sha,is_bug,committer_name,commit_time,parents,all_del,all_add,all_change_lines,all_lines,files_change_nums,dmm_unit_size,dmm_unit_complexity,dmm_unit_interfacing,file_nums
642da2f28c9bc6e373603d6d9119ce33684090f5,1,Edward Jay Kreps,2011-08-01 23:41:24+00:00,[],0,72944,72944,72944,433,0.507537319,0.800647106,0.912567101,433
cbbfbaf33179f2a44ae641ccaaba1f0a8e73730f,0,Chris Burroughs,2011-08-03 17:34:03+00:00,['642da2f28c9bc6e373603d6d9119ce33684090f5'],0,14,14,72958,1,,,,434
665f1d0527846e1eaf6c39fd8a329dbfeb08b0c9,0,Jun Rao,2011-08-05 01:36:43+00:00,['cbbfbaf33179f2a44ae641ccaaba1f0a8e73730f'],0,0,0,72958,1,,,,434
96b8e03dd1ee23a550ca87803777b4d7bec05d5a,1,Jun Rao,2011-08-07 16:29:55+00:00,['665f1d0527846e1eaf6c39fd8a329dbfeb08b0c9'],31,33,64,73022,11,0,0,1,434
f7046c247dd466c90337bb39a4612115c3e41923,0,Jun Rao,2011-08-07 23:56:05+00:00,['96b8e03dd1ee23a550ca87803777b4d7bec05d5a'],13,4,17,73039,1,1,0,0,434
ed34f0cb35cf7ec1a6837ba5180d05a9659e0d37,0,Jun Rao,2011-08-08 18:27:54+00:00,['f7046c247dd466c90337bb39a4612115c3e41923'],0,2,2,73041,1,,,,434
e96cf1facfa4ef21128f38aaf9484a307c6bdb61,0,Chris Burroughs,2011-08-10 13:14:28+00:00,['ed34f0cb35cf7ec1a6837ba5180d05a9659e0d37'],4,5,9,73050,1,,,,434
462dfda513d98a0017564f5070f678d57f834872,0,Henry Saputra,2011-08-10 15:33:21+00:00,['e96cf1facfa4ef21128f38aaf9484a307c6bdb61'],1088,1380,2468,75518,188,,,,434
d0c980dab278627286e9a2be649de0f6c8ce8b53,0,Henry Saputra,2011-08-10 18:32:09+00:00,['462dfda513d98a0017564f5070f678d57f834872'],46,74,120,75638,10,,,,434
49f3b4017918c4e254e9bc09e2ef5178d62e0248,1,Jun Rao,2011-08-10 22:32:23+00:00,['d0c980dab278627286e9a2be649de0f6c8ce8b53'],159,720,879,76517,20,0.521367521,0.641025641,0.829059829,440
944da579ba1828586b1b000fcd5cad6076abbcd3,1,Jun Rao,2011-08-12 02:09:56+00:00,['49f3b4017918c4e254e9bc09e2ef5178d62e0248'],2,4,6,76523,1,0,0,1,440
d7e0b11d875e4c8fc21bfe3cc0cc4da542fa387a,1,Jun Rao,2011-08-14 16:42:35+00:00,['944da579ba1828586b1b000fcd5cad6076abbcd3'],1,1,2,76525,1,,,,440
7976993f9e20d7448105e50e1dca74ecf8bc1ea3,0,Edward Jay Kreps,2011-08-15 17:31:35+00:00,['d7e0b11d875e4c8fc21bfe3cc0cc4da542fa387a'],4,4,8,76533,2,,,,440
6d1b6f28270e0bfc0678bd69fbb77341cef74d51,1,Edward Jay Kreps,2011-08-15 17:34:24+00:00,['7976993f9e20d7448105e50e1dca74ecf8bc1ea3'],20,20,40,76573,7,0,1,1,440
4cf1f167460f9ee5da60214eef72ea43148063c6,0,Jun Rao,2011-08-16 21:07:54+00:00,['6d1b6f28270e0bfc0678bd69fbb77341cef74d51'],7,1,8,76581,1,,,,440
82b42163a55440eee6508ff4a721906bc40704e8,0,Jun Rao,2011-08-17 23:34:08+00:00,['4cf1f167460f9ee5da60214eef72ea43148063c6'],9,18,27,76608,3,1,1,1,440
8a07bdb71e74377d7b8ae3c53fe1e59f46bbe2a8,1,Neha Narkhede,2011-08-19 00:29:09+00:00,['82b42163a55440eee6508ff4a721906bc40704e8'],31,76,107,76715,2,0,1,1,440
900496eedabd7acfdeaaf077239228f4d94312e8,1,Neha Narkhede,2011-08-19 00:47:34+00:00,['8a07bdb71e74377d7b8ae3c53fe1e59f46bbe2a8'],36,28,64,76779,4,1,0,0,440
28984e6c1834bd88f5acb86dd7468751c542ac50,0,Neha Narkhede,2011-08-19 00:51:20+00:00,['900496eedabd7acfdeaaf077239228f4d94312e8'],0,77,77,76856,2,0.210526316,1,1,440
76ccf2211db03d819b7847d69c41cb88da04bfe9,0,Neha Narkhede,2011-08-19 01:00:07+00:00,['28984e6c1834bd88f5acb86dd7468751c542ac50'],2,4,6,76862,2,0.5,1,1,440
4f56e4410025a1154b75f20e86091589aace7bd5,1,Neha Narkhede,2011-08-19 01:09:26+00:00,['76ccf2211db03d819b7847d69c41cb88da04bfe9'],6,13,19,76881,1,0.142857143,0.142857143,1,440
4a688c5d6c87aa8dfffdb2154ef880107176573f,1,Edward Jay Kreps,2011-08-20 04:08:06+00:00,['4f56e4410025a1154b75f20e86091589aace7bd5'],12,102,114,76995,5,0.837837838,0.864864865,1,441
a484c1bcd1ecf4116102576ccd615168c693832f,0,Neha Narkhede,2011-08-23 02:31:56+00:00,['4a688c5d6c87aa8dfffdb2154ef880107176573f'],1,1,2,76997,1,,,,441
2e05fbfa221fcec5ef6b57490e005759363966ee,1,Neha Narkhede,2011-08-23 02:36:24+00:00,['a484c1bcd1ecf4116102576ccd615168c693832f'],17,34,51,77048,3,0,0,1,441
e311cbb6bb1735ecd1d94be0fb1e6fca9fa99f75,0,Chris Burroughs,2011-08-23 22:22:13+00:00,['2e05fbfa221fcec5ef6b57490e005759363966ee'],0,4,4,77052,2,,,,441
c79c4f6f94328da5ca5090037093453311b0bfa4,1,Neha Narkhede,2011-08-24 00:44:22+00:00,['e311cbb6bb1735ecd1d94be0fb1e6fca9fa99f75'],33,48,81,77133,3,0.25,0.25,1,441
4cdc982e22870f0e4d993d479036a3571ad3a2bc,1,Neha Narkhede,2011-08-24 00:50:28+00:00,['c79c4f6f94328da5ca5090037093453311b0bfa4'],14,4,18,77151,4,,,,441
bf30ae996f2ec08ae97f61a0eff0c50bb8ce8067,1,Neha Narkhede,2011-08-24 01:27:42+00:00,['4cdc982e22870f0e4d993d479036a3571ad3a2bc'],23,20,43,77194,3,1,1,1,441
72544aa51ee07d573922498f33783aa636de7fea,0,Neha Narkhede,2011-08-24 01:33:59+00:00,['bf30ae996f2ec08ae97f61a0eff0c50bb8ce8067'],12,6,18,77212,2,0,1,,441
b5ea7c9055bbc7dd0b1a655b9340f48a7e795d4d,0,Neha Narkhede,2011-08-24 21:10:03+00:00,['72544aa51ee07d573922498f33783aa636de7fea'],0,25,25,77237,1,1,1,1,442
d72b388236fb9b1541c79bd7e31687795e137b25,1,Jun Rao,2011-08-25 17:47:03+00:00,['b5ea7c9055bbc7dd0b1a655b9340f48a7e795d4d'],6,3,9,77246,1,1,1,0,442
92b1dd925256455b97200a5c77d4e83ba50c4b86,0,Chris Burroughs,2011-08-31 16:53:38+00:00,['d72b388236fb9b1541c79bd7e31687795e137b25'],4,5,9,77255,1,,,,442
c247dfa8844f6d112755f21918dc1515db37a05e,1,Edward Jay Kreps,2011-09-01 05:47:21+00:00,['92b1dd925256455b97200a5c77d4e83ba50c4b86'],3,10,13,77268,1,0,0,1,442
ec21a5e841bf561275f1095deb7e8b38ad9ca953,1,Jun Rao,2011-09-01 07:49:31+00:00,['c247dfa8844f6d112755f21918dc1515db37a05e'],4,5,9,77277,1,0,0,1,442
c8e507aba42cd5572ea237c1db0654164209b3c8,0,Jun Rao,2011-09-02 05:19:15+00:00,['ec21a5e841bf561275f1095deb7e8b38ad9ca953'],2,2,4,77281,2,,,,442
d42450715cf8ac6774fc68e36c1751e34f29549b,0,Jun Rao,2011-09-07 21:47:26+00:00,['c8e507aba42cd5572ea237c1db0654164209b3c8'],7,9,16,77297,1,1,1,1,442
6af334d69ade5f4f21a89b8b2a8e0e881ed51359,1,Jun Rao,2011-09-09 23:49:45+00:00,['d42450715cf8ac6774fc68e36c1751e34f29549b'],0,147,147,77444,1,0.256880734,0.532110092,0.660550459,443
54f49314afbc1e13ff511f152e9b292ffaf9104d,1,Edward Jay Kreps,2011-09-17 03:21:06+00:00,['6af334d69ade5f4f21a89b8b2a8e0e881ed51359'],14,99,113,77557,3,0.828125,1,1,443
8efb536aff3fefda0e7f683c5daf6814d0f27c2c,1,Edward Jay Kreps,2011-09-17 03:31:15+00:00,['54f49314afbc1e13ff511f152e9b292ffaf9104d'],1,3,4,77561,1,1,1,1,443
dc66fd9a4b6e77cacb5c15dee18a404a0bb89408,0,Jun Rao,2011-09-21 19:17:19+00:00,['8efb536aff3fefda0e7f683c5daf6814d0f27c2c'],1333,16997,18330,95891,144,0.410405585,0.845079787,0.882480053,569
d772600c7b79d84d332aa2b7d37512b47fd7d7ae,0,Jun Rao,2011-09-23 01:44:40+00:00,['dc66fd9a4b6e77cacb5c15dee18a404a0bb89408'],872,1121,1993,97884,129,,,,569
5fbac30f865dd0829ea965b5a5a62b8b8f695e2a,1,Jun Rao,2011-09-26 17:34:48+00:00,['d772600c7b79d84d332aa2b7d37512b47fd7d7ae'],7,16,23,97907,5,1,1,1,569
61433bf0a2afc4d7da9bcde79c504aab434f4d79,0,Jun Rao,2011-09-26 17:41:02+00:00,['5fbac30f865dd0829ea965b5a5a62b8b8f695e2a'],1,1,2,97909,1,,,,569
4092ceeb5ae5c5e2546c824ccab7478a8ab19c68,1,Jun Rao,2011-09-28 00:42:30+00:00,['61433bf0a2afc4d7da9bcde79c504aab434f4d79'],84,154,238,98147,14,0,0,1,569
1b0feb6345b07136c8a7807962c4a7aa0691d777,1,Jun Rao,2011-09-28 00:51:51+00:00,['4092ceeb5ae5c5e2546c824ccab7478a8ab19c68'],4,4,8,98155,2,,,,569
da35513245797a491f8908c2c9ef7f66341bcbd2,1,Jun Rao,2011-09-30 05:44:13+00:00,['1b0feb6345b07136c8a7807962c4a7aa0691d777'],1,1,2,98157,1,,,,569
efc7a8a0cd16c759cee54b8621bbfdbd4e7bb2a9,0,Jun Rao,2011-09-30 19:36:07+00:00,['da35513245797a491f8908c2c9ef7f66341bcbd2'],0,19,19,98176,3,1,1,1,569
596c8d1af7403782c54c1e0814fff526f21cb8df,1,Jun Rao,2011-10-03 04:57:06+00:00,['efc7a8a0cd16c759cee54b8621bbfdbd4e7bb2a9'],4,59,63,98239,4,1,1,1,570
42c2241cfb1308956b87477dad6e71a63d0ab40f,0,Jun Rao,2011-10-03 15:49:36+00:00,['596c8d1af7403782c54c1e0814fff526f21cb8df'],1,1,2,98241,1,,,,570
031a559e89134497d0e3e9a366321fbdb3976b99,1,Edward Jay Kreps,2011-10-03 20:11:36+00:00,['42c2241cfb1308956b87477dad6e71a63d0ab40f'],2,2,4,98245,1,,,,570
59a5c3215a4736f8c6ccbaace3bf99ec935e738d,1,Edward Jay Kreps,2011-10-04 00:54:14+00:00,['031a559e89134497d0e3e9a366321fbdb3976b99'],0,155,155,98400,2,0.23,0.23,1,572
4c2d121b26ad9c2efa7d6b23bff7278a54c5e3ed,0,Chris Burroughs,2011-10-04 01:41:02+00:00,['59a5c3215a4736f8c6ccbaace3bf99ec935e738d'],3,3,6,98406,5,,,,573
a7b4731947b605d8433c91e967aaecacd5340aa4,0,Chris Burroughs,2011-10-04 01:41:25+00:00,['4c2d121b26ad9c2efa7d6b23bff7278a54c5e3ed'],98,98,196,98602,10,,,,573
513c4a59d8335e019a6742f731ce3fd5d6a433ff,0,Chris Burroughs,2011-10-04 22:30:28+00:00,['a7b4731947b605d8433c91e967aaecacd5340aa4'],1,1,2,98604,1,,,,573
dd62e77f90f5f6fb9050627a9cfa40b35dae67b1,1,Neha Narkhede,2011-10-04 22:43:00+00:00,['513c4a59d8335e019a6742f731ce3fd5d6a433ff'],97,199,296,98900,7,0.4,0,1,573
bac6d9c3fa0e650aa1af99959fe63a8dd33971c8,0,Neha Narkhede,2011-10-05 02:49:56+00:00,['dd62e77f90f5f6fb9050627a9cfa40b35dae67b1'],147,0,147,99047,2,1,0,0,573
4f284428640f172976f2ece9e696b5cf95907b5f,0,Neha Narkhede,2011-10-05 22:48:10+00:00,['bac6d9c3fa0e650aa1af99959fe63a8dd33971c8'],29,70,99,99146,1,1,1,0,573
f7b2819bff31bb58c4fd32f847e2659b23ecda4a,0,Neha Narkhede,2011-10-06 01:57:38+00:00,['4f284428640f172976f2ece9e696b5cf95907b5f'],3,3,6,99152,5,,,,574
881eaf14e5a8d8396c897b158209080b558be377,0,Jun Rao,2011-10-06 05:04:40+00:00,['f7b2819bff31bb58c4fd32f847e2659b23ecda4a'],0,1,1,99153,1,0,0,1,574
0a9aea7160cc3b0e493608d843998300dd0ec495,1,Jun Rao,2011-10-06 05:10:09+00:00,['881eaf14e5a8d8396c897b158209080b558be377'],1,76,77,99230,2,0,1,1,575
101af58f6c0dc007d53819eb5f3281c60d1fa7bc,0,Neha Narkhede,2011-10-06 19:45:38+00:00,['0a9aea7160cc3b0e493608d843998300dd0ec495'],10,118,128,99358,8,,,,575
472723f1cccb8cb1e74ef52e47ccb2fbdc6c3e3d,0,Neha Narkhede,2011-10-06 19:48:03+00:00,['101af58f6c0dc007d53819eb5f3281c60d1fa7bc'],1339,0,1339,100697,23,0.280930233,0.16372093,0.140465116,575
4de899c24d29b86b2faf51040976ae795e12fea8,1,Neha Narkhede,2011-10-06 19:57:38+00:00,['472723f1cccb8cb1e74ef52e47ccb2fbdc6c3e3d'],8,21,29,100726,1,0.153846154,0,0.076923077,575
a1193810b62504ff2e3b4a931bc8c5109a7a530b,0,Neha Narkhede,2011-10-06 21:12:35+00:00,['4de899c24d29b86b2faf51040976ae795e12fea8'],22,1,23,100749,1,,,,575
e2a91de7a212a0f5fd18686b0e1dff659a1fe1bb,0,Neha Narkhede,2011-10-06 22:28:52+00:00,['a1193810b62504ff2e3b4a931bc8c5109a7a530b'],0,69,69,100818,1,,,,576
79092880fdce34005b5de8d4fb2c80b1d5e7533f,0,Neha Narkhede,2011-10-07 00:54:13+00:00,['e2a91de7a212a0f5fd18686b0e1dff659a1fe1bb'],53,84,137,100955,1,,,,576
a99becbe491680346c47b0bf8af738e1729de348,0,Neha Narkhede,2011-10-07 17:18:56+00:00,['79092880fdce34005b5de8d4fb2c80b1d5e7533f'],15,1193,1208,102163,84,,,,576
f34dfc002d7e1aa6b57eb7fa28ee3c928a96e968,0,Neha Narkhede,2011-10-07 17:33:43+00:00,['a99becbe491680346c47b0bf8af738e1729de348'],1193,1,1194,103357,83,,,,576
fa09aacdbdf0cd325edd28eb80cbd0f4b232ffc3,0,Neha Narkhede,2011-10-07 19:51:28+00:00,['f34dfc002d7e1aa6b57eb7fa28ee3c928a96e968'],1,1193,1194,104551,83,,,,576
a45af2f1ed30bd6586690076dc7523b303fa6168,0,Chris Burroughs,2011-10-10 14:18:40+00:00,['fa09aacdbdf0cd325edd28eb80cbd0f4b232ffc3'],0,14,14,104565,1,,,,577
84c06d4285fd087a44df07684031d96a4ba249c5,1,Jun Rao,2011-10-11 01:10:37+00:00,['a45af2f1ed30bd6586690076dc7523b303fa6168'],1,2,3,104568,1,0,0,1,577
c7fb4649384d6635b820b6b39fa6c424e0c535b9,1,Neha Narkhede,2011-10-11 19:00:28+00:00,['84c06d4285fd087a44df07684031d96a4ba249c5'],18,831,849,105417,16,,,,580
c0fc483d9f34d2adf3499b7d164f4c73d2e4f10e,0,Jun Rao,2011-10-11 19:11:38+00:00,['c7fb4649384d6635b820b6b39fa6c424e0c535b9'],1,1,2,105419,1,,,,580
e27136d81a47a5601e0a85069140a0a7854d3d65,0,Neha Narkhede,2011-10-12 01:05:28+00:00,['c0fc483d9f34d2adf3499b7d164f4c73d2e4f10e'],39891,167,40058,145477,24,1,0,1,581
85989a1baf42f5a3e204044e09a01dcee8332afa,0,Neha Narkhede,2011-10-12 19:28:46+00:00,['e27136d81a47a5601e0a85069140a0a7854d3d65'],100,0,100,145577,1,,,,581
4ad98872ad25b93a10c368edc77b59ed4032d3af,0,Neha Narkhede,2011-10-14 01:30:12+00:00,['85989a1baf42f5a3e204044e09a01dcee8332afa'],0,74,74,145651,4,,,,584
3f0046be1b1ff9f0561b3f6cbf36dd32b0c0727d,0,Neha Narkhede,2011-10-14 01:32:41+00:00,['4ad98872ad25b93a10c368edc77b59ed4032d3af'],4,256,260,145911,16,,,,584
e39c11abbc24223344b5ee8f7c8c03f126da5750,0,Jun Rao,2011-10-18 17:52:13+00:00,['3f0046be1b1ff9f0561b3f6cbf36dd32b0c0727d'],1392,1815,3207,149118,63,0.215231788,0.910596026,1,584
c2dc9c0841532abc3cdb29e2daeae2a4854dee3d,0,Jun Rao,2011-10-18 17:57:29+00:00,['e39c11abbc24223344b5ee8f7c8c03f126da5750'],19,26,45,149163,3,1,1,1,584
a0b2aa8847a97a60fbc087d7fff27db28be170d1,0,Edward Jay Kreps,2011-10-19 22:14:50+00:00,['c2dc9c0841532abc3cdb29e2daeae2a4854dee3d'],2,3,5,149168,1,1,1,1,584
81f8d0dd83a25e075cc6a08c6105b01459980c5f,1,Jun Rao,2011-10-19 23:52:58+00:00,['a0b2aa8847a97a60fbc087d7fff27db28be170d1'],3,23,26,149194,4,1,1,1,584
ce070548e413714c60a5cbdd642421cdc1e49b1d,1,Edward Jay Kreps,2011-10-23 22:03:49+00:00,['81f8d0dd83a25e075cc6a08c6105b01459980c5f'],0,23,23,149217,1,,,,585
46b6144a8fee4d9cc1c4ff22d2c1984540259c6b,1,Edward Jay Kreps,2011-10-24 05:01:40+00:00,['ce070548e413714c60a5cbdd642421cdc1e49b1d'],38,76,114,149331,1,,,,585
76957e5e3a748b59525e5e7934f93721eb8f4c38,0,Edward Jay Kreps,2011-10-24 17:47:20+00:00,['46b6144a8fee4d9cc1c4ff22d2c1984540259c6b'],3,11,14,149345,2,0,1,1,585
41f14a3e965b8ff6a3e2e734e92574199463b452,1,Edward Jay Kreps,2011-10-24 18:52:12+00:00,['76957e5e3a748b59525e5e7934f93721eb8f4c38'],0,110,110,149455,1,0.176470588,1,1,586
d9a8af778275fda2057d49f244e61456dfcf2f96,0,Neha Narkhede,2011-10-24 19:41:35+00:00,['41f14a3e965b8ff6a3e2e734e92574199463b452'],25,30,55,149510,3,0,1,1,586
14a1f0dcd6af28bc710e108e6f7a5c10f825a40a,0,Neha Narkhede,2011-10-27 14:24:27+00:00,['d9a8af778275fda2057d49f244e61456dfcf2f96'],88,456,544,150054,13,0.4,0.42173913,0.991304348,587
12572102c695058264af1599112f0660325e7189,0,Neha Narkhede,2011-10-30 21:17:13+00:00,['14a1f0dcd6af28bc710e108e6f7a5c10f825a40a'],1074,0,1074,151128,15,,,,587
65c25ae6b948587b65ada9c87f8a783ac1b2ab22,1,Neha Narkhede,2011-10-30 21:39:44+00:00,['12572102c695058264af1599112f0660325e7189'],0,23,23,151151,1,1,1,1,587
5c3d5d815ca4f74611ffdd0fbd9da05cd5943d83,0,Neha Narkhede,2011-10-30 23:46:41+00:00,['65c25ae6b948587b65ada9c87f8a783ac1b2ab22'],0,0,0,151151,15,,,,587
5497e8d156abeb898ed556c688d2a84b8c8bdd83,0,Edward Jay Kreps,2011-11-05 20:25:33+00:00,['5c3d5d815ca4f74611ffdd0fbd9da05cd5943d83'],1,1,2,151153,1,,,,587
4f9000c412f0586032bf622ebad23f941969d2c4,1,Neha Narkhede,2011-11-06 19:07:20+00:00,['5497e8d156abeb898ed556c688d2a84b8c8bdd83'],8,8,16,151169,1,0,0,0,587
0153d4bb597283f48ae07af7cda3c633a71e436b,1,Jun Rao,2011-11-07 18:11:10+00:00,['4f9000c412f0586032bf622ebad23f941969d2c4'],15,90,105,151274,2,1,0,0,588
c51b940179e2a5719021ea253b38ec4a2beed41f,1,Jun Rao,2011-11-15 05:02:08+00:00,['0153d4bb597283f48ae07af7cda3c633a71e436b'],112,154,266,151540,4,1,1,1,588
7d856dce92d00e2c5a5dccdac7f8908f7fba44e2,1,Neha Narkhede,2011-11-18 00:23:44+00:00,['c51b940179e2a5719021ea253b38ec4a2beed41f'],52,40,92,151632,2,,,,589
af923c3018f8ddee6703e577eadf9227d826806e,1,Jun Rao,2011-11-22 00:35:09+00:00,['7d856dce92d00e2c5a5dccdac7f8908f7fba44e2'],31,85,116,151748,8,0.70212766,1,1,589
09f5ce21b337bdfb950cb393bf8fc004dcd0f36d,1,Jun Rao,2011-11-22 00:58:39+00:00,['af923c3018f8ddee6703e577eadf9227d826806e'],20,31,51,151799,3,,,,589
41db543d31622e2b0943e3e62fbca4203493825f,1,Neha Narkhede,2011-11-22 18:03:09+00:00,['09f5ce21b337bdfb950cb393bf8fc004dcd0f36d'],0,64,64,151863,1,,,,589
1280b71a35f0868de427a22271fa9f38384d9f2f,1,Edward Jay Kreps,2011-11-23 07:21:16+00:00,['41db543d31622e2b0943e3e62fbca4203493825f'],591,495,1086,152949,55,1,1,1,590
cb4486656e2c25d2988892628a61279b0a9eb913,1,Edward Jay Kreps,2011-11-23 07:29:37+00:00,['1280b71a35f0868de427a22271fa9f38384d9f2f'],25,22,47,152996,9,0,0,0,590
56b48d3fb6eaac98f3452901af0f61a60adf7db8,1,Neha Narkhede,2011-11-23 18:19:06+00:00,['cb4486656e2c25d2988892628a61279b0a9eb913'],525,682,1207,154203,11,0.25,0,0,595
e98bf881a5b3c81d00e6d5b424ef74236c197952,0,Jun Rao,2011-11-23 18:43:48+00:00,['56b48d3fb6eaac98f3452901af0f61a60adf7db8'],185,3,188,154391,1,1,0,0,595
285acbec41af90a9308a5c762fc13441ce83a57c,0,Jun Rao,2011-11-23 23:25:14+00:00,['e98bf881a5b3c81d00e6d5b424ef74236c197952'],2,4,6,154397,1,0,1,1,595
eefd133656f6dfcf6cfcdc524b300bfa13fd1d0a,0,Jun Rao,2011-11-23 23:40:23+00:00,['285acbec41af90a9308a5c762fc13441ce83a57c'],4,2,6,154403,1,1,0,0,595
c65e771d4714e7081d54222d847ad5e08a3238ed,0,Jun Rao,2011-11-23 23:41:23+00:00,['eefd133656f6dfcf6cfcdc524b300bfa13fd1d0a'],2,4,6,154409,1,0,1,1,595
cb2564c45e83ab829cbf482665abe667bd830292,0,Jun Rao,2011-11-28 21:53:13+00:00,['c65e771d4714e7081d54222d847ad5e08a3238ed'],2,2,4,154413,1,,,,595
078bd591e1c5c37198af43184620fc69320d6a36,0,Jun Rao,2011-11-28 21:56:14+00:00,['cb2564c45e83ab829cbf482665abe667bd830292'],3,6,9,154422,2,,,,595
8aecab22532711dbe568261347ebaa077298f007,1,Jakob Glen Homan,2011-11-30 23:30:28+00:00,['078bd591e1c5c37198af43184620fc69320d6a36'],0,34,34,154456,2,,,,595
07611f317474a3d4fd835df0feca729de976ada9,1,Neha Narkhede,2011-12-01 00:46:25+00:00,['8aecab22532711dbe568261347ebaa077298f007'],1,7,8,154464,2,0,0.25,1,595
c36cba4f6c7f439984a40a09dee58355200624a4,1,Neha Narkhede,2011-12-01 01:03:35+00:00,['07611f317474a3d4fd835df0feca729de976ada9'],0,1,1,154465,1,,,,595
f53eb16f879374fea421deb0a31464d5a32273d4,0,Neha Narkhede,2011-12-07 20:14:15+00:00,['c36cba4f6c7f439984a40a09dee58355200624a4'],10,35,45,154510,14,,,,595
9a3e2104b5fcf845afb1a1218989ec2436fbf0da,0,Jun Rao,2011-12-08 02:38:46+00:00,['f53eb16f879374fea421deb0a31464d5a32273d4'],1,1,2,154512,1,,,,595
bbba103d768b02bd39dc77caceb560d78c10f024,1,Jun Rao,2011-12-13 03:03:38+00:00,['9a3e2104b5fcf845afb1a1218989ec2436fbf0da'],59,60,119,154631,2,1,1,,595
31f6f02aa2395011e713b3ca66f2412926db34ca,0,Jun Rao,2011-12-13 23:55:52+00:00,['bbba103d768b02bd39dc77caceb560d78c10f024'],23,47,70,154701,4,1,0,0,596
77da5f54d736bfa63fb0b2a20415919aaf9ad96d,0,Neha Narkhede,2011-12-15 18:30:05+00:00,['31f6f02aa2395011e713b3ca66f2412926db34ca'],99,32,131,154832,2,,,,596
e5a4ec1806e5a457dae4d9b0df75953876888940,0,Jun Rao,2011-12-16 02:21:02+00:00,['77da5f54d736bfa63fb0b2a20415919aaf9ad96d'],1,0,1,154833,1,1,1,0,596
5eb4badfc9980d25dd817c4caee6264e1e5b4b70,0,Edward Jay Kreps,2012-01-02 20:51:36+00:00,['e5a4ec1806e5a457dae4d9b0df75953876888940'],3,3,6,154839,1,,,,596
a7d4c2cf235cbe626ff3bc9053982929b6a62884,1,Jun Rao,2012-01-03 01:55:23+00:00,['5eb4badfc9980d25dd817c4caee6264e1e5b4b70'],6,4,10,154849,3,0,0,0,596
aac76681959f8e6090e443cbbce41c74e0393089,1,Jun Rao,2012-01-05 01:12:43+00:00,['a7d4c2cf235cbe626ff3bc9053982929b6a62884'],5,8,13,154862,3,,,,596
336410a7774b0ee20758358a1bf03461ce4b98e1,1,Neha Narkhede,2012-01-06 00:43:46+00:00,['aac76681959f8e6090e443cbbce41c74e0393089'],11,1616,1627,156489,23,0.444444444,0.5,1,614
66be5eedf3e758ad53b966272f9228f54a96e648,0,Jun Rao,2012-01-06 22:50:29+00:00,['336410a7774b0ee20758358a1bf03461ce4b98e1'],7,20,27,156516,4,0.714285714,1,1,614
b0484eccf3e72ff856c4e1c63949ac036c92d932,1,Neha Narkhede,2012-01-07 00:01:25+00:00,['66be5eedf3e758ad53b966272f9228f54a96e648'],69,123,192,156708,12,1,1,0,614
7821f5b20fd9c842cad00435abd1f697b238f540,0,Neha Narkhede,2012-01-10 22:53:04+00:00,['b0484eccf3e72ff856c4e1c63949ac036c92d932'],1,1,2,156710,1,,,,614
a3c742ef23d19962bdc13f75eebb8a8082ad04a2,0,Neha Narkhede,2012-01-10 23:17:45+00:00,['7821f5b20fd9c842cad00435abd1f697b238f540'],21,2,23,156733,2,0,0,0,614
7bd3e169f165a15822e2c81f3ea90ea954175f31,1,Jun Rao,2012-01-11 02:53:04+00:00,['a3c742ef23d19962bdc13f75eebb8a8082ad04a2'],2,2,4,156737,1,,,,614
6c43b4634e5cebae822f19ed581bd97d74b3d47f,0,Neha Narkhede,2012-01-12 20:26:25+00:00,['7bd3e169f165a15822e2c81f3ea90ea954175f31'],1,1,2,156739,1,,,,614
570672793791b927162d4bf7d9da6f8c016f270d,0,Neha Narkhede,2012-01-12 23:54:57+00:00,['6c43b4634e5cebae822f19ed581bd97d74b3d47f'],0,0,0,156739,0,,,,614
60d88a3ac95bee3b54a3d732d1ada22258054a33,1,Neha Narkhede,2012-01-13 00:03:02+00:00,['570672793791b927162d4bf7d9da6f8c016f270d'],209,219,428,157167,28,1,1,1,614
1021ea9002dc7250c000512db7a8dec92f462404,1,Neha Narkhede,2012-01-13 19:53:32+00:00,['6c43b4634e5cebae822f19ed581bd97d74b3d47f'],67,148,215,157382,3,0.526315789,0.526315789,1,614
cd91e6770b62d336ea61332782d31a21599587a3,1,Neha Narkhede,2012-01-13 21:15:29+00:00,['60d88a3ac95bee3b54a3d732d1ada22258054a33'],0,272,272,157654,3,0.579710145,0.913043478,1,617
ff668f4fc9a07137c92cc9259f8116d9ec2d2e1f,1,Jun Rao,2012-01-13 23:48:27+00:00,['cd91e6770b62d336ea61332782d31a21599587a3'],0,683,683,158337,11,0.197560976,0.353658537,0.897560976,626
e913a06533c12c3cb7f139962abe5b61d2d08e0a,0,Jun Rao,2012-01-13 23:52:21+00:00,['ff668f4fc9a07137c92cc9259f8116d9ec2d2e1f'],0,0,0,158337,3,,,,626
d3c58b64287b73ff9613e53e293d4a0989389cb2,0,Jun Rao,2012-01-17 17:30:38+00:00,['1021ea9002dc7250c000512db7a8dec92f462404'],4,1,5,158342,1,,,,626
fe2f0557130b21aca203ced11bd6990322847b97,0,Jun Rao,2012-01-19 17:53:32+00:00,['d3c58b64287b73ff9613e53e293d4a0989389cb2'],9,19,28,158370,3,0.6,0.8,1,626
af0ceff79b3f1902bf9d005136ace81549332902,1,Neha Narkhede,2012-01-24 20:54:11+00:00,['e913a06533c12c3cb7f139962abe5b61d2d08e0a'],520,957,1477,159847,89,0.560483871,0.774193548,0.834677419,629
fcc82dce6aff8fee30ce8a5ada3c6167aef1462f,0,Jun Rao,2012-02-02 17:33:46+00:00,['fe2f0557130b21aca203ced11bd6990322847b97'],12,12,24,159871,2,1,0,1,629
afd4b0d772f35f902a7acf81039abcc47b983d1f,1,Neha Narkhede,2012-02-02 19:07:48+00:00,['fcc82dce6aff8fee30ce8a5ada3c6167aef1462f'],140,356,496,160367,37,0.12345679,0,0.932098765,630
e3b529df80bfbc8d5ae3f86ef29efaf25e2edfb7,1,Neha Narkhede,2012-02-02 23:40:39+00:00,['af0ceff79b3f1902bf9d005136ace81549332902'],173,532,705,161072,18,0.155844156,0.025974026,0.952380952,631
2552a2488f2674e2fc3abea02272e85ff13a3ee4,0,Neha Narkhede,2012-02-06 23:10:54+00:00,['afd4b0d772f35f902a7acf81039abcc47b983d1f'],40,107,147,161219,3,0,0,1,631
345bc7bad594af43df5fc264ad0b5904d1126257,0,Neha Narkhede,2012-02-07 17:38:15+00:00,['2552a2488f2674e2fc3abea02272e85ff13a3ee4'],82,246,328,161547,15,1,1,1,631
21da30456f4c23aae1f40b3446f74565d5b6d917,1,Jun Rao,2012-02-08 02:59:54+00:00,['e3b529df80bfbc8d5ae3f86ef29efaf25e2edfb7'],2479,747,3226,164773,32,0.914778857,0.074433657,0,631
a888a9d09e4fc219ab9d8536034ac043093f17df,0,Neha Narkhede,2012-02-09 22:04:32+00:00,['345bc7bad594af43df5fc264ad0b5904d1126257'],114,37,151,164924,23,0.723404255,0.255319149,0.659574468,631
6a3c2f2032c5e910f634a29bfead555b63433465,0,Jun Rao,2012-02-10 06:52:37+00:00,['a888a9d09e4fc219ab9d8536034ac043093f17df'],1,1,2,164926,1,,,,631
a5fb217293e5124ef7f47e0d45c7400bd9286077,1,Jun Rao,2012-02-13 03:58:37+00:00,['21da30456f4c23aae1f40b3446f74565d5b6d917'],803,1037,1840,166766,37,0.531578947,0.905263158,0.889473684,633
732c27ff3e8bc6d5a9511ee64de275df49adf73f,0,Jun Rao,2012-02-13 22:31:02+00:00,['6a3c2f2032c5e910f634a29bfead555b63433465'],3,33,36,166802,1,0.24,1,1,633
0bd3b9c3f6df76043afbdce817d33d7531f1eecd,0,Jun Rao,2012-02-14 06:19:34+00:00,['732c27ff3e8bc6d5a9511ee64de275df49adf73f'],1,8,9,166811,2,0,0,1,633
6e36047fae3338b425a63c0d1e4a5acb499e5207,1,Jun Rao,2012-02-15 19:08:08+00:00,['a5fb217293e5124ef7f47e0d45c7400bd9286077'],14,84,98,166909,6,0.432432432,0.837837838,1,634
5c4ce616994112a68f8864520c4a2a6c7b545e30,0,Jun Rao,2012-02-15 22:04:00+00:00,['0bd3b9c3f6df76043afbdce817d33d7531f1eecd'],3,56,59,166968,2,0.222222222,0.925925926,1,634
3e79116e7a7c725cafae1b5248a99837641a4ca2,0,Jun Rao,2012-02-15 22:22:11+00:00,['5c4ce616994112a68f8864520c4a2a6c7b545e30'],1,1,2,166970,1,,,,634
2ead8a49ea1c7e634c889e9425fd5eb209e7f1ff,0,Jun Rao,2012-02-15 23:51:27+00:00,['3e79116e7a7c725cafae1b5248a99837641a4ca2'],0,1,1,166971,1,0,0,1,634
6e1b2ebe3278c99e1b3ea89a47c60497cb964d44,0,Jun Rao,2012-02-17 02:14:25+00:00,['2ead8a49ea1c7e634c889e9425fd5eb209e7f1ff'],2,5,7,166978,1,0,0,1,634
c28b3a61cce3288d3c0b620d1ef73d936989d3c5,0,Neha Narkhede,2012-02-17 02:33:07+00:00,['6e1b2ebe3278c99e1b3ea89a47c60497cb964d44'],6,19,25,167003,3,0.333333333,0.333333333,1,634
ff562472ddf834e092cc2a8124dad59e763017db,0,Joe Stein,2012-02-17 04:14:47+00:00,['c28b3a61cce3288d3c0b620d1ef73d936989d3c5'],2,2,4,167007,1,,,,634
a23d396a5a2f5c8685a404ce8478540c13fac6d4,0,Jun Rao,2012-02-17 21:54:29+00:00,['ff562472ddf834e092cc2a8124dad59e763017db'],1,1,2,167009,1,,,,634
95ee38728cb1d8eb9b62a73eb5ad26902142a1fd,0,Jun Rao,2012-02-20 22:24:52+00:00,['a23d396a5a2f5c8685a404ce8478540c13fac6d4'],1,4,5,167014,1,,,,634
7066d1c38b66d4de2d02fc1ef2fa8e7908990d07,0,Jun Rao,2012-02-21 00:25:55+00:00,['95ee38728cb1d8eb9b62a73eb5ad26902142a1fd'],0,123,123,167137,1,0.119402985,0.119402985,0.940298507,635
22d80462b15e24fc63960254bdfd8be74ddc14ba,0,Jun Rao,2012-02-21 00:26:42+00:00,['7066d1c38b66d4de2d02fc1ef2fa8e7908990d07'],0,112,112,167249,1,0.490909091,1,1,636
333966f50ea42ba41ff243d1ba5571a2fa8b9a60,1,Jun Rao,2012-02-23 22:57:40+00:00,['22d80462b15e24fc63960254bdfd8be74ddc14ba'],43,89,132,167381,3,0,0.820512821,1,636
7e91c167430afcffd5b700de58bbc54b2149be00,0,Jun Rao,2012-02-25 23:08:02+00:00,['333966f50ea42ba41ff243d1ba5571a2fa8b9a60'],0,16,16,167397,1,0,1,1,636
caf310c2283731751926ccf8bd902df01dcb04f4,0,Jun Rao,2012-02-27 19:46:36+00:00,['7e91c167430afcffd5b700de58bbc54b2149be00'],16,22,38,167435,1,0.333333333,0,1,636
d8286aad107dbec34faae9e4e29c65bde20eb6f8,0,Jun Rao,2012-02-28 01:50:38+00:00,['caf310c2283731751926ccf8bd902df01dcb04f4'],2,44,46,167481,3,1,1,0.333333333,636
6c34cf2dcc5961703001ab484a1ca6e662eee362,0,Jun Rao,2012-02-29 03:22:14+00:00,['d8286aad107dbec34faae9e4e29c65bde20eb6f8'],6,21,27,167508,5,0,1,1,636
ccc464c19a80f9818145c70079e9966fed22d75c,0,Joe Stein,2012-03-01 02:47:03+00:00,['6c34cf2dcc5961703001ab484a1ca6e662eee362'],1,1,2,167510,1,0,1,0,636
9fd2d4ffdba4b45df7807c1a70ff17496b51afa8,1,Neha Narkhede,2012-03-01 21:15:26+00:00,['6e36047fae3338b425a63c0d1e4a5acb499e5207'],1760,1036,2796,170306,45,0.74137931,0.243842365,0,637
f8042d5b3932a0114c33cad6388eba9c41d77809,1,Joe Stein,2012-03-03 05:46:43+00:00,['9fd2d4ffdba4b45df7807c1a70ff17496b51afa8'],251,289,540,170846,20,0.196721311,1,0.163934426,637
0443e2dd737cada1fed3964dd1cb2b687944f9c6,0,Jun Rao,2012-03-06 02:21:54+00:00,['ccc464c19a80f9818145c70079e9966fed22d75c'],5,19,24,170870,2,0,1,1,637
88660999a87c5e8214a57439156ed62358af3509,1,Joe Stein,2012-03-06 17:45:17+00:00,['f8042d5b3932a0114c33cad6388eba9c41d77809'],0,50,50,170920,1,1,1,1,638
624a361e01431bf87ccda883fb9b1817d67cdbf7,0,Jun Rao,2012-03-07 17:51:21+00:00,['0443e2dd737cada1fed3964dd1cb2b687944f9c6'],3,3,6,170926,2,0,0,0,638
74af0deef17bfed19237367cdbee7027666add08,0,Jun Rao,2012-03-08 15:18:30+00:00,['624a361e01431bf87ccda883fb9b1817d67cdbf7'],3,9,12,170938,1,0.25,1,1,638
4dd7f95569d3af60c73484e7969080ac0d755085,1,Jun Rao,2012-03-14 01:35:46+00:00,['88660999a87c5e8214a57439156ed62358af3509'],296,378,674,171612,15,0.619047619,0.714285714,1,638
66d8073156403ce1a8f91b56f27beed93196ae04,0,Jun Rao,2012-03-14 22:58:57+00:00,['74af0deef17bfed19237367cdbee7027666add08'],49,49,98,171710,10,1,1,1,638
5e0e0b17fb5a9549fc9860c91384121def8ae695,0,Jun Rao,2012-03-15 00:39:42+00:00,['66d8073156403ce1a8f91b56f27beed93196ae04'],49,49,98,171808,10,0,0,0,638
7b39d7eed1449d993cdec6dca6babea6032dbbc3,0,Jun Rao,2012-03-21 00:25:09+00:00,['5e0e0b17fb5a9549fc9860c91384121def8ae695'],5,5,10,171818,1,,,,638
e180e68f94d1d50fb9563d273c03d255eb081998,0,Jun Rao,2012-03-21 00:38:14+00:00,['7b39d7eed1449d993cdec6dca6babea6032dbbc3'],4,0,4,171822,1,0,0,0,638
854fb29c26ed55926956e858b0465b85f80ef738,1,Neha Narkhede,2012-03-21 17:29:32+00:00,['4dd7f95569d3af60c73484e7969080ac0d755085'],202,712,914,172736,31,0.51984127,0.714285714,0.761904762,640
2bcc91134316a546322bf59a422bec1934613607,0,Neha Narkhede,2012-03-22 16:03:49+00:00,['e180e68f94d1d50fb9563d273c03d255eb081998'],5,14,19,172755,2,0,0,1,640
ba8fd9f1ee9fc47a1e62ee6f529f7cb272b3c7f3,0,Neha Narkhede,2012-03-22 16:59:11+00:00,['2bcc91134316a546322bf59a422bec1934613607'],2,6,8,172763,1,1,1,0,640
fedb9d6c19903651e5b27412374aad84994f1320,1,Neha Narkhede,2012-03-23 16:46:03+00:00,['854fb29c26ed55926956e858b0465b85f80ef738'],80,126,206,172969,10,1,1,0.441176471,641
a260bfacaee251b4f23236a71651cfb87ce3f6d7,1,Jun Rao,2012-03-26 17:12:30+00:00,['fedb9d6c19903651e5b27412374aad84994f1320'],237,338,575,173544,8,0.132743363,0.460176991,1,642
f8346239d492b22416d9c5d4639ebd5eafdbae92,0,Jun Rao,2012-04-06 16:59:44+00:00,['ba8fd9f1ee9fc47a1e62ee6f529f7cb272b3c7f3'],8,11,19,173563,1,0,0,1,642
d9441f0066604534a8226ce1809eaf68e5a4ada2,0,Jun Rao,2012-04-06 21:18:56+00:00,['f8346239d492b22416d9c5d4639ebd5eafdbae92'],10,40,50,173613,6,0.454545455,1,1,642
c0e190cdefabc7c59b11bbe0de843baec78efe3f,0,Jun Rao,2012-04-07 00:04:51+00:00,['d9441f0066604534a8226ce1809eaf68e5a4ada2'],937,1411,2348,175961,70,0,0.477477477,0.621621622,649
79a3b31f267921dedbe8b6ca6af648609bb11dc0,1,Neha Narkhede,2012-04-07 02:12:26+00:00,['a260bfacaee251b4f23236a71651cfb87ce3f6d7'],77,66,143,176104,18,0.5,1,1,649
d97c557202e7f20001d2597d09bcbf0bfc123fa9,0,Neha Narkhede,2012-04-08 02:00:19+00:00,['c0e190cdefabc7c59b11bbe0de843baec78efe3f'],18,32,50,176154,8,0,1,1,649
d73355017a66fbcdf0a6ad1bafbf3d60fa004b92,1,Neha Narkhede,2012-04-23 23:32:59+00:00,['79a3b31f267921dedbe8b6ca6af648609bb11dc0'],45,654,699,176853,15,0.465625,0.715625,0.809375,654
d6b1de35f6b9cd5370c7812790fea8e61618f461,0,Jun Rao,2012-04-25 02:24:47+00:00,['d97c557202e7f20001d2597d09bcbf0bfc123fa9'],15,84,99,176952,8,0,0.405405405,0.621621622,654
1bedde76c280181fe5114cd262389f599d8542fb,1,Edward Jay Kreps,2012-04-30 21:34:49+00:00,['d73355017a66fbcdf0a6ad1bafbf3d60fa004b92'],305,747,1052,178004,28,0.806818182,1,0.806818182,657
2a59ad76c657e4aad8ee6ca67078f49d2f6017c9,0,Neha Narkhede,2012-05-18 01:22:11+00:00,['d6b1de35f6b9cd5370c7812790fea8e61618f461'],0,1,1,178005,1,0,1,1,657
23b422bc446e351363d19d00397fc1b3c0e269fa,1,Jun Rao,2012-05-25 01:49:22+00:00,['1bedde76c280181fe5114cd262389f599d8542fb'],2,21,23,178028,2,1,1,1,658
904708fae892417f248b74130da14a165747abcc,1,Prashanth Menon,2012-05-28 13:45:51+00:00,['23b422bc446e351363d19d00397fc1b3c0e269fa'],109,228,337,178365,15,0,0.785714286,0.928571429,659
822963bb9dab9c948ecf850ab25b311e9d9fa7ae,1,Joe Stein,2012-05-31 01:51:23+00:00,['904708fae892417f248b74130da14a165747abcc'],1217,2458,3675,182040,107,0.119804401,0.415647922,0.904645477,669
045f4fdca4f8305a537d0e382f88aed3da0965a7,1,Neha Narkhede,2012-06-01 01:53:19+00:00,['822963bb9dab9c948ecf850ab25b311e9d9fa7ae'],370,1452,1822,183862,43,0.559254328,0.704394141,0.838881491,673
c4a913e3c4a8ce21a08a49ca72f090750aa9e7f0,0,Neha Narkhede,2012-06-01 01:54:41+00:00,['045f4fdca4f8305a537d0e382f88aed3da0965a7'],0,0,0,183862,0,,,,673
f99177766aff632831598a1e2e2c929a015b7c68,1,Jun Rao,2012-06-06 01:28:46+00:00,['c4a913e3c4a8ce21a08a49ca72f090750aa9e7f0'],311,823,1134,184996,30,0.896174863,1,0.967213115,680
7d3a782e50e878f7f4f948b5edbc440297097382,1,Jun Rao,2012-06-13 22:36:20+00:00,['f99177766aff632831598a1e2e2c929a015b7c68'],1,4,5,185001,1,0,0,0,680
83c82a3ecc734138ed561a69f18ca3ac02a41ddb,1,Jun Rao,2012-06-14 15:17:35+00:00,['7d3a782e50e878f7f4f948b5edbc440297097382'],7,471,478,185479,10,0.643109541,0.886925795,0.975265018,682
965edbbcd8149abe4d9ecd87dcf813fb13874e83,1,Jun Rao,2012-06-14 16:23:30+00:00,['83c82a3ecc734138ed561a69f18ca3ac02a41ddb'],0,988,988,186467,9,,,,691
ebcf7fc10d2a6a83545316d6f1526d5084c92b01,0,Joe Stein,2012-06-14 17:47:20+00:00,['965edbbcd8149abe4d9ecd87dcf813fb13874e83'],1,1,2,186469,1,,,,691
f8ce071f3fa0efdad555a82aba9e024e3a7f4f56,1,Joe Stein,2012-06-14 17:47:20+00:00,['2a59ad76c657e4aad8ee6ca67078f49d2f6017c9'],1,1,2,186471,1,,,,691
efdc57bc58c2812cc01e627b64eaace9a5f92cb4,1,Joe Stein,2012-06-17 15:32:29+00:00,['ebcf7fc10d2a6a83545316d6f1526d5084c92b01'],8,40,48,186519,4,0,0.346153846,1,691
eff68ce1d0ef59e27a49edea4759ad0cd4096b7a,1,Prashanth Menon,2012-06-18 01:17:44+00:00,['efdc57bc58c2812cc01e627b64eaace9a5f92cb4'],239,222,461,186980,10,1,0.03030303,0.090909091,691
16b600d4fd972be697af95398f22f23aa8ad2608,0,Jun Rao,2012-06-19 00:27:00+00:00,['f8ce071f3fa0efdad555a82aba9e024e3a7f4f56'],0,13,13,186993,3,1,1,1,691
1a8511684c9d6e3b8ec073036551b79441aa5280,1,Jun Rao,2012-06-19 00:32:18+00:00,['eff68ce1d0ef59e27a49edea4759ad0cd4096b7a'],0,13,13,187006,3,1,1,1,691
1af23bb2633c162659ab6fa99020307960f41465,0,Joe Stein,2012-06-20 15:04:04+00:00,['16b600d4fd972be697af95398f22f23aa8ad2608'],0,6,6,187012,3,,,,691
a16448b71e00c19749cd98d8deb37ad7977a3202,1,Joe Stein,2012-06-20 15:04:53+00:00,['1a8511684c9d6e3b8ec073036551b79441aa5280'],0,6,6,187018,3,,,,691
0efd609fe7ee9b8bbcac1cb7ff681a95aadace4b,0,Jun Rao,2012-06-22 17:31:38+00:00,['a16448b71e00c19749cd98d8deb37ad7977a3202'],1,1,2,187020,1,,,,691
505cf9d618c24f532e7b800d8b34a20a40c45feb,1,Jun Rao,2012-06-23 07:14:24+00:00,['0efd609fe7ee9b8bbcac1cb7ff681a95aadace4b'],130,359,489,187509,11,0.80620155,0.550387597,0.403100775,694
cb5be0aff10423eca34fb43d107c65032b158b93,1,Jun Rao,2012-06-26 16:23:14+00:00,['505cf9d618c24f532e7b800d8b34a20a40c45feb'],4,17,21,187530,4,0.071428571,0.071428571,1,694
e7efee02c10e2def27d6b301e2f926202dabb9ce,1,Joel Jacob Koshy,2012-06-29 22:05:57+00:00,['cb5be0aff10423eca34fb43d107c65032b158b93'],131,401,532,188062,27,0.293650794,0.150793651,0.992063492,695
489b09c120992d624fe95ed970b80ec8157131a9,0,Joel Jacob Koshy,2012-07-06 20:44:51+00:00,['1af23bb2633c162659ab6fa99020307960f41465'],468,694,1162,189224,14,,,,696
d79919d82748429589da9907a560e5a5071a4229,1,Jun Rao,2012-07-10 18:05:54+00:00,['e7efee02c10e2def27d6b301e2f926202dabb9ce'],539,548,1087,190311,13,,,,696
3bade0b5c86c1313f52d4488964d9773344542d9,1,Jun Rao,2012-07-10 18:08:07+00:00,['d79919d82748429589da9907a560e5a5071a4229'],38,113,151,190462,4,1,1,1,696
89661d3b678974fe5574fb3e6b85f7cd2e5b2c2c,1,Jun Rao,2012-07-11 16:16:26+00:00,['3bade0b5c86c1313f52d4488964d9773344542d9'],320,324,644,191106,14,1,1,0,698
0d0f1fcfb3598c6d4b6304bd49e3545dbddf9a4b,1,Edward Jay Kreps,2012-07-18 17:16:28+00:00,['89661d3b678974fe5574fb3e6b85f7cd2e5b2c2c'],8,8,16,191122,1,0,1,1,698
9e44db6af0a91a6071a046eb8b94f042ca223ec9,1,Neha Narkhede,2012-07-19 19:51:12+00:00,['0d0f1fcfb3598c6d4b6304bd49e3545dbddf9a4b'],29,80,109,191231,9,0.177777778,0.711111111,0.977777778,698
16b0f44559de969f1fd4387dceda881e6aabdc1c,1,Edward Jay Kreps,2012-07-19 21:02:15+00:00,['9e44db6af0a91a6071a046eb8b94f042ca223ec9'],87,27,114,191345,4,0.020833333,0,0,698
c0e6ca95bffdf6cebc74036bea04695721542ebf,0,Neha Narkhede,2012-07-20 22:36:19+00:00,['16b0f44559de969f1fd4387dceda881e6aabdc1c'],6,0,6,191351,1,,,,698
842da7bfcddb322266ee27bab279c6f4e05b79cb,1,Neha Narkhede,2012-07-24 18:13:01+00:00,['c0e6ca95bffdf6cebc74036bea04695721542ebf'],516,1005,1521,192872,70,0,0.258064516,0.919354839,701
b49de724f12549354836c34aea6f2e0640994e07,1,Neha Narkhede,2012-07-25 23:42:07+00:00,['842da7bfcddb322266ee27bab279c6f4e05b79cb'],297,578,875,193747,20,0,0.858757062,0.847457627,703
2e073db8dc3ce51c993f2174ab8c9c47716f3e3d,1,Jun Rao,2012-07-26 16:59:06+00:00,['b49de724f12549354836c34aea6f2e0640994e07'],2,2,4,193751,1,,,,703
86de21a71c1d5bafeff04945088fb3e67ff0b800,0,Jun Rao,2012-07-26 23:56:59+00:00,['2e073db8dc3ce51c993f2174ab8c9c47716f3e3d'],6,10,16,193767,1,0,0,0,703
19fbdb30998f6dead6cc788a41617c55bcb20d8e,1,Jun Rao,2012-07-27 00:16:08+00:00,['86de21a71c1d5bafeff04945088fb3e67ff0b800'],3,38,41,193808,4,0.214285714,0,1,703
2a9d42c243397142f80d3f0f96c8d7a6b74d1b02,0,Jun Rao,2012-07-31 15:33:29+00:00,['19fbdb30998f6dead6cc788a41617c55bcb20d8e'],1729,1334,3063,196871,54,0,0,0.220588235,704
c21a7979c18c93336bd1dda5f82627c9ae537b62,1,Jun Rao,2012-07-31 22:50:59+00:00,['2a9d42c243397142f80d3f0f96c8d7a6b74d1b02'],1334,1729,3063,199934,54,1,1,0.779411765,709
96ed9af6201e7ce7bc3cf44c5d5153ffbb95f7fd,1,Neha Narkhede,2012-07-31 23:27:11+00:00,['c21a7979c18c93336bd1dda5f82627c9ae537b62'],125,73,198,200132,22,0.838709677,0.322580645,0,709
0223fd827003b94babdf6cb6624d0f97e936d00a,1,Jun Rao,2012-08-01 16:13:59+00:00,['96ed9af6201e7ce7bc3cf44c5d5153ffbb95f7fd'],1715,1327,3042,203174,53,0,0,0.262295082,710
8ceec6eff0769198a454e2163e7597aab6c3e7ab,1,Neha Narkhede,2012-08-06 17:27:05+00:00,['0223fd827003b94babdf6cb6624d0f97e936d00a'],21,123,144,203318,1,,,,710
b995133387881222cf3947f5b333a623a6d8407b,1,Neha Narkhede,2012-08-08 20:17:31+00:00,['8ceec6eff0769198a454e2163e7597aab6c3e7ab'],12,19,31,203349,3,0,0,1,710
ee855fe1aa4a4f549c9d91c81ee53f448828d81a,1,Jun Rao,2012-08-14 04:17:27+00:00,['b995133387881222cf3947f5b333a623a6d8407b'],389,344,733,204082,34,0.866666667,0,1,710
a8790784df26c7ab13ac82b521812c06fdeb718b,0,Edward Jay Kreps,2012-08-14 19:47:54+00:00,['ee855fe1aa4a4f549c9d91c81ee53f448828d81a'],4,4,8,204090,2,,,,710
d48253181007d908e2c2099b912b64179a0ad959,1,Edward Jay Kreps,2012-08-14 19:56:36+00:00,['a8790784df26c7ab13ac82b521812c06fdeb718b'],3,3,6,204096,3,,,,710
623e2b7e53f052e9d2db2ab406867e8029ff8852,0,Edward Jay Kreps,2012-08-14 19:59:11+00:00,['d48253181007d908e2c2099b912b64179a0ad959'],1,1,2,204098,1,,,,710
9eb99fde9a5154e1cb8389a8ee2ceead2b995814,1,Edward Jay Kreps,2012-08-14 20:35:48+00:00,['623e2b7e53f052e9d2db2ab406867e8029ff8852'],1,22,23,204121,1,0.5,0,1,710
0fe89f7a493ec8879b31fafa560fd59f5df4a910,1,Jun Rao,2012-08-15 15:07:41+00:00,['9eb99fde9a5154e1cb8389a8ee2ceead2b995814'],38,44,82,204203,2,0,1,1,710
190bd3ff71d85b8e3831e1dbedcce3098f50960f,1,Joel Jacob Koshy,2012-08-16 21:26:40+00:00,['0fe89f7a493ec8879b31fafa560fd59f5df4a910'],158,778,936,205139,16,0.595505618,0.865168539,0.91011236,716
60735b7ad6ef15f25ae9e432c2fc566bec535e31,0,Jun Rao,2012-08-17 21:09:15+00:00,['190bd3ff71d85b8e3831e1dbedcce3098f50960f'],53,39,92,205231,3,1,0,0.285714286,716
12a3ccafa1cbc333539b98d83d7d6d572700f05b,1,Jun Rao,2012-08-17 23:09:05+00:00,['60735b7ad6ef15f25ae9e432c2fc566bec535e31'],28,32,60,205291,6,1,1,1,716
be521175dcf383ad97bc4cbcc642f25666dc0336,0,Jun Rao,2012-08-18 05:26:59+00:00,['12a3ccafa1cbc333539b98d83d7d6d572700f05b'],5,0,5,205296,1,1,0,0,716
27aaebc874d0b0c0fc9380ed71dca56e1a12e9f1,1,Jun Rao,2012-08-21 01:10:00+00:00,['be521175dcf383ad97bc4cbcc642f25666dc0336'],186,190,376,205672,13,0.777777778,1,1,717
7baccc6c331467335954d32558c68511223d8c7c,1,Jun Rao,2012-08-21 01:52:50+00:00,['27aaebc874d0b0c0fc9380ed71dca56e1a12e9f1'],100,9,109,205781,3,0,0,0,717
663d25443359763b2d0fb8adcbdd96cc82dcbda7,1,Jun Rao,2012-08-21 17:17:29+00:00,['7baccc6c331467335954d32558c68511223d8c7c'],906,610,1516,207297,30,0.873469388,0.595918367,0,717
5861046d09e82b2bd187177c227bdd1be792d60b,1,Neha Narkhede,2012-08-22 17:16:26+00:00,['663d25443359763b2d0fb8adcbdd96cc82dcbda7'],0,2073,2073,209370,21,0.298540965,0.607182941,0.736251403,737
0d6a4dff097d5e46d659db7f7ef922c91ede24e0,1,Jun Rao,2012-08-23 17:15:17+00:00,['5861046d09e82b2bd187177c227bdd1be792d60b'],61,32,93,209463,4,1,1,1,737
9a84e408c1dff1f32ea030190987501701a1903f,0,Jun Rao,2012-08-24 14:32:10+00:00,['489b09c120992d624fe95ed970b80ec8157131a9'],14,54,68,209531,5,0.071428571,0.964285714,1,737
21326cb9f29c3514b9533a741b69b90ef6d45038,0,Jun Rao,2012-08-24 20:38:27+00:00,['9a84e408c1dff1f32ea030190987501701a1903f'],53,162,215,209746,8,0.666666667,0.985507246,1,737
93e9dbd0268ae04790c75bdd1fb5c521ae331ee0,1,Jun Rao,2012-08-25 00:06:33+00:00,['0d6a4dff097d5e46d659db7f7ef922c91ede24e0'],55,58,113,209859,2,1,0,1,737
17283a377dc9b2026b3eecdf1d9a32908b3bfc90,1,Jun Rao,2012-08-25 00:24:49+00:00,['93e9dbd0268ae04790c75bdd1fb5c521ae331ee0'],149,233,382,210241,7,0,0.692307692,1,738
2756b424a73785be49a4bcfc2d5dae704e64d2d5,1,Jun Rao,2012-08-25 00:34:27+00:00,['17283a377dc9b2026b3eecdf1d9a32908b3bfc90'],46,158,204,210445,8,0.632352941,0.985294118,1,738
31b9d124d609b1494cd6f79cdc2a022c7fae8a4f,1,Jun Rao,2012-08-25 00:46:08+00:00,['2756b424a73785be49a4bcfc2d5dae704e64d2d5'],1,11,12,210457,3,0,0.833333333,0.833333333,738
749665e33672b0e96869af787d8a4c78fa681732,1,Jun Rao,2012-08-25 01:04:59+00:00,['21326cb9f29c3514b9533a741b69b90ef6d45038'],8,106,114,210571,5,1,1,1,739
2f34eda87eaea7b65aa5ad091cafa4c5d0f1853e,1,Jun Rao,2012-08-25 01:14:41+00:00,['31b9d124d609b1494cd6f79cdc2a022c7fae8a4f'],10,106,116,210687,5,1,1,1,740
f2c901bcd422807f5d172a3a2f8aa18ee1b7c701,0,Jun Rao,2012-08-25 05:16:27+00:00,['749665e33672b0e96869af787d8a4c78fa681732'],12,40,52,210739,1,1,1,1,740
a74cdb61b16dc0aabcd51e7f50d8d5422445aa9a,1,Jun Rao,2012-08-25 05:28:33+00:00,['2f34eda87eaea7b65aa5ad091cafa4c5d0f1853e'],12,40,52,210791,1,1,1,1,740
a32d37f6d1b0576c2851feb7d7850b89d6e79dfd,1,Jun Rao,2012-08-25 06:23:18+00:00,['a74cdb61b16dc0aabcd51e7f50d8d5422445aa9a'],295,312,607,211398,17,1,1,1,741
e72ff0ee2aef90f532249c7b29d184091d69b4c4,1,Jun Rao,2012-08-28 18:42:00+00:00,['a32d37f6d1b0576c2851feb7d7850b89d6e79dfd'],10,14,24,211422,1,1,1,0,741
695a8d43eb2a58920f3f00ae4dbce30b10adb42c,0,Jun Rao,2012-08-29 14:52:39+00:00,['f2c901bcd422807f5d172a3a2f8aa18ee1b7c701'],4,9,13,211435,2,0,1,1,741
d4f3eff171f97c45c977191999f1f03f7b343fd3,1,Neha Narkhede,2012-08-29 18:07:58+00:00,['e72ff0ee2aef90f532249c7b29d184091d69b4c4'],1029,848,1877,213312,28,0.562068966,0.762068966,0.593103448,744
4cea1de21a8f1638e9908560de08072e5782ff68,1,Neha Narkhede,2012-08-30 23:47:55+00:00,['d4f3eff171f97c45c977191999f1f03f7b343fd3'],120,443,563,213875,9,0.225641026,0.235897436,0.78974359,744
9e54dadf4bffbd0401d4b92fb82b1044c87cccc8,0,Jun Rao,2012-09-07 03:48:50+00:00,['695a8d43eb2a58920f3f00ae4dbce30b10adb42c'],4,73,77,213952,4,0.3,0.3,1,745
259b710694a15a5554e895d41508dfc7241181c0,1,Jun Rao,2012-09-07 03:54:10+00:00,['4cea1de21a8f1638e9908560de08072e5782ff68'],2,2,4,213956,2,,,,745
50792c8765458c93e4d3632a0b76be4ef4354a60,1,Jun Rao,2012-09-07 03:57:32+00:00,['259b710694a15a5554e895d41508dfc7241181c0'],3,5,8,213964,1,0,0,1,745
87fa96e29186a9b874caed820cf25d3d6f91b9f3,1,Prashanth Menon,2012-09-10 13:28:44+00:00,['50792c8765458c93e4d3632a0b76be4ef4354a60'],30,260,290,214254,3,0.055555556,0.761904762,0.761904762,746
22e4341ba9f7744314ae0363529333a276bd325d,1,Neha Narkhede,2012-09-10 17:09:52+00:00,['87fa96e29186a9b874caed820cf25d3d6f91b9f3'],621,731,1352,215606,19,1,0,0.103448276,749
ba58c9a7040e778b6c8cf9dc59d97858c2617afe,1,Jun Rao,2012-09-10 20:47:23+00:00,['22e4341ba9f7744314ae0363529333a276bd325d'],174,85,259,215865,15,0.537037037,1,0.148148148,749
082d9d3b5a9be63740e4f4f033589f9ebb71e7be,0,Jun Rao,2012-09-11 16:07:35+00:00,['ba58c9a7040e778b6c8cf9dc59d97858c2617afe'],0,0,0,215865,1,,,,749
ea14ae8b7fe12b0c1dbb05c89d3d3eb4d7c882f9,1,Jun Rao,2012-09-12 01:30:09+00:00,['082d9d3b5a9be63740e4f4f033589f9ebb71e7be'],63,86,149,216014,10,0,0.375,0.5,749
de927e29482f066cc919817e260356ca9248d42f,1,Jun Rao,2012-09-12 02:14:37+00:00,['ea14ae8b7fe12b0c1dbb05c89d3d3eb4d7c882f9'],10,121,131,216145,8,0.285714286,0.285714286,0.952380952,751
2bc65dab67933e9f9cdade59bd0e45ff99afd338,1,Jun Rao,2012-09-13 04:27:13+00:00,['de927e29482f066cc919817e260356ca9248d42f'],997,631,1628,217773,43,0.041666667,0.385416667,0.40625,751
e42c8d5f4e54d3661cb15c7231f9ad306d807790,0,Jun Rao,2012-09-14 01:29:07+00:00,['2bc65dab67933e9f9cdade59bd0e45ff99afd338'],48,1,49,217822,6,1,0,0,751
fb0f176131b1d075e08cc110bbb9b58ce10dccf9,1,Neha Narkhede,2012-09-14 17:20:04+00:00,['e42c8d5f4e54d3661cb15c7231f9ad306d807790'],117,179,296,218118,5,0,1,0,751
c8f75870721ac99286272d1b85d09ce41fad444c,1,Jun Rao,2012-09-17 14:52:18+00:00,['fb0f176131b1d075e08cc110bbb9b58ce10dccf9'],98,149,247,218365,5,0,0.85106383,1,751
b688c3ba045df340bc32caa40ba1909eddbcbec5,1,Joel Jacob Koshy,2012-09-17 20:15:59+00:00,['c8f75870721ac99286272d1b85d09ce41fad444c'],829,759,1588,219953,31,0.033333333,0.8,0.511111111,752
d37eb7fdd87ce16afb1cf94e1236301663833247,0,Jun Rao,2012-09-18 05:04:00+00:00,['9e54dadf4bffbd0401d4b92fb82b1044c87cccc8'],7,23,30,219983,2,1,1,1,752
13e606924f7d234a548a47232bc1413e46d54539,0,Jun Rao,2012-09-18 17:18:09+00:00,['b688c3ba045df340bc32caa40ba1909eddbcbec5'],1,1,2,219985,1,,,,752
3889a3b34fd358ce512efe8c44c44befc19e3273,1,Neha Narkhede,2012-09-18 17:21:15+00:00,['13e606924f7d234a548a47232bc1413e46d54539'],655,1337,1992,221977,20,0.951923077,0.942307692,0.471153846,759
0f06136aa87393f3c3ac8be3ab9e0c601a13fd63,1,Jun Rao,2012-09-19 22:15:52+00:00,['3889a3b34fd358ce512efe8c44c44befc19e3273'],265,223,488,222465,22,0.653465347,0.435643564,0,762
081f0d2353ffb86db3aa3a5080e00b0b0aee7c4a,1,Jun Rao,2012-09-24 16:08:44+00:00,['0f06136aa87393f3c3ac8be3ab9e0c601a13fd63'],2,364,366,222831,2,0.243654822,0.395939086,0.908629442,763
b5dc73219e2e4b02b0d7f49e4059a8308f899995,0,Jun Rao,2012-09-25 19:02:30+00:00,['081f0d2353ffb86db3aa3a5080e00b0b0aee7c4a'],2,2,4,222835,2,,,,763
e9d07d72fa3bd29d61b4995abff07ea287853f6b,0,Joe Stein,2012-09-27 00:21:45+00:00,['d37eb7fdd87ce16afb1cf94e1236301663833247'],26121,0,26121,248956,239,0.510816393,0.145885422,0.098054136,763
9a4ef48ef145e2fecf3b6f4154e5086c5e00e848,0,Joe Stein,2012-09-27 00:22:12+00:00,['b5dc73219e2e4b02b0d7f49e4059a8308f899995'],26121,0,26121,275077,239,0.510816393,0.145885422,0.098054136,763
2a62bdb040352f838fd0afceb9983c35a6a9dafe,0,Joe Stein,2012-09-27 00:24:56+00:00,['e9d07d72fa3bd29d61b4995abff07ea287853f6b'],35,1,36,275113,2,,,,763
85d5edfa9c8c519ceb4ec9c375645c38616e2bbe,0,Joe Stein,2012-09-27 00:25:23+00:00,['9a4ef48ef145e2fecf3b6f4154e5086c5e00e848'],35,1,36,275149,2,,,,763
1cf88bc6c5ede994f8d7ee46fffedc146a9d7d68,1,Jun Rao,2012-09-27 01:19:29+00:00,['85d5edfa9c8c519ceb4ec9c375645c38616e2bbe'],77,100,177,275326,6,0,1,0.947368421,763
3310531d8752c9d19bf3083f9b0c062c2578ba52,1,Jun Rao,2012-09-27 01:33:54+00:00,['1cf88bc6c5ede994f8d7ee46fffedc146a9d7d68'],45,35,80,275406,6,0.5,0,1,763
14b42f795641e13f9703286a527015cbf99a7788,1,Joel Jacob Koshy,2012-09-27 19:20:08+00:00,['3310531d8752c9d19bf3083f9b0c062c2578ba52'],177,477,654,276060,25,0,0.663865546,1,765
80d571049f60414537d385d1c688a6fb7f724740,0,Joe Stein,2012-09-29 01:11:07+00:00,['2a62bdb040352f838fd0afceb9983c35a6a9dafe'],0,29,29,276089,2,,,,765
77b511f696f7fa75777a003ade5065fab128bf38,0,Joe Stein,2012-09-29 01:11:36+00:00,['14b42f795641e13f9703286a527015cbf99a7788'],0,29,29,276118,2,,,,765
9623ae4de3e4c65ab2e90798843769795b8a00c6,1,Jun Rao,2012-09-29 18:17:39+00:00,['77b511f696f7fa75777a003ade5065fab128bf38'],18,24,42,276160,11,0.6,0.2,1,765
db78c35fc051be561dadbf07dac9cedd659662a2,0,Jun Rao,2012-10-02 15:47:10+00:00,['9623ae4de3e4c65ab2e90798843769795b8a00c6'],10,7,17,276177,2,1,0,0,765
db4e02f2630d157ad021751aa47d0251bdac4d0e,1,Joel Jacob Koshy,2012-10-03 19:50:13+00:00,['db78c35fc051be561dadbf07dac9cedd659662a2'],8,38,46,276223,3,1,1,1,765
3bb1c16691877a86754509d2170e40ce5804b78f,1,Jun Rao,2012-10-04 03:46:44+00:00,['db4e02f2630d157ad021751aa47d0251bdac4d0e'],13,32,45,276268,3,1,1,,766
c42726cdaf213544c965162925dd9bda75a62d91,0,Jun Rao,2012-10-04 17:29:33+00:00,['3bb1c16691877a86754509d2170e40ce5804b78f'],3,4,7,276275,1,1,1,1,766
3f1fbb1d077a63d49f2d0dbdca5eb95af1d987f1,1,Joe Stein,2012-10-05 15:27:05+00:00,['c42726cdaf213544c965162925dd9bda75a62d91'],42,74,116,276391,12,1,1,1,766
f64fd3dcbaace1dba7bbd72398bb3e7d28b41d61,1,Edward Jay Kreps,2012-10-08 19:13:24+00:00,['3f1fbb1d077a63d49f2d0dbdca5eb95af1d987f1'],1772,2374,4146,280537,69,1,1,1,774
c85c01b6e4c5fc5bf0894522210617710131751e,1,Joel Jacob Koshy,2012-10-08 23:18:48+00:00,['f64fd3dcbaace1dba7bbd72398bb3e7d28b41d61'],1,2,3,280540,1,,,,774
7294dd3333238423cd665f3103221e24182173ec,0,Joel Jacob Koshy,2012-10-08 23:18:48+00:00,['80d571049f60414537d385d1c688a6fb7f724740'],1,2,3,280543,1,,,,774
eed59835968603c6dd10a124e8b119e7cb66be12,1,Jun Rao,2012-10-09 05:16:26+00:00,['c85c01b6e4c5fc5bf0894522210617710131751e'],1,1,2,280545,1,,,,774
3819adc48631d6841032c0d8d08b74ea1912daf2,0,Jun Rao,2012-10-09 15:56:52+00:00,['7294dd3333238423cd665f3103221e24182173ec'],2,2,4,280549,1,,,,774
452be9080ea00327834386014657c01f057aaaca,1,Edward Jay Kreps,2012-10-09 16:40:56+00:00,['eed59835968603c6dd10a124e8b119e7cb66be12'],131,98,229,280778,10,0,0,0.409090909,774
d5df29b84f65fbcfab7b3289ec761eebbf6174f8,1,Jun Rao,2012-10-09 17:08:42+00:00,['452be9080ea00327834386014657c01f057aaaca'],12,3,15,280793,1,0,0,0,774
3a525e0bfa4cd5b3dd963bb95617e3431f6040fd,1,Edward Jay Kreps,2012-10-09 18:37:51+00:00,['d5df29b84f65fbcfab7b3289ec761eebbf6174f8'],0,1,1,280794,1,1,1,1,774
542ac86313916b7903a50c1d4f2a4ce5ee2d4ebd,1,Joel Jacob Koshy,2012-10-09 21:28:20+00:00,['3a525e0bfa4cd5b3dd963bb95617e3431f6040fd'],21,53,74,280868,15,0,0,0,776
2f41be0916e0a15ed19d639528e3e46e0b175034,0,Joel Jacob Koshy,2012-10-10 00:06:28+00:00,['542ac86313916b7903a50c1d4f2a4ce5ee2d4ebd'],20,18,38,280906,1,0,0,0,776
dd21b35120119dc35da7e800bfd50dad3dd2f44b,0,Joel Jacob Koshy,2012-10-10 00:06:28+00:00,['3819adc48631d6841032c0d8d08b74ea1912daf2'],21,19,40,280946,1,0,0,0,776
5a33bfa9d42b1158273ec24ac9633bd149162488,1,Edward Jay Kreps,2012-10-10 04:24:27+00:00,['2f41be0916e0a15ed19d639528e3e46e0b175034'],78,76,154,281100,11,1,1,0,776
a975113c0eb038d8ffdb1e4286b367bcec3a66cc,0,Jun Rao,2012-10-10 15:46:42+00:00,['5a33bfa9d42b1158273ec24ac9633bd149162488'],12,1,13,281113,1,,,,776
6ccdc40ae8767138be01f7dab5db1ece771f7c99,0,Jun Rao,2012-10-10 16:25:42+00:00,['a975113c0eb038d8ffdb1e4286b367bcec3a66cc'],89,116,205,281318,12,0.681818182,0.681818182,0.318181818,776
3c335bfbdc2720863a5fe18c6aa27dea0528b719,0,Jun Rao,2012-10-10 16:33:42+00:00,['6ccdc40ae8767138be01f7dab5db1ece771f7c99'],1,2,3,281321,1,0,0,1,776
1b4d3c3061d030ce5ebf67c15803fff7f9bca4ac,1,Neha Narkhede,2012-10-10 16:56:57+00:00,['3c335bfbdc2720863a5fe18c6aa27dea0528b719'],413,5536,5949,287270,71,0.064327485,0.033625731,0.600877193,836
cdc6ca2c7bd691b194f631942e14586284e8d655,0,Jun Rao,2012-10-10 17:03:11+00:00,['1b4d3c3061d030ce5ebf67c15803fff7f9bca4ac'],0,0,0,287270,1,,,,836
01a8b8d12377eae66a1924d2e26ed4e94d3f52bc,1,Neha Narkhede,2012-10-10 17:32:10+00:00,['cdc6ca2c7bd691b194f631942e14586284e8d655'],116,89,205,287475,12,0.318181818,0.318181818,0.681818182,836
6d0042b4f4125b3731d3b85a0e741f1dde1413fe,1,Neha Narkhede,2012-10-10 18:03:07+00:00,['01a8b8d12377eae66a1924d2e26ed4e94d3f52bc'],400,1411,1811,289286,52,0.482614743,0.739916551,0.635605007,842
a1698e2b70341cae20c53fb6b2e890df34b29a3e,1,Neha Narkhede,2012-10-10 18:42:57+00:00,['6d0042b4f4125b3731d3b85a0e741f1dde1413fe'],1411,400,1811,291097,52,0.517385257,0.260083449,0.364394993,842
23d7620442df299f43d147a2ad924b2759f7efbd,1,Neha Narkhede,2012-10-10 21:27:11+00:00,['a1698e2b70341cae20c53fb6b2e890df34b29a3e'],217,821,1038,292135,15,0.622641509,0.891509434,0.66745283,842
93fdcfa0e2a26a7fa68fd882564903ca5d9710fd,1,Neha Narkhede,2012-10-10 21:43:44+00:00,['23d7620442df299f43d147a2ad924b2759f7efbd'],0,415,415,292550,6,0.085365854,0.382113821,0.544715447,848
aaa5d14e39d1b784facf5048b99a097ce45cdc8a,1,Edward Jay Kreps,2012-10-11 16:06:50+00:00,['93fdcfa0e2a26a7fa68fd882564903ca5d9710fd'],13,19,32,292582,7,1,1,1,848
432423518310a5ed9e8f6fbcf238767b25d63f35,1,Edward Jay Kreps,2012-10-11 17:40:00+00:00,['aaa5d14e39d1b784facf5048b99a097ce45cdc8a'],39,112,151,292733,4,0,0.511111111,1,848
eb06b93f97808a7071df43621bd09a4f168864f8,1,Neha Narkhede,2012-10-11 23:30:23+00:00,['432423518310a5ed9e8f6fbcf238767b25d63f35'],90,129,219,292952,13,0.533333333,0.566666667,0.4,848
97d434513fe949005ae87d7c0fb3912708f3f728,0,Edward Jay Kreps,2012-10-12 00:15:26+00:00,['eb06b93f97808a7071df43621bd09a4f168864f8'],1,1,2,292954,1,,,,848
dd44ec672a95a414972747a23c76cbe74efb37ea,1,Neha Narkhede,2012-10-12 02:56:28+00:00,['97d434513fe949005ae87d7c0fb3912708f3f728'],378,382,760,293714,17,0.325,0,0.775,848
3629f6f882b354265489d4b2b7c80975bb9134d7,0,Neha Narkhede,2012-10-12 04:48:33+00:00,['dd44ec672a95a414972747a23c76cbe74efb37ea'],1,1,2,293716,1,,,,848
2b13581711ec506e87a93f0c3dc0ec43fb66707f,0,Jun Rao,2012-10-12 15:50:10+00:00,['3629f6f882b354265489d4b2b7c80975bb9134d7'],0,0,0,293716,2,,,,848
c0fdcd305c8487610b7bdb2ac080b4a1055534f3,0,Jun Rao,2012-10-12 20:28:14+00:00,['2b13581711ec506e87a93f0c3dc0ec43fb66707f'],0,2,2,293718,1,0,0,1,848
669ae397f8846d8ddc5af350b44bd7c0e442d3aa,1,Neha Narkhede,2012-10-13 00:21:45+00:00,['c0fdcd305c8487610b7bdb2ac080b4a1055534f3'],137,130,267,293985,13,1,0,0,848
3015d0a447a72fd571e71123bae0e541c46a1830,1,Neha Narkhede,2012-10-13 00:39:41+00:00,['669ae397f8846d8ddc5af350b44bd7c0e442d3aa'],284,559,843,294828,13,0.553763441,1,1,850
d1a22b2e3b59c2cf00adabd75d29ddd53938bacb,1,Edward Jay Kreps,2012-10-13 03:35:02+00:00,['3015d0a447a72fd571e71123bae0e541c46a1830'],549,570,1119,295947,57,0.012820513,0,0.128205128,854
98f64070891a34e3a8b3f0483a7f5397b8a6933b,1,Neha Narkhede,2012-10-16 17:30:46+00:00,['d1a22b2e3b59c2cf00adabd75d29ddd53938bacb'],55,63,118,296065,10,1,0.5,0,854
e35854062f7dd48714ef756657321020d7351a5c,1,Jun Rao,2012-10-19 00:09:32+00:00,['98f64070891a34e3a8b3f0483a7f5397b8a6933b'],27,37,64,296129,6,0.666666667,0.833333333,0.666666667,854
1b7b43c6e1387baea50fb7c1225411342db5b62b,1,Neha Narkhede,2012-10-23 01:26:08+00:00,['e35854062f7dd48714ef756657321020d7351a5c'],126,216,342,296471,48,0.033898305,0,0.491525424,855
2c66f5b701bff82cca8dcdb759194557e412719a,1,Jun Rao,2012-10-23 17:25:02+00:00,['1b7b43c6e1387baea50fb7c1225411342db5b62b'],24,25,49,296520,1,0,0,1,855
3deb6cd4208351fa6831331da5b60e8e2ffc97c6,1,Jun Rao,2012-10-24 14:19:18+00:00,['2c66f5b701bff82cca8dcdb759194557e412719a'],8,15,23,296543,2,0.125,0.375,0.625,855
23bce10e779a8be03a3f1883e60c9a5e85cf6fe0,1,Jun Rao,2012-10-24 16:19:26+00:00,['3deb6cd4208351fa6831331da5b60e8e2ffc97c6'],50,48,98,296641,15,,,,855
68d8f59045defe4da5e10d2fe4351ba2247d433c,0,Jun Rao,2012-10-24 16:46:32+00:00,['23bce10e779a8be03a3f1883e60c9a5e85cf6fe0'],37,3,40,296681,4,1,1,0,855
0d9f7ffe4d6d0eb571a3699176eb765c2e77cf47,1,Jun Rao,2012-10-24 16:57:56+00:00,['68d8f59045defe4da5e10d2fe4351ba2247d433c'],0,180,180,296861,6,,,,861
adebb7d78a52fc7c5cca1e2368c7e54d64f6a626,1,Jun Rao,2012-10-24 20:56:16+00:00,['0d9f7ffe4d6d0eb571a3699176eb765c2e77cf47'],588,4321,4909,301770,99,0.002617801,0.09947644,0.764397906,908
4ef91667692101cec0e82bfb9f0d3c14cd915ef0,0,Jun Rao,2012-10-24 23:00:25+00:00,['adebb7d78a52fc7c5cca1e2368c7e54d64f6a626'],1,1,2,301772,1,,,,908
9eb9e510118d1a69a3ab9ceac2acee6ab08099d6,1,Jun Rao,2012-10-25 18:15:41+00:00,['4ef91667692101cec0e82bfb9f0d3c14cd915ef0'],4,9,13,301785,1,0,1,1,908
947ad072af00cb16b818836041be1d48e1e142f4,1,Joel Jacob Koshy,2012-10-26 05:23:55+00:00,['9eb9e510118d1a69a3ab9ceac2acee6ab08099d6'],101,539,640,302425,15,0.02640264,0.554455446,0.676567657,909
4f529c74445804a85d8eabfb353727b032094589,1,Jun Rao,2012-10-27 01:18:27+00:00,['947ad072af00cb16b818836041be1d48e1e142f4'],1,1,2,302427,1,,,,909
743ac37382113f526d706a7cb65340d1f8880897,1,Jun Rao,2012-10-29 22:09:43+00:00,['4f529c74445804a85d8eabfb353727b032094589'],188,151,339,302766,10,1,1,0,909
ddabfa7da5580fc633a184ba6a031a93863d5415,1,Jun Rao,2012-10-30 01:28:01+00:00,['743ac37382113f526d706a7cb65340d1f8880897'],70,83,153,302919,9,0,1,0.846153846,909
4d7c0b7a51cea25b3d42dfe588d771b750e0a8b1,1,Jun Rao,2012-10-30 01:36:44+00:00,['ddabfa7da5580fc633a184ba6a031a93863d5415'],1,11,12,302931,1,0.833333333,1,1,909
414e9faf9badd67bdfd4f0d055a771a41775165e,1,Edward Jay Kreps,2012-10-30 20:18:45+00:00,['4d7c0b7a51cea25b3d42dfe588d771b750e0a8b1'],27,58,85,303016,3,0,1,1,909
6d86e43f0a44f3ba0d4188a7b44c83e0ed351927,0,Jun Rao,2012-10-31 15:21:11+00:00,['414e9faf9badd67bdfd4f0d055a771a41775165e'],81,96,177,303193,69,0,0,0,909
1828b1852cd745ae3ed5847fef55fdc53890ffdf,1,Jun Rao,2012-10-31 15:25:43+00:00,['6d86e43f0a44f3ba0d4188a7b44c83e0ed351927'],4,38,42,303235,2,,,,909
3adf92151a2f794559d9ef9961bd04b7ba6af1fd,1,Jun Rao,2012-11-02 02:07:03+00:00,['1828b1852cd745ae3ed5847fef55fdc53890ffdf'],33,86,119,303354,4,0,0,1,909
75fc5eab35aa33cffd9c09a2070dfe287db0ef4e,1,Edward Jay Kreps,2012-11-02 19:01:38+00:00,['3adf92151a2f794559d9ef9961bd04b7ba6af1fd'],280,440,720,304074,18,1,0.23853211,0.963302752,910
989c9bfbab5838525783a0cb3ca48c5db4939c85,0,Jun Rao,2012-11-05 23:10:38+00:00,['75fc5eab35aa33cffd9c09a2070dfe287db0ef4e'],1,7,8,304082,1,1,1,1,910
f54f481873b9fe8f5675ef5a1faf823aa590697a,1,Jun Rao,2012-11-05 23:37:24+00:00,['989c9bfbab5838525783a0cb3ca48c5db4939c85'],8,77,85,304167,1,0,0,0.1,910
ed6243852af125c0399b9ceae817f863043b2373,1,Neha Narkhede,2012-11-06 03:43:15+00:00,['f54f481873b9fe8f5675ef5a1faf823aa590697a'],10,52,62,304229,4,0.107142857,0.142857143,1,910
6800b0ed3b2519952c3253023c4fda06627bc1e0,1,Jun Rao,2012-11-08 06:19:55+00:00,['ed6243852af125c0399b9ceae817f863043b2373'],15,110,125,304354,7,0.161290323,0.741935484,1,911
1cc8c3beab1cf42d8f6d3216af081b767761693c,1,Jun Rao,2012-11-09 22:58:23+00:00,['6800b0ed3b2519952c3253023c4fda06627bc1e0'],208,6918,7126,311480,73,0.027586207,0,0,973
6c97767b88de625ea5101999ace7fb78744b75b5,1,Joel Jacob Koshy,2012-11-14 18:57:48+00:00,['1cc8c3beab1cf42d8f6d3216af081b767761693c'],38,41,79,311559,13,1,1,1,974
22e032fdd4f8fd8dff5c4b77c61834b4f7561980,1,Neha Narkhede,2012-11-15 00:28:28+00:00,['6c97767b88de625ea5101999ace7fb78744b75b5'],108,98,206,311765,4,0.8,0,0.533333333,974
f4ccf21d5d65ae313b2a400eb831df6d2d3daa67,1,Edward Jay Kreps,2012-11-15 22:15:14+00:00,['22e032fdd4f8fd8dff5c4b77c61834b4f7561980'],679,735,1414,313179,54,0.785714286,1,0,974
60d0587e8fca7197683b55e00537c32ddee4795d,1,Edward Jay Kreps,2012-11-15 22:54:45+00:00,['f4ccf21d5d65ae313b2a400eb831df6d2d3daa67'],69,136,205,313384,16,0.169014085,0.169014085,1,974
125548274a414355bb1241695e7593cc0ddc7b5b,0,Jun Rao,2012-11-16 00:31:58+00:00,['60d0587e8fca7197683b55e00537c32ddee4795d'],1,1,2,313386,1,,,,974
e13ecfc1df8966c91384e9c7787f9026b0c500ab,1,Jun Rao,2012-11-16 19:38:14+00:00,['125548274a414355bb1241695e7593cc0ddc7b5b'],40,357,397,313783,13,0.0625,0,1,976
8c884ee6a6433745e68febdc68f0b22520a7e335,1,Edward Jay Kreps,2012-11-16 21:55:36+00:00,['e13ecfc1df8966c91384e9c7787f9026b0c500ab'],39,2,41,313824,2,0.142857143,0,0.285714286,976
92d64170bbae8b1d44c55c61181de2451f0bf5de,0,Jun Rao,2012-11-17 00:28:38+00:00,['8c884ee6a6433745e68febdc68f0b22520a7e335'],1,2,3,313827,1,,,,976
39edb7beea33bc0075c15f88183764f8515e1874,0,Jun Rao,2012-11-17 01:33:58+00:00,['92d64170bbae8b1d44c55c61181de2451f0bf5de'],2,5,7,313834,1,0,0,1,976
79d3be92932bbe0222c6cf61add639eeb676063f,0,Joel Jacob Koshy,2012-11-17 01:38:14+00:00,['39edb7beea33bc0075c15f88183764f8515e1874'],22,11,33,313867,3,0,0,0,976
8e7b0d40169f93710d08ee36e53b4a16c1d3a344,1,Neha Narkhede,2012-11-18 22:48:20+00:00,['79d3be92932bbe0222c6cf61add639eeb676063f'],204,512,716,314583,22,0.402777778,0.518518519,0.731481481,977
602acaf412f924ab139c731d629b9b129301d20b,1,Jun Rao,2012-11-19 05:51:59+00:00,['8e7b0d40169f93710d08ee36e53b4a16c1d3a344'],32,71,103,314686,5,0.621621622,0.621621622,0.891891892,977
3f432cd01c4728396f277e33897f6f898c530c99,0,Jun Rao,2012-11-26 17:33:03+00:00,"['dd21b35120119dc35da7e800bfd50dad3dd2f44b', '602acaf412f924ab139c731d629b9b129301d20b']",10359,38872,49231,363917,498,,,,977
6e6522c7c96c15007a69eba24ea0db8ec16fb978,1,Edward Jay Kreps,2012-11-26 20:59:21+00:00,['602acaf412f924ab139c731d629b9b129301d20b'],29,79,108,364025,6,0.348837209,0.348837209,1,977
961affa3fcf2721fc80883f4710bb1a92bb18b17,0,Gavin McDonald,2012-11-28 08:41:58+00:00,['6e6522c7c96c15007a69eba24ea0db8ec16fb978'],0,0,0,364025,0,,,,977
45ba1019cb007c9876b2392577a4db7a9ab5dba8,0,Gavin McDonald,2012-11-28 08:41:58+00:00,['3f432cd01c4728396f277e33897f6f898c530c99'],0,0,0,364025,0,,,,977
bdb04bba67326bdf1451df3ec4a855ed3c109869,1,Jun Rao,2012-11-28 21:05:17+00:00,['961affa3fcf2721fc80883f4710bb1a92bb18b17'],9,5,14,364039,3,1,1,0,977
7b2d9c33126f21efa06d2b2f9f275c66fbaac078,0,Jun Rao,2012-11-29 00:03:13+00:00,['bdb04bba67326bdf1451df3ec4a855ed3c109869'],88,0,88,364127,2,1,0,0,977
e556063520193c8065d7f8e39153d23dae8cf8b8,1,Jun Rao,2012-11-29 00:09:31+00:00,['7b2d9c33126f21efa06d2b2f9f275c66fbaac078'],8,8,16,364143,1,,,,977
d7c71c0949e0cbae8963ca76bc69d64bee8f10af,1,Neha Narkhede,2012-11-29 01:31:18+00:00,['e556063520193c8065d7f8e39153d23dae8cf8b8'],311,441,752,364895,63,0.5625,0.546875,0.953125,981
6486fd1a9f503af24c83d16a014a6405ae07cf9b,1,Neha Narkhede,2012-11-30 17:49:49+00:00,['d7c71c0949e0cbae8963ca76bc69d64bee8f10af'],13,13,26,364921,5,1,1,0,981
6ca7b3acfdfe34752c42a0a1a26ea991b8e4c3b1,1,Neha Narkhede,2012-12-01 02:04:19+00:00,['6486fd1a9f503af24c83d16a014a6405ae07cf9b'],177,130,307,365228,20,0.3125,0.3125,1,982
4be0b1be29e301500515b6c5e00655b06e829045,1,Edward Jay Kreps,2012-12-02 20:50:01+00:00,['45ba1019cb007c9876b2392577a4db7a9ab5dba8'],786,1044,1830,367058,26,1,0.3,0,982
494706999c43003f1f16ce3558bebe39421ff3eb,1,Edward Jay Kreps,2012-12-02 20:55:27+00:00,['4be0b1be29e301500515b6c5e00655b06e829045'],269,14,283,367341,4,0.776119403,0.059701493,0,982
e11447650a9a9fbaebff0e5c6a369375e087f1ae,1,Edward Jay Kreps,2012-12-06 04:23:44+00:00,['6ca7b3acfdfe34752c42a0a1a26ea991b8e4c3b1'],224,222,446,367787,29,0,0.941176471,0.176470588,982
98042e912392ec01173a4fcc5413a72577ee7576,1,Edward Jay Kreps,2012-12-06 16:23:12+00:00,['e11447650a9a9fbaebff0e5c6a369375e087f1ae'],14,8,22,367809,3,0.333333333,0,0,982
a4c767582991787ca4a06b6e2844b23a2010def9,0,Joel Jacob Koshy,2012-12-07 01:09:11+00:00,['98042e912392ec01173a4fcc5413a72577ee7576'],29,32,61,367870,1,0,1,1,982
f5a48b06e31ebe925dc99abfb6518f6057871318,1,Edward Jay Kreps,2012-12-07 04:01:29+00:00,['a4c767582991787ca4a06b6e2844b23a2010def9'],66,42,108,367978,15,0.307692308,0,0,982
ab2494470c56d48b79eea3260d6db3c8274fe2aa,0,Edward Jay Kreps,2012-12-07 18:27:48+00:00,['f5a48b06e31ebe925dc99abfb6518f6057871318'],1,1,2,367980,1,,,,982
12706637371fa95067dbbb76c246a4fe983387c7,0,Neha Narkhede,2012-12-07 23:07:16+00:00,['ab2494470c56d48b79eea3260d6db3c8274fe2aa'],42,118,160,368140,4,0.145454545,0,0.763636364,982
8a93698a75fccb8fbad5c9c24b6657c646e11b3a,0,Neha Narkhede,2012-12-08 00:45:15+00:00,['12706637371fa95067dbbb76c246a4fe983387c7'],5,11,16,368156,2,0,0,1,982
133c88278da2469bdf5c3d012a03c5eb117022bd,0,Neha Narkhede,2012-12-10 18:23:22+00:00,['8a93698a75fccb8fbad5c9c24b6657c646e11b3a'],3,3,6,368162,1,,,,982
a10be4b69c904a596af198feaac4cef4c391bf4c,1,Edward Jay Kreps,2012-12-10 19:31:29+00:00,['494706999c43003f1f16ce3558bebe39421ff3eb'],111,325,436,368598,15,0.358974359,1,0.935897436,984
e15432efd3d43b2814703d2d5ed6d05758861a6b,0,Jun Rao,2012-12-11 05:38:37+00:00,['133c88278da2469bdf5c3d012a03c5eb117022bd'],0,35,35,368633,2,,,,986
f9702c66b76873de6b2cce1f688e233dae4bf590,0,Edward Jay Kreps,2012-12-11 19:35:54+00:00,['e15432efd3d43b2814703d2d5ed6d05758861a6b'],1,1,2,368635,1,,,,986
ac35ae1fef0294cc5a33908209598f938dc7d84c,1,Edward Jay Kreps,2012-12-11 19:47:13+00:00,['a10be4b69c904a596af198feaac4cef4c391bf4c'],86,210,296,368931,9,0.341176471,0.905882353,1,986
3244bcafe4233611fc0366f9df53ec98b44ca571,1,Neha Narkhede,2012-12-13 10:15:32-08:00,['f9702c66b76873de6b2cce1f688e233dae4bf590'],11,46,57,368988,2,0,0.666666667,1,986
45cb03d456c3c541815691e80f5216a6e524c95c,1,Derek Chen-Becker,2012-12-14 17:12:38-07:00,['3244bcafe4233611fc0366f9df53ec98b44ca571'],42,193,235,369223,12,1,1,1,993
f0d26335f2aa3397f0fd6125bfd833c331e90ae9,0,Jay Kreps,2012-12-16 11:05:50-08:00,['3244bcafe4233611fc0366f9df53ec98b44ca571'],1,1,2,369225,1,,,,993
739b2df6806c10b934f69e6181555fccb85cd9b8,0,Jay Kreps,2012-12-16 11:28:16-08:00,['ac35ae1fef0294cc5a33908209598f938dc7d84c'],3,670,673,369898,3,0.203389831,0.491525424,0.491525424,995
8ad9018ea197676bdc4e57ccf985dc752e54e5c7,1,Neha Narkhede,2012-12-17 14:05:17-08:00,['f0d26335f2aa3397f0fd6125bfd833c331e90ae9'],358,172,530,370428,21,1,1,0.068965517,995
9001d74839772d148443d3d86aca48f5dbbc890b,0,Neha Narkhede,2012-12-17 14:12:27-08:00,['f0d26335f2aa3397f0fd6125bfd833c331e90ae9'],32,103,135,370563,4,0,0.046511628,0.720930233,995
792b071ccaa9a01259af34cd86a705d474df7036,0,Neha Narkhede,2012-12-17 14:33:03-08:00,"['8ad9018ea197676bdc4e57ccf985dc752e54e5c7', '9001d74839772d148443d3d86aca48f5dbbc890b']",32,103,135,370698,4,,,,995
af83dfbe0c092eea37e9b1b840870386bb612db8,0,Jun Rao,2012-12-17 14:56:13-08:00,['792b071ccaa9a01259af34cd86a705d474df7036'],1,1,2,370700,1,,,,995
994fe081b6e429ba1cfd5c09d464015c41e64cf7,1,Neha Narkhede,2012-12-17 15:53:12-08:00,['792b071ccaa9a01259af34cd86a705d474df7036'],0,494,494,371194,14,0.402877698,0.316546763,1,1005
4e5a6fc0cf3454e665cd156ca2b8db34e3d0bcaf,0,Neha Narkhede,2012-12-17 15:54:04-08:00,"['994fe081b6e429ba1cfd5c09d464015c41e64cf7', 'af83dfbe0c092eea37e9b1b840870386bb612db8']",1,1,2,371196,1,,,,1005
04b52743f8eaa9057b0b5687fb3681e1bd1e2d49,1,Joel Koshy,2012-12-17 16:35:32-08:00,['4e5a6fc0cf3454e665cd156ca2b8db34e3d0bcaf'],44,58,102,371298,5,1,1,0,1005
85ec04452b1039acd927b9794ab848f4f052c765,0,Jay Kreps,2012-12-18 09:00:27-08:00,['04b52743f8eaa9057b0b5687fb3681e1bd1e2d49'],1,1,2,371300,1,,,,1005
32dae955d5e2e2dd45bddb628cb07c874241d856,1,Jay Kreps,2012-12-18 09:43:41-08:00,"['739b2df6806c10b934f69e6181555fccb85cd9b8', '85ec04452b1039acd927b9794ab848f4f052c765']",1020,1576,2596,373896,122,,,,1005
c6d41102d81ac48b345d3f42d669e6a6bbfbe062,1,Jay Kreps,2012-12-20 14:13:22-08:00,['85ec04452b1039acd927b9794ab848f4f052c765'],21,48,69,373965,7,0.25,1,1,1005
25d77cc69c5f12394f55e22516fc90fd3c272166,1,Joel Koshy,2013-01-02 14:08:46-08:00,['c6d41102d81ac48b345d3f42d669e6a6bbfbe062'],21,21,42,374007,4,1,0,0,1005
6cf46e7cabd2041cb0c171bab4166d5f8b377a51,0,Jun Rao,2013-01-04 09:13:22-08:00,['25d77cc69c5f12394f55e22516fc90fd3c272166'],8,6,14,374021,1,1,1,0,1005
2f4bfc645a597892c3b0a8dfe722158f3b993874,1,Jun Rao,2013-01-04 13:39:07-08:00,['6cf46e7cabd2041cb0c171bab4166d5f8b377a51'],5,92,97,374118,2,0.292682927,0.292682927,1,1006
a39c34a2d138b3bdc5af70f4888982b02dea0742,0,Jun Rao,2013-01-04 13:42:27-08:00,"['32dae955d5e2e2dd45bddb628cb07c874241d856', '2f4bfc645a597892c3b0a8dfe722158f3b993874']",55,167,222,374340,12,,,,1006
222c0e46ab78a12e1f58e3fb526667a4f73d344a,1,Jay Kreps,2013-01-04 14:30:03-08:00,['a39c34a2d138b3bdc5af70f4888982b02dea0742'],20,998,1018,375358,24,0.259887006,0.861581921,0.994350282,1017
274cd02f1ad69650e8abe7022d36049124219317,0,Jay Kreps,2013-01-04 15:56:41-08:00,['222c0e46ab78a12e1f58e3fb526667a4f73d344a'],1,3,4,375362,1,,,,1017
dc9edc462257f535ebf1acc2d6a1404904b8798e,0,Joe Stein,2013-01-05 10:58:38-08:00,['274cd02f1ad69650e8abe7022d36049124219317'],1,1,2,375364,1,,,,1017
ed36a7f07a45650862e115f42696b9ec70e563a5,0,Joe Stein,2013-01-06 19:45:51-08:00,['dc9edc462257f535ebf1acc2d6a1404904b8798e'],21,25,46,375410,2,,,,1017
241fea700758cec7746103c50d1751155d08576a,0,Derek Chen-Becker,2013-01-07 10:42:01-07:00,['45cb03d456c3c541815691e80f5216a6e524c95c'],0,0,0,375410,1,,,,1017
fd94251d89180cdb6cf815cf2d6f568e15b85c59,1,Jun Rao,2013-01-08 13:43:53-08:00,['2f4bfc645a597892c3b0a8dfe722158f3b993874'],34,31,65,375475,1,1,0,1,1017
85c9e91c8010c9455ac484c1c679437bd5f43a3c,1,Jun Rao,2013-01-08 13:57:16-08:00,['fd94251d89180cdb6cf815cf2d6f568e15b85c59'],13,44,57,375532,1,0,0,1,1017
e0b3b6316342271d798af10494c0ceab13e1eb02,1,Neha Narkhede,2013-01-09 08:49:11-08:00,['85c9e91c8010c9455ac484c1c679437bd5f43a3c'],9,32,41,375573,3,0,0,1,1017
ddd66cbd80d1765898fd82322dc5c5afc9b29fba,1,Joe Stein,2013-01-09 16:48:23-08:00,['e0b3b6316342271d798af10494c0ceab13e1eb02'],21,25,46,375619,2,,,,1017
b71e6dc352770f22daec0c9a3682138666f032be,1,Jun Rao,2013-01-10 11:03:19-08:00,['ddd66cbd80d1765898fd82322dc5c5afc9b29fba'],15,37,52,375671,3,0,0,1,1017
c12608c5fed04ece82582cb5b764ceb0b5b389e0,0,Neha Narkhede,2013-01-11 09:58:04-08:00,['b71e6dc352770f22daec0c9a3682138666f032be'],1,1,2,375673,1,,,,1017
03eb903ce223ab55c5acbcf4243ce805aaaf4fad,1,Neha Narkhede,2013-01-11 14:06:00-08:00,['c12608c5fed04ece82582cb5b764ceb0b5b389e0'],107,179,286,375959,26,0,0.027027027,0.972972973,1017
dbe87f6df314190225956fff338dd14173e04715,0,Neha Narkhede,2013-01-11 14:06:42-08:00,['03eb903ce223ab55c5acbcf4243ce805aaaf4fad'],1,2,3,375962,1,,,,1017
a40953196e1ef558eb61b78219a20c20a4bd63df,1,Jun Rao,2013-01-11 16:12:57-08:00,['dbe87f6df314190225956fff338dd14173e04715'],585,541,1126,377088,76,1,0.25,0,1017
9249b76d1d04f2583843cf5fe09ba8bbdf611183,1,Jun Rao,2013-01-11 18:25:56-08:00,"['ed36a7f07a45650862e115f42696b9ec70e563a5', 'a40953196e1ef558eb61b78219a20c20a4bd63df']",759,855,1614,378702,98,,,,1017
c02e7fd690301e93454638a73cd31343cad178b8,1,Jun Rao,2013-01-13 13:59:10-08:00,['a40953196e1ef558eb61b78219a20c20a4bd63df'],2,2,4,378706,1,,,,1017
d7f410925e870f3f8b220fb7bdc2c2f265f06ed6,0,Jun Rao,2013-01-13 14:00:52-08:00,"['9249b76d1d04f2583843cf5fe09ba8bbdf611183', 'c02e7fd690301e93454638a73cd31343cad178b8']",2,2,4,378710,1,,,,1017
53818bb7ee8022486eee06a22328200fc5cfced1,0,Jun Rao,2013-01-14 09:21:10-08:00,['c02e7fd690301e93454638a73cd31343cad178b8'],16,22,38,378748,3,0,0,1,1017
bd5504c0520d393715afe524313c5c8ac00337a2,0,Jun Rao,2013-01-14 14:29:34-08:00,['53818bb7ee8022486eee06a22328200fc5cfced1'],784,809,1593,380341,103,0,0,0,1017
b052e80de20785946dff27559ee3fd5eb45e7ce1,0,Jun Rao,2013-01-14 14:30:52-08:00,"['d7f410925e870f3f8b220fb7bdc2c2f265f06ed6', 'bd5504c0520d393715afe524313c5c8ac00337a2']",800,831,1631,381972,106,,,,1017
b2eec991d35e7d17b3cfc05438d81637a056aa83,1,Jun Rao,2013-01-15 09:45:28-08:00,['bd5504c0520d393715afe524313c5c8ac00337a2'],12,14,26,381998,4,1,0,1,1017
eeb817ac23f4aa756ebe404a85eeb618a7cb5a08,0,Neha Narkhede,2013-01-15 09:45:46-08:00,['bd5504c0520d393715afe524313c5c8ac00337a2'],12,14,26,382024,4,1,0,1,1017
3696d728116ee1b408d11bab54ca3f0234438610,0,Neha Narkhede,2013-01-15 09:46:04-08:00,"['eeb817ac23f4aa756ebe404a85eeb618a7cb5a08', 'b2eec991d35e7d17b3cfc05438d81637a056aa83']",0,0,0,382024,0,,,,1017
362eba981de40a69ae509a291649531ead6f6aee,0,Jun Rao,2013-01-15 09:46:34-08:00,"['b052e80de20785946dff27559ee3fd5eb45e7ce1', 'b2eec991d35e7d17b3cfc05438d81637a056aa83']",12,14,26,382050,4,,,,1017
de1a4d727693c39be19fd9db427746fa6c8a4a12,1,Jay Kreps,2013-01-15 15:43:10-08:00,['3696d728116ee1b408d11bab54ca3f0234438610'],4,7,11,382061,1,0,0,1,1017
777f66220153a64cd33cd5484a64de556f4fa3a8,0,Jun Rao,2013-01-15 21:26:45-08:00,['de1a4d727693c39be19fd9db427746fa6c8a4a12'],12,30,42,382103,2,1,1,0,1017
da7f14676e677bb6b4fc1ea75fe9792709954591,0,Neha Narkhede,2013-01-16 10:00:31-08:00,['777f66220153a64cd33cd5484a64de556f4fa3a8'],1,1,2,382105,1,,,,1017
214a0af46b98aa9eaf54d0fbe982bc8ba2ae0a74,1,Jun Rao,2013-01-17 09:36:01-08:00,['da7f14676e677bb6b4fc1ea75fe9792709954591'],44,44,88,382193,9,0,1,1,1017
9ee795ac563c3ce4c4f03e022c7f951e065ad1ed,0,Jun Rao,2013-01-17 10:17:30-08:00,"['362eba981de40a69ae509a291649531ead6f6aee', '214a0af46b98aa9eaf54d0fbe982bc8ba2ae0a74']",62,81,143,382336,13,,,,1017
ecd1f19f5aea2d2907d1a5594080062cb5c945f1,0,Neha Narkhede,2013-01-17 21:31:06-08:00,['214a0af46b98aa9eaf54d0fbe982bc8ba2ae0a74'],1,1,2,382338,1,,,,1017
aa1546b0907c959a4df90a7e3d48bad0890d1f2f,0,Neha Narkhede,2013-01-19 14:38:46-08:00,['ecd1f19f5aea2d2907d1a5594080062cb5c945f1'],6,17,23,382361,3,0,0.222222222,0,1017
1e011bf42efce996a553d6c0a2d7e51b45622b6b,0,Joe Stein,2013-01-20 22:37:56-05:00,['ecd1f19f5aea2d2907d1a5594080062cb5c945f1'],0,1,1,382362,1,,,,1017
96dc298438994fb5c93daa8c544bf8581a0eeb69,0,Jun Rao,2013-01-20 20:52:54-08:00,['1e011bf42efce996a553d6c0a2d7e51b45622b6b'],15,1,16,382378,2,,,,1017
999813821c091adcc5c50d0cb6b8c702473a0a8c,0,Jun Rao,2013-01-20 20:53:36-08:00,"['9ee795ac563c3ce4c4f03e022c7f951e065ad1ed', '96dc298438994fb5c93daa8c544bf8581a0eeb69']",16,3,19,382397,4,,,,1017
2d059148febe3804116311924ad7953c40914dc1,0,Neha Narkhede,2013-01-21 00:19:03-08:00,"['aa1546b0907c959a4df90a7e3d48bad0890d1f2f', '96dc298438994fb5c93daa8c544bf8581a0eeb69']",15,2,17,382414,3,,,,1017
426ef1662590893ff27a4be0b5f17b73115f154c,0,Neha Narkhede,2013-01-21 00:20:12-08:00,['2d059148febe3804116311924ad7953c40914dc1'],1,2,3,382417,1,0,0,1,1017
5490884e9cbd28ac57e4b73bec72bcab81ce6523,0,Neha Narkhede,2013-01-21 09:53:41-08:00,['426ef1662590893ff27a4be0b5f17b73115f154c'],17,6,23,382440,3,1,0.777777778,1,1017
f112ef2b5799cc8cf7786e98d1269145a19ef361,1,Joel Koshy,2013-01-21 10:47:31-08:00,['5490884e9cbd28ac57e4b73bec72bcab81ce6523'],8,8,16,382456,1,,,,1017
e6aa600813549ed6219ea5cfda95ecb08dc3717d,1,Joe Stein,2013-01-21 14:41:47-05:00,"['1e011bf42efce996a553d6c0a2d7e51b45622b6b', '241fea700758cec7746103c50d1751155d08576a']",47,199,246,382702,13,,,,1017
d5c980a912e2d1f48e99ccc16c713b1ba187b716,0,Joe Stein,2013-01-21 14:42:01-05:00,"['e6aa600813549ed6219ea5cfda95ecb08dc3717d', 'f112ef2b5799cc8cf7786e98d1269145a19ef361']",24,11,35,382737,4,,,,1017
5e3e181aceb22dd7054f134beee53e185dc0d05b,1,Joe Stein,2013-01-21 21:33:53-05:00,['d5c980a912e2d1f48e99ccc16c713b1ba187b716'],6,17,23,382760,3,,,,1017
0d197f9b97c586d53bb5328eaac67ef0c39601bd,0,Joel Koshy,2013-01-22 12:12:11-08:00,['5e3e181aceb22dd7054f134beee53e185dc0d05b'],16,19,35,382795,1,0,0,1,1017
b5d685bb7c1649f46f6553b0e807e704ffcef748,1,Neha Narkhede,2013-01-22 12:15:20-08:00,['5e3e181aceb22dd7054f134beee53e185dc0d05b'],2,2,4,382799,1,,,,1017
22cd8bfd6eca64a1a6d23ecef7f5dc938ac02c7f,0,Neha Narkhede,2013-01-22 12:15:37-08:00,"['b5d685bb7c1649f46f6553b0e807e704ffcef748', '0d197f9b97c586d53bb5328eaac67ef0c39601bd']",16,19,35,382834,1,,,,1017
307b1f338ad9748809c9b782dc3f28263edcadf2,0,Jun Rao,2013-01-23 12:06:20-08:00,['22cd8bfd6eca64a1a6d23ecef7f5dc938ac02c7f'],22,7,29,382863,4,0,0,0,1017
eb0d5a7f815ac51e3bdcf7bb2c1d3af9f33f2d83,1,Neha Narkhede,2013-01-23 13:47:27-08:00,['22cd8bfd6eca64a1a6d23ecef7f5dc938ac02c7f'],94,105,199,383062,9,1,1,1,1017
22bde135a85da9507f08698f29403c792db31e42,0,Neha Narkhede,2013-01-23 13:47:34-08:00,"['eb0d5a7f815ac51e3bdcf7bb2c1d3af9f33f2d83', '307b1f338ad9748809c9b782dc3f28263edcadf2']",22,7,29,383091,4,,,,1017
311a5d81d8a8b34e18e1ad2fdc491661477de83c,1,Neha Narkhede,2013-01-23 14:07:26-08:00,['22bde135a85da9507f08698f29403c792db31e42'],3,113,116,383207,3,0.671428571,0.771428571,1,1018
7833c894a89779b4d49c329b16d66b3296f6c09d,1,Neha Narkhede,2013-01-23 14:22:36-08:00,['311a5d81d8a8b34e18e1ad2fdc491661477de83c'],4,17,21,383228,5,0.076923077,0.076923077,1,1018
2bee455ed86f5780862c09edd01cd347a5551665,1,Neha Narkhede,2013-01-23 15:00:16-08:00,['7833c894a89779b4d49c329b16d66b3296f6c09d'],0,15,15,383243,1,,,,1018
aeac593a90e0d796260f876159d3cf2b0416ca61,1,Joe Stein,2013-01-23 21:02:12-05:00,['2bee455ed86f5780862c09edd01cd347a5551665'],0,2,2,383245,1,,,,1018
cb3359f9f14c4632ed31b7fcef7f311d7597955c,1,Joe Stein,2013-01-24 01:23:44-05:00,['aeac593a90e0d796260f876159d3cf2b0416ca61'],13,20,33,383278,1,,,,1018
8e7effc0550f57064fba0c3b48a248ad9c3ab003,0,Neha Narkhede,2013-01-24 10:06:32-08:00,['cb3359f9f14c4632ed31b7fcef7f311d7597955c'],2,2,4,383282,1,,,,1018
a15f1f2d84d133a3e01b2c7fe88cbed033ee7bac,0,Neha Narkhede,2013-01-24 10:47:17-08:00,['8e7effc0550f57064fba0c3b48a248ad9c3ab003'],1,1,2,383284,1,,,,1018
8d41620a427a027d212c241ae105d09cd470e64f,1,Neha Narkhede,2013-01-24 11:51:29-08:00,['a15f1f2d84d133a3e01b2c7fe88cbed033ee7bac'],95,156,251,383535,10,1,1,0.13559322,1018
758778ebaa357f41fb9f1e4f3c1a13c639ad6d2f,0,Neha Narkhede,2013-01-24 14:04:02-08:00,['8d41620a427a027d212c241ae105d09cd470e64f'],0,797,797,384332,9,,,,1027
22a010b8bcd19e29a9acfe1489ffb6db429f8e07,0,Neha Narkhede,2013-01-25 08:34:52-08:00,['758778ebaa357f41fb9f1e4f3c1a13c639ad6d2f'],1,2,3,384335,2,,,,1028
40a80fa7b7ae3d49e32c40fbaad1a4e402b2ac71,1,Neha Narkhede,2013-01-25 13:06:24-08:00,['22a010b8bcd19e29a9acfe1489ffb6db429f8e07'],4,6,10,384345,3,0,1,1,1028
92f177b309834a9b572bbab33e8f6198316bd156,1,Jun Rao,2013-01-25 22:03:39-08:00,"['999813821c091adcc5c50d0cb6b8c702473a0a8c', '40a80fa7b7ae3d49e32c40fbaad1a4e402b2ac71']",314,1490,1804,386149,58,,,,1028
1fb3e8c037c01ecfe6bb1d4261b59cb19baae6cf,1,Neha Narkhede,2013-01-28 16:50:36-08:00,['40a80fa7b7ae3d49e32c40fbaad1a4e402b2ac71'],17,12,29,386178,1,0,0,0,1028
e7edb5e1e933f5535378d546bcf4d8b178d2e69c,1,Jay Kreps,2013-01-28 19:31:17-08:00,['92f177b309834a9b572bbab33e8f6198316bd156'],547,2280,2827,389005,40,0.551390568,0.911729141,0.783555018,1038
b3a4fe9cedca778a95b7f22054cb8f8ef6cf38c7,0,Jun Rao,2013-01-29 17:00:49-08:00,['1fb3e8c037c01ecfe6bb1d4261b59cb19baae6cf'],7,10,17,389022,2,1,1,0,1038
2ae069024120a7c9775ac53966f0af08435f2e5b,0,Jun Rao,2013-01-29 18:01:28-08:00,['b3a4fe9cedca778a95b7f22054cb8f8ef6cf38c7'],2,2,4,389026,2,,,,1038
295734f6abb69d0c184faa0085ca198040b2adbf,1,Neha Narkhede,2013-02-01 10:46:02-08:00,['2ae069024120a7c9775ac53966f0af08435f2e5b'],173,108,281,389307,6,1,1,0,1038
1086d001d8f2389cd8cf409d099ca3260b00eb49,0,Neha Narkhede,2013-02-05 15:04:18-08:00,['295734f6abb69d0c184faa0085ca198040b2adbf'],1,2,3,389310,1,0,1,1,1038
aed6c3c0313ec00fa10b2fb0dd07658c96a99647,0,Neha Narkhede,2013-02-05 17:35:58-08:00,['1086d001d8f2389cd8cf409d099ca3260b00eb49'],2,3,5,389315,1,0,0,0,1038
826f02a74e00bec1efb9d60b43cf9e0702d8d58a,1,Neha Narkhede,2013-02-05 20:11:03-08:00,['aed6c3c0313ec00fa10b2fb0dd07658c96a99647'],3,8,11,389326,4,1,1,1,1038
814c9709c07c514b1a1255e2adb5555c323e6485,1,Neha Narkhede,2013-02-05 22:05:28-08:00,['826f02a74e00bec1efb9d60b43cf9e0702d8d58a'],28,42,70,389396,5,0,1,0.4,1038
b89fc2be8a771a8a7b4a618805a6154ec0bda18b,1,Neha Narkhede,2013-02-07 10:03:19-08:00,['814c9709c07c514b1a1255e2adb5555c323e6485'],5,5,10,389406,1,,,,1038
790a1504c3437b84ce2d910b9769a2b4ae481ed3,1,Jay Kreps,2013-02-08 10:50:38-08:00,['b89fc2be8a771a8a7b4a618805a6154ec0bda18b'],11,23,34,389440,3,0.75,0.75,1,1038
2f0df95f796db9049ed2dfc8e1253957e9e0cfd8,1,Jun Rao,2013-02-12 07:50:49-08:00,['b89fc2be8a771a8a7b4a618805a6154ec0bda18b'],3,3,6,389446,3,,,,1038
879d2692ea1192a4989297acbcbc01092ccbfb54,0,Jun Rao,2013-02-12 07:52:21-08:00,"['2f0df95f796db9049ed2dfc8e1253957e9e0cfd8', '790a1504c3437b84ce2d910b9769a2b4ae481ed3']",11,23,34,389480,3,,,,1038
48745f04d12988121cb770cbd33ed3ed6fe98cff,1,Jun Rao,2013-02-12 12:29:59-08:00,['879d2692ea1192a4989297acbcbc01092ccbfb54'],11,33,44,389524,4,0.058823529,1,0.411764706,1038
e81b0a3ded9ff31f5089f2a3f294fbe0aef9614b,1,Jun Rao,2013-02-13 14:01:57-08:00,['48745f04d12988121cb770cbd33ed3ed6fe98cff'],7,22,29,389553,2,1,0.333333333,1,1038
8103b4f6355a8267aa5638cfd382412221bdddfa,1,Jun Rao,2013-02-13 14:12:44-08:00,['e81b0a3ded9ff31f5089f2a3f294fbe0aef9614b'],1,1,2,389555,1,,,,1038
b84168a3e3b68bb7d6d2904d4f7c591e43fc5435,1,Jun Rao,2013-02-14 08:23:48-08:00,['8103b4f6355a8267aa5638cfd382412221bdddfa'],9,24,33,389588,1,,,,1038
30f992c52dd3aba8cc35c9835df5b5e56581e0d8,1,Jun Rao,2013-02-18 14:54:28-08:00,['b84168a3e3b68bb7d6d2904d4f7c591e43fc5435'],0,2,2,389590,1,1,1,1,1038
859959f974225dd066ae94fc8254809203ffd980,0,Jun Rao,2013-02-21 21:42:18-08:00,['30f992c52dd3aba8cc35c9835df5b5e56581e0d8'],2,2,4,389594,1,,,,1038
049ac882bfa3d9f01100f84ab4cf9b0a41ae88a8,1,Jun Rao,2013-02-21 21:48:43-08:00,['859959f974225dd066ae94fc8254809203ffd980'],0,1,1,389595,1,1,1,1,1038
b056a9a1eca8fb27812c7e4bc5872a9d96aae866,0,Neha Narkhede,2013-02-22 08:13:32-08:00,['049ac882bfa3d9f01100f84ab4cf9b0a41ae88a8'],3,1,4,389599,2,0,0,0,1038
0be45b334b821b079d6d0336515248bf11b4cf8d,0,Neha Narkhede,2013-02-22 15:03:13-08:00,['b056a9a1eca8fb27812c7e4bc5872a9d96aae866'],7,12,19,389618,1,0,1,1,1038
144a0a2ac02ecf6297f4dee4ae773be59095b1e7,0,Neha Narkhede,2013-02-22 15:26:13-08:00,['0be45b334b821b079d6d0336515248bf11b4cf8d'],2,7,9,389627,1,0,0,1,1038
828ce83dcb442d1cc6c0dbc538d12bbb04a0884d,1,Jun Rao,2013-02-22 16:43:54-08:00,['144a0a2ac02ecf6297f4dee4ae773be59095b1e7'],245,248,493,390120,15,0.419354839,0.290322581,1,1038
4d8fb1eebc043fab11c58d3309e93cc83ef24a89,1,Neha Narkhede,2013-02-22 17:48:10-08:00,['828ce83dcb442d1cc6c0dbc538d12bbb04a0884d'],124,215,339,390459,22,0.114285714,0.814285714,1,1038
9115977b38ad207028c7c194524a408b9e5789f0,1,Jun Rao,2013-02-22 18:47:37-08:00,['828ce83dcb442d1cc6c0dbc538d12bbb04a0884d'],32,38,70,390529,14,0,0,1,1038
ccfdabc045175491ebe95ee50d18646caeafd916,0,Jun Rao,2013-02-22 18:48:14-08:00,"['9115977b38ad207028c7c194524a408b9e5789f0', '4d8fb1eebc043fab11c58d3309e93cc83ef24a89']",124,215,339,390868,22,,,,1038
d925b157f42b13cb410a86e8850c23a11de3d2f1,1,Neha Narkhede,2013-02-24 14:27:21-08:00,['ccfdabc045175491ebe95ee50d18646caeafd916'],133,244,377,391245,6,0.505494505,0.703296703,0.901098901,1038
218e6a53c1385be897d9f8a3a39baa38b68d7992,0,Neha Narkhede,2013-02-24 18:10:29-08:00,['e7edb5e1e933f5535378d546bcf4d8b178d2e69c'],1,11,12,391257,2,1,0,1,1038
db1cb5bbd9dbd46da67cb3bf859829ffa1d69ad8,1,Neha Narkhede,2013-02-25 00:13:45-08:00,['d925b157f42b13cb410a86e8850c23a11de3d2f1'],5,11,16,391273,2,0,0.428571429,1,1038
76a4fbfb13a3541960c8c9312defdb69fa4c3f32,0,Neha Narkhede,2013-02-25 09:53:40-08:00,['db1cb5bbd9dbd46da67cb3bf859829ffa1d69ad8'],7,9,16,391289,1,0,1,1,1038
37ca9db782b43180385704201633ca38e932b4cf,0,Neha Narkhede,2013-02-26 15:21:31-08:00,['76a4fbfb13a3541960c8c9312defdb69fa4c3f32'],0,7,7,391296,1,0,1,1,1038
6989dac889f2afd3cd192d345d3bd29995e605b9,1,Neha Narkhede,2013-02-26 16:34:11-08:00,['37ca9db782b43180385704201633ca38e932b4cf'],37,33,70,391366,4,1,1,1,1038
4f752cab189878053c4eb2dd78515bbf94026f3e,0,Neha Narkhede,2013-02-26 16:44:46-08:00,['6989dac889f2afd3cd192d345d3bd29995e605b9'],1,2,3,391369,1,0,0,1,1038
89622c8e88ddddeddb8c3449ef1782c1d399c2b0,1,Neha Narkhede,2013-02-26 17:36:15-08:00,['4f752cab189878053c4eb2dd78515bbf94026f3e'],26,36,62,391431,7,0.833333333,0.833333333,1,1038
cea27356feedb66f91b734c9c63de1ea44ac0d47,0,Neha Narkhede,2013-02-27 19:17:43-08:00,['89622c8e88ddddeddb8c3449ef1782c1d399c2b0'],35,54,89,391520,6,0,0,1,1038
db65c9573533b5d6f8a3a5cbfdd287ebdcde72e4,1,Neha Narkhede,2013-02-27 19:23:04-08:00,['89622c8e88ddddeddb8c3449ef1782c1d399c2b0'],35,54,89,391609,6,0,0,1,1038
92ecebecd0551eb61e4ee31dfd020fe51f4090e2,0,Neha Narkhede,2013-02-27 19:23:28-08:00,"['db65c9573533b5d6f8a3a5cbfdd287ebdcde72e4', 'cea27356feedb66f91b734c9c63de1ea44ac0d47']",0,0,0,391609,0,,,,1038
82b11aa0d4bc32c5a351ace3a67cd2d57c9d1e8d,1,Neha Narkhede,2013-03-01 13:54:00-08:00,['218e6a53c1385be897d9f8a3a39baa38b68d7992'],12,2,14,391623,3,1,0.333333333,0,1038
4f2742d60d16f5ba468aa66d2c3ed7aa37479dce,1,Jun Rao,2013-03-03 20:20:41-08:00,"['82b11aa0d4bc32c5a351ace3a67cd2d57c9d1e8d', '92ecebecd0551eb61e4ee31dfd020fe51f4090e2']",922,1200,2122,393745,81,,,,1038
0ee46e05ddcbf1d6bc2aa0039800aaeac860ad56,0,Jun Rao,2013-03-04 22:40:12-08:00,['92ecebecd0551eb61e4ee31dfd020fe51f4090e2'],1,2,3,393748,1,,,,1038
a971a27b59dacb4fbc882a8fead5406c5b4144c6,0,Neha Narkhede,2013-03-05 09:38:29-08:00,['0ee46e05ddcbf1d6bc2aa0039800aaeac860ad56'],19,2,21,393769,2,0.307692308,0,0,1038
2e64c6a5f221c616b2ac222fdadb96618f65e1ec,0,Jun Rao,2013-03-06 09:21:56-08:00,['a971a27b59dacb4fbc882a8fead5406c5b4144c6'],19,5,24,393793,4,1,1,0,1038
2457bc49ef39c70622816250025eefc3bfcc7640,1,Neha Narkhede,2013-03-06 09:35:35-08:00,['2e64c6a5f221c616b2ac222fdadb96618f65e1ec'],136,414,550,394343,25,0,0.012578616,0.855345912,1039
eae1bd52ef1d991834151898e768e57de8bb07bf,1,Jun Rao,2013-03-06 12:54:39-08:00,['2457bc49ef39c70622816250025eefc3bfcc7640'],95,94,189,394532,8,0,1,0,1039
771760ce23f00ba86b916420d8e209b2611b23c0,0,Jun Rao,2013-03-06 16:08:56-08:00,['eae1bd52ef1d991834151898e768e57de8bb07bf'],17,3,20,394552,5,1,0.8,0,1039
19ae1959b091df44475243e3b199d6121ddedc72,1,Jun Rao,2013-03-07 18:20:33-08:00,['771760ce23f00ba86b916420d8e209b2611b23c0'],25,29,54,394606,9,0,1,1,1039
5a275b077af41803e22e5ac53a1fe474c53116ff,1,Neha Narkhede,2013-03-07 18:31:20-08:00,['19ae1959b091df44475243e3b199d6121ddedc72'],1,1,2,394608,1,,,,1039
b5edbb193b33ebf0b3056935a537967ff21478a6,0,Jun Rao,2013-03-08 14:59:50-08:00,['5a275b077af41803e22e5ac53a1fe474c53116ff'],324,884,1208,395816,102,,,,1039
c1ed12e44ddebe41dc464683e3d7eeb4e6d39a45,1,Jay Kreps,2013-03-08 15:07:39-08:00,['4f2742d60d16f5ba468aa66d2c3ed7aa37479dce'],496,906,1402,397218,44,0.898876404,1,0.853932584,1042
da1dc17887e536824df35958c6abdc14828fb4cb,0,Neha Narkhede,2013-03-09 14:53:22-08:00,['b5edbb193b33ebf0b3056935a537967ff21478a6'],1,1,2,397220,1,,,,1042
9ff4e8eb10e0ddd86f257e99d55971a132426605,1,Jay Kreps,2013-03-12 11:17:12-07:00,['c1ed12e44ddebe41dc464683e3d7eeb4e6d39a45'],191,504,695,397915,23,0.158653846,0.961538462,0.879807692,1043
485afe646af282c59927b177ddc70742349cdad8,1,Neha Narkhede,2013-03-12 11:21:44-07:00,['da1dc17887e536824df35958c6abdc14828fb4cb'],9,17,26,397941,2,1,1,1,1043
290d5e0eac38e9917c64353a131154821b899f26,1,Jun Rao,2013-03-12 20:59:09-07:00,['485afe646af282c59927b177ddc70742349cdad8'],66,78,144,398085,4,0.923076923,0,1,1043
dd9676163956b3e577808a1e9744aa9fb5e83e4e,0,Jun Rao,2013-03-13 10:10:52-07:00,['290d5e0eac38e9917c64353a131154821b899f26'],3,3,6,398091,1,0,0,1,1043
c5462864aab05b98158bcbe623123db083b8e136,0,Neha Narkhede,2013-03-13 11:50:59-07:00,['dd9676163956b3e577808a1e9744aa9fb5e83e4e'],7,10,17,398108,2,0,0,1,1043
0a9283530418781941b7c232a8b09e4ec071b0e9,0,Neha Narkhede,2013-03-13 13:11:54-07:00,['c5462864aab05b98158bcbe623123db083b8e136'],28,17,45,398153,3,1,0.125,1,1043
3b3fb7fed622cc0339c3b9e3fb175e6093e427a3,0,Jun Rao,2013-03-13 15:11:15-07:00,['0a9283530418781941b7c232a8b09e4ec071b0e9'],6,2,8,398161,2,1,1,0,1043
7fd9268f7b89afa2e41b526f1f4d7bfc90a519cf,1,Neha Narkhede,2013-03-15 08:31:13-07:00,['3b3fb7fed622cc0339c3b9e3fb175e6093e427a3'],1,9,10,398171,1,0,0,1,1043
d40d255bc86a8b82dddd79c71f4a0309af6731e0,0,Neha Narkhede,2013-03-18 14:34:22-07:00,['7fd9268f7b89afa2e41b526f1f4d7bfc90a519cf'],1,2,3,398174,1,,,,1043
46ebdc16e99c4bb9236a6c25c47ff2c97fdc0f53,1,Jun Rao,2013-03-18 15:53:03-07:00,['d40d255bc86a8b82dddd79c71f4a0309af6731e0'],19,19,38,398212,2,1,1,0,1043
a376f922149330995f91d427d76ff1595fbd26ce,1,Jun Rao,2013-03-19 16:32:59-07:00,['46ebdc16e99c4bb9236a6c25c47ff2c97fdc0f53'],27,71,98,398310,1,0.613636364,0.613636364,0.795454545,1043
a737986e54ea53a2b93f3d08f5eb7fd155095f3c,0,Neha Narkhede,2013-03-19 17:19:29-07:00,['a376f922149330995f91d427d76ff1595fbd26ce'],4,20,24,398334,2,0.153846154,0.153846154,1,1043
7b14ebae3382427b44a928d0b186001735c15efb,0,Jun Rao,2013-03-20 09:44:36-07:00,['a737986e54ea53a2b93f3d08f5eb7fd155095f3c'],1,2,3,398337,1,0,0,1,1043
08b2a37c33ed907614e9621f315bb737f9be490e,1,Neha Narkhede,2013-03-22 09:12:41-07:00,['7b14ebae3382427b44a928d0b186001735c15efb'],19,31,50,398387,3,0,0.363636364,0.363636364,1043
51421fcc0111031bb77f779a6f6c00520d526a34,1,Neha Narkhede,2013-03-22 09:32:27-07:00,['08b2a37c33ed907614e9621f315bb737f9be490e'],1,27,28,398415,1,0,0,1,1043
28ee7855360b8e6ea690fc802dac4eaa60ad81e2,1,Jun Rao,2013-03-25 09:31:57-07:00,['51421fcc0111031bb77f779a6f6c00520d526a34'],92,87,179,398594,11,1,0.75,0.5,1043
df221297c715f2a9dbe389f727a840ea1ab27e47,0,Jun Rao,2013-03-25 10:45:44-07:00,['28ee7855360b8e6ea690fc802dac4eaa60ad81e2'],0,28,28,398622,1,1,1,1,1044
e367f3ffb3340a0f0c0f46b0787d12476d751815,0,Jun Rao,2013-03-25 10:47:29-07:00,['df221297c715f2a9dbe389f727a840ea1ab27e47'],1,3,4,398626,1,1,1,1,1044
26c50fac47802e4aa03793c60cb8316995bb37f1,0,Jun Rao,2013-03-25 14:08:24-07:00,['e367f3ffb3340a0f0c0f46b0787d12476d751815'],185,222,407,399033,5,1,1,0,1044
c5e354d3ab8ee4f9d18da6c084d4abfb00911b7c,0,Neha Narkhede,2013-03-27 13:29:18-07:00,['26c50fac47802e4aa03793c60cb8316995bb37f1'],1,2,3,399036,1,0,0,0,1044
f570cce1f4bec4ce50b4b1878a804b725f316b91,0,Jun Rao,2013-03-27 16:58:54-07:00,['c5e354d3ab8ee4f9d18da6c084d4abfb00911b7c'],0,76,76,399112,2,0,0,0.022222222,1044
2fe3f9fef6e641ed64aca654b607c4d398e11d25,0,Neha Narkhede,2013-03-28 08:51:00-07:00,['f570cce1f4bec4ce50b4b1878a804b725f316b91'],41,27,68,399180,6,1,0,0,1044
be3ce14721a97df8331331b024ac602dcf66abe3,0,Neha Narkhede,2013-03-28 09:45:52-07:00,['2fe3f9fef6e641ed64aca654b607c4d398e11d25'],0,27,27,399207,1,1,1,1,1045
66b103895720700c5ea47e8f75a1105aca6e9342,1,Neha Narkhede,2013-03-28 09:54:02-07:00,['be3ce14721a97df8331331b024ac602dcf66abe3'],46,64,110,399317,4,1,1,1,1045
1d5e95f6c4067884a374deddd88ec3f471664658,0,Neha Narkhede,2013-03-28 16:29:37-07:00,['66b103895720700c5ea47e8f75a1105aca6e9342'],2,5,7,399324,1,,,,1045
6e05d7da865898c1c44f552c735484dfe2603b60,1,Jun Rao,2013-03-28 16:34:47-07:00,['1d5e95f6c4067884a374deddd88ec3f471664658'],37,25,62,399386,4,0,0,0,1045
9f6af315ca101272748de54fd1347c9def7d80af,1,Neha Narkhede,2013-03-29 08:26:41-07:00,['6e05d7da865898c1c44f552c735484dfe2603b60'],14,11,25,399411,2,1,1,1,1045
68528dafa1fcfb7a469654575288e19f5b4bda04,0,Jun Rao,2013-03-29 08:31:50-07:00,['9f6af315ca101272748de54fd1347c9def7d80af'],1,1,2,399413,1,,,,1045
06911384f2f32fe17a3057c9830e3f7dc30d66e6,0,Jun Rao,2013-03-29 13:24:45-07:00,['68528dafa1fcfb7a469654575288e19f5b4bda04'],1,1,2,399415,1,,,,1045
a9ce73cfd36bdb197e722ce8b828f27153f9e4ed,1,Neha Narkhede,2013-04-01 09:17:20-07:00,['06911384f2f32fe17a3057c9830e3f7dc30d66e6'],10,18,28,399443,3,0,0,0,1045
3c27988ca4036985f4c7bef62b9bbae3f95f0fb9,0,Jun Rao,2013-04-01 10:41:40-07:00,['a9ce73cfd36bdb197e722ce8b828f27153f9e4ed'],2,13,15,399458,2,1,1,1,1045
bd262ac708062e502406e8d775f4c9432a5364e7,0,Neha Narkhede,2013-04-03 13:43:50-07:00,['3c27988ca4036985f4c7bef62b9bbae3f95f0fb9'],1,4,5,399463,1,0.333333333,1,1,1045
5a50f7e555510b8cde08cd588cf4b67b06484b16,1,Jun Rao,2013-04-03 17:15:06-07:00,['bd262ac708062e502406e8d775f4c9432a5364e7'],25,20,45,399508,2,0,0,0,1045
3ead78b966a8464efa6d53fbb81fcb0efc75ba63,1,Neha Narkhede,2013-04-03 23:40:05-07:00,['5a50f7e555510b8cde08cd588cf4b67b06484b16'],12,14,26,399534,2,,,,1045
afecc9f23108b100b27017974b132331d6bab8e6,0,Neha Narkhede,2013-04-04 16:19:00-07:00,['3ead78b966a8464efa6d53fbb81fcb0efc75ba63'],8,128,136,399670,9,0,0,1,1045
1d3c343f57db55076c7e627bc362b4a64e22dcb2,0,Neha Narkhede,2013-04-04 21:19:52-07:00,['afecc9f23108b100b27017974b132331d6bab8e6'],2,5,7,399677,1,,,,1045
756be5363b83782b55922dfedd8ef9d3b405199c,1,Neha Narkhede,2013-04-04 21:27:20-07:00,['1d3c343f57db55076c7e627bc362b4a64e22dcb2'],40,51,91,399768,11,0,1,1,1045
d4a70eb9b04bd4cec286cfb09eeeb3794ab4f4ee,0,Jun Rao,2013-04-08 09:48:03-07:00,['756be5363b83782b55922dfedd8ef9d3b405199c'],11,29,40,399808,2,0,0,0,1045
ef123c20b82dab2f9bfa125bbb81521b0ff806ae,0,Neha Narkhede,2013-04-09 14:11:07-07:00,['d4a70eb9b04bd4cec286cfb09eeeb3794ab4f4ee'],10,9,19,399827,2,1,1,0,1045
ae362b0864cab835088fc1cd2faf8f646a502af6,1,Jun Rao,2013-04-09 15:37:33-07:00,['ef123c20b82dab2f9bfa125bbb81521b0ff806ae'],24,27,51,399878,10,0,0.333333333,1,1045
6dbf9212ae4dc6ed7f91fc99135b8a3b35ab5edb,1,Neha Narkhede,2013-04-09 16:07:58-07:00,['ae362b0864cab835088fc1cd2faf8f646a502af6'],147,29,176,400054,18,0,0,0,1045
f9e36ca790060a12a51569169cc4a53c4ebc5d74,1,Neha Narkhede,2013-04-11 10:09:24-07:00,['6dbf9212ae4dc6ed7f91fc99135b8a3b35ab5edb'],9,34,43,400097,3,0,0.842105263,1,1045
158baf661c142d1ebeb96a817f5a121ca71360ac,1,Jun Rao,2013-04-11 11:01:11-07:00,['f9e36ca790060a12a51569169cc4a53c4ebc5d74'],3,48,51,400148,3,,,,1045
b29b6296ac5b799a78d61920a3f4131051230a02,1,Jun Rao,2013-04-15 18:09:57-07:00,['158baf661c142d1ebeb96a817f5a121ca71360ac'],4,9,13,400161,2,0,0,1,1045
c5bb1d49942fd94a1ead938567031f9faaeacfbd,1,Jun Rao,2013-04-17 08:20:30-07:00,['b29b6296ac5b799a78d61920a3f4131051230a02'],5,6,11,400172,1,,,,1045
731ba9007d4e2fa2f3a5e44f7b30827975fca420,1,Jun Rao,2013-04-17 21:52:04-07:00,"['9ff4e8eb10e0ddd86f257e99d55971a132426605', '51421fcc0111031bb77f779a6f6c00520d526a34']",788,1700,2488,402660,160,,,,1045
f1d2141ca065d51b41aeac8c7e2124672298d5f0,0,Jun Rao,2013-04-22 16:50:29-07:00,['c5bb1d49942fd94a1ead938567031f9faaeacfbd'],1,9,10,402670,1,0,0,1,1045
1976ce8069818c2c6d093b5b75e8f7b6653120bc,0,Neha Narkhede,2013-04-22 19:20:01-07:00,['f1d2141ca065d51b41aeac8c7e2124672298d5f0'],1,4,5,402675,1,,,,1045
ede85875a3aea5723baf82736cc71bb1a04a6102,1,Joel Koshy,2013-04-23 10:40:47-07:00,['1976ce8069818c2c6d093b5b75e8f7b6653120bc'],4,20,24,402699,3,0.75,1,1,1045
2d7403174f8fd6d35fce05585a7ee6edb8af7dd4,1,Jun Rao,2013-04-25 18:57:31-07:00,['ede85875a3aea5723baf82736cc71bb1a04a6102'],102,111,213,402912,38,0,0,0,1045
6e640e355632d97e322e462c2bbc379c05d407a4,0,Jun Rao,2013-04-25 19:03:21-07:00,['2d7403174f8fd6d35fce05585a7ee6edb8af7dd4'],0,4,4,402916,1,1,1,1,1045
e37a4644209de00f265a5361b31ca63cafc895e9,0,Joel Koshy,2013-04-26 14:13:00-07:00,['6e640e355632d97e322e462c2bbc379c05d407a4'],1,1,2,402918,1,,,,1045
a61e7381382ada885debef15379675fea6974ec1,1,Neha Narkhede,2013-04-29 11:09:19-07:00,['e37a4644209de00f265a5361b31ca63cafc895e9'],47,50,97,403015,14,0,1,0,1045
103aef8ca3c0eb1ff5574df656bfe5273ed9492b,0,Neha Narkhede,2013-04-29 17:04:42-07:00,['a61e7381382ada885debef15379675fea6974ec1'],4,4,8,403023,1,,,,1045
d726e14eea2133cb8a1e52d20f6a17047f726e1c,0,Neha Narkhede,2013-04-30 12:42:15-07:00,['103aef8ca3c0eb1ff5574df656bfe5273ed9492b'],5,9,14,403037,1,0,0,1,1045
cae19aa44f36775d8f95256e63e0cb50a0c0ba9f,0,Neha Narkhede,2013-04-30 15:35:01-07:00,['d726e14eea2133cb8a1e52d20f6a17047f726e1c'],0,9,9,403046,1,,,,1045
988d4d8e65a14390abd748318a64e281e4a37c19,1,Neha Narkhede,2013-04-30 17:20:54-07:00,['cae19aa44f36775d8f95256e63e0cb50a0c0ba9f'],5,6,11,403057,2,,1,,1045
cfdc403e1780882f62df6e9a092cda6bea017fbe,1,Neha Narkhede,2013-05-17 15:45:33-07:00,['988d4d8e65a14390abd748318a64e281e4a37c19'],412,664,1076,404133,42,0.366197183,0.647887324,1,1047
eff59330f2ce19e7074d74f4d268774dd260bca7,0,Neha Narkhede,2013-05-17 16:59:40-07:00,['cfdc403e1780882f62df6e9a092cda6bea017fbe'],31,23,54,404187,2,1,1,0,1047
2d40ca30d34b2d4de35d5b811858b0f915451a19,1,Neha Narkhede,2013-05-21 10:01:51-07:00,['eff59330f2ce19e7074d74f4d268774dd260bca7'],4,19,23,404210,2,0,0.866666667,1,1047
e93937c88639146657f314bfdd29b200c054cade,0,Neha Narkhede,2013-05-22 10:29:45-07:00,['2d40ca30d34b2d4de35d5b811858b0f915451a19'],2,2,4,404214,1,,,,1047
32cd8994bf35b65a8053e0caea9a7710cc889df7,1,Jun Rao,2013-05-22 16:23:21-07:00,['e93937c88639146657f314bfdd29b200c054cade'],2,4,6,404220,1,0,0,1,1047
ffd84eb23fcbb279a63ba5d4cb72077a0c079cff,1,Joel Koshy,2013-05-22 16:26:04-07:00,['32cd8994bf35b65a8053e0caea9a7710cc889df7'],11,49,60,404280,2,0.173913043,0,1,1047
59599cc127f32e17b07092a6c59fce742d027c47,0,Jun Rao,2013-05-24 22:00:57-07:00,['ffd84eb23fcbb279a63ba5d4cb72077a0c079cff'],0,1,1,404281,1,1,1,0,1047
517af4779aed73efa9889b89d99a9c789f091b06,0,Joel Koshy,2013-05-28 09:55:39-07:00,['59599cc127f32e17b07092a6c59fce742d027c47'],1,1,2,404283,2,,,,1047
85c71591548d1069ff78214dd943df87fa87b3db,0,Neha Narkhede,2013-05-29 09:36:52-07:00,['517af4779aed73efa9889b89d99a9c789f091b06'],0,1,1,404284,1,,,,1047
312ed2e67a0bca194ee3012c61239d30d8890566,1,Jun Rao,2013-05-29 09:56:27-07:00,['85c71591548d1069ff78214dd943df87fa87b3db'],3,5,8,404292,1,0,0,1,1047
e4f287db6142cafdf1ddb4ebf7110180ec06f7c4,1,Jun Rao,2013-05-29 10:00:51-07:00,['312ed2e67a0bca194ee3012c61239d30d8890566'],15,22,37,404329,3,0,0,1,1047
bbb161aa250ce3071b03e01d9fa82091f23e1b30,1,Neha Narkhede,2013-05-29 10:05:48-07:00,['e4f287db6142cafdf1ddb4ebf7110180ec06f7c4'],15,21,36,404365,4,1,1,1,1047
436dd25a4885fa13749604111000f52724eb4ccd,1,Jun Rao,2013-05-29 20:26:08-07:00,['bbb161aa250ce3071b03e01d9fa82091f23e1b30'],0,16,16,404381,1,,,,1047
3b470f56b479f618b7e90577f9857b4e25b38c1a,0,Jun Rao,2013-05-29 21:25:34-07:00,['731ba9007d4e2fa2f3a5e44f7b30827975fca420'],2,2,4,404385,1,,,,1047
492ed7a35d031b737b7c98dadcc8be777b9d2d57,0,Jun Rao,2013-05-29 21:34:11-07:00,['436dd25a4885fa13749604111000f52724eb4ccd'],2,3,5,404390,1,,,,1047
dc0de292531f0af0a0eba71d170c7bd2706500d8,0,Jun Rao,2013-05-29 21:43:41-07:00,['492ed7a35d031b737b7c98dadcc8be777b9d2d57'],1,1,2,404392,1,,,,1047
d93cbc610a412d099324c2b4ce04660a00178fa9,0,Jun Rao,2013-05-30 20:32:10-07:00,['dc0de292531f0af0a0eba71d170c7bd2706500d8'],11,6,17,404409,2,1,1,1,1047
1caae2c2a10856ea2a31c8b82f1fae5b107a2a07,0,Jun Rao,2013-05-30 22:16:47-07:00,['d93cbc610a412d099324c2b4ce04660a00178fa9'],41,22,63,404472,3,0,0,1,1047
4850519a2c32b3ee882eb79375ba77de8d0488f7,0,Joel Koshy,2013-05-31 10:43:28-07:00,['1caae2c2a10856ea2a31c8b82f1fae5b107a2a07'],4,38,42,404514,4,,,,1047
658427638f1b00ae1d284e579b4631f7119e54cc,0,Neha Narkhede,2013-06-03 14:06:08-07:00,['4850519a2c32b3ee882eb79375ba77de8d0488f7'],6,4,10,404524,2,,,,1047
4f387ae43544c422b1845b3da5ab09aee8e4acd0,1,Jun Rao,2013-06-03 16:08:37-07:00,['658427638f1b00ae1d284e579b4631f7119e54cc'],84,472,556,405080,14,0.626506024,0.686746988,0.927710843,1050
43c43b1c6d05fb93f4ca96a4e1a1aa8c6fd58d18,0,Jun Rao,2013-06-03 16:51:41-07:00,['4f387ae43544c422b1845b3da5ab09aee8e4acd0'],3,7,10,405090,1,0,1,1,1050
fb37ea8c749c41b1e34158debc7e9221b4db8f31,1,Neha Narkhede,2013-06-03 17:05:17-07:00,['43c43b1c6d05fb93f4ca96a4e1a1aa8c6fd58d18'],10,51,61,405151,4,0,0.411764706,1,1051
9bd2a11486420a313f800d734cab8a858fac6d0e,0,Jun Rao,2013-06-03 18:40:16-07:00,['fb37ea8c749c41b1e34158debc7e9221b4db8f31'],5,6,11,405162,3,1,1,0,1051
9b30aceea3996853b95464d29a2582dbc173d2ac,0,Neha Narkhede,2013-06-06 09:30:33-07:00,['9bd2a11486420a313f800d734cab8a858fac6d0e'],3,3,6,405168,1,,,,1051
ddb7947c05583ea317e8f994f07b83bf6d5213c3,0,Jun Rao,2013-06-09 09:15:17-07:00,['9b30aceea3996853b95464d29a2582dbc173d2ac'],1,0,1,405169,1,1,1,0,1051
6881bf08f26ec64c056c6880922c4321679ba92d,0,Jun Rao,2013-06-11 22:43:41-07:00,['ddb7947c05583ea317e8f994f07b83bf6d5213c3'],1,1,2,405171,1,,,,1051
640026467cf705fbcf6fd6bcada058b18a95bff5,0,Jun Rao,2013-06-12 20:42:40-07:00,['6881bf08f26ec64c056c6880922c4321679ba92d'],1,1,2,405173,1,,,,1051
5bd33c1517bb2e7734166dc3e787ac90a4ef8f86,1,Jun Rao,2013-06-12 20:50:38-07:00,['640026467cf705fbcf6fd6bcada058b18a95bff5'],53,35,88,405261,4,1,1,0,1051
23acbd309f5e17de71db46cb6f1a60c8d38ea4e4,0,Joe Stein,2013-06-13 16:05:56-04:00,['5bd33c1517bb2e7734166dc3e787ac90a4ef8f86'],9,216,225,405486,13,,,,1051
7ad742d802498542d0b60e87c331053805a94ac7,0,Jun Rao,2013-06-17 08:27:59-07:00,['23acbd309f5e17de71db46cb6f1a60c8d38ea4e4'],1,1,2,405488,1,,,,1051
0a8716f8e026abcc586057a4fbaeb32d538cd393,1,Joe Stein,2013-06-17 12:21:22-04:00,['7ad742d802498542d0b60e87c331053805a94ac7'],1,1,2,405490,1,,,,1051
7b43f0132ce93a231b21e943d665ec4227f67b6b,0,Joe Stein,2013-06-19 23:01:26-04:00,['0a8716f8e026abcc586057a4fbaeb32d538cd393'],1,16,17,405507,1,,,,1051
cc6027b3279ac5cd8908d01d35511c93716fbe60,0,Jun Rao,2013-06-20 13:22:56-07:00,['7b43f0132ce93a231b21e943d665ec4227f67b6b'],1,3,4,405511,1,1,1,1,1051
5a084f7be6986ccbe6ede9df0b519d0fd7929d01,0,Jun Rao,2013-06-23 22:03:14-07:00,['cc6027b3279ac5cd8908d01d35511c93716fbe60'],4,4,8,405519,1,,,,1051
5f14a69c2e5c21be9b1257e62040e89f400ac2d9,0,Jun Rao,2013-06-23 22:04:46-07:00,['5a084f7be6986ccbe6ede9df0b519d0fd7929d01'],0,1,1,405520,1,1,1,1,1051
86e314aa7301cc2802bb4910c07f0957e391ed18,1,Jun Rao,2013-06-25 21:12:19-07:00,['5f14a69c2e5c21be9b1257e62040e89f400ac2d9'],2,6,8,405528,2,0,0,1,1051
6b53c649e9d5708d683431522ca750e2fde40fb9,0,Joe Stein,2013-07-07 09:20:08-04:00,['86e314aa7301cc2802bb4910c07f0957e391ed18'],0,4,4,405532,1,,,,1051
c39d37e9dd97bf2462ffbd1a96c0b2cb05034bae,0,Jun Rao,2013-07-08 13:07:16-07:00,['6b53c649e9d5708d683431522ca750e2fde40fb9'],3,3,6,405538,1,,,,1051
c98bdd3e4f6edb7a4db97a876c26e7d37e88e12a,1,Jun Rao,2013-07-08 15:42:24-07:00,"['731ba9007d4e2fa2f3a5e44f7b30827975fca420', '988d4d8e65a14390abd748318a64e281e4a37c19']",936,1198,2134,407672,106,,,,1051
2cda5d1fca90e93ecfd44665fe32033ddce99c52,0,Jun Rao,2013-07-08 15:49:53-07:00,"['c98bdd3e4f6edb7a4db97a876c26e7d37e88e12a', '3b470f56b479f618b7e90577f9857b4e25b38c1a']",2,2,4,407676,1,,,,1051
bf31a6bf705f0438dfc15320ff7047a62eb8f94d,0,Jun Rao,2013-07-10 22:50:28-07:00,['c39d37e9dd97bf2462ffbd1a96c0b2cb05034bae'],71,81,152,407828,1,0,0,1,1051
db37ed0054305a3f5d824166914092076b10ac1e,1,Jun Rao,2013-07-10 23:36:51-07:00,"['2cda5d1fca90e93ecfd44665fe32033ddce99c52', 'c39d37e9dd97bf2462ffbd1a96c0b2cb05034bae']",559,1573,2132,409960,87,,,,1051
c27c768463a5dc6be113f2e5b3e00bf8d9d9d602,1,Jay Kreps,2013-07-11 15:34:57-07:00,['db37ed0054305a3f5d824166914092076b10ac1e'],31,7,38,409998,3,1,0.166666667,0,1051
b1891e700889e8e4ae78a6d73d785ff681ac70b9,0,Joe Stein,2013-07-14 21:21:13-04:00,['bf31a6bf705f0438dfc15320ff7047a62eb8f94d'],1,1,2,410000,1,,,,1051
3817857b15f9ce03f10a9730f0ff4619d728b06f,1,Jun Rao,2013-07-22 21:33:28-07:00,['b1891e700889e8e4ae78a6d73d785ff681ac70b9'],24,448,472,410472,8,0.041666667,0.5,0.8125,1054
d3aa3ef073fe773a10168f925a45747f52c4e3c0,1,Jun Rao,2013-07-23 09:38:52-07:00,['3817857b15f9ce03f10a9730f0ff4619d728b06f'],18,75,93,410565,2,0,1,1,1054
f596ab577869a71811fee6bffdfcd171cd188fa6,0,Jun Rao,2013-07-23 09:46:25-07:00,['d3aa3ef073fe773a10168f925a45747f52c4e3c0'],2,103,105,410670,73,,,,1054
ce7d588055e7d3aacebcc696665b1260fa2e9063,0,Jun Rao,2013-07-23 10:32:30-07:00,['f596ab577869a71811fee6bffdfcd171cd188fa6'],8,7,15,410685,9,0,0,0.5,1054
401d59199cf727f5001dcec3eaa05fa9cdfd079e,1,Neha Narkhede,2013-07-23 11:19:24-07:00,['ce7d588055e7d3aacebcc696665b1260fa2e9063'],8,12,20,410705,1,0,0.333333333,0.666666667,1054
5cf6a546649c213c33ef41d5d47e6af959c0c587,1,Joel Koshy,2013-07-24 11:41:22-07:00,['401d59199cf727f5001dcec3eaa05fa9cdfd079e'],5,52,57,410762,2,0,0.65,1,1055
bc5620cbd270cd8ab443f567fee5203c66db253f,1,Joel Koshy,2013-07-24 18:05:26-07:00,['5cf6a546649c213c33ef41d5d47e6af959c0c587'],12,17,29,410791,1,1,1,,1055
76d39052f717cb6d9fdac6a516df298036b5ffff,0,Jun Rao,2013-07-25 10:10:35-07:00,['bc5620cbd270cd8ab443f567fee5203c66db253f'],7,20,27,410818,1,0,0,1,1055
d285e263bf403f3db27f5d138594c395643a2284,1,Jay Kreps,2013-07-29 15:32:36-07:00,['c27c768463a5dc6be113f2e5b3e00bf8d9d9d602'],39,53,92,410910,10,1,1,0,1055
8edd3e63024832f2c05b5819ab3dfc2e0b300729,1,Joel Koshy,2013-08-01 14:58:25-07:00,['76d39052f717cb6d9fdac6a516df298036b5ffff'],4,7,11,410921,2,,,,1055
b6479e8adca6be8e363d289be29dc755e0655550,0,Joel Koshy,2013-08-01 17:11:58-07:00,['8edd3e63024832f2c05b5819ab3dfc2e0b300729'],15,16,31,410952,3,1,1,0,1055
0c8aefc251d03ba824cecd6acbcbdf143fdebfb8,0,Jun Rao,2013-08-01 21:30:05-07:00,['76d39052f717cb6d9fdac6a516df298036b5ffff'],0,2,2,410954,1,1,1,1,1055
ed3e146cf4b48683756e3c445f539fa99ba9076a,0,Jun Rao,2013-08-01 21:31:46-07:00,"['0c8aefc251d03ba824cecd6acbcbdf143fdebfb8', 'b6479e8adca6be8e363d289be29dc755e0655550']",18,22,40,410994,4,,,,1055
81a9f6a682e5ca35a041717d6c1d4a60af5fd36a,0,Joel Koshy,2013-08-02 16:18:25-07:00,['ed3e146cf4b48683756e3c445f539fa99ba9076a'],5,5,10,411004,1,0,0,1,1055
bdb2fdc6460c48189b487e1e8a75c344e32aa222,0,Jay Kreps,2013-08-03 09:46:50-07:00,['d285e263bf403f3db27f5d138594c395643a2284'],1,1,2,411006,1,,,,1055
493a46613e9a90c0879de96d04c42696fdf95510,0,Jay Kreps,2013-08-03 09:58:48-07:00,['bdb2fdc6460c48189b487e1e8a75c344e32aa222'],2,2,4,411010,1,,,,1055
f3f8fa5c8c17ade2205ef0f80d9092cae640327d,1,Neha Narkhede,2013-08-05 10:05:55-07:00,['81a9f6a682e5ca35a041717d6c1d4a60af5fd36a'],9,33,42,411052,2,0,0,0,1055
14af713252f016929f8150f2f6c2df9d0d447ddb,1,Jay Kreps,2013-08-05 10:10:18-07:00,['f3f8fa5c8c17ade2205ef0f80d9092cae640327d'],109,110,219,411271,21,,,,1055
7fbbb6666bef10f31301c4af17a6077e8895fa06,0,Neha Narkhede,2013-08-05 13:23:55-07:00,['14af713252f016929f8150f2f6c2df9d0d447ddb'],1,1,2,411273,1,,,,1055
1d6ad3d7d441bc7174a445a4e5e49319ee1003eb,1,Jun Rao,2013-08-05 18:59:34-07:00,['7fbbb6666bef10f31301c4af17a6077e8895fa06'],44,50,94,411367,1,0,0,1,1055
df18fe13ad50bba3dbc7d1db0ecd8b698169ade2,1,Jay Kreps,2013-08-05 21:31:52-07:00,['493a46613e9a90c0879de96d04c42696fdf95510'],231,331,562,411929,20,0.438095238,0.628571429,0.99047619,1055
9753d15ef1da0ecab9bbee51d8cdc08c2159c50b,1,Neha Narkhede,2013-08-06 20:42:08-07:00,['1d6ad3d7d441bc7174a445a4e5e49319ee1003eb'],29,29,58,411987,7,1,1,0,1055
e7a546b67cdcdcbb1071ed805a4e4177cbbc15ff,0,Jun Rao,2013-08-07 10:24:21-07:00,['9753d15ef1da0ecab9bbee51d8cdc08c2159c50b'],1,1,2,411989,1,,,,1055
81c49bbdae5e490f9d5dc7b042ee60e617fbb22b,0,Neha Narkhede,2013-08-08 22:06:12-07:00,['e7a546b67cdcdcbb1071ed805a4e4177cbbc15ff'],28,126,154,412143,5,0,0,0.673469388,1055
1d75e09313b5b3f1cde6c39fdda20bc7185cfdf6,1,Neha Narkhede,2013-08-09 15:29:08-07:00,['81c49bbdae5e490f9d5dc7b042ee60e617fbb22b'],126,28,154,412297,5,1,1,0.326530612,1055
1db824ed2fcdaa45c3b1d0dcbf9101299fded09c,1,Neha Narkhede,2013-08-09 15:44:11-07:00,['1d75e09313b5b3f1cde6c39fdda20bc7185cfdf6'],27,126,153,412450,5,0,0,0.673469388,1055
7a9faa49ed5c7581cb2bd6c86b68df06a8879fec,1,Jun Rao,2013-08-16 10:13:30-07:00,['1db824ed2fcdaa45c3b1d0dcbf9101299fded09c'],4,2,6,412456,2,0,0,0,1055
6849da0505da1f38edfbfb64e27cff504231142a,1,Jun Rao,2013-08-16 21:51:35-07:00,['7a9faa49ed5c7581cb2bd6c86b68df06a8879fec'],138,103,241,412697,5,1,1,0.125,1055
ceb55cad5863fa7c39615e48a5d6358eb416a83e,1,Jun Rao,2013-08-19 08:17:26-07:00,['6849da0505da1f38edfbfb64e27cff504231142a'],10,10,20,412717,5,1,1,0,1055
ff6292904a67cd021d365ef1e07c113002b80582,0,Neha Narkhede,2013-08-19 09:45:48-07:00,['df18fe13ad50bba3dbc7d1db0ecd8b698169ade2'],2,7,9,412726,2,1,1,1,1055
d217f4cc276eee021a0d756d3390b633e43f7115,0,Jun Rao,2013-08-22 09:52:48-07:00,['ceb55cad5863fa7c39615e48a5d6358eb416a83e'],54,56,110,412836,2,1,1,1,1055
7640bee3d281e0658f97997738a1f1f599fd4c07,1,Neha Narkhede,2013-08-27 10:16:56-07:00,['d217f4cc276eee021a0d756d3390b633e43f7115'],2,2,4,412840,1,,,,1055
39fc578d5da3f871fbcd5205de010f1f574507d1,1,Neha Narkhede,2013-08-27 22:12:35-07:00,['7640bee3d281e0658f97997738a1f1f599fd4c07'],87,162,249,413089,4,0.106060606,0.378787879,0.909090909,1055
51de7c55d2b3107b79953f401fc8c9530bd0eea0,0,Jun Rao,2013-08-28 09:51:19-07:00,['7640bee3d281e0658f97997738a1f1f599fd4c07'],1,1,2,413091,1,,,,1055
ea54700d57e18e59e210814b70bddca38739d414,0,Jun Rao,2013-08-28 09:53:07-07:00,"['51de7c55d2b3107b79953f401fc8c9530bd0eea0', '39fc578d5da3f871fbcd5205de010f1f574507d1']",87,162,249,413340,4,,,,1055
f89ddced1ba058f0c51697957cde8bb2e2b05c4d,1,Neha Narkhede,2013-08-28 10:16:59-07:00,['ea54700d57e18e59e210814b70bddca38739d414'],20,86,106,413446,5,0.260869565,0.086956522,0.956521739,1055
20953b52558935ba210eaee18e9504bf16bfec27,1,Jun Rao,2013-09-03 20:50:45-07:00,['f89ddced1ba058f0c51697957cde8bb2e2b05c4d'],1,14,15,413461,1,0,0,1,1055
da4512174b6f7c395ffe053a86d2c6bb19d2538a,0,Jun Rao,2013-09-05 07:45:01-07:00,['20953b52558935ba210eaee18e9504bf16bfec27'],1,12,13,413474,1,0,0,1,1055
c12d2ea9e5b4bdcf9aeb07c89c69553a9f270c82,1,Neha Narkhede,2013-09-09 15:21:05-07:00,['da4512174b6f7c395ffe053a86d2c6bb19d2538a'],185,266,451,413925,63,0.545454545,1,0.909090909,1056
75d95d9b0770d187916bed1dd1ca7a3e82ef08b0,1,Jun Rao,2013-09-11 09:49:48-07:00,"['ff6292904a67cd021d365ef1e07c113002b80582', 'da4512174b6f7c395ffe053a86d2c6bb19d2538a']",575,1530,2105,416030,150,,,,1056
8e554c4d2acf5108805905b9f06198f20398ee3a,1,Neha Narkhede,2013-09-13 12:55:53-07:00,['75d95d9b0770d187916bed1dd1ca7a3e82ef08b0'],191,230,421,416451,67,0.75,1,0.821428571,1056
fed901cad2e7f8fe8dffd36b72006d912c18743a,0,Neha Narkhede,2013-09-13 13:17:17-07:00,['8e554c4d2acf5108805905b9f06198f20398ee3a'],0,74,74,416525,2,,,,1058
324936609f9e087aa4168e7f7581148e34b346a4,0,Jun Rao,2013-09-13 15:36:53-07:00,"['fed901cad2e7f8fe8dffd36b72006d912c18743a', 'c12d2ea9e5b4bdcf9aeb07c89c69553a9f270c82']",0,0,0,416525,0,,,,1058
0c1885b800077e4d360935a6d91fe1068a684560,0,Jun Rao,2013-09-13 16:17:55-07:00,['c12d2ea9e5b4bdcf9aeb07c89c69553a9f270c82'],5,10,15,416540,1,1,1,0,1058
aebf746190685d055358ca122aedc424fe024afa,0,Jun Rao,2013-09-13 16:29:39-07:00,['0c1885b800077e4d360935a6d91fe1068a684560'],1,2,3,416543,1,,,,1058
9feef9fd60920cf25a88e03dc5711745c0b7c0c5,0,Jay Kreps,2013-09-15 08:18:07-07:00,['324936609f9e087aa4168e7f7581148e34b346a4'],11,11,22,416565,1,,,,1058
c6ca971738700643ecba78ad1f3998062481aab9,1,Neha Narkhede,2013-09-17 14:22:48-07:00,['aebf746190685d055358ca122aedc424fe024afa'],12,2,14,416579,1,1,1,0,1058
d6f95cf97a928067977fef5216e954d5147fd138,0,Neha Narkhede,2013-09-17 20:44:33-07:00,['c6ca971738700643ecba78ad1f3998062481aab9'],0,106,106,416685,2,0.113924051,0.113924051,1,1060
8959690e96f22e6905f80c76faa355448e4d2e51,1,Neha Narkhede,2013-09-17 20:48:15-07:00,['9feef9fd60920cf25a88e03dc5711745c0b7c0c5'],0,106,106,416791,2,0.113924051,0.113924051,1,1062
61b8b2bf818c36e5844a32b24b2855c32bd34254,0,Neha Narkhede,2013-09-20 09:56:28-07:00,['d6f95cf97a928067977fef5216e954d5147fd138'],1,1,2,416793,1,,,,1062
bb7b45cd5d454d64c3454b01f8f3f1e13ed26ff3,0,Jun Rao,2013-09-24 08:31:18-07:00,['61b8b2bf818c36e5844a32b24b2855c32bd34254'],4,5,9,416802,2,,,,1062
56ada9576204b754e792a3d3c9063908f4f24b4d,0,Joe Stein,2013-09-26 23:01:09-04:00,['bb7b45cd5d454d64c3454b01f8f3f1e13ed26ff3'],2,3,5,416807,1,,,,1062
dcbf0bf0b7e949e0f2652d6f3bd967349813bf6f,0,Neha Narkhede,2013-10-01 13:22:46-07:00,['56ada9576204b754e792a3d3c9063908f4f24b4d'],1,4,5,416812,1,1,1,1,1062
93921a3a5720a1ffd9e272d59d8a7627da28e89e,0,Jun Rao,2013-10-03 17:46:53-07:00,['dcbf0bf0b7e949e0f2652d6f3bd967349813bf6f'],2,2,4,416816,1,,,,1062
2c6d3c7b450e50e2efaab8d55a5574b2ec1cd376,1,Jun Rao,2013-10-06 09:11:07-07:00,['93921a3a5720a1ffd9e272d59d8a7627da28e89e'],0,69,69,416885,2,0,0,0,1063
71ed6ca3368ff38909f502565a4bf0f39e70fc6c,1,Jun Rao,2013-10-07 09:22:12-07:00,['2c6d3c7b450e50e2efaab8d55a5574b2ec1cd376'],138,63,201,417086,3,1,1,0,1063
40efe0a972e8a1673b51b05f3937265d97acb01c,0,Jun Rao,2013-10-07 14:00:14-07:00,['71ed6ca3368ff38909f502565a4bf0f39e70fc6c'],4,4,8,417094,2,,,,1063
1cb217579bbb1f9d4df24a3d32bf88644697b7fe,1,Jun Rao,2013-10-07 14:05:40-07:00,['40efe0a972e8a1673b51b05f3937265d97acb01c'],6,32,38,417132,1,1,1,1,1063
bfc4ba499521addf3d109c3fbe77b8908eabc644,0,Jun Rao,2013-10-07 14:29:16-07:00,"['8959690e96f22e6905f80c76faa355448e4d2e51', '1cb217579bbb1f9d4df24a3d32bf88644697b7fe']",174,195,369,417501,14,,,,1063
f53fe18361a434c388e88b0eed90b8faa0983fd8,0,Jun Rao,2013-10-08 09:12:28-07:00,['1cb217579bbb1f9d4df24a3d32bf88644697b7fe'],1,6,7,417508,1,1,1,1,1063
a6904a2644a95a3d8d2a59e3915a76e7ee43557a,0,Jun Rao,2013-10-08 09:22:32-07:00,['f53fe18361a434c388e88b0eed90b8faa0983fd8'],4,10,14,417522,1,0,1,1,1063
b384c27c33dc12d466b4e432b03faea5f88b55aa,0,Jun Rao,2013-10-08 13:04:12-07:00,['a6904a2644a95a3d8d2a59e3915a76e7ee43557a'],10,18,28,417550,1,,,,1063
343a1e2660aa7c3c847c459360a5fbbcb065c759,0,Jun Rao,2013-10-08 13:05:40-07:00,"['bfc4ba499521addf3d109c3fbe77b8908eabc644', 'b384c27c33dc12d466b4e432b03faea5f88b55aa']",15,34,49,417599,3,,,,1063
c304a92a1ce39cc7b7e329fde0b97f93cb8caee3,0,Sriram Subramanian,2013-10-08 23:42:34-07:00,['343a1e2660aa7c3c847c459360a5fbbcb065c759'],140,76,216,417815,4,0.675,1,0,1063
b998f5d8790cf6f4d079cba399f5c5ea8ea43e68,0,Sriram Subramanian,2013-10-09 10:47:18-07:00,['c304a92a1ce39cc7b7e329fde0b97f93cb8caee3'],1,1,2,417817,1,,0,,1063
7c920e97ef9e2db80774d6ccd9b85e3934e92645,0,Sriram Subramanian,2013-10-09 10:54:09-07:00,['b998f5d8790cf6f4d079cba399f5c5ea8ea43e68'],2,3,5,417822,1,0,1,1,1063
8d4dbe60f188c48a7f0d552b7b1109fb8e126521,1,Jun Rao,2013-10-09 20:44:49-07:00,['343a1e2660aa7c3c847c459360a5fbbcb065c759'],140,76,216,418038,4,0.666666667,0.666666667,0,1063
ace95c48a924db69ea6c6053d4cc2943c7b8958a,0,Jun Rao,2013-10-10 07:58:10-07:00,['8d4dbe60f188c48a7f0d552b7b1109fb8e126521'],18,0,18,418056,1,,,,1063
b0fecacbe8232deea5ea8a71e8dd9b57c7cf0435,1,Joe Stein,2013-10-11 00:59:43-04:00,['ace95c48a924db69ea6c6053d4cc2943c7b8958a'],1,2,3,418059,1,,,,1063
3e7c9c6abfed90b4e6e0e1bb3c806adf1c6bbbe9,1,Jay Kreps,2013-10-14 09:39:10-07:00,['b0fecacbe8232deea5ea8a71e8dd9b57c7cf0435'],29,15,44,418103,14,,,,1063
062d910e3235ef71b1e7a01472f4360658c83bea,0,Neha Narkhede,2013-10-15 09:30:28-07:00,['3e7c9c6abfed90b4e6e0e1bb3c806adf1c6bbbe9'],1,1,2,418105,1,,,,1063
e351039b1a9ed188e3be1581f31674b876094274,0,Jun Rao,2013-10-15 09:47:40-07:00,['062d910e3235ef71b1e7a01472f4360658c83bea'],1,1,2,418107,1,,,,1063
a160f1023b23c7d9d79c7970a72f48ae883dfe07,1,Neha Narkhede,2013-10-15 09:58:08-07:00,['e351039b1a9ed188e3be1581f31674b876094274'],17,48,65,418172,2,0,0,1,1063
c98b6de15db9a2ce72f44a5b2736f74de5066113,1,Jay Kreps,2013-10-15 14:06:48-07:00,['a160f1023b23c7d9d79c7970a72f48ae883dfe07'],61,138,199,418371,8,1,1,1,1064
ccdb56201e494d6025e47a48c82f233ccc9386ac,0,Jay Kreps,2013-10-15 14:06:48-07:00,['c98b6de15db9a2ce72f44a5b2736f74de5066113'],9,9,18,418389,2,1,0,0,1064
d5dfa28596857d5564c14b598901653714717bdc,0,Joel Koshy,2013-10-16 09:36:40-07:00,['ccdb56201e494d6025e47a48c82f233ccc9386ac'],1,76,77,418466,3,0,0,0,1065
b448d4e075f0f138530e6cfc0634f4035c8d1878,1,Neha Narkhede,2013-10-16 16:37:03-07:00,['d5dfa28596857d5564c14b598901653714717bdc'],9,3,12,418478,1,1,1,0,1065
c66e4d58687bee54bae6a31e976d4b9b63c36de1,0,Jun Rao,2013-10-17 09:37:06-07:00,['b448d4e075f0f138530e6cfc0634f4035c8d1878'],1,1,2,418480,1,,,,1065
d0e948ca86730a900adbe3300fe4af01cf15922a,1,Jun Rao,2013-10-17 10:26:53-07:00,['c66e4d58687bee54bae6a31e976d4b9b63c36de1'],9,9,18,418498,1,0,1,1,1065
d030778861e6d274281adf7e0311dc4d51448c84,1,Jay Kreps,2013-10-18 11:33:50-07:00,['d0e948ca86730a900adbe3300fe4af01cf15922a'],14,22,36,418534,3,0.7,0.7,1,1065
b61d147fd0774370a41d2a6cadcbfd30c7703a34,0,Neha Narkhede,2013-10-19 16:38:07-07:00,['d030778861e6d274281adf7e0311dc4d51448c84'],1,6,7,418541,1,0,0,1,1065
0198e67febfa805b7a5d7ef8a939254bbe0b0d00,1,Neha Narkhede,2013-10-21 11:15:28-07:00,['b61d147fd0774370a41d2a6cadcbfd30c7703a34'],1,1,2,418543,1,,,,1065
0e90c246c68954204ea524139023d97173bfde56,1,Jay Kreps,2013-10-24 21:33:53-07:00,['0198e67febfa805b7a5d7ef8a939254bbe0b0d00'],5,5,10,418553,1,,,,1065
274b12f3351e007f76e8ef64ba9baf5b0824e690,1,Jun Rao,2013-10-25 08:12:36-07:00,['0e90c246c68954204ea524139023d97173bfde56'],2,80,82,418635,3,1,1,1,1066
bd49e4f3e77c86a9cd93262e628143fff762d4ee,1,Jun Rao,2013-10-29 13:11:17-07:00,['274b12f3351e007f76e8ef64ba9baf5b0824e690'],179,275,454,419089,9,0.179487179,0,1,1066
bf4dbd5ee3be67a214c01aae0bf01b1492994cf5,1,Neha Narkhede,2013-10-30 16:22:00-07:00,['bd49e4f3e77c86a9cd93262e628143fff762d4ee'],11,20,31,419120,2,0.714285714,1,1,1066
a55ec0620f6ce805fafe2e1d4035ec3e0ab4e0d0,1,Jun Rao,2013-10-30 21:06:23-07:00,['bf4dbd5ee3be67a214c01aae0bf01b1492994cf5'],22,118,140,419260,7,1,1,1,1067
ec547737de730cddb29200eba62c0165f901447b,1,Neha Narkhede,2013-10-31 21:14:17-07:00,['a55ec0620f6ce805fafe2e1d4035ec3e0ab4e0d0'],2,45,47,419307,3,0,0.6875,1,1067
a4fafefdb3a2701d30f14feed3be11f1c0905c31,1,Neha Narkhede,2013-10-31 21:27:38-07:00,['ec547737de730cddb29200eba62c0165f901447b'],3,2,5,419312,2,1,1,0,1067
e602ed0582b04d7b6fd442990dd3182f1e2834a5,0,Neha Narkhede,2013-11-01 10:03:37-07:00,['a4fafefdb3a2701d30f14feed3be11f1c0905c31'],1,1,2,419314,1,,,,1067
df7f7a255bdd803cddfdf3fea2ace4f1ae366377,1,Neha Narkhede,2013-11-01 10:27:36-07:00,['e602ed0582b04d7b6fd442990dd3182f1e2834a5'],72,214,286,419600,8,0,0.25,0.770833333,1068
7d1ac1d806ea893a1503c35dbd6087941dc5c25c,1,Neha Narkhede,2013-11-03 16:18:11-08:00,['df7f7a255bdd803cddfdf3fea2ace4f1ae366377'],1,1,2,419602,1,,,,1068
98616188645d1d57e98a6b92f615345fc7653d9d,0,Neha Narkhede,2013-11-05 18:14:08-08:00,['7d1ac1d806ea893a1503c35dbd6087941dc5c25c'],6,6,12,419614,1,,,,1068
a700c99efddb3ae83b42a2bcf5c58dd16ee7edf1,0,Joe Stein,2013-11-07 20:39:43-05:00,['98616188645d1d57e98a6b92f615345fc7653d9d'],15,0,15,419629,1,,,,1068
eedbea6526986783257ad0e025c451a8ee3d9095,1,Neha Narkhede,2013-11-07 17:45:39-08:00,['a700c99efddb3ae83b42a2bcf5c58dd16ee7edf1'],23,50,73,419702,4,0.8,1,1,1068
793b60763c0bb073dd5cacf3117b34877f557fb8,0,Sriram Subramanian,2013-11-18 03:15:27-08:00,"['7c920e97ef9e2db80774d6ccd9b85e3934e92645', 'eedbea6526986783257ad0e025c451a8ee3d9095']",461,1106,1567,421269,62,,,,1068
7c54e39bd48c9908c220ee68cee608a0d0cf5d9d,0,Jun Rao,2013-11-18 18:31:32-08:00,['eedbea6526986783257ad0e025c451a8ee3d9095'],47,62,109,421378,7,1,1,1,1068
58789d7cbe21f0b29f4a94a1fe75d1f1e0851d86,1,Jun Rao,2013-11-18 21:02:00-08:00,['7c54e39bd48c9908c220ee68cee608a0d0cf5d9d'],14,74,88,421466,4,,,,1068
39c5b75c9675636d1f77a549fc55b527ed1d7f38,0,Sriram Subramanian,2013-11-19 16:04:16-08:00,"['793b60763c0bb073dd5cacf3117b34877f557fb8', '58789d7cbe21f0b29f4a94a1fe75d1f1e0851d86']",61,136,197,421663,11,,,,1068
5bcb41835f58be142bb6ac7c3155dfc163a516b4,1,Sriram Subramanian,2013-11-19 17:03:39-08:00,['39c5b75c9675636d1f77a549fc55b527ed1d7f38'],5,74,79,421742,2,0.045454545,1,1,1068
09e807bda103fe632e62312f036b850a59576f36,0,Sriram Subramanian,2013-11-19 17:07:43-08:00,['5bcb41835f58be142bb6ac7c3155dfc163a516b4'],8,0,8,421750,1,1,1,0,1068
a4cd17a37bf0f5ccae7b8f6a404c8b8c0de4dbad,0,Sriram Subramanian,2013-11-19 17:15:01-08:00,['09e807bda103fe632e62312f036b850a59576f36'],10,1,11,421761,2,,,,1068
033872b316fd5a68d7463138d8199fb5d821f41b,1,Sriram Subramanian,2013-11-19 17:38:13-08:00,['a4cd17a37bf0f5ccae7b8f6a404c8b8c0de4dbad'],4,5,9,421770,1,1,1,1,1068
440e45e5131131a30987b991eabfee147061c42b,1,Jun Rao,2013-11-20 09:21:56-08:00,['58789d7cbe21f0b29f4a94a1fe75d1f1e0851d86'],1,392,393,422163,2,0.206766917,0.206766917,0.988721805,1069
9b0776d157afd9eacddb84a99f2420fa9c0d505b,1,Jun Rao,2013-11-20 10:05:40-08:00,['440e45e5131131a30987b991eabfee147061c42b'],185,72,257,422420,16,0,0,0.028169014,1069
c2dd071b52632c638fefcf864cc2aa1a2cac629b,0,Joe Stein,2013-11-20 15:16:40-07:00,['9b0776d157afd9eacddb84a99f2420fa9c0d505b'],0,2,2,422422,1,,,,1069
cd81d37ac872654c0cc68fab830ee457c56b7c6a,0,Jun Rao,2013-11-20 21:42:46-08:00,['c2dd071b52632c638fefcf864cc2aa1a2cac629b'],8,4,12,422434,2,0,0,0,1069
7f32a1c276f5a027870d7cc340cce34274d9a896,0,Sriram Subramanian,2013-11-21 09:25:35-08:00,"['033872b316fd5a68d7463138d8199fb5d821f41b', 'cd81d37ac872654c0cc68fab830ee457c56b7c6a']",194,470,664,423098,21,,,,1069
99dd94c9b659775e738e12330d90ae7ebe7bdbb6,0,Jun Rao,2013-11-21 21:37:34-08:00,['cd81d37ac872654c0cc68fab830ee457c56b7c6a'],2,1,3,423101,1,0,0,0,1069
2477a7468e7bfe728abae793236d8aaf1c211d3b,0,Jun Rao,2013-11-22 08:25:05-08:00,['99dd94c9b659775e738e12330d90ae7ebe7bdbb6'],4,8,12,423113,1,1,1,1,1069
87efda7f818218e0868be7032c73c994d75931fd,0,Jun Rao,2013-11-22 09:16:39-08:00,['2477a7468e7bfe728abae793236d8aaf1c211d3b'],36,11,47,423160,4,0,0,0,1069
bb2dc49bde2f77b7ceb9e47a0f710204530774a4,0,Joe Stein,2013-11-24 21:33:45-05:00,['87efda7f818218e0868be7032c73c994d75931fd'],1,3,4,423164,1,,,,1069
583044cd5109cd060bdfc9e516f4c85d1d4e73a0,1,Jun Rao,2013-11-25 15:34:04-08:00,['bb2dc49bde2f77b7ceb9e47a0f710204530774a4'],47,62,109,423273,7,1,1,1,1069
ac239da502c4de10f63b0b5d638c3d8b11711eae,0,Joel Koshy,2013-11-25 19:46:42-08:00,['583044cd5109cd060bdfc9e516f4c85d1d4e73a0'],8,12,20,423293,4,,,,1069
df288b75a0c6685deeda99ce4db3e17fff39b0ad,0,Jun Rao,2013-11-27 21:56:55-08:00,['ac239da502c4de10f63b0b5d638c3d8b11711eae'],5,51,56,423349,3,0.275862069,1,1,1069
224f192c776b4348596fbf068771c98aa9db9f3d,1,Jun Rao,2013-11-29 09:29:56-08:00,['df288b75a0c6685deeda99ce4db3e17fff39b0ad'],7,17,24,423373,1,0,0,0,1069
7c7951426df5fe8a65b176fe49584868e7af3b4f,1,Jun Rao,2013-12-02 13:58:10-08:00,['224f192c776b4348596fbf068771c98aa9db9f3d'],44,52,96,423469,5,0.25,0.25,1,1069
b638b0f34623769e2efbcb7c2c36f7b742f6b690,0,Jun Rao,2013-12-02 21:55:48-08:00,['7c7951426df5fe8a65b176fe49584868e7af3b4f'],12,0,12,423481,1,,,,1069
ea3961fc84c5a45a5458b9db4080b32f28855f7b,1,Neha Narkhede,2013-12-03 16:25:40-08:00,['b638b0f34623769e2efbcb7c2c36f7b742f6b690'],118,123,241,423722,2,1,1,0,1069
6c36beef873e8696e3e68b38c886893e01ce6dbb,1,Jun Rao,2013-12-03 16:50:18-08:00,['ea3961fc84c5a45a5458b9db4080b32f28855f7b'],4,4,8,423730,1,,,,1069
8a2ba3f6f2eab88db4b5ea6d880ec2feba93276c,1,Jun Rao,2013-12-04 15:47:18-08:00,['6c36beef873e8696e3e68b38c886893e01ce6dbb'],1,1,2,423732,1,,,,1069
7dee06ee99bf2610d71df04e4e5238a10a8388a2,0,Jun Rao,2013-12-05 09:38:24-08:00,['8a2ba3f6f2eab88db4b5ea6d880ec2feba93276c'],2,5,7,423739,1,0,0,1,1069
876cfdb59730f0e0c0f87aed15d65fa747c19bd3,1,Neha Narkhede,2013-12-05 16:57:26-08:00,['7dee06ee99bf2610d71df04e4e5238a10a8388a2'],4,19,23,423762,1,0,1,1,1069
32aae7202ce041128fb1f6d2ea43580ee7864d74,1,Neha Narkhede,2013-12-06 16:26:53-08:00,['876cfdb59730f0e0c0f87aed15d65fa747c19bd3'],82,106,188,423950,10,0.142857143,0.666666667,0.714285714,1069
55d77c67c236488df2b9f6bb59d99eeb645a0553,1,Sriram Subramanian,2013-12-09 22:51:41-08:00,['7f32a1c276f5a027870d7cc340cce34274d9a896'],31,56,87,424037,1,0.6,0,1,1069
6bc290f66d738a9133afe93e2a6ac64f1344c111,1,Neha Narkhede,2013-12-11 11:18:24-08:00,['32aae7202ce041128fb1f6d2ea43580ee7864d74'],22,51,73,424110,6,0.62962963,0.740740741,1,1069
169a79e687799bffd5cf1f4bb86855bf3725cb88,0,Neha Narkhede,2013-12-11 16:20:38-08:00,['6bc290f66d738a9133afe93e2a6ac64f1344c111'],0,15,15,424125,1,0,0,1,1069
dd58d753ce3ffb41776a6fa6322cb822f2222500,0,Neha Narkhede,2013-12-11 16:34:34-08:00,['169a79e687799bffd5cf1f4bb86855bf3725cb88'],1,4,5,424130,3,1,1,1,1069
b5d16871c02a585643aec3229546af04721bb42c,1,Neha Narkhede,2013-12-19 12:54:10-08:00,['dd58d753ce3ffb41776a6fa6322cb822f2222500'],59,72,131,424261,2,1,0.785714286,1,1069
425af9b4a7afeb21191c33ba6bc3f20623a3f0b3,1,Sriram Subramanian,2013-12-20 11:11:20-08:00,['55d77c67c236488df2b9f6bb59d99eeb645a0553'],19,29,48,424309,1,0,0,1,1069
e88f1acdaac9fe738787ccb8375519293c913a37,0,Sriram Subramanian,2013-12-20 11:22:26-08:00,['425af9b4a7afeb21191c33ba6bc3f20623a3f0b3'],7,7,14,424323,1,0,0,,1069
72610d1fc0bbf706a14f1605bf9862ea3830e707,0,Sriram Subramanian,2013-12-20 13:01:45-08:00,"['e88f1acdaac9fe738787ccb8375519293c913a37', 'b5d16871c02a585643aec3229546af04721bb42c']",447,605,1052,425375,40,,,,1069
b23cf1968f2aa4f8dbd6629634ae813b5e14564c,1,Sriram Subramanian,2013-12-20 14:04:23-08:00,['b5d16871c02a585643aec3229546af04721bb42c'],2,102,104,425479,2,0.175675676,0.256756757,1,1069
10fa20001dd22a2cfc7da065d75d7cf6c0009b42,1,Neha Narkhede,2013-12-20 14:39:03-08:00,['b5d16871c02a585643aec3229546af04721bb42c'],28,40,68,425547,2,1,1,1,1069
a119f532c8b310122d85391efe11fd26027ef7f9,0,Neha Narkhede,2014-01-03 11:06:04-08:00,"['10fa20001dd22a2cfc7da065d75d7cf6c0009b42', 'b23cf1968f2aa4f8dbd6629634ae813b5e14564c']",6,108,114,425661,2,,,,1069
3f88be6318670864b372deccb2af705e8c84382a,1,Neha Narkhede,2014-01-03 11:29:53-08:00,['a119f532c8b310122d85391efe11fd26027ef7f9'],15,39,54,425715,2,0.3,0.3,1,1069
15f3c8417e07e6bc6cbe0c5991f5641396c61b24,1,Jun Rao,2014-01-03 12:21:49-08:00,['3f88be6318670864b372deccb2af705e8c84382a'],5,5,10,425725,1,0,0,,1069
f63e3f730673f60ca179030cf0d64380689c2a40,1,Jun Rao,2014-01-07 22:36:00-08:00,['15f3c8417e07e6bc6cbe0c5991f5641396c61b24'],208,432,640,426365,12,0.580357143,0.901785714,0.6875,1071
d2e2c607d1490cf2121dd64f4e79f34ba64c8ed7,1,Neha Narkhede,2014-01-13 13:59:33-08:00,['f63e3f730673f60ca179030cf0d64380689c2a40'],73,199,272,426637,22,0.801724138,0.698275862,1,1071
d401292abb0f3660895173d4613f712058ae097f,0,Joe Stein,2014-01-13 21:16:32-05:00,['d2e2c607d1490cf2121dd64f4e79f34ba64c8ed7'],5,5,10,426647,1,,,,1071
855340a2e65ffbb79520c49d0b9a231b94acd538,0,Jun Rao,2014-01-15 08:37:14-08:00,['d401292abb0f3660895173d4613f712058ae097f'],130,146,276,426923,6,0.476190476,0.476190476,0.142857143,1071
c2ed6415fcfa02d08dde031f0f799f5a0f18d8c5,0,Jun Rao,2014-01-15 20:57:07-08:00,['855340a2e65ffbb79520c49d0b9a231b94acd538'],3,3,6,426929,1,,,,1071
e1f7bea157c828d1eefdc5f9cf0337be79d809eb,0,Jun Rao,2014-01-17 08:29:28-08:00,['c2ed6415fcfa02d08dde031f0f799f5a0f18d8c5'],3,3,6,426935,1,,,,1071
c9028ad8c5d8bac9278836ebbc21fada5e6b562b,0,Jun Rao,2014-01-24 09:58:28-08:00,['e1f7bea157c828d1eefdc5f9cf0337be79d809eb'],3,3,6,426941,1,,,,1071
26a02c32dda0222c6ab1ad897992558c1c1eab76,0,Joel Koshy,2014-01-24 18:00:01-08:00,['c9028ad8c5d8bac9278836ebbc21fada5e6b562b'],1,5,6,426947,2,0,0,1,1071
3f473566ab2ef51f17034dc02f632df5d38fe307,1,Sriram Subramanian,2014-01-27 13:25:06-08:00,"['72610d1fc0bbf706a14f1605bf9862ea3830e707', '26a02c32dda0222c6ab1ad897992558c1c1eab76']",493,893,1386,428333,48,,,,1071
269d16d3c915d09f650ae32aa81542bd8522ca68,1,Jay Kreps,2014-01-28 11:15:05-08:00,['26a02c32dda0222c6ab1ad897992558c1c1eab76'],0,11720,11720,440053,121,0.666383881,0.86892895,0.846447508,1191
9c1d8e35c5913d22098cf80ae69035131cfee87f,0,Neha Narkhede,2014-01-30 08:37:28-08:00,['269d16d3c915d09f650ae32aa81542bd8522ca68'],1,12,13,440066,4,0,1,0,1191
2b0c6a7d7b83a58362e32191674e55da25d3077f,0,Jun Rao,2014-01-30 10:14:53-08:00,['9c1d8e35c5913d22098cf80ae69035131cfee87f'],5,4,9,440075,1,1,1,0,1191
74b42a8f810281e26d80d764fc8f391836b87844,0,Neha Narkhede,2014-02-03 21:16:55-08:00,['2b0c6a7d7b83a58362e32191674e55da25d3077f'],4,4,8,440083,4,,,,1191
c9052c5ff510f4b750d456b7efa159b39501da98,0,Jun Rao,2014-02-04 08:04:35-08:00,['74b42a8f810281e26d80d764fc8f391836b87844'],1,1,2,440085,1,,,,1191
253f86e31062fb86401abdc13835c251eef47417,1,Jay Kreps,2014-02-04 08:39:56-08:00,['c9052c5ff510f4b750d456b7efa159b39501da98'],641,652,1293,441378,38,0.864864865,0.72972973,1,1196
2d848c5ae0d10fc4d49ad9a3477b8c46f1c3dab7,0,Sriram Subramanian,2014-02-05 22:06:42-08:00,"['3f473566ab2ef51f17034dc02f632df5d38fe307', '253f86e31062fb86401abdc13835c251eef47417']",11,11752,11763,453141,128,,,,1196
3220af1fe2fad8da1f5bcc101ab9d3e8919b03bd,0,Jay Kreps,2014-02-06 10:49:37-08:00,['253f86e31062fb86401abdc13835c251eef47417'],36,136,172,453313,5,0.065789474,0.407894737,0.815789474,1196
fa6339c19cd06880d32ec9a5ee6b66e7f1488dcf,1,Jay Kreps,2014-02-06 16:25:11-08:00,['3220af1fe2fad8da1f5bcc101ab9d3e8919b03bd'],362,441,803,454116,116,1,1,1,1196
167acb832d7f104eb2c344dcfd7b914c763d881d,1,Neha Narkhede,2014-02-06 20:18:24-08:00,['fa6339c19cd06880d32ec9a5ee6b66e7f1488dcf'],341,1444,1785,455901,28,0.298998569,0.907010014,0.928469242,1198
1032bf74054a198d5d663713be1152a9216ca150,1,Jun Rao,2014-02-06 21:00:17-08:00,['167acb832d7f104eb2c344dcfd7b914c763d881d'],59,90,149,456050,2,0.791666667,0.708333333,1,1198
8c9a7811c492d23b706ff2c3a728d8c49a387885,1,Neha Narkhede,2014-02-06 21:19:34-08:00,['1032bf74054a198d5d663713be1152a9216ca150'],1,1,2,456052,1,,,,1198
52614ad65e698a9860ab22b2ce66bae773263b36,1,Jun Rao,2014-02-07 13:48:04-08:00,['8c9a7811c492d23b706ff2c3a728d8c49a387885'],46,695,741,456793,13,,,,1208
36eae8f63c81f8d38c2351054c15bf7d5eb612d9,0,Jun Rao,2014-02-07 14:19:06-08:00,['52614ad65e698a9860ab22b2ce66bae773263b36'],14,2006,2020,458813,125,,,,1208
1a7048d41bb56118d4f31ff972618ebe13007857,1,Neha Narkhede,2014-02-08 11:09:39-08:00,['36eae8f63c81f8d38c2351054c15bf7d5eb612d9'],102,193,295,459108,7,0.5,0.028571429,0.957142857,1208
8014b6ff694d07956da10135508d98c625f3da3d,0,Joe Stein,2014-02-09 09:16:06-05:00,['1a7048d41bb56118d4f31ff972618ebe13007857'],35,0,35,459143,1,,,,1208
962b5475cbccfba7dbc424915fe517123f5e5203,0,Jay Kreps,2014-02-09 15:20:32-08:00,['8014b6ff694d07956da10135508d98c625f3da3d'],3,8,11,459154,2,1,1,1,1208
d2ec321a03e654552ee364f6572437f233b0c226,0,Jay Kreps,2014-02-09 15:20:33-08:00,['962b5475cbccfba7dbc424915fe517123f5e5203'],59,117,176,459330,4,0.88,0.84,1,1210
02bb382621ea5079ac77094928d12a129db251c0,0,Jay Kreps,2014-02-09 15:20:33-08:00,['d2ec321a03e654552ee364f6572437f233b0c226'],1,1,2,459332,1,,,,1210
6b80dbb97b3d9b533f60d5c09639ea6c7c5f2be5,1,Jay Kreps,2014-02-10 20:49:08-08:00,['02bb382621ea5079ac77094928d12a129db251c0'],186,213,399,459731,7,0.176470588,1,1,1210
71e21c6bacb75bf7b5f65dc67c921d4c7583fa12,1,Neha Narkhede,2014-02-10 21:40:34-08:00,['6b80dbb97b3d9b533f60d5c09639ea6c7c5f2be5'],0,185,185,459916,2,0.394957983,0.394957983,1,1211
a0939f412d7c5c0e294f7d1c2779ae9321338155,1,Neha Narkhede,2014-02-11 14:25:40-08:00,['71e21c6bacb75bf7b5f65dc67c921d4c7583fa12'],0,16,16,459932,2,1,1,0,1211
d6303ec79e6871c901951e7dcde93d4996b52c49,1,Neha Narkhede,2014-02-11 18:03:19-08:00,['a0939f412d7c5c0e294f7d1c2779ae9321338155'],0,306,306,460238,1,0.150943396,0.383647799,1,1212
cdd03d19943d42b6401b255196c83ee32ef6c792,1,Neha Narkhede,2014-02-11 19:29:35-08:00,['d6303ec79e6871c901951e7dcde93d4996b52c49'],6,6,12,460250,1,1,1,,1212
e1845ba1d80f0ba89d01d450c066aae90b416ab1,0,Jay Kreps,2014-02-11 19:51:43-08:00,['cdd03d19943d42b6401b255196c83ee32ef6c792'],5,21,26,460276,1,0,0.8,1,1212
ef1e30bf5b0aba1758522f8cacd2804d3bfbd4fb,0,Jay Kreps,2014-02-11 19:52:49-08:00,['e1845ba1d80f0ba89d01d450c066aae90b416ab1'],2,11,13,460289,1,1,0,1,1212
b494cd9de6002c59b7181cefab6854b9a0c88817,1,Jun Rao,2014-02-12 08:22:51-08:00,['ef1e30bf5b0aba1758522f8cacd2804d3bfbd4fb'],6,42,48,460337,4,,,,1213
84a5803a7e5235e3fa0af7de8e40bdf77ff9affe,1,Neha Narkhede,2014-02-12 12:50:33-08:00,['b494cd9de6002c59b7181cefab6854b9a0c88817'],54,33,87,460424,2,1,1,0,1213
7e154a36f74ad0ea7e0f6d48b71a5a73d99330e7,0,Jay Kreps,2014-02-13 10:54:07-08:00,['84a5803a7e5235e3fa0af7de8e40bdf77ff9affe'],31,36,67,460491,2,0.5,1,1,1213
3d830c9ef1a186cd36e4f5c7bdc2dfef2d51edc7,1,Neha Narkhede,2014-02-13 14:46:52-08:00,['7e154a36f74ad0ea7e0f6d48b71a5a73d99330e7'],71,87,158,460649,3,0,0,0,1213
5be973674fe726181fc12e7a098b46286a545361,1,Joe Stein,2014-02-13 22:45:53-05:00,['3d830c9ef1a186cd36e4f5c7bdc2dfef2d51edc7'],57,55,112,460761,1,,,,1213
dc5a993e676da4f7042ba1dd9efc034202d46263,1,Joe Stein,2014-02-14 14:15:32-05:00,['5be973674fe726181fc12e7a098b46286a545361'],21,23,44,460805,2,,,,1213
f550cc76cd4aa6a1ed771c477ed8cc832520ba1a,0,Jun Rao,2014-02-17 11:43:45-08:00,['dc5a993e676da4f7042ba1dd9efc034202d46263'],101,39,140,460945,1,1,1,0,1213
3f0b67b6ac864befccfdd4bb5dee08c0b33c3b43,1,Jay Kreps,2014-02-18 17:18:13-08:00,['f550cc76cd4aa6a1ed771c477ed8cc832520ba1a'],401,652,1053,461998,23,0.526666667,0.846666667,0.733333333,1215
22f76d8b362417858e61f0f9a2fc80d620790f2f,1,Jay Kreps,2014-02-18 19:31:30-08:00,['3f0b67b6ac864befccfdd4bb5dee08c0b33c3b43'],1,1,2,462000,1,,,,1215
16c69a844fabfe512f8c090fedde2014e392800b,1,Joe Stein,2014-02-19 10:53:11-05:00,['22f76d8b362417858e61f0f9a2fc80d620790f2f'],1,4,5,462005,2,,,,1215
a8297cc6ca90f2b528091a46e3cf254e84e74d47,0,Joe Stein,2014-02-20 00:11:31-05:00,['16c69a844fabfe512f8c090fedde2014e392800b'],609,0,609,462614,16,,,,1215
d392f56b803c41a32860346398f36c9a453d0406,1,Jun Rao,2014-02-19 21:32:46-08:00,['a8297cc6ca90f2b528091a46e3cf254e84e74d47'],1,1,2,462616,1,,,,1215
90bea0b12e3944226df29d78d3aa9658cfb7799a,1,Jun Rao,2014-02-20 09:44:21-08:00,['d392f56b803c41a32860346398f36c9a453d0406'],2,3,5,462621,2,1,1,1,1215
6ab9b1ecd89c74a42233fc792684e7a8757e9460,1,Jun Rao,2014-02-20 17:44:41-08:00,['90bea0b12e3944226df29d78d3aa9658cfb7799a'],23,37,60,462681,9,0.818181818,0.818181818,1,1215
993e1aac8f351b9ea5c322c568505d795f6d664a,1,Jay Kreps,2014-02-21 10:56:42-08:00,['6ab9b1ecd89c74a42233fc792684e7a8757e9460'],2,5,7,462688,1,,,,1215
5de68ef4aef7812fd9f2d5e4fb6158bf753658e3,1,Sriram Subramanian,2014-02-24 01:50:02-08:00,"['2d848c5ae0d10fc4d49ad9a3477b8c46f1c3dab7', '993e1aac8f351b9ea5c322c568505d795f6d664a']",3165,7438,10603,473291,244,,,,1215
3955915a5f8a0daa7b96be69a87b3fbd013c9501,1,Jay Kreps,2014-02-24 14:44:32-08:00,['993e1aac8f351b9ea5c322c568505d795f6d664a'],23,31,54,473345,2,1,0.666666667,1,1215
5b80758b57d8063b8a8124562cc5c83854a99e00,0,Sriram Subramanian,2014-02-25 00:22:04-08:00,"['5de68ef4aef7812fd9f2d5e4fb6158bf753658e3', '3955915a5f8a0daa7b96be69a87b3fbd013c9501']",23,31,54,473399,2,,,,1215
00afb619cb1f2aaca0ddc785ab1d649428f9c93e,0,Sriram Subramanian,2014-02-25 00:26:14-08:00,['5b80758b57d8063b8a8124562cc5c83854a99e00'],1,0,1,473400,1,1,1,0,1215
edbed2823fc3e4948bb56ec3bee02fe4ad1bbdca,1,Jun Rao,2014-02-25 09:37:15-08:00,['00afb619cb1f2aaca0ddc785ab1d649428f9c93e'],12,39,51,473451,8,,,,1215
57be6c81a748a30e583037ddc70d2eec9acc7832,0,Jun Rao,2014-02-25 18:09:59-08:00,['edbed2823fc3e4948bb56ec3bee02fe4ad1bbdca'],0,1,1,473452,1,,,,1215
5e2a9a560d847bd0cf364d86bd6784f70d99c71a,1,Neha Narkhede,2014-02-27 10:50:26-08:00,['57be6c81a748a30e583037ddc70d2eec9acc7832'],115,392,507,473959,14,0.705357143,1,0.875,1216
eb6da57492caad7a6b71692ad184a95c89035b67,0,Jun Rao,2014-02-27 14:15:41-08:00,['5e2a9a560d847bd0cf364d86bd6784f70d99c71a'],3,30,33,473992,1,0,0,0.833333333,1216
a810b8ecbe66f36f8ef58a440d439a54762b3d9c,1,Jay Kreps,2014-02-27 14:25:02-08:00,['eb6da57492caad7a6b71692ad184a95c89035b67'],7,7,14,474006,1,,,,1216
f1a53b972eb1f8e75db54d3272d9eb7c398e238a,1,Jay Kreps,2014-02-27 18:04:50-08:00,['a810b8ecbe66f36f8ef58a440d439a54762b3d9c'],173,291,464,474470,18,0.0625,0.927083333,0.958333333,1216
8cdb234ad81ec324f15c9c1f8e484861926076f9,0,Jun Rao,2014-02-28 08:02:42-08:00,['f1a53b972eb1f8e75db54d3272d9eb7c398e238a'],22,26,48,474518,1,0,0,1,1216
220cc842a6e866806e3f53c394b5547fe7c44b3e,1,Jun Rao,2014-02-28 13:53:37-08:00,['8cdb234ad81ec324f15c9c1f8e484861926076f9'],0,30,30,474548,4,,,,1217
40c6555eb0d0db25d6bd06c5eb4040246805c79f,0,Jun Rao,2014-03-03 09:35:21-08:00,['220cc842a6e866806e3f53c394b5547fe7c44b3e'],3,7,10,474558,1,,,,1217
77118a935ee28da80c67d4050f41a1e7e838ebaa,1,Joe Stein,2014-03-04 15:30:59-05:00,['40c6555eb0d0db25d6bd06c5eb4040246805c79f'],22,30,52,474610,12,1,1,1,1217
153ac8aa604014351e6958dce5d479e4875031fa,0,Joe Stein,2014-03-04 15:49:12-05:00,['77118a935ee28da80c67d4050f41a1e7e838ebaa'],1,1,2,474612,1,,,,1217
5ba48348b3abb8f84fda0798d992ff2e0a04051d,1,Jay Kreps,2014-03-04 20:07:00-08:00,['153ac8aa604014351e6958dce5d479e4875031fa'],59,237,296,474908,14,0.107142857,0.654761905,0.761904762,1218
2404191be9f4323fc6144a8f56ae36f794d50da6,0,Jay Kreps,2014-03-05 13:32:08-08:00,['5ba48348b3abb8f84fda0798d992ff2e0a04051d'],1,1,2,474910,1,,,,1218
4524f384dc041f33297b47b181be6b59061577b4,1,Jay Kreps,2014-03-05 14:35:07-08:00,['2404191be9f4323fc6144a8f56ae36f794d50da6'],2,2,4,474914,1,,,,1218
6319f26e6f47350f1e7926dea153ed848f464d2e,0,Jay Kreps,2014-03-06 08:26:12-08:00,['4524f384dc041f33297b47b181be6b59061577b4'],1,1,2,474916,1,,,,1218
c3520fe7e0e50f0eeb4f82ad1ed961bdd39440fc,0,Neha Narkhede,2014-03-06 09:35:20-08:00,['6319f26e6f47350f1e7926dea153ed848f464d2e'],1,1,2,474918,1,,,,1218
74c54c7eeb236cbf66710751165ea9f632cf3f52,1,Neha Narkhede,2014-03-06 18:08:55-08:00,['c3520fe7e0e50f0eeb4f82ad1ed961bdd39440fc'],228,258,486,475404,8,1,1,0.04494382,1218
c765d7bd4e30e0b952fc4bc00d142f7939b498a6,1,Jun Rao,2014-03-06 19:06:25-08:00,['74c54c7eeb236cbf66710751165ea9f632cf3f52'],24,3314,3338,478742,143,0.239130435,0.239130435,0.673913043,1245
c124bbbb6c3e2152915411e1c3b00fca67634eed,1,Jun Rao,2014-03-11 20:56:32-07:00,['c765d7bd4e30e0b952fc4bc00d142f7939b498a6'],8,18,26,478768,3,1,1,1,1245
84a3a9a3d9a5f1c4936dfb9d65b4bf0cd3b445d6,1,Jun Rao,2014-03-13 14:25:37-07:00,['c124bbbb6c3e2152915411e1c3b00fca67634eed'],34,98,132,478900,7,0.21875,0.40625,0.84375,1246
a670537aa33732b15b56644d8ccc1681e16395f5,1,Joel Koshy,2014-03-14 15:14:33-07:00,['84a3a9a3d9a5f1c4936dfb9d65b4bf0cd3b445d6'],1644,3609,5253,484153,82,0.326592518,0.464105157,0.778564206,1265
616086b909252eeee2cb05f379659a2de2c7bd83,1,Neha Narkhede,2014-03-17 18:40:59-07:00,['a670537aa33732b15b56644d8ccc1681e16395f5'],42,150,192,484345,9,0.520833333,0.75,0.875,1265
53e4061b2b0170ee35939ba1d6462e6c6f37ccea,1,Neha Narkhede,2014-03-17 18:46:30-07:00,['616086b909252eeee2cb05f379659a2de2c7bd83'],0,290,290,484635,1,0.666666667,1,1,1266
423d9d5af9481b782c7655dc2410e61e1b48a0bb,1,Joel Koshy,2014-03-18 10:38:03-07:00,['53e4061b2b0170ee35939ba1d6462e6c6f37ccea'],12,12,24,484659,6,,,,1266
cc859dcca791dc8e1e6eeabe8b88387a11241b24,1,Jun Rao,2014-03-18 10:52:34-07:00,['423d9d5af9481b782c7655dc2410e61e1b48a0bb'],18,32,50,484709,11,0.444444444,1,0.555555556,1266
74e22092519270428c067a5209ec3028e0745bea,0,Jun Rao,2014-03-18 10:55:19-07:00,['cc859dcca791dc8e1e6eeabe8b88387a11241b24'],14,18,32,484741,1,1,1,1,1266
4484916d656243384d91e172a8e0b7ca240785f0,1,Neha Narkhede,2014-03-18 17:31:35-07:00,['74e22092519270428c067a5209ec3028e0745bea'],47,69,116,484857,5,0.894736842,1,1,1266
8477b4f2a216562e36e0e09b105fdc4daa503e96,0,Jay Kreps,2014-03-19 14:21:15-07:00,['4484916d656243384d91e172a8e0b7ca240785f0'],1,6,7,484864,1,,,,1266
80e92064dcc1fdcf96af91b73816f5bb16fe6536,0,Jun Rao,2014-03-20 09:08:19-07:00,['8477b4f2a216562e36e0e09b105fdc4daa503e96'],0,2,2,484866,1,,,,1266
d9be502bcc6b9d7e5716c01d2273189c00506f53,1,Neha Narkhede,2014-03-20 17:34:38-07:00,['80e92064dcc1fdcf96af91b73816f5bb16fe6536'],2,48,50,484916,3,1,1,1,1267
455c490f63692de076bbf06749bf4aec8f481bbc,0,Jun Rao,2014-03-23 17:54:24-07:00,['d9be502bcc6b9d7e5716c01d2273189c00506f53'],1,0,1,484917,1,,,,1267
466a83b78c2bfcb9ac3116748394e7845a99bf7a,1,Neha Narkhede,2014-03-26 21:49:06-07:00,['455c490f63692de076bbf06749bf4aec8f481bbc'],178,367,545,485462,19,0.333333333,0,0.603603604,1267
9bc47bc1365d17c34f8d43239846de28219a663c,1,Neha Narkhede,2014-03-26 21:50:30-07:00,['466a83b78c2bfcb9ac3116748394e7845a99bf7a'],0,535,535,485997,5,0.59375,0.69140625,0.7578125,1272
23d7fc470638c4dffa5ca005ef2e3d34c14dc92e,1,Jay Kreps,2014-03-27 20:52:42-07:00,['9bc47bc1365d17c34f8d43239846de28219a663c'],331,643,974,486971,24,0.334615385,0.742307692,0.723076923,1272
e287e02b12ca3ca00184fabf07a7dc0a52571a23,0,Jay Kreps,2014-03-27 21:00:33-07:00,['23d7fc470638c4dffa5ca005ef2e3d34c14dc92e'],8,10,18,486989,2,1,1,0,1272
fb92b3a2cdf571715b948f81f1f8bb4bc363d497,1,Neha Narkhede,2014-03-28 18:13:19-07:00,['e287e02b12ca3ca00184fabf07a7dc0a52571a23'],20,39,59,487048,3,0.916666667,0.916666667,1,1272
1d5bbc8b5afa35d7a7784670bcea4e9cf2093723,0,Jun Rao,2014-03-31 16:05:55-07:00,['fb92b3a2cdf571715b948f81f1f8bb4bc363d497'],0,1,1,487049,1,,,,1272
f82ce3314f74c6755f09eec1044cf68ea6d1dc9f,0,Neha Narkhede,2014-03-31 22:29:14-07:00,['1d5bbc8b5afa35d7a7784670bcea4e9cf2093723'],16,16,32,487081,7,1,1,0,1272
083b6265c93619dd8b672c59fc31f0ed3d5da29b,1,Neha Narkhede,2014-03-31 22:36:42-07:00,['f82ce3314f74c6755f09eec1044cf68ea6d1dc9f'],2,9,11,487092,2,1,1,1,1272
bd784aeb20b6a4252675c681116b47ea86402130,1,Jun Rao,2014-04-01 11:40:03-07:00,['083b6265c93619dd8b672c59fc31f0ed3d5da29b'],13,100,113,487205,5,0,0.222222222,0.111111111,1273
98952b3cc7bb9b08ad553da014c80b79d0bc24d6,1,Jay Kreps,2014-04-01 12:48:44-07:00,['bd784aeb20b6a4252675c681116b47ea86402130'],35,29,64,487269,3,1,0,0,1273
4f23ed32debfd77272ee972ed064567d7d614bf2,1,Jay Kreps,2014-04-02 10:19:03-07:00,['98952b3cc7bb9b08ad553da014c80b79d0bc24d6'],15,68,83,487352,4,0.142857143,1,0.714285714,1273
3721821108ef344423ebe149a4dad96a3b2f989f,1,Jun Rao,2014-04-02 12:07:02-07:00,['4f23ed32debfd77272ee972ed064567d7d614bf2'],6,13,19,487371,1,1,0,0,1273
640f3b05efd00d5e1d7bfc8fe9c90c7aadc3d087,1,Jay Kreps,2014-04-04 13:55:47-07:00,['3721821108ef344423ebe149a4dad96a3b2f989f'],246,376,622,487993,13,0.288888889,0.488888889,0.988888889,1273
62fcaedd66c46d8c15e1fd1725badcd575b10849,1,Joel Koshy,2014-04-07 16:24:14-07:00,['640f3b05efd00d5e1d7bfc8fe9c90c7aadc3d087'],54,62,116,488109,5,0.625,1,0.875,1273
a840c73c36f10e212190ca4ed3918af08a8810e6,0,Neha Narkhede,2014-04-07 18:08:54-07:00,['62fcaedd66c46d8c15e1fd1725badcd575b10849'],0,7,7,488116,1,,,,1273
8f94bc3315e7d469489da55f94e08a51235c01f3,0,Neha Narkhede,2014-04-08 10:15:08-07:00,['a840c73c36f10e212190ca4ed3918af08a8810e6'],59,33,92,488208,3,1,1,0,1273
0e1d853c04cb2fe86cf98f0b1006a96e1bb1e177,1,Neha Narkhede,2014-04-08 10:44:07-07:00,['8f94bc3315e7d469489da55f94e08a51235c01f3'],97,150,247,488455,6,1,0.926829268,0.219512195,1273
69655d5fb92ea7e15ebcbfbe345bea9fe04f69d1,0,Joel Koshy,2014-04-08 11:14:35-07:00,['0e1d853c04cb2fe86cf98f0b1006a96e1bb1e177'],3,1,4,488459,1,,,,1273
a39f2c18c027708ff5830a81c1263c6ebb073445,0,Jun Rao,2014-04-08 17:56:59-07:00,['69655d5fb92ea7e15ebcbfbe345bea9fe04f69d1'],5,5,10,488469,3,,,,1273
33e07a61f9a0455da544659b62e4ce8ffca7e9ab,0,Jun Rao,2014-04-09 08:08:17-07:00,['a39f2c18c027708ff5830a81c1263c6ebb073445'],0,2,2,488471,1,,,,1273
de6066e8e78e62739e3eb6f771d0739bf9b73dfd,1,Jun Rao,2014-04-09 08:13:53-07:00,['33e07a61f9a0455da544659b62e4ce8ffca7e9ab'],0,90,90,488561,1,,,,1274
75d5f5bff8519b36d5eb0a904ebbd0d3c0b7c8cc,0,Jun Rao,2014-04-09 08:24:13-07:00,['de6066e8e78e62739e3eb6f771d0739bf9b73dfd'],2,2,4,488565,1,,,,1274
8d15de85114da6012530f0dd837f131bd1e367cd,1,Joel Koshy,2014-04-09 10:45:10-07:00,['75d5f5bff8519b36d5eb0a904ebbd0d3c0b7c8cc'],8,9,17,488582,5,0,1,1,1274
911ff524515148421ff58b41f271c21f792ed9de,1,Jun Rao,2014-04-09 14:49:17-07:00,['8d15de85114da6012530f0dd837f131bd1e367cd'],6,5,11,488593,1,0,0,0,1274
47019a849e69209c16defa81001055aa9f57674d,0,Jun Rao,2014-04-09 14:53:03-07:00,['911ff524515148421ff58b41f271c21f792ed9de'],1,1,2,488595,1,,,,1274
44ee6b7c9d9da207bebe6d927b38ed7df1388df3,1,Jun Rao,2014-04-09 18:52:23-07:00,['47019a849e69209c16defa81001055aa9f57674d'],10,53,63,488658,3,0.307692308,0,1,1274
2d429e19da22416aeb7de68b9e00f33a337e31a0,0,Jun Rao,2014-04-11 14:39:35-07:00,['44ee6b7c9d9da207bebe6d927b38ed7df1388df3'],0,1,1,488659,1,0,0,0,1274
a3a2cba842a9945d4ce7b032e311d17956c33249,0,Jun Rao,2014-04-11 20:31:13-07:00,['2d429e19da22416aeb7de68b9e00f33a337e31a0'],3,13,16,488675,1,0.666666667,0.666666667,1,1274
6bb616e5ae6a2f45cfa190e245c9217a8bf9771a,0,Jun Rao,2014-04-11 21:29:09-07:00,['a3a2cba842a9945d4ce7b032e311d17956c33249'],0,57,57,488732,1,,,,1275
05612ac44de775cf3bc8ffdc15c033920d4a1440,0,Jun Rao,2014-04-12 13:47:13-07:00,['6bb616e5ae6a2f45cfa190e245c9217a8bf9771a'],4,7,11,488743,1,0,1,1,1275
d37ca7f627551c9960e2edb8498784bf2487d53e,0,Jun Rao,2014-04-12 13:48:57-07:00,['05612ac44de775cf3bc8ffdc15c033920d4a1440'],4,4,8,488751,1,,,,1275
2bfd49b955831f3455ff486ce4f613d73239a317,0,Jun Rao,2014-04-12 13:51:29-07:00,['d37ca7f627551c9960e2edb8498784bf2487d53e'],31,10,41,488792,1,,,,1275
4bd33e5ba792667913991638a15f0a2c9f20d7b5,1,Jun Rao,2014-04-13 08:43:53-07:00,['2bfd49b955831f3455ff486ce4f613d73239a317'],51,111,162,488954,6,,,,1276
9a6f7113ed630d8e6bb50f4a58846d976a2d5f97,0,Jun Rao,2014-04-15 13:46:54-07:00,['4bd33e5ba792667913991638a15f0a2c9f20d7b5'],515,520,1035,489989,27,0.674285714,0.048571429,0,1276
ec075c5a853e4168ff30cf133493588671aa2fac,1,Jay Kreps,2014-04-16 10:19:18-07:00,['9a6f7113ed630d8e6bb50f4a58846d976a2d5f97'],76,118,194,490183,2,0,1,1,1276
97f13ec73255f3978c1cbb80ea26f446cf756515,1,Joel Koshy,2014-04-16 10:31:36-07:00,['ec075c5a853e4168ff30cf133493588671aa2fac'],37,132,169,490352,7,0.738461538,1,1,1276
b9351e04f0a26f2f9e4abc7ec526ed802495f991,1,Jay Kreps,2014-04-17 20:31:07-07:00,['97f13ec73255f3978c1cbb80ea26f446cf756515'],20,67,87,490439,2,1,1,1,1277
8b052150f55fb9a6f8c4aedc6b3fa0528719671e,1,Jay Kreps,2014-04-18 13:05:13-07:00,['b9351e04f0a26f2f9e4abc7ec526ed802495f991'],25,30,55,490494,4,0,0.4,1,1277
037c054be260bcc3b470b9724572cb814b704bff,1,Joel Koshy,2014-04-18 13:26:35-07:00,['8b052150f55fb9a6f8c4aedc6b3fa0528719671e'],440,89,529,491023,7,,,,1279
89f040c8c9807fc4f9e219f0b57279b692b6e45d,0,Jay Kreps,2014-04-18 15:02:06-07:00,['037c054be260bcc3b470b9724572cb814b704bff'],3,19,22,491045,2,0,0,0,1279
3af3efe3773348fd7adb8ca43f2abc5490416e55,1,Joel Koshy,2014-04-21 17:12:48-07:00,['89f040c8c9807fc4f9e219f0b57279b692b6e45d'],12,16,28,491073,2,0,0.666666667,0.666666667,1279
ed68ba402e088070da0513a3675ed420ec6a70b0,0,Jun Rao,2014-04-22 13:56:00-07:00,['3af3efe3773348fd7adb8ca43f2abc5490416e55'],226,1,227,491300,3,0.833333333,0.229166667,0,1279
caafc9d614dcb8584fbaf01902fbeaf2d5ea6786,1,Jun Rao,2014-04-22 17:22:27-07:00,['ed68ba402e088070da0513a3675ed420ec6a70b0'],167,194,361,491661,4,1,0.090909091,0.636363636,1280
93af67cd4f75d2f4cc3a25ad999fe6349925504e,1,Jun Rao,2014-04-22 17:47:55-07:00,['caafc9d614dcb8584fbaf01902fbeaf2d5ea6786'],198,202,400,492061,21,1,1,1,1280
0efdfa6f7b6be688d5c531e801c9d37882e55f7f,1,Jun Rao,2014-04-23 17:26:46-07:00,['93af67cd4f75d2f4cc3a25ad999fe6349925504e'],192,95,287,492348,23,1,0.28125,0,1280
3ebbaaea99d9ce94026fb1eef7d024839cf2e436,0,Jun Rao,2014-04-24 15:23:42-07:00,['0efdfa6f7b6be688d5c531e801c9d37882e55f7f'],5,13,18,492366,4,0.666666667,0.666666667,1,1280
e69c613274250bca2bd40a2b3523b55c8231978b,0,Jun Rao,2014-04-25 08:22:34-07:00,['3ebbaaea99d9ce94026fb1eef7d024839cf2e436'],0,1,1,492367,1,0,0,1,1280
0bd4c87f9f88fe7f011c7eefc0410132fcf30ff2,1,Jun Rao,2014-04-25 11:49:02-07:00,['e69c613274250bca2bd40a2b3523b55c8231978b'],63,79,142,492509,5,0,0,0.454545455,1280
c9bb24f153e0975f68386cd7818feceb3ebade3e,1,Jun Rao,2014-04-25 13:44:52-07:00,['0bd4c87f9f88fe7f011c7eefc0410132fcf30ff2'],69,100,169,492678,9,0,1,0.125,1280
8a0314d01786541f06d0eb41b2e81c8bb1d45a8d,1,Jun Rao,2014-04-25 14:31:33-07:00,['c9bb24f153e0975f68386cd7818feceb3ebade3e'],153,116,269,492947,9,1,0.904761905,0.904761905,1280
631536327e3aad866d7c797984794a8800fa9fc3,0,Jun Rao,2014-04-28 14:59:35-07:00,['8a0314d01786541f06d0eb41b2e81c8bb1d45a8d'],16,17,33,492980,3,1,1,0,1280
2f5666408fa9cf44c59f068f19d654a4b7b52914,0,Jun Rao,2014-04-28 15:01:59-07:00,['631536327e3aad866d7c797984794a8800fa9fc3'],1,3,4,492984,1,1,1,1,1280
bbb357c174ffe4ead1229301847c08c3879c6723,0,Jay Kreps,2014-04-28 15:37:29-07:00,['2f5666408fa9cf44c59f068f19d654a4b7b52914'],6,12,18,493002,1,1,1,1,1280
3de97c7c4039783f4a5d1db9de48f6778123a953,0,Jun Rao,2014-04-29 10:33:00-07:00,['bbb357c174ffe4ead1229301847c08c3879c6723'],1,1,2,493004,1,,,,1280
6b4217d192275e35b6b6d1a73ef37dcba46d1ac1,0,Jun Rao,2014-05-01 08:54:03-07:00,['3de97c7c4039783f4a5d1db9de48f6778123a953'],109,123,232,493236,5,0,0,1,1280
198c793ab1f96f1fc4b46ec35aa7008335583fdc,0,Joel Koshy,2014-05-01 10:16:28-07:00,['6b4217d192275e35b6b6d1a73ef37dcba46d1ac1'],0,8,8,493244,1,,,,1280
0062d4cc94843bfc67b1cb03bad708a8121f9d06,1,Jun Rao,2014-05-01 16:35:18-07:00,['198c793ab1f96f1fc4b46ec35aa7008335583fdc'],29,33,62,493306,3,0,1,0,1280
fe18595492ee91a6a8a796b21c66a682ee9db4a0,0,Jun Rao,2014-05-02 07:44:59-07:00,['0062d4cc94843bfc67b1cb03bad708a8121f9d06'],0,3,3,493309,1,1,1,1,1280
3f7a9061b4d1b9ef9e0f4dae3117fd985f84e072,1,Neha Narkhede,2014-05-05 16:56:50-07:00,['fe18595492ee91a6a8a796b21c66a682ee9db4a0'],392,270,662,493971,7,0.622377622,0.265734266,0,1281
44c39c4ea48f365445b8c08ce57d0f16b15f0d0b,1,Jun Rao,2014-05-06 10:37:49-07:00,['3f7a9061b4d1b9ef9e0f4dae3117fd985f84e072'],406,376,782,494753,12,0.342756184,0.893992933,0.886925795,1281
9b6bf407874ef0fda12d8b2cc7f8331ce4aebeea,1,Jun Rao,2014-05-06 16:36:09-07:00,['44c39c4ea48f365445b8c08ce57d0f16b15f0d0b'],16,97,113,494866,7,0,0.918032787,1,1281
4fe5c46848821872fb6e21513cd47d564242c576,1,Jun Rao,2014-05-06 18:03:59-07:00,['9b6bf407874ef0fda12d8b2cc7f8331ce4aebeea'],0,80,80,494946,1,1,1,1,1282
2848a7ab5e80bce9007420517a634229e03ec6f9,0,Neha Narkhede,2014-05-07 10:07:54-07:00,['4fe5c46848821872fb6e21513cd47d564242c576'],19,24,43,494989,1,1,1,,1282
754dacb90b48ee2cd226d544ab0c9cefa692f171,0,Jun Rao,2014-05-07 20:43:06-07:00,['2848a7ab5e80bce9007420517a634229e03ec6f9'],0,1,1,494990,1,0,0,0,1282
1d35cce79d3f2e928fe27d109f962c0a9dda73ea,0,Neha Narkhede,2014-05-08 16:03:49-07:00,['754dacb90b48ee2cd226d544ab0c9cefa692f171'],11,24,35,495025,1,0.272727273,0.272727273,1,1282
31e32b386b7c31ca6b69f883a94268902e2cf17b,1,Jun Rao,2014-05-13 17:32:10-07:00,['1d35cce79d3f2e928fe27d109f962c0a9dda73ea'],33,34,67,495092,3,0,1,0.25,1282
c179c45f2375cb1253e519d0be8c8e9e6ff679f6,0,Joel Koshy,2014-05-15 14:41:29-07:00,['31e32b386b7c31ca6b69f883a94268902e2cf17b'],10,11,21,495113,6,0,0,0,1282
b866c5506a936572c9a948c4bae68da0d045fc53,1,Neha Narkhede,2014-05-15 15:48:16-07:00,['c179c45f2375cb1253e519d0be8c8e9e6ff679f6'],13,18,31,495144,1,0,0,1,1282
99f10739b5921534dddc6e3773e4f8a05b8909b0,1,Jay Kreps,2014-05-15 16:56:45-07:00,['b866c5506a936572c9a948c4bae68da0d045fc53'],140,167,307,495451,9,0.727272727,0,1,1282
8d454f374b4f879b50825b192617167070749b4f,0,Neha Narkhede,2014-05-15 17:36:14-07:00,['99f10739b5921534dddc6e3773e4f8a05b8909b0'],38,80,118,495569,5,0,0,1,1283
b4c1089fa963ec204dc350693a6a69dc929c99c3,1,Jun Rao,2014-05-15 21:26:41-07:00,['8d454f374b4f879b50825b192617167070749b4f'],11,48,59,495628,1,0.947368421,0.947368421,1,1283
345c52ee3581847ddfaa4e53173714d8d97896c5,0,Jun Rao,2014-05-16 10:52:58-07:00,['b4c1089fa963ec204dc350693a6a69dc929c99c3'],21,26,47,495675,1,0,0,1,1283
bf7fb63218640873781720a494d1114fbe628795,1,Jun Rao,2014-05-16 15:31:53-07:00,['345c52ee3581847ddfaa4e53173714d8d97896c5'],1,3,4,495679,1,0,0,1,1283
c24740c7b0f6a6e7c66659da786a346650b76766,1,Neha Narkhede,2014-05-20 16:49:31-07:00,['bf7fb63218640873781720a494d1114fbe628795'],24,1720,1744,497423,11,0.885350318,0.885350318,0.942675159,1293
bf83131dffbdb6c39de0135e0426701ca141f150,0,Neha Narkhede,2014-05-20 22:11:19-07:00,['c24740c7b0f6a6e7c66659da786a346650b76766'],24,29,53,497476,2,,,,1293
d0df33df3df314ccd42f700a592e8efc31e80f87,0,Neha Narkhede,2014-05-21 11:14:35-07:00,['bf83131dffbdb6c39de0135e0426701ca141f150'],186,53,239,497715,3,1,0.042105263,0,1293
52f1149ddbb31ff33d1fd122bb9ffed937be14f6,0,Neha Narkhede,2014-05-22 11:32:51-07:00,['d0df33df3df314ccd42f700a592e8efc31e80f87'],28,31,59,497774,1,0,0,1,1293
547ccedcfa081de2679f9607e4e868041c2cc55f,1,Joe Stein,2014-05-26 11:34:50-04:00,['52f1149ddbb31ff33d1fd122bb9ffed937be14f6'],9,98,107,497881,10,0.12987013,0,0.701298701,1293
01ea4eb42dfea5f47586e2f12be2344f7910fee0,1,Neha Narkhede,2014-05-27 10:21:16-07:00,['547ccedcfa081de2679f9607e4e868041c2cc55f'],1,15,16,497897,2,1,1,1,1293
0ccc1dc08e3664bb2c9bc1548d4d7966e14cc7f9,1,Neha Narkhede,2014-05-27 13:43:32-07:00,['01ea4eb42dfea5f47586e2f12be2344f7910fee0'],7,13,20,497917,1,0,0,1,1293
f8ea4ac01d63831d7f5e170d7669e92fca73b673,0,Neha Narkhede,2014-05-27 14:56:00-07:00,['0ccc1dc08e3664bb2c9bc1548d4d7966e14cc7f9'],83,28,111,498028,1,1,1,0,1293
e73e90e99984c29151dbae063c72ab737cf99968,0,Jun Rao,2014-05-28 09:42:18-07:00,['f8ea4ac01d63831d7f5e170d7669e92fca73b673'],1,1,2,498030,1,,,,1293
26eb1277e502efe1b1c5c4e4382fc80fa231bade,1,Neha Narkhede,2014-05-28 16:58:12-07:00,['e73e90e99984c29151dbae063c72ab737cf99968'],1,1,2,498032,1,,,,1293
02311c0642b3358e8180191ea0542e985ed0f6dc,1,Jay Kreps,2014-05-31 15:05:45-07:00,['26eb1277e502efe1b1c5c4e4382fc80fa231bade'],64,230,294,498326,8,0.524271845,1,0.611650485,1293
3a048e80d526d5eaa39ec1588c6ee47af975d015,1,Jun Rao,2014-06-03 07:36:00-07:00,['02311c0642b3358e8180191ea0542e985ed0f6dc'],7,27,34,498360,1,0.444444444,0.444444444,0.777777778,1293
df449a24a7bd7b87502cab93c847a0dfea12c6db,0,Jun Rao,2014-06-04 13:33:23-07:00,['3a048e80d526d5eaa39ec1588c6ee47af975d015'],60,7,67,498427,1,1,0,0,1293
1363ed7c5268546e657d2d8d9e9e3aeac2df04d8,1,Neha Narkhede,2014-06-04 22:20:55-07:00,['df449a24a7bd7b87502cab93c847a0dfea12c6db'],142,107,249,498676,18,,,,1293
ee4456a3f45eac7df31a170d6ce9d0a4a2fe98a0,1,Neha Narkhede,2014-06-06 09:46:02-07:00,['1363ed7c5268546e657d2d8d9e9e3aeac2df04d8'],69,13,82,498758,2,1,1,0,1293
d3007171102a95cd2979fad6dec5d0bbefb57d7a,0,Neha Narkhede,2014-06-06 10:03:28-07:00,['ee4456a3f45eac7df31a170d6ce9d0a4a2fe98a0'],1,10,11,498769,2,1,1,1,1293
6d1992274cce97dc13e5ace099b7af1a69eb3894,1,Jun Rao,2014-06-09 08:18:08-07:00,['d3007171102a95cd2979fad6dec5d0bbefb57d7a'],5,3,8,498777,1,,,,1293
b04a3be54e872599a1e3a0fda488de5f19ce7c24,1,Jun Rao,2014-06-10 10:35:32-07:00,['6d1992274cce97dc13e5ace099b7af1a69eb3894'],73,75,148,498925,13,0.6,0.6,0,1293
dee16451e04a4bb905a0479e08fa1f0848fea4fb,1,Neha Narkhede,2014-06-10 14:54:58-07:00,['b04a3be54e872599a1e3a0fda488de5f19ce7c24'],52,247,299,499224,6,0.04040404,0.323232323,0.545454545,1295
bb01847579dcf86841956c29278649bcf8609732,1,Jun Rao,2014-06-10 16:51:10-07:00,['dee16451e04a4bb905a0479e08fa1f0848fea4fb'],6,40,46,499270,3,0.541666667,1,1,1295
dcc88408c98a07cb9a816ab55cd81e55f1d2217d,1,Jun Rao,2014-06-10 17:14:45-07:00,['bb01847579dcf86841956c29278649bcf8609732'],19,40,59,499329,3,0.5,0.5,0.5,1295
548d1ba0939c43fff14531510140e2c641b1caa5,1,Jay Kreps,2014-06-10 17:41:29-07:00,['dcc88408c98a07cb9a816ab55cd81e55f1d2217d'],964,1582,2546,501875,37,1,1,1,1306
dd048d8fee60db7282076a71eeeb8a1d0a4381d9,1,Neha Narkhede,2014-06-18 21:13:48-07:00,['548d1ba0939c43fff14531510140e2c641b1caa5'],151,110,261,502136,7,0.75,0.875,0.28125,1306
d0c019a07ee63a8c31de2d60513ed8f03494e348,1,Jay Kreps,2014-06-19 13:52:56-07:00,['dd048d8fee60db7282076a71eeeb8a1d0a4381d9'],2,5,7,502143,1,0,0,1,1306
6b0ae4bba0d0f8e4c8da19de65a8f03f162bec39,1,Jay Kreps,2014-06-19 14:04:06-07:00,['d0c019a07ee63a8c31de2d60513ed8f03494e348'],166,344,510,502653,36,0.657894737,0,0,1318
62f208704fe7fb08f085d569a26e780e0050dba0,0,Neha Narkhede,2014-06-26 16:16:15-07:00,['6b0ae4bba0d0f8e4c8da19de65a8f03f162bec39'],41,12,53,502706,1,0,0,0,1318
c4b95641ea295478f9480b264652b7b52d8f71c5,0,Joel Koshy,2014-06-27 11:09:18-07:00,['62f208704fe7fb08f085d569a26e780e0050dba0'],1,7,8,502714,2,0.166666667,0.166666667,0.166666667,1318
f1c6e97d718581566d037a48640ac3d869d1f15a,1,Jay Kreps,2014-07-01 13:21:36-07:00,['c4b95641ea295478f9480b264652b7b52d8f71c5'],120,187,307,503021,13,1,0,0.527777778,1318
e3dfad304e6c2ffc146cdb9bc25a1d683f289ace,0,Jay Kreps,2014-07-01 14:47:57-07:00,['f1c6e97d718581566d037a48640ac3d869d1f15a'],0,1,1,503022,1,0,1,1,1318
b8d87d0b22cc4e87bac2e9fdfe761b23734851ff,0,Jakob Homan,2014-07-02 15:01:06-07:00,['e3dfad304e6c2ffc146cdb9bc25a1d683f289ace'],2,5,7,503029,1,,,,1318
2a4718c1a7e8e1566c5c87468779fdd1f95fe3bc,0,Jun Rao,2014-07-02 21:54:42-07:00,['b8d87d0b22cc4e87bac2e9fdfe761b23734851ff'],2,3,5,503034,1,0,0,1,1318
b1a1cae880817332f172dccaa5e3e4a69228074f,0,Jun Rao,2014-07-02 22:09:26-07:00,['2a4718c1a7e8e1566c5c87468779fdd1f95fe3bc'],7,1,8,503042,1,0,0,0,1318
6de56b30b0f9aee19bf110431bcb4511d9b748f2,1,Jay Kreps,2014-07-03 21:15:01-07:00,['b1a1cae880817332f172dccaa5e3e4a69228074f'],7,59,66,503108,2,1,1,1,1319
cd3ce27d4baf5434676ec040d64663ad3ce09817,1,Jay Kreps,2014-07-08 13:16:56-07:00,['6de56b30b0f9aee19bf110431bcb4511d9b748f2'],48,77,125,503233,5,1,1,1,1319
420628d695cc675711b94af5cfd14653147bf7f7,1,Jun Rao,2014-07-10 08:27:33-07:00,['cd3ce27d4baf5434676ec040d64663ad3ce09817'],5,73,78,503311,3,1,1,1,1319
8034390ef0f49a1ed180bc1e883dbbd1f6d864a0,0,Jun Rao,2014-07-10 09:45:05-07:00,['420628d695cc675711b94af5cfd14653147bf7f7'],48,44,92,503403,6,,,,1319
83a9aa55d340f6b2720394a49f01a88509e17e52,1,Jay Kreps,2014-07-11 13:08:24-07:00,['8034390ef0f49a1ed180bc1e883dbbd1f6d864a0'],29,37,66,503469,3,0,0.833333333,1,1319
4b3d03e8e0d660b27c7823c03dde075d6ce8348b,0,Jay Kreps,2014-07-12 12:49:04-07:00,['83a9aa55d340f6b2720394a49f01a88509e17e52'],0,7,7,503476,1,1,1,1,1319
3e6b386b72b0d1a39621d7e166f2228c97646e1d,0,Jun Rao,2014-07-15 14:53:15-07:00,['4b3d03e8e0d660b27c7823c03dde075d6ce8348b'],31,0,31,503507,1,1,0,0,1319
b428d8cc48237099af648de12d18be78d54446eb,1,Jun Rao,2014-07-16 08:13:06-07:00,['3e6b386b72b0d1a39621d7e166f2228c97646e1d'],8,8,16,503523,2,,,,1319
8e444a3562d6723b9f33cbdaa6a461409c84c98b,1,Jay Kreps,2014-07-16 09:53:15-07:00,['b428d8cc48237099af648de12d18be78d54446eb'],46,129,175,503698,4,0.183673469,1,1,1319
4ebcdfd51f1e9e4c3d684204e6a785fae6c0e549,1,Jay Kreps,2014-07-17 15:53:52-07:00,['8e444a3562d6723b9f33cbdaa6a461409c84c98b'],15,15,30,503728,6,0,0,0,1319
fc0e03f79131746da81c05c12e056862c08d79d4,1,Jun Rao,2014-07-17 18:20:01-07:00,['4ebcdfd51f1e9e4c3d684204e6a785fae6c0e549'],239,2610,2849,506577,61,0.51266464,0.936170213,0.866261398,1341
592678e4d72151940002ffb1a367ec433b27f2ef,1,Joe Stein,2014-07-19 21:00:22-04:00,['fc0e03f79131746da81c05c12e056862c08d79d4'],2,52,54,506631,3,0.540540541,0.594594595,1,1341
1e4b0841b37e9e6526d7a7a7c643b1369d9f03c5,1,Jay Kreps,2014-07-21 10:22:50-07:00,['592678e4d72151940002ffb1a367ec433b27f2ef'],2,4,6,506637,1,0,1,1,1341
014b700f0323b4dc00d3aa0e1b598f7e2ed07957,0,Jun Rao,2014-07-22 10:53:34-07:00,['1e4b0841b37e9e6526d7a7a7c643b1369d9f03c5'],39,102,141,506778,7,1,1,1,1342
ff05e9b3616a222e29a42f6e8fdf41945a417f41,1,Jun Rao,2014-07-22 14:14:19-07:00,['014b700f0323b4dc00d3aa0e1b598f7e2ed07957'],90,78,168,506946,6,0,0,0,1342
3f1a9c4cee778d089d3ec3167555c2b89cdc48bb,0,Jun Rao,2014-07-23 17:08:51-07:00,['ff05e9b3616a222e29a42f6e8fdf41945a417f41'],6,21,27,506973,1,0,0,0.833333333,1342
db41f98ea943d806362487b8f8192360a488eb39,1,Jay Kreps,2014-07-24 16:34:40-07:00,['3f1a9c4cee778d089d3ec3167555c2b89cdc48bb'],2,12,14,506987,1,1,1,1,1342
d9e5080dfceff12ea599f8d518ad402ba7d54c9d,1,Neha Narkhede,2014-07-24 16:48:41-07:00,['db41f98ea943d806362487b8f8192360a488eb39'],26,9,35,507022,1,0.818181818,0.545454545,0.818181818,1342
7f2278fb9de08141f21b017ba66752857dcdeba4,1,Jun Rao,2014-07-27 09:59:08-07:00,['d9e5080dfceff12ea599f8d518ad402ba7d54c9d'],26,29,55,507077,3,,,,1342
fa34841d9889fc45b4824b729b71bfb2215a082d,0,Jun Rao,2014-07-27 10:55:30-07:00,['7f2278fb9de08141f21b017ba66752857dcdeba4'],1,1,2,507079,1,,,,1342
f489493c385e3266c3bc17db2e8ebc215a6e54e2,1,Jun Rao,2014-07-27 21:13:20-07:00,['fa34841d9889fc45b4824b729b71bfb2215a082d'],167,203,370,507449,10,1,0,0,1342
50f2b245c1a666400fab7ddfdebf7c1c2bdf3084,0,Jun Rao,2014-07-28 10:58:58-07:00,['f489493c385e3266c3bc17db2e8ebc215a6e54e2'],1,6,7,507456,1,0,0,1,1342
a01a101e82d5b06e89857e79c4b8268589d81fca,1,Jun Rao,2014-07-30 08:14:41-07:00,['50f2b245c1a666400fab7ddfdebf7c1c2bdf3084'],7,23,30,507486,1,1,1,1,1342
f8d521a9616134d78966419e5cf2aa73e8d6a5c5,1,Jun Rao,2014-08-04 07:21:25-07:00,['a01a101e82d5b06e89857e79c4b8268589d81fca'],4,73,77,507563,3,0,0.833333333,0.833333333,1343
1d2e776d8c4ffbe59e40985ecfc3b010d99519d1,1,Jun Rao,2014-08-04 21:19:49-07:00,['f8d521a9616134d78966419e5cf2aa73e8d6a5c5'],5,9,14,507577,1,1,1,1,1343
0386790e757fe4eeae4a179e573f71ef8c7de43c,0,Jun Rao,2014-08-04 21:24:05-07:00,['1d2e776d8c4ffbe59e40985ecfc3b010d99519d1'],1,1,2,507579,1,,,,1343
09690e339aabea6e9141f7e2ddd50449cc1c9180,1,Joel Koshy,2014-08-05 14:47:51-07:00,['0386790e757fe4eeae4a179e573f71ef8c7de43c'],2,4,6,507585,1,0,0,1,1343
7a67a72261bcb5b09d9defb2fd95a65c89e75172,0,vagrant,2014-08-05 22:24:03+00:00,['09690e339aabea6e9141f7e2ddd50449cc1c9180'],2,4,6,507591,2,,,,1343
0dc243b92a6ae1683795caf8222edc1b2bb49565,1,Jun Rao,2014-08-05 21:27:57-07:00,['7a67a72261bcb5b09d9defb2fd95a65c89e75172'],744,1149,1893,509484,34,0.469026549,0.920353982,1,1350
c9894fb6ee4d33155bdb669a2e2f64ed9c3f9441,1,Jun Rao,2014-08-08 13:50:08-07:00,['0dc243b92a6ae1683795caf8222edc1b2bb49565'],16,97,113,509597,3,0.933333333,1,1,1350
4d0759713fb2722bac8ce7dcbbb047d7af99280a,1,Jun Rao,2014-08-10 21:20:30-07:00,['c9894fb6ee4d33155bdb669a2e2f64ed9c3f9441'],84,40,124,509721,13,,,,1350
0607953f3ad5a8a77bdd83870897541af66c7ced,1,Jun Rao,2014-08-11 07:45:50-07:00,['4d0759713fb2722bac8ce7dcbbb047d7af99280a'],2,1,3,509724,1,0,0,0,1350
8a8c49028a19444684a23cb1ef456d0dc82e022f,0,Joe Stein,2014-08-11 17:12:29-04:00,['0607953f3ad5a8a77bdd83870897541af66c7ced'],1,1,2,509726,1,,,,1350
48cc2dc0ead0df1501abf16f583b3e365488e2d0,0,Joe Stein,2014-08-12 12:49:29-04:00,['8a8c49028a19444684a23cb1ef456d0dc82e022f'],4,2,6,509732,2,,,,1350
aa70a7d02552585a83c62784b92b67ed8ae3a304,1,Jun Rao,2014-08-13 13:08:57-07:00,['48cc2dc0ead0df1501abf16f583b3e365488e2d0'],27,175,202,509934,8,0.629032258,0.629032258,1,1350
a552d4b743c44db0adcb58273b92301b2a4df38b,0,Neha Narkhede,2014-08-14 17:39:46-07:00,['aa70a7d02552585a83c62784b92b67ed8ae3a304'],4,22,26,509960,1,0.3,0.3,1,1350
caf256ad8ce1b204959b431b6268c7c66f9c480d,0,Neha Narkhede,2014-08-14 17:46:21-07:00,['a552d4b743c44db0adcb58273b92301b2a4df38b'],1,1,2,509962,1,,,,1350
d678449b967ed92a5a02289c061f201da25b07de,0,Joel Koshy,2014-08-15 10:46:34-07:00,['caf256ad8ce1b204959b431b6268c7c66f9c480d'],16,18,34,509996,1,0,0,0,1350
c6f08b6094924ff3560a8e16090c85ed1a415b03,1,Joel Koshy,2014-08-15 15:49:54-07:00,['d678449b967ed92a5a02289c061f201da25b07de'],16,63,79,510075,5,0.652173913,0.652173913,1,1351
780225506d89b587d3974615b8444ef2b62122d5,1,Jay Kreps,2014-08-18 11:44:42-07:00,['c6f08b6094924ff3560a8e16090c85ed1a415b03'],2,21,23,510098,1,0,1,1,1351
f402b7a96d802c1cf8624416c98da416e193e7fd,1,Jun Rao,2014-08-18 15:49:29-07:00,['780225506d89b587d3974615b8444ef2b62122d5'],4,4,8,510106,1,,,,1351
a30491ac5d3fc5967e8c4b16c68bdbfc312748f5,0,Jun Rao,2014-08-19 17:53:21-07:00,['f402b7a96d802c1cf8624416c98da416e193e7fd'],1,1,2,510108,1,,,,1351
aa775a199edbdbb4bcb1b3ac8f75d7e5c80fcaee,0,Jun Rao,2014-08-22 17:05:33-07:00,['a30491ac5d3fc5967e8c4b16c68bdbfc312748f5'],15,12,27,510135,1,1,1,0,1351
2cdc83e85b56c946eed51da6143fbe9d2d0c9d08,0,Joe Stein,2014-08-28 21:15:10-04:00,['aa775a199edbdbb4bcb1b3ac8f75d7e5c80fcaee'],5,7,12,510147,3,,,,1351
538122fa793fe59021ac35feaef22e302b194030,1,Joel Koshy,2014-08-29 14:08:21-07:00,['2cdc83e85b56c946eed51da6143fbe9d2d0c9d08'],1,1,2,510149,1,,,,1351
953e35b5c591559a600b4e6bd01d1dd1f2e979db,1,Joel Koshy,2014-08-29 17:55:14-07:00,['538122fa793fe59021ac35feaef22e302b194030'],73,441,514,510663,7,0.198717949,0.961538462,0.826923077,1353
3abe3403a1a9dfb2eae4b73f79e60b99401079f6,1,Joe Stein,2014-08-30 12:14:54-04:00,['953e35b5c591559a600b4e6bd01d1dd1f2e979db'],36,30,66,510729,1,,,,1353
ae24141275727255e0dd5d8a739648851d0a0491,1,Joe Stein,2014-09-02 14:17:10-04:00,['3abe3403a1a9dfb2eae4b73f79e60b99401079f6'],0,39,39,510768,1,1,1,1,1354
ffb81a581b6cbd3bd7338ec88022aa745a05b1c9,1,Jun Rao,2014-09-04 22:23:25-07:00,['ae24141275727255e0dd5d8a739648851d0a0491'],30,67,97,510865,2,0.75,0.875,1,1354
e22f8ededaf838e7cec9dd22975d8461764ab076,0,Joel Koshy,2014-09-05 12:20:31-07:00,['ffb81a581b6cbd3bd7338ec88022aa745a05b1c9'],15,11,26,510891,1,1,1,0,1354
3d3c544d6f87ddff58fc01be00410321ef0d497d,0,Neha Narkhede,2014-09-14 09:33:02-07:00,['e22f8ededaf838e7cec9dd22975d8461764ab076'],2,6,8,510899,2,,,,1354
8d0ab1de70f3361d26e1e2cbfc4363f5ca45d4c2,1,Jun Rao,2014-09-14 10:16:07-07:00,['3d3c544d6f87ddff58fc01be00410321ef0d497d'],22,7,29,510928,3,,,,1354
f9d9b3814317f80ea08df9c7879de966aa0a2554,1,Jun Rao,2014-09-14 10:45:37-07:00,['8d0ab1de70f3361d26e1e2cbfc4363f5ca45d4c2'],8,16,24,510952,5,,,,1354
f5ab8e1780cf80f267906e3259ad4f9278c32d28,0,Jun Rao,2014-09-14 11:16:17-07:00,['f9d9b3814317f80ea08df9c7879de966aa0a2554'],1,1,2,510954,1,,,,1354
cb6a1597b768404d758540e3ed53f5918c28c31b,0,Neha Narkhede,2014-09-14 20:14:07-07:00,['f5ab8e1780cf80f267906e3259ad4f9278c32d28'],14,18,32,510986,3,0,0,1,1354
3e8854c0c86e75311994d805bcb3b2d5d9836879,0,Neha Narkhede,2014-09-14 20:23:24-07:00,['cb6a1597b768404d758540e3ed53f5918c28c31b'],1,1,2,510988,1,,,,1354
d677701b93b3b792fac6191588984f7a5323eecd,0,Neha Narkhede,2014-09-14 20:40:35-07:00,['3e8854c0c86e75311994d805bcb3b2d5d9836879'],1,7,8,510996,2,0,1,1,1354
cf0f5750b39e675cf9a9c6d6394a665366db0f58,0,Neha Narkhede,2014-09-15 20:34:44-07:00,['d677701b93b3b792fac6191588984f7a5323eecd'],2,22,24,511020,2,1,,,1354
a1423aec7bd2ba857bf3d5e829c960907c297def,0,Jun Rao,2014-09-16 21:55:40-07:00,['cf0f5750b39e675cf9a9c6d6394a665366db0f58'],1,1,2,511022,1,,,,1354
c892c08df01c3dfc2d466bd37a6838072d390819,0,Jun Rao,2014-09-17 09:50:10-07:00,['a1423aec7bd2ba857bf3d5e829c960907c297def'],10,10,20,511042,3,,,,1354
be5edd2f8d0c0355cb33feb2ac7482b7df7dccbc,1,Jun Rao,2014-09-18 15:53:48-07:00,['c892c08df01c3dfc2d466bd37a6838072d390819'],51,176,227,511269,15,0.966666667,0.966666667,1,1356
8eac7d789f588b48ad278f4db620402c426c65bc,1,Neha Narkhede,2014-09-20 13:51:22-07:00,['be5edd2f8d0c0355cb33feb2ac7482b7df7dccbc'],6,47,53,511322,4,0.555555556,0.777777778,1,1356
6d7057566f0c3a872f625957aa086b993e76071f,1,Jun Rao,2014-09-20 15:47:49-07:00,['8eac7d789f588b48ad278f4db620402c426c65bc'],22,30,52,511374,1,,,,1356
d2d1ef357b3b07e83f880ee2a6e02fb3c18ae011,1,Joe Stein,2014-09-23 12:06:17-04:00,['6d7057566f0c3a872f625957aa086b993e76071f'],6,12,18,511392,4,,,,1356
db0b0b8509ce904a0eab021a0453a80cecf3efb7,1,Joe Stein,2014-09-23 12:46:02-04:00,['d2d1ef357b3b07e83f880ee2a6e02fb3c18ae011'],0,25,25,511417,1,,,,1357
27bc37289c316fb5a978423f4b2c88f49ae15e52,1,Jun Rao,2014-09-23 14:39:10-07:00,['db0b0b8509ce904a0eab021a0453a80cecf3efb7'],91,92,183,511600,3,,,,1357
084566b837ee2204b6898b82156e811d0601085f,0,Jun Rao,2014-09-24 21:13:21-07:00,['27bc37289c316fb5a978423f4b2c88f49ae15e52'],2164,2,2166,513766,28,0.93129771,0.93129771,0.038167939,1357
f750dba65f9d9552a61a0754c46fa6e294785b31,1,Neha Narkhede,2014-09-25 17:49:29-07:00,['084566b837ee2204b6898b82156e811d0601085f'],1,73,74,513840,2,0.2,1,1,1358
9c17747baab829adb268da28b4d943bbd6ef4e9f,1,Neha Narkhede,2014-09-25 21:23:10-07:00,['f750dba65f9d9552a61a0754c46fa6e294785b31'],79,121,200,514040,4,0,0.805555556,1,1358
a9c7d77249224666b1e5fcded213c516fdd46ac0,1,Neha Narkhede,2014-09-26 15:30:49-07:00,['9c17747baab829adb268da28b4d943bbd6ef4e9f'],11,58,69,514109,7,0.714285714,0.714285714,1,1359
6861d4688ad044447881bfff22a1183ed8b6fc9e,0,Jun Rao,2014-09-29 14:40:09-07:00,['a9c7d77249224666b1e5fcded213c516fdd46ac0'],3,1,4,514113,1,0,0,0,1359
54b6419bb37ed88c8b77aee3c0c23aeb9b5be419,1,Joel Koshy,2014-09-29 18:21:07-07:00,['6861d4688ad044447881bfff22a1183ed8b6fc9e'],1,3,4,514117,1,1,1,1,1359
795e262b9f7c9c046b397e670f35698f17d2c13d,1,Jun Rao,2014-09-30 08:13:45-07:00,['54b6419bb37ed88c8b77aee3c0c23aeb9b5be419'],1,1,2,514119,1,,,,1359
e05704c40b51b399e2143faa3dbb668daca9890c,1,Joe Stein,2014-10-03 22:04:36-04:00,['795e262b9f7c9c046b397e670f35698f17d2c13d'],0,1,1,514120,1,,,,1359
9cb59f319e26a5ad0b2646f9718bdb90deb21656,0,Neha Narkhede,2014-10-04 16:34:34-07:00,['e05704c40b51b399e2143faa3dbb668daca9890c'],1,1,2,514122,1,,,,1359
40948a33c93ab7b5bdc62c7cf680538e920afa4d,0,Neha Narkhede,2014-10-04 18:09:29-07:00,['9cb59f319e26a5ad0b2646f9718bdb90deb21656'],3,1,4,514126,1,0,0,0,1359
f452c426bb562ffc5cc2db38665591d157d5c80a,0,Jun Rao,2014-10-06 07:45:23-07:00,['40948a33c93ab7b5bdc62c7cf680538e920afa4d'],8,5,13,514139,1,1,1,0,1359
88595bfb5229bda0ad7c3de2ce3b04f95a9f38a7,1,Jay Kreps,2014-10-06 17:19:09-07:00,['f452c426bb562ffc5cc2db38665591d157d5c80a'],0,3,3,514142,1,0,0,1,1359
1a6c9207c7c19f04b91b455e86bbf4e779e7e7a2,1,Jun Rao,2014-10-06 17:22:29-07:00,['88595bfb5229bda0ad7c3de2ce3b04f95a9f38a7'],1,1,2,514144,1,,,,1359
68b9f7716df1d994a9d43bec6bc42c90e66f1e99,1,Jun Rao,2014-10-07 18:22:31-07:00,['1a6c9207c7c19f04b91b455e86bbf4e779e7e7a2'],1,12,13,514157,1,1,1,1,1359
c940470e32916e2dbbe8f95bd295950a3681c5b7,1,Jun Rao,2014-10-09 08:05:32-07:00,['68b9f7716df1d994a9d43bec6bc42c90e66f1e99'],23,117,140,514297,8,0.862068966,0.862068966,1,1361
a7e49298b02ae35c227a40deae63debeae91138f,0,Jun Rao,2014-10-09 14:29:21-07:00,['c940470e32916e2dbbe8f95bd295950a3681c5b7'],0,2,2,514299,1,1,1,1,1361
a314461fa04b3249608607d1040c8e0cf8724bac,1,Jun Rao,2014-10-09 14:51:08-07:00,['a7e49298b02ae35c227a40deae63debeae91138f'],4,3,7,514306,2,1,0,0,1361
58e58529b350a3da860b1f51fdfa356dfc42761f,0,Joel Koshy,2014-10-09 16:34:40-07:00,['a314461fa04b3249608607d1040c8e0cf8724bac'],31,33,64,514370,2,0,1,1,1361
043190c601f37e42c32189f3df5ddd986e57da95,1,Jun Rao,2014-10-09 18:26:03-07:00,['58e58529b350a3da860b1f51fdfa356dfc42761f'],67,384,451,514821,17,0.62406015,0.92481203,0.969924812,1365
09b2b3cbe07e8cdea42434fa6c54af0a064a93a2,0,Jun Rao,2014-10-09 21:08:38-07:00,['043190c601f37e42c32189f3df5ddd986e57da95'],3,4,7,514828,1,,,,1365
1733c0bfb06a86eba7b16db3c80cabc91fc04b22,1,Jun Rao,2014-10-12 08:44:59-07:00,['09b2b3cbe07e8cdea42434fa6c54af0a064a93a2'],203,203,406,515234,42,,,,1365
7062ed7db36f913328a9124797c47f70e3461025,1,Neha Narkhede,2014-10-12 15:50:48-07:00,['1733c0bfb06a86eba7b16db3c80cabc91fc04b22'],1,2,3,515237,1,0,1,1,1365
0d65f043fed14c482a788d403c6a05544c0dd01b,0,Neha Narkhede,2014-10-12 16:15:54-07:00,['7062ed7db36f913328a9124797c47f70e3461025'],6,9,15,515252,5,,,,1365
be2e8a769efe35dc5c360545e6220a9fe652cced,0,Neha Narkhede,2014-10-13 11:36:29-07:00,['0d65f043fed14c482a788d403c6a05544c0dd01b'],2,2,4,515256,1,,,,1365
d5041bc79fd656fe361c7f6643f9f26c2e8f22fe,1,Jun Rao,2014-10-13 16:16:14-07:00,['be2e8a769efe35dc5c360545e6220a9fe652cced'],49,53,102,515358,1,0,0,1,1365
22643bfc2b683b426eb41d4b66cf90c3b7ec7f0d,1,Neha Narkhede,2014-10-14 21:17:01-07:00,['d5041bc79fd656fe361c7f6643f9f26c2e8f22fe'],8,67,75,515433,8,0.333333333,0.909090909,1,1365
de432a09e632f78df9e580b51277f81582c3f026,0,Neha Narkhede,2014-10-14 21:47:02-07:00,['22643bfc2b683b426eb41d4b66cf90c3b7ec7f0d'],4,24,28,515461,3,0.294117647,1,1,1365
841387b23ac30707dd7f24a79de441c3302458d4,1,Joel Koshy,2014-10-14 22:31:50-07:00,['de432a09e632f78df9e580b51277f81582c3f026'],24,4,28,515489,3,0.705882353,0,0,1365
4271ecbf06d0ffe16db3222b4e75247641a4c35f,1,Neha Narkhede,2014-10-15 17:07:30-07:00,['841387b23ac30707dd7f24a79de441c3302458d4'],4,23,27,515516,3,0.294117647,1,1,1365
37356bfee09bf0dffc93d85270c342e03c36ca44,1,Jun Rao,2014-10-17 10:07:34-07:00,['4271ecbf06d0ffe16db3222b4e75247641a4c35f'],58,698,756,516272,14,0.81875,0.99375,0.884375,1367
5f1ad107b71318144af07a0fd9098b560c4efa82,1,Jun Rao,2014-10-17 12:30:41-07:00,['37356bfee09bf0dffc93d85270c342e03c36ca44'],1,1,2,516274,1,,,,1367
5152fb7e8eea720046ce844ca5153d2766ee002e,0,Neha Narkhede,2014-10-17 15:04:51-07:00,['5f1ad107b71318144af07a0fd9098b560c4efa82'],1,1,2,516276,1,0,0,1,1367
2d322a7bd12966e4a66f04b75add619a481ff22d,0,Jun Rao,2014-10-20 11:07:44-07:00,['5152fb7e8eea720046ce844ca5153d2766ee002e'],0,1,1,516277,1,,,,1367
4b095760cb38c726c49e6f245ffd7dc8ccf49863,1,Jun Rao,2014-10-20 18:02:00-07:00,['2d322a7bd12966e4a66f04b75add619a481ff22d'],0,43,43,516320,2,0,1,0.433333333,1367
e8923ae33ac90170381d8c4a59a5eb810ee9f36d,1,Neha Narkhede,2014-10-22 10:04:39-07:00,['4b095760cb38c726c49e6f245ffd7dc8ccf49863'],12,59,71,516391,6,0.2,0,1,1367
cda1f73d0498d66aafc8c6e57f84e0cd3c69928a,0,Jun Rao,2014-10-23 14:52:07-07:00,['e8923ae33ac90170381d8c4a59a5eb810ee9f36d'],1,1,2,516393,1,,,,1367
35f589bb4654b49035c27780717f560e74400444,0,Joel Koshy,2014-10-23 15:42:48-07:00,['cda1f73d0498d66aafc8c6e57f84e0cd3c69928a'],6,24,30,516423,1,0,0,1,1367
b77099626e8fc258abed67dc10b2816347ba0f2b,1,Jun Rao,2014-10-23 16:12:54-07:00,['35f589bb4654b49035c27780717f560e74400444'],92,7,99,516522,3,,,,1367
e402c7be723e5f189a8f2b4f91a28f3b26ea9112,1,Jun Rao,2014-10-23 17:06:49-07:00,['b77099626e8fc258abed67dc10b2816347ba0f2b'],2,4,6,516528,1,0,0,1,1367
12ce4b1e1e0e6ec7fd3585baf3ed531ecc16a5d9,0,Neha Narkhede,2014-10-24 09:04:23-07:00,['e402c7be723e5f189a8f2b4f91a28f3b26ea9112'],1,7,8,516536,23,0,0,0,1368
43cb192b59ab676d35c38f9144fbc98a954a11d3,1,Neha Narkhede,2014-10-24 09:26:41-07:00,['12ce4b1e1e0e6ec7fd3585baf3ed531ecc16a5d9'],26,48,74,516610,1,0.545454545,1,1,1368
20f5b01feacd1e95d558073b7be511cb82888b3e,0,Neha Narkhede,2014-10-27 16:23:35-07:00,['43cb192b59ab676d35c38f9144fbc98a954a11d3'],2,1,3,516613,1,1,1,1,1368
89831204c092f3a417bf41945925a2e9a0ec828e,1,Joel Koshy,2014-10-29 18:56:23-07:00,['20f5b01feacd1e95d558073b7be511cb82888b3e'],1074,1006,2080,518693,26,1,0.059322034,0,1368
1ed9cf6d03603518d950f7e9a5f122c4ed5d7cee,0,Joel Koshy,2014-10-30 16:06:21-07:00,['89831204c092f3a417bf41945925a2e9a0ec828e'],4,8,12,518705,1,0,0,0,1368
58e3f99e244d6c4b9ad4166cc5fcf75561d87dab,0,Jun Rao,2014-11-03 21:17:21-08:00,['1ed9cf6d03603518d950f7e9a5f122c4ed5d7cee'],5,8,13,518718,2,0,0,1,1368
4bb020212aa0260a750b69dc18856cf25c1e7011,1,Joel Koshy,2014-11-04 10:09:22-08:00,['58e3f99e244d6c4b9ad4166cc5fcf75561d87dab'],0,318,318,519036,2,0.395973154,0.838926174,0.838926174,1370
06e1a6552e2c1de08c185359f3114eb12e61cfae,0,Neha Narkhede,2014-11-06 18:13:28-08:00,['4bb020212aa0260a750b69dc18856cf25c1e7011'],59,58,117,519153,1,0,1,0,1370
cbdcd5f108d783e9d0e758fbf0d8479968db3a68,0,Neha Narkhede,2014-11-06 18:16:17-08:00,['06e1a6552e2c1de08c185359f3114eb12e61cfae'],1,8,9,519162,5,0,0,0.5,1370
f20e5108a271e1fc37ca6752773efa74e2fef67f,0,Jun Rao,2014-11-07 10:46:21-08:00,['cbdcd5f108d783e9d0e758fbf0d8479968db3a68'],3,3,6,519168,1,,,,1370
9b3da9fbfd60e3a0482ec7bd615dc9806cd9941c,0,Neha Narkhede,2014-11-09 20:24:35-08:00,['f20e5108a271e1fc37ca6752773efa74e2fef67f'],9,0,9,519177,1,0,0,0,1370
53160bb07c9f77ed21f486ed448aff0277c139b0,0,Joel Koshy,2014-11-11 18:42:22-08:00,['9b3da9fbfd60e3a0482ec7bd615dc9806cd9941c'],2,2,4,519181,1,,,,1370
2cd9ae74544efe049393e1a6bf60533aea956d7d,0,Joel Koshy,2014-11-12 15:55:03-08:00,['53160bb07c9f77ed21f486ed448aff0277c139b0'],1,3,4,519185,1,,,,1370
d99af88eafefbfd1c537a64f8107cd9041346015,0,Joel Koshy,2014-11-13 18:10:35-08:00,['2cd9ae74544efe049393e1a6bf60533aea956d7d'],2,1,3,519188,2,1,1,0,1370
8c35030e4d24e603e5dbd53862ca6ae4fe59b4e9,1,Joel Koshy,2014-11-13 20:58:03-08:00,['d99af88eafefbfd1c537a64f8107cd9041346015'],1,2,3,519191,2,0,0,1,1370
ca2cf97a6b151566f091a5dd016b93dfdaf87628,0,Joel Koshy,2014-11-14 10:02:45-08:00,['8c35030e4d24e603e5dbd53862ca6ae4fe59b4e9'],3,2,5,519196,3,1,1,0,1370
7d89867c05a7cca6e76cc48c47f8e703d68a9a43,1,Jun Rao,2014-11-14 14:30:04-08:00,['ca2cf97a6b151566f091a5dd016b93dfdaf87628'],20,124,144,519340,7,0.369565217,0.826086957,1,1370
26ad54c109db9eca01df926255017ece3eb65645,0,Jun Rao,2014-11-14 15:15:14-08:00,['7d89867c05a7cca6e76cc48c47f8e703d68a9a43'],1,1,2,519342,1,,,,1370
6f4b8a10115a7373917cf2a55b74aa8a14c547b9,0,Jun Rao,2014-11-17 18:53:16-08:00,['26ad54c109db9eca01df926255017ece3eb65645'],0,6,6,519348,1,,,,1370
1c7d783dd648d0e691ad80cb1357c52d3f0af11a,0,Jun Rao,2014-11-18 19:03:51-08:00,['6f4b8a10115a7373917cf2a55b74aa8a14c547b9'],7,17,24,519372,4,1,1,1,1370
457744a820d806e546edebbd8ffd33f6772e519f,1,Jun Rao,2014-11-19 17:57:41-08:00,['1c7d783dd648d0e691ad80cb1357c52d3f0af11a'],338,540,878,520250,33,0.909090909,0.954545455,0.454545455,1372
f0fd70929a1ad607aa1fbf6ed9b40b16ab95b807,0,Guozhang Wang,2014-11-21 14:25:45-08:00,['457744a820d806e546edebbd8ffd33f6772e519f'],1,3,4,520254,1,,,,1372
409c367ceb5f9eae395cb346dd3fa02b8ee8ee70,1,Neha Narkhede,2014-11-23 16:41:24-08:00,['f0fd70929a1ad607aa1fbf6ed9b40b16ab95b807'],10,150,160,520414,3,0.829268293,1,1,1373
72601f783e24217734a3923c6318e12a0f600d0f,1,Guozhang Wang,2014-11-24 11:45:14-08:00,['409c367ceb5f9eae395cb346dd3fa02b8ee8ee70'],12,12,24,520438,5,,,,1373
9f8b8dad2b7ad31c9595f559f6d9e7d07d2f696d,1,Guozhang Wang,2014-11-24 14:38:49-08:00,['72601f783e24217734a3923c6318e12a0f600d0f'],63,87,150,520588,5,0.357142857,0.428571429,0,1373
834b6419806750ff555e8ffd104caa420004e84e,1,Jun Rao,2014-11-25 14:36:31-08:00,['9f8b8dad2b7ad31c9595f559f6d9e7d07d2f696d'],60,218,278,520866,6,0.75,0.533333333,1,1374
4408f487ae911e29dbc6ef4d94010a6fad702109,0,Guozhang Wang,2014-12-01 10:09:58-08:00,['834b6419806750ff555e8ffd104caa420004e84e'],1,1,2,520868,1,,,,1374
8a719e037201e343e22a3d2479651e781ddaccc1,1,Jun Rao,2014-12-01 16:02:47-08:00,['4408f487ae911e29dbc6ef4d94010a6fad702109'],1,6,7,520875,1,0,0,1,1374
74bc8860c3c3d582f88581fc7d9edffdfa2dc3a5,1,Jun Rao,2014-12-01 16:04:01-08:00,['8a719e037201e343e22a3d2479651e781ddaccc1'],0,100,100,520975,1,1,1,1,1375
b24f9c0890302a5149aaaf26dc933bd0a842f1be,0,Jun Rao,2014-12-01 16:24:31-08:00,['74bc8860c3c3d582f88581fc7d9edffdfa2dc3a5'],3,16,19,520994,2,0.076923077,0.538461538,0.538461538,1375
723fa4c40d2d04a8557ef9a0ae1626e56f30a9a3,1,Neha Narkhede,2014-12-02 15:17:42-08:00,['b24f9c0890302a5149aaaf26dc933bd0a842f1be'],2,28,30,521024,2,1,1,1,1375
15f9e2762d32a0345a5ca13a1e981be646856b41,0,Jun Rao,2014-12-02 16:35:02-08:00,['723fa4c40d2d04a8557ef9a0ae1626e56f30a9a3'],2,0,2,521026,1,,,,1375
7e9368baf2e1cd457293b815a665e5d3e4418dfb,1,Jun Rao,2014-12-02 17:53:21-08:00,['15f9e2762d32a0345a5ca13a1e981be646856b41'],4,3,7,521033,1,,,,1375
3cc10d5ff9bf73cff2045685f89d71fee92a41f4,1,Guozhang Wang,2014-12-04 13:51:44-08:00,['7e9368baf2e1cd457293b815a665e5d3e4418dfb'],79,116,195,521228,8,1,1,1,1376
09e2fd651e0a98a96107f0ee1087c785a54b4e20,1,Joe Stein,2014-12-05 08:37:11-05:00,['3cc10d5ff9bf73cff2045685f89d71fee92a41f4'],1,427,428,521656,7,,,,1381
4fc74958e3569f6179c11fddace99b674c81f370,1,Neha Narkhede,2014-12-05 09:18:34-08:00,['09e2fd651e0a98a96107f0ee1087c785a54b4e20'],6,10,16,521672,1,0,0,1,1381
2801629964882015a9148e1c0ade22da46376faa,1,Guozhang Wang,2014-12-05 15:18:25-08:00,['4fc74958e3569f6179c11fddace99b674c81f370'],85,493,578,522250,6,0.465648855,0.56870229,0.996183206,1382
e8ffbd0fee0bc715ad0fe6c9afe85715f84d8e51,0,Joe Stein,2014-12-12 03:46:29-05:00,['2801629964882015a9148e1c0ade22da46376faa'],50,91,141,522391,2,0.09375,1,1,1382
0ef631bc694d0c6071450c43501ca319a58859f4,1,Jun Rao,2014-12-12 11:37:57-08:00,['e8ffbd0fee0bc715ad0fe6c9afe85715f84d8e51'],3,12,15,522406,2,0.777777778,1,1,1382
523b36589e942cb99a95debd2c45e795ae533d08,0,Jun Rao,2014-12-12 11:51:41-08:00,['0ef631bc694d0c6071450c43501ca319a58859f4'],1,4,5,522411,1,0,1,1,1382
ae0bb84fa7e599774cd984196dc62b3dc84b13ca,1,Neha Narkhede,2014-12-16 20:33:28-08:00,['523b36589e942cb99a95debd2c45e795ae533d08'],4,95,99,522510,3,1,0.820512821,1,1382
92d1d4cd31e1045f0e000e8d2d777c73f7529743,1,Jun Rao,2014-12-17 16:29:09-08:00,['ae0bb84fa7e599774cd984196dc62b3dc84b13ca'],158,499,657,523167,32,0.538461538,0.961538462,0,1388
84521872d18dd90aff6eb47d470893f64749783f,1,Neha Narkhede,2014-12-18 17:05:55-08:00,['92d1d4cd31e1045f0e000e8d2d777c73f7529743'],6,4,10,523177,1,1,1,0,1388
10c6dec34dae8820bf7ce24839c938135f9a9189,1,Joel Koshy,2014-12-23 17:04:45-08:00,['84521872d18dd90aff6eb47d470893f64749783f'],168,423,591,523768,6,0.133928571,0.910714286,1,1389
4471dc08b64809f3cdcbff6b8c830e13df87b117,1,Jun Rao,2015-01-06 10:56:32-08:00,['10c6dec34dae8820bf7ce24839c938135f9a9189'],3,14,17,523785,1,0,0.666666667,0.666666667,1389
50b734690a93e58030f69cede8d0a84d1e3f5461,1,Jun Rao,2015-01-06 11:40:26-08:00,['4471dc08b64809f3cdcbff6b8c830e13df87b117'],99,370,469,524254,24,0.623529412,0.864705882,0.729411765,1392
517503db2616531b08ee4d08d39c0e1c0bd19e97,1,Jun Rao,2015-01-06 12:10:04-08:00,['50b734690a93e58030f69cede8d0a84d1e3f5461'],2,6,8,524262,1,0,0.333333333,0.666666667,1392
f82518a85001307334132056fe32c28b452cf48b,1,Joe Stein,2015-01-06 22:40:27-05:00,['517503db2616531b08ee4d08d39c0e1c0bd19e97'],14,36,50,524312,3,0,1,1,1392
a93ef199b2375c422e35d82ac7aa3a2fdacc1e74,0,Jun Rao,2015-01-09 11:27:00-08:00,['f82518a85001307334132056fe32c28b452cf48b'],3,11,14,524326,3,0,1,1,1392
e52a6181bf0969f315ac0f0d325eac34d2b4a6ee,0,Jun Rao,2015-01-09 11:33:48-08:00,['a93ef199b2375c422e35d82ac7aa3a2fdacc1e74'],2,13,15,524341,2,0,1,1,1392
b1b80860a01cc378cfada3549a3480f0773c3ff8,1,Neha Narkhede,2015-01-12 15:45:29-08:00,['e52a6181bf0969f315ac0f0d325eac34d2b4a6ee'],25,596,621,524962,9,0.350574713,0.747126437,1,1397
ad4883a0cd5afc4219e28cdafbd98576eeaee2d1,1,Neha Narkhede,2015-01-12 15:59:16-08:00,['b1b80860a01cc378cfada3549a3480f0773c3ff8'],11,43,54,525016,2,0,0.095238095,1,1397
14779dddb6a9bb3aefbaa825a62874f89bb47d2c,1,Neha Narkhede,2015-01-12 21:12:34-08:00,['ad4883a0cd5afc4219e28cdafbd98576eeaee2d1'],12,103,115,525131,5,0.232142857,1,0.857142857,1397
6f4dea9dbce5cc9f69a917182981b41a56a98a85,0,Jun Rao,2015-01-12 21:29:40-08:00,['14779dddb6a9bb3aefbaa825a62874f89bb47d2c'],8,5,13,525144,3,,,,1397
688e38ce45a7358a1e0bb359aa9b1a698a841619,1,Jun Rao,2015-01-12 22:02:02-08:00,['6f4dea9dbce5cc9f69a917182981b41a56a98a85'],300,533,833,525977,27,0.075630252,0.789915966,0.672268908,1398
e79ebdfe222288f2c5d997ba7e7c5e18c8c514ed,0,Neha Narkhede,2015-01-13 09:39:29-08:00,['688e38ce45a7358a1e0bb359aa9b1a698a841619'],8,23,31,526008,1,0.615384615,0.615384615,1,1398
bfb2da3c82ab01f5914d5559ee196d5aa977b17c,1,Jun Rao,2015-01-13 09:54:54-08:00,['e79ebdfe222288f2c5d997ba7e7c5e18c8c514ed'],4,3,7,526015,1,0,0,1,1398
a611178408cf8497054ff015caba18cfcff70a60,0,Jun Rao,2015-01-14 12:02:50-08:00,['bfb2da3c82ab01f5914d5559ee196d5aa977b17c'],20,26,46,526061,2,,,,1398
1c8f89bc73ec1844371c812215b255db037e24a5,1,Joel Koshy,2015-01-14 18:46:38-08:00,['a611178408cf8497054ff015caba18cfcff70a60'],29,201,230,526291,10,0.928571429,0.964285714,0.696428571,1399
45697ed6c6132475b5dd4dd0069a2a192a75d329,1,Joel Koshy,2015-01-15 08:04:29-08:00,['1c8f89bc73ec1844371c812215b255db037e24a5'],17,17,34,526325,6,1,1,1,1399
602d572f6365f80f14e8c968390972ea9767e263,0,Jun Rao,2015-01-15 17:58:32-08:00,['45697ed6c6132475b5dd4dd0069a2a192a75d329'],4,0,4,526329,1,1,1,0,1399
1769642bb779921267bd57d3d338591dbdf33842,0,Jun Rao,2015-01-16 18:34:39-08:00,['602d572f6365f80f14e8c968390972ea9767e263'],3,6,9,526338,4,,,,1399
5174df53778cb5cb2d6d86e4cec9f3185a2c85db,1,Jun Rao,2015-01-16 18:56:32-08:00,['1769642bb779921267bd57d3d338591dbdf33842'],5,30,35,526373,5,0,0.125,1,1399
09234f0e5206b8cb55e89cffc4a0ecfbaafc7f86,0,Jun Rao,2015-01-16 19:04:11-08:00,['5174df53778cb5cb2d6d86e4cec9f3185a2c85db'],1,1,2,526375,1,,,,1399
49d7f8ee1cd96a99f44ac48043db9ad8a5336c7d,0,Jun Rao,2015-01-19 08:44:53-08:00,['09234f0e5206b8cb55e89cffc4a0ecfbaafc7f86'],3,3,6,526381,2,,,,1399
07cff763633f20f51310e4f123963aaa0c008b2f,0,Jun Rao,2015-01-19 09:05:25-08:00,['49d7f8ee1cd96a99f44ac48043db9ad8a5336c7d'],1,4,5,526386,1,,,,1399
5d648cfdb13dee078bb1b3415f77dbe2d47d7ec4,0,Jun Rao,2015-01-19 11:18:23-08:00,['07cff763633f20f51310e4f123963aaa0c008b2f'],8,8,16,526402,2,,,,1399
fcc2521858efd1bd99e06c319de9489330125a4d,0,Joel Koshy,2015-01-20 13:13:50-08:00,['5d648cfdb13dee078bb1b3415f77dbe2d47d7ec4'],4,6,10,526412,1,0,0,0,1399
a0852d477ec097bd4efe120c21de020fccf6dc49,0,Guozhang Wang,2015-01-21 17:25:54-08:00,['fcc2521858efd1bd99e06c319de9489330125a4d'],29,28,57,526469,1,1,1,0,1399
54e53b7312274a3599229a36caa35f0cd931e341,0,Joe Stein,2015-01-22 22:29:33-05:00,['a0852d477ec097bd4efe120c21de020fccf6dc49'],1,1,2,526471,1,,,,1399
8cff9119f8d125e55898e2095512b90826522336,0,Neha Narkhede,2015-01-23 09:07:26-08:00,['54e53b7312274a3599229a36caa35f0cd931e341'],3,3,6,526477,1,,,,1399
ff5cbcacc6fc3217ea41c624fb293adeae7bb672,0,Guozhang Wang,2015-01-23 18:23:32-08:00,['8cff9119f8d125e55898e2095512b90826522336'],1,1,2,526479,1,,,,1399
995d0d369363ef3ad7cf43980746c52768b4df2e,0,Neha Narkhede,2015-01-25 18:43:28-08:00,['ff5cbcacc6fc3217ea41c624fb293adeae7bb672'],1,1,2,526481,1,,,,1399
4aa3dab3de088096461941353ba27cb37f1bd9d1,0,Neha Narkhede,2015-01-25 18:54:58-08:00,['995d0d369363ef3ad7cf43980746c52768b4df2e'],15,17,32,526513,1,0,0,1,1399
0b171dee1fca16595f635bc9991056712e9e3b1a,0,Neha Narkhede,2015-01-25 19:15:57-08:00,['4aa3dab3de088096461941353ba27cb37f1bd9d1'],1,6,7,526520,2,,,,1399
0f6cc0a058bbd2736f1e638448fc64b58a9f6b41,0,Neha Narkhede,2015-01-25 19:28:14-08:00,['0b171dee1fca16595f635bc9991056712e9e3b1a'],20,22,42,526562,2,1,0,1,1399
f689e9b1e361cdf47e9966567631c06f614e446d,1,Jun Rao,2015-01-28 19:07:39-06:00,['0f6cc0a058bbd2736f1e638448fc64b58a9f6b41'],2,25,27,526589,1,0.095238095,1,0.714285714,1399
11ec9bf5a5f150e5c172f88bb3e60b197ee9df5a,0,Jun Rao,2015-01-28 19:33:15-06:00,['f689e9b1e361cdf47e9966567631c06f614e446d'],0,3,3,526592,1,,,,1399
0699ff2ce60abb466cab5315977a224f1a70a4da,1,Jay Kreps,2015-01-29 02:55:35-08:00,['11ec9bf5a5f150e5c172f88bb3e60b197ee9df5a'],1947,3984,5931,532523,89,0.425940138,0.767459708,0.801227936,1409
75a286e4308831203cc7e1d4748bdab504e8a1f3,0,Jay Kreps,2015-01-29 20:09:36-08:00,['0699ff2ce60abb466cab5315977a224f1a70a4da'],2,3,5,532528,1,1,1,1,1409
f1ba4ff87e60a6dc06fb3d16e84fa94f8c4a7d9e,0,Joel Koshy,2015-02-02 18:17:15-08:00,['75a286e4308831203cc7e1d4748bdab504e8a1f3'],3,35,38,532566,5,1,1,0.571428571,1409
1c6d5bbac672cbf49591aed0889510b10e3285fa,1,Jay Kreps,2015-02-03 09:16:55-08:00,['f1ba4ff87e60a6dc06fb3d16e84fa94f8c4a7d9e'],3468,1972,5440,538006,97,0,1,0,1414
0839def4bdbfd9f5939e463f42cfbc81a98a8eff,0,Guozhang Wang,2015-02-09 09:33:16-08:00,['1c6d5bbac672cbf49591aed0889510b10e3285fa'],2,3,5,538011,3,1,1,1,1414
39cd48de321585ac55c94ec407fede5858f38962,1,Guozhang Wang,2015-02-09 15:13:10-08:00,['0839def4bdbfd9f5939e463f42cfbc81a98a8eff'],111,179,290,538301,10,0.15,0,1,1414
71602de0bbf7727f498a812033027f6cbfe34eb8,1,Guozhang Wang,2015-02-09 15:24:44-08:00,['39cd48de321585ac55c94ec407fede5858f38962'],0,645,645,538946,7,0.853448276,1,0.732758621,1421
9fe9913e95e1d3e114c74620d8da40f804f71b18,1,Neha Narkhede,2015-02-10 11:59:01-08:00,['71602de0bbf7727f498a812033027f6cbfe34eb8'],48,641,689,539635,6,0.542079208,0.735148515,0.685643564,1423
a3d6dcaf1bcc6189c3ef17b63719ae4d12dcb789,0,Guozhang Wang,2015-02-12 17:09:42-08:00,['9fe9913e95e1d3e114c74620d8da40f804f71b18'],1,6,7,539642,2,0,1,1,1423
eab4f4c9f43e20b3d91bf0e2e9be6b6fd72f0acf,1,Joel Koshy,2015-02-13 13:08:10-08:00,['a3d6dcaf1bcc6189c3ef17b63719ae4d12dcb789'],62,111,173,539815,8,0.807692308,1,0.461538462,1424
5b949c7b1ad5ab3f71cae6024eea10b59a7ad9b6,1,Guozhang Wang,2015-02-17 16:18:35-08:00,['eab4f4c9f43e20b3d91bf0e2e9be6b6fd72f0acf'],0,76,76,539891,2,0.472222222,0.722222222,1,1425
b8be3140b68cb62d908ca78fe280b089ded851b8,0,Joel Koshy,2015-02-17 17:33:04-08:00,['5b949c7b1ad5ab3f71cae6024eea10b59a7ad9b6'],3,7,10,539901,1,0,0,0,1425
cb40ec2e7a73bdecdfea6c88ffd8e8717b630d0f,1,Joel Koshy,2015-02-17 17:36:12-08:00,['b8be3140b68cb62d908ca78fe280b089ded851b8'],1,15,16,539917,3,0.5,0.5,0.5,1425
cdf06564458ac384119d21ac8b25a3a7ebe27014,0,Joel Koshy,2015-02-17 23:48:21-08:00,['cb40ec2e7a73bdecdfea6c88ffd8e8717b630d0f'],5,5,10,539927,1,,,,1425
d5fbba633612fd08f15c523362a0c1ff5a121ff2,1,Joel Koshy,2015-02-17 23:49:57-08:00,['cdf06564458ac384119d21ac8b25a3a7ebe27014'],0,2,2,539929,1,,,,1425
f5684366ef60125c4d799121a6c0adca4744e8ab,1,Jun Rao,2015-02-18 13:39:05-08:00,['d5fbba633612fd08f15c523362a0c1ff5a121ff2'],11,23,34,539963,1,0,0,1,1425
8d72816f48d18d61e8ef8b174896c6d177a09a92,0,Joel Koshy,2015-02-18 14:38:03-08:00,['f5684366ef60125c4d799121a6c0adca4744e8ab'],3,0,3,539966,1,0,0,0,1425
f7f8ac1a8864acdbfc52326edc7cbeb9e35f4adf,0,Joel Koshy,2015-02-18 16:37:29-08:00,['8d72816f48d18d61e8ef8b174896c6d177a09a92'],0,3,3,539969,1,1,1,1,1425
4c8817e3d156416240906dd06a4494386949ba0a,0,Joel Koshy,2015-02-18 18:01:15-08:00,['f7f8ac1a8864acdbfc52326edc7cbeb9e35f4adf'],1,9,10,539979,1,1,1,0,1425
38346fb106064a10047ecc7cefa634c6f1b09960,0,Neha Narkhede,2015-02-20 14:36:57-08:00,['4c8817e3d156416240906dd06a4494386949ba0a'],2,2,4,539983,1,,,,1425
8c1b9325be4adc5065c6dbe3dcdbdccb1887d604,1,Neha Narkhede,2015-02-20 16:22:23-08:00,['38346fb106064a10047ecc7cefa634c6f1b09960'],16,8,24,540007,3,0,1,1,1425
fbb11549743aa00420e40696f11b48a705dce019,0,Neha Narkhede,2015-02-20 16:33:15-08:00,['8c1b9325be4adc5065c6dbe3dcdbdccb1887d604'],19,10,29,540036,1,0,0,0,1425
19031823c15cb3a0e5fcecaaf5de79c09b5300ed,0,Jay Kreps,2015-02-21 15:39:23-08:00,['fbb11549743aa00420e40696f11b48a705dce019'],2,12,14,540050,2,1,1,0.6,1425
62c7e0e485b8b7693354c3a0a0bf95af671c93b6,0,Neha Narkhede,2015-02-21 20:27:23-08:00,['19031823c15cb3a0e5fcecaaf5de79c09b5300ed'],2,3,5,540055,1,0,1,1,1425
3f1e0882297a102843dcd17e05f54ddbedb4882a,1,Jay Kreps,2015-02-21 21:10:28-08:00,['62c7e0e485b8b7693354c3a0a0bf95af671c93b6'],0,2,2,540057,1,1,1,1,1425
41189ea5601837bdb697ade31f55e244abbe6d1c,0,Jun Rao,2015-02-23 11:51:32-08:00,['3f1e0882297a102843dcd17e05f54ddbedb4882a'],26,31,57,540114,4,0.086956522,0.086956522,0,1425
7c82afddc812908f9289ded4e2cb0733b8116a77,1,Neha Narkhede,2015-02-24 08:25:33-08:00,['41189ea5601837bdb697ade31f55e244abbe6d1c'],0,17,17,540131,1,,,,1426
10311c138923dcded5d8f57f587c7f7ef1119dac,1,Jun Rao,2015-02-24 14:07:27-08:00,['7c82afddc812908f9289ded4e2cb0733b8116a77'],23,45,68,540199,3,0.2,0.2,0.866666667,1426
b8904e9614b4c1f11b8487e7a4b88b1e37e1f20b,1,Joel Koshy,2015-02-25 10:59:28-08:00,['10311c138923dcded5d8f57f587c7f7ef1119dac'],13,93,106,540305,9,0.966666667,0.966666667,0.966666667,1426
ef252dea704192a8055367d22e45f673f5b06e94,0,Jun Rao,2015-02-26 15:03:12-08:00,['b8904e9614b4c1f11b8487e7a4b88b1e37e1f20b'],0,2,2,540307,1,0,1,1,1426
e39373d16bc208128d5d6cf0e0672f27f35e3b20,0,Jun Rao,2015-02-26 18:02:19-08:00,['ef252dea704192a8055367d22e45f673f5b06e94'],1,4,5,540312,1,1,1,1,1426
a864172da53db009607989e2d7a6c0ff1c600995,0,Neha Narkhede,2015-02-27 14:11:21-08:00,['e39373d16bc208128d5d6cf0e0672f27f35e3b20'],289,0,289,540601,1,0.710227273,0,0,1426
b56f5973c739072350f3f6bf6efa4eb05bc692bf,1,Neha Narkhede,2015-02-27 15:10:01-08:00,['a864172da53db009607989e2d7a6c0ff1c600995'],10,183,193,540794,2,1,1,0.875,1427
687abc98a4600bf90ed7a7acb6fb2a5e6eac2055,1,Neha Narkhede,2015-02-27 16:10:47-08:00,['b56f5973c739072350f3f6bf6efa4eb05bc692bf'],8,52,60,540854,4,1,1,1,1427
22ff9e943a960a73d2f007b2c52b90e675a61299,1,Neha Narkhede,2015-02-28 07:41:37-08:00,['687abc98a4600bf90ed7a7acb6fb2a5e6eac2055'],43,148,191,541045,2,0.794871795,1,1,1428
0636928d961a6ceaab46d908f9372d913c3e5faf,1,Jay Kreps,2015-02-28 14:11:59-08:00,['22ff9e943a960a73d2f007b2c52b90e675a61299'],99,393,492,541537,18,0.633333333,1,0.966666667,1429
1cd6ed9e2c07a63474ed80a8224bd431d5d4243c,1,Joel Koshy,2015-03-03 10:44:04-08:00,['0636928d961a6ceaab46d908f9372d913c3e5faf'],106,235,341,541878,8,0.097560976,0,0.682926829,1429
616987d196b654486a1261f4eed50e48560e3041,0,Joel Koshy,2015-03-03 11:16:38-08:00,['1cd6ed9e2c07a63474ed80a8224bd431d5d4243c'],20,55,75,541953,5,0.76,0.88,0.88,1429
c5d654acb2097eabb1784dcc88145e111a3d037b,1,Joel Koshy,2015-03-03 11:18:07-08:00,['616987d196b654486a1261f4eed50e48560e3041'],2,2,4,541957,1,,,,1429
57d38f672bcb85fdb20d8ca3fab9bd60d1bc8965,0,Joel Koshy,2015-03-03 11:21:04-08:00,['c5d654acb2097eabb1784dcc88145e111a3d037b'],0,4,4,541961,1,0,0,0,1429
61f02fa542380e70c837fbc52deac74daec62505,0,Joel Koshy,2015-03-03 16:03:24-08:00,['57d38f672bcb85fdb20d8ca3fab9bd60d1bc8965'],1,0,1,541962,1,,,,1429
4c9ad9b8a23e5487fc17579c46472c3693114d8b,0,Joel Koshy,2015-03-03 16:14:03-08:00,['61f02fa542380e70c837fbc52deac74daec62505'],0,1,1,541963,1,,,,1429
151ae42cdf2f54d83563da7c90cd087b99300408,1,Jun Rao,2015-03-03 16:53:50-08:00,['4c9ad9b8a23e5487fc17579c46472c3693114d8b'],3,5,8,541971,1,0,1,1,1429
00c643e6fd6b54c7270e2b5a27441d738c7bcbd5,0,Joel Koshy,2015-03-03 16:57:07-08:00,['151ae42cdf2f54d83563da7c90cd087b99300408'],2,2,4,541975,1,,,,1429
3a9f4b833bb7e86dc759361c33f4321ab043db05,0,Guozhang Wang,2015-03-03 17:15:30-08:00,['00c643e6fd6b54c7270e2b5a27441d738c7bcbd5'],5,29,34,542009,3,1,1,1,1429
8f0003f9b694b4da5fbd2f86db872d77a43eb63f,1,Joe Stein,2015-03-05 09:53:27-05:00,['3a9f4b833bb7e86dc759361c33f4321ab043db05'],515,1521,2036,544045,48,0.082725061,0.566909976,0.99026764,1430
67940c43e0efa6a49af1fe928fe73a13b21d57f1,0,Jay Kreps,2015-03-08 15:10:54-07:00,['8f0003f9b694b4da5fbd2f86db872d77a43eb63f'],2,4,6,544051,1,1,1,1,1430
0b92cec1e07a1f2d9aa70f3ecd7d0fb12290d2e2,1,Guozhang Wang,2015-03-10 11:19:48-07:00,['67940c43e0efa6a49af1fe928fe73a13b21d57f1'],905,2346,3251,547302,46,0.488734835,0.979202773,0.797227036,1437
01d2a25235841feb01eac55f6ea5141750225a21,0,Guozhang Wang,2015-03-10 16:18:00-07:00,['0b92cec1e07a1f2d9aa70f3ecd7d0fb12290d2e2'],21,21,42,547344,6,1,,1,1437
1eb5f53aa4f5c5c0f67ce62d86e8d9b4e5bbc500,0,Guozhang Wang,2015-03-10 17:31:17-07:00,['01d2a25235841feb01eac55f6ea5141750225a21'],3,2,5,547349,3,,,,1437
01f20e029fbd068a8493492a2c4a1364a5668579,1,Guozhang Wang,2015-03-11 16:25:21-07:00,['1eb5f53aa4f5c5c0f67ce62d86e8d9b4e5bbc500'],3,7,10,547359,4,1,1,1,1437
b7439c8081465f8764e88326b3fa7b320f99f130,1,Jun Rao,2015-03-12 13:56:52-07:00,['01f20e029fbd068a8493492a2c4a1364a5668579'],5,21,26,547385,6,0,0.875,0.375,1437
c41c7b40b63ecd668c727a897f29e276a1c5adf7,1,Guozhang Wang,2015-03-13 15:07:48-07:00,['b7439c8081465f8764e88326b3fa7b320f99f130'],521,358,879,548264,7,0.783783784,0.22972973,0,1437
1caaf6db400df7e37b7f0416bb83ab451018a5c8,0,Guozhang Wang,2015-03-13 15:17:08-07:00,['c41c7b40b63ecd668c727a897f29e276a1c5adf7'],2,62,64,548328,6,,,,1437
5bbbb7fddbddc823b0946fda6e82dfba4ab8b5fd,0,Guozhang Wang,2015-03-17 14:22:01-07:00,['1caaf6db400df7e37b7f0416bb83ab451018a5c8'],6,6,12,548340,1,,,,1437
82789e75199fdc1cae115c5c2eadfd0f1ece4d0d,0,Guozhang Wang,2015-03-18 14:58:11-07:00,['5bbbb7fddbddc823b0946fda6e82dfba4ab8b5fd'],8,9,17,548357,1,0.5,0.5,1,1437
b2c833aa41cb9a7a6232781b273402042e021607,1,Guozhang Wang,2015-03-19 15:52:54-07:00,['82789e75199fdc1cae115c5c2eadfd0f1ece4d0d'],13,16,29,548386,4,1,1,1,1437
c62cff355936eea2a96e3b9678c761334fce8ee2,0,Guozhang Wang,2015-03-19 16:10:23-07:00,['b2c833aa41cb9a7a6232781b273402042e021607'],2,1,3,548389,2,,,,1437
991195416e0c179d2d2a79891d0214244c287618,1,Guozhang Wang,2015-03-24 15:48:46-07:00,['c62cff355936eea2a96e3b9678c761334fce8ee2'],3,15,18,548407,2,0.75,1,1,1437
4e0da4965b83b25debdec4d55e075c18be436fa8,0,Guozhang Wang,2015-03-24 20:56:22-07:00,['991195416e0c179d2d2a79891d0214244c287618'],1,1,2,548409,1,,,,1437
eb2100876b70d1e0d53a88c2513ca3a4ac7a1c1e,1,Joe Stein,2015-03-25 01:57:42-04:00,['4e0da4965b83b25debdec4d55e075c18be436fa8'],0,457,457,548866,1,0.821576763,0.77593361,0.680497925,1438
a74688de46c23dd34ad964372fbed05c1f7f4b3e,1,Jun Rao,2015-03-25 13:08:38-07:00,['eb2100876b70d1e0d53a88c2513ca3a4ac7a1c1e'],31,370,401,549267,3,0.845814978,0.929515419,0.977973568,1440
5b42b538eb46203f7fd308cb3d3f27dde98840b8,0,Guozhang Wang,2015-03-25 14:01:19-07:00,['a74688de46c23dd34ad964372fbed05c1f7f4b3e'],30,19,49,549316,1,1,1,0,1440
d2f50fc3886896bc569fea7fb308036008b89f94,1,Guozhang Wang,2015-03-26 15:43:18-07:00,['5b42b538eb46203f7fd308cb3d3f27dde98840b8'],28,52,80,549396,6,0,1,1,1440
c5df2a8e3acca1e2c905fa6b78e73e09b1dd0cd7,1,Guozhang Wang,2015-03-26 17:16:33-07:00,['d2f50fc3886896bc569fea7fb308036008b89f94'],172,490,662,550058,17,0.141104294,0.447852761,0.865030675,1440
d8fe98efee5a44ae12c1e3484fa20f89b0f30054,1,Jun Rao,2015-03-28 08:39:48-07:00,['c5df2a8e3acca1e2c905fa6b78e73e09b1dd0cd7'],218,287,505,550563,26,0.539325843,0.629213483,1,1441
66c6f9b1c436187635674f82a9e9940d8f5331f2,0,Jun Rao,2015-04-01 13:26:45-07:00,['d8fe98efee5a44ae12c1e3484fa20f89b0f30054'],15,15,30,550593,6,,,,1441
619d78eb521185f365a002e5f1987b75d3f35192,1,Jun Rao,2015-04-01 16:14:48-07:00,['66c6f9b1c436187635674f82a9e9940d8f5331f2'],0,275,275,550868,1,0.384615385,1,1,1442
ad722531daafadbcb27b0c0db0b9fcbb68b25b28,0,Jun Rao,2015-04-02 18:20:54-07:00,['619d78eb521185f365a002e5f1987b75d3f35192'],1,1,2,550870,2,0,1,0,1442
48f997047228c327f91e8f848142b4607366fc3e,1,Neha Narkhede,2015-04-03 11:43:59-07:00,['ad722531daafadbcb27b0c0db0b9fcbb68b25b28'],7,52,59,550929,2,0,0.25,1,1442
15b93a410a8e988e09dc147c6d5250cbbe328b26,1,Joel Koshy,2015-04-03 18:40:17-07:00,['48f997047228c327f91e8f848142b4607366fc3e'],88,177,265,551194,10,0,0.948717949,1,1442
6adaffd8ea4bc1f40bd5cf5268c30eb2df1868ab,1,Jay Kreps,2015-04-04 14:26:38-07:00,['15b93a410a8e988e09dc147c6d5250cbbe328b26'],551,732,1283,552477,54,0.772727273,0.993506494,0.935064935,1445
70e5c92e213bff7502288c610c252735d6b68c08,1,Jay Kreps,2015-04-04 15:17:09-07:00,['6adaffd8ea4bc1f40bd5cf5268c30eb2df1868ab'],1,1,2,552479,1,,,,1445
a686a67f60beb42eb3d4942508fb15b636e5100d,0,Jay Kreps,2015-04-04 15:27:41-07:00,['70e5c92e213bff7502288c610c252735d6b68c08'],1,1,2,552481,1,,,,1445
7acfa92c09bbfeb6d28a0771c09d36c9c89fc31f,1,Jay Kreps,2015-04-04 15:56:17-07:00,['a686a67f60beb42eb3d4942508fb15b636e5100d'],1,48,49,552530,2,0,0.083333333,1,1445
9a071017ee80331dc5b776e04ee2ed77f1d751db,0,Jay Kreps,2015-04-04 16:05:45-07:00,['7acfa92c09bbfeb6d28a0771c09d36c9c89fc31f'],2,2,4,552534,2,,,,1445
07598ad8a4e508e738c4af11f16b1649d90d5fdb,0,Jay Kreps,2015-04-04 19:36:54-07:00,['9a071017ee80331dc5b776e04ee2ed77f1d751db'],1,2,3,552537,1,0,0,1,1445
53f31432a0e1da78abf31ad42297790445083072,1,Jun Rao,2015-04-05 17:21:37-07:00,['07598ad8a4e508e738c4af11f16b1649d90d5fdb'],487,1497,1984,554521,88,0.658163265,0.821428571,0.977040816,1454
9c23d93553a33c5d85231193614d192a9945796e,1,Jun Rao,2015-04-05 21:46:11-07:00,['53f31432a0e1da78abf31ad42297790445083072'],1141,412,1553,556074,100,0.297029703,0.297029703,0.306930693,1454
75e1cc8bc497e6aaa0dd05454d6c817ed0fb5e23,1,Jun Rao,2015-04-06 13:34:31-07:00,['9c23d93553a33c5d85231193614d192a9945796e'],24,28,52,556126,4,0,1,0,1454
04fce48e1af183d5133be1044d27e0f526e94f2a,1,Jun Rao,2015-04-06 18:20:45-07:00,['75e1cc8bc497e6aaa0dd05454d6c817ed0fb5e23'],85,85,170,556296,27,,,,1454
b1cc72510792fdf83ac2d6f302ea07c7ea397ce4,0,Jun Rao,2015-04-07 14:40:06-07:00,['04fce48e1af183d5133be1044d27e0f526e94f2a'],3,3,6,556302,1,,,,1454
d9ab917dcc972aa3ef3644aeb4c96094bd9e54d8,1,Jun Rao,2015-04-07 15:10:47-07:00,['b1cc72510792fdf83ac2d6f302ea07c7ea397ce4'],17,21,38,556340,2,0,0,1,1454
79f7cca85e9ed6511ad50cb9412bfa5c8e5b9ddb,1,Guozhang Wang,2015-04-07 15:26:26-07:00,['d9ab917dcc972aa3ef3644aeb4c96094bd9e54d8'],54,87,141,556481,2,0.19047619,1,1,1454
013cda2d79e1b82755cf948b668f4fb40b4efe62,0,Guozhang Wang,2015-04-07 15:38:36-07:00,['79f7cca85e9ed6511ad50cb9412bfa5c8e5b9ddb'],40,6,46,556527,6,0.333333333,0.333333333,0,1454
06a26656ff103d2cdd7dc90f517278bd1df065a7,0,Jun Rao,2015-04-07 21:18:00-07:00,['013cda2d79e1b82755cf948b668f4fb40b4efe62'],203,0,203,556730,1,,,,1454
fef709d51ae3d568c6b6a9ff41a16f1969d4ffd6,0,Jun Rao,2015-04-07 22:18:56-07:00,['06a26656ff103d2cdd7dc90f517278bd1df065a7'],2,1,3,556733,1,,,,1454
b47f811ee14a3a7507f435266bbbce85d71f7744,1,Jun Rao,2015-04-08 13:28:37-07:00,['fef709d51ae3d568c6b6a9ff41a16f1969d4ffd6'],38,38,76,556809,1,,,,1454
d3aa99c54a41d45d42c8fd19b98747b4190d8433,0,Jun Rao,2015-04-08 14:33:47-07:00,['b47f811ee14a3a7507f435266bbbce85d71f7744'],0,5,5,556814,1,0.5,0.5,1,1454
6880f66c97f63b2d1f3750f1753ec8b6094cb8a5,1,Jun Rao,2015-04-08 15:19:59-07:00,['d3aa99c54a41d45d42c8fd19b98747b4190d8433'],109,723,832,557646,9,0.53125,0.96484375,1,1460
194d1fc030561fd06e39224584b58cc49e2f63e8,1,Jun Rao,2015-04-08 17:21:29-07:00,['6880f66c97f63b2d1f3750f1753ec8b6094cb8a5'],0,1,1,557647,1,0,1,1,1460
2490b1c4994295ba6c291b1109c5d67ebb4c244d,0,Jun Rao,2015-04-08 19:06:05-07:00,['194d1fc030561fd06e39224584b58cc49e2f63e8'],1,1,2,557649,1,,,,1460
26673f982e7da885cdb8f615cc7868237106de64,0,Jun Rao,2015-04-09 12:15:25-07:00,['2490b1c4994295ba6c291b1109c5d67ebb4c244d'],1,4,5,557654,1,,,,1460
fb86cf633833b1daa6ccf6f27b68836646d2bcba,0,Jun Rao,2015-04-10 08:09:53-07:00,['26673f982e7da885cdb8f615cc7868237106de64'],1,1,2,557656,1,,,,1460
aa365639b2dd36d8feff761f09208154ce71964d,1,Jun Rao,2015-04-13 09:21:53-05:00,['fb86cf633833b1daa6ccf6f27b68836646d2bcba'],14,20,34,557690,3,,,,1460
157fba840759e39bc1422fdca2597e2d9a77bfb2,0,Guozhang Wang,2015-04-13 18:41:33-07:00,['aa365639b2dd36d8feff761f09208154ce71964d'],1,1,2,557692,1,,,,1460
9e5d481c7ccb5ef82196b7093f3b916194bdd90d,0,Guozhang Wang,2015-04-14 14:42:53-07:00,['157fba840759e39bc1422fdca2597e2d9a77bfb2'],163,139,302,557994,6,0.928571429,0,0.976190476,1460
bfbd3acbf71fa1b913de154f7ffa12aead28a2d2,0,Guozhang Wang,2015-04-15 11:16:58-07:00,['9e5d481c7ccb5ef82196b7093f3b916194bdd90d'],3,7,10,558004,2,,1,,1460
5397d3c53e028a745f9d6dbfe8fc84c859656de0,0,Jun Rao,2015-04-16 10:26:49-07:00,['bfbd3acbf71fa1b913de154f7ffa12aead28a2d2'],7,17,24,558028,1,1,1,1,1460
813c4230d4c25fa3f411a9b9230cd3f605f09a28,0,Jun Rao,2015-04-17 18:02:23-07:00,['5397d3c53e028a745f9d6dbfe8fc84c859656de0'],2,2,4,558032,1,,,,1460
35297a85ee4a0d9af8a3277b5ea79ed7c67496c2,0,Jun Rao,2015-04-18 08:49:01-07:00,['813c4230d4c25fa3f411a9b9230cd3f605f09a28'],0,5,5,558037,1,0,0,1,1460
185eb9b59a9676f641af8bac8e8373ad4dfd5dc6,1,Jun Rao,2015-04-18 09:26:50-07:00,['35297a85ee4a0d9af8a3277b5ea79ed7c67496c2'],19,41,60,558097,2,1,1,0,1460
5408931a2955adf8cb9d604d17dc9b5bd47b4d57,1,Jun Rao,2015-04-19 07:46:58-07:00,['185eb9b59a9676f641af8bac8e8373ad4dfd5dc6'],25,105,130,558227,6,0.537037037,1,0.907407407,1460
7c5b2405d89e279fbb2590a1c16147e488588ce6,0,Jun Rao,2015-04-19 07:53:46-07:00,['5408931a2955adf8cb9d604d17dc9b5bd47b4d57'],0,82,82,558309,2,1,1,1,1462
761711ecaf9ce8a876defdcaf6802c1e048edc3d,0,Jun Rao,2015-04-19 07:56:53-07:00,['7c5b2405d89e279fbb2590a1c16147e488588ce6'],5,5,10,558319,2,,,,1462
3139cc31f6cab26f3dfd429c36280d1567dbf61a,1,Jun Rao,2015-04-19 11:46:18-07:00,['761711ecaf9ce8a876defdcaf6802c1e048edc3d'],19,83,102,558421,6,0.103448276,0.275862069,1,1462
ed11e177d4144a3a803b60f9040ee1bfc17b3b50,0,Neha Narkhede,2015-04-20 09:28:05-07:00,['3139cc31f6cab26f3dfd429c36280d1567dbf61a'],4,4,8,558429,1,,,,1462
6b964461af23e604a1f7f96b24194c276efebe96,0,Neha Narkhede,2015-04-20 09:56:03-07:00,['ed11e177d4144a3a803b60f9040ee1bfc17b3b50'],1,1,2,558431,1,,,,1462
01e94e2b4a22eb0dd9ec4c3bbc353d054b1904b1,1,Guozhang Wang,2015-04-22 10:14:44-07:00,['6b964461af23e604a1f7f96b24194c276efebe96'],171,397,568,558999,11,0.183486239,0,0.688073394,1465
2166104aff174e2ceb45638ca7be34f1db37e3e1,1,Joel Koshy,2015-04-24 12:41:32-07:00,['01e94e2b4a22eb0dd9ec4c3bbc353d054b1904b1'],11,53,64,559063,2,0,0.9,0.9,1465
622e707554f32bf239534c6d8aff566768b85f70,1,Neha Narkhede,2015-04-25 14:43:19-07:00,['2166104aff174e2ceb45638ca7be34f1db37e3e1'],0,2,2,559065,1,,,,1465
ed1a548c503f041c025e00e75d338b4fc4a51f47,1,Neha Narkhede,2015-04-26 08:40:58-07:00,['622e707554f32bf239534c6d8aff566768b85f70'],233,194,427,559492,70,0.384615385,1,0.153846154,1465
ae797467eb36d75083c87520d8ccaa759dafc7bb,0,Neha Narkhede,2015-04-26 09:37:23-07:00,['ed1a548c503f041c025e00e75d338b4fc4a51f47'],15,1,16,559508,10,1,0.333333333,0,1465
4c010fc2d392a8367f1871745ec1bb19b99f558c,0,Neha Narkhede,2015-04-26 12:13:02-07:00,['ae797467eb36d75083c87520d8ccaa759dafc7bb'],0,26,26,559534,1,1,1,1,1466
1000bb6226d09f627b3d89f12300800ebee071e1,1,Neha Narkhede,2015-04-26 12:52:58-07:00,['4c010fc2d392a8367f1871745ec1bb19b99f558c'],1,3,4,559538,1,0,1,1,1466
ba3e089582d46b0193a734b6d1c5ebdd41da4dcc,1,Neha Narkhede,2015-04-26 13:09:09-07:00,['1000bb6226d09f627b3d89f12300800ebee071e1'],0,38,38,559576,2,0.833333333,1,1,1467
dbfe8c0a7dfea65e9f32e6157da1c9a3ce256171,1,Jun Rao,2015-04-26 19:17:15-05:00,['ba3e089582d46b0193a734b6d1c5ebdd41da4dcc'],10,144,154,559730,2,0.175675676,0.175675676,1,1467
97358411af15b64a4bc21c58a0e477fbe9c9b79d,0,Guozhang Wang,2015-04-27 17:41:43-07:00,['dbfe8c0a7dfea65e9f32e6157da1c9a3ce256171'],1,1,2,559732,1,,,,1467
22b3db47e73931a72b8519155be3e48ab5e3849d,0,Jun Rao,2015-04-27 21:35:39-05:00,['97358411af15b64a4bc21c58a0e477fbe9c9b79d'],1,1,2,559734,1,,,,1467
2e90f5e51f688ca2e347668ab83d2d0c2730d071,0,Neha Narkhede,2015-04-27 20:37:51-07:00,['22b3db47e73931a72b8519155be3e48ab5e3849d'],14,17,31,559765,5,0,0,1,1467
f148d8659bca757ff889b404841b423d9e71ba41,1,Neha Narkhede,2015-04-28 09:31:50-07:00,['2e90f5e51f688ca2e347668ab83d2d0c2730d071'],12,11,23,559788,3,,,,1467
161b1aa16ef0821c15fc7283d87cd83336b28d1a,1,Guozhang Wang,2015-05-03 17:26:20-07:00,['f148d8659bca757ff889b404841b423d9e71ba41'],75,161,236,560024,8,0,0,1,1467
e40ebcff6a7da483b5b748053b223a2012c2274c,0,Neha Narkhede,2015-05-04 11:52:37-07:00,['161b1aa16ef0821c15fc7283d87cd83336b28d1a'],0,5,5,560029,1,0,0,1,1467
944628b0f5b5a7873c2bfd3d52c445b7ab0eaff3,0,Neha Narkhede,2015-05-04 11:58:53-07:00,['e40ebcff6a7da483b5b748053b223a2012c2274c'],13,47,60,560089,2,0,0.531914894,1,1467
31dadf0242e2c4884035f9da1b67d2e916e33743,0,Guozhang Wang,2015-05-07 15:48:40-07:00,['944628b0f5b5a7873c2bfd3d52c445b7ab0eaff3'],0,4,4,560093,1,1,1,0,1467
5a47ef8ecbdf574bb18bd9ee5397188097924558,0,Guozhang Wang,2015-05-07 17:04:51-07:00,['31dadf0242e2c4884035f9da1b67d2e916e33743'],8,36,44,560137,5,0.888888889,1,1,1467
4328aa02c0fed198331d7bc6dcddf5d5065ef581,0,Guozhang Wang,2015-05-07 21:52:07-07:00,['5a47ef8ecbdf574bb18bd9ee5397188097924558'],0,46,46,560183,1,1,1,1,1468
af506192332f223393639bb390c38a13e0f2ca82,0,Guozhang Wang,2015-05-11 17:41:54-07:00,['4328aa02c0fed198331d7bc6dcddf5d5065ef581'],7,8,15,560198,1,0,1,1,1468
9b57fe448f01b1b6f844908adf05dd26e174db48,0,Joel Koshy,2015-05-12 13:39:42-07:00,['af506192332f223393639bb390c38a13e0f2ca82'],2,2,4,560202,2,,,,1468
2d5e0f07613fba67a0e22aaeda61789588e6a73b,0,Joel Koshy,2015-05-12 13:44:55-07:00,['9b57fe448f01b1b6f844908adf05dd26e174db48'],73,80,153,560355,2,0.428571429,0.428571429,1,1468
33af0cba3bff87874ae6cef61900cd065edad064,1,Joel Koshy,2015-05-12 15:31:07-07:00,['2d5e0f07613fba67a0e22aaeda61789588e6a73b'],64,332,396,560751,9,0.243589744,0.621794872,0.679487179,1468
49026f11781181c38e9d5edb634be9d27245c961,1,Guozhang Wang,2015-05-14 14:54:59-07:00,['33af0cba3bff87874ae6cef61900cd065edad064'],489,1512,2001,562752,21,0.775434243,0.877171216,0.879652605,1474
41ba26273b497e4cbcc947c742ff6831b7320152,1,Jun Rao,2015-05-18 13:02:47-07:00,['49026f11781181c38e9d5edb634be9d27245c961'],1,17,18,562770,5,1,1,1,1474
0ad646620614f257a0485ef3ff69ad8b83eeaf8d,1,Guozhang Wang,2015-05-19 18:43:18-07:00,['41ba26273b497e4cbcc947c742ff6831b7320152'],137,119,256,563026,10,0,0,1,1474
29419581f5b28b66c7de7d5eb49b3bd6b62c9aba,0,Guozhang Wang,2015-05-19 21:39:32-07:00,['0ad646620614f257a0485ef3ff69ad8b83eeaf8d'],11,12,23,563049,2,0,1,1,1474
bb133c63b0645c22f2d9b76393886fb506b14a93,1,Guozhang Wang,2015-05-20 10:27:39-07:00,['29419581f5b28b66c7de7d5eb49b3bd6b62c9aba'],98,158,256,563305,5,0.159090909,1,0.613636364,1474
b4f2391f9e6d7b8cd29a7d79365517c19799a9e7,1,Joel Koshy,2015-05-20 18:11:52-07:00,['bb133c63b0645c22f2d9b76393886fb506b14a93'],8,16,24,563329,1,1,0.333333333,1,1474
23ff851f30bb55e794aefd2fae5367845d9230ee,0,Joel Koshy,2015-05-21 11:55:40-07:00,['b4f2391f9e6d7b8cd29a7d79365517c19799a9e7'],0,11,11,563340,1,,,,1474
467736c7ad4a24e2eb1048b6fe4211bec02e4a05,0,Joel Koshy,2015-05-21 14:32:58-07:00,['23ff851f30bb55e794aefd2fae5367845d9230ee'],11,0,11,563351,1,,,,1474
43b92f8b1ce8140c432edf11b0c842f5fbe04120,1,Guozhang Wang,2015-05-24 12:02:32-07:00,['467736c7ad4a24e2eb1048b6fe4211bec02e4a05'],56,50,106,563457,21,1,1,0,1474
c60f325014b911b8dec04848d598717e49b09011,0,Jun Rao,2015-05-28 10:16:20-07:00,['43b92f8b1ce8140c432edf11b0c842f5fbe04120'],1,1,2,563459,1,,,,1474
05e8a78145fc3db673bb46be8ba1788558c5a26d,0,Joel Koshy,2015-05-28 13:22:30-07:00,['c60f325014b911b8dec04848d598717e49b09011'],0,11,11,563470,1,,,,1474
d6c45c70fb9773043766446e88370db9709e7995,1,Joel Koshy,2015-05-28 13:27:12-07:00,['05e8a78145fc3db673bb46be8ba1788558c5a26d'],81,168,249,563719,6,1,1,0.65,1475
3836c57865fe9f75f193d9dbdc236c2b81133eac,0,Jun Rao,2015-05-28 17:22:05-07:00,['d6c45c70fb9773043766446e88370db9709e7995'],1,1,2,563721,1,,,,1475
3d8494bca3074f49567f352f6eedd1ed008eeabd,1,Jay Kreps,2015-05-29 14:50:45-07:00,['3836c57865fe9f75f193d9dbdc236c2b81133eac'],28,29,57,563778,3,,,,1475
9e894aa0173b14d64a900bcf780d6b7809368384,0,Jun Rao,2015-06-01 14:15:16-07:00,['3d8494bca3074f49567f352f6eedd1ed008eeabd'],23,60,83,563861,4,0,0.047619048,1,1475
48edeca33b4d47f65ddf47c46b30d0ae605295b8,0,Joel Koshy,2015-06-02 20:55:29-07:00,['9e894aa0173b14d64a900bcf780d6b7809368384'],33,25,58,563919,3,,,,1475
d22987f01d50549d855ae092b69f520d75bfeb7b,1,Guozhang Wang,2015-06-03 13:47:08-07:00,['48edeca33b4d47f65ddf47c46b30d0ae605295b8'],65,156,221,564140,11,0,0,1,1475
78ba492e3e70fd9db61bc82469371d04a8d6b762,1,Jun Rao,2015-06-03 21:40:35-07:00,['d22987f01d50549d855ae092b69f520d75bfeb7b'],1077,1056,2133,566273,67,0.047619048,1,0,1478
ca6d01bc690c2182a611bb65ca46995edc9f356e,0,Joel Koshy,2015-06-05 11:20:25-07:00,['78ba492e3e70fd9db61bc82469371d04a8d6b762'],1,1,2,566275,1,,,,1478
9f80665ec6deff8525b61096034af8dc0cc9a03c,1,Guozhang Wang,2015-06-10 11:28:53-07:00,['ca6d01bc690c2182a611bb65ca46995edc9f356e'],16,29,45,566320,1,1,1,1,1478
ab76dbd1f7f0bfdc9841baee64cfa37de1d870fb,0,Jun Rao,2015-06-11 15:27:51-07:00,['9f80665ec6deff8525b61096034af8dc0cc9a03c'],4,131,135,566455,1,0.275510204,0.448979592,0.775510204,1478
017c00caf44aaad3418cb99d3ef42c4d1b066ddd,1,Jun Rao,2015-06-12 10:24:54-07:00,['ab76dbd1f7f0bfdc9841baee64cfa37de1d870fb'],1,18,19,566474,2,0.888888889,1,1,1478
d31a2c2381bebc9c4b27e36fdf986183732e13eb,1,Jun Rao,2015-06-12 14:16:03-07:00,['017c00caf44aaad3418cb99d3ef42c4d1b066ddd'],27,58,85,566559,3,0,1,0.058823529,1478
719f2bddd147d4583a15ee8398bb0edccbbcc3f4,1,Jun Rao,2015-06-12 18:45:48-07:00,['d31a2c2381bebc9c4b27e36fdf986183732e13eb'],1,1,2,566561,1,,,,1478
20a31a29f7aa6ce6687a13aa0cf60b92c5ac4d1e,1,Jun Rao,2015-06-15 17:43:56-07:00,['719f2bddd147d4583a15ee8398bb0edccbbcc3f4'],5,22,27,566588,3,1,1,1,1478
54e54f08077c9d71a5121e640b55836e6f7f2c9b,1,Jun Rao,2015-06-16 14:46:48-07:00,['20a31a29f7aa6ce6687a13aa0cf60b92c5ac4d1e'],100,192,292,566880,15,0.513513514,0.945945946,0.675675676,1478
395716ebf0af2520a33ef352a62c10a71239bb4f,1,Jun Rao,2015-06-16 15:03:40-07:00,['54e54f08077c9d71a5121e640b55836e6f7f2c9b'],27,15,42,566922,10,,,,1478
28ecea421794d0c9a1c4f95375ccd1a6dfd8f365,1,Jun Rao,2015-06-16 15:25:16-07:00,['395716ebf0af2520a33ef352a62c10a71239bb4f'],1,7,8,566930,2,0,1,1,1478
7009f1d6fffe3866723d1d33a28a4572053eb4e5,1,Jun Rao,2015-06-16 15:30:52-07:00,['28ecea421794d0c9a1c4f95375ccd1a6dfd8f365'],6,6,12,566942,4,,,,1478
478505632edc8f4b51e4ed561d1adf455256c3e4,1,Jun Rao,2015-06-16 15:37:58-07:00,['7009f1d6fffe3866723d1d33a28a4572053eb4e5'],1,2,3,566945,1,0,0,1,1478
9650e12df2502f85ea665ae46a982d6fd0d2a954,0,Jun Rao,2015-06-16 15:50:17-07:00,['478505632edc8f4b51e4ed561d1adf455256c3e4'],1,2,3,566948,1,,,,1478
ba86f0a25dd8675d3c840c33605494a2f637576f,0,Jun Rao,2015-06-16 16:41:20-07:00,['9650e12df2502f85ea665ae46a982d6fd0d2a954'],4,4,8,566956,4,,,,1478
5c9040745466945a04ea0315de583ccdab0614ac,1,Jun Rao,2015-06-18 14:07:33-07:00,['ba86f0a25dd8675d3c840c33605494a2f637576f'],682,444,1126,568082,22,0,0,0,1478
d9c0ad6855b4871694ddf17c9d4546b021302ee8,0,Jun Rao,2015-06-18 15:59:11-07:00,['5c9040745466945a04ea0315de583ccdab0614ac'],12,1,13,568095,1,0,0.25,0.25,1478
5c2ca30f229c7f39fca65aed6bd45c382aacda77,0,Jun Rao,2015-06-18 16:37:25-07:00,['d9c0ad6855b4871694ddf17c9d4546b021302ee8'],3,8,11,568106,1,0,1,1,1478
1c93bb16a91788d3489d4d784c13f1f0fddb6fb7,0,Jun Rao,2015-06-18 17:00:34-07:00,['5c2ca30f229c7f39fca65aed6bd45c382aacda77'],1,1,2,568108,1,,,,1478
19c98cb8ed69d3d6da787dc04e1e88add5f6b9d7,0,Jun Rao,2015-06-18 18:50:52-07:00,['1c93bb16a91788d3489d4d784c13f1f0fddb6fb7'],1,9,10,568118,1,0,0,1,1478
ca758252c5a524fe6135a585282dd4bf747afef2,1,Jun Rao,2015-06-19 07:52:37-07:00,['19c98cb8ed69d3d6da787dc04e1e88add5f6b9d7'],23,204,227,568345,12,0.213675214,0.888888889,0.769230769,1478
16ecf9806b286d9510103a4426bf0901d7dc8778,1,Jun Rao,2015-06-19 09:34:22-07:00,['ca758252c5a524fe6135a585282dd4bf747afef2'],5,46,51,568396,2,0,0.733333333,1,1478
cf28f893963c363bca43747e2f37fad3bb67d033,1,Jun Rao,2015-06-22 08:59:05-07:00,['16ecf9806b286d9510103a4426bf0901d7dc8778'],1,1,2,568398,1,,,,1478
dc54055d05742a4a7729a1fe1073c18e3d95cbb2,1,Jun Rao,2015-06-22 09:19:45-07:00,['cf28f893963c363bca43747e2f37fad3bb67d033'],3,9,12,568410,1,0,1,0,1478
1eac3ceaf94b3e7583c7b6de2cfe13539ab06dd6,1,Joel Koshy,2015-06-22 10:14:14-07:00,['dc54055d05742a4a7729a1fe1073c18e3d95cbb2'],4,297,301,568711,3,0.903409091,1,0.857954545,1479
2270a7537f7734ec02b2391fae280624520a664d,1,Joel Koshy,2015-06-22 15:28:35-07:00,['1eac3ceaf94b3e7583c7b6de2cfe13539ab06dd6'],4,3,7,568718,1,1,0,0,1479
b6d326b0893e60b350608260fd1bd2542337cb5a,1,Jun Rao,2015-06-23 00:09:06-04:00,['2270a7537f7734ec02b2391fae280624520a664d'],542,1330,1872,570590,18,0.626506024,1,1,1482
6d4991e312548bc81e0f6b790a370b6165a92df9,0,Jakob Homan,2015-06-23 10:52:21-07:00,['b6d326b0893e60b350608260fd1bd2542337cb5a'],1,2,3,570593,1,,,,1482
9ff5b27bc572850863f58a3767da3c72aa2a9831,1,Guozhang Wang,2015-06-29 18:48:05-07:00,['6d4991e312548bc81e0f6b790a370b6165a92df9'],4,10,14,570607,1,1,1,0,1482
14e0ce0a47fb7f6ae6dab085b2ea9d5a1f644433,1,Guozhang Wang,2015-07-01 15:28:11-07:00,['9ff5b27bc572850863f58a3767da3c72aa2a9831'],20,21,41,570648,3,0.5,1,1,1482
3f8480ccfb011eb43da774737597c597f703e11b,1,Guozhang Wang,2015-07-02 11:41:51-07:00,['14e0ce0a47fb7f6ae6dab085b2ea9d5a1f644433'],207,357,564,571212,23,0,0.145631068,0.349514563,1482
fd612a2d50f1ee13009395f082357403c4277164,1,Jun Rao,2015-07-06 15:47:40-07:00,['3f8480ccfb011eb43da774737597c597f703e11b'],46,409,455,571667,10,,,,1484
2d96da05a0af7847aca5edc6d003a18be7f5216a,1,Jun Rao,2015-07-06 16:36:20-07:00,['fd612a2d50f1ee13009395f082357403c4277164'],253,370,623,572290,8,0.979591837,0.93877551,1,1487
271b18d119fdc37952c36c573ba185aa672e3f96,0,Guozhang Wang,2015-07-07 09:12:57-07:00,['2d96da05a0af7847aca5edc6d003a18be7f5216a'],2,2,4,572294,1,,,,1487
f77dc386c099da5ff0bac4d2a12b04f7f17f07d3,1,Jun Rao,2015-07-07 09:45:45-07:00,['271b18d119fdc37952c36c573ba185aa672e3f96'],20,158,178,572472,6,0.186046512,0.627906977,0.906976744,1487
ad485e148d7ac104abe173687ba27dccff8e4d39,0,Joe Stein,2015-07-07 10:09:11-07:00,['f77dc386c099da5ff0bac4d2a12b04f7f17f07d3'],3,16,19,572491,3,,,,1487
a99f70feb23db9ac4274cad9e8cbbf9934d3d075,1,Guozhang Wang,2015-07-07 12:42:49-07:00,['ad485e148d7ac104abe173687ba27dccff8e4d39'],2,12,14,572505,2,0,0.428571429,0.571428571,1487
826276de1eaabfebf2a414c69ebcdff17429016c,0,Guozhang Wang,2015-07-07 13:26:00-07:00,['a99f70feb23db9ac4274cad9e8cbbf9934d3d075'],4,10,14,572519,1,0.833333333,1,1,1487
f13dd8024d5bc1c11587a3b539556ea01e2c84ca,0,Guozhang Wang,2015-07-07 13:36:55-07:00,['826276de1eaabfebf2a414c69ebcdff17429016c'],6,6,12,572531,1,,,,1487
23d72bccbeeeb0774b86c47e05cdcd1575a5d38a,0,Joel Koshy,2015-07-07 18:09:00-07:00,['f13dd8024d5bc1c11587a3b539556ea01e2c84ca'],0,1,1,572532,1,0,0,1,1487
4204f4a06bf23160ceec4aa54331db62681bff82,0,Joel Koshy,2015-07-07 21:48:42-07:00,['23d72bccbeeeb0774b86c47e05cdcd1575a5d38a'],0,1,1,572533,1,,,,1487
67b6b9a45ba6f096645f4f344dfdcf1df1e50dd6,0,Guozhang Wang,2015-07-08 09:57:16-07:00,['4204f4a06bf23160ceec4aa54331db62681bff82'],3,5,8,572541,1,1,1,1,1487
7df39e0394a6fd2f26e8f12768ebf7fecd56e3da,0,Gwen Shapira,2015-07-08 10:22:42-07:00,['67b6b9a45ba6f096645f4f344dfdcf1df1e50dd6'],3,3,6,572547,1,,,,1487
ee88dbb67f19b787e12ccef37982c9459b78c7b6,1,Gwen Shapira,2015-07-09 14:58:01-07:00,['7df39e0394a6fd2f26e8f12768ebf7fecd56e3da'],4,477,481,573028,3,0.22962963,0.4,0.52962963,1488
9ca61d17915f09b8010fa1da5ad0285b076a96e1,1,Guozhang Wang,2015-07-09 18:15:45-07:00,['ee88dbb67f19b787e12ccef37982c9459b78c7b6'],7,40,47,573075,2,0.36,1,0.64,1488
4aba4bc1dfb74cc378ea58d7b0a9f16c96cfe757,0,Joel Koshy,2015-07-09 18:28:38-07:00,['9ca61d17915f09b8010fa1da5ad0285b076a96e1'],1,1,2,573077,1,,,,1488
69b451e28944deb162f7427105c3090f41c8797f,0,Guozhang Wang,2015-07-13 13:13:02-07:00,['4aba4bc1dfb74cc378ea58d7b0a9f16c96cfe757'],4,6,10,573087,1,,,,1488
bdbb9672f5e035fd00801037e2affe64811ec6ab,1,Jun Rao,2015-07-13 17:16:34-07:00,['69b451e28944deb162f7427105c3090f41c8797f'],10,77,87,573174,2,0,1,1,1488
a7e0ac3659c2b499124a866bc0b16b6b1b412376,1,Gwen Shapira,2015-07-13 22:08:33-07:00,['bdbb9672f5e035fd00801037e2affe64811ec6ab'],6,11,17,573191,1,0,0,1,1488
99c0686be2141a0fffe1c55e279370a87ef8c1ea,1,Guozhang Wang,2015-07-15 12:38:45-07:00,['a7e0ac3659c2b499124a866bc0b16b6b1b412376'],984,2350,3334,576525,33,0.873720137,0.972696246,0.919795222,1506
4fcb7acafe4c98cd2930e6d348d456a3eb7f7444,0,Guozhang Wang,2015-07-15 15:46:19-07:00,['99c0686be2141a0fffe1c55e279370a87ef8c1ea'],4,4,8,576533,1,,,,1506
83d17e5b2403a4916d51ab69825ea657f8c802a7,0,Guozhang Wang,2015-07-15 19:00:37-07:00,['4fcb7acafe4c98cd2930e6d348d456a3eb7f7444'],1,1,2,576535,1,,,,1506
fa03a7c6c48550f01176402139201af75d3836a2,0,Guozhang Wang,2015-07-16 12:59:27-07:00,['83d17e5b2403a4916d51ab69825ea657f8c802a7'],1,12,13,576548,2,1,1,1,1506
458ebeb04bffb3237a46c12e05e270d9b26d4d40,0,Jun Rao,2015-07-16 16:21:50-07:00,['fa03a7c6c48550f01176402139201af75d3836a2'],11,9,20,576568,1,,,,1506
8fa24a6171781bbdb2b814dcdc37520a92511f69,0,Jun Rao,2015-07-16 16:38:41-07:00,['458ebeb04bffb3237a46c12e05e270d9b26d4d40'],2,17,19,576587,2,0.75,0.75,0.75,1506
1e0ed7a592cd80cfca727b27ba01f6faa511531f,0,Jun Rao,2015-07-16 17:13:12-07:00,['8fa24a6171781bbdb2b814dcdc37520a92511f69'],9,10,19,576606,2,,,,1506
5033b9613e9e9f28c8eb60a734920d90d155e6f9,1,Jun Rao,2015-07-16 17:29:25-07:00,['1e0ed7a592cd80cfca727b27ba01f6faa511531f'],4,4,8,576614,1,,,,1506
31f621716ebace5a05d5cbf65d7d5bf2a902ea7b,0,Jun Rao,2015-07-16 17:57:12-07:00,['5033b9613e9e9f28c8eb60a734920d90d155e6f9'],0,1,1,576615,1,0,1,0,1506
15cba9f00dc606dd49e428f4ac8ccae0c0b8b37d,0,Gwen Shapira,2015-07-16 21:46:46-07:00,['31f621716ebace5a05d5cbf65d7d5bf2a902ea7b'],10,10,20,576635,2,,,,1506
a5b11886df8c7aad0548efd2c7c3dbc579232f03,0,Gwen Shapira,2015-07-17 10:32:43-07:00,['15cba9f00dc606dd49e428f4ac8ccae0c0b8b37d'],1,7,8,576643,1,1,1,1,1506
84636272422b6379d57d4c5ef68b156edc1c67f8,0,Gwen Shapira,2015-07-17 10:49:40-07:00,['a5b11886df8c7aad0548efd2c7c3dbc579232f03'],0,21,21,576664,1,,,,1507
1d2bd6284b06b579c901e6be8919a8a27dbe11ee,1,Gwen Shapira,2015-07-20 16:15:42-07:00,['84636272422b6379d57d4c5ef68b156edc1c67f8'],5,95,100,576764,5,0.033898305,1,0.847457627,1507
2040890462a22614ccb836e43837f8739855b84f,0,Gwen Shapira,2015-07-20 16:40:54-07:00,['1d2bd6284b06b579c901e6be8919a8a27dbe11ee'],3,6,9,576773,1,1,1,1,1507
fd3b4cc41e9249ec6848cde8137691d32b2e79e5,1,Guozhang Wang,2015-07-22 13:00:03-07:00,['2040890462a22614ccb836e43837f8739855b84f'],4,35,39,576812,3,0.625,0.5625,1,1507
18adec7ed5ad71eb73171aff0e0c82d627cfa5d5,0,Gwen Shapira,2015-07-23 08:46:47-07:00,['fd3b4cc41e9249ec6848cde8137691d32b2e79e5'],4,20,24,576836,1,0,0,0,1507
66c8647d85f801893b9f882a7ad49242cef683fd,0,Gwen Shapira,2015-07-23 09:17:19-07:00,['18adec7ed5ad71eb73171aff0e0c82d627cfa5d5'],1,22,23,576859,1,1,1,1,1507
520a8135f4820ee92e63427c5dbb2d5356e6a473,1,Guozhang Wang,2015-07-23 17:19:16-07:00,['66c8647d85f801893b9f882a7ad49242cef683fd'],44,60,104,576963,1,0,0.5,1,1507
fd3a3cd59539a741b6d3c830870dae1d5a5f93b5,1,Guozhang Wang,2015-07-24 09:19:59-07:00,['520a8135f4820ee92e63427c5dbb2d5356e6a473'],15,12,27,576990,2,,,,1507
4389a11f68f4c0e028441acd0ef30951296c38ce,1,Guozhang Wang,2015-07-27 10:54:23-07:00,['fd3a3cd59539a741b6d3c830870dae1d5a5f93b5'],0,12,12,577002,2,,,,1508
57386de64530edcb54e9dae4566fb6d4a8b4700e,1,Guozhang Wang,2015-07-28 14:09:10-07:00,['4389a11f68f4c0e028441acd0ef30951296c38ce'],0,2,2,577004,1,0,0,1,1508
269c2407d4e6e38b3b6be00566c480121b5dc51a,1,Guozhang Wang,2015-07-28 14:23:44-07:00,['57386de64530edcb54e9dae4566fb6d4a8b4700e'],1,43,44,577048,3,0.454545455,1,1,1508
3df46bf4ce9c134cc7b532be3d01f920127be706,0,Guozhang Wang,2015-07-28 14:27:35-07:00,['269c2407d4e6e38b3b6be00566c480121b5dc51a'],0,6,6,577054,1,,,,1508
594b963930c2054199ed54203415d1cb7917df27,1,Guozhang Wang,2015-07-28 15:49:22-07:00,['3df46bf4ce9c134cc7b532be3d01f920127be706'],5,130,135,577189,8,0.422535211,0.647887324,0.915492958,1508
f4101ab3fcf7ec65f6541b157f1894ffdc8d861d,1,Guozhang Wang,2015-07-28 16:31:33-07:00,['594b963930c2054199ed54203415d1cb7917df27'],5,13,18,577207,1,0,1,1,1508
e43c9aff92c57da6abb0c1d0af3431a550110a89,1,Guozhang Wang,2015-07-28 17:22:14-07:00,['f4101ab3fcf7ec65f6541b157f1894ffdc8d861d'],38,2322,2360,579567,34,0.49825784,0.958188153,0.730545877,1532
b7bd2978dc3947297fefc06ff9b22949d5bd1b50,0,Gwen Shapira,2015-07-29 10:34:42-07:00,['e43c9aff92c57da6abb0c1d0af3431a550110a89'],2,11,13,579580,1,1,1,1,1532
1162cc1dd30e896e8c7a03f960b7d7bcbf883624,0,Guozhang Wang,2015-07-29 18:23:54-07:00,['b7bd2978dc3947297fefc06ff9b22949d5bd1b50'],2,3,5,579585,1,,,,1532
be82a2afc9e38adc0109dc694834ca5947128877,1,Guozhang Wang,2015-07-30 14:23:43-07:00,['1162cc1dd30e896e8c7a03f960b7d7bcbf883624'],130,386,516,580101,10,0.896341463,0.87804878,1,1532
23a36eb54958485d1e84c64cc739ca268e96b181,1,Guozhang Wang,2015-07-30 14:29:21-07:00,['be82a2afc9e38adc0109dc694834ca5947128877'],1,1,2,580103,1,,,,1532
b152c0604cdce8882028b62601916b5d2b82d6a5,0,Guozhang Wang,2015-08-03 13:08:57-07:00,['23a36eb54958485d1e84c64cc739ca268e96b181'],12,14,26,580129,1,0,0,1,1532
cd3dc7a5c9f3a68ad73d2ae7c975f9882f00036e,0,Chen Shapira,2015-08-03 14:12:00-07:00,['b152c0604cdce8882028b62601916b5d2b82d6a5'],0,1,1,580130,1,,,,1532
3c09630844f6e70793f53a9d4f0ef562fe9d91d3,0,Chen Shapira,2015-08-03 15:42:33-07:00,['cd3dc7a5c9f3a68ad73d2ae7c975f9882f00036e'],4,5,9,580139,1,,,,1532
4b400afceadcbe74e3ecbfeb7c3066fd436da192,0,Guozhang Wang,2015-08-04 11:29:10-07:00,['3c09630844f6e70793f53a9d4f0ef562fe9d91d3'],0,5,5,580144,1,0,1,1,1532
1a0179f21a3937065fea2b745de67967bcafcb68,0,Guozhang Wang,2015-08-04 11:33:03-07:00,['4b400afceadcbe74e3ecbfeb7c3066fd436da192'],1,1,2,580146,1,,,,1532
a56a79055dfba4687f476b0a4d20aeec1c4ebff7,1,Jun Rao,2015-08-04 15:11:27-07:00,['1a0179f21a3937065fea2b745de67967bcafcb68'],151,624,775,580921,17,0.376963351,0.80104712,0.816753927,1536
7a666f7aa8b1be927579817187e0b5b93543b5e2,0,Chen Shapira,2015-08-04 17:10:02-07:00,['a56a79055dfba4687f476b0a4d20aeec1c4ebff7'],2,1,3,580924,2,0,0,0,1536
9cefb2a0fb7852d35cfe0f051bc6eadb8e9c4c80,1,Gwen Shapira,2015-08-04 19:04:58-07:00,['7a666f7aa8b1be927579817187e0b5b93543b5e2'],429,175,604,581528,5,1,0.548022599,0,1536
fc40016cf3cc4143f2e8486722737da3461771e6,0,Gwen Shapira,2015-08-05 11:46:11-07:00,['9cefb2a0fb7852d35cfe0f051bc6eadb8e9c4c80'],9,11,20,581548,1,,,,1536
85d8218ef41381c58eb16d7542e41416c82bdf4a,1,Guozhang Wang,2015-08-05 12:50:05-07:00,['fc40016cf3cc4143f2e8486722737da3461771e6'],18,7,25,581573,1,1,0,0,1536
27d499fe66fc034669a1852ca33ee2f486e1b83c,1,Jun Rao,2015-08-05 15:55:48-07:00,['85d8218ef41381c58eb16d7542e41416c82bdf4a'],1,32,33,581606,2,0,0,1,1536
95c626dc04e033c4349e68d47a3bd6e21b77706c,0,Guozhang Wang,2015-08-05 16:32:25-07:00,['27d499fe66fc034669a1852ca33ee2f486e1b83c'],2,2,4,581610,1,,,,1536
4b798f0dee004ac6b96ff563a0e2df65e016c694,0,Guozhang Wang,2015-08-05 16:33:55-07:00,['95c626dc04e033c4349e68d47a3bd6e21b77706c'],1,1,2,581612,1,,,,1536
907ee7b5eae9e163e7abb24f97dedbaa78bc9d8c,0,Guozhang Wang,2015-08-05 16:34:57-07:00,['4b798f0dee004ac6b96ff563a0e2df65e016c694'],1,1,2,581614,1,,,,1536
9b1c52d52e4e9bbbd89b125fd510bf8b247643ac,1,Guozhang Wang,2015-08-05 16:51:25-07:00,['907ee7b5eae9e163e7abb24f97dedbaa78bc9d8c'],2,2,4,581618,1,,,,1536
006b45c7e5b94e70b3a4200f4646042f3557c48e,1,Guozhang Wang,2015-08-06 14:17:30-07:00,['9b1c52d52e4e9bbbd89b125fd510bf8b247643ac'],17,37,54,581672,8,0.6,0.9,0,1536
f6373e4d9929d123a8474ab7673ee701f63ac593,1,Guozhang Wang,2015-08-06 15:52:43-07:00,['006b45c7e5b94e70b3a4200f4646042f3557c48e'],17,169,186,581858,3,1,1,0.913978495,1536
63b820c592aba3ec6f26cc99c0c470795029b10c,0,Gwen Shapira,2015-08-07 15:20:09-07:00,['f6373e4d9929d123a8474ab7673ee701f63ac593'],13,49,62,581920,2,0,1,1,1536
47c99f38726dd5bd3bf2c2f8a8a999d36b53ffcf,0,Gwen Shapira,2015-08-07 16:07:45-07:00,['63b820c592aba3ec6f26cc99c0c470795029b10c'],7,8,15,581935,1,,,,1536
a36befd81ed97c18e3e676559617bffdbb191d65,0,Gwen Shapira,2015-08-07 16:10:25-07:00,['47c99f38726dd5bd3bf2c2f8a8a999d36b53ffcf'],5,5,10,581945,1,,,,1536
68ad80f8524931222d78a8125cd012321d784337,0,Gwen Shapira,2015-08-07 16:16:34-07:00,['a36befd81ed97c18e3e676559617bffdbb191d65'],0,3,3,581948,1,,,,1536
1ed88f0eba860bce4be0269cdd4d38c2b57db7f7,0,Guozhang Wang,2015-08-07 23:42:42-07:00,['68ad80f8524931222d78a8125cd012321d784337'],2,5,7,581955,1,0,0,1,1536
1fdb758f286868a00cbebcc5bbcfc8195529158e,0,Guozhang Wang,2015-08-10 20:58:20-07:00,['1ed88f0eba860bce4be0269cdd4d38c2b57db7f7'],4,11,15,581970,1,0,0,1,1536
96534a7d502be58026feec3c2012f022bf330049,0,Gwen Shapira,2015-08-11 15:07:40-07:00,['1fdb758f286868a00cbebcc5bbcfc8195529158e'],2,14,16,581986,1,,,,1536
be633a713e311c90ebfafc650eb3dcfb94ce372d,1,Guozhang Wang,2015-08-11 15:24:52-07:00,['96534a7d502be58026feec3c2012f022bf330049'],12,171,183,582169,5,0.942307692,1,0.942307692,1539
a62d63007c89c0c6f7ad62fe4643f7adc7fbc661,1,Guozhang Wang,2015-08-12 14:31:39-07:00,['be633a713e311c90ebfafc650eb3dcfb94ce372d'],53,288,341,582510,3,0.346405229,0.117647059,1,1540
3902dc024595baf715cdfc8fa4b66aacbeca72d1,1,Guozhang Wang,2015-08-12 14:34:30-07:00,['a62d63007c89c0c6f7ad62fe4643f7adc7fbc661'],6,6,12,582522,1,,,,1540
04b0d870b263117e301584bfc00dd8e81486617a,0,Gwen Shapira,2015-08-12 14:57:42-07:00,['3902dc024595baf715cdfc8fa4b66aacbeca72d1'],0,52,52,582574,3,,,,1541
78685dc162a867c0b8870faf5baa6a098953ddc8,1,Guozhang Wang,2015-08-12 19:58:44-07:00,['04b0d870b263117e301584bfc00dd8e81486617a'],293,276,569,583143,87,0.111111111,0,0,1541
e2ebae80982c45c65f709efaedd89d10e109600f,0,Guozhang Wang,2015-08-13 10:35:09-07:00,['78685dc162a867c0b8870faf5baa6a098953ddc8'],6,17,23,583166,1,0,0,0,1541
2c55bd8aa2666ea11ee2814b04f782eef8fa52c6,1,Jun Rao,2015-08-13 17:54:36-04:00,['e2ebae80982c45c65f709efaedd89d10e109600f'],59,88,147,583313,8,0.681818182,1,1,1541
c8e62c9818a04c01a4eb16cf30772dfbd30d3a26,0,Guozhang Wang,2015-08-13 15:22:54-07:00,['2c55bd8aa2666ea11ee2814b04f782eef8fa52c6'],1,2,3,583316,1,,,,1541
f6acfb08917946f15cb8de2fee786019124af212,1,Gwen Shapira,2015-08-14 16:00:51-07:00,['c8e62c9818a04c01a4eb16cf30772dfbd30d3a26'],15,11116,11131,594447,82,0.677950595,0.844236048,0.903247941,1618
bbb7d97adefe5826f2e02a8e55423ea215c9f749,1,Joel Koshy,2015-08-14 18:51:48-07:00,['f6acfb08917946f15cb8de2fee786019124af212'],61,945,1006,595453,17,0.272277228,0.98019802,0.955445545,1623
63b89658bcb5fc2d95e10d28987337c3d971163f,1,Guozhang Wang,2015-08-14 21:55:42-07:00,['bbb7d97adefe5826f2e02a8e55423ea215c9f749'],18,106,124,595577,24,,,,1623
786867c2e18f79fa17be120f78a253bb9822a861,0,Gwen Shapira,2015-08-16 20:53:39-07:00,['63b89658bcb5fc2d95e10d28987337c3d971163f'],0,4,4,595581,1,,,,1623
503bd36647695e8cc91893ffb80346dd03eb0bc5,0,Gwen Shapira,2015-08-18 13:03:11-07:00,['786867c2e18f79fa17be120f78a253bb9822a861'],39,58,97,595678,4,1,1,1,1623
9e2c683f550b7ae58008d0bcb62238b7a2d89a65,1,Jun Rao,2015-08-18 21:51:15-07:00,['503bd36647695e8cc91893ffb80346dd03eb0bc5'],599,4121,4720,600398,52,0.504648074,0.68061089,0.785524568,1643
47b7a686e9636a68226efeca221073f76d887f36,1,Joel Koshy,2015-08-19 14:32:25-07:00,['9e2c683f550b7ae58008d0bcb62238b7a2d89a65'],24,10,34,600432,3,,,,1643
0b04f9f34b37dd43c68c572dfae6bb75144f066c,0,Joel Koshy,2015-08-19 18:16:59-07:00,['47b7a686e9636a68226efeca221073f76d887f36'],9,9,18,600450,3,,,,1643
e4fc456ab06a228c4228cbae58d391de1b768f9e,0,Gwen Shapira,2015-08-19 18:20:51-07:00,['0b04f9f34b37dd43c68c572dfae6bb75144f066c'],5,5,10,600460,2,,,,1643
767a8a7628bd936ee3da1f03c27639657cd0dd5e,1,Guozhang Wang,2015-08-20 13:00:58-07:00,['e4fc456ab06a228c4228cbae58d391de1b768f9e'],144,350,494,600954,3,1,1,0,1645
9a6b57334953ef86603454e5b0d1287ee4281d03,1,Joel Koshy,2015-08-20 13:24:14-07:00,['767a8a7628bd936ee3da1f03c27639657cd0dd5e'],36,174,210,601164,7,0.918918919,0.918918919,0.972972973,1646
3285a9c890c1800b15c85a80e676cf4365cbe785,1,Gwen Shapira,2015-08-21 11:32:57-07:00,['9a6b57334953ef86603454e5b0d1287ee4281d03'],2,2,4,601168,2,,,,1646
6acd37720df402a665094ba1153ae200ad5d6705,0,Gwen Shapira,2015-08-21 12:52:30-07:00,['3285a9c890c1800b15c85a80e676cf4365cbe785'],1,1,2,601170,1,,,,1646
1d2ae89c5a1dc5d18b8188bf737a8e1d195be325,1,Gwen Shapira,2015-08-22 19:23:36-07:00,['6acd37720df402a665094ba1153ae200ad5d6705'],97,353,450,601620,14,0.581196581,1,0.905982906,1650
5d453ba6d4654efc93e6b2d2f069139afa571b94,0,Joel Koshy,2015-08-25 17:50:49-07:00,['1d2ae89c5a1dc5d18b8188bf737a8e1d195be325'],24,36,60,601680,1,0,0,1,1650
436b7ddc386eb688ba0f12836710f5e4bcaa06c8,1,Joel Koshy,2015-08-25 18:33:10-07:00,['5d453ba6d4654efc93e6b2d2f069139afa571b94'],157,463,620,602300,24,0.738095238,1,0.895238095,1650
8b538d62bd7ddcefd177bfed01b10b39fc971bb1,1,Gwen Shapira,2015-08-26 13:49:33-07:00,['436b7ddc386eb688ba0f12836710f5e4bcaa06c8'],21,36,57,602357,8,0.727272727,0.727272727,1,1650
03f850f671ba3035eb150fa243dca0a2aed28302,1,Jun Rao,2015-08-26 17:16:30-05:00,['8b538d62bd7ddcefd177bfed01b10b39fc971bb1'],10,269,279,602636,5,0.666666667,0.983333333,0.833333333,1652
35eaef7bb4ebcf6b209312db774564451b052ca9,1,Guozhang Wang,2015-08-26 17:20:51-07:00,['03f850f671ba3035eb150fa243dca0a2aed28302'],354,379,733,603369,24,0,0,0.8,1652
8c88d198a0bcd0292a6b7ec3b08ae138e41fcc6e,1,Guozhang Wang,2015-08-26 18:38:43-07:00,['35eaef7bb4ebcf6b209312db774564451b052ca9'],16,75,91,603460,3,0.022222222,0.422222222,0.644444444,1652
492bfdfa873db649049382b9785cefef2d6d1eca,1,Gwen Shapira,2015-08-27 11:58:42-07:00,['8c88d198a0bcd0292a6b7ec3b08ae138e41fcc6e'],4012,2774,6786,610246,56,0,0,0.077102804,1661
2fa8c748537a86a8b81b43ab7df060b6e61f5085,1,Gwen Shapira,2015-08-27 13:53:00-07:00,['492bfdfa873db649049382b9785cefef2d6d1eca'],31,264,295,610541,13,1,1,0.789473684,1666
8956004a51a67c028f8acc73e82f4d1a3e4116c7,1,Guozhang Wang,2015-08-27 20:45:42-07:00,['2fa8c748537a86a8b81b43ab7df060b6e61f5085'],2,2,4,610545,1,,,,1666
9c936b186d390f59f1d4ad8cc2995f800036a3d6,1,Gwen Shapira,2015-08-28 11:22:39-07:00,['8956004a51a67c028f8acc73e82f4d1a3e4116c7'],3,19,22,610567,3,1,0,1,1667
3803e5cb37cb602ff9eab5562ff8db3a2dd79b45,1,Gwen Shapira,2015-08-31 12:26:16-07:00,['9c936b186d390f59f1d4ad8cc2995f800036a3d6'],517,991,1508,612075,32,0.46975089,1,0.992882562,1670
8354959969c3fe2094b66c44c1c54c3949605e13,0,Gwen Shapira,2015-08-31 12:39:01-07:00,['3803e5cb37cb602ff9eab5562ff8db3a2dd79b45'],1,13,14,612089,1,,,,1670
13c432f7952de27e9bf8cb4adb33a91ae3a4b738,0,Gwen Shapira,2015-08-31 14:23:23-07:00,['8354959969c3fe2094b66c44c1c54c3949605e13'],12,3,15,612104,1,1,0,0,1670
e582447adb4708731aff74aa294e7ce2b30b0a41,0,Joel Koshy,2015-09-01 14:46:16-07:00,['13c432f7952de27e9bf8cb4adb33a91ae3a4b738'],4,16,20,612124,6,0,1,1,1670
ff189fa05ccdacac100f3d15d167dcbe561f57a6,0,Gwen Shapira,2015-09-02 10:13:23-07:00,['e582447adb4708731aff74aa294e7ce2b30b0a41'],21,21,42,612166,8,,,,1670
17f85fcdef162c6d772db389350d3f334cbaa545,0,Gwen Shapira,2015-09-02 10:17:01-07:00,['ff189fa05ccdacac100f3d15d167dcbe561f57a6'],1,1,2,612168,1,,,,1670
d0adf6abec7a61004d9fe35fc9999a40a953ea7b,0,Gwen Shapira,2015-09-02 11:33:07-07:00,['17f85fcdef162c6d772db389350d3f334cbaa545'],1,5,6,612174,1,,,,1670
d02ca36ca1cccdb6962191b97f54ce96b9d75abc,1,Jun Rao,2015-09-02 11:55:08-07:00,['d0adf6abec7a61004d9fe35fc9999a40a953ea7b'],384,2229,2613,614787,39,0.49026764,0.791970803,0.777372263,1682
689d170ac32ed15af9098faa03a97609af14bf05,1,Jun Rao,2015-09-02 18:09:13-07:00,['d02ca36ca1cccdb6962191b97f54ce96b9d75abc'],64,842,906,615693,21,0.3125,0.735576923,0.971153846,1694
6f398d63a4b9a23e8a3dfa436b5522e505dd5b47,1,Joel Koshy,2015-09-02 18:12:42-07:00,['689d170ac32ed15af9098faa03a97609af14bf05'],0,4,4,615697,1,1,1,1,1694
9223155e9c3f55107197758afc5238fe4cebeaa9,1,Joel Koshy,2015-09-02 18:22:26-07:00,['6f398d63a4b9a23e8a3dfa436b5522e505dd5b47'],2,2,4,615701,1,,,,1694
24da542727225c7920ad974582fdca222a38ccc2,0,Gwen Shapira,2015-09-02 22:07:05-07:00,['9223155e9c3f55107197758afc5238fe4cebeaa9'],5,5,10,615711,1,1,1,1,1694
4ffbfefccbbbc513e708bdacbf2ff32772b5c85f,1,Gwen Shapira,2015-09-03 13:25:16-07:00,['24da542727225c7920ad974582fdca222a38ccc2'],3,3,6,615717,1,,,,1694
f25731265ef63e5440a188b3e5553c31fb9a397b,0,Jun Rao,2015-09-04 09:30:13-07:00,['4ffbfefccbbbc513e708bdacbf2ff32772b5c85f'],0,20,20,615737,2,1,1,1,1694
92629756616849d62dde3d09c7ddd9bcf5f7326c,1,Gwen Shapira,2015-09-08 15:15:51-07:00,['f25731265ef63e5440a188b3e5553c31fb9a397b'],43,98,141,615878,2,0.36,0,1,1694
f8902981c65ac93426c0edc65d10381d7c285ea1,0,Gwen Shapira,2015-09-08 15:17:15-07:00,['92629756616849d62dde3d09c7ddd9bcf5f7326c'],1,2,3,615881,1,,,,1694
b8b1bca44095df0481fc6bb0d7ea5c06686b9337,1,Gwen Shapira,2015-09-08 17:59:49-07:00,['f8902981c65ac93426c0edc65d10381d7c285ea1'],338,494,832,616713,12,1,0,0,1700
fd123965802f900fa474a8d5b1539e62d28bff73,1,Guozhang Wang,2015-09-10 13:14:24-07:00,['b8b1bca44095df0481fc6bb0d7ea5c06686b9337'],24,458,482,617195,10,0.583011583,1,1,1700
845514d62329be8382e6d02b8041fc858718d534,1,Guozhang Wang,2015-09-11 15:49:51-07:00,['fd123965802f900fa474a8d5b1539e62d28bff73'],162,180,342,617537,12,1,0.607142857,1,1700
6c1957d004f9b1a7d115543327cade274edc9cfd,0,Guozhang Wang,2015-09-11 15:57:36-07:00,['845514d62329be8382e6d02b8041fc858718d534'],2,3,5,617542,1,0,0,1,1700
65bf3afe86ef883136fcd6bc857724b25e750bd7,1,Jun Rao,2015-09-11 16:08:00-07:00,['6c1957d004f9b1a7d115543327cade274edc9cfd'],222,693,915,618457,29,0.577889447,0.814070352,0.884422111,1704
b7d4043d8da1d296519faf321e9f0f7188d7d67a,0,Guozhang Wang,2015-09-12 21:58:34-07:00,['65bf3afe86ef883136fcd6bc857724b25e750bd7'],1,1,2,618459,1,,,,1704
d88b5bdfde0b6d020e687f6d59ad88d577910ae9,1,Gwen Shapira,2015-09-14 13:14:53-07:00,['b7d4043d8da1d296519faf321e9f0f7188d7d67a'],4,1,5,618464,1,1,1,0,1704
7199c87c32b94daec612bc022607bb86103bd8b2,0,Gwen Shapira,2015-09-14 15:00:04-07:00,['d88b5bdfde0b6d020e687f6d59ad88d577910ae9'],33,181,214,618678,4,,,,1706
b658e25207174578c26ea94a75e5b0ea10f06ba5,0,Gwen Shapira,2015-09-14 15:02:32-07:00,['7199c87c32b94daec612bc022607bb86103bd8b2'],2,0,2,618680,1,,,,1706
da39931afad8008bc2b385a75a462777be051435,0,Joel Koshy,2015-09-16 10:31:57-07:00,['b658e25207174578c26ea94a75e5b0ea10f06ba5'],251,457,708,619388,33,0.36,0.12,0.21,1706
9dbeb71ab258955e04b46991c1baf880b07633f4,0,Joel Koshy,2015-09-17 14:36:01-07:00,['da39931afad8008bc2b385a75a462777be051435'],457,251,708,620096,33,0.64,0.88,0.79,1706
9ae98685ec7882598aee80d11af41d7c0828e1b9,1,Guozhang Wang,2015-09-21 11:59:59-07:00,['9dbeb71ab258955e04b46991c1baf880b07633f4'],0,9,9,620105,2,0.75,0.875,1,1706
e18f6860c2b297cc2ce06f9f3cb37987af3bdbae,0,Guozhang Wang,2015-09-21 12:07:56-07:00,['9ae98685ec7882598aee80d11af41d7c0828e1b9'],16,17,33,620138,1,0,1,1,1706
6ec88f7f8a18be7aff12fb0c73fc8abd00ef62d2,1,Guozhang Wang,2015-09-21 13:14:17-07:00,['e18f6860c2b297cc2ce06f9f3cb37987af3bdbae'],124,71,195,620333,12,0.787878788,0,0,1706
0990b6ba6a28276f79a1a8bfaf48455c6eddfa1f,1,Jun Rao,2015-09-21 17:47:18-07:00,['6ec88f7f8a18be7aff12fb0c73fc8abd00ef62d2'],5,724,729,621062,9,0.57486631,0.967914439,0.874331551,1710
4833d8a8c34b2fb86a5cf605ea5483d0b9eadc4f,1,Guozhang Wang,2015-09-21 18:25:42-07:00,['0990b6ba6a28276f79a1a8bfaf48455c6eddfa1f'],35,44,79,621141,9,0.428571429,1,1,1710
2837fa5a34420ea1ede90901ded6e9f3c94a3e7b,0,Guozhang Wang,2015-09-22 14:32:28-07:00,['4833d8a8c34b2fb86a5cf605ea5483d0b9eadc4f'],5,13,18,621159,4,0,0,0.666666667,1710
d1dd1e902685178a990861f9948fe07f820cf4ef,1,Guozhang Wang,2015-09-23 14:10:06-07:00,['2837fa5a34420ea1ede90901ded6e9f3c94a3e7b'],123,276,399,621558,23,1,1,1,1711
b9ceac3ace353526da9c5d0f5b486265c871793a,1,Guozhang Wang,2015-09-23 16:53:05-07:00,['d1dd1e902685178a990861f9948fe07f820cf4ef'],4,65,69,621627,4,0.351351351,0.405405405,0.972972973,1711
54dd6e3ad7038ce4a32108b44153ec81caff2c68,0,Jun Rao,2015-09-24 09:25:11-07:00,['b9ceac3ace353526da9c5d0f5b486265c871793a'],22,43,65,621692,2,0,0,1,1711
1daf6ac510602ee27210f069bbe7415d4610fbea,1,Jun Rao,2015-09-24 10:14:23-07:00,['54dd6e3ad7038ce4a32108b44153ec81caff2c68'],91,326,417,622109,12,0.365079365,0.674603175,0.619047619,1711
8943b08c9fbd31f7c50d5e06934a5fc225d56460,0,Guozhang Wang,2015-09-24 10:35:05-07:00,['1daf6ac510602ee27210f069bbe7415d4610fbea'],17,17,34,622143,1,1,1,1,1711
ac757eb19ec50b79ab2b5336fa4d7411cd99456d,0,Gwen Shapira,2015-09-24 12:38:27-07:00,['8943b08c9fbd31f7c50d5e06934a5fc225d56460'],14,14,28,622171,7,,,,1711
bcf374da9e0d9ec8d13ecdaf4a1a15691549442b,1,Guozhang Wang,2015-09-24 14:40:03-07:00,['ac757eb19ec50b79ab2b5336fa4d7411cd99456d'],19,63,82,622253,3,0.238095238,1,1,1711
48b4d6938dfb9dc72c941e979ff0d0c4d921f743,1,Gwen Shapira,2015-09-24 19:01:11-07:00,['bcf374da9e0d9ec8d13ecdaf4a1a15691549442b'],199,1685,1884,624137,29,0.418666667,0.826666667,1,1722
18d370124b51a97eb0522c220eb0ca619e315c6a,0,Gwen Shapira,2015-09-24 19:16:28-07:00,['48b4d6938dfb9dc72c941e979ff0d0c4d921f743'],1,1,2,624139,1,,,,1722
fe798641a2ba5e60940fa91f5f01a14bcf98cf3e,0,Gwen Shapira,2015-09-24 19:26:07-07:00,['18d370124b51a97eb0522c220eb0ca619e315c6a'],19,19,38,624177,1,0,1,1,1722
7e453df3179efed92d5bbe4ce9ee1d90a07cd503,0,Guozhang Wang,2015-09-25 11:08:24-07:00,['fe798641a2ba5e60940fa91f5f01a14bcf98cf3e'],15,7,22,624199,3,1,0,0,1722
a07fbd0f19962037ec386b1814dc6c95749c91a3,0,Guozhang Wang,2015-09-25 12:01:41-07:00,['7e453df3179efed92d5bbe4ce9ee1d90a07cd503'],5,10,15,624214,3,0,0,1,1722
10d5deac0c00a0f651be1857fbdde6c74d7e9dac,0,Guozhang Wang,2015-09-25 14:06:07-07:00,['a07fbd0f19962037ec386b1814dc6c95749c91a3'],1,0,1,624215,1,,,,1722
ad120d5789306209ab8d110fcbd86d453d01641b,0,Jun Rao,2015-09-25 15:40:38-07:00,['10d5deac0c00a0f651be1857fbdde6c74d7e9dac'],15,17,32,624247,1,0,1,1,1722
263c10ab7c8e8fde9d3566bf59dccaa454ee2605,1,Guozhang Wang,2015-09-25 17:27:58-07:00,['ad120d5789306209ab8d110fcbd86d453d01641b'],20,10083,10103,634350,104,0.565938206,0.905300176,0.874654609,1814
b62f8ea43b6d5307f7274fbe8b7984dd5ee22239,1,Gwen Shapira,2015-09-26 18:32:49-07:00,['263c10ab7c8e8fde9d3566bf59dccaa454ee2605'],20,335,355,634705,7,0.385185185,1,0.933333333,1819
e90562fb19996db901771ad9757d12b0a2f50f9e,1,Gwen Shapira,2015-09-28 05:46:09-07:00,['b62f8ea43b6d5307f7274fbe8b7984dd5ee22239'],0,1,1,634706,1,1,1,1,1819
c20e3bf8d81330407cbbb5445a9f294d3df7a821,1,Gwen Shapira,2015-09-28 05:58:11-07:00,['e90562fb19996db901771ad9757d12b0a2f50f9e'],2,3,5,634711,3,,,,1819
f540f4a9193fd8437708f3bfe7856bc41d35d727,0,Jun Rao,2015-09-28 07:47:56-07:00,['c20e3bf8d81330407cbbb5445a9f294d3df7a821'],8,11,19,634730,1,0,1,0,1819
c7bc5366dd874bf956873ba0f60c2c2820052fb3,0,Jun Rao,2015-09-28 08:40:32-07:00,['f540f4a9193fd8437708f3bfe7856bc41d35d727'],2,2,4,634734,2,,,,1819
41afdbe680c73621c309280a307e1f60b330905e,0,Gwen Shapira,2015-09-28 14:41:18-07:00,['c7bc5366dd874bf956873ba0f60c2c2820052fb3'],1,7,8,634742,1,1,1,1,1819
4e7db39556ba916c17f7dfeb32ff8ebefe468a33,0,Gwen Shapira,2015-09-28 14:51:06-07:00,['41afdbe680c73621c309280a307e1f60b330905e'],174,174,348,635090,2,,,,1819
2c4e63a899c6cf832fba4be35773218a9ba5239f,1,Joel Koshy,2015-09-29 10:30:03-07:00,['4e7db39556ba916c17f7dfeb32ff8ebefe468a33'],253,460,713,635803,33,0.356435644,0.118811881,0.207920792,1819
73720113b97ccfcd796a844f87438546ed2e09e4,0,Guozhang Wang,2015-09-29 10:54:45-07:00,['2c4e63a899c6cf832fba4be35773218a9ba5239f'],1,17,18,635821,2,1,1,1,1819
f5596a851d8e8aa29686b6f9ae18cfa5183dd29c,0,Joel Koshy,2015-09-29 13:23:02-07:00,['73720113b97ccfcd796a844f87438546ed2e09e4'],4,2,6,635827,1,,,,1819
6b1a92c89fce443902b7ef85e1f4b7eaa9bd33c3,0,Sriharsha Chintalapani,2015-09-29 15:17:09-07:00,['f5596a851d8e8aa29686b6f9ae18cfa5183dd29c'],2,3,5,635832,1,1,1,1,1819
5e769ccd5bf81f82c90069d4b0e79182a1cfe3c0,1,Guozhang Wang,2015-09-29 17:49:06-07:00,['6b1a92c89fce443902b7ef85e1f4b7eaa9bd33c3'],35,145,180,636012,5,0.23943662,1,0.957746479,1819
d03b871dd0c395d372e6a7d1ff027105380f588b,1,Joel Koshy,2015-10-01 16:30:31-07:00,['5e769ccd5bf81f82c90069d4b0e79182a1cfe3c0'],30,32,62,636074,5,1,1,1,1819
5764e54de147af81aac85acc00687c23e9646a5c,1,Jun Rao,2015-10-01 18:04:09-07:00,['d03b871dd0c395d372e6a7d1ff027105380f588b'],19,604,623,636697,13,0.746212121,0.75,1,1824
7cfdf19b54ab60b9644dcbecccb9130d6621da57,1,Jun Rao,2015-10-02 14:46:07-07:00,['5764e54de147af81aac85acc00687c23e9646a5c'],14,51,65,636762,4,0,1,0,1824
4f8ad1561c761dd3ced22a5b8e2a6fa5e77283f2,0,Guozhang Wang,2015-10-02 15:07:28-07:00,['7cfdf19b54ab60b9644dcbecccb9130d6621da57'],5,5,10,636772,1,,,,1824
a3bd99811c6ed7b30611ff0592e4ce7bc8537260,0,Guozhang Wang,2015-10-02 15:09:28-07:00,['4f8ad1561c761dd3ced22a5b8e2a6fa5e77283f2'],23,1,24,636796,3,,,,1824
b56e02b656e47fa7a0b402d3870735fba2bbe699,0,Guozhang Wang,2015-10-02 16:03:01-07:00,['a3bd99811c6ed7b30611ff0592e4ce7bc8537260'],0,2,2,636798,1,,,,1824
37f7d75e3d55c600902cd15c3cb219ddd221d23c,1,Guozhang Wang,2015-10-02 20:12:34-07:00,['b56e02b656e47fa7a0b402d3870735fba2bbe699'],145,270,415,637213,20,0,1,0,1825
4016011457296e5f5d7d84bc12181eeea14b0a16,1,Gwen Shapira,2015-10-03 06:50:45-07:00,['37f7d75e3d55c600902cd15c3cb219ddd221d23c'],1,3284,3285,640498,13,,,,1837
f9faf334b0f62aec04214236dd10e9ba36fb9567,1,Sriharsha Chintalapani,2015-10-05 00:04:03-05:00,['4016011457296e5f5d7d84bc12181eeea14b0a16'],4,7,11,640509,1,0,0,1,1837
b88ba9a6bdde4d0828c513cde3251667ae13e655,1,Guozhang Wang,2015-10-05 12:01:33-07:00,['f9faf334b0f62aec04214236dd10e9ba36fb9567'],69,16,85,640594,4,0,0,0,1837
f236bc20ff5995aa367089afcd0a6738aaaae754,0,Guozhang Wang,2015-10-05 13:59:04-07:00,['b88ba9a6bdde4d0828c513cde3251667ae13e655'],2,2,4,640598,1,,,,1837
726e23ef491637e03b0ba90c21992a639dcd158d,1,Guozhang Wang,2015-10-05 14:11:58-07:00,['f236bc20ff5995aa367089afcd0a6738aaaae754'],4,1,5,640603,1,,,,1837
b46cb3b2975afd8a3e82a0265c57760d8b9910da,1,Guozhang Wang,2015-10-06 13:39:17-07:00,['726e23ef491637e03b0ba90c21992a639dcd158d'],1,8,9,640612,2,1,1,1,1837
a0ca8f6422e031c58e3a832852ba105e0f2efbad,0,Guozhang Wang,2015-10-06 14:11:06-07:00,['b46cb3b2975afd8a3e82a0265c57760d8b9910da'],2,2,4,640616,1,,,,1837
23f9afb70bc5cdbf66550a1e69161e2fe06a909a,1,Guozhang Wang,2015-10-06 14:26:08-07:00,['a0ca8f6422e031c58e3a832852ba105e0f2efbad'],12,183,195,640811,4,0.447619048,1,1,1837
174a43cd09d3a2a2785daf0cfa5ada1646d8bfcc,1,Guozhang Wang,2015-10-06 15:31:28-07:00,['23f9afb70bc5cdbf66550a1e69161e2fe06a909a'],6,336,342,641153,6,0.62601626,0.926829268,1,1841
02e103b75aa6161c27358e83ab2828515c876701,1,Guozhang Wang,2015-10-06 22:02:46-07:00,['174a43cd09d3a2a2785daf0cfa5ada1646d8bfcc'],45,772,817,641970,14,0.879699248,0.842105263,0.981203008,1847
2047a9afe1ef9cf81e6347fe27f0051c8758d226,1,Jun Rao,2015-10-07 09:28:22-07:00,['02e103b75aa6161c27358e83ab2828515c876701'],203,751,954,642924,5,0.872274143,0.813084112,0.925233645,1848
118912e76e5c867a8727f90d40bb969e0e6b65c5,1,Joel Koshy,2015-10-07 13:08:07-07:00,['2047a9afe1ef9cf81e6347fe27f0051c8758d226'],215,450,665,643589,20,0,0.987421384,0.924528302,1848
2254f2bfaf5a6a2332ec390471ff3a7c34b8b890,0,Jun Rao,2015-10-07 18:13:58-07:00,['118912e76e5c867a8727f90d40bb969e0e6b65c5'],10,12,22,643611,4,1,1,1,1848
693d4ca1a6fbb883fef5a2e7228ad56dd2f95fc8,0,Guozhang Wang,2015-10-07 18:30:53-07:00,['2254f2bfaf5a6a2332ec390471ff3a7c34b8b890'],0,5,5,643616,1,0,0,0,1848
f1110c3fbb166f94204b6bb18bc4e1a9100d3c4e,0,Jun Rao,2015-10-07 21:59:14-07:00,['693d4ca1a6fbb883fef5a2e7228ad56dd2f95fc8'],13,35,48,643664,2,0,0,0,1848
5a921a3239e8b6c6f0fd6a65093c491ac3e539fd,0,Guozhang Wang,2015-10-08 23:19:12-07:00,['f1110c3fbb166f94204b6bb18bc4e1a9100d3c4e'],22,22,44,643708,12,,,,1848
6a06e22ef81aae3335ca59c94cb0fc33e9f4ceff,1,Guozhang Wang,2015-10-08 23:39:17-07:00,['5a921a3239e8b6c6f0fd6a65093c491ac3e539fd'],8,104,112,643820,5,0.553571429,0.946428571,0.946428571,1848
49822ff836e0fcd2a30bdf994d7b881a9de95cdf,0,Guozhang Wang,2015-10-09 11:59:38-07:00,['6a06e22ef81aae3335ca59c94cb0fc33e9f4ceff'],1,253,254,644074,6,0.977777778,0.977777778,1,1850
7233858bea1c548153ed00b7edffd55299db7cf2,1,Guozhang Wang,2015-10-09 12:19:07-07:00,['49822ff836e0fcd2a30bdf994d7b881a9de95cdf'],161,172,333,644407,32,,,,1850
96209b1e7a5ea9da0296a3319e3731b3802e3652,0,Guozhang Wang,2015-10-09 13:08:31-07:00,['7233858bea1c548153ed00b7edffd55299db7cf2'],1,1,2,644409,1,,,,1850
c67ca65889721e3af7527ab26df49a9fb4db87ef,1,Guozhang Wang,2015-10-09 16:28:40-07:00,['96209b1e7a5ea9da0296a3319e3731b3802e3652'],13,539,552,644961,12,0.406015038,0.984962406,1,1858
1265d7cb7f56b5f5aad940250dc705a9a060a6f0,1,Jun Rao,2015-10-10 15:24:36-07:00,['c67ca65889721e3af7527ab26df49a9fb4db87ef'],181,256,437,645398,7,0.972222222,0.888888889,1,1858
bd98a99c1e28f17bccafc317c819c1a82bfc6244,1,Jun Rao,2015-10-10 22:15:56-07:00,['1265d7cb7f56b5f5aad940250dc705a9a060a6f0'],2,2,4,645402,1,,,,1858
fe4818e0944a9146059b02fde3fea4cc15676bf6,0,Gwen Shapira,2015-10-12 10:00:05-07:00,['bd98a99c1e28f17bccafc317c819c1a82bfc6244'],4,5,9,645411,1,,,,1858
9fde92f9f1f1e40ceb6b3d5ff9676ba590385825,1,Joel Koshy,2015-10-12 12:22:39-07:00,['fe4818e0944a9146059b02fde3fea4cc15676bf6'],16,86,102,645513,6,0.486486486,1,1,1858
7915396ee891759200cb3d89bbcf3b84bf20ed6a,1,Guozhang Wang,2015-10-12 13:36:19-07:00,['9fde92f9f1f1e40ceb6b3d5ff9676ba590385825'],0,8,8,645521,1,,,,1858
dd514b2bb8c476642952bf923de8d4c81bbeca7d,1,Guozhang Wang,2015-10-12 17:19:45-07:00,['7915396ee891759200cb3d89bbcf3b84bf20ed6a'],68,363,431,645952,13,0,0.980519481,0,1859
d7340503a14e3f31d96e3582e36c0255cd008e03,0,Gwen Shapira,2015-10-12 18:26:38-07:00,['dd514b2bb8c476642952bf923de8d4c81bbeca7d'],1,9,10,645962,2,,,,1859
518f78be0b96b92c03b985fbb61901c5cded7127,0,Gwen Shapira,2015-10-12 18:53:06-07:00,['d7340503a14e3f31d96e3582e36c0255cd008e03'],0,0,0,645962,0,,,,1859
373332b0f98ade1a7d98e79c11cb5ea33dbe0985,0,Gwen Shapira,2015-10-12 20:14:44-07:00,['518f78be0b96b92c03b985fbb61901c5cded7127'],0,0,0,645962,0,,,,1859
e2ec02e1d1580e73c06f1acbf3a53a1b8ee52930,1,Sriharsha Chintalapani,2015-10-13 06:59:25-07:00,['373332b0f98ade1a7d98e79c11cb5ea33dbe0985'],24,23,47,646009,4,0,0,1,1859
36d4469326fe20c3f0657315321e6ad515530a3e,1,Gwen Shapira,2015-10-13 10:23:21-07:00,['e2ec02e1d1580e73c06f1acbf3a53a1b8ee52930'],595,3005,3600,649609,31,0.48,0.904680851,0.93787234,1866
123d27e4d005a384611671133fbecde7e390d24f,1,Gwen Shapira,2015-10-13 13:54:40-07:00,['36d4469326fe20c3f0657315321e6ad515530a3e'],26,340,366,649975,7,0.124293785,0.581920904,0.282485876,1868
b1ce9494e3a964613d3d9534471df79593514c77,0,Guozhang Wang,2015-10-13 15:31:27-07:00,['123d27e4d005a384611671133fbecde7e390d24f'],4,4,8,649983,1,,,,1868
d8c5750799b9c5c4485514b6b02560679af8255d,1,Gwen Shapira,2015-10-13 18:48:45-07:00,['b1ce9494e3a964613d3d9534471df79593514c77'],6,18,24,650007,1,0,0,1,1868
27c099b043704d16a22c33e0602f0ae7295cab25,0,Gwen Shapira,2015-10-13 18:50:32-07:00,['d8c5750799b9c5c4485514b6b02560679af8255d'],1,43,44,650051,2,0.333333333,1,1,1868
f13d1155960a1ea907b09754877ee74586efd041,1,Guozhang Wang,2015-10-14 13:35:49-07:00,['27c099b043704d16a22c33e0602f0ae7295cab25'],11,20,31,650082,4,0.571428571,1,1,1868
6e571225d51f5d71ffcfc4d22d108e89ae2f46ec,1,Guozhang Wang,2015-10-14 13:59:10-07:00,['f13d1155960a1ea907b09754877ee74586efd041'],123,1359,1482,651564,17,0.658995816,0.887029289,0.786610879,1875
5013a41a514973e9612012413832e063ab062aef,0,Gwen Shapira,2015-10-14 14:06:14-07:00,['6e571225d51f5d71ffcfc4d22d108e89ae2f46ec'],16,16,32,651596,2,,,,1875
362613347371e9d74184e900ab80ba230940a5c8,0,Gwen Shapira,2015-10-14 14:28:14-07:00,['5013a41a514973e9612012413832e063ab062aef'],16,44,60,651656,1,0.52173913,0,1,1875
28e59a1df7da9bbfc133180ee332a68e4540ee3e,0,Gwen Shapira,2015-10-14 14:53:12-07:00,['362613347371e9d74184e900ab80ba230940a5c8'],0,9,9,651665,1,,,,1875
c50d39ea82e282d08163ebe7f0e398de2dc8c128,1,Guozhang Wang,2015-10-15 11:06:51-07:00,['28e59a1df7da9bbfc133180ee332a68e4540ee3e'],11,36,47,651712,3,0.368421053,0.736842105,1,1875
a4dbf9010754183965772066a9cd2c5c4a49d44a,1,Guozhang Wang,2015-10-15 11:11:32-07:00,['c50d39ea82e282d08163ebe7f0e398de2dc8c128'],11,31,42,651754,5,1,1,1,1875
50a076d1e9929d82107b3086f664a234a1c7b9f6,1,Guozhang Wang,2015-10-15 11:49:44-07:00,['a4dbf9010754183965772066a9cd2c5c4a49d44a'],98,118,216,651970,1,0.538461538,1,1,1875
5338f8432f74054671e9da59ba6f97abb81a03f2,0,Guozhang Wang,2015-10-15 17:28:23-07:00,['50a076d1e9929d82107b3086f664a234a1c7b9f6'],36,36,72,652042,1,,,,1875
7efa12705d91e21eec527ab49033b01ca5e3e3ce,1,Guozhang Wang,2015-10-16 09:45:32-07:00,['5338f8432f74054671e9da59ba6f97abb81a03f2'],6,6,12,652054,1,,,,1875
aa66b42daca0791840da3c77d47c96cf98f19ef2,1,Jun Rao,2015-10-16 09:47:04-07:00,['7efa12705d91e21eec527ab49033b01ca5e3e3ce'],16,39,55,652109,3,0.5,1,0.2,1875
c553249b4e6d7d385821061f9742f15f90e94def,1,Guozhang Wang,2015-10-16 14:46:26-07:00,['aa66b42daca0791840da3c77d47c96cf98f19ef2'],11,386,397,652506,4,0.397959184,1,0.908163265,1877
ef65d0a360ed65180ddd84d17679f24671c66e14,1,Gwen Shapira,2015-10-16 15:44:31-07:00,['c553249b4e6d7d385821061f9742f15f90e94def'],0,721,721,653227,3,0.119373777,0.714285714,0.956947162,1880
e2e5c891428e5f1288b6f4674983d924f8bdb779,1,Guozhang Wang,2015-10-16 17:39:39-07:00,['ef65d0a360ed65180ddd84d17679f24671c66e14'],3,66,69,653296,4,0.888888889,0.916666667,0.972222222,1880
636e14a99191eeededfb933aacfe2459c7c7bb6f,0,Guozhang Wang,2015-10-16 17:46:17-07:00,['e2e5c891428e5f1288b6f4674983d924f8bdb779'],6,286,292,653588,11,0.784313725,0.803921569,0.751633987,1882
78a2e2f8f39b24774e5edc8cf0c1093889db2fdf,0,Guozhang Wang,2015-10-16 17:52:06-07:00,['636e14a99191eeededfb933aacfe2459c7c7bb6f'],7,7,14,653602,14,,,,1892
ce306ba4ebc77464bf8ff4d656e1f1f44979182e,1,Jun Rao,2015-10-18 15:23:52-07:00,['78a2e2f8f39b24774e5edc8cf0c1093889db2fdf'],1109,1283,2392,655994,91,0.296703297,0.450549451,1,1893
241b9ab58dcbde0ca2545fcbaea864d778f4f93d,0,Guozhang Wang,2015-10-18 22:45:27-07:00,['ce306ba4ebc77464bf8ff4d656e1f1f44979182e'],3,2,5,655999,1,,,,1893
964114a8aa28024f0e34693bb78da618f36574d3,0,Jun Rao,2015-10-19 13:39:19-07:00,['241b9ab58dcbde0ca2545fcbaea864d778f4f93d'],1,1,2,656001,1,,,,1893
6745435251feab3085056cd2f8c9c400da849048,1,Jun Rao,2015-10-19 13:49:09-07:00,['964114a8aa28024f0e34693bb78da618f36574d3'],37,17,54,656055,5,0.25,0.25,0,1893
343db8a7f4d22a593f0aecc79d55869350803889,1,Guozhang Wang,2015-10-19 14:50:18-07:00,['6745435251feab3085056cd2f8c9c400da849048'],10,31,41,656096,4,0.636363636,1,1,1893
14c128a162a7540f22e78a2e4bab6f20662b49ce,0,Guozhang Wang,2015-10-19 17:18:52-07:00,['343db8a7f4d22a593f0aecc79d55869350803889'],2,6,8,656104,1,1,1,1,1893
8f32617e6506a5f67d4f922f4088507994ba91ef,1,Guozhang Wang,2015-10-19 19:33:27-07:00,['14c128a162a7540f22e78a2e4bab6f20662b49ce'],2,2,4,656108,1,,,,1893
403158b54b18cabf93eb15d4c4dd8ab66604bf9f,1,Jun Rao,2015-10-20 14:13:34-07:00,['8f32617e6506a5f67d4f922f4088507994ba91ef'],727,2882,3609,659717,74,0.48156682,0.56797235,0.821428571,1920
44f6c4b946511ce4663d41bf40f2960d2faee198,1,Jun Rao,2015-10-20 17:21:46-07:00,['403158b54b18cabf93eb15d4c4dd8ab66604bf9f'],3,78,81,659798,3,0.681818182,1,0.984848485,1920
0785feeb0fae2a4f75a59147197c5138109b1b39,1,Guozhang Wang,2015-10-21 10:04:49-07:00,['44f6c4b946511ce4663d41bf40f2960d2faee198'],28,129,157,659955,10,0.671875,0.8125,0.859375,1920
1d4a0b8811d82a6465015a71194a712679d63efe,1,Guozhang Wang,2015-10-21 11:20:29-07:00,['0785feeb0fae2a4f75a59147197c5138109b1b39'],125,97,222,660177,2,0.852941176,0.058823529,0,1920
6e747d42974bd6b445a3ffed50281a1e8d55c3a1,0,Guozhang Wang,2015-10-21 11:37:57-07:00,['1d4a0b8811d82a6465015a71194a712679d63efe'],1,1,2,660179,1,,,,1920
86eb74d9236c586af5889fe79f4b9e066c9c2af3,1,Guozhang Wang,2015-10-21 12:13:42-07:00,['6e747d42974bd6b445a3ffed50281a1e8d55c3a1'],3307,5513,8820,668999,90,0.286792453,0.911320755,0.743396226,1938
30056538130ae1e2be35398b0ddd2ea04105bafd,1,Joel Koshy,2015-10-21 13:24:10-07:00,['86eb74d9236c586af5889fe79f4b9e066c9c2af3'],9,11,20,669019,1,1,1,1,1938
361686d4a999298b6e5b63cacda72168172eb936,1,Jun Rao,2015-10-21 14:39:39-07:00,['30056538130ae1e2be35398b0ddd2ea04105bafd'],38,99,137,669156,4,0.142857143,0.595238095,0.976190476,1938
d9b1dc70817de9366513b0cbed0b6e0702d473fa,1,Jun Rao,2015-10-21 16:07:39-07:00,['361686d4a999298b6e5b63cacda72168172eb936'],167,216,383,669539,15,0,0.888888889,1,1938
65922b5388561e3ab830fd1f367faa289d205e2a,1,Jun Rao,2015-10-21 17:10:36-07:00,['d9b1dc70817de9366513b0cbed0b6e0702d473fa'],74,63,137,669676,13,1,1,1,1938
2e25f899a118e7d4d5eb89118e447a87ad02f71c,1,Guozhang Wang,2015-10-22 09:26:05-07:00,['65922b5388561e3ab830fd1f367faa289d205e2a'],1,1,2,669678,1,,,,1938
bf292a6fa5b52844edfe256e8f1dd42da432d0c9,0,Guozhang Wang,2015-10-22 09:52:09-07:00,['2e25f899a118e7d4d5eb89118e447a87ad02f71c'],0,22,22,669700,1,,,,1939
aa56dfb9e7cea19faa545a13d42d499a6958cbef,1,Guozhang Wang,2015-10-22 21:06:10-07:00,['bf292a6fa5b52844edfe256e8f1dd42da432d0c9'],90,142,232,669932,9,0,1,1,1939
701c46b3a32da78008ae48298778fca8b5a16bce,1,Gwen Shapira,2015-10-22 22:27:46-07:00,['aa56dfb9e7cea19faa545a13d42d499a6958cbef'],8,15,23,669955,2,1,1,1,1939
21443f214fc6f1f51037e27f8ece155cf1eb288c,1,Jun Rao,2015-10-23 15:11:07-07:00,['701c46b3a32da78008ae48298778fca8b5a16bce'],7,285,292,670247,9,0.315436242,0.140939597,0.684563758,1941
2e61773590c0ba86cb8813e6ba17bf6ee33f4461,1,Gwen Shapira,2015-10-23 16:37:30-07:00,['21443f214fc6f1f51037e27f8ece155cf1eb288c'],696,2966,3662,673909,34,0.22450805,0.783542039,0.814847943,1950
6f2f1f9843f537b9bda3aa3951a867fdee661761,1,Gwen Shapira,2015-10-23 17:01:33-07:00,['2e61773590c0ba86cb8813e6ba17bf6ee33f4461'],17,59,76,673985,2,0.76,0,0.76,1950
16f194b20ad9795188f1d7781e7cbca1cd2a6a2d,1,Sriharsha Chintalapani,2015-10-24 09:42:19-07:00,['6f2f1f9843f537b9bda3aa3951a867fdee661761'],304,297,601,674586,25,,,,1950
939c4244e7353e0000939837b14ec7c7550aeb21,0,Guozhang Wang,2015-10-26 10:17:16-07:00,['16f194b20ad9795188f1d7781e7cbca1cd2a6a2d'],1,1,2,674588,2,,,,1950
71399ffe4c52e2539a5794a17852c8c5b3d5fe72,1,Guozhang Wang,2015-10-26 13:33:51-07:00,['939c4244e7353e0000939837b14ec7c7550aeb21'],171,980,1151,675739,26,0.512396694,0.975206612,0.96969697,1956
b251bebbcc3074f0491fce988f1d46ccdc97f1fa,1,Guozhang Wang,2015-10-26 18:30:41-07:00,['71399ffe4c52e2539a5794a17852c8c5b3d5fe72'],70,73,143,675882,5,1,0,1,1956
e6f9b9e473f0396743cdfc5236bfd551316fc6f7,1,Guozhang Wang,2015-10-26 20:14:19-07:00,['b251bebbcc3074f0491fce988f1d46ccdc97f1fa'],149,247,396,676278,19,0,0.538461538,1,1957
fc4ef479109fbae12470e44f8c12fe9e5f41e179,1,Gwen Shapira,2015-10-27 07:43:19-07:00,['e6f9b9e473f0396743cdfc5236bfd551316fc6f7'],13,31,44,676322,3,,,,1957
2e4aed7070f0283e2c1e0e563fdb3324482463a5,1,Gwen Shapira,2015-10-27 07:44:32-07:00,['fc4ef479109fbae12470e44f8c12fe9e5f41e179'],58,57,115,676437,8,,,,1957
2fd645ac2fec7cf089cb8175ee47823b67a07226,1,Gwen Shapira,2015-10-27 07:59:52-07:00,['2e4aed7070f0283e2c1e0e563fdb3324482463a5'],193,373,566,677003,2,0.365671642,0.828358209,1,1957
d21cb66e7d21ed3d20fc1e13b9a856f764bb4237,0,Gwen Shapira,2015-10-27 08:45:27-07:00,['2fd645ac2fec7cf089cb8175ee47823b67a07226'],6,82,88,677091,1,0.75,0.75,1,1957
8bc59a3b8f29854b8c7178609b99d7c9491886dc,0,Gwen Shapira,2015-10-27 10:00:01-07:00,['d21cb66e7d21ed3d20fc1e13b9a856f764bb4237'],6,6,12,677103,1,,,,1957
c6c4f50703ff250b737080aaf239969473af99f0,1,Guozhang Wang,2015-10-27 13:44:59-07:00,['8bc59a3b8f29854b8c7178609b99d7c9491886dc'],3,92,95,677198,4,0.930232558,0.930232558,1,1958
38a1b605533632f61f4c23b69933eb496098311b,0,Guozhang Wang,2015-10-27 13:49:19-07:00,['c6c4f50703ff250b737080aaf239969473af99f0'],1,1,2,677200,1,,,,1958
af42c37899e8fc66590e7f3c4893f8224441f6a8,1,Guozhang Wang,2015-10-27 13:57:19-07:00,['38a1b605533632f61f4c23b69933eb496098311b'],9,16,25,677225,1,0,0,1,1958
e6b343302f3208f7f6e0099fe2a7132ef9eaaafb,1,Guozhang Wang,2015-10-27 15:23:47-07:00,['af42c37899e8fc66590e7f3c4893f8224441f6a8'],330,1237,1567,678792,31,0.843220339,0.580508475,0.720338983,1969
0b05d3b939c5ed37a4253e7c3614d824e76ed664,1,Guozhang Wang,2015-10-27 16:24:10-07:00,['e6b343302f3208f7f6e0099fe2a7132ef9eaaafb'],53,83,136,678928,4,1,1,1,1969
13c3e049fbf22522c90c2a0b4b4f680b974d9bea,0,Guozhang Wang,2015-10-27 16:26:47-07:00,['0b05d3b939c5ed37a4253e7c3614d824e76ed664'],1,1,2,678930,1,,,,1969
1ac2640f8095262f423c770060b737f81652e211,1,Guozhang Wang,2015-10-27 17:39:19-07:00,['13c3e049fbf22522c90c2a0b4b4f680b974d9bea'],47,63,110,679040,11,0,1,0.777777778,1969
7a36d36478635ae16b64c6410b88c92b45d5f129,0,Guozhang Wang,2015-10-27 17:55:59-07:00,['1ac2640f8095262f423c770060b737f81652e211'],3,3,6,679046,1,,,,1969
80223baa3b7125fd656ed85b450498a21924ca71,1,Guozhang Wang,2015-10-27 19:32:42-07:00,['7a36d36478635ae16b64c6410b88c92b45d5f129'],2,3,5,679051,1,,,,1969
b6fe164dd6f9483469c0b0661c24467e33e91cd9,1,Guozhang Wang,2015-10-28 10:11:05-07:00,['80223baa3b7125fd656ed85b450498a21924ca71'],63,66,129,679180,8,1,0.5,0,1969
9855bb9c655ebad0ed5586175452056466189b8a,1,Jun Rao,2015-10-28 10:48:39-07:00,['b6fe164dd6f9483469c0b0661c24467e33e91cd9'],514,531,1045,680225,22,1,1,0,1969
8838fa8010c146af6aab014a41bc7e68318b4eb0,0,Gwen Shapira,2015-10-28 12:42:03-07:00,['9855bb9c655ebad0ed5586175452056466189b8a'],0,6,6,680231,2,0,1,0.333333333,1969
983b1f9e17a0f392cfb7785f572c767540a12e2b,1,Jun Rao,2015-10-28 13:20:26-07:00,['8838fa8010c146af6aab014a41bc7e68318b4eb0'],38,460,498,680729,8,0.509960159,0.741035857,0.860557769,1971
443cd9ab0db5223b7c85ac8333f2fc1a0e554870,1,Guozhang Wang,2015-10-28 14:14:11-07:00,['983b1f9e17a0f392cfb7785f572c767540a12e2b'],5,46,51,680780,6,0.896551724,0.896551724,0.931034483,1971
bd3fe839ce0e4a7276d19e8e873783aa0cd76707,0,Jun Rao,2015-10-28 15:35:13-07:00,['443cd9ab0db5223b7c85ac8333f2fc1a0e554870'],1,3,4,680784,2,,,,1971
47c888078d257c45c3685c514d0d4556ac46f947,0,Guozhang Wang,2015-10-28 20:44:41-07:00,['bd3fe839ce0e4a7276d19e8e873783aa0cd76707'],0,12,12,680796,1,,,,1971
1b5687b9e4cd10e0f91fb921d3569fdd44be163d,1,Jun Rao,2015-10-29 08:30:06-07:00,['47c888078d257c45c3685c514d0d4556ac46f947'],41,477,518,681314,13,0.49537037,0.972222222,0.930555556,1973
217eb90444ef6a6aacf95997666768ee849e6769,1,Joel Koshy,2015-10-29 11:56:55-07:00,['1b5687b9e4cd10e0f91fb921d3569fdd44be163d'],7,27,34,681348,3,0,0.333333333,1,1973
42bcc4339f41bed320edde8bf141d0702798c021,1,Jun Rao,2015-10-29 12:00:50-07:00,['217eb90444ef6a6aacf95997666768ee849e6769'],31,44,75,681423,4,0,0,0,1974
0da65476175e398378381041232af718321a5829,0,Joel Koshy,2015-10-29 12:07:43-07:00,['42bcc4339f41bed320edde8bf141d0702798c021'],2,5,7,681430,1,,,,1974
e0ca8fdd7cf3fcc51a5a1152eacdf585434052d8,1,Gwen Shapira,2015-10-29 15:53:19-07:00,['0da65476175e398378381041232af718321a5829'],0,5,5,681435,1,,,,1974
13803ae91cc2d25ef42b71f3737e6c2ee7eb8809,1,Gwen Shapira,2015-10-29 18:33:56-07:00,['e0ca8fdd7cf3fcc51a5a1152eacdf585434052d8'],2,63,65,681500,3,,,,1974
622730905d7826694d6ae503ad61927dfa255d14,0,Guozhang Wang,2015-10-30 08:57:00-07:00,['13803ae91cc2d25ef42b71f3737e6c2ee7eb8809'],1,1,2,681502,1,,,,1974
d9ae33d4c0473ef53a9ea560536467333136c0a0,1,Jun Rao,2015-10-30 08:53:16-07:00,['622730905d7826694d6ae503ad61927dfa255d14'],95,114,209,681711,9,0.333333333,1,1,1975
efdc2ad2e7ec62c6d4d72c8d672a2995be5032a0,1,Gwen Shapira,2015-10-30 14:54:18-07:00,['d9ae33d4c0473ef53a9ea560536467333136c0a0'],0,54,54,681765,1,0,1,1,1975
c001b2040cb7bf3a24aa77ec8de1312d4f780620,1,Gwen Shapira,2015-10-30 15:00:00-07:00,['efdc2ad2e7ec62c6d4d72c8d672a2995be5032a0'],375,2799,3174,684939,51,0.599659284,0.912265758,0.784497445,1990
d50499a0e08586d61445df6e287762333dc22d0a,1,Gwen Shapira,2015-10-30 15:13:16-07:00,['c001b2040cb7bf3a24aa77ec8de1312d4f780620'],26346,2,26348,711287,251,0.811004041,0.689462232,0.436120609,1990
1cc44830b90688f1a2034243b8ee03b97101f75c,1,Gwen Shapira,2015-10-30 15:30:34-07:00,['d50499a0e08586d61445df6e287762333dc22d0a'],46,117,163,711450,5,0,0.816326531,1,1990
637f9a31660bebd0a3b94d930792e0b19405acd0,1,Gwen Shapira,2015-10-30 17:08:45-07:00,['1cc44830b90688f1a2034243b8ee03b97101f75c'],1,1,2,711452,1,,,,1990
eec222e9828b36064827f206b398655aa2d4cd29,0,Gwen Shapira,2015-10-30 17:50:11-07:00,['637f9a31660bebd0a3b94d930792e0b19405acd0'],20,124,144,711596,3,0.455696203,0.455696203,0.886075949,1990
b944356990d97401721a5752f8dcdd1ac5b8d4d4,1,Jun Rao,2015-10-30 18:14:20-07:00,['eec222e9828b36064827f206b398655aa2d4cd29'],10,25,35,711631,3,,,,1990
9d8dd9f104aef3a9db9005d85bc55a15f851d258,1,Jun Rao,2015-10-31 09:01:59-07:00,['b944356990d97401721a5752f8dcdd1ac5b8d4d4'],47,41,88,711719,19,0,1,,1990
34775bd3ed7b8eb4ca3532d30a9d8e6bf7c0b738,1,Gwen Shapira,2015-11-02 10:16:39-08:00,['9d8dd9f104aef3a9db9005d85bc55a15f851d258'],0,128,128,711847,2,,,,1991
6383593fed5215f31e050d5a459b161249ed8366,0,Guozhang Wang,2015-11-02 11:14:10-08:00,['34775bd3ed7b8eb4ca3532d30a9d8e6bf7c0b738'],1,1,2,711849,1,,,,1991
758272267c811bf559336ea45571bc420a62a478,1,Guozhang Wang,2015-11-02 13:24:48-08:00,['6383593fed5215f31e050d5a459b161249ed8366'],244,662,906,712755,29,0.579439252,0.981308411,1,1993
1f5d05fe718b7db7ee07c727b7a736fab09322d6,0,Guozhang Wang,2015-11-02 14:14:38-08:00,['758272267c811bf559336ea45571bc420a62a478'],1,2,3,712758,1,,,,1993
e466ccd711ae00c5bb046c18aacf353b1a460dcd,1,Guozhang Wang,2015-11-02 14:40:52-08:00,['1f5d05fe718b7db7ee07c727b7a736fab09322d6'],30,51,81,712839,4,1,1,1,1993
7c33475274cb6e65a8e8d907e7fef6e56bc8c8e6,1,Guozhang Wang,2015-11-02 23:41:58-08:00,['e466ccd711ae00c5bb046c18aacf353b1a460dcd'],1218,1357,2575,715414,31,1,0,1,1995
694e03c35582212749db5efaabd98b9f723609d5,1,Jun Rao,2015-11-03 08:10:37-08:00,['7c33475274cb6e65a8e8d907e7fef6e56bc8c8e6'],9,11,20,715434,1,,,,1995
840e95897fdb5118aa1308ec1a3be27369b9d71e,1,Gwen Shapira,2015-11-03 09:42:20-08:00,['694e03c35582212749db5efaabd98b9f723609d5'],2,41,43,715477,1,,,,1995
edddc41b37d06f8e819976b20b2e8ac711033e95,1,Gwen Shapira,2015-11-03 10:30:09-08:00,['840e95897fdb5118aa1308ec1a3be27369b9d71e'],2,2,4,715481,1,,,,1995
5aa5f19d38eda33f32e170e14bcd4fd0d2835fc0,1,Gwen Shapira,2015-11-03 13:17:20-08:00,['edddc41b37d06f8e819976b20b2e8ac711033e95'],46,223,269,715750,5,0.376623377,1,1,1996
f413143eddd713dc5f03d53fdeb10e4e7f3738b1,1,Guozhang Wang,2015-11-03 14:25:16-08:00,['5aa5f19d38eda33f32e170e14bcd4fd0d2835fc0'],0,145,145,715895,1,,,,1996
596c203af1f33360c04f4be7c466310d11343f78,1,Guozhang Wang,2015-11-03 14:46:04-08:00,['f413143eddd713dc5f03d53fdeb10e4e7f3738b1'],269,1479,1748,717643,44,0.603498542,0.944606414,0.881924198,2002
98db5ea94fcf7600137b5072453705c2a62e1f54,1,Jun Rao,2015-11-03 21:25:15-08:00,['596c203af1f33360c04f4be7c466310d11343f78'],114,343,457,718100,19,0.162162162,0.378378378,0.824324324,2006
70a7d5786cc3f04b5f3d964eb1fd1d826e9b9e0f,0,Jun Rao,2015-11-04 05:52:16-08:00,['98db5ea94fcf7600137b5072453705c2a62e1f54'],8,24,32,718132,3,0.714285714,1,1,2006
7ded64bc2edf8645d7fd113633a56791bf1e8e4a,0,Guozhang Wang,2015-11-04 09:19:49-08:00,['70a7d5786cc3f04b5f3d964eb1fd1d826e9b9e0f'],168,168,336,718468,3,,,,2006
421de0a3f93f8d21f7ca0f1287a4305c00edaa08,1,Guozhang Wang,2015-11-04 09:57:50-08:00,['7ded64bc2edf8645d7fd113633a56791bf1e8e4a'],101,155,256,718724,9,0.885714286,1,1,2006
aa73554c19b15a1589a77a4fae85c2d66a649acf,0,Guozhang Wang,2015-11-04 10:11:31-08:00,['421de0a3f93f8d21f7ca0f1287a4305c00edaa08'],2,169,171,718895,2,0.345794393,1,0.897196262,2006
c30ee50d82131ead8bc64223ae5970555b0c78cf,0,Gwen Shapira,2015-11-04 10:23:39-08:00,['aa73554c19b15a1589a77a4fae85c2d66a649acf'],1,3,4,718899,1,,,,2006
c39e79bb5af5b4e56bec358f8ec3758e6822dbcf,1,Gwen Shapira,2015-11-04 11:02:30-08:00,['c30ee50d82131ead8bc64223ae5970555b0c78cf'],284,716,1000,719899,37,0.876595745,0.617021277,0.685106383,2008
70a784b64ab61bcd517619fed44419d59d467b27,0,Guozhang Wang,2015-11-04 12:05:34-08:00,['c39e79bb5af5b4e56bec358f8ec3758e6822dbcf'],5,5,10,719909,1,,,,2008
8de62253adb4c6b90badbf92881c0402068cd65c,1,Guozhang Wang,2015-11-04 15:02:32-08:00,['70a784b64ab61bcd517619fed44419d59d467b27'],5,7,12,719921,1,,,,2008
ef5d168cc8f10ad4f0efe9df4cbe849a4b35496e,1,Guozhang Wang,2015-11-04 15:04:03-08:00,['8de62253adb4c6b90badbf92881c0402068cd65c'],64,190,254,720175,11,0.269662921,1,1,2008
68f42210a1c8ce64846ffdc2cdbecc6fa5b87739,1,Guozhang Wang,2015-11-04 17:31:34-08:00,['ef5d168cc8f10ad4f0efe9df4cbe849a4b35496e'],0,29,29,720204,1,0,1,1,2008
4a9e7607b9e563195556873b6ec9b74561cedfbb,0,Guozhang Wang,2015-11-05 08:42:44-08:00,['68f42210a1c8ce64846ffdc2cdbecc6fa5b87739'],15,52,67,720271,1,0.225806452,0.225806452,1,2008
7d6515fb8f6141f5c34fe8434e97ea6ebd65941f,1,Guozhang Wang,2015-11-05 08:44:44-08:00,['4a9e7607b9e563195556873b6ec9b74561cedfbb'],52,87,139,720410,8,0,1,0,2009
b30d68a4e31cb49c2e664bb2e3263e056a27db40,1,Guozhang Wang,2015-11-05 08:49:58-08:00,['7d6515fb8f6141f5c34fe8434e97ea6ebd65941f'],82,187,269,720679,2,0,0.679487179,0.820512821,2009
d23785ff2df136090e3c80a3a6df5cb85443924b,1,Guozhang Wang,2015-11-05 09:11:24-08:00,['b30d68a4e31cb49c2e664bb2e3263e056a27db40'],8,8,16,720695,2,,,,2009
a4551773ca8cb3c1b75cea873715f30053d88f47,1,Guozhang Wang,2015-11-05 10:13:23-08:00,['d23785ff2df136090e3c80a3a6df5cb85443924b'],69,140,209,720904,3,0.245614035,0.877192982,1,2009
7eee11451e1f0d17efa27775becfb370a9894d56,1,Guozhang Wang,2015-11-05 10:22:21-08:00,['a4551773ca8cb3c1b75cea873715f30053d88f47'],7,76,83,720987,2,0,0.442307692,1,2009
490bbc91183d1468a164d80f826317f137026684,1,Guozhang Wang,2015-11-05 13:16:58-08:00,['7eee11451e1f0d17efa27775becfb370a9894d56'],3,14,17,721004,2,1,1,1,2009
bf2563e2f73881491ea94e83013e0ff319a25016,1,Guozhang Wang,2015-11-05 13:31:01-08:00,['490bbc91183d1468a164d80f826317f137026684'],1,6,7,721011,2,1,1,1,2009
0273c4379f12d7c3daedc89b0838485270e16bf4,1,Guozhang Wang,2015-11-05 15:49:29-08:00,['bf2563e2f73881491ea94e83013e0ff319a25016'],4,6,10,721021,2,,,,2009
cbdd8218c16b56d952267c162dc1dfc93191571e,0,Guozhang Wang,2015-11-05 15:51:42-08:00,['0273c4379f12d7c3daedc89b0838485270e16bf4'],1,3,4,721025,1,1,1,1,2009
76bcccd61f61d33a4a4d4db02043a2f0063d0d38,0,Gwen Shapira,2015-11-05 16:42:27-08:00,['cbdd8218c16b56d952267c162dc1dfc93191571e'],49,81,130,721155,1,,,,2009
33e879a389aeaff3576064b10a0f5dea5ad391ed,1,Gwen Shapira,2015-11-05 18:17:30-08:00,['76bcccd61f61d33a4a4d4db02043a2f0063d0d38'],116,84,200,721355,7,0,1,1,2009
c3c0c04e62253f2a9f78b383bbf0d1a04d9b3b25,1,Gwen Shapira,2015-11-05 18:56:26-08:00,['33e879a389aeaff3576064b10a0f5dea5ad391ed'],46,164,210,721565,3,0.37254902,0.401960784,0.823529412,2009
b1eaa46a512295abb4b4eb8b98402fc60a2c911a,1,Gwen Shapira,2015-11-05 20:32:10-08:00,['c3c0c04e62253f2a9f78b383bbf0d1a04d9b3b25'],0,17,17,721582,2,1,1,1,2009
a76660ac811eb6e2cdf36a110ed4afb5bf3a617a,1,Gwen Shapira,2015-11-06 10:27:18-08:00,['b1eaa46a512295abb4b4eb8b98402fc60a2c911a'],34,161,195,721777,7,0,1,0.983870968,2009
c006c5916ef7a8048ed55db64db27c7b64a3af59,1,Guozhang Wang,2015-11-06 13:27:45-08:00,['a76660ac811eb6e2cdf36a110ed4afb5bf3a617a'],162,167,329,722106,26,1,1,,2009
a423316d388c386aa905b3d195487370f8703787,1,Guozhang Wang,2015-11-06 13:31:38-08:00,['c006c5916ef7a8048ed55db64db27c7b64a3af59'],40,19,59,722165,3,0,0,0,2009
a9e4ce79fe81d3fc8c9841ac9a14db53d3102854,0,Guozhang Wang,2015-11-06 13:42:18-08:00,['a423316d388c386aa905b3d195487370f8703787'],7,16,23,722188,1,,,,2009
09ff68673843109eedc5caae4bf46e62d1868aab,0,Guozhang Wang,2015-11-06 15:34:04-08:00,['a9e4ce79fe81d3fc8c9841ac9a14db53d3102854'],1,1,2,722190,1,,,,2009
130a561ad511db5a592e5a4217d6fa5dee704d33,0,Guozhang Wang,2015-11-06 15:35:59-08:00,['09ff68673843109eedc5caae4bf46e62d1868aab'],1,0,1,722191,1,1,1,0,2009
d297b3af265a5be5a83ee11a990060231ea4cc25,1,Gwen Shapira,2015-11-06 17:50:46-08:00,['130a561ad511db5a592e5a4217d6fa5dee704d33'],2,60,62,722253,9,0.75,1,1,2009
15524d0970868d2dd9bc16b9d5de4519fc469e11,1,Gwen Shapira,2015-11-06 17:55:32-08:00,['d297b3af265a5be5a83ee11a990060231ea4cc25'],9,27,36,722289,5,,,,2009
30bf985348dcc5b9dc2fba4ad38009342fa18442,0,Jun Rao,2015-11-06 20:22:34-06:00,['15524d0970868d2dd9bc16b9d5de4519fc469e11'],1,1,2,722291,1,,,,2009
b4e1bdf48b215e1acb3f81c964eb2c180d6dfa54,0,Gwen Shapira,2015-11-06 19:23:15-08:00,['30bf985348dcc5b9dc2fba4ad38009342fa18442'],490,41,531,722822,3,,,,2009
23cc9c77b27889bb7d71d7ea74b80ab96c4529ae,1,Guozhang Wang,2015-11-08 11:32:17-08:00,['b4e1bdf48b215e1acb3f81c964eb2c180d6dfa54'],109,270,379,723201,17,0.375,0.375,1,2011
34d9976656893abcec3d24c54b367eeb091c101d,0,Guozhang Wang,2015-11-08 11:36:14-08:00,['23cc9c77b27889bb7d71d7ea74b80ab96c4529ae'],6,18,24,723225,2,0,1,1,2011
83fb734603376d1c9ef1d88bcb5f160da5522e45,1,Guozhang Wang,2015-11-08 12:29:02-08:00,['34d9976656893abcec3d24c54b367eeb091c101d'],3,10,13,723238,1,0.5,0.5,0.5,2011
f4b87deefecf4902992a84d4a3fe3b99a94ff72b,1,Gwen Shapira,2015-11-08 20:41:35-08:00,['83fb734603376d1c9ef1d88bcb5f160da5522e45'],470,763,1233,724471,7,0.243697479,0.680672269,1,2013
f2031d40639ef34c1591c22971394ef41c87652c,1,Gwen Shapira,2015-11-08 22:11:03-08:00,['f4b87deefecf4902992a84d4a3fe3b99a94ff72b'],1175,1175,2350,726821,154,,,,2013
efbebc6e843850b7ed9a1d015413c99f114a7d92,1,Jun Rao,2015-11-09 07:23:47-08:00,['f2031d40639ef34c1591c22971394ef41c87652c'],5,8,13,726834,1,0,0,1,2013
a24f9a23a6d8759538e91072e8d96d158d03bb63,0,Jun Rao,2015-11-09 09:10:20-08:00,['efbebc6e843850b7ed9a1d015413c99f114a7d92'],1,1,2,726836,1,,,,2013
e9fc7b8c84908ae642339a2522a79f8bb5155728,0,Gwen Shapira,2015-11-09 10:19:27-08:00,['a24f9a23a6d8759538e91072e8d96d158d03bb63'],2,2,4,726840,1,,,,2013
2b04004de878823fe631af1f3f85108c0b38caec,1,Guozhang Wang,2015-11-09 10:26:17-08:00,['e9fc7b8c84908ae642339a2522a79f8bb5155728'],3,11,14,726854,1,0.6,0.6,1,2013
bc76e6704e8f14d59bb5d4fcf9bdf544c9e463bf,0,Gwen Shapira,2015-11-09 10:27:18-08:00,['2b04004de878823fe631af1f3f85108c0b38caec'],0,0,0,726854,3,,,,2013
13ba57dcfc45e60de281cc55125e7446322308ba,1,Gwen Shapira,2015-11-09 10:36:57-08:00,['bc76e6704e8f14d59bb5d4fcf9bdf544c9e463bf'],2,19,21,726875,2,0,1,1,2013
75f2b8c8b42459a3ab2962f75f0e05fbbb9e8333,0,Gwen Shapira,2015-11-09 10:39:34-08:00,['13ba57dcfc45e60de281cc55125e7446322308ba'],7,8,15,726890,1,0,1,1,2013
7073fa7efea4acd6615f9dad4f649f6094be6332,1,Gwen Shapira,2015-11-09 10:45:51-08:00,['75f2b8c8b42459a3ab2962f75f0e05fbbb9e8333'],112,252,364,727254,11,0.875,1,0.325,2016
69af573b35f04657e31f60e636aba19ffa0b2c84,1,Gwen Shapira,2015-11-09 11:02:46-08:00,['7073fa7efea4acd6615f9dad4f649f6094be6332'],2837,54,2891,730145,30,0.35412844,0.175229358,0.19266055,2016
359be3a682951fd469d690df8d9e7a5a89a9d03b,0,Guozhang Wang,2015-11-09 11:17:18-08:00,['69af573b35f04657e31f60e636aba19ffa0b2c84'],17,20,37,730182,1,,,,2016
a87b978223a827c34db1341b2da3e17e571c4464,0,Gwen Shapira,2015-11-09 13:36:35-08:00,['359be3a682951fd469d690df8d9e7a5a89a9d03b'],146,19,165,730347,2,,,,2016
3ebb4ee1b0803b755eaefc3286fe107868b7b085,0,Guozhang Wang,2015-11-09 13:47:55-08:00,['a87b978223a827c34db1341b2da3e17e571c4464'],1,1,2,730349,1,,,,2016
e2794a79c8d2e8ae9cf30bfe10bbed34951a004b,0,Guozhang Wang,2015-11-09 14:11:14-08:00,['3ebb4ee1b0803b755eaefc3286fe107868b7b085'],0,4,4,730353,1,,,,2016
79bdc17ab4b0157ceb5257e6c4ff646a3fa55f6d,1,Jun Rao,2015-11-09 15:08:34-08:00,['e2794a79c8d2e8ae9cf30bfe10bbed34951a004b'],0,8,8,730361,1,,,,2016
83eaf3284fe8535bd06743a367a469d3d01946b1,1,Gwen Shapira,2015-11-09 16:29:30-08:00,['79bdc17ab4b0157ceb5257e6c4ff646a3fa55f6d'],8,428,436,730797,11,1,1,1,2017
c6b93fa50de97c2fe79d5db98823a811c6743f69,1,Gwen Shapira,2015-11-09 16:36:42-08:00,['83eaf3284fe8535bd06743a367a469d3d01946b1'],9,11,20,730817,2,,,,2017
c9264b4c8904bf330b70cd84b433a7a141ec9d0e,0,Guozhang Wang,2015-11-09 17:07:40-08:00,['c6b93fa50de97c2fe79d5db98823a811c6743f69'],42,267,309,731126,4,0.872727273,1,1,2017
bce664b42a0c414dc19e2c07406cf6f14890cbd1,1,Guozhang Wang,2015-11-09 18:38:22-08:00,['c9264b4c8904bf330b70cd84b433a7a141ec9d0e'],12,1059,1071,732197,11,0.556683587,0.913705584,0.778341794,2022
590a4616a1030b3175ba5a548b5f1e1b49c323c2,0,Gwen Shapira,2015-11-09 20:43:07-08:00,['bce664b42a0c414dc19e2c07406cf6f14890cbd1'],4,6,10,732207,1,1,1,1,2022
fe11488a7787732b6cc2ba306f745ea1f318208c,0,Gwen Shapira,2015-11-10 10:17:13-08:00,['590a4616a1030b3175ba5a548b5f1e1b49c323c2'],17,19,36,732243,1,,,,2022
ae5a5d7c08bb634576a414f6f2864c5b8a7e58a3,1,Gwen Shapira,2015-11-10 10:26:51-08:00,['fe11488a7787732b6cc2ba306f745ea1f318208c'],11,8,19,732262,3,1,0,0,2022
403d89edeaa7808f71c0e7318411c925895210f2,0,Gwen Shapira,2015-11-10 11:07:26-08:00,['ae5a5d7c08bb634576a414f6f2864c5b8a7e58a3'],10,5,15,732277,3,0,0,0,2022
1d884d1f60aec9ec7ea334761bead4c60b13c7a9,0,Guozhang Wang,2015-11-10 11:54:18-08:00,['403d89edeaa7808f71c0e7318411c925895210f2'],4,5,9,732286,1,,,,2022
c455e608c1f2c7be6ff0a721f49c1fe3ede0165f,1,Guozhang Wang,2015-11-10 13:06:55-08:00,['1d884d1f60aec9ec7ea334761bead4c60b13c7a9'],9,6,15,732301,1,,,,2022
60c06734b345bbf292773e5b9206282ff3995968,1,Jun Rao,2015-11-10 14:27:55-08:00,['c455e608c1f2c7be6ff0a721f49c1fe3ede0165f'],36,40,76,732377,2,1,1,1,2022
64a1bfeb9b1b90c94cc62ee2587f9745c850ada3,1,Gwen Shapira,2015-11-10 14:43:25-08:00,['60c06734b345bbf292773e5b9206282ff3995968'],1,1,2,732379,1,,,,2022
8db55618d5d5d5de97feab2bf8da4dc45387a76a,1,Guozhang Wang,2015-11-10 14:54:15-08:00,['64a1bfeb9b1b90c94cc62ee2587f9745c850ada3'],64,873,937,733316,24,0.493421053,0.601973684,0.980263158,2028
9d9bb708bf59c93672306cd731b89d7df114bba7,1,Guozhang Wang,2015-11-10 14:55:47-08:00,['8db55618d5d5d5de97feab2bf8da4dc45387a76a'],12,27,39,733355,5,1,,,2028
04827e6e999c1b5e89e7dc8b1573ad263e66cd56,0,Guozhang Wang,2015-11-10 15:57:02-08:00,['9d9bb708bf59c93672306cd731b89d7df114bba7'],1,0,1,733356,1,,,,2028
ea702c384fcfb5a46c5d1354498e418c5801ed30,1,Jun Rao,2015-11-10 16:37:16-08:00,['04827e6e999c1b5e89e7dc8b1573ad263e66cd56'],1,1,2,733358,1,,,,2028
e0098b4567541d1c0cefc6f57ce38f67a9133b5e,1,Guozhang Wang,2015-11-10 19:24:15-08:00,['ea702c384fcfb5a46c5d1354498e418c5801ed30'],10,38,48,733406,4,0.625,0.6875,1,2028
a8ccdc6154a1e10982cb80df82e8661903eb9ae5,1,Gwen Shapira,2015-11-11 10:54:09-08:00,['e0098b4567541d1c0cefc6f57ce38f67a9133b5e'],18,156,174,733580,7,,,,2028
c6b8de4e6806d8f9f4af57e15f2a7f4170265c42,1,Gwen Shapira,2015-11-11 15:55:12-08:00,['a8ccdc6154a1e10982cb80df82e8661903eb9ae5'],28,27,55,733635,6,,,,2028
124f73b1747a574982e9ca491712e6758ddbacea,1,Guozhang Wang,2015-11-11 16:14:27-08:00,['c6b8de4e6806d8f9f4af57e15f2a7f4170265c42'],70,1464,1534,735169,16,0.38239159,0.679369251,0.925098555,2037
1cd22ed33f1e1f63d8cb63f68309e5d8f43be1e1,0,Jun Rao,2015-11-11 18:41:45-08:00,['124f73b1747a574982e9ca491712e6758ddbacea'],12,9,21,735190,1,1,1,1,2037
df88d3be75396b48a762149af2f4bbcd60fe69b9,0,Jun Rao,2015-11-11 18:45:24-08:00,['1cd22ed33f1e1f63d8cb63f68309e5d8f43be1e1'],1,1,2,735192,1,,,,2037
3fd168d9522d1ad25f5582fbe838cea15bdb525f,1,Jun Rao,2015-11-11 22:18:19-08:00,['df88d3be75396b48a762149af2f4bbcd60fe69b9'],13,7,20,735212,1,1,1,0,2037
b5401f291a16977992c50f0a66d9f02aea07bbe7,1,Jun Rao,2015-11-12 07:19:02-08:00,['3fd168d9522d1ad25f5582fbe838cea15bdb525f'],4,1,5,735217,1,1,1,0,2037
d60e2ea581289a02efcef3b692bbb043fbdf3199,0,Jun Rao,2015-11-12 07:20:10-08:00,['b5401f291a16977992c50f0a66d9f02aea07bbe7'],1,1,2,735219,1,,,,2037
2cf6218849a3634badaf70809923a31934182794,1,Jun Rao,2015-11-12 07:21:45-08:00,['d60e2ea581289a02efcef3b692bbb043fbdf3199'],3,3,6,735225,1,,,,2037
d9a455243e2350a18b5c734f0a6edaeb74ac6698,0,Guozhang Wang,2015-11-12 09:13:51-08:00,['2cf6218849a3634badaf70809923a31934182794'],1,4,5,735230,1,1,1,1,2037
370ce2b4b73b60ca52a4fbce246f3fd87b8dbf85,0,Guozhang Wang,2015-11-12 09:59:47-08:00,['d9a455243e2350a18b5c734f0a6edaeb74ac6698'],0,1,1,735231,1,0,1,1,2037
ab5ac264a71d7f895b21b4acfd93d9581dabd7c1,1,Gwen Shapira,2015-11-12 10:07:04-08:00,['370ce2b4b73b60ca52a4fbce246f3fd87b8dbf85'],38,163,201,735432,10,0.816666667,0.883333333,0.883333333,2038
1408c670ea576a430287182e9aaa26793917129a,0,Gwen Shapira,2015-11-12 11:11:56-08:00,['ab5ac264a71d7f895b21b4acfd93d9581dabd7c1'],85,23,108,735540,8,,,,2038
28d71ce5e06a17248f944147e850f3e5e029bdee,0,Guozhang Wang,2015-11-12 12:28:08-08:00,['1408c670ea576a430287182e9aaa26793917129a'],7,1,8,735548,1,0,0,0,2038
2991c9865d87a715717dbc1bae431a4d39631d9e,0,Gwen Shapira,2015-11-12 13:19:12-08:00,['28d71ce5e06a17248f944147e850f3e5e029bdee'],1,1,2,735550,1,,,,2038
2802bd081c9cfd91b8d7aa104c145ef0514ada49,0,Gwen Shapira,2015-11-12 18:51:26-08:00,['2991c9865d87a715717dbc1bae431a4d39631d9e'],1,1,2,735552,1,,,,2038
969d0cb0ae316ba0dfdb34ed096bfd56fe86ad92,0,Gwen Shapira,2015-11-12 18:54:20-08:00,['2802bd081c9cfd91b8d7aa104c145ef0514ada49'],8,15,23,735575,1,1,1,0,2038
4170847f1227b73a20645af1b5b2d88375e37426,0,Jun Rao,2015-11-12 21:23:28-08:00,['969d0cb0ae316ba0dfdb34ed096bfd56fe86ad92'],3,17,20,735595,3,0.5,0.5,0.5,2039
528c78fd30b77e8c60e8b3645e7d44404fd4e013,0,Jun Rao,2015-11-13 08:29:28-08:00,['4170847f1227b73a20645af1b5b2d88375e37426'],12,15,27,735622,1,0,0,1,2039
da97330915f5c9f73dc55288cc271818044e163f,0,Guozhang Wang,2015-11-13 10:03:47-08:00,['528c78fd30b77e8c60e8b3645e7d44404fd4e013'],1,1,2,735624,1,,,,2039
4511aeebc3e37a3d9e2ebeabbd6bbfd16d681719,0,Gwen Shapira,2015-11-13 10:25:00-08:00,['da97330915f5c9f73dc55288cc271818044e163f'],0,16,16,735640,1,,,,2039
397306cdfe22ea65ee39afae9ecdf11efd486dfa,1,Jun Rao,2015-11-13 10:34:15-08:00,['4511aeebc3e37a3d9e2ebeabbd6bbfd16d681719'],7,9,16,735656,3,,,,2039
4efe4ac6d785c708ec623a6dca24ae34d4b29097,1,Jun Rao,2015-11-13 10:42:50-08:00,['397306cdfe22ea65ee39afae9ecdf11efd486dfa'],8,6,14,735670,1,1,0,0,2039
002ec9c796acf8570754522a4eb1b0c3ee9aab13,1,Jun Rao,2015-11-13 11:11:56-08:00,['4efe4ac6d785c708ec623a6dca24ae34d4b29097'],45,87,132,735802,3,1,0,1,2039
a26dbcdf3ac57515cbc9a1c39d8c27e90f74188a,0,Guozhang Wang,2015-11-13 12:56:15-08:00,['002ec9c796acf8570754522a4eb1b0c3ee9aab13'],15,17,32,735834,2,0,1,1,2039
43ef0150bdc4ca349af61bf4c75dfb8fd8d14691,1,Jun Rao,2015-11-13 14:10:38-08:00,['a26dbcdf3ac57515cbc9a1c39d8c27e90f74188a'],9,52,61,735895,3,0.666666667,0.666666667,1,2039
5d87eac856273ec505e96ed8d7f7a17fba474471,0,Jun Rao,2015-11-13 14:18:02-08:00,['43ef0150bdc4ca349af61bf4c75dfb8fd8d14691'],4,4,8,735903,3,,,,2039
8e6bae21c64699245cf24dbaac3942f32a2a241b,0,Jun Rao,2015-11-13 17:36:09-08:00,['5d87eac856273ec505e96ed8d7f7a17fba474471'],5,3,8,735911,3,,,,2039
599a31c245618651c7973d040de793376f43bd95,1,Jun Rao,2015-11-13 17:42:50-08:00,['8e6bae21c64699245cf24dbaac3942f32a2a241b'],2,2,4,735915,1,,,,2039
f6d369b70d329af1cc882998aa517926aa9458ab,0,Jun Rao,2015-11-13 18:22:05-08:00,['599a31c245618651c7973d040de793376f43bd95'],3,3,6,735921,1,,,,2039
356544caba6448c6ba3bcdb38bea787e1fbc277b,0,Jun Rao,2015-11-14 09:25:57-08:00,['f6d369b70d329af1cc882998aa517926aa9458ab'],1,1,2,735923,1,,,,2039
45e7f71309f9a3e30d25a6ddd3171c67e3e79286,1,Guozhang Wang,2015-11-16 13:34:42-08:00,['356544caba6448c6ba3bcdb38bea787e1fbc277b'],181,951,1132,737055,12,0.442542787,0.95599022,0.936430318,2043
4a3d244a2cb95654d18368de6e5b67661d4f4f10,1,Guozhang Wang,2015-11-16 14:09:27-08:00,['45e7f71309f9a3e30d25a6ddd3171c67e3e79286'],3,9,12,737067,1,0.666666667,1,1,2043
5fc4546de7f238a8ee9c6f0b4fe276f0da47707c,1,Jun Rao,2015-11-16 14:04:26-08:00,['4a3d244a2cb95654d18368de6e5b67661d4f4f10'],248,310,558,737625,2,1,1,1,2043
6cbd97597ccf456a4f01f19553da5a03e12c9366,1,Jun Rao,2015-11-16 14:14:17-08:00,['5fc4546de7f238a8ee9c6f0b4fe276f0da47707c'],218,217,435,738060,14,,,,2043
6df9e7ff2c6cfb3c7ca16f94928d0e86f3d087e2,1,Jun Rao,2015-11-16 15:50:46-08:00,['6cbd97597ccf456a4f01f19553da5a03e12c9366'],26,42,68,738128,2,0,0,0.071428571,2043
ae315264dbc8a9efc5b5fbb1967a8a5df76dddb3,0,Jun Rao,2015-11-16 17:57:59-08:00,['6df9e7ff2c6cfb3c7ca16f94928d0e86f3d087e2'],1,4,5,738133,1,,,,2043
f1169f1da8728db842aca23dcb6fde740a400699,1,Jun Rao,2015-11-16 22:00:34-08:00,['ae315264dbc8a9efc5b5fbb1967a8a5df76dddb3'],24,8,32,738165,1,,,,2043
52d5e88393630ce6f817bd003c7c787e36e31277,0,Jun Rao,2015-11-17 08:36:43-08:00,['f1169f1da8728db842aca23dcb6fde740a400699'],28,35,63,738228,11,1,1,1,2043
ffc0965d38c364272078d771fc5ed5f8784e4012,0,Jun Rao,2015-11-17 12:00:16-08:00,['52d5e88393630ce6f817bd003c7c787e36e31277'],20,19,39,738267,2,0.333333333,0.333333333,0,2043
1a36af80b79a634a652e594d8240924ac32376ae,1,Confluent,2015-11-17 17:34:54-08:00,['ffc0965d38c364272078d771fc5ed5f8784e4012'],3,67,70,738337,4,0.081081081,1,1,2043
015862348002cc6d1148dda0555fe88c27998982,1,Confluent,2015-11-17 17:39:21-08:00,['1a36af80b79a634a652e594d8240924ac32376ae'],3,12,15,738352,2,1,1,1,2043
dacd21ec4e9028593faedeb7d2a4484394367612,1,Jun Rao,2015-11-17 17:46:59-08:00,['015862348002cc6d1148dda0555fe88c27998982'],34,28,62,738414,3,0,0,0,2043
36b1c1dae292b9a43f56c385de13b89dfd03cad8,0,Jun Rao,2015-11-17 18:00:09-08:00,['dacd21ec4e9028593faedeb7d2a4484394367612'],0,12,12,738426,1,0.2,0.4,0.4,2043
06d2c78164aca4b20d1d76f2ddef563b115f2b81,0,Jun Rao,2015-11-17 18:10:38-08:00,['36b1c1dae292b9a43f56c385de13b89dfd03cad8'],8,16,24,738450,1,1,1,1,2043
dbdec927b9badcdbe4a4b4b6ccebf5044ca32747,1,Jun Rao,2015-11-17 18:34:51-08:00,['06d2c78164aca4b20d1d76f2ddef563b115f2b81'],150,200,350,738800,8,0.519230769,0.903846154,0,2043
17c6f33126823c4f54ea22ed2284267271b58e21,1,Jun Rao,2015-11-17 19:05:53-08:00,['dbdec927b9badcdbe4a4b4b6ccebf5044ca32747'],8,8,16,738816,2,,,,2043
8f6ffe1c28d43bebf1cef7198c1e154a2adc92c3,0,Jun Rao,2015-11-18 10:42:15-08:00,['17c6f33126823c4f54ea22ed2284267271b58e21'],25,24,49,738865,6,,,,2043
d6e900a185c840b7373b35bf065e1d8cc6e4183a,0,Confluent,2015-11-18 12:44:02-08:00,['8f6ffe1c28d43bebf1cef7198c1e154a2adc92c3'],8,4,12,738877,2,,,,2043
0f00ec97ae328d04c29cb1cb3eabad3f17e31582,1,Gwen Shapira,2015-11-18 14:19:37-08:00,['d6e900a185c840b7373b35bf065e1d8cc6e4183a'],60,176,236,739113,2,0.375,0.35,0.9625,2043
2e91806db45b3854bd2fadb69cee4ecae9fd43ac,1,Confluent,2015-11-18 15:11:17-08:00,['0f00ec97ae328d04c29cb1cb3eabad3f17e31582'],36,40,76,739189,3,,,,2043
f154956a76790220a9ecb84d88644076c6885683,1,Confluent,2015-11-18 17:13:21-08:00,['2e91806db45b3854bd2fadb69cee4ecae9fd43ac'],6,105,111,739300,3,0.568627451,1,0.980392157,2044
fa4244745fc363410fd5bc21e0b045f8124a8f9c,1,Confluent,2015-11-18 17:19:47-08:00,['f154956a76790220a9ecb84d88644076c6885683'],22,79,101,739401,2,0.617647059,0.911764706,0.970588235,2044
c7c7f4cfa7e1c385d5f5706161572d657b495b7a,1,Gwen Shapira,2015-11-19 07:59:03-08:00,['fa4244745fc363410fd5bc21e0b045f8124a8f9c'],117,132,249,739650,2,,,,2044
4e22abaa85414ab4679f22fdc25f531bc701f4c6,0,Gwen Shapira,2015-11-19 15:58:42-08:00,['c7c7f4cfa7e1c385d5f5706161572d657b495b7a'],2,18,20,739670,2,0.9,1,0.1,2044
b206a807f3c781d8d8126d7c3b97724632486fd0,0,Gwen Shapira,2015-11-19 19:29:35-08:00,['4e22abaa85414ab4679f22fdc25f531bc701f4c6'],4,1,5,739675,3,,,,2044
8ee9846e019c7758719d7e706f9e26958faedfc6,0,Gwen Shapira,2015-11-19 19:59:26-08:00,['b206a807f3c781d8d8126d7c3b97724632486fd0'],1,1,2,739677,1,,,,2044
d0614f97bc1c45734631770c46ab6a79fc8c8547,1,Jun Rao,2015-11-20 08:28:20-08:00,['8ee9846e019c7758719d7e706f9e26958faedfc6'],33,36,69,739746,5,0,0,1,2044
7b3d1bf6a398f5b1f454a7719d04f5ee9e630f96,1,Jun Rao,2015-11-20 10:04:40-08:00,['d0614f97bc1c45734631770c46ab6a79fc8c8547'],4,10,14,739760,1,0,0,1,2044
b1d17e7ef0e901234d95d7825f6862d2aaead76f,1,Jun Rao,2015-11-20 10:43:25-08:00,['7b3d1bf6a398f5b1f454a7719d04f5ee9e630f96'],47,73,120,739880,6,0,1,1,2044
9b0ddc555fcb0e65962d0a7fb3dbaba43fae3fb8,0,Gwen Shapira,2015-11-20 11:44:25-08:00,['b1d17e7ef0e901234d95d7825f6862d2aaead76f'],0,1,1,739881,1,1,1,0,2044
b609645dc4813de7ca5c6366e940831f6e7c1177,0,Jun Rao,2015-11-20 13:26:40-08:00,['9b0ddc555fcb0e65962d0a7fb3dbaba43fae3fb8'],1,1,2,739883,1,,,,2044
a7726ee651ac3b23fd5a4925b9a324c3462ea127,0,Jun Rao,2015-11-20 13:47:27-08:00,['b609645dc4813de7ca5c6366e940831f6e7c1177'],4,4,8,739891,1,,,,2044
0d68eb73f3af8d0e8e32a1e61d8a569c615c3c8c,1,Guozhang Wang,2015-11-20 15:36:59-08:00,['a7726ee651ac3b23fd5a4925b9a324c3462ea127'],13,14,27,739918,1,,,,2044
b16817a54c592eefc5a462132f45c5b4f786d5f1,1,Guozhang Wang,2015-11-20 15:46:42-08:00,['0d68eb73f3af8d0e8e32a1e61d8a569c615c3c8c'],103,370,473,740391,2,0.598802395,0.97005988,0.51497006,2044
6a1993b8e08da1a4e8b5b7fbb55d777b70b1f6f5,0,Guozhang Wang,2015-11-20 15:59:24-08:00,['b16817a54c592eefc5a462132f45c5b4f786d5f1'],1,1,2,740393,1,,,,2044
3e0333d692762b99eb51d0e2948fe240eef7a6af,0,Jun Rao,2015-11-20 16:31:05-08:00,['6a1993b8e08da1a4e8b5b7fbb55d777b70b1f6f5'],2,2,4,740397,1,,,,2044
84c8d2bb86dc2794a3d6a86ae28b3cb51cea5c4b,1,wangguoz@gmail.com,2015-11-21 18:46:15-08:00,['3e0333d692762b99eb51d0e2948fe240eef7a6af'],5,39,44,740441,2,0.909090909,0.909090909,0.909090909,2044
f81dd4a4fbb5c1c78dc5fc38a13d2adaf7eff2e7,0,Jun Rao,2015-11-23 07:38:10-08:00,['84c8d2bb86dc2794a3d6a86ae28b3cb51cea5c4b'],1,1,2,740443,1,,,,2044
e32df4722ca476ab373cca45a824f712cf4943ef,0,Guozhang Wang,2015-11-23 16:14:23-08:00,['f81dd4a4fbb5c1c78dc5fc38a13d2adaf7eff2e7'],2,3,5,740448,1,1,1,0,2044
c213952fa180c56908ef70c01a784d24202beb55,0,Gwen Shapira,2015-11-23 18:22:01-08:00,['e32df4722ca476ab373cca45a824f712cf4943ef'],4,3,7,740455,1,,,,2044
5a9b12eb5d62cfb04db93a105e10ddfcae793e2b,0,Jun Rao,2015-11-24 09:47:54-08:00,['c213952fa180c56908ef70c01a784d24202beb55'],0,1,1,740456,1,,,,2044
394eda510dfc1af5c614fa88ee96c7cf2c098fd0,1,Guozhang Wang,2015-11-24 16:17:23-08:00,['5a9b12eb5d62cfb04db93a105e10ddfcae793e2b'],1,2,3,740459,1,0,0,1,2044
395bf46ddac8c5fe1d6fd0d1636b94dcddadd678,1,Gwen Shapira,2015-11-24 16:39:01-08:00,['394eda510dfc1af5c614fa88ee96c7cf2c098fd0'],13,33,46,740505,3,,,,2044
d1053915f64aec7ea717bbeac9570b1f75e9a2b0,1,Gwen Shapira,2015-11-24 17:39:14-08:00,['395bf46ddac8c5fe1d6fd0d1636b94dcddadd678'],16,34,50,740555,2,0,0,1,2044
3022c1938d6cce22450be45d3a28728159f4dfbc,1,Gwen Shapira,2015-11-24 17:41:02-08:00,['d1053915f64aec7ea717bbeac9570b1f75e9a2b0'],19,42,61,740616,3,,,,2044
87b894d682a5f10b2e1d32dd028ddb258f2f1bbf,0,Jun Rao,2015-11-25 08:53:13-08:00,['3022c1938d6cce22450be45d3a28728159f4dfbc'],0,19,19,740635,2,1,1,1,2044
617a91a236a44431aeca9345ae954f7067da48f3,1,Guozhang Wang,2015-11-25 12:04:24-08:00,['87b894d682a5f10b2e1d32dd028ddb258f2f1bbf'],1,11,12,740647,2,1,1,1,2044
8ed271b82abd4641b594aff262512bd9eb588263,1,Guozhang Wang,2015-11-25 14:20:48-08:00,['617a91a236a44431aeca9345ae954f7067da48f3'],20,27,47,740694,5,1,1,1,2044
e14ae66e721f98ca7c18d35ea022e6de733f4c03,0,Guozhang Wang,2015-11-25 14:53:24-08:00,['8ed271b82abd4641b594aff262512bd9eb588263'],16,16,32,740726,1,,,,2044
34a6be2ccd95d50e7659a57c943436e579521471,0,Gwen Shapira,2015-11-25 15:03:10-08:00,['e14ae66e721f98ca7c18d35ea022e6de733f4c03'],2,15,17,740743,1,1,1,1,2044
69a1cced49d7d0c805adeb1dfd327f8bb5c7ce9a,0,Gwen Shapira,2015-11-25 15:05:31-08:00,['34a6be2ccd95d50e7659a57c943436e579521471'],14,41,55,740798,4,0,0.3,0.2,2044
5e8958a856a5b4ccbdcb610473cab4c2eeddbac5,1,Guozhang Wang,2015-11-25 15:21:17-08:00,['69a1cced49d7d0c805adeb1dfd327f8bb5c7ce9a'],73,40,113,740911,11,0.125,0,1,2044
d07bb1814010ca4d822e44330d1e8ea4b2839c80,0,Guozhang Wang,2015-11-25 16:44:43-08:00,['5e8958a856a5b4ccbdcb610473cab4c2eeddbac5'],39,25,64,740975,4,0,0,0.5,2044
abf6b2ebb3e6e34ef9c4623b4c28dacce461c0c0,0,Gwen Shapira,2015-11-25 17:19:00-08:00,['d07bb1814010ca4d822e44330d1e8ea4b2839c80'],3,3,6,740981,1,,,,2044
c18a1bd64e7f8416e8256b968fe1b9e2da553b00,0,Gwen Shapira,2015-11-25 22:30:18-08:00,['abf6b2ebb3e6e34ef9c4623b4c28dacce461c0c0'],2,1,3,740984,1,,,,2044
4a0e011be3d038763d6326bb0092524f809c3f4d,1,Guozhang Wang,2015-11-26 22:18:21-08:00,['c18a1bd64e7f8416e8256b968fe1b9e2da553b00'],18,69,87,741071,1,1,1,1,2044
09b43beb1d0aabb2776da2a5790752992ef617f7,0,Guozhang Wang,2015-11-27 12:13:59-08:00,['4a0e011be3d038763d6326bb0092524f809c3f4d'],1,1,2,741073,1,,,,2044
1dd558aeceffdd98da83f8240cdc3bf8bc182c93,0,Guozhang Wang,2015-11-27 12:24:32-08:00,['09b43beb1d0aabb2776da2a5790752992ef617f7'],1,1,2,741075,1,,,,2044
4a8acdf9d7135a50b751a0bea9e205ea4a071e5c,1,Jun Rao,2015-11-28 08:23:35-08:00,['1dd558aeceffdd98da83f8240cdc3bf8bc182c93'],91,554,645,741720,15,0.8,1,0.74,2048
75c7abd82628b7aae026a662ad0395d1f9c8536b,0,Gwen Shapira,2015-11-30 05:26:32+08:00,['4a8acdf9d7135a50b751a0bea9e205ea4a071e5c'],19,19,38,741758,5,,,,2048
78e7f87db8be3b1eae59752e8c9ceb0b8c064a96,1,Guozhang Wang,2015-11-30 11:01:54-08:00,['75c7abd82628b7aae026a662ad0395d1f9c8536b'],1,1,2,741760,1,,,,2048
ea971397c8c1b8deedc48c4165aded42118eee43,0,Guozhang Wang,2015-11-30 11:10:01-08:00,['78e7f87db8be3b1eae59752e8c9ceb0b8c064a96'],1,1,2,741762,1,,,,2048
a35334908df58b7aaa01efd5ce8434f5e6804cb1,0,Guozhang Wang,2015-11-30 13:57:54-08:00,['ea971397c8c1b8deedc48c4165aded42118eee43'],7,10,17,741779,1,,,,2048
6b4cc2ea2b141b25852e2110ac4a400905154b92,1,Guozhang Wang,2015-11-30 14:13:50-08:00,['a35334908df58b7aaa01efd5ce8434f5e6804cb1'],25,197,222,742001,11,0.752941176,1,0.858823529,2049
eafc349a1f26a20086b320916c2c819e05bc77ea,0,Guozhang Wang,2015-11-30 21:33:31-08:00,['6b4cc2ea2b141b25852e2110ac4a400905154b92'],3,5,8,742009,1,0,0,1,2049
fb6ea6b179b6e4b8a7b23063b17828b42361cd75,1,Guozhang Wang,2015-12-01 11:16:33-08:00,['eafc349a1f26a20086b320916c2c819e05bc77ea'],1,2,3,742012,1,,,,2049
0264127ba829adae0f1f1e7f610d2356fbcf17f3,0,Guozhang Wang,2015-12-01 11:48:16-08:00,['fb6ea6b179b6e4b8a7b23063b17828b42361cd75'],5,4,9,742021,3,,,,2049
4649c347b6a59f8fbd4fcaf2363eb172a7da1d4c,0,Guozhang Wang,2015-12-01 11:50:21-08:00,['0264127ba829adae0f1f1e7f610d2356fbcf17f3'],1,1,2,742023,1,,,,2049
0a52ddfd039721521f60fd23399469d975f3f9ea,0,Guozhang Wang,2015-12-01 11:52:38-08:00,['4649c347b6a59f8fbd4fcaf2363eb172a7da1d4c'],8,16,24,742047,2,,,,2049
69269e76a43adf85a478240280c6ab3c7eef4d8e,1,Guozhang Wang,2015-12-01 11:57:34-08:00,['0a52ddfd039721521f60fd23399469d975f3f9ea'],24,45,69,742116,4,0,0,0,2049
cff03f8b68604ce8c8c743801b075b655af23011,0,Jun Rao,2015-12-02 08:08:37-06:00,['69269e76a43adf85a478240280c6ab3c7eef4d8e'],8,9,17,742133,5,1,1,0,2049
8c3c9548b636cdf760d2537afe115942d13bc003,0,Guozhang Wang,2015-12-02 11:17:23-08:00,['cff03f8b68604ce8c8c743801b075b655af23011'],2,3,5,742138,1,,,,2049
9fb1e25738f89b75a36ef69f730b0e138ccd55b1,1,Guozhang Wang,2015-12-02 11:27:36-08:00,['8c3c9548b636cdf760d2537afe115942d13bc003'],172,313,485,742623,12,1,1,1,2049
a5382a333ebb51a10c1a1cab46d66f10abff128a,1,Guozhang Wang,2015-12-02 18:40:07-08:00,['9fb1e25738f89b75a36ef69f730b0e138ccd55b1'],1,71,72,742695,2,1,1,1,2050
b09663eeec2153e2556983b8ef21551e69ee6afc,0,Guozhang Wang,2015-12-03 08:58:24-08:00,['a5382a333ebb51a10c1a1cab46d66f10abff128a'],1,1,2,742697,1,,,,2050
5b5f6bbe68a82ce5eae946e0a1a199e9713a6ff7,1,Guozhang Wang,2015-12-03 10:43:44-08:00,['b09663eeec2153e2556983b8ef21551e69ee6afc'],39,81,120,742817,3,1,1,1,2050
13e483adeee8d968397a21bde3bb159516f26ff0,1,Guozhang Wang,2015-12-03 11:01:08-08:00,['5b5f6bbe68a82ce5eae946e0a1a199e9713a6ff7'],10,20,30,742847,2,1,1,0,2050
80df43500141d6bf710b19f342c8ab172587c128,1,Guozhang Wang,2015-12-03 17:47:44-08:00,['13e483adeee8d968397a21bde3bb159516f26ff0'],12,199,211,743058,7,0.701492537,0.731343284,0.880597015,2051
cd54fc8816964f5a56469075c75c567e777b9656,1,Guozhang Wang,2015-12-03 21:17:51-08:00,['80df43500141d6bf710b19f342c8ab172587c128'],64,198,262,743320,12,0.773333333,1,1,2052
39c3512eceedebcb6e50f8c6c4ef66601ff7dbc4,1,Guozhang Wang,2015-12-04 14:59:24-08:00,['cd54fc8816964f5a56469075c75c567e777b9656'],528,2268,2796,746116,40,0.291492329,0.853556485,0.871687587,2069
23f36c5903e9b65c2b322a9405149de671de7a23,1,Guozhang Wang,2015-12-05 15:57:15-08:00,['39c3512eceedebcb6e50f8c6c4ef66601ff7dbc4'],31,9,40,746156,2,0.272727273,0.272727273,0,2069
d05fa0a03bc9bcfcff8d73cbf1b22832ebdb75a2,1,Gwen Shapira,2015-12-07 15:12:09-08:00,['23f36c5903e9b65c2b322a9405149de671de7a23'],356,899,1255,747411,38,0.179310345,0.624137931,0.675862069,2069
b390b15cdbf89f7ffce16dad2a20ee9330f82731,0,Guozhang Wang,2015-12-07 23:15:04-08:00,['d05fa0a03bc9bcfcff8d73cbf1b22832ebdb75a2'],179,3,182,747593,2,0.544444444,0,0,2069
268392f5e99dc3eab9d89e921bafde782a1d10a6,1,Guozhang Wang,2015-12-07 23:16:19-08:00,['b390b15cdbf89f7ffce16dad2a20ee9330f82731'],20,184,204,747797,5,0.146788991,0.935779817,0.880733945,2069
5bc90d4542ca9d6cea3eac1e0a7e1bfa1fed15e7,1,Gwen Shapira,2015-12-08 09:55:46-08:00,['268392f5e99dc3eab9d89e921bafde782a1d10a6'],219,175,394,748191,21,0,0,0,2069
e1c4aefc36fad009326b9611606c41f43d500108,0,Gwen Shapira,2015-12-08 12:56:13-08:00,['5bc90d4542ca9d6cea3eac1e0a7e1bfa1fed15e7'],3,3,6,748197,2,,,,2069
d09188aa36f7dad262bef8480e7785f496dc321b,0,Gwen Shapira,2015-12-08 17:20:50-08:00,['e1c4aefc36fad009326b9611606c41f43d500108'],2,2,4,748201,1,,,,2069
b5f5be69ea99f3b434b187129e7319607009a8f3,0,Gwen Shapira,2015-12-08 17:22:03-08:00,['d09188aa36f7dad262bef8480e7785f496dc321b'],6,3,9,748210,2,,,,2069
ee6b5e044c5a4b8ec996b05da76a21c191a95149,0,Ewen Cheslack-Postava,2015-12-08 17:48:52-08:00,['b5f5be69ea99f3b434b187129e7319607009a8f3'],9,20,29,748239,1,0.75,1,1,2069
ef92a8ae7479560b26edecfa8db79934065f13cf,1,Jun Rao,2015-12-08 19:43:05-08:00,['ee6b5e044c5a4b8ec996b05da76a21c191a95149'],375,458,833,749072,35,1,1,1,2069
454d7d09014c0e6be3064a120c80261998341fed,1,Guozhang Wang,2015-12-08 21:48:11-08:00,['ef92a8ae7479560b26edecfa8db79934065f13cf'],18,111,129,749201,2,0.666666667,0.76,1,2069
991aad23baa2f55d405d374b0a01785acdc63974,1,Guozhang Wang,2015-12-08 23:33:46-08:00,['454d7d09014c0e6be3064a120c80261998341fed'],116,634,750,749951,17,0.942708333,1,0.989583333,2074
977ebbe9bafb6c1a6e1be69620f745712118fe80,0,Gwen Shapira,2015-12-09 09:52:17-08:00,['991aad23baa2f55d405d374b0a01785acdc63974'],1,4,5,749956,2,0,1,1,2074
3fa0e12920061788fae87a1293ebcf5e863815ae,1,Gwen Shapira,2015-12-09 10:02:13-08:00,['977ebbe9bafb6c1a6e1be69620f745712118fe80'],2,2,4,749960,1,,,,2074
98ea82a8913b4d34e67a6c7e5fb6f149be6bec64,0,Guozhang Wang,2015-12-09 10:59:21-08:00,['3fa0e12920061788fae87a1293ebcf5e863815ae'],2,2,4,749964,1,,,,2074
7bb7e415a371909757a6099a911587047d4c4b69,0,Guozhang Wang,2015-12-09 11:57:20-08:00,['98ea82a8913b4d34e67a6c7e5fb6f149be6bec64'],1,13,14,749978,2,1,1,1,2074
f7fc2853868caa3b8a044b6d5d52ce26ae2a3677,0,Gwen Shapira,2015-12-09 17:39:53-06:00,['7bb7e415a371909757a6099a911587047d4c4b69'],3,3,6,749984,3,,,,2074
6e5bd2497af2b6bb67a47e4f3defa50da3cad4c7,1,Guozhang Wang,2015-12-09 20:34:09-08:00,['f7fc2853868caa3b8a044b6d5d52ce26ae2a3677'],11,17,28,750012,5,0,1,1,2074
ec466d358dcd5ff9e035a6d5de82ada12d187ae0,1,Guozhang Wang,2015-12-09 22:15:34-08:00,['6e5bd2497af2b6bb67a47e4f3defa50da3cad4c7'],18,20,38,750050,2,1,1,0,2074
3b350cdff795ec08dc77e60f127f2790149d8d52,1,Guozhang Wang,2015-12-09 23:02:44-08:00,['ec466d358dcd5ff9e035a6d5de82ada12d187ae0'],12,996,1008,751058,10,0.432735426,0.468609865,0.968609865,2080
ed8748b7d17448a215ebbf68749d311aae30d7f7,1,Ewen Cheslack-Postava,2015-12-10 10:01:58-08:00,['3b350cdff795ec08dc77e60f127f2790149d8d52'],4,4,8,751066,1,,,,2080
9d23b512ccb95940782f51c93bd6cdbed3e938db,1,Guozhang Wang,2015-12-10 10:49:02-08:00,['ed8748b7d17448a215ebbf68749d311aae30d7f7'],0,17,17,751083,2,1,1,1,2080
882fe01284ef7d61e19e4a527fb7c18471a8c074,0,Ewen Cheslack-Postava,2015-12-10 13:09:33-08:00,['9d23b512ccb95940782f51c93bd6cdbed3e938db'],1,1,2,751085,1,,,,2080
a29f80dc74fcdfea4f92ed3c7d18e4978f809307,0,Ewen Cheslack-Postava,2015-12-10 15:27:38-08:00,['882fe01284ef7d61e19e4a527fb7c18471a8c074'],1,1,2,751087,1,,,,2080
a5f1537f8762f4787b2af106c5d93c156f906074,1,Ewen Cheslack-Postava,2015-12-10 17:06:47-08:00,['a29f80dc74fcdfea4f92ed3c7d18e4978f809307'],0,138,138,751225,2,1,1,0.862068966,2081
18d7abd899c5bdbbcde3be448f24458ed4f9a851,0,Ewen Cheslack-Postava,2015-12-10 17:35:03-08:00,['a5f1537f8762f4787b2af106c5d93c156f906074'],63,118,181,751406,4,1,1,0,2081
98a093d6c97b322e2175ebdcd987dac7efe6bb1b,0,Ewen Cheslack-Postava,2015-12-10 20:45:18-08:00,['18d7abd899c5bdbbcde3be448f24458ed4f9a851'],3,3,6,751412,1,,,,2081
1dcafadefc09aece9037bc930aa0de7617f655b2,1,Guozhang Wang,2015-12-10 21:48:27-08:00,['98a093d6c97b322e2175ebdcd987dac7efe6bb1b'],0,97,97,751509,3,0.082191781,1,1,2081
01f3e59ef91b348a5fab805bc6915591dd490a16,1,Ewen Cheslack-Postava,2015-12-11 09:37:09-08:00,['1dcafadefc09aece9037bc930aa0de7617f655b2'],36,51,87,751596,4,0,0,1,2081
fd8af25d0ae354e962850c9d6b5991056613aa2d,0,Guozhang Wang,2015-12-11 11:32:42-08:00,['01f3e59ef91b348a5fab805bc6915591dd490a16'],1,1,2,751598,1,,,,2081
3fed57909c16f807715f305152a5034aeb1a5532,0,Guozhang Wang,2015-12-13 11:51:42-08:00,['fd8af25d0ae354e962850c9d6b5991056613aa2d'],10,9,19,751617,3,1,0,1,2081
e08b922aad485a96fceb51d5c27877729156ddab,1,Guozhang Wang,2015-12-14 14:54:22-08:00,['3fed57909c16f807715f305152a5034aeb1a5532'],103,54,157,751774,6,0.085714286,0.028571429,0,2081
b352d7fbfc07cc14368c01005966924cc3a8d6fe,0,Gwen Shapira,2015-12-14 15:45:12-08:00,['e08b922aad485a96fceb51d5c27877729156ddab'],1,1,2,751776,1,,,,2081
f3fc9e108eb1e5d47144cc7f2eaa8beb4f88be6b,0,Ewen Cheslack-Postava,2015-12-14 16:02:03-08:00,['b352d7fbfc07cc14368c01005966924cc3a8d6fe'],3,1,4,751780,1,,,,2081
901fe2eec272043236e149513b7cbce1b21f592d,0,Guozhang Wang,2015-12-14 17:52:27-08:00,['f3fc9e108eb1e5d47144cc7f2eaa8beb4f88be6b'],13,13,26,751806,2,,,,2081
9a0e16397e81323a3c93053ee473dfcdf3bcceb3,0,Ewen Cheslack-Postava,2015-12-14 19:03:20-08:00,['901fe2eec272043236e149513b7cbce1b21f592d'],3,5,8,751814,2,,,,2081
9545cc88348b78f66c1c7a891449caa35f322a74,1,Sriharsha Chintalapani,2015-12-15 10:55:24-08:00,['9a0e16397e81323a3c93053ee473dfcdf3bcceb3'],13,20,33,751847,1,,,,2081
3f3358b6d4374662f5ca57c6e93e009b58a6b2a2,0,Gwen Shapira,2015-12-15 13:46:57-08:00,['9545cc88348b78f66c1c7a891449caa35f322a74'],34,34,68,751915,25,,,,2081
3432e85f664c5e3d8300171c314ea52b2f4b88fd,1,Gwen Shapira,2015-12-15 13:48:34-08:00,['3f3358b6d4374662f5ca57c6e93e009b58a6b2a2'],366,162,528,752443,8,0.160583942,0.01459854,0.145985401,2082
fdac34e6ab2a7760c170f53556fec7dca8ee9b22,0,Ewen Cheslack-Postava,2015-12-15 16:18:39-08:00,['3432e85f664c5e3d8300171c314ea52b2f4b88fd'],4,3,7,752450,1,,,,2082
5df783f18e9a6a6e17960e3ef4b0a66f4d10d65c,1,Gwen Shapira,2015-12-15 17:05:46-08:00,['fdac34e6ab2a7760c170f53556fec7dca8ee9b22'],6,9,15,752465,1,0,0,0,2082
4ad165c0783bc49e5750292cd0e8d277e3186846,0,Ewen Cheslack-Postava,2015-12-15 20:57:05-08:00,['5df783f18e9a6a6e17960e3ef4b0a66f4d10d65c'],3,5,8,752473,1,,,,2082
841d2d1a26af94ec95c480dbf2453f9c7d28c2f7,1,Guozhang Wang,2015-12-15 23:53:23-08:00,['4ad165c0783bc49e5750292cd0e8d277e3186846'],25,38,63,752536,1,0.222222222,0.444444444,0.777777778,2082
587a2f4efd7994d4d3af82ed91304f939514294a,1,Guozhang Wang,2015-12-16 15:37:53-08:00,['841d2d1a26af94ec95c480dbf2453f9c7d28c2f7'],227,1222,1449,753985,21,0.086587436,0.400679117,1,2085
a2a417caf9fa4f177e099fed7d2a9b8d1942a9d6,0,Gwen Shapira,2015-12-17 16:52:24-08:00,['587a2f4efd7994d4d3af82ed91304f939514294a'],6,6,12,753997,3,,,,2085
9220df9f8b58870a2282d3e4ceb2e003667d854b,1,Gwen Shapira,2015-12-17 18:02:38-08:00,['a2a417caf9fa4f177e099fed7d2a9b8d1942a9d6'],50,119,169,754166,5,0.66,0.5,0,2085
8c754c45af57a3249232268c6093cb4f50e1d45f,0,Ewen Cheslack-Postava,2015-12-18 10:27:03-08:00,['9220df9f8b58870a2282d3e4ceb2e003667d854b'],60,64,124,754290,41,,,,2085
3615e4773dd20327dead494cd0ba6a26edada92d,1,Guozhang Wang,2015-12-20 22:01:21-08:00,['8c754c45af57a3249232268c6093cb4f50e1d45f'],0,11,11,754301,2,0.909090909,0.909090909,0.090909091,2085
d2632d011f7bda3cbd0cbcc8f2a3bd1e985d5b1b,1,Guozhang Wang,2015-12-20 22:06:56-08:00,['3615e4773dd20327dead494cd0ba6a26edada92d'],5,8,13,754314,1,0,1,0.666666667,2085
e32131ed6fcfaea7e56295ea0b6ddbf8c804460f,0,Guozhang Wang,2015-12-21 10:43:46-08:00,['d2632d011f7bda3cbd0cbcc8f2a3bd1e985d5b1b'],0,3,3,754317,1,1,1,1,2085
fa4ffb8767da18b2b84ef3d3cbeb2d4c5b804dbe,1,Guozhang Wang,2015-12-21 10:53:51-08:00,['e32131ed6fcfaea7e56295ea0b6ddbf8c804460f'],7,5,12,754329,1,,0,1,2085
a0d21407cbdd3b7cb73f52c986aa2f60804618e7,1,Ewen Cheslack-Postava,2015-12-21 13:30:59-08:00,['fa4ffb8767da18b2b84ef3d3cbeb2d4c5b804dbe'],37,193,230,754559,30,,,,2085
64b746bd8b4dae17d7dd804f0e7161f304e2d8ee,0,Ewen Cheslack-Postava,2015-12-21 22:48:03-08:00,['a0d21407cbdd3b7cb73f52c986aa2f60804618e7'],648,720,1368,755927,9,0.285714286,0.142857143,0,2086
a6889a2bf94cb326247b5076f474337fbadfadf4,0,Guozhang Wang,2015-12-22 10:44:25-08:00,['64b746bd8b4dae17d7dd804f0e7161f304e2d8ee'],2,2,4,755931,1,,,,2086
976fa192d45243d2da3eb7e1d6fa1ce0fdda1fd2,1,Ewen Cheslack-Postava,2015-12-22 16:15:37-08:00,['a6889a2bf94cb326247b5076f474337fbadfadf4'],151,194,345,756276,4,0,1,0,2087
bde49e3711a45721a0d1df9acf3ce2e5a8f990e9,0,Ewen Cheslack-Postava,2015-12-22 17:07:15-08:00,['976fa192d45243d2da3eb7e1d6fa1ce0fdda1fd2'],2,3,5,756281,1,0,1,1,2087
ba6f141dd78b3dfeafb2088f8acb6dcf65468b19,0,Gwen Shapira,2015-12-22 17:55:13-08:00,['bde49e3711a45721a0d1df9acf3ce2e5a8f990e9'],2,2,4,756285,1,,,,2087
0f11b2b8251a3905a93cfe84abefd24791ae3658,0,Gwen Shapira,2015-12-22 18:16:38-08:00,['ba6f141dd78b3dfeafb2088f8acb6dcf65468b19'],2,0,2,756287,1,,,,2087
07ee17fd05900101ad2ebc7210f94b05e230bf83,0,Gwen Shapira,2015-12-22 18:28:48-08:00,['0f11b2b8251a3905a93cfe84abefd24791ae3658'],684,1,685,756972,4,0.471291866,0.437799043,0.184210526,2087
83d4c359bab40ce7418cd5f7219a23a9fcfba921,0,Gwen Shapira,2015-12-22 18:30:38-08:00,['07ee17fd05900101ad2ebc7210f94b05e230bf83'],1,1,2,756974,1,,,,2087
ea73356905ff4663d0d085c46b348fa4e9b9568d,1,Ewen Cheslack-Postava,2015-12-23 20:55:01-08:00,['83d4c359bab40ce7418cd5f7219a23a9fcfba921'],1,5,6,756980,2,1,1,1,2087
ca7c76b2632bceaddacb5e6167e84904fd6f58f9,0,Ewen Cheslack-Postava,2015-12-25 14:40:00-05:00,['ea73356905ff4663d0d085c46b348fa4e9b9568d'],1,1,2,756982,1,,,,2087
b0a4a57c56cf5691aaf0e11a3ddf4c6d067994f7,1,Gwen Shapira,2015-12-26 08:51:07-08:00,['ca7c76b2632bceaddacb5e6167e84904fd6f58f9'],1,1,2,756984,1,,,,2087
d9ddc109fd360d5deb2894ad73cb9e12e2f8edbf,1,Gwen Shapira,2015-12-26 23:14:31-08:00,['b0a4a57c56cf5691aaf0e11a3ddf4c6d067994f7'],6,6,12,756996,3,,,,2087
9f33bfe19cd7841b03ff60c84148fe309555b58a,0,Gwen Shapira,2015-12-30 08:00:43-08:00,['d9ddc109fd360d5deb2894ad73cb9e12e2f8edbf'],2,2,4,757000,1,,,,2087
e11946b097ed617b6de78909dbd9f6e44765c1fd,0,Gwen Shapira,2015-12-30 17:02:58-08:00,['9f33bfe19cd7841b03ff60c84148fe309555b58a'],16,16,32,757032,2,,,,2087
b905d489188768ba1c55226857db9713b9272918,1,Jun Rao,2016-01-03 15:25:59-08:00,['e11946b097ed617b6de78909dbd9f6e44765c1fd'],12,31,43,757075,2,1,0,0,2087
2679524604b611046e9826b2a1fba461d42f06f4,0,Ewen Cheslack-Postava,2016-01-04 11:47:31-05:00,['b905d489188768ba1c55226857db9713b9272918'],5,7,12,757087,2,1,1,1,2087
f9642e2a9878faff81366dbc885a206727bd7c7b,1,Guozhang Wang,2016-01-04 08:51:30-08:00,['2679524604b611046e9826b2a1fba461d42f06f4'],40,28,68,757155,4,0,0,0,2087
b93f48f7494e1db4d564b6c28772712ee7681620,1,Ewen Cheslack-Postava,2016-01-04 15:01:58-05:00,['f9642e2a9878faff81366dbc885a206727bd7c7b'],22,181,203,757358,11,0.106382979,0.787234043,1,2087
57df460f8d7b225509dd8c061a5b6efa65c8ac9c,1,Jun Rao,2016-01-04 12:49:23-08:00,['b93f48f7494e1db4d564b6c28772712ee7681620'],41,69,110,757468,8,1,1,0.545454545,2087
b0b3e5aebf381faf81bd9454ef7b448e2ad922c7,1,Guozhang Wang,2016-01-04 16:47:17-08:00,['57df460f8d7b225509dd8c061a5b6efa65c8ac9c'],69,1417,1486,758954,14,0.338630807,1,0.937652812,2094
23d607dc2174f8d2202d438fa65e03e951591fcd,0,Gwen Shapira,2016-01-05 06:22:28-08:00,['b0b3e5aebf381faf81bd9454ef7b448e2ad922c7'],28,19,47,759001,3,,,,2094
5db147c1d453c9dabcc277bd95435f17201b9c1c,0,Jun Rao,2016-01-05 11:39:56-08:00,['23d607dc2174f8d2202d438fa65e03e951591fcd'],17,14,31,759032,1,0,1,1,2094
c44c898ec835bb16950137f831cbc18c6b8b82f5,1,Jun Rao,2016-01-05 12:03:19-08:00,['5db147c1d453c9dabcc277bd95435f17201b9c1c'],14,29,43,759075,2,0.454545455,0,1,2094
b098f677aec998600f42529b0755b8fd39e777ff,0,Jun Rao,2016-01-05 12:04:55-08:00,['c44c898ec835bb16950137f831cbc18c6b8b82f5'],6,4,10,759085,3,,,,2094
25fa39d5ef751ce5a79ff25f70203724d4272504,1,Guozhang Wang,2016-01-06 12:48:47-08:00,['b098f677aec998600f42529b0755b8fd39e777ff'],4,5,9,759094,1,,,,2094
a788c65f02ae493abc27fe63c6d181e6a9b8edfe,0,Jun Rao,2016-01-06 14:16:56-08:00,['25fa39d5ef751ce5a79ff25f70203724d4272504'],1,1,2,759096,1,,,,2094
5aad4999d1a1d35d61365ff57a9b79a6af3e70d2,1,Guozhang Wang,2016-01-06 14:34:40-08:00,['a788c65f02ae493abc27fe63c6d181e6a9b8edfe'],904,1170,2074,761170,16,0,0,0.618705036,2097
85039ab43664577524bf99453cf2b972d3724f60,1,Jun Rao,2016-01-06 15:01:18-08:00,['5aad4999d1a1d35d61365ff57a9b79a6af3e70d2'],13,20,33,761203,2,1,1,0.333333333,2097
d9cabfde6cd94fa62ed698d14321e7f1494933c0,0,Jun Rao,2016-01-06 15:21:49-08:00,['85039ab43664577524bf99453cf2b972d3724f60'],1,1,2,761205,1,,,,2097
00114dae7a0ecb361aa5b843d5c7a95381294bd2,1,Jun Rao,2016-01-06 16:08:16-08:00,['d9cabfde6cd94fa62ed698d14321e7f1494933c0'],237,31,268,761473,6,0.293650794,0,0.103174603,2097
991cafe4d4d1875ce40c31fbb54ba3930a826e62,1,Ewen Cheslack-Postava,2016-01-06 16:19:39-08:00,['00114dae7a0ecb361aa5b843d5c7a95381294bd2'],238,37,275,761748,1,,,,2097
a9ff3f2eced76a0aa13804439101c2897916e250,1,Ewen Cheslack-Postava,2016-01-06 21:24:19-08:00,['991cafe4d4d1875ce40c31fbb54ba3930a826e62'],521,727,1248,762996,68,0.975,0.975,1,2102
ee1770e00e841ba68dc25f03a8d3f2ac647b0eb3,0,Jun Rao,2016-01-07 09:57:35-08:00,['a9ff3f2eced76a0aa13804439101c2897916e250'],15,13,28,763024,4,0,0,0,2102
4836e525c851640e0da9d8d11321621a2c70e8f0,1,Guozhang Wang,2016-01-07 14:46:02-08:00,['ee1770e00e841ba68dc25f03a8d3f2ac647b0eb3'],22,203,225,763249,8,0.765957447,1,0.319148936,2103
40d731b8712950122915795acca43886851a73b6,1,Guozhang Wang,2016-01-07 17:18:33-08:00,['4836e525c851640e0da9d8d11321621a2c70e8f0'],108,1361,1469,764718,39,0.803763441,1,0.696236559,2120
49778b18446d691321026415aeaac1b265057ece,1,Ewen Cheslack-Postava,2016-01-07 20:04:24-08:00,['40d731b8712950122915795acca43886851a73b6'],14,115,129,764847,6,0.982758621,1,0.344827586,2121
ccdf552749135b2c40f5a0afb4aa121115165ed2,0,Guozhang Wang,2016-01-08 10:43:52-08:00,['49778b18446d691321026415aeaac1b265057ece'],2,2,4,764851,2,,,,2121
58def1cba022987b83e9bc72588aaee0c1965f77,1,Ewen Cheslack-Postava,2016-01-08 15:04:27-08:00,['ccdf552749135b2c40f5a0afb4aa121115165ed2'],6,11,17,764868,1,0,0,1,2121
8d674857996667bce52a804feb6108a6903eb39b,1,Ewen Cheslack-Postava,2016-01-08 15:13:14-08:00,['58def1cba022987b83e9bc72588aaee0c1965f77'],13,23,36,764904,2,,,,2121
36f5c46a5cf510001a4990db6199beb37f215007,1,Ewen Cheslack-Postava,2016-01-08 16:08:38-08:00,['8d674857996667bce52a804feb6108a6903eb39b'],31,32,63,764967,1,,,,2121
7059158c48ec05288c0b45ccac05d62b38f1bf76,0,Ewen Cheslack-Postava,2016-01-10 22:13:54-08:00,['36f5c46a5cf510001a4990db6199beb37f215007'],2,3,5,764972,1,,,,2121
3a0fc125f4337a670ea52009afb1a254179ac07b,0,Ewen Cheslack-Postava,2016-01-11 10:08:45-08:00,['7059158c48ec05288c0b45ccac05d62b38f1bf76'],16,89,105,765077,2,0.795454545,0.431818182,1,2121
9c998dd8cd4a489512b6ed34a05afce88a0b1ba2,1,Ewen Cheslack-Postava,2016-01-11 11:10:23-08:00,['3a0fc125f4337a670ea52009afb1a254179ac07b'],11,18,29,765106,6,1,1,1,2121
f009c30947c49fec4f41efcc31b9d5d72b6f7f37,1,Ewen Cheslack-Postava,2016-01-11 14:16:58-08:00,['9c998dd8cd4a489512b6ed34a05afce88a0b1ba2'],127,171,298,765404,4,,,,2122
e789a35d3bce916f25705915b5e86353462a1454,1,Jun Rao,2016-01-11 15:00:48-08:00,['f009c30947c49fec4f41efcc31b9d5d72b6f7f37'],7,9,16,765420,1,0,0,1,2122
c9114488b3c266fe60cf96426bfa143b4b8109c0,0,Guozhang Wang,2016-01-11 18:00:57-08:00,['e789a35d3bce916f25705915b5e86353462a1454'],11,0,11,765431,1,0,0,0,2122
2adeb214b1e366e36deef045f8049406f7b3773d,1,Ewen Cheslack-Postava,2016-01-11 23:14:14-08:00,['c9114488b3c266fe60cf96426bfa143b4b8109c0'],2,40,42,765473,1,0.666666667,0.666666667,1,2122
3e5afbfa0dd4ddfca65fae1f3b2a268ae1ed2025,0,Ewen Cheslack-Postava,2016-01-11 23:15:42-08:00,['2adeb214b1e366e36deef045f8049406f7b3773d'],9,56,65,765538,3,0,0.341463415,1,2122
72eebad43d5aaf4bbd29532eedc2a793fc3ee9d5,1,Ewen Cheslack-Postava,2016-01-12 09:48:47-08:00,['3e5afbfa0dd4ddfca65fae1f3b2a268ae1ed2025'],16,46,62,765600,2,0.75,1,0,2122
836cb1963330a9e342379899e0fe52b72347736e,1,Ewen Cheslack-Postava,2016-01-12 16:16:10-08:00,['72eebad43d5aaf4bbd29532eedc2a793fc3ee9d5'],51,78,129,765729,4,1,0.846153846,1,2122
d61543e3219c5d820d1b38ccd063501da0966ba6,1,Guozhang Wang,2016-01-13 14:58:37-08:00,['836cb1963330a9e342379899e0fe52b72347736e'],1,1,2,765731,1,,,,2122
70011747c85337817497bc005ac9ea191d8688e3,0,Guozhang Wang,2016-01-13 15:01:20-08:00,['d61543e3219c5d820d1b38ccd063501da0966ba6'],1,1,2,765733,1,,,,2122
4f22705c7d0c8e8cab68883e76f554439341e34a,1,Guozhang Wang,2016-01-13 17:15:57-08:00,['70011747c85337817497bc005ac9ea191d8688e3'],172,776,948,766681,15,0.447826087,1,0.808695652,2130
a3d3d5379df71e7a2c653d06ebf1b30923dde738,1,Guozhang Wang,2016-01-14 17:09:33-08:00,['4f22705c7d0c8e8cab68883e76f554439341e34a'],26,71,97,766778,4,0.2,0.24,0.76,2130
37be6d98da842512367ab0b31d8f0244afafda92,1,Guozhang Wang,2016-01-14 17:20:08-08:00,['a3d3d5379df71e7a2c653d06ebf1b30923dde738'],2,150,152,766930,4,0.486486486,1,0.756756757,2132
6dc974312590f089c9e0ac27e8eb9b848caf32b5,1,Ewen Cheslack-Postava,2016-01-15 09:28:43-08:00,['37be6d98da842512367ab0b31d8f0244afafda92'],28,151,179,767109,4,0.678571429,0.916666667,0.988095238,2132
a071e3554bf626182557dfaca491afebe9c17020,0,Guozhang Wang,2016-01-17 17:14:07-08:00,['6dc974312590f089c9e0ac27e8eb9b848caf32b5'],6,4,10,767119,1,0,0,0,2132
60a5a523b6f7e5151d8cdc835845cfc4d2e72b52,0,Jun Rao,2016-01-17 21:22:36-08:00,['a071e3554bf626182557dfaca491afebe9c17020'],4,3,7,767126,1,1,1,0,2132
0c32bc99265c4645fad2e3244dc2c697bfd9a229,1,Ewen Cheslack-Postava,2016-01-18 09:47:32-08:00,['60a5a523b6f7e5151d8cdc835845cfc4d2e72b52'],43,35,78,767204,7,1,0,0,2132
747dc930ff710ec890b5f054b4ec4bf7bbb7c960,1,Guozhang Wang,2016-01-18 09:54:02-08:00,['0c32bc99265c4645fad2e3244dc2c697bfd9a229'],6,110,116,767320,5,0.185185185,0.419753086,1,2132
5979480c3af6be00cf7b135aeabf11bf8141f936,0,Gwen Shapira,2016-01-18 09:56:12-08:00,['747dc930ff710ec890b5f054b4ec4bf7bbb7c960'],5,0,5,767325,1,,,,2132
401ae7707cf3990240544eb4575acc46a9c85017,1,Gwen Shapira,2016-01-18 10:03:47-08:00,['5979480c3af6be00cf7b135aeabf11bf8141f936'],1,5,6,767331,2,,,,2132
cc3570d1a28354acd082c41a15d9c9efde540b16,0,Gwen Shapira,2016-01-18 10:09:17-08:00,['401ae7707cf3990240544eb4575acc46a9c85017'],4,171,175,767506,6,1,1,1,2137
a62eb5993f5517a64dd1020b0a9bbd1012f7ee67,1,Guozhang Wang,2016-01-18 12:14:43-08:00,['cc3570d1a28354acd082c41a15d9c9efde540b16'],371,912,1283,768789,39,0.462882096,0.829694323,0.672489083,2141
f75e3350259c6df11719ee0a55f5780c136f3d26,0,Guozhang Wang,2016-01-18 13:43:52-08:00,['a62eb5993f5517a64dd1020b0a9bbd1012f7ee67'],73,27,100,768889,2,0,0,1,2141
c06542edeadb99fc5adddcea422d411e3ac96171,0,Gwen Shapira,2016-01-18 18:16:12-08:00,['f75e3350259c6df11719ee0a55f5780c136f3d26'],1,1,2,768891,1,,,,2141
5c337d759892ae6d46d6901a24e9b97cebd2a4da,1,Gwen Shapira,2016-01-18 18:39:55-08:00,['c06542edeadb99fc5adddcea422d411e3ac96171'],6,39,45,768936,5,0.684210526,1,1,2141
b1d325b3c09cd95d69a66fac4a3760f57d3062c9,1,Gwen Shapira,2016-01-18 18:55:50-08:00,['5c337d759892ae6d46d6901a24e9b97cebd2a4da'],8,55,63,768999,2,0.3,0.975,1,2141
0a7f2bf335e426b12f717ec7f6d51779d56fe59b,0,Guozhang Wang,2016-01-18 22:25:37-08:00,['b1d325b3c09cd95d69a66fac4a3760f57d3062c9'],1,1,2,769001,1,,,,2141
a1efe633207312d63897ad27953a324d1874fa6b,0,Guozhang Wang,2016-01-19 09:17:47-08:00,['0a7f2bf335e426b12f717ec7f6d51779d56fe59b'],1,1,2,769003,1,,,,2141
23b8740d82e4c009fcfb4827f7cd673210bde3b4,1,Guozhang Wang,2016-01-19 09:22:13-08:00,['a1efe633207312d63897ad27953a324d1874fa6b'],4,7,11,769014,1,1,1,1,2141
e4ef8e6640a266da1d9135282ae41d18f44f8025,1,Guozhang Wang,2016-01-19 22:50:24-08:00,['23b8740d82e4c009fcfb4827f7cd673210bde3b4'],3,6,9,769023,1,0,0,0,2141
959cf09e8653f4b8255f49c6f4c258ed1a5ec38e,1,Guozhang Wang,2016-01-20 16:10:43-08:00,['e4ef8e6640a266da1d9135282ae41d18f44f8025'],570,607,1177,770200,38,0.2,0,1,2144
79cda0472b8e3af915c45daca9cce82d7c964182,1,Ewen Cheslack-Postava,2016-01-20 16:27:34-08:00,['959cf09e8653f4b8255f49c6f4c258ed1a5ec38e'],170,208,378,770578,13,0,0,1,2144
9577dc2358f4324de04219c7160a10c230a130b9,0,Gwen Shapira,2016-01-21 11:18:24-08:00,['79cda0472b8e3af915c45daca9cce82d7c964182'],2,2,4,770582,1,1,0,1,2144
f2d4ed5bc4c2bc2bf7241ad6b6a9d3c0ce026269,0,Guozhang Wang,2016-01-21 11:44:44-08:00,['9577dc2358f4324de04219c7160a10c230a130b9'],0,1,1,770583,1,,,,2144
4922a51edd91d862d9be92b1a652d2a83d936b2c,0,Guozhang Wang,2016-01-21 16:18:13-08:00,['f2d4ed5bc4c2bc2bf7241ad6b6a9d3c0ce026269'],5,13,18,770601,1,0,0,0,2144
7b2263946b944249e84c8923c2c14aa661a83639,0,Ewen Cheslack-Postava,2016-01-21 17:11:28-08:00,['4922a51edd91d862d9be92b1a652d2a83d936b2c'],5,6,11,770612,1,,,,2144
91ba074e4a9a012559ce8626c55db199c830cb0d,0,Gwen Shapira,2016-01-21 18:33:39-08:00,['7b2263946b944249e84c8923c2c14aa661a83639'],20,0,20,770632,2,,,,2144
21c6cfe50dbe818a392c28f48ce8891f7f99aaf6,1,Gwen Shapira,2016-01-22 13:00:00-08:00,['91ba074e4a9a012559ce8626c55db199c830cb0d'],507,472,979,771611,61,0.666666667,0,0,2144
a19729fe61b23178c6f91135cb81901f76f982f0,0,Ewen Cheslack-Postava,2016-01-22 14:18:30-08:00,['21c6cfe50dbe818a392c28f48ce8891f7f99aaf6'],1,27,28,771639,2,1,1,1,2145
c197113a9c04e2f6c2d1a72161c0d40d5804490e,1,Ewen Cheslack-Postava,2016-01-22 15:25:24-08:00,['a19729fe61b23178c6f91135cb81901f76f982f0'],252,670,922,772561,33,0.382716049,0.99382716,0.99382716,2151
bc9237701b06768c119e954ddb4cd2e61c24e305,1,Gwen Shapira,2016-01-22 16:24:47-08:00,['c197113a9c04e2f6c2d1a72161c0d40d5804490e'],4,12,16,772577,1,1,1,1,2151
4f39b5bc5b2104fb39ab5b0c087fe84a71205a74,1,Ewen Cheslack-Postava,2016-01-23 16:59:28-08:00,['bc9237701b06768c119e954ddb4cd2e61c24e305'],0,155,155,772732,2,0.284090909,0.545454545,0.215909091,2152
d00cf520fb0b36c7c705250b1773db2f242d5f44,1,Ewen Cheslack-Postava,2016-01-23 22:26:53-08:00,['4f39b5bc5b2104fb39ab5b0c087fe84a71205a74'],48,50,98,772830,4,,,,2152
c8b60b6344e659b805ea04fc976abcae2bf9fcf8,0,Ewen Cheslack-Postava,2016-01-24 01:16:41-08:00,['d00cf520fb0b36c7c705250b1773db2f242d5f44'],1,1,2,772832,1,,,,2152
5e8a084834ad35506ee74e1da15a3964642a512e,0,Ewen Cheslack-Postava,2016-01-24 01:55:30-08:00,['c8b60b6344e659b805ea04fc976abcae2bf9fcf8'],2,94,96,772928,2,0,1,1,2153
fa6b90f97cb366a02eae8057124ec22db1f7e9cd,0,Ewen Cheslack-Postava,2016-01-24 02:26:00-08:00,['5e8a084834ad35506ee74e1da15a3964642a512e'],1,0,1,772929,1,,,,2153
9f21837e9925cf768c95a29423f9481b50dbe21d,0,Jun Rao,2016-01-25 14:45:09-08:00,['fa6b90f97cb366a02eae8057124ec22db1f7e9cd'],4,7,11,772940,1,0,0,1,2153
30d3cc6314bf896ea37d01c5a1d6b21d69a7053f,1,Jun Rao,2016-01-25 15:12:37-08:00,['9f21837e9925cf768c95a29423f9481b50dbe21d'],17,40,57,772997,2,0,0,0,2153
942074b77b1b1162acdd1bf7a3ee299bd0113886,1,Guozhang Wang,2016-01-25 16:22:32-08:00,['30d3cc6314bf896ea37d01c5a1d6b21d69a7053f'],0,19,19,773016,1,1,1,1,2153
5ae97196ae149e58f6cfa3c5b6d968cbd7cb6787,1,Ewen Cheslack-Postava,2016-01-26 09:19:28-08:00,['942074b77b1b1162acdd1bf7a3ee299bd0113886'],188,283,471,773487,25,1,1,1,2156
82c219149027e8d96840af98d32fb1b877ab4ec2,0,Guozhang Wang,2016-01-26 11:04:58-08:00,['5ae97196ae149e58f6cfa3c5b6d968cbd7cb6787'],9,9,18,773505,1,,,,2156
1388ed9ba21a4f451f4208e0a6179bb18b14008d,0,Gwen Shapira,2016-01-26 15:33:48-08:00,['82c219149027e8d96840af98d32fb1b877ab4ec2'],0,2,2,773507,1,,,,2156
e9a72ceab6e0ceaf4d2125756f07154cd15a7178,1,Gwen Shapira,2016-01-26 16:47:26-08:00,['1388ed9ba21a4f451f4208e0a6179bb18b14008d'],5,20,25,773532,6,1,1,1,2156
9ffa907d704b424ad05c18d834cfefdc1c7ad22a,0,Gwen Shapira,2016-01-26 20:03:50-08:00,['e9a72ceab6e0ceaf4d2125756f07154cd15a7178'],157,0,157,773689,2,0,0,0,2156
22de0a8ab5d0e84fa40016754f9a8eff8193aa89,1,Guozhang Wang,2016-01-26 23:03:42-08:00,['9ffa907d704b424ad05c18d834cfefdc1c7ad22a'],2,157,159,773848,2,0,1,1,2156
523562c109b29cc5a5e56313f16f1b1ff6c5dd9c,1,Jun Rao,2016-01-27 08:23:25-08:00,['22de0a8ab5d0e84fa40016754f9a8eff8193aa89'],103,75,178,774026,28,0,0,0.85,2156
a40a2a260a8ddde8651dd8278bf70da7c67b2c1d,0,Guozhang Wang,2016-01-27 10:12:58-08:00,['523562c109b29cc5a5e56313f16f1b1ff6c5dd9c'],1,1,2,774028,1,,,,2156
9ce595d130c39ce83030e81765702697920dfcfa,0,Guozhang Wang,2016-01-28 12:25:58-08:00,['a40a2a260a8ddde8651dd8278bf70da7c67b2c1d'],1,1,2,774030,1,,,,2156
af0df0961fbc890309137424fe6b16f7c3e0a303,0,Guozhang Wang,2016-01-28 17:30:47-08:00,['9ce595d130c39ce83030e81765702697920dfcfa'],1,1,2,774032,1,,,,2156
87eccb9a3bea56e5d7d5696aaddef1421f038903,1,Guozhang Wang,2016-01-28 20:19:21-08:00,['af0df0961fbc890309137424fe6b16f7c3e0a303'],4,23,27,774059,1,0,1,1,2156
8e8b9cadea0715882997bd5d1641a065f3997077,0,Guozhang Wang,2016-01-28 20:24:58-08:00,['87eccb9a3bea56e5d7d5696aaddef1421f038903'],1,1,2,774061,1,,,,2156
962aec1a78cac18608556ac99ab583cdc944ac3f,0,Guozhang Wang,2016-01-28 20:42:51-08:00,['8e8b9cadea0715882997bd5d1641a065f3997077'],3,74,77,774138,1,,,,2156
91491986c0a4c9c4cde2ab33be822852b76759e6,1,Sriharsha Chintalapani,2016-01-29 15:51:10+05:18,['962aec1a78cac18608556ac99ab583cdc944ac3f'],23,37,60,774198,6,0.666666667,0,1,2156
8f302c83c3be0f5264a07dae73287dec81a0198d,0,Guozhang Wang,2016-01-29 08:43:33-08:00,['91491986c0a4c9c4cde2ab33be822852b76759e6'],5,1,6,774204,2,0,0,0,2156
3cfa6da6f1141c7dc70459aa0a73c75340a65cef,0,Guozhang Wang,2016-01-29 08:45:47-08:00,['8f302c83c3be0f5264a07dae73287dec81a0198d'],10,10,20,774224,1,,,,2156
20afdcdd2ec129e94cbf335555c3d78f19a2d58e,0,Guozhang Wang,2016-01-29 08:52:50-08:00,['3cfa6da6f1141c7dc70459aa0a73c75340a65cef'],1,2,3,774227,1,,,,2156
e1d32bdffd0979596058788ffa3b1130cc7d93b8,1,Ewen Cheslack-Postava,2016-01-29 09:23:55-08:00,['20afdcdd2ec129e94cbf335555c3d78f19a2d58e'],2,177,179,774406,7,1,1,1,2161
a58b459bddd5b1dcab224b53cda0196e947a5b09,0,Guozhang Wang,2016-01-29 09:29:09-08:00,['e1d32bdffd0979596058788ffa3b1130cc7d93b8'],7,7,14,774420,7,,,,2161
598851f19cbf444c1f2530ec27543dd606b6fbc9,0,Guozhang Wang,2016-01-29 09:31:02-08:00,['a58b459bddd5b1dcab224b53cda0196e947a5b09'],25,11,36,774456,3,0,0,0,2161
afda7c4dc7246bb6e1589f2d9a21f825aa9325dc,0,Guozhang Wang,2016-01-29 13:38:30-08:00,['598851f19cbf444c1f2530ec27543dd606b6fbc9'],7,0,7,774463,7,,,,2161
b433b4a2470896d90d9dc596bb932030869d5d67,0,Sriharsha Chintalapani,2016-01-30 16:53:01+05:18,['afda7c4dc7246bb6e1589f2d9a21f825aa9325dc'],3,5,8,774471,2,1,1,0,2161
eaa1433a2f2a9e9d528f5a2620edb63304067f62,0,Gwen Shapira,2016-01-30 16:22:42-08:00,['b433b4a2470896d90d9dc596bb932030869d5d67'],1,4,5,774476,1,,,,2161
181df80dc3ac04b544501f3640f8727842e272b4,0,Guozhang Wang,2016-02-01 13:51:53-08:00,['eaa1433a2f2a9e9d528f5a2620edb63304067f62'],159,0,159,774635,1,0,0,0.422222222,2161
66ecf3f08d7ce19c45fc16bf679df46cab349a8a,1,Guozhang Wang,2016-02-01 14:41:21-08:00,['181df80dc3ac04b544501f3640f8727842e272b4'],1,8,9,774644,1,0,1,1,2161
57da044a991ebf8913d44dfcfa6a27729f54a4d5,1,Ewen Cheslack-Postava,2016-02-01 16:11:13-08:00,['66ecf3f08d7ce19c45fc16bf679df46cab349a8a'],554,1227,1781,776425,36,0.542586751,0.892744479,0.943217666,2167
4adfd7960c4bef187454d1ff5186f3be690abbf5,0,Ewen Cheslack-Postava,2016-02-01 17:32:36-08:00,['57da044a991ebf8913d44dfcfa6a27729f54a4d5'],12,13,25,776450,2,1,1,0,2167
c4f32c53ede93027aa08b1cc6c9f18ec71a702a0,0,Ewen Cheslack-Postava,2016-02-02 09:36:22-08:00,['4adfd7960c4bef187454d1ff5186f3be690abbf5'],47,1,48,776498,1,0.464285714,0.392857143,0.107142857,2167
c97a75d985e42a9d1b1be0352240c45e0b0d2978,0,Guozhang Wang,2016-02-02 09:38:52-08:00,['c4f32c53ede93027aa08b1cc6c9f18ec71a702a0'],1,2,3,776501,2,,,,2167
86a9036a7b03c8ae07d014c25a5eedc315544139,1,Guozhang Wang,2016-02-02 10:14:13-08:00,['c97a75d985e42a9d1b1be0352240c45e0b0d2978'],3,8,11,776512,2,1,1,1,2167
8189f9d58002ec0092737741bf6c74eebab4dc73,0,Guozhang Wang,2016-02-02 10:52:43-08:00,['86a9036a7b03c8ae07d014c25a5eedc315544139'],9,58,67,776579,5,,,,2167
95174337c2f6cda90e213e5c3a73fc89854f42a7,1,Ewen Cheslack-Postava,2016-02-02 12:01:47-08:00,['8189f9d58002ec0092737741bf6c74eebab4dc73'],115,154,269,776848,14,0,1,0,2167
fd10f6dff11c74ab4b12229305ab78fb694d5ea9,0,Ewen Cheslack-Postava,2016-02-02 17:57:58-08:00,['95174337c2f6cda90e213e5c3a73fc89854f42a7'],1,1,2,776850,1,,,,2167
e8343e67e1ca74c4c0ebd994b9811b9fed7aa386,0,Ewen Cheslack-Postava,2016-02-02 18:29:29-08:00,['fd10f6dff11c74ab4b12229305ab78fb694d5ea9'],9,15,24,776874,3,1,1,1,2167
1d80f563bcd043cd464003782802906b60a0ade8,1,Ewen Cheslack-Postava,2016-02-03 11:28:58-08:00,['e8343e67e1ca74c4c0ebd994b9811b9fed7aa386'],459,512,971,777845,10,0,1,0,2167
79eacf6c95506d5d6819add5a1256681b13170b1,1,Ewen Cheslack-Postava,2016-02-03 11:31:32-08:00,['1d80f563bcd043cd464003782802906b60a0ade8'],24,155,179,778024,30,,,,2167
5b5869383832512d78e20183c855f83d30a5ab37,1,Gwen Shapira,2016-02-03 15:42:22-08:00,['79eacf6c95506d5d6819add5a1256681b13170b1'],2,37,39,778063,3,0.75862069,1,1,2167
d3ff902d6023eff257653a5dfb31f4e482204c44,1,Guozhang Wang,2016-02-03 20:42:43-08:00,['5b5869383832512d78e20183c855f83d30a5ab37'],9,11,20,778083,5,,,,2167
99956f56c9f994b4f55315559c07310b3d599d9b,0,Gwen Shapira,2016-02-03 23:48:17-08:00,['d3ff902d6023eff257653a5dfb31f4e482204c44'],1,1,2,778085,1,,,,2167
77683c3cb0eab8c85eb13d0e1397cf9ee32586b6,0,Guozhang Wang,2016-02-04 10:16:01-08:00,['99956f56c9f994b4f55315559c07310b3d599d9b'],2,3,5,778090,1,0,0,0,2167
f8598f96df3500cdea15a913d78de201469244b0,0,Ewen Cheslack-Postava,2016-02-04 11:11:41-08:00,['77683c3cb0eab8c85eb13d0e1397cf9ee32586b6'],0,5,5,778095,1,0,1,1,2167
287e45ab40ad744405ee2008b51caa7922f1b7b2,0,Ewen Cheslack-Postava,2016-02-04 13:49:01-08:00,['f8598f96df3500cdea15a913d78de201469244b0'],29,2,31,778126,3,,,,2167
0a7b20e2863b2519e63d85bc83610e63c58c6d46,1,Guozhang Wang,2016-02-04 14:14:08-08:00,['287e45ab40ad744405ee2008b51caa7922f1b7b2'],5,42,47,778173,1,0.75,0.791666667,1,2167
9b47f9a7f631ad4c84ab305126e71d74968cc967,1,Ewen Cheslack-Postava,2016-02-04 14:34:29-08:00,['0a7b20e2863b2519e63d85bc83610e63c58c6d46'],2,4,6,778179,1,0,1,1,2167
7802a90ed98ea5b9a2b2dcf2e04db1a50e34a2f8,1,Guozhang Wang,2016-02-04 14:51:10-08:00,['9b47f9a7f631ad4c84ab305126e71d74968cc967'],25,65,90,778269,10,0.933333333,1,0.8,2167
db8d6f02c092c42f2402b7e2587c1b28d330bf83,0,Joel Koshy,2016-02-04 16:08:21-08:00,['7802a90ed98ea5b9a2b2dcf2e04db1a50e34a2f8'],18,69,87,778356,4,0.416666667,0.944444444,1,2167
dc662776cde8e980a3f978041adaf961edf0fe7d,1,Ewen Cheslack-Postava,2016-02-04 18:00:45-08:00,['db8d6f02c092c42f2402b7e2587c1b28d330bf83'],0,95,95,778451,2,0.047619048,1,1,2168
216c75bbc567a633447b1cbf2bb8c6ba34e2464f,1,Guozhang Wang,2016-02-05 09:06:47-08:00,['dc662776cde8e980a3f978041adaf961edf0fe7d'],6,16,22,778473,1,1,0,1,2168
d6e36df8737aa2b898b4fd0a81c2d94f3c349b68,0,Guozhang Wang,2016-02-05 09:11:24-08:00,['216c75bbc567a633447b1cbf2bb8c6ba34e2464f'],2,4,6,778479,1,1,1,1,2168
40df94af5ca7df99cf384b52ea0090ba63048682,0,Ewen Cheslack-Postava,2016-02-05 10:41:03-08:00,['d6e36df8737aa2b898b4fd0a81c2d94f3c349b68'],14,14,28,778507,1,,,,2168
fa05ee727960257ec4b9aa92e1b46348a5450cf4,0,Ewen Cheslack-Postava,2016-02-05 12:58:14-08:00,['40df94af5ca7df99cf384b52ea0090ba63048682'],1,6,7,778514,2,1,1,1,2168
26efdede6c31904935c66de3bd979fa4edab624d,0,Ewen Cheslack-Postava,2016-02-05 13:15:57-08:00,['fa05ee727960257ec4b9aa92e1b46348a5450cf4'],1,15,16,778530,1,,,,2168
f292820920a3f1b1fc52c5eba0e23b024af9156f,0,Ewen Cheslack-Postava,2016-02-05 13:25:21-08:00,['26efdede6c31904935c66de3bd979fa4edab624d'],1,2,3,778533,1,,,,2168
1a539c74c115cbfeaebefee2298e846b4821132c,0,Ewen Cheslack-Postava,2016-02-05 14:58:45-08:00,['f292820920a3f1b1fc52c5eba0e23b024af9156f'],2,7,9,778542,1,,,,2168
4ee68b43c180d1f68648c0fb388a66b1ed0023e5,1,Guozhang Wang,2016-02-09 04:46:11+08:00,['1a539c74c115cbfeaebefee2298e846b4821132c'],10,26,36,778578,3,0.363636364,0,1,2168
d2fc6f36cc0b98d4d0acaa62ce3f2283c4e60581,1,Guozhang Wang,2016-02-09 05:00:38+08:00,['4ee68b43c180d1f68648c0fb388a66b1ed0023e5'],3,4,7,778585,2,1,1,1,2168
f7ad3d1b1fe24f3d33caf5f168d1292d4ae0b979,1,Ewen Cheslack-Postava,2016-02-08 16:35:05-08:00,['d2fc6f36cc0b98d4d0acaa62ce3f2283c4e60581'],2,123,125,778710,2,0.133333333,1,1,2169
feda3f68e98b5269431db9f2a5f131c03a16f651,1,Ewen Cheslack-Postava,2016-02-08 16:48:06-08:00,['f7ad3d1b1fe24f3d33caf5f168d1292d4ae0b979'],33,75,108,778818,3,0.9375,1,0.21875,2169
0eaede4dc95846e2b8f7452f41c58c0122e7a563,0,Ewen Cheslack-Postava,2016-02-08 16:56:59-08:00,['feda3f68e98b5269431db9f2a5f131c03a16f651'],2,29,31,778849,1,,,,2169
9cac38c0216879776b9eab728235e35118e9026e,1,Ewen Cheslack-Postava,2016-02-09 09:25:22-08:00,['0eaede4dc95846e2b8f7452f41c58c0122e7a563'],4,3,7,778856,1,0,0,0,2169
9f5a1f87667c23db557a712d51c45541372f3c5d,1,Ewen Cheslack-Postava,2016-02-09 09:49:32-08:00,['9cac38c0216879776b9eab728235e35118e9026e'],2,11,13,778869,2,1,1,0.375,2169
6352a30f46f2da11a8dc3e58912d0a2db8284c35,0,Ewen Cheslack-Postava,2016-02-09 10:02:20-08:00,['9f5a1f87667c23db557a712d51c45541372f3c5d'],0,1,1,778870,1,1,1,1,2169
cd15321e0d250253abb990af53e1f5624cf46b42,0,Ewen Cheslack-Postava,2016-02-09 10:16:57-08:00,['6352a30f46f2da11a8dc3e58912d0a2db8284c35'],14,48,62,778932,3,1,1,1,2169
4fd60c6120dc4330deb7317360c835b04bc6cb9a,0,Gwen Shapira,2016-02-09 10:33:39-08:00,['cd15321e0d250253abb990af53e1f5624cf46b42'],1,3,4,778936,1,,,,2169
b5e6b8671a5b6d97d5026261ae8d62b54f068e53,1,Ewen Cheslack-Postava,2016-02-09 13:22:46-08:00,['4fd60c6120dc4330deb7317360c835b04bc6cb9a'],5,182,187,779123,2,0,0.730496454,1,2169
6d0dca7345d9e3c0b8924496a4632954ca1268e5,1,Jun Rao,2016-02-09 16:57:53-06:00,['b5e6b8671a5b6d97d5026261ae8d62b54f068e53'],29,21,50,779173,3,0,1,0,2169
fe3b7492b73bf21ecb1a49e730dd30efd1e66693,1,Gwen Shapira,2016-02-09 21:48:56-07:00,['6d0dca7345d9e3c0b8924496a4632954ca1268e5'],10,29,39,779212,4,0,1,1,2169
d5b43b19bb06e9cdc606312c8bcf87ed267daf44,1,Gwen Shapira,2016-02-09 22:10:06-07:00,['fe3b7492b73bf21ecb1a49e730dd30efd1e66693'],19,1182,1201,780413,19,0.382882883,0.869369369,0.990990991,2177
1faab034b10a15beac2b90f8f2fe1c65a6b40765,1,Gwen Shapira,2016-02-10 12:50:57-07:00,['d5b43b19bb06e9cdc606312c8bcf87ed267daf44'],4,4,8,780421,2,,,,2177
c1f8f689af43f5ce5a95dad86537db4615449694,1,Gwen Shapira,2016-02-10 15:02:27-07:00,['1faab034b10a15beac2b90f8f2fe1c65a6b40765'],15,28,43,780464,1,0,0,1,2177
5092e7f8347d17d1b6e509424cbebf2406d8d4ba,0,Ewen Cheslack-Postava,2016-02-10 17:08:23-08:00,['c1f8f689af43f5ce5a95dad86537db4615449694'],17,21,38,780502,1,1,1,1,2177
67a7ea9d6744645dd4e08b6a78dd69704a4982b3,1,Ewen Cheslack-Postava,2016-02-10 22:01:56-08:00,['5092e7f8347d17d1b6e509424cbebf2406d8d4ba'],0,11,11,780513,1,1,1,1,2177
330274ed1c8efd2b1aa9907860429d9d20f72c3c,1,Gwen Shapira,2016-02-11 11:35:55-07:00,['67a7ea9d6744645dd4e08b6a78dd69704a4982b3'],23,29,52,780565,15,,,,2177
f141e647a4a3daf618b48073058320ecaa3671d0,1,Guozhang Wang,2016-02-12 17:11:12+08:00,['330274ed1c8efd2b1aa9907860429d9d20f72c3c'],9,23,32,780597,1,0,0.833333333,1,2177
85599bc3e861c77cd91c55273debe396da85deeb,1,Guozhang Wang,2016-02-12 17:15:41+08:00,['f141e647a4a3daf618b48073058320ecaa3671d0'],2,3,5,780602,1,1,1,1,2177
d7fc7cf6154592b7fea494a092e42ad9d45b98a0,1,Joel Koshy,2016-02-12 18:49:19-08:00,['85599bc3e861c77cd91c55273debe396da85deeb'],11,266,277,780879,7,0.570621469,0.740112994,0.915254237,2178
f355918ec7edd6cfa1c0d74902a21d32d3065997,1,Ewen Cheslack-Postava,2016-02-16 10:19:00-05:00,['d7fc7cf6154592b7fea494a092e42ad9d45b98a0'],9,9,18,780897,2,,,,2178
3ee1878d80aa6e3198731159d4479ac393489378,1,Ewen Cheslack-Postava,2016-02-16 15:23:24-05:00,['f355918ec7edd6cfa1c0d74902a21d32d3065997'],8,25,33,780930,3,,,,2178
5df56145a51c78e8808046254ad4771d60957ac5,1,Sriharsha Chintalapani,2016-02-16 18:25:00-08:00,['3ee1878d80aa6e3198731159d4479ac393489378'],287,95,382,781312,9,0.622222222,0.5,0,2178
2faf9f60c81023b4c061c4b8067c8b23cf73516e,1,Sriharsha Chintalapani,2016-02-16 20:34:59-08:00,['5df56145a51c78e8808046254ad4771d60957ac5'],102,40,142,781454,4,0.416666667,0.0625,0,2178
3382b6db7b2b9c17a4ccfd9ebe840741bcf44670,0,Guozhang Wang,2016-02-17 18:48:00+08:00,['2faf9f60c81023b4c061c4b8067c8b23cf73516e'],49,115,164,781618,7,0.486486486,0.486486486,1,2179
8c90b1a98acb1222a0e907153bf52a85af0fe443,1,Ewen Cheslack-Postava,2016-02-17 11:12:41-05:00,['3382b6db7b2b9c17a4ccfd9ebe840741bcf44670'],0,17,17,781635,2,0.692307692,0.846153846,1,2179
eee95228fabe1643baa016a2d49fb0a9fe2c66bd,1,Guozhang Wang,2016-02-18 09:39:30+08:00,['8c90b1a98acb1222a0e907153bf52a85af0fe443'],3,14,17,781652,1,1,1,1,2179
45c8195fa14c766b200c720f316836dbb84e9d8b,1,Jun Rao,2016-02-19 07:56:40-08:00,['eee95228fabe1643baa016a2d49fb0a9fe2c66bd'],723,2688,3411,785063,106,0.215328467,0.631386861,0.562043796,2181
5caa800e217c6b83f62ee3e6b5f02f56e331b309,0,Jun Rao,2016-02-19 09:41:37-08:00,['45c8195fa14c766b200c720f316836dbb84e9d8b'],0,1,1,785064,1,,,,2181
6ebb2363ba775c518e08e3c21c15f721e5f10841,0,Gwen Shapira,2016-02-21 22:52:50-08:00,['5caa800e217c6b83f62ee3e6b5f02f56e331b309'],0,4,4,785068,1,,,,2181
49fd0ceb09daf1d981d5a631342a8e3478db68ab,0,Gwen Shapira,2016-02-21 22:54:40-08:00,['6ebb2363ba775c518e08e3c21c15f721e5f10841'],2,3,5,785073,1,1,1,1,2181
d2527af99a9bb1007f7fe63a0cd7d27a55182857,1,Ewen Cheslack-Postava,2016-02-22 10:13:11-08:00,['49fd0ceb09daf1d981d5a631342a8e3478db68ab'],9,29,38,785111,2,1,1,1,2181
e3ab96b2f0b429e0fe5991a185cd980b0d490e25,1,Gwen Shapira,2016-02-22 11:40:33-08:00,['d2527af99a9bb1007f7fe63a0cd7d27a55182857'],24,21,45,785156,4,1,0,0,2181
46e4d40135d840a6d09e1f309e5c19ce7237b23a,1,Guozhang Wang,2016-02-22 13:03:24-08:00,['e3ab96b2f0b429e0fe5991a185cd980b0d490e25'],1,1,2,785158,1,,,,2181
ff7b0f5b467bdf553584fb253b00f460dfbe8943,1,Guozhang Wang,2016-02-22 13:16:06-08:00,['46e4d40135d840a6d09e1f309e5c19ce7237b23a'],63,71,134,785292,3,0.875,1,1,2181
d142f8294af67fea20d77dcc5272770af153c0d9,1,Jun Rao,2016-02-22 15:57:55-08:00,['ff7b0f5b467bdf553584fb253b00f460dfbe8943'],3,9,12,785304,1,1,0,0.4,2181
04585d99c6843a4253bae8ee958e360dd734d10e,0,Joel Koshy,2016-02-22 18:14:18-08:00,['d142f8294af67fea20d77dcc5272770af153c0d9'],20,3,23,785327,5,,,,2181
982ab09a790c6dbc2e1a5c52311103fd14ab5233,0,Guozhang Wang,2016-02-22 21:37:27-08:00,['04585d99c6843a4253bae8ee958e360dd734d10e'],12,16,28,785355,3,1,1,1,2181
68af16ac15e5675daebb710ed8f15f780dc43abd,1,Guozhang Wang,2016-02-22 21:39:26-08:00,['982ab09a790c6dbc2e1a5c52311103fd14ab5233'],0,5,5,785360,1,1,1,1,2181
3358e1682f034a82afd670be95505b2f620c78c6,1,Ewen Cheslack-Postava,2016-02-23 12:14:26-08:00,['68af16ac15e5675daebb710ed8f15f780dc43abd'],0,1343,1343,786703,11,0.247787611,0.733249052,0.618204804,2190
525f4c81db8f0dfd600b98f68cbb46e78bd76349,0,Gwen Shapira,2016-02-23 12:52:04-08:00,['3358e1682f034a82afd670be95505b2f620c78c6'],9,9,18,786721,1,,,,2190
878b78acb68d0fa62eb3c8f21d572664ca2bcdd0,1,Guozhang Wang,2016-02-23 14:54:06-08:00,['525f4c81db8f0dfd600b98f68cbb46e78bd76349'],174,242,416,787137,3,0.142857143,0.857142857,0,2191
f7fe9ccb466f85c417a545eb8acc4d61047c9f09,0,Guozhang Wang,2016-02-23 14:55:07-08:00,['878b78acb68d0fa62eb3c8f21d572664ca2bcdd0'],1,0,1,787138,1,0,0,0,2191
14b688e00ddb54a5c8451411d269721484be875f,0,Guozhang Wang,2016-02-23 15:03:55-08:00,['f7fe9ccb466f85c417a545eb8acc4d61047c9f09'],0,103,103,787241,3,0.604651163,1,1,2193
0ce9163989cb9898df7e74245cbc2ee37d729670,0,Gwen Shapira,2016-02-23 15:10:56-08:00,['14b688e00ddb54a5c8451411d269721484be875f'],24,54,78,787319,5,0.727272727,0.5,0.727272727,2193
c00a036e068ea5b33363992abc0499affa7ca2d7,0,Gwen Shapira,2016-02-23 15:33:29-08:00,['0ce9163989cb9898df7e74245cbc2ee37d729670'],0,50,50,787369,1,1,1,1,2194
73ecd7a1797a023039fea365a08dbdba4171d10b,1,Ewen Cheslack-Postava,2016-02-23 15:46:32-08:00,['c00a036e068ea5b33363992abc0499affa7ca2d7'],57,205,262,787631,6,0.235849057,1,0.5,2194
aeb9c2adcfe5fb99490fb15163ebcfd1d75d34c1,0,Gwen Shapira,2016-02-23 15:55:09-08:00,['73ecd7a1797a023039fea365a08dbdba4171d10b'],0,45,45,787676,2,,,,2194
f7d019ed408fa988129be9af3689bfa4878bc627,1,Ewen Cheslack-Postava,2016-02-23 22:47:31-08:00,['aeb9c2adcfe5fb99490fb15163ebcfd1d75d34c1'],298,2611,2909,790585,46,0.461604096,0.982935154,0.818259386,2207
b084c485e25bfe77154e805219b24714d59c396c,0,Ewen Cheslack-Postava,2016-02-24 09:21:38-08:00,['f7d019ed408fa988129be9af3689bfa4878bc627'],3,3,6,790591,3,,,,2207
f98cb3aa248b72ddacb2ce2ca6af5248365de366,0,Gwen Shapira,2016-02-24 10:12:51-08:00,['b084c485e25bfe77154e805219b24714d59c396c'],0,2,2,790593,1,,,,2207
1bfaddae9c7d8b40801a28c4806f61e647107c93,1,Ewen Cheslack-Postava,2016-02-24 11:07:34-08:00,['f98cb3aa248b72ddacb2ce2ca6af5248365de366'],1,5,6,790599,2,0,0,1,2207
01aeea7c7bca34f1edce40116b7721335938b13b,1,Jun Rao,2016-02-24 11:28:53-08:00,['1bfaddae9c7d8b40801a28c4806f61e647107c93'],529,575,1104,791703,37,0,1,0.833333333,2208
fa05752ccd9ee4996f252aa5ed71f10f28e80a52,1,Guozhang Wang,2016-02-24 13:41:46-08:00,['01aeea7c7bca34f1edce40116b7721335938b13b'],1,22,23,791726,1,1,1,1,2208
13b8fb295c3becc27e7954af623fe90b3062409e,1,Guozhang Wang,2016-02-24 18:11:36-08:00,['fa05752ccd9ee4996f252aa5ed71f10f28e80a52'],34,182,216,791942,11,0.2421875,0.578125,1,2208
5db2c99e15a4467489b495144815ac8334c2c5d4,1,Guozhang Wang,2016-02-24 19:41:57-08:00,['13b8fb295c3becc27e7954af623fe90b3062409e'],9,62,71,792013,4,1,1,1,2208
b3b533171caebdfaf9e7c0adc9e62ef0f7ab0ed3,1,Gwen Shapira,2016-02-25 13:59:17-08:00,['5db2c99e15a4467489b495144815ac8334c2c5d4'],5,7,12,792025,2,,,,2208
af1699bccbb725633f0b9deb666054a573da7667,0,Jun Rao,2016-02-25 17:53:19-08:00,['b3b533171caebdfaf9e7c0adc9e62ef0f7ab0ed3'],0,3,3,792028,1,0,1,1,2208
62945280a7fcfd69840a115fec16698bd8254323,0,Jun Rao,2016-02-25 18:08:20-08:00,['af1699bccbb725633f0b9deb666054a573da7667'],1,7,8,792036,1,0,0,0,2208
d51dd5fc7475ad29bea8616f77e1183a8fa9e000,0,Gwen Shapira,2016-02-25 18:24:51-08:00,['62945280a7fcfd69840a115fec16698bd8254323'],5,6,11,792047,1,,,,2208
4542b027c1ac361cc8770383b66abac2129a05e7,0,Ewen Cheslack-Postava,2016-02-26 10:37:41-08:00,['d51dd5fc7475ad29bea8616f77e1183a8fa9e000'],6,17,23,792070,2,0,0,1,2208
4e0ae79d5c9aec04c014aca55cd4823f89b933c8,0,Gwen Shapira,2016-02-26 13:40:39-08:00,['4542b027c1ac361cc8770383b66abac2129a05e7'],32,204,236,792306,13,0.775,0.9,0.4,2209
d4e60b9f59e04e82125b404f173c4fccc949d906,0,Guozhang Wang,2016-02-26 15:00:38-08:00,['4e0ae79d5c9aec04c014aca55cd4823f89b933c8'],6,9,15,792321,1,1,1,1,2209
92c35230f463e570de17239d8e76c7be5350c7d8,0,Sriharsha Chintalapani,2016-02-29 09:14:38-08:00,['d4e60b9f59e04e82125b404f173c4fccc949d906'],1,14,15,792336,1,0,0,0.333333333,2209
d501cc62ddcbbddcb114a40527d3e4f71f501286,1,Guozhang Wang,2016-02-29 12:46:03-08:00,['92c35230f463e570de17239d8e76c7be5350c7d8'],0,97,97,792433,7,0.560606061,1,1,2209
a7312971a06e3576720ac6d38978eb0a2a25f544,0,Guozhang Wang,2016-02-29 12:50:24-08:00,['d501cc62ddcbbddcb114a40527d3e4f71f501286'],0,1,1,792434,1,,,,2209
845c6eae1f6c6bcf117f5baa53bb19b4611c0528,1,Guozhang Wang,2016-02-29 14:03:32-08:00,['a7312971a06e3576720ac6d38978eb0a2a25f544'],339,875,1214,793648,28,0.240384615,0.850961538,0.745192308,2213
5da935ef78ecf4a671bddc632cfd36ef65bd6f6d,1,Guozhang Wang,2016-02-29 16:05:46-08:00,['845c6eae1f6c6bcf117f5baa53bb19b4611c0528'],22,16,38,793686,8,0.2,0,0.2,2213
74eff8a830ff6508ab98761a9e77d19d4e49a73e,1,Guozhang Wang,2016-02-29 16:10:25-08:00,['5da935ef78ecf4a671bddc632cfd36ef65bd6f6d'],22,17,39,793725,1,1,1,0.75,2213
695fdc69db6e080419bb05d624e91fa88d5c0a02,1,Jun Rao,2016-02-29 18:52:54-08:00,['74eff8a830ff6508ab98761a9e77d19d4e49a73e'],92,176,268,793993,8,1,1,1,2215
79662cc7cb139c33888148139f44fb4b1ac0fe56,0,Guozhang Wang,2016-03-01 16:27:45-08:00,['695fdc69db6e080419bb05d624e91fa88d5c0a02'],1,1,2,793995,1,,,,2215
edeb11bc561c0721855b34a4506dc7f1c76445c6,1,Ewen Cheslack-Postava,2016-03-01 18:53:58-08:00,['79662cc7cb139c33888148139f44fb4b1ac0fe56'],16,22,38,794033,11,,,,2215
23f239b06195c461a118962d45b6b02c3d89885c,0,Ewen Cheslack-Postava,2016-03-01 23:53:28-08:00,['edeb11bc561c0721855b34a4506dc7f1c76445c6'],0,1,1,794034,1,,,,2215
002b377dad9c956cd0ae0597981f29698883b6d5,1,Jun Rao,2016-03-02 09:40:34-08:00,['23f239b06195c461a118962d45b6b02c3d89885c'],114,251,365,794399,32,0.298850575,0.712643678,0.689655172,2215
2a58ba9fd893979f89aec251579b10f5cda41d10,1,Guozhang Wang,2016-03-02 13:43:48-08:00,['002b377dad9c956cd0ae0597981f29698883b6d5'],51,169,220,794619,5,0,0,0.6125,2215
f676cfeb83195f032e3ad8908288a7e04011c830,1,Guozhang Wang,2016-03-02 16:11:19-08:00,['2a58ba9fd893979f89aec251579b10f5cda41d10'],31,91,122,794741,21,,,,2215
cfc324333fa13e06ec7ac5ef3a09d8a6b6b54485,1,Gwen Shapira,2016-03-02 17:22:14-08:00,['f676cfeb83195f032e3ad8908288a7e04011c830'],9,13,22,794763,2,0,1,1,2215
fe1fd703e85a2acfd7209b38d15c428fcd77dc67,0,Gwen Shapira,2016-03-02 17:23:30-08:00,['cfc324333fa13e06ec7ac5ef3a09d8a6b6b54485'],1,1,2,794765,1,,,,2215
9cd65c46a71cb07276f23838aa55747efc32674c,1,Gwen Shapira,2016-03-02 18:22:28-08:00,['fe1fd703e85a2acfd7209b38d15c428fcd77dc67'],8,4,12,794777,1,1,1,0,2215
00a58f8e1e0c82c2948a8fdfacf812ec4865b339,1,Ewen Cheslack-Postava,2016-03-02 18:50:59-08:00,['9cd65c46a71cb07276f23838aa55747efc32674c'],4,16,20,794797,1,0,0.090909091,1,2215
b9eda22d71aa9896cac90798c7e888a04f14549d,0,Guozhang Wang,2016-03-02 23:42:17-08:00,['00a58f8e1e0c82c2948a8fdfacf812ec4865b339'],4,3,7,794804,1,,,,2215
10394aa80153db27e7672a949c91b436724b0ead,0,Ewen Cheslack-Postava,2016-03-03 02:53:12-08:00,['b9eda22d71aa9896cac90798c7e888a04f14549d'],14,16,30,794834,1,0,0,1,2215
079c88178dff4b3a4c9de55629e7d15b60e5f562,1,Ewen Cheslack-Postava,2016-03-03 08:54:37-08:00,['10394aa80153db27e7672a949c91b436724b0ead'],75,153,228,795062,21,0,1,1,2215
1d19ac9fea5b3344a0cdd00ee8c58ab8a22a5579,1,Guozhang Wang,2016-03-03 08:57:21-08:00,['079c88178dff4b3a4c9de55629e7d15b60e5f562'],18,17,35,795097,1,1,1,0,2215
0d49a542691ff5983e72e4c42ec1d356c6ce9268,1,Gwen Shapira,2016-03-03 11:43:09-08:00,['1d19ac9fea5b3344a0cdd00ee8c58ab8a22a5579'],1,132,133,795230,2,,,,2215
291f430d9c13227cc30a11939cc550057c583b20,1,Gwen Shapira,2016-03-03 11:46:16-08:00,['0d49a542691ff5983e72e4c42ec1d356c6ce9268'],6,6,12,795242,3,,,,2215
ae1fd085873c5119609df5120c02763c5ae48142,1,Gwen Shapira,2016-03-03 11:47:33-08:00,['291f430d9c13227cc30a11939cc550057c583b20'],2,2,4,795246,1,,,,2215
c8b6c18f68b9efbbd5e349885d301c47baabcd98,0,Jun Rao,2016-03-03 13:41:17-08:00,['ae1fd085873c5119609df5120c02763c5ae48142'],0,2,2,795248,1,,,,2215
7079f57f70dfb5e731baf0a19bbf16e7364c15bb,1,Gwen Shapira,2016-03-03 14:58:43-08:00,['c8b6c18f68b9efbbd5e349885d301c47baabcd98'],8,8,16,795264,2,,,,2215
f25fe02d994a663b6a5a0d01ea290785d63e1e52,1,Gwen Shapira,2016-03-03 15:10:16-08:00,['7079f57f70dfb5e731baf0a19bbf16e7364c15bb'],3,26,29,795293,3,,,,2215
5d893654489647e8be65c4d54864ab63b7285faa,1,Jun Rao,2016-03-03 16:16:56-08:00,['f25fe02d994a663b6a5a0d01ea290785d63e1e52'],9,54,63,795356,2,0.424242424,1,1,2215
d63bdc28cad57bb1cb38598c4ec5c0ef27113a8c,1,Gwen Shapira,2016-03-03 17:34:38-08:00,['5d893654489647e8be65c4d54864ab63b7285faa'],1,3,4,795360,1,,,,2215
f7887bd6f9db578a5a3ee04606bb4f3a74528eb8,1,Gwen Shapira,2016-03-03 17:41:47-08:00,['d63bdc28cad57bb1cb38598c4ec5c0ef27113a8c'],2,18,20,795380,2,,,,2215
6d65edebae5a834fe58d4a29b74267eb34bec065,1,Gwen Shapira,2016-03-04 10:28:55-08:00,['f7887bd6f9db578a5a3ee04606bb4f3a74528eb8'],1,2,3,795383,1,,,,2215
b7d6fae59ed782833981675efa0304ce2b12a59e,1,Ewen Cheslack-Postava,2016-03-04 14:21:22-08:00,['6d65edebae5a834fe58d4a29b74267eb34bec065'],13,25,38,795421,3,0.375,0.75,0.875,2215
33f33075468f53bf6d4d1bd79fdb64443ca30dfa,0,Guozhang Wang,2016-03-05 15:17:21-08:00,['b7d6fae59ed782833981675efa0304ce2b12a59e'],2,27,29,795450,1,0,1,0,2215
25bde48e6a43b0a2c1c9430eb560b43e160ae3ea,0,Gwen Shapira,2016-03-07 11:28:41-08:00,['33f33075468f53bf6d4d1bd79fdb64443ca30dfa'],1,3,4,795454,1,,,,2215
5761a9ec7285cae9167fcb10f0e800e2a048511a,0,Gwen Shapira,2016-03-07 11:32:34-08:00,['25bde48e6a43b0a2c1c9430eb560b43e160ae3ea'],7,1,8,795462,1,,,,2215
94c234341907b705ec34dd2b390899435286e242,1,Gwen Shapira,2016-03-07 11:34:12-08:00,['5761a9ec7285cae9167fcb10f0e800e2a048511a'],15,57,72,795534,5,0.866666667,0.866666667,0.866666667,2216
33fcaad26ed2b48dcc3a41c1c71d95eeb3779168,1,Gwen Shapira,2016-03-07 18:24:16-08:00,['94c234341907b705ec34dd2b390899435286e242'],22,22,44,795578,5,,,,2216
2fed0c62db0dac5a43c2bd29555f09010bfc74ec,1,Gwen Shapira,2016-03-07 18:30:01-08:00,['33fcaad26ed2b48dcc3a41c1c71d95eeb3779168'],3,31,34,795612,2,0,0,0,2216
8d0c298c8c3283a7f8cffc4f68b3af87b0588e07,1,Gwen Shapira,2016-03-07 18:33:52-08:00,['2fed0c62db0dac5a43c2bd29555f09010bfc74ec'],176,181,357,795969,6,0,0,1,2216
f6e35dec9bf330c3531fd95c6566070d4ddf0457,1,Ewen Cheslack-Postava,2016-03-07 23:18:17-08:00,['8d0c298c8c3283a7f8cffc4f68b3af87b0588e07'],28,65,93,796062,7,0,1,0,2216
5afa1660103df8aecbf7558e761418944fb5905a,1,Joel Koshy,2016-03-08 14:06:53-08:00,['f6e35dec9bf330c3531fd95c6566070d4ddf0457'],36,156,192,796254,6,0.073170732,0.829268293,0.865853659,2216
c4282371d954d7ae6decd32252d85f0d2a254e8c,1,Jun Rao,2016-03-08 18:34:07-06:00,['5afa1660103df8aecbf7558e761418944fb5905a'],10,14,24,796278,1,0.5,1,0.75,2216
39f1c3ff83879e3d00ea4567db15181c746deba2,0,Guozhang Wang,2016-03-08 21:40:40-08:00,['c4282371d954d7ae6decd32252d85f0d2a254e8c'],2,6,8,796286,2,,,,2216
090d7220e2c0c4c8a39c388043c6032386ea024f,1,Ewen Cheslack-Postava,2016-03-08 21:56:33-08:00,['39f1c3ff83879e3d00ea4567db15181c746deba2'],2,15,17,796303,2,1,1,1,2216
689309135b3d75c2c6e7b215aca2e8d42b435877,1,Ewen Cheslack-Postava,2016-03-08 22:53:34-08:00,['090d7220e2c0c4c8a39c388043c6032386ea024f'],25,37,62,796365,1,,,,2216
324b0c85f603005dceee69033b8fbffc7ef95281,0,Ewen Cheslack-Postava,2016-03-08 23:40:09-08:00,['689309135b3d75c2c6e7b215aca2e8d42b435877'],23,18,41,796406,3,0,1,0,2216
59d19cf3e9dce777e5c7bb333c0836adf9da80e1,0,Ewen Cheslack-Postava,2016-03-09 09:24:18-08:00,['324b0c85f603005dceee69033b8fbffc7ef95281'],1,1,2,796408,1,,,,2216
818080312364940e4a6e964c22ec54e133b8ec02,1,Gwen Shapira,2016-03-09 14:19:57-08:00,['59d19cf3e9dce777e5c7bb333c0836adf9da80e1'],4,46,50,796458,3,1,1,1,2217
ee9995583ad74277464d3e9cb669a7c96c07f70b,0,Gwen Shapira,2016-03-09 17:57:24-08:00,['818080312364940e4a6e964c22ec54e133b8ec02'],3,3,6,796464,2,,,,2217
f0a4125d3edf4ff28399584e7800addc026f5d08,1,Gwen Shapira,2016-03-09 21:13:54-08:00,['ee9995583ad74277464d3e9cb669a7c96c07f70b'],16,435,451,796915,8,0.180904523,0.522613065,0.804020101,2218
df41bc544aea91fd1e2d5258ebf1b99347700731,0,Gwen Shapira,2016-03-09 21:55:05-08:00,['f0a4125d3edf4ff28399584e7800addc026f5d08'],3,3,6,796921,1,,,,2218
83f714bae11f9bca0f1cedb8a68e73a1dd637ade,0,Ewen Cheslack-Postava,2016-03-09 23:55:22-08:00,['df41bc544aea91fd1e2d5258ebf1b99347700731'],66,0,66,796987,1,,,,2218
1a451b4812ae2502bb6bc105e77eb00175a76ec5,0,Gwen Shapira,2016-03-10 10:44:58-08:00,['83f714bae11f9bca0f1cedb8a68e73a1dd637ade'],1,20,21,797008,1,,,,2218
6eb061fa85de1b5346eb2652622c9c60f7f3baf1,1,Ewen Cheslack-Postava,2016-03-10 11:12:07-08:00,['1a451b4812ae2502bb6bc105e77eb00175a76ec5'],2,3,5,797013,2,,,,2218
e403b3c4bf8ca308fe180b093da20700f4db73c5,1,Gwen Shapira,2016-03-10 11:29:08-08:00,['6eb061fa85de1b5346eb2652622c9c60f7f3baf1'],104,115,219,797232,5,0.833333333,1,0.833333333,2218
04ef9c35479f5cf92df3b74a7379ce77dc809243,0,Gwen Shapira,2016-03-10 12:13:04-08:00,['e403b3c4bf8ca308fe180b093da20700f4db73c5'],1,1,2,797234,1,,,,2218
9c4c5ae1cd15aa0afe3156e572362fbb40130573,1,Ewen Cheslack-Postava,2016-03-10 14:54:47-08:00,['04ef9c35479f5cf92df3b74a7379ce77dc809243'],5,80,85,797319,3,0.38,1,1,2218
287cce251f7d5471946d550031147aaab4e7ca26,0,Guozhang Wang,2016-03-11 10:56:21-08:00,['9c4c5ae1cd15aa0afe3156e572362fbb40130573'],1,1,2,797321,1,,,,2218
764d8ca9eb0aba6099ba289a10f437e72b53ffec,1,Gwen Shapira,2016-03-11 11:11:59-08:00,['287cce251f7d5471946d550031147aaab4e7ca26'],393,699,1092,798413,22,0.396984925,1,0.984924623,2219
02d4da5f64989b41358cdfd94d95b94fb4e20198,1,Joel Koshy,2016-03-11 11:22:15-08:00,['764d8ca9eb0aba6099ba289a10f437e72b53ffec'],17,100,117,798530,2,0.151515152,0.924242424,0.924242424,2219
a162f6bf66d0d21505c8d11942f84be446616491,1,Gwen Shapira,2016-03-11 12:17:45-08:00,['02d4da5f64989b41358cdfd94d95b94fb4e20198'],1,110,111,798641,2,1,1,0.607843137,2220
c9311d5f4ec3b135cb6c0f87008da946863daaa2,1,Guozhang Wang,2016-03-11 17:53:32-08:00,['a162f6bf66d0d21505c8d11942f84be446616491'],1,1,2,798643,1,,,,2220
ac7b2e95d342972e3499d203bc23e1675e90c591,0,Sriharsha Chintalapani,2016-03-13 20:32:47-07:00,['c9311d5f4ec3b135cb6c0f87008da946863daaa2'],1,1,2,798645,1,,,,2220
c1a56c6839e77f3de5266315a92b236a379ec857,1,Guozhang Wang,2016-03-14 14:50:24-07:00,['ac7b2e95d342972e3499d203bc23e1675e90c591'],56,84,140,798785,12,0.586206897,0.551724138,1,2220
cf40acc2b17cf6d32cee712dad6c88a851ae0715,1,Guozhang Wang,2016-03-14 15:09:47-07:00,['c1a56c6839e77f3de5266315a92b236a379ec857'],15,3,18,798803,3,0,0,0,2220
ffbe624e6f4906c55080508fab19ac60dc93761e,1,Gwen Shapira,2016-03-14 19:13:26-07:00,['cf40acc2b17cf6d32cee712dad6c88a851ae0715'],47,48,95,798898,9,1,0,0,2220
241c3ebb2803f1e09306fb06f20a66e7a60ca3c8,1,Gwen Shapira,2016-03-14 19:14:36-07:00,['ffbe624e6f4906c55080508fab19ac60dc93761e'],16,56,72,798970,28,0,0.5,1,2220
deb2b004cb983baa9e2fbff47b39a6f9a243623d,0,Gwen Shapira,2016-03-14 19:22:05-07:00,['241c3ebb2803f1e09306fb06f20a66e7a60ca3c8'],1,1,2,798972,1,,,,2220
951e30adc6d4a0ed37dcc3fde0050ca5faff146d,1,Jun Rao,2016-03-15 10:03:03-07:00,['deb2b004cb983baa9e2fbff47b39a6f9a243623d'],250,1000,1250,800222,27,0.282178218,0.596534653,0.621287129,2226
355076cd262dd071287a1c8586ae0f9635e218e3,0,Guozhang Wang,2016-03-15 12:08:26-07:00,['951e30adc6d4a0ed37dcc3fde0050ca5faff146d'],36,22,58,800280,8,1,0,0.769230769,2226
90c623d10f1c081e41f151eb28524f0fb57609c7,1,Guozhang Wang,2016-03-15 12:15:15-07:00,['355076cd262dd071287a1c8586ae0f9635e218e3'],21,34,55,800335,1,1,1,1,2226
fd6efbe0b7f18beb506f112350b30b7209a2f5cc,0,Ewen Cheslack-Postava,2016-03-15 13:37:33-07:00,['90c623d10f1c081e41f151eb28524f0fb57609c7'],1,0,1,800336,1,,,,2226
6eacc0de303e4d29e083b89c1f53615c1dfa291e,0,Ewen Cheslack-Postava,2016-03-15 14:32:22-07:00,['fd6efbe0b7f18beb506f112350b30b7209a2f5cc'],0,42,42,800378,3,0.761904762,0.952380952,1,2226
6834b91e349f2ed4b8ff5c97eb3b0c390bc27648,0,Ewen Cheslack-Postava,2016-03-16 08:24:18-07:00,['6eacc0de303e4d29e083b89c1f53615c1dfa291e'],17,8,25,800403,1,0,0,0,2226
b0f811804fb818792dfc55298bd11eacd19dec5c,0,Ewen Cheslack-Postava,2016-03-16 08:47:38-07:00,['6834b91e349f2ed4b8ff5c97eb3b0c390bc27648'],102,0,102,800505,1,0.42,0,0,2226
cd8bd606cbf63f37eaee448ffbbab01ce3e0e7db,0,Gwen Shapira,2016-03-16 15:07:37-07:00,['b0f811804fb818792dfc55298bd11eacd19dec5c'],1,1,2,800507,1,,,,2226
858047a12ba3a7d426178c63226dd2c7509f20dd,1,Gwen Shapira,2016-03-16 16:15:55-07:00,['cd8bd606cbf63f37eaee448ffbbab01ce3e0e7db'],27,72,99,800606,3,0.235294118,1,1,2226
9a836d0154efe6ea1effc688567186cb56265bf4,1,Jun Rao,2016-03-16 17:29:29-07:00,['858047a12ba3a7d426178c63226dd2c7509f20dd'],17,138,155,800761,7,0.253333333,0.533333333,0.68,2226
958e10c87ce293c3bf59bb9840eaaae915eff25e,1,Guozhang Wang,2016-03-17 10:41:48-07:00,['9a836d0154efe6ea1effc688567186cb56265bf4'],181,163,344,801105,30,1,0,0,2226
dce06766da245ca95951c9c7e82d6a113db7cb13,0,Guozhang Wang,2016-03-17 10:52:33-07:00,['958e10c87ce293c3bf59bb9840eaaae915eff25e'],1,59,60,801165,2,0,1,1,2227
30e78fa00650b258f3ab5ef6c9bdf5ca137289c0,1,Gwen Shapira,2016-03-17 12:33:47-07:00,['dce06766da245ca95951c9c7e82d6a113db7cb13'],73,135,208,801373,19,0.722222222,0.888888889,0,2228
a1eb12d7c6ad9422b9cf24b670d1b4c11227b03e,1,Gwen Shapira,2016-03-17 13:17:01-07:00,['30e78fa00650b258f3ab5ef6c9bdf5ca137289c0'],1,79,80,801453,2,0.322580645,1,0.322580645,2229
c07d017227f319250e5c373f8a6f504874ecfbf2,1,Ewen Cheslack-Postava,2016-03-17 13:26:02-07:00,['a1eb12d7c6ad9422b9cf24b670d1b4c11227b03e'],114,1836,1950,803403,30,0.553140097,0.787439614,0.751207729,2237
8ef804dc194bb562b6dbe48855e81965cacd1114,1,Gwen Shapira,2016-03-17 13:56:27-07:00,['c07d017227f319250e5c373f8a6f504874ecfbf2'],1,29,30,803433,2,1,1,1,2237
3f28d77449bd3280f53edab81657e6c2a37f3c3e,1,Gwen Shapira,2016-03-17 13:59:56-07:00,['8ef804dc194bb562b6dbe48855e81965cacd1114'],17,17,34,803467,4,,,,2237
61281f5c53ebe130defa881f32084c581cf16d43,1,Gwen Shapira,2016-03-17 14:14:12-07:00,['3f28d77449bd3280f53edab81657e6c2a37f3c3e'],0,11,11,803478,1,,,,2237
579d473ce9c5ef1a442af734e362dd545e5ab988,1,Jun Rao,2016-03-17 15:21:20-07:00,['61281f5c53ebe130defa881f32084c581cf16d43'],2,25,27,803505,3,0.058823529,0.882352941,0.235294118,2237
f57dabbe56b3db40c06a1946d4cecd0a144b6ac4,1,Gwen Shapira,2016-03-17 15:37:37-07:00,['579d473ce9c5ef1a442af734e362dd545e5ab988'],2,107,109,803614,3,0.666666667,1,0.208333333,2238
dea0719e99211684775780f5da8b93835d7a5dac,1,Guozhang Wang,2016-03-17 15:41:59-07:00,['f57dabbe56b3db40c06a1946d4cecd0a144b6ac4'],1315,1184,2499,806113,76,1,0,1,2243
e89a9ce1a4383af32435c7f4ee04361b1b65797d,1,Gwen Shapira,2016-03-17 18:12:40-07:00,['dea0719e99211684775780f5da8b93835d7a5dac'],147,263,410,806523,46,0,0.5,1,2243
0d8cbbcb208ccaf1cb84df0440331d4cef064391,0,Ewen Cheslack-Postava,2016-03-18 12:01:56-07:00,['e89a9ce1a4383af32435c7f4ee04361b1b65797d'],0,0,0,806523,3,,,,2243
5d0cd7667f7e584f05ab4e76ed139fbafa81e042,1,Guozhang Wang,2016-03-18 12:39:41-07:00,['0d8cbbcb208ccaf1cb84df0440331d4cef064391'],232,584,816,807339,26,0.705882353,1,0.164705882,2244
d9bf55171ba41962edc05cdf106f540cf94a2c3e,1,Jun Rao,2016-03-18 13:37:33-07:00,['5d0cd7667f7e584f05ab4e76ed139fbafa81e042'],13,33,46,807385,6,0.736842105,0.947368421,1,2244
07360cb0d24b18f6f7c8a35d437c7cb2b0142506,0,Guozhang Wang,2016-03-18 13:43:13-07:00,['d9bf55171ba41962edc05cdf106f540cf94a2c3e'],0,1,1,807386,1,0,0,1,2244
4332175c11dda5deb491f27a6ecf66661676ca47,1,Gwen Shapira,2016-03-18 16:07:20-07:00,['07360cb0d24b18f6f7c8a35d437c7cb2b0142506'],141,156,297,807683,23,0.666666667,0.333333333,0,2244
b6c6291e1f42b2ca1fbcdaf662a2a868c8881921,1,Gwen Shapira,2016-03-18 16:13:33-07:00,['4332175c11dda5deb491f27a6ecf66661676ca47'],82,101,183,807866,5,0,0.083333333,0.416666667,2244
655367971875a8d6a079ff7d186c05a6b76a9c53,0,Gwen Shapira,2016-03-19 18:04:56-07:00,['b6c6291e1f42b2ca1fbcdaf662a2a868c8881921'],1,2,3,807869,1,1,1,0,2244
eb823281a52f3b27c3a889e7412bc07b3024e688,1,Gwen Shapira,2016-03-19 18:39:52-07:00,['655367971875a8d6a079ff7d186c05a6b76a9c53'],1,177,178,808047,5,0.329545455,0.727272727,0.409090909,2245
bfac36ad0e378b5f39e3889e40a75c5c1fc48fa7,1,Gwen Shapira,2016-03-20 00:46:12-07:00,['eb823281a52f3b27c3a889e7412bc07b3024e688'],86,318,404,808451,4,0.26875,0.55,0.89375,2245
c188a68e2b487191f1f3004e22b68c21e26c3f2e,1,Ewen Cheslack-Postava,2016-03-20 16:46:42-07:00,['bfac36ad0e378b5f39e3889e40a75c5c1fc48fa7'],10,258,268,808719,5,,,,2246
95eabc8c8b383af84466d4c2cfafd0920e5a52ee,1,Jun Rao,2016-03-20 19:58:31-07:00,['c188a68e2b487191f1f3004e22b68c21e26c3f2e'],5,5,10,808729,1,,,,2246
4f048c4f194a90ded5f0df35e4e23379272d5bc6,0,Jun Rao,2016-03-20 20:19:54-07:00,['95eabc8c8b383af84466d4c2cfafd0920e5a52ee'],4,7,11,808740,2,0,1,1,2246
702d560c555bf7121eca02010adedd4986e36b87,0,Gwen Shapira,2016-03-21 09:53:17-07:00,['4f048c4f194a90ded5f0df35e4e23379272d5bc6'],1,1,2,808742,1,,,,2246
b6c29e3810bd59f39fa93c429817396cf8c324b7,1,Guozhang Wang,2016-03-21 12:06:07-07:00,['702d560c555bf7121eca02010adedd4986e36b87'],285,303,588,809330,19,,,,2246
69df734470f1db9ba1732cb4bedaa1541d721103,0,Ewen Cheslack-Postava,2016-03-21 13:15:53-07:00,['b6c29e3810bd59f39fa93c429817396cf8c324b7'],2,2,4,809334,1,,,,2246
4f0417931a71a974241e685031f2a5f1680e9b51,0,Ewen Cheslack-Postava,2016-03-21 13:40:59-07:00,['69df734470f1db9ba1732cb4bedaa1541d721103'],2,2,4,809338,2,,,,2246
8d8e3aaa6172d314230a8d61e6892e9c09dc45b6,1,Ewen Cheslack-Postava,2016-03-21 20:47:25-07:00,['4f0417931a71a974241e685031f2a5f1680e9b51'],19,39,58,809396,6,1,1,1,2246
99cfb99aa161007f2ceae33945d11b968d932175,0,Gwen Shapira,2016-03-22 11:53:12-07:00,['8d8e3aaa6172d314230a8d61e6892e9c09dc45b6'],9,7,16,809412,2,,,,2246
73470b028cd659c1c405e6b6ba52bf483113b90b,1,Gwen Shapira,2016-03-22 11:58:01-07:00,['99cfb99aa161007f2ceae33945d11b968d932175'],22,28,50,809462,2,,,,2246
73c79000edddd929cd0af25f4a29fcc682a1c9c0,0,Gwen Shapira,2016-03-22 12:39:04-07:00,['73470b028cd659c1c405e6b6ba52bf483113b90b'],5,112,117,809579,3,0.454545455,0.954545455,1,2246
ca77d67058726fc9df9bdd7cc0217ee62ccc5106,0,Guozhang Wang,2016-03-22 13:09:13-07:00,['73c79000edddd929cd0af25f4a29fcc682a1c9c0'],7,16,23,809602,3,,,,2246
ad3dfc6ab25c3f80d2425e24e72ae732b850dc60,0,Gwen Shapira,2016-03-22 13:10:07-07:00,['ca77d67058726fc9df9bdd7cc0217ee62ccc5106'],2,5,7,809609,3,0,0,1,2246
d6b450ced57bb5ab8a7164358e6a360f97a7b5cc,0,Gwen Shapira,2016-03-22 14:09:10-07:00,['ad3dfc6ab25c3f80d2425e24e72ae732b850dc60'],2,0,2,809611,2,,,,2246
983e9486ef139f8c9797679732d09feb3f7bfb87,0,Jun Rao,2016-03-22 15:01:05-07:00,['d6b450ced57bb5ab8a7164358e6a360f97a7b5cc'],1,1,2,809613,1,,,,2246
adca4d7df3155ac29ae510c237adf06c9521d221,1,Jun Rao,2016-03-22 18:20:07-07:00,['983e9486ef139f8c9797679732d09feb3f7bfb87'],14,12,26,809639,1,1,0,0,2246
255b5e13863a95cfc327236856db2df188f04d49,1,Gwen Shapira,2016-03-22 19:13:26-07:00,['adca4d7df3155ac29ae510c237adf06c9521d221'],131,38,169,809808,9,0.472727273,0.418181818,0.090909091,2246
7af67ce22aa02121d6b82dc54dad42358282e524,0,Jun Rao,2016-03-23 07:15:59-07:00,['255b5e13863a95cfc327236856db2df188f04d49'],13,32,45,809853,2,0.75,1,1,2246
20c313526a0518a51142d3abc5ee2a4d2ef3cb34,1,Guozhang Wang,2016-03-23 09:47:48-07:00,['7af67ce22aa02121d6b82dc54dad42358282e524'],7,17,24,809877,1,0,0.714285714,1,2246
d57847641037823a7306f53251b063869f7affb6,0,Gwen Shapira,2016-03-23 12:54:26-07:00,['20c313526a0518a51142d3abc5ee2a4d2ef3cb34'],7,7,14,809891,2,,,,2246
d4d5920ed40736d21f056188efa8a86c93e22506,1,Guozhang Wang,2016-03-23 13:53:37-07:00,['d57847641037823a7306f53251b063869f7affb6'],35,17,52,809943,2,1,1,0,2246
80d78f81470f109dc6d221f755b039c7332bb93b,0,Guozhang Wang,2016-03-23 14:25:08-07:00,['d4d5920ed40736d21f056188efa8a86c93e22506'],2,2,4,809947,1,,,,2246
de062443381df84ee0d65acc20e44ffca2b2552b,0,Guozhang Wang,2016-03-23 14:57:03-07:00,['80d78f81470f109dc6d221f755b039c7332bb93b'],24,2,26,809973,2,1,1,1,2246
cb78223bf90aca4f75699f36c1a82db7661a62f3,0,Ewen Cheslack-Postava,2016-03-23 22:36:19-07:00,['de062443381df84ee0d65acc20e44ffca2b2552b'],2,79,81,810054,3,0.307692308,1,0.692307692,2247
419e268d6fe9695e31e9be299c99573522a81dd0,0,Ewen Cheslack-Postava,2016-03-24 10:12:19-07:00,['cb78223bf90aca4f75699f36c1a82db7661a62f3'],1,5,6,810060,1,,,,2247
2dc17230f90be60c6c08061600fdf79c8e5f5b52,0,Ewen Cheslack-Postava,2016-03-24 11:03:30-07:00,['419e268d6fe9695e31e9be299c99573522a81dd0'],2,2,4,810064,1,,,,2247
d3a66a65365579e9320347663969b30c1148e497,0,Gwen Shapira,2016-03-25 10:07:05-07:00,['2dc17230f90be60c6c08061600fdf79c8e5f5b52'],487,1,488,810552,2,0.688963211,0.525083612,0.090301003,2247
d691faf98cb573c4e92748d95d5c8afc492db806,0,Gwen Shapira,2016-03-25 12:51:54-07:00,['d3a66a65365579e9320347663969b30c1148e497'],2,8,10,810562,2,,,,2247
c1d8c38345e0a1e04ced143ed07e63fe02ceb8b0,1,Guozhang Wang,2016-03-25 15:00:45-07:00,['d691faf98cb573c4e92748d95d5c8afc492db806'],17,17,34,810596,9,,,,2247
23b50093f4100ce7fbff325cdc92ee6cf3c54102,1,Gwen Shapira,2016-03-25 16:04:58-07:00,['c1d8c38345e0a1e04ced143ed07e63fe02ceb8b0'],74,546,620,811216,11,,,,2248
78fa20eb58a948abd9ad4e44acfed606400a47f3,1,Ewen Cheslack-Postava,2016-03-25 16:46:53-07:00,['23b50093f4100ce7fbff325cdc92ee6cf3c54102'],3,116,119,811335,5,0.666666667,1,1,2249
1fbe445dde71df0023a978c5e54dd229d3d23e1b,1,Jun Rao,2016-03-26 09:22:59-07:00,['78fa20eb58a948abd9ad4e44acfed606400a47f3'],27,94,121,811456,3,0.125,0.575,0.8,2249
4c0660bf3da9879cb405a0f85cf1524511e091e8,0,Jun Rao,2016-03-28 09:00:03-07:00,['1fbe445dde71df0023a978c5e54dd229d3d23e1b'],5,5,10,811466,1,,,,2249
43d5078e981bbb25fd81cdc8ba4c339cd2d3f3d2,1,Guozhang Wang,2016-03-28 14:35:31-07:00,['4c0660bf3da9879cb405a0f85cf1524511e091e8'],111,86,197,811663,29,0,0,0,2249
5089f547d5d64a0235e1b4adc327a0cb05eb4ca8,1,Guozhang Wang,2016-03-29 13:30:56-07:00,['43d5078e981bbb25fd81cdc8ba4c339cd2d3f3d2'],11,16,27,811690,1,1,1,1,2249
27583953528138ff3503fb8f300c97971718e48a,0,Guozhang Wang,2016-03-29 14:18:57-07:00,['5089f547d5d64a0235e1b4adc327a0cb05eb4ca8'],1,5,6,811696,1,,,,2249
aaafd23df800d41e4b16fd399015991b2e426dc5,1,Ewen Cheslack-Postava,2016-03-30 00:50:29-07:00,['27583953528138ff3503fb8f300c97971718e48a'],1,1,2,811698,1,,,,2249
2788f2dc73dd62c35c87842d02d23a0ed6a62e97,1,Guozhang Wang,2016-03-30 14:26:01-07:00,['aaafd23df800d41e4b16fd399015991b2e426dc5'],2,415,417,812115,2,0.124513619,1,0.556420233,2250
78d91dcd8805d850038df52718380a6f956abad7,1,Gwen Shapira,2016-03-30 19:30:34-07:00,['2788f2dc73dd62c35c87842d02d23a0ed6a62e97'],26,557,583,812698,10,0.412556054,0.905829596,0.874439462,2253
9f6a6f97134a1d4969c91c4b4e9037b376e03440,1,Gwen Shapira,2016-03-30 19:33:37-07:00,['78d91dcd8805d850038df52718380a6f956abad7'],0,144,144,812842,2,1,1,0.770491803,2255
623ab1e7c6497c000bc9c9978637f20542a3191c,1,Gwen Shapira,2016-03-31 10:07:54-07:00,['9f6a6f97134a1d4969c91c4b4e9037b376e03440'],5,71,76,812918,4,0,0,0,2255
77142f6baeb35e6de9608a7372113f72ea330936,0,Ewen Cheslack-Postava,2016-04-01 10:52:26-07:00,['623ab1e7c6497c000bc9c9978637f20542a3191c'],1,12,13,812931,3,1,1,0,2255
ae939467e8aec38f47e2474e74e7ab7ea29c2840,1,Gwen Shapira,2016-04-01 13:14:47-07:00,['77142f6baeb35e6de9608a7372113f72ea330936'],0,20,20,812951,4,0,0,1,2255
b865413cd8b71f905ad4ee695f193dcf91ee0595,1,Gwen Shapira,2016-04-01 13:56:11-07:00,['ae939467e8aec38f47e2474e74e7ab7ea29c2840'],3,3,6,812957,1,,,,2255
a4d6f1dce5b1d3f45505d732ad3dc9bcb92bfd98,1,Gwen Shapira,2016-04-01 14:12:49-07:00,['b865413cd8b71f905ad4ee695f193dcf91ee0595'],0,6,6,812963,1,0,0,1,2255
89fd97f8c934b99b1ad994e36435e0686ef7b85a,1,Gwen Shapira,2016-04-01 15:25:35-07:00,['a4d6f1dce5b1d3f45505d732ad3dc9bcb92bfd98'],215,217,432,813395,7,0.869565217,0.782608696,0.260869565,2256
75ec67eda833e3da2b5925d11ab043d1ef4be9ba,0,Gwen Shapira,2016-04-01 15:57:39-07:00,['89fd97f8c934b99b1ad994e36435e0686ef7b85a'],6,6,12,813407,1,,,,2256
bd5325dd8be7c5cf920acee2aa33b3c288bd551a,1,Guozhang Wang,2016-04-01 17:14:29-07:00,['75ec67eda833e3da2b5925d11ab043d1ef4be9ba'],29,24,53,813460,3,1,1,0,2256
dd5480a47eb0f45214c179b7f14ffaf493164222,1,Ewen Cheslack-Postava,2016-04-02 23:02:19-07:00,['bd5325dd8be7c5cf920acee2aa33b3c288bd551a'],42,134,176,813636,2,0,1,0.868852459,2256
ef3f053155c73af053a36a2e50047c5a49cd30bf,0,Guozhang Wang,2016-04-03 13:44:05-07:00,['dd5480a47eb0f45214c179b7f14ffaf493164222'],20,21,41,813677,1,,,,2256
b94a7812beeb840926871df84838f35ca7b76ffe,1,Jun Rao,2016-04-03 16:34:46-07:00,['ef3f053155c73af053a36a2e50047c5a49cd30bf'],45,40,85,813762,5,0.857142857,0.571428571,0,2256
3a20ba305517ace78ea5f54554bd3b333f0b7d3d,0,Ewen Cheslack-Postava,2016-04-03 18:14:53-07:00,['b94a7812beeb840926871df84838f35ca7b76ffe'],1,1,2,813764,1,,,,2256
83cf38545be4614bd1f6b1759ada851fb38d63b0,0,Ewen Cheslack-Postava,2016-04-03 19:04:48-07:00,['3a20ba305517ace78ea5f54554bd3b333f0b7d3d'],7,4,11,813775,2,0,0,0,2256
45c585b4f7e3d5e5dd5297b4d121badbd2052922,0,Ewen Cheslack-Postava,2016-04-03 20:04:36-07:00,['83cf38545be4614bd1f6b1759ada851fb38d63b0'],0,104,104,813879,33,,,,2263
31e263e8294e94de3d2c44d2ab3a827ab904e247,0,Guozhang Wang,2016-04-04 14:57:15-07:00,['45c585b4f7e3d5e5dd5297b4d121badbd2052922'],1,2,3,813882,2,0,1,0,2263
c3c9289c12342065d6c671098aaace23a328c7ff,1,Gwen Shapira,2016-04-04 18:49:29-07:00,['31e263e8294e94de3d2c44d2ab3a827ab904e247'],29,86,115,813997,7,0.071428571,0.928571429,0.607142857,2263
4ff667711ffd477872adbd3e3e39bd94eac6e763,1,Guozhang Wang,2016-04-04 21:28:59-07:00,['c3c9289c12342065d6c671098aaace23a328c7ff'],2,23,25,814022,2,0.882352941,0.882352941,0.588235294,2263
732b111f458454552411ce787c0b9f9fff8db642,0,Ewen Cheslack-Postava,2016-04-04 22:07:20-07:00,['4ff667711ffd477872adbd3e3e39bd94eac6e763'],2,2,4,814026,2,,,,2263
aee8ebb46cd9393a0886c42cb88b080d065da397,1,Guozhang Wang,2016-04-05 11:46:04-07:00,['732b111f458454552411ce787c0b9f9fff8db642'],91,98,189,814215,5,0,0,0,2263
893e79af88016f1d8659e72d48a25d4a825b8867,1,Jun Rao,2016-04-05 18:16:48-04:00,['aee8ebb46cd9393a0886c42cb88b080d065da397'],128,257,385,814600,4,0.707964602,1,0.82300885,2263
8218a4a153d9138f29486e74cf77c88d1786997a,0,Ewen Cheslack-Postava,2016-04-05 15:17:46-07:00,['893e79af88016f1d8659e72d48a25d4a825b8867'],2,6,8,814608,2,1,1,1,2263
99d232922734e115f8e3585d91ccfb0ef067385d,1,Guozhang Wang,2016-04-05 15:56:09-07:00,['8218a4a153d9138f29486e74cf77c88d1786997a'],41,206,247,814855,5,1,0.583333333,0.5,2263
8dbd688b1617968329087317fa6bde8b8df0392e,1,Guozhang Wang,2016-04-07 10:20:17-07:00,['99d232922734e115f8e3585d91ccfb0ef067385d'],0,113,113,814968,7,0.756756757,1,0.5,2263
9c34df1511a769b272893b75ec1ed90d38cc9576,1,Ewen Cheslack-Postava,2016-04-07 15:48:50-07:00,['8dbd688b1617968329087317fa6bde8b8df0392e'],71,118,189,815157,12,0.158730159,0.984126984,1,2263
8b9b07e5d6aed2552d1cdfba27b0211af39c691f,0,Ewen Cheslack-Postava,2016-04-07 18:17:40-07:00,['9c34df1511a769b272893b75ec1ed90d38cc9576'],16,18,34,815191,1,0,1,1,2263
3a58407e2e0aee0bb2c5e343fbe98c7f28fc6f3e,1,Ewen Cheslack-Postava,2016-04-08 08:59:50-07:00,['8b9b07e5d6aed2552d1cdfba27b0211af39c691f'],227,458,685,815876,24,0.261538462,1,1,2264
9beafae23a83774fc1d9ea811d449eac34240363,1,Guozhang Wang,2016-04-08 09:17:05-07:00,['3a58407e2e0aee0bb2c5e343fbe98c7f28fc6f3e'],0,288,288,816164,8,0.247311828,1,1,2268
4d467c2ec275b5659c2da0ca196409dffaa3caf3,1,Guozhang Wang,2016-04-08 09:44:51-07:00,['9beafae23a83774fc1d9ea811d449eac34240363'],31,104,135,816299,3,0.895833333,0.916666667,0.916666667,2268
cbdd70ec0de4b4d6d04b62580a5a67ea69311c4a,0,Ewen Cheslack-Postava,2016-04-08 10:04:46-07:00,['4d467c2ec275b5659c2da0ca196409dffaa3caf3'],0,13,13,816312,2,1,1,0.428571429,2268
2a8fa287862912491d1e118c52a2d194d8480075,1,Ewen Cheslack-Postava,2016-04-08 12:55:21-07:00,['cbdd70ec0de4b4d6d04b62580a5a67ea69311c4a'],5,57,62,816374,2,0,0.78125,1,2268
8c59565761a42984335294683c3501df8427ce62,1,Ewen Cheslack-Postava,2016-04-08 13:30:46-07:00,['2a8fa287862912491d1e118c52a2d194d8480075'],19,81,100,816474,13,0.3,0.666666667,1,2268
7c27989860e7e063bfec3c679cb6bc8fd52abc84,1,Guozhang Wang,2016-04-10 17:43:47-07:00,['8c59565761a42984335294683c3501df8427ce62'],4,454,458,816932,7,0.9,1,0.78125,2270
c76b6e6d9bad2278076054f5175a2b053383388f,1,Guozhang Wang,2016-04-10 23:09:43-07:00,['7c27989860e7e063bfec3c679cb6bc8fd52abc84'],10,15,25,816957,3,1,1,1,2270
411b04a3c933b5253f34342bf24f63a9473f9ab5,0,Gwen Shapira,2016-04-11 10:37:04-07:00,['c76b6e6d9bad2278076054f5175a2b053383388f'],2,5,7,816964,1,1,1,1,2270
1ec842a3ea9bbe414a5c59f90569fbc3348bdfb8,1,Guozhang Wang,2016-04-11 12:02:49-07:00,['411b04a3c933b5253f34342bf24f63a9473f9ab5'],6,4,10,816974,1,0,0,1,2270
40fd456649b5df29d030da46865b5e7e0ca6db15,1,Guozhang Wang,2016-04-11 12:33:48-07:00,['1ec842a3ea9bbe414a5c59f90569fbc3348bdfb8'],25,57,82,817056,11,0.76,1,1,2270
319c6e7195143c1fa4a1e5b34ad923c2b73f373d,0,Guozhang Wang,2016-04-12 11:34:46-07:00,['40fd456649b5df29d030da46865b5e7e0ca6db15'],0,2,2,817058,1,,,,2270
ba9456de2ebf1a34bdf5f6f62a701875822e1923,0,Gwen Shapira,2016-04-12 13:00:54-07:00,['319c6e7195143c1fa4a1e5b34ad923c2b73f373d'],0,232,232,817290,39,,,,2270
34a594472133c3bc6a2886cf58ded0065f26d28a,0,Gwen Shapira,2016-04-12 13:47:02-07:00,['ba9456de2ebf1a34bdf5f6f62a701875822e1923'],1,0,1,817291,1,,,,2270
e79d9af3cfbb8884e00424f84f3c687114497998,1,Gwen Shapira,2016-04-12 13:48:18-07:00,['34a594472133c3bc6a2886cf58ded0065f26d28a'],21,21,42,817333,5,,,,2270
667ff7ef737612773c50908d2b3cc829bb5132c7,1,Guozhang Wang,2016-04-12 17:38:20-07:00,['e79d9af3cfbb8884e00424f84f3c687114497998'],65,86,151,817484,3,0,0,0,2270
c1694833d5c095e47e5767f38c3e85bbe927a0a7,1,Ewen Cheslack-Postava,2016-04-13 13:50:49-07:00,['667ff7ef737612773c50908d2b3cc829bb5132c7'],106,364,470,817954,9,0.105527638,0.979899497,0.577889447,2271
f4d3d2865894f1a1ade9d92ac27931fd35d16cae,1,Guozhang Wang,2016-04-13 18:09:08-07:00,['c1694833d5c095e47e5767f38c3e85bbe927a0a7'],79,312,391,818345,14,0.204724409,0.984251969,0.88976378,2272
4fa456bc6e875c819e41aadadd1e37ba9bdb9cd0,1,Guozhang Wang,2016-04-14 10:44:05-07:00,['f4d3d2865894f1a1ade9d92ac27931fd35d16cae'],3,3,6,818351,1,,,,2272
065ddf90195e09689512b55d0718a5ebdb3d42ad,1,Ewen Cheslack-Postava,2016-04-14 22:02:19-07:00,['4fa456bc6e875c819e41aadadd1e37ba9bdb9cd0'],30,40,70,818421,5,0,0.909090909,0.909090909,2272
5236bf60debbb0c08010315a92dd3fbfa482e871,1,Ewen Cheslack-Postava,2016-04-15 15:51:31-07:00,['065ddf90195e09689512b55d0718a5ebdb3d42ad'],39,120,159,818580,6,0.46,0.56,1,2272
b1691cf49e9de850ac8a2675c487af9fb60bfdaa,1,Guozhang Wang,2016-04-16 20:18:27-07:00,['5236bf60debbb0c08010315a92dd3fbfa482e871'],0,209,209,818789,6,0.191176471,1,1,2274
89c67727c2793bf56b0b005a7d758beebedb5aed,1,Ewen Cheslack-Postava,2016-04-18 10:50:58-07:00,['b1691cf49e9de850ac8a2675c487af9fb60bfdaa'],100,1009,1109,819898,15,0.345699831,0.836424958,0.903878583,2277
03817d5a26722c6e95647f6219abf2802b187c8d,1,Ewen Cheslack-Postava,2016-04-18 12:49:36-07:00,['89c67727c2793bf56b0b005a7d758beebedb5aed'],7,2,9,819907,1,0,0,0,2277
a81ad2582ee0e533d335fe0dc5c5cc885dbf645d,0,Ewen Cheslack-Postava,2016-04-18 14:10:26-07:00,['03817d5a26722c6e95647f6219abf2802b187c8d'],6,6,12,819919,2,,,,2277
a5f1158c317e22a79c4186d1acb04fb25ce6e56a,1,Ewen Cheslack-Postava,2016-04-18 14:23:46-07:00,['a81ad2582ee0e533d335fe0dc5c5cc885dbf645d'],74,105,179,820098,5,0.863636364,0.568181818,0.659090909,2277
f89f5fb907711e4696bee8a8d7bb53c6941ed693,0,Jun Rao,2016-04-18 18:49:17-07:00,['a5f1158c317e22a79c4186d1acb04fb25ce6e56a'],2,2,4,820102,2,,,,2277
501fa37222ee7bb6c1883441af05fa883c51d93b,1,Ewen Cheslack-Postava,2016-04-19 11:06:31-07:00,['f89f5fb907711e4696bee8a8d7bb53c6941ed693'],12,22,34,820136,1,,,,2277
0bf61039c858af17260878d4815dbe7fb1645f90,0,Guozhang Wang,2016-04-19 17:39:04-07:00,['501fa37222ee7bb6c1883441af05fa883c51d93b'],9,9,18,820154,9,,,,2277
280efe7f789d21f0c45657e14830451c1c8fc2b4,0,Gwen Shapira,2016-04-20 10:16:44-07:00,['0bf61039c858af17260878d4815dbe7fb1645f90'],95,0,95,820249,1,0,0,0,2277
c9485b78a6e43747daf1314ae9532839fb7bc810,1,Ewen Cheslack-Postava,2016-04-20 14:09:59-07:00,['280efe7f789d21f0c45657e14830451c1c8fc2b4'],679,2173,2852,823101,37,0.464619493,0.913217623,0.959946595,2282
8a863ecee7e5dcdaf66a55b91040a7893ffdbf66,1,Guozhang Wang,2016-04-20 17:08:00-07:00,['c9485b78a6e43747daf1314ae9532839fb7bc810'],21,125,146,823247,6,0.044776119,0.492537313,1,2282
f213625fc55dd0eb9087ba6482ce67fcb737172d,0,Ewen Cheslack-Postava,2016-04-20 17:50:00-07:00,['8a863ecee7e5dcdaf66a55b91040a7893ffdbf66'],2,2,4,823251,1,,,,2282
9d71489ff0e62fd1897c7a6f54671673db7b37b8,1,Gwen Shapira,2016-04-20 18:54:30-07:00,['f213625fc55dd0eb9087ba6482ce67fcb737172d'],30,57,87,823338,23,,,,2282
5c547475d86aa336f8b3c4bb69faff39759d5df5,1,Guozhang Wang,2016-04-21 13:42:17-07:00,['9d71489ff0e62fd1897c7a6f54671673db7b37b8'],265,291,556,823894,6,1,0,1,2284
74e6dc842559d344241c70cb6607a69291e3a20d,1,Guozhang Wang,2016-04-21 14:51:21-07:00,['5c547475d86aa336f8b3c4bb69faff39759d5df5'],78,302,380,824274,12,0.581395349,1,0.918604651,2287
32740044972ad3bfc9539b5d76128dceddedc2ba,0,Guozhang Wang,2016-04-21 15:13:25-07:00,['74e6dc842559d344241c70cb6607a69291e3a20d'],1,15,16,824290,2,1,1,1,2287
c7f9bd2a68ea7bb604c4dcf2a2f0b030fc019ca7,0,Ewen Cheslack-Postava,2016-04-21 17:59:23-07:00,['32740044972ad3bfc9539b5d76128dceddedc2ba'],13,36,49,824339,1,0.888888889,1,1,2287
bc5051565171cf65b4ed7dd4d9ef269d66a1021a,1,Gwen Shapira,2016-04-22 07:09:14-07:00,['c7f9bd2a68ea7bb604c4dcf2a2f0b030fc019ca7'],13,20,33,824372,3,0,1,1,2287
1b764c5e834c0d03f3c7107a58f21ad3bbb98ac3,1,Guozhang Wang,2016-04-25 11:18:28-07:00,['bc5051565171cf65b4ed7dd4d9ef269d66a1021a'],0,86,86,824458,1,0.2,1,1,2288
996e29cfe8a9e5a45d4b778a84fb20479eeba469,1,Guozhang Wang,2016-04-25 13:45:51-07:00,['1b764c5e834c0d03f3c7107a58f21ad3bbb98ac3'],1,9,10,824468,3,0,0.75,1,2288
b3847f76b571deac5c7da7287a642c8b354a2a8c,1,Ismael Juma,2016-04-26 06:31:00-07:00,['996e29cfe8a9e5a45d4b778a84fb20479eeba469'],9,126,135,824603,3,1,1,1,2289
e7d04c2515be158d9a7f0ff0d7571bd41287d91a,1,Ismael Juma,2016-04-26 06:37:08-07:00,['b3847f76b571deac5c7da7287a642c8b354a2a8c'],14,18,32,824635,3,1,1,1,2289
a02c8aaecfbd13838c2a062bac1455da352028fe,1,Guozhang Wang,2016-04-26 07:32:21-07:00,['e7d04c2515be158d9a7f0ff0d7571bd41287d91a'],191,386,577,825212,15,0.176470588,0,0.029411765,2292
18dd1986bd354e8c7d75982112fad848780a6b33,0,Guozhang Wang,2016-04-26 09:11:40-07:00,['a02c8aaecfbd13838c2a062bac1455da352028fe'],3,3,6,825218,1,,,,2292
088ab3eaadb2389b52aedc049b6f1f0d4b5fb989,1,Guozhang Wang,2016-04-26 09:59:37-07:00,['18dd1986bd354e8c7d75982112fad848780a6b33'],50,23,73,825291,1,1,0,1,2292
9d37b9f4b6ba228ff7f7b99c8a0921a971fc03a6,1,Guozhang Wang,2016-04-26 10:53:49-07:00,['088ab3eaadb2389b52aedc049b6f1f0d4b5fb989'],4,3,7,825298,4,,,,2292
f60a3fad38d22654e7560d56730e2dd74b5ae659,0,Ismael Juma,2016-04-26 11:25:23-07:00,['9d37b9f4b6ba228ff7f7b99c8a0921a971fc03a6'],2,2,4,825302,2,,,,2292
1a73629bb43bbc781e5a968a61f6079365bc75b7,1,Guozhang Wang,2016-04-26 11:39:49-07:00,['f60a3fad38d22654e7560d56730e2dd74b5ae659'],2197,2349,4546,829848,32,1,1,1,2293
fbac525c08d54a26248eb8f9a5f7d3d053f99bd4,0,Ismael Juma,2016-04-26 11:46:03-07:00,['1a73629bb43bbc781e5a968a61f6079365bc75b7'],1,1,2,829850,1,,,,2293
2790d0cb1fc6ade216f2c1bf2667a0ebb53d85e3,0,Ismael Juma,2016-04-26 11:52:33-07:00,['fbac525c08d54a26248eb8f9a5f7d3d053f99bd4'],1,1,2,829852,1,,,,2293
cd427c9b905c161a6b135504dc515515de6a6438,0,Gwen Shapira,2016-04-26 15:14:33-07:00,['2790d0cb1fc6ade216f2c1bf2667a0ebb53d85e3'],25,29,54,829906,3,,,,2293
5b375d7bf9b26aaeed06bac2dc5de3f8214cbad4,1,Ismael Juma,2016-04-26 16:56:42-07:00,['cd427c9b905c161a6b135504dc515515de6a6438'],293,1740,2033,831939,51,0.418760469,0.58961474,0.840871022,2308
33d745e2dcfa7a9cac90af5594903330ad774cd2,1,Gwen Shapira,2016-04-26 17:03:18-07:00,['5b375d7bf9b26aaeed06bac2dc5de3f8214cbad4'],128,732,860,832799,23,0.469208211,0.695014663,0.686217009,2310
77fa0b116f0cc8aba37884a1a5d487f8683f7845,0,Ismael Juma,2016-04-27 00:03:00-07:00,['33d745e2dcfa7a9cac90af5594903330ad774cd2'],1,1,2,832801,1,,,,2310
2885bc33daaf75477bf39a92d1d1da02c0e03eaa,0,Ismael Juma,2016-04-27 06:53:16-07:00,['77fa0b116f0cc8aba37884a1a5d487f8683f7845'],6,6,12,832813,1,,,,2310
4c76b5fa6a72412efa5936c284800148c2c69c24,0,Guozhang Wang,2016-04-27 10:50:20-07:00,['2885bc33daaf75477bf39a92d1d1da02c0e03eaa'],1,8,9,832822,2,1,1,1,2310
8407dac6ee409d832c95533e6f1d5578511232ae,1,Gwen Shapira,2016-04-27 11:28:32-07:00,['4c76b5fa6a72412efa5936c284800148c2c69c24'],38,357,395,833217,10,0.948717949,0.888888889,0.94017094,2314
94aee2143ed5290d27cdd4072c6ae9bb70a6ba30,1,Guozhang Wang,2016-04-27 16:55:51-07:00,['8407dac6ee409d832c95533e6f1d5578511232ae'],0,656,656,833873,6,0.588235294,1,0.68487395,2318
669be7fadc808a8436ba28d033b70d24641c75ea,0,Ismael Juma,2016-04-27 17:15:37-07:00,['94aee2143ed5290d27cdd4072c6ae9bb70a6ba30'],1,9,10,833883,2,1,1,1,2318
57831a56a581128e164b4372c5e5eb4b55038d4a,1,Ismael Juma,2016-04-27 17:31:31-07:00,['669be7fadc808a8436ba28d033b70d24641c75ea'],3,55,58,833941,2,1,1,1,2319
316389d6adfb1398e30ca2ce5d586ea94d3f3110,1,Ewen Cheslack-Postava,2016-04-28 11:59:02-07:00,['57831a56a581128e164b4372c5e5eb4b55038d4a'],6,104,110,834051,5,0.952380952,1,1,2320
3a496f480d002a4512273477eda9d92731e600c3,1,Ismael Juma,2016-04-28 13:39:22-07:00,['316389d6adfb1398e30ca2ce5d586ea94d3f3110'],268,982,1250,835301,15,0.761904762,0.933333333,0.933333333,2327
fdded2da6e0f57431fc19fd1705bbb6373c1c863,0,Ismael Juma,2016-04-28 14:08:10-07:00,['3a496f480d002a4512273477eda9d92731e600c3'],9,9,18,835319,1,,,,2327
346df72736d03acb4a6f5681e705ce3e330900a8,1,Ismael Juma,2016-04-28 14:46:47-07:00,['fdded2da6e0f57431fc19fd1705bbb6373c1c863'],5,14,19,835338,1,,,,2327
0ada3b1fc215bb8efdf5c7ae27eb52b29e0fbbdc,1,Ewen Cheslack-Postava,2016-04-28 15:49:01-07:00,['346df72736d03acb4a6f5681e705ce3e330900a8'],1,176,177,835515,3,0.928571429,0.702380952,0.476190476,2329
68433dcfdc0ae078ee4e7d278c286a9b7c1b3e76,1,Guozhang Wang,2016-04-29 07:44:03-07:00,['0ada3b1fc215bb8efdf5c7ae27eb52b29e0fbbdc'],535,615,1150,836665,19,0.575,1,0.9125,2332
4ab4e4af814fb791fe6e8c2bd3381da8ca80b0b5,1,Guozhang Wang,2016-04-29 08:49:16-07:00,['68433dcfdc0ae078ee4e7d278c286a9b7c1b3e76'],163,383,546,837211,43,0,0,0,2332
cea01af125a33b81f973a96501fe41ca9d698197,1,Ewen Cheslack-Postava,2016-04-29 09:41:12-07:00,['4ab4e4af814fb791fe6e8c2bd3381da8ca80b0b5'],59,92,151,837362,6,0.4,0.666666667,0.4,2332
fe6c481b38d6b1b61341e4e1a6237f64accfbfbc,0,Ewen Cheslack-Postava,2016-04-29 10:26:01-07:00,['cea01af125a33b81f973a96501fe41ca9d698197'],14,57,71,837433,1,,,,2332
eb50d2f6ca9dee041689db6fe397a83ece05b9e2,1,Ewen Cheslack-Postava,2016-04-29 10:29:00-07:00,['fe6c481b38d6b1b61341e4e1a6237f64accfbfbc'],18,54,72,837505,3,,,,2332
e29eac4bbb678aa3d5a29a75f413a7b10cc2f0b1,1,Gwen Shapira,2016-04-29 10:51:29-07:00,['eb50d2f6ca9dee041689db6fe397a83ece05b9e2'],4,33,37,837542,4,0.454545455,0,0.5,2332
e50327331d7d4e2854297a377f6701d737599672,0,Ewen Cheslack-Postava,2016-04-29 10:52:42-07:00,['e29eac4bbb678aa3d5a29a75f413a7b10cc2f0b1'],13,39,52,837594,3,0,0,0.4375,2332
69d9a669d7bbfec1e33dd6177c5687ef7f9977df,1,Gwen Shapira,2016-04-29 11:15:20-07:00,['e50327331d7d4e2854297a377f6701d737599672'],43,297,340,837934,9,0.778625954,0.984732824,0.86259542,2333
3414d56121d8d2f66f8dd613453af71d5b3f0c5f,0,Ewen Cheslack-Postava,2016-04-29 12:50:02-07:00,['69d9a669d7bbfec1e33dd6177c5687ef7f9977df'],5,189,194,838128,7,,,,2333
096b8b84e0dba8cdf0e0f7afae8d118a68e06e6c,0,Gwen Shapira,2016-04-29 14:48:25-07:00,['3414d56121d8d2f66f8dd613453af71d5b3f0c5f'],0,6,6,838134,1,1,1,0,2333
d0dedc6314bfd83d9b2b9a9557e3168e715981da,1,Ewen Cheslack-Postava,2016-04-29 14:49:22-07:00,['096b8b84e0dba8cdf0e0f7afae8d118a68e06e6c'],106,174,280,838414,7,0,1,1,2333
60380e31d4bf6688d8d26ec44cf514a3c32731cb,0,Ewen Cheslack-Postava,2016-04-29 15:14:36-07:00,['d0dedc6314bfd83d9b2b9a9557e3168e715981da'],29,52,81,838495,2,0,1,1,2333
94d1878a9b7aaf57c7520fb5bdcd2f05aeec5853,0,Gwen Shapira,2016-04-29 15:49:48-07:00,['60380e31d4bf6688d8d26ec44cf514a3c32731cb'],4,36,40,838535,2,0,1,1,2333
9eaf529ffb168e44a461be24b666eee00fdaf497,0,Gwen Shapira,2016-04-29 17:27:02-07:00,['94d1878a9b7aaf57c7520fb5bdcd2f05aeec5853'],11,10,21,838556,3,0,1,1,2333
1e4dd66b19857f4f0ce3f83fd0a808885b0a88c1,1,Ewen Cheslack-Postava,2016-04-30 18:53:44-07:00,['9eaf529ffb168e44a461be24b666eee00fdaf497'],1,1,2,838558,1,,,,2333
5c47b9f80e2130ab4cc76e2645e0ac0215bf8abe,1,Ewen Cheslack-Postava,2016-05-02 21:42:01-07:00,['1e4dd66b19857f4f0ce3f83fd0a808885b0a88c1'],5,19,24,838582,1,0,0.666666667,0.333333333,2333
abac51dc0bf0d5bdc1d5414787da3191e00adcab,1,Jun Rao,2016-05-03 09:49:23-07:00,['5c47b9f80e2130ab4cc76e2645e0ac0215bf8abe'],94,293,387,838969,2,,,,2333
bf578f987bd303e672354e2f3a97552cc5145237,0,Ewen Cheslack-Postava,2016-05-03 10:20:17-07:00,['abac51dc0bf0d5bdc1d5414787da3191e00adcab'],2,1,3,838972,1,,,,2333
62253539d87e1ccb353673ed96adc98fb2d854ae,0,Ewen Cheslack-Postava,2016-05-03 10:21:57-07:00,['bf578f987bd303e672354e2f3a97552cc5145237'],1,1,2,838974,1,,,,2333
1f528815de8d0e094ee5446794ab7325629ca7ed,1,Guozhang Wang,2016-05-03 10:47:23-07:00,['62253539d87e1ccb353673ed96adc98fb2d854ae'],17,26,43,839017,4,0,0,0,2333
c7425be5be8d0c2786155fbc697d83f80827d084,1,Jun Rao,2016-05-03 10:55:54-07:00,['1f528815de8d0e094ee5446794ab7325629ca7ed'],108,136,244,839261,14,0,0.916666667,1,2334
88e5d5a9a16f4831b8a178355d38d203febe85f9,1,Ismael Juma,2016-05-03 19:24:14+01:00,['c7425be5be8d0c2786155fbc697d83f80827d084'],3,16,19,839280,5,0,1,1,2334
b3d2c0dabbcfc8e5d286e181450029adefc9fee8,1,Guozhang Wang,2016-05-03 13:26:22-07:00,['88e5d5a9a16f4831b8a178355d38d203febe85f9'],8,830,838,840118,7,0.117283951,1,1,2339
af013788436ae5652b531184770f2620f8914123,1,Ismael Juma,2016-05-03 23:42:03+01:00,['b3d2c0dabbcfc8e5d286e181450029adefc9fee8'],2,2,4,840122,2,,,,2339
94e12a2e1fbd2f43821643d67a0d91f03b3f94e5,1,Ismael Juma,2016-05-03 23:59:12+01:00,['af013788436ae5652b531184770f2620f8914123'],18,49,67,840189,2,0,0.80952381,0.571428571,2339
50aacd660d4c4212ffa4a9dca7d45bcfe50af833,1,Ewen Cheslack-Postava,2016-05-03 18:05:04-07:00,['94e12a2e1fbd2f43821643d67a0d91f03b3f94e5'],8,22,30,840219,2,0,1,1,2339
03a1f7d39c553835022987826df4762cfd39a639,1,Ismael Juma,2016-05-04 02:14:35+01:00,['50aacd660d4c4212ffa4a9dca7d45bcfe50af833'],2,4,6,840225,2,1,0,1,2339
b410ea37b092740bf3e2a6e04caa3cf681ebc0d3,0,Ismael Juma,2016-05-04 14:26:41+01:00,['03a1f7d39c553835022987826df4762cfd39a639'],9,16,25,840250,2,1,0,0,2339
768328689a59fa0984c099768136328e529e9fee,1,Guozhang Wang,2016-05-04 11:25:26-07:00,['b410ea37b092740bf3e2a6e04caa3cf681ebc0d3'],11,15,26,840276,3,,,,2339
7a0821d653c6c99a26ded6046ea24722c8d8ad85,1,Ismael Juma,2016-05-04 20:10:41+01:00,['768328689a59fa0984c099768136328e529e9fee'],10,176,186,840462,2,1,1,0.910447761,2340
c46cc480214080844ef0ca04d96f1db61b1f2ea3,1,Guozhang Wang,2016-05-04 14:26:30-07:00,['7a0821d653c6c99a26ded6046ea24722c8d8ad85'],5,26,31,840493,2,0.888888889,0.888888889,0.888888889,2340
da7095f3689b7a16f2b9050a8b1e5a3d6d400b12,0,Ewen Cheslack-Postava,2016-05-04 16:08:08-07:00,['c46cc480214080844ef0ca04d96f1db61b1f2ea3'],3,1,4,840497,1,1,1,0,2340
c8c6ac3f6d2d590261acb35fabbf7418ae102d4e,0,Ismael Juma,2016-05-05 00:23:34+01:00,['da7095f3689b7a16f2b9050a8b1e5a3d6d400b12'],70,99,169,840666,4,1,1,1,2340
64451af9e08de428064dc232cd6dea0ea0b2a81d,1,Jun Rao,2016-05-04 18:16:08-07:00,['c8c6ac3f6d2d590261acb35fabbf7418ae102d4e'],39,146,185,840851,7,0.564516129,0.774193548,1,2340
ad316509787787afeed6e2a24a62fd22cadd09c7,1,Ewen Cheslack-Postava,2016-05-04 19:20:54-07:00,['64451af9e08de428064dc232cd6dea0ea0b2a81d'],8,59,67,840918,5,0.6,1,1,2341
694303a3da18e73cb08dfe229a07c7b31e0fa10c,0,Ewen Cheslack-Postava,2016-05-04 19:24:58-07:00,['ad316509787787afeed6e2a24a62fd22cadd09c7'],19,18,37,840955,2,,,,2341
32bf83e5a792c5ee9eb88660da71b73aad5bbc02,1,Ewen Cheslack-Postava,2016-05-05 12:03:28-07:00,['694303a3da18e73cb08dfe229a07c7b31e0fa10c'],60,225,285,841240,8,1,0.782608696,0.797101449,2342
b6cd0e2791e0e6a6ef02d069b3001ffb477f7c6c,1,Ewen Cheslack-Postava,2016-05-05 13:12:11-07:00,['32bf83e5a792c5ee9eb88660da71b73aad5bbc02'],52,55,107,841347,13,0.4,1,0.2,2342
7f4e3ccde820eedd962b4cfd3abaecd8a49b83a8,0,Guozhang Wang,2016-05-05 13:50:15-07:00,['b6cd0e2791e0e6a6ef02d069b3001ffb477f7c6c'],5,5,10,841357,5,,,,2342
8429db937e2134d9935d9dccd2ed0febc474fd66,0,Ismael Juma,2016-05-05 23:25:03+01:00,['7f4e3ccde820eedd962b4cfd3abaecd8a49b83a8'],20,14,34,841391,5,0,0,0,2342
6856c5c214fb0a40b18cfb25db3dadae320c4142,1,Ismael Juma,2016-05-05 23:31:46+01:00,['8429db937e2134d9935d9dccd2ed0febc474fd66'],8,95,103,841494,2,0.446428571,0.821428571,1,2342
4a076a03bee376853713f4b5784b66b18ad5535c,0,Guozhang Wang,2016-05-05 16:55:23-07:00,['6856c5c214fb0a40b18cfb25db3dadae320c4142'],42,50,92,841586,5,1,1,1,2342
2ff955044aa875176aaa58a9be4a79c494a3fb27,1,Ewen Cheslack-Postava,2016-05-05 22:24:03-07:00,['4a076a03bee376853713f4b5784b66b18ad5535c'],89,621,710,842296,8,0.134078212,0.98603352,0.61452514,2342
78de891ace41547d83901c3c18a9a01a517ccba1,0,Ismael Juma,2016-05-06 16:33:01+01:00,['2ff955044aa875176aaa58a9be4a79c494a3fb27'],2,2,4,842300,1,,,,2342
fec2d41bc2bed9f4effbd9922ca487bb02e5eeae,1,Guozhang Wang,2016-05-06 08:49:44-07:00,['78de891ace41547d83901c3c18a9a01a517ccba1'],114,201,315,842615,7,1,0,0,2345
54092c12ed276b4bf91741e3c7fd315443f3c0b1,1,Ewen Cheslack-Postava,2016-05-06 11:10:27-07:00,['fec2d41bc2bed9f4effbd9922ca487bb02e5eeae'],243,651,894,843509,42,0.887850467,0.934579439,0.859813084,2354
19850331272c19de15240403a03ca3812037947b,0,Gwen Shapira,2016-05-06 13:31:29-07:00,['54092c12ed276b4bf91741e3c7fd315443f3c0b1'],1,1,2,843511,1,,,,2354
58f9d7cf8a68824a8fc451cf7ff5fcfb696fa863,0,Ismael Juma,2016-05-06 21:47:00+01:00,['19850331272c19de15240403a03ca3812037947b'],0,2,2,843513,1,1,1,1,2354
717eea8350feb670e8ba3dd3505c708a8a52de71,0,Ismael Juma,2016-05-06 21:57:53+01:00,['58f9d7cf8a68824a8fc451cf7ff5fcfb696fa863'],4,40,44,843557,2,1,1,1,2354
c4bbf342432291220242ad4177fd72a959ddcb94,1,Ismael Juma,2016-05-07 09:05:55+01:00,['717eea8350feb670e8ba3dd3505c708a8a52de71'],6,21,27,843584,2,0.8,0.8,1,2354
8fe2552239863f3a01d01708d55edf3c7082ff92,1,Ismael Juma,2016-05-07 19:35:55+01:00,['c4bbf342432291220242ad4177fd72a959ddcb94'],73,289,362,843946,11,0.758241758,0.912087912,0.384615385,2355
51f7a35c929d9aa04d821098a2266902f9178d7c,1,Jun Rao,2016-05-08 10:45:47-07:00,['8fe2552239863f3a01d01708d55edf3c7082ff92'],6,76,82,844028,2,0,1,1,2356
62b9fa22545a8e254b4ffd07ddc5bd3315542548,0,Ismael Juma,2016-05-08 22:27:58+01:00,['51f7a35c929d9aa04d821098a2266902f9178d7c'],25,31,56,844084,3,0.5,1,1,2356
d1bb2b9df105169c47f16d057c887acb7f8fe818,1,Ewen Cheslack-Postava,2016-05-08 22:26:26-07:00,['62b9fa22545a8e254b4ffd07ddc5bd3315542548'],54,155,209,844293,9,0.666666667,0.878787879,0.666666667,2358
dbafc631ad78c96f85361a3d5e1c4d203cedb26f,1,Ewen Cheslack-Postava,2016-05-08 23:50:43-07:00,['d1bb2b9df105169c47f16d057c887acb7f8fe818'],30,45,75,844368,3,1,1,0,2358
fc89083f812a513699f5f0c02648f7a7927acf64,1,Ewen Cheslack-Postava,2016-05-08 23:52:13-07:00,['dbafc631ad78c96f85361a3d5e1c4d203cedb26f'],2,2,4,844372,1,,,,2358
8911660e2e7d9553502974393ad1aa04852c2da2,1,Ewen Cheslack-Postava,2016-05-09 00:12:30-07:00,['fc89083f812a513699f5f0c02648f7a7927acf64'],20,498,518,844890,5,0.098039216,0.977124183,0.983660131,2358
f5b98b8fa786ff0ca37c5cba6d43c3390d28436e,0,Ewen Cheslack-Postava,2016-05-09 00:22:13-07:00,['8911660e2e7d9553502974393ad1aa04852c2da2'],0,4,4,844894,1,,,,2358
bce3415b18fd0d2b7ab05330f2590f98939b8850,0,Ismael Juma,2016-05-09 14:48:08+01:00,['f5b98b8fa786ff0ca37c5cba6d43c3390d28436e'],1,6,7,844901,1,1,1,1,2358
b86378840a2a6defcbdc59c1c1462ecbfd2c47d4,1,Ismael Juma,2016-05-09 17:01:16+01:00,['bce3415b18fd0d2b7ab05330f2590f98939b8850'],2,2,4,844905,1,,,,2358
29a682e2ea1918b50c6fd4c36ce399242929e5ae,0,Guozhang Wang,2016-05-09 09:31:11-07:00,['b86378840a2a6defcbdc59c1c1462ecbfd2c47d4'],2,2,4,844909,1,,,,2358
2caf872c2e51d689c6ac20240c4a306e36d98b15,1,Ismael Juma,2016-05-09 18:10:40+01:00,['29a682e2ea1918b50c6fd4c36ce399242929e5ae'],9,51,60,844969,2,0.212121212,0.060606061,0.727272727,2358
4331bf4ff2d0e7ab1a24ea29382897162c1ed91c,1,Ismael Juma,2016-05-09 18:40:54+01:00,['2caf872c2e51d689c6ac20240c4a306e36d98b15'],7,95,102,845071,3,0.901960784,0.901960784,1,2359
ff8580da6fb1d65b206df544ebd574222abe7f3f,0,Ismael Juma,2016-05-09 23:34:30+01:00,['4331bf4ff2d0e7ab1a24ea29382897162c1ed91c'],0,12,12,845083,1,1,1,1,2359
22c098b71b38d22a01e142716d5ac8ee3d07b9c6,0,Ismael Juma,2016-05-09 23:36:22+01:00,['ff8580da6fb1d65b206df544ebd574222abe7f3f'],5,3,8,845091,1,,,,2359
36ed00d9bf82d48b0a02b6414734b7698c9ac4ea,0,Ismael Juma,2016-05-09 23:42:09+01:00,['22c098b71b38d22a01e142716d5ac8ee3d07b9c6'],2,4,6,845097,1,,,,2359
87285f36c9cd8e1d9861f6dfaacef978772fb7f1,0,Ismael Juma,2016-05-09 23:47:04+01:00,['36ed00d9bf82d48b0a02b6414734b7698c9ac4ea'],1,68,69,845166,2,0.90625,1,0.71875,2359
eb1de107b0c29e322999d9052b82b1e042d8fcfd,0,Gwen Shapira,2016-05-09 16:47:20-07:00,['87285f36c9cd8e1d9861f6dfaacef978772fb7f1'],1,1,2,845168,1,,,,2359
f96da638ee9a4e1e47ece1ea337ee071d911c3da,1,Ewen Cheslack-Postava,2016-05-09 16:56:32-07:00,['eb1de107b0c29e322999d9052b82b1e042d8fcfd'],12,166,178,845346,4,0.52173913,1,0.684782609,2359
18226ff0be6f98795b98dd505d8ac0b4f3cf8c07,1,Gwen Shapira,2016-05-09 17:29:15-07:00,['f96da638ee9a4e1e47ece1ea337ee071d911c3da'],5,5,10,845356,1,,,,2359
9575e93070a480eb1ef1e136a67ce0226914b937,1,Ewen Cheslack-Postava,2016-05-09 17:37:17-07:00,['18226ff0be6f98795b98dd505d8ac0b4f3cf8c07'],12,14,26,845382,4,1,1,1,2359
6f1873242c1a189770319e09f53467d26584112f,1,Ismael Juma,2016-05-10 08:00:51+01:00,['9575e93070a480eb1ef1e136a67ce0226914b937'],10,31,41,845423,5,,,,2359
fe0335ea1030ca61f38b343a67c78e6537d25717,0,Ewen Cheslack-Postava,2016-05-10 17:30:36-07:00,['6f1873242c1a189770319e09f53467d26584112f'],1,1,2,845425,1,,,,2359
3e89d2bc59b1bf6c73b262a36019df01af7a958c,0,Ismael Juma,2016-05-11 01:52:43+01:00,['fe0335ea1030ca61f38b343a67c78e6537d25717'],15,15,30,845455,3,1,0,0,2359
e20eba958d8de29cb4e3b6feea37ac3a1e1ab4f9,1,Ismael Juma,2016-05-11 13:05:58+01:00,['3e89d2bc59b1bf6c73b262a36019df01af7a958c'],7,7,14,845469,1,1,1,1,2359
6978115514fc74021e4f2c761402d6b0c954d50c,1,Ismael Juma,2016-05-11 15:28:18+01:00,['e20eba958d8de29cb4e3b6feea37ac3a1e1ab4f9'],0,11,11,845480,1,,,,2359
bd8681cdd51d2878ea917941abe335f68a373716,0,Ewen Cheslack-Postava,2016-05-11 13:06:20-07:00,['6978115514fc74021e4f2c761402d6b0c954d50c'],3,10,13,845493,3,0,1,1,2359
b28bc57a1fdb9b56c89c3cb9c3df60afbeda521c,1,Ismael Juma,2016-05-11 21:11:17+01:00,['bd8681cdd51d2878ea917941abe335f68a373716'],15,112,127,845620,5,0.555555556,1,1,2359
f892f0ca6d38cb21a93c2c05dd8b9a23c4165181,0,Ismael Juma,2016-05-11 23:48:46+01:00,['b28bc57a1fdb9b56c89c3cb9c3df60afbeda521c'],9,21,30,845650,4,0.666666667,1,0.666666667,2359
1182d61deb23b5cd86cbe462471f7df583a796e1,0,Guozhang Wang,2016-05-11 17:01:14-07:00,['f892f0ca6d38cb21a93c2c05dd8b9a23c4165181'],12,8,20,845670,3,0,0,1,2359
4807dd1df945f6e66c6276f0a85e8abeb24b568a,0,Ewen Cheslack-Postava,2016-05-11 17:19:11-07:00,['1182d61deb23b5cd86cbe462471f7df583a796e1'],0,49,49,845719,1,,,,2359
84d17bdf220292dc9950566afe1de34b64be4746,1,Ismael Juma,2016-05-12 01:38:50+01:00,['4807dd1df945f6e66c6276f0a85e8abeb24b568a'],1,1,2,845721,1,,,,2359
5aedde5b29cc5a1adea4c65d5c44fb657f162eab,1,Ismael Juma,2016-05-12 11:12:17+01:00,['84d17bdf220292dc9950566afe1de34b64be4746'],1,21,22,845743,2,1,1,1,2359
ac434a4ebdc36338ff707c38e189f9d1668ff423,0,Ismael Juma,2016-05-12 20:36:47+01:00,['5aedde5b29cc5a1adea4c65d5c44fb657f162eab'],3,1,4,845747,1,,,,2359
563611935d5d559722712cb00820c31a42d5726c,0,Ismael Juma,2016-05-12 22:06:14+01:00,['ac434a4ebdc36338ff707c38e189f9d1668ff423'],11,4,15,845762,1,,,,2359
527b98d82f5142ab6a5efc26e84f6b0a21aec062,0,Ewen Cheslack-Postava,2016-05-12 18:15:04-07:00,['563611935d5d559722712cb00820c31a42d5726c'],18,50,68,845830,2,,,,2359
81f76bde8565eaffd67e5adaa69ddfdb4f5cebaa,1,Ewen Cheslack-Postava,2016-05-12 18:19:00-07:00,['527b98d82f5142ab6a5efc26e84f6b0a21aec062'],12,49,61,845891,6,0.588235294,1,0.588235294,2359
f34164eed53d791768f05df21f4dfeca89859b2e,1,Guozhang Wang,2016-05-12 21:14:51-07:00,['81f76bde8565eaffd67e5adaa69ddfdb4f5cebaa'],5,115,120,846011,2,0.714285714,0.698412698,1,2360
fb421dbcfe36c4a0d9df7a742c18c11515f095c5,1,Ismael Juma,2016-05-13 12:10:09+01:00,['f34164eed53d791768f05df21f4dfeca89859b2e'],25,25,50,846061,1,,,,2360
1c4b943f2d9cc90101026519769f142c07bc1785,1,Ismael Juma,2016-05-13 12:57:09+01:00,['fb421dbcfe36c4a0d9df7a742c18c11515f095c5'],9,39,48,846109,2,0,0.304347826,1,2360
08205de185090b0cd744844b58b1508c82459d28,1,Guozhang Wang,2016-05-13 15:32:24-07:00,['1c4b943f2d9cc90101026519769f142c07bc1785'],1,1,2,846111,1,,,,2360
13130139ff70d0127e87d2c87dd5e62e6320fa45,0,Gwen Shapira,2016-05-13 21:03:35-07:00,['08205de185090b0cd744844b58b1508c82459d28'],3,7,10,846121,3,1,1,0,2360
7ded19a29ec140de93d57a9eb01722e6a8f2012a,0,Jun Rao,2016-05-15 09:04:21-07:00,['13130139ff70d0127e87d2c87dd5e62e6320fa45'],0,7,7,846128,1,,,,2360
62985f313f4b66d3810b05650d2a3f42b6cb054e,0,Ismael Juma,2016-05-16 13:39:33+01:00,['7ded19a29ec140de93d57a9eb01722e6a8f2012a'],1,4,5,846133,1,,,,2360
6a5d3e65c6ba9faa0f6cf4ec2871a83beb28c6c4,1,Ismael Juma,2016-05-16 14:37:09+01:00,['62985f313f4b66d3810b05650d2a3f42b6cb054e'],18,56,74,846207,3,0.826086957,0.826086957,0.826086957,2360
61f4c8b0923baa17bfc6160082fc2c8ca5a2c44d,0,Ismael Juma,2016-05-16 17:16:27+01:00,['6a5d3e65c6ba9faa0f6cf4ec2871a83beb28c6c4'],26,36,62,846269,1,,,,2360
9a3fcf41350ddda9a41db18cde718f892b95177c,1,Gwen Shapira,2016-05-16 12:00:06-07:00,['61f4c8b0923baa17bfc6160082fc2c8ca5a2c44d'],9,17,26,846295,2,,,0,2360
d54616bc31cec226cdb0ffd2003a41b4c27fdfed,1,Guozhang Wang,2016-05-16 14:44:23-07:00,['9a3fcf41350ddda9a41db18cde718f892b95177c'],0,2,2,846297,1,0,1,1,2360
53fd22a76613b309b7941a5b0c64f17523b39202,0,Guozhang Wang,2016-05-17 11:25:49-07:00,['d54616bc31cec226cdb0ffd2003a41b4c27fdfed'],6,12,18,846315,3,0.6,1,1,2360
ab8fc86382fc9f5a8a0f696a91c66806d51c05a5,1,Ismael Juma,2016-05-18 01:51:23+01:00,['53fd22a76613b309b7941a5b0c64f17523b39202'],9,9,18,846333,3,,,,2360
9a44d938da4badec25e30733409cf7299e945bf6,1,Gwen Shapira,2016-05-17 19:18:33-07:00,['ab8fc86382fc9f5a8a0f696a91c66806d51c05a5'],2,9,11,846344,1,,,,2360
2bd7b64506a2a7ecef562f5b7db8a34e28d4e957,1,Jun Rao,2016-05-17 21:16:52-07:00,['9a44d938da4badec25e30733409cf7299e945bf6'],6,15,21,846365,4,,,,2360
c36cc60f73ca1fe956fb8792bc538b1fdebb712d,1,Guozhang Wang,2016-05-18 11:01:27-07:00,['2bd7b64506a2a7ecef562f5b7db8a34e28d4e957'],17,52,69,846434,2,0.157894737,1,0.421052632,2360
5b5f3ed0f29faa803e894fc3ee2797b3bfe5766a,0,Ewen Cheslack-Postava,2016-05-18 14:47:43-07:00,['c36cc60f73ca1fe956fb8792bc538b1fdebb712d'],1,1,2,846436,1,,,,2360
9791401a778fee5a165373b923bbe0ece70defbe,0,Ismael Juma,2016-05-19 00:47:14+01:00,['5b5f3ed0f29faa803e894fc3ee2797b3bfe5766a'],14,33,47,846483,2,,,,2360
2ce3285297a8cf20d801c7ac479603dd5926851c,1,Ismael Juma,2016-05-19 17:16:37+01:00,['9791401a778fee5a165373b923bbe0ece70defbe'],72,73,145,846628,1,,,,2360
e18bbba77fcab9667536f624f85576516aff55be,0,Ewen Cheslack-Postava,2016-05-19 09:25:06-07:00,['2ce3285297a8cf20d801c7ac479603dd5926851c'],7,0,7,846635,1,1,0,0,2360
177b2d0bea76f270ec087ebe73431307c1aef5a1,1,Guozhang Wang,2016-05-20 11:52:36-07:00,['e18bbba77fcab9667536f624f85576516aff55be'],95,110,205,846840,10,0.941176471,1,1,2360
dee38806663b0062706dfaca40da9537792f05a9,1,Ismael Juma,2016-05-22 10:01:32+01:00,['177b2d0bea76f270ec087ebe73431307c1aef5a1'],1,1,2,846842,1,,,,2360
fe27d8f787f38428e0add36edeac9d694f16af53,1,Ismael Juma,2016-05-24 09:13:40+01:00,['dee38806663b0062706dfaca40da9537792f05a9'],26,60,86,846928,3,0.85,1,0.75,2360
5f498855d9e247b07af54c6329b5b5347e469ace,1,Gwen Shapira,2016-05-24 12:53:24-07:00,['fe27d8f787f38428e0add36edeac9d694f16af53'],5,5,10,846938,2,,,,2360
98928f7ad0f556caf4b8ff4b212c946ce948d7d6,0,Gwen Shapira,2016-05-24 17:07:45-07:00,['5f498855d9e247b07af54c6329b5b5347e469ace'],2,2,4,846942,1,,,,2360
0e1c012fb551f32cf27b6b7367749047c374ee97,1,Gwen Shapira,2016-05-24 17:26:54-07:00,['98928f7ad0f556caf4b8ff4b212c946ce948d7d6'],5,4,9,846951,1,,,,2360
8c8b54ee482306652af39d3682eb7a73599503c2,0,Gwen Shapira,2016-05-24 17:32:17-07:00,['0e1c012fb551f32cf27b6b7367749047c374ee97'],1,3,4,846955,1,,,,2360
fee6f6f927b36ac74bc4a8b233711234558f3b51,1,Ismael Juma,2016-05-25 13:08:57+01:00,['8c8b54ee482306652af39d3682eb7a73599503c2'],29,98,127,847082,7,0.208333333,1,0.041666667,2360
5653249e08b1050f0e2081bf1dcc50324b3ec409,0,Gwen Shapira,2016-05-25 11:25:04-07:00,['fee6f6f927b36ac74bc4a8b233711234558f3b51'],6,14,20,847102,3,,,,2360
62dc1afb69369c64207991ba59bcd203505d37ea,1,Ismael Juma,2016-05-26 09:17:31+01:00,['5653249e08b1050f0e2081bf1dcc50324b3ec409'],13,78,91,847193,5,0.818181818,1,0.818181818,2361
be0f3502da1f703b27d7a3fae5a01325dff44957,0,Jun Rao,2016-05-26 09:50:49-07:00,['62dc1afb69369c64207991ba59bcd203505d37ea'],2,28,30,847223,2,1,1,1,2361
c699b1a914260b7d6fd84596f78128369d2bf2bf,0,Gwen Shapira,2016-05-26 09:58:59-07:00,['be0f3502da1f703b27d7a3fae5a01325dff44957'],4,4,8,847231,3,,,,2361
d5366471d2c1a611f2241362041debc0118e5422,0,Gwen Shapira,2016-05-26 10:23:24-07:00,['c699b1a914260b7d6fd84596f78128369d2bf2bf'],2,1,3,847234,1,,,,2361
3cf2de0694cf0e276d25d8c7048a9928b41969a3,0,Ewen Cheslack-Postava,2016-05-26 14:13:54-07:00,['d5366471d2c1a611f2241362041debc0118e5422'],3,20,23,847257,4,1,1,1,2362
9355427efc4c2c6d0f0d61dd956e5ad187da2dfc,0,Ewen Cheslack-Postava,2016-05-26 21:03:14-07:00,['3cf2de0694cf0e276d25d8c7048a9928b41969a3'],4,20,24,847281,1,1,1,1,2362
ebed7ce3604d32d1b502888bc188904b43e5674f,0,Ewen Cheslack-Postava,2016-05-26 23:21:20-07:00,['9355427efc4c2c6d0f0d61dd956e5ad187da2dfc'],1,0,1,847282,1,1,1,0,2362
f79db1a4234b4af75a2d027c86df62d77ba3d29e,1,Ismael Juma,2016-05-27 10:25:38+01:00,['ebed7ce3604d32d1b502888bc188904b43e5674f'],5,10,15,847297,5,,,,2362
936e26aa8db991b51141b21df234d702bc05408f,0,Ismael Juma,2016-05-27 21:35:08+01:00,['f79db1a4234b4af75a2d027c86df62d77ba3d29e'],2,2,4,847301,2,,,,2362
55225bd55ba6f9d84a2963942d52bd4d316c8274,0,Ismael Juma,2016-05-27 21:45:14+01:00,['936e26aa8db991b51141b21df234d702bc05408f'],2,2,4,847305,2,,,,2362
756ec494da75c49e6b537bd094b941c0492ec46e,0,Jun Rao,2016-05-27 15:39:07-07:00,['55225bd55ba6f9d84a2963942d52bd4d316c8274'],1,18,19,847324,2,0.769230769,1,1,2362
7b7c4a7bb0fd25ddca4e4bdde9e605b3d5a1ba70,1,Guozhang Wang,2016-05-27 18:40:11-07:00,['756ec494da75c49e6b537bd094b941c0492ec46e'],26,8,34,847358,6,,,,2362
a4802962c9e87f9cc81e1820fc88c71bd70b6666,0,Ismael Juma,2016-05-28 11:30:19+01:00,['7b7c4a7bb0fd25ddca4e4bdde9e605b3d5a1ba70'],0,15,15,847373,1,,,,2362
0aff450961a8dd14cc7820ee8d1c9eea855439b0,0,Ismael Juma,2016-05-28 23:30:10+01:00,['a4802962c9e87f9cc81e1820fc88c71bd70b6666'],21,24,45,847418,3,0,1,1,2362
404b696bea58aca17fbe528aed03cb3c94516c39,1,Ismael Juma,2016-05-29 09:01:20+01:00,['0aff450961a8dd14cc7820ee8d1c9eea855439b0'],44,45,89,847507,17,1,1,1,2362
3fd9be49ac35adaca401f58552b3ffa68f8d4eaa,0,Ewen Cheslack-Postava,2016-05-30 17:11:17-07:00,['404b696bea58aca17fbe528aed03cb3c94516c39'],9,5,14,847521,1,1,0,0,2362
fed3f1f8890b219e4247fd9de1305ad18679ff99,1,Ewen Cheslack-Postava,2016-05-31 09:03:18-07:00,['3fd9be49ac35adaca401f58552b3ffa68f8d4eaa'],34,30,64,847585,2,1,1,0,2362
fec24d19cc66e4d18cf87f0ff597eecfe5a7e000,0,Guozhang Wang,2016-06-01 08:14:36-07:00,['fed3f1f8890b219e4247fd9de1305ad18679ff99'],1,1,2,847587,1,,,,2362
61e0eaefd15a8bc158424d786ca4ec25eb6b39df,0,Ismael Juma,2016-06-02 00:49:47+01:00,['fec24d19cc66e4d18cf87f0ff597eecfe5a7e000'],1,1,2,847589,1,,,,2362
ab7325928164b0cc7c26c695ecdf431ce1d89b8d,1,Ewen Cheslack-Postava,2016-06-01 21:03:40-07:00,['61e0eaefd15a8bc158424d786ca4ec25eb6b39df'],3,3,6,847595,1,,,,2362
107205a7f17a4b1e235089668cb283bf16fbb88a,0,Ewen Cheslack-Postava,2016-06-01 21:50:45-07:00,['ab7325928164b0cc7c26c695ecdf431ce1d89b8d'],1,1,2,847597,1,,,,2362
e6ca328f80a8f7504d740c9f77dfc8b04db20324,0,Ewen Cheslack-Postava,2016-06-01 22:53:35-07:00,['107205a7f17a4b1e235089668cb283bf16fbb88a'],1,1,2,847599,1,,,,2362
245fa2bd8c08bb17c0b2b7aad4aba145d3c49783,0,Guozhang Wang,2016-06-02 15:40:35-07:00,['e6ca328f80a8f7504d740c9f77dfc8b04db20324'],5,3,8,847607,1,,,,2362
1029030466f01937d416e11f93562bcaaecce253,0,Ismael Juma,2016-06-03 01:19:46+01:00,['245fa2bd8c08bb17c0b2b7aad4aba145d3c49783'],31,33,64,847671,4,0,0,0,2362
7699b91f870f58e71dbdeddba79b58f009f9c0a2,1,Ismael Juma,2016-06-03 09:41:26+01:00,['1029030466f01937d416e11f93562bcaaecce253'],3,6,9,847680,1,0,1,0,2362
76ca6f8cc1a6533866a2bd7ca6a7d32314d21dba,1,Ismael Juma,2016-06-03 10:30:01+01:00,['7699b91f870f58e71dbdeddba79b58f009f9c0a2'],1,4,5,847685,2,,,,2362
a27030693bd89b16a436ba873192ebc98c4c7910,0,Ewen Cheslack-Postava,2016-06-03 09:33:32-07:00,['76ca6f8cc1a6533866a2bd7ca6a7d32314d21dba'],0,6,6,847691,1,,,,2362
234fa5a6949c9a5bfb4f543989c2ece84fcce033,1,Guozhang Wang,2016-06-03 13:21:40-07:00,['a27030693bd89b16a436ba873192ebc98c4c7910'],3,9,12,847703,2,1,1,1,2362
49ddc897b8feda9c4786d5bcd03814b91ede7124,1,Ismael Juma,2016-06-03 21:31:27+01:00,['234fa5a6949c9a5bfb4f543989c2ece84fcce033'],5,17,22,847725,1,1,1,1,2362
ff300c9d4f45e4a355db11258965c3a3a6f6bbf7,1,Ismael Juma,2016-06-04 09:24:45+01:00,['49ddc897b8feda9c4786d5bcd03814b91ede7124'],31,12,43,847768,2,1,1,0,2362
ab356060665b3b6502c7d531366b26e1e0f48f9c,1,Ismael Juma,2016-06-04 21:24:45+01:00,['ff300c9d4f45e4a355db11258965c3a3a6f6bbf7'],116,111,227,847995,8,0.5,1,0,2362
27cb6686fd678a1625fe3bb114e7ff0afb4f6448,0,Ismael Juma,2016-06-04 22:43:54+01:00,['ab356060665b3b6502c7d531366b26e1e0f48f9c'],1,1,2,847997,1,,,,2362
f4a263b5a89e028ad3b658dca2259b6da0197214,1,Ismael Juma,2016-06-05 08:42:42+01:00,['27cb6686fd678a1625fe3bb114e7ff0afb4f6448'],2,44,46,848043,2,1,1,1,2363
b60af34d4a200dbc5062ba40bfb7ffc7162e72d0,1,Sriharsha Chintalapani,2016-06-05 19:32:51-07:00,['f4a263b5a89e028ad3b658dca2259b6da0197214'],5,9,14,848057,2,1,1,1,2363
2c7fae0a4a2b59133e53eb02a533cf8ffd0f864c,0,Sriharsha Chintalapani,2016-06-05 19:34:54-07:00,['b60af34d4a200dbc5062ba40bfb7ffc7162e72d0'],8,7,15,848072,1,1,1,1,2363
79aaf19f24bb48f90404a3e3896d115107991f4c,1,Ismael Juma,2016-06-06 08:08:47+01:00,['2c7fae0a4a2b59133e53eb02a533cf8ffd0f864c'],392,401,793,848865,104,0.170212766,0.170212766,0.007092199,2363
0cee0c321897b4fca4409651fdf28188870cb2f0,1,Ismael Juma,2016-06-06 19:55:50+01:00,['79aaf19f24bb48f90404a3e3896d115107991f4c'],34,216,250,849115,8,0.138211382,0.959349593,0.894308943,2363
430bf56cdfa32baffad21bb37dd50c080491dc03,1,Ismael Juma,2016-06-07 00:05:33+01:00,['0cee0c321897b4fca4409651fdf28188870cb2f0'],7,10,17,849132,3,0,0,1,2363
f643d1b75d17bb27a378c7e66fcc49607454e445,0,Ismael Juma,2016-06-07 01:22:58+01:00,['430bf56cdfa32baffad21bb37dd50c080491dc03'],3,76,79,849211,3,1,1,1,2364
feab5a374a33a7b7b8e96c6a88b872c4db33dcf1,0,Ewen Cheslack-Postava,2016-06-06 20:28:31-07:00,['f643d1b75d17bb27a378c7e66fcc49607454e445'],2,12,14,849225,2,1,1,1,2364
d9f052acc396871801edee13ef0a6042a9af6626,0,Ewen Cheslack-Postava,2016-06-06 21:34:33-07:00,['feab5a374a33a7b7b8e96c6a88b872c4db33dcf1'],10,41,51,849276,2,0.833333333,0.888888889,0.888888889,2364
06a57cf19c45e82245ada886ea885087ce60ab80,0,Ewen Cheslack-Postava,2016-06-06 23:58:29-07:00,['d9f052acc396871801edee13ef0a6042a9af6626'],1,8,9,849285,1,0.5,0.5,1,2364
4b28d38ca463ff3788885a904591a5699127158a,0,Ewen Cheslack-Postava,2016-06-07 19:38:39-07:00,['06a57cf19c45e82245ada886ea885087ce60ab80'],2,14,16,849301,1,,,,2364
eb6f04a8b12194b9e13e2a28d8ffdfa971516d68,1,Ewen Cheslack-Postava,2016-06-08 09:33:45-07:00,['4b28d38ca463ff3788885a904591a5699127158a'],7,79,86,849387,2,1,1,1,2364
da8517182d2f30c4e03b33b38d41d2fa33621e24,1,Guozhang Wang,2016-06-10 13:14:05-07:00,['eb6f04a8b12194b9e13e2a28d8ffdfa971516d68'],20,61,81,849468,2,0,0.675675676,1,2364
5b88af9929c12b587796ceed7d85238206131249,0,Ewen Cheslack-Postava,2016-06-11 17:17:06-07:00,['da8517182d2f30c4e03b33b38d41d2fa33621e24'],2,2,4,849472,1,,,,2364
250981fb98113d5c693132798225e075f162d92d,0,Ewen Cheslack-Postava,2016-06-11 17:20:23-07:00,['5b88af9929c12b587796ceed7d85238206131249'],7,7,14,849486,1,,,,2364
b058fcf5ec3b818f7275d6d3591881c69033a830,0,Ewen Cheslack-Postava,2016-06-11 17:50:38-07:00,['250981fb98113d5c693132798225e075f162d92d'],1,1,2,849488,1,,,,2364
b8ea094b427768bb360d87fc0a07f670cb667e1e,1,Guozhang Wang,2016-06-13 14:15:28-07:00,['b058fcf5ec3b818f7275d6d3591881c69033a830'],47,93,140,849628,4,1,1,0,2364
b1ba54025fc872e14e1ff97fde018637826a3a5e,1,Ewen Cheslack-Postava,2016-06-14 09:50:30-07:00,['b8ea094b427768bb360d87fc0a07f670cb667e1e'],0,26,26,849654,1,,,,2364
7cc6e0e2d376c2504cf6fafd69ccd30f4c03f31f,0,Ewen Cheslack-Postava,2016-06-14 11:54:29-07:00,['b1ba54025fc872e14e1ff97fde018637826a3a5e'],1,1,2,849656,1,,,,2364
9ff54cb5dd99fab83533ddfdf0ed89508e5525fb,1,Ewen Cheslack-Postava,2016-06-14 13:21:30-07:00,['7cc6e0e2d376c2504cf6fafd69ccd30f4c03f31f'],18,67,85,849741,2,1,1,0,2364
84ca887295efbd99a6a7d7363f77d59b7a42b642,0,Sriharsha Chintalapani,2016-06-15 09:32:40-07:00,['9ff54cb5dd99fab83533ddfdf0ed89508e5525fb'],1,2,3,849744,1,1,1,1,2364
17668e81c95d89f6543657351abc0a18004ecde5,1,Ewen Cheslack-Postava,2016-06-15 12:09:03-07:00,['84ca887295efbd99a6a7d7363f77d59b7a42b642'],0,48,48,849792,2,1,1,1,2365
1ef7b494bbd937205ecd14dd30e625c2efdb3aa9,1,Guozhang Wang,2016-06-15 17:08:33-07:00,['17668e81c95d89f6543657351abc0a18004ecde5'],0,86,86,849878,7,0.625,1,1,2365
fb42558e2500835722a4e5028896ddae4f407d6f,1,Guozhang Wang,2016-06-15 19:20:43-07:00,['1ef7b494bbd937205ecd14dd30e625c2efdb3aa9'],21,664,685,850563,9,0.395136778,0.79331307,0.902735562,2366
8c551675adb11947e9f27b20a9195c9c4a20b432,1,Guozhang Wang,2016-06-15 19:46:42-07:00,['fb42558e2500835722a4e5028896ddae4f407d6f'],416,1081,1497,852060,9,0.275784753,0.903587444,0.970852018,2367
eb2619cac0849dd54db956e87781d143a57b2477,0,Ismael Juma,2016-06-16 09:10:59+02:00,['8c551675adb11947e9f27b20a9195c9c4a20b432'],3,3,6,852066,1,,,,2367
54ba2280f0c42b0bd3d74c197f97d8a12617a847,0,Ismael Juma,2016-06-16 14:34:58+02:00,['eb2619cac0849dd54db956e87781d143a57b2477'],4,62,66,852132,4,1,1,1,2367
7d9d1cb2355e33270703280ed6bb712033b03d26,1,Guozhang Wang,2016-06-16 11:56:32-07:00,['54ba2280f0c42b0bd3d74c197f97d8a12617a847'],501,1944,2445,854577,35,0.30990099,0.961386139,0.858415842,2372
f62db5dd8886f467e1de7e534a9ef3a839a08e84,1,Ismael Juma,2016-06-17 00:02:57+02:00,['7d9d1cb2355e33270703280ed6bb712033b03d26'],10,7,17,854594,2,0,0,1,2372
47f5ae9e9c902e18fc0f7f153da945de2839c3e2,1,Ismael Juma,2016-06-17 00:12:53+02:00,['f62db5dd8886f467e1de7e534a9ef3a839a08e84'],1,6,7,854601,1,0,0,1,2372
751fe9309011b99f60c1cb03c23a47d0444dce05,0,Guozhang Wang,2016-06-16 16:18:02-07:00,['47f5ae9e9c902e18fc0f7f153da945de2839c3e2'],1,16,17,854618,3,1,1,1,2372
4c6d7ed95a05e1f08e820305afbab983822e8b82,0,Ismael Juma,2016-06-17 08:51:55+02:00,['751fe9309011b99f60c1cb03c23a47d0444dce05'],4,4,8,854626,3,,,,2372
0b0925a16f6cc94ad96fbc4dc2bcf48bf96557e6,0,Guozhang Wang,2016-06-18 11:25:33-07:00,['4c6d7ed95a05e1f08e820305afbab983822e8b82'],3,3,6,854632,1,,,,2372
91135ea33a7231e9b17cfc74c78dc5223475834b,0,Guozhang Wang,2016-06-18 12:02:17-07:00,['0b0925a16f6cc94ad96fbc4dc2bcf48bf96557e6'],1,11,12,854644,2,1,1,1,2372
7fd4fe4487d328da0aab80ac658ba783ff1ebf9b,0,Ismael Juma,2016-06-19 10:42:30+02:00,['91135ea33a7231e9b17cfc74c78dc5223475834b'],9,9,18,854662,1,,,,2372
40fb90937e7ce5e9a44ab634c5987da1ab73a04f,0,Ewen Cheslack-Postava,2016-06-19 11:42:00-07:00,['7fd4fe4487d328da0aab80ac658ba783ff1ebf9b'],1,3,4,854666,1,0,0,0,2372
2c9796114d0a9638be79b4165d0096c7a63babe7,1,Ewen Cheslack-Postava,2016-06-19 15:31:04-07:00,['40fb90937e7ce5e9a44ab634c5987da1ab73a04f'],8,73,81,854747,2,0.6,0.955555556,1,2372
b9f1c60328da8a494424e30e7ebcb75d31c6fe85,1,Ewen Cheslack-Postava,2016-06-19 16:03:40-07:00,['2c9796114d0a9638be79b4165d0096c7a63babe7'],2,5,7,854754,1,,,,2372
4544ee448703b8c1900adcb7a605380eb99a00a2,0,Ewen Cheslack-Postava,2016-06-20 12:30:27-07:00,['b9f1c60328da8a494424e30e7ebcb75d31c6fe85'],2,17,19,854773,2,1,1,1,2372
44c8308ab1a6b950c5b12386d7864881b5d052a0,1,Guozhang Wang,2016-06-20 14:37:43-07:00,['4544ee448703b8c1900adcb7a605380eb99a00a2'],241,122,363,855136,7,0.738636364,0,0,2372
50781b75d8368ae67cf06d15ea11579a2aa4fb2c,0,Ewen Cheslack-Postava,2016-06-20 20:32:09-07:00,['44c8308ab1a6b950c5b12386d7864881b5d052a0'],26,53,79,855215,1,0,1,1,2372
9716768810635b75b7668730962c399048ca883e,1,Ewen Cheslack-Postava,2016-06-20 22:28:27-07:00,['50781b75d8368ae67cf06d15ea11579a2aa4fb2c'],23,134,157,855372,3,0.588235294,0.647058824,1,2372
d546aa292aa8710f4285cef4e89c75b44d24a8b0,0,Guozhang Wang,2016-06-21 12:16:52-07:00,['9716768810635b75b7668730962c399048ca883e'],3,4,7,855379,1,,,,2372
8b7dce87a744837e5b3bba41b3e3c4c408c78b7f,0,Ismael Juma,2016-06-21 22:35:01+02:00,['d546aa292aa8710f4285cef4e89c75b44d24a8b0'],0,1,1,855380,1,1,1,1,2372
10bbffd75439e10fe9db6cf0aa48a7da7e386ef3,1,Ismael Juma,2016-06-22 10:03:29+02:00,['8b7dce87a744837e5b3bba41b3e3c4c408c78b7f'],44,56,100,855480,2,1,1,0.1,2372
8bf18df1b6584d95a850a846b26046c2b79531b7,0,Sriharsha Chintalapani,2016-06-22 15:26:39-07:00,['10bbffd75439e10fe9db6cf0aa48a7da7e386ef3'],1,1,2,855482,1,,,,2372
36cab7dbdff6981d0df4b355dadee3fac35508a6,1,Ewen Cheslack-Postava,2016-06-22 17:06:49-07:00,['8bf18df1b6584d95a850a846b26046c2b79531b7'],7,554,561,856043,11,0.864978903,1,0.831223629,2377
8ec4e4b7a37164a1189a74815decb1d6f6410963,1,Guozhang Wang,2016-06-23 14:16:42-07:00,['36cab7dbdff6981d0df4b355dadee3fac35508a6'],37,145,182,856225,7,0.489795918,0.93877551,0.816326531,2378
41a54358bececc42ba680267281ba01b3f33f77f,0,Guozhang Wang,2016-06-23 14:36:38-07:00,['8ec4e4b7a37164a1189a74815decb1d6f6410963'],1,1,2,856227,1,,,,2378
6cd031e7cf189ed7748c5c62fc17dc097dcfde18,0,Guozhang Wang,2016-06-23 14:42:20-07:00,['41a54358bececc42ba680267281ba01b3f33f77f'],1,1,2,856229,1,,,,2378
ef42c224a701161a15e046de73c11982024bbc53,0,Gwen Shapira,2016-06-23 15:05:11-07:00,['6cd031e7cf189ed7748c5c62fc17dc097dcfde18'],5,10,15,856244,1,0.8,1,1,2378
88924b03d511132212ee5d8dec02063deb8313f1,1,Guozhang Wang,2016-06-24 13:42:53-07:00,['ef42c224a701161a15e046de73c11982024bbc53'],172,236,408,856652,12,1,1,0,2380
54f9a7012c05f3e2993463727d7e199e8589e68e,0,Ewen Cheslack-Postava,2016-06-24 14:16:50-07:00,['88924b03d511132212ee5d8dec02063deb8313f1'],2,2,4,856656,1,,,,2380
0e0b632b926f52451495ab254e74ab87848cb353,0,Guozhang Wang,2016-06-24 14:46:39-07:00,['54f9a7012c05f3e2993463727d7e199e8589e68e'],2,8,10,856666,1,,,,2380
10abe858bd892863f1d01c29bfb6d0f4206de2d3,0,Guozhang Wang,2016-06-27 11:50:44-07:00,['0e0b632b926f52451495ab254e74ab87848cb353'],5,12,17,856683,1,1,1,1,2380
cf03f349caa92592ec42c7864b7f9d9ef21fee94,0,Ismael Juma,2016-06-29 22:58:45+02:00,['10abe858bd892863f1d01c29bfb6d0f4206de2d3'],10,13,23,856706,3,1,0,0,2380
96ae0a5929bcd784dc632ddadf083bbedababbb6,1,Guozhang Wang,2016-06-29 15:17:04-07:00,['cf03f349caa92592ec42c7864b7f9d9ef21fee94'],49,49,98,856804,9,0,0,0,2380
a34f78dcad1d7844a21d0afbf0f6eef183847d0d,1,Guozhang Wang,2016-06-29 15:19:47-07:00,['96ae0a5929bcd784dc632ddadf083bbedababbb6'],0,36,36,856840,2,0,0.107142857,0.464285714,2380
7e9f5a7ee6dfe22107c8cc3c9f57daa288d6c392,1,Guozhang Wang,2016-06-30 10:50:51-07:00,['a34f78dcad1d7844a21d0afbf0f6eef183847d0d'],20,26,46,856886,2,1,1,1,2380
7d6b416f9e75f1d9f886b9b43637c488667222e1,1,Guozhang Wang,2016-06-30 11:10:16-07:00,['7e9f5a7ee6dfe22107c8cc3c9f57daa288d6c392'],0,70,70,856956,5,0.142857143,1,0.928571429,2380
3605ffa30602ebf9373b47f92f2a9f399a4a36db,1,Guozhang Wang,2016-06-30 11:12:34-07:00,['7d6b416f9e75f1d9f886b9b43637c488667222e1'],15,16,31,856987,1,0,,0,2380
44ad7b574e376f958cf1d3893156d666f904cdd3,1,Ewen Cheslack-Postava,2016-06-30 13:59:31-07:00,['3605ffa30602ebf9373b47f92f2a9f399a4a36db'],17,133,150,857137,8,0.767123288,0.98630137,0.589041096,2380
7edaa3dd89d1a7300a12e101e23f66459a9cc33d,0,Ewen Cheslack-Postava,2016-06-30 21:16:13-07:00,['44ad7b574e376f958cf1d3893156d666f904cdd3'],28,36,64,857201,6,1,1,0.833333333,2380
5a97304170a697cb08f1c8d455d6661a37f92196,0,Ewen Cheslack-Postava,2016-07-01 11:47:58-07:00,['7edaa3dd89d1a7300a12e101e23f66459a9cc33d'],10,5,15,857216,5,,,,2380
2098529b44cad78731e478aa8af2b49e9c94db7d,1,Guozhang Wang,2016-07-01 16:47:10-07:00,['5a97304170a697cb08f1c8d455d6661a37f92196'],2,46,48,857264,3,0.2,1,1,2380
32e24b7c28e357c051bbe21b08c4e8c6d45a3907,0,Ismael Juma,2016-07-02 02:09:01+01:00,['2098529b44cad78731e478aa8af2b49e9c94db7d'],1,0,1,857265,1,,,,2380
f1323d4ffa451b8c7965d51f422f0933f35ff828,0,Ismael Juma,2016-07-02 02:11:42+01:00,['32e24b7c28e357c051bbe21b08c4e8c6d45a3907'],4,5,9,857274,1,,,,2380
0f8b6790351cb6b078ad3ec73e8d36f5bb3ad270,0,Ismael Juma,2016-07-02 02:20:42+01:00,['f1323d4ffa451b8c7965d51f422f0933f35ff828'],1,1,2,857276,1,,,,2380
31b4460cf9a520bd019ed98949ebfa9243e6e4a6,0,Ismael Juma,2016-07-02 02:26:33+01:00,['0f8b6790351cb6b078ad3ec73e8d36f5bb3ad270'],1,1,2,857278,1,,,,2380
d7de59a579af5ba4ecb1aec8fed84054f8b86443,1,Ewen Cheslack-Postava,2016-07-04 14:09:30-07:00,['31b4460cf9a520bd019ed98949ebfa9243e6e4a6'],12,113,125,857403,3,0.133333333,1,1,2380
87b3ce16c05eb105f1ee0da26b090e02b6c18678,1,Guozhang Wang,2016-07-04 19:56:09-07:00,['d7de59a579af5ba4ecb1aec8fed84054f8b86443'],6,22,28,857431,1,,,,2380
12fa188b9aaeafa337c813f4a84a3117d6bf403f,1,Guozhang Wang,2016-07-05 09:16:45-07:00,['87b3ce16c05eb105f1ee0da26b090e02b6c18678'],18,15,33,857464,2,0,0,0,2380
416c3a7d97d473d0d9928c814d68d502c21077b7,1,Guozhang Wang,2016-07-05 09:30:40-07:00,['12fa188b9aaeafa337c813f4a84a3117d6bf403f'],8,6,14,857478,2,,,,2380
dca263b4e00b00983a4b9f74517b25b01492a4c6,1,Guozhang Wang,2016-07-05 11:38:15-07:00,['416c3a7d97d473d0d9928c814d68d502c21077b7'],2,2,4,857482,1,,,,2380
15e008783cf73dcaed851fe6cc587767031886e5,0,Ismael Juma,2016-07-06 14:33:07+01:00,['dca263b4e00b00983a4b9f74517b25b01492a4c6'],8,79,87,857569,2,1,1,1,2380
b64302f9cea0e3e95d740cbe7bbd4c64e147301c,1,Guozhang Wang,2016-07-06 10:46:36-07:00,['15e008783cf73dcaed851fe6cc587767031886e5'],36,213,249,857818,6,0.627906977,1,0.465116279,2380
7218648ae7ac1ce93f3ff25702b99c3af236fd0f,1,Guozhang Wang,2016-07-06 12:27:10-07:00,['b64302f9cea0e3e95d740cbe7bbd4c64e147301c'],8,21,29,857847,2,0,1,1,2380
efc4c88811c93d11eeffe61310b7f8652ca73ceb,1,Guozhang Wang,2016-07-06 12:32:09-07:00,['7218648ae7ac1ce93f3ff25702b99c3af236fd0f'],23,37,60,857907,1,0,1,1,2380
730bf9a37a08b2ca41dcda52d2c70e92e85980f7,1,Guozhang Wang,2016-07-08 08:36:20-07:00,['efc4c88811c93d11eeffe61310b7f8652ca73ceb'],3,4,7,857914,2,,,,2380
542350d616e4638958d133d1d5599acf8546ed06,1,Ewen Cheslack-Postava,2016-07-08 10:56:58-07:00,['730bf9a37a08b2ca41dcda52d2c70e92e85980f7'],2,248,250,858164,4,0.297029703,1,1,2382
0edaa89be35ad427b848e0d91164422871853640,0,Jun Rao,2016-07-08 16:18:22-07:00,['542350d616e4638958d133d1d5599acf8546ed06'],24,29,53,858217,2,0,0,0.333333333,2382
4b5ed36c2264808c33f92ccfdc456a19af3471bd,0,Ismael Juma,2016-07-09 02:04:52+01:00,['0edaa89be35ad427b848e0d91164422871853640'],1,3,4,858221,1,,,,2382
c2459d3251cec538755b08ac35a742df5e3f2a76,1,Ismael Juma,2016-07-09 02:07:46+01:00,['4b5ed36c2264808c33f92ccfdc456a19af3471bd'],3,2,5,858226,1,,,,2382
a5da2a4f4c3b9d1917cbafc0e79d8e8318f7cbff,0,Ismael Juma,2016-07-09 02:09:14+01:00,['c2459d3251cec538755b08ac35a742df5e3f2a76'],4,4,8,858234,3,,,,2382
2dfbf4b5fdd7698a83a1c3d078a846f3674235f4,0,Ismael Juma,2016-07-09 02:32:38+01:00,['a5da2a4f4c3b9d1917cbafc0e79d8e8318f7cbff'],2,7,9,858243,1,,,,2382
f8a7ace9d4e508d29d664418446c37783a82cb3b,1,Gwen Shapira,2016-07-10 21:23:14-07:00,['2dfbf4b5fdd7698a83a1c3d078a846f3674235f4'],4,20,24,858267,1,,,,2382
e0eaa7f12e5e90b61b6793301053acad50cbd9ab,1,Ismael Juma,2016-07-11 09:01:04+01:00,['f8a7ace9d4e508d29d664418446c37783a82cb3b'],4,16,20,858287,1,,,,2382
383cec9cf38607cdfbda0256d3447d253dcdde7d,1,Ismael Juma,2016-07-11 09:19:33+01:00,['e0eaa7f12e5e90b61b6793301053acad50cbd9ab'],14,6,20,858307,4,1,1,1,2382
c439268224e3178002bfa28bc048722870f992e3,1,Ismael Juma,2016-07-11 17:06:59+01:00,['383cec9cf38607cdfbda0256d3447d253dcdde7d'],13,93,106,858413,3,0.111111111,0.911111111,1,2382
136a8fabca8e266f67897cf5471b2e41c0a341be,1,Guozhang Wang,2016-07-11 13:57:02-07:00,['c439268224e3178002bfa28bc048722870f992e3'],564,95,659,859072,11,0.975124378,0,0,2382
fc47b9fa6b89a612cd0f79dfc689ee3813fd405a,1,Jun Rao,2016-07-12 08:21:19-07:00,['136a8fabca8e266f67897cf5471b2e41c0a341be'],71,1197,1268,860340,35,0.484848485,0.820075758,0.857954545,2391
98dfc4b307c2e41a7fb0fff330048aa9ff78addd,0,Guozhang Wang,2016-07-12 11:31:39-07:00,['fc47b9fa6b89a612cd0f79dfc689ee3813fd405a'],1,11,12,860352,1,1,1,1,2391
3537063a52b97b6d46f6bd17e3f03e1b03630a3e,0,Guozhang Wang,2016-07-12 12:15:16-07:00,['98dfc4b307c2e41a7fb0fff330048aa9ff78addd'],2,2,4,860356,1,,0,,2391
f17790cd9952aecef67fbec58122c55c72e5c2b2,1,Guozhang Wang,2016-07-13 18:11:25-07:00,['3537063a52b97b6d46f6bd17e3f03e1b03630a3e'],47,84,131,860487,9,1,1,0,2391
9f94a7752a590c36186a7eb1eee16e992ec68c97,1,Ismael Juma,2016-07-14 10:44:58+01:00,['f17790cd9952aecef67fbec58122c55c72e5c2b2'],7,136,143,860630,2,0.552083333,0.552083333,1,2391
7a70c1a1087ca78d5e6db3908f6d6b6b19e8aaab,0,Guozhang Wang,2016-07-15 10:08:48-07:00,['9f94a7752a590c36186a7eb1eee16e992ec68c97'],2,1,3,860633,1,,,,2391
fbc5185543fd4895c7c81ff55b3c8b4c25ac7600,1,Guozhang Wang,2016-07-18 12:12:51-07:00,['7a70c1a1087ca78d5e6db3908f6d6b6b19e8aaab'],344,431,775,861408,39,0,0,0,2391
61c568d8391de6fceb6c8d6a33d349def8d2ada8,1,Guozhang Wang,2016-07-18 12:16:58-07:00,['fbc5185543fd4895c7c81ff55b3c8b4c25ac7600'],5,184,189,861597,3,0.765432099,0.87654321,0.839506173,2393
7354cc1f487cea5c0422c8e80c3aed244321dbfd,1,Ismael Juma,2016-07-19 10:10:25+01:00,['61c568d8391de6fceb6c8d6a33d349def8d2ada8'],8,8,16,861613,1,,,,2393
0744449eaa0f80827b60f2be3a5a2cc306360ce7,0,Ismael Juma,2016-07-19 10:20:13+01:00,['7354cc1f487cea5c0422c8e80c3aed244321dbfd'],1,1,2,861615,1,,,,2393
114945cb6297f909a7b1272bd61e17b662d42d24,1,Guozhang Wang,2016-07-19 08:44:48-07:00,['0744449eaa0f80827b60f2be3a5a2cc306360ce7'],23,23,46,861661,1,,,,2393
b418922a3b48bef9d890abb471908ab2a8aeba18,1,Guozhang Wang,2016-07-19 10:56:12-07:00,['114945cb6297f909a7b1272bd61e17b662d42d24'],0,6,6,861667,1,1,1,1,2393
f1dd0d272313deceaf7021e54c09a63043acf4af,1,Guozhang Wang,2016-07-19 14:02:21-07:00,['b418922a3b48bef9d890abb471908ab2a8aeba18'],167,2380,2547,864214,40,0.665961945,0.934460888,0.873150106,2415
cfebfdfa5e537946e4c6e1cc986f20131899be31,0,Guozhang Wang,2016-07-19 15:45:12-07:00,['f1dd0d272313deceaf7021e54c09a63043acf4af'],1,3,4,864218,1,,,,2415
14934157df7aaf5e9c37a302ef9fd9317b95efa4,1,Guozhang Wang,2016-07-19 16:00:48-07:00,['cfebfdfa5e537946e4c6e1cc986f20131899be31'],657,850,1507,865725,12,1,0.813953488,1,2417
72c6b7d84a6f1bdece804d7e42642b7505c4a4eb,1,Guozhang Wang,2016-07-19 16:54:51-07:00,['14934157df7aaf5e9c37a302ef9fd9317b95efa4'],3,7,10,865735,1,0,1,1,2417
9cad9dbdac273e8fe893b0cbe4f0f22d4271fb7b,0,Gwen Shapira,2016-07-19 19:04:24-07:00,['72c6b7d84a6f1bdece804d7e42642b7505c4a4eb'],32,25,57,865792,4,1,0,0.142857143,2417
0d19f58850282d16c14fd4abd04663eae817d012,1,Guozhang Wang,2016-07-20 12:49:29-07:00,['9cad9dbdac273e8fe893b0cbe4f0f22d4271fb7b'],75,142,217,866009,3,0.75,1,1,2417
e5a0d139861b58589233e2bcd3a10e9fb032ddbc,0,Ismael Juma,2016-07-21 00:49:24+01:00,['0d19f58850282d16c14fd4abd04663eae817d012'],2,4,6,866015,2,0,0,1,2417
0e5700fb68671f3fb75bfdeceda40e84330aca69,1,Ismael Juma,2016-07-21 01:00:33+01:00,['e5a0d139861b58589233e2bcd3a10e9fb032ddbc'],74,81,155,866170,12,,,1,2418
9991086671b0a74bc5fd5698ba81aaf9a2985404,1,Guozhang Wang,2016-07-21 11:04:08-07:00,['0e5700fb68671f3fb75bfdeceda40e84330aca69'],8,111,119,866289,7,0.913043478,1,0.869565217,2419
933a7506efb57add31a1e9dbd984c1230128b855,1,Guozhang Wang,2016-07-21 13:11:53-07:00,['9991086671b0a74bc5fd5698ba81aaf9a2985404'],21,228,249,866538,15,0.535433071,0.94488189,0.913385827,2419
1ccab26a325e6ee23396049a24a5b6eb4b7a1c8e,1,Guozhang Wang,2016-07-21 14:44:59-07:00,['933a7506efb57add31a1e9dbd984c1230128b855'],44,104,148,866686,14,0.242424242,0.727272727,0.727272727,2419
44723caec74067aee9b06836b048465f4cffc431,0,Guozhang Wang,2016-07-21 16:11:20-07:00,['1ccab26a325e6ee23396049a24a5b6eb4b7a1c8e'],1,1,2,866688,1,,,,2419
f1b37eec7422fde2e9240ff56b031b6958887176,0,Ismael Juma,2016-07-22 00:18:48+01:00,['44723caec74067aee9b06836b048465f4cffc431'],10,17,27,866715,3,0,0,0,2420
f5df13627aaa6052a19e4cd7896e94730dac7f64,0,Ewen Cheslack-Postava,2016-07-21 20:09:03-07:00,['f1b37eec7422fde2e9240ff56b031b6958887176'],6,9,15,866730,1,1,1,0,2420
1ef7672ed6333c02cb0fb8096e5a700b1ef38ce1,1,Ewen Cheslack-Postava,2016-07-21 21:32:54-07:00,['f5df13627aaa6052a19e4cd7896e94730dac7f64'],1,1,2,866732,1,,,,2420
427e638517d2efedb7e7cb1387b1c59363cda21d,0,Ismael Juma,2016-07-22 17:58:24+01:00,['1ef7672ed6333c02cb0fb8096e5a700b1ef38ce1'],32,12,44,866776,2,0,0,0,2420
fa32545442ef6724aa9fb5f4e0e269b0c873288f,0,Ismael Juma,2016-07-22 18:09:38+01:00,['427e638517d2efedb7e7cb1387b1c59363cda21d'],2,2,4,866780,1,,,,2420
932bb84c837807eeca3600007ae3030561fdcb37,1,Ismael Juma,2016-07-23 09:31:16+01:00,['fa32545442ef6724aa9fb5f4e0e269b0c873288f'],0,61,61,866841,3,0.227272727,1,1,2420
aebab7cab6af88f777c1fb83604a1573554549a9,0,Ewen Cheslack-Postava,2016-07-25 11:04:00-07:00,['932bb84c837807eeca3600007ae3030561fdcb37'],4,4,8,866849,1,,,,2420
8a417c89d2f0b7861b2dec26f02e4e302b64b604,0,Ismael Juma,2016-07-26 02:41:46+01:00,['aebab7cab6af88f777c1fb83604a1573554549a9'],35,34,69,866918,1,1,1,0,2420
d1546960de0aa43989680a59c8f6b1ae7cb333e9,1,Ismael Juma,2016-07-26 03:02:02+01:00,['8a417c89d2f0b7861b2dec26f02e4e302b64b604'],3,34,37,866955,4,0.857142857,1,1,2420
801fee89d801e6d222c7b1b76a97847ecc9f10ff,0,Ismael Juma,2016-07-26 03:04:13+01:00,['d1546960de0aa43989680a59c8f6b1ae7cb333e9'],26,4,30,866985,20,,,,2420
1e1c164cfa58d225c38de9f8aea3c666a9464808,1,Ismael Juma,2016-07-27 00:40:42+01:00,['801fee89d801e6d222c7b1b76a97847ecc9f10ff'],4,7,11,866996,1,0.333333333,0.666666667,0,2420
4059f07216a07db0cdd88b46db40914069171838,1,Gwen Shapira,2016-07-26 19:43:32-07:00,['1e1c164cfa58d225c38de9f8aea3c666a9464808'],2,76,78,867074,2,0.053571429,1,1,2420
64842f47f8ad21c942be2e2dd1edb56e3bc76cb8,0,Jun Rao,2016-07-27 07:51:40-07:00,['4059f07216a07db0cdd88b46db40914069171838'],16,96,112,867186,5,1,1,0.980392157,2420
d58c2d9ac6047b14ab22e19c9f7c857bb85a970d,1,Jun Rao,2016-07-27 08:22:23-07:00,['64842f47f8ad21c942be2e2dd1edb56e3bc76cb8'],2,2,4,867190,1,,,,2420
8deedcacb68ff8ebae802e086ff706ad7e5f38e9,1,Guozhang Wang,2016-07-27 14:11:40-07:00,['d58c2d9ac6047b14ab22e19c9f7c857bb85a970d'],60,709,769,867959,8,0.058355438,0.811671088,0.99734748,2423
d5c821c198dcfbc69bd393c7725f93b22b479bca,0,Ismael Juma,2016-07-27 23:54:04+01:00,['8deedcacb68ff8ebae802e086ff706ad7e5f38e9'],0,84,84,868043,1,1,1,0.470588235,2424
ff557f02ac628edbe220ea69888d39de834527d3,1,Ismael Juma,2016-07-28 11:18:25+01:00,['d5c821c198dcfbc69bd393c7725f93b22b479bca'],176,310,486,868529,4,0.125,0.420454545,0.659090909,2424
6e8c6f17f5ccdcc12f6d568a15af7c3ee893e22c,0,Ismael Juma,2016-07-28 12:50:20+01:00,['ff557f02ac628edbe220ea69888d39de834527d3'],0,15,15,868544,1,,,,2424
131f96868aa24f38f69ee2ab769ea3f289e5c1fc,1,Ismael Juma,2016-07-28 21:36:30+01:00,['6e8c6f17f5ccdcc12f6d568a15af7c3ee893e22c'],4,3,7,868551,2,,,,2424
071b76cc50b4f79c839306f40eb84ee2b9724ab2,0,Ewen Cheslack-Postava,2016-07-28 13:48:04-07:00,['131f96868aa24f38f69ee2ab769ea3f289e5c1fc'],13,16,29,868580,1,,,,2424
38c65a9a39081068e05e3222ccb0dbc3c9f56942,1,Ismael Juma,2016-07-29 00:01:48+01:00,['071b76cc50b4f79c839306f40eb84ee2b9724ab2'],6,9,15,868595,1,0.5,1,1,2424
31264f69796b5b2f803bb6daeac7ecd76acd6f99,0,Gwen Shapira,2016-07-29 15:53:58-07:00,['38c65a9a39081068e05e3222ccb0dbc3c9f56942'],2,2,4,868599,2,,,,2424
cd767aee45fd522fb8dbbd911a5a82fc0f9d2623,0,Ismael Juma,2016-07-31 22:43:46+01:00,['31264f69796b5b2f803bb6daeac7ecd76acd6f99'],3,2,5,868604,3,,,,2424
2a9f7af6c28ace1fc0bf8f64127e39b7ec13940a,0,Gwen Shapira,2016-08-01 09:08:18-07:00,['cd767aee45fd522fb8dbbd911a5a82fc0f9d2623'],1,1,2,868606,1,,,,2424
f7976d2fc1793d0f635b42eb4dca3810e40c4cc8,1,Ewen Cheslack-Postava,2016-08-01 20:12:38-07:00,['2a9f7af6c28ace1fc0bf8f64127e39b7ec13940a'],15,21,36,868642,6,,,,2424
3bb38d37b7a3fe2dc794c717df1d67e8f9a8af21,1,Ismael Juma,2016-08-02 12:57:26+01:00,['f7976d2fc1793d0f635b42eb4dca3810e40c4cc8'],7,14,21,868663,1,,,,2424
bb629f2243c4462db2a863793c190d734f11f3c6,1,Guozhang Wang,2016-08-02 14:14:52-07:00,['3bb38d37b7a3fe2dc794c717df1d67e8f9a8af21'],8,139,147,868810,2,0.983870968,1,0.983870968,2424
e62dd4cb770e3662524d4f2f50547549e3ab2eaf,0,Guozhang Wang,2016-08-02 14:30:12-07:00,['bb629f2243c4462db2a863793c190d734f11f3c6'],34,32,66,868876,1,1,0,0,2424
c840f2a95c2e247c384315846067daa839df77a7,1,Guozhang Wang,2016-08-02 14:33:50-07:00,['e62dd4cb770e3662524d4f2f50547549e3ab2eaf'],10,6,16,868892,1,0,0,0,2424
416817920bcc0a5f74ddf5231505160a68c7d2db,1,Guozhang Wang,2016-08-02 14:41:18-07:00,['c840f2a95c2e247c384315846067daa839df77a7'],19,21,40,868932,3,,,,2424
c89707f315a6fe654b764840a49cdf5d9bbcfc90,1,Ismael Juma,2016-08-03 10:15:36+01:00,['416817920bcc0a5f74ddf5231505160a68c7d2db'],2,20,22,868954,1,,,,2424
227c54fa9e240b7a7f060c2bbbb849379be0d072,1,Ismael Juma,2016-08-03 10:56:06+01:00,['c89707f315a6fe654b764840a49cdf5d9bbcfc90'],4,4,8,868962,1,,,,2424
7d513055671664433a783e4a62e9cbad6c44fc83,0,Guozhang Wang,2016-08-03 14:01:48-07:00,['227c54fa9e240b7a7f060c2bbbb849379be0d072'],1,1,2,868964,1,,,,2424
27fc11d1c9b1ec8c63a991cb8c481f95eddb850b,1,Guozhang Wang,2016-08-03 15:24:36-07:00,['7d513055671664433a783e4a62e9cbad6c44fc83'],21,21,42,869006,9,,,,2424
2e3722a234df5c0cd2e91c258cc0e4d825ee0626,1,Ismael Juma,2016-08-04 02:03:57+01:00,['27fc11d1c9b1ec8c63a991cb8c481f95eddb850b'],0,3,3,869009,1,,,,2424
6fb33afff976e467bfa8e0b29eb82770a2a3aaec,1,Ismael Juma,2016-08-04 12:30:24+01:00,['2e3722a234df5c0cd2e91c258cc0e4d825ee0626'],8,17,25,869034,2,0,0.142857143,0.142857143,2424
3dafb81da788294d4c2e9811f49437608e5b9ce8,0,Guozhang Wang,2016-08-05 10:03:22-07:00,['6fb33afff976e467bfa8e0b29eb82770a2a3aaec'],13,77,90,869124,2,0,1,1,2424
778fcd0e9192c8de4c17f23189029d5c1bf98e2a,1,Ewen Cheslack-Postava,2016-08-06 18:14:53-07:00,['3dafb81da788294d4c2e9811f49437608e5b9ce8'],179,212,391,869515,5,0.885714286,1,0.4,2424
8d303d0d389a1dfda93224ae6cc8b426ed6750fb,0,Ewen Cheslack-Postava,2016-08-06 21:11:54-07:00,['778fcd0e9192c8de4c17f23189029d5c1bf98e2a'],3,0,3,869518,1,0,0,0,2424
29f44e75cd4ade107b169dbf43bbcb191013e75f,0,Ewen Cheslack-Postava,2016-08-06 21:59:22-07:00,['8d303d0d389a1dfda93224ae6cc8b426ed6750fb'],2,2,4,869522,1,,,,2424
6b2564811a6137f1fe639dee236f2538bb7160b1,0,Ewen Cheslack-Postava,2016-08-07 14:29:03-07:00,['29f44e75cd4ade107b169dbf43bbcb191013e75f'],91,314,405,869927,3,,,,2424
7b7f57df6229c02482e5176f2f265e7a890de2a3,1,Ismael Juma,2016-08-09 01:34:04+01:00,['6b2564811a6137f1fe639dee236f2538bb7160b1'],2,5,7,869934,1,1,1,1,2424
91b4e3c00d84bf05387d55869062a2f988a8a4eb,0,Ismael Juma,2016-08-09 02:12:22+01:00,['7b7f57df6229c02482e5176f2f265e7a890de2a3'],1,1,2,869936,1,,,,2424
da015585a94755d2e499e6fa4723cf1397404e7f,0,Ewen Cheslack-Postava,2016-08-08 19:46:08-07:00,['91b4e3c00d84bf05387d55869062a2f988a8a4eb'],14,14,28,869964,2,1,1,0,2424
fb65ff40a8d89bc7ad9b079cf1f2a8b902abd182,1,Ewen Cheslack-Postava,2016-08-08 20:33:59-07:00,['da015585a94755d2e499e6fa4723cf1397404e7f'],145,148,293,870257,33,0,0.913043478,0.652173913,2424
cb7af0b7fb546cee7a3761b9a80078948f699b33,0,Ewen Cheslack-Postava,2016-08-09 08:33:53-07:00,['fb65ff40a8d89bc7ad9b079cf1f2a8b902abd182'],4,19,23,870280,1,,,,2424
15722745831b6373817ca156b6d18b8dc1ee9de1,0,Ewen Cheslack-Postava,2016-08-09 09:16:17-07:00,['cb7af0b7fb546cee7a3761b9a80078948f699b33'],6,6,12,870292,2,,,,2424
8abcece40aea8860bd0c2feb25d2a91db529cc29,0,Guozhang Wang,2016-08-09 11:27:57-07:00,['15722745831b6373817ca156b6d18b8dc1ee9de1'],1,1,2,870294,1,,,,2424
caa9bd0fcd2fab4758791408e2b145532153910e,1,Guozhang Wang,2016-08-09 11:31:04-07:00,['8abcece40aea8860bd0c2feb25d2a91db529cc29'],5,540,545,870839,12,0.88852459,0.967213115,0.881967213,2426
68b5d014fa3bf2e18da253ded2bbcd4f5d4a9d8d,1,Guozhang Wang,2016-08-10 14:25:23-07:00,['caa9bd0fcd2fab4758791408e2b145532153910e'],222,1599,1821,872660,25,0.566666667,0.897435897,0.841025641,2432
39431f7347d994f18878d199cc268ee7cdcf063d,0,Ismael Juma,2016-08-12 12:06:58+01:00,['68b5d014fa3bf2e18da253ded2bbcd4f5d4a9d8d'],1,5,6,872666,1,1,0,1,2432
208ecae23994812d2a707b776de6b95d9f591bb7,1,Gwen Shapira,2016-08-12 14:06:37-07:00,['39431f7347d994f18878d199cc268ee7cdcf063d'],10,28,38,872704,3,0.466666667,1,0.266666667,2432
539633ba0eba452960a4d2a3bf07abd79020b329,1,Jun Rao,2016-08-12 14:26:46-07:00,['208ecae23994812d2a707b776de6b95d9f591bb7'],153,668,821,873525,16,0.566539924,0.874524715,0.878326996,2436
b18c3f5caba51a07ec514b5d04bca8b85bae3748,0,Ismael Juma,2016-08-12 22:57:17+01:00,['539633ba0eba452960a4d2a3bf07abd79020b329'],1,6,7,873532,1,1,1,1,2436
fc55f804e1b66a5ced14841d05e03f60cce65c63,0,Ismael Juma,2016-08-12 23:02:49+01:00,['b18c3f5caba51a07ec514b5d04bca8b85bae3748'],1,1,2,873534,1,,,,2436
be36b322749003581474e2c84a3ec9ba2aaec53c,1,Ismael Juma,2016-08-12 23:26:41+01:00,['fc55f804e1b66a5ced14841d05e03f60cce65c63'],19,147,166,873700,8,0.337209302,0.988372093,1,2436
e615d0be78decbc6fe2f508d5ab83fb3e05d6dc6,0,Jun Rao,2016-08-12 18:11:43-07:00,['be36b322749003581474e2c84a3ec9ba2aaec53c'],2,1,3,873703,1,,,,2436
e49b3aee6b25b9b26275849c693d5dec41d6cf68,0,Sriharsha Chintalapani,2016-08-14 10:00:08-07:00,['e615d0be78decbc6fe2f508d5ab83fb3e05d6dc6'],2,2,4,873707,2,,,,2436
ae237be1bbfd7d1b84a5095491a6131cd3cc9346,1,Ewen Cheslack-Postava,2016-08-16 10:43:12-07:00,['e49b3aee6b25b9b26275849c693d5dec41d6cf68'],81,123,204,873911,8,1,0,1,2436
11f1801c3b637ac1d355b8e35f9f879f3b946517,0,Ewen Cheslack-Postava,2016-08-16 11:35:11-07:00,['ae237be1bbfd7d1b84a5095491a6131cd3cc9346'],0,6,6,873917,1,0,1,1,2436
19997ede08bffeb95d17b2c41066e8943a391034,1,Jun Rao,2016-08-17 08:05:18-07:00,['11f1801c3b637ac1d355b8e35f9f879f3b946517'],0,6,6,873923,1,0,0,1,2436
40b1dd3f495a59abef8a0cba5450526994c92c04,1,Guozhang Wang,2016-08-17 11:50:04-07:00,['19997ede08bffeb95d17b2c41066e8943a391034'],1281,1686,2967,876890,43,0.404761905,0.376984127,0.575396825,2436
9af2e69ef4323dc6c8daf479226f25cc821b1bb6,0,Ismael Juma,2016-08-18 12:31:50+01:00,['40b1dd3f495a59abef8a0cba5450526994c92c04'],1,2,3,876893,1,,,,2436
59cfa84801c67de9729385a8f9b536721e0c37b9,1,Ewen Cheslack-Postava,2016-08-18 15:29:56-07:00,['9af2e69ef4323dc6c8daf479226f25cc821b1bb6'],38,46,84,876977,3,1,1,0,2436
c6e6fadeed3e060da34b0fc7ec4c8540f8dffa90,1,Gwen Shapira,2016-08-18 20:39:57-07:00,['59cfa84801c67de9729385a8f9b536721e0c37b9'],2,3,5,876982,1,,,,2436
e3ede843443ddb98b249d8ce1d111cc18aec6ed5,0,Gwen Shapira,2016-08-18 20:50:20-07:00,['c6e6fadeed3e060da34b0fc7ec4c8540f8dffa90'],1,1,2,876984,1,,,,2436
05ed54bf2b80691d413dbfa05065eb3afe33972f,1,Gwen Shapira,2016-08-18 20:56:31-07:00,['e3ede843443ddb98b249d8ce1d111cc18aec6ed5'],99,272,371,877355,14,0.106382979,0.680851064,1,2436
79d3fd2bf0e5c89ff74a2988c403882ae8a9852e,1,Jun Rao,2016-08-19 10:07:07-07:00,['05ed54bf2b80691d413dbfa05065eb3afe33972f'],475,1607,2082,879437,23,0.312091503,0.565359477,0.745098039,2439
104d2154b635c50efc80331ee2a4779cc3658414,1,Joel Koshy,2016-08-19 11:05:39-07:00,['79d3fd2bf0e5c89ff74a2988c403882ae8a9852e'],3,47,50,879487,7,0.473684211,0.526315789,1,2439
880bde5ac5644c904eacc1c4a53159a58d107254,1,Gwen Shapira,2016-08-19 11:29:54-07:00,['104d2154b635c50efc80331ee2a4779cc3658414'],1,1,2,879489,1,,,,2439
33447cb4beb8dd710a20556a6a2baf8307f03860,0,Gwen Shapira,2016-08-19 11:59:11-07:00,['880bde5ac5644c904eacc1c4a53159a58d107254'],6,6,12,879501,1,,,,2439
c5d26c4829583c95af7ca9e961a4d3954f8e09eb,1,Guozhang Wang,2016-08-19 15:23:30-07:00,['33447cb4beb8dd710a20556a6a2baf8307f03860'],63,270,333,879834,3,0.725806452,0.661290323,0.435483871,2439
317c4fdede41f2026b34f473af1ad69f8ee62a1d,1,Guozhang Wang,2016-08-19 21:59:55-07:00,['c5d26c4829583c95af7ca9e961a4d3954f8e09eb'],308,354,662,880496,11,1,1,1,2439
113d23e8fe290878120c1384b580181169777f4f,1,Jun Rao,2016-08-22 10:34:01-07:00,['317c4fdede41f2026b34f473af1ad69f8ee62a1d'],2,2,4,880500,1,,,,2439
6ed3e6b1cb8a73b1f5f78926ccb247a8953a554c,1,Jun Rao,2016-08-22 10:58:40-07:00,['113d23e8fe290878120c1384b580181169777f4f'],39,111,150,880650,3,0.5,0.6,1,2439
7b16b4731666ff321fbe46828d526872ff5f56d7,1,Ismael Juma,2016-08-22 21:34:26+01:00,['6ed3e6b1cb8a73b1f5f78926ccb247a8953a554c'],17,15,32,880682,1,1,0.25,0,2439
f153407c42716f4f4d9abe8be39ab1112f36a8be,1,Ismael Juma,2016-08-22 23:16:56+01:00,['7b16b4731666ff321fbe46828d526872ff5f56d7'],3,3,6,880688,1,,,,2439
d851ce76fdaa469dcaed7f66340574529d79a3cd,1,Guozhang Wang,2016-08-22 15:45:29-07:00,['f153407c42716f4f4d9abe8be39ab1112f36a8be'],1,13,14,880702,1,0,1,1,2439
d903babb726bdf725bd473c0590f9826b6fa2f14,1,Ismael Juma,2016-08-22 23:52:50+01:00,['d851ce76fdaa469dcaed7f66340574529d79a3cd'],1,9,10,880712,2,,,,2439
dedacd06e4d1e967261b9bca3e32ba0e44b52ba1,0,Gwen Shapira,2016-08-22 15:58:32-07:00,['d903babb726bdf725bd473c0590f9826b6fa2f14'],3,8,11,880723,3,,,,2439
f903215536af06b7b79739882d9286abc2e50000,1,Guozhang Wang,2016-08-22 16:09:02-07:00,['dedacd06e4d1e967261b9bca3e32ba0e44b52ba1'],42,21,63,880786,2,1,0,0,2439
05d00b5aca2e1e59ad685a3f051d2ab022f75acc,1,Ismael Juma,2016-08-23 00:14:44+01:00,['f903215536af06b7b79739882d9286abc2e50000'],2,27,29,880815,2,,,,2439
24fd025d407d42176847143d3a0dc416a75d8f35,1,Ismael Juma,2016-08-23 02:59:30+01:00,['05d00b5aca2e1e59ad685a3f051d2ab022f75acc'],82,120,202,881017,3,1,0.882352941,0,2439
a2bac70a6634e9a78734d23158fb7e45f290ea26,1,Ewen Cheslack-Postava,2016-08-22 21:33:47-07:00,['24fd025d407d42176847143d3a0dc416a75d8f35'],224,232,456,881473,11,0.933333333,0.133333333,0,2439
a1e0b2240dba0740135621d959441eefa6fd3124,1,Jun Rao,2016-08-22 21:49:40-07:00,['a2bac70a6634e9a78734d23158fb7e45f290ea26'],2,20,22,881495,2,1,1,1,2439
313aad423cb19618b8693af6f04b68138059c585,1,Ismael Juma,2016-08-23 10:31:29+01:00,['a1e0b2240dba0740135621d959441eefa6fd3124'],14,133,147,881642,4,0.345679012,0.345679012,1,2439
cec2769e2281ac731e8cfd12b5d8e34e0ebe38cd,0,Ewen Cheslack-Postava,2016-08-23 10:19:07-07:00,['313aad423cb19618b8693af6f04b68138059c585'],11,88,99,881741,2,0,0.983050847,1,2439
d85aaf95febca62cb03f4c2a2f84401cae4800d2,0,Ismael Juma,2016-08-23 23:46:41+01:00,['cec2769e2281ac731e8cfd12b5d8e34e0ebe38cd'],15,37,52,881793,2,0.5625,0,1,2439
7a877895a1c8494d48bf2c18e2f74fb913ed036a,0,Ismael Juma,2016-08-23 23:56:36+01:00,['d85aaf95febca62cb03f4c2a2f84401cae4800d2'],10,7,17,881810,3,,,,2439
08bdffbe4d13fff202b2598b3732ef041183a5f4,0,Ismael Juma,2016-08-25 04:04:40+01:00,['7a877895a1c8494d48bf2c18e2f74fb913ed036a'],1,1,2,881812,1,,,,2439
151288fe1f271391ebb53b14ff3146cfc3a4daee,0,Ismael Juma,2016-08-25 04:31:08+01:00,['08bdffbe4d13fff202b2598b3732ef041183a5f4'],2,2,4,881816,1,,,,2439
36044fdc544f1b6b4829558691e0e7d280abce99,1,Jun Rao,2016-08-25 08:15:55-07:00,['151288fe1f271391ebb53b14ff3146cfc3a4daee'],78,452,530,882346,14,0.844827586,0.943965517,0.879310345,2440
4cdb96f4c396e331ec98fe881ab0255e247bc62a,0,Ismael Juma,2016-08-26 00:02:50+01:00,['36044fdc544f1b6b4829558691e0e7d280abce99'],0,2,2,882348,1,,,,2440
53651937fa8a7750daf44d7e88e616f01e2e37d3,0,Ismael Juma,2016-08-26 00:05:22+01:00,['4cdb96f4c396e331ec98fe881ab0255e247bc62a'],8,19,27,882375,2,0.833333333,1,1,2440
32feed25aefdda3a9f2b780d0709a3002777c9df,1,Ismael Juma,2016-08-26 00:41:23+01:00,['53651937fa8a7750daf44d7e88e616f01e2e37d3'],82,77,159,882534,4,1,1,1,2440
dddb79f3129497997dce9a0d3170eba169b72a57,1,Gwen Shapira,2016-08-25 19:15:51-07:00,['32feed25aefdda3a9f2b780d0709a3002777c9df'],5,8,13,882547,1,,,,2440
bf3dbcba4fe5fd8185a529ba216acf20f7e2d02d,0,Gwen Shapira,2016-08-25 19:19:50-07:00,['dddb79f3129497997dce9a0d3170eba169b72a57'],2,20,22,882569,1,0,0.533333333,1,2440
08ad2be0da23afdaf6af05213005c9f765f39d8e,0,Gwen Shapira,2016-08-25 19:25:36-07:00,['bf3dbcba4fe5fd8185a529ba216acf20f7e2d02d'],0,19,19,882588,1,0,1,1,2440
c80649078bb38f8b3a32ace2c5d4aa328bb8246b,0,Gwen Shapira,2016-08-25 19:27:52-07:00,['08ad2be0da23afdaf6af05213005c9f765f39d8e'],1,1,2,882590,1,,,,2440
dca63fc0a50fe268b82ae5bdafa0b876f6389907,0,Gwen Shapira,2016-08-25 20:23:05-07:00,['c80649078bb38f8b3a32ace2c5d4aa328bb8246b'],2,38,40,882630,2,,,,2440
20155ef87e935a37779ee07d9605be9feabe2ad0,0,Gwen Shapira,2016-08-25 20:29:20-07:00,['dca63fc0a50fe268b82ae5bdafa0b876f6389907'],3,8,11,882641,1,,,,2440
b4ddd021b42225f8cb1d7049298f0e503cb09633,0,Gwen Shapira,2016-08-25 20:32:08-07:00,['20155ef87e935a37779ee07d9605be9feabe2ad0'],7,5,12,882653,1,,,,2440
d4c379832b525d1a9c20c5cb84f0e586b9d977e0,0,Guozhang Wang,2016-08-26 11:12:25-07:00,['b4ddd021b42225f8cb1d7049298f0e503cb09633'],1,1,2,882655,1,,,,2440
190239441878d73ad0c50d59c73bcc8717a12ed6,1,Guozhang Wang,2016-08-26 12:40:18-07:00,['d4c379832b525d1a9c20c5cb84f0e586b9d977e0'],25,49,74,882729,2,1,1,1,2440
71f7e7c3a29e8f7339430837065126256907bd2a,1,Ewen Cheslack-Postava,2016-08-26 14:00:42-07:00,['190239441878d73ad0c50d59c73bcc8717a12ed6'],536,548,1084,883813,15,1,0,0,2441
9aaeb33c16d4a319967560215e2ea72082367f92,0,Ewen Cheslack-Postava,2016-08-29 13:13:08-07:00,['71f7e7c3a29e8f7339430837065126256907bd2a'],10,30,40,883853,2,1,1,1,2441
b91eeac9438b8718c410045b0e9191296ebb536d,1,Ewen Cheslack-Postava,2016-08-29 19:08:52-07:00,['9aaeb33c16d4a319967560215e2ea72082367f92'],7,26,33,883886,4,0.933333333,1,0.933333333,2441
2f20a398735f9c0d39487bedc2d5dd7f4d3eb179,0,Ewen Cheslack-Postava,2016-08-30 21:31:09-07:00,['b91eeac9438b8718c410045b0e9191296ebb536d'],10,10,20,883906,1,,,,2441
2e731a9ee002298b4b90f97e9c876b330b005539,1,Ewen Cheslack-Postava,2016-08-31 09:14:59-07:00,['2f20a398735f9c0d39487bedc2d5dd7f4d3eb179'],36,170,206,884112,4,0.920634921,0.984126984,0.587301587,2442
bc397db0e13998160f0b4e723211d6662ca7e964,0,Guozhang Wang,2016-08-31 12:08:59-07:00,['2e731a9ee002298b4b90f97e9c876b330b005539'],3,5,8,884120,1,,,,2442
c3b64cc8f1cd1958c4522aff8743624105fef0af,1,Ewen Cheslack-Postava,2016-08-31 13:39:59-07:00,['bc397db0e13998160f0b4e723211d6662ca7e964'],2,2,4,884124,1,,,,2442
3a161db57138b8001a66bef19dfc6e865f4fdfcd,0,Ewen Cheslack-Postava,2016-09-01 10:05:36-07:00,['c3b64cc8f1cd1958c4522aff8743624105fef0af'],3,5,8,884132,1,1,1,1,2442
268cff704994693e177c38cd2a16bf5179765f33,0,Guozhang Wang,2016-09-01 12:21:55-07:00,['3a161db57138b8001a66bef19dfc6e865f4fdfcd'],9,10,19,884151,2,,,,2442
8f3462552fa4d6a6d70a837c2ef7439bba512657,1,Guozhang Wang,2016-09-01 21:21:42-07:00,['268cff704994693e177c38cd2a16bf5179765f33'],0,50,50,884201,2,0.205128205,0,1,2442
af9fc503dea5058df890fbd79249abb7634e06bc,1,Jun Rao,2016-09-02 12:49:34-07:00,['8f3462552fa4d6a6d70a837c2ef7439bba512657'],19,34,53,884254,4,0.2,0,1,2442
a960faf5f48025548de71a84b16e0ccf2a1837ca,1,Guozhang Wang,2016-09-04 21:49:48-07:00,['af9fc503dea5058df890fbd79249abb7634e06bc'],46,442,488,884742,10,0.188191882,0.667896679,0.557195572,2442
ed639e8263d9409a9836a55938174122d6ff3ffa,1,Guozhang Wang,2016-09-06 11:38:53-07:00,['a960faf5f48025548de71a84b16e0ccf2a1837ca'],94,105,199,884941,14,0.666666667,1,0.666666667,2442
de1b853c3ed326cf296a56538ca9570b0ecc0636,1,Guozhang Wang,2016-09-06 15:35:12-07:00,['ed639e8263d9409a9836a55938174122d6ff3ffa'],511,538,1049,885990,10,1,0,0,2442
8248caf1ca514adcbc6130d6674cad39275fdd36,0,Ismael Juma,2016-09-07 01:15:55+01:00,['de1b853c3ed326cf296a56538ca9570b0ecc0636'],2,2,4,885994,1,,,,2442
286411cbb19ad267516c73e0a5a8a22e8341b9ad,1,Ismael Juma,2016-09-07 01:17:29+01:00,['8248caf1ca514adcbc6130d6674cad39275fdd36'],1,2,3,885997,1,0,1,1,2442
d2acd676c3eb0c11d0042bc3b9ae314165c68443,0,Gwen Shapira,2016-09-06 17:34:46-07:00,['286411cbb19ad267516c73e0a5a8a22e8341b9ad'],12,87,99,886096,4,0.875,0.875,0.9375,2443
16469d7f94f0a7d82c2a74515ab0903ce6ca9c5e,0,Ismael Juma,2016-09-07 03:42:57+01:00,['d2acd676c3eb0c11d0042bc3b9ae314165c68443'],1,1,2,886098,1,,,,2443
2586226a9a5300fea427ca001608ad86d393df1b,1,Guozhang Wang,2016-09-06 23:02:41-07:00,['16469d7f94f0a7d82c2a74515ab0903ce6ca9c5e'],90,147,237,886335,3,0.325,1,0.75,2443
85c441023b2cfb0860115a52ad36075a618b0fc1,1,Ismael Juma,2016-09-07 16:07:52+01:00,['2586226a9a5300fea427ca001608ad86d393df1b'],2,2,4,886339,2,,,,2443
3a244b78372373ea1028fa77eef8b7c739001bd2,1,Guozhang Wang,2016-09-07 15:27:58-07:00,['85c441023b2cfb0860115a52ad36075a618b0fc1'],9,9,18,886357,3,,,,2443
ca3f3a492c1f10eda965c8402075a3e666f47885,0,Jason Gustafson,2016-09-07 17:34:24-07:00,['3a244b78372373ea1028fa77eef8b7c739001bd2'],3,3,6,886363,1,,,,2443
eba0ede878bd9c42431cc702bc58f56354c595a6,1,Guozhang Wang,2016-09-07 17:42:35-07:00,['ca3f3a492c1f10eda965c8402075a3e666f47885'],23,141,164,886527,15,0,0.780821918,1,2443
69ebf6f7be2fc0e471ebd5b7a166468017ff2651,1,Guozhang Wang,2016-09-07 18:02:24-07:00,['eba0ede878bd9c42431cc702bc58f56354c595a6'],501,1063,1564,888091,28,0.726984127,0.917460317,1,2446
6cf2cb6f294d0d4766f57e9da660fb4efac7d258,1,Jason Gustafson,2016-09-08 09:42:22-07:00,['69ebf6f7be2fc0e471ebd5b7a166468017ff2651'],16,32,48,888139,2,1,1,1,2446
eb59c8124e41fce176bfa6087d5aa4dce18f3642,0,Guozhang Wang,2016-09-08 10:53:29-07:00,['6cf2cb6f294d0d4766f57e9da660fb4efac7d258'],13,5,18,888157,1,1,1,1,2446
54767bbba5bf18c01f50bb40c339433bfed09627,1,Jason Gustafson,2016-09-08 19:56:53-07:00,['eb59c8124e41fce176bfa6087d5aa4dce18f3642'],206,568,774,888931,5,0.45320197,0.738916256,0.891625616,2446
3759d7f764a94f27ba2d5f7f4eca58730a84b1b1,1,Ismael Juma,2016-09-09 15:22:29+01:00,['54767bbba5bf18c01f50bb40c339433bfed09627'],0,1,1,888932,1,,,,2446
4af50bb8600c37ee2e3597fba9a54a29cef94afa,1,Ismael Juma,2016-09-09 21:47:03+01:00,['3759d7f764a94f27ba2d5f7f4eca58730a84b1b1'],53,395,448,889380,7,0.765,0.89,0.91,2446
ac99a3c86d5d8a56b61b1e0d1b2594e627016718,1,Ismael Juma,2016-09-10 08:16:23+01:00,['4af50bb8600c37ee2e3597fba9a54a29cef94afa'],71,76,147,889527,2,,,,2446
1933f12a5368f1f60816d986a2777fa324754f80,1,Ismael Juma,2016-09-11 08:46:20+01:00,['ac99a3c86d5d8a56b61b1e0d1b2594e627016718'],16,23,39,889566,2,1,1,1,2446
5f040cd77f4b8fbe12b3e3389fab1fc2565dda82,1,Jun Rao,2016-09-11 20:45:05-05:00,['1933f12a5368f1f60816d986a2777fa324754f80'],95,520,615,890181,11,0.306122449,1,0.710204082,2447
a7ab9cb83d2c47d980b0b9f6b702e01bd1cf4139,1,Guozhang Wang,2016-09-11 21:00:32-07:00,['5f040cd77f4b8fbe12b3e3389fab1fc2565dda82'],0,7,7,890188,1,0,0,0,2447
2a660f13d2a805f0e27351996e904b1ea2365eba,0,Jason Gustafson,2016-09-12 20:28:01-07:00,['a7ab9cb83d2c47d980b0b9f6b702e01bd1cf4139'],2,1,3,890191,1,0,0,0,2447
41e676d29587042994a72baa5000a8861a075c8c,1,Joel Koshy,2016-09-13 17:33:54-07:00,['2a660f13d2a805f0e27351996e904b1ea2365eba'],2,29,31,890222,3,0.4,1,1,2447
f2cd17010267b0e219d339d4bbc1157f5290cdfe,0,Jason Gustafson,2016-09-14 09:16:29-07:00,['41e676d29587042994a72baa5000a8861a075c8c'],0,4,4,890226,1,1,1,1,2447
c1bce2d757c5a93bebc1abaf1304bf84375a4cc9,0,Ewen Cheslack-Postava,2016-09-14 10:38:40-07:00,['f2cd17010267b0e219d339d4bbc1157f5290cdfe'],2,2,4,890230,2,,,,2447
084a19e9acb43666cfcaa2ca155a775d47cd8b39,1,Jason Gustafson,2016-09-14 18:04:58-07:00,['c1bce2d757c5a93bebc1abaf1304bf84375a4cc9'],12,65,77,890307,2,0.135135135,0.945945946,1,2447
f197ad4997032a848540a7d577b5846f76a26bfb,1,Guozhang Wang,2016-09-14 22:31:52-07:00,['084a19e9acb43666cfcaa2ca155a775d47cd8b39'],56,73,129,890436,3,0.714285714,1,1,2447
f3bb10413d11525a396851eb7e6b9d75b8c6fe23,1,Guozhang Wang,2016-09-15 08:57:48-07:00,['f197ad4997032a848540a7d577b5846f76a26bfb'],1,1,2,890438,1,,,,2447
d4366610241321a58d62c0b919d60ccfe3c3d698,1,Guozhang Wang,2016-09-15 17:08:00-07:00,['f3bb10413d11525a396851eb7e6b9d75b8c6fe23'],6,85,91,890529,2,0.16,1,1,2447
143a33bc506c703ea02fe5daa61f90b7094da13c,1,Jun Rao,2016-09-15 22:25:56-07:00,['d4366610241321a58d62c0b919d60ccfe3c3d698'],368,2122,2490,893019,47,0.583333333,0.980452675,0.768518519,2456
86aa0eb0f274c6e44eb190ce250433419e011a67,1,Guozhang Wang,2016-09-16 09:58:36-07:00,['143a33bc506c703ea02fe5daa61f90b7094da13c'],888,4784,5672,898691,105,0.625348189,0.967966574,0.873723305,2484
567cc3d78746391a3b050d4eea76571e4bf20e89,1,Jason Gustafson,2016-09-16 14:55:46-07:00,['86aa0eb0f274c6e44eb190ce250433419e011a67'],0,42,42,898733,2,1,1,1,2484
d7bffebca05aa91a69da03fe29add4f29b964fd9,0,Jason Gustafson,2016-09-16 15:54:33-07:00,['567cc3d78746391a3b050d4eea76571e4bf20e89'],7,26,33,898766,2,1,0,1,2484
ecc1fb10fad39c2da82731a36552cb5dd9ac2858,1,Ismael Juma,2016-09-17 07:53:25+01:00,['d7bffebca05aa91a69da03fe29add4f29b964fd9'],145,1265,1410,900176,54,0.478991597,0.911764706,0.878151261,2492
69356fbc6e76ab4291ff4957f0d6ea04e7245909,1,Jun Rao,2016-09-17 10:06:05-07:00,['ecc1fb10fad39c2da82731a36552cb5dd9ac2858'],406,1449,1855,902031,22,0.587774295,0.576802508,0.857366771,2496
932e4d7ba781b9ea920d34b49810381afe5069b4,1,Ismael Juma,2016-09-17 22:43:43+01:00,['69356fbc6e76ab4291ff4957f0d6ea04e7245909'],1,1,2,902033,1,,,,2496
b8683026ea7ebfddcec41274b12e8a579dc4ca71,0,Ismael Juma,2016-09-17 22:45:29+01:00,['932e4d7ba781b9ea920d34b49810381afe5069b4'],3,3,6,902039,1,,,,2496
b5bc1a1caaa8a4ad3b10bfdfa9c2250ef8e09b1d,0,Ismael Juma,2016-09-17 22:47:56+01:00,['b8683026ea7ebfddcec41274b12e8a579dc4ca71'],2,2,4,902043,1,,,,2496
6fb25f080fc07948ce2ea620b15b934d91b67d16,0,Ismael Juma,2016-09-17 23:01:32+01:00,['b5bc1a1caaa8a4ad3b10bfdfa9c2250ef8e09b1d'],1,1,2,902045,1,,,,2496
d04b0998c043a6a430921585ffd4c42572a3bf5a,1,Jason Gustafson,2016-09-18 09:15:16-07:00,['6fb25f080fc07948ce2ea620b15b934d91b67d16'],678,1716,2394,904439,48,0.393989983,0.911519199,0.791318865,2499
d9206500bf2f99ce93f6ad64c7a89483100b3b5f,0,Ismael Juma,2016-09-18 22:59:00+01:00,['d04b0998c043a6a430921585ffd4c42572a3bf5a'],1,1,2,904441,1,,,,2499
8c07e0f31d6a7b6bfa119bc557da6781324758bf,0,Guozhang Wang,2016-09-19 10:28:58-07:00,['d9206500bf2f99ce93f6ad64c7a89483100b3b5f'],2,2,4,904445,1,,,,2499
70afd5f9dd2eddc784a24fa2518992ef3371f0a4,1,Guozhang Wang,2016-09-19 10:30:58-07:00,['8c07e0f31d6a7b6bfa119bc557da6781324758bf'],3,7,10,904455,3,0,1,1,2499
3d74196f205c53946b6fc3dd0501aa2095f0031a,1,Guozhang Wang,2016-09-19 11:00:53-07:00,['70afd5f9dd2eddc784a24fa2518992ef3371f0a4'],60,152,212,904667,16,0.56,1,0.78,2499
f27a6f319ac058288a8cd3d7f95247cf45fea817,1,Jun Rao,2016-09-19 12:16:45-07:00,['3d74196f205c53946b6fc3dd0501aa2095f0031a'],21,105,126,904793,2,,,,2499
896ad63f14c5240207daeedea304c62c8fc7bb7e,1,Guozhang Wang,2016-09-19 12:37:21-07:00,['f27a6f319ac058288a8cd3d7f95247cf45fea817'],5,10,15,904808,1,0,0,0,2499
431c3b0937da103b6e79e9f970c0862898205909,1,Jason Gustafson,2016-09-19 12:49:38-07:00,['896ad63f14c5240207daeedea304c62c8fc7bb7e'],32,88,120,904928,2,0.901639344,0.901639344,1,2499
57ee6ffc897a26fea381a13b6e2b00d024c49ee8,0,Jason Gustafson,2016-09-19 13:08:07-07:00,['431c3b0937da103b6e79e9f970c0862898205909'],0,2,2,904930,1,1,1,1,2499
3281b3c9043edec0b1f8cadfb137851a60d509ef,1,Jason Gustafson,2016-09-19 14:26:26-07:00,['57ee6ffc897a26fea381a13b6e2b00d024c49ee8'],27,31,58,904988,3,,,,2499
4e1c7d844f743e5b439447e645fa41d2f92b8b5f,1,Jason Gustafson,2016-09-19 16:42:43-07:00,['3281b3c9043edec0b1f8cadfb137851a60d509ef'],0,42,42,905030,3,0.935483871,0.129032258,1,2499
cf8f4a713b64f010c15a4a7b8dae616edb8a1b74,1,Guozhang Wang,2016-09-19 17:13:47-07:00,['4e1c7d844f743e5b439447e645fa41d2f92b8b5f'],2,219,221,905251,3,0,0,1,2499
eaaa433fc97b86450833d8fcc8c9289ea35d47c0,1,Jason Gustafson,2016-09-19 18:38:27-07:00,['cf8f4a713b64f010c15a4a7b8dae616edb8a1b74'],251,837,1088,906339,22,0.366863905,0.473372781,0.778106509,2500
6acbf27aebbe5b6b4f230ce44ea5151c4c53ffbd,0,Jason Gustafson,2016-09-19 21:19:17-07:00,['eaaa433fc97b86450833d8fcc8c9289ea35d47c0'],3,3,6,906345,3,,,,2500
f396fdac197409fb955f00a6f642f04e4926ba41,0,Jason Gustafson,2016-09-19 23:17:23-07:00,['6acbf27aebbe5b6b4f230ce44ea5151c4c53ffbd'],1,1,2,906347,1,,,,2500
c195003cb6e05f2d8c49285ff7e77b1cb3aa4361,1,Ismael Juma,2016-09-20 11:33:50+01:00,['f396fdac197409fb955f00a6f642f04e4926ba41'],2,2,4,906351,1,,,,2500
3663275cf066b7715cc11b26fd9c144bbff1c373,1,Ismael Juma,2016-09-20 15:14:40+01:00,['c195003cb6e05f2d8c49285ff7e77b1cb3aa4361'],47,49,96,906447,2,1,1,0,2500
4f821830bc6b726cddf90999fff76006745b1a3f,1,Ismael Juma,2016-09-20 15:41:14+01:00,['3663275cf066b7715cc11b26fd9c144bbff1c373'],1,1,2,906449,1,,,,2500
24f81ea764a493b4422b6a3ef6b3e771d0e4d63b,0,Guozhang Wang,2016-09-21 11:11:12-07:00,['4f821830bc6b726cddf90999fff76006745b1a3f'],0,4,4,906453,1,,,,2500
a632716a3c9a871f325c6f13aefa9aed0add4b82,0,Guozhang Wang,2016-09-21 11:13:39-07:00,['24f81ea764a493b4422b6a3ef6b3e771d0e4d63b'],17,0,17,906470,1,0,0,0,2500
732fabf94ebc9631d31f2feb2116ee8b63beabef,1,Guozhang Wang,2016-09-22 10:07:50-07:00,['a632716a3c9a871f325c6f13aefa9aed0add4b82'],16,330,346,906816,2,0.111111111,1,0.995884774,2500
27e3edc791760dea7ff4d048f87d1585f9e235d7,0,Guozhang Wang,2016-09-22 10:33:23-07:00,['732fabf94ebc9631d31f2feb2116ee8b63beabef'],20,20,40,906856,1,,,,2500
4112bc3af7bec63ae1248c1b9db745ba8ac4c63c,1,Guozhang Wang,2016-09-22 12:45:43-07:00,['27e3edc791760dea7ff4d048f87d1585f9e235d7'],0,1,1,906857,1,0,1,0,2500
d32f3f2828c199a5a09bbba779d07430e43fb190,0,Jason Gustafson,2016-09-22 14:53:40-07:00,['4112bc3af7bec63ae1248c1b9db745ba8ac4c63c'],3,3,6,906863,2,,,,2500
106a7456060750ab0604d290b8c1e33a57adbf20,0,Ismael Juma,2016-09-22 23:03:49+01:00,['d32f3f2828c199a5a09bbba779d07430e43fb190'],7,75,82,906945,1,0.625,1,1,2500
6a13a3dbaddf99850b2583007577fa2a6e1e6d3a,1,Jason Gustafson,2016-09-23 13:13:29-07:00,['106a7456060750ab0604d290b8c1e33a57adbf20'],60,127,187,907132,3,0.74,0.8,1,2500
0de807357be4d776747e960b5fd17ddeae9a6cad,1,Ismael Juma,2016-09-23 22:20:56+01:00,['6a13a3dbaddf99850b2583007577fa2a6e1e6d3a'],11,25,36,907168,6,0.1,1,1,2500
36242b846a42b33d7d4c1931f2dae93ebe1547c7,1,Ismael Juma,2016-09-24 10:23:18+01:00,['0de807357be4d776747e960b5fd17ddeae9a6cad'],2,18,20,907188,2,,,,2500
1d055f7551d138324d2540095a1cfc1c8f74d76f,1,Ismael Juma,2016-09-25 09:12:02+01:00,['36242b846a42b33d7d4c1931f2dae93ebe1547c7'],48,76,124,907312,4,0,0.818181818,1,2500
c0a62b70a8eadc550c937bb18e0203ab691618f5,1,Jun Rao,2016-09-25 17:01:45-07:00,['1d055f7551d138324d2540095a1cfc1c8f74d76f'],54,85,139,907451,4,0,0,0,2500
b75245cfbbefc712103b9329da0f27a205baa6aa,0,Ewen Cheslack-Postava,2016-09-26 14:54:01-07:00,['c0a62b70a8eadc550c937bb18e0203ab691618f5'],60,60,120,907571,2,1,0,,2500
be6056abc9970600347c95c4c8658799b76dbe6b,0,Jun Rao,2016-09-26 17:18:18-07:00,['b75245cfbbefc712103b9329da0f27a205baa6aa'],14,7,21,907592,1,1,1,0,2500
60ad6d727861a87fa756918a7be7547e9b1f4c3d,0,Jason Gustafson,2016-09-26 19:04:22-07:00,['be6056abc9970600347c95c4c8658799b76dbe6b'],13,18,31,907623,1,0,0,1,2500
a208478f37f216324a87b530f18f30ecd79601c8,0,Jason Gustafson,2016-09-26 21:15:25-07:00,['60ad6d727861a87fa756918a7be7547e9b1f4c3d'],1,1,2,907625,1,,,,2500
5d6408f6cfda3f8ab366195f69e90de048cde25d,1,Ismael Juma,2016-09-27 14:00:44+01:00,['a208478f37f216324a87b530f18f30ecd79601c8'],29,292,321,907946,3,0.857142857,0.857142857,0.969387755,2501
b8ed4a51134ca8b98d1445871a55ed33b6ad5b92,1,Ismael Juma,2016-09-27 20:37:49+01:00,['5d6408f6cfda3f8ab366195f69e90de048cde25d'],86,211,297,908243,16,1,1,0.916666667,2503
3db752a565071c78e4b11eaafa739844fa785b04,1,Ismael Juma,2016-09-27 21:35:29+01:00,['b8ed4a51134ca8b98d1445871a55ed33b6ad5b92'],26,44,70,908313,5,0,0,1,2503
61d3378bc84914a521a65cdfffb7299928fa8671,1,Jason Gustafson,2016-09-27 16:49:46-07:00,['3db752a565071c78e4b11eaafa739844fa785b04'],10,17,27,908340,4,,,,2503
0c25c73782e6e70b8f37e3dda2fa2a5b0b1c8c65,1,Guozhang Wang,2016-09-27 17:35:24-07:00,['61d3378bc84914a521a65cdfffb7299928fa8671'],1,6,7,908347,2,1,1,1,2503
0c4cc5a4466d0dfce01903c29d97af3e428597f3,1,Guozhang Wang,2016-09-27 17:37:12-07:00,['0c25c73782e6e70b8f37e3dda2fa2a5b0b1c8c65'],20,18,38,908385,5,1,1,0,2503
c526c0c3f6f153ef8f84a3e66d9f997d8c31e20c,0,Guozhang Wang,2016-09-27 17:43:36-07:00,['0c4cc5a4466d0dfce01903c29d97af3e428597f3'],0,9,9,908394,1,1,1,1,2503
d83cde7cabe4e86951c6760e68e65b99752cfe0e,1,Guozhang Wang,2016-09-28 11:07:44-07:00,['c526c0c3f6f153ef8f84a3e66d9f997d8c31e20c'],39,469,508,908902,14,0.391472868,0.65503876,0.937984496,2505
281fac9ed626b16190d56e609c9bf04a3188374a,1,Ismael Juma,2016-09-28 20:18:20+01:00,['d83cde7cabe4e86951c6760e68e65b99752cfe0e'],0,6,6,908908,2,0.6,0.6,1,2505
16f85e84ce8c01329b3298d5fca8b27cfcacddb6,1,Jay Kreps,2016-09-28 16:30:21-07:00,['281fac9ed626b16190d56e609c9bf04a3188374a'],202,170,372,909280,5,,,,2505
71036527e949c5c165e866163c55df9678327044,1,Ismael Juma,2016-09-29 01:03:44+01:00,['16f85e84ce8c01329b3298d5fca8b27cfcacddb6'],47,51,98,909378,1,0,0,1,2505
aa506a6919e8ec0381657db2c2f15dc1f62b00f6,1,Jason Gustafson,2016-09-28 17:58:08-07:00,['71036527e949c5c165e866163c55df9678327044'],105,265,370,909748,22,0.311827957,0.655913978,0.516129032,2506
67e99d0869dd49358d7ca549ac715b722fda89f5,0,Jason Gustafson,2016-09-28 19:15:00-07:00,['aa506a6919e8ec0381657db2c2f15dc1f62b00f6'],1,11,12,909760,1,,,,2506
a6f3cf56b3ce5c97e89f4b80c34d54ea608950ee,1,Ismael Juma,2016-09-29 07:48:40+01:00,['67e99d0869dd49358d7ca549ac715b722fda89f5'],5,8,13,909773,2,0,0,1,2506
2ca9177f499a07262db0072bbbb252d3ca2dfb58,1,Ismael Juma,2016-09-29 08:57:17+01:00,['a6f3cf56b3ce5c97e89f4b80c34d54ea608950ee'],172,315,487,910260,13,0.899159664,1,0.378151261,2506
0c8c167e844e53f64df80fca52b9b9b1d3dba8b7,0,Jason Gustafson,2016-09-29 13:50:39-07:00,['2ca9177f499a07262db0072bbbb252d3ca2dfb58'],6,12,18,910278,3,,,,2506
7c6d70655a7de6a3b688a3e869a091f863de2eef,0,Jason Gustafson,2016-09-29 16:36:42-07:00,['0c8c167e844e53f64df80fca52b9b9b1d3dba8b7'],0,1,1,910279,1,0,0,1,2506
d2a267b111d23d6b98f2784382095b9ae5ddf886,1,Jason Gustafson,2016-09-29 19:37:20-07:00,['7c6d70655a7de6a3b688a3e869a091f863de2eef'],21,22,43,910322,7,,,,2506
9edc71230ee7b77fd512f6d923e76469508c3280,1,Ismael Juma,2016-09-30 09:41:28+01:00,['d2a267b111d23d6b98f2784382095b9ae5ddf886'],13,126,139,910461,3,0,1,1,2506
0bc1f41fc02062ff224f12ffac053ea3753ecb98,1,Ismael Juma,2016-09-30 11:02:08+01:00,['9edc71230ee7b77fd512f6d923e76469508c3280'],47,131,178,910639,9,0.540983607,0.704918033,0.704918033,2506
43c30b8c3970d6a6252490c42b3300c445d80d37,0,Ismael Juma,2016-09-30 11:26:17+01:00,['0bc1f41fc02062ff224f12ffac053ea3753ecb98'],0,5,5,910644,3,0.4,1,1,2506
4292243009c066c9ab5477ce886d8eb00534587e,1,Guozhang Wang,2016-09-30 09:36:46-07:00,['43c30b8c3970d6a6252490c42b3300c445d80d37'],2,2,4,910648,2,,,,2506
18a0812618a151e8ac700545699173b10caf692b,0,Jason Gustafson,2016-09-30 11:49:54-07:00,['4292243009c066c9ab5477ce886d8eb00534587e'],1,3,4,910652,1,,,,2506
5f3746d135697f364aaacf877ce288267d00b9a2,1,Guozhang Wang,2016-09-30 11:55:32-07:00,['18a0812618a151e8ac700545699173b10caf692b'],6,20,26,910678,2,1,1,1,2506
5a989d1748426004212d44abad4567f9034a04ef,1,Ismael Juma,2016-09-30 19:58:58+01:00,['5f3746d135697f364aaacf877ce288267d00b9a2'],22,242,264,910942,5,0.037313433,0.910447761,0.574626866,2507
451d263bb4df844bc4a359c320e7265ea25f3c8e,1,Ismael Juma,2016-09-30 20:33:24+01:00,['5a989d1748426004212d44abad4567f9034a04ef'],6,10,16,910958,2,0.5,1,0.5,2507
095475d481a230b81f312f94034a8d4d2b581eb9,0,Jason Gustafson,2016-09-30 12:39:44-07:00,['451d263bb4df844bc4a359c320e7265ea25f3c8e'],1,5,6,910964,1,1,1,0.666666667,2507
20322446aa261dec8b51e6e4514307e926a29ba5,0,Jason Gustafson,2016-09-30 13:13:24-07:00,['095475d481a230b81f312f94034a8d4d2b581eb9'],15,1,16,910980,2,0.833333333,0.833333333,0,2507
788989158a466aa89f030940a28d4f868e275ed7,0,Jason Gustafson,2016-09-30 17:05:37-07:00,['20322446aa261dec8b51e6e4514307e926a29ba5'],5,5,10,910990,1,,,,2507
f8b69aacd4ed1af1263e46b93879cea2d855df3b,0,Jason Gustafson,2016-09-30 17:25:42-07:00,['788989158a466aa89f030940a28d4f868e275ed7'],68,73,141,911131,1,,,,2507
8124f6e0996cb673760750b3aba004ae11e34c6a,1,Jason Gustafson,2016-09-30 23:07:51-07:00,['f8b69aacd4ed1af1263e46b93879cea2d855df3b'],147,474,621,911752,11,0.2265625,0.4609375,1,2507
33c7b88ffe3fc0de9f0154c5667b20ea34c94849,1,Jason Gustafson,2016-10-01 17:21:19-07:00,['8124f6e0996cb673760750b3aba004ae11e34c6a'],11,11,22,911774,4,,,,2507
c78a3b173d019e8bb58f4e31c94bf4dd3f7ab614,1,Guozhang Wang,2016-10-01 21:57:49-07:00,['33c7b88ffe3fc0de9f0154c5667b20ea34c94849'],33,54,87,911861,2,0.944444444,1,1,2507
9e8934065a85437767617d06d922a4f6591bb63d,0,Jason Gustafson,2016-10-03 09:54:30-07:00,['c78a3b173d019e8bb58f4e31c94bf4dd3f7ab614'],1,1,2,911863,1,,,,2507
496594a12c67d468c5ab58d83bf31caea3154e56,1,Ismael Juma,2016-10-03 18:21:57+01:00,['9e8934065a85437767617d06d922a4f6591bb63d'],84,84,168,912031,10,,,,2507
a23859e5686bf93ed7e0d310f949757694d47a1b,1,Jason Gustafson,2016-10-03 16:19:41-07:00,['496594a12c67d468c5ab58d83bf31caea3154e56'],36,175,211,912242,3,0.133333333,1,0.786666667,2507
7115c66aefb11efa802e61a42bcc13fadf92598d,1,Jason Gustafson,2016-10-03 16:49:50-07:00,['a23859e5686bf93ed7e0d310f949757694d47a1b'],171,186,357,912599,13,0.279069767,0,0.651162791,2507
cf0bf7c7a24aa5a19069b6e8456353c9b498dffc,0,Ismael Juma,2016-10-04 02:18:19+01:00,['7115c66aefb11efa802e61a42bcc13fadf92598d'],6,85,91,912690,3,0.351351351,0.351351351,1,2508
91d025e063e9f2b8e5799f84f6f3f7f1e9b0916c,0,Jason Gustafson,2016-10-03 19:35:54-07:00,['cf0bf7c7a24aa5a19069b6e8456353c9b498dffc'],1,1,2,912692,1,,,,2508
672dfaa243850a835c1b01da4fb20311ba6455bc,1,Jason Gustafson,2016-10-03 20:22:52-07:00,['91d025e063e9f2b8e5799f84f6f3f7f1e9b0916c'],16,53,69,912761,2,0.136363636,0.954545455,0.863636364,2508
1a396c9cf22441a7afa8ec9c4a94a48f881cdd90,0,Jason Gustafson,2016-10-03 21:17:11-07:00,['672dfaa243850a835c1b01da4fb20311ba6455bc'],0,1,1,912762,1,,,,2508
d8d2f3aac44562d2eec0911a44aec6b699dd0212,0,Jason Gustafson,2016-10-04 10:38:49-07:00,['1a396c9cf22441a7afa8ec9c4a94a48f881cdd90'],1,7,8,912770,1,,,,2508
b3eef7bc72743b006d068ae6c3edf71d413ef433,1,Jason Gustafson,2016-10-04 11:12:56-07:00,['d8d2f3aac44562d2eec0911a44aec6b699dd0212'],5,5,10,912780,2,,,,2508
305fb59b13da8b0b0a1a657688c0fa5f5916c91f,0,Ewen Cheslack-Postava,2016-10-04 14:45:09-07:00,['b3eef7bc72743b006d068ae6c3edf71d413ef433'],2,4,6,912786,1,,,,2508
3e9f357fb56fd2b030a616b0d9d475cfa481e149,1,Guozhang Wang,2016-10-05 08:30:05-07:00,['305fb59b13da8b0b0a1a657688c0fa5f5916c91f'],5,3,8,912794,1,0,0,1,2508
b049606aebbb6c08120e53a6bf3d9519bb14b076,0,Ismael Juma,2016-10-05 23:01:53+01:00,['3e9f357fb56fd2b030a616b0d9d475cfa481e149'],12,12,24,912818,1,0,0,0,2508
4efa833f45c5765ce3a5179f20fd384e2f2e210c,0,Jason Gustafson,2016-10-06 09:39:26-07:00,['b049606aebbb6c08120e53a6bf3d9519bb14b076'],7,10,17,912835,1,,,,2508
c9da62794547ee75a7e2ade1aa8bbf4a1443c49c,1,Guozhang Wang,2016-10-06 09:43:39-07:00,['4efa833f45c5765ce3a5179f20fd384e2f2e210c'],71,189,260,913095,12,1,1,0.666666667,2509
3c8925946ddfe7be8bea521c7d08a56aec756a2d,0,Jason Gustafson,2016-10-06 11:19:43-07:00,['c9da62794547ee75a7e2ade1aa8bbf4a1443c49c'],2,2,4,913099,1,,,,2509
8b75a016db16e20c5d5180deb6859bf0ad4c48fd,1,Ismael Juma,2016-10-07 12:10:53+01:00,['3c8925946ddfe7be8bea521c7d08a56aec756a2d'],1,32,33,913132,2,0,1,1,2509
5e4600ae469559b9cdb36c17efb90cc6b6388826,0,Ismael Juma,2016-10-07 15:02:26+01:00,['8b75a016db16e20c5d5180deb6859bf0ad4c48fd'],2,2,4,913136,1,,,,2509
615cd4fd3ad7abe7600e4f80ce6c36f7125f599e,0,Jason Gustafson,2016-10-07 09:00:12-07:00,['5e4600ae469559b9cdb36c17efb90cc6b6388826'],3,4,7,913143,1,,,,2509
454f6845b34d0e3faabd9427f3cd8bbe6209c30d,0,Guozhang Wang,2016-10-07 11:30:00-07:00,['615cd4fd3ad7abe7600e4f80ce6c36f7125f599e'],11,12,23,913166,1,1,1,1,2509
e876df8b37fc6ea54b0a0571306c4a833c919cda,1,Guozhang Wang,2016-10-07 13:13:27-07:00,['454f6845b34d0e3faabd9427f3cd8bbe6209c30d'],87,50,137,913303,3,1,0,0,2509
6b91f83fbaef26fefb9ec221529c29872a04c004,1,Jason Gustafson,2016-10-07 18:43:24-07:00,['e876df8b37fc6ea54b0a0571306c4a833c919cda'],1,6,7,913310,3,0.333333333,0.333333333,1,2509
44d18d273c36bb76fa16baec68a9294d697a1c9b,0,Ismael Juma,2016-10-08 12:22:34+01:00,['6b91f83fbaef26fefb9ec221529c29872a04c004'],1,1,2,913312,1,,,,2509
179d0698573bfc75b2c91185bdcb8b4d2f3038e0,1,Jason Gustafson,2016-10-09 10:32:01-07:00,['44d18d273c36bb76fa16baec68a9294d697a1c9b'],5,16,21,913333,1,,,,2509
fb22685fa9e2df7793605ea6f41181ad51c76686,1,Jason Gustafson,2016-10-10 09:26:37-07:00,['179d0698573bfc75b2c91185bdcb8b4d2f3038e0'],1,1,2,913335,1,,,,2509
7a5133d5545fbffa5bea89818a5b6b3e2175e418,0,Jason Gustafson,2016-10-10 10:15:47-07:00,['fb22685fa9e2df7793605ea6f41181ad51c76686'],1,1,2,913337,1,,,,2509
bf98c47389baa735aab9cfbf513190a8205447f9,1,Jason Gustafson,2016-10-10 13:39:05-07:00,['7a5133d5545fbffa5bea89818a5b6b3e2175e418'],80,134,214,913551,5,,,,2509
1bce0d1b5120743a9a0559a6c9a98249d463fe02,1,Joel Koshy,2016-10-10 14:06:12-07:00,['bf98c47389baa735aab9cfbf513190a8205447f9'],22,59,81,913632,3,0.578947368,0,1,2509
06d6d98bed616a66799585fc1f9166dc87247f8c,0,Jason Gustafson,2016-10-10 14:46:36-07:00,['1bce0d1b5120743a9a0559a6c9a98249d463fe02'],158,167,325,913957,2,,,,2509
e972d2afd31913acdef8979c6cac7cf48f99da7b,1,Jason Gustafson,2016-10-10 15:58:37-07:00,['06d6d98bed616a66799585fc1f9166dc87247f8c'],125,308,433,914390,13,,,,2509
8e9e63138d96a607c1f0482c395e7f9d1005a182,1,Jason Gustafson,2016-10-10 17:09:52-07:00,['e972d2afd31913acdef8979c6cac7cf48f99da7b'],3,2,5,914395,2,,,,2509
2e82bc0a105be5d19e3f6960184659db6eb4e74b,0,Jason Gustafson,2016-10-10 19:58:53-07:00,['8e9e63138d96a607c1f0482c395e7f9d1005a182'],0,0,0,914395,2,,,,2511
72d5675a7cfc64a5547b921672856ea4afc4f4c2,1,Ewen Cheslack-Postava,2016-10-10 20:02:04-07:00,['2e82bc0a105be5d19e3f6960184659db6eb4e74b'],30,189,219,914614,2,0.060606061,0.840909091,1,2511
c1e840050c11d2f1d20118273c572e4c8491866d,0,Ewen Cheslack-Postava,2016-10-10 23:03:06-07:00,['72d5675a7cfc64a5547b921672856ea4afc4f4c2'],6,12,18,914632,1,0,1,1,2511
9179bbc067cef5211107d19f96e0d836c3a007e1,0,Jason Gustafson,2016-10-11 09:32:36-07:00,['c1e840050c11d2f1d20118273c572e4c8491866d'],1,1,2,914634,1,,,,2511
93b940016348fcf64034f36e4b4f3fc53a966f74,0,Guozhang Wang,2016-10-11 13:57:30-07:00,['9179bbc067cef5211107d19f96e0d836c3a007e1'],8,141,149,914783,4,0.816326531,0.87755102,1,2511
ae9532c6b3befe2b18d336004bb0976e9d27d08e,1,Jason Gustafson,2016-10-11 20:25:35-07:00,['93b940016348fcf64034f36e4b4f3fc53a966f74'],7,13,20,914803,3,,,,2511
704308a6352461f09ac5adc37028b6c7b9f4f83f,1,Ismael Juma,2016-10-12 12:55:44+01:00,['ae9532c6b3befe2b18d336004bb0976e9d27d08e'],4,7,11,914814,2,,,,2511
c04486f4a5ec1101e6f1344658db359647ffa791,1,Guozhang Wang,2016-10-12 12:45:00-07:00,['704308a6352461f09ac5adc37028b6c7b9f4f83f'],3,3,6,914820,1,,,,2511
83116c733d09f5c85ced56701cdb614ce6efc847,0,Joel Koshy,2016-10-12 16:28:29-07:00,['c04486f4a5ec1101e6f1344658db359647ffa791'],3,9,12,914832,1,,,,2511
65f6a7964f5e59e789eae3cdd4d301bb6a649064,0,Guozhang Wang,2016-10-13 13:15:26-07:00,['83116c733d09f5c85ced56701cdb614ce6efc847'],0,8,8,914840,2,1,1,1,2511
1a67739c2f3d0418a8f2d8f7b15d5af2ed3a324a,1,Jason Gustafson,2016-10-13 20:17:57-07:00,['65f6a7964f5e59e789eae3cdd4d301bb6a649064'],83,255,338,915178,6,0,0.76146789,0.71559633,2511
d09043637d5ea4094e3ee9808f29d037e8afaba6,1,Jason Gustafson,2016-10-13 21:08:28-07:00,['1a67739c2f3d0418a8f2d8f7b15d5af2ed3a324a'],48,280,328,915506,5,0.251572327,0.974842767,0.886792453,2511
9662e466d90093c9bc5315d0b9949dfbf353b988,0,Jason Gustafson,2016-10-14 10:04:13-07:00,['d09043637d5ea4094e3ee9808f29d037e8afaba6'],4,4,8,915514,3,,,,2511
e7663a306f40e9fcbc3096d17fb0f99fa3d11d1d,1,Guozhang Wang,2016-10-14 13:54:01-07:00,['9662e466d90093c9bc5315d0b9949dfbf353b988'],111,152,263,915777,8,0,0.826086957,0.782608696,2511
6199c62776bf3ce9467703ca651a0119b261e60e,1,Jason Gustafson,2016-10-14 15:36:43-07:00,['e7663a306f40e9fcbc3096d17fb0f99fa3d11d1d'],36,43,79,915856,6,1,1,0.75,2511
4e0b0b83a7af8fd7d6041d39275e9f82dba9d606,1,Jason Gustafson,2016-10-17 16:58:21-07:00,['6199c62776bf3ce9467703ca651a0119b261e60e'],6,6,12,915868,5,,1,,2511
925310aac0b6a0fb32e3e2d614198ffc78f34f96,1,Guozhang Wang,2016-10-17 21:48:40-07:00,['4e0b0b83a7af8fd7d6041d39275e9f82dba9d606'],32,214,246,916114,20,0.561983471,1,1,2512
6f842c1e9e2b95c3faa81c0822bae88dc9ac9899,1,Jason Gustafson,2016-10-18 11:08:10-07:00,['925310aac0b6a0fb32e3e2d614198ffc78f34f96'],0,17,17,916131,1,,,,2513
3c02e5a20f2c4f1112e9ba79560f0afcd6b09e5d,0,Jason Gustafson,2016-10-18 14:09:09-07:00,['6f842c1e9e2b95c3faa81c0822bae88dc9ac9899'],6,0,6,916137,2,,,,2513
b8cfa167edfefbae52bec98eb357121e6437cef6,1,Gwen Shapira,2016-10-18 14:24:52-07:00,['3c02e5a20f2c4f1112e9ba79560f0afcd6b09e5d'],0,94,94,916231,1,,,,2513
2965f50e0de755cd36cf5e13bd9968493a0f8279,0,Jason Gustafson,2016-10-18 22:12:08-07:00,['b8cfa167edfefbae52bec98eb357121e6437cef6'],7,7,14,916245,1,,,,2513
332b8b9afd04b975a42b91775edebdef5c27ff6b,0,Jason Gustafson,2016-10-19 09:43:03-07:00,['2965f50e0de755cd36cf5e13bd9968493a0f8279'],0,4,4,916249,1,1,1,1,2513
179d4dc0f2a23d7e67caf4875a0563e74027933a,0,Guozhang Wang,2016-10-19 14:01:23-07:00,['332b8b9afd04b975a42b91775edebdef5c27ff6b'],3,48,51,916300,2,1,1,0.857142857,2513
6bd866b92fc5cf6e7a669e2d66c92c18b0ce869e,0,Guozhang Wang,2016-10-19 14:17:33-07:00,['179d4dc0f2a23d7e67caf4875a0563e74027933a'],1,1,2,916302,1,,,,2513
c2a8b86117ede2ffda4cc4a8800b46f65ef9922d,0,Guozhang Wang,2016-10-19 14:21:53-07:00,['6bd866b92fc5cf6e7a669e2d66c92c18b0ce869e'],3,42,45,916347,1,,,,2513
b51002c576ea9758132d75a8a0fe454e1bc270a2,0,Guozhang Wang,2016-10-19 14:29:53-07:00,['c2a8b86117ede2ffda4cc4a8800b46f65ef9922d'],0,19,19,916366,4,1,1,0.461538462,2513
46666a1f64af3617d7f47f50fedf3b9a6ae5cddb,0,Joel Koshy,2016-10-19 16:34:29-07:00,['b51002c576ea9758132d75a8a0fe454e1bc270a2'],2,2,4,916370,2,,,,2513
17cb4fe52f74fcc1b7c43baa4649e0a4aba80fa3,1,Guozhang Wang,2016-10-19 20:58:18-07:00,['46666a1f64af3617d7f47f50fedf3b9a6ae5cddb'],7,287,294,916664,2,0.182857143,1,0.902857143,2514
4c295a78446be6eba24ca4a9b7e506657e55c875,1,Guozhang Wang,2016-10-19 21:04:28-07:00,['17cb4fe52f74fcc1b7c43baa4649e0a4aba80fa3'],11,57,68,916732,3,0.533333333,1,1,2514
24067e40764d91e1a6b2d80be45407841bbb72a2,1,Ismael Juma,2016-10-20 10:45:31+01:00,['4c295a78446be6eba24ca4a9b7e506657e55c875'],26,133,159,916891,6,0,1,0.430107527,2514
62c0972efc525cc0677bd3fd470bd9fbbd70b004,1,Guozhang Wang,2016-10-20 13:06:25-07:00,['24067e40764d91e1a6b2d80be45407841bbb72a2'],494,1075,1569,918460,20,0.108870968,0.649193548,0.899193548,2517
5cf579a7e43e0d2e6a2a26ede88ee850127aa4a1,0,Jason Gustafson,2016-10-20 16:18:25-07:00,['62c0972efc525cc0677bd3fd470bd9fbbd70b004'],1,1,2,918462,1,,,,2517
2ac70c0b744780c8a7af1f9c8be27a45059da6cc,0,Ismael Juma,2016-10-21 10:12:08+01:00,['5cf579a7e43e0d2e6a2a26ede88ee850127aa4a1'],3,7,10,918472,1,0.666666667,1,0,2517
302a246c72677b1045696f4d6dda51da8c6a1da0,1,Jason Gustafson,2016-10-21 14:41:04-07:00,['2ac70c0b744780c8a7af1f9c8be27a45059da6cc'],61,111,172,918644,2,0,0.714285714,0.571428571,2517
74014af8332c6ec95133cd7fda3848bcd7fb4ce6,0,Ewen Cheslack-Postava,2016-10-21 14:52:06-07:00,['302a246c72677b1045696f4d6dda51da8c6a1da0'],0,9,9,918653,1,1,1,0,2517
7afdad8c37cde4a32ad7ce66ca7a878cf730495e,1,Jason Gustafson,2016-10-21 19:19:04-07:00,['74014af8332c6ec95133cd7fda3848bcd7fb4ce6'],162,463,625,919278,9,0.282758621,0.744827586,1,2519
63da487213765cb543a4255a83acb876a57d3634,1,Guozhang Wang,2016-10-23 21:31:34-07:00,['7afdad8c37cde4a32ad7ce66ca7a878cf730495e'],6,8,14,919292,2,0,1,1,2519
ed5076923483bba36df6d4b70575ee0ffd6a046c,0,Ewen Cheslack-Postava,2016-10-23 22:32:03-07:00,['63da487213765cb543a4255a83acb876a57d3634'],1,1,2,919294,1,,,,2519
b2fa0d75df6ae2959da8c3dbe7d83f692043e577,1,Guozhang Wang,2016-10-24 13:44:27-07:00,['ed5076923483bba36df6d4b70575ee0ffd6a046c'],83,76,159,919453,1,1,1,0,2519
1fc450fdb5f7b16c3bfb39832d7fe348995e2cf4,1,Jun Rao,2016-10-24 16:18:23-07:00,['b2fa0d75df6ae2959da8c3dbe7d83f692043e577'],4,4,8,919461,1,,,,2519
d092673838173d9dedbf5acf3f4e2cd8c736294f,1,Ismael Juma,2016-10-25 02:55:55+01:00,['1fc450fdb5f7b16c3bfb39832d7fe348995e2cf4'],704,477,1181,920642,155,0.470588235,0.705882353,0.117647059,2519
986c15450df8fce4a57bb606959c4ccfb4cde080,0,Ismael Juma,2016-10-25 11:32:57+01:00,['d092673838173d9dedbf5acf3f4e2cd8c736294f'],6,6,12,920654,2,,,,2519
2ac332e9c9015964d993692c99c5ad19c9e2d56b,0,Ismael Juma,2016-10-25 13:07:50+01:00,['986c15450df8fce4a57bb606959c4ccfb4cde080'],2,2,4,920658,2,,,,2519
a4413fc8a42b0222107cad20835e4461141c2ea2,0,Ismael Juma,2016-10-25 13:11:04+01:00,['2ac332e9c9015964d993692c99c5ad19c9e2d56b'],1,5,6,920664,1,0,1,1,2519
dab3617e1af6efe9898b2675d7266272107d9105,0,Guozhang Wang,2016-10-26 12:57:57-07:00,['a4413fc8a42b0222107cad20835e4461141c2ea2'],1,2,3,920667,1,,,,2519
53fc26723ec0a5dfe6b5ce5f17db8b306953a1fb,1,Jason Gustafson,2016-10-27 09:17:34-07:00,['dab3617e1af6efe9898b2675d7266272107d9105'],12,12,24,920691,1,,,,2519
34e9cc5dfae1f0a7b2cab51cb2939d48ba048964,1,Jason Gustafson,2016-10-27 18:41:38-07:00,['53fc26723ec0a5dfe6b5ce5f17db8b306953a1fb'],16,25,41,920732,2,0,0,1,2519
0dd9607f9ca50a385e78af06b66e0e90c1f37076,1,Ismael Juma,2016-10-28 06:31:29-04:00,['34e9cc5dfae1f0a7b2cab51cb2939d48ba048964'],157,210,367,921099,3,0,1,1,2519
a4ab9d02a22e77f0ebca0450e608898d83d4fe18,1,Guozhang Wang,2016-10-29 10:48:17-07:00,['0dd9607f9ca50a385e78af06b66e0e90c1f37076'],549,642,1191,922290,22,1,1,1,2519
29ea4b0f1481aa2ee29694f2b469c16059f9c17e,1,Guozhang Wang,2016-10-30 11:21:44-07:00,['a4ab9d02a22e77f0ebca0450e608898d83d4fe18'],50,277,327,922617,10,0.634146341,0.890243902,1,2519
18223415b091b0c05af4767191bb97b366aa8fa5,0,Guozhang Wang,2016-10-30 11:34:17-07:00,['29ea4b0f1481aa2ee29694f2b469c16059f9c17e'],48,12,60,922677,3,0,0.12,0,2519
76b070284142635d2be78e8f86e779dfdbb0a2e0,0,Guozhang Wang,2016-10-30 11:37:38-07:00,['18223415b091b0c05af4767191bb97b366aa8fa5'],1,156,157,922834,2,1,1,0.910447761,2520
979a7baa7b3039060d1a788ae179dc3593c6821e,1,Jason Gustafson,2016-11-01 08:41:58-07:00,['76b070284142635d2be78e8f86e779dfdbb0a2e0'],3,8,11,922845,1,,,,2520
ba322e54203ffec5779944753f264d70b87a24fd,1,Guozhang Wang,2016-11-01 10:07:58-07:00,['979a7baa7b3039060d1a788ae179dc3593c6821e'],8,56,64,922909,2,0.970588235,1,0.970588235,2520
fbbe5821c26d5e4c7d0dff130ea722fbf90169d8,1,Guozhang Wang,2016-11-01 10:30:13-07:00,['ba322e54203ffec5779944753f264d70b87a24fd'],1,2,3,922912,1,0,1,1,2520
94909a8f83bfe214726f85130ad04d867e022894,1,Jason Gustafson,2016-11-01 11:36:12-07:00,['fbbe5821c26d5e4c7d0dff130ea722fbf90169d8'],18,46,64,922976,2,0,0.941176471,1,2520
c62dc28ceb215da003dba39fa845c29bbd7271fa,1,Gwen Shapira,2016-11-01 18:17:42-07:00,['94909a8f83bfe214726f85130ad04d867e022894'],6,3,9,922985,1,,,,2520
2959bc2ad382fa786bd6209fe742b8218edfa4a8,0,Jason Gustafson,2016-11-01 22:20:19-07:00,['c62dc28ceb215da003dba39fa845c29bbd7271fa'],21,25,46,923031,3,0,0,0,2520
508711d09e7c6070868aadfff1b2627e77f7f3d9,0,Gwen Shapira,2016-11-02 10:27:19-07:00,['2959bc2ad382fa786bd6209fe742b8218edfa4a8'],0,2,2,923033,1,0,0,1,2520
1a2ed8633d6d7194b398a4aa0f0b6f0b4fe4178e,0,Ismael Juma,2016-11-03 07:00:05-04:00,['508711d09e7c6070868aadfff1b2627e77f7f3d9'],1,1,2,923035,1,,,,2520
e795ad96ca9f26cdef01d063b79483a6c9221f27,1,Jason Gustafson,2016-11-03 23:19:01-07:00,['1a2ed8633d6d7194b398a4aa0f0b6f0b4fe4178e'],42,172,214,923249,4,0.5,1,0.986486486,2520
5e7190cf83860190d54815aab957a58c26fd816e,0,Jason Gustafson,2016-11-04 00:37:18-07:00,['e795ad96ca9f26cdef01d063b79483a6c9221f27'],0,1,1,923250,1,,,,2520
0a659e50f7d98c0a195a7dca4ef9f117ab2aa257,1,Ewen Cheslack-Postava,2016-11-04 10:44:05-07:00,['5e7190cf83860190d54815aab957a58c26fd816e'],1,21,22,923272,2,1,1,1,2520
7868e657757d66aed13546dcdba97feeba8f1b14,0,Ewen Cheslack-Postava,2016-11-04 13:29:31-07:00,['0a659e50f7d98c0a195a7dca4ef9f117ab2aa257'],1,1,2,923274,1,,,,2520
5307efe1ae447cc1ba01c699af002b154b3b04e3,1,Ewen Cheslack-Postava,2016-11-04 15:57:12-07:00,['7868e657757d66aed13546dcdba97feeba8f1b14'],1,1,2,923276,1,,,,2520
8f2e0a5ec1dd285fcf47e2df396b897176c2008b,0,Jason Gustafson,2016-11-07 08:47:28-08:00,['5307efe1ae447cc1ba01c699af002b154b3b04e3'],1,1,2,923278,1,,,,2520
471a2ab17df66c52e0a98afa81e0b360560a5e9a,1,Ewen Cheslack-Postava,2016-11-08 09:27:11-08:00,['8f2e0a5ec1dd285fcf47e2df396b897176c2008b'],1,77,78,923356,4,0.46875,0.96875,0.875,2521
92287849e46ee0dad360fcd971c6207aa11777a7,0,Guozhang Wang,2016-11-08 12:10:13-08:00,['471a2ab17df66c52e0a98afa81e0b360560a5e9a'],31,0,31,923387,1,0,0,0,2521
11766ad31861e0350178f59127e471fde2b20970,0,Ewen Cheslack-Postava,2016-11-08 14:47:33-08:00,['92287849e46ee0dad360fcd971c6207aa11777a7'],7,19,26,923413,7,0.625,1,1,2521
6dbe202b6dc3ba638d3a55ff89b594bd334bb8b0,1,Guozhang Wang,2016-11-09 10:37:59-08:00,['11766ad31861e0350178f59127e471fde2b20970'],8,18,26,923439,2,1,1,1,2521
8ab8f37b43e3274ad0d8fb3883e3f432992058ba,0,Guozhang Wang,2016-11-09 10:41:29-08:00,['6dbe202b6dc3ba638d3a55ff89b594bd334bb8b0'],5,5,10,923449,3,,,,2521
7c36fc377650dac8a9d6e5f2d0049a78cd93d2e5,1,Guozhang Wang,2016-11-09 10:43:27-08:00,['8ab8f37b43e3274ad0d8fb3883e3f432992058ba'],35,160,195,923644,12,0.488888889,1,0.822222222,2521
f1e1b6e744cde036d75678575bd5e32c608ecdb1,0,Guozhang Wang,2016-11-09 11:17:37-08:00,['7c36fc377650dac8a9d6e5f2d0049a78cd93d2e5'],23,1,24,923668,2,0,0,1,2521
a66ca1624c692d30b7ae1e25c29915331cbf41e3,0,Guozhang Wang,2016-11-09 11:22:28-08:00,['f1e1b6e744cde036d75678575bd5e32c608ecdb1'],1,1,2,923670,1,,,,2521
da13b537871ee59d30fb82703de4b6b1fcb11dff,0,Ewen Cheslack-Postava,2016-11-09 14:58:02-08:00,['a66ca1624c692d30b7ae1e25c29915331cbf41e3'],2,2,4,923674,2,,,,2521
6972d9476fc036d5fdcc59fb82fb20f063091df8,0,Guozhang Wang,2016-11-09 15:31:11-08:00,['da13b537871ee59d30fb82703de4b6b1fcb11dff'],11,78,89,923763,2,1,1,1,2521
cc62b4f844ca16eee974e75b736af87b7532de0d,0,Guozhang Wang,2016-11-10 07:12:53-08:00,['6972d9476fc036d5fdcc59fb82fb20f063091df8'],41,11,52,923815,1,0,0,0,2521
d8fa4006cb824aa2a8ab890b6754c920ac17182c,1,Guozhang Wang,2016-11-10 17:06:36-08:00,['cc62b4f844ca16eee974e75b736af87b7532de0d'],103,43,146,923961,2,0,0,0.285714286,2521
0fc1898bf6b91ac5f79dbf3da7ebc90da410876d,0,Guozhang Wang,2016-11-11 06:36:15-08:00,['d8fa4006cb824aa2a8ab890b6754c920ac17182c'],5,5,10,923971,1,1,1,1,2521
97839344601cc67256e871bd461e877eed974104,0,Ewen Cheslack-Postava,2016-11-11 09:10:20-08:00,['0fc1898bf6b91ac5f79dbf3da7ebc90da410876d'],5,37,42,924013,6,0.411764706,1,0.529411765,2521
64a860c5853e21ff91109d0acb74b42f2dc20c7c,1,Guozhang Wang,2016-11-11 10:21:03-08:00,['97839344601cc67256e871bd461e877eed974104'],177,60,237,924250,8,0.677777778,0.433333333,0.077777778,2521
7282de39f7b7cef1ca85f21771f2401a4a67eaec,1,Jason Gustafson,2016-11-11 10:21:59-08:00,['64a860c5853e21ff91109d0acb74b42f2dc20c7c'],0,19,19,924269,2,0.8,0.8,1,2521
4f1d8c6859c5767c314de84bd654cb7e1153db4b,0,Ewen Cheslack-Postava,2016-11-11 15:00:40-08:00,['7282de39f7b7cef1ca85f21771f2401a4a67eaec'],2,2,4,924273,1,,,,2521
b7d36b7261ddefea68667a65cc5e2ee0734ed4a1,1,Ewen Cheslack-Postava,2016-11-12 16:11:28-08:00,['4f1d8c6859c5767c314de84bd654cb7e1153db4b'],94,498,592,924865,17,0.165137615,1,0.967889908,2523
1f1d4500623275ca05fe661b608a5119bde934ed,0,Jiangjie Qin,2016-11-14 09:58:53-08:00,['b7d36b7261ddefea68667a65cc5e2ee0734ed4a1'],2,2,4,924869,1,,,,2523
3b4c347949c02b1e2b1dd473deda0f8d2304d027,1,Jason Gustafson,2016-11-14 16:31:04-08:00,['1f1d4500623275ca05fe661b608a5119bde934ed'],1394,1870,3264,928133,120,0.691666667,0.7625,0.7375,2528
a32962af1427483eb103868497d3bfb6d5537fc6,0,Jason Gustafson,2016-11-14 17:07:39-08:00,['3b4c347949c02b1e2b1dd473deda0f8d2304d027'],37,0,37,928170,1,1,0,0,2528
31203efcb20b7efcbad5984b377ad87c58673dbc,0,Ismael Juma,2016-11-15 14:23:36+00:00,['a32962af1427483eb103868497d3bfb6d5537fc6'],1,2,3,928173,1,0,0,1,2528
b902ef985a8d4ce304950fcb2c02499054fe6d24,0,Jason Gustafson,2016-11-16 09:38:42-08:00,['31203efcb20b7efcbad5984b377ad87c58673dbc'],333,4,337,928510,5,0.576923077,0.153846154,0.153846154,2528
39a1c42dfc78b1a55df1312c66daec4a491f0708,0,Guozhang Wang,2016-11-16 11:36:05-08:00,['b902ef985a8d4ce304950fcb2c02499054fe6d24'],3,3,6,928516,3,,,,2528
04a13e82a6cb6346589262faf65e8b484a1948b6,0,Guozhang Wang,2016-11-16 12:46:32-08:00,['39a1c42dfc78b1a55df1312c66daec4a491f0708'],19,16,35,928551,5,0,0,0,2528
249e4136852be49579eef53b2bce0b2506797666,1,Jason Gustafson,2016-11-16 16:30:48-08:00,['04a13e82a6cb6346589262faf65e8b484a1948b6'],39,37,76,928627,15,1,0,0.5,2528
aad93840668ae895fce5762c2491b09c32bc3e0c,0,Ismael Juma,2016-11-17 02:15:14+00:00,['249e4136852be49579eef53b2bce0b2506797666'],3,11,14,928641,3,,,,2528
f3aad3b54b7cbc5109d8398829a31100fd82b3e0,0,Ismael Juma,2016-11-17 02:58:13+00:00,['aad93840668ae895fce5762c2491b09c32bc3e0c'],5,8,13,928654,3,,,,2528
2daa10d77f8f177a8db6ff5de5c511165fedc2f5,1,Guozhang Wang,2016-11-17 12:49:20-08:00,['f3aad3b54b7cbc5109d8398829a31100fd82b3e0'],45,282,327,928981,7,0.161290323,0.838709677,0.983870968,2530
eaf0e4af341818b335d17400b0a02be87a7fff9b,1,Guozhang Wang,2016-11-17 12:52:50-08:00,['2daa10d77f8f177a8db6ff5de5c511165fedc2f5'],150,442,592,929573,21,0.666666667,0.956989247,0.376344086,2531
079ea89b369f13d3c0edcab8dd3f6bd32a31983d,1,Ewen Cheslack-Postava,2016-11-17 14:43:00-08:00,['eaf0e4af341818b335d17400b0a02be87a7fff9b'],20,21,41,929614,5,,,,2531
0e7ba70008fa8961ae55861a4dd3a5370d1d5a69,1,Ismael Juma,2016-11-18 04:29:55+00:00,['079ea89b369f13d3c0edcab8dd3f6bd32a31983d'],277,181,458,930072,44,0.575,0.125,0.1,2531
edfa2806712da9663998195c1a7eed0c96bfa509,0,Ismael Juma,2016-11-19 01:26:53+00:00,['0e7ba70008fa8961ae55861a4dd3a5370d1d5a69'],1,10,11,930083,1,0,0,1,2531
e53babab9cada20cc54a18c0fd63aa5ab84fd012,1,Ismael Juma,2016-11-19 09:33:48+00:00,['edfa2806712da9663998195c1a7eed0c96bfa509'],58,321,379,930462,9,0.329479769,0.774566474,1,2531
bbe84051c724023171370f15d74188eecfeace49,0,Ismael Juma,2016-11-19 09:38:47+00:00,['e53babab9cada20cc54a18c0fd63aa5ab84fd012'],1,1,2,930464,1,,,,2531
44f61ba4f96df995265f9cfa004aa49c82b02374,0,Ismael Juma,2016-11-22 11:29:12+00:00,['bbe84051c724023171370f15d74188eecfeace49'],2,2,4,930468,1,,,,2531
dcea5f83888bb346c8ae20887b57904e046463a7,1,Guozhang Wang,2016-11-22 09:54:54-08:00,['44f61ba4f96df995265f9cfa004aa49c82b02374'],20,91,111,930579,3,0.041666667,0.5,1,2531
4b003d8bcfffded55a00b8ecc9eed8eb373fb6c7,1,Jiangjie Qin,2016-11-22 20:32:42-08:00,['dcea5f83888bb346c8ae20887b57904e046463a7'],193,298,491,931070,4,0,0,0.746835443,2531
0ea540552a52b3265c48aacbb9790ea6e71431a5,0,Ismael Juma,2016-11-23 10:06:10+00:00,['4b003d8bcfffded55a00b8ecc9eed8eb373fb6c7'],4,24,28,931098,3,1,1,1,2531
724cddbc56fec227727db4caf75c77adb62438e6,1,Guozhang Wang,2016-11-23 17:31:34-08:00,['0ea540552a52b3265c48aacbb9790ea6e71431a5'],40,164,204,931302,2,0,0.742268041,1,2531
e035fc039598127e88f31739458f705290b1fdba,0,Sriharsha Chintalapani,2016-11-23 20:48:58-08:00,['724cddbc56fec227727db4caf75c77adb62438e6'],9,358,367,931669,40,,,,2548
3e3b7a010be9959ac6f205a0ea66a2595bb62ae6,1,Ismael Juma,2016-11-24 14:44:54+00:00,['e035fc039598127e88f31739458f705290b1fdba'],16,101,117,931786,2,1,1,0.70212766,2548
a5d28149fb67ab68d9de7d8de63c0de93b80a82c,1,Ewen Cheslack-Postava,2016-11-29 09:11:21-08:00,['3e3b7a010be9959ac6f205a0ea66a2595bb62ae6'],358,9,367,932153,40,,,,2548
6f0cbe7212ba9124488d13e00a24a23e083cb918,0,Ewen Cheslack-Postava,2016-11-29 09:57:22-08:00,['a5d28149fb67ab68d9de7d8de63c0de93b80a82c'],2,5,7,932160,1,,,,2548
7ed3768fb6e16ec97815e1676d27833569ec2a98,0,Jiangjie Qin,2016-11-29 10:03:17-08:00,['6f0cbe7212ba9124488d13e00a24a23e083cb918'],1,4,5,932165,1,,,,2548
7d3aa01ced15d30cd1c5390e76a68a06403cd2c1,1,Ewen Cheslack-Postava,2016-11-29 10:32:32-08:00,['7ed3768fb6e16ec97815e1676d27833569ec2a98'],56,1,57,932222,3,0,0,0.162790698,2548
7d0f3e75ad2934b8ad5b84f81707b01285022523,1,Guozhang Wang,2016-11-29 11:07:39-08:00,['7d3aa01ced15d30cd1c5390e76a68a06403cd2c1'],8,98,106,932328,3,0.219512195,0.902439024,1,2549
b11ead58041f6618b4d585dda32f2d71ef0da46a,0,Ewen Cheslack-Postava,2016-11-29 11:36:06-08:00,['7d0f3e75ad2934b8ad5b84f81707b01285022523'],3,20,23,932351,1,,,,2549
f37dab76f494e313eafc4f64d0eeaed82ddad0f7,0,Jiangjie Qin,2016-11-29 12:17:27-08:00,['b11ead58041f6618b4d585dda32f2d71ef0da46a'],49,45,94,932445,1,1,0.166666667,0,2549
d98ca230a14b0aedae752fa97f5d55b3a0c49b9c,1,Ewen Cheslack-Postava,2016-11-29 15:31:14-08:00,['f37dab76f494e313eafc4f64d0eeaed82ddad0f7'],62,58,120,932565,6,0.5,0,0,2549
5819b06fafd8a1a32276018560e0ff731191caf5,1,Jason Gustafson,2016-11-29 19:04:24-08:00,['d98ca230a14b0aedae752fa97f5d55b3a0c49b9c'],37,6,43,932608,2,1,1,0,2549
1503f7603c1d5e0511bf71175d84bde555c80e9a,1,Jason Gustafson,2016-11-29 19:57:13-08:00,['5819b06fafd8a1a32276018560e0ff731191caf5'],6,106,112,932720,7,0.138888889,0.972222222,0.972222222,2549
497e669dd806fc984f5dceaede4a1f40f4e77c48,1,Joel Koshy,2016-11-30 10:40:31-08:00,['1503f7603c1d5e0511bf71175d84bde555c80e9a'],53,114,167,932887,5,0,0.37037037,1,2549
8d188c9110f7f2a6f9f16f1340d9d254bf583741,0,Guozhang Wang,2016-11-30 12:19:23-08:00,['497e669dd806fc984f5dceaede4a1f40f4e77c48'],1,9,10,932897,1,,,,2549
f9d7808bab52a0a6fa879aaac0b1da80e0f33adb,1,Jason Gustafson,2016-11-30 13:18:04-08:00,['8d188c9110f7f2a6f9f16f1340d9d254bf583741'],41,41,82,932979,1,0,1,1,2549
ea42d65354b5905668d45dedae1cd1f7f39c888c,1,Guozhang Wang,2016-11-30 22:23:31-08:00,['f9d7808bab52a0a6fa879aaac0b1da80e0f33adb'],41,309,350,933329,5,0.654867257,0.96460177,0.973451327,2549
88d8508b85bb11d452658ff5c32afcb12c314f9a,0,Ismael Juma,2016-12-01 15:39:06+00:00,['ea42d65354b5905668d45dedae1cd1f7f39c888c'],6,9,15,933344,1,,,,2549
b65f9a777d46fbe4edfed8a4c7216dd1e741be53,1,Ewen Cheslack-Postava,2016-12-01 14:42:15-08:00,['88d8508b85bb11d452658ff5c32afcb12c314f9a'],197,539,736,934080,8,0.282051282,0.801282051,0.871794872,2550
b45a67ede9021985c8df87c633b225231092c0c9,1,Ewen Cheslack-Postava,2016-12-01 15:01:09-08:00,['b65f9a777d46fbe4edfed8a4c7216dd1e741be53'],51,301,352,934432,6,0,0.674556213,0.976331361,2550
ea370be518a783f3a5d8d834f78c82e36bf968b3,0,Jason Gustafson,2016-12-01 19:14:15-08:00,['b45a67ede9021985c8df87c633b225231092c0c9'],58,48,106,934538,1,1,1,0,2550
128d0ff91d84a3a1f5a5237133f9ec01caf18d66,1,Ismael Juma,2016-12-02 14:00:58+00:00,['ea370be518a783f3a5d8d834f78c82e36bf968b3'],432,435,867,935405,83,0.733333333,0.866666667,0.4,2550
93804d50ffc40fb6cdc61c073f4a62f0931f042d,1,Guozhang Wang,2016-12-02 10:02:50-08:00,['128d0ff91d84a3a1f5a5237133f9ec01caf18d66'],4,4,8,935413,1,,,,2550
b06fc322bf008f55bb8b14c5b02c9af5a90a92ed,1,Guozhang Wang,2016-12-02 11:02:04-08:00,['93804d50ffc40fb6cdc61c073f4a62f0931f042d'],72,113,185,935598,3,0,1,1,2550
e43bbce493192ea5f936867e8cdae163ab850650,0,Jason Gustafson,2016-12-02 20:09:33-08:00,['b06fc322bf008f55bb8b14c5b02c9af5a90a92ed'],4,7,11,935609,1,,,,2550
2d19ad4bb07b4f10f2a314e86bbf4171cdcd7765,1,Guozhang Wang,2016-12-04 10:51:16-08:00,['e43bbce493192ea5f936867e8cdae163ab850650'],16,40,56,935665,4,1,1,1,2550
a55e2963116eb11252b957304b4f399eff3df9c2,1,Guozhang Wang,2016-12-05 11:12:03-08:00,['2d19ad4bb07b4f10f2a314e86bbf4171cdcd7765'],47,61,108,935773,5,1,1,1,2550
34aa538bf3e0a38fe61de66a4536dfe48a6cdc57,0,Ewen Cheslack-Postava,2016-12-05 14:34:14-08:00,['a55e2963116eb11252b957304b4f399eff3df9c2'],4,43,47,935820,2,0,0.961538462,1,2550
f4f0f8222276b630b61355b30827bf1b50160712,1,Ismael Juma,2016-12-06 11:26:12+00:00,['34aa538bf3e0a38fe61de66a4536dfe48a6cdc57'],10,50,60,935880,2,1,,1,2551
8fd5b6a6669b5e2ba921904596a14936b1317304,1,Ismael Juma,2016-12-06 15:03:01+00:00,['f4f0f8222276b630b61355b30827bf1b50160712'],3,3,6,935886,1,,,,2551
a4592a18641f84a1983c5fe7e697a8b0ab43eb25,1,Guozhang Wang,2016-12-06 11:49:54-08:00,['8fd5b6a6669b5e2ba921904596a14936b1317304'],131,226,357,936243,14,0.368421053,1,1,2552
39f62ddcec9f3f915b3ca5941429e79190c93e7b,0,Ewen Cheslack-Postava,2016-12-06 13:57:27-08:00,['a4592a18641f84a1983c5fe7e697a8b0ab43eb25'],1,1,2,936245,1,,,,2552
c9e99f297f3090cd348e231dbeaf69c388de1234,0,Ewen Cheslack-Postava,2016-12-06 14:34:52-08:00,['39f62ddcec9f3f915b3ca5941429e79190c93e7b'],19,23,42,936287,1,1,1,0,2552
b6af35161caa7629ee8c75ab400556cb1ea9c1fd,0,Ismael Juma,2016-12-07 00:23:57+00:00,['c9e99f297f3090cd348e231dbeaf69c388de1234'],0,1,1,936288,1,,,,2552
9e72c12e9811811997b6ca99a6dc56a9af46e43d,1,Ismael Juma,2016-12-07 00:31:49+00:00,['b6af35161caa7629ee8c75ab400556cb1ea9c1fd'],8,24,32,936320,1,0,0,0,2552
56e5627da5bfa01d1fa95e760a6f45949f89996a,0,Jiangjie Qin,2016-12-07 10:08:46-08:00,['9e72c12e9811811997b6ca99a6dc56a9af46e43d'],23,11,34,936354,1,1,0.083333333,1,2552
e9a67a8daaf4be35f292dd06ae3c7797200658fa,1,Guozhang Wang,2016-12-07 12:08:34-08:00,['56e5627da5bfa01d1fa95e760a6f45949f89996a'],13,222,235,936589,5,0.22972973,0.824324324,1,2552
600859e77c8e9a93212815ac26a6ae8b778fee6f,0,Ismael Juma,2016-12-08 15:50:24+00:00,['e9a67a8daaf4be35f292dd06ae3c7797200658fa'],1,12,13,936602,1,0,0,1,2552
1949a76bc4189534b853e21c476bb11172fa3fc9,1,Guozhang Wang,2016-12-08 11:07:59-08:00,['600859e77c8e9a93212815ac26a6ae8b778fee6f'],626,2028,2654,939256,2,,,,2552
006630fd93d8efb823e5b5f7d61584138df984a6,1,Ismael Juma,2016-12-08 23:42:48+00:00,['1949a76bc4189534b853e21c476bb11172fa3fc9'],12,33,45,939301,3,1,1,1,2552
01d58ad8e039181ade742cf896a08199e3cb7483,0,Ismael Juma,2016-12-08 23:46:05+00:00,['006630fd93d8efb823e5b5f7d61584138df984a6'],2,2,4,939305,2,,,,2552
36528df088a28b4373f148627627d7c116297209,0,Jason Gustafson,2016-12-09 09:46:55-08:00,['01d58ad8e039181ade742cf896a08199e3cb7483'],4,4,8,939313,1,,,,2552
9684487b43234b0800d31f689bde48422b7faf87,0,Jason Gustafson,2016-12-09 11:18:38-08:00,['36528df088a28b4373f148627627d7c116297209'],0,4,4,939317,4,1,1,1,2552
055ca9b7a235564f6766d1f2505e900db2d17a4f,1,Jason Gustafson,2016-12-09 11:40:50-08:00,['9684487b43234b0800d31f689bde48422b7faf87'],0,68,68,939385,2,,,,2554
7f8edbc8e848d22b1cb016a7208bee1e52a65b73,1,Jason Gustafson,2016-12-09 14:55:42-08:00,['055ca9b7a235564f6766d1f2505e900db2d17a4f'],11,34,45,939430,1,0,1,0.230769231,2554
9bed8fbcfc52ced719f2dcafa3f30cbfd5e6bd57,1,Guozhang Wang,2016-12-09 16:17:36-08:00,['7f8edbc8e848d22b1cb016a7208bee1e52a65b73'],76,617,693,940123,24,0.680327869,0.975409836,0.795081967,2563
7c7becd4cb88b372d199b05661f8efb1e1d022e6,1,Guozhang Wang,2016-12-09 17:17:55-08:00,['9bed8fbcfc52ced719f2dcafa3f30cbfd5e6bd57'],3,8,11,940134,1,1,1,1,2563
8e9e1776790abb0a9b103f75d0231dd66d09e68f,0,Ewen Cheslack-Postava,2016-12-10 12:48:51-08:00,['7c7becd4cb88b372d199b05661f8efb1e1d022e6'],10,28,38,940172,2,1,1,0.833333333,2563
1d586cb50a94540f6b931a8d525ba75273f314f0,1,Guozhang Wang,2016-12-10 21:48:44-08:00,['8e9e1776790abb0a9b103f75d0231dd66d09e68f'],41,114,155,940327,3,0,0.877192982,1,2563
6f7ed15dad8d914ae65a595eef327c0510f11469,1,Guozhang Wang,2016-12-10 21:53:46-08:00,['1d586cb50a94540f6b931a8d525ba75273f314f0'],7,18,25,940352,3,1,1,1,2563
62e043a86565cc9bc485658d6c6d176e9aff620f,1,Ewen Cheslack-Postava,2016-12-11 18:43:23-08:00,['6f7ed15dad8d914ae65a595eef327c0510f11469'],167,400,567,940919,45,0.35,0.666666667,0.45,2563
f0acc4a0dd49c80929c36a073733c0147b2cd64a,0,Ismael Juma,2016-12-12 03:08:12+00:00,['62e043a86565cc9bc485658d6c6d176e9aff620f'],0,1,1,940920,1,1,1,1,2563
efeaf129890c2195b4753d5b9eece4f1b7cdf756,1,Jason Gustafson,2016-12-12 09:38:25-08:00,['f0acc4a0dd49c80929c36a073733c0147b2cd64a'],28,36,64,940984,4,0.571428571,0.857142857,1,2563
21d7e6f19bd36a7ad16291294fc933f9abfac9b7,1,Guozhang Wang,2016-12-12 18:00:00-08:00,['efeaf129890c2195b4753d5b9eece4f1b7cdf756'],2,135,137,941121,7,1,1,0.978723404,2563
6626b058c7893ce1192456b3fc7617f98da6f3cc,0,Guozhang Wang,2016-12-13 09:44:11-08:00,['21d7e6f19bd36a7ad16291294fc933f9abfac9b7'],8,8,16,941137,1,,,,2563
67f1e5b91bf073151ff57d5d656693e385726697,1,Jason Gustafson,2016-12-13 10:26:25-08:00,['6626b058c7893ce1192456b3fc7617f98da6f3cc'],3914,5269,9183,950320,89,1,1,0.760262726,2573
859113786957a36381222f21287a940767e92f1c,1,Guozhang Wang,2016-12-13 12:11:09-08:00,['67f1e5b91bf073151ff57d5d656693e385726697'],25,233,258,950578,4,0.3125,0.714285714,1,2574
448f194c70e7a66ae2f1a7e89c822032359b14c9,1,Guozhang Wang,2016-12-13 12:34:46-08:00,['859113786957a36381222f21287a940767e92f1c'],0,26,26,950604,2,1,1,1,2574
53428694a624a1956cb8fa3a6a674638f9b09816,1,Guozhang Wang,2016-12-13 17:59:49-08:00,['448f194c70e7a66ae2f1a7e89c822032359b14c9'],4101,4215,8316,958920,11,,,,2575
70499381658e85cfdcfc4f0cd65424b92a8620cd,0,Guozhang Wang,2016-12-14 13:01:43-08:00,['53428694a624a1956cb8fa3a6a674638f9b09816'],1,0,1,958921,1,,,,2575
ea724497a85e922af6acccd02d7e7466871fb339,1,Guozhang Wang,2016-12-15 09:44:09-08:00,['70499381658e85cfdcfc4f0cd65424b92a8620cd'],18,50,68,958989,5,0.590909091,0.181818182,0,2575
a9687bc0d8ddab27c83f7e6f3e87d9e74e32c8df,0,Jun Rao,2016-12-15 11:14:41-08:00,['ea724497a85e922af6acccd02d7e7466871fb339'],4,33,37,959026,2,0,1,1,2575
908b6d1148df963d21a70aaa73a7a87571b965a9,1,Jiangjie Qin,2016-12-15 13:23:01-08:00,['a9687bc0d8ddab27c83f7e6f3e87d9e74e32c8df'],4,46,50,959076,1,1,1,1,2575
e36e8079d8a005550c5281ecebb4b7b622cc41b1,1,Jun Rao,2016-12-15 15:46:26-08:00,['908b6d1148df963d21a70aaa73a7a87571b965a9'],36,109,145,959221,7,0.113207547,0.830188679,0.566037736,2575
c2cfadf254c9d5da14db1db9a4a3889c20192f60,0,Guozhang Wang,2016-12-15 15:54:29-08:00,['e36e8079d8a005550c5281ecebb4b7b622cc41b1'],66,0,66,959287,1,,,,2575
233cd4b18af83e9f9eadfaf048cdaa1888faf546,1,Guozhang Wang,2016-12-15 16:49:35-08:00,['c2cfadf254c9d5da14db1db9a4a3889c20192f60'],1,50,51,959338,2,0,1,1,2575
056ed86600ebf884057ea24daafc9e3b1ab85b81,1,Guozhang Wang,2016-12-15 17:22:41-08:00,['233cd4b18af83e9f9eadfaf048cdaa1888faf546'],29,108,137,959475,3,0.2,1,0.8,2575
e55205b810b6717c5135a463d2fe98975b117187,1,Guozhang Wang,2016-12-15 17:26:44-08:00,['056ed86600ebf884057ea24daafc9e3b1ab85b81'],1,1,2,959477,1,,,,2575
b58b6a1bef0ecdc2107a415e222af099fcd9bce3,1,Jason Gustafson,2016-12-16 10:41:27-08:00,['e55205b810b6717c5135a463d2fe98975b117187'],224,241,465,959942,38,1,1,1,2575
e156f5179f18e045b8f47e8fe5c1e39eaee2afec,0,Ismael Juma,2016-12-16 15:02:46-08:00,['b58b6a1bef0ecdc2107a415e222af099fcd9bce3'],1,1,2,959944,1,,,,2575
d6b0b520fc0755fa560af84f5fc4c9f86699739c,1,Ismael Juma,2016-12-17 04:24:15-08:00,['e156f5179f18e045b8f47e8fe5c1e39eaee2afec'],104,484,588,960532,22,0.736842105,0.905263158,0.715789474,2577
65acff32d195a2ac6e3d7ca4542702065417ba66,1,Guozhang Wang,2016-12-19 12:22:37-08:00,['d6b0b520fc0755fa560af84f5fc4c9f86699739c'],18,56,74,960606,2,1,1,1,2577
bc9ef716af8ac387d63b22ee973a9fc6f864bebb,0,Jason Gustafson,2016-12-19 12:37:58-08:00,['65acff32d195a2ac6e3d7ca4542702065417ba66'],49,123,172,960778,2,0,0.392156863,0.941176471,2577
529ca3293254cc84fef82dbe5931e98129f6dba3,0,Ismael Juma,2016-12-19 23:39:35+00:00,['bc9ef716af8ac387d63b22ee973a9fc6f864bebb'],2,2,4,960782,1,,,,2577
8dbdc90bae940b47dfaf28a0066b061ebfa87b87,1,Ismael Juma,2016-12-19 23:41:56+00:00,['529ca3293254cc84fef82dbe5931e98129f6dba3'],1,2,3,960785,1,,,,2577
8b84d14c6fb338e9e6a6d41fe0a6298a63cfc5c0,1,Ismael Juma,2016-12-20 00:32:44+00:00,['8dbdc90bae940b47dfaf28a0066b061ebfa87b87'],3,6,9,960794,1,0,1,0,2577
a786be94788816bbce32a6cd6ffcf8949ed95556,0,Jiangjie Qin,2016-12-19 18:35:30-08:00,['8b84d14c6fb338e9e6a6d41fe0a6298a63cfc5c0'],132,156,288,961082,12,1,1,1,2578
135860225ecb579d77d6f364b33471fa261ae0b0,1,Ismael Juma,2016-12-20 10:49:19+00:00,['a786be94788816bbce32a6cd6ffcf8949ed95556'],254,2,256,961338,3,,,,2578
a5c15ba0374acbb43f69b1a556077e4ad53332e8,1,Ismael Juma,2016-12-20 12:40:07+00:00,['135860225ecb579d77d6f364b33471fa261ae0b0'],41,27,68,961406,17,0,0,0,2578
0321bf5aa67b52d7fab82a326b15ca8e058faee6,1,Guozhang Wang,2016-12-20 09:59:25-08:00,['a5c15ba0374acbb43f69b1a556077e4ad53332e8'],1,64,65,961471,2,0.901960784,0.901960784,0.901960784,2578
56c61745deeadd299e5ef24577c1bdf5d9d231a0,1,Guozhang Wang,2016-12-20 10:30:33-08:00,['0321bf5aa67b52d7fab82a326b15ca8e058faee6'],64,225,289,961760,2,0,1,1,2578
7f4b278c030f6e5cff8caca6428f0e631c8918ec,1,Guozhang Wang,2016-12-20 10:35:52-08:00,['56c61745deeadd299e5ef24577c1bdf5d9d231a0'],3,4,7,961767,1,0,0,1,2578
3930dd7e7502ab94a7594a0ca41f27638663ae7c,1,Jason Gustafson,2016-12-20 11:01:46-08:00,['7f4b278c030f6e5cff8caca6428f0e631c8918ec'],48,78,126,961893,5,0,1,1,2579
0f86dbe89da19ed1cc9142a5362cfa2fe3bc48ee,1,Ismael Juma,2016-12-21 00:07:10+00:00,['3930dd7e7502ab94a7594a0ca41f27638663ae7c'],79,131,210,962103,9,1,1,0.689655172,2579
68f204e01bb6fd8b9b6c56dff7a2b0daa448764d,1,Jason Gustafson,2016-12-20 16:36:32-08:00,['0f86dbe89da19ed1cc9142a5362cfa2fe3bc48ee'],563,546,1109,963212,46,1,0.29787234,0.382978723,2579
ecc0fc447a496494130648820e5b9c3536fc78f6,0,Guozhang Wang,2016-12-20 17:39:07-08:00,['68f204e01bb6fd8b9b6c56dff7a2b0daa448764d'],2,2,4,963216,1,,,,2579
fc88bac66686ef963b5aec53a3eba717336e4ba7,1,Jun Rao,2016-12-20 21:31:50-08:00,['ecc0fc447a496494130648820e5b9c3536fc78f6'],42,130,172,963388,6,0,0.075471698,0.41509434,2579
baab43f0d218e743693a933c0d6c44c428ebfc93,0,Guozhang Wang,2016-12-21 09:38:52-08:00,['fc88bac66686ef963b5aec53a3eba717336e4ba7'],9,6,15,963403,1,,,,2579
05d76643174e64b183cb9c315e9dad94d5775d4f,0,Guozhang Wang,2016-12-21 11:37:32-08:00,['baab43f0d218e743693a933c0d6c44c428ebfc93'],1,1,2,963405,1,,,,2579
3c1df09cd50b8c4796f698d0ceec9160fad3f434,0,Guozhang Wang,2016-12-21 12:36:54-08:00,['05d76643174e64b183cb9c315e9dad94d5775d4f'],1,1,2,963407,1,,,,2579
7599d5d78be2d67119e6e56b67acd50b1a8fba67,0,Guozhang Wang,2016-12-21 13:33:39-08:00,['3c1df09cd50b8c4796f698d0ceec9160fad3f434'],6,6,12,963419,2,,,,2579
8ff5a9f3cf1765674e21dc35e9d7570816954e25,0,Guozhang Wang,2016-12-21 16:25:28-08:00,['7599d5d78be2d67119e6e56b67acd50b1a8fba67'],2,2,4,963423,1,,,,2579
76169f9e24fb62dbc6bcd6520bc910272c43aceb,0,Guozhang Wang,2016-12-22 08:15:21-08:00,['8ff5a9f3cf1765674e21dc35e9d7570816954e25'],2,2,4,963427,1,,,,2579
9eb665c39af1950548f903ad959449f2e69d7671,1,Ismael Juma,2016-12-24 09:21:53+00:00,['76169f9e24fb62dbc6bcd6520bc910272c43aceb'],46,551,597,964024,15,0.633561644,0.938356164,0.702054795,2581
d092146247f3b3de061ecdb4ddfeac9321d8cf73,0,Ewen Cheslack-Postava,2016-12-24 17:25:01-05:00,['9eb665c39af1950548f903ad959449f2e69d7671'],53,53,106,964130,5,1,0,1,2581
4ca5abe8ee7578f602fb7653cb8a09640607ea85,1,Ewen Cheslack-Postava,2016-12-27 15:02:22-05:00,['d092146247f3b3de061ecdb4ddfeac9321d8cf73'],0,21,21,964151,2,1,1,1,2581
8e1395b1702fcf7465324a3f52b391245137fd54,0,Ismael Juma,2016-12-28 11:56:35+00:00,['4ca5abe8ee7578f602fb7653cb8a09640607ea85'],1,1,2,964153,1,,,,2581
88a439ed8e78803ae47783c3e5a75d4e4cad2a77,1,Ismael Juma,2016-12-28 12:49:00+00:00,['8e1395b1702fcf7465324a3f52b391245137fd54'],12,29,41,964194,2,0.214285714,0,0.928571429,2581
dc550259ea04011b22501c82dd6510a29b5a9b0f,1,Ismael Juma,2016-12-28 17:34:31+00:00,['88a439ed8e78803ae47783c3e5a75d4e4cad2a77'],10,37,47,964241,2,1,1,1,2581
e79954637782c104171bad2a1227b0d7a12e2efa,1,Ewen Cheslack-Postava,2016-12-29 12:03:24-05:00,['dc550259ea04011b22501c82dd6510a29b5a9b0f'],5,32,37,964278,1,,,,2581
64bab80520e4a5452cd60de8e982ffd2be806ff7,0,Ewen Cheslack-Postava,2016-12-29 21:05:11-08:00,['e79954637782c104171bad2a1227b0d7a12e2efa'],1,1,2,964280,1,,,,2581
3d7e88456f14fbac66309973f1334cb32c10e3ea,0,Ewen Cheslack-Postava,2016-12-29 21:14:26-08:00,['64bab80520e4a5452cd60de8e982ffd2be806ff7'],2,3,5,964285,1,,,,2581
29d456cd21d8f3430d52db50a8fd17cc8d700f36,0,Ismael Juma,2016-12-31 12:22:23+00:00,['3d7e88456f14fbac66309973f1334cb32c10e3ea'],20,92,112,964397,3,0.058823529,1,1,2582
6f09bcb59cd42521152cd8439df94606036ad85f,0,Guozhang Wang,2016-12-31 10:49:27-08:00,['29d456cd21d8f3430d52db50a8fd17cc8d700f36'],5,11,16,964413,1,0,0,0,2582
252e7e958a2fabfa680d23a00e7f0ce7c74f6ad8,1,Ismael Juma,2017-01-03 11:07:57+00:00,['6f09bcb59cd42521152cd8439df94606036ad85f'],20,18,38,964451,7,0,0,0,2582
7411ed89be151be4b3df6f0d2adab956b79e2885,1,Ismael Juma,2017-01-03 15:47:44+00:00,['252e7e958a2fabfa680d23a00e7f0ce7c74f6ad8'],54,40,94,964545,1,1,0,0,2582
cea2a669b34b2f94d445aace2b6e95e70af7e2f6,1,Guozhang Wang,2017-01-03 08:34:15-08:00,['7411ed89be151be4b3df6f0d2adab956b79e2885'],128,431,559,965104,16,0.022421525,0.874439462,1,2582
9e9e6d8752646436cb836af03a8906605fa76471,0,Guozhang Wang,2017-01-03 08:57:30-08:00,['cea2a669b34b2f94d445aace2b6e95e70af7e2f6'],22,66,88,965192,3,0,1,1,2582
7f22ab6550813124ce2bb5254a925c0da3eb1ab9,0,Guozhang Wang,2017-01-03 09:11:07-08:00,['9e9e6d8752646436cb836af03a8906605fa76471'],14,16,30,965222,1,1,1,1,2582
a565a77b1f9c42e5255afc096b58602869cb0cc5,0,Jason Gustafson,2017-01-03 11:02:20-08:00,['7f22ab6550813124ce2bb5254a925c0da3eb1ab9'],1,60,61,965283,1,,,,2582
b565dd7eb184da5ef3b08c88a8acc3df221aaa08,1,Jason Gustafson,2017-01-03 13:54:40-08:00,['a565a77b1f9c42e5255afc096b58602869cb0cc5'],12,40,52,965335,2,1,0.8,0.6,2582
ce1cb329d5aa788968e47d7dfe307128f2ddc2ff,0,Ewen Cheslack-Postava,2017-01-03 14:49:33-08:00,['b565dd7eb184da5ef3b08c88a8acc3df221aaa08'],6,17,23,965358,1,,,,2582
6d6c77a7a9c102f7508e4bc48e0d6eba1fcbc9c6,1,Jason Gustafson,2017-01-03 19:53:20-08:00,['ce1cb329d5aa788968e47d7dfe307128f2ddc2ff'],617,458,1075,966433,54,0.587155963,0.880733945,0,2583
d62ef55252594bbfa1c26fab19207a9632f7bdd3,0,Guozhang Wang,2017-01-03 21:41:14-08:00,['6d6c77a7a9c102f7508e4bc48e0d6eba1fcbc9c6'],7,17,24,966457,2,1,1,1,2583
ac57d1751186967bcba6aceffa6857a4449fa70c,0,Ismael Juma,2017-01-04 09:41:14+00:00,['d62ef55252594bbfa1c26fab19207a9632f7bdd3'],1,5,6,966463,2,1,1,1,2583
7959bf50696f309c7bf8022461b8cad113ceda8a,0,Ismael Juma,2017-01-04 11:58:54+00:00,['ac57d1751186967bcba6aceffa6857a4449fa70c'],1,3,4,966467,1,,,,2583
0cd5afdb611d6d35009b9806be6bdf9874999bb3,1,Ismael Juma,2017-01-04 13:55:36+00:00,['7959bf50696f309c7bf8022461b8cad113ceda8a'],0,80,80,966547,2,0.555555556,1,1,2584
d3572648b6c3524784fc3f60964a7f28817cbd55,0,Ismael Juma,2017-01-05 10:26:02+00:00,['0cd5afdb611d6d35009b9806be6bdf9874999bb3'],11,44,55,966602,2,1,1,1,2585
77c4eb13a4edf82a7fa6850974673eb743c463c9,1,Ismael Juma,2017-01-05 11:02:56+00:00,['d3572648b6c3524784fc3f60964a7f28817cbd55'],2,2,4,966606,1,,,,2585
050288ab121bfdf486fd94d1a4926e3a819d18d0,1,Guozhang Wang,2017-01-05 11:27:25-08:00,['77c4eb13a4edf82a7fa6850974673eb743c463c9'],24,61,85,966691,3,,,,2585
2e1bcf661df8f22ee05f5bd883a8b501588fc4e2,0,Ewen Cheslack-Postava,2017-01-05 15:25:00-08:00,['050288ab121bfdf486fd94d1a4926e3a819d18d0'],7,35,42,966733,3,0.181818182,1,1,2585
b7da847f6ae5786925d65a673b7e80f2de8fe389,1,Ismael Juma,2017-01-06 11:23:03+00:00,['2e1bcf661df8f22ee05f5bd883a8b501588fc4e2'],40,255,295,967028,4,0.112781955,1,1,2586
00964ec74d0b3124c88958d5c0db4266e4e38f37,1,Guozhang Wang,2017-01-06 08:24:09-08:00,['b7da847f6ae5786925d65a673b7e80f2de8fe389'],50,116,166,967194,5,,,,2586
e0de3a4211a3701c98230b115fadfb67b655e3cf,1,Guozhang Wang,2017-01-06 10:12:30-08:00,['00964ec74d0b3124c88958d5c0db4266e4e38f37'],738,5237,5975,973169,81,0.693225191,1,0.926526718,2619
10b330cf057a90038407a89fdb59d096da01bc55,1,Guozhang Wang,2017-01-06 11:48:11-08:00,['e0de3a4211a3701c98230b115fadfb67b655e3cf'],33,86,119,973288,7,1,1,1,2619
fa80093c067e6684e005bfd548770541b5b2778b,1,Ewen Cheslack-Postava,2017-01-08 16:15:05-08:00,['10b330cf057a90038407a89fdb59d096da01bc55'],1,264,265,973553,10,,,,2626
42a6b7166348455482934f7845160d10cd435eaa,1,Ewen Cheslack-Postava,2017-01-08 20:08:07-08:00,['fa80093c067e6684e005bfd548770541b5b2778b'],3,49,52,973605,2,0.314285714,1,1,2626
52e397962b624f3c881b6f99e71c94da32cf6a33,1,Guozhang Wang,2017-01-09 11:13:09-08:00,['42a6b7166348455482934f7845160d10cd435eaa'],206,178,384,973989,4,0,0,0,2626
64514ff5ec2ec9616dd7b11308d8da4f095edb37,0,Guozhang Wang,2017-01-09 15:17:23-08:00,['52e397962b624f3c881b6f99e71c94da32cf6a33'],36,46,82,974071,12,,,,2626
109aa353686cc0a9e4448c2b48da63f1d79acae6,1,Guozhang Wang,2017-01-09 20:17:16-08:00,['64514ff5ec2ec9616dd7b11308d8da4f095edb37'],54,138,192,974263,8,1,0.310344828,1,2626
e4720569bb5fc866351c0887a8a8dcd9b8f5bc32,0,Ewen Cheslack-Postava,2017-01-09 22:11:58-08:00,['109aa353686cc0a9e4448c2b48da63f1d79acae6'],1,1,2,974265,1,,,,2626
5401a17ad7b9f0879cf66c4dbc6167512c2523a8,0,Ewen Cheslack-Postava,2017-01-09 22:53:48-08:00,['e4720569bb5fc866351c0887a8a8dcd9b8f5bc32'],1,1,2,974267,1,,,,2626
54e2bd210029b124be4835d5c50c56aa5edc5b38,0,Ewen Cheslack-Postava,2017-01-09 23:53:38-08:00,['5401a17ad7b9f0879cf66c4dbc6167512c2523a8'],2,2,4,974271,2,,,,2626
044b56b8b5106f5115de7054ac95e199f1b621ea,1,Ewen Cheslack-Postava,2017-01-10 00:42:41-08:00,['54e2bd210029b124be4835d5c50c56aa5edc5b38'],3,340,343,974614,4,0.810344828,1,0.642241379,2627
1fea1c390846673fd39452100e949be61c21b9ce,1,Ismael Juma,2017-01-10 11:41:04+00:00,['044b56b8b5106f5115de7054ac95e199f1b621ea'],3,3,6,974620,3,,,,2627
275c5e1df237808fe72b8d9933f826949d4b5781,1,Jun Rao,2017-01-10 08:05:07-05:00,['1fea1c390846673fd39452100e949be61c21b9ce'],63,2462,2525,977145,42,0.686767169,0.881072027,0.838358459,2645
fe82330f0be1d478b134732a9d29c229b37afe3b,1,Guozhang Wang,2017-01-10 09:38:30-08:00,['275c5e1df237808fe72b8d9933f826949d4b5781'],29,29,58,977203,7,,,,2645
75469a3b602c26ea81d6fc0a409d39d321195ea4,1,Guozhang Wang,2017-01-10 11:53:03-08:00,['fe82330f0be1d478b134732a9d29c229b37afe3b'],226,227,453,977656,17,0,1,1,2645
a95170f822227c50414c57860e8547dc2e9d84cb,1,Guozhang Wang,2017-01-11 09:11:18-08:00,['75469a3b602c26ea81d6fc0a409d39d321195ea4'],372,465,837,978493,69,0.882352941,0.282352941,1,2645
4b71c0bdc1acf244e3c96fa809a1a0e48471d586,1,Guozhang Wang,2017-01-11 09:15:26-08:00,['a95170f822227c50414c57860e8547dc2e9d84cb'],411,672,1083,979576,24,0.913043478,1,1,2647
d1733953742236e0430aff4e502bd8ee7c642591,0,Guozhang Wang,2017-01-11 09:37:06-08:00,['4b71c0bdc1acf244e3c96fa809a1a0e48471d586'],1,1,2,979578,1,,,,2647
3d60f1e64350710a5fd2a6036da353cc83195741,1,Ismael Juma,2017-01-11 19:25:58+00:00,['d1733953742236e0430aff4e502bd8ee7c642591'],1194,2184,3378,982956,81,0.637532134,0.730077121,0.802056555,2650
ecff8544dd45e8cf0fcf04f5e0e716d3e21c9f20,1,Guozhang Wang,2017-01-11 12:06:18-08:00,['3d60f1e64350710a5fd2a6036da353cc83195741'],585,1627,2212,985168,53,0.648702595,0.998003992,0.838323353,2654
f72203ee9223d3b724ee67bdad9912612dd72f63,1,Jason Gustafson,2017-01-11 15:56:56-08:00,['ecff8544dd45e8cf0fcf04f5e0e716d3e21c9f20'],68,603,671,985839,10,0.613810742,0.739130435,0.618925831,2654
6508e63c7ab1fbabb322754fabf41eb75bbbcec2,0,Ismael Juma,2017-01-12 01:36:31+00:00,['f72203ee9223d3b724ee67bdad9912612dd72f63'],104,223,327,986166,11,0,0.954545455,0,2655
23dff4b04a4c4cd338b5f39c9bb7d384857c482c,1,Guozhang Wang,2017-01-11 20:30:47-08:00,['6508e63c7ab1fbabb322754fabf41eb75bbbcec2'],28,595,623,986789,6,0.577981651,0.958715596,0.733944954,2656
3c60511655df3349323e394bdc3836300991352f,1,Guozhang Wang,2017-01-11 20:33:42-08:00,['23dff4b04a4c4cd338b5f39c9bb7d384857c482c'],135,335,470,987259,15,1,1,1,2658
7ff407eaa2761d8f86f39cf99e703634761e038c,1,Guozhang Wang,2017-01-12 11:25:17-08:00,['3c60511655df3349323e394bdc3836300991352f'],3,3,6,987265,1,,,,2658
c063172c23394db94320bf095f15f82999da321b,0,Gwen Shapira,2017-01-12 11:28:46-08:00,['7ff407eaa2761d8f86f39cf99e703634761e038c'],2,2,4,987269,1,,,,2658
8079c980ac5c9c00d7577fa05857b4de6864dbb5,1,Guozhang Wang,2017-01-12 11:46:02-08:00,['c063172c23394db94320bf095f15f82999da321b'],695,4322,5017,992286,93,0.663667042,0.957255343,0.826209224,2687
a1e8b507d274f03f542866d72b14d9d664acfad0,0,Guozhang Wang,2017-01-12 15:44:23-08:00,['8079c980ac5c9c00d7577fa05857b4de6864dbb5'],2,0,2,992288,1,,,,2687
2f904883237c476fd82a202f7ddda93fe56eef36,1,Ewen Cheslack-Postava,2017-01-12 16:14:53-08:00,['a1e8b507d274f03f542866d72b14d9d664acfad0'],156,1692,1848,994136,35,0.491758242,0.835164835,0.868131868,2698
b6011918fbc36bfaa465bdcc750e2435985d9101,0,Guozhang Wang,2017-01-12 16:20:05-08:00,['2f904883237c476fd82a202f7ddda93fe56eef36'],26,20,46,994182,5,,,,2698
ad8ddf737aea629b607693dbb2ee631937db698f,0,Ewen Cheslack-Postava,2017-01-12 17:09:30-08:00,['b6011918fbc36bfaa465bdcc750e2435985d9101'],2,3,5,994187,1,0,0,1,2698
2b6ba55c73b72fb3bfb6ebb2e2c8507cbacd5690,0,Ismael Juma,2017-01-13 02:20:58+00:00,['ad8ddf737aea629b607693dbb2ee631937db698f'],3,2,5,994192,1,,,,2698
2eb32d6a70bcdef86bf87f9afd56b70de9df505e,1,Ismael Juma,2017-01-13 02:31:19+00:00,['2b6ba55c73b72fb3bfb6ebb2e2c8507cbacd5690'],33,52,85,994277,5,1,1,1,2698
8d9d847904e28759b44ffc87752802e8e6f1f659,0,Ismael Juma,2017-01-13 10:34:15+00:00,['2eb32d6a70bcdef86bf87f9afd56b70de9df505e'],5,22,27,994304,3,0,1,1,2698
80d6c64c1b83c25e11e653abb0356f1cbcbba6e8,0,Jason Gustafson,2017-01-13 09:32:46-08:00,['8d9d847904e28759b44ffc87752802e8e6f1f659'],0,2,2,994306,1,,,,2698
d25671884bbbdf7843ada3e7797573a00ac7cd56,1,Jason Gustafson,2017-01-13 10:00:06-08:00,['80d6c64c1b83c25e11e653abb0356f1cbcbba6e8'],498,1049,1547,995853,58,0.409090909,0.886363636,0.772727273,2700
7a61ce4cf40c0a9c75fab4757722010576d3f18d,1,Ewen Cheslack-Postava,2017-01-13 10:22:38-08:00,['d25671884bbbdf7843ada3e7797573a00ac7cd56'],2,2,4,995857,1,,,,2700
6496271a11003195d703292a68c6a6c04e56d79d,0,Ismael Juma,2017-01-13 19:04:57+00:00,['7a61ce4cf40c0a9c75fab4757722010576d3f18d'],32,2,34,995891,3,,,,2700
f6fee34a2d6315cd25855b9805e2f4129e24e5c3,0,Jason Gustafson,2017-01-13 11:09:26-08:00,['6496271a11003195d703292a68c6a6c04e56d79d'],5,27,32,995923,4,0.571428571,0,0.642857143,2700
d1956d4b6c3ab30cba78bc6f6034ec20303e4801,1,Guozhang Wang,2017-01-13 11:11:17-08:00,['f6fee34a2d6315cd25855b9805e2f4129e24e5c3'],4,3,7,995930,2,1,0,0,2700
fc0d612b0806032675b433a48f56ccd04f7e52cf,1,Guozhang Wang,2017-01-13 11:13:16-08:00,['d1956d4b6c3ab30cba78bc6f6034ec20303e4801'],2,114,116,996046,3,0.459459459,1,1,2700
e90db3e3af0718a80d729809186d45076e71a241,1,Guozhang Wang,2017-01-13 11:28:40-08:00,['fc0d612b0806032675b433a48f56ccd04f7e52cf'],179,160,339,996385,18,1,0.375,0.333333333,2700
88fdca26a0881d12e9f3ba942cd580c8e8154025,1,Ewen Cheslack-Postava,2017-01-13 11:38:25-08:00,['e90db3e3af0718a80d729809186d45076e71a241'],25,218,243,996628,10,0.183206107,0.740458015,0.977099237,2701
c2d9b95f36a9bb853bb3851696161d7f7f790bec,1,Jason Gustafson,2017-01-13 17:16:28-08:00,['88fdca26a0881d12e9f3ba942cd580c8e8154025'],220,693,913,997541,21,0.30794702,0.254966887,0.894039735,2701
bc61d9bee67f7f6d403f834a80b517e59405930b,0,Jun Rao,2017-01-13 21:30:10-05:00,['c2d9b95f36a9bb853bb3851696161d7f7f790bec'],0,5,5,997546,1,0,0,1,2701
da57bc27e7cb52cb1e817010ed5101188cbeb68e,1,Jason Gustafson,2017-01-13 19:46:02-08:00,['bc61d9bee67f7f6d403f834a80b517e59405930b'],231,636,867,998413,23,0.417989418,0.894179894,0.740740741,2705
d2f6b934bcbd8feca561e050ff8e18d0a4db7d61,1,Ismael Juma,2017-01-15 09:55:11+00:00,['da57bc27e7cb52cb1e817010ed5101188cbeb68e'],2,2,4,998417,1,,,,2705
b712b8675d6977a9171edc6569cf382ffcd91354,1,Ismael Juma,2017-01-16 10:56:03+00:00,['d2f6b934bcbd8feca561e050ff8e18d0a4db7d61'],16,33,49,998466,3,0.8125,0.8125,1,2705
a8eb1d13e0d962ca3bb3f7708cbf92bd97b54ffd,0,Guozhang Wang,2017-01-16 11:24:20-08:00,['b712b8675d6977a9171edc6569cf382ffcd91354'],11,189,200,998666,2,0.12,1,1,2705
6e42ce8fe8035872af2815368f707abf6e6ad8b5,0,Ewen Cheslack-Postava,2017-01-16 11:39:13-08:00,['a8eb1d13e0d962ca3bb3f7708cbf92bd97b54ffd'],3,3,6,998672,3,,,,2705
b62804a252b96932952006a483b3afd7da7363ab,1,Guozhang Wang,2017-01-16 11:40:47-08:00,['6e42ce8fe8035872af2815368f707abf6e6ad8b5'],11,10,21,998693,3,1,0,1,2705
b4d8668d6d47fca8cc6de4f550d703cd8926c436,1,Ismael Juma,2017-01-17 11:16:29+00:00,['b62804a252b96932952006a483b3afd7da7363ab'],48,99,147,998840,1,,,,2705
55abe65e0996008d54bd5bb8440906ac4a359937,0,Ismael Juma,2017-01-17 12:55:07+00:00,['b4d8668d6d47fca8cc6de4f550d703cd8926c436'],2,46,48,998888,5,0,1,0.277777778,2705
7a84b241eeb8cb63400a9512b066c3f733f94b8c,1,Jason Gustafson,2017-01-17 10:42:05-08:00,['55abe65e0996008d54bd5bb8440906ac4a359937'],142,211,353,999241,11,0.20754717,0.830188679,0.962264151,2705
3f6c4f63c9c17424cf717ca76c74554bcf3b2e9a,0,Ismael Juma,2017-01-17 18:42:55+00:00,['7a84b241eeb8cb63400a9512b066c3f733f94b8c'],15,35,50,999291,5,0.454545455,0,0.545454545,2705
825f225bc5706b16af8ec44ca47ee1452c11e6f3,1,Guozhang Wang,2017-01-17 12:33:11-08:00,['3f6c4f63c9c17424cf717ca76c74554bcf3b2e9a'],21,87,108,999399,11,0.54,1,0.2,2705
73b7ae0019d387407375f3865e263225c986a6ce,1,Guozhang Wang,2017-01-17 14:13:46-08:00,['825f225bc5706b16af8ec44ca47ee1452c11e6f3'],642,2081,2723,1002122,40,0.661242604,0.933431953,0.949704142,2719
e3bdc84d864a5ca655f985473770f7b7cb24b79b,1,Guozhang Wang,2017-01-17 18:14:43-08:00,['73b7ae0019d387407375f3865e263225c986a6ce'],36,23,59,1002181,5,0.555555556,0.222222222,1,2719
fd6d7bcf335166a524dc9a29a50c96af8f1c1c02,0,Ismael Juma,2017-01-18 02:43:10+00:00,['e3bdc84d864a5ca655f985473770f7b7cb24b79b'],55,183,238,1002419,9,0.339285714,0.5,0.678571429,2719
1974e1b0e54abe5fdebd8ff3338df864b7ab60f3,1,Jason Gustafson,2017-01-17 20:31:31-08:00,['fd6d7bcf335166a524dc9a29a50c96af8f1c1c02'],209,153,362,1002781,22,1,0,0.707317073,2719
4c492975a05e4a646f7140c560ed403c48925331,1,Ismael Juma,2017-01-18 11:06:14+00:00,['1974e1b0e54abe5fdebd8ff3338df864b7ab60f3'],54,64,118,1002899,16,0.625,0.625,1,2719
ccb183f9fca20a37b9b39761dedcd197e3cf2033,0,Ismael Juma,2017-01-18 15:17:05+00:00,['4c492975a05e4a646f7140c560ed403c48925331'],2,2,4,1002903,1,,,,2719
961ebca57fdd4f8f84df8cf26a835f07ea1718c9,1,Guozhang Wang,2017-01-18 09:19:06-08:00,['ccb183f9fca20a37b9b39761dedcd197e3cf2033'],6,6,12,1002915,2,,,,2719
d8a77560c2fa2c209353e3ba2366ad3d4cfdf22c,1,Guozhang Wang,2017-01-18 11:55:23-08:00,['961ebca57fdd4f8f84df8cf26a835f07ea1718c9'],128,43,171,1003086,4,0.326530612,0.204081633,0,2719
4a6f2c6cc0647a08f016a2d712a01ec02630cf87,1,Ismael Juma,2017-01-18 23:44:11+00:00,['d8a77560c2fa2c209353e3ba2366ad3d4cfdf22c'],25,244,269,1003355,7,0.350515464,0.762886598,1,2722
8e2cbae8b12cd71f99f13953b744163f68021323,1,Guozhang Wang,2017-01-18 15:54:15-08:00,['4a6f2c6cc0647a08f016a2d712a01ec02630cf87'],107,174,281,1003636,4,0.407407407,1,0.888888889,2723
666abafcc54f8cab64912355dba4c8ada8e44827,1,Jun Rao,2017-01-19 08:35:39-08:00,['8e2cbae8b12cd71f99f13953b744163f68021323'],99,218,317,1003953,1,,,,2723
5fc530bc483db145e0cba3b63a57d6d6a7c547f2,0,Jun Rao,2017-01-19 09:47:34-08:00,['666abafcc54f8cab64912355dba4c8ada8e44827'],4,12,16,1003969,1,1,1,1,2723
813897a00653351710d37acbbb598235e86db824,1,Jason Gustafson,2017-01-19 16:35:12-08:00,['5fc530bc483db145e0cba3b63a57d6d6a7c547f2'],7,132,139,1004108,5,0.590909091,1,1,2723
a37bf5fffa4a607ded14ec055276d76f19df2d50,1,Jun Rao,2017-01-19 17:46:59-08:00,['813897a00653351710d37acbbb598235e86db824'],10,72,82,1004190,1,0,0.511111111,1,2723
50e035dc341bb595decbac0851354a10c90b0e06,0,Guozhang Wang,2017-01-20 11:07:57-08:00,['a37bf5fffa4a607ded14ec055276d76f19df2d50'],2,4,6,1004196,1,0,0,1,2723
a8aa75616602363847848f004fd0b1a36d0de78c,1,Ewen Cheslack-Postava,2017-01-20 16:15:15-08:00,['50e035dc341bb595decbac0851354a10c90b0e06'],138,1779,1917,1006113,24,0.690966719,0.969889065,0.976228209,2740
0b99bea590842018e8e97e7fd1c71b1471db4d08,1,Guozhang Wang,2017-01-21 13:18:39-08:00,['a8aa75616602363847848f004fd0b1a36d0de78c'],74,90,164,1006277,3,0.2,1,0,2740
20e957c9b1f389621bb8ae9e9f5554b66cd92a4f,0,Guozhang Wang,2017-01-21 14:10:01-08:00,['0b99bea590842018e8e97e7fd1c71b1471db4d08'],2,2,4,1006281,2,,,,2740
22782ccfc47af219ee50d61549558a5eeb83efe5,0,Ismael Juma,2017-01-22 23:10:40+00:00,['20e957c9b1f389621bb8ae9e9f5554b66cd92a4f'],2,2,4,1006285,1,,,,2740
1eb1e2f60ae006144757fc9fc10ab423c58970bb,1,Ismael Juma,2017-01-23 15:16:57+00:00,['22782ccfc47af219ee50d61549558a5eeb83efe5'],4,64,68,1006353,4,0.25,1,1,2741
a321750646733aa0a2e6346b5e785a4dd5d7675c,0,Ismael Juma,2017-01-23 16:25:01+00:00,['1eb1e2f60ae006144757fc9fc10ab423c58970bb'],7,9,16,1006369,1,,,,2741
dd897bdb2e9cc8790d1e0494fb7867a5cd09ecc6,1,Guozhang Wang,2017-01-23 09:34:52-08:00,['a321750646733aa0a2e6346b5e785a4dd5d7675c'],25,49,74,1006443,2,1,1,1,2741
62206de4e52dbec32b99baffa0ebf7f5303d7b7f,0,Guozhang Wang,2017-01-23 10:21:06-08:00,['dd897bdb2e9cc8790d1e0494fb7867a5cd09ecc6'],0,2,2,1006445,1,,,,2741
3400d0c3cc07d5d3136bf9a19142b36cca93f92d,1,Jason Gustafson,2017-01-23 10:45:45-08:00,['62206de4e52dbec32b99baffa0ebf7f5303d7b7f'],347,478,825,1007270,19,0,0,0.585365854,2741
79987590e3e96351ff75ce86718801ec605b2419,1,Guozhang Wang,2017-01-23 16:31:36-08:00,['3400d0c3cc07d5d3136bf9a19142b36cca93f92d'],183,701,884,1008154,21,1,1,1,2746
bf5aebadb54dd67d27e85cda0109bfc40f7e2883,0,Jason Gustafson,2017-01-23 16:42:50-08:00,['79987590e3e96351ff75ce86718801ec605b2419'],9,16,25,1008179,1,0,1,0.375,2746
337f576f5979bf8924c5707b338cf4d3c76a53fd,1,Ismael Juma,2017-01-24 11:02:20+00:00,['bf5aebadb54dd67d27e85cda0109bfc40f7e2883'],13,201,214,1008393,4,0.403508772,1,0.587719298,2746
567180605c0a8cf74b8d2cad52e2873c83065a95,1,Ismael Juma,2017-01-24 11:15:53+00:00,['337f576f5979bf8924c5707b338cf4d3c76a53fd'],1,5,6,1008399,3,,,,2746
3bb0d3cd888c29a002400253d9ff84ce73ebc03c,0,Ismael Juma,2017-01-24 12:44:17+00:00,['567180605c0a8cf74b8d2cad52e2873c83065a95'],1,10,11,1008410,1,,,,2746
b938c03b0aa7a0cebdaad0cbb22689cc719c6ebc,1,Guozhang Wang,2017-01-24 11:02:34-08:00,['3bb0d3cd888c29a002400253d9ff84ce73ebc03c'],155,403,558,1008968,10,,,,2746
7837d3e54850fc6ecd16f9bc4dd28a02779572c2,1,Guozhang Wang,2017-01-24 12:00:35-08:00,['b938c03b0aa7a0cebdaad0cbb22689cc719c6ebc'],151,123,274,1009242,7,1,0,0.8,2746
3df60e7eb8b6fb38cd560708f5b909a9b2e61de2,1,Ismael Juma,2017-01-24 20:07:13+00:00,['7837d3e54850fc6ecd16f9bc4dd28a02779572c2'],7,466,473,1009715,3,0.377104377,0.69023569,0.912457912,2748
8dfb8afb93f3f1026f868466edb66a4cc63b4455,0,Ismael Juma,2017-01-24 20:24:18+00:00,['3df60e7eb8b6fb38cd560708f5b909a9b2e61de2'],10,28,38,1009753,4,0.909090909,0.909090909,0.909090909,2748
9b8d99b1b866a90b07c8a9a61fe79a75d01ae272,0,Ewen Cheslack-Postava,2017-01-24 13:19:03-08:00,['8dfb8afb93f3f1026f868466edb66a4cc63b4455'],8,11,19,1009772,1,0.666666667,0.666666667,0.333333333,2748
3f0168cd35c1baaa5a032e9a534f28a1bd9221b9,0,Jun Rao,2017-01-24 13:56:30-08:00,['9b8d99b1b866a90b07c8a9a61fe79a75d01ae272'],4,9,13,1009785,2,1,1,1,2748
2a5db4d6c46fbc9c42cdaef1da19cdbda945a3d3,0,Jun Rao,2017-01-24 15:17:26-08:00,['3f0168cd35c1baaa5a032e9a534f28a1bd9221b9'],1,3,4,1009789,1,,,,2748
675881b0f1138c6c09ff4700b17f008ea9053aa4,1,Guozhang Wang,2017-01-24 15:40:45-08:00,['2a5db4d6c46fbc9c42cdaef1da19cdbda945a3d3'],0,6,6,1009795,1,1,1,1,2748
63cf0e58775b8f0b4abf907866bd7c955500902c,0,Ewen Cheslack-Postava,2017-01-24 16:24:19-08:00,['675881b0f1138c6c09ff4700b17f008ea9053aa4'],2,2,4,1009799,1,,,,2748
abe19fe693d81ea65a018041f157c58ebecd014d,1,Guozhang Wang,2017-01-24 16:36:31-08:00,['63cf0e58775b8f0b4abf907866bd7c955500902c'],127,324,451,1010250,17,0,0.978494624,0.811827957,2748
448c1a4114798892bef60d44199a07a86fc4505a,1,Guozhang Wang,2017-01-24 19:36:08-08:00,['abe19fe693d81ea65a018041f157c58ebecd014d'],15,34,49,1010299,9,1,1,1,2748
b8c3b7c964c6167be7f8ad72c96733dfa0d648a2,0,Ismael Juma,2017-01-25 12:38:47+00:00,['448c1a4114798892bef60d44199a07a86fc4505a'],13,124,137,1010436,3,0.111111111,1,0.913580247,2748
b22a4f0782d0f4d3e07075403e8e5dc318d8d387,1,Sriharsha Chintalapani,2017-01-25 08:17:50-08:00,['b8c3b7c964c6167be7f8ad72c96733dfa0d648a2'],11,71,82,1010518,7,0.431818182,0.840909091,0.954545455,2748
2ca3e59bb6054cc8ecf6926a74859efe3df000ba,1,Guozhang Wang,2017-01-25 11:11:21-08:00,['b22a4f0782d0f4d3e07075403e8e5dc318d8d387'],67,87,154,1010672,10,1,1,1,2748
0971e62e50b94a74aae170fb49d1e532e39b2136,0,Guozhang Wang,2017-01-25 11:40:17-08:00,['2ca3e59bb6054cc8ecf6926a74859efe3df000ba'],98,99,197,1010869,13,0,0,0,2748
23f6951961060ad9a07b42f392470a227269e65a,0,Jason Gustafson,2017-01-25 16:51:58-08:00,['0971e62e50b94a74aae170fb49d1e532e39b2136'],1,0,1,1010870,1,,,,2748
8b3c6c0a1c1bb8f098a7013dbf9c2cb97720e106,1,Jason Gustafson,2017-01-25 17:25:10-08:00,['23f6951961060ad9a07b42f392470a227269e65a'],228,217,445,1011315,25,0,0,0.375,2748
e9426291aa989ac2624905b844724eeffa608773,1,Guozhang Wang,2017-01-25 17:53:51-08:00,['8b3c6c0a1c1bb8f098a7013dbf9c2cb97720e106'],0,17,17,1011332,1,,,,2749
9a7032720f4600099b130a0bb7b578cedc83e5ff,0,Guozhang Wang,2017-01-25 18:00:14-08:00,['e9426291aa989ac2624905b844724eeffa608773'],0,2,2,1011334,1,,,,2749
51e745ef30c777009c2d1f75965e63a3fe7bb474,0,Guozhang Wang,2017-01-25 18:01:37-08:00,['9a7032720f4600099b130a0bb7b578cedc83e5ff'],1,1,2,1011336,1,,,,2749
135488352cbe646334a274418d7014a91e92057f,1,Ismael Juma,2017-01-26 02:53:59+00:00,['51e745ef30c777009c2d1f75965e63a3fe7bb474'],197,250,447,1011783,12,0.090909091,1,0.96969697,2749
5b4e299a46a8ee92e450c54880408713606e4f52,1,Ismael Juma,2017-01-26 11:19:32+00:00,['135488352cbe646334a274418d7014a91e92057f'],64,198,262,1012045,10,0.272727273,1,0.977272727,2749
254e3b77d656a610f19efd1124802e073dfda4b8,1,Jason Gustafson,2017-01-26 09:50:25-08:00,['5b4e299a46a8ee92e450c54880408713606e4f52'],21,33,54,1012099,6,0.875,1,0.875,2749
8301cc608e0e3c334da96b546bf6d943a1704024,1,Ismael Juma,2017-01-26 20:52:54+00:00,['254e3b77d656a610f19efd1124802e073dfda4b8'],61,55,116,1012215,4,1,0,0.125,2749
dc4d1bb81b37908725e3bcefd21bade9c2297ebd,1,Guozhang Wang,2017-01-26 14:17:09-08:00,['8301cc608e0e3c334da96b546bf6d943a1704024'],4,6,10,1012225,1,,,,2749
31716590454e1bdd53a65836741f316bf4715c9d,1,Guozhang Wang,2017-01-26 14:18:54-08:00,['dc4d1bb81b37908725e3bcefd21bade9c2297ebd'],1,71,72,1012297,3,1,1,1,2750
0c83eddcda8ed1b483a869f0915815204e3faade,0,Ewen Cheslack-Postava,2017-01-26 15:04:35-08:00,['31716590454e1bdd53a65836741f316bf4715c9d'],2,2,4,1012301,1,,,,2750
1eac3f33f5de3490046203a8e408970da161b84e,0,Jason Gustafson,2017-01-26 16:46:57-08:00,['0c83eddcda8ed1b483a869f0915815204e3faade'],1,1,2,1012303,1,,,,2750
ca0c071c108c9fd31a759e1cd1c4f89bdc5ac47e,1,Ismael Juma,2017-01-27 01:24:56+00:00,['1eac3f33f5de3490046203a8e408970da161b84e'],464,852,1316,1013619,50,0.524193548,0.975806452,0.705645161,2752
a01b72236926d2bcc52dd7d0378147f8fae8117d,1,Guozhang Wang,2017-01-26 21:25:26-08:00,['ca0c071c108c9fd31a759e1cd1c4f89bdc5ac47e'],47,180,227,1013846,8,,,,2752
2f9e9195abada7c2bcbd41147cb9d4c00f3a712d,1,Jason Gustafson,2017-01-26 21:27:44-08:00,['a01b72236926d2bcc52dd7d0378147f8fae8117d'],8,42,50,1013896,2,0.315789474,0.684210526,1,2752
89fb02aa81fe67f5a506f579e463f30f3020dee5,1,Guozhang Wang,2017-01-26 21:46:37-08:00,['2f9e9195abada7c2bcbd41147cb9d4c00f3a712d'],28,304,332,1014228,6,0.066225166,0.920529801,0.900662252,2754
4277645d25e3be0276cb443a36c7ebaa0638034c,1,Guozhang Wang,2017-01-26 21:50:44-08:00,['89fb02aa81fe67f5a506f579e463f30f3020dee5'],384,396,780,1015008,11,,,,2754
1956b462527972217447c5e2a5743df8547451c1,0,Ismael Juma,2017-01-27 11:10:28+00:00,['4277645d25e3be0276cb443a36c7ebaa0638034c'],10,52,62,1015070,1,,,,2754
ec76ea343616df27ae2a4e42f5078e081d5878e2,0,Ismael Juma,2017-01-27 12:16:27+00:00,['1956b462527972217447c5e2a5743df8547451c1'],4,4,8,1015078,1,,,,2754
1bd11b23ab55b25d5669813f47ad1d5670c6ec9c,1,Guozhang Wang,2017-01-27 08:40:53-08:00,['ec76ea343616df27ae2a4e42f5078e081d5878e2'],542,1434,1976,1017054,5,,,,2754
662c2f893c95128a9d5033f730f1538d368fd151,1,Guozhang Wang,2017-01-27 08:47:19-08:00,['1bd11b23ab55b25d5669813f47ad1d5670c6ec9c'],137,237,374,1017428,3,1,1,1,2755
9213de8f14dfd2754d913667ae9a703f76277022,0,Guozhang Wang,2017-01-27 09:45:01-08:00,['662c2f893c95128a9d5033f730f1538d368fd151'],25,26,51,1017479,3,0,0,0,2755
57f0cb29973bb40e76ed6deb64b934b4b2e0592a,1,Ismael Juma,2017-01-27 20:30:00+00:00,['9213de8f14dfd2754d913667ae9a703f76277022'],167,358,525,1018004,10,0.188405797,1,0.876811594,2755
4a14adbb63205e052b7620420b306e29320a4343,0,Ismael Juma,2017-01-27 21:39:27+00:00,['57f0cb29973bb40e76ed6deb64b934b4b2e0592a'],13,12,25,1018029,1,,,,2755
1b964396b88b3d6eea3148fe7c8b4b870910cd8b,0,Ewen Cheslack-Postava,2017-01-27 14:49:12-08:00,['4a14adbb63205e052b7620420b306e29320a4343'],1,1,2,1018031,1,,,,2755
aef6927a42cde193dd6acc36cd4d9f32167da622,1,Ismael Juma,2017-01-27 23:26:24+00:00,['1b964396b88b3d6eea3148fe7c8b4b870910cd8b'],21,85,106,1018137,3,0.475,1,1,2755
4c42654b1eecebae272dfe5ce018b85ad4db7709,1,Guozhang Wang,2017-01-27 16:48:44-08:00,['aef6927a42cde193dd6acc36cd4d9f32167da622'],691,1043,1734,1019871,12,0.375,0.833333333,0.333333333,2755
8827a5b34ed2a2a570219fb8f29d955918867796,1,Ismael Juma,2017-01-28 01:08:46+00:00,['4c42654b1eecebae272dfe5ce018b85ad4db7709'],114,171,285,1020156,13,0.444444444,0.8,0.933333333,2755
6264cc155757216c878bcce48e02099a9f5a7d6f,1,Ismael Juma,2017-01-28 01:40:34+00:00,['8827a5b34ed2a2a570219fb8f29d955918867796'],106,107,213,1020369,29,0,1,0,2755
84323eea23aa8e1f2485b0ff43b3d316e7b0d06a,0,Ewen Cheslack-Postava,2017-01-27 19:58:22-08:00,['6264cc155757216c878bcce48e02099a9f5a7d6f'],44,0,44,1020413,20,,,,2755
413444c0ec01ea51019df436cc1f2b664ac61e5a,1,Guozhang Wang,2017-01-29 14:05:34-08:00,['84323eea23aa8e1f2485b0ff43b3d316e7b0d06a'],328,324,652,1021065,25,,,,2755
b559846f2f8151e41a6259e8a570b9422932c836,0,Guozhang Wang,2017-01-30 15:14:49-08:00,['413444c0ec01ea51019df436cc1f2b664ac61e5a'],44,42,86,1021151,9,0,0.083333333,1,2755
e108a8b4ed4512b021f9326cf079517523c83060,0,Guozhang Wang,2017-01-30 16:32:31-08:00,['b559846f2f8151e41a6259e8a570b9422932c836'],13,18,31,1021182,2,,,,2755
b948f43278e7641977c07df0069158a61fd3b443,1,Guozhang Wang,2017-01-31 09:30:29-08:00,['e108a8b4ed4512b021f9326cf079517523c83060'],0,1,1,1021183,1,0,0,1,2755
5afe959647fcad9d01365427f4b455e1586b1fd5,1,Jason Gustafson,2017-01-31 12:27:00-08:00,['b948f43278e7641977c07df0069158a61fd3b443'],56,90,146,1021329,9,0,0.566666667,1,2755
82744414d50d28a7bf7b0084118b68a4411c5781,1,Ewen Cheslack-Postava,2017-01-31 16:06:10-08:00,['5afe959647fcad9d01365427f4b455e1586b1fd5'],21,21,42,1021371,1,,,,2755
0b48ea1c81f22465cf32a19c012e0fb3c849afcc,1,Guozhang Wang,2017-01-31 20:16:47-08:00,['82744414d50d28a7bf7b0084118b68a4411c5781'],575,1085,1660,1023031,11,1,1,1,2758
cea46135338150e409e140b8b96856e060be8780,0,Jason Gustafson,2017-02-01 10:25:24-08:00,['0b48ea1c81f22465cf32a19c012e0fb3c849afcc'],13,13,26,1023057,3,,,,2758
3d9f34dd84a1c802b18874ba365c23713bfb189a,1,Guozhang Wang,2017-02-01 12:35:59-08:00,['cea46135338150e409e140b8b96856e060be8780'],0,2,2,1023059,1,0,1,1,2758
063d534c5160316cdf22e476d128e872a1412783,1,Ewen Cheslack-Postava,2017-02-01 19:55:06-08:00,['3d9f34dd84a1c802b18874ba365c23713bfb189a'],12,22,34,1023093,7,0,0,0.833333333,2758
3e85f131e6af5d2ef34499d0b2aca7afca85d79c,1,Guozhang Wang,2017-02-01 20:17:06-08:00,['063d534c5160316cdf22e476d128e872a1412783'],6,231,237,1023330,1,0.25,1,1,2758
da70316a588172585a3960f2b0edb0e2d4ba5461,1,Guozhang Wang,2017-02-01 20:20:31-08:00,['3e85f131e6af5d2ef34499d0b2aca7afca85d79c'],2,34,36,1023366,1,0,1,1,2758
35cd008e5a1ec89d09f956a6f9952ad834e556d7,0,Guozhang Wang,2017-02-01 20:30:04-08:00,['da70316a588172585a3960f2b0edb0e2d4ba5461'],21,67,88,1023454,1,1,1,1,2758
7436d28a243295ae7c8c3723e97ea43a10f2771c,1,Guozhang Wang,2017-02-02 10:33:33-08:00,['35cd008e5a1ec89d09f956a6f9952ad834e556d7'],29,24,53,1023507,2,0,0,0,2758
c8baf28545984ef8c88d43899004224c6ef54013,0,Guozhang Wang,2017-02-02 10:35:58-08:00,['7436d28a243295ae7c8c3723e97ea43a10f2771c'],70,181,251,1023758,9,,,,2764
76550dd8956b07f24713f10992fc15aeedabe2c9,0,Ewen Cheslack-Postava,2017-02-02 10:49:11-08:00,['c8baf28545984ef8c88d43899004224c6ef54013'],18,39,57,1023815,4,0,0.947368421,0.526315789,2764
cb674e5487f3f56647546b323dfe4fd45ccf0186,1,Ismael Juma,2017-02-02 22:23:49+00:00,['76550dd8956b07f24713f10992fc15aeedabe2c9'],231,602,833,1024648,64,0.812030075,0.827067669,0.947368421,2769
ea70a9bcfc8a9ce317e8fa9b8cc4f7cb1aba26a9,1,Ismael Juma,2017-02-02 22:34:53+00:00,['cb674e5487f3f56647546b323dfe4fd45ccf0186'],55,110,165,1024813,14,0.023809524,0.976190476,0.857142857,2769
ab4ebb4bb93fbaab432d3f91dbc362d18796c83c,0,Guozhang Wang,2017-02-02 21:36:27-08:00,['ea70a9bcfc8a9ce317e8fa9b8cc4f7cb1aba26a9'],8,96,104,1024917,2,,,,2769
da082900b3d800ba43616706def611df7a00308f,1,Guozhang Wang,2017-02-03 08:50:20-08:00,['ab4ebb4bb93fbaab432d3f91dbc362d18796c83c'],0,88,88,1025005,1,1,1,1,2769
47517da40dcb37d91925c1888ce01d06c28ce4cc,1,Guozhang Wang,2017-02-03 09:10:58-08:00,['da082900b3d800ba43616706def611df7a00308f'],15,30,45,1025050,1,1,1,1,2769
d95f22c12c36a92f9c71a78cabf897d65ddef65f,1,Guozhang Wang,2017-02-03 09:15:56-08:00,['47517da40dcb37d91925c1888ce01d06c28ce4cc'],2,246,248,1025298,4,1,1,0.933333333,2771
7ebc5da606fb806bde8b7176fed0e60243e0f7f3,1,Guozhang Wang,2017-02-03 11:12:49-08:00,['d95f22c12c36a92f9c71a78cabf897d65ddef65f'],1683,1313,2996,1028294,63,0.891025641,0,0,2774
88809b9b8eb7895f3756a39ee2ad7dffd0b4d516,0,Jason Gustafson,2017-02-03 13:47:14-08:00,['7ebc5da606fb806bde8b7176fed0e60243e0f7f3'],1,1,2,1028296,1,,,,2774
d0932b0286d8e69a704211aeaba9fa9503c0fb42,1,Ismael Juma,2017-02-05 10:29:44+00:00,['88809b9b8eb7895f3756a39ee2ad7dffd0b4d516'],11,89,100,1028396,5,0.345454545,0.563636364,0.927272727,2774
7de22453bbd05a7ac629543e09626ac6987ce306,1,Guozhang Wang,2017-02-06 11:03:26-08:00,['d0932b0286d8e69a704211aeaba9fa9503c0fb42'],43,76,119,1028515,14,0.875,0.875,0.1875,2774
1f8a2ad2edc5d9de4dc3a3311a0650f25d2b9114,1,Guozhang Wang,2017-02-06 11:37:48-08:00,['7de22453bbd05a7ac629543e09626ac6987ce306'],2,32,34,1028549,2,0.727272727,0,0.727272727,2774
b31a7a9022bfb645cb61e6fbc0b22829108b3a3f,0,Jason Gustafson,2017-02-06 11:47:45-08:00,['1f8a2ad2edc5d9de4dc3a3311a0650f25d2b9114'],2,2,4,1028553,1,,,,2774
48aec6ef1e8065bd14e54172d6443144fb80738b,1,Jun Rao,2017-02-06 12:23:24-08:00,['b31a7a9022bfb645cb61e6fbc0b22829108b3a3f'],4,172,176,1028729,3,0.216216216,0.486486486,1,2775
82e75b960737b50456e862f127f857832b22624e,1,Ewen Cheslack-Postava,2017-02-06 13:53:22-08:00,['48aec6ef1e8065bd14e54172d6443144fb80738b'],2,2,4,1028733,1,,,,2775
2c0055e62fc6308e45ff8a9c1c386b43fa3a3905,1,Jason Gustafson,2017-02-06 14:55:12-08:00,['82e75b960737b50456e862f127f857832b22624e'],15,1,16,1028749,1,0,0,1,2775
45d9fb3d5f13bef0bf6809ea71b2cbd73996a1b6,0,Jiangjie Qin,2017-02-06 16:01:59-08:00,['2c0055e62fc6308e45ff8a9c1c386b43fa3a3905'],1,10,11,1028760,1,1,1,1,2775
be98865dfcddd38e3e411d41126fa6049c509cae,0,Jun Rao,2017-02-07 08:40:30-08:00,['45d9fb3d5f13bef0bf6809ea71b2cbd73996a1b6'],6,1,7,1028767,1,,,,2775
6cef4f5e4c3a73911a43378caf5cfc2736814333,0,Jun Rao,2017-02-07 08:43:02-08:00,['be98865dfcddd38e3e411d41126fa6049c509cae'],1,7,8,1028775,2,0,0.4,1,2775
7f6bf5d44796ac14665d5ba8c2243f5d7f5d30bd,0,Jun Rao,2017-02-07 15:12:47-08:00,['6cef4f5e4c3a73911a43378caf5cfc2736814333'],0,1,1,1028776,1,1,1,1,2775
2e662a061608a0755274da3e2ccf87401936febf,0,Guozhang Wang,2017-02-08 00:08:07-08:00,['7f6bf5d44796ac14665d5ba8c2243f5d7f5d30bd'],3,23,26,1028802,1,0,1,1,2775
effa19c045b15c0f82568e91d7f485ae564123a2,1,Ismael Juma,2017-02-08 13:38:05+00:00,['2e662a061608a0755274da3e2ccf87401936febf'],4,10,14,1028816,1,0,0,0,2775
b621703706118b383153da60937c1d31d518d5b8,1,Guozhang Wang,2017-02-08 11:26:45-08:00,['effa19c045b15c0f82568e91d7f485ae564123a2'],69,157,226,1029042,4,1,1,1,2775
e7c869e65d25dcf2d0a8f949da31c15d1d843950,1,Guozhang Wang,2017-02-08 12:50:04-08:00,['b621703706118b383153da60937c1d31d518d5b8'],2,2,4,1029046,1,,,,2775
c7c113af63d8b4c49f16297af22b3a02528a500c,1,Guozhang Wang,2017-02-08 13:00:49-08:00,['e7c869e65d25dcf2d0a8f949da31c15d1d843950'],1,7,8,1029054,1,0,1,1,2775
13a82b48cab5f13feeb9d3597b24d26416eb4033,1,Guozhang Wang,2017-02-08 13:06:09-08:00,['c7c113af63d8b4c49f16297af22b3a02528a500c'],201,351,552,1029606,4,0.716981132,0.254716981,1,2775
8bd8751aa776990d1847e4d6ab187a0aea90c051,1,Jun Rao,2017-02-08 17:18:55-08:00,['13a82b48cab5f13feeb9d3597b24d26416eb4033'],33,20,53,1029659,1,,,,2775
6c1478d19f5a9c8dede9e7c3b047533ba61cc731,0,Jason Gustafson,2017-02-08 18:41:14-08:00,['8bd8751aa776990d1847e4d6ab187a0aea90c051'],2,2,4,1029663,1,,,,2775
69d3af8be26c8f3abb2c9dfd43d2462d5aa27c69,1,Ismael Juma,2017-02-09 15:11:18+00:00,['6c1478d19f5a9c8dede9e7c3b047533ba61cc731'],5,5,10,1029673,1,,,,2775
f8c11eb0c34b0c2b4330aea9181ccb0452a62ce7,0,Ismael Juma,2017-02-09 15:13:31+00:00,['69d3af8be26c8f3abb2c9dfd43d2462d5aa27c69'],1,1,2,1029675,1,,,,2775
b865a8b1dcae642b80280b8a7b5e23e82666061b,1,Guozhang Wang,2017-02-09 14:01:13-08:00,['f8c11eb0c34b0c2b4330aea9181ccb0452a62ce7'],29,60,89,1029764,6,1,1,0.846153846,2775
d24616777ade24a37c5e7e517bcd1d8912eaf19d,0,Guozhang Wang,2017-02-09 17:20:30-08:00,['b865a8b1dcae642b80280b8a7b5e23e82666061b'],0,45,45,1029809,1,1,1,1,2775
b6c34e2df5dc4e3f6cda9b64786d7e929acb963b,0,Ismael Juma,2017-02-10 02:45:29+00:00,['d24616777ade24a37c5e7e517bcd1d8912eaf19d'],1,40,41,1029850,2,,,,2775
b5dd39dda68e8bab555eea1b80de8f969f8641ea,0,Ismael Juma,2017-02-10 02:57:35+00:00,['b6c34e2df5dc4e3f6cda9b64786d7e929acb963b'],5,44,49,1029899,5,1,1,1,2775
a15fcea799a843c1b4888fffbb2d382ee2e2ee36,1,Ewen Cheslack-Postava,2017-02-09 19:13:23-08:00,['b5dd39dda68e8bab555eea1b80de8f969f8641ea'],280,630,910,1030809,16,,,,2782
9898d665d1ab201405d66c70e3ea9710d9dcecd7,1,Jason Gustafson,2017-02-09 21:03:46-08:00,['a15fcea799a843c1b4888fffbb2d382ee2e2ee36'],1034,1054,2088,1032897,112,1,1,1,2782
516d3284943b3fdb0bf1f6208b84210def9a8a9b,0,Guozhang Wang,2017-02-10 09:15:12-08:00,['9898d665d1ab201405d66c70e3ea9710d9dcecd7'],1,11,12,1032909,2,,,,2782
253dfcf4756e8e0d434da69516993ea784f830c9,0,Guozhang Wang,2017-02-10 09:32:52-08:00,['516d3284943b3fdb0bf1f6208b84210def9a8a9b'],0,2,2,1032911,1,,,,2782
1c45f79c91a9f2b98f9549f51f80de2e89146490,0,Guozhang Wang,2017-02-10 09:45:13-08:00,['253dfcf4756e8e0d434da69516993ea784f830c9'],8,21,29,1032940,1,,,,2782
601d4040d446599bb01c45389b3e90645245e9af,0,Ewen Cheslack-Postava,2017-02-10 15:06:54-08:00,['1c45f79c91a9f2b98f9549f51f80de2e89146490'],4,1,5,1032945,1,,,,2782
8bc9d583930110cf209f8ab20f9ff640ace3ed35,1,Jiangjie Qin,2017-02-11 21:33:55-08:00,['601d4040d446599bb01c45389b3e90645245e9af'],49,84,133,1033078,9,0.142857143,0.214285714,0.892857143,2782
260d487cdd689c9689b7f4ddcc67978ed72ab413,0,Ismael Juma,2017-02-12 07:08:55-08:00,['8bc9d583930110cf209f8ab20f9ff640ace3ed35'],2,2,4,1033082,1,,,,2782
5dabca02594e4b71fb6ff275283a3851f1c62d60,1,Jason Gustafson,2017-02-12 16:06:33-08:00,['260d487cdd689c9689b7f4ddcc67978ed72ab413'],5,79,84,1033166,5,0.971428571,0.971428571,1,2783
ed91af512fcb5c0ea3032ed259451817c96b5ee1,1,Jun Rao,2017-02-13 13:46:37-08:00,['5dabca02594e4b71fb6ff275283a3851f1c62d60'],14,57,71,1033237,5,0.785714286,0.785714286,0.035714286,2783
3b36d5cff0b7a51e737a97144d6d479af708b2d7,1,Jason Gustafson,2017-02-13 14:07:19-08:00,['ed91af512fcb5c0ea3032ed259451817c96b5ee1'],30,96,126,1033363,8,0,1,1,2783
4db048d61206bc6efbd143d6293216b7cb4b86c5,0,Guozhang Wang,2017-02-14 10:43:34-08:00,['3b36d5cff0b7a51e737a97144d6d479af708b2d7'],1,3,4,1033367,1,,,,2783
2c91b324d4798138dd479f54269bdc4f39339817,1,Guozhang Wang,2017-02-15 13:17:29-08:00,['4db048d61206bc6efbd143d6293216b7cb4b86c5'],94,137,231,1033598,6,,,,2783
2e1b00f262947c4c3211df205df259ef517763f4,1,Guozhang Wang,2017-02-15 16:32:02-08:00,['2c91b324d4798138dd479f54269bdc4f39339817'],6,124,130,1033728,1,,,,2783
abe5e0e489a1d93867098da8d472060055b31b72,0,Guozhang Wang,2017-02-15 16:39:52-08:00,['2e1b00f262947c4c3211df205df259ef517763f4'],0,7,7,1033735,1,,,,2783
af182480d2f31f8ef44764fc8cfa250ec76a878f,0,Guozhang Wang,2017-02-15 17:02:15-08:00,['abe5e0e489a1d93867098da8d472060055b31b72'],196,196,392,1034127,1,,,,2783
cb725c6a2d21651fe8b2e50225635209aa949bb5,1,Guozhang Wang,2017-02-15 21:20:49-08:00,['af182480d2f31f8ef44764fc8cfa250ec76a878f'],0,156,156,1034283,4,1,1,1,2785
a1900ada7fdc3318f24e94e4aac956dca3463bbf,1,Ismael Juma,2017-02-16 06:37:52-08:00,['cb725c6a2d21651fe8b2e50225635209aa949bb5'],8,8,16,1034299,4,,,,2785
6c839395b7b43d8e9c0dfbb3c12470fc9284a94a,0,Guozhang Wang,2017-02-16 13:44:08-08:00,['a1900ada7fdc3318f24e94e4aac956dca3463bbf'],4,129,133,1034432,4,0.923076923,0.923076923,0.276923077,2786
022d2017a781286d223d80d8eae505fbc3fb369c,1,Jason Gustafson,2017-02-16 15:22:55-08:00,['6c839395b7b43d8e9c0dfbb3c12470fc9284a94a'],190,191,381,1034813,7,1,1,1,2786
505af6bfdafa4719e4faeefab4d334cb0eebf784,0,Guozhang Wang,2017-02-16 15:35:32-08:00,['022d2017a781286d223d80d8eae505fbc3fb369c'],2,2,4,1034817,1,,,,2786
a88737929e880d5c6892a306d3c9b1358853b76b,0,Ismael Juma,2017-02-17 01:46:14-08:00,['505af6bfdafa4719e4faeefab4d334cb0eebf784'],8,6,14,1034831,3,1,1,0,2786
1f2ee5f0a9dfc33e34362f7cd4ac45edaabe421b,1,Ismael Juma,2017-02-17 02:40:34-08:00,['a88737929e880d5c6892a306d3c9b1358853b76b'],23,82,105,1034936,7,0.833333333,0.916666667,0.833333333,2786
fc1cfe475e8ae8458d8ddf119ce18d0c64653a70,1,Jason Gustafson,2017-02-17 14:19:01-08:00,['1f2ee5f0a9dfc33e34362f7cd4ac45edaabe421b'],1819,1681,3500,1038436,83,1,0.015151515,1,2787
1f1e794ad0025bb2a33b7d8378a481f224b3bccc,1,Guozhang Wang,2017-02-17 14:41:28-08:00,['fc1cfe475e8ae8458d8ddf119ce18d0c64653a70'],136,401,537,1038973,18,0.308571429,1,0.994285714,2788
a515e93570c5c117ca29fb05137898817f058fb9,1,Jason Gustafson,2017-02-17 16:31:00-08:00,['1f1e794ad0025bb2a33b7d8378a481f224b3bccc'],1,1,2,1038975,1,,,,2788
d734f4e56d276f84b8c52b602edd67d41cbb6c35,1,Ismael Juma,2017-02-18 06:31:25-08:00,['a515e93570c5c117ca29fb05137898817f058fb9'],37,34,71,1039046,10,1,0,0.333333333,2788
c6fcc721e2973f0bf2610d76bee4072bc30d48c9,0,Ismael Juma,2017-02-18 06:38:35-08:00,['d734f4e56d276f84b8c52b602edd67d41cbb6c35'],1,1,2,1039048,1,,,,2788
916edc3a4ed0b44e64d0a0410137bf96e2a5558d,0,Ismael Juma,2017-02-18 06:40:35-08:00,['c6fcc721e2973f0bf2610d76bee4072bc30d48c9'],6,6,12,1039060,5,,,,2788
dcea49856805a039f0859facf169a87a574c06d3,1,Jason Gustafson,2017-02-18 09:25:28-08:00,['916edc3a4ed0b44e64d0a0410137bf96e2a5558d'],4,4,8,1039068,1,1,1,0,2788
d24d932efb980b1fc15bb4dbba4d67d464e97ab3,0,Jason Gustafson,2017-02-18 10:04:40-08:00,['dcea49856805a039f0859facf169a87a574c06d3'],1,1,2,1039070,1,,,,2788
3db3d73de6bc1fbb846d0943a8fe73dcca96b78a,1,Jason Gustafson,2017-02-19 16:39:36-08:00,['d24d932efb980b1fc15bb4dbba4d67d464e97ab3'],5,6,11,1039081,3,,,,2788
e41e782006d807a1ca8098dbfb95b8ab2295d6af,1,Jason Gustafson,2017-02-19 20:53:19-08:00,['3db3d73de6bc1fbb846d0943a8fe73dcca96b78a'],9,71,80,1039161,5,0.090909091,0.909090909,0.909090909,2788
3b8b7a4be39cb4a3f7257f8a17f74a887572e627,0,Ismael Juma,2017-02-21 13:52:18+00:00,['e41e782006d807a1ca8098dbfb95b8ab2295d6af'],6,13,19,1039180,2,1,1,1,2788
f48e8c1a88404c9ef386707c5ac79e21dc8df5af,0,Ismael Juma,2017-02-21 13:59:25+00:00,['3b8b7a4be39cb4a3f7257f8a17f74a887572e627'],0,1,1,1039181,1,,,,2788
8bd06482d0562a518bce67dd06c590da4391d12a,0,Ismael Juma,2017-02-21 14:02:17+00:00,['f48e8c1a88404c9ef386707c5ac79e21dc8df5af'],478,56,534,1039715,7,0.217857143,0.157142857,0.196428571,2789
7b302add35762139c265b7658add144cd12c8278,0,Guozhang Wang,2017-02-21 09:25:06-08:00,['8bd06482d0562a518bce67dd06c590da4391d12a'],15,28,43,1039758,1,0,0.916666667,1,2789
696b1d311c89671cdebd6e8ade4d2c2e55a0696c,1,Jiangjie Qin,2017-02-21 20:41:55-08:00,['7b302add35762139c265b7658add144cd12c8278'],4,8,12,1039770,1,0,1,0,2789
913c09e4a94447a953cb55ccd702d7131d1764a8,0,Ismael Juma,2017-02-22 11:05:04+00:00,['696b1d311c89671cdebd6e8ade4d2c2e55a0696c'],3,17,20,1039790,3,1,1,1,2789
5916ef0227d099e5fa05341db3f918f5ef035816,1,Jason Gustafson,2017-02-22 12:08:09-08:00,['913c09e4a94447a953cb55ccd702d7131d1764a8'],13,33,46,1039836,1,1,1,1,2789
015f1d73811e52b3b7a578cf4c1ca4c48b6c2f5c,1,Jason Gustafson,2017-02-22 15:11:12-08:00,['5916ef0227d099e5fa05341db3f918f5ef035816'],352,253,605,1040441,61,0,1,1,2789
5a2abc51821fab4d3834b615e577d97e0f0e6494,0,Ismael Juma,2017-02-23 16:28:38+00:00,['015f1d73811e52b3b7a578cf4c1ca4c48b6c2f5c'],21,0,21,1040462,2,0,0,0,2789
3428bc1a2549778378ffeb781ad62ca719ca3b7f,0,Guozhang Wang,2017-02-23 10:04:34-08:00,['5a2abc51821fab4d3834b615e577d97e0f0e6494'],4,4,8,1040470,1,,,,2789
6a55d41fe326d72052ca8214809c2e346f8ae775,0,Guozhang Wang,2017-02-23 13:21:49-08:00,['3428bc1a2549778378ffeb781ad62ca719ca3b7f'],1,9,10,1040480,1,,,,2789
1ed4b48d5a43af743229fafc22f78846c9c3134d,0,Ismael Juma,2017-02-24 12:02:53+00:00,['6a55d41fe326d72052ca8214809c2e346f8ae775'],9,11,20,1040500,4,1,1,0,2789
01898ebbadec6d9df72bd9a89752d7f5bd128a7d,1,Ismael Juma,2017-02-24 13:42:44+00:00,['1ed4b48d5a43af743229fafc22f78846c9c3134d'],55,56,111,1040611,4,0.333333333,0.333333333,0.333333333,2789
0be3a7226f816bd4b612477ea3b9916bddade290,0,Ismael Juma,2017-02-24 15:31:36+00:00,['01898ebbadec6d9df72bd9a89752d7f5bd128a7d'],1,1,2,1040613,1,,,,2789
2a7b18a2ac1213b189df8585671b713373dae383,1,Ismael Juma,2017-02-24 17:24:07+00:00,['0be3a7226f816bd4b612477ea3b9916bddade290'],5,14,19,1040632,3,1,1,1,2789
151b23689ea1c2e13a1d38f403bf5839eddbe377,1,Guozhang Wang,2017-02-24 10:34:21-08:00,['2a7b18a2ac1213b189df8585671b713373dae383'],622,1067,1689,1042321,23,1,0.885964912,0.798245614,2797
0483a0b0b70e1ec7cd12c17f622f91ebc3932fc4,0,Jason Gustafson,2017-02-24 11:04:37-08:00,['151b23689ea1c2e13a1d38f403bf5839eddbe377'],34,39,73,1042394,3,1,1,1,2797
43524442dc10c5dc731248674eb1a811287e88f7,0,Jason Gustafson,2017-02-24 14:37:31-08:00,['0483a0b0b70e1ec7cd12c17f622f91ebc3932fc4'],6,1,7,1042401,2,0,0,0,2797
b917af19014c6a8860d6523d24c87783c51bab4e,1,Jason Gustafson,2017-02-24 15:12:32-08:00,['43524442dc10c5dc731248674eb1a811287e88f7'],4,45,49,1042450,2,,,,2798
3749832637b58b291a45076658feb8cd6e830247,1,Jason Gustafson,2017-02-24 15:49:13-08:00,['b917af19014c6a8860d6523d24c87783c51bab4e'],2,1,3,1042453,1,1,1,0,2798
5b22b53f0e581e3239ca6bbeceec6c01ce0f8ce0,1,Jason Gustafson,2017-02-24 16:41:51-08:00,['3749832637b58b291a45076658feb8cd6e830247'],8,48,56,1042509,3,0.206896552,1,1,2798
5b682baad546e41fe7aa27be0865ea6adaca2d2a,0,Ewen Cheslack-Postava,2017-02-25 18:44:32-08:00,['5b22b53f0e581e3239ca6bbeceec6c01ce0f8ce0'],2,3,5,1042514,2,0,0,1,2798
9260e8563c19cc1c5ac2d47ad05955774138036d,1,Ismael Juma,2017-02-27 11:48:55+00:00,['5b682baad546e41fe7aa27be0865ea6adaca2d2a'],1,5,6,1042520,2,1,1,1,2798
9231cc439e58d6ac252ca960e15c703366e32e1a,0,Guozhang Wang,2017-02-27 11:19:09-08:00,['9260e8563c19cc1c5ac2d47ad05955774138036d'],1,1,2,1042522,1,,,,2798
8e6fbe8fed592e7cc15731a0827c350794413767,0,Ewen Cheslack-Postava,2017-02-28 11:49:16-08:00,['9231cc439e58d6ac252ca960e15c703366e32e1a'],2,2,4,1042526,1,,,,2798
f3fab2e476cf5101ba6ae68e4d61ae9ab957b26c,1,Ewen Cheslack-Postava,2017-02-28 12:21:46-08:00,['8e6fbe8fed592e7cc15731a0827c350794413767'],26,12,38,1042564,3,,,,2798
d0e436c471ba4122ddcc0f7a1624546f97c4a517,0,Ewen Cheslack-Postava,2017-02-28 12:35:04-08:00,['f3fab2e476cf5101ba6ae68e4d61ae9ab957b26c'],7406,7765,15171,1057735,1100,,,,2799
e31c0c9bdbad432bc21b583bd3c084f05323f642,0,Guozhang Wang,2017-02-28 13:30:10-08:00,['d0e436c471ba4122ddcc0f7a1624546f97c4a517'],2,2,4,1057739,1,,,,2799
a10d7b1b765a2ac4af3e219b7c344f67a93de487,1,Guozhang Wang,2017-02-28 13:31:32-08:00,['e31c0c9bdbad432bc21b583bd3c084f05323f642'],8,67,75,1057814,2,1,1,0.9,2799
de05c9d3a0d79a555088afe9344b52e002d287f2,1,Ismael Juma,2017-02-28 22:57:57+00:00,['a10d7b1b765a2ac4af3e219b7c344f67a93de487'],40,307,347,1058161,13,1,1,1,2800
c9872cb2142bbee12e4657af9a84627a1684fddd,1,Ismael Juma,2017-02-28 23:20:12+00:00,['de05c9d3a0d79a555088afe9344b52e002d287f2'],3,60,63,1058224,3,,,,2801
0fba529608a5eb829feb66a499c89ead40b79694,1,Guozhang Wang,2017-03-01 11:21:41-08:00,['c9872cb2142bbee12e4657af9a84627a1684fddd'],27,182,209,1058433,4,0.041666667,0.725,0.958333333,2801
b380a82d5be7c68141590467911ecb61db45ed1e,1,Guozhang Wang,2017-03-01 12:07:46-08:00,['0fba529608a5eb829feb66a499c89ead40b79694'],62,55,117,1058550,2,1,1,1,2801
ef92bb4e00da10728cf74c2d81f8f2bbec4c9c02,1,Guozhang Wang,2017-03-01 14:36:08-08:00,['b380a82d5be7c68141590467911ecb61db45ed1e'],36,28,64,1058614,3,0.666666667,0.666666667,0,2801
1b902b4ed39e78066fab163d1b6d54dd435b1d7b,1,Jun Rao,2017-03-02 09:55:01-08:00,['ef92bb4e00da10728cf74c2d81f8f2bbec4c9c02'],10,21,31,1058645,2,0.714285714,0.714285714,1,2801
ca06862a7005ca476f900bd9c2373021422d695b,1,Guozhang Wang,2017-03-02 13:12:59-08:00,['1b902b4ed39e78066fab163d1b6d54dd435b1d7b'],11,14,25,1058670,8,1,1,1,2801
9e65b25e9fca6c26cef3498ff747879d4f527700,0,Guozhang Wang,2017-03-02 13:19:08-08:00,['ca06862a7005ca476f900bd9c2373021422d695b'],0,92,92,1058762,1,1,1,1,2801
59779aa1546c6039ea145c6e21706cbf68cad4a2,0,Guozhang Wang,2017-03-02 13:23:54-08:00,['9e65b25e9fca6c26cef3498ff747879d4f527700'],2,2,4,1058766,1,,,,2801
670980ef29fb70838dcd462d11789c2519981164,0,Guozhang Wang,2017-03-02 13:26:30-08:00,['59779aa1546c6039ea145c6e21706cbf68cad4a2'],47,50,97,1058863,2,,,,2801
a3c45b0c9263ca4481b1af7af3f7d8ae8cb5d5cd,1,Jason Gustafson,2017-03-02 17:49:10-08:00,['670980ef29fb70838dcd462d11789c2519981164'],107,270,377,1059240,19,0.0625,0.839285714,0.321428571,2801
573a6f39863061a6f38a0aca35f11470c3e8538e,1,Jason Gustafson,2017-03-03 12:01:38-08:00,['a3c45b0c9263ca4481b1af7af3f7d8ae8cb5d5cd'],92,110,202,1059442,5,1,1,0,2801
2e92f9b2e4ab367f89a055a32a64915a38274065,0,Ismael Juma,2017-03-03 22:23:20+00:00,['573a6f39863061a6f38a0aca35f11470c3e8538e'],3,3,6,1059448,3,,,,2801
4b1415c109fa75a01a11460aa80f0404baecac51,1,Ewen Cheslack-Postava,2017-03-03 16:40:25-08:00,['2e92f9b2e4ab367f89a055a32a64915a38274065'],5,11,16,1059464,2,,,,2801
d2792e356ff9d3ed8b0484bf62ac98e85fdc26fa,1,Ismael Juma,2017-03-04 00:48:01+00:00,['4b1415c109fa75a01a11460aa80f0404baecac51'],4,2,6,1059470,1,1,1,0,2801
d9b784e1470714c8b04e7c3d74f626a96ca1591e,0,Ismael Juma,2017-03-04 00:52:26+00:00,['d2792e356ff9d3ed8b0484bf62ac98e85fdc26fa'],75,113,188,1059658,17,0.666666667,1,1,2801
5781feb527766fbb3620cb601ed453dd8086e0c2,0,Ismael Juma,2017-03-04 15:28:35+00:00,['d9b784e1470714c8b04e7c3d74f626a96ca1591e'],1,4,5,1059663,1,0,1,1,2801
adb70da13e18eb652e734887b430ac0ecbc5f9e6,1,Jiangjie Qin,2017-03-04 11:38:57-08:00,['5781feb527766fbb3620cb601ed453dd8086e0c2'],61,153,214,1059877,3,1,0.578947368,1,2801
b7378d567fffd06395f5babc36cebd64bdf539d1,0,Guozhang Wang,2017-03-04 20:55:16-08:00,['adb70da13e18eb652e734887b430ac0ecbc5f9e6'],3,18,21,1059898,3,1,1,1,2801
580bebe09798b8f0062a2a1566a1d5836ecad4bb,1,Guozhang Wang,2017-03-05 10:01:30-08:00,['b7378d567fffd06395f5babc36cebd64bdf539d1'],20,42,62,1059960,9,0,0.777777778,0.888888889,2801
3e69ef6e3c41a83bdec1e2a37073a6af2f44e2a2,0,Gwen Shapira,2017-03-05 10:21:04-08:00,['580bebe09798b8f0062a2a1566a1d5836ecad4bb'],1,10,11,1059971,1,,,,2801
b1272500bd7a80931d9571b426afb6a2de7ddeca,0,Gwen Shapira,2017-03-05 10:28:36-08:00,['3e69ef6e3c41a83bdec1e2a37073a6af2f44e2a2'],0,2,2,1059973,1,,,,2801
5b013d9cd28d86b50109e8e08f813c3b5af0054b,1,Guozhang Wang,2017-03-05 22:42:16-08:00,['b1272500bd7a80931d9571b426afb6a2de7ddeca'],27,43,70,1060043,3,1,1,1,2801
f111f2a7167f3abcb0b0e53ac22f9f7bb367766e,1,Ismael Juma,2017-03-06 10:46:04+00:00,['5b013d9cd28d86b50109e8e08f813c3b5af0054b'],19,19,38,1060081,4,,,,2801
79f85039d7be1b4266f06715a487f3635558ded6,1,Ismael Juma,2017-03-06 11:56:14+00:00,['f111f2a7167f3abcb0b0e53ac22f9f7bb367766e'],1,224,225,1060306,6,1,1,1,2804
63010cbfe5d07df5db060888afd348fab5cbe62c,1,Ismael Juma,2017-03-06 13:12:28+00:00,['79f85039d7be1b4266f06715a487f3635558ded6'],43,60,103,1060409,5,0.5,1,1,2804
2064a2a55dde9ae4e263eb7c78da3b4ac2896201,0,Guozhang Wang,2017-03-06 09:52:17-08:00,['63010cbfe5d07df5db060888afd348fab5cbe62c'],2,2,4,1060413,1,,,,2804
5cf491c2765b4912ff5f7f69f0b992a67005b983,1,Ismael Juma,2017-03-06 20:29:37+00:00,['2064a2a55dde9ae4e263eb7c78da3b4ac2896201'],40,128,168,1060581,4,1,1,1,2805
81f9e1376cefed57022de62cd3abf5641c46e4aa,1,Ismael Juma,2017-03-07 01:30:01+00:00,['5cf491c2765b4912ff5f7f69f0b992a67005b983'],104,105,209,1060790,5,,,,2805
146edd530a6dfa534fd8cb924fd2336e27872c2a,1,Guozhang Wang,2017-03-07 15:31:22-08:00,['81f9e1376cefed57022de62cd3abf5641c46e4aa'],8,14,22,1060812,1,0,0,1,2805
c6bccddb94affe8f85110004341f75bd66b839eb,0,Ismael Juma,2017-03-08 01:01:11+00:00,['146edd530a6dfa534fd8cb924fd2336e27872c2a'],58,52,110,1060922,3,1,1,0,2805
29084a9b27b959532813141591ce03be2921e860,0,Guozhang Wang,2017-03-08 11:40:40-08:00,['c6bccddb94affe8f85110004341f75bd66b839eb'],5,4,9,1060931,1,1,0,1,2805
f7354e779cb058985dd385b2b1209db71eb7a5e8,1,Ismael Juma,2017-03-08 22:25:58+00:00,['29084a9b27b959532813141591ce03be2921e860'],189,668,857,1061788,22,0.554744526,1,1,2807
022bf129518e33e165f9ceefc4ab9e622952d3bd,1,Ismael Juma,2017-03-08 23:16:53+00:00,['f7354e779cb058985dd385b2b1209db71eb7a5e8'],41,58,99,1061887,3,1,1,0.9,2807
537f98a5d64b86022ac2125c75d079c26e4b9830,0,Ismael Juma,2017-03-09 01:00:44+00:00,['022bf129518e33e165f9ceefc4ab9e622952d3bd'],2,2,4,1061891,1,0,0,0,2807
294018a578cbbc187ac123a6b99990468186e349,0,Jun Rao,2017-03-08 21:41:38-08:00,['537f98a5d64b86022ac2125c75d079c26e4b9830'],34,46,80,1061971,9,,,,2807
65650ba4dcba8a9729cb9cb6477a62a7b7c3714e,1,Jason Gustafson,2017-03-09 09:27:33-08:00,['294018a578cbbc187ac123a6b99990468186e349'],14,80,94,1062065,7,0.425,1,1,2807
dbcbd7920f7056c80d55453ad543ea9ba87da9be,1,Ewen Cheslack-Postava,2017-03-09 16:24:38-08:00,['65650ba4dcba8a9729cb9cb6477a62a7b7c3714e'],1,358,359,1062424,3,,,,2808
7565dcd8b0547f91a5d9d19771d9cd6693079d01,1,Jason Gustafson,2017-03-09 16:45:41-08:00,['dbcbd7920f7056c80d55453ad543ea9ba87da9be'],47,128,175,1062599,11,0,0.6,0.5,2809
c063561ce815ec066851e480b7f70a84d6ccd371,0,Guozhang Wang,2017-03-10 07:51:42-08:00,['7565dcd8b0547f91a5d9d19771d9cd6693079d01'],2,2,4,1062603,1,,,,2809
dfa2ef4837259cd127b013e63ce26acdec8b94c5,1,Guozhang Wang,2017-03-10 11:28:06-08:00,['c063561ce815ec066851e480b7f70a84d6ccd371'],125,143,268,1062871,5,1,1,1,2809
0011a3dc337a41ceb21b1567db7bdc3219a07552,1,Guozhang Wang,2017-03-10 13:43:04-08:00,['dfa2ef4837259cd127b013e63ce26acdec8b94c5'],0,4,4,1062875,1,0,1,1,2809
046519d0714591785cd984ab2d57e193b54a2f19,0,Guozhang Wang,2017-03-10 16:48:48-08:00,['0011a3dc337a41ceb21b1567db7bdc3219a07552'],2,2,4,1062879,1,,,,2809
cd69daa4150631e9cea4e299c5ea08e12359118d,0,Guozhang Wang,2017-03-13 11:49:49-07:00,['046519d0714591785cd984ab2d57e193b54a2f19'],0,199,199,1063078,4,0.971698113,0.971698113,1,2811
85e7a0a2b0d56891c13c15fc88a3011877f9c9e9,0,Guozhang Wang,2017-03-13 12:05:47-07:00,['cd69daa4150631e9cea4e299c5ea08e12359118d'],3,46,49,1063127,1,1,1,1,2811
2a9c18a87d4374d03f8a07b37a4e66d74325f1c2,1,Jiangjie Qin,2017-03-13 13:00:53-07:00,['85e7a0a2b0d56891c13c15fc88a3011877f9c9e9'],0,10,10,1063137,2,1,1,1,2811
d3b8ff02437e735801e36cc4970b794344400058,0,Jason Gustafson,2017-03-13 13:47:17-07:00,['2a9c18a87d4374d03f8a07b37a4e66d74325f1c2'],18,26,44,1063181,2,,,,2811
9e4548df30d50a56ae99cb3383f1a3f97bbe77bb,1,Guozhang Wang,2017-03-14 14:21:03-07:00,['d3b8ff02437e735801e36cc4970b794344400058'],482,663,1145,1064326,7,0.650793651,1,0.698412698,2813
52a15d7c0b88da11409954321463b8b57b133a23,0,Ewen Cheslack-Postava,2017-03-14 17:20:49-07:00,['9e4548df30d50a56ae99cb3383f1a3f97bbe77bb'],0,146,146,1064472,3,1,1,0.847826087,2815
962c378cc6cdb178541155af419c24e463516a5d,0,Ismael Juma,2017-03-15 14:46:32+00:00,['52a15d7c0b88da11409954321463b8b57b133a23'],11,11,22,1064494,2,,,,2815
b9f812491f5eb06ffe5b68f5e53df4302d2f68a8,1,Jason Gustafson,2017-03-15 10:46:57-07:00,['962c378cc6cdb178541155af419c24e463516a5d'],31,32,63,1064557,2,1,0,0,2815
be11272818a06eea157ab7f6eee8905855f1cede,0,Sriharsha Chintalapani,2017-03-15 11:50:57-07:00,['b9f812491f5eb06ffe5b68f5e53df4302d2f68a8'],1,1,2,1064559,1,,,,2815
1659ca1773596b5889fe8b2f163196f7b32ea70a,0,Jun Rao,2017-03-16 09:13:58-07:00,['be11272818a06eea157ab7f6eee8905855f1cede'],15,115,130,1064689,5,0.424242424,1,0.984848485,2815
b8fe2bb56c25715de1602c1f00ab720af085f2e5,1,Guozhang Wang,2017-03-16 22:33:50-07:00,['1659ca1773596b5889fe8b2f163196f7b32ea70a'],14,41,55,1064744,4,0.55,1,1,2815
cfda0368dbb7ddd014780e1ed1dedcae2778f403,1,Guozhang Wang,2017-03-16 22:36:06-07:00,['b8fe2bb56c25715de1602c1f00ab720af085f2e5'],5,16,21,1064765,5,0,1,0.75,2815
c5adf17aeae763d9e8a4e802d988a464fef5d5e8,0,Ismael Juma,2017-03-17 10:26:28+00:00,['cfda0368dbb7ddd014780e1ed1dedcae2778f403'],0,4,4,1064769,1,1,1,1,2815
6b11fb7af81390789ba449c0cd5daa81c8ee9cb5,0,Ismael Juma,2017-03-17 12:39:53+00:00,['c5adf17aeae763d9e8a4e802d988a464fef5d5e8'],1,1,2,1064771,1,,,,2815
01768e3321cfce19bf558ad0fe7bf6ca84ada8f6,0,Ismael Juma,2017-03-17 13:49:19+00:00,['6b11fb7af81390789ba449c0cd5daa81c8ee9cb5'],1,1,2,1064773,1,,,,2815
ec8feb766f0fc560200a326941632033600c141e,0,Ismael Juma,2017-03-17 13:59:40+00:00,['01768e3321cfce19bf558ad0fe7bf6ca84ada8f6'],3,3,6,1064779,2,,,,2815
9e787716b013595851b4a6c1ddf8b8af1ec0f42e,0,Guozhang Wang,2017-03-17 12:03:02-07:00,['ec8feb766f0fc560200a326941632033600c141e'],15,274,289,1065068,13,0.849056604,1,0.91509434,2817
783900c259511f86f5af03cbd96f2e74833447b9,0,Guozhang Wang,2017-03-17 15:18:06-07:00,['9e787716b013595851b4a6c1ddf8b8af1ec0f42e'],22,78,100,1065168,2,0,1,1,2817
5a2fcdd6d480e9f003cc49a59d5952ba4c515a71,1,Jun Rao,2017-03-20 13:52:35-07:00,['783900c259511f86f5af03cbd96f2e74833447b9'],121,168,289,1065457,24,0,0.791666667,1,2817
197a5d5a6d160e9f3f1642caf85bad968a35f109,1,Guozhang Wang,2017-03-20 21:56:15-07:00,['5a2fcdd6d480e9f003cc49a59d5952ba4c515a71'],8,22,30,1065487,7,0,0.666666667,0.333333333,2822
05690f0c851007fb60ebd96c43c1141bddd510c1,1,Ismael Juma,2017-03-21 09:52:16+00:00,['197a5d5a6d160e9f3f1642caf85bad968a35f109'],1,1,2,1065489,1,,,,2822
fef7fca2af7fd00bc6b0889062da3f8b56b2224e,1,Ismael Juma,2017-03-21 10:12:36+00:00,['05690f0c851007fb60ebd96c43c1141bddd510c1'],178,289,467,1065956,21,1,1,0,2824
c74eec96c5e8828a88df67f6eb21d2369b340a22,1,Guozhang Wang,2017-03-21 16:11:50-07:00,['fef7fca2af7fd00bc6b0889062da3f8b56b2224e'],21,167,188,1066144,6,0.316455696,0.53164557,0.974683544,2825
c2653754d9dbc232ae5f2052993611b26ed62693,0,Guozhang Wang,2017-03-21 16:17:17-07:00,['c74eec96c5e8828a88df67f6eb21d2369b340a22'],3,0,3,1066147,1,,,,2825
6f7780cf127c8f4bb0edabaa5cb228fc566681f2,0,Guozhang Wang,2017-03-21 16:21:28-07:00,['c2653754d9dbc232ae5f2052993611b26ed62693'],57,64,121,1066268,2,,,,2825
a7e3679d22504b0808e970ac9c481a3ee62f9243,0,Ewen Cheslack-Postava,2017-03-21 16:48:44-07:00,['6f7780cf127c8f4bb0edabaa5cb228fc566681f2'],2,33,35,1066303,3,0,0,1,2825
b3beaebd4481dc94a36949dbb87e02c28272adb0,1,Guozhang Wang,2017-03-21 19:13:57-07:00,['a7e3679d22504b0808e970ac9c481a3ee62f9243'],0,13,13,1066316,1,0.5,0.5,0.5,2825
83824089f2371d6375c2713d494f276aec27c1a1,0,Guozhang Wang,2017-03-21 19:18:41-07:00,['b3beaebd4481dc94a36949dbb87e02c28272adb0'],12,27,39,1066355,1,0,1,1,2825
d5cec01f2aeb37823d1a158683da0809a0c54818,0,Ewen Cheslack-Postava,2017-03-21 22:24:17-07:00,['83824089f2371d6375c2713d494f276aec27c1a1'],109,487,596,1066951,8,0.77,1,0.67,2827
666beecec83db755335eac9cef2433d0b4870a05,0,Guozhang Wang,2017-03-22 12:23:07-07:00,['d5cec01f2aeb37823d1a158683da0809a0c54818'],1,1,2,1066953,1,,,,2827
763ea5aad191b09ed3deefaa12ce7b9925ebe7dc,0,Gwen Shapira,2017-03-22 16:02:09-05:00,['666beecec83db755335eac9cef2433d0b4870a05'],12,14,26,1066979,7,,,,2827
57278aa82da5dc9d040eb3dcf4a182e0731a621b,1,Guozhang Wang,2017-03-22 14:33:34-07:00,['763ea5aad191b09ed3deefaa12ce7b9925ebe7dc'],84,179,263,1067242,11,0.267605634,0.929577465,0.788732394,2827
95ef40dd31b6b0ee403413184ef974c6c051ddeb,0,Ewen Cheslack-Postava,2017-03-22 23:06:26-07:00,['57278aa82da5dc9d040eb3dcf4a182e0731a621b'],1,73,74,1067316,2,,,,2827
2269eed242d9ccd4cc3e9ae3211d01f166f6e234,0,Guozhang Wang,2017-03-23 09:47:45-07:00,['95ef40dd31b6b0ee403413184ef974c6c051ddeb'],5,9,14,1067330,4,1,0,0,2827
f615c9e9d2c59542665edd95cd7152f17e61f026,1,Guozhang Wang,2017-03-23 10:04:58-07:00,['2269eed242d9ccd4cc3e9ae3211d01f166f6e234'],2,4,6,1067336,1,0,0,0,2827
5bd06f1d542e6b588a1d402d059bc24690017d32,1,Ismael Juma,2017-03-24 19:38:43+00:00,['f615c9e9d2c59542665edd95cd7152f17e61f026'],3267,7417,10684,1078020,143,0.508511567,0.731558271,0.73068529,2847
462767660baf49fb63550e60cd9a418705831715,0,Ewen Cheslack-Postava,2017-03-24 19:42:55-07:00,['5bd06f1d542e6b588a1d402d059bc24690017d32'],3,22,25,1078045,3,1,1,1,2847
d348ac92c80b6426864e3ed68b89bad341b3bda5,1,Jason Gustafson,2017-03-25 14:03:40-07:00,['462767660baf49fb63550e60cd9a418705831715'],34,100,134,1078179,2,0.653061224,0.755102041,1,2847
d27e09e60c53520bd24872f8b7dbfee87b523d04,1,Jason Gustafson,2017-03-27 09:28:46-07:00,['d348ac92c80b6426864e3ed68b89bad341b3bda5'],118,33,151,1078330,2,0,0,0,2847
1abed91bd2915226cf6320395e1a5877ea0705d7,1,Guozhang Wang,2017-03-27 10:30:38-07:00,['d27e09e60c53520bd24872f8b7dbfee87b523d04'],72,152,224,1078554,10,0.617021277,0.914893617,0.29787234,2847
f3f9a9eafb9aee9d87dd188521a4fd72466abfeb,1,Jason Gustafson,2017-03-27 16:05:15-07:00,['1abed91bd2915226cf6320395e1a5877ea0705d7'],50,51,101,1078655,4,0,,0,2847
8b05ad406d4cba6a75d1683b6d8699c3ab28f9d6,1,Jiangjie Qin,2017-03-28 09:59:44-07:00,['f3f9a9eafb9aee9d87dd188521a4fd72466abfeb'],271,1732,2003,1080658,59,0.436314363,0.707317073,0.933604336,2853
23a0f0986319cc0061a0ea149f23f5b5d696d1c1,0,Jiangjie Qin,2017-03-28 12:16:32-07:00,['8b05ad406d4cba6a75d1683b6d8699c3ab28f9d6'],4,0,4,1080662,1,,,,2853
edb372dcaf34312b5c1c91c4df5e5ff87586e73b,0,Ismael Juma,2017-03-28 23:47:51+01:00,['23a0f0986319cc0061a0ea149f23f5b5d696d1c1'],1,5,6,1080668,1,,,,2853
a0b8e435c9419a9402d08408260bea0c1d95cff0,1,Jason Gustafson,2017-03-28 17:47:10-07:00,['edb372dcaf34312b5c1c91c4df5e5ff87586e73b'],153,175,328,1080996,3,1,1,1,2853
4ce65d65dff3e185bdfd387b6fd4b730e69adec4,0,Ismael Juma,2017-03-29 02:30:30+01:00,['a0b8e435c9419a9402d08408260bea0c1d95cff0'],1,2,3,1080999,1,,,,2853
42284960dab4724445a4a3a7831b3b48f0ddcb48,0,Ismael Juma,2017-03-29 16:10:19+01:00,['4ce65d65dff3e185bdfd387b6fd4b730e69adec4'],20,66,86,1081085,4,1,1,1,2854
7adf1e4148a1b709f9bc754b08129c390e725cdf,1,Ismael Juma,2017-03-29 16:22:47+01:00,['42284960dab4724445a4a3a7831b3b48f0ddcb48'],0,6,6,1081091,1,,,,2854
aea5989d988cd1b46c95409989a7c12c7cf52b5f,0,Ismael Juma,2017-03-29 16:33:12+01:00,['7adf1e4148a1b709f9bc754b08129c390e725cdf'],4,0,4,1081095,1,0,0,0,2854
6feaa8a581daaa76ff7c85e4a0b9c9aa4284fe99,1,Jason Gustafson,2017-03-29 11:10:43-07:00,['aea5989d988cd1b46c95409989a7c12c7cf52b5f'],109,1086,1195,1082290,14,0.471590909,0.352272727,0.653409091,2859
84a14fec299749a208251bce1a0eb9c1a8241d08,1,Guozhang Wang,2017-03-29 15:00:26-07:00,['6feaa8a581daaa76ff7c85e4a0b9c9aa4284fe99'],105,188,293,1082583,5,0.574468085,0.85106383,0.70212766,2859
c808e8955f23c551c86ec0f51683c88486ad394e,0,Ismael Juma,2017-03-30 12:33:59+01:00,['84a14fec299749a208251bce1a0eb9c1a8241d08'],1,9,10,1082593,2,1,1,1,2859
43fb2df7a4b2bc7637dcba9436a5435cdcb4fb27,1,Ismael Juma,2017-03-30 13:23:52+01:00,['c808e8955f23c551c86ec0f51683c88486ad394e'],59,30,89,1082682,14,0,0,0,2859
d345d53e4e5e4f74707e2521aa635b93ba3f1e7b,1,Ismael Juma,2017-03-30 13:38:09+01:00,['43fb2df7a4b2bc7637dcba9436a5435cdcb4fb27'],25,87,112,1082794,12,0.0625,0.875,1,2859
81721f8c535d9b32c518bb8f74611ead50826d4c,0,Ismael Juma,2017-03-30 13:50:46+01:00,['d345d53e4e5e4f74707e2521aa635b93ba3f1e7b'],2,2,4,1082798,1,,,,2859
a3e13776e6c0889131ddfdaa8b10cd2ef2498603,0,Ismael Juma,2017-03-30 13:52:22+01:00,['81721f8c535d9b32c518bb8f74611ead50826d4c'],16,16,32,1082830,12,,,,2859
4b3ea062be515bc173f6c788c4c1e14f77935aef,0,Jiangjie Qin,2017-03-30 10:50:38-07:00,['a3e13776e6c0889131ddfdaa8b10cd2ef2498603'],2,0,2,1082832,1,0,0,0,2859
2e075fe6a47221b24abc49c25a4a69a447362eeb,0,Jason Gustafson,2017-03-30 11:24:01-07:00,['4b3ea062be515bc173f6c788c4c1e14f77935aef'],2,2,4,1082836,1,,,,2859
92b7d7570027cdc4e069862472ce6ec6b3dad04a,1,Guozhang Wang,2017-03-30 13:30:10-07:00,['2e075fe6a47221b24abc49c25a4a69a447362eeb'],1,32,33,1082869,1,0.32,1,1,2859
f9772d5fb26b0a375729a88db5e7ee199f85c8b3,0,Guozhang Wang,2017-03-30 13:47:11-07:00,['92b7d7570027cdc4e069862472ce6ec6b3dad04a'],6,6,12,1082881,1,,,,2859
dd71e4a8d830c9de40b5ec3f987f60a1d2f26b39,1,Ismael Juma,2017-03-30 22:39:28+01:00,['f9772d5fb26b0a375729a88db5e7ee199f85c8b3'],182,516,698,1083579,13,0.387559809,0.918660287,1,2860
4e92fd5f7411da155aeec166901f5f6f89ca7ba2,0,Jason Gustafson,2017-03-30 14:41:27-07:00,['dd71e4a8d830c9de40b5ec3f987f60a1d2f26b39'],1,21,22,1083601,1,,,,2860
15e0234a5f4976facd4cfe61b91cfcdec6f6083c,1,Guozhang Wang,2017-03-30 15:44:56-07:00,['4e92fd5f7411da155aeec166901f5f6f89ca7ba2'],71,178,249,1083850,3,0.043478261,0.347826087,1,2860
93d451ceeb00a150bbbdae3f0601620b902b7c87,0,Ismael Juma,2017-03-30 23:52:03+01:00,['15e0234a5f4976facd4cfe61b91cfcdec6f6083c'],2,2,4,1083854,1,,,,2860
5f88cf79fb51996e77614aafdfbb15e4989e159b,0,Guozhang Wang,2017-03-30 15:58:24-07:00,['93d451ceeb00a150bbbdae3f0601620b902b7c87'],1,7,8,1083862,1,,,,2860
1ce6aa550324f74c41fc404ce9f4a9e51f7c862e,1,Ismael Juma,2017-03-31 11:08:12+01:00,['5f88cf79fb51996e77614aafdfbb15e4989e159b'],5,5,10,1083872,1,,,,2860
bdf4cba047334943aa8357585c4fb379b27e9ffd,1,Jun Rao,2017-04-02 19:41:44-07:00,['1ce6aa550324f74c41fc404ce9f4a9e51f7c862e'],563,3124,3687,1087559,70,0.453092425,0.748436414,0.82904795,2875
3364f12bc240e3fefa6a467519ef608fa768917c,1,Ismael Juma,2017-04-03 12:50:57+01:00,['bdf4cba047334943aa8357585c4fb379b27e9ffd'],22,26,48,1087607,4,1,1,1,2875
1ba8b40b3421ad0d23787ba9a1a4b635d8f11d91,0,Ismael Juma,2017-04-03 12:57:40+01:00,['3364f12bc240e3fefa6a467519ef608fa768917c'],1,4,5,1087612,1,0,1,0,2875
f54b61909d525547d65123c02bbd36d92ccee5da,1,Jun Rao,2017-04-03 09:40:38-07:00,['1ba8b40b3421ad0d23787ba9a1a4b635d8f11d91'],14,29,43,1087655,3,0,1,1,2875
800d29648bc370643d6dd1ead861792d7585c843,1,Jun Rao,2017-04-03 09:54:16-07:00,['f54b61909d525547d65123c02bbd36d92ccee5da'],255,243,498,1088153,1,1,0,0,2875
040fde8ec1f94856799c6bb47fa23a73c20bda66,1,Gwen Shapira,2017-04-03 13:09:10-07:00,['800d29648bc370643d6dd1ead861792d7585c843'],12,80,92,1088245,4,0,1,1,2875
b9b2cfc28c055745f606ba1a20c5e8e428acefcf,1,Ismael Juma,2017-04-04 00:13:56+01:00,['040fde8ec1f94856799c6bb47fa23a73c20bda66'],12,61,73,1088318,5,1,1,0.833333333,2875
ca2979f847ead39b4480f31085c5cf26bb102080,0,Ismael Juma,2017-04-04 00:16:35+01:00,['b9b2cfc28c055745f606ba1a20c5e8e428acefcf'],6,5,11,1088329,2,0,0,1,2875
f812a8fd93c37cb27db07505dd5f8f29463906a1,1,Ewen Cheslack-Postava,2017-04-03 17:57:12-07:00,['ca2979f847ead39b4480f31085c5cf26bb102080'],8,71,79,1088408,6,1,1,1,2875
75e213e55036850abef77e4641af9b9071465f80,0,Ewen Cheslack-Postava,2017-04-03 20:07:47-07:00,['f812a8fd93c37cb27db07505dd5f8f29463906a1'],9,20,29,1088437,2,1,1,1,2875
54bf2fb5ff8f1841aea2df2e6fa76f8a05fddfba,0,Ewen Cheslack-Postava,2017-04-04 14:58:45-07:00,['75e213e55036850abef77e4641af9b9071465f80'],10,27,37,1088474,2,1,1,0.636363636,2875
9160810072e540a3a037481505aaaa23e3b50546,1,Ewen Cheslack-Postava,2017-04-04 15:07:32-07:00,['54bf2fb5ff8f1841aea2df2e6fa76f8a05fddfba'],14,224,238,1088712,2,0.081632653,1,1,2875
49f80b2360ab55274ad28405352596f9d560ec1c,1,Ewen Cheslack-Postava,2017-04-04 18:32:58-07:00,['9160810072e540a3a037481505aaaa23e3b50546'],52,354,406,1089118,11,0.257668712,0.779141104,0.582822086,2876
aea14651184476940c69238535de5143e61f4c31,1,Ismael Juma,2017-04-05 10:31:06+01:00,['49f80b2360ab55274ad28405352596f9d560ec1c'],146,229,375,1089493,38,0,1,0.381818182,2876
0df910c0345ce7a667aa3276a9fea15851df50f1,1,Ismael Juma,2017-04-05 10:42:08+01:00,['aea14651184476940c69238535de5143e61f4c31'],33,73,106,1089599,1,0,1,1,2876
d4c4bcf017a1b770dca71868b97d37ec7327ea00,0,Ismael Juma,2017-04-05 11:35:04+01:00,['0df910c0345ce7a667aa3276a9fea15851df50f1'],12,17,29,1089628,4,1,1,1,2876
97e61d4ae2feaf0551e75fa8cdd041f49f42a9a5,0,Ismael Juma,2017-04-05 11:39:18+01:00,['d4c4bcf017a1b770dca71868b97d37ec7327ea00'],3,10,13,1089641,1,0.75,0.75,0.75,2876
d5fb7364aebf293c621b804a4585eb9ef1001864,1,Ismael Juma,2017-04-05 22:17:32+01:00,['97e61d4ae2feaf0551e75fa8cdd041f49f42a9a5'],24,82,106,1089747,7,0,0,1,2876
afeadbef50ee8cb5c23de26c1b2a5ad2c7ad941e,1,Ismael Juma,2017-04-06 12:00:38+01:00,['d5fb7364aebf293c621b804a4585eb9ef1001864'],63,160,223,1089970,2,0.317460317,1,0.301587302,2876
6ba98f6e5ad8776b7268441b5392330496565814,0,Ismael Juma,2017-04-06 12:34:19+01:00,['afeadbef50ee8cb5c23de26c1b2a5ad2c7ad941e'],11,16,27,1089997,5,,,,2876
b611cfa5c0f4941a491781424afd9b699bdb894e,0,Ismael Juma,2017-04-06 14:44:40+01:00,['6ba98f6e5ad8776b7268441b5392330496565814'],1,20,21,1090018,1,,,,2876
0baea2ac13532981f3fea11e5dfc6da5aafaeaa8,1,Jun Rao,2017-04-06 14:51:09-07:00,['b611cfa5c0f4941a491781424afd9b699bdb894e'],256,3837,4093,1094111,53,0.596992481,0.952882206,0.920300752,2891
76a10e23f0a3d89e4a0a88854d0ec3926e7f6827,0,Jun Rao,2017-04-06 15:57:21-07:00,['0baea2ac13532981f3fea11e5dfc6da5aafaeaa8'],7,6,13,1094124,2,,,,2891
2f4f3b957d753debd8d10c98a2c867211064503e,1,Ismael Juma,2017-04-06 23:59:16+01:00,['76a10e23f0a3d89e4a0a88854d0ec3926e7f6827'],28,65,93,1094217,7,1,1,1,2891
865d82af2cc050d10544d70b95468da90c1d800b,1,Ismael Juma,2017-04-07 12:07:25+01:00,['2f4f3b957d753debd8d10c98a2c867211064503e'],47,1597,1644,1095861,25,0.60619469,0.957227139,0.871681416,2904
359a68510801a22630a7af275c9935fb2d4c8dbf,1,Ismael Juma,2017-04-07 12:19:49+01:00,['865d82af2cc050d10544d70b95468da90c1d800b'],121,46,167,1096028,2,0.346938776,0.142857143,0,2904
ab148f39ae64ecbaa84f49c38b3cab8a0a0fd846,1,Ismael Juma,2017-04-07 12:41:35+01:00,['359a68510801a22630a7af275c9935fb2d4c8dbf'],132,204,336,1096364,22,0,1,1,2904
e19bf3f24466cd8dcd6c11f2d7cbc5796600fb88,0,Ismael Juma,2017-04-07 13:39:32+01:00,['ab148f39ae64ecbaa84f49c38b3cab8a0a0fd846'],0,1,1,1096365,1,,,,2904
a4c50687f6a5a5a7ea9e523df7c55355441c7ffa,0,Gwen Shapira,2017-04-07 10:14:06-07:00,['e19bf3f24466cd8dcd6c11f2d7cbc5796600fb88'],1,4,5,1096370,2,0,1,1,2904
5cf64f06a877a181d12a2ae2390516ba1a572135,1,Ismael Juma,2017-04-07 18:29:55+01:00,['a4c50687f6a5a5a7ea9e523df7c55355441c7ffa'],359,529,888,1097258,15,0,0,0.666666667,2904
67fc2a91a6e80bfda30537c7c95cd9ce396d4e7d,1,Gwen Shapira,2017-04-07 11:07:06-07:00,['5cf64f06a877a181d12a2ae2390516ba1a572135'],45,80,125,1097383,3,0.25,0,0.708333333,2904
82a8e83de622f777a81e9ea0c01d6832f44e7956,1,Ismael Juma,2017-04-08 01:03:49+01:00,['67fc2a91a6e80bfda30537c7c95cd9ce396d4e7d'],57,68,125,1097508,4,0.333333333,0.333333333,0,2904
c31958eb0d547b10a388fc63fcc3cbe00dec27f2,0,Gwen Shapira,2017-04-10 09:16:49-07:00,['82a8e83de622f777a81e9ea0c01d6832f44e7956'],21,22,43,1097551,1,,,,2904
749e9e14c7a1b8a97f79a2d852d8c8647b55b38e,1,Ismael Juma,2017-04-11 01:21:07+01:00,['c31958eb0d547b10a388fc63fcc3cbe00dec27f2'],3,3,6,1097557,2,,,,2904
d0e7c6b9304b23ced046934c799df0cba39c28e5,1,Ismael Juma,2017-04-11 09:11:46+01:00,['749e9e14c7a1b8a97f79a2d852d8c8647b55b38e'],332,641,973,1098530,46,0.727272727,0.909090909,0.909090909,2909
7c58351e9e7d109a54dfa319437ca5f891164e5b,0,Ismael Juma,2017-04-11 09:50:02+01:00,['d0e7c6b9304b23ced046934c799df0cba39c28e5'],1,8,9,1098539,2,,,,2909
d2f5589afc4505c2e2c11e125ad1be69eb9fe645,0,Ismael Juma,2017-04-11 11:28:58+01:00,['7c58351e9e7d109a54dfa319437ca5f891164e5b'],1,1,2,1098541,1,,,,2909
8e7516ea2e6b99a6e9a3fb5a958e62b1fb186cf9,1,Ismael Juma,2017-04-11 12:38:09+01:00,['d2f5589afc4505c2e2c11e125ad1be69eb9fe645'],8,25,33,1098574,2,0,0,1,2909
256f8d5662bcaf0804a4b328de1466d2b57d039e,1,Ismael Juma,2017-04-12 00:44:59+01:00,['8e7516ea2e6b99a6e9a3fb5a958e62b1fb186cf9'],56,93,149,1098723,9,0,0,0,2909
1d25369d22f47567a7117dede14b62b8586f394a,0,Ismael Juma,2017-04-12 01:01:59+01:00,['256f8d5662bcaf0804a4b328de1466d2b57d039e'],139,152,291,1099014,7,1,1,1,2909
a74f0358444160516990a8d6585fb95734381301,0,Gwen Shapira,2017-04-11 17:08:04-07:00,['1d25369d22f47567a7117dede14b62b8586f394a'],1,16,17,1099031,2,,,,2909
3c93fa321ba7c0027169685beade2082c041a60e,0,Ismael Juma,2017-04-12 11:09:21+01:00,['a74f0358444160516990a8d6585fb95734381301'],1,1,2,1099033,1,,,,2909
0be835dde50611277504a4ddd93cc62f39e6defe,1,Ismael Juma,2017-04-12 13:04:44+01:00,['3c93fa321ba7c0027169685beade2082c041a60e'],5,30,35,1099068,15,0,1,1,2909
1e93c3b9a3b8cbf069c57b46737fc02c818cb286,1,Ismael Juma,2017-04-12 16:34:07+01:00,['0be835dde50611277504a4ddd93cc62f39e6defe'],5,37,42,1099110,3,0.476190476,1,0.714285714,2909
148f8c25453e453f56ef429f8ef607de808de679,1,Ismael Juma,2017-04-14 15:19:52+01:00,['1e93c3b9a3b8cbf069c57b46737fc02c818cb286'],233,515,748,1099858,8,0.321428571,0.841836735,0.994897959,2909
17ce2a7307222d7476eb60318fab2e672eebe559,1,Jiangjie Qin,2017-04-16 23:23:25-07:00,['148f8c25453e453f56ef429f8ef607de808de679'],25,135,160,1100018,3,0.073170732,0.780487805,0.93902439,2909
020ca7903669306862950260b8d63177402322c3,1,Jun Rao,2017-04-17 17:24:45-07:00,['17ce2a7307222d7476eb60318fab2e672eebe559'],352,278,630,1100648,19,0.145454545,0.090909091,0,2909
c4e59a338a045fc9d9b726ad68641e93582a8642,1,Jun Rao,2017-04-18 16:39:47-07:00,['020ca7903669306862950260b8d63177402322c3'],7,340,347,1100995,5,0.425531915,1,0.904255319,2910
41c0f8addeef44be23524bade61bcb2ab6077706,0,Ismael Juma,2017-04-19 11:30:55+01:00,['c4e59a338a045fc9d9b726ad68641e93582a8642'],31,33,64,1101059,2,,,1,2910
7c436d38890083cd833091971e40f0c977993570,0,Ismael Juma,2017-04-19 16:17:53+01:00,['41c0f8addeef44be23524bade61bcb2ab6077706'],2,2,4,1101063,1,,,,2910
609e9b0b2f46ce72ed91965f7e43c512b26a609b,1,Jun Rao,2017-04-19 09:53:13-07:00,['7c436d38890083cd833091971e40f0c977993570'],6,119,125,1101188,4,0,0.440677966,1,2911
c2d17c830ca309a4e3989981a47790209955273c,1,Ismael Juma,2017-04-20 08:55:42+01:00,['609e9b0b2f46ce72ed91965f7e43c512b26a609b'],17,14,31,1101219,2,,,,2911
63f01a8af897ee9510ab0364f2d026e4bf5472ef,0,Ismael Juma,2017-04-20 09:42:23+01:00,['c2d17c830ca309a4e3989981a47790209955273c'],39,107,146,1101365,9,0.974358974,1,1,2911
6af876b94dc588c8d6098a7fef7a18c46625d1d5,1,Ismael Juma,2017-04-20 13:19:36+01:00,['63f01a8af897ee9510ab0364f2d026e4bf5472ef'],129,137,266,1101631,5,0,0,0.769230769,2912
588ed4644fe8842e4217c8e2add39f6e08e07db9,1,Jun Rao,2017-04-20 13:01:46-07:00,['6af876b94dc588c8d6098a7fef7a18c46625d1d5'],196,609,805,1102436,11,0.208609272,1,1,2912
98d62a880d91ac1b552ac3a049c5d202c2d63520,1,Guozhang Wang,2017-04-20 13:36:52-07:00,['588ed4644fe8842e4217c8e2add39f6e08e07db9'],36,59,95,1102531,4,0.6,0.6,1,2912
779874fb14f5a2f60016546059576e8ae936b14c,0,Guozhang Wang,2017-04-20 13:49:06-07:00,['98d62a880d91ac1b552ac3a049c5d202c2d63520'],4,2,6,1102537,1,0,0,0,2912
2aa339de1135e110bba9c345e809bebf27ce3178,0,Jason Gustafson,2017-04-20 14:07:58-07:00,['779874fb14f5a2f60016546059576e8ae936b14c'],1,1,2,1102539,1,,,,2912
14ab3dcc6c70d5bd4b21d99e0b97332ea332ac07,1,Guozhang Wang,2017-04-20 14:11:49-07:00,['2aa339de1135e110bba9c345e809bebf27ce3178'],7,15,22,1102561,8,0.2,1,0.8,2912
3c471d25b97b9a867ec6a2a1ed9467b8e4ba6b66,1,Guozhang Wang,2017-04-20 14:24:47-07:00,['14ab3dcc6c70d5bd4b21d99e0b97332ea332ac07'],18,75,93,1102654,8,0.864864865,0.324324324,0.891891892,2912
49230625736d30cb4d0467ac0a103b23de5c266b,0,Guozhang Wang,2017-04-20 14:34:45-07:00,['3c471d25b97b9a867ec6a2a1ed9467b8e4ba6b66'],0,4,4,1102658,1,1,1,1,2912
f18a14af361f24851664b428b46d5789f51a80ea,0,Guozhang Wang,2017-04-20 14:55:43-07:00,['49230625736d30cb4d0467ac0a103b23de5c266b'],2,2,4,1102662,1,,,,2912
fc5ad22e33cb9f757f645cec9d4afe9e65292712,0,Guozhang Wang,2017-04-20 21:43:08-07:00,['f18a14af361f24851664b428b46d5789f51a80ea'],3,3,6,1102668,3,,,,2912
d18de0e9547728e4fa0df985c1778aab5ffec751,1,Ismael Juma,2017-04-21 10:47:24+01:00,['fc5ad22e33cb9f757f645cec9d4afe9e65292712'],9,23,32,1102700,2,0,0,1,2912
d53e99736550b37edc89d1a220cab43604fa3f03,1,Ismael Juma,2017-04-21 11:35:49+01:00,['d18de0e9547728e4fa0df985c1778aab5ffec751'],10,11,21,1102721,3,,,,2912
c82118b196687cf5f523dfd733bfe575a127c315,0,Ismael Juma,2017-04-21 14:05:14+01:00,['d53e99736550b37edc89d1a220cab43604fa3f03'],3,3,6,1102727,2,,,,2912
93fbda4c577870c96c3ab86c29b60c04dc9183b9,0,Jason Gustafson,2017-04-21 10:35:33-07:00,['c82118b196687cf5f523dfd733bfe575a127c315'],1,8,9,1102736,1,1,1,0,2912
3bedcce01b9d3e8ba0516fa33eb59d57817ce27e,1,Guozhang Wang,2017-04-21 10:47:28-07:00,['93fbda4c577870c96c3ab86c29b60c04dc9183b9'],250,277,527,1103263,9,0.444444444,1,0.777777778,2912
72be1df5984a8d2df7b4d2ea8f386c69fe31f4d2,1,Guozhang Wang,2017-04-21 10:53:29-07:00,['3bedcce01b9d3e8ba0516fa33eb59d57817ce27e'],3,72,75,1103338,4,0.730769231,0.884615385,1,2913
80e0548e2b1620c25f4fddc69550d00dd460961c,0,Jun Rao,2017-04-21 12:52:38-07:00,['72be1df5984a8d2df7b4d2ea8f386c69fe31f4d2'],0,4,4,1103342,1,0,0,1,2913
cba0094f5a9833194bf2a13965eda678bd4a05ea,1,Guozhang Wang,2017-04-21 13:10:05-07:00,['80e0548e2b1620c25f4fddc69550d00dd460961c'],228,243,471,1103813,34,1,0,0.258064516,2913
3d8506a3ac5e4176ea1f2f0be97bef2712f46464,0,Guozhang Wang,2017-04-21 13:25:12-07:00,['cba0094f5a9833194bf2a13965eda678bd4a05ea'],2,2,4,1103817,1,,,,2913
d7b5eadb92e514857754f8599f3d902093651f25,0,Guozhang Wang,2017-04-21 13:27:11-07:00,['3d8506a3ac5e4176ea1f2f0be97bef2712f46464'],2,1,3,1103820,1,,,,2913
19f266d4075a8c56d56f6b8c7e95773378b95211,1,Jason Gustafson,2017-04-22 13:57:27-07:00,['d7b5eadb92e514857754f8599f3d902093651f25'],13,14,27,1103847,3,1,1,1,2913
1fbb8cfafa64307f94de09e4a14217a69f01cea0,0,Ismael Juma,2017-04-23 16:23:48+01:00,['19f266d4075a8c56d56f6b8c7e95773378b95211'],1,1,2,1103849,1,,,,2913
b15422177460a8f928a2ba93c429de426ae68076,0,Ismael Juma,2017-04-23 16:29:45+01:00,['1fbb8cfafa64307f94de09e4a14217a69f01cea0'],7,14,21,1103870,1,0,0,1,2913
4815323be73e4e207fcf7079714bd1fd82fd8f6b,0,Ismael Juma,2017-04-24 10:17:12+01:00,['b15422177460a8f928a2ba93c429de426ae68076'],5,9,14,1103884,1,0,1,0,2913
c43eb856d16e648c2a6ab1f87b58f59035fce065,1,Jiangjie Qin,2017-04-25 10:31:16-07:00,['4815323be73e4e207fcf7079714bd1fd82fd8f6b'],62,110,172,1104056,2,0,1,1,2913
f7b7b4745541a576eb0219468263487b07bac959,1,Guozhang Wang,2017-04-25 18:10:49-07:00,['c43eb856d16e648c2a6ab1f87b58f59035fce065'],616,547,1163,1105219,10,0,0,0.288461538,2913
d06f2cc7ac8d214edbefa57addc82312fbae884f,1,Guozhang Wang,2017-04-26 12:27:24-07:00,['f7b7b4745541a576eb0219468263487b07bac959'],1,1,2,1105221,1,0,1,1,2913
8d8ab2ebcd498982a9dd6be873f4d7cc032c65d8,1,Jason Gustafson,2017-04-26 13:46:35-07:00,['d06f2cc7ac8d214edbefa57addc82312fbae884f'],13,31,44,1105265,2,0.705882353,0.705882353,1,2913
f69d94158ce72f4ef2df5b98f2395c2b2e61251e,1,Guozhang Wang,2017-04-26 14:10:38-07:00,['8d8ab2ebcd498982a9dd6be873f4d7cc032c65d8'],442,4452,4894,1110159,58,0.518087318,0.798752599,0.852390852,2931
bb663d04febcadd4f120e0ff5c5919ca8bf7e971,1,Jun Rao,2017-04-27 08:51:23-07:00,['f69d94158ce72f4ef2df5b98f2395c2b2e61251e'],1135,831,1966,1112125,11,1,0,1,2931
a82f194b21a6af2f52e36e55e2c6adcdba942c08,1,Jason Gustafson,2017-04-27 14:11:36-07:00,['bb663d04febcadd4f120e0ff5c5919ca8bf7e971'],377,2515,2892,1115017,35,0.434181818,0.744727273,0.861818182,2935
5b5efd4b5cb092813d878b080e0657f40fc1f72c,1,Rajini Sivaram,2017-04-27 23:01:01+01:00,['a82f194b21a6af2f52e36e55e2c6adcdba942c08'],0,41,41,1115058,2,0,0.96969697,0.96969697,2935
909cf9bb9778e3ba240fbcd4073a1642b79a6c23,0,Ismael Juma,2017-04-28 00:01:34+01:00,['5b5efd4b5cb092813d878b080e0657f40fc1f72c'],6,11,17,1115075,1,,,,2935
efa479736c041f7c311fbb26664d91a739ac4040,0,Ismael Juma,2017-04-28 00:06:42+01:00,['909cf9bb9778e3ba240fbcd4073a1642b79a6c23'],3,3,6,1115081,1,,,,2935
36aef1c2682169571b410a4986680361db5eec01,1,Guozhang Wang,2017-04-27 16:38:28-07:00,['efa479736c041f7c311fbb26664d91a739ac4040'],92,143,235,1115316,3,0.696969697,1,0.181818182,2935
6753af270c8a966411f5574afa57f6e5ffe43dbe,1,Guozhang Wang,2017-04-27 17:11:46-07:00,['36aef1c2682169571b410a4986680361db5eec01'],776,788,1564,1116880,9,0,0.368421053,1,2935
ee8c5e2dc391222b618b8a48dde9e407031ea85b,1,Jason Gustafson,2017-04-27 17:19:14-07:00,['6753af270c8a966411f5574afa57f6e5ffe43dbe'],129,84,213,1117093,9,0.260869565,0,0,2935
4b9de871df1b2574a7e5d1159b45ae9e4ba31955,1,Guozhang Wang,2017-04-27 17:41:21-07:00,['ee8c5e2dc391222b618b8a48dde9e407031ea85b'],0,15,15,1117108,2,0.785714286,0,0.785714286,2935
bc10f5f173383ae4593d4742a16060faa88d7fb6,1,Ismael Juma,2017-04-28 02:17:56+01:00,['4b9de871df1b2574a7e5d1159b45ae9e4ba31955'],2,3,5,1117113,1,,,,2935
a931e9954d27f4c9f12fd89afd6f0fe523cf35e8,1,Guozhang Wang,2017-04-27 23:28:50-07:00,['bc10f5f173383ae4593d4742a16060faa88d7fb6'],72,83,155,1117268,7,0.857142857,1,0,2935
f0152a7fdac2ae4dcac65d5ed24fa201f3d30120,1,Jason Gustafson,2017-04-27 23:40:33-07:00,['a931e9954d27f4c9f12fd89afd6f0fe523cf35e8'],2,46,48,1117316,2,0.1,1,0.9,2935
ca6ae811662fd291421c5e064dda067517fc624e,0,Ismael Juma,2017-04-28 11:05:59+01:00,['f0152a7fdac2ae4dcac65d5ed24fa201f3d30120'],6,5,11,1117327,1,,1,,2935
6185bc0276c03075022c30d3c36f7f5c09ef19c6,1,Jason Gustafson,2017-04-28 19:18:27-07:00,['ca6ae811662fd291421c5e064dda067517fc624e'],130,1167,1297,1118624,39,0.551020408,0.983673469,0.92244898,2941
0104b657a154fb15e716d872a0e6084f9da650bf,1,Jun Rao,2017-05-01 09:13:31-07:00,['6185bc0276c03075022c30d3c36f7f5c09ef19c6'],484,1879,2363,1120987,82,0.600652884,0.785636561,0.807399347,2943
c96656efb3718f8b2badc30e56c7f179c0658de8,0,Jason Gustafson,2017-05-01 11:17:30-07:00,['0104b657a154fb15e716d872a0e6084f9da650bf'],0,14,14,1121001,2,0.666666667,0.666666667,1,2943
4aed28d1897c6c5293f372cb4fc44ab363dfc365,1,Ismael Juma,2017-05-02 00:20:22+01:00,['c96656efb3718f8b2badc30e56c7f179c0658de8'],122,3681,3803,1124804,38,0.556686047,0.771802326,0.893168605,2968
1f2451d4e7e3766540d3650d177e304fcddf49b8,1,Guozhang Wang,2017-05-01 16:47:08-07:00,['4aed28d1897c6c5293f372cb4fc44ab363dfc365'],113,64,177,1124981,4,0.822222222,0.622222222,0.266666667,2968
67f1f4d270c279480cea5e6120ca157637910cba,1,Ismael Juma,2017-05-02 01:10:40+01:00,['1f2451d4e7e3766540d3650d177e304fcddf49b8'],462,443,905,1125886,13,0.7,1,1,2969
324b475eca48502fb16c8efd0de99756f68437bf,0,Guozhang Wang,2017-05-01 17:15:32-07:00,['67f1f4d270c279480cea5e6120ca157637910cba'],148,149,297,1126183,9,1,0,0,2969
94a35fd93684ea5713777c6b4e1631642de5f377,0,Guozhang Wang,2017-05-01 17:16:42-07:00,['324b475eca48502fb16c8efd0de99756f68437bf'],1,1,2,1126185,1,,,,2969
64ea193ceee931ee42c3fce27341980ee7c50d15,1,Ismael Juma,2017-05-02 12:28:20+01:00,['94a35fd93684ea5713777c6b4e1631642de5f377'],15,13,28,1126213,3,1,0,0,2969
46da01a4a7d12243a7f8b1d5a51f7815a9162320,1,Ismael Juma,2017-05-02 16:27:28+01:00,['64ea193ceee931ee42c3fce27341980ee7c50d15'],20,25,45,1126258,6,1,1,1,2969
b2fcf73b68d7ad3b0b4fb90371298e7163c630c6,1,Jun Rao,2017-05-02 08:41:19-07:00,['46da01a4a7d12243a7f8b1d5a51f7815a9162320'],57,42,99,1126357,2,0,1,1,2969
619fd7aeb62b2c1a68938a341ff81f728fc60090,1,Ismael Juma,2017-05-03 01:18:17+01:00,['b2fcf73b68d7ad3b0b4fb90371298e7163c630c6'],61,110,171,1126528,4,1,1,0.743589744,2969
0e7cc4aa384372d1e08d7bd444b5e23510f447d9,1,Ismael Juma,2017-05-03 01:19:35+01:00,['619fd7aeb62b2c1a68938a341ff81f728fc60090'],3,30,33,1126561,3,0.695652174,1,1,2969
f60009b14dae33168009290e549e4e9544595685,0,Ismael Juma,2017-05-03 02:26:53+01:00,['0e7cc4aa384372d1e08d7bd444b5e23510f447d9'],2,19,21,1126582,2,1,1,1,2969
4a6bbd5f1386562262193b5054b44894a196997b,0,Ismael Juma,2017-05-03 10:17:42+01:00,['f60009b14dae33168009290e549e4e9544595685'],43,40,83,1126665,11,0,0,0,2969
8d749201632618e66fbc7077d730e5fac5e157a5,0,Ismael Juma,2017-05-03 10:51:32+01:00,['4a6bbd5f1386562262193b5054b44894a196997b'],1,2,3,1126668,2,,,,2969
a7671c7f3723113e716b99471e7be3499fde1b15,0,Rajini Sivaram,2017-05-03 21:08:30+01:00,['8d749201632618e66fbc7077d730e5fac5e157a5'],56,163,219,1126887,8,0.615384615,0.923076923,0.115384615,2971
cfb2386743cc1981d7eb5c042ae8cbad70f99370,0,Guozhang Wang,2017-05-03 13:26:08-07:00,['a7671c7f3723113e716b99471e7be3499fde1b15'],19,27,46,1126933,1,0,0,1,2971
bc65c62e661c2829a30ad6b08fc9fa34303ad386,1,Guozhang Wang,2017-05-03 13:43:20-07:00,['cfb2386743cc1981d7eb5c042ae8cbad70f99370'],12,16,28,1126961,1,,,,2971
a3952aee49c5eb11cd38c1bc2fb95e9a285ff158,0,Guozhang Wang,2017-05-03 14:19:25-07:00,['bc65c62e661c2829a30ad6b08fc9fa34303ad386'],1,1,2,1126963,1,,,,2971
ec9e4eafa406fec897713310bafdedf6bbb3c0c5,1,Guozhang Wang,2017-05-03 16:15:54-07:00,['a3952aee49c5eb11cd38c1bc2fb95e9a285ff158'],734,3793,4527,1131490,26,0.786447639,0.976386037,0.313141684,2971
24e6423424bf0e41dc05c4a67226e92011e34968,1,Guozhang Wang,2017-05-04 00:20:16-07:00,['ec9e4eafa406fec897713310bafdedf6bbb3c0c5'],11,18,29,1131519,1,0,1,1,2971
ed59f742b0b2c7920444d56c44d0bc79dbc8a2ad,1,Guozhang Wang,2017-05-04 11:14:28-07:00,['24e6423424bf0e41dc05c4a67226e92011e34968'],22,183,205,1131724,13,0.205607477,0.953271028,0.971962617,2971
a6728f6ee7a87da2859baca95b50e00dd6368431,1,Guozhang Wang,2017-05-04 11:46:06-07:00,['ed59f742b0b2c7920444d56c44d0bc79dbc8a2ad'],1,23,24,1131748,2,0,0.894736842,1,2971
41fead3acf6b70f829eb61688d31b0914adedadc,0,Guozhang Wang,2017-05-04 12:32:22-07:00,['a6728f6ee7a87da2859baca95b50e00dd6368431'],11,16,27,1131775,4,,,,2971
1816e29981b0e9df67d416c8cfccc4f2ee1241fa,0,Ismael Juma,2017-05-05 04:51:51+01:00,['41fead3acf6b70f829eb61688d31b0914adedadc'],20,7,27,1131802,3,0,0,0,2971
8c872762f7ef47a4a2d2c7d49993cedacd50d8b4,1,Ismael Juma,2017-05-05 04:58:16+01:00,['1816e29981b0e9df67d416c8cfccc4f2ee1241fa'],11,4,15,1131817,2,,,,2971
124ddf5779b845cb220f622d3b4233e586db4888,1,Ismael Juma,2017-05-05 05:08:17+01:00,['8c872762f7ef47a4a2d2c7d49993cedacd50d8b4'],10,25,35,1131852,1,,,,2971
2448343edd0ea2e1f1a4cdc325d361913e48ff14,0,Ismael Juma,2017-05-05 05:11:47+01:00,['124ddf5779b845cb220f622d3b4233e586db4888'],2,2,4,1131856,1,,,,2971
95b48b157aca44beec4335e62a59f37097fe7499,0,Guozhang Wang,2017-05-04 22:12:28-07:00,['2448343edd0ea2e1f1a4cdc325d361913e48ff14'],1,18,19,1131875,2,0.6,0.6,1,2971
05ea454dfb1c68e9026b74fe443279e3a4bc5182,0,Ismael Juma,2017-05-05 08:46:19+01:00,['95b48b157aca44beec4335e62a59f37097fe7499'],2,21,23,1131898,2,1,1,1,2971
715eae6da92d5d1db7ac65e3c8ff753e15b5c0ca,0,Ismael Juma,2017-05-05 08:51:02+01:00,['05ea454dfb1c68e9026b74fe443279e3a4bc5182'],4,21,25,1131923,3,1,1,1,2971
29994dd10de5c58166e7aa248beab78cab3c9b86,0,Guozhang Wang,2017-05-05 16:53:32-07:00,['715eae6da92d5d1db7ac65e3c8ff753e15b5c0ca'],0,17,17,1131940,1,,,,2972
e71dce89c0da50f3eccc47d0fc050c92d5a99b88,1,Jason Gustafson,2017-05-06 11:49:35-07:00,['29994dd10de5c58166e7aa248beab78cab3c9b86'],1488,4099,5587,1137527,69,0.340998317,1,0.758272574,2979
e472ee7b613dbcab2ba1f5b6b384fa713f3906d0,1,Guozhang Wang,2017-05-07 22:15:40-07:00,['e71dce89c0da50f3eccc47d0fc050c92d5a99b88'],5,32,37,1137564,2,0.052631579,1,1,2979
257ad524d305bd052feb8bf81d6736f74a19983f,1,Guozhang Wang,2017-05-08 09:40:57-07:00,['e472ee7b613dbcab2ba1f5b6b384fa713f3906d0'],3,7,10,1137574,1,,,,2979
2554a8dd4dd07b0ac844839b51533bd1e67eed85,1,Jason Gustafson,2017-05-08 09:42:44-07:00,['257ad524d305bd052feb8bf81d6736f74a19983f'],12,50,62,1137636,3,0.761904762,0,0.428571429,2979
3bcadbfb474f6caccc939fb3775a6f969d136af7,0,Jason Gustafson,2017-05-08 10:00:04-07:00,['2554a8dd4dd07b0ac844839b51533bd1e67eed85'],86,4,90,1137726,3,0.709677419,0,0,2979
59b918ec2be5ec69fd5b62613e7665510f5217c0,0,Jason Gustafson,2017-05-08 10:29:31-07:00,['3bcadbfb474f6caccc939fb3775a6f969d136af7'],83,1,84,1137810,4,0,0,0.56,2979
78ace3725151dc056e83a8ec389141fc8809d4c0,1,Ismael Juma,2017-05-09 02:10:31+01:00,['59b918ec2be5ec69fd5b62613e7665510f5217c0'],6,41,47,1137857,3,0,1,0.666666667,2979
5b36adde4f158d9d3b47bb98123a0bcca8028288,1,Guozhang Wang,2017-05-09 09:23:35-07:00,['78ace3725151dc056e83a8ec389141fc8809d4c0'],4,4,8,1137865,1,,,,2979
c69842336d87cc321a58171c517c46cdddfe1a64,1,Guozhang Wang,2017-05-09 10:15:40-07:00,['5b36adde4f158d9d3b47bb98123a0bcca8028288'],40,592,632,1138497,2,0.734146341,1,0.992682927,2979
8ace736f7121161518953b4ce2a03f36a8306e18,1,Jason Gustafson,2017-05-09 14:02:30-07:00,['c69842336d87cc321a58171c517c46cdddfe1a64'],1,1,2,1138499,1,,,,2979
b982eefd37595b30600b7a979915db5da22271fe,1,Guozhang Wang,2017-05-09 14:31:50-07:00,['8ace736f7121161518953b4ce2a03f36a8306e18'],26,72,98,1138597,2,1,1,1,2979
7371bf7f65d1245b084f17e534b5728d5929e207,1,Guozhang Wang,2017-05-09 14:35:57-07:00,['b982eefd37595b30600b7a979915db5da22271fe'],16,33,49,1138646,2,1,1,0,2979
0eedd6d806ffc2f8e1e2a704d831bc5ac865ce3e,0,Gwen Shapira,2017-05-10 13:09:25-07:00,['7371bf7f65d1245b084f17e534b5728d5929e207'],0,475,475,1139121,2,0.7375,0.7375,0.5,2980
a420d20c0e3da2c9637820f7d1a344706fd835fa,1,Jun Rao,2017-05-10 13:45:32-07:00,['0eedd6d806ffc2f8e1e2a704d831bc5ac865ce3e'],27,52,79,1139200,6,0.28,0.96,0.24,2980
0bede30ada6d5719950ad35a69c586f0ba9c4f7e,1,Ismael Juma,2017-05-10 22:38:30+01:00,['a420d20c0e3da2c9637820f7d1a344706fd835fa'],472,295,767,1139967,34,0.480769231,0.673076923,1,2980
970c00eab80d82b97456e276ee0f5615cb1ccfa1,1,Jason Gustafson,2017-05-10 18:15:54-07:00,['0bede30ada6d5719950ad35a69c586f0ba9c4f7e'],1,16,17,1139984,2,1,1,1,2980
bcf447e93ec15c70156d5a17bd1c7c28b7188e43,1,Ismael Juma,2017-05-11 08:08:11+01:00,['970c00eab80d82b97456e276ee0f5615cb1ccfa1'],64,74,138,1140122,9,,,,2980
3085d4f435bba74fc9aa077e23a4da3475b4d2ec,1,Ismael Juma,2017-05-11 13:19:50+01:00,['bcf447e93ec15c70156d5a17bd1c7c28b7188e43'],11,16,27,1140149,5,0.5,0.5,1,2980
24a4e6146a83c3ce188f6ee2f56d763a58b88b8b,0,Ismael Juma,2017-05-11 13:59:48+01:00,['3085d4f435bba74fc9aa077e23a4da3475b4d2ec'],2,2,4,1140153,1,,,,2980
27107ee34d1df89035eb9b9b4e11036fca6cf723,1,Rajini Sivaram,2017-05-11 16:17:34-04:00,['24a4e6146a83c3ce188f6ee2f56d763a58b88b8b'],3,11,14,1140167,2,1,1,1,2980
b6effcbba50eaa3abf91e24f0ae83abb53881add,1,Ewen Cheslack-Postava,2017-05-11 18:16:25-07:00,['27107ee34d1df89035eb9b9b4e11036fca6cf723'],20,283,303,1140470,5,0.619402985,0.910447761,0.932835821,2982
12aa70d55bc422226255ab18e69e4bc6f24be2d9,1,Ismael Juma,2017-05-12 02:29:16+01:00,['b6effcbba50eaa3abf91e24f0ae83abb53881add'],299,265,564,1141034,26,0.977272727,0,0,2982
911c768bcc3ba950d63536ce4e6ba2542542d573,1,Jiangjie Qin,2017-05-11 20:03:30-07:00,['12aa70d55bc422226255ab18e69e4bc6f24be2d9'],14,43,57,1141091,2,0,0,0.95,2982
d96866243990a4d739ec8fc239f0c2758bba66e8,1,Ismael Juma,2017-05-12 12:33:48+01:00,['911c768bcc3ba950d63536ce4e6ba2542542d573'],14,102,116,1141207,5,0.574468085,1,0.808510638,2982
e2fafddbbf335a96e828b00c6ace0a0921803ad3,0,Ismael Juma,2017-05-12 13:14:55+01:00,['d96866243990a4d739ec8fc239f0c2758bba66e8'],4,4,8,1141215,2,,,,2982
766dea94e477a2f84afc57c4d3091ec1688c35c5,0,Ismael Juma,2017-05-12 16:48:04+01:00,['e2fafddbbf335a96e828b00c6ace0a0921803ad3'],1,4,5,1141220,1,0,1,1,2982
4951849163b1defea91129472b5354531407deb9,1,Guozhang Wang,2017-05-12 10:36:02-07:00,['766dea94e477a2f84afc57c4d3091ec1688c35c5'],11,170,181,1141401,8,0.330645161,1,0.991935484,2982
1c2bbaa501c2d0fd4db9c2dacacc3ff7f5236d3d,1,Jason Gustafson,2017-05-12 10:36:44-07:00,['4951849163b1defea91129472b5354531407deb9'],33,84,117,1141518,6,1,1,0,2982
7baa58d797126b6fb2b1de30e72428895d2bcb40,1,Jason Gustafson,2017-05-12 12:07:22-07:00,['1c2bbaa501c2d0fd4db9c2dacacc3ff7f5236d3d'],221,840,1061,1142579,16,0.357293869,0.900634249,0.805496829,2982
794e6dbd14f040d21d3402c5eda22cfa8f5c4b3d,1,Guozhang Wang,2017-05-12 15:01:01-07:00,['7baa58d797126b6fb2b1de30e72428895d2bcb40'],1504,1430,2934,1145513,20,0,0,0,2982
da0b5b8596fa20836b8c80c473b3f37af96c9b96,1,Guozhang Wang,2017-05-12 15:27:03-07:00,['794e6dbd14f040d21d3402c5eda22cfa8f5c4b3d'],3,17,20,1145533,2,1,1,1,2982
7258a5fddf3fb77480cd414819cdbfbd96b709e5,1,Jason Gustafson,2017-05-12 16:27:11-07:00,['da0b5b8596fa20836b8c80c473b3f37af96c9b96'],91,906,997,1146530,10,0.152459016,0.686885246,0.847540984,2982
b1cd3afc13070c4c50ba963520e7266f97ac52b4,1,Guozhang Wang,2017-05-12 17:01:26-07:00,['7258a5fddf3fb77480cd414819cdbfbd96b709e5'],3,7,10,1146540,1,1,1,1,2982
238e739782222b17f33a3ac5a0374d8dac3be28f,0,Ismael Juma,2017-05-13 01:38:35+01:00,['b1cd3afc13070c4c50ba963520e7266f97ac52b4'],26,5,31,1146571,5,0,0,0,2982
f21f8f2d44f97eba4ce155ac9fcc8432f00cad24,1,Ismael Juma,2017-05-13 02:42:37+01:00,['238e739782222b17f33a3ac5a0374d8dac3be28f'],11,34,45,1146616,2,0,1,1,2982
1cb39f7570b8dad3e8b5c7643fb1cbbcf382bb31,0,Ismael Juma,2017-05-13 03:23:38+01:00,['f21f8f2d44f97eba4ce155ac9fcc8432f00cad24'],10,9,19,1146635,1,0,0,0,2982
a1c8e7d941ad9c765dac232435a297f905eeeed5,1,Jason Gustafson,2017-05-12 19:59:34-07:00,['1cb39f7570b8dad3e8b5c7643fb1cbbcf382bb31'],313,315,628,1147263,26,0,0.75,0.25,2982
9198467eb293435385edcef9028a59fa41a3828a,1,Guozhang Wang,2017-05-12 21:38:49-07:00,['a1c8e7d941ad9c765dac232435a297f905eeeed5'],228,947,1175,1148438,40,0.884444444,0.995555556,0.528888889,2982
6a5026b23bec5207105d498f784872a3d2dd1e72,1,Ismael Juma,2017-05-13 08:07:30+01:00,['9198467eb293435385edcef9028a59fa41a3828a'],7,20,27,1148465,2,0.692307692,1,1,2982
c5aeaa7d898ce4b21e3204cd805d0b2c508e24eb,1,Ismael Juma,2017-05-13 08:15:30+01:00,['6a5026b23bec5207105d498f784872a3d2dd1e72'],2,9,11,1148476,1,,,,2982
1af096039d7a2d8fd865b0eaee28c70f10e07008,0,Ismael Juma,2017-05-13 09:45:17+01:00,['c5aeaa7d898ce4b21e3204cd805d0b2c508e24eb'],13,14,27,1148503,1,1,1,1,2982
e3892c29c342629be789437c2c52b4e367af52ef,0,Ismael Juma,2017-05-14 18:33:05+01:00,['1af096039d7a2d8fd865b0eaee28c70f10e07008'],1,41,42,1148545,2,1,1,1,2983
885643ce100b3b74a2b6859bf0b85103d8c05ef8,0,Ismael Juma,2017-05-15 00:39:12+01:00,['e3892c29c342629be789437c2c52b4e367af52ef'],1,68,69,1148614,2,1,1,1,2983
bc55f85237cb46e73c6774298cf308060a4a739c,1,Ismael Juma,2017-05-15 09:10:09+01:00,['885643ce100b3b74a2b6859bf0b85103d8c05ef8'],349,230,579,1149193,29,0.671428571,0.485714286,0,2983
f56bbb6510df8c12db3ad075e2f6c78dd0092d60,1,Ismael Juma,2017-05-15 09:14:26+01:00,['bc55f85237cb46e73c6774298cf308060a4a739c'],33,104,137,1149330,4,0,0.901960784,1,2983
50eacb7b45143dbc26a341620290991428194e4d,1,Ismael Juma,2017-05-15 14:08:18+01:00,['f56bbb6510df8c12db3ad075e2f6c78dd0092d60'],14,27,41,1149371,2,0,1,1,2983
a511a47020a1a3f58c7778b5d5aba08d2b4876d6,0,Jun Rao,2017-05-15 10:50:33-07:00,['50eacb7b45143dbc26a341620290991428194e4d'],0,14,14,1149385,2,0.444444444,1,1,2983
82e84fabf87fa5b5e6b4b9fd464edafaa9c5a744,0,Jason Gustafson,2017-05-15 11:15:22-07:00,['a511a47020a1a3f58c7778b5d5aba08d2b4876d6'],1,1,2,1149387,1,,,,2983
e40e27b4eb99e8931488e86289453c5f14d5e886,1,Guozhang Wang,2017-05-15 11:18:12-07:00,['82e84fabf87fa5b5e6b4b9fd464edafaa9c5a744'],1,1,2,1149389,1,,,,2983
3e6669000f082808999a7216b00c4b0f5a94e1da,1,Jason Gustafson,2017-05-15 11:26:08-07:00,['e40e27b4eb99e8931488e86289453c5f14d5e886'],213,221,434,1149823,29,0.25,0.75,0.75,2983
c26545ea5701e02fc2667c81c719630ba14f500b,1,Guozhang Wang,2017-05-15 11:57:52-07:00,['3e6669000f082808999a7216b00c4b0f5a94e1da'],3,3,6,1149829,1,,,,2983
0186794104b7106fe426024d65730fec79ad999a,0,Jason Gustafson,2017-05-15 12:58:50-07:00,['c26545ea5701e02fc2667c81c719630ba14f500b'],21,6,27,1149856,5,0.285714286,0,0.285714286,2983
46aa88b9cf82971a0890f4f83efa9639f84c677b,1,Ismael Juma,2017-05-15 22:35:17+01:00,['0186794104b7106fe426024d65730fec79ad999a'],130,221,351,1150207,24,0,0.895522388,0.925373134,2983
4c75f31a5f80e6a717d040b0534c79f5ed8d9346,1,Rajini Sivaram,2017-05-15 18:13:20-04:00,['46aa88b9cf82971a0890f4f83efa9639f84c677b'],57,156,213,1150420,14,0,0,0.172413793,2984
7bb551b4a1737f1819e11e08248b1f2277a0680e,1,Jun Rao,2017-05-15 15:23:26-07:00,['4c75f31a5f80e6a717d040b0534c79f5ed8d9346'],8,141,149,1150569,6,0.019047619,1,1,2984
dd9f43140d4a898576d86f6d5b7be1a021de1040,1,Jun Rao,2017-05-15 16:08:06-07:00,['7bb551b4a1737f1819e11e08248b1f2277a0680e'],80,80,160,1150729,11,0,0,0,2984
cacbba6519a150ed25780889e8fa9b03c27832ee,1,Jason Gustafson,2017-05-15 22:56:20-07:00,['dd9f43140d4a898576d86f6d5b7be1a021de1040'],6,6,12,1150741,1,,,,2984
0e2c90bad934b276610fdcf027252553208099ac,0,Guozhang Wang,2017-05-15 23:34:31-07:00,['cacbba6519a150ed25780889e8fa9b03c27832ee'],1,1,2,1150743,1,,,,2984
0a1689a749392d8de9dfbdc200ad9edce75024a1,0,Ismael Juma,2017-05-16 10:46:26+01:00,['0e2c90bad934b276610fdcf027252553208099ac'],1,1,2,1150745,1,,,,2984
a281fe17fe1dda9a41890648299b74fa2449552a,0,Ismael Juma,2017-05-16 11:56:02+01:00,['0a1689a749392d8de9dfbdc200ad9edce75024a1'],3,3,6,1150751,1,,,,2984
d66e7af6526f208900a5d6cb588cf47058800804,1,Jason Gustafson,2017-05-16 09:57:15-07:00,['a281fe17fe1dda9a41890648299b74fa2449552a'],182,752,934,1151685,22,0.484764543,0.736842105,1,2987
4e3092d27648b9db18a496d16cd44f600429dcfc,1,Jason Gustafson,2017-05-16 13:22:15-07:00,['d66e7af6526f208900a5d6cb588cf47058800804'],331,350,681,1152366,9,1,1,0.76,2987
73703a15c5006ddca166a458dcde72e17c91de4a,1,Guozhang Wang,2017-05-16 13:59:19-07:00,['4e3092d27648b9db18a496d16cd44f600429dcfc'],3,15,18,1152384,2,1,1,1,2987
d1d71aa29afd4aa959864225d2fec50c71513481,1,Guozhang Wang,2017-05-16 14:24:31-07:00,['73703a15c5006ddca166a458dcde72e17c91de4a'],31,120,151,1152535,1,0,0,0.650793651,2987
670193f22d9e05a130024c1bcc7408ac2f736fba,1,Jun Rao,2017-05-16 16:36:25-07:00,['d1d71aa29afd4aa959864225d2fec50c71513481'],20,56,76,1152611,2,,,,2987
ebc7f7caaeb47c9588d79a2f3ed496daa0bd39e5,1,Guozhang Wang,2017-05-16 17:23:11-07:00,['670193f22d9e05a130024c1bcc7408ac2f736fba'],746,1812,2558,1155169,25,0.193975904,0.830120482,0.930120482,2987
1cea4d8f5a51cc5795ddd3af2ea015b9e14d937d,1,Jason Gustafson,2017-05-16 23:05:35-07:00,['ebc7f7caaeb47c9588d79a2f3ed496daa0bd39e5'],2,1350,1352,1156521,8,0.540572792,0.761336516,0.868735084,2991
62d5aac5dda5ad7108aeb41ac3006221e2dab74b,0,Ismael Juma,2017-05-17 12:36:38+01:00,['1cea4d8f5a51cc5795ddd3af2ea015b9e14d937d'],1,1,2,1156523,1,,,,2991
c36b5b7f6ef5767c9455cca093ce05bf2a54d5db,1,Ismael Juma,2017-05-17 12:41:28+01:00,['62d5aac5dda5ad7108aeb41ac3006221e2dab74b'],5,16,21,1156544,5,1,1,1,2991
8c7e6631308ae986bd60df0b0761f68c777fadff,1,Rajini Sivaram,2017-05-17 09:41:19-04:00,['c36b5b7f6ef5767c9455cca093ce05bf2a54d5db'],45,33,78,1156622,1,0,0,0,2991
6910baf548ebad4c1530432e51be40793b4a4f10,1,Guozhang Wang,2017-05-17 11:15:31-07:00,['8c7e6631308ae986bd60df0b0761f68c777fadff'],383,262,645,1157267,10,0.185714286,0,0.142857143,2994
2181ae768719a9ae3a929ba875faa89c67edf643,1,Jason Gustafson,2017-05-17 14:24:40-07:00,['6910baf548ebad4c1530432e51be40793b4a4f10'],29,874,903,1158170,2,0.516071429,0.823214286,0.969642857,2995
b3a33ce4b81a20ae5635cf28490fd2e1f9d86141,1,Jason Gustafson,2017-05-17 16:20:33-07:00,['2181ae768719a9ae3a929ba875faa89c67edf643'],36,806,842,1159012,10,0.341240876,0.812043796,0.976277372,2997
c64cfd2e2bffd0a8fcfa515d3bbbe76416a89ee7,1,Guozhang Wang,2017-05-17 18:05:12-07:00,['b3a33ce4b81a20ae5635cf28490fd2e1f9d86141'],74,157,231,1159243,13,0.409090909,0.409090909,0.909090909,2997
24915206260c33cd7118db5359f3927d3be1ff60,1,Jun Rao,2017-05-17 18:54:46-07:00,['c64cfd2e2bffd0a8fcfa515d3bbbe76416a89ee7'],86,100,186,1159429,6,0.555555556,1,1,2997
9815e18fefa27d8d901356ec1d994a41b4db4622,1,Ismael Juma,2017-05-18 03:20:30+01:00,['24915206260c33cd7118db5359f3927d3be1ff60'],32,3472,3504,1162933,45,0.588513914,0.776791001,0.969212552,3025
e1abf17708918b82d3974ea028a4d74e3892fa0f,1,Jason Gustafson,2017-05-17 20:15:17-07:00,['9815e18fefa27d8d901356ec1d994a41b4db4622'],7,1685,1692,1164625,7,0.435871743,0.654308617,0.794589178,3027
972b7545363ae85a55f94cf7ea83614be8840b75,1,Ismael Juma,2017-05-18 06:51:02+01:00,['e1abf17708918b82d3974ea028a4d74e3892fa0f'],295,2271,2566,1167191,52,0.464390244,0.777560976,0.952195122,3042
9fa0d52cac24c69dbc907208ccb3e603cab3503b,1,Guozhang Wang,2017-05-17 23:15:23-07:00,['972b7545363ae85a55f94cf7ea83614be8840b75'],22,10,32,1167223,1,1,1,1,3042
14a3d69d9463b2aa26776329610f8fc5eddd0202,1,Ismael Juma,2017-05-18 11:27:56+01:00,['9fa0d52cac24c69dbc907208ccb3e603cab3503b'],17,3,20,1167243,1,0,0,0,3042
816578b5c13d36d73af02d1c11787f789a69be3f,0,Ismael Juma,2017-05-18 11:28:53+01:00,['14a3d69d9463b2aa26776329610f8fc5eddd0202'],16,11,27,1167270,1,1,1,0,3042
5aaaba7ffe51a3216262811f24e6ccf10488b5e1,0,Ismael Juma,2017-05-18 11:35:51+01:00,['816578b5c13d36d73af02d1c11787f789a69be3f'],37,72,109,1167379,2,1,1,1,3042
45f2261763eac5caaebf860daab32ef5337c9293,1,Ewen Cheslack-Postava,2017-05-18 10:39:15-07:00,['5aaaba7ffe51a3216262811f24e6ccf10488b5e1'],404,1937,2341,1169720,41,0.386666667,0.863589744,0.804102564,3050
d662b09c9f32d7d4dcfc18522a4d2789b43d319c,0,Jason Gustafson,2017-05-18 11:17:30-07:00,['45f2261763eac5caaebf860daab32ef5337c9293'],3,9,12,1169732,3,0,1,1,3050
34e379f10779bfb17fb399fde0357d17dc34ab62,0,Jason Gustafson,2017-05-18 11:38:44-07:00,['d662b09c9f32d7d4dcfc18522a4d2789b43d319c'],5,10,15,1169747,2,0,0,0,3050
c1fdf575deed0398e1692be16cacf24308afd5d5,1,Jason Gustafson,2017-05-18 13:07:06-07:00,['34e379f10779bfb17fb399fde0357d17dc34ab62'],5,8,13,1169760,1,1,0,1,3050
65edd64ca4902c9b2bc48e952056235f016031e1,1,Rajini Sivaram,2017-05-18 16:11:14-04:00,['c1fdf575deed0398e1692be16cacf24308afd5d5'],23,105,128,1169888,6,1,1,1,3051
96959bc5620b6dc5900173a15cccfe83d20be944,1,Ismael Juma,2017-05-18 22:32:18+01:00,['65edd64ca4902c9b2bc48e952056235f016031e1'],36,51,87,1169975,1,1,1,1,3051
30736da65d6e47eb68ab7563357a063caf753964,0,Jason Gustafson,2017-05-18 15:21:15-07:00,['96959bc5620b6dc5900173a15cccfe83d20be944'],4,5,9,1169984,2,1,1,1,3051
56623efd73ec77e68cf35021d18d630b27062e82,1,Ewen Cheslack-Postava,2017-05-18 16:02:29-07:00,['30736da65d6e47eb68ab7563357a063caf753964'],123,828,951,1170935,18,0.585760518,0.86407767,0.870550162,3054
b661d3b8ab37fc63b44145ba29d129b07c1582b9,1,Ismael Juma,2017-05-19 00:14:08+01:00,['56623efd73ec77e68cf35021d18d630b27062e82'],247,231,478,1171413,12,0,0.55,0,3054
e28752357705568219315375c666f8e500db9c12,1,Guozhang Wang,2017-05-18 17:02:51-07:00,['b661d3b8ab37fc63b44145ba29d129b07c1582b9'],460,2044,2504,1173917,51,0.493303571,0.962053571,0.780133929,3063
8b2995c31a44a03883b0ad85523bdf67f694ad36,0,Ismael Juma,2017-05-19 10:20:23+01:00,['e28752357705568219315375c666f8e500db9c12'],3,3,6,1173923,3,,,,3063
abe699176babe4f065b67b2b72d20daa0a2e46a1,1,Ismael Juma,2017-05-19 14:06:40+01:00,['8b2995c31a44a03883b0ad85523bdf67f694ad36'],19,128,147,1174070,19,0,0.923076923,0.564102564,3063
61bab2d875ab5e03d0df4f62217346549a4c64c3,1,Jason Gustafson,2017-05-19 11:26:59-07:00,['abe699176babe4f065b67b2b72d20daa0a2e46a1'],2,826,828,1174898,4,0.779661017,0.802259887,0.968926554,3065
338857e1c2c2bb0c6011fcab477818102b95cb56,1,Guozhang Wang,2017-05-19 16:29:25-07:00,['61bab2d875ab5e03d0df4f62217346549a4c64c3'],3,3,6,1174904,1,,,,3065
8b04d8ba071fbcafc72a17d4cbfe6f00613e59b3,1,Jason Gustafson,2017-05-19 18:51:42-07:00,['338857e1c2c2bb0c6011fcab477818102b95cb56'],34,140,174,1175078,5,0.328767123,0.95890411,0.630136986,3065
1c7fdd2843482beab4039fbb487a8d7d53800292,0,Jiangjie Qin,2017-05-21 14:34:19-07:00,['8b04d8ba071fbcafc72a17d4cbfe6f00613e59b3'],0,5,5,1175083,1,,,,3065
7fad45557e4cb7b345f34cec32f910b437c59bc2,1,Jiangjie Qin,2017-05-21 17:31:31-07:00,['1c7fdd2843482beab4039fbb487a8d7d53800292'],60,701,761,1175844,14,0.366742597,0.858769932,0.760820046,3066
d190d89dbc3df90e00f5e3c55507f67c5818504e,0,Ewen Cheslack-Postava,2017-05-21 18:04:32-07:00,['7fad45557e4cb7b345f34cec32f910b437c59bc2'],8,8,16,1175860,1,,,,3066
dc10b0ea014974b450f2abcd4a58e09d5b988e9e,0,Ewen Cheslack-Postava,2017-05-21 18:23:12-07:00,['d190d89dbc3df90e00f5e3c55507f67c5818504e'],8,18,26,1175886,3,1,1,0,3066
495836a4a27c2219f72a5f3776ba8e5216493b41,1,Guozhang Wang,2017-05-21 22:16:18-07:00,['dc10b0ea014974b450f2abcd4a58e09d5b988e9e'],32,86,118,1176004,8,1,0,1,3066
d3f1407f7bc95b823516e5a1bdaa23c717b6354e,0,Rajini Sivaram,2017-05-22 11:00:30+01:00,['495836a4a27c2219f72a5f3776ba8e5216493b41'],0,1,1,1176005,1,1,1,1,3066
ceb10c53302bd4824737e03ab86ca19e2aa64c7a,1,Rajini Sivaram,2017-05-22 13:37:29+01:00,['d3f1407f7bc95b823516e5a1bdaa23c717b6354e'],3,3,6,1176011,1,,,,3066
c2ced5fb51f2a4ec94d158e18836afb7284d26ce,0,Rajini Sivaram,2017-05-22 16:08:06+01:00,['ceb10c53302bd4824737e03ab86ca19e2aa64c7a'],3,7,10,1176021,3,,,,3066
65861a712ddf67eb071a00218730926fdeef7084,1,Jason Gustafson,2017-05-22 10:59:38-07:00,['c2ced5fb51f2a4ec94d158e18836afb7284d26ce'],278,307,585,1176606,8,0,0,0,3066
fcdbb71953fc4c92559a9c7adb4cb8ad4a74acd6,1,Jason Gustafson,2017-05-22 15:41:26-07:00,['65861a712ddf67eb071a00218730926fdeef7084'],17,60,77,1176683,2,0,1,1,3066
cca9ad42434265e388ec0100e0080250120e2cf9,0,Ewen Cheslack-Postava,2017-05-22 17:46:23-07:00,['fcdbb71953fc4c92559a9c7adb4cb8ad4a74acd6'],1,5,6,1176689,1,,,,3066
e3e2f1d22d17a20ccccf67218c600e7e1647e1ca,1,Jason Gustafson,2017-05-22 20:00:07-07:00,['cca9ad42434265e388ec0100e0080250120e2cf9'],19,72,91,1176780,4,0.195652174,0.717391304,0.608695652,3066
d1853f791147d66303c2700a8e58af762518188c,1,Jason Gustafson,2017-05-23 09:45:31-07:00,['e3e2f1d22d17a20ccccf67218c600e7e1647e1ca'],47,310,357,1177137,4,0.224489796,0.831632653,0.897959184,3066
5a6676bfca9f56c467ff46aefffc6f344ff4bf65,0,Guozhang Wang,2017-05-23 09:50:45-07:00,['d1853f791147d66303c2700a8e58af762518188c'],102,0,102,1177239,1,0.757575758,0,0,3066
70ec4b1d927cad7373eda2c54ef44bfc4275832f,1,Jason Gustafson,2017-05-23 09:53:18-07:00,['5a6676bfca9f56c467ff46aefffc6f344ff4bf65'],279,306,585,1177824,11,0.789473684,1,0.315789474,3066
49587750570a2aaf332eb73f5aad373196f984ce,1,Guozhang Wang,2017-05-23 11:53:13-07:00,['70ec4b1d927cad7373eda2c54ef44bfc4275832f'],172,163,335,1178159,12,1,0,0,3066
1bf64833168e81015e1f30a30c64eb6849c15422,1,Guozhang Wang,2017-05-23 13:34:43-07:00,['49587750570a2aaf332eb73f5aad373196f984ce'],458,455,913,1179072,16,0,0,0,3066
beeddc25d6b443ed344658a2562a162fb03048ef,1,Jun Rao,2017-05-23 16:29:55-07:00,['1bf64833168e81015e1f30a30c64eb6849c15422'],7,16,23,1179095,1,1,1,1,3066
516d8457d8142111a91af94cab918c84990685da,1,Ismael Juma,2017-05-24 00:37:06+01:00,['beeddc25d6b443ed344658a2562a162fb03048ef'],241,549,790,1179885,12,1,1,0,3069
90dc2d16fbed59fc65e6e190380c8b9c43b6d95a,0,Ewen Cheslack-Postava,2017-05-23 22:07:17-07:00,['516d8457d8142111a91af94cab918c84990685da'],1,9,10,1179895,1,,,,3069
4d89db968257c0c3273ece7e5546cb95ddcbeb46,1,Guozhang Wang,2017-05-23 23:08:57-07:00,['90dc2d16fbed59fc65e6e190380c8b9c43b6d95a'],29,36,65,1179960,6,1,1,1,3069
88200938f0c3ace5ec0bdb65a315ebd9b6adb4d0,1,Jason Gustafson,2017-05-24 09:14:10-07:00,['4d89db968257c0c3273ece7e5546cb95ddcbeb46'],3,3,6,1179966,1,,,,3069
38f6cae9e879baa35c5dbc5829bf09ecd59930c2,1,Jason Gustafson,2017-05-24 15:26:46-07:00,['88200938f0c3ace5ec0bdb65a315ebd9b6adb4d0'],833,1280,2113,1182079,42,0.692307692,0.96474359,1,3069
c5d44af77473abb36cb9bf7ca3dead36490b8320,0,Guozhang Wang,2017-05-24 19:00:37-07:00,['38f6cae9e879baa35c5dbc5829bf09ecd59930c2'],1,38,39,1182118,1,1,1,0,3069
fdcee8b8b3c027cdc1b13031fa19fcfc7de5609f,1,Jason Gustafson,2017-05-24 21:00:44-07:00,['c5d44af77473abb36cb9bf7ca3dead36490b8320'],117,218,335,1182453,8,0.298850575,1,0.988505747,3069
cea319a4ad9c55d3d3263cf7a4224c25772d0e11,1,Ismael Juma,2017-05-25 08:21:01+01:00,['fdcee8b8b3c027cdc1b13031fa19fcfc7de5609f'],134,285,419,1182872,24,0.72,0.946666667,1,3070
a10990f44b1a4f8345eae7ebfc9c571bfd0447c3,0,Ismael Juma,2017-05-25 11:21:00+01:00,['cea319a4ad9c55d3d3263cf7a4224c25772d0e11'],1,0,1,1182873,1,1,0,0,3070
64fc1a7cae348fad10e84c5ebc457c2a391573ee,1,Rajini Sivaram,2017-05-25 11:23:18+01:00,['a10990f44b1a4f8345eae7ebfc9c571bfd0447c3'],34,79,113,1182986,8,0,0,1,3070
20e2008785d46aa0500b02d8737380c50d66da3b,1,Guozhang Wang,2017-05-25 11:01:10-07:00,['64fc1a7cae348fad10e84c5ebc457c2a391573ee'],30,252,282,1183268,6,0.369318182,0.5625,0.988636364,3070
73ca0d215ead9574487744eb89f7ae677a9e13ea,1,Rajini Sivaram,2017-05-25 20:28:18+01:00,['20e2008785d46aa0500b02d8737380c50d66da3b'],92,156,248,1183516,36,0.130434783,0.956521739,0.52173913,3070
02c0c3b01730bdbff8a09d355c1b017715c7ce10,1,Jason Gustafson,2017-05-25 16:21:04-07:00,['73ca0d215ead9574487744eb89f7ae677a9e13ea'],16,20,36,1183552,2,0.5,1,1,3070
37433638271718344498d695d5da08db12c24eed,1,Ismael Juma,2017-05-26 09:46:09+01:00,['02c0c3b01730bdbff8a09d355c1b017715c7ce10'],41,178,219,1183771,11,0,1,0.967391304,3070
faa1803aa35871e5e040a22b7fcec61a2be16e24,1,Guozhang Wang,2017-05-26 09:42:02-07:00,['37433638271718344498d695d5da08db12c24eed'],69,166,235,1184006,5,0.144736842,0.907894737,0.947368421,3070
7892b4e6c7c32be09d78a8bbbeeaa823d3197aaa,1,Jason Gustafson,2017-05-26 09:52:47-07:00,['faa1803aa35871e5e040a22b7fcec61a2be16e24'],41,246,287,1184293,8,0.715909091,0.977272727,0.875,3072
68eed84f24a4771ccd805d8f39340eb7599df2ed,0,Jun Rao,2017-05-26 15:25:02-07:00,['7892b4e6c7c32be09d78a8bbbeeaa823d3197aaa'],55,4,59,1184352,6,0.625,1,0,3072
ca8915d2efc225dbc0a4c138a2a34cf34d07e347,1,Guozhang Wang,2017-05-26 15:31:58-07:00,['68eed84f24a4771ccd805d8f39340eb7599df2ed'],0,12,12,1184364,1,1,1,1,3072
0bc4f75eedf14af6d0b2e3e9be62a460b1049d0b,1,Guozhang Wang,2017-05-26 15:34:20-07:00,['ca8915d2efc225dbc0a4c138a2a34cf34d07e347'],187,498,685,1185049,13,0.315217391,0.72826087,0.994565217,3076
eb3aae7a058845852024fb0a551e1d2917ac121c,1,Ismael Juma,2017-05-27 10:17:57+01:00,['0bc4f75eedf14af6d0b2e3e9be62a460b1049d0b'],46,52,98,1185147,2,1,1,0,3076
b50387eb7c7be978081ecce7724f3058e679e4b8,0,Ismael Juma,2017-05-27 10:19:15+01:00,['eb3aae7a058845852024fb0a551e1d2917ac121c'],3,3,6,1185153,1,,,,3076
dfa3c8a92dddd58cab95e12c72669f250bb99683,1,Jason Gustafson,2017-05-28 09:57:59-07:00,['b50387eb7c7be978081ecce7724f3058e679e4b8'],212,490,702,1185855,22,0.436781609,0.844827586,1,3077
dc520d275adc715d56231fad771c66104e77ff3f,0,Guozhang Wang,2017-05-29 16:01:54-07:00,['dfa3c8a92dddd58cab95e12c72669f250bb99683'],1,1,2,1185857,1,,,,3077
a8794d8a5d18bb4eaafceac1ef675243af945862,1,Jason Gustafson,2017-05-29 22:52:59-07:00,['dc520d275adc715d56231fad771c66104e77ff3f'],4,99,103,1185960,4,0,0.710144928,1,3077
6f5930d631a7d3fc090cb81e5eb9cd69580f142b,1,Guozhang Wang,2017-05-30 00:12:54-07:00,['a8794d8a5d18bb4eaafceac1ef675243af945862'],2,9,11,1185971,1,,,,3077
6b03497915665bb4823073a5a34b03be709eb287,1,Ismael Juma,2017-05-30 15:44:34+01:00,['6f5930d631a7d3fc090cb81e5eb9cd69580f142b'],15,4,19,1185990,3,1,0,0,3077
b3788d8dcbeee7a20f562e878c187a75bac11ff0,1,Jason Gustafson,2017-05-30 12:53:32-07:00,['6b03497915665bb4823073a5a34b03be709eb287'],63,77,140,1186130,7,0,0.142857143,1,3077
f0745cd514a8af6ea22e1fddfef66f0e69ae8b1c,1,Guozhang Wang,2017-05-30 13:53:32-07:00,['b3788d8dcbeee7a20f562e878c187a75bac11ff0'],34,35,69,1186199,32,,,,3077
80223b14ee092e95d05b40b12631df2d6db7ef53,1,Jason Gustafson,2017-05-30 14:35:51-07:00,['f0745cd514a8af6ea22e1fddfef66f0e69ae8b1c'],87,178,265,1186464,5,0,0,0.746478873,3077
b38b74bb77e6d12e4ea74b51216bdc15e47dbbce,0,Jun Rao,2017-05-30 16:35:25-07:00,['80223b14ee092e95d05b40b12631df2d6db7ef53'],10,10,20,1186484,1,,,,3077
6021618f9dafa3478104575d307e7bcd2cb4cca9,0,Jun Rao,2017-05-30 16:59:33-07:00,['b38b74bb77e6d12e4ea74b51216bdc15e47dbbce'],199,137,336,1186820,10,0.630769231,1,0.015384615,3078
c060c482855bb9f51e19dde51911645413d85260,1,Ismael Juma,2017-05-31 02:22:07+01:00,['6021618f9dafa3478104575d307e7bcd2cb4cca9'],204,731,935,1187755,18,0.61003861,0.915057915,0.953667954,3080
3250cc767e8ef79d0160312a8b605535d3002851,1,Ismael Juma,2017-05-31 03:02:52+01:00,['c060c482855bb9f51e19dde51911645413d85260'],57,273,330,1188085,4,0.479674797,0.325203252,0.87804878,3080
d41cf1b77819ede5716b31683d0137eb60cb7bfb,1,Jason Gustafson,2017-05-30 20:32:51-07:00,['3250cc767e8ef79d0160312a8b605535d3002851'],125,259,384,1188469,12,0.431818182,0.909090909,1,3080
d082563907103ea79eed681305df7093053f52ec,1,Jason Gustafson,2017-05-30 22:41:21-07:00,['d41cf1b77819ede5716b31683d0137eb60cb7bfb'],88,123,211,1188680,2,0,1,1,3080
dd8cdb79d356b3049c21bf00613b8144dff0882c,1,Guozhang Wang,2017-05-30 23:21:12-07:00,['d082563907103ea79eed681305df7093053f52ec'],2,111,113,1188793,3,0.902439024,1,0.707317073,3081
2cc8f48ae5358087381fa5f79233789499d6b939,1,Guozhang Wang,2017-05-30 23:38:50-07:00,['dd8cdb79d356b3049c21bf00613b8144dff0882c'],73,266,339,1189132,6,0.206349206,0.531746032,1,3082
ef9551297c815a0ac3065a65a0831863090714f0,0,Jason Gustafson,2017-05-31 00:50:48-07:00,['2cc8f48ae5358087381fa5f79233789499d6b939'],41,80,121,1189253,2,1,0.647058824,1,3082
31cc8885e4cfc35d97291b5d9eece6f3793f2538,0,Ismael Juma,2017-05-31 10:22:17+01:00,['ef9551297c815a0ac3065a65a0831863090714f0'],7,6,13,1189266,1,1,0,0,3082
aebba89a2b9b5ea6a7cab2599555232ef3fe21ad,1,Ismael Juma,2017-05-31 10:27:16+01:00,['31cc8885e4cfc35d97291b5d9eece6f3793f2538'],3,25,28,1189294,2,0.8,0.8,0.8,3082
9323a753355abcb62fe8121303e5e65dbfe018ea,0,Ismael Juma,2017-05-31 16:13:30+01:00,['aebba89a2b9b5ea6a7cab2599555232ef3fe21ad'],54,44,98,1189392,4,0.875,1,0,3082
da9a171c99eb456378bdda95a563d09dfd9af4d8,1,Ismael Juma,2017-05-31 17:35:31+01:00,['9323a753355abcb62fe8121303e5e65dbfe018ea'],241,416,657,1190049,47,,,,3083
81f0c1e8f2ba2d86f061361b5ee33bb8e6f640c5,1,Jason Gustafson,2017-05-31 14:11:47-07:00,['da9a171c99eb456378bdda95a563d09dfd9af4d8'],183,504,687,1190736,13,0.553921569,1,0.745098039,3083
d9479275fdacd172a2b545007b55e787c53fe54e,1,Guozhang Wang,2017-05-31 14:53:28-07:00,['81f0c1e8f2ba2d86f061361b5ee33bb8e6f640c5'],153,167,320,1191056,2,,,,3083
dc5bf4bd453495af050ea7c0ec7a66b8d2b2e8d4,0,Guozhang Wang,2017-05-31 15:09:58-07:00,['d9479275fdacd172a2b545007b55e787c53fe54e'],185,176,361,1191417,7,1,0,0,3085
eeb8f67810e2b02ee73eeb3a784e365b7b780f47,0,Ismael Juma,2017-05-31 23:47:11+01:00,['dc5bf4bd453495af050ea7c0ec7a66b8d2b2e8d4'],1,1,2,1191419,1,,,,3085
647afeff6a2e3fd78328f6989e8d9f96bcde5121,0,Ismael Juma,2017-06-01 00:16:55+01:00,['eeb8f67810e2b02ee73eeb3a784e365b7b780f47'],20,45,65,1191484,5,0.9,1,0,3085
7311dcbc5363d59dd0a0de86518dd12a7b259ca4,1,Ismael Juma,2017-06-01 01:00:11+01:00,['647afeff6a2e3fd78328f6989e8d9f96bcde5121'],125,226,351,1191835,32,0.278481013,0.784810127,0.443037975,3085
681c6fc1fb37c9cfec00df09fdfe5bf1b11f3b4b,0,Guozhang Wang,2017-05-31 19:30:43-07:00,['7311dcbc5363d59dd0a0de86518dd12a7b259ca4'],74,35,109,1191944,53,,,,3085
6360e04e70b8f5ce562c2f24f85208aaae788363,1,Guozhang Wang,2017-05-31 19:36:08-07:00,['681c6fc1fb37c9cfec00df09fdfe5bf1b11f3b4b'],10,140,150,1192094,6,0.277777778,0.988888889,1,3085
e4a6b50deca8fabc9880c6764334bfaa830a6d5e,1,Jason Gustafson,2017-05-31 21:31:52-07:00,['6360e04e70b8f5ce562c2f24f85208aaae788363'],53,162,215,1192309,10,0.513888889,0.513888889,0,3085
049abe7efa17c9660fce7b57b4c235e24c72315c,1,Guozhang Wang,2017-05-31 22:48:43-07:00,['e4a6b50deca8fabc9880c6764334bfaa830a6d5e'],4,49,53,1192362,4,0,0,0.846153846,3085
e0150a25e8127c282f54a0395eb2b1c80ebda94a,1,Ewen Cheslack-Postava,2017-06-01 02:07:53-07:00,['049abe7efa17c9660fce7b57b4c235e24c72315c'],171,219,390,1192752,5,0,0.875,1,3085
640082776b429067613922c576a57ec716b1dbe9,1,Rajini Sivaram,2017-06-01 15:45:30+01:00,['e0150a25e8127c282f54a0395eb2b1c80ebda94a'],7,31,38,1192790,1,0.954545455,1,1,3085
a0863464279d3175f7c97ea5b247fe0826b1579e,0,Ewen Cheslack-Postava,2017-06-01 09:33:10-07:00,['640082776b429067613922c576a57ec716b1dbe9'],1,1,2,1192792,1,,,,3085
8e8b3c56572a825d3c1beb6ad77ce88571354f51,1,Jason Gustafson,2017-06-01 10:17:03-07:00,['a0863464279d3175f7c97ea5b247fe0826b1579e'],50,201,251,1193043,9,0,0.418181818,0.490909091,3085
1959835d9e148f0eb6407b36ff96b334d5e785cb,1,Jason Gustafson,2017-06-01 10:25:29-07:00,['8e8b3c56572a825d3c1beb6ad77ce88571354f51'],6,706,712,1193755,10,0.391862955,0.802997859,0.676659529,3088
39c1e6259c8ff547c3f7c5165b43c88f9f3ea158,1,Guozhang Wang,2017-06-01 13:16:42-07:00,['1959835d9e148f0eb6407b36ff96b334d5e785cb'],3,823,826,1194581,5,0.155290102,0.817406143,0.885665529,3089
b3036c5861df2c5fc8a06ca5b817d43147f5ba92,1,Ismael Juma,2017-06-01 21:21:58+01:00,['39c1e6259c8ff547c3f7c5165b43c88f9f3ea158'],3,137,140,1194721,8,0.576923077,1,1,3090
1b16acaaa181ceb214d84e70b8ddc146af9c0c5c,1,Guozhang Wang,2017-06-01 13:30:49-07:00,['b3036c5861df2c5fc8a06ca5b817d43147f5ba92'],3,76,79,1194800,2,0.020833333,1,1,3090
e4d829c47b9e143aa914cc492500d568d44836ef,1,Guozhang Wang,2017-06-01 13:31:25-07:00,['1b16acaaa181ceb214d84e70b8ddc146af9c0c5c'],1,1,2,1194802,1,,1,,3090
adb4ea74ab55860e5a775151f317e923acac2ad4,1,Guozhang Wang,2017-06-01 13:42:12-07:00,['e4d829c47b9e143aa914cc492500d568d44836ef'],0,6,6,1194808,1,,,,3090
be392f95dee921377b903cff18f70c1e7845a879,0,Ewen Cheslack-Postava,2017-06-01 13:47:27-07:00,['adb4ea74ab55860e5a775151f317e923acac2ad4'],1,3,4,1194812,1,,,,3090
6b9bc3fd26d0e565c1fe86ce46859f9c1a024987,1,Ismael Juma,2017-06-01 21:54:28+01:00,['be392f95dee921377b903cff18f70c1e7845a879'],2,6,8,1194820,1,1,1,1,3090
1e350b860acd8e3fcc6ee296e9babbdfe4bcd365,0,Guozhang Wang,2017-06-01 15:27:41-07:00,['6b9bc3fd26d0e565c1fe86ce46859f9c1a024987'],6,27,33,1194853,2,,,,3090
4c8ec795a0c7091b70bc90add329076c5525dcbc,0,Guozhang Wang,2017-06-01 18:24:54-07:00,['1e350b860acd8e3fcc6ee296e9babbdfe4bcd365'],2,6,8,1194861,1,,,,3090
0c3e466eb035859659ce41404f3b71b577467dca,1,Jason Gustafson,2017-06-01 19:08:32-07:00,['4c8ec795a0c7091b70bc90add329076c5525dcbc'],84,157,241,1195102,15,1,1,0.979591837,3090
1c882ee5fb4ef2d256c914bd69239d58d9706108,1,Jason Gustafson,2017-06-01 23:37:36-07:00,['0c3e466eb035859659ce41404f3b71b577467dca'],199,605,804,1195906,16,0.293929712,0.968051118,0.942492013,3091
673ab671e6d72f48fcc98de0b73564983c34e752,1,Jason Gustafson,2017-06-02 00:53:21-07:00,['1c882ee5fb4ef2d256c914bd69239d58d9706108'],6,139,145,1196051,2,0,0.677083333,1,3091
1188db5657e1db6944b59b1c91a75e47856f4e5c,0,Ismael Juma,2017-06-02 09:26:02+01:00,['673ab671e6d72f48fcc98de0b73564983c34e752'],41,128,169,1196220,11,1,1,0,3092
47a3066ccb216bfb65dda2746ca1b7775d8cba05,0,Ismael Juma,2017-06-02 09:45:15+01:00,['1188db5657e1db6944b59b1c91a75e47856f4e5c'],27,83,110,1196330,3,0.3,0.7,0.7,3092
5d46348619b1ca8610af305bf5e90c560b050258,0,Ismael Juma,2017-06-02 10:24:42+01:00,['47a3066ccb216bfb65dda2746ca1b7775d8cba05'],194,180,374,1196704,1,1,1,0,3092
f85c18032be5d583c2ca8f9fa1eb1b5ec55e59fa,1,Ismael Juma,2017-06-02 12:27:47+01:00,['5d46348619b1ca8610af305bf5e90c560b050258'],70,187,257,1196961,45,0.466666667,0.733333333,0.733333333,3092
af85e05b98a41cd5f8ac45a853b2ddd28463c084,0,Ewen Cheslack-Postava,2017-06-02 10:02:40-07:00,['f85c18032be5d583c2ca8f9fa1eb1b5ec55e59fa'],2,111,113,1197074,2,0.438356164,1,1,3092
d7d1196a0b542adb46d22eeb5b6d12af950b64c9,1,Guozhang Wang,2017-06-02 12:08:26-07:00,['af85e05b98a41cd5f8ac45a853b2ddd28463c084'],13,36,49,1197123,2,0.3,1,1,3092
0a8b10e27f573612e1d5d6787b2096d3a8528b94,1,Guozhang Wang,2017-06-02 12:20:57-07:00,['d7d1196a0b542adb46d22eeb5b6d12af950b64c9'],1,47,48,1197171,2,1,1,0.25,3093
b63e41ea78a58bdea78be33f90bfcb61ce5988d3,1,Guozhang Wang,2017-06-02 12:38:11-07:00,['0a8b10e27f573612e1d5d6787b2096d3a8528b94'],6,60,66,1197237,2,0.034482759,0.965517241,1,3093
4959444afc927026f48f5c7d9babed7b9f1bea50,0,Ismael Juma,2017-06-02 21:20:02+01:00,['b63e41ea78a58bdea78be33f90bfcb61ce5988d3'],20,25,45,1197282,6,1,1,1,3093
a318b1512900d29dc9ff0082f52f467999ba69b8,1,Jason Gustafson,2017-06-02 14:21:50-07:00,['4959444afc927026f48f5c7d9babed7b9f1bea50'],15,141,156,1197438,6,0.510204082,0.918367347,1,3095
0b107e5f752f4f7d1d6dc97891cb9569c3db5b3d,0,Jason Gustafson,2017-06-02 15:29:09-07:00,['a318b1512900d29dc9ff0082f52f467999ba69b8'],1,1,2,1197440,1,,,,3095
8104c0de273fb7627c4172f18a609472186860fd,0,Ismael Juma,2017-06-03 01:53:30+01:00,['0b107e5f752f4f7d1d6dc97891cb9569c3db5b3d'],60,6,66,1197506,2,0.965517241,0.034482759,0,3095
1c786c589ab6737e1660981e739582935f9e0f0d,1,Ismael Juma,2017-06-03 02:07:01+01:00,['8104c0de273fb7627c4172f18a609472186860fd'],31,46,77,1197583,4,0,0.166666667,0.333333333,3095
eb5586102e5bb4b66f2cacafbe45f9a7bad8eb10,1,Ismael Juma,2017-06-03 03:14:55+01:00,['1c786c589ab6737e1660981e739582935f9e0f0d'],110,443,553,1198136,7,0.464788732,0.929577465,0.683098592,3097
6a5a908b1cf972451ec8d5c66cf9fb4507a1355f,0,Ismael Juma,2017-06-03 06:24:06+01:00,['eb5586102e5bb4b66f2cacafbe45f9a7bad8eb10'],1,2,3,1198139,1,0,1,1,3097
f389b715707e4e53eaf6ce476a218a4a06c427ee,1,Ismael Juma,2017-06-03 06:26:16+01:00,['6a5a908b1cf972451ec8d5c66cf9fb4507a1355f'],2,44,46,1198185,4,0.068965517,1,1,3097
8711e5937fe33b87123843f9ce9825c60b784ef9,1,Ismael Juma,2017-06-03 06:36:29+01:00,['f389b715707e4e53eaf6ce476a218a4a06c427ee'],11,71,82,1198267,1,,,,3097
a598c4d26fb06acb455e14e84468306dfa6e1c8b,0,Ismael Juma,2017-06-03 10:28:57+01:00,['8711e5937fe33b87123843f9ce9825c60b784ef9'],9,68,77,1198344,5,0.425531915,0.85106383,1,3097
941e2177c0cf57eff818192258300d256971a11e,0,Ismael Juma,2017-06-03 10:38:03+01:00,['a598c4d26fb06acb455e14e84468306dfa6e1c8b'],0,9,9,1198353,1,0,0,0,3097
9b58372dcce5dc96826d4786123513a4d8c7b39f,0,Ismael Juma,2017-06-04 15:28:10+01:00,['941e2177c0cf57eff818192258300d256971a11e'],28,16,44,1198397,2,1,1,0,3097
d7ec9feaf1c2d2fc79218a798394f4665e4d72d0,0,Ismael Juma,2017-06-04 17:15:31+01:00,['9b58372dcce5dc96826d4786123513a4d8c7b39f'],9,0,9,1198406,1,1,1,1,3097
c7bc8f7d8c0101103853b5f6778edb04d1f41b76,0,Jason Gustafson,2017-06-04 10:48:34-07:00,['d7ec9feaf1c2d2fc79218a798394f4665e4d72d0'],1,50,51,1198457,4,1,1,1,3098
3557f097b81edd6518100d79b442223fadf9f81f,1,Ismael Juma,2017-06-05 00:36:26+01:00,['c7bc8f7d8c0101103853b5f6778edb04d1f41b76'],202,323,525,1198982,19,0.407407407,0.925925926,0.268518519,3098
d4a070fcfae97a5ec0681f7055385c6459727956,0,Guozhang Wang,2017-06-04 22:42:44-07:00,['3557f097b81edd6518100d79b442223fadf9f81f'],8,22,30,1199012,1,,,,3098
b62f156eb480498eba338b1746a995ed0d8ce871,0,Ismael Juma,2017-06-05 13:44:37+01:00,['d4a070fcfae97a5ec0681f7055385c6459727956'],0,4,4,1199016,1,0,0,0,3098
1c70e7ac12966bb13fecd633b5ba8223178733a4,0,Guozhang Wang,2017-06-05 11:24:29-07:00,['b62f156eb480498eba338b1746a995ed0d8ce871'],8,33,41,1199057,1,,,,3098
8e3ed7028e235b014cd14aedde6808b4ae411232,1,Guozhang Wang,2017-06-05 11:43:19-07:00,['1c70e7ac12966bb13fecd633b5ba8223178733a4'],46,105,151,1199208,3,0.564102564,0.41025641,0.717948718,3098
39eb31feaeebfb184d98cc5d94da9148c2319d81,0,Ismael Juma,2017-06-06 03:08:40+01:00,['8e3ed7028e235b014cd14aedde6808b4ae411232'],4,65,69,1199277,4,1,0.090909091,1,3099
b119d04093c2eb771fc3d9bc2d5c1390fc3dd184,1,Ismael Juma,2017-06-06 03:21:43+01:00,['39eb31feaeebfb184d98cc5d94da9148c2319d81'],23,43,66,1199343,8,0,1,0,3099
2bb48a4fa45422d0773f2f4ea5b38328d3c173ac,1,Ismael Juma,2017-06-06 03:37:37+01:00,['b119d04093c2eb771fc3d9bc2d5c1390fc3dd184'],45,200,245,1199588,7,0,1,0.888888889,3099
9934d28a34351a63738f8e9bac6b53fd699a4905,1,Ismael Juma,2017-06-06 03:43:14+01:00,['2bb48a4fa45422d0773f2f4ea5b38328d3c173ac'],16,56,72,1199660,4,0,0.545454545,0,3099
4b37918ef47f5d8c4874644f576d8e1a72e16212,0,Jiangjie Qin,2017-06-05 19:45:14-07:00,['9934d28a34351a63738f8e9bac6b53fd699a4905'],29,69,98,1199758,2,0.466666667,1,1,3099
17b2bde4be6296dfd47defce85443cbf6e23835b,1,Rajini Sivaram,2017-06-06 12:34:39+01:00,['4b37918ef47f5d8c4874644f576d8e1a72e16212'],47,252,299,1200057,8,0.862745098,1,0.980392157,3099
313f8d7ddc48943d9f2290a27751d7a0fa1d3a82,1,Ismael Juma,2017-06-06 13:31:46+01:00,['17b2bde4be6296dfd47defce85443cbf6e23835b'],191,174,365,1200422,8,1,0.642857143,0.357142857,3099
cb78ba1294d1a27b2c4d842a125486ffec593d98,1,Ismael Juma,2017-06-06 13:58:51+01:00,['313f8d7ddc48943d9f2290a27751d7a0fa1d3a82'],64,381,445,1200867,6,0.577272727,1,1,3099
3de683993dcc1f363cc2e1b177181036b96c2cee,0,Rajini Sivaram,2017-06-06 17:07:23+01:00,['cb78ba1294d1a27b2c4d842a125486ffec593d98'],0,7,7,1200874,1,,,,3099
ad8e7cf5e82386f8596025b06fab6b1cbd0b9109,0,Guozhang Wang,2017-06-06 09:37:13-07:00,['3de683993dcc1f363cc2e1b177181036b96c2cee'],1,20,21,1200895,1,,,,3099
2244c68ebc4b016e1a037026f625a2ecceb852a3,0,Guozhang Wang,2017-06-06 10:57:47-07:00,['ad8e7cf5e82386f8596025b06fab6b1cbd0b9109'],0,2,2,1200897,1,1,1,1,3099
d655d806ee4fe345ea25f8ff4a5f168c1a5f609b,0,Ewen Cheslack-Postava,2017-06-06 14:22:39-07:00,['2244c68ebc4b016e1a037026f625a2ecceb852a3'],1,107,108,1201005,2,0.047619048,1,1,3099
202cb8ea892f443e95c7a08fce5828131809a678,1,Jason Gustafson,2017-06-06 17:21:45-07:00,['d655d806ee4fe345ea25f8ff4a5f168c1a5f609b'],35,143,178,1201183,5,0,0.652777778,0.611111111,3099
b01c83ea916f9dd2a2db664d6e458b255d0242a6,0,Guozhang Wang,2017-06-06 17:52:50-07:00,['202cb8ea892f443e95c7a08fce5828131809a678'],3,0,3,1201186,1,,,,3099
bb914a0445549b41fb0b667ea2f5f15a90060133,1,Rajini Sivaram,2017-06-07 12:51:53+01:00,['b01c83ea916f9dd2a2db664d6e458b255d0242a6'],5,19,24,1201210,3,0.214285714,0,1,3099
f8d6dba345de432006a0644434823d70c0a907fc,0,Ismael Juma,2017-06-07 15:15:13+01:00,['bb914a0445549b41fb0b667ea2f5f15a90060133'],0,8,8,1201218,1,,,,3099
57b0d0fe572399048e523d54beafa3520a708cf5,1,Ismael Juma,2017-06-07 15:17:25+01:00,['f8d6dba345de432006a0644434823d70c0a907fc'],260,268,528,1201746,9,,,,3099
dcbdce31ba525771016be5be4abc4a2067e0890b,1,Ismael Juma,2017-06-07 16:36:57+01:00,['57b0d0fe572399048e523d54beafa3520a708cf5'],251,332,583,1202329,15,0.151515152,0.575757576,0.363636364,3099
5c3d7ca7113dd380d7465d5f914adfb4c7394eaa,0,Ismael Juma,2017-06-07 16:52:10+01:00,['dcbdce31ba525771016be5be4abc4a2067e0890b'],14,15,29,1202358,2,0,1,0,3099
38ae746448f799c3ff8be113f608aaa870e00c87,1,Ismael Juma,2017-06-07 18:05:25+01:00,['5c3d7ca7113dd380d7465d5f914adfb4c7394eaa'],88,216,304,1202662,8,0.662162162,0.986486486,0.959459459,3099
6aeca1012356a90d75d58c9294891619e4a7ab81,0,Ismael Juma,2017-06-07 19:32:33+01:00,['38ae746448f799c3ff8be113f608aaa870e00c87'],5,6,11,1202673,1,,,,3099
effda15f1fbe643cde1f610b9d54715c9e2078cf,1,Jason Gustafson,2017-06-07 11:50:20-07:00,['6aeca1012356a90d75d58c9294891619e4a7ab81'],24,19,43,1202716,3,1,1,0,3099
79db393ffaca25fdaac0fef69d6fb082f1628649,1,Jason Gustafson,2017-06-07 13:01:54-07:00,['effda15f1fbe643cde1f610b9d54715c9e2078cf'],91,242,333,1203049,8,0.11,1,0.97,3099
2fc91afbad2229ef2f8ef6fbeebc257ab7019746,1,Ismael Juma,2017-06-08 01:56:08+01:00,['79db393ffaca25fdaac0fef69d6fb082f1628649'],124,397,521,1203570,20,0.320930233,0.637209302,0.995348837,3099
12612e82971b8dc85941c771b7fe87ff95a07ab5,1,Ismael Juma,2017-06-08 03:26:54+01:00,['2fc91afbad2229ef2f8ef6fbeebc257ab7019746'],69,148,217,1203787,14,0.117647059,1,1,3099
d1a279dcc7aba6ad965fbdd854f1daf0ec184f46,1,Guozhang Wang,2017-06-07 20:52:54-07:00,['12612e82971b8dc85941c771b7fe87ff95a07ab5'],1,18,19,1203806,1,,,,3099
3de2d296e9fec89631b6521ed488263dca5808a9,0,Guozhang Wang,2017-06-07 21:00:13-07:00,['d1a279dcc7aba6ad965fbdd854f1daf0ec184f46'],2,8,10,1203816,1,,,,3099
f4e0deca43595f30b9c6f1a1666192416ecc8a9c,1,Guozhang Wang,2017-06-07 21:16:46-07:00,['3de2d296e9fec89631b6521ed488263dca5808a9'],29,372,401,1204217,18,0.703125,1,0.770833333,3100
1e87b09ec7018a396e9c31bde443b231ccfea73e,0,Ismael Juma,2017-06-08 16:58:46+01:00,['f4e0deca43595f30b9c6f1a1666192416ecc8a9c'],20,7,27,1204244,3,0,0,0,3100
eff79849a0cf8150bd0e4b7e18f77ecbf1f89a36,1,Jason Gustafson,2017-06-08 09:46:15-07:00,['1e87b09ec7018a396e9c31bde443b231ccfea73e'],2,10,12,1204256,2,0,1,0,3100
b4b65e9eafc45cadca093b023361bd15e77ccb21,1,Guozhang Wang,2017-06-08 11:50:29-07:00,['eff79849a0cf8150bd0e4b7e18f77ecbf1f89a36'],53,58,111,1204367,2,1,0.222222222,1,3100
21194a63edb460105acd8763e03d07ebbff1df68,0,Jason Gustafson,2017-06-08 13:10:34-07:00,['b4b65e9eafc45cadca093b023361bd15e77ccb21'],1,1,2,1204369,1,,,,3100
ba07d828c545d542cc11db60249e660d88a20fbb,1,Guozhang Wang,2017-06-08 14:08:54-07:00,['21194a63edb460105acd8763e03d07ebbff1df68'],2,813,815,1205184,7,0.095516569,0.543859649,0.869395712,3104
c57cfdf4fa56667cb2a5e4ffdb0bcd0b7ff1e134,1,Gwen Shapira,2017-06-08 15:27:30-07:00,['ba07d828c545d542cc11db60249e660d88a20fbb'],6,24,30,1205214,5,,,,3104
88aec3eb6d6f8d328e322493ebf4c3011b7335ea,0,Guozhang Wang,2017-06-08 15:32:45-07:00,['c57cfdf4fa56667cb2a5e4ffdb0bcd0b7ff1e134'],0,3,3,1205217,1,,,,3104
5d7c8cc81af6cd2f209f8e5f3df784b9272830b9,0,Jason Gustafson,2017-06-08 18:35:12-07:00,['88aec3eb6d6f8d328e322493ebf4c3011b7335ea'],36,13,49,1205266,2,0.7,0,0,3104
2af4dd8653dd6717cca1630a57b2835a2698a1bc,1,Jason Gustafson,2017-06-09 11:42:58-07:00,['5d7c8cc81af6cd2f209f8e5f3df784b9272830b9'],28,10,38,1205304,1,1,1,0,3104
8e7839f610a9278f800ba2f7378fb10abded8f28,1,Jason Gustafson,2017-06-09 15:54:23-07:00,['2af4dd8653dd6717cca1630a57b2835a2698a1bc'],1,67,68,1205372,2,0,0.979166667,1,3104
1e03b711875d45081c6f839962f9a019d3f64d8c,0,Jason Gustafson,2017-06-09 17:08:34-07:00,['8e7839f610a9278f800ba2f7378fb10abded8f28'],1,1,2,1205374,1,,,,3104
40509fd7b60018f06bcb4c55deabc2503415fcb2,0,Guozhang Wang,2017-06-10 14:54:35-07:00,['1e03b711875d45081c6f839962f9a019d3f64d8c'],0,11,11,1205385,1,1,1,1,3104
a623d8fe391f4c4439707b4522c66a3764f620d8,0,Jun Rao,2017-06-11 21:34:29-07:00,['40509fd7b60018f06bcb4c55deabc2503415fcb2'],2,2,4,1205389,1,,,,3104
46db2c5b99de05591274241c70378d845ee4c847,0,Rajini Sivaram,2017-06-12 16:49:41+01:00,['a623d8fe391f4c4439707b4522c66a3764f620d8'],9,13,22,1205411,1,0,1,1,3104
9d6f0f40ceb4859d54454e03f6abfe8b67963e83,1,Jason Gustafson,2017-06-12 12:47:46-07:00,['46db2c5b99de05591274241c70378d845ee4c847'],115,419,534,1205945,9,0.348178138,0.79757085,0.947368421,3104
7d1ef63bec459bcf05b46c1542488283db02a6e2,1,Ismael Juma,2017-06-12 22:27:58+01:00,['9d6f0f40ceb4859d54454e03f6abfe8b67963e83'],18,119,137,1206082,2,0,0.096385542,0.903614458,3104
2d154420c54f725988a7ca696febe341f625049a,1,Ismael Juma,2017-06-12 22:38:08+01:00,['7d1ef63bec459bcf05b46c1542488283db02a6e2'],6,9,15,1206097,1,0,0,1,3104
d06a0db8b8fcd8ddbdf277885204a062a642dd67,1,Ismael Juma,2017-06-12 22:43:58+01:00,['2d154420c54f725988a7ca696febe341f625049a'],2,2,4,1206101,1,,,,3104
2724053adf3466d01a70ad9020b3d639150050d6,1,Jason Gustafson,2017-06-12 14:56:28-07:00,['d06a0db8b8fcd8ddbdf277885204a062a642dd67'],84,63,147,1206248,6,0.933333333,1,0.733333333,3104
43e935a630eb0a7fa64c5a1a38bfee17f9b724dc,1,Jason Gustafson,2017-06-12 15:04:05-07:00,['2724053adf3466d01a70ad9020b3d639150050d6'],23,133,156,1206404,2,0.225,1,1,3104
0f3f2f56a2d013e6ff723155607b2f71b20db620,0,Jason Gustafson,2017-06-12 15:57:01-07:00,['43e935a630eb0a7fa64c5a1a38bfee17f9b724dc'],2,2,4,1206408,1,,,1,3104
6c92fc557682e853a0a3ed5684c13174fff45acf,1,Jason Gustafson,2017-06-12 16:29:29-07:00,['0f3f2f56a2d013e6ff723155607b2f71b20db620'],17,111,128,1206536,3,0.516129032,1,0.85483871,3104
aea53108a7d9573b8976da83235639a981c09af3,1,Jason Gustafson,2017-06-12 18:07:27-07:00,['6c92fc557682e853a0a3ed5684c13174fff45acf'],42,288,330,1206866,11,0,1,0.971751412,3104
4660bac4eb45a65767d05b03d275e3bf08a85c2a,1,Ismael Juma,2017-06-13 13:11:13+01:00,['aea53108a7d9573b8976da83235639a981c09af3'],1,39,40,1206906,2,0,1,1,3104
435e5e196b64625f017ef2c8c7ab49ce7fc271b8,0,Ismael Juma,2017-06-13 13:33:26+01:00,['4660bac4eb45a65767d05b03d275e3bf08a85c2a'],2,14,16,1206922,2,1,1,1,3104
aaca1b478fcce99860e2eb89aa468ff863458572,1,Rajini Sivaram,2017-06-13 13:47:41+01:00,['435e5e196b64625f017ef2c8c7ab49ce7fc271b8'],6,63,69,1206991,5,1,1,1,3104
136b03868a3156b1566f109eb47b3832b02c14f7,0,Rajini Sivaram,2017-06-13 15:58:22+01:00,['aaca1b478fcce99860e2eb89aa468ff863458572'],3,10,13,1207004,1,1,1,1,3104
85b7c855bdf88994712d6b6683c9ab69bfa437a9,0,Jason Gustafson,2017-06-13 10:45:14-07:00,['136b03868a3156b1566f109eb47b3832b02c14f7'],1,2,3,1207007,1,0,0,1,3104
5c9557857602a4c5a57afd06d98447d02cc325c8,0,Rajini Sivaram,2017-06-13 19:25:53+01:00,['85b7c855bdf88994712d6b6683c9ab69bfa437a9'],6,12,18,1207025,1,0,1,1,3104
4b4102884c8d317fe362523a9f5af20a27a4ee52,0,Ewen Cheslack-Postava,2017-06-13 14:40:07-07:00,['5c9557857602a4c5a57afd06d98447d02cc325c8'],2,2,4,1207029,1,,,,3104
c2daf4c623e5919872012aff57ffa25af46a97f8,1,Jason Gustafson,2017-06-13 16:14:36-07:00,['4b4102884c8d317fe362523a9f5af20a27a4ee52'],14,71,85,1207114,2,0.318181818,1,0.818181818,3104
004dde9e7abb9ebf18a7bfdf8b6f0e997ea9badb,0,Ewen Cheslack-Postava,2017-06-13 16:55:22-07:00,['c2daf4c623e5919872012aff57ffa25af46a97f8'],0,241,241,1207355,1,0.12987013,1,0.915584416,3105
d099c749591ac0e819017a9d3ae48144ddbbff0d,1,Ismael Juma,2017-06-14 01:59:24+01:00,['004dde9e7abb9ebf18a7bfdf8b6f0e997ea9badb'],2,17,19,1207374,2,1,1,1,3105
32f0f1f50aa618e8a3c52eb37006f4945fa6865a,0,Ismael Juma,2017-06-14 02:05:02+01:00,['d099c749591ac0e819017a9d3ae48144ddbbff0d'],162,4,166,1207540,5,0.741935484,0,0,3105
179d574a39fe6ab13501de23c0689356da3e19aa,0,Ismael Juma,2017-06-14 02:34:18+01:00,['32f0f1f50aa618e8a3c52eb37006f4945fa6865a'],13,63,76,1207616,1,0.142857143,1,1,3105
0082066c56676cbc6721d7ea1d0b6b3c011d7083,0,Ismael Juma,2017-06-14 04:35:54+01:00,['179d574a39fe6ab13501de23c0689356da3e19aa'],15,54,69,1207685,4,,,,3105
09b354a84606fe1862edecc9378908abb4048121,0,Ismael Juma,2017-06-14 11:50:28+01:00,['0082066c56676cbc6721d7ea1d0b6b3c011d7083'],3,24,27,1207712,2,0.055555556,1,1,3105
b20d9333be05b18dd776d3c8a92d76bde8d36794,1,Gwen Shapira,2017-06-14 08:57:49-07:00,['09b354a84606fe1862edecc9378908abb4048121'],73,681,754,1208466,43,1,1,0.833333333,3105
160933bc092b4392cac1dd9497010320c6ae4d10,1,Guozhang Wang,2017-06-14 09:18:59-07:00,['b20d9333be05b18dd776d3c8a92d76bde8d36794'],231,270,501,1208967,3,1,0,0,3105
65e36895f5cf91afcf785857ebff4c0fce8d1d9c,1,Guozhang Wang,2017-06-14 09:20:48-07:00,['160933bc092b4392cac1dd9497010320c6ae4d10'],0,2,2,1208969,1,0,0,1,3105
2572637121527f8c37bc95212e7eaf8190eb436b,1,Ismael Juma,2017-06-14 17:54:15+01:00,['65e36895f5cf91afcf785857ebff4c0fce8d1d9c'],0,46,46,1209015,2,0,0.935483871,1,3105
3c2329ad0b56fe39d9cbc8301c5902689e54fb3a,0,Ismael Juma,2017-06-14 23:09:11+01:00,['2572637121527f8c37bc95212e7eaf8190eb436b'],31,21,52,1209067,2,0.333333333,0.333333333,0,3105
b760615f3d58ed1fd4e17bb3ec647b26135cf458,0,Gwen Shapira,2017-06-14 15:24:32-07:00,['3c2329ad0b56fe39d9cbc8301c5902689e54fb3a'],27,238,265,1209332,3,1,1,1,3106
005b86ecf3bd881cb2005c177c2555eeb2a049d9,0,Jason Gustafson,2017-06-14 16:20:18-07:00,['b760615f3d58ed1fd4e17bb3ec647b26135cf458'],20,43,63,1209395,3,0,0.529411765,0.823529412,3106
bcf5da0baccc6bf9baa2a45047845dc6842cd200,0,Ewen Cheslack-Postava,2017-06-14 16:23:29-07:00,['005b86ecf3bd881cb2005c177c2555eeb2a049d9'],2,2,4,1209399,1,,,,3106
0f60617fab5fc6805f522d0b9a213a7f600fab12,1,Ismael Juma,2017-06-15 02:05:41+01:00,['bcf5da0baccc6bf9baa2a45047845dc6842cd200'],159,173,332,1209731,39,0,0.083333333,0.833333333,3106
1d556e471411b3ffa5bf65afd08d1a78ee40e710,0,Guozhang Wang,2017-06-15 11:05:12-07:00,['0f60617fab5fc6805f522d0b9a213a7f600fab12'],1,2,3,1209734,1,0,1,1,3106
90b2a2bf664e4e40d4cd1b46c72732c5edb97cf9,0,Guozhang Wang,2017-06-15 13:55:25-07:00,['1d556e471411b3ffa5bf65afd08d1a78ee40e710'],3,8,11,1209745,1,1,1,1,3106
6cc29e32169e069a75304803feac67591a57b6a5,1,Jason Gustafson,2017-06-15 14:31:20-07:00,['90b2a2bf664e4e40d4cd1b46c72732c5edb97cf9'],4,9,13,1209758,2,0.6,0.6,1,3106
54a3718a900a5286baf2193713ea8d58ca2c08f6,1,Ismael Juma,2017-06-16 01:17:54+01:00,['6cc29e32169e069a75304803feac67591a57b6a5'],115,341,456,1210214,8,0.132450331,0.993377483,0.960264901,3107
6f1d4c693307d1c5d1a178d56e403bb7084d537f,1,Ismael Juma,2017-06-16 11:43:10+01:00,['54a3718a900a5286baf2193713ea8d58ca2c08f6'],51,32,83,1210297,11,0,0,1,3107
6cd7f448aa6cc9f8bde27ab46ab1db1048194066,0,Ismael Juma,2017-06-16 12:32:33+01:00,['6f1d4c693307d1c5d1a178d56e403bb7084d537f'],2,4,6,1210303,1,0,0,1,3107
c83719f3d8799ec35cf9af95fd93c97b910df570,0,Ismael Juma,2017-06-16 14:39:11+01:00,['6cd7f448aa6cc9f8bde27ab46ab1db1048194066'],23,37,60,1210363,7,1,1,1,3107
354cbebdc1f26f745aaf614486449fbe240a88e0,0,Ismael Juma,2017-06-16 16:52:30+01:00,['c83719f3d8799ec35cf9af95fd93c97b910df570'],1,2,3,1210366,1,,,,3107
f49697a2796540452a21d4a29ab879ba04214046,1,Ismael Juma,2017-06-16 20:36:28+01:00,['354cbebdc1f26f745aaf614486449fbe240a88e0'],31,91,122,1210488,8,0.341463415,1,0.926829268,3107
518f141ed0c6ca8a91da36a427650fc329a943fd,0,Guozhang Wang,2017-06-16 13:07:18-07:00,['f49697a2796540452a21d4a29ab879ba04214046'],1,1,2,1210490,1,,,,3107
5b063252e293b7cbb0ccb21eb0e813db689a535f,0,Guozhang Wang,2017-06-16 13:09:31-07:00,['518f141ed0c6ca8a91da36a427650fc329a943fd'],9,9,18,1210508,1,,,,3107
11aa110126d641cb8f078162fd87bf519ef29766,1,Guozhang Wang,2017-06-16 16:09:27-07:00,['5b063252e293b7cbb0ccb21eb0e813db689a535f'],20,20,40,1210548,3,,,,3107
fdd12698b8c8f9d4b70d775e5844b76912977843,1,Ismael Juma,2017-06-17 02:05:34+01:00,['11aa110126d641cb8f078162fd87bf519ef29766'],184,151,335,1210883,8,1,1,0,3108
48de613a90fe91ca56628803fe9f02fdfd99813a,1,Jason Gustafson,2017-06-16 21:58:34-07:00,['fdd12698b8c8f9d4b70d775e5844b76912977843'],36,201,237,1211120,5,0.289256198,1,0.785123967,3108
b6c2bbc4dd044ca2aef09d5d7e2be6cb9e8fdd48,0,Ismael Juma,2017-06-17 08:43:48+01:00,['48de613a90fe91ca56628803fe9f02fdfd99813a'],4,0,4,1211124,1,,,,3108
3fdbba1c7218f77fc4b7b4b2d7d2a8b4b24ef1f0,0,Ismael Juma,2017-06-17 08:52:41+01:00,['b6c2bbc4dd044ca2aef09d5d7e2be6cb9e8fdd48'],2,1,3,1211127,1,,,,3108
51fc50ed0ba7aa4d0e618f9103a1531680489139,1,Ismael Juma,2017-06-17 12:48:38+01:00,['3fdbba1c7218f77fc4b7b4b2d7d2a8b4b24ef1f0'],11,104,115,1211242,4,0.506849315,0.931506849,1,3108
d68f9e2fe6cf2f76a81105ace5061eb7abb85995,1,Ismael Juma,2017-06-17 14:02:01+01:00,['51fc50ed0ba7aa4d0e618f9103a1531680489139'],317,251,568,1211810,22,1,0.441558442,0,3108
bcaee7fe19b3f2e75f6de0dfc5487deebfef446e,1,Jason Gustafson,2017-06-17 10:20:00-07:00,['d68f9e2fe6cf2f76a81105ace5061eb7abb85995'],244,663,907,1212717,15,0.189655172,0.837931034,0.95862069,3108
b836bd18f99e32ee71e30693853518fdc2061218,0,Jason Gustafson,2017-06-17 14:56:24-07:00,['bcaee7fe19b3f2e75f6de0dfc5487deebfef446e'],5,143,148,1212865,2,,,,3108
198a43d84693153c0f0177b8314117525c05047b,0,Ewen Cheslack-Postava,2017-06-19 09:22:19-07:00,['b836bd18f99e32ee71e30693853518fdc2061218'],2,35,37,1212902,4,1,1,1,3108
ea2a21dda4ee402cf06e127609456b11c5997d37,0,Guozhang Wang,2017-06-19 21:00:32-07:00,['198a43d84693153c0f0177b8314117525c05047b'],1,1,2,1212904,1,,,,3108
9790d5aba05256a203ef3763f91972f9b2f94a56,0,Guozhang Wang,2017-06-20 09:34:59-07:00,['ea2a21dda4ee402cf06e127609456b11c5997d37'],2,2,4,1212908,2,,,,3108
1d24e10aeab616eede416201336e928b9a8efa98,0,Jason Gustafson,2017-06-20 11:29:11-07:00,['9790d5aba05256a203ef3763f91972f9b2f94a56'],109,4,113,1213021,2,1,0.548387097,0.591397849,3108
cb2fdbd6c1621fd578c4c1422ead62faf7ae3f7f,1,Guozhang Wang,2017-06-20 11:31:59-07:00,['1d24e10aeab616eede416201336e928b9a8efa98'],4,2,6,1213027,3,,,,3108
ffa8100457bbde24eaba27a0fadb1bc5212bfc4e,0,Ewen Cheslack-Postava,2017-06-20 12:21:43-07:00,['cb2fdbd6c1621fd578c4c1422ead62faf7ae3f7f'],10,18,28,1213055,2,,,,3108
54205697aea5bfeb4fbcd40fc849c0c975fd6070,0,Jason Gustafson,2017-06-20 13:01:17-07:00,['ffa8100457bbde24eaba27a0fadb1bc5212bfc4e'],15,48,63,1213118,6,0,0.863636364,0.863636364,3108
491774bd52bfe34f32f935bc4fc5db22dc8ceba2,1,Jason Gustafson,2017-06-20 14:21:53-07:00,['54205697aea5bfeb4fbcd40fc849c0c975fd6070'],6,10,16,1213134,1,,,,3108
f28fc1100b5f6e79baeb6b2f2363e86e5cd12306,0,Jason Gustafson,2017-06-20 16:29:08-07:00,['491774bd52bfe34f32f935bc4fc5db22dc8ceba2'],10,41,51,1213185,3,,,,3108
cb3952a4fd14f72374165acdc3ed777347ffdaba,0,Jason Gustafson,2017-06-20 16:56:38-07:00,['f28fc1100b5f6e79baeb6b2f2363e86e5cd12306'],12,22,34,1213219,1,,,,3108
84de7f1756d34e6890c2608a699701d659fa191a,0,Guozhang Wang,2017-06-20 17:38:56-07:00,['cb3952a4fd14f72374165acdc3ed777347ffdaba'],4,1,5,1213224,1,,,,3108
de982ba3fbf99664f0aaa5aa4b72af8fd1881232,1,Ewen Cheslack-Postava,2017-06-20 17:48:32-07:00,['84de7f1756d34e6890c2608a699701d659fa191a'],8,12,20,1213244,2,,,,3108
76f6e14b07bd97d17f9275968a047d68b4658704,1,Jun Rao,2017-06-20 18:00:41-07:00,['de982ba3fbf99664f0aaa5aa4b72af8fd1881232'],11,76,87,1213331,2,0.25,1,0.21875,3108
cae5977ed0d6b63f992973800273769c970b0a0a,0,Damian Guy,2017-06-21 09:32:46+01:00,['76f6e14b07bd97d17f9275968a047d68b4658704'],0,13,13,1213344,1,,,,3108
55a90938a12d8928289a30588bbad6c959c48674,0,Damian Guy,2017-06-21 11:46:59+01:00,['cae5977ed0d6b63f992973800273769c970b0a0a'],45,438,483,1213827,6,0.380733945,0.844036697,0.279816514,3109
254add953477df65fe36144dc0714e0c9815c767,1,Jason Gustafson,2017-06-21 11:00:08-07:00,['55a90938a12d8928289a30588bbad6c959c48674'],10,118,128,1213955,6,0.15942029,0.927536232,0.710144928,3109
f848e2cd681ced74fefdd38a54a44e31e4d867fb,0,Guozhang Wang,2017-06-21 13:05:54-07:00,['254add953477df65fe36144dc0714e0c9815c767'],8,3,11,1213966,1,0,0,0,3109
e6e263174300ffab05676790f2a6c963ba24e5c9,0,Jason Gustafson,2017-06-21 14:04:19-07:00,['f848e2cd681ced74fefdd38a54a44e31e4d867fb'],4,18,22,1213988,1,,,,3109
96587f4b1ffd372d3e4f9a1fba6fc1d2f84a191d,1,Ewen Cheslack-Postava,2017-06-21 14:20:48-07:00,['e6e263174300ffab05676790f2a6c963ba24e5c9'],115,313,428,1214416,9,0.506493506,1,1,3111
bc47e9d6ca976ba3c15249500b2bb6f6355816bc,0,Jun Rao,2017-06-21 14:41:51-07:00,['96587f4b1ffd372d3e4f9a1fba6fc1d2f84a191d'],1,47,48,1214464,1,0,0.444444444,1,3111
914e42a28254ef6a4818b3fcdc2197db6fbe8e0f,1,Guozhang Wang,2017-06-21 17:16:48-07:00,['bc47e9d6ca976ba3c15249500b2bb6f6355816bc'],17,114,131,1214595,5,0.153846154,0.969230769,1,3111
4e8797f54ef9d2d7f40e3100943ae8afd5496b16,1,Damian Guy,2017-06-22 08:40:54+01:00,['914e42a28254ef6a4818b3fcdc2197db6fbe8e0f'],0,49,49,1214644,2,1,1,1,3111
7f4feda959f5a0c438487844a0754cdf75f32a46,0,Damian Guy,2017-06-22 08:53:32+01:00,['4e8797f54ef9d2d7f40e3100943ae8afd5496b16'],0,4,4,1214648,4,0,1,1,3111
cb5e1f0a40e9a9779a5dcabf555a593363728b33,0,Damian Guy,2017-06-22 12:23:58+01:00,['7f4feda959f5a0c438487844a0754cdf75f32a46'],6,67,73,1214721,4,0.30952381,0.30952381,1,3111
a4794b11b201804c39ee9f9a2f32dbdd7c2c246b,0,Damian Guy,2017-06-22 12:48:53+01:00,['cb5e1f0a40e9a9779a5dcabf555a593363728b33'],13,18,31,1214752,1,,,,3111
a6799f4e14ac68a5915bce50f37343bec45c988a,1,Ismael Juma,2017-06-22 13:42:40+01:00,['a4794b11b201804c39ee9f9a2f32dbdd7c2c246b'],134,10,144,1214896,2,,,,3111
785d8e20caf31d4165dbd9573828b74e5859b259,1,Ismael Juma,2017-06-22 14:03:39+01:00,['a6799f4e14ac68a5915bce50f37343bec45c988a'],1,1,2,1214898,1,,,,3111
adfaa1161150635b9bb0e36a573382c5b68960e2,1,Damian Guy,2017-06-22 15:00:41+01:00,['785d8e20caf31d4165dbd9573828b74e5859b259'],3,15,18,1214916,2,1,1,1,3111
1744a9b4c2a13545036f172064df01b34b0dded0,0,Damian Guy,2017-06-22 15:04:29+01:00,['adfaa1161150635b9bb0e36a573382c5b68960e2'],0,16,16,1214932,1,1,1,1,3111
fc58ac594f0eb63e0928374f67eba25bfa18eaea,1,Ismael Juma,2017-06-22 16:54:28+01:00,['1744a9b4c2a13545036f172064df01b34b0dded0'],18,103,121,1215053,4,0.013333333,0.986666667,0.76,3111
5d9563d95fb09903d13b7135e1136081feb4fc4b,0,Ismael Juma,2017-06-22 16:56:06+01:00,['fc58ac594f0eb63e0928374f67eba25bfa18eaea'],3,3,6,1215059,1,,,,3111
cd11fd787438d26324d9644c248b812d25e26b34,0,Gwen Shapira,2017-06-22 13:00:12-07:00,['5d9563d95fb09903d13b7135e1136081feb4fc4b'],2,56,58,1215117,2,1,1,1,3111
6d2fbfc911120c178d9ba2528179fb4d8475afc4,0,Jun Rao,2017-06-22 14:28:03-07:00,['cd11fd787438d26324d9644c248b812d25e26b34'],1,3,4,1215121,1,,,,3111
4baca9172dd662c2e45cd99c638a052eeca688c5,0,Ismael Juma,2017-06-22 23:00:29+01:00,['6d2fbfc911120c178d9ba2528179fb4d8475afc4'],2,2,4,1215125,1,,,,3111
b62cccd078210a5333a6dbc64881dd36f925e139,0,Ewen Cheslack-Postava,2017-06-22 16:17:27-07:00,['4baca9172dd662c2e45cd99c638a052eeca688c5'],7,11,18,1215143,2,,,,3111
ac539796478d6f39933d02f52e9c8972ac07466c,0,Ewen Cheslack-Postava,2017-06-22 16:42:55-07:00,['b62cccd078210a5333a6dbc64881dd36f925e139'],8,21,29,1215172,2,,,,3111
2420491f417012ba5215a9f72fa5e3a0c586c8e8,1,Damian Guy,2017-06-23 08:59:13+01:00,['ac539796478d6f39933d02f52e9c8972ac07466c'],13,41,54,1215226,4,0.863636364,0,0.318181818,3111
26eea1d71e57348284ea00182045c8d943336f4e,0,Damian Guy,2017-06-23 11:32:47+01:00,['2420491f417012ba5215a9f72fa5e3a0c586c8e8'],0,50,50,1215276,1,1,1,1,3111
701e318ee1046946ce6681a59223504d8c33d751,1,Damian Guy,2017-06-23 11:41:02+01:00,['26eea1d71e57348284ea00182045c8d943336f4e'],0,74,74,1215350,2,0.981132075,1,1,3111
9ada0f81695d99587b18bffe939de651065076ab,1,Damian Guy,2017-06-23 14:14:18+01:00,['701e318ee1046946ce6681a59223504d8c33d751'],9,9,18,1215368,5,,,,3111
b490368735b3bfe82acab3f2db4894a757abb966,1,Damian Guy,2017-06-23 15:56:29+01:00,['9ada0f81695d99587b18bffe939de651065076ab'],6,33,39,1215407,2,0.894736842,1,1,3111
d65844b52723c7a093d969c4b2822e3b36389b70,1,Jason Gustafson,2017-06-23 11:19:14-07:00,['b490368735b3bfe82acab3f2db4894a757abb966'],6,104,110,1215517,4,0.666666667,0.977777778,1,3112
d5e463b9de1f92b0dcc8fea4cf74a0eaca835ef7,1,Guozhang Wang,2017-06-23 18:01:41-07:00,['d65844b52723c7a093d969c4b2822e3b36389b70'],84,94,178,1215695,11,0,0.727272727,1,3112
ee5eac715d58e6b16a115692ede93ae481ae7785,1,Damian Guy,2017-06-24 07:48:10+01:00,['d5e463b9de1f92b0dcc8fea4cf74a0eaca835ef7'],0,169,169,1215864,2,0.151898734,1,0.493670886,3113
a5c47db1382c14720106ae1da20d2b332f89c22c,0,Ismael Juma,2017-06-24 08:20:55+01:00,['ee5eac715d58e6b16a115692ede93ae481ae7785'],22,35,57,1215921,3,0.818181818,0.909090909,0.818181818,3113
2265834803649d2f9fb090e86d11309f6e9789cb,1,Guozhang Wang,2017-06-25 09:34:27-07:00,['a5c47db1382c14720106ae1da20d2b332f89c22c'],217,391,608,1216529,8,0.087591241,0.233576642,0.277372263,3113
e45c767d5344c4d0a42c444840ad81a82fcc9f7f,0,Ewen Cheslack-Postava,2017-06-26 17:06:38-07:00,['2265834803649d2f9fb090e86d11309f6e9789cb'],6,9,15,1216544,2,0.5,1,0.25,3113
f1cc8008e5e77d0587921d727daff1eafb80f74c,0,Ismael Juma,2017-06-27 15:11:12+01:00,['e45c767d5344c4d0a42c444840ad81a82fcc9f7f'],21,26,47,1216591,4,,,,3113
031da889bc811200da67568c5779760dcb006238,0,Ismael Juma,2017-06-27 16:36:45+01:00,['f1cc8008e5e77d0587921d727daff1eafb80f74c'],45,68,113,1216704,3,1,1,0.894736842,3113
1d28e25748024d78dcc1a35c825ce5eef0dfd30d,0,Guozhang Wang,2017-06-27 15:29:48-07:00,['031da889bc811200da67568c5779760dcb006238'],4,1,5,1216709,1,,,,3113
a293e1dc0c0cdc6620abb3c8e099f29772e3d688,0,Ismael Juma,2017-06-28 01:47:00+01:00,['1d28e25748024d78dcc1a35c825ce5eef0dfd30d'],9,9,18,1216727,1,,,,3113
efb060c57f05d1d586bb14c016b0187c60f8e994,1,Damian Guy,2017-06-28 11:26:02+01:00,['a293e1dc0c0cdc6620abb3c8e099f29772e3d688'],142,612,754,1217481,26,0.40952381,0.995238095,0.657142857,3116
f05c70b06972db92b9d8fe3247babf0882a35e8c,0,Jason Gustafson,2017-06-28 10:22:11-07:00,['efb060c57f05d1d586bb14c016b0187c60f8e994'],1,0,1,1217482,1,,,,3116
cb0325d484b957432048dd29419f0fa59c5f132d,1,Jason Gustafson,2017-06-28 11:35:13-07:00,['f05c70b06972db92b9d8fe3247babf0882a35e8c'],93,462,555,1218037,11,0.02962963,0.881481481,0.955555556,3116
a05a00e50364d33a0206e8dffe6bce6713c9467b,0,Ismael Juma,2017-06-28 20:31:43+01:00,['cb0325d484b957432048dd29419f0fa59c5f132d'],4,14,18,1218055,4,1,1,1,3116
dc95456f1df1a6ba451944d515fcee81c29262f5,0,Rajini Sivaram,2017-06-29 08:01:12-04:00,['a05a00e50364d33a0206e8dffe6bce6713c9467b'],47,114,161,1218216,7,0.608695652,1,0.47826087,3116
27fdd46dcd303566a35d4824c571cf988912575e,0,Jason Gustafson,2017-06-29 09:51:04-07:00,['dc95456f1df1a6ba451944d515fcee81c29262f5'],1,2,3,1218219,1,1,1,1,3116
5536b1237fe954ba712cd62013e7cd91b7caee51,1,Ewen Cheslack-Postava,2017-06-29 13:28:35-07:00,['27fdd46dcd303566a35d4824c571cf988912575e'],114,566,680,1218899,6,,,,3118
a16475eb333b0205b74b817237cba187862e61e7,0,Ismael Juma,2017-06-30 06:47:32+01:00,['5536b1237fe954ba712cd62013e7cd91b7caee51'],0,1,1,1218900,1,1,1,1,3118
c4193cd1ad8eeed8383a1c2660383c455e848929,1,Ismael Juma,2017-06-30 06:48:45+01:00,['a16475eb333b0205b74b817237cba187862e61e7'],41,57,98,1218998,5,,,,3118
0dfeb31a116d26023540f6c6074127f0aab00b6d,1,Damian Guy,2017-06-30 08:56:40+01:00,['c4193cd1ad8eeed8383a1c2660383c455e848929'],82,254,336,1219334,3,0.283464567,1,1,3118
7429f49780a69d0c5eda8ef0c69a3209aecee11c,0,Damian Guy,2017-06-30 08:59:10+01:00,['0dfeb31a116d26023540f6c6074127f0aab00b6d'],12,68,80,1219414,2,,,,3118
17bdd4831c0098ea2c50e9bad1bf8ba70352854c,0,Damian Guy,2017-06-30 17:15:23+01:00,['7429f49780a69d0c5eda8ef0c69a3209aecee11c'],2,0,2,1219416,1,1,1,1,3118
6471822079e0bf378ff5bc83f4bd3b71ac0582cf,1,Jason Gustafson,2017-06-30 09:22:25-07:00,['17bdd4831c0098ea2c50e9bad1bf8ba70352854c'],46,79,125,1219541,1,,,,3118
342f34a1994caafa3cea94a2f85ffd219b8cebc5,1,Rajini Sivaram,2017-06-30 15:07:00-04:00,['6471822079e0bf378ff5bc83f4bd3b71ac0582cf'],12,7,19,1219560,2,0,0,0,3118
49ed16daf43b5f28e51fed7cc124cd308de3deca,1,Ismael Juma,2017-06-30 23:36:21+02:00,['342f34a1994caafa3cea94a2f85ffd219b8cebc5'],13,21,34,1219594,6,,,,3118
9c2de4920e6035a8fb1d3dd5c6b5a8ccb31c7aa3,0,Jun Rao,2017-06-30 15:01:53-07:00,['49ed16daf43b5f28e51fed7cc124cd308de3deca'],0,4,4,1219598,1,,,,3118
9238aeaa2171f7860fd6ae7980608505a63c12ca,1,Jason Gustafson,2017-06-30 15:38:03-07:00,['9c2de4920e6035a8fb1d3dd5c6b5a8ccb31c7aa3'],95,250,345,1219943,6,0.422222222,0.992592593,1,3118
ab8e9d1755e9527ca76e994dd59a21cc94550312,0,Ewen Cheslack-Postava,2017-07-01 02:46:55-07:00,['9238aeaa2171f7860fd6ae7980608505a63c12ca'],0,42,42,1219985,2,1,0.59375,1,3118
c9f777cc44269c2e9537eab2451481422e613383,1,Damian Guy,2017-07-03 09:34:16+01:00,['ab8e9d1755e9527ca76e994dd59a21cc94550312'],0,107,107,1220092,2,1,1,1,3119
2c6e9a9653ffd19f4c9407cd74a89a8d7deb8b3f,1,Damian Guy,2017-07-03 15:35:47+01:00,['c9f777cc44269c2e9537eab2451481422e613383'],1079,1367,2446,1222538,12,,,,3129
cbafc08a5f25df58d33093b2e6015e8c49fefdea,0,Damian Guy,2017-07-03 16:04:41+01:00,['2c6e9a9653ffd19f4c9407cd74a89a8d7deb8b3f'],2,7,9,1222547,2,,,,3129
afb91a02ae1ef8aab6a33335eec0a07490b36390,0,Rajini Sivaram,2017-07-04 10:36:42+01:00,['cbafc08a5f25df58d33093b2e6015e8c49fefdea'],3,6,9,1222556,1,1,1,1,3129
ef5867dce3894aa57a8f815aa206693e2530b576,0,Damian Guy,2017-07-04 15:05:36+01:00,['afb91a02ae1ef8aab6a33335eec0a07490b36390'],1,19,20,1222576,2,1,1,1,3129
48c2160c75e24bae61133eb932a790fdf80e7ca9,0,Rajini Sivaram,2017-07-05 22:05:27+01:00,['ef5867dce3894aa57a8f815aa206693e2530b576'],0,3,3,1222579,1,1,1,1,3129
6cae5ec6687bdb0ba12c9f8a2c54008ce4d2334f,0,Guozhang Wang,2017-07-05 14:15:43-07:00,['48c2160c75e24bae61133eb932a790fdf80e7ca9'],0,519,519,1223098,7,,,,3134
3ab0456db839d8959b2846b9a7e4cc28b4c822c7,0,Guozhang Wang,2017-07-05 15:05:05-07:00,['6cae5ec6687bdb0ba12c9f8a2c54008ce4d2334f'],23,18,41,1223139,1,1,0.5,0,3134
70e949d522eba72b22c2619c4fde372d0f1a26b3,1,Guozhang Wang,2017-07-05 20:20:51-07:00,['3ab0456db839d8959b2846b9a7e4cc28b4c822c7'],8,231,239,1223378,2,0.044198895,0.751381215,1,3134
e68a94056fa7eb5b8d69815bcfa522247568d3e9,1,Guozhang Wang,2017-07-05 22:20:24-07:00,['70e949d522eba72b22c2619c4fde372d0f1a26b3'],25,28,53,1223431,1,0,0,,3134
f53f5eaa1bce0129bac7b8ffac3a8da11d2ee574,1,Damian Guy,2017-07-06 09:46:11+01:00,['e68a94056fa7eb5b8d69815bcfa522247568d3e9'],2,2,4,1223435,1,,,,3134
9078554232f9de56849b5c35bf45b81a67a748c4,1,Damian Guy,2017-07-06 10:05:16+01:00,['f53f5eaa1bce0129bac7b8ffac3a8da11d2ee574'],251,808,1059,1224494,8,0.366242038,0.828025478,0.968152866,3135
6d203361a04380d8fb0f23c0bfcb37811eccb590,0,Damian Guy,2017-07-06 10:10:03+01:00,['9078554232f9de56849b5c35bf45b81a67a748c4'],2,2,4,1224498,1,,,,3135
0046a881d389878bbb673c2591c06fd667923964,1,Damian Guy,2017-07-06 14:29:12+01:00,['6d203361a04380d8fb0f23c0bfcb37811eccb590'],7,27,34,1224532,1,0.523809524,1,1,3135
6ea36bc6fbd7bf73dbbd0e097353f6caf89b9488,1,Damian Guy,2017-07-07 09:45:37+01:00,['0046a881d389878bbb673c2591c06fd667923964'],0,5,5,1224537,1,,,,3135
071b8f975f3f4eeb5659ffe04dbffafa0c8ab263,0,Damian Guy,2017-07-07 13:29:05+01:00,['6ea36bc6fbd7bf73dbbd0e097353f6caf89b9488'],3,4,7,1224544,1,0,1,1,3135
c574c58a16147d2d4997145bc47b0ba558d68a36,0,Ismael Juma,2017-07-07 14:41:54+01:00,['071b8f975f3f4eeb5659ffe04dbffafa0c8ab263'],10,11,21,1224565,3,,,,3135
75f1b757e19d40738cbd5e6154ea9afccab7977a,1,Damian Guy,2017-07-07 15:10:16+01:00,['c574c58a16147d2d4997145bc47b0ba558d68a36'],6,6,12,1224577,1,,,,3135
35f9fa804b0391492d7914f60e9b1ae94c223ad9,1,Guozhang Wang,2017-07-07 11:38:35-07:00,['75f1b757e19d40738cbd5e6154ea9afccab7977a'],1,1,2,1224579,1,,,,3135
bb8eff1e70491c4ce2dad07249d769b467f4068e,0,Guozhang Wang,2017-07-07 13:43:32-07:00,['35f9fa804b0391492d7914f60e9b1ae94c223ad9'],4,6,10,1224589,1,1,1,1,3135
7bfe008ae1a2bb2fa98c3a765be5022e75cd151d,1,Guozhang Wang,2017-07-09 17:35:14-07:00,['bb8eff1e70491c4ce2dad07249d769b467f4068e'],169,294,463,1225052,8,,,,3137
6a5cd67b9bf38acd4fe437bc385747aaf7bd91e7,0,Damian Guy,2017-07-10 10:16:02-07:00,['7bfe008ae1a2bb2fa98c3a765be5022e75cd151d'],3,3,6,1225058,1,,,,3137
a1f97c8dc4edd49c7a8a2ebb72734728029a85aa,1,Damian Guy,2017-07-10 11:58:51-07:00,['6a5cd67b9bf38acd4fe437bc385747aaf7bd91e7'],57,403,460,1225518,15,0.671755725,1,0.65648855,3140
990382b94cfeb7a73a93ccbfd92e80f0f62fc7b0,1,Guozhang Wang,2017-07-10 15:12:47-07:00,['a1f97c8dc4edd49c7a8a2ebb72734728029a85aa'],14,22,36,1225554,1,0,0,1,3140
2628695356de87aba7d046855fbe1f1963d3f911,1,Guozhang Wang,2017-07-10 17:59:43-07:00,['990382b94cfeb7a73a93ccbfd92e80f0f62fc7b0'],20,61,81,1225635,2,1,1,1,3140
9c6fc95f9161cc5c3347d36cb3d2616fd0255cad,0,Jason Gustafson,2017-07-11 08:50:57-07:00,['2628695356de87aba7d046855fbe1f1963d3f911'],1,1,2,1225637,1,,,,3140
44167399157b06d566401a3f6c17e9ca901a8c20,1,Damian Guy,2017-07-11 12:03:51-07:00,['9c6fc95f9161cc5c3347d36cb3d2616fd0255cad'],1,1,2,1225639,1,,,,3140
8068a3560b1896f25bdc664acd50d9c4d84f7baa,1,Damian Guy,2017-07-12 13:06:45-07:00,['44167399157b06d566401a3f6c17e9ca901a8c20'],1,1,2,1225641,1,,,,3140
ef275159432fd5fe88204783b621165ec39293d8,0,Damian Guy,2017-07-12 13:17:21-07:00,['8068a3560b1896f25bdc664acd50d9c4d84f7baa'],3,3,6,1225647,1,,,,3140
0547a082545277dc119aa96dd8b8124949703be0,1,Ismael Juma,2017-07-12 16:24:58-07:00,['ef275159432fd5fe88204783b621165ec39293d8'],2,2,4,1225651,1,,,,3140
2d2e9adb5d8d3805f082208ae9dd241f87566b27,0,Ismael Juma,2017-07-12 17:20:19-07:00,['0547a082545277dc119aa96dd8b8124949703be0'],1,23,24,1225675,2,1,1,1,3140
e391045473f258562d55bbc07faafe75ec7213ac,1,Jason Gustafson,2017-07-14 09:57:14-07:00,['2d2e9adb5d8d3805f082208ae9dd241f87566b27'],195,133,328,1226003,14,1,1,0.1875,3140
1685e7112c5d4dc723ffcfa219febaed045b6426,1,Jason Gustafson,2017-07-14 11:44:42-07:00,['e391045473f258562d55bbc07faafe75ec7213ac'],202,186,388,1226391,83,0.415158371,0.877828054,1,3140
873eeae9f7ae661d27df5351c0001b785dc40956,1,Jason Gustafson,2017-07-14 13:32:32-07:00,['1685e7112c5d4dc723ffcfa219febaed045b6426'],5,7,12,1226403,1,0.5,0.5,0,3140
d0ce0a95de8c5451d73dcc87f3f9b6c03f5f85de,1,Ismael Juma,2017-07-14 13:50:38-07:00,['873eeae9f7ae661d27df5351c0001b785dc40956'],9,76,85,1226488,2,0.9,0.9,0.6,3141
cf94b188f1678276a4a6df6b87d89f2d4d2e922c,1,Ismael Juma,2017-07-17 09:41:29+01:00,['d0ce0a95de8c5451d73dcc87f3f9b6c03f5f85de'],5,6,11,1226499,2,1,1,1,3141
6d7a81b478e1f36d7632c84d34280c22a2f717b1,0,Ewen Cheslack-Postava,2017-07-17 10:45:31-07:00,['cf94b188f1678276a4a6df6b87d89f2d4d2e922c'],0,7,7,1226506,2,1,1,1,3141
e2fe19d22a42525001c5a66f21f02f49c051ecb5,1,Jason Gustafson,2017-07-17 11:51:57-07:00,['6d7a81b478e1f36d7632c84d34280c22a2f717b1'],47,105,152,1226658,2,0.609756098,1,0.804878049,3141
28c83d9667676515607713d4ccfd3757a8afcba2,1,Ismael Juma,2017-07-17 23:58:22+01:00,['e2fe19d22a42525001c5a66f21f02f49c051ecb5'],7,86,93,1226751,5,0.5,0.5,1,3144
d663005fddcebafba439473299dc4c6ad74c966c,1,Ewen Cheslack-Postava,2017-07-17 21:24:45-07:00,['28c83d9667676515607713d4ccfd3757a8afcba2'],21,19,40,1226791,1,1,1,1,3144
454f0f1ca1eccbeba6c459ce62c8e1caa4cf9a70,0,Ismael Juma,2017-07-18 09:52:24+01:00,['d663005fddcebafba439473299dc4c6ad74c966c'],1,0,1,1226792,1,1,1,0,3144
bbc390018571602fb4fb77609093d450ab95a4c0,1,Ismael Juma,2017-07-18 16:50:29+01:00,['454f0f1ca1eccbeba6c459ce62c8e1caa4cf9a70'],46,44,90,1226882,2,,,,3144
ea8845bbd6a8b0b3b930c637461c8da2fc84c342,0,Gwen Shapira,2017-07-18 08:57:06-07:00,['bbc390018571602fb4fb77609093d450ab95a4c0'],4,12,16,1226898,3,,,,3144
fc0ea25025df8af5079e8142ba085939b3c9c073,0,Ewen Cheslack-Postava,2017-07-18 13:00:46-07:00,['ea8845bbd6a8b0b3b930c637461c8da2fc84c342'],1,1,2,1226900,1,,,,3144
3bfc073f03e02bd34c813ee424864b5ace628aae,1,Ismael Juma,2017-07-19 14:25:02+01:00,['fc0ea25025df8af5079e8142ba085939b3c9c073'],19,20,39,1226939,4,,,,3144
f87d58b796977fdaefb089d17cb30b2071cd4485,1,Jason Gustafson,2017-07-19 10:51:28-07:00,['3bfc073f03e02bd34c813ee424864b5ace628aae'],440,419,859,1227798,62,1,1,1,3144
f50af9c31df6fc6febba51d39293051efc82cec9,1,Ewen Cheslack-Postava,2017-07-19 21:39:51-07:00,['f87d58b796977fdaefb089d17cb30b2071cd4485'],29,64,93,1227891,3,1,0.604166667,0,3144
43aa14f2dc47b36b86d644c08794118e82869c74,0,Ismael Juma,2017-07-20 10:18:45+01:00,['f50af9c31df6fc6febba51d39293051efc82cec9'],2,2,4,1227895,1,,,,3144
1b8aed6dc52e5d2f7ba29e4589baf15d53ad2870,0,Ismael Juma,2017-07-20 11:30:50+01:00,['43aa14f2dc47b36b86d644c08794118e82869c74'],0,11,11,1227906,1,1,1,1,3144
0816e47bfe7e7999084a2448a39826166c8fff08,0,Ismael Juma,2017-07-20 12:31:17+01:00,['1b8aed6dc52e5d2f7ba29e4589baf15d53ad2870'],1,1,2,1227908,1,,,,3144
272956f03a54ef4f476d6f6f49c0cf74e5daf7d0,0,Ismael Juma,2017-07-20 12:48:17+01:00,['0816e47bfe7e7999084a2448a39826166c8fff08'],10,5,15,1227923,3,0,0,0,3144
84d2b6a01c0fd71ee18fdf2364d85473d78c2b2f,1,Ismael Juma,2017-07-20 14:01:11+01:00,['272956f03a54ef4f476d6f6f49c0cf74e5daf7d0'],36,29,65,1227988,4,0.666666667,0,0.333333333,3144
fe4a469fce5a47b89083781ed8a03d0d71428aeb,1,Damian Guy,2017-07-20 14:47:38+01:00,['84d2b6a01c0fd71ee18fdf2364d85473d78c2b2f'],67,374,441,1228429,6,0.051948052,1,0.493506494,3144
e0099e1f5852536918bfa27b4d1c33779e45ab6b,1,Jason Gustafson,2017-07-20 08:54:25-07:00,['fe4a469fce5a47b89083781ed8a03d0d71428aeb'],1,8,9,1228438,2,1,1,1,3144
b04bed022aec0f1f478a03383ab5184f048133b6,1,Damian Guy,2017-07-20 18:47:47+01:00,['e0099e1f5852536918bfa27b4d1c33779e45ab6b'],17,1012,1029,1229467,4,0.715242881,0.986599665,0.842546064,3146
9b7a6ee2a9eabbeca2000c2d1831bc11fcc4a41f,0,Ewen Cheslack-Postava,2017-07-20 10:49:06-07:00,['b04bed022aec0f1f478a03383ab5184f048133b6'],15,17,32,1229499,1,,,,3146
cdff011fe02cb8e14cb5bf226e47b83cbbec8f3c,1,Jason Gustafson,2017-07-20 13:05:51-07:00,['9b7a6ee2a9eabbeca2000c2d1831bc11fcc4a41f'],9,71,80,1229579,2,0.37254902,0.921568627,1,3146
5bb53e034e4f8a06550dd06377fae7b3c2137ce2,1,Jason Gustafson,2017-07-20 17:38:30-07:00,['cdff011fe02cb8e14cb5bf226e47b83cbbec8f3c'],295,327,622,1230201,5,1,1,1,3146
9ae09e80591f2deec3b89686dee5752a6be4adc7,1,Ewen Cheslack-Postava,2017-07-20 19:34:16-07:00,['5bb53e034e4f8a06550dd06377fae7b3c2137ce2'],3,5,8,1230209,2,0,1,0,3146
8a81566214a6028f58d35c04cde8ccc7edc71960,0,Ewen Cheslack-Postava,2017-07-20 19:51:09-07:00,['9ae09e80591f2deec3b89686dee5752a6be4adc7'],4,5,9,1230218,1,,,,3146
1d2d0bac9ea61de38b1afa6ab301a0a9a05f5758,1,Ewen Cheslack-Postava,2017-07-20 20:16:15-07:00,['8a81566214a6028f58d35c04cde8ccc7edc71960'],1,1,2,1230220,1,,,,3146
cd207dd3feb08052a82db90d2e5da956bad5ac33,0,Jun Rao,2017-07-20 21:49:27-07:00,['1d2d0bac9ea61de38b1afa6ab301a0a9a05f5758'],0,28,28,1230248,2,0,0.95,0.95,3146
ad6c53d89e5dac2e6d3fa9e3df9c597d0d52e485,1,Ewen Cheslack-Postava,2017-07-20 21:55:50-07:00,['cd207dd3feb08052a82db90d2e5da956bad5ac33'],2,2,4,1230252,1,,,,3146
beb0ad9bbb36a642f5fe4a01d92949ba79299edf,1,Ewen Cheslack-Postava,2017-07-20 22:06:46-07:00,['ad6c53d89e5dac2e6d3fa9e3df9c597d0d52e485'],2,7,9,1230261,1,,,,3146
1110f66fa7278212160c6e8392b6e6ab09560452,1,Damian Guy,2017-07-21 12:15:40+01:00,['beb0ad9bbb36a642f5fe4a01d92949ba79299edf'],46,234,280,1230541,8,0.759493671,1,0.632911392,3146
08b775c322d359e20506069d54f5b92a5a37ce63,0,Ismael Juma,2017-07-21 13:42:52+01:00,['1110f66fa7278212160c6e8392b6e6ab09560452'],4,4,8,1230549,1,0,0,0,3146
4a7064d1ae323903a0d1353372aabadabebb1ed6,1,Jason Gustafson,2017-07-21 08:47:54-07:00,['08b775c322d359e20506069d54f5b92a5a37ce63'],11,61,72,1230621,2,0.161290323,1,1,3146
da42977a004dc0c9d29c8c28f0f0cd2c06b889ef,0,Ewen Cheslack-Postava,2017-07-21 16:02:36-07:00,['4a7064d1ae323903a0d1353372aabadabebb1ed6'],2,73,75,1230696,2,1,1,1,3147
6c6cf014f6eb9c90453e6ac1b01b8c1851d98f06,0,Ewen Cheslack-Postava,2017-07-21 16:55:38-07:00,['da42977a004dc0c9d29c8c28f0f0cd2c06b889ef'],0,10,10,1230706,1,1,1,1,3147
300f48018cf7835e3de6a998d4e50895a2714a4e,1,Guozhang Wang,2017-07-21 19:16:14-07:00,['6c6cf014f6eb9c90453e6ac1b01b8c1851d98f06'],74,226,300,1231006,14,,,,3154
c71e7fa3a3916358f8307e8739e330814937372d,0,Ewen Cheslack-Postava,2017-07-21 19:36:43-07:00,['300f48018cf7835e3de6a998d4e50895a2714a4e'],1,1,2,1231008,1,,,,3154
7727d7a9a574ec4305bcf9f490b329f4ffcf4824,1,Ismael Juma,2017-07-22 10:35:02+01:00,['c71e7fa3a3916358f8307e8739e330814937372d'],8,7,15,1231023,1,1,0,1,3154
91b5fc737b308a4d17ca2a61dba3b039d19cdb17,0,Ismael Juma,2017-07-22 10:36:12+01:00,['7727d7a9a574ec4305bcf9f490b329f4ffcf4824'],1,1,2,1231025,1,,,,3154
fc93fb4b6116e809f2b69ddb2f7e0f12548fef51,1,Jiangjie Qin,2017-07-22 12:35:32-07:00,['91b5fc737b308a4d17ca2a61dba3b039d19cdb17'],1096,2526,3622,1234647,97,0.367013373,0.448736999,0.676077266,3159
5d798511b12c5ef7555e4234fdd99a360176e435,1,Guozhang Wang,2017-07-24 11:03:27-07:00,['fc93fb4b6116e809f2b69ddb2f7e0f12548fef51'],1772,3016,4788,1239435,19,0.543373494,0.997590361,0.86746988,3162
b887eeb7215351e7509993f8609846115962e594,0,Ivan Babrou,2017-07-24 12:06:12-07:00,['5d798511b12c5ef7555e4234fdd99a360176e435'],10,10,20,1239455,1,,,,3162
91c207c2c6b09d88cc3366d69a31d0bf0ab0bffb,1,Guozhang Wang,2017-07-25 11:34:16-07:00,['5d798511b12c5ef7555e4234fdd99a360176e435'],71,214,285,1239740,6,0,1,1,3162
f15cdbc91b240e656d9a2aeb6877e94624b21f8d,1,Jiangjie Qin,2017-07-25 20:38:30-07:00,['91c207c2c6b09d88cc3366d69a31d0bf0ab0bffb'],181,151,332,1240072,19,0,1,0,3162
47ee8e954df62b9a79099e944ec4be29afe046f6,1,Jun Rao,2017-07-26 08:19:56+02:00,['f15cdbc91b240e656d9a2aeb6877e94624b21f8d'],62,1446,1508,1241580,38,0.502932551,0.718475073,1,3172
e5e88f636fa9857105324f62cc758b1fed3602bb,1,Jun Rao,2017-07-26 08:03:10+01:00,['47ee8e954df62b9a79099e944ec4be29afe046f6'],0,615,615,1242195,2,0.758530184,0.805774278,0.895013123,3174
89faed8d30eb441fac7f1564edd40115006f5051,1,Damian Guy,2017-07-26 09:08:14+01:00,['e5e88f636fa9857105324f62cc758b1fed3602bb'],6,47,53,1242248,2,1,1,1,3174
9f3f8b4de64501902a4843064b1cf1feb21c690a,1,Damian Guy,2017-07-26 10:10:50+01:00,['89faed8d30eb441fac7f1564edd40115006f5051'],314,331,645,1242893,10,1,0,0.428571429,3174
f4d1305bfef669446d4dbdeeed4d2c4d212c6e1d,0,Ewen Cheslack-Postava,2017-07-26 09:17:44-07:00,['9f3f8b4de64501902a4843064b1cf1feb21c690a'],2,2,4,1242897,1,,,,3174
f8498ec9e27ca0f08e3791d7a19ad8c6a97e210f,0,Guozhang Wang,2017-07-26 12:58:33-07:00,['f4d1305bfef669446d4dbdeeed4d2c4d212c6e1d'],12,63,75,1242972,2,1,1,1,3174
5effe72390e0a3b7f82debcaaf069a531caaa351,0,Guozhang Wang,2017-07-26 13:01:41-07:00,['f8498ec9e27ca0f08e3791d7a19ad8c6a97e210f'],31,21,52,1243024,7,,,,3174
3620035c45736b74e69921f7c50a1c3857aec334,1,Jason Gustafson,2017-07-26 22:53:11-07:00,['5effe72390e0a3b7f82debcaaf069a531caaa351'],3,58,61,1243085,3,0.083333333,0.958333333,0.916666667,3174
8b14e11743360a711b2bb670cf503acc0e604602,1,Ismael Juma,2017-07-27 14:12:57+01:00,['3620035c45736b74e69921f7c50a1c3857aec334'],381,879,1260,1244345,24,1,1,0.266666667,3179
9d6020ec5fac21f36e2caa58256ee2158658866e,0,Damian Guy,2017-07-27 16:00:51+01:00,['8b14e11743360a711b2bb670cf503acc0e604602'],1,3,4,1244349,1,,,,3179
6bd7302645a6167299de6de4e5a19749502db25c,1,Jason Gustafson,2017-07-27 12:53:26-07:00,['9d6020ec5fac21f36e2caa58256ee2158658866e'],81,299,380,1244729,15,0.108695652,0.81884058,0.927536232,3180
4059fa5763252c6869b6b7c682d7b5f9d4dc3a87,0,Damian Guy,2017-07-28 09:05:23+01:00,['6bd7302645a6167299de6de4e5a19749502db25c'],75,99,174,1244903,1,0.565217391,1,1,3180
4003c9384bcf452ba7eb4072b96ad731b13da035,1,Ewen Cheslack-Postava,2017-07-28 11:28:33-07:00,['4059fa5763252c6869b6b7c682d7b5f9d4dc3a87'],0,38,38,1244941,3,1,1,1,3180
c50c941af1395d010160790f0127f06106cc69c8,1,Guozhang Wang,2017-07-28 11:30:56-07:00,['4003c9384bcf452ba7eb4072b96ad731b13da035'],65,1233,1298,1246239,27,0.764210526,0.837894737,0.787368421,3189
1844bf2b2f4cdf5a8209d7ceccb6701fc7dcf768,1,Guozhang Wang,2017-07-28 16:46:34-07:00,['c50c941af1395d010160790f0127f06106cc69c8'],334,1480,1814,1248053,24,0.943074004,0.948766603,0.540796964,3191
da2205578be3228ce40eb5e59f6bbcb0c8da0aba,1,Guozhang Wang,2017-07-31 15:28:59-07:00,['1844bf2b2f4cdf5a8209d7ceccb6701fc7dcf768'],1057,3119,4176,1252229,89,0.781088083,0.99611399,0.523316062,3195
cd4c6c0183edfbf8e7e8ce526d638e31fcd09186,1,Jason Gustafson,2017-08-01 08:56:23-07:00,['da2205578be3228ce40eb5e59f6bbcb0c8da0aba'],33,67,100,1252329,2,0.909090909,0.772727273,1,3195
4086db472d08f6dee4d30dda82ab9ff7b67d1a20,0,Jason Gustafson,2017-08-01 09:10:28-07:00,['cd4c6c0183edfbf8e7e8ce526d638e31fcd09186'],1,1,2,1252331,1,,,,3195
94a6d6c02d478f5ccec1928163ff921688155a01,1,Guozhang Wang,2017-08-01 11:22:49-07:00,['4086db472d08f6dee4d30dda82ab9ff7b67d1a20'],0,144,144,1252475,1,0,1,1,3196
228a4fdb6dc15d1b8615615e00825e7ce53a41fa,1,Guozhang Wang,2017-08-01 12:28:24-07:00,['94a6d6c02d478f5ccec1928163ff921688155a01'],76,120,196,1252671,6,0,0.885714286,1,3196
edcefccfd7bd83110746fa81669e0d69ece5bb4b,0,Guozhang Wang,2017-08-01 16:16:34-07:00,['228a4fdb6dc15d1b8615615e00825e7ce53a41fa'],461,225,686,1253357,34,0,0,0,3196
b7684b47b80a2a7d604632bb325fde49e570480f,0,Damian Guy,2017-08-02 14:11:23+01:00,['edcefccfd7bd83110746fa81669e0d69ece5bb4b'],55,96,151,1253508,2,1,0,1,3196
db306ec36297d042b58de6f825b0419d0ea912d8,0,Ismael Juma,2017-08-02 15:50:40+01:00,['b7684b47b80a2a7d604632bb325fde49e570480f'],5,31,36,1253544,1,1,1,0.8,3196
630e9c5679efa0916a7bfca849dfc8850737681c,1,Guozhang Wang,2017-08-02 14:34:20-07:00,['db306ec36297d042b58de6f825b0419d0ea912d8'],13,14,27,1253571,1,0,0,0,3196
125d69caee993710bc07523fdd3deb0e06b10636,1,Guozhang Wang,2017-08-02 15:13:02-07:00,['630e9c5679efa0916a7bfca849dfc8850737681c'],238,216,454,1254025,42,0,0,0.535714286,3196
fb21209b5ad30001eeace56b3c8ab060e0ceb021,1,Ismael Juma,2017-08-02 23:53:56+01:00,['125d69caee993710bc07523fdd3deb0e06b10636'],562,441,1003,1255028,16,1,0,0,3196
6bee1e9e5799398550e1897bcef6c5067452500b,1,Guozhang Wang,2017-08-03 14:16:47-07:00,['fb21209b5ad30001eeace56b3c8ab060e0ceb021'],207,552,759,1255787,15,1,1,0.290909091,3196
13deb84dcf4b3e583997dbd05a0e25840f024375,1,Jason Gustafson,2017-08-03 14:56:20-07:00,['6bee1e9e5799398550e1897bcef6c5067452500b'],79,26,105,1255892,6,1,0,0,3196
613971f8d401e42f985e0942927348dcee640b75,0,Ewen Cheslack-Postava,2017-08-03 15:24:05-07:00,['13deb84dcf4b3e583997dbd05a0e25840f024375'],5,10,15,1255907,2,,,,3196
5a516fb28e6a2af559fcbac5df12f048a5916fc6,1,Jason Gustafson,2017-08-03 16:18:26-07:00,['613971f8d401e42f985e0942927348dcee640b75'],431,247,678,1256585,16,0.823529412,0.764705882,0.019607843,3197
e7f7d4093968d8de494e371a6d3c85e555332cbb,0,Ismael Juma,2017-08-04 11:28:46+01:00,['5a516fb28e6a2af559fcbac5df12f048a5916fc6'],6,41,47,1256632,3,0.6,0.733333333,1,3197
62f03ba2cd27880562dbf85c5ef6699d25bc5b43,0,Ismael Juma,2017-08-04 11:55:01+01:00,['e7f7d4093968d8de494e371a6d3c85e555332cbb'],10,22,32,1256664,2,0,0.714285714,1,3197
5766f212db961470f30125a813c1edcc1fe75f6c,1,Ismael Juma,2017-08-04 12:41:07+01:00,['62f03ba2cd27880562dbf85c5ef6699d25bc5b43'],2,9,11,1256675,1,,,,3197
332a8129d3769163c622688bc7bf53a435f44b34,1,Ismael Juma,2017-08-04 12:46:47+01:00,['5766f212db961470f30125a813c1edcc1fe75f6c'],2,15,17,1256692,2,0,0,1,3197
c06fa5adaaf7fe940c314a0be97e122e921de970,0,Damian Guy,2017-08-04 12:52:13+01:00,['332a8129d3769163c622688bc7bf53a435f44b34'],53,50,103,1256795,1,1,0,0,3197
c1690da071c00ef8d6cca7b3bed50a0e5e2c3332,0,Ismael Juma,2017-08-04 13:46:08+01:00,['c06fa5adaaf7fe940c314a0be97e122e921de970'],36,54,90,1256885,7,1,1,1,3197
5704d8f05f0d271b62d0170ba5a8fbfceacb4304,1,Guozhang Wang,2017-08-04 09:16:57-07:00,['c1690da071c00ef8d6cca7b3bed50a0e5e2c3332'],1,4,5,1256890,1,,,,3197
22611aca9b33cc3db9362add785e44c7a3698ba3,0,Ewen Cheslack-Postava,2017-08-04 10:25:21-07:00,['5704d8f05f0d271b62d0170ba5a8fbfceacb4304'],7,48,55,1256945,3,1,1,1,3197
70796c3ca3306943e74d2ca260f3f28707481985,1,Jason Gustafson,2017-08-04 13:08:12-07:00,['22611aca9b33cc3db9362add785e44c7a3698ba3'],3,6,9,1256954,2,0.5,1,1,3197
d637c134c8d8ce729cdff4e152a6eee3846bafcb,1,Ismael Juma,2017-08-05 09:04:05+01:00,['70796c3ca3306943e74d2ca260f3f28707481985'],20,65,85,1257039,1,,,,3197
1d291a4219656cd9f597432ff9d7f8a42900abdb,0,Ewen Cheslack-Postava,2017-08-06 21:50:43-07:00,['d637c134c8d8ce729cdff4e152a6eee3846bafcb'],1,1,2,1257041,1,,,,3197
1cd86284e808e2846e94b312bb55141f6d216d51,1,Jiangjie Qin,2017-08-06 22:25:52-07:00,['1d291a4219656cd9f597432ff9d7f8a42900abdb'],2,42,44,1257085,3,0,0,1,3197
2010aa067ffb3adba1afd392d7da10f67e231eb8,0,Damian Guy,2017-08-07 10:17:17+01:00,['1cd86284e808e2846e94b312bb55141f6d216d51'],0,175,175,1257260,2,,,,3198
f15cdc73ddd06e0bf0f319b0d8ad8f63e80cf28d,1,Ewen Cheslack-Postava,2017-08-07 08:10:42-07:00,['2010aa067ffb3adba1afd392d7da10f67e231eb8'],132,241,373,1257633,2,1,1,1,3198
1f0ad0121e03a2e4f6c0cf3551b14c75085bd34f,1,Guozhang Wang,2017-08-07 09:54:43-07:00,['f15cdc73ddd06e0bf0f319b0d8ad8f63e80cf28d'],31,139,170,1257803,4,0.950819672,0.508196721,1,3199
57770dd235a82994f296971079a97281be0a130b,1,Guozhang Wang,2017-08-07 15:20:24-07:00,['1f0ad0121e03a2e4f6c0cf3551b14c75085bd34f'],70,52,122,1257925,2,1,0,0,3199
c9ffab16228ecd5d931b58d93dfa3f49287d2909,1,Ismael Juma,2017-08-08 09:38:22+01:00,['57770dd235a82994f296971079a97281be0a130b'],14,99,113,1258038,4,0.092307692,0.461538462,0.753846154,3199
98d4a483382dacad280e0cd25f10bccca51328a5,0,Ismael Juma,2017-08-08 23:15:57+01:00,['c9ffab16228ecd5d931b58d93dfa3f49287d2909'],6,6,12,1258050,1,,,,3199
649276abb284c4f71504e9f028c5ab1450849fae,0,Ismael Juma,2017-08-08 23:22:57+01:00,['98d4a483382dacad280e0cd25f10bccca51328a5'],17,19,36,1258086,4,,,,3199
fb8edbdc6314411e0ed006a76e9658460a99208a,1,Ismael Juma,2017-08-09 01:11:39+01:00,['649276abb284c4f71504e9f028c5ab1450849fae'],28,38,66,1258152,4,0,1,1,3199
b8cf976865f3559b4e5c45eeb261444cd1d7383f,0,Ewen Cheslack-Postava,2017-08-08 19:58:47-07:00,['fb8edbdc6314411e0ed006a76e9658460a99208a'],0,10,10,1258162,1,1,1,1,3199
1a653c813c842c0b67f26fb119d7727e272cf834,1,Ewen Cheslack-Postava,2017-08-08 20:20:41-07:00,['b8cf976865f3559b4e5c45eeb261444cd1d7383f'],17,44,61,1258223,3,0.9,0.9,0,3199
a593db6a2b6c3511215008b6d3dd6bd77f84e8c4,1,Ewen Cheslack-Postava,2017-08-09 09:07:27-07:00,['1a653c813c842c0b67f26fb119d7727e272cf834'],67,66,133,1258356,6,1,0,0,3199
c35c4798139bc30e3a380311e45a22ba56fcc918,1,Damian Guy,2017-08-09 20:03:28+01:00,['a593db6a2b6c3511215008b6d3dd6bd77f84e8c4'],2,26,28,1258384,2,1,1,1,3199
1ad74f5b760d16f3990a5024e717f4826278675d,0,Jason Gustafson,2017-08-09 13:22:05-07:00,['c35c4798139bc30e3a380311e45a22ba56fcc918'],3,140,143,1258527,2,0.794871795,1,1,3199
889da45dd00af266ddf2154a062903bd0d4cad17,0,Ismael Juma,2017-08-09 23:35:13+01:00,['1ad74f5b760d16f3990a5024e717f4826278675d'],3,3,6,1258533,1,,,,3199
69d3d4aad6ce0678f592140501485893b68b20b1,1,Ismael Juma,2017-08-09 23:38:57+01:00,['889da45dd00af266ddf2154a062903bd0d4cad17'],2,4,6,1258539,3,,,,3199
d2a2b80cc615429a14ccdf21a1bd6c5fd0b31728,0,Ismael Juma,2017-08-09 23:58:25+01:00,['69d3d4aad6ce0678f592140501485893b68b20b1'],0,5,5,1258544,1,,,,3199
23df2199d78d799851a797f9c90c74e3bbc464f5,0,Ismael Juma,2017-08-10 01:31:41+01:00,['d2a2b80cc615429a14ccdf21a1bd6c5fd0b31728'],0,26,26,1258570,13,,,,3199
75b0f30c448c12199263e3d82708c2cb6817d702,0,Ismael Juma,2017-08-10 02:06:53+01:00,['23df2199d78d799851a797f9c90c74e3bbc464f5'],1,8,9,1258579,1,,,,3199
017a21c6044189abe40b2b8b09ba51447646136e,0,Jason Gustafson,2017-08-10 11:07:53-07:00,['75b0f30c448c12199263e3d82708c2cb6817d702'],98,13,111,1258690,8,0,0,1,3199
8ffb1a1fedad4350dd0f0ce0dd52107f962ce428,1,Guozhang Wang,2017-08-10 11:31:55-07:00,['017a21c6044189abe40b2b8b09ba51447646136e'],2,95,97,1258787,2,0.316666667,1,1,3199
b2b529522d0683b4c3f97be8ac92597048f45037,0,Damian Guy,2017-08-11 09:35:26+01:00,['8ffb1a1fedad4350dd0f0ce0dd52107f962ce428'],34,200,234,1259021,1,,,,3199
3e69ce80157eb6a5e6dd05e3be522b5208a41bc5,1,Damian Guy,2017-08-11 12:14:01+01:00,['b2b529522d0683b4c3f97be8ac92597048f45037'],2228,2038,4266,1263287,24,1,0.034229829,0,3204
d2774e302fa528b4fe7b7db39f69cf679753f348,1,Guozhang Wang,2017-08-11 12:19:28-07:00,['3e69ce80157eb6a5e6dd05e3be522b5208a41bc5'],46,1317,1363,1264650,21,0,1,1,3216
b6102cf4b2c3c56850593c5d88612cb9c4ac704f,0,Guozhang Wang,2017-08-11 13:53:47-07:00,['d2774e302fa528b4fe7b7db39f69cf679753f348'],1,2,3,1264653,2,,,,3216
f4dc5ac15ca120d8240ac3b8ba28139ccb26cf91,1,Ismael Juma,2017-08-14 00:11:58+01:00,['b6102cf4b2c3c56850593c5d88612cb9c4ac704f'],5,10,15,1264668,3,0,0.5,0.5,3216
e19c37e5914b1fa64befdfdf24edbf2415f8cdb3,1,Damian Guy,2017-08-14 10:02:32+01:00,['f4dc5ac15ca120d8240ac3b8ba28139ccb26cf91'],336,886,1222,1265890,12,0.627376426,1,0.756653992,3219
8265a43897b3da88839df061ce22559820087ad9,0,Ismael Juma,2017-08-14 14:05:40+01:00,['e19c37e5914b1fa64befdfdf24edbf2415f8cdb3'],11,132,143,1266033,3,0.133333333,0.983333333,0.983333333,3220
21ea4b1d2a1b99aa804bd4461015abaf31673923,1,Ismael Juma,2017-08-14 17:07:50+01:00,['8265a43897b3da88839df061ce22559820087ad9'],20,181,201,1266234,3,0.528846154,0.980769231,0.913461538,3220
c0f7a7705851eec4a77d3e42cf6bf2546c07ffa8,1,Damian Guy,2017-08-14 18:24:43+01:00,['21ea4b1d2a1b99aa804bd4461015abaf31673923'],0,48,48,1266282,1,1,1,1,3220
869ef5579f00661a5d68e92f09e088e7ed884189,1,Jason Gustafson,2017-08-14 13:52:02-07:00,['c0f7a7705851eec4a77d3e42cf6bf2546c07ffa8'],28,123,151,1266433,2,1,1,1,3220
3b1cea60e909e579e54775fc479397ddbeba95eb,1,Jason Gustafson,2017-08-15 14:16:00-07:00,['869ef5579f00661a5d68e92f09e088e7ed884189'],44,262,306,1266739,3,0.02739726,0.97260274,0.924657534,3220
bf34a5b74035a90a7461ac8c8a209da450c0346b,0,Ismael Juma,2017-08-16 13:22:44+01:00,['3b1cea60e909e579e54775fc479397ddbeba95eb'],1,1,2,1266741,1,,,,3220
72eacbea5b831096a6cc9a4fa42401bc74a88a80,0,Ewen Cheslack-Postava,2017-08-16 14:43:29-07:00,['bf34a5b74035a90a7461ac8c8a209da450c0346b'],8,79,87,1266828,2,0,1,0.982142857,3220
efe4f6540a3c26371c88b3f956bbd4abfe9dc52e,1,Guozhang Wang,2017-08-17 14:02:10-07:00,['72eacbea5b831096a6cc9a4fa42401bc74a88a80'],22,83,105,1266933,3,0.487179487,0.974358974,1,3220
334a30bcfffc3759aeded08f2089cea4ed6e9937,1,Jason Gustafson,2017-08-17 15:04:03-07:00,['efe4f6540a3c26371c88b3f956bbd4abfe9dc52e'],13,147,160,1267093,9,0.432098765,0.691358025,1,3220
520e651d532558b346d08388cb9aa0ac6e156ece,1,Ewen Cheslack-Postava,2017-08-17 15:14:32-07:00,['334a30bcfffc3759aeded08f2089cea4ed6e9937'],48,56,104,1267197,11,0,0,0,3220
a4720b25a372790b26a0b00fa18eb78f830b1311,1,Ismael Juma,2017-08-18 11:38:45+01:00,['520e651d532558b346d08388cb9aa0ac6e156ece'],0,28,28,1267225,1,1,1,1,3220
3457c4761ae09ef2befc141278fe489900cac470,1,Ismael Juma,2017-08-18 15:58:59+01:00,['a4720b25a372790b26a0b00fa18eb78f830b1311'],8,6,14,1267239,1,1,1,1,3220
75c78e9692a479e2c94dbd08e564f64faedd2071,1,Damian Guy,2017-08-18 17:59:33+01:00,['3457c4761ae09ef2befc141278fe489900cac470'],121,197,318,1267557,9,0.923076923,1,0.653846154,3222
3e22c1c04a8751d8b6bd4cefa88f8f33ec2de8e0,0,Damian Guy,2017-08-18 18:13:02+01:00,['75c78e9692a479e2c94dbd08e564f64faedd2071'],4,48,52,1267609,1,1,1,0,3222
ed96523a2c763b48399a9720dcce0af44f5fc1a1,1,Ismael Juma,2017-08-19 08:55:29+01:00,['3e22c1c04a8751d8b6bd4cefa88f8f33ec2de8e0'],182,505,687,1268296,73,1,1,0.962264151,3224
6896f1ddb7650f42630aef8c67c8b61866e9fc00,1,Jason Gustafson,2017-08-19 11:17:02-07:00,['ed96523a2c763b48399a9720dcce0af44f5fc1a1'],204,628,832,1269128,15,0.868,0.988,0.504,3225
26c65953ede2b449d7165f2d04453bc00dd29c20,0,Ismael Juma,2017-08-20 07:54:36+01:00,['6896f1ddb7650f42630aef8c67c8b61866e9fc00'],0,4,4,1269132,1,,,,3225
8a5a84dc67e16f6ff77cc30454682b0ad6e5a878,0,Ismael Juma,2017-08-21 17:49:11+01:00,['26c65953ede2b449d7165f2d04453bc00dd29c20'],1,3,4,1269136,1,1,1,1,3225
bf3bfd6749610eb49a4e47bdda2e667ca7458ff2,1,Jason Gustafson,2017-08-21 10:22:53-07:00,['8a5a84dc67e16f6ff77cc30454682b0ad6e5a878'],28,91,119,1269255,2,0.416666667,0.333333333,1,3225
57dbe39ae1e8312c5e0e6603061d2816a8c05198,0,Ismael Juma,2017-08-21 18:36:45+01:00,['bf3bfd6749610eb49a4e47bdda2e667ca7458ff2'],28,36,64,1269319,7,0.25,1,0.25,3225
0b0819ba057bdb1e4d0d16745491aad523cab399,0,Guozhang Wang,2017-08-21 11:01:26-07:00,['57dbe39ae1e8312c5e0e6603061d2816a8c05198'],16,15,31,1269350,4,,,,3225
ee8e9349b22277ec69bf831dda66cfc6e767df14,1,Damian Guy,2017-08-22 11:21:32+01:00,['0b0819ba057bdb1e4d0d16745491aad523cab399'],175,769,944,1270294,14,0.820338983,1,0.762711864,3230
ecea150bdeb7cb98f1aa32eb2cf8ac4116e28f74,0,Damian Guy,2017-08-22 14:14:35+01:00,['ee8e9349b22277ec69bf831dda66cfc6e767df14'],12,117,129,1270423,1,,,,3230
6cf92a253b7102c18547481387df4db17853267e,0,Ismael Juma,2017-08-22 15:06:52+01:00,['ecea150bdeb7cb98f1aa32eb2cf8ac4116e28f74'],9,9,18,1270441,1,0,0,0,3230
3615ef730caeab3f79874c8e2acb9f7e0e9cff82,1,Ismael Juma,2017-08-22 15:11:04+01:00,['6cf92a253b7102c18547481387df4db17853267e'],16,53,69,1270510,4,0.807692308,1,1,3230
343a8ef99cbc23e27ada8eb5f8c1b752067a7e41,1,Damian Guy,2017-08-22 15:25:00+01:00,['3615ef730caeab3f79874c8e2acb9f7e0e9cff82'],74,84,158,1270668,3,0,0,1,3230
b78d7ba5d58fa77b831244444eef005a62883f9b,1,Guozhang Wang,2017-08-22 11:13:08-07:00,['343a8ef99cbc23e27ada8eb5f8c1b752067a7e41'],1089,2043,3132,1273800,27,1,1,1,3234
ea21752a79f3e843f0c2a74ea093a8793e42edb4,0,Ismael Juma,2017-08-23 14:47:41+01:00,['b78d7ba5d58fa77b831244444eef005a62883f9b'],21,75,96,1273896,2,0.04,1,1,3234
3b7e104559211d8104eb6d1493b6cdb5ec93de3a,0,Ewen Cheslack-Postava,2017-08-23 09:52:21-07:00,['ea21752a79f3e843f0c2a74ea093a8793e42edb4'],1,10,11,1273907,1,1,1,1,3234
99eebc840485d5b3352bc9e2f9230a33303cc080,0,Damian Guy,2017-08-23 20:53:00+01:00,['3b7e104559211d8104eb6d1493b6cdb5ec93de3a'],1,1,2,1273909,1,,,,3234
5b99a288cd2d4461380b041067768ee6c1b2efc7,1,Jason Gustafson,2017-08-23 14:31:44-07:00,['99eebc840485d5b3352bc9e2f9230a33303cc080'],62,47,109,1274018,2,0,0,0,3234
5e65c0da45f3a86a25087c4d2e2b501e81e0a285,0,Damian Guy,2017-08-24 14:53:39+01:00,['5b99a288cd2d4461380b041067768ee6c1b2efc7'],50,454,504,1274522,1,,,,3234
21fea170d8499a7153f2b821bcd32a55ad602645,1,Guozhang Wang,2017-08-24 09:12:12-07:00,['5e65c0da45f3a86a25087c4d2e2b501e81e0a285'],5,29,34,1274556,2,,,,3234
71417552c7651a5b41e73460d0577615864aafe8,1,Jason Gustafson,2017-08-24 16:03:55-07:00,['21fea170d8499a7153f2b821bcd32a55ad602645'],51,299,350,1274906,10,0.09375,0.8125,0.921875,3234
e6164ec611ca48e71c549f88d8a92fef90bf5a71,0,Rajini Sivaram,2017-08-24 22:12:50-07:00,['71417552c7651a5b41e73460d0577615864aafe8'],15,35,50,1274956,3,1,1,0.315789474,3234
14f6ecd9151fa985fad0a30347efab1397af2491,0,Ismael Juma,2017-08-25 07:44:42+01:00,['e6164ec611ca48e71c549f88d8a92fef90bf5a71'],1,1,2,1274958,1,,,,3234
05e3850b2ea24f372ea1cc6ca7457e0ff99445f6,1,Damian Guy,2017-08-25 13:59:10+01:00,['14f6ecd9151fa985fad0a30347efab1397af2491'],3,16,19,1274977,2,1,1,1,3234
c4d629a0b3cbd11c174cb8b09a50bc8de77825e9,1,Jason Gustafson,2017-08-25 10:23:11-07:00,['05e3850b2ea24f372ea1cc6ca7457e0ff99445f6'],571,685,1256,1276233,52,0.432432432,1,1,3236
607c3c21f652a8f911d1efb8374d2eec313a4e2d,1,Jason Gustafson,2017-08-25 10:42:40-07:00,['c4d629a0b3cbd11c174cb8b09a50bc8de77825e9'],67,103,170,1276403,7,0.65,0.7,0,3236
0772fde562ed361beec6ad745895a0ee0cf229e8,1,Rajini Sivaram,2017-08-25 12:29:40-07:00,['607c3c21f652a8f911d1efb8374d2eec313a4e2d'],7,4648,4655,1281058,47,0.520930233,0.737209302,0.926976744,3279
c715f6a5ab94d187eb662efde594f0f14dcd9910,1,Damian Guy,2017-08-26 09:08:46+01:00,['0772fde562ed361beec6ad745895a0ee0cf229e8'],765,883,1648,1282706,19,1,1,0.563636364,3283
551d57561d6cb9e53aa16e0616190d370d339355,1,Guozhang Wang,2017-08-26 11:14:08-07:00,['c715f6a5ab94d187eb662efde594f0f14dcd9910'],35,98,133,1282839,3,0.391304348,0.739130435,0.891304348,3283
b01fcc3b89ee27940ca20dea00226d09a0ca0b8e,0,Guozhang Wang,2017-08-26 16:08:24-07:00,['551d57561d6cb9e53aa16e0616190d370d339355'],2,2,4,1282843,1,,,,3283
b6adb2dc89ae0625aa5d7fa501c9585585d50107,0,Guozhang Wang,2017-08-26 16:15:40-07:00,['b01fcc3b89ee27940ca20dea00226d09a0ca0b8e'],1,1,2,1282845,1,,,,3283
5648dcc3e59f4518d7febb31e0d687b94f1baadf,0,Guozhang Wang,2017-08-26 16:33:33-07:00,['b6adb2dc89ae0625aa5d7fa501c9585585d50107'],3,3,6,1282851,2,,,,3283
8d3aa6acadd057b866ffa39f04592ec8f92ad700,0,Ismael Juma,2017-08-27 09:13:05+01:00,['5648dcc3e59f4518d7febb31e0d687b94f1baadf'],3,6,9,1282860,1,,,,3283
7ae02a69c4965ccc6b9aeb72a0803d8ab1f62cc8,1,Ismael Juma,2017-08-27 09:26:38+01:00,['8d3aa6acadd057b866ffa39f04592ec8f92ad700'],6,23,29,1282889,3,0.888888889,0.888888889,1,3283
1f659913a631d9e77e7cd9b9c9775e3249ef803a,1,Guozhang Wang,2017-08-29 10:40:42-07:00,['7ae02a69c4965ccc6b9aeb72a0803d8ab1f62cc8'],482,485,967,1283856,10,0,0,0,3283
9ef2b3ce8e4553504e52385a6370bf641fc6ea1e,1,Guozhang Wang,2017-08-29 13:01:57-07:00,['1f659913a631d9e77e7cd9b9c9775e3249ef803a'],41,84,125,1283981,5,1,1,1,3283
949577ca77d5c143774d4879b19505b4d6284de3,1,Jason Gustafson,2017-08-29 16:41:19-07:00,['9ef2b3ce8e4553504e52385a6370bf641fc6ea1e'],42,86,128,1284109,11,0.814814815,0.925925926,0.851851852,3283
bd54d2e3e09e7dc717828ed5690aa30f7c3611d8,0,Damian Guy,2017-08-30 10:09:08+01:00,['949577ca77d5c143774d4879b19505b4d6284de3'],16,815,831,1284940,2,,,,3284
10cb534c8b18997301553db6debfe91bf596500e,1,Ismael Juma,2017-08-30 12:27:54+01:00,['bd54d2e3e09e7dc717828ed5690aa30f7c3611d8'],57,55,112,1285052,1,0,0,0,3284
76c9a6dcbc1fa92d1a7c2e913ad42b5f1a72fe62,1,Damian Guy,2017-08-30 13:52:44+01:00,['10cb534c8b18997301553db6debfe91bf596500e'],7,147,154,1285206,3,1,1,1,3285
6682abe4ae68fdbf0eb362e45f43ea14e2aba847,1,Guozhang Wang,2017-08-30 08:43:22-07:00,['76c9a6dcbc1fa92d1a7c2e913ad42b5f1a72fe62'],191,112,303,1285509,13,0.217391304,0.782608696,0.173913043,3285
f5310d645c4920d37925e82edb07f1e4a582b0b2,1,Guozhang Wang,2017-08-30 09:45:16-07:00,['6682abe4ae68fdbf0eb362e45f43ea14e2aba847'],54,59,113,1285622,5,,,,3285
ce04b14358054dd33134a596de97ef5594d187b7,0,Guozhang Wang,2017-08-30 11:17:55-07:00,['f5310d645c4920d37925e82edb07f1e4a582b0b2'],6,6,12,1285634,2,,,,3285
9836adc732288924813927c4869ffb3908febba1,1,Ismael Juma,2017-08-31 16:30:42+01:00,['ce04b14358054dd33134a596de97ef5594d187b7'],0,15,15,1285649,3,1,1,1,3285
9ebc303bb85bf5aae2b732c60d3b3e0a6e07512d,1,Guozhang Wang,2017-08-31 08:43:13-07:00,['9836adc732288924813927c4869ffb3908febba1'],153,66,219,1285868,4,0,0,0,3285
47c2753496875db2849065ad91ee03c7c842c8e9,1,Rajini Sivaram,2017-08-31 12:42:08-04:00,['9ebc303bb85bf5aae2b732c60d3b3e0a6e07512d'],9,172,181,1286049,4,0.901639344,0.901639344,0.918032787,3287
ded8741173854c98f3be0525403b6a17a55b6027,0,Jason Gustafson,2017-08-31 13:19:28-07:00,['47c2753496875db2849065ad91ee03c7c842c8e9'],4,7,11,1286060,1,0,0,1,3287
75070bdb5d70cc0b2f52faf4f769144f68f02ee2,0,Ewen Cheslack-Postava,2017-08-31 14:53:44-07:00,['ded8741173854c98f3be0525403b6a17a55b6027'],1,1,2,1286062,1,,,,3287
51af6fb654c482fb6fdd85126991149238640fd7,0,Guozhang Wang,2017-08-31 14:57:54-07:00,['75070bdb5d70cc0b2f52faf4f769144f68f02ee2'],13,56,69,1286131,2,1,1,0.37037037,3287
bc999989bff39db2f5e7b07968988ed9ccba49b2,1,Jiangjie Qin,2017-09-01 09:38:27-07:00,['51af6fb654c482fb6fdd85126991149238640fd7'],6,13,19,1286150,4,0,0,0,3287
14a7c297ab917efb28e579fa942d58cdcf4930c5,1,Damian Guy,2017-09-02 08:24:43+01:00,['bc999989bff39db2f5e7b07968988ed9ccba49b2'],8,31,39,1286189,2,1,1,1,3287
b2a328daf2a51520290fc4ec31ce5d92b2c0ef01,1,Ismael Juma,2017-09-02 08:54:58+01:00,['14a7c297ab917efb28e579fa942d58cdcf4930c5'],41,74,115,1286304,2,0.538461538,0.538461538,1,3287
adefc8ea076354e07839f0319fee1fba52343b91,1,Jiangjie Qin,2017-09-02 23:20:13-07:00,['b2a328daf2a51520290fc4ec31ce5d92b2c0ef01'],318,2399,2717,1289021,53,0.311302682,0.607279693,0.965517241,3304
493c2aad595c70247d70572579853c90ee4ea5db,0,Damian Guy,2017-09-04 14:28:50+01:00,['adefc8ea076354e07839f0319fee1fba52343b91'],7,57,64,1289085,1,,,,3304
b1871e5adf3fef7256a75d09b812c6ba64791ff4,0,Damian Guy,2017-09-05 10:27:36+01:00,['493c2aad595c70247d70572579853c90ee4ea5db'],0,2,2,1289087,1,1,1,1,3304
caddae19ea87fb2fa46884eddfa6eb742c770267,0,Damian Guy,2017-09-05 11:45:21+01:00,['b1871e5adf3fef7256a75d09b812c6ba64791ff4'],2,2,4,1289091,1,,,,3304
d78eb03fad33b6060f246ae31c9276038e8555ec,0,Guozhang Wang,2017-09-05 10:51:04-07:00,['caddae19ea87fb2fa46884eddfa6eb742c770267'],0,18,18,1289109,1,,,,3304
facd2c5a8c7a4379755955ba3e318bfecde6af39,1,Guozhang Wang,2017-09-05 14:11:59-07:00,['d78eb03fad33b6060f246ae31c9276038e8555ec'],6,410,416,1289525,8,0.481632653,0.926530612,0.959183673,3306
752e5317410f05d08f69f302e4ee0cadae183b59,1,Guozhang Wang,2017-09-05 15:47:31-07:00,['facd2c5a8c7a4379755955ba3e318bfecde6af39'],49,58,107,1289632,11,0.166666667,0,0,3306
81e789ae3dc6ea8369db181c5aef440491d74f19,0,Jason Gustafson,2017-09-05 16:27:08-07:00,['752e5317410f05d08f69f302e4ee0cadae183b59'],53,52,105,1289737,21,,,,3306
5d69966195409d73e6e4d74e8a898fac754450cc,1,Rajini Sivaram,2017-09-06 00:32:59+01:00,['81e789ae3dc6ea8369db181c5aef440491d74f19'],3,14,17,1289754,2,1,1,1,3306
cd59976eea54efe6367b4c55872ab206f504829a,0,Guozhang Wang,2017-09-05 16:54:00-07:00,['5d69966195409d73e6e4d74e8a898fac754450cc'],1,39,40,1289794,1,,,,3306
2fb5664bf4591f3e7bdc02894b9de392bf72913c,1,Guozhang Wang,2017-09-05 17:38:58-07:00,['cd59976eea54efe6367b4c55872ab206f504829a'],160,240,400,1290194,9,0.22972973,0.972972973,0.945945946,3308
b687c068008a81fad390c80da289249cc04b3efb,0,Damian Guy,2017-09-06 10:43:14+01:00,['2fb5664bf4591f3e7bdc02894b9de392bf72913c'],44,215,259,1290453,13,1,1,1,3309
45394d52c1ba566178c57897297a3ea31379f957,0,Damian Guy,2017-09-06 10:55:43+01:00,['b687c068008a81fad390c80da289249cc04b3efb'],84,732,816,1291269,9,0.886956522,0.817391304,0.626086957,3310
51025764601760684f3dbdc0171fd7aa2ebe70e7,0,Jason Gustafson,2017-09-06 11:12:23-07:00,['45394d52c1ba566178c57897297a3ea31379f957'],31,36,67,1291336,2,0,0,1,3310
23d01c805bef7504abfa83ecac7e384d121a583a,1,Jason Gustafson,2017-09-06 11:41:33-07:00,['51025764601760684f3dbdc0171fd7aa2ebe70e7'],11,40,51,1291387,6,1,1,1,3310
212bce6e3fed5069e530aa75c7a25443f28a2ffb,0,Guozhang Wang,2017-09-06 15:42:52-07:00,['23d01c805bef7504abfa83ecac7e384d121a583a'],2,2,4,1291391,1,,,,3310
3f155eaa23c6081e4afa3b49f0f8a65a16b8e05c,0,Guozhang Wang,2017-09-06 18:38:08-07:00,['212bce6e3fed5069e530aa75c7a25443f28a2ffb'],49,17,66,1291457,3,0.357142857,0,0,3310
9b85cf9ed02d4b3b87ea39e0c2f8c35e1e813f2f,1,Guozhang Wang,2017-09-06 18:39:40-07:00,['3f155eaa23c6081e4afa3b49f0f8a65a16b8e05c'],16,16,32,1291489,7,,,,3310
b041c8d87deab536b262e6260334b5bda1d896c8,0,Guozhang Wang,2017-09-06 22:12:10-07:00,['9b85cf9ed02d4b3b87ea39e0c2f8c35e1e813f2f'],0,22,22,1291511,1,,,,3310
667cd60dc6ba68831423a256b6e455f7d955581c,1,Damian Guy,2017-09-07 08:54:10+01:00,['b041c8d87deab536b262e6260334b5bda1d896c8'],16,287,303,1291814,5,1,1,0.975609756,3311
9cbb9f0939c88868bf33ae340c5fa756ee2965e8,1,Damian Guy,2017-09-07 09:39:46+01:00,['667cd60dc6ba68831423a256b6e455f7d955581c'],232,1716,1948,1293762,29,0.851913478,1,0.703826955,3326
329d5fa64a2a3ac1d39ac37fdacbf6e43d500d11,1,Damian Guy,2017-09-07 12:35:31+01:00,['9cbb9f0939c88868bf33ae340c5fa756ee2965e8'],24,62,86,1293848,6,1,1,1,3326
4065ffb3e1a82f71578811a0a329cdc90e5e1567,0,Rajini Sivaram,2017-09-07 13:23:03+01:00,['329d5fa64a2a3ac1d39ac37fdacbf6e43d500d11'],143,993,1136,1294984,25,0.783606557,0.921311475,0.855737705,3338
3410f02fec6bc8633ebb58e3c1a8f9c2e49a1aa4,1,Ewen Cheslack-Postava,2017-09-07 11:40:54-07:00,['4065ffb3e1a82f71578811a0a329cdc90e5e1567'],6,43,49,1295033,2,0.947368421,1,1,3338
674407908b898dd18b447447ad3346b5268b1dfc,1,Guozhang Wang,2017-09-07 14:36:49-07:00,['3410f02fec6bc8633ebb58e3c1a8f9c2e49a1aa4'],26,132,158,1295191,2,0.435483871,1,0.983870968,3338
a1ec6527db808679330a54e802c4ae1630e6b50d,0,Guozhang Wang,2017-09-07 17:08:45-07:00,['674407908b898dd18b447447ad3346b5268b1dfc'],4,4,8,1295199,1,,,,3338
07a428e0c8fea498f084f5918fa88d5334ae8028,0,Ismael Juma,2017-09-08 02:29:03+01:00,['a1ec6527db808679330a54e802c4ae1630e6b50d'],6,8,14,1295213,2,1,1,0,3338
27336192ff62d43d0beabc5dab2855b87befcc55,1,Ismael Juma,2017-09-08 04:40:24+01:00,['07a428e0c8fea498f084f5918fa88d5334ae8028'],70,83,153,1295366,14,1,1,1,3338
d0ee6ed36baf702fa24dac8ae31f45fc27324d89,1,Damian Guy,2017-09-08 08:21:48+01:00,['27336192ff62d43d0beabc5dab2855b87befcc55'],501,553,1054,1296420,47,0.525,1,1,3340
b07435638d66f80c10c23c7e87bbe1d6844968a3,0,Ismael Juma,2017-09-08 10:47:58+01:00,['d0ee6ed36baf702fa24dac8ae31f45fc27324d89'],19,27,46,1296466,1,,,,3340
6546f9af6da45044ce68e392d4bdeac4122d132e,0,Ismael Juma,2017-09-08 11:21:28+01:00,['b07435638d66f80c10c23c7e87bbe1d6844968a3'],0,13,13,1296479,1,,,,3340
ef17d5b892fa34811c805cac366744040e6d6efb,1,Ismael Juma,2017-09-08 13:10:13+01:00,['6546f9af6da45044ce68e392d4bdeac4122d132e'],2,14,16,1296495,2,0.666666667,0.666666667,1,3340
ee4e4c8cb35d1403c521518d6c269bbc03700325,0,Ismael Juma,2017-09-08 13:30:23+01:00,['ef17d5b892fa34811c805cac366744040e6d6efb'],8,173,181,1296676,2,0.829787234,1,1,3341
beeed86600f3571635e83e6a3b6ee0c38679c7fe,0,Ismael Juma,2017-09-08 14:47:21+01:00,['ee4e4c8cb35d1403c521518d6c269bbc03700325'],4,4,8,1296684,1,,,,3341
e16b9143dfcecbd58e3bebecbdb7d8e933b88cc4,1,Damian Guy,2017-09-08 16:49:18+01:00,['beeed86600f3571635e83e6a3b6ee0c38679c7fe'],46,544,590,1297274,9,0.725609756,1,0.682926829,3344
4769e3d92acdc6036f1f834c70004f0c867ae582,1,Damian Guy,2017-09-08 18:22:04+01:00,['e16b9143dfcecbd58e3bebecbdb7d8e933b88cc4'],85,366,451,1297725,12,1,1,1,3347
6ebd9d35fc081bca3f1efeba8b70ec71cde85270,1,Ismael Juma,2017-09-08 18:42:42+01:00,['4769e3d92acdc6036f1f834c70004f0c867ae582'],132,762,894,1298619,5,0.619952494,1,0.933491686,3347
5d73b37b14d03babffebd0bde6022d2cff175b8b,1,Ismael Juma,2017-09-08 19:01:31+01:00,['6ebd9d35fc081bca3f1efeba8b70ec71cde85270'],1,1,2,1298621,1,,,,3347
6e4045586212812165693840b68d7577a05b890a,1,Ismael Juma,2017-09-08 19:05:01+01:00,['5d73b37b14d03babffebd0bde6022d2cff175b8b'],2,2,4,1298625,1,,,,3347
2db1e4423fb33405a319b253b040e57e069c1f7a,1,Guozhang Wang,2017-09-08 14:01:58-07:00,['6e4045586212812165693840b68d7577a05b890a'],14,683,697,1299322,11,0.767634855,1,0.917012448,3351
9cec4109b236c1380f2b44caba2fbf2c8b96a828,0,Guozhang Wang,2017-09-08 14:12:00-07:00,['2db1e4423fb33405a319b253b040e57e069c1f7a'],1,1,2,1299324,1,,,,3351
689a84c7d6aec32956aabf2e8b3612e754ba2e88,0,Guozhang Wang,2017-09-08 14:13:11-07:00,['9cec4109b236c1380f2b44caba2fbf2c8b96a828'],1,1,2,1299326,1,,,,3351
ae4100f82c13b3e6978c0a0f697312bd073e0eb3,0,Ismael Juma,2017-09-09 08:34:03+01:00,['689a84c7d6aec32956aabf2e8b3612e754ba2e88'],1,7,8,1299334,3,0.6,1,1,3351
3728f4cd9623ce028f1720b03e15d444856fd7fc,0,Rajini Sivaram,2017-09-10 20:37:00+01:00,['ae4100f82c13b3e6978c0a0f697312bd073e0eb3'],2,3,5,1299339,1,0,1,1,3351
c5464edbb7a6821e0a91a3712b1fe2fd92a22d68,1,Damian Guy,2017-09-11 09:42:10+01:00,['3728f4cd9623ce028f1720b03e15d444856fd7fc'],901,900,1801,1301140,106,0.8,0,0,3351
779714c08bc16fcdd6fe7c39e92a7f73ebebdb71,0,Damian Guy,2017-09-11 12:00:54+01:00,['c5464edbb7a6821e0a91a3712b1fe2fd92a22d68'],18,57,75,1301215,3,1,1,1,3352
9bb06c3eef3ebdff77e5e3b98c26b86c40efc56c,1,Ismael Juma,2017-09-11 15:37:46+01:00,['779714c08bc16fcdd6fe7c39e92a7f73ebebdb71'],140,206,346,1301561,27,0.304347826,0.869565217,0.52173913,3352
d6fabb011af848ff96691b5deb97c88a84e1a683,0,Guozhang Wang,2017-09-11 13:06:55-07:00,['9bb06c3eef3ebdff77e5e3b98c26b86c40efc56c'],14,51,65,1301626,4,1,1,1,3353
1f5bc11cc0e94110e9cb673cacc63c02bb23c279,0,Ismael Juma,2017-09-11 23:47:00+01:00,['d6fabb011af848ff96691b5deb97c88a84e1a683'],0,13,13,1301639,1,1,1,1,3353
439050816bef679efe403447a88cbaac69769567,0,Ismael Juma,2017-09-12 05:41:46+01:00,['1f5bc11cc0e94110e9cb673cacc63c02bb23c279'],1,2,3,1301642,1,,,,3353
a67140317a644034e91ee596ab22bfb55adde1e0,0,Damian Guy,2017-09-12 09:23:28+01:00,['439050816bef679efe403447a88cbaac69769567'],0,45,45,1301687,2,1,1,1,3354
e1491d4a0463deaaa8de7e100dddc2edbc030abf,0,Damian Guy,2017-09-12 09:26:09+01:00,['a67140317a644034e91ee596ab22bfb55adde1e0'],44,72,116,1301803,1,1,1,0,3354
08063f50a04fda3e40c6060a432a97f49bb68c8c,0,Damian Guy,2017-09-12 16:01:19+01:00,['e1491d4a0463deaaa8de7e100dddc2edbc030abf'],35,400,435,1302238,4,0.255813953,0.697674419,0.104651163,3354
8bd2a68b5020f0bf8f79cbe59676d649eebf170f,1,Damian Guy,2017-09-12 17:20:43+01:00,['08063f50a04fda3e40c6060a432a97f49bb68c8c'],33,509,542,1302780,6,0.846590909,1,0.704545455,3355
9ed8bf273c6ee5569ed68b71782ec7ab947f9c93,0,Rajini Sivaram,2017-09-12 17:39:47+01:00,['8bd2a68b5020f0bf8f79cbe59676d649eebf170f'],12,10,22,1302802,2,1,1,0.25,3355
90b4b07e6e3b44edfa41eebea83a674cb6f61922,1,Guozhang Wang,2017-09-12 16:42:06-07:00,['9ed8bf273c6ee5569ed68b71782ec7ab947f9c93'],17,51,68,1302870,4,1,1,1,3355
49b992dd8bad3d34bb6cdebda5eed9367b20e093,0,Ismael Juma,2017-09-13 12:42:05+01:00,['90b4b07e6e3b44edfa41eebea83a674cb6f61922'],3,3,6,1302876,1,,,,3355
c42bfc0d51e6691b4b5672ef7c8a1bedcd452d7f,0,Damian Guy,2017-09-13 17:52:45+01:00,['49b992dd8bad3d34bb6cdebda5eed9367b20e093'],1,1,2,1302878,1,,,,3355
ffd8f18a129fa826d62f527ea2c8eba2cfd644b2,1,Ismael Juma,2017-09-13 18:18:54+01:00,['c42bfc0d51e6691b4b5672ef7c8a1bedcd452d7f'],50,69,119,1302997,7,0,1,1,3355
9d2437a464062025ea9288a307db3f0f4eaf1695,0,Guozhang Wang,2017-09-13 13:12:09-07:00,['ffd8f18a129fa826d62f527ea2c8eba2cfd644b2'],2,2,4,1303001,1,,,,3355
f47996ccbd9ad873230b509a1fef724989d2f1e8,0,Jason Gustafson,2017-09-13 13:20:14-07:00,['9d2437a464062025ea9288a307db3f0f4eaf1695'],1,1,2,1303003,1,,,,3355
f7b1add686c27bcf26519c8a6963d9a773d7ffbe,1,Guozhang Wang,2017-09-13 13:22:06-07:00,['f47996ccbd9ad873230b509a1fef724989d2f1e8'],10,10,20,1303023,1,,,,3355
3b5d88febb186c4b92cc514fa2338de7bc338f67,1,Rajini Sivaram,2017-09-14 10:16:00+01:00,['f7b1add686c27bcf26519c8a6963d9a773d7ffbe'],421,1398,1819,1304842,49,0.699680511,0.856230032,0.872204473,3367
a0ad9f156a122e3e3a073cba0e2b0c39c93c7db5,0,Ismael Juma,2017-09-14 11:18:07+01:00,['3b5d88febb186c4b92cc514fa2338de7bc338f67'],1,1,2,1304844,1,,,,3367
2656659e0d7c0e427768ce216df2698acc8c9b11,1,Ismael Juma,2017-09-14 11:24:25+01:00,['a0ad9f156a122e3e3a073cba0e2b0c39c93c7db5'],52,46,98,1304942,5,0.25,0.25,0,3367
dfd625daa36de2e34e6c596967775394c55bc605,0,Jason Gustafson,2017-09-14 13:39:30-07:00,['2656659e0d7c0e427768ce216df2698acc8c9b11'],73,17,90,1305032,10,0.3125,0.03125,0.5,3367
8a5e86660593eab49c64fdfb5ef090634ae5ae06,1,Ismael Juma,2017-09-15 00:07:17+01:00,['dfd625daa36de2e34e6c596967775394c55bc605'],109,416,525,1305557,20,0.338888889,1,0.616666667,3369
5d2422258cb975a137a42a4e08f03573c49a387e,1,Jason Gustafson,2017-09-14 16:10:19-07:00,['8a5e86660593eab49c64fdfb5ef090634ae5ae06'],273,1362,1635,1307192,22,0.171232877,0.95890411,0.965753425,3369
f6f56a645bb1c5ec6810c024ba517e43bf77056c,1,Ismael Juma,2017-09-15 01:51:35+01:00,['5d2422258cb975a137a42a4e08f03573c49a387e'],128,129,257,1307449,11,1,1,0.6,3369
985cc534a4278b64fc37dc37913ab974266efe43,0,Damian Guy,2017-09-15 11:35:57+01:00,['f6f56a645bb1c5ec6810c024ba517e43bf77056c'],4,7,11,1307460,2,1,1,1,3369
8fca432223da521b78e60e0cf8fa881ced19589c,1,Rajini Sivaram,2017-09-15 17:16:29+01:00,['985cc534a4278b64fc37dc37913ab974266efe43'],165,1017,1182,1308642,29,0.557919622,0.699763593,0.78250591,3372
6055c749899a6d5ae618206548afd1f1e83eb65c,0,Jason Gustafson,2017-09-15 13:51:52-07:00,['8fca432223da521b78e60e0cf8fa881ced19589c'],0,2,2,1308644,1,,,,3372
f305dd68f6524abc25c4ed88983f0e78b4e6c243,1,Damian Guy,2017-09-18 09:53:27+01:00,['6055c749899a6d5ae618206548afd1f1e83eb65c'],391,466,857,1309501,51,0,0.8,0.1,3372
a339a387e0669226bc1537783b3d4c6ea5b9b4c0,1,Ismael Juma,2017-09-18 10:13:28+01:00,['f305dd68f6524abc25c4ed88983f0e78b4e6c243'],3,106,109,1309610,5,0.315789474,0.881578947,0.881578947,3372
a3f068e22da6915cbc473be8da0cfbb229817436,0,Rajini Sivaram,2017-09-18 10:49:12+01:00,['a339a387e0669226bc1537783b3d4c6ea5b9b4c0'],36,20,56,1309666,3,,,,3372
346d0ca5382800f4bbc670b80660408705742392,0,Ismael Juma,2017-09-18 10:52:54+01:00,['a3f068e22da6915cbc473be8da0cfbb229817436'],6,22,28,1309694,1,1,1,1,3372
d83252ebaeeca5bf19584908d95b424beb31b12e,0,Damian Guy,2017-09-18 11:54:14+01:00,['346d0ca5382800f4bbc670b80660408705742392'],99,515,614,1310308,7,1,0.992063492,0.73015873,3373
be6252d8ebdf9cf2d151028a7ba20eb1591b5961,1,Damian Guy,2017-09-18 12:04:56+01:00,['d83252ebaeeca5bf19584908d95b424beb31b12e'],2,2,4,1310312,2,,,,3373
ed0e692147d81e396bf10f4d9425516d51bd52cc,1,Damian Guy,2017-09-18 12:11:56+01:00,['be6252d8ebdf9cf2d151028a7ba20eb1591b5961'],24,91,115,1310427,4,0.195652174,1,1,3373
b363901cbe9451bc5fc7ce55053aab1ffa9d7d49,0,Guozhang Wang,2017-09-18 20:22:24+08:00,['ed0e692147d81e396bf10f4d9425516d51bd52cc'],1,2,3,1310430,1,0,0,1,3373
bd83ae6ba1f887ab112c4ccb2002633dfd387d69,0,Damian Guy,2017-09-18 15:30:25+01:00,['b363901cbe9451bc5fc7ce55053aab1ffa9d7d49'],2,2,4,1310434,1,,,,3373
52d7b6763b7f8ec1973f1bc399d428542e6e962e,0,Ismael Juma,2017-09-18 15:49:44+01:00,['bd83ae6ba1f887ab112c4ccb2002633dfd387d69'],3,4,7,1310441,2,,,,3373
f2b74aa1c36bf2882006c14f7cbd56b493f39d26,1,Damian Guy,2017-09-18 15:53:44+01:00,['52d7b6763b7f8ec1973f1bc399d428542e6e962e'],854,443,1297,1311738,36,0,0,1,3373
ae3eeb3e1c194c60fa62fbc7931566f3d8c87d68,1,Jason Gustafson,2017-09-18 09:00:37-07:00,['f2b74aa1c36bf2882006c14f7cbd56b493f39d26'],179,216,395,1312133,10,1,1,1,3374
4ac7c48e91f37471e83cc82d26b26e5b715e8e80,0,Jason Gustafson,2017-09-18 12:58:30-07:00,['ae3eeb3e1c194c60fa62fbc7931566f3d8c87d68'],2,3,5,1312138,1,,,,3374
f46d414c1643e15bc5b7a152b8df475aacd1e66d,0,Guozhang Wang,2017-09-19 06:36:47+08:00,['4ac7c48e91f37471e83cc82d26b26e5b715e8e80'],1,1,2,1312140,1,1,1,0,3374
d0645aaeefa77e5c4a801002d2bacdc6692dfa63,0,Guozhang Wang,2017-09-19 07:30:16+08:00,['f46d414c1643e15bc5b7a152b8df475aacd1e66d'],1,2,3,1312143,1,,,,3374
a64fe2ed88642bdd6531540e3d67f958deca2891,1,Guozhang Wang,2017-09-19 07:58:06+08:00,['d0645aaeefa77e5c4a801002d2bacdc6692dfa63'],4,6,10,1312153,1,,,,3374
0cf7708007b01faac5012d939f3c50db274f858d,1,Ismael Juma,2017-09-19 05:12:55+01:00,['a64fe2ed88642bdd6531540e3d67f958deca2891'],2956,3243,6199,1318352,113,0.983606557,1,0.741803279,3376
83bdcdbaef4e594ec5aac0736ffce5d0172c1671,1,Ismael Juma,2017-09-19 05:33:02+01:00,['0cf7708007b01faac5012d939f3c50db274f858d'],5,5,10,1318362,1,,,,3376
c8f1471992c98e0104e3a7b2e093adc21b2d2a6f,1,Damian Guy,2017-09-19 10:56:42+01:00,['83bdcdbaef4e594ec5aac0736ffce5d0172c1671'],54,361,415,1318777,7,0.658333333,1,0.866666667,3376
c96f89f845f790d8e7bce45aae6c8c4d15a25660,1,Damian Guy,2017-09-19 12:05:52+01:00,['c8f1471992c98e0104e3a7b2e093adc21b2d2a6f'],14,15,29,1318806,1,0,0,1,3376
5e0bb3df9679797f0036d4718e2c1fd22dbee8f2,0,Ismael Juma,2017-09-19 12:37:11+01:00,['c96f89f845f790d8e7bce45aae6c8c4d15a25660'],1,1,2,1318808,1,,,,3376
92c06cbad591b88e69f416180052a72af455fa30,1,Jason Gustafson,2017-09-19 11:07:32-07:00,['5e0bb3df9679797f0036d4718e2c1fd22dbee8f2'],160,81,241,1319049,21,0,0,0,3376
80e0af50d94ffb99f669e55581d262db5f6dd027,0,Jason Gustafson,2017-09-19 16:01:15-07:00,['92c06cbad591b88e69f416180052a72af455fa30'],1,5,6,1319055,1,0,0,0,3376
bd0146d984dd5df82fb19aa936e8f4ff9ca40030,1,Guozhang Wang,2017-09-20 07:13:03+08:00,['80e0af50d94ffb99f669e55581d262db5f6dd027'],203,251,454,1319509,19,0,0.518518519,0.111111111,3376
398714b75888fca00319493c38c8ead2a02fd7cc,0,Guozhang Wang,2017-09-20 16:50:08+08:00,['bd0146d984dd5df82fb19aa936e8f4ff9ca40030'],21,59,80,1319589,2,,,,3376
c5879059546c2e38cb9dc2b8b4dd884485780059,0,Guozhang Wang,2017-09-20 17:57:07+08:00,['398714b75888fca00319493c38c8ead2a02fd7cc'],0,35,35,1319624,1,,,,3376
37ec15e9627e2fe68d78eb6d95e9a117e3bca320,0,Damian Guy,2017-09-20 12:04:13+01:00,['c5879059546c2e38cb9dc2b8b4dd884485780059'],20,64,84,1319708,1,,,,3376
bb9859720bf88732cb63ec27cfa10d510d767d2b,0,Damian Guy,2017-09-20 12:07:04+01:00,['37ec15e9627e2fe68d78eb6d95e9a117e3bca320'],3,2,5,1319713,2,,,,3376
c82be0f30373dc9b73200d55c66931cd18c22245,0,Ewen Cheslack-Postava,2017-09-20 08:59:05-07:00,['bb9859720bf88732cb63ec27cfa10d510d767d2b'],2,18,20,1319733,5,,,,3380
239dad1b9fb6803842067dd588f679ba6ae5efe7,1,Jason Gustafson,2017-09-20 09:29:39-07:00,['c82be0f30373dc9b73200d55c66931cd18c22245'],51,129,180,1319913,2,0.355263158,0.802631579,0.276315789,3380
552b1707871fd92656debe33b03381f597be2578,1,Ewen Cheslack-Postava,2017-09-20 14:01:43-07:00,['239dad1b9fb6803842067dd588f679ba6ae5efe7'],25,101,126,1320039,9,0.288461538,0.384615385,0.884615385,3380
c2af13ed0eb0c664e944f6e6f27f2b59d003954a,0,Ismael Juma,2017-09-20 22:19:48+01:00,['552b1707871fd92656debe33b03381f597be2578'],1,1,2,1320041,1,,,,3380
69d2a177101eb1c29b59b4c64d8c22f6d5e3d281,1,Rajini Sivaram,2017-09-20 22:51:53+01:00,['c2af13ed0eb0c664e944f6e6f27f2b59d003954a'],59,496,555,1320596,22,0.718894009,0.958525346,0.903225806,3382
94692288bedc353383e014914937a4798a1d4caa,1,Jason Gustafson,2017-09-20 20:31:33-07:00,['69d2a177101eb1c29b59b4c64d8c22f6d5e3d281'],82,651,733,1321329,22,0.093093093,0.891891892,0.927927928,3383
5f6393f9b17cce17ded7a00e439599dfa77deb2d,1,Ismael Juma,2017-09-21 05:06:36+01:00,['94692288bedc353383e014914937a4798a1d4caa'],82,1258,1340,1322669,25,0.3696,0.5136,0.9056,3390
b12ba240e95eacd514bf79e029fbc6b9ed1a1a67,1,Ismael Juma,2017-09-21 08:32:14+01:00,['5f6393f9b17cce17ded7a00e439599dfa77deb2d'],1,1,2,1322671,1,,,,3390
a2da064cbf01558d0af64adc9d6fc9444cd744ec,0,Guozhang Wang,2017-09-21 16:10:17+08:00,['b12ba240e95eacd514bf79e029fbc6b9ed1a1a67'],36,816,852,1323523,10,0.882154882,1,0.828282828,3393
f29391c4902699939cc621b2313f06fce5440691,0,Guozhang Wang,2017-09-21 18:19:24+08:00,['a2da064cbf01558d0af64adc9d6fc9444cd744ec'],1,10,11,1323534,1,,,,3393
96ba21e0dfb1a564d5349179d844f020abf1e08b,1,Ismael Juma,2017-09-21 13:58:43+01:00,['f29391c4902699939cc621b2313f06fce5440691'],73,258,331,1323865,18,0.752136752,0.615384615,0.931623932,3393
a553764c8b1611cafd318022d0fc4a34c861f6ba,1,Ismael Juma,2017-09-21 15:21:09+01:00,['96ba21e0dfb1a564d5349179d844f020abf1e08b'],301,212,513,1324378,16,0,1,0.054054054,3393
afaaea8093d9d4f159cfd68d1f24ee36af3db8a0,0,Ismael Juma,2017-09-21 16:46:10+01:00,['a553764c8b1611cafd318022d0fc4a34c861f6ba'],2,4,6,1324384,1,0,1,1,3393
c8c6ab63248639b167350642efdfc4341fa3ce37,1,Rajini Sivaram,2017-09-21 21:16:57+01:00,['afaaea8093d9d4f159cfd68d1f24ee36af3db8a0'],141,235,376,1324760,19,0.041666667,0.875,0.875,3395
690575ec466b5ef6099c3a731e97d45b28c98b33,1,Jason Gustafson,2017-09-21 13:57:54-07:00,['c8c6ab63248639b167350642efdfc4341fa3ce37'],4,6,10,1324770,2,1,1,1,3395
ea533f0c5e2438f0aef070dbadb023bffb9ce009,0,Jason Gustafson,2017-09-21 14:39:00-07:00,['690575ec466b5ef6099c3a731e97d45b28c98b33'],3,34,37,1324807,4,0,1,1,3395
36afd1095c78b24a0f956ee09bb806e701d6cf18,0,Guozhang Wang,2017-09-22 07:11:06+08:00,['ea533f0c5e2438f0aef070dbadb023bffb9ce009'],1,16,17,1324824,1,,,,3395
402aa093db243965d2b6c04118ac7ee6d196fd45,1,Guozhang Wang,2017-09-22 07:33:50+08:00,['36afd1095c78b24a0f956ee09bb806e701d6cf18'],38,147,185,1325009,3,0,0.764705882,1,3395
7c988a3c8bc9429c1f28f9c29dafed185cec1a67,1,Ewen Cheslack-Postava,2017-09-21 20:12:08-07:00,['402aa093db243965d2b6c04118ac7ee6d196fd45'],39,46,85,1325094,2,0.428571429,0,0.714285714,3395
125d8d6f70829b9a0dbeabfef8f6b2df438dc12b,1,Damian Guy,2017-09-22 13:45:19+01:00,['7c988a3c8bc9429c1f28f9c29dafed185cec1a67'],3,60,63,1325157,2,0.428571429,1,1,3395
e554dc518eaaa0747899e708160275f95c4e525f,1,Ismael Juma,2017-09-22 19:32:09+01:00,['125d8d6f70829b9a0dbeabfef8f6b2df438dc12b'],30,209,239,1325396,4,1,1,1,3397
d60f011d77ce80a44b02d43bf0889a50a8797dcd,1,Ismael Juma,2017-09-22 20:29:25+01:00,['e554dc518eaaa0747899e708160275f95c4e525f'],279,506,785,1326181,13,0.656862745,0.539215686,0.901960784,3398
8f90fd6530ce2c4f7e2fdfe3541c61d0178289d5,1,Jason Gustafson,2017-09-22 13:07:59-07:00,['d60f011d77ce80a44b02d43bf0889a50a8797dcd'],1,32,33,1326214,2,0.037037037,1,1,3398
f4a1ca347bd21cacf5906887f56001bce61c4544,1,Ewen Cheslack-Postava,2017-09-22 13:17:28-07:00,['8f90fd6530ce2c4f7e2fdfe3541c61d0178289d5'],38,711,749,1326963,8,0.711111111,1,0.822222222,3401
71a65d95a257d98925b5f0f6f2227504cf5043a2,0,Ismael Juma,2017-09-22 22:34:11+01:00,['f4a1ca347bd21cacf5906887f56001bce61c4544'],7,7,14,1326977,2,,,,3401
1fd70c7c94b20b82299ac1004e0ee01777b7beab,0,Guozhang Wang,2017-09-23 10:53:10+08:00,['71a65d95a257d98925b5f0f6f2227504cf5043a2'],14,16,30,1327007,2,,,,3402
271f6b5aec885d2eb348dea4de637ac269d3e1ca,1,Guozhang Wang,2017-09-23 12:05:16+08:00,['1fd70c7c94b20b82299ac1004e0ee01777b7beab'],80,103,183,1327190,3,1,1,1,3402
a0f533266a8a51a6288eda64f3a80242af13e2f9,1,Guozhang Wang,2017-09-24 10:08:52+08:00,['271f6b5aec885d2eb348dea4de637ac269d3e1ca'],230,4,234,1327424,3,0.805755396,0.805755396,0.208633094,3402
a96e28eac17f1e80f2dfddb0b491fd4d5da84b2c,1,Guozhang Wang,2017-09-25 16:17:01+08:00,['a0f533266a8a51a6288eda64f3a80242af13e2f9'],1,9,10,1327434,2,,,,3402
852297efd99af04df28710b1b5c99530ab20a072,1,Ismael Juma,2017-09-26 00:13:02+01:00,['a96e28eac17f1e80f2dfddb0b491fd4d5da84b2c'],211,243,454,1327888,21,0.44,1,0,3402
51611b1b7cb61df314b412bf726a696ba3f5b490,0,Ismael Juma,2017-09-26 08:09:12+01:00,['852297efd99af04df28710b1b5c99530ab20a072'],4,39,43,1327931,1,0.909090909,1,1,3402
4e43a7231dafa149de908eac79c437d65a9de4fb,1,Ismael Juma,2017-09-26 08:20:26+01:00,['51611b1b7cb61df314b412bf726a696ba3f5b490'],20,51,71,1328002,3,,,,3402
b8be86b80543e41fd3181a8de8f1a3ac0a72e4c5,0,Damian Guy,2017-09-26 09:42:53+01:00,['4e43a7231dafa149de908eac79c437d65a9de4fb'],42,107,149,1328151,11,0.43902439,1,1,3402
8256f882c92daa1470382502ab94cbe2c16028f1,0,Ismael Juma,2017-09-26 15:02:38+01:00,['b8be86b80543e41fd3181a8de8f1a3ac0a72e4c5'],4,27,31,1328182,2,0.952380952,1,1,3402
73cc416664dbc8e1442f70cb3c4cd8f4d365ea50,1,Ewen Cheslack-Postava,2017-09-26 22:23:37-07:00,['8256f882c92daa1470382502ab94cbe2c16028f1'],85,1567,1652,1329834,22,0.386335404,0.865838509,0.81242236,3407
5b943ca8a9bec9f2c990d9d03fc0f4b7c3e9cca5,0,Damian Guy,2017-09-27 09:26:57+01:00,['73cc416664dbc8e1442f70cb3c4cd8f4d365ea50'],3,4,7,1329841,1,,,,3407
8dfdcfd02c72b3c37ae50ec4da8b76f4a31e45e0,0,Ismael Juma,2017-09-27 16:39:12+01:00,['5b943ca8a9bec9f2c990d9d03fc0f4b7c3e9cca5'],4,10,14,1329855,3,1,1,1,3407
8e0e2a5b238092a3730d22d36046fe078a01c15b,1,Ismael Juma,2017-09-27 17:54:37+01:00,['8dfdcfd02c72b3c37ae50ec4da8b76f4a31e45e0'],207,265,472,1330327,6,1,1,0.896551724,3407
1444b7b594f9c0c426a3631ec43d77b19c8f4373,1,Ewen Cheslack-Postava,2017-09-27 22:07:37-07:00,['8e0e2a5b238092a3730d22d36046fe078a01c15b'],3,126,129,1330456,3,0.781818182,0.890909091,1,3408
e1543a5a8ecbd9da6e39fb0952b1193450b3c931,1,Damian Guy,2017-09-28 10:54:38+01:00,['1444b7b594f9c0c426a3631ec43d77b19c8f4373'],16,66,82,1330538,7,0.46875,0.65625,0.65625,3408
2703fda52a14eeae70b206b19a47c5acd4a83915,1,Ismael Juma,2017-09-28 10:57:53+01:00,['e1543a5a8ecbd9da6e39fb0952b1193450b3c931'],90,69,159,1330697,10,0,0,0,3408
e5f2471c548fc490a42dd0321bcf7fcdd4ddc52d,1,Damian Guy,2017-09-28 11:00:31+01:00,['2703fda52a14eeae70b206b19a47c5acd4a83915'],299,395,694,1331391,48,0.787878788,0.090909091,1,3408
e846daa89b1cbdf7c08f1b719fcf1ffc3885614f,0,Damian Guy,2017-09-28 11:07:54+01:00,['e5f2471c548fc490a42dd0321bcf7fcdd4ddc52d'],12,9,21,1331412,3,,,,3408
983280c454eb1ec4aa8c5c9a1b6bf49ea581ee5b,1,Ismael Juma,2017-09-28 11:18:08+01:00,['e846daa89b1cbdf7c08f1b719fcf1ffc3885614f'],5,11,16,1331428,1,0,0,1,3408
071f9fe1a2fd903336606f9fae735d7f33d2768c,1,Ismael Juma,2017-09-28 11:40:24+01:00,['983280c454eb1ec4aa8c5c9a1b6bf49ea581ee5b'],17,17,34,1331462,4,,,,3408
9d0a89aea5252e5b7ff8deff707547e6a6dbbc4f,0,Damian Guy,2017-09-28 12:53:30+01:00,['071f9fe1a2fd903336606f9fae735d7f33d2768c'],1,1,2,1331464,1,,,,3408
89ba0c1525b8f8a4e36d1e1b486ca660d5c24a7b,1,Ewen Cheslack-Postava,2017-09-28 09:53:19-07:00,['9d0a89aea5252e5b7ff8deff707547e6a6dbbc4f'],11,273,284,1331748,8,0.514084507,0.964788732,0.992957746,3408
dd6347a5df5299efeeae27d5b196182058027502,0,Jason Gustafson,2017-09-28 13:03:07-07:00,['89ba0c1525b8f8a4e36d1e1b486ca660d5c24a7b'],50,74,124,1331872,1,0.928571429,1,0,3408
021d8a8e9698dce454e0e801092460b98f0a8a4d,1,Ismael Juma,2017-09-28 21:58:59+01:00,['dd6347a5df5299efeeae27d5b196182058027502'],243,1544,1787,1333659,103,0.597560976,0.921409214,0.766937669,3413
a86873be50b3bf1585098a13b2ce710a717c0321,1,Ismael Juma,2017-09-29 03:20:36+01:00,['021d8a8e9698dce454e0e801092460b98f0a8a4d'],108,112,220,1333879,4,0.538461538,0.076923077,0,3413
177dd7f210c7783b49f47de1c7028c9830d3d795,1,Rajini Sivaram,2017-09-29 09:53:32+01:00,['a86873be50b3bf1585098a13b2ce710a717c0321'],38,59,97,1333976,6,0,0,1,3413
eaabb6cd0173c4f6854eb5da39194a7e3fc0162c,1,Damian Guy,2017-09-29 10:00:13+01:00,['177dd7f210c7783b49f47de1c7028c9830d3d795'],170,479,649,1334625,15,0.386363636,0.856060606,0.765151515,3415
b79b179716b5f8bacb870a53a5a9216a0687b3c9,0,Damian Guy,2017-09-29 10:21:57+01:00,['eaabb6cd0173c4f6854eb5da39194a7e3fc0162c'],30,30,60,1334685,2,0,0,,3415
082def05ca5af4f30e05aa28ba83fa299f30337b,0,Damian Guy,2017-09-29 11:06:34+01:00,['b79b179716b5f8bacb870a53a5a9216a0687b3c9'],6,26,32,1334717,8,1,1,1,3415
36556b8041d3647375380e6fd70b8f37ba572ddc,1,Damian Guy,2017-09-29 11:11:12+01:00,['082def05ca5af4f30e05aa28ba83fa299f30337b'],13,100,113,1334830,8,0.171875,0.703125,0.984375,3415
3107a6c5c8d1358b8e705c5d5a16b7441d2225a6,1,Damian Guy,2017-09-29 15:07:41+01:00,['36556b8041d3647375380e6fd70b8f37ba572ddc'],15,101,116,1334946,3,0,1,1,3415
0ef960304b6b81c1b725bf8e036f20d295045c4a,1,Ismael Juma,2017-09-29 15:11:29+01:00,['3107a6c5c8d1358b8e705c5d5a16b7441d2225a6'],50,89,139,1335085,5,0.296296296,1,1,3415
4f4f99532557439c6e85b18a23df59c2ae45a71b,1,Ismael Juma,2017-10-01 01:29:33+01:00,['0ef960304b6b81c1b725bf8e036f20d295045c4a'],9,9,18,1335103,3,,,,3415
39d5cdcccfc0f7d7893188bb22580da0c842a993,0,Damian Guy,2017-10-02 11:49:22-07:00,['4f4f99532557439c6e85b18a23df59c2ae45a71b'],6,24,30,1335133,7,,,,3415
cdbf806e2d03594161a18d9a7484a74dfed05a3e,1,Jason Gustafson,2017-10-02 12:46:05-07:00,['39d5cdcccfc0f7d7893188bb22580da0c842a993'],8,21,29,1335162,1,,,,3415
cc84686a4aa24e541f7ca5ee9dcb0dea0ddbd79a,0,Damian Guy,2017-10-02 13:20:49-07:00,['cdbf806e2d03594161a18d9a7484a74dfed05a3e'],116,128,244,1335406,1,,,,3415
f9865d52e81bbdddb7889d6c3cc7be537e610826,1,Damian Guy,2017-10-02 13:47:45-07:00,['cc84686a4aa24e541f7ca5ee9dcb0dea0ddbd79a'],372,615,987,1336393,6,0.18699187,0.788617886,1,3417
e110e1c1ea6a365bcde07a1ee3fe466a6fde1541,1,Ismael Juma,2017-10-02 22:35:55+01:00,['f9865d52e81bbdddb7889d6c3cc7be537e610826'],145,232,377,1336770,9,0.245283019,1,0.716981132,3417
a1a5e93beb16e38cf997554a7819a0b92c6661e5,1,Jun Rao,2017-10-02 22:24:09-07:00,['e110e1c1ea6a365bcde07a1ee3fe466a6fde1541'],106,106,212,1336982,20,,,,3417
716330a5b2f629e6bb0316b5f036837660916a0e,0,Ismael Juma,2017-10-03 11:27:22+01:00,['a1a5e93beb16e38cf997554a7819a0b92c6661e5'],2,4,6,1336988,2,,,,3417
3dcbbf703017985c9e212ad69cc7afdddbf358eb,0,Damian Guy,2017-10-03 07:35:42-07:00,['716330a5b2f629e6bb0316b5f036837660916a0e'],266,288,554,1337542,20,,,,3417
42b356500b7188eb2507f9b48399d5491a7eff16,1,Jason Gustafson,2017-10-03 08:37:30-07:00,['3dcbbf703017985c9e212ad69cc7afdddbf358eb'],27,65,92,1337634,5,0.647058824,0.823529412,0.705882353,3417
9e35a2aa78dc7785d08565ade8a44edaebbfd930,0,Ewen Cheslack-Postava,2017-10-03 10:25:09-07:00,['42b356500b7188eb2507f9b48399d5491a7eff16'],75,75,150,1337784,1,,,,3417
5663f51edfeb8f642fe74955021d6f38e9d9abe4,1,Jason Gustafson,2017-10-03 10:44:11-07:00,['9e35a2aa78dc7785d08565ade8a44edaebbfd930'],2,6,8,1337792,1,0,1,1,3417
05357b7030c784a6548453f533d3c00e19548ba2,1,Ewen Cheslack-Postava,2017-10-03 11:52:14-07:00,['5663f51edfeb8f642fe74955021d6f38e9d9abe4'],34,540,574,1338366,6,0.253424658,0.988584475,0.99086758,3417
cbef33f3d0bc686e1258352cd5e13143b3f09d78,1,Jun Rao,2017-10-03 17:11:21-07:00,['05357b7030c784a6548453f533d3c00e19548ba2'],109,181,290,1338656,13,0.019607843,0.019607843,0.803921569,3417
28aaba2818053ffc36b1ae65b7714638ef41b91e,1,Ismael Juma,2017-10-04 08:06:05+01:00,['cbef33f3d0bc686e1258352cd5e13143b3f09d78'],27,90,117,1338773,6,0.384615385,1,1,3417
a202da742d1c372d5391b37a9734694c27c6c071,0,Rajini Sivaram,2017-10-04 10:25:08-04:00,['28aaba2818053ffc36b1ae65b7714638ef41b91e'],0,5,5,1338778,1,,,,3417
c4b8a7eab4e0bf387efba02986d5b9d1bf914038,0,Rajini Sivaram,2017-10-04 10:53:18-04:00,['a202da742d1c372d5391b37a9734694c27c6c071'],0,3,3,1338781,1,,,,3417
198302feecf17cd1eff38e6d93e807d7b04922f2,1,Jason Gustafson,2017-10-04 08:50:56-07:00,['c4b8a7eab4e0bf387efba02986d5b9d1bf914038'],5,134,139,1338920,2,0.02247191,0.02247191,1,3417
5383f9bed0ec4fda86b74a94d9d1ba595a2a1c8a,1,Jason Gustafson,2017-10-04 09:20:21-07:00,['198302feecf17cd1eff38e6d93e807d7b04922f2'],130,116,246,1339166,90,,,,3417
5afeddaa99c48ac827d1cade7812deb83b1f80bd,0,Damian Guy,2017-10-04 10:11:11-07:00,['5383f9bed0ec4fda86b74a94d9d1ba595a2a1c8a'],1,23,24,1339190,2,1,1,1,3417
9949e1ed1be8293ba60dcab10345fbcce8d61e36,1,Rajini Sivaram,2017-10-04 13:44:46-04:00,['5afeddaa99c48ac827d1cade7812deb83b1f80bd'],22,74,96,1339286,9,0.894736842,0.894736842,0.368421053,3417
2a1b39ef1b65a4de4f3813bc749458f9fd6a1e38,1,Ismael Juma,2017-10-04 18:55:46+01:00,['9949e1ed1be8293ba60dcab10345fbcce8d61e36'],64,78,142,1339428,17,0.5,1,1,3417
c6e5a32d0464622ced4b7887923ca37c717b9e74,1,Ismael Juma,2017-10-04 18:57:31+01:00,['2a1b39ef1b65a4de4f3813bc749458f9fd6a1e38'],157,302,459,1339887,9,0.275862069,0.287356322,1,3417
11afff09908035166febf9b75c410112693ff98c,1,Ewen Cheslack-Postava,2017-10-04 11:05:50-07:00,['c6e5a32d0464622ced4b7887923ca37c717b9e74'],259,454,713,1340600,13,0.079545455,1,1,3418
d985513b2236af6070bc8187db63eac08845ab3f,1,Guozhang Wang,2017-10-04 11:28:59-07:00,['11afff09908035166febf9b75c410112693ff98c'],28,37,65,1340665,4,,,,3418
f8621b4174ddb14f9e8377da34e81e1b7ddd205f,1,Jason Gustafson,2017-10-04 11:35:37-07:00,['d985513b2236af6070bc8187db63eac08845ab3f'],50,105,155,1340820,13,0.632653061,1,1,3418
ac7695c32a4d8424bafcb8eb5409a4a4ad752c4a,0,Ewen Cheslack-Postava,2017-10-04 11:44:15-07:00,['f8621b4174ddb14f9e8377da34e81e1b7ddd205f'],1,2,3,1340823,1,,,,3418
93b71e7deeb9d5c705d654443147f90e45cb11c8,1,Guozhang Wang,2017-10-04 12:19:40-07:00,['ac7695c32a4d8424bafcb8eb5409a4a4ad752c4a'],17,28,45,1340868,3,0,1,1,3418
06738b41bc2447211d901d09aade7aadd0df6254,0,Guozhang Wang,2017-10-04 12:42:07-07:00,['93b71e7deeb9d5c705d654443147f90e45cb11c8'],8,77,85,1340953,4,,,,3418
51c652c40cb8a775b40374e968ed35bec5378906,1,Rajini Sivaram,2017-10-04 17:37:26-04:00,['06738b41bc2447211d901d09aade7aadd0df6254'],5,9,14,1340967,3,0,1,1,3418
713a67fddaec3fa9cd7cce53dd6fef5ab6e0cdab,1,Guozhang Wang,2017-10-04 14:42:07-07:00,['51c652c40cb8a775b40374e968ed35bec5378906'],284,394,678,1341645,36,0,1,0.777777778,3418
5792f2fb3db69333bfd22b57b00b42336dc16aa9,0,Guozhang Wang,2017-10-04 15:10:59-07:00,['713a67fddaec3fa9cd7cce53dd6fef5ab6e0cdab'],4,11,15,1341660,1,1,1,0,3418
6bcbd17d3481b3396a9907cf21c617e87edbbd40,0,Guozhang Wang,2017-10-04 15:36:19-07:00,['5792f2fb3db69333bfd22b57b00b42336dc16aa9'],6,6,12,1341672,6,,,,3418
20d9adb173a0cde010a2502da7415ecda9bcaa80,1,Jun Rao,2017-10-04 17:12:53-07:00,['6bcbd17d3481b3396a9907cf21c617e87edbbd40'],28,72,100,1341772,12,0,0.92,1,3418
b5b266eeeccc18c5cfbd37fa59ab5d9cf3676e34,0,Jun Rao,2017-10-04 17:37:35-07:00,['20d9adb173a0cde010a2502da7415ecda9bcaa80'],3,8,11,1341783,1,1,1,1,3418
6ea4fffdd287a0c6a02c1b6dc1006b1a7b614405,1,Jason Gustafson,2017-10-04 22:27:03-07:00,['b5b266eeeccc18c5cfbd37fa59ab5d9cf3676e34'],61,134,195,1341978,6,0.473684211,1,0.912280702,3418
e61002e2ab70454304e12f2834cbbcb4bed002d7,1,Damian Guy,2017-10-05 08:23:15-07:00,['6ea4fffdd287a0c6a02c1b6dc1006b1a7b614405'],17,154,171,1342149,5,0.313953488,1,1,3418
e40b3a2e74133de6d60599beefb65407ca4cc7dd,1,Rajini Sivaram,2017-10-05 12:25:34-04:00,['e61002e2ab70454304e12f2834cbbcb4bed002d7'],21,38,59,1342208,3,1,1,1,3418
ff5fc9dd1eb3f8f42011ef0fd05ba56e836566d2,0,Guozhang Wang,2017-10-05 09:30:38-07:00,['e40b3a2e74133de6d60599beefb65407ca4cc7dd'],3,3,6,1342214,2,,,,3418
a47bfbcae050659d32f777ed2f4b26dda5fbdbbd,1,Ewen Cheslack-Postava,2017-10-05 11:23:11-07:00,['ff5fc9dd1eb3f8f42011ef0fd05ba56e836566d2'],145,704,849,1343063,13,0.174603175,0.989417989,0.738095238,3418
f29203d022f110761415c9a2ae2c149b4bc5dd21,1,Jun Rao,2017-10-05 13:31:18-07:00,['a47bfbcae050659d32f777ed2f4b26dda5fbdbbd'],2,2,4,1343067,2,,,,3418
196bcfca0c56420793f85514d1602bde564b0651,1,Guozhang Wang,2017-10-05 17:02:53-07:00,['f29203d022f110761415c9a2ae2c149b4bc5dd21'],10,7,17,1343084,5,1,0,1,3418
974d6fec93b779cd2f9036d0ea89cf1b0917de7b,0,Ewen Cheslack-Postava,2017-10-06 11:42:04-07:00,['196bcfca0c56420793f85514d1602bde564b0651'],0,37,37,1343121,1,0,1,0.966666667,3418
fb6ca658d699d41fb9e6a647e92b1382ea1aaa65,0,Guozhang Wang,2017-10-06 12:35:19-07:00,['974d6fec93b779cd2f9036d0ea89cf1b0917de7b'],6,2,8,1343129,1,0,0,0,3418
10cd98cc894b88c5d1e24fc54c66361ad9914df2,1,Jason Gustafson,2017-10-06 12:51:30-07:00,['fb6ca658d699d41fb9e6a647e92b1382ea1aaa65'],127,145,272,1343401,7,0,0.222222222,1,3418
105ab47ed90c8a0e83c159c97a8f2294c5582657,1,Jason Gustafson,2017-10-06 15:01:29-07:00,['10cd98cc894b88c5d1e24fc54c66361ad9914df2'],7,157,164,1343565,5,0.226804124,0.989690722,0.989690722,3418
23a014052d39521a3af471b3f95809c2164820f7,1,Guozhang Wang,2017-10-06 15:38:23-07:00,['105ab47ed90c8a0e83c159c97a8f2294c5582657'],154,330,484,1344049,24,0,1,0.633333333,3420
2427a44768f9734179c957b645df0476e7cb6d05,1,Guozhang Wang,2017-10-06 15:42:18-07:00,['23a014052d39521a3af471b3f95809c2164820f7'],5,5,10,1344059,2,,,,3420
91517e8fbd7767ba6d7f43b517f5a26b6f870585,1,Jason Gustafson,2017-10-06 16:45:45-07:00,['2427a44768f9734179c957b645df0476e7cb6d05'],252,401,653,1344712,20,0,1,0.922222222,3420
51063441d3ed4dec8a96794f085028b4b8feb20c,1,Guozhang Wang,2017-10-06 17:48:34-07:00,['91517e8fbd7767ba6d7f43b517f5a26b6f870585'],69,166,235,1344947,6,0.634408602,0.161290323,0.602150538,3420
e2e8d4a57a83693b946c3e26f9be2e41a7341ab4,0,Guozhang Wang,2017-10-06 17:57:32-07:00,['51063441d3ed4dec8a96794f085028b4b8feb20c'],19,23,42,1344989,1,,,,3420
a1ea5360631f4366ba536fca37d9f906b0e58a5c,1,Guozhang Wang,2017-10-06 19:59:03-07:00,['e2e8d4a57a83693b946c3e26f9be2e41a7341ab4'],22,74,96,1345085,3,0,0.893617021,1,3420
6d6080f13633508c57e48cbc12788ce643af4953,1,Guozhang Wang,2017-10-09 09:28:42-07:00,['a1ea5360631f4366ba536fca37d9f906b0e58a5c'],46,125,171,1345256,11,1,1,0.836363636,3420
f4ac68a400a8289704a5888bf62f1d93e7aee99d,0,Jason Gustafson,2017-10-09 13:21:04-07:00,['6d6080f13633508c57e48cbc12788ce643af4953'],198,182,380,1345636,16,1,1,1,3420
1f64942021bd8fe0f2791700fb402cfac1acc9de,0,Jason Gustafson,2017-10-09 14:33:24-07:00,['f4ac68a400a8289704a5888bf62f1d93e7aee99d'],5,5,10,1345646,1,,,,3420
b411f57c1ce82d66ec2c837349a54357b322e803,0,Jason Gustafson,2017-10-09 17:57:13-07:00,['1f64942021bd8fe0f2791700fb402cfac1acc9de'],2,10,12,1345658,2,1,1,1,3420
29c46ddb91fac8c0fb3f35c1511e2afdcf67fd2e,1,Jun Rao,2017-10-10 08:29:17-07:00,['b411f57c1ce82d66ec2c837349a54357b322e803'],6,41,47,1345705,5,0,0.875,0.9375,3420
64930cd71361853cc46ed02232213cc7ba749e77,0,Guozhang Wang,2017-10-10 10:03:02-07:00,['29c46ddb91fac8c0fb3f35c1511e2afdcf67fd2e'],1,24,25,1345730,1,0.75,0,1,3420
90b5ce3f04626ee24aebd1d06588489180a4bb05,1,Jason Gustafson,2017-10-10 10:32:17-07:00,['64930cd71361853cc46ed02232213cc7ba749e77'],32,109,141,1345871,6,0,0.595744681,0.723404255,3420
1027ff3c769906b7b80582217cf5b4703fd6864d,1,Jason Gustafson,2017-10-10 15:01:10-07:00,['90b5ce3f04626ee24aebd1d06588489180a4bb05'],128,96,224,1346095,8,1,1,0.647058824,3420
dac990aab31ab13ed08a6818e1516f4dd25331dd,0,Guozhang Wang,2017-10-10 15:07:53-07:00,['1027ff3c769906b7b80582217cf5b4703fd6864d'],1,1,2,1346097,1,,,,3420
a5a9a901ef78373cda4b743323ef9f6e6da0dbf6,0,Guozhang Wang,2017-10-10 15:13:19-07:00,['dac990aab31ab13ed08a6818e1516f4dd25331dd'],19,63,82,1346179,3,0,1,1,3420
c22c1775a550dbefe6bd4cdcf8820404351257a8,1,Guozhang Wang,2017-10-10 15:16:53-07:00,['a5a9a901ef78373cda4b743323ef9f6e6da0dbf6'],16,18,34,1346213,1,1,0,1,3420
54ed3435bf0660295b0f0fee0df4c9761873225c,0,Guozhang Wang,2017-10-11 14:20:41-07:00,['c22c1775a550dbefe6bd4cdcf8820404351257a8'],7,7,14,1346227,1,,,,3420
7d6ca52a2751908c7fc6b752d70dfaaaaa9bbe8c,1,Rajini Sivaram,2017-10-11 17:32:40-04:00,['54ed3435bf0660295b0f0fee0df4c9761873225c'],198,206,404,1346631,24,0,1,0,3420
f6e724b127891bc950499fd7a6876e500ba78de3,1,Guozhang Wang,2017-10-11 15:16:12-07:00,['7d6ca52a2751908c7fc6b752d70dfaaaaa9bbe8c'],266,328,594,1347225,1,,,,3420
bdf8e211ecb50a24071390d493cf1c1732f7346d,0,Ismael Juma,2017-10-12 10:05:14+01:00,['f6e724b127891bc950499fd7a6876e500ba78de3'],2,11,13,1347238,1,0,1,1,3420
bfa82fc0b63a5ad0121da6e2190a587eb672a1d5,0,Ismael Juma,2017-10-12 10:09:16+01:00,['bdf8e211ecb50a24071390d493cf1c1732f7346d'],1,1,2,1347240,1,,,,3420
57839e17cf6ea287e5e16a5fa22b077e0d01854e,1,Ismael Juma,2017-10-12 10:12:46+01:00,['bfa82fc0b63a5ad0121da6e2190a587eb672a1d5'],3,3,6,1347246,1,,,,3420
f8ffb67ad6e630a2e3350f74c108154267b85c98,0,Ismael Juma,2017-10-12 14:23:03+01:00,['57839e17cf6ea287e5e16a5fa22b077e0d01854e'],1,1,2,1347248,1,,,,3420
76a45e0dceb256a8bd46867ad3127d99716b4f64,0,Ismael Juma,2017-10-12 14:28:55+01:00,['f8ffb67ad6e630a2e3350f74c108154267b85c98'],12,10,22,1347270,3,,,,3420
62682d07885fe8b15d3e4874d58f9e5174c96edf,0,Ismael Juma,2017-10-12 15:37:02+01:00,['76a45e0dceb256a8bd46867ad3127d99716b4f64'],8,10,18,1347288,2,1,1,1,3420
53c23bb5e65c147d7b2cae0a7fd9b3ba46c8fce5,1,Damian Guy,2017-10-12 15:55:43+01:00,['62682d07885fe8b15d3e4874d58f9e5174c96edf'],13,102,115,1347403,2,0.64516129,1,0.790322581,3420
31fe1f98e2f19074360e85c8ec839356238f0b29,0,Guozhang Wang,2017-10-12 14:19:41-07:00,['53c23bb5e65c147d7b2cae0a7fd9b3ba46c8fce5'],3,3,6,1347409,1,,,,3420
34188b4cc4703f6919526ae10b7185842d1047b4,0,Jason Gustafson,2017-10-12 16:54:26-07:00,['31fe1f98e2f19074360e85c8ec839356238f0b29'],0,6,6,1347415,1,1,1,1,3420
9806c1b176a8a07016ad18e0a6843cc486e52cc6,0,Guozhang Wang,2017-10-12 22:52:54-07:00,['34188b4cc4703f6919526ae10b7185842d1047b4'],10,96,106,1347521,3,0.918918919,0.972972973,1,3421
a51e3bf5e61e37177bd61d385332f97021a8face,0,Ismael Juma,2017-10-13 12:24:54+01:00,['9806c1b176a8a07016ad18e0a6843cc486e52cc6'],19,2,21,1347542,1,1,1,1,3421
f5341c9f350e6a3320faa0689cb4e2757898af58,0,Ismael Juma,2017-10-13 12:26:24+01:00,['a51e3bf5e61e37177bd61d385332f97021a8face'],1,1,2,1347544,1,,,,3421
c2d9a2f307ce0b221c915030a1b3831aa4d3763c,0,Jason Gustafson,2017-10-13 14:25:00-07:00,['f5341c9f350e6a3320faa0689cb4e2757898af58'],0,1,1,1347545,1,1,1,1,3421
ef4914520019e941827dac8eda6000a82cb74cc5,1,Guozhang Wang,2017-10-16 16:50:59-07:00,['c2d9a2f307ce0b221c915030a1b3831aa4d3763c'],14,40,54,1347599,5,,,,3421
7a14663929ba1111ba05b57e47cf96fc55891a36,1,Guozhang Wang,2017-10-16 17:38:31-07:00,['ef4914520019e941827dac8eda6000a82cb74cc5'],1,1,2,1347601,1,,,,3421
f931febc8c4b74baa522a593f16df84a0b05bd99,0,Jason Gustafson,2017-10-16 17:49:35-07:00,['7a14663929ba1111ba05b57e47cf96fc55891a36'],7,7,14,1347615,5,,,,3421
6c416aceeb172dc6b0103855f3c1ecbfc9f4d411,0,Guozhang Wang,2017-10-16 18:01:32-07:00,['f931febc8c4b74baa522a593f16df84a0b05bd99'],0,33,33,1347648,2,1,1,1,3421
9c346ddc724d04a1e3d87baf6785c03a5909b161,0,Ismael Juma,2017-10-17 11:21:34+01:00,['6c416aceeb172dc6b0103855f3c1ecbfc9f4d411'],3,5,8,1347656,1,,,,3421
5cc162f30eca28f699a622671669fefba56fb447,1,Jun Rao,2017-10-17 08:35:18-07:00,['9c346ddc724d04a1e3d87baf6785c03a5909b161'],523,1406,1929,1349585,45,0.187613843,0.663023679,0.741347905,3423
68f324f4bf0003d5dcfd79c5ab7f9c53bd0c1522,0,Damian Guy,2017-10-18 09:44:39+01:00,['5cc162f30eca28f699a622671669fefba56fb447'],4,11,15,1349600,2,1,1,1,3423
b71ee043f8959ee0d4699071ba8fc1e2c5675842,1,Jun Rao,2017-10-18 09:14:59-07:00,['68f324f4bf0003d5dcfd79c5ab7f9c53bd0c1522'],1609,3163,4772,1354372,20,0.68988955,0.898045879,1,3428
5c1a85caa074267fd84a2fed3662cbe1af93738d,0,Jun Rao,2017-10-18 09:59:13-07:00,['b71ee043f8959ee0d4699071ba8fc1e2c5675842'],4,8,12,1354384,2,1,1,1,3428
6cb649b56b1194f4f1cf080d4596244119c3ce78,1,Ismael Juma,2017-10-18 22:15:22+01:00,['5c1a85caa074267fd84a2fed3662cbe1af93738d'],14,5,19,1354403,7,0.5,0.25,0.5,3428
7fdafda9796fc8033c5f77bf19be17be462e1b4e,0,Ismael Juma,2017-10-19 10:35:18+01:00,['6cb649b56b1194f4f1cf080d4596244119c3ce78'],1,1,2,1354405,1,,,,3428
249e398bf84cdd475af6529e163e78486b43c570,1,Damian Guy,2017-10-19 15:40:26+01:00,['7fdafda9796fc8033c5f77bf19be17be462e1b4e'],2,46,48,1354453,2,1,1,1,3428
60c36b098444a07ca2e6ada57642660598a7e3f4,0,Jason Gustafson,2017-10-19 08:42:12-07:00,['249e398bf84cdd475af6529e163e78486b43c570'],1,1,2,1354455,1,,,,3428
561dd3864d89db58bd3cbdd64480f12fa7249f1f,0,Jason Gustafson,2017-10-19 13:11:51-07:00,['60c36b098444a07ca2e6ada57642660598a7e3f4'],9,8,17,1354472,2,,,,3428
5ec6765bdbe136951d737f30b5da62b07cc5cc68,1,Ewen Cheslack-Postava,2017-10-19 14:24:57-07:00,['561dd3864d89db58bd3cbdd64480f12fa7249f1f'],2,209,211,1354683,2,0.950980392,0.950980392,1,3428
fdbd4d62f30991db7e7ce8ee9004a0431c8c226e,1,Jun Rao,2017-10-19 18:48:54-07:00,['5ec6765bdbe136951d737f30b5da62b07cc5cc68'],20,20,40,1354723,2,1,0,1,3428
9be71f7bdcd147aee7a360a4ccf400acb858a056,0,Ewen Cheslack-Postava,2017-10-19 19:37:52-07:00,['fdbd4d62f30991db7e7ce8ee9004a0431c8c226e'],18,104,122,1354845,5,0.864864865,1,1,3428
efefb452df0d60ae427c708cc7da312217bbe647,1,Guozhang Wang,2017-10-21 20:18:20-07:00,['9be71f7bdcd147aee7a360a4ccf400acb858a056'],59,161,220,1355065,20,0.04,0.14,0.86,3428
b1cd6c530119f5d97a1801b8983166248573481a,1,Ismael Juma,2017-10-22 08:44:08+01:00,['efefb452df0d60ae427c708cc7da312217bbe647'],588,714,1302,1356367,10,0,0.833333333,0.875,3429
86cd558b3345879429ba177de8ff5b40e1219e73,0,Ismael Juma,2017-10-23 00:54:44+01:00,['b1cd6c530119f5d97a1801b8983166248573481a'],2,2,4,1356371,1,,,,3429
c216adb4bbf8306977380a1ec371380e30137765,0,Damian Guy,2017-10-23 10:33:51+01:00,['86cd558b3345879429ba177de8ff5b40e1219e73'],0,6,6,1356377,1,,,,3429
580390b78cd490b3bc3372cd86f9089aa9890508,0,Ismael Juma,2017-10-23 11:39:39+01:00,['c216adb4bbf8306977380a1ec371380e30137765'],1,1,2,1356379,1,,,,3429
021f2e7e246268da46be80fd87d76bb9961b93d8,1,Ismael Juma,2017-10-23 12:07:58+01:00,['580390b78cd490b3bc3372cd86f9089aa9890508'],0,181,181,1356560,1,0.268041237,1,1,3430
6fc5732259d76603c37524d588b1429b42c8a5d5,1,Ismael Juma,2017-10-23 14:49:01+01:00,['021f2e7e246268da46be80fd87d76bb9961b93d8'],3,5,8,1356568,1,,,,3430
277fc927c0d6c2699b64a5a54461fb96a50f58ae,1,Ismael Juma,2017-10-23 15:52:30+01:00,['6fc5732259d76603c37524d588b1429b42c8a5d5'],11,96,107,1356675,3,0.678571429,1,1,3430
a3c4ab24278d8d5dfc662bc276ceba8ec6fe0a90,0,Ismael Juma,2017-10-23 16:38:39+01:00,['277fc927c0d6c2699b64a5a54461fb96a50f58ae'],1,1,2,1356677,1,,,,3430
d3f24798f92a6e4d6038d28b63daf3ac9d14fcbf,1,Guozhang Wang,2017-10-23 12:35:31-07:00,['a3c4ab24278d8d5dfc662bc276ceba8ec6fe0a90'],87,70,157,1356834,8,1,0.041666667,0,3430
b281015c150cb95c4205ff6a8d8945b86fc94d4b,1,Guozhang Wang,2017-10-23 16:12:54-07:00,['d3f24798f92a6e4d6038d28b63daf3ac9d14fcbf'],8,27,35,1356869,3,0,0,1,3430
c504b22841b1066c0d46183adb22f48596479d7e,0,Ismael Juma,2017-10-24 01:13:06+01:00,['b281015c150cb95c4205ff6a8d8945b86fc94d4b'],1,1,2,1356871,1,,,,3430
5f779ca3f38a1149aea1219ed4a91c677955101d,0,Guozhang Wang,2017-10-25 10:11:09-07:00,['c504b22841b1066c0d46183adb22f48596479d7e'],1,1,2,1356873,1,,,,3430
f7f8e11213ed2228e6f6a4baa7d4cf0653aad19e,0,Ewen Cheslack-Postava,2017-10-25 13:34:36-07:00,['5f779ca3f38a1149aea1219ed4a91c677955101d'],4,8,12,1356885,2,1,1,1,3430
ab6f848ba6cafaed3d75b54005c954733f0d1735,1,Jun Rao,2017-10-25 21:11:16-07:00,['f7f8e11213ed2228e6f6a4baa7d4cf0653aad19e'],334,371,705,1357590,30,1,1,1,3430
070ec0fc586958f260f71558171abfd0d447290d,1,Ismael Juma,2017-10-26 14:23:00+01:00,['ab6f848ba6cafaed3d75b54005c954733f0d1735'],10,21,31,1357621,3,,,,3430
adb9d5ae7671c5befa615e369c97a701d7dfb58b,0,Ismael Juma,2017-10-26 14:24:29+01:00,['070ec0fc586958f260f71558171abfd0d447290d'],1,1,2,1357623,1,,,,3430
ea6a67af70c6ee811154ab947ce947e1bc0c3a20,0,Guozhang Wang,2017-10-26 13:27:08-07:00,['adb9d5ae7671c5befa615e369c97a701d7dfb58b'],1,6,7,1357630,2,0,1,1,3430
ebe749b4ee941be9baed90349b72931a041a480f,1,Guozhang Wang,2017-10-26 13:46:11-07:00,['ea6a67af70c6ee811154ab947ce947e1bc0c3a20'],3,4,7,1357637,1,,,,3430
69e8463c06b51299f16b30274da1026febebaecc,0,Ismael Juma,2017-10-27 02:56:19+01:00,['ebe749b4ee941be9baed90349b72931a041a480f'],4,53,57,1357694,3,0.266666667,1,0.966666667,3430
501a5e262702bcc043724cb9e1f536e16a66399e,1,Guozhang Wang,2017-10-26 23:26:33-07:00,['69e8463c06b51299f16b30274da1026febebaecc'],41,156,197,1357891,7,0.069444444,0.194444444,0.777777778,3430
6197481b8be0dcf259e4a6f08fa78f120bed5b60,0,Ismael Juma,2017-10-27 14:10:56+01:00,['501a5e262702bcc043724cb9e1f536e16a66399e'],4,6,10,1357901,1,,,,3430
4ea5fb760f571fd3e4be14cbd3828f65830a314e,0,Ismael Juma,2017-10-27 14:26:58+01:00,['6197481b8be0dcf259e4a6f08fa78f120bed5b60'],1,1,2,1357903,1,,,,3430
9b53c31d0854f02139acbd39c33f17ac4886914d,0,Ismael Juma,2017-10-27 14:41:46+01:00,['4ea5fb760f571fd3e4be14cbd3828f65830a314e'],2,0,2,1357905,1,,,,3430
603d4e5d9c6ae8f0283c39f412eb81b8b82d802a,0,Ismael Juma,2017-10-27 14:59:56+01:00,['9b53c31d0854f02139acbd39c33f17ac4886914d'],4,8,12,1357917,1,,,,3430
4e8ad90b94f28affd8e29db136df5e6e7c6c6c15,1,Ismael Juma,2017-10-27 15:49:42+01:00,['603d4e5d9c6ae8f0283c39f412eb81b8b82d802a'],44,39,83,1358000,2,0.857142857,0,0,3430
f4e9c84c52fbb7ec6a4ca50c9ac35cacbd0df082,1,Ismael Juma,2017-10-27 16:40:39+01:00,['4e8ad90b94f28affd8e29db136df5e6e7c6c6c15'],91,26,117,1358117,3,1,1,0.02173913,3430
9504af72ff915f5e82833fd96b57dc00e5825925,1,Jun Rao,2017-10-30 09:46:11-07:00,['f4e9c84c52fbb7ec6a4ca50c9ac35cacbd0df082'],17,201,218,1358335,6,0.854545455,0.863636364,0.709090909,3431
6118ecb590afed5fd41376b521a5dffe522f3c07,0,Jason Gustafson,2017-10-30 09:57:06-07:00,['9504af72ff915f5e82833fd96b57dc00e5825925'],1,1,2,1358337,1,,,,3431
8e4b3dca7b1bcef0e4875fea4fa79377998616c3,1,Jason Gustafson,2017-10-30 11:06:11-07:00,['6118ecb590afed5fd41376b521a5dffe522f3c07'],13,38,51,1358388,2,0,1,1,3431
7fe88e8bd9acedcb74a4b3e61440f61481b60711,1,Jason Gustafson,2017-10-30 11:31:36-07:00,['8e4b3dca7b1bcef0e4875fea4fa79377998616c3'],22,30,52,1358440,12,0.333333333,0.666666667,0.166666667,3431
c7ab3efcbe5d34c28e19a5a6a59962c2abfd2235,1,Guozhang Wang,2017-10-30 13:13:19-07:00,['7fe88e8bd9acedcb74a4b3e61440f61481b60711'],158,263,421,1358861,16,0.210526316,0.964912281,0.771929825,3431
71fe23b445e242ca0f03f06aa8dad96e610db00b,0,Jason Gustafson,2017-10-31 09:43:18-07:00,['c7ab3efcbe5d34c28e19a5a6a59962c2abfd2235'],37,168,205,1359066,8,0.709090909,1,1,3433
3c9e30a2f71c83b7efd45a65ffb5df5a80f48d19,1,Jason Gustafson,2017-10-31 09:57:05-07:00,['71fe23b445e242ca0f03f06aa8dad96e610db00b'],42,45,87,1359153,3,1,1,0.2,3433
51787027159f6f206df928a5c8bd2a18bacd3d5c,0,Guozhang Wang,2017-10-31 13:22:56-07:00,['3c9e30a2f71c83b7efd45a65ffb5df5a80f48d19'],16,37,53,1359206,1,,,,3433
f88fdbd3115cdb0f1bd26817513f3d33359512b1,1,Jun Rao,2017-10-31 18:06:51-07:00,['51787027159f6f206df928a5c8bd2a18bacd3d5c'],53,210,263,1359469,12,0.505494505,0.681318681,0.681318681,3433
554e0b529884e0dd6b4968a0fc58b02f58e95a07,0,Rajini Sivaram,2017-11-02 22:41:29+00:00,['f88fdbd3115cdb0f1bd26817513f3d33359512b1'],21,0,21,1359490,3,,,,3433
b6765e46c8f85b6f9ba9600da753cc7638aa1027,0,Guozhang Wang,2017-11-02 17:50:13-07:00,['554e0b529884e0dd6b4968a0fc58b02f58e95a07'],1,1,2,1359492,1,,,,3433
e4208b1d5fa1c28ac7e64e2cb039404a14084dc0,0,Guozhang Wang,2017-11-02 17:53:15-07:00,['b6765e46c8f85b6f9ba9600da753cc7638aa1027'],2,14,16,1359508,5,0,1,1,3433
4fac83ba1f80353e9544b15b95b8da9dc557041d,1,Rajini Sivaram,2017-11-03 09:37:29+00:00,['e4208b1d5fa1c28ac7e64e2cb039404a14084dc0'],2121,3976,6097,1365605,74,0.569707401,1,0.736660929,3462
487436b1a46b728904e543456c8bcc0d3ceea55a,0,Guozhang Wang,2017-11-03 08:51:44-07:00,['4fac83ba1f80353e9544b15b95b8da9dc557041d'],27,34,61,1365666,3,,,,3462
520b3136280dc3dd427e773b882290ffff51d59a,1,Guozhang Wang,2017-11-03 10:10:35-07:00,['487436b1a46b728904e543456c8bcc0d3ceea55a'],3,13,16,1365682,1,,,,3462
86062e9a78dccad74e012f11755025512ad5cf63,0,Jiangjie Qin,2017-11-05 18:00:43-08:00,['520b3136280dc3dd427e773b882290ffff51d59a'],54,55,109,1365791,40,,,,3462
7672e9ec3def7af6797bc0ecf254ac694efdfad5,0,Rajini Sivaram,2017-11-06 15:59:23+00:00,['86062e9a78dccad74e012f11755025512ad5cf63'],2,13,15,1365806,3,1,1,1,3462
0c895706e8ab511efe352a824a0c9e2dab62499e,0,Jiangjie Qin,2017-11-06 09:28:29-08:00,['7672e9ec3def7af6797bc0ecf254ac694efdfad5'],5,17,22,1365828,1,0.857142857,0.857142857,0.857142857,3462
d637ad0dafb727bb73c63f1b187d9f83abcd4ec1,1,Guozhang Wang,2017-11-06 10:26:52-08:00,['0c895706e8ab511efe352a824a0c9e2dab62499e'],304,278,582,1366410,16,0.934782609,0,0.086956522,3464
2b5a21395cf8ce6e3e29a9a778bc20f727ec35fd,1,Guozhang Wang,2017-11-06 10:50:57-08:00,['d637ad0dafb727bb73c63f1b187d9f83abcd4ec1'],70,86,156,1366566,2,0,0,0,3464
6f96d7f1735c53b97ebac43168ded64007277beb,1,Ismael Juma,2017-11-06 21:37:55+00:00,['2b5a21395cf8ce6e3e29a9a778bc20f727ec35fd'],62,194,256,1366822,5,0.075949367,1,1,3464
58138126ce93efc48291fe444f554eabdf4a5609,1,Onur Karaman,2017-11-06 16:46:31-08:00,['6f96d7f1735c53b97ebac43168ded64007277beb'],35,87,122,1366944,6,0.352941176,0.970588235,1,3464
3735a6ca8b6432db2de4a0bd07df9301459bbf0b,1,Ismael Juma,2017-11-07 09:55:44+00:00,['58138126ce93efc48291fe444f554eabdf4a5609'],404,356,760,1367704,21,0.848484848,0,0.272727273,3464
9b44c3e7f89b55528b12ba280007c804682beb0b,1,Jun Rao,2017-11-08 09:34:43-08:00,['3735a6ca8b6432db2de4a0bd07df9301459bbf0b'],241,593,834,1368538,16,0.881773399,0.891625616,1,3464
ee1aaa091fc68587635604de5006b7acdb160361,1,Guozhang Wang,2017-11-08 15:07:14-08:00,['9b44c3e7f89b55528b12ba280007c804682beb0b'],2,46,48,1368586,4,0.310344828,1,1,3464
fef80c8636d03a25a3b17f31d9cf2ab9b98f385f,0,Ismael Juma,2017-11-09 00:57:15+00:00,['ee1aaa091fc68587635604de5006b7acdb160361'],23,45,68,1368654,2,1,1,0,3464
4a55818bbfb8d104b1ef34c5b9d96184e8187c5c,0,Ismael Juma,2017-11-09 14:23:54+00:00,['fef80c8636d03a25a3b17f31d9cf2ab9b98f385f'],1,1,2,1368656,1,,,,3464
fe3171844b599a3e6c0cfe1e606a21eb4ef32ce6,1,Ismael Juma,2017-11-09 15:17:52+00:00,['4a55818bbfb8d104b1ef34c5b9d96184e8187c5c'],36,69,105,1368761,15,1,0.333333333,1,3464
0653a895f51492a8687aaba0dc7a43b21fca2a56,1,Ismael Juma,2017-11-09 16:03:24+00:00,['fe3171844b599a3e6c0cfe1e606a21eb4ef32ce6'],15,117,132,1368893,5,0.202531646,0.797468354,0.696202532,3464
718dda1144629d824f4bdb8ff73fbd531a22723a,1,Ewen Cheslack-Postava,2017-11-09 09:42:46-08:00,['0653a895f51492a8687aaba0dc7a43b21fca2a56'],50,924,974,1369867,13,0.525274725,0.771428571,0.92967033,3467
e23de3caee3eb31a5d43a8869e6d28e25ea720d4,0,Guozhang Wang,2017-11-09 09:46:47-08:00,['718dda1144629d824f4bdb8ff73fbd531a22723a'],166,0,166,1370033,1,0.953125,0,0,3467
3e86161b8446e0b8f1c4fe537f1c7d65692b6a73,0,Ismael Juma,2017-11-09 18:24:48+00:00,['e23de3caee3eb31a5d43a8869e6d28e25ea720d4'],5,5,10,1370043,4,,,,3467
564d7b365d102ffbeb24e2421ab6319db311e6b5,1,Onur Karaman,2017-11-09 13:51:32-08:00,['3e86161b8446e0b8f1c4fe537f1c7d65692b6a73'],75,65,140,1370183,3,0,0,0,3467
66cab2f7fb72417f9bf8759fccb26dfdb33ac6ce,1,Guozhang Wang,2017-11-09 15:35:00-08:00,['564d7b365d102ffbeb24e2421ab6319db311e6b5'],6,93,99,1370282,3,0,1,0.587301587,3467
12af521c487a146456442f895b9fc99a45ed100f,1,Jiangjie Qin,2017-11-09 22:08:03-08:00,['66cab2f7fb72417f9bf8759fccb26dfdb33ac6ce'],41,76,117,1370399,4,0.65,1,1,3467
84ddff6792a2082a1940664d42f5b03edc617c31,1,Guozhang Wang,2017-11-09 22:43:59-08:00,['12af521c487a146456442f895b9fc99a45ed100f'],1,1,2,1370401,1,,,,3467
14e3ed048c96bc441f5fc5c893833f705fd53241,0,Ismael Juma,2017-11-10 08:35:40+00:00,['84ddff6792a2082a1940664d42f5b03edc617c31'],0,14,14,1370415,1,,,,3468
b9039bbd4b3d8eb231c9f2d1d40042706f8f4f19,1,Ismael Juma,2017-11-10 09:44:43+00:00,['14e3ed048c96bc441f5fc5c893833f705fd53241'],19,20,39,1370454,2,0,0,0,3468
50a44ee6a5c5024e1761529ebd41d884acec328f,0,Ismael Juma,2017-11-10 10:41:28+00:00,['b9039bbd4b3d8eb231c9f2d1d40042706f8f4f19'],0,1,1,1370455,1,,,,3468
d04daf570ec4064ae6b3fe5f60f6ce6e0df7ecbc,0,Ismael Juma,2017-11-10 12:34:21+00:00,['50a44ee6a5c5024e1761529ebd41d884acec328f'],6,12,18,1370473,2,0,0,0,3468
3cfbb25c616bee44ac181e9320d4fd6d79ab9c58,1,Rajini Sivaram,2017-11-15 09:54:42+00:00,['d04daf570ec4064ae6b3fe5f60f6ce6e0df7ecbc'],11,37,48,1370521,5,0.866666667,0.866666667,1,3468
f300480f882e8b17999e1172bfbec0f13c71eda7,1,Ismael Juma,2017-11-15 13:37:07+00:00,['3cfbb25c616bee44ac181e9320d4fd6d79ab9c58'],223,175,398,1370919,3,1,0,0.027027027,3468
1756a22f7923766175ee4f90bed074cf1b60f932,1,Guozhang Wang,2017-11-15 11:40:39-08:00,['f300480f882e8b17999e1172bfbec0f13c71eda7'],42,4,46,1370965,1,1,0,0,3468
54371e63d3c703c932777c2c0f95700c8cb5ba61,0,Ewen Cheslack-Postava,2017-11-15 13:27:58-08:00,['1756a22f7923766175ee4f90bed074cf1b60f932'],8,21,29,1370994,1,1,1,1,3468
48f5f048bc6fd5e059cd1311eb8428f0c1f088e8,1,Guozhang Wang,2017-11-15 14:32:00-08:00,['54371e63d3c703c932777c2c0f95700c8cb5ba61'],12,17,29,1371023,1,,,,3468
dc2322a272c3093b3a65910fc35c383c7bb40fab,0,Guozhang Wang,2017-11-15 14:36:05-08:00,['48f5f048bc6fd5e059cd1311eb8428f0c1f088e8'],3,1,4,1371027,2,1,1,0,3468
ca7f3dab0485158cf91b20d8a4b7164dbcdd3a64,0,Guozhang Wang,2017-11-15 14:43:11-08:00,['dc2322a272c3093b3a65910fc35c383c7bb40fab'],4,106,110,1371137,4,,,,3468
cdcbd9283ddea0207dad7a9f534a534a463f01f4,0,Ismael Juma,2017-11-16 01:21:11+00:00,['ca7f3dab0485158cf91b20d8a4b7164dbcdd3a64'],58,115,173,1371310,4,0.113636364,1,1,3469
9eabcc20d2dc9529b64f3967222fdd30a65dc961,0,Ismael Juma,2017-11-16 01:41:50+00:00,['cdcbd9283ddea0207dad7a9f534a534a463f01f4'],4,4,8,1371318,1,,,,3469
539c4d53f8fac65063e4e519c6a51911550a151f,1,Guozhang Wang,2017-11-15 17:43:35-08:00,['9eabcc20d2dc9529b64f3967222fdd30a65dc961'],32,120,152,1371470,3,0.440677966,1,0.796610169,3469
53c5ccb33401b772678e9d1ef3bebd5784e22814,1,Guozhang Wang,2017-11-16 09:52:33-08:00,['539c4d53f8fac65063e4e519c6a51911550a151f'],10,587,597,1372067,8,0.214532872,0.726643599,1,3473
d9cbc6b1a28e2fb3f88137429e08c12201998bc7,1,Rajini Sivaram,2017-11-16 17:59:24+00:00,['53c5ccb33401b772678e9d1ef3bebd5784e22814'],1,747,748,1372815,10,0.763313609,1,0.831360947,3480
00261215436e50fa894f765c1b123f9a780380b1,0,Ewen Cheslack-Postava,2017-11-16 15:04:27-08:00,['d9cbc6b1a28e2fb3f88137429e08c12201998bc7'],6,6,12,1372827,3,,,,3480
ad71b9d068f63b2e64bcce72c557115efd2cc1ca,0,Ismael Juma,2017-11-17 12:20:33+00:00,['00261215436e50fa894f765c1b123f9a780380b1'],1,1,2,1372829,1,,0,,3480
406071c2b5c06b25f9167ffd566325fdb65b268d,0,Ismael Juma,2017-11-17 15:18:48+00:00,['ad71b9d068f63b2e64bcce72c557115efd2cc1ca'],18,8,26,1372855,1,1,1,0,3480
b604540fbde818025afac85c3e96be76f212503e,0,Guozhang Wang,2017-11-17 11:49:09-08:00,['406071c2b5c06b25f9167ffd566325fdb65b268d'],2,11,13,1372868,1,,,,3480
40fd9fa98105111bca373e76f8f39914cade709b,1,Guozhang Wang,2017-11-18 14:54:01-08:00,['b604540fbde818025afac85c3e96be76f212503e'],178,350,528,1373396,33,0,0.379562044,1,3480
83b8cf96f92242d61db9e87aafce1e8dc457c1a1,0,Guozhang Wang,2017-11-19 10:54:50-08:00,['40fd9fa98105111bca373e76f8f39914cade709b'],1,1,2,1373398,1,,,,3480
e3c32391f95d82a217295c7e4c1519981124bc3f,1,Guozhang Wang,2017-11-20 11:25:22-08:00,['83b8cf96f92242d61db9e87aafce1e8dc457c1a1'],93,172,265,1373663,8,1,1,0.782608696,3480
f0276f5ca2ebed2848055ccec875181f5db7ba51,0,Ewen Cheslack-Postava,2017-11-20 20:29:33-08:00,['e3c32391f95d82a217295c7e4c1519981124bc3f'],6,22,28,1373691,1,0,0,1,3480
a133e69b458cae25f997680e577a930c06961ecb,1,Ismael Juma,2017-11-21 14:39:14+00:00,['f0276f5ca2ebed2848055ccec875181f5db7ba51'],9,30,39,1373730,3,1,1,1,3480
fd8eb268d655e00fd1f5e41452a2a30e81daa244,0,Ewen Cheslack-Postava,2017-11-21 14:26:32-08:00,['a133e69b458cae25f997680e577a930c06961ecb'],4,10,14,1373744,1,1,1,1,3480
049342e440a5ca045771f3eb5b4c72d3e52ffac6,1,Ewen Cheslack-Postava,2017-11-21 16:01:16-08:00,['fd8eb268d655e00fd1f5e41452a2a30e81daa244'],50,134,184,1373928,11,0,0.452380952,1,3480
cfa6a78c7c2529839d2f3cb1129098f2e552fd72,0,Ewen Cheslack-Postava,2017-11-21 16:07:06-08:00,['049342e440a5ca045771f3eb5b4c72d3e52ffac6'],0,8,8,1373936,2,,,,3480
225b0b9c712deb3c29f8bca300ba9f73d1084e81,1,Guozhang Wang,2017-11-21 17:55:30-08:00,['cfa6a78c7c2529839d2f3cb1129098f2e552fd72'],22,12,34,1373970,3,1,1,0,3480
80038e6d205a037ee969f1c5839ec03925cd8ba4,0,Damian Guy,2017-11-22 10:53:32+00:00,['225b0b9c712deb3c29f8bca300ba9f73d1084e81'],0,1,1,1373971,1,0,0,0,3480
ed8b0315a6c3705b2a163ce3ab4723234779264f,1,Ismael Juma,2017-11-22 15:06:56+00:00,['80038e6d205a037ee969f1c5839ec03925cd8ba4'],223,218,441,1374412,39,0.016129032,0,0,3481
c5f31fe3840e87fbdda63444ef285ede840744cf,1,Ewen Cheslack-Postava,2017-11-22 09:54:06-08:00,['ed8b0315a6c3705b2a163ce3ab4723234779264f'],4,52,56,1374468,2,0.307692308,1,0.923076923,3481
bc852baffbf602ead9cb719a01747de414940d53,1,Jun Rao,2017-11-22 13:25:52-08:00,['c5f31fe3840e87fbdda63444ef285ede840744cf'],389,1459,1848,1376316,43,0.54311649,0.84720121,0.792738275,3483
67ba4c4eaed830df3132aea2b50bca076be4edd2,0,Ismael Juma,2017-11-23 14:23:43+00:00,['bc852baffbf602ead9cb719a01747de414940d53'],1,1,2,1376318,1,,,,3483
90da94c3848531e638f31231ea3068fabf4cc8dd,1,Ismael Juma,2017-11-23 14:37:07+00:00,['67ba4c4eaed830df3132aea2b50bca076be4edd2'],4,3,7,1376325,1,,,,3483
062c5568e13ecde4585dae8aeb38ff103632111e,1,Ismael Juma,2017-11-23 14:46:21+00:00,['90da94c3848531e638f31231ea3068fabf4cc8dd'],2,15,17,1376342,1,,,,3483
ac17ab4f09082579d0a239b3b7aac6e2ce342d84,1,Ismael Juma,2017-11-23 16:39:59+00:00,['062c5568e13ecde4585dae8aeb38ff103632111e'],139,132,271,1376613,6,0.5,0.5,0,3483
0bc2d0e02aaea5b2517c40f7a76654460467177c,1,Ismael Juma,2017-11-24 11:25:31+00:00,['ac17ab4f09082579d0a239b3b7aac6e2ce342d84'],108,79,187,1376800,15,1,0.222222222,0.222222222,3483
49b773bfc814ac9606419c0e8dfdc877dc4ba99b,1,Ismael Juma,2017-11-24 18:02:52+00:00,['0bc2d0e02aaea5b2517c40f7a76654460467177c'],1,3,4,1376804,1,,,,3483
be2918b3a04f669a1264f5d1b0be3cdb6915b2fa,1,Ismael Juma,2017-11-24 20:00:00+00:00,['49b773bfc814ac9606419c0e8dfdc877dc4ba99b'],27,144,171,1376975,9,0.479452055,0.657534247,1,3484
5a2960f811c27f59d78dfdb99c7c3c6eeed16c4b,1,Ewen Cheslack-Postava,2017-11-25 17:50:17-08:00,['be2918b3a04f669a1264f5d1b0be3cdb6915b2fa'],9,22,31,1377006,2,1,1,1,3484
8f6a372eed3655b3823ac6372821d138879e9d9f,0,Guozhang Wang,2017-11-26 11:33:49-08:00,['5a2960f811c27f59d78dfdb99c7c3c6eeed16c4b'],1,2,3,1377009,1,1,1,1,3484
5df1eee7d689e18ac2f7b74410e7a30159d3afdc,1,Guozhang Wang,2017-11-28 09:37:27-08:00,['8f6a372eed3655b3823ac6372821d138879e9d9f'],1485,912,2397,1379406,25,0.985680191,0.071599045,0.054892601,3484
1a1d923f252e9b1576dad6f7285f237feb064f64,0,Guozhang Wang,2017-11-28 11:08:42-08:00,['5df1eee7d689e18ac2f7b74410e7a30159d3afdc'],6,30,36,1379442,2,0,1,1,3484
58877a0deacd6c13436af83ef5be1a6f75a3ac4a,1,Rajini Sivaram,2017-11-28 22:09:55+00:00,['1a1d923f252e9b1576dad6f7285f237feb064f64'],4,1054,1058,1380500,11,0.597785978,0.837638376,0.833948339,3493
0cc32abc17d26c5faf6fdc3b63a01016e05a65b9,1,Guozhang Wang,2017-11-29 10:55:43-08:00,['58877a0deacd6c13436af83ef5be1a6f75a3ac4a'],19,589,608,1381108,26,0.474226804,0.894329897,1,3493
b512cd474c6ebfbbbe0192764cec3413a94baba0,1,Guozhang Wang,2017-11-29 11:20:29-08:00,['0cc32abc17d26c5faf6fdc3b63a01016e05a65b9'],14,81,95,1381203,3,0.517857143,0.553571429,1,3493
38c5d7fba7387b797a10c9c6ed71bf99c6d417bc,1,Jason Gustafson,2017-11-29 16:22:07-08:00,['b512cd474c6ebfbbbe0192764cec3413a94baba0'],35,123,158,1381361,4,0,0.774193548,0.774193548,3493
bc2c17a9b85c8cba546ec41129de8055d46f740d,1,Ismael Juma,2017-11-30 12:17:34+02:00,['38c5d7fba7387b797a10c9c6ed71bf99c6d417bc'],73,80,153,1381514,6,0,0,,3493
18e34482e685098ebef90233d78ae803f906633a,0,Ewen Cheslack-Postava,2017-11-30 13:51:19-08:00,['bc2c17a9b85c8cba546ec41129de8055d46f740d'],1,1,2,1381516,1,,,,3493
d01f01ec63f61bd4742f02abff2ab6cf339e2897,1,Jason Gustafson,2017-12-01 11:32:44-08:00,['18e34482e685098ebef90233d78ae803f906633a'],121,232,353,1381869,7,0.677419355,1,1,3493
8c1e1cf27a58d7433c0230ff2b8ecefb30f73fd0,0,Jason Gustafson,2017-12-01 13:01:18-08:00,['d01f01ec63f61bd4742f02abff2ab6cf339e2897'],2,2,4,1381873,1,,,,3493
d1e0443bac769c10598bbdeddf6d7e06f2fdf7e4,0,Guozhang Wang,2017-12-01 14:39:46-08:00,['8c1e1cf27a58d7433c0230ff2b8ecefb30f73fd0'],2,4,6,1381879,2,,,,3493
2d8918b1aec2601a66e9321da4460a8826b88139,0,Guozhang Wang,2017-12-01 23:52:25-08:00,['d1e0443bac769c10598bbdeddf6d7e06f2fdf7e4'],6,10,16,1381895,2,0.875,1,1,3493
9204197abf2e13d345ad6ee6a7f827268a49ebca,1,Guozhang Wang,2017-12-03 09:05:18-08:00,['2d8918b1aec2601a66e9321da4460a8826b88139'],9,24,33,1381928,2,0,1,1,3493
39c438ec1f0830e8a651315cb24059ae290645ea,1,Guozhang Wang,2017-12-04 09:56:34-08:00,['9204197abf2e13d345ad6ee6a7f827268a49ebca'],2,2,4,1381932,2,,,,3493
4b8a29f12a142d02be0b64eac71975b6a129d04a,1,Guozhang Wang,2017-12-04 10:21:42-08:00,['39c438ec1f0830e8a651315cb24059ae290645ea'],671,725,1396,1383328,21,1,0,0,3494
078fd2136524409711e535544ac8960135064df3,0,Ismael Juma,2017-12-06 15:56:56+02:00,['4b8a29f12a142d02be0b64eac71975b6a129d04a'],3,119,122,1383450,12,1,1,1,3494
fd8f182cc4ea80c6d394ca68a47c0ee26b114ebe,1,Ismael Juma,2017-12-06 16:27:21+02:00,['078fd2136524409711e535544ac8960135064df3'],26,30,56,1383506,3,1,1,1,3494
30f08d158a97e0d83b59e5910fbb0a84c5c6d14f,1,Guozhang Wang,2017-12-06 11:38:38-08:00,['fd8f182cc4ea80c6d394ca68a47c0ee26b114ebe'],101,835,936,1384442,9,0.537525355,0.888438134,0.657200811,3495
b6909339876ca1cbcce28043c4b42f2c7e48307b,0,Rajini Sivaram,2017-12-06 19:43:29+00:00,['30f08d158a97e0d83b59e5910fbb0a84c5c6d14f'],30,39,69,1384511,1,0.375,0.375,1,3495
d543e19a09ed34ccb6fa435d430c2c715c3c7098,1,Ismael Juma,2017-12-06 22:18:41+02:00,['b6909339876ca1cbcce28043c4b42f2c7e48307b'],89,135,224,1384735,8,1,0,1,3495
b00a9fc7c3b62506262cbd759c35d58ad99eb17a,1,Ismael Juma,2017-12-07 01:13:40+02:00,['d543e19a09ed34ccb6fa435d430c2c715c3c7098'],55,90,145,1384880,14,0.666666667,0.75,1,3495
b73c765d7e172de4742a3aa023d5a0a4b7387247,1,Ismael Juma,2017-12-07 02:38:34+02:00,['b00a9fc7c3b62506262cbd759c35d58ad99eb17a'],201,271,472,1385352,18,0.6,0.98,1,3495
86e2bc937ae012c726f8e99daf02a1a2a5cc4a3f,0,Ismael Juma,2017-12-07 10:36:47+02:00,['b73c765d7e172de4742a3aa023d5a0a4b7387247'],0,1,1,1385353,1,,,,3495
234ec8a8af76bfb7874dd99714a65089d6048953,1,Guozhang Wang,2017-12-07 16:16:54-08:00,['86e2bc937ae012c726f8e99daf02a1a2a5cc4a3f'],871,744,1615,1386968,23,0,0,1,3496
2bf2348b5fc9f9f62bee5b91a431b8703a20cdbb,1,Rajini Sivaram,2017-12-08 10:54:31+00:00,['234ec8a8af76bfb7874dd99714a65089d6048953'],15,76,91,1387059,3,0.6,1,1,3496
043951753b6fb6c8bae6d25d7a6a97e74b614cac,1,Damian Guy,2017-12-11 14:20:10+00:00,['2bf2348b5fc9f9f62bee5b91a431b8703a20cdbb'],267,862,1129,1388188,30,0.04,0.731764706,0.804705882,3497
e5741b90cde98052c6f9172e12b8f06facb6e977,0,Jason Gustafson,2017-12-11 11:13:57-08:00,['043951753b6fb6c8bae6d25d7a6a97e74b614cac'],2,2,4,1388192,1,,,,3497
72eec0a04c782d8dbe93314cd4c2e62fbd3a73c3,0,Guozhang Wang,2017-12-11 18:55:13-08:00,['e5741b90cde98052c6f9172e12b8f06facb6e977'],1,1,2,1388194,1,,,,3497
a5cd34d7962ff5da9b99d0229ef5a9a5fcb3f318,1,Ismael Juma,2017-12-12 10:00:05+02:00,['72eec0a04c782d8dbe93314cd4c2e62fbd3a73c3'],329,513,842,1389036,19,0.727272727,0.715909091,0.465909091,3498
651c6e480a233ce374bc0a9128f0398d18de7898,0,Ismael Juma,2017-12-12 12:05:11+02:00,['a5cd34d7962ff5da9b99d0229ef5a9a5fcb3f318'],21,78,99,1389135,7,0.090909091,1,0.909090909,3498
0a508a436c928c0440e8b90dda98c22dc0ec244c,1,Ismael Juma,2017-12-12 18:34:03+02:00,['651c6e480a233ce374bc0a9128f0398d18de7898'],112,187,299,1389434,20,0,1,0.931034483,3498
b08882213489706c663785f2c94d76584ba6e856,1,Jason Gustafson,2017-12-12 15:47:57-08:00,['0a508a436c928c0440e8b90dda98c22dc0ec244c'],11,82,93,1389527,4,0.404255319,0.276595745,0.978723404,3498
fe3699ce3362c8942f96e52281a2bd0fc1bda032,0,Guozhang Wang,2017-12-12 19:13:39-08:00,['b08882213489706c663785f2c94d76584ba6e856'],1,1,2,1389529,1,,,,3498
d1a9252ca1808711882ae4c3043b0576620f8177,1,Guozhang Wang,2017-12-12 19:25:01-08:00,['fe3699ce3362c8942f96e52281a2bd0fc1bda032'],5,52,57,1389586,2,0,1,1,3498
1cf7ec87d3afeaab7b4f40d387d34e91e9616e64,1,Guozhang Wang,2017-12-14 09:51:56-08:00,['d1a9252ca1808711882ae4c3043b0576620f8177'],0,19,19,1389605,3,1,1,1,3498
616321bcb618b57d063273df7764058dbd2b7a9c,0,Jason Gustafson,2017-12-14 14:50:34-08:00,['1cf7ec87d3afeaab7b4f40d387d34e91e9616e64'],67,9,76,1389681,9,0,0,0,3498
68712dcdec6e15f24f720f094ccc504ae7829b30,0,Jason Gustafson,2017-12-14 15:26:20-08:00,['616321bcb618b57d063273df7764058dbd2b7a9c'],2,51,53,1389734,2,0,1,1,3498
69777260e05ab12ee8480c23cd2e6acc6e218a12,1,Damian Guy,2017-12-15 12:53:17+00:00,['68712dcdec6e15f24f720f094ccc504ae7829b30'],61,350,411,1390145,15,0.827586207,0.99137931,0.698275862,3501
529786638baeb4335065df4e2b240aad42caca9a,1,Jason Gustafson,2017-12-15 10:26:00-08:00,['69777260e05ab12ee8480c23cd2e6acc6e218a12'],174,764,938,1391083,4,0.540942928,0.749379653,1,3501
e5daa40e316261e8e6cb8866ad9a4eedcf17f919,0,Jun Rao,2017-12-15 14:48:30-08:00,['529786638baeb4335065df4e2b240aad42caca9a'],86,140,226,1391309,9,0.458333333,0.458333333,1,3501
e86f70ed20b2d2415f3f01497fd85a7f6c2ac2e8,0,Guozhang Wang,2017-12-18 11:10:03-08:00,['e5daa40e316261e8e6cb8866ad9a4eedcf17f919'],4,29,33,1391342,3,,,,3501
066bfc314c912aa90283a1c1c53a958237d1adff,1,Jason Gustafson,2017-12-18 11:15:09-08:00,['e86f70ed20b2d2415f3f01497fd85a7f6c2ac2e8'],12,121,133,1391475,4,0.363636364,0.893939394,0.848484848,3501
22f742cdd2899b76c1b4222863ee02ad3bc749a1,0,Guozhang Wang,2017-12-18 17:34:50-08:00,['066bfc314c912aa90283a1c1c53a958237d1adff'],10,43,53,1391528,1,0.681818182,0.681818182,0.681818182,3501
9aad649fd0defa4b55f305e3e025883ebb567b34,1,Guozhang Wang,2017-12-18 17:39:25-08:00,['22f742cdd2899b76c1b4222863ee02ad3bc749a1'],14,12,26,1391554,2,0,0,0,3501
88c2b6849a5af2af74972c8b2e8431473542ca83,1,Ismael Juma,2017-12-19 15:15:27+00:00,['9aad649fd0defa4b55f305e3e025883ebb567b34'],7,83,90,1391644,2,,,,3501
f3b9afe62265d7559ef65f5aa692feecc5fa8f25,1,Guozhang Wang,2017-12-19 15:37:21-08:00,['88c2b6849a5af2af74972c8b2e8431473542ca83'],0,267,267,1391911,4,0.452380952,0.587301587,0.96031746,3503
82c6d429e70f1c782103953072dc6dbec650dd6e,1,Guozhang Wang,2017-12-19 16:05:42-08:00,['f3b9afe62265d7559ef65f5aa692feecc5fa8f25'],273,736,1009,1392920,23,0.496688742,0.841059603,1,3507
cdb39554527a59d436d5b6b26967f14adfae072f,0,Ismael Juma,2017-12-20 12:01:36+00:00,['82c6d429e70f1c782103953072dc6dbec650dd6e'],3,7,10,1392930,1,0,1,1,3507
35c1be74694745a4e5ee861b6340eb832a3ada34,1,Ismael Juma,2017-12-20 13:37:42+00:00,['cdb39554527a59d436d5b6b26967f14adfae072f'],0,50,50,1392980,1,,,,3507
488ea4b9fd797b5edd58c6f9685d70acd15e3e74,1,Jun Rao,2017-12-20 12:19:36-08:00,['35c1be74694745a4e5ee861b6340eb832a3ada34'],420,489,909,1393889,17,1,1,1,3507
760d86a970d20643f1b8f71e78c60a7ad2be7003,1,Rajini Sivaram,2017-12-20 21:35:33+00:00,['488ea4b9fd797b5edd58c6f9685d70acd15e3e74'],156,1041,1197,1395086,22,0.486284289,0.663341646,0.695760599,3516
9cacb92d13468803d219f8331c6e4402444abc1a,1,Guozhang Wang,2017-12-20 15:22:06-08:00,['760d86a970d20643f1b8f71e78c60a7ad2be7003'],68,109,177,1395263,2,0.230769231,0.974358974,0.333333333,3516
dca1474b4b33b85dba461c61568b86b17d6be18f,0,Guozhang Wang,2017-12-20 18:02:33-08:00,['9cacb92d13468803d219f8331c6e4402444abc1a'],83,7,90,1395353,4,0.62295082,0.655737705,0,3516
7d6f6f7320f2058d1108224eefe615e333955721,0,Guozhang Wang,2017-12-20 18:44:36-08:00,['dca1474b4b33b85dba461c61568b86b17d6be18f'],1,1,2,1395355,1,,,,3516
3e2fe17c084370d81ffd35a03a5ed463945ee263,1,Guozhang Wang,2017-12-21 11:15:54-08:00,['7d6f6f7320f2058d1108224eefe615e333955721'],3038,6553,9591,1404946,38,,,,3546
9fcb0017d7b8d0a2d31a615235e82f9c0ebdc38f,0,GitHub,2017-12-22 01:19:13+00:00,['3e2fe17c084370d81ffd35a03a5ed463945ee263'],2,2,4,1404950,1,,,,3546
43aaa7c3631ed7240f0e0dbd1eda90cf85811605,0,Ismael Juma,2017-12-22 01:52:12+00:00,['9fcb0017d7b8d0a2d31a615235e82f9c0ebdc38f'],1,1,2,1404952,1,,,,3546
27c2c81663d6518a3da5cfde88109f90ded8a6db,1,Ismael Juma,2017-12-22 10:28:57+00:00,['43aaa7c3631ed7240f0e0dbd1eda90cf85811605'],291,340,631,1405583,17,1,1,0.945454545,3546
2652565d429138c5841f254afef3cfd689315dbb,1,GitHub,2017-12-22 18:41:22+00:00,['27c2c81663d6518a3da5cfde88109f90ded8a6db'],17,17,34,1405617,4,,,,3546
0538f15ac36358937eb7a3167ea99f7a668797e0,0,Jason Gustafson,2017-12-22 11:41:21-08:00,['2652565d429138c5841f254afef3cfd689315dbb'],7,22,29,1405646,7,1,1,1,3546
5995453f4cd69036f0bed77afb19ff505c903dc9,1,Guozhang Wang,2017-12-22 11:53:04-08:00,['0538f15ac36358937eb7a3167ea99f7a668797e0'],36,58,94,1405740,2,,,,3546
5fc3fd48b0f43056e524b4c0f35aea3e3f9653e8,0,Jason Gustafson,2017-12-22 18:37:36-08:00,['5995453f4cd69036f0bed77afb19ff505c903dc9'],20,20,40,1405780,1,0,0,0,3546
89b245baa7963e908d5f22d6f53c34f14690af67,1,Ismael Juma,2017-12-27 16:30:02+00:00,['5fc3fd48b0f43056e524b4c0f35aea3e3f9653e8'],453,455,908,1406688,73,0,0,0,3546
a3aea3cf4dbedb293f2d7859e0298bebc8e2185f,0,Jason Gustafson,2017-12-28 10:21:43-08:00,['89b245baa7963e908d5f22d6f53c34f14690af67'],14,13,27,1406715,2,1,1,0,3546
2bc780b959cad59b51d26562bd2f801432e05e2a,0,Ismael Juma,2017-12-29 12:39:18+00:00,['a3aea3cf4dbedb293f2d7859e0298bebc8e2185f'],7,8,15,1406730,3,,,,3546
2cefe3f0d0f5567b54f3ca5883726fec4f5756eb,0,Ismael Juma,2017-12-29 12:44:08+00:00,['2bc780b959cad59b51d26562bd2f801432e05e2a'],0,4,4,1406734,1,,,,3546
5d4965bad4ea4a64d798f1cc0271de8d4e3d4289,0,Ismael Juma,2018-01-01 10:16:07+00:00,['2cefe3f0d0f5567b54f3ca5883726fec4f5756eb'],8,21,29,1406763,2,0.416666667,1,1,3546
96df93522f84173ff47f47ec78ec408991140b65,0,Ismael Juma,2018-01-01 13:07:32+00:00,['5d4965bad4ea4a64d798f1cc0271de8d4e3d4289'],20,19,39,1406802,4,,,,3546
47db063c310cf47e4c544196acab2abfe62977b0,0,Guozhang Wang,2018-01-02 09:32:17-08:00,['96df93522f84173ff47f47ec78ec408991140b65'],13,91,104,1406906,4,0.045454545,0.984848485,1,3546
39f2d4588fb1bf82748fa4c1025b7452ca1ff5ba,1,Guozhang Wang,2018-01-02 09:34:31-08:00,['47db063c310cf47e4c544196acab2abfe62977b0'],0,48,48,1406954,1,0,1,1,3546
0ecc3596b450b3cf638b5d830c6fea4577038d40,1,Guozhang Wang,2018-01-02 09:42:40-08:00,['39f2d4588fb1bf82748fa4c1025b7452ca1ff5ba'],32,414,446,1407400,4,0.575,0.98,0.835,3547
f8593b0958c594e07426136cc05c87ec496e1714,0,Guozhang Wang,2018-01-02 10:07:54-08:00,['0ecc3596b450b3cf638b5d830c6fea4577038d40'],1,1,2,1407402,1,,,,3547
5ca1226c22976050fd929c7bf66f3af8a5cd0493,1,Guozhang Wang,2018-01-02 10:22:28-08:00,['f8593b0958c594e07426136cc05c87ec496e1714'],21,126,147,1407549,2,0,1,1,3547
fd2bdbfd700273699725f281a7abab4ff8e55a04,0,Guozhang Wang,2018-01-02 10:45:57-08:00,['5ca1226c22976050fd929c7bf66f3af8a5cd0493'],3,82,85,1407634,3,0.586956522,0.934782609,1,3547
d61a592c8a5ee2279760c2c7c72550160032bf8a,0,Guozhang Wang,2018-01-02 10:54:20-08:00,['fd2bdbfd700273699725f281a7abab4ff8e55a04'],65,53,118,1407752,4,1,1,0,3547
2119e9f26ed988746ee22d139d1eb1aca2bbb950,1,Guozhang Wang,2018-01-02 14:21:42-08:00,['d61a592c8a5ee2279760c2c7c72550160032bf8a'],91,13,104,1407856,4,0.954545455,0.015151515,0,3547
6869f952326f72f108250dbbdd8253cf95410633,0,Guozhang Wang,2018-01-03 11:08:43-08:00,['2119e9f26ed988746ee22d139d1eb1aca2bbb950'],13,48,61,1407917,1,0,0,1,3547
3de910319e56d81c50597f05459d35752345907c,0,Rajini Sivaram,2018-01-03 19:17:53+00:00,['6869f952326f72f108250dbbdd8253cf95410633'],0,3,3,1407920,1,0,0,1,3547
98296f852f334067553e541d6ecdfa624f0eb689,1,Jun Rao,2018-01-03 14:02:14-08:00,['3de910319e56d81c50597f05459d35752345907c'],695,684,1379,1409299,67,1,0,0.387096774,3547
f459a31ccb1271291e148a412463aacbc1b18cc6,0,Jason Gustafson,2018-01-04 08:59:53-08:00,['98296f852f334067553e541d6ecdfa624f0eb689'],76,484,560,1409859,1,1,1,0.57037037,3547
3ea2d912c82a021bf43ba7a26b9b714c2fc0e817,1,Jason Gustafson,2018-01-04 10:16:04-08:00,['f459a31ccb1271291e148a412463aacbc1b18cc6'],37,96,133,1409992,14,0.514285714,1,1,3547
bfb272c5cdb227040d862f0ab7337df68f787764,1,Jason Gustafson,2018-01-05 07:52:50-08:00,['3ea2d912c82a021bf43ba7a26b9b714c2fc0e817'],26,268,294,1410286,17,0.606060606,0.98989899,0.898989899,3549
ecf0ab42c1591be2a3784b6e107567ad883e0330,1,Ewen Cheslack-Postava,2018-01-05 18:31:53-08:00,['bfb272c5cdb227040d862f0ab7337df68f787764'],1,52,53,1410339,3,0,0,1,3549
3b03c9d3484f59c7a5fccb282ff77ad45734c10c,0,Ewen Cheslack-Postava,2018-01-05 21:24:39-08:00,['ecf0ab42c1591be2a3784b6e107567ad883e0330'],1,51,52,1410391,5,0.866666667,1,0.933333333,3549
e1c5d0c119b38a9ddb2b09b6309a3817d86d8e14,1,Damian Guy,2018-01-08 11:33:23+00:00,['3b03c9d3484f59c7a5fccb282ff77ad45734c10c'],17,68,85,1410476,2,,,,3549
a7e49027b2b95bc8656ee9f419306c559ad1cb5c,0,Ismael Juma,2018-01-08 12:14:25+00:00,['e1c5d0c119b38a9ddb2b09b6309a3817d86d8e14'],2,98,100,1410576,2,1,1,1,3550
d63f94797cd3a283b2d374d24a23ac54f92c7b27,0,Guozhang Wang,2018-01-08 09:38:58-08:00,['a7e49027b2b95bc8656ee9f419306c559ad1cb5c'],12,12,24,1410600,4,,,,3550
e1c407973f5c4a7af6b80c1a9be92ab1635de665,0,Guozhang Wang,2018-01-08 11:14:54-08:00,['d63f94797cd3a283b2d374d24a23ac54f92c7b27'],2,4,6,1410606,1,0,0,1,3550
26270983cd2318b00a6e20ff1d354008307fe082,1,Guozhang Wang,2018-01-08 11:43:38-08:00,['e1c407973f5c4a7af6b80c1a9be92ab1635de665'],62,148,210,1410816,16,,,,3550
697a4af35a3672dd339c3a6a34d5ab27e31e0fbd,1,Guozhang Wang,2018-01-08 11:58:56-08:00,['26270983cd2318b00a6e20ff1d354008307fe082'],75,92,167,1410983,7,0,1,0.909090909,3550
2900af6b33c8d6a12459dcdd0e1fb4b49676c2ff,0,Guozhang Wang,2018-01-08 12:02:29-08:00,['697a4af35a3672dd339c3a6a34d5ab27e31e0fbd'],2,30,32,1411015,2,,,,3550
f2e9725ec9d88f37e0048dbd50e23f96c1e51e0e,0,Jason Gustafson,2018-01-08 14:59:16-08:00,['2900af6b33c8d6a12459dcdd0e1fb4b49676c2ff'],4,8,12,1411027,1,0,0,1,3550
6396d01957ea355c21d658c3614190458229fa5b,1,Jason Gustafson,2018-01-08 16:15:35-08:00,['f2e9725ec9d88f37e0048dbd50e23f96c1e51e0e'],9,946,955,1411982,4,0.752981261,1,0.954003407,3553
abf4c547017304c9b1e743723bdcb0b8a4df1ad0,0,Jun Rao,2018-01-09 14:49:18-08:00,['6396d01957ea355c21d658c3614190458229fa5b'],5,6,11,1411993,1,,,,3553
06597ba26b85e1efa02078753d67855b82b79a4d,0,Guozhang Wang,2018-01-09 16:28:49-08:00,['abf4c547017304c9b1e743723bdcb0b8a4df1ad0'],36,36,72,1412065,8,,,,3553
874eeb88d9dc5e8fbcd681672fb90a4cd7597fec,1,Damian Guy,2018-01-10 10:21:51+00:00,['06597ba26b85e1efa02078753d67855b82b79a4d'],26,71,97,1412162,1,0.609756098,1,1,3553
fa5ebc8a019f8cb24823dd29ef84d422d93624dc,1,Guozhang Wang,2018-01-10 11:14:20-08:00,['874eeb88d9dc5e8fbcd681672fb90a4cd7597fec'],51,135,186,1412348,19,0.894736842,0.973684211,0.894736842,3554
92529ac6d8c117f1704d84f94f18b9497707a1b5,0,GitHub,2018-01-10 13:32:16-08:00,"['fa5ebc8a019f8cb24823dd29ef84d422d93624dc', 'b887eeb7215351e7509993f8609846115962e594']",10,10,20,1412368,1,,,,3554
4d544d4f08b027ce318b088b112f03dccc566098,1,Guozhang Wang,2018-01-10 16:24:43-08:00,['92529ac6d8c117f1704d84f94f18b9497707a1b5'],25,143,168,1412536,5,0.030927835,0.989690722,1,3554
b8aa1761c39bd320950104fa2ddf4fbd7163fc85,0,Guozhang Wang,2018-01-11 09:54:02-08:00,['4d544d4f08b027ce318b088b112f03dccc566098'],1,56,57,1412593,5,1,1,1,3554
936e81afcb0488e65a3dbca688c768b0100fe04a,1,Jason Gustafson,2018-01-11 15:52:50-08:00,['b8aa1761c39bd320950104fa2ddf4fbd7163fc85'],3,28,31,1412624,2,0.666666667,0.666666667,1,3554
3e21e17a7d3613bfab8c34555c0f598a07cf0675,1,Guozhang Wang,2018-01-12 15:40:59-08:00,['936e81afcb0488e65a3dbca688c768b0100fe04a'],1188,1104,2292,1414916,8,0,1,1,3557
1d1c8575961bf6bce7decb049be7f10ca76bd0c5,0,Guozhang Wang,2018-01-12 17:27:52-08:00,['3e21e17a7d3613bfab8c34555c0f598a07cf0675'],0,4,4,1414920,1,,,,3557
5d81639907869ce7355c40d2bac176a655e52074,0,Jiangjie Qin,2018-01-14 16:18:39-08:00,['1d1c8575961bf6bce7decb049be7f10ca76bd0c5'],22,85,107,1415027,5,0,1,1,3557
27a8d0f9e7f3b05f331d1449b17cf7e085a4b45c,1,Jun Rao,2018-01-16 09:50:31-08:00,['5d81639907869ce7355c40d2bac176a655e52074'],70,3910,3980,1419007,78,0.658713693,0.8843361,0.895228216,3585
c7e7cc1a5ad6540ab58b7cda5eba82090cc8aa86,0,Guozhang Wang,2018-01-16 10:30:43-08:00,['27a8d0f9e7f3b05f331d1449b17cf7e085a4b45c'],1,1,2,1419009,1,,,,3585
bcc712b45820da74b44209857ebbf7b9d59e0ed7,1,Guozhang Wang,2018-01-16 10:47:29-08:00,['c7e7cc1a5ad6540ab58b7cda5eba82090cc8aa86'],104,830,934,1419943,22,0.210227273,1,1,3590
8ded496c9be619fe29d00b406b3c1e094abc202c,1,Guozhang Wang,2018-01-16 15:13:30-08:00,['bcc712b45820da74b44209857ebbf7b9d59e0ed7'],363,129,492,1420435,3,0.836206897,1,0,3591
2771f52ea7070a3147058e0d6661e0a7e4158161,0,Guozhang Wang,2018-01-16 16:57:15-08:00,['8ded496c9be619fe29d00b406b3c1e094abc202c'],68,85,153,1420588,3,0,0,0,3591
11f3db0b731739017174e488670e529af4dc22ae,0,GitHub,2018-01-17 11:25:50-08:00,['2771f52ea7070a3147058e0d6661e0a7e4158161'],10,28,38,1420626,4,0.6,1,0.8,3591
f6f65a78684e41bcd6115438a76cd6c552afc043,0,GitHub,2018-01-17 14:01:43-08:00,['11f3db0b731739017174e488670e529af4dc22ae'],2,2,4,1420630,1,,,,3591
5701ba88f895ac9211f25c15204d6281aed00ffc,0,Guozhang Wang,2018-01-18 08:45:22-08:00,['f6f65a78684e41bcd6115438a76cd6c552afc043'],2,35,37,1420667,2,1,1,1,3591
e98162792684b0874c60003c6a596ec739c934a3,1,GitHub,2018-01-18 08:57:42-08:00,['5701ba88f895ac9211f25c15204d6281aed00ffc'],89,90,179,1420846,1,1,0,0,3591
40759595e2e4d3751da8787c62ffd659cde257aa,0,Jason Gustafson,2018-01-18 09:11:20-08:00,['e98162792684b0874c60003c6a596ec739c934a3'],1,1,2,1420848,1,,,,3591
e2e36d34edfbb0f75ef70bf1e3bd13df2a5dc7ea,0,Jason Gustafson,2018-01-18 09:23:23-08:00,['40759595e2e4d3751da8787c62ffd659cde257aa'],1,1,2,1420850,1,,,,3591
8cd563d4785f719c4876d9d4626713994c3a3a6f,0,Jason Gustafson,2018-01-18 09:56:22-08:00,['e2e36d34edfbb0f75ef70bf1e3bd13df2a5dc7ea'],2,10,12,1420862,1,,,,3591
b543bfc18e424c58897bb973206ea9a1d120d21a,0,Guozhang Wang,2018-01-18 09:59:32-08:00,['8cd563d4785f719c4876d9d4626713994c3a3a6f'],1,1,2,1420864,1,,,,3591
51f0f3ee792cf9352ce61afeca098c765cdad664,1,Rajini Sivaram,2018-01-18 19:14:49+00:00,['b543bfc18e424c58897bb973206ea9a1d120d21a'],11,42,53,1420917,3,0.7,0,1,3591
b2146a1cba060d6e3baa67d26a5c06ab316e3f92,0,Jason Gustafson,2018-01-18 11:32:44-08:00,['51f0f3ee792cf9352ce61afeca098c765cdad664'],1,1,2,1420919,1,,,,3591
75e37d7e2063b726aa0185f4b695f32cde69d95c,1,Guozhang Wang,2018-01-18 13:12:44-08:00,['b2146a1cba060d6e3baa67d26a5c06ab316e3f92'],159,281,440,1421359,19,0.270588235,1,0.894117647,3592
70f25b95192bb7d56c62c8b8bc80b478b8e08ef9,1,GitHub,2018-01-18 13:54:59-08:00,['75e37d7e2063b726aa0185f4b695f32cde69d95c'],385,275,660,1422019,3,1,0.329545455,0.022727273,3592
ae6cb15f5f8947f8e0e87035b212a1e6ddf36193,0,Jason Gustafson,2018-01-18 14:36:20-08:00,['70f25b95192bb7d56c62c8b8bc80b478b8e08ef9'],1,1,2,1422021,1,,,,3592
ca30c2d55b4f882fda34a13aff6f9ea510a959f6,1,GitHub,2018-01-20 13:28:24-08:00,['ae6cb15f5f8947f8e0e87035b212a1e6ddf36193'],27,98,125,1422146,5,0.06122449,0.93877551,1,3592
0fa52644debfbc20cda0a93678140537fa2cb24c,1,Ewen Cheslack-Postava,2018-01-21 19:41:20-08:00,['ca30c2d55b4f882fda34a13aff6f9ea510a959f6'],16,59,75,1422221,1,0,0,1,3592
9ef883e62fc10e04105278d3cb8d7076e3ebc941,0,Guozhang Wang,2018-01-22 14:37:19-08:00,['0fa52644debfbc20cda0a93678140537fa2cb24c'],1,6,7,1422228,2,,,,3592
2c08d7e39e3c7e0a65b0255db3c86d3e259cedbf,0,Guozhang Wang,2018-01-22 14:38:31-08:00,['9ef883e62fc10e04105278d3cb8d7076e3ebc941'],20,9,29,1422257,1,1,1,0,3592
83cc138e0c04a2f30f4536c27314890d06818190,1,Ewen Cheslack-Postava,2018-01-22 15:00:31-08:00,['2c08d7e39e3c7e0a65b0255db3c86d3e259cedbf'],12,60,72,1422329,1,0.433333333,1,0.2,3592
b814a16b968d144802d08523b5c359d6706f5632,1,Jason Gustafson,2018-01-23 08:44:31-08:00,['83cc138e0c04a2f30f4536c27314890d06818190'],213,2294,2507,1424836,41,0.628067485,0.822852761,0.758435583,3597
faafdbe014ca6ac7e253be6934f78885642666ed,0,Guozhang Wang,2018-01-23 15:21:40-08:00,['b814a16b968d144802d08523b5c359d6706f5632'],1,1,2,1424838,1,,,,3597
5e04fb8d8e55a5281bd40da9e1c99e9eb5e3c5f5,1,GitHub,2018-01-23 18:58:49-08:00,['faafdbe014ca6ac7e253be6934f78885642666ed'],457,658,1115,1425953,15,0.26875,0.925,0.725,3598
52191c34986431673580575264c5c0414ae20243,0,Guozhang Wang,2018-01-24 13:24:23-08:00,['5e04fb8d8e55a5281bd40da9e1c99e9eb5e3c5f5'],2,16,18,1425971,1,0,1,1,3598
aa42a11dfd99ee9ab24d2e9a7521ef1c97ae1ff4,1,Jason Gustafson,2018-01-24 21:06:44-08:00,['52191c34986431673580575264c5c0414ae20243'],46,84,130,1426101,13,1,1,1,3598
3cb6a00c5a6b8f9c79f154cd391f729c4f5b5a0b,0,Jason Gustafson,2018-01-25 09:16:15-08:00,['aa42a11dfd99ee9ab24d2e9a7521ef1c97ae1ff4'],1,1,2,1426103,1,,,,3598
82020629c54636fb9b0dded7f7262e45abea5e2e,1,Jason Gustafson,2018-01-25 09:25:29-08:00,['3cb6a00c5a6b8f9c79f154cd391f729c4f5b5a0b'],6,46,52,1426155,1,,,,3598
41e4e93b5ae8a7d221fce1733e050cb98ac9713c,1,Jason Gustafson,2018-01-25 09:49:50-08:00,['82020629c54636fb9b0dded7f7262e45abea5e2e'],4,3,7,1426162,1,,,,3598
7a246eea7b68851c3de5345d43f70853b4a15f21,1,Jason Gustafson,2018-01-25 12:39:20-08:00,['41e4e93b5ae8a7d221fce1733e050cb98ac9713c'],56,53,109,1426271,9,0.666666667,0.666666667,1,3598
138f57f16068b49a08a2f58155b71e72ff7ed273,1,Jiangjie Qin,2018-01-25 20:40:11-08:00,['7a246eea7b68851c3de5345d43f70853b4a15f21'],105,132,237,1426508,1,0,0.222222222,1,3598
6d266907cd93bc9e5b5341b9c6e9d026c4b60eee,1,Jason Gustafson,2018-01-26 08:25:12-08:00,['138f57f16068b49a08a2f58155b71e72ff7ed273'],9,2,11,1426519,2,,,,3598
97e458342252749d591f4037747668856c63e3a3,1,Jason Gustafson,2018-01-26 08:30:47-08:00,['6d266907cd93bc9e5b5341b9c6e9d026c4b60eee'],1,1,2,1426521,1,,,,3598
993d3c727e6f21931bf66c671358dfe7b0e1fae3,0,Jason Gustafson,2018-01-26 08:39:57-08:00,['97e458342252749d591f4037747668856c63e3a3'],4,21,25,1426546,2,1,1,1,3598
d673c8cf94b5fdf773c768eded746ae4d8febc86,0,Guozhang Wang,2018-01-26 09:18:22-08:00,['993d3c727e6f21931bf66c671358dfe7b0e1fae3'],1,5,6,1426552,2,,,,3598
c615c597aa24cc5a4552102f1b6d27fcf4e24d12,1,Guozhang Wang,2018-01-26 09:34:55-08:00,['d673c8cf94b5fdf773c768eded746ae4d8febc86'],50,100,150,1426702,12,0.707317073,0.975609756,0.951219512,3598
decfb834fbbc8ae1a718e083edc70f5f226ea43e,1,Guozhang Wang,2018-01-26 10:14:10-08:00,['c615c597aa24cc5a4552102f1b6d27fcf4e24d12'],3,3,6,1426708,1,,,,3598
115c3055266dd83ef3ae1d95128dc4afbf2bac0b,0,Guozhang Wang,2018-01-26 10:40:32-08:00,['decfb834fbbc8ae1a718e083edc70f5f226ea43e'],1,1,2,1426710,1,,,,3598
c8d80073c9d68c4e7fce695118fb52093fa39d45,0,Guozhang Wang,2018-01-26 10:49:17-08:00,['115c3055266dd83ef3ae1d95128dc4afbf2bac0b'],4,4,8,1426718,1,,,,3598
d706c87cb2a7e060ae22ccb7809b5d588bb3d6b5,0,Guozhang Wang,2018-01-26 11:14:57-08:00,['c8d80073c9d68c4e7fce695118fb52093fa39d45'],1,1,2,1426720,1,,,,3598
a693e86181637ad21927cf3e2c70277daadd6469,0,Guozhang Wang,2018-01-26 11:17:52-08:00,['d706c87cb2a7e060ae22ccb7809b5d588bb3d6b5'],2,2,4,1426724,1,,,,3598
739256bea95856b4ae0a6b9fb7b0f4b1e6d8c0fd,0,Guozhang Wang,2018-01-26 11:29:46-08:00,['a693e86181637ad21927cf3e2c70277daadd6469'],1,1,2,1426726,1,,,,3598
a9af5c79638cb6ac4e729cdd995facc6153e45db,0,Guozhang Wang,2018-01-26 11:31:37-08:00,['739256bea95856b4ae0a6b9fb7b0f4b1e6d8c0fd'],2,4,6,1426732,1,,,,3598
4a274bc9fd2ac3714788af0429fde8945a48636f,0,Guozhang Wang,2018-01-26 11:35:54-08:00,['a9af5c79638cb6ac4e729cdd995facc6153e45db'],7,10,17,1426749,2,,,,3598
93ab94d7edcbf577747d306c19fc5378dd092d76,0,Guozhang Wang,2018-01-26 11:40:35-08:00,['4a274bc9fd2ac3714788af0429fde8945a48636f'],1,3,4,1426753,1,,,,3598
1fef10d47f8b7481b4fed8f5366c6780d9c7d733,1,Guozhang Wang,2018-01-26 11:43:48-08:00,['93ab94d7edcbf577747d306c19fc5378dd092d76'],5,5,10,1426763,3,,,,3598
70cecb6881f8b4f45cfd4780ef27f9fb9a8ce0b6,1,Jason Gustafson,2018-01-26 14:38:46-08:00,['1fef10d47f8b7481b4fed8f5366c6780d9c7d733'],39,244,283,1427046,8,0.739130435,0.939130435,1,3598
e8b30e4d255dce455632d809f7bd54b04e6bc6fd,1,Jason Gustafson,2018-01-26 16:44:49-08:00,['70cecb6881f8b4f45cfd4780ef27f9fb9a8ce0b6'],2,10,12,1427058,3,0.857142857,1,1,3598
9b3722cea1845784853073d2a22764ec9fd5a8e5,1,GitHub,2018-01-27 12:22:05-08:00,['e8b30e4d255dce455632d809f7bd54b04e6bc6fd'],56,246,302,1427360,12,0.473684211,1,0.986842105,3598
1e04f5d2348d91fc18d4e0f330c231919663be1a,0,Jason Gustafson,2018-01-27 18:08:51-08:00,['9b3722cea1845784853073d2a22764ec9fd5a8e5'],4,5,9,1427369,4,,,,3598
2f267871eac86623950e8e3a67a98687e42a0b3e,0,Rajini Sivaram,2018-01-28 13:22:24+00:00,['1e04f5d2348d91fc18d4e0f330c231919663be1a'],2,1,3,1427372,2,,,,3598
b5da5f8bec2b87c13f82d57be8e38a397c61366e,0,Guozhang Wang,2018-01-28 20:17:48-08:00,['2f267871eac86623950e8e3a67a98687e42a0b3e'],6,3,9,1427381,1,0,0,0,3598
6ea53d22e25e948b26c8f2c436f242edb0748df2,0,Guozhang Wang,2018-01-29 10:09:32-08:00,['b5da5f8bec2b87c13f82d57be8e38a397c61366e'],12,11,23,1427404,3,,,,3598
a78f66a5ae7865418ee482c535e883598e1ec51f,1,Guozhang Wang,2018-01-29 17:21:48-08:00,['6ea53d22e25e948b26c8f2c436f242edb0748df2'],14,2943,2957,1430361,19,0.625814863,0.855932203,0.792046936,3605
05e42e1df12d87a29c8127dec23d7a9c290901d6,0,Guozhang Wang,2018-01-29 17:28:49-08:00,['a78f66a5ae7865418ee482c535e883598e1ec51f'],13,15,28,1430389,3,,,,3605
fdc14dacedc3d3497dcc222b44f539e6355b45a9,0,GitHub,2018-01-29 17:48:53-08:00,['05e42e1df12d87a29c8127dec23d7a9c290901d6'],105,70,175,1430564,9,0.583333333,0,0.75,3605
b7a0c327cc24adf38e91c05af6f96a7271f2ab61,0,Rajini Sivaram,2018-01-30 03:09:06-08:00,['fdc14dacedc3d3497dcc222b44f539e6355b45a9'],5,109,114,1430678,2,1,1,1,3606
b4165522b3c244b67c0f88e4df9f0cd581a75bb0,0,Jason Gustafson,2018-01-30 08:45:07-08:00,['b7a0c327cc24adf38e91c05af6f96a7271f2ab61'],2,10,12,1430690,2,0,1,1,3606
710aa678b7a6409296fb3c852a47c1876d8fa8e9,1,GitHub,2018-01-30 09:29:27-08:00,['b4165522b3c244b67c0f88e4df9f0cd581a75bb0'],95,353,448,1431138,10,0.690196078,0.807843137,0.811764706,3606
cb93d764613d801a1185989f09ce2d6b76009020,0,Guozhang Wang,2018-01-30 10:18:51-08:00,['710aa678b7a6409296fb3c852a47c1876d8fa8e9'],5,59,64,1431202,2,1,1,1,3606
d97e63b26063c8fe629005ff61c8150317c88503,0,Jiangjie Qin,2018-01-30 10:20:08-08:00,['cb93d764613d801a1185989f09ce2d6b76009020'],9,81,90,1431292,2,1,1,1,3607
70d3b19b1126ae64c214615adef590275f218ee7,1,GitHub,2018-01-30 12:55:32-08:00,['d97e63b26063c8fe629005ff61c8150317c88503'],50,343,393,1431685,7,0.735751295,0.937823834,0.911917098,3607
2264613c4e2f51f1332671db50b6af6284baa6fc,0,GitHub,2018-01-30 14:14:50-08:00,['70d3b19b1126ae64c214615adef590275f218ee7'],4,23,27,1431712,1,,,,3607
ef93998fa7e31f6222d6f0b12b9a01fa785faf48,1,Jason Gustafson,2018-01-30 14:47:28-08:00,['2264613c4e2f51f1332671db50b6af6284baa6fc'],9,75,84,1431796,2,0.055555556,0.555555556,1,3607
3431be2aeb4f16599c419f89360856b72d0d335d,1,Ewen Cheslack-Postava,2018-01-30 15:09:40-08:00,['ef93998fa7e31f6222d6f0b12b9a01fa785faf48'],160,798,958,1432754,15,0.376582278,0.851265823,0.965189873,3610
c6635e8d12fa5fed32ac75a727e62332fffa210b,1,Guozhang Wang,2018-01-30 15:30:58-08:00,['3431be2aeb4f16599c419f89360856b72d0d335d'],29,197,226,1432980,4,0.137931034,0.870689655,0.637931034,3610
ae42cc803023c795eae00d138ea22a6a7951db31,1,Ewen Cheslack-Postava,2018-01-30 15:55:49-08:00,['c6635e8d12fa5fed32ac75a727e62332fffa210b'],21,147,168,1433148,11,0.176470588,1,1,3610
3e4176fdd653f002ce878d99ba5c05389c8b6cb4,0,Guozhang Wang,2018-01-30 17:22:36-08:00,['ae42cc803023c795eae00d138ea22a6a7951db31'],12,8,20,1433168,3,1,0,0,3610
15568fdbe753ea1c2e5fef571daf45e435999c07,1,Matthias J. Sax,2018-01-30 18:18:55-08:00,['3e4176fdd653f002ce878d99ba5c05389c8b6cb4'],39,285,324,1433492,6,0.023952096,1,0.898203593,3610
530bc59de2732ba71e82c0110c59e9f6162531c6,1,Ewen Cheslack-Postava,2018-01-31 08:49:23-08:00,['15568fdbe753ea1c2e5fef571daf45e435999c07'],15,163,178,1433670,6,0.776315789,0.776315789,1,3610
4c48942f9d9e1428e21f934746cb7ce22b3df746,1,Ewen Cheslack-Postava,2018-01-31 10:40:24-08:00,['530bc59de2732ba71e82c0110c59e9f6162531c6'],158,4479,4637,1438307,43,0.528786537,0.680248007,0.807351639,3628
1ed6da7cc8eb2231f73509c907c2e67af2f249d2,1,Jason Gustafson,2018-01-31 13:23:12-08:00,['4c48942f9d9e1428e21f934746cb7ce22b3df746'],47,941,988,1439295,22,0.540337711,0.81988743,0.998123827,3633
b8222065e0cc09f455dc5b2aa43c1d68cf0d4a1f,1,Matthias J. Sax,2018-01-31 13:53:15-08:00,['1ed6da7cc8eb2231f73509c907c2e67af2f249d2'],9,41,50,1439345,2,1,1,0,3633
c38a34559fd078be3ed30162619078f129802353,1,GitHub,2018-01-31 17:59:49-08:00,['b8222065e0cc09f455dc5b2aa43c1d68cf0d4a1f'],11,13,24,1439369,3,0.5,1,1,3633
ca01711c0ec0b616840cc696419e5bbf500f6651,0,GitHub,2018-02-01 11:35:43+00:00,['c38a34559fd078be3ed30162619078f129802353'],6,6,12,1439381,6,,,,3633
7804ea173bdbb0f401ad0135442c563fb52f895c,1,Jiangjie Qin,2018-02-01 08:58:29-08:00,['ca01711c0ec0b616840cc696419e5bbf500f6651'],24,52,76,1439457,3,0.285714286,0.666666667,0.142857143,3633
4a2aa4bb6700c02b573c3ae71a40bdb8df5ab3a7,1,GitHub,2018-02-01 10:11:29-08:00,['7804ea173bdbb0f401ad0135442c563fb52f895c'],13,36,49,1439506,6,0.727272727,1,1,3633
498cf73f54c202417ce0e12d8ef7f552da850f7d,0,Guozhang Wang,2018-02-01 10:17:06-08:00,['4a2aa4bb6700c02b573c3ae71a40bdb8df5ab3a7'],75,75,150,1439656,1,,,,3633
86de4a86b87c1b45732303c07d263e317ffd0ebf,1,Guozhang Wang,2018-02-01 10:27:59-08:00,['498cf73f54c202417ce0e12d8ef7f552da850f7d'],93,617,710,1440366,6,1,1,0.913875598,3635
afdf9a85101539e2afb2b0355d7a2008b3055780,1,Jiangjie Qin,2018-02-01 11:57:52-08:00,['86de4a86b87c1b45732303c07d263e317ffd0ebf'],11,90,101,1440467,3,0.48,1,0.72,3635
b0132c31e91bb090ff012c726ac4ed92566ce7fb,1,Guozhang Wang,2018-02-01 16:14:22-08:00,['afdf9a85101539e2afb2b0355d7a2008b3055780'],384,47,431,1440898,6,0.159340659,0.263736264,0.038461538,3635
8b60c8b1417c4a20c17026a7f326c4a502a8797f,1,Jason Gustafson,2018-02-01 22:04:14-08:00,['b0132c31e91bb090ff012c726ac4ed92566ce7fb'],5,11,16,1440914,2,,,,3635
f6bbec4af2f1842ea7be35899e3c7d60179ab2fb,1,Matthias J. Sax,2018-02-02 11:24:20-08:00,['8b60c8b1417c4a20c17026a7f326c4a502a8797f'],32,24,56,1440970,4,,,,3635
505adefcecc6e7282b73f934aa8c7a59adcb675e,1,Jason Gustafson,2018-02-02 16:31:58-08:00,['f6bbec4af2f1842ea7be35899e3c7d60179ab2fb'],83,341,424,1441394,6,0.322429907,0.714953271,0.705607477,3635
f9b56d680bab86fad276d01c8421d3679a788f2b,0,Jason Gustafson,2018-02-03 13:27:02-08:00,['505adefcecc6e7282b73f934aa8c7a59adcb675e'],0,9,9,1441403,1,1,1,1,3635
4019b21d602c0912d9dc0286f10701e7e724f750,1,Jason Gustafson,2018-02-04 09:19:16-08:00,['f9b56d680bab86fad276d01c8421d3679a788f2b'],363,1574,1937,1443340,41,0.403282532,0.835873388,0.853458382,3637
17aaff3606393b42d4e8ef5299141b5bb21300b0,1,Ewen Cheslack-Postava,2018-02-04 14:57:25-08:00,['4019b21d602c0912d9dc0286f10701e7e724f750'],26,44,70,1443410,3,0.538461538,0.538461538,1,3637
822cd7d608ca70ead1fe17fc9e69ad0c82a447be,1,Rajini Sivaram,2018-02-05 06:54:09-08:00,['17aaff3606393b42d4e8ef5299141b5bb21300b0'],3,3,6,1443416,1,,,,3637
eb3fef760e1c876b936f175e0eb9a1446cf5bdcf,1,Ewen Cheslack-Postava,2018-02-05 09:46:07-08:00,['822cd7d608ca70ead1fe17fc9e69ad0c82a447be'],47,92,139,1443555,7,0.382352941,1,1,3637
7fe1c2b3d3a78ea3ffb9e269563653626861fbd2,1,Jun Rao,2018-02-05 10:09:17-08:00,['eb3fef760e1c876b936f175e0eb9a1446cf5bdcf'],218,3329,3547,1447102,25,0.401287554,0.78111588,0.899678112,3646
ed971fd4341f1643cba38684a0be3f9362e9394c,1,Jun Rao,2018-02-05 11:07:18-08:00,['7fe1c2b3d3a78ea3ffb9e269563653626861fbd2'],0,102,102,1447204,1,,,,3646
447c64fffb72fdb82e2f3c670e891ae1d00a8ec8,0,Ewen Cheslack-Postava,2018-02-05 12:13:26-08:00,['ed971fd4341f1643cba38684a0be3f9362e9394c'],17,66,83,1447287,4,,,,3646
2d4fb785409056b7abfdfe6082f2862a138acf74,0,Ewen Cheslack-Postava,2018-02-05 13:42:04-08:00,['447c64fffb72fdb82e2f3c670e891ae1d00a8ec8'],1,1,2,1447289,1,,,,3646
332e698ac9c74ce29317021b03a54512c92ac8b3,1,GitHub,2018-02-05 16:35:12-08:00,['2d4fb785409056b7abfdfe6082f2862a138acf74'],4,14,18,1447307,4,1,1,0.8,3646
65d262cc30315ed47bd17e94c0db672de93d908a,0,GitHub,2018-02-06 01:50:51-08:00,['332e698ac9c74ce29317021b03a54512c92ac8b3'],36,66,102,1447409,3,0,0,1,3646
7d70a427b2689c0a1de4345db4b04ea557b4c27b,0,Jason Gustafson,2018-02-06 09:18:37-08:00,['65d262cc30315ed47bd17e94c0db672de93d908a'],9,108,117,1447526,4,0,1,1,3646
6541ab199395bfb06a7a020f7ab76d70855006c2,0,Ewen Cheslack-Postava,2018-02-06 09:38:35-08:00,['7d70a427b2689c0a1de4345db4b04ea557b4c27b'],4,8,12,1447538,1,0,0,0,3646
7c97b239a5261cf030984f71427287196e657d95,1,Jun Rao,2018-02-06 10:40:51-08:00,['6541ab199395bfb06a7a020f7ab76d70855006c2'],5,237,242,1447780,5,0.226519337,0.806629834,0.928176796,3646
c32860b22427ca32a9e83e4f741b85062bb22140,0,Guozhang Wang,2018-02-06 11:33:49-08:00,['7c97b239a5261cf030984f71427287196e657d95'],32,18,50,1447830,10,0.6,0,0.066666667,3646
a88db9595910a1a7f249f7c9f3effb14636955c7,1,GitHub,2018-02-06 13:14:33-08:00,['c32860b22427ca32a9e83e4f741b85062bb22140'],355,269,624,1448454,32,0.352941176,0,1,3646
caf03d642b6992bf95b922f0cb5f724d265d4029,1,Jun Rao,2018-02-06 14:04:46-08:00,['a88db9595910a1a7f249f7c9f3effb14636955c7'],1,1,2,1448456,1,,,,3646
65b5ccf6413369aa4f21c72abcdf31ca72a79b00,1,GitHub,2018-02-07 03:29:08-08:00,['caf03d642b6992bf95b922f0cb5f724d265d4029'],104,193,297,1448753,15,0.8,0.8,1,3648
263a510676ee0173cbaa11b5de1de4c19d2f5202,1,Matthias J. Sax,2018-02-07 11:07:32-08:00,['65b5ccf6413369aa4f21c72abcdf31ca72a79b00'],9,24,33,1448786,3,0.833333333,0.833333333,0.75,3648
164fea30ea6b43d65074957f1f7b8342721b2a31,1,GitHub,2018-02-07 11:43:57-08:00,['263a510676ee0173cbaa11b5de1de4c19d2f5202'],7,8,15,1448801,3,,,,3648
4ee5182f35d612daa223f890b9eaad08655b761b,0,Matthias J. Sax,2018-02-07 11:53:07-08:00,['164fea30ea6b43d65074957f1f7b8342721b2a31'],0,5,5,1448806,1,1,1,1,3648
5d69a79948bce0fab4705c7d7d0f3b02f2548c0d,1,GitHub,2018-02-07 14:08:53-08:00,['4ee5182f35d612daa223f890b9eaad08655b761b'],6,161,167,1448973,2,0,1,1,3648
68ec1a3cce22706faf762de7d2d97b490c47fd90,1,GitHub,2018-02-07 16:20:18-08:00,['5d69a79948bce0fab4705c7d7d0f3b02f2548c0d'],19,26,45,1449018,3,0,0,1,3648
67803384d9b7959661bb2a32129b03a374507c8a,0,Guozhang Wang,2018-02-07 17:21:35-08:00,['68ec1a3cce22706faf762de7d2d97b490c47fd90'],23,143,166,1449184,3,0.526315789,0.934210526,0.763157895,3648
e7905fc7c3398490e02cddb3bcf30590b2f6d7b7,0,Guozhang Wang,2018-02-07 17:41:39-08:00,['67803384d9b7959661bb2a32129b03a374507c8a'],1,2,3,1449187,1,,,,3648
8a2d00fc44eb48bf80fd2383178665986a73cdd8,0,Guozhang Wang,2018-02-07 17:44:40-08:00,['e7905fc7c3398490e02cddb3bcf30590b2f6d7b7'],2,2,4,1449191,1,,,,3648
79f22805a75cf2eb49560bd8387cb6ec14769bd7,0,GitHub,2018-02-08 09:30:25-08:00,['8a2d00fc44eb48bf80fd2383178665986a73cdd8'],4,9,13,1449204,2,,,,3648
077fd9ced3f5c7101c0d4e91c0ae3aeb05f9318f,1,GitHub,2018-02-08 09:31:58-08:00,['79f22805a75cf2eb49560bd8387cb6ec14769bd7'],78,78,156,1449360,6,,,,3648
ac267dc5cec605f3981c9db7d889cabd59f09a61,1,Jason Gustafson,2018-02-08 09:49:12-08:00,['077fd9ced3f5c7101c0d4e91c0ae3aeb05f9318f'],14,27,41,1449401,3,0.555555556,1,1,3648
d8eddc6e16012e43ab832d9f522d04429fc56227,0,Guozhang Wang,2018-02-08 09:53:57-08:00,['ac267dc5cec605f3981c9db7d889cabd59f09a61'],20,25,45,1449446,1,,,,3648
dd51d19306b73f9ff15a9d96c9c4904ce6e801ec,1,GitHub,2018-02-08 10:14:07-08:00,['d8eddc6e16012e43ab832d9f522d04429fc56227'],57,51,108,1449554,2,1,1,1,3648
a0fb4db40a5b4af915600d3a20081bb9e865a551,0,GitHub,2018-02-08 11:49:09-08:00,['dd51d19306b73f9ff15a9d96c9c4904ce6e801ec'],1,9,10,1449564,1,,,,3648
a1352f8c5a96c8e861c17c8105557428a47f4334,1,GitHub,2018-02-08 13:21:56-08:00,['a0fb4db40a5b4af915600d3a20081bb9e865a551'],155,200,355,1449919,11,0,1,1,3648
77a6104f548a42851cd44ca0ce73145784f924d3,1,GitHub,2018-02-08 13:35:57-08:00,['a1352f8c5a96c8e861c17c8105557428a47f4334'],2,337,339,1450258,5,,,,3650
15bc40507b06cccd1777e94b83ef8e5a9bdc9bc1,1,Jason Gustafson,2018-02-08 16:22:51-08:00,['77a6104f548a42851cd44ca0ce73145784f924d3'],55,134,189,1450447,6,0.537037037,0.907407407,0.925925926,3650
fc56a90e05a922722859ebc594736d6e7d3514ba,1,Rajini Sivaram,2018-02-09 04:59:18-08:00,['15bc40507b06cccd1777e94b83ef8e5a9bdc9bc1'],27,85,112,1450559,2,0.571428571,0.607142857,0.482142857,3650
dc54c0e24b3f7ca27990b1d576b8b8fd6d740ca1,1,GitHub,2018-02-09 15:29:21-08:00,['fc56a90e05a922722859ebc594736d6e7d3514ba'],35,188,223,1450782,2,0.647058824,1,1,3650
976a3b0cc858d4a13cf8b34b325aefc8d706be9e,1,Ewen Cheslack-Postava,2018-02-09 15:47:44-08:00,['dc54c0e24b3f7ca27990b1d576b8b8fd6d740ca1'],154,520,674,1451456,7,0.642487047,0.787564767,0.497409326,3651
9f4fe7679e96f0ca38a9f0bc0b43797ec0bf23e0,0,Jason Gustafson,2018-02-12 09:16:25-08:00,['976a3b0cc858d4a13cf8b34b325aefc8d706be9e'],1,27,28,1451484,2,1,1,1,3651
98959a126601e718a6bda459389d2f0e67dc481b,1,Guozhang Wang,2018-02-12 09:46:49-08:00,['9f4fe7679e96f0ca38a9f0bc0b43797ec0bf23e0'],4,4,8,1451492,1,,,,3651
596d3d0ec4ee1ba719ce87e464a095bd63ab72be,1,Jason Gustafson,2018-02-12 14:29:44-08:00,['98959a126601e718a6bda459389d2f0e67dc481b'],3,232,235,1451727,6,0.281437126,0.532934132,1,3651
f324de45b88a08357061c55ff69610d7b9ceb116,0,Guozhang Wang,2018-02-12 16:52:32-08:00,['596d3d0ec4ee1ba719ce87e464a095bd63ab72be'],21,21,42,1451769,1,,,,3651
65aa1a0c3eebe17e0fbe16be3d51d2ab8c692c59,1,Guozhang Wang,2018-02-12 16:54:52-08:00,['f324de45b88a08357061c55ff69610d7b9ceb116'],1,1,2,1451771,1,,,,3651
962bc638f9c2ab249e5008a587ee78e3ba35fcb9,0,GitHub,2018-02-12 18:28:18-08:00,['65aa1a0c3eebe17e0fbe16be3d51d2ab8c692c59'],2,40,42,1451813,1,0,1,1,3651
a42c4edfa79dfe66424fbfc356d126a3a689a3c1,0,Guozhang Wang,2018-02-12 18:33:59-08:00,['962bc638f9c2ab249e5008a587ee78e3ba35fcb9'],2,2,4,1451817,1,,,,3651
83b058a0d13955ade43440963f480c7fe3d94c6a,0,Guozhang Wang,2018-02-12 20:54:30-08:00,['a42c4edfa79dfe66424fbfc356d126a3a689a3c1'],23,22,45,1451862,3,1,0,1,3651
d030caf9561e306556f5e0ab323bb382e967138d,0,Jason Gustafson,2018-02-13 10:19:33-08:00,['83b058a0d13955ade43440963f480c7fe3d94c6a'],19,26,45,1451907,1,1,1,1,3651
a68a8b6b6cc47d488ada99e4bfe87cc7467621bb,1,Jason Gustafson,2018-02-13 11:44:12-08:00,['d030caf9561e306556f5e0ab323bb382e967138d'],9,132,141,1452048,2,0.830769231,0.830769231,1,3651
2693e9be7412ec03173c8942e9ccfcc24cfbbce1,1,Guozhang Wang,2018-02-13 16:39:21-08:00,['a68a8b6b6cc47d488ada99e4bfe87cc7467621bb'],31,35,66,1452114,7,0.25,1,1,3651
c0d579ca12f43c41536dbc7911d2d9485604c52c,0,Guozhang Wang,2018-02-13 18:24:08-08:00,['2693e9be7412ec03173c8942e9ccfcc24cfbbce1'],1,1,2,1452116,1,,,,3651
234b54c2c46fb7e7e60b3cedd5be642925f1da19,0,Guozhang Wang,2018-02-13 18:36:35-08:00,['c0d579ca12f43c41536dbc7911d2d9485604c52c'],2,2,4,1452120,1,,,,3651
d902b6b4b6bcf1cc1c488f6a975db8beed5689a6,0,Jason Gustafson,2018-02-14 08:46:22-08:00,['234b54c2c46fb7e7e60b3cedd5be642925f1da19'],2,20,22,1452142,2,1,1,1,3651
f3a3253e24d63cbfcbd42c8a550a3f898c734044,1,GitHub,2018-02-14 08:49:23-08:00,['d902b6b4b6bcf1cc1c488f6a975db8beed5689a6'],113,137,250,1452392,7,0.6,1,0.8,3651
36b00300f5a9117abb4e8570c1714b3023a0ab01,0,Rajini Sivaram,2018-02-14 17:53:49+00:00,['f3a3253e24d63cbfcbd42c8a550a3f898c734044'],1,1,2,1452394,1,,,,3651
6d18d882b850a8d757c32bb124b1e42e60587c69,1,GitHub,2018-02-14 10:52:46-08:00,['36b00300f5a9117abb4e8570c1714b3023a0ab01'],737,955,1692,1454086,13,0.625,1,0.928571429,3651
27b56b1458d0af0a397e9f47ecd008c10c088c6d,1,Guozhang Wang,2018-02-14 12:43:57-08:00,['6d18d882b850a8d757c32bb124b1e42e60587c69'],6,81,87,1454173,3,0.88,1,0.88,3651
38e9958d6e5d2224fbb9a54d04b1505ad561e8a3,1,GitHub,2018-02-14 22:09:45+00:00,['27b56b1458d0af0a397e9f47ecd008c10c088c6d'],7,257,264,1454437,6,0.302325581,0.255813953,1,3651
3af13967db089b9a8320b539f5d5d218488ce467,0,Ewen Cheslack-Postava,2018-02-14 16:24:05-08:00,['38e9958d6e5d2224fbb9a54d04b1505ad561e8a3'],1,28,29,1454466,1,0,1,1,3651
50cd85538580c9c9833ad957d64d39953c124374,0,Guozhang Wang,2018-02-14 17:02:47-08:00,['3af13967db089b9a8320b539f5d5d218488ce467'],3,52,55,1454521,2,0,1,1,3652
88307657dff0202804447d06eef6ecdc808590d8,0,Jun Rao,2018-02-14 17:30:09-08:00,['50cd85538580c9c9833ad957d64d39953c124374'],12,6,18,1454539,1,1,0,0,3652
015e224b3d3c8e7bc412686ff22d5e99324b1019,0,GitHub,2018-02-15 09:26:34+00:00,['88307657dff0202804447d06eef6ecdc808590d8'],22,177,199,1454738,8,0.4125,1,0.825,3653
d9d0d79287eeec0a1c3dcc2203288421284b5ca1,1,Jason Gustafson,2018-02-15 08:41:38-08:00,['015e224b3d3c8e7bc412686ff22d5e99324b1019'],139,216,355,1455093,25,1,1,0.977272727,3653
1067cc3422e6f2731ae57df9f01e84f2242a60be,0,GitHub,2018-02-15 17:36:44+00:00,['d9d0d79287eeec0a1c3dcc2203288421284b5ca1'],22,73,95,1455188,3,0,1,1,3653
bce8125dcf5a87ed29bbe795cd7591d45bdf3d9a,1,GitHub,2018-02-15 10:52:58-08:00,['1067cc3422e6f2731ae57df9f01e84f2242a60be'],22,22,44,1455232,3,1,0,0,3653
c72062ddc089c338a3017aff6db702ca74e56847,1,GitHub,2018-02-15 20:21:12+00:00,['bce8125dcf5a87ed29bbe795cd7591d45bdf3d9a'],16,137,153,1455385,2,0.95,0.95,1,3653
004ef6b04bbc0ce0ebfc1cad42656559b043bcb2,0,Ismael Juma,2018-02-15 14:11:00-08:00,['c72062ddc089c338a3017aff6db702ca74e56847'],26,19,45,1455430,1,1,1,0.1,3653
f12d237fdd47302d1c6c77553db986dd6dda568a,1,GitHub,2018-02-16 07:58:49-08:00,['004ef6b04bbc0ce0ebfc1cad42656559b043bcb2'],19,106,125,1455555,3,0.272727273,1,1,3654
55aa7de62adf6a99e6d6268c832b61de6b37d416,0,Jason Gustafson,2018-02-16 08:24:04-08:00,['f12d237fdd47302d1c6c77553db986dd6dda568a'],20,20,40,1455595,2,,,,3654
4837d44673490f6adf1e62466702f49c7f411250,0,Jason Gustafson,2018-02-16 08:30:14-08:00,['55aa7de62adf6a99e6d6268c832b61de6b37d416'],2,2,4,1455599,1,,,,3654
7303f41dc171e3a8f57c40abc467582602d1cde4,1,Matthias J. Sax,2018-02-16 12:36:21-08:00,['4837d44673490f6adf1e62466702f49c7f411250'],18,46,64,1455663,1,0,1,1,3654
0b3b6049f002acf040a5312cef35c87f199bbfd2,0,GitHub,2018-02-16 13:13:13-08:00,['7303f41dc171e3a8f57c40abc467582602d1cde4'],8,10,18,1455681,2,0.75,1,0.75,3654
a2b6f66fd37a436ebdd5bee1b74ca157c5ddf9c9,0,Matthias J. Sax,2018-02-16 13:24:18-08:00,['0b3b6049f002acf040a5312cef35c87f199bbfd2'],0,2,2,1455683,1,,,,3654
13caded15e21bff450f6f042e86f856046e0f40a,0,Ismael Juma,2018-02-16 15:03:32-08:00,['a2b6f66fd37a436ebdd5bee1b74ca157c5ddf9c9'],3,11,14,1455697,1,0,1,1,3654
b20639db4489a264d25ca5ad6f5b78489cc3fb0f,1,GitHub,2018-02-16 23:20:16+00:00,['13caded15e21bff450f6f042e86f856046e0f40a'],2,100,102,1455799,3,1,1,1,3655
7c09b9410a63a1dda118b872afcbd2fcdcd56b65,1,Jason Gustafson,2018-02-16 18:04:21-08:00,['b20639db4489a264d25ca5ad6f5b78489cc3fb0f'],5,100,105,1455904,2,0.25974026,0.25974026,1,3655
ee352be9c88663b95b1096b7a294e61857857380,0,Jason Gustafson,2018-02-16 18:30:12-08:00,['7c09b9410a63a1dda118b872afcbd2fcdcd56b65'],39,63,102,1456006,6,1,1,1,3655
1547cf6de86bbb8f7bacc26ab9ab89d4c9ec5566,1,Rajini Sivaram,2018-02-20 09:32:09+00:00,['ee352be9c88663b95b1096b7a294e61857857380'],5,62,67,1456073,3,0.413043478,0.804347826,0.804347826,3655
f10c0d38634822ab4c9abc4744268c9fd5b50a2c,1,Damian Guy,2018-02-20 10:45:50+00:00,['1547cf6de86bbb8f7bacc26ab9ab89d4c9ec5566'],3,5,8,1456081,1,0,1,1,3655
a41373309497da449a1f757e2c24399794d77072,1,Ismael Juma,2018-02-20 07:19:30-08:00,['f10c0d38634822ab4c9abc4744268c9fd5b50a2c'],28,12,40,1456121,2,0,1,0,3655
ac2536e77e43510cde6009146487a5f867bf9b3f,1,Jason Gustafson,2018-02-20 08:57:21-08:00,['a41373309497da449a1f757e2c24399794d77072'],7,55,62,1456183,3,0.25,1,0.875,3655
b79e11bb511e259c8187d865761c3b448391603f,0,Damian Guy,2018-02-20 17:15:31+00:00,['ac2536e77e43510cde6009146487a5f867bf9b3f'],2,4,6,1456189,1,0,0,0,3655
57059d40223d6284d1b2c9f3034b30f6bd61c44f,0,Damian Guy,2018-02-20 17:46:05+00:00,['b79e11bb511e259c8187d865761c3b448391603f'],2,2,4,1456193,1,,,,3655
eaafbdecb56d11f66d833b63fbc2aced65990e69,0,Rajini Sivaram,2018-02-20 20:42:05+00:00,['57059d40223d6284d1b2c9f3034b30f6bd61c44f'],15,37,52,1456245,9,1,1,1,3655
256708dbbb7204e4025f2ca74eceea1170236255,1,Guozhang Wang,2018-02-20 12:46:36-08:00,['eaafbdecb56d11f66d833b63fbc2aced65990e69'],128,128,256,1456501,7,1,1,1,3655
a050eb56f759954498a0a58993d754cebde144d5,0,GitHub,2018-02-20 13:07:50-08:00,['256708dbbb7204e4025f2ca74eceea1170236255'],3,12,15,1456516,1,0,0,0,3655
f3c4240e6cd4237b1160328fb037708de138a05b,0,Jason Gustafson,2018-02-20 13:39:45-08:00,['a050eb56f759954498a0a58993d754cebde144d5'],1,0,1,1456517,1,1,0,0,3655
75df8cc77adc61746b3abd0e48d2c7a343e805f6,1,Ismael Juma,2018-02-20 13:53:49-08:00,['f3c4240e6cd4237b1160328fb037708de138a05b'],2,12,14,1456531,1,,,,3655
660c0c0aa33ced5307ee70bfdb78ebde4b978d73,1,Damian Guy,2018-02-21 09:38:39+00:00,['75df8cc77adc61746b3abd0e48d2c7a343e805f6'],32,131,163,1456694,9,0.672413793,0.948275862,1,3656
90e0bbec94dd85e1c5b1af0b6426df0a02e5da3f,0,Jason Gustafson,2018-02-21 08:43:25-08:00,['660c0c0aa33ced5307ee70bfdb78ebde4b978d73'],13,48,61,1456755,7,0.6875,1,1,3656
1667c16be1747ae2ffaab410a5903ad284209456,0,Jason Gustafson,2018-02-21 08:58:35-08:00,['90e0bbec94dd85e1c5b1af0b6426df0a02e5da3f'],4,7,11,1456766,1,,,,3656
da379c95e4e3fe4dbe4d810a27a2d0b821cb2fb1,0,Ewen Cheslack-Postava,2018-02-21 10:52:27-08:00,['1667c16be1747ae2ffaab410a5903ad284209456'],0,2,2,1456768,1,1,1,0.5,3656
1715e6eac03e26f745b3a6f97a8b61b335207e9d,0,GitHub,2018-02-21 15:53:46-08:00,['da379c95e4e3fe4dbe4d810a27a2d0b821cb2fb1'],29,36,65,1456833,2,0,0,1,3656
fc19c3e6f243a8d1b3e27cdc912dc092bbd342e0,1,Damian Guy,2018-02-22 09:39:59+00:00,['1715e6eac03e26f745b3a6f97a8b61b335207e9d'],2,17,19,1456852,9,0.5,0.875,0.625,3656
1cabef0d3dc7a3c245f260b8d34a60d7d044bb9c,1,Jason Gustafson,2018-02-22 08:19:13-08:00,['fc19c3e6f243a8d1b3e27cdc912dc092bbd342e0'],21,32,53,1456905,3,1,1,1,3656
1d8ed875db6ec624cdb8bc15ec677729a42fc13a,0,Rajini Sivaram,2018-02-22 17:47:13+00:00,['1cabef0d3dc7a3c245f260b8d34a60d7d044bb9c'],11,7,18,1456923,1,,,,3656
66039b1312be6356a3cb12efa8e562d2264498d1,1,Jason Gustafson,2018-02-22 22:23:14-08:00,['1d8ed875db6ec624cdb8bc15ec677729a42fc13a'],3,32,35,1456958,3,0,1,1,3656
0e22fd6f8d49e7884b7126d963af12ab305d5629,0,Jason Gustafson,2018-02-22 22:29:49-08:00,['66039b1312be6356a3cb12efa8e562d2264498d1'],80,94,174,1457132,2,0,0.5,1,3656
e26d0d760466c3da6189637a7de69eb5509e7b51,0,GitHub,2018-02-23 15:31:50-08:00,['0e22fd6f8d49e7884b7126d963af12ab305d5629'],428,309,737,1457869,6,0.775510204,0,0,3656
0cd83e997dd8ca3ac0cc6458eee75fdf7b66ae57,0,GitHub,2018-02-23 16:13:57-08:00,['e26d0d760466c3da6189637a7de69eb5509e7b51'],0,9,9,1457878,1,0,0,1,3656
4a027a0af10bc10bb223856100fdc19c6186a405,0,Jason Gustafson,2018-02-24 12:07:42-08:00,['0cd83e997dd8ca3ac0cc6458eee75fdf7b66ae57'],1,1,2,1457880,1,,,,3656
99d650c2c882cc1f359a1dbb5fc6bea2d5b303b6,1,Jason Gustafson,2018-02-24 18:43:10-08:00,['4a027a0af10bc10bb223856100fdc19c6186a405'],17,41,58,1457938,2,0,1,1,3656
5df535e8a349771942050f1e3fd58851f413fa3a,1,GitHub,2018-02-25 12:26:18-08:00,['99d650c2c882cc1f359a1dbb5fc6bea2d5b303b6'],78,70,148,1458086,11,0.5,1,0,3656
3600316a1490e81e4efafc15dd0ac31025b76e1c,0,Jason Gustafson,2018-02-26 09:00:39-08:00,['5df535e8a349771942050f1e3fd58851f413fa3a'],7,7,14,1458100,1,,,,3656
2591a469305532ba79497dd435f58a9051b689db,0,Jason Gustafson,2018-02-26 11:26:34-08:00,['3600316a1490e81e4efafc15dd0ac31025b76e1c'],15,71,86,1458186,3,0.333333333,0.972222222,1,3656
7c5d0c459f1d4a8796e3b5af925f40fd4f8a69fa,0,Guozhang Wang,2018-02-26 12:25:53-08:00,['2591a469305532ba79497dd435f58a9051b689db'],8,8,16,1458202,3,,,,3656
f26fbb9adcd66a31740da5c99f14a108bbc24304,1,GitHub,2018-02-26 14:39:47-08:00,['7c5d0c459f1d4a8796e3b5af925f40fd4f8a69fa'],39,39,78,1458280,10,,,,3656
97ad549d56d3432b0c70e72d402ebec1d07f8273,1,GitHub,2018-02-27 00:29:25-08:00,['f26fbb9adcd66a31740da5c99f14a108bbc24304'],18,67,85,1458365,9,0,0.416666667,1,3656
031f522a2d45c22540fb1e15ae0d0d3bf6061a98,0,Jason Gustafson,2018-02-27 19:04:29-08:00,['97ad549d56d3432b0c70e72d402ebec1d07f8273'],1,1,2,1458367,1,,,,3656
9166ae4ec45ae7dccaa90d8950b3583d7efd0a34,0,Jason Gustafson,2018-02-27 19:06:07-08:00,['031f522a2d45c22540fb1e15ae0d0d3bf6061a98'],1,1,2,1458369,1,,,,3656
f582a7515c9303589a7cf964e53bd12992c66254,0,Ewen Cheslack-Postava,2018-02-28 10:28:55-08:00,['9166ae4ec45ae7dccaa90d8950b3583d7efd0a34'],29,135,164,1458533,1,0.660377358,1,1,3656
eb449fe7c55a0816328a851fc1102dfeac6d8616,1,GitHub,2018-03-01 09:27:11-08:00,['f582a7515c9303589a7cf964e53bd12992c66254'],333,377,710,1459243,15,1,1,1,3656
6cfcc9d553622e7d511a849935e9b504f947399d,1,GitHub,2018-03-01 11:04:11-08:00,['eb449fe7c55a0816328a851fc1102dfeac6d8616'],57,213,270,1459513,6,0.725,0.766666667,0.966666667,3656
9868976747fb4a7a4a9b18e1f4050633c226be7d,1,Ismael Juma,2018-03-02 11:25:43-08:00,['6cfcc9d553622e7d511a849935e9b504f947399d'],26,555,581,1460094,2,0.568831169,1,0.919480519,3656
604b93cfdee7a8c5c879ef2217d50be88e39ac89,1,GitHub,2018-03-03 13:27:29-08:00,['9868976747fb4a7a4a9b18e1f4050633c226be7d'],109,210,319,1460413,2,0.576923077,1,0.807692308,3656
2a4ba75e1338eaa97da87077330b43d7448a18bc,1,GitHub,2018-03-05 10:56:42-08:00,['604b93cfdee7a8c5c879ef2217d50be88e39ac89'],289,530,819,1461232,8,0.965346535,1,0.782178218,3656
8a7d7e7955889125b1196caeded6fa57d93a0b46,1,Matthias J. Sax,2018-03-05 11:06:32-08:00,['2a4ba75e1338eaa97da87077330b43d7448a18bc'],1,589,590,1461822,6,0.307958478,0.522491349,0.896193772,3661
8f2c08716630eba7e3badacc79be4c8c413a00da,1,GitHub,2018-03-05 16:48:05-08:00,['8a7d7e7955889125b1196caeded6fa57d93a0b46'],27,151,178,1462000,4,0.581395349,1,1,3661
a1b01f48e9ef06291f3e052a37bde887b891e708,0,Guozhang Wang,2018-03-05 21:24:22-08:00,['8f2c08716630eba7e3badacc79be4c8c413a00da'],4,61,65,1462065,2,0.340909091,0.954545455,1,3661
d13cbd0cae26d13c36c25d04a489ee309187ebeb,1,Jason Gustafson,2018-03-05 22:21:53-08:00,['a1b01f48e9ef06291f3e052a37bde887b891e708'],3,64,67,1462132,3,,,,3661
e5d6c9a79a4ca9b82502b8e7f503d86ddaddb7fb,1,GitHub,2018-03-06 11:19:38-08:00,['d13cbd0cae26d13c36c25d04a489ee309187ebeb'],8,20,28,1462160,2,0.8,1,0.9,3661
23c1c52c85eaca9d51046f5235721a3239c2a229,0,GitHub,2018-03-06 15:37:50-08:00,['e5d6c9a79a4ca9b82502b8e7f503d86ddaddb7fb'],0,34,34,1462194,2,,,,3663
cf092aeecc473b70d81c00b604e29de8c9f6d84b,0,Guozhang Wang,2018-03-06 17:49:33-08:00,['23c1c52c85eaca9d51046f5235721a3239c2a229'],44,37,81,1462275,5,1,0,0,3663
925d6a2ef363ee540e65f7ec3b699dce05aa591c,1,Rajini Sivaram,2018-03-08 11:00:20+00:00,['cf092aeecc473b70d81c00b604e29de8c9f6d84b'],32,100,132,1462407,9,0.479166667,0.354166667,1,3663
c5ba0da99301c9ffc1216e23541cbe7d2cc9a102,0,Jason Gustafson,2018-03-08 10:28:20-08:00,['925d6a2ef363ee540e65f7ec3b699dce05aa591c'],3,3,6,1462413,3,,,,3663
989088f697a221bc2b7b1d0d0ae6e9d03b2bf8ac,1,Guozhang Wang,2018-03-08 13:24:22-08:00,['c5ba0da99301c9ffc1216e23541cbe7d2cc9a102'],20,96,116,1462529,10,1,1,1,3664
6a383d8bc4555665fad502bb9b6e6c97657d996a,1,Matthias J. Sax,2018-03-08 15:43:45-08:00,['989088f697a221bc2b7b1d0d0ae6e9d03b2bf8ac'],1,62,63,1462592,2,0.02,1,1,3664
db619c6da2b1f02a4ca321d7a3b91ef47c09a46c,0,Ismael Juma,2018-03-09 07:44:57-08:00,['6a383d8bc4555665fad502bb9b6e6c97657d996a'],1,1,2,1462594,1,,,,3664
3ef2fb843e873a4597b1d1d068144102271d3002,1,GitHub,2018-03-09 16:50:34+00:00,['db619c6da2b1f02a4ca321d7a3b91ef47c09a46c'],10,26,36,1462630,2,0,0.866666667,0.8,3664
b1aa1912f08765d9914e3d036deee6b71ea009dd,1,Guozhang Wang,2018-03-09 11:08:08-08:00,['3ef2fb843e873a4597b1d1d068144102271d3002'],979,1236,2215,1464845,51,1,1,0.704225352,3673
f1c112c63d8223e62cf9e2f31cc42321f1e6dada,1,Ismael Juma,2018-03-09 13:57:04-08:00,['b1aa1912f08765d9914e3d036deee6b71ea009dd'],18,356,374,1465219,6,0.794701987,1,0.894039735,3676
5760da7d0be8d9326e82f187015d5c0169bfb40b,0,Jason Gustafson,2018-03-09 14:21:06-08:00,['f1c112c63d8223e62cf9e2f31cc42321f1e6dada'],2,5,7,1465226,1,0,0,1,3676
fd015b401dcc977b51396f80fab5acdd792ba694,0,Ismael Juma,2018-03-09 14:54:43-08:00,['5760da7d0be8d9326e82f187015d5c0169bfb40b'],1,4,5,1465231,1,,,,3676
8d4d5f8c9ffeba45022014bdcf98eddbd3a3afc8,1,Jun Rao,2018-03-09 15:18:23-08:00,['fd015b401dcc977b51396f80fab5acdd792ba694'],14,45,59,1465290,2,0.607142857,1,1,3676
8df96a4119a5d46372eecdceb916f80dd073338a,0,GitHub,2018-03-10 15:57:05+00:00,['8d4d5f8c9ffeba45022014bdcf98eddbd3a3afc8'],17,11,28,1465318,1,1,0,0,3676
c28c556e9295b9d499f7b1b0ec65bbb4d1ad4b67,0,Guozhang Wang,2018-03-11 11:38:03-07:00,['8df96a4119a5d46372eecdceb916f80dd073338a'],3,3,6,1465324,1,,,,3676
825bfe5adefe4b5f967068b332cb0feedd7dc4fc,0,GitHub,2018-03-12 04:40:59-07:00,['c28c556e9295b9d499f7b1b0ec65bbb4d1ad4b67'],3,5,8,1465332,3,,,,3676
8e84961661e4d033a68dfff8498436d14b396bb3,1,GitHub,2018-03-12 13:11:29-07:00,['825bfe5adefe4b5f967068b332cb0feedd7dc4fc'],5,22,27,1465359,1,,,,3676
596b6048623c7c001dbe5299bc373729d28d83e8,0,Jason Gustafson,2018-03-12 14:34:59-07:00,['8e84961661e4d033a68dfff8498436d14b396bb3'],1,1,2,1465361,1,,,,3676
29d2e8cf17815fd738323006dd20e57a8d85be84,1,Jason Gustafson,2018-03-12 15:13:34-07:00,['596b6048623c7c001dbe5299bc373729d28d83e8'],7,73,80,1465441,2,,,,3676
724032bd06ae6928595ad3d5d21ead7f9e834d34,0,Guozhang Wang,2018-03-12 16:32:19-07:00,['29d2e8cf17815fd738323006dd20e57a8d85be84'],1,1,2,1465443,1,,,,3676
1ea07b993d75ed68f4c04282eb177bf84156e0b2,1,Jun Rao,2018-03-12 22:20:44-07:00,['724032bd06ae6928595ad3d5d21ead7f9e834d34'],5,13,18,1465461,1,0.571428571,0.571428571,1,3676
0bb8e66184931e2f7830cb713d9260cc0f3383a9,0,Jason Gustafson,2018-03-12 23:03:32-07:00,['1ea07b993d75ed68f4c04282eb177bf84156e0b2'],13,12,25,1465486,1,0,0,0,3676
2bf06890b9af62b0aa0ed0debc1b36232afe463a,0,Jason Gustafson,2018-03-12 23:23:00-07:00,['0bb8e66184931e2f7830cb713d9260cc0f3383a9'],3,15,18,1465504,1,0,1,0,3676
0c00aa0983f963dae18232ca539cc0731f228c70,0,GitHub,2018-03-13 00:42:40-07:00,['2bf06890b9af62b0aa0ed0debc1b36232afe463a'],2,2,4,1465508,1,,,,3676
ec9e8110e3967c3ef38ed475a0cb40fc951a2aef,0,Rajini Sivaram,2018-03-13 13:15:44+00:00,['0c00aa0983f963dae18232ca539cc0731f228c70'],2,9,11,1465519,3,,,,3676
95ad03540f0d15ae47fd73bae935ab1cb3e8f4b9,1,GitHub,2018-03-13 08:43:58-07:00,['ec9e8110e3967c3ef38ed475a0cb40fc951a2aef'],39,41,80,1465599,6,0,1,1,3676
ad355298c65c2c00131480ab2ed59d79539ea80f,0,Jason Gustafson,2018-03-13 13:59:13-07:00,['95ad03540f0d15ae47fd73bae935ab1cb3e8f4b9'],79,0,79,1465678,3,0,0,0,3676
aa14ec08b76a1d9e85e39c4aa48e0554b7e17301,0,Jason Gustafson,2018-03-13 16:41:54-07:00,['ad355298c65c2c00131480ab2ed59d79539ea80f'],17,0,17,1465695,1,,,,3676
6b08905dfb40923317745b5e2237b2310b713333,1,Jason Gustafson,2018-03-13 22:52:59-07:00,['aa14ec08b76a1d9e85e39c4aa48e0554b7e17301'],7,47,54,1465749,4,0.095238095,1,1,3676
bf8a4c2ce7291e2f92fca297e970f668b4b85066,0,Rajini Sivaram,2018-03-14 10:12:15+00:00,['6b08905dfb40923317745b5e2237b2310b713333'],27,167,194,1465943,6,0.864864865,0.918918919,0.824324324,3676
d2bbcbed442d3c3c6e5351b93c93f860c144ef47,1,Jason Gustafson,2018-03-14 08:46:07-07:00,['bf8a4c2ce7291e2f92fca297e970f668b4b85066'],1,1,2,1465945,1,,,,3676
d93569948657a1fd58dad9fd2541b75b2b330a4a,1,Jason Gustafson,2018-03-14 14:58:24-07:00,['d2bbcbed442d3c3c6e5351b93c93f860c144ef47'],2,3,5,1465950,1,0,0,1,3676
35c08189cb862090676898e7568cd6d30091424b,0,Matthias J. Sax,2018-03-14 15:19:51-07:00,['d93569948657a1fd58dad9fd2541b75b2b330a4a'],3,3,6,1465956,1,,,,3676
925acc9f47bb4265f4b033e75467643dbc9ccab9,0,GitHub,2018-03-14 17:33:54-07:00,['35c08189cb862090676898e7568cd6d30091424b'],1,8,9,1465965,1,,,,3676
5cdb951091129b530326140aa711f0b61c446f06,1,Jason Gustafson,2018-03-15 00:09:48-07:00,['925acc9f47bb4265f4b033e75467643dbc9ccab9'],86,197,283,1466248,2,0.265822785,1,1,3676
8c10e0600736e8620f868ae15516d1fc06f775a2,1,Rajini Sivaram,2018-03-15 11:44:27+00:00,['5cdb951091129b530326140aa711f0b61c446f06'],22,100,122,1466370,14,0.433333333,1,0.966666667,3677
372b4c6a775461c6ca54d4c58078718f5f046216,1,GitHub,2018-03-15 10:33:29-07:00,['8c10e0600736e8620f868ae15516d1fc06f775a2'],40,86,126,1466496,2,0.813953488,1,1,3677
d2aca95aeb7e15bebb7726987586b7f5cadbe0ef,0,Guozhang Wang,2018-03-15 11:34:33-07:00,['372b4c6a775461c6ca54d4c58078718f5f046216'],1,1,2,1466498,1,,,,3677
a6fad27372f9a931540c2e4345e428b643535d46,1,Matthias J. Sax,2018-03-15 13:02:28-07:00,['d2aca95aeb7e15bebb7726987586b7f5cadbe0ef'],117,74,191,1466689,6,0,0.055555556,0,3677
7006d0f58b9a72f181b13bab6f1f64b0e7b4117e,1,Guozhang Wang,2018-03-15 14:42:43-07:00,['a6fad27372f9a931540c2e4345e428b643535d46'],78,105,183,1466872,7,0.333333333,1,0.333333333,3677
e7ef719a5bc0d1276f0e9482d59b25406fda276b,0,Ewen Cheslack-Postava,2018-03-15 15:52:53-07:00,['7006d0f58b9a72f181b13bab6f1f64b0e7b4117e'],5,31,36,1466908,2,0,1,1,3677
9e0e6e43a787092ff908cb17da37ab5dea03978b,0,Rajini Sivaram,2018-03-16 17:57:38+00:00,['e7ef719a5bc0d1276f0e9482d59b25406fda276b'],6,75,81,1466989,4,0,0.851851852,1,3678
a9c16a8110f9a3c9ef2ec4c595c8802dbcd63635,0,Matthias J. Sax,2018-03-16 13:24:14-07:00,['9e0e6e43a787092ff908cb17da37ab5dea03978b'],2,1,3,1466992,1,,,,3678
b6ae51b108d48a1ac5e5721cd4c3b54ed845e040,0,Matthias J. Sax,2018-03-16 15:30:38-07:00,['a9c16a8110f9a3c9ef2ec4c595c8802dbcd63635'],0,3,3,1466995,1,0,0,0,3678
394aa7426117d0d04666c1c2a63d5f98229b7894,1,GitHub,2018-03-16 16:02:11-07:00,['b6ae51b108d48a1ac5e5721cd4c3b54ed845e040'],197,481,678,1467673,27,0.474137931,0.267241379,0.75,3680
a70e4f95d713dd34757b3807171a2e520dd9c04d,0,Jason Gustafson,2018-03-16 16:15:49-07:00,['394aa7426117d0d04666c1c2a63d5f98229b7894'],233,422,655,1468328,11,0.316666667,0.566666667,0.85,3684
9782465d6f28dda7fd7f156743f4278e6b62364b,0,GitHub,2018-03-16 22:29:22-07:00,['a70e4f95d713dd34757b3807171a2e520dd9c04d'],8,12,20,1468348,3,1,1,1,3684
2afac715666347a30ac54cef1485db369288b478,0,Jason Gustafson,2018-03-16 23:34:16-07:00,['9782465d6f28dda7fd7f156743f4278e6b62364b'],3,3,6,1468354,3,,,,3684
ae31ee63dc3bdb9068543791bea44a12a97aa928,1,Jason Gustafson,2018-03-17 10:29:42-07:00,['2afac715666347a30ac54cef1485db369288b478'],120,255,375,1468729,11,0.086956522,1,1,3684
7fe06a86665e513f73caff824a36a723ab21c917,0,GitHub,2018-03-17 18:02:20-07:00,['ae31ee63dc3bdb9068543791bea44a12a97aa928'],1,1,2,1468731,1,,,,3684
4391a4214de7594e64de4b0b0d5a1196813b04b8,1,Jason Gustafson,2018-03-18 11:21:43-07:00,['7fe06a86665e513f73caff824a36a723ab21c917'],2,4,6,1468737,1,1,1,1,3684
02a8ef859539349151e9d1dd0c69ac83a24ee7a2,0,Matthias J. Sax,2018-03-18 20:44:11-07:00,['4391a4214de7594e64de4b0b0d5a1196813b04b8'],2,17,19,1468756,2,1,1,1,3684
f264bfa2967f4b431f09d8b99d5f468fca310805,0,Rajini Sivaram,2018-03-19 10:37:02+00:00,['02a8ef859539349151e9d1dd0c69ac83a24ee7a2'],7,37,44,1468800,3,1,1,0.6,3684
7041e76bd6ef0c28ec8de2d07f2208171745f936,1,Rajini Sivaram,2018-03-19 11:08:12+00:00,['f264bfa2967f4b431f09d8b99d5f468fca310805'],24,19,43,1468843,4,1,1,1,3684
0560193706bf7c7dbe39d8baa65129d765ca9868,0,Rajini Sivaram,2018-03-19 11:55:29+00:00,['7041e76bd6ef0c28ec8de2d07f2208171745f936'],4,29,33,1468876,3,,,,3685
6fab286da2735517f6d0c945328abcb77fa0a7a4,1,Rajini Sivaram,2018-03-19 15:03:58+00:00,['0560193706bf7c7dbe39d8baa65129d765ca9868'],18,16,34,1468910,11,,,,3685
27bb3ccaceae52c730b2c02d72c63a84060966f1,0,Jason Gustafson,2018-03-19 13:30:13-07:00,['6fab286da2735517f6d0c945328abcb77fa0a7a4'],1,1,2,1468912,1,,,,3685
0f364cd53a7a56e4ddea1db44fd044860ba2c0b4,1,GitHub,2018-03-19 14:17:00-07:00,['27bb3ccaceae52c730b2c02d72c63a84060966f1'],95,136,231,1469143,13,1,0.388888889,1,3685
aefe35e493758e439d7dd5cb5aa50762132a5e5d,1,Rajini Sivaram,2018-03-19 22:22:53+00:00,['0f364cd53a7a56e4ddea1db44fd044860ba2c0b4'],2,57,59,1469202,2,1,1,1,3685
5c24295d44b4f015a620914992542c4d2083c611,1,Rajini Sivaram,2018-03-20 13:51:45+00:00,['aefe35e493758e439d7dd5cb5aa50762132a5e5d'],66,405,471,1469673,8,0.548387097,0.940860215,0.709677419,3686
36d4b91573028a687236ab27154ce4a04d9d8cb3,0,Rajini Sivaram,2018-03-20 13:56:40+00:00,['5c24295d44b4f015a620914992542c4d2083c611'],4,5,9,1469682,1,,,,3686
f5287ccad2de7de586788ed4ee08a065a007a42e,0,Ismael Juma,2018-03-20 22:36:41-07:00,['36d4b91573028a687236ab27154ce4a04d9d8cb3'],14,15,29,1469711,1,0,1,0,3686
2f90cb86c18e854fd687ea7bbeb8692178bbb02d,1,Jason Gustafson,2018-03-20 22:40:16-07:00,['f5287ccad2de7de586788ed4ee08a065a007a42e'],18,29,47,1469758,2,1,1,0,3686
f0a29a693548efe539cba04807e21862c8dfc1bf,0,GitHub,2018-03-21 16:24:59-07:00,['2f90cb86c18e854fd687ea7bbeb8692178bbb02d'],6,0,6,1469764,1,1,1,0,3686
57b1c28d60e05f2cf7394ef727a86df92b1bb02b,1,GitHub,2018-03-22 20:05:45+00:00,['f0a29a693548efe539cba04807e21862c8dfc1bf'],25,71,96,1469860,4,0,0,0.945945946,3686
9ee00c4b6661a590afcd5fb390bd0abaa3dcce1b,0,Matthias J. Sax,2018-03-22 15:37:28-07:00,['57b1c28d60e05f2cf7394ef727a86df92b1bb02b'],1,7,8,1469868,1,0,1,1,3686
286216b56e27d8db18f7268b63cbd8d7f8bd8830,1,Matthias J. Sax,2018-03-22 16:02:16-07:00,['9ee00c4b6661a590afcd5fb390bd0abaa3dcce1b'],141,277,418,1470286,5,0,1,0.719298246,3688
f2fbfaaccc99f889ae0796005a46d6c62c8e5be9,1,GitHub,2018-03-22 16:46:56-07:00,['286216b56e27d8db18f7268b63cbd8d7f8bd8830'],28,142,170,1470456,8,0.105263158,0.078947368,0.736842105,3688
fcf87816028830d168fd2142cf5277adcbade91b,1,Ismael Juma,2018-03-22 21:42:49-07:00,['f2fbfaaccc99f889ae0796005a46d6c62c8e5be9'],164,274,438,1470894,6,0,0.671232877,1,3688
395dcad7d9208aad5399222e1d19a13fecf035c9,0,GitHub,2018-03-22 22:01:51-07:00,['fcf87816028830d168fd2142cf5277adcbade91b'],9,17,26,1470920,2,,,,3688
2307314432c871cf045787b44295d8dc4943e77d,0,GitHub,2018-03-23 17:01:32+00:00,['395dcad7d9208aad5399222e1d19a13fecf035c9'],9,13,22,1470942,2,0,0,0,3688
685fd03dda02957a91a50fa16409400b1ea08f81,0,Jiangjie Qin,2018-03-23 18:18:16-07:00,['2307314432c871cf045787b44295d8dc4943e77d'],3,101,104,1471046,2,0.418918919,1,1,3688
dd78b9fa268ad1708b6e6da583e8b7e2a6bd690a,0,Jason Gustafson,2018-03-24 12:14:53-07:00,['685fd03dda02957a91a50fa16409400b1ea08f81'],1,1,2,1471048,1,,,,3688
549a5cec1ee82eb86e5b8bcb3886bf2d2dde2b39,0,Jason Gustafson,2018-03-24 12:20:11-07:00,['dd78b9fa268ad1708b6e6da583e8b7e2a6bd690a'],3,1,4,1471052,1,0,0,0,3688
514936af6f04e00ad908d3835040db5b0d5698c2,0,Jason Gustafson,2018-03-24 12:39:10-07:00,['549a5cec1ee82eb86e5b8bcb3886bf2d2dde2b39'],1,0,1,1471053,1,1,0,0,3688
f66aebff363c768afb50b10f31458c2f447b0abc,0,GitHub,2018-03-24 20:54:09+00:00,['514936af6f04e00ad908d3835040db5b0d5698c2'],9,29,38,1471091,2,0,0.666666667,1,3688
3f611044cc55c6633cb64fd86a3ac6274952fa72,0,Jason Gustafson,2018-03-24 14:04:08-07:00,['f66aebff363c768afb50b10f31458c2f447b0abc'],37,193,230,1471321,3,0.410852713,1,1,3688
f4a39f9b8314847ffc7250f8cee3e87795b0aaeb,0,Guozhang Wang,2018-03-26 16:22:20-07:00,['3f611044cc55c6633cb64fd86a3ac6274952fa72'],1,5,6,1471327,2,0,1,1,3688
9eb32eaad5fa3863d60b84ef095fa041e83b7b47,1,Jason Gustafson,2018-03-27 09:21:18-07:00,['f4a39f9b8314847ffc7250f8cee3e87795b0aaeb'],7,103,110,1471437,5,0.112676056,1,1,3688
395c7e0f0985b424ea2bc2bd40c0237eada24dcf,0,Jason Gustafson,2018-03-27 13:18:53-07:00,['9eb32eaad5fa3863d60b84ef095fa041e83b7b47'],1,3,4,1471441,1,0,1,1,3688
adbf31ab1d27cda0b62d611e6141d830736a8e2e,1,Matthias J. Sax,2018-03-27 14:03:24-07:00,['395c7e0f0985b424ea2bc2bd40c0237eada24dcf'],203,1328,1531,1472972,38,0.469758065,1,0.903225806,3691
964693e40d9303d5d754010f03731d2134bae749,1,Guozhang Wang,2018-03-27 16:09:34-07:00,['adbf31ab1d27cda0b62d611e6141d830736a8e2e'],52,91,143,1473115,8,1,1,0,3691
281dbfd9813603d913a2a0b948547dea7b863be2,0,GitHub,2018-03-27 21:03:35-07:00,['964693e40d9303d5d754010f03731d2134bae749'],2,1,3,1473118,1,0,1,0,3691
9baa9bddba0dc1b3bda167ea509bd90226615e1f,0,Jason Gustafson,2018-03-27 23:08:07-07:00,['281dbfd9813603d913a2a0b948547dea7b863be2'],1,1,2,1473120,1,,,,3691
5d5a2ce4bba4b42b3652d0126d1d2dab979a3e07,0,Rajini Sivaram,2018-03-28 15:03:39+01:00,['9baa9bddba0dc1b3bda167ea509bd90226615e1f'],4,5,9,1473129,1,1,1,1,3691
dd7011783f7e013a0a40a0d4d0e38ac2612b36e1,0,Jason Gustafson,2018-03-28 10:33:23-07:00,['5d5a2ce4bba4b42b3652d0126d1d2dab979a3e07'],2,0,2,1473131,1,1,1,1,3691
659fbb0b06a79fa7e94ac0d68925b1718ed3f214,0,Guozhang Wang,2018-03-28 11:00:35-07:00,['dd7011783f7e013a0a40a0d4d0e38ac2612b36e1'],1,3,4,1473135,1,,,,3691
28f1fc2f55269f43f0b2bb769b78f80b8cc9cf51,1,GitHub,2018-03-28 14:40:21-07:00,['659fbb0b06a79fa7e94ac0d68925b1718ed3f214'],14,14,28,1473163,5,,,,3691
77b840b7c40dab29d1c05c70b3fd1e3ac981da6c,0,GitHub,2018-03-28 16:10:26-07:00,['28f1fc2f55269f43f0b2bb769b78f80b8cc9cf51'],1,1,2,1473165,1,,,,3691
29838c104249572cebac69c7d156dff4e1cc41f1,1,Guozhang Wang,2018-03-28 17:41:08-07:00,['77b840b7c40dab29d1c05c70b3fd1e3ac981da6c'],5,8,13,1473178,2,,,,3691
cb7cf7c5a78ef2d0beadac023fb0b2250a313160,0,Guozhang Wang,2018-03-29 15:50:46-07:00,['29838c104249572cebac69c7d156dff4e1cc41f1'],5,3,8,1473186,3,,,,3691
fc0d0021cc74bf957b3ebf7e5d98e40f718fe1c4,0,Guozhang Wang,2018-03-29 16:24:34-07:00,['cb7cf7c5a78ef2d0beadac023fb0b2250a313160'],6,6,12,1473198,1,,,,3691
2ef6ee2338178c7501f5bd4c7cce5f4cea9d3e17,0,Jun Rao,2018-03-29 22:08:28-07:00,['fc0d0021cc74bf957b3ebf7e5d98e40f718fe1c4'],99,148,247,1473445,7,0.428571429,0.333333333,1,3691
4106cb1db18cc45cbbeb54546a7468a4727bd88f,1,Ismael Juma,2018-03-31 07:57:19-07:00,['2ef6ee2338178c7501f5bd4c7cce5f4cea9d3e17'],38,155,193,1473638,6,0,1,1,3692
2e5d4af83f6b9f87fc84c0ff10462a5414ff8cb4,0,GitHub,2018-04-01 17:37:00-07:00,['4106cb1db18cc45cbbeb54546a7468a4727bd88f'],17,25,42,1473680,3,1,1,1,3692
ac4374dc245d428f80a26ef95c59250c9f6aa975,0,Guozhang Wang,2018-04-01 18:05:15-07:00,['2e5d4af83f6b9f87fc84c0ff10462a5414ff8cb4'],1,1,2,1473682,1,,,,3692
b8f8ce4146af4fbc7ae40380f1ff251b05bd8773,0,Guozhang Wang,2018-04-01 20:36:25-07:00,['ac4374dc245d428f80a26ef95c59250c9f6aa975'],1,1,2,1473684,1,,,,3692
8662a022c42b7a6245e8ec54c544fccd8b79b6f8,1,GitHub,2018-04-02 08:35:17-07:00,['b8f8ce4146af4fbc7ae40380f1ff251b05bd8773'],187,243,430,1474114,4,1,1,1,3692
1dc30272e1e684764563e3091a19a8ff8892f8eb,1,Jason Gustafson,2018-04-02 08:45:15-07:00,['8662a022c42b7a6245e8ec54c544fccd8b79b6f8'],4,42,46,1474160,3,0,1,0.793103448,3692
e4c8e3e758cbc0b5826885644da69bb7fc3c35ef,1,Rajini Sivaram,2018-04-03 15:40:12+01:00,['1dc30272e1e684764563e3091a19a8ff8892f8eb'],5,15,20,1474180,1,0,1,1,3692
67077ebbcf24448e48d6223dc7090d5d94ea7780,0,Ewen Cheslack-Postava,2018-04-03 08:36:57-07:00,['e4c8e3e758cbc0b5826885644da69bb7fc3c35ef'],1,10,11,1474191,1,,,,3692
d9369de8f2c6435843fb7577d313bb24e3b09cba,1,Ewen Cheslack-Postava,2018-04-03 08:48:05-07:00,['67077ebbcf24448e48d6223dc7090d5d94ea7780'],23,80,103,1474294,4,0.230769231,0.692307692,0.692307692,3692
1815e01188e1f1f7c71acc9fb6466dbae8e47c9e,0,Guozhang Wang,2018-04-03 08:58:13-07:00,['d9369de8f2c6435843fb7577d313bb24e3b09cba'],4,1,5,1474299,1,0,0,0,3692
719a21f7c9fefc6ebe16089b2a5e4c155fde8b16,1,Jason Gustafson,2018-04-03 10:39:20-07:00,['1815e01188e1f1f7c71acc9fb6466dbae8e47c9e'],4,19,23,1474322,2,0.444444444,0.444444444,0.444444444,3692
9313e18fbbd974a17bfd132fe8b9ea594b26a97a,0,GitHub,2018-04-03 19:23:06-07:00,['719a21f7c9fefc6ebe16089b2a5e4c155fde8b16'],10,2,12,1474334,2,0,0,0,3692
d5db4e9b8055536bdbb3b2d2308e36efa4abafcc,0,Guozhang Wang,2018-04-04 18:54:40-07:00,['9313e18fbbd974a17bfd132fe8b9ea594b26a97a'],13,4,17,1474351,1,,,,3692
53d4267c59177cd826e1b0645168b1e9330bdbcd,0,Jason Gustafson,2018-04-05 00:06:14-07:00,['d5db4e9b8055536bdbb3b2d2308e36efa4abafcc'],4,18,22,1474373,3,0.5,0.8,0.9,3692
9f8c3167eb2fcab158147eb4fefdabc933b8a3a1,0,GitHub,2018-04-05 09:41:42+01:00,['53d4267c59177cd826e1b0645168b1e9330bdbcd'],417,1323,1740,1476113,66,0.616071429,0.783482143,0.703125,3696
63642d6051015d84aa8c084380bcab174a5f3303,0,Rajini Sivaram,2018-04-05 13:35:20+01:00,['9f8c3167eb2fcab158147eb4fefdabc933b8a3a1'],11,255,266,1476379,7,0.306569343,0.861313869,0.729927007,3697
77c79df396ec232981829f2ed61c5484cc8f1722,1,Rajini Sivaram,2018-04-05 14:56:27+01:00,['63642d6051015d84aa8c084380bcab174a5f3303'],1,1,2,1476381,1,,,,3697
ed2f10e0500e48e42cf5c5b9c9358c36be332413,1,Jason Gustafson,2018-04-05 08:59:35-07:00,['77c79df396ec232981829f2ed61c5484cc8f1722'],2,16,18,1476399,2,0.7,0.7,1,3697
3abd4107082ff69619d434d456c664c21cf77f82,0,Guozhang Wang,2018-04-05 11:17:40-07:00,['ed2f10e0500e48e42cf5c5b9c9358c36be332413'],1,41,42,1476441,2,0,1,0.931034483,3697
ac542c9a835d3a2dd46f37712c6b5438f56747c0,1,Guozhang Wang,2018-04-05 15:29:04-07:00,['3abd4107082ff69619d434d456c664c21cf77f82'],2,10,12,1476453,2,1,1,1,3697
da32db9f3462242082f23973dc154f6f5e69f069,1,Rajini Sivaram,2018-04-06 19:21:41+01:00,['ac542c9a835d3a2dd46f37712c6b5438f56747c0'],13,154,167,1476620,8,0.666666667,0.955555556,0.644444444,3697
77ebd32016d13c64ee5a3c7db63ca71bf4b79aad,1,GitHub,2018-04-06 22:49:34+01:00,['da32db9f3462242082f23973dc154f6f5e69f069'],465,1429,1894,1478514,21,0.727619048,0.994285714,1,3701
0c0d8363e5787e97cce5e0b9b86486d737a6890c,1,GitHub,2018-04-06 17:00:52-07:00,['77ebd32016d13c64ee5a3c7db63ca71bf4b79aad'],294,1636,1930,1480444,28,0.074523397,0.868284229,0.798960139,3707
fedac0cea74feeeece529ee1c0cefd6af53ecbdd,1,Dong Lin,2018-04-08 11:20:21+08:00,['0c0d8363e5787e97cce5e0b9b86486d737a6890c'],19,26,45,1480489,3,0,0.285714286,0.142857143,3707
40183e31567795d4d0f2b836294bc5d5fac2a56b,0,Rajini Sivaram,2018-04-08 09:35:33+01:00,['fedac0cea74feeeece529ee1c0cefd6af53ecbdd'],196,486,682,1481171,29,0.329113924,1,0.64556962,3709
37efc79eb82e0f290d0d2a17f24001f2cbc922cc,0,Guozhang Wang,2018-04-08 11:54:22-07:00,['40183e31567795d4d0f2b836294bc5d5fac2a56b'],4,24,28,1481199,15,0,1,1,3709
e6b4d17c593d764875db6681f20c51828780bf75,0,GitHub,2018-04-09 03:34:36-07:00,['37efc79eb82e0f290d0d2a17f24001f2cbc922cc'],4,3,7,1481206,2,,,,3709
0a8f35b68415bb3f79b0ec61df6cb0ab0db937c4,1,GitHub,2018-04-09 15:39:07-07:00,['e6b4d17c593d764875db6681f20c51828780bf75'],1,21,22,1481228,2,1,1,1,3709
989fe0497ec72ea3470a30a9ef47389b48ee5421,1,Rajini Sivaram,2018-04-10 09:45:08+01:00,['0a8f35b68415bb3f79b0ec61df6cb0ab0db937c4'],6,572,578,1481806,4,0.543478261,0.782608696,0.717391304,3711
e490a90625730564f712837b19f7a08b4d576764,0,Rajini Sivaram,2018-04-10 12:40:42+01:00,['989fe0497ec72ea3470a30a9ef47389b48ee5421'],2,2,4,1481810,2,,,,3711
79c6f7cd9af462807a9f6b6313fd6c6c7908951f,1,GitHub,2018-04-10 20:42:07+01:00,['e490a90625730564f712837b19f7a08b4d576764'],14,25,39,1481849,7,1,1,0.5,3711
5e277e5579f4a989ecef6473fbc3619178b33a35,0,Rajini Sivaram,2018-04-10 20:46:32+01:00,['79c6f7cd9af462807a9f6b6313fd6c6c7908951f'],0,8,8,1481857,2,0.6,0,1,3711
4223ef61060673e95077abfe6aca27bc0f71fffa,0,Rajini Sivaram,2018-04-10 20:48:38+01:00,['5e277e5579f4a989ecef6473fbc3619178b33a35'],1,43,44,1481901,3,1,1,1,3712
e29fa9a4ca72e6eae0a4b75ef30f2df4ffec943d,1,Jun Rao,2018-04-11 10:30:30-07:00,['4223ef61060673e95077abfe6aca27bc0f71fffa'],12,37,49,1481950,3,0.666666667,0.833333333,1,3712
47918f2d79e907f6a6da599ab82a97c169722229,1,Jun Rao,2018-04-11 10:48:04-07:00,['e29fa9a4ca72e6eae0a4b75ef30f2df4ffec943d'],178,995,1173,1483123,41,0.437007874,1,1,3721
6a99da87abff26a749cee4e765d125bec8b6c424,1,Guozhang Wang,2018-04-11 14:17:46-07:00,['47918f2d79e907f6a6da599ab82a97c169722229'],2,1290,1292,1484415,19,0.301953819,0.603907638,0.978685613,3733
83a9e04c1975f9e0fcfe41f5084a43353592b340,0,Jason Gustafson,2018-04-11 14:27:04-07:00,['6a99da87abff26a749cee4e765d125bec8b6c424'],3,3,6,1484421,2,,,,3733
e4d652befe3a4ac126dced9144c1b694e7334a94,0,Ismael Juma,2018-04-11 14:50:11-07:00,['83a9e04c1975f9e0fcfe41f5084a43353592b340'],2,5,7,1484428,1,,,,3733
7421f9dce2d2e763f70602b13df1efcd32f691b9,1,GitHub,2018-04-11 16:47:11-07:00,['e4d652befe3a4ac126dced9144c1b694e7334a94'],73,96,169,1484597,3,0,1,1,3733
cc43e77bbbfad71883011186de55603c936cbcd1,1,Guozhang Wang,2018-04-11 20:50:10-07:00,['7421f9dce2d2e763f70602b13df1efcd32f691b9'],43,83,126,1484723,3,0.136363636,1,0.727272727,3733
4e35a2bfb7f3b0437a27bb58b8cb39339f750064,1,Guozhang Wang,2018-04-12 09:35:37-07:00,['cc43e77bbbfad71883011186de55603c936cbcd1'],77,221,298,1485021,3,0.098765432,0.950617284,0.530864198,3733
fb3a9485a8f830336e2cd07d959cf6aa0a5356a5,0,GitHub,2018-04-12 11:36:59-07:00,['4e35a2bfb7f3b0437a27bb58b8cb39339f750064'],0,1,1,1485022,1,,,,3733
886daf5fca70846ad0ce5b85f2522cf08b08ee44,1,Jason Gustafson,2018-04-12 15:45:38-07:00,['fb3a9485a8f830336e2cd07d959cf6aa0a5356a5'],11,10,21,1485043,1,0,0,1,3733
8434d494e68be65b9f29ded26af71b0c40be530c,0,Guozhang Wang,2018-04-15 09:56:12-07:00,['886daf5fca70846ad0ce5b85f2522cf08b08ee44'],3,3,6,1485049,2,,,,3733
b599b395f3d421b3fdb1d25b294778478c2467cf,1,GitHub,2018-04-15 10:13:22-07:00,['8434d494e68be65b9f29ded26af71b0c40be530c'],148,336,484,1485533,8,0.104,0.512,0.928,3733
0dc7f0e66f849346049f6f90cee05a2796735d14,1,GitHub,2018-04-15 10:15:31-07:00,['b599b395f3d421b3fdb1d25b294778478c2467cf'],725,738,1463,1486996,17,0.526315789,0.070175439,1,3734
98713570867619de7de8e885a82d5fb0bfdb3b4e,1,GitHub,2018-04-15 20:51:53-07:00,['0dc7f0e66f849346049f6f90cee05a2796735d14'],38,35,73,1487069,4,0.933333333,1,1,3734
832b096f4fcfde9e90d796470eb0ce2a26283e81,0,Rajini Sivaram,2018-04-16 08:51:33+01:00,['98713570867619de7de8e885a82d5fb0bfdb3b4e'],416,870,1286,1488355,31,0.224783862,0.449567723,0.757925072,3734
93e03414f72c24854abaa6925149196580cfc691,0,Rajini Sivaram,2018-04-16 08:55:13+01:00,['832b096f4fcfde9e90d796470eb0ce2a26283e81'],147,563,710,1489065,12,0.738372093,0.622093023,1,3739
f3ed56b21f6ac1e47337983b46aca1af88337e9e,0,Jason Gustafson,2018-04-16 09:53:08-07:00,['93e03414f72c24854abaa6925149196580cfc691'],1,1,2,1489067,1,,,,3739
19418fc86aefde2acdc62f6790b2ff0bb4d15699,1,Jason Gustafson,2018-04-16 10:16:26-07:00,['f3ed56b21f6ac1e47337983b46aca1af88337e9e'],6,21,27,1489094,3,1,1,1,3739
b6f04203501bddd355b5663861b559b4bbc90d8f,1,Guozhang Wang,2018-04-16 10:49:41-07:00,['19418fc86aefde2acdc62f6790b2ff0bb4d15699'],4,4,8,1489102,1,,,,3739
432c82d3bf6bbe679df1c2ac7cc11683e8f9c611,0,Jason Gustafson,2018-04-16 12:32:07-07:00,['b6f04203501bddd355b5663861b559b4bbc90d8f'],9,101,110,1489212,2,1,1,1,3740
4013767d864a23c1a3eeb91806375525eb706649,0,Jason Gustafson,2018-04-16 13:43:54-07:00,['432c82d3bf6bbe679df1c2ac7cc11683e8f9c611'],1,1,2,1489214,1,,,,3740
341db990dc4e2acb207622c7fa254f07650742bc,0,Jun Rao,2018-04-16 17:16:08-07:00,['4013767d864a23c1a3eeb91806375525eb706649'],10,48,58,1489272,4,0.647058824,0.647058824,0.294117647,3740
e5de679d62f734eb1cdfc91c863107b64cd630b6,1,GitHub,2018-04-17 14:46:28+01:00,['341db990dc4e2acb207622c7fa254f07650742bc'],7,146,153,1489425,3,0.204081633,0.204081633,1,3740
01eddce01f94887d5f15d32d8050e8a526599fcc,1,Guozhang Wang,2018-04-17 09:40:58-07:00,['e5de679d62f734eb1cdfc91c863107b64cd630b6'],13,52,65,1489490,2,0.8,0.8,0.833333333,3740
83503404e4ea18a576967c71b26b91da70642ed4,1,Jason Gustafson,2018-04-17 13:07:08-07:00,['01eddce01f94887d5f15d32d8050e8a526599fcc'],2,5,7,1489497,2,,,,3740
ac9c3ed0b43ee848e6e555a01c55ea2eee78540a,1,Guozhang Wang,2018-04-17 13:13:15-07:00,['83503404e4ea18a576967c71b26b91da70642ed4'],1808,2134,3942,1493439,57,0,0.940740741,0.722222222,3740
52e9ba66a5cc46abbe49c872a244e3e8cc77514e,1,Jason Gustafson,2018-04-17 16:37:34-07:00,['ac9c3ed0b43ee848e6e555a01c55ea2eee78540a'],1,2,3,1493442,1,,,,3740
0e0fd4fe8d8b3701b38dfdcd875fb4f4f98d23c2,0,GitHub,2018-04-17 17:53:39-07:00,['52e9ba66a5cc46abbe49c872a244e3e8cc77514e'],14,14,28,1493470,1,,,,3740
cae42215b7597cc39afc682cb0399782cf42fe23,1,GitHub,2018-04-18 09:38:27+02:00,['0e0fd4fe8d8b3701b38dfdcd875fb4f4f98d23c2'],216,586,802,1494272,14,0.7625,0.8875,0.7875,3741
98bb75a58fc241b400ed7535d9e9723f678b4803,1,GitHub,2018-04-18 10:20:28+01:00,['cae42215b7597cc39afc682cb0399782cf42fe23'],7,120,127,1494399,3,0.975,0.975,1,3742
462342210fd5d6f571d26b8af838fe77d5c5ca48,0,Jason Gustafson,2018-04-18 09:18:45-07:00,['98bb75a58fc241b400ed7535d9e9723f678b4803'],43,191,234,1494633,5,0.144144144,0.900900901,1,3742
6b2be2693c60fd222bf8c80b3c9ee783feb00d40,0,Guozhang Wang,2018-04-18 15:07:09-07:00,['462342210fd5d6f571d26b8af838fe77d5c5ca48'],12,2,14,1494647,2,1,0,0,3742
2162d0713f9fa20c6b5c7fd151c7f66acd15e7ce,1,Guozhang Wang,2018-04-18 15:35:10-07:00,['6b2be2693c60fd222bf8c80b3c9ee783feb00d40'],2,10,12,1494659,2,0,0.428571429,1,3742
93fd5707fab218abb2c9d13b034608f0a606bfc7,0,Guozhang Wang,2018-04-19 11:51:24-07:00,['2162d0713f9fa20c6b5c7fd151c7f66acd15e7ce'],8,23,31,1494690,1,1,1,1,3742
f2514e67e01ac015c021e15274c83a8dee7db9aa,1,Jason Gustafson,2018-04-19 15:34:13-07:00,['93fd5707fab218abb2c9d13b034608f0a606bfc7'],2,9,11,1494701,1,,,,3742
1f523d9d72ad3008664146e1d2a5b40861b06072,1,GitHub,2018-04-19 16:14:32-07:00,['f2514e67e01ac015c021e15274c83a8dee7db9aa'],3,59,62,1494763,2,0,0.931818182,1,3742
b510737e761e21e63e6ed15e5111358d7515fdd2,1,Matthias J. Sax,2018-04-20 15:22:28+02:00,['1f523d9d72ad3008664146e1d2a5b40861b06072'],6,186,192,1494955,5,0.529850746,1,1,3742
9e062b3e651bd41ad3275fb78ef577b49a108f7a,0,Jason Gustafson,2018-04-20 09:46:57-07:00,['b510737e761e21e63e6ed15e5111358d7515fdd2'],8,11,19,1494974,1,0,0.333333333,0.333333333,3742
d9e804b88952160630eb305ff05978b66cbbf49f,0,Jason Gustafson,2018-04-20 13:00:11-07:00,['9e062b3e651bd41ad3275fb78ef577b49a108f7a'],7,5,12,1494986,1,,,,3742
51db468bf329794b586390abf5b3069abb281ffe,0,Guozhang Wang,2018-04-23 09:49:53-07:00,['d9e804b88952160630eb305ff05978b66cbbf49f'],1,1,2,1494988,1,,,,3742
ed51b2cdf5bdac210a6904bead1a2ca6e8411406,1,Guozhang Wang,2018-04-23 11:41:03-07:00,['51db468bf329794b586390abf5b3069abb281ffe'],565,1462,2027,1497015,72,0,0.834254144,0.871086556,3746
35c75ea5036fbffe6ac74fe4f76a633bda061fec,1,Jason Gustafson,2018-04-23 11:42:17-07:00,['ed51b2cdf5bdac210a6904bead1a2ca6e8411406'],5,5,10,1497025,3,,,,3746
b2e4db01b679e0759bdd340310a864cc83f48deb,1,Guozhang Wang,2018-04-23 13:33:35-07:00,['35c75ea5036fbffe6ac74fe4f76a633bda061fec'],118,3055,3173,1500198,30,0.760286225,1,0.880143113,3765
a05e33693b66ac38ccb21f2238c194ca59fcb6ec,1,Matthias J. Sax,2018-04-24 19:13:12+01:00,['b2e4db01b679e0759bdd340310a864cc83f48deb'],20,18,38,1500236,2,0,0,1,3765
3bc2575dfcfbf856b75c510d986f270f7f9411ca,0,Jason Gustafson,2018-04-24 15:24:07-07:00,['a05e33693b66ac38ccb21f2238c194ca59fcb6ec'],1,2,3,1500239,1,,,,3765
12a0f46895e730f6a3a4c5fc311c206f6d8219e5,0,Guozhang Wang,2018-04-24 15:40:16-07:00,['3bc2575dfcfbf856b75c510d986f270f7f9411ca'],1,37,38,1500277,2,,,,3765
acd669e4248c605ac54c38862a8678f521f6f574,1,Ismael Juma,2018-04-24 21:49:44-07:00,['12a0f46895e730f6a3a4c5fc311c206f6d8219e5'],50,176,226,1500503,5,0.988888889,1,1,3765
c853ef75a11663cbee3160e64e45f46f5a8ac78c,0,Rajini Sivaram,2018-04-25 11:19:31+01:00,['acd669e4248c605ac54c38862a8678f521f6f574'],4,12,16,1500519,4,,,,3765
34a1f7099b65f43037602eb13cbffd7df276e290,1,Guozhang Wang,2018-04-25 08:36:14-07:00,['c853ef75a11663cbee3160e64e45f46f5a8ac78c'],6,4,10,1500529,1,0,0,0,3765
cbb5b51475368613c7972297ea6055a4f75285e1,1,Dong Lin,2018-04-25 14:24:29-07:00,['34a1f7099b65f43037602eb13cbffd7df276e290'],4,539,543,1501072,3,0.05801105,1,0.914364641,3766
6be908a8296456adee254b405605acff55fd47a5,1,Jason Gustafson,2018-04-25 17:49:02-07:00,['cbb5b51475368613c7972297ea6055a4f75285e1'],155,166,321,1501393,3,1,1,0.941176471,3766
459efb02ad243e87f42caffcf4f3a0004c41ccd6,0,Guozhang Wang,2018-04-26 06:58:36-07:00,['6be908a8296456adee254b405605acff55fd47a5'],3,3,6,1501399,1,,,,3766
fc6e92260c3ff3b5ef72ac05e7a518a8cb2e7090,1,Guozhang Wang,2018-04-26 10:01:17-07:00,['459efb02ad243e87f42caffcf4f3a0004c41ccd6'],214,258,472,1501871,32,0,0.981818182,0.254545455,3766
e7f019690a10306a717b9757a21d5bf01964532e,1,Guozhang Wang,2018-04-26 10:04:59-07:00,['fc6e92260c3ff3b5ef72ac05e7a518a8cb2e7090'],8,9,17,1501888,2,0,0,0,3766
f38bc0c33992ed4879ec37e0d425beadc088bbff,0,Ismael Juma,2018-04-26 10:50:22-07:00,['e7f019690a10306a717b9757a21d5bf01964532e'],11,11,22,1501910,2,,,,3766
885abbfcd40aab57acec278d976956f07be15090,1,Guozhang Wang,2018-04-26 11:30:42-07:00,['f38bc0c33992ed4879ec37e0d425beadc088bbff'],1366,1290,2656,1504566,35,1,1,1,3766
8725e3604b31d0bf822959fc6d870512411c7a05,1,GitHub,2018-04-26 13:16:51-07:00,['885abbfcd40aab57acec278d976956f07be15090'],144,8,152,1504718,2,0,0,0,3766
ff1875fce0a82737069e195060b6a93881954a23,0,Jason Gustafson,2018-04-26 14:01:04-07:00,['8725e3604b31d0bf822959fc6d870512411c7a05'],4,30,34,1504752,2,0.777777778,0.777777778,1,3766
e128f7f3bb6f7761225b2c0f3dfe1bf1d5d1aff8,0,Guozhang Wang,2018-04-26 21:01:27-07:00,['ff1875fce0a82737069e195060b6a93881954a23'],1,1,2,1504754,1,,,,3766
b2e0812f6946f88cef2cdffb0be603b4b769033a,0,GitHub,2018-04-27 13:40:24-07:00,['e128f7f3bb6f7761225b2c0f3dfe1bf1d5d1aff8'],6,6,12,1504766,1,,,,3766
3ce14a84a8c2009198e81a077cabe4b3031f6698,0,Guozhang Wang,2018-04-27 14:20:29-07:00,['b2e0812f6946f88cef2cdffb0be603b4b769033a'],8,3,11,1504777,2,,,,3766
0143a650911729c290a8a0b41597af375ef7c901,0,Guozhang Wang,2018-04-27 16:15:55-07:00,['3ce14a84a8c2009198e81a077cabe4b3031f6698'],51,0,51,1504828,2,,,,3766
c6fd3d488e8dba904f6abb2324a89466fc354387,0,Guozhang Wang,2018-04-27 22:12:57-07:00,['0143a650911729c290a8a0b41597af375ef7c901'],157,61,218,1505046,6,1,1,0,3766
8577632b3a7dd3dd5ce9cf2562627983bbabba20,0,Rajini Sivaram,2018-04-29 15:54:38+01:00,['c6fd3d488e8dba904f6abb2324a89466fc354387'],11,41,52,1505098,6,0,0.090909091,0.454545455,3766
aa3c38f5950470be66dcd29aba355af9779edaaa,0,Rajini Sivaram,2018-04-29 15:57:25+01:00,['8577632b3a7dd3dd5ce9cf2562627983bbabba20'],0,285,285,1505383,5,,,,3770
6655a4d75f8d839c9f87e68fbda77ed0637825d2,0,Matthias J. Sax,2018-04-30 12:18:40+02:00,['aa3c38f5950470be66dcd29aba355af9779edaaa'],9,25,34,1505417,7,1,1,1,3770
902009ea981075bdad178c96eb9e9a835d9cc52f,0,Rajini Sivaram,2018-04-30 12:34:02+01:00,['6655a4d75f8d839c9f87e68fbda77ed0637825d2'],16,149,165,1505582,4,0.734375,1,1,3771
be5b0fd2a9513fa13f2abd5b39782e714b0c9956,0,Rajini Sivaram,2018-04-30 15:29:50+01:00,['902009ea981075bdad178c96eb9e9a835d9cc52f'],1,1,2,1505584,1,,,,3771
f467c9c2438a8b182083879927ff171a6a2c6f2f,1,GitHub,2018-04-30 08:59:04-07:00,['be5b0fd2a9513fa13f2abd5b39782e714b0c9956'],35,54,89,1505673,7,1,0.294117647,0.470588235,3771
9d2efd83a6a8e5576886dd146eebdb072f4c8d47,1,Jason Gustafson,2018-04-30 13:08:34-07:00,['f467c9c2438a8b182083879927ff171a6a2c6f2f'],188,431,619,1506292,6,0.481481481,0.796296296,1,3771
b4d8552218c9ab41bc1e0221c4e79417a2662d19,1,GitHub,2018-05-01 15:27:02+01:00,['9d2efd83a6a8e5576886dd146eebdb072f4c8d47'],5,85,90,1506382,4,0.266666667,1,1,3771
b82252b1e03c2cff9ca4059157dc850afbe047bf,1,Ismael Juma,2018-05-01 15:27:20-07:00,['b4d8552218c9ab41bc1e0221c4e79417a2662d19'],3,1,4,1506386,3,,,,3771
31ce3a27050443276f8a634443ade5c251766614,0,GitHub,2018-05-02 11:58:43-07:00,['b82252b1e03c2cff9ca4059157dc850afbe047bf'],1,1,2,1506388,1,,,,3771
1b170df31c7304f6d4c938b5e0c2a09ae1e9189d,1,Guozhang Wang,2018-05-02 13:24:15-07:00,['31ce3a27050443276f8a634443ade5c251766614'],33,266,299,1506687,8,0.955555556,1,1,3771
a7746dd5b4d1eb529433b33be65aa2decd99a737,0,Guozhang Wang,2018-05-02 13:32:05-07:00,['1b170df31c7304f6d4c938b5e0c2a09ae1e9189d'],12,6,18,1506705,1,0,0,0,3771
04a70bd3fe40628462f63955c8522cae625feee3,0,Guozhang Wang,2018-05-02 17:01:28-07:00,['a7746dd5b4d1eb529433b33be65aa2decd99a737'],8,8,16,1506721,2,1,1,0,3771
55cdc934fb0e3bb184dc3fe3072acc918a0b1174,1,GitHub,2018-05-03 09:25:33-07:00,['04a70bd3fe40628462f63955c8522cae625feee3'],6,4,10,1506731,3,,,,3771
de147837dda5865565d718d32465ec41f8f44d25,0,Ismael Juma,2018-05-03 09:46:30-07:00,['55cdc934fb0e3bb184dc3fe3072acc918a0b1174'],6,10,16,1506747,2,1,1,1,3771
6dbd9b59e60eff821fe677af1c6ed33b96243153,1,Jason Gustafson,2018-05-03 13:05:36-07:00,['de147837dda5865565d718d32465ec41f8f44d25'],3,39,42,1506789,3,0,1,1,3771
a5318722c74ec0279a2e831e93e4164d9adcb8a1,1,Jason Gustafson,2018-05-03 23:06:34-07:00,['6dbd9b59e60eff821fe677af1c6ed33b96243153'],4,22,26,1506815,2,0.888888889,1,1,3771
515ce21c74743171df6cb069b4754f68fe7f2233,0,Guozhang Wang,2018-05-04 08:39:56-07:00,['a5318722c74ec0279a2e831e93e4164d9adcb8a1'],0,1722,1722,1508537,14,0.78613396,0.961222092,0.74853114,3785
af983267be7a2d0f81527f5a348af377f30caee4,1,GitHub,2018-05-04 08:42:01-07:00,['515ce21c74743171df6cb069b4754f68fe7f2233'],761,562,1323,1509860,66,0.5,0.316455696,0,3786
2d8049b713f2b9982bd43e7340a0e0f302f30d6b,1,Guozhang Wang,2018-05-04 09:05:53-07:00,['af983267be7a2d0f81527f5a348af377f30caee4'],59,315,374,1510234,18,0.304964539,0.737588652,0.765957447,3788
de8a67b56534e37ae149423aac43097645029ce0,1,Guozhang Wang,2018-05-04 09:59:36-07:00,['2d8049b713f2b9982bd43e7340a0e0f302f30d6b'],1,1,2,1510236,1,,,,3788
f448e49fbe8c3c609f9beffa2f421fc0b875aa3d,1,Guozhang Wang,2018-05-04 15:18:44-07:00,['de8a67b56534e37ae149423aac43097645029ce0'],4,223,227,1510463,2,0.662921348,1,1,3789
03a2d8243d820c359d35a5feaa25bef3fdb7ca0a,0,Jason Gustafson,2018-05-04 15:42:44-07:00,['f448e49fbe8c3c609f9beffa2f421fc0b875aa3d'],2,2,4,1510467,1,,,,3789
564311f5cdedd63fa03052368c321db5ce15dc4f,0,GitHub,2018-05-04 16:35:17-07:00,['03a2d8243d820c359d35a5feaa25bef3fdb7ca0a'],57,38,95,1510562,6,0,0,0,3789
893e0445150614d3538654af0e25f78d87a717ba,0,Guozhang Wang,2018-05-06 20:55:12-07:00,['564311f5cdedd63fa03052368c321db5ce15dc4f'],17,16,33,1510595,6,,,,3789
6f641fef6a88036ab4dacb59ab21bc8b21ef9bcf,1,Guozhang Wang,2018-05-07 09:21:20-07:00,['893e0445150614d3538654af0e25f78d87a717ba'],1502,1084,2586,1513181,27,0,0,0,3789
32e97b1d9db46cab526d1882eaf9633934ed21bd,1,GitHub,2018-05-07 09:22:26-07:00,['6f641fef6a88036ab4dacb59ab21bc8b21ef9bcf'],71,65,136,1513317,18,0.2,0,1,3789
00d1137570e3b877253288ad730842551b998d3b,1,Matthias J. Sax,2018-05-07 09:27:45-07:00,['32e97b1d9db46cab526d1882eaf9633934ed21bd'],8,8,16,1513333,1,,,,3789
42771eb37d6abd0a34220d30773e559680bdf9b0,0,GitHub,2018-05-07 09:44:45-07:00,['00d1137570e3b877253288ad730842551b998d3b'],1129,95,1224,1514557,9,0.43231441,0,0.497816594,3789
55dd97097f51e9e9a687c35afa0cfd38d60a6b45,1,Guozhang Wang,2018-05-07 10:57:35-07:00,['42771eb37d6abd0a34220d30773e559680bdf9b0'],95,132,227,1514784,1,1,1,1,3789
2b5a59406622affa1e333e073546f075f59b4ac9,1,GitHub,2018-05-07 17:34:34-07:00,['55dd97097f51e9e9a687c35afa0cfd38d60a6b45'],5317,695,6012,1520796,33,0.081794195,0,0.654353562,3789
b88d70b53290af715034a1f772a271f7e44505fd,1,Guozhang Wang,2018-05-08 09:15:31-07:00,['2b5a59406622affa1e333e073546f075f59b4ac9'],152,105,257,1521053,10,0,0,0,3790
bce10794a016f86cda63ceb437d8db7dfc65063b,1,Ismael Juma,2018-05-08 15:52:43-07:00,['b88d70b53290af715034a1f772a271f7e44505fd'],35,140,175,1521228,4,0.5,1,1,3790
b328fc729b79fee6a9d210cf25890068d92943ee,0,Matthias J. Sax,2018-05-08 16:07:33-07:00,['bce10794a016f86cda63ceb437d8db7dfc65063b'],0,43,43,1521271,2,1,0.193548387,1,3790
fcb15e357c1b818d2d543dc9db3e011ddc1fbf5e,0,Jason Gustafson,2018-05-08 17:07:50-07:00,['b328fc729b79fee6a9d210cf25890068d92943ee'],4,20,24,1521295,2,1,1,1,3790
7afcb3a64c53831f05f99037dfa07aba1d396c48,1,Jiangjie Qin,2018-05-08 18:57:34-07:00,['fcb15e357c1b818d2d543dc9db3e011ddc1fbf5e'],4,94,98,1521393,2,0,0.0625,1,3790
b27e098a7dbcc07c6abb758de570596c74722025,0,Ismael Juma,2018-05-08 23:02:33-07:00,['7afcb3a64c53831f05f99037dfa07aba1d396c48'],2,2,4,1521397,1,,,,3790
0ecb72f59da6491edc96b99b147b4983be794acf,1,GitHub,2018-05-09 11:46:36+01:00,['b27e098a7dbcc07c6abb758de570596c74722025'],18,194,212,1521609,5,0.419642857,0.866071429,0.803571429,3790
5ca9ed5ede4f03cdef54cdbce70be3fdf052157d,1,Guozhang Wang,2018-05-09 10:34:44-07:00,['0ecb72f59da6491edc96b99b147b4983be794acf'],0,40,40,1521649,3,1,1,1,3790
e32dcb9a669bc354cc97cb45f14f0dbad9657693,1,Guozhang Wang,2018-05-09 10:42:10-07:00,['5ca9ed5ede4f03cdef54cdbce70be3fdf052157d'],1,7,8,1521657,2,0,1,1,3790
abbd53da4ad98c3a95118c9770a9d247e54b0eef,1,Jason Gustafson,2018-05-09 14:27:28-07:00,['e32dcb9a669bc354cc97cb45f14f0dbad9657693'],173,626,799,1522456,8,0.402214022,0.79704797,0.778597786,3791
8fb5b3701307f7ce597083f41b3c812680f7195d,1,Guozhang Wang,2018-05-09 17:06:47-07:00,['abbd53da4ad98c3a95118c9770a9d247e54b0eef'],5,9,14,1522470,3,0,1,0,3791
0b1a118f45418aba6af03e71e7169e38cb3ec9af,1,GitHub,2018-05-09 17:13:05-07:00,['8fb5b3701307f7ce597083f41b3c812680f7195d'],1524,249,1773,1524243,29,0.433691756,0.189964158,0.198924731,3792
9679c44d2b521b5c627e7bde375c0883f5857e0c,1,Jun Rao,2018-05-09 18:49:51-07:00,['0b1a118f45418aba6af03e71e7169e38cb3ec9af'],200,752,952,1525195,24,0.01509434,0.988679245,0.864150943,3792
4f7c11a1df26836c7a15f062a5431adb3d371a86,0,Rajini Sivaram,2018-05-10 12:27:45+01:00,['9679c44d2b521b5c627e7bde375c0883f5857e0c'],7,69,76,1525271,2,0,0,1,3792
830ee16d0d043bad281ba25ed7287f7d45ac9c09,0,Jason Gustafson,2018-05-10 08:55:15-07:00,['4f7c11a1df26836c7a15f062a5431adb3d371a86'],0,16,16,1525287,1,,,,3792
fa1702fece04c5fc50149fc9b05d77a459b7180b,0,GitHub,2018-05-10 09:50:59-07:00,['830ee16d0d043bad281ba25ed7287f7d45ac9c09'],150,34,184,1525471,8,0.930232558,0,0,3792
c90bbc2749d80d8fed7484dcf34aeae0593dde59,0,Jason Gustafson,2018-05-10 09:53:49-07:00,['fa1702fece04c5fc50149fc9b05d77a459b7180b'],1,1,2,1525473,1,,,,3792
7ed7cca4c9ee854432132a4fbf9be9d655dabbf2,0,Jason Gustafson,2018-05-10 14:17:59-07:00,['c90bbc2749d80d8fed7484dcf34aeae0593dde59'],1,1,2,1525475,1,,,,3792
f69900cd1e6b17196e88321062e865d6585c6423,0,Guozhang Wang,2018-05-10 15:49:39-07:00,['7ed7cca4c9ee854432132a4fbf9be9d655dabbf2'],0,4,4,1525479,1,0,0,1,3792
a5ea6d10a8152df8f1dcb3d7c3fe3635325d82e4,1,GitHub,2018-05-10 17:31:12-07:00,['f69900cd1e6b17196e88321062e865d6585c6423'],81,53,134,1525613,2,0.714285714,0.619047619,1,3792
c3921d489f4da80aad6f387158c33ec2e4bca52d,0,GitHub,2018-05-10 22:06:18-07:00,['a5ea6d10a8152df8f1dcb3d7c3fe3635325d82e4'],126,163,289,1525902,8,1,1,1,3792
6eb7cf1300fc0c411ffab93de041654bc10918bf,1,Guozhang Wang,2018-05-11 08:44:27-07:00,['c3921d489f4da80aad6f387158c33ec2e4bca52d'],13,14,27,1525929,1,0,0,0,3792
ec7ba32af6542c6dbbf264a79804d25a98707971,1,Jason Gustafson,2018-05-11 08:49:49-07:00,['6eb7cf1300fc0c411ffab93de041654bc10918bf'],3,57,60,1525989,4,1,1,0.533333333,3793
40d191b563cb8e94b28b15a217a759a1df9b6759,1,Guozhang Wang,2018-05-11 10:15:48-07:00,['ec7ba32af6542c6dbbf264a79804d25a98707971'],100,88,188,1526177,8,0,1,1,3793
c14b0ad9eeffa3fadb2d04a23f5673fc6bb94ac9,0,Matthias J. Sax,2018-05-11 10:27:07-07:00,['40d191b563cb8e94b28b15a217a759a1df9b6759'],20,20,40,1526217,1,,,,3793
caca1fdc90b6ef877385b044b2a3230f8e6e9874,1,GitHub,2018-05-11 11:38:02-07:00,['c14b0ad9eeffa3fadb2d04a23f5673fc6bb94ac9'],4130,164,4294,1530511,28,0.206223307,0,0.341671751,3793
adeced299785bbeab53241e0013a1f22cdeae76f,0,Guozhang Wang,2018-05-11 13:53:27-07:00,['caca1fdc90b6ef877385b044b2a3230f8e6e9874'],1,3,4,1530515,1,1,1,1,3793
9947cd40c617d4e12690b81a2d28624355580e34,0,GitHub,2018-05-11 17:19:11-07:00,['adeced299785bbeab53241e0013a1f22cdeae76f'],99,139,238,1530753,11,0.421052632,1,0.157894737,3793
0bb48a1669d7fdc30d3768f087fd6e592530dde2,0,Dong Lin,2018-05-14 23:04:56-07:00,['9947cd40c617d4e12690b81a2d28624355580e34'],15,44,59,1530812,4,0.333333333,0.333333333,1,3793
1e207b2ef83db4296fb944ade4c301794f9e8460,1,Guozhang Wang,2018-05-15 14:29:07-07:00,['0bb48a1669d7fdc30d3768f087fd6e592530dde2'],4,84,88,1530900,5,0.338461538,0.769230769,0.938461538,3793
c9161afda998e42d8ee9ebbfe5e647ff337bd19b,1,GitHub,2018-05-15 20:26:19-07:00,['1e207b2ef83db4296fb944ade4c301794f9e8460'],111,58,169,1531069,2,,,,3793
e9154b7960fd9fe9bf05811e4e9972698eeec355,0,Guozhang Wang,2018-05-16 13:10:21-07:00,['c9161afda998e42d8ee9ebbfe5e647ff337bd19b'],3,9,12,1531081,2,,,,3793
d4204e8b1456c46d4a343e219855cbe1ea20aa4a,1,GitHub,2018-05-16 13:23:20-07:00,['e9154b7960fd9fe9bf05811e4e9972698eeec355'],11,11,22,1531103,5,,,,3793
0b3712d8a5fceacffb388eb9ee9ca583723a096d,1,GitHub,2018-05-16 13:58:25-07:00,['d4204e8b1456c46d4a343e219855cbe1ea20aa4a'],0,19,19,1531122,1,,,,3793
ac9de822b2164426a6ebfce62ab0ad10766c2cad,0,Guozhang Wang,2018-05-17 08:44:50-07:00,['0b3712d8a5fceacffb388eb9ee9ca583723a096d'],1,1,2,1531124,1,,,,3793
1a324d784cfc53288730b7c1b5c1bde0685e4686,1,GitHub,2018-05-17 11:28:45-07:00,['ac9de822b2164426a6ebfce62ab0ad10766c2cad'],72,62,134,1531258,17,0,0,,3793
6b8e79b13780d4e91d79325e0bf9f1c8df191176,1,GitHub,2018-05-17 11:56:07-07:00,['1a324d784cfc53288730b7c1b5c1bde0685e4686'],66,74,140,1531398,62,,,,3793
ba237c5d21abb8b63c5edf53517654a214157582,0,Guozhang Wang,2018-05-17 17:20:12-07:00,['6b8e79b13780d4e91d79325e0bf9f1c8df191176'],8,12,20,1531418,1,1,1,0.5,3793
58a910f0a7e6e2da4af9f1fcebdabeb22d909fcb,1,Guozhang Wang,2018-05-18 08:05:09-07:00,['ba237c5d21abb8b63c5edf53517654a214157582'],196,42,238,1531656,16,0.728571429,0.185714286,0.128571429,3793
ee8abb2f7053575bd2abec8152907e0642b1d713,1,Ewen Cheslack-Postava,2018-05-18 10:39:34-07:00,['58a910f0a7e6e2da4af9f1fcebdabeb22d909fcb'],8,46,54,1531710,2,0,1,1,3793
05ea580091a230a7843e0a7312e7980fc54f302e,0,GitHub,2018-05-18 10:58:10-07:00,['ee8abb2f7053575bd2abec8152907e0642b1d713'],58,0,58,1531768,1,0,0,0.409090909,3793
c53e274d3128bc92f0e8b6a79c407cf764f16f7b,1,Jason Gustafson,2018-05-18 13:30:12-07:00,['05ea580091a230a7843e0a7312e7980fc54f302e'],34,56,90,1531858,5,0.941176471,1,1,3793
4e1c8ffd0d44ab7d1c0ca9ac9d70a98b46f35181,1,Guozhang Wang,2018-05-18 16:06:50-07:00,['c53e274d3128bc92f0e8b6a79c407cf764f16f7b'],209,1358,1567,1533425,32,1,0.9375,0.872685185,3798
f65f3a878fc23c658ba2e62f9a1863a7b3d2bd4f,0,Guozhang Wang,2018-05-19 18:44:20-07:00,['4e1c8ffd0d44ab7d1c0ca9ac9d70a98b46f35181'],2,8,10,1533435,2,,,,3798
9752ccad552543964c2ba92a152cb67636233e13,1,GitHub,2018-05-20 10:24:07-07:00,['f65f3a878fc23c658ba2e62f9a1863a7b3d2bd4f'],3,13,16,1533451,4,1,1,0.8,3798
96cda0e07ac4981a642c6b32fa543bcce78be769,1,Guozhang Wang,2018-05-20 16:25:16-07:00,['9752ccad552543964c2ba92a152cb67636233e13'],105,87,192,1533643,8,0,0,0.083333333,3798
16ad358d64a138fc4b455379745ae1550a93d57b,1,Jason Gustafson,2018-05-21 08:37:35-07:00,['96cda0e07ac4981a642c6b32fa543bcce78be769'],106,315,421,1534064,10,0.1875,0.857142857,0.919642857,3799
cbce95d9a5273a072c6c1e3d489760d5d52e638e,0,GitHub,2018-05-21 11:50:19-07:00,['16ad358d64a138fc4b455379745ae1550a93d57b'],3,3,6,1534070,1,,,,3799
70a506b9839605304a0a67b70e711a1139b47cbe,0,GitHub,2018-05-21 17:28:40-07:00,['cbce95d9a5273a072c6c1e3d489760d5d52e638e'],4,11,15,1534085,4,0,0.25,1,3799
95b46a12e5a74da2699b3472c639cc82b28cea96,0,Ewen Cheslack-Postava,2018-05-21 21:10:17-07:00,['70a506b9839605304a0a67b70e711a1139b47cbe'],2,12,14,1534099,1,1,1,0,3799
e70a191d3038e00790aa95fbd1e16e78c32b79a4,1,GitHub,2018-05-21 23:17:42-07:00,['95b46a12e5a74da2699b3472c639cc82b28cea96'],86,64,150,1534249,17,,,,3799
193c77968251a06b2393d1d286425a4f4ec97d10,0,GitHub,2018-05-22 00:15:40-07:00,['e70a191d3038e00790aa95fbd1e16e78c32b79a4'],3,1,4,1534253,1,1,1,0,3799
6281fbcb6ad3c1f7172af0ba590fa1e2605093de,0,Guozhang Wang,2018-05-22 08:48:54-07:00,['193c77968251a06b2393d1d286425a4f4ec97d10'],123,130,253,1534506,4,0,1,1,3799
a30ecc67556e46e423a16e725bd712eb72ab338b,0,Dong Lin,2018-05-22 09:57:39-07:00,['6281fbcb6ad3c1f7172af0ba590fa1e2605093de'],437,61,498,1535004,17,0.035502959,0,0,3799
c1b30a12b1a01ca0d1e39783884e8180f79ed8b1,1,Dong Lin,2018-05-22 10:12:18-07:00,['a30ecc67556e46e423a16e725bd712eb72ab338b'],80,219,299,1535303,5,0.738461538,1,1,3800
5be47a2f269ad5356a19c353c1e53e20bf9c140c,0,GitHub,2018-05-22 11:23:47-07:00,['c1b30a12b1a01ca0d1e39783884e8180f79ed8b1'],8,8,16,1535319,3,,,,3800
7ecfbab92fa0993a3046ff0c3d4fc69f319f13a3,0,Ewen Cheslack-Postava,2018-05-22 13:53:15-07:00,['5be47a2f269ad5356a19c353c1e53e20bf9c140c'],2,35,37,1535356,3,0,1,1,3800
133108cdacf7ee1cc4569e797f2cdf9ec60f7fdd,1,Matthias J. Sax,2018-05-22 15:44:37-07:00,['7ecfbab92fa0993a3046ff0c3d4fc69f319f13a3'],132,839,971,1536327,56,0.567839196,0.753768844,0.341708543,3800
e8847205f93851b544899e08e00e17ec2d66f617,0,GitHub,2018-05-22 16:24:54-07:00,['133108cdacf7ee1cc4569e797f2cdf9ec60f7fdd'],3,4,7,1536334,1,1,0,0,3800
0f86e6884070ec9c867c9354ae331aceeb90b1e8,1,Dong Lin,2018-05-23 12:13:04-07:00,['e8847205f93851b544899e08e00e17ec2d66f617'],87,97,184,1536518,4,1,1,1,3800
ff9f928c16ddf95311f1c1badc64212b4975e623,1,Jason Gustafson,2018-05-24 16:24:37-07:00,['0f86e6884070ec9c867c9354ae331aceeb90b1e8'],31,40,71,1536589,3,1,1,0,3800
7132a85fc394bc0627fe1763c17cb523d8a8ff37,1,Dong Lin,2018-05-24 17:32:49-07:00,['ff9f928c16ddf95311f1c1badc64212b4975e623'],4402,168,4570,1541159,58,0.681166837,0.271750256,0.04912999,3800
440445e7c58508413006d37a475d642283ef984b,0,Jason Gustafson,2018-05-25 00:47:54-07:00,['7132a85fc394bc0627fe1763c17cb523d8a8ff37'],0,36,36,1541195,2,1,1,1,3801
70f0d0bd3f16aa6493271398da34c5960066456c,0,GitHub,2018-05-25 07:00:56-07:00,['440445e7c58508413006d37a475d642283ef984b'],26,138,164,1541359,3,0.066666667,0.166666667,1,3803
c9ec292135f26d1d70a40809026a420e4092f1c3,0,Dong Lin,2018-05-25 15:39:05-07:00,['70f0d0bd3f16aa6493271398da34c5960066456c'],14,76,90,1541449,2,0.807692308,1,0.653846154,3804
345db596502de59a3119d2f86186143395b74e5b,1,GitHub,2018-05-25 16:19:12-07:00,['c9ec292135f26d1d70a40809026a420e4092f1c3'],8,42,50,1541499,4,0.384615385,1,1,3804
ab3ff7101c710f873b192f25697adc8fa6f72c0e,0,Ismael Juma,2018-05-25 16:26:44-07:00,['345db596502de59a3119d2f86186143395b74e5b'],7,7,14,1541513,1,,,,3804
39fe105dfd1cae724238f5452d91c84cb6820e50,1,Jun Rao,2018-05-25 17:10:59-07:00,['ab3ff7101c710f873b192f25697adc8fa6f72c0e'],1,17,18,1541531,2,1,1,0.692307692,3804
7f19df29ac60ec9aef1dbd14704a2dd045b1cfbf,0,Dong Lin,2018-05-25 17:55:21-07:00,['39fe105dfd1cae724238f5452d91c84cb6820e50'],23,80,103,1541634,3,0.485714286,0.971428571,0.828571429,3804
d45d7ec781c7ab6d481d8e7495a08459de29d264,0,Jason Gustafson,2018-05-25 23:49:31-07:00,['7f19df29ac60ec9aef1dbd14704a2dd045b1cfbf'],3,30,33,1541667,1,1,1,1,3804
8c5d7e0408a62aa5f414e8b707050bf8e313a57e,1,Rajini Sivaram,2018-05-26 08:18:41+01:00,['d45d7ec781c7ab6d481d8e7495a08459de29d264'],19,5956,5975,1547642,46,0.481974922,0.725705329,0.850705329,3838
8d1e96181da777800e82b5c34457dc313539eced,1,Ismael Juma,2018-05-26 00:54:41-07:00,['8c5d7e0408a62aa5f414e8b707050bf8e313a57e'],25,24,49,1547691,16,0,0,0,3838
c470ff70d3e829c8b12f6eb6cc812c4162071a1f,1,Jason Gustafson,2018-05-26 11:50:51-07:00,['8d1e96181da777800e82b5c34457dc313539eced'],369,733,1102,1548793,21,0.265402844,0.578199052,0.943127962,3838
b7513214860008070568eae2f28b7eb581166d72,0,Dong Lin,2018-05-27 10:04:58-07:00,['c470ff70d3e829c8b12f6eb6cc812c4162071a1f'],1,1,2,1548795,1,,,,3838
8bf20bb58637a59aa816e9d9668741a15fe9b55d,0,Jason Gustafson,2018-05-28 12:08:14-07:00,['b7513214860008070568eae2f28b7eb581166d72'],9,11,20,1548815,2,,,,3838
24a7b1c6a5b20d29d605446fa7162624d76b2529,0,Jason Gustafson,2018-05-28 12:11:50-07:00,['8bf20bb58637a59aa816e9d9668741a15fe9b55d'],6,0,6,1548821,1,,,,3838
3a8d3a792755cb2bc2a72d3a64dd84b6c8653035,1,Jason Gustafson,2018-05-29 08:37:17-07:00,['24a7b1c6a5b20d29d605446fa7162624d76b2529'],2,43,45,1548866,3,0.9,0.966666667,1,3838
a64ab91238aa8fc499397374c3589127425fb229,1,Ewen Cheslack-Postava,2018-05-29 16:22:47-07:00,['3a8d3a792755cb2bc2a72d3a64dd84b6c8653035'],47,145,192,1549058,9,0.246376812,0.637681159,0.507246377,3838
4943c3f2f7976dc9ff7ba143f6debc1b07642c0d,1,Guozhang Wang,2018-05-29 16:33:00-07:00,['a64ab91238aa8fc499397374c3589127425fb229'],13,12,25,1549083,1,,,,3838
fffb9c5b5cac1a669f22dd99860774d6c0fdb94b,1,Ewen Cheslack-Postava,2018-05-29 16:37:33-07:00,['4943c3f2f7976dc9ff7ba143f6debc1b07642c0d'],0,657,657,1549740,13,1,1,0.85380117,3851
98094954a27849b027831a7401e965c6a949790c,1,Ewen Cheslack-Postava,2018-05-29 21:35:22-07:00,['fffb9c5b5cac1a669f22dd99860774d6c0fdb94b'],37,1519,1556,1551296,31,0.765784114,0.947046843,0.775967413,3869
d99f4a0ffa65ae3a654b043547f114a16fbe4905,1,Dong Lin,2018-05-29 22:09:21-07:00,['98094954a27849b027831a7401e965c6a949790c'],10,12,22,1551318,1,0,0,1,3869
f24a62d4acfc48e23dd4bbb854668a727e9445a8,1,Jason Gustafson,2018-05-30 08:29:54-07:00,['d99f4a0ffa65ae3a654b043547f114a16fbe4905'],32,370,402,1551720,3,0.903225806,0.612903226,1,3869
1facab387f8c2e513c8b7397430251dc44970e35,1,Dong Lin,2018-05-30 10:10:33-07:00,['f24a62d4acfc48e23dd4bbb854668a727e9445a8'],471,1792,2263,1553983,113,0.635701275,0.777777778,0.879781421,3870
1e0793c4cea44368b0fa07e361a27ad638136448,0,Guozhang Wang,2018-05-30 11:03:58-07:00,['1facab387f8c2e513c8b7397430251dc44970e35'],4,2,6,1553989,1,,,,3870
2b6630b518c7edb74b2fc225c2bcd39ef5e4aa26,0,Guozhang Wang,2018-05-30 11:09:12-07:00,['1e0793c4cea44368b0fa07e361a27ad638136448'],1,0,1,1553990,1,0,0,0,3870
14171fa8b43e445afd7731463e0b548422602712,0,Guozhang Wang,2018-05-30 11:13:24-07:00,['2b6630b518c7edb74b2fc225c2bcd39ef5e4aa26'],2,8,10,1554000,2,1,1,1,3870
f8dfbb067caa797c19494e12da6b4c6786980f73,1,Ewen Cheslack-Postava,2018-05-30 11:39:45-07:00,['14171fa8b43e445afd7731463e0b548422602712'],74,2356,2430,1556430,24,0.566598361,0.977459016,0.879098361,3882
f33e9a346e22e29bb66e0ea0f3442903d136ca67,1,Matthias J. Sax,2018-05-30 11:54:53-07:00,['f8dfbb067caa797c19494e12da6b4c6786980f73'],283,548,831,1557261,47,0.774193548,0.822580645,0.629032258,3884
08e8facdc9fce3a9195f5f646b49f55ffa043c73,1,Ewen Cheslack-Postava,2018-05-30 14:43:11-07:00,['f33e9a346e22e29bb66e0ea0f3442903d136ca67'],76,1434,1510,1558771,42,0.607142857,0.773809524,0.680272109,3895
3683d475edb7dbb4990ba6da7861552a602537bd,0,GitHub,2018-05-30 17:28:17-07:00,['08e8facdc9fce3a9195f5f646b49f55ffa043c73'],27,93,120,1558891,5,0.533333333,0.533333333,1,3895
d166485be15d95192ec1b2818f815fa58726ec54,1,GitHub,2018-05-30 22:39:42-07:00,['3683d475edb7dbb4990ba6da7861552a602537bd'],284,1219,1503,1560394,16,0.280952381,0.487301587,0.687301587,3895
837f31dd1850b179918f83338b4b4487486b2c58,1,Jason Gustafson,2018-05-30 23:03:51-07:00,['d166485be15d95192ec1b2818f815fa58726ec54'],586,1418,2004,1562398,47,0.246575342,0.326027397,0.547945205,3901
ad56f04af9d6173628f3ec41b0d9fd9f35855c14,0,Guozhang Wang,2018-05-31 17:19:37-07:00,['837f31dd1850b179918f83338b4b4487486b2c58'],191,46,237,1562635,6,0,0,0.466666667,3901
e24916a68f8259046be677e7f8c1f365960e0dc3,0,Damian Guy,2018-06-01 12:09:24+01:00,['ad56f04af9d6173628f3ec41b0d9fd9f35855c14'],1,1,2,1562637,1,,,,3901
0120e88e2cab1c02cac471ab4acc76ce876bf72b,0,Ismael Juma,2018-06-01 07:12:42-07:00,['e24916a68f8259046be677e7f8c1f365960e0dc3'],1,18,19,1562656,2,1,1,1,3901
cb2f024f87aa1d4848eb059b15fefd7eca028a73,0,Guozhang Wang,2018-06-01 14:48:44-07:00,['0120e88e2cab1c02cac471ab4acc76ce876bf72b'],68,83,151,1562807,5,0.333333333,1,1,3901
73e2cbbd8f56f70bd5ef4594adc3770fa5a402ce,0,Ismael Juma,2018-06-01 16:40:16-07:00,['cb2f024f87aa1d4848eb059b15fefd7eca028a73'],0,44,44,1562851,4,1,1,1,3901
341d5db2604f20a8bd2a69e9ad08d14462829068,1,Ismael Juma,2018-06-02 12:41:55-07:00,['73e2cbbd8f56f70bd5ef4594adc3770fa5a402ce'],214,87,301,1563152,5,0.307692308,0,0,3901
adec6d6e47e18882ba012ae4f1fa8793c18bd0e1,0,Ismael Juma,2018-06-02 13:14:55-07:00,['341d5db2604f20a8bd2a69e9ad08d14462829068'],76,14,90,1563242,2,0.192307692,0,0.346153846,3901
1d5f8649ce3e7c8d3b437e89b2cfbc6fdc18e49f,0,Jason Gustafson,2018-06-02 16:43:53-07:00,['adec6d6e47e18882ba012ae4f1fa8793c18bd0e1'],1,10,11,1563253,1,0,0,0,3901
7b0254e00f137c574783341358b654c7a38f6135,0,GitHub,2018-06-02 17:01:43-07:00,['1d5f8649ce3e7c8d3b437e89b2cfbc6fdc18e49f'],1,1,2,1563255,1,,,,3901
f6d7377f95b80686e51f8b60de57f2769685945a,0,Dong Lin,2018-06-02 18:28:16-07:00,['7b0254e00f137c574783341358b654c7a38f6135'],127,214,341,1563596,4,1,1,1,3903
0cacbcf30e0a90ab9fad7bc310e5477cf959f1fd,1,Ismael Juma,2018-06-02 23:45:44-07:00,['f6d7377f95b80686e51f8b60de57f2769685945a'],28,31,59,1563655,12,1,1,1,3903
202ab22b9837169294a2bcff0a9f00016d859e0d,0,Ismael Juma,2018-06-03 01:52:11-07:00,['0cacbcf30e0a90ab9fad7bc310e5477cf959f1fd'],197,1,198,1563853,4,0.927272727,0.509090909,0,3903
d02f02130eb36cdc4375eb40bdbe4a1f9b58fc60,1,Rajini Sivaram,2018-06-04 10:23:05+01:00,['202ab22b9837169294a2bcff0a9f00016d859e0d'],191,298,489,1564342,14,1,1,0.706896552,3903
718d6f2475d377fd220da9898d25f7c8191f98cd,1,GitHub,2018-06-04 13:43:20-07:00,['d02f02130eb36cdc4375eb40bdbe4a1f9b58fc60'],83,61,144,1564486,11,,,,3903
c8f38dff71da356604cd357e92e4a9263bacafb4,0,Dong Lin,2018-06-04 14:32:04-07:00,['718d6f2475d377fd220da9898d25f7c8191f98cd'],42,94,136,1564622,3,0.565217391,0.934782609,1,3903
6f9f3655731ea1d46bd1f0ed0957579d831e2692,1,Guozhang Wang,2018-06-04 15:33:53-07:00,['c8f38dff71da356604cd357e92e4a9263bacafb4'],209,544,753,1565375,13,0.133828996,1,1,3903
e8ddb76573d0aba659dd97d42ac02f5ec24516d2,1,Guozhang Wang,2018-06-04 15:39:20-07:00,['6f9f3655731ea1d46bd1f0ed0957579d831e2692'],2,19,21,1565396,1,,,,3903
9df3872fbd1526bf6aecab1fcfdc52a33ab9630e,1,Ismael Juma,2018-06-05 04:08:13-07:00,['e8ddb76573d0aba659dd97d42ac02f5ec24516d2'],19,74,93,1565489,9,0,1,1,3903
8a166f8c28cf046cba0c596d781f1daeca795ccd,1,Ismael Juma,2018-06-05 05:23:10-07:00,['9df3872fbd1526bf6aecab1fcfdc52a33ab9630e'],34,105,139,1565628,14,0.5,1,0.555555556,3903
ba5fd3c8a40836dd91389e566253affb0677776f,0,Guozhang Wang,2018-06-05 11:12:57-07:00,['8a166f8c28cf046cba0c596d781f1daeca795ccd'],1,144,145,1565773,1,0,1,1,3903
86410e14d7f2947dff7c6e3e91cdb80597ff3b4c,1,Matthias J. Sax,2018-06-05 11:41:03-07:00,['ba5fd3c8a40836dd91389e566253affb0677776f'],6,29,35,1565808,1,,,,3903
ef413699b658c939fa0a3930ddbface69bedd26e,1,Guozhang Wang,2018-06-05 11:49:36-07:00,['86410e14d7f2947dff7c6e3e91cdb80597ff3b4c'],39,60,99,1565907,4,1,1,1,3903
7c69de42df78bbb4a651b293038d4e957e528970,0,GitHub,2018-06-05 21:07:30+01:00,['ef413699b658c939fa0a3930ddbface69bedd26e'],122,122,244,1566151,68,,,,3903
ba0ebca7a516d4179b6327ddc60b0b49b1265347,1,Matthias J. Sax,2018-06-05 13:35:47-07:00,['7c69de42df78bbb4a651b293038d4e957e528970'],110,16,126,1566277,3,0.534482759,0,0.448275862,3903
faa15b8b758ed4e3f93aaa4d49a941562bdc86bb,1,Ewen Cheslack-Postava,2018-06-05 13:59:15-07:00,['ba0ebca7a516d4179b6327ddc60b0b49b1265347'],306,284,590,1566867,17,1,0,0.076923077,3903
c238e14ac629b258c914dd4bf06479f7b2faa7ac,0,Guozhang Wang,2018-06-05 14:21:33-07:00,['faa15b8b758ed4e3f93aaa4d49a941562bdc86bb'],2,2,4,1566871,1,,,,3903
e5492d77260afdffbe4d016081de30f74526f831,1,Ewen Cheslack-Postava,2018-06-05 16:27:22-07:00,['c238e14ac629b258c914dd4bf06479f7b2faa7ac'],1,1,2,1566873,1,,,,3903
a23b28726ee04530b54da939a0c371be7f4f95bb,0,Ismael Juma,2018-06-05 16:32:06-07:00,['e5492d77260afdffbe4d016081de30f74526f831'],1,1,2,1566875,1,,,,3903
be8808dd4b4c67add4cd3b5adbc54b263a027831,0,Ismael Juma,2018-06-05 20:28:03-07:00,['a23b28726ee04530b54da939a0c371be7f4f95bb'],52,142,194,1567069,11,1,0.943661972,0.85915493,3903
0c035c46b47cd4734d0529486e776c6c18d6643d,1,Ismael Juma,2018-06-06 03:36:52-07:00,['be8808dd4b4c67add4cd3b5adbc54b263a027831'],101,155,256,1567325,9,0.953488372,0.953488372,1,3903
b3aa655a70d92fedfebd32cf469a87b45766fc59,1,Ismael Juma,2018-06-06 07:22:57-07:00,['0c035c46b47cd4734d0529486e776c6c18d6643d'],422,2063,2485,1569810,47,0.813235294,0.911764706,0.976470588,3911
8264492deefa594567573fecd19fba3068bf3d6f,0,Ewen Cheslack-Postava,2018-06-06 08:55:57-07:00,['b3aa655a70d92fedfebd32cf469a87b45766fc59'],10,38,48,1569858,6,1,1,1,3912
a1ca07d3163b8be05056347e9403bcd6a36d535a,0,GitHub,2018-06-06 17:24:53+01:00,['8264492deefa594567573fecd19fba3068bf3d6f'],9,9,18,1569876,6,,,,3912
594a0e1a07f57cd99faa0020b727c4af87be8fad,0,Guozhang Wang,2018-06-06 12:54:15-07:00,['a1ca07d3163b8be05056347e9403bcd6a36d535a'],26,41,67,1569943,2,,,,3912
0eddddb82be563bee9e4b65030e27efd5148ff4b,1,GitHub,2018-06-06 15:16:21-07:00,['594a0e1a07f57cd99faa0020b727c4af87be8fad'],108,190,298,1570241,8,0,1,0.333333333,3912
c140603fa9670840f47774c694a8b2d7eddb5018,0,Rajini Sivaram,2018-06-06 23:29:42+01:00,['0eddddb82be563bee9e4b65030e27efd5148ff4b'],2,5,7,1570248,2,,,,3912
f54acdbb13a6cf2a7ef9979f5a4e04240b1724c5,1,Guozhang Wang,2018-06-06 18:11:03-07:00,['c140603fa9670840f47774c694a8b2d7eddb5018'],2,44,46,1570294,2,1,1,1,3912
150967994a69b2e26f5f68efb2a54a8522ae641d,0,Matthias J. Sax,2018-06-06 20:42:41-07:00,['f54acdbb13a6cf2a7ef9979f5a4e04240b1724c5'],31,61,92,1570386,4,0,1,0.875,3912
642a09168c38e961a2936e5a2fe72f5cd83ae7a6,1,Ewen Cheslack-Postava,2018-06-06 21:09:16-07:00,['150967994a69b2e26f5f68efb2a54a8522ae641d'],14,95,109,1570495,11,0.9,1,1,3913
287a92f746e898971cac0bdca18a045f2d5e0907,0,GitHub,2018-06-07 00:28:07-07:00,['642a09168c38e961a2936e5a2fe72f5cd83ae7a6'],4,4,8,1570503,2,,,,3913
aa014b27099103549fac7bbbeed5ef9544b01e84,0,Ewen Cheslack-Postava,2018-06-07 15:27:13-07:00,['287a92f746e898971cac0bdca18a045f2d5e0907'],1,1,2,1570505,1,,,,3913
22612be46dd68255642ca50a1f78fa1790eb4759,0,Ewen Cheslack-Postava,2018-06-07 15:49:57-07:00,['aa014b27099103549fac7bbbeed5ef9544b01e84'],6,24,30,1570535,3,1,1,1,3913
b4fa87cc51f0a7d640dc6ae2cc8f89f006aae652,1,Jun Rao,2018-06-07 16:35:30-07:00,['22612be46dd68255642ca50a1f78fa1790eb4759'],475,939,1414,1571949,36,0.828125,0.927083333,0.96875,3918
bb260e924f1fada8f6f138b13d809b58dcc85b2c,1,GitHub,2018-06-07 18:47:49-07:00,['b4fa87cc51f0a7d640dc6ae2cc8f89f006aae652'],10,6,16,1571965,1,1,1,0,3918
0b3989fd72acc6e989c495c63cb8ca6aa5850811,1,Jun Rao,2018-06-08 08:13:44-07:00,['bb260e924f1fada8f6f138b13d809b58dcc85b2c'],229,229,458,1572423,17,0.5,1,1,3918
d2b2fbdf94cf48094081650ebc18ee860e67d8d5,1,Jason Gustafson,2018-06-08 08:39:59-07:00,['0b3989fd72acc6e989c495c63cb8ca6aa5850811'],460,1184,1644,1574067,14,0.258823529,0.731764706,0.708235294,3920
74bdafe386ae6080d6f5ead852f9026061a65be4,1,Guozhang Wang,2018-06-08 10:54:26-07:00,['d2b2fbdf94cf48094081650ebc18ee860e67d8d5'],151,188,339,1574406,19,1,0,1,3920
a4c292173618e22b3f99ab8615c6b585c7688a40,0,GitHub,2018-06-09 16:10:31-07:00,['74bdafe386ae6080d6f5ead852f9026061a65be4'],182,0,182,1574588,6,0,0,0.106382979,3920
53c84dbb49ff9ef5a1946dd389e75a4d0eb174f7,0,GitHub,2018-06-11 11:29:02+01:00,['a4c292173618e22b3f99ab8615c6b585c7688a40'],24,11,35,1574623,2,,,,3920
7d85785d3de7640ca0ee61e7110a32286e328343,1,Dong Lin,2018-06-11 10:35:30-07:00,['53c84dbb49ff9ef5a1946dd389e75a4d0eb174f7'],14,43,57,1574680,3,0.714285714,1,1,3920
49db5a63c043b50c10c2dfd0648f8d74ee917b6a,1,Jun Rao,2018-06-11 13:26:22-07:00,['7d85785d3de7640ca0ee61e7110a32286e328343'],261,215,476,1575156,18,0,0,0,3921
cc4157d8773dc7f8b4fd771211bb24cc645e1341,1,Guozhang Wang,2018-06-11 13:32:03-07:00,['49db5a63c043b50c10c2dfd0648f8d74ee917b6a'],4,5,9,1575165,1,,,,3921
ee5cc974d2ef449444861d82e1793668184ca86f,1,Matthias J. Sax,2018-06-11 14:40:03-07:00,['cc4157d8773dc7f8b4fd771211bb24cc645e1341'],10,49,59,1575224,3,0.366666667,0.9,1,3921
3face7fce2489715c040c9756ec05406aaa657d4,1,Ewen Cheslack-Postava,2018-06-11 15:16:46-07:00,['ee5cc974d2ef449444861d82e1793668184ca86f'],7,165,172,1575396,4,0.291666667,0.697916667,0.9375,3921
a20c8e87605edc759a452f6eee79df901a9aafa6,0,GitHub,2018-06-11 15:45:29-07:00,['3face7fce2489715c040c9756ec05406aaa657d4'],2,2,4,1575400,1,,,,3921
d98ec33364d4ddb6ee53e0cd6001857207ba2089,1,GitHub,2018-06-11 16:08:24-07:00,['a20c8e87605edc759a452f6eee79df901a9aafa6'],78,230,308,1575708,15,0.495412844,0.990825688,0.871559633,3921
f0b1b46486ca67a5d44b68ee076af0d6e986764a,0,Ismael Juma,2018-06-11 23:02:19-07:00,['d98ec33364d4ddb6ee53e0cd6001857207ba2089'],5,3,8,1575716,1,1,1,1,3921
4580d9f16aabc44f3d97931c6bfa29de1e40bf2d,0,Dong Lin,2018-06-11 23:32:30-07:00,['f0b1b46486ca67a5d44b68ee076af0d6e986764a'],67,32,99,1575815,5,1,0,0,3921
2bfb239495c97e57ee51f2f462f5d09160a0d67b,1,Ismael Juma,2018-06-12 00:46:24-07:00,['4580d9f16aabc44f3d97931c6bfa29de1e40bf2d'],158,255,413,1576228,3,0.659090909,1,1,3921
dbca6b9b88e8e2eaa6a9c091ce5d88b8229c0d39,0,Ismael Juma,2018-06-12 01:58:58-07:00,['2bfb239495c97e57ee51f2f462f5d09160a0d67b'],1,13,14,1576242,2,,,,3921
fa1d0383902260576132e09bdf9efcc2784b55b4,0,Ismael Juma,2018-06-12 02:08:51-07:00,['dbca6b9b88e8e2eaa6a9c091ce5d88b8229c0d39'],10,7,17,1576259,7,,,,3921
7a590612524bd8e899c8d6bbb73daece7f352d46,1,GitHub,2018-06-12 11:12:07-07:00,['fa1d0383902260576132e09bdf9efcc2784b55b4'],35,74,109,1576368,3,1,1,0.708333333,3921
40f63eb9c1775bd292a5d028412fb784b7854701,1,Matthias J. Sax,2018-06-12 11:54:07-07:00,['7a590612524bd8e899c8d6bbb73daece7f352d46'],66,429,495,1576863,6,0.133064516,1,0.915322581,3923
16190e9bfd2db13a886b4122127fbe4f96ed8f65,1,Jason Gustafson,2018-06-12 12:52:51-07:00,['40f63eb9c1775bd292a5d028412fb784b7854701'],18,44,62,1576925,21,0.5,1,1,3923
a5924025126a6ab77fd9fb74cf66a180931ffecf,1,Jun Rao,2018-06-12 19:07:10-03:00,['16190e9bfd2db13a886b4122127fbe4f96ed8f65'],132,551,683,1577608,13,0.97029703,1,1,3925
53ca52f855e903907378188d29224b3f9cefa6cb,0,Jason Gustafson,2018-06-12 16:29:50-07:00,['a5924025126a6ab77fd9fb74cf66a180931ffecf'],21,54,75,1577683,4,0,0.8,0,3925
329ee62da93d1a81690dea7786b99e9f1c13a48b,0,Ismael Juma,2018-06-12 17:26:08-07:00,['53ca52f855e903907378188d29224b3f9cefa6cb'],1,0,1,1577684,1,,,,3925
477ae9e860fd2a2e605bb6d9892c6eab12ef7824,0,Ismael Juma,2018-06-12 17:35:26-07:00,['329ee62da93d1a81690dea7786b99e9f1c13a48b'],0,27,27,1577711,1,0,1,1,3925
70e13f032e6f594d021787583e1982225eea9388,0,Ewen Cheslack-Postava,2018-06-12 21:03:19-07:00,['477ae9e860fd2a2e605bb6d9892c6eab12ef7824'],6,0,6,1577717,1,0.75,0,0.75,3925
22356d55ef232871f144be750087f71c5ed1e9a9,1,Ewen Cheslack-Postava,2018-06-12 21:35:45-07:00,['70e13f032e6f594d021787583e1982225eea9388'],0,20,20,1577737,2,0,1,1,3925
ee3d3f1b27c4f456c6ccf28d1f4b62cc45beaed8,0,Ewen Cheslack-Postava,2018-06-12 22:15:47-07:00,['22356d55ef232871f144be750087f71c5ed1e9a9'],1,4,5,1577742,2,,,,3925
7a1f55567610725c5f9d5b6ddfc945b0153e6acd,0,Ewen Cheslack-Postava,2018-06-12 22:56:49-07:00,['ee3d3f1b27c4f456c6ccf28d1f4b62cc45beaed8'],0,1,1,1577743,1,,,,3925
5145d6b6b413721948bf89079b13ddbe82143bf1,1,GitHub,2018-06-13 00:51:11-07:00,['7a1f55567610725c5f9d5b6ddfc945b0153e6acd'],128,82,210,1577953,12,1,1,0,3925
de4f4f530a92473edb3665c94ac386d5c53cc893,0,Guozhang Wang,2018-06-13 10:27:35-07:00,['5145d6b6b413721948bf89079b13ddbe82143bf1'],504,576,1080,1579033,6,1,1,1,3926
301474f0baff19400db9206c502a9f1e488a5374,0,GitHub,2018-06-13 11:00:46-07:00,['de4f4f530a92473edb3665c94ac386d5c53cc893'],5,0,5,1579038,1,1,1,0,3926
c903d5767e7432db04ac93c4db8712ff08d9b93b,0,Matthias J. Sax,2018-06-13 14:31:51-07:00,['301474f0baff19400db9206c502a9f1e488a5374'],0,32,32,1579070,2,0.045454545,0.772727273,0.954545455,3926
ecfe27ebab87a47542fde3ef6f4e02d06ae8cd92,0,GitHub,2018-06-13 14:46:05-07:00,['c903d5767e7432db04ac93c4db8712ff08d9b93b'],1,1,2,1579072,1,,,,3926
ce7fe8fe5f8333e1e6936e2198713211bfb0dfe5,1,Guozhang Wang,2018-06-13 15:04:53-07:00,['ecfe27ebab87a47542fde3ef6f4e02d06ae8cd92'],7,1,8,1579080,1,1,0,0,3926
ff96d574371811c75f4f454847f67508d1de98c0,1,GitHub,2018-06-13 15:13:55-07:00,['ce7fe8fe5f8333e1e6936e2198713211bfb0dfe5'],62,67,129,1579209,4,0.8,0.8,0.8,3926
443091b844d4119637d252a5303568e22d4f1d48,1,GitHub,2018-06-13 16:21:30-07:00,['ff96d574371811c75f4f454847f67508d1de98c0'],211,492,703,1579912,23,0.474226804,0.989690722,0.556701031,3926
0b591d703b574165fccf3c3a34f984beea140992,1,GitHub,2018-06-13 20:33:38-07:00,['443091b844d4119637d252a5303568e22d4f1d48'],481,177,658,1580570,4,0.723076923,0.430769231,0,3926
9a71bfb9d64dae5d0296d162a01a62d8c13324da,1,Jason Gustafson,2018-06-13 21:23:23-07:00,['0b591d703b574165fccf3c3a34f984beea140992'],49,238,287,1580857,9,0.87628866,1,0.773195876,3927
0dfa53c47a5a6ea0c06dfbd8341507322efe199f,1,Rajini Sivaram,2018-06-14 12:44:09+01:00,['9a71bfb9d64dae5d0296d162a01a62d8c13324da'],8,61,69,1580926,4,0.818181818,1,0.818181818,3927
37a4d5ea46bb5ba1bdf2d7cb03c3678a128b6f9e,1,Jason Gustafson,2018-06-14 08:26:45-07:00,['0dfa53c47a5a6ea0c06dfbd8341507322efe199f'],27,449,476,1581402,9,0.261603376,0.860759494,0.945147679,3930
a423b1d07d7e0ec70ff8b380f944368e6ebfb53b,0,GitHub,2018-06-14 10:37:35-07:00,['37a4d5ea46bb5ba1bdf2d7cb03c3678a128b6f9e'],42,85,127,1581529,1,0.333333333,0.333333333,1,3930
fa993fbaa00e994feb2c02b47fc646953b42d824,1,GitHub,2018-06-14 11:38:00-07:00,['a423b1d07d7e0ec70ff8b380f944368e6ebfb53b'],244,210,454,1581983,4,0.052631579,0,0,3930
642a97783d29bb1d43ee20e8564db7b9432dade2,1,Jun Rao,2018-06-14 17:47:59-03:00,['fa993fbaa00e994feb2c02b47fc646953b42d824'],410,475,885,1582868,45,0.321428571,0.357142857,1,3930
339fc2379dd0d01bc039518f70b017b7520dcc9f,0,Matthias J. Sax,2018-06-14 20:26:01-07:00,['642a97783d29bb1d43ee20e8564db7b9432dade2'],22,81,103,1582971,7,0.795454545,0.318181818,0.727272727,3930
a8c17e36c3239f33925b061d99a5d1d1074bbc67,0,Jason Gustafson,2018-06-14 23:00:33-07:00,['339fc2379dd0d01bc039518f70b017b7520dcc9f'],163,174,337,1583308,7,1,1,0,3930
f2cb8523d1d9c74ebf2fd6f58f51e8afc95f01ca,0,Rajini Sivaram,2018-06-15 12:16:04+01:00,['a8c17e36c3239f33925b061d99a5d1d1074bbc67'],3,15,18,1583326,2,1,1,1,3930
dad19ac00f3388040d2d4d04a7c2439f89b65021,0,GitHub,2018-06-15 08:49:45-07:00,['f2cb8523d1d9c74ebf2fd6f58f51e8afc95f01ca'],1,11,12,1583338,1,,,,3930
fab8b7e676bcaf4faf84d563ab48e3ebee61b4ab,1,Ewen Cheslack-Postava,2018-06-15 14:52:28-07:00,['dad19ac00f3388040d2d4d04a7c2439f89b65021'],23,33,56,1583394,15,,,,3930
d904058c5fc321ea6d29dee41f74ea44cdbad3ea,0,GitHub,2018-06-15 22:43:15-07:00,['fab8b7e676bcaf4faf84d563ab48e3ebee61b4ab'],1,0,1,1583395,1,,,,3930
2bcc6e82767fb07c7a86c0a4e5da64d75fb15f25,0,GitHub,2018-06-16 18:36:51-07:00,['d904058c5fc321ea6d29dee41f74ea44cdbad3ea'],0,1,1,1583396,1,,,,3930
239dd0fb9b8a72ff0f108fea9a9372ab0858339c,1,Ewen Cheslack-Postava,2018-06-16 22:18:20-07:00,['2bcc6e82767fb07c7a86c0a4e5da64d75fb15f25'],2,8,10,1583406,1,1,1,1,3930
f0282cb3de9b60d6eea12803103f8ca4d7f45734,1,Ewen Cheslack-Postava,2018-06-16 22:23:20-07:00,['239dd0fb9b8a72ff0f108fea9a9372ab0858339c'],0,4,4,1583410,2,0,1,1,3930
be846d833caade74f1d0536ecf9d540855cde758,0,Ewen Cheslack-Postava,2018-06-16 23:04:31-07:00,['f0282cb3de9b60d6eea12803103f8ca4d7f45734'],1,11,12,1583422,2,1,1,1,3930
d06da1b7f424ebad16ea5eca11b58b7c2ca3fa34,0,Ewen Cheslack-Postava,2018-06-17 12:12:11-07:00,['be846d833caade74f1d0536ecf9d540855cde758'],6,35,41,1583463,2,0.608695652,0,0.869565217,3930
6810617179222ae659343efb02ef7e6cefb15662,0,Guozhang Wang,2018-06-17 16:49:01-07:00,['d06da1b7f424ebad16ea5eca11b58b7c2ca3fa34'],0,7,7,1583470,2,1,1,1,3930
1546bcd87770fba60b9663a2dc202823a873ecb4,1,GitHub,2018-06-17 17:31:30-07:00,['6810617179222ae659343efb02ef7e6cefb15662'],3,46,49,1583519,2,,,,3930
d504e85011332016447472fb37f1c1edd8acbf1a,1,GitHub,2018-06-18 18:28:08+01:00,['1546bcd87770fba60b9663a2dc202823a873ecb4'],82,295,377,1583896,7,0.486666667,0.673333333,0.866666667,3930
1354371d4f4dd208458c776e1f27715ec5f77f47,0,Guozhang Wang,2018-06-18 10:58:26-07:00,['d504e85011332016447472fb37f1c1edd8acbf1a'],1415,1625,3040,1586936,34,0,0.806818182,0.232954545,3938
347b37e31945b54fb96fc7dacc2b2deed40e8e5e,0,GitHub,2018-06-18 13:43:01-07:00,['1354371d4f4dd208458c776e1f27715ec5f77f47'],6,0,6,1586942,1,1,1,1,3938
fc81acbfd704404a7599c4b97095a554f9fe69ba,1,Jason Gustafson,2018-06-18 15:37:26-07:00,['347b37e31945b54fb96fc7dacc2b2deed40e8e5e'],2,7,9,1586951,1,,,,3938
e8955f731eff61417ec04253547f125cb921a59a,0,GitHub,2018-06-19 15:16:16+01:00,['fc81acbfd704404a7599c4b97095a554f9fe69ba'],7,116,123,1587074,4,0.684931507,0.356164384,0.98630137,3938
cc4dce94af8b19a796eeb7a9be78640739cb1a48,1,GitHub,2018-06-19 07:32:54-07:00,['e8955f731eff61417ec04253547f125cb921a59a'],14931,677,15608,1602682,207,0.549968573,0.288812068,0.120835952,3938
3afe2ed8e39da3605274baddc7245be569b4aed7,1,GitHub,2018-06-19 13:26:29-07:00,['cc4dce94af8b19a796eeb7a9be78640739cb1a48'],310,448,758,1603440,15,1,1,1,3939
d2b84bd4b03d528ff82c8fb6067f118ca9256792,0,Jun Rao,2018-06-19 13:47:24-07:00,['3afe2ed8e39da3605274baddc7245be569b4aed7'],13,48,61,1603501,7,1,1,1,3939
410e00cbcb7dd664dcd1f451eca57e5882985186,0,Guozhang Wang,2018-06-19 14:10:13-07:00,['d2b84bd4b03d528ff82c8fb6067f118ca9256792'],2,42,44,1603545,2,1,1,1,3939
f8cb3c3e1d16d34e5cc382cf4833330f9cce9aad,0,GitHub,2018-06-19 14:23:04-07:00,['410e00cbcb7dd664dcd1f451eca57e5882985186'],2,9,11,1603556,1,,,,3939
fd969beae7326aed70fd201f299e9ebb0e0b72a9,0,Ismael Juma,2018-06-20 01:24:26-07:00,['f8cb3c3e1d16d34e5cc382cf4833330f9cce9aad'],7,36,43,1603599,2,0.916666667,0.916666667,1,3939
96bcfdfc7c9aac075635b2034e65e412a725672e,1,GitHub,2018-06-20 05:05:50-07:00,['fd969beae7326aed70fd201f299e9ebb0e0b72a9'],139,75,214,1603813,44,0,0,0,3939
e5ec3f55c968292ae8fd0cb8ad8b626abed8f503,1,GitHub,2018-06-20 17:08:58+01:00,['96bcfdfc7c9aac075635b2034e65e412a725672e'],28,159,187,1604000,7,0.397435897,0.935897436,0.205128205,3940
6732593bbad3d1e07f1ec7c2d00a2e1eabf382f2,1,Guozhang Wang,2018-06-20 18:40:48-07:00,['e5ec3f55c968292ae8fd0cb8ad8b626abed8f503'],249,305,554,1604554,19,1,1,1,3940
bb68b9c046b36dc73e5e4d9343e1de962c7699d1,0,GitHub,2018-06-21 11:18:31+01:00,['6732593bbad3d1e07f1ec7c2d00a2e1eabf382f2'],5,5,10,1604564,2,,,,3940
456b17fc8e46db7a7d57e1aac3c2af961c93f57a,0,GitHub,2018-06-21 08:27:04-07:00,['bb68b9c046b36dc73e5e4d9343e1de962c7699d1'],1,1,2,1604566,1,,,,3940
d3e264e773c4652f34b40c7c3b494c0f7fbabffc,0,GitHub,2018-06-21 10:02:58-07:00,['456b17fc8e46db7a7d57e1aac3c2af961c93f57a'],195,88,283,1604849,10,1,0,0,3940
e33ccb628efd9a039d2ad9f9ca74f001bc682fcd,0,GitHub,2018-06-21 16:47:44-07:00,['d3e264e773c4652f34b40c7c3b494c0f7fbabffc'],5,37,42,1604891,3,1,1,1,3940
418a91b5d4e3a0579b91d286f61c2b63c5b4a9b6,1,Jason Gustafson,2018-06-21 17:19:24-07:00,['e33ccb628efd9a039d2ad9f9ca74f001bc682fcd'],159,545,704,1605595,18,0,0.665254237,0.741525424,3940
624acc63dabd6f46974540ef27a5ca1caa891c1b,1,GitHub,2018-06-22 15:41:52+01:00,['418a91b5d4e3a0579b91d286f61c2b63c5b4a9b6'],23,52,75,1605670,8,1,1,0.631578947,3940
80553197e9c8fd3e496cfb3108ad774201de0831,0,Matthias J. Sax,2018-06-22 16:55:39-07:00,['624acc63dabd6f46974540ef27a5ca1caa891c1b'],0,1,1,1605671,1,,,,3940
954be11bf2d3dc9fa11a69830d2ef5ff580ff533,1,Guozhang Wang,2018-06-22 17:08:00-07:00,['80553197e9c8fd3e496cfb3108ad774201de0831'],321,332,653,1606324,19,0,1,1,3941
74502710b383175a760b563fb67dad295d97ec5a,0,Guozhang Wang,2018-06-22 17:10:06-07:00,['954be11bf2d3dc9fa11a69830d2ef5ff580ff533'],1,5,6,1606330,1,,,,3941
c32f7e6ad8155915593f94bfb8bed4acf395d296,0,Guozhang Wang,2018-06-22 17:18:10-07:00,['74502710b383175a760b563fb67dad295d97ec5a'],3,3,6,1606336,1,,,,3941
bd216db4c0ab963412ad27055253f3469cf468ef,0,Ismael Juma,2018-06-23 16:33:04-07:00,['c32f7e6ad8155915593f94bfb8bed4acf395d296'],16,4,20,1606356,1,1,0,0,3941
6e043af1449264efd6a5b3638011134cc6b85888,0,GitHub,2018-06-25 10:52:31+01:00,['bd216db4c0ab963412ad27055253f3469cf468ef'],9,19,28,1606384,1,0.307692308,1,1,3941
2f36da1747e62a21108e21edacaf2e5ef12c2d6a,1,Matthias J. Sax,2018-06-25 08:49:01-07:00,['6e043af1449264efd6a5b3638011134cc6b85888'],3,4,7,1606391,1,0,0,1,3941
3cdc78e6bb1f83973a14ce1550fe3874f7348b05,0,Jason Gustafson,2018-06-25 15:46:09-07:00,['2f36da1747e62a21108e21edacaf2e5ef12c2d6a'],25,33,58,1606449,1,1,1,1,3941
9ea81baf34113ccb05244ea9fb63199e7f071bb0,1,Dong Lin,2018-06-25 23:39:02-07:00,['3cdc78e6bb1f83973a14ce1550fe3874f7348b05'],31,110,141,1606590,4,0.483870968,0.983870968,1,3941
9bc9a37e50e403a356a4f10d6df12e9f808d4fba,0,Jason Gustafson,2018-06-26 07:57:28-07:00,['9ea81baf34113ccb05244ea9fb63199e7f071bb0'],5,6,11,1606601,3,,,,3941
581adb5013ed996705031ca8dd9e175c40675692,1,Guozhang Wang,2018-06-26 08:24:44-07:00,['9bc9a37e50e403a356a4f10d6df12e9f808d4fba'],2,7,9,1606610,1,,,,3941
b054789d698c2c0a6e050ef5d27804e7764bc801,0,Matthias J. Sax,2018-06-26 13:32:24-07:00,['581adb5013ed996705031ca8dd9e175c40675692'],1,1,2,1606612,1,,,,3941
a20555102bf1c0a216fe9d3e2fa59edfb6091b1b,0,Guozhang Wang,2018-06-26 18:53:06-07:00,['b054789d698c2c0a6e050ef5d27804e7764bc801'],9,12,21,1606633,1,,,,3941
7a74ec62d291bf344b308115bd115a6788074a93,1,GitHub,2018-06-27 01:00:05-07:00,['a20555102bf1c0a216fe9d3e2fa59edfb6091b1b'],134,141,275,1606908,32,1,0,1,3941
7ea8a25a4c03c0c5f342d621eacd07ff62489b06,0,Guozhang Wang,2018-06-27 09:35:34-07:00,['7a74ec62d291bf344b308115bd115a6788074a93'],3,2,5,1606913,1,,,,3941
2db7eb7a8c28f4f5d2550b45a9215948652f82ca,1,Jason Gustafson,2018-06-27 14:48:08-07:00,['7ea8a25a4c03c0c5f342d621eacd07ff62489b06'],43,98,141,1607054,4,0.318181818,0.772727273,0.113636364,3941
51935ee2e6dc473415b6708b60c9d47410876997,1,Jason Gustafson,2018-06-27 15:09:44-07:00,['2db7eb7a8c28f4f5d2550b45a9215948652f82ca'],73,136,209,1607263,9,0.911764706,1,1,3941
a3db23cb76436786ebe0e5f388b4ca97dec51686,0,Dong Lin,2018-06-27 16:49:12-07:00,['51935ee2e6dc473415b6708b60c9d47410876997'],4,19,23,1607286,1,0,1,0,3941
b2ed7d80dea092e4258d04c191d42682a4db950f,0,Jason Gustafson,2018-06-27 16:59:14-07:00,['a3db23cb76436786ebe0e5f388b4ca97dec51686'],1,1,2,1607288,1,,,,3941
10b84a3661cde77b25f6408e6f360655ee618a18,0,Ismael Juma,2018-06-27 21:15:20-07:00,['b2ed7d80dea092e4258d04c191d42682a4db950f'],11,10,21,1607309,2,0.6,0.6,0,3941
daa8082d6718d39584ed6d25863af48acec2cea6,1,Rajini Sivaram,2018-06-28 14:15:15+01:00,['10b84a3661cde77b25f6408e6f360655ee618a18'],0,56,56,1607365,2,0.6,1,1,3941
be0f10e1902961daa51b543f293f7038dc6e4344,1,GitHub,2018-06-28 10:19:42-07:00,['daa8082d6718d39584ed6d25863af48acec2cea6'],11,16,27,1607392,1,0,0,1,3941
6bfaf4dc6087062ac9ea8e9c036ef3c5ec95b254,0,GitHub,2018-06-28 14:32:02-07:00,['be0f10e1902961daa51b543f293f7038dc6e4344'],37,154,191,1607583,4,,,,3941
24b3844fe4163dbf7c6fcdffdf3531d052ec8e08,0,Guozhang Wang,2018-06-28 14:46:26-07:00,['6bfaf4dc6087062ac9ea8e9c036ef3c5ec95b254'],2,2,4,1607587,1,,,,3941
919409bb2331fbd60cd3d425fe7d9384d66967fa,1,Guozhang Wang,2018-06-28 20:45:29-07:00,['24b3844fe4163dbf7c6fcdffdf3531d052ec8e08'],46,106,152,1607739,8,0.473684211,1,0.526315789,3941
b0d2ddb330a24971c53ba96129a3c66312b30c5c,0,Rajini Sivaram,2018-06-29 14:13:45+01:00,['919409bb2331fbd60cd3d425fe7d9384d66967fa'],1,47,48,1607787,2,1,1,1,3941
053d831992e5351deb174f11f0ecd0ebe7c4ba5a,0,Rajini Sivaram,2018-06-29 15:37:14+01:00,['b0d2ddb330a24971c53ba96129a3c66312b30c5c'],1,1,2,1607789,1,,,,3941
98e546611a88eed4772178090f1498d4f6f6f506,0,Jason Gustafson,2018-06-29 09:19:22-07:00,['053d831992e5351deb174f11f0ecd0ebe7c4ba5a'],9,8,17,1607806,1,0,0,0,3941
7947c94140dbcfa1ce78bd35d400bb309470fc81,0,GitHub,2018-06-29 11:10:21-07:00,['98e546611a88eed4772178090f1498d4f6f6f506'],6,1,7,1607813,2,1,0,0,3941
d44d5d7520d31f33feb03b0679f8c552254dac4e,1,Guozhang Wang,2018-06-29 13:27:26-07:00,['7947c94140dbcfa1ce78bd35d400bb309470fc81'],1,92,93,1607906,7,0.316666667,1,1,3941
18181ca953b672e8856879e1daff530deccc2fec,0,Jason Gustafson,2018-06-29 13:50:28-07:00,['d44d5d7520d31f33feb03b0679f8c552254dac4e'],1,1,2,1607908,1,,,,3941
57320981bb98086a0b9f836a29df248b1c0378c3,0,Matthias J. Sax,2018-06-30 14:27:30-07:00,['18181ca953b672e8856879e1daff530deccc2fec'],4,4,8,1607916,2,,,,3941
0db8074d492ec96f3e894b484e8f0bb9fdd45544,0,GitHub,2018-07-02 22:11:05+01:00,['57320981bb98086a0b9f836a29df248b1c0378c3'],4,40,44,1607960,2,0.230769231,1,1,3941
64fff8bfcc9b92769640bfaa692e19d0db8861a6,1,Guozhang Wang,2018-07-02 16:07:38-07:00,['0db8074d492ec96f3e894b484e8f0bb9fdd45544'],115,190,305,1608265,20,0,1,0.09375,3941
8250738ae41f6f0a87dc1e21e7623c5d69cae148,1,GitHub,2018-07-02 22:00:23-07:00,['64fff8bfcc9b92769640bfaa692e19d0db8861a6'],14,45,59,1608324,5,0.380952381,1,1,3941
e38e3a66ab099996ecb156ec9105869f3d9b9228,1,Guozhang Wang,2018-07-03 07:07:50-07:00,['8250738ae41f6f0a87dc1e21e7623c5d69cae148'],202,389,591,1608915,9,0.121428571,1,0.65,3941
c5b00d20d3703b7fc4358b7258d5d6adb890136f,0,Rajini Sivaram,2018-07-03 19:42:44+01:00,['e38e3a66ab099996ecb156ec9105869f3d9b9228'],0,1,1,1608916,1,,,,3941
1aea0834d346f0afa16f946c47e51fefac37612b,0,GitHub,2018-07-05 17:07:53+01:00,['c5b00d20d3703b7fc4358b7258d5d6adb890136f'],0,3,3,1608919,1,,,,3941
1f8527b331f3d4c8e3ea16993d96caae2ea18fc5,1,Guozhang Wang,2018-07-06 10:54:28-07:00,['1aea0834d346f0afa16f946c47e51fefac37612b'],22,135,157,1609076,3,0.015873016,0.26984127,0.873015873,3941
f54ba7cf8528b5082471a86850ba951244a990e1,1,GitHub,2018-07-06 14:35:25-07:00,['1f8527b331f3d4c8e3ea16993d96caae2ea18fc5'],32,68,100,1609176,7,0,1,1,3941
9a18f92935844abc3c6926a94f65a0ccb639aeb3,0,GitHub,2018-07-08 21:14:47-07:00,['f54ba7cf8528b5082471a86850ba951244a990e1'],1,1,2,1609178,1,,,,3941
05c5854d1ff8510c867066b65e28ad9414d6c266,1,Guozhang Wang,2018-07-09 16:48:34-07:00,['9a18f92935844abc3c6926a94f65a0ccb639aeb3'],282,318,600,1609778,16,0,1,0.333333333,3942
8119683a234543aa7b523a571b8a68a5002c5b56,1,GitHub,2018-07-11 11:44:54-07:00,['05c5854d1ff8510c867066b65e28ad9414d6c266'],9,51,60,1609838,2,0.888888889,0.555555556,0.888888889,3942
000a2d42cb813768866a52a652176c253babb043,0,Guozhang Wang,2018-07-11 23:00:55-07:00,['8119683a234543aa7b523a571b8a68a5002c5b56'],1,1,2,1609840,1,,,,3942
b68766017f11afd7e541fa84378d5e616cf1e81a,0,Jason Gustafson,2018-07-12 11:44:12-07:00,['000a2d42cb813768866a52a652176c253babb043'],1,5,6,1609846,1,,,,3942
ba8fb6ec7094e1e31da25b39f9e6d872ed9b9fdd,0,Harsha,2018-07-16 19:30:10-07:00,['b68766017f11afd7e541fa84378d5e616cf1e81a'],1,1,2,1609848,1,,,,3942
b0b11a2dde4f3a9663f1c941d30350e1273d89e0,0,GitHub,2018-07-17 07:56:11-07:00,['ba8fb6ec7094e1e31da25b39f9e6d872ed9b9fdd'],1,1,2,1609850,1,,,,3942
07647c2a4cc56fd47a6092c72131aa15b34bf819,0,Matthias J. Sax,2018-07-17 11:42:08-07:00,['b0b11a2dde4f3a9663f1c941d30350e1273d89e0'],1,1,2,1609852,1,,,,3942
8ec8ec542264604cc44ef5a17439573c0de0990a,1,Jason Gustafson,2018-07-17 11:51:05-07:00,['07647c2a4cc56fd47a6092c72131aa15b34bf819'],162,254,416,1610268,7,0.338983051,0.457627119,0.830508475,3942
41abfcb642ebb0bcdaf43c7908ba2e4380c7a223,0,GitHub,2018-07-17 13:12:13-07:00,['8ec8ec542264604cc44ef5a17439573c0de0990a'],10,10,20,1610288,1,,,,3942
f6219c6ad1d338792413c562615bad22f6baca1c,1,GitHub,2018-07-17 13:53:03-07:00,['41abfcb642ebb0bcdaf43c7908ba2e4380c7a223'],19,15,34,1610322,3,0,0,0,3942
08fe24b46a327424e3249eeef1a32e05db717b18,1,Guozhang Wang,2018-07-17 14:04:51-07:00,['f6219c6ad1d338792413c562615bad22f6baca1c'],15,173,188,1610510,4,0.435643564,0.762376238,0.891089109,3942
8c47a3e52f3d6871a708b1d2c8b5a7e30a2a5b99,1,Joel Koshy,2018-07-17 15:45:29-07:00,['08fe24b46a327424e3249eeef1a32e05db717b18'],40,182,222,1610732,11,0.277777778,0.911111111,0.833333333,3942
0c0ced770c45879d67b0e16878ddd36015aa3fd9,0,Jason Gustafson,2018-07-17 17:09:45-07:00,['8c47a3e52f3d6871a708b1d2c8b5a7e30a2a5b99'],1,2,3,1610735,2,,,,3942
2d877631cde81bd0fdc42bd5bff0c31e5820d623,0,GitHub,2018-07-17 17:31:32-07:00,['0c0ced770c45879d67b0e16878ddd36015aa3fd9'],2,2,4,1610739,1,,,,3942
28e29a4c61d98e6f79e1edfb79b8812d753dc139,1,Harsha,2018-07-17 22:24:08-07:00,['2d877631cde81bd0fdc42bd5bff0c31e5820d623'],2,2,4,1610743,1,,,,3942
0875ddeb2381c68afb0e4d5a15b25baf4cde29a2,1,GitHub,2018-07-18 12:27:21+01:00,['28e29a4c61d98e6f79e1edfb79b8812d753dc139'],23,120,143,1610886,3,0.869565217,0.608695652,0.739130435,3942
06d96628f0e098d93aecc650534c9e9965127d92,1,GitHub,2018-07-18 09:30:52-07:00,['0875ddeb2381c68afb0e4d5a15b25baf4cde29a2'],595,325,920,1611806,10,0.882882883,0,0.603603604,3942
359eb4e083c2e22b44b740a8e19319a457f4ef77,0,GitHub,2018-07-18 18:07:59+01:00,['06d96628f0e098d93aecc650534c9e9965127d92'],3,3,6,1611812,1,,,,3942
03e788b29be6da0ef729f38448dc4345e68e398f,0,Matthias J. Sax,2018-07-18 13:52:44-07:00,['359eb4e083c2e22b44b740a8e19319a457f4ef77'],2,2,4,1611816,1,,,,3942
7c9a7359dcf1a325c6eac8b5199048df05ad39e4,1,Dong Lin,2018-07-18 21:45:17-07:00,['03e788b29be6da0ef729f38448dc4345e68e398f'],443,372,815,1612631,19,0.670886076,0,0.164556962,3943
3205989d585c3939254911ee0757eeaaeb15ae27,0,Jason Gustafson,2018-07-18 23:05:52-07:00,['7c9a7359dcf1a325c6eac8b5199048df05ad39e4'],7,0,7,1612638,1,,,,3943
10a0b8a6baad201227281a34ce80748beddd0739,0,GitHub,2018-07-19 11:33:34+01:00,['3205989d585c3939254911ee0757eeaaeb15ae27'],12,11,23,1612661,2,,,,3943
2f6240ac944f2a55ece50a179b79f4e2ee63a621,1,GitHub,2018-07-19 08:06:17-07:00,['10a0b8a6baad201227281a34ce80748beddd0739'],342,96,438,1613099,9,0.162790698,0.034883721,0.011627907,3943
284b46b7ce8520792a337b721762721817628b3f,1,Rajini Sivaram,2018-07-19 17:55:29+01:00,['2f6240ac944f2a55ece50a179b79f4e2ee63a621'],61,197,258,1613357,7,0.8,0.8,0.709090909,3945
96c53e96b8834c550e6db54b2748c08e545f9150,1,Guozhang Wang,2018-07-19 14:28:12-07:00,['284b46b7ce8520792a337b721762721817628b3f'],55,86,141,1613498,5,0.555555556,1,0.888888889,3945
82f124ae30116b2b7d45878aaeb9699b6bdf1c30,1,Guozhang Wang,2018-07-19 15:22:53-07:00,['96c53e96b8834c550e6db54b2748c08e545f9150'],229,550,779,1614277,20,0.613924051,0.46835443,0.727848101,3948
80b55309d1090b0bb45d571c5f6114461f6cb041,0,Dong Lin,2018-07-19 23:48:41-07:00,['82f124ae30116b2b7d45878aaeb9699b6bdf1c30'],1,64,65,1614342,2,0,1,1,3949
be02dbe287f94064fd15b40df1d455342cb512c6,0,GitHub,2018-07-20 09:16:20+01:00,['80b55309d1090b0bb45d571c5f6114461f6cb041'],1,2,3,1614345,1,1,1,1,3949
980b725bb09ee42469534bf50d01118ce650880a,0,GitHub,2018-07-20 09:23:01+01:00,['be02dbe287f94064fd15b40df1d455342cb512c6'],1,1,2,1614347,1,,,,3949
9089fb2d8255b9ea08e083c39c1ec3fe37d78082,1,Guozhang Wang,2018-07-20 08:20:36-07:00,['980b725bb09ee42469534bf50d01118ce650880a'],5,7,12,1614359,2,0,1,0,3949
bf237fa7c576bd141d78fdea9f17f65ea269c290,0,Jason Gustafson,2018-07-20 08:52:04-07:00,['9089fb2d8255b9ea08e083c39c1ec3fe37d78082'],20,46,66,1614425,3,0.058823529,0,0.941176471,3949
75825caee4eba332808fe9bb8575920b01d99af4,1,GitHub,2018-07-20 10:37:56-07:00,['bf237fa7c576bd141d78fdea9f17f65ea269c290'],88,30,118,1614543,2,1,0,0,3949
c5a4d5cb91e690a740ab9761e78791d5075ea150,0,Matthias J. Sax,2018-07-20 11:01:32-07:00,['75825caee4eba332808fe9bb8575920b01d99af4'],36,26,62,1614605,1,,,,3949
0b5fd99ecb2672b74cf970c15a3959c5a1571d6f,0,Jason Gustafson,2018-07-20 11:10:43-07:00,['c5a4d5cb91e690a740ab9761e78791d5075ea150'],1,13,14,1614619,1,1,1,0.6,3949
9449f055c7a0b340a8d69d7365c5817464b2f6ed,1,Rajini Sivaram,2018-07-20 20:35:12+01:00,['0b5fd99ecb2672b74cf970c15a3959c5a1571d6f'],1,14,15,1614634,2,1,1,1,3949
5d2bf6328e1c5b054017419cf4de562dc8a3ec7a,0,Ismael Juma,2018-07-20 21:01:10-07:00,['9449f055c7a0b340a8d69d7365c5817464b2f6ed'],3,55,58,1614692,2,0.117647059,1,1,3949
f9cdadfdcf64b95afe21590884594eb3b11043f8,0,Dong Lin,2018-07-21 00:04:16-07:00,['5d2bf6328e1c5b054017419cf4de562dc8a3ec7a'],4,6,10,1614702,1,,,,3949
ee0c2cee214b3d46f83562467bb1e4f5165f172c,0,Ismael Juma,2018-07-21 03:13:58-07:00,['f9cdadfdcf64b95afe21590884594eb3b11043f8'],5,8,13,1614715,1,0,0,0,3949
b9b70c95a2cfdf01379f053c65e393bfc4ed7f37,1,Ismael Juma,2018-07-21 03:32:56-07:00,['ee0c2cee214b3d46f83562467bb1e4f5165f172c'],106,105,211,1614926,2,0,0.018181818,0.018181818,3949
591954e2e55e0c262bf029f4b8f17566dcae6818,0,Ismael Juma,2018-07-21 11:40:00-07:00,['b9b70c95a2cfdf01379f053c65e393bfc4ed7f37'],19,30,49,1614975,6,1,1,1,3949
d11f6f26b773343246c217f498de3c02916bec6c,1,Jason Gustafson,2018-07-21 14:03:14-07:00,['591954e2e55e0c262bf029f4b8f17566dcae6818'],43,174,217,1615192,15,0.192307692,0.833333333,0.961538462,3949
9a7f29c1ede9f1ece67b73d2d6497d60f38fb62a,1,Dong Lin,2018-07-21 16:52:54-07:00,['d11f6f26b773343246c217f498de3c02916bec6c'],15,53,68,1615260,2,0.045454545,1,1,3949
5db2f9903a1e1d9fe574730e89aec0022333db71,1,Ismael Juma,2018-07-22 09:49:32-07:00,['9a7f29c1ede9f1ece67b73d2d6497d60f38fb62a'],4,19,23,1615283,2,1,1,1,3949
4b60ed3247f0931731904c49dc7381b8eaac88d8,0,GitHub,2018-07-23 19:10:33+01:00,['5db2f9903a1e1d9fe574730e89aec0022333db71'],1,4,5,1615288,2,,,,3949
52c5b5f1118f3571c6c981c16c02484ada0b28c4,0,Ismael Juma,2018-07-24 00:39:33-07:00,['4b60ed3247f0931731904c49dc7381b8eaac88d8'],8,1,9,1615297,4,,,,3949
c83ecf4c55a2dbbb89c71080c601417adb8b699c,1,Rajini Sivaram,2018-07-24 09:25:18+01:00,['52c5b5f1118f3571c6c981c16c02484ada0b28c4'],9,61,70,1615367,3,0,1,1,3949
487b95454233e981a65c184c7f3b86adf34058ef,1,GitHub,2018-07-24 19:33:55-07:00,['c83ecf4c55a2dbbb89c71080c601417adb8b699c'],24,35,59,1615426,4,1,1,0,3949
1d9a427225c64e7629a4eb2e2d129d5551185049,0,Guozhang Wang,2018-07-24 22:00:18-07:00,['487b95454233e981a65c184c7f3b86adf34058ef'],1,20,21,1615447,2,1,1,1,3949
7fc7136ffd28245629f00870fc7f7cbe1fe1c6ce,1,Jason Gustafson,2018-07-26 09:13:50-07:00,['1d9a427225c64e7629a4eb2e2d129d5551185049'],431,900,1331,1616778,22,0.083333333,0.903225806,0.89516129,3949
42af41d5fc991c392b75396352903b4d919da5d3,1,GitHub,2018-07-26 09:31:02-07:00,['7fc7136ffd28245629f00870fc7f7cbe1fe1c6ce'],194,202,396,1617174,4,1,0,0,3949
a932520135d42c7d9731064d96c21ab2fc5de696,1,Dong Lin,2018-07-26 10:29:09-07:00,['42af41d5fc991c392b75396352903b4d919da5d3'],2,68,70,1617244,3,0.0625,0.90625,1,3949
061885e9f1675221f31ce47cfb0e59eb5748b9c7,1,GitHub,2018-07-26 17:58:29-07:00,['a932520135d42c7d9731064d96c21ab2fc5de696'],28,81,109,1617353,5,0.578947368,0.868421053,0.868421053,3949
a61594dee143ba089300546d1994b875a16ba521,0,Harsha,2018-07-27 14:00:19-07:00,['061885e9f1675221f31ce47cfb0e59eb5748b9c7'],17,84,101,1617454,1,1,1,1,3949
c8c3a7dc48dc1ec6220798294da123bb617a6cd7,1,GitHub,2018-07-27 22:11:55-07:00,['a61594dee143ba089300546d1994b875a16ba521'],59,87,146,1617600,4,0,0.875,1,3949
08a4cda34e7535ead76d2a65826ff9e09b8bdd4f,1,Guozhang Wang,2018-07-28 07:48:01-07:00,['c8c3a7dc48dc1ec6220798294da123bb617a6cd7'],16,22,38,1617638,4,0,0,0,3949
495c78db6f0d0d3fe111ea49f8041b5b3e32a8a4,0,Guozhang Wang,2018-07-28 07:56:31-07:00,['08a4cda34e7535ead76d2a65826ff9e09b8bdd4f'],0,6,6,1617644,1,,,,3949
96bc0b882d0c51d9b58c9f87654e6d133fd9ef34,0,Dong Lin,2018-07-29 21:06:18-07:00,['495c78db6f0d0d3fe111ea49f8041b5b3e32a8a4'],0,9,9,1617653,1,0,1,1,3949
e09d6d796f5a0b840519021d7f6435c65f88a60a,0,Guozhang Wang,2018-07-31 09:24:13-07:00,['96bc0b882d0c51d9b58c9f87654e6d133fd9ef34'],0,14,14,1617667,1,1,1,1,3949
814fbe0feabea0f78b690f44ee99b61b07ea7dd2,1,Guozhang Wang,2018-08-01 11:01:12-07:00,['e09d6d796f5a0b840519021d7f6435c65f88a60a'],240,318,558,1618225,7,0,1,1,3949
aa4879129770798f0e2cee385ab848b64dbe9498,0,Guozhang Wang,2018-08-01 11:02:27-07:00,['814fbe0feabea0f78b690f44ee99b61b07ea7dd2'],0,81,81,1618306,1,0.428571429,1,1,3950
c3e7c0bcb258061568294c0d96b62fea94ef8ee7,1,GitHub,2018-08-01 11:04:17-07:00,['aa4879129770798f0e2cee385ab848b64dbe9498'],137,133,270,1618576,39,0.727272727,0.454545455,0.181818182,3950
c19213ab4139aa1f56f89982448184a5c82f98a4,1,Guozhang Wang,2018-08-01 15:01:18-07:00,['c3e7c0bcb258061568294c0d96b62fea94ef8ee7'],1110,1468,2578,1621154,39,0.781914894,1,1,3951
530d951cbd47e7d27d5e687881f3dffe8b880377,1,Harsha,2018-08-01 19:27:08-07:00,['c19213ab4139aa1f56f89982448184a5c82f98a4'],1,1,2,1621156,1,,,,3951
ac79d4904797aad99b9481b4e34789402b259664,0,Rajini Sivaram,2018-08-02 11:14:21+01:00,['530d951cbd47e7d27d5e687881f3dffe8b880377'],0,8,8,1621164,1,1,1,1,3951
596c6c0c0b27c13f2017c770ea37cd39e27e5dcf,0,GitHub,2018-08-02 11:02:38-07:00,['ac79d4904797aad99b9481b4e34789402b259664'],18,20,38,1621202,2,1,1,1,3951
70d882861e1bf3eb503c84a31834e8b628de2df9,0,Ewen Cheslack-Postava,2018-08-02 14:36:02-07:00,['596c6c0c0b27c13f2017c770ea37cd39e27e5dcf'],50,43,93,1621295,6,1,0,0,3951
b083ed66b9988a15b01b7359370e4bf82e28059f,0,GitHub,2018-08-02 15:16:21-07:00,['70d882861e1bf3eb503c84a31834e8b628de2df9'],26,30,56,1621351,2,0,1,1,3951
afe00effe2d79e89e159972cf1f5f7ffeb0c6e97,1,GitHub,2018-08-02 18:34:53-07:00,['b083ed66b9988a15b01b7359370e4bf82e28059f'],184,242,426,1621777,12,1,0.92,0,3951
09fe51f3eb7e3ddee54cfb210d8a22327d1b0773,1,Dong Lin,2018-08-03 10:38:50-07:00,['afe00effe2d79e89e159972cf1f5f7ffeb0c6e97'],1,47,48,1621825,2,0,1,1,3951
3637b2c374d48e99e0a7be37605d3c79f2661007,1,Matthias J. Sax,2018-08-03 13:19:46-07:00,['09fe51f3eb7e3ddee54cfb210d8a22327d1b0773'],1221,1229,2450,1624275,214,,,0,3951
fc5f6b0e46ff81302b3e445fed0cdf454c942792,1,GitHub,2018-08-03 17:25:07-07:00,['3637b2c374d48e99e0a7be37605d3c79f2661007'],682,916,1598,1625873,20,1,1,1,3953
cf2c5e9ffc066aad37090fb6f2953a602cd8621b,1,Guozhang Wang,2018-08-03 22:43:18-07:00,['fc5f6b0e46ff81302b3e445fed0cdf454c942792'],346,426,772,1626645,13,1,0.6,0,3954
924466ad627d96fd1851722fdbb02dd6cd71eafa,0,Guozhang Wang,2018-08-04 09:41:09-07:00,['cf2c5e9ffc066aad37090fb6f2953a602cd8621b'],0,2,2,1626647,1,1,1,1,3954
b9f11796944056a5b3c7440033d587d19290b3c3,1,Matthias J. Sax,2018-08-04 13:57:18-07:00,['924466ad627d96fd1851722fdbb02dd6cd71eafa'],34,31,65,1626712,8,0.5,1,1,3954
609c81ec8b190f4812e7008b30fc509ee1656d68,0,Rajini Sivaram,2018-08-06 08:47:25+01:00,['b9f11796944056a5b3c7440033d587d19290b3c3'],3,338,341,1627053,4,0.472727273,0.793939394,0.751515152,3956
e75048d3e5344187c3980a2a72793fa9ada3196a,0,Guozhang Wang,2018-08-06 09:13:38-07:00,['609c81ec8b190f4812e7008b30fc509ee1656d68'],2,2,4,1627057,2,,,,3956
518e9d3eee1b1d2c8c76d68e043edd3cf49139fa,1,Rajini Sivaram,2018-08-06 17:22:04+01:00,['e75048d3e5344187c3980a2a72793fa9ada3196a'],83,797,880,1627937,21,0.588571429,0.851428571,0.882857143,3960
b01f8fb668988caa19feb63e878fe1901a9d0c89,1,Harsha,2018-08-06 13:20:40-07:00,['518e9d3eee1b1d2c8c76d68e043edd3cf49139fa'],26,56,82,1628019,4,1,0.545454545,0.454545455,3960
b282bbe8bea48acc06b0c9b779787d45056b2155,0,Harsha,2018-08-06 13:25:18-07:00,['b01f8fb668988caa19feb63e878fe1901a9d0c89'],1,1,2,1628021,1,,,,3960
c1ca53b3697e04a0cf3536440a622983b553c69a,0,Guozhang Wang,2018-08-06 13:39:50-07:00,['b282bbe8bea48acc06b0c9b779787d45056b2155'],1,1,2,1628023,1,,,,3960
cf981443e493f134bf78b97ad83e5bedddb3fde0,1,Jason Gustafson,2018-08-06 17:55:55-07:00,['c1ca53b3697e04a0cf3536440a622983b553c69a'],4,2,6,1628029,1,,,,3960
b0d840d34b4172add831367e8fc2c51e75efb549,0,Dong Lin,2018-08-06 20:04:59-07:00,['cf981443e493f134bf78b97ad83e5bedddb3fde0'],50,44,94,1628123,3,0,0,1,3960
fb8eba3d33df2940d58e204697ef84434a5bb089,0,Rajini Sivaram,2018-08-07 08:49:57+01:00,['b0d840d34b4172add831367e8fc2c51e75efb549'],5,95,100,1628223,1,,,,3960
ed13d7eebb0a8c2155ac50fce16c12ec502c1f0d,1,Guozhang Wang,2018-08-07 08:00:22-07:00,['fb8eba3d33df2940d58e204697ef84434a5bb089'],22,75,97,1628320,3,1,1,1,3960
b966ce127c2152cebe6d94f18de6db0cbdcccbcb,0,Harsha,2018-08-07 10:46:56-07:00,['ed13d7eebb0a8c2155ac50fce16c12ec502c1f0d'],1,1,2,1628322,1,,,,3960
cbe86bc463a59d5c2e4d3fde2659a85bda257910,0,Jason Gustafson,2018-08-07 11:08:51-07:00,['b966ce127c2152cebe6d94f18de6db0cbdcccbcb'],2,2,4,1628326,1,,,,3960
a9d7f8a1fdfa129105c6b3a128a91524874071ef,1,Guozhang Wang,2018-08-07 12:50:42-07:00,['cbe86bc463a59d5c2e4d3fde2659a85bda257910'],14,17,31,1628357,2,0,1,1,3960
36a8fec0ab2d05a8386ecd386bbbd294c3dc9126,1,Ewen Cheslack-Postava,2018-08-07 13:18:16-07:00,['a9d7f8a1fdfa129105c6b3a128a91524874071ef'],3,79,82,1628439,8,0.104166667,0,0.854166667,3961
e876c921b0cbf01e4d2aef26db56834da1d70c80,1,Ewen Cheslack-Postava,2018-08-07 14:34:27-07:00,['36a8fec0ab2d05a8386ecd386bbbd294c3dc9126'],0,49,49,1628488,6,0.80952381,1,1,3961
28a1ae4183c707af363b69e2ec2b743bdf4f236c,1,Ewen Cheslack-Postava,2018-08-07 14:44:01-07:00,['e876c921b0cbf01e4d2aef26db56834da1d70c80'],1,101,102,1628590,4,0,0,1,3961
2fd4e8d13c4f923d0ebab82a66aba24481f3e22d,0,GitHub,2018-08-07 15:48:54-07:00,['28a1ae4183c707af363b69e2ec2b743bdf4f236c'],1,1,2,1628592,1,,,,3961
ce19f34f1e3e6e697cce2e01721bedc850fca698,1,GitHub,2018-08-08 17:44:57+01:00,['2fd4e8d13c4f923d0ebab82a66aba24481f3e22d'],50,70,120,1628712,4,1,1,1,3961
cc39e4aa494f036f15e5d105fd472ea4553d1e36,0,Harsha,2018-08-08 09:51:19-07:00,['ce19f34f1e3e6e697cce2e01721bedc850fca698'],1,1,2,1628714,1,,,,3961
d12ceacd7aff623ae8c9063f89655b1f54af8123,1,GitHub,2018-08-08 13:53:34-07:00,['cc39e4aa494f036f15e5d105fd472ea4553d1e36'],0,104,104,1628818,1,0,0,1,3961
59ae73482d17f1bd19a27afd4c8624747b10274e,0,Guozhang Wang,2018-08-08 15:41:02-07:00,['d12ceacd7aff623ae8c9063f89655b1f54af8123'],11,135,146,1628964,3,1,1,0.744186047,3963
811c6433bdd6c888860d18e28bd9751d57ee8e0d,1,Jason Gustafson,2018-08-08 15:43:43-07:00,['59ae73482d17f1bd19a27afd4c8624747b10274e'],4,111,115,1629079,5,0,1,1,3963
13a7544418a139d3b2f3891da796cfa33065cbec,0,Matthias J. Sax,2018-08-08 21:22:36-07:00,['811c6433bdd6c888860d18e28bd9751d57ee8e0d'],18,14,32,1629111,2,0,0,0,3963
b1539ff62dd3e8eeffeae526a2cbd7e4cb63ecda,0,Guozhang Wang,2018-08-09 10:11:48-07:00,['13a7544418a139d3b2f3891da796cfa33065cbec'],28,31,59,1629170,3,1,1,1,3963
92004fa21a9cc75e3790ab39e44d4d3b754d95d9,1,Jason Gustafson,2018-08-09 14:40:24-07:00,['b1539ff62dd3e8eeffeae526a2cbd7e4cb63ecda'],7,242,249,1629419,9,0.732283465,0.976377953,0.866141732,3964
be43e2330e85d56d6aebf756b83b5ad43d0d4da4,0,Dong Lin,2018-08-10 14:24:27-07:00,['92004fa21a9cc75e3790ab39e44d4d3b754d95d9'],4,19,23,1629442,2,1,1,1,3964
79a2f892caef38f28c3ad837ad28b63dcbb58b87,1,Matthias J. Sax,2018-08-10 16:12:03-07:00,['be43e2330e85d56d6aebf756b83b5ad43d0d4da4'],21,120,141,1629583,4,0.530612245,0.755102041,0.857142857,3964
8a78d76466bacd8a2a3487cc84890d29c9bc4a3d,0,Jason Gustafson,2018-08-10 22:51:17-07:00,['79a2f892caef38f28c3ad837ad28b63dcbb58b87'],36,57,93,1629676,15,0,0,1,3964
a3dc10f1d9bc90b13f7449902bf5af43de166de0,1,GitHub,2018-08-12 18:38:22+01:00,['8a78d76466bacd8a2a3487cc84890d29c9bc4a3d'],5,53,58,1629734,6,0.184210526,1,0.894736842,3964
69283b4038aec24b240e5825766e8d5629e0ba9e,1,Jason Gustafson,2018-08-12 23:30:09-07:00,['a3dc10f1d9bc90b13f7449902bf5af43de166de0'],7,256,263,1629997,3,0.176056338,1,0.929577465,3964
e6fd99dc6253333c5aaa9931d8ae319e637e9a11,0,Jason Gustafson,2018-08-12 23:59:31-07:00,['69283b4038aec24b240e5825766e8d5629e0ba9e'],11,54,65,1630062,3,0,1,1,3964
68fb2932c9bbcec6c71886fd8f7d2b93b4a00274,0,Guozhang Wang,2018-08-13 09:25:36-07:00,['e6fd99dc6253333c5aaa9931d8ae319e637e9a11'],0,1,1,1630063,1,,,,3964
a2bc237cef86ca701e371196883429efb7f4074a,0,Jason Gustafson,2018-08-13 10:41:33-07:00,['68fb2932c9bbcec6c71886fd8f7d2b93b4a00274'],102,53,155,1630218,5,1,1,0.933333333,3964
76a00d78be758153b6485818c0cb86423b69100b,0,Rajini Sivaram,2018-08-13 21:54:14+01:00,['a2bc237cef86ca701e371196883429efb7f4074a'],13,4,17,1630235,1,1,0,1,3964
6d1685fa45da775f9f971121ec53d6135a4561b2,1,Matthias J. Sax,2018-08-13 17:13:13-07:00,['76a00d78be758153b6485818c0cb86423b69100b'],27,33,60,1630295,3,0,0,0,3964
9e0e29ac5c354079a4306641bc3a44ff6c4ac041,0,Jason Gustafson,2018-08-13 17:31:29-07:00,['6d1685fa45da775f9f971121ec53d6135a4561b2'],19,69,88,1630383,11,1,1,1,3964
cc8fc7c449b97807fecaa179f5831f9bd31ce950,0,Jason Gustafson,2018-08-14 09:14:48-07:00,['9e0e29ac5c354079a4306641bc3a44ff6c4ac041'],1,16,17,1630400,3,0.875,0.875,1,3964
b3771ba22acad7870e38ff7f58820c5b50946787,1,Guozhang Wang,2018-08-14 09:53:25-07:00,['cc8fc7c449b97807fecaa179f5831f9bd31ce950'],302,769,1071,1631471,40,0.125506073,0.352226721,0.975708502,3965
0d73351852369b0f969e11236332c03e2d955ae7,1,GitHub,2018-08-14 18:00:54+01:00,['b3771ba22acad7870e38ff7f58820c5b50946787'],14,245,259,1631730,4,0.626086957,0.973913043,1,3966
ad84eb5e76cb8db7c27355a2f121c0642a692980,0,Rajini Sivaram,2018-08-14 19:44:58+01:00,['0d73351852369b0f969e11236332c03e2d955ae7'],15,435,450,1632180,9,0.780898876,1,1,3970
7a9631e6349239b2dff3728d9237e6a17aa5ad81,1,GitHub,2018-08-14 14:34:42-07:00,['ad84eb5e76cb8db7c27355a2f121c0642a692980'],1169,1081,2250,1634430,38,0,0.888888889,1,3970
bb4cc4962894cf930c6b1cc01b121444f4ebb106,1,Dong Lin,2018-08-14 15:30:47-07:00,['7a9631e6349239b2dff3728d9237e6a17aa5ad81'],106,107,213,1634643,5,0,0,0,3970
3e64e5b9c03f13f58e6a049ff1fed039c6a15d69,1,Guozhang Wang,2018-08-14 17:46:40-07:00,['bb4cc4962894cf930c6b1cc01b121444f4ebb106'],66,1108,1174,1635817,8,0.393939394,0.755050505,0.987373737,3972
e4de328daba2d337929b26dad8e3993b97e9715b,0,GitHub,2018-08-15 09:05:30+01:00,['3e64e5b9c03f13f58e6a049ff1fed039c6a15d69'],1,3,4,1635821,1,0,0,1,3972
a4a65abcd3e5a01e0910afb10a214f4bb47577a3,0,Guozhang Wang,2018-08-15 14:30:24-07:00,['e4de328daba2d337929b26dad8e3993b97e9715b'],1,357,358,1636179,9,0.480314961,0.874015748,1,3972
3c14feb442219f58e0008a6242a24f1a492ca337,1,GitHub,2018-08-15 17:12:55-07:00,['a4a65abcd3e5a01e0910afb10a214f4bb47577a3'],171,464,635,1636814,19,0.803921569,0.955882353,1,3972
634f9af8c0454f46a2510c12c3a155c6fca876e9,1,GitHub,2018-08-16 09:02:24+01:00,['3c14feb442219f58e0008a6242a24f1a492ca337'],82,120,202,1637016,4,0.333333333,0.444444444,1,3973
4f25f1fb7118825384f89ed9d00c08a54870e3aa,1,GitHub,2018-08-16 09:37:32-07:00,['634f9af8c0454f46a2510c12c3a155c6fca876e9'],28,42,70,1637086,2,0,1,0.833333333,3973
e7b9e0473062e4062ee65d4eb4b1a35c66f77781,0,Jun Rao,2018-08-16 14:54:58-07:00,['4f25f1fb7118825384f89ed9d00c08a54870e3aa'],10,7,17,1637103,1,1,1,0,3973
0d778987ee3b920b5c876696385c0792671adef8,1,GitHub,2018-08-17 09:35:38-07:00,['e7b9e0473062e4062ee65d4eb4b1a35c66f77781'],208,254,462,1637565,59,1,0.857142857,1,3973
7c4e6724699bb6fc65112b5513848c733a03019e,1,Guozhang Wang,2018-08-17 12:14:29-07:00,['0d778987ee3b920b5c876696385c0792671adef8'],38,27,65,1637630,3,1,0,0.538461538,3973
bf2c46a0b8266562bf4697dc8e3e9443059f9abb,0,Matthias J. Sax,2018-08-17 15:44:08-07:00,['7c4e6724699bb6fc65112b5513848c733a03019e'],1,9,10,1637640,2,1,1,1,3973
f9f0b5c6755c7481699e67d27fb53e03d1493d12,0,Guozhang Wang,2018-08-17 16:13:59-07:00,['bf2c46a0b8266562bf4697dc8e3e9443059f9abb'],1,6,7,1637647,1,1,1,1,3973
b282b2ab1073a04d33009865b4e9c600899bc2a0,0,GitHub,2018-08-18 08:18:28-07:00,['f9f0b5c6755c7481699e67d27fb53e03d1493d12'],16,19,35,1637682,3,,,,3973
914ffa9dbef3c8ad6851b380276a1cb7c5aa4a0d,0,Ismael Juma,2018-08-20 03:46:57-07:00,['b282b2ab1073a04d33009865b4e9c600899bc2a0'],21,532,553,1638235,6,0.420588235,0.947058824,0.811764706,3976
8325046be2f6577c58fdff7366835308a81718f4,1,GitHub,2018-08-20 09:00:21-07:00,['914ffa9dbef3c8ad6851b380276a1cb7c5aa4a0d'],3,36,39,1638274,2,0,1,1,3976
028e80204dd9bfd9d6258f1eb5b0e4132bd3795d,1,Jun Rao,2018-08-20 09:48:13-07:00,['8325046be2f6577c58fdff7366835308a81718f4'],12,132,144,1638418,9,0.310810811,1,0.77027027,3976
e46827c4eab21f89a8a4bad10c4e009b5366f2d1,1,Jason Gustafson,2018-08-20 11:00:57-07:00,['028e80204dd9bfd9d6258f1eb5b0e4132bd3795d'],4,78,82,1638500,2,0.285714286,1,1,3976
ea4078e72a737268cc45776a10d8c3a566be9b4a,1,Guozhang Wang,2018-08-20 12:41:20-07:00,['e46827c4eab21f89a8a4bad10c4e009b5366f2d1'],0,48,48,1638548,3,0.103448276,0.965517241,1,3976
da35cd5114899d278c697efe5f4b19cc16fc4abc,1,Jason Gustafson,2018-08-20 13:27:44-07:00,['ea4078e72a737268cc45776a10d8c3a566be9b4a'],0,63,63,1638611,1,,,,3976
504824b7b3b62fa1774584c74815c47fa07edd4f,0,Jason Gustafson,2018-08-20 16:43:11-07:00,['da35cd5114899d278c697efe5f4b19cc16fc4abc'],7,16,23,1638634,2,0,0.5,1,3976
d31762a0c2ec1fc8e2a0fce4b38d9e5be0fd9dae,0,Jason Gustafson,2018-08-21 08:21:46-07:00,['504824b7b3b62fa1774584c74815c47fa07edd4f'],1,13,14,1638648,2,0,1,1,3976
5b25d823aff47f1a50848f5d2b3d329441aac8e9,0,Jun Rao,2018-08-21 11:37:35-07:00,['d31762a0c2ec1fc8e2a0fce4b38d9e5be0fd9dae'],46,238,284,1638932,8,0.684210526,0.939849624,0.887218045,3976
80294d0f5a7a224c478578253782644f4b5ad724,1,Jason Gustafson,2018-08-21 11:39:54-07:00,['5b25d823aff47f1a50848f5d2b3d329441aac8e9'],35,35,70,1639002,6,,,,3976
73f8809d99f1ab2db83580715c2e7e8ef3448c24,0,Jason Gustafson,2018-08-21 13:15:23-07:00,['80294d0f5a7a224c478578253782644f4b5ad724'],0,3,3,1639005,1,0,1,1,3976
3afcbebf39e557448e9bebbf5e3fa0148af1cdd7,0,Matthias J. Sax,2018-08-21 13:40:33-07:00,['73f8809d99f1ab2db83580715c2e7e8ef3448c24'],0,1,1,1639006,1,1,1,1,3976
49c5994dd9519775de104bc8d6b8ccdad8908e44,1,Jason Gustafson,2018-08-21 14:02:14-07:00,['3afcbebf39e557448e9bebbf5e3fa0148af1cdd7'],329,31,360,1639366,6,,,,3976
a289865266618d9736fe49d11edfbc2b146f5148,0,Guozhang Wang,2018-08-21 14:41:59-07:00,['49c5994dd9519775de104bc8d6b8ccdad8908e44'],3,3,6,1639372,1,,,,3976
dae9c41838e745d51dba4e6be18359d42d5ff8a3,0,Guozhang Wang,2018-08-21 15:41:36-07:00,['a289865266618d9736fe49d11edfbc2b146f5148'],25,213,238,1639610,8,1,1,1,3979
3511e904effbfb74fa54c26467477863b7f730c0,0,Ismael Juma,2018-08-21 23:42:56-07:00,['dae9c41838e745d51dba4e6be18359d42d5ff8a3'],1,1,2,1639612,1,,,,3979
bf0675ac5f31d67a1c75baf211475b8fc98f1ef1,0,Jun Rao,2018-08-22 10:13:10-07:00,['3511e904effbfb74fa54c26467477863b7f730c0'],2,3,5,1639617,1,,,,3979
8f562c1a8d16b940f898a57ec508318c397f6f13,0,Ismael Juma,2018-08-23 01:36:18-07:00,['bf0675ac5f31d67a1c75baf211475b8fc98f1ef1'],20,20,40,1639657,1,1,1,1,3979
4b2af9de6b3330bc7d9098ff690d80ef64628a6c,1,Ismael Juma,2018-08-23 01:44:04-07:00,['8f562c1a8d16b940f898a57ec508318c397f6f13'],456,95,551,1640208,1,,,,3979
b1090e52a3c7ea83ef2d79cc4b6ff7084a5070a4,1,Ismael Juma,2018-08-23 06:40:33-07:00,['4b2af9de6b3330bc7d9098ff690d80ef64628a6c'],78,67,145,1640353,1,1,0,0,3979
d8f9f278a2326f3d1ef872a21ef1b43593df571f,0,Guozhang Wang,2018-08-23 09:15:27-07:00,['b1090e52a3c7ea83ef2d79cc4b6ff7084a5070a4'],2,116,118,1640471,3,,,,3979
c968267bf1362a91eca8bb22566da76d6c9aeb26,1,Guozhang Wang,2018-08-23 13:39:35-07:00,['d8f9f278a2326f3d1ef872a21ef1b43593df571f'],51,86,137,1640608,12,1,1,1,3980
e577f6d36665012c65fc651ad392dc49e87618e6,0,Jason Gustafson,2018-08-23 14:22:09-07:00,['c968267bf1362a91eca8bb22566da76d6c9aeb26'],7,28,35,1640643,3,0.428571429,0,1,3980
7884258489a190f076b0d4bd85ca68dbf808a989,0,Jason Gustafson,2018-08-23 14:55:40-07:00,['e577f6d36665012c65fc651ad392dc49e87618e6'],18,50,68,1640711,4,0.5,0,0.0625,3980
b8559de23d120ca07daa6f66de6bba253d16a74a,0,Guozhang Wang,2018-08-23 17:07:39-07:00,['7884258489a190f076b0d4bd85ca68dbf808a989'],7,27,34,1640745,3,1,1,1,3980
1dd85a328f437643a5c135f242c644f47c3767e4,0,Matthias J. Sax,2018-08-23 17:53:10-07:00,['b8559de23d120ca07daa6f66de6bba253d16a74a'],252,481,733,1641478,13,0.188679245,0.386792453,0.622641509,3982
04770916a743ca9526cfa2fdecaef419d429a443,1,Jason Gustafson,2018-08-24 08:32:06-07:00,['1dd85a328f437643a5c135f242c644f47c3767e4'],21,163,184,1641662,7,0.104166667,0,1,3984
89cf515aecd1ce3a5265a5df94357b3b55694522,1,GitHub,2018-08-24 08:53:54-07:00,['04770916a743ca9526cfa2fdecaef419d429a443'],3,3,6,1641668,2,,,,3984
6f48978b629d7f6eaf3f82783789cf46c3566d9b,1,Guozhang Wang,2018-08-24 11:20:57-07:00,['89cf515aecd1ce3a5265a5df94357b3b55694522'],10,94,104,1641772,5,0.166666667,1,0.916666667,3985
42610e5aa105339b4f691ca97e300202b7d4812b,0,Jason Gustafson,2018-08-24 14:03:58-07:00,['6f48978b629d7f6eaf3f82783789cf46c3566d9b'],5,5,10,1641782,1,,,,3985
50a145d090ae6a4400000d844bf708e6e68a5dce,0,Ismael Juma,2018-08-25 08:49:41-07:00,['42610e5aa105339b4f691ca97e300202b7d4812b'],7,3,10,1641792,1,1,0,0.25,3985
e8e3e34c67c45ae76a51758c600ddb4f7e707717,0,Dong Lin,2018-08-25 08:55:15-07:00,['50a145d090ae6a4400000d844bf708e6e68a5dce'],1,1,2,1641794,1,,,,3985
93a60ee266a202c0b1e94010ce72ba7eb8d068a5,0,Jason Gustafson,2018-08-25 12:08:25-07:00,['e8e3e34c67c45ae76a51758c600ddb4f7e707717'],2,30,32,1641826,2,0.052631579,1,1,3985
ebd1354fd7578deb1cfb15846d7dbf8c9cf26074,1,GitHub,2018-08-27 17:39:44-07:00,['93a60ee266a202c0b1e94010ce72ba7eb8d068a5'],9,171,180,1642006,6,0.185185185,0.604938272,0.802469136,3987
7d2b95895ae53060f5743a5e4b8f06ddc039bf66,0,Guozhang Wang,2018-08-27 18:44:12-07:00,['ebd1354fd7578deb1cfb15846d7dbf8c9cf26074'],0,0,0,1642006,1,,,,3987
70c51633f2f4bdcdc045697c17cbb47c78ed14ad,1,Jason Gustafson,2018-08-28 10:45:00-07:00,['7d2b95895ae53060f5743a5e4b8f06ddc039bf66'],7,103,110,1642116,2,0.169014085,0.971830986,0.957746479,3987
fd5acd73e648a2aab4b970ddf04ad4cace6bad9a,1,Ewen Cheslack-Postava,2018-08-28 12:59:08-07:00,['70c51633f2f4bdcdc045697c17cbb47c78ed14ad'],13,154,167,1642283,6,0.648148148,0.962962963,0.666666667,3987
9e23af3115ddfbf311f6b37c273327b3fa8e9a14,0,Jun Rao,2018-08-28 15:47:07-07:00,['fd5acd73e648a2aab4b970ddf04ad4cace6bad9a'],5,19,24,1642307,2,1,1,1,3987
7cef37cf55353f542db3562157547d26c992e782,1,Rajini Sivaram,2018-08-29 11:16:29+01:00,['9e23af3115ddfbf311f6b37c273327b3fa8e9a14'],13,127,140,1642447,5,0.1,0.6,0.975,3987
c580f08b7775e4431a4a1559ef7239b69708a782,1,Rajini Sivaram,2018-08-29 12:30:39+01:00,['7cef37cf55353f542db3562157547d26c992e782'],12,135,147,1642594,4,0.771084337,0.963855422,1,3987
d76965e38f6a66ab37c14014a2efea7816ab73cb,0,Rajini Sivaram,2018-08-29 15:15:08+01:00,['c580f08b7775e4431a4a1559ef7239b69708a782'],1,3,4,1642598,1,1,1,1,3987
d0fcf12832d9d383a5c76c174119e96e36d94eaf,0,Dong Lin,2018-08-29 08:30:51-07:00,['d76965e38f6a66ab37c14014a2efea7816ab73cb'],2,3,5,1642603,1,,,,3987
34d9ae66281602dad3a70ecd07ca0f2b6237ae8c,0,Guozhang Wang,2018-08-29 09:34:01-07:00,['d0fcf12832d9d383a5c76c174119e96e36d94eaf'],2,25,27,1642630,2,,,,3987
2514a42e84c4e4bad9ac560c09e3d397707436d8,1,Guozhang Wang,2018-08-29 09:34:54-07:00,['34d9ae66281602dad3a70ecd07ca0f2b6237ae8c'],4,27,31,1642661,1,,,,3987
1918f5cb5b5ebbcfb80d19521e2ee7734346a32b,0,Ismael Juma,2018-08-29 16:01:17-07:00,['2514a42e84c4e4bad9ac560c09e3d397707436d8'],1,2,3,1642664,1,0,0,1,3987
5fb2cdb5c7c4941d3261ec92dc80ca65840de495,0,Guozhang Wang,2018-08-29 17:41:58-07:00,['1918f5cb5b5ebbcfb80d19521e2ee7734346a32b'],1,1,2,1642666,1,,,,3987
5651729038406733d7ecd28430b2774473928d29,0,Ismael Juma,2018-08-30 08:19:34-07:00,['5fb2cdb5c7c4941d3261ec92dc80ca65840de495'],0,2,2,1642668,1,,,,3987
d31c9db4afb300aa53e0a663083f2cfd3a31c537,0,Jason Gustafson,2018-08-30 08:49:01-07:00,['5651729038406733d7ecd28430b2774473928d29'],26,3,29,1642697,3,1,1,1,3987
f3a4ebc8f8be12884ff67a63c7ba5ce5c5f67881,1,Jason Gustafson,2018-08-30 17:04:28-07:00,['d31c9db4afb300aa53e0a663083f2cfd3a31c537'],11,172,183,1642880,6,0.091743119,0.944954128,0.844036697,3987
5d1bfa0665ce0850ee76cee152e397c23ac329a7,1,Rajini Sivaram,2018-08-31 12:04:33+01:00,['f3a4ebc8f8be12884ff67a63c7ba5ce5c5f67881'],62,603,665,1643545,20,0.61461794,0.877076412,0.784053156,3989
f6890e78687afbbe09ff34b0a9383b548be77ee6,1,GitHub,2018-08-31 13:10:27-07:00,['5d1bfa0665ce0850ee76cee152e397c23ac329a7'],260,222,482,1644027,7,0,1,0.142857143,3989
d57fe1b053546966e6a867d84ee24dd256bb071a,0,Guozhang Wang,2018-08-31 13:13:42-07:00,['f6890e78687afbbe09ff34b0a9383b548be77ee6'],182,128,310,1644337,5,0.861111111,0,0,3989
4f38c8cd6079100548ca8056c358a2fea57986c2,0,GitHub,2018-08-31 18:40:42-07:00,['d57fe1b053546966e6a867d84ee24dd256bb071a'],7,41,48,1644385,3,0,0.884615385,1,3989
aa7358e8cc0305dd9051fe0d281913247a39264d,0,Guozhang Wang,2018-09-01 09:48:50-07:00,['4f38c8cd6079100548ca8056c358a2fea57986c2'],0,7,7,1644392,3,1,1,1,3989
7299e18369999ba2ff9485c1256410c569e35379,0,Dong Lin,2018-09-01 11:10:03-07:00,['aa7358e8cc0305dd9051fe0d281913247a39264d'],1,1,2,1644394,1,,,,3989
6a1bb547c0c1f8e9f021e89958234f92f8a9014f,0,Rajini Sivaram,2018-09-03 15:21:20+01:00,['7299e18369999ba2ff9485c1256410c569e35379'],1,3,4,1644398,2,,,,3989
cb484666f2474747538585ed3b986aed5b02830d,0,Rajini Sivaram,2018-09-03 16:49:48+01:00,['6a1bb547c0c1f8e9f021e89958234f92f8a9014f'],1,1,2,1644400,1,,,,3989
a8eac1b8149da20c797d42f426178b31032b76a0,0,Dong Lin,2018-09-03 10:21:48-07:00,['cb484666f2474747538585ed3b986aed5b02830d'],1,1,2,1644402,1,,,,3989
62ea10a5c17b6a8d3ebed26cdba813647585dc20,0,Ismael Juma,2018-09-04 05:29:50-07:00,['a8eac1b8149da20c797d42f426178b31032b76a0'],1,1,2,1644404,1,,,,3989
4a46a353482116ed5502737f7809bc6c0d37bf36,1,GitHub,2018-09-04 21:24:06+01:00,['62ea10a5c17b6a8d3ebed26cdba813647585dc20'],14,41,55,1644459,7,0.310344828,1,1,3989
79a608b286fd6271b841d3cc7997bf69227de912,0,Dong Lin,2018-09-04 13:56:05-07:00,['4a46a353482116ed5502737f7809bc6c0d37bf36'],21,76,97,1644556,2,0.565217391,0.152173913,1,3989
847780e5a5f376fa2ce8705f483bfd33b319b83d,0,Ewen Cheslack-Postava,2018-09-05 20:15:25-07:00,['79a608b286fd6271b841d3cc7997bf69227de912'],7,7,14,1644570,3,,,,3989
297fb396a0038addea06a76fd4ab9a451eb7562e,1,Dong Lin,2018-09-07 14:17:49-07:00,['847780e5a5f376fa2ce8705f483bfd33b319b83d'],298,680,978,1645548,19,0.570815451,0.896995708,0.721030043,3990
f348f10ef87925081fdf9455ace6d2a86179b483,1,Jun Rao,2018-09-07 17:40:59-07:00,['297fb396a0038addea06a76fd4ab9a451eb7562e'],91,307,398,1645946,4,0.699346405,0.908496732,1,3990
4106ff6e5a61b76c5f05377df6f31fa8ae50c73b,0,Ismael Juma,2018-09-08 07:43:22-07:00,['f348f10ef87925081fdf9455ace6d2a86179b483'],6,6,12,1645958,5,,,,3990
0984a76b712caa18c688eafbacaa2a7c889d27b2,1,GitHub,2018-09-08 17:00:13-07:00,['4106ff6e5a61b76c5f05377df6f31fa8ae50c73b'],318,615,933,1646891,8,0.417266187,0.884892086,1,3990
958cdca9bece8b65ceb204e1c7a14cf44729bb66,1,Jason Gustafson,2018-09-08 18:01:01-07:00,['0984a76b712caa18c688eafbacaa2a7c889d27b2'],118,229,347,1647238,5,0.644736842,1,1,3990
4a5cba87bcd4621b999f7290d17d88d6859afb84,1,Jason Gustafson,2018-09-09 00:05:49-07:00,['958cdca9bece8b65ceb204e1c7a14cf44729bb66'],7,75,82,1647320,6,0.023255814,0.558139535,0.976744186,3990
05ba5aa00847b18b74369a821e972bbba9f155eb,1,Dong Lin,2018-09-09 00:17:25-07:00,['4a5cba87bcd4621b999f7290d17d88d6859afb84'],1448,2062,3510,1650830,114,0.503937008,1,0.62992126,3991
b8651d4e82d45463d2c71798bd5852f8a605b440,1,Ismael Juma,2018-09-09 14:25:30-07:00,['05ba5aa00847b18b74369a821e972bbba9f155eb'],615,472,1087,1651917,96,1,0.576,0.04,3991
164ef9462e9d18a36f7be856243a1cacf9a300bf,0,Ewen Cheslack-Postava,2018-09-09 17:22:18-07:00,['b8651d4e82d45463d2c71798bd5852f8a605b440'],1,139,140,1652057,4,0.942307692,0.942307692,1,3993
0d535b167aa352dbc94b71d598e1ae2a2201b6d7,0,Guozhang Wang,2018-09-10 09:53:02-07:00,['164ef9462e9d18a36f7be856243a1cacf9a300bf'],6,9,15,1652072,3,,,,3993
f123d2f18c55b1cf2edb452aeb87e6ad0743c292,0,Dong Lin,2018-09-10 13:14:00-07:00,['0d535b167aa352dbc94b71d598e1ae2a2201b6d7'],31,39,70,1652142,7,0,1,0,3993
1427e84cc7935e3826eb91408ca7fa87ff868505,0,Ismael Juma,2018-09-10 17:34:48-07:00,['f123d2f18c55b1cf2edb452aeb87e6ad0743c292'],3,3,6,1652148,1,,,,3993
25b13bca7b696b349bae2e9d5e41b75496bfdb1b,1,Dong Lin,2018-09-10 21:41:14-07:00,['1427e84cc7935e3826eb91408ca7fa87ff868505'],2,57,59,1652207,3,0.947368421,0.947368421,1,3993
257c402c1565eebf421dbd44a272a3dd6c99d609,0,Ismael Juma,2018-09-11 00:00:52-07:00,['25b13bca7b696b349bae2e9d5e41b75496bfdb1b'],6,8,14,1652221,3,1,1,1,3993
79ad9026a667469a2013ce82961c0c90f3bb0877,0,GitHub,2018-09-11 09:08:22-07:00,['257c402c1565eebf421dbd44a272a3dd6c99d609'],10,27,37,1652258,6,0.727272727,0.909090909,1,3993
e2ec2d79c8d5adefc0c764583cec47144dbc5705,1,Jason Gustafson,2018-09-11 10:10:42-07:00,['79ad9026a667469a2013ce82961c0c90f3bb0877'],18,72,90,1652348,4,0.5,1,1,3993
acd3858ea69e676a7840d998240deb32aee62dc0,0,Guozhang Wang,2018-09-11 14:08:42-07:00,['e2ec2d79c8d5adefc0c764583cec47144dbc5705'],36,676,712,1653060,23,1,1,0,4004
283a19481d1ce4a77f5f465e7b96288db22a8ff1,1,GitHub,2018-09-11 16:16:52-07:00,['acd3858ea69e676a7840d998240deb32aee62dc0'],490,663,1153,1654213,24,0,0.531531532,1,4004
9dac615d228c5b3464c6322aea9f9ce70f9ef37b,0,Guozhang Wang,2018-09-11 16:17:47-07:00,['283a19481d1ce4a77f5f465e7b96288db22a8ff1'],11,11,22,1654235,1,,,,4004
68b2f49ea75059df5527378e8ae771195029c98a,1,GitHub,2018-09-11 16:28:52-07:00,['9dac615d228c5b3464c6322aea9f9ce70f9ef37b'],0,31,31,1654266,1,,,,4004
c121f4eb82da654acbdd133a556cfe1f9197a46a,1,Rajini Sivaram,2018-09-12 19:05:19+01:00,['68b2f49ea75059df5527378e8ae771195029c98a'],96,110,206,1654472,15,1,1,1,4004
398d2ab244a40e7f975faa1ed60c0e0b14cf4674,1,Ismael Juma,2018-09-12 21:13:03-07:00,['c121f4eb82da654acbdd133a556cfe1f9197a46a'],39,34,73,1654545,1,1,1,0,4004
f0282498e7a312a977acb127557520def338d45c,1,Ismael Juma,2018-09-12 21:21:46-07:00,['398d2ab244a40e7f975faa1ed60c0e0b14cf4674'],31,25,56,1654601,4,1,1,0.5,4004
ac7cd16e936116ee92ce5f179b671203b3bacf25,1,GitHub,2018-09-12 23:34:41-07:00,['f0282498e7a312a977acb127557520def338d45c'],29,85,114,1654715,4,0.487179487,1,1,4004
df35c22eac2b0d067263378d0d7251fe9b1418a6,0,Ismael Juma,2018-09-13 07:38:53-07:00,['ac7cd16e936116ee92ce5f179b671203b3bacf25'],1,1,2,1654717,1,,,,4004
b18c8dda525a18c1ade7377a408aabd2254bb6d7,0,Guozhang Wang,2018-09-13 08:29:07-07:00,['df35c22eac2b0d067263378d0d7251fe9b1418a6'],27,27,54,1654771,5,,,,4004
466d89306ea23d1f17be0914416944618ceb9f86,1,GitHub,2018-09-13 13:04:09-07:00,['b18c8dda525a18c1ade7377a408aabd2254bb6d7'],306,368,674,1655445,13,0.592592593,0.888888889,1,4004
b74e7e407c0b065adf68bc45042063def922aa10,0,Guozhang Wang,2018-09-13 13:46:47-07:00,['466d89306ea23d1f17be0914416944618ceb9f86'],53,160,213,1655658,10,0,1,1,4005
e24d82e0eb66b62b5d74f2c60b1eb5db9f378673,1,Jason Gustafson,2018-09-14 11:51:46-07:00,['b74e7e407c0b065adf68bc45042063def922aa10'],49,209,258,1655916,2,0.177419355,0.024193548,0.951612903,4005
4e31147a41f03f4ad4c0c8f11414e49d33e60aac,1,Dong Lin,2018-09-16 00:11:05-07:00,['e24d82e0eb66b62b5d74f2c60b1eb5db9f378673'],11,53,64,1655980,1,0,0.9375,0.90625,4005
3a8ab3258f8b461239bc7c0202f81c611745eee9,1,Dong Lin,2018-09-16 00:17:07-07:00,['4e31147a41f03f4ad4c0c8f11414e49d33e60aac'],53,11,64,1656044,1,1,0.0625,0.09375,4005
607dea234f30a0c40d5a48f518a51372e02fa0a0,0,Guozhang Wang,2018-09-17 09:22:36-07:00,['3a8ab3258f8b461239bc7c0202f81c611745eee9'],2,9,11,1656055,1,0,1,1,4005
b21c66f9484a47f549cdfbdf286158fb2d85ee78,1,Dong Lin,2018-09-17 09:35:00-07:00,['607dea234f30a0c40d5a48f518a51372e02fa0a0'],11,59,70,1656125,2,0,0.9375,0.90625,4005
5e72f66ab5c6220098ebbd20957a05a1ed657ab7,0,GitHub,2018-09-17 19:12:46+01:00,['b21c66f9484a47f549cdfbdf286158fb2d85ee78'],1,1,2,1656127,1,,,,4005
c5ef614bbf133e18bd207e22f2697a2d1d3e8e4e,1,GitHub,2018-09-17 12:36:53-07:00,['5e72f66ab5c6220098ebbd20957a05a1ed657ab7'],181,11,192,1656319,5,0.214285714,0.010204082,0.040816327,4005
d87ed233c9e3a8faf2a8032d62ff9b90b0e40bfb,1,Dong Lin,2018-09-17 23:38:01-07:00,['c5ef614bbf133e18bd207e22f2697a2d1d3e8e4e'],48,170,218,1656537,4,0.0875,0.55,0.9875,4005
4bbbfaf39c79fc5dfa7fbc22842717b0fad13503,0,Dong Lin,2018-09-18 01:01:54-07:00,['d87ed233c9e3a8faf2a8032d62ff9b90b0e40bfb'],1,1,2,1656539,1,,,,4005
43e21252cac8eebfbb168cd47d4de18241f8b755,0,Rajini Sivaram,2018-09-18 09:35:59+01:00,['4bbbfaf39c79fc5dfa7fbc22842717b0fad13503'],21,50,71,1656610,3,1,0.277777778,1,4005
88823c6016ea2e306340938994d9e122abf3c6c0,1,GitHub,2018-09-18 14:19:41-07:00,['43e21252cac8eebfbb168cd47d4de18241f8b755'],115,94,209,1656819,9,1,0,1,4005
af80dccc7dfb18c41d17d590a316cb6803294cbb,0,Guozhang Wang,2018-09-19 09:10:15-07:00,['88823c6016ea2e306340938994d9e122abf3c6c0'],14,130,144,1656963,9,1,1,0.870967742,4006
df00f1a738b1fe4cfe1140f5ee966745659c212a,0,Guozhang Wang,2018-09-19 15:05:39-07:00,['af80dccc7dfb18c41d17d590a316cb6803294cbb'],19,4,23,1656986,1,0,0,0,4006
9f187a9a880c603323a258df3450a29329f95d62,0,Guozhang Wang,2018-09-19 15:09:33-07:00,['df00f1a738b1fe4cfe1140f5ee966745659c212a'],1,1,2,1656988,1,,,,4006
7bc1019d4bdf2b9592a7fc3e08659aae7961046b,1,Guozhang Wang,2018-09-20 12:20:03-07:00,['9f187a9a880c603323a258df3450a29329f95d62'],6,33,39,1657027,5,1,1,1,4006
f1f719211e5f28fe5163e65dba899b1da796a8e0,1,Jason Gustafson,2018-09-20 15:55:10-07:00,['7bc1019d4bdf2b9592a7fc3e08659aae7961046b'],88,124,212,1657239,12,1,1,0.647058824,4006
96132e2dbb69a0c6c11cb183bb05cefef4e30557,0,Matthias J. Sax,2018-09-21 11:55:56-07:00,['f1f719211e5f28fe5163e65dba899b1da796a8e0'],8,8,16,1657255,8,,,,4006
0bc7008e7559337b588c60366d1b935eace59ffc,1,Jun Rao,2018-09-21 13:31:45-07:00,['96132e2dbb69a0c6c11cb183bb05cefef4e30557'],12,57,69,1657324,5,1,1,1,4006
6ced8550b3183a71500a66728e9957c19456d4f9,0,Jun Rao,2018-09-21 13:47:26-07:00,['0bc7008e7559337b588c60366d1b935eace59ffc'],8,13,21,1657345,1,0,1,1,4006
95f9622cce2d4a47d59bdfe2dbce6c1cbc2e4573,0,Jason Gustafson,2018-09-21 16:00:05-07:00,['6ced8550b3183a71500a66728e9957c19456d4f9'],10,12,22,1657367,1,,,,4006
86b4d9d58fc990939b654382adde7d86a4f4c24c,0,Guozhang Wang,2018-09-24 09:25:54-07:00,['95f9622cce2d4a47d59bdfe2dbce6c1cbc2e4573'],2,6,8,1657375,1,,,,4006
057c5307e0f055b37794453d16f6f43b8c56528c,1,Guozhang Wang,2018-09-24 13:27:39-07:00,['86b4d9d58fc990939b654382adde7d86a4f4c24c'],20,1944,1964,1659339,21,0.380310881,0.894300518,0.939896373,4022
c835331c7855c4bd60b3eb82b8f284006a1ee9b7,0,Dong Lin,2018-09-24 22:01:00-07:00,['057c5307e0f055b37794453d16f6f43b8c56528c'],4,36,40,1659379,4,0,0,1,4022
81d124440dfeaa421f9ef30e88924fc439f5b7bf,0,GitHub,2018-09-25 01:14:20-07:00,['c835331c7855c4bd60b3eb82b8f284006a1ee9b7'],1,1,2,1659381,1,,,,4022
2933f21374ed383e4db1dfb9c7df02f1707903ba,0,Jason Gustafson,2018-09-25 09:06:30-07:00,['81d124440dfeaa421f9ef30e88924fc439f5b7bf'],4,3,7,1659388,2,,,,4022
f712ce69fc2cb6a164b1ea8e491c9d68e6661933,1,Guozhang Wang,2018-09-25 13:41:22-07:00,['2933f21374ed383e4db1dfb9c7df02f1707903ba'],76,1242,1318,1660706,11,0.136971047,0.922048998,0.986636971,4024
888423ee569d27876468c83243be6dab10a57dc9,1,Rajini Sivaram,2018-09-26 10:08:48+01:00,['f712ce69fc2cb6a164b1ea8e491c9d68e6661933'],8,45,53,1660759,2,0,0.666666667,0.875,4024
5916db11f65482fd226450a2b8da407a3397e8e9,1,Rajini Sivaram,2018-09-26 10:20:11+01:00,['888423ee569d27876468c83243be6dab10a57dc9'],1,1,2,1660761,1,,,,4024
9f7267dd2fedde86bf15aabdbc5256e5fc617184,1,Rajini Sivaram,2018-09-26 14:25:55+01:00,['5916db11f65482fd226450a2b8da407a3397e8e9'],183,290,473,1661234,10,0.297029703,0.841584158,1,4025
70d90c371833b09cf934c8c2358171433892a085,1,Jason Gustafson,2018-09-27 22:39:44-07:00,['9f7267dd2fedde86bf15aabdbc5256e5fc617184'],6,40,46,1661280,6,0,0.875,0.875,4025
0a8205cb45667fd7d001f21e4e0412220b1abec1,1,GitHub,2018-09-28 21:07:57+01:00,['70d90c371833b09cf934c8c2358171433892a085'],0,15,15,1661295,2,1,1,0.833333333,4025
e7b6d65713857e55453e4558957fbd3c7a68ea04,0,Guozhang Wang,2018-09-28 14:41:50-07:00,['0a8205cb45667fd7d001f21e4e0412220b1abec1'],2,3,5,1661300,2,,,,4025
cb21bca400359e6b7e61555578b7539f27d9d2ff,1,Ismael Juma,2018-09-28 23:09:10-07:00,['e7b6d65713857e55453e4558957fbd3c7a68ea04'],7,17,24,1661324,3,0.142857143,0.142857143,1,4025
22f1724123c267352116c18db1abdee25c31b382,0,Ewen Cheslack-Postava,2018-09-29 10:19:10-07:00,['cb21bca400359e6b7e61555578b7539f27d9d2ff'],1,35,36,1661360,2,0.148148148,1,1,4025
69709d70fc2385516d4e07c0ec4a3e481a6e8d79,0,Dong Lin,2018-09-29 22:29:57-07:00,['22f1724123c267352116c18db1abdee25c31b382'],12,12,24,1661384,2,,,,4025
08dfab06e7919dfe625431b1978a3754b72d46a2,0,GitHub,2018-09-30 12:01:11-07:00,['69709d70fc2385516d4e07c0ec4a3e481a6e8d79'],1,10,11,1661395,2,,,,4025
eb61df642d8227fb7eaa1099ec055145b02e3dca,1,Guozhang Wang,2018-09-30 16:04:28-07:00,['08dfab06e7919dfe625431b1978a3754b72d46a2'],154,279,433,1661828,15,0.197530864,1,1,4027
49b5206a82d0a47e01f4c5f7098119440061a1bb,0,Matthias J. Sax,2018-09-30 16:52:55-07:00,['eb61df642d8227fb7eaa1099ec055145b02e3dca'],11,43,54,1661882,3,,,1,4028
b35e97125f291aa7dca22b8d897f9ab4b196fd37,0,Ismael Juma,2018-09-30 19:13:28-07:00,['49b5206a82d0a47e01f4c5f7098119440061a1bb'],4,4,8,1661890,1,,,,4028
c1457be99555063b774db61f526fd0c059721c69,1,Ewen Cheslack-Postava,2018-09-30 19:51:59-07:00,['b35e97125f291aa7dca22b8d897f9ab4b196fd37'],1,1,2,1661892,1,,,,4028
fd44dc7fb210614349a873cdd82087ef5677f583,1,Ewen Cheslack-Postava,2018-09-30 22:24:09-07:00,['c1457be99555063b774db61f526fd0c059721c69'],23,83,106,1661998,3,0.275,0.925,0.15,4028
d568f73fc6ece3d29989413174eee0195d3d0a4a,1,Matthias J. Sax,2018-10-01 16:24:12-07:00,['fd44dc7fb210614349a873cdd82087ef5677f583'],406,594,1000,1662998,20,0.129032258,0.427419355,1,4028
dff1a3799c1c25b1b0009be6835f2c9c78cb5900,1,Matthias J. Sax,2018-10-01 23:09:12-07:00,['d568f73fc6ece3d29989413174eee0195d3d0a4a'],143,1170,1313,1664311,18,0.689759036,0.996987952,0.93373494,4031
5ba9cade7b066cc26842aeaac5662a57c502ffcb,1,Matthias J. Sax,2018-10-01 23:10:34-07:00,['dff1a3799c1c25b1b0009be6835f2c9c78cb5900'],232,880,1112,1665423,27,0.358543417,0.952380952,0.932773109,4037
8fb5e63aa88019216e95fdbe0b6874c723b64bb4,1,Colin Patrick McCabe,2018-10-02 12:57:31-07:00,['5ba9cade7b066cc26842aeaac5662a57c502ffcb'],11,141,152,1665575,5,0.430232558,0.848837209,0.837209302,4037
2a0abe55f0b13ef0e9d136551e29a8fae137c3b7,0,Matthias J. Sax,2018-10-02 15:44:33-07:00,['8fb5e63aa88019216e95fdbe0b6874c723b64bb4'],30,30,60,1665635,4,,,,4037
044350f28e4d0edcc0503b2bc2593c0d25948ed0,1,Dong Lin,2018-10-03 05:24:51-07:00,['2a0abe55f0b13ef0e9d136551e29a8fae137c3b7'],9,16,25,1665660,3,,,,4037
09f3205e44a0b1251e88edb73faa04b0c73521a2,0,Colin Patrick McCabe,2018-10-03 08:56:44-07:00,['044350f28e4d0edcc0503b2bc2593c0d25948ed0'],1,1,2,1665662,1,,,,4037
b793eaade4fcb0705ab80c2a806331fab8c29f9f,1,Guozhang Wang,2018-10-03 09:52:13-07:00,['09f3205e44a0b1251e88edb73faa04b0c73521a2'],485,927,1412,1667074,10,0.640926641,0.996138996,0.71042471,4039
a5335e7cbd1e53790b4bb5e95b6f9027e17fbf2b,1,Colin Patrick McCabe,2018-10-03 09:56:22-07:00,['b793eaade4fcb0705ab80c2a806331fab8c29f9f'],5,51,56,1667130,8,0.818181818,0.939393939,0.848484848,4039
7bd8ada8e21cd9717eea6916a5a55274a49fdeda,1,GitHub,2018-10-03 11:20:47-07:00,['a5335e7cbd1e53790b4bb5e95b6f9027e17fbf2b'],1,15,16,1667146,2,,,,4039
87879d51521d5574cbbf37dd97c83b7e4fc00dae,1,Guozhang Wang,2018-10-03 18:05:41-07:00,['7bd8ada8e21cd9717eea6916a5a55274a49fdeda'],63,329,392,1667538,10,0.758241758,0.978021978,0.978021978,4040
862e09f994e329a4f56f597ab002db9946fa9523,1,Guozhang Wang,2018-10-03 18:27:15-07:00,['87879d51521d5574cbbf37dd97c83b7e4fc00dae'],23,178,201,1667739,4,,,,4040
260b07a6da070e6312443fb7cc6b937bef2865ea,0,Dong Lin,2018-10-04 09:15:11-07:00,['862e09f994e329a4f56f597ab002db9946fa9523'],2,21,23,1667762,2,0,0.933333333,1,4040
ca641b3e2e48c14ff308181c775775408f5f35f7,1,Matthias J. Sax,2018-10-04 13:51:39-07:00,['260b07a6da070e6312443fb7cc6b937bef2865ea'],536,1311,1847,1669609,100,0.995614035,1,0.451754386,4041
f2dd6aa2698345fd0b0348f7bc74ce3215adf682,1,GitHub,2018-10-04 14:02:23-07:00,['ca641b3e2e48c14ff308181c775775408f5f35f7'],478,444,922,1670531,17,0,0.262295082,0,4041
7ea0655711a664296cddb656364d367c66ed277c,0,Dong Lin,2018-10-04 17:02:27-07:00,['f2dd6aa2698345fd0b0348f7bc74ce3215adf682'],39,110,149,1670680,3,0.871794872,0.41025641,0.871794872,4041
2b37a041d3c7048a4b95b65197c278df7f51a521,0,Dong Lin,2018-10-04 17:30:03-07:00,['7ea0655711a664296cddb656364d367c66ed277c'],7,7,14,1670694,7,,,,4041
d76805f0fd2d65e9fb5582e4e0d30c1bd3fccd89,0,Guozhang Wang,2018-10-04 17:37:53-07:00,['2b37a041d3c7048a4b95b65197c278df7f51a521'],114,125,239,1670933,6,0,1,0,4041
3edd8e7333ec0bb32ab5ae4ec4814fe30bb8f91d,0,Ewen Cheslack-Postava,2018-10-04 20:34:50-07:00,['d76805f0fd2d65e9fb5582e4e0d30c1bd3fccd89'],1,12,13,1670946,2,0,1,1,4041
1bc620d1af50d24b4d5f12147e425bb7cb7f19bf,0,Guozhang Wang,2018-10-05 09:44:49-07:00,['3edd8e7333ec0bb32ab5ae4ec4814fe30bb8f91d'],112,55,167,1671113,6,0.152173913,0,0,4041
50ec82940d4af61f12300235b7553bd5cf231894,0,Ewen Cheslack-Postava,2018-10-05 10:21:25-07:00,['1bc620d1af50d24b4d5f12147e425bb7cb7f19bf'],4,15,19,1671132,4,,,,4041
62f9b64f11a08bbacb6d5a0585e3285add1590cf,0,GitHub,2018-10-05 11:31:05-07:00,['50ec82940d4af61f12300235b7553bd5cf231894'],1,2,3,1671135,1,,,,4041
089d1b154fff1536fe7953ffe157a203b4a24455,0,Ismael Juma,2018-10-05 11:45:50-07:00,['62f9b64f11a08bbacb6d5a0585e3285add1590cf'],8,36,44,1671179,3,0,0.714285714,0.714285714,4041
79757c90df8ee8390aa256998ce5cd1394d8822a,1,Jason Gustafson,2018-10-05 11:58:59-07:00,['089d1b154fff1536fe7953ffe157a203b4a24455'],34,212,246,1671425,9,0.072992701,0.934306569,0.905109489,4041
6a03d3b42cde89c921777d100c9107407f206de4,0,Jason Gustafson,2018-10-05 12:46:13-07:00,['79757c90df8ee8390aa256998ce5cd1394d8822a'],1,5,6,1671431,1,,,,4041
ed3bd79633ae227ad995dafc3d9f384a5534d4e9,1,GitHub,2018-10-05 13:25:08-07:00,['6a03d3b42cde89c921777d100c9107407f206de4'],1129,2497,3626,1675057,60,0.421496312,0.897787144,0.858798736,4045
5e9208fc0546ab768e6711ec927589589ff270ac,0,GitHub,2018-10-05 13:38:33-07:00,['ed3bd79633ae227ad995dafc3d9f384a5534d4e9'],3,6,9,1675066,1,0,1,1,4045
eb8b1c027a610fdf514bcb352613cca2919ed35c,0,Matthias J. Sax,2018-10-05 14:12:12-07:00,['5e9208fc0546ab768e6711ec927589589ff270ac'],2,10,12,1675078,2,,,,4045
02a9579373e7bbce27fe545a0e35fd3f80998c4e,0,Ismael Juma,2018-10-06 10:36:02-07:00,['eb8b1c027a610fdf514bcb352613cca2919ed35c'],2,2,4,1675082,2,,,,4045
c26823b01e61f301bc2fbd3fe54665e5b92284d1,0,GitHub,2018-10-08 10:14:25+01:00,['02a9579373e7bbce27fe545a0e35fd3f80998c4e'],35,119,154,1675236,4,0,0.267857143,1,4045
13379af17d95788568038c0c6daeb983819669e3,1,Jun Rao,2018-10-08 12:54:37-07:00,['c26823b01e61f301bc2fbd3fe54665e5b92284d1'],397,799,1196,1676432,11,0.295454545,0.881818182,0.759090909,4047
6165b43744bf9df9d4bda577f11db75b704a6ac5,0,Dong Lin,2018-10-08 14:07:56-07:00,['13379af17d95788568038c0c6daeb983819669e3'],1,3,4,1676436,1,0,0,1,4047
04f284400a33acae2eff1a615d48236dd313b531,0,Rajini Sivaram,2018-10-08 22:23:55+01:00,['6165b43744bf9df9d4bda577f11db75b704a6ac5'],13,11,24,1676460,1,1,0.5,0,4047
f44860faee8fdd7ea870ebbfa14847e0ea46507e,0,Matthias J. Sax,2018-10-08 14:55:44-07:00,['04f284400a33acae2eff1a615d48236dd313b531'],2,2,4,1676464,1,,,,4047
87bf5c36504d5f5353d98994d5c31d033bea00b8,0,Matthias J. Sax,2018-10-09 09:58:12-07:00,['f44860faee8fdd7ea870ebbfa14847e0ea46507e'],0,1,1,1676465,1,,,,4047
0848b78881afce5899cea1f10c323249f9f0b8cc,1,Jun Rao,2018-10-09 10:37:54-07:00,['87bf5c36504d5f5353d98994d5c31d033bea00b8'],28,68,96,1676561,6,0.909090909,1,1,4047
6d16879c0ffc4b52a544a8664329d09101832964,1,Matthias J. Sax,2018-10-09 11:37:08-07:00,['0848b78881afce5899cea1f10c323249f9f0b8cc'],12,55,67,1676628,2,1,1,1,4047
15dbab0e35063714b7bbea58176d1627878c15c3,0,Jun Rao,2018-10-09 11:52:56-07:00,['6d16879c0ffc4b52a544a8664329d09101832964'],4,4,8,1676636,1,,,,4047
4be79b6ceef8310ef8ab78f274f889ced3ab2532,0,Matthias J. Sax,2018-10-09 13:16:49-07:00,['15dbab0e35063714b7bbea58176d1627878c15c3'],17,12,29,1676665,1,1,1,1,4047
9a74569b994681a7b672ccb22a2e359ab8f7ed0b,0,Guozhang Wang,2018-10-09 15:29:04-07:00,['4be79b6ceef8310ef8ab78f274f889ced3ab2532'],16,65,81,1676746,6,0.290322581,1,0.741935484,4047
578205cadd0bf64d671c6c162229c4975081a9d6,1,Dong Lin,2018-10-09 15:55:09-07:00,['9a74569b994681a7b672ccb22a2e359ab8f7ed0b'],599,537,1136,1677882,22,1,0.464285714,0,4047
741cb761c5239297029a446518c332f6c4ed08f6,1,Jason Gustafson,2018-10-09 17:13:33-07:00,['578205cadd0bf64d671c6c162229c4975081a9d6'],86,610,696,1678578,38,0.084291188,0.689655172,0.969348659,4048
349b5ad56c9348a8aecbf9b7fad8eeb910e6e88f,0,GitHub,2018-10-10 12:09:09-07:00,['741cb761c5239297029a446518c332f6c4ed08f6'],1,11,12,1678590,2,,,,4048
34f029e3dc30d8a7b0f1f1ec639d16a4e1fb4cbf,0,Ismael Juma,2018-10-10 13:18:00-07:00,['349b5ad56c9348a8aecbf9b7fad8eeb910e6e88f'],6,6,12,1678602,2,,,,4048
adb3a950ee2d5843673cdf14d5471ded5c0419b2,0,GitHub,2018-10-10 13:31:06-07:00,['34f029e3dc30d8a7b0f1f1ec639d16a4e1fb4cbf'],54,41,95,1678697,4,0,,,4048
b63cd6370f53fe8e1e2201c29b03a3e75dbd3db8,0,Jason Gustafson,2018-10-10 15:16:54-07:00,['adb3a950ee2d5843673cdf14d5471ded5c0419b2'],5,6,11,1678708,1,,,,4048
8d52b7ee0bf67100fa151fef87a2d0a26a915cbf,0,GitHub,2018-10-10 17:22:28-07:00,['b63cd6370f53fe8e1e2201c29b03a3e75dbd3db8'],7,6,13,1678721,1,0,0,0,4048
905f8135078127e08633400277c5829b10971d42,0,Matthias J. Sax,2018-10-10 19:08:21-07:00,['8d52b7ee0bf67100fa151fef87a2d0a26a915cbf'],98,24,122,1678843,5,0,0,0.705882353,4048
79bc0dcf7059fb65bab466a662f6f969e359d7bd,1,Rajini Sivaram,2018-10-11 12:20:19+01:00,['905f8135078127e08633400277c5829b10971d42'],10,44,54,1678897,4,0.181818182,0.954545455,0.772727273,4048
f393b2f7dd477c3a43e70631f7036a211bf5d740,1,Rajini Sivaram,2018-10-11 18:14:17+01:00,['79bc0dcf7059fb65bab466a662f6f969e359d7bd'],34,289,323,1679220,25,0.67768595,0.991735537,0.79338843,4049
21f88a595b5785d8b9b9a17a3fb667b1712f3b61,1,Guozhang Wang,2018-10-12 09:12:51-07:00,['f393b2f7dd477c3a43e70631f7036a211bf5d740'],120,248,368,1679588,10,0.202531646,0.949367089,0.227848101,4049
aaf8e0240355d77777eb3828583f61af14dc3c3b,0,GitHub,2018-10-12 10:11:54-07:00,['21f88a595b5785d8b9b9a17a3fb667b1712f3b61'],5,6,11,1679599,2,,,,4049
6f5e37347f87936befb5c448bb9b95b6ba1025fc,0,GitHub,2018-10-12 21:36:10+01:00,['aaf8e0240355d77777eb3828583f61af14dc3c3b'],1,1,2,1679601,1,,,,4049
6a3382c9d397619a7f27766fd28aff41d85ed4ff,1,GitHub,2018-10-12 14:48:28-07:00,['6f5e37347f87936befb5c448bb9b95b6ba1025fc'],34,37,71,1679672,2,,,,4049
a947fe8da8646058335ff76b9a744462a3337a63,0,Rajini Sivaram,2018-10-13 21:39:35+01:00,['6a3382c9d397619a7f27766fd28aff41d85ed4ff'],88,158,246,1679918,25,0.4,0.577777778,0.844444444,4049
2d77746a7beeb96d04ff3a907cde78f126cf6e85,0,GitHub,2018-10-13 22:39:24-07:00,['a947fe8da8646058335ff76b9a744462a3337a63'],18,34,52,1679970,1,0.4,0.4,0.4,4049
148b5be74b7addde6d5a0c0f8f6011f3f27647ba,0,GitHub,2018-10-15 08:59:20+01:00,['2d77746a7beeb96d04ff3a907cde78f126cf6e85'],4,10,14,1679984,1,1,1,1,4049
4c602e6130e869abbd111d5d4efe1c2046935c6c,1,GitHub,2018-10-15 13:21:15+01:00,['148b5be74b7addde6d5a0c0f8f6011f3f27647ba'],35,68,103,1680087,8,0.95,0.95,1,4049
0b417b8331e44c64011ea0b48ac66d5fa8005e0f,1,GitHub,2018-10-15 17:22:03-07:00,['4c602e6130e869abbd111d5d4efe1c2046935c6c'],46,68,114,1680201,5,,,,4049
f047e1c17847518c7d9ce24ff8cb02f80ea2f824,0,Guozhang Wang,2018-10-15 17:47:20-07:00,['0b417b8331e44c64011ea0b48ac66d5fa8005e0f'],5,9,14,1680215,2,1,1,1,4049
763b72c9a58ba90e93b3bd948c420f6a894682d2,0,Matthias J. Sax,2018-10-15 18:55:39-07:00,['f047e1c17847518c7d9ce24ff8cb02f80ea2f824'],0,10,10,1680225,2,,,,4049
8182c4fc7d928598a5d50f8f87407e66bf384b2f,0,Matthias J. Sax,2018-10-15 19:01:21-07:00,['763b72c9a58ba90e93b3bd948c420f6a894682d2'],15,28,43,1680268,3,,,,4049
5681309094b114c65018c6951f23eca88c329e03,0,Colin Patrick McCabe,2018-10-15 20:14:17-07:00,['8182c4fc7d928598a5d50f8f87407e66bf384b2f'],2,69,71,1680339,2,0.531914894,1,1,4049
2646781d3265c8269f35d39c199dfddf14d3c2a8,0,GitHub,2018-10-15 20:56:30-07:00,['5681309094b114c65018c6951f23eca88c329e03'],59,25,84,1680423,3,0,0,0.6,4049
4b7148a5b66d2207c4c6ef1d2729ce32ec6f8bcf,1,Matthias J. Sax,2018-10-15 21:04:01-07:00,['2646781d3265c8269f35d39c199dfddf14d3c2a8'],5,128,133,1680556,4,,,,4049
90d0fd51d1e73d1bb93ba304c72972a515908a40,0,Guozhang Wang,2018-10-15 21:26:18-07:00,['4b7148a5b66d2207c4c6ef1d2729ce32ec6f8bcf'],2,14,16,1680572,1,,,,4049
509dd95ebbf03681ea680a84b8436814ba3e7541,0,Rajini Sivaram,2018-10-16 12:07:49+01:00,['90d0fd51d1e73d1bb93ba304c72972a515908a40'],0,14,14,1680586,2,0,1,1,4049
86b1150e18d3fe0a0e3019e034e2a6f0204f7a17,0,Guozhang Wang,2018-10-16 07:24:50-07:00,['509dd95ebbf03681ea680a84b8436814ba3e7541'],52,150,202,1680788,12,0,1,1,4049
9951f8fee145ce10b5dccde665e160a5f4ff6d03,1,GitHub,2018-10-16 17:15:21+01:00,['86b1150e18d3fe0a0e3019e034e2a6f0204f7a17'],11,4,15,1680803,3,1,0,1,4049
eae5ae3b047b776fa144064b45cf7a6a62e285c6,0,Ewen Cheslack-Postava,2018-10-17 11:03:16-07:00,['9951f8fee145ce10b5dccde665e160a5f4ff6d03'],30,13,43,1680846,5,0.076923077,0,0,4049
1e92b703063433bb6855f9fad8d171dce43080b3,1,Manikumar Reddy,2018-10-18 15:53:49+05:18,['eae5ae3b047b776fa144064b45cf7a6a62e285c6'],71,58,129,1680975,9,0.5,1,1,4049
53d0674662f965f12bdbf2720a076de687f5be70,1,GitHub,2018-10-18 15:08:42+01:00,['1e92b703063433bb6855f9fad8d171dce43080b3'],19,33,52,1681027,1,0,0.625,1,4049
3f7e4fb8ac70740aff433bf2cb1dd2cda1c43ce1,0,Dong Lin,2018-10-18 11:13:38-07:00,['53d0674662f965f12bdbf2720a076de687f5be70'],0,4,4,1681031,1,,,,4049
928f45f61f793f0b2d7df11ff92463d7edda60d6,1,Dong Lin,2018-10-18 11:25:03-07:00,['3f7e4fb8ac70740aff433bf2cb1dd2cda1c43ce1'],3,54,57,1681088,2,0.135135135,1,1,4049
9e088eb120a5c4950e8107e08875fdb4e12f4bef,1,Ismael Juma,2018-10-20 09:40:41-07:00,['928f45f61f793f0b2d7df11ff92463d7edda60d6'],6,3,9,1681097,1,1,1,0,4049
74f686d3c24d06c977341cee7294f36e02cbc366,1,Ismael Juma,2018-10-20 17:40:44-07:00,['9e088eb120a5c4950e8107e08875fdb4e12f4bef'],7,10,17,1681114,1,0.5,1,1,4049
83c39969745dc7076e3756439f6842e7431a8c55,0,Ewen Cheslack-Postava,2018-10-20 19:40:53-07:00,['74f686d3c24d06c977341cee7294f36e02cbc366'],25,25,50,1681164,9,,,,4049
83e98334a94ce2071a3294a8b310f1d646127f1c,0,Ewen Cheslack-Postava,2018-10-20 20:43:22-07:00,['83c39969745dc7076e3756439f6842e7431a8c55'],8,133,141,1681305,1,0.13559322,0.13559322,1,4049
fed27fdd75e3f7994b87a035f4984d77b8f4411b,1,Ismael Juma,2018-10-22 01:36:24-07:00,['83e98334a94ce2071a3294a8b310f1d646127f1c'],6,42,48,1681353,3,0.125,1,1,4049
ed94cf4d314d1fea63fa4972e5aec73d35cd6813,1,Ismael Juma,2018-10-22 05:14:32-07:00,['fed27fdd75e3f7994b87a035f4984d77b8f4411b'],40,36,76,1681429,2,1,1,0,4049
e9bbfde10f1d73e500063817ada7a9ad474bca3f,1,Matthias J. Sax,2018-10-22 17:21:19-07:00,['ed94cf4d314d1fea63fa4972e5aec73d35cd6813'],12,16,28,1681457,6,1,1,1,4049
ff3c4e22b8a53a1f344c96d5a20b6852d31e765f,0,GitHub,2018-10-23 16:47:06-07:00,['e9bbfde10f1d73e500063817ada7a9ad474bca3f'],3,3,6,1681463,1,,,,4049
cb6d69cbee42d26006c62abb6ae6cea50b346fb9,1,Matthias J. Sax,2018-10-23 22:21:37-07:00,['ff3c4e22b8a53a1f344c96d5a20b6852d31e765f'],5,48,53,1681516,2,1,1,1,4050
8b1d705404cf52b508874c7ae0ab1d86cab83bfc,0,Ewen Cheslack-Postava,2018-10-24 13:16:34-07:00,['cb6d69cbee42d26006c62abb6ae6cea50b346fb9'],1,1,2,1681518,1,,,,4050
d2c870b468c1b84fb372ef7d9681efe84783c3b8,0,Ismael Juma,2018-10-24 13:22:02-07:00,['8b1d705404cf52b508874c7ae0ab1d86cab83bfc'],1,1,2,1681520,1,,,,4050
32e1da570a8aa2ac87d9b5ab1cda1e3cdb867874,1,Manikumar Reddy,2018-10-25 16:58:14+05:18,['d2c870b468c1b84fb372ef7d9681efe84783c3b8'],20,437,457,1681977,13,0.493273543,0.704035874,0.950672646,4052
73da59191606fe9c03ef6e1b978549bc1d9ee81e,0,Dong Lin,2018-10-25 08:22:31-07:00,['32e1da570a8aa2ac87d9b5ab1cda1e3cdb867874'],4,47,51,1682028,4,0.405405405,1,1,4052
262bb006d58f96e3e24cab552506561310ebfb5d,0,Dong Lin,2018-10-25 09:43:39-07:00,['73da59191606fe9c03ef6e1b978549bc1d9ee81e'],0,4,4,1682032,1,,,,4052
b403a09ec0d78a352411414aaac0663885f777c0,1,Dong Lin,2018-10-25 16:26:55-07:00,['262bb006d58f96e3e24cab552506561310ebfb5d'],72,85,157,1682189,2,1,0.777777778,0.888888889,4052
29a2921a3a93800f7cc1fcf97118e512961f8beb,0,Dong Lin,2018-10-25 16:29:12-07:00,['b403a09ec0d78a352411414aaac0663885f777c0'],2,1,3,1682192,1,0,0,0,4052
eda4a2904a863b04f6ea511a4cf1e2bd4806ad35,0,Ismael Juma,2018-10-26 06:48:31-07:00,['29a2921a3a93800f7cc1fcf97118e512961f8beb'],1,2,3,1682195,1,1,1,1,4052
51061792ca6120eeffe9845826962b49dc7939a1,0,GitHub,2018-10-26 12:18:50-07:00,['eda4a2904a863b04f6ea511a4cf1e2bd4806ad35'],3,0,3,1682198,1,0,0,0,4052
e8a3bc74254a8e4e4aaca41395177fa4a98b480c,1,Rajini Sivaram,2018-10-26 23:18:15+01:00,['51061792ca6120eeffe9845826962b49dc7939a1'],222,1937,2159,1684357,52,0.468965517,0.706896552,0.808045977,4054
57502a6995d3e086e2d9019405c949bbbdc29b8c,1,Matthias J. Sax,2018-10-26 16:00:33-07:00,['e8a3bc74254a8e4e4aaca41395177fa4a98b480c'],4,28,32,1684389,2,1,1,1,4054
c9d3debfe44fb09fa1740c645883717e669f0117,1,Ismael Juma,2018-10-27 09:22:02-07:00,['57502a6995d3e086e2d9019405c949bbbdc29b8c'],28,6,34,1684423,1,1,0,0,4054
ccfcbfd13f6f072e8d5b00b52525ac1184a30421,0,Ismael Juma,2018-10-27 12:30:06-07:00,['c9d3debfe44fb09fa1740c645883717e669f0117'],3,3,6,1684429,2,,,,4054
7cdc433d119bc734d0ad2ea01ff2c21b11944fe6,0,Ismael Juma,2018-10-27 19:01:59-07:00,['ccfcbfd13f6f072e8d5b00b52525ac1184a30421'],1,3,4,1684433,1,1,1,1,4054
63715efa02861b25b3be84c2970342aebec7a439,1,Matthias J. Sax,2018-10-27 20:07:40-07:00,['7cdc433d119bc734d0ad2ea01ff2c21b11944fe6'],3,3,6,1684439,2,,,,4054
5d7cb438a5607fd1bba35ee7a7cf1b2924bae45d,0,Ismael Juma,2018-10-27 21:45:59-07:00,['63715efa02861b25b3be84c2970342aebec7a439'],6,4,10,1684449,1,1,0.5,0.5,4054
4fd5fe2af3d0ebcfade232d322a007428c9decff,0,Manikumar Reddy,2018-10-28 11:47:08+05:18,['5d7cb438a5607fd1bba35ee7a7cf1b2924bae45d'],1,1,2,1684451,1,,,,4054
b4722cc16f285e8835c0733b9ec5cdc492f16874,1,GitHub,2018-10-28 11:31:39-07:00,['4fd5fe2af3d0ebcfade232d322a007428c9decff'],35,35,70,1684521,10,,,,4054
eede70a805cd9bea55734d79f5d324f2631e4547,1,Ismael Juma,2018-10-28 22:12:42-07:00,['b4722cc16f285e8835c0733b9ec5cdc492f16874'],4,4,8,1684529,2,,,,4054
9a0ea25fee85837748145d37c69cf4d9bb7f9933,1,Ismael Juma,2018-10-29 06:37:23-07:00,['eede70a805cd9bea55734d79f5d324f2631e4547'],81,71,152,1684681,32,0,0,0,4054
d28c5348197256db09b59d1ebbfe7db9d3934f47,0,Colin Patrick McCabe,2018-10-29 10:51:07-07:00,['9a0ea25fee85837748145d37c69cf4d9bb7f9933'],47,459,506,1685187,10,0.557077626,0.894977169,0.726027397,4057
d71cb54672e63d2f0f4b999668336642a9a63a1d,1,GitHub,2018-10-30 13:20:13-07:00,['d28c5348197256db09b59d1ebbfe7db9d3934f47'],757,726,1483,1686670,31,1,0.146666667,0.56,4057
fc1eea127a6aec66284f917cc8fd776b196adf6c,0,Ismael Juma,2018-10-31 06:47:19-07:00,['d71cb54672e63d2f0f4b999668336642a9a63a1d'],2,2,4,1686674,1,,,,4057
8065a0bef41b6f3d0f8b0fcc01a008d7916ac5c6,1,GitHub,2018-10-31 15:51:02-07:00,['fc1eea127a6aec66284f917cc8fd776b196adf6c'],228,169,397,1687071,4,1,0.016393443,0,4057
b2c67e4b9a01a1183cefa913da006c3e0d99387b,0,GitHub,2018-11-01 10:29:59+05:18,['8065a0bef41b6f3d0f8b0fcc01a008d7916ac5c6'],7,9,16,1687087,1,0,1,1,4057
fc1dc358ee9b956e062b0966e1ed1fef40ab43d8,1,GitHub,2018-11-01 14:34:28-07:00,['b2c67e4b9a01a1183cefa913da006c3e0d99387b'],55,264,319,1687406,13,0.54,0.826666667,0.793333333,4057
ea518e4d6734608de84cf9d0ee31342e2e6c7f3c,0,Ismael Juma,2018-11-03 10:06:17-07:00,['fc1dc358ee9b956e062b0966e1ed1fef40ab43d8'],1,1,2,1687408,1,,,,4057
872df553fc03557d87dc43f4762641da9f874c2e,0,Colin Patrick McCabe,2018-11-05 11:22:56-08:00,['ea518e4d6734608de84cf9d0ee31342e2e6c7f3c'],1,3,4,1687412,1,0,1,1,4057
f856082cb8370941a8dc1efc9a383c6167db12ad,1,Ismael Juma,2018-11-05 22:39:12-08:00,['872df553fc03557d87dc43f4762641da9f874c2e'],1,1,2,1687414,1,,,,4057
6f83d051315e120d148a53e3deba6541d3bb9857,1,Dong Lin,2018-11-06 11:40:39-08:00,['f856082cb8370941a8dc1efc9a383c6167db12ad'],5,68,73,1687487,4,0.05,0,1,4058
1c5aec6e9d1df4c3552b8de783845f07bc482a84,1,Jason Gustafson,2018-11-06 13:41:19-08:00,['6f83d051315e120d148a53e3deba6541d3bb9857'],8,10,18,1687505,1,1,0.5,0,4058
63889b36e5301f63b7712540f99ef4132d2ac5ef,0,Dong Lin,2018-11-06 13:56:33-08:00,['1c5aec6e9d1df4c3552b8de783845f07bc482a84'],0,41,41,1687546,1,,,,4058
7b5ffa0a070065e5e8320f481bbd8a3a26378f91,0,Jun Rao,2018-11-06 15:28:53-08:00,['63889b36e5301f63b7712540f99ef4132d2ac5ef'],35,90,125,1687671,4,0,0.904761905,1,4058
df0faee09787ec4d14a1a5da98fe9bf4cd7f461c,1,Ewen Cheslack-Postava,2018-11-07 08:04:29-08:00,['7b5ffa0a070065e5e8320f481bbd8a3a26378f91'],18,38,56,1687727,2,0,1,1,4058
8abbf33b5978b93354ae35c5e21c474816c9cc76,1,Ewen Cheslack-Postava,2018-11-07 08:23:19-08:00,['df0faee09787ec4d14a1a5da98fe9bf4cd7f461c'],145,130,275,1688002,17,1,0,0,4058
29383d6d6a3d42d30e815fbbb084275d449928c8,0,Rajini Sivaram,2018-11-08 13:37:05+00:00,['8abbf33b5978b93354ae35c5e21c474816c9cc76'],5,5,10,1688012,1,,,,4058
eb3335ef592a3dd22895a5bb499a2d0b232227a7,1,Jun Rao,2018-11-08 13:28:37-08:00,['29383d6d6a3d42d30e815fbbb084275d449928c8'],7,141,148,1688160,2,0.574468085,0.936170213,0.861702128,4058
895c83f88d351ac1f86e5df13af23423e162b774,0,Jun Rao,2018-11-08 16:58:14-08:00,['eb3335ef592a3dd22895a5bb499a2d0b232227a7'],7,8,15,1688175,2,,,,4058
ecb71cf4719e6d22d6738f8df2fd9e16dad33295,0,Colin Patrick McCabe,2018-11-09 10:31:04-08:00,['895c83f88d351ac1f86e5df13af23423e162b774'],1,152,153,1688328,7,0.441558442,0.805194805,1,4059
af2e6fb548cf3b5778455a7b5791bbebe3b74b44,1,GitHub,2018-11-10 13:58:18-08:00,['ecb71cf4719e6d22d6738f8df2fd9e16dad33295'],250,251,501,1688829,37,,,,4059
3eaf44ba8ea26a7a820894390e8877d404ddd5a2,1,Jun Rao,2018-11-12 09:02:44-08:00,['af2e6fb548cf3b5778455a7b5791bbebe3b74b44'],23,66,89,1688918,2,0.727272727,0.939393939,1,4059
1c1e5ee97959d1841c9190deb0de2f18d55a4030,0,Ismael Juma,2018-11-12 11:17:55-08:00,['3eaf44ba8ea26a7a820894390e8877d404ddd5a2'],15,107,122,1689040,6,0.923076923,0.974358974,0.923076923,4060
6c2e7005badf1bde8843c45017f93220fa4ca8e4,0,Ismael Juma,2018-11-12 13:42:29-08:00,['1c1e5ee97959d1841c9190deb0de2f18d55a4030'],146,4,150,1689190,3,0.262295082,0,0,4060
12f310d50e7f5b1c18c4f61a119a6cd830da3bc0,1,GitHub,2018-11-12 22:18:59-08:00,['6c2e7005badf1bde8843c45017f93220fa4ca8e4'],814,800,1614,1690804,197,1,0.055555556,0.266666667,4060
e08d721b048c70a0eea82d6c8a57faa69ed40163,0,Ismael Juma,2018-11-12 22:21:21-08:00,['12f310d50e7f5b1c18c4f61a119a6cd830da3bc0'],32,51,83,1690887,3,1,1,1,4060
d00938fdf862b70923528ceff87ed0fc081b13d1,0,Colin Patrick McCabe,2018-11-13 08:35:03-08:00,['e08d721b048c70a0eea82d6c8a57faa69ed40163'],4,4,8,1690895,1,,,,4060
8259fda6953be6c87829af80eb85b1c63e86b65c,0,Colin Patrick McCabe,2018-11-13 08:38:42-08:00,['d00938fdf862b70923528ceff87ed0fc081b13d1'],88,376,464,1691359,8,0.328125,0.71875,1,4060
f52de5f0adf1d3d3557aa38421d9212a1f768b19,0,Jason Gustafson,2018-11-13 09:43:29-08:00,['8259fda6953be6c87829af80eb85b1c63e86b65c'],3,0,3,1691362,1,0,0,0,4060
545d40d83c73445d0417b1bf3b6e979501888ae7,0,Jason Gustafson,2018-11-13 13:30:34-08:00,['f52de5f0adf1d3d3557aa38421d9212a1f768b19'],19,23,42,1691404,1,0,0,1,4060
14d3ead19d250f2f3117af473ff6244c663ef8ca,1,GitHub,2018-11-14 17:29:19-08:00,['545d40d83c73445d0417b1bf3b6e979501888ae7'],164,125,289,1691693,28,0.909090909,0,0,4060
004fd1fde799d0b3918aaadef86b05d1bc7191eb,0,Dong Lin,2018-11-15 11:22:12-08:00,['14d3ead19d250f2f3117af473ff6244c663ef8ca'],2,2,4,1691697,1,,,,4060
93466602d80c0c8dba7544964f48feb49589b0b5,1,Guozhang Wang,2018-11-15 13:23:39-08:00,['004fd1fde799d0b3918aaadef86b05d1bc7191eb'],20,29,49,1691746,1,0,1,0,4060
d2f37944b6043ff443adbdf547d5bd335affbc1a,0,Guozhang Wang,2018-11-15 13:26:58-08:00,['93466602d80c0c8dba7544964f48feb49589b0b5'],10,50,60,1691806,2,0.483870968,0.483870968,1,4060
80eb2c28f6b8bef603b5281f94cb32f5dadbeb7d,1,Guozhang Wang,2018-11-15 13:29:25-08:00,['d2f37944b6043ff443adbdf547d5bd335affbc1a'],4,85,89,1691895,3,0.542857143,1,0.914285714,4061
abc09597db86091c5273348e74be07b63c31a189,0,Guozhang Wang,2018-11-15 13:39:18-08:00,['80eb2c28f6b8bef603b5281f94cb32f5dadbeb7d'],340,3,343,1692238,2,0.949458484,0,0.010830325,4061
23ed45a21df3717332cbd2e284e9867ef5c2cc51,0,Guozhang Wang,2018-11-15 14:28:13-08:00,['abc09597db86091c5273348e74be07b63c31a189'],1,1,2,1692240,1,,,,4061
1a4d44f2067ed8c575d5927fd8361bb99d42b23e,0,Jason Gustafson,2018-11-15 17:27:29-08:00,['23ed45a21df3717332cbd2e284e9867ef5c2cc51'],44,197,241,1692481,10,0.585106383,0.904255319,0.893617021,4061
c3e7d6252c41d48e74379810595c978efada9efb,1,Jason Gustafson,2018-11-16 00:58:56-08:00,['1a4d44f2067ed8c575d5927fd8361bb99d42b23e'],74,318,392,1692873,8,0.055555556,0,0.927777778,4061
b21e933592a4893d1341a251a96b546e1b0ce3a1,1,Guozhang Wang,2018-11-16 15:28:47-08:00,['c3e7d6252c41d48e74379810595c978efada9efb'],1,8,9,1692882,1,0,0,1,4061
9646602d6832ad0a5f2e9b65af5df1a80a571691,1,Colin Patrick McCabe,2018-11-16 15:58:47-08:00,['b21e933592a4893d1341a251a96b546e1b0ce3a1'],13,13,26,1692908,13,,,,4061
190cbd9fe59e3baa2d6002d60ed241120f346228,0,GitHub,2018-11-19 18:44:45-08:00,['9646602d6832ad0a5f2e9b65af5df1a80a571691'],5,16,21,1692929,1,0.75,0.875,0.875,4061
8dc4d0e7872bad4cf7e5ebaf28229acc5667ae2d,0,Guozhang Wang,2018-11-19 21:28:12-08:00,['190cbd9fe59e3baa2d6002d60ed241120f346228'],167,5,172,1693101,3,0.637681159,0,0.144927536,4061
938e6aa22ab32238f16e3e5d7af13d8b527081c5,0,Manikumar Reddy,2018-11-20 12:05:02+05:18,['8dc4d0e7872bad4cf7e5ebaf28229acc5667ae2d'],1,1,2,1693103,1,,,,4061
1d4ca5adf360224940984d20d819a85c94d95144,0,Manikumar Reddy,2018-11-20 23:04:21+05:18,['938e6aa22ab32238f16e3e5d7af13d8b527081c5'],4,15,19,1693122,2,1,1,1,4061
46e7b136e22430340337d3540627a1d685dfa31e,0,GitHub,2018-11-20 14:39:12-08:00,['1d4ca5adf360224940984d20d819a85c94d95144'],3,20,23,1693145,3,1,1,1,4061
068ab9cefae301f3187ea885d645c425955e77d2,0,Guozhang Wang,2018-11-20 15:54:24-08:00,['46e7b136e22430340337d3540627a1d685dfa31e'],46,69,115,1693260,12,1,0,0.461538462,4061
808dc0a96b3a8e6a6dbecb0473382b39a366d7a2,0,Matthias J. Sax,2018-11-21 09:48:01-08:00,['068ab9cefae301f3187ea885d645c425955e77d2'],9,9,18,1693278,3,,,,4061
14fbf16875f6b1dca9022b5d22aebd4e8bb2b2da,0,Guozhang Wang,2018-11-21 11:49:36-08:00,['808dc0a96b3a8e6a6dbecb0473382b39a366d7a2'],1,1,2,1693280,1,,,,4061
ad26914de65e2db244fbe36a2a5fd03de87dfb79,1,Manikumar Reddy,2018-11-22 17:00:34+05:18,['14fbf16875f6b1dca9022b5d22aebd4e8bb2b2da'],451,478,929,1694209,23,1,0.478632479,0,4062
50a61c0dbf89a42c802aca2688ca8e0648e3e40c,0,Manikumar Reddy,2018-11-22 22:15:57+05:18,['ad26914de65e2db244fbe36a2a5fd03de87dfb79'],1,1,2,1694211,1,,,,4062
4e90af34c6c2eff8e164a7d3fafb1ae8b744784c,0,Manikumar Reddy,2018-11-23 10:38:30+05:18,['50a61c0dbf89a42c802aca2688ca8e0648e3e40c'],41,47,88,1694299,8,,,,4062
d0ed3894d6c586a580504c5141b3ae7de18f3518,1,GitHub,2018-11-23 12:32:37-08:00,['4e90af34c6c2eff8e164a7d3fafb1ae8b744784c'],87,133,220,1694519,4,1,1,1,4062
7fadf0a11ddb2451adc66e1b179b84b050ad3f4f,0,Colin P. Mccabe,2018-11-26 16:46:58-08:00,['d0ed3894d6c586a580504c5141b3ae7de18f3518'],65,146,211,1694730,9,0,0.875,0.375,4063
9368743b8fd2b42a41b44860ea0f3588bb273cc8,0,Colin Patrick McCabe,2018-11-27 12:49:53-08:00,['7fadf0a11ddb2451adc66e1b179b84b050ad3f4f'],26,318,344,1695074,11,0.298969072,0.567010309,0.93814433,4066
55c77ebf01ea8662b98f73f6f6c17d05163a85b8,1,Guozhang Wang,2018-11-27 12:57:04-08:00,['9368743b8fd2b42a41b44860ea0f3588bb273cc8'],24,375,399,1695473,9,0.077419355,0.967741935,0.658064516,4067
dfd545485ab0399e0c129ff2d68fbb3113f3e8c9,0,Guozhang Wang,2018-11-27 13:07:34-08:00,['55c77ebf01ea8662b98f73f6f6c17d05163a85b8'],0,332,332,1695805,3,0.430107527,1,0.860215054,4069
de24d4a459ccfac623e71722f8df8b1e99f2ad43,1,Matthias J. Sax,2018-11-27 13:09:44-08:00,['dfd545485ab0399e0c129ff2d68fbb3113f3e8c9'],87,375,462,1696267,17,0.506976744,0.669767442,0.51627907,4069
0ee16350ac2e1ac7fa16f276ae61d2899eaaf28e,0,GitHub,2018-11-27 14:40:17-08:00,['de24d4a459ccfac623e71722f8df8b1e99f2ad43'],15,23,38,1696305,2,,,,4069
a2e87feb8b1db8200ca3a34aa72b0802e8f61096,1,Ewen Cheslack-Postava,2018-11-27 22:01:21-08:00,['0ee16350ac2e1ac7fa16f276ae61d2899eaaf28e'],45,39,84,1696389,6,1,0,0.333333333,4069
e869d8f7b495e65379212ab8e5ec1f8e8f3fa650,0,Manikumar Reddy,2018-11-28 12:01:26+05:18,['a2e87feb8b1db8200ca3a34aa72b0802e8f61096'],3,9,12,1696401,2,,,,4069
c32b7e5a9f494dc4ef9c04bca6f73902269e1d49,0,Manikumar Reddy,2018-11-28 16:04:45+05:18,['e869d8f7b495e65379212ab8e5ec1f8e8f3fa650'],2,36,38,1696439,2,0,1,1,4069
ec668180d797c4d08ea899de61c344438621ced7,0,Colin Patrick McCabe,2018-11-28 09:13:21-08:00,['c32b7e5a9f494dc4ef9c04bca6f73902269e1d49'],8,8,16,1696455,4,,,,4069
2c305dc64c033ffcfd6e45548752f0702f373032,0,Guozhang Wang,2018-11-28 18:15:26-08:00,['ec668180d797c4d08ea899de61c344438621ced7'],1,25,26,1696481,2,0,1,1,4069
fb9f2d8c9b296c44f42ae3838380895f95171133,0,Jun Rao,2018-11-28 18:23:30-08:00,['2c305dc64c033ffcfd6e45548752f0702f373032'],4,57,61,1696542,2,1,1,1,4070
4fb5520901d9908d2ca16b6f56242b778f6d2f05,0,Manikumar Reddy,2018-11-29 12:06:56+05:18,['fb9f2d8c9b296c44f42ae3838380895f95171133'],1,1,2,1696544,1,,,,4070
bfbc32d9bc9e63c5e02840aeed4de157654dc5e8,0,Guozhang Wang,2018-11-29 15:09:50-08:00,['4fb5520901d9908d2ca16b6f56242b778f6d2f05'],33,98,131,1696675,3,0,1,1,4070
4a0fd4c41b3255a6df932eb22bd4f45d38717641,0,Ismael Juma,2018-11-29 16:04:39-08:00,['bfbc32d9bc9e63c5e02840aeed4de157654dc5e8'],3,3,6,1696681,2,,,,4070
b7d95da88df3a521870fa4f6d6e53cee7e679d40,0,Guozhang Wang,2018-11-29 20:10:24-08:00,['4a0fd4c41b3255a6df932eb22bd4f45d38717641'],2,29,31,1696712,3,0.785714286,0.785714286,1,4070
944f24cfdc8edd2b4ef89ed40a55a480e8f89632,1,Manikumar Reddy,2018-11-30 10:59:25+05:18,['b7d95da88df3a521870fa4f6d6e53cee7e679d40'],164,279,443,1697155,12,0.826923077,0.846153846,0.692307692,4071
3acebe63836b4a30d21f8c2ca2934e1a0fcad2f5,0,Ewen Cheslack-Postava,2018-11-29 22:21:20-08:00,['944f24cfdc8edd2b4ef89ed40a55a480e8f89632'],9,32,41,1697196,1,0.473684211,0.473684211,1,4071
4712a3641619e86b8e6d901355088f6ae06e9f37,0,Ewen Cheslack-Postava,2018-11-29 22:29:50-08:00,['3acebe63836b4a30d21f8c2ca2934e1a0fcad2f5'],1,27,28,1697224,5,0,0.875,0.875,4071
ace4dd00566afb7d04235bbbcc50097191af0fec,1,Ewen Cheslack-Postava,2018-11-29 23:38:50-08:00,['4712a3641619e86b8e6d901355088f6ae06e9f37'],65,123,188,1697412,6,0.875,1,1,4071
eca66207c8dc81ca139975a25ce22c6f465fabba,1,Manikumar Reddy,2018-11-30 14:30:34+05:18,['ace4dd00566afb7d04235bbbcc50097191af0fec'],0,444,444,1697856,1,,,,4071
9b476bc5f4a2fdbd62ad84e50e65331c21b321d0,1,GitHub,2018-11-30 10:31:07-08:00,['eca66207c8dc81ca139975a25ce22c6f465fabba'],29,42,71,1697927,1,0,1,1,4071
c4822648ef1bb0cd6825d8dbe465c8a5a26a76bc,1,Manikumar Reddy,2018-12-03 10:50:05+05:18,['9b476bc5f4a2fdbd62ad84e50e65331c21b321d0'],102,75,177,1698104,1,1,0,0.555555556,4071
e7ce0e7e0a82bb56b1106479c0c8a7984fd92604,0,Manikumar Reddy,2018-12-03 11:16:36+05:18,['c4822648ef1bb0cd6825d8dbe465c8a5a26a76bc'],22,294,316,1698420,6,0.572289157,0.885542169,0.740963855,4073
2155c6d54b087206b6aa1d58747f141761394eaf,1,Jun Rao,2018-12-02 22:00:51-08:00,['e7ce0e7e0a82bb56b1106479c0c8a7984fd92604'],793,1627,2420,1700840,39,0.31779661,0.644067797,0.976694915,4077
4444a31edbcf0298f3299b5708c0eb1f5121f131,1,Guozhang Wang,2018-12-02 22:11:04-08:00,['2155c6d54b087206b6aa1d58747f141761394eaf'],207,114,321,1701161,1,0.973333333,0.36,0.16,4077
ab1fb3fdde95be535b97eb1c8c21ef32896f891a,0,Guozhang Wang,2018-12-03 12:37:31-08:00,['4444a31edbcf0298f3299b5708c0eb1f5121f131'],0,261,261,1701422,3,0.410447761,0.589552239,0.940298507,4079
b4030a0375a46f71000d11147192db83a7f3bb25,0,Manikumar Reddy,2018-12-04 09:29:08+05:18,['ab1fb3fdde95be535b97eb1c8c21ef32896f891a'],1,35,36,1701458,1,,,,4079
7283711c0d99d484b10dd7c460f7df01a319fc2b,0,Guozhang Wang,2018-12-03 22:59:54-08:00,['b4030a0375a46f71000d11147192db83a7f3bb25'],46,97,143,1701601,12,1,1,0.85,4079
437cf35373dbfa9d5c1ca44a8e2c0e363a0ffa7c,0,GitHub,2018-12-04 09:44:11+00:00,['7283711c0d99d484b10dd7c460f7df01a319fc2b'],4,15,19,1701620,2,1,1,1,4079
f65b1c4796fdf34a883e0228f7b74a0fe36dd4a8,0,Jason Gustafson,2018-12-04 09:04:39-08:00,['437cf35373dbfa9d5c1ca44a8e2c0e363a0ffa7c'],28,34,62,1701682,2,1,1,1,4079
a1807d491450480c32d86df2df3f8b685c65e6ed,0,Guozhang Wang,2018-12-04 16:21:18-08:00,['f65b1c4796fdf34a883e0228f7b74a0fe36dd4a8'],4,5,9,1701691,1,,,,4079
0d4cf64af359d22749f7e865c4efaee773d64962,1,GitHub,2018-12-05 09:05:26+00:00,['a1807d491450480c32d86df2df3f8b685c65e6ed'],6,102,108,1701799,3,0.289156627,0.975903614,0.975903614,4079
ec501f305e53a09072580fb3824048c170d32a48,1,Matthias J. Sax,2018-12-05 11:25:52-08:00,['0d4cf64af359d22749f7e865c4efaee773d64962'],0,441,441,1702240,2,0.780991736,0.892561983,0.938016529,4080
b616f913c8a57609476e5cf99b1802ef1dfe1c98,0,Matthias J. Sax,2018-12-05 11:48:39-08:00,['ec501f305e53a09072580fb3824048c170d32a48'],2,16,18,1702258,2,1,1,1,4080
9f954ac614cd5dd7efbcabe34799207128f16e63,0,Ewen Cheslack-Postava,2018-12-05 13:23:52-08:00,['b616f913c8a57609476e5cf99b1802ef1dfe1c98'],2,2,4,1702262,1,,,,4080
0ffdf8307f8c0822def6f97f69777337106fc347,0,Jason Gustafson,2018-12-05 14:49:19-08:00,['9f954ac614cd5dd7efbcabe34799207128f16e63'],21,87,108,1702370,3,0,0,1,4080
38e7d5763fda21608d1b29742cf502b257bef157,0,GitHub,2018-12-05 16:52:25-08:00,['0ffdf8307f8c0822def6f97f69777337106fc347'],1,1,2,1702372,1,,,,4080
87cc31c4e7ea36e7e832a1d02d71480a91a75293,0,Jun Rao,2018-12-06 08:46:35-05:00,['38e7d5763fda21608d1b29742cf502b257bef157'],2,2,4,1702376,1,,,,4080
c05050346468cc27bcfb3a43bde90c47533a386c,1,Guozhang Wang,2018-12-06 16:55:01-08:00,['87cc31c4e7ea36e7e832a1d02d71480a91a75293'],4,44,48,1702424,2,0,0.964285714,1,4080
05dc36d548fbe8e00dff51b19d698c980e7ecf0b,0,Ismael Juma,2018-12-08 09:27:59-08:00,['c05050346468cc27bcfb3a43bde90c47533a386c'],4,4,8,1702432,1,0,1,1,4080
ac35ef6242d6893223af946f3c9438b8b4294389,0,Ismael Juma,2018-12-08 09:36:14-08:00,['05dc36d548fbe8e00dff51b19d698c980e7ecf0b'],3,3,6,1702438,1,,,,4080
edfa68173615cddaa421ef02ccf7b82ce4181c79,0,Ismael Juma,2018-12-08 09:43:43-08:00,['ac35ef6242d6893223af946f3c9438b8b4294389'],4,5,9,1702447,2,,,,4080
b49229675748afae584799e11a8b8f090c4218a9,1,Guozhang Wang,2018-12-08 19:00:57-08:00,['edfa68173615cddaa421ef02ccf7b82ce4181c79'],1,91,92,1702539,3,0.225806452,1,0.919354839,4080
c0353d8ddce88bac6fc04f85dd40cb95b8ca5cf9,1,GitHub,2018-12-08 22:49:48-08:00,['b49229675748afae584799e11a8b8f090c4218a9'],899,494,1393,1703932,32,0.948571429,0.131428571,0.137142857,4080
ab156fded1548b6cf06aff56bb5193c37a8f7e51,1,GitHub,2018-12-09 15:33:17-08:00,['c0353d8ddce88bac6fc04f85dd40cb95b8ca5cf9'],37,27,64,1703996,13,0,0,1,4080
7a3dffb0ca1f7ff2bd838f42ca2f12b7a2fc3b0e,1,Jason Gustafson,2018-12-10 09:45:18-08:00,['ab156fded1548b6cf06aff56bb5193c37a8f7e51'],37,74,111,1704107,3,0.620689655,0.827586207,0.965517241,4080
20069b390637813c289175327f08fe410fd0cb71,1,Guozhang Wang,2018-12-10 14:32:29-08:00,['7a3dffb0ca1f7ff2bd838f42ca2f12b7a2fc3b0e'],28,98,126,1704233,5,0.238095238,0.976190476,0.714285714,4080
a94c8da5083381d9ca4224b1489e1dc205bf55bb,1,Matthias J. Sax,2018-12-11 00:40:18-08:00,['20069b390637813c289175327f08fe410fd0cb71'],0,42,42,1704275,3,0,0.833333333,1,4080
c142809038e67625638165462ceefd3f1191e0e9,1,Matthias J. Sax,2018-12-11 01:44:18-08:00,['a94c8da5083381d9ca4224b1489e1dc205bf55bb'],94,385,479,1704754,5,0.335106383,0.877659574,0.920212766,4080
046b0087bd76637bbfd813ccef31693fa358ff2d,1,GitHub,2018-12-11 01:54:41-08:00,['c142809038e67625638165462ceefd3f1191e0e9'],743,697,1440,1706194,74,1,0,0.411764706,4080
3ef6b0fce05a6ecdf7a703ff48680b16594b7bc4,0,Jason Gustafson,2018-12-12 08:28:58-08:00,['046b0087bd76637bbfd813ccef31693fa358ff2d'],1,1,2,1706196,1,,,,4080
975b680bcd74661eeecf21052f6185cd637bbeda,0,Jason Gustafson,2018-12-12 08:37:09-08:00,['3ef6b0fce05a6ecdf7a703ff48680b16594b7bc4'],4,0,4,1706200,1,,,,4080
46e8081f9cae24f5edbfa2099e317a33e531d2fb,1,Jason Gustafson,2018-12-12 10:50:56-08:00,['975b680bcd74661eeecf21052f6185cd637bbeda'],12,72,84,1706284,2,0.844444444,1,0.733333333,4080
fdd33bcab0b727d87ceb8f242de67d4452ead6e1,0,Guozhang Wang,2018-12-12 18:22:54-08:00,['46e8081f9cae24f5edbfa2099e317a33e531d2fb'],7,67,74,1706358,1,,,,4080
dffce6e7ae047a21fb40ec2c27d3d1f562a511a3,0,Matthias J. Sax,2018-12-13 16:40:39+01:00,['fdd33bcab0b727d87ceb8f242de67d4452ead6e1'],9,34,43,1706401,3,0.142857143,0.285714286,1,4080
88443b4a3718a848188db9f5152c1077b15f1159,0,Guozhang Wang,2018-12-13 19:31:58-08:00,['dffce6e7ae047a21fb40ec2c27d3d1f562a511a3'],5,117,122,1706523,3,1,1,1,4081
da332f2241f1781aca64d1007c0c209b50ec5ff0,0,Guozhang Wang,2018-12-13 20:30:04-08:00,['88443b4a3718a848188db9f5152c1077b15f1159'],4,5,9,1706532,2,1,0,1,4081
f982f61fbef07970114f3c59ddb212f3e223cd46,0,Guozhang Wang,2018-12-13 20:33:25-08:00,['da332f2241f1781aca64d1007c0c209b50ec5ff0'],8,12,20,1706552,1,,,,4081
5c549b2a89c2364eb966bd56f136a7891f0ffc9f,1,GitHub,2018-12-14 09:37:43-08:00,['f982f61fbef07970114f3c59ddb212f3e223cd46'],1,1,2,1706554,1,,,,4081
152292994e45d5bedda0673c142f9406e70d5d3e,1,Jason Gustafson,2018-12-14 13:53:03-08:00,['5c549b2a89c2364eb966bd56f136a7891f0ffc9f'],30,346,376,1706930,13,0.32748538,0.555555556,0.988304094,4082
c441528b93a05da58ad1a8599c4de35e2c14ff16,1,GitHub,2018-12-17 13:57:01+01:00,['152292994e45d5bedda0673c142f9406e70d5d3e'],3,10,13,1706943,1,1,1,1,4082
40392266aa6c1b4c5314fd89337fecee768441a2,1,GitHub,2018-12-17 15:51:01-08:00,['c441528b93a05da58ad1a8599c4de35e2c14ff16'],3,17,20,1706963,3,0.833333333,0,0.833333333,4082
09c4a3e87dc2d247d4d88dc17b665daa34089f90,1,Jason Gustafson,2018-12-17 16:30:14-08:00,['40392266aa6c1b4c5314fd89337fecee768441a2'],1,1,2,1706965,1,,,,4082
40ca7ddeedaee6edf39ca941b13a79ad42c3e5b5,0,Guozhang Wang,2018-12-19 17:53:09-08:00,['09c4a3e87dc2d247d4d88dc17b665daa34089f90'],65,158,223,1707188,2,0.011363636,1,0.988636364,4082
b23bf41e84d468185aa4165bf171b24735b8fecd,0,Manikumar Reddy,2018-12-20 15:43:34+05:18,['40ca7ddeedaee6edf39ca941b13a79ad42c3e5b5'],7,43,50,1707238,2,0.304347826,1,1,4082
d413117769efea0d5212ce29445049918209fd03,0,Manikumar Reddy,2018-12-20 22:13:25+05:18,['b23bf41e84d468185aa4165bf171b24735b8fecd'],3,3,6,1707244,1,,,,4082
ee370d389350b5a6e8afa89a67995fa8b8dbde55,0,Jason Gustafson,2018-12-20 14:24:05-08:00,['d413117769efea0d5212ce29445049918209fd03'],8,33,41,1707285,2,0,0.947368421,1,4082
85906d3d2ba49e593623de1484a9946224ce71cc,1,Manikumar Reddy,2018-12-21 14:08:57+05:18,['ee370d389350b5a6e8afa89a67995fa8b8dbde55'],284,196,480,1707765,19,1,0.695121951,0.12195122,4082
684184973e27f1f072bb194acf55706860db237f,0,Manikumar Reddy,2018-12-21 14:20:22+05:18,['85906d3d2ba49e593623de1484a9946224ce71cc'],4,2,6,1707771,1,0,0,0,4082
55334453a561646b303e7de961e5990345effc15,1,Manikumar Reddy,2018-12-21 14:36:22+05:18,['684184973e27f1f072bb194acf55706860db237f'],10,41,51,1707822,2,1,0,1,4082
639427a38f0760d4a41fd477dc37f249d92a2020,0,Guozhang Wang,2018-12-21 22:32:19-08:00,['55334453a561646b303e7de961e5990345effc15'],3,3,6,1707828,2,,,,4082
53eb8df344c376ed651db83a084f962083df8a6d,0,Guozhang Wang,2018-12-21 22:43:55-08:00,['639427a38f0760d4a41fd477dc37f249d92a2020'],0,2,2,1707830,1,0,1,1,4082
4616c0aaff5766b6305baeed521efdfaae0094e8,0,Guozhang Wang,2018-12-21 22:56:32-08:00,['53eb8df344c376ed651db83a084f962083df8a6d'],2,14,16,1707846,1,1,1,1,4082
964e2c57c2aead1638d0e7ddb614a08e4fd20d2f,0,Jason Gustafson,2018-12-28 09:39:52-08:00,['4616c0aaff5766b6305baeed521efdfaae0094e8'],19,40,59,1707905,2,0.533333333,1,0.8,4082
9295444d48eb057900ef09f1176e34b37331f60b,0,Jason Gustafson,2018-12-28 13:58:05-08:00,['964e2c57c2aead1638d0e7ddb614a08e4fd20d2f'],15,19,34,1707939,3,1,0.5,1,4082
ffd6f2a2e8a573695d0c1c98e663f0b8198b1b6d,0,Manikumar Reddy,2019-01-02 19:18:51+05:18,['9295444d48eb057900ef09f1176e34b37331f60b'],1,1,2,1707941,1,,,,4082
d086e83fecbf211695868f6aebe6a80b68ff1c50,1,Jason Gustafson,2019-01-02 15:00:40-08:00,['ffd6f2a2e8a573695d0c1c98e663f0b8198b1b6d'],1,1,2,1707943,1,,,,4082
459a4dd032fe51f651a6d74170d64e3b041ba480,0,Harsha,2019-01-03 16:08:49-08:00,['d086e83fecbf211695868f6aebe6a80b68ff1c50'],20,39,59,1708002,1,1,1,1,4082
6ea5474e4c073bec6cfa99bbb73ee547588b11ef,0,Guozhang Wang,2019-01-03 17:14:26-08:00,['459a4dd032fe51f651a6d74170d64e3b041ba480'],11,78,89,1708091,11,0.434782609,1,1,4082
eb9ca17a7ed6602c363fe1f77f5b98f2915f2c31,0,Manikumar Reddy,2019-01-04 16:03:40+05:18,['6ea5474e4c073bec6cfa99bbb73ee547588b11ef'],3,9,12,1708103,2,0,1,0,4082
f8113c053b1266916ae3ce73385d4ed336ab2730,0,Matthias J. Sax,2019-01-04 13:01:57+01:00,['eb9ca17a7ed6602c363fe1f77f5b98f2915f2c31'],8,22,30,1708133,2,0,0.25,0,4082
b16afbb77bc1a497096815e64ed9e97df1edf92d,1,GitHub,2019-01-04 10:49:08-08:00,['f8113c053b1266916ae3ce73385d4ed336ab2730'],127,140,267,1708400,3,1,1,0,4082
329297ba3840df9cead731adf3448edebf6e37e2,1,Guozhang Wang,2019-01-04 11:42:33-08:00,['b16afbb77bc1a497096815e64ed9e97df1edf92d'],15,67,82,1708482,7,1,1,0.96875,4082
ef9204dc586038b97440485c81c218d438f22b9c,0,Guozhang Wang,2019-01-04 13:44:15-08:00,['329297ba3840df9cead731adf3448edebf6e37e2'],4,10,14,1708496,2,0.142857143,0.428571429,0,4082
d6698308194625e7921b9c3ace27a918f42f26f1,0,GitHub,2019-01-04 14:39:47-08:00,['ef9204dc586038b97440485c81c218d438f22b9c'],170,216,386,1708882,6,0,0.53125,0.90625,4082
9d544212e69269f155bb3a51f94a9b13cf1fa565,1,GitHub,2019-01-04 14:41:15-08:00,['d6698308194625e7921b9c3ace27a918f42f26f1'],216,170,386,1709268,6,1,0.46875,0.09375,4082
fcdde2c604b7b9488862b3a2dba3b47be7a3d239,1,GitHub,2019-01-04 14:41:59-08:00,['9d544212e69269f155bb3a51f94a9b13cf1fa565'],47,43,90,1709358,3,1,0,0,4082
8e4799b017c6a3c65eaf47f60ab136654c9741de,1,GitHub,2019-01-04 21:27:50-08:00,['fcdde2c604b7b9488862b3a2dba3b47be7a3d239'],166,212,378,1709736,6,0,0.459459459,0.891891892,4082
b6d1450012734a841fdf85400636593092cf7e2b,0,Jason Gustafson,2019-01-05 02:56:15-08:00,['8e4799b017c6a3c65eaf47f60ab136654c9741de'],1,1,2,1709738,1,,,,4082
1f3cb6c4efbbd648aa2b91370bfea2041a7c413a,0,GitHub,2019-01-06 17:50:25-08:00,['b6d1450012734a841fdf85400636593092cf7e2b'],5,6,11,1709749,2,,,,4082
404bdef08db8c88f1b7a921737279feabfd0cb1f,0,Guozhang Wang,2019-01-06 23:03:54-08:00,['1f3cb6c4efbbd648aa2b91370bfea2041a7c413a'],43,185,228,1709977,8,0.1,1,0.842857143,4083
e4f233ed33ffa5076becbd5458520eb2945263ca,1,Rajini Sivaram,2019-01-07 13:33:58+00:00,['404bdef08db8c88f1b7a921737279feabfd0cb1f'],5,33,38,1710015,2,1,1,0.888888889,4083
6a20e3cd4ca242036649e8e32982451a72cde777,1,Guozhang Wang,2019-01-07 09:21:33-08:00,['e4f233ed33ffa5076becbd5458520eb2945263ca'],85,85,170,1710185,5,,,,4083
145cad752d720c6ea735a5e2f977d10ace5bcc0f,1,GitHub,2019-01-07 13:20:07-08:00,['6a20e3cd4ca242036649e8e32982451a72cde777'],9,15,24,1710209,1,0,0,0,4083
aff02944fee9dd79e58a6dd31291d5058bc786bb,0,Colin P. Mccabe,2019-01-07 13:21:14-08:00,['145cad752d720c6ea735a5e2f977d10ace5bcc0f'],1,1,2,1710211,1,,,,4083
8ae985705f8e16e64e1cd66bbfd38ac57d875cb7,1,Guozhang Wang,2019-01-07 13:30:49-08:00,['aff02944fee9dd79e58a6dd31291d5058bc786bb'],78,78,156,1710367,5,,,,4083
f9a22f42a842b2d80ac687567ae04e91dadebefe,1,Rajini Sivaram,2019-01-08 14:14:51+00:00,['8ae985705f8e16e64e1cd66bbfd38ac57d875cb7'],132,290,422,1710789,10,0.467391304,1,0,4084
96013154206ce1f5a643f3e38a30eb8789e0aa0c,1,Jason Gustafson,2019-01-08 08:52:42-08:00,['f9a22f42a842b2d80ac687567ae04e91dadebefe'],4,5,9,1710798,2,1,1,1,4084
3991d81f6c645bdf36c58e3d56b829ff92dbff3a,1,GitHub,2019-01-08 22:32:53+01:00,['96013154206ce1f5a643f3e38a30eb8789e0aa0c'],705,818,1523,1712321,19,0,0.962962963,0.962962963,4084
515e680c7102b2045bb6b08d7bbd2ae55ae3e5d8,0,Guozhang Wang,2019-01-08 13:48:38-08:00,['3991d81f6c645bdf36c58e3d56b829ff92dbff3a'],2,2,4,1712325,2,,,,4084
e32567699451e2fb0ccd63dd8a3df582cfd18d61,1,Jason Gustafson,2019-01-08 18:05:13-08:00,['515e680c7102b2045bb6b08d7bbd2ae55ae3e5d8'],94,153,247,1712572,4,0.185185185,0.62962963,0.666666667,4084
73a9fcaa4db3f758dd8a16eff5651555ded1b8b7,0,GitHub,2019-01-08 23:47:28-08:00,['e32567699451e2fb0ccd63dd8a3df582cfd18d61'],3,7,10,1712582,1,1,1,1,4084
6e7149b77a10ac6aa4da2edd549f468015170236,1,GitHub,2019-01-09 15:03:28+01:00,['73a9fcaa4db3f758dd8a16eff5651555ded1b8b7'],298,515,813,1713395,6,0.063063063,1,0.900900901,4084
86de2dfd27f96dd3fea0635ad110c63bc639c721,1,GitHub,2019-01-09 15:04:52+01:00,['6e7149b77a10ac6aa4da2edd549f468015170236'],477,442,919,1714314,7,0,0,0.05,4084
1c7bf4e4976e2b58826f68f1abe8ffc9fd41692c,1,GitHub,2019-01-09 18:03:16+01:00,['86de2dfd27f96dd3fea0635ad110c63bc639c721'],454,435,889,1715203,31,1,0.852941176,0,4084
66a9416e384fa3d3388de65885d895335e707286,0,Ismael Juma,2019-01-09 09:32:02-08:00,['1c7bf4e4976e2b58826f68f1abe8ffc9fd41692c'],10,18,28,1715231,1,0,0,0,4084
b2b79c4f0ef33035ecdb486a6526a2cf20d77385,1,Jason Gustafson,2019-01-09 11:09:48-08:00,['66a9416e384fa3d3388de65885d895335e707286'],6,125,131,1715362,6,0.44047619,1,1,4084
b1b792d9a81530fb872176c8d30e5b473f59e12f,0,Guozhang Wang,2019-01-09 15:19:00-08:00,['b2b79c4f0ef33035ecdb486a6526a2cf20d77385'],3,4,7,1715369,2,0,1,1,4084
4154eb9f11a44c447e3f14318020c708a88d8e78,0,GitHub,2019-01-10 01:14:30-08:00,['b1b792d9a81530fb872176c8d30e5b473f59e12f'],16,16,32,1715401,6,,,,4084
e8959bd766cc6e19f6208fe7ea0a3103cc8fe123,0,Manikumar Reddy,2019-01-10 19:06:58+05:18,['4154eb9f11a44c447e3f14318020c708a88d8e78'],12,6,18,1715419,1,1,1,0,4084
c238af29bf50cade5aa10c1bb2678ad01cfbbf47,1,Guozhang Wang,2019-01-10 10:03:11-08:00,['e8959bd766cc6e19f6208fe7ea0a3103cc8fe123'],2,36,38,1715457,2,0,0.916666667,1,4084
b4bf6232c290e820ba408c049910b00599a0f27a,1,Guozhang Wang,2019-01-10 15:50:52-08:00,['c238af29bf50cade5aa10c1bb2678ad01cfbbf47'],1,7,8,1715465,1,,,,4084
694da1ac1e77c5b9aafe990def2238e521c0fa1f,1,Harsha,2019-01-11 10:29:10-08:00,['b4bf6232c290e820ba408c049910b00599a0f27a'],22,187,209,1715674,4,0.0078125,1,1,4084
3746bf2c848e28ad5551a1adcf7516da1d61dbc5,1,Guozhang Wang,2019-01-11 11:35:33-08:00,['694da1ac1e77c5b9aafe990def2238e521c0fa1f'],1,40,41,1715715,1,,,,4084
625e0d882944f74568464037c3a8aafb585079f2,0,Colin Patrick McCabe,2019-01-11 13:38:00-08:00,['3746bf2c848e28ad5551a1adcf7516da1d61dbc5'],71,282,353,1716068,7,0.206666667,1,0.886666667,4084
e120feb4859a502749d7de08f594fd7d1ba86bcf,0,GitHub,2019-01-11 13:40:22-08:00,['625e0d882944f74568464037c3a8aafb585079f2'],2,2,4,1716072,1,,,,4084
7df3e8cd38083ae78ec1e26a259cfb3bb1fbe2d2,0,Colin Patrick McCabe,2019-01-11 14:56:06-08:00,['e120feb4859a502749d7de08f594fd7d1ba86bcf'],29,9,38,1716110,3,0.076923077,0.076923077,0.923076923,4084
cc33511e9a0a1493ef89afefb7df089ca546687e,1,Ewen Cheslack-Postava,2019-01-11 15:11:55-08:00,['7df3e8cd38083ae78ec1e26a259cfb3bb1fbe2d2'],7,19,26,1716136,3,,,,4084
71e85f5e842687c040f9ee69b9073fc285113541,1,Jason Gustafson,2019-01-11 16:40:21-08:00,['cc33511e9a0a1493ef89afefb7df089ca546687e'],70,8035,8105,1724241,124,0.416666667,0.639280125,0.80399061,4199
cb3eedcf9414244b3e75e0e1d91ac149a573d8b8,1,Manikumar Reddy,2019-01-13 18:32:29+05:18,['71e85f5e842687c040f9ee69b9073fc285113541'],14,20,34,1724275,8,1,1,1,4199
8afce0e338e3715824e309f6289af6bc607ce020,1,Jun Rao,2019-01-13 10:17:52-08:00,['cb3eedcf9414244b3e75e0e1d91ac149a573d8b8'],257,500,757,1725032,23,0.330645161,0.838709677,0.951612903,4199
f3ab1e5b9e429a930bb3f9fd5a26dd12730c5110,0,Guozhang Wang,2019-01-13 11:43:48-08:00,['8afce0e338e3715824e309f6289af6bc607ce020'],7,19,26,1725058,1,,,,4199
eb61410a002e95a623425cc89348216a8da56ffe,0,Guozhang Wang,2019-01-13 16:57:08-08:00,['f3ab1e5b9e429a930bb3f9fd5a26dd12730c5110'],2,4,6,1725064,1,,,,4199
12947f4f944955240fd14ce8b75fab5464ea6808,0,Rajini Sivaram,2019-01-14 12:24:26+00:00,['eb61410a002e95a623425cc89348216a8da56ffe'],2,3,5,1725069,1,,,,4199
0206e6c306b68b8260658389c570188d60fb3df3,1,Manikumar Reddy,2019-01-14 21:22:25+05:18,['12947f4f944955240fd14ce8b75fab5464ea6808'],3,3,6,1725075,1,,,,4199
82d1db635826246570287cfb4c0b3572e3b011b4,1,GitHub,2019-01-14 13:36:36-08:00,['0206e6c306b68b8260658389c570188d60fb3df3'],496,1052,1548,1726623,24,0,1,0.98013245,4199
69d8d2ea11c5e08884ab4c7b8079af5fd21247be,1,Ewen Cheslack-Postava,2019-01-14 13:50:23-08:00,['82d1db635826246570287cfb4c0b3572e3b011b4'],103,1614,1717,1728340,24,0.643410853,1,0.841860465,4208
d8f126d70a5d67f283cf98dca60b41dbcd8b95ef,0,Jun Rao,2019-01-14 14:00:30-08:00,['69d8d2ea11c5e08884ab4c7b8079af5fd21247be'],1,1,2,1728342,1,,,,4208
aca52b6d2c1381646f211978735be59c0a7de1fd,1,Ewen Cheslack-Postava,2019-01-14 15:41:23-08:00,['d8f126d70a5d67f283cf98dca60b41dbcd8b95ef'],5,102,107,1728449,2,1,1,1,4208
13f679013aaa93198d30df8dada4aba5614790ea,0,Colin Patrick McCabe,2019-01-14 20:49:24-08:00,['aca52b6d2c1381646f211978735be59c0a7de1fd'],1,16,17,1728466,2,0,1,1,4208
af634a4a98eaa2457752e3f2841720020e0e9ad0,1,Jason Gustafson,2019-01-15 08:48:32-08:00,['13f679013aaa93198d30df8dada4aba5614790ea'],42,69,111,1728577,11,0.75,0.75,1,4208
3dffd5df2f7d4a8a3e512be5af908328c9d5e92e,0,GitHub,2019-01-15 10:19:03-08:00,['af634a4a98eaa2457752e3f2841720020e0e9ad0'],1,2,3,1728580,1,0,1,1,4208
68a6a7ae29c19070c2f3a7ee855dad3937c8159f,1,GitHub,2019-01-15 10:25:29-08:00,['3dffd5df2f7d4a8a3e512be5af908328c9d5e92e'],0,17,17,1728597,1,,,,4208
2e53fa08af6aba8200f4c7846a8e8e568b56560d,0,Colin Patrick McCabe,2019-01-15 11:52:48-08:00,['68a6a7ae29c19070c2f3a7ee855dad3937c8159f'],9,156,165,1728762,9,0.797468354,0.797468354,0.974683544,4209
9a9310d074ead70ebf3e93d29d880e094b9080f6,1,Jason Gustafson,2019-01-15 13:26:04-08:00,['2e53fa08af6aba8200f4c7846a8e8e568b56560d'],128,360,488,1729250,18,0.288732394,0.774647887,0.633802817,4210
dec68c9350dba6da9f38247db08f93dc0a798ebd,1,Ewen Cheslack-Postava,2019-01-16 22:58:30-08:00,['9a9310d074ead70ebf3e93d29d880e094b9080f6'],0,6,6,1729256,1,0,0,1,4210
2c44e77e2f2056ee88b4b9cc8bac1f769748830a,1,Jason Gustafson,2019-01-17 10:14:41-08:00,['dec68c9350dba6da9f38247db08f93dc0a798ebd'],96,730,826,1730082,15,0.459390863,1,0.814720812,4211
6a7eebe891d50ac0bf4d17bb870031718705fa37,0,Jun Rao,2019-01-17 15:30:16-08:00,['2c44e77e2f2056ee88b4b9cc8bac1f769748830a'],10,13,23,1730105,2,,,,4211
4b54eb46212a5d40d814ab36315f589d69782675,0,Jun Rao,2019-01-17 18:30:54-08:00,['6a7eebe891d50ac0bf4d17bb870031718705fa37'],1,3,4,1730109,1,1,1,1,4211
1221a348156c71c8aae4db61157a01c1862be789,0,Vahid Hashemian,2019-01-18 00:47:10-08:00,['4b54eb46212a5d40d814ab36315f589d69782675'],7,7,14,1730123,2,,,,4211
78076f9b2a40362e7c7194fb13dbee66d7342dfc,1,Guozhang Wang,2019-01-18 09:34:56-08:00,['1221a348156c71c8aae4db61157a01c1862be789'],0,1,1,1730124,1,0,1,1,4211
e1652de1198da66a7ee32241e63e137dd70c4cda,0,GitHub,2019-01-18 11:36:55-08:00,['78076f9b2a40362e7c7194fb13dbee66d7342dfc'],4,1,5,1730129,1,1,1,0,4211
56139df84495a67d311b160045497ec26f60c3a9,1,GitHub,2019-01-18 12:08:14-08:00,['e1652de1198da66a7ee32241e63e137dd70c4cda'],115,87,202,1730331,13,0,,0,4211
59f22521c097741a45528f0d4afb7ebceb62d47c,0,Ismael Juma,2019-01-18 20:54:57-08:00,['56139df84495a67d311b160045497ec26f60c3a9'],1,1,2,1730333,1,,,,4211
e19eb3e290cb7b7d2dc434b02648fe5c5726bdc2,1,GitHub,2019-01-19 09:39:57-08:00,['59f22521c097741a45528f0d4afb7ebceb62d47c'],48,195,243,1730576,16,0.319444444,1,0.930555556,4212
6cae2577bad5895a922dee96fdcd69182ebb7d0c,0,Vahid Hashemian,2019-01-19 13:14:50-08:00,['e19eb3e290cb7b7d2dc434b02648fe5c5726bdc2'],12,16,28,1730604,1,,,,4212
ed7b67dd1135e213ed7eda8ee2d733de7c965519,1,GitHub,2019-01-19 22:54:26-08:00,['6cae2577bad5895a922dee96fdcd69182ebb7d0c'],80,416,496,1731100,10,0,0.748743719,0.954773869,4214
e87e3f2cb286add0c315069b3b2a13c31d65043e,1,Vahid Hashemian,2019-01-20 13:25:35-08:00,['ed7b67dd1135e213ed7eda8ee2d733de7c965519'],14,6,20,1731120,5,1,1,0,4214
dc935c4beb49a83497536902f96c19fb7f472d41,1,Matthias J. Sax,2019-01-20 19:31:20-08:00,['e87e3f2cb286add0c315069b3b2a13c31d65043e'],6,77,83,1731203,4,0.208333333,1,1,4214
e75e4732c9ad67a5bf7a267346f0774c2a41b4e9,1,Manikumar Reddy,2019-01-21 11:49:36+05:18,['dc935c4beb49a83497536902f96c19fb7f472d41'],2,52,54,1731257,2,0.454545455,0.477272727,1,4214
913e87ac536e7e4f8350243d4d4da7dde265ed31,0,GitHub,2019-01-21 00:15:57-08:00,['e75e4732c9ad67a5bf7a267346f0774c2a41b4e9'],11,12,23,1731280,1,,,,4214
07d2cf2fdb0e3184ac2d5cdbc6b7f4ca94cfb828,0,Vahid Hashemian,2019-01-21 10:04:22-08:00,['913e87ac536e7e4f8350243d4d4da7dde265ed31'],1,1,2,1731282,1,,,,4214
fb0db7602abfd54137677d582a7781e4f790d7f9,0,Ismael Juma,2019-01-21 21:06:37-08:00,['07d2cf2fdb0e3184ac2d5cdbc6b7f4ca94cfb828'],137,57,194,1731476,18,0,0,0,4214
523465b3c17fc2ef67b0de10c78f83aae56606ae,0,GitHub,2019-01-22 08:35:14-08:00,['fb0db7602abfd54137677d582a7781e4f790d7f9'],22,73,95,1731571,4,0,0.945945946,1,4214
743607af5aa625a19377688709870b021014dee2,1,Ewen Cheslack-Postava,2019-01-23 11:00:23-08:00,['523465b3c17fc2ef67b0de10c78f83aae56606ae'],16,43,59,1731630,7,0.117647059,1,1,4214
f8e8d62f56c902f2445ab0af910decc3d5f01114,0,Colin Patrick McCabe,2019-01-23 13:39:47-08:00,['743607af5aa625a19377688709870b021014dee2'],5,8,13,1731643,1,,,,4214
0efed12f50f683131b31d33d787e2141122a5c11,1,Guozhang Wang,2019-01-23 16:00:26-08:00,['f8e8d62f56c902f2445ab0af910decc3d5f01114'],2,82,84,1731727,3,0.265306122,1,0.734693878,4214
86995adbdedb41766eb19d66c2683bc468b295b7,1,Guozhang Wang,2019-01-23 16:55:54-08:00,['0efed12f50f683131b31d33d787e2141122a5c11'],13,4,17,1731744,1,0.75,0,0,4214
a79d6dcdb687b1df911af024946880a5d9d5490a,0,GitHub,2019-01-24 09:26:51-08:00,['86995adbdedb41766eb19d66c2683bc468b295b7'],407,1204,1611,1733355,26,0.316091954,0.369731801,0.980842912,4222
ab4deb1bcbd41fac5e2ec14a78d5b3ca35955002,0,GitHub,2019-01-24 14:30:44-08:00,['a79d6dcdb687b1df911af024946880a5d9d5490a'],1,1,2,1733357,1,,,,4222
e4b54a5d97373368e601f47a74f9355b0a8dfbb1,1,Jason Gustafson,2019-01-24 16:28:01-08:00,['ab4deb1bcbd41fac5e2ec14a78d5b3ca35955002'],13,37,50,1733407,3,1,1,1,4222
0f926f0c1ee51f0db7649e63136310a29237ec84,0,Jason Gustafson,2019-01-24 16:45:08-08:00,['e4b54a5d97373368e601f47a74f9355b0a8dfbb1'],1,14,15,1733422,2,1,1,1,4222
ad3b6dd83571d06aa9b39c9c37e8663a017c6916,0,Ewen Cheslack-Postava,2019-01-24 22:19:19-08:00,['0f926f0c1ee51f0db7649e63136310a29237ec84'],40,41,81,1733503,2,,,,4222
64d6e56bd6bb8dcb3b0f65b141ad2533dbb90daf,1,Vahid Hashemian,2019-01-24 23:17:49-08:00,['ad3b6dd83571d06aa9b39c9c37e8663a017c6916'],31,169,200,1733703,1,,,,4222
0dbb064963cff16195b21b85ff117d9a91e23c34,0,Colin Patrick McCabe,2019-01-25 11:14:19-08:00,['64d6e56bd6bb8dcb3b0f65b141ad2533dbb90daf'],2,2,4,1733707,2,,,,4222
a65940cd820c68ee9613c7ff54676560cd01f88a,1,Guozhang Wang,2019-01-25 13:17:39-08:00,['0dbb064963cff16195b21b85ff117d9a91e23c34'],17,53,70,1733777,3,,,,4222
269b65279c746bc54c611141a5a6509f9b310f11,1,Jun Rao,2019-01-25 14:06:18-08:00,['a65940cd820c68ee9613c7ff54676560cd01f88a'],82,1798,1880,1735657,35,0.327951564,0.634712412,0.887991927,4231
ef89cf4eb687dbcca719acca09c98ded001d12dd,1,Jun Rao,2019-01-25 14:11:31-08:00,['269b65279c746bc54c611141a5a6509f9b310f11'],5,14,19,1735676,1,0,1,1,4231
1a47febd5ba6a58b651482619e7ea1cfe161c066,0,Colin Patrick McCabe,2019-01-25 17:27:35-08:00,['ef89cf4eb687dbcca719acca09c98ded001d12dd'],1,1,2,1735678,1,,,,4231
646ec948794c927e4ffa5f96d60b5b9f7fe8f228,0,Jun Rao,2019-01-25 19:40:50-08:00,['1a47febd5ba6a58b651482619e7ea1cfe161c066'],1,9,10,1735688,1,1,1,1,4231
203f58bb840e10e1e9c0d7807c49b04882699958,0,Vahid Hashemian,2019-01-25 20:37:31-08:00,['646ec948794c927e4ffa5f96d60b5b9f7fe8f228'],1,1,2,1735690,1,,,,4231
ef62dd3ef2f88d990bff21e3ff825c992e65fa10,1,GitHub,2019-01-25 23:56:39-08:00,['203f58bb840e10e1e9c0d7807c49b04882699958'],409,511,920,1736610,16,1,1,0,4234
c7dfbb91df1f97baa6175a80ce1325bca85066da,0,GitHub,2019-01-26 21:10:56-08:00,['ef62dd3ef2f88d990bff21e3ff825c992e65fa10'],1,1,2,1736612,1,,,,4234
aca027e96cff818177e52196f676a9d3a2a980b4,0,Matthias J. Sax,2019-01-26 21:38:19-08:00,['c7dfbb91df1f97baa6175a80ce1325bca85066da'],35,667,702,1737314,9,0.560283688,1,1,4238
1fa02d5aef1febfc7258b88385545463386634a8,1,GitHub,2019-01-29 11:15:43-08:00,['aca027e96cff818177e52196f676a9d3a2a980b4'],31,40,71,1737385,3,0.333333333,0.333333333,1,4238
201022d19eac50a4bce8ccfa12c8e233f2b5cad6,0,GitHub,2019-01-30 15:57:56-08:00,['1fa02d5aef1febfc7258b88385545463386634a8'],98,97,195,1737580,11,0,1,1,4238
73565b7f679c281f83a5df11e662b0f27cb1e55d,1,GitHub,2019-01-30 16:13:19-08:00,['201022d19eac50a4bce8ccfa12c8e233f2b5cad6'],252,2761,3013,1740593,12,0.734693878,0.89047619,0.980272109,4245
9d5893d3d5c548ffbc11b8aa880f5a280892e47a,1,GitHub,2019-01-30 17:31:31-08:00,['73565b7f679c281f83a5df11e662b0f27cb1e55d'],108,158,266,1740859,16,1,0.928571429,0,4245
dc634f18f7ea2ef24d202d6a2380365754005b60,1,Colin Patrick McCabe,2019-01-31 10:25:18-08:00,['9d5893d3d5c548ffbc11b8aa880f5a280892e47a'],136,82,218,1741077,12,0,0,0.238095238,4245
3ebf058123b230d7c2c6686a8c9dd7af1565bd99,0,Colin Patrick McCabe,2019-01-31 10:29:55-08:00,['dc634f18f7ea2ef24d202d6a2380365754005b60'],1,1,2,1741079,1,,,,4245
4b29487fa9d3d4ff8adaaaa6204db796eccd3a68,1,Ismael Juma,2019-02-01 06:02:25-08:00,['3ebf058123b230d7c2c6686a8c9dd7af1565bd99'],62,181,243,1741322,4,0,0.592105263,0.592105263,4245
176ea0d0f9b4386cdc0e3b9bab560a11e3d3d516,0,Jason Gustafson,2019-02-01 14:17:52-08:00,['4b29487fa9d3d4ff8adaaaa6204db796eccd3a68'],0,4,4,1741326,1,0,1,1,4245
2ca54cfd33a98d7f2d1834a7fbe55525776efa7e,0,GitHub,2019-02-01 14:21:35-08:00,['176ea0d0f9b4386cdc0e3b9bab560a11e3d3d516'],2,3,5,1741331,1,,,,4245
1f85e8e9235141e1cc5c752c19740e769e03e034,1,Manikumar Reddy,2019-02-01 14:24:12-08:00,['2ca54cfd33a98d7f2d1834a7fbe55525776efa7e'],354,1416,1770,1743101,7,0.781002639,0.986807388,1,4246
4420d9ec67fcd437cf55b4ca70a0180615215c8a,1,Jason Gustafson,2019-02-01 19:56:39-08:00,['1f85e8e9235141e1cc5c752c19740e769e03e034'],32,334,366,1743467,12,0.344497608,0.602870813,0.889952153,4247
9dc76f8872b862ca008562cdcf8cf50524e2eaa3,1,Matthias J. Sax,2019-02-01 21:29:00-08:00,['4420d9ec67fcd437cf55b4ca70a0180615215c8a'],32,142,174,1743641,7,0.075,0.95,0.9,4247
64b2d4fc0467607055d07773d0a29ae4c34d8ba2,0,Ismael Juma,2019-02-02 12:22:57-08:00,['9dc76f8872b862ca008562cdcf8cf50524e2eaa3'],1,11,12,1743653,1,,,,4247
66129b15181615a16e524c52c036cbb15aa25910,0,Ismael Juma,2019-02-02 12:38:28-08:00,['64b2d4fc0467607055d07773d0a29ae4c34d8ba2'],2,6,8,1743661,1,1,1,1,4247
4d70e8971fb5f43021cd0d38630faa9ac23161a2,0,Vahid Hashemian,2019-02-02 15:15:42-08:00,['66129b15181615a16e524c52c036cbb15aa25910'],2,2,4,1743665,1,,,,4247
e2e8bdbd8cb6ca2ac962c72147d21a9e8b9ba2c0,1,GitHub,2019-02-04 10:39:43-08:00,['4d70e8971fb5f43021cd0d38630faa9ac23161a2'],674,461,1135,1744800,19,0,0,0,4247
776041db112be8a9ba98130d7394da61e82bbd26,1,Manikumar Reddy,2019-02-04 13:46:33-08:00,['e2e8bdbd8cb6ca2ac962c72147d21a9e8b9ba2c0'],19,22,41,1744841,7,,,,4247
e942e294f0a700cdc2f94bb7f967c2e9bcb1a271,0,Manikumar Reddy,2019-02-04 14:27:50-08:00,['776041db112be8a9ba98130d7394da61e82bbd26'],7,22,29,1744870,1,1,1,0,4247
83c435f3babec485cf2091532191fe5420c27820,0,Ewen Cheslack-Postava,2019-02-04 16:46:03-08:00,['e942e294f0a700cdc2f94bb7f967c2e9bcb1a271'],8,39,47,1744917,3,0.888888889,1,0.277777778,4247
7debda4d41e7c951fe54b8b916d4b87cc7843348,0,Rajini Sivaram,2019-02-05 12:29:54+00:00,['83c435f3babec485cf2091532191fe5420c27820'],8,34,42,1744959,3,1,1,0.307692308,4247
4be68c58da6bbd16cb5682dbf1c9b5b1c93500a7,0,GitHub,2019-02-06 16:42:02-08:00,['7debda4d41e7c951fe54b8b916d4b87cc7843348'],0,780,780,1745739,5,0.373937677,0.750708215,0.861189802,4252
8147846acb5efd0c0bb5274b68f19cd34fe4f402,0,GitHub,2019-02-07 02:00:57-08:00,['4be68c58da6bbd16cb5682dbf1c9b5b1c93500a7'],5,10,15,1745754,1,1,1,1,4252
08dbec7429ba0e5ffac816dab3e465caf75a4c03,0,Vahid Hashemian,2019-02-07 07:59:32-08:00,['8147846acb5efd0c0bb5274b68f19cd34fe4f402'],1,1,2,1745756,1,,,,4252
9f7e6b291309286e3e3c1610e98d978773c9d504,0,Rajini Sivaram,2019-02-07 18:06:01+00:00,['08dbec7429ba0e5ffac816dab3e465caf75a4c03'],14,230,244,1746000,4,0.015873016,0.944444444,1,4253
d152989f26f51b9004b881397db818ad6eaf0392,1,GitHub,2019-02-08 09:22:13-08:00,['9f7e6b291309286e3e3c1610e98d978773c9d504'],358,496,854,1746854,21,0.8,0.838095238,0.99047619,4253
2fb9b03d6f19abada6babeec777a4452e989bc15,0,Guozhang Wang,2019-02-08 13:47:53-08:00,['d152989f26f51b9004b881397db818ad6eaf0392'],9,11,20,1746874,1,0,0,1,4253
c6528424dfce22f18a6938f1bcc9409811719dc3,1,Ismael Juma,2019-02-10 00:45:57-08:00,['2fb9b03d6f19abada6babeec777a4452e989bc15'],2,3,5,1746879,1,,,,4253
5148d7b0ae1ff4ac5f8c500d345045c050b47f88,0,GitHub,2019-02-11 22:23:54+00:00,['c6528424dfce22f18a6938f1bcc9409811719dc3'],13,75,88,1746967,2,0.272727273,1,1,4253
3fb1d70b6b2dbb78aafe60bae081237980fcd326,1,Vahid Hashemian,2019-02-11 14:39:02-08:00,['5148d7b0ae1ff4ac5f8c500d345045c050b47f88'],10,91,101,1747068,2,0.14516129,0.903225806,1,4253
d2575f03a38a1aaa1ac3a276eb86fce866548dec,0,GitHub,2019-02-11 14:46:49-08:00,['3fb1d70b6b2dbb78aafe60bae081237980fcd326'],10,10,20,1747088,8,,,,4253
08036fa4b1e5b8227fef78c5693897f19bb80de9,0,Manikumar Reddy,2019-02-12 09:21:30+05:18,['d2575f03a38a1aaa1ac3a276eb86fce866548dec'],3,80,83,1747171,3,0.882352941,0.882352941,1,4253
c7f99bc2bd9af5eb6ca9e20a02d5806c52d434b3,1,GitHub,2019-02-11 22:06:14-08:00,['08036fa4b1e5b8227fef78c5693897f19bb80de9'],276,251,527,1747698,42,0,1,1,4253
c0d6fac2385f88feb892666cfa778c1ac0ef8c6b,0,Ismael Juma,2019-02-12 06:40:01-08:00,['c7f99bc2bd9af5eb6ca9e20a02d5806c52d434b3'],7,8,15,1747713,1,,,,4253
637355138a426eb678b2cc9348ac07f970f20764,0,GitHub,2019-02-12 11:58:26-08:00,['c0d6fac2385f88feb892666cfa778c1ac0ef8c6b'],15,71,86,1747799,2,0,1,1,4253
41f2628bde88050fb1be8c2c1c4069caffc84471,0,GitHub,2019-02-12 12:00:33-08:00,['637355138a426eb678b2cc9348ac07f970f20764'],24,24,48,1747847,2,0,0,0,4253
ec42e0378e7c66b8ceadc480bca6f98ad1df0643,1,Gwen Shapira,2019-02-12 12:03:08-08:00,['41f2628bde88050fb1be8c2c1c4069caffc84471'],80,62,142,1747989,4,0.142857143,1,0.857142857,4253
62b22496c22563c30eec4f84c0083e15d2abbdf0,0,Gwen Shapira,2019-02-12 17:39:27-08:00,['ec42e0378e7c66b8ceadc480bca6f98ad1df0643'],3,3,6,1747995,2,,,,4253
826b6d9424d0748d4eac28dd8475a31d0529b63a,0,Manikumar Reddy,2019-02-13 11:33:59+05:18,['62b22496c22563c30eec4f84c0083e15d2abbdf0'],12,12,24,1748019,1,,,,4253
0a1c26934757afae4dce49ff3ee038311ca6dd4a,1,GitHub,2019-02-12 22:36:40-08:00,['826b6d9424d0748d4eac28dd8475a31d0529b63a'],158,274,432,1748451,13,0,0.305882353,1,4253
b02b5b63a5d43ab552c6cec1237707b2edd1bb36,1,Jason Gustafson,2019-02-13 09:51:35-08:00,['0a1c26934757afae4dce49ff3ee038311ca6dd4a'],31,158,189,1748640,5,0.344086022,0.870967742,0.946236559,4253
1aae604861068bb7337d4972c9dcc0c0a99c374d,0,Guozhang Wang,2019-02-13 12:10:10-08:00,['b02b5b63a5d43ab552c6cec1237707b2edd1bb36'],1,3,4,1748644,2,0,0,1,4253
8b97c3d8a96424e09f5e9ba1846625dfeb419923,0,Manikumar Reddy,2019-02-14 09:33:09+05:18,['1aae604861068bb7337d4972c9dcc0c0a99c374d'],6,6,12,1748656,2,,,,4253
01f0f0af28ea05921868171c88448e299766e773,1,Guozhang Wang,2019-02-14 08:38:01-08:00,['8b97c3d8a96424e09f5e9ba1846625dfeb419923'],460,347,807,1749463,28,1,0.398148148,0.074074074,4254
795f7331e27602fb2579d2aa12f048d546fc4de6,0,Guozhang Wang,2019-02-14 09:48:44-08:00,['01f0f0af28ea05921868171c88448e299766e773'],6,1,7,1749470,1,0,0,0,4254
b12b7f0435f6163af25bce8797b054762d65de5a,0,Matthias J. Sax,2019-02-14 09:59:01-08:00,['795f7331e27602fb2579d2aa12f048d546fc4de6'],0,1,1,1749471,1,0,1,1,4254
d0718718aecdb9030205fde30846b0b6481c762b,0,Jason Gustafson,2019-02-14 09:59:36-08:00,['b12b7f0435f6163af25bce8797b054762d65de5a'],1,6,7,1749478,2,0,1,1,4254
af91eeeb793af2f5b873c48ef8ff636e8b485308,1,Bill Bejeck,2019-02-14 13:39:10-05:00,['d0718718aecdb9030205fde30846b0b6481c762b'],7,12,19,1749497,4,,,,4254
c1918a2b9a9ba282efe92ddb867abef3d6d9b98c,0,Matthias J. Sax,2019-02-14 15:06:47-08:00,['af91eeeb793af2f5b873c48ef8ff636e8b485308'],662,499,1161,1750658,3,0.485294118,0.514705882,0.75,4254
a421dd2a26ca140f821cd5be1a4f716cf04beb43,0,GitHub,2019-02-14 17:13:20-08:00,['c1918a2b9a9ba282efe92ddb867abef3d6d9b98c'],109,50,159,1750817,15,0.884615385,1,0,4254
3656ad93bc7fb74138e36d39575c3b86c319577b,1,Bill Bejeck,2019-02-15 11:23:57-05:00,['a421dd2a26ca140f821cd5be1a4f716cf04beb43'],466,438,904,1751721,5,1,1,1,4255
ed3071231aee1ba8a5c2c496112dd6034f9bf942,0,Ewen Cheslack-Postava,2019-02-15 10:50:08-08:00,['3656ad93bc7fb74138e36d39575c3b86c319577b'],1,65,66,1751787,1,,,,4255
44257f293732588fc493f072b0cee4bd3a1840ab,0,Jason Gustafson,2019-02-15 16:50:01-08:00,['ed3071231aee1ba8a5c2c496112dd6034f9bf942'],0,9,9,1751796,2,1,1,1,4255
247ccd7ac97234d91ba8c6c58a54272e89cd81b4,0,Matthias J. Sax,2019-02-16 18:43:48-08:00,['44257f293732588fc493f072b0cee4bd3a1840ab'],45,142,187,1751983,3,0.694444444,0.486111111,0.916666667,4255
b53f84402890636e4990b102ba9f832a98b4e5df,1,GitHub,2019-02-17 02:54:58-08:00,['247ccd7ac97234d91ba8c6c58a54272e89cd81b4'],9,9,18,1752001,2,0,0,,4255
bc4fed315dd3b99b95bc5544f81cd7e5541aafdb,1,Matthias J. Sax,2019-02-17 10:10:28-08:00,['b53f84402890636e4990b102ba9f832a98b4e5df'],9,53,62,1752063,4,0.5,1,1,4256
decc09b0128a01048928c6ceddc98065dae2dadb,1,Ismael Juma,2019-02-18 00:05:42-08:00,['bc4fed315dd3b99b95bc5544f81cd7e5541aafdb'],7,25,32,1752095,4,,,,4256
0846f590dac5d3893d41e262d67ee8a228dcc332,1,Matthias J. Sax,2019-02-18 10:14:37-08:00,['decc09b0128a01048928c6ceddc98065dae2dadb'],180,183,363,1752458,27,1,0.055555556,0,4256
45a896e74166a15daf9d8d05d3459f7f6b237de2,1,Rajini Sivaram,2019-02-18 18:19:15+00:00,['0846f590dac5d3893d41e262d67ee8a228dcc332'],4,66,70,1752528,2,0,1,1,4256
9fe89f357ced1f75d5c7053979e8ec6430041885,0,Bill Bejeck,2019-02-18 14:22:41-05:00,['45a896e74166a15daf9d8d05d3459f7f6b237de2'],40,19,59,1752587,1,,,,4256
e17352f03ebabc1fd6a8289392b55a2191fd2dfd,1,GitHub,2019-02-18 11:42:41-08:00,['9fe89f357ced1f75d5c7053979e8ec6430041885'],204,302,506,1753093,7,0.46,1,0.84,4256
4cb8f56b45f3bfb596fb00ef2cc88938fc66f364,1,Jason Gustafson,2019-02-19 16:14:13-08:00,['e17352f03ebabc1fd6a8289392b55a2191fd2dfd'],15,285,300,1753393,6,0.347305389,0.814371257,0.868263473,4256
71a7219dfdc0a40dc1846c749d2f219776b56955,1,Jason Gustafson,2019-02-20 08:44:04-08:00,['4cb8f56b45f3bfb596fb00ef2cc88938fc66f364'],64,142,206,1753599,10,0.028571429,0.871428571,0.871428571,4256
be765600111246430f4d61689e068cc55a1ade7b,0,GitHub,2019-02-20 12:45:22-05:00,['71a7219dfdc0a40dc1846c749d2f219776b56955'],0,22,22,1753621,1,1,1,1,4256
74ad46d880884f9b1435ef10d813a4c6ca843240,0,Rajini Sivaram,2019-02-20 21:26:41+00:00,['be765600111246430f4d61689e068cc55a1ade7b'],4,103,107,1753728,2,0.098360656,0.918032787,1,4256
18984434df5295b0940e468ffb467c47b0fd72dd,1,GitHub,2019-02-20 19:09:23-05:00,['74ad46d880884f9b1435ef10d813a4c6ca843240'],2,4,6,1753734,2,,,,4256
071f62a356e2f3e1255b48597ef5468cffe9dd29,0,Matthias J. Sax,2019-02-20 17:02:30-08:00,['18984434df5295b0940e468ffb467c47b0fd72dd'],7,16,23,1753757,1,1,1,1,4256
ff603c63bb3e0b47ce14121bb0e96ce0fc42d3c1,1,Guozhang Wang,2019-02-20 19:09:50-08:00,['071f62a356e2f3e1255b48597ef5468cffe9dd29'],2,1005,1007,1754764,7,0.514084507,1,0.757042254,4259
2932d32afb293b2c230a6d73b2eb134ef2828c56,1,Jun Rao,2019-02-20 21:50:31-08:00,['ff603c63bb3e0b47ce14121bb0e96ce0fc42d3c1'],51,157,208,1754972,7,0.25,1,1,4259
83281ba0e49693207b8c657dc4cd6c0f6d130928,0,GitHub,2019-02-20 23:17:58-08:00,['2932d32afb293b2c230a6d73b2eb134ef2828c56'],9,31,40,1755012,1,0,1,1,4259
8de3092b0579a2319fb1191b4a66e573bc2b0781,1,Matthias J. Sax,2019-02-20 23:38:55-08:00,['83281ba0e49693207b8c657dc4cd6c0f6d130928'],1,6,7,1755019,1,1,1,1,4259
35a0de32ee3823dfb548a1cd5d5faf4f7c99e4e0,0,Guozhang Wang,2019-02-21 09:05:13-08:00,['8de3092b0579a2319fb1191b4a66e573bc2b0781'],307,33,340,1755359,37,0.077669903,0,0,4259
a8ed8e74951c6412aebee3395ef043938b274c93,0,Vahid Hashemian,2019-02-21 12:55:14-08:00,['35a0de32ee3823dfb548a1cd5d5faf4f7c99e4e0'],1,1,2,1755361,1,,,,4259
c9cf6e2176bec3091c069031c70e46b0162f8095,0,GitHub,2019-02-21 13:03:34-08:00,['a8ed8e74951c6412aebee3395ef043938b274c93'],4,5,9,1755370,2,,,,4259
f775be0514dc6a512245fd244e06e0aa11cc45c4,0,GitHub,2019-02-21 13:11:36-08:00,['c9cf6e2176bec3091c069031c70e46b0162f8095'],16,66,82,1755452,3,0.4,1,1,4260
201da0542726472d954080d54bc585b111aaf86f,1,Jason Gustafson,2019-02-21 14:18:36-08:00,['f775be0514dc6a512245fd244e06e0aa11cc45c4'],57,186,243,1755695,7,0.604651163,1,0.779069767,4260
342c336bf9706a99c65c7fd42b0f5edeccb8adbe,0,Bill Bejeck,2019-02-21 19:41:03-05:00,['201da0542726472d954080d54bc585b111aaf86f'],3,5,8,1755703,1,,,,4260
93ba9621fe0ebe2945fe5d14a3c94abc5cffd7b4,0,Bill Bejeck,2019-02-22 12:07:30-05:00,['342c336bf9706a99c65c7fd42b0f5edeccb8adbe'],4,12,16,1755719,1,,,,4260
217f45ed554b34d5221e1dd3db76e4be892661cf,0,Jun Rao,2019-02-22 09:11:21-08:00,['93ba9621fe0ebe2945fe5d14a3c94abc5cffd7b4'],4,25,29,1755748,4,0,0.642857143,0.642857143,4260
0d461e4ea0a8353c358ae661837f471995943bb0,0,GitHub,2019-02-22 10:50:55-08:00,['217f45ed554b34d5221e1dd3db76e4be892661cf'],60,73,133,1755881,7,0,1,1,4260
eb8cc09625c9913c4029763a46d4b7e5639c85f5,1,Jason Gustafson,2019-02-22 20:51:09-08:00,['0d461e4ea0a8353c358ae661837f471995943bb0'],39,171,210,1756091,8,0.022988506,0.770114943,0.908045977,4260
1f9aa01a5b3b59d90499a059d719af03483d5130,1,Guozhang Wang,2019-02-22 21:49:28-08:00,['eb8cc09625c9913c4029763a46d4b7e5639c85f5'],56,71,127,1756218,15,0,1,0.888888889,4260
b3689b0c0e09851f41dd7013e57178760de70743,0,Bill Bejeck,2019-02-23 09:03:00-05:00,['1f9aa01a5b3b59d90499a059d719af03483d5130'],2,2,4,1756222,1,,,,4260
0150dbc1d0ad052664054d17826348c2eb1eefaf,0,Vahid Hashemian,2019-02-23 08:41:03-08:00,['b3689b0c0e09851f41dd7013e57178760de70743'],0,4,4,1756226,1,1,1,1,4260
e82cc50ddb229a081787b920a8d27aea54f4bfd6,0,Vahid Hashemian,2019-02-23 09:31:33-08:00,['0150dbc1d0ad052664054d17826348c2eb1eefaf'],27,5,32,1756258,1,0,0,0,4260
12e8b8c2c7ddce09daa449d9843e9fa08cd538f1,1,Matthias J. Sax,2019-02-23 12:09:46-08:00,['e82cc50ddb229a081787b920a8d27aea54f4bfd6'],2,19,21,1756279,1,0.785714286,1,1,4260
4824dc994d7fc56b7540b643a78aadb4bdd0f14d,0,Manikumar Reddy,2019-02-25 11:08:07+05:18,['12e8b8c2c7ddce09daa449d9843e9fa08cd538f1'],116,86,202,1756481,12,0,0,0,4260
489a6e1674df4ec4943c2751652446aaad6037eb,0,Matthias J. Sax,2019-02-25 18:20:02-08:00,['4824dc994d7fc56b7540b643a78aadb4bdd0f14d'],2,1,3,1756484,1,,,,4260
21b79635474209fcd67d3bf33a70c25f6827c6ef,1,Guozhang Wang,2019-02-25 19:59:14-08:00,['489a6e1674df4ec4943c2751652446aaad6037eb'],65,230,295,1756779,12,1,1,1,4261
2627a1be2cf5ef865fd1da0bc81680df9612655a,0,Randall Hauch,2019-02-25 23:26:59-06:00,['21b79635474209fcd67d3bf33a70c25f6827c6ef'],2,2,4,1756783,1,,,,4261
dc91ce58af941b822fbad3b560c35774130848f0,1,Bill Bejeck,2019-02-26 10:22:25-05:00,['2627a1be2cf5ef865fd1da0bc81680df9612655a'],95,46,141,1756924,17,0.934782609,0.065217391,0.369565217,4261
66a6fc7204b3903ae8015bc8bceb200b6838ec10,1,GitHub,2019-02-26 08:38:32-08:00,['dc91ce58af941b822fbad3b560c35774130848f0'],19,55,74,1756998,2,0.8,1,1,4261
bd6520a22a773b94aece20826bb00189986b3966,0,Jun Rao,2019-02-26 09:55:38-08:00,['66a6fc7204b3903ae8015bc8bceb200b6838ec10'],4,12,16,1757014,2,0.857142857,0.857142857,1,4261
49f1096814c089081e75f6e87b0d5867c7f01430,0,Matthias J. Sax,2019-02-26 19:13:27-08:00,['bd6520a22a773b94aece20826bb00189986b3966'],9,9,18,1757032,1,,,,4261
a8f2307164ce0f1f47c458eee8f54173f7218a16,1,Bill Bejeck,2019-02-27 10:08:08-05:00,['49f1096814c089081e75f6e87b0d5867c7f01430'],252,126,378,1757410,14,0.647887324,0,0.549295775,4261
f667f573ff12321f2913ccf17cdf9e9bcc97b550,0,Rajini Sivaram,2019-02-27 20:36:49+00:00,['a8f2307164ce0f1f47c458eee8f54173f7218a16'],1,8,9,1757419,1,1,1,1,4261
a1f7925d23be0b81cb77561d2113443df52c6f74,1,Vahid Hashemian,2019-02-27 22:27:38-08:00,['f667f573ff12321f2913ccf17cdf9e9bcc97b550'],2,36,38,1757457,2,1,1,1,4261
dfae20eceed67924c7122698a2c2f8b50a339133,0,Matthias J. Sax,2019-02-28 00:20:44-08:00,['a1f7925d23be0b81cb77561d2113443df52c6f74'],0,1,1,1757458,1,,,,4261
abbd992a4a06031918478ef1460f9dc069ffab6c,0,Matthias J. Sax,2019-02-28 09:22:54-08:00,['dfae20eceed67924c7122698a2c2f8b50a339133'],1,1,2,1757460,1,,,,4261
18b3a878a06dc1d5b6cb3f25ff7af8a5a1ff3798,0,Jason Gustafson,2019-02-28 09:32:02-08:00,['abbd992a4a06031918478ef1460f9dc069ffab6c'],7,9,16,1757476,3,0.5,1,1,4261
3c46b5669de856f4510b8d291a8af7dbd809c07b,1,GitHub,2019-02-28 09:33:53-08:00,['18b3a878a06dc1d5b6cb3f25ff7af8a5a1ff3798'],637,856,1493,1758969,33,1,1,1,4262
a7ce7e37f370b1e2b35e3c9588f49b136884818b,0,GitHub,2019-02-28 11:55:29-08:00,['3c46b5669de856f4510b8d291a8af7dbd809c07b'],17,17,34,1759003,1,,,,4262
47b51260fda33e3fa7916b69e2f2e80e3a147e32,0,Jason Gustafson,2019-02-28 13:33:51-08:00,['a7ce7e37f370b1e2b35e3c9588f49b136884818b'],1,1,2,1759005,1,,,,4262
33e005994debd26ea245a16137e0b9e1af57a22c,0,Jason Gustafson,2019-02-28 13:43:09-08:00,['47b51260fda33e3fa7916b69e2f2e80e3a147e32'],2,2,4,1759009,2,,,,4262
09136235db2fcae5282a218de75b6356f9420031,1,Guozhang Wang,2019-02-28 14:47:27-08:00,['33e005994debd26ea245a16137e0b9e1af57a22c'],15,25,40,1759049,2,1,1,1,4262
45adc80366e6e61187484d7e88467df05af2470f,1,GitHub,2019-02-28 18:54:25-05:00,['09136235db2fcae5282a218de75b6356f9420031'],2,3,5,1759054,1,,,,4262
70828cea49ab8a3ceb54a9017618b84e0d9c1420,0,Jason Gustafson,2019-02-28 16:37:30-08:00,['45adc80366e6e61187484d7e88467df05af2470f'],13,89,102,1759156,2,0.25,1,1,4262
b03e8c234a8aeecd10c2c96b683cfb39b24b548a,1,Guozhang Wang,2019-02-28 17:39:47-08:00,['70828cea49ab8a3ceb54a9017618b84e0d9c1420'],102,84,186,1759342,2,0.222222222,0,0,4262
f11fa5ef402193e2da785466e698e11b56bd19c7,1,Manikumar Reddy,2019-03-01 21:11:52+05:18,['b03e8c234a8aeecd10c2c96b683cfb39b24b548a'],375,462,837,1760179,21,0.55952381,0.857142857,0.80952381,4263
caecc16b5cc9c85acda50d68384a1ff9ebf930c9,0,Guozhang Wang,2019-03-01 08:54:57-08:00,['f11fa5ef402193e2da785466e698e11b56bd19c7'],0,3,3,1760182,1,0,1,1,4263
057bb35f24b2b14092edbcf56a6fa06dd1102fd6,0,Guozhang Wang,2019-03-01 11:20:41-08:00,['caecc16b5cc9c85acda50d68384a1ff9ebf930c9'],1,1,2,1760184,1,,,,4263
33ba2820f4fbb459172022a83d761a7c674a8fdd,1,GitHub,2019-03-01 15:39:23-08:00,['057bb35f24b2b14092edbcf56a6fa06dd1102fd6'],112,1202,1314,1761498,26,0.953907816,0.997995992,0.917835671,4274
57604c2331d8fb307ce9a18c14036746a18df552,1,Jason Gustafson,2019-03-01 17:39:42-08:00,['33ba2820f4fbb459172022a83d761a7c674a8fdd'],66,115,181,1761679,11,0,1,1,4274
0d56f1413557adabc736cae2dffcdc56a620403e,1,Manikumar Reddy,2019-03-02 21:16:30+05:18,['57604c2331d8fb307ce9a18c14036746a18df552'],128,98,226,1761905,11,0,0,1,4274
9ee5f920d5e4b837c3240dff948e120aaef7cd23,0,Manikumar Reddy,2019-03-05 00:26:15+05:18,['0d56f1413557adabc736cae2dffcdc56a620403e'],3,7,10,1761915,2,,,,4274
d930e5d3d85697a9a851ab2de98e7d8ca567d001,0,Randall Hauch,2019-03-04 17:57:45-06:00,['9ee5f920d5e4b837c3240dff948e120aaef7cd23'],3,3,6,1761921,3,,,,4274
20f701cc505f6bca01c41f85cb38bbb32554fbfb,1,Randall Hauch,2019-03-04 18:04:34-06:00,['d930e5d3d85697a9a851ab2de98e7d8ca567d001'],0,4,4,1761925,1,0,1,1,4274
5e161736597e0430dd276ac9007d8559733af3e2,0,Jason Gustafson,2019-03-05 18:12:47-08:00,['20f701cc505f6bca01c41f85cb38bbb32554fbfb'],0,8,8,1761933,1,0,0,1,4274
3747f553366a50ae123c6176cd339e078bed33c1,1,GitHub,2019-03-06 09:55:05+00:00,['5e161736597e0430dd276ac9007d8559733af3e2'],5,9,14,1761947,1,1,0,0,4274
2bb74bfc3bc7e94c00280a7de884b95f160f8797,0,GitHub,2019-03-06 14:13:32+00:00,['3747f553366a50ae123c6176cd339e078bed33c1'],2,6,8,1761955,1,0.5,1,1,4274
14d97aabad1d5aab4b9407e24ab523157832934b,1,Bill Bejeck,2019-03-06 12:17:58-05:00,['2bb74bfc3bc7e94c00280a7de884b95f160f8797'],6,12,18,1761973,4,,,,4274
3a50dc27b994ea73228a989b4047b4bd54e31ed7,0,GitHub,2019-03-06 17:33:26+00:00,['14d97aabad1d5aab4b9407e24ab523157832934b'],0,5,5,1761978,1,0,1,1,4274
1db46673661cf6dcb7f2fa2565262b04cf580367,1,Jason Gustafson,2019-03-06 09:52:09-08:00,['3a50dc27b994ea73228a989b4047b4bd54e31ed7'],176,200,376,1762354,4,1,1,1,4274
e62e23099b8de2414b2961e7d87be311e06db4e1,0,Bill Bejeck,2019-03-06 13:54:36-05:00,['1db46673661cf6dcb7f2fa2565262b04cf580367'],3,2,5,1762359,1,,,,4274
8662efbad24c859aeee5c3b469dbc907e39ff82d,1,Matthias J. Sax,2019-03-06 10:56:44-08:00,['e62e23099b8de2414b2961e7d87be311e06db4e1'],7,46,53,1762412,3,1,1,1,4274
47888630a05260f548988d943a633120845f767d,1,Bill Bejeck,2019-03-06 14:02:27-05:00,['8662efbad24c859aeee5c3b469dbc907e39ff82d'],120,284,404,1762816,2,0.576576577,1,1,4274
ab00c51b6362b41071ae32611ebf698ba9c221ee,1,GitHub,2019-03-06 14:57:08-08:00,['47888630a05260f548988d943a633120845f767d'],19,1300,1319,1764135,17,0.874538745,1,0.950184502,4285
240d7589d624b72fa95e2f84a84778bc3a127927,0,Bill Bejeck,2019-03-06 21:19:47-05:00,['ab00c51b6362b41071ae32611ebf698ba9c221ee'],76,110,186,1764321,4,,,,4285
7f6bf95c1e4875b1042746e3d73240496073f081,1,Colin Patrick McCabe,2019-03-07 00:07:23-08:00,['240d7589d624b72fa95e2f84a84778bc3a127927'],34,66,100,1764421,4,1,1,0.9,4285
73737892d5a51688b3403454b6e0f1f59c85ba8d,0,Manikumar Reddy,2019-03-07 15:21:54+05:18,['7f6bf95c1e4875b1042746e3d73240496073f081'],4,27,31,1764452,3,0,1,0,4285
b10d311f8a6c88149a4859c6ca0d2f53bfe2fc35,0,GitHub,2019-03-07 13:22:16+00:00,['73737892d5a51688b3403454b6e0f1f59c85ba8d'],6,14,20,1764472,2,0.5,1,1,4285
f708e782947c340b480882d61f28a98623226583,0,Manikumar Reddy,2019-03-07 21:43:14+05:18,['b10d311f8a6c88149a4859c6ca0d2f53bfe2fc35'],1,1,2,1764474,1,,,,4285
644ff6e60f9ee7126cf02ee839610dab82037ac9,1,GitHub,2019-03-07 18:09:50+00:00,['f708e782947c340b480882d61f28a98623226583'],1,3,4,1764478,1,0,0,1,4285
1f525cd2c90ec81fa9c3967d1303a905d1afccb2,1,Jason Gustafson,2019-03-07 14:28:21-08:00,['644ff6e60f9ee7126cf02ee839610dab82037ac9'],1,76,77,1764555,2,0,1,1,4285
96c4e323bfc886b654b198896e78a7d21c80e30a,0,Bill Bejeck,2019-03-07 17:41:57-05:00,['1f525cd2c90ec81fa9c3967d1303a905d1afccb2'],20,41,61,1764616,1,,,,4285
ccd3af15669d38bc8dba3a376a23e9615faf98a2,0,Guozhang Wang,2019-03-07 15:05:35-08:00,['96c4e323bfc886b654b198896e78a7d21c80e30a'],38,44,82,1764698,2,0,0,0,4285
460e46c3bb76a361d0706b263c03696005e12566,1,GitHub,2019-03-07 16:29:19-08:00,['ccd3af15669d38bc8dba3a376a23e9615faf98a2'],1296,1980,3276,1767974,37,0.870870871,1,0.795795796,4291
027cbbaec521542f53274183daccc2073e91cfe9,1,Manikumar Reddy,2019-03-08 09:13:28+05:18,['460e46c3bb76a361d0706b263c03696005e12566'],3,26,29,1768003,5,0.55,0.55,1,4291
47bc85f2e76061d7cb9cdc05db74739c1441e72c,0,GitHub,2019-03-08 14:37:23+00:00,['027cbbaec521542f53274183daccc2073e91cfe9'],1,6,7,1768010,1,,,,4291
f716d08c9c7f0f3ec7456cb9a27a42104457b867,1,Bill Bejeck,2019-03-08 10:29:22-05:00,['47bc85f2e76061d7cb9cdc05db74739c1441e72c'],8,170,178,1768188,3,0.114503817,0.93129771,0.93129771,4291
460b3a6259388733771b312a55ff83805dc36e9b,0,GitHub,2019-03-08 16:57:58+00:00,['f716d08c9c7f0f3ec7456cb9a27a42104457b867'],4,4,8,1768196,4,,,,4291
44be5d2221c9faff2ecb17878d6193504b7289aa,0,Jason Gustafson,2019-03-08 09:04:04-08:00,['460b3a6259388733771b312a55ff83805dc36e9b'],1,32,33,1768229,2,0.892857143,0.892857143,1,4291
04e206154ac614b7d4d34a7a1b6ba2c882f607b9,1,Bill Bejeck,2019-03-08 12:30:00-05:00,['44be5d2221c9faff2ecb17878d6193504b7289aa'],83,635,718,1768947,13,0.764705882,0.984313725,0.894117647,4296
3619d2f383f65108dfd33686119f675aaeea54b7,1,Bill Bejeck,2019-03-08 15:31:34-05:00,['04e206154ac614b7d4d34a7a1b6ba2c882f607b9'],150,165,315,1769262,28,0.939393939,1,0.181818182,4296
09f1009d246b82475bbf018d187fff5a3e035539,1,GitHub,2019-03-08 19:24:26-08:00,['3619d2f383f65108dfd33686119f675aaeea54b7'],4,63,67,1769329,2,0.454545455,1,0.954545455,4296
da5f353401baaae3da9bc23690c1c9cbb28ecd56,0,GitHub,2019-03-09 08:09:56+00:00,['09f1009d246b82475bbf018d187fff5a3e035539'],1,1,2,1769331,1,,,,4296
0ef2b4cccea4196256ea28b5429ce95e2507928b,0,Bill Bejeck,2019-03-09 08:09:07-05:00,['da5f353401baaae3da9bc23690c1c9cbb28ecd56'],2,1,3,1769334,1,,,,4296
65aea1f362fb6562c39df34b4d5c014f544b45ec,0,Manikumar Reddy,2019-03-10 12:07:43+05:18,['0ef2b4cccea4196256ea28b5429ce95e2507928b'],5,16,21,1769355,2,1,1,1,4296
a42f16f980cba86a8889be8b7499437ecbc2cd42,1,Manikumar Reddy,2019-03-10 17:18:16+05:18,['65aea1f362fb6562c39df34b4d5c014f544b45ec'],526,559,1085,1770440,35,0.662251656,1,0.655629139,4296
173a7e3d54ede6616037d6c55057417dfeb44ab9,0,Manikumar Reddy,2019-03-11 19:36:52+05:18,['a42f16f980cba86a8889be8b7499437ecbc2cd42'],0,10,10,1770450,2,0.6,1,1,4296
1e1b669e9d3aa94773924909d154cad191cfde93,0,Manikumar Reddy,2019-03-11 23:34:49+05:18,['173a7e3d54ede6616037d6c55057417dfeb44ab9'],5,5,10,1770460,2,,,,4296
9aaa32b64d70646c429cd657980b330f7b85d542,0,GitHub,2019-03-11 18:43:46+00:00,['1e1b669e9d3aa94773924909d154cad191cfde93'],0,10,10,1770470,1,0.75,1,1,4296
290360692114baa74f6ca1963b6700c38594d876,0,Manikumar Reddy,2019-03-12 11:23:48+05:18,['9aaa32b64d70646c429cd657980b330f7b85d542'],2,24,26,1770496,2,1,1,1,4296
0f83c4cdb76c2123a4c365ebcdd9cfb7bf711a45,1,GitHub,2019-03-12 09:47:05+00:00,['290360692114baa74f6ca1963b6700c38594d876'],11,24,35,1770531,2,0,0,0,4296
9a384daf0eafb26e2e445c62659be78956c6e1c9,0,Jason Gustafson,2019-03-12 08:31:50-07:00,['0f83c4cdb76c2123a4c365ebcdd9cfb7bf711a45'],4,5,9,1770540,1,,,,4296
ab7ea07f5e57ec405dc7fddce95de7c639a2fd6e,0,Bill Bejeck,2019-03-12 12:28:14-04:00,['9a384daf0eafb26e2e445c62659be78956c6e1c9'],13,215,228,1770768,3,0.540145985,0.97080292,1,4296
8e975400711b0ea64bf4a00c8c551e448ab48416,1,Guozhang Wang,2019-03-12 09:53:29-07:00,['ab7ea07f5e57ec405dc7fddce95de7c639a2fd6e'],221,251,472,1771240,8,0,1,0,4296
2aca6241624f6b924b3e0164a9b7d021d80096b6,0,Matthias J. Sax,2019-03-12 11:05:53-07:00,['8e975400711b0ea64bf4a00c8c551e448ab48416'],11,16,27,1771267,1,1,1,1,4296
9ecadc4df474d9cfbfda3256f01eba1423cf5902,0,Guozhang Wang,2019-03-12 13:35:25-07:00,['2aca6241624f6b924b3e0164a9b7d021d80096b6'],61,14,75,1771342,2,1,0,0,4296
fd79dd060812af0531428cb2f7fd4aa74ea8124a,1,Jason Gustafson,2019-03-12 15:24:24-07:00,['9ecadc4df474d9cfbfda3256f01eba1423cf5902'],7,25,32,1771374,1,0,0,1,4296
a648ef0b44e9c3efbee3d66fc7dae85fea24a74b,0,Bill Bejeck,2019-03-13 12:16:48-04:00,['fd79dd060812af0531428cb2f7fd4aa74ea8124a'],8,8,16,1771390,4,,,,4296
d436f32e6b15b9ff8bc4a4ab0ce6dd0ec5f14a8d,0,GitHub,2019-03-14 19:29:33+00:00,['a648ef0b44e9c3efbee3d66fc7dae85fea24a74b'],2,0,2,1771392,1,1,0,0,4296
3ec2ca5e334ef42683263ed50c718c62917046af,1,Gwen Shapira,2019-03-14 16:18:52-07:00,['d436f32e6b15b9ff8bc4a4ab0ce6dd0ec5f14a8d'],102,441,543,1771935,7,0.567049808,1,0.954022989,4296
4ca8e40e2f4ab415657d1e07ee868448802f4565,0,Guozhang Wang,2019-03-14 18:42:07-07:00,['3ec2ca5e334ef42683263ed50c718c62917046af'],125,170,295,1772230,3,0.571428571,0.571428571,0.885714286,4296
ee3b9c57fd4ba37aa34396da44ed04e55b224c18,0,Manikumar Reddy,2019-03-15 12:12:42+05:18,['4ca8e40e2f4ab415657d1e07ee868448802f4565'],2,2,4,1772234,1,,,,4296
853f24a4a18b26b4e4cc03555673ee951067fa6e,0,Bill Bejeck,2019-03-15 10:56:48-04:00,['ee3b9c57fd4ba37aa34396da44ed04e55b224c18'],2,184,186,1772420,2,0.309278351,1,0.979381443,4296
a6691fb79e2c55b325513710c5e6e34e8dd4961e,0,GitHub,2019-03-15 15:36:22+00:00,['853f24a4a18b26b4e4cc03555673ee951067fa6e'],1,1,2,1772422,1,,,,4296
f20f3c1a97b8a31a2f211cd66506fb823f420c55,0,Colin Patrick McCabe,2019-03-15 09:53:21-07:00,['a6691fb79e2c55b325513710c5e6e34e8dd4961e'],16,51,67,1772489,2,1,1,0,4297
e1961b8298c6d7ec028cd95721f4b498689c506e,1,GitHub,2019-03-15 19:47:40-07:00,['f20f3c1a97b8a31a2f211cd66506fb823f420c55'],25,29,54,1772543,8,,,,4297
fd5c0849e119fa19b393c9900584a6ff8abe3a79,0,Matthias J. Sax,2019-03-15 19:51:20-07:00,['e1961b8298c6d7ec028cd95721f4b498689c506e'],3,3,6,1772549,1,,,,4297
20e3a3035b02388d46a4d7bf93370329aa405956,0,GitHub,2019-03-16 11:00:03+00:00,['fd5c0849e119fa19b393c9900584a6ff8abe3a79'],3,25,28,1772577,2,1,1,0.823529412,4297
74e755fdb1ea98c2f90f2127160f905ad3c00486,0,Rajini Sivaram,2019-03-16 11:03:35+00:00,['20e3a3035b02388d46a4d7bf93370329aa405956'],0,9,9,1772586,1,1,1,1,4297
938580ff6c5c27b1d7a3baf9cc09029ef3c2eb68,0,Ewen Cheslack-Postava,2019-03-17 18:50:55-07:00,['74e755fdb1ea98c2f90f2127160f905ad3c00486'],7,15,22,1772608,1,0,0,1,4297
6279b03813af58411951a94cfa3509f6ef14bec0,1,GitHub,2019-03-18 08:47:28+00:00,['938580ff6c5c27b1d7a3baf9cc09029ef3c2eb68'],12,22,34,1772642,2,0.777777778,1,1,4297
ca6ac9393bae9161465275cb8f836bc987a5098d,0,GitHub,2019-03-18 08:51:50+00:00,['6279b03813af58411951a94cfa3509f6ef14bec0'],10,29,39,1772681,4,1,1,0,4297
5192956581dad7eeb7796d51d85195102f151ab0,0,Rajini Sivaram,2019-03-18 16:48:49+00:00,['ca6ac9393bae9161465275cb8f836bc987a5098d'],2,5,7,1772688,1,0,1,1,4297
810bc69b7a474297aa345613cf18cb8bfb115603,1,GitHub,2019-03-18 18:07:24+00:00,['5192956581dad7eeb7796d51d85195102f151ab0'],3,9,12,1772700,2,0.666666667,1,1,4297
8406f3624d8f99b614eb7171b71fae8b0e663dcb,1,Colin Patrick McCabe,2019-03-18 13:26:09-07:00,['810bc69b7a474297aa345613cf18cb8bfb115603'],533,393,926,1773626,16,0,0,0,4297
70ddd8af71938b4f5f6d1bb3df6243ef13359bcf,0,Jason Gustafson,2019-03-18 23:00:01-07:00,['8406f3624d8f99b614eb7171b71fae8b0e663dcb'],18,30,48,1773674,4,0.666666667,1,1,4297
6d649f503a964ed9612e79ef2d9e55e26240fbc3,1,Bill Bejeck,2019-03-19 10:12:49-04:00,['70ddd8af71938b4f5f6d1bb3df6243ef13359bcf'],8,69,77,1773751,3,0,1,1,4297
538bd7eddf13897245524f015e3207affb03fcdc,1,Bill Bejeck,2019-03-19 11:51:10-04:00,['6d649f503a964ed9612e79ef2d9e55e26240fbc3'],51,21,72,1773823,4,0,0,0,4297
5092b26393de731e8f826fde86b7ea97c9aaba35,0,Bill Bejeck,2019-03-19 18:01:59-04:00,['538bd7eddf13897245524f015e3207affb03fcdc'],13,10,23,1773846,1,,,,4297
70ee72491fead119b18384e06cb93e66f81799b3,1,Matthias J. Sax,2019-03-19 16:33:41-07:00,['5092b26393de731e8f826fde86b7ea97c9aaba35'],3,3,6,1773852,2,,,,4297
b5ce093a24d0fe212b5d1374330fc720b4913bee,1,GitHub,2019-03-19 17:27:32-07:00,['70ee72491fead119b18384e06cb93e66f81799b3'],886,594,1480,1775332,29,1,0.822580645,0,4297
fa57eb065d032c225f63a0b2ca3f050e728c2235,0,Bill Bejeck,2019-03-19 22:27:03-04:00,['b5ce093a24d0fe212b5d1374330fc720b4913bee'],11,124,135,1775467,5,0.777777778,1,0.777777778,4299
f6f8da70713be6486b9ca085f4130043a3b9e9aa,0,Manikumar Reddy,2019-03-20 10:35:34+05:18,['fa57eb065d032c225f63a0b2ca3f050e728c2235'],4,14,18,1775485,1,0,0,1,4299
58d057296ae66cdf439dff19e73d7d6497dffc37,0,Rajini Sivaram,2019-03-21 10:15:43+00:00,['f6f8da70713be6486b9ca085f4130043a3b9e9aa'],3,10,13,1775498,1,0,1,1,4299
62171781396b613b6be8e13a2541ab0895b9bb6b,0,Colin Patrick McCabe,2019-03-21 10:03:09-07:00,['58d057296ae66cdf439dff19e73d7d6497dffc37'],34,62,96,1775594,2,0,0.047619048,1,4299
4cae4523fc04597814d85c1484ec67d8cadc2256,0,Bill Bejeck,2019-03-21 15:51:18-04:00,['62171781396b613b6be8e13a2541ab0895b9bb6b'],2,48,50,1775644,2,,,,4299
3124b070666d3b8cdc0e96067e69b8e7a6245742,1,Guozhang Wang,2019-03-21 17:21:55-07:00,['4cae4523fc04597814d85c1484ec67d8cadc2256'],1,533,534,1776178,2,0.238095238,1,0.977777778,4300
1f692bdf53af4a80b7fd256de4e94ff1d17fc861,0,GitHub,2019-03-21 23:53:56-07:00,['3124b070666d3b8cdc0e96067e69b8e7a6245742'],14,122,136,1776314,4,0.951612903,1,1,4301
1deb072f56ac07b3233089ccaab8271d75f483c5,1,Ismael Juma,2019-03-22 01:32:45-07:00,['1f692bdf53af4a80b7fd256de4e94ff1d17fc861'],5,6,11,1776325,1,,,,4301
1acae2a67c8fce071bfe7a373187bdff209f1705,0,GitHub,2019-03-22 09:27:58-04:00,['1deb072f56ac07b3233089ccaab8271d75f483c5'],74,22,96,1776421,1,1,0,0,4301
860e9579994aa00dbbbeadb3ab10eec0cb854ddf,0,Ewen Cheslack-Postava,2019-03-22 11:50:00-07:00,['1acae2a67c8fce071bfe7a373187bdff209f1705'],3,3,6,1776427,3,,,,4301
f304667df089b9e39850fe401ddfd0c457b1bb67,0,GitHub,2019-03-23 12:14:35-07:00,['860e9579994aa00dbbbeadb3ab10eec0cb854ddf'],5,7,12,1776439,2,1,1,0,4301
82615256ffcb97b74eee0a81850421a3c0e14a68,0,Gwen Shapira,2019-03-23 15:48:24-07:00,['f304667df089b9e39850fe401ddfd0c457b1bb67'],0,3,3,1776442,2,,,,4301
c74acb24eb1da5d16cc2721a63931cd87f79ec66,0,GitHub,2019-03-24 12:47:58-04:00,['82615256ffcb97b74eee0a81850421a3c0e14a68'],1,0,1,1776443,1,,,,4301
e4cad353124478fd4034f18d2292ba62fb702924,1,Randall Hauch,2019-03-25 09:29:33-05:00,['c74acb24eb1da5d16cc2721a63931cd87f79ec66'],64,962,1026,1777469,12,0.748743719,1,0.969849246,4305
e0d028bf6cbf140c72706247c40bded7bfabcb0c,0,GitHub,2019-03-25 09:43:44-07:00,['e4cad353124478fd4034f18d2292ba62fb702924'],7,15,22,1777491,2,0,0.5,1,4305
1baba1b347a9db51514777dba07263e285e8237b,0,Colin Patrick McCabe,2019-03-25 09:54:17-07:00,['e0d028bf6cbf140c72706247c40bded7bfabcb0c'],1,1,2,1777493,1,,,,4305
0d55f0f3ec8f97bc250b325481f6f2fa70f52a5c,0,Colin Patrick McCabe,2019-03-25 09:58:11-07:00,['1baba1b347a9db51514777dba07263e285e8237b'],3,123,126,1777619,7,0.847826087,0.847826087,1,4307
13e265ab3dfd69cdc3709b6f871418bcf1a2221f,1,Jun Rao,2019-03-25 18:50:12-07:00,['0d55f0f3ec8f97bc250b325481f6f2fa70f52a5c'],6,23,29,1777648,4,1,1,0,4307
f47b8493bce314e166e27c9c7a9fabb8ba650c0f,0,GitHub,2019-03-26 09:41:29-07:00,['13e265ab3dfd69cdc3709b6f871418bcf1a2221f'],0,41,41,1777689,1,,,,4307
dc0601a1c604bea3f426ed25b6c20176ff444079,1,GitHub,2019-03-26 14:23:01-07:00,['f47b8493bce314e166e27c9c7a9fabb8ba650c0f'],779,1624,2403,1780092,21,0.700956938,1,0.844497608,4317
b42d904f810b6ed8381397af2e27d579bbad5e41,0,Manikumar Reddy,2019-03-28 20:28:58+05:18,['dc0601a1c604bea3f426ed25b6c20176ff444079'],7,8,15,1780107,1,,,,4317
d63d7022526565a96323a45fad4ead6c3db573ad,1,Guozhang Wang,2019-03-28 13:57:04-07:00,['b42d904f810b6ed8381397af2e27d579bbad5e41'],49,62,111,1780218,3,0.0625,0,0,4317
b25974c387571b77fbe1e5010dbdd3f40a60a61d,0,GitHub,2019-03-28 14:47:37-07:00,['d63d7022526565a96323a45fad4ead6c3db573ad'],2,6,8,1780226,1,1,1,0,4317
17f73b42ad677f4c2b0d52e8d2d7be40731443e6,0,Guozhang Wang,2019-03-28 21:02:41-07:00,['b25974c387571b77fbe1e5010dbdd3f40a60a61d'],2,2,4,1780230,1,,,,4317
d10023e8d3093eaa6b0b3afa04c7ea1b9bee6c30,0,Bill Bejeck,2019-03-29 17:08:20-04:00,['17f73b42ad677f4c2b0d52e8d2d7be40731443e6'],9,22,31,1780261,1,0,1,0,4317
ff78c684ff22d81174cd789a4ac7e7e1fe4dfc8a,0,Bill Bejeck,2019-03-29 17:10:04-04:00,['d10023e8d3093eaa6b0b3afa04c7ea1b9bee6c30'],9,23,32,1780293,1,0,1,1,4317
369d89f2080586773b5a3cc432cbcf655aa1f625,0,GitHub,2019-03-29 17:16:56-04:00,['ff78c684ff22d81174cd789a4ac7e7e1fe4dfc8a'],38,23,61,1780354,5,0,0,0,4317
981815c8d14daf1042e06f8fa9cb355187719b1d,1,Colin Patrick McCabe,2019-03-29 14:32:36-07:00,['369d89f2080586773b5a3cc432cbcf655aa1f625'],214,206,420,1780774,13,0.8,1,1,4317
219c22113ee3e8c2b9763d8577c50e481fb1ba31,1,Gwen Shapira,2019-03-29 15:02:10-07:00,['981815c8d14daf1042e06f8fa9cb355187719b1d'],60,100,160,1780934,1,1,1,1,4317
8592baf7848983aaf3ead98733307e3c47101c67,0,Gwen Shapira,2019-03-29 17:38:26-07:00,['219c22113ee3e8c2b9763d8577c50e481fb1ba31'],1,1,2,1780936,1,,,,4317
acb5188810320224713babbd03eb3709f6e7968e,0,Bill Bejeck,2019-04-01 11:39:05-04:00,['8592baf7848983aaf3ead98733307e3c47101c67'],1,1,2,1780938,1,,,,4317
e560bae22a33c0f39d3347c82d5edb120719c02c,1,Manikumar Reddy,2019-04-01 21:35:20+05:18,['acb5188810320224713babbd03eb3709f6e7968e'],1,36,37,1780975,1,0,1,1,4317
e5a131d9bf02ae768b088b1cf9fe3ba5e852228a,0,Guozhang Wang,2019-04-01 16:32:14-07:00,['e560bae22a33c0f39d3347c82d5edb120719c02c'],1,0,1,1780976,1,,,,4317
4825bc47a0341076009bdcb15d9a195f206a1f32,1,Colin Patrick McCabe,2019-04-02 17:09:40-07:00,['e5a131d9bf02ae768b088b1cf9fe3ba5e852228a'],6,28,34,1781010,1,0,1,0,4317
213466b3d4fd21b332c0b6882fea36cf1affef1c,0,GitHub,2019-04-02 17:12:32-07:00,['4825bc47a0341076009bdcb15d9a195f206a1f32'],17,10,27,1781037,4,1,0,0,4317
c23bf7a360c5854380fa74df55f1f65df102c97c,0,Guozhang Wang,2019-04-03 08:47:51-07:00,['213466b3d4fd21b332c0b6882fea36cf1affef1c'],1,1,2,1781039,1,,,,4317
d3316bc6a7834db9eef6dde21728891ba6b07b37,0,Randall Hauch,2019-04-03 15:00:05-05:00,['c23bf7a360c5854380fa74df55f1f65df102c97c'],11,21,32,1781071,2,1,1,0,4317
9bd0d6aa93b901be97adb53f290b262c7cf1f175,0,Bill Bejeck,2019-04-04 09:38:25-04:00,['d3316bc6a7834db9eef6dde21728891ba6b07b37'],7,0,7,1781078,1,,,,4317
c3010254843dcdf0bd68602f752f690cd76d9813,1,Manikumar Reddy,2019-04-04 21:53:04+05:18,['9bd0d6aa93b901be97adb53f290b262c7cf1f175'],136,110,246,1781324,9,0,0,1,4317
a674ded0b34b79e04b4242a3db19c90ae87b6f87,0,Gwen Shapira,2019-04-04 14:16:56-07:00,['c3010254843dcdf0bd68602f752f690cd76d9813'],23,43,66,1781390,1,0.833333333,1,0.916666667,4317
31d191fc85229c9b0a6e85aad56e8a7975b295e1,1,Gwen Shapira,2019-04-05 09:14:41-07:00,['a674ded0b34b79e04b4242a3db19c90ae87b6f87'],7,95,102,1781492,6,0.553191489,0.957446809,1,4317
825fa3fa09b89e9ba9d38a92c1b01bd170494efb,0,Manikumar Reddy,2019-04-05 23:18:48+05:18,['31d191fc85229c9b0a6e85aad56e8a7975b295e1'],10,9,19,1781511,6,1,1,1,4317
844120c601e87693e540fa98a9cdb4d0272f5601,0,GitHub,2019-04-05 19:42:28+01:00,['825fa3fa09b89e9ba9d38a92c1b01bd170494efb'],5,41,46,1781557,3,0,0.931034483,0.965517241,4317
4aa2cfe467b9ccae1b7d8a83777f900b6a526f59,0,GitHub,2019-04-05 12:50:42-07:00,['844120c601e87693e540fa98a9cdb4d0272f5601'],37,40,77,1781634,10,,,,4317
cc4fde35c9cc2818af1bcb6861ce32dee0f41677,1,Jason Gustafson,2019-04-05 13:08:04-07:00,['4aa2cfe467b9ccae1b7d8a83777f900b6a526f59'],405,393,798,1782432,41,1,1,1,4317
62381bd9152d30e95af58f4423240ed4eaa084b5,0,Gwen Shapira,2019-04-05 15:27:34-07:00,['cc4fde35c9cc2818af1bcb6861ce32dee0f41677'],134,361,495,1782927,6,0.48447205,0.788819876,1,4319
db338ef67c3162e5b64efdb1538bf56cc53ec28a,1,GitHub,2019-04-05 15:33:37-07:00,['62381bd9152d30e95af58f4423240ed4eaa084b5'],423,457,880,1783807,3,,,,4320
71e721f1354739b183fa7c58a3483098c6832928,1,Randall Hauch,2019-04-07 09:43:09-05:00,['db338ef67c3162e5b64efdb1538bf56cc53ec28a'],15,113,128,1783935,4,0.513513514,1,0.864864865,4321
1bf1e46e7e7ea192019576a5ee613bcedd843e96,0,Jason Gustafson,2019-04-08 14:24:00-07:00,['71e721f1354739b183fa7c58a3483098c6832928'],2,103,105,1784040,2,0.405405405,0.689189189,1,4321
97bca4d3f5507f326046c78695ead99b10883631,0,Matthias J. Sax,2019-04-08 22:36:46-07:00,['1bf1e46e7e7ea192019576a5ee613bcedd843e96'],9,9,18,1784058,1,,,,4321
0667fe2bfda95b756faa589896b7da52622ef871,0,Ismael Juma,2019-04-09 11:20:37+02:00,['97bca4d3f5507f326046c78695ead99b10883631'],7,7,14,1784072,3,,,,4321
950cfe3e703f1726d6447e17480d1c8c04c46796,1,Manikumar Reddy,2019-04-10 12:27:11+05:18,['0667fe2bfda95b756faa589896b7da52622ef871'],0,10,10,1784082,1,,,,4321
9f5a69a4c2d6ac812ab6134e64839602a0840b87,0,Bill Bejeck,2019-04-10 15:10:47-04:00,['950cfe3e703f1726d6447e17480d1c8c04c46796'],2,291,293,1784375,14,0.743455497,1,0.87434555,4321
53e95ffcdb1cecbba67eb726aa2abcab3ae49c66,1,GitHub,2019-04-11 08:27:08-07:00,['9f5a69a4c2d6ac812ab6134e64839602a0840b87'],210,160,370,1784745,16,0,0,0,4321
04a023e302d1c02c32bba1653303bc0d40140f18,0,GitHub,2019-04-11 11:16:06-07:00,['53e95ffcdb1cecbba67eb726aa2abcab3ae49c66'],0,1,1,1784746,1,0,1,1,4321
02221bd907a23041c95ce6446986bff631652b3a,1,GitHub,2019-04-11 11:55:14-07:00,['04a023e302d1c02c32bba1653303bc0d40140f18'],51,39,90,1784836,4,1,0,0.25,4321
8bd66eb87004f538533a6cdc69fcc0f4a057de83,0,Matthias J. Sax,2019-04-13 15:35:47-07:00,['02221bd907a23041c95ce6446986bff631652b3a'],1,1,2,1784838,1,,,,4321
ad0f7aead708e5aa1ffb0d2769f6247f6f0b9faf,0,Matthias J. Sax,2019-04-13 15:43:51-07:00,['8bd66eb87004f538533a6cdc69fcc0f4a057de83'],1,1,2,1784840,1,,,,4321
75dc7e2b6b5522911b22f52bdba5357b19a9a773,0,GitHub,2019-04-13 18:50:27-04:00,['ad0f7aead708e5aa1ffb0d2769f6247f6f0b9faf'],1,1,2,1784842,1,,,,4321
5e2d062267731a90a4f4c60fd2594f1f67e4752b,0,GitHub,2019-04-13 18:54:06-04:00,['75dc7e2b6b5522911b22f52bdba5357b19a9a773'],1,1,2,1784844,1,,,,4321
312e55bf56c4670f0a2701b94dc21bfc8fa2990d,0,GitHub,2019-04-13 18:59:40-04:00,['5e2d062267731a90a4f4c60fd2594f1f67e4752b'],1,1,2,1784846,1,,,,4321
51a67d52cbd9aee0b0dacd33cca5f39322aae4ef,1,GitHub,2019-04-15 12:42:23+01:00,['312e55bf56c4670f0a2701b94dc21bfc8fa2990d'],2,2,4,1784850,1,,,,4321
9495b5f991684d51ac22dccfe964030eed469f21,0,Vahid Hashemian,2019-04-15 07:23:50-07:00,['51a67d52cbd9aee0b0dacd33cca5f39322aae4ef'],1,1,2,1784852,1,,,,4321
7bd81628d9f6c21649e615e73ed507520fd74fd9,1,Jason Gustafson,2019-04-15 15:56:36-07:00,['9495b5f991684d51ac22dccfe964030eed469f21'],39,306,345,1785197,7,0.243654822,0.923857868,1,4321
b7d7f7590de405d8d527c32ca9f067e073e9d83b,1,Guozhang Wang,2019-04-15 16:27:19-07:00,['7bd81628d9f6c21649e615e73ed507520fd74fd9'],16,500,516,1785713,10,1,1,1,4323
47a9871ef65a13f9d58d5ea216de340f7e123da5,1,Vahid Hashemian,2019-04-15 16:53:28-07:00,['b7d7f7590de405d8d527c32ca9f067e073e9d83b'],366,723,1089,1786802,7,0.029520295,0.804428044,0.911439114,4323
05668e98f531cf4d6ddb0696f0f72675ca128581,0,Bill Bejeck,2019-04-16 12:10:38-04:00,['47a9871ef65a13f9d58d5ea216de340f7e123da5'],65,679,744,1787546,6,0.438931298,1,1,4325
99ce7d76ce5b326e95e9f70ee4eacdd23cf44dc7,0,Guozhang Wang,2019-04-16 13:48:58-07:00,['05668e98f531cf4d6ddb0696f0f72675ca128581'],0,1,1,1787547,1,,,,4325
3b1524c5dfd2a94f3fb919dad0de70984963772b,1,Colin Patrick McCabe,2019-04-16 16:26:33-07:00,['99ce7d76ce5b326e95e9f70ee4eacdd23cf44dc7'],68,1023,1091,1788638,23,0.44952381,0.916190476,0.811428571,4330
5919e73e5d2ebdf3d3fcefcb691b0718bcce34bb,0,Matthias J. Sax,2019-04-16 16:44:17-07:00,['3b1524c5dfd2a94f3fb919dad0de70984963772b'],9,9,18,1788656,1,1,0,0,4330
0e08358da4b114834140c720b98125a2a3a84caa,0,GitHub,2019-04-17 09:07:25-07:00,['5919e73e5d2ebdf3d3fcefcb691b0718bcce34bb'],322,1084,1406,1790062,3,0,1,0,4330
7f9b9a60dab990efb79df89a6603e78d9ce5a34f,0,GitHub,2019-04-17 18:17:40+01:00,['0e08358da4b114834140c720b98125a2a3a84caa'],15,93,108,1790170,2,0,0.636363636,1,4330
a05eaaa8f41db9fca86020845a3336acc105ee19,1,Jason Gustafson,2019-04-17 12:41:46-07:00,['7f9b9a60dab990efb79df89a6603e78d9ce5a34f'],1,7,8,1790178,1,0,0,1,4330
555d05971e16123a497ad423ef4786e0831b2101,0,Bill Bejeck,2019-04-17 17:17:32-04:00,['a05eaaa8f41db9fca86020845a3336acc105ee19'],0,3,3,1790181,1,,,,4330
c7836307c3588ed5d267f32eabcd7dfc0dbeec80,1,Bill Bejeck,2019-04-17 19:21:59-04:00,['555d05971e16123a497ad423ef4786e0831b2101'],9,38,47,1790228,4,1,1,0.909090909,4330
0f7a87e93dd06659b886a75547ea576f374d01c2,1,Guozhang Wang,2019-04-17 16:42:49-07:00,['c7836307c3588ed5d267f32eabcd7dfc0dbeec80'],13,320,333,1790561,4,0.95049505,1,0.767326733,4330
3e8a10e7d9a9d5d3d29c8793e30d8401be1588ac,1,Jason Gustafson,2019-04-18 08:35:24-07:00,['0f7a87e93dd06659b886a75547ea576f374d01c2'],73,478,551,1791112,6,0.108626198,0.731629393,0.811501597,4330
48179677a75276b495c59bd429e1f7874dc905b3,1,GitHub,2019-04-18 08:38:43-07:00,['3e8a10e7d9a9d5d3d29c8793e30d8401be1588ac'],31,73,104,1791216,3,0,0.891891892,0,4330
6964c356aa0acdb96d5ccb689a088ba224cf41f5,1,GitHub,2019-04-18 08:41:32-07:00,['48179677a75276b495c59bd429e1f7874dc905b3'],15,122,137,1791353,6,0.261904762,0.988095238,0.964285714,4330
7b4b298edd02dc0313d655f94ef6670794ac24b2,1,Jason Gustafson,2019-04-18 09:38:54-07:00,['6964c356aa0acdb96d5ccb689a088ba224cf41f5'],1,6,7,1791360,1,1,1,1,4330
075b368d47ad3144518e4d425f9155e35f15f418,0,Bill Bejeck,2019-04-18 18:45:33-04:00,['7b4b298edd02dc0313d655f94ef6670794ac24b2'],66,522,588,1791948,21,0.91509434,0.891509434,0.971698113,4334
e32d33cd4f0c884c9d0c871c0aa4b423ae4a7bf0,1,Gwen Shapira,2019-04-19 16:43:06-07:00,['075b368d47ad3144518e4d425f9155e35f15f418'],45,19,64,1792012,2,1,1,0,4334
c596204c0dc880ee51772f06cc786057f78f34f3,0,GitHub,2019-04-19 18:29:27-07:00,['e32d33cd4f0c884c9d0c871c0aa4b423ae4a7bf0'],30,23,53,1792065,1,1,0,0,4334
3aa909575d3f978a5045200986eb692eebd47ab8,0,GitHub,2019-04-19 18:44:27-07:00,['c596204c0dc880ee51772f06cc786057f78f34f3'],30,23,53,1792118,1,1,0,0,4334
6538e9e4d6c1f64fe3045a5c3fbfe306277a1bee,1,Bill Bejeck,2019-04-20 11:08:32-04:00,['3aa909575d3f978a5045200986eb692eebd47ab8'],110,1195,1305,1793423,12,0.400516796,0.828165375,0.877260982,4335
964e90a725f7a0bcaf03735f81e525388868b4d9,0,Colin Patrick McCabe,2019-04-20 10:43:35-07:00,['6538e9e4d6c1f64fe3045a5c3fbfe306277a1bee'],2,0,2,1793425,1,1,1,0,4335
e56ebbffca57741d398283e46073ed4170f8f927,0,Matthias J. Sax,2019-04-20 11:30:20-07:00,['964e90a725f7a0bcaf03735f81e525388868b4d9'],17,135,152,1793577,13,0,0.8,0.98,4335
409fabc5610443f36574bdea2e2994b6c20e2829,1,Jason Gustafson,2019-04-21 16:24:18-07:00,['e56ebbffca57741d398283e46073ed4170f8f927'],240,1574,1814,1795391,23,0.531914894,0.787234043,0.826032541,4340
172fbb2dd55144e2e44777174f970b56768e1777,0,GitHub,2019-04-22 10:15:46-07:00,['409fabc5610443f36574bdea2e2994b6c20e2829'],14,439,453,1795844,8,0.142857143,1,1,4340
7d9e93ac6df511475a159daedc5e32b12a9ebc8b,1,GitHub,2019-04-22 11:58:25-07:00,['172fbb2dd55144e2e44777174f970b56768e1777'],31,31,62,1795906,11,,,,4340
c2bee988faa3c338fdc275aac9f638bb652b38a0,0,GitHub,2019-04-22 13:08:27-07:00,['7d9e93ac6df511475a159daedc5e32b12a9ebc8b'],3,9,12,1795918,1,1,1,1,4340
3000fda8b9800f4cddfc9675dfae11f762aabccc,0,Randall Hauch,2019-04-22 14:19:58-07:00,['c2bee988faa3c338fdc275aac9f638bb652b38a0'],6,27,33,1795951,2,1,1,1,4340
58d6043d4c88892f6718e31799503c3482000ea2,1,Guozhang Wang,2019-04-22 14:53:51-07:00,['3000fda8b9800f4cddfc9675dfae11f762aabccc'],279,564,843,1796794,15,0.496,0.296,0.928,4343
a552a2704e36b6db0a6295370d4e190ff212d5d1,0,GitHub,2019-04-22 18:59:00-04:00,['58d6043d4c88892f6718e31799503c3482000ea2'],1,1,2,1796796,1,,,,4343
d801c4fc69398ab96fa8a90feb0fb94ffc5d1ac5,1,Randall Hauch,2019-04-22 22:29:12-05:00,['a552a2704e36b6db0a6295370d4e190ff212d5d1'],2,44,46,1796842,4,0.206896552,1,1,4343
9ff490509f860a729f20777c5c9d38267c44f7a1,0,Randall Hauch,2019-04-22 22:47:30-05:00,['d801c4fc69398ab96fa8a90feb0fb94ffc5d1ac5'],22,22,44,1796886,1,,,,4343
9e10916abda2f2a3911b8ff50ad7f76bf1f45030,0,GitHub,2019-04-23 16:16:25-07:00,['9ff490509f860a729f20777c5c9d38267c44f7a1'],7,44,51,1796937,2,,,,4343
dd8131499fe99300338b2238a994923ac94a698e,0,Bill Bejeck,2019-04-24 14:54:29-07:00,['9e10916abda2f2a3911b8ff50ad7f76bf1f45030'],20,19,39,1796976,1,,,,4343
17c80166461c0005b7603414db4d0a3541df0f82,1,GitHub,2019-04-24 22:23:15-07:00,['dd8131499fe99300338b2238a994923ac94a698e'],551,1093,1644,1798620,15,0.390710383,0.928961749,1,4347
3eaccb3eff8baf7cfc74ea4e263155bcb1f5780b,0,Jason Gustafson,2019-04-24 22:31:11-07:00,['17c80166461c0005b7603414db4d0a3541df0f82'],1,1,2,1798622,1,,,,4347
ad4a7c343620bdeb4395ff80b0fae7fbb585df7c,0,Jason Gustafson,2019-04-25 07:53:47-07:00,['3eaccb3eff8baf7cfc74ea4e263155bcb1f5780b'],6,7,13,1798635,1,,1,,4347
25ea9246be749b9f1bafda56fb547871eae557c0,0,Manikumar Reddy,2019-04-25 20:23:50+05:18,['ad4a7c343620bdeb4395ff80b0fae7fbb585df7c'],1,1,2,1798637,1,,,,4347
96e1fd6cc7ec6af2f688fc4641bdd6d6b608835b,0,Jason Gustafson,2019-04-25 09:05:43-07:00,['25ea9246be749b9f1bafda56fb547871eae557c0'],2,2,4,1798641,1,,,,4347
26a001d13394986ab2cfbd3cec2aebe000105dad,0,Jason Gustafson,2019-04-25 09:13:33-07:00,['96e1fd6cc7ec6af2f688fc4641bdd6d6b608835b'],4,4,8,1798649,2,,,,4347
f6c59df07ed865a8bdc777db73216347f4882114,0,Jason Gustafson,2019-04-25 10:10:42-07:00,['26a001d13394986ab2cfbd3cec2aebe000105dad'],1,5,6,1798655,1,0,0,1,4347
847957cbea48d404a4090d5c35ea41c3aca820c2,0,Guozhang Wang,2019-04-25 14:16:34-07:00,['f6c59df07ed865a8bdc777db73216347f4882114'],1,1,2,1798657,1,,,,4347
0c2d829249567c6a87140ae25f631a2abad11d00,1,Colin Patrick McCabe,2019-04-25 16:42:54-07:00,['847957cbea48d404a4090d5c35ea41c3aca820c2'],490,366,856,1799513,11,0,0,1,4347
eecb403bae80b82b6fb7a27bebb5b53d6c8f3115,1,Guozhang Wang,2019-04-26 09:30:20-07:00,['0c2d829249567c6a87140ae25f631a2abad11d00'],245,418,663,1800176,15,0.126984127,0.920634921,1,4347
0f995ba6be1c0f949320b0879241d9a7c9578436,1,Guozhang Wang,2019-04-26 11:44:38-07:00,['eecb403bae80b82b6fb7a27bebb5b53d6c8f3115'],285,1300,1585,1801761,35,0.38125,0.828125,0.746875,4349
dc31fea8bc06e1fb58a3698e55ab44d765f3dc9f,1,Guozhang Wang,2019-04-26 11:50:34-07:00,['0f995ba6be1c0f949320b0879241d9a7c9578436'],95,114,209,1801970,8,1,1,0,4349
8299f2a397b6033d60c295a689b7a45fcf413f4a,0,Guozhang Wang,2019-04-26 13:22:35-07:00,['dc31fea8bc06e1fb58a3698e55ab44d765f3dc9f'],5,1016,1021,1802991,8,0.67,1,0.858333333,4352
39400c46ac42518374aefdbd42ea57b6795d5a7c,1,Matthias J. Sax,2019-04-27 14:59:54-07:00,['8299f2a397b6033d60c295a689b7a45fcf413f4a'],20,51,71,1803062,4,0,0,1,4352
df0adbcc2cb9b11f5f9f9c681108edaae9eeeafa,0,Ismael Juma,2019-04-29 06:37:10-07:00,['39400c46ac42518374aefdbd42ea57b6795d5a7c'],9,9,18,1803080,1,,,,4352
3af3f425c6301cbd1282155a29b5683b9dc54c18,1,Jason Gustafson,2019-04-29 07:53:24-07:00,['df0adbcc2cb9b11f5f9f9c681108edaae9eeeafa'],1,1,2,1803082,1,,,,4352
b4532a65f758448c763b65b2fdde1405db2f9d9d,1,Colin Patrick McCabe,2019-04-29 08:59:17-07:00,['3af3f425c6301cbd1282155a29b5683b9dc54c18'],49,57,106,1803188,9,0.857142857,1,0.857142857,4352
626fbc60dd546166f953d83f6ab1c29de31f764b,0,Jason Gustafson,2019-04-29 12:55:29-07:00,['b4532a65f758448c763b65b2fdde1405db2f9d9d'],1,10,11,1803199,1,1,1,1,4352
c5665e6945c8e63ddfb1056c4893f16cae1f6f99,0,GitHub,2019-05-01 09:28:10+02:00,['626fbc60dd546166f953d83f6ab1c29de31f764b'],156,929,1085,1804284,14,0.89673913,1,0.842391304,4356
56c64803fa190814232c5f71e9a758346c474bb4,1,GitHub,2019-05-01 09:33:53+02:00,['c5665e6945c8e63ddfb1056c4893f16cae1f6f99'],566,23,589,1804873,16,0.913253012,0.048192771,0.004819277,4356
191f2faae07b6608b0601dc2caf204b196a8fc47,0,Colin Patrick McCabe,2019-05-01 08:58:02-07:00,['56c64803fa190814232c5f71e9a758346c474bb4'],69,117,186,1805059,9,1,1,1,4357
ba1fc21864bbd4c1374695890f98ff1fa2614504,0,GitHub,2019-05-01 12:07:45-04:00,['191f2faae07b6608b0601dc2caf204b196a8fc47'],2,39,41,1805100,2,0,0.9,1,4357
6ca899e56d451eef04e81b0f4d88bdb10f3cf4b3,1,Jason Gustafson,2019-05-01 12:40:48-07:00,['ba1fc21864bbd4c1374695890f98ff1fa2614504'],34,68,102,1805202,7,0.111111111,1,1,4357
093a22536fb9e970e12d8b186ea8ae18ad8bcca1,0,Ismael Juma,2019-05-01 19:20:12-07:00,['6ca899e56d451eef04e81b0f4d88bdb10f3cf4b3'],13,25,38,1805240,2,,,,4357
c34330c5481803c91705cbfcc499021360ff7fdc,1,GitHub,2019-05-02 09:29:22-07:00,['093a22536fb9e970e12d8b186ea8ae18ad8bcca1'],484,571,1055,1806295,8,0.258064516,0.580645161,0.870967742,4357
b074173ea249ef028272c2c07358222550917d8c,1,Harsha,2019-05-02 15:11:42-07:00,['c34330c5481803c91705cbfcc499021360ff7fdc'],9,332,341,1806636,8,0.713178295,0.968992248,0.852713178,4360
a4f7675db1a928e73c7a69eb906dd1e9ecd4a22a,0,Guozhang Wang,2019-05-02 17:16:17-07:00,['b074173ea249ef028272c2c07358222550917d8c'],6,9,15,1806651,3,0,0.75,0.25,4360
eab855541a4b776b150a849cecda9c758598cdca,1,Guozhang Wang,2019-05-02 17:44:53-07:00,['a4f7675db1a928e73c7a69eb906dd1e9ecd4a22a'],49,128,177,1806828,5,0,1,1,4360
3ba4686d4d650f0f9155b2e22dddb192a5a56a6c,0,GitHub,2019-05-02 17:46:01-07:00,['eab855541a4b776b150a849cecda9c758598cdca'],1,23,24,1806852,2,0.647058824,0.647058824,0.647058824,4360
6d3ff132b57835fc879d678e9addc5e7c3804205,0,Bill Bejeck,2019-05-03 10:32:34-04:00,['3ba4686d4d650f0f9155b2e22dddb192a5a56a6c'],37,121,158,1807010,2,1,0.966101695,0.898305085,4360
a37282415e4e7f682b43abe78517ed18a8dea962,1,GitHub,2019-05-03 10:35:07-07:00,['6d3ff132b57835fc879d678e9addc5e7c3804205'],98,111,209,1807219,78,0.5,0.25,0,4360
a1b1e088b98763818e933dce335b580d02916640,0,Bill Bejeck,2019-05-03 19:50:18-04:00,['a37282415e4e7f682b43abe78517ed18a8dea962'],1,5,6,1807225,1,0,1,1,4360
14314e3d687b4c7b77750d27a085b803c934e3e9,1,Bill Bejeck,2019-05-04 10:44:18-04:00,['a1b1e088b98763818e933dce335b580d02916640'],17,91,108,1807333,3,0.408163265,0.551020408,0.755102041,4360
c85152f5b96a0904b7b503f8edb1485e41daca05,0,Bill Bejeck,2019-05-04 10:52:53-04:00,['14314e3d687b4c7b77750d27a085b803c934e3e9'],1,4,5,1807338,1,1,1,1,4360
56b92a550454765b09047be9ad561f3395c614e4,1,Jason Gustafson,2019-05-04 14:08:16-07:00,['c85152f5b96a0904b7b503f8edb1485e41daca05'],29,82,111,1807449,2,0.195121951,0.585365854,1,4360
aaf23453865a832fab6bc1145a6416c5071ce348,0,Manikumar Reddy,2019-05-06 15:55:30+05:18,['56b92a550454765b09047be9ad561f3395c614e4'],2,2,4,1807453,1,,,,4360
3322439d9895a7b599104eeb957939a23fef69cf,0,Manikumar Reddy,2019-05-06 16:40:23+05:18,['aaf23453865a832fab6bc1145a6416c5071ce348'],3,3,6,1807459,1,,,,4360
0c62f5e664e30e44af341cc38605bd5cfb498272,0,Manikumar Reddy,2019-05-06 17:40:53+05:18,['3322439d9895a7b599104eeb957939a23fef69cf'],1,26,27,1807486,1,,,,4360
90043d5f7e1b09a959080c2064f758d5890fc454,1,GitHub,2019-05-06 06:53:49-07:00,['0c62f5e664e30e44af341cc38605bd5cfb498272'],29,4,33,1807519,1,0.833333333,0.833333333,0.166666667,4360
407bcdf78e06f83f2b358d2cbd96aed348a5c28f,1,Jason Gustafson,2019-05-06 14:26:22-07:00,['90043d5f7e1b09a959080c2064f758d5890fc454'],257,198,455,1807974,21,0,0,1,4360
2bf153f6a7100e481000ce6bc28baabcaf29dc7f,0,Jason Gustafson,2019-05-07 08:26:24-07:00,['407bcdf78e06f83f2b358d2cbd96aed348a5c28f'],20,61,81,1808055,7,0.409090909,0,1,4360
4eadaff6b2a9c730b7108f4386985714a4a3aea9,0,Jason Gustafson,2019-05-07 08:36:59-07:00,['2bf153f6a7100e481000ce6bc28baabcaf29dc7f'],1,1,2,1808057,1,,,,4360
8e7b57fbcd13edcab280725bb808f232f2e60a1b,0,Guozhang Wang,2019-05-07 08:54:32-07:00,['4eadaff6b2a9c730b7108f4386985714a4a3aea9'],0,1,1,1808058,1,1,1,1,4360
a6d5efaf0d06f8a66350a8f1b959baf176fd482a,1,Bill Bejeck,2019-05-07 13:49:31-04:00,['8e7b57fbcd13edcab280725bb808f232f2e60a1b'],27,285,312,1808370,6,0.671794872,0.892307692,1,4360
889512202c2a2cfba23e358da08747357b60d8ac,1,GitHub,2019-05-07 13:13:19-07:00,['a6d5efaf0d06f8a66350a8f1b959baf176fd482a'],30,65,95,1808465,3,1,0.826086957,1,4360
cc097e909c7e5b1617565e4456f5328a826eafbc,1,Randall Hauch,2019-05-07 17:20:51-05:00,['889512202c2a2cfba23e358da08747357b60d8ac'],158,205,363,1808828,17,0.68,1,1,4361
b0e82a68b34512d23a5a60a9b5da0db86eb880b2,1,Guozhang Wang,2019-05-07 17:43:13-07:00,['cc097e909c7e5b1617565e4456f5328a826eafbc'],130,84,214,1809042,31,1,0,0,4361
8308829e46fcc4903b9faa3d2dcdf10f56f262fe,0,Gwen Shapira,2019-05-07 20:25:37-07:00,['b0e82a68b34512d23a5a60a9b5da0db86eb880b2'],1,1,2,1809044,1,,,,4361
5144660040839cee6e213b5146c1ae44340eddb0,0,GitHub,2019-05-07 21:35:17-07:00,['8308829e46fcc4903b9faa3d2dcdf10f56f262fe'],102,261,363,1809407,60,0.662162162,0.959459459,0.959459459,4363
83823aedf2e2d176004402152b69bd67f97d8e12,1,Bill Bejeck,2019-05-08 11:26:25-04:00,['5144660040839cee6e213b5146c1ae44340eddb0'],20,159,179,1809586,2,0,1,0.914529915,4363
e6cff21fd8c5add0eb7e55417a91f0530a7d3a32,1,Jason Gustafson,2019-05-08 09:31:05-07:00,['83823aedf2e2d176004402152b69bd67f97d8e12'],66,228,294,1809880,18,0.94,0.94,0.92,4364
cc4a7f01e872e6d0664360d5148af09c876ca72b,0,Guozhang Wang,2019-05-08 18:38:28-07:00,['e6cff21fd8c5add0eb7e55417a91f0530a7d3a32'],5,9,14,1809894,1,,,,4364
c09e25fac2aaea61af892ae3e5273679a4bdbc7d,1,GitHub,2019-05-09 06:21:24-07:00,['cc4a7f01e872e6d0664360d5148af09c876ca72b'],323,392,715,1810609,28,1,1,0,4365
53dec548b6149274e6c2acf832386dba6ec3c1e1,0,GitHub,2019-05-09 15:45:50+02:00,['c09e25fac2aaea61af892ae3e5273679a4bdbc7d'],9,13,22,1810631,1,,,,4365
a97e55b83868ff786e740db55e73116f85456dcb,1,Colin Patrick McCabe,2019-05-09 11:08:22-07:00,['53dec548b6149274e6c2acf832386dba6ec3c1e1'],341,853,1194,1811825,22,0.382550336,1,1,4366
5a8d74e151e4472d5e5b4541972f5515e4f138ff,1,Jason Gustafson,2019-05-09 15:31:10-07:00,['a97e55b83868ff786e740db55e73116f85456dcb'],69,117,186,1812011,3,0,1,1,4366
b2826c6c2bfc3360913e63e0b65f9d79e782fd50,1,Bill Bejeck,2019-05-09 18:45:22-04:00,['5a8d74e151e4472d5e5b4541972f5515e4f138ff'],2,32,34,1812045,2,0.428571429,1,1,4366
36a5aba4ecf56631372ad12d5c67af8fa3de05f8,1,Randall Hauch,2019-05-09 20:27:59-05:00,['b2826c6c2bfc3360913e63e0b65f9d79e782fd50'],9,165,174,1812219,7,0.9,1,0.833333333,4368
7a4618a793aacd240745c8de0ad7e502121f5dc2,0,Randall Hauch,2019-05-09 20:35:08-05:00,['36a5aba4ecf56631372ad12d5c67af8fa3de05f8'],3,3,6,1812225,1,,,,4368
96096cebe1ec77b3f7e0c60cf9f4ce575adccd67,0,Gwen Shapira,2019-05-09 22:16:13-07:00,['7a4618a793aacd240745c8de0ad7e502121f5dc2'],1,1,2,1812227,1,,,,4368
c638235dbc0019b67fd520378d7efdcfd8dec0c0,0,Gwen Shapira,2019-05-09 22:48:23-07:00,['96096cebe1ec77b3f7e0c60cf9f4ce575adccd67'],3,3,6,1812233,1,,,,4368
31859a452b68ddd98281ff341a6b75c579f3c050,0,Gwen Shapira,2019-05-09 22:51:10-07:00,['c638235dbc0019b67fd520378d7efdcfd8dec0c0'],1,1,2,1812235,1,,,,4368
437382cceb8549f33948398c92040e6fc16e0ed7,0,Matthias J. Sax,2019-05-10 11:54:09+02:00,['31859a452b68ddd98281ff341a6b75c579f3c050'],2,2,4,1812239,1,,,,4368
40d5c9fac92f019c46b1de15ee428e6f47544551,0,Randall Hauch,2019-05-10 18:20:39-05:00,['437382cceb8549f33948398c92040e6fc16e0ed7'],2,2,4,1812243,1,,,,4368
511c8e2c9ee802176c5193e80dfb5c86030144a7,0,Jason Gustafson,2019-05-10 23:36:15-07:00,['40d5c9fac92f019c46b1de15ee428e6f47544551'],1,0,1,1812244,1,,,,4368
1876605fa7245ecd94e8c34a04817e5b02d161ae,0,Jason Gustafson,2019-05-11 00:28:37-07:00,['511c8e2c9ee802176c5193e80dfb5c86030144a7'],0,1,1,1812245,1,,,,4368
7c20257d98c7037efc74e4159d4b0adc1741d891,0,GitHub,2019-05-11 11:54:58+02:00,['1876605fa7245ecd94e8c34a04817e5b02d161ae'],20,31,51,1812296,3,0,0,1,4368
4c85171a1f1219bb735be3ca034640e298fda0dc,1,Jason Gustafson,2019-05-11 11:05:37-07:00,['7c20257d98c7037efc74e4159d4b0adc1741d891'],0,23,23,1812319,2,0.684210526,0.684210526,1,4368
16ece15fb3abcd2a144b311129c22ab9203025a2,0,Jason Gustafson,2019-05-11 11:13:07-07:00,['4c85171a1f1219bb735be3ca034640e298fda0dc'],8,9,17,1812336,1,,,,4368
5236a3e5ec35b02ad3b40e904997b91b82e9f36d,1,Guozhang Wang,2019-05-11 11:20:14-07:00,['16ece15fb3abcd2a144b311129c22ab9203025a2'],2413,2113,4526,1816862,6,0.596,0,0.064,4370
8649717d6dde081c75fc441a56f63ee1556dc758,1,GitHub,2019-05-12 11:50:55+02:00,['5236a3e5ec35b02ad3b40e904997b91b82e9f36d'],252,1055,1307,1818169,44,0.812195122,0.956097561,0.887804878,4375
8a237f599afa539868a138b5a2534dbf884cb4ec,1,Guozhang Wang,2019-05-12 15:31:44-07:00,['8649717d6dde081c75fc441a56f63ee1556dc758'],220,531,751,1818920,19,0,1,0.913793103,4376
d798dbf497d91509517c60d67ceeea02e2b9b383,1,GitHub,2019-05-13 08:47:53-07:00,['8a237f599afa539868a138b5a2534dbf884cb4ec'],10,84,94,1819014,4,0,0.413793103,1,4376
1fdc8533016e948b1d534145978252209d7612ed,1,Joel Koshy,2019-05-13 09:16:12-07:00,['d798dbf497d91509517c60d67ceeea02e2b9b383'],41,281,322,1819336,14,0.469387755,1,0.761904762,4376
63e4f67d9ba9e08bdce705b35c5acf32dcd20633,1,GitHub,2019-05-13 13:36:26-07:00,['1fdc8533016e948b1d534145978252209d7612ed'],5,29,34,1819370,2,0.4,1,1,4376
e4007a6408236d9b52b355fcf3c3a80fe5f570ff,1,GitHub,2019-05-13 18:58:42-07:00,['63e4f67d9ba9e08bdce705b35c5acf32dcd20633'],790,1644,2434,1821804,16,0.239353891,0.944199706,0.898678414,4377
b86e8c1ea908b8fa2576d058700b0ac14b1b4a3e,1,Joel Koshy,2019-05-13 22:54:06-07:00,['e4007a6408236d9b52b355fcf3c3a80fe5f570ff'],13,31,44,1821848,4,,,,4377
e2f6a9c74723328d384f7a9669b9027521b612d6,0,Randall Hauch,2019-05-14 14:32:54-05:00,['b86e8c1ea908b8fa2576d058700b0ac14b1b4a3e'],1,8,9,1821857,2,1,1,1,4377
16d4d8cafc7394a35caf3354b449505bde56920f,1,Jason Gustafson,2019-05-14 15:14:49-07:00,['e2f6a9c74723328d384f7a9669b9027521b612d6'],36,47,83,1821940,2,0,1,1,4377
d92eb0d8d85cc24256499eff97672141493fb90b,1,Randall Hauch,2019-05-14 21:11:07-05:00,['16d4d8cafc7394a35caf3354b449505bde56920f'],3,354,357,1822297,4,0.62804878,0.792682927,0.981707317,4379
47fdf228605534302811287f77553d3c5303284e,0,Bill Bejeck,2019-05-14 22:36:05-04:00,['d92eb0d8d85cc24256499eff97672141493fb90b'],4,10,14,1822311,1,1,1,0.75,4379
29b1f66c2c307f8692a5ae9db0774d5b6f965127,0,GitHub,2019-05-14 23:23:22-07:00,['47fdf228605534302811287f77553d3c5303284e'],1,1,2,1822313,1,,,,4379
050fdd6537fcfb640277ff5e1607e44d18c0d95f,1,GitHub,2019-05-15 09:17:10+01:00,['29b1f66c2c307f8692a5ae9db0774d5b6f965127'],12,76,88,1822401,6,0.468085106,1,0.723404255,4379
0494cd329f3aaed94b3b46de0abe495f80faaedd,1,GitHub,2019-05-15 13:52:59-07:00,['050fdd6537fcfb640277ff5e1607e44d18c0d95f'],435,625,1060,1823461,10,1,1,1,4381
fbb09952ac5a42b32042e32cde95e48c22ba129a,0,Randall Hauch,2019-05-15 17:02:35-05:00,['0494cd329f3aaed94b3b46de0abe495f80faaedd'],5,14,19,1823480,2,1,1,1,4381
2208f9966d31a3f52bf9b63938bd6f3729378d9b,1,Jason Gustafson,2019-05-15 15:09:00-07:00,['fbb09952ac5a42b32042e32cde95e48c22ba129a'],235,169,404,1823884,13,0,0,1,4381
5928ffd0dc444cf0ef21178e36c1103c3e4a0996,0,Randall Hauch,2019-05-15 17:20:20-05:00,['2208f9966d31a3f52bf9b63938bd6f3729378d9b'],3,3,6,1823890,1,,,,4381
2327b3555849dd73d5695525548410e5257298e4,0,Randall Hauch,2019-05-15 22:05:52-05:00,['5928ffd0dc444cf0ef21178e36c1103c3e4a0996'],2,5,7,1823897,1,,,,4381
b395ef418237a37b95d6452f0111998f63c047db,1,Guozhang Wang,2019-05-16 12:35:01+01:00,['2327b3555849dd73d5695525548410e5257298e4'],184,655,839,1824736,8,0.601010101,1,0.833333333,4383
6e6dcceb9325a919650e016adde4a02cf87f7529,1,Jason Gustafson,2019-05-16 06:10:24-07:00,['b395ef418237a37b95d6452f0111998f63c047db'],32,226,258,1824994,4,0.047619048,0.959183673,1,4383
b96aa003b6793c749a8d8f2ec1e2f2e3da8af01a,0,Jason Gustafson,2019-05-16 06:16:31-07:00,['6e6dcceb9325a919650e016adde4a02cf87f7529'],0,1,1,1824995,1,,,,4383
80784271043d2da8e93055a5f9b1bcfd53347461,1,Bill Bejeck,2019-05-16 10:07:53-04:00,['b96aa003b6793c749a8d8f2ec1e2f2e3da8af01a'],27,68,95,1825090,3,0,1,1,4383
16b408898e75b00ddf6b607246833cdbcd56f507,1,GitHub,2019-05-16 16:16:00+01:00,['80784271043d2da8e93055a5f9b1bcfd53347461'],44,1188,1232,1826322,3,0.149010477,0.752037253,0.728754366,4384
855f899bb523f3b334f711926a7db4cc75ebb4b4,1,Jason Gustafson,2019-05-16 13:08:49-07:00,['16b408898e75b00ddf6b607246833cdbcd56f507'],126,76,202,1826524,13,0,0,0.571428571,4384
26814e060e98f9674127be13a28ce41a21ca6b3c,0,Ismael Juma,2019-05-16 13:37:19-07:00,['855f899bb523f3b334f711926a7db4cc75ebb4b4'],9,48,57,1826581,4,0,0.571428571,1,4384
5a95c2e1cd555d5f3ec148cc7c765d1bb7d716f9,1,Randall Hauch,2019-05-16 16:29:29-05:00,['26814e060e98f9674127be13a28ce41a21ca6b3c'],51,232,283,1826864,9,0,0.77443609,1,4384
ce584a01fff4e73afa96d38c9a7508fcd67e3e46,1,Randall Hauch,2019-05-16 22:46:03-05:00,['5a95c2e1cd555d5f3ec148cc7c765d1bb7d716f9'],216,4833,5049,1831913,22,0.331791908,0.899807322,0.796917148,4396
2e91a310d7bf9e7d4d46b0bc0ca0c11cb4531e10,1,Ismael Juma,2019-05-17 01:37:32-07:00,['ce584a01fff4e73afa96d38c9a7508fcd67e3e46'],88,1246,1334,1833247,35,0.357274401,0.865561694,0.699815838,4407
8de7d3772443a63e46649ab651260db277efafec,0,GitHub,2019-05-17 14:20:04+01:00,['2e91a310d7bf9e7d4d46b0bc0ca0c11cb4531e10'],8,15,23,1833270,2,0.6,1,0.2,4407
64c2d49cf5c8b1cecbd7601dc2d1577fc606ab1e,0,Jason Gustafson,2019-05-17 08:06:06-07:00,['8de7d3772443a63e46649ab651260db277efafec'],1,37,38,1833308,2,0,1,1,4407
a1286edb040a5d368a76d6c9c809c5cf0c080ec8,1,GitHub,2019-05-17 20:02:13+02:00,['64c2d49cf5c8b1cecbd7601dc2d1577fc606ab1e'],16,16,32,1833340,5,1,0,0,4407
16769d263e2e8fd91704d2e3519abf9dcba507df,0,Bill Bejeck,2019-05-17 16:32:17-04:00,['a1286edb040a5d368a76d6c9c809c5cf0c080ec8'],5,74,79,1833419,7,0.05,0.55,0.975,4407
9077d83672a4d08273ce4a6012f1787f5313f948,0,GitHub,2019-05-17 18:10:11-04:00,['16769d263e2e8fd91704d2e3519abf9dcba507df'],50,62,112,1833531,5,1,1,0,4407
414852c701763b6f8362b44d156753b6c3ef247a,1,Jason Gustafson,2019-05-17 15:39:20-07:00,['9077d83672a4d08273ce4a6012f1787f5313f948'],55,244,299,1833830,11,0.775,1,0.933333333,4407
e018bfe2b050b55b479bbabb9fc26ebcc211b177,0,Bill Bejeck,2019-05-17 18:50:45-04:00,['414852c701763b6f8362b44d156753b6c3ef247a'],53,221,274,1834104,2,0,0.943661972,0.345070423,4407
6a2749faa63397caa93dae7bfdc3f1d0573a2ff4,1,Bill Bejeck,2019-05-17 19:48:07-04:00,['e018bfe2b050b55b479bbabb9fc26ebcc211b177'],939,1621,2560,1836664,61,0,0.591016548,0.910165485,4407
d6057a9fe44b5e9521dd679b0dc1e6ccfec866c2,1,Gwen Shapira,2019-05-17 16:55:55-07:00,['6a2749faa63397caa93dae7bfdc3f1d0573a2ff4'],16,10,26,1836690,2,1,1,0,4407
e2847e8603fe19a87ff03584fb38954e4bd3a59e,1,Jason Gustafson,2019-05-17 22:45:45-07:00,['d6057a9fe44b5e9521dd679b0dc1e6ccfec866c2'],51,484,535,1837225,23,0.420600858,0.896995708,0.678111588,4407
9fa331b811d893a0d580e9136c1c7e1fa9774542,1,Guozhang Wang,2019-05-18 07:28:36-07:00,['e2847e8603fe19a87ff03584fb38954e4bd3a59e'],137,691,828,1838053,29,0.518950437,0.89212828,0.897959184,4410
51c72ad025bfaab9ee5035c9fd7ad6cf9d44b37c,0,Jason Gustafson,2019-05-18 14:41:39-07:00,['9fa331b811d893a0d580e9136c1c7e1fa9774542'],1,1,2,1838055,1,,,,4410
a29a00531659864e053aff2019fde8202132c35b,0,Jason Gustafson,2019-05-18 15:18:50-07:00,['51c72ad025bfaab9ee5035c9fd7ad6cf9d44b37c'],0,34,34,1838089,2,,,,4412
e00c0d316db01fbe5e57a4dfd54856c89e761b08,0,Jason Gustafson,2019-05-18 16:19:59-07:00,['a29a00531659864e053aff2019fde8202132c35b'],12,28,40,1838129,8,0,0,1,4412
b52170372b26249c7c7e8604bbbdc3a792f092b2,1,GitHub,2019-05-18 16:52:18-07:00,['e00c0d316db01fbe5e57a4dfd54856c89e761b08'],2,2,4,1838133,1,,,,4412
c140f09406b119d86d43bba6248d17fe0120a4dd,0,Guozhang Wang,2019-05-18 19:18:14-07:00,['b52170372b26249c7c7e8604bbbdc3a792f092b2'],570,186,756,1838889,4,0.411504425,0,0.278761062,4412
fc616cb521c3f7e377b8b0ac65a3a83101156951,0,Jason Gustafson,2019-05-18 19:56:56-07:00,['c140f09406b119d86d43bba6248d17fe0120a4dd'],2,2,4,1838893,1,,,,4412
11a8a8d274a16ee2aa8271efc1f7418499372e31,1,GitHub,2019-05-20 09:02:25-04:00,['fc616cb521c3f7e377b8b0ac65a3a83101156951'],1,36,37,1838930,2,0.92,0.92,1,4412
5a30a806ec1502cab34555bfa4df4fc6ed7a7917,0,Jason Gustafson,2019-05-20 07:56:07-07:00,['11a8a8d274a16ee2aa8271efc1f7418499372e31'],7,8,15,1838945,1,0,0,1,4412
614ea55ad7495c3abcc5942caaf5274ad4029327,0,GitHub,2019-05-20 16:24:11+01:00,['5a30a806ec1502cab34555bfa4df4fc6ed7a7917'],11,57,68,1839013,3,0.333333333,1,1,4412
b43f5446acd36eb60554e57f5b9bdb415395f2d1,1,Jason Gustafson,2019-05-20 10:15:15-07:00,['614ea55ad7495c3abcc5942caaf5274ad4029327'],44,102,146,1839159,5,0,1,1,4412
7d70133b7529f144b760cb914ec64da25ba561a7,0,Randall Hauch,2019-05-20 14:02:22-05:00,['b43f5446acd36eb60554e57f5b9bdb415395f2d1'],7,7,14,1839173,7,,,,4412
87ff83a82efd64849b855b5397fb26ae17327010,0,GitHub,2019-05-20 12:47:21-07:00,['7d70133b7529f144b760cb914ec64da25ba561a7'],10,10,20,1839193,8,,,,4412
a420abf2db33f6082df6d8ec07a2b90d805fae76,0,Jason Gustafson,2019-05-20 15:24:15-07:00,['87ff83a82efd64849b855b5397fb26ae17327010'],2,10,12,1839205,1,,,,4412
d77bac1c930afc7b7247f9a1a66b666801ae7798,0,Manikumar Reddy,2019-05-21 20:36:49+05:18,['a420abf2db33f6082df6d8ec07a2b90d805fae76'],32,151,183,1839388,6,0.528571429,1,1,4412
126230dad0ca9e4660ad2f1912935c41bce77ea9,0,Randall Hauch,2019-05-21 11:28:28-05:00,['d77bac1c930afc7b7247f9a1a66b666801ae7798'],3,3,6,1839394,1,,,,4412
3b5d7aee6cb9f191eaf647576ae39d3d8ebc941f,0,Guozhang Wang,2019-05-21 10:54:26-07:00,['126230dad0ca9e4660ad2f1912935c41bce77ea9'],2,3,5,1839399,1,,,,4412
012880d4246fedb5c1ea7621e86217c57fd217e2,0,GitHub,2019-05-21 21:46:04+01:00,['3b5d7aee6cb9f191eaf647576ae39d3d8ebc941f'],43,116,159,1839558,2,0,0.016129032,0.983870968,4412
ce5ce2d569dd9fead42974d81bc7adfc5e6c7a22,1,GitHub,2019-05-21 14:50:24-07:00,['012880d4246fedb5c1ea7621e86217c57fd217e2'],12,14,26,1839584,4,1,1,0,4412
bacb45e044aae61fd373f6535f8073263c972370,1,Jason Gustafson,2019-05-21 15:50:21-07:00,['ce5ce2d569dd9fead42974d81bc7adfc5e6c7a22'],32,43,75,1839659,11,0.857142857,0.857142857,0,4412
4f110905975188d0855dc0c7b168724679aae97d,1,GitHub,2019-05-21 22:51:56-07:00,['bacb45e044aae61fd373f6535f8073263c972370'],60,165,225,1839884,8,1,0.951807229,1,4412
5ca6a2ee94c71092083c93a384faa46c9e2ade97,0,Manikumar Reddy,2019-05-22 19:00:55+05:18,['4f110905975188d0855dc0c7b168724679aae97d'],1,1,2,1839886,1,,,,4412
cafdc1e7df7725c92a374ba9528f7974fe592196,0,Bill Bejeck,2019-05-22 11:03:00-04:00,['5ca6a2ee94c71092083c93a384faa46c9e2ade97'],11,47,58,1839944,10,0,0.9375,0.4375,4412
5f06999cf370ddd773b30f5d707c37c6087fa755,1,GitHub,2019-05-22 15:51:25-07:00,['cafdc1e7df7725c92a374ba9528f7974fe592196'],9,44,53,1839997,2,0.956521739,1,1,4412
89f331eac3aaeab53a3b36bc437eba5f6213ca91,0,Jason Gustafson,2019-05-22 23:50:48-07:00,['5f06999cf370ddd773b30f5d707c37c6087fa755'],1,18,19,1840016,2,0.375,1,1,4412
4574b2438a82115c5ec3ca3c381270b06fc2a8e3,1,GitHub,2019-05-23 11:38:10-07:00,['89f331eac3aaeab53a3b36bc437eba5f6213ca91'],60,42,102,1840118,3,1,0,0,4412
c6d083d7fc0a3c1e08157ffd0e6665be40a5680f,0,Colin Patrick McCabe,2019-05-23 11:46:10-07:00,['4574b2438a82115c5ec3ca3c381270b06fc2a8e3'],1,1,2,1840120,1,,,,4412
68a3eb373b5e176468ba5b9c045f327eb75f5f19,1,Randall Hauch,2019-05-23 14:14:09-05:00,['c6d083d7fc0a3c1e08157ffd0e6665be40a5680f'],1,24,25,1840145,2,0,1,1,4412
5351efe48ac71318fbbca21ac280c43921267744,1,Randall Hauch,2019-05-23 14:21:19-05:00,['68a3eb373b5e176468ba5b9c045f327eb75f5f19'],5,70,75,1840220,2,0.056603774,0.830188679,0.830188679,4412
3696b9882d0267871a31fc3df03da568b59433b7,1,GitHub,2019-05-23 13:20:39-07:00,['5351efe48ac71318fbbca21ac280c43921267744'],563,696,1259,1841479,29,0.782608696,1,0.773913043,4412
c823f32070e19dbdeaf200259777aab668bc012c,0,Gwen Shapira,2019-05-23 13:34:00-07:00,['3696b9882d0267871a31fc3df03da568b59433b7'],6,30,36,1841515,7,,,,4412
69132901721077331ae9de21e32c629830bc8e8d,0,GitHub,2019-05-23 17:00:33-07:00,['c823f32070e19dbdeaf200259777aab668bc012c'],1,1,2,1841517,1,,,,4412
7df79e1508496e1b9350866c390de692434b1549,0,GitHub,2019-05-23 23:19:12-07:00,['69132901721077331ae9de21e32c629830bc8e8d'],3,63,66,1841583,2,,,,4412
eefb25d4ca12a9c33ad654bf789eee4d451ebb0d,0,Jason Gustafson,2019-05-24 00:11:04-07:00,['7df79e1508496e1b9350866c390de692434b1549'],3,9,12,1841595,5,0,0,0.2,4412
d286051a21ef212494876fe9103ea75637531916,0,GitHub,2019-05-24 08:08:52-07:00,['eefb25d4ca12a9c33ad654bf789eee4d451ebb0d'],16,11,27,1841622,2,1,0,0,4412
105264b5cdf16f310f23345b468063e97768672f,0,Guozhang Wang,2019-05-24 10:35:16-07:00,['d286051a21ef212494876fe9103ea75637531916'],4,19,23,1841645,1,,,,4412
46a02f3231cd6d340c622636159b9f59b4b3cb6e,1,Colin Patrick McCabe,2019-05-24 17:20:22-07:00,['105264b5cdf16f310f23345b468063e97768672f'],219,383,602,1842247,2,0.656862745,1,0.901960784,4412
5ecac84cd8b5cb7be701e0cbcc53b37f41b50d60,0,Ismael Juma,2019-05-24 21:18:25-07:00,['46a02f3231cd6d340c622636159b9f59b4b3cb6e'],1,61,62,1842309,2,0.260869565,1,1,4413
a1808962e56eaaa3657298baad3fc09abcc49040,1,Ismael Juma,2019-05-24 21:29:51-07:00,['5ecac84cd8b5cb7be701e0cbcc53b37f41b50d60'],82,302,384,1842693,21,0.472,0.904,0.776,4414
6afb0ca735cd5c1a559d496247559d21bcadcb6c,1,GitHub,2019-05-24 23:10:56-07:00,['a1808962e56eaaa3657298baad3fc09abcc49040'],58,129,187,1842880,2,0,0.86,0.9,4414
e6057e5038c2b681152d2608d551db675960d12a,1,GitHub,2019-05-27 14:22:39-07:00,['6afb0ca735cd5c1a559d496247559d21bcadcb6c'],7,54,61,1842941,3,0,0.848484848,1,4414
27943e39876efad87fce7b558af3419f1a7a025c,1,Guozhang Wang,2019-05-27 14:25:47-07:00,['e6057e5038c2b681152d2608d551db675960d12a'],0,37,37,1842978,3,,,,4414
94195f8643670069545cbe948d4bafa8b291d2f9,1,Bill Bejeck,2019-05-28 11:50:11-04:00,['27943e39876efad87fce7b558af3419f1a7a025c'],1,51,52,1843030,2,0,1,1,4414
24f664aa1621dc70794fd6576ac99547e41d2113,1,GitHub,2019-05-28 11:22:09-07:00,['94195f8643670069545cbe948d4bafa8b291d2f9'],10,137,147,1843177,11,0.042553191,1,0.79787234,4414
88619b7dd85acd79c111cfdc90a594cb5c2cf96e,1,GitHub,2019-05-28 11:33:12-07:00,['24f664aa1621dc70794fd6576ac99547e41d2113'],10,51,61,1843238,4,0.333333333,1,1,4414
4a3c92bfc78044e1a325543e906ad38a2cfbb39c,0,GitHub,2019-05-28 12:56:22-07:00,['88619b7dd85acd79c111cfdc90a594cb5c2cf96e'],8,3,11,1843249,1,1,1,1,4414
901eb3688337a0e173ef7fcff9b3384926520c08,0,Jason Gustafson,2019-05-28 13:55:38-07:00,['4a3c92bfc78044e1a325543e906ad38a2cfbb39c'],2,22,24,1843273,2,1,1,1,4414
051379ea5df6b9906a8fd97cb41a0a6d584b8f03,0,Guozhang Wang,2019-05-28 16:34:03-07:00,['901eb3688337a0e173ef7fcff9b3384926520c08'],0,10,10,1843283,1,1,1,1,4414
592410fc585ad72934fef2cef8624b8146fedf3d,1,GitHub,2019-05-28 21:37:52-07:00,['051379ea5df6b9906a8fd97cb41a0a6d584b8f03'],72,156,228,1843511,2,0.720588235,0.970588235,0.5,4414
efeefa5d1825b9cb798452ebec9cfb2b627187e1,0,Manikumar Reddy,2019-05-29 17:04:39+05:18,['592410fc585ad72934fef2cef8624b8146fedf3d'],2,3,5,1843516,1,0,0,1,4414
da6063be4ff2499ea2c65fec2a7975e0cf48e7b7,1,Bill Bejeck,2019-05-29 09:25:07-04:00,['efeefa5d1825b9cb798452ebec9cfb2b627187e1'],0,52,52,1843568,1,0,1,1,4414
348e5d738fac0047428929970c8e1de226f738ea,0,GitHub,2019-05-29 07:45:46-07:00,['da6063be4ff2499ea2c65fec2a7975e0cf48e7b7'],6,14,20,1843588,5,0.8,1,1,4414
121308cc7a2639a70fc8a60c99d2eaee52931951,1,Jason Gustafson,2019-05-29 10:44:52-07:00,['348e5d738fac0047428929970c8e1de226f738ea'],1086,2102,3188,1846776,56,0.040948276,0.5,0.808189655,4425
e7da042d76e413d9d5c95c1bd75f2c7e3ede1aad,0,Bill Bejeck,2019-05-29 15:06:13-04:00,['121308cc7a2639a70fc8a60c99d2eaee52931951'],1,1,2,1846778,1,,,,4425
f249956390c051c92ebb090a61933dd08c522861,0,GitHub,2019-05-29 17:02:37-04:00,['e7da042d76e413d9d5c95c1bd75f2c7e3ede1aad'],1,5,6,1846784,1,1,0,1,4425
4838855ea795e9cc5e2a4ac0cb0d00ef88f77f80,0,Randall Hauch,2019-05-29 17:33:24-05:00,['f249956390c051c92ebb090a61933dd08c522861'],1,1,2,1846786,1,,,,4425
e82e2e723a8a71e5e0a73af4ce408e60065c1356,1,Jason Gustafson,2019-05-29 15:59:08-07:00,['4838855ea795e9cc5e2a4ac0cb0d00ef88f77f80'],161,249,410,1847196,6,0.538461538,0.989010989,0.791208791,4425
91ccbca4c25dba1671dfdd29053521ce93996f3e,0,Bill Bejeck,2019-05-30 07:12:26-04:00,['e82e2e723a8a71e5e0a73af4ce408e60065c1356'],1,3,4,1847200,1,,,,4425
932a1b7d7e2b7ea8c145552c3d050a0999ce13dc,0,Bill Bejeck,2019-05-30 07:28:43-04:00,['91ccbca4c25dba1671dfdd29053521ce93996f3e'],5,56,61,1847261,1,,,,4425
9f1ce60a9c0eae99388504349870018f0dd55afa,1,Bill Bejeck,2019-05-30 11:33:37-04:00,['932a1b7d7e2b7ea8c145552c3d050a0999ce13dc'],46,64,110,1847371,2,1,1,1,4425
fd9a20e4167c51c6645c55ed98800b768518c863,1,GitHub,2019-05-30 08:50:45-07:00,['9f1ce60a9c0eae99388504349870018f0dd55afa'],89,368,457,1847828,6,0.288461538,0.9375,0.831730769,4425
77e6e8ec054608a30626271b4952b63294a93c3b,1,GitHub,2019-05-30 09:46:12-07:00,['fd9a20e4167c51c6645c55ed98800b768518c863'],592,922,1514,1849342,12,0.069536424,0.880794702,0.92384106,4425
77a9a108ff1dff861ecc8dacc7220acde061658c,0,Randall Hauch,2019-05-30 14:01:00-05:00,['77e6e8ec054608a30626271b4952b63294a93c3b'],5,4,9,1849351,1,,,,4425
55bfea13789c3898ce4c9259a5fad74192c1bfb0,0,GitHub,2019-05-30 12:50:30-07:00,['77a9a108ff1dff861ecc8dacc7220acde061658c'],5,5,10,1849361,4,,,,4425
a4c0b1841a9fe69d040128129293db201f81fe4a,0,GitHub,2019-05-30 14:58:53-07:00,['55bfea13789c3898ce4c9259a5fad74192c1bfb0'],38,22,60,1849421,2,1,0,0,4425
efa6410611aa0862065ad804323c280a4d8a372d,1,Guozhang Wang,2019-05-30 15:42:04-07:00,['a4c0b1841a9fe69d040128129293db201f81fe4a'],356,1265,1621,1851042,17,0.384473198,0.975970425,0.975970425,4431
579567559915e750d305d51a10d9c6797b6eb2aa,0,Matthias J. Sax,2019-05-30 16:46:41-07:00,['efa6410611aa0862065ad804323c280a4d8a372d'],12,2,14,1851056,2,0.5,0.5,0,4431
78c55c8d66f5570d975caa53a9751b126ca10538,0,Bill Bejeck,2019-05-31 09:29:42-04:00,['579567559915e750d305d51a10d9c6797b6eb2aa'],239,1694,1933,1852989,5,0.562300319,0.993610224,0.587859425,4431
529a5a502e5fc4d05536d23df0bd75973affff01,0,GitHub,2019-05-31 17:02:40-07:00,['78c55c8d66f5570d975caa53a9751b126ca10538'],6,9,15,1853004,1,1,1,1,4431
87d493f07219a215816783557a5981a74f192f06,1,Guozhang Wang,2019-06-01 19:12:58-07:00,['529a5a502e5fc4d05536d23df0bd75973affff01'],5,177,182,1853186,3,0.438596491,1,1,4433
17345b3be527a3e4808440fceb1179a1b9f9e684,0,Randall Hauch,2019-06-02 12:19:19-05:00,['87d493f07219a215816783557a5981a74f192f06'],13,94,107,1853293,2,0,1,1,4433
2c810e4afb1b41ec1f8565d9a830d479b29dc708,1,Rajini Sivaram,2019-06-03 12:43:11+01:00,['17345b3be527a3e4808440fceb1179a1b9f9e684'],4,54,58,1853351,3,0.84,0.08,1,4433
b042b36674f0bd8046f0229c96e0b8cf99554b2b,0,Rajini Sivaram,2019-06-03 12:56:31+01:00,['2c810e4afb1b41ec1f8565d9a830d479b29dc708'],9,55,64,1853415,3,1,1,1,4433
3c7c988e3903d87ae1072fa9be5f349e5912d98e,1,Randall Hauch,2019-06-03 11:13:39-05:00,['b042b36674f0bd8046f0229c96e0b8cf99554b2b'],51,220,271,1853686,3,0,0.435185185,0.712962963,4433
ce008e72de6ce67a8e9bb3d5d78fb0bb3849a38a,0,Colin Patrick McCabe,2019-06-03 10:34:55-07:00,['3c7c988e3903d87ae1072fa9be5f349e5912d98e'],0,6,6,1853692,1,1,1,1,4433
45fae339373fe4bd90fb320695267b8340094fa3,1,Jason Gustafson,2019-06-03 13:16:38-07:00,['ce008e72de6ce67a8e9bb3d5d78fb0bb3849a38a'],56,294,350,1854042,4,0.139896373,1,1,4433
17712b96c86d6c2cce695531d7e5f2e3d5718b21,1,Guozhang Wang,2019-06-03 14:31:18-07:00,['45fae339373fe4bd90fb320695267b8340094fa3'],219,773,992,1855034,27,0.468013468,0.96969697,0.848484848,4435
55d07e717ec3d2a0b79a690d3a3fdf912cf01a26,1,Randall Hauch,2019-06-03 16:50:03-05:00,['17712b96c86d6c2cce695531d7e5f2e3d5718b21'],23,61,84,1855118,3,0,0.944444444,0,4435
573152dfa8087e40ee69b27fb9fb8f45d3825eb6,1,GitHub,2019-06-03 16:56:28-07:00,['55d07e717ec3d2a0b79a690d3a3fdf912cf01a26'],56,74,130,1855248,3,0.615384615,0.615384615,0,4435
1a3fe9aa52555eb24ce692963e4461d6f05b771d,1,Randall Hauch,2019-06-03 21:06:00-05:00,['573152dfa8087e40ee69b27fb9fb8f45d3825eb6'],68,175,243,1855491,7,0.943661972,0.957746479,0.154929577,4435
ba3dc494371145e8ad35d6b85f45b8fe1e44c21f,1,GitHub,2019-06-03 21:09:58-07:00,['1a3fe9aa52555eb24ce692963e4461d6f05b771d'],24,119,143,1855634,13,0,1,1,4436
055c9c7bd6780436d201f5101df464814ba940e2,0,Guozhang Wang,2019-06-04 12:14:34-07:00,['ba3dc494371145e8ad35d6b85f45b8fe1e44c21f'],1,2,3,1855637,1,0,1,1,4436
e6563aab722b35c4984b77e9eee42a1904cd1ea6,1,Gwen Shapira,2019-06-04 14:14:32-07:00,['055c9c7bd6780436d201f5101df464814ba940e2'],8,61,69,1855706,5,0.545454545,0.931818182,1,4436
264d1d8a8b7ede0fb8e3595d0153893966bb73b8,1,GitHub,2019-06-04 17:49:30-04:00,['e6563aab722b35c4984b77e9eee42a1904cd1ea6'],5,9,14,1855720,3,0.75,1,1,4436
b6d9e152234b14031ff1851b659b7bdf209d4710,0,GitHub,2019-06-04 15:38:18-07:00,['264d1d8a8b7ede0fb8e3595d0153893966bb73b8'],2,2,4,1855724,1,,,,4436
8e161580b859b2fcd54c59625e232b99f3bb48d0,1,Jason Gustafson,2019-06-05 14:10:00-07:00,['b6d9e152234b14031ff1851b659b7bdf209d4710'],78,248,326,1856050,18,0.302521008,0.25210084,0.87394958,4436
fb1f74958d1431af7c45a4d499b3b6ffef0bf70e,1,Jason Gustafson,2019-06-05 14:20:04-07:00,['8e161580b859b2fcd54c59625e232b99f3bb48d0'],23,61,84,1856134,2,1,1,1,4436
0e95c9f3a829110f0cd8c3695f40ba47f146fef7,1,GitHub,2019-06-05 14:36:43-07:00,['fb1f74958d1431af7c45a4d499b3b6ffef0bf70e'],302,726,1028,1857162,18,0.072507553,0.98489426,0.81570997,4436
59d3a56740a8c668ff8151b88d00c7adc371a50c,1,Bill Bejeck,2019-06-06 09:58:58-04:00,['0e95c9f3a829110f0cd8c3695f40ba47f146fef7'],73,46,119,1857281,3,0.111111111,0.055555556,0,4436
58aa04f91e9cd8203cd58f972d042d068727d256,0,Colin Patrick McCabe,2019-06-06 10:04:05-07:00,['59d3a56740a8c668ff8151b88d00c7adc371a50c'],15,33,48,1857329,4,1,0,0,4436
30adf2a096a7c879497b435b1704620e86d9e71e,1,Guozhang Wang,2019-06-06 11:30:21-07:00,['58aa04f91e9cd8203cd58f972d042d068727d256'],0,1,1,1857330,1,0,1,1,4436
562424cee87d8f87ae94d88cf5863c9f5db6dab5,0,Jason Gustafson,2019-06-06 16:18:50-07:00,['30adf2a096a7c879497b435b1704620e86d9e71e'],2,2,4,1857334,1,,,,4436
72c3b88ed5066d71eac7be393b94e1f64b631b1f,0,Guozhang Wang,2019-06-06 17:32:12-07:00,['562424cee87d8f87ae94d88cf5863c9f5db6dab5'],2,2,4,1857338,1,,,,4436
28eccc3ca3fe591c06d6067f08f60ce71f2a1e3c,1,Jason Gustafson,2019-06-06 21:36:33-07:00,['72c3b88ed5066d71eac7be393b94e1f64b631b1f'],11,447,458,1857796,4,0.26443769,0.875379939,1,4437
060701fb6f000046e19ccb94a5e366377d0a2599,0,Manikumar Reddy,2019-06-07 12:03:03+05:18,['28eccc3ca3fe591c06d6067f08f60ce71f2a1e3c'],6,10,16,1857812,1,0,0,1,4437
07dd7db324ac623190e48720ce446d82320edc36,0,Manikumar Reddy,2019-06-07 13:06:18+05:18,['060701fb6f000046e19ccb94a5e366377d0a2599'],55,49,104,1857916,1,0.692307692,0,0,4437
bb8de0b8c5f98f7a9d6b5ae7342ba7a0e1af8868,0,Gwen Shapira,2019-06-07 12:51:51-07:00,['07dd7db324ac623190e48720ce446d82320edc36'],3,7,10,1857926,1,,,,4437
cca05cace4105c829f303c13eed8ace2efd7fa0c,0,Bill Bejeck,2019-06-07 16:52:12-04:00,['bb8de0b8c5f98f7a9d6b5ae7342ba7a0e1af8868'],66,316,382,1858308,14,0.314814815,0.666666667,0.925925926,4442
677713baf3c47add13628ed498ffa11a34d4a5f4,0,Colin Patrick McCabe,2019-06-07 14:23:49-07:00,['cca05cace4105c829f303c13eed8ace2efd7fa0c'],1,2,3,1858311,1,,,,4442
c7c310beff23423c484b3a86aa284141a190d581,0,Gwen Shapira,2019-06-07 16:53:50-07:00,['677713baf3c47add13628ed498ffa11a34d4a5f4'],1,1,2,1858313,1,,,,4442
2feb44ebc89d36b682396ca00134440818fa8d8c,0,Gwen Shapira,2019-06-07 16:56:21-07:00,['c7c310beff23423c484b3a86aa284141a190d581'],1,5,6,1858319,1,1,1,1,4442
b9c55351fd2e7c47dd1abd6c7a47f7fff8bb0157,0,Matthias J. Sax,2019-06-10 10:09:07-07:00,['2feb44ebc89d36b682396ca00134440818fa8d8c'],1,1,2,1858321,1,,,,4442
1e5227c230c20af4a8182c6324ffbb481712b718,0,GitHub,2019-06-10 12:20:51-07:00,['b9c55351fd2e7c47dd1abd6c7a47f7fff8bb0157'],41,62,103,1858424,2,1,1,1,4442
0864779ce2a0454b2924567189e2f690d92498a6,0,GitHub,2019-06-10 18:13:30-04:00,['1e5227c230c20af4a8182c6324ffbb481712b718'],1,1,2,1858426,1,,,,4442
783ab74793cc7e541e6b8ed4e1c545bf5dcff959,1,GitHub,2019-06-10 18:59:59-07:00,['0864779ce2a0454b2924567189e2f690d92498a6'],18,67,85,1858511,4,0.454545455,1,1,4442
1669b773ba31f7bb3395ec536be7c17bc98ab9fc,0,Bill Bejeck,2019-06-11 10:04:44-04:00,['783ab74793cc7e541e6b8ed4e1c545bf5dcff959'],7,1,8,1858519,1,1,0.666666667,1,4442
bebcbe3a049f78c4184404f2dfb8b4150233856e,1,GitHub,2019-06-11 09:48:43-07:00,['1669b773ba31f7bb3395ec536be7c17bc98ab9fc'],49,141,190,1858709,5,0.327586207,0.75862069,0.810344828,4442
cb2c4c3d7aa854a8ce209145ab85851a8b4ffe85,0,Manikumar Reddy,2019-06-12 10:52:12+05:18,['bebcbe3a049f78c4184404f2dfb8b4150233856e'],1,1,2,1858711,1,,,,4442
388889fbfe6e586355fd186572016d8c199b4f55,0,Ismael Juma,2019-06-12 06:25:33-07:00,['cb2c4c3d7aa854a8ce209145ab85851a8b4ffe85'],1,1,2,1858713,1,,,,4442
e2c15e0eeb8e853aead9ef5e307930fd781b38e4,0,David Arthur,2019-06-12 09:33:03-04:00,['388889fbfe6e586355fd186572016d8c199b4f55'],7,0,7,1858720,1,0,0,0,4442
e981b82601e9967d3a2492d2cebb45369407b398,1,Jason Gustafson,2019-06-12 08:41:58-07:00,['e2c15e0eeb8e853aead9ef5e307930fd781b38e4'],90,349,439,1859159,8,0.365979381,1,0.979381443,4442
1cc0b5eb81b838c4ffb6ff2c2d3f16b7b3754a01,1,Jason Gustafson,2019-06-12 09:38:21-07:00,['e981b82601e9967d3a2492d2cebb45369407b398'],46,46,92,1859251,6,,,,4442
af2801031c455f86fb771d9f36c313f99459cd1a,1,GitHub,2019-06-12 12:54:17-07:00,['1cc0b5eb81b838c4ffb6ff2c2d3f16b7b3754a01'],96,399,495,1859746,4,0.382075472,1,0.919811321,4442
df9ea618a397955806fc7f1fba7003492046c77a,0,Guozhang Wang,2019-06-12 14:10:38-07:00,['af2801031c455f86fb771d9f36c313f99459cd1a'],251,205,456,1860202,1,1,0,0,4442
f396372fb894b43c4ca85f1a71bd1b1750ca3e05,0,Guozhang Wang,2019-06-12 15:38:06-07:00,['df9ea618a397955806fc7f1fba7003492046c77a'],1,35,36,1860238,1,1,1,1,4442
e54ab292e7e2fd1d18e82387a586969ba57eb7ea,1,Bill Bejeck,2019-06-13 09:48:15-04:00,['f396372fb894b43c4ca85f1a71bd1b1750ca3e05'],308,518,826,1861064,14,0.75,0.816666667,0.883333333,4443
48b65ac617a17cb5570e152256c1073619cfaabe,0,Bill Bejeck,2019-06-13 17:57:26-04:00,['e54ab292e7e2fd1d18e82387a586969ba57eb7ea'],217,216,433,1861497,1,0.615384615,1,0.846153846,4443
9e60f4cd17a5574a52755c58c78bf7291440a79b,0,Manikumar Reddy,2019-06-14 18:39:37+05:18,['48b65ac617a17cb5570e152256c1073619cfaabe'],0,4,4,1861501,1,,,,4443
8dd4fb5ebeccbb427ec5d0d92d4d5281ba9291f6,0,GitHub,2019-06-14 08:16:11-07:00,['9e60f4cd17a5574a52755c58c78bf7291440a79b'],7,35,42,1861543,3,0.476190476,0.476190476,1,4443
35814298e1fa2840f89ef1f40163b2480da28a2b,0,Colin Patrick McCabe,2019-06-14 09:24:27-07:00,['8dd4fb5ebeccbb427ec5d0d92d4d5281ba9291f6'],6,10,16,1861559,1,0,0,1,4443
2ef02f111e3a1640d3e92aa29dae5677d0eefe18,1,GitHub,2019-06-14 15:51:33-07:00,['35814298e1fa2840f89ef1f40163b2480da28a2b'],62,426,488,1862047,4,0.808510638,1,0.863829787,4443
e047864f30fa47c6bcb2a0e6d9da86fa053fe6f6,0,Gwen Shapira,2019-06-15 19:21:10-07:00,['2ef02f111e3a1640d3e92aa29dae5677d0eefe18'],9,9,18,1862065,9,0,0.9375,0.9375,4443
c758122ce59674ec3e33618d896e4e5cdbb45e87,1,Gwen Shapira,2019-06-15 21:00:09-07:00,['e047864f30fa47c6bcb2a0e6d9da86fa053fe6f6'],3,3,6,1862071,1,,,,4443
57baa4079d9fc14103411f790b9a025c9f2146a4,1,Jason Gustafson,2019-06-17 08:52:37-07:00,['c758122ce59674ec3e33618d896e4e5cdbb45e87'],949,907,1856,1863927,36,0.392857143,1,0.214285714,4443
1b9e1073885951697f34950a1ea706c93826e871,1,Guozhang Wang,2019-06-17 10:58:43-07:00,['57baa4079d9fc14103411f790b9a025c9f2146a4'],303,409,712,1864639,17,0.272727273,1,1,4444
47f908fa73fb7bbaec553635e75bffddd7a473f9,1,Jason Gustafson,2019-06-17 11:25:22-07:00,['1b9e1073885951697f34950a1ea706c93826e871'],27,75,102,1864741,6,0.815789474,0.973684211,0.763157895,4444
1ae92914e28919a97520e91bfd0e588d55eb1774,0,Jason Gustafson,2019-06-17 13:46:48-07:00,['47f908fa73fb7bbaec553635e75bffddd7a473f9'],0,1,1,1864742,1,,,,4444
52cd59bdb4de89c15f41984859469100f919dd6f,0,GitHub,2019-06-17 14:30:05-07:00,['1ae92914e28919a97520e91bfd0e588d55eb1774'],84,82,166,1864908,3,1,1,0,4444
6d6366cd5563ba2a7bd894611ef037cdea99273a,0,Bill Bejeck,2019-06-17 18:02:51-04:00,['52cd59bdb4de89c15f41984859469100f919dd6f'],129,1272,1401,1866309,4,0.950413223,0.966942149,0,4444
c7db82b59a145735fce227436c6191d1825fe384,0,Guozhang Wang,2019-06-17 17:11:11-07:00,['6d6366cd5563ba2a7bd894611ef037cdea99273a'],19,16,35,1866344,5,0.333333333,0,0,4444
c6ddd31887c3008da97d8a96dc53a408f420fcad,0,Randall Hauch,2019-06-17 21:53:20-07:00,['c7db82b59a145735fce227436c6191d1825fe384'],17,53,70,1866414,2,,,,4444
33e39de4ad5ff5cdea918e076565416e9295f46c,1,Colin Patrick McCabe,2019-06-18 10:52:58-07:00,['c6ddd31887c3008da97d8a96dc53a408f420fcad'],8,81,89,1866503,4,0.64,1,0.9,4444
2c9a15045eaac519c7a8dd20208e95a2bfccf76a,0,Guozhang Wang,2019-06-18 13:15:04-07:00,['33e39de4ad5ff5cdea918e076565416e9295f46c'],5,5,10,1866513,1,,,,4444
93bf96589471acadfb90e57ebfecbd91f679f77b,0,Ismael Juma,2019-06-18 21:28:04-07:00,['2c9a15045eaac519c7a8dd20208e95a2bfccf76a'],1,1,2,1866515,1,,,,4444
a7e771c6da72bb7f3c5c5cbab3dc9c4fd403f866,1,Bill Bejeck,2019-06-19 12:45:35-04:00,['93bf96589471acadfb90e57ebfecbd91f679f77b'],23,30,53,1866568,7,1,1,0.5,4444
635c21311f6bf0405e743dcf5004ef6ea36737e0,0,Jason Gustafson,2019-06-19 12:41:05-07:00,['a7e771c6da72bb7f3c5c5cbab3dc9c4fd403f866'],1,20,21,1866589,2,0.470588235,1,1,4444
d40805deacc5416be89984550b82c0b5d9dd57c5,0,Jason Gustafson,2019-06-20 09:49:32-07:00,['635c21311f6bf0405e743dcf5004ef6ea36737e0'],1,1,2,1866591,1,,,,4444
03d61ebfb93aab53b0b0ecdfc77175d18a58e861,0,Guozhang Wang,2019-06-20 13:56:00-07:00,['d40805deacc5416be89984550b82c0b5d9dd57c5'],19,20,39,1866630,6,1,1,,4444
1233c963f81ebf09762754c7d4cde97c85ae364f,1,GitHub,2019-06-20 23:41:34-07:00,['03d61ebfb93aab53b0b0ecdfc77175d18a58e861'],651,245,896,1867526,3,0.317391304,0.317391304,0,4444
d7a5e31ca2f694fe0f5aaf8536ea30400fc19d3e,0,GitHub,2019-06-21 11:30:05-04:00,['1233c963f81ebf09762754c7d4cde97c85ae364f'],0,239,239,1867765,4,0.83,1,0.66,4447
5f8b2898ce512b9d1390857e036bb3a896dca170,0,Jason Gustafson,2019-06-21 09:36:29-07:00,['d7a5e31ca2f694fe0f5aaf8536ea30400fc19d3e'],0,37,37,1867802,2,0,0.96,0.96,4447
f51d7d3c931ad9de34cf9633b5b97d9a7b5a0ad4,1,Rajini Sivaram,2019-06-21 17:51:43+01:00,['5f8b2898ce512b9d1390857e036bb3a896dca170'],55,182,237,1868039,3,0.935483871,1,0.5,4447
4d1d995a115939da51a8ad93f9df91e05ec0c808,0,Ismael Juma,2019-06-21 09:55:31-07:00,['f51d7d3c931ad9de34cf9633b5b97d9a7b5a0ad4'],5,1,6,1868045,1,0,0,0,4447
11b25a13ee72e1c91facd0f94b888215f67d5a69,0,Guozhang Wang,2019-06-21 12:42:34-07:00,['4d1d995a115939da51a8ad93f9df91e05ec0c808'],1,1,2,1868047,1,,,,4447
3e9d1c1411c5268de382f9dfcc95bdf66d0063a0,1,GitHub,2019-06-21 12:44:45-07:00,['11b25a13ee72e1c91facd0f94b888215f67d5a69'],133,817,950,1868997,16,0.352297593,0.824945295,0.623632385,4449
11641c7f53b2ee156490b2aadf79552d266ec956,0,GitHub,2019-06-21 18:00:46-07:00,['3e9d1c1411c5268de382f9dfcc95bdf66d0063a0'],23,5,28,1869025,1,1,0,0,4449
5339d2dfd240972b2f6f54148512793e930fa3c4,0,Ismael Juma,2019-06-22 09:26:14-07:00,['11641c7f53b2ee156490b2aadf79552d266ec956'],14,33,47,1869072,3,,,,4449
fc27cbe4159eaf9195017bc0fa929b0b84216d61,0,GitHub,2019-06-22 20:44:40-07:00,['5339d2dfd240972b2f6f54148512793e930fa3c4'],1707,18,1725,1870797,11,0.341652324,0.17211704,0.317555938,4449
7cb0a1ef4f4a7c08a56cb9b84d482e60ed5f20f3,0,Manikumar Reddy,2019-06-23 13:48:28+05:18,['fc27cbe4159eaf9195017bc0fa929b0b84216d61'],1,6,7,1870804,1,1,1,1,4449
e5c4ebdd7433d746a46d6962ee04ff2d782d892b,1,GitHub,2019-06-23 15:22:07-07:00,['7cb0a1ef4f4a7c08a56cb9b84d482e60ed5f20f3'],353,624,977,1871781,9,0.324873096,0.446700508,0.695431472,4449
a03b5037dffbd73fc368b4bdbcba47c3c2a1bb40,0,Guozhang Wang,2019-06-24 19:18:10-07:00,['e5c4ebdd7433d746a46d6962ee04ff2d782d892b'],1,1,2,1871783,1,,,,4449
55707adaee992e835a67920e016376235b92b70f,1,Manikumar Reddy,2019-06-25 11:01:11+05:18,['a03b5037dffbd73fc368b4bdbcba47c3c2a1bb40'],0,17,17,1871800,1,1,1,1,4449
14d854936e1d2fed2e69a7c6367becf360f88833,0,Manikumar Reddy,2019-06-25 18:19:11+05:18,['55707adaee992e835a67920e016376235b92b70f'],224,122,346,1872146,8,0,0,0.051282051,4449
07f492eb862f99e6ba53843afa2f927fdd57be1e,0,GitHub,2019-06-25 13:44:04-07:00,['14d854936e1d2fed2e69a7c6367becf360f88833'],3,5,8,1872154,1,0,1,1,4449
a9bf9487dd84c8a874f5a71b2557b57801308249,0,Bill Bejeck,2019-06-25 17:46:44-04:00,['07f492eb862f99e6ba53843afa2f927fdd57be1e'],3,3,6,1872160,1,,,,4449
5216839d8bcda5c00825a0f4be866a525d948da8,0,Bill Bejeck,2019-06-25 18:22:44-04:00,['a9bf9487dd84c8a874f5a71b2557b57801308249'],3,3,6,1872166,3,,,,4449
cfea95343dfe9f297bceb98676b7bc04e5035776,0,Guozhang Wang,2019-06-27 09:08:49-07:00,['5216839d8bcda5c00825a0f4be866a525d948da8'],2,3,5,1872171,2,,,,4449
594d0430377446e672322e8ef3f509eca419ec46,0,Rajini Sivaram,2019-06-27 17:50:17+01:00,['cfea95343dfe9f297bceb98676b7bc04e5035776'],0,7,7,1872178,2,1,1,1,4449
357aedeb1b9d4b0e7c40b29487751bd3a8ae009b,1,Rajini Sivaram,2019-06-27 18:10:43+01:00,['594d0430377446e672322e8ef3f509eca419ec46'],28,87,115,1872293,4,0.195121951,0.146341463,0.146341463,4450
fbf6a76fc40fc5fecd679ef6484a0b92a4ab3971,0,Guozhang Wang,2019-06-27 21:12:39-07:00,['357aedeb1b9d4b0e7c40b29487751bd3a8ae009b'],256,561,817,1873110,8,0.086956522,1,0.788819876,4451
f8db022b08cf0b7fa65f271711a4103ef4b28897,1,Guozhang Wang,2019-06-27 21:14:13-07:00,['fbf6a76fc40fc5fecd679ef6484a0b92a4ab3971'],28,87,115,1873225,10,0.428571429,0.976190476,0.833333333,4451
3d2d87abd1320ffbe6cbfc752845a3e50ea496f4,0,GitHub,2019-06-28 09:25:08-07:00,['f8db022b08cf0b7fa65f271711a4103ef4b28897'],4,16,20,1873245,7,,,,4451
f74cedb985bc573e3638dd272ebbe9a87f5482ec,0,GitHub,2019-06-28 14:50:37-07:00,['3d2d87abd1320ffbe6cbfc752845a3e50ea496f4'],1,39,40,1873285,1,,,,4451
b4e20495fa442a4312f946f518541a04fc6efcc9,0,Bill Bejeck,2019-06-28 18:47:16-04:00,['f74cedb985bc573e3638dd272ebbe9a87f5482ec'],3,1,4,1873289,1,,,,4451
53b837f9c604cdb8a5a77a9363fc058b9ef9cd7e,1,GitHub,2019-06-29 16:49:42-07:00,['b4e20495fa442a4312f946f518541a04fc6efcc9'],78,127,205,1873494,5,0,0.976744186,0.23255814,4451
da07985b0166c7048b7e92d54fbc33bea1d31da5,0,GitHub,2019-07-01 08:45:22-07:00,['53b837f9c604cdb8a5a77a9363fc058b9ef9cd7e'],1,0,1,1873495,1,1,1,0,4451
6dd4ebcea78f9c6fb8a2921cab3fd92be4978063,1,GitHub,2019-07-02 06:29:39-07:00,['da07985b0166c7048b7e92d54fbc33bea1d31da5'],332,413,745,1874240,125,0.428571429,0,0.857142857,4451
711c817254eaf62d91b0d783fdd04c5f1915fa75,1,Gwen Shapira,2019-07-02 09:40:54-07:00,['6dd4ebcea78f9c6fb8a2921cab3fd92be4978063'],100,379,479,1874719,9,0.306010929,0.852459016,0.93442623,4453
6f91096c7d8056de68e443373c35f337213c7bba,1,Rajini Sivaram,2019-07-02 19:10:41+01:00,['711c817254eaf62d91b0d783fdd04c5f1915fa75'],3,1,4,1874723,1,,,,4453
ea6cf41eb5135ec75f976ca769a16984c04a9c07,1,Jason Gustafson,2019-07-02 20:27:22-07:00,['6f91096c7d8056de68e443373c35f337213c7bba'],186,204,390,1875113,12,0,0.8,1,4453
298a9bc397878ddc755b91c44aef0c928be6eaf9,0,GitHub,2019-07-02 21:14:06-07:00,['ea6cf41eb5135ec75f976ca769a16984c04a9c07'],1,5,6,1875119,1,,,,4453
b0935e548b9d698f3ee7e9cb2ea5efc9647d6ba3,0,GitHub,2019-07-02 22:15:22-07:00,['298a9bc397878ddc755b91c44aef0c928be6eaf9'],1,1,2,1875121,1,,,,4453
5287036b384570d5f7824f188d52200ea23216d5,0,Rajini Sivaram,2019-07-03 12:17:17+01:00,['b0935e548b9d698f3ee7e9cb2ea5efc9647d6ba3'],1,1,2,1875123,1,,,,4453
5e5dbbd47f02d831ee4cda508a0ce28b8213feb2,0,Jason Gustafson,2019-07-03 10:53:57-07:00,['5287036b384570d5f7824f188d52200ea23216d5'],2,2,4,1875127,1,,,,4453
3750898e20c0680d0c58220fd3ecb6ecf1b5fef0,0,Jason Gustafson,2019-07-03 11:16:44-07:00,['5e5dbbd47f02d831ee4cda508a0ce28b8213feb2'],7,2,9,1875136,2,0,0,0,4453
11337afecb9a4fd0b993402c5195ef33dbd7a539,0,Jason Gustafson,2019-07-03 11:19:50-07:00,['3750898e20c0680d0c58220fd3ecb6ecf1b5fef0'],1,1,2,1875138,1,,,,4453
0b40d276477e6f405c6c163cee7d8b45c849eef7,0,Jason Gustafson,2019-07-03 11:23:23-07:00,['11337afecb9a4fd0b993402c5195ef33dbd7a539'],1,1,2,1875140,1,,,,4453
07a154eee75ae0580cd5e6a833947b7073450101,0,Jason Gustafson,2019-07-03 11:45:01-07:00,['0b40d276477e6f405c6c163cee7d8b45c849eef7'],1,1,2,1875142,1,,,,4453
822abe47db07fcf92e8aa24e920a54239a90348d,0,GitHub,2019-07-03 16:08:39-07:00,['07a154eee75ae0580cd5e6a833947b7073450101'],21,58,79,1875221,3,0.647058824,0.882352941,0.852941176,4453
442d36241bea6e83c75ed7513e48099b8d73ef39,0,Colin Patrick McCabe,2019-07-03 17:23:36-07:00,['822abe47db07fcf92e8aa24e920a54239a90348d'],5,31,36,1875257,3,0,0.8,0.8,4453
41e1c13a52082521b3702a8466f6b8a484cc6ddf,0,Jason Gustafson,2019-07-04 01:00:26-07:00,['442d36241bea6e83c75ed7513e48099b8d73ef39'],1,1,2,1875259,1,,,,4453
23beeea34bf9e5e7a33dc0566d54a17b2b417c0f,1,Jason Gustafson,2019-07-04 08:18:51-07:00,['41e1c13a52082521b3702a8466f6b8a484cc6ddf'],134,1236,1370,1876629,34,0.210169492,0.815254237,0.725423729,4459
2b529d15022c022a1f6705555442f089394d6ba3,0,GitHub,2019-07-04 08:22:45-07:00,['23beeea34bf9e5e7a33dc0566d54a17b2b417c0f'],12,18,30,1876659,2,0.666666667,1,0.5,4459
57903be49665566260160a6f1f995409ec48c9bc,0,GitHub,2019-07-05 07:50:32-07:00,['2b529d15022c022a1f6705555442f089394d6ba3'],23,5,28,1876687,10,0,0,0,4459
102490ea0caba93631c4dc7ea05a64c0117331b7,1,Bill Bejeck,2019-07-08 19:11:17-04:00,['57903be49665566260160a6f1f995409ec48c9bc'],24,17,41,1876728,3,,,,4459
05cba28ca7aafd3974e9e818be08f239b6162855,0,Jason Gustafson,2019-07-08 16:53:02-07:00,['102490ea0caba93631c4dc7ea05a64c0117331b7'],28,7,35,1876763,6,0,0,0,4459
289ac092923a32e5a839750fcaef0ae0856d05b3,0,Jason Gustafson,2019-07-08 23:07:10-07:00,['05cba28ca7aafd3974e9e818be08f239b6162855'],5,15,20,1876783,2,0,1,0,4459
3bb126dfbf7534135bfe73b5dbc9272b6acd351f,0,Manikumar Reddy,2019-07-09 14:13:38+05:18,['289ac092923a32e5a839750fcaef0ae0856d05b3'],2,2,4,1876787,2,,,,4459
99737588b6db7647d0d03b7306f143714fbae4d5,0,Colin Patrick McCabe,2019-07-09 11:46:07-07:00,['3bb126dfbf7534135bfe73b5dbc9272b6acd351f'],1,201,202,1876989,3,0.417721519,1,0.848101266,4461
38f86d139cbd8a3b92ce555f185e52252f626cd4,0,Jason Gustafson,2019-07-09 17:51:54-07:00,['99737588b6db7647d0d03b7306f143714fbae4d5'],4,4,8,1876997,3,,,,4461
65b044b2001065bce92045d236eb74dc57646f81,0,Jason Gustafson,2019-07-10 01:37:41-07:00,['38f86d139cbd8a3b92ce555f185e52252f626cd4'],26,29,55,1877052,1,,,,4461
df6efda1f2618c922821b14784857ab69c76c8d3,0,GitHub,2019-07-10 08:57:34-07:00,['65b044b2001065bce92045d236eb74dc57646f81'],6,7,13,1877065,1,1,1,1,4461
d67495d6a7f4c5f7e8736a25d6a11a1c1bef8d87,0,GitHub,2019-07-10 09:45:10-07:00,['df6efda1f2618c922821b14784857ab69c76c8d3'],43,7,50,1877115,4,0,0,0,4461
4f5a5eb579a20cf86eaf5018663d44e5592d0401,0,Colin Patrick McCabe,2019-07-10 14:48:37-07:00,['d67495d6a7f4c5f7e8736a25d6a11a1c1bef8d87'],172,137,309,1877424,10,0,1,1,4461
ebb80f568da59cf60c76170176584bcb34d88ecb,0,Ismael Juma,2019-07-10 23:19:04-07:00,['4f5a5eb579a20cf86eaf5018663d44e5592d0401'],15,36,51,1877475,3,0.454545455,1,1,4461
d70fe5ed2d25af432ec6ce02ccfeaa40bcd2f295,1,Gwen Shapira,2019-07-11 09:52:01-07:00,['ebb80f568da59cf60c76170176584bcb34d88ecb'],11,124,135,1877610,2,0.094594595,0.837837838,1,4462
7a7d4cb5819b169db2f40f0ca2efc04043ff10df,1,GitHub,2019-07-11 13:52:04-07:00,['d70fe5ed2d25af432ec6ce02ccfeaa40bcd2f295'],226,290,516,1878126,18,1,1,1,4462
25f4e3c7d4a50a55e3d66ea479e40a38c841ba39,0,Jason Gustafson,2019-07-11 21:54:33-07:00,['7a7d4cb5819b169db2f40f0ca2efc04043ff10df'],6,116,122,1878248,2,0.673469388,0.979591837,0.87755102,4463
53b4ce5c00d61be87962f603682873665155cec4,1,Bill Bejeck,2019-07-12 09:42:11-04:00,['25f4e3c7d4a50a55e3d66ea479e40a38c841ba39'],141,356,497,1878745,13,0.253246753,0.993506494,0.922077922,4463
8cabd44e1d35d3cf3f865d8a4eee8c04228e0d75,0,Bill Bejeck,2019-07-12 11:06:05-04:00,['53b4ce5c00d61be87962f603682873665155cec4'],1,1,2,1878747,1,,,,4463
fc4fea6761986749f0ac640868d9b4d2a552eb62,0,Randall Hauch,2019-07-12 10:27:33-05:00,['8cabd44e1d35d3cf3f865d8a4eee8c04228e0d75'],11,58,69,1878816,2,0,0.916666667,0.916666667,4463
fa042bc491cf8b1e8ae0e5b9f7996564ba886d3d,0,Randall Hauch,2019-07-12 12:12:20-05:00,['fc4fea6761986749f0ac640868d9b4d2a552eb62'],42,243,285,1879101,2,0.631578947,1,0.796052632,4463
ae4a97543e990407096d9a1e63c77bab8c18649c,1,GitHub,2019-07-12 15:18:17-04:00,['fa042bc491cf8b1e8ae0e5b9f7996564ba886d3d'],17,25,42,1879143,1,1,1,1,4463
d2328a1a0e2fa5f3592cd67b320fb8f223978659,0,Matthias J. Sax,2019-07-12 12:43:46-07:00,['ae4a97543e990407096d9a1e63c77bab8c18649c'],2,5,7,1879150,2,,,,4463
1d873a9de9ad98d9f3120fa2ff59c3372650775b,0,GitHub,2019-07-12 15:29:10-07:00,['d2328a1a0e2fa5f3592cd67b320fb8f223978659'],1,4,5,1879155,1,0.666666667,1,1,4463
ea814d78690940827e90950282f40a74ca45eb0f,1,Jason Gustafson,2019-07-12 17:18:40-07:00,['1d873a9de9ad98d9f3120fa2ff59c3372650775b'],17,17,34,1879189,6,,,,4463
1f2d230bfdaafb34c9be12a370ab2eb4d3016039,1,Jason Gustafson,2019-07-13 00:50:27-07:00,['ea814d78690940827e90950282f40a74ca45eb0f'],143,124,267,1879456,3,0,0,0,4463
528e5c0f57aa5014cd13baef2b683a1a328f459a,1,Bill Bejeck,2019-07-15 16:40:01-04:00,['1f2d230bfdaafb34c9be12a370ab2eb4d3016039'],1,248,249,1879705,3,0.542857143,1,0.95,4464
3e48bdbc333602a042b6b0fb7fb9e14625ab4ece,0,Matthias J. Sax,2019-07-15 15:02:13-07:00,['528e5c0f57aa5014cd13baef2b683a1a328f459a'],7,108,115,1879820,2,0.075949367,0.873417722,1,4464
8cefe977eb61759baaad644cf1a15020dd3c13ae,0,Guozhang Wang,2019-07-15 16:38:24-07:00,['3e48bdbc333602a042b6b0fb7fb9e14625ab4ece'],0,1,1,1879821,1,1,1,1,4464
d227f940489434c2f23491340d4399d98fd48d2d,1,GitHub,2019-07-16 13:08:16+01:00,['8cefe977eb61759baaad644cf1a15020dd3c13ae'],43,223,266,1880087,13,0.523076923,1,0.9,4464
00757cd99f6d8bf2760c3708d307347f4cde65f6,0,Bill Bejeck,2019-07-16 10:16:15-04:00,['d227f940489434c2f23491340d4399d98fd48d2d'],444,821,1265,1881352,28,0,0.559493671,0.853164557,4464
f65c71cf6e13973ebff8ef590eb3d369da4d1b11,1,GitHub,2019-07-16 12:00:49-07:00,['00757cd99f6d8bf2760c3708d307347f4cde65f6'],4,5,9,1881361,2,0,1,1,4464
ecf23b51b0f5a21bafb44c4b4c1e8c6c6bfa1a91,0,Jason Gustafson,2019-07-16 22:21:23-07:00,['f65c71cf6e13973ebff8ef590eb3d369da4d1b11'],2,5,7,1881368,1,,,,4464
53b10a37a42769b0c1b91c3a66fbe7f60917cab5,1,GitHub,2019-07-17 09:42:57-07:00,['ecf23b51b0f5a21bafb44c4b4c1e8c6c6bfa1a91'],23,51,74,1881442,9,0.9,0.9,1,4464
f8994897d30ef7508756dceb1d19171d6204f2a2,0,Bill Bejeck,2019-07-17 18:39:55-04:00,['53b10a37a42769b0c1b91c3a66fbe7f60917cab5'],6,142,148,1881590,6,1,1,1,4464
ab8a7ff36326742e1c6d4fc0a0aff818c7e6d313,1,Jason Gustafson,2019-07-18 13:25:25-07:00,['f8994897d30ef7508756dceb1d19171d6204f2a2'],12,19,31,1881621,2,1,1,1,4464
62fbc92e3d9d84617dab46329c279835d157bda4,1,Guozhang Wang,2019-07-18 13:54:46-07:00,['ab8a7ff36326742e1c6d4fc0a0aff818c7e6d313'],58,151,209,1881830,15,0.210526316,0.98245614,1,4464
2e26a46358d97112b9b912a7c5c29a2d6fb517cf,1,Jason Gustafson,2019-07-18 15:07:42-07:00,['62fbc92e3d9d84617dab46329c279835d157bda4'],59,81,140,1881970,2,1,1,1,4464
9829c726996f52bf02547951a13548ee4057e46f,0,Bill Bejeck,2019-07-19 12:58:27-04:00,['2e26a46358d97112b9b912a7c5c29a2d6fb517cf'],5,1,6,1881976,1,,,,4464
d0548758e5c89f0d387332227ae8f844f15a8772,0,GitHub,2019-07-19 13:15:17-04:00,['9829c726996f52bf02547951a13548ee4057e46f'],0,8,8,1881984,1,,,,4464
58938a045fd1eab517bdd3317be309b1be324dec,0,Matthias J. Sax,2019-07-19 10:53:37-07:00,['d0548758e5c89f0d387332227ae8f844f15a8772'],0,23,23,1882007,1,,,,4465
aa8e850afb7baa447882b493eae29f99a39e35a0,1,Guozhang Wang,2019-07-19 15:25:18-07:00,['58938a045fd1eab517bdd3317be309b1be324dec'],31,239,270,1882277,4,0.173611111,0.972222222,0.972222222,4465
e3524ef350830e3e1fa918ec0ae93b09d51fcf37,1,Colin Patrick McCabe,2019-07-19 17:04:22-07:00,['aa8e850afb7baa447882b493eae29f99a39e35a0'],209,248,457,1882734,12,0,0.973684211,1,4466
e5f7220b23ba556352d80a0575fcb6cbfe2d576d,0,Rajini Sivaram,2019-07-22 09:38:28+01:00,['e3524ef350830e3e1fa918ec0ae93b09d51fcf37'],3,10,13,1882747,2,1,1,1,4466
2a133ba656ae550cc9ad4bcda0a9afb27b14f4e0,1,Jason Gustafson,2019-07-22 15:47:34-07:00,['e5f7220b23ba556352d80a0575fcb6cbfe2d576d'],1206,1249,2455,1885202,121,1,1,1,4467
f98e176746d663fadedbcd3c18312a7f476a20c8,0,Jason Gustafson,2019-07-22 16:13:02-07:00,['2a133ba656ae550cc9ad4bcda0a9afb27b14f4e0'],4,164,168,1885370,4,0.422535211,1,1,4469
6b6a6b930fda853fd91dfbe85b4462e17654f804,0,Jason Gustafson,2019-07-23 08:57:38-07:00,['f98e176746d663fadedbcd3c18312a7f476a20c8'],47,112,159,1885529,2,0.268292683,1,1,4469
a8aedc85ebfadcf1472acafe2e0311a73d3040be,1,Guozhang Wang,2019-07-23 16:54:20-07:00,['6b6a6b930fda853fd91dfbe85b4462e17654f804'],230,292,522,1886051,32,0,0,0.625,4472
e9c61f690e548fb8c587d777e5c8f71149a38fea,1,Jun Rao,2019-07-24 22:17:05-07:00,['a8aedc85ebfadcf1472acafe2e0311a73d3040be'],29,64,93,1886144,2,0.956521739,0.913043478,1,4472
69d86a197f86ad4c6f1636b5ab4678907e30a4c0,1,Guozhang Wang,2019-07-25 13:02:09-07:00,['e9c61f690e548fb8c587d777e5c8f71149a38fea'],460,495,955,1887099,22,0.639344262,0.606557377,0.524590164,4474
79341a12f235510d9f78af24d979102c3d8882e1,1,Jason Gustafson,2019-07-26 15:31:30-07:00,['69d86a197f86ad4c6f1636b5ab4678907e30a4c0'],1,18,19,1887118,2,1,1,1,4474
74c90f46c34727be9484e9826ff543b451ada775,1,Jason Gustafson,2019-07-26 23:13:37-07:00,['79341a12f235510d9f78af24d979102c3d8882e1'],453,1065,1518,1888636,20,0.664021164,0.952380952,0.957671958,4474
9ad7bce492869e7d971bb7c83becf795622fa4dd,0,Ismael Juma,2019-07-27 23:35:25-07:00,['74c90f46c34727be9484e9826ff543b451ada775'],1,2,3,1888639,1,,,,4474
acf507ce9cd0a6037da3e4c561bd4c50ba526f8a,1,GitHub,2019-07-28 09:38:26-07:00,['9ad7bce492869e7d971bb7c83becf795622fa4dd'],42,11,53,1888692,9,0.333333333,0,0,4474
39bcc8447c906506d63b8df156cf90174bbb8b78,0,GitHub,2019-07-28 18:18:59-07:00,['acf507ce9cd0a6037da3e4c561bd4c50ba526f8a'],4,14,18,1888710,1,,,,4474
81900d0ba0a5839a1e5dc876897bab1c24b3bd94,1,Colin Patrick McCabe,2019-07-29 14:35:55-07:00,['39bcc8447c906506d63b8df156cf90174bbb8b78'],15,867,882,1889592,22,0.59375,0.8125,0.909090909,4483
204710832eb4787b185264a0c8e5fe89a3db9d44,0,Jason Gustafson,2019-07-30 08:29:45-07:00,['81900d0ba0a5839a1e5dc876897bab1c24b3bd94'],296,569,865,1890457,15,0.387665198,0.603524229,0.942731278,4485
c6286b2b3e0d573773844f9b0a2931e9c2058f58,1,Jason Gustafson,2019-07-30 08:44:11-07:00,['204710832eb4787b185264a0c8e5fe89a3db9d44'],7,9,16,1890473,4,1,1,1,4485
a48b5d900c6b5c9c52a97124a1b51aff3636c32c,1,GitHub,2019-07-30 08:50:13-07:00,['c6286b2b3e0d573773844f9b0a2931e9c2058f58'],189,314,503,1890976,17,0.226086957,1,0.817391304,4485
73ed9eac2c875a12d933af48b7a7817ea57ad447,0,GitHub,2019-07-30 13:35:02-07:00,['a48b5d900c6b5c9c52a97124a1b51aff3636c32c'],24,26,50,1891026,1,1,1,0,4485
de8ce78a90632b0d79e0a6ad6abb638982376b52,0,GitHub,2019-07-31 16:19:36+01:00,['73ed9eac2c875a12d933af48b7a7817ea57ad447'],6,28,34,1891060,3,0.166666667,0.25,0.166666667,4485
211745d0b3346b69451932358f45987dc790858f,1,GitHub,2019-07-31 08:27:38-07:00,['de8ce78a90632b0d79e0a6ad6abb638982376b52'],98,126,224,1891284,3,1,1,0,4485
cdea3480c693d270064ebcb3871d08dee053ce7f,0,Jun Rao,2019-07-31 09:06:55-07:00,['211745d0b3346b69451932358f45987dc790858f'],1,1,2,1891286,1,,,,4485
6fbac3cfa88bd3eba36b2d3e254d7ce5e11a550b,0,Guozhang Wang,2019-07-31 13:53:38-07:00,['cdea3480c693d270064ebcb3871d08dee053ce7f'],15,333,348,1891634,11,0.680555556,0.791666667,1,4487
2c2b30d96b7d30037d3ee69ebbf985cd88557af9,0,Colin Patrick McCabe,2019-07-31 14:00:49-07:00,['6fbac3cfa88bd3eba36b2d3e254d7ce5e11a550b'],3,290,293,1891927,5,0.165354331,0.472440945,1,4489
a028f597d7ea042c414e9669d2261c1423a96f95,0,Bill Bejeck,2019-07-31 17:19:46-04:00,['2c2b30d96b7d30037d3ee69ebbf985cd88557af9'],0,13,13,1891940,2,0,1,1,4489
06e246d4a11c63d1b46516442de81f370f89a0ee,0,GitHub,2019-08-01 11:31:00-07:00,['a028f597d7ea042c414e9669d2261c1423a96f95'],123,150,273,1892213,1,0,1,0.444444444,4489
d997dc65a434558961a842fd2006a6ed36cd1ac7,0,Matthias J. Sax,2019-08-01 11:47:21-07:00,['06e246d4a11c63d1b46516442de81f370f89a0ee'],1,1,2,1892215,1,,,,4489
717c55be971df862c55f55d245b9997f1d6f998c,1,Colin Patrick McCabe,2019-08-01 14:36:12-07:00,['d997dc65a434558961a842fd2006a6ed36cd1ac7'],254,569,823,1893038,12,0.154255319,0.478723404,0.85106383,4491
1546fc30af520f8d133aa3454cdc8a036bae0f3e,1,Jason Gustafson,2019-08-01 17:10:19-07:00,['717c55be971df862c55f55d245b9997f1d6f998c'],34,253,287,1893325,3,0.103703704,0.888888889,1,4491
22d4ccd8acbece69e1e1897714b18ff95ff37694,0,GitHub,2019-08-02 06:09:51-07:00,['1546fc30af520f8d133aa3454cdc8a036bae0f3e'],2,3,5,1893330,3,,,,4491
a7d0fdd534ef55533a868ea7388bbc081ee42718,0,Guozhang Wang,2019-08-02 09:51:03-07:00,['22d4ccd8acbece69e1e1897714b18ff95ff37694'],9,852,861,1894191,4,0.972027972,1,0.809440559,4493
a99e0111114d1cb8c762494ac195cf84e6425bb3,1,Gwen Shapira,2019-08-02 11:51:35-07:00,['a7d0fdd534ef55533a868ea7388bbc081ee42718'],109,719,828,1895019,12,0.418823529,0.741176471,0.894117647,4494
96c575a2c7d5740efe9b4fdbc5a6c22c558a3f8f,0,GitHub,2019-08-02 21:37:42-07:00,['a99e0111114d1cb8c762494ac195cf84e6425bb3'],9,9,18,1895037,3,,,,4494
c76f5651fa1b406d8f7a88b20e435ad4f14c4797,0,Matthias J. Sax,2019-08-03 13:51:43-07:00,['96c575a2c7d5740efe9b4fdbc5a6c22c558a3f8f'],1,1,2,1895039,1,,,,4494
320f7b0d7afd75c6d76ee33770461e93bef43689,1,GitHub,2019-08-03 14:03:15-07:00,['c76f5651fa1b406d8f7a88b20e435ad4f14c4797'],5,4,9,1895048,1,1,1,0,4494
0b1dc1ca7be3566a4367d7d3aae2c691cf94f48e,1,Gwen Shapira,2019-08-03 21:00:46-07:00,['320f7b0d7afd75c6d76ee33770461e93bef43689'],19,157,176,1895224,11,0,0.955882353,0.970588235,4494
f70ece26d1cce23556f8f69ca2ccb2bb9e4f4de1,0,GitHub,2019-08-03 23:59:06-07:00,['0b1dc1ca7be3566a4367d7d3aae2c691cf94f48e'],6,60,66,1895290,3,1,1,1,4494
7663a6c44daae5d72f38cbba79d728416e11167d,1,Guozhang Wang,2019-08-06 08:51:08-07:00,['f70ece26d1cce23556f8f69ca2ccb2bb9e4f4de1'],84,85,169,1895459,10,0,1,0,4494
7ebcd50fbf70dcf401094f6f28dc615820835fb1,0,Matthias J. Sax,2019-08-06 10:05:44-07:00,['7663a6c44daae5d72f38cbba79d728416e11167d'],2,6,8,1895467,2,1,1,1,4494
e4e2dd31ca66330aefdbb226eb25968bb14fee64,0,Gwen Shapira,2019-08-06 12:25:23-07:00,['7ebcd50fbf70dcf401094f6f28dc615820835fb1'],29,33,62,1895529,2,0,1,1,4494
97b731b0866c1e78b9136e8bc088f8a1a19b966a,0,GitHub,2019-08-06 23:01:10-07:00,['e4e2dd31ca66330aefdbb226eb25968bb14fee64'],1,2,3,1895532,1,,,,4494
926fb35d9dcefd45c1e1d276ee7252b15875f23e,0,Manikumar Reddy,2019-08-07 13:20:26+05:18,['97b731b0866c1e78b9136e8bc088f8a1a19b966a'],119,73,192,1895724,9,0,0,1,4494
66d81a0e50680916f541703049dd4e911542b5ed,0,GitHub,2019-08-08 06:01:22-07:00,['926fb35d9dcefd45c1e1d276ee7252b15875f23e'],13,13,26,1895750,4,,,,4494
e867a58425876767b952e06892c72b5e13066acc,1,GitHub,2019-08-08 14:31:22-07:00,['66d81a0e50680916f541703049dd4e911542b5ed'],275,686,961,1896711,19,0.428571429,0.782857143,1,4494
5e543ae10832808a9d7efef363603f07695d4368,0,Manikumar Reddy,2019-08-09 12:37:38+05:18,['e867a58425876767b952e06892c72b5e13066acc'],127,75,202,1896913,8,0,0,0.833333333,4494
600cc48fa56ca675421eaf383929e89a04b529f1,0,GitHub,2019-08-09 06:16:32-07:00,['5e543ae10832808a9d7efef363603f07695d4368'],7,8,15,1896928,3,0,1,0,4494
3f0064974f5040da5bedd07f3eb382ac63424537,0,Ismael Juma,2019-08-09 08:05:25-07:00,['600cc48fa56ca675421eaf383929e89a04b529f1'],1,6,7,1896935,1,,,,4494
e9a35fe02effe10dcbec2daed4ef66c40d35716c,0,GitHub,2019-08-09 14:33:20-07:00,['3f0064974f5040da5bedd07f3eb382ac63424537'],8,7,15,1896950,4,,,,4494
7511ccf68dc41a78bdef8f34e57d94b600666232,0,Randall Hauch,2019-08-11 09:56:05-05:00,['e9a35fe02effe10dcbec2daed4ef66c40d35716c'],4,34,38,1896988,3,0,0.904761905,0.904761905,4494
35ed7b14cc8f943b4fbc9945a93eecbff7b72ab2,0,Ismael Juma,2019-08-11 11:44:30-07:00,['7511ccf68dc41a78bdef8f34e57d94b600666232'],3,11,14,1897002,1,1,1,1,4494
558bb1d0692b3ba6cf9c46d7170be6d31656024b,0,GitHub,2019-08-11 15:31:42-07:00,['35ed7b14cc8f943b4fbc9945a93eecbff7b72ab2'],54,43,97,1897099,6,0.444444444,0,0,4494
4148d79880948a928a211c88d7280c748780c8aa,1,Vahid Hashemian,2019-08-11 20:42:24-07:00,['558bb1d0692b3ba6cf9c46d7170be6d31656024b'],47,31,78,1897177,9,0,0,0,4494
0c2d1c390d9e1653d25654bef9418af1fc68fdb7,0,Jason Gustafson,2019-08-12 12:53:28-07:00,['4148d79880948a928a211c88d7280c748780c8aa'],29,41,70,1897247,1,,,,4494
88087e91dd4eed1ee3c3e12961db84b7b56c34a0,0,Colin Patrick McCabe,2019-08-12 14:17:28-07:00,['0c2d1c390d9e1653d25654bef9418af1fc68fdb7'],39,43,82,1897329,4,,,,4494
794637232cea44ee458839a293091473e81fb01e,0,Randall Hauch,2019-08-13 09:40:12-05:00,['88087e91dd4eed1ee3c3e12961db84b7b56c34a0'],3,32,35,1897364,3,1,1,1,4494
e2c8612d01f5e6e97476b1656fe728b2f316efef,1,Randall Hauch,2019-08-13 10:16:54-05:00,['794637232cea44ee458839a293091473e81fb01e'],12,112,124,1897488,7,0.213333333,0.946666667,1,4494
e5657bc910bbf82638a8b6c3e96c30101cf27560,0,Gwen Shapira,2019-08-13 11:14:41-07:00,['e2c8612d01f5e6e97476b1656fe728b2f316efef'],30,790,820,1898308,12,0.916363636,0.923636364,0.952727273,4498
ff9e95cb09907739c17b4f4681b11c525515b995,0,Jason Gustafson,2019-08-13 12:33:05-07:00,['e5657bc910bbf82638a8b6c3e96c30101cf27560'],0,144,144,1898452,1,0.138888889,0.486111111,0.958333333,4499
f8078f380381604f1c7b07204b98e9c08d5e0af1,0,Bill Bejeck,2019-08-13 17:54:58-04:00,['ff9e95cb09907739c17b4f4681b11c525515b995'],13,10,23,1898475,1,0,0,0,4499
e07b46dd0424717829f5e12fb0fa91065b943fcd,0,Guozhang Wang,2019-08-13 16:30:48-07:00,['f8078f380381604f1c7b07204b98e9c08d5e0af1'],128,4,132,1898607,23,0.243902439,0.097560976,0.097560976,4499
245e9caa4418f9c2241ce1e518d5159ec6e53ad1,0,GitHub,2019-08-13 18:37:45-07:00,['e07b46dd0424717829f5e12fb0fa91065b943fcd'],133,240,373,1898980,2,0.293478261,0.043478261,1,4499
2ca30191d2bb430a4b27b125177406cf263d444f,1,Ismael Juma,2019-08-13 21:35:03-07:00,['245e9caa4418f9c2241ce1e518d5159ec6e53ad1'],10,11,21,1899001,1,,,,4499
39158bd944f7c64e32634cec8171515b93466ffa,0,GitHub,2019-08-13 22:39:42-07:00,['2ca30191d2bb430a4b27b125177406cf263d444f'],51,1,52,1899053,24,,,,4499
f125c2dfe22a9a51f2881f63673c9b85a863ba14,0,Gwen Shapira,2019-08-13 23:07:49-07:00,['39158bd944f7c64e32634cec8171515b93466ffa'],0,4,4,1899057,1,,,,4499
e6fe4c13deb9ca814513a8c12d79dd76af658762,0,Bill Bejeck,2019-08-14 10:58:28-04:00,['f125c2dfe22a9a51f2881f63673c9b85a863ba14'],1,1,2,1899059,1,,,,4499
5129ab53ee9a2e46a22a13b1d5300ee139c4999f,1,Colin Patrick McCabe,2019-08-14 09:25:17-07:00,['e6fe4c13deb9ca814513a8c12d79dd76af658762'],15,878,893,1899952,16,0.15212528,0.554809843,0.988814318,4505
4d169f5a859ac1d4a34134ef5b6def574769aa43,1,Jason Gustafson,2019-08-14 09:56:03-07:00,['5129ab53ee9a2e46a22a13b1d5300ee139c4999f'],48,232,280,1900232,5,0.736263736,0.637362637,0.945054945,4507
ebf78c04c9aa841f7bd702afdbc782cc07b35ad8,1,GitHub,2019-08-14 19:44:38-07:00,['4d169f5a859ac1d4a34134ef5b6def574769aa43'],81,203,284,1900516,6,0.266666667,0.12,0.626666667,4507
b13391e0fe0b249d46e47d886fbdafaaed7c1eef,0,Jason Gustafson,2019-08-15 09:53:56-07:00,['ebf78c04c9aa841f7bd702afdbc782cc07b35ad8'],1,2,3,1900519,1,,,,4507
14215d1b84e937c4656e0984c1ce76d9aac65bdd,0,Jason Gustafson,2019-08-15 13:47:56-07:00,['b13391e0fe0b249d46e47d886fbdafaaed7c1eef'],57,51,108,1900627,6,1,1,1,4507
83a575d4b92a7a49917244dbf7cdee0d2c5aa253,0,Colin Patrick McCabe,2019-08-15 15:49:28-07:00,['14215d1b84e937c4656e0984c1ce76d9aac65bdd'],4,24,28,1900655,4,1,0,1,4507
bd7d92e0c3dae4841f23f796f50384e6653111a2,0,Rajini Sivaram,2019-08-16 08:43:24+01:00,['83a575d4b92a7a49917244dbf7cdee0d2c5aa253'],33,132,165,1900820,4,0.328358209,1,0.985074627,4507
b8605c9bc1331b876f9d134ebc8fcf9bfc684c8e,0,Manikumar Reddy,2019-08-16 22:53:54+05:18,['bd7d92e0c3dae4841f23f796f50384e6653111a2'],241,82,323,1901143,6,0.95,0,0,4507
e2d16b504c717038ba6030b40661df80b92353fe,0,Guozhang Wang,2019-08-16 10:41:30-07:00,['b8605c9bc1331b876f9d134ebc8fcf9bfc684c8e'],36,42,78,1901221,3,1,1,1,4507
33d06082117d971cdcddd4f01392006b543f3c01,1,Colin Patrick McCabe,2019-08-16 13:28:10-07:00,['e2d16b504c717038ba6030b40661df80b92353fe'],1902,1902,3804,1905025,265,0.333137139,0.959387875,0.974102413,4507
b9ffe596864b576d81c3ca0ae060ae4ac9006d0c,0,Colin Patrick McCabe,2019-08-16 16:04:03-07:00,['33d06082117d971cdcddd4f01392006b543f3c01'],0,272,272,1905297,2,0.060150376,0.060150376,0.954887218,4509
572f9e697693e53facb087e9ddb1bac9ecabb1b6,0,Manikumar Reddy,2019-08-17 21:16:43+05:18,['b9ffe596864b576d81c3ca0ae060ae4ac9006d0c'],1,1,2,1905299,1,,,,4509
784f7e84edea548ef76008dddc750ac650479755,0,Ismael Juma,2019-08-17 09:27:35-07:00,['572f9e697693e53facb087e9ddb1bac9ecabb1b6'],2,2,4,1905303,1,,,,4509
aa4ba8eee8e6f52a9d80a98fb2530b5bcc1b9a11,1,Ismael Juma,2019-08-17 14:24:08-07:00,['784f7e84edea548ef76008dddc750ac650479755'],33,62,95,1905398,1,0.363636364,1,0,4509
6c8f654d5f0609a2a3426fca70dca93d263f1515,0,Ewen Cheslack-Postava,2019-08-19 17:12:48-07:00,['aa4ba8eee8e6f52a9d80a98fb2530b5bcc1b9a11'],2,2,4,1905402,2,,,,4509
4d1ee26a136997d31dbd6ddca07e09b34c41c77d,1,GitHub,2019-08-21 10:26:57-07:00,['6c8f654d5f0609a2a3426fca70dca93d263f1515'],9,122,131,1905533,9,0,1,1,4510
35bc53c55ff317890d13490443a8685adfc33084,0,Matthias J. Sax,2019-08-21 19:48:00-07:00,['4d1ee26a136997d31dbd6ddca07e09b34c41c77d'],6,31,37,1905570,5,1,1,1,4510
e4215c17846d8790712ee1764f3f852d99d3fc3a,1,Jason Gustafson,2019-08-21 23:29:20-07:00,['35bc53c55ff317890d13490443a8685adfc33084'],8,51,59,1905629,2,0.071428571,1,1,4510
e213608127696dd742752bbc57da209e8eade0f2,1,Guozhang Wang,2019-08-22 13:35:33-07:00,['e4215c17846d8790712ee1764f3f852d99d3fc3a'],2,14,16,1905645,2,1,1,1,4510
40b7166e812bae97497edbcb9f4ec1a0cb3fa53c,0,Manikumar Reddy,2019-08-23 18:30:57+05:18,['e213608127696dd742752bbc57da209e8eade0f2'],1,1,2,1905647,1,,,,4510
c1f2b0ffb820c4af030f24ca50693d8169261f95,0,Jason Gustafson,2019-08-23 13:22:41-07:00,['40b7166e812bae97497edbcb9f4ec1a0cb3fa53c'],0,78,78,1905725,3,0.2,0.4,1,4510
c6664e1d081155f6a24ac940fa07c2a061e71cff,0,GitHub,2019-08-23 14:34:32-07:00,['c1f2b0ffb820c4af030f24ca50693d8169261f95'],5,2,7,1905732,1,1,0,0,4510
237e83dea081b38d2af8fa465df4f1914747ba6f,1,Randall Hauch,2019-08-25 15:54:00-05:00,['c6664e1d081155f6a24ac940fa07c2a061e71cff'],19,61,80,1905812,3,0.571428571,0,0.657142857,4510
5b4e749dc671df583588c713913bb9eb85e67cc2,1,Gwen Shapira,2019-08-25 14:30:23-07:00,['237e83dea081b38d2af8fa465df4f1914747ba6f'],0,4,4,1905816,1,,,,4510
d7f8ec8628ee18326d22f6a58c787629a8faf307,0,Randall Hauch,2019-08-25 17:35:03-05:00,['5b4e749dc671df583588c713913bb9eb85e67cc2'],1,4,5,1905821,1,,,,4510
7334222a71d522f2e99ee84622c672a4c5636e1f,1,Guozhang Wang,2019-08-26 09:53:36-07:00,['d7f8ec8628ee18326d22f6a58c787629a8faf307'],22,136,158,1905979,4,0,0.945205479,1,4510
d08bcae7f99a863b6d2058a1568384f904e539ed,1,Harsha,2019-08-26 10:01:01-07:00,['7334222a71d522f2e99ee84622c672a4c5636e1f'],16,434,450,1906429,19,0.772727273,0.8,0.890909091,4517
6b24b2e8363180cc9cfbca11dbce9cf60c7013be,1,Guozhang Wang,2019-08-26 13:59:49-07:00,['d08bcae7f99a863b6d2058a1568384f904e539ed'],3,33,36,1906465,4,0.052631579,1,1,4517
24547b810ce9aae4389dad7f41cc47caba73046c,1,Guozhang Wang,2019-08-26 16:28:22-07:00,['6b24b2e8363180cc9cfbca11dbce9cf60c7013be'],104,733,837,1907302,27,0.401639344,0.967213115,0.904371585,4519
add662907d8002a4c38196c4d8654a0db19a061a,0,Guozhang Wang,2019-08-27 09:55:51-07:00,['24547b810ce9aae4389dad7f41cc47caba73046c'],1,5,6,1907308,1,0,0,1,4519
e23a7182d5252a057e053dd19554c515100dc63b,0,Guozhang Wang,2019-08-27 13:01:29-07:00,['add662907d8002a4c38196c4d8654a0db19a061a'],30,43,73,1907381,2,0,1,1,4519
cf32a1a6a06df910dd11f26abe7b62e560392e25,1,Guozhang Wang,2019-08-27 14:41:33-07:00,['e23a7182d5252a057e053dd19554c515100dc63b'],1674,1973,3647,1911028,10,0.625,0.946428571,0,4523
826408e12204d4260c018ee1da7a327193682ada,0,Ismael Juma,2019-08-27 21:12:38-07:00,['cf32a1a6a06df910dd11f26abe7b62e560392e25'],63,117,180,1911208,3,1,1,1,4523
d32a2d12757e24311cae8f495a3b6f2150f3e041,0,Ismael Juma,2019-08-27 22:23:19-07:00,['826408e12204d4260c018ee1da7a327193682ada'],34,50,84,1911292,6,1,1,1,4523
fcfee618ee440cb78e422963ba7db1fa03620b33,0,Guozhang Wang,2019-08-28 09:22:36-07:00,['d32a2d12757e24311cae8f495a3b6f2150f3e041'],3,4,7,1911299,1,1,0,1,4523
d2741e5cbf546117d9eb3f6776f9063bfc240d9d,0,Guozhang Wang,2019-08-29 11:26:44-07:00,['fcfee618ee440cb78e422963ba7db1fa03620b33'],11,2,13,1911312,2,0,0,0,4523
09ad6b84c558b2f2790dac3317709f7593c81bc8,0,Guozhang Wang,2019-08-29 14:12:08-07:00,['d2741e5cbf546117d9eb3f6776f9063bfc240d9d'],1,1,2,1911314,1,,,,4523
fb381cb6c7c9e1183dfeb88dd94c25134049ece9,0,Jason Gustafson,2019-08-29 18:02:27-07:00,['09ad6b84c558b2f2790dac3317709f7593c81bc8'],2,2,4,1911318,1,,,,4523
d18d6b033e09515adff19225f8ec6845ca34c23b,0,Bill Bejeck,2019-08-30 09:46:07-04:00,['fb381cb6c7c9e1183dfeb88dd94c25134049ece9'],60,69,129,1911447,16,,,,4523
40432e31f7c5b0e0992a51621dc8b1c0e3d3103f,0,GitHub,2019-08-30 14:48:46-07:00,['d18d6b033e09515adff19225f8ec6845ca34c23b'],3,2,5,1911452,1,1,1,0,4523
a225347ff20a8d12fa6ffb6788feb64af25a0b3c,0,GitHub,2019-08-30 16:07:59-07:00,['40432e31f7c5b0e0992a51621dc8b1c0e3d3103f'],1,7,8,1911460,1,0,0,1,4523
364794866f82d2d99f7a610d699478d5055688f0,1,GitHub,2019-09-02 14:43:17+01:00,['a225347ff20a8d12fa6ffb6788feb64af25a0b3c'],948,3406,4354,1915814,49,0.540830946,0.888968481,0.95773639,4535
88d1b6de1f0e5b5228743f4f54ac01a2a153adf9,0,Manikumar Reddy,2019-09-02 23:20:49+05:18,['364794866f82d2d99f7a610d699478d5055688f0'],90,98,188,1916002,6,1,1,0,4535
2c0157765f3fa174c48520fc8cf7dc542cbf7273,1,Bill Bejeck,2019-09-03 10:27:03-04:00,['88d1b6de1f0e5b5228743f4f54ac01a2a153adf9'],26,22,48,1916050,1,1,1,0,4535
31a5f92b9f657d3b0f65ad2abfc2a085958621c9,0,Randall Hauch,2019-09-03 15:47:17-05:00,['2c0157765f3fa174c48520fc8cf7dc542cbf7273'],1,1,2,1916052,1,,,,4535
74fc3323a5815fad80318e96a88dc2164c700809,0,Randall Hauch,2019-09-03 15:48:19-05:00,['31a5f92b9f657d3b0f65ad2abfc2a085958621c9'],0,90,90,1916142,1,0,1,1,4535
caaf253b637d8fa2ad90b84a5b55103e192b37d6,0,Bill Bejeck,2019-09-04 10:12:18-04:00,['8dc80e22973d89090833cb791d9269e9a0598059'],3,0,3,1916189,1,0,0,0,4535
18e6bb251b6637d49ec53d790ea8e8ef7ab808c4,0,Bill Bejeck,2019-09-04 10:13:56-04:00,['caaf253b637d8fa2ad90b84a5b55103e192b37d6'],2,2,4,1916193,1,,,,4535
8d8e2fb5c94a2287d62fe010c87fe0c8728e88c0,1,Guozhang Wang,2019-09-04 12:46:30-07:00,['18e6bb251b6637d49ec53d790ea8e8ef7ab808c4'],106,300,406,1916599,8,0.025974026,0.714285714,0.649350649,4535
c5f2bd64d1f21a44bc9832f80f4ae76d3c065b96,0,Manikumar Reddy,2019-09-05 08:55:23+05:18,['8d8e2fb5c94a2287d62fe010c87fe0c8728e88c0'],7,7,14,1916613,6,,,,4535
b66ea874406c3b4d59b23e47e036cbdd4c843c7a,0,GitHub,2019-09-05 09:21:01+01:00,['c5f2bd64d1f21a44bc9832f80f4ae76d3c065b96'],62,52,114,1916727,11,1,0.214285714,0,4535
c9318ced19c812c90066af468732d8af8d12f890,0,GitHub,2019-09-05 09:23:11+01:00,['b66ea874406c3b4d59b23e47e036cbdd4c843c7a'],4,39,43,1916770,2,0,1,0.939393939,4535
deac5d93cef000f408332a7648a3062e4e25e388,1,GitHub,2019-09-05 09:10:52-07:00,['c9318ced19c812c90066af468732d8af8d12f890'],129,208,337,1917107,6,1,1,0.740740741,4535
ffef0871c2d64bcbc171b129c2057b572c2f41b2,1,Guozhang Wang,2019-09-05 13:50:55-07:00,['deac5d93cef000f408332a7648a3062e4e25e388'],57,163,220,1917327,6,0.674418605,0.104651163,0.930232558,4535
ad3ccf8f317bd28b6527fd4d5089ce8f0a37479f,1,Jason Gustafson,2019-09-05 23:03:13-07:00,['ffef0871c2d64bcbc171b129c2057b572c2f41b2'],110,82,192,1917519,1,0,0,0.4,4535
c0019e653891182d7a95464175c9b4ef63f8bae1,0,Jason Gustafson,2019-09-05 23:07:42-07:00,['ad3ccf8f317bd28b6527fd4d5089ce8f0a37479f'],344,820,1164,1918683,18,0,0.771159875,1,4538
c65e19ae95549f7dc49eec3e5fd3cc2de84687d9,0,GitHub,2019-09-06 00:54:53-07:00,['c0019e653891182d7a95464175c9b4ef63f8bae1'],106,15,121,1918804,5,0.962264151,0.41509434,0,4538
7b62248c6219937727e059cd4ecf020d9188894e,0,GitHub,2019-09-06 09:44:15-07:00,['c65e19ae95549f7dc49eec3e5fd3cc2de84687d9'],2,2,4,1918808,1,,,,4538
0f177ea6b826cd96f7a4a687da3691fb786a0a89,1,Guozhang Wang,2019-09-08 17:06:06-07:00,['7b62248c6219937727e059cd4ecf020d9188894e'],505,749,1254,1920062,18,0,0.794117647,1,4542
39afe9fe0eea057a53d85ec645ea2dcba54b29f7,0,Gwen Shapira,2019-09-08 19:49:13-07:00,['0f177ea6b826cd96f7a4a687da3691fb786a0a89'],0,729,729,1920791,3,0.514367816,0.899425287,0.755747126,4544
312e4db5902a2d18d7e1df4932608fe789cec6d0,0,Colin Patrick McCabe,2019-09-09 07:57:29-07:00,['39afe9fe0eea057a53d85ec645ea2dcba54b29f7'],3,53,56,1920847,2,,,,4544
e59e4caadc48ee3ba3325d98cbc1fc714ced2b8e,1,Guozhang Wang,2019-09-09 13:06:47-07:00,['312e4db5902a2d18d7e1df4932608fe789cec6d0'],23,711,734,1921581,13,0.230769231,0.621082621,1,4550
d54285f0c0f1095bab0fa860e73f9258def397c2,0,Guozhang Wang,2019-09-09 22:26:53-07:00,['e59e4caadc48ee3ba3325d98cbc1fc714ced2b8e'],1,1,2,1921583,1,,,,4550
18246e509ee39736d38694b98e0c98ee73c6675f,0,Bill Bejeck,2019-09-10 16:37:34-04:00,['d54285f0c0f1095bab0fa860e73f9258def397c2'],37,3,40,1921623,2,1,0.12,0,4550
7012fa3262d63cb15125ea45c378128786899b49,0,Jason Gustafson,2019-09-10 17:29:15-07:00,['18246e509ee39736d38694b98e0c98ee73c6675f'],3,5,8,1921631,1,0.5,1,1,4550
a043edb559a20501660ffe593b4c14bc572dc16e,0,GitHub,2019-09-10 19:01:10-07:00,['7012fa3262d63cb15125ea45c378128786899b49'],6,6,12,1921643,1,,,,4550
41b89a6ecf2aef6ee01b8bbf9a38c366d242b0ca,0,GitHub,2019-09-10 19:08:42-07:00,['a043edb559a20501660ffe593b4c14bc572dc16e'],0,1,1,1921644,1,1,1,1,4550
18d4e57f6e8c67ffa7937fc855707d3a03cc165a,1,Colin Patrick McCabe,2019-09-10 22:19:44-07:00,['41b89a6ecf2aef6ee01b8bbf9a38c366d242b0ca'],326,1721,2047,1923691,27,0.220977597,0.843177189,0.916496945,4551
6882b3b760de3208ee0cca86d6e1a651cc5e5a1f,0,GitHub,2019-09-11 16:56:56+01:00,['18d4e57f6e8c67ffa7937fc855707d3a03cc165a'],75,218,293,1923984,13,0.410526316,0.831578947,1,4551
6a3a58039943aa047fbd07abfc7eff6431c367a5,0,Guozhang Wang,2019-09-11 11:01:39-07:00,['6882b3b760de3208ee0cca86d6e1a651cc5e5a1f'],1,58,59,1924043,2,1,1,1,4551
d3559f628b2ccb23a9faf531796675376ac06abb,0,Jason Gustafson,2019-09-11 14:24:27-07:00,['6a3a58039943aa047fbd07abfc7eff6431c367a5'],1,21,22,1924065,2,0.875,0.875,0.875,4551
23708b77db110bdb20bf4a01b656d1b0ccc0f864,0,Guozhang Wang,2019-09-12 09:57:22-07:00,['d3559f628b2ccb23a9faf531796675376ac06abb'],136,283,419,1924484,4,0.771428571,1,1,4551
6530600e6b314565f100b65ae774f3f409ed9828,1,Colin Patrick McCabe,2019-09-13 11:36:58-07:00,['23708b77db110bdb20bf4a01b656d1b0ccc0f864'],17,311,328,1924812,15,0.591194969,0.79245283,0.93081761,4553
83c7c0158fc62c294267f0ae60e9f52945e6a678,1,Guozhang Wang,2019-09-13 15:45:29-07:00,['6530600e6b314565f100b65ae774f3f409ed9828'],138,698,836,1925648,11,0.135135135,0.962162162,0.862162162,4554
ac385c4c3a770728848438f28f4acb8854ffc868,0,Jason Gustafson,2019-09-13 15:48:36-07:00,['83c7c0158fc62c294267f0ae60e9f52945e6a678'],27,87,114,1925762,16,0.272727273,0.272727273,0.931818182,4554
e24d0e22abb0fb3e4cb3974284a3dad126544584,1,Jason Gustafson,2019-09-13 16:49:25-07:00,['ac385c4c3a770728848438f28f4acb8854ffc868'],21,1717,1738,1927500,27,0.225480283,0.898887765,0.956521739,4561
fbd06ec00c42a937ba06943431ae99ea2da31c4b,0,GitHub,2019-09-16 13:13:06-07:00,['e24d0e22abb0fb3e4cb3974284a3dad126544584'],23,123,146,1927646,2,0.644444444,1,1,4561
c5dfb90b46d52112963066295dcd38e10cb61a9d,1,Jason Gustafson,2019-09-16 13:26:20-07:00,['fbd06ec00c42a937ba06943431ae99ea2da31c4b'],12,5,17,1927663,5,1,1,1,4561
bab3e082dc48bc3db68692694bd114a39b41fa68,1,Guozhang Wang,2019-09-16 21:48:25-07:00,['c5dfb90b46d52112963066295dcd38e10cb61a9d'],39,116,155,1927818,13,0.927272727,0.927272727,0.490909091,4561
935b280540913ade0b2dc1549ba22c4262ee2669,1,Guozhang Wang,2019-09-17 09:43:39-07:00,['bab3e082dc48bc3db68692694bd114a39b41fa68'],0,1,1,1927819,1,0,1,1,4561
4962c8193e2faa589914be52962c701aba0980d1,1,Guozhang Wang,2019-09-17 09:46:40-07:00,['935b280540913ade0b2dc1549ba22c4262ee2669'],14,19,33,1927852,9,0,0,1,4561
dcfd31c5520008dfc1518ac142192df57eaabcd5,0,Ismael Juma,2019-09-17 14:28:22-07:00,['4962c8193e2faa589914be52962c701aba0980d1'],10,4,14,1927866,2,,,,4561
9ba898edc7c834259c3676402337f74b62aaba99,0,Bill Bejeck,2019-09-17 14:29:46-07:00,['dcfd31c5520008dfc1518ac142192df57eaabcd5'],1,0,1,1927867,1,,,,4561
15d69b78561a7912e2257c1dcc3909c35563b4ff,1,Matthias J. Sax,2019-09-17 17:36:59-07:00,['9ba898edc7c834259c3676402337f74b62aaba99'],0,9,9,1927876,1,,,,4561
f3ded39a0556f9e43a66b238c89c6a60f3ef33df,1,Jason Gustafson,2019-09-18 09:11:39-07:00,['15d69b78561a7912e2257c1dcc3909c35563b4ff'],58,306,364,1928240,7,0.493975904,0.927710843,0.927710843,4563
ada35d5ff45500d9d77ff64bc6017305e1cac70d,0,Colin Patrick McCabe,2019-09-18 10:21:21-07:00,['f3ded39a0556f9e43a66b238c89c6a60f3ef33df'],1,13,14,1928254,1,,,,4563
f718c5e1e10d07253d2024d221768434a731fd17,0,GitHub,2019-09-18 12:51:47-07:00,['ada35d5ff45500d9d77ff64bc6017305e1cac70d'],10,10,20,1928274,4,,,,4563
fe2797a9fa9f344dbbdd73a46ec48cf9894a9e80,1,Manikumar Reddy,2019-09-19 20:31:28+05:18,['f718c5e1e10d07253d2024d221768434a731fd17'],5,16,21,1928295,2,0.888888889,1,1,4563
d9d3d3b710dd627533175f5142a5957e6b3cc2cc,0,GitHub,2019-09-19 08:50:59-07:00,['fe2797a9fa9f344dbbdd73a46ec48cf9894a9e80'],9,14,23,1928318,2,0,0,0,4563
73c6bd8ac9a63de83162370a20f5364581fc9576,1,Matthias J. Sax,2019-09-19 11:50:25-07:00,['d9d3d3b710dd627533175f5142a5957e6b3cc2cc'],18,477,495,1928813,12,0.501754386,0.989473684,0.992982456,4564
3825ff3866325dcf0e9bff3e557eacb66450a856,0,Jason Gustafson,2019-09-19 14:42:14-07:00,['73c6bd8ac9a63de83162370a20f5364581fc9576'],35,73,108,1928921,4,0,0.962962963,1,4564
8aff871b0da5604fe981561467dff7359fb56942,1,Colin Patrick McCabe,2019-09-19 14:50:30-07:00,['3825ff3866325dcf0e9bff3e557eacb66450a856'],1,23,24,1928945,3,0,1,1,4564
2d0cd2ef54029cfb592ab5762f16214ef5d0101f,0,Guozhang Wang,2019-09-19 15:36:32-07:00,['8aff871b0da5604fe981561467dff7359fb56942'],0,643,643,1929588,4,0.375675676,0.508108108,0.383783784,4566
a0470726c44a26a1cbd0cb7f6c29b4e3e28a3af1,0,Guozhang Wang,2019-09-19 16:38:18-07:00,['2d0cd2ef54029cfb592ab5762f16214ef5d0101f'],10,11,21,1929609,4,,,,4566
e85d671dee3ac03a1b4623a8b65330df50fe2990,0,GitHub,2019-09-19 18:28:24-07:00,['a0470726c44a26a1cbd0cb7f6c29b4e3e28a3af1'],29,30,59,1929668,8,,,,4566
c955828095b28d9533b98fc979e4a768c28263d8,1,Colin Patrick McCabe,2019-09-20 09:25:19-07:00,['e85d671dee3ac03a1b4623a8b65330df50fe2990'],18,25,43,1929711,6,1,1,0,4566
8001aff30429879401cdd8cb44c12ea9d773dcfd,0,Manikumar Reddy,2019-09-20 23:39:06+05:18,['c955828095b28d9533b98fc979e4a768c28263d8'],4,4,8,1929719,1,,,,4566
d91a94e7bff7a2ffe94b562ef1108307afce1bc7,1,GitHub,2019-09-20 17:50:12-07:00,['8001aff30429879401cdd8cb44c12ea9d773dcfd'],44,287,331,1930050,6,0,1,1,4566
e98e239a0c7fd9a500de606b7a05582f1a384da4,0,Bill Bejeck,2019-09-23 07:12:45-07:00,['d91a94e7bff7a2ffe94b562ef1108307afce1bc7'],130,367,497,1930547,7,0.41221374,0.847328244,0.267175573,4568
b4035610b8ec77ab152c89a655f3ba0453c39cdd,0,GitHub,2019-09-23 09:24:32-07:00,['e98e239a0c7fd9a500de606b7a05582f1a384da4'],4,2,6,1930553,3,0,0,0,4568
beac4c7534ef0cd7be92514a8d92639bf417221c,0,Bill Bejeck,2019-09-23 13:11:56-04:00,['b4035610b8ec77ab152c89a655f3ba0453c39cdd'],54,1320,1374,1931927,13,0.551724138,1,0.062068966,4568
bc4fd676e5ea0e3cf44a8684dca0db46f912c828,0,Matthias J. Sax,2019-09-23 21:04:26-07:00,['beac4c7534ef0cd7be92514a8d92639bf417221c'],0,0,0,1931927,0,,,,4568
0d31272b350adf40bda09709304721545553d7f8,0,GitHub,2019-09-24 10:30:17+01:00,['bc4fd676e5ea0e3cf44a8684dca0db46f912c828'],5,7,12,1931939,3,,,,4568
1ae0956892cf7fb6e2337dcdd8cd07d56a22ed54,1,GitHub,2019-09-24 09:54:30-07:00,['0d31272b350adf40bda09709304721545553d7f8'],2,16,18,1931957,2,,,,4568
bcc023773ff0f5b68f0e808bc7c7aba457a4c472,1,GitHub,2019-09-24 13:23:27-07:00,['1ae0956892cf7fb6e2337dcdd8cd07d56a22ed54'],127,235,362,1932319,17,0,1,1,4568
ad3b8437fd9ecc18fcfa8204e43be9bccb1a6548,1,Guozhang Wang,2019-09-24 13:29:08-07:00,['bcc023773ff0f5b68f0e808bc7c7aba457a4c472'],249,782,1031,1933350,20,0.511494253,0.885057471,0.833333333,4570
74f8ae13034d90800da5573666dea3bea5d702ce,1,Guozhang Wang,2019-09-24 15:33:03-07:00,['ad3b8437fd9ecc18fcfa8204e43be9bccb1a6548'],556,1085,1641,1934991,21,0.504761905,0.66984127,0.866666667,4571
d112ffd8d85de2441a8ea32d080e584d7d16a9a5,0,GitHub,2019-09-24 19:32:14-07:00,['74f8ae13034d90800da5573666dea3bea5d702ce'],0,5,5,1934996,1,,,,4571
1d7f0b7c58f212d555c4f2ce766c2ca38f93a1cd,0,GitHub,2019-09-25 08:20:51-07:00,['d112ffd8d85de2441a8ea32d080e584d7d16a9a5'],59,95,154,1935150,10,0.909090909,0.954545455,0.545454545,4571
92688ef82ccbeee6014ae9c1db64fb4289b7bdd7,0,David Arthur,2019-09-25 11:58:54-04:00,['1d7f0b7c58f212d555c4f2ce766c2ca38f93a1cd'],33,931,964,1936114,13,0.42662116,0.854948805,0.87883959,4577
70d1bb40d958918ac691ba906a35c4a158815d78,1,Randall Hauch,2019-09-25 11:23:03-05:00,['92688ef82ccbeee6014ae9c1db64fb4289b7bdd7'],24,384,408,1936522,8,0.370731707,0.980487805,0.731707317,4578
0566dfd3cedc13e2c0357378cc100c1ec9bd585a,1,David Arthur,2019-09-25 22:35:13-04:00,['70d1bb40d958918ac691ba906a35c4a158815d78'],285,251,536,1937058,27,1,1,0,4578
666505b72f1baaf5f37fac4f59fa26d93d833f63,1,GitHub,2019-09-26 08:28:05+01:00,['0566dfd3cedc13e2c0357378cc100c1ec9bd585a'],68,72,140,1937198,12,0,0,0,4578
5d0052fe00c9071095b872b3b6ab6b1b455c9e20,1,GitHub,2019-09-27 13:28:00+01:00,['666505b72f1baaf5f37fac4f59fa26d93d833f63'],25,267,292,1937490,9,0.341772152,0.708860759,0.835443038,4578
30443af1c8d6c8b9ca327d046c4d4daffe5d43b2,1,Manikumar Reddy,2019-09-28 00:01:45+05:18,['5d0052fe00c9071095b872b3b6ab6b1b455c9e20'],4,48,52,1937542,4,0.15625,0.84375,0.96875,4578
22434e6535c6471b8ac3e9cff1919e5ac15a50be,1,GitHub,2019-09-27 12:08:15-07:00,['30443af1c8d6c8b9ca327d046c4d4daffe5d43b2'],469,461,930,1938472,6,0,1,1,4578
863210d172cacd8abccc4807f393116700bf19a9,0,Guozhang Wang,2019-09-27 12:12:30-07:00,['22434e6535c6471b8ac3e9cff1919e5ac15a50be'],0,40,40,1938512,1,,,,4578
8818a7037dff8b099b2516460b34353ca0c38a2b,0,Matthias J. Sax,2019-09-27 13:11:27-07:00,['863210d172cacd8abccc4807f393116700bf19a9'],2,2,4,1938516,1,,,,4578
1dc5063cde2101e4efb058a24379a7c7cb97db5e,0,Ismael Juma,2019-09-28 17:03:06-07:00,['8818a7037dff8b099b2516460b34353ca0c38a2b'],8,11,19,1938535,1,0,0,1,4578
66183f730feaa7dca7b4088053f44015a626a6e8,1,GitHub,2019-09-28 19:39:45-07:00,['1dc5063cde2101e4efb058a24379a7c7cb97db5e'],1768,2354,4122,1942657,65,0,0.937791602,1,4584
469f002810cbbd9f96400298dc853c33b7f4f750,0,GitHub,2019-09-28 23:34:16-07:00,['66183f730feaa7dca7b4088053f44015a626a6e8'],1,1,2,1942659,1,,,,4584
9aa660786e46c1efbf5605a6a69136a1dac6edb9,0,GitHub,2019-09-29 08:53:41-07:00,['469f002810cbbd9f96400298dc853c33b7f4f750'],3,2,5,1942664,1,,,,4584
45c800ff0189bb8343f276aa1077fd01d0483860,0,Bill Bejeck,2019-09-30 18:53:25-04:00,['9aa660786e46c1efbf5605a6a69136a1dac6edb9'],3,5,8,1942672,1,,,,4584
d53eab16b28a44e24fa2f9d592f536835b29ea22,1,Guozhang Wang,2019-09-30 16:28:41-07:00,['45c800ff0189bb8343f276aa1077fd01d0483860'],4,5,9,1942681,1,0,0,1,4584
ef2fbfda24115fbadc6a55542ec76d3bedff17d5,0,Guozhang Wang,2019-09-30 17:56:12-07:00,['d53eab16b28a44e24fa2f9d592f536835b29ea22'],0,7,7,1942688,2,0,1,1,4584
9fbb0de5fc493f9186d23ccdf03b772ccc01e1d4,0,Guozhang Wang,2019-09-30 18:11:37-07:00,['ef2fbfda24115fbadc6a55542ec76d3bedff17d5'],22,57,79,1942767,9,1,1,1,4584
f6f24c470004063d14fa33d8680d1eff75c4f598,1,Guozhang Wang,2019-09-30 19:29:36-07:00,['9fbb0de5fc493f9186d23ccdf03b772ccc01e1d4'],51,248,299,1943066,31,0.009708738,0.291262136,0.922330097,4584
422687148e01b607ef26d001fe1874a35e90d0ae,0,GitHub,2019-10-01 06:11:05-07:00,['f6f24c470004063d14fa33d8680d1eff75c4f598'],0,3,3,1943069,1,,,,4584
270e6109159f9288b4ed807462d8180a3c92e0da,1,David Arthur,2019-10-01 09:19:43-04:00,['422687148e01b607ef26d001fe1874a35e90d0ae'],9,47,56,1943125,2,0.942857143,1,0.657142857,4584
9e294cbca22e9da5f491792e8a8b0f9b27047fd0,0,GitHub,2019-10-01 09:34:05-04:00,['270e6109159f9288b4ed807462d8180a3c92e0da'],0,14,14,1943139,1,1,1,1,4584
bfcc17f211834710add79122d7ba3d267931cfb1,1,Randall Hauch,2019-10-01 15:33:06-05:00,['9e294cbca22e9da5f491792e8a8b0f9b27047fd0'],76,283,359,1943498,8,1,1,1,4586
3c87c9b5382891c924784828bad3d6a1b32940c6,0,GitHub,2019-10-01 22:25:56+01:00,['bfcc17f211834710add79122d7ba3d267931cfb1'],30,346,376,1943874,5,0.670588235,1,1,4587
3ca204b427971af161fa3550c46d9ec796e8b401,0,Bill Bejeck,2019-10-02 10:54:08-04:00,['3c87c9b5382891c924784828bad3d6a1b32940c6'],20,82,102,1943976,2,0.196428571,1,1,4587
157aadbbf38f6255208678058df506005cc066fd,0,Rajini Sivaram,2019-10-02 15:57:52+01:00,['3ca204b427971af161fa3550c46d9ec796e8b401'],1,2,3,1943979,1,0,0,1,4587
c218aa63ca8cdcd9b0c2c02dd0dae600318fd47c,1,Gwen Shapira,2019-10-02 08:16:41-07:00,['157aadbbf38f6255208678058df506005cc066fd'],20,320,340,1944319,5,0.528634361,0.678414097,0.810572687,4588
dc7dd5f4fe3d72fcf4388e9eef48b6fce05c56bb,1,Jason Gustafson,2019-10-02 08:43:57-07:00,['c218aa63ca8cdcd9b0c2c02dd0dae600318fd47c'],15,17,32,1944351,1,0,1,1,4588
8da69936a7e7c4da51e45cdf0fa392bcb0eacbbc,1,Guozhang Wang,2019-10-02 08:54:32-07:00,['dc7dd5f4fe3d72fcf4388e9eef48b6fce05c56bb'],158,241,399,1944750,11,0,1,0.934782609,4588
c7efc3613c4a021ddaae314ca8226d04e6dd2080,0,Guozhang Wang,2019-10-02 14:32:07-07:00,['8da69936a7e7c4da51e45cdf0fa392bcb0eacbbc'],34,35,69,1944819,1,0,1,1,4588
1c831c22e13fcc59e7e1a9e6c28fd38048eb3f62,1,Randall Hauch,2019-10-02 17:00:37-05:00,['c7efc3613c4a021ddaae314ca8226d04e6dd2080'],12,808,820,1945639,11,0.30334728,0.690376569,0.960251046,4591
16edc54048fec621c8bd428dee22f927903969b0,0,Randall Hauch,2019-10-02 17:04:10-05:00,['1c831c22e13fcc59e7e1a9e6c28fd38048eb3f62'],4,16,20,1945659,1,,,,4591
791d0d61bf5a2b7a4fda72d4c50075a1933a6af3,1,Randall Hauch,2019-10-02 17:06:57-05:00,['16edc54048fec621c8bd428dee22f927903969b0'],267,1730,1997,1947656,37,0.47375,0.79375,0.84875,4596
11ab6e7d8fbdf213a22b7fa5dff04f374f55a1d2,0,Guozhang Wang,2019-10-02 17:05:24-07:00,['791d0d61bf5a2b7a4fda72d4c50075a1933a6af3'],1,0,1,1947657,1,,,,4596
5b829f2b610d71d3176a7df523b34df807b47f22,1,Randall Hauch,2019-10-02 19:42:21-05:00,['11ab6e7d8fbdf213a22b7fa5dff04f374f55a1d2'],20,299,319,1947976,4,0.24120603,0.989949749,0.974874372,4596
6925775e63fd33e6a44bbda671b2de7db41d150e,1,Matthias J. Sax,2019-10-02 20:32:18-07:00,['5b829f2b610d71d3176a7df523b34df807b47f22'],257,1480,1737,1949713,20,0.739035088,0.817982456,0.756578947,4601
f99bb0466e9c8845963b350f3ad9b353db72fd5a,0,GitHub,2019-10-02 21:02:33-07:00,['6925775e63fd33e6a44bbda671b2de7db41d150e'],1,1,2,1949715,1,,,,4601
c62dd1e92e44551c138c28e9cc628084481da8ee,0,Colin Patrick McCabe,2019-10-03 10:11:28-07:00,['f99bb0466e9c8845963b350f3ad9b353db72fd5a'],2,2,4,1949719,1,,,,4601
e76770343c8a7b81d04c00d219381814190c8745,1,Randall Hauch,2019-10-03 13:51:00-05:00,['c62dd1e92e44551c138c28e9cc628084481da8ee'],6,54,60,1949779,2,1,0.5,1,4601
ded1fb8c4d7448ffbc939aaacd2d9b475fd58f4e,0,Randall Hauch,2019-10-03 14:55:52-05:00,['e76770343c8a7b81d04c00d219381814190c8745'],2,119,121,1949900,2,0.125,0.965909091,0.965909091,4601
c87fe9402cbebc460b42cd3dd7c268e5e6e659d9,1,Bill Bejeck,2019-10-03 18:59:31-04:00,['ded1fb8c4d7448ffbc939aaacd2d9b475fd58f4e'],32,3141,3173,1953073,39,0.296463023,0.758842444,0.815434084,4621
f98013cc501ab30c43ca707a1fbf46c4e9dc1215,1,Colin Patrick McCabe,2019-10-04 09:19:18-07:00,['c87fe9402cbebc460b42cd3dd7c268e5e6e659d9'],304,782,1086,1954159,30,0.299625468,0.880149813,0.958801498,4622
586c587b3db0bd622d74a5d4da5734c50c698061,1,Randall Hauch,2019-10-04 13:12:32-05:00,['f98013cc501ab30c43ca707a1fbf46c4e9dc1215'],0,1,1,1954160,1,0,1,1,4622
3b05dc685b4bf7bafb8057b15c837fd5333789c5,0,Guozhang Wang,2019-10-04 15:58:11-07:00,['586c587b3db0bd622d74a5d4da5734c50c698061'],41,3,44,1954204,1,0.939393939,0.757575758,0.272727273,4622
52007e878aaac3f48d0d949dbe428a2ae5e56f57,1,Guozhang Wang,2019-10-04 17:07:30-07:00,['3b05dc685b4bf7bafb8057b15c837fd5333789c5'],590,1625,2215,1956419,67,0.018915511,0.924337957,0.670870113,4624
4be2b0958840fcb229a260b4efde6c9eae1f9e9f,1,Jason Gustafson,2019-10-05 15:28:59-07:00,['52007e878aaac3f48d0d949dbe428a2ae5e56f57'],2,4,6,1956425,1,0,0,1,4624
7349608009df3d231db154b9f5c15134b047e38d,0,Jason Gustafson,2019-10-06 10:55:04-07:00,['4be2b0958840fcb229a260b4efde6c9eae1f9e9f'],3,10,13,1956438,2,0.714285714,0.714285714,1,4624
0de61a4683b92bdee803c51211c3277578ab3edf,1,Jason Gustafson,2019-10-06 21:13:23-07:00,['7349608009df3d231db154b9f5c15134b047e38d'],885,3139,4024,1960462,151,0.210353866,0.465268676,0.495412844,4632
a5a6938c69f4310f7ec519036f0df77d8022326a,1,Matthias J. Sax,2019-10-07 01:01:58-07:00,['0de61a4683b92bdee803c51211c3277578ab3edf'],1445,3595,5040,1965502,59,0.529411765,0.89532872,0.833044983,4639
debf225ff4c2700d982c0054068859f5afbdd816,0,GitHub,2019-10-07 13:24:20+05:18,['a5a6938c69f4310f7ec519036f0df77d8022326a'],2,2,4,1965506,1,,,,4639
4ac892ca783acab8e574b9b24d17e767eedb3d5f,1,Manikumar Reddy,2019-10-07 13:45:54+05:18,['debf225ff4c2700d982c0054068859f5afbdd816'],13,6197,6210,1971716,55,0.665805022,0.967872969,0.935745938,4683
4c2bd567b1293a285f7ec11258cd476e2c73aea5,0,GitHub,2019-10-07 19:52:57+05:18,['4ac892ca783acab8e574b9b24d17e767eedb3d5f'],10,10,20,1971736,8,,,,4683
c06e45a215072b1f909ccc9d1a9a82ae521b4bab,0,GitHub,2019-10-07 09:21:14-07:00,['4c2bd567b1293a285f7ec11258cd476e2c73aea5'],59,180,239,1971975,21,1,0.698113208,1,4684
d88f1048da6bdc5670102bbbde7bd92fa7af4ccb,1,Guozhang Wang,2019-10-07 09:27:09-07:00,['c06e45a215072b1f909ccc9d1a9a82ae521b4bab'],436,1058,1494,1973469,24,0.103773585,0.79245283,0.761792453,4684
cfa10678bd87f5e35f4934ecd2a40a9a089a5b52,1,Matthias J. Sax,2019-10-07 14:50:46-07:00,['d88f1048da6bdc5670102bbbde7bd92fa7af4ccb'],4,60,64,1973533,21,0,0,1,4684
7e3f8895d69da13df574701e6a3fd9d74d092053,0,Matthias J. Sax,2019-10-07 19:32:40-07:00,['cfa10678bd87f5e35f4934ecd2a40a9a089a5b52'],9,28,37,1973570,4,0,1,0.857142857,4684
a9493346aa020747f46eb916e4859dfb7192ffde,1,GitHub,2019-10-08 08:19:07-07:00,['7e3f8895d69da13df574701e6a3fd9d74d092053'],43,127,170,1973740,3,0.423076923,1,1,4684
c49775bf072f7265b744fd4f3fbfd123d7a20c49,1,Jason Gustafson,2019-10-08 14:06:36-07:00,['a9493346aa020747f46eb916e4859dfb7192ffde'],108,27,135,1973875,4,0.391304348,0.028985507,0.028985507,4684
f9934e7e9304cb6e1827f1e883df6725e7c32e88,0,Guozhang Wang,2019-10-08 14:57:07-07:00,['c49775bf072f7265b744fd4f3fbfd123d7a20c49'],3,0,3,1973878,2,,,,4684
e3c2148b207a6ca98c89211d12cb47abdfaa70b3,0,Guozhang Wang,2019-10-08 15:24:31-07:00,['f9934e7e9304cb6e1827f1e883df6725e7c32e88'],141,146,287,1974165,23,1,0,1,4684
7c4b029df940430471a39bdaa50b5c3188e4dc37,1,Bill Bejeck,2019-10-08 23:40:21-04:00,['e3c2148b207a6ca98c89211d12cb47abdfaa70b3'],2,2,4,1974169,1,,,,4684
1f1179ea64bbaf068d759aae988bd2a6fe966161,1,GitHub,2019-10-09 09:19:18+01:00,['7c4b029df940430471a39bdaa50b5c3188e4dc37'],16,14,30,1974199,3,,,,4684
50857b81bbaa3cd3a8ac2c460ff6e93acd3d8220,1,Jason Gustafson,2019-10-09 08:36:49-07:00,['1f1179ea64bbaf068d759aae988bd2a6fe966161'],47,104,151,1974350,4,0.19047619,0,1,4684
32a3dc8f5f7cb377ed57896547a2eba401060e00,1,GitHub,2019-10-09 09:39:24-07:00,['50857b81bbaa3cd3a8ac2c460ff6e93acd3d8220'],6,73,79,1974429,3,,,,4684
e0824e26ec194dddbc3397b8c4725b84f72c482c,0,GitHub,2019-10-09 10:32:05-07:00,['32a3dc8f5f7cb377ed57896547a2eba401060e00'],11,3,14,1974443,1,1,0,0,4684
fb9b0dfde5f674e2aa9f9948e2f14bc7698413ae,1,GitHub,2019-10-09 10:34:19-07:00,['e0824e26ec194dddbc3397b8c4725b84f72c482c'],35,52,87,1974530,5,0.833333333,0.833333333,1,4684
c620b73883c675ef7c49cd87a5873b3f9da3a5e1,0,Colin Patrick McCabe,2019-10-09 11:46:31-07:00,['fb9b0dfde5f674e2aa9f9948e2f14bc7698413ae'],2,2,4,1974534,1,,,,4684
4c01668f7725d4057d3ff09ad9898c15e2899892,0,Colin Patrick McCabe,2019-10-09 11:47:29-07:00,['c620b73883c675ef7c49cd87a5873b3f9da3a5e1'],4,4,8,1974542,1,,,,4684
5c4bbf9344d82ebcb98ff1444a5a6e5d8ff05215,0,GitHub,2019-10-10 13:52:07-07:00,['4c01668f7725d4057d3ff09ad9898c15e2899892'],2,8,10,1974552,2,,,,4684
c3177a1ba42f91b1f37598b1f711a17ad0352d46,1,Matthias J. Sax,2019-10-10 13:59:43-07:00,['5c4bbf9344d82ebcb98ff1444a5a6e5d8ff05215'],0,11,11,1974563,1,0,1,1,4684
f41a5c2c8632bfd0dc50321c1c69418db04f42f6,1,Guozhang Wang,2019-10-10 14:44:37-07:00,['c3177a1ba42f91b1f37598b1f711a17ad0352d46'],100,285,385,1974948,13,0.261904762,0.579365079,0.753968254,4685
fa2a9f09e4042f821d7373e2d9e01b21aede775a,0,Colin Patrick McCabe,2019-10-10 15:12:14-07:00,['f41a5c2c8632bfd0dc50321c1c69418db04f42f6'],4,15,19,1974967,2,1,1,1,4685
cc6525a74631d44d093ef75ecedb47f422004f13,0,Guozhang Wang,2019-10-10 16:23:18-07:00,['fa2a9f09e4042f821d7373e2d9e01b21aede775a'],428,465,893,1975860,4,1,1,1,4685
b80a572d12d53f463bb381b3412788af2ae64f93,0,Guozhang Wang,2019-10-10 19:38:14-07:00,['cc6525a74631d44d093ef75ecedb47f422004f13'],6,6,12,1975872,1,,,,4685
ac937706be2cdbf262a7dfea6c48346741f02370,0,GitHub,2019-10-10 21:37:37-07:00,['b80a572d12d53f463bb381b3412788af2ae64f93'],1,1,2,1975874,1,,,,4685
69ad41d6f0ec0360e0470aba91126eea8367ffbe,0,GitHub,2019-10-11 08:40:59-07:00,['ac937706be2cdbf262a7dfea6c48346741f02370'],0,1,1,1975875,1,,,,4685
b8d609c207ed3d1e678c2f1eb6f3cae637f92c30,1,Jason Gustafson,2019-10-11 10:53:32-07:00,['69ad41d6f0ec0360e0470aba91126eea8367ffbe'],26,113,139,1976014,5,0.222222222,1,1,4685
f771005f40af160e604b65b1f376c3ef2aff5cd1,1,Jason Gustafson,2019-10-11 15:10:29-07:00,['b8d609c207ed3d1e678c2f1eb6f3cae637f92c30'],48,103,151,1976165,3,0.5,1,1,4685
2ff8fa0780ec8bf4849fd085b3dfaecb9b986c3d,1,GitHub,2019-10-11 23:59:01-07:00,['f771005f40af160e604b65b1f376c3ef2aff5cd1'],47,57,104,1976269,3,1,1,1,4685
6fb8bd0987d2da1ded55383a02692a34f120f3b4,0,Guozhang Wang,2019-10-12 11:07:12-07:00,['2ff8fa0780ec8bf4849fd085b3dfaecb9b986c3d'],1,1,2,1976271,1,,,,4685
11a401d51d835c32d365f6a089016bdb871e42e0,0,Bill Bejeck,2019-10-14 11:41:44-04:00,['6fb8bd0987d2da1ded55383a02692a34f120f3b4'],119,0,119,1976390,1,0.423076923,0,0.192307692,4685
c9c3adca43fb066de0e16c65d381981c313cfb0c,0,Guozhang Wang,2019-10-14 12:38:33-07:00,['11a401d51d835c32d365f6a089016bdb871e42e0'],2,2,4,1976394,1,,,,4685
b006205edb57117c5a399647b4352b06953e9e84,0,Bill Bejeck,2019-10-14 16:15:03-04:00,['c9c3adca43fb066de0e16c65d381981c313cfb0c'],269,259,528,1976922,6,1,0,0,4685
13c2e150e59f21292183906ae8d3c96bac768155,0,Matthias J. Sax,2019-10-14 14:41:57-07:00,['b006205edb57117c5a399647b4352b06953e9e84'],2,2,4,1976926,1,,,,4685
c55277cd79f103d9c686b9698f9f63208fdee272,1,GitHub,2019-10-14 21:22:55-07:00,['13c2e150e59f21292183906ae8d3c96bac768155'],211,243,454,1977380,13,1,1,1,4685
2fce203a54483d9f229304a7ed3e963cc15f983b,1,Matthias J. Sax,2019-10-14 21:47:50-07:00,['c55277cd79f103d9c686b9698f9f63208fdee272'],0,44,44,1977424,2,0.4375,0.4375,1,4685
9c80a06466dbfade96308ef26c20c6555612191e,1,Guozhang Wang,2019-10-15 11:13:43-07:00,['2fce203a54483d9f229304a7ed3e963cc15f983b'],0,102,102,1977526,1,,,,4685
176c93412eaf96616890109852a3183b1e2e947d,1,Jason Gustafson,2019-10-15 11:22:26-07:00,['9c80a06466dbfade96308ef26c20c6555612191e'],40,318,358,1977884,9,0.410810811,1,0.951351351,4685
76fcabc7b4bf432b54101d394bcc2ad5affff716,1,GitHub,2019-10-15 11:34:48-07:00,['176c93412eaf96616890109852a3183b1e2e947d'],9,24,33,1977917,1,1,1,1,4685
e66ed2dbea80230b6eeb7dbf5c27ce5cf4ff9fc0,1,GitHub,2019-10-15 11:49:45-07:00,['76fcabc7b4bf432b54101d394bcc2ad5affff716'],231,283,514,1978431,7,0.307692308,0.935897436,0.858974359,4685
caf349923646ae4c572ab58ecc02371b2f5babe8,0,Guozhang Wang,2019-10-15 12:18:20-07:00,['e66ed2dbea80230b6eeb7dbf5c27ce5cf4ff9fc0'],1,0,1,1978432,1,,,,4685
5e231f1738ab4fec7b3fec3dc72d7f8568991cd4,0,Randall Hauch,2019-10-15 16:08:31-05:00,['caf349923646ae4c572ab58ecc02371b2f5babe8'],1,66,67,1978499,2,0.311111111,0.977777778,1,4685
e58401b2f072df4c4f0aa3fe895fc73aa64be518,1,Matthias J. Sax,2019-10-15 14:30:16-07:00,['5e231f1738ab4fec7b3fec3dc72d7f8568991cd4'],1,39,40,1978539,1,,,,4685
b24e9f3ccb68dd519aa3e6d3a1b3745c493f201c,1,GitHub,2019-10-15 14:52:26-07:00,['e58401b2f072df4c4f0aa3fe895fc73aa64be518'],11,31,42,1978581,2,1,1,1,4685
bcdc6336fc4346f384a742ca88aeb188bd97cb38,0,Randall Hauch,2019-10-15 17:27:26-05:00,['b24e9f3ccb68dd519aa3e6d3a1b3745c493f201c'],20,173,193,1978774,6,0.504761905,0.8,0.847619048,4685
9c8ab5ce10e16531c6db95b5ad2abafb1ec62d38,1,Matthias J. Sax,2019-10-15 17:18:58-07:00,['bcdc6336fc4346f384a742ca88aeb188bd97cb38'],59,128,187,1978961,5,0.3,0.2,0.7,4686
3e24495c69175002635fbf4a2ebc249cc920e4af,1,Matthias J. Sax,2019-10-15 22:39:28-07:00,['9c8ab5ce10e16531c6db95b5ad2abafb1ec62d38'],4,85,89,1979050,4,0.981481481,0.981481481,0.907407407,4686
072503527e292ed8aeb19edf7a05089581152007,0,Guozhang Wang,2019-10-16 09:34:52-07:00,['3e24495c69175002635fbf4a2ebc249cc920e4af'],15,60,75,1979125,2,0.904761905,1,1,4686
8966d066bd2f80c6d8f270423e7e9982097f97b9,1,Guozhang Wang,2019-10-16 09:49:53-07:00,['072503527e292ed8aeb19edf7a05089581152007'],112,579,691,1979816,12,0.480392157,1,0.960784314,4688
1d6d3709d6cb1d5157f3636b9598146a5d02ea4d,1,GitHub,2019-10-16 11:53:36-07:00,['8966d066bd2f80c6d8f270423e7e9982097f97b9'],0,53,53,1979869,1,,,,4688
3e30bf5439777c6dc94a389317a40715ab951677,1,Guozhang Wang,2019-10-16 16:09:09-07:00,['1d6d3709d6cb1d5157f3636b9598146a5d02ea4d'],6,36,42,1979911,2,,,,4688
ff68b60429b7b3369da411cea127beebed85033b,1,Randall Hauch,2019-10-16 20:43:00-05:00,['3e30bf5439777c6dc94a389317a40715ab951677'],86,1402,1488,1981399,19,0.640684411,0.965779468,0.868821293,4701
2a54347a56bcf29facd74ea219db12bf495c7af9,0,Bill Bejeck,2019-10-16 23:55:20-04:00,['ff68b60429b7b3369da411cea127beebed85033b'],54,91,145,1981544,2,0.074074074,0.074074074,1,4701
78f5da914e78958b00af643aed7ce13fb156e59e,0,Guozhang Wang,2019-10-16 22:23:15-07:00,['2a54347a56bcf29facd74ea219db12bf495c7af9'],17,57,74,1981618,5,0.818181818,0.848484848,1,4701
b62f2a1123612af30d29140efa6d3e89091f87dc,1,Guozhang Wang,2019-10-16 22:29:33-07:00,['78f5da914e78958b00af643aed7ce13fb156e59e'],2,1589,1591,1983209,15,0.190527449,0.362755651,0.925726588,4713
f93c473be1d24774f9c2d29576b063835f8d2737,1,Guozhang Wang,2019-10-16 22:40:57-07:00,['b62f2a1123612af30d29140efa6d3e89091f87dc'],627,637,1264,1984473,5,0.384615385,0,0.256410256,4714
00374c3ddf6c4ecc96f58c6685fd107500b976cd,1,Guozhang Wang,2019-10-16 22:53:14-07:00,['f93c473be1d24774f9c2d29576b063835f8d2737'],23,100,123,1984596,2,0.0625,0.8125,1,4714
f324754852a297319ac8b0ea119e48741a0dd61c,0,Matthias J. Sax,2019-10-17 00:00:39-07:00,['00374c3ddf6c4ecc96f58c6685fd107500b976cd'],4,70,74,1984670,3,0.11627907,1,1,4714
18bdcaa5a1e770b46c07655f138bf0ef4d16818d,0,Matthias J. Sax,2019-10-17 00:26:36-07:00,['f324754852a297319ac8b0ea119e48741a0dd61c'],2,3,5,1984675,1,0,1,1,4714
ed078bd702e30b300050aefd7a65561fbd75049f,1,Manikumar Reddy,2019-10-17 14:34:42+05:18,['18bdcaa5a1e770b46c07655f138bf0ef4d16818d'],1,215,216,1984891,4,0.105769231,0.971153846,0.980769231,4715
2cf7b35d90f56e8f5326576d0683128421a37a09,1,Rajini Sivaram,2019-10-17 11:56:41+01:00,['ed078bd702e30b300050aefd7a65561fbd75049f'],66,106,172,1985063,3,0.222222222,1,1,4715
3cb8ccf63a3f88b4de5a2133b39fb4bf175f3532,0,GitHub,2019-10-17 09:21:34-07:00,['2cf7b35d90f56e8f5326576d0683128421a37a09'],31,29,60,1985123,9,0,1,1,4715
d9f0be45231fd19036095ccc544b3df304811724,1,Jason Gustafson,2019-10-17 09:44:14-07:00,['3cb8ccf63a3f88b4de5a2133b39fb4bf175f3532'],8,98,106,1985229,2,0.048192771,0.975903614,0.975903614,4715
baaccbb018a8dc5fee434f98a73c566da5e3e72f,0,GitHub,2019-10-17 09:59:02-07:00,['d9f0be45231fd19036095ccc544b3df304811724'],1,1,2,1985231,1,,,,4715
7a87a30f1f63982e9a4ed4d14a558a330190051f,1,Matthias J. Sax,2019-10-17 10:33:08-07:00,['baaccbb018a8dc5fee434f98a73c566da5e3e72f'],58,149,207,1985438,3,0.714285714,0,1,4716
fa2c61e23fdf41be1f19d6c8c60eae9bfe52ff80,1,Matthias J. Sax,2019-10-17 11:42:10-07:00,['7a87a30f1f63982e9a4ed4d14a558a330190051f'],61,403,464,1985902,5,0.43030303,0.642424242,0.593939394,4717
9660ecd4ec3a6656a116458a084b7c461f29c1ee,0,Bill Bejeck,2019-10-17 14:45:43-04:00,['fa2c61e23fdf41be1f19d6c8c60eae9bfe52ff80'],1,1,2,1985904,1,,,,4717
6c0aed2fbe282e88fec618e31dcc8417f5f390b1,1,Jason Gustafson,2019-10-17 22:54:28-07:00,['9660ecd4ec3a6656a116458a084b7c461f29c1ee'],221,788,1009,1986913,24,0.14379085,0.830065359,0.947712418,4719
317089663cc7ff4fdfcba6ee434f455e8ae13acd,1,Jason Gustafson,2019-10-17 23:08:34-07:00,['6c0aed2fbe282e88fec618e31dcc8417f5f390b1'],101,141,242,1987155,6,0.638888889,1,0.416666667,4719
8feb516dd9aa7c921747c8994f95ef5de324d7bb,0,Matthias J. Sax,2019-10-18 16:23:33-07:00,['317089663cc7ff4fdfcba6ee434f455e8ae13acd'],2,2,4,1987159,1,,,,4719
4e094217f7360becd3640a38587e25f9a3bfd4b3,0,Matthias J. Sax,2019-10-18 16:54:23-07:00,['8feb516dd9aa7c921747c8994f95ef5de324d7bb'],0,85,85,1987244,4,1,1,1,4721
eac367c76a32cd131618c6fa2ac014e0d9b162e5,1,GitHub,2019-10-18 17:32:03-07:00,['4e094217f7360becd3640a38587e25f9a3bfd4b3'],0,90,90,1987334,1,,,,4721
8f639eb79cb315b23d1544268b0ddfca032bd5ec,0,Jason Gustafson,2019-10-19 10:13:19-07:00,['eac367c76a32cd131618c6fa2ac014e0d9b162e5'],9,7,16,1987350,1,1,0,0,4721
2298c7f84fd0e29b304eb11078bfe76ca5b04a97,1,Guozhang Wang,2019-10-19 13:45:36-07:00,['8f639eb79cb315b23d1544268b0ddfca032bd5ec'],531,1234,1765,1989115,50,0.111900533,1,0.904085258,4721
99a4068c5ca61951d70b9e647ead3b08a2af4309,1,Jason Gustafson,2019-10-19 21:30:50-07:00,['2298c7f84fd0e29b304eb11078bfe76ca5b04a97'],230,1529,1759,1990874,39,0.113606341,0.805812417,0.862615588,4728
a9b0fc866a02762878a83e21130fdb236766aff5,0,Manikumar Reddy,2019-10-20 17:01:17+05:18,['99a4068c5ca61951d70b9e647ead3b08a2af4309'],17,41,58,1990932,2,,,,4728
e20dcffa847648519fa622fc159f8a34580df40a,0,Rajini Sivaram,2019-10-21 08:48:33+01:00,['a9b0fc866a02762878a83e21130fdb236766aff5'],8,11,19,1990951,7,,,,4728
6afe05fe896af3b646d79ff6ec3056e04656d2e7,0,GitHub,2019-10-21 10:51:15-04:00,['e20dcffa847648519fa622fc159f8a34580df40a'],54,36,90,1991041,11,1,1,0,4728
f90b7e9cb4478c41031d495d45cb37dfcf343e43,1,GitHub,2019-10-21 13:02:55-07:00,['6afe05fe896af3b646d79ff6ec3056e04656d2e7'],36,72,108,1991149,4,0,0,0,4728
7bc8c0dcd1db27465661e135cea8e800c337f19e,0,Matthias J. Sax,2019-10-21 14:25:41-07:00,['f90b7e9cb4478c41031d495d45cb37dfcf343e43'],1,4,5,1991154,1,0,0,0,4728
7bef73d724795347cab36ddf0fa9854540c11907,0,Matthias J. Sax,2019-10-21 15:42:08-07:00,['7bc8c0dcd1db27465661e135cea8e800c337f19e'],1,14,15,1991169,1,,,,4728
c7a3d1b52da7ae4f19f22f6d5c70bb96387e5cac,0,Matthias J. Sax,2019-10-21 17:27:23-07:00,['7bef73d724795347cab36ddf0fa9854540c11907'],2,19,21,1991190,1,,,,4728
f46eb292f5be892fbfcd6551d57c5a425c514673,0,Manikumar Reddy,2019-10-22 20:39:10+05:18,['c7a3d1b52da7ae4f19f22f6d5c70bb96387e5cac'],0,42,42,1991232,1,,,,4728
6d8da96ba8c892aab53ec9e1d5a074c5043c2092,0,GitHub,2019-10-22 09:27:38-07:00,['f46eb292f5be892fbfcd6551d57c5a425c514673'],1,50,51,1991283,2,0,1,1,4728
2efee34b74d4895b504ab541b716edab72b320d1,1,Colin Patrick McCabe,2019-10-22 15:26:50-07:00,['6d8da96ba8c892aab53ec9e1d5a074c5043c2092'],4,8,12,1991295,2,0,0,1,4728
c00bd38ab27ceaee174be8ce803c64000c5730ed,0,Colin Patrick McCabe,2019-10-22 15:36:53-07:00,['2efee34b74d4895b504ab541b716edab72b320d1'],16,14,30,1991325,3,,,,4728
4fc649d85cc5e2fc19ef6fcc222303687ecfd0b8,0,GitHub,2019-10-22 17:11:58-07:00,['c00bd38ab27ceaee174be8ce803c64000c5730ed'],2,11,13,1991338,2,1,1,1,4728
fc0963a2367bbb47fa369fbfad89989f148b7e1d,0,Manikumar Reddy,2019-10-23 15:34:26+05:18,['4fc649d85cc5e2fc19ef6fcc222303687ecfd0b8'],1,4,5,1991343,1,0,1,1,4728
0971f66ff546f780b46cf341b41a1513f916398e,1,GitHub,2019-10-23 08:45:08-07:00,['fc0963a2367bbb47fa369fbfad89989f148b7e1d'],99,393,492,1991835,9,0.118343195,0.98816568,0.727810651,4730
adb2bdb122df0e352a414df4a26158909c25155b,1,Colin Patrick McCabe,2019-10-23 12:39:12-07:00,['0971f66ff546f780b46cf341b41a1513f916398e'],44,259,303,1992138,11,0.03164557,0.518987342,0.601265823,4730
6975f1dfa9864728605a7e430cf929b3280aae2b,1,Guozhang Wang,2019-10-23 12:39:31-07:00,['adb2bdb122df0e352a414df4a26158909c25155b'],149,260,409,1992547,4,0,1,0,4731
c015169aa6ae835978cadbcb1d17a123e8c475f8,0,GitHub,2019-10-24 10:28:29-04:00,['6975f1dfa9864728605a7e430cf929b3280aae2b'],84,41,125,1992672,13,1,0,0,4731
aab14fb8432260d5beff83473ef22cb4cc920466,1,Matthias J. Sax,2019-10-24 11:35:55-07:00,['c015169aa6ae835978cadbcb1d17a123e8c475f8'],25,339,364,1993036,2,,,,4731
28ef7f1d6d7f4cec7e81b8d0641debebefec9104,0,Colin Patrick McCabe,2019-10-24 15:23:54-07:00,['aab14fb8432260d5beff83473ef22cb4cc920466'],28,33,61,1993097,5,1,,,4731
1df01d258369222e1978016efb20c8a990b13c5c,1,GitHub,2019-10-24 19:33:16-07:00,['28ef7f1d6d7f4cec7e81b8d0641debebefec9104'],542,428,970,1994067,21,1,0.772727273,1,4731
4f682b3c0ae3588592e76f0259a1dc26087d8a49,0,GitHub,2019-10-24 19:45:09-07:00,['1df01d258369222e1978016efb20c8a990b13c5c'],0,7,7,1994074,1,,,,4731
5987c76153085cdf729a72f22bfce9e2f815234f,0,Guozhang Wang,2019-10-24 21:24:55-07:00,['4f682b3c0ae3588592e76f0259a1dc26087d8a49'],10,13,23,1994097,1,0,1,1,4731
43262d358a489b74dbe0e686f4e87e75ff0324d8,0,Jason Gustafson,2019-10-24 23:40:02-07:00,['5987c76153085cdf729a72f22bfce9e2f815234f'],12,75,87,1994184,2,0.214285714,0.976190476,0.976190476,4731
77fc49888938e29ca3e86649611cc3f6996cccd8,1,Jason Gustafson,2019-10-25 00:01:51-07:00,['43262d358a489b74dbe0e686f4e87e75ff0324d8'],576,634,1210,1995394,20,1,1,0,4735
27ba8f5a399cdd799a7eade52c31e6bc21ad18d1,1,Bill Bejeck,2019-10-25 17:16:25-04:00,['77fc49888938e29ca3e86649611cc3f6996cccd8'],382,917,1299,1996693,42,0.411458333,0.9140625,0.552083333,4737
c5df2082811af3cd3d7bc20974dddd5780a5836e,1,Jason Gustafson,2019-10-25 14:40:45-07:00,['27ba8f5a399cdd799a7eade52c31e6bc21ad18d1'],2,49,51,1996744,3,0.294117647,1,0.941176471,4737
4bde9bb3ccaf5571be76cb96ea051dadaeeaf5c7,1,GitHub,2019-10-25 22:10:01-07:00,['c5df2082811af3cd3d7bc20974dddd5780a5836e'],14,21,35,1996779,6,,,,4737
e4262471c9aee4a4c04dd04ebbdbdba7e3c5ead1,1,Jason Gustafson,2019-10-26 13:16:26-07:00,['4bde9bb3ccaf5571be76cb96ea051dadaeeaf5c7'],3,3,6,1996785,1,,,,4737
59a75f4422a68d2e1edc661264058f040139fde5,0,GitHub,2019-10-28 07:57:50-07:00,['e4262471c9aee4a4c04dd04ebbdbdba7e3c5ead1'],39,26,65,1996850,4,1,0,0,4737
56bc5074858e1b8793a74697570ceeb948bdb2ce,1,Matthias J. Sax,2019-10-29 10:15:39-07:00,['59a75f4422a68d2e1edc661264058f040139fde5'],48,75,123,1996973,10,0.857142857,1,0.952380952,4737
465f810730b62e1739d0567da1254ac0167248bb,1,Guozhang Wang,2019-10-29 10:41:25-07:00,['56bc5074858e1b8793a74697570ceeb948bdb2ce'],29,157,186,1997159,8,0.27173913,0.847826087,0.72826087,4737
065411aa2273fd393e02f0af46f015edfc9f9b55,0,Bill Bejeck,2019-10-29 16:02:15-04:00,['465f810730b62e1739d0567da1254ac0167248bb'],1,1,2,1997161,1,,,,4737
cb5c7313b469b2fcd4bcd5042e74affb28f3616e,1,Guozhang Wang,2019-10-29 21:20:01-07:00,['065411aa2273fd393e02f0af46f015edfc9f9b55'],129,127,256,1997417,10,1,0.764705882,0.352941176,4737
2dba8803f77fc2000f15933aeac9a63a4ee10288,0,Manikumar Reddy,2019-10-30 15:05:14+05:18,['cb5c7313b469b2fcd4bcd5042e74affb28f3616e'],0,2,2,1997419,1,,,,4737
0dbf95b1c1f4317fb2018d9852878aada6c01c32,0,David Arthur,2019-10-30 10:41:12-04:00,['2dba8803f77fc2000f15933aeac9a63a4ee10288'],2,0,2,1997421,1,,,,4737
fc0f82372e1e456cbd43490b9eba957c4a0d3eb5,1,Bill Bejeck,2019-10-30 12:24:59-04:00,['0dbf95b1c1f4317fb2018d9852878aada6c01c32'],933,2317,3250,2000671,29,0.135629709,0.724434876,0.413347686,4739
9e81ec9a6ebe2913687f66cfb286177dd853ac13,0,Guozhang Wang,2019-10-30 14:19:57-07:00,['fc0f82372e1e456cbd43490b9eba957c4a0d3eb5'],2,5,7,2000678,1,0,0,0,4739
f65c2acad70ef644cf1ce54cfc071ffc7436a8a7,0,Guozhang Wang,2019-10-31 17:14:28-07:00,['9e81ec9a6ebe2913687f66cfb286177dd853ac13'],1,144,145,2000823,2,0.134615385,1,1,4739
72282ed1988e33000f91672a72c7356e26658241,0,Manikumar Reddy,2019-11-01 14:06:48+05:18,['f65c2acad70ef644cf1ce54cfc071ffc7436a8a7'],8,8,16,2000839,2,,,,4739
4a5155c934b9d2045e1f7af09a0298bc4b413027,1,Guozhang Wang,2019-11-01 10:03:55-07:00,['72282ed1988e33000f91672a72c7356e26658241'],394,1004,1398,2002237,14,0.019390582,0.897506925,0.886426593,4742
5fa2de43ec2dfd7cd5e1db9f5e66f373d6ec91d5,0,Manikumar Reddy,2019-11-02 00:11:21+05:18,['4a5155c934b9d2045e1f7af09a0298bc4b413027'],46,25,71,2002308,2,1,1,0.8125,4742
96d95e947a2445890e410024721dd3aef5eab576,0,Guozhang Wang,2019-11-01 11:55:29-07:00,['5fa2de43ec2dfd7cd5e1db9f5e66f373d6ec91d5'],2,2,4,2002312,1,1,0,1,4742
2421a69556f0275efc99680c05f0bab27ecafb0c,0,Bill Bejeck,2019-11-01 17:14:57-04:00,['96d95e947a2445890e410024721dd3aef5eab576'],45,46,91,2002403,7,0,0,0,4742
d61b0c131ced14cd3a006ef4ccff39f6d9ad51e8,1,Guozhang Wang,2019-11-01 16:10:42-07:00,['2421a69556f0275efc99680c05f0bab27ecafb0c'],21,18,39,2002442,7,0,1,0,4742
f5a4519be97881666d2d3e558ae6934fc2dad87c,0,Manikumar Reddy,2019-11-02 05:51:27+05:18,['d61b0c131ced14cd3a006ef4ccff39f6d9ad51e8'],11,0,11,2002453,1,1,1,1,4742
7bdbdf19009709e83cb8c679a0c1c0972746555c,0,GitHub,2019-11-02 08:42:30-07:00,['f5a4519be97881666d2d3e558ae6934fc2dad87c'],30,49,79,2002532,3,1,1,1,4742
6b905ade0cdc7a5f6f746727ecfe4e7a7463a200,0,Guozhang Wang,2019-11-02 10:22:36-07:00,['7bdbdf19009709e83cb8c679a0c1c0972746555c'],16,77,93,2002625,4,0.040816327,0.265306122,1,4742
c552c06aed50b4d4d9a85f73ccc89bc06fa7e094,1,GitHub,2019-11-05 04:51:25-08:00,['6b905ade0cdc7a5f6f746727ecfe4e7a7463a200'],56,115,171,2002796,7,0,0,0,4742
be58580e14be93618f11e609389ff6bb16317702,1,Colin Patrick McCabe,2019-11-05 10:34:11-08:00,['c552c06aed50b4d4d9a85f73ccc89bc06fa7e094'],21,16,37,2002833,5,0,0,0,4742
a4cbdc6a7b3140ccbcd0e2339e28c048b434974e,0,Colin Patrick McCabe,2019-11-05 17:27:50-08:00,['be58580e14be93618f11e609389ff6bb16317702'],6,196,202,2003035,2,0,1,1,4742
a41bc7274b8902036ff75e0b25181d6ed80acd5d,0,Guozhang Wang,2019-11-05 17:53:11-08:00,['a4cbdc6a7b3140ccbcd0e2339e28c048b434974e'],1,1,2,2003037,1,,,,4742
903d66e2f9220fc8a016f68b798ef11930372557,0,Manikumar Reddy,2019-11-06 15:47:51+05:18,['a41bc7274b8902036ff75e0b25181d6ed80acd5d'],2,4,6,2003043,2,0.5,1,0.5,4742
82137ba52e52a7abb652d2774e9b54485ace1612,1,GitHub,2019-11-06 09:22:47-08:00,['903d66e2f9220fc8a016f68b798ef11930372557'],71,175,246,2003289,2,0,1,0.769230769,4742
213270967548bea938f9a77564aea81b43fdc591,1,GitHub,2019-11-06 09:47:08-08:00,['82137ba52e52a7abb652d2774e9b54485ace1612'],6,18,24,2003313,2,0,0.857142857,1,4742
731018222c19a260f2c576b27946bf0a8eb2167e,1,Bill Bejeck,2019-11-06 14:01:26-05:00,['213270967548bea938f9a77564aea81b43fdc591'],439,389,828,2004141,8,0,0,0,4742
16f1ce12e4a62fd9f4e2f591dc81080eb9651b2b,0,Guozhang Wang,2019-11-06 12:59:20-08:00,['731018222c19a260f2c576b27946bf0a8eb2167e'],50,140,190,2004331,4,0.24137931,1,0.75862069,4742
54f8d0c3fcd9c61126e005835c4f91756cb399e5,1,Manikumar Reddy,2019-11-07 10:04:26+05:18,['16f1ce12e4a62fd9f4e2f591dc81080eb9651b2b'],3,49,52,2004383,2,0,1,1,4742
e3f5d308aa76cf6296cdc4d96f116bcac1a6734b,0,GitHub,2019-11-07 10:20:17-05:00,['54f8d0c3fcd9c61126e005835c4f91756cb399e5'],1,34,35,2004418,1,0,1,1,4742
1b08fceb7a3c502d2d18dc99796101ed0b4ff8b7,1,GitHub,2019-11-07 14:18:32-08:00,['e3f5d308aa76cf6296cdc4d96f116bcac1a6734b'],7,153,160,2004578,4,0.719512195,0.975609756,1,4743
929c25732f3722c3e3b49c305113fc69c87df1fc,0,GitHub,2019-11-07 22:15:39-08:00,['1b08fceb7a3c502d2d18dc99796101ed0b4ff8b7'],2,1,3,2004581,1,,,,4743
4283fd640cbad7af9d4d5da25b6a7d4edb985a1e,1,GitHub,2019-11-08 08:53:38-08:00,['929c25732f3722c3e3b49c305113fc69c87df1fc'],29,58,87,2004668,9,0.652173913,0.956521739,1,4743
6df058ec150b9c3c8938740ce5ce95d256f4b012,0,GitHub,2019-11-08 09:02:34-08:00,['4283fd640cbad7af9d4d5da25b6a7d4edb985a1e'],31,24,55,2004723,4,1,0,0,4743
0dcd0a2ef9b4317ce910b7c2792f3ba073ae20b2,0,Dong Lin,2019-11-08 10:49:12-08:00,['6df058ec150b9c3c8938740ce5ce95d256f4b012'],6,6,12,2004735,3,,,,4743
4deb80676e66311dc919f97dad1cac6131267885,0,GitHub,2019-11-08 16:21:13-05:00,['0dcd0a2ef9b4317ce910b7c2792f3ba073ae20b2'],325,340,665,2005400,5,0,1,0,4743
92dd337688a519e88f2b206fb506f3cd3aad14d2,1,GitHub,2019-11-08 19:35:22-08:00,['4deb80676e66311dc919f97dad1cac6131267885'],59,111,170,2005570,6,1,0.972972973,1,4743
67fd88050ff8968d5d51a4b37b5af701f26b1ba3,1,Manikumar Reddy,2019-11-09 10:25:48+05:18,['92dd337688a519e88f2b206fb506f3cd3aad14d2'],12,138,150,2005720,4,0,0,0,4744
0f43d77cfdab1cdd4f2e440eee372ef91c02fbdf,0,Jason Gustafson,2019-11-08 22:38:07-08:00,['67fd88050ff8968d5d51a4b37b5af701f26b1ba3'],1,1,2,2005722,1,,,,4744
dbce4c12ba1b5056146ffa9fd5cb1d9f38b986c7,0,Manikumar Reddy,2019-11-09 14:18:37+05:18,['0f43d77cfdab1cdd4f2e440eee372ef91c02fbdf'],0,14,14,2005736,2,,,,4744
1cd5d0da1d378c5dca059b9cba43a0358955d591,0,Matthias J. Sax,2019-11-09 22:43:42-08:00,['dbce4c12ba1b5056146ffa9fd5cb1d9f38b986c7'],16,53,69,2005805,1,,,,4744
38ed69241f928530b13a31edfe918c0e695e2e9f,0,Matthias J. Sax,2019-11-09 23:11:39-08:00,['1cd5d0da1d378c5dca059b9cba43a0358955d591'],1,2,3,2005808,1,,,,4744
42284fbbee1915e72d812e224dae23c7e30de62d,0,Mickael Maison,2019-11-10 17:37:02+00:00,['38ed69241f928530b13a31edfe918c0e695e2e9f'],2,2,4,2005812,1,,,,4744
ff50f28794ab65b5c5d30564c60a769e7f1a1af3,1,Mickael Maison,2019-11-10 18:15:44+00:00,['42284fbbee1915e72d812e224dae23c7e30de62d'],6,6,12,2005824,1,,,,4744
f15d318aaa0ad2739455a36253daf090239a7145,0,GitHub,2019-11-11 09:16:09+00:00,['ff50f28794ab65b5c5d30564c60a769e7f1a1af3'],0,3,3,2005827,1,0,0,0,4744
6f0008643db6e7299658442784f1bcc6c96395ed,1,GitHub,2019-11-11 20:03:06+00:00,['f15d318aaa0ad2739455a36253daf090239a7145'],21,64,85,2005912,2,0.111111111,0.916666667,1,4744
9a125a72a285f1b169586bb8c40429369f6a4fe9,0,Bill Bejeck,2019-11-12 10:23:24-05:00,['6f0008643db6e7299658442784f1bcc6c96395ed'],1,242,243,2006155,3,1,1,1,4744
1675115ec193acf4c7d44e68a57272edfec0b455,1,Ismael Juma,2019-11-12 21:21:18-08:00,['9a125a72a285f1b169586bb8c40429369f6a4fe9'],54,57,111,2006266,8,0,0,1,4744
ed8810127f2e19ded8ea402a1571a933a6667430,1,GitHub,2019-11-13 10:54:47-05:00,['1675115ec193acf4c7d44e68a57272edfec0b455'],1,375,376,2006642,2,,,,4745
7027d9292761101d10037323cae50c298af978ee,0,GitHub,2019-11-13 20:36:25+00:00,['ed8810127f2e19ded8ea402a1571a933a6667430'],15,17,32,2006674,1,,,,4745
fecb977b257888e2022c1b1e04dd7bf03e18720c,1,Jason Gustafson,2019-11-13 17:40:53-08:00,['7027d9292761101d10037323cae50c298af978ee'],179,933,1112,2007786,23,0.211169284,0.893542757,0.970331588,4745
cac85601a00efd5b0be2f95572739fa2e5b8f719,0,GitHub,2019-11-13 22:03:44-06:00,['fecb977b257888e2022c1b1e04dd7bf03e18720c'],16,97,113,2007899,5,0.021276596,1,1,4745
2bd6b6ff0f86d588fc09f96973a469989b9693df,0,Manikumar Reddy,2019-11-14 13:35:10+05:18,['cac85601a00efd5b0be2f95572739fa2e5b8f719'],2,2,4,2007903,1,,,,4745
38d243b022336ecaf5cb400ae015c485f56ff978,0,Manikumar Reddy,2019-11-14 13:57:04+05:18,['2bd6b6ff0f86d588fc09f96973a469989b9693df'],5,20,25,2007928,2,0,1,0.222222222,4745
f44272e392d1b330a895fca71558bb7c4f9450e4,0,Bill Bejeck,2019-11-14 10:32:35-05:00,['38d243b022336ecaf5cb400ae015c485f56ff978'],1,1,2,2007930,1,,,,4745
898ad8271ac80d30ae7e1446d3d811996c4b5d9e,0,Bill Bejeck,2019-11-14 11:25:11-05:00,['f44272e392d1b330a895fca71558bb7c4f9450e4'],1,35,36,2007966,2,1,1,1,4745
20b2bce29076527214dba58e50bf9b1d2f21a645,0,Ismael Juma,2019-11-14 08:40:16-08:00,['898ad8271ac80d30ae7e1446d3d811996c4b5d9e'],10,12,22,2007988,2,,,,4745
7f5c380c34967dfb57ba7f2c46fe28ba4ae24ad6,0,Bill Bejeck,2019-11-14 16:12:08-05:00,['20b2bce29076527214dba58e50bf9b1d2f21a645'],12,18,30,2008018,1,1,1,1,4745
69a63304de53ea10858f842b8db03932a05cc671,0,GitHub,2019-11-15 10:41:12-08:00,['7f5c380c34967dfb57ba7f2c46fe28ba4ae24ad6'],2,94,96,2008114,4,0.777777778,0.888888889,1,4747
464b6ed0349f28779a48bdbb50e29d1319848416,0,Ismael Juma,2019-11-15 14:10:47-08:00,['69a63304de53ea10858f842b8db03932a05cc671'],15,63,78,2008192,2,0.216216216,1,1,4747
7f496744399adfbe5cd283ae3f49dec7c55b88a1,0,GitHub,2019-11-15 15:13:32-08:00,['464b6ed0349f28779a48bdbb50e29d1319848416'],9,16,25,2008217,4,0,1,0,4747
400185421f008662ee6f92298154151493486c1e,1,GitHub,2019-11-15 16:06:15-08:00,['7f496744399adfbe5cd283ae3f49dec7c55b88a1'],253,312,565,2008782,8,0.733333333,1,1,4748
255fcdc2369dccb03c91b14b99a177bce6e966ea,0,Manikumar Reddy,2019-11-16 14:26:35+05:18,['400185421f008662ee6f92298154151493486c1e'],0,20,20,2008802,2,,,,4748
cf84f244e5d5309d8e34514d2a66d2312d40ef65,0,Ismael Juma,2019-11-16 09:48:02-08:00,['255fcdc2369dccb03c91b14b99a177bce6e966ea'],1,1,2,2008804,1,,,,4748
ca7a5eae890fd92cb9794ee0923d424a7e680d61,0,Ismael Juma,2019-11-17 10:08:29-08:00,['cf84f244e5d5309d8e34514d2a66d2312d40ef65'],3,1,4,2008808,1,,,,4748
7eafea0d57522ca391a5c3c91bd251c59f839c3c,1,Ismael Juma,2019-11-17 14:42:00-08:00,['ca7a5eae890fd92cb9794ee0923d424a7e680d61'],3,41,44,2008852,2,0.4,1,1,4748
374e4803527f84001ca4b0d0f5ca411a5e8c45c6,0,Ismael Juma,2019-11-17 19:18:20-08:00,['7eafea0d57522ca391a5c3c91bd251c59f839c3c'],9,9,18,2008870,2,,0,,4748
0ee9bf326d71d06bef4c3623867402561f86c673,0,Jason Gustafson,2019-11-18 08:41:40-08:00,['374e4803527f84001ca4b0d0f5ca411a5e8c45c6'],1,1,2,2008872,1,,,,4748
f98d935b3ef568d780c4f7b9fe2e76dad3dfd5df,0,GitHub,2019-11-18 08:43:52-08:00,['0ee9bf326d71d06bef4c3623867402561f86c673'],0,26,26,2008898,2,1,1,1,4749
9fb22868fe1d5f2c192664deef5172ec205f7dc4,0,Colin Patrick McCabe,2019-11-18 10:50:36-08:00,['f98d935b3ef568d780c4f7b9fe2e76dad3dfd5df'],3,6,9,2008907,1,0,1,0,4749
305f134abfe9dc047364ba3abd48f25fec77a6a4,1,Jason Gustafson,2019-11-18 14:32:08-08:00,['9fb22868fe1d5f2c192664deef5172ec205f7dc4'],2,3,5,2008912,1,,,,4749
6ae1af842a3d4bc01ebf1bb72b52f8353c8628f5,1,GitHub,2019-11-18 15:11:42-08:00,['305f134abfe9dc047364ba3abd48f25fec77a6a4'],32,155,187,2009099,4,0.217391304,1,1,4749
dcf660a2a067c9ba3add5cd2269a036ce76a7758,0,Matthias J. Sax,2019-11-18 16:32:21-08:00,['6ae1af842a3d4bc01ebf1bb72b52f8353c8628f5'],47,36,83,2009182,2,0,0,1,4750
32bf0774e9727e8f92ce168bc568f62d20968386,0,GitHub,2019-11-18 17:32:23-08:00,['dcf660a2a067c9ba3add5cd2269a036ce76a7758'],237,48,285,2009467,18,1,0.752747253,0,4750
d04699486d4203cf53afcc6aeb2abbffdd5e1b9c,1,GitHub,2019-11-18 20:36:00-05:00,['32bf0774e9727e8f92ce168bc568f62d20968386'],29,282,311,2009778,10,0.363636364,0.545454545,0.289256198,4751
19681f6b95a5076af7020475f46d0bbe9f6015e1,1,Bill Bejeck,2019-11-19 13:05:09-05:00,['d04699486d4203cf53afcc6aeb2abbffdd5e1b9c'],586,1466,2052,2011830,25,0.240981241,0.875901876,0.401154401,4753
cca0225390c7a3393b0e4406d4908cb7109a2753,0,GitHub,2019-11-19 15:19:48-05:00,['19681f6b95a5076af7020475f46d0bbe9f6015e1'],2,2,4,2011834,1,,,,4753
41a9e2c7c3f3c0ae48db89178d56d26dff3a2839,0,Bill Bejeck,2019-11-19 16:55:03-05:00,['cca0225390c7a3393b0e4406d4908cb7109a2753'],170,156,326,2012160,8,0.9,1,0.133333333,4753
da4337271ef0b72643c0cf47ae51e69f79cf1901,0,Randall Hauch,2019-11-19 21:18:21-08:00,['41a9e2c7c3f3c0ae48db89178d56d26dff3a2839'],91,420,511,2012671,13,0.600985222,0.891625616,0.990147783,4755
2b2de2ddc64a842252a3abba4f1d6301c5a9e9b1,0,GitHub,2019-11-20 07:19:22-08:00,['da4337271ef0b72643c0cf47ae51e69f79cf1901'],24,8,32,2012703,5,1,1,1,4755
fe7543abd36e1e7566157c351893c8e124da2ee9,0,GitHub,2019-11-20 12:49:25-08:00,['2b2de2ddc64a842252a3abba4f1d6301c5a9e9b1'],94,2,96,2012799,4,0.222222222,0.111111111,0,4755
02df8e1496e25f7b4a2609c6f35a522e59cf7ce0,1,GitHub,2019-11-20 16:40:18-08:00,['fe7543abd36e1e7566157c351893c8e124da2ee9'],158,343,501,2013300,6,0.439189189,0.614864865,0.804054054,4755
af17468fa6ad032732781788539ef486e778dd9d,0,Mickael Maison,2019-11-21 13:36:56+00:00,['02df8e1496e25f7b4a2609c6f35a522e59cf7ce0'],1,1,2,2013302,1,,,,4755
2604d39b9fbad209be6e89d395dd4c97582d9c52,0,Bill Bejeck,2019-11-21 10:32:31-05:00,['af17468fa6ad032732781788539ef486e778dd9d'],4,4,8,2013310,1,0,1,0,4755
4e431246c31170a7f632da8edfdb9cf4f882f6ef,1,GitHub,2019-11-21 07:41:29-08:00,['2604d39b9fbad209be6e89d395dd4c97582d9c52'],17,60,77,2013387,4,0.555555556,0.703703704,1,4755
09f700ab3e2a8441109e26851cc861be7856f5e4,0,Ismael Juma,2019-11-21 08:06:06-08:00,['4e431246c31170a7f632da8edfdb9cf4f882f6ef'],15,323,338,2013725,5,,,,4757
1d8ebc7b57ce2b193c4e630e1fd3c2307fe6184d,0,GitHub,2019-11-21 10:51:55-08:00,['09f700ab3e2a8441109e26851cc861be7856f5e4'],1,2,3,2013728,1,,,,4757
f9fc53ea28a9c3e66aadb7d353b6b79317353b68,0,GitHub,2019-11-21 21:58:46-08:00,['1d8ebc7b57ce2b193c4e630e1fd3c2307fe6184d'],2,35,37,2013765,2,0.230769231,0.269230769,1,4757
5d0c2f3b2ad3cb12c8727b4fbf3a64c25ece6209,0,Matthias J. Sax,2019-11-21 23:40:19-08:00,['f9fc53ea28a9c3e66aadb7d353b6b79317353b68'],0,5,5,2013770,1,0,0,1,4757
9d8ab3a1a29371699da6dcc998117522f4e72ccf,0,GitHub,2019-11-22 10:09:13-08:00,['5d0c2f3b2ad3cb12c8727b4fbf3a64c25ece6209'],9,146,155,2013925,4,0.75,0.464285714,0.464285714,4758
054f2f1e8bc40aae78e1240578613fbe83e1e5d5,0,GitHub,2019-11-22 11:37:22-08:00,['9d8ab3a1a29371699da6dcc998117522f4e72ccf'],18,18,36,2013961,1,0,1,1,4758
e499c960e4f9cfc462f1a05a110d79ffa1c5b322,0,John Roesler,2019-11-22 15:25:57-06:00,['054f2f1e8bc40aae78e1240578613fbe83e1e5d5'],14,61,75,2014036,2,0,1,1,4758
b15e05d9257ad981d3b0d337cf3b372abbe185ae,0,GitHub,2019-11-22 19:32:08-05:00,['e499c960e4f9cfc462f1a05a110d79ffa1c5b322'],9,171,180,2014216,4,0.244897959,1,0,4759
b94c7f479b917d4ec602c31a24f11390627c479b,1,GitHub,2019-11-22 22:05:03-08:00,['b15e05d9257ad981d3b0d337cf3b372abbe185ae'],77,108,185,2014401,13,1,1,1,4759
e057d610502a1588e3436a53aedfaaad5126d7d5,0,GitHub,2019-11-23 14:18:42-08:00,['b94c7f479b917d4ec602c31a24f11390627c479b'],1,1,2,2014403,1,,,,4759
45842a396286cac79516a743babf13dae3d036a3,0,GitHub,2019-11-24 10:51:49-08:00,['e057d610502a1588e3436a53aedfaaad5126d7d5'],61,11,72,2014475,4,,,,4759
301b784d1b4e8672061e04613bd712ad15dfc734,0,Matthias J. Sax,2019-11-24 17:44:20-08:00,['45842a396286cac79516a743babf13dae3d036a3'],38,19,57,2014532,1,,,,4759
d38b8444d1be7f66c7e09a27fb145a05f3992577,0,GitHub,2019-11-25 16:16:04-08:00,['301b784d1b4e8672061e04613bd712ad15dfc734'],2,16,18,2014550,2,1,1,1,4759
88448f625570a82bf268b21a8d2120d8679844fb,1,Mickael Maison,2019-11-27 11:46:49+00:00,['d38b8444d1be7f66c7e09a27fb145a05f3992577'],0,6,6,2014556,1,0,1,1,4759
d7513693a3976cd39c827e822d50e4dc2344d62a,0,Mickael Maison,2019-11-27 12:08:06+00:00,['88448f625570a82bf268b21a8d2120d8679844fb'],1,9,10,2014566,1,,,,4759
3daddab8a89486c519bf6ce22f8765af8ff6d356,0,Bill Bejeck,2019-11-27 11:40:46-05:00,['d7513693a3976cd39c827e822d50e4dc2344d62a'],1,1,2,2014568,1,,,,4759
a50b7c497db5a2ef2326072c95d45b982346fc56,0,GitHub,2019-11-27 16:32:38-05:00,['3daddab8a89486c519bf6ce22f8765af8ff6d356'],192,192,384,2014952,1,,,,4759
446be127f7f7089b349dc5a75bc1af67589b22f6,0,Manikumar Reddy,2019-11-29 17:05:10+05:18,['a50b7c497db5a2ef2326072c95d45b982346fc56'],103,102,205,2015157,1,,,,4759
9dbca4c336c060bd3c0bc2a63641498af1f5e179,0,Manikumar Reddy,2019-11-29 20:42:00+05:18,['446be127f7f7089b349dc5a75bc1af67589b22f6'],4,4,8,2015165,1,,,,4759
ba02e8c6b6802262646a7d6287c7a2c237be65fd,1,GitHub,2019-11-29 21:21:06-08:00,['9dbca4c336c060bd3c0bc2a63641498af1f5e179'],2,73,75,2015240,2,0,1,1,4759
6649b7a91dafcff4f2ed5b5ec1c0bb02b755e7f7,0,Manikumar Reddy,2019-11-30 19:56:46+05:18,['ba02e8c6b6802262646a7d6287c7a2c237be65fd'],1,1,2,2015242,1,,,,4759
0b8ea7e162e68662fbda6893d188862999d9b427,1,Matthias J. Sax,2019-11-30 19:37:04-08:00,['6649b7a91dafcff4f2ed5b5ec1c0bb02b755e7f7'],18,1124,1142,2016384,13,0.219101124,0.835205993,0.741573034,4763
a2aa0a458bad7143092e3d55c743854b0572ec8a,0,Mickael Maison,2019-12-02 14:39:28+00:00,['0b8ea7e162e68662fbda6893d188862999d9b427'],2,2,4,2016388,1,,,,4763
075f583d95c98297a3bd83ad4e06e7241657e002,1,Ismael Juma,2019-12-02 12:05:14-08:00,['a2aa0a458bad7143092e3d55c743854b0572ec8a'],82,104,186,2016574,6,1,1,0,4764
38fde81132e0457e983eae60b3d4a9834ad84129,1,Rajini Sivaram,2019-12-03 12:56:16+00:00,['075f583d95c98297a3bd83ad4e06e7241657e002'],267,224,491,2017065,9,1,0,0,4764
5cddf9860bfb6271dae3a5286051a23a12c13dfe,1,GitHub,2019-12-03 08:26:17-08:00,['38fde81132e0457e983eae60b3d4a9834ad84129'],4,29,33,2017098,1,0.166666667,0.166666667,0.833333333,4764
18c13d38ed7090801f125088e3eaec7e3c85c09d,1,John Roesler,2019-12-03 19:13:25-06:00,['5cddf9860bfb6271dae3a5286051a23a12c13dfe'],32,387,419,2017517,14,0.233766234,0.995670996,0.965367965,4766
122941793ee932afccb1bd73d0c341e5946f1f5e,1,Jason Gustafson,2019-12-03 18:04:53-08:00,['18c13d38ed7090801f125088e3eaec7e3c85c09d'],8,40,48,2017565,2,0,1,1,4766
d3131a10209ae06eca7840e86f39e98e18b7e1dd,1,Randall Hauch,2019-12-03 21:13:52-06:00,['122941793ee932afccb1bd73d0c341e5946f1f5e'],10,78,88,2017653,2,0.027027027,1,0.540540541,4766
95b6f42e0082b31202d10f5c79c32f3069bd3c56,1,GitHub,2019-12-03 19:27:00-08:00,['d3131a10209ae06eca7840e86f39e98e18b7e1dd'],86,81,167,2017820,3,1,1,0.461538462,4766
2accf14ccf9b1f96c9dd8cfb94530c56378fae80,1,Ismael Juma,2019-12-04 05:52:29-08:00,['95b6f42e0082b31202d10f5c79c32f3069bd3c56'],1,26,27,2017847,3,0.055555556,1,1,4766
0871f7b735856348c7d5bcfc663b4bae8e49ff76,1,Jason Gustafson,2019-12-04 08:39:39-08:00,['2accf14ccf9b1f96c9dd8cfb94530c56378fae80'],18,93,111,2017958,4,0.126984127,1,0.873015873,4766
95581f33f3f0a3dfb8769a2aa782cc11ffe1dccd,0,Colin Patrick McCabe,2019-12-04 09:11:26-08:00,['0871f7b735856348c7d5bcfc663b4bae8e49ff76'],41,159,200,2018158,2,0.341772152,1,1,4766
5b6de9f2d022cf25df73067b9de77ec267b4af8c,0,GitHub,2019-12-04 13:12:17-08:00,['95581f33f3f0a3dfb8769a2aa782cc11ffe1dccd'],164,219,383,2018541,17,1,1,0,4766
b0d89cb6ad8e01de05d7840de754ad45c361173a,0,Jason Gustafson,2019-12-04 13:33:34-08:00,['5b6de9f2d022cf25df73067b9de77ec267b4af8c'],0,41,41,2018582,2,0,0.870967742,1,4766
91f948763d183607b720625afea71c45a3e71fc3,0,GitHub,2019-12-04 17:54:37-05:00,['b0d89cb6ad8e01de05d7840de754ad45c361173a'],1,3,4,2018586,2,1,1,0,4766
0e57a3924ee73529e79790c1e7a70c74911777da,1,Randall Hauch,2019-12-04 17:27:51-06:00,['91f948763d183607b720625afea71c45a3e71fc3'],44,207,251,2018837,7,0.256637168,0.575221239,0.911504425,4766
eaccb9292984455a2978a635a224fb51f3b051b9,1,GitHub,2019-12-04 22:54:46-08:00,['0e57a3924ee73529e79790c1e7a70c74911777da'],517,298,815,2019652,27,0.278350515,0.304123711,0.298969072,4767
ba365bbb8deb16ec133e0e7983c1c56cef0152aa,0,Guozhang Wang,2019-12-05 12:44:26-08:00,['eaccb9292984455a2978a635a224fb51f3b051b9'],20,43,63,2019715,3,0,1,1,4767
04cd1457aee94e3aa3eda1b80e354d1be1b3b240,0,Guozhang Wang,2019-12-05 13:06:09-08:00,['ba365bbb8deb16ec133e0e7983c1c56cef0152aa'],429,272,701,2020416,2,0.834951456,0,0,4767
1d496a26c998cefc77223a7575980208620dfe2d,1,GitHub,2019-12-05 16:57:23-08:00,['04cd1457aee94e3aa3eda1b80e354d1be1b3b240'],27,30,57,2020473,2,1,1,1,4767
8e12c3eda6ba0f837979eefdd8d3f9d4d4d907c4,0,Manikumar Reddy,2019-12-06 15:11:35+05:18,['1d496a26c998cefc77223a7575980208620dfe2d'],3,7,10,2020483,1,0,1,1,4767
fa41521687ebbe429fdc37a11e6512a369a26c21,0,GitHub,2019-12-06 11:20:16-08:00,['8e12c3eda6ba0f837979eefdd8d3f9d4d4d907c4'],5,542,547,2021030,10,0.385964912,0.733333333,0.894736842,4770
9d9139024a77fc490b26d5fd5a416eb3d8c1e386,0,GitHub,2019-12-06 15:33:43-06:00,['fa41521687ebbe429fdc37a11e6512a369a26c21'],1,1,2,2021032,1,,,,4770
ccded348ebce1adbeafeab06ea2fa427a868ba8f,0,GitHub,2019-12-06 15:44:56-06:00,['9d9139024a77fc490b26d5fd5a416eb3d8c1e386'],12,13,25,2021057,4,,,,4770
cd5618f866921d420e2abeb5b9c03862217ec3b2,0,John Roesler,2019-12-06 16:03:42-06:00,['ccded348ebce1adbeafeab06ea2fa427a868ba8f'],3,7,10,2021067,2,,,,4770
5d0cb1419cd1f1cdfb7bc04ed4760d5a0eae0aa1,1,Ismael Juma,2019-12-08 11:38:50-08:00,['cd5618f866921d420e2abeb5b9c03862217ec3b2'],23,210,233,2021300,5,0.136,1,0.992,4770
deafc56fed575b82faa6f130e2c10c9efcb94680,1,Matthias J. Sax,2019-12-08 19:23:19-08:00,['5d0cb1419cd1f1cdfb7bc04ed4760d5a0eae0aa1'],8,139,147,2021447,10,1,1,0.666666667,4772
e4827fdbe8b9296124c6f0862205e592c15e2de5,0,Bill Bejeck,2019-12-09 11:20:06-05:00,['deafc56fed575b82faa6f130e2c10c9efcb94680'],2,2,4,2021451,1,,,,4772
d2d68380175905775aac0eeaf2238a280fb77f7f,1,GitHub,2019-12-09 18:18:01+00:00,['e4827fdbe8b9296124c6f0862205e592c15e2de5'],5,62,67,2021518,2,0.934782609,1,0.934782609,4772
648497a5e5e9373e17f632d0c2d101cc369ff20e,0,Rajini Sivaram,2019-12-09 18:57:42+00:00,['d2d68380175905775aac0eeaf2238a280fb77f7f'],10,29,39,2021557,2,0.5,0.8125,1,4772
bcfe8c76dd5a5b2913813cfd2ff733b7fa94a130,0,Guozhang Wang,2019-12-09 12:23:39-08:00,['648497a5e5e9373e17f632d0c2d101cc369ff20e'],65,343,408,2021965,6,0.319277108,1,0.602409639,4772
48da0c6c95c5aebd6c64b7810f83e3f65350e965,0,Bill Bejeck,2019-12-09 16:35:17-05:00,['bcfe8c76dd5a5b2913813cfd2ff733b7fa94a130'],0,8,8,2021973,1,,,,4772
72df28fe8c0ca4c8e552c8cfb3f907b9969f47d2,0,Manikumar Reddy,2019-12-10 13:40:54+05:18,['48da0c6c95c5aebd6c64b7810f83e3f65350e965'],3,19,22,2021995,1,0.857142857,0.928571429,1,4772
8968cdd809a54ec82a206f04cf296ea15207cb7a,0,GitHub,2019-12-10 11:01:31-05:00,['72df28fe8c0ca4c8e552c8cfb3f907b9969f47d2'],1,0,1,2021996,1,0,0,0,4772
39d68de39377db5bd911175c157953bc6102d86b,0,GitHub,2019-12-10 12:30:49-06:00,['8968cdd809a54ec82a206f04cf296ea15207cb7a'],12,2,14,2022010,1,1,0,0.5,4772
f770b4946ea92a7e14f69619494de688e8bc94c1,0,GitHub,2019-12-10 11:53:07-08:00,['39d68de39377db5bd911175c157953bc6102d86b'],0,4,4,2022014,1,,,,4772
4fea3e4f1ab9ee1f0a714c80297b782ab5b15067,0,GitHub,2019-12-10 16:27:16-08:00,['f770b4946ea92a7e14f69619494de688e8bc94c1'],2,36,38,2022052,4,0,0.379310345,0,4772
717ce42a6d68d3ac8d9478451a31423b5d43234e,0,GitHub,2019-12-11 09:48:23-08:00,['4fea3e4f1ab9ee1f0a714c80297b782ab5b15067'],5,1268,1273,2023325,7,0.367119901,0.653893696,0.754017305,4776
bd5be8457f7f0d163ff801adecac4687da6d8251,0,GitHub,2019-12-12 09:56:12+00:00,['717ce42a6d68d3ac8d9478451a31423b5d43234e'],31,158,189,2023514,4,0.5,0.961538462,1,4776
ae2e7be20010815c7ceef02d235a6671349ed225,0,Rajini Sivaram,2019-12-12 11:38:10+00:00,['bd5be8457f7f0d163ff801adecac4687da6d8251'],5,58,63,2023577,2,0.416666667,0.694444444,1,4776
d1161bf1060efc2d58b9c72997500dae2b59f169,1,Matthias J. Sax,2019-12-12 10:52:24-08:00,['ae2e7be20010815c7ceef02d235a6671349ed225'],10,767,777,2024354,6,0.276094276,0.804713805,0.845117845,4779
7a84d936339c0a1a2d8a3c6d319835ffdeb270d8,0,GitHub,2019-12-12 16:24:01-05:00,['d1161bf1060efc2d58b9c72997500dae2b59f169'],2,56,58,2024412,2,0,0.8,1,4779
9567921fd4cf39112aa317111cefbcd774c1bbea,1,Guozhang Wang,2019-12-12 18:43:37-08:00,['7a84d936339c0a1a2d8a3c6d319835ffdeb270d8'],0,16,16,2024428,1,,,,4779
ae38315895659ea3f71a612ba014184c936fd6cc,1,Colin Patrick McCabe,2019-12-13 10:38:17-08:00,['9567921fd4cf39112aa317111cefbcd774c1bbea'],99,539,638,2025066,31,0.637860082,1,0.670781893,4782
8b57f6cb3a7ea6d27169b91456355433ccfa2974,1,Matthias J. Sax,2019-12-13 14:07:21-08:00,['ae38315895659ea3f71a612ba014184c936fd6cc'],26,759,785,2025851,6,0.016920474,0.974619289,0.954314721,4782
dd8af2b23d7b58ad6d850cf9acc0eaca73681863,1,Matthias J. Sax,2019-12-15 11:44:31-08:00,['8b57f6cb3a7ea6d27169b91456355433ccfa2974'],9,701,710,2026561,8,0.277258567,0.897196262,0.825545171,4785
9fefe6aa6cc08937de51aa60af139c93d1dbad76,0,Mickael Maison,2019-12-16 18:27:32+00:00,['dd8af2b23d7b58ad6d850cf9acc0eaca73681863'],12,73,85,2026646,3,0,1,1,4785
dbafa07be3fa458f1af906b395fc3691f90a335c,0,Bill Bejeck,2019-12-16 15:55:10-05:00,['9fefe6aa6cc08937de51aa60af139c93d1dbad76'],6,23,29,2026675,1,,,,4785
763cb9683f7f8c0c93fab77cdccb4cc6098e69b0,0,Guozhang Wang,2019-12-16 14:08:30-08:00,['dbafa07be3fa458f1af906b395fc3691f90a335c'],2,0,2,2026677,1,,,,4785
16d36f1674f4867b4dc498464df20a0e8e18eb3f,0,Rajini Sivaram,2019-12-16 22:52:34+00:00,['763cb9683f7f8c0c93fab77cdccb4cc6098e69b0'],10,14,24,2026701,1,,,,4785
a87decb9e4df5bfa092c26ae4346f65c426f1321,1,GitHub,2019-12-16 16:37:40-08:00,['16d36f1674f4867b4dc498464df20a0e8e18eb3f'],691,423,1114,2027815,26,0.723756906,0.005524862,0.066298343,4785
b50d925e07d5ea5902b723f2ba6e248c7ef86c32,0,GitHub,2019-12-17 19:32:32+05:18,['a87decb9e4df5bfa092c26ae4346f65c426f1321'],4,16,20,2027835,7,,,,4785
fd7991ae23d2c169fe3f353c22f9fb888260be2d,1,GitHub,2019-12-17 08:20:25-08:00,['b50d925e07d5ea5902b723f2ba6e248c7ef86c32'],61,50,111,2027946,3,1,0,0,4785
75a68341da423d8b041ac8824fbebe99f9bd15ff,0,Jason Gustafson,2019-12-17 22:08:53-08:00,['fd7991ae23d2c169fe3f353c22f9fb888260be2d'],279,51,330,2028276,1,1,0,0,4785
29ccbed2c27a77466ded38b20155b3cd73f091d8,0,Manikumar Reddy,2019-12-18 20:37:17+05:18,['75a68341da423d8b041ac8824fbebe99f9bd15ff'],1,1,2,2028278,1,,,,4785
8c64aa080a9c49f84b62817b6d6a804af34d4f48,1,Manikumar Reddy,2019-12-18 20:57:16+05:18,['29ccbed2c27a77466ded38b20155b3cd73f091d8'],52,53,105,2028383,15,1,1,1,4785
c1351c34a9ebb61a721d9f41495dc9adf356a697,0,John Roesler,2019-12-18 11:16:42-06:00,['8c64aa080a9c49f84b62817b6d6a804af34d4f48'],4,0,4,2028387,1,1,0,0.666666667,4785
c6e25bb362899f4e6335ac5578b1cae31b7f2575,0,John Roesler,2019-12-18 11:21:57-06:00,['c1351c34a9ebb61a721d9f41495dc9adf356a697'],1,1,2,2028389,1,,,,4785
714eea91904e1e0672dd4d1168133a55a6d1ce4c,0,Manikumar Reddy,2019-12-19 18:18:08+05:18,['c6e25bb362899f4e6335ac5578b1cae31b7f2575'],1,4,5,2028394,1,,,,4785
6e56ba4b7da28529960df1d2099ac5a3b0591985,1,Mickael Maison,2019-12-19 13:04:38+00:00,['714eea91904e1e0672dd4d1168133a55a6d1ce4c'],1,1,2,2028396,1,,,,4785
e275742f850af4a1b79b0d1bd1ac9a1d2e89c64e,1,GitHub,2019-12-19 14:13:03+00:00,['6e56ba4b7da28529960df1d2099ac5a3b0591985'],142,379,521,2028917,13,0.387096774,0.774193548,1,4785
7e36865541307554ebad410d61c8186f6d641c55,1,GitHub,2019-12-19 09:38:26-08:00,['e275742f850af4a1b79b0d1bd1ac9a1d2e89c64e'],8,40,48,2028965,3,0.346153846,0.961538462,1,4785
96edabb6b8bdb44e3a09bc4ac98d7d3969d87859,0,Manikumar Reddy,2019-12-20 00:35:12+05:18,['7e36865541307554ebad410d61c8186f6d641c55'],9,16,25,2028990,2,,,,4785
7f35a6713434dd7f2ccd3897aef825d34582beab,1,Colin Patrick McCabe,2019-12-19 17:05:19-08:00,['96edabb6b8bdb44e3a09bc4ac98d7d3969d87859'],153,369,522,2029512,3,0.365079365,0.788359788,1,4785
5a65da5fe96bc44b5323f001263e487144e50f06,0,GitHub,2019-12-20 13:18:16-08:00,['7f35a6713434dd7f2ccd3897aef825d34582beab'],188,230,418,2029930,12,1,1,1,4785
1d21cf166a8ed7def514a1860318e74b64dd47da,0,Matthias J. Sax,2019-12-20 14:21:12-08:00,['5a65da5fe96bc44b5323f001263e487144e50f06'],10,111,121,2030051,9,0,1,1,4786
cdbf40d572c388cb8616a6ffe6b8b2361cee4522,1,GitHub,2019-12-21 12:30:36-06:00,['1d21cf166a8ed7def514a1860318e74b64dd47da'],15,91,106,2030157,2,0,1,1,4786
e812784e7442a76914bbd4427abcb5b1bc5e3372,1,Bill Bejeck,2019-12-23 12:05:57-05:00,['cdbf40d572c388cb8616a6ffe6b8b2361cee4522'],3,3,6,2030163,1,,,,4786
0f0eb49e35e30c444acee1d95c1e7029f65aaecb,1,Jason Gustafson,2019-12-23 15:20:40-08:00,['e812784e7442a76914bbd4427abcb5b1bc5e3372'],30,62,92,2030255,3,0,0.875,1,4786
7e71b1ac48613961d3099b295614f02d89f36829,0,Guozhang Wang,2019-12-23 15:36:32-08:00,['0f0eb49e35e30c444acee1d95c1e7029f65aaecb'],15,21,36,2030291,1,,,,4786
6b6b36cec043eefc830c5209d5a18bbcb47a31db,1,Jason Gustafson,2019-12-23 15:55:48-08:00,['7e71b1ac48613961d3099b295614f02d89f36829'],4,40,44,2030335,2,0.130434783,1,1,4786
6d486eddb5adc1e00d0fbf5b6e690df56628fbd0,0,Guozhang Wang,2019-12-28 15:43:05-08:00,['6b6b36cec043eefc830c5209d5a18bbcb47a31db'],2,19,21,2030356,2,1,1,1,4786
8fd7cd6a439a3914b49f7c6919e84e6937ee5a18,0,Jason Gustafson,2019-12-30 11:02:30-08:00,['6d486eddb5adc1e00d0fbf5b6e690df56628fbd0'],9,32,41,2030397,2,0.764705882,1,0.764705882,4786
65d97762abdc089a57dfb57a6f4d42910f8900dc,0,Matthias J. Sax,2019-12-31 12:29:40-08:00,['8fd7cd6a439a3914b49f7c6919e84e6937ee5a18'],8,53,61,2030458,1,1,1,1,4786
3453e9e2eee1400901ef8e1965d657b825d5d64a,0,Guozhang Wang,2019-12-31 18:44:31-08:00,['65d97762abdc089a57dfb57a6f4d42910f8900dc'],3,7,10,2030468,3,1,1,0,4786
b56b848682079052e98ecde9a15a8f6b8860c599,1,Guozhang Wang,2020-01-01 10:49:21-08:00,['3453e9e2eee1400901ef8e1965d657b825d5d64a'],71,110,181,2030649,4,1,1,1,4786
b2b6b5c65ad5646efe6d54b410d8ee22ba27a8a1,0,GitHub,2020-01-02 13:35:05+00:00,['b56b848682079052e98ecde9a15a8f6b8860c599'],1,1,2,2030651,1,,,,4786
f610f9ff1f59f90434c3614f00c95001f50100e4,0,GitHub,2020-01-02 13:45:24-08:00,['b2b6b5c65ad5646efe6d54b410d8ee22ba27a8a1'],2,0,2,2030653,1,1,1,0,4786
a09450426785d1d4d051703ea1d86cc7e585ceef,0,GitHub,2020-01-03 13:04:10-08:00,['f610f9ff1f59f90434c3614f00c95001f50100e4'],139,252,391,2031044,8,0.414141414,1,1,4786
933b982f48cc10873cc3eeba8575eebb0fd5d463,1,Manikumar Reddy,2020-01-06 17:07:54+05:18,['a09450426785d1d4d051703ea1d86cc7e585ceef'],8,2,10,2031054,3,1,0,0,4786
bd3bde76232f580477fb457b40258b3bae33788d,0,GitHub,2020-01-06 09:06:11-08:00,['933b982f48cc10873cc3eeba8575eebb0fd5d463'],2,2,4,2031058,2,,,,4786
46980d632c787e75d870420eb1ddda039c59c5dc,0,GitHub,2020-01-06 17:52:50+00:00,['bd3bde76232f580477fb457b40258b3bae33788d'],0,42,42,2031100,1,,,,4786
42b0971e94651c590865ef163543d91722779f88,0,GitHub,2020-01-06 10:30:42-08:00,['46980d632c787e75d870420eb1ddda039c59c5dc'],8,58,66,2031166,2,0,0.75,1,4786
6dc6f6a60ddf7a70c394c147fbed579749d2abcc,1,GitHub,2020-01-06 19:51:01+01:00,['42b0971e94651c590865ef163543d91722779f88'],1466,776,2242,2033408,104,0,0,0.106936416,4786
2ac78ff621b1755b84daa8196197b774865357e7,1,GitHub,2020-01-06 14:27:30-08:00,['6dc6f6a60ddf7a70c394c147fbed579749d2abcc'],83,138,221,2033629,24,0.470588235,0.794117647,0.205882353,4786
03f763df8a8d9482d8c099806336f00cf2521465,1,GitHub,2020-01-06 18:42:06-05:00,['2ac78ff621b1755b84daa8196197b774865357e7'],0,20,20,2033649,2,,,,4787
b2988863598ca4106a5455f1d19975852149cbb0,0,Mickael Maison,2020-01-07 17:00:30+00:00,['03f763df8a8d9482d8c099806336f00cf2521465'],5,27,32,2033681,1,,,,4787
8d480c5eed38b2c559f3304db83ffa0bb26df356,1,Jason Gustafson,2020-01-07 11:07:32-08:00,['b2988863598ca4106a5455f1d19975852149cbb0'],22,54,76,2033757,2,0.619047619,1,1,4787
1513c817d4437300865b06bde2ae33210ae05ff9,0,Matthias J. Sax,2020-01-07 12:52:40-08:00,['8d480c5eed38b2c559f3304db83ffa0bb26df356'],18,70,88,2033845,7,1,1,1,4787
618226c544f35a02d606342d984bb60c6e1371d7,1,Jason Gustafson,2020-01-07 14:03:08-08:00,['1513c817d4437300865b06bde2ae33210ae05ff9'],7,74,81,2033926,4,0.375,0.9,1,4787
1adf0ee889f6f221bc41da41b25a653db5dcda60,0,Guozhang Wang,2020-01-07 14:59:27-08:00,['618226c544f35a02d606342d984bb60c6e1371d7'],4,158,162,2034088,2,0.245614035,0.964912281,1,4788
98d36fa54e4053af71a69d6580c1a8b0dee84f77,0,GitHub,2020-01-08 03:11:16-08:00,['1adf0ee889f6f221bc41da41b25a653db5dcda60'],2,2,4,2034092,1,,,,4788
03da52ecacd460c6765f216fa6c557275f4bec01,0,GitHub,2020-01-08 03:57:57-08:00,['98d36fa54e4053af71a69d6580c1a8b0dee84f77'],1,2,3,2034095,1,,,,4788
1ccca5c6a99df5d1e398b098c733bad93f29d1f7,0,GitHub,2020-01-08 15:28:51-08:00,['03da52ecacd460c6765f216fa6c557275f4bec01'],38,315,353,2034448,16,0.66,1,0.92,4791
e63becb83d68e0d8f33271d9212886e60508c34d,1,Jason Gustafson,2020-01-08 15:47:27-08:00,['1ccca5c6a99df5d1e398b098c733bad93f29d1f7'],418,319,737,2035185,12,0,0.323529412,0.235294118,4791
a024e679c7207aee2242d72aef53dc441c60ca27,1,GitHub,2020-01-08 16:25:20-08:00,['e63becb83d68e0d8f33271d9212886e60508c34d'],52,44,96,2035281,4,,,,4791
f6b36fe842d18dd8015ccb6f8490b84c7639336d,0,Jason Gustafson,2020-01-08 16:55:00-08:00,['a024e679c7207aee2242d72aef53dc441c60ca27'],1,8,9,2035290,2,,,,4791
bbbf431d6e82ce33ba77f378c173acedbe1e0d98,0,Guozhang Wang,2020-01-08 17:16:46-08:00,['f6b36fe842d18dd8015ccb6f8490b84c7639336d'],12,5,17,2035307,1,1,1,0,4791
163c5e7ac2e386d4d1ef74711018e3cb6d6fd165,0,Matthias J. Sax,2020-01-08 19:08:58-08:00,['bbbf431d6e82ce33ba77f378c173acedbe1e0d98'],11,8,19,2035326,1,,,,4791
e9734f5486ac3f9a62ade6a06689d6194ae55b51,1,GitHub,2020-01-09 14:17:42+00:00,['163c5e7ac2e386d4d1ef74711018e3cb6d6fd165'],8,1,9,2035335,1,0,0,0,4791
655843c5d66a514c84f4ca7f027b81f6bcb45c92,0,GitHub,2020-01-09 14:48:02+00:00,['e9734f5486ac3f9a62ade6a06689d6194ae55b51'],2,15,17,2035352,1,0.916666667,0.916666667,1,4791
e9cde112cd47d88c3e256881a70035c0fd31c022,1,Matthias J. Sax,2020-01-09 09:34:59-08:00,['655843c5d66a514c84f4ca7f027b81f6bcb45c92'],35,162,197,2035549,9,0.365384615,1,1,4792
dbbe0fcf9299b9625dadcf21aa183987539b5877,1,GitHub,2020-01-09 11:11:23-08:00,['e9cde112cd47d88c3e256881a70035c0fd31c022'],9,70,79,2035628,2,0,0.909090909,1,4792
dbc9cd638f3524dacca4753b25e9f6566fd4560a,1,GitHub,2020-01-09 13:47:26-08:00,['dbbe0fcf9299b9625dadcf21aa183987539b5877'],350,508,858,2036486,24,0.428571429,0.899159664,0.957983193,4792
e94f5dcc802f8e786e84a58754c800c0fbad5ab4,1,GitHub,2020-01-09 15:38:09-08:00,['dbc9cd638f3524dacca4753b25e9f6566fd4560a'],3030,4170,7200,2043686,5,0.798913043,0.984782609,0.913043478,4792
505e8240cd29fe3f0effa96d794bc711d5c8423b,1,GitHub,2020-01-09 15:52:19-08:00,['e94f5dcc802f8e786e84a58754c800c0fbad5ab4'],109,331,440,2044126,14,0,1,1,4792
422bc1f0fa024924032c1b128a02bdb90929ed4b,0,Jason Gustafson,2020-01-09 16:53:36-08:00,['505e8240cd29fe3f0effa96d794bc711d5c8423b'],38,0,38,2044164,2,0.366666667,0.033333333,0.033333333,4792
63576dde57109092c6103420fe60a1a983307cf8,0,Jason Gustafson,2020-01-09 17:08:16-08:00,['422bc1f0fa024924032c1b128a02bdb90929ed4b'],152,224,376,2044540,12,0,0.838709677,1,4794
700a931ff55293bce1825a96913f059ff1dec2be,0,GitHub,2020-01-10 11:23:24+00:00,['63576dde57109092c6103420fe60a1a983307cf8'],1,17,18,2044558,1,0,1,1,4794
be4f50e7fdda4b22781ce0dae3e19d385e244400,0,GitHub,2020-01-10 13:17:56-08:00,['700a931ff55293bce1825a96913f059ff1dec2be'],638,869,1507,2046065,4,,,,4794
36805b8ba9803a44775a5eb711ac9d763c71598e,0,Jason Gustafson,2020-01-10 20:21:45-08:00,['be4f50e7fdda4b22781ce0dae3e19d385e244400'],115,77,192,2046257,8,0.027777778,0,0,4794
5731caf9c709c70215e88a703636a49ac7445ff5,0,Jason Gustafson,2020-01-11 10:09:46-08:00,['36805b8ba9803a44775a5eb711ac9d763c71598e'],27,3,30,2046287,1,0,0,0,4794
655447140ea5d3a59743f4bf77c0af7e34e2d96e,0,Jason Gustafson,2020-01-11 10:11:29-08:00,['5731caf9c709c70215e88a703636a49ac7445ff5'],12,12,24,2046311,9,,,,4794
1e09ecec2a7c50fbb3fd74ab9a11f250f38460cd,0,Jason Gustafson,2020-01-11 22:23:24-08:00,['655447140ea5d3a59743f4bf77c0af7e34e2d96e'],11,11,22,2046333,2,,,,4794
e418c53ff7992f6e2906397782c66207714a7b95,0,Jason Gustafson,2020-01-11 22:27:23-08:00,['1e09ecec2a7c50fbb3fd74ab9a11f250f38460cd'],0,1,1,2046334,1,0,0,1,4794
eb09efa9ac79efa484307bdcf03ac8eb8a3a94e2,1,GitHub,2020-01-13 09:43:10+00:00,['e418c53ff7992f6e2906397782c66207714a7b95'],319,740,1059,2047393,14,0.584033613,1,0.575630252,4794
4fe324b5a696d47ae8414cf030ae36b83a2cf163,1,Mickael Maison,2020-01-13 18:06:29+00:00,['eb09efa9ac79efa484307bdcf03ac8eb8a3a94e2'],2,85,87,2047480,2,0,1,1,4794
8c21fa837df6908d9147805e097407d006d95fd4,0,GitHub,2020-01-13 12:40:06-08:00,['4fe324b5a696d47ae8414cf030ae36b83a2cf163'],1,6,7,2047487,1,,,,4794
3953204d3512d3b0e4fb83ccb8f6e248a71fe2b9,0,Jason Gustafson,2020-01-13 15:25:24-08:00,['8c21fa837df6908d9147805e097407d006d95fd4'],1,1,2,2047489,2,,,,4794
39278d3089dfab4377051ed1ff47edf75dbf8583,1,Guozhang Wang,2020-01-13 19:17:08-08:00,['3953204d3512d3b0e4fb83ccb8f6e248a71fe2b9'],0,35,35,2047524,2,0,0.925925926,0.925925926,4794
6da70f9b95d2f7cc1f32de4e405661a8015bfa7e,1,Guozhang Wang,2020-01-13 19:21:00-08:00,['39278d3089dfab4377051ed1ff47edf75dbf8583'],141,343,484,2048008,21,0.291338583,0.874015748,0.763779528,4795
d6ace7b2d7c4ad721dd8247fb2b3eff9f67fbfee,1,GitHub,2020-01-14 14:51:30+00:00,['6da70f9b95d2f7cc1f32de4e405661a8015bfa7e'],12,335,347,2048355,2,0.616161616,0.833333333,0.702020202,4796
0a2569e2b9907a1217dd50ccbc320f8ad0b42fd0,1,GitHub,2020-01-14 11:36:34-08:00,['d6ace7b2d7c4ad721dd8247fb2b3eff9f67fbfee'],36,51,87,2048442,17,1,1,1,4796
81fcb809249e9f7152232ec8aa66a79155327e6f,0,GitHub,2020-01-14 13:50:36-08:00,['0a2569e2b9907a1217dd50ccbc320f8ad0b42fd0'],275,801,1076,2049518,3,1,1,1,4796
06e296be9b8d1ce777074b0e4953b6ad66105d55,0,David Arthur,2020-01-14 17:03:44-05:00,['81fcb809249e9f7152232ec8aa66a79155327e6f'],2,56,58,2049576,2,0,0.121212121,0.787878788,4796
ed7c071e07f1f90e4c2895582f61ca090ced3c42,1,Guozhang Wang,2020-01-14 15:04:18-08:00,['06e296be9b8d1ce777074b0e4953b6ad66105d55'],85,189,274,2049850,17,0,0.685714286,0.685714286,4796
71c5729a41330702ff0592776e2fe7f67e472b2c,1,John Roesler,2020-01-15 09:39:02-06:00,['ed7c071e07f1f90e4c2895582f61ca090ced3c42'],284,827,1111,2050961,20,0.491582492,0.818181818,0.602693603,4797
0c76fbbbedb5d342080dcaf0207602c158d3116d,1,John Roesler,2020-01-15 13:47:40-06:00,['71c5729a41330702ff0592776e2fe7f67e472b2c'],150,365,515,2051476,16,0.269503546,0.943262411,0.496453901,4798
5c00191ea957fef425bf5dbbe47d70e41249e2d6,0,Vahid Hashemian,2020-01-15 12:25:43-08:00,['0c76fbbbedb5d342080dcaf0207602c158d3116d'],1,1,2,2051478,1,,,,4798
6d87c12729ac6dc9d39949c931fad4c45c6af841,1,Jason Gustafson,2020-01-15 21:22:55-08:00,['5c00191ea957fef425bf5dbbe47d70e41249e2d6'],11,13,24,2051502,1,0,0,0,4798
fbe2e604cc5b5a82afa3ec6eda956294fe5fea17,1,GitHub,2020-01-16 13:50:24-08:00,['6d87c12729ac6dc9d39949c931fad4c45c6af841'],115,267,382,2051884,8,0.111111111,1,1,4798
bbd3348dcbcb01017914b64dbe6f16c00c1b7b61,1,John Roesler,2020-01-16 16:25:48-06:00,['fbe2e604cc5b5a82afa3ec6eda956294fe5fea17'],7,606,613,2052497,16,0.267647059,0.611764706,0.961764706,4800
cd4ab4189e32a7b4a88d6762a39fa947c4eee14b,0,GitHub,2020-01-16 16:30:57-06:00,['bbd3348dcbcb01017914b64dbe6f16c00c1b7b61'],5,6,11,2052508,1,,,,4800
1e1110d8f378bee0b5c4a0b78270eddf78db1fee,0,Jason Gustafson,2020-01-16 22:35:38-08:00,['cd4ab4189e32a7b4a88d6762a39fa947c4eee14b'],1,0,1,2052509,1,0,0,0,4800
8da12d4d37a26f577726097f284308c32ad07f9f,0,Rajini Sivaram,2020-01-17 09:45:10+00:00,['1e1110d8f378bee0b5c4a0b78270eddf78db1fee'],1,1,2,2052511,1,,,,4800
08e1576eeeb2ed2111a3c0a93fb1d911bbee8b33,0,GitHub,2020-01-17 10:01:09+00:00,['8da12d4d37a26f577726097f284308c32ad07f9f'],1,1,2,2052513,1,,,,4800
dbeaba5d9e45846d89835c1d30c138147528d0f4,0,GitHub,2020-01-17 13:20:34+00:00,['08e1576eeeb2ed2111a3c0a93fb1d911bbee8b33'],547,688,1235,2053748,39,1,0,0,4801
a88703255b25eda2a75ca9a876fa8c8c5e7bfb6f,1,Mickael Maison,2020-01-17 13:44:18+00:00,['dbeaba5d9e45846d89835c1d30c138147528d0f4'],54,143,197,2053945,4,0.698113208,0.811320755,0.660377358,4801
eed81c66e907dc798bf0c43fddf34bcc192136c7,0,Jason Gustafson,2020-01-17 08:23:34-08:00,['a88703255b25eda2a75ca9a876fa8c8c5e7bfb6f'],1,1,2,2053947,1,,,,4801
eb8e2a8e3b3e2e7f5c097593faf2c651f92f2caf,1,GitHub,2020-01-17 19:21:02+00:00,['eed81c66e907dc798bf0c43fddf34bcc192136c7'],39,61,100,2054047,1,1,1,1,4801
9eface2e731ac53037bfa29b191171dae8c44d41,0,Jason Gustafson,2020-01-17 14:27:31-08:00,['eb8e2a8e3b3e2e7f5c097593faf2c651f92f2caf'],1,78,79,2054126,3,0.391304348,0.869565217,0.97826087,4801
9b312c401c0fe66039be28815218d28fae37dc0d,1,Jason Gustafson,2020-01-17 14:34:00-08:00,['9eface2e731ac53037bfa29b191171dae8c44d41'],34,181,215,2054341,5,0.489361702,1,1,4801
faf46de5156ac8e0f02cc98227ed449ddcdea307,0,GitHub,2020-01-17 14:36:04-08:00,['9b312c401c0fe66039be28815218d28fae37dc0d'],35,139,174,2054515,4,0.533333333,1,0.833333333,4801
21df6eeda93e61b3197f0dd8008b4ce0ed985484,0,Jason Gustafson,2020-01-19 10:07:17-08:00,['faf46de5156ac8e0f02cc98227ed449ddcdea307'],1,1,2,2054517,1,,,,4801
9d96964792924fd86e1be6e2deebe8b68e069859,1,Manikumar Reddy,2020-01-20 22:07:41+05:18,['21df6eeda93e61b3197f0dd8008b4ce0ed985484'],1,2,3,2054520,1,,,,4801
0ecb5bb58615361fc5a9b909b736e800088a2b41,0,GitHub,2020-01-21 14:39:22+00:00,['9d96964792924fd86e1be6e2deebe8b68e069859'],1,1,2,2054522,1,,,,4801
1e823a6884c8123635756fda56ed1e77ea725ff3,0,GitHub,2020-01-21 15:40:33+00:00,['0ecb5bb58615361fc5a9b909b736e800088a2b41'],2,5,7,2054529,1,0,1,1,4801
d755ca14a05550480e3c9eba36846aafdb5a06fd,0,Randall Hauch,2020-01-21 13:21:16-06:00,['1e823a6884c8123635756fda56ed1e77ea725ff3'],1,1,2,2054531,1,,,,4801
58a0b99e92f9caba16003256ee7db771939bb956,1,Randall Hauch,2020-01-21 13:33:50-06:00,['d755ca14a05550480e3c9eba36846aafdb5a06fd'],47,278,325,2054856,4,0.793939394,0.884848485,0.939393939,4801
c8c0ec6ac994a071224b151253a95d0e48868ecf,1,Guozhang Wang,2020-01-21 11:46:13-08:00,['58a0b99e92f9caba16003256ee7db771939bb956'],1,21,22,2054878,2,0.866666667,0.866666667,1,4801
28f013708ffe8e48e46f408c7f570bf2cd5c54b2,0,Randall Hauch,2020-01-21 14:25:35-06:00,['c8c0ec6ac994a071224b151253a95d0e48868ecf'],2,25,27,2054905,2,0.785714286,1,1,4801
a14f25546ad5f497055999b8be51835c89e1de85,0,Jason Gustafson,2020-01-21 12:39:35-08:00,['28f013708ffe8e48e46f408c7f570bf2cd5c54b2'],10,7,17,2054922,1,1,0,0,4801
6594114cbdc77609241535b9f4957796102ef20e,0,Randall Hauch,2020-01-21 14:52:40-06:00,['a14f25546ad5f497055999b8be51835c89e1de85'],2,4,6,2054928,1,0,1,1,4801
b4ecd03cececc8eb8a39c223d96302e48a4e54c7,0,Jason Gustafson,2020-01-21 18:02:18-08:00,['6594114cbdc77609241535b9f4957796102ef20e'],1,3,4,2054932,1,0,0,1,4801
b399a731a39c28bdd89998edc7c9fd732c56eee1,0,Randall Hauch,2020-01-22 10:46:53-06:00,['b4ecd03cececc8eb8a39c223d96302e48a4e54c7'],1,2,3,2054935,1,,,,4801
de90175fc24357e20306c5a4de4f0f8ec8675ad2,1,Jason Gustafson,2020-01-22 13:48:36-08:00,['b399a731a39c28bdd89998edc7c9fd732c56eee1'],157,868,1025,2055960,21,0.319688109,0.996101365,0.877192982,4801
df13fc93d0aebfe0ecc40dd4af3c5fb19b35f710,1,GitHub,2020-01-23 08:14:31-08:00,['de90175fc24357e20306c5a4de4f0f8ec8675ad2'],586,442,1028,2056988,6,1,0.25210084,0,4801
a565d1a182cc69c9994c4512b5e9877e97f06cdf,1,GitHub,2020-01-24 10:38:21+00:00,['df13fc93d0aebfe0ecc40dd4af3c5fb19b35f710'],23,59,82,2057070,6,0,1,1,4801
57b2f6807d332f4e6de4dc4ad18aa24686d304de,1,Bill Bejeck,2020-01-24 14:30:47-05:00,['a565d1a182cc69c9994c4512b5e9877e97f06cdf'],126,110,236,2057306,9,0.625,0,0,4801
8e5faca963cdcb082c882a5e726327b36e9701f0,0,Randall Hauch,2020-01-24 13:56:08-06:00,['57b2f6807d332f4e6de4dc4ad18aa24686d304de'],1,1,2,2057308,1,,,,4801
2e351e06b3557ed63a54946f33fd1c0f0f136b50,1,Bill Bejeck,2020-01-24 16:55:50-05:00,['8e5faca963cdcb082c882a5e726327b36e9701f0'],56,250,306,2057614,2,0.424242424,1,1,4801
a3509c0870230bcc1af4efbfafcf9f69d7cf55fd,1,Rajini Sivaram,2020-01-24 22:21:12+00:00,['2e351e06b3557ed63a54946f33fd1c0f0f136b50'],108,374,482,2058096,32,0.405594406,1,1,4804
790a39e353d957632b8296346890dbc8d4694255,0,Jason Gustafson,2020-01-24 14:47:22-08:00,['a3509c0870230bcc1af4efbfafcf9f69d7cf55fd'],2,36,38,2058134,2,0,1,1,4804
b50e213eebcbc5e9ea64c84c8b51736991e0a7c3,0,Matthias J. Sax,2020-01-27 16:19:26-08:00,['790a39e353d957632b8296346890dbc8d4694255'],3,1,4,2058138,1,0,0,0,4804
ef23b432f133ba831d1f4b966e414cac894d7ce7,0,GitHub,2020-01-28 05:19:56-08:00,['b50e213eebcbc5e9ea64c84c8b51736991e0a7c3'],7,7,14,2058152,1,,,,4804
172409c44b8551e2315bd93044a8a95ccda4699f,0,Rajini Sivaram,2020-01-28 18:57:23+00:00,['ef23b432f133ba831d1f4b966e414cac894d7ce7'],10,44,54,2058206,3,0.15,1,1,4804
31ef2b9addbc097a1977ad749f7001a47d1c7704,0,GitHub,2020-01-28 21:41:06-08:00,['172409c44b8551e2315bd93044a8a95ccda4699f'],3,0,3,2058209,1,,,,4804
40b35178e8dc8f6d243f985a3f1f93a79aacd8d1,0,GitHub,2020-01-29 12:45:15-08:00,['31ef2b9addbc097a1977ad749f7001a47d1c7704'],243,285,528,2058737,12,0.168674699,0.590361446,0.43373494,4804
aecd3936a3edd61576feb6873876b1b16831e9ef,0,GitHub,2020-01-29 13:00:22-08:00,['40b35178e8dc8f6d243f985a3f1f93a79aacd8d1'],19,7,26,2058763,2,1,0.166666667,0,4804
b4d7560b4fb221583190c6d950daf389906cf15f,1,GitHub,2020-01-29 13:03:17-08:00,['aecd3936a3edd61576feb6873876b1b16831e9ef'],25,34,59,2058822,1,0,0,0,4804
bd5a1c4d368b9e91398e48400965d30d3045062e,1,GitHub,2020-01-29 13:03:35-08:00,['b4d7560b4fb221583190c6d950daf389906cf15f'],13,36,49,2058871,4,0,1,1,4804
8494fdb50a53099b4a80fe0cea75de0b78b20e52,0,GitHub,2020-01-29 16:14:41-08:00,['bd5a1c4d368b9e91398e48400965d30d3045062e'],12,58,70,2058941,2,0.75,0.055555556,0.888888889,4804
7746301c2643e0037bff3bcb84c41d512937e4c9,1,GitHub,2020-01-29 23:54:21-06:00,['8494fdb50a53099b4a80fe0cea75de0b78b20e52'],40,778,818,2059759,20,0.491566265,0.874698795,0.922891566,4807
05b2361c0412be25877cb106e9847e9a8a4f622a,1,GitHub,2020-01-29 23:45:47-08:00,['7746301c2643e0037bff3bcb84c41d512937e4c9'],146,669,815,2060574,22,0.378676471,0.768382353,1,4809
6b86af3a2703dfbb9685b4440ba7538091ca3e73,1,GitHub,2020-01-29 23:57:10-08:00,['05b2361c0412be25877cb106e9847e9a8a4f622a'],1,870,871,2061445,4,0.087542088,1,0.988215488,4810
f217752bed75a79d9bfdf9195721d0b05cebbf79,0,GitHub,2020-01-30 10:43:34+00:00,['6b86af3a2703dfbb9685b4440ba7538091ca3e73'],21,187,208,2061653,8,1,1,1,4813
57cef765f55fa1b9bab99cf4c71cf40f64533656,1,GitHub,2020-01-30 04:54:27-08:00,['f217752bed75a79d9bfdf9195721d0b05cebbf79'],15,246,261,2061914,15,0.382716049,0.777777778,0.932098765,4813
43576562d3def25c913ffdc2371a0c6c937a6eb4,0,GitHub,2020-01-30 04:58:53-08:00,['57cef765f55fa1b9bab99cf4c71cf40f64533656'],11,13,24,2061938,4,,,,4813
fa7047ad9ab18f6ba660faad27aaf11e313effa5,0,GitHub,2020-01-30 08:02:25-08:00,['43576562d3def25c913ffdc2371a0c6c937a6eb4'],14,15,29,2061967,4,,,,4813
d37d95b3593482bcc22b05d7f27401511e58f823,0,GitHub,2020-01-30 17:46:03+00:00,['fa7047ad9ab18f6ba660faad27aaf11e313effa5'],1,13,14,2061981,1,1,1,1,4813
0780f0043d4f9e43d38a3490a8159fef3702f949,0,GitHub,2020-01-30 14:29:14-05:00,['d37d95b3593482bcc22b05d7f27401511e58f823'],7,16,23,2062004,1,0,0,0,4813
4317325fbcb29d1f5ab828821b8e0714e10ed981,1,GitHub,2020-01-30 22:48:51-08:00,['0780f0043d4f9e43d38a3490a8159fef3702f949'],84,229,313,2062317,22,0.127906977,1,0.581395349,4813
72232df4e0d59868b230a5a0f5e1667d5486c0d5,0,GitHub,2020-01-31 12:42:16-05:00,['4317325fbcb29d1f5ab828821b8e0714e10ed981'],1,10,11,2062328,1,,,,4813
c8d97c6d51bf8872eb5c0e5a123a8ee0ba6cfd6b,1,GitHub,2020-01-31 18:21:21+00:00,['72232df4e0d59868b230a5a0f5e1667d5486c0d5'],25,149,174,2062502,20,0.583333333,1,0.966666667,4814
96c4ce4803c39f669a7f539481be76c67979faf0,1,GitHub,2020-01-31 13:54:07-08:00,['c8d97c6d51bf8872eb5c0e5a123a8ee0ba6cfd6b'],399,1098,1497,2063999,21,0.268537074,0.93987976,0.861723447,4814
5ddab1b60c33ed85315b77ba0ca194814499fc63,0,GitHub,2020-02-02 14:50:03-08:00,['96c4ce4803c39f669a7f539481be76c67979faf0'],1,1,2,2064001,1,,,,4814
eebbae7b31e5dfd5f99c0ec04a568aff28e3394b,0,GitHub,2020-02-03 06:36:06-08:00,['5ddab1b60c33ed85315b77ba0ca194814499fc63'],31,44,75,2064076,1,0,1,1,4814
738e14edb833f3efdf807c506531b3eed4ee7137,0,GitHub,2020-02-03 07:12:00-08:00,['eebbae7b31e5dfd5f99c0ec04a568aff28e3394b'],919,652,1571,2065647,27,0,0,0.459459459,4814
7e776b0462801b05620ba01d3fcf2a0b2d1bf014,0,GitHub,2020-02-03 13:04:56-05:00,['738e14edb833f3efdf807c506531b3eed4ee7137'],10,10,20,2065667,8,,,,4814
8bb962d66f0fe3296659960fa19a24f4175f2700,0,GitHub,2020-02-03 17:02:31-08:00,['7e776b0462801b05620ba01d3fcf2a0b2d1bf014'],5,2,7,2065674,1,,,,4814
281ed90cd8f6d5221b4a87def8019a5b881898c8,0,GitHub,2020-02-04 17:01:08+00:00,['8bb962d66f0fe3296659960fa19a24f4175f2700'],62,128,190,2065864,3,0,0.888888889,1,4815
dd7a314591c54af67d769f78d85c10be063cb909,0,GitHub,2020-02-04 11:15:04-06:00,['281ed90cd8f6d5221b4a87def8019a5b881898c8'],31,257,288,2066152,2,0.807909605,0.807909605,0.966101695,4815
7748fc2fc6cab504403276696df9ae8cf193601f,1,GitHub,2020-02-04 09:44:12-08:00,['dd7a314591c54af67d769f78d85c10be063cb909'],1,12,13,2066165,1,,,,4815
b029902b129333f0bafa2d0776cc827004e2532b,1,GitHub,2020-02-04 11:22:33-08:00,['7748fc2fc6cab504403276696df9ae8cf193601f'],18,43,61,2066226,3,0.714285714,1,1,4815
a16dfe673980a0d637287b63ec1e7340384806ac,0,GitHub,2020-02-04 12:38:04-08:00,['b029902b129333f0bafa2d0776cc827004e2532b'],10,10,20,2066246,1,,,,4815
4090f9a2b0a95e4da127e4786007542276d97520,1,GitHub,2020-02-04 21:06:39-08:00,['a16dfe673980a0d637287b63ec1e7340384806ac'],9430,6673,16103,2082349,87,0.50711989,0.073036288,0.121727147,4815
bdd0a9299f8004cc82c7128b02acb6b843101c32,0,GitHub,2020-02-04 21:16:54-08:00,['4090f9a2b0a95e4da127e4786007542276d97520'],1,85,86,2082435,2,0.32,1,0.88,4816
5db02ead60fbc937b3c51a51ecd6e93936dddf88,0,GitHub,2020-02-05 08:23:57-08:00,['bdd0a9299f8004cc82c7128b02acb6b843101c32'],3,3,6,2082441,3,,,,4816
ae0c6e58e5a2c545ba54eea5fb4d5dd103d237ff,1,GitHub,2020-02-05 09:13:11-08:00,['5db02ead60fbc937b3c51a51ecd6e93936dddf88'],479,635,1114,2083555,30,0,0.794871795,1,4817
7ea636c661e7a178639e7205bd86ca9f7fb1bd9a,0,Guozhang Wang,2020-02-05 09:58:40-08:00,['ae0c6e58e5a2c545ba54eea5fb4d5dd103d237ff'],8,8,16,2083571,1,,,,4817
987f0eeb31c874a9e163d98a7751e11c65dfa80a,0,GitHub,2020-02-05 16:41:28-08:00,['7ea636c661e7a178639e7205bd86ca9f7fb1bd9a'],0,20,20,2083591,3,,,,4817
9d17bf98b6eae2d5a91a9a719e5c447b55ded3a5,0,GitHub,2020-02-05 16:51:07-08:00,['987f0eeb31c874a9e163d98a7751e11c65dfa80a'],42,508,550,2084141,9,0.171052632,0.526315789,0.714912281,4820
f48946f572be2ff201abf69653b1eacc4436e34e,0,GitHub,2020-02-06 10:58:05-08:00,['9d17bf98b6eae2d5a91a9a719e5c447b55ded3a5'],7,21,28,2084169,2,0.25,0,1,4820
5380938f8bb0cc2dcaab187e381f369361dcbf79,1,GitHub,2020-02-06 15:28:18-08:00,['f48946f572be2ff201abf69653b1eacc4436e34e'],95,121,216,2084385,8,1,1,0.454545455,4820
f698f3f8401845e0f73b104c0f96c54d2851b67a,1,GitHub,2020-02-06 19:20:52-08:00,['5380938f8bb0cc2dcaab187e381f369361dcbf79'],73,96,169,2084554,6,0.052631579,1,0.947368421,4820
83e1a8d71c316634c96674e4bd8670b169cb1a21,0,GitHub,2020-02-07 13:08:25-08:00,['f698f3f8401845e0f73b104c0f96c54d2851b67a'],2,2,4,2084558,1,,,,4820
a6c9e96bd396cea58da3e9d206b0bd907e8c7543,0,GitHub,2020-02-07 13:51:37-08:00,['83e1a8d71c316634c96674e4bd8670b169cb1a21'],16,16,32,2084590,2,,,,4820
4d86b191c0ae39dcdd1e306c68ae0cdaedea1de5,1,GitHub,2020-02-07 13:58:22-08:00,['a6c9e96bd396cea58da3e9d206b0bd907e8c7543'],3,45,48,2084638,1,0.851851852,1,1,4820
be4a6ddebb2728311f11bfaef25c0a2df7246129,0,GitHub,2020-02-07 16:08:15-08:00,['4d86b191c0ae39dcdd1e306c68ae0cdaedea1de5'],2,4,6,2084644,1,0,1,1,4820
7a2a198d1e8755ec367a3d95c68aaf35b8ad9ede,0,GitHub,2020-02-07 16:43:51-08:00,['be4a6ddebb2728311f11bfaef25c0a2df7246129'],2,13,15,2084659,3,0,0,1,4820
87eaa5396d991b53ef89e58c37b54b6c1517b554,0,GitHub,2020-02-08 14:14:21+00:00,['7a2a198d1e8755ec367a3d95c68aaf35b8ad9ede'],3,5,8,2084667,1,,,,4820
7b5b15e2f8d925ebdf657c99ac4cda2df90eb860,0,GitHub,2020-02-08 14:17:08+00:00,['87eaa5396d991b53ef89e58c37b54b6c1517b554'],1,1,2,2084669,1,,,,4820
342f13a838b22464cb6297869d75eb04fd0617f3,1,Manikumar Reddy,2020-02-08 21:04:48+05:18,['7b5b15e2f8d925ebdf657c99ac4cda2df90eb860'],109,1387,1496,2086165,36,0.495495495,0.848348348,0.917417417,4822
059a81e3c95fd89a3cb444aa9ffd3578648b4549,0,GitHub,2020-02-08 21:39:27-08:00,['342f13a838b22464cb6297869d75eb04fd0617f3'],259,303,562,2086727,16,1,0.666666667,0.666666667,4822
0f8698a3292333ca527248d5cb08bf1a3f6b5def,1,GitHub,2020-02-10 14:54:04+00:00,['059a81e3c95fd89a3cb444aa9ffd3578648b4549'],178,698,876,2087603,17,0.150724638,0.968115942,0.72173913,4822
3b1c61385be7fb31b75f1352248bc00fa52d4a44,1,GitHub,2020-02-10 18:05:17+00:00,['0f8698a3292333ca527248d5cb08bf1a3f6b5def'],12,16,28,2087631,2,0.6,0.6,0.4,4822
d76fa1b22d4b06e1f1a7700272ca963091f13931,1,GitHub,2020-02-10 12:09:27-06:00,['3b1c61385be7fb31b75f1352248bc00fa52d4a44'],210,216,426,2088057,25,0.272727273,0.272727273,0,4822
41fdae35df6f3913b6f92841aa9cc743d9f01c6d,0,Manikumar Reddy,2020-02-11 00:29:48+05:18,['d76fa1b22d4b06e1f1a7700272ca963091f13931'],23,23,46,2088103,7,,,,4822
e70e5d913a1d2295cdf47742a2cc89ec9acdacf4,1,GitHub,2020-02-10 12:59:14-08:00,['41fdae35df6f3913b6f92841aa9cc743d9f01c6d'],25,90,115,2088218,5,0.15,0.4,1,4822
3dfc6c15e41950cba41329d6ecffb933ea29b6df,0,GitHub,2020-02-10 13:06:06-08:00,['e70e5d913a1d2295cdf47742a2cc89ec9acdacf4'],2,55,57,2088275,3,0.428571429,1,1,4823
ff8c40ccb6aa9687a70976bc64eafef2b25d71a4,0,GitHub,2020-02-10 13:09:26-08:00,['3dfc6c15e41950cba41329d6ecffb933ea29b6df'],151,86,237,2088512,2,0,1,1,4823
520a76155c66486cbcd0c519ef2980359964fd7c,1,GitHub,2020-02-10 15:33:23-06:00,['ff8c40ccb6aa9687a70976bc64eafef2b25d71a4'],38,325,363,2088875,15,0.191176471,0.963235294,1,4826
5727b245091cdd20be335b5044f070ef4aecff0c,0,GitHub,2020-02-11 13:48:22-06:00,['520a76155c66486cbcd0c519ef2980359964fd7c'],1,35,36,2088911,2,1,1,1,4826
0f14aef8cbc959551b8dd393cb47517c0479dc5e,1,GitHub,2020-02-11 14:49:26-06:00,['5727b245091cdd20be335b5044f070ef4aecff0c'],313,561,874,2089785,7,0.1,0.483333333,0,4827
50aead64b962139103e0d68b446156e9c0588cfc,0,GitHub,2020-02-11 14:13:04-08:00,['0f14aef8cbc959551b8dd393cb47517c0479dc5e'],2,2,4,2089789,1,,,,4827
dc89c86d4339875085298b47e85e574d6d698dd0,0,GitHub,2020-02-11 14:15:43-08:00,['50aead64b962139103e0d68b446156e9c0588cfc'],0,45,45,2089834,2,1,1,1,4827
a149c3effabaeaac9fc8205d5f1cb56d265b2cfc,0,GitHub,2020-02-11 14:22:20-08:00,['dc89c86d4339875085298b47e85e574d6d698dd0'],5,5,10,2089844,1,,,,4827
e16859dc48c679b3c7d9735438df046479b8ec4a,1,GitHub,2020-02-11 17:34:00-06:00,['a149c3effabaeaac9fc8205d5f1cb56d265b2cfc'],53,272,325,2090169,10,0.692307692,0.915384615,0.707692308,4828
cde6d18983b5d58199f8857d8d61d7efcbe6e54a,1,GitHub,2020-02-11 17:31:13-08:00,['e16859dc48c679b3c7d9735438df046479b8ec4a'],136,426,562,2090731,11,0.46835443,1,0.974683544,4829
998f1520f9af2dddfec9a9ac072f8dcf9d9004fd,0,GitHub,2020-02-11 21:00:17-06:00,['cde6d18983b5d58199f8857d8d61d7efcbe6e54a'],90,364,454,2091185,4,0.082901554,1,0.953367876,4830
1681c78f60a3a75e69e2222be0649cd61f02f042,1,GitHub,2020-02-11 22:38:05-06:00,['998f1520f9af2dddfec9a9ac072f8dcf9d9004fd'],172,317,489,2091674,8,0.245901639,0,0.770491803,4830
0a5dec0b3a3e1b027230ba766fee0c08b70cc63c,0,GitHub,2020-02-12 11:45:06-08:00,['1681c78f60a3a75e69e2222be0649cd61f02f042'],23,67,90,2091764,6,0.322580645,1,0.580645161,4830
2cbd3d7519fd9cc6a7e74c20cd058cc833952c90,0,GitHub,2020-02-12 11:46:54-08:00,['0a5dec0b3a3e1b027230ba766fee0c08b70cc63c'],75,114,189,2091953,6,0.09375,0.71875,1,4830
aa0d0ec32ac53099ddf33e04be2a1701e539dffa,1,GitHub,2020-02-12 12:19:34-08:00,['2cbd3d7519fd9cc6a7e74c20cd058cc833952c90'],131,399,530,2092483,12,0.474226804,0.969072165,0.912371134,4830
07db26c20fcbccbf758591607864f7fd4bd8975f,1,GitHub,2020-02-12 12:34:12-08:00,['aa0d0ec32ac53099ddf33e04be2a1701e539dffa'],82,520,602,2093085,20,0.217105263,0.786184211,0.398026316,4831
c8f1ee9cd994c08056df67d22c30a5893e0901a2,0,GitHub,2020-02-12 15:44:23-06:00,['07db26c20fcbccbf758591607864f7fd4bd8975f'],1,10,11,2093096,2,1,1,1,4831
f51e1e654812105c26693e318d20cfbe417f88fb,0,GitHub,2020-02-12 16:36:06-06:00,['c8f1ee9cd994c08056df67d22c30a5893e0901a2'],1,41,42,2093138,2,0.428571429,1,1,4831
97d2c726f1eee137eaad0ccb8f6f71a8e10c8c23,0,GitHub,2020-02-12 17:40:37-06:00,['f51e1e654812105c26693e318d20cfbe417f88fb'],57,52,109,2093247,9,0,1,1,4831
46e80dbd20999253a73675f38e3fba05a20fc2a0,0,GitHub,2020-02-12 22:40:43-08:00,['97d2c726f1eee137eaad0ccb8f6f71a8e10c8c23'],2,12,14,2093261,1,0.777777778,1,1,4831
ea72edebf2d484e42a4251c53cd6e383743b5d1a,0,GitHub,2020-02-12 23:42:02-08:00,['46e80dbd20999253a73675f38e3fba05a20fc2a0'],11,1,12,2093273,1,0.111111111,0,0.111111111,4831
7e1c39f75abc443281f31f3c2f1e4829e738619d,1,GitHub,2020-02-13 10:21:14-08:00,['ea72edebf2d484e42a4251c53cd6e383743b5d1a'],121,447,568,2093841,40,0.38961039,0.948051948,0.954545455,4833
96c69da8c164966c1281df7001d5d239053442fd,1,GitHub,2020-02-13 13:44:51-08:00,['7e1c39f75abc443281f31f3c2f1e4829e738619d'],35,177,212,2094053,9,0.551724138,0.057471264,1,4833
9da6823a3a5cef7305d72788c295ada2fd1c0c88,0,GitHub,2020-02-13 18:20:15-08:00,['96c69da8c164966c1281df7001d5d239053442fd'],14,4,18,2094071,2,0,0,0,4833
37d0b12cfc9d2c52f9b8f73a176d3c3123e8c570,0,GitHub,2020-02-14 08:49:46-08:00,['9da6823a3a5cef7305d72788c295ada2fd1c0c88'],20,57,77,2094148,1,0.35483871,0.935483871,1,4833
8d0b069b0fbda0826ad447accbf93a19f6e813fe,0,GitHub,2020-02-14 15:54:39-06:00,['37d0b12cfc9d2c52f9b8f73a176d3c3123e8c570'],38,99,137,2094285,3,0,0.952380952,0.976190476,4833
16ee326755e3f13914a0ed446c34c84e65fc0bc4,0,GitHub,2020-02-14 14:34:34-08:00,['8d0b069b0fbda0826ad447accbf93a19f6e813fe'],87,957,1044,2095329,16,0.380670611,0.996055227,0.968441815,4834
d8756e81c57040130ec163e63798663d62298589,0,GitHub,2020-02-14 17:28:14-08:00,['16ee326755e3f13914a0ed446c34c84e65fc0bc4'],46,104,150,2095479,8,0,0.84375,0.84375,4834
937f1f741c026767b6b71ce0b0e63ae7ebe6e936,1,GitHub,2020-02-15 22:47:10-08:00,['d8756e81c57040130ec163e63798663d62298589'],432,1449,1881,2097360,13,0.116883117,0.903318903,0.952380952,4835
863b534f83aad50528828a30857e1ff56ac93f27,1,GitHub,2020-02-16 12:06:33-08:00,['937f1f741c026767b6b71ce0b0e63ae7ebe6e936'],104,181,285,2097645,3,0,1,1,4835
97c5dc1c134def07360a7f65405c3b0587f2d44d,1,GitHub,2020-02-16 15:54:59-08:00,['863b534f83aad50528828a30857e1ff56ac93f27'],15,14,29,2097674,3,,,,4835
f3642814317e1dc44722a6262ace08bfc1527b15,0,GitHub,2020-02-17 09:49:35+00:00,['97c5dc1c134def07360a7f65405c3b0587f2d44d'],1,1,2,2097676,1,,,,4835
b1449f683c43c51da579e18a404a1cff87c3c18d,0,GitHub,2020-02-17 11:37:15+00:00,['f3642814317e1dc44722a6262ace08bfc1527b15'],0,4,4,2097680,1,,,,4835
2c0c2c595b21cd07ba96bc1fa70a2874874241a5,1,GitHub,2020-02-17 07:51:26-08:00,['b1449f683c43c51da579e18a404a1cff87c3c18d'],1,1,2,2097682,1,,,,4835
413db69d41f22b10295782e38890cb0077d6e21c,0,GitHub,2020-02-17 09:58:02-08:00,['2c0c2c595b21cd07ba96bc1fa70a2874874241a5'],5,6,11,2097693,1,0,0,1,4835
ebcdcd9fa94efbff80e52b02c85d4a61c09f850b,0,GitHub,2020-02-18 11:29:14-08:00,['413db69d41f22b10295782e38890cb0077d6e21c'],44,43,87,2097780,1,0.5,1,1,4835
72122fc0696720495ae06e72ed40d8fd289b1425,1,GitHub,2020-02-18 14:35:32-08:00,['ebcdcd9fa94efbff80e52b02c85d4a61c09f850b'],24,104,128,2097908,2,0.957446809,0.957446809,1,4835
913c61934e49f2739e6fd4d21480a82674a7c0be,0,GitHub,2020-02-18 16:00:22-08:00,['72122fc0696720495ae06e72ed40d8fd289b1425'],1,1,2,2097910,1,,,,4835
eb7dfef2452bf7975cde4e44baa0c9b9ea193401,1,GitHub,2020-02-19 09:11:45-08:00,['913c61934e49f2739e6fd4d21480a82674a7c0be'],8,120,128,2098038,2,0,0.965116279,0.965116279,4835
5a19fe6cd110ccbb5641649a2439f9c708d062c2,0,GitHub,2020-02-19 09:24:26-08:00,['eb7dfef2452bf7975cde4e44baa0c9b9ea193401'],3,6,9,2098047,1,0,1,0,4835
9942e20a5854e9b6f7d17b3092710108025e193c,0,GitHub,2020-02-19 10:23:59-08:00,['5a19fe6cd110ccbb5641649a2439f9c708d062c2'],2,2,4,2098051,1,,,,4835
a41d3d86c13a55a75e67b1635bc74361ebe6d7af,0,GitHub,2020-02-19 16:20:35-05:00,['9942e20a5854e9b6f7d17b3092710108025e193c'],1,24,25,2098076,2,1,1,1,4835
f51d06712a5fcc0a1ad1ee2be1b8dca7d6f39e4d,0,GitHub,2020-02-20 11:10:08+00:00,['a41d3d86c13a55a75e67b1635bc74361ebe6d7af'],0,1,1,2098077,1,,,,4835
04b6641c1420fbc8d5e1a1040961a42d8cfbeba6,0,GitHub,2020-02-20 11:35:27+00:00,['f51d06712a5fcc0a1ad1ee2be1b8dca7d6f39e4d'],2,2,4,2098081,1,,,,4835
6d4cfad0133ca10c91beb16efc6c4230d1395d95,1,GitHub,2020-02-20 14:19:50+00:00,['04b6641c1420fbc8d5e1a1040961a42d8cfbeba6'],2,18,20,2098101,2,,,,4835
8ab0994919752cd4870e771221ba934a6a539a67,0,GitHub,2020-02-20 14:54:37+00:00,['6d4cfad0133ca10c91beb16efc6c4230d1395d95'],59,28,87,2098188,14,0.434782609,0,0.086956522,4835
776565f7a8646c1920dbb303aad7fe3edb08d7ce,1,GitHub,2020-02-20 09:59:09-08:00,['8ab0994919752cd4870e771221ba934a6a539a67'],101,75,176,2098364,6,1,1,0.19047619,4835
b2aec9496d11af15e8f68ae96a4fefb0aa69d36d,0,GitHub,2020-02-20 10:56:11-08:00,['776565f7a8646c1920dbb303aad7fe3edb08d7ce'],2,2,4,2098368,1,,,,4835
0d16c26e3c0affadfada1ce91faa617dc065dbcd,1,GitHub,2020-02-20 13:24:38-08:00,['b2aec9496d11af15e8f68ae96a4fefb0aa69d36d'],40,49,89,2098457,7,1,1,1,4835
3b6573c150527efb3e90b2b3d1a059ac5c2db80b,1,GitHub,2020-02-20 16:14:45-08:00,['0d16c26e3c0affadfada1ce91faa617dc065dbcd'],232,359,591,2099048,16,0.653061224,0.408163265,1,4836
d9b8b86bdd0b4fe6965b1f597f9ba7ec33954a50,0,Manikumar Reddy,2020-02-21 18:33:14+05:18,['3b6573c150527efb3e90b2b3d1a059ac5c2db80b'],0,10,10,2099058,1,,,,4836
b28aa4ece6e65a30dfb2009afffd39ba07b31374,0,Manikumar Reddy,2020-02-21 18:37:11+05:18,['d9b8b86bdd0b4fe6965b1f597f9ba7ec33954a50'],1,1,2,2099060,1,,,,4836
747ef08d47f438b885a72aa7a906e88ba322ef06,0,Manikumar Reddy,2020-02-21 20:05:52+05:18,['b28aa4ece6e65a30dfb2009afffd39ba07b31374'],2,0,2,2099062,1,,,,4836
84c4025fdd13fb6943568ebaf78d7ea2faa35540,1,GitHub,2020-02-21 10:03:09-08:00,['747ef08d47f438b885a72aa7a906e88ba322ef06'],2,38,40,2099102,3,0,0.62962963,1,4836
003dce5d51c8b74040ac22f0697f25b581f920c9,1,GitHub,2020-02-21 12:08:00-08:00,['84c4025fdd13fb6943568ebaf78d7ea2faa35540'],1,40,41,2099143,2,0,1,1,4836
bbfecaef725456f648f03530d26a5395042966fa,0,Ewen Cheslack-Postava,2020-02-21 12:25:35-08:00,['003dce5d51c8b74040ac22f0697f25b581f920c9'],0,6,6,2099149,1,,,,4836
97d107a270d3e9b795b42d209f838f2f81009ce8,1,GitHub,2020-02-22 06:40:28+01:00,['bbfecaef725456f648f03530d26a5395042966fa'],956,1615,2571,2101720,21,1,1,0.873287671,4838
1a8dcffe4adb61f6073c8fb2514a7fdd49b50716,0,GitHub,2020-02-21 21:49:11-08:00,['97d107a270d3e9b795b42d209f838f2f81009ce8'],17,96,113,2101833,4,0.350877193,1,1,4838
bf16e358610222320ed0b6ffbca39536121c132e,0,Manikumar Reddy,2020-02-22 22:02:51+05:18,['1a8dcffe4adb61f6073c8fb2514a7fdd49b50716'],0,3,3,2101836,1,,,,4838
7d504d668f266becd3562cbe688f10962c5ca87b,1,GitHub,2020-02-23 13:08:14+01:00,['bf16e358610222320ed0b6ffbca39536121c132e'],1,52,53,2101889,2,0.244444444,0.844444444,1,4838
2df7ea5a4a43920ae1ac8a259f6f69846011eda7,1,GitHub,2020-02-23 10:16:32-08:00,['7d504d668f266becd3562cbe688f10962c5ca87b'],18,15,33,2101922,1,1,1,0,4838
1de9981fe38f3e46dcc98cd8b5d3378f7ce0f6a8,1,GitHub,2020-02-24 08:49:56-08:00,['2df7ea5a4a43920ae1ac8a259f6f69846011eda7'],34,92,126,2102048,4,0.431818182,1,1,4838
384eb16805ef8f7520f46cc6def25e71495bd6bd,0,GitHub,2020-02-24 11:32:15-08:00,['1de9981fe38f3e46dcc98cd8b5d3378f7ce0f6a8'],1,1,2,2102050,1,,,,4838
5359b2e3bc1cf13a301f32490a6630802afc4974,1,GitHub,2020-02-24 12:12:33-08:00,['384eb16805ef8f7520f46cc6def25e71495bd6bd'],435,611,1046,2103096,14,1,1,0.753623188,4838
9d53ad794de45739093070306f44df2a2f31e9e4,1,Manikumar Reddy,2020-02-25 19:47:55+05:18,['5359b2e3bc1cf13a301f32490a6630802afc4974'],47,219,266,2103362,9,0.902777778,1,0.444444444,4839
30ab2297f1697f9aee048283fb2cf307e3f4f4be,1,GitHub,2020-02-25 16:23:56+00:00,['9d53ad794de45739093070306f44df2a2f31e9e4'],76,253,329,2103691,1,,,,4839
5216da3de27116f60b11f810e0613e4bec7ec7fa,0,GitHub,2020-02-25 17:11:17+00:00,['30ab2297f1697f9aee048283fb2cf307e3f4f4be'],9,9,18,2103709,1,,,,4839
9639ff494a511e9af81c2e4f4d6463969bccc984,0,GitHub,2020-02-25 13:24:58-05:00,['5216da3de27116f60b11f810e0613e4bec7ec7fa'],24,1,25,2103734,2,0,0,0,4839
90640266393b530107db8256d38ec5aeba4805e1,1,GitHub,2020-02-25 13:23:25-06:00,['9639ff494a511e9af81c2e4f4d6463969bccc984'],7,343,350,2104084,10,0.288888889,1,0.924444444,4839
a28447a06582bf8e6de427f047f3d3ba4e2219a1,1,GitHub,2020-02-25 15:28:01-08:00,['90640266393b530107db8256d38ec5aeba4805e1'],148,263,411,2104495,16,0.289473684,0.947368421,0.842105263,4839
dd22b3f01b6bab41dce4d608f405ec6c78f7759e,1,GitHub,2020-02-25 17:45:12-08:00,['a28447a06582bf8e6de427f047f3d3ba4e2219a1'],40,121,161,2104656,14,0.675675676,1,1,4839
0dc0b71d5d1b92c72ca3e5d7382b2a335e278748,1,GitHub,2020-02-25 20:12:11-08:00,['dd22b3f01b6bab41dce4d608f405ec6c78f7759e'],30,60,90,2104746,3,0.19047619,1,1,4839
c1784947cd23a433d61188276527d863ad39a08d,1,GitHub,2020-02-26 10:40:21+05:18,['0dc0b71d5d1b92c72ca3e5d7382b2a335e278748'],1,1,2,2104748,1,,,,4839
922a95a18d6cf7ead03642bd422409fe922cccfc,1,Manikumar Reddy,2020-02-26 10:43:48+05:18,['c1784947cd23a433d61188276527d863ad39a08d'],34,293,327,2105075,3,0.388059701,1,0.962686567,4840
7d6d386c4c3826c5b61d5066b10c12a6eafffe2c,0,GitHub,2020-02-26 11:10:00-06:00,['922a95a18d6cf7ead03642bd422409fe922cccfc'],1,7,8,2105083,1,,,,4840
b9e3fa2322eaae20a96818fd16ad38adb11be41f,0,GitHub,2020-02-26 15:52:15-06:00,['7d6d386c4c3826c5b61d5066b10c12a6eafffe2c'],1,1,2,2105085,1,,,,4840
dfef2a3ec2f69a5159cc6d1def3130197dba9cf9,1,GitHub,2020-02-26 14:03:16-08:00,['b9e3fa2322eaae20a96818fd16ad38adb11be41f'],18,59,77,2105162,2,0.033333333,1,1,4840
a983545d3c8a059d290db832e1bfcf9c9e38b1ce,1,GitHub,2020-02-26 14:05:42-08:00,['dfef2a3ec2f69a5159cc6d1def3130197dba9cf9'],2,29,31,2105193,2,0,1,1,4840
39d5534f8d1b6113d23e9cd38f40ab5495ce3286,0,GitHub,2020-02-26 15:33:18-08:00,['a983545d3c8a059d290db832e1bfcf9c9e38b1ce'],3,3,6,2105199,3,,,,4840
bafdf8630e7e66c2ff4405ff3ec75aa75105e837,0,GitHub,2020-02-26 17:47:13-08:00,['39d5534f8d1b6113d23e9cd38f40ab5495ce3286'],9,16,25,2105224,5,0.5,1,0.75,4840
fb5bd9eb7cdfdae8ed1ea8f68e9be5687f610b28,0,GitHub,2020-02-26 21:11:20-08:00,['bafdf8630e7e66c2ff4405ff3ec75aa75105e837'],1,0,1,2105225,1,1,0,0,4840
399d18fd8ee47bee533ee4f4e4f8d9bbaf703b90,0,GitHub,2020-02-27 09:05:55-08:00,['fb5bd9eb7cdfdae8ed1ea8f68e9be5687f610b28'],7,6,13,2105238,2,0,0,0,4840
d2c42125aad73fdcb063e0cbc45417cf88989d03,0,GitHub,2020-02-27 09:48:53-08:00,['399d18fd8ee47bee533ee4f4e4f8d9bbaf703b90'],317,203,520,2105758,1,,,,4840
52f36d1987f1911b26f79d741dc241137ea1f715,0,GitHub,2020-02-27 13:06:43-08:00,['d2c42125aad73fdcb063e0cbc45417cf88989d03'],1,4,5,2105763,1,,,,4840
294b62963b563f65f64a60ed673276c0c36af101,0,GitHub,2020-02-27 17:46:55-05:00,['52f36d1987f1911b26f79d741dc241137ea1f715'],1,1,2,2105765,1,,,,4840
ede07306a70689f51fbca4f13d3b65a2326bfa43,1,GitHub,2020-02-28 12:06:58-08:00,['294b62963b563f65f64a60ed673276c0c36af101'],47,336,383,2106148,7,0.456852792,0.903553299,0.791878173,4841
e0551acce434985acbbf28e441aa2d4af033b1b5,1,GitHub,2020-02-28 14:15:55-08:00,['ede07306a70689f51fbca4f13d3b65a2326bfa43'],3,58,61,2106209,4,0.088235294,0.264705882,1,4841
0df03a681c00a4778d2f306ded658cc1794a6f8e,0,GitHub,2020-02-29 14:07:15-08:00,['e0551acce434985acbbf28e441aa2d4af033b1b5'],1,1,2,2106211,1,,,,4841
0d83894feca98ef69fccc49dce290471c1a6104d,1,GitHub,2020-02-29 15:13:00-08:00,['0df03a681c00a4778d2f306ded658cc1794a6f8e'],2,2,4,2106215,1,,,,4841
72a5aa8b0758f23b42c6e4453d6dc6c4861aa1ad,0,GitHub,2020-02-29 19:43:51-05:00,['0d83894feca98ef69fccc49dce290471c1a6104d'],20,46,66,2106281,4,0.869565217,0.913043478,0,4841
a1f2ece323e59a751a55386bf06beb5724c56545,1,GitHub,2020-02-29 18:44:22-08:00,['72a5aa8b0758f23b42c6e4453d6dc6c4861aa1ad'],40,138,178,2106459,9,0.428571429,1,1,4842
c07db1c7d9b67a635fec4bd81d1c51bb2e15f68e,0,GitHub,2020-03-01 16:31:15-08:00,['a1f2ece323e59a751a55386bf06beb5724c56545'],11,17,28,2106487,2,,,,4842
285ad85ff71c0baf048e95d0f875a4dcfbb4b101,0,GitHub,2020-03-01 16:54:34-08:00,['c07db1c7d9b67a635fec4bd81d1c51bb2e15f68e'],1,1,2,2106489,1,,,,4842
75268cb8e91130d192b1f1614f66d3897d1f93fa,0,Manikumar Reddy,2020-03-02 12:02:51+05:18,['285ad85ff71c0baf048e95d0f875a4dcfbb4b101'],0,15,15,2106504,1,,,,4842
ea0c02753140cacbac5893874f623441073b3837,0,GitHub,2020-03-02 10:22:01-06:00,['75268cb8e91130d192b1f1614f66d3897d1f93fa'],46,33,79,2106583,2,1,0,0,4842
8dff0b168a28a5ed75b1ee8a8c33ba9a9c67d1a1,0,Manikumar Reddy,2020-03-03 01:39:09+05:18,['ea0c02753140cacbac5893874f623441073b3837'],10,138,148,2106731,4,0.487804878,0.487804878,0.87804878,4843
d3f9cb5cd37486e33cb90a6ec7eb382044ba1e51,0,GitHub,2020-03-02 15:53:23-05:00,['8dff0b168a28a5ed75b1ee8a8c33ba9a9c67d1a1'],1,1,2,2106733,1,,,,4843
69b670a444c7638f663e13dc37e0532ce64b1363,0,GitHub,2020-03-02 17:24:19-08:00,['d3f9cb5cd37486e33cb90a6ec7eb382044ba1e51'],1,2,3,2106736,1,1,1,1,4843
c2ec974e81f1c65aa2f2e43f7f4dc820b1957bca,1,GitHub,2020-03-03 21:45:11-08:00,['69b670a444c7638f663e13dc37e0532ce64b1363'],25,549,574,2107310,7,0.435684647,0.958506224,0.871369295,4845
f35e6496aa003dc0667dc338001a5b51be78fe76,0,GitHub,2020-03-04 09:36:06+00:00,['c2ec974e81f1c65aa2f2e43f7f4dc820b1957bca'],24,71,95,2107405,2,0.540540541,1,1,4845
41f9d7a82b36b3040551efa549202457aa9c5b0a,0,GitHub,2020-03-04 13:54:07-08:00,['f35e6496aa003dc0667dc338001a5b51be78fe76'],0,6,6,2107411,1,0,1,1,4845
bd53249796f9ea90a56f1641d39a9b8d835ce2db,0,GitHub,2020-03-05 11:46:37-05:00,['41f9d7a82b36b3040551efa549202457aa9c5b0a'],5,37,42,2107453,2,0.266666667,0.933333333,0.933333333,4845
78374a15492cfb6df49353bd166d8c45ac9abdb2,1,GitHub,2020-03-05 14:20:46-06:00,['bd53249796f9ea90a56f1641d39a9b8d835ce2db'],716,1362,2078,2109531,15,0.221518987,0.974683544,1,4847
674360f5b3a7e5e05b626fd55c277f7c03f27b9e,1,GitHub,2020-03-06 09:19:04-06:00,['78374a15492cfb6df49353bd166d8c45ac9abdb2'],294,418,712,2110243,14,1,0.928571429,1,4847
6b419933a09513d10e57a1909c7c06f43dc472f2,0,GitHub,2020-03-06 14:50:22-05:00,['674360f5b3a7e5e05b626fd55c277f7c03f27b9e'],0,21,21,2110264,2,0.857142857,1,0.142857143,4847
ca90a8480183bf287d07baf6b3794bc51f76b89e,0,GitHub,2020-03-06 13:08:52-08:00,['6b419933a09513d10e57a1909c7c06f43dc472f2'],13,106,119,2110383,4,0.951219512,0.951219512,1,4848
d3c067f35d184ca75e8cc59bedd56689cbc8269b,1,GitHub,2020-03-06 15:38:55-08:00,['ca90a8480183bf287d07baf6b3794bc51f76b89e'],122,281,403,2110786,20,0,0.893203883,0.961165049,4848
c67e8bc542bde47ac52d065a797037812860b163,0,GitHub,2020-03-06 22:13:54-08:00,['d3c067f35d184ca75e8cc59bedd56689cbc8269b'],9,0,9,2110795,2,1,0,0,4848
e7f6c1e1a7590244cca88622c9e1f6b3545b1dc1,0,GitHub,2020-03-06 23:27:04-08:00,['c67e8bc542bde47ac52d065a797037812860b163'],72,134,206,2111001,4,0,0.140350877,0.701754386,4848
27755723c23d475d915befe58f4c63966e3b02d1,0,GitHub,2020-03-06 23:47:32-08:00,['e7f6c1e1a7590244cca88622c9e1f6b3545b1dc1'],8,12,20,2111021,2,,,,4848
fe0b704285ebc916ce5080a5248d91b4dc3c60e0,1,GitHub,2020-03-07 08:08:23-08:00,['27755723c23d475d915befe58f4c63966e3b02d1'],14,76,90,2111111,3,0.022222222,0.977777778,1,4848
f081f3bd7619194e567daaa53b52216b75925adf,0,GitHub,2020-03-07 08:22:55-08:00,['fe0b704285ebc916ce5080a5248d91b4dc3c60e0'],8,6,14,2111125,3,1,0,1,4848
4b03d67e106c6d3b9dd465a308a62b400ead70a4,1,GitHub,2020-03-07 08:46:38-08:00,['f081f3bd7619194e567daaa53b52216b75925adf'],147,287,434,2111559,1,0,1,0,4848
cdd5ef3a5063a83f67f49b51fadffa524ab9cbaf,1,GitHub,2020-03-09 18:05:15+00:00,['4b03d67e106c6d3b9dd465a308a62b400ead70a4'],36,24,60,2111619,3,0.125,0.125,0.125,4848
dcfb641add650073f46fe8d8370c72f0284e62d7,1,GitHub,2020-03-09 17:48:44-07:00,['cdd5ef3a5063a83f67f49b51fadffa524ab9cbaf'],26,82,108,2111727,2,0,0.634146341,1,4848
fc9d91a6323baf4b79177db14f7f9af50e3c87a3,0,GitHub,2020-03-10 08:42:59-07:00,['dcfb641add650073f46fe8d8370c72f0284e62d7'],19,21,40,2111767,2,0,0,0,4848
33f6e1a1cd4c38728112ca697bb04293d65cd968,1,GitHub,2020-03-10 10:13:40-07:00,['fc9d91a6323baf4b79177db14f7f9af50e3c87a3'],31,67,98,2111865,5,0.807692308,0.923076923,0.884615385,4848
97fc6a52216a3da1c76771ddc37e25fed102551c,0,GitHub,2020-03-10 12:30:58-07:00,['33f6e1a1cd4c38728112ca697bb04293d65cd968'],37,96,133,2111998,2,1,1,1,4848
b0fd308b2bb8b199811b1d37e4582c2898093e54,0,GitHub,2020-03-10 14:19:33-07:00,['97fc6a52216a3da1c76771ddc37e25fed102551c'],24,75,99,2112097,3,1,1,1,4848
71113b4aac43a3a6f13625e25171ef8f2233fe7d,1,GitHub,2020-03-10 16:43:07-07:00,['b0fd308b2bb8b199811b1d37e4582c2898093e54'],262,284,546,2112643,32,0,0,0.872340426,4848
d3c7ef251a1ff9dfa94cd462d736a9f6592106dd,1,GitHub,2020-03-11 15:22:44-07:00,['71113b4aac43a3a6f13625e25171ef8f2233fe7d'],18,193,211,2112854,8,0.144578313,0.891566265,0.963855422,4849
f19a79800833acda0379898fd08911c4d96d2c6c,0,GitHub,2020-03-11 15:23:59-07:00,['d3c7ef251a1ff9dfa94cd462d736a9f6592106dd'],5,32,37,2112891,3,0,0.894736842,0.894736842,4849
524182d7f4f5ce274da6cf6cdd2b648095bfe5e9,0,GitHub,2020-03-11 15:25:35-07:00,['f19a79800833acda0379898fd08911c4d96d2c6c'],53,53,106,2112997,10,,,,4849
b526528cafe4142b73df8c930473b0cddc84ca9d,0,GitHub,2020-03-11 15:52:53-07:00,['524182d7f4f5ce274da6cf6cdd2b648095bfe5e9'],3,3,6,2113003,1,,,,4849
8a80d942e65a40f6ee70154de25eff733d6da54e,1,GitHub,2020-03-12 10:44:15+00:00,['b526528cafe4142b73df8c930473b0cddc84ca9d'],2,53,55,2113058,2,0.162790698,0.744186047,0.930232558,4849
0c256e16ab33b58c8306502401e2c992018a1781,0,GitHub,2020-03-12 13:51:33-05:00,['8a80d942e65a40f6ee70154de25eff733d6da54e'],29,108,137,2113195,2,0.892857143,1,0.875,4849
935aa1a3d4025d4d179d18e316b6dfe3b0d596ec,1,GitHub,2020-03-12 16:41:50-07:00,['0c256e16ab33b58c8306502401e2c992018a1781'],6,12,18,2113213,2,0,0.666666667,0,4849
c1901c023191df70d4c97156d8b8544e37245ebb,1,Manikumar Reddy,2020-03-13 06:38:13+05:18,['935aa1a3d4025d4d179d18e316b6dfe3b0d596ec'],10,52,62,2113275,3,0,0.611111111,1,4849
2d2311d75c081745c7a24f7da7c8ec14feddd259,1,GitHub,2020-03-12 22:28:52-07:00,['c1901c023191df70d4c97156d8b8544e37245ebb'],146,245,391,2113666,12,1,0.727272727,1,4849
e3ccf2079463d0be6141d3a86c0499ceba8a3afa,0,Manikumar Reddy,2020-03-13 20:41:29+05:18,['2d2311d75c081745c7a24f7da7c8ec14feddd259'],7,56,63,2113729,3,0.454545455,0.454545455,1,4849
f869e33ab240008050edb9a390892294344f13de,1,GitHub,2020-03-13 17:48:47+00:00,['e3ccf2079463d0be6141d3a86c0499ceba8a3afa'],301,206,507,2114236,13,0,0,0.125,4849
f165cdc325388883541db381c4bdfd30da089b3b,1,GitHub,2020-03-13 18:24:03+00:00,['f869e33ab240008050edb9a390892294344f13de'],17,277,294,2114530,6,0.606666667,0.933333333,0.766666667,4850
454c3cf6171d151a1ecf37d28a800ae254d375ca,0,GitHub,2020-03-13 13:16:45-07:00,['f165cdc325388883541db381c4bdfd30da089b3b'],7,4,11,2114541,4,,,,4850
542853d99b9e0d660a9cf9317be8a3f8fce4c765,1,GitHub,2020-03-13 22:56:59-05:00,['454c3cf6171d151a1ecf37d28a800ae254d375ca'],87,475,562,2115103,10,0.367697595,0.855670103,0.865979381,4850
7945cbc73bec5529c3c6915809379f00f8604a77,1,GitHub,2020-03-13 23:04:14-05:00,['542853d99b9e0d660a9cf9317be8a3f8fce4c765'],7,155,162,2115265,5,0.337837838,1,0.959459459,4851
dd2c6a0a6f70746995fc732dff204df03a57f708,0,GitHub,2020-03-14 11:34:43-07:00,['7945cbc73bec5529c3c6915809379f00f8604a77'],8,0,8,2115273,1,,,,4851
78554e73f66e0cdf7d289e64b4f8b13b68c48acf,1,GitHub,2020-03-14 20:45:50+00:00,['dd2c6a0a6f70746995fc732dff204df03a57f708'],6,78,84,2115357,5,0.847826087,0.847826087,0.913043478,4851
605d55dc173156471fb05c40d715ab318ce74952,1,GitHub,2020-03-14 13:49:08-07:00,['78554e73f66e0cdf7d289e64b4f8b13b68c48acf'],85,160,245,2115602,6,0.193548387,0.225806452,1,4851
227a7322b77840e08924b9486e4bda2f3dfc1f1a,1,GitHub,2020-03-14 23:03:13-07:00,['605d55dc173156471fb05c40d715ab318ce74952'],54,2416,2470,2118072,32,0.453137734,0.837000815,0.93398533,4868
2e6b15813cac75e54dc7b3623d365b6990b77c48,0,GitHub,2020-03-15 10:24:37+00:00,['227a7322b77840e08924b9486e4bda2f3dfc1f1a'],1,1,2,2118074,1,,,,4868
ddd3dfbfae77e789eedbb9a0a32a0f382e194b7f,0,GitHub,2020-03-15 10:46:09+00:00,['2e6b15813cac75e54dc7b3623d365b6990b77c48'],6,8,14,2118088,1,0,0,1,4868
045c6c3c48244c43cf5db2506827c20b01c353c8,1,GitHub,2020-03-15 09:30:40-07:00,['ddd3dfbfae77e789eedbb9a0a32a0f382e194b7f'],8,89,97,2118185,3,0.709090909,0.836363636,0.927272727,4868
31659c3ee1868ec2ae82868e3976836a160440f1,0,GitHub,2020-03-16 08:56:47-07:00,['045c6c3c48244c43cf5db2506827c20b01c353c8'],3,25,28,2118213,4,1,1,1,4868
a0e14078202febbe4df726078a179d66e908fb32,1,GitHub,2020-03-16 09:30:48-07:00,['31659c3ee1868ec2ae82868e3976836a160440f1'],106,375,481,2118694,10,0.213114754,0.918032787,0.680327869,4869
569cf994b0b36c871ca2e575a7f72d069cd409eb,0,GitHub,2020-03-16 14:43:10-07:00,['a0e14078202febbe4df726078a179d66e908fb32'],3,78,81,2118775,2,0.489795918,1,0.857142857,4869
fc79853c4d435af3602cb54e979a617fe218c4eb,0,GitHub,2020-03-16 16:21:45-07:00,['569cf994b0b36c871ca2e575a7f72d069cd409eb'],0,7,7,2118782,1,0,0,1,4869
dffc7f8c30824cb6bf38c05838a466488cbb1f81,0,GitHub,2020-03-16 18:23:21-07:00,['fc79853c4d435af3602cb54e979a617fe218c4eb'],10,4,14,2118796,4,,,,4869
1e6d944813d43f5b0512f10bf3e0818dfcd58ff9,0,GitHub,2020-03-16 21:37:46-07:00,['dffc7f8c30824cb6bf38c05838a466488cbb1f81'],20,34,54,2118850,1,0,1,1,4869
673018504f6653141cc5d1c997a165f0c03d8239,0,GitHub,2020-03-16 21:59:02-07:00,['1e6d944813d43f5b0512f10bf3e0818dfcd58ff9'],51,79,130,2118980,2,1,0.36,1,4869
97156256c733c89cdebac7bac35a17547e4cf28d,0,GitHub,2020-03-17 09:12:40-07:00,['673018504f6653141cc5d1c997a165f0c03d8239'],1,1,2,2118982,1,,,,4869
6a88d32b9fe3cb320088dec72fce30992b89ef28,0,GitHub,2020-03-17 14:40:02-07:00,['97156256c733c89cdebac7bac35a17547e4cf28d'],24,194,218,2119200,2,0,1,1,4869
f08c9c7de6f7b85bddc6c83c0d852b5b3b1f430a,0,GitHub,2020-03-17 22:13:13-07:00,['6a88d32b9fe3cb320088dec72fce30992b89ef28'],4,7,11,2119211,1,0,1,1,4869
d38e97e319b1ca90ce951b8a153fa51953bba43e,1,GitHub,2020-03-17 22:14:00-07:00,['f08c9c7de6f7b85bddc6c83c0d852b5b3b1f430a'],323,186,509,2119720,2,1,0,0.070866142,4869
5fc3cd61fcb73da8b52f34b72fe6bb7457f46ce2,1,GitHub,2020-03-17 23:02:33-07:00,['d38e97e319b1ca90ce951b8a153fa51953bba43e'],15,121,136,2119856,4,0.25,0.25,0.99,4869
da7d1346407a84293755d996fad70bc82adae4a1,0,GitHub,2020-03-18 06:38:36-07:00,['5fc3cd61fcb73da8b52f34b72fe6bb7457f46ce2'],2,1,3,2119859,1,,,,4869
93f082e0939f3d5fc348186893d3cdfc6be4c9eb,0,GitHub,2020-03-18 09:33:14-07:00,['da7d1346407a84293755d996fad70bc82adae4a1'],4,10,14,2119873,5,,,,4869
c0cff61e8cb3fa768d880c017d63335687fa195e,0,Guozhang Wang,2020-03-18 11:31:23-07:00,['93f082e0939f3d5fc348186893d3cdfc6be4c9eb'],8,9,17,2119890,1,,,,4869
34a7ba56a161c066aeacaf88c1ead6109a111d8a,1,GitHub,2020-03-18 12:19:40-07:00,['c0cff61e8cb3fa768d880c017d63335687fa195e'],13,482,495,2120385,2,0.149253731,0.994029851,0.970149254,4869
b586283c53ba235f2194ca4923266ad0653064b4,1,GitHub,2020-03-18 12:25:36-07:00,['34a7ba56a161c066aeacaf88c1ead6109a111d8a'],3,64,67,2120452,2,0,0.545454545,1,4869
b1999ba22dbf83b662591baf64e3d68e0f69e818,0,GitHub,2020-03-18 14:22:53-07:00,['b586283c53ba235f2194ca4923266ad0653064b4'],9,10,19,2120471,1,0,1,1,4869
85c96f523090cce5fd8767c0fd3505ee4885f63d,1,GitHub,2020-03-18 18:37:38-07:00,['b1999ba22dbf83b662591baf64e3d68e0f69e818'],48,172,220,2120691,11,0.614035088,0.98245614,1,4870
c7164a3866ab6a28eb5ae158ff29ac806f4f3d54,0,GitHub,2020-03-19 14:26:41+00:00,['85c96f523090cce5fd8767c0fd3505ee4885f63d'],230,277,507,2121198,6,1,1,1,4872
5c0cf02947b48bab78bd04ee0f298875a7c69e10,0,GitHub,2020-03-19 08:19:51-07:00,['c7164a3866ab6a28eb5ae158ff29ac806f4f3d54'],2,2,4,2121202,1,,,,4872
4f1e8331ff9479e40a1a76f2c9b28a631d51bf80,1,GitHub,2020-03-19 15:26:18+00:00,['5c0cf02947b48bab78bd04ee0f298875a7c69e10'],263,132,395,2121597,12,1,0,0,4872
0174c95f4f82c11f10735c4820ade25f8a37efa1,0,GitHub,2020-03-19 13:12:24-04:00,['4f1e8331ff9479e40a1a76f2c9b28a631d51bf80'],13,12,25,2121622,1,,,,4872
9ee8277cdd4bc02257f5ff6cffd67d823485562d,0,GitHub,2020-03-19 13:19:14-05:00,['0174c95f4f82c11f10735c4820ade25f8a37efa1'],10,219,229,2121851,5,1,1,1,4872
89cd2f2a0b21368297323437fd15ba6341e4707b,1,GitHub,2020-03-19 11:31:51-07:00,['9ee8277cdd4bc02257f5ff6cffd67d823485562d'],706,1467,2173,2124024,23,0.394106814,0.73480663,0.957642726,4873
21cfd0b453c878780236f623249b3b5ddec52e6e,0,GitHub,2020-03-19 14:29:15-07:00,['89cd2f2a0b21368297323437fd15ba6341e4707b'],313,325,638,2124662,33,0,0,0.181818182,4873
11e6aedff624c2d101a63fb6254e05394d4886a0,0,GitHub,2020-03-19 15:50:23-07:00,['21cfd0b453c878780236f623249b3b5ddec52e6e'],1,1,2,2124664,1,,,,4873
c27f629e953025d726f722c15bd18c78f5f6cb66,1,GitHub,2020-03-19 16:49:35-07:00,['11e6aedff624c2d101a63fb6254e05394d4886a0'],28,113,141,2124805,4,0,0.878787879,0.96969697,4873
56051e763965d439f11f20f876475732eed7b307,1,GitHub,2020-03-19 20:44:34-07:00,['c27f629e953025d726f722c15bd18c78f5f6cb66'],2673,3426,6099,2130904,13,0.234899329,0.296979866,0.451342282,4874
24d05aa601e05ec92948364f72e1d5f92998475d,1,GitHub,2020-03-19 23:35:16-07:00,['56051e763965d439f11f20f876475732eed7b307'],42,49,91,2130995,5,0.333333333,1,0,4874
960b2162903dd7d07f20c162aa536b1e67b6477e,1,GitHub,2020-03-20 10:17:51-05:00,['24d05aa601e05ec92948364f72e1d5f92998475d'],34,26,60,2131055,7,1,0.25,0,4874
cbdd0d6cf1c7033dde6cd51f41d52034fd59c59d,0,GitHub,2020-03-20 13:51:24-05:00,['960b2162903dd7d07f20c162aa536b1e67b6477e'],0,1291,1291,2132346,3,0.189245088,1,0.679420889,4877
c249ea8e5d9dad5e74b804a6f062b059517d6a8d,1,GitHub,2020-03-20 15:26:13-07:00,['cbdd0d6cf1c7033dde6cd51f41d52034fd59c59d'],53,252,305,2132651,7,0.18556701,1,0.783505155,4878
406635bcc9f2a4c439d198ea0549170de331323c,0,GitHub,2020-03-20 16:39:17-07:00,['c249ea8e5d9dad5e74b804a6f062b059517d6a8d'],1,1,2,2132653,1,,,,4878
c75dc5e2e09cee4ba47a9b6c484cb225acdb086e,1,GitHub,2020-03-20 21:26:57-07:00,['406635bcc9f2a4c439d198ea0549170de331323c'],20,49,69,2132722,2,0,1,1,4878
635b5fd47c86809401dd8f3c0e9a225526f96555,0,GitHub,2020-03-20 21:34:08-07:00,['c75dc5e2e09cee4ba47a9b6c484cb225acdb086e'],3,24,27,2132749,2,0,1,1,4878
c16938fd960fbc9e209b19b2abb874683a5aedcb,0,GitHub,2020-03-21 09:09:29-07:00,['635b5fd47c86809401dd8f3c0e9a225526f96555'],0,9,9,2132758,1,,,,4878
6cf27c9c771900baf43cc47f9b010dbf7a86fa22,1,GitHub,2020-03-21 13:40:34-05:00,['c16938fd960fbc9e209b19b2abb874683a5aedcb'],244,940,1184,2133942,13,0.379237288,0.936440678,0.813559322,4878
5ccd3cd46d7144ff96271e0b579a612070acc1c4,1,GitHub,2020-03-21 22:00:33-07:00,['6cf27c9c771900baf43cc47f9b010dbf7a86fa22'],1,1,2,2133944,1,,,,4878
4f6907947a95db48876dd331133d349236d5152a,0,GitHub,2020-03-22 10:15:18-07:00,['5ccd3cd46d7144ff96271e0b579a612070acc1c4'],12,32,44,2133988,13,,,,4878
f8173c2df573ae9b53ab7ea6e5d6700acf8e0cf4,1,GitHub,2020-03-22 12:42:45-07:00,['4f6907947a95db48876dd331133d349236d5152a'],2,2,4,2133992,2,,,,4878
8aa1861816e2bdee8884a01b3c0444bd43c09519,0,GitHub,2020-03-22 12:58:21-07:00,['f8173c2df573ae9b53ab7ea6e5d6700acf8e0cf4'],0,1,1,2133993,1,,,,4878
1ad5f346cb88072c419142c86c3d897aad2de996,1,GitHub,2020-03-22 13:50:07-07:00,['8aa1861816e2bdee8884a01b3c0444bd43c09519'],339,1060,1399,2135392,17,0.707048458,0.962555066,0.9030837,4878
afe26e29921578b46364268ea41633c8c86cab2d,0,GitHub,2020-03-22 20:07:21-07:00,['1ad5f346cb88072c419142c86c3d897aad2de996'],1,3,4,2135396,1,,,,4878
6cfed8ad0061cdb2c71df03001cbd485491d6dfa,1,GitHub,2020-03-23 10:07:54-07:00,['afe26e29921578b46364268ea41633c8c86cab2d'],8,20,28,2135424,2,1,1,0,4878
eb7b8295ac8395fead8f8f6d1a6e7b8aef47b684,0,GitHub,2020-03-23 13:17:00-07:00,['6cfed8ad0061cdb2c71df03001cbd485491d6dfa'],1,1,2,2135426,1,,,,4878
f538caf13819c79b37fcdd300d7dacd724180197,1,GitHub,2020-03-23 17:58:14-05:00,['eb7b8295ac8395fead8f8f6d1a6e7b8aef47b684'],53,59,112,2135538,4,0.333333333,0,1,4878
99eb0d10067a95cbb85ba6dd02ad9a8e6a8f1791,0,GitHub,2020-03-23 17:25:19-07:00,['f538caf13819c79b37fcdd300d7dacd724180197'],4,2,6,2135544,1,1,0,0,4878
cc7061410567be3e5f2aae199b67e943409fd215,1,GitHub,2020-03-24 09:26:14-07:00,['99eb0d10067a95cbb85ba6dd02ad9a8e6a8f1791'],9,71,80,2135624,2,0,0.829787234,1,4878
1b36e11967e7a459d6401ba5ea740a659fc1994b,0,GitHub,2020-03-24 10:10:23-07:00,['cc7061410567be3e5f2aae199b67e943409fd215'],7,20,27,2135651,3,1,1,1,4878
4c96b7deba53976ae9fdc961d93e5dc3ce754d72,0,GitHub,2020-03-24 14:27:53-07:00,['1b36e11967e7a459d6401ba5ea740a659fc1994b'],1,7,8,2135659,2,0.8,0.8,1,4878
8012f47e2cb955ddecc3bd58240a84d021ed571c,1,GitHub,2020-03-24 16:28:08-05:00,['4c96b7deba53976ae9fdc961d93e5dc3ce754d72'],149,229,378,2136037,8,1,1,1,4880
1fbddd853da8b36b0c84197ceab936465f0b4f7c,0,GitHub,2020-03-24 17:49:12-05:00,['8012f47e2cb955ddecc3bd58240a84d021ed571c'],0,467,467,2136504,3,0.181229773,0.906148867,0.770226537,4883
a5c257890e843ea7d755aee8ecde2e4e4f89d0ab,1,GitHub,2020-03-24 16:41:58-07:00,['1fbddd853da8b36b0c84197ceab936465f0b4f7c'],7,23,30,2136534,4,1,1,1,4883
b8e508c823517c857c9cfa8a3de77ab374549fde,0,GitHub,2020-03-24 18:45:05-07:00,['a5c257890e843ea7d755aee8ecde2e4e4f89d0ab'],4,30,34,2136568,2,0.75,0.75,1,4883
b5409b9c04d7aa102ab9ca0f8fdea46235da8554,0,GitHub,2020-03-24 20:48:50-07:00,['b8e508c823517c857c9cfa8a3de77ab374549fde'],2,55,57,2136625,2,0,1,1,4884
e1cbefef600ea7186ffb92cf2f13c4c87b7769b3,1,GitHub,2020-03-24 21:46:37-07:00,['b5409b9c04d7aa102ab9ca0f8fdea46235da8554'],1,3,4,2136629,2,0,0,1,4884
ef1cd3490a591d6a2436a847688b317fe3d48344,0,GitHub,2020-03-24 22:16:49-07:00,['e1cbefef600ea7186ffb92cf2f13c4c87b7769b3'],38,135,173,2136802,4,0,1,1,4884
4c9e56b358f00f4938b86f64ef4de17f17516aa2,1,GitHub,2020-03-25 09:31:00-07:00,['ef1cd3490a591d6a2436a847688b317fe3d48344'],0,26,26,2136828,3,,,,4884
befd80b38d3ccb1aa0c6d99a899129fd5cf27774,0,GitHub,2020-03-25 10:31:07-07:00,['4c9e56b358f00f4938b86f64ef4de17f17516aa2'],17,94,111,2136939,8,0.340909091,0.659090909,0.590909091,4884
0f48446690e42b78a9a6b8c6a9bbab9f01d84cb1,1,GitHub,2020-03-25 16:21:27-07:00,['befd80b38d3ccb1aa0c6d99a899129fd5cf27774'],66,111,177,2137116,2,,,,4884
ee0ef09db4e450f3d32cc70b21eeca927820fefe,0,GitHub,2020-03-25 18:48:20-07:00,['0f48446690e42b78a9a6b8c6a9bbab9f01d84cb1'],2,4,6,2137122,1,0,0,0,4884
08759b253121569dcf614c0689d9073512c360c5,1,GitHub,2020-03-25 20:45:42-07:00,['ee0ef09db4e450f3d32cc70b21eeca927820fefe'],6,12,18,2137140,1,1,1,1,4884
8cf781ef0196995ef99d875612b6b7e9adcb912b,1,GitHub,2020-03-25 20:53:42-07:00,['08759b253121569dcf614c0689d9073512c360c5'],211,360,571,2137711,19,0.081081081,1,1,4885
222726d6f97f624711e64487c8e48114aca7526e,1,GitHub,2020-03-26 04:26:51-07:00,['8cf781ef0196995ef99d875612b6b7e9adcb912b'],47,152,199,2137910,8,0.706666667,1,1,4885
3df5464fca06d36b806e50c9d6db047d9d612651,0,GitHub,2020-03-26 11:59:21+00:00,['222726d6f97f624711e64487c8e48114aca7526e'],18,10,28,2137938,8,1,0,0,4885
0b230910662e36337a81b7300c04599e68e97c79,0,GitHub,2020-03-26 15:30:51+00:00,['3df5464fca06d36b806e50c9d6db047d9d612651'],10,63,73,2138011,2,0,1,1,4885
4018f5e8b3314b142810ad882d43ea610bdcc81e,0,GitHub,2020-03-26 09:40:49-07:00,['0b230910662e36337a81b7300c04599e68e97c79'],0,9,9,2138020,1,,,,4885
29697758a4e287d59332ffe97b6f0c1e0d4847ad,0,GitHub,2020-03-26 09:50:18-07:00,['4018f5e8b3314b142810ad882d43ea610bdcc81e'],0,4,4,2138024,1,1,1,1,4885
1ad8b3f829d22f53394a9e6c367111e715565233,0,Manikumar Reddy,2020-03-26 22:28:37+05:18,['29697758a4e287d59332ffe97b6f0c1e0d4847ad'],33,25,58,2138082,1,0.333333333,0,0,4885
932ad614068c3ba2f6dedc71065325df234192a6,1,GitHub,2020-03-26 13:20:25-04:00,['1ad8b3f829d22f53394a9e6c367111e715565233'],1,3,4,2138086,1,0,0,1,4885
008a3b21f6c3670f4030da2280596155e57241b0,0,GitHub,2020-03-26 10:21:11-07:00,['932ad614068c3ba2f6dedc71065325df234192a6'],18,58,76,2138162,2,0.357142857,0.357142857,1,4885
c59835c1d7281863722f5c11b54e6b9c07070304,1,GitHub,2020-03-26 14:53:40-07:00,['008a3b21f6c3670f4030da2280596155e57241b0'],108,146,254,2138416,8,0,0.303030303,1,4885
9d9b59fccc1d3a71758dfb7dc6d2325d4fba9955,1,GitHub,2020-03-26 22:54:08-07:00,['c59835c1d7281863722f5c11b54e6b9c07070304'],114,241,355,2138771,6,0.597826087,0.956521739,0.956521739,4885
3f5ad4640bd7cf373fddcbbfe5ac5596d95c82c0,0,GitHub,2020-03-27 10:50:43-05:00,['9d9b59fccc1d3a71758dfb7dc6d2325d4fba9955'],6,26,32,2138803,2,0,0,1,4885
ee832d7d78009e82a968eed28644bf97a34170e2,0,GitHub,2020-03-27 10:33:40-07:00,['3f5ad4640bd7cf373fddcbbfe5ac5596d95c82c0'],1,15,16,2138819,1,1,1,1,4885
c595470713be1fd2daf93816a5dbf0e245a707a0,1,GitHub,2020-03-27 20:36:10-05:00,['ee832d7d78009e82a968eed28644bf97a34170e2'],81,493,574,2139393,14,0.697916667,1,0.993055556,4886
88bc0fdf822aeadb10f875aecb55322b11854f5a,1,GitHub,2020-03-28 10:55:13-07:00,['c595470713be1fd2daf93816a5dbf0e245a707a0'],27,125,152,2139545,2,0.474358974,0.974358974,0.807692308,4886
68ac551966e2be5b13adb2f703a01211e6f7a34b,0,GitHub,2020-03-28 16:38:12-07:00,['88bc0fdf822aeadb10f875aecb55322b11854f5a'],25,25,50,2139595,6,1,0,0.333333333,4886
43f4372531ff04072545cfb0b959a28d5f109447,0,GitHub,2020-03-28 18:34:07-07:00,['68ac551966e2be5b13adb2f703a01211e6f7a34b'],1,1,2,2139597,1,,,,4886
169fa0efcc9089bdcf37e6f8b1b9a6f3377f38f8,0,GitHub,2020-03-28 21:28:06-07:00,['43f4372531ff04072545cfb0b959a28d5f109447'],2,2,4,2139601,1,,,,4886
923f1ec1cfe98d27154c19dfe4e6014e18c2f094,0,GitHub,2020-03-29 20:28:57-07:00,['169fa0efcc9089bdcf37e6f8b1b9a6f3377f38f8'],6,12,18,2139619,1,,,,4886
c725c2338ba45f7497505a32647d1227b7841e64,0,GitHub,2020-03-30 12:55:35-04:00,['923f1ec1cfe98d27154c19dfe4e6014e18c2f094'],6,7,13,2139632,4,,,,4886
4fa5bdcfe3cd49c96c1902cff82ce286c4eb96df,0,GitHub,2020-03-30 10:41:04-07:00,['c725c2338ba45f7497505a32647d1227b7841e64'],16,16,32,2139664,1,,,,4886
0520bc6c7c787d3a056f1ed27aa45fcc2d61dfdf,0,GitHub,2020-03-30 13:06:54-07:00,['4fa5bdcfe3cd49c96c1902cff82ce286c4eb96df'],2,8,10,2139674,2,,,,4886
2c969b14d358f902ef7037395a4f8a0a2b79a611,0,GitHub,2020-03-30 15:09:27-07:00,['0520bc6c7c787d3a056f1ed27aa45fcc2d61dfdf'],1,28,29,2139703,2,1,1,1,4886
6ad540735037bcc668dd94c65d4203d0e2f63dba,0,GitHub,2020-03-30 15:21:27-07:00,['2c969b14d358f902ef7037395a4f8a0a2b79a611'],48,149,197,2139900,7,0.352941176,0.411764706,1,4886
75e8ee1d1add308095d11bcf6d7ea8c499d92fc9,1,GitHub,2020-03-30 17:47:04-07:00,['6ad540735037bcc668dd94c65d4203d0e2f63dba'],188,163,351,2140251,7,1,0.5,0.6,4886
121c7692cea4dea13ecfe89c85e38a3d6516a9ac,1,GitHub,2020-03-31 16:43:49+01:00,['75e8ee1d1add308095d11bcf6d7ea8c499d92fc9'],7,5,12,2140263,1,1,0.5,0,4886
353aa6206d43b4923d21510797709bbbb210f6b6,0,GitHub,2020-03-31 16:39:28-07:00,['121c7692cea4dea13ecfe89c85e38a3d6516a9ac'],59,247,306,2140569,12,0.291044776,1,0.932835821,4886
c18143298e9d99992c3c435a0c9b70492c5fb58e,0,GitHub,2020-03-31 16:59:25-07:00,['353aa6206d43b4923d21510797709bbbb210f6b6'],0,9,9,2140578,2,0.428571429,0,0.571428571,4886
6a49ede9475a8bb50e85d10a5c1b60179f8a0888,0,GitHub,2020-03-31 20:07:18-07:00,['c18143298e9d99992c3c435a0c9b70492c5fb58e'],48,1,49,2140627,6,1,0,0.05,4886
cb9125106d69f4662df070cb2196341066698a5e,0,GitHub,2020-04-01 08:34:06+05:18,['6a49ede9475a8bb50e85d10a5c1b60179f8a0888'],3,27,30,2140657,2,0.291666667,0,1,4886
90bbeedf52f4b6a411e9630dd132583afa4cd428,1,GitHub,2020-04-01 06:20:48-07:00,['cb9125106d69f4662df070cb2196341066698a5e'],815,780,1595,2142252,259,0,0,0,4886
9eeffdfb7d47a2f25b9b08fc9a2d25b8d1589220,0,GitHub,2020-04-01 17:45:45+01:00,['90bbeedf52f4b6a411e9630dd132583afa4cd428'],0,82,82,2142334,2,1,1,0.838709677,4886
e6a6b69acf009e0b58a5b54384814a17289f3c5e,0,GitHub,2020-04-01 12:42:16-05:00,['9eeffdfb7d47a2f25b9b08fc9a2d25b8d1589220'],59,42,101,2142435,3,1,0,0,4886
fee5f0e50f9fc48ed23993a8f75de748a72a59e6,0,GitHub,2020-04-01 12:35:41-07:00,['e6a6b69acf009e0b58a5b54384814a17289f3c5e'],0,0,0,2142435,1,,,,4886
cc59150f408de6ffea277267ec7d2e3920fbe6b5,1,GitHub,2020-04-01 13:20:27-07:00,['fee5f0e50f9fc48ed23993a8f75de748a72a59e6'],195,561,756,2143191,13,0.632911392,0.658227848,0.932489451,4886
a2092ecd7a94ee390832a1fdcbe67ef7b70a4561,0,Guozhang Wang,2020-04-01 16:16:13-07:00,['cc59150f408de6ffea277267ec7d2e3920fbe6b5'],4,1,5,2143196,1,1,0,0,4886
86a3ebe537e8b2551716939397eff3b425c15fdd,0,GitHub,2020-04-01 17:56:47-07:00,['a2092ecd7a94ee390832a1fdcbe67ef7b70a4561'],1,1,2,2143198,1,,,,4886
f0ad03069a70a9248a44782dddbc42fd0462bb3e,1,GitHub,2020-04-02 23:11:48+05:18,['86a3ebe537e8b2551716939397eff3b425c15fdd'],3,25,28,2143226,4,0.5,0,0.25,4886
2322bc0a6fdf8b26619b6aa9f09355d6c25e6298,1,GitHub,2020-04-02 13:36:03-05:00,['f0ad03069a70a9248a44782dddbc42fd0462bb3e'],513,1706,2219,2145445,15,0.556650246,0.821428571,0.896551724,4888
dfdb49f26aff256ebe28ab55d11604619bfa66b1,0,GitHub,2020-04-02 16:52:56-07:00,['2322bc0a6fdf8b26619b6aa9f09355d6c25e6298'],2,106,108,2145553,3,0.8,1,0.48,4888
6ddbf4d800403de33e08273e92fb0e7159bd9f22,0,GitHub,2020-04-02 19:53:14-07:00,['dfdb49f26aff256ebe28ab55d11604619bfa66b1'],0,4,4,2145557,2,1,1,1,4888
7f640f13b4d486477035c3edb28466734f053beb,1,GitHub,2020-04-02 21:48:37-07:00,['6ddbf4d800403de33e08273e92fb0e7159bd9f22'],576,579,1155,2146712,15,1,0,0,4888
9783b85fdd947fe55fa80c724c8b4ae9a7eb63c3,0,GitHub,2020-04-03 12:04:44-04:00,['7f640f13b4d486477035c3edb28466734f053beb'],5,198,203,2146915,2,0.066666667,0.966666667,1,4888
726a7d5de27dda6968643f1557d3478a436a4a63,0,GitHub,2020-04-03 11:29:34-05:00,['9783b85fdd947fe55fa80c724c8b4ae9a7eb63c3'],0,5,5,2146920,1,0,0,0,4888
9a154c6505954d521b597faeff2d5e61fd802fd7,0,Manikumar Reddy,2020-04-03 22:22:44+05:18,['726a7d5de27dda6968643f1557d3478a436a4a63'],2,52,54,2146974,3,0.75,0,1,4889
62dcfa196e7819f7fb77aa181d96767988cbe908,1,GitHub,2020-04-03 11:51:04-07:00,['9a154c6505954d521b597faeff2d5e61fd802fd7'],42,311,353,2147327,8,0.197309417,1,0.887892377,4889
6e0d553350cef876f4fd2de0e3b8e6e40ce6be44,1,GitHub,2020-04-03 13:53:51-05:00,['62dcfa196e7819f7fb77aa181d96767988cbe908'],1529,1740,3269,2150596,22,0,0,1,4894
8595267260f38254222542ed50972abe4ecf1475,0,GitHub,2020-04-03 13:27:27-07:00,['6e0d553350cef876f4fd2de0e3b8e6e40ce6be44'],0,6,6,2150602,1,,,,4894
d4eb406f01e02f42d433caaa4752c66c9c792076,0,GitHub,2020-04-03 13:56:42-07:00,['8595267260f38254222542ed50972abe4ecf1475'],2,59,61,2150663,2,0,1,1,4894
ab5e4f52ecb072df55c7f5cd8941122a135cdf79,1,GitHub,2020-04-03 19:17:57-07:00,['d4eb406f01e02f42d433caaa4752c66c9c792076'],485,719,1204,2151867,15,0,1,0.830687831,4894
46540eb5e0a7abb32a159250564d42137bd8b99f,0,GitHub,2020-04-04 10:05:51-07:00,['ab5e4f52ecb072df55c7f5cd8941122a135cdf79'],4,45,49,2151916,3,0,0.9,0.9,4894
23b4d875d6306fd2f3dc22fd5f2ef7335239552c,0,GitHub,2020-04-04 10:22:41-07:00,['46540eb5e0a7abb32a159250564d42137bd8b99f'],1,1,2,2151918,1,,,,4894
0eab92012bdba3f4b8b3afafc41fbea751179671,0,GitHub,2020-04-04 11:12:05-07:00,['23b4d875d6306fd2f3dc22fd5f2ef7335239552c'],1,1,2,2151920,1,,,,4894
37990f9099d02b32392b9dded8e715ad3fb0be12,0,GitHub,2020-04-05 14:24:54-07:00,['0eab92012bdba3f4b8b3afafc41fbea751179671'],3,4,7,2151927,1,0,1,1,4894
3b8ed0a194bd1c90917c01ffc659fc05d2683c94,1,GitHub,2020-04-05 22:47:38-07:00,['37990f9099d02b32392b9dded8e715ad3fb0be12'],6,29,35,2151962,1,1,1,1,4894
712ac5203e6ce199bed8804f6173acf33d79a173,1,GitHub,2020-04-05 22:50:26-07:00,['3b8ed0a194bd1c90917c01ffc659fc05d2683c94'],41,69,110,2152072,2,0.272727273,0.909090909,1,4894
82dff1db5486647b27e5297e4c839bd2a905c1d9,1,GitHub,2020-04-06 15:30:29-07:00,['712ac5203e6ce199bed8804f6173acf33d79a173'],170,418,588,2152660,16,0.379807692,0.985576923,0.860576923,4894
588e8a5be83037225716a78358d0203a9e070168,1,GitHub,2020-04-06 17:00:11-07:00,['82dff1db5486647b27e5297e4c839bd2a905c1d9'],1,62,63,2152723,2,0.069767442,0.930232558,1,4894
9d965236a4459ddfaf333203cc4465902247926a,0,GitHub,2020-04-06 17:11:12-07:00,['588e8a5be83037225716a78358d0203a9e070168'],3,4,7,2152730,1,0,1,1,4894
f1850162de9174faab68c6674548dc40fb6a352f,1,GitHub,2020-04-06 20:44:14-07:00,['9d965236a4459ddfaf333203cc4465902247926a'],2,8,10,2152740,2,0,0.666666667,1,4894
731630e8665d111491db48760ee2af5c2dbe1b1b,0,GitHub,2020-04-06 21:22:34-07:00,['f1850162de9174faab68c6674548dc40fb6a352f'],1,9,10,2152750,1,0,1,1,4894
cd1e46c8bb46f1e5303c51f476c74e33b522fce8,1,GitHub,2020-04-07 06:26:18-07:00,['731630e8665d111491db48760ee2af5c2dbe1b1b'],79,184,263,2153013,2,0,0.888888889,0.987654321,4894
29e08fd2c2d3349ba5cbd8fe5a9d35a0cea02b85,0,GitHub,2020-04-07 13:11:02-05:00,['cd1e46c8bb46f1e5303c51f476c74e33b522fce8'],234,184,418,2153431,70,0,0.1,0.4,4894
4c9f5cf7c3217cf802ce233a0093586dcf5a1b7c,0,GitHub,2020-04-07 13:32:16-07:00,['29e08fd2c2d3349ba5cbd8fe5a9d35a0cea02b85'],9,10,19,2153450,1,0,1,1,4894
94ef25ab9128030de8692b6e690787ec8012830a,1,Guozhang Wang,2020-04-07 20:46:46-07:00,['4c9f5cf7c3217cf802ce233a0093586dcf5a1b7c'],85,183,268,2153718,8,0.227272727,1,0.772727273,4894
833dc7725c8990f02edb4ed7e4ddb37c1e25ca37,0,GitHub,2020-04-08 13:00:03+01:00,['94ef25ab9128030de8692b6e690787ec8012830a'],1,1,2,2153720,1,,,,4894
9ba49b806ad0dcdb72a3a80393175a143f181382,0,GitHub,2020-04-08 15:20:32+01:00,['833dc7725c8990f02edb4ed7e4ddb37c1e25ca37'],191,493,684,2154404,11,0.984615385,0.969230769,0.946153846,4895
98ea773a22f84eb21c318fa1da78d2e6b323e8de,1,GitHub,2020-04-08 13:02:30-05:00,['9ba49b806ad0dcdb72a3a80393175a143f181382'],79,400,479,2154883,8,0.200819672,0.454918033,0.844262295,4895
778b1e3f5435c5b98fb52a4e15fc32d5cfa2c92c,0,GitHub,2020-04-08 11:31:27-07:00,['98ea773a22f84eb21c318fa1da78d2e6b323e8de'],3,39,42,2154925,2,0.038461538,0.961538462,1,4895
ed3a7157e0d1ecfddf5a0cd9d839635cc78f3e60,0,GitHub,2020-04-08 20:08:40-05:00,['778b1e3f5435c5b98fb52a4e15fc32d5cfa2c92c'],140,362,502,2155427,10,0.360248447,0.937888199,0.906832298,4895
0fad944ca777e788e21ff577a1f1ab3b5a7f1266,1,GitHub,2020-04-08 23:46:45-07:00,['ed3a7157e0d1ecfddf5a0cd9d839635cc78f3e60'],2,2,4,2155431,2,,,,4895
c84e6ab491f5344554333c6ce021a4564e9dc64b,1,GitHub,2020-04-09 14:59:25+01:00,['0fad944ca777e788e21ff577a1f1ab3b5a7f1266'],186,94,280,2155711,6,1,0.055555556,0.277777778,4895
371ad143a6bb973927c89c0788d048a17ebac91a,0,GitHub,2020-04-09 15:24:44+01:00,['c84e6ab491f5344554333c6ce021a4564e9dc64b'],1,1,2,2155713,1,,,,4895
179be72e3003183b0472a888f5f2396423bb031d,0,GitHub,2020-04-09 10:22:23-07:00,['371ad143a6bb973927c89c0788d048a17ebac91a'],1,1,2,2155715,1,,,,4895
73ec7304b9e13cf4b9da05f215bd356a84efe0e7,1,GitHub,2020-04-09 10:57:10-07:00,['179be72e3003183b0472a888f5f2396423bb031d'],47,73,120,2155835,7,1,1,1,4895
bf6dffe93bbe0fe33ad076ebccebb840d66b936d,1,GitHub,2020-04-09 13:11:36-07:00,['73ec7304b9e13cf4b9da05f215bd356a84efe0e7'],55,699,754,2156589,11,0.157786885,0.491803279,0.731557377,4896
0470e2bc9585acb64eb19a64c4099e495890d355,0,GitHub,2020-04-09 17:28:44-05:00,['bf6dffe93bbe0fe33ad076ebccebb840d66b936d'],1,4,5,2156594,1,0,1,1,4896
e131a9963484e46f45a7302267507ed54dab6871,1,GitHub,2020-04-09 16:52:41-07:00,['0470e2bc9585acb64eb19a64c4099e495890d355'],219,1986,2205,2158799,30,0.305447471,0.9192607,0.861867704,4903
6b6afce60fc481db104a09c51b4f6935c16662cc,0,GitHub,2020-04-09 22:17:35-04:00,['e131a9963484e46f45a7302267507ed54dab6871'],2,2,4,2158803,1,,,,4903
b02bdd3227f08eef78080ef471c0950a4f77e5fb,1,GitHub,2020-04-09 20:15:43-07:00,['6b6afce60fc481db104a09c51b4f6935c16662cc'],25,32,57,2158860,1,0,1,1,4903
ea1e634664197c89a0e98e4f5717933ef8499109,0,GitHub,2020-04-10 13:42:54-05:00,['b02bdd3227f08eef78080ef471c0950a4f77e5fb'],30,195,225,2159085,4,0,0.884297521,0.975206612,4903
20e4a74c3579837df7b46ce1a5dcea37b6e1e452,1,GitHub,2020-04-10 11:55:01-07:00,['ea1e634664197c89a0e98e4f5717933ef8499109'],56,60,116,2159201,10,0,0.142857143,0,4903
a276c546375994300dcd4d257993cd4c75ec4e3b,1,GitHub,2020-04-10 13:15:05-07:00,['20e4a74c3579837df7b46ce1a5dcea37b6e1e452'],21,159,180,2159381,7,0.28125,0.520833333,0.635416667,4903
e032a360708cec2284f714e4cae388066064d61c,0,GitHub,2020-04-10 16:48:29-07:00,['a276c546375994300dcd4d257993cd4c75ec4e3b'],30,44,74,2159455,6,1,1,0.333333333,4903
430e00ea95da959d6d8308dd49c4ed1cdffa7914,0,GitHub,2020-04-11 12:54:53+01:00,['e032a360708cec2284f714e4cae388066064d61c'],160,116,276,2159731,11,0,0,0.55,4903
37f20c6924bc2b2d861508cdb79b78152cc01b60,1,GitHub,2020-04-13 15:01:19-07:00,['430e00ea95da959d6d8308dd49c4ed1cdffa7914'],32,88,120,2159851,3,0.225,1,1,4903
6216c886de1fcfdc404620d13baae3863fb9d2d0,0,GitHub,2020-04-13 17:09:12-07:00,['37f20c6924bc2b2d861508cdb79b78152cc01b60'],10,2,12,2159863,1,1,1,0,4903
799183b3f8d5e8d4c955e7d3ce654b97f8309aad,1,GitHub,2020-04-13 17:20:01-07:00,['6216c886de1fcfdc404620d13baae3863fb9d2d0'],1,57,58,2159921,2,0,0.976190476,1,4903
ea47a885b1fe47dfb87c1dc86db1b0e7eb8a273c,0,GitHub,2020-04-14 09:49:03-07:00,['799183b3f8d5e8d4c955e7d3ce654b97f8309aad'],1344,0,1344,2161265,5,0.642857143,0.250673854,0.363881402,4903
7c7d55dbd8d42f6378d13ba02d62633366a7ede8,1,GitHub,2020-04-14 11:39:56-07:00,['ea47a885b1fe47dfb87c1dc86db1b0e7eb8a273c'],224,1065,1289,2162554,20,0.087289433,0.69525268,0.80704441,4903
cadb3499ff7bc0704680f2d48dea1ed0602df6c0,0,GitHub,2020-04-14 16:36:52-07:00,['7c7d55dbd8d42f6378d13ba02d62633366a7ede8'],2,2,4,2162558,2,,,,4903
742f9281d9a747c35dfa2c3cfbd0a6b19f326508,0,GitHub,2020-04-14 18:18:02-07:00,['cadb3499ff7bc0704680f2d48dea1ed0602df6c0'],12,12,24,2162582,1,0,0,0,4903
60684cbeaac6a68a4fc7d63df09a15b0f4083d67,0,Gwen Shapira,2020-04-14 22:08:47-07:00,['742f9281d9a747c35dfa2c3cfbd0a6b19f326508'],1,1,2,2162584,1,,,,4903
b8c292c36187d3feda8ae0ce22d58604115b8507,0,GitHub,2020-04-14 22:27:50-07:00,['60684cbeaac6a68a4fc7d63df09a15b0f4083d67'],14,56,70,2162654,4,0,1,0.92,4903
8820055744b9de09de68b65216a46be4cf658712,0,GitHub,2020-04-15 13:04:11+01:00,['b8c292c36187d3feda8ae0ce22d58604115b8507'],2,7,9,2162663,1,1,1,0,4903
7da13024b4b42c7fe1e82792a5d85c77d4e93037,0,Gwen Shapira,2020-04-15 08:31:09-07:00,['8820055744b9de09de68b65216a46be4cf658712'],4,10,14,2162677,2,1,1,1,4903
4ac2ad3a2bea9db1e4835a9dffc4b029dc1d9fcd,1,GitHub,2020-04-15 09:24:30-07:00,['7da13024b4b42c7fe1e82792a5d85c77d4e93037'],16,12,28,2162705,4,1,0,0.5,4903
0a5097323bce270440697201d359bc67bf646f28,1,GitHub,2020-04-15 09:30:44-07:00,['4ac2ad3a2bea9db1e4835a9dffc4b029dc1d9fcd'],11,18,29,2162734,2,1,1,1,4903
bd427346a4f3355e45e302b0f3ca89878fdafffe,0,GitHub,2020-04-15 09:50:37-07:00,['0a5097323bce270440697201d359bc67bf646f28'],20,20,40,2162774,1,,,,4903
17f98792617a6de39cbd0d651a03fc40a06e0ff6,1,GitHub,2020-04-15 13:13:23-07:00,['bd427346a4f3355e45e302b0f3ca89878fdafffe'],273,466,739,2163513,13,0,0.836065574,1,4903
1263576b6060fc457996137819302d14c6714803,0,GitHub,2020-04-15 16:29:35-04:00,['17f98792617a6de39cbd0d651a03fc40a06e0ff6'],0,6,6,2163519,1,,,,4903
640be46ef5555d6e957589ab8cb67cc31fb5a4b9,1,GitHub,2020-04-15 14:17:47-07:00,['1263576b6060fc457996137819302d14c6714803'],68,98,166,2163685,6,1,1,1,4903
f646c9c0bc1ed7d2c57dc72a9a290f29b1e6757c,0,GitHub,2020-04-15 14:23:15-07:00,['640be46ef5555d6e957589ab8cb67cc31fb5a4b9'],5,66,71,2163756,2,0.076923077,1,1,4903
f7d2b1baf7745b0f505edd186e1731cc5c9f382c,0,GitHub,2020-04-15 15:50:39-07:00,['f646c9c0bc1ed7d2c57dc72a9a290f29b1e6757c'],0,48,48,2163804,2,0.487179487,0.743589744,1,4903
df41713d64b4c71e95f7153edc879d7eb213b1d5,0,GitHub,2020-04-15 15:59:03-07:00,['f7d2b1baf7745b0f505edd186e1731cc5c9f382c'],13,123,136,2163940,18,0,1,1,4904
c85fd07bd161c9a4fd531fcb633e62c25db1f660,0,Jiangjie (Becket) Qin,2020-04-16 08:01:10+08:00,['df41713d64b4c71e95f7153edc879d7eb213b1d5'],1,4,5,2163945,1,0,0,1,4904
413c4b55b56838cf5ec8d0e0fa758a955f84404e,1,GitHub,2020-04-15 17:18:30-07:00,['c85fd07bd161c9a4fd531fcb633e62c25db1f660'],6,188,194,2164139,2,0.415929204,0.743362832,1,4905
93123720fcd34d61a80c5a255808cd103b35f337,0,GitHub,2020-04-16 13:26:30+01:00,['413c4b55b56838cf5ec8d0e0fa758a955f84404e'],4,123,127,2164266,4,0.560606061,1,1,4905
03f812aa4a9e0856b0068336fc194759156d2521,0,GitHub,2020-04-16 09:00:12-04:00,['93123720fcd34d61a80c5a255808cd103b35f337'],0,2,2,2164268,1,,,,4905
0e46dd4a1d4a71b94efc8163b82cbcad1e2a4787,0,GitHub,2020-04-16 06:00:38-07:00,['03f812aa4a9e0856b0068336fc194759156d2521'],8,11,19,2164287,1,0,0,0,4905
9a36d9f913e3474a3c4c83e91699759c5fa848a2,1,GitHub,2020-04-16 17:14:02+01:00,['0e46dd4a1d4a71b94efc8163b82cbcad1e2a4787'],78,164,242,2164529,3,0.820895522,1,0.71641791,4905
a0119aa859ba37f7ed1a2a7c3c00b00672986914,0,Guozhang Wang,2020-04-16 14:21:36-07:00,['9a36d9f913e3474a3c4c83e91699759c5fa848a2'],1,1,2,2164531,1,,,,4905
770b095e917b8976b9ba67de3aad052ea5cd2606,0,GitHub,2020-04-17 07:49:50-07:00,['a0119aa859ba37f7ed1a2a7c3c00b00672986914'],1,7,8,2164539,2,1,1,1,4905
cc4e3aa30207679f70f41abd2ca2c79a5d91ca9d,1,GitHub,2020-04-17 11:25:51-04:00,['770b095e917b8976b9ba67de3aad052ea5cd2606'],38,38,76,2164615,1,,,,4905
00a59b392d92b0d6d3a321ef9a53dae4b3a9d030,0,GitHub,2020-04-17 09:29:35-07:00,['cc4e3aa30207679f70f41abd2ca2c79a5d91ca9d'],0,83,83,2164698,1,0.178082192,0.178082192,0.904109589,4905
a0173ec45d83a38512c724b801d8c176c1f510db,0,GitHub,2020-04-17 10:49:40-07:00,['00a59b392d92b0d6d3a321ef9a53dae4b3a9d030'],43,43,86,2164784,3,0,,,4905
0f8dc1fcd720fbb7eb6152ef40ecaafdd6b04e15,1,GitHub,2020-04-17 16:03:39-05:00,['a0173ec45d83a38512c724b801d8c176c1f510db'],19,494,513,2165297,3,0.346938776,0.597667638,0.7696793,4906
851b45c842a9d35c8299f87725b52b1b6523271e,0,GitHub,2020-04-17 14:22:30-07:00,['0f8dc1fcd720fbb7eb6152ef40ecaafdd6b04e15'],12,17,29,2165326,3,0,0,0,4906
ecde596180975f8546c0e8e10f77f7eee5f1c4d8,0,GitHub,2020-04-17 14:40:02-07:00,['851b45c842a9d35c8299f87725b52b1b6523271e'],1,1,2,2165328,1,,,,4906
6ea3eedfd8c74d40157d6e489408d871e172ba34,0,GitHub,2020-04-18 13:01:16-07:00,['ecde596180975f8546c0e8e10f77f7eee5f1c4d8'],75,47,122,2165450,2,0.19047619,0,0,4906
cfea096a8dc0036c0993d9be7948298a5f8f0001,0,GitHub,2020-04-19 12:32:25-07:00,['6ea3eedfd8c74d40157d6e489408d871e172ba34'],2,2,4,2165454,2,0,1,1,4906
d6da0452b6b14be81076d82a257381d42c515e08,0,GitHub,2020-04-19 19:24:21-07:00,['cfea096a8dc0036c0993d9be7948298a5f8f0001'],115,59,174,2165628,7,,,,4907
101eca624abbd7005bda83ea7a3e6af494e3cfd8,0,GitHub,2020-04-20 20:10:37+05:18,['d6da0452b6b14be81076d82a257381d42c515e08'],0,22,22,2165650,1,,,,4908
fcf45e1fac88238b1d3dbcfa1f324674939706f3,0,GitHub,2020-04-20 11:00:58-07:00,['101eca624abbd7005bda83ea7a3e6af494e3cfd8'],147,57,204,2165854,2,0.75,0,0.1625,4908
065415e5244b7ca3a01c3840a55be8b41222c1a5,0,GitHub,2020-04-20 13:55:20-07:00,['fcf45e1fac88238b1d3dbcfa1f324674939706f3'],14,19,33,2165887,4,,,,4908
dff2192cfaf747d56d821645a8d45e8ac8ac08d5,0,GitHub,2020-04-20 14:42:59-07:00,['065415e5244b7ca3a01c3840a55be8b41222c1a5'],0,4,4,2165891,1,,,,4908
60b912cd160992ea2d391e6d03fb8dc57b8e1d1c,1,GitHub,2020-04-20 19:50:42-07:00,['dff2192cfaf747d56d821645a8d45e8ac8ac08d5'],23,4,27,2165918,1,0,0,0,4908
e406d9dcd6b3e65963eb71cb8f6c5c989bf42700,0,GitHub,2020-04-20 23:52:57-07:00,['60b912cd160992ea2d391e6d03fb8dc57b8e1d1c'],1,1,2,2165920,1,,,,4908
11d8ef76ff5348a48eb1c37cddf244e399666d59,1,GitHub,2020-04-21 09:25:45-07:00,['e406d9dcd6b3e65963eb71cb8f6c5c989bf42700'],711,999,1710,2167630,42,0,0.996323529,1,4908
7004fc22db1002497a4b0b4130e8aceba309c668,1,GitHub,2020-04-21 14:42:08-05:00,['11d8ef76ff5348a48eb1c37cddf244e399666d59'],3,5,8,2167638,1,,,,4908
5c548e5dfc223371f3109de14eddf0918b8dcad2,1,GitHub,2020-04-21 17:09:59-05:00,['7004fc22db1002497a4b0b4130e8aceba309c668'],1970,649,2619,2170257,15,0.874889086,0.088731145,0.260869565,4911
a91b06708bcba09ac77ad5d5f57e938bb35a0fc7,1,GitHub,2020-04-22 13:42:35-07:00,['5c548e5dfc223371f3109de14eddf0918b8dcad2'],32,32,64,2170321,3,,,,4911
fbd8cf0d861dec5b7bac237e8221cfae51bec14a,1,GitHub,2020-04-22 14:29:23-07:00,['a91b06708bcba09ac77ad5d5f57e938bb35a0fc7'],209,261,470,2170791,24,0,1,1,4911
8429310cdba3c76cd41cf80ee013be96cf1c0e07,0,GitHub,2020-04-22 23:26:33-07:00,['fbd8cf0d861dec5b7bac237e8221cfae51bec14a'],125,96,221,2171012,38,0,0,0,4911
b161358998cdb6cee1ec184621836fa035fa16c6,0,GitHub,2020-04-23 00:15:43-07:00,['8429310cdba3c76cd41cf80ee013be96cf1c0e07'],2,13,15,2171027,1,1,1,0.857142857,4911
039774038c7d245cb62186ce3de65c24733bf331,0,GitHub,2020-04-23 00:19:08-07:00,['b161358998cdb6cee1ec184621836fa035fa16c6'],2,2,4,2171031,1,,,,4911
c5ae154a3fdcf20d388405361da37feed0c64ad9,0,GitHub,2020-04-23 00:44:03-07:00,['039774038c7d245cb62186ce3de65c24733bf331'],23,75,98,2171129,30,0.346153846,1,1,4911
402f2c1ece929dec3a89647a3ac1a044015d772b,0,GitHub,2020-04-23 10:44:36+01:00,['c5ae154a3fdcf20d388405361da37feed0c64ad9'],8,8,16,2171145,1,,,,4911
dbe618c63c2dab4115a45dd9503b23c14bc481b0,0,GitHub,2020-04-23 07:02:54-07:00,['402f2c1ece929dec3a89647a3ac1a044015d772b'],8,8,16,2171161,6,,,,4911
2ecdca2814e232e038909c562fbfd667935ab69e,0,GitHub,2020-04-23 13:37:45-05:00,['dbe618c63c2dab4115a45dd9503b23c14bc481b0'],1,25,26,2171187,2,0.666666667,0.666666667,0.666666667,4911
5c0fd36ee53052fa8a92dac1266fee3aaf16d7a1,1,GitHub,2020-04-23 12:25:02-07:00,['2ecdca2814e232e038909c562fbfd667935ab69e'],63,447,510,2171697,8,0.192156863,0.941176471,1,4911
85e81d48c81a11f8e32a734703c2103c655a4cc9,1,GitHub,2020-04-23 13:37:19-07:00,['5c0fd36ee53052fa8a92dac1266fee3aaf16d7a1'],14,51,65,2171762,3,0.291666667,1,1,4911
1d55127d976c1c3db119fc13ce88128f13522713,0,GitHub,2020-04-23 21:11:42-07:00,['85e81d48c81a11f8e32a734703c2103c655a4cc9'],45,87,132,2171894,4,0.793103448,0.206896552,0.793103448,4911
f3c8bff311b0e4c4d0e316ac949fe4491f9b107f,1,GitHub,2020-04-23 21:39:11-07:00,['1d55127d976c1c3db119fc13ce88128f13522713'],390,459,849,2172743,12,1,1,0,4913
62b2eac4e1a97e6d77bc57f9100bf22a2f364178,0,GitHub,2020-04-24 15:24:14+01:00,['f3c8bff311b0e4c4d0e316ac949fe4491f9b107f'],6,9,15,2172758,2,,,,4913
362d199dbe1a36f32fe6192fa8a2be1611a1f292,0,GitHub,2020-04-24 08:49:47-07:00,['62b2eac4e1a97e6d77bc57f9100bf22a2f364178'],2,2,4,2172762,2,,,,4913
99b8b51f1ecc7fb92f3d7c48709b20133cf15bb2,0,GitHub,2020-04-24 19:18:00-07:00,['362d199dbe1a36f32fe6192fa8a2be1611a1f292'],82,0,82,2172844,1,0.666666667,0,0.666666667,4913
cfc34cace523e6d9698a892b9ec7ba4af33d00ea,0,GitHub,2020-04-25 13:54:59-07:00,['99b8b51f1ecc7fb92f3d7c48709b20133cf15bb2'],5,23,28,2172872,3,1,1,1,4913
d63eaaaa0181bb7b9b4f5ed088abc00d7b32aeb0,0,GitHub,2020-04-25 19:31:41-07:00,['cfc34cace523e6d9698a892b9ec7ba4af33d00ea'],5,61,66,2172938,4,0,1,1,4914
2ca19cf603d457b0ec25e5e0f4769560b4c52d6d,0,Manikumar Reddy,2020-04-27 23:28:34+05:18,['d63eaaaa0181bb7b9b4f5ed088abc00d7b32aeb0'],11,109,120,2173058,3,0.351351351,0.959459459,1,4914
bd17085ec10c767bc82e6b19a3016cf5d50dad92,0,GitHub,2020-04-27 12:41:30-07:00,['2ca19cf603d457b0ec25e5e0f4769560b4c52d6d'],22,206,228,2173286,3,0.324840764,1,0.159235669,4914
db9e55a50f93d82e4aad5e4f82a13fac0e93759e,0,GitHub,2020-04-27 13:51:10-07:00,['bd17085ec10c767bc82e6b19a3016cf5d50dad92'],3,14,17,2173303,2,0.818181818,0.818181818,1,4914
c5d13dcb6ca2a7564cb5b707941b7c68d3de9289,0,GitHub,2020-04-27 14:43:29-07:00,['db9e55a50f93d82e4aad5e4f82a13fac0e93759e'],4,234,238,2173541,3,0.088235294,0.926470588,1,4914
88eae49a8df710f86cd43bcf74c7346a2b33edbb,0,GitHub,2020-04-27 18:22:00-05:00,['c5d13dcb6ca2a7564cb5b707941b7c68d3de9289'],0,4,4,2173545,1,,,,4914
2eb0ccfa46d1cca248c3b5e1c653d097b2c4a58d,0,GitHub,2020-04-27 17:16:41-07:00,['88eae49a8df710f86cd43bcf74c7346a2b33edbb'],4,2,6,2173551,1,1,0,0,4914
9886d6799900f4db88b938a1710010e74ba96ba1,0,GitHub,2020-04-27 23:10:08-07:00,['2eb0ccfa46d1cca248c3b5e1c653d097b2c4a58d'],2,2,4,2173555,1,,,,4914
2bc87de08ee5580f942648077d8703bc9bde22ac,0,GitHub,2020-04-27 23:25:46-07:00,['9886d6799900f4db88b938a1710010e74ba96ba1'],1,1,2,2173557,1,,,,4914
77ac06f3f1921d118b9854ee7b8a4d3b58e832a4,0,GitHub,2020-04-28 09:12:00-07:00,['2bc87de08ee5580f942648077d8703bc9bde22ac'],1,1,2,2173559,1,,,,4914
6a5946282cbc6b24b185a1a1297110198fd9e97c,0,GitHub,2020-04-28 11:33:41-07:00,['77ac06f3f1921d118b9854ee7b8a4d3b58e832a4'],3,40,43,2173602,4,0.789473684,1,1,4914
57961c33deb7a1c01942473b755f16376ea2da6a,0,GitHub,2020-04-28 12:10:03-07:00,['6a5946282cbc6b24b185a1a1297110198fd9e97c'],1,1,2,2173604,1,,,,4914
5bb3415c77cc61b7d1591ccfe028d10bbf9f2a7a,1,GitHub,2020-04-28 15:57:11-05:00,['57961c33deb7a1c01942473b755f16376ea2da6a'],701,1233,1934,2175538,25,0.488479263,0.866359447,0.884792627,4917
f7edf46a5e5c30310542c00eb2d771bd72f42fd3,1,GitHub,2020-04-28 14:44:11-07:00,['5bb3415c77cc61b7d1591ccfe028d10bbf9f2a7a'],12,98,110,2175648,3,0,0.93220339,1,4917
11fc953c05eb2c8db61c61bc765aa8be0598d638,1,GitHub,2020-04-28 15:04:19-07:00,['f7edf46a5e5c30310542c00eb2d771bd72f42fd3'],269,262,531,2176179,9,1,0,0,4917
4e1d6a3d0432ad05e3a4f703c45c4a6cd5b53ca4,0,Gwen Shapira,2020-04-28 18:01:24-07:00,['11fc953c05eb2c8db61c61bc765aa8be0598d638'],6,15,21,2176200,1,0,1,0,4917
b5de44937768304ba17351e7e742f4258533a150,1,GitHub,2020-04-28 22:34:17-05:00,['4e1d6a3d0432ad05e3a4f703c45c4a6cd5b53ca4'],36,129,165,2176365,5,0.769230769,0.769230769,0.769230769,4917
7907b5a6e921cec3b5fad2a4f84a78a851140755,1,GitHub,2020-04-29 09:24:23-05:00,['b5de44937768304ba17351e7e742f4258533a150'],0,60,60,2176425,2,0,0.98,1,4917
688f2e9c0f1b7a493d16da41d96dc7cd17195502,1,GitHub,2020-04-29 16:17:34-05:00,['7907b5a6e921cec3b5fad2a4f84a78a851140755'],64,118,182,2176607,10,0.03030303,0.727272727,0.787878788,4917
7edbff33946328fafe1fe1138308fc62e3d66ff9,0,GitHub,2020-04-29 14:33:10-07:00,['688f2e9c0f1b7a493d16da41d96dc7cd17195502'],44,50,94,2176701,7,1,0.75,0.75,4917
dc4d439825b2d117707b01c7c64769e700246fc6,0,GitHub,2020-04-29 17:11:49-05:00,['7edbff33946328fafe1fe1138308fc62e3d66ff9'],132,183,315,2177016,25,1,1,0.75,4917
0ee19e87d2b1e5e94323ca8bcac5089bf4b3f1af,1,GitHub,2020-04-29 17:07:01-07:00,['dc4d439825b2d117707b01c7c64769e700246fc6'],3,138,141,2177157,8,0.340909091,1,1,4917
8a8302510929c3dffa4e04000478c3a4c48f6ed6,0,GitHub,2020-04-29 19:31:26-07:00,['0ee19e87d2b1e5e94323ca8bcac5089bf4b3f1af'],30,7,37,2177194,2,,,,4917
322b10964ce71eac81da9e574be7dec59c0fc93d,0,GitHub,2020-04-29 20:09:17-07:00,['8a8302510929c3dffa4e04000478c3a4c48f6ed6'],113,156,269,2177463,15,0.744680851,0.744680851,0,4917
417d9b1801eba46267a1370f88c6c869c1ddbb4d,0,GitHub,2020-04-29 20:25:33-07:00,['322b10964ce71eac81da9e574be7dec59c0fc93d'],1,1,2,2177465,1,,,,4917
cc02dd6e3b937c9a84142e6fea40bee9ac484ab7,0,GitHub,2020-04-29 20:42:13-07:00,['417d9b1801eba46267a1370f88c6c869c1ddbb4d'],3,9,12,2177477,1,0,1,1,4917
07e14e9cc5d9f1999d64fa9e56ed0f00e4b9c9d8,0,GitHub,2020-04-29 22:37:05-07:00,['cc02dd6e3b937c9a84142e6fea40bee9ac484ab7'],6,6,12,2177489,4,,,,4917
e4e28883d49dd724c9d25b8b4fd35114fd43b9e4,0,GitHub,2020-04-29 23:06:21-07:00,['07e14e9cc5d9f1999d64fa9e56ed0f00e4b9c9d8'],3,3,6,2177495,1,,,,4917
c34f3d066ead40d8c0bca0cf92d4226d2d6416c6,0,Manikumar Reddy,2020-04-30 13:39:23+05:18,['e4e28883d49dd724c9d25b8b4fd35114fd43b9e4'],3,3,6,2177501,1,,,,4917
74fdbc42dd7b54df3376149db4c379989ef01fa3,1,GitHub,2020-04-30 08:36:01-07:00,['c34f3d066ead40d8c0bca0cf92d4226d2d6416c6'],1,16,17,2177518,1,,,,4917
f92cc85c9f018f353da69a24d950bc281f721781,1,GitHub,2020-04-30 10:33:10-07:00,['74fdbc42dd7b54df3376149db4c379989ef01fa3'],11,102,113,2177631,6,0.441176471,0.985294118,1,4917
e5217d6cb5eaebaf13bd4e1f98c21ad174d8afb3,1,GitHub,2020-04-30 21:15:00-05:00,['f92cc85c9f018f353da69a24d950bc281f721781'],197,11,208,2177839,5,0.654761905,0.416666667,0.047619048,4917
6bb4bbf8745dab94171562e2fcfd6b0c31adf4d3,0,GitHub,2020-05-01 14:57:52+05:18,['e5217d6cb5eaebaf13bd4e1f98c21ad174d8afb3'],1,1,2,2177841,1,,,,4917
95edaba8615d4ca2d623722eee38eb78fc24d317,0,GitHub,2020-05-01 09:59:08-05:00,['6bb4bbf8745dab94171562e2fcfd6b0c31adf4d3'],116,18,134,2177975,13,1,0.03030303,0.060606061,4917
fd095aaafdd207162cddf293b17f249875b9a532,1,GitHub,2020-05-01 14:26:36-05:00,['95edaba8615d4ca2d623722eee38eb78fc24d317'],192,242,434,2178409,78,1,0.9,0.6,4918
4803c779dec72a733dc8345a812b8affd68a4b54,0,GitHub,2020-05-01 14:43:47-07:00,['fd095aaafdd207162cddf293b17f249875b9a532'],1,1,2,2178411,1,,,,4918
e5a7708f03bee9a2090990c4c55e3a702e77527e,0,GitHub,2020-05-01 15:04:16-07:00,['4803c779dec72a733dc8345a812b8affd68a4b54'],1,1,2,2178413,1,,,,4918
794648aa554b5566268ff3eb650b14610a34091c,1,GitHub,2020-05-01 15:29:49-07:00,['e5a7708f03bee9a2090990c4c55e3a702e77527e'],212,54,266,2178679,3,1,0,0,4918
945356724147549421727eb52a4ac33efa920b2e,1,GitHub,2020-05-01 17:11:26-07:00,['794648aa554b5566268ff3eb650b14610a34091c'],118,197,315,2178994,32,0.6875,0.90625,0.53125,4918
8fd967e10cdfbb6e48ef1f590b8902bbf1080a71,0,GitHub,2020-05-01 17:18:43-07:00,['945356724147549421727eb52a4ac33efa920b2e'],9,3,12,2179006,3,0,0,0,4918
2aecb089afe2f5cdc5d36bc91a3f0e39eb7e9a91,0,GitHub,2020-05-02 19:52:37-07:00,['8fd967e10cdfbb6e48ef1f590b8902bbf1080a71'],5,9,14,2179020,1,0,1,1,4918
efa7c0eb70ad65c957cc241609a0d3d1b38c73c6,0,Gwen Shapira,2020-05-03 14:02:55-07:00,['2aecb089afe2f5cdc5d36bc91a3f0e39eb7e9a91'],0,1,1,2179021,1,,,,4918
34824b7bff64ba387a04466d74ac6bbbd10bf37c,0,GitHub,2020-05-03 18:39:43-07:00,['efa7c0eb70ad65c957cc241609a0d3d1b38c73c6'],5,11,16,2179037,2,0,1,1,4918
b2a5633a2c7e5d6de45a46d406f08a968916ab7f,0,GitHub,2020-05-04 10:25:49-07:00,['34824b7bff64ba387a04466d74ac6bbbd10bf37c'],45,73,118,2179155,6,0.869565217,1,1,4918
7cb1600d6ae7245bfa717fa93502d28f17096ea8,1,GitHub,2020-05-04 14:34:23-07:00,['b2a5633a2c7e5d6de45a46d406f08a968916ab7f'],31,73,104,2179259,6,0.184210526,1,0.763157895,4918
69586fb6049b78747ef61ac2b17f67b568f7817c,0,Guozhang Wang,2020-05-04 17:53:28-07:00,['7cb1600d6ae7245bfa717fa93502d28f17096ea8'],1,1,2,2179261,1,,,,4918
fbfda2c4ad889c731aa52b5214e0521f187f8db6,1,GitHub,2020-05-04 21:38:53-07:00,['69586fb6049b78747ef61ac2b17f67b568f7817c'],73,137,210,2179471,5,0.051282051,0.205128205,1,4918
1daa8f638bfc8034d8499525d569660a050194f8,1,GitHub,2020-05-04 22:45:54-07:00,['fbfda2c4ad889c731aa52b5214e0521f187f8db6'],6,1115,1121,2180592,5,0.238636364,0.277597403,0.948051948,4919
dd3ea214303595020e5c6c54c7ab93cfc53d0262,0,Manikumar Reddy,2020-05-05 13:49:04+05:18,['1daa8f638bfc8034d8499525d569660a050194f8'],4,7,11,2180603,1,0,0,1,4919
ff9995fa029e71f57cd7b04c3bf79ba2fba20184,0,GitHub,2020-05-05 18:25:39-04:00,['dd3ea214303595020e5c6c54c7ab93cfc53d0262'],0,6,6,2180609,1,,,,4919
3b6bf8053097200349ecb143148255e02efd1431,0,GitHub,2020-05-05 18:38:09-07:00,['ff9995fa029e71f57cd7b04c3bf79ba2fba20184'],24,90,114,2180723,2,0,0.824561404,1,4919
1d438033f7f4d7cbdac34e1b57d97b5a647ae4de,0,GitHub,2020-05-05 22:20:29-07:00,['3b6bf8053097200349ecb143148255e02efd1431'],3,9,12,2180735,4,,,,4919
d70dacb54ad894d188e6ed97e0ce61d10110db20,0,GitHub,2020-05-06 12:39:34-07:00,['1d438033f7f4d7cbdac34e1b57d97b5a647ae4de'],22,6,28,2180763,3,0.5,0,0,4919
849b65a13a2587044e965d755c820c78590af51a,1,GitHub,2020-05-06 15:22:58-07:00,['d70dacb54ad894d188e6ed97e0ce61d10110db20'],30,40,70,2180833,3,1,1,0.75,4919
c15cd5cfeb52ce9cd0d40b7d44e442bcd4ab61c1,1,GitHub,2020-05-06 15:30:13-07:00,['849b65a13a2587044e965d755c820c78590af51a'],4,14,18,2180851,3,1,1,1,4919
074ab2ebf6856628219d4c4ee95d57ff69d29bf3,0,GitHub,2020-05-06 16:02:26-07:00,['c15cd5cfeb52ce9cd0d40b7d44e442bcd4ab61c1'],9,128,137,2180988,2,0.411764706,1,1,4920
29dd1148c831ff0007ef3f1df54eee6298da99de,0,GitHub,2020-05-06 18:09:47-07:00,['074ab2ebf6856628219d4c4ee95d57ff69d29bf3'],1,20,21,2181009,2,0,1,1,4920
5203ab0c5d71d7fad16a308c7b2706dc80b4255e,0,GitHub,2020-05-06 21:10:19-07:00,['29dd1148c831ff0007ef3f1df54eee6298da99de'],2,2,4,2181013,2,,,,4920
33bfdacd7ab5afefbc8d494aeab6957b33b1354c,0,GitHub,2020-05-07 07:57:55-07:00,['5203ab0c5d71d7fad16a308c7b2706dc80b4255e'],9,61,70,2181083,2,1,1,1,4920
71397adaff8fb4e9dd126c51cd38110cbd813936,0,GitHub,2020-05-07 12:03:43-07:00,['33bfdacd7ab5afefbc8d494aeab6957b33b1354c'],2,6,8,2181091,2,0.666666667,0.666666667,1,4920
4f61b00fcd49b58e2cc806c0dea86d8ffb14ca20,0,GitHub,2020-05-07 16:21:08-05:00,['71397adaff8fb4e9dd126c51cd38110cbd813936'],41,103,144,2181235,4,1,1,1,4920
c19a3be1984d6d4a6192250fc6255168a0942703,1,GitHub,2020-05-07 21:10:44-05:00,['4f61b00fcd49b58e2cc806c0dea86d8ffb14ca20'],11,9,20,2181255,1,,0,0,4920
611831b051080543d94ef5bea9b3aa02b4992140,1,GitHub,2020-05-07 23:01:11-07:00,['c19a3be1984d6d4a6192250fc6255168a0942703'],165,298,463,2181718,7,0.188976378,0.88976378,0.464566929,4920
133c2ed58ad3c70df75882728213a86013e17e95,0,GitHub,2020-05-07 23:14:17-07:00,['611831b051080543d94ef5bea9b3aa02b4992140'],126,126,252,2181970,8,,,,4920
91efb30dfa8efad84c2644fd1559ce6c0b36da8d,0,GitHub,2020-05-08 15:32:50-07:00,['133c2ed58ad3c70df75882728213a86013e17e95'],1,1,2,2181972,1,,,,4920
5583089df03ac6def37418e6b7c16f4e78ca010d,0,GitHub,2020-05-10 05:54:08-07:00,['91efb30dfa8efad84c2644fd1559ce6c0b36da8d'],20,65,85,2182057,2,0.024390244,0.829268293,1,4920
847ff8f55735568fe879d490af297e047b994f5e,1,GitHub,2020-05-11 07:26:34-07:00,['5583089df03ac6def37418e6b7c16f4e78ca010d'],218,195,413,2182470,58,1,1,0.083333333,4920
fe2742e1b23158ca697cdf00cd027031403f979d,0,GitHub,2020-05-11 12:12:52-07:00,['847ff8f55735568fe879d490af297e047b994f5e'],7,77,84,2182554,3,0.109090909,0.509090909,0.890909091,4920
391ad90112fb2e9a85bf76250d57863bbf33b383,1,GitHub,2020-05-11 13:38:05-07:00,['fe2742e1b23158ca697cdf00cd027031403f979d'],127,294,421,2182975,5,0.115942029,1,1,4920
72d72a974c660db7851c1f053ae4a64dfc913837,0,GitHub,2020-05-11 16:35:02-07:00,['391ad90112fb2e9a85bf76250d57863bbf33b383'],15,44,59,2183034,5,1,0,0.846153846,4920
6d0e722f4d14b48030b34418fb538c75fbad69e8,1,GitHub,2020-05-11 17:03:34-07:00,['72d72a974c660db7851c1f053ae4a64dfc913837'],8,35,43,2183077,1,0,1,1,4920
318063a16ab8b34dcb036d995bf78b941975e8e8,1,GitHub,2020-05-11 19:11:58-07:00,['6d0e722f4d14b48030b34418fb538c75fbad69e8'],15,68,83,2183160,5,,,,4920
035299a55d5b7a7de3feb628018fcd15b9775dbc,0,GitHub,2020-05-12 10:38:23-07:00,['318063a16ab8b34dcb036d995bf78b941975e8e8'],46,0,46,2183206,1,1,0,0,4920
f54cece73e6116566979bcf6a865d803b7c18974,1,GitHub,2020-05-12 13:19:32-05:00,['035299a55d5b7a7de3feb628018fcd15b9775dbc'],33,322,355,2183561,14,0.395121951,0.717073171,0.819512195,4920
81cf3fa5f2391c39e550a19874d50fcf18cdfd34,0,GitHub,2020-05-12 12:06:08-07:00,['f54cece73e6116566979bcf6a865d803b7c18974'],15,85,100,2183661,3,0.48,0.96,0.8,4920
58f7a973149f66b980f99c3f2bd688d70b06b2eb,1,GitHub,2020-05-12 15:57:18-05:00,['81cf3fa5f2391c39e550a19874d50fcf18cdfd34'],109,166,275,2183936,12,0,1,0.340909091,4920
c9dc0cd9cf474794ceee1977542740bcb64e4439,1,GitHub,2020-05-12 15:10:22-07:00,['58f7a973149f66b980f99c3f2bd688d70b06b2eb'],15,58,73,2184009,2,0.228571429,1,0.657142857,4920
778d04d4f94636771cf1765633c53426ae7e1b89,0,GitHub,2020-05-12 15:19:46-07:00,['c9dc0cd9cf474794ceee1977542740bcb64e4439'],109,113,222,2184231,5,1,1,0,4920
9bc96d54f8953d190a1fb6478a0656f049ee3b32,0,GitHub,2020-05-12 16:12:31-07:00,['778d04d4f94636771cf1765633c53426ae7e1b89'],5,5,10,2184241,1,,,,4920
53875bb043c9062078887453a5c09216ae12e89c,1,GitHub,2020-05-13 14:50:10-07:00,['9bc96d54f8953d190a1fb6478a0656f049ee3b32'],160,208,368,2184609,7,0.581395349,0.976744186,1,4920
14e426c9a820f992cc34f67c1f6e885c6e81ca53,1,GitHub,2020-05-13 15:26:50-07:00,['53875bb043c9062078887453a5c09216ae12e89c'],15,137,152,2184761,5,0.138888889,0.490740741,0.981481481,4920
43a9e39983bc3fc2363723b9c555e49b016c1ae2,0,GitHub,2020-05-13 17:35:56-07:00,['14e426c9a820f992cc34f67c1f6e885c6e81ca53'],47,93,140,2184901,4,0.081081081,0.135135135,1,4920
fad8db67bb74d1ebffdde22fd4e8ec6666fd1881,0,GitHub,2020-05-13 17:54:43-07:00,['43a9e39983bc3fc2363723b9c555e49b016c1ae2'],0,9,9,2184910,2,,,,4920
d62f6ebdfe38adf894187e76546eedf13ee98432,1,GitHub,2020-05-14 08:32:08-05:00,['fad8db67bb74d1ebffdde22fd4e8ec6666fd1881'],1583,1427,3010,2187920,23,0.516666667,0.533333333,0,4921
873e9446ef8426061e2f1b6cd21815b270e27f03,0,GitHub,2020-05-14 19:56:13+01:00,['d62f6ebdfe38adf894187e76546eedf13ee98432'],2,93,95,2188015,2,0.379746835,0.379746835,1,4921
4e722021a916a2a4183210dae70e6c95df2b5593,1,GitHub,2020-05-14 15:53:28-05:00,['873e9446ef8426061e2f1b6cd21815b270e27f03'],71,108,179,2188194,7,0.258064516,0,0,4921
f50bd5f80e33598e7fd70290f0c0e809443bc9a0,0,GitHub,2020-05-14 14:18:15-07:00,['4e722021a916a2a4183210dae70e6c95df2b5593'],2,10,12,2188206,2,0,1,1,4921
b558287c0b6cfb8ac11548048ae12ca6b5c63257,1,GitHub,2020-05-14 19:31:49-05:00,['f50bd5f80e33598e7fd70290f0c0e809443bc9a0'],17,88,105,2188311,2,0.13559322,1,1,4921
8d3251e57b8dd70cf13d86722b5a63cd5faf5144,0,GitHub,2020-05-15 08:56:00-07:00,['b558287c0b6cfb8ac11548048ae12ca6b5c63257'],1,1,2,2188313,1,,,,4921
924cee29542129a8ff4b371e43c24890b6a3a510,0,GitHub,2020-05-15 12:14:20-05:00,['8d3251e57b8dd70cf13d86722b5a63cd5faf5144'],1,91,92,2188405,2,0.413793103,0.396551724,1,4921
d534b5d81771148b3b1db2db837ef72c84b2f61d,0,GitHub,2020-05-15 11:27:02-07:00,['924cee29542129a8ff4b371e43c24890b6a3a510'],3,104,107,2188512,3,0.044117647,0.808823529,1,4921
8a0fcd1695253fd4b8bb252576525219e668957e,1,GitHub,2020-05-15 15:28:23-07:00,['d534b5d81771148b3b1db2db837ef72c84b2f61d'],0,24,24,2188536,2,,,,4921
62fa8fc9a95d738780d1f73d2d758d7329828feb,1,GitHub,2020-05-15 17:53:32-07:00,['8a0fcd1695253fd4b8bb252576525219e668957e'],5,102,107,2188643,3,0,1,1,4921
78e18b575c6b4724afe6107371d70c46fb57d3d9,1,GitHub,2020-05-16 10:05:17-07:00,['62fa8fc9a95d738780d1f73d2d758d7329828feb'],8,30,38,2188681,2,0.8,0.8,0,4921
2d37c8c844130987ec49a4d2864d3edbc80e9fcd,0,GitHub,2020-05-17 11:02:53-07:00,['78e18b575c6b4724afe6107371d70c46fb57d3d9'],3,5,8,2188689,3,,,,4921
b72ab51e4d7cfe39094985d7a732618ef57b877f,0,GitHub,2020-05-18 09:30:19-07:00,['2d37c8c844130987ec49a4d2864d3edbc80e9fcd'],17,0,17,2188706,1,,,,4921
f04fd7e9fd36c4d95f97991d1686ccb6f9d140b6,0,GitHub,2020-05-18 12:43:35-07:00,['b72ab51e4d7cfe39094985d7a732618ef57b877f'],1,1,2,2188708,1,,,,4921
1f2ff73b28ddb538c4fda263c31b56368787970d,0,GitHub,2020-05-18 14:18:16-07:00,['f04fd7e9fd36c4d95f97991d1686ccb6f9d140b6'],0,193,193,2188901,3,0.535714286,1,1,4923
392e49b1eddd2fcd8d09177cc80abc8a51f5c991,1,GitHub,2020-05-18 14:50:54-07:00,['1f2ff73b28ddb538c4fda263c31b56368787970d'],932,1020,1952,2190853,37,1,1,0.8125,4925
ad0850659f5d536d43f09221c941022fc273e6d5,0,GitHub,2020-05-18 18:43:45-07:00,['392e49b1eddd2fcd8d09177cc80abc8a51f5c991'],10,46,56,2190909,2,0.290322581,1,1,4925
3ec5e8e652baac0ff10fb4164c545c09163c2d25,1,GitHub,2020-05-19 07:31:06-07:00,['ad0850659f5d536d43f09221c941022fc273e6d5'],24,30,54,2190963,3,,,,4925
82fb6e9473e3cfd0c20faded7cc4b8ddfa166014,1,GitHub,2020-05-19 11:05:55-04:00,['3ec5e8e652baac0ff10fb4164c545c09163c2d25'],8,8,16,2190979,5,,,,4925
af02f76623b11a043b8e0f308bc6ba7e830b6a64,0,GitHub,2020-05-19 13:34:36-05:00,['82fb6e9473e3cfd0c20faded7cc4b8ddfa166014'],4,60,64,2191043,1,0,1,1,4925
c0fa36dde72e1045368ebd519349b57bb3c69332,0,GitHub,2020-05-19 13:38:35-05:00,['af02f76623b11a043b8e0f308bc6ba7e830b6a64'],8,9,17,2191060,1,1,1,1,4925
76e0233c93db0301832a7d22ddbcb58f05319f30,0,GitHub,2020-05-19 14:00:13-07:00,['c0fa36dde72e1045368ebd519349b57bb3c69332'],1,24,25,2191085,2,0,0.909090909,1,4925
7c7d88339bf36a0a4c046f5dfd57e83a35a8e1e1,1,GitHub,2020-05-19 15:02:55-07:00,['76e0233c93db0301832a7d22ddbcb58f05319f30'],4,11,15,2191100,2,0,0,0,4925
affb270bbc0629822857e7558ab96bbe9f1b4582,0,GitHub,2020-05-19 23:53:32-07:00,['7c7d88339bf36a0a4c046f5dfd57e83a35a8e1e1'],7,7,14,2191114,5,,,,4925
67770072da1bd13762af978faaa278c4039167a2,1,GitHub,2020-05-20 10:03:57-07:00,['affb270bbc0629822857e7558ab96bbe9f1b4582'],6,21,27,2191141,2,1,1,1,4925
9a47d7e35fb2849ae58d7443a5b854c37cc34479,1,GitHub,2020-05-20 15:11:15-07:00,['67770072da1bd13762af978faaa278c4039167a2'],5,23,28,2191169,3,0.818181818,1,1,4925
9a18e0e3e8a5e473cc41b122919a3e48b309c42f,0,GitHub,2020-05-21 07:06:26+05:18,['9a47d7e35fb2849ae58d7443a5b854c37cc34479'],1,1,2,2191171,1,,,,4925
59efa12d0c0c098e6f57848bf5a43b459c0563e0,0,GitHub,2020-05-20 20:05:28-07:00,['9a18e0e3e8a5e473cc41b122919a3e48b309c42f'],11,12,23,2191194,1,1,1,1,4925
82f5efabc9249e0accf530a6a82afc2f32e65ec6,0,GitHub,2020-05-20 20:15:43-07:00,['59efa12d0c0c098e6f57848bf5a43b459c0563e0'],1,13,14,2191208,2,0,0.777777778,1,4925
ab4b4d73727e401e5fce46030b80ec70ba927b0c,0,GitHub,2020-05-20 21:14:40-07:00,['82f5efabc9249e0accf530a6a82afc2f32e65ec6'],1,26,27,2191235,2,0,1,1,4925
aa1b3c1107f53638ec2a4a6c2f06a4626545fad3,0,GitHub,2020-05-20 21:24:00-07:00,['ab4b4d73727e401e5fce46030b80ec70ba927b0c'],2,10,12,2191247,1,0.25,0.25,1,4925
d4ffc24a02165824d588349c57cd37edbb09327f,0,GitHub,2020-05-21 10:56:04-05:00,['aa1b3c1107f53638ec2a4a6c2f06a4626545fad3'],3,3,6,2191253,1,,,,4925
f6781f42ff35b7ca597f889f96b28c5b2da62d4a,0,GitHub,2020-05-21 17:21:04+01:00,['d4ffc24a02165824d588349c57cd37edbb09327f'],1,357,358,2191611,2,0.253333333,1,0.871111111,4926
4aa4786a81635475b85441698e9dba870fa630db,0,GitHub,2020-05-21 09:59:32-07:00,['f6781f42ff35b7ca597f889f96b28c5b2da62d4a'],5,20,25,2191636,1,1,1,0,4926
856e36651203b03bf9a6df2f2d85a356644cbce3,0,GitHub,2020-05-21 14:18:09-05:00,['4aa4786a81635475b85441698e9dba870fa630db'],6,10,16,2191652,4,,,,4926
d9e9a18a196bb13fe8406d7110d38bedee3cc262,0,GitHub,2020-05-21 17:50:21-07:00,['856e36651203b03bf9a6df2f2d85a356644cbce3'],7,21,28,2191680,2,1,1,1,4926
27824baa210b9744074ac1fcdabbf1c8ff1b42ca,0,GitHub,2020-05-22 08:41:28-07:00,['d9e9a18a196bb13fe8406d7110d38bedee3cc262'],230,518,748,2192428,25,0.707317073,0.43902439,0.93902439,4928
9fdd87715ed1c725e268caa14d8415d4f1428ebc,1,GitHub,2020-05-22 11:41:15-05:00,['27824baa210b9744074ac1fcdabbf1c8ff1b42ca'],31,212,243,2192671,6,0.1328125,0.6484375,0.4296875,4928
91113749745ca6cd2259de3b42d1e4bf19aec49c,0,GitHub,2020-05-22 11:40:25-07:00,['9fdd87715ed1c725e268caa14d8415d4f1428ebc'],0,11,11,2192682,1,,,,4928
713f305172b64e8cb9e2d5e3047b53a018e0c195,1,GitHub,2020-05-22 11:52:59-07:00,['91113749745ca6cd2259de3b42d1e4bf19aec49c'],22,42,64,2192746,4,1,1,1,4928
ec205171e5fddbae2ebc1784adf73a6732889a49,0,GitHub,2020-05-22 15:35:25-05:00,['713f305172b64e8cb9e2d5e3047b53a018e0c195'],1,125,126,2192872,1,0,1,1,4928
981ef5166d2c95cacb6cdc1d52ed0c866b473868,1,GitHub,2020-05-23 09:00:32-05:00,['ec205171e5fddbae2ebc1784adf73a6732889a49'],49,900,949,2193821,14,0.485454545,0.978181818,0.898181818,4929
40ee580ed23c876dec45eca4770e834d9aed76da,0,GitHub,2020-05-23 15:35:43-07:00,['981ef5166d2c95cacb6cdc1d52ed0c866b473868'],4,11,15,2193836,3,0,1,1,4929
2988eac0822022578bd2c6c5626bfbda3e8c73a6,1,GitHub,2020-05-24 08:56:27-05:00,['40ee580ed23c876dec45eca4770e834d9aed76da'],3,202,205,2194041,6,0.459016393,0.762295082,1,4929
85ed123ac65d7459df5049b75178cf7bcc9c9e79,0,GitHub,2020-05-24 09:09:40-05:00,['2988eac0822022578bd2c6c5626bfbda3e8c73a6'],30,136,166,2194207,4,0,0,0.857142857,4929
9aeb78b99003f39f2d9194c3cc376cabb25ab8b1,0,GitHub,2020-05-24 09:22:40-05:00,['85ed123ac65d7459df5049b75178cf7bcc9c9e79'],69,204,273,2194480,4,1,1,1,4929
5302efb2d1b7a69bcd3173a13b2d08a2666979ed,0,GitHub,2020-05-24 09:35:24-07:00,['9aeb78b99003f39f2d9194c3cc376cabb25ab8b1'],13,17,30,2194510,2,1,1,0.75,4929
45383f75b3b343ac2695f0722b794947ee37098c,0,GitHub,2020-05-24 17:10:43-07:00,['5302efb2d1b7a69bcd3173a13b2d08a2666979ed'],2,19,21,2194531,2,0.875,1,1,4929
3818770d7fcd6ccdd373cdcd3aa6952ea08c901c,1,GitHub,2020-05-24 20:09:54-05:00,['45383f75b3b343ac2695f0722b794947ee37098c'],80,638,718,2195249,12,0.922018349,1,0.931192661,4934
de6468ae5915298279e229dc64721e01e7d14fab,1,GitHub,2020-05-25 09:10:03-07:00,['3818770d7fcd6ccdd373cdcd3aa6952ea08c901c'],8,81,89,2195338,8,0.418604651,1,1,4934
c6adcca95f03758089715c60e806a8090f5422d9,0,GitHub,2020-05-25 21:51:14-07:00,['de6468ae5915298279e229dc64721e01e7d14fab'],1,1,2,2195340,1,,,,4934
c95b45d04f504734224421ce59378c29137290dd,0,GitHub,2020-05-26 13:52:19-07:00,['c6adcca95f03758089715c60e806a8090f5422d9'],37,48,85,2195425,9,,,,4934
4b97e50eea977a2a9020e6ed49516a1904361f12,0,GitHub,2020-05-26 16:24:00-07:00,['c95b45d04f504734224421ce59378c29137290dd'],3,7,10,2195435,2,,,,4934
371f14c3c12d2e341ac96bd52393b43a10acfa84,1,GitHub,2020-05-26 22:07:34-07:00,['4b97e50eea977a2a9020e6ed49516a1904361f12'],456,5654,6110,2201545,33,0.373267327,0.946534653,0.926732673,4943
ac3043cff089b8ae7fdc37cf453d426932c1c738,0,GitHub,2020-05-27 05:50:58-07:00,['371f14c3c12d2e341ac96bd52393b43a10acfa84'],56,4,60,2201605,3,0.928571429,0.404761905,0,4943
33c8774acef27d061df8e001bc150d6c2eea8a2b,0,GitHub,2020-05-27 09:06:00-07:00,['ac3043cff089b8ae7fdc37cf453d426932c1c738'],6,20,26,2201631,1,0,0.071428571,1,4943
99115cba00ae35f19ae4ba8bbd77b471d7e33ac4,1,GitHub,2020-05-27 10:40:41-07:00,['33c8774acef27d061df8e001bc150d6c2eea8a2b'],91,356,447,2202078,9,0.411214953,1,1,4943
075bbcfec40a46c58ba38b58d8a9235e2eb1395d,1,GitHub,2020-05-27 10:57:14-07:00,['99115cba00ae35f19ae4ba8bbd77b471d7e33ac4'],534,1748,2282,2204360,28,0.590529248,0.908077994,0.980501393,4946
2cff1fab3f1c20f464f75f32b6138707050199b5,1,GitHub,2020-05-27 13:50:12-05:00,['075bbcfec40a46c58ba38b58d8a9235e2eb1395d'],63,296,359,2204719,15,0.047169811,0.811320755,0.91509434,4948
cec6202369315d183c410ff7145ae414678b0763,0,GitHub,2020-05-27 11:54:41-07:00,['2cff1fab3f1c20f464f75f32b6138707050199b5'],18,298,316,2205035,3,0.964285714,1,0.964285714,4948
bfc9c9909d7b4ab5d3fd0f0faad1bcfd684f61f9,0,GitHub,2020-05-27 12:24:15-07:00,['cec6202369315d183c410ff7145ae414678b0763'],4,0,4,2205039,1,,,,4948
1672a75e1f04ce3b7cd4fa202942a8887cf811e1,1,GitHub,2020-05-27 16:37:22-04:00,['bfc9c9909d7b4ab5d3fd0f0faad1bcfd684f61f9'],73,243,316,2205355,6,0.173076923,0.990384615,0.961538462,4948
83c616f70694637627edb6b1215738c78b74a50d,1,GitHub,2020-05-27 15:55:29-05:00,['1672a75e1f04ce3b7cd4fa202942a8887cf811e1'],22,470,492,2205847,19,0.118343195,0.825443787,0.568047337,4948
2c1096cb0edb73c052c3517da82deaf3725d13b6,0,GitHub,2020-05-27 14:31:31-07:00,['83c616f70694637627edb6b1215738c78b74a50d'],7,7,14,2205861,7,,,,4948
c66cde029ee275f45605116116c7f773de967393,0,GitHub,2020-05-27 14:33:40-07:00,['2c1096cb0edb73c052c3517da82deaf3725d13b6'],0,2,2,2205863,1,,,,4948
2cbf6be54a364bfc95db00594775941d1fb45041,1,GitHub,2020-05-27 14:41:49-07:00,['c66cde029ee275f45605116116c7f773de967393'],223,56,279,2206142,10,1,0.144927536,0.304347826,4948
9c833f665f349e5c292228f75188f5521282835d,1,GitHub,2020-05-27 20:18:36-05:00,['2cbf6be54a364bfc95db00594775941d1fb45041'],74,870,944,2207086,44,0.535064935,0.987012987,0.888311688,4952
90045f63ea357a0ef3ea11464371e12a942ec5b3,1,GitHub,2020-05-27 18:41:00-07:00,['9c833f665f349e5c292228f75188f5521282835d'],78,302,380,2207466,10,0,0.740740741,0.864197531,4952
2951b6dd99b53db8ef5d261e19b8e6ce0b9a8ed4,0,GitHub,2020-05-27 20:49:57-07:00,['90045f63ea357a0ef3ea11464371e12a942ec5b3'],0,3,3,2207469,1,1,1,0,4952
d9fe30dab0fc56318b012731c348ed1ddae2ec04,1,GitHub,2020-05-27 20:54:09-07:00,['2951b6dd99b53db8ef5d261e19b8e6ce0b9a8ed4'],4,5,9,2207478,3,0,1,0,4952
c22e4508a01ab39aab4929fe763e1200a2e92c36,0,GitHub,2020-05-27 21:03:36-07:00,['d9fe30dab0fc56318b012731c348ed1ddae2ec04'],2,2,4,2207482,1,,,,4952
c89f040d45a688d2dd3d244e176e2acd9f9418ac,0,GitHub,2020-05-27 21:14:55-07:00,['c22e4508a01ab39aab4929fe763e1200a2e92c36'],25,50,75,2207557,3,0.137931034,1,0.310344828,4952
38c1e96d2c2084c7f3c3f9e5309ca91953e7c88f,1,GitHub,2020-05-27 23:49:57-07:00,['c89f040d45a688d2dd3d244e176e2acd9f9418ac'],27,710,737,2208294,25,0.691449814,0.869888476,0.810408922,4957
1c4eb1a5757df611735cfac9b709e0d80d0da4b3,1,GitHub,2020-05-28 08:54:30-05:00,['38c1e96d2c2084c7f3c3f9e5309ca91953e7c88f'],133,1706,1839,2210133,24,0.565452092,1,0.858299595,4967
9e2d4b508d4561ea34f76d1f6d4e8ace69ee4e8a,0,GitHub,2020-05-28 12:52:04-05:00,['1c4eb1a5757df611735cfac9b709e0d80d0da4b3'],2,2,4,2210137,1,,,,4967
ed3c42bd9b89448a60454a5c0b98ccd2908529ab,0,GitHub,2020-05-28 12:56:30-05:00,['9e2d4b508d4561ea34f76d1f6d4e8ace69ee4e8a'],2,2,4,2210141,1,,,,4967
1a35037016accaabea9c790c4c66df59335b5ab7,0,GitHub,2020-05-28 14:41:07-05:00,['ed3c42bd9b89448a60454a5c0b98ccd2908529ab'],1,16,17,2210158,1,0,1,1,4967
2faf7f301f41c3bee15c2bf78d5846f2163175ec,0,GitHub,2020-05-28 18:25:50-05:00,['1a35037016accaabea9c790c4c66df59335b5ab7'],2,2,4,2210162,1,,,,4967
36ca33f9cf1902399afe7494f88c6bbd16022b56,1,GitHub,2020-05-28 18:01:01-07:00,['2faf7f301f41c3bee15c2bf78d5846f2163175ec'],71,34,105,2210267,11,1,0,0.76,4967
1fd195e5c21806d3e597cf666d7132ff829f775c,0,GitHub,2020-05-29 09:32:57+01:00,['36ca33f9cf1902399afe7494f88c6bbd16022b56'],28,188,216,2210483,5,0.348214286,0.991071429,1,4967
aab52485a4f566523cbcffd2dc4a60b1d73f4e9e,0,GitHub,2020-05-29 08:52:19-05:00,['1fd195e5c21806d3e597cf666d7132ff829f775c'],1,1,2,2210485,1,,,,4967
277e4cd3bb7759978256be76f055363f66516d17,0,GitHub,2020-05-29 17:03:49+01:00,['aab52485a4f566523cbcffd2dc4a60b1d73f4e9e'],1,59,60,2210545,3,0.533333333,1,0.733333333,4967
9d52deca247d9e16cf530d655891b2bbe474ffae,1,GitHub,2020-05-29 10:48:03-07:00,['277e4cd3bb7759978256be76f055363f66516d17'],465,1149,1614,2212159,42,0.378021978,0.861538462,0.727472527,4967
fe948d39e54cf2d57e9b9e0e2a203890dc8ce86d,1,GitHub,2020-05-29 11:25:20-07:00,['9d52deca247d9e16cf530d655891b2bbe474ffae'],93,598,691,2212850,22,0.316753927,0.107329843,0.986910995,4967
3b7017671f2ae0ed52ba499f2cb1032344b333cd,0,GitHub,2020-05-29 12:09:09-07:00,['fe948d39e54cf2d57e9b9e0e2a203890dc8ce86d'],18,14,32,2212882,1,0.5,0,0,4967
af3b8b50f2b79b41c1bc3a518942f3df1c5b64f9,1,GitHub,2020-05-29 23:18:50+01:00,['3b7017671f2ae0ed52ba499f2cb1032344b333cd'],34,328,362,2213244,14,0.435483871,0.123655914,0.505376344,4967
07360680138d8cd65fb50757df0e4bf9b3ff6cc3,0,GitHub,2020-05-30 08:13:07-07:00,['af3b8b50f2b79b41c1bc3a518942f3df1c5b64f9'],2,1,3,2213247,1,1,1,1,4967
40b0033eedf823d3bd3c6781cfd871a949c5827e,0,GitHub,2020-05-30 08:58:34-07:00,['07360680138d8cd65fb50757df0e4bf9b3ff6cc3'],2,2,4,2213251,1,,,,4967
d4c1ef4a100857659ff4ff055bb743dc0471560e,0,GitHub,2020-05-31 14:36:27-07:00,['40b0033eedf823d3bd3c6781cfd871a949c5827e'],40,155,195,2213446,5,0.189655172,0.948275862,1,4968
d7ce35d61aaf50ea48790900cde14a444994cbe0,0,GitHub,2020-05-31 14:58:30-07:00,['d4c1ef4a100857659ff4ff055bb743dc0471560e'],1,1,2,2213448,1,,,,4968
36aa3664343ee8a72b27d4ee6b1ccc8ce323d421,0,GitHub,2020-05-31 14:59:40-07:00,['d7ce35d61aaf50ea48790900cde14a444994cbe0'],10,34,44,2213492,2,1,1,1,4968
e2e2c628b9f2368ca253cc00b99f85899afc9cc7,0,GitHub,2020-06-01 07:01:18-07:00,['36aa3664343ee8a72b27d4ee6b1ccc8ce323d421'],28,45,73,2213565,2,0.454545455,0.636363636,1,4968
66fdb59ed0482f430ee59dcbfeccfab75f3cd948,1,GitHub,2020-06-01 16:38:21+01:00,['e2e2c628b9f2368ca253cc00b99f85899afc9cc7'],5,103,108,2213673,3,0.480519481,1,0.571428571,4968
c6633a157eec1712116d294eb3785a96cba4e331,1,GitHub,2020-06-01 15:57:15-07:00,['66fdb59ed0482f430ee59dcbfeccfab75f3cd948'],173,283,456,2214129,5,0.242105263,0,1,4968
88d996f9fae62e48c6b326103f555d08bbd97d4e,0,GitHub,2020-06-01 17:04:34-07:00,['c6633a157eec1712116d294eb3785a96cba4e331'],4,2,6,2214135,2,1,0,0,4968
f0d6e87421b95858b150cab8bc7a2d691f0e0ed9,0,GitHub,2020-06-01 17:17:46-07:00,['88d996f9fae62e48c6b326103f555d08bbd97d4e'],94,0,94,2214229,1,0,0,0,4968
77f123391cc0c4bd2efbddb20a7b4d6d463ca46b,1,GitHub,2020-06-01 17:19:26-07:00,['f0d6e87421b95858b150cab8bc7a2d691f0e0ed9'],1,9,10,2214239,2,,,,4968
ec67788d9d50151f98d6c8ad88d1ce5b7ea173e4,1,GitHub,2020-06-01 18:06:28-07:00,['77f123391cc0c4bd2efbddb20a7b4d6d463ca46b'],22,151,173,2214412,6,0.191489362,0.5,0.946808511,4968
19e40788e7f4f4c5775063f6a70d20cd6cc37ecb,0,GitHub,2020-06-01 21:23:09-05:00,['ec67788d9d50151f98d6c8ad88d1ce5b7ea173e4'],10,10,20,2214432,8,,,,4968
07f66765396bffa7e45edeb141726a9a55ead7e0,1,GitHub,2020-06-01 22:33:22-07:00,['19e40788e7f4f4c5775063f6a70d20cd6cc37ecb'],5,44,49,2214481,3,0.111111111,0.962962963,1,4968
a3d79ff23643d83f9df191522c003fb6335ca80c,0,GitHub,2020-06-02 08:59:56-07:00,['07f66765396bffa7e45edeb141726a9a55ead7e0'],1,0,1,2214482,1,1,1,0,4968
1d7168ce5fe7125f08b96d0288f989e983edde88,0,GitHub,2020-06-02 09:13:01-07:00,['a3d79ff23643d83f9df191522c003fb6335ca80c'],0,0,0,2214482,0,,,,4968
9e5e4cd55864c6a402a9513f0cedfb8ea8c83fba,1,GitHub,2020-06-02 09:50:20-07:00,['1d7168ce5fe7125f08b96d0288f989e983edde88'],7,7,14,2214496,1,,,,4968
8b22b8159673bfe22d8ac5dcd4e4312d4f2c863c,1,GitHub,2020-06-02 15:34:43-07:00,['9e5e4cd55864c6a402a9513f0cedfb8ea8c83fba'],99,483,582,2215078,17,1,0.980769231,1,4970
ea6d373a93205bad41b42ad9a2b2bec717c11c93,1,GitHub,2020-06-02 16:17:05-07:00,['8b22b8159673bfe22d8ac5dcd4e4312d4f2c863c'],55,95,150,2215228,2,0.617647059,0.705882353,1,4970
35a0692ce1ac456ce8155afc1f0838f4895140ab,0,GitHub,2020-06-02 20:39:02-07:00,['ea6d373a93205bad41b42ad9a2b2bec717c11c93'],1,2,3,2215231,1,0,1,1,4970
cb88be45ebc400069c03ad8b9a2332da0aecc7b8,0,GitHub,2020-06-03 11:12:47-05:00,['35a0692ce1ac456ce8155afc1f0838f4895140ab'],23,20,43,2215274,1,1,1,1,4970
0ffbc6e75fffb39d0dc387db534a51ce613f52af,0,GitHub,2020-06-03 10:37:53-07:00,['cb88be45ebc400069c03ad8b9a2332da0aecc7b8'],36,98,134,2215408,4,0,1,1,4970
98cd4b8cab9f44ad27c6d538c21707d70d5f61af,0,GitHub,2020-06-03 19:04:21+01:00,['0ffbc6e75fffb39d0dc387db534a51ce613f52af'],0,29,29,2215437,2,0.043478261,1,1,4970
162884409d1ac99f931c4291000d24bb98441fe6,0,GitHub,2020-06-03 13:17:31-07:00,['98cd4b8cab9f44ad27c6d538c21707d70d5f61af'],2,2,4,2215441,1,,,,4970
3af3ab9bf9522079f89094eae8d5987e09cc1397,0,GitHub,2020-06-03 13:18:50-07:00,['162884409d1ac99f931c4291000d24bb98441fe6'],13,18,31,2215472,5,,,,4970
21362ad7f7ec8f3cd5376f30288da4bf74ab4fd3,0,GitHub,2020-06-03 17:06:22-07:00,['3af3ab9bf9522079f89094eae8d5987e09cc1397'],8,2,10,2215482,2,,,,4970
87bef1d1b0fe1502be2335524990aad94bfd4bae,0,GitHub,2020-06-03 17:53:30-07:00,['21362ad7f7ec8f3cd5376f30288da4bf74ab4fd3'],7,13,20,2215502,2,,,,4970
6074f864b99b9df9ab7ac850046bd66e2b3962d9,0,GitHub,2020-06-03 22:13:50-07:00,['87bef1d1b0fe1502be2335524990aad94bfd4bae'],3,52,55,2215557,2,1,1,0.777777778,4970
50c30128909a6714c64518d84642e8c45478668a,1,GitHub,2020-06-04 06:21:52-07:00,['6074f864b99b9df9ab7ac850046bd66e2b3962d9'],26,73,99,2215656,18,1,1,1,4970
78e8a49cda651002549e6e992660f0cfd77ce6e1,0,GitHub,2020-06-04 15:36:37+01:00,['50c30128909a6714c64518d84642e8c45478668a'],248,537,785,2216441,14,0.53271028,0.841121495,0.953271028,4972
f1b093144792dc07b14dd5261565bdfcd70a9fd2,1,Manikumar Reddy,2020-06-04 23:50:43+05:18,['78e8a49cda651002549e6e992660f0cfd77ce6e1'],4,6,10,2216451,3,,,,4972
542b94be54ada718146331e3c6c522c25a48b693,0,GitHub,2020-06-04 15:42:13-07:00,['f1b093144792dc07b14dd5261565bdfcd70a9fd2'],4,9,13,2216464,1,,,,4972
6383a22fafdf09219145edaff8c3e0adf3455832,0,GitHub,2020-06-04 16:00:59-07:00,['542b94be54ada718146331e3c6c522c25a48b693'],4,58,62,2216526,2,0,1,1,4972
7867c24a40ab0a8d1e7b0d9bcb7776d1335ad3ea,1,GitHub,2020-06-04 17:31:18-07:00,['6383a22fafdf09219145edaff8c3e0adf3455832'],93,195,288,2216814,11,0.820224719,1,1,4972
31c81a6e9e7703cd86a3fc59a317205c8c57edc3,0,GitHub,2020-06-05 12:21:47-04:00,['7867c24a40ab0a8d1e7b0d9bcb7776d1335ad3ea'],27,27,54,2216868,6,,,,4972
9774c73e43dc2f628b9fb07a30ab4a595c0ee0a8,1,GitHub,2020-06-05 10:40:59-07:00,['31c81a6e9e7703cd86a3fc59a317205c8c57edc3'],143,248,391,2217259,7,0,0,1,4972
b020671f3124e7fea464a6f5e6712c1e773441c5,0,GitHub,2020-06-05 14:12:40-04:00,['9774c73e43dc2f628b9fb07a30ab4a595c0ee0a8'],0,6,6,2217265,6,,,,4972
7a876ec9dea931af0f17d6a856a5932091ef5056,0,Manikumar Reddy,2020-06-06 01:18:48+05:18,['b020671f3124e7fea464a6f5e6712c1e773441c5'],0,27,27,2217292,2,1,1,1,4972
8f552fd6ac03e846f77376681e962594d46ef7e3,0,GitHub,2020-06-05 15:02:11-05:00,['7a876ec9dea931af0f17d6a856a5932091ef5056'],12,12,24,2217316,1,,,,4972
b44ce35fe95af079cec99320128a4dde31d4c9c4,0,GitHub,2020-06-05 15:19:23-05:00,['8f552fd6ac03e846f77376681e962594d46ef7e3'],1,90,91,2217407,2,1,1,1,4973
da32720c19dfdfb0d1151267b5459bded7ba3bc5,0,GitHub,2020-06-05 15:20:24-05:00,['b44ce35fe95af079cec99320128a4dde31d4c9c4'],1,3,4,2217411,1,1,1,1,4973
2d9376c8bb129d1f880887169890149b914e3a32,0,GitHub,2020-06-05 16:02:17-05:00,['da32720c19dfdfb0d1151267b5459bded7ba3bc5'],2,91,93,2217504,3,0.97826087,1,1,4974
5a0e65ed394da76ddebf387739f9dec8687a9485,0,GitHub,2020-06-05 14:38:08-07:00,['2d9376c8bb129d1f880887169890149b914e3a32'],94,95,189,2217693,2,0.222222222,1,1,4974
e385e4639ea1bcf53af4f11ded10c77290dca8ee,0,GitHub,2020-06-05 18:29:17-04:00,['5a0e65ed394da76ddebf387739f9dec8687a9485'],26,26,52,2217745,6,,,,4974
910f3179960067135ec8ad4ab83d4582ff3847b5,1,GitHub,2020-06-05 15:53:13-07:00,['e385e4639ea1bcf53af4f11ded10c77290dca8ee'],193,462,655,2218400,15,0.682352941,1,0.723529412,4975
464aca362707f792eaa1d1111fd4b66a577c2123,0,GitHub,2020-06-05 15:56:02-07:00,['910f3179960067135ec8ad4ab83d4582ff3847b5'],18,54,72,2218472,3,0,1,0.727272727,4975
bdae26d0477aa7e505333ef7d074828d5bcc8b16,1,GitHub,2020-06-05 15:56:32-07:00,['464aca362707f792eaa1d1111fd4b66a577c2123'],4,2,6,2218478,1,1,0,0,4975
4eb3f75556b31b866384a58f4300294624d71bc1,0,GitHub,2020-06-05 20:29:50-07:00,['bdae26d0477aa7e505333ef7d074828d5bcc8b16'],26,22,48,2218526,3,0.25,0,0,4975
dd7c0369560c815482e6efc0a7ad08e0fcdf640f,1,Manikumar Reddy,2020-06-06 20:52:04+05:18,['4eb3f75556b31b866384a58f4300294624d71bc1'],6,37,43,2218569,2,0.333333333,1,0.916666667,4975
d4ef46c69dbc525f55a6d9ae5c9ae6da795f98fb,1,GitHub,2020-06-06 17:34:03-07:00,['dd7c0369560c815482e6efc0a7ad08e0fcdf640f'],86,80,166,2218735,8,1,1,0,4975
9a0b694a6686d0dc165d7dab54be0f77535582fa,0,GitHub,2020-06-07 12:42:00-07:00,['d4ef46c69dbc525f55a6d9ae5c9ae6da795f98fb'],0,51,51,2218786,3,0.641025641,1,1,4975
7777dc8f8ffd2ada55ecde3ddedc0d7907a73c3e,0,GitHub,2020-06-07 18:44:44-07:00,['9a0b694a6686d0dc165d7dab54be0f77535582fa'],12,12,24,2218810,1,1,0,0,4975
922ed9d2afe96d102757b89ce51583585e9005a8,0,GitHub,2020-06-08 12:18:01-04:00,['7777dc8f8ffd2ada55ecde3ddedc0d7907a73c3e'],1,1,2,2218812,1,,,,4975
73b1d4219d56784b8eb4c6b58baafc319bcbaee9,0,GitHub,2020-06-08 11:58:40-07:00,['922ed9d2afe96d102757b89ce51583585e9005a8'],102,110,212,2219024,1,0,0,0,4975
6a30b4e38502f3821d3e500bb8fa6f00ec39aa92,1,GitHub,2020-06-08 12:57:48-07:00,['73b1d4219d56784b8eb4c6b58baafc319bcbaee9'],5,84,89,2219113,5,0.283333333,0.85,0.85,4975
ad4b12a18cd82660c329feb0eac95ff3dda0839d,0,GitHub,2020-06-08 14:17:45-07:00,['6a30b4e38502f3821d3e500bb8fa6f00ec39aa92'],943,39,982,2220095,26,0.29342723,0.138497653,0.164319249,4975
aed7ba9f164ec35adbab948afd1ff8b20ccd8283,0,GitHub,2020-06-08 14:25:20-07:00,['ad4b12a18cd82660c329feb0eac95ff3dda0839d'],14,1,15,2220110,3,1,0.076923077,0,4975
5bcd7cca2263b4c7909c46a9fce2bd8aec2c3835,1,GitHub,2020-06-08 15:55:16-07:00,['aed7ba9f164ec35adbab948afd1ff8b20ccd8283'],76,139,215,2220325,16,0.222222222,0.203703704,1,4975
0fa95935dbe9b942f44088010a8fd8b742572ab1,0,GitHub,2020-06-08 16:08:27-07:00,['5bcd7cca2263b4c7909c46a9fce2bd8aec2c3835'],26,12,38,2220363,1,1,1,1,4975
8d3d2742b39980e7c0c0ee0713a25dbb14abc148,0,GitHub,2020-06-08 16:47:22-07:00,['0fa95935dbe9b942f44088010a8fd8b742572ab1'],3,36,39,2220402,2,1,1,1,4975
1d24e2e3b2a119997fc6805f9c754a5ee286d7b2,0,GitHub,2020-06-08 16:51:48-07:00,['8d3d2742b39980e7c0c0ee0713a25dbb14abc148'],4,4,8,2220410,1,,,,4975
58794d2f2eb43fe6debe191b10eb20b7b8093cf9,0,GitHub,2020-06-09 14:41:40+05:18,['1d24e2e3b2a119997fc6805f9c754a5ee286d7b2'],1,1,2,2220412,1,,,,4975
09b22e7e67e3ddfa319b723e00105fb0af2bd48b,0,GitHub,2020-06-09 09:41:11-07:00,['58794d2f2eb43fe6debe191b10eb20b7b8093cf9'],69,280,349,2220761,10,0.070512821,0.852564103,0.826923077,4976
6fa44a3a14aadaa140fb99962823a0fe2cb55f52,0,GitHub,2020-06-09 12:09:32-07:00,['09b22e7e67e3ddfa319b723e00105fb0af2bd48b'],2,4,6,2220767,1,0,1,1,4976
b2d37cc74e9b694713a561d307f52cc0ddf08fe6,1,GitHub,2020-06-09 13:02:35-07:00,['6fa44a3a14aadaa140fb99962823a0fe2cb55f52'],14,248,262,2221029,6,0.098265896,1,0.994219653,4976
a22aa95f503edf36c6a286cad94aed4a9f23f2cb,0,GitHub,2020-06-09 14:55:56-07:00,['b2d37cc74e9b694713a561d307f52cc0ddf08fe6'],4,9,13,2221042,1,0,0,0,4976
84051e0e886de46b8320e3ee222d380b00459b26,1,GitHub,2020-06-09 17:33:43-07:00,['a22aa95f503edf36c6a286cad94aed4a9f23f2cb'],14,37,51,2221093,4,0.071428571,0.714285714,1,4976
0f68dc7a640b26a8edea154ea4ea2b6d93b5104b,0,GitHub,2020-06-10 09:56:06-05:00,['84051e0e886de46b8320e3ee222d380b00459b26'],396,341,737,2221830,5,1,0,1,4976
164db1a6611224e0289df15215344ce6d600d7b1,1,GitHub,2020-06-10 12:24:31-07:00,['0f68dc7a640b26a8edea154ea4ea2b6d93b5104b'],18,76,94,2221924,5,0.780487805,1,0.829268293,4976
ff8a757b9c4fcadda5a8aa165b4c3e8e8dd2d8fd,0,GitHub,2020-06-10 14:07:18-07:00,['164db1a6611224e0289df15215344ce6d600d7b1'],39,36,75,2221999,1,1,0,1,4976
7d8e62b3b6d5a4f414211eb9cd5caa0e77d72cfb,0,GitHub,2020-06-10 15:04:36-07:00,['ff8a757b9c4fcadda5a8aa165b4c3e8e8dd2d8fd'],108,258,366,2222365,2,0.26984127,1,1,4976
3e9ba2236ab67ca48a3ce6af085f08acf54ee689,1,GitHub,2020-06-10 17:06:22-07:00,['7d8e62b3b6d5a4f414211eb9cd5caa0e77d72cfb'],0,39,39,2222404,2,0,0.914285714,0.914285714,4976
8e083e1b8879e732522bb9a560c82ff84b176cc9,1,GitHub,2020-06-10 17:53:43-07:00,['3e9ba2236ab67ca48a3ce6af085f08acf54ee689'],586,363,949,2223353,11,0.652173913,0.565217391,0,4976
45fb78edd42057f3fc8c28892b8948c3f36cf017,1,GitHub,2020-06-10 19:58:00-05:00,['8e083e1b8879e732522bb9a560c82ff84b176cc9'],5,76,81,2223434,3,0.433962264,0.41509434,1,4976
6abb913c6449113141582921340994c0d5e50839,0,GitHub,2020-06-10 17:59:32-07:00,['45fb78edd42057f3fc8c28892b8948c3f36cf017'],4,217,221,2223655,2,0.056497175,0.988700565,0.728813559,4976
775f0d484b6fccc3d985a9d53d86d7a3710c0b22,0,GitHub,2020-06-10 22:03:25-05:00,['6abb913c6449113141582921340994c0d5e50839'],31,52,83,2223738,7,0.647058824,1,1,4976
eef5d494329a4526783c16e7b5711b04bfbd01b2,0,GitHub,2020-06-10 20:05:10-07:00,['775f0d484b6fccc3d985a9d53d86d7a3710c0b22'],35,103,138,2223876,2,0.094339623,0.943396226,0.943396226,4976
92d56ed93325c3849a36fc6dceb9ccab1c42edce,0,GitHub,2020-06-10 22:06:38-05:00,['eef5d494329a4526783c16e7b5711b04bfbd01b2'],1,23,24,2223900,1,1,1,1,4976
48b56e533b3ff22ae0e2cf7fcc649e7df19f2b06,1,GitHub,2020-06-10 22:39:52-05:00,['92d56ed93325c3849a36fc6dceb9ccab1c42edce'],5,645,650,2224550,15,0.294642857,0.799107143,0.904017857,4976
a6ca7ad31015b7395247290179ae24ce51894b50,1,Randall Hauch,2020-06-10 22:53:50-05:00,['48b56e533b3ff22ae0e2cf7fcc649e7df19f2b06'],75,104,179,2224729,6,0.615384615,0,0.769230769,4976
5f7b07b5140adb9f606c71ae1c261466ccacad74,1,GitHub,2020-06-11 01:05:18-07:00,['a6ca7ad31015b7395247290179ae24ce51894b50'],5,7,12,2224741,3,1,1,1,4976
7f4fc76e968a6b2cf4a73364c93bfdea03f81af3,1,GitHub,2020-06-11 01:29:23-07:00,['5f7b07b5140adb9f606c71ae1c261466ccacad74'],773,2171,2944,2227685,20,0.244877049,0.892418033,0.930327869,4978
e8e9fe82daa4b0604d039be6f408256b66f97072,1,GitHub,2020-06-11 08:31:20-05:00,['7f4fc76e968a6b2cf4a73364c93bfdea03f81af3'],47,367,414,2228099,6,0.082901554,0.186528497,0.849740933,4979
42f46abb34a2b29993b1a8e6333a400a00227e30,0,GitHub,2020-06-11 09:47:48-05:00,['e8e9fe82daa4b0604d039be6f408256b66f97072'],65,270,335,2228434,8,0.156716418,0.395522388,0.798507463,4979
4f96c5b424956355339dd3216c426c1c0388fe9e,1,GitHub,2020-06-11 11:28:57-07:00,['42f46abb34a2b29993b1a8e6333a400a00227e30'],43,2315,2358,2230792,29,0.533393502,0.868231047,0.934115523,4993
bcf45b09d34607d53e17d1f75a3097f3a8157903,1,GitHub,2020-06-12 10:00:38-05:00,['4f96c5b424956355339dd3216c426c1c0388fe9e'],78,86,164,2230956,10,0,1,1,4993
9a4f00f78bf37041006ae8b6432d194f603ac6cc,1,GitHub,2020-06-12 21:19:35+01:00,['bcf45b09d34607d53e17d1f75a3097f3a8157903'],682,469,1151,2232107,12,0.567164179,1,0.71641791,4993
3d45e1f09ee91a3233eec9adc416ff9c15c2b5c8,0,GitHub,2020-06-12 14:17:20-07:00,['9a4f00f78bf37041006ae8b6432d194f603ac6cc'],4,8,12,2232119,1,,,,4993
03ed08d0d17a10ca4f96c8cc0a8694834ae01e6d,1,GitHub,2020-06-12 16:21:57-07:00,['3d45e1f09ee91a3233eec9adc416ff9c15c2b5c8'],95,146,241,2232360,8,0,1,0.958333333,4993
88fe466f03ff61d684c5b7b1f20558181a8f2078,0,GitHub,2020-06-13 01:00:39-07:00,['03ed08d0d17a10ca4f96c8cc0a8694834ae01e6d'],15,18,33,2232393,1,0,1,1,4993
a3e8f495cfa4624202eb327512785d66e7e730a9,0,GitHub,2020-06-15 10:53:27-07:00,['88fe466f03ff61d684c5b7b1f20558181a8f2078'],0,1,1,2232394,1,0,0,1,4993
a0da6785a27b13be173762965402b55860ac5635,0,GitHub,2020-06-15 10:56:40-07:00,['a3e8f495cfa4624202eb327512785d66e7e730a9'],1,2,3,2232397,1,1,1,1,4993
cb9f130ec8a584036b7953212572a6090c85af27,0,GitHub,2020-06-15 12:21:36-07:00,['a0da6785a27b13be173762965402b55860ac5635'],1,1,2,2232399,1,,,,4993
a1f429d4f636b8cfe99e052a20b85ed1cc7a0cef,0,GitHub,2020-06-15 22:07:01-07:00,['cb9f130ec8a584036b7953212572a6090c85af27'],9,200,209,2232608,8,0.966666667,0.966666667,0,4994
e5bb5358606d8acad03301dc85f2e559ee51ccd0,0,GitHub,2020-06-16 10:23:09-07:00,['a1f429d4f636b8cfe99e052a20b85ed1cc7a0cef'],9,0,9,2232617,1,1,0,0,4994
bea5ceb4343e79ede4107c879288a5f690bd455f,1,GitHub,2020-06-16 10:28:36-07:00,['e5bb5358606d8acad03301dc85f2e559ee51ccd0'],1,4,5,2232622,3,1,1,1,4994
2239004907b29e00811fee9ded5a790172701a03,1,GitHub,2020-06-16 16:30:37-07:00,['bea5ceb4343e79ede4107c879288a5f690bd455f'],411,402,813,2233435,7,1,0,0,4994
147ffb9a968d62ef78ac6b330a20023ed49ddbb8,1,GitHub,2020-06-17 09:24:07-05:00,['2239004907b29e00811fee9ded5a790172701a03'],202,179,381,2233816,12,1,0,0.777777778,4994
26e238c6f5a242459f52bfefa97a6b0c247b2d5e,0,GitHub,2020-06-17 09:56:07-05:00,['147ffb9a968d62ef78ac6b330a20023ed49ddbb8'],49,23,72,2233888,1,0.48,0.56,0,4994
0c2dfcfc85ccf2ab06a69910f5a991720880d7ba,0,GitHub,2020-06-17 10:01:30-05:00,['26e238c6f5a242459f52bfefa97a6b0c247b2d5e'],34,57,91,2233979,1,0.888888889,1,1,4994
492306a0c5ad558d8acf34325985aed803ae75fd,1,GitHub,2020-06-17 09:25:02-07:00,['0c2dfcfc85ccf2ab06a69910f5a991720880d7ba'],20,3,23,2234002,2,0,0,0,4994
3b7c2ab6d814e7860771f2eec055d34be5002e5d,0,GitHub,2020-06-17 15:46:05-05:00,['492306a0c5ad558d8acf34325985aed803ae75fd'],4,1,5,2234007,1,1,1,0,4994
42aa0f38b9676ecac02de7b0c9246b6f32bac8d4,1,GitHub,2020-06-17 17:04:43-07:00,['3b7c2ab6d814e7860771f2eec055d34be5002e5d'],40,10,50,2234057,1,,,,4994
7ed899a320697e20a7c7f9a2753dd5de6bbecb9d,1,GitHub,2020-06-17 19:28:41-07:00,['42aa0f38b9676ecac02de7b0c9246b6f32bac8d4'],12,5,17,2234074,1,1,0,0,4994
446196d6e9d66f45c64b483e3d375aaeaca28e3b,1,GitHub,2020-06-17 20:23:45-07:00,['7ed899a320697e20a7c7f9a2753dd5de6bbecb9d'],37,157,194,2234268,7,0.432835821,0.895522388,1,4994
d3d65dd5dd2fa3466366afac478724ef5d330df3,0,GitHub,2020-06-17 21:53:22-07:00,['446196d6e9d66f45c64b483e3d375aaeaca28e3b'],2,2,4,2234272,2,,,,4994
d8cc6fe8e36329c647736773d9d66de89c447409,0,GitHub,2020-06-18 11:28:49-07:00,['d3d65dd5dd2fa3466366afac478724ef5d330df3'],203,222,425,2234697,11,1,0,0,4994
f3c00ae1c86a48ad36fa42e8e7e1d2b448790e99,0,GitHub,2020-06-18 18:10:05-07:00,['d8cc6fe8e36329c647736773d9d66de89c447409'],77,182,259,2234956,6,0.405405405,1,0.932432432,4994
1e5fa9e082fcd5875222f9d7458ffa1fa7b1587b,0,GitHub,2020-06-18 20:32:55-07:00,['f3c00ae1c86a48ad36fa42e8e7e1d2b448790e99'],8,40,48,2235004,2,0.307692308,1,1,4994
5ecd094b57ed381f3420b65971fe3059c72fb45f,0,GitHub,2020-06-19 07:32:53-07:00,['1e5fa9e082fcd5875222f9d7458ffa1fa7b1587b'],43,60,103,2235107,2,,,,4994
3c43adff1d4562c6b33732f399691c9e2f887903,1,GitHub,2020-06-19 09:05:54-07:00,['5ecd094b57ed381f3420b65971fe3059c72fb45f'],8,224,232,2235339,2,0.023809524,1,1,4994
68db063aa4918ac7dc40cb5c0be48ec731c160f7,0,GitHub,2020-06-19 14:17:58-05:00,['3c43adff1d4562c6b33732f399691c9e2f887903'],17,89,106,2235445,3,0.206349206,0.873015873,1,4994
54dbd041bc8fa3e3965f79f8bb160f997fdd9cf3,0,GitHub,2020-06-19 12:35:49-07:00,['68db063aa4918ac7dc40cb5c0be48ec731c160f7'],2,16,18,2235463,2,1,1,1,4994
965877c11c221640b6fda3cdb55e78da7551e525,0,GitHub,2020-06-19 14:50:22-07:00,['54dbd041bc8fa3e3965f79f8bb160f997fdd9cf3'],72,72,144,2235607,12,,,,4994
712cc5d073da7595dab836c95372c13fc61047ee,0,GitHub,2020-06-19 17:41:06-07:00,['965877c11c221640b6fda3cdb55e78da7551e525'],45,60,105,2235712,22,,,,4994
199f375b546c201289d2b15084e0a95598093fe0,0,Manikumar Reddy,2020-06-21 15:31:34+05:18,['712cc5d073da7595dab836c95372c13fc61047ee'],1,1,2,2235714,1,,,,4994
f7c38d83c727310f4b0678886ba410ae2fae9379,1,GitHub,2020-06-22 15:54:35-07:00,['199f375b546c201289d2b15084e0a95598093fe0'],37,39,76,2235790,4,1,1,0,4994
14137def712a43b5bbbf02b067f2b1d4a12926b6,0,GitHub,2020-06-23 08:33:13-07:00,['f7c38d83c727310f4b0678886ba410ae2fae9379'],1,1,2,2235792,1,,,,4994
a047a7c0ebd8401e11ac9bde69a1a2b3e1f15377,0,GitHub,2020-06-23 14:07:14-07:00,['14137def712a43b5bbbf02b067f2b1d4a12926b6'],0,59,59,2235851,1,0.152173913,1,1,4994
e70bc044481e98508a32f2f73f9f9bc89b0997eb,0,GitHub,2020-06-23 15:10:00-07:00,['a047a7c0ebd8401e11ac9bde69a1a2b3e1f15377'],2,6,8,2235859,1,,,,4994
448e7d7f0f46db1eae14d4fe7a1d25b7af894b09,1,GitHub,2020-06-23 18:08:26-07:00,['e70bc044481e98508a32f2f73f9f9bc89b0997eb'],238,400,638,2236497,12,0.396039604,0.702970297,1,4994
3348fc49d8824155e737b866f633e14684da5fe9,0,GitHub,2020-06-24 18:57:38-07:00,['448e7d7f0f46db1eae14d4fe7a1d25b7af894b09'],22,54,76,2236573,8,1,1,1,4994
43f4b1b7b57c22b1f852afa256088b8b98f0392d,0,GitHub,2020-06-25 23:22:58-07:00,['3348fc49d8824155e737b866f633e14684da5fe9'],11,14,25,2236598,4,1,1,0,4994
9c9a79b459d2b34218b46da4c54113c500255bbb,1,GitHub,2020-06-26 16:17:29+01:00,['43f4b1b7b57c22b1f852afa256088b8b98f0392d'],59,337,396,2236994,4,0.198717949,0.762820513,0.878205128,4994
7f90a58b69cd0eb63ba122b41e6ef6195b0a5d98,1,GitHub,2020-06-26 10:19:04-07:00,['9c9a79b459d2b34218b46da4c54113c500255bbb'],405,382,787,2237781,79,0.045714286,0.045714286,0,4994
fa2da1c9db098c5d9be8847b681c9407d5124940,0,Manikumar Reddy,2020-06-26 22:56:28+05:18,['7f90a58b69cd0eb63ba122b41e6ef6195b0a5d98'],5,5,10,2237791,1,,,,4994
30df089631cf3c7667b609e2b9689cb02230c64e,1,GitHub,2020-06-26 15:11:56-07:00,['fa2da1c9db098c5d9be8847b681c9407d5124940'],155,281,436,2238227,7,0.726190476,0.880952381,1,4994
831938952e47d4e65ae40c389e74756c596c6989,0,GitHub,2020-06-26 21:41:51-05:00,['30df089631cf3c7667b609e2b9689cb02230c64e'],273,705,978,2239205,10,0.280851064,1,0.782978723,4995
3661f981fff2653aaf1d5ee0b6dde3410b5498db,1,GitHub,2020-06-27 09:27:49-07:00,['831938952e47d4e65ae40c389e74756c596c6989'],10,12,22,2239227,1,1,1,1,4995
52d9d6651f2862f36a10965be5ed7c68481212e9,0,GitHub,2020-06-29 00:18:28-07:00,['3661f981fff2653aaf1d5ee0b6dde3410b5498db'],8,10,18,2239245,1,0,0,1,4995
2dfb6b05e1fd697b085f937ddfb70ea28854b8ff,0,GitHub,2020-06-29 10:36:12-07:00,['52d9d6651f2862f36a10965be5ed7c68481212e9'],1,1,2,2239247,1,,,,4995
3624daef2addf8ab6339e068d4d0f77f08ab6c6e,1,GitHub,2020-06-29 13:22:08-07:00,['2dfb6b05e1fd697b085f937ddfb70ea28854b8ff'],1,1,2,2239249,1,,,,4995
7db52a46b00eed652e791dd4eae809d590626a1f,0,GitHub,2020-06-29 13:31:32-07:00,['3624daef2addf8ab6339e068d4d0f77f08ab6c6e'],3,1,4,2239253,2,,,,4995
7dcdd35b657e000720cb3c10abfd9db886d2b3c6,0,GitHub,2020-06-29 16:25:48-07:00,['7db52a46b00eed652e791dd4eae809d590626a1f'],1,14,15,2239268,2,1,1,1,4995
4be4420b3da781265032d651a9dd20087d67a83f,1,Manikumar Reddy,2020-06-30 06:15:42+05:18,['7dcdd35b657e000720cb3c10abfd9db886d2b3c6'],6,67,73,2239341,3,0.173913043,1,1,4996
89c6562082f737351ec28b8f2bf9549ebb23c377,0,GitHub,2020-06-29 20:27:52-07:00,['4be4420b3da781265032d651a9dd20087d67a83f'],8,6,14,2239355,2,0,1,0,4996
55b5b248cd0974f48e8bf261f61227722cb47570,1,GitHub,2020-06-30 12:15:17+01:00,['89c6562082f737351ec28b8f2bf9549ebb23c377'],37,496,533,2239888,27,0.39047619,0.952380952,0.757142857,4998
1e1aa4a5fb86d938a7c8166eebeed5b041cca459,0,GitHub,2020-06-30 18:07:46+05:18,['55b5b248cd0974f48e8bf261f61227722cb47570'],3,2,5,2239893,1,,,,4998
18dcd2c78a620853f4cc8e1178cdfef57b591bf7,0,GitHub,2020-06-30 19:19:28+05:18,['1e1aa4a5fb86d938a7c8166eebeed5b041cca459'],1,1,2,2239895,1,,,,4998
0e6c8a55b93d66dbf666ca8625fbe6e1ef919552,0,GitHub,2020-06-30 11:59:47-05:00,['18dcd2c78a620853f4cc8e1178cdfef57b591bf7'],35,363,398,2240293,13,0.299363057,1,1,5001
c4ec765af51cfce8a09bcc2446c6ad33cae69ba1,0,GitHub,2020-06-30 12:15:28-05:00,['0e6c8a55b93d66dbf666ca8625fbe6e1ef919552'],19,27,46,2240339,3,0,0,1,5001
f3a9ce4a69d17db7b8ba21134eb8118070176e48,0,GitHub,2020-06-30 12:18:23-05:00,['c4ec765af51cfce8a09bcc2446c6ad33cae69ba1'],2,5,7,2240346,1,1,1,1,5001
6094af897436f2e24764ad99cfa6e81391baa916,0,Manikumar Reddy,2020-07-01 16:56:54+05:18,['f3a9ce4a69d17db7b8ba21134eb8118070176e48'],0,12,12,2240358,2,0,0,1,5001
16eb9c0bfe9d27b4de127576084154a9ab663e1b,0,GitHub,2020-07-01 10:18:16-05:00,['6094af897436f2e24764ad99cfa6e81391baa916'],0,78,78,2240436,1,,,,5001
d1133bf7bff5a6f8c880953b0aff863020703887,0,GitHub,2020-07-01 13:01:49-05:00,['16eb9c0bfe9d27b4de127576084154a9ab663e1b'],3,3,6,2240442,1,,,,5001
efec315d0a79ef281f337d328cb51667814fa5b3,1,GitHub,2020-07-01 14:03:11-05:00,['d1133bf7bff5a6f8c880953b0aff863020703887'],2,22,24,2240466,1,1,1,1,5001
b8a99be7847c61d7792689b71fda5b283f8340a8,0,GitHub,2020-07-01 21:17:02+01:00,['efec315d0a79ef281f337d328cb51667814fa5b3'],1,1,2,2240468,1,,,,5001
5dade71a8f859b0ffd122af27cfea3a1d1b64491,1,GitHub,2020-07-02 05:09:29+05:18,['b8a99be7847c61d7792689b71fda5b283f8340a8'],1,1,2,2240470,1,,,,5001
5275e4b7efbbc1b09cd353025827eff5ba674d80,0,GitHub,2020-07-01 22:36:30-07:00,['5dade71a8f859b0ffd122af27cfea3a1d1b64491'],2,13,15,2240485,2,,,,5001
cf1ebcbbbde0430663afd20d4f9753583ed35d81,0,GitHub,2020-07-02 13:57:38-07:00,['5275e4b7efbbc1b09cd353025827eff5ba674d80'],18,144,162,2240647,3,0.030927835,0.835051546,0.18556701,5001
3b2ae7b95a27176a22e5356160a9df468c483778,1,GitHub,2020-07-02 18:14:46-05:00,['cf1ebcbbbde0430663afd20d4f9753583ed35d81'],113,5049,5162,2245809,22,0.213771518,0.518622848,0.571517997,5018
caa806cd82fb9fa88510c81de53e69ac9846311d,0,GitHub,2020-07-03 10:41:45+01:00,['3b2ae7b95a27176a22e5356160a9df468c483778'],37,258,295,2246104,12,0.5,0.96875,1,5022
72042f26aff396ed85d02e7e312fd07ea2cc7617,0,GitHub,2020-07-03 10:38:42-07:00,['caa806cd82fb9fa88510c81de53e69ac9846311d'],2,2,4,2246108,1,,,,5022
ce939e9136b7a1ea5343d464b7660f905212c053,1,GitHub,2020-07-04 10:54:11-07:00,['72042f26aff396ed85d02e7e312fd07ea2cc7617'],4,9,13,2246121,2,,,,5022
e263566303ae4f4aa92f4f95d4e88d01325195ec,0,GitHub,2020-07-06 09:43:40-07:00,['ce939e9136b7a1ea5343d464b7660f905212c053'],6,6,12,2246133,2,,,,5022
2a4d938ef00edfdde7279cd16ff2e01f06416596,1,GitHub,2020-07-06 10:30:16-07:00,['e263566303ae4f4aa92f4f95d4e88d01325195ec'],24,36,60,2246193,2,0,0.166666667,0.833333333,5022
3a55fb9f28365c0bf9e91fadf68de0c504c2a27e,1,GitHub,2020-07-06 11:25:39-07:00,['2a4d938ef00edfdde7279cd16ff2e01f06416596'],2,19,21,2246214,1,0,0,1,5022
8a24da376b801c6eb6522ad4861b83f5beb5826c,0,GitHub,2020-07-06 11:34:36-07:00,['3a55fb9f28365c0bf9e91fadf68de0c504c2a27e'],3,5,8,2246222,1,1,1,1,5022
cd2f5f030b353dfcaa7c3c8e18f69c681ea8e0f1,1,GitHub,2020-07-06 14:04:36-07:00,['8a24da376b801c6eb6522ad4861b83f5beb5826c'],5,46,51,2246273,2,0.52,0.52,1,5022
34f749db307c2886af82b31aec4c9a21588e097d,0,GitHub,2020-07-06 18:52:51-05:00,['cd2f5f030b353dfcaa7c3c8e18f69c681ea8e0f1'],7,2,9,2246282,1,,,,5022
cdf68a4dae284ef021ae4ed26c5e0128c0cd7224,0,GitHub,2020-07-06 17:16:12-07:00,['34f749db307c2886af82b31aec4c9a21588e097d'],13,70,83,2246365,4,0.58974359,0.58974359,1,5022
11a8549479431826e64e80e49f1c5e41be8a7fd5,0,GitHub,2020-07-06 18:09:24-07:00,['cdf68a4dae284ef021ae4ed26c5e0128c0cd7224'],0,28,28,2246393,1,,,,5022
aae8b5f54f716312d413a76fb4228e68e6df7df2,0,GitHub,2020-07-06 18:50:24-07:00,['11a8549479431826e64e80e49f1c5e41be8a7fd5'],0,6,6,2246399,1,0,0,1,5022
18f2589c1e087654c0cdd46d2473246f37f0b66a,0,GitHub,2020-07-06 18:50:40-07:00,['aae8b5f54f716312d413a76fb4228e68e6df7df2'],29,102,131,2246530,3,0.018518519,1,1,5022
47cbbf2752affc2a511cbe5cb926692d74e6a9cf,0,GitHub,2020-07-07 16:48:44+01:00,['18f2589c1e087654c0cdd46d2473246f37f0b66a'],16,80,96,2246626,4,0,1,1,5022
69531611258ca732c93a8cded95c0c776cd28643,0,GitHub,2020-07-07 12:48:36-05:00,['47cbbf2752affc2a511cbe5cb926692d74e6a9cf'],2,54,56,2246682,4,0.384615385,1,0.820512821,5022
6f3ceea5c61d90d4075ed5c5a22bde33142f7ec7,1,GitHub,2020-07-08 09:51:50-07:00,['69531611258ca732c93a8cded95c0c776cd28643'],14,25,39,2246721,3,0.857142857,1,1,5022
38877c0025a84ae02394d7542957f522514da94e,0,GitHub,2020-07-08 12:31:14-07:00,['6f3ceea5c61d90d4075ed5c5a22bde33142f7ec7'],9,46,55,2246776,2,0.148148148,0.851851852,0.851851852,5022
80cab851ee9626880516486ad60d661f9c82e6d2,0,GitHub,2020-07-08 13:19:40-07:00,['38877c0025a84ae02394d7542957f522514da94e'],3,9,12,2246788,3,,,,5022
dd79579c718d069b985897ca7837dc211b39092a,0,Manikumar Reddy,2020-07-09 14:17:12+05:18,['80cab851ee9626880516486ad60d661f9c82e6d2'],4,71,75,2246863,2,1,1,0.88,5023
f5e970df1d18ba999f1d4c2c227127f741e80604,0,Manikumar Reddy,2020-07-09 14:47:05+05:18,['dd79579c718d069b985897ca7837dc211b39092a'],34,98,132,2246995,2,0.592592593,1,1,5023
cfadb8b8d98fe616c976cf1f697d360276206b86,0,GitHub,2020-07-09 16:15:52+05:18,['f5e970df1d18ba999f1d4c2c227127f741e80604'],1,1,2,2246997,1,,,,5023
faf96fa771744717c30b37545b6c83f120d0c8a4,0,GitHub,2020-07-09 19:57:21+05:18,['cfadb8b8d98fe616c976cf1f697d360276206b86'],10,15,25,2247022,1,1,1,1,5023
e099b58df5b3e4f87173fc55880f9c343308739f,1,GitHub,2020-07-09 09:33:07-07:00,['faf96fa771744717c30b37545b6c83f120d0c8a4'],1,5,6,2247028,1,,,,5023
813f92c21ad4bd7ffdd8acc66c20d31927e7a67f,1,GitHub,2020-07-09 13:50:31-05:00,['e099b58df5b3e4f87173fc55880f9c343308739f'],204,767,971,2247999,31,0.466472303,1,0.997084548,5024
17256abb23c181205edaa6470729cf67fa6f9e99,0,Manikumar Reddy,2020-07-10 00:39:50+05:18,['813f92c21ad4bd7ffdd8acc66c20d31927e7a67f'],4,3,7,2248006,1,0,0,0,5024
7e668482009a9a78353915d5563c272bb5141621,0,GitHub,2020-07-09 13:50:29-07:00,['17256abb23c181205edaa6470729cf67fa6f9e99'],24,74,98,2248104,1,,,,5024
888f83c2c3d03084629256f9f993072a22da74c0,0,GitHub,2020-07-09 20:49:20-05:00,['7e668482009a9a78353915d5563c272bb5141621'],14,123,137,2248241,4,0.139240506,0.873417722,0.962025316,5024
f209b3c5c1efbd80d709244a41f55c19c5c1c4de,0,GitHub,2020-07-10 16:51:00-07:00,['888f83c2c3d03084629256f9f993072a22da74c0'],25,45,70,2248311,2,0,0.692307692,0.384615385,5024
f2db8d5318e099e492e44effbfcea57005c1cf94,1,GitHub,2020-07-11 11:11:06-07:00,['f209b3c5c1efbd80d709244a41f55c19c5c1c4de'],5,63,68,2248379,2,1,1,0.787878788,5024
cec5f377b59443a52ed1895d4e76e6f31cd46d66,0,GitHub,2020-07-11 11:39:23-07:00,['f2db8d5318e099e492e44effbfcea57005c1cf94'],28,232,260,2248639,5,0,0.65625,1,5024
f40aa33de792f74c3bc8078c61d5cac67df963ba,1,GitHub,2020-07-13 08:00:51-07:00,['cec5f377b59443a52ed1895d4e76e6f31cd46d66'],7,35,42,2248681,2,1,1,1,5024
c0bcabcc9adcd59adf92bdeae0d92a7a46b26cb9,0,GitHub,2020-07-13 08:30:09-07:00,['f40aa33de792f74c3bc8078c61d5cac67df963ba'],0,4,4,2248685,1,0,0,1,5024
d945b287ff694394449826d01ae238cf7e53a5f1,0,GitHub,2020-07-13 15:01:14-07:00,['c0bcabcc9adcd59adf92bdeae0d92a7a46b26cb9'],1,27,28,2248713,1,,,,5024
ffdec02e25bb3be52ee5c06fe76d388303f6ea43,0,GitHub,2020-07-13 16:23:18-07:00,['d945b287ff694394449826d01ae238cf7e53a5f1'],12,43,55,2248768,7,1,1,0,5024
43d43e6c7bbfbc87d0288f7b934d5b6e0ebf1913,1,GitHub,2020-07-13 17:49:13-07:00,['ffdec02e25bb3be52ee5c06fe76d388303f6ea43'],124,247,371,2249139,7,0.594936709,1,0.240506329,5024
4cd6dfc825b934e8e360bdd586c41931b0b3b8e6,0,GitHub,2020-07-13 20:55:12-07:00,['43d43e6c7bbfbc87d0288f7b934d5b6e0ebf1913'],0,57,57,2249196,2,0.075,1,1,5024
cf69bdc713cf72a0407d46e0d07f6d77512ebfaf,1,GitHub,2020-07-13 21:02:03-07:00,['4cd6dfc825b934e8e360bdd586c41931b0b3b8e6'],1,12,13,2249209,1,0,1,1,5024
f699bd98c14e31f07c5a3f6ba9ce2c4b441e7fdb,0,GitHub,2020-07-14 11:59:34-07:00,['cf69bdc713cf72a0407d46e0d07f6d77512ebfaf'],2,0,2,2249211,1,,,,5024
e5335bcb58f0892d8cd6222fc14d6458922a6c2e,1,GitHub,2020-07-15 09:03:50-07:00,['f699bd98c14e31f07c5a3f6ba9ce2c4b441e7fdb'],19,89,108,2249319,4,0.789473684,0.789473684,0.789473684,5025
934033bd1701810f9031c4c1b898fd5f72b38980,0,GitHub,2020-07-15 10:09:27-07:00,['e5335bcb58f0892d8cd6222fc14d6458922a6c2e'],1,1,2,2249321,1,,,,5025
598a0d16fa779cba9bb9ad0354236f269b2ff13d,0,GitHub,2020-07-15 11:33:49-07:00,['934033bd1701810f9031c4c1b898fd5f72b38980'],3,3,6,2249327,1,,,,5025
2eeae09ca3e5a9af89e1f15c0d772413ddc489ec,0,GitHub,2020-07-15 14:16:06-07:00,['598a0d16fa779cba9bb9ad0354236f269b2ff13d'],7,214,221,2249548,4,0.02,0.606666667,0.986666667,5025
796fae25c34593a76e97761ca525aec1a739a803,0,GitHub,2020-07-16 09:01:46-07:00,['2eeae09ca3e5a9af89e1f15c0d772413ddc489ec'],8,17,25,2249573,2,1,1,1,5025
99c64822a723c6f87e3319a2def82f2c0c99f5f4,1,GitHub,2020-07-17 08:55:53+01:00,['796fae25c34593a76e97761ca525aec1a739a803'],98,221,319,2249892,10,0.611764706,0.847058824,0.941176471,5025
6d2c7802da3e3ca29c1b225bd9d41ad29a6e5417,0,GitHub,2020-07-17 11:27:33-07:00,['99c64822a723c6f87e3319a2def82f2c0c99f5f4'],1,3,4,2249896,1,0,1,0,5025
715df0d27122e0799c68daa78ab5f9ce0ab6b594,0,GitHub,2020-07-17 12:02:37-07:00,['6d2c7802da3e3ca29c1b225bd9d41ad29a6e5417'],85,182,267,2250163,4,0.326530612,0.714285714,1,5025
9c8f75c4b624084c954b4da69f092211a9ac4689,1,GitHub,2020-07-17 20:05:11+01:00,['715df0d27122e0799c68daa78ab5f9ce0ab6b594'],199,279,478,2250641,52,1,1,1,5026
b988de2842c703fc81bfaa450ffbbb3e8fb2c8fa,0,GitHub,2020-07-18 14:36:31+05:18,['9c8f75c4b624084c954b4da69f092211a9ac4689'],12,9,21,2250662,4,0.333333333,0.333333333,0.333333333,5026
cd6850b4108892d565b94f7cb9150d07f6116511,0,GitHub,2020-07-19 20:24:12+05:18,['b988de2842c703fc81bfaa450ffbbb3e8fb2c8fa'],1,4,5,2250667,4,0.333333333,0.666666667,1,5026
b02fa53419c53e8bb5e9a34f2b4dc80bd1bdd3ac,0,Manikumar Reddy,2020-07-20 18:08:48+05:18,['cd6850b4108892d565b94f7cb9150d07f6116511'],4,9,13,2250680,4,,,,5026
5a2a7c6348f32b31d8f048eea7f144c690a00be1,0,GitHub,2020-07-20 08:48:02-05:00,['b02fa53419c53e8bb5e9a34f2b4dc80bd1bdd3ac'],4,21,25,2250705,1,0.714285714,0.714285714,0.357142857,5026
f4944ee460ed3186cbbabba12e8b486c53030044,0,GitHub,2020-07-20 08:50:05-05:00,['5a2a7c6348f32b31d8f048eea7f144c690a00be1'],0,14,14,2250719,1,0,0,0,5026
9b30276e58a26d68b6665e71dd1295abc67ddcd8,1,GitHub,2020-07-20 16:27:28-05:00,['f4944ee460ed3186cbbabba12e8b486c53030044'],140,312,452,2251171,6,,,,5026
f77e250b99888aaf7907b92e5be853171f178c8d,0,GitHub,2020-07-20 17:55:21-07:00,['9b30276e58a26d68b6665e71dd1295abc67ddcd8'],3,53,56,2251227,2,0.477272727,1,1,5026
6162a1532673dd12485c8df0c6f00725cc7d134a,0,GitHub,2020-07-21 10:36:39+01:00,['f77e250b99888aaf7907b92e5be853171f178c8d'],9,86,95,2251322,4,0.060606061,1,1,5026
c38825ab976e5187d14c10503a5b403fc41c8d5c,0,Manikumar Reddy,2020-07-21 17:20:11+05:18,['6162a1532673dd12485c8df0c6f00725cc7d134a'],2,60,62,2251384,4,0.333333333,0.955555556,1,5026
b63fecb6930cd0546a938cebe91b9f506a5e47d5,0,GitHub,2020-07-21 15:48:37+01:00,['c38825ab976e5187d14c10503a5b403fc41c8d5c'],74,124,198,2251582,5,1,1,1,5026
194c56fce2e1b35b518f54ff0d2e5a1104a8126a,0,GitHub,2020-07-21 12:19:13-07:00,['b63fecb6930cd0546a938cebe91b9f506a5e47d5'],42,156,198,2251780,32,0.208333333,1,1,5026
a5ffd1ca44caf4e4117c09cb99acd42084ea0fa8,0,GitHub,2020-07-22 16:38:55+01:00,['194c56fce2e1b35b518f54ff0d2e5a1104a8126a'],596,1772,2368,2254148,35,0.606884058,1,0.842391304,5032
d9168970dd9cfd815b72db176baa62a9849fcb47,0,GitHub,2020-07-22 19:12:26+01:00,['a5ffd1ca44caf4e4117c09cb99acd42084ea0fa8'],163,694,857,2255005,11,0.275689223,1,0.513784461,5032
67f5b5de77d67c02edb335737215312d099a1cac,0,GitHub,2020-07-22 12:06:47-07:00,['d9168970dd9cfd815b72db176baa62a9849fcb47'],8,12,20,2255025,1,0,1,1,5032
6fda5e2b5fffdbc6cca55e70decffef96446860e,0,GitHub,2020-07-22 20:33:55+01:00,['67f5b5de77d67c02edb335737215312d099a1cac'],1,1,2,2255027,1,,,,5032
39cf75bd8168363f6185dcd3c66b22bf2fac4009,0,GitHub,2020-07-22 21:42:13+01:00,['6fda5e2b5fffdbc6cca55e70decffef96446860e'],24,25,49,2255076,1,,,,5032
2d791712851701bee29e373c7db607a58c3fa44a,0,GitHub,2020-07-22 19:53:51-07:00,['39cf75bd8168363f6185dcd3c66b22bf2fac4009'],7,221,228,2255304,7,1,1,1,5038
9b36de3abbf70f81437341ef1df0c14f0d8e48c4,1,Manikumar Reddy,2020-07-23 09:50:54+05:18,['2d791712851701bee29e373c7db607a58c3fa44a'],1,1,2,2255306,1,,,,5038
0b181fdde55574e818a72510e1507dce79394dc6,0,GitHub,2020-07-23 10:15:23+05:18,['9b36de3abbf70f81437341ef1df0c14f0d8e48c4'],0,2,2,2255308,1,,,,5038
0d5c967073e78e2a50ffa5bb860bff9ff43086d5,0,GitHub,2020-07-23 15:59:57-07:00,['0b181fdde55574e818a72510e1507dce79394dc6'],3,10,13,2255321,1,0,1,1,5038
1c439da590771c604ba25f4776ba9deb1670a891,0,GitHub,2020-07-24 09:33:22+08:00,['0d5c967073e78e2a50ffa5bb860bff9ff43086d5'],3,28,31,2255352,2,0,1,1,5038
fa6e5b892227db24568e2cec0a0a0969bc1ec4b5,1,GitHub,2020-07-24 12:03:10-07:00,['1c439da590771c604ba25f4776ba9deb1670a891'],4,100,104,2255456,4,0.314814815,1,1,5039
a44ac3b3cd61a968c68f398813dfa0a9e0a89994,0,GitHub,2020-07-24 15:30:20-05:00,['fa6e5b892227db24568e2cec0a0a0969bc1ec4b5'],0,25,25,2255481,2,,,,5039
91330d830d500d4d7853b04a9fdcf5a0c91d1c2c,0,GitHub,2020-07-24 15:31:44-05:00,['a44ac3b3cd61a968c68f398813dfa0a9e0a89994'],21,11,32,2255513,1,,,,5039
0ecce0d5daa67fc1abf81dc827c2a3dc3e85fcfb,0,GitHub,2020-07-24 16:22:10-07:00,['91330d830d500d4d7853b04a9fdcf5a0c91d1c2c'],12,11,23,2255536,1,,,,5039
206b69af8b1267a5022d22d1535bd1db02702be1,0,GitHub,2020-07-25 19:04:16+08:00,['0ecce0d5daa67fc1abf81dc827c2a3dc3e85fcfb'],6,16,22,2255558,2,1,1,1,5039
483fbd812d3d59bc8332eaeb12f1360a916332b3,0,GitHub,2020-07-25 08:51:51-07:00,['206b69af8b1267a5022d22d1535bd1db02702be1'],1,7,8,2255566,2,1,1,1,5039
a4b923f76f8d4557f353c8ceb98d2366cfcd86ae,0,GitHub,2020-07-25 08:54:35-07:00,['483fbd812d3d59bc8332eaeb12f1360a916332b3'],4,4,8,2255574,2,,,,5039
99472c54f01e1f654a3ccb774a7857f10d69e2e3,1,GitHub,2020-07-26 08:28:47-07:00,['a4b923f76f8d4557f353c8ceb98d2366cfcd86ae'],3,19,22,2255596,2,0,1,1,5039
0d47c69a9351ae258ad6165841840a65f0301d86,1,GitHub,2020-07-26 11:58:40-07:00,['99472c54f01e1f654a3ccb774a7857f10d69e2e3'],91,147,238,2255834,10,0.448979592,0,0.979591837,5039
6004ee9f2283163b0a36a38f41c717bd16973c0b,1,GitHub,2020-07-26 12:25:30-07:00,['0d47c69a9351ae258ad6165841840a65f0301d86'],5,9,14,2255848,1,,,,5039
f748d59d28bf5882286acef896af7805a761b760,0,GitHub,2020-07-26 16:45:16-07:00,['6004ee9f2283163b0a36a38f41c717bd16973c0b'],0,10,10,2255858,1,0,0.428571429,1,5039
24e76a94f6291c0f4430ec6a26df257673a5952e,1,GitHub,2020-07-27 03:47:19-07:00,['f748d59d28bf5882286acef896af7805a761b760'],16,16,32,2255890,2,,,,5039
11f75691b87fcecc8b29bfd25c7067e054e408ea,0,GitHub,2020-07-27 09:22:22-05:00,['24e76a94f6291c0f4430ec6a26df257673a5952e'],3,3,6,2255896,1,,,,5039
ac3a51d013dd2e4b7dcaa8a51493cbd852dcec3c,0,GitHub,2020-07-27 09:38:14-07:00,['11f75691b87fcecc8b29bfd25c7067e054e408ea'],2,1,3,2255899,1,,,,5039
659ca8f089c6b1c3a53036a8f96de7f763971fd1,0,GitHub,2020-07-27 09:57:28-07:00,['ac3a51d013dd2e4b7dcaa8a51493cbd852dcec3c'],7,5,12,2255911,1,,,,5039
3993041c7602506a8b194e3a67ac018b623a3cd8,1,GitHub,2020-07-28 13:06:49-05:00,['659ca8f089c6b1c3a53036a8f96de7f763971fd1'],125,278,403,2256314,1,,,,5039
de2e6938c8648f02254a645a8fff9c2fa8364ef1,1,GitHub,2020-07-29 11:40:14-07:00,['3993041c7602506a8b194e3a67ac018b623a3cd8'],18,413,431,2256745,7,0.22513089,0.994764398,1,5041
783a6451f5f8c50dbe151caf5e76b74917690364,0,GitHub,2020-07-29 15:38:27-07:00,['de2e6938c8648f02254a645a8fff9c2fa8364ef1'],19,48,67,2256812,3,0.142857143,1,1,5041
2f64f6deb906cdfe4d006e530edeff2e79c05f76,0,GitHub,2020-07-29 21:04:21-07:00,['783a6451f5f8c50dbe151caf5e76b74917690364'],10,39,49,2256861,2,1,1,1,5041
819cd454f9b3078515a86e43a4486794df0a7971,1,GitHub,2020-07-30 14:10:30+01:00,['2f64f6deb906cdfe4d006e530edeff2e79c05f76'],80,543,623,2257484,12,0.414285714,1,0.792857143,5043
96e0719e421a91b5fa289dc0d23276977655633e,0,GitHub,2020-07-30 09:54:37-05:00,['819cd454f9b3078515a86e43a4486794df0a7971'],18,25,43,2257527,4,1,0,1,5043
4cd2396db31418c90005c998d9107ad40df055b2,1,GitHub,2020-07-30 13:29:39-04:00,['96e0719e421a91b5fa289dc0d23276977655633e'],800,1086,1886,2259413,28,0.790697674,1,1,5048
43a8b4458d5b7f6d9a4b623cf88b2061843f360a,1,GitHub,2020-07-30 22:01:20+01:00,['4cd2396db31418c90005c998d9107ad40df055b2'],19,54,73,2259486,1,0.32,1,0.24,5048
36b273370dd840cc2bb6307f311f8952b886b323,0,Gwen Shapira,2020-07-30 19:11:56-07:00,['43a8b4458d5b7f6d9a4b623cf88b2061843f360a'],65,126,191,2259677,4,1,1,1,5048
d15cbf1ccc6ef046b85a65a2d9e375c453ca4971,0,GitHub,2020-07-30 20:32:40-07:00,['36b273370dd840cc2bb6307f311f8952b886b323'],2,0,2,2259679,1,0,0,0,5048
4e2546ab832739061092b91b65a4d554df61cc9d,0,GitHub,2020-07-31 10:20:34-07:00,['d15cbf1ccc6ef046b85a65a2d9e375c453ca4971'],0,8,8,2259687,1,,,,5048
5c2991aff66e58c4ab6a04bef85e1cac4ef8f5f6,0,GitHub,2020-08-03 10:44:42+01:00,['4e2546ab832739061092b91b65a4d554df61cc9d'],6,11,17,2259704,4,1,1,1,5048
28b7d8e21656649fb09b09f9bacfe865b0ca133c,0,GitHub,2020-08-03 11:51:20-07:00,['5c2991aff66e58c4ab6a04bef85e1cac4ef8f5f6'],1,38,39,2259743,1,,,,5048
dccc82ea9dca1c29a86dd655802d26f646615317,0,GitHub,2020-08-04 06:53:10-07:00,['28b7d8e21656649fb09b09f9bacfe865b0ca133c'],2,3,5,2259748,2,,,,5048
b06a603689ccae6af2139b67feb20fc2ae0f55e2,0,GitHub,2020-08-04 11:41:31-07:00,['dccc82ea9dca1c29a86dd655802d26f646615317'],1,6,7,2259755,1,,,,5048
fcfb71cd500403ddc318a5fec7c48ee23c18f390,1,GitHub,2020-08-04 12:20:53-07:00,['b06a603689ccae6af2139b67feb20fc2ae0f55e2'],1,1,2,2259757,1,,,,5048
1112fd47238abd0254ceb11d699478d4451278f7,0,GitHub,2020-08-04 18:04:52-05:00,['fcfb71cd500403ddc318a5fec7c48ee23c18f390'],4,1266,1270,2261027,13,0.200762389,0.557814485,0.598475222,5053
e9ebe39e7c693ef595c68cfe91ce4e3a68788e2c,0,GitHub,2020-08-04 22:07:16-07:00,['1112fd47238abd0254ceb11d699478d4451278f7'],3,8,11,2261038,3,0.5,1,0.666666667,5053
bc883cdbcfa6309116a48eb4ba1531c49e1a5d5e,0,GitHub,2020-08-05 13:38:34-07:00,['e9ebe39e7c693ef595c68cfe91ce4e3a68788e2c'],11,7,18,2261056,1,1,0,0,5053
26a217c8e75b238bbba5f1799b7d91b5b4910123,0,GitHub,2020-08-05 13:52:50-07:00,['bc883cdbcfa6309116a48eb4ba1531c49e1a5d5e'],40,74,114,2261170,16,0,0,1,5053
b351493543b7e26aa345df3b568d0dc08a8c8d91,1,GitHub,2020-08-05 14:14:18-07:00,['26a217c8e75b238bbba5f1799b7d91b5b4910123'],204,802,1006,2262176,16,0.048780488,1,0.943089431,5053
b5f90daf13b4945305951ca0eecdb454a4dcafc2,0,GitHub,2020-08-06 09:11:55-07:00,['b351493543b7e26aa345df3b568d0dc08a8c8d91'],79,467,546,2262722,12,0.424581006,0.888268156,0.893854749,5056
e7316f35d933d8bf738caa1a01e8477f74021677,1,GitHub,2020-08-06 11:15:35-07:00,['b5f90daf13b4945305951ca0eecdb454a4dcafc2'],21,54,75,2262797,5,1,1,1,5056
a5aadeb31a81428b52fdcd3b17aecee131401808,0,GitHub,2020-08-06 11:22:14-07:00,['e7316f35d933d8bf738caa1a01e8477f74021677'],2,2,4,2262801,1,,,,5056
990301323cc5a774e17b0a5d373aff8439cda489,1,GitHub,2020-08-06 11:28:07-07:00,['a5aadeb31a81428b52fdcd3b17aecee131401808'],171,272,443,2263244,11,0,1,1,5056
680e68413b4648f8539dc175f7e8dabab59ec5e3,0,Manikumar Reddy,2020-08-07 22:37:16+05:18,['990301323cc5a774e17b0a5d373aff8439cda489'],40,141,181,2263425,4,0.427350427,0.632478632,1,5056
6f0ab89b9204e86cd49d44d6b9f97ee1939c50c6,1,GitHub,2020-08-07 10:59:41-07:00,['680e68413b4648f8539dc175f7e8dabab59ec5e3'],50,95,145,2263570,2,1,0.870967742,0.64516129,5056
a4a3d7064e16d4964a5b64a114579512c22ae6d2,0,GitHub,2020-08-07 15:30:00-07:00,['6f0ab89b9204e86cd49d44d6b9f97ee1939c50c6'],26,34,60,2263630,1,0,0,0,5056
92828d53b18703000159f4dd7dc8b3170667db25,1,GitHub,2020-08-09 21:05:25-05:00,['a4a3d7064e16d4964a5b64a114579512c22ae6d2'],239,1244,1483,2265113,40,1,0.619047619,0.871794872,5063
3fdf1523a369e9e2f03e215f39c0ed987b2a16c5,0,GitHub,2020-08-10 13:09:50-07:00,['92828d53b18703000159f4dd7dc8b3170667db25'],0,6,6,2265119,1,,,,5063
c8bccdd9137c285c1fb550a961d37654470f0fda,0,GitHub,2020-08-10 13:57:47-07:00,['3fdf1523a369e9e2f03e215f39c0ed987b2a16c5'],10,11,21,2265140,1,,,,5063
3e6dcb14dd9716f07d1ba96b1b06b78e55e92de1,1,GitHub,2020-08-10 17:32:44-05:00,['c8bccdd9137c285c1fb550a961d37654470f0fda'],80,121,201,2265341,4,0,1,0.55,5063
26d620ec556e55ac7ce6b9e13c7571bb750213da,0,GitHub,2020-08-11 09:22:19-07:00,['3e6dcb14dd9716f07d1ba96b1b06b78e55e92de1'],3,3,6,2265347,3,,,,5063
7159c6ddd084717c431c94416ca9243a3ec6006e,0,GitHub,2020-08-11 15:18:33-05:00,['26d620ec556e55ac7ce6b9e13c7571bb750213da'],6,7,13,2265360,4,,,,5063
0f3622cc092b347bac903bad32898f83652087f4,0,GitHub,2020-08-11 16:38:07-07:00,['7159c6ddd084717c431c94416ca9243a3ec6006e'],39,36,75,2265435,2,0,0,0,5063
048f45ce915c55110f0cf78dd4a8ff8b46e79482,0,GitHub,2020-08-11 19:23:58-07:00,['0f3622cc092b347bac903bad32898f83652087f4'],1,1,2,2265437,1,,,,5063
7915d5e5f826a71c11e1c9183c84702410f7209a,1,GitHub,2020-08-11 20:21:41-07:00,['048f45ce915c55110f0cf78dd4a8ff8b46e79482'],362,666,1028,2266465,24,0.214659686,0.890052356,0.54973822,5063
89e12f3c6b4f37c405455d5cb0fca60f2be3ff92,1,GitHub,2020-08-12 08:29:59-07:00,['7915d5e5f826a71c11e1c9183c84702410f7209a'],12,63,75,2266540,2,1,0.627906977,0.697674419,5063
b937ec75677f8af13bf6fda686f07e9c62cdd20f,1,GitHub,2020-08-12 08:54:01-07:00,['89e12f3c6b4f37c405455d5cb0fca60f2be3ff92'],107,571,678,2267218,23,0.144329897,0.81443299,1,5064
7fed816f03ef65105e93fd18c722c506a7b4b36f,0,GitHub,2020-08-12 10:32:03-07:00,['b937ec75677f8af13bf6fda686f07e9c62cdd20f'],0,2,2,2267220,1,,,,5064
a15c1a93023e4035d43ddeae97faa1d1c991f3ef,0,GitHub,2020-08-12 23:39:21+01:00,['7fed816f03ef65105e93fd18c722c506a7b4b36f'],2,4,6,2267226,1,,,,5064
d0800b3f7c135c97ec8632c247fc02946527c0a2,1,GitHub,2020-08-12 21:20:53-07:00,['a15c1a93023e4035d43ddeae97faa1d1c991f3ef'],10,29,39,2267265,4,0.142857143,0.928571429,0.857142857,5064
3a189ad868151b71b0bdcc6ffd428a9bc25cd531,0,GitHub,2020-08-13 09:52:23-07:00,['d0800b3f7c135c97ec8632c247fc02946527c0a2'],8,348,356,2267621,8,0.59798995,0.381909548,0.904522613,5067
5645d906fa319206a9270c080926a21dfddc852a,0,GitHub,2020-08-13 14:40:40-05:00,['3a189ad868151b71b0bdcc6ffd428a9bc25cd531'],244,613,857,2268478,29,0.373913043,0.926086957,0.813043478,5069
153db488660575e8c033c3c4424211a6f567bb57,1,GitHub,2020-08-15 12:27:36-04:00,['5645d906fa319206a9270c080926a21dfddc852a'],83,224,307,2268785,5,1,1,1,5071
3397cc95626dcfe045b50c5f6ae5ec054e36a80d,0,GitHub,2020-08-16 10:30:03+01:00,['153db488660575e8c033c3c4424211a6f567bb57'],1,1,2,2268787,1,,,,5071
70f10137f998f6948b122717f87ff48006909ce3,0,GitHub,2020-08-16 10:51:28+01:00,['3397cc95626dcfe045b50c5f6ae5ec054e36a80d'],2,3,5,2268792,1,,,,5071
f7a4fe7c1447a4c0c8465e6f695ad72ea145eec9,0,GitHub,2020-08-16 11:15:41+01:00,['70f10137f998f6948b122717f87ff48006909ce3'],1,1,2,2268794,1,,,,5071
d8d9d1a559c6564a7690ddaeebaeb53a52ceec4a,0,GitHub,2020-08-16 14:43:21+01:00,['f7a4fe7c1447a4c0c8465e6f695ad72ea145eec9'],1,3,4,2268798,1,0,1,1,5071
e034fedbd369461c7a673fa877b67638c7b1d952,0,GitHub,2020-08-16 21:12:50-07:00,['d8d9d1a559c6564a7690ddaeebaeb53a52ceec4a'],22,179,201,2268999,3,0,1,0.965517241,5071
e8b2dcdee6f25e9344d52b84e86328ec616bf819,0,GitHub,2020-08-17 14:35:27+01:00,['e034fedbd369461c7a673fa877b67638c7b1d952'],195,939,1134,2270133,10,0.607296137,0.961373391,0.821888412,5073
f6c26eaa04d8eb44c8decf91bb80b621e4086e84,0,Manikumar Reddy,2020-08-18 06:59:24+05:18,['e8b2dcdee6f25e9344d52b84e86328ec616bf819'],2,2,4,2270137,2,,,,5073
077984690132c6ecfe2514359450342101437032,0,GitHub,2020-08-18 09:39:40-05:00,['f6c26eaa04d8eb44c8decf91bb80b621e4086e84'],5,20,25,2270162,3,1,1,1,5073
21dc5231ce9c7398c7ede4dbefa2f2202e06b2d4,0,GitHub,2020-08-18 13:38:59-07:00,['077984690132c6ecfe2514359450342101437032'],89,271,360,2270522,28,0.13740458,1,0.824427481,5073
b7856df21b22605eaa548d450885638932d87b26,0,GitHub,2020-08-19 13:37:27+01:00,['21dc5231ce9c7398c7ede4dbefa2f2202e06b2d4'],7,5,12,2270534,1,0,0,1,5073
dc2b7d6f8898d1d01bdda50a356ba9552c36a4d7,0,GitHub,2020-08-20 09:18:11+08:00,['b7856df21b22605eaa548d450885638932d87b26'],0,22,22,2270556,1,0.857142857,0.857142857,1,5073
9cabc8c2b3836430879b01f543d0228a2fa83775,0,GitHub,2020-08-20 20:38:07+05:18,['dc2b7d6f8898d1d01bdda50a356ba9552c36a4d7'],3,3,6,2270562,1,,,,5073
88d4bc4641064d21a481ba3b8562a4c97703d64d,0,GitHub,2020-08-20 14:06:16-05:00,['9cabc8c2b3836430879b01f543d0228a2fa83775'],355,680,1035,2271597,44,0.695652174,1,0.813664596,5075
a1db4a8010b44498962475e33c34817f3922f6e0,0,GitHub,2020-08-20 23:28:22-07:00,['88d4bc4641064d21a481ba3b8562a4c97703d64d'],6,11,17,2271614,2,0.5,0.5,0,5075
1a9697430a8a6da575fdc7e96c1aa9a5640295df,0,GitHub,2020-08-21 10:25:52-04:00,['a1db4a8010b44498962475e33c34817f3922f6e0'],52,179,231,2271845,7,0.574468085,1,0.957446809,5076
a027b9a93458f8e2b995b0786ba3cee87645f3e9,0,GitHub,2020-08-22 00:18:22+05:18,['1a9697430a8a6da575fdc7e96c1aa9a5640295df'],1,1,2,2271847,1,,,,5076
567d76c7f823aed44be6c82ab390760bdbad0387,1,GitHub,2020-08-21 12:35:34-07:00,['a027b9a93458f8e2b995b0786ba3cee87645f3e9'],296,266,562,2272409,3,0,0,0,5076
c8453e9a687f0d194d78c2ba8660a94c7628eed6,0,GitHub,2020-08-21 12:39:24-07:00,['567d76c7f823aed44be6c82ab390760bdbad0387'],0,8,8,2272417,1,,,,5076
89d06780a0f5f27a7420fc2cd8063294367f6693,1,GitHub,2020-08-21 20:29:40-05:00,['c8453e9a687f0d194d78c2ba8660a94c7628eed6'],341,1096,1437,2273854,44,0.368589744,0.915064103,0.778846154,5076
8b94e6229548cc4fc015b2dc1e756ce86b5e84bb,0,GitHub,2020-08-22 17:10:48+02:00,['89d06780a0f5f27a7420fc2cd8063294367f6693'],0,255,255,2274109,2,0.672727273,1,1,5078
8af7b96bfbffb2455191beac41ec8db4f6d24e3b,0,GitHub,2020-08-22 18:00:00+02:00,['8b94e6229548cc4fc015b2dc1e756ce86b5e84bb'],25,76,101,2274210,4,0.028571429,1,1,5078
f19cd6ca48ccd2971948c9589279bb8ee20e5d88,0,GitHub,2020-08-24 11:18:59-07:00,['8af7b96bfbffb2455191beac41ec8db4f6d24e3b'],36,15,51,2274261,2,1,0,0,5078
22bcd9fac3c988c15862d0b6c01930814b676253,0,GitHub,2020-08-24 17:37:49-07:00,['f19cd6ca48ccd2971948c9589279bb8ee20e5d88'],119,358,477,2274738,18,0.375690608,0.950276243,0.977900552,5078
d2c978c98e87bd38b525cca4368f8818d86c27fa,0,GitHub,2020-08-26 10:31:16-07:00,['22bcd9fac3c988c15862d0b6c01930814b676253'],4,4,8,2274746,2,,,,5078
b6ba67482f9365ec982f88e4b456859696099e33,1,GitHub,2020-08-26 15:10:09-07:00,['d2c978c98e87bd38b525cca4368f8818d86c27fa'],787,1105,1892,2276638,14,0.488636364,0.971590909,0.488636364,5080
9da32b6bd014f1bdeeee5da8fcd00995a5916323,0,GitHub,2020-08-27 18:04:28-05:00,['b6ba67482f9365ec982f88e4b456859696099e33'],269,640,909,2277547,23,0.762135922,1,0.95631068,5081
85b6545b8159885c57ab67e08b7185be8a607988,1,GitHub,2020-08-31 17:22:00-05:00,['9da32b6bd014f1bdeeee5da8fcd00995a5916323'],210,3005,3215,2280762,21,0.201101928,0.884848485,0.830853994,5089
d0111d3bcdc6f86d9d9daf2f75b89e32e28a7541,0,GitHub,2020-09-01 16:48:40-05:00,['85b6545b8159885c57ab67e08b7185be8a607988'],110,211,321,2281083,18,1,1,1,5090
241e1447fae8b85b3bb491f371357b8f92d2da72,0,GitHub,2020-09-01 18:12:10-04:00,['d0111d3bcdc6f86d9d9daf2f75b89e32e28a7541'],0,174,174,2281257,3,,,,5091
59206b895e9f4449df7bf03fc005b81e8504c317,0,GitHub,2020-09-02 17:58:33+08:00,['241e1447fae8b85b3bb491f371357b8f92d2da72'],1,1,2,2281259,1,,,,5091
6e8a01e18cd07e95a5a9d4c1b35e279bfe9955fe,0,GitHub,2020-09-02 17:30:00+02:00,['59206b895e9f4449df7bf03fc005b81e8504c317'],1,1,2,2281261,1,,,,5091
55c1ab62c9a05c9a5727d6229a9170bd85609791,0,GitHub,2020-09-02 17:46:24+02:00,['6e8a01e18cd07e95a5a9d4c1b35e279bfe9955fe'],2,8,10,2281271,2,,,,5091
fd02c8f07fa04b10aa8fa64b3934ce0a439aa037,0,GitHub,2020-09-02 18:04:51+02:00,['55c1ab62c9a05c9a5727d6229a9170bd85609791'],1,1,2,2281273,1,,,,5091
4662ed4aac79ed539f3a62140b8b154517837dbd,0,GitHub,2020-09-02 12:49:47-05:00,['fd02c8f07fa04b10aa8fa64b3934ce0a439aa037'],27,27,54,2281327,3,,,,5091
4f06d9e7d083c30912c810f9deadea809fd74edf,1,GitHub,2020-09-02 15:17:07-07:00,['4662ed4aac79ed539f3a62140b8b154517837dbd'],673,2367,3040,2284367,48,0.446906035,0.964858671,0.638655462,5091
24b03a688f95012d6b2e35390f889bfd465aeacb,0,GitHub,2020-09-02 17:19:39-05:00,['4f06d9e7d083c30912c810f9deadea809fd74edf'],4,4,8,2284375,1,,,,5091
c04000cab1e98c206c5410ef68d00df1d9129182,0,GitHub,2020-09-02 15:32:17-07:00,['24b03a688f95012d6b2e35390f889bfd465aeacb'],75,1225,1300,2285675,8,0.690205011,0.972665148,0.642369021,5091
1e31354557f49ab4a887aac0b71916da53b22d50,0,GitHub,2020-09-03 14:16:14-05:00,['c04000cab1e98c206c5410ef68d00df1d9129182'],4,218,222,2285897,4,0.419354839,1,1,5094
9c8501f5f0d4c1f8f4928ea98c889954f0e06cf8,0,GitHub,2020-09-03 14:18:45-05:00,['1e31354557f49ab4a887aac0b71916da53b22d50'],1,1,2,2285899,1,,,,5094
23cade850678eeae1bc1227a2a2a4bc09b02f2fc,1,GitHub,2020-09-04 17:34:31+02:00,['9c8501f5f0d4c1f8f4928ea98c889954f0e06cf8'],40,83,123,2286022,4,0,1,1,5094
c6d135e21fbd5f112477288a79501e4343b7a8b5,0,GitHub,2020-09-04 19:26:23+02:00,['23cade850678eeae1bc1227a2a2a4bc09b02f2fc'],1,34,35,2286057,1,,,,5094
e8524ccd8fca0caac79b844d87e98e9c055f76fb,1,GitHub,2020-09-04 13:05:01-07:00,['c6d135e21fbd5f112477288a79501e4343b7a8b5'],161,3534,3695,2289752,60,0.474321985,0.803231391,0.918061166,5120
d7f3505a212a8e97b39b3baae5f347bd859c87e4,0,GitHub,2020-09-08 07:11:43-07:00,['e8524ccd8fca0caac79b844d87e98e9c055f76fb'],1,1,2,2289754,1,,,,5120
d2521855b8eb8a0dbb6f94cd9bb5093276fb7db2,0,GitHub,2020-09-08 12:43:36-07:00,['d7f3505a212a8e97b39b3baae5f347bd859c87e4'],6,52,58,2289812,2,0.193548387,1,1,5120
4ea709dc454a2c2635ef65ebf835025d82f177de,0,GitHub,2020-09-09 07:44:04-07:00,['d2521855b8eb8a0dbb6f94cd9bb5093276fb7db2'],2,11,13,2289825,2,1,1,1,5120
8e9cf0e0cb1f875df27ec0cf624ad245bd780723,1,GitHub,2020-09-09 16:07:36+01:00,['4ea709dc454a2c2635ef65ebf835025d82f177de'],3,34,37,2289862,2,0.1,1,1,5120
09d1498e3065eccc26a2d396ea13e7c8b553b974,1,GitHub,2020-09-09 12:37:21-05:00,['8e9cf0e0cb1f875df27ec0cf624ad245bd780723'],444,742,1186,2291048,45,0.392857143,0,0.636904762,5120
dd2b9eca5d6eee507d3c5baaf0647554e201fe18,0,GitHub,2020-09-09 12:02:19-07:00,['09d1498e3065eccc26a2d396ea13e7c8b553b974'],73,401,474,2291522,3,0.07421875,0.72265625,0.68359375,5120
c2273adc25b2bab0a3ac95bf7844fedf2860b40b,0,GitHub,2020-09-09 14:42:37-07:00,['dd2b9eca5d6eee507d3c5baaf0647554e201fe18'],176,257,433,2291955,12,1,0.542857143,0.714285714,5121
86013dc9f8cf02813418f41c3c49c745f9ee6ea5,0,GitHub,2020-09-09 17:29:12-07:00,['c2273adc25b2bab0a3ac95bf7844fedf2860b40b'],28,64,92,2292047,2,1,1,1,5121
6bba661e24d0a133bfbccef841fcd8f1e057ef6b,1,GitHub,2020-09-10 08:50:28-07:00,['86013dc9f8cf02813418f41c3c49c745f9ee6ea5'],125,7,132,2292179,2,0.826086957,0,0,5121
e7f1cffd97fdf9f1186877cfc7e082153e483eae,0,GitHub,2020-09-10 13:27:20-07:00,['6bba661e24d0a133bfbccef841fcd8f1e057ef6b'],6,10,16,2292195,5,0,0.25,1,5121
e4eab377e1489fc0cc90edec3eeb382b1192a442,0,GitHub,2020-09-10 13:36:29-07:00,['e7f1cffd97fdf9f1186877cfc7e082153e483eae'],18,35,53,2292248,1,0,1,1,5121
5ee3ecb1e3bb4f6a8f8e344229c1a88b1d230e73,1,GitHub,2020-09-10 15:47:16-05:00,['e4eab377e1489fc0cc90edec3eeb382b1192a442'],52,89,141,2292389,2,0,0.037037037,1,5121
7e7bb184d2abe34280a7f0eb0f0d9fc0e32389f2,1,GitHub,2020-09-10 14:34:38-07:00,['5ee3ecb1e3bb4f6a8f8e344229c1a88b1d230e73'],180,228,408,2292797,10,0,0,0.722222222,5121
7d0086e0c35d827a46e82956f42af57f6a6539f1,0,GitHub,2020-09-10 16:14:38-07:00,['7e7bb184d2abe34280a7f0eb0f0d9fc0e32389f2'],422,399,821,2293618,28,1,0,0,5121
8260d7cdfbe30250e8bf4079c8f0734e1b5a203b,0,GitHub,2020-09-10 21:55:11-07:00,['7d0086e0c35d827a46e82956f42af57f6a6539f1'],6,51,57,2293675,3,,,,5122
2194ccba5b95657ff7d6a4739edc98cf70f4472b,0,GitHub,2020-09-11 16:38:17-05:00,['8260d7cdfbe30250e8bf4079c8f0734e1b5a203b'],318,605,923,2294598,7,0.277777778,0.35,0.505555556,5122
c180823bdffeca2d8145a75bfdf3d31ac233eaac,0,GitHub,2020-09-12 07:59:14-04:00,['2194ccba5b95657ff7d6a4739edc98cf70f4472b'],3,3,6,2294604,2,,,,5122
1552db7d4cd530fb04a54913ee1753005080a14b,0,GitHub,2020-09-12 08:16:25-04:00,['c180823bdffeca2d8145a75bfdf3d31ac233eaac'],3,1,4,2294608,1,0,0,0,5122
df8918b90f558486029985a78b545c1e8ee0f6e4,0,GitHub,2020-09-12 08:35:49-04:00,['1552db7d4cd530fb04a54913ee1753005080a14b'],2,2,4,2294612,1,,,,5122
96f5502774759edf1665a1b4ce763c582c7df768,0,GitHub,2020-09-14 07:47:31-07:00,['df8918b90f558486029985a78b545c1e8ee0f6e4'],1,1,2,2294614,1,,,,5122
77f6175d2e67aa4405fc08cbb6f7eee8dc5e68f0,0,GitHub,2020-09-14 10:11:03-05:00,['96f5502774759edf1665a1b4ce763c582c7df768'],4,4,8,2294622,1,,,,5122
77a0bba140cbf2b249194ac7ba962813cf69fe0c,0,GitHub,2020-09-14 08:50:45-07:00,['77f6175d2e67aa4405fc08cbb6f7eee8dc5e68f0'],26,186,212,2294834,9,0.613333333,0.613333333,0.506666667,5122
94e61c3979dbdd4884772bd41a0acca7dd5b1712,0,GitHub,2020-09-14 19:48:47+01:00,['77a0bba140cbf2b249194ac7ba962813cf69fe0c'],23,116,139,2294973,6,0.666666667,1,1,5122
ee68b999c49cbbf514940a81282ff894e6cf50d9,0,GitHub,2020-09-14 15:22:00-07:00,['94e61c3979dbdd4884772bd41a0acca7dd5b1712'],1,2,3,2294976,1,,,,5122
ebd64b5d558f5500f419e7e66499ba9ffc30dc04,0,GitHub,2020-09-14 15:56:21-07:00,['ee68b999c49cbbf514940a81282ff894e6cf50d9'],106,299,405,2295381,8,0.52,0.77,0.59,5122
12d98a3d7ad9b023c600bdbb5e3ffb42b07406b1,0,GitHub,2020-09-14 20:23:58-04:00,['ebd64b5d558f5500f419e7e66499ba9ffc30dc04'],26,21,47,2295428,1,,,,5122
a46c07ec8d8351e05cdccf55b52861b670fd1307,0,GitHub,2020-09-15 11:12:37-07:00,['12d98a3d7ad9b023c600bdbb5e3ffb42b07406b1'],1,8,9,2295437,1,1,1,0,5122
634c9175054cc69d10b6da22ea1e95edff6a4747,1,GitHub,2020-09-15 13:38:16-07:00,['a46c07ec8d8351e05cdccf55b52861b670fd1307'],145,442,587,2296024,21,0.138392857,0.776785714,0.691964286,5122
f28713f92218f41d21d5149cdc6034fa374821ca,0,GitHub,2020-09-15 16:25:19-07:00,['634c9175054cc69d10b6da22ea1e95edff6a4747'],2,54,56,2296080,1,1,1,1,5122
aa5263fba903c85812c0c31443f7d49ee371e9db,1,GitHub,2020-09-16 09:05:08-07:00,['f28713f92218f41d21d5149cdc6034fa374821ca'],46,80,126,2296206,11,1,1,0.923076923,5122
1443f24ace98aac9e15f5ec8178040f848ff3d74,1,GitHub,2020-09-17 16:44:43-04:00,['aa5263fba903c85812c0c31443f7d49ee371e9db'],10,9,19,2296225,2,,,,5122
97d1a3248a4184da1e8ef47c1b94986665b941bf,0,GitHub,2020-09-17 14:37:51-07:00,['1443f24ace98aac9e15f5ec8178040f848ff3d74'],22,60,82,2296307,6,0,1,0.736842105,5122
9fda3d206fb6b4ff58792f6dcebd9275e46427f7,0,GitHub,2020-09-18 09:56:06-05:00,['97d1a3248a4184da1e8ef47c1b94986665b941bf'],1,0,1,2296308,1,1,1,0,5122
9a32ea9e5248172bb67723165afda462fd6c53d0,0,Manikumar Reddy,2020-09-19 16:16:24+05:18,['9fda3d206fb6b4ff58792f6dcebd9275e46427f7'],0,3,3,2296311,1,1,1,1,5122
59c1d4ece309311dc670c280eea37953049ed19d,0,GitHub,2020-09-19 16:53:13+05:18,['9a32ea9e5248172bb67723165afda462fd6c53d0'],13,14,27,2296338,11,1,1,1,5122
2a27e0ddce9f4d2157522f7a9eaef234b3f24596,0,GitHub,2020-09-19 18:49:34+05:18,['59c1d4ece309311dc670c280eea37953049ed19d'],0,2,2,2296340,1,0,0,1,5122
3ef6c045e25941e2f61637eec29c6a7a06d5f00a,0,GitHub,2020-09-19 17:25:47-07:00,['2a27e0ddce9f4d2157522f7a9eaef234b3f24596'],6,4,10,2296350,1,,,,5122
aa0cd667bcd5c4025e84097192030b59165ac9d0,0,GitHub,2020-09-21 07:36:42-07:00,['3ef6c045e25941e2f61637eec29c6a7a06d5f00a'],1,1,2,2296352,1,,,,5122
4b6d8da9fd5bbc7e90c062c4d2131437183349a0,0,GitHub,2020-09-21 08:03:49-07:00,['aa0cd667bcd5c4025e84097192030b59165ac9d0'],127,286,413,2296765,8,0.558823529,1,1,5125
5cf5cc2fc0141eedc6a3204162b99ca67df27109,0,GitHub,2020-09-21 13:35:16-07:00,['4b6d8da9fd5bbc7e90c062c4d2131437183349a0'],12,47,59,2296824,2,0.541666667,1,1,5125
ac89e49bf217941d436e2160732f8c045d2a4d3b,1,GitHub,2020-09-21 16:04:19-07:00,['5cf5cc2fc0141eedc6a3204162b99ca67df27109'],111,166,277,2297101,38,1,1,0,5125
822b9c9866b5c327ad058f8812ddc1d632a72888,0,GitHub,2020-09-21 18:41:02-07:00,['ac89e49bf217941d436e2160732f8c045d2a4d3b'],0,5,5,2297106,1,,,,5125
90517d15c0fb09f09168e77aff7ad30f234b1091,1,GitHub,2020-09-22 09:20:46-05:00,['822b9c9866b5c327ad058f8812ddc1d632a72888'],75,336,411,2297517,6,0.291970803,0.299270073,0.291970803,5126
285328420c4fd9c025a34fe2ce0583136809c5db,1,GitHub,2020-09-22 11:12:25-05:00,['90517d15c0fb09f09168e77aff7ad30f234b1091'],34,97,131,2297648,2,0.456140351,0.50877193,1,5126
b7c8490cf47b0c18253d6a776b2b35c76c71c65d,1,GitHub,2020-09-22 11:32:44-07:00,['285328420c4fd9c025a34fe2ce0583136809c5db'],88,15744,15832,2313480,127,0.534705228,0.882424917,0.860622914,5211
e9251a11dc60122893c7bcfb2be36c3cd0521902,0,GitHub,2020-09-23 12:34:46+01:00,['b7c8490cf47b0c18253d6a776b2b35c76c71c65d'],6,12,18,2313498,1,0.714285714,1,1,5211
acfa0795c5dea4c1f38c30c60c30c381f998d597,0,GitHub,2020-09-23 10:02:32-05:00,['e9251a11dc60122893c7bcfb2be36c3cd0521902'],0,1,1,2313499,1,1,1,1,5211
ab44de81db774d165ff9cfd20cb17562a4a9afe9,0,GitHub,2020-09-23 09:38:53-07:00,['acfa0795c5dea4c1f38c30c60c30c381f998d597'],2,0,2,2313501,1,,,,5211
bc7674fe1bd50bfa8e6b568ab84d112412b1d3e5,0,GitHub,2020-09-23 14:24:02-07:00,['ab44de81db774d165ff9cfd20cb17562a4a9afe9'],5,14,19,2313520,4,1,1,1,5211
7abed3dbb092fdbd0c7a3afd1bd4081f2ba63bc4,0,GitHub,2020-09-23 14:36:56-07:00,['bc7674fe1bd50bfa8e6b568ab84d112412b1d3e5'],57,55,112,2313632,21,0,0.5,1,5211
51957de80606609232d5346a0aa86a945173317d,0,GitHub,2020-09-24 02:37:17-07:00,['7abed3dbb092fdbd0c7a3afd1bd4081f2ba63bc4'],107,82,189,2313821,14,0,1,0,5211
b36e3c22ab88399d439e870edaf60eea89d5c73d,0,GitHub,2020-09-24 02:46:21-07:00,['51957de80606609232d5346a0aa86a945173317d'],6,9,15,2313836,1,0,0,0,5211
785de1e3d459b26c3ce383986827719388be7c6f,1,GitHub,2020-09-24 15:53:59+02:00,['b36e3c22ab88399d439e870edaf60eea89d5c73d'],913,1124,2037,2315873,25,0,0.873720137,1,5212
bca2a4e0d36139b5816edd935537324eb2b30233,1,GitHub,2020-09-24 09:25:35-05:00,['785de1e3d459b26c3ce383986827719388be7c6f'],39,35,74,2315947,3,1,1,0,5212
57de67db22eb373f92ec5dd449d317ed2bc8b8d1,1,GitHub,2020-09-24 16:28:25-07:00,['bca2a4e0d36139b5816edd935537324eb2b30233'],201,1533,1734,2317681,35,0.348864994,0.778972521,0.864994026,5219
89485fe137588531744752bd772aabe78cd4f374,1,GitHub,2020-09-25 15:57:19+01:00,['57de67db22eb373f92ec5dd449d317ed2bc8b8d1'],11,173,184,2317865,5,0.558823529,0.941176471,1,5219
ac8acec65380bb97d1de6696c7ac870c2156c115,0,GitHub,2020-09-25 09:12:56-07:00,['89485fe137588531744752bd772aabe78cd4f374'],2,67,69,2317934,2,0,1,1,5220
466f8fd21c6651ea5daa50154239e85fa629dbb4,1,GitHub,2020-09-25 09:21:22-07:00,['ac8acec65380bb97d1de6696c7ac870c2156c115'],273,208,481,2318415,5,0.348837209,0,0,5222
dc81d442dfc5c3d8d9c069942f6b00e2de377a3c,0,GitHub,2020-09-25 13:58:04-07:00,['466f8fd21c6651ea5daa50154239e85fa629dbb4'],82,247,329,2318744,20,0.293103448,0.939655172,1,5222
bd462df20321ff5b75a7e3eae70634268582d90b,1,GitHub,2020-09-25 20:29:17-07:00,['dc81d442dfc5c3d8d9c069942f6b00e2de377a3c'],26,32,58,2318802,3,0,0,1,5222
c2789934e4e9598c3bb789ae189a67a2aeab383e,0,GitHub,2020-09-26 20:37:48-07:00,['bd462df20321ff5b75a7e3eae70634268582d90b'],0,6,6,2318808,1,,,,5222
18f70835a39381967b4d0d57effa14a91e44ac74,0,GitHub,2020-09-27 19:16:17-07:00,['c2789934e4e9598c3bb789ae189a67a2aeab383e'],1,1,2,2318810,1,,,,5222
42161236285865755f05ad698da28d3d22ff0697,0,GitHub,2020-09-27 21:04:31-07:00,['18f70835a39381967b4d0d57effa14a91e44ac74'],5,9,14,2318824,1,,,,5222
ae2304f27c5a099b52cc9dd707fc237576deada0,0,GitHub,2020-09-28 20:30:25+01:00,['42161236285865755f05ad698da28d3d22ff0697'],28,81,109,2318933,3,0.909090909,1,0.909090909,5222
340cd07bab7ea0f9caeb0cbf50987bbe38cf126f,0,GitHub,2020-09-28 14:56:36-05:00,['ae2304f27c5a099b52cc9dd707fc237576deada0'],2,16,18,2318951,2,0.916666667,1,0.916666667,5222
17fa3d92967c8d3493e4636a7e394db371afb18f,0,GitHub,2020-09-28 18:30:01-05:00,['340cd07bab7ea0f9caeb0cbf50987bbe38cf126f'],3,19,22,2318973,2,0,0.363636364,1,5222
dbe3e4a4cccce06836b59c2f3853669e008eb58f,0,GitHub,2020-09-28 17:16:55-07:00,['17fa3d92967c8d3493e4636a7e394db371afb18f'],21,38,59,2319032,6,1,1,1,5222
e98b38cb1eb2804c96b94bd13c553a1e92e793b9,0,GitHub,2020-09-29 10:32:17+02:00,['dbe3e4a4cccce06836b59c2f3853669e008eb58f'],0,5,5,2319037,1,,,,5222
a0fec75d3cee3d23bd517fe0acc65270a6cb0f88,0,GitHub,2020-09-29 15:17:37+01:00,['e98b38cb1eb2804c96b94bd13c553a1e92e793b9'],22,85,107,2319144,2,0.265306122,0.448979592,0.183673469,5222
821c1ac6641845aeca96a43bc2b946ecec5cba4f,0,GitHub,2020-09-29 12:15:08-07:00,['a0fec75d3cee3d23bd517fe0acc65270a6cb0f88'],13,17,30,2319174,3,1,1,0,5222
fda67018375ce3f6b90658e1ae9c30ab463e0240,1,GitHub,2020-09-30 06:51:02-07:00,['821c1ac6641845aeca96a43bc2b946ecec5cba4f'],7,45,52,2319226,3,0.470588235,1,1,5222
2fda4458b4d8e65cee255879f1a0a9cf858506a3,1,GitHub,2020-09-30 10:13:01-07:00,['fda67018375ce3f6b90658e1ae9c30ab463e0240'],114,70,184,2319410,6,0.434782609,0.282608696,0,5222
e1ab1433ad3530fdcde9163f1da14e18b6830f87,0,GitHub,2020-09-30 11:26:48-07:00,['2fda4458b4d8e65cee255879f1a0a9cf858506a3'],0,34,34,2319444,2,1,1,1,5222
3669cde00b5675a0242ffc1c7d3b1a691ce3191c,0,Gwen Shapira,2020-09-30 11:54:39-07:00,['e1ab1433ad3530fdcde9163f1da14e18b6830f87'],1,1,2,2319446,1,,,,5222
6e0a10b41ab1a5e68fc1d5b972a91dd43a86c40e,0,GitHub,2020-09-30 11:59:11-07:00,['3669cde00b5675a0242ffc1c7d3b1a691ce3191c'],34,67,101,2319547,3,1,1,0.619047619,5222
d1c82a9baf5f3a0d3bde3ec35157358f7a62ecc8,0,GitHub,2020-09-30 12:06:11-07:00,['6e0a10b41ab1a5e68fc1d5b972a91dd43a86c40e'],0,58,58,2319605,3,0,0.829268293,1,5222
a15387f34d142684859c2a57fcbef25edcdce25a,0,GitHub,2020-09-30 12:13:34-07:00,['d1c82a9baf5f3a0d3bde3ec35157358f7a62ecc8'],74,15,89,2319694,21,0.428571429,0,0,5222
95986a8f48da47645659556e2b03149e138d1d4e,0,GitHub,2020-09-30 20:07:23-07:00,['a15387f34d142684859c2a57fcbef25edcdce25a'],18,21,39,2319733,3,,,,5222
b8090add335903e6daf38ea99d0f94be5a5e6ed4,0,GitHub,2020-09-30 20:23:07-07:00,['95986a8f48da47645659556e2b03149e138d1d4e'],4,74,78,2319811,6,1,1,1,5222
901bf57c0825f4ae88d057a99020344b4b26baab,0,GitHub,2020-09-30 22:31:07-07:00,['b8090add335903e6daf38ea99d0f94be5a5e6ed4'],0,16,16,2319827,2,0.555555556,0.555555556,1,5222
ad17ea10890872ddd1264681d61e2c5a40382590,0,GitHub,2020-10-01 09:20:25+01:00,['901bf57c0825f4ae88d057a99020344b4b26baab'],5,21,26,2319853,3,0,1,1,5222
3bc2df7651d8b9029d2478a3f39b3b223c0532b7,0,GitHub,2020-10-01 17:57:00-07:00,['ad17ea10890872ddd1264681d61e2c5a40382590'],15,23,38,2319891,2,0,1,1,5222
57c221689998d99a200d91320a1c33d37169b7dd,1,GitHub,2020-10-02 10:59:15+02:00,['3bc2df7651d8b9029d2478a3f39b3b223c0532b7'],24,47,71,2319962,3,0,1,0.25,5222
3edb94eb231f33b42e3420541632b38fb349d9c2,0,GitHub,2020-10-02 11:09:10+02:00,['57c221689998d99a200d91320a1c33d37169b7dd'],1,33,34,2319996,2,0,1,1,5222
ca559a2dcf1a2a29f635401111c743b5da1bd81d,0,GitHub,2020-10-02 09:21:11-05:00,['3edb94eb231f33b42e3420541632b38fb349d9c2'],1,31,32,2320028,2,1,1,1,5222
6b95f1ec57c303b758f0bea4cc96943108adce2c,0,GitHub,2020-10-02 18:34:50+02:00,['ca559a2dcf1a2a29f635401111c743b5da1bd81d'],129,252,381,2320409,2,0.21875,0.6875,0.625,5222
b5aa2691e9718df65e051aa2a5a2087ff2ade39f,0,GitHub,2020-10-02 18:50:22+02:00,['6b95f1ec57c303b758f0bea4cc96943108adce2c'],1,1,2,2320411,1,,,,5222
69790a1463bafc1f63e3c288a6636b3f4586c1b4,1,GitHub,2020-10-02 18:49:12-05:00,['b5aa2691e9718df65e051aa2a5a2087ff2ade39f'],1112,1281,2393,2322804,80,0,0,1,5227
6fa9f3c97d7b6dd47eea236fc4d60b2791b6d040,0,GitHub,2020-10-05 14:06:55-05:00,['69790a1463bafc1f63e3c288a6636b3f4586c1b4'],6,9,15,2322819,1,0,1,1,5227
e0f215bbd3d1da21e97ad03c4375f4e7225b1a82,1,GitHub,2020-10-05 14:14:51-07:00,['6fa9f3c97d7b6dd47eea236fc4d60b2791b6d040'],1,38,39,2322858,2,0.2,1,1,5227
5146c5a6cb3c4f483220494b429a9fd0fdd5aeed,0,GitHub,2020-10-05 14:52:34-07:00,['e0f215bbd3d1da21e97ad03c4375f4e7225b1a82'],1,1,2,2322860,1,,,,5227
34efc057b09d90952debacdc2ac1e712493d489e,0,GitHub,2020-10-05 17:15:27-07:00,['5146c5a6cb3c4f483220494b429a9fd0fdd5aeed'],9,14,23,2322883,2,,,,5227
06a5a68a933a2f03619382f191c53720f8359e72,0,GitHub,2020-10-05 17:24:44-07:00,['34efc057b09d90952debacdc2ac1e712493d489e'],1,135,136,2323019,2,0,0.949152542,1,5227
b8410a4df01f1a0d8fa107495019a234b45920b7,0,GitHub,2020-10-06 09:13:35+01:00,['06a5a68a933a2f03619382f191c53720f8359e72'],2,3,5,2323024,1,0,1,1,5227
28d736b6f474bb49fcbb3f8f9780ba861a7b8cc2,0,GitHub,2020-10-06 07:40:15-07:00,['b8410a4df01f1a0d8fa107495019a234b45920b7'],0,7,7,2323031,1,,,,5227
c77183dbb323d1aa4b72ebcfedeac9947c3c76d0,0,GitHub,2020-10-06 10:50:06-04:00,['28d736b6f474bb49fcbb3f8f9780ba861a7b8cc2'],65,358,423,2323454,3,0.56626506,1,0.746987952,5228
53a35c1de3970513e75517fb4e776c961dc2aff5,0,GitHub,2020-10-06 09:09:54-07:00,['c77183dbb323d1aa4b72ebcfedeac9947c3c76d0'],41,53,94,2323548,6,0,1,1,5229
05f9803d72ba2eeedd10901ebf3a39ed2240f092,0,GitHub,2020-10-06 10:11:56-07:00,['53a35c1de3970513e75517fb4e776c961dc2aff5'],119,118,237,2323785,4,0,1,0,5229
7be8bd8cbfea5cc19f815a142c4689e97728ea4b,1,GitHub,2020-10-06 19:13:43+01:00,['05f9803d72ba2eeedd10901ebf3a39ed2240f092'],268,1286,1554,2325339,16,0.435251799,0.627697842,0.746402878,5230
4c6b96296db0d5fea2e7cf85ac14c9cc783b8d54,1,GitHub,2020-10-06 13:18:54-05:00,['7be8bd8cbfea5cc19f815a142c4689e97728ea4b'],0,57,57,2325396,2,0.119047619,1,0.976190476,5230
5a5d1c34b9669d8f121336ad3b427a3314a7dab5,0,GitHub,2020-10-06 11:21:23-07:00,['4c6b96296db0d5fea2e7cf85ac14c9cc783b8d54'],4,10,14,2325410,1,1,1,0.3,5230
af27c2ddfc87ece60d8b4e4e16e14d1fbc3c4ba4,0,GitHub,2020-10-06 13:02:52-07:00,['5a5d1c34b9669d8f121336ad3b427a3314a7dab5'],1,1,2,2325412,1,,,,5230
75e53585255a0c2737dee84ddbad39094c5e8500,1,Ismael Juma,2020-10-07 07:12:16-07:00,['af27c2ddfc87ece60d8b4e4e16e14d1fbc3c4ba4'],45,7,52,2325464,3,0.529411765,0,0,5230
218135a4a1ccf7bf91f8e818cc5b24151e664d8d,0,GitHub,2020-10-07 09:27:17-07:00,['75e53585255a0c2737dee84ddbad39094c5e8500'],1,0,1,2325465,1,,,,5230
40a23cc0c2e1efa8632f59b093672221a3c03c36,1,GitHub,2020-10-07 09:34:39-07:00,['218135a4a1ccf7bf91f8e818cc5b24151e664d8d'],2,69,71,2325536,3,1,1,1,5231
4e65030e055104a7526e85b563a11890c61d6ddf,0,GitHub,2020-10-07 09:41:30-07:00,['40a23cc0c2e1efa8632f59b093672221a3c03c36'],105,93,198,2325734,47,1,1,1,5231
fb4f297207ef62f71e4a6d2d0dac75752933043d,1,GitHub,2020-10-07 10:23:16-07:00,['4e65030e055104a7526e85b563a11890c61d6ddf'],359,3005,3364,2329098,46,0.435623749,0.755837225,0.934623082,5247
a8b5f5a430412aa6536beb2a93237a1b768693c5,0,GitHub,2020-10-07 11:20:06-07:00,['fb4f297207ef62f71e4a6d2d0dac75752933043d'],0,45,45,2329143,3,0.837837838,0.837837838,1,5247
65c29a9dec3c8b14775344c2edf5c929ec5d1694,1,GitHub,2020-10-07 12:17:47-07:00,['a8b5f5a430412aa6536beb2a93237a1b768693c5'],9,152,161,2329304,8,0.663043478,1,0.641304348,5247
250c71b532605172693ada6ac93a68909fe0b2b6,0,GitHub,2020-10-07 15:48:35-07:00,['65c29a9dec3c8b14775344c2edf5c929ec5d1694'],1,34,35,2329339,2,0,1,1,5247
8d4bbf22ad1918dd03300fa48221b71563286f8e,0,GitHub,2020-10-07 19:08:31-07:00,['250c71b532605172693ada6ac93a68909fe0b2b6'],25,182,207,2329546,25,0.475806452,1,0.951612903,5247
2804257fe221f37e5098bd3f633a5d76ca890634,1,GitHub,2020-10-07 23:06:53-05:00,['8d4bbf22ad1918dd03300fa48221b71563286f8e'],110,877,987,2330533,71,0.717391304,1,1,5247
4d3036bb4ee6356e3022ea67354f827e960ef32f,0,bill,2020-10-08 07:47:36-04:00,['2804257fe221f37e5098bd3f633a5d76ca890634'],10,10,20,2330553,8,,,,5247
d0e6943bdd048aa6e0a4dbbdad3c8da460db16dc,1,GitHub,2020-10-08 08:08:24-05:00,['4d3036bb4ee6356e3022ea67354f827e960ef32f'],152,2095,2247,2332800,19,0.368676369,0.96049896,0.744975745,5249
68401a40b208d3977afa225b67e6a8a60b319dc7,0,GitHub,2020-10-08 16:10:08+02:00,['d0e6943bdd048aa6e0a4dbbdad3c8da460db16dc'],60,0,60,2332860,2,0,0,0,5249
de546ba827d7e8286e4157e83ee271a7b3681d6b,0,GitHub,2020-10-08 16:58:50+02:00,['68401a40b208d3977afa225b67e6a8a60b319dc7'],3,3,6,2332866,3,,,,5249
de4183485b0be534738010b19944edf3388cf49b,0,GitHub,2020-10-08 10:05:29-07:00,['de546ba827d7e8286e4157e83ee271a7b3681d6b'],24,28,52,2332918,3,0,0,,5249
cc54000e722f2b258ad6e04643189327bebc5b77,1,GitHub,2020-10-08 10:12:33-07:00,['de4183485b0be534738010b19944edf3388cf49b'],90,79,169,2333087,10,1,1,0,5249
5fc3f73f087a0c85a79e39a9a4b85e827c570c2d,1,GitHub,2020-10-08 12:20:21-07:00,['cc54000e722f2b258ad6e04643189327bebc5b77'],3,16,19,2333106,4,0,0.153846154,0.692307692,5249
4ab72780dd95c788a3b4fc22906543ae7cf1948d,0,Gwen Shapira,2020-10-08 15:54:59-07:00,['5fc3f73f087a0c85a79e39a9a4b85e827c570c2d'],34,34,68,2333174,10,,,,5249
7947c18b5788fd12841de649a662336f7d3d14d8,0,Gwen Shapira,2020-10-08 17:05:15-07:00,['4ab72780dd95c788a3b4fc22906543ae7cf1948d'],8,8,16,2333190,3,,,,5249
147a19036ee4bce9091575f23e1338527c618290,0,GitHub,2020-10-09 15:34:53+01:00,['7947c18b5788fd12841de649a662336f7d3d14d8'],155,223,378,2333568,5,0,0,0.272727273,5249
46e48d7f22c274768bbbb24cda3cc7765e71ae18,0,GitHub,2020-10-09 10:25:54-07:00,['147a19036ee4bce9091575f23e1338527c618290'],0,17,17,2333585,1,1,1,1,5249
24290de82821d16f7d163d086f5cfa88cec2b976,1,GitHub,2020-10-09 14:25:01-07:00,['46e48d7f22c274768bbbb24cda3cc7765e71ae18'],134,344,478,2334063,6,0.30952381,0.833333333,0.988095238,5249
a73bf5931aaf1510f0efa86bc7d61ff8aab046c2,0,GitHub,2020-10-10 11:34:45+08:00,['24290de82821d16f7d163d086f5cfa88cec2b976'],8,8,16,2334079,1,,,,5249
1f8ac6e6fee3aa404fc1a4c01ac2e0c48429a306,1,GitHub,2020-10-12 09:34:32-05:00,['a73bf5931aaf1510f0efa86bc7d61ff8aab046c2'],118,295,413,2334492,19,0,0.859259259,0.822222222,5249
0a93d2b1af68ebe4601802cb366f57f20eb2a466,0,GitHub,2020-10-12 11:42:42-05:00,['1f8ac6e6fee3aa404fc1a4c01ac2e0c48429a306'],1,14,15,2334507,2,1,1,1,5249
aba9036eb681597911343510e246de4fc547a479,1,GitHub,2020-10-12 12:36:46-07:00,['0a93d2b1af68ebe4601802cb366f57f20eb2a466'],190,333,523,2335030,5,0.639175258,1,1,5249
1457cc65254d1e67f8b54c49a5590dfa0db8dbb6,0,GitHub,2020-10-13 10:06:47+08:00,['aba9036eb681597911343510e246de4fc547a479'],1,1,2,2335032,1,,,,5249
a72f0c1eac67d531a4725d3e48dcab4dce361b95,0,GitHub,2020-10-13 08:59:02-07:00,['1457cc65254d1e67f8b54c49a5590dfa0db8dbb6'],135,191,326,2335358,12,0.96,0.4,1,5249
27b0e35e7a98f94c341a10a58e20dee177054712,0,GitHub,2020-10-13 11:15:22-05:00,['a72f0c1eac67d531a4725d3e48dcab4dce361b95'],118,1184,1302,2336660,11,0.368686869,0.622895623,0.920875421,5252
40ad4fe0ae9c687ed3c4d35fb5f5830cb1a867b8,0,GitHub,2020-10-13 11:19:05-07:00,['27b0e35e7a98f94c341a10a58e20dee177054712'],31,158,189,2336849,7,0.75,0.543478261,0.434782609,5252
f46d4f4fce341326c06c0aa8b2d0d64982573658,0,Gwen Shapira,2020-10-13 12:33:05-07:00,['40ad4fe0ae9c687ed3c4d35fb5f5830cb1a867b8'],22,291,313,2337162,5,0.5,0.847222222,1,5254
0c044a77cb6a93130bf2f357f478c00344e0aad6,1,Gwen Shapira,2020-10-13 12:36:52-07:00,['f46d4f4fce341326c06c0aa8b2d0d64982573658'],25,25,50,2337212,7,,,,5254
26e9058aa0426102117aa00f1bbb41fae66ff4ed,0,Gwen Shapira,2020-10-13 14:52:04-07:00,['0c044a77cb6a93130bf2f357f478c00344e0aad6'],17,17,34,2337246,4,,,,5254
eab61cad2c418786ab5e58aa1267f689d82a61d1,0,GitHub,2020-10-13 18:13:44-05:00,['26e9058aa0426102117aa00f1bbb41fae66ff4ed'],15,69,84,2337330,2,0.419354839,1,1,5254
8118b6c9f9c3a8cc77dca2f6a516254f03a43d5e,1,GitHub,2020-10-13 17:53:47-07:00,['eab61cad2c418786ab5e58aa1267f689d82a61d1'],40,139,179,2337509,3,0.104166667,0.770833333,0.770833333,5254
7e9dec707dab344ceabf36346d1611bae1f20a8e,0,GitHub,2020-10-13 22:23:43-07:00,['8118b6c9f9c3a8cc77dca2f6a516254f03a43d5e'],0,2,2,2337511,1,,,,5254
7f9beeaaafdb1bc74a5f0c1386f7e01f5f831d6b,0,GitHub,2020-10-14 14:53:30-07:00,['7e9dec707dab344ceabf36346d1611bae1f20a8e'],3,24,27,2337538,2,0,1,1,5254
da6871943f911bb38a98bd4551f1faf824dec890,1,GitHub,2020-10-14 20:16:24-07:00,['7f9beeaaafdb1bc74a5f0c1386f7e01f5f831d6b'],3,2,5,2337543,1,1,0,0,5254
88862cc84845f3260edfecdd95903673c361605f,0,GitHub,2020-10-14 23:30:42-07:00,['da6871943f911bb38a98bd4551f1faf824dec890'],2,2,4,2337547,1,,,,5254
ebe6595c3dfcd0cc68e14c013868587e54350302,0,GitHub,2020-10-15 07:54:43-07:00,['88862cc84845f3260edfecdd95903673c361605f'],4,4,8,2337555,3,,,,5254
1636481c5f653ca7c2790a9e5b05474abf36046f,0,GitHub,2020-10-15 17:08:42+01:00,['ebe6595c3dfcd0cc68e14c013868587e54350302'],1,2,3,2337558,1,1,1,0,5254
c40985049fd02601913c95a71fcaa2481d57d403,0,GitHub,2020-10-15 10:01:51-07:00,['1636481c5f653ca7c2790a9e5b05474abf36046f'],51,70,121,2337679,2,1,0.909090909,0,5254
236daf294dd844b1273f2f5af7ba60cbd428af41,1,GitHub,2020-10-15 10:08:55-07:00,['c40985049fd02601913c95a71fcaa2481d57d403'],0,6,6,2337685,3,0.666666667,1,0.833333333,5254
b752097f849cef17d5ffcbaec1d56f32825167da,0,GitHub,2020-10-15 10:23:05-07:00,['236daf294dd844b1273f2f5af7ba60cbd428af41'],0,2,2,2337687,1,1,1,1,5254
c217788e699db66ba1aa2e6e9d48d1ca92a19625,0,GitHub,2020-10-15 11:14:54-07:00,['b752097f849cef17d5ffcbaec1d56f32825167da'],2,5,7,2337694,1,0,1,1,5254
775a08876a636cc9f4b6cfd89e305b8becf44670,0,GitHub,2020-10-15 11:54:46-07:00,['c217788e699db66ba1aa2e6e9d48d1ca92a19625'],11,120,131,2337825,2,0.070588235,0.070588235,0.929411765,5254
a85802faa1d5e050e921e35739b7aefe43b0f372,0,GitHub,2020-10-15 15:10:21-07:00,['775a08876a636cc9f4b6cfd89e305b8becf44670'],88,2,90,2337915,2,1,0,0,5254
e8ad80ebe152a2ae55272b538282e407acab5cc4,0,GitHub,2020-10-15 16:10:27-07:00,['a85802faa1d5e050e921e35739b7aefe43b0f372'],269,153,422,2338337,13,0.686440678,0.398305085,0.008474576,5255
fcc7c2de391cadad8edecb108d978ea50afd428d,1,GitHub,2020-10-16 09:58:01+01:00,['e8ad80ebe152a2ae55272b538282e407acab5cc4'],16,144,160,2338497,5,0.161904762,0.866666667,0.971428571,5255
432be58a7cd16fd3a1d214e876ed6e0f0426b1ec,0,GitHub,2020-10-16 09:10:41-05:00,['fcc7c2de391cadad8edecb108d978ea50afd428d'],4,4,8,2338505,2,,,,5255
9e0bf0bd2a1a2ce3bb667b0568732ec2c7cdb39b,0,GitHub,2020-10-16 09:14:43-05:00,['432be58a7cd16fd3a1d214e876ed6e0f0426b1ec'],2,173,175,2338680,2,0.205479452,1,0.869863014,5255
cf202cb6acf38c64a3e8b9e541673a12ee55eaaa,0,GitHub,2020-10-16 18:17:03+02:00,['9e0bf0bd2a1a2ce3bb667b0568732ec2c7cdb39b'],11,142,153,2338833,3,0.771428571,1,1,5255
50bcb34d8dd8bf97fe0cf9b9faccf705054b8c8b,0,GitHub,2020-10-18 21:29:13+08:00,['cf202cb6acf38c64a3e8b9e541673a12ee55eaaa'],11,12,23,2338856,2,,,,5255
7d7b92b3aedab9c9955cde484e3f9d4782da0021,0,GitHub,2020-10-18 22:16:52+08:00,['50bcb34d8dd8bf97fe0cf9b9faccf705054b8c8b'],1,1,2,2338858,1,,,,5255
d841b912d18fdb83aaab9f32366cab9198c12656,1,GitHub,2020-10-18 23:19:49+08:00,['7d7b92b3aedab9c9955cde484e3f9d4782da0021'],2,2,4,2338862,1,,,,5255
d71fd8857ca5a7faa1cf01061cf66c5644b9df2d,0,GitHub,2020-10-19 15:53:48+08:00,['d841b912d18fdb83aaab9f32366cab9198c12656'],0,6,6,2338868,2,,,,5255
270881cd65fa9d6e12c4a6b755c5abe2ae852dc1,1,GitHub,2020-10-19 10:51:44-05:00,['d71fd8857ca5a7faa1cf01061cf66c5644b9df2d'],16,67,83,2338951,2,0.033333333,1,1,5255
d99fe49234d94bbd7893c130edbb8c7138a180c2,0,GitHub,2020-10-19 09:24:26-07:00,['270881cd65fa9d6e12c4a6b755c5abe2ae852dc1'],0,669,669,2339620,3,0.143222506,0.588235294,1,5258
2db67db8e1329cb2e047322cff81d97ff98b4328,0,GitHub,2020-10-19 17:54:47+01:00,['d99fe49234d94bbd7893c130edbb8c7138a180c2'],4,4,8,2339628,1,,,,5258
aef6cd6e9995b42db2cefa7d715321d0edee5628,1,GitHub,2020-10-19 11:07:56-07:00,['2db67db8e1329cb2e047322cff81d97ff98b4328'],209,400,609,2340237,15,0,0.41875,1,5258
4d14d6a96c952a3e71a3b8e1c6d9c68e8dd4568b,0,GitHub,2020-10-19 13:29:35-05:00,['aef6cd6e9995b42db2cefa7d715321d0edee5628'],28,108,136,2340373,11,0.683333333,0.466666667,0.816666667,5258
fd71e1355b06bb644454728a887feb1c962917fa,0,GitHub,2020-10-19 21:15:30+02:00,['4d14d6a96c952a3e71a3b8e1c6d9c68e8dd4568b'],1,1,2,2340375,1,,,,5258
659b05f78a500aa5bf9cfb482a1df0fce8a46101,0,GitHub,2020-10-19 15:29:27-05:00,['fd71e1355b06bb644454728a887feb1c962917fa'],35,49,84,2340459,7,1,0,0,5258
8339d78ad2ded67bd2c8fcbe1989c9c842c5add7,0,GitHub,2020-10-20 10:54:14+08:00,['659b05f78a500aa5bf9cfb482a1df0fce8a46101'],5,6,11,2340470,2,0,1,1,5258
8f96c3450feaf40758bb968833475ee2c3ef20c3,0,GitHub,2020-10-20 13:58:02+08:00,['8339d78ad2ded67bd2c8fcbe1989c9c842c5add7'],1,0,1,2340471,1,0,0,0,5258
e3d6344ed7feadae119a57ce658fe7dc0505ca06,0,GitHub,2020-10-20 08:36:22+02:00,['8f96c3450feaf40758bb968833475ee2c3ef20c3'],7,6,13,2340484,3,,,,5258
f8e3b84ec068a9678c5389df11c74ad8ebf886f4,1,GitHub,2020-10-20 10:15:01+01:00,['e3d6344ed7feadae119a57ce658fe7dc0505ca06'],15,43,58,2340542,3,0.904761905,1,0.952380952,5258
c7f19aba37150371c7fbaa41e3480c85f564beb4,0,GitHub,2020-10-20 13:13:50+01:00,['f8e3b84ec068a9678c5389df11c74ad8ebf886f4'],3,3,6,2340548,1,,,,5258
60d002f9ebfe8576dc900acfac97bcd29a3d2973,0,GitHub,2020-10-20 09:15:14-05:00,['c7f19aba37150371c7fbaa41e3480c85f564beb4'],126,239,365,2340913,8,0.327272727,1,1,5258
850e9922c142b69d159e4922308a8bb76977b488,0,GitHub,2020-10-20 22:17:56+08:00,['60d002f9ebfe8576dc900acfac97bcd29a3d2973'],4,4,8,2340921,1,,,,5258
f38ebbaa5be33c4286024cb86f898aa294ebecd0,0,GitHub,2020-10-20 09:05:30-07:00,['850e9922c142b69d159e4922308a8bb76977b488'],31,29,60,2340981,1,1,1,0,5258
78ac5a4003851b6910c44143ab3a8342f6ab31fb,0,GitHub,2020-10-20 21:15:11+02:00,['f38ebbaa5be33c4286024cb86f898aa294ebecd0'],12,15,27,2341008,1,1,1,1,5258
aebd5d9df0652b1d4f28f2c136a08130898f021f,0,GitHub,2020-10-20 21:24:55+02:00,['78ac5a4003851b6910c44143ab3a8342f6ab31fb'],3,7,10,2341018,1,0,0,1,5258
b6ce9d68627bda904924ba2dce5c334a2c615e18,0,GitHub,2020-10-20 15:46:31-04:00,['aebd5d9df0652b1d4f28f2c136a08130898f021f'],3,3,6,2341024,3,,,,5258
bb47519a42cd3cf157aa5be4687ff4592a3faee4,0,GitHub,2020-10-20 17:03:39-05:00,['b6ce9d68627bda904924ba2dce5c334a2c615e18'],174,542,716,2341740,17,0.879581152,1,0.570680628,5261
d87cd00f5acc3d48181b4b9f084bbc638184c903,1,GitHub,2020-10-20 18:39:37-04:00,['bb47519a42cd3cf157aa5be4687ff4592a3faee4'],1,272,273,2342013,3,0.436619718,0.985915493,0.732394366,5262
50a5671135df80209ea3c781acf9d77456b6b88c,0,GitHub,2020-10-20 19:30:49-04:00,['d87cd00f5acc3d48181b4b9f084bbc638184c903'],10,10,20,2342033,6,,,,5262
c3c65de3f0c655d92b242d49f3ce63398c27fd3e,0,GitHub,2020-10-20 19:16:23-07:00,['50a5671135df80209ea3c781acf9d77456b6b88c'],0,2,2,2342035,1,0,1,1,5262
df3d287b426fc21af4ddaa4f97334e454619a869,0,GitHub,2020-10-21 10:59:18+08:00,['c3c65de3f0c655d92b242d49f3ce63398c27fd3e'],10,0,10,2342045,1,0,0,0,5262
fc4710e2da81dae4becbfa5ff0f43d82250870fe,0,GitHub,2020-10-20 20:38:24-07:00,['df3d287b426fc21af4ddaa4f97334e454619a869'],1,1,2,2342047,1,,,,5262
67bc4f08feb50ac135a4d8e1d469747102aad3a6,0,GitHub,2020-10-21 10:17:12+01:00,['fc4710e2da81dae4becbfa5ff0f43d82250870fe'],21,216,237,2342284,12,0.97260274,0.97260274,0.98630137,5264
5dc94b1ff4fc580c240def5bd65daef3840041e0,0,GitHub,2020-10-21 09:06:25-07:00,['67bc4f08feb50ac135a4d8e1d469747102aad3a6'],77,226,303,2342587,5,0.052631579,1,0.99122807,5264
1d26391368d146fc0b7be9abfcf98d3475d7a834,1,GitHub,2020-10-21 12:07:27-07:00,['5dc94b1ff4fc580c240def5bd65daef3840041e0'],13,289,302,2342889,4,0.299401198,0.754491018,0.964071856,5265
42ce00fdd614e2c10b92e51ef67a2eeadc8bdcd2,0,GitHub,2020-10-22 16:36:41+08:00,['1d26391368d146fc0b7be9abfcf98d3475d7a834'],4,1,5,2342894,1,0,0,0,5265
94ccd4d25efd8f35183ca827da40c275b60c67bc,0,GitHub,2020-10-22 16:42:53+08:00,['42ce00fdd614e2c10b92e51ef67a2eeadc8bdcd2'],1,1,2,2342896,1,,,,5265
c283886b8edf65d1bf9fb10b5288929152d82af6,0,GitHub,2020-10-22 17:02:13+08:00,['94ccd4d25efd8f35183ca827da40c275b60c67bc'],19,51,70,2342966,3,0.578947368,1,1,5265
47933088decc1bb33374b020e8f23ab7947285f2,0,GitHub,2020-10-22 20:19:05+08:00,['c283886b8edf65d1bf9fb10b5288929152d82af6'],4,63,67,2343033,1,,,,5265
58bd0a6ee383b54ad8f1f9c7213d0978108150b8,0,GitHub,2020-10-22 08:19:01-05:00,['47933088decc1bb33374b020e8f23ab7947285f2'],69,55,124,2343157,15,1,1,0,5265
7ca299b8c0f2f3256c40b694078e422350c20d19,1,GitHub,2020-10-22 09:55:52-05:00,['58bd0a6ee383b54ad8f1f9c7213d0978108150b8'],22,157,179,2343336,2,0.119565217,0.369565217,0.565217391,5265
17e30a8dbcca1493a5c27c0c576d5a12eb20bf03,0,GitHub,2020-10-22 14:23:01-05:00,['7ca299b8c0f2f3256c40b694078e422350c20d19'],0,51,51,2343387,2,0.393939394,1,1,5265
714d125772a1e18dc8ce3e582a15792e3cfdcb97,0,GitHub,2020-10-22 17:57:41-04:00,['17e30a8dbcca1493a5c27c0c576d5a12eb20bf03'],7,54,61,2343448,2,,,,5265
8acbd85e1d369e950f8c81894dfebb6ac09bd0f8,0,GitHub,2020-10-22 17:51:05-07:00,['714d125772a1e18dc8ce3e582a15792e3cfdcb97'],21,16,37,2343485,2,,,,5265
94820ca652aceccef5f617e6ca139d139fa25a1b,1,GitHub,2020-10-22 18:14:27-07:00,['8acbd85e1d369e950f8c81894dfebb6ac09bd0f8'],1368,1610,2978,2346463,2,0,1,0.891156463,5266
c8c1baf4e1ee292b638e5c22fb32f18616cc8a42,0,Manikumar Reddy,2020-10-25 00:57:16+05:18,['94820ca652aceccef5f617e6ca139d139fa25a1b'],5,5,10,2346473,2,,,,5266
36493efa59465abee43dcd6d7ec63399947f25d6,0,Manikumar Reddy,2020-10-25 14:33:05+05:18,['c8c1baf4e1ee292b638e5c22fb32f18616cc8a42'],1,1,2,2346475,1,,,,5266
3bfbe682a2246313d126045f2c5e1a0c2577bbd2,0,GitHub,2020-10-26 13:06:56+08:00,['36493efa59465abee43dcd6d7ec63399947f25d6'],6,2,8,2346483,1,0,0,0,5266
25c10c8722bff22121f5d011f773e3af9b1b4fe0,0,GitHub,2020-10-26 17:22:04+01:00,['3bfbe682a2246313d126045f2c5e1a0c2577bbd2'],41,61,102,2346585,2,0,0,1,5266
8f02b92fcf1bf33609cbe01ffdec5ba63e1023dc,0,GitHub,2020-10-26 17:28:03+01:00,['25c10c8722bff22121f5d011f773e3af9b1b4fe0'],1,14,15,2346600,2,1,1,1,5266
f1a7097ccd79ecba2c0640766d64ba0f1e3e313d,0,GitHub,2020-10-26 14:24:05-07:00,['8f02b92fcf1bf33609cbe01ffdec5ba63e1023dc'],6,30,36,2346636,2,0.357142857,0.642857143,1,5266
94d21e3f8a64ea09449d7c4ce0e3eb4423dec369,0,GitHub,2020-10-26 20:44:25-04:00,['f1a7097ccd79ecba2c0640766d64ba0f1e3e313d'],5,13,18,2346654,1,,,,5266
c2737ee9ebe1f9f0a1aa7860fd212ce1b0ca59ea,1,GitHub,2020-10-27 17:45:11+08:00,['94d21e3f8a64ea09449d7c4ce0e3eb4423dec369'],203,197,400,2347054,1,1,0.666666667,1,5266
aa287acb2eed07cf6d75c10e71f051f538a57872,1,GitHub,2020-10-27 11:11:24+01:00,['c2737ee9ebe1f9f0a1aa7860fd212ce1b0ca59ea'],1,38,39,2347093,2,0.344827586,1,1,5266
81465a1951c18d458345ba9acb07eeacf869c17f,0,GitHub,2020-10-27 14:35:02-04:00,['aa287acb2eed07cf6d75c10e71f051f538a57872'],0,9,9,2347102,1,,,,5266
927edfece3db8aab7d01850955f9a65e5c110da5,1,GitHub,2020-10-27 12:10:13-07:00,['81465a1951c18d458345ba9acb07eeacf869c17f'],706,2417,3123,2350225,33,0.558089034,1,0.852334419,5275
d5c77695a2a26f0103853e2401ae93018a1accf8,0,GitHub,2020-10-27 19:35:33-04:00,['927edfece3db8aab7d01850955f9a65e5c110da5'],0,4,4,2350229,1,,,,5275
b4100d4b2898df070450b7326f32303f834f8e09,0,GitHub,2020-10-27 16:41:00-07:00,['d5c77695a2a26f0103853e2401ae93018a1accf8'],2,2,4,2350233,1,,,,5275
35deb2f7c4a735924b6452c6c60016fbe7dc54e0,0,GitHub,2020-10-28 11:29:12-07:00,['b4100d4b2898df070450b7326f32303f834f8e09'],1,3,4,2350237,1,1,1,1,5275
51c8c69e3a039f41b85912469207bd11a56bb04d,0,GitHub,2020-10-29 10:08:00+08:00,['35deb2f7c4a735924b6452c6c60016fbe7dc54e0'],3,3,6,2350243,1,,,,5275
9f26906fcc2fd095b7d27c504e342b9a8d619b4b,1,GitHub,2020-10-28 22:57:10-07:00,['51c8c69e3a039f41b85912469207bd11a56bb04d'],266,71,337,2350580,28,0.779310345,0,0.15862069,5275
933a813950b1ae06e19ead23734fa6bdf1f32e3f,1,GitHub,2020-10-29 11:57:31-05:00,['9f26906fcc2fd095b7d27c504e342b9a8d619b4b'],102,165,267,2350847,2,0.28,0.56,1,5275
dc4d3ecbb664ce928e5929be155c85b1b6bcc954,0,GitHub,2020-10-29 12:23:55-05:00,['933a813950b1ae06e19ead23734fa6bdf1f32e3f'],8,12,20,2350867,1,0.333333333,1,1,5275
a85b9440118ae5aa442d2e1e70b379841f941ddc,0,GitHub,2020-10-29 16:10:30-07:00,['dc4d3ecbb664ce928e5929be155c85b1b6bcc954'],15,19,34,2350901,1,0,0,0,5275
cf78fbe41ed387e08dcb1b071c28f6dea03a5778,0,GitHub,2020-10-29 16:45:43-07:00,['a85b9440118ae5aa442d2e1e70b379841f941ddc'],12,29,41,2350942,4,0.888888889,1,1,5275
328c58f94ab2231b3842f8cc587200db498e2580,0,GitHub,2020-10-30 11:37:44+01:00,['cf78fbe41ed387e08dcb1b071c28f6dea03a5778'],0,2,2,2350944,1,0,0,0,5275
92e947c3a11409e830fe2cc145c01973a11da756,0,GitHub,2020-10-30 13:28:31-07:00,['328c58f94ab2231b3842f8cc587200db498e2580'],2,23,25,2350969,2,0.916666667,1,1,5275
c75fd668751e7852f151661976bfaaae807d1cfe,0,GitHub,2020-10-30 13:36:35-07:00,['92e947c3a11409e830fe2cc145c01973a11da756'],9,61,70,2351039,2,0,1,1,5275
a8247023a7c07dd62f9534e075ffbfd025dde3d4,0,GitHub,2020-10-30 17:29:10-04:00,['c75fd668751e7852f151661976bfaaae807d1cfe'],1,1,2,2351041,1,,,,5275
d39382d3e23bc4f6e3de239fe7b96c54a4aef490,0,GitHub,2020-10-31 07:52:14-04:00,['a8247023a7c07dd62f9534e075ffbfd025dde3d4'],29,151,180,2351221,2,,,,5275
ee1aa070367829e7670b6ca705398e82c6c6514e,0,GitHub,2020-10-31 13:43:13+01:00,['d39382d3e23bc4f6e3de239fe7b96c54a4aef490'],2,3,5,2351226,1,1,1,1,5275
d7aaa7007c30bb30e1d092f7a0b312b501b8e41a,0,GitHub,2020-11-02 13:21:52+08:00,['ee1aa070367829e7670b6ca705398e82c6c6514e'],2,0,2,2351228,1,1,1,1,5275
236d7dc890e82c9b146579a8be801c1c7f54feb9,0,Manikumar Reddy,2020-11-02 23:27:03+05:18,['d7aaa7007c30bb30e1d092f7a0b312b501b8e41a'],15,32,47,2351275,3,0,1,0.625,5275
be4c45286945ea91d703660e86811bd24f561aaa,1,GitHub,2020-11-02 13:07:14-08:00,['236d7dc890e82c9b146579a8be801c1c7f54feb9'],95,144,239,2351514,3,0.805555556,1,0.638888889,5275
21a65e10436fc81cac0518dd4babb9612eeaf667,1,GitHub,2020-11-02 15:06:58-08:00,['be4c45286945ea91d703660e86811bd24f561aaa'],1270,2434,3704,2355218,47,0.814946619,0.927046263,1,5287
b9e2a89c0f48f8fa0849b173a2846d3689201dd6,0,GitHub,2020-11-02 17:16:52-08:00,['21a65e10436fc81cac0518dd4babb9612eeaf667'],76,22,98,2355316,7,0.967741935,1,0.032258065,5287
fb3d26d5b7dd3103c6e2eff4ac30b6d790b2f263,0,GitHub,2020-11-03 10:49:49+08:00,['b9e2a89c0f48f8fa0849b173a2846d3689201dd6'],0,4,4,2355320,1,,,,5287
bbc6c3108b324e8cd898ce8f60348f0beaa88ff5,0,GitHub,2020-11-03 14:48:17+08:00,['fb3d26d5b7dd3103c6e2eff4ac30b6d790b2f263'],20,20,40,2355360,1,,,,5287
b4f00d7ef61ff5a53487a3930889c0b329250534,1,GitHub,2020-11-03 13:40:44-05:00,['bbc6c3108b324e8cd898ce8f60348f0beaa88ff5'],1203,1140,2343,2357703,13,,,,5289
b3e77dfad93b9e4d2798ecf84e777c99905d380f,1,GitHub,2020-11-03 17:30:15-08:00,['b4f00d7ef61ff5a53487a3930889c0b329250534'],95,484,579,2358282,29,0.77027027,0.945945946,0.959459459,5291
8f49d1a9ff7611493ecc9d61fb467b37d190ee65,0,GitHub,2020-11-04 11:16:07+08:00,['b3e77dfad93b9e4d2798ecf84e777c99905d380f'],9,2,11,2358293,1,1,1,0,5291
ec3feb4f0904c119d4e1cd901603515253a2e3b1,0,GitHub,2020-11-04 11:20:11+08:00,['8f49d1a9ff7611493ecc9d61fb467b37d190ee65'],19,12,31,2358324,3,0,0,0,5291
e847f057e31cbd50db854f12f2eafe0d1a865068,1,GitHub,2020-11-04 08:30:10-05:00,['ec3feb4f0904c119d4e1cd901603515253a2e3b1'],830,557,1387,2359711,21,,,,5291
b5a1c2649b5a85008a9d1b7ce9c3874ca66a3732,0,bill,2020-11-04 09:16:30-05:00,['e847f057e31cbd50db854f12f2eafe0d1a865068'],3,3,6,2359717,1,,,,5291
27153e226890c7dd8884965212d049cd212081d6,0,GitHub,2020-11-04 14:44:29-05:00,['b5a1c2649b5a85008a9d1b7ce9c3874ca66a3732'],0,9,9,2359726,1,,,,5291
5df8457e05f6808145e90f5637d7f8a4aed548d9,1,GitHub,2020-11-04 19:54:26+00:00,['27153e226890c7dd8884965212d049cd212081d6'],14,235,249,2359975,3,0.693548387,0.951612903,0.806451613,5292
0814e4f645880a3c63102fc197c8912c63846ad5,1,GitHub,2020-11-04 14:21:44-08:00,['5df8457e05f6808145e90f5637d7f8a4aed548d9'],496,2246,2742,2362717,70,0.385370205,0.95985727,0.803746655,5302
eb53bffd13c70d232741fa77c6b56c6fe8924e85,0,GitHub,2020-11-05 11:43:17+08:00,['0814e4f645880a3c63102fc197c8912c63846ad5'],1,1,2,2362719,1,,,,5302
e2d325ee4cd15eb4df10af59b5f8f42eca52a269,0,GitHub,2020-11-05 15:01:20+08:00,['eb53bffd13c70d232741fa77c6b56c6fe8924e85'],1,1,2,2362721,1,,,,5302
c3d0140a5577f85ee64f739f5f8832f54612de22,1,GitHub,2020-11-05 15:02:00-06:00,['e2d325ee4cd15eb4df10af59b5f8f42eca52a269'],24,23,47,2362768,3,0,0,0,5302
ff48edbed46f23600ab434deee57e3ef2da8ed28,0,GitHub,2020-11-05 15:55:13-08:00,['c3d0140a5577f85ee64f739f5f8832f54612de22'],7,20,27,2362795,2,1,1,1,5302
c2cc8a6b4316338075d163f277fe0d6825172a36,0,GitHub,2020-11-06 09:28:31+01:00,['ff48edbed46f23600ab434deee57e3ef2da8ed28'],1,2,3,2362798,1,,,,5302
8e211eb72f9a45897cc37fed394a38096aa47feb,0,GitHub,2020-11-06 08:51:14+00:00,['c2cc8a6b4316338075d163f277fe0d6825172a36'],0,59,59,2362857,2,0,0.931818182,1,5302
d61dc0c1832935ae680388dcb8c12d1250dece33,1,Manikumar Reddy,2020-11-09 22:02:29+05:18,['8e211eb72f9a45897cc37fed394a38096aa47feb'],1,1,2,2362859,1,,,,5302
f49c6c203f6ce5c4eb643907c7f164b47db65989,1,GitHub,2020-11-09 12:52:28-08:00,['d61dc0c1832935ae680388dcb8c12d1250dece33'],206,687,893,2363752,11,0.220640569,1,1,5304
846e356dce7e2d344a7de11136017bb6e2cefb0f,0,GitHub,2020-11-10 10:50:25+00:00,['f49c6c203f6ce5c4eb643907c7f164b47db65989'],1,2,3,2363755,1,0,0,1,5304
960e64072592bc1ad939518b58dbdfb17068680d,0,Ismael Juma,2020-11-10 06:19:36-08:00,['846e356dce7e2d344a7de11136017bb6e2cefb0f'],7,45,52,2363807,3,0.470588235,1,1,5304
ab64e58320b82aed7c30a5cca5b816dd605b7963,1,GitHub,2020-11-10 09:18:40-08:00,['960e64072592bc1ad939518b58dbdfb17068680d'],188,100,288,2364095,3,1,0,0,5304
eb24ed893aabef0db5d3dd7e1258312be716411f,0,GitHub,2020-11-11 10:11:52+08:00,['ab64e58320b82aed7c30a5cca5b816dd605b7963'],3,7,10,2364105,2,,,,5304
ad7390f079fd5809672389d7e0b4c25ea2162c23,1,GitHub,2020-11-11 11:47:40+01:00,['eb24ed893aabef0db5d3dd7e1258312be716411f'],32,59,91,2364196,5,1,1,0.9375,5304
ece01e6e83c174ee098d355052078e9bbf536267,0,GitHub,2020-11-11 19:57:07+08:00,['ad7390f079fd5809672389d7e0b4c25ea2162c23'],1,1,2,2364198,1,,,,5304
156584915a61d15c8840ed14eed4ff1474b77db6,0,GitHub,2020-11-11 19:57:40+08:00,['ece01e6e83c174ee098d355052078e9bbf536267'],2,2,4,2364202,2,,,,5304
bb34c5c8cc32d1b769a34329e34b83cda040aafc,0,GitHub,2020-11-11 23:21:10-08:00,['156584915a61d15c8840ed14eed4ff1474b77db6'],53,95,148,2364350,7,1,0.875,1,5305
f978d0551be5ffaec282cf8c3643bacbe90ad4b9,0,GitHub,2020-11-12 13:09:15-08:00,['bb34c5c8cc32d1b769a34329e34b83cda040aafc'],2,1,3,2364353,1,,,,5305
3e2d1fc8aa10a27599f698a4dd64a04524122e5f,0,GitHub,2020-11-12 19:36:27-08:00,['f978d0551be5ffaec282cf8c3643bacbe90ad4b9'],0,31,31,2364384,1,1,1,1,5305
0b9c7512bf20da2b7123e0e14ec38790906651b8,1,GitHub,2020-11-13 10:44:09-08:00,['3e2d1fc8aa10a27599f698a4dd64a04524122e5f'],0,41,41,2364425,2,0,0.666666667,0.666666667,5305
cfc813537e955c267106eea989f6aec4879e14d7,0,GitHub,2020-11-13 13:25:43-08:00,['0b9c7512bf20da2b7123e0e14ec38790906651b8'],6,14,20,2364445,2,0,0,1,5305
cb3dc6785bc8263d8e1fc695e499e1eeb9df52a4,1,GitHub,2020-11-13 14:35:26-08:00,['cfc813537e955c267106eea989f6aec4879e14d7'],28,167,195,2364640,8,0.742268041,0.824742268,1,5305
e14e7086713b2d65e8db0fb1a2daf2717fe7d13c,1,GitHub,2020-11-14 13:16:30-08:00,['cb3dc6785bc8263d8e1fc695e499e1eeb9df52a4'],572,789,1361,2366001,39,0.804511278,1,0.902255639,5310
53026b799c609373696382c685b9080630128af2,0,GitHub,2020-11-14 21:03:12-08:00,['e14e7086713b2d65e8db0fb1a2daf2717fe7d13c'],5,7,12,2366013,1,,,,5310
6eff08761c3f70febc8394d950ac2e726613f4be,0,GitHub,2020-11-17 08:57:21+01:00,['53026b799c609373696382c685b9080630128af2'],7,7,14,2366027,1,,,,5310
aafab199e3ec46e03355cd63c5e31a4388d5b1a5,0,GitHub,2020-11-17 09:51:12-08:00,['6eff08761c3f70febc8394d950ac2e726613f4be'],2,1,3,2366030,1,,,,5310
7a23e592f447725dbbbdc91e8062ef4a60a06031,0,GitHub,2020-11-17 11:32:01-08:00,['aafab199e3ec46e03355cd63c5e31a4388d5b1a5'],16,68,84,2366114,2,0,0.851851852,1,5310
e71cb7ab11f85ce793aa337f185a20866ed3dc20,0,GitHub,2020-11-17 16:57:53-08:00,['7a23e592f447725dbbbdc91e8062ef4a60a06031'],23,135,158,2366272,5,0,0.897435897,0.91025641,5310
e7090173eeb72ba5c125ded2ec1cbf63cb5c0674,1,GitHub,2020-11-17 19:56:38-08:00,['e71cb7ab11f85ce793aa337f185a20866ed3dc20'],24,99,123,2366395,13,0.333333333,1,1,5310
6bbf69fb009bd7c4d6f1a39ec71b514db87de440,1,GitHub,2020-11-18 14:49:04+08:00,['e7090173eeb72ba5c125ded2ec1cbf63cb5c0674'],397,278,675,2367070,15,1,0.808080808,0.323232323,5314
5899f5fc4a9557c33e466e58d7555990ee742a2b,1,GitHub,2020-11-17 22:55:09-08:00,['6bbf69fb009bd7c4d6f1a39ec71b514db87de440'],166,754,920,2367990,38,0.379710145,0.64057971,0.884057971,5316
83f75464c2843f88051a15c7cad4494f3e8ff4f7,0,GitHub,2020-11-18 15:25:21+08:00,['5899f5fc4a9557c33e466e58d7555990ee742a2b'],2,2,4,2367994,1,,,,5316
8c163e027e86d3c1ff03b50db63c682278d5f641,1,GitHub,2020-11-18 16:31:46+08:00,['83f75464c2843f88051a15c7cad4494f3e8ff4f7'],95,91,186,2368180,2,0.181818182,0,0,5316
28c57b273a3620c18be0bba6d5f74f981d9ef47d,0,GitHub,2020-11-18 00:58:20-08:00,['8c163e027e86d3c1ff03b50db63c682278d5f641'],90,102,192,2368372,14,1,1,1,5316
6fec4713d5ab5e7e229bb5e26a132e947dd9a8b6,0,GitHub,2020-11-19 00:05:01+08:00,['28c57b273a3620c18be0bba6d5f74f981d9ef47d'],3,0,3,2368375,1,,,,5316
b3264b79961b9bf32cc8f967054d634c4c63fde6,0,GitHub,2020-11-19 00:06:48+08:00,['6fec4713d5ab5e7e229bb5e26a132e947dd9a8b6'],10,1,11,2368386,1,0,0,0,5316
30bc21ca35b165f04c472b4ce794893843809ccc,1,GitHub,2020-11-18 13:44:21-08:00,['b3264b79961b9bf32cc8f967054d634c4c63fde6'],759,997,1756,2370142,27,0,1,1,5318
77a46b1f4d4e962d1b416d20c9ff76ec6fbaab68,1,GitHub,2020-11-18 22:51:06+00:00,['30bc21ca35b165f04c472b4ce794893843809ccc'],55,290,345,2370487,9,0,0.674033149,0.950276243,5318
d12fbb7c0077fba23282adb84ff87635d6e44e5e,1,GitHub,2020-11-18 15:45:40-08:00,['77a46b1f4d4e962d1b416d20c9ff76ec6fbaab68'],21,82,103,2370590,5,0.745098039,1,1,5318
192db666c913c3fb2bfe3568ac51aa4ddb010a25,1,GitHub,2020-11-18 16:23:43-08:00,['d12fbb7c0077fba23282adb84ff87635d6e44e5e'],72,286,358,2370948,9,0.118881119,0.496503497,0.979020979,5319
179ecdf49e947a30d1bf5a277470cc2147cc35e4,0,GitHub,2020-11-19 11:23:41+08:00,['192db666c913c3fb2bfe3568ac51aa4ddb010a25'],118,43,161,2371109,23,1,0.029411765,0.235294118,5319
51c833e7959bd6ab7fbb043f76933456b40ecae4,0,GitHub,2020-11-19 11:41:50+01:00,['179ecdf49e947a30d1bf5a277470cc2147cc35e4'],347,328,675,2371784,15,0.631578947,0.842105263,0.421052632,5319
7ceb34bbeccab1d16def1812aecd61a6a3f021e0,0,GitHub,2020-11-19 09:18:04-05:00,['51c833e7959bd6ab7fbb043f76933456b40ecae4'],1,1,2,2371786,1,,,,5319
1625984149491c33b6b1c815acccaefcd0f6a959,0,GitHub,2020-11-19 15:01:22+00:00,['7ceb34bbeccab1d16def1812aecd61a6a3f021e0'],6,35,41,2371827,2,1,1,1,5319
91679f247a0fcc2d25fecd88e1b126c7459d36fe,0,GitHub,2020-11-19 15:26:25+00:00,['1625984149491c33b6b1c815acccaefcd0f6a959'],22,27,49,2371876,9,0,0,1,5319
1841e9f49788fa41b6a2e2ab29bb8ebf948d2625,1,GitHub,2020-11-19 16:32:22+01:00,['91679f247a0fcc2d25fecd88e1b126c7459d36fe'],137,811,948,2372824,11,0.296536797,0.913419913,0.963203463,5319
b9bab3b76299503d4277a9ac51d8a100a81a1802,0,GitHub,2020-11-19 16:42:38+01:00,['1841e9f49788fa41b6a2e2ab29bb8ebf948d2625'],4,20,24,2372848,2,0.8,0.8,0.8,5319
dcbd28da53bfc6edb78fd1735993163fc6f4c7c7,0,GitHub,2020-11-19 10:52:18-08:00,['b9bab3b76299503d4277a9ac51d8a100a81a1802'],15,68,83,2372931,2,0.028571429,0.857142857,1,5319
6054837c0a88800451027d17b86fdb9b4b2b3a34,0,GitHub,2020-11-19 12:45:23-08:00,['dcbd28da53bfc6edb78fd1735993163fc6f4c7c7'],29,82,111,2373042,6,1,1,0.684210526,5319
31d84e66baf92544eda85e89552a4841026d07cd,0,GitHub,2020-11-19 14:06:46-08:00,['6054837c0a88800451027d17b86fdb9b4b2b3a34'],5,6,11,2373053,1,,,,5319
438749bb5d78f2ca34aaf306739f210794f8e3f9,1,GitHub,2020-11-19 19:00:52-08:00,['31d84e66baf92544eda85e89552a4841026d07cd'],73,265,338,2373391,8,0.094017094,0.974358974,0.418803419,5321
407808964a140cb27e5d745db32a471db11e235a,1,GitHub,2020-11-20 15:30:03+08:00,['438749bb5d78f2ca34aaf306739f210794f8e3f9'],51,123,174,2373565,18,0,0.345454545,1,5321
43fd630d80332f2b3b3512a712100825a8417704,0,GitHub,2020-11-20 15:34:27+08:00,['407808964a140cb27e5d745db32a471db11e235a'],2,2,4,2373569,2,,,,5321
351a22a12ecb79a1e1070bf1129f2e168e4e0670,1,GitHub,2020-11-20 18:55:40-08:00,['43fd630d80332f2b3b3512a712100825a8417704'],5,39,44,2373613,2,0,0.962962963,1,5321
502a544ee7a179ef8d2042c3a9c0baf3ad362788,0,GitHub,2020-11-20 21:53:34-08:00,['351a22a12ecb79a1e1070bf1129f2e168e4e0670'],1,1,2,2373615,1,,,,5321
6e3bf1eaab55db531b298dc018779b9cece1e165,0,GitHub,2020-11-21 15:55:46+08:00,['502a544ee7a179ef8d2042c3a9c0baf3ad362788'],2,6,8,2373623,1,0,0,0,5321
bc96a8feb5dcd7f034a2c8f30282485a1fde5c67,0,GitHub,2020-11-21 09:25:54-08:00,['6e3bf1eaab55db531b298dc018779b9cece1e165'],0,43,43,2373666,2,0.884615385,1,1,5321
af4e34867b91ad8f600c68481659a069b8f28afa,0,Matthias J. Sax,2020-11-21 11:34:47-08:00,['bc96a8feb5dcd7f034a2c8f30282485a1fde5c67'],1,2,3,2373669,1,0,1,1,5321
72918a98161ba71ff4fa8116fdf8ed02b09a0580,0,GitHub,2020-11-22 14:00:31-08:00,['af4e34867b91ad8f600c68481659a069b8f28afa'],3,3,6,2373675,2,,,,5321
9fdea8a6b60800461c8f120517bc0cfe2db311df,0,GitHub,2020-11-23 12:02:18+08:00,['72918a98161ba71ff4fa8116fdf8ed02b09a0580'],2,3,5,2373680,1,0,0,1,5321
ed8659b4a09a4affff6798b8077ed2d8fb94b6da,1,GitHub,2020-11-23 09:04:16+00:00,['9fdea8a6b60800461c8f120517bc0cfe2db311df'],19,126,145,2373825,5,0.789473684,0.973684211,1,5321
80b81ef9fe68b2695152ef7f86a794718e874c99,0,GitHub,2020-11-23 19:31:42-08:00,['ed8659b4a09a4affff6798b8077ed2d8fb94b6da'],1,1,2,2373827,1,,,,5321
047ad654da7903f3903760b0e6a6a58648ca7715,0,GitHub,2020-11-24 15:02:56+08:00,['80b81ef9fe68b2695152ef7f86a794718e874c99'],4,4,8,2373835,1,,,1,5321
a5986bd32df94465b6202db02a52580aec0f348d,0,GitHub,2020-11-24 06:20:05-08:00,['047ad654da7903f3903760b0e6a6a58648ca7715'],28,65,93,2373928,7,1,1,1,5322
cbf8ad277a515b9a3e42dc63658fb60e6e6146b6,0,GitHub,2020-11-24 10:28:53-08:00,['a5986bd32df94465b6202db02a52580aec0f348d'],56,67,123,2374051,23,0,0,0.333333333,5322
2a409200dc9d1fa3198908e231161988affa1754,0,GitHub,2020-11-24 13:59:16-08:00,['cbf8ad277a515b9a3e42dc63658fb60e6e6146b6'],63,52,115,2374166,3,1,0,0,5322
dbf4e63ae7e4c637917124c148d5f21193d395b1,0,GitHub,2020-11-24 17:59:29-08:00,['2a409200dc9d1fa3198908e231161988affa1754'],24,60,84,2374250,8,0.5,0,1,5322
5200eaab258637f99966d9920812e1fa3fd36b35,0,GitHub,2020-11-25 22:48:02+08:00,['dbf4e63ae7e4c637917124c148d5f21193d395b1'],1,0,1,2374251,1,1,1,0,5322
7a49326822dbdb489b2d27e3f9ff5990ca604f02,0,GitHub,2020-11-25 14:00:02-05:00,['5200eaab258637f99966d9920812e1fa3fd36b35'],1,1,2,2374253,1,,,,5322
6b1c8f921d1c138ac88bdb884180b2b96e8c0590,0,GitHub,2020-11-26 11:57:39+08:00,['7a49326822dbdb489b2d27e3f9ff5990ca604f02'],1,3,4,2374257,1,0,0,1,5322
8a59a228817df221ac9acc7cce4f6c9dd702e9ef,0,GitHub,2020-11-26 14:59:04+00:00,['6b1c8f921d1c138ac88bdb884180b2b96e8c0590'],1,7,8,2374265,3,1,1,1,5322
0df461582c78449fd39e35b241a77a7acf5735e2,0,GitHub,2020-11-26 22:39:41+00:00,['8a59a228817df221ac9acc7cce4f6c9dd702e9ef'],0,5,5,2374270,1,,,,5322
9412fc11516dd8218645c6f8c6a86bee5b36db8d,0,GitHub,2020-11-28 13:06:48+08:00,['0df461582c78449fd39e35b241a77a7acf5735e2'],12,17,29,2374299,2,,,,5322
0a74c7d935b004acfa2eba0fc199be3cabd857a4,0,GitHub,2020-11-30 17:43:42+08:00,['9412fc11516dd8218645c6f8c6a86bee5b36db8d'],183,140,323,2374622,6,0.414634146,0,0,5324
6add0594a70e1a401501587c0379f27d37493ab7,0,GitHub,2020-11-30 15:41:14-05:00,['0a74c7d935b004acfa2eba0fc199be3cabd857a4'],1,1,2,2374624,1,,,,5324
e7de280b0f1c7a924293dba79be77f56a08d0e15,0,GitHub,2020-11-30 14:48:28-08:00,['6add0594a70e1a401501587c0379f27d37493ab7'],40,102,142,2374766,3,0.45,1,0.575,5324
90bc7e9777343568ea130fd48613696b5f6f3ece,0,GitHub,2020-11-30 17:25:47-07:00,['e7de280b0f1c7a924293dba79be77f56a08d0e15'],0,6,6,2374772,1,,,,5324
cc1aa3b83d22dfe45fab945c3958325d87858a8f,0,GitHub,2020-12-01 13:10:22+08:00,['90bc7e9777343568ea130fd48613696b5f6f3ece'],42,65,107,2374879,5,0,0,0,5325
60139d5b2553c4e6119601509396f1724c57bc38,0,GitHub,2020-12-01 10:28:04-08:00,['cc1aa3b83d22dfe45fab945c3958325d87858a8f'],1,1,2,2374881,1,,,,5325
9211ff6ffd06485a4c3bc41185be22bac0d961d8,0,GitHub,2020-12-01 10:58:57-08:00,['60139d5b2553c4e6119601509396f1724c57bc38'],13,81,94,2374975,2,0.636363636,1,1,5325
8839514efb9f037462541b8c1957a47ec19a1565,1,GitHub,2020-12-01 11:17:08-08:00,['9211ff6ffd06485a4c3bc41185be22bac0d961d8'],39,61,100,2375075,1,0,0,0,5325
dc55be2d92922dbee28d010bec464fcf0e90a350,1,GitHub,2020-12-01 11:26:16-08:00,['8839514efb9f037462541b8c1957a47ec19a1565'],257,297,554,2375629,31,1,1,0,5326
85f94d50271c952c3e9ee49c4fc814c0da411618,0,GitHub,2020-12-01 15:55:07-08:00,['dc55be2d92922dbee28d010bec464fcf0e90a350'],102,148,250,2375879,40,0,1,0,5326
aeeb7b2f9a9abe8f49543a2278757722e5974cb3,1,GitHub,2020-12-02 11:21:28+08:00,['85f94d50271c952c3e9ee49c4fc814c0da411618'],30,32,62,2375941,1,0,0,0,5326
e63f591ec4d4664608286072c31127323371cb96,1,GitHub,2020-12-03 10:34:27+08:00,['aeeb7b2f9a9abe8f49543a2278757722e5974cb3'],151,306,457,2376398,10,1,1,0.61627907,5326
10b07575f1c62b67fb87bf39327ea0bebffc15d6,0,GitHub,2020-12-03 10:38:27+08:00,['e63f591ec4d4664608286072c31127323371cb96'],1,2,3,2376401,1,0,0,0,5326
abb8ff61cc1e94fb1a7e237bb21e246bb754f53a,0,GitHub,2020-12-03 10:39:58+08:00,['10b07575f1c62b67fb87bf39327ea0bebffc15d6'],10,26,36,2376437,3,,,,5326
7ecc3a579a4b13e0cef4bd3129982ea3bc1a9341,1,GitHub,2020-12-03 10:12:06+00:00,['abb8ff61cc1e94fb1a7e237bb21e246bb754f53a'],175,565,740,2377177,18,0.066666667,0.514814815,0.807407407,5328
9de16bd2e64431b1b25d7a34aae78c6c98795143,0,GitHub,2020-12-03 14:36:48+00:00,['7ecc3a579a4b13e0cef4bd3129982ea3bc1a9341'],1,3,4,2377181,2,0,1,1,5328
10364e4b0c1f3757d9291d4ac11978cd5f7d08a3,0,GitHub,2020-12-03 18:50:29+01:00,['9de16bd2e64431b1b25d7a34aae78c6c98795143'],425,579,1004,2378185,33,0,0.495049505,0.227722772,5328
16eb1f5cd13759ff2971a92b0e7a646656bfa2a8,0,GitHub,2020-12-03 11:18:12-08:00,['10364e4b0c1f3757d9291d4ac11978cd5f7d08a3'],1,20,21,2378206,1,,,,5328
03cff6cb59994027d20848d9433d3e946de610e4,0,GitHub,2020-12-03 13:17:01-07:00,['16eb1f5cd13759ff2971a92b0e7a646656bfa2a8'],2,2,4,2378210,1,,,,5328
633f7cff190385a693486ddb88eaf5e84b3c13ed,1,GitHub,2020-12-03 16:11:07-05:00,['03cff6cb59994027d20848d9433d3e946de610e4'],37,122,159,2378369,11,0.483870968,0.85483871,0.967741935,5328
7c68531a1f114e39f04532ed1c59619c25a143f3,0,GitHub,2020-12-03 13:59:32-08:00,['633f7cff190385a693486ddb88eaf5e84b3c13ed'],2,2,4,2378373,1,0,1,1,5328
b18ecad90ecf1698319ef2fc19c6ab9220242af1,0,GitHub,2020-12-04 11:54:44+08:00,['7c68531a1f114e39f04532ed1c59619c25a143f3'],2,3,5,2378378,1,0,0,0,5328
155f2c06fbadc7a1a7a15cd2a2d5c2b7e72de0eb,1,GitHub,2020-12-04 11:59:39+08:00,['b18ecad90ecf1698319ef2fc19c6ab9220242af1'],1,28,29,2378407,2,0,1,1,5328
4cc6d204ec5cb21841a2f8f21e6333bb688cd892,1,GitHub,2020-12-04 00:56:11-07:00,['155f2c06fbadc7a1a7a15cd2a2d5c2b7e72de0eb'],13,191,204,2378611,8,0.512,0.984,0.968,5328
df0c52e7fd880b30bef3d7a59e0c1d5eb2de76e4,0,GitHub,2020-12-04 21:48:01+08:00,['4cc6d204ec5cb21841a2f8f21e6333bb688cd892'],2,2,4,2378615,1,,,,5328
20ae73b051272c53bac108ae5ffd5a4ccd411049,0,GitHub,2020-12-04 09:04:50-05:00,['df0c52e7fd880b30bef3d7a59e0c1d5eb2de76e4'],3,5,8,2378623,1,1,1,1,5328
cc0247bf535e79ffa4b55204a7ff15340354b566,0,GitHub,2020-12-04 23:56:01+08:00,['20ae73b051272c53bac108ae5ffd5a4ccd411049'],3,3,6,2378629,1,,,,5328
4f2f08eb006cdf3dc848b34b4b17cf27a023e9da,1,GitHub,2020-12-04 11:48:23-06:00,['cc0247bf535e79ffa4b55204a7ff15340354b566'],150,472,622,2379251,4,1,1,1,5328
4e9c7fc8a5db6e59e43a67586867c3b1c9fbe567,0,GitHub,2020-12-04 11:51:12-07:00,['4f2f08eb006cdf3dc848b34b4b17cf27a023e9da'],47,60,107,2379358,8,1,1,1,5328
b9640a71c42ad117ed418209f87dc2962173469d,0,GitHub,2020-12-04 11:55:42-07:00,['4e9c7fc8a5db6e59e43a67586867c3b1c9fbe567'],1,2,3,2379361,1,0,1,1,5328
9ece7fe372230e848920d843af2d0d5c2fbaac4d,1,GitHub,2020-12-04 12:21:03-07:00,['b9640a71c42ad117ed418209f87dc2962173469d'],42,262,304,2379665,4,0.275862069,1,1,5329
88c818095752f39488fd5aff232d4773e8b385b3,0,GitHub,2020-12-04 12:56:59-07:00,['9ece7fe372230e848920d843af2d0d5c2fbaac4d'],0,5,5,2379670,1,,,,5329
a57486e75084d70f1fbf22df9d3ffc3462302add,0,GitHub,2020-12-04 14:02:17-08:00,['88c818095752f39488fd5aff232d4773e8b385b3'],1,7,8,2379678,1,0,0,1,5329
8db3b1a09af0bad274e07161336994610d616b35,0,GitHub,2020-12-07 09:34:34-06:00,['a57486e75084d70f1fbf22df9d3ffc3462302add'],19,61,80,2379758,2,0,1,1,5329
b8ebcc2a93a4e0525afb4f5ff6690ef5b7529c57,0,GitHub,2020-12-07 16:12:18+00:00,['8db3b1a09af0bad274e07161336994610d616b35'],4,37,41,2379799,3,1,1,1,5329
ab0807dd858887d934d2be520608d20bf765b609,1,GitHub,2020-12-07 14:06:25-08:00,['b8ebcc2a93a4e0525afb4f5ff6690ef5b7529c57'],14,1153,1167,2380966,17,0.62962963,1,0.938271605,5337
6f27bb02da0dec63a16c0c6aa456b47ba416eb19,1,GitHub,2020-12-07 15:39:57-08:00,['ab0807dd858887d934d2be520608d20bf765b609'],2501,1642,4143,2385109,191,0,0.081850534,0.040925267,5337
1d84f543678c4c08800bc3ea18c04a9db8adf7e4,0,GitHub,2020-12-07 16:42:19-08:00,['6f27bb02da0dec63a16c0c6aa456b47ba416eb19'],5,1,6,2385115,1,1,0.25,0,5337
aebb0e33943bd8d410de1aa8160a01d9581c8681,0,GitHub,2020-12-08 09:13:32-08:00,['1d84f543678c4c08800bc3ea18c04a9db8adf7e4'],1,0,1,2385116,1,1,0,0,5337
153bbb8ac0012ddd9818514320e3c740d13d7bd7,0,GitHub,2020-12-08 09:19:30-08:00,['aebb0e33943bd8d410de1aa8160a01d9581c8681'],2,2,4,2385120,1,,,,5337
3e5a22cefa902df9ab78d509d5b8a1052f3d54e8,0,GitHub,2020-12-08 10:27:11-08:00,['153bbb8ac0012ddd9818514320e3c740d13d7bd7'],0,62,62,2385182,1,0,1,1,5338
41ea0775e0360eeb60376fb19bbd3941ed67676d,1,GitHub,2020-12-08 11:12:30-08:00,['3e5a22cefa902df9ab78d509d5b8a1052f3d54e8'],66,192,258,2385440,8,0.4625,1,1,5338
99b5e4f4ab62b40efdbd311a9e455ccbe50ce069,0,GitHub,2020-12-08 17:37:48-08:00,['41ea0775e0360eeb60376fb19bbd3941ed67676d'],45,107,152,2385592,7,0,1,0.880952381,5338
c5575801b79d0759c8e29b1ee6d1c98fd1a82b94,0,GitHub,2020-12-09 10:44:55+08:00,['99b5e4f4ab62b40efdbd311a9e455ccbe50ce069'],7,7,14,2385606,4,,,,5338
78a986bf597835df2eec3e875da299cd147fa62c,0,GitHub,2020-12-09 17:51:31+08:00,['c5575801b79d0759c8e29b1ee6d1c98fd1a82b94'],37,25,62,2385668,1,1,0,1,5338
cd95ce4ace9fc6749709968ff23b682c8a9916e2,0,GitHub,2020-12-09 20:15:34+08:00,['78a986bf597835df2eec3e875da299cd147fa62c'],57,57,114,2385782,7,,,,5338
00f7341a8236fe4d9c0956b07fc5931056a841cf,0,Ismael Juma,2020-12-09 06:33:43-08:00,['cd95ce4ace9fc6749709968ff23b682c8a9916e2'],7,1,8,2385790,3,0,0,0,5338
ff88874e0de4aa1ce177330869e0ddf4a4ba2732,0,GitHub,2020-12-09 23:31:04+08:00,['00f7341a8236fe4d9c0956b07fc5931056a841cf'],17,99,116,2385906,2,0,0.781818182,0.909090909,5338
1f98112e993bc4ae098936b1b0661fdb2c4b1880,1,GitHub,2020-12-09 11:15:58-08:00,['ff88874e0de4aa1ce177330869e0ddf4a4ba2732'],775,772,1547,2387453,95,1,0.066666667,1,5339
1cf9ce95ad21fe480ac7e5046773fc09726d661f,0,GitHub,2020-12-09 11:19:06-08:00,['1f98112e993bc4ae098936b1b0661fdb2c4b1880'],4,4,8,2387461,3,,,,5339
a8b668b37caf9dd8211e97ccebcc70d074a2c646,0,GitHub,2020-12-09 13:33:28-08:00,['1cf9ce95ad21fe480ac7e5046773fc09726d661f'],56,119,175,2387636,5,0,1,1,5339
6e15937feb65e664ae4dc694246e1e486ff26567,0,GitHub,2020-12-09 13:38:17-08:00,['a8b668b37caf9dd8211e97ccebcc70d074a2c646'],11,11,22,2387658,2,,,,5339
fa93982d3a65ff800b9bef2039a15421ca1b46c9,0,GitHub,2020-12-09 14:13:36-08:00,['6e15937feb65e664ae4dc694246e1e486ff26567'],2,6,8,2387666,1,0,1,1,5339
db79f86025683346e7a960fbf1ebc7b3b86b3c65,0,GitHub,2020-12-10 11:08:17+08:00,['fa93982d3a65ff800b9bef2039a15421ca1b46c9'],13,1,14,2387680,1,0,0,1,5339
8e82eaa7116f39f82d11b926d34b5c873f7f05ab,0,GitHub,2020-12-10 11:14:35+08:00,['db79f86025683346e7a960fbf1ebc7b3b86b3c65'],2,2,4,2387684,1,,,,5339
310e240abd6acb6ad27dea8b5aae01c1a7674ca4,0,GitHub,2020-12-09 20:15:43-08:00,['8e82eaa7116f39f82d11b926d34b5c873f7f05ab'],58,89,147,2387831,5,1,0.666666667,0.666666667,5339
404062d2b66498951eeddfcb14072545982584ec,1,GitHub,2020-12-10 09:53:32+01:00,['310e240abd6acb6ad27dea8b5aae01c1a7674ca4'],255,604,859,2388690,10,0.588850174,0.857142857,0.926829268,5339
b44d32dffedb368b888e3431257d68abb1e62b9f,0,GitHub,2020-12-10 12:24:45+01:00,['404062d2b66498951eeddfcb14072545982584ec'],15,46,61,2388751,2,0.708333333,1,0.416666667,5339
125d5ea0fb80a82ee23fe3e354981b75db1a4756,0,GitHub,2020-12-10 09:25:04-08:00,['b44d32dffedb368b888e3431257d68abb1e62b9f'],0,44,44,2388795,3,0.172413793,1,0.931034483,5339
567a2ec737ca48cbeeb9c47e90ff3eca8c2b9967,0,GitHub,2020-12-10 17:32:30-08:00,['125d5ea0fb80a82ee23fe3e354981b75db1a4756'],173,192,365,2389160,2,0,0.210526316,1,5339
8cabd57612189d633ca2aed40b63f20e1f668fa4,0,GitHub,2020-12-10 17:56:52-08:00,['567a2ec737ca48cbeeb9c47e90ff3eca8c2b9967'],45,111,156,2389316,6,,,,5339
d5dc7dfe00b3a9c9934ba6627b892c2c76732e1b,1,GitHub,2020-12-11 15:08:21-06:00,['8cabd57612189d633ca2aed40b63f20e1f668fa4'],11,107,118,2389434,3,0.12,0.96,1,5339
cdf725828bc247078458de403b17190a9da07496,0,GitHub,2020-12-11 16:34:46-08:00,['d5dc7dfe00b3a9c9934ba6627b892c2c76732e1b'],27,30,57,2389491,1,0.333333333,1,0.666666667,5339
3572049863ddc7a41c1549eaf23fad59d74f589f,0,GitHub,2020-12-13 08:36:37-08:00,['cdf725828bc247078458de403b17190a9da07496'],1,2,3,2389494,1,,,,5339
4401f52d17b41bc560b04f0883d2cb57c3c983aa,0,GitHub,2020-12-14 15:20:20+08:00,['3572049863ddc7a41c1549eaf23fad59d74f589f'],7,5,12,2389506,3,1,1,0.5,5339
8577ceae874fac7958340e5cc4277bc54b336fda,0,GitHub,2020-12-14 15:34:10+08:00,['4401f52d17b41bc560b04f0883d2cb57c3c983aa'],1,1,2,2389508,1,,,,5339
78b74debe4b7c7b56d6beed43aa7c45701957464,0,GitHub,2020-12-15 08:39:58+08:00,['8577ceae874fac7958340e5cc4277bc54b336fda'],1,1,2,2389510,1,,,,5339
5e5daf47ef0de74c0662063e975dd1f52993be7b,0,GitHub,2020-12-14 22:28:47-08:00,['78b74debe4b7c7b56d6beed43aa7c45701957464'],20,24,44,2389554,4,1,,,5339
1a10c3445e157da1d2fd670c043f19c385465eb0,0,GitHub,2020-12-15 14:33:36+01:00,['5e5daf47ef0de74c0662063e975dd1f52993be7b'],259,913,1172,2390726,133,0.35924933,0.782841823,0.922252011,5343
a07923c4f27c4a938da53e9b0d55fa2d6a0515fe,0,GitHub,2020-12-15 14:54:22+01:00,['1a10c3445e157da1d2fd670c043f19c385465eb0'],10,23,33,2390759,1,0,1,1,5343
3717ab0ff2e5906da6f4c2d2bcc73480abcf753b,0,GitHub,2020-12-15 06:39:07-08:00,['a07923c4f27c4a938da53e9b0d55fa2d6a0515fe'],1,1,2,2390761,1,,,,5343
1aac64667f99e1b7513d7e0a653112a0ac88f35e,0,GitHub,2020-12-15 10:05:40-08:00,['3717ab0ff2e5906da6f4c2d2bcc73480abcf753b'],13,50,63,2390824,4,0.666666667,1,1,5343
793117d45587ddcaed1629b7bb446df93268f27e,1,GitHub,2020-12-15 14:53:56-06:00,['1aac64667f99e1b7513d7e0a653112a0ac88f35e'],11,196,207,2391031,4,0.40952381,0,0.695238095,5344
d072be6d9002cf3650e21d7005bf5adc6ae70454,0,GitHub,2020-12-15 13:07:48-08:00,['793117d45587ddcaed1629b7bb446df93268f27e'],72,94,166,2391197,2,0.7,1,1,5344
ea8ae976504e7a3f5c6f4a7efa5069d03316b093,0,GitHub,2020-12-15 14:38:18-08:00,['d072be6d9002cf3650e21d7005bf5adc6ae70454'],16,24,40,2391237,3,0.833333333,0.833333333,1,5344
a084dd829c901401dce2b03e53c0ba87aa817579,0,GitHub,2020-12-15 15:51:37-08:00,['ea8ae976504e7a3f5c6f4a7efa5069d03316b093'],1,1,2,2391239,1,,,,5344
f285188f1028759cf3cb349a15ec225331a6fd35,1,GitHub,2020-12-15 16:26:59-08:00,['a084dd829c901401dce2b03e53c0ba87aa817579'],1,2,3,2391242,1,,,,5344
d84a82c32db94be9c5dbdc155c38a3775e6882eb,0,GitHub,2020-12-16 08:51:40+08:00,['f285188f1028759cf3cb349a15ec225331a6fd35'],152,230,382,2391624,17,0.267857143,1,1,5345
61166051798ca6901462a29f09eed096810335f0,0,GitHub,2020-12-16 21:50:15+08:00,['d84a82c32db94be9c5dbdc155c38a3775e6882eb'],1,3,4,2391628,1,0,0,0,5345
ad4211fad709d0de8b2e650531892d0712232485,0,GitHub,2020-12-16 22:22:08+08:00,['61166051798ca6901462a29f09eed096810335f0'],2,2,4,2391632,1,,,,5345
782175dfbc4a6694ae9a3970cd92ebd20647bc7e,1,GitHub,2020-12-16 06:33:10-08:00,['ad4211fad709d0de8b2e650531892d0712232485'],1023,697,1720,2393352,43,0.606557377,0.483606557,0.327868852,5345
f4272fd5d38fdc3145f9b0a78f4ab7f0692aecd5,0,GitHub,2020-12-16 16:19:33-06:00,['782175dfbc4a6694ae9a3970cd92ebd20647bc7e'],16,175,191,2393543,4,0.086206897,1,0.879310345,5345
4089c36b334eafde03f0f7dc062e19ac6ae4abaa,0,GitHub,2020-12-16 18:31:15-08:00,['f4272fd5d38fdc3145f9b0a78f4ab7f0692aecd5'],0,1,1,2393544,1,0,1,1,5345
02a30a51ebaace6f42d1fd9027fcf3345179a52e,0,GitHub,2020-12-17 17:40:37+01:00,['4089c36b334eafde03f0f7dc062e19ac6ae4abaa'],98,125,223,2393767,13,0,0,0.766666667,5345
f8b26563e10bfdcc05b1e981893fae38e589d083,0,GitHub,2020-12-18 00:43:21+08:00,['02a30a51ebaace6f42d1fd9027fcf3345179a52e'],5,5,10,2393777,1,,,,5345
b689507c417a0f846b8a86318312eb50e4ac2adb,0,GitHub,2020-12-17 17:09:45-08:00,['f8b26563e10bfdcc05b1e981893fae38e589d083'],2,2,4,2393781,1,,,,5345
67150b815ef33a03994bce6210643fd1dcc2855f,0,GitHub,2020-12-18 12:01:38+08:00,['b689507c417a0f846b8a86318312eb50e4ac2adb'],12,78,90,2393871,2,0.5,0.942307692,0.673076923,5345
ae3a6ed990f91708686d27c6023bac050c422248,1,GitHub,2020-12-18 18:08:46+00:00,['67150b815ef33a03994bce6210643fd1dcc2855f'],103,1201,1304,2395175,12,0.336828309,0.732634338,0.726081258,5348
baef516789f0d80ce1faba5d257a905ecb27e6fe,0,GitHub,2020-12-18 13:03:59-08:00,['ae3a6ed990f91708686d27c6023bac050c422248'],17,1554,1571,2396746,17,0.757692308,0.930769231,0.776923077,5360
5c921afa4a593478f7d1c49e5db9d787558d0d5e,1,GitHub,2020-12-18 21:30:52+00:00,['baef516789f0d80ce1faba5d257a905ecb27e6fe'],85,260,345,2397091,25,0.140350877,0.578947368,0.543859649,5360
1dd1e7f945d7a8c1dc177223cd88800680f1ff46,1,GitHub,2020-12-18 22:19:50+00:00,['5c921afa4a593478f7d1c49e5db9d787558d0d5e'],124,760,884,2397975,26,0,0.67965368,0.896103896,5361
87260a33b01590d0f73577840422e24fa589bed0,0,GitHub,2020-12-21 12:29:10+08:00,['1dd1e7f945d7a8c1dc177223cd88800680f1ff46'],27,27,54,2398029,1,1,,1,5361
4e7c789118fed28ee99275e3e84a626fe912c79a,0,GitHub,2020-12-21 16:11:51+08:00,['87260a33b01590d0f73577840422e24fa589bed0'],38,40,78,2398107,2,1,1,1,5361
167036223606ace089966ce2cf3dd74e0eb19a68,1,GitHub,2020-12-21 17:38:33+08:00,['4e7c789118fed28ee99275e3e84a626fe912c79a'],16,16,32,2398139,12,,,,5361
300909d9e60eb1d5e80f4d744d3662a105ac0c15,0,GitHub,2020-12-21 11:52:49-05:00,['167036223606ace089966ce2cf3dd74e0eb19a68'],0,6,6,2398145,3,,,,5361
d3f19e4bb047338840d380d2253dc92cf56b0a0f,1,GitHub,2020-12-21 14:44:02-05:00,['300909d9e60eb1d5e80f4d744d3662a105ac0c15'],279,427,706,2398851,17,0,1,0.783333333,5362
eb9fe411bbbfca1baf5e0900ee9cfb9147e5099e,1,GitHub,2020-12-21 18:15:15-08:00,['d3f19e4bb047338840d380d2253dc92cf56b0a0f'],782,1215,1997,2400848,37,0.160583942,1,0.467153285,5366
d5151f6f095896799296aecaa483a76981425ed5,0,GitHub,2020-12-22 10:05:07-08:00,['eb9fe411bbbfca1baf5e0900ee9cfb9147e5099e'],28,34,62,2400910,4,,,,5366
b6891f6729e9997b18ffca2515cb0265520a1874,0,GitHub,2020-12-22 14:34:59-08:00,['d5151f6f095896799296aecaa483a76981425ed5'],2,1256,1258,2402168,8,0.200762389,0.557814485,0.598475222,5371
bb813310c79bda967ddd817964aa18c0ae7bcefd,0,GitHub,2020-12-22 16:19:43-08:00,['b6891f6729e9997b18ffca2515cb0265520a1874'],482,1,483,2402651,3,,,,5371
e3b0ea81ca4f72c6716c7512d51c07d11cf3160b,0,GitHub,2020-12-22 16:45:50-08:00,['bb813310c79bda967ddd817964aa18c0ae7bcefd'],0,277,277,2402928,1,,,,5372
9aeacb425bfdd66a7588781c0838b485c2d80199,0,GitHub,2020-12-23 10:04:36+08:00,['e3b0ea81ca4f72c6716c7512d51c07d11cf3160b'],1,1,2,2402930,1,,,,5372
5b06e9690b0fba37ac369149f573b27abc39a721,0,GitHub,2020-12-24 00:22:30+08:00,['9aeacb425bfdd66a7588781c0838b485c2d80199'],28,28,56,2402986,8,,,,5372
a0e0028b16ae1b7b4a1dca1715b5b130187b334a,0,GitHub,2020-12-23 11:56:55-08:00,['5b06e9690b0fba37ac369149f573b27abc39a721'],1,30,31,2403017,1,0,1,1,5372
baea94d9264b87d777f67afcc1e161fb51ac57ec,0,GitHub,2020-12-23 15:50:52-08:00,['a0e0028b16ae1b7b4a1dca1715b5b130187b334a'],30,60,90,2403107,4,,,,5372
2023aed59d863278a6302e03066d387f994f085c,1,GitHub,2020-12-28 18:37:08-08:00,['baea94d9264b87d777f67afcc1e161fb51ac57ec'],35,1980,2015,2405122,29,0.183609141,0.851851852,0.930654058,5379
3ebd32b2a563440645de45ecb578d8a8dccbee95,0,GitHub,2020-12-29 13:41:56-08:00,['2023aed59d863278a6302e03066d387f994f085c'],34,141,175,2405297,5,0,1,1,5381
afa5423356d3d2a2135a51200573b45d097f6d60,0,GitHub,2020-12-30 23:06:29+08:00,['3ebd32b2a563440645de45ecb578d8a8dccbee95'],1,1,2,2405299,1,,,,5381
42272f0a37c2f4df1d629617d299a4d7e97dcedc,0,GitHub,2020-12-31 10:26:45-08:00,['afa5423356d3d2a2135a51200573b45d097f6d60'],1,1,2,2405301,1,,,,5381
bdb29e42cb19ff108c671f05cf0d2732fab0a2d8,0,GitHub,2021-01-03 15:09:31+08:00,['42272f0a37c2f4df1d629617d299a4d7e97dcedc'],0,52,52,2405353,2,0.15,1,0.85,5382
0e91d053f33d9525951cf24eb2a444925cdffe45,0,GitHub,2021-01-03 21:04:28+08:00,['bdb29e42cb19ff108c671f05cf0d2732fab0a2d8'],3,3,6,2405359,1,,,,5382
2515bf236864c04cc75d8fd136b048625663e16c,0,GitHub,2021-01-03 21:11:31+08:00,['0e91d053f33d9525951cf24eb2a444925cdffe45'],1,1,2,2405361,1,,,,5382
0eea5845c5c62d0beec63f5940518d06315ee896,0,GitHub,2021-01-03 21:20:48-08:00,['2515bf236864c04cc75d8fd136b048625663e16c'],1,1,2,2405363,1,,,,5382
8ac5ef90a0dcf4fd49b7c5c5131728297319f45e,0,Gwen Shapira,2021-01-03 21:44:05-08:00,['0eea5845c5c62d0beec63f5940518d06315ee896'],1,1,2,2405365,1,,,,5382
ac7b5d3389fddf46bc53ab656de1fa7e2562efdb,0,GitHub,2021-01-05 00:23:34+08:00,['8ac5ef90a0dcf4fd49b7c5c5131728297319f45e'],3,3,6,2405371,1,,,,5382
e3ce4a6e11dd8f3d8e08f39c22c4f19f30ff65b8,0,GitHub,2021-01-04 14:20:24-08:00,['ac7b5d3389fddf46bc53ab656de1fa7e2562efdb'],0,33,33,2405404,2,0,0.826086957,1,5382
c9afd2db01415b49d572f2f257bb83a243d249e3,0,GitHub,2021-01-05 10:32:04+08:00,['e3ce4a6e11dd8f3d8e08f39c22c4f19f30ff65b8'],43,21,64,2405468,2,0,0,0,5382
bf694b29439d27a527b0be5a8fb7a25fc280c892,0,GitHub,2021-01-05 09:45:00-05:00,['c9afd2db01415b49d572f2f257bb83a243d249e3'],6,18,24,2405492,4,,,,5382
daad1cbf5555d20579953244481279594be1c845,0,GitHub,2021-01-05 13:02:55-08:00,['bf694b29439d27a527b0be5a8fb7a25fc280c892'],8,73,81,2405573,3,0.034482759,1,1,5382
fa1e456933e4ef9f033d9d1a67c66ce0c1ec6008,0,GitHub,2021-01-05 16:34:01-08:00,['daad1cbf5555d20579953244481279594be1c845'],4,4,8,2405581,3,,,,5382
b80cf9c240989b5c7c742ef7594411eb24a3cf9f,0,GitHub,2021-01-06 14:52:15+08:00,['fa1e456933e4ef9f033d9d1a67c66ce0c1ec6008'],16,55,71,2405652,2,0.310344828,1,1,5382
ea2423e0e33c862fe93fbe42903e9d4478807353,1,Manikumar Reddy,2021-01-06 19:47:10+05:18,['b80cf9c240989b5c7c742ef7594411eb24a3cf9f'],19,33,52,2405704,3,0,1,0.714285714,5382
df9fc3834cc456bb14489af0c699e7a1ddd98d93,0,GitHub,2021-01-06 11:13:51-05:00,['ea2423e0e33c862fe93fbe42903e9d4478807353'],21,30,51,2405755,1,1,1,1,5382
bf55afecdab9fe00c9defcec04adb27856df93cc,0,GitHub,2021-01-06 10:06:56-08:00,['df9fc3834cc456bb14489af0c699e7a1ddd98d93'],19,54,73,2405828,2,0.230769231,1,1,5382
2e0c686ec1e1b0ec30b0fd6fd53ed599fe718f8c,0,GitHub,2021-01-06 11:31:05-08:00,['bf55afecdab9fe00c9defcec04adb27856df93cc'],2,4,6,2405834,2,,,,5382
2552aa35cce6447034493a2884fc0a8a50106dd8,0,GitHub,2021-01-06 11:41:51-08:00,['2e0c686ec1e1b0ec30b0fd6fd53ed599fe718f8c'],11,12,23,2405857,1,,,,5382
393139064f79ee664b6d8507ea1f974dad84c82e,0,GitHub,2021-01-06 13:51:07-08:00,['2552aa35cce6447034493a2884fc0a8a50106dd8'],97,110,207,2406064,9,0,0,0,5382
22e8e71156762b40ac93e2cbd42eacba00dbfb0c,0,GitHub,2021-01-06 14:01:02-08:00,['393139064f79ee664b6d8507ea1f974dad84c82e'],86,175,261,2406325,2,0.15625,0.921875,1,5382
71540c03b86f55111ca7cc9b0f87724b40e0bda2,1,GitHub,2021-01-07 09:46:07+01:00,['22e8e71156762b40ac93e2cbd42eacba00dbfb0c'],1,8,9,2406334,1,0,1,1,5382
f0ef5785e3964eab3844a36dc95c4c33fcf98ef5,0,Manikumar Reddy,2021-01-07 16:20:22+05:18,['71540c03b86f55111ca7cc9b0f87724b40e0bda2'],0,1,1,2406335,1,1,1,1,5382
52652a0dca647009a59ac9ed125e571a0e99af60,0,GitHub,2021-01-07 15:11:21-08:00,['f0ef5785e3964eab3844a36dc95c4c33fcf98ef5'],149,139,288,2406623,2,0.53125,1,0.40625,5382
94f9b919ab483661994810c90567c1938eb8e2f6,0,GitHub,2021-01-07 15:59:33-08:00,['52652a0dca647009a59ac9ed125e571a0e99af60'],0,6,6,2406629,1,,,,5382
e5733f3aded628551843f8a738ca2e794671d6b6,1,GitHub,2021-01-08 12:07:49+08:00,['94f9b919ab483661994810c90567c1938eb8e2f6'],1,1,2,2406631,1,,,,5382
8716ba1ff18a6d969c44d73bbfb756c2046a9802,0,GitHub,2021-01-08 09:46:29+01:00,['e5733f3aded628551843f8a738ca2e794671d6b6'],5,6,11,2406642,1,0,0,0,5382
689bb7dc80f96467475e9b6ebd1ba4b841bc1889,0,GitHub,2021-01-08 20:57:22+01:00,['8716ba1ff18a6d969c44d73bbfb756c2046a9802'],0,1,1,2406643,1,,,,5382
ea459d1457084d162860452a7e2166b2b4d2f878,0,GitHub,2021-01-08 17:38:40-08:00,['689bb7dc80f96467475e9b6ebd1ba4b841bc1889'],35,106,141,2406784,5,0.311111111,1,1,5382
f06dff11030b3eebc9baa8e7ff95a1ce0c8f5997,0,GitHub,2021-01-10 14:59:31+08:00,['ea459d1457084d162860452a7e2166b2b4d2f878'],58,40,98,2406882,2,1,0,0,5382
3697390402980d28e961f3094ab255dbfd8113e6,0,GitHub,2021-01-10 15:10:07+08:00,['f06dff11030b3eebc9baa8e7ff95a1ce0c8f5997'],2,4,6,2406888,1,,,,5382
913a019d6c9b03eb44706deb7fb164f79c1f601f,1,GitHub,2021-01-10 20:20:13+08:00,['3697390402980d28e961f3094ab255dbfd8113e6'],3127,2794,5921,2412809,264,0.896848138,0,0,5382
119a2d9127b8e0cbc2979eab42e837c2a43b8542,1,GitHub,2021-01-10 20:06:37+01:00,['913a019d6c9b03eb44706deb7fb164f79c1f601f'],65,78,143,2412952,29,,,,5382
33fcc830c1e81b4069455d3cff316194d6594997,0,GitHub,2021-01-11 13:27:19+08:00,['119a2d9127b8e0cbc2979eab42e837c2a43b8542'],1,1,2,2412954,1,,,,5382
39a92743218fdf8c3c89aa77922ea541845d0d92,0,GitHub,2021-01-11 13:43:56+08:00,['33fcc830c1e81b4069455d3cff316194d6594997'],2,7,9,2412963,1,,,,5382
f62c2b26cc5f6fd7c0df7eb39eb834dc82ed576c,1,GitHub,2021-01-11 09:28:12-08:00,['39a92743218fdf8c3c89aa77922ea541845d0d92'],246,455,701,2413664,10,0.935483871,1,0.89516129,5384
aedb53a4e6313398ed9626fbd2fbd7106e2ce94e,1,GitHub,2021-01-11 12:38:02-08:00,['f62c2b26cc5f6fd7c0df7eb39eb834dc82ed576c'],24,253,277,2413941,6,0.558659218,0.87150838,0.94972067,5384
7455b701028337b53fe434e4ff16a2881975584e,1,GitHub,2021-01-11 21:20:57-08:00,['aedb53a4e6313398ed9626fbd2fbd7106e2ce94e'],88,168,256,2414197,4,0,1,1,5385
1e4d33524510769aff819ac9ef780ae1f904c3bc,1,Colin P. Mccabe,2021-01-12 12:43:59-08:00,['7455b701028337b53fe434e4ff16a2881975584e'],23,533,556,2414753,18,0.35890411,0.824657534,0.983561644,5387
474ad1eebd7d80f5cfa2e5f783e6fd6aafcf388b,1,GitHub,2021-01-12 13:32:43-08:00,['1e4d33524510769aff819ac9ef780ae1f904c3bc'],252,230,482,2415235,5,1,0,0,5387
bed4c6a33b16b96c1a20f47d818f7a44eea33fa9,0,GitHub,2021-01-13 21:02:13+08:00,['474ad1eebd7d80f5cfa2e5f783e6fd6aafcf388b'],19,19,38,2415273,5,,,,5387
2996642566a729c6bbb1b7b1b41e8c0c75999b3d,0,GitHub,2021-01-13 21:49:11+08:00,['bed4c6a33b16b96c1a20f47d818f7a44eea33fa9'],1,1,2,2415275,1,,,,5387
1ad7cea1d889af78ce56b7d521c36228acb1c9d9,0,GitHub,2021-01-14 00:04:32+08:00,['2996642566a729c6bbb1b7b1b41e8c0c75999b3d'],3,2,5,2415280,1,,,,5387
94a0aac81d2d021826b52db1285c6b13b5ee2838,0,GitHub,2021-01-13 09:05:23-08:00,['1ad7cea1d889af78ce56b7d521c36228acb1c9d9'],3,14,17,2415297,4,0.625,0.625,1,5387
ee5ef89a71c57888b24f3bd4b5b82eead631aa7c,0,GitHub,2021-01-13 10:01:14-08:00,['94a0aac81d2d021826b52db1285c6b13b5ee2838'],5,2,7,2415304,1,0,0,1,5387
ee08b0b32ad6af82ecdfac04134dbf52996374d8,1,GitHub,2021-01-13 13:52:38-05:00,['ee5ef89a71c57888b24f3bd4b5b82eead631aa7c'],95,97,192,2415496,2,0,0,0,5387
fec6831b1063b7d9205faa79d4cd725bc59d427c,0,GitHub,2021-01-13 14:32:09-08:00,['ee08b0b32ad6af82ecdfac04134dbf52996374d8'],4,8,12,2415508,1,0,0,1,5387
52b8aa0fdce1872b5b525b62dc3ac2241cfaa379,1,GitHub,2021-01-13 16:17:45-08:00,['fec6831b1063b7d9205faa79d4cd725bc59d427c'],3527,3614,7141,2422649,262,0.486956522,0.365217391,0,5393
04827dad51583390a3b718a52a5d6f5931e8020c,0,GitHub,2021-01-13 21:23:48-08:00,['52b8aa0fdce1872b5b525b62dc3ac2241cfaa379'],133,143,276,2422925,15,0,0,0,5395
2896a4b8212f0efd0a8f0bba2fd5de207cb7ed86,0,GitHub,2021-01-14 17:52:56+08:00,['04827dad51583390a3b718a52a5d6f5931e8020c'],1,1,2,2422927,1,,,,5395
2746af45357f41b0ed130926562076b8d4f94673,0,GitHub,2021-01-14 12:16:16+00:00,['2896a4b8212f0efd0a8f0bba2fd5de207cb7ed86'],3,2,5,2422932,1,1,1,0,5395
966e9dd6a29072b81f3bef9fbfa50daff3c57c17,0,GitHub,2021-01-14 12:24:18+00:00,['2746af45357f41b0ed130926562076b8d4f94673'],7,8,15,2422947,4,,,,5395
fa66ecef280b3f66e1efdd32594fb7b3ba8f39ae,0,GitHub,2021-01-14 05:16:43-08:00,['966e9dd6a29072b81f3bef9fbfa50daff3c57c17'],1,4,5,2422952,1,,,,5395
06aa9c5aa373e742722f7ed34e3a01ead66b948e,0,GitHub,2021-01-14 05:47:48-08:00,['fa66ecef280b3f66e1efdd32594fb7b3ba8f39ae'],1,1,2,2422954,1,,,,5395
2cde6f61b8a3b4a13a771099c2a35f3013c46e70,1,GitHub,2021-01-14 14:48:17+00:00,['06aa9c5aa373e742722f7ed34e3a01ead66b948e'],598,722,1320,2424274,9,1,1,1,5398
217334b0f412e801bb3a3f5b10c71c1e33a2227a,0,GitHub,2021-01-14 09:58:52-08:00,['2cde6f61b8a3b4a13a771099c2a35f3013c46e70'],0,1133,1133,2425407,27,0.648888889,1,0.906666667,5420
4a985b594f3c5b55c6add8c902dc0748e59a3bef,0,GitHub,2021-01-14 13:25:48-08:00,['217334b0f412e801bb3a3f5b10c71c1e33a2227a'],3,3,6,2425413,1,,,,5420
a68c14190e8e4654d75c01e2f2c2fad536332b6b,0,GitHub,2021-01-14 15:43:47-08:00,['4a985b594f3c5b55c6add8c902dc0748e59a3bef'],27,16,43,2425456,3,1,0,0,5420
c49f660c621fc688a7998655e991b056bfde94a3,1,GitHub,2021-01-14 17:31:54-08:00,['a68c14190e8e4654d75c01e2f2c2fad536332b6b'],141,213,354,2425810,8,0.653846154,0.230769231,0.423076923,5421
0c92b8398dc1625e4cf601f170b262380fe3adf0,0,GitHub,2021-01-15 13:42:07+08:00,['c49f660c621fc688a7998655e991b056bfde94a3'],9,8,17,2425827,2,,,,5421
63f49f91ce409a7ba43d6fe38b0a5f3d95138927,0,GitHub,2021-01-15 14:23:42+08:00,['0c92b8398dc1625e4cf601f170b262380fe3adf0'],12,6,18,2425845,1,0,0,0,5421
738904ed6f3f85e08c522c27f233d1b49bcf8a8e,0,GitHub,2021-01-15 14:34:46+08:00,['63f49f91ce409a7ba43d6fe38b0a5f3d95138927'],9,5,14,2425859,1,0,0,0,5421
144b1230e3d1a3d88cd03faf7478a59bebbb02e2,0,GitHub,2021-01-15 05:40:48-08:00,['738904ed6f3f85e08c522c27f233d1b49bcf8a8e'],1,1,2,2425861,1,,,,5421
c9f3d5e7c455b66667f6cbc5b1dff4e40ff0b095,0,GitHub,2021-01-15 05:41:26-08:00,['144b1230e3d1a3d88cd03faf7478a59bebbb02e2'],1,32,33,2425894,2,1,1,1,5421
9361a43cfa07ab8589336ddf831070284099be62,0,GitHub,2021-01-16 00:53:14+08:00,['c9f3d5e7c455b66667f6cbc5b1dff4e40ff0b095'],45,28,73,2425967,5,1,1,0,5421
3e6c6f595016e808906d59c8c845654e2b46e637,0,GitHub,2021-01-16 03:14:08+08:00,['9361a43cfa07ab8589336ddf831070284099be62'],31,31,62,2426029,3,,,,5421
ba1e16f0c02aeeaba54600c1a828f6cd13acf1a4,1,GitHub,2021-01-15 12:28:43-08:00,['3e6c6f595016e808906d59c8c845654e2b46e637'],314,434,748,2426777,4,0.4,1,0.533333333,5423
b5c107363fda42def9d750f8015542ecc187b6fc,0,GitHub,2021-01-15 12:56:09-08:00,['ba1e16f0c02aeeaba54600c1a828f6cd13acf1a4'],13,13,26,2426803,9,,,,5423
7ac06065f1e25158688fc3be316ce9571dc51335,1,GitHub,2021-01-15 14:10:17-08:00,['b5c107363fda42def9d750f8015542ecc187b6fc'],117,232,349,2427152,11,0.546666667,0.906666667,1,5423
06c9a391011251a38b0941c81cc2bc1f37922e01,0,GitHub,2021-01-15 16:32:55-08:00,['7ac06065f1e25158688fc3be316ce9571dc51335'],3,24,27,2427179,2,0,1,1,5423
8f063c15da51d77a40aa63f110e48c5eeeaf5dfc,0,GitHub,2021-01-15 17:30:29-08:00,['06c9a391011251a38b0941c81cc2bc1f37922e01'],178,385,563,2427742,21,0.666666667,0.916666667,0.763888889,5427
bfc96efa3a9a004f963cd4913fb2875c84bc9cb8,1,GitHub,2021-01-15 20:36:25-08:00,['8f063c15da51d77a40aa63f110e48c5eeeaf5dfc'],106,444,550,2428292,21,0.175213675,0.824786325,0.94017094,5427
6f9e73cfd87d551a27fbd6d68ce2a0cf94e857b1,0,GitHub,2021-01-16 06:44:02-08:00,['bfc96efa3a9a004f963cd4913fb2875c84bc9cb8'],223,238,461,2428753,7,0.033333333,0,0.5,5428
4126cfd0492c0d97b3a0525c01ada1733800ec59,0,GitHub,2021-01-16 07:17:37-08:00,['6f9e73cfd87d551a27fbd6d68ce2a0cf94e857b1'],116,114,230,2428983,16,,,,5428
e0ebb1d202e8865ccfa31ed066ed50b7198312f4,1,GitHub,2021-01-16 09:30:04-08:00,['4126cfd0492c0d97b3a0525c01ada1733800ec59'],256,224,480,2429463,17,1,0,0,5428
87df3b9e7da03b7670f5c9724e55e7a24ca9de19,0,GitHub,2021-01-17 11:29:28-08:00,['e0ebb1d202e8865ccfa31ed066ed50b7198312f4'],77,0,77,2429540,1,,,,5428
962b69b5b31273d6072cc192fda60a89ef112f09,0,GitHub,2021-01-17 17:01:51-08:00,['87df3b9e7da03b7670f5c9724e55e7a24ca9de19'],40,33,73,2429613,5,0,0,0,5428
462be6da9b36b3e29268c94c1582f3b06c5d92c7,0,GitHub,2021-01-17 19:17:47-08:00,['962b69b5b31273d6072cc192fda60a89ef112f09'],208,154,362,2429975,23,0.87804878,0.073170732,0,5428
7bd10ff56a41969c3e318ae8694e2cee61e5dd0d,0,GitHub,2021-01-18 13:42:46+01:00,['462be6da9b36b3e29268c94c1582f3b06c5d92c7'],16,15,31,2430006,2,,,,5428
5a4bbb9f91f583a9c27a2f64f28547033da4f4fb,1,GitHub,2021-01-19 00:00:32+08:00,['7bd10ff56a41969c3e318ae8694e2cee61e5dd0d'],3877,3250,7127,2437133,276,1,0.906525573,0.003527337,5430
f2ac0c62ef19566b4303e23f8c817e157a3fc14f,0,GitHub,2021-01-19 00:05:44+08:00,['5a4bbb9f91f583a9c27a2f64f28547033da4f4fb'],18,19,37,2437170,3,1,1,1,5430
8648643abb91aa4f18372bc575b260860d0cbb3a,0,GitHub,2021-01-18 08:59:09-08:00,['f2ac0c62ef19566b4303e23f8c817e157a3fc14f'],9,22,31,2437201,1,,,,5430
1ca497a7fdb4f17bfc7d2ad87e0085a3adfab934,0,GitHub,2021-01-18 09:04:20-08:00,['8648643abb91aa4f18372bc575b260860d0cbb3a'],6,6,12,2437213,4,,,,5430
efff9db827f00f28765b5bdebda5709e200928f6,0,GitHub,2021-01-18 16:55:21-08:00,['1ca497a7fdb4f17bfc7d2ad87e0085a3adfab934'],20,13,33,2437246,2,1,0.5625,0.5625,5430
277c4371c74dd642a2b7ace2f5e0bfaba31de84a,0,GitHub,2021-01-19 13:38:30+08:00,['efff9db827f00f28765b5bdebda5709e200928f6'],20,70,90,2437336,1,0.363636364,1,1,5430
6752f2825444ad652930d708c6665c5e49a9b69a,1,GitHub,2021-01-19 17:54:34+08:00,['277c4371c74dd642a2b7ace2f5e0bfaba31de84a'],35,91,126,2437462,2,0.692307692,1,1,5430
418aaa0d3de8dde8f2a223cbc55b270540f66d4d,0,GitHub,2021-01-19 08:12:26-08:00,['6752f2825444ad652930d708c6665c5e49a9b69a'],0,7,7,2437469,1,,,,5430
ef5b7b701fa6e727c82454caf67e58d09bd83931,0,GitHub,2021-01-19 08:15:57-08:00,['418aaa0d3de8dde8f2a223cbc55b270540f66d4d'],1,3,4,2437473,1,,,,5430
f7c0b0d1728c0d5ccac90776be86d2c4740633cc,1,GitHub,2021-01-20 00:37:45+08:00,['ef5b7b701fa6e727c82454caf67e58d09bd83931'],227,223,450,2437923,22,0.75,1,0.964285714,5430
302eee63c479fd4b955c44f1058a5e5d111acb57,1,GitHub,2021-01-19 18:43:36+01:00,['f7c0b0d1728c0d5ccac90776be86d2c4740633cc'],3,498,501,2438424,15,0.5,0.964285714,0.984126984,5435
130274b7f64bb07de8f9f431b4e3dbbe6be5ddde,0,GitHub,2021-01-19 10:31:14-08:00,['302eee63c479fd4b955c44f1058a5e5d111acb57'],16,42,58,2438482,1,0.352941176,0.352941176,1,5435
4c6f9006738f9cdd570199ae71dbaceed26865b1,0,GitHub,2021-01-19 10:34:46-08:00,['130274b7f64bb07de8f9f431b4e3dbbe6be5ddde'],2,2,4,2438486,1,,,,5435
be88f5a1aa5efcd321d24befa7877d541628c714,0,GitHub,2021-01-19 14:57:34-06:00,['4c6f9006738f9cdd570199ae71dbaceed26865b1'],26,29,55,2438541,1,0,1,1,5435
add160d522d8ce6ce70595bd76196e7f42a21435,0,GitHub,2021-01-19 13:30:23-08:00,['be88f5a1aa5efcd321d24befa7877d541628c714'],7,146,153,2438694,2,,,,5435
0158e1d7196748aa346da90f688048a32f75c2d1,1,GitHub,2021-01-19 19:28:46-08:00,['add160d522d8ce6ce70595bd76196e7f42a21435'],142,397,539,2439233,7,0.702898551,0.81884058,0.826086957,5436
918c332cbfed9cf3e00d6d8a3cdd353a903865b2,0,GitHub,2021-01-20 15:48:44+08:00,['0158e1d7196748aa346da90f688048a32f75c2d1'],50,76,126,2439359,5,0,1,0.409090909,5436
38b320a1f286f6e7a3509deeb1b0393a221c5e70,0,GitHub,2021-01-20 22:58:04+08:00,['918c332cbfed9cf3e00d6d8a3cdd353a903865b2'],3,3,6,2439365,1,,,,5436
287b600cf712a4a7e9139e15e1151768f67eec75,0,GitHub,2021-01-20 17:45:45+01:00,['38b320a1f286f6e7a3509deeb1b0393a221c5e70'],26,156,182,2439547,3,0.079207921,0.287128713,0.712871287,5436
462c89e0b436abd56864bea8bbcaf1ab70b7f66e,1,GitHub,2021-01-20 11:37:56-08:00,['287b600cf712a4a7e9139e15e1151768f67eec75'],25,35,60,2439607,2,0.666666667,0.666666667,0.666666667,5436
86b9fdef2b9e6ef3429313afbaa18487d6e2906e,1,GitHub,2021-01-20 22:32:06+00:00,['462c89e0b436abd56864bea8bbcaf1ab70b7f66e'],47,290,337,2439944,18,0.185185185,0.722222222,0.919753086,5437
484c99e200cb16ee950ebb5e35b37a40e46163ca,0,GitHub,2021-01-21 11:42:47+08:00,['86b9fdef2b9e6ef3429313afbaa18487d6e2906e'],124,92,216,2440160,9,0.214285714,0,0,5437
62860fa0a15a474130d63a9459b5ddb5335b5987,0,GitHub,2021-01-21 12:06:35+08:00,['484c99e200cb16ee950ebb5e35b37a40e46163ca'],1,19,20,2440180,2,0.75,0.75,0.75,5437
eb026fcf82db3daccb9e4108c0347fa6d5af187c,1,GitHub,2021-01-21 09:38:19+01:00,['62860fa0a15a474130d63a9459b5ddb5335b5987'],41,316,357,2440537,4,0.179310345,1,0.765517241,5437
24e7e81524d60e933d05298ff2fa47c699e6ac35,0,GitHub,2021-01-21 17:34:08+01:00,['eb026fcf82db3daccb9e4108c0347fa6d5af187c'],67,79,146,2440683,1,0.75,1,1,5437
92e72f7bf96841d7991f1d71f440c2da06dd89cf,0,GitHub,2021-01-21 08:52:34-08:00,['24e7e81524d60e933d05298ff2fa47c699e6ac35'],59,115,174,2440857,2,0,1,0.95,5437
976e6ea0f77c16816b068720abd476005073f39d,0,GitHub,2021-01-21 18:18:48+00:00,['92e72f7bf96841d7991f1d71f440c2da06dd89cf'],2,2,4,2440861,2,,,,5437
fea2f65929e7283df09bdc1c82dd248abc4cdd45,0,GitHub,2021-01-21 10:26:23-08:00,['976e6ea0f77c16816b068720abd476005073f39d'],269,170,439,2441300,10,0.166666667,0,1,5437
9689a313f52a7b45f38faecddf018dc8ab02dc62,1,GitHub,2021-01-21 15:16:15-08:00,['fea2f65929e7283df09bdc1c82dd248abc4cdd45'],110,132,242,2441542,26,0,1,0.608695652,5437
45550e98f031f7401b8ea8a8e16eeedc0ccbdc7b,0,GitHub,2021-01-21 16:32:55-08:00,['9689a313f52a7b45f38faecddf018dc8ab02dc62'],14,25,39,2441581,2,0,0,1,5437
7a1d1d9a69a241efd68e572badee999229b3942f,0,GitHub,2021-01-22 09:06:37+01:00,['45550e98f031f7401b8ea8a8e16eeedc0ccbdc7b'],26,89,115,2441696,4,0.977777778,0.955555556,1,5437
019cd4ab80f21f8234f96d151fc0e649916bf4ab,0,GitHub,2021-01-22 10:03:39-08:00,['7a1d1d9a69a241efd68e572badee999229b3942f'],141,655,796,2442492,5,0.239067055,1,0.89212828,5439
7b06a2417df0d098b8947327f77629f16d2f5e49,0,GitHub,2021-01-22 12:15:52-08:00,['019cd4ab80f21f8234f96d151fc0e649916bf4ab'],16,38,54,2442546,2,0,1,1,5439
667a6b2d2611200e8363d67185785412bb701d73,1,GitHub,2021-01-22 15:55:05-08:00,['7b06a2417df0d098b8947327f77629f16d2f5e49'],3,4,7,2442553,1,0,1,1,5439
91d6c55da4cd9d4023d87bf96ee5d23fbc7d3c21,0,GitHub,2021-01-22 20:23:55-08:00,['667a6b2d2611200e8363d67185785412bb701d73'],2,2,4,2442557,2,,,,5439
6d411620ddb731fd5eb5b05280b89d31ac52ee3d,1,GitHub,2021-01-23 13:07:31-08:00,['91d6c55da4cd9d4023d87bf96ee5d23fbc7d3c21'],63,40,103,2442660,10,0.263157895,0.105263158,0.263157895,5439
b8a92012808c8e55a17011d1ac31539a79ed8fd3,0,GitHub,2021-01-23 15:54:06-08:00,['6d411620ddb731fd5eb5b05280b89d31ac52ee3d'],3,3,6,2442666,3,,,,5439
6f8ca661270c18f92304976dc8266ef2af3c16e5,0,GitHub,2021-01-23 15:57:25-08:00,['b8a92012808c8e55a17011d1ac31539a79ed8fd3'],50,36,86,2442752,1,1,0,0,5439
f4c2030b2006fc0c447a10f8b251579424f39f7b,0,GitHub,2021-01-24 08:47:37+01:00,['6f8ca661270c18f92304976dc8266ef2af3c16e5'],16,16,32,2442784,11,,,,5439
cb0e781b31aabfcf96f4e9b7271dfcc7fe666e10,0,GitHub,2021-01-24 14:09:57+01:00,['f4c2030b2006fc0c447a10f8b251579424f39f7b'],1,1,2,2442786,1,,,,5439
24a2ed26a642d13701dfb501e14a05280ba01415,0,GitHub,2021-01-24 20:20:52-08:00,['cb0e781b31aabfcf96f4e9b7271dfcc7fe666e10'],7,15,22,2442808,3,0,1,1,5439
cd0b9280d4ba39f6adf450c70b8c011374c27f12,0,GitHub,2021-01-25 15:42:45+08:00,['24a2ed26a642d13701dfb501e14a05280ba01415'],3,1,4,2442812,1,,,,5439
35f03ec5c657fc4d2404692e6e1cc8631bb5458a,0,GitHub,2021-01-25 15:54:12+08:00,['cd0b9280d4ba39f6adf450c70b8c011374c27f12'],1,1,2,2442814,1,,,,5439
411ac7d4c0df9359eec9068018da60ffb02cbb50,0,GitHub,2021-01-25 04:41:30-08:00,['35f03ec5c657fc4d2404692e6e1cc8631bb5458a'],539,26,565,2443379,10,0.884615385,0.542986425,0.524886878,5439
e1a4dccc15676713ca4a9a47096975bc8dd38b8b,0,GitHub,2021-01-25 11:33:05-08:00,['411ac7d4c0df9359eec9068018da60ffb02cbb50'],24,40,64,2443443,2,0.222222222,1,1,5439
45b7a0a334970dadb842dbc4e781606b54288485,0,GitHub,2021-01-25 19:36:57-08:00,['e1a4dccc15676713ca4a9a47096975bc8dd38b8b'],1,6,7,2443450,2,0,1,1,5439
7230d148f4288b40f3d14e77ebdb48edb1c7b579,0,GitHub,2021-01-26 13:59:33+08:00,['45b7a0a334970dadb842dbc4e781606b54288485'],2,2,4,2443454,1,,,,5439
0c6bb3d6ff2e7d148eb4c32f802b869bf0c0107c,0,GitHub,2021-01-26 16:27:37+08:00,['7230d148f4288b40f3d14e77ebdb48edb1c7b579'],35,0,35,2443489,1,0,0,0,5439
3d6776102e985b9839cdcf8904cdde23c781ca67,0,GitHub,2021-01-27 02:01:12+08:00,['0c6bb3d6ff2e7d148eb4c32f802b869bf0c0107c'],1,1,2,2443491,1,,,,5439
f572545611b3e5daa71bd7b3f0c20cba01dfb46d,0,GitHub,2021-01-26 10:17:05-08:00,['3d6776102e985b9839cdcf8904cdde23c781ca67'],2,109,111,2443602,2,0.074074074,0.679012346,1,5439
a26db2a1ec931fa43b350b37639e6116b7ccffc4,0,GitHub,2021-01-26 10:33:36-08:00,['f572545611b3e5daa71bd7b3f0c20cba01dfb46d'],146,565,711,2444313,26,0.701986755,1,0.847682119,5444
6c8033abf3161f78d92244cdd915102844aafc05,0,GitHub,2021-01-26 11:38:13-08:00,['a26db2a1ec931fa43b350b37639e6116b7ccffc4'],0,6,6,2444319,1,,,,5444
647c609cef3914f7cf2923314c4e99714d86ca25,1,GitHub,2021-01-26 11:43:49-08:00,['6c8033abf3161f78d92244cdd915102844aafc05'],144,115,259,2444578,9,0.857142857,0,0.285714286,5444
35b1e76ffd7a2d03beb5d17710e670aa3717d12e,0,GitHub,2021-01-26 19:05:37-08:00,['647c609cef3914f7cf2923314c4e99714d86ca25'],22,37,59,2444637,1,0.444444444,0,1,5444
c830bce570c0a008a201dfbe1531cfd36ceef6e3,0,GitHub,2021-01-27 11:14:31+08:00,['35b1e76ffd7a2d03beb5d17710e670aa3717d12e'],1,1,2,2444639,1,,,,5444
4075a5c8e835b727e0aa262577f2c3282e8516a1,0,GitHub,2021-01-27 12:43:10+08:00,['c830bce570c0a008a201dfbe1531cfd36ceef6e3'],3,3,6,2444645,1,,,,5444
91c504c55a04e6d3a3d7623b5e02633440ec53d3,0,GitHub,2021-01-27 12:51:28+08:00,['4075a5c8e835b727e0aa262577f2c3282e8516a1'],1,24,25,2444670,2,1,1,1,5444
fc68c0fc9b1199b4eb63d9d486b012667c1d448f,0,GitHub,2021-01-27 14:43:07+08:00,['91c504c55a04e6d3a3d7623b5e02633440ec53d3'],2,2,4,2444674,2,,,,5444
8bdab2e4cf0d6a1d4ff3bb3b30f9db22c146bd8c,1,GitHub,2021-01-27 14:50:01+08:00,['fc68c0fc9b1199b4eb63d9d486b012667c1d448f'],10,9,19,2444693,2,,,,5444
fb6c7beb297fab16c533c5df484e36771ade8ecd,0,GitHub,2021-01-27 14:52:33+08:00,['8bdab2e4cf0d6a1d4ff3bb3b30f9db22c146bd8c'],25,21,46,2444739,1,1,1,1,5444
5cf9cfcaba67cffa2435b07ade58365449c60bd9,0,GitHub,2021-01-27 05:39:02-08:00,['fb6c7beb297fab16c533c5df484e36771ade8ecd'],1,1,2,2444741,1,,,,5444
f4983f41727305a0e26eb979b7ddc32782683f92,1,GitHub,2021-01-27 11:51:34-05:00,['5cf9cfcaba67cffa2435b07ade58365449c60bd9'],28,575,603,2445344,2,,,,5444
fdcf8fbf72bee9e672d0790cdbe5539846f7dc8e,1,GitHub,2021-01-27 18:18:38-06:00,['f4983f41727305a0e26eb979b7ddc32782683f92'],81,473,554,2445898,12,0.569565217,0.939130435,0.895652174,5445
3daa348f0dfb39e38b84db616b397507c0cf92e6,0,GitHub,2021-01-28 09:02:39+08:00,['fdcf8fbf72bee9e672d0790cdbe5539846f7dc8e'],1,1,2,2445900,1,,,,5445
4d28391480fd8c547a63af119bba67fceb5d2ede,1,GitHub,2021-01-27 21:57:20-06:00,['3daa348f0dfb39e38b84db616b397507c0cf92e6'],364,790,1154,2447054,19,0.080779944,0.782729805,0.832869081,5445
923dea34b8b778a17080a3d8a4d9d9f36410e1ba,0,GitHub,2021-01-28 14:12:54+08:00,['4d28391480fd8c547a63af119bba67fceb5d2ede'],3,57,60,2447114,2,1,1,1,5446
a5deb5326ff53b9bed08f4b2805e857cc8ed483f,0,GitHub,2021-01-28 17:14:28+08:00,['923dea34b8b778a17080a3d8a4d9d9f36410e1ba'],19,5,24,2447138,2,0,0,0,5446
550d8b82609ed3771f15d908bcf00fade2d2511e,0,GitHub,2021-01-28 09:57:18-05:00,['a5deb5326ff53b9bed08f4b2805e857cc8ed483f'],133,1245,1378,2448516,12,1,1,0.622807018,5446
61431f5b4375d4edf45078bae91650b57237b0e4,0,GitHub,2021-01-28 07:24:35-08:00,['550d8b82609ed3771f15d908bcf00fade2d2511e'],0,1,1,2448517,1,,,,5446
a63094930fe38c6d8ef2d6a2c820460c255eb046,0,GitHub,2021-01-28 14:52:51-08:00,['61431f5b4375d4edf45078bae91650b57237b0e4'],2,96,98,2448615,2,0.583333333,0.583333333,1,5446
27a998e8a06461145dfa8016f7fcd379debd3cbb,1,GitHub,2021-01-28 17:14:56-08:00,['a63094930fe38c6d8ef2d6a2c820460c255eb046'],104,172,276,2448891,11,0.111111111,0.777777778,0.622222222,5446
bf4afae8f53471ab6403cbbfcd2c4e427bdd4568,0,Ismael Juma,2021-01-28 18:32:35-08:00,['27a998e8a06461145dfa8016f7fcd379debd3cbb'],11,9,20,2448911,1,0,0,0,5446
e3ff4b087050b5a4b3f819a9535fb8275a380e23,1,GitHub,2021-01-29 09:45:13-06:00,['bf4afae8f53471ab6403cbbfcd2c4e427bdd4568'],9,43,52,2448963,8,0.192307692,0.961538462,0.961538462,5446
eff51a82f2668bd2beb7d19fe047ba0b3a7126cb,0,GitHub,2021-01-29 09:00:56-08:00,['e3ff4b087050b5a4b3f819a9535fb8275a380e23'],0,28,28,2448991,2,,,,5446
d87fc217634d7c89e55ccfb686a714527bfb03f4,0,GitHub,2021-01-29 11:37:43-08:00,['eff51a82f2668bd2beb7d19fe047ba0b3a7126cb'],3,2,5,2448996,2,,,,5446
4f588f7ca2a1c5e8dd845863da81425ac69bac92,0,GitHub,2021-01-29 19:40:16+00:00,['d87fc217634d7c89e55ccfb686a714527bfb03f4'],48,815,863,2449859,23,0.24288425,0.696394687,0.802656546,5448
bd6c212538984399e78ab6a3493a15270b38eca9,1,GitHub,2021-01-29 12:35:34-08:00,['4f588f7ca2a1c5e8dd845863da81425ac69bac92'],19,208,227,2450086,5,0.224489796,0.537414966,0.986394558,5448
5b3351e10b339f5ef43fa4ec9e23544acad298c3,1,GitHub,2021-01-29 14:06:01-08:00,['bd6c212538984399e78ab6a3493a15270b38eca9'],308,1810,2118,2452204,26,0.327213823,0.854211663,0.881209503,5452
e9edf104866822d9e6c3b637ffbf338767b5bf27,1,GitHub,2021-01-29 17:00:14-08:00,['5b3351e10b339f5ef43fa4ec9e23544acad298c3'],40,698,738,2452942,18,0.236979167,0.96875,0.8046875,5456
23de8cbe12ae9e8f1795f507dbf7705bacb56d21,0,GitHub,2021-01-30 20:03:15+08:00,['e9edf104866822d9e6c3b637ffbf338767b5bf27'],0,8,8,2452950,1,1,1,1,5456
7205cd36e41d1beb3d8f375e1cfdf3c80e0ef06c,1,GitHub,2021-01-30 17:05:31-08:00,['23de8cbe12ae9e8f1795f507dbf7705bacb56d21'],162,888,1050,2454000,23,0.727472527,0.964835165,0.986813187,5459
47b417260cc8b0368119e2693cbe27ed1ace76a2,0,GitHub,2021-02-01 12:40:02+08:00,['7205cd36e41d1beb3d8f375e1cfdf3c80e0ef06c'],0,4,4,2454004,4,,,,5459
1c00d9dfa50570b4554a123bfe91ccc5e9ad1ca9,0,GitHub,2021-02-01 13:13:18+08:00,['47b417260cc8b0368119e2693cbe27ed1ace76a2'],6,2,8,2454012,1,0,0,0,5459
db73d86ea65413af73a95268f1a10787079f79d9,0,GitHub,2021-02-01 10:05:47-08:00,['1c00d9dfa50570b4554a123bfe91ccc5e9ad1ca9'],16,55,71,2454083,7,0.172413793,0.862068966,0.75862069,5459
7feb55731ea9a86f81e8b1ed2b8dc44dba546dfe,1,GitHub,2021-02-01 10:16:28-08:00,['db73d86ea65413af73a95268f1a10787079f79d9'],60,88,148,2454231,12,1,1,1,5459
af2e8bc193b0c121ab1194cd65e8c2db6eaad76c,0,GitHub,2021-02-01 11:35:04-08:00,['7feb55731ea9a86f81e8b1ed2b8dc44dba546dfe'],49,57,106,2454337,1,0,1,0,5459
62218a05d3c1564fadd1cb64daf4932107f10819,1,GitHub,2021-02-01 14:30:53-08:00,['af2e8bc193b0c121ab1194cd65e8c2db6eaad76c'],70,78,148,2454485,4,1,1,0.6,5459
f5a2fbac6d26fc1613ec34d9764a1e86732f0a45,0,GitHub,2021-02-01 16:20:35-08:00,['62218a05d3c1564fadd1cb64daf4932107f10819'],125,207,332,2454817,11,0.085106383,0.446808511,0.936170213,5459
a022072df3c8175950c03263d2bbf2e3ea7a7a5d,0,GitHub,2021-02-01 21:59:30-08:00,['f5a2fbac6d26fc1613ec34d9764a1e86732f0a45'],2,505,507,2455324,16,0.742331288,0.754601227,0.950920245,5467
fd2a0ec480ae4a483f6f7d7024f24ce6d6cb8ca4,0,GitHub,2021-02-02 15:33:29+08:00,['a022072df3c8175950c03263d2bbf2e3ea7a7a5d'],45,42,87,2455411,1,1,1,0,5467
821d867c1bd01b88aa695827cb57c9aa764857a4,0,GitHub,2021-02-02 16:07:11+08:00,['fd2a0ec480ae4a483f6f7d7024f24ce6d6cb8ca4'],1,0,1,2455412,1,1,0,0,5467
5c562efb2d76407011ea88c1ca1b2355079935bc,0,GitHub,2021-02-02 14:56:23+00:00,['821d867c1bd01b88aa695827cb57c9aa764857a4'],17,231,248,2455660,10,0.60483871,0.64516129,0.661290323,5467
8bdfc5770d794071c11008259fa306aa2f7843d9,0,GitHub,2021-02-02 10:12:22-08:00,['5c562efb2d76407011ea88c1ca1b2355079935bc'],0,5,5,2455665,1,,,,5467
1711cfa4ebe325b2445d7bf00cf3e8b93377e4b1,1,GitHub,2021-02-02 11:33:55-08:00,['8bdfc5770d794071c11008259fa306aa2f7843d9'],0,2554,2554,2458219,16,0.623859649,0.853333333,0.990877193,5481
e260f64a9c763f30df13e6694893cdcc15a1acfe,0,GitHub,2021-02-02 12:04:06-08:00,['1711cfa4ebe325b2445d7bf00cf3e8b93377e4b1'],41,127,168,2458387,4,0.129032258,0.758064516,0.725806452,5481
1390d02ce4a1c9be47e360b08a0dd4f8a3dcf03e,0,GitHub,2021-02-03 12:12:11+08:00,['e260f64a9c763f30df13e6694893cdcc15a1acfe'],1,1,2,2458389,1,,,,5481
2ab5301085fa4ad5db778953505c317875e299a2,1,Colin P. Mccabe,2021-02-02 21:29:51-08:00,['1390d02ce4a1c9be47e360b08a0dd4f8a3dcf03e'],113,177,290,2458679,16,1,1,1,5482
0eba4cce5dc8468a04e8629ea855cde5ea253336,0,GitHub,2021-02-02 21:44:05-08:00,['2ab5301085fa4ad5db778953505c317875e299a2'],1,32,33,2458712,2,1,1,1,5483
e31d3d46427e59cca9e3df19bf0bd79bc827b7d3,0,GitHub,2021-02-03 01:19:36-08:00,['0eba4cce5dc8468a04e8629ea855cde5ea253336'],57,118,175,2458887,15,0.612903226,0.548387097,0.870967742,5483
3f36f9a7ca153a9d221f6bedeb7d1503aa18eff1,0,GitHub,2021-02-03 05:46:46-08:00,['e31d3d46427e59cca9e3df19bf0bd79bc827b7d3'],13,509,522,2459409,17,0.806930693,0.985148515,0.98019802,5489
eb524ec73eca7fd1b4e9871a5fa3cc0fb397d4dd,1,GitHub,2021-02-03 23:46:11+08:00,['3f36f9a7ca153a9d221f6bedeb7d1503aa18eff1'],1,1,2,2459411,1,,,,5489
49f9229ea61bc0a79df32dd71685b2b2d2d55a0a,0,GitHub,2021-02-03 08:11:22-08:00,['eb524ec73eca7fd1b4e9871a5fa3cc0fb397d4dd'],37,45,82,2459493,5,0.75,0.75,1,5489
14377afdacc73dc8b10b7521536328412d07e39f,0,GitHub,2021-02-03 09:01:58-08:00,['49f9229ea61bc0a79df32dd71685b2b2d2d55a0a'],53,0,53,2459546,1,,,,5489
51833bf37c7ab5ce24aed82749d45f5c8550d12f,1,GitHub,2021-02-03 10:26:30-08:00,['14377afdacc73dc8b10b7521536328412d07e39f'],10,467,477,2460023,18,0.23964497,0.869822485,0.890532544,5489
3acc1938534131c6e84a0be4e8839c33bc034bfe,1,GitHub,2021-02-03 10:30:20-08:00,['51833bf37c7ab5ce24aed82749d45f5c8550d12f'],93,250,343,2460366,7,0.2734375,0.7734375,1,5490
70404baffa47b99914d34143e779b0e65522a5ef,0,GitHub,2021-02-03 11:47:49-08:00,['3acc1938534131c6e84a0be4e8839c33bc034bfe'],2,2,4,2460370,2,,,,5490
772f2cfc828d9da56559968a8eed06f2c8c43062,0,GitHub,2021-02-03 13:41:38-08:00,['70404baffa47b99914d34143e779b0e65522a5ef'],128,56,184,2460554,16,0,0,0,5490
0fe9fde376cb1dc63184fea9d1fdc7ebc0c8531f,0,GitHub,2021-02-03 13:51:03-08:00,['772f2cfc828d9da56559968a8eed06f2c8c43062'],3,79,82,2460636,2,1,1,1,5490
e119ea66cb1458637039c16169728c9e9989ec52,1,David Arthur,2021-02-03 17:08:13-05:00,['0fe9fde376cb1dc63184fea9d1fdc7ebc0c8531f'],1,794,795,2461431,6,0.634328358,0.884328358,0.940298507,5495
c64241f9c2b066f68ddbab2a21650daa856838dc,0,GitHub,2021-02-03 15:39:32-08:00,['e119ea66cb1458637039c16169728c9e9989ec52'],10,10,20,2461451,4,,,,5495
f58c2acf2676e1375fbca6f421f321549619c558,0,GitHub,2021-02-03 16:16:35-08:00,['c64241f9c2b066f68ddbab2a21650daa856838dc'],39,257,296,2461747,13,0.705882353,1,0.929411765,5498
5eb8a238e29184b84f0b675eec3df538572c973c,0,GitHub,2021-02-03 18:29:55-06:00,['f58c2acf2676e1375fbca6f421f321549619c558'],24,192,216,2461963,5,0.75257732,0.979381443,0.979381443,5498
706f5097b70ce140e6a0473ad55342b514b6db04,1,GitHub,2021-02-03 18:01:26-08:00,['5eb8a238e29184b84f0b675eec3df538572c973c'],234,499,733,2462696,9,0.788819876,0.869565217,0.664596273,5498
f4ddb89166fb0ec98feee53ff760f3b929f47860,0,GitHub,2021-02-04 11:07:45+08:00,['706f5097b70ce140e6a0473ad55342b514b6db04'],1,0,1,2462697,1,,,,5498
1c56abaa625465df2be5e217e0d09b0caf2fb602,0,GitHub,2021-02-04 13:51:53+08:00,['f4ddb89166fb0ec98feee53ff760f3b929f47860'],3,2,5,2462702,1,,,,5498
131d4753cfed65ed6dee0a8c754765c97c3d513f,0,GitHub,2021-02-04 11:42:43+00:00,['1c56abaa625465df2be5e217e0d09b0caf2fb602'],69,400,469,2463171,10,0.083870968,0.767741935,0.870967742,5501
c19a35d1b740c85559a7ff4e882fc95b4737808d,1,GitHub,2021-02-04 09:15:49-08:00,['131d4753cfed65ed6dee0a8c754765c97c3d513f'],1637,983,2620,2465791,50,1,0.052542373,0.088135593,5501
ca29727d2afd85156ab8e48771785193270f28a1,1,GitHub,2021-02-04 10:48:04-08:00,['c19a35d1b740c85559a7ff4e882fc95b4737808d'],51,162,213,2466004,4,0.441860465,0,1,5502
c4ea6fb0a7cce5cf54e8ddd32bb14e99e639b8df,1,GitHub,2021-02-04 12:58:26-08:00,['ca29727d2afd85156ab8e48771785193270f28a1'],357,736,1093,2467097,29,0.503496503,0.993006993,0.888111888,5508
d98df7fc4d968e46a130d23e2c01ef861924d7d9,0,GitHub,2021-02-04 14:46:57-08:00,['c4ea6fb0a7cce5cf54e8ddd32bb14e99e639b8df'],0,942,942,2468039,5,0.423553719,0.756198347,0.884297521,5511
5552da3a20ca432626d62b0e892bd25501484689,0,GitHub,2021-02-04 16:23:35-08:00,['d98df7fc4d968e46a130d23e2c01ef861924d7d9'],72,1097,1169,2469208,20,0.810344828,0.995689655,0.862068966,5519
b78fa9cea24b9f0abff45ca873a49cdb7370430d,0,GitHub,2021-02-04 17:01:07-08:00,['5552da3a20ca432626d62b0e892bd25501484689'],0,112,112,2469320,6,0.430379747,1,0.898734177,5519
07843cfbf4e3e7a2d26d63904bbf0da0fcd07ca2,1,GitHub,2021-02-04 17:08:56-08:00,['b78fa9cea24b9f0abff45ca873a49cdb7370430d'],240,233,473,2469793,41,1,0,0,5519
016128c92085f2a77e77261583a434e947040fab,0,GitHub,2021-02-04 18:50:19-08:00,['07843cfbf4e3e7a2d26d63904bbf0da0fcd07ca2'],8,13,21,2469814,1,,,,5519
c8dc74e16deb59bab7e6adb08d9e1281af51ddd0,0,GitHub,2021-02-04 18:54:08-08:00,['016128c92085f2a77e77261583a434e947040fab'],3,3,6,2469820,2,,,,5519
470e6f2b9ac45fc32bdeb77d0bf4c72d26c6f3fd,1,GitHub,2021-02-04 19:02:56-08:00,['c8dc74e16deb59bab7e6adb08d9e1281af51ddd0'],63,328,391,2470211,8,0.162037037,0.87962963,0.967592593,5519
d01d97ed665c14e7289ede0ccebbc5921d6fc86e,0,GitHub,2021-02-04 20:18:20-08:00,['470e6f2b9ac45fc32bdeb77d0bf4c72d26c6f3fd'],9,8,17,2470228,2,,,,5519
a3305c4b8b29c9fb4eede11aea4dd6fd60e445dc,1,GitHub,2021-02-05 08:51:00-08:00,['d01d97ed665c14e7289ede0ccebbc5921d6fc86e'],75,68,143,2470371,11,0.047619048,0.952380952,1,5519
acf39fe94ad6a666e7ddd88dbcc6ddf5173fe56c,1,GitHub,2021-02-05 12:57:44-08:00,['a3305c4b8b29c9fb4eede11aea4dd6fd60e445dc'],68,341,409,2470780,5,0.732323232,0.949494949,0.873737374,5520
242f65e5ba8a546cff6d85e663d27282a93bfd6a,0,GitHub,2021-02-05 16:25:26-08:00,['acf39fe94ad6a666e7ddd88dbcc6ddf5173fe56c'],90,584,674,2471454,19,0.393063584,0.656069364,0.552023121,5521
0bc394cc1d19f1e41dd6646e9ac0e09b91fb1398,0,GitHub,2021-02-05 17:25:50-08:00,['242f65e5ba8a546cff6d85e663d27282a93bfd6a'],169,223,392,2471846,10,0.2,0.4,1,5521
3a766bd30dfea3c246b82e9028eea26a628ffee3,0,Manikumar Reddy,2021-02-06 19:38:54+05:18,['0bc394cc1d19f1e41dd6646e9ac0e09b91fb1398'],234,234,468,2472314,1,,,,5521
d2cb2dc45d536ae124e3da25d6d5a4e932a23a27,1,GitHub,2021-02-06 13:04:30-08:00,['3a766bd30dfea3c246b82e9028eea26a628ffee3'],467,1334,1801,2474115,32,0.398916968,0.945848375,0.718411552,5526
1f240ce1793cab09e1c4823e17436d2b030df2bc,0,John Roesler,2021-02-07 09:25:36-06:00,['d2cb2dc45d536ae124e3da25d6d5a4e932a23a27'],10,14,24,2474139,8,,,,5526
4cab6092492fcdbfcb040cec1dd247e3113ec8f7,0,GitHub,2021-02-08 01:06:54+08:00,['1f240ce1793cab09e1c4823e17436d2b030df2bc'],5,5,10,2474149,2,,,,5526
42a9355e606bd2bbdb7fd0dd348805e6666dc189,1,GitHub,2021-02-07 15:46:41-08:00,['4cab6092492fcdbfcb040cec1dd247e3113ec8f7'],242,245,487,2474636,19,1,0.571428571,0.142857143,5526
8bd5ceb3d297bd6cd06ccec52978315898719e6d,0,GitHub,2021-02-08 18:04:47+05:18,['42a9355e606bd2bbdb7fd0dd348805e6666dc189'],1,1,2,2474638,1,,,,5526
8c7284275ec8706523d36159c4d97b4c6d8b4e99,0,GitHub,2021-02-08 10:22:40-08:00,['8bd5ceb3d297bd6cd06ccec52978315898719e6d'],2,1,3,2474641,1,1,1,1,5526
1d3e293c08b8073f992cdc8c240dfae7e036efd1,0,GitHub,2021-02-08 12:07:39-08:00,['8c7284275ec8706523d36159c4d97b4c6d8b4e99'],4,268,272,2474913,6,0.432432432,0.574324324,0.858108108,5530
1f508ea8c33726f6a4690b4eabe9713b277a7dd8,0,GitHub,2021-02-08 12:42:40-08:00,['1d3e293c08b8073f992cdc8c240dfae7e036efd1'],3,445,448,2475361,4,0.235820896,0.489552239,0.895522388,5533
3769bc21b5e4b48785b2c795ade8458d849ceda5,0,GitHub,2021-02-09 10:06:01+08:00,['1f508ea8c33726f6a4690b4eabe9713b277a7dd8'],39,49,88,2475449,16,,,,5533
1bfce16de5a2d3957e2af3548a256d1dae09f0d1,0,GitHub,2021-02-09 11:34:26+08:00,['3769bc21b5e4b48785b2c795ade8458d849ceda5'],13,22,35,2475484,3,1,1,1,5533
e7e4252b0ff2add9acbc8cd61cef2cae94c0c2ff,1,GitHub,2021-02-09 11:49:33-05:00,['1bfce16de5a2d3957e2af3548a256d1dae09f0d1'],111,1690,1801,2477285,25,0.645435244,0.823779193,0.762208068,5550
982ea2f6a471c217c7400a725c9504d9d8348d02,1,GitHub,2021-02-09 11:09:41-06:00,['e7e4252b0ff2add9acbc8cd61cef2cae94c0c2ff'],64,808,872,2478157,14,0.455696203,0.903797468,0.883544304,5552
7583e14fb20b34a044d92dcf6b078456bc4f6903,0,GitHub,2021-02-10 11:18:13+08:00,['982ea2f6a471c217c7400a725c9504d9d8348d02'],4,4,8,2478165,1,,,,5552
19506b6c012c919410a2aadc75453586ec7072b3,0,GitHub,2021-02-10 11:24:13+00:00,['7583e14fb20b34a044d92dcf6b078456bc4f6903'],0,8,8,2478173,1,,,,5552
ad541b9759168844065bb1ef95ded4cbb2c1b7ed,1,GitHub,2021-02-10 07:12:06-08:00,['19506b6c012c919410a2aadc75453586ec7072b3'],16,18,34,2478207,7,,,,5552
06dce721ec0185d49fac37775dbf191d0e80e687,1,GitHub,2021-02-10 12:44:47-08:00,['ad541b9759168844065bb1ef95ded4cbb2c1b7ed'],145,151,296,2478503,20,1,1,1,5552
3a3af5e20069f245113f4ff12a0259d6420e89cc,1,GitHub,2021-02-10 14:04:22-08:00,['06dce721ec0185d49fac37775dbf191d0e80e687'],0,923,923,2479426,3,0.170111288,0.484896661,0.882352941,5555
31a647f5adf0d1ff8f190cccc0da900cfbaf2756,1,GitHub,2021-02-10 14:37:16-08:00,['3a3af5e20069f245113f4ff12a0259d6420e89cc'],107,961,1068,2480494,6,0.162251656,0.413907285,0.604304636,5558
39dcdeffd7075b8cbb018c5a4bfdd17e7828d75b,1,GitHub,2021-02-10 15:22:15-08:00,['31a647f5adf0d1ff8f190cccc0da900cfbaf2756'],54,70,124,2480618,13,0.444444444,0.777777778,0.222222222,5558
202ff6336faa010f9452c55e8eb71a6cabe83936,0,GitHub,2021-02-11 12:06:21+01:00,['39dcdeffd7075b8cbb018c5a4bfdd17e7828d75b'],96,792,888,2481506,7,0.742152466,0.905829596,0.975336323,5562
83ec80988a1f9418ec1296e990115017c732594b,0,GitHub,2021-02-11 23:21:22+08:00,['202ff6336faa010f9452c55e8eb71a6cabe83936'],1,1,2,2481508,1,0,0,0,5562
6b3a4553f91d737b0e26a9ae028b7a85e0fc475a,1,GitHub,2021-02-11 08:32:38-08:00,['83ec80988a1f9418ec1296e990115017c732594b'],0,713,713,2482221,3,0.401028278,0.735218509,0.976863753,5564
bf5e1f1cc0d7f7b1f54c879fbb5f415d30fa9c06,1,GitHub,2021-02-11 08:42:59-08:00,['6b3a4553f91d737b0e26a9ae028b7a85e0fc475a'],0,1729,1729,2483950,16,0.646258503,0.925170068,0.906122449,5579
faaef2c2dff3208fe3ed23f4b075260475543957,1,GitHub,2021-02-11 09:44:17-08:00,['bf5e1f1cc0d7f7b1f54c879fbb5f415d30fa9c06'],64,930,994,2484944,8,0.301587302,0,0.484126984,5583
25555b89f5155e4c9cbd474674cc6f24b0121b29,0,GitHub,2021-02-11 12:43:21-08:00,['faaef2c2dff3208fe3ed23f4b075260475543957'],0,269,269,2485213,7,0.541436464,0.541436464,0.817679558,5584
2caef070d4199877337f59399563354e41b203f7,1,GitHub,2021-02-11 15:12:25-08:00,['25555b89f5155e4c9cbd474674cc6f24b0121b29'],5,14,19,2485232,1,1,1,1,5584
d4de383f5fe8e0d35bdb82f85d71aaaea77d8e90,0,GitHub,2021-02-11 16:49:05-08:00,['2caef070d4199877337f59399563354e41b203f7'],3,118,121,2485353,2,0,0.99047619,1,5584
1adb580faae89e0a298c0cb4ba08b238d91f9d03,1,GitHub,2021-02-11 21:35:24-08:00,['d4de383f5fe8e0d35bdb82f85d71aaaea77d8e90'],18,114,132,2485485,3,0.508196721,0.852459016,1,5584
2c590de54e626eda3be1bbbedf11126ec47cc450,1,GitHub,2021-02-12 10:38:10-05:00,['1adb580faae89e0a298c0cb4ba08b238d91f9d03'],9,15,24,2485509,3,,,,5584
2294d1040504f871290293131f2b98a76f1d93d3,0,GitHub,2021-02-13 00:07:19+08:00,['2c590de54e626eda3be1bbbedf11126ec47cc450'],1,9,10,2485519,2,1,1,1,5584
1d4f69be34615b108dd53c3734cf0bb9f0891685,0,GitHub,2021-02-12 16:53:29-06:00,['2294d1040504f871290293131f2b98a76f1d93d3'],1,1,2,2485521,1,,,,5584
70a36bdacbe505a56fbb0cbe314aea88469944ff,0,GitHub,2021-02-13 07:28:17-08:00,['1d4f69be34615b108dd53c3734cf0bb9f0891685'],3,3,6,2485527,2,,,,5584
b3313b8636f8b6abad6389c99aa6d62a8976482a,0,Manikumar Reddy,2021-02-13 23:06:10+05:18,['70a36bdacbe505a56fbb0cbe314aea88469944ff'],3,28,31,2485558,2,0.1,1,0.9,5584
744d05b12897267803f46549e8bca3d31d57be4c,0,GitHub,2021-02-14 08:12:25-08:00,['b3313b8636f8b6abad6389c99aa6d62a8976482a'],95,171,266,2485824,31,1,1,0,5586
ac86a720b820448470fcc31290261626256aa27a,0,GitHub,2021-02-14 10:19:33-08:00,['744d05b12897267803f46549e8bca3d31d57be4c'],11,11,22,2485846,1,,,,5586
987aafeddf69645b6089306dac8f9f32ac7cd9b3,0,GitHub,2021-02-15 12:21:01+00:00,['ac86a720b820448470fcc31290261626256aa27a'],10,0,10,2485856,1,0,0,0,5586
fe3f2bec8e46b22650a4ee2552379d2abbaa6f40,0,GitHub,2021-02-16 23:55:20+08:00,['987aafeddf69645b6089306dac8f9f32ac7cd9b3'],32,7,39,2485895,2,0.833333333,0,0,5586
fb7da1a245ff24a3d538e011ab3ec4e96ef86d28,0,GitHub,2021-02-16 15:12:29-08:00,['fe3f2bec8e46b22650a4ee2552379d2abbaa6f40'],1,5,6,2485901,2,0,1,1,5586
da58ce4065695b0106d545e79a156faafa5d139b,0,GitHub,2021-02-16 17:11:24-08:00,['fb7da1a245ff24a3d538e011ab3ec4e96ef86d28'],9,10,19,2485920,3,,,,5586
f5c2f608b05c8094a898c14a6c4a3238f6388df1,1,GitHub,2021-02-17 12:14:08+08:00,['da58ce4065695b0106d545e79a156faafa5d139b'],36,39,75,2485995,11,0.444444444,1,1,5586
0bdb469b56c63aa4dfae1ab24bb1868471cfa7bf,0,GitHub,2021-02-17 12:19:20+08:00,['f5c2f608b05c8094a898c14a6c4a3238f6388df1'],1,1,2,2485997,1,,,,5586
16a8f2c3c4e48e2ce84862dc60406ed6672d75b1,0,Jun Rao,2021-02-17 09:48:08-08:00,['0bdb469b56c63aa4dfae1ab24bb1868471cfa7bf'],4,8,12,2486009,1,,,,5586
8c7c7494f9c2a0a6fc2d5b0b1fdee9da3d84b7a0,0,GitHub,2021-02-18 11:08:29+08:00,['16a8f2c3c4e48e2ce84862dc60406ed6672d75b1'],0,2,2,2486011,2,,,,5586
46690113cd0066e57f914539978cfdf69ebbef63,0,GitHub,2021-02-18 11:15:56+08:00,['8c7c7494f9c2a0a6fc2d5b0b1fdee9da3d84b7a0'],605,555,1160,2487171,2,0.833333333,0,0,5586
a30f92bf59cf31fc1dd36eadc2b9e554e0aef900,1,GitHub,2021-02-17 21:35:13-08:00,['46690113cd0066e57f914539978cfdf69ebbef63'],202,1908,2110,2489281,39,0.41509434,0.616352201,0.900419287,5590
38ec258c66b2e7762885c07f5b104349b69908ee,0,GitHub,2021-02-18 09:54:02+00:00,['a30f92bf59cf31fc1dd36eadc2b9e554e0aef900'],1,1,2,2489283,1,,,,5590
b58b944e70780029806a6004114bba43ce5b9483,0,GitHub,2021-02-18 15:01:49+00:00,['38ec258c66b2e7762885c07f5b104349b69908ee'],1,45,46,2489329,2,0.387096774,1,1,5590
97c9ae119ac12e9b3cf60d6639900a46ab30d062,0,GitHub,2021-02-18 13:47:14-08:00,['b58b944e70780029806a6004114bba43ce5b9483'],1,1,2,2489331,1,,,,5590
b50a78b4acdcba14930e528162dd4ffcea4bedc0,0,GitHub,2021-02-18 16:02:25-08:00,['97c9ae119ac12e9b3cf60d6639900a46ab30d062'],1,1,2,2489333,1,,,,5590
698319b8e2c1f6cb574f339eede6f2a5b1919b55,1,Colin P. Mccabe,2021-02-18 16:25:51-08:00,['b50a78b4acdcba14930e528162dd4ffcea4bedc0'],585,1091,1676,2491009,113,0.524444444,0.991111111,0.675555556,5593
e29f7a36dbbd316ae03008140a1a0d282a26b82d,0,GitHub,2021-02-18 16:44:40-08:00,['698319b8e2c1f6cb574f339eede6f2a5b1919b55'],82,190,272,2491281,10,0,1,0.795698925,5593
c8112b5ecdda6b62d34ad97fcebbf5c7fec3de53,0,GitHub,2021-02-18 18:18:53-08:00,['e29f7a36dbbd316ae03008140a1a0d282a26b82d'],4,18,22,2491303,2,1,1,1,5593
9243c10161eb10631353f34a821a8dfb8cab51ed,1,GitHub,2021-02-18 19:46:23-08:00,['c8112b5ecdda6b62d34ad97fcebbf5c7fec3de53'],128,339,467,2491770,6,0.20661157,0.834710744,0.636363636,5593
a524a751c1a6b4ac95d470b0baed0616643808ed,0,Chia-Ping Tsai,2021-02-19 12:10:12+08:00,['9243c10161eb10631353f34a821a8dfb8cab51ed'],0,1,1,2491771,1,,,,5593
b17f70ed665bc2ab1d1fa28babe6f14902d9d75a,0,GitHub,2021-02-19 11:36:12+00:00,['a524a751c1a6b4ac95d470b0baed0616643808ed'],2,2,4,2491775,1,,,,5593
c75a73862aa4bf752179e83c7fbeab771a2aef57,0,GitHub,2021-02-19 11:49:56-06:00,['b17f70ed665bc2ab1d1fa28babe6f14902d9d75a'],6,51,57,2491832,3,0.5,1,1,5593
76de61475bf61fdd746ba035cc8410b38462982d,0,Colin P. Mccabe,2021-02-19 10:45:20-08:00,['c75a73862aa4bf752179e83c7fbeab771a2aef57'],2,10,12,2491844,3,0.5,0.5,0.5,5593
d030dc55ab4e94b4bb049b91474d5a8f533fb3bb,1,GitHub,2021-02-19 11:08:00-08:00,['76de61475bf61fdd746ba035cc8410b38462982d'],30,134,164,2492008,5,0.083333333,0.8,1,5594
5b761e66ccf08768215e2f25a335a614c3d9b954,0,GitHub,2021-02-19 12:26:12-08:00,['d030dc55ab4e94b4bb049b91474d5a8f533fb3bb'],1,1,2,2492010,1,,,,5594
1c31176ae1ef49071b0d3e717e5f3037492b5b30,1,GitHub,2021-02-19 14:43:32-06:00,['5b761e66ccf08768215e2f25a335a614c3d9b954'],42,140,182,2492192,4,1,0.901639344,1,5594
b35ca4349dabb199411cb6bc4c80ef89f19d9328,1,GitHub,2021-02-19 13:36:07-08:00,['1c31176ae1ef49071b0d3e717e5f3037492b5b30'],185,141,326,2492518,12,0,0,0,5594
bbf145b1b163bada0b20cea42b29d91443161170,1,GitHub,2021-02-19 14:43:14-08:00,['b35ca4349dabb199411cb6bc4c80ef89f19d9328'],36,158,194,2492712,9,0.342105263,0.960526316,0.684210526,5595
45b7a2a2ac697636cb4810a8c9357527361babd6,1,GitHub,2021-02-19 17:02:09-06:00,['bbf145b1b163bada0b20cea42b29d91443161170'],8,47,55,2492767,2,0.129032258,1,0.032258065,5595
690f72dd69d31589655c84d3cc1a6eec006bcab5,1,Colin P. Mccabe,2021-02-19 15:46:34-08:00,['45b7a2a2ac697636cb4810a8c9357527361babd6'],4,3879,3883,2496650,39,0.563967417,0.750359368,0.810253953,5625
d3612ebc775ea401e6170b3248d146b228d85d1f,1,GitHub,2021-02-19 17:07:01-08:00,['690f72dd69d31589655c84d3cc1a6eec006bcab5'],10,11,21,2496671,1,0,1,0,5625
5eac5a822fe4eb8691d2411fb25fcba1d4203b55,1,GitHub,2021-02-19 18:03:23-08:00,['d3612ebc775ea401e6170b3248d146b228d85d1f'],45,6914,6959,2503630,55,0.387749937,0.717033662,0.762591749,5661
6bab96da043b5d097bf05ddf93044f776ff24568,0,GitHub,2021-02-20 11:27:46+08:00,['5eac5a822fe4eb8691d2411fb25fcba1d4203b55'],1,1,2,2503632,1,,,,5661
a2d46110321632430dd813383991afac41555fe1,0,GitHub,2021-02-20 11:33:20+08:00,['6bab96da043b5d097bf05ddf93044f776ff24568'],2,2,4,2503636,1,,,,5661
236ddda3601b0337b49b248ca4064546ed853371,0,GitHub,2021-02-20 11:38:43+08:00,['a2d46110321632430dd813383991afac41555fe1'],1,1,2,2503638,1,,,,5661
954c090ffc378a63ce3c3c9a72b87724fcd2cd6c,0,GitHub,2021-02-20 11:44:29+08:00,['236ddda3601b0337b49b248ca4064546ed853371'],45,53,98,2503736,23,0.833333333,1,0.166666667,5661
1a09bac0301a15fe7967e9a0c5bf11d34120561b,0,GitHub,2021-02-20 12:38:09-08:00,['954c090ffc378a63ce3c3c9a72b87724fcd2cd6c'],1,0,1,2503737,1,0,0,0,5661
c71ec552d100973cda65da3228ba3f2ab8039221,0,Manikumar Reddy,2021-02-22 23:07:06+05:18,['1a09bac0301a15fe7967e9a0c5bf11d34120561b'],1,1,2,2503739,1,,,,5661
95f51539c8d0b88bd7f285011d42e2d1117107de,1,GitHub,2021-02-22 10:16:48-08:00,['c71ec552d100973cda65da3228ba3f2ab8039221'],45,247,292,2504031,10,0.166666667,1,0.907407407,5661
0711d1558250c60807dfa815d46907eac8bb4b98,0,GitHub,2021-02-22 13:57:17-08:00,['95f51539c8d0b88bd7f285011d42e2d1117107de'],261,538,799,2504830,47,0.188976378,0.976377953,0,5662
9e799cb23ca512c47db3e41e4d552e4e0095a012,0,GitHub,2021-02-22 15:09:25-08:00,['0711d1558250c60807dfa815d46907eac8bb4b98'],5,5,10,2504840,2,,,,5662
9728b4ff9218249a5d44b47d395a1d9d33759677,0,GitHub,2021-02-22 17:06:25-08:00,['9e799cb23ca512c47db3e41e4d552e4e0095a012'],8,0,8,2504848,1,,,,5662
f5e01f743be2276c1c0365b4e3e6639de32b985a,0,GitHub,2021-02-23 10:54:14+08:00,['9728b4ff9218249a5d44b47d395a1d9d33759677'],7,29,36,2504884,2,0.944444444,0,1,5662
23b85417b3ed53bf092877baef42608f7b778843,1,GitHub,2021-02-22 20:34:25-08:00,['f5e01f743be2276c1c0365b4e3e6639de32b985a'],512,449,961,2505845,13,0,0.181818182,0,5662
da1d9da7ea6a5ae515c94c68aefd4768b388a3d1,0,GitHub,2021-02-23 12:51:06+08:00,['23b85417b3ed53bf092877baef42608f7b778843'],1,1,2,2505847,1,,,,5662
b5265e98ebc48c44f6d9b836d4ab9d1c9cd371af,0,GitHub,2021-02-22 21:11:17-08:00,['da1d9da7ea6a5ae515c94c68aefd4768b388a3d1'],14,25,39,2505886,2,,,,5662
dd34e40f3e8ea097374654e8afea7dabc050272d,0,GitHub,2021-02-22 22:02:38-08:00,['b5265e98ebc48c44f6d9b836d4ab9d1c9cd371af'],4,4,8,2505894,4,,,,5662
837208009fa994751958b5d748dc422c9058993e,0,GitHub,2021-02-23 17:29:11+08:00,['dd34e40f3e8ea097374654e8afea7dabc050272d'],3,27,30,2505924,1,1,1,1,5662
a74b5eb0df7ecfa46601ee572e44877373af0cd6,0,Manikumar Reddy,2021-02-23 14:58:24+05:18,['837208009fa994751958b5d748dc422c9058993e'],1,1,2,2505926,1,,,,5662
0605b690e94ae2fa442551b2741472c8d5cac485,0,GitHub,2021-02-23 08:39:19-08:00,['a74b5eb0df7ecfa46601ee572e44877373af0cd6'],0,5,5,2505931,1,,,,5662
6f2cb60ef6a6512d48a7dbfd0c9adc0f1cc3fa11,0,GitHub,2021-02-23 10:47:53-08:00,['0605b690e94ae2fa442551b2741472c8d5cac485'],8,7,15,2505946,2,,,,5662
16d1439fc413f42ff97f62ebb9fd102cfbf2e063,0,GitHub,2021-02-23 15:25:08-08:00,['6f2cb60ef6a6512d48a7dbfd0c9adc0f1cc3fa11'],1,1,2,2505948,1,,,,5662
bc04c335fc6c39a507f14d0cda71c8a2780a53cf,0,GitHub,2021-02-23 18:32:42-08:00,['16d1439fc413f42ff97f62ebb9fd102cfbf2e063'],3,0,3,2505951,3,1,0,0.333333333,5662
f75efb96fae99a22eb54b5d0ef4e23b28fe8cd2d,1,GitHub,2021-02-23 20:41:02-08:00,['bc04c335fc6c39a507f14d0cda71c8a2780a53cf'],15,99,114,2506065,2,0,1,0.887096774,5662
5a9435afd18e0f9fdc34b4567bd51442e599053d,0,GitHub,2021-02-25 01:52:34+08:00,['f75efb96fae99a22eb54b5d0ef4e23b28fe8cd2d'],4,4,8,2506073,1,,,,5662
8bd0e218d829c3e2966df98b9ca4406753530d01,0,GitHub,2021-02-24 13:34:38-06:00,['5a9435afd18e0f9fdc34b4567bd51442e599053d'],0,5,5,2506078,1,,,,5662
059c9b3fcf427697be6e06269a4c0ace271e729a,0,GitHub,2021-02-24 12:23:24-08:00,['8bd0e218d829c3e2966df98b9ca4406753530d01'],1,1,2,2506080,1,,,,5662
3f09fb97b6943c0612488dfa8e5eab8078fd7ca0,1,GitHub,2021-02-24 12:50:18-08:00,['059c9b3fcf427697be6e06269a4c0ace271e729a'],29,669,698,2506778,20,0.388429752,0.856749311,0.953168044,5667
e2a0d0c90e1916d77223a420e3595e8aba643001,0,GitHub,2021-02-24 17:49:18-08:00,['3f09fb97b6943c0612488dfa8e5eab8078fd7ca0'],13,13,26,2506804,8,,,,5667
bd04f7557a4962d5d5054dc8339f8727b8e428b6,0,GitHub,2021-02-25 12:14:38-08:00,['e2a0d0c90e1916d77223a420e3595e8aba643001'],2,3,5,2506809,1,0,0,0,5667
a8eda3c785104615fa7144d6722a91223ecfea58,1,GitHub,2021-02-25 14:17:19-08:00,['bd04f7557a4962d5d5054dc8339f8727b8e428b6'],86,479,565,2507374,9,0.294117647,0.955017301,0.795847751,5668
7f90eda04720274a0e4f7ec32a7340245f493e9e,0,GitHub,2021-02-25 17:02:40-08:00,['a8eda3c785104615fa7144d6722a91223ecfea58'],57,62,119,2507493,7,0,0,1,5668
1657deec37a45dc4c6a932024de4aa5042c9dda2,0,GitHub,2021-02-25 17:16:37-08:00,['7f90eda04720274a0e4f7ec32a7340245f493e9e'],7,12,19,2507512,3,,,,5668
74dfe80bb8b63b3916560143ce2c85f8b41f0f2e,1,GitHub,2021-02-25 19:38:21-08:00,['1657deec37a45dc4c6a932024de4aa5042c9dda2'],134,68,202,2507714,28,1,0.105263158,0,5668
c9832aabae5d55dc22b962867d5c1bcc3804b605,0,GitHub,2021-02-26 15:04:25+08:00,['74dfe80bb8b63b3916560143ce2c85f8b41f0f2e'],4,16,20,2507734,1,,,,5668
4c0be2080d554f19cbc7b45e8e980c73df163bc8,0,GitHub,2021-02-26 11:02:44+00:00,['c9832aabae5d55dc22b962867d5c1bcc3804b605'],4,16,20,2507754,2,,,,5668
5dae3648abdb64969680ad2313756277a63530c1,1,GitHub,2021-02-26 11:26:43-08:00,['4c0be2080d554f19cbc7b45e8e980c73df163bc8'],435,609,1044,2508798,6,0,0.406779661,0,5668
32e6a5b320194c40824ac3cdd5ecc015b0254cce,0,GitHub,2021-02-26 11:28:11-08:00,['5dae3648abdb64969680ad2313756277a63530c1'],26,132,158,2508956,2,0.151898734,0.886075949,0.886075949,5668
a66f154370980783add1973954cff120cf3825e1,0,GitHub,2021-02-26 11:33:21-08:00,['32e6a5b320194c40824ac3cdd5ecc015b0254cce'],2,23,25,2508981,2,0,1,1,5668
958f90e710f0de164dce1dda5f45d75a8b8fb8d4,1,GitHub,2021-02-26 12:17:28-08:00,['a66f154370980783add1973954cff120cf3825e1'],3,5,8,2508989,1,0,0,1,5668
02226fa090513882b9229ac834fd493d71ae6d96,0,GitHub,2021-02-26 13:54:21-08:00,['958f90e710f0de164dce1dda5f45d75a8b8fb8d4'],1,0,1,2508990,1,,,,5668
068d8fedcb34dcb2d07a6375bd267d3323c7e06c,0,GitHub,2021-02-26 14:40:46-08:00,['02226fa090513882b9229ac834fd493d71ae6d96'],15,39,54,2509044,3,0,1,1,5668
5d37901500d554cc5602ae141a98fd87bda3dcbf,1,GitHub,2021-02-26 16:56:11-08:00,['068d8fedcb34dcb2d07a6375bd267d3323c7e06c'],47,293,340,2509384,10,0.194174757,0.825242718,1,5668
581344673047c126f2e5f2c00c00221d12a9b7d5,0,GitHub,2021-02-26 17:13:20-08:00,['5d37901500d554cc5602ae141a98fd87bda3dcbf'],15,26,41,2509425,4,1,1,0,5668
cc088c5abe367989e833e444171dd546370c356f,1,GitHub,2021-03-01 09:30:30+00:00,['581344673047c126f2e5f2c00c00221d12a9b7d5'],29,92,121,2509546,2,0.458333333,1,1,5668
d78a923a16d5a211b2bc984aa8026cd4441c4da9,0,GitHub,2021-03-01 14:59:54+01:00,['cc088c5abe367989e833e444171dd546370c356f'],15,46,61,2509607,2,0.866666667,1,1,5668
a63e5be4195e97e5b825b5912291144d2d0283a3,1,GitHub,2021-03-01 10:03:34-06:00,['d78a923a16d5a211b2bc984aa8026cd4441c4da9'],24,98,122,2509729,12,0.463414634,1,0.951219512,5668
2633db9b61ab68862556e1c17d90f9baba6666f8,0,GitHub,2021-03-01 18:25:23+01:00,['a63e5be4195e97e5b825b5912291144d2d0283a3'],5,13,18,2509747,1,1,1,1,5668
e2bffb9086823230c60c4838d38f32917dd8d03d,0,GitHub,2021-03-01 11:02:28-08:00,['2633db9b61ab68862556e1c17d90f9baba6666f8'],4,4,8,2509755,4,,,,5668
7a0e371e0ed0988f5f66f207d5ec665ecfaaac88,0,GitHub,2021-03-01 11:32:05-08:00,['e2bffb9086823230c60c4838d38f32917dd8d03d'],5,2,7,2509762,1,1,1,0,5668
22dbf89886974c27c705bba653f9cfe36f70904c,0,GitHub,2021-03-01 12:11:11-08:00,['7a0e371e0ed0988f5f66f207d5ec665ecfaaac88'],22,20,42,2509804,1,1,0,0,5668
020ead4b97ed96b9f7e4c7c3ac2523bd18ac930f,0,GitHub,2021-03-02 10:32:21+01:00,['22dbf89886974c27c705bba653f9cfe36f70904c'],1,1,2,2509806,1,,,,5668
652cca377a1559d1e0143283779ae90bde5d1e7d,0,GitHub,2021-03-02 17:51:47+08:00,['020ead4b97ed96b9f7e4c7c3ac2523bd18ac930f'],2,2,4,2509810,1,,,,5668
38fee5fce515e2186c9ea708a50b515a8fffcaf2,0,GitHub,2021-03-02 11:14:43+01:00,['652cca377a1559d1e0143283779ae90bde5d1e7d'],0,5,5,2509815,1,0,0,0,5668
a92b986c855592d630fbabf49d1e9a160ad5b230,1,GitHub,2021-03-02 08:20:47-06:00,['38fee5fce515e2186c9ea708a50b515a8fffcaf2'],571,203,774,2510589,23,0.366515837,0.117647059,0.126696833,5668
b2075a094688855be4e0cb37504c87bb09d4a576,0,GitHub,2021-03-02 09:53:27-08:00,['a92b986c855592d630fbabf49d1e9a160ad5b230'],1,170,171,2510760,2,0.128205128,1,1,5668
4c5867a39b4f817ae34f74e7e0918ec8eef9fdbb,0,GitHub,2021-03-02 09:55:14-08:00,['b2075a094688855be4e0cb37504c87bb09d4a576'],0,440,440,2511200,1,0,1,1,5669
29b4a3d1fe98475666b518be3b68fa93c9b575d7,0,GitHub,2021-03-02 12:57:12-05:00,['4c5867a39b4f817ae34f74e7e0918ec8eef9fdbb'],3,3,6,2511206,2,,,,5669
a4ba73270cbdcb31e92fc54fc8c9858abf4be552,0,GitHub,2021-03-02 10:20:07-08:00,['29b4a3d1fe98475666b518be3b68fa93c9b575d7'],99,233,332,2511538,4,0.316831683,0.782178218,1,5669
420162d190d26130e8ff8699991a32205f320add,0,GitHub,2021-03-02 11:46:32-08:00,['a4ba73270cbdcb31e92fc54fc8c9858abf4be552'],2,3,5,2511543,1,,,,5669
a848e0c4208318e5db305876d14af4be0c3ce5fc,0,GitHub,2021-03-02 12:00:00-08:00,['420162d190d26130e8ff8699991a32205f320add'],114,373,487,2512030,3,0.341880342,1,1,5671
3708a7c6c1ecf1304f091dda1e79ae53ba2df489,0,GitHub,2021-03-02 13:01:35-08:00,['a848e0c4208318e5db305876d14af4be0c3ce5fc'],33,587,620,2512650,20,0.566371681,0.867256637,0.955752212,5675
36d61650f4437a40ee599f2d36ad05570c4786f6,0,GitHub,2021-03-02 13:11:16-08:00,['3708a7c6c1ecf1304f091dda1e79ae53ba2df489'],1,24,25,2512675,2,0.111111111,1,1,5675
23b61ba3837e92f1cde9cbbcbb172c545b1ae6da,1,GitHub,2021-03-02 16:28:15-08:00,['36d61650f4437a40ee599f2d36ad05570c4786f6'],22,62,84,2512759,3,0.038461538,0.961538462,0,5675
4b3e3a9e86a8293282095d15709c1aa56c526ddf,1,Manikumar Reddy,2021-03-03 09:33:24+05:18,['23b61ba3837e92f1cde9cbbcbb172c545b1ae6da'],1,1,2,2512761,1,,,,5675
cfb60064ec50f52f7deeda3c3581259d07670a59,0,GitHub,2021-03-03 12:38:06+08:00,['4b3e3a9e86a8293282095d15709c1aa56c526ddf'],2,2,4,2512765,1,,,,5675
b77deece1db3fca5575e336e157677f83bf3b506,1,Manikumar Reddy,2021-03-03 10:01:40+05:18,['cfb60064ec50f52f7deeda3c3581259d07670a59'],1,1,2,2512767,1,,,,5675
0d9a95a7d0ab06aecc4480901707e29dd2a3147e,0,GitHub,2021-03-03 08:55:13-08:00,['b77deece1db3fca5575e336e157677f83bf3b506'],0,1398,1398,2514165,13,0.886297376,0.84548105,0.801749271,5687
f6929637b9222a64e8037348ed85c1088dfc1efb,0,GitHub,2021-03-03 19:20:08+00:00,['0d9a95a7d0ab06aecc4480901707e29dd2a3147e'],37,68,105,2514270,1,0.555555556,1,0.944444444,5687
f40a82e05440e579c69363dc62c2dd9c8520eb02,0,GitHub,2021-03-03 15:57:27-05:00,['f6929637b9222a64e8037348ed85c1088dfc1efb'],4,23,27,2514297,1,,,,5687
f06a47a7bba9baf035691feadbfeb3ff21802e82,0,GitHub,2021-03-03 22:17:49+00:00,['f40a82e05440e579c69363dc62c2dd9c8520eb02'],3,30,33,2514330,2,0.352941176,1,1,5687
3ef39e13658be2ea0c79d44fba241fdf9257e51c,0,GitHub,2021-03-04 10:31:35+01:00,['f06a47a7bba9baf035691feadbfeb3ff21802e82'],64,80,144,2514474,8,0,1,1,5687
8205051e90e3ea16165f8dc1f5c81af744bb1b9a,1,GitHub,2021-03-04 18:06:50+08:00,['3ef39e13658be2ea0c79d44fba241fdf9257e51c'],1047,1102,2149,2516623,45,0,0.697986577,0.966442953,5687
ea005cc700b1b9e3cb001da19d73798ea8520d63,0,GitHub,2021-03-04 22:24:50+08:00,['8205051e90e3ea16165f8dc1f5c81af744bb1b9a'],0,18,18,2516641,1,,,,5687
1fd75bf1ed6e24ce3f25615f30edb1d00c5452b2,0,GitHub,2021-03-04 10:47:48-05:00,['ea005cc700b1b9e3cb001da19d73798ea8520d63'],10,179,189,2516830,2,,,,5687
be1476869fc93553b3099d387d26bfd0092a9d65,0,GitHub,2021-03-05 00:22:57+08:00,['1fd75bf1ed6e24ce3f25615f30edb1d00c5452b2'],161,155,316,2517146,27,0,0,0,5687
96a2b7aac4f1c4a9e020ccc08dadc7a71b460abc,1,GitHub,2021-03-04 13:55:43-05:00,['be1476869fc93553b3099d387d26bfd0092a9d65'],103,268,371,2517517,15,0.395522388,0.619402985,0.858208955,5687
7a3ebbebbc6aed2049f22c650a52f6f685546207,1,GitHub,2021-03-04 11:22:22-08:00,['96a2b7aac4f1c4a9e020ccc08dadc7a71b460abc'],423,460,883,2518400,10,,,,5687
eebc6f279e61bcd9a331a3a0b305b57ffdc1ab66,1,GitHub,2021-03-04 11:28:20-08:00,['7a3ebbebbc6aed2049f22c650a52f6f685546207'],112,980,1092,2519492,15,0.31738437,0.834130781,0.805422648,5688
60a097ae406bf2b263d7651ead762ccf1845b14b,0,GitHub,2021-03-04 12:19:34-08:00,['eebc6f279e61bcd9a331a3a0b305b57ffdc1ab66'],12,14,26,2519518,2,0,1,1,5688
83c68399cdaa249c817c248a4ebf210cf8274eec,0,GitHub,2021-03-04 14:25:51-08:00,['60a097ae406bf2b263d7651ead762ccf1845b14b'],0,1,1,2519519,1,1,1,1,5688
0685b9dcd5e47ea1d543c475e3af6f833b4bb633,1,GitHub,2021-03-04 14:40:31-08:00,['83c68399cdaa249c817c248a4ebf210cf8274eec'],141,197,338,2519857,8,0.805555556,1,0.486111111,5688
5c22e03e9ea297d36dcff5d0ac3890d648c49532,0,GitHub,2021-03-04 14:42:56-08:00,['0685b9dcd5e47ea1d543c475e3af6f833b4bb633'],6,42,48,2519905,2,,,,5688
728be21bde591cc7b6534b5d5dc8c30ca67efe8d,0,GitHub,2021-03-05 17:48:50+05:18,['5c22e03e9ea297d36dcff5d0ac3890d648c49532'],1,1,2,2519907,1,,,,5688
207bb0826be1be91c12ceb30f525f73aa9519463,1,GitHub,2021-03-05 11:27:25-08:00,['728be21bde591cc7b6534b5d5dc8c30ca67efe8d'],76,188,264,2520171,10,1,0.967213115,0.786885246,5688
17851da66791361e9fb0250325da236988149100,0,GitHub,2021-03-05 15:55:14-08:00,['207bb0826be1be91c12ceb30f525f73aa9519463'],50,110,160,2520331,4,1,1,0.307692308,5688
cf329cbfb75543db3b3ec849bb684d4287bf64dd,0,GitHub,2021-03-08 14:21:56+08:00,['17851da66791361e9fb0250325da236988149100'],1,1,2,2520333,1,,,,5688
31a121c3b7088527e7926392de8f3511e3a76afa,1,GitHub,2021-03-08 11:21:42-08:00,['cf329cbfb75543db3b3ec849bb684d4287bf64dd'],79,441,520,2520853,9,0.389705882,1,0.650735294,5689
6b432e48ba50add0efd9382e68a395967d85376b,0,GitHub,2021-03-08 13:04:46-08:00,['31a121c3b7088527e7926392de8f3511e3a76afa'],3,4,7,2520860,2,0,0,1,5689
a1fb80ffe2556b00869e2cd0bf79e5e9da4d9ef8,0,GitHub,2021-03-09 12:46:43+08:00,['6b432e48ba50add0efd9382e68a395967d85376b'],1,1,2,2520862,1,,,,5689
1c3a13983135d3b1d533ca40b152532bd918b373,0,GitHub,2021-03-09 05:49:20-08:00,['a1fb80ffe2556b00869e2cd0bf79e5e9da4d9ef8'],3,4,7,2520869,1,0,0,0,5689
0e8a84e5d7203765240894873fd2896906dfbc2b,1,GitHub,2021-03-09 06:00:16-08:00,['1c3a13983135d3b1d533ca40b152532bd918b373'],14,18,32,2520901,1,,,,5689
8d6ae33ac51e8878e441e83256da313dc9fb4227,0,GitHub,2021-03-09 11:03:41-06:00,['0e8a84e5d7203765240894873fd2896906dfbc2b'],1,1,2,2520903,1,,,,5689
0fc53652e1786192b8732909789a94eed96ba604,0,GitHub,2021-03-09 13:55:29-08:00,['8d6ae33ac51e8878e441e83256da313dc9fb4227'],1,2,3,2520906,1,,0,,5689
b92d6063798c08bf2344871794f2de1f3a2bfd67,0,GitHub,2021-03-09 13:57:15-08:00,['0fc53652e1786192b8732909789a94eed96ba604'],5,0,5,2520911,1,,,,5689
e6f8f5d0ae7777f15fb4a6d7744cd58c195aac31,1,GitHub,2021-03-10 13:21:30+08:00,['b92d6063798c08bf2344871794f2de1f3a2bfd67'],83,17,100,2521011,8,0.681818182,0.681818182,0.681818182,5689
8c9bc9c6401354b04e6f786eb3b8187edb4b3b04,0,GitHub,2021-03-10 13:27:06+08:00,['e6f8f5d0ae7777f15fb4a6d7744cd58c195aac31'],48,48,96,2521107,35,,,,5689
029f5a136ae2c74f7f93e716bcc30ce90d8241ad,0,GitHub,2021-03-10 14:26:24-08:00,['8c9bc9c6401354b04e6f786eb3b8187edb4b3b04'],42,326,368,2521475,24,0.765151515,0.992424242,0.939393939,5690
50518fa8e05827bb4bd9d96278f90015525a1527,0,GitHub,2021-03-10 16:14:44-08:00,['029f5a136ae2c74f7f93e716bcc30ce90d8241ad'],46,4,50,2521525,3,1,0,0.970588235,5690
c534bf45cecb8c06abea699b62084d6aee74705c,0,GitHub,2021-03-10 17:25:59-08:00,['50518fa8e05827bb4bd9d96278f90015525a1527'],0,15,15,2521540,2,0.666666667,1,1,5690
800d9b5abc50e38a8137dc2912cc4b924d1d372d,0,GitHub,2021-03-11 09:55:30-08:00,['c534bf45cecb8c06abea699b62084d6aee74705c'],63,1000,1063,2522603,3,0.224464061,0.881462799,0.804539723,5690
0e5591beda058e93c959ee78021dc30f6c004a30,1,GitHub,2021-03-11 10:10:27-08:00,['800d9b5abc50e38a8137dc2912cc4b924d1d372d'],74,362,436,2523039,9,0.169014085,1,0.985915493,5690
15620ae54fea758b7d0c5c0db840ab4c6c8df370,0,GitHub,2021-03-11 14:50:43-08:00,['0e5591beda058e93c959ee78021dc30f6c004a30'],1,1,2,2523041,1,,,,5690
1f9c9f8bb57ebc0afeb0f4761bcc5b559f826cc2,0,GitHub,2021-03-12 13:37:33+08:00,['15620ae54fea758b7d0c5c0db840ab4c6c8df370'],1,1,2,2523043,1,,,,5690
0dbafce8dd0954b822c17eac8951aee35bbef0bc,0,GitHub,2021-03-12 11:32:17+00:00,['1f9c9f8bb57ebc0afeb0f4761bcc5b559f826cc2'],3,151,154,2523197,4,0.505882353,1,0.952941176,5691
4e60ad72fb280926f1d98bcde187a399b577310d,0,GitHub,2021-03-12 12:14:53+00:00,['0dbafce8dd0954b822c17eac8951aee35bbef0bc'],11,24,35,2523232,2,1,1,1,5691
b519117b22e80b0b5597de1ce1e0eb4e4a74878b,0,GitHub,2021-03-12 08:59:41-08:00,['4e60ad72fb280926f1d98bcde187a399b577310d'],162,292,454,2523686,2,0.4375,1,0.669642857,5691
19e5918b23c5ae5cc7021602487604767a41e0f8,0,GitHub,2021-03-12 13:03:25-08:00,['b519117b22e80b0b5597de1ce1e0eb4e4a74878b'],3,1,4,2523690,1,,,,5691
c6a0f760737bf609409eb928c00cef9e4ba1015d,0,GitHub,2021-03-12 16:31:51-08:00,['19e5918b23c5ae5cc7021602487604767a41e0f8'],0,30,30,2523720,3,1,1,1,5691
4fe4cdc4a61cbac8e070a8b5514403235194015b,1,GitHub,2021-03-12 20:06:54-08:00,['c6a0f760737bf609409eb928c00cef9e4ba1015d'],2,4,6,2523726,2,,,,5691
2114eb712cde8b2f1108479c989192fed34f30a7,0,GitHub,2021-03-13 17:51:35+08:00,['4fe4cdc4a61cbac8e070a8b5514403235194015b'],5,0,5,2523731,1,0,0,0,5691
9edc828c92ee847704b5675db72a83eff0bba40c,0,GitHub,2021-03-13 18:16:11+01:00,['2114eb712cde8b2f1108479c989192fed34f30a7'],8,11,19,2523750,1,,,,5691
08a4ce42aa47e15dde83d484cbd722c81d61edb6,0,GitHub,2021-03-15 12:18:32+00:00,['9edc828c92ee847704b5675db72a83eff0bba40c'],1,1,2,2523752,1,,,,5691
802ee10bfd802735f7d4d1d7b1f1212e5ae0c4b2,1,GitHub,2021-03-15 08:45:57-07:00,['08a4ce42aa47e15dde83d484cbd722c81d61edb6'],94,27,121,2523873,4,1,0.137931034,0.620689655,5691
2387d191fcbcc6ae33fe5c48a933e6b14da7aaa5,1,GitHub,2021-03-15 09:24:38-07:00,['802ee10bfd802735f7d4d1d7b1f1212e5ae0c4b2'],48,42,90,2523963,7,1,1,0,5691
8da65936d7fc53d24c665c0d01893d25a430933b,0,GitHub,2021-03-15 11:00:35-07:00,['2387d191fcbcc6ae33fe5c48a933e6b14da7aaa5'],1,1,2,2523965,1,,,,5691
336d26accf1bbf7417299790b8860def19635a7b,1,GitHub,2021-03-15 20:12:37-07:00,['8da65936d7fc53d24c665c0d01893d25a430933b'],3,2,5,2523970,1,1,1,0,5691
eee0045b06758509e61580d64fad06a09f9fc636,0,GitHub,2021-03-16 17:00:04+01:00,['336d26accf1bbf7417299790b8860def19635a7b'],124,102,226,2524196,4,1,1,0.130434783,5691
bf639905f66acb86d04c33165cd9e232dba66b80,1,GitHub,2021-03-16 19:18:28+00:00,['eee0045b06758509e61580d64fad06a09f9fc636'],3,37,40,2524236,2,0.129032258,1,1,5691
d80a87f2abe24095729d8a33bad6fef6ca0e642e,0,GitHub,2021-03-16 19:24:08+00:00,['bf639905f66acb86d04c33165cd9e232dba66b80'],2,98,100,2524336,2,0.108108108,1,1,5691
36c5ad4c6adcfb4cd3dee194f7cd835c364a3082,0,GitHub,2021-03-16 13:51:44-07:00,['d80a87f2abe24095729d8a33bad6fef6ca0e642e'],0,62,62,2524398,7,1,1,1,5691
b96fc7892f1e885239d3290cf509e1d1bb41e7db,1,GitHub,2021-03-16 13:57:29-07:00,['36c5ad4c6adcfb4cd3dee194f7cd835c364a3082'],10,16,26,2524424,2,1,1,0,5691
0fb0440081bb9e74fd831c015a886c5d260d884e,0,GitHub,2021-03-17 18:56:43+08:00,['b96fc7892f1e885239d3290cf509e1d1bb41e7db'],34,30,64,2524488,6,1,0,0,5691
28ee656081d5b7984c324c3ea3fc9c34614d17db,0,GitHub,2021-03-17 19:03:29+08:00,['0fb0440081bb9e74fd831c015a886c5d260d884e'],5,0,5,2524493,1,,,,5691
3288db5ed1ad0fc51d03f07974a7b92f8397eb16,0,GitHub,2021-03-18 01:27:06+08:00,['28ee656081d5b7984c324c3ea3fc9c34614d17db'],1,8,9,2524502,1,1,1,0.333333333,5691
9adfac280392da0837cfd8d582bc540951e94087,0,GitHub,2021-03-17 10:58:42-07:00,['3288db5ed1ad0fc51d03f07974a7b92f8397eb16'],0,5,5,2524507,1,1,0,1,5691
8ef1619f3e7e6eb9e350424b0320cb0a11886aaa,1,GitHub,2021-03-17 19:20:07-07:00,['9adfac280392da0837cfd8d582bc540951e94087'],359,277,636,2525143,7,0,0,0,5691
bca29e29000d9f223c4289002c8565cf9779e807,0,GitHub,2021-03-18 16:15:43+08:00,['8ef1619f3e7e6eb9e350424b0320cb0a11886aaa'],12,99,111,2525254,2,0,1,1,5692
f6ef714addc0631d4a6f7abed433ebb8ef7559d7,0,GitHub,2021-03-18 07:00:22-07:00,['bca29e29000d9f223c4289002c8565cf9779e807'],2,4,6,2525260,1,,,,5692
9ffa6d6d74431581a89da556800509e2eef8e211,0,GitHub,2021-03-18 07:27:14-07:00,['f6ef714addc0631d4a6f7abed433ebb8ef7559d7'],26,1,27,2525287,2,,,,5692
b5a80e5be6d67acbff0fe39203eeab495d7f1819,0,GitHub,2021-03-18 23:39:26+08:00,['9ffa6d6d74431581a89da556800509e2eef8e211'],6,6,12,2525299,3,,1,,5692
4be0033e622b760ec0387b6a316ca8b3763b54b2,1,GitHub,2021-03-18 09:52:08-07:00,['b5a80e5be6d67acbff0fe39203eeab495d7f1819'],115,772,887,2526186,4,0.136936937,0.769369369,0.812612613,5692
f6884cc6ddb6b938443512d029c7beacfc7a3ffc,0,GitHub,2021-03-18 09:58:49-07:00,['4be0033e622b760ec0387b6a316ca8b3763b54b2'],7,43,50,2526236,2,0.307692308,1,1,5692
dc6ea93e8a2ea8c69b5a8566975613074b62345e,0,GitHub,2021-03-18 10:27:52-07:00,['f6884cc6ddb6b938443512d029c7beacfc7a3ffc'],6,175,181,2526417,4,,,,5693
94f319d9bbeca70ef59b351834ac19a057d09c5e,1,GitHub,2021-03-18 14:03:06-04:00,['dc6ea93e8a2ea8c69b5a8566975613074b62345e'],7,52,59,2526476,5,0.235294118,0.970588235,1,5693
6190fb32ce30a74759b0428a50b88e8d44e88e76,0,GitHub,2021-03-18 11:03:21-07:00,['94f319d9bbeca70ef59b351834ac19a057d09c5e'],17,19,36,2526512,2,0,0,1,5693
b98e5f457c6c8c413431e16679dc70959ff32593,0,GitHub,2021-03-18 11:50:13-07:00,['6190fb32ce30a74759b0428a50b88e8d44e88e76'],19,19,38,2526550,1,,,,5693
a065fa5d1ac0e1775e472dcc6e9a9b138cb6639e,0,GitHub,2021-03-18 13:17:44-07:00,['b98e5f457c6c8c413431e16679dc70959ff32593'],0,1,1,2526551,1,,,,5693
4abdb59d71e6dcc25dd093f425d3b39857587554,1,GitHub,2021-03-19 10:04:56+08:00,['a065fa5d1ac0e1775e472dcc6e9a9b138cb6639e'],124,132,256,2526807,8,0,1,1,5693
367eca083b44261d4e5fa8aa61b7990a8b35f8b0,0,GitHub,2021-03-18 19:34:39-07:00,['4abdb59d71e6dcc25dd093f425d3b39857587554'],2,16,18,2526825,2,0,0.2,0.8,5693
1fb8bd9c44749bc0045dce0e156fea04652f0524,1,GitHub,2021-03-19 14:03:36+00:00,['367eca083b44261d4e5fa8aa61b7990a8b35f8b0'],3686,572,4258,2531083,8,0.726251277,0.041368744,0.060776302,5694
f49053bf5cf0462d19ded851b562888f2d4cd508,0,GitHub,2021-03-19 17:23:08+01:00,['1fb8bd9c44749bc0045dce0e156fea04652f0524'],1,0,1,2531084,1,,,,5694
d9bb2ef596343da9402bff4903b129cff1f7c22b,1,GitHub,2021-03-19 09:56:04-07:00,['f49053bf5cf0462d19ded851b562888f2d4cd508'],58,44,102,2531186,12,0,0,0,5694
a19806f2628e79baa2dbf84ea307787af7ca186f,0,GitHub,2021-03-19 10:09:38-07:00,['d9bb2ef596343da9402bff4903b129cff1f7c22b'],24,341,365,2531551,4,0.643478261,1,1,5694
69eebbf968b520097c9e8441e5b18eac9f1fc075,1,GitHub,2021-03-19 10:27:47-07:00,['a19806f2628e79baa2dbf84ea307787af7ca186f'],6,312,318,2531869,6,0.261261261,0.824324324,0.693693694,5694
ca166ea61b6a05b09178370656b6a5c7625970a0,0,GitHub,2021-03-19 11:19:56-07:00,['69eebbf968b520097c9e8441e5b18eac9f1fc075'],31,35,66,2531935,4,1,1,1,5694
fdd11a034cc450153b4a9cf89ce045b679bd0709,0,GitHub,2021-03-19 11:41:50-07:00,['ca166ea61b6a05b09178370656b6a5c7625970a0'],19,35,54,2531989,2,0.111111111,1,1,5694
a3930aad6c386f80d791a25abf1926e3bdbeb11b,0,GitHub,2021-03-19 15:09:59-07:00,['fdd11a034cc450153b4a9cf89ce045b679bd0709'],0,1,1,2531990,1,0,1,0,5694
5dfbefcb3765efd9253795d16b518a84bf6c9a24,0,GitHub,2021-03-19 15:51:19-07:00,['a3930aad6c386f80d791a25abf1926e3bdbeb11b'],1,133,134,2532124,2,0.114754098,1,1,5695
7c7e8078e4f91712e44c002b2f67d8d3abb95a31,0,GitHub,2021-03-19 16:42:37-07:00,['5dfbefcb3765efd9253795d16b518a84bf6c9a24'],75,86,161,2532285,20,,,,5695
13b4ca87954160c73db787fd9f9d1af5e21edcb1,0,GitHub,2021-03-19 18:11:07-07:00,['7c7e8078e4f91712e44c002b2f67d8d3abb95a31'],46,143,189,2532474,5,0,0.916666667,1,5695
a290c8e1df371a5605d1eb2ed527f6021f2766b6,1,GitHub,2021-03-20 22:19:01-04:00,['13b4ca87954160c73db787fd9f9d1af5e21edcb1'],254,1756,2010,2534484,13,0.929487179,1,0.685897436,5697
2e2fad747d273f98edfb9b294ef1f1321f2f5505,0,GitHub,2021-03-21 17:43:03+01:00,['a290c8e1df371a5605d1eb2ed527f6021f2766b6'],1,1,2,2534486,1,,,,5697
2bfe7a9d1ec7a39bb6cb290ed91644f6ad14cb3f,0,GitHub,2021-03-21 20:56:16-05:00,['2e2fad747d273f98edfb9b294ef1f1321f2f5505'],2,20,22,2534508,2,1,1,1,5697
e6f8ca80cd1ae301caba7b9c3f0b1f2d90a51409,0,GitHub,2021-03-22 13:39:05+08:00,['2bfe7a9d1ec7a39bb6cb290ed91644f6ad14cb3f'],2,2,4,2534512,2,,,,5697
e820eb42b2c7cb812c9db25c4788347029fd7119,1,GitHub,2021-03-22 11:45:56-04:00,['e6f8ca80cd1ae301caba7b9c3f0b1f2d90a51409'],43,1361,1404,2535916,19,0.392059553,0.745657568,0.94044665,5704
7c45976c8da0e89c618c7159e5ce23b5b1bea06b,0,John Roesler,2021-03-22 10:59:17-05:00,['e820eb42b2c7cb812c9db25c4788347029fd7119'],2,21,23,2535939,1,,,,5704
80f373d34f7716a54fa9ec1e37a27c65cbbae0f2,0,GitHub,2021-03-22 13:39:29-07:00,['7c45976c8da0e89c618c7159e5ce23b5b1bea06b'],167,224,391,2536330,10,0.2,0.4,1,5704
f5f66b982d98a98558809edc51685c3b0a12a958,1,GitHub,2021-03-22 16:05:07-07:00,['80f373d34f7716a54fa9ec1e37a27c65cbbae0f2'],80,200,280,2536610,4,0.348837209,0.930232558,0.674418605,5704
e0cbd0fa664feddd412b23d75e12fa5862b24696,0,GitHub,2021-03-23 10:44:55+08:00,['f5f66b982d98a98558809edc51685c3b0a12a958'],15,15,30,2536640,14,,,,5704
3d0b4d910b681df7d873c8a0285eaca01d6c173a,0,GitHub,2021-03-23 08:29:17+01:00,['e0cbd0fa664feddd412b23d75e12fa5862b24696'],1,143,144,2536784,3,0.061728395,1,1,5705
e3f60c254c66d7021d3e0b61968a59a70e00cb39,1,GitHub,2021-03-23 09:56:56+00:00,['3d0b4d910b681df7d873c8a0285eaca01d6c173a'],25,186,211,2536995,3,0.61627907,1,1,5706
99b9b3e84f4e98c3f07714e1de6a139a004cbc5b,0,GitHub,2021-03-23 12:44:42-07:00,['e3f60c254c66d7021d3e0b61968a59a70e00cb39'],23,6,29,2537024,3,0,0,0,5706
7071ded2a61448da21c149fa1d85b3999b0d2f73,0,GitHub,2021-03-23 21:05:42-07:00,['99b9b3e84f4e98c3f07714e1de6a139a004cbc5b'],22,8,30,2537054,4,0,0,0,5706
9af81955c497b31b211b1e21d8323c875518df39,0,GitHub,2021-03-25 01:04:39+08:00,['7071ded2a61448da21c149fa1d85b3999b0d2f73'],603,1035,1638,2538692,63,0.444352159,1,1,5706
11f0ea3a5e692f7b68e05f287e73ffc0f7fd073c,0,GitHub,2021-03-24 11:10:19-07:00,['9af81955c497b31b211b1e21d8323c875518df39'],68,190,258,2538950,4,0.065217391,0.47826087,1,5706
9bf5c579973f842ce892c0131923fb6e009c10de,0,GitHub,2021-03-24 13:55:27-05:00,['11f0ea3a5e692f7b68e05f287e73ffc0f7fd073c'],262,178,440,2539390,10,,,,5706
3ab9ab6b6ffea700753309d5b9074b45f97b0aa7,1,GitHub,2021-03-24 20:15:58-07:00,['9bf5c579973f842ce892c0131923fb6e009c10de'],41,3174,3215,2542605,23,0.472746897,0.896923907,0.759848894,5718
e840b03a026ddb9a67a15a164d877545130d6e17,0,GitHub,2021-03-24 20:19:28-07:00,['3ab9ab6b6ffea700753309d5b9074b45f97b0aa7'],0,1,1,2542606,1,,,,5718
9ef52dd2dba51f01f856560132056ebe4bacd51a,0,GitHub,2021-03-25 14:42:26-05:00,['e840b03a026ddb9a67a15a164d877545130d6e17'],46,11,57,2542663,3,1,1,0,5718
03f13d1c41c033432f5a605b557cc832a18f1790,0,GitHub,2021-03-25 19:49:18-07:00,['9ef52dd2dba51f01f856560132056ebe4bacd51a'],387,18,405,2543068,16,0.223809524,0,0.314285714,5718
704cabf10d2e5daeddb3ebfbecf7cd831e6c856e,1,GitHub,2021-03-25 20:09:32-07:00,['03f13d1c41c033432f5a605b557cc832a18f1790'],7,10,17,2543085,1,1,0,1,5718
f91d592a270dc4254978fbdb51e9cd479426b931,0,GitHub,2021-03-26 19:55:27-07:00,['704cabf10d2e5daeddb3ebfbecf7cd831e6c856e'],28,96,124,2543209,3,0,1,1,5718
bd9a5da9d11af9a7112ba249dbe65be711acd812,0,GitHub,2021-03-28 11:36:42-07:00,['f91d592a270dc4254978fbdb51e9cd479426b931'],0,4,4,2543213,2,,,,5718
69baa03404aa9abd66504e6ed2470ebc1b9b9ff9,0,GitHub,2021-03-28 11:39:53-07:00,['bd9a5da9d11af9a7112ba249dbe65be711acd812'],2,2,4,2543217,1,,,,5718
b8058829bbc2eaaebba3ca959e9e601e112516ab,0,GitHub,2021-03-28 12:20:31-07:00,['69baa03404aa9abd66504e6ed2470ebc1b9b9ff9'],244,3,247,2543464,5,0.726315789,0.042105263,0.852631579,5718
d5fd491bf7e92e4b07a0a371dfa766161ac301d2,0,GitHub,2021-03-28 12:33:40-07:00,['b8058829bbc2eaaebba3ca959e9e601e112516ab'],685,92,777,2544241,19,0.136792453,0.231132075,0.155660377,5718
fb2eef94a4ae91501d869e2075c511b433877099,0,GitHub,2021-03-29 14:06:22-07:00,['d5fd491bf7e92e4b07a0a371dfa766161ac301d2'],53,433,486,2544727,6,0.125899281,0.863309353,1,5718
e971d94eb36a8386c50fdb8273a55a2b7822a439,0,GitHub,2021-03-29 14:26:39-07:00,['fb2eef94a4ae91501d869e2075c511b433877099'],3,8,11,2544738,3,0,0,0,5718
16b2d4f3a7864aabb7c438268eeea8d602b9299c,0,GitHub,2021-03-29 15:39:10-07:00,['e971d94eb36a8386c50fdb8273a55a2b7822a439'],100,109,209,2544947,25,,,,5718
0018c3c0890407bb18788174c9c8fb584becd83e,0,GitHub,2021-03-30 09:28:48+02:00,['16b2d4f3a7864aabb7c438268eeea8d602b9299c'],27,1,28,2544975,4,0,0,0,5718
d02ad2c0e109656ccb05d79ef28e97d66cf6beba,0,GitHub,2021-03-30 11:36:13-05:00,['0018c3c0890407bb18788174c9c8fb584becd83e'],1,5,6,2544981,1,1,1,1,5718
d92d464b124f7e94cc240f062c6f96813ecb76d7,0,GitHub,2021-03-30 09:51:49-07:00,['d02ad2c0e109656ccb05d79ef28e97d66cf6beba'],89,446,535,2545516,3,0.424242424,0.962121212,0.954545455,5720
617ee003223873da2c1c7f383d3416684c2d84c8,0,GitHub,2021-03-30 12:13:53-07:00,['d92d464b124f7e94cc240f062c6f96813ecb76d7'],6,5,11,2545527,1,,,,5720
d22c49217e3635c9aea919470d30ed924723821a,0,GitHub,2021-03-30 15:45:08-07:00,['617ee003223873da2c1c7f383d3416684c2d84c8'],13,47,60,2545587,3,1,1,0.428571429,5720
0189298d8667f770a69fb453d99971475f56af4b,0,GitHub,2021-03-30 17:02:42-07:00,['d22c49217e3635c9aea919470d30ed924723821a'],260,96,356,2545943,12,0.858333333,0.475,0.058333333,5720
b35704a8431a5ea99b4da3ae3b344da92c42859c,0,GitHub,2021-03-30 17:31:27-07:00,['0189298d8667f770a69fb453d99971475f56af4b'],63,70,133,2546076,4,0,1,1,5720
3eff8d39f144644eea31687cf36c8e181fb6405e,0,GitHub,2021-03-30 18:55:38-07:00,['b35704a8431a5ea99b4da3ae3b344da92c42859c'],12,75,87,2546163,2,0.363636364,0.909090909,1,5720
482b79dc2586f186971bf7db8e5e23ec7a7566a5,0,GitHub,2021-03-31 12:02:46+08:00,['3eff8d39f144644eea31687cf36c8e181fb6405e'],1,0,1,2546164,1,1,1,0,5720
e8754ba7a01f33ba503ef79de66a5f644cc2ced8,0,GitHub,2021-03-30 22:02:16-07:00,['482b79dc2586f186971bf7db8e5e23ec7a7566a5'],608,18,626,2546790,18,0.223809524,0.138095238,0.142857143,5720
a7251ce17402a93a2017628b378c893bd8a06ddd,0,GitHub,2021-03-30 22:04:13-07:00,['e8754ba7a01f33ba503ef79de66a5f644cc2ced8'],197,1,198,2546988,5,0.413793103,0,0,5720
0981d25d6294f2a65992ec0c7d1783c6b26dc6c8,0,GitHub,2021-03-31 13:14:56+08:00,['a7251ce17402a93a2017628b378c893bd8a06ddd'],9,8,17,2547005,1,,,,5720
667578860a746a0065bf5c3f976e346ddb0c2e26,0,GitHub,2021-03-31 11:28:29+02:00,['0981d25d6294f2a65992ec0c7d1783c6b26dc6c8'],23,4,27,2547032,2,0,0,1,5720
b6a787a0723d39e1f07d1ac7d242e4359a6e26aa,1,GitHub,2021-03-31 08:45:30-07:00,['667578860a746a0065bf5c3f976e346ddb0c2e26'],1,1,2,2547034,1,,,,5720
3829df103e99cba8a54c8591d9e32a969af47a02,0,GitHub,2021-03-31 10:43:10-07:00,['b6a787a0723d39e1f07d1ac7d242e4359a6e26aa'],73,73,146,2547180,4,1,0,1,5720
58d4e527d0b07037e392dc33378b0775010f2c8a,0,GitHub,2021-03-31 11:02:16-07:00,['3829df103e99cba8a54c8591d9e32a969af47a02'],22,25,47,2547227,1,,,,5720
6d7a9012dc25ced4884441ab6ff42a7658f5c15b,0,GitHub,2021-03-31 20:45:18+02:00,['58d4e527d0b07037e392dc33378b0775010f2c8a'],721,1,722,2547949,5,0.619354839,0.223655914,0,5720
b6278ee79da722f85aaefe7755a2be920887175c,0,GitHub,2021-03-31 15:26:40-07:00,['6d7a9012dc25ced4884441ab6ff42a7658f5c15b'],13,8,21,2547970,2,0,0,0,5720
7c5c739b7f020ae40cc435a5f31f4c72bdfa1242,0,GitHub,2021-03-31 16:48:40-07:00,['b6278ee79da722f85aaefe7755a2be920887175c'],3,3,6,2547976,3,,,,5720
ad83fd00bf7e67da2db608978c0bd51fdfa657e8,0,GitHub,2021-04-01 05:13:39-07:00,['7c5c739b7f020ae40cc435a5f31f4c72bdfa1242'],5,0,5,2547981,1,,,,5720
2342ec1d1cc03f4f244fc2921978534af63ae54f,1,GitHub,2021-04-01 07:59:59-07:00,['ad83fd00bf7e67da2db608978c0bd51fdfa657e8'],157,60,217,2548198,28,0.841269841,0.031746032,0.428571429,5720
cc00dffade37754b66fed2775f2d1d85abfbbab3,0,GitHub,2021-04-01 16:08:28+01:00,['2342ec1d1cc03f4f244fc2921978534af63ae54f'],4,4,8,2548206,1,,,,5720
4ed7f2cd01deabca5cf81383d8c9ee68609f8b45,1,GitHub,2021-04-01 10:38:37-05:00,['cc00dffade37754b66fed2775f2d1d85abfbbab3'],94,23,117,2548323,35,,,,5720
aea059a07bf82697635caccb208313163ff89f10,0,GitHub,2021-04-01 12:26:01-05:00,['4ed7f2cd01deabca5cf81383d8c9ee68609f8b45'],5,97,102,2548425,2,0,0.896551724,1,5720
03b52dbe31e1ffc18d95ab98b4a79952dc6e6310,0,GitHub,2021-04-01 10:41:30-07:00,['aea059a07bf82697635caccb208313163ff89f10'],21,19,40,2548465,1,0,1,0.142857143,5720
40f001cc537d6ff2efa71e609c2f84c6b934994d,1,GitHub,2021-04-01 15:42:21-07:00,['03b52dbe31e1ffc18d95ab98b4a79952dc6e6310'],292,674,966,2549431,34,0.333333333,1,0.674074074,5720
110484869797a34281b24fef74d50642aaacee18,0,GitHub,2021-04-02 09:04:21+08:00,['40f001cc537d6ff2efa71e609c2f84c6b934994d'],15,0,15,2549446,1,0,0,0,5720
ec38dcb72f8a056c8f71ad8f577f539356827b74,0,GitHub,2021-04-01 18:30:53-07:00,['110484869797a34281b24fef74d50642aaacee18'],0,191,191,2549637,3,0.755555556,1,1,5721
798672fa141d1ba53d49844f9ac7d2c8060381fa,0,GitHub,2021-04-01 18:37:10-07:00,['ec38dcb72f8a056c8f71ad8f577f539356827b74'],391,0,391,2550028,1,0.385214008,0.171206226,0.101167315,5721
57723f0c97d35960c39e09ce79ac67da09c7f082,0,GitHub,2021-04-02 09:36:35-07:00,['798672fa141d1ba53d49844f9ac7d2c8060381fa'],5,0,5,2550033,1,,,,5721
f863749c51552b6f8e4afd3e5b772e8aa26d1234,0,GitHub,2021-04-02 14:48:36-07:00,['57723f0c97d35960c39e09ce79ac67da09c7f082'],0,3,3,2550036,1,,,,5721
66b0c5c64f2969dc62362b9f169ad1d18f64efe9,1,GitHub,2021-04-02 17:31:56-07:00,['f863749c51552b6f8e4afd3e5b772e8aa26d1234'],19,80,99,2550135,12,0,0.9375,0.09375,5721
976e78e405d57943b989ac487b7f49119b0f4af4,1,GitHub,2021-04-03 08:23:26-07:00,['66b0c5c64f2969dc62362b9f169ad1d18f64efe9'],2173,68,2241,2552376,26,0.320038911,0.086575875,0.043774319,5721
136f584c05c1d381544a95cfcde7adc43f6a7ae9,0,GitHub,2021-04-05 08:11:58-07:00,['976e78e405d57943b989ac487b7f49119b0f4af4'],1,1,2,2552378,1,,,,5721
161c5638b8b1b12fdac04fa56bbaeb270fa36f8d,0,GitHub,2021-04-05 08:42:04-07:00,['136f584c05c1d381544a95cfcde7adc43f6a7ae9'],17,121,138,2552516,2,,,,5721
4f47a565e29539d1c252c36c59f5f24d105cec4b,0,GitHub,2021-04-05 09:27:50-07:00,['161c5638b8b1b12fdac04fa56bbaeb270fa36f8d'],125,330,455,2552971,16,1,1,0.900990099,5721
66ba91733c58ddc3e9465a5b1b234be0b2b06be4,0,GitHub,2021-04-05 11:50:54-07:00,['4f47a565e29539d1c252c36c59f5f24d105cec4b'],97,326,423,2553394,13,0.229299363,0.656050955,0.464968153,5721
cad514bff9140b75a3da18c56efaf26df68310c7,1,GitHub,2021-04-05 15:54:57-07:00,['66ba91733c58ddc3e9465a5b1b234be0b2b06be4'],36,271,307,2553701,7,0.335260116,0.676300578,0.953757225,5721
0a8921517f8e7bdfd5318e7576f6feacc4f3e6f8,0,GitHub,2021-04-05 22:20:23-07:00,['cad514bff9140b75a3da18c56efaf26df68310c7'],6,8,14,2553715,1,,,,5721
267b73616d801e946bb12746787b2793f0639e7b,0,GitHub,2021-04-06 15:46:00+08:00,['0a8921517f8e7bdfd5318e7576f6feacc4f3e6f8'],1,1,2,2553717,1,,,,5721
2f3600198722dd5a01a210bc78b7d43b33967c7f,1,GitHub,2021-04-06 08:54:53-07:00,['267b73616d801e946bb12746787b2793f0639e7b'],434,36,470,2554187,19,0.303448276,0,0.255172414,5721
137491c7248c90327b72eda88fa26d18c4a589f0,0,GitHub,2021-04-06 09:49:14-07:00,['2f3600198722dd5a01a210bc78b7d43b33967c7f'],1,11,12,2554199,2,1,1,1,5721
7bc84d6ced71056dbb4cecdc9abbdbd7d8a5aa10,1,GitHub,2021-04-06 10:18:06-07:00,['137491c7248c90327b72eda88fa26d18c4a589f0'],53,1394,1447,2555646,26,0.303947368,0.905263158,0.827631579,5730
12e655f45c4f8002a19c5847363a15d974bba7e9,0,GitHub,2021-04-06 12:10:55-07:00,['7bc84d6ced71056dbb4cecdc9abbdbd7d8a5aa10'],1,5,6,2555652,1,,,,5730
ff77864a699df46a01fc76114f662c609f4fd7a6,1,GitHub,2021-04-06 15:08:24-05:00,['12e655f45c4f8002a19c5847363a15d974bba7e9'],349,1331,1680,2557332,13,,,,5740
33d0445b8408289800352de7822340028782a154,0,GitHub,2021-04-06 17:47:52-07:00,['ff77864a699df46a01fc76114f662c609f4fd7a6'],11,17,28,2557360,3,,,,5740
174f0f9ea110897797b7dd0bb503f74786f1aa66,0,GitHub,2021-04-07 11:29:14+08:00,['33d0445b8408289800352de7822340028782a154'],8,16,24,2557384,1,1,1,0.285714286,5740
be592dfbed716f2ce39e8f8e719a70d0a9d56ae1,0,GitHub,2021-04-07 11:39:48+08:00,['174f0f9ea110897797b7dd0bb503f74786f1aa66'],48,20,68,2557452,3,0,1,0,5740
e28924062f6cf5702080ca8b8473019bcb09ecae,0,GitHub,2021-04-06 22:29:26-07:00,['be592dfbed716f2ce39e8f8e719a70d0a9d56ae1'],2,7,9,2557461,3,1,1,0,5740
999fcba3ec16526c32949836549ae8059ea61ffa,1,GitHub,2021-04-07 10:34:51-07:00,['e28924062f6cf5702080ca8b8473019bcb09ecae'],72,133,205,2557666,3,0,0.169811321,1,5740
37493d1e18d9ec85b392e852032c85a57bbc3d28,1,GitHub,2021-04-07 13:35:12-07:00,['999fcba3ec16526c32949836549ae8059ea61ffa'],34,954,988,2558654,13,0.727822581,0.965725806,0.739919355,5745
00ec646c5a1762bdce28ed9878cfa46961de37b6,0,GitHub,2021-04-07 13:36:39-07:00,['37493d1e18d9ec85b392e852032c85a57bbc3d28'],195,13,208,2558862,9,0.448275862,0,0,5745
6e1723b4834b75bc0e16749afe31e5b690bec698,0,GitHub,2021-04-07 13:52:50-07:00,['00ec646c5a1762bdce28ed9878cfa46961de37b6'],1,129,130,2558992,13,,,,5745
04f47c54c26525f6aa7ee4097dc1f60525fad83a,0,GitHub,2021-04-07 13:57:12-07:00,['6e1723b4834b75bc0e16749afe31e5b690bec698'],1,0,1,2558993,1,,,,5745
3ca5a3bb78ec2324391c026d3dd1b6773cf9c772,0,GitHub,2021-04-07 17:38:43-07:00,['04f47c54c26525f6aa7ee4097dc1f60525fad83a'],795,17,812,2559805,13,0.008547009,0.008547009,0.179487179,5745
e9c5a3995abcf5ddda16ff4ae4ad19be97035e9a,0,GitHub,2021-04-07 21:13:32-07:00,['3ca5a3bb78ec2324391c026d3dd1b6773cf9c772'],6,27,33,2559838,1,,,,5745
a97f0f515d02d743ab2fcc48fba024c2e115c243,0,GitHub,2021-04-08 16:27:07+08:00,['e9c5a3995abcf5ddda16ff4ae4ad19be97035e9a'],3,3,6,2559844,1,,,,5745
232e5150b56ca0c4253f1281db7de693e00fa11e,0,GitHub,2021-04-08 16:35:15+08:00,['a97f0f515d02d743ab2fcc48fba024c2e115c243'],1,0,1,2559845,1,1,0,0,5745
aa0f450dada9ac47c5e9874c44eba801051ed899,0,GitHub,2021-04-08 08:39:51-07:00,['232e5150b56ca0c4253f1281db7de693e00fa11e'],24,1,25,2559870,2,0,0,0,5745
d44e01be4895bee9e19a8b9f0727e44af79ad940,0,Guozhang Wang,2021-04-08 08:49:33-07:00,['aa0f450dada9ac47c5e9874c44eba801051ed899'],0,1,1,2559871,1,,,,5745
c2ea0c2e1d44332639214b921ddf3dc1edf478c0,1,GitHub,2021-04-08 10:24:23-07:00,['d44e01be4895bee9e19a8b9f0727e44af79ad940'],18,64,82,2559953,14,0.842105263,1,0.894736842,5745
d2c06c9c3c35803b9f5f0b6060b242789657f008,0,GitHub,2021-04-08 10:42:30-07:00,['c2ea0c2e1d44332639214b921ddf3dc1edf478c0'],83,100,183,2560136,4,0,1,0.3125,5745
5964401bf9aab611bd4a072941bd1c927e044258,1,GitHub,2021-04-08 13:56:21-04:00,['d2c06c9c3c35803b9f5f0b6060b242789657f008'],140,335,475,2560611,17,0.210191083,0.420382166,0.789808917,5745
8d356b034b5759e7baa740921a4804dbba678f49,0,GitHub,2021-04-08 20:55:52-07:00,['5964401bf9aab611bd4a072941bd1c927e044258'],26,30,56,2560667,1,,,,5745
ff3b2d67a1049c75b300547ca6ecf074b6a3ab28,1,GitHub,2021-04-09 18:11:34+02:00,['8d356b034b5759e7baa740921a4804dbba678f49'],74,49,123,2560790,11,0,0.333333333,0,5745
c7ab9b0ef8fe335c9376669d6ec9efd90291c955,0,GitHub,2021-04-09 11:36:43-07:00,['ff3b2d67a1049c75b300547ca6ecf074b6a3ab28'],0,2,2,2560792,1,,,,5745
e4b6ffae5d932af6efb0764a12c7faa812758353,0,GitHub,2021-04-09 11:41:52-07:00,['c7ab9b0ef8fe335c9376669d6ec9efd90291c955'],7,9,16,2560808,1,,,,5745
db0323e9ba3f767614415d833a2081a33825a284,1,GitHub,2021-04-09 11:49:37-07:00,['e4b6ffae5d932af6efb0764a12c7faa812758353'],316,119,435,2561243,22,0.642857143,0,0.089285714,5745
c9edb8ad84ef1a275b1874f0617c07d6e33cdd3d,0,GitHub,2021-04-09 12:12:52-07:00,['db0323e9ba3f767614415d833a2081a33825a284'],1,1,2,2561245,1,,,,5745
f76b8e493832fe7374e58dff460b81eee6245ce5,1,GitHub,2021-04-09 12:19:14-07:00,['c9edb8ad84ef1a275b1874f0617c07d6e33cdd3d'],51,171,222,2561467,2,0.068965517,0.706896552,0.586206897,5745
c9cab2beb8159ca83e6e2c930514ba97282e1ae9,0,GitHub,2021-04-09 14:49:54-05:00,['f76b8e493832fe7374e58dff460b81eee6245ce5'],131,217,348,2561815,17,0.888888889,0.222222222,1,5747
872b44455c76affc80837b2ef8971753803edc86,0,GitHub,2021-04-09 14:58:44-07:00,['c9cab2beb8159ca83e6e2c930514ba97282e1ae9'],24,0,24,2561839,1,0,0,0,5747
db688b1a5e5904eed5849fbab4940585e5a3d646,0,GitHub,2021-04-09 19:15:11-07:00,['872b44455c76affc80837b2ef8971753803edc86'],1,113,114,2561953,2,0.197368421,1,1,5747
2004f5b2cac733b33e776311ad0144b03aca40e4,0,GitHub,2021-04-11 22:48:42-07:00,['db688b1a5e5904eed5849fbab4940585e5a3d646'],2,2,4,2561957,1,,,,5747
2899200c9741a647f89808f212267a689b17ebaf,0,GitHub,2021-04-11 22:49:33-07:00,['2004f5b2cac733b33e776311ad0144b03aca40e4'],15,0,15,2561972,1,,,,5747
73df36d2412b980dd92b4dfc2a38a0ee4fd0fe57,1,GitHub,2021-04-12 17:49:24+08:00,['2899200c9741a647f89808f212267a689b17ebaf'],2,2,4,2561976,1,,,,5747
0b0eaefc60a39aac2f6e90a0eff87deff0f77bf2,0,GitHub,2021-04-12 15:35:15+01:00,['73df36d2412b980dd92b4dfc2a38a0ee4fd0fe57'],0,10,10,2561986,1,,,,5747
10308b7a528e9da1e8c6dba6cff0596729d3c1fb,0,GitHub,2021-04-12 08:06:18-07:00,['0b0eaefc60a39aac2f6e90a0eff87deff0f77bf2'],2,101,103,2562089,2,0,0.657534247,1,5747
e677782112743d16eca411dd1e1f905f67956da1,0,GitHub,2021-04-12 09:28:23-07:00,['10308b7a528e9da1e8c6dba6cff0596729d3c1fb'],4,77,81,2562170,2,0.553191489,1,0.808510638,5747
c972c4ea64d9b939e3ef6e8b8d6d8b4017e32c6e,0,GitHub,2021-04-12 14:02:24-07:00,['e677782112743d16eca411dd1e1f905f67956da1'],1,3,4,2562174,1,,,,5747
c608d8480edad982bd121fc8b70cd8347eff2e60,0,GitHub,2021-04-12 18:24:18-07:00,['c972c4ea64d9b939e3ef6e8b8d6d8b4017e32c6e'],20,11,31,2562205,4,0.75,1,0,5747
88eb24db40cc47786b6c72fa9f77032281f6e1b0,0,GitHub,2021-04-12 18:37:01-07:00,['c608d8480edad982bd121fc8b70cd8347eff2e60'],465,159,624,2562829,9,0.03,0.03,0,5748
1e8a7c45efe77e25f39b6db775ad37c2f39b80ef,0,GitHub,2021-04-12 21:05:49-07:00,['88eb24db40cc47786b6c72fa9f77032281f6e1b0'],123,9,132,2562961,2,,,,5748
a776020688ad1e050b7f129d28f7481ae6d55ce6,0,GitHub,2021-04-12 22:26:54-07:00,['1e8a7c45efe77e25f39b6db775ad37c2f39b80ef'],0,2,2,2562963,1,,,,5748
80de188727a98d282bac29fda8751c5be0189f52,0,GitHub,2021-04-13 14:28:31+08:00,['a776020688ad1e050b7f129d28f7481ae6d55ce6'],7,11,18,2562981,1,0,0,1,5748
235d13ff2a1a4f97e4a38c3a6a2478579ae134c7,0,GitHub,2021-04-13 14:40:55+08:00,['80de188727a98d282bac29fda8751c5be0189f52'],1,1,2,2562983,1,,,,5748
23633cd1ec3c8a044af9bb9da362f74100c20326,0,GitHub,2021-04-13 11:48:17+02:00,['235d13ff2a1a4f97e4a38c3a6a2478579ae134c7'],58,2,60,2563043,3,,,,5748
327809024fab07c44cd6d87985db5b9d14fd43bb,0,GitHub,2021-04-13 10:14:03-07:00,['23633cd1ec3c8a044af9bb9da362f74100c20326'],20,1725,1745,2564788,14,0.58186398,0.909319899,0.870277078,5756
a8a6952e4a0b6f161dee4caa3eb0cb0fbf23091c,1,GitHub,2021-04-13 11:00:22-07:00,['327809024fab07c44cd6d87985db5b9d14fd43bb'],39,438,477,2565265,13,0.073964497,0.75739645,1,5756
232ffc358a415897634261371827b460f1b161c6,1,GitHub,2021-04-13 11:41:12-07:00,['a8a6952e4a0b6f161dee4caa3eb0cb0fbf23091c'],19,15,34,2565299,1,1,0,1,5756
b163706dc92d15476a9c0749e7b1176594067203,0,GitHub,2021-04-14 11:45:45-07:00,['232ffc358a415897634261371827b460f1b161c6'],2,2,4,2565303,1,,,,5756
89933f21f204abf75336464d3ac24a4fdd254628,1,GitHub,2021-04-14 14:38:37-07:00,['b163706dc92d15476a9c0749e7b1176594067203'],487,636,1123,2566426,52,0,1,0.912698413,5756
07fb69c16cf2ce1aa2d45b5c7e0dd04a11e42d96,0,GitHub,2021-04-15 17:01:26+02:00,['89933f21f204abf75336464d3ac24a4fdd254628'],7,1,8,2566434,2,0,1,0,5756
2e25a1d4d44b517e133b227cf4cb817a7c82bc0a,1,GitHub,2021-04-15 10:13:41-07:00,['07fb69c16cf2ce1aa2d45b5c7e0dd04a11e42d96'],4,6,10,2566444,2,,,,5756
31b4ba8c5a77b7fc5b92fce5228a872f860b0f18,1,GitHub,2021-04-15 10:45:24-07:00,['2e25a1d4d44b517e133b227cf4cb817a7c82bc0a'],162,687,849,2567293,6,0.248366013,0.616557734,0.930283224,5756
fc405d792de12a50956195827eaf57bbf64444c9,0,GitHub,2021-04-15 11:37:15-07:00,['31b4ba8c5a77b7fc5b92fce5228a872f860b0f18'],4,84,88,2567381,139,,,,5757
637c44c976c115b7e770a6fd9e62e8822051b45b,0,GitHub,2021-04-15 20:48:53-07:00,['fc405d792de12a50956195827eaf57bbf64444c9'],0,4,4,2567385,2,,,,5757
a6b22f33f140d521e0ef6b764aa210e8c1f51c24,0,GitHub,2021-04-16 14:38:42+08:00,['637c44c976c115b7e770a6fd9e62e8822051b45b'],33,24,57,2567442,7,,,,5757
f8f1769256de2a1afa92794309ecee475cd80b79,0,GitHub,2021-04-16 15:11:25+01:00,['a6b22f33f140d521e0ef6b764aa210e8c1f51c24'],1,996,997,2568439,8,0.655555556,0.962962963,0.812962963,5763
df185aabc04fbd3c95327a878863a0549539ea6c,1,GitHub,2021-04-16 22:59:22+08:00,['f8f1769256de2a1afa92794309ecee475cd80b79'],30,30,60,2568499,1,,,,5763
035449eb5576bf97df888a85edaaf4428b9a19e5,0,GitHub,2021-04-18 10:46:01-07:00,['df185aabc04fbd3c95327a878863a0549539ea6c'],2053,25,2078,2570577,7,0.343403827,0.146022155,0.348439074,5763
15c24da888bc0a2582fd84d89fa1b84354fede64,1,GitHub,2021-04-18 11:18:09-07:00,['035449eb5576bf97df888a85edaaf4428b9a19e5'],194,325,519,2571096,12,1,1,1,5763
03b953cf5530ab32c7c907f4e3c3b253800c3f0e,0,GitHub,2021-04-19 13:54:04+02:00,['15c24da888bc0a2582fd84d89fa1b84354fede64'],1,1,2,2571098,1,,,,5763
937054bb5e424d07075a758aad46abea129d0b24,0,GitHub,2021-04-19 21:40:07+08:00,['03b953cf5530ab32c7c907f4e3c3b253800c3f0e'],50,18,68,2571166,7,0.181818182,0,0,5763
0fd3eb03746ecff0c902a7133136cf15b5095fa0,0,GitHub,2021-04-20 10:35:52+08:00,['937054bb5e424d07075a758aad46abea129d0b24'],17,7,24,2571190,1,0.25,0,0,5763
8360db41da32bb053acd1e0c61fcb43ba1c40780,0,GitHub,2021-04-20 13:58:15+08:00,['0fd3eb03746ecff0c902a7133136cf15b5095fa0'],14,9,23,2571213,3,0,0,0,5763
7ca13d32bb513ca8ee101b91aca8eb2eebbfcc94,0,GitHub,2021-04-20 16:30:29+08:00,['8360db41da32bb053acd1e0c61fcb43ba1c40780'],3,3,6,2571219,2,,,,5763
0b464419e2e4f28444fca653ae5aa8dd7feae9ba,1,GitHub,2021-04-20 09:20:40-07:00,['7ca13d32bb513ca8ee101b91aca8eb2eebbfcc94'],2182,3004,5186,2576405,13,0.147117296,0.980119284,0.497017893,5765
a24e78b34a17c9da2c9a5236c76febacddc52aef,0,GitHub,2021-04-20 19:14:26-07:00,['0b464419e2e4f28444fca653ae5aa8dd7feae9ba'],1,0,1,2576406,1,,,,5765
d3538ed0ab7a97cf596a366accd0a81518841e5d,0,GitHub,2021-04-21 10:40:01+08:00,['a24e78b34a17c9da2c9a5236c76febacddc52aef'],13,10,23,2576429,4,0,0,0,5765
a46beb9d29781e0709baf596601122f770a5fa31,0,GitHub,2021-04-21 17:35:17+08:00,['d3538ed0ab7a97cf596a366accd0a81518841e5d'],1,1,2,2576431,1,,,,5765
87b24025cedf08c550a180819b2a5a2dbb75f020,0,Guozhang Wang,2021-04-21 10:25:54-07:00,['a46beb9d29781e0709baf596601122f770a5fa31'],1,1,2,2576433,1,,,,5765
3bfc9fe48683ecc43139f98c7f270280dd7a3e57,0,GitHub,2021-04-21 12:50:30-07:00,['87b24025cedf08c550a180819b2a5a2dbb75f020'],6,7,13,2576446,4,,,,5765
72236f343d644569c8699b2337b0b99b2c8d2752,1,GitHub,2021-04-21 19:43:18-07:00,['3bfc9fe48683ecc43139f98c7f270280dd7a3e57'],2,29,31,2576477,2,0.095238095,0.952380952,0.952380952,5765
6013ac3cea29ede41d0c9f1bf1f54069aeceb2ad,1,GitHub,2021-04-22 11:10:05+08:00,['72236f343d644569c8699b2337b0b99b2c8d2752'],2,3,5,2576482,1,,,,5765
523d63df983815fed0b9d65978edd14dcab65e05,0,GitHub,2021-04-22 11:41:09+08:00,['6013ac3cea29ede41d0c9f1bf1f54069aeceb2ad'],0,5,5,2576487,1,1,1,1,5765
4de5f1267164d59c741632c870f2a7aa5153e3a7,0,GitHub,2021-04-21 22:12:04-07:00,['523d63df983815fed0b9d65978edd14dcab65e05'],8,3,11,2576498,1,0,0,0,5765
2a1b240829ed4c28708df50da281f6f4d5cfe59c,1,GitHub,2021-04-22 09:34:11-07:00,['4de5f1267164d59c741632c870f2a7aa5153e3a7'],33,1250,1283,2577781,22,0.592319055,0.889217134,0.782865583,5774
105243afb11883cf0dbbe46e3e783b7fa697836a,0,GitHub,2021-04-23 10:06:55-07:00,['2a1b240829ed4c28708df50da281f6f4d5cfe59c'],65,129,194,2577975,3,0.909090909,0.96969697,1,5775
c972ac929edaa32f30dae19714180cdd23addeeb,0,GitHub,2021-04-23 12:09:32-07:00,['105243afb11883cf0dbbe46e3e783b7fa697836a'],8,23,31,2578006,5,1,1,1,5775
ea076a8d6289fa8e94e7e6876437b565f9a9f9c3,0,GitHub,2021-04-25 20:55:10+08:00,['c972ac929edaa32f30dae19714180cdd23addeeb'],6,11,17,2578023,1,,,,5775
031b7208b3b54ab03c6d93fa617967d2f1f8abe5,1,GitHub,2021-04-25 21:15:50+08:00,['ea076a8d6289fa8e94e7e6876437b565f9a9f9c3'],1,43,44,2578067,2,0,1,1,5775
d949f1094e2dc270ecbdd7b84aa8470690c697e4,0,GitHub,2021-04-26 11:38:48-07:00,['031b7208b3b54ab03c6d93fa617967d2f1f8abe5'],3,76,79,2578146,3,0.117647059,1,1,5775
bcfe91035657e471fbc041adf26d548da24c2b0e,0,GitHub,2021-04-26 15:41:00-07:00,['d949f1094e2dc270ecbdd7b84aa8470690c697e4'],2,20,22,2578168,1,0.727272727,1,1,5775
0ea440b2af07fe0d6465f76afc948b28509606b5,0,GitHub,2021-04-27 15:44:53-07:00,['bcfe91035657e471fbc041adf26d548da24c2b0e'],24,114,138,2578306,5,0.426229508,1,1,5775
56c7eb68d2cd03c256236779a3e8d53b885f6b17,1,GitHub,2021-04-28 07:58:55-07:00,['0ea440b2af07fe0d6465f76afc948b28509606b5'],0,719,719,2579025,11,0.467661692,0.803482587,0.855721393,5780
ab06aef2b8507768413c9d2525b8d1f6ed68f28c,0,GitHub,2021-04-28 23:56:48+08:00,['56c7eb68d2cd03c256236779a3e8d53b885f6b17'],16,45,61,2579086,2,0.571428571,1,0.785714286,5780
e57973bbf2e79cd9168b5c7fefb962289f5c0f62,0,GitHub,2021-04-28 11:31:37-07:00,['ab06aef2b8507768413c9d2525b8d1f6ed68f28c'],5,0,5,2579091,1,,,,5780
3805f3706f8f3ebba81b80915c9259590525fb05,1,GitHub,2021-04-28 13:22:15-07:00,['e57973bbf2e79cd9168b5c7fefb962289f5c0f62'],228,495,723,2579814,42,0.581967213,0.721311475,1,5780
bf359f8e2924ee03b34a6f7e7eaf80bef55f9d98,1,GitHub,2021-04-28 17:57:28-07:00,['3805f3706f8f3ebba81b80915c9259590525fb05'],61,2500,2561,2582375,23,0.192645883,0.8441247,0.849720224,5791
f9de25f046452b2a6d916e6bca41e31d49bbdecf,0,GitHub,2021-04-29 11:39:55+08:00,['bf359f8e2924ee03b34a6f7e7eaf80bef55f9d98'],8,8,16,2582391,1,,,,5791
eaa14a8a688c8a6c23eb8d081dbee9f53fd8dc03,0,GitHub,2021-04-29 14:32:50+01:00,['f9de25f046452b2a6d916e6bca41e31d49bbdecf'],15,63,78,2582469,2,1,0.4,1,5791
a855f6ac37149d6908499c68df46671a2754d21a,0,GitHub,2021-04-29 09:25:21-07:00,['eaa14a8a688c8a6c23eb8d081dbee9f53fd8dc03'],138,356,494,2582963,13,0.262195122,1,0.993902439,5791
8d38189eddd66d8ae53749f15bfff557f102a936,1,GitHub,2021-04-29 11:20:30-07:00,['a855f6ac37149d6908499c68df46671a2754d21a'],176,241,417,2583380,6,1,0.433333333,0.25,5791
9dbf2226cdae4a30e44340a552613446c5053d87,0,GitHub,2021-04-29 12:30:48-07:00,['8d38189eddd66d8ae53749f15bfff557f102a936'],249,56,305,2583685,5,0.450980392,0.607843137,0.006535948,5791
e454becb33faac0851b7d145452992f183cbff76,1,GitHub,2021-04-29 19:47:26-07:00,['9dbf2226cdae4a30e44340a552613446c5053d87'],7,176,183,2583868,9,0.813084112,1,0.934579439,5791
0a1ef2e9824df1f5d6f32a4be2c1cd0c57bfb398,0,GitHub,2021-04-30 12:50:37-07:00,['e454becb33faac0851b7d145452992f183cbff76'],46,46,92,2583960,1,,,,5791
16b2ce7da72e60d88b6ca8a3eff853a28a1458f9,0,GitHub,2021-04-30 22:46:00-07:00,['0a1ef2e9824df1f5d6f32a4be2c1cd0c57bfb398'],57,329,386,2584346,16,0.615942029,0.782608696,0.84057971,5794
1f4207c7c187b201fa3fc47f5752b7ee3df681bd,0,GitHub,2021-05-01 23:22:46+08:00,['16b2ce7da72e60d88b6ca8a3eff853a28a1458f9'],29,31,60,2584406,8,1,1,0,5794
3ec6317ee67de0774a6c8c2b48faf0b38b8643d9,0,GitHub,2021-05-01 08:31:41-07:00,['1f4207c7c187b201fa3fc47f5752b7ee3df681bd'],130,4,134,2584540,3,0,0,0.333333333,5794
bee3cf7d98645af5460f3483acf81cf1c60de08e,0,GitHub,2021-05-01 08:32:14-07:00,['3ec6317ee67de0774a6c8c2b48faf0b38b8643d9'],26,4,30,2584570,2,0.727272727,1,0,5794
6203bf8b94c7c340671c1729f4a8e4fcc302605e,1,GitHub,2021-05-01 10:05:45-07:00,['bee3cf7d98645af5460f3483acf81cf1c60de08e'],644,1676,2320,2586890,32,0.389908257,1,0.934250765,5798
e73731d8486735c882a721b92df450eb4be59f15,0,GitHub,2021-05-02 13:07:08+08:00,['6203bf8b94c7c340671c1729f4a8e4fcc302605e'],7,35,42,2586932,3,0.708333333,0.916666667,1,5798
325cb8853b7682bfe065a96d8b7808f0ef6cb89e,0,GitHub,2021-05-03 00:44:32+08:00,['e73731d8486735c882a721b92df450eb4be59f15'],12,7,19,2586951,4,1,0.6,0.6,5798
711608b3b1ed409afc0a7a3c701861559dd7a416,0,GitHub,2021-05-02 12:15:54-07:00,['325cb8853b7682bfe065a96d8b7808f0ef6cb89e'],8,8,16,2586967,2,,,,5798
3ddc377b056bde60f549ef383f9a8af1152ac3d6,1,GitHub,2021-05-03 12:41:03+08:00,['711608b3b1ed409afc0a7a3c701861559dd7a416'],64,47,111,2587078,12,0.727272727,0,0,5798
816f5c3b86ce94b1872f0d9d4bac9fdaa37b390f,0,GitHub,2021-05-03 13:53:35-07:00,['3ddc377b056bde60f549ef383f9a8af1152ac3d6'],18,74,92,2587170,4,1,1,1,5798
62221edaff412ca18cf32d81e82fd1f68752eaf6,1,GitHub,2021-05-03 14:10:05-07:00,['816f5c3b86ce94b1872f0d9d4bac9fdaa37b390f'],8,255,263,2587433,7,0.157258065,0.830645161,0.955645161,5798
45f24c41954e5bfeeec5b7050ee8fb873dd8104a,0,GitHub,2021-05-04 09:23:30-07:00,['62221edaff412ca18cf32d81e82fd1f68752eaf6'],207,50,257,2587690,7,0,0,0.763636364,5798
9a71468cb0e5fc9faeba39b56f36d0c93ca73c59,0,GitHub,2021-05-05 12:26:51+02:00,['45f24c41954e5bfeeec5b7050ee8fb873dd8104a'],57,168,225,2587915,1,1,0.848837209,0.848837209,5798
a1367f57f52e7c5bdb2fadf14f3b124dd7148213,1,GitHub,2021-05-05 07:48:52-07:00,['9a71468cb0e5fc9faeba39b56f36d0c93ca73c59'],148,1122,1270,2589185,21,0.860169492,0.991525424,1,5811
d915ce58d2adcfd6113f961ecbf337770dbe760b,1,GitHub,2021-05-05 10:21:43-07:00,['a1367f57f52e7c5bdb2fadf14f3b124dd7148213'],31,276,307,2589492,4,0.237113402,0.953608247,0.943298969,5811
d881d113886b837f382d89a02cf7f3c5715edf6e,0,GitHub,2021-05-05 11:12:00-07:00,['d915ce58d2adcfd6113f961ecbf337770dbe760b'],2,2,4,2589496,1,,,,5811
9ba583f6d6677a48685b37eb4b2bef2a711c94b7,0,GitHub,2021-05-05 16:11:15-05:00,['d881d113886b837f382d89a02cf7f3c5715edf6e'],7,110,117,2589613,3,0.210526316,0.973684211,0.763157895,5811
6a5992a814364a41ce7ad34aa6b27cc44d0eb78c,0,GitHub,2021-05-05 16:16:06-07:00,['9ba583f6d6677a48685b37eb4b2bef2a711c94b7'],15,99,114,2589727,5,0,0.672413793,1,5811
79225504ed920e63b2a31a968b7d50f88af5ada2,1,GitHub,2021-05-05 18:44:59-07:00,['6a5992a814364a41ce7ad34aa6b27cc44d0eb78c'],99,313,412,2590139,2,0,0.737588652,0.709219858,5811
80aea23beb2654b2a53e0248387f2b4dbc0f0dc1,0,GitHub,2021-05-05 21:58:27-07:00,['79225504ed920e63b2a31a968b7d50f88af5ada2'],1,1,2,2590141,1,,,,5811
ebd4748eba80c9fc9264f434bbb135336e38133e,0,GitHub,2021-05-06 09:57:45+01:00,['80aea23beb2654b2a53e0248387f2b4dbc0f0dc1'],3,3,6,2590147,1,,,,5811
03690d7a1f5e90fb85690352d7f2b7651e554dc3,0,GitHub,2021-05-06 12:05:36+02:00,['ebd4748eba80c9fc9264f434bbb135336e38133e'],49,45,94,2590241,1,1,0,0,5811
b73d639adc9e4b5f1940d364f5ece481604b802a,0,GitHub,2021-05-06 20:02:03+05:18,['03690d7a1f5e90fb85690352d7f2b7651e554dc3'],1,1,2,2590243,1,,,,5811
94be57d6106fa6d0dea16f9574b7e8fcbffcf88b,0,GitHub,2021-05-06 17:25:02+02:00,['b73d639adc9e4b5f1940d364f5ece481604b802a'],31,36,67,2590310,1,0,0.666666667,0.833333333,5811
12a1e68aeb2d1e38c06d92c957dabc239e2252d5,0,GitHub,2021-05-06 11:25:23-07:00,['94be57d6106fa6d0dea16f9574b7e8fcbffcf88b'],21,6,27,2590337,6,,,,5811
90fc875e24121fd0a39143983ce9eb8a93849d7e,0,GitHub,2021-05-06 15:29:26-07:00,['12a1e68aeb2d1e38c06d92c957dabc239e2252d5'],110,486,596,2590933,23,0.817460317,0.880952381,1,5811
45d7440c1577b838d4584d3860e5c4d691446f3f,0,GitHub,2021-05-06 17:27:23-07:00,['90fc875e24121fd0a39143983ce9eb8a93849d7e'],21,64,85,2591018,20,0,0.5,1,5811
15d1cc8b5435eda7c36e42ae0898b0671b70a96f,0,GitHub,2021-05-06 17:46:01-07:00,['45d7440c1577b838d4584d3860e5c4d691446f3f'],54,260,314,2591332,8,1,1,0.863636364,5813
f109240236a991f2051cea1e319f97e1fdcc3206,0,GitHub,2021-05-07 18:24:33+08:00,['15d1cc8b5435eda7c36e42ae0898b0671b70a96f'],0,1,1,2591333,1,,,,5813
91b3be44a246a49084bce0c957127aa759c616cc,1,GitHub,2021-05-07 14:16:58+01:00,['f109240236a991f2051cea1e319f97e1fdcc3206'],8,9,17,2591350,2,1,1,1,5813
8f8f914efc2dfb2a6638553038dcb17393d7de96,1,GitHub,2021-05-07 13:24:41-05:00,['91b3be44a246a49084bce0c957127aa759c616cc'],141,359,500,2591850,11,0.660550459,0.990825688,0.055045872,5813
f1ef21f70afafa2e9778b355eeffdec804f5c7d9,1,GitHub,2021-05-08 18:11:40-07:00,['8f8f914efc2dfb2a6638553038dcb17393d7de96'],20,33,53,2591903,1,0,0,1,5813
d934647484ad61f0ca82f303738b28d9b7c54328,0,GitHub,2021-05-09 19:03:14-07:00,['f1ef21f70afafa2e9778b355eeffdec804f5c7d9'],1,1,2,2591905,1,,,,5813
9bec36256ef0fa151da97d0d970d381d4d66d6e1,0,GitHub,2021-05-09 19:22:29-07:00,['d934647484ad61f0ca82f303738b28d9b7c54328'],1,0,1,2591906,1,,,,5813
8a574adcae5111f1795f52d638d43fac382fd547,1,GitHub,2021-05-10 10:22:26+01:00,['9bec36256ef0fa151da97d0d970d381d4d66d6e1'],1,1,2,2591908,1,,,,5813
25f4ee879cf9e13f586d4d45f9451cf0090e084d,0,GitHub,2021-05-10 12:32:51-07:00,['8a574adcae5111f1795f52d638d43fac382fd547'],2,9,11,2591919,1,0,1,1,5813
fae0784ce32a448a0d8c69e0b55f957290df1b5a,0,GitHub,2021-05-10 17:29:58-07:00,['25f4ee879cf9e13f586d4d45f9451cf0090e084d'],1,13,14,2591933,4,1,1,1,5813
80a468e2b3eea28173f03651b33c35f8b1547597,0,GitHub,2021-05-11 09:04:40-07:00,['fae0784ce32a448a0d8c69e0b55f957290df1b5a'],4,0,4,2591937,1,,,,5813
7ef38794291fc5d2317a3c3e33b463e2525b12a9,1,GitHub,2021-05-11 09:58:28-07:00,['80a468e2b3eea28173f03651b33c35f8b1547597'],79,152,231,2592168,64,,,,5813
2debbb98c8dae8fabb2d3d88a1a8d8e68cf14caa,0,GitHub,2021-05-11 18:14:38-07:00,['7ef38794291fc5d2317a3c3e33b463e2525b12a9'],15,11,26,2592194,1,0,0,0,5813
9c9ea3044e7306249441c6ee6c4540afd8ff0bc0,0,GitHub,2021-05-12 15:27:49+08:00,['2debbb98c8dae8fabb2d3d88a1a8d8e68cf14caa'],7,2,9,2592203,1,,,,5813
13ffebe2f1012da473189c4fe86fd14b83809962,0,GitHub,2021-05-12 08:13:03-07:00,['9c9ea3044e7306249441c6ee6c4540afd8ff0bc0'],3,3,6,2592209,2,,,,5813
4b2736570c9d5f4b6e501ab8cd5efe696a5142b7,0,GitHub,2021-05-13 11:25:18-07:00,['13ffebe2f1012da473189c4fe86fd14b83809962'],158,286,444,2592653,19,1,1,0.823529412,5815
e69571aecc75d4b3d37c8b43d39cae83e250bedb,1,GitHub,2021-05-13 12:08:18-07:00,['4b2736570c9d5f4b6e501ab8cd5efe696a5142b7'],5,145,150,2592803,6,0.183908046,1,0.965517241,5815
6d1ae8bc007ffa1f3b3a9f949db6a99820dab75c,0,GitHub,2021-05-13 15:54:00-07:00,['e69571aecc75d4b3d37c8b43d39cae83e250bedb'],1,1004,1005,2593808,11,0.800995025,0.800995025,1,5819
4153e754f1a4ebbd9a3d10be8bf75a7057c82f1d,0,GitHub,2021-05-13 16:16:35-07:00,['6d1ae8bc007ffa1f3b3a9f949db6a99820dab75c'],58,66,124,2593932,4,1,1,0,5819
29c55fdbbc331bbede17908ccc878953a1b15d87,0,GitHub,2021-05-14 13:51:31+08:00,['4153e754f1a4ebbd9a3d10be8bf75a7057c82f1d'],0,9,9,2593941,1,1,1,1,5819
db3e5e2c0de367ffcfe4078359d6d208ba722581,1,GitHub,2021-05-14 09:25:24-07:00,['29c55fdbbc331bbede17908ccc878953a1b15d87'],42,25,67,2594008,5,1,0,1,5819
f2785f3c4f83bbc3caef48993018896bf73224df,1,GitHub,2021-05-14 12:17:31-07:00,['db3e5e2c0de367ffcfe4078359d6d208ba722581'],35,254,289,2594297,9,0.384615385,0.905982906,0.871794872,5820
f20fdbd839ea1275fa4b26e9eb3c49ef5d9af1ca,1,GitHub,2021-05-14 12:44:16-07:00,['f2785f3c4f83bbc3caef48993018896bf73224df'],48,241,289,2594586,7,0.172661871,0.726618705,0.964028777,5820
ad91c5edf09af83cf44e2be71f19407ade1896bb,0,GitHub,2021-05-15 06:10:04-07:00,['f20fdbd839ea1275fa4b26e9eb3c49ef5d9af1ca'],11,15,26,2594612,4,,,,5820
3b6599c600f6e7fbeb000a088591f1cf9aba107d,0,GitHub,2021-05-16 14:22:49-07:00,['ad91c5edf09af83cf44e2be71f19407ade1896bb'],5,3,8,2594620,1,,,,5820
e35f5c88b17d26b7f31b34b9a00239e514c8a811,0,GitHub,2021-05-17 09:34:43+02:00,['3b6599c600f6e7fbeb000a088591f1cf9aba107d'],1,1,2,2594622,1,,,,5820
fe16912dfc59aa9f2379b904df89c9531cc9a2d5,0,GitHub,2021-05-17 06:34:32-07:00,['e35f5c88b17d26b7f31b34b9a00239e514c8a811'],2,13,15,2594637,2,1,1,1,5820
0188fbea09c1a5081ab8e50e3cb934b1a0069c57,0,GitHub,2021-05-17 17:44:10+02:00,['fe16912dfc59aa9f2379b904df89c9531cc9a2d5'],7,6,13,2594650,1,,,,5820
b9acc492a568ba869a8abdee0fa965f5f58c4de6,0,GitHub,2021-05-17 10:17:31-07:00,['0188fbea09c1a5081ab8e50e3cb934b1a0069c57'],126,208,334,2594984,11,0,0,1,5820
0b9a7bd75ed76d0def67ef96da1cd8cc2f902943,1,GitHub,2021-05-17 10:21:26-07:00,['b9acc492a568ba869a8abdee0fa965f5f58c4de6'],6,383,389,2595373,6,0.806122449,1,1,5824
cc6f4c49a9dc241b1b63ed7cf6ec982b05c541d4,1,GitHub,2021-05-17 10:25:35-07:00,['0b9a7bd75ed76d0def67ef96da1cd8cc2f902943'],185,66,251,2595624,15,1,0.710526316,0.092105263,5824
55b24ce9d68153effe8c303d03c7ac1a8a534eba,0,GitHub,2021-05-17 13:46:44-04:00,['cc6f4c49a9dc241b1b63ed7cf6ec982b05c541d4'],10,23,33,2595657,3,0.666666667,0.555555556,0.111111111,5824
9eb9b16d573ae7a1dc235ad4eb036f88b98ad005,1,GitHub,2021-05-17 19:31:39+01:00,['55b24ce9d68153effe8c303d03c7ac1a8a534eba'],1,13,14,2595671,2,0,1,1,5824
12377bd3c64ee2f5ab50e4f268eee938279f29df,0,GitHub,2021-05-17 17:33:43-04:00,['9eb9b16d573ae7a1dc235ad4eb036f88b98ad005'],0,2,2,2595673,1,,,,5824
9e5b77fb9687c319dd2b188d9669ca2bd01e9bb8,1,GitHub,2021-05-17 16:49:47-07:00,['12377bd3c64ee2f5ab50e4f268eee938279f29df'],124,789,913,2596586,17,0.455737705,0.859016393,1,5828
aefe0e4d8cba8585f74fb7c50761951e663bd8ef,1,GitHub,2021-05-18 09:56:37-04:00,['9e5b77fb9687c319dd2b188d9669ca2bd01e9bb8'],30,142,172,2596758,7,0.010309278,0.835051546,0.690721649,5828
924c870fb102041363acc00227f8dba152dc830f,0,GitHub,2021-05-18 14:14:17-04:00,['aefe0e4d8cba8585f74fb7c50761951e663bd8ef'],254,320,574,2597332,10,0.075471698,0.377358491,1,5828
3a42baa260d4e39b82843d5458b56c1c4026abf7,0,GitHub,2021-05-18 12:59:20-07:00,['924c870fb102041363acc00227f8dba152dc830f'],18,18,36,2597368,3,,,,5828
937e28db5df0232215ed5284c945963ec96196a0,0,GitHub,2021-05-18 17:09:51-04:00,['3a42baa260d4e39b82843d5458b56c1c4026abf7'],4,5,9,2597377,2,1,1,0,5828
e11f2493277360680f9b97332a0957f395be2db1,1,GitHub,2021-05-18 23:00:43-07:00,['937e28db5df0232215ed5284c945963ec96196a0'],0,2,2,2597379,1,1,1,1,5828
a8bd649dbf940a41e94ee695d3ecec5b97566c2d,0,GitHub,2021-05-19 05:26:08-07:00,['e11f2493277360680f9b97332a0957f395be2db1'],6,6,12,2597391,5,,,,5828
7beec14e5cd544882e3ca4095e6f5eb997309e58,0,GitHub,2021-05-19 09:38:41-07:00,['a8bd649dbf940a41e94ee695d3ecec5b97566c2d'],2,2,4,2597395,1,,,,5828
5b0c58ed53c420e93957369516f34346580dac95,1,GitHub,2021-05-19 10:32:56-07:00,['7beec14e5cd544882e3ca4095e6f5eb997309e58'],272,514,786,2598181,26,0.317307692,0.942307692,0.682692308,5830
bb48cf33b3d6968fac392824edc331ccd2a1b89a,0,GitHub,2021-05-19 11:03:49-07:00,['5b0c58ed53c420e93957369516f34346580dac95'],3,67,70,2598251,4,0.395348837,0.418604651,0.976744186,5830
b58da356be06517461c6c9a8b8c0d615a08d9c46,0,GitHub,2021-05-19 11:49:26-07:00,['bb48cf33b3d6968fac392824edc331ccd2a1b89a'],13,0,13,2598264,2,0,0,0,5830
476eccb968322879b1843dfa837b63ce386d192c,1,GitHub,2021-05-19 14:58:46-07:00,['b58da356be06517461c6c9a8b8c0d615a08d9c46'],78,109,187,2598451,17,0,1,1,5830
0af37730fc7b93cbed7329cc47b9d24295581e81,0,GitHub,2021-05-19 16:03:01-07:00,['476eccb968322879b1843dfa837b63ce386d192c'],128,12,140,2598591,12,0,0,0.697674419,5830
e23ede1ece67fc54d5be49493cbe1d96d78fc4f1,0,GitHub,2021-05-19 16:07:35-07:00,['0af37730fc7b93cbed7329cc47b9d24295581e81'],67,4,71,2598662,2,0.72,0,0.72,5830
7f91d2935f821c55afce520debb7bc97d60185d4,0,GitHub,2021-05-20 10:43:15+01:00,['e23ede1ece67fc54d5be49493cbe1d96d78fc4f1'],6,7,13,2598675,4,,,,5830
5d4f9f917c8dc356a2d922980ba8101e0f2e7093,0,GitHub,2021-05-20 23:06:09+08:00,['7f91d2935f821c55afce520debb7bc97d60185d4'],23,15,38,2598713,8,1,0,0,5830
b706eb4a9549f9d8448ff5a889c02e48ee07d71d,0,GitHub,2021-05-20 08:46:34-07:00,['5d4f9f917c8dc356a2d922980ba8101e0f2e7093'],306,178,484,2599197,5,0.456140351,0,0.456140351,5830
26b535226045cebba6a19174c50826a122778c52,0,GitHub,2021-05-20 14:32:51-07:00,['b706eb4a9549f9d8448ff5a889c02e48ee07d71d'],17,0,17,2599214,1,0,0,0,5830
b56d9e4416bba3bc54d2e167298c370cbbe7edbd,0,GitHub,2021-05-20 15:01:23-07:00,['26b535226045cebba6a19174c50826a122778c52'],167,232,399,2599613,25,1,1,0,5831
f50f13d781fa60b7915b687e075e523aa9ba5bfc,1,GitHub,2021-05-20 15:39:46-07:00,['b56d9e4416bba3bc54d2e167298c370cbbe7edbd'],944,960,1904,2601517,40,0,0.017857143,1,5833
80ec8fbcd560a7068cfa7baea72846f0ffd98b72,1,GitHub,2021-05-20 16:28:32-07:00,['f50f13d781fa60b7915b687e075e523aa9ba5bfc'],1,179,180,2601697,6,0.339622642,0.943396226,0.933962264,5833
c714e676856c99da8101a0b91e70687e34ffb289,0,Colin P. Mccabe,2021-05-20 16:39:52-07:00,['80ec8fbcd560a7068cfa7baea72846f0ffd98b72'],2,2,4,2601701,1,,,,5833
57c142246806e3767cec290222ed80369312fdf9,0,GitHub,2021-05-21 12:25:07+05:18,['c714e676856c99da8101a0b91e70687e34ffb289'],1,1,2,2601703,1,,,,5833
0c707b1fccd0b21a3ead765d61f376f338c69bd0,0,GitHub,2021-05-21 11:34:45+01:00,['57c142246806e3767cec290222ed80369312fdf9'],0,40,40,2601743,2,1,1,1,5833
b46e17b1d7f58f2af8e3c634b3c0ba8c97a16d80,0,GitHub,2021-05-21 12:37:35+02:00,['0c707b1fccd0b21a3ead765d61f376f338c69bd0'],173,6,179,2601922,3,0.882352941,0,0.941176471,5833
aa25176e77c7643d8c7ca5c6ded797d9fe315aee,1,GitHub,2021-05-21 17:27:42+02:00,['b46e17b1d7f58f2af8e3c634b3c0ba8c97a16d80'],2125,1994,4119,2606041,14,,,,5833
72d108274c98dca44514007254552481c731c958,1,GitHub,2021-05-21 15:58:49-04:00,['aa25176e77c7643d8c7ca5c6ded797d9fe315aee'],154,868,1022,2607063,32,0.658536585,0.474254743,0.791327913,5839
ae8b7845374b6bb01e1ae9ca27f6ab967561e011,0,GitHub,2021-05-21 15:05:39-07:00,['72d108274c98dca44514007254552481c731c958'],80,138,218,2607281,65,0.794871795,0.923076923,0.897435897,5839
47796d2f8781447c8e7de716841db438cde9cc3c,0,GitHub,2021-05-22 14:22:42-07:00,['ae8b7845374b6bb01e1ae9ca27f6ab967561e011'],5,7,12,2607293,1,1,1,1,5839
efb7cda1789b27867a69d3a0131b56123ada0bbe,0,GitHub,2021-05-23 18:33:01-07:00,['47796d2f8781447c8e7de716841db438cde9cc3c'],7,3,10,2607303,2,,,,5839
c92e62a67fc8efe51550492592039986994c81fb,1,GitHub,2021-05-24 10:39:46-07:00,['efb7cda1789b27867a69d3a0131b56123ada0bbe'],51,71,122,2607425,9,0,0.866666667,0.266666667,5839
33df5c633f68cb3726f053fe51109bbed897cbb4,1,GitHub,2021-05-24 16:14:58-07:00,['c92e62a67fc8efe51550492592039986994c81fb'],6,6,12,2607437,1,,,,5839
63b6db39b55e63c98aaf69ad79b9de21e135ac8f,0,GitHub,2021-05-25 15:12:48+02:00,['33df5c633f68cb3726f053fe51109bbed897cbb4'],0,1,1,2607438,1,,,,5839
77573d88c819753e6409e6f346e1d72172313d7a,0,GitHub,2021-05-25 23:43:33-07:00,['63b6db39b55e63c98aaf69ad79b9de21e135ac8f'],34,35,69,2607507,1,1,0,0,5839
e4f2f6f6e82cafbdea785d53521b96fe062e172d,1,GitHub,2021-05-25 23:59:30-07:00,['77573d88c819753e6409e6f346e1d72172313d7a'],11,34,45,2607552,5,0,0,1,5839
38e8391a7709b53ef895825368a87eae72e1e346,1,GitHub,2021-05-26 09:21:21+02:00,['e4f2f6f6e82cafbdea785d53521b96fe062e172d'],21,28,49,2607601,9,0.2,1,1,5839
bbe170af701609180387ad4abbfaa2712936266d,0,GitHub,2021-05-26 10:35:12-07:00,['38e8391a7709b53ef895825368a87eae72e1e346'],0,65,65,2607666,4,0.416666667,1,0.805555556,5839
47094ef7bbd248baa8deaf24cd7c6ff88e6498a6,1,GitHub,2021-05-26 13:22:32-07:00,['bbe170af701609180387ad4abbfaa2712936266d'],3,3,6,2607672,1,,,,5839
db288e4a64cf41501c445b13e778e4d225a48a14,0,GitHub,2021-05-26 17:30:34-07:00,['47094ef7bbd248baa8deaf24cd7c6ff88e6498a6'],1,1,2,2607674,1,,,,5839
56d9482462c2aa941b151015499fc59485fe7426,1,GitHub,2021-05-26 23:21:45-07:00,['db288e4a64cf41501c445b13e778e4d225a48a14'],112,180,292,2607966,12,0.363636364,1,1,5839
a02b19cb77084a573a25be1b75fc195b9a9c1f9b,0,GitHub,2021-05-27 11:30:15+02:00,['56d9482462c2aa941b151015499fc59485fe7426'],311,1,312,2608278,5,0.457627119,0,0,5839
e4b3a3cdeb295fdd4c4434ec1a7ee77b66553ae0,0,GitHub,2021-05-27 06:25:00-07:00,['a02b19cb77084a573a25be1b75fc195b9a9c1f9b'],14,14,28,2608306,6,,,,5839
3fb836f507d35e2a1ab39df57edca671ffc66073,0,GitHub,2021-05-27 08:56:00-07:00,['e4b3a3cdeb295fdd4c4434ec1a7ee77b66553ae0'],54,119,173,2608479,3,0.205128205,1,1,5839
23130262ca1d6372cc6df0fdc7e79ba668776fab,1,GitHub,2021-05-27 09:56:33-07:00,['3fb836f507d35e2a1ab39df57edca671ffc66073'],5,3,8,2608487,2,,,,5839
6659777b820f32483d1e96e26831cb87f80a8576,1,GitHub,2021-05-27 13:50:51-07:00,['23130262ca1d6372cc6df0fdc7e79ba668776fab'],30,35,65,2608552,10,0.666666667,0,1,5839
5cbe6a7b098a9e973d57581dd4cf0fc91cb33dd6,0,GitHub,2021-05-27 13:54:54-07:00,['6659777b820f32483d1e96e26831cb87f80a8576'],3,7,10,2608562,1,1,1,1,5839
a6f30945facc7b77cd90ba4c4562932c8cd53f2d,0,GitHub,2021-05-28 13:41:52+08:00,['5cbe6a7b098a9e973d57581dd4cf0fc91cb33dd6'],4,9,13,2608575,1,,,,5839
588ea443c431a4c2404d3f4025d5a2d852d702d1,0,GitHub,2021-05-28 11:52:08-07:00,['a6f30945facc7b77cd90ba4c4562932c8cd53f2d'],5,5,10,2608585,1,,,,5839
f207bac20cf19e841d3ee8dbcba03b1c30d88836,1,GitHub,2021-05-28 14:59:35-05:00,['588ea443c431a4c2404d3f4025d5a2d852d702d1'],221,514,735,2609320,70,0.12,0.342857143,0.868571429,5840
0bf4b47f582562f0727b6af367cc2654be273bd6,0,GitHub,2021-05-29 14:49:25+08:00,['f207bac20cf19e841d3ee8dbcba03b1c30d88836'],1,1,2,2609322,1,,,,5840
99a031207bca6910b6ddbf5406fc69253aafcdb9,0,GitHub,2021-05-29 16:49:34+05:18,['0bf4b47f582562f0727b6af367cc2654be273bd6'],2,2,4,2609326,1,,,,5840
6b005b2b4eece81a5500fb0080ef5354b4240681,1,GitHub,2021-05-30 12:16:36-07:00,['99a031207bca6910b6ddbf5406fc69253aafcdb9'],333,568,901,2610227,34,0.021052632,0.794736842,0.721052632,5841
6c9e27c2b51b3653f8a4009ca9712b3bf85ebacd,0,GitHub,2021-05-31 14:08:41+02:00,['6b005b2b4eece81a5500fb0080ef5354b4240681'],1,1,2,2610229,1,,,,5841
274eccf922bd05f0979a649f1b466a569f197009,0,GitHub,2021-05-31 12:06:37-07:00,['6c9e27c2b51b3653f8a4009ca9712b3bf85ebacd'],5,5,10,2610239,2,,,,5841
dc5456c0d29c0e788940d5010cb18aa430a10c37,0,GitHub,2021-06-01 12:31:09+08:00,['274eccf922bd05f0979a649f1b466a569f197009'],0,8,8,2610247,1,,,,5841
f426a72f03284e34ed39f1422d9fe0b667addd8f,0,GitHub,2021-06-01 13:03:25+08:00,['dc5456c0d29c0e788940d5010cb18aa430a10c37'],1,1,2,2610249,1,,,,5841
054d5f9e91e1d5c1c201d8ede22e053a0eabcc61,1,GitHub,2021-06-01 13:20:35+02:00,['f426a72f03284e34ed39f1422d9fe0b667addd8f'],722,721,1443,2611692,1,,,,5841
cfe642edee80977173279f4a41e23aa822b9d19f,0,GitHub,2021-06-01 14:05:08+02:00,['054d5f9e91e1d5c1c201d8ede22e053a0eabcc61'],2947,788,3735,2615427,73,0.896096096,0.203003003,0.400600601,5841
a842e0e0847aef4860c59a4445e022d185833f26,1,GitHub,2021-06-01 18:58:07+05:18,['cfe642edee80977173279f4a41e23aa822b9d19f'],1,66,67,2615494,2,0.92,1,0.92,5842
21532a745d47a6851c11f7b4d8234d6f3025f264,1,GitHub,2021-06-01 06:59:00-07:00,['a842e0e0847aef4860c59a4445e022d185833f26'],826,82,908,2616402,4,0.485239852,0.193726937,0,5842
2d7a4ed3352a927d7d2a13662b585eaef6efdf1c,1,GitHub,2021-06-01 17:58:47-07:00,['21532a745d47a6851c11f7b4d8234d6f3025f264'],293,1929,2222,2618624,29,0.609489051,0.99026764,0.930656934,5853
1a7ad70f24a1fa6b1640c2f768457324bbcda0df,0,GitHub,2021-06-02 11:10:16+02:00,['2d7a4ed3352a927d7d2a13662b585eaef6efdf1c'],6,6,12,2618636,2,,,,5853
8b71604c5dd5e33d3110de62d2976fcd74139e5a,0,GitHub,2021-06-02 05:55:01-07:00,['1a7ad70f24a1fa6b1640c2f768457324bbcda0df'],1,6,7,2618643,2,,,,5853
4c1efd3d08bd9b57b6d8aa9b99fa3fdbc8fedc59,1,GitHub,2021-06-02 05:57:04-07:00,['8b71604c5dd5e33d3110de62d2976fcd74139e5a'],0,1,1,2618644,1,,,,5853
13ba9c9305343d5b11bf26d72d1688cda1d5fd60,0,GitHub,2021-06-02 19:30:28+01:00,['4c1efd3d08bd9b57b6d8aa9b99fa3fdbc8fedc59'],1,1,2,2618646,1,1,1,,5853
364bd36771394bb342b13425b56f2b7a28324498,0,GitHub,2021-06-02 11:31:05-07:00,['13ba9c9305343d5b11bf26d72d1688cda1d5fd60'],37,3,40,2618686,3,,,,5853
6db51e466301408e59a055dbadf614612e492fb2,1,GitHub,2021-06-02 15:01:11-07:00,['364bd36771394bb342b13425b56f2b7a28324498'],335,459,794,2619480,3,1,0,0,5853
ccec9b0c0dbcc63e733eacd310d3e3ebc4b87a44,0,GitHub,2021-06-02 16:10:59-07:00,['6db51e466301408e59a055dbadf614612e492fb2'],0,0,0,2619480,3,,,,5853
c2c08b41f2bfd5fd3c2bb14417c27c6b7de92710,1,GitHub,2021-06-02 21:13:09-07:00,['ccec9b0c0dbcc63e733eacd310d3e3ebc4b87a44'],181,199,380,2619860,1,0,1,1,5853
93dca8ebd973f7a49280aa216137f685c00030e3,0,GitHub,2021-06-03 20:00:19+02:00,['c2c08b41f2bfd5fd3c2bb14417c27c6b7de92710'],37,111,148,2620008,5,0,0.790322581,1,5853
e97cff2702b6ba836c7925caa36ab18066a7c95d,1,GitHub,2021-06-03 16:23:32-07:00,['93dca8ebd973f7a49280aa216137f685c00030e3'],28,398,426,2620434,18,0.465608466,0.941798942,0.91005291,5856
0358c21ae4d78c2f035f5d0fb1ed087611ec2ba5,0,GitHub,2021-06-03 18:51:03-07:00,['e97cff2702b6ba836c7925caa36ab18066a7c95d'],31,21,52,2620486,1,0.4,0,0.6,5856
ccde334ca9314e28b16b931293db0eb7822fde4f,0,GitHub,2021-06-03 23:31:29-07:00,['0358c21ae4d78c2f035f5d0fb1ed087611ec2ba5'],492,59,551,2621037,4,0.518272425,0.106312292,0.352159468,5856
b2d463aa12feee5b3207d1afea5e6b0b6fb9656f,1,GitHub,2021-06-04 08:30:14-07:00,['ccde334ca9314e28b16b931293db0eb7822fde4f'],35,33,68,2621105,2,1,1,0,5856
5ef90226f8936e06bfc06665ac81cdb2a7f386c4,1,GitHub,2021-06-04 09:40:36-07:00,['b2d463aa12feee5b3207d1afea5e6b0b6fb9656f'],4,5,9,2621114,1,0,1,1,5856
37a86598269330fb3180b8742dc19ee072391dd9,1,GitHub,2021-06-05 17:32:48+05:18,['5ef90226f8936e06bfc06665ac81cdb2a7f386c4'],65,26,91,2621205,2,0,0,0,5856
1ba217dbe0def58ba03456b37e82cc4093ea1aa8,0,GitHub,2021-06-07 08:34:21+02:00,['37a86598269330fb3180b8742dc19ee072391dd9'],4,4,8,2621213,1,,,,5856
c72ce005e70a965dee25d341e5be8fceb1477b37,0,GitHub,2021-06-07 14:19:48+01:00,['1ba217dbe0def58ba03456b37e82cc4093ea1aa8'],70,229,299,2621512,7,0,0.971631206,0.865248227,5856
51665b9f39f0df2f474de21ccc31af0b3b1811ae,1,GitHub,2021-06-07 10:52:16-07:00,['c72ce005e70a965dee25d341e5be8fceb1477b37'],283,213,496,2622008,8,0,1,1,5856
43db8ac86ac3e609d9e2a993444b8f1b22f7693b,1,GitHub,2021-06-07 14:13:06-07:00,['51665b9f39f0df2f474de21ccc31af0b3b1811ae'],13,94,107,2622115,2,1,1,1,5856
48379bd6e5075fc73449e235f1b527114f5a430c,1,GitHub,2021-06-07 15:38:12-07:00,['43db8ac86ac3e609d9e2a993444b8f1b22f7693b'],159,615,774,2622889,22,0.440329218,0.600823045,0.95473251,5857
b5f7ce8b7b62b76951f9c5d6732b69e600b7ab15,0,GitHub,2021-06-07 22:04:33-07:00,['48379bd6e5075fc73449e235f1b527114f5a430c'],5,16,21,2622910,3,,,,5857
1dadb6db0c6848a8a1d2eee1497f9b79b6e04e0e,0,GitHub,2021-06-08 06:39:31-07:00,['b5f7ce8b7b62b76951f9c5d6732b69e600b7ab15'],6,43,49,2622959,4,0,1,1,5857
a9fe2bd935fe9a9e73fd70551f1d88aae009b173,0,GitHub,2021-06-09 14:22:18-07:00,['1dadb6db0c6848a8a1d2eee1497f9b79b6e04e0e'],16,0,16,2622975,1,,,,5857
a75b5c635b3551d23da3fa66268b27c4801aef6e,1,GitHub,2021-06-09 15:09:31-07:00,['a9fe2bd935fe9a9e73fd70551f1d88aae009b173'],8,19,27,2623002,10,0,1,0.714285714,5857
953ec9810099d6e5f41541de46c0ceebf4372790,1,GitHub,2021-06-09 22:51:36-07:00,['a75b5c635b3551d23da3fa66268b27c4801aef6e'],233,385,618,2623620,28,1,1,0,5857
98e2f252dde664542a63a3b7b0f49c2fb0b2305b,0,GitHub,2021-06-10 10:36:53+01:00,['953ec9810099d6e5f41541de46c0ceebf4372790'],6,6,12,2623632,1,,,,5857
8b6752d1839823b211b25c16bb1c0dc9abb13e17,0,GitHub,2021-06-10 12:18:19+02:00,['98e2f252dde664542a63a3b7b0f49c2fb0b2305b'],28,13,41,2623673,2,0.166666667,0,0,5857
398800a4f3291f6e3388acc4d86ebc8e7df0dd91,0,GitHub,2021-06-10 22:02:17+08:00,['8b6752d1839823b211b25c16bb1c0dc9abb13e17'],3,0,3,2623676,1,0,0,1,5857
d4961038649b4f498b0fdd667ef4ad2a27f09605,1,GitHub,2021-06-10 16:51:31+02:00,['398800a4f3291f6e3388acc4d86ebc8e7df0dd91'],59,33,92,2623768,19,0,0,0.466666667,5857
8a50a5204d2cf49a07f0fa7b3741d7ad35c425b5,0,GitHub,2021-06-10 17:17:42+01:00,['d4961038649b4f498b0fdd667ef4ad2a27f09605'],0,1,1,2623769,1,1,1,1,5857
2bd6d2735d31ab8f29e53d4fabc9d65fcdc9ef96,0,GitHub,2021-06-10 17:42:02+01:00,['8a50a5204d2cf49a07f0fa7b3741d7ad35c425b5'],19,25,44,2623813,1,,,,5857
7cd09b6a14f51aeef9e701fe24adf9f4f07170b0,0,GitHub,2021-06-10 14:59:57-05:00,['2bd6d2735d31ab8f29e53d4fabc9d65fcdc9ef96'],9,347,356,2624169,4,0.072164948,0,1,5858
69d507590efc0588a61214c35e0bb552744aae05,0,GitHub,2021-06-10 15:21:46-05:00,['7cd09b6a14f51aeef9e701fe24adf9f4f07170b0'],361,206,567,2624736,7,1,0,0.106382979,5858
8eecb91419fd9f40f5da6d83a93d180e7798781c,0,GitHub,2021-06-10 13:57:25-07:00,['69d507590efc0588a61214c35e0bb552744aae05'],2,1,3,2624739,1,0,0,0,5858
5936a249bda171851cfa669da4276d23230eab6e,1,GitHub,2021-06-10 17:34:15-07:00,['8eecb91419fd9f40f5da6d83a93d180e7798781c'],269,417,686,2625425,14,1,1,1,5861
6de37e536ac76ef13530d49dc7320110332cd1ee,0,GitHub,2021-06-11 18:03:23+05:18,['5936a249bda171851cfa669da4276d23230eab6e'],1,2,3,2625428,1,,,,5861
787b4fe9550389a2ca6d1131b32aff6e4f8610d1,0,GitHub,2021-06-13 19:00:14+08:00,['6de37e536ac76ef13530d49dc7320110332cd1ee'],58,2,60,2625488,33,1,0.5,0,5861
530224e4fe853df734e7bf7c15661fe6b1ab34fe,0,GitHub,2021-06-13 08:14:37-07:00,['787b4fe9550389a2ca6d1131b32aff6e4f8610d1'],21,57,78,2625566,3,1,0,0,5861
39b9df50909ecd92c4e1427e476ca5996e46df9a,0,GitHub,2021-06-13 09:14:24-07:00,['530224e4fe853df734e7bf7c15661fe6b1ab34fe'],1,1,2,2625568,1,,,,5861
4724083a321a034ce03f708507dd81b668c0a344,0,GitHub,2021-06-13 09:49:05-07:00,['39b9df50909ecd92c4e1427e476ca5996e46df9a'],3,11,14,2625582,2,0,0,1,5861
987391958dd201c5f033a88a83300a0a0db47834,0,GitHub,2021-06-13 21:35:02-05:00,['4724083a321a034ce03f708507dd81b668c0a344'],1,2,3,2625585,2,1,1,1,5861
3944f9664783e0cfbf5a00d49ac91192404df35b,0,GitHub,2021-06-15 08:11:19+02:00,['987391958dd201c5f033a88a83300a0a0db47834'],6,15,21,2625606,3,0,0,1,5861
01967e48a279e83f836dca557b9e503b73c17106,0,GitHub,2021-06-15 00:59:55-07:00,['3944f9664783e0cfbf5a00d49ac91192404df35b'],16,27,43,2625649,4,0,0,1,5861
1e88c758dea8c1f1cd5f5724e98a6af93637644c,0,GitHub,2021-06-15 09:18:30+01:00,['01967e48a279e83f836dca557b9e503b73c17106'],0,34,34,2625683,2,0.038461538,1,1,5861
c16711cb8e0d1c03f123e3e9d7e3d810796bf315,0,GitHub,2021-06-15 06:09:46-07:00,['1e88c758dea8c1f1cd5f5724e98a6af93637644c'],4,94,98,2625781,5,0,0.597014925,1,5861
4b7ad7b14d04e1e362b8100f43375d1630ded1b4,1,GitHub,2021-06-15 10:22:48-07:00,['c16711cb8e0d1c03f123e3e9d7e3d810796bf315'],124,159,283,2626064,11,0,1,0.909090909,5861
b67a77d5b9ed497b5b3cf0dde95a4f3ef7f0b74f,1,GitHub,2021-06-15 10:32:01-07:00,['4b7ad7b14d04e1e362b8100f43375d1630ded1b4'],740,975,1715,2627779,34,0.218562874,0.931137725,0.964071856,5861
7c7cecded68213619ff988e9745ba9e97c0e3e31,0,GitHub,2021-06-15 13:56:22-07:00,['b67a77d5b9ed497b5b3cf0dde95a4f3ef7f0b74f'],27,90,117,2627896,4,0,1,1,5862
135de5801ecaa1812e1677588025bb42878e0611,1,GitHub,2021-06-15 16:04:30-07:00,['7c7cecded68213619ff988e9745ba9e97c0e3e31'],0,42,42,2627938,33,0,0.666666667,0.666666667,5862
f0bb85cee3b127cfb13cd8fea85ac61936f2d39f,1,GitHub,2021-06-15 16:39:18-07:00,['135de5801ecaa1812e1677588025bb42878e0611'],185,232,417,2628355,28,1,0.862068966,0,5864
96767a60db4117f257e911871d139572b84be65d,0,GitHub,2021-06-16 09:25:16-07:00,['f0bb85cee3b127cfb13cd8fea85ac61936f2d39f'],621,1131,1752,2630107,12,0.109865471,0.6367713,0.85426009,5865
fc5245d8c37a6c9d585c5792940a8f9501bedbe1,0,GitHub,2021-06-16 15:02:50-07:00,['96767a60db4117f257e911871d139572b84be65d'],43,53,96,2630203,4,0,1,1,5865
1a16fc139a91e8344915173da4b6d5a90e3965a3,0,GitHub,2021-06-16 22:24:11-07:00,['fc5245d8c37a6c9d585c5792940a8f9501bedbe1'],23,39,62,2630265,3,0,0,1,5865
d294b946ca78c9b8caf16547cf2fa6ed348a3033,0,GitHub,2021-06-17 13:46:16+02:00,['1a16fc139a91e8344915173da4b6d5a90e3965a3'],51,520,571,2630836,9,0.409252669,0.982206406,0.914590747,5867
580c1112582ed6ddaca6c0402a1bb014c36235e5,0,GitHub,2021-06-17 20:07:12+08:00,['d294b946ca78c9b8caf16547cf2fa6ed348a3033'],43,227,270,2631106,4,0.989795918,1,0.693877551,5868
d27a84f70c3f65de49da161213233291505c09db,1,GitHub,2021-06-17 05:32:34-07:00,['580c1112582ed6ddaca6c0402a1bb014c36235e5'],200,100,300,2631406,10,0.711864407,0,0,5868
4d43af4a572685104c34614611a883e934f806bb,0,GitHub,2021-06-17 10:30:44-07:00,['d27a84f70c3f65de49da161213233291505c09db'],6,5,11,2631417,1,0,0,0,5868
f5a94d913f35c70175d4724596df5fc2479a57af,1,GitHub,2021-06-17 15:58:40-04:00,['4d43af4a572685104c34614611a883e934f806bb'],158,159,317,2631734,5,,,,5868
31bb4c368dd8723ac90a89c5b255506fba43c633,1,GitHub,2021-06-17 14:49:21-07:00,['f5a94d913f35c70175d4724596df5fc2479a57af'],29,162,191,2631925,4,0.56097561,0.987804878,0.56097561,5869
6c260a5e1d34a8f4ccadb77bc78d124b11641a60,0,GitHub,2021-06-17 23:33:02-07:00,['31bb4c368dd8723ac90a89c5b255506fba43c633'],3,3,6,2631931,1,,,,5869
195a8b0ed153a711d88e51b9dff66d27cc451776,1,GitHub,2021-06-18 09:25:03+02:00,['6c260a5e1d34a8f4ccadb77bc78d124b11641a60'],30,158,188,2632119,6,0.063063063,0.801801802,0.981981982,5869
ebef7d0c216ab6b86b5743bb29538dfa27224be4,0,GitHub,2021-06-18 15:50:21+08:00,['195a8b0ed153a711d88e51b9dff66d27cc451776'],10,22,32,2632151,1,1,1,1,5869
be5889d1d110abfd2f580d88b109a9a0c8e7b2d6,0,GitHub,2021-06-18 09:53:23-05:00,['ebef7d0c216ab6b86b5743bb29538dfa27224be4'],1,2,3,2632154,1,,,,5869
56250f446af6667bb034b7e20c235b2b59cd651b,0,GitHub,2021-06-18 09:38:42-07:00,['be5889d1d110abfd2f580d88b109a9a0c8e7b2d6'],11,686,697,2632851,8,0.375464684,0.836431227,0.82527881,5871
4ddf1a5f94f7e74a0429ce23043b8d8a4961effa,0,GitHub,2021-06-18 13:20:43-07:00,['56250f446af6667bb034b7e20c235b2b59cd651b'],19,62,81,2632932,7,0.911764706,1,0.323529412,5871
299eea88a5068f973dc055776c7137538ed01c62,1,GitHub,2021-06-18 15:50:49-07:00,['4ddf1a5f94f7e74a0429ce23043b8d8a4961effa'],34,259,293,2633225,7,0.258503401,0.979591837,0.761904762,5872
c333bfd41766bf33f41b5d32d8959ebbeff240b4,1,GitHub,2021-06-18 17:08:54-07:00,['299eea88a5068f973dc055776c7137538ed01c62'],20,118,138,2633363,11,1,1,1,5872
01c234565825f318b283370b55a8366816f6838f,0,GitHub,2021-06-19 23:54:02+08:00,['c333bfd41766bf33f41b5d32d8959ebbeff240b4'],1,2,3,2633366,1,,,,5872
d3709dafbe4d77e0635d3a39bbb9a4f14be159bf,0,GitHub,2021-06-19 23:58:57+08:00,['01c234565825f318b283370b55a8366816f6838f'],5,5,10,2633376,2,,,,5872
ac5ddc574ef23279267a8f9bda737a840be30c85,0,GitHub,2021-06-19 15:33:52-07:00,['d3709dafbe4d77e0635d3a39bbb9a4f14be159bf'],1,50,51,2633427,2,0,0.966666667,0.966666667,5872
f914ed73e9de028d2e6bb1353cec02bcc2275c19,0,GitHub,2021-06-21 11:19:05-07:00,['ac5ddc574ef23279267a8f9bda737a840be30c85'],2,2,4,2633431,1,,,,5872
b38cadca230e85bc0748f975e6a8e8c2739c747e,0,GitHub,2021-06-22 13:17:39+02:00,['f914ed73e9de028d2e6bb1353cec02bcc2275c19'],78,0,78,2633509,4,0.568965517,0.017241379,0.017241379,5872
2ad9350cc1052b39d8ae526d1df5a59744f74f2f,0,GitHub,2021-06-22 14:10:28+02:00,['b38cadca230e85bc0748f975e6a8e8c2739c747e'],68,6,74,2633583,5,0.897959184,0,0.285714286,5872
6cdde726a33d6f98c03ed415e86f0e95c850502e,0,GitHub,2021-06-22 09:11:05-05:00,['2ad9350cc1052b39d8ae526d1df5a59744f74f2f'],4,3,7,2633590,1,,,,5872
c8684d883b4c7db13272e8e28f55e2a02bf8cab7,0,GitHub,2021-06-22 09:12:11-05:00,['6cdde726a33d6f98c03ed415e86f0e95c850502e'],4,22,26,2633616,2,0.818181818,1,1,5872
b285662bda38e598805eb4361895c9f838688db8,0,GitHub,2021-06-22 09:15:13-05:00,['c8684d883b4c7db13272e8e28f55e2a02bf8cab7'],1,1,2,2633618,1,,,,5872
c3475081c5e8228e9bd3a45022a93d61e542f72e,1,GitHub,2021-06-22 09:17:11-05:00,['b285662bda38e598805eb4361895c9f838688db8'],395,696,1091,2634709,126,0.358974359,0.948717949,0.358974359,5872
fce771579c3e20f20949c4c7e0a5e3a16c57c7f0,0,GitHub,2021-06-22 09:47:30-07:00,['c3475081c5e8228e9bd3a45022a93d61e542f72e'],0,1201,1201,2635910,5,0.330677291,0.949535193,0.622841965,5877
d03f7c84f914130a58810e5e490374029d08b2b5,0,GitHub,2021-06-22 12:15:32-07:00,['fce771579c3e20f20949c4c7e0a5e3a16c57c7f0'],0,2,2,2635912,1,0,0,1,5877
7da881ffbe0249b7ea98f1668303fc6f1ae4f803,0,GitHub,2021-06-22 16:35:30-07:00,['d03f7c84f914130a58810e5e490374029d08b2b5'],16,53,69,2635981,2,0.692307692,0.192307692,0.884615385,5877
5652ef1af04a919f6483294315572c7153ac6301,0,GitHub,2021-06-23 09:20:04-05:00,['7da881ffbe0249b7ea98f1668303fc6f1ae4f803'],97,93,190,2636171,7,0,1,1,5877
386670227b2e5ef7633c74033e2b99222b35d7cc,0,GitHub,2021-06-24 09:56:27+02:00,['5652ef1af04a919f6483294315572c7153ac6301'],14,48,62,2636233,2,0.208333333,1,1,5877
574af88305273f21456a9b10f21c182181cfc600,0,GitHub,2021-06-24 17:40:40+02:00,['386670227b2e5ef7633c74033e2b99222b35d7cc'],19,29,48,2636281,2,0,0,1,5877
b0cfd1f4ca83e1bc3a324e5d4081b2731c420733,0,GitHub,2021-06-24 12:07:22-04:00,['574af88305273f21456a9b10f21c182181cfc600'],1,21,22,2636303,2,1,1,1,5877
2beaf9a720330615bc5474ec079f8b4b105eff91,1,GitHub,2021-06-24 10:54:32-07:00,['b0cfd1f4ca83e1bc3a324e5d4081b2731c420733'],25,171,196,2636499,7,0.461538462,0.987179487,1,5878
bd72ef1bf1e40feb3bc17349a385b479fa5fa530,1,GitHub,2021-06-25 14:29:12+02:00,['2beaf9a720330615bc5474ec079f8b4b105eff91'],47,441,488,2636987,21,0.389705882,0.860294118,0.875,5879
6655a09e99125aff34cb96188924fca1df3387ad,1,GitHub,2021-06-25 18:31:49+02:00,['bd72ef1bf1e40feb3bc17349a385b479fa5fa530'],190,1473,1663,2638650,38,0.867674858,0.937618147,0.939508507,5887
bd668e90c6992e7a1f23274aab37d186d6a4b560,0,GitHub,2021-06-25 16:40:42-07:00,['6655a09e99125aff34cb96188924fca1df3387ad'],52,164,216,2638866,20,0.959183673,1,0.551020408,5889
12aa595e17c495a1650d8da349c8ef69f787ebe8,0,GitHub,2021-06-27 14:15:19-07:00,['bd668e90c6992e7a1f23274aab37d186d6a4b560'],18,0,18,2638884,1,0,0,0,5889
bc6873a61bf0f718a4a614fe4b442438763bf4b6,0,GitHub,2021-06-27 20:32:06-07:00,['12aa595e17c495a1650d8da349c8ef69f787ebe8'],1,1,2,2638886,1,,,,5889
bd1ee02b87ea508c1372af2d3982a8919e375b2d,0,GitHub,2021-06-28 10:36:16+02:00,['bc6873a61bf0f718a4a614fe4b442438763bf4b6'],0,7,7,2638893,1,0,1,1,5889
c96dc3aef7479a448cdb563ff3a735a988f5bad7,0,GitHub,2021-06-28 16:09:59+05:18,['bd1ee02b87ea508c1372af2d3982a8919e375b2d'],15,12,27,2638920,1,1,0,0,5889
397fa1f894c176d71601183c36e5d498fc83fd1e,0,GitHub,2021-06-28 10:15:50-07:00,['c96dc3aef7479a448cdb563ff3a735a988f5bad7'],5,2,7,2638927,2,1,1,0,5889
670630ae5b81d8d1cd32defe8824640dd865a538,0,GitHub,2021-06-28 14:10:25-07:00,['397fa1f894c176d71601183c36e5d498fc83fd1e'],121,164,285,2639212,3,0.558823529,1,1,5889
2540b777695b2e90d353e81e970012f9a9aecc44,0,GitHub,2021-06-28 15:32:16-07:00,['670630ae5b81d8d1cd32defe8824640dd865a538'],0,21,21,2639233,1,1,1,1,5889
cfcabc368c3f0a123c4561059b043648d79b1df8,0,GitHub,2021-06-28 15:39:49-07:00,['2540b777695b2e90d353e81e970012f9a9aecc44'],12,12,24,2639257,3,,,,5889
f86cb1d1da4f73bf92b0fcfd5ef75b3ce77658cf,1,GitHub,2021-06-28 18:00:19-07:00,['cfcabc368c3f0a123c4561059b043648d79b1df8'],32,252,284,2639541,6,0.33974359,0.762820513,1,5889
d95c1919458bd5621774394c9eb61698ce2187b8,0,GitHub,2021-06-29 09:00:56+02:00,['f86cb1d1da4f73bf92b0fcfd5ef75b3ce77658cf'],7,86,93,2639634,2,0.086956522,1,1,5889
dc6805df732532ff4fbc0b2aa92c09cc19604c93,0,GitHub,2021-06-29 13:00:35+02:00,['d95c1919458bd5621774394c9eb61698ce2187b8'],4,27,31,2639665,4,0,1,1,5889
c6d2778a8d1383e76695ec82710208153e83b2c2,0,GitHub,2021-06-29 08:49:36-07:00,['dc6805df732532ff4fbc0b2aa92c09cc19604c93'],0,11,11,2639676,2,0,0.428571429,0.428571429,5889
0b6d6b178563f1890cc86458c677af4fb9179467,0,GitHub,2021-06-29 09:17:13-07:00,['c6d2778a8d1383e76695ec82710208153e83b2c2'],92,97,189,2639865,2,0,0,1,5889
d3ec9f940cc4402270cba3ad159ec64a9676a385,0,GitHub,2021-06-29 09:37:20-07:00,['0b6d6b178563f1890cc86458c677af4fb9179467'],92,546,638,2640503,21,0.578358209,0.940298507,0.597014925,5891
3c4be0b57a50f46e360830f9cf954919e6deec45,0,GitHub,2021-06-29 21:33:59+01:00,['d3ec9f940cc4402270cba3ad159ec64a9676a385'],5,184,189,2640692,6,0.795275591,1,1,5891
d9b898b678158626bd2872bbfef883ca60a41c43,1,GitHub,2021-06-29 15:59:20-07:00,['3c4be0b57a50f46e360830f9cf954919e6deec45'],139,146,285,2640977,18,1,1,1,5891
9f71db96fdc618e89435726e0b0e3434bb617cd4,0,GitHub,2021-06-29 16:03:02-07:00,['d9b898b678158626bd2872bbfef883ca60a41c43'],384,408,792,2641769,2,,,,5892
19edbda1647a2f862b4ffbf8f79698e0b6aec1aa,0,GitHub,2021-06-30 09:55:27+02:00,['9f71db96fdc618e89435726e0b0e3434bb617cd4'],2,3,5,2641774,1,,,,5892
b1562a90e013be43bdc14de33d0cceea04230819,0,GitHub,2021-06-30 01:25:08-07:00,['19edbda1647a2f862b4ffbf8f79698e0b6aec1aa'],15,14,29,2641803,2,0,0,0,5892
4f5b4c868e72cc9d9a4f859c5bfe8364e9af9fff,0,GitHub,2021-06-30 11:21:33-07:00,['b1562a90e013be43bdc14de33d0cceea04230819'],8,37,45,2641848,7,0,1,0,5892
a10e4e8547478024794e1ec78bc491181c85d61b,0,GitHub,2021-06-30 14:58:01-07:00,['4f5b4c868e72cc9d9a4f859c5bfe8364e9af9fff'],26,18,44,2641892,9,0.166666667,0,0.166666667,5892
b3905d9f71d48a60f2a9ee38014582d7ec7bc3c2,0,GitHub,2021-06-30 17:09:19-07:00,['a10e4e8547478024794e1ec78bc491181c85d61b'],79,404,483,2642375,49,0.189873418,1,0.886075949,5892
1b7ab8eb9fefc238c48c94130dda38563143c74b,1,GitHub,2021-06-30 18:13:53-07:00,['b3905d9f71d48a60f2a9ee38014582d7ec7bc3c2'],96,547,643,2643018,17,0.446254072,0.951140065,1,5893
527ba111c73aa32deaef102fc953f3d20a8670d7,1,GitHub,2021-06-30 21:13:07-07:00,['1b7ab8eb9fefc238c48c94130dda38563143c74b'],41,2579,2620,2645638,36,0.336118252,0.901028278,0.847686375,5899
cee2e975d124da0a2bdc0065a3172ce31e036fa0,0,GitHub,2021-06-30 23:20:21-07:00,['527ba111c73aa32deaef102fc953f3d20a8670d7'],105,351,456,2646094,13,0.978021978,0.989010989,1,5902
593b34a5bed4e1989d966f08d0fb1b318abb5007,0,GitHub,2021-07-01 08:35:55+02:00,['cee2e975d124da0a2bdc0065a3172ce31e036fa0'],24,83,107,2646201,4,0.086956522,0.869565217,1,5902
b4e45cd0d245eb66a9f3d2d69523a507bd820dff,1,GitHub,2021-07-01 00:08:25-07:00,['593b34a5bed4e1989d966f08d0fb1b318abb5007'],28,3064,3092,2649293,33,0.676197284,0.75196569,0.959256612,5927
93f57370c68fe1e74320ec50cd26d44f84d63777,1,GitHub,2021-07-01 09:21:27+01:00,['b4e45cd0d245eb66a9f3d2d69523a507bd820dff'],35,501,536,2649829,11,0.33877551,1,1,5929
c92d013fd4bdcf98f9d0c65e57ff161966046944,0,GitHub,2021-07-01 07:06:27-07:00,['93f57370c68fe1e74320ec50cd26d44f84d63777'],2,2,4,2649833,1,,,,5929
f5d5f654db359af077088685e29fbe5ea69616cf,1,GitHub,2021-07-01 22:05:03+01:00,['c92d013fd4bdcf98f9d0c65e57ff161966046944'],1058,2873,3931,2653764,54,0.754844961,0.948643411,0.510658915,5941
8cd04cb1a0e7e592d765a8b77dea85011a6e6f12,0,GitHub,2021-07-01 14:16:35-07:00,['f5d5f654db359af077088685e29fbe5ea69616cf'],11,12,23,2653787,6,0,0,0,5941
789fc26042b3863d1ff74619a59b8e66dccba63e,0,GitHub,2021-07-01 14:23:58-07:00,['8cd04cb1a0e7e592d765a8b77dea85011a6e6f12'],12,222,234,2654021,4,0.420634921,0.46031746,0.96031746,5941
4fd71a7ef1c79ec3f110ee2f9d38fa7d5194937e,0,GitHub,2021-07-01 14:58:29-07:00,['789fc26042b3863d1ff74619a59b8e66dccba63e'],159,292,451,2654472,39,0.59375,1,1,5942
a095e1fd8ca38099605a21c9c8498ceb37cd07cd,1,GitHub,2021-07-01 15:46:22-07:00,['4fd71a7ef1c79ec3f110ee2f9d38fa7d5194937e'],32,94,126,2654598,5,0.078947368,0.052631579,0.710526316,5942
9f01909dc38624a4893b9292af35411dd04f0076,1,GitHub,2021-07-01 16:38:59-07:00,['a095e1fd8ca38099605a21c9c8498ceb37cd07cd'],63,209,272,2654870,15,0.366336634,0.910891089,0.079207921,5942
51796bcdef2e93ee4176415961ab98dd7407ebec,0,Gwen Shapira,2021-07-01 18:56:35-07:00,['9f01909dc38624a4893b9292af35411dd04f0076'],15,28,43,2654913,2,0,0,1,5942
cad2f5e1208230f52e77f14759bdaba2d6da9781,0,GitHub,2021-07-01 21:02:24-05:00,['51796bcdef2e93ee4176415961ab98dd7407ebec'],184,73,257,2655170,19,1,0.385714286,0.371428571,5942
08757d0d19f95ad6a911cb164ca4b146a23ef3f4,0,GitHub,2021-07-02 20:02:20+02:00,['cad2f5e1208230f52e77f14759bdaba2d6da9781'],21,28,49,2655219,3,0.833333333,1,1,5942
6d2f563865de2a9921417ffc3f769ab65598664b,0,GitHub,2021-07-04 15:17:31+01:00,['08757d0d19f95ad6a911cb164ca4b146a23ef3f4'],4,9,13,2655232,3,0,,,5942
fa685fa1529f8a180fefa89d22f95729a856db4b,0,GitHub,2021-07-04 07:48:25-07:00,['6d2f563865de2a9921417ffc3f769ab65598664b'],1,1,2,2655234,1,,,,5942
10b1f73cd42faaaabe3154694aae62a01d5de20d,0,GitHub,2021-07-04 08:32:12-07:00,['fa685fa1529f8a180fefa89d22f95729a856db4b'],0,27,27,2655261,2,0.9375,1,1,5942
855011f92a20c07ae5ee5a93f29f11a356e30ba3,0,GitHub,2021-07-04 10:55:16-07:00,['10b1f73cd42faaaabe3154694aae62a01d5de20d'],26,6,32,2655293,6,,,,5942
c85d67796f6fae028f1976b889155a124617a364,0,GitHub,2021-07-05 09:25:17+02:00,['855011f92a20c07ae5ee5a93f29f11a356e30ba3'],2,2,4,2655297,1,,,,5942
16d224d35b59c500527c66ed0c23203073be120d,0,GitHub,2021-07-05 09:26:59+02:00,['c85d67796f6fae028f1976b889155a124617a364'],54,0,54,2655351,1,0,0,0,5942
2b6365c78b6e659f8df0651a24013d028f39edd9,0,GitHub,2021-07-05 14:26:03+01:00,['16d224d35b59c500527c66ed0c23203073be120d'],107,150,257,2655608,7,0.5,1,1,5942
19e8fd513a15b595f940370be07215863ad1ff7b,0,GitHub,2021-07-05 17:33:33+01:00,['2b6365c78b6e659f8df0651a24013d028f39edd9'],265,766,1031,2656639,5,0.782234957,0.830945559,0.87965616,5943
943967773dd9de9c77e8203d7bde701407400f85,0,GitHub,2021-07-05 17:21:40-07:00,['19e8fd513a15b595f940370be07215863ad1ff7b'],11,8,19,2656658,1,,,,5943
fb6425188cde8bc79c7d54ab4f28263c631bec10,0,GitHub,2021-07-06 19:28:09+02:00,['943967773dd9de9c77e8203d7bde701407400f85'],24,22,46,2656704,2,0.333333333,0,0.333333333,5943
f29c43bdbb85fd7c97ad2f567dcd67f2f2ece8ef,1,GitHub,2021-07-06 10:39:59-07:00,['fb6425188cde8bc79c7d54ab4f28263c631bec10'],14,1050,1064,2657768,3,0.14987715,0.942260442,0.696560197,5943
2e89f4057598a76b56262a0f75e7a42a07b1164c,0,GitHub,2021-07-06 13:31:40-05:00,['f29c43bdbb85fd7c97ad2f567dcd67f2f2ece8ef'],1,6,7,2657775,1,,,,5943
284ec262c6c84063d90271c965e4cbc1eda111fe,1,Colin P. Mccabe,2021-07-06 14:19:44-07:00,['2e89f4057598a76b56262a0f75e7a42a07b1164c'],185,470,655,2658430,10,0.595375723,0.878612717,0.89017341,5943
d2a05d71c0fb537fe7a35ed939f85d2e16663502,0,GitHub,2021-07-06 14:28:13-07:00,['284ec262c6c84063d90271c965e4cbc1eda111fe'],10,14,24,2658454,8,,,,5943
7bd55f51567d08d35922cf5c23a4b424e58fff9a,1,GitHub,2021-07-06 16:36:01-07:00,['d2a05d71c0fb537fe7a35ed939f85d2e16663502'],4202,1454,5656,2664110,46,0.65562249,0.247991968,0.181726908,5946
b32e548156f10876b2d28065fa8b4e17928d2942,0,GitHub,2021-07-06 21:41:00-07:00,['7bd55f51567d08d35922cf5c23a4b424e58fff9a'],17,79,96,2664206,4,0,0.285714286,0.628571429,5946
ec0d12cd6ad4370c949c20c35eeca3224d061283,0,GitHub,2021-07-07 08:44:25+02:00,['b32e548156f10876b2d28065fa8b4e17928d2942'],1,1,2,2664208,1,,,,5946
c671e44b0bebc4cf4eb04392a673d3dad9cf5f23,0,GitHub,2021-07-07 08:58:56+02:00,['ec0d12cd6ad4370c949c20c35eeca3224d061283'],3,159,162,2664370,3,0.321428571,1,0.892857143,5947
e00c0f3719ad0803620752159ef8315d668735d6,1,GitHub,2021-07-07 11:55:00+01:00,['c671e44b0bebc4cf4eb04392a673d3dad9cf5f23'],260,1701,1961,2666331,15,0.105663567,0.681318681,0.901098901,5948
862f814cc3a55e20a01e2d0da719b1610a634f42,1,GitHub,2021-07-07 17:24:31+01:00,['e00c0f3719ad0803620752159ef8315d668735d6'],78,110,188,2666519,22,1,1,0.8,5948
61b65395175834bf5a41e05f9b834a0e100c44b7,0,GitHub,2021-07-07 14:51:13-04:00,['862f814cc3a55e20a01e2d0da719b1610a634f42'],1,2,3,2666522,1,,,,5948
03890ff1d1beabcd773bf96de4f8e9462fd82a5a,1,GitHub,2021-07-07 15:39:43-07:00,['61b65395175834bf5a41e05f9b834a0e100c44b7'],27,28,55,2666577,7,,,,5948
2b8aff58b575c199ee8372e5689420c9d77357a5,1,GitHub,2021-07-07 16:02:37-07:00,['03890ff1d1beabcd773bf96de4f8e9462fd82a5a'],882,3214,4096,2670673,59,0.152247191,0.842134831,0.779213483,5950
058589b03db686803b33052d574ce887fb5cfbd1,1,GitHub,2021-07-08 20:23:14+05:18,['2b8aff58b575c199ee8372e5689420c9d77357a5'],12,85,97,2670770,5,,,,5950
5a88a59ddd7f3ef2d7222a88b8baf9ad0eca7018,0,GitHub,2021-07-08 09:58:46-07:00,['058589b03db686803b33052d574ce887fb5cfbd1'],4,13,17,2670787,1,,,,5950
ecfccb480bd57f5195ea67d23702710014ec0e1a,1,GitHub,2021-07-08 10:13:23-07:00,['5a88a59ddd7f3ef2d7222a88b8baf9ad0eca7018'],18,111,129,2670916,3,0.169014085,1,1,5950
cd24e1233ed1dc5a84b80719b1b5867ace42b7cc,0,GitHub,2021-07-08 11:00:46-07:00,['ecfccb480bd57f5195ea67d23702710014ec0e1a'],1,1,2,2670918,1,,,,5950
66e8b8b413fecff9106a5044870cb7c83c7b3212,0,GitHub,2021-07-08 11:11:39-07:00,['cd24e1233ed1dc5a84b80719b1b5867ace42b7cc'],4,16,20,2670938,4,0.428571429,1,0.428571429,5950
d6918e427e806e1d80926365c4c3ccb37134591c,0,GitHub,2021-07-08 11:33:22-07:00,['66e8b8b413fecff9106a5044870cb7c83c7b3212'],25,34,59,2670997,3,,,,5950
53f9b04176ab415536fbba642ac47867f14d6653,0,GitHub,2021-07-08 12:32:45-07:00,['d6918e427e806e1d80926365c4c3ccb37134591c'],1,1,2,2670999,1,,,,5950
35e65b7f065dde50844e675c81f68b15b577ff64,0,Colin P. Mccabe,2021-07-08 16:51:56-07:00,['53f9b04176ab415536fbba642ac47867f14d6653'],3,2,5,2671004,1,1,1,0,5950
f6d6bcc153618893932bbe53340d823932ac4e70,0,GitHub,2021-07-09 14:17:57-04:00,['35e65b7f065dde50844e675c81f68b15b577ff64'],1,1,2,2671006,1,,,,5950
526fdfb97b90234b7292030d39acf3cfd798a6e2,1,GitHub,2021-07-09 12:00:26-07:00,['f6d6bcc153618893932bbe53340d823932ac4e70'],38,498,536,2671542,10,0.320143885,0.960431655,0.665467626,5953
d20865ae792baa287cf9707ab6c05ea6da6be517,1,GitHub,2021-07-09 12:18:34-07:00,['526fdfb97b90234b7292030d39acf3cfd798a6e2'],63,62,125,2671667,16,0,0,1,5953
d24094bb0af2422979dd5a45e8f310bf863fdf3d,0,GitHub,2021-07-09 21:33:12+02:00,['d20865ae792baa287cf9707ab6c05ea6da6be517'],2,2,4,2671671,1,,,,5953
efe6029f9c2b70cebc4359913ff809b7efa31daa,0,GitHub,2021-07-09 22:35:02-07:00,['d24094bb0af2422979dd5a45e8f310bf863fdf3d'],13,31,44,2671715,2,0.785714286,0.785714286,0.785714286,5953
af282f76a7fcf15e87071523b2a7dcae9e10524b,0,GitHub,2021-07-10 08:43:55+01:00,['efe6029f9c2b70cebc4359913ff809b7efa31daa'],121,84,205,2671920,2,1,1,0,5953
6e857c531f14d07d5b05f174e6063a124c917324,0,GitHub,2021-07-10 10:45:27-07:00,['af282f76a7fcf15e87071523b2a7dcae9e10524b'],20,11,31,2671951,11,0.166666667,0.166666667,0,5953
5ef962ba064efd5e073310aa39ab6a9b6ae8b7c3,1,GitHub,2021-07-10 10:47:46-07:00,['6e857c531f14d07d5b05f174e6063a124c917324'],48,94,142,2672093,3,0,0.945945946,1,5953
c003cc6b35333dd687b5fa5c6d16e7c2b305d25d,1,GitHub,2021-07-12 09:17:46-07:00,['5ef962ba064efd5e073310aa39ab6a9b6ae8b7c3'],54,338,392,2672485,10,0.376712329,1,0.910958904,5954
332db13047e7f2065cd698e4c2443eb550c6df17,0,GitHub,2021-07-12 18:50:25+02:00,['c003cc6b35333dd687b5fa5c6d16e7c2b305d25d'],3,4,7,2672492,2,0,0,0,5954
2b8d41b468cc67b90f1ba0b54577ebb59e634a35,1,GitHub,2021-07-12 13:40:09-07:00,['332db13047e7f2065cd698e4c2443eb550c6df17'],5,124,129,2672621,4,0.610526316,1,0.536842105,5954
bfdef11b9781c2cdd4cd526aeca3bf3898d34422,0,GitHub,2021-07-12 16:16:29-05:00,['2b8d41b468cc67b90f1ba0b54577ebb59e634a35'],6,92,98,2672719,3,,,,5954
cc33cc5f374355e67ce885ff4c2d6611a6aaa346,0,GitHub,2021-07-12 14:20:58-07:00,['bfdef11b9781c2cdd4cd526aeca3bf3898d34422'],7,7,14,2672733,1,,,,5954
a08e0cfe652dc93cbed07a8912a460d85c579dd8,0,GitHub,2021-07-13 10:23:50-05:00,['cc33cc5f374355e67ce885ff4c2d6611a6aaa346'],118,141,259,2672992,4,1,0,0,5954
f97f36b650ef75841164ba01d42e02955141655a,0,GitHub,2021-07-13 10:54:36-07:00,['a08e0cfe652dc93cbed07a8912a460d85c579dd8'],19,37,56,2673048,11,0,0,1,5954
1f64df921cb3ab3341fef014dd7dd9a199770833,1,GitHub,2021-07-13 12:14:39-07:00,['f97f36b650ef75841164ba01d42e02955141655a'],1,18,19,2673067,2,0.785714286,1,1,5954
ac18bdc183f6c549ab08ad4ebd3bb7647d887d4f,0,GitHub,2021-07-13 13:00:15-07:00,['1f64df921cb3ab3341fef014dd7dd9a199770833'],2,7,9,2673076,2,,,,5954
f3017683a2f625394bcc43695dd86049be7727b6,0,GitHub,2021-07-13 13:34:40-07:00,['ac18bdc183f6c549ab08ad4ebd3bb7647d887d4f'],112,83,195,2673271,2,,,,5954
d33a874ce7971c030ba58be80d98bb2e393fe901,1,GitHub,2021-07-13 16:14:15-07:00,['f3017683a2f625394bcc43695dd86049be7727b6'],1,60,61,2673332,2,0.22,0.98,1,5954
0f00f3677f05b60124b937588c05c5ecc114e230,0,GitHub,2021-07-13 16:20:03-07:00,['d33a874ce7971c030ba58be80d98bb2e393fe901'],13,31,44,2673376,3,0.8125,1,0.8125,5954
0785aa38d22f6a71d58deca43d53975292fe3ff7,0,GitHub,2021-07-13 16:23:32-07:00,['0f00f3677f05b60124b937588c05c5ecc114e230'],4,47,51,2673427,3,0.035714286,1,0.714285714,5954
8134adcf91bd20d4f9def54c8b030ff392fad616,0,GitHub,2021-07-13 17:06:18-07:00,['0785aa38d22f6a71d58deca43d53975292fe3ff7'],54,74,128,2673555,8,1,1,0.25,5954
b80ff184f35fb1690b7d724f365ebcbf2720ece8,0,GitHub,2021-07-13 18:01:39-07:00,['8134adcf91bd20d4f9def54c8b030ff392fad616'],1308,2202,3510,2677065,20,0.697068404,1,0.736156352,5956
37d086fa2aa3aea07053304fe9758e104e6abb1a,0,GitHub,2021-07-13 18:29:31-07:00,['b80ff184f35fb1690b7d724f365ebcbf2720ece8'],80,341,421,2677486,6,0.71686747,0.813253012,0.174698795,5956
5e5d5bff3bdaf807338ec9adeac982f8a5c98fbd,0,GitHub,2021-07-13 21:00:23-07:00,['37d086fa2aa3aea07053304fe9758e104e6abb1a'],1,1,2,2677488,1,,,,5956
a95d0e9326dda176dc9def49febe18d731135dbc,0,GitHub,2021-07-14 06:14:35+01:00,['5e5d5bff3bdaf807338ec9adeac982f8a5c98fbd'],3,5,8,2677496,1,0,0.5,1,5956
700a553864a3edca22a627cf4ccb96c587f9b118,0,GitHub,2021-07-13 23:18:01-07:00,['a95d0e9326dda176dc9def49febe18d731135dbc'],2,2,4,2677500,1,,,,5956
eccdfcdc3a67423a1b5e72f30ed2b0ef022a5137,0,GitHub,2021-07-14 08:26:07+02:00,['700a553864a3edca22a627cf4ccb96c587f9b118'],13,113,126,2677626,2,1,1,1,5956
1e19add7a6a74495bd1ba606cad0fbfea43bd56d,0,GitHub,2021-07-14 08:53:28+02:00,['eccdfcdc3a67423a1b5e72f30ed2b0ef022a5137'],5,14,19,2677645,1,0,0,1,5956
efd09c2dafb14ed8b0c93be3b35e0d4bd7a81dcb,0,GitHub,2021-07-14 10:38:15-07:00,['1e19add7a6a74495bd1ba606cad0fbfea43bd56d'],11,500,511,2678156,4,0.288321168,0.770072993,0.952554745,5957
301a07f4d877ebd22e111831d5445ade3f73af14,1,GitHub,2021-07-14 10:52:25-07:00,['efd09c2dafb14ed8b0c93be3b35e0d4bd7a81dcb'],90,205,295,2678451,3,0.235294118,0.794117647,0.529411765,5957
f413435585a3ed735ea9d4c551aa4f4f533d6a13,0,GitHub,2021-07-14 15:55:50-07:00,['301a07f4d877ebd22e111831d5445ade3f73af14'],1,1256,1257,2679708,16,0.099691675,1,1,5957
46c91f471259357bc63dd627b54113453c206eb9,0,GitHub,2021-07-15 14:18:03+02:00,['f413435585a3ed735ea9d4c551aa4f4f533d6a13'],55,143,198,2679906,3,0.328125,0.9375,0.921875,5957
df398aa71b116895ae030adb9cbb2a55d8beee7b,0,GitHub,2021-07-15 14:25:41+02:00,['46c91f471259357bc63dd627b54113453c206eb9'],32,38,70,2679976,3,,,1,5957
f7cf4a44bc928c60e1519d26ffeb4aa06a9e4133,0,GitHub,2021-07-15 14:40:21+02:00,['df398aa71b116895ae030adb9cbb2a55d8beee7b'],33,49,82,2680058,3,0.2,0,0.4,5957
921a3428a8f961f2931b9e2798d5b32618a791f2,0,GitHub,2021-07-15 18:03:46+02:00,['f7cf4a44bc928c60e1519d26ffeb4aa06a9e4133'],46,106,152,2680210,3,0.976744186,1,0.953488372,5957
3e3264760ba26e75153c655694c820a531935607,0,GitHub,2021-07-15 10:58:15-07:00,['921a3428a8f961f2931b9e2798d5b32618a791f2'],208,67,275,2680485,7,0.701754386,0,0,5957
e07de97a4ce730a2755db7eeacb9b3e1f69a12c8,1,GitHub,2021-07-15 11:41:51-07:00,['3e3264760ba26e75153c655694c820a531935607'],252,1722,1974,2682459,21,0.340270552,0.791883455,0.888657648,5963
584213ed20d679b11206b67c5a65035347632f07,1,GitHub,2021-07-15 14:00:32-07:00,['e07de97a4ce730a2755db7eeacb9b3e1f69a12c8'],31,347,378,2682837,5,0.417142857,0.988571429,0.994285714,5964
fd66db4793fc6785e7e30b2c9b0d571c12c81a39,0,GitHub,2021-07-15 15:29:18-07:00,['584213ed20d679b11206b67c5a65035347632f07'],2,5,7,2682844,1,,,,5964
4fd6d2bec8a6249e211b9769e887cc24d5cf1444,0,GitHub,2021-07-16 09:58:57+02:00,['fd66db4793fc6785e7e30b2c9b0d571c12c81a39'],30,91,121,2682965,3,0.852941176,1,0.941176471,5964
e01c8a1cae7153cfc3fe876cfca3164b93a5eb46,0,GitHub,2021-07-16 15:40:17+01:00,['4fd6d2bec8a6249e211b9769e887cc24d5cf1444'],22,2,24,2682989,1,0,0,0,5964
13b2df733a963963b0275266eed2b5e156cd56a0,0,GitHub,2021-07-16 11:22:26-07:00,['e01c8a1cae7153cfc3fe876cfca3164b93a5eb46'],13,44,57,2683046,7,1,1,1,5964
8e482123438d1ad354a62b45432eeaf620efa54e,0,GitHub,2021-07-16 12:56:15-07:00,['13b2df733a963963b0275266eed2b5e156cd56a0'],12,10,22,2683068,1,1,0,0,5964
061517212f4bd51a3128a6d1b86c7c4f68dd2465,0,GitHub,2021-07-16 13:17:32-07:00,['8e482123438d1ad354a62b45432eeaf620efa54e'],2,8,10,2683078,1,1,1,1,5964
3e38038278e8c6bb9c59432bedc81a06bc10d1de,1,GitHub,2021-07-16 13:30:19-07:00,['061517212f4bd51a3128a6d1b86c7c4f68dd2465'],2,7,9,2683087,4,0,0,0.6,5964
b5cb02b2883d25b4a39f99e8ac16450a92b13e02,0,Colin P. Mccabe,2021-07-16 14:10:52-07:00,['3e38038278e8c6bb9c59432bedc81a06bc10d1de'],55,95,150,2683237,8,0.086956522,1,1,5964
762d11c13f1f4dc8e5a82f9bbed88582dcb045f4,0,GitHub,2021-07-16 16:28:09-07:00,['b5cb02b2883d25b4a39f99e8ac16450a92b13e02'],20,116,136,2683373,2,0.153846154,0.461538462,0,5964
a24dbba1e566080a8ad734c68ef1f0e1839ee8c8,0,GitHub,2021-07-17 14:52:37+08:00,['762d11c13f1f4dc8e5a82f9bbed88582dcb045f4'],3,18,21,2683394,5,0.75,0.75,1,5964
98bd590718658f3af2d7f1ff307d1d170624f199,0,GitHub,2021-07-17 16:36:52+08:00,['a24dbba1e566080a8ad734c68ef1f0e1839ee8c8'],1,1,2,2683396,1,,,,5964
597dd1359d10d9a4360c8a78e7cb2dc273ad798b,1,GitHub,2021-07-19 13:55:18+08:00,['98bd590718658f3af2d7f1ff307d1d170624f199'],2,20,22,2683418,2,,,,5964
a46b82bea9abbd08e550d985f87e79a6d912a9ab,1,GitHub,2021-07-19 05:37:16-07:00,['597dd1359d10d9a4360c8a78e7cb2dc273ad798b'],460,804,1264,2684682,54,0,0.957746479,1,5968
f7790a067586e39df09cf8b4b8ab99baa74c055f,0,GitHub,2021-07-19 16:48:03+02:00,['a46b82bea9abbd08e550d985f87e79a6d912a9ab'],111,235,346,2685028,5,0.597938144,0.484536082,0.618556701,5968
e8ce93bd5310229ffd49cc42af49ee3a4368d014,0,GitHub,2021-07-19 09:05:46-07:00,['f7790a067586e39df09cf8b4b8ab99baa74c055f'],431,2718,3149,2688177,24,0.52718894,0.847926267,0.903225806,5983
bfc57aa4ddcd719fc4a646c2ac09d4979c076455,0,GitHub,2021-07-19 09:08:55-07:00,['e8ce93bd5310229ffd49cc42af49ee3a4368d014'],6,10,16,2688193,1,0.25,1,1,5983
4423a54935109cb521eb556ca6161c016526f43b,0,GitHub,2021-07-19 12:34:42-07:00,['bfc57aa4ddcd719fc4a646c2ac09d4979c076455'],0,3,3,2688196,1,0,0,1,5983
b6159042c0f9bd84bc248dc1e291b9cc70157811,0,GitHub,2021-07-19 18:53:14-07:00,['4423a54935109cb521eb556ca6161c016526f43b'],99,227,326,2688522,3,0.60952381,0.914285714,0.80952381,5983
b0c243f032b779a96dcdf944a9ff3ef3d16ca680,0,GitHub,2021-07-20 07:40:33-07:00,['b6159042c0f9bd84bc248dc1e291b9cc70157811'],7,10,17,2688539,1,1,1,1,5983
69a4661d7a7578789f4752928622c010b2264565,0,GitHub,2021-07-20 10:13:01-07:00,['b0c243f032b779a96dcdf944a9ff3ef3d16ca680'],76,103,179,2688718,12,1,0.923076923,1,5983
030caec096d6d2bbab2545d1b748847451ef8d35,1,GitHub,2021-07-20 14:10:14-04:00,['69a4661d7a7578789f4752928622c010b2264565'],2,46,48,2688766,2,1,1,0.882352941,5984
47a0974f5a168435eceff039de071d704a5ec65a,0,GitHub,2021-07-20 11:28:11-07:00,['030caec096d6d2bbab2545d1b748847451ef8d35'],9,6,15,2688781,1,1,0,0,5984
eeb788d1b9a5cc869a5fa0aa935d7bd2979f733d,0,GitHub,2021-07-20 14:56:07-07:00,['47a0974f5a168435eceff039de071d704a5ec65a'],4,8,12,2688793,1,1,1,1,5984
0314801a8e67a96f8cdea85bf55cb5bed808fc34,0,GitHub,2021-07-20 17:39:26-05:00,['eeb788d1b9a5cc869a5fa0aa935d7bd2979f733d'],114,507,621,2689414,10,0.696517413,1,0.870646766,5986
1e78dcda69ce97b9f08c89226ccb1a077da4547f,0,GitHub,2021-07-20 16:35:14-07:00,['0314801a8e67a96f8cdea85bf55cb5bed808fc34'],0,13,13,2689427,1,0,1,1,5986
d779ab08ae450fc9bd1782e995ad992321e7f599,1,GitHub,2021-07-20 16:37:27-07:00,['1e78dcda69ce97b9f08c89226ccb1a077da4547f'],2,58,60,2689487,2,1,1,1,5987
56ef910358e2bde42aba4aaafd7f5c899055ad92,0,GitHub,2021-07-20 16:41:20-07:00,['d779ab08ae450fc9bd1782e995ad992321e7f599'],1,2,3,2689490,2,0,1,0,5987
9b3687e0acff5c33c05ee318bfbb809580c09ea5,0,GitHub,2021-07-21 07:58:14+02:00,['56ef910358e2bde42aba4aaafd7f5c899055ad92'],1,3,4,2689494,2,0,1,1,5987
ad59e3b622c52030ea324f32ae3966ed11b78389,0,GitHub,2021-07-21 13:26:41+02:00,['9b3687e0acff5c33c05ee318bfbb809580c09ea5'],43,37,80,2689574,4,,,,5987
e0f8eda6fd814a71bc5c87516c382738b05b0f38,0,GitHub,2021-07-21 06:12:03-07:00,['ad59e3b622c52030ea324f32ae3966ed11b78389'],6,7,13,2689587,2,,,,5987
6dd425e276497f7e22109d94c0d0a57e7fc65ce5,1,GitHub,2021-07-21 10:41:41-07:00,['e0f8eda6fd814a71bc5c87516c382738b05b0f38'],2,31,33,2689620,8,0.64,0.76,1,5987
89286668eb2f7c6629e288dc5925429fbb42fbd4,0,GitHub,2021-07-21 12:54:59-07:00,['6dd425e276497f7e22109d94c0d0a57e7fc65ce5'],1,4,5,2689625,1,0,1,1,5987
02dc615c1e2139e1bc92bf2284fda2c740152a0e,1,GitHub,2021-07-21 13:23:15-07:00,['89286668eb2f7c6629e288dc5925429fbb42fbd4'],15,111,126,2689751,5,0.068493151,1,1,5987
57866bd588074b11ccddc38cabb7d3d84e590405,0,GitHub,2021-07-21 17:30:35-07:00,['02dc615c1e2139e1bc92bf2284fda2c740152a0e'],7,7,14,2689765,4,,,,5987
2dbd65ecafe4b7148ba9098b62caf82c550c4236,0,GitHub,2021-07-22 10:28:53+02:00,['57866bd588074b11ccddc38cabb7d3d84e590405'],38,32,70,2689835,4,0.733333333,0.066666667,0.733333333,5987
d99562a1452ac09c8b5d6bc96b1e6b5a5a481f6d,0,GitHub,2021-07-22 19:27:07+02:00,['2dbd65ecafe4b7148ba9098b62caf82c550c4236'],0,2,2,2689837,1,0,0,1,5987
c38adaf74ba1019272515a04d9cfb721183a0fca,1,GitHub,2021-07-22 22:46:46-07:00,['d99562a1452ac09c8b5d6bc96b1e6b5a5a481f6d'],2,8,10,2689847,2,1,1,1,5987
f959e6c58309a31b88f47263a9ea144d94f6b24a,0,GitHub,2021-07-23 05:33:43-07:00,['c38adaf74ba1019272515a04d9cfb721183a0fca'],9,8,17,2689864,4,0,0,0,5987
d998cbcc886c82d5fc4081cda0908aa386e856c5,1,GitHub,2021-07-23 09:30:55-07:00,['f959e6c58309a31b88f47263a9ea144d94f6b24a'],7,49,56,2689920,2,0.117647059,1,1,5987
273d66479dbee2398b09e478ffaf996498d1ab34,0,GitHub,2021-07-23 13:26:54-07:00,['d998cbcc886c82d5fc4081cda0908aa386e856c5'],1,1,2,2689922,1,,,,5987
f34bb28ab6c69945d944abc1283cacecdaf4ef8e,0,GitHub,2021-07-23 13:43:31-07:00,['273d66479dbee2398b09e478ffaf996498d1ab34'],12,28,40,2689962,5,0.666666667,0,0.666666667,5987
3ba688e75f29b2089317b3cf7331192ce81ea3f0,0,GitHub,2021-07-23 14:32:41-07:00,['f34bb28ab6c69945d944abc1283cacecdaf4ef8e'],29,56,85,2690047,1,0.25,1,1,5987
03edcdd972e7aec7cb8cc50799741940630ea652,0,GitHub,2021-07-23 14:56:46-07:00,['3ba688e75f29b2089317b3cf7331192ce81ea3f0'],11,7,18,2690065,1,1,0,0,5987
a75997f2794926332baa99eea5de9aa18c213031,0,GitHub,2021-07-23 15:01:39-07:00,['03edcdd972e7aec7cb8cc50799741940630ea652'],30,148,178,2690243,8,0.209302326,1,0.779069767,5987
b69027726eee1be6e20c9f16d271d6948dc13224,0,GitHub,2021-07-23 15:56:41-07:00,['a75997f2794926332baa99eea5de9aa18c213031'],10,146,156,2690399,2,0.226086957,1,1,5987
04fd555475a4b458a21d337347117902ee1feafb,0,GitHub,2021-07-23 16:01:54-07:00,['b69027726eee1be6e20c9f16d271d6948dc13224'],1,1,2,2690401,1,,,,5987
7fbc6b73aa5d194948b30a00074cd0f79365694d,0,GitHub,2021-07-23 16:14:37-07:00,['04fd555475a4b458a21d337347117902ee1feafb'],95,126,221,2690622,9,1,1,0.2,5987
8b1eca1c58aef822082dd9954bc41179ecf3eb06,0,GitHub,2021-07-23 16:22:41-07:00,['7fbc6b73aa5d194948b30a00074cd0f79365694d'],11,14,25,2690647,7,0,1,1,5987
dc512cc038e554f1abf1fbfe6b79b27fe637471b,0,GitHub,2021-07-23 16:28:21-07:00,['8b1eca1c58aef822082dd9954bc41179ecf3eb06'],1,267,268,2690915,4,0.483606557,1,0.918032787,5988
9baf5eb67b2a9086cb7c083a766d291ea0ba9fb7,1,GitHub,2021-07-23 16:46:10-07:00,['dc512cc038e554f1abf1fbfe6b79b27fe637471b'],16,162,178,2691093,5,0.279569892,0.76344086,0.752688172,5988
d4877982bc19ebecb085e4009618f2bcf296eee2,0,GitHub,2021-07-23 20:22:23-07:00,['9baf5eb67b2a9086cb7c083a766d291ea0ba9fb7'],2,0,2,2691095,1,,,,5988
55d9acad65826176595bf7f9242524bda1985ba9,1,GitHub,2021-07-23 21:54:44-07:00,['d4877982bc19ebecb085e4009618f2bcf296eee2'],53,188,241,2691336,7,0.390243902,0.597560976,1,5988
c8079800889d88f398962863036a603bb28858b4,0,GitHub,2021-07-25 20:53:27+05:18,['55d9acad65826176595bf7f9242524bda1985ba9'],1,1,2,2691338,1,,,,5988
8ed271e1fd7b64a7731df3accaf3f3a0ca333efe,1,GitHub,2021-07-26 21:45:59+01:00,['c8079800889d88f398962863036a603bb28858b4'],3,90,93,2691431,3,0,1,0.974025974,5988
a7d9a8ac3687b6ea57bb19d1029bc20b9be05f8c,0,GitHub,2021-07-26 14:09:47-07:00,['8ed271e1fd7b64a7731df3accaf3f3a0ca333efe'],1,2,3,2691434,1,,,,5988
d89ea74918ce0a1f2309a09473c9500c52af3b10,0,GitHub,2021-07-26 14:15:33-07:00,['a7d9a8ac3687b6ea57bb19d1029bc20b9be05f8c'],1,1,2,2691436,1,,,,5988
246a8afb63313907921407d92f9243cfcb4bce66,0,GitHub,2021-07-26 15:53:30-07:00,['d89ea74918ce0a1f2309a09473c9500c52af3b10'],20,39,59,2691495,1,1,1,1,5988
f9aeebed054000934af7555f39085f5caecf34bc,1,GitHub,2021-07-26 16:23:04-07:00,['246a8afb63313907921407d92f9243cfcb4bce66'],409,291,700,2692195,10,1,0,0,5988
ded66d92a4e0fd5810311b727f76058386d92c25,1,GitHub,2021-07-26 16:25:22-07:00,['f9aeebed054000934af7555f39085f5caecf34bc'],272,333,605,2692800,7,0.183673469,1,1,5988
818cbfba6ddf8252b7da314bbaac74201951dfb3,1,GitHub,2021-07-26 16:26:02-07:00,['ded66d92a4e0fd5810311b727f76058386d92c25'],281,337,618,2693418,8,0.307692308,0.961538462,1,5988
f6f6e52c7416e8bacef4b5fc265dc1aa0ff52520,0,GitHub,2021-07-27 13:47:16-07:00,['818cbfba6ddf8252b7da314bbaac74201951dfb3'],4,9,13,2693431,2,1,1,1,5988
c5ec390fa6fded24dee5d699a0ec87a5345a4e99,0,GitHub,2021-07-27 18:23:00-07:00,['f6f6e52c7416e8bacef4b5fc265dc1aa0ff52520'],99,418,517,2693948,7,0.414179104,0.951492537,0.902985075,5988
fe0fe686e92d019ac2b5c8407ab2cbb55ae069e1,1,GitHub,2021-07-28 17:27:26+01:00,['c5ec390fa6fded24dee5d699a0ec87a5345a4e99'],1,29,30,2693978,2,0,0.818181818,1,5988
fd36e5a8b657b0858dbfef4ae9706bf714db4ca7,0,GitHub,2021-07-28 09:28:56-07:00,['fe0fe686e92d019ac2b5c8407ab2cbb55ae069e1'],12,54,66,2694044,2,0.475,0.7,1,5988
4710a491463a91ec12c670ea50c139fc14134e80,0,GitHub,2021-07-28 11:18:56-07:00,['fd36e5a8b657b0858dbfef4ae9706bf714db4ca7'],439,1520,1959,2696003,59,0.671511628,0.872093023,0.938953488,5990
58402a6fe8ff0b395ef5d28008a58f15db8c270d,0,GitHub,2021-07-28 11:38:31-07:00,['4710a491463a91ec12c670ea50c139fc14134e80'],0,1,1,2696004,1,0,0,1,5990
3190ebd1e604b480ea5bdb7be2d8c269cccc415e,0,GitHub,2021-07-28 20:58:15-05:00,['58402a6fe8ff0b395ef5d28008a58f15db8c270d'],88,158,246,2696250,9,0,0,1,5990
257533a21b3ad72fa2c5c3b90985e8902ff66e89,0,GitHub,2021-07-29 09:23:47-07:00,['3190ebd1e604b480ea5bdb7be2d8c269cccc415e'],39,1,40,2696290,2,0.833333333,0.027777778,0,5990
52f87e2c65220a76f9c21d7da28004bf074d02b3,0,GitHub,2021-07-29 13:53:29-05:00,['257533a21b3ad72fa2c5c3b90985e8902ff66e89'],2,857,859,2697149,3,,,,5991
a2aa3b9ea5f4e1cbe81c62400a6dc37bd9e9aadf,0,GitHub,2021-07-29 15:50:57-04:00,['52f87e2c65220a76f9c21d7da28004bf074d02b3'],12,14,26,2697175,2,0.5,1,1,5991
976409ee081b5a4e5edfe73b5d597998feb2f402,0,GitHub,2021-07-29 13:01:19-07:00,['a2aa3b9ea5f4e1cbe81c62400a6dc37bd9e9aadf'],18,139,157,2697332,6,0.985915493,1,0.704225352,5992
c074b673958efe90553700a89f89e3d0c4a13c25,1,GitHub,2021-07-29 16:26:00-05:00,['976409ee081b5a4e5edfe73b5d597998feb2f402'],6,11,17,2697349,1,0,1,1,5992
bebb9aeb9cc493d8acc475273c1c1c34a6a484d5,1,GitHub,2021-07-29 14:36:44-07:00,['c074b673958efe90553700a89f89e3d0c4a13c25'],27,141,168,2697517,4,0.021276596,0.872340426,0.85106383,5992
22541361b7c62913bc848fb03e5f807e152a1023,0,GitHub,2021-07-29 21:52:16-05:00,['bebb9aeb9cc493d8acc475273c1c1c34a6a484d5'],93,856,949,2698466,16,0.595338983,0.447033898,0.550847458,5994
5d52de2ccfaebc8d4f8d6ff247b86a2830eb1c8b,0,GitHub,2021-07-30 10:56:57-07:00,['22541361b7c62913bc848fb03e5f807e152a1023'],135,255,390,2698856,7,0.378787879,1,1,5994
6f104935e9fb4a6d58c710fecdf1a28d52e0009e,0,GitHub,2021-07-30 12:46:25-07:00,['5d52de2ccfaebc8d4f8d6ff247b86a2830eb1c8b'],0,5,5,2698861,1,0,0,1,5994
56eb950d854c235c02b9a6396c45c1dd2eb68286,0,GitHub,2021-07-30 13:26:42-07:00,['6f104935e9fb4a6d58c710fecdf1a28d52e0009e'],2,3,5,2698866,1,0,0,1,5994
8a1fcee86e42c8bd1f26309dde8748927109056e,0,GitHub,2021-07-30 17:48:03-05:00,['56eb950d854c235c02b9a6396c45c1dd2eb68286'],5,87,92,2698958,6,0.385964912,0.666666667,1,5994
4efd9bf0cfde34b2438fdb013581f57cfc51cae1,1,GitHub,2021-08-01 15:26:04-07:00,['8a1fcee86e42c8bd1f26309dde8748927109056e'],43,286,329,2699287,7,0.061111111,0.933333333,1,5994
6fbea5743d3a4bc7b4da951972dc63e8065a21aa,0,GitHub,2021-08-01 16:59:28-07:00,['4efd9bf0cfde34b2438fdb013581f57cfc51cae1'],2,7,9,2699296,1,,,,5994
d88989d595702706c0fa8fea357a4b1d83f12f1d,0,GitHub,2021-08-01 17:00:57-07:00,['6fbea5743d3a4bc7b4da951972dc63e8065a21aa'],42,42,84,2699380,3,,,,5994
2edaf9ddd30a6417c34f5bce6894a5340632ff1e,0,GitHub,2021-08-02 10:39:32-07:00,['d88989d595702706c0fa8fea357a4b1d83f12f1d'],15,12,27,2699407,2,,,,5994
b980ca8709dbef31890a84de02ccf277af5743c7,1,GitHub,2021-08-02 14:47:03-07:00,['2edaf9ddd30a6417c34f5bce6894a5340632ff1e'],90,252,342,2699749,13,0.711538462,1,0.961538462,5997
79788ca042330faea7dc736f1f6ceb75b3f4d1d9,0,GitHub,2021-08-03 13:53:54+01:00,['b980ca8709dbef31890a84de02ccf277af5743c7'],7,34,41,2699790,3,0.2,0.88,0.88,5997
4eb72add11b548e3fe8fea72856af49dc950e444,0,GitHub,2021-08-03 17:26:46-07:00,['79788ca042330faea7dc736f1f6ceb75b3f4d1d9'],105,58,163,2699953,3,0,0,0,5997
ad13c66d8e98cc526e97ec8ec6b5f5cea96dc275,0,GitHub,2021-08-04 09:56:37-07:00,['4eb72add11b548e3fe8fea72856af49dc950e444'],2,2,4,2699957,1,,,,5997
06034938c46e9f2eaad61bc7961a6b968442070a,0,GitHub,2021-08-04 10:12:19-07:00,['ad13c66d8e98cc526e97ec8ec6b5f5cea96dc275'],2,2,4,2699961,1,,,,5997
a103c95a31ee276e936669438828bdb6e73d5f14,0,GitHub,2021-08-04 17:31:10-05:00,['06034938c46e9f2eaad61bc7961a6b968442070a'],11,1299,1310,2701271,16,0.204545455,0.560606061,0.601010101,6002
fccaa5c389f01485d32603063443096b1dded689,1,GitHub,2021-08-04 15:58:34-07:00,['a103c95a31ee276e936669438828bdb6e73d5f14'],19,36,55,2701326,2,0.090909091,1,1,6002
1790025f644a610ac96965eb9c3e1b101d8d8ede,1,GitHub,2021-08-04 16:43:49-07:00,['fccaa5c389f01485d32603063443096b1dded689'],2,6,8,2701334,1,0,0,0,6002
d414de37796bf4c8d98069eb505ece4ab4e4157c,0,GitHub,2021-08-05 00:32:25-07:00,['1790025f644a610ac96965eb9c3e1b101d8d8ede'],2,2,4,2701338,1,,,,6002
d6f6edd2b17cbaccd4c87bfa66f871a676760044,1,GitHub,2021-08-05 11:18:41-04:00,['d414de37796bf4c8d98069eb505ece4ab4e4157c'],2,72,74,2701412,3,0.553571429,1,1,6002
f6351a95429b9724b9fc528df87bb7787ae34844,0,GitHub,2021-08-05 11:33:20-07:00,['d6f6edd2b17cbaccd4c87bfa66f871a676760044'],7,68,75,2701487,1,,,,6002
001afa8ebec2a1b5fd05319b02f7d3eb6410ab8e,0,GitHub,2021-08-05 13:26:18-07:00,['f6351a95429b9724b9fc528df87bb7787ae34844'],4,65,69,2701556,2,0,0.96,1,6002
e5df7fd90b9e9a8ad7edd635ca9bb9d0511f2ffe,0,GitHub,2021-08-05 13:41:46-07:00,['001afa8ebec2a1b5fd05319b02f7d3eb6410ab8e'],4,49,53,2701609,2,0,0.222222222,1,6002
be8820cdacb93e7b2aef5ae20ca00ad401328379,1,GitHub,2021-08-05 16:39:33-05:00,['e5df7fd90b9e9a8ad7edd635ca9bb9d0511f2ffe'],11,28,39,2701648,1,0,0.666666667,1,6002
9bc45d4e031bef63772b3d8d7c5828c0733a27b0,0,GitHub,2021-08-05 15:26:10-07:00,['be8820cdacb93e7b2aef5ae20ca00ad401328379'],1,1,2,2701650,1,,,,6002
04023d49fd4ecdbd1cc05c442b04277de3334ee4,0,GitHub,2021-08-05 18:10:48-07:00,['9bc45d4e031bef63772b3d8d7c5828c0733a27b0'],17,52,69,2701719,3,0,0.8,1,6002
6854eb8332d6ef1f1c6216d2f67d6e146b1ef60f,0,GitHub,2021-08-06 00:18:27-07:00,['04023d49fd4ecdbd1cc05c442b04277de3334ee4'],219,794,1013,2702732,28,0.732142857,1,0.642857143,6002
83f0ae3821033d6c564c6df0d55c06e8642bf231,0,GitHub,2021-08-09 12:05:31+02:00,['6854eb8332d6ef1f1c6216d2f67d6e146b1ef60f'],215,309,524,2703256,25,1,1,0.333333333,6002
f16a9499ec3b7fa20aae66f478171ababaf0cbd4,0,GitHub,2021-08-09 14:19:35-05:00,['83f0ae3821033d6c564c6df0d55c06e8642bf231'],4,4,8,2703264,1,,,,6002
89f1bea39bdab1e93898480434b041414c102461,1,GitHub,2021-08-09 12:57:23-07:00,['f16a9499ec3b7fa20aae66f478171ababaf0cbd4'],21,141,162,2703426,12,0.06741573,0.91011236,0.505617978,6002
9565a529e08d7aa36beac02c8e6115bcc87d2dc7,0,GitHub,2021-08-09 15:19:21-07:00,['89f1bea39bdab1e93898480434b041414c102461'],56,55,111,2703537,24,,,,6002
a5daae20b5fc12956a27e8426b87f3c56327b235,0,GitHub,2021-08-10 09:39:59-07:00,['9565a529e08d7aa36beac02c8e6115bcc87d2dc7'],12,12,24,2703561,1,1,1,0,6002
0837fba997f480629172e752036cd1dce00a0c7a,1,GitHub,2021-08-10 12:06:30-07:00,['a5daae20b5fc12956a27e8426b87f3c56327b235'],236,568,804,2704365,4,0.091633466,0.952191235,0.741035857,6002
35ebdd7ed0f271d52289903dcadce4bf82ab5a39,0,GitHub,2021-08-10 12:27:44-07:00,['0837fba997f480629172e752036cd1dce00a0c7a'],53,51,104,2704469,2,1,0,0,6002
2bfd0ae2e91827518a9e31092b0940d74d1a29f0,0,GitHub,2021-08-10 13:37:59-07:00,['35ebdd7ed0f271d52289903dcadce4bf82ab5a39'],29,41,70,2704539,5,0.454545455,0,0,6002
b1b872bd4eac979159a0fa7ec25a124973dc7314,1,GitHub,2021-08-12 09:38:44-07:00,['2bfd0ae2e91827518a9e31092b0940d74d1a29f0'],30,227,257,2704796,8,0.191489362,1,0.695035461,6002
db1f581da7f3440cfd5be93800b4a9a2d7327a35,1,GitHub,2021-08-12 16:10:19-07:00,['b1b872bd4eac979159a0fa7ec25a124973dc7314'],477,486,963,2705759,56,1,1,1,6002
64b8e17827251174490678dd296ce2c1a79ff5ef,0,GitHub,2021-08-13 15:35:59-07:00,['db1f581da7f3440cfd5be93800b4a9a2d7327a35'],6,47,53,2705812,6,0.130434783,1,0.826086957,6002
38fd06146cf83ffc7187817dc983ef9a52de78fe,1,GitHub,2021-08-16 11:59:09-07:00,['64b8e17827251174490678dd296ce2c1a79ff5ef'],1,7,8,2705820,2,1,1,1,6002
bbf1ee74d719494ed5a5cac9dc54b7093171707c,1,GitHub,2021-08-17 17:12:51+01:00,['38fd06146cf83ffc7187817dc983ef9a52de78fe'],16,67,83,2705903,2,0.12195122,0.902439024,1,6002
b923ec236edc99b4de39d4339c06cf7ada166a8a,0,GitHub,2021-08-17 23:44:17+05:18,['bbf1ee74d719494ed5a5cac9dc54b7093171707c'],1,1,2,2705905,1,,,,6002
9bcf4a525b9a08b1d0a5f8c134c46f70c84692a0,1,GitHub,2021-08-17 13:10:03-07:00,['b923ec236edc99b4de39d4339c06cf7ada166a8a'],238,705,943,2706848,10,0.054495913,0.907356948,0.948228883,6003
fb2b131310ceff06008fbad3af1e99bba4bc2b1e,0,GitHub,2021-08-17 17:03:11-07:00,['9bcf4a525b9a08b1d0a5f8c134c46f70c84692a0'],14,19,33,2706881,1,,,,6003
8bc4c334e36ac6fafe6e1d4a468da713336447e3,0,GitHub,2021-08-18 17:23:29-07:00,['fb2b131310ceff06008fbad3af1e99bba4bc2b1e'],0,65,65,2706946,3,0.820512821,0.820512821,1,6003
f4e787c380d9a18ef60c3cd75e8d167a84cbfb46,1,GitHub,2021-08-18 21:58:36-07:00,['8bc4c334e36ac6fafe6e1d4a468da713336447e3'],43,78,121,2707067,2,,,,6004
d20e51d1cd300236d0a1d9101dcf8e3f192555d5,0,GitHub,2021-08-19 14:54:57-07:00,['f4e787c380d9a18ef60c3cd75e8d167a84cbfb46'],4,7,11,2707078,2,0,1,0,6004
45ecaa19f8ded255eff9b31ca5e586ca08cf3d3d,0,GitHub,2021-08-20 11:27:54-05:00,['d20e51d1cd300236d0a1d9101dcf8e3f192555d5'],40,42,82,2707160,2,0,1,1,6004
a382fbdcd40bdfabf3c0987c9cc43bd17e9e3879,0,GitHub,2021-08-23 09:07:01+02:00,['45ecaa19f8ded255eff9b31ca5e586ca08cf3d3d'],1,1,2,2707162,1,,,,6004
26ee78f392386862e0a125cdb9c040fda13f5604,1,GitHub,2021-08-23 11:07:39-07:00,['a382fbdcd40bdfabf3c0987c9cc43bd17e9e3879'],195,282,477,2707639,3,0,0.888888889,0.5,6004
a594747d7566b28e3599c1940cb4c98ca9816dca,0,GitHub,2021-08-23 13:21:38-07:00,['26ee78f392386862e0a125cdb9c040fda13f5604'],1,136,137,2707776,2,1,1,1,6005
bc3972c9f3e8c6d92e2154501bf18ebcb1a93f64,0,GitHub,2021-08-23 13:45:44-07:00,['a594747d7566b28e3599c1940cb4c98ca9816dca'],34,35,69,2707845,7,0,0,0,6005
9cf7a5c4bc98e980007c7bd19d693930a56f4281,0,GitHub,2021-08-23 14:33:04-07:00,['bc3972c9f3e8c6d92e2154501bf18ebcb1a93f64'],1,0,1,2707846,1,1,0,0,6005
0fe4e24c095f57606a9c33a3135f2f81a1fb0285,0,GitHub,2021-08-24 09:57:13+02:00,['9cf7a5c4bc98e980007c7bd19d693930a56f4281'],20,76,96,2707942,4,0.307692308,1,1,6005
7298aa373441205579e01874b04e2db58f7cf4b2,0,GitHub,2021-08-24 12:07:11+02:00,['0fe4e24c095f57606a9c33a3135f2f81a1fb0285'],7,8,15,2707957,1,0,0,0,6005
d30b4e51513e6938970020bf1e894c983447ef8f,0,GitHub,2021-08-24 09:22:58-07:00,['7298aa373441205579e01874b04e2db58f7cf4b2'],8,16,24,2707981,1,0,0,1,6005
d0ec4d7ebf0022537807f5080b19414bd81f706e,1,GitHub,2021-08-24 11:59:38-07:00,['d30b4e51513e6938970020bf1e894c983447ef8f'],7,149,156,2708137,3,0.447368421,1,0.815789474,6005
735b10e3cbc85ce164f6fd98726269802fea1720,0,GitHub,2021-08-25 19:13:22-07:00,['d0ec4d7ebf0022537807f5080b19414bd81f706e'],0,1,1,2708138,1,,,,6005
53277a92a691aefe779e2d2663590581c7db167c,0,GitHub,2021-08-25 21:52:32-07:00,['735b10e3cbc85ce164f6fd98726269802fea1720'],0,1,1,2708139,1,1,1,1,6005
1d3b96389b325520648d29b6363941f50e5b6d35,0,GitHub,2021-08-26 13:27:51-07:00,['53277a92a691aefe779e2d2663590581c7db167c'],4,4,8,2708147,1,,,,6005
844c1259a9e2ea9caf2635213c4c0a144f6b758f,0,GitHub,2021-08-26 14:37:34-07:00,['1d3b96389b325520648d29b6363941f50e5b6d35'],13,25,38,2708185,2,0,1,1,6005
d9bb98895453fa7cdf14eb3184e904fca884f9a1,0,GitHub,2021-08-26 17:19:03-07:00,['844c1259a9e2ea9caf2635213c4c0a144f6b758f'],45,19,64,2708249,18,,,,6005
8d5185d9768cfce9581040341a15912a014797f7,1,GitHub,2021-08-27 08:22:36+02:00,['d9bb98895453fa7cdf14eb3184e904fca884f9a1'],61,115,176,2708425,3,0,1,1,6005
c4e1e238574e24aac7ee80f89fb6cb25ecf97ef3,0,GitHub,2021-08-27 08:28:14+02:00,['8d5185d9768cfce9581040341a15912a014797f7'],1,5,6,2708431,1,1,1,1,6005
4e2f2b0674848ea105e74e787403b0260f91dc1e,0,GitHub,2021-08-27 11:11:57+02:00,['c4e1e238574e24aac7ee80f89fb6cb25ecf97ef3'],2,1,3,2708434,1,,,,6005
edd5a249e905670b9d7f806250d83bff777afa28,0,GitHub,2021-08-27 11:19:58-04:00,['4e2f2b0674848ea105e74e787403b0260f91dc1e'],7,22,29,2708463,3,0,0,1,6005
7201976378aeb206563c949dd0e0c62d411e57d6,0,GitHub,2021-08-27 18:28:21+02:00,['edd5a249e905670b9d7f806250d83bff777afa28'],7,42,49,2708512,2,0,0.916666667,1,6005
ba47beec015ace9306c19bf2b7467df5ff0d1be2,0,GitHub,2021-08-27 11:02:47-07:00,['7201976378aeb206563c949dd0e0c62d411e57d6'],7,27,34,2708546,1,1,1,1,6005
555f70917535176b61aa920223c02dcb27f25372,0,GitHub,2021-08-27 11:10:58-07:00,['ba47beec015ace9306c19bf2b7467df5ff0d1be2'],37,50,87,2708633,4,0,1,1,6005
84b111f968a47c65d3498a1b3af42dd644403728,0,GitHub,2021-08-27 20:06:49-07:00,['555f70917535176b61aa920223c02dcb27f25372'],2,4,6,2708639,2,0,1,1,6005
49aed781d8b398975e8952ef21578c05114064ed,1,GitHub,2021-08-27 20:12:12-07:00,['84b111f968a47c65d3498a1b3af42dd644403728'],40,18,58,2708697,1,1,0.391304348,0,6005
1d22b0d70686aef5689b775ea2ea7610a37f3e8c,1,GitHub,2021-08-28 09:00:36+01:00,['49aed781d8b398975e8952ef21578c05114064ed'],172,846,1018,2709715,49,0.502369668,0.547393365,0.902843602,6006
923bc2e9f78c0d0f14e4adf6fc50bd9abdd416da,0,GitHub,2021-08-30 08:43:25-07:00,['1d22b0d70686aef5689b775ea2ea7610a37f3e8c'],163,274,437,2710152,7,1,1,0,6008
01ab888dbd08ccd4b0de9333d21581ce24fe2c3b,1,GitHub,2021-08-30 15:39:25-07:00,['923bc2e9f78c0d0f14e4adf6fc50bd9abdd416da'],44,1302,1346,2711498,29,0.434194342,0.993849938,0.833948339,6013
a5ce43781e7c5f66dcfc5684207a70666f2e1838,0,GitHub,2021-08-31 11:44:45-07:00,['01ab888dbd08ccd4b0de9333d21581ce24fe2c3b'],6,6,12,2711510,4,,,,6013
25b0857bdb8a17f786c8f546fef2a60b6a87b797,0,GitHub,2021-09-01 08:37:05-07:00,['a5ce43781e7c5f66dcfc5684207a70666f2e1838'],1,48,49,2711559,4,0.904761905,1,1,6013
4835c64f89876db5af2bba8fa3ef17de5a0b44e3,0,GitHub,2021-09-01 09:58:36-07:00,['25b0857bdb8a17f786c8f546fef2a60b6a87b797'],11,78,89,2711648,4,1,1,1,6013
1a33b65e0f91cb19c6cd24ccf7c67e3ed09ce72e,0,GitHub,2021-09-01 10:16:41-07:00,['4835c64f89876db5af2bba8fa3ef17de5a0b44e3'],1,3,4,2711652,1,0,0,0,6013
0093b19e2e53a78eb597d948533fb051dda594f6,0,GitHub,2021-09-02 10:09:55+02:00,['1a33b65e0f91cb19c6cd24ccf7c67e3ed09ce72e'],9,10,19,2711671,3,0,0,0,6013
3c0b89d9df7a46cceeaa08a6efd25bd2e49dcaaf,0,GitHub,2021-09-02 13:44:12-07:00,['0093b19e2e53a78eb597d948533fb051dda594f6'],6,36,42,2711713,3,0,1,1,6013
37584ce4f57a9e087e9c9280803e556a856d95e8,0,GitHub,2021-09-03 20:29:44+02:00,['3c0b89d9df7a46cceeaa08a6efd25bd2e49dcaaf'],16,13,29,2711742,5,1,0,1,6013
7c64077b34e58bc82a708a070aa005546d0a34cf,0,GitHub,2021-09-06 14:03:16+02:00,['37584ce4f57a9e087e9c9280803e556a856d95e8'],0,30,30,2711772,4,1,0.928571429,1,6013
89ee72b5b555b4195bb5fa2a4779f1109f7f6ee9,0,GitHub,2021-09-06 08:18:52-07:00,['7c64077b34e58bc82a708a070aa005546d0a34cf'],8,3,11,2711783,1,,,,6013
81667e2bf5e0f91b75e70a7e7420fa5ede98a287,0,GitHub,2021-09-06 08:22:34-07:00,['89ee72b5b555b4195bb5fa2a4779f1109f7f6ee9'],17,4,21,2711804,2,0,0,0,6013
0118330103e992253a7875a523de3526cad4a6c5,0,GitHub,2021-09-06 08:55:52-07:00,['81667e2bf5e0f91b75e70a7e7420fa5ede98a287'],79,125,204,2712008,12,1,0,0,6014
3475347aed004141f2bf8e16ddf34ecfbbae0ed6,1,GitHub,2021-09-06 09:18:47-07:00,['0118330103e992253a7875a523de3526cad4a6c5'],144,169,313,2712321,15,0.375,1,1,6014
519322338993ab56bac74a37bd74a135c83ccc23,0,GitHub,2021-09-06 11:20:38-07:00,['3475347aed004141f2bf8e16ddf34ecfbbae0ed6'],69,35,104,2712425,2,1,0,0.208333333,6014
49f7c824fa156aa275eeb7e28ae93df4742204cb,0,GitHub,2021-09-07 08:46:21-07:00,['519322338993ab56bac74a37bd74a135c83ccc23'],3,3,6,2712431,1,,,,6014
80635e4255561882509493af2c6a6faebd54da35,0,GitHub,2021-09-07 12:06:03-07:00,['49f7c824fa156aa275eeb7e28ae93df4742204cb'],6,7,13,2712444,1,,,,6014
9d107c174bfb23e5ce0daca9a59796f018f627c6,0,GitHub,2021-09-07 13:02:45-07:00,['80635e4255561882509493af2c6a6faebd54da35'],1,18,19,2712463,2,1,1,1,6014
66a27af2f17f4abd94f76edf828745f104c7ba4d,0,GitHub,2021-09-07 13:49:50-07:00,['9d107c174bfb23e5ce0daca9a59796f018f627c6'],3,108,111,2712574,7,0.956521739,0.956521739,0.956521739,6014
bc1800809d1ad7a5f7a26169c441877715a9c766,0,GitHub,2021-09-07 13:50:34-07:00,['66a27af2f17f4abd94f76edf828745f104c7ba4d'],0,12,12,2712586,1,1,1,1,6014
5f89ce5f202bf560214e00fa1ac7add7a27248cf,0,GitHub,2021-09-07 17:17:44-05:00,['bc1800809d1ad7a5f7a26169c441877715a9c766'],130,365,495,2713081,9,0.777777778,1,0.811965812,6015
6472e790928e24e27da1bb9723b9b5d2ab3efe50,0,GitHub,2021-09-07 19:50:18-07:00,['5f89ce5f202bf560214e00fa1ac7add7a27248cf'],97,106,203,2713284,2,0.6,1,1,6015
c56905bacc6c20e8996d8dd79b4c22ee944cdc7d,0,GitHub,2021-09-08 11:16:23+02:00,['6472e790928e24e27da1bb9723b9b5d2ab3efe50'],4,23,27,2713311,4,0.736842105,1,0.736842105,6015
fb77da941ac2a34513cf2cd5d11137ba9b275575,0,GitHub,2021-09-08 13:57:08+02:00,['c56905bacc6c20e8996d8dd79b4c22ee944cdc7d'],13,64,77,2713388,2,0,1,1,6015
06e53afbefaf3ad1f64a49607775bbcc85edb81e,1,GitHub,2021-09-08 18:23:37+02:00,['fb77da941ac2a34513cf2cd5d11137ba9b275575'],37,150,187,2713575,2,0,0.952941176,0.741176471,6015
5e3ecf192e40f7eda092e71bc758886a2dba37e3,0,GitHub,2021-09-08 18:44:29+02:00,['06e53afbefaf3ad1f64a49607775bbcc85edb81e'],0,8,8,2713583,2,0.666666667,0.666666667,1,6015
286126f9a53751285e6b71349cdb6abcba35ddff,0,GitHub,2021-09-08 18:00:58+01:00,['5e3ecf192e40f7eda092e71bc758886a2dba37e3'],18,73,91,2713674,8,0.571428571,1,0,6015
0a1df1238274adf0d5f599f97687cc1b082495d4,0,GitHub,2021-09-08 12:15:44-07:00,['286126f9a53751285e6b71349cdb6abcba35ddff'],40,36,76,2713750,12,1,1,1,6015
56928205bdaa05f7178bc049563a50cb2338d637,0,GitHub,2021-09-08 13:28:07-07:00,['0a1df1238274adf0d5f599f97687cc1b082495d4'],8,2,10,2713760,1,,,,6015
df55c7ecfffa4601eaf36a3cd534d75c6525af49,0,GitHub,2021-09-09 18:39:10+02:00,['56928205bdaa05f7178bc049563a50cb2338d637'],7,24,31,2713791,2,0.235294118,0,0.882352941,6015
1e19de3199f53c89b5455390d8bbb2b58f6603b3,0,GitHub,2021-09-09 10:06:25-07:00,['df55c7ecfffa4601eaf36a3cd534d75c6525af49'],92,148,240,2714031,9,0,1,1,6015
c1c639db77aea4842a12a5630e2346d975a9f7d6,0,GitHub,2021-09-10 14:33:37-07:00,['1e19de3199f53c89b5455390d8bbb2b58f6603b3'],2,28,30,2714061,3,1,1,1,6015
01abc7a57ebf94f32736434e65c70aa9ca2e880d,0,GitHub,2021-09-10 16:47:53-07:00,['c1c639db77aea4842a12a5630e2346d975a9f7d6'],2,7,9,2714070,1,1,1,1,6015
08d5840fbaae55870721a8c8a965997751307214,0,GitHub,2021-09-13 09:30:47+02:00,['01abc7a57ebf94f32736434e65c70aa9ca2e880d'],1,1,2,2714072,1,,,,6015
0786dc87842bae3733b309ea50c5601c7df3a62d,1,GitHub,2021-09-13 10:13:41-07:00,['08d5840fbaae55870721a8c8a965997751307214'],12,98,110,2714182,2,0.963414634,0.963414634,1,6015
a03bda61e068d72823af47e5f25ffd12c3319541,1,GitHub,2021-09-13 14:15:22-07:00,['0786dc87842bae3733b309ea50c5601c7df3a62d'],7,110,117,2714299,3,0.26984127,0.968253968,0.984126984,6015
9628c1278e5dcd4f6995c89809461d350d9a530a,0,GitHub,2021-09-13 14:40:54-07:00,['a03bda61e068d72823af47e5f25ffd12c3319541'],288,451,739,2715038,3,1,0.430769231,0.138461538,6016
75795d1ed8402f185e00b5f3aedcc2bcbb914ca9,0,GitHub,2021-09-14 09:47:54-07:00,['9628c1278e5dcd4f6995c89809461d350d9a530a'],1,13,14,2715052,2,1,1,0.8,6016
7de8a93c7e1036553ab6e738cf91bc39e154719e,1,GitHub,2021-09-15 08:52:45-07:00,['75795d1ed8402f185e00b5f3aedcc2bcbb914ca9'],531,1210,1741,2716793,31,0.382845188,0.983263598,0.769874477,6017
6c806430093c152b916d8e8f1fa542980c03a181,0,GitHub,2021-09-16 09:17:15-07:00,['7de8a93c7e1036553ab6e738cf91bc39e154719e'],191,499,690,2717483,18,0.31147541,0.584699454,0.786885246,6017
a0c7e6d8b4945f01f0ea956a66f05d57b92937f0,0,GitHub,2021-09-16 16:44:32-07:00,['6c806430093c152b916d8e8f1fa542980c03a181'],1007,708,1715,2719198,27,0.305164319,0,0.525821596,6021
c558d94c438788637eae640db29b5b8312983bb8,0,GitHub,2021-09-17 05:34:37-07:00,['a0c7e6d8b4945f01f0ea956a66f05d57b92937f0'],1,1,2,2719200,1,,,,6021
55701dc00ab72233e7c238550a423fdce479afc1,0,GitHub,2021-09-17 15:35:49+02:00,['c558d94c438788637eae640db29b5b8312983bb8'],13,57,70,2719270,7,0.75,1,0,6021
1b0294dfc4943421cef50365fc698508d2806965,0,GitHub,2021-09-17 12:05:21-07:00,['55701dc00ab72233e7c238550a423fdce479afc1'],10,6,16,2719286,2,0,0,0,6021
074a3dacca27f3ee313b5185adcf83cfa2c6605d,1,GitHub,2021-09-17 14:12:31-07:00,['1b0294dfc4943421cef50365fc698508d2806965'],290,1019,1309,2720595,21,0.321276596,0.725531915,1,6024
db16c516a7086451950d3bafeecc8a56044327c2,0,GitHub,2021-09-18 22:19:02-07:00,['074a3dacca27f3ee313b5185adcf83cfa2c6605d'],3,3,6,2720601,1,,,,6024
0cf047325b56bfc37755e7dba5c88b8d64ff45bd,0,GitHub,2021-09-19 03:17:53-07:00,['db16c516a7086451950d3bafeecc8a56044327c2'],0,17,17,2720618,2,0,0.375,1,6024
493280735b418cb7d7cb68cfc2e7f84ca4a552ca,0,GitHub,2021-09-20 09:23:15+02:00,['0cf047325b56bfc37755e7dba5c88b8d64ff45bd'],6,7,13,2720631,4,,,,6024
ad6b7d421caff9bced99ca89b215e568a96c9afe,0,GitHub,2021-09-20 10:27:36+02:00,['493280735b418cb7d7cb68cfc2e7f84ca4a552ca'],0,42,42,2720673,1,,,,6024
968e18cc799faa6b2b5f94e4f376bc768895afd2,1,GitHub,2021-09-20 09:46:38-07:00,['ad6b7d421caff9bced99ca89b215e568a96c9afe'],233,807,1040,2721713,8,0.365535248,1,0.702349869,6025
1338025d24deb546d15fc1b6ae3b24500404e2f2,0,GitHub,2021-09-20 10:49:03-07:00,['968e18cc799faa6b2b5f94e4f376bc768895afd2'],4,4,8,2721721,2,,,,6025
3f3c3e1c696c7a4eb4a95a948c17a06939e0d51e,0,GitHub,2021-09-20 12:51:56-07:00,['1338025d24deb546d15fc1b6ae3b24500404e2f2'],13,9,22,2721743,1,1,0,0,6025
f650a14d56c0cc33263c29d8d242760406943c5b,0,GitHub,2021-09-21 10:26:46+02:00,['3f3c3e1c696c7a4eb4a95a948c17a06939e0d51e'],0,7,7,2721750,1,0,0,0,6025
5a6f19b2a1ff72c52ad627230ffdf464456104ee,0,GitHub,2021-09-21 11:18:15-05:00,['f650a14d56c0cc33263c29d8d242760406943c5b'],2,4,6,2721756,1,0,1,1,6025
02795d7f571b0b1d9b8a528b075523dc1270eaf5,0,GitHub,2021-09-21 16:29:38-07:00,['5a6f19b2a1ff72c52ad627230ffdf464456104ee'],5,5,10,2721766,2,,,,6025
b61ec0003f907b61243102811fdb2e92f8d7d2c5,0,GitHub,2021-09-22 09:14:58-07:00,['02795d7f571b0b1d9b8a528b075523dc1270eaf5'],117,773,890,2722656,17,0.153409091,0.352272727,0.84469697,6025
d15969af286f4f239c0a972f4135ef429381ccd6,0,GitHub,2021-09-22 14:25:41-05:00,['b61ec0003f907b61243102811fdb2e92f8d7d2c5'],97,92,189,2722845,6,0.75,0,0.25,6025
85548acafbc799ee371b531802580fcde170ddc1,1,GitHub,2021-09-22 13:07:45-07:00,['d15969af286f4f239c0a972f4135ef429381ccd6'],32,339,371,2723216,10,0.364035088,0.714912281,0.74122807,6025
509c1653fd0d107196fbf599a01d7899f6222160,0,GitHub,2021-09-23 05:08:06-07:00,['85548acafbc799ee371b531802580fcde170ddc1'],63,82,145,2723361,3,1,1,1,6025
9abc45e0680b8bac6a9cb7a53f4499c9e8f2be3d,0,GitHub,2021-09-23 10:07:33-07:00,['509c1653fd0d107196fbf599a01d7899f6222160'],1,2,3,2723364,1,0,1,1,6025
d08e3ad7d5b9824f6ddd4f20746850926278f3ff,0,GitHub,2021-09-23 16:28:39-07:00,['9abc45e0680b8bac6a9cb7a53f4499c9e8f2be3d'],23,59,82,2723446,3,0.714285714,1,0.714285714,6025
b76bcaf3a8f28a5ad553a9edd477c4d6d887f08a,1,GitHub,2021-09-24 10:51:08+02:00,['d08e3ad7d5b9824f6ddd4f20746850926278f3ff'],101,398,499,2723945,13,0.278761062,0.827433628,0.82300885,6025
af0c2a9370979d6c21b0d5b6fba66151658958fb,0,GitHub,2021-09-24 11:16:05-07:00,['b76bcaf3a8f28a5ad553a9edd477c4d6d887f08a'],4,4,8,2723953,1,,,,6025
4eb386f6e060e12e1940c0d780987e3a7c438d74,0,GitHub,2021-09-25 11:41:52-07:00,['af0c2a9370979d6c21b0d5b6fba66151658958fb'],0,10,10,2723963,1,0,0,1,6025
1af1c80e2de561e012313d69649635d871e43181,0,GitHub,2021-09-27 17:02:48+02:00,['4eb386f6e060e12e1940c0d780987e3a7c438d74'],28,31,59,2724022,3,1,1,1,6025
c6aeb5c5546f34276879c1eef4199d208f1c23dc,0,GitHub,2021-09-27 09:49:21-07:00,['1af1c80e2de561e012313d69649635d871e43181'],9,46,55,2724077,3,0.555555556,1,1,6025
b741e9386e74aa9c9fceb5715b8c138ae49c07a8,1,GitHub,2021-09-27 16:00:41-07:00,['c6aeb5c5546f34276879c1eef4199d208f1c23dc'],2,42,44,2724121,2,0.361111111,0.861111111,1,6025
5e45196fb078e5e211440c70e928a23aa45f9d48,0,GitHub,2021-09-28 07:22:42+01:00,['b741e9386e74aa9c9fceb5715b8c138ae49c07a8'],0,19,19,2724140,4,1,1,1,6025
5a5c05807ddc82b183f4489e81b9ad02fe83a0df,0,GitHub,2021-09-28 07:26:10+01:00,['5e45196fb078e5e211440c70e928a23aa45f9d48'],3,7,10,2724150,1,1,1,1,6025
24a335b3384497b0675a0f4b5927bff6a1adad70,0,GitHub,2021-09-28 15:58:49-07:00,['5a5c05807ddc82b183f4489e81b9ad02fe83a0df'],36,25,61,2724211,1,0.142857143,0,0,6025
7e573001484427dc73d821cc232a4c3bb3b5f5bb,0,GitHub,2021-09-28 16:50:16-07:00,['24a335b3384497b0675a0f4b5927bff6a1adad70'],3,150,153,2724364,3,0,0.959016393,0.991803279,6025
71f1cb7bfb2dc801c9ea47e0794d915e7f279635,1,GitHub,2021-09-28 17:22:05-07:00,['7e573001484427dc73d821cc232a4c3bb3b5f5bb'],46,149,195,2724559,7,0.068181818,1,0.795454545,6025
361b7845c6e6badc4be19fec596380a3de7a5c98,0,GitHub,2021-09-28 17:31:29-07:00,['71f1cb7bfb2dc801c9ea47e0794d915e7f279635'],65,320,385,2724944,4,0.107142857,0.714285714,0.642857143,6026
0888953e0e834bf849751a36ae5adf92b20ec0a5,0,GitHub,2021-09-28 23:09:24-07:00,['361b7845c6e6badc4be19fec596380a3de7a5c98'],6,0,6,2724950,1,,,,6026
6d7a7859568eb5b25931a3be81cda9f4e0e3ec0d,0,GitHub,2021-09-29 18:19:43-07:00,['0888953e0e834bf849751a36ae5adf92b20ec0a5'],2,7,9,2724959,2,0,0,0,6026
ce83e5be6644884d5c727ed49982f45eca8c136f,0,GitHub,2021-09-30 11:40:40-05:00,['6d7a7859568eb5b25931a3be81cda9f4e0e3ec0d'],413,522,935,2725894,20,0.231707317,0,0.829268293,6026
db42afd6e24ef4291390b4d1c1f10758beedefed,0,GitHub,2021-09-30 13:02:31-07:00,['ce83e5be6644884d5c727ed49982f45eca8c136f'],2,2,4,2725898,2,,,,6026
1a3e23a5798373fb40f31af2eb7c4348270ac437,0,GitHub,2021-10-05 11:37:38-07:00,['db42afd6e24ef4291390b4d1c1f10758beedefed'],16,99,115,2726013,7,1,1,0.769230769,6027
1573c707e6a9b0bc14d0e261e958c14d86fff6e4,0,GitHub,2021-10-05 19:07:13-07:00,['1a3e23a5798373fb40f31af2eb7c4348270ac437'],1,9,10,2726023,1,,,,6027
769882d9100cccf82fbccd4398a1d7f0a2d80f9d,0,GitHub,2021-10-06 18:32:10-07:00,['1573c707e6a9b0bc14d0e261e958c14d86fff6e4'],14,14,28,2726051,1,0,0,0,6027
34d96257e41bfc59493a1f10966e68946ed2428b,1,GitHub,2021-10-06 19:00:09-07:00,['769882d9100cccf82fbccd4398a1d7f0a2d80f9d'],3,42,45,2726096,1,0,1,1,6027
3f3a0e0d9ee1142d47913e744bfd57ebbc5e5b40,0,GitHub,2021-10-07 09:41:57-07:00,['34d96257e41bfc59493a1f10966e68946ed2428b'],17,303,320,2726416,6,0.88028169,1,1,6029
a9ffabc4470b7847ec394e8e9f993326fd2c3390,0,GitHub,2021-10-08 10:15:37+01:00,['3f3a0e0d9ee1142d47913e744bfd57ebbc5e5b40'],2,8,10,2726426,1,1,1,1,6029
400d39bb0efaa4fdda4c0597a63a1ddd17082291,1,GitHub,2021-10-11 16:35:12+02:00,['a9ffabc4470b7847ec394e8e9f993326fd2c3390'],25,70,95,2726521,7,1,1,1,6029
48475e89ca7aade7551b76d6667aecf5c6565d40,0,GitHub,2021-10-11 16:45:36+02:00,['400d39bb0efaa4fdda4c0597a63a1ddd17082291'],2,2,4,2726525,1,,,,6029
34d56dc8d00bd27955eb9bb6ac01d5ae7f134dbd,0,GitHub,2021-10-11 10:24:55-07:00,['48475e89ca7aade7551b76d6667aecf5c6565d40'],142,1626,1768,2728293,28,0.473933649,0.788309637,0.924170616,6038
e31a53a2cdee2ad8a1f71c9e8c9f1cab64393df9,0,GitHub,2021-10-12 13:33:23-07:00,['34d56dc8d00bd27955eb9bb6ac01d5ae7f134dbd'],24,39,63,2728356,4,0.2,1,1,6038
d1415866cc3ed7eeb198df6477a09584b6d1f8a2,0,GitHub,2021-10-12 16:05:22-07:00,['e31a53a2cdee2ad8a1f71c9e8c9f1cab64393df9'],14,60,74,2728430,6,0.384615385,1,0.538461538,6038
65b01a0464d9bc4cc185cfb99ea80dc66cfeb2ec,0,GitHub,2021-10-12 16:14:38-07:00,['d1415866cc3ed7eeb198df6477a09584b6d1f8a2'],177,529,706,2729136,12,0,0.69379845,0.910852713,6038
da58d75c4389aa988ac6028bb8bd073646f07300,1,GitHub,2021-10-12 17:19:03-07:00,['65b01a0464d9bc4cc185cfb99ea80dc66cfeb2ec'],150,235,385,2729521,17,0,0.804878049,1,6038
cd1ce49bdbbd08eff255fdb5795e1fbd647a13c2,0,GitHub,2021-10-13 16:52:36+02:00,['da58d75c4389aa988ac6028bb8bd073646f07300'],1,3,4,2729525,1,0,0,1,6038
7fbe482289fe2c7619bd1e3a1ecfb40aa56c619c,0,GitHub,2021-10-14 18:58:20-07:00,['cd1ce49bdbbd08eff255fdb5795e1fbd647a13c2'],5,8,13,2729538,5,,,,6038
f58d79d549957d4a13547a41634735325ab56982,0,GitHub,2021-10-14 22:06:30-07:00,['7fbe482289fe2c7619bd1e3a1ecfb40aa56c619c'],4,86,90,2729628,4,0.070175439,1,0.947368421,6038
99d18b7410cbd854999a40695b70cd12549a3395,0,GitHub,2021-10-15 16:08:22+02:00,['f58d79d549957d4a13547a41634735325ab56982'],4,4,8,2729636,1,,,,6038
041b76dc57f096be2a2d7532d917122992bff6e2,0,GitHub,2021-10-15 09:37:31-07:00,['99d18b7410cbd854999a40695b70cd12549a3395'],2,3,5,2729641,1,,,,6038
48575a9c2d5498b24745608f1e17eb46b94e6b4f,0,GitHub,2021-10-18 10:11:47+02:00,['041b76dc57f096be2a2d7532d917122992bff6e2'],11,20,31,2729672,1,1,1,1,6038
14671e28d7f6c530796d3abffd4f7ccb74ac849e,0,GitHub,2021-10-18 10:19:05+02:00,['48575a9c2d5498b24745608f1e17eb46b94e6b4f'],1,1,2,2729674,1,,,,6038
74f25bf3adbb5af5ad99b91c9bef5fb91615c5f7,0,GitHub,2021-10-18 10:40:48+02:00,['14671e28d7f6c530796d3abffd4f7ccb74ac849e'],1,1,2,2729676,1,,,,6038
da38a1df273ec9d3a077435b2a63d75053edd308,0,GitHub,2021-10-18 10:44:11+02:00,['74f25bf3adbb5af5ad99b91c9bef5fb91615c5f7'],9,10,19,2729695,5,0,0,0,6038
68223d32278913bc75d8f8ed41d27afe0c25d959,0,GitHub,2021-10-18 15:34:08-05:00,['da38a1df273ec9d3a077435b2a63d75053edd308'],66,84,150,2729845,4,0,0,1,6038
b86c307b0e514cae4be5bed3e74cfca65d08c673,1,GitHub,2021-10-19 15:48:24-07:00,['68223d32278913bc75d8f8ed41d27afe0c25d959'],119,317,436,2730281,4,0.238888889,0,0.466666667,6038
38a3ddb5627f7860aea40cb602186bde79808d3d,0,GitHub,2021-10-20 08:19:36+02:00,['b86c307b0e514cae4be5bed3e74cfca65d08c673'],7,135,142,2730423,3,0.169811321,0,0.943396226,6039
765e588bdd29d9f971ad26c945a3436688be9f66,0,GitHub,2021-10-20 14:14:45+01:00,['38a3ddb5627f7860aea40cb602186bde79808d3d'],8,15,23,2730446,1,,,,6039
8a1d84b06a9421245f3032c42517c6fc8d72536c,1,GitHub,2021-10-21 08:25:52+02:00,['765e588bdd29d9f971ad26c945a3436688be9f66'],1,1,2,2730448,1,,,,6039
6288b5370de21715d3c505c664d51e476105c560,0,GitHub,2021-10-21 13:44:08-07:00,['8a1d84b06a9421245f3032c42517c6fc8d72536c'],1,2,3,2730451,5,0,0,1,6039
b53412422496f6cc2caf2abe3139f3bc2ed75c9d,0,GitHub,2021-10-21 16:21:20-07:00,['6288b5370de21715d3c505c664d51e476105c560'],55,139,194,2730645,10,0.234375,0.53125,0.578125,6039
86e83de742720e9800ef0f55d1a65c8a2f79e4cc,0,GitHub,2021-10-21 16:50:37-07:00,['b53412422496f6cc2caf2abe3139f3bc2ed75c9d'],10,10,20,2730665,1,,,,6039
3f433c0b4a3fc024d4ec48f7e8b5541336fca053,1,GitHub,2021-10-22 12:57:36-07:00,['86e83de742720e9800ef0f55d1a65c8a2f79e4cc'],10,155,165,2730830,8,0.152173913,0.75,0.97826087,6039
145392b8c66cf5c351d11bc659a3fc80fc6b602a,0,GitHub,2021-10-25 10:12:07-07:00,['3f433c0b4a3fc024d4ec48f7e8b5541336fca053'],1,3,4,2730834,1,,,,6039
37b3f8c15b2a9f7d332179a33ab18ce4753a66fd,0,GitHub,2021-10-26 13:23:20-07:00,['145392b8c66cf5c351d11bc659a3fc80fc6b602a'],2,303,305,2731139,3,0.403061224,0.923469388,0.93877551,6040
82d5e1cf1439b01609b180e2727e665986223416,0,GitHub,2021-10-26 14:03:46-07:00,['37b3f8c15b2a9f7d332179a33ab18ce4753a66fd'],34,116,150,2731289,2,0,1,1,6040
53f5c2606de16331cb4ddeb38fdc3f94bff4b233,0,Colin P. Mccabe,2021-10-26 14:16:52-07:00,['82d5e1cf1439b01609b180e2727e665986223416'],19,180,199,2731488,13,,,,6041
a4333bed845c3aebfb9f173028194ab6ea643509,0,GitHub,2021-10-26 14:30:16-07:00,['53f5c2606de16331cb4ddeb38fdc3f94bff4b233'],1,1,2,2731490,1,,,,6041
d36832e6fc531b56bbab49e60d96efdf17fb6191,0,GitHub,2021-10-26 15:27:30-07:00,['a4333bed845c3aebfb9f173028194ab6ea643509'],17,47,64,2731554,2,0.545454545,1,1,6041
4bb492aa270eca1fe1357f2f01b7cf401bd86a38,0,GitHub,2021-10-27 10:53:48+02:00,['d36832e6fc531b56bbab49e60d96efdf17fb6191'],1,1,2,2731556,1,,,,6041
195ebff25b637bf09ce3283e204cfb1faffe34fc,0,GitHub,2021-10-27 11:02:48+02:00,['4bb492aa270eca1fe1357f2f01b7cf401bd86a38'],1,2,3,2731559,1,1,1,1,6041
22aa9d2ce13c556d0876491e428c57b75010d07e,0,GitHub,2021-10-27 10:47:57-07:00,['195ebff25b637bf09ce3283e204cfb1faffe34fc'],1,4,5,2731564,1,,,,6041
cf2b3930311f3dfe23b64853a19607c5f3085b13,0,GitHub,2021-10-27 15:19:09-07:00,['22aa9d2ce13c556d0876491e428c57b75010d07e'],2,29,31,2731595,2,0,1,1,6041
1afe2a5190e9c98e38c84dc793f4303ea51bc19b,0,Colin P. Mccabe,2021-10-27 17:17:05-07:00,['cf2b3930311f3dfe23b64853a19607c5f3085b13'],1,0,1,2731596,1,,,,6041
2c0364f34394601ef83b8ac7502a18a0d35418d9,0,GitHub,2021-10-28 09:01:47+02:00,['1afe2a5190e9c98e38c84dc793f4303ea51bc19b'],2,2,4,2731600,1,,,,6041
7b379539a5533179b0c86adb352548ac1aa82006,1,GitHub,2021-10-28 11:36:53-07:00,['2c0364f34394601ef83b8ac7502a18a0d35418d9'],5,5896,5901,2737501,48,0.559792028,0.89254766,0.870017331,6083
af8100b94fda4a27511797233e9845078ae8a69f,1,GitHub,2021-10-30 08:00:34-07:00,['7b379539a5533179b0c86adb352548ac1aa82006'],539,946,1485,2738986,109,0.442446043,0.755395683,0.967625899,6085
3aef0a5cebe3d17ed17a79b999d5f78a03b44949,0,GitHub,2021-11-02 13:38:54+01:00,['af8100b94fda4a27511797233e9845078ae8a69f'],10,14,24,2739010,8,,,,6085
252a40ea1f273a5f11ccb5a9b362bceca7e66271,0,GitHub,2021-11-03 12:18:28+01:00,['3aef0a5cebe3d17ed17a79b999d5f78a03b44949'],0,166,166,2739176,3,0.044247788,1,1,6085
22d056c9b76c9bf8417d8701594d1fcee1c6a655,0,GitHub,2021-11-03 14:58:42+01:00,['252a40ea1f273a5f11ccb5a9b362bceca7e66271'],56,52,108,2739284,11,1,0,0.5,6085
01e6a6ebf2af87e12b60fb7cf55d261ded72ed3e,1,GitHub,2021-11-03 10:55:24-07:00,['22d056c9b76c9bf8417d8701594d1fcee1c6a655'],20,695,715,2739999,8,0.704453441,0.955465587,0.659919028,6088
9d305c79d312dbafafcb2a5fb936f6a0546c8aaa,0,GitHub,2021-11-04 10:04:02+01:00,['01e6a6ebf2af87e12b60fb7cf55d261ded72ed3e'],9,0,9,2740008,2,,,,6088
43bcc5682da82a602a4c0a000dc7433d0507b450,0,GitHub,2021-11-04 06:44:05-07:00,['9d305c79d312dbafafcb2a5fb936f6a0546c8aaa'],16,33,49,2740057,2,1,1,1,6088
c1bdfa125d224d07290a2d33cdac9d7387796fef,1,GitHub,2021-11-07 11:39:04-06:00,['43bcc5682da82a602a4c0a000dc7433d0507b450'],192,712,904,2740961,7,0.642307692,1,0.938461538,6090
807c5b4d282e7a7a16d0bb94aa2cda9566a7cc2d,1,GitHub,2021-11-08 14:48:54-06:00,['c1bdfa125d224d07290a2d33cdac9d7387796fef'],441,578,1019,2741980,46,0,0.024096386,1,6090
feee65a2cf1efed02422fe2c9392682b0aaf7882,0,GitHub,2021-11-09 09:07:05-08:00,['807c5b4d282e7a7a16d0bb94aa2cda9566a7cc2d'],1,2,3,2741983,2,,,,6090
78a5e921d4566f2e2d56714834e3c5dd6ad17125,0,GitHub,2021-11-09 13:42:54-08:00,['feee65a2cf1efed02422fe2c9392682b0aaf7882'],31,154,185,2742168,6,0,0.988888889,0.988888889,6090
b8c3a67012218188330110ce94636b70116131f9,0,GitHub,2021-11-10 05:44:26-08:00,['78a5e921d4566f2e2d56714834e3c5dd6ad17125'],9,38,47,2742215,2,1,1,1,6090
79d97bd29d059e8ba8ee7726b49d76e03e281059,0,GitHub,2021-11-10 09:56:55-08:00,['b8c3a67012218188330110ce94636b70116131f9'],15,33,48,2742263,3,0,0,0.421052632,6090
39b1bf4ee3cb63a889eb64d51d922866d37e7f5f,1,GitHub,2021-11-10 11:14:50-08:00,['79d97bd29d059e8ba8ee7726b49d76e03e281059'],163,907,1070,2743333,13,0.290388548,0.955010225,0.842535787,6091
908a6d2ad7807642b917231769c8d3b6a0c1ad16,0,GitHub,2021-11-10 11:27:59-08:00,['39b1bf4ee3cb63a889eb64d51d922866d37e7f5f'],406,692,1098,2744431,28,0.067669173,0.616541353,0.691729323,6093
214b59b3ec2c19bd1831076970aff86c1755d0e8,0,GitHub,2021-11-10 14:36:24-06:00,['908a6d2ad7807642b917231769c8d3b6a0c1ad16'],0,5,5,2744436,5,,,,6098
6f6248509c0c38dcd867b28e6481de5370c6e082,0,GitHub,2021-11-11 16:39:08+01:00,['214b59b3ec2c19bd1831076970aff86c1755d0e8'],14,80,94,2744530,3,1,1,1,6100
e9db5a11e48ffeec88bb37feb5bc08b756bb6662,0,GitHub,2021-11-13 10:06:16-08:00,['6f6248509c0c38dcd867b28e6481de5370c6e082'],3,3,6,2744536,2,0,1,1,6100
e8818e234a879d5ca45accba0121f43f45381f4a,1,GitHub,2021-11-15 10:04:43+01:00,['e9db5a11e48ffeec88bb37feb5bc08b756bb6662'],1515,2854,4369,2748905,45,0.095187166,1,1,6101
01ddeabc2b733823881d021fb5a867cf8497fabe,0,GitHub,2021-11-15 10:09:20+01:00,['e8818e234a879d5ca45accba0121f43f45381f4a'],10,0,10,2748915,4,0.571428571,0.571428571,0,6101
8318786b72ccc1e74538aa99f3c5b1c21258bbfb,1,GitHub,2021-11-15 11:45:48+01:00,['01ddeabc2b733823881d021fb5a867cf8497fabe'],3,104,107,2749022,4,0.095238095,1,1,6101
3f8ca44bc63dacfeab278aa135f322f82cc480b0,0,GitHub,2021-11-15 14:16:41+01:00,['8318786b72ccc1e74538aa99f3c5b1c21258bbfb'],2,2,4,2749026,1,,,,6101
1075e1189a28c287e8238863c5fba98b4934f6a7,0,GitHub,2021-11-15 17:00:49+01:00,['3f8ca44bc63dacfeab278aa135f322f82cc480b0'],1,1,2,2749028,1,,,,6101
a3ab7d5b42d02f194a8bdf3047c374f938ca0dad,0,GitHub,2021-11-15 11:04:53-08:00,['1075e1189a28c287e8238863c5fba98b4934f6a7'],2,2,4,2749032,1,,,,6101
ec29b62e924a6e2dac886cdfdb960aea1e911166,0,GitHub,2021-11-15 15:45:18-08:00,['a3ab7d5b42d02f194a8bdf3047c374f938ca0dad'],137,245,382,2749414,1,1,1,1,6101
f7031aa8073097e806d011b1aacf967e2a173a9c,1,GitHub,2021-11-15 16:20:27-08:00,['ec29b62e924a6e2dac886cdfdb960aea1e911166'],48,83,131,2749545,5,0.636363636,0.863636364,1,6101
627cad1f7b6dd70caf88ec314daf1719ac377f90,1,GitHub,2021-11-15 18:57:03-08:00,['f7031aa8073097e806d011b1aacf967e2a173a9c'],3,110,113,2749658,2,0.154929577,0.521126761,0.985915493,6101
1c99c0ce151e4fa22a1998bf5e333df9cc4485ef,0,GitHub,2021-11-16 10:39:35+01:00,['627cad1f7b6dd70caf88ec314daf1719ac377f90'],2,1,3,2749661,1,,,,6101
babc54333c3f58e465e75d0f77eede23745634e8,0,GitHub,2021-11-16 10:50:15+01:00,['1c99c0ce151e4fa22a1998bf5e333df9cc4485ef'],1,2,3,2749664,1,1,1,1,6101
894e520cfd5ce7657b576d2ea5a1ff8deaa2303d,0,GitHub,2021-11-16 14:08:40+01:00,['babc54333c3f58e465e75d0f77eede23745634e8'],1,3,4,2749668,1,,,,6101
9ea9f0f8fc2c5cdc89caa84dc6487d47ccae669c,0,Randall Hauch,2021-11-16 09:39:51-06:00,['894e520cfd5ce7657b576d2ea5a1ff8deaa2303d'],4,4,8,2749676,1,,,0,6101
ffbef88cd7fba1b545002d9f9150eb1a36d5f81a,0,GitHub,2021-11-16 10:51:41-06:00,['9ea9f0f8fc2c5cdc89caa84dc6487d47ccae669c'],0,19,19,2749695,2,0,1,1,6101
d37aaf68de6b1bd62b87a36967375a4463cd751e,0,GitHub,2021-11-16 11:24:59-08:00,['ffbef88cd7fba1b545002d9f9150eb1a36d5f81a'],6,18,24,2749719,1,0,0,1,6101
30d1989db139ece5e5c7ecec0c4177e008e14003,0,GitHub,2021-11-16 17:34:49-08:00,['d37aaf68de6b1bd62b87a36967375a4463cd751e'],106,127,233,2749952,2,,,,6101
a448ddbecb5036baafea039325e644e8bf866507,0,GitHub,2021-11-17 11:17:26+01:00,['30d1989db139ece5e5c7ecec0c4177e008e14003'],0,11,11,2749963,2,1,1,1,6101
1b4cffdcb78c4dd31aa9e5c16b7c66f8a8dc72c8,0,GitHub,2021-11-17 03:05:19-08:00,['a448ddbecb5036baafea039325e644e8bf866507'],2,14,16,2749979,2,0,0,1,6101
ef94af1e8ad283800a9ff4aed20890db666d6e1d,0,GitHub,2021-11-17 18:14:02+01:00,['1b4cffdcb78c4dd31aa9e5c16b7c66f8a8dc72c8'],2,47,49,2750028,3,0.8,1,1,6102
06dfa54be758e8589e9ce9b2ee67c9721b5b0546,1,GitHub,2021-11-17 09:57:17-08:00,['ef94af1e8ad283800a9ff4aed20890db666d6e1d'],92,153,245,2750273,6,0,1,0.868421053,6102
c21c3ad3ee2a2421b2fcf1e3a50392b089825ab7,0,GitHub,2021-11-18 11:04:25+01:00,['06dfa54be758e8589e9ce9b2ee67c9721b5b0546'],1,1,2,2750275,1,,,,6102
051efc7b1a740ebe9f8fc3b167644ccf64396d50,0,GitHub,2021-11-18 11:52:10+01:00,['c21c3ad3ee2a2421b2fcf1e3a50392b089825ab7'],20,14,34,2750309,11,0.6,0.6,0.8,6102
67d21c494d4fd441f0c52eed4390a69eb605d9c6,0,GitHub,2021-11-18 12:14:57+01:00,['051efc7b1a740ebe9f8fc3b167644ccf64396d50'],11,8,19,2750328,2,,,,6102
0916622bcc04ba6fdbe2b58752c71c77341f2211,0,GitHub,2021-11-18 17:30:40+01:00,['67d21c494d4fd441f0c52eed4390a69eb605d9c6'],8,103,111,2750439,3,0.317073171,0.853658537,0.853658537,6103
9285820df066af002cc5b009a6829baade8f4bd6,0,GitHub,2021-11-18 18:14:36+01:00,['0916622bcc04ba6fdbe2b58752c71c77341f2211'],6,4,10,2750449,1,,,,6103
a96ff4ba23d64c92c593130a8a83943858f1517a,0,GitHub,2021-11-19 10:02:40+01:00,['9285820df066af002cc5b009a6829baade8f4bd6'],1,1,2,2750451,1,,,,6103
30a9085d505ac301acee18e4cdcc98d8060e0388,1,GitHub,2021-11-19 17:53:43+01:00,['a96ff4ba23d64c92c593130a8a83943858f1517a'],7,35,42,2750493,4,0.923076923,0.923076923,0,6103
074a03cca162f91ccdecc12eb84c6a45af75f6bf,0,GitHub,2021-11-19 09:28:19-08:00,['30a9085d505ac301acee18e4cdcc98d8060e0388'],26,3,29,2750522,3,1,0,0,6103
c1071327c50613ae8647f1fa98f00f78a0cb5d76,0,GitHub,2021-11-22 10:15:04+01:00,['074a03cca162f91ccdecc12eb84c6a45af75f6bf'],1,1,2,2750524,1,,,,6103
c0b2afb353c9b2bd8e4fccd40c0655670f75cedc,1,GitHub,2021-11-22 14:41:24+01:00,['c1071327c50613ae8647f1fa98f00f78a0cb5d76'],4,69,73,2750597,1,,,,6103
76ac43bbe55b8a657bf83e78c420cbcefaa9d120,0,GitHub,2021-11-22 13:46:30-08:00,['c0b2afb353c9b2bd8e4fccd40c0655670f75cedc'],49,62,111,2750708,1,0,1,0,6103
1e0916580f16b99b911b0ed36e9740dcaeef520e,0,GitHub,2021-11-22 21:34:59-06:00,['76ac43bbe55b8a657bf83e78c420cbcefaa9d120'],381,241,622,2751330,30,0.175438596,0.631578947,1,6103
28dcbad007e64275df98868e7f79133fad0cba9e,1,GitHub,2021-11-24 09:30:43+01:00,['1e0916580f16b99b911b0ed36e9740dcaeef520e'],7,50,57,2751387,2,0.552631579,1,1,6103
e8b53caab475a976fc2ce97d4b41977752b64633,0,José Armando García Sancio,2021-11-24 11:06:09-07:00,['28dcbad007e64275df98868e7f79133fad0cba9e'],41,321,362,2751749,8,0.778761062,0.911504425,0.973451327,6106
0f967828e1d610ab140be1a3f04279b872df7e3c,0,José Armando García Sancio,2021-11-24 12:38:27-07:00,['e8b53caab475a976fc2ce97d4b41977752b64633'],1,23,24,2751773,1,0,0,1,6106
23e9818e625976c22fe6d4297a5ab76b01f92ef6,0,GitHub,2021-11-24 18:28:00-06:00,['0f967828e1d610ab140be1a3f04279b872df7e3c'],0,307,307,2752080,7,0.684848485,0.945454545,0.951515152,6109
908461a07eee9348bd81c183b15f5c3fe7bbd254,0,GitHub,2021-11-25 10:20:32+01:00,['23e9818e625976c22fe6d4297a5ab76b01f92ef6'],5,5,10,2752090,1,,,,6109
4fed0001ec1ddbfd1f8fc9af75007e89ef40ea8d,0,GitHub,2021-11-25 10:48:09+01:00,['908461a07eee9348bd81c183b15f5c3fe7bbd254'],2,10,12,2752102,2,,,,6109
6a56fc57d21ea38fdd0a387a72864c58f05c8fab,0,GitHub,2021-11-25 10:56:47-07:00,['4fed0001ec1ddbfd1f8fc9af75007e89ef40ea8d'],0,4,4,2752106,1,0,0,1,6109
6c59d2d68580c9ecc5af7502d3e3412f2acca9ba,0,GitHub,2021-11-29 08:49:36+01:00,['6a56fc57d21ea38fdd0a387a72864c58f05c8fab'],2,2,4,2752110,1,,,,6109
cec4d231fffda1a34cacd1f36d98f2a18e4772ef,0,GitHub,2021-11-29 10:42:14+01:00,['6c59d2d68580c9ecc5af7502d3e3412f2acca9ba'],38,38,76,2752186,2,1,0,1,6109
b6e7f6a4dfa5cee667e64014bb653f918c130017,0,GitHub,2021-11-29 18:49:14+08:00,['cec4d231fffda1a34cacd1f36d98f2a18e4772ef'],1,1,2,2752188,1,,,,6109
a9891497314339057bbcfbd43c7715db8d16500e,0,GitHub,2021-11-29 16:37:51+01:00,['b6e7f6a4dfa5cee667e64014bb653f918c130017'],6,9,15,2752203,6,,,,6109
e8dcbb99bb3289193a9036599d87acd56e11499f,0,GitHub,2021-11-29 11:26:08-08:00,['a9891497314339057bbcfbd43c7715db8d16500e'],19,157,176,2752379,3,0,1,0.99009901,6109
f875576f218c90bc4a682a641ff149d66f75e0b8,0,GitHub,2021-11-30 10:35:50-06:00,['e8dcbb99bb3289193a9036599d87acd56e11499f'],10,149,159,2752538,3,0.202020202,0.95959596,1,6109
d1e0d2b474b0bdb0b0141b6d341ce77dd331a8d4,0,GitHub,2021-11-30 18:42:41+01:00,['f875576f218c90bc4a682a641ff149d66f75e0b8'],0,5,5,2752543,2,,,,6109
42306ba267aba684f7377bd78db90fdc4139546f,0,GitHub,2021-11-30 11:44:39-07:00,['d1e0d2b474b0bdb0b0141b6d341ce77dd331a8d4'],284,377,661,2753204,14,,,,6111
1bf418beafa55204ca75c728cdf3128152482fb2,0,GitHub,2021-11-30 17:29:36-08:00,['42306ba267aba684f7377bd78db90fdc4139546f'],1,1,2,2753206,1,,,,6111
62f73c30d3b156a440bd0e4ac2c5491869c83ba5,1,GitHub,2021-12-01 11:49:10-06:00,['1bf418beafa55204ca75c728cdf3128152482fb2'],6,269,275,2753481,13,0.352941176,0.835294118,0.894117647,6111
da56146c60cf016966b119ea63eb2cfa60f03ad4,0,GitHub,2021-12-02 22:10:37+00:00,['62f73c30d3b156a440bd0e4ac2c5491869c83ba5'],3,12,15,2753496,2,0,0,0,6111
fd9fdd8dac69f342dfc834eff73a9a73893f1df2,1,GitHub,2021-12-03 09:55:33+01:00,['da56146c60cf016966b119ea63eb2cfa60f03ad4'],5,92,97,2753593,3,,,,6111
14c24490505090b0bedeabd891542915692501be,1,GitHub,2021-12-03 12:53:31-06:00,['fd9fdd8dac69f342dfc834eff73a9a73893f1df2'],235,2836,3071,2756664,44,0.523664122,0.877862595,0.83129771,6126
965ec40c0a282bc311c702c6eb795689ec7ddfa5,0,GitHub,2021-12-03 11:32:55-08:00,['14c24490505090b0bedeabd891542915692501be'],38,452,490,2757154,7,0.081632653,0.648979592,0.995918367,6128
a957748d2e0de872e881ec17f6cc27ada7ab7cd9,1,Colin P. McCabe,2021-12-05 16:32:56-08:00,['965ec40c0a282bc311c702c6eb795689ec7ddfa5'],42,232,274,2757428,9,0.558441558,0.688311688,1,6131
d93c4123eff6402db36abef275ceefca323e646e,0,GitHub,2021-12-05 18:49:30-08:00,['a957748d2e0de872e881ec17f6cc27ada7ab7cd9'],161,0,161,2757589,1,,,,6131
a2da309f134ec2930f70f1a3917eaade7548132f,0,GitHub,2021-12-06 17:08:26-08:00,['d93c4123eff6402db36abef275ceefca323e646e'],9,9,18,2757607,1,,,0,6131
68c3018a5a1b7048fd410ea8233831a2426c320e,0,GitHub,2021-12-07 18:23:52+01:00,['a2da309f134ec2930f70f1a3917eaade7548132f'],24,37,61,2757668,1,0,1,1,6131
9e579587acc1678d0f69b7a57df375310267f6ec,0,GitHub,2021-12-07 18:24:43+01:00,['68c3018a5a1b7048fd410ea8233831a2426c320e'],6,1,7,2757675,2,,,,6131
7acd12d6e3550d5e3768215e5bd64487c0a2ae7e,1,GitHub,2021-12-08 11:58:35-06:00,['9e579587acc1678d0f69b7a57df375310267f6ec'],346,1657,2003,2759678,40,0.333761232,0.998716303,0.883183569,6135
e14499948eb6ac94bf7f7d66b8848077ee7b2191,0,GitHub,2021-12-08 13:57:08-08:00,['7acd12d6e3550d5e3768215e5bd64487c0a2ae7e'],3,8,11,2759689,2,1,1,1,6135
ddb6959c6272d2039ed8c9f595634c3c9573f85e,0,GitHub,2021-12-08 20:36:53-08:00,['e14499948eb6ac94bf7f7d66b8848077ee7b2191'],90,225,315,2760004,4,1,1,0.660714286,6136
e20f102298cc3e056e079cbd1cb33913a9ade0ce,1,GitHub,2021-12-09 03:54:28-08:00,['ddb6959c6272d2039ed8c9f595634c3c9573f85e'],19,397,416,2760420,8,0.672340426,0.736170213,0.54893617,6138
f6360d1dc12269c346f51799bf542fe133dcfc78,0,GitHub,2021-12-09 15:06:37+01:00,['e20f102298cc3e056e079cbd1cb33913a9ade0ce'],357,201,558,2760978,4,1,0.336633663,0.089108911,6138
133b515b5e95a7ce511f442eb6d7892b506af27c,0,GitHub,2021-12-09 09:42:00-05:00,['f6360d1dc12269c346f51799bf542fe133dcfc78'],2,39,41,2761019,2,0.965517241,1,0.965517241,6138
e1dba7af57ec69eb2bbf5a8f4d009502139f0e24,0,GitHub,2021-12-09 13:23:01-06:00,['133b515b5e95a7ce511f442eb6d7892b506af27c'],30,3,33,2761052,6,1,0,0,6138
d5eb3c10ecd394015336868f948348c62c0e4e77,0,GitHub,2021-12-09 16:19:56-08:00,['e1dba7af57ec69eb2bbf5a8f4d009502139f0e24'],16,26,42,2761094,1,0,0,1,6138
d565c969f33e00ed91ce2da3f9b150d6999ab0e7,1,GitHub,2021-12-10 18:54:52+01:00,['d5eb3c10ecd394015336868f948348c62c0e4e77'],802,1069,1871,2762965,3,0.906103286,1,1,6138
0c01ab67a034a9454fdd1e0c791c56c5466d9ff4,0,José Armando García Sancio,2021-12-10 10:52:33-08:00,['d565c969f33e00ed91ce2da3f9b150d6999ab0e7'],93,100,193,2763158,1,0.333333333,0.333333333,0.333333333,6138
454d63c158dcf778bf12b412063341f2dd3e3088,1,GitHub,2021-12-10 12:29:58-08:00,['0c01ab67a034a9454fdd1e0c791c56c5466d9ff4'],283,425,708,2763866,9,0.564814815,0.981481481,0.777777778,6138
ff6cf670f49301a325342b6d7b598a1b462a012c,1,GitHub,2021-12-10 13:28:57-08:00,['454d63c158dcf778bf12b412063341f2dd3e3088'],159,482,641,2764507,21,0.137254902,0.780392157,0.992156863,6138
1e459271d777e4721c3f7a36c5b4fbb2a5793f63,0,GitHub,2021-12-10 14:26:27-08:00,['ff6cf670f49301a325342b6d7b598a1b462a012c'],14,51,65,2764572,5,0.925925926,1,1,6138
2cd96f0e64f8a4f4b74e8049a6c527a990cb4777,0,Colin P. McCabe,2021-12-10 15:29:50-08:00,['1e459271d777e4721c3f7a36c5b4fbb2a5793f63'],34,24,58,2764630,5,1,0,0.6,6138
acd1f9c5631ed2aec2d6ab238e6b81c1a9eb47a2,1,GitHub,2021-12-11 01:00:59-06:00,['2cd96f0e64f8a4f4b74e8049a6c527a990cb4777'],153,327,480,2765110,24,0.201492537,0.962686567,0.574626866,6138
065fba96198074ab473e4734ae29084d3681084a,0,GitHub,2021-12-14 10:01:58+00:00,['acd1f9c5631ed2aec2d6ab238e6b81c1a9eb47a2'],13,74,87,2765197,4,0.095238095,0.547619048,0.880952381,6138
b4602e88ef96c6f3a1a4bf99164a1e333fe34b8b,0,GitHub,2021-12-15 15:25:16+01:00,['065fba96198074ab473e4734ae29084d3681084a'],2,5,7,2765204,1,1,1,1,6138
0e150a4cfaaa49e4400198f1cb0da427238f670b,0,GitHub,2021-12-15 14:30:39+00:00,['b4602e88ef96c6f3a1a4bf99164a1e333fe34b8b'],0,1,1,2765205,1,1,1,1,6138
04787334a52f9ebde5007ba72162001aee73d271,0,GitHub,2021-12-15 19:43:40-08:00,['0e150a4cfaaa49e4400198f1cb0da427238f670b'],3,3,6,2765211,2,,,,6138
f653cb7b5889fd619ab0e6a25216bd981a9d82bf,0,GitHub,2021-12-16 15:44:39+01:00,['04787334a52f9ebde5007ba72162001aee73d271'],7,117,124,2765335,3,0,1,1,6139
b38f6ba5cc989702180f5d5f8e55ba20444ea884,1,GitHub,2021-12-16 11:09:01-06:00,['f653cb7b5889fd619ab0e6a25216bd981a9d82bf'],28,553,581,2765916,9,0.240677966,0.73559322,0.383050847,6140
247c271353752a588162983a1a6f7eb96cf9870f,0,GitHub,2021-12-16 19:39:55-08:00,['b38f6ba5cc989702180f5d5f8e55ba20444ea884'],0,6,6,2765922,1,0,0,1,6140
33853c154ff24ab4e68efa23893646f093c6333f,0,Gwen Shapira,2021-12-17 11:51:02-08:00,['247c271353752a588162983a1a6f7eb96cf9870f'],4,12,16,2765938,2,0.25,0.5,1,6140
c219fba421fde142729a42da038a8e747b71cca4,1,GitHub,2021-12-17 15:36:12-08:00,['33853c154ff24ab4e68efa23893646f093c6333f'],36,132,168,2766106,4,0.578125,0.96875,0.9375,6140
8cca18d7b99d5905a84ccabb813d6a27bc8f44db,0,GitHub,2021-12-17 16:02:24-08:00,['c219fba421fde142729a42da038a8e747b71cca4'],1,2,3,2766109,1,1,1,1,6140
d4d8a1deb7a80922ad93161e304208ec1320f25c,0,GitHub,2021-12-17 16:32:01-08:00,['8cca18d7b99d5905a84ccabb813d6a27bc8f44db'],1,0,1,2766110,1,0,0,0,6140
272e0114643bcf7aa203173e8b9b971770d7ad59,0,GitHub,2021-12-20 10:32:23+01:00,['d4d8a1deb7a80922ad93161e304208ec1320f25c'],3,3,6,2766116,1,,,,6140
e82df8396897b28946ab2df5473a1947cb84be7a,0,GitHub,2021-12-20 18:34:20+01:00,['272e0114643bcf7aa203173e8b9b971770d7ad59'],1,1,2,2766118,1,,,,6140
57477886593a60cd92cc50b5722788f9ac1c3d7a,1,GitHub,2021-12-20 12:22:05-06:00,['e82df8396897b28946ab2df5473a1947cb84be7a'],177,276,453,2766571,9,0.309859155,0.957746479,0.028169014,6141
018fb88efa8bc5641c74a49f0531842a32b4287e,0,GitHub,2021-12-20 19:04:08-06:00,['57477886593a60cd92cc50b5722788f9ac1c3d7a'],99,349,448,2767019,6,0.833333333,0.833333333,0.333333333,6145
394175688a76d52d1895c4419711edb4b47bfd47,0,GitHub,2021-12-22 09:22:32+01:00,['018fb88efa8bc5641c74a49f0531842a32b4287e'],12,13,25,2767044,1,,,,6145
be60fe56cc1b68244c1f46a77678275a54e05668,0,GitHub,2021-12-23 21:15:24+01:00,['394175688a76d52d1895c4419711edb4b47bfd47'],2,2,4,2767048,1,,,,6145
b8f1cf14c396ab04b8968a8fa04d8cf67dd3254c,1,GitHub,2022-01-02 22:17:38-06:00,['be60fe56cc1b68244c1f46a77678275a54e05668'],102,1031,1133,2768181,17,0.139465875,0.853115727,0.416913947,6147
fb01c1376f8e6fb0292a60d7f5ad37e58b682d93,0,GitHub,2022-01-04 11:10:34+01:00,['b8f1cf14c396ab04b8968a8fa04d8cf67dd3254c'],14,23,37,2768218,1,,,,6147
2518c37f9a2c3bf478bbe69d571e22527824adfd,0,GitHub,2022-01-04 15:47:03-08:00,['fb01c1376f8e6fb0292a60d7f5ad37e58b682d93'],0,10,10,2768228,2,0,1,1,6147
daaa9dfb54b86ccb93cc2018b374476dcb0beed1,0,GitHub,2022-01-05 10:37:23-08:00,['2518c37f9a2c3bf478bbe69d571e22527824adfd'],1,3,4,2768232,1,0,1,0,6147
99d9e8f7fc90f08b99bdf0ec8eefbbf1b6c356ee,0,GitHub,2022-01-05 17:03:50-08:00,['daaa9dfb54b86ccb93cc2018b374476dcb0beed1'],2,3,5,2768237,1,,,,6147
7ef8701cca92d8d4ecf07b2b12832aaafb8a5331,1,GitHub,2022-01-05 21:04:37-06:00,['99d9e8f7fc90f08b99bdf0ec8eefbbf1b6c356ee'],110,238,348,2768585,2,0,1,0.96969697,6147
b424553101c56547beafab2ae39f16671fc05c9e,0,GitHub,2022-01-05 23:16:33-06:00,['7ef8701cca92d8d4ecf07b2b12832aaafb8a5331'],8,121,129,2768714,1,0,1,1,6147
7567cbc857eef4f535410a8f6256308197c3b9c8,0,GitHub,2022-01-05 21:38:10-08:00,['b424553101c56547beafab2ae39f16671fc05c9e'],9,21,30,2768744,2,0,1,1,6147
7530ac65834d98ae4f30fb32c50795b17f01b356,1,GitHub,2022-01-05 21:53:54-08:00,['7567cbc857eef4f535410a8f6256308197c3b9c8'],92,190,282,2769026,7,0,1,0.857142857,6147
0b9a8bac36f16b5397e9ec3a0441758e4b60a384,0,GitHub,2022-01-06 09:22:19+00:00,['7530ac65834d98ae4f30fb32c50795b17f01b356'],3,20,23,2769049,2,1,1,1,6147
6b135bb59b4b80e47468efc00ca909497e53fb79,0,GitHub,2022-01-06 09:59:31-08:00,['0b9a8bac36f16b5397e9ec3a0441758e4b60a384'],29,66,95,2769144,3,0.769230769,1,1,6147
8e301b48e937198c65a058518dc7551488aac8fc,1,GitHub,2022-01-06 10:28:36-08:00,['6b135bb59b4b80e47468efc00ca909497e53fb79'],22,85,107,2769251,9,0.205882353,0.882352941,0.764705882,6147
9078451e37a5e8bc8cd0c9865837fe5379e8f2d0,0,GitHub,2022-01-06 11:28:27-08:00,['8e301b48e937198c65a058518dc7551488aac8fc'],5,24,29,2769280,1,0.111111111,0.222222222,1,6147
ff3ec47b7928a1ba262d7bdc4786eff1d9122ed8,0,GitHub,2022-01-06 14:01:40-08:00,['9078451e37a5e8bc8cd0c9865837fe5379e8f2d0'],7,8,15,2769295,1,,,,6147
aaa546df7a2f2c6cff79f6f2593b1434f65adf50,0,GitHub,2022-01-06 14:53:35-08:00,['ff3ec47b7928a1ba262d7bdc4786eff1d9122ed8'],9,13,22,2769317,1,,,,6147
1785e1223eb2ce6b6c00af8b6ab406f60795f593,0,GitHub,2022-01-10 20:54:26+01:00,['aaa546df7a2f2c6cff79f6f2593b1434f65adf50'],6,11,17,2769334,1,1,1,1,6147
c182a431d224cb39c0bb43a55199e2d8b4aee1b7,0,GitHub,2022-01-10 16:08:48-08:00,['1785e1223eb2ce6b6c00af8b6ab406f60795f593'],25,129,154,2769488,12,0.670731707,1,0.890243902,6147
1aa26faf8889005d65e338540e888b60ef5a611f,0,GitHub,2022-01-11 21:48:39-08:00,['c182a431d224cb39c0bb43a55199e2d8b4aee1b7'],26,58,84,2769572,2,1,1,1,6147
bd9e484087059ea8ddfc86ada10844358623afa0,0,GitHub,2022-01-12 09:46:50+01:00,['1aa26faf8889005d65e338540e888b60ef5a611f'],1,1,2,2769574,1,,,,6147
5c7cf29c150631e7572934c69b3685d34c56f2ab,1,GitHub,2022-01-13 11:24:50+01:00,['bd9e484087059ea8ddfc86ada10844358623afa0'],288,583,871,2770445,12,1,0.9375,1,6148
69645f1fe5103adb00de6fa43152e7df989f3aea,1,GitHub,2022-01-13 16:01:37+01:00,['5c7cf29c150631e7572934c69b3685d34c56f2ab'],28,136,164,2770609,11,0.253731343,0.850746269,0.656716418,6148
bf609694f83931990ce63e0123f811e6475820c5,1,GitHub,2022-01-13 16:06:11+01:00,['69645f1fe5103adb00de6fa43152e7df989f3aea'],11,103,114,2770723,9,0,0.981818182,1,6148
30c9087d7454735ea6f80285550ab365591b23e0,0,GitHub,2022-01-14 10:32:07+01:00,['bf609694f83931990ce63e0123f811e6475820c5'],2,2,4,2770727,2,,,,6148
c45cf35d306c18d887f3676733420c078a898cf4,0,GitHub,2022-01-17 10:20:53+01:00,['30c9087d7454735ea6f80285550ab365591b23e0'],9,3,12,2770739,1,0.25,0,0,6148
529dde904a892ba2f95e6150066758e7476f15e3,0,GitHub,2022-01-18 11:49:23-08:00,['c45cf35d306c18d887f3676733420c078a898cf4'],91,218,309,2771048,6,0.088888889,0.966666667,1,6148
ed8b7875fed82feccec3d35aa700cce1ea5138f9,0,GitHub,2022-01-19 09:53:28+01:00,['529dde904a892ba2f95e6150066758e7476f15e3'],22,332,354,2771402,2,0.683937824,0.839378238,0.917098446,6149
a945bd45b85dee6a2d90833e365f1b48c11d66e4,0,GitHub,2022-01-19 11:37:47-08:00,['ed8b7875fed82feccec3d35aa700cce1ea5138f9'],4,6,10,2771412,1,0,1,1,6149
df2236d73bc630a588adc049e7e63a4a5095da32,1,GitHub,2022-01-19 13:20:41-08:00,['a945bd45b85dee6a2d90833e365f1b48c11d66e4'],318,421,739,2772151,9,1,1,0.433962264,6149
3dd3f3ef035501816efac23c32d517bf62fdaa56,0,GitHub,2022-01-20 14:14:44+01:00,['df2236d73bc630a588adc049e7e63a4a5095da32'],1,1,2,2772153,1,,,,6149
7d9b9847f184ec72c4c80c046edc408789dcc066,0,GitHub,2022-01-20 09:26:38-08:00,['3dd3f3ef035501816efac23c32d517bf62fdaa56'],35,229,264,2772417,6,0.348148148,1,0.844444444,6150
ebe0ede5ede3c6b267b34b97d6e449b52a243f65,0,GitHub,2022-01-21 17:38:40+01:00,['7d9b9847f184ec72c4c80c046edc408789dcc066'],11,10,21,2772438,1,1,0,0,6150
33a004ab6270c3e30c15fb555a50113131debff5,0,GitHub,2022-01-21 17:44:56+01:00,['ebe0ede5ede3c6b267b34b97d6e449b52a243f65'],4,37,41,2772479,3,1,1,0.933333333,6150
448e44a7344f9014ebd867abadff3c3cd40ad5b4,0,GitHub,2022-01-21 10:07:20-08:00,['33a004ab6270c3e30c15fb555a50113131debff5'],0,6,6,2772485,1,0,1,1,6150
486cbd479365f44167316a5214f5c6eb499ea010,0,GitHub,2022-01-21 10:09:11-08:00,['448e44a7344f9014ebd867abadff3c3cd40ad5b4'],1,1,2,2772487,1,,,,6150
34208e84290af742a7be865eaee9819ea4e40021,0,GitHub,2022-01-21 21:30:56+01:00,['486cbd479365f44167316a5214f5c6eb499ea010'],0,12,12,2772499,3,,,,6150
68a19539cf1fcd86787960d0010b672d0d611b91,1,GitHub,2022-01-21 17:00:21-07:00,['34208e84290af742a7be865eaee9819ea4e40021'],266,1617,1883,2774382,22,0.292806484,0.714285714,0.819655522,6152
4ceb2191e1c5e13f64300b4377eb9cd7a23b3753,0,GitHub,2022-01-24 17:08:03+01:00,['68a19539cf1fcd86787960d0010b672d0d611b91'],1,1,2,2774384,1,,,,6152
d13d09fb682356a3013ca531c769e92a664657db,0,GitHub,2022-01-24 21:03:37-08:00,['4ceb2191e1c5e13f64300b4377eb9cd7a23b3753'],29,29,58,2774442,8,,,,6152
265d3199ec741928c1731397302f6c320cf6af40,0,GitHub,2022-01-25 05:49:23-08:00,['d13d09fb682356a3013ca531c769e92a664657db'],283,627,910,2775352,19,0.277108434,0.851405622,0.891566265,6153
110fae2f59f85e8273c2aad3a6e43bd1bd516813,0,GitHub,2022-01-25 16:22:48+01:00,['265d3199ec741928c1731397302f6c320cf6af40'],5,23,28,2775380,5,,,,6153
9d602a01beb0a9467c43b9ee0b80ff53fdd2dbb4,1,GitHub,2022-01-25 10:37:35-08:00,['110fae2f59f85e8273c2aad3a6e43bd1bd516813'],298,314,612,2775992,10,1,0,0,6153
96fa468106f538ca83973ce040e6cfe900f389ed,0,GitHub,2022-01-25 13:23:46-06:00,['9d602a01beb0a9467c43b9ee0b80ff53fdd2dbb4'],18,115,133,2776125,10,0,0.396551724,0.793103448,6154
868cbcb8e54493a60668bdb433b2821d64d9bb97,0,GitHub,2022-01-25 13:46:20-06:00,['96fa468106f538ca83973ce040e6cfe900f389ed'],18,17,35,2776160,4,1,0,1,6154
5b12d8a59537f563f6236807ec753618b782a476,0,GitHub,2022-01-26 08:14:00+01:00,['868cbcb8e54493a60668bdb433b2821d64d9bb97'],43,58,101,2776261,1,0.705882353,1,0.941176471,6154
da25add383b3c855bfaa7cd12eff84539fe27e38,1,GitHub,2022-01-25 23:38:11-08:00,['5b12d8a59537f563f6236807ec753618b782a476'],119,181,300,2776561,6,1,0.594594595,0,6154
000ba031c3d1135cb0e1fe6438d1e464ff10b6b0,1,GitHub,2022-01-26 11:51:10+01:00,['da25add383b3c855bfaa7cd12eff84539fe27e38'],2,151,153,2776714,3,0,0.973214286,1,6154
fe72187cb15bf7dcc16e8630ed379e979c101151,0,GitHub,2022-01-26 09:36:39-06:00,['000ba031c3d1135cb0e1fe6438d1e464ff10b6b0'],127,428,555,2777269,45,0.31884058,0.797101449,0.550724638,6155
dd58f81b2549a7a7965f701940a9d577f2e1f3f9,0,GitHub,2022-01-26 18:30:56+01:00,['fe72187cb15bf7dcc16e8630ed379e979c101151'],2,2,4,2777273,1,,,,6155
e51ebb8a0ab5e9322572fae6bfcdfac74a603e87,0,GitHub,2022-01-26 12:54:07-08:00,['dd58f81b2549a7a7965f701940a9d577f2e1f3f9'],187,185,372,2777645,9,0,1,0.5,6155
5eef6b269d86944798001f2a9a7361498d6a25fc,1,GitHub,2022-01-27 08:21:57+01:00,['e51ebb8a0ab5e9322572fae6bfcdfac74a603e87'],8,81,89,2777734,3,0.111111111,0.984126984,0.984126984,6155
1a218926636d2d0f31b4ad402f8d26c2ad8d9838,0,GitHub,2022-01-27 09:25:04-06:00,['5eef6b269d86944798001f2a9a7361498d6a25fc'],190,1281,1471,2779205,30,0.20441989,0.928176796,0.812154696,6157
9f2f63e3a118acb334b6ca755392da06c938f2e5,0,GitHub,2022-01-27 19:17:59+01:00,['1a218926636d2d0f31b4ad402f8d26c2ad8d9838'],11,94,105,2779310,5,0.843137255,0.843137255,0.607843137,6157
a21aec8d6287f170ccb2568eadde515980dd597c,0,GitHub,2022-01-27 14:59:21-08:00,['9f2f63e3a118acb334b6ca755392da06c938f2e5'],38,119,157,2779467,14,0.06557377,0.983606557,1,6157
af377b5f30e7cff691bb50f67c3e9a1cd040fe32,0,GitHub,2022-01-27 20:40:43-08:00,['a21aec8d6287f170ccb2568eadde515980dd597c'],7,27,34,2779501,4,0,0.727272727,0.818181818,6157
14c6030c6ad70997863070f5b93c817ea8829425,0,GitHub,2022-01-27 21:19:04-08:00,['af377b5f30e7cff691bb50f67c3e9a1cd040fe32'],297,966,1263,2780764,66,0.187122736,0.947686117,0.867203219,6157
7215c90c5e9086126cbecbb5d8b3bfee22f6d1fa,0,GitHub,2022-01-28 10:06:31+01:00,['14c6030c6ad70997863070f5b93c817ea8829425'],6,2519,2525,2783289,14,0.201530612,0.556122449,0.596938776,6167
98e860864673e43d088f642cee3085e22b94df2f,0,GitHub,2022-01-30 23:15:58+08:00,['7215c90c5e9086126cbecbb5d8b3bfee22f6d1fa'],1,1,2,2783291,1,,,,6167
a47dae4622a25d7ca094c32ef36cf234a6c61cca,0,GitHub,2022-01-31 10:34:11+01:00,['98e860864673e43d088f642cee3085e22b94df2f'],5,45,50,2783341,2,0.086956522,1,1,6167
31081e6ec4bdd35f443b5b8ead127fc32e4c3ec2,0,GitHub,2022-02-01 11:03:43+01:00,['a47dae4622a25d7ca094c32ef36cf234a6c61cca'],3,1,4,2783345,1,0,0,0,6167
830d83e2cde4f33735128b533cacc8b8ea23a2c0,0,GitHub,2022-02-01 11:09:04+01:00,['31081e6ec4bdd35f443b5b8ead127fc32e4c3ec2'],6,6,12,2783357,2,,,,6167
31fca1611a6780e8a8aa3ac21618135201718e32,1,GitHub,2022-02-01 18:53:30+01:00,['830d83e2cde4f33735128b533cacc8b8ea23a2c0'],14,48,62,2783419,9,0.32,1,1,6167
3b534e1c7d098a8dc7e08f95c2611b53fa40f522,0,GitHub,2022-02-01 18:56:04+01:00,['31fca1611a6780e8a8aa3ac21618135201718e32'],15,137,152,2783571,2,0.174757282,0.708737864,1,6167
67cf187603f54ba4f53f0b9eb93b269430f829db,0,Matthias J. Sax,2022-02-01 14:08:11-08:00,['3b534e1c7d098a8dc7e08f95c2611b53fa40f522'],966,297,1263,2784834,66,0.812877264,0.052313883,0.132796781,6167
ec05f90a3d18637bb9a50da09d75ffdb0485c918,0,GitHub,2022-02-02 10:56:14+01:00,['67cf187603f54ba4f53f0b9eb93b269430f829db'],1,99,100,2784934,2,1,1,1,6167
cc3d22cc3b8240a6f72f62b556fa18ba48768c2b,0,GitHub,2022-02-02 05:47:05-08:00,['ec05f90a3d18637bb9a50da09d75ffdb0485c918'],108,157,265,2785199,3,,,,6167
4101be51aa2331b11d19707b641e4df159d7aef1,0,GitHub,2022-02-02 05:59:13-08:00,['cc3d22cc3b8240a6f72f62b556fa18ba48768c2b'],6,0,6,2785205,2,1,1,0,6167
c1896e0bdcb1cf3dc221cf858aa1bb0d9f709bed,0,GitHub,2022-02-02 06:02:57-08:00,['4101be51aa2331b11d19707b641e4df159d7aef1'],7,6,13,2785218,1,1,0,0,6167
756fa1c7f3666da881a7138acae0af7fc37f926e,0,GitHub,2022-02-02 06:10:07-08:00,['c1896e0bdcb1cf3dc221cf858aa1bb0d9f709bed'],0,2,2,2785220,1,0,0,1,6167
9f42739dd32e48aa583780f67e34284cc8cc9505,0,GitHub,2022-02-02 06:11:56-08:00,['756fa1c7f3666da881a7138acae0af7fc37f926e'],3,13,16,2785236,1,0.166666667,0.166666667,1,6167
915991445fde106d02e61a70425ae2601c813db0,1,GitHub,2022-02-02 11:57:13-08:00,['9f42739dd32e48aa583780f67e34284cc8cc9505'],101,437,538,2785774,30,0.126482213,0.988142292,0.861660079,6167
0ab36e8b104ce4947f7e6fe04dc8fd80235deb22,0,GitHub,2022-02-02 14:21:25-08:00,['915991445fde106d02e61a70425ae2601c813db0'],1,1,2,2785776,1,,,,6167
319732dbeb08aa7926175cbaf4dfa8a05c52ac18,1,GitHub,2022-02-02 16:03:32-08:00,['0ab36e8b104ce4947f7e6fe04dc8fd80235deb22'],6,62,68,2785844,4,0.090909091,0.939393939,1,6167
af6a9a17bffe654096d21190b3742e8835b2fccf,1,GitHub,2022-02-03 10:32:25+01:00,['319732dbeb08aa7926175cbaf4dfa8a05c52ac18'],4,58,62,2785906,2,0.525,1,1,6167
23771cd27c7bfea30c12a5c278d8096becbb7e47,0,GitHub,2022-02-03 10:54:54+01:00,['af6a9a17bffe654096d21190b3742e8835b2fccf'],3,3,6,2785912,1,,,,6167
3781117653062a8ed16e9c58d7f4b8c3144a8603,0,GitHub,2022-02-03 10:57:21+01:00,['23771cd27c7bfea30c12a5c278d8096becbb7e47'],8,8,16,2785928,1,,,,6167
21c3009ac12f79d01daa073ed104956e3f7ff04a,0,GitHub,2022-02-03 10:59:12+01:00,['3781117653062a8ed16e9c58d7f4b8c3144a8603'],3,3,6,2785934,1,,,,6167
d4fb388583c1b0221ee22d75dbc364d95a7b2a2c,0,GitHub,2022-02-03 10:08:00-08:00,['21c3009ac12f79d01daa073ed104956e3f7ff04a'],1,1,2,2785936,1,,,,6167
17dcb8097c1983ca9d26c36f780b484fa7c86035,0,GitHub,2022-02-04 16:20:37-08:00,['d4fb388583c1b0221ee22d75dbc364d95a7b2a2c'],30,31,61,2785997,4,,,,6167
e6db0ca48c42c03655e3781b46ac09dae75cf33e,1,GitHub,2022-02-05 10:53:27-08:00,['17dcb8097c1983ca9d26c36f780b484fa7c86035'],121,313,434,2786431,15,0,1,0.952380952,6167
ba0fe610eddf2710cdb404f198a9886c01293de3,0,GitHub,2022-02-05 11:00:17-08:00,['e6db0ca48c42c03655e3781b46ac09dae75cf33e'],23,43,66,2786497,6,0.476190476,1,0.476190476,6167
f49524e4c315e47f6a29cf330db8755fb6d51c57,0,GitHub,2022-02-06 03:34:22+08:00,['ba0fe610eddf2710cdb404f198a9886c01293de3'],1,11,12,2786509,2,0.875,1,1,6167
c05403f47fa4e6a8244b56c2287b64a42b968292,0,GitHub,2022-02-06 13:36:44-08:00,['f49524e4c315e47f6a29cf330db8755fb6d51c57'],12,163,175,2786684,3,0.721311475,1,1,6168
ca5d6f9229c170beb23809159113037f05a1120f,0,GitHub,2022-02-06 15:07:59-08:00,['c05403f47fa4e6a8244b56c2287b64a42b968292'],147,74,221,2786905,4,1,0.068493151,0.04109589,6168
b125a06c4625b106c7d743d602b9147b1951eac6,0,GitHub,2022-02-07 06:42:30-08:00,['ca5d6f9229c170beb23809159113037f05a1120f'],460,14,474,2787379,4,0.493333333,0.493333333,0.56,6168
f1fdd31e8f0fd3145aeb86fb561e97e99672a623,1,GitHub,2022-02-07 09:53:10-08:00,['b125a06c4625b106c7d743d602b9147b1951eac6'],4,46,50,2787429,2,1,1,0.666666667,6168
7c2d6724130f8251aa255917b74d9c3ef1fe67f7,1,GitHub,2022-02-07 15:24:50-08:00,['f1fdd31e8f0fd3145aeb86fb561e97e99672a623'],27,27,54,2787483,6,,,,6168
44fcba980fb6fd245c4fa105f18458e30e19aa55,0,GitHub,2022-02-08 18:03:57+01:00,['7c2d6724130f8251aa255917b74d9c3ef1fe67f7'],1,1,2,2787485,1,,,,6168
ca375d8004c1ef070394d29028744d68b6feebd0,1,GitHub,2022-02-08 11:03:19-08:00,['44fcba980fb6fd245c4fa105f18458e30e19aa55'],33,40,73,2787558,2,,,,6168
61b0014ec968b396af502742bacfb0675deb055d,0,GitHub,2022-02-08 12:43:45-08:00,['ca375d8004c1ef070394d29028744d68b6feebd0'],45,45,90,2787648,1,,,,6168
4b468a9d81f7380f7197a2a6b859c1b4dca84bd9,1,GitHub,2022-02-08 23:05:42-08:00,['61b0014ec968b396af502742bacfb0675deb055d'],37,184,221,2787869,7,0.307692308,0.875,1,6168
150fecf6d3a1be30eb1b2f40a27524a9f60586df,1,GitHub,2022-02-09 17:02:27+01:00,['4b468a9d81f7380f7197a2a6b859c1b4dca84bd9'],1787,1440,3227,2791096,15,1,0,0,6168
d35283f011a797902fc9c4d896a1a6f039eb7d06,1,GitHub,2022-02-09 10:38:52-08:00,['150fecf6d3a1be30eb1b2f40a27524a9f60586df'],263,3681,3944,2795040,44,0.537831021,0.750945776,0.907944515,6188
57235a0cb4de9efe698ab5ce4493bee2784a9863,1,GitHub,2022-02-10 09:15:58+01:00,['d35283f011a797902fc9c4d896a1a6f039eb7d06'],997,812,1809,2796849,19,1,0,0.017094017,6188
2e25ca1355094682d405e3f0e062fa85dd7200f6,0,GitHub,2022-02-10 11:27:34+01:00,['57235a0cb4de9efe698ab5ce4493bee2784a9863'],1,2,3,2796852,1,,,,6188
78a3789496569dad373d7a961361a54e3a4abd73,0,GitHub,2022-02-10 17:21:17+01:00,['2e25ca1355094682d405e3f0e062fa85dd7200f6'],5,47,52,2796904,2,0,1,1,6188
4da515da94623e54cab359f1b3df9dae8b4ab7a7,0,GitHub,2022-02-10 09:55:14-08:00,['78a3789496569dad373d7a961361a54e3a4abd73'],0,7,7,2796911,1,1,1,1,6188
590df2c8befa912366925ab9b529c9f9c4bced70,0,GitHub,2022-02-10 14:10:23-08:00,['4da515da94623e54cab359f1b3df9dae8b4ab7a7'],16,46,62,2796973,3,0.25,0.875,1,6188
368f4cee7afb269fab092cb58f6411f27a1dece4,0,GitHub,2022-02-10 14:13:43-08:00,['590df2c8befa912366925ab9b529c9f9c4bced70'],5,5,10,2796983,1,,,,6188
03af63d0761cff0cc895f65825829eb6314c0de1,1,GitHub,2022-02-11 16:14:06+01:00,['368f4cee7afb269fab092cb58f6411f27a1dece4'],2,61,63,2797046,4,0.840909091,0.840909091,1,6188
0269edfc80e36d468516b943f0a9a08b7ee652fb,0,GitHub,2022-02-11 16:16:25+01:00,['03af63d0761cff0cc895f65825829eb6314c0de1'],982,799,1781,2798827,4,1,0,0.459016393,6188
40b261f0820faa335fab880e1366f7e56a62eada,0,GitHub,2022-02-11 10:50:44-08:00,['0269edfc80e36d468516b943f0a9a08b7ee652fb'],37,150,187,2799014,5,0.827586207,0.827586207,0.862068966,6190
e43916c148ad90aab6b51c465a32ba1d4d4b474b,1,GitHub,2022-02-11 15:01:08-08:00,['40b261f0820faa335fab880e1366f7e56a62eada'],20,124,144,2799158,6,0.093023256,1,1,6190
fc20c551d6b4f5c675d9bd80876950e23d194933,1,GitHub,2022-02-11 16:14:31-08:00,['e43916c148ad90aab6b51c465a32ba1d4d4b474b'],90,155,245,2799403,13,1,1,1,6191
99310360a589ccb28f7636b714e98e2e7c5a5110,1,GitHub,2022-02-11 22:25:03-06:00,['fc20c551d6b4f5c675d9bd80876950e23d194933'],676,592,1268,2800671,54,0.571428571,0,0.214285714,6191
076648e280ba319773bdca56775b775b7b21a8a8,0,GitHub,2022-02-12 11:11:21-08:00,['99310360a589ccb28f7636b714e98e2e7c5a5110'],1,50,51,2800722,2,0,0.789473684,1,6191
f9201666a1216fcbe07ed4f2ba544833fced6e39,0,GitHub,2022-02-14 10:17:54+01:00,['076648e280ba319773bdca56775b775b7b21a8a8'],33,23,56,2800778,10,0.375,0.375,0.375,6191
c8fbe26f3bd3a7c018e7619deba002ee454208b9,0,GitHub,2022-02-14 11:55:38+01:00,['f9201666a1216fcbe07ed4f2ba544833fced6e39'],85,350,435,2801213,15,0.09039548,0.807909605,0.598870056,6191
b5b590cb6711617cbb3c978de9f8bb0903291efa,0,GitHub,2022-02-14 20:24:20+08:00,['c8fbe26f3bd3a7c018e7619deba002ee454208b9'],6,6,12,2801225,1,,,,6191
71f732e6e5dc90875046c43f2a5c2ed0ee478a91,0,GitHub,2022-02-14 15:17:44-08:00,['b5b590cb6711617cbb3c978de9f8bb0903291efa'],0,19,19,2801244,1,,,,6191
dd36331a817d5db8b595d0cec6e03d747af3b760,1,GitHub,2022-02-15 10:16:03-08:00,['71f732e6e5dc90875046c43f2a5c2ed0ee478a91'],52,130,182,2801426,11,0.322033898,0.491525424,1,6191
71cbff62b685ef2b6b3169c2e69693687ddf7b3f,0,GitHub,2022-02-15 10:27:38-08:00,['dd36331a817d5db8b595d0cec6e03d747af3b760'],34,41,75,2801501,7,,,,6191
fdb98df839146a6ac742c4d603c6f73ae00ba484,0,GitHub,2022-02-15 13:06:54-08:00,['71cbff62b685ef2b6b3169c2e69693687ddf7b3f'],58,166,224,2801725,7,0.23943662,0.169014085,0.985915493,6191
77cb8e0a5a5884e6a565131c77a906b41b978f3c,0,GitHub,2022-02-15 13:09:14-08:00,['fdb98df839146a6ac742c4d603c6f73ae00ba484'],3,9,12,2801737,1,0,0,1,6191
b765a2b44e9e7c7fd662cb7e0ed7d964a0ddeeed,0,GitHub,2022-02-15 18:28:34-08:00,['77cb8e0a5a5884e6a565131c77a906b41b978f3c'],175,5,180,2801917,6,0.591549296,0,0,6191
1c7cd7979228a97c5c5674f6527a813ae298fd2d,0,GitHub,2022-02-15 18:36:13-08:00,['b765a2b44e9e7c7fd662cb7e0ed7d964a0ddeeed'],4,4,8,2801925,1,,,,6191
6d7e6d6f8701a018202f06ad94620953e82127cb,0,GitHub,2022-02-16 12:56:06+01:00,['1c7cd7979228a97c5c5674f6527a813ae298fd2d'],1,1,2,2801927,1,,,,6191
c012fc411c39e29a6189a3c912c2ea292fb21834,0,GitHub,2022-02-16 08:40:47-08:00,['6d7e6d6f8701a018202f06ad94620953e82127cb'],10,109,119,2802046,1,,,,6191
81e709c4e2554f045a9961e520c0b7cc1a7b3495,0,GitHub,2022-02-16 10:12:07-08:00,['c012fc411c39e29a6189a3c912c2ea292fb21834'],3,0,3,2802049,1,,,,6191
8047ba3800436d6162d0f8eb707e28857ab9eb68,1,GitHub,2022-02-16 20:02:25+01:00,['81e709c4e2554f045a9961e520c0b7cc1a7b3495'],245,180,425,2802474,76,1,0.787234043,0.276595745,6191
333278d9bbf9c180d556b5c3676c1832c583bbd5,0,GitHub,2022-02-16 20:32:00+01:00,['8047ba3800436d6162d0f8eb707e28857ab9eb68'],5,6,11,2802485,1,0.5,0.5,1,6191
c7586cc38dc1844dbef0f2b0ab511b60aaef684e,0,GitHub,2022-02-16 17:50:58-08:00,['333278d9bbf9c180d556b5c3676c1832c583bbd5'],1,1,2,2802487,1,,,,6191
760e6f3741a7a4ea4204c20a05ee0ce980d7581d,0,GitHub,2022-02-17 14:35:36+08:00,['c7586cc38dc1844dbef0f2b0ab511b60aaef684e'],72,87,159,2802646,6,,,,6191
219a446febe247e22ce5a7bbf55017d5cf02ad00,0,GitHub,2022-02-17 20:56:57+08:00,['760e6f3741a7a4ea4204c20a05ee0ce980d7581d'],1,1,2,2802648,1,,,,6191
a4b1e50f08e7fef85b41f00f2d5fe40406466ec0,0,GitHub,2022-02-18 14:31:44+08:00,['219a446febe247e22ce5a7bbf55017d5cf02ad00'],3,1,4,2802652,1,,,,6191
4c23e47bd5b04d49e1ef55b8a33ba18e72a818e2,0,GitHub,2022-02-18 00:39:41-08:00,['a4b1e50f08e7fef85b41f00f2d5fe40406466ec0'],299,433,732,2803384,17,1,1,0,6193
06ca4850c5b2b12e972f48e03fe4f9c1032f9a3e,0,GitHub,2022-02-18 14:49:03+01:00,['4c23e47bd5b04d49e1ef55b8a33ba18e72a818e2'],26,4,30,2803414,4,0,0,0,6193
496aa1f84b0e75ed1c89559e41d75f69fe1ac71f,0,GitHub,2022-02-21 14:48:24+08:00,['06ca4850c5b2b12e972f48e03fe4f9c1032f9a3e'],304,1,305,2803719,2,,,,6193
4d036ee8714d1dbc18d598d390edb311360f717b,0,GitHub,2022-02-21 07:55:04-06:00,['496aa1f84b0e75ed1c89559e41d75f69fe1ac71f'],3,5,8,2803727,1,,,,6193
2dc4d5d95ee6204aa2c0597bdbb9592a3329ba9e,0,GitHub,2022-02-22 10:54:53+08:00,['4d036ee8714d1dbc18d598d390edb311360f717b'],0,4,4,2803731,1,,,,6193
576496a1ca53456d45532e83ba5f698ed592f4cb,0,GitHub,2022-02-22 20:49:53+08:00,['2dc4d5d95ee6204aa2c0597bdbb9592a3329ba9e'],206,182,388,2804119,3,,,,6193
a5bb45c11ad7a68856d14c86184bc3488770aa43,0,GitHub,2022-02-22 17:17:16+01:00,['576496a1ca53456d45532e83ba5f698ed592f4cb'],21,200,221,2804340,2,0.43877551,1,0.989795918,6193
d8cf47bf28af0b5eb5be8382883e6a331b788e01,0,GitHub,2022-02-22 23:10:05-08:00,['a5bb45c11ad7a68856d14c86184bc3488770aa43'],8,158,166,2804506,4,0.269230769,0.976923077,0.946153846,6193
6bef67319726d64058c696d9ca84fe0d05dc38ca,0,GitHub,2022-02-23 14:48:43+01:00,['d8cf47bf28af0b5eb5be8382883e6a331b788e01'],1,14,15,2804521,2,0,1,1,6193
6f09c3f88b2f02946f85a3cbde1298b47a4470cc,0,GitHub,2022-02-23 14:49:30+01:00,['6bef67319726d64058c696d9ca84fe0d05dc38ca'],0,158,158,2804679,3,0.178217822,1,0.683168317,6193
8d88b20b2779faa413ffc4c6d2546800e225213f,0,GitHub,2022-02-23 10:13:08-08:00,['6f09c3f88b2f02946f85a3cbde1298b47a4470cc'],0,69,69,2804748,1,,,,6194
711b603ddc85210090246349603bdb7a2b1466d7,1,GitHub,2022-02-24 07:37:28-08:00,['8d88b20b2779faa413ffc4c6d2546800e225213f'],446,442,888,2805636,70,0.6875,1,0.604166667,6194
cd4a1cb4101abcc7cdd1d2d0d73662114108f3e5,0,GitHub,2022-02-24 12:10:31-08:00,['711b603ddc85210090246349603bdb7a2b1466d7'],101,307,408,2806044,8,0.594594595,0.972972973,0.72972973,6196
15ebad54b4cd6aa377f60c3781e3d0aaeac05526,0,GitHub,2022-02-24 13:26:23-08:00,['cd4a1cb4101abcc7cdd1d2d0d73662114108f3e5'],1,1,2,2806046,1,,,,6196
c2ee1411c8bb73fcf96c12abeedbfe6fde2c6354,0,GitHub,2022-02-24 16:18:13-08:00,['15ebad54b4cd6aa377f60c3781e3d0aaeac05526'],5,4,9,2806055,2,0,,,6196
2c90447a593196a11b57d1617f990de2aa492b7c,1,GitHub,2022-02-25 15:43:21-08:00,['c2ee1411c8bb73fcf96c12abeedbfe6fde2c6354'],19,154,173,2806228,3,0.196078431,0.960784314,0.960784314,6196
29317e695394617918fe30007a136d0710800885,0,GitHub,2022-02-25 19:04:07-08:00,['2c90447a593196a11b57d1617f990de2aa492b7c'],0,13,13,2806241,2,1,1,1,6196
abb74d406a13bd989e718f737b18073af5a626d5,0,GitHub,2022-02-25 19:11:06-08:00,['29317e695394617918fe30007a136d0710800885'],2,5,7,2806248,2,0,1,1,6196
5f91aa7b4c1a5b7b22305b08c35871050853a855,1,GitHub,2022-02-26 10:52:34-08:00,['abb74d406a13bd989e718f737b18073af5a626d5'],1,86,87,2806335,3,0.09375,1,1,6196
2ccc834faa3fffcd5d15d2463aeef3ee6f5cea13,0,GitHub,2022-02-28 18:26:46+01:00,['5f91aa7b4c1a5b7b22305b08c35871050853a855'],6,8,14,2806349,2,,,,6196
14faea4aab8b772d7e41d0fb12cad110ad922293,0,GitHub,2022-03-01 10:10:43-05:00,['2ccc834faa3fffcd5d15d2463aeef3ee6f5cea13'],0,36,36,2806385,2,0.818181818,0.818181818,1,6196
67e99a42361b8f0febc3e691488c668ebfe257e9,0,GitHub,2022-03-01 10:55:17-08:00,['14faea4aab8b772d7e41d0fb12cad110ad922293'],5,8,13,2806398,1,1,1,1,6196
6eb57f6df1706c6ec228123cea1c120bd53b62d6,0,GitHub,2022-03-01 12:59:18-08:00,['67e99a42361b8f0febc3e691488c668ebfe257e9'],363,184,547,2806945,6,0.581395349,0,0,6196
84f8c90b132522639f13e36096b405b818d208c3,0,GitHub,2022-03-01 13:15:53-08:00,['6eb57f6df1706c6ec228123cea1c120bd53b62d6'],14,16,30,2806975,1,,,,6196
7172f358071772af7f606f17989cbd0d95977bd1,0,GitHub,2022-03-01 20:30:29-06:00,['84f8c90b132522639f13e36096b405b818d208c3'],10,8,18,2806993,1,,,,6196
f089bea7ed9fee2bad7084e6b40561ff6935ce5f,0,GitHub,2022-03-01 21:58:10-08:00,['7172f358071772af7f606f17989cbd0d95977bd1'],2,11,13,2807006,1,,,,6196
07553d13f7207d3e005cee3f8c8b520815738d89,1,GitHub,2022-03-02 14:26:31-08:00,['f089bea7ed9fee2bad7084e6b40561ff6935ce5f'],123,476,599,2807605,15,0.956834532,0.992805755,1,6200
62e646619b208098c07e4d044c1ed7fcd44bf6f9,0,GitHub,2022-03-03 11:37:26+08:00,['07553d13f7207d3e005cee3f8c8b520815738d89'],121,1447,1568,2809173,16,0.30994898,0.996173469,0.732142857,6206
066cdc8c621dfc4d26e12ee539368d6c1eb2707f,0,GitHub,2022-03-03 10:27:17+00:00,['62e646619b208098c07e4d044c1ed7fcd44bf6f9'],50,611,661,2809834,34,0.640926641,0.903474903,0.722007722,6210
029a14b530dcaab980faee4fa18c925b95db3122,0,GitHub,2022-03-03 14:28:50+01:00,['066cdc8c621dfc4d26e12ee539368d6c1eb2707f'],386,735,1121,2810955,27,0.648648649,0.466216216,1,6214
7c280c1d5f6267acbbebd10d3e58ea4b8fe7a4ef,0,GitHub,2022-03-03 05:40:41-08:00,['029a14b530dcaab980faee4fa18c925b95db3122'],76,137,213,2811168,4,0,0.43902439,1,6214
f5d8fb2b0bf2049800fd7745ac0e2c7e239dce68,0,GitHub,2022-03-03 10:13:01-08:00,['7c280c1d5f6267acbbebd10d3e58ea4b8fe7a4ef'],0,1,1,2811169,1,,,,6214
ae76b9d45a1a3fe8c4202217a179b1b6905f45dc,0,GitHub,2022-03-04 09:47:23+08:00,['f5d8fb2b0bf2049800fd7745ac0e2c7e239dce68'],8,0,8,2811177,1,1,0,0,6214
95dbba9fe584c2d62be3d589b90ecc224ce2d130,0,GitHub,2022-03-04 09:51:53+01:00,['ae76b9d45a1a3fe8c4202217a179b1b6905f45dc'],0,1,1,2811178,1,1,1,1,6214
6f54faed2d0792f3a36534fd7e6d00b6603253a8,0,GitHub,2022-03-04 09:58:56-08:00,['95dbba9fe584c2d62be3d589b90ecc224ce2d130'],42,97,139,2811317,2,0.75,0.777777778,1,6214
11143d4883179734bcb9fc324ddbc5f9b7a8bf25,0,GitHub,2022-03-04 10:31:37-08:00,['6f54faed2d0792f3a36534fd7e6d00b6603253a8'],99,113,212,2811529,1,0,1,1,6214
3be978464ca01c29241954516b4d952f69d4e16d,0,GitHub,2022-03-04 10:45:44-08:00,['11143d4883179734bcb9fc324ddbc5f9b7a8bf25'],12,17,29,2811558,3,1,1,1,6214
0dac4b42678049e210759f38d897a75271aac72a,1,GitHub,2022-03-05 16:08:14+08:00,['3be978464ca01c29241954516b4d952f69d4e16d'],15,150,165,2811723,7,0.766990291,1,1,6214
e3ef29ea0300e3ed5edf5c800f914f19273c9851,0,GitHub,2022-03-05 16:11:42+08:00,['0dac4b42678049e210759f38d897a75271aac72a'],71,236,307,2812030,2,0,0.92248062,0.92248062,6214
bbb2dc54a0f45bc5455f22a0671adde206dcfa29,0,GitHub,2022-03-07 10:18:54+01:00,['e3ef29ea0300e3ed5edf5c800f914f19273c9851'],0,18,18,2812048,1,,,,6214
539f006e65d9060cd46a4052d1b70f2312d8ca34,0,GitHub,2022-03-07 11:09:18-08:00,['bbb2dc54a0f45bc5455f22a0671adde206dcfa29'],38,71,109,2812157,7,0,0.8,1,6214
1848f049e106101293739f6471d3d589c4018e5e,0,GitHub,2022-03-08 14:28:16+08:00,['539f006e65d9060cd46a4052d1b70f2312d8ca34'],9,13,22,2812179,2,1,1,1,6214
fc7133d52d1ad6d8a2c91ce2f3d550bb56de1fb1,0,GitHub,2022-03-07 23:59:43-08:00,['1848f049e106101293739f6471d3d589c4018e5e'],56,79,135,2812314,5,1,1,1,6214
10f34ce6b3f6e43424cc6a1e1b334776b0171f98,0,GitHub,2022-03-08 10:42:36-06:00,['fc7133d52d1ad6d8a2c91ce2f3d550bb56de1fb1'],2,4,6,2812320,1,,,,6214
b27000ec6af6edfe8a6958dfcc3c0745667e25f4,0,GitHub,2022-03-08 19:03:11+01:00,['10f34ce6b3f6e43424cc6a1e1b334776b0171f98'],1,3,4,2812324,1,0,0,0,6214
717f9e2149d6e273c6d4e5457dc6bc067691269f,0,GitHub,2022-03-08 13:59:58-06:00,['b27000ec6af6edfe8a6958dfcc3c0745667e25f4'],70,58,128,2812452,1,0,0,0,6214
69926b5193d1b4837039c8a738f3dc9c5bbd267b,0,GitHub,2022-03-09 07:31:07+01:00,['717f9e2149d6e273c6d4e5457dc6bc067691269f'],20,18,38,2812490,1,1,0.25,0,6214
add11eed752e3ee912e469245cc7cf56914ae07f,0,GitHub,2022-03-09 16:51:26+08:00,['69926b5193d1b4837039c8a738f3dc9c5bbd267b'],5,5,10,2812500,1,,,,6214
2367c8994be1751950d989edb6ff62b10d98a03d,1,GitHub,2022-03-09 05:41:06-08:00,['add11eed752e3ee912e469245cc7cf56914ae07f'],64,85,149,2812649,1,0,0,0.833333333,6214
28393be6d7416f51eb51f7fe2b075570b45ef09f,1,GitHub,2022-03-09 12:39:28-06:00,['2367c8994be1751950d989edb6ff62b10d98a03d'],55,402,457,2813106,8,0.596491228,0.777777778,0.713450292,6216
ddcee81043dd892776a36657db3eb1771e7bc017,1,GitHub,2022-03-09 14:37:48-06:00,['28393be6d7416f51eb51f7fe2b075570b45ef09f'],8,13,21,2813127,2,0,0,0,6216
d2d49f6421639bb1d5c655b46d7212dff2616b96,0,GitHub,2022-03-09 15:11:46-06:00,['ddcee81043dd892776a36657db3eb1771e7bc017'],1,0,1,2813128,1,1,1,1,6216
9c7d8577134559437c67cc2d24154023993a901f,0,GitHub,2022-03-09 16:30:42-08:00,['d2d49f6421639bb1d5c655b46d7212dff2616b96'],7,11,18,2813146,3,1,1,1,6216
798275f25401b41af6a9703c117173b687d218ba,0,GitHub,2022-03-10 10:52:05+08:00,['9c7d8577134559437c67cc2d24154023993a901f'],4,17,21,2813167,2,0.75,1,1,6216
84b41b9d3ad4b45a9137197a304996759e993cde,0,GitHub,2022-03-10 10:54:10+08:00,['798275f25401b41af6a9703c117173b687d218ba'],151,15,166,2813333,7,0.233009709,0,0,6216
38e3787d760fba6bdac4c91126e87cd7939ae43f,0,GitHub,2022-03-10 14:03:12-05:00,['84b41b9d3ad4b45a9137197a304996759e993cde'],1,1,2,2813335,1,,,,6216
113595cf5c1d9ba06cbb84e63f5d42aaff030e7b,0,GitHub,2022-03-10 12:02:07-08:00,['38e3787d760fba6bdac4c91126e87cd7939ae43f'],82,114,196,2813531,4,1,1,0.166666667,6216
4d5a28973f96492215531520b34737d529d8fd8b,0,GitHub,2022-03-10 13:52:05-08:00,['113595cf5c1d9ba06cbb84e63f5d42aaff030e7b'],8,6,14,2813545,2,,,,6216
dc36dedd28ff384218b669de13993646483db966,0,GitHub,2022-03-10 18:18:41-05:00,['4d5a28973f96492215531520b34737d529d8fd8b'],2,2,4,2813549,1,,,,6216
f025a93c7c38a87da0f9df6372a7df0992517ab5,0,GitHub,2022-03-11 15:42:44+08:00,['dc36dedd28ff384218b669de13993646483db966'],3,3,6,2813555,1,,,,6216
87eb0cf03c879fe77e6e72b490fcf0b9621dd559,0,GitHub,2022-03-11 16:29:05+08:00,['f025a93c7c38a87da0f9df6372a7df0992517ab5'],34,132,166,2813721,11,0.724137931,0.862068966,0.931034483,6216
7e683852b46c0fe70f5100e953e3cd61d1697c06,0,GitHub,2022-03-11 17:36:19+05:18,['87eb0cf03c879fe77e6e72b490fcf0b9621dd559'],3,3,6,2813727,2,,,,6216
17988f471032d9e2df56a3800a8b0ec5a4aa02af,1,GitHub,2022-03-11 12:01:46-06:00,['7e683852b46c0fe70f5100e953e3cd61d1697c06'],28,27,55,2813782,1,1,0,1,6216
63ea5db9ec2e93ded483025649f48565f056242d,0,GitHub,2022-03-11 17:51:10-08:00,['17988f471032d9e2df56a3800a8b0ec5a4aa02af'],92,2950,3042,2816824,17,0.394650655,0.951419214,0.804585153,6223
7f284497cb46366cc266ec6abac4661e6e3a839d,0,GitHub,2022-03-14 13:03:41+01:00,['63ea5db9ec2e93ded483025649f48565f056242d'],798,484,1282,2818106,3,0.739534884,0,0.009302326,6223
eb6c5baf3ee764cd821f0a1d48b0fede445146f6,0,GitHub,2022-03-14 09:20:28-07:00,['7f284497cb46366cc266ec6abac4661e6e3a839d'],0,17,17,2818123,1,,,,6224
b1f36360ed739ff1e29941952f219ee6d15258ec,0,GitHub,2022-03-14 09:22:01-07:00,['eb6c5baf3ee764cd821f0a1d48b0fede445146f6'],0,38,38,2818161,2,1,1,1,6224
b916cb40bd7bfe7077ce9fd1c2b4270b1b97b5ed,0,GitHub,2022-03-14 15:42:10-07:00,['b1f36360ed739ff1e29941952f219ee6d15258ec'],103,55,158,2818319,1,0.416666667,0,0,6224
76cf7a5793702b55e2cfd98a375f8f1708ff32c3,0,GitHub,2022-03-15 11:20:18+08:00,['b916cb40bd7bfe7077ce9fd1c2b4270b1b97b5ed'],4,0,4,2818323,2,1,0,0.5,6224
cad4985a0a15c6372e9b42260c2468d18d93e3d6,1,GitHub,2022-03-14 21:32:28-07:00,['76cf7a5793702b55e2cfd98a375f8f1708ff32c3'],3,14,17,2818340,5,,,,6224
418b1221502aaab0c9d9f627172927b5ff2d1005,0,GitHub,2022-03-15 12:08:10+01:00,['cad4985a0a15c6372e9b42260c2468d18d93e3d6'],2,3,5,2818345,1,,,,6224
e8a762eee4f2dbe2564cbb2319e51277ba6b4b3a,0,GitHub,2022-03-15 19:40:11+08:00,['418b1221502aaab0c9d9f627172927b5ff2d1005'],0,84,84,2818429,2,0.875,1,1,6224
03411ca28b21d554d754b3f67a7857afe64f5bef,0,GitHub,2022-03-15 09:37:01-07:00,['e8a762eee4f2dbe2564cbb2319e51277ba6b4b3a'],36,285,321,2818750,4,0.043478261,1,1,6224
76d287c96771159d9b86dcf2fa193ff69198dd5b,0,GitHub,2022-03-15 12:26:23-07:00,['03411ca28b21d554d754b3f67a7857afe64f5bef'],1,117,118,2818868,3,0.395604396,1,1,6224
bda5c34b030207f542c7987a5e0f9bcb23406c18,1,GitHub,2022-03-15 12:50:53-07:00,['76d287c96771159d9b86dcf2fa193ff69198dd5b'],41,88,129,2818997,5,1,0.935483871,0.741935484,6224
f708dc58ed7f7e9d7aed2d43cd36aadaf32c75ee,0,GitHub,2022-03-15 13:54:48-07:00,['bda5c34b030207f542c7987a5e0f9bcb23406c18'],1,5,6,2819003,1,0,1,1,6224
9e8ace080990a6471ed058edffaafa74984649e4,0,GitHub,2022-03-15 15:55:20-07:00,['f708dc58ed7f7e9d7aed2d43cd36aadaf32c75ee'],1,99,100,2819103,3,0.215384615,0.984615385,0.984615385,6224
620f1d88d80fdf8150bd0b75be307bc4a2d3a0ea,0,GitHub,2022-03-15 19:58:47-04:00,['9e8ace080990a6471ed058edffaafa74984649e4'],1,1,2,2819105,1,,,,6224
1783fb14df6d83caf8af27bf5029e27674d53363,0,GitHub,2022-03-16 11:43:37+01:00,['620f1d88d80fdf8150bd0b75be307bc4a2d3a0ea'],6,7,13,2819118,4,,,,6224
5c1dd493d6f608b566fdad5ab3a896cb13622bce,0,GitHub,2022-03-16 11:54:02-04:00,['1783fb14df6d83caf8af27bf5029e27674d53363'],7,15,22,2819140,2,1,1,1,6224
b68463c250ec99d86ffacdbd45e58059d0ca51e1,0,GitHub,2022-03-16 18:02:24+01:00,['5c1dd493d6f608b566fdad5ab3a896cb13622bce'],121,946,1067,2820207,21,0.694092827,0.938818565,0.91350211,6227
fbe7fb941173c0907792a8b48e8e9122aabecbd8,0,GitHub,2022-03-17 10:19:42+08:00,['b68463c250ec99d86ffacdbd45e58059d0ca51e1'],108,1009,1117,2821324,30,0.094614265,0.807860262,0.978165939,6227
3dacdc5694da5db283524889d2270695defebbaa,0,GitHub,2022-03-17 17:30:37+01:00,['fbe7fb941173c0907792a8b48e8e9122aabecbd8'],45,26,71,2821395,3,1,0,0,6227
5cebe12a664d95c6dc5b5aeacd3cee0913ce2c4f,0,GitHub,2022-03-17 17:53:37+01:00,['3dacdc5694da5db283524889d2270695defebbaa'],196,415,611,2822006,3,0.768361582,0.983050847,0.903954802,6227
7afdb069bf5539ec404d9305239849ac35ad2d82,0,GitHub,2022-03-17 18:00:27+01:00,['5cebe12a664d95c6dc5b5aeacd3cee0913ce2c4f'],0,14,14,2822020,2,0,1,1,6227
df963ee0a98c3107093b22c670a6bc8d8f459e05,0,GitHub,2022-03-18 10:00:03+08:00,['7afdb069bf5539ec404d9305239849ac35ad2d82'],2,2,4,2822024,2,,,,6227
03641e6a28ce56898f28610f0d58c59182befc2b,0,GitHub,2022-03-18 09:20:08+01:00,['df963ee0a98c3107093b22c670a6bc8d8f459e05'],1,1,2,2822026,1,,,,6227
43bf46423245383238998031b8c5b4294335cff6,0,GitHub,2022-03-18 10:27:49+01:00,['03641e6a28ce56898f28610f0d58c59182befc2b'],0,7,7,2822033,1,1,1,1,6227
52621613fd386203773ba93903abd50b46fa093a,1,GitHub,2022-03-18 09:24:11-07:00,['43bf46423245383238998031b8c5b4294335cff6'],707,1619,2326,2824359,65,0.073308271,0.759398496,0.77443609,6231
8d6968e8322d74ebb0fde513113d42bef69fb72b,1,GitHub,2022-03-18 14:30:52-07:00,['52621613fd386203773ba93903abd50b46fa093a'],231,754,985,2825344,12,0.043343653,0.526315789,0.975232198,6232
6145974fef05cc212ad78a87505f930c47ba26e7,0,GitHub,2022-03-19 21:09:28-07:00,['8d6968e8322d74ebb0fde513113d42bef69fb72b'],1,0,1,2825345,1,1,1,0,6232
3a8f6b17a6a771d99322c78e8455bbbe4bdc6930,0,GitHub,2022-03-21 16:51:21+08:00,['6145974fef05cc212ad78a87505f930c47ba26e7'],8,21,29,2825374,2,1,1,1,6232
e5eb180a6fa6e1ff3ff2c3d1d67b702ca8c9957b,0,GitHub,2022-03-21 17:03:04+08:00,['3a8f6b17a6a771d99322c78e8455bbbe4bdc6930'],1,39,40,2825414,2,1,1,1,6232
72558da97654ee88c3fb046eb8aac84ddc375827,0,GitHub,2022-03-21 11:23:31+01:00,['e5eb180a6fa6e1ff3ff2c3d1d67b702ca8c9957b'],9,9,18,2825432,1,1,1,1,6232
4c8685e701e89e1c65acea720cb3facf63389791,0,GitHub,2022-03-21 21:37:05+01:00,['72558da97654ee88c3fb046eb8aac84ddc375827'],11,15,26,2825458,8,,,,6232
d449f850e1934680a96780c01ac95bfef52eeac7,1,GitHub,2022-03-21 14:33:51-07:00,['4c8685e701e89e1c65acea720cb3facf63389791'],2,14,16,2825474,4,0,0.571428571,1,6232
c9c03dd7ef9ff4edf2596e905cabececc72a9e9d,0,GitHub,2022-03-21 14:56:25-07:00,['d449f850e1934680a96780c01ac95bfef52eeac7'],36,11,47,2825521,5,0,0,0,6232
0924fd3f9f75c446310ed1e97b44bbc3f33c6c31,0,GitHub,2022-03-21 17:16:00-07:00,['c9c03dd7ef9ff4edf2596e905cabececc72a9e9d'],198,1287,1485,2827006,71,0.182692308,0.960164835,0.885989011,6234
be4ef3df428b9d783710a8779d5eadc80e10e299,0,GitHub,2022-03-22 09:31:46+01:00,['0924fd3f9f75c446310ed1e97b44bbc3f33c6c31'],10,90,100,2827106,5,0.238095238,1,1,6235
eddb98df67e792b87719636b33c19b0bc5934ffa,0,GitHub,2022-03-22 09:45:04+01:00,['be4ef3df428b9d783710a8779d5eadc80e10e299'],1,55,56,2827162,3,0,1,1,6236
a44e1ed449750f8d0d0aadd1fb37856158a88aa8,0,GitHub,2022-03-22 13:55:54+01:00,['eddb98df67e792b87719636b33c19b0bc5934ffa'],2,2,4,2827166,1,,,,6236
b60f4464acaa540de75ef2fc83a911d4ff6a8786,0,GitHub,2022-03-22 17:19:29-07:00,['a44e1ed449750f8d0d0aadd1fb37856158a88aa8'],0,4,4,2827170,2,0,1,0.5,6236
a3adf41d8b90d1244232e448b959db3b3f4dc2fe,0,GitHub,2022-03-22 20:53:53-07:00,['b60f4464acaa540de75ef2fc83a911d4ff6a8786'],0,112,112,2827282,2,0.517241379,1,0.517241379,6237
dcd09de1ed84b43f269eb32fc2baf589a791d468,0,GitHub,2022-03-23 13:07:02-05:00,['a3adf41d8b90d1244232e448b959db3b3f4dc2fe'],2,8,10,2827292,1,,,,6237
6ce69021fd1daa7bf39a9796152aff260b633b3a,0,GitHub,2022-03-23 15:03:52-07:00,['dcd09de1ed84b43f269eb32fc2baf589a791d468'],1,40,41,2827333,6,0,1,0.75,6237
322a065b9055649c713baf43f154052d45cd1588,0,GitHub,2022-03-23 22:09:05-05:00,['6ce69021fd1daa7bf39a9796152aff260b633b3a'],57,250,307,2827640,12,0.178294574,0.821705426,1,6237
e8f09007e4259d8a6adcba162b0385b66783a7f8,0,GitHub,2022-03-24 11:54:05+08:00,['322a065b9055649c713baf43f154052d45cd1588'],10,13,23,2827663,2,,,,6237
12bb23157c5dd6e305ce93dd28efcb2ba4782d98,1,GitHub,2022-03-24 15:49:25+08:00,['e8f09007e4259d8a6adcba162b0385b66783a7f8'],18,20,38,2827701,1,0,1,1,6237
db724f23f38cdb6c668a10681ea2a03bb11611ad,0,GitHub,2022-03-24 06:36:56-07:00,['12bb23157c5dd6e305ce93dd28efcb2ba4782d98'],0,4,4,2827705,1,0,0,1,6237
c5bc2688da5902015e658667186611d5d060070c,0,GitHub,2022-03-24 09:29:39-07:00,['db724f23f38cdb6c668a10681ea2a03bb11611ad'],2,7,9,2827714,2,0.5,1,1,6237
01533e3dd7388ca96b9fd3b84260a8df1b2a9d28,0,GitHub,2022-03-24 09:55:26-07:00,['c5bc2688da5902015e658667186611d5d060070c'],7,40,47,2827761,5,0,0.913043478,0.913043478,6237
46df7ee97ce696e8868a654cfdff483e6f180902,0,GitHub,2022-03-24 14:04:40-05:00,['01533e3dd7388ca96b9fd3b84260a8df1b2a9d28'],0,3,3,2827764,1,,,,6237
ce883892270a02a72e91afbdb1fabdd50d7da474,0,GitHub,2022-03-24 21:40:10-05:00,['46df7ee97ce696e8868a654cfdff483e6f180902'],1,28,29,2827793,2,1,1,0.875,6237
0586f544ef5a3e2ffa263babc811568ce672dfa1,0,GitHub,2022-03-25 09:30:02-07:00,['ce883892270a02a72e91afbdb1fabdd50d7da474'],2,4,6,2827799,1,0,1,1,6237
0461382adbf8b8dfddc547f28c8d7cfa801e585b,0,GitHub,2022-03-25 10:16:50-07:00,['0586f544ef5a3e2ffa263babc811568ce672dfa1'],5,2,7,2827806,1,1,0,0,6237
d706d6cac4622153973d131417e809ee57c60de0,0,GitHub,2022-03-25 10:18:15-07:00,['0461382adbf8b8dfddc547f28c8d7cfa801e585b'],2,0,2,2827808,1,,,,6237
ca3271e0f3e3c31cce413668c6a1ed2dacab91fe,0,GitHub,2022-03-27 15:47:24+08:00,['d706d6cac4622153973d131417e809ee57c60de0'],1,1,2,2827810,1,,,,6237
110bccac4af74e04368e13c4e638b0b5bcf4100f,0,GitHub,2022-03-28 16:48:39+02:00,['ca3271e0f3e3c31cce413668c6a1ed2dacab91fe'],67,303,370,2828180,4,0.263414634,1,0.551219512,6237
7243facb8d69a7252e6b9556b5eaee13e41bab7f,0,GitHub,2022-03-28 11:35:43-05:00,['110bccac4af74e04368e13c4e638b0b5bcf4100f'],10,129,139,2828319,3,0.159574468,0.957446809,1,6237
2a270591f868c59bae191ec059ef982dea22db96,1,GitHub,2022-03-28 16:20:21-07:00,['7243facb8d69a7252e6b9556b5eaee13e41bab7f'],163,164,327,2828646,10,,,,6237
19a62697803a91fc24c1a704881e531f848a759c,0,GitHub,2022-03-28 21:19:22-07:00,['2a270591f868c59bae191ec059ef982dea22db96'],3,5,8,2828654,1,0,0,1,6237
db2485cb597c6f9cc0787a24b49273e992e8e310,1,GitHub,2022-03-29 10:13:05+02:00,['19a62697803a91fc24c1a704881e531f848a759c'],9,75,84,2828738,2,0.02,0.92,0.88,6237
35ae4f248b34cc60a522bc856a42158e503d20b7,0,GitHub,2022-03-29 14:08:51+02:00,['db2485cb597c6f9cc0787a24b49273e992e8e310'],2,60,62,2828800,4,1,1,1,6237
f2aa0c439cb0045e6505d1bbdf8bbbb731a253ca,0,GitHub,2022-03-29 14:31:12+02:00,['35ae4f248b34cc60a522bc856a42158e503d20b7'],0,2,2,2828802,1,,,,6237
5aed178048dd5a79112274ee5e8a72611d9f0ec2,1,GitHub,2022-03-29 14:59:38-07:00,['f2aa0c439cb0045e6505d1bbdf8bbbb731a253ca'],49,180,229,2829031,5,0.166666667,0.888888889,1,6239
3904652b3e2dd2908ee30cff228041ce80508548,0,GitHub,2022-03-30 14:04:47+02:00,['5aed178048dd5a79112274ee5e8a72611d9f0ec2'],1,1,2,2829033,1,,,,6239
8e205b503a39ba8c798e3ce14cd887b66a88551c,0,GitHub,2022-03-30 14:58:58+02:00,['3904652b3e2dd2908ee30cff228041ce80508548'],10,11,21,2829054,2,1,0,0,6239
bb60eb86e1a0028274f02482eb70d9e018b7014e,0,GitHub,2022-03-30 17:09:19+01:00,['8e205b503a39ba8c798e3ce14cd887b66a88551c'],1,1,2,2829056,1,,,,6239
76ca62a39673f90c7cb65d90f27f68ba035a164f,0,GitHub,2022-03-30 20:36:34+02:00,['bb60eb86e1a0028274f02482eb70d9e018b7014e'],2,3,5,2829061,2,,,,6239
ecb0e8eece0b47a1376643a11056c77d0aa5ad6e,0,GitHub,2022-03-30 20:54:01+02:00,['76ca62a39673f90c7cb65d90f27f68ba035a164f'],6,9,15,2829076,4,,,,6239
dd62ef2eda571576a222d757beabcd7690dd8c16,0,GitHub,2022-03-30 13:15:42-07:00,['ecb0e8eece0b47a1376643a11056c77d0aa5ad6e'],20,73,93,2829169,7,0.352941176,0.352941176,0.617647059,6239
b2cb6caa1e9267c720c00fa367a277ee8509baea,0,GitHub,2022-03-30 13:59:22-07:00,['dd62ef2eda571576a222d757beabcd7690dd8c16'],117,420,537,2829706,38,0.280898876,1,0.825842697,6242
1317f3f77a9e1e432e7a81de2dcb88365feeac43,0,GitHub,2022-03-30 16:24:01-07:00,['b2cb6caa1e9267c720c00fa367a277ee8509baea'],113,114,227,2829933,9,0,0,0,6242
366b998a229f26aa4601e6b114c2198de0697562,0,GitHub,2022-03-31 09:45:33+08:00,['1317f3f77a9e1e432e7a81de2dcb88365feeac43'],2,6,8,2829941,1,0,1,1,6242
8965240da3ba704e1606f1a00024f365aa0b3d2a,0,GitHub,2022-03-31 09:54:42+08:00,['366b998a229f26aa4601e6b114c2198de0697562'],2,2,4,2829945,2,,,,6242
669a49063db814b7d7181f0798bd9822bdf5a3d4,0,GitHub,2022-03-31 10:34:39+08:00,['8965240da3ba704e1606f1a00024f365aa0b3d2a'],2,13,15,2829960,2,0.6,0.6,1,6242
ce7788aadaf989214c70e4df7ec286ed080e8cd1,0,GitHub,2022-03-31 14:31:31+02:00,['669a49063db814b7d7181f0798bd9822bdf5a3d4'],25,101,126,2830086,5,0.25862069,1,0.75862069,6242
430f9c99012d1585aa544d4dadf449963296c1fd,0,GitHub,2022-03-31 14:45:59+02:00,['ce7788aadaf989214c70e4df7ec286ed080e8cd1'],9,145,154,2830240,3,0.534653465,1,0.544554455,6242
3c279b63fa862671330b568f5f58df69f9352c35,0,GitHub,2022-03-31 10:05:53-04:00,['430f9c99012d1585aa544d4dadf449963296c1fd'],1,305,306,2830546,2,0,1,1,6242
6b2a0bcf8c76e6387f0f5ec13d1a7f00341ba110,0,GitHub,2022-03-31 09:48:21-07:00,['3c279b63fa862671330b568f5f58df69f9352c35'],99,842,941,2831487,12,0.487528345,0.945578231,0.993197279,6246
eefdf9d6a7fd79a21bb9aea2df25ea642062f28c,0,GitHub,2022-03-31 10:56:07-07:00,['6b2a0bcf8c76e6387f0f5ec13d1a7f00341ba110'],17,96,113,2831600,3,0.148148148,0.944444444,0.574074074,6246
502f2caca4fca520a6b22191573112b3784f5e34,0,GitHub,2022-04-01 11:39:50+08:00,['eefdf9d6a7fd79a21bb9aea2df25ea642062f28c'],70,2,72,2831672,3,0,0,0,6246
1bdd35d8d8d58238a493c5f5fc94fca413a7d324,0,GitHub,2022-04-01 16:23:29+08:00,['502f2caca4fca520a6b22191573112b3784f5e34'],1,2,3,2831675,1,,,,6246
62ea4c46a9be7388baeaef1c505d3e5798a9066f,1,GitHub,2022-04-01 10:50:25-07:00,['1bdd35d8d8d58238a493c5f5fc94fca413a7d324'],193,899,1092,2832767,22,0.248815166,0.644549763,0.710900474,6248
02a465b0906f3514a0c6182e8cf8f5b75b228088,0,GitHub,2022-04-04 09:07:58+02:00,['62ea4c46a9be7388baeaef1c505d3e5798a9066f'],1,1,2,2832769,1,,,,6248
ae45c59e61c34fcf1abb5d4731a99d400d2c79be,0,GitHub,2022-04-04 09:10:33+02:00,['02a465b0906f3514a0c6182e8cf8f5b75b228088'],1,1,2,2832771,1,,,,6248
dd4afdeb6d5226e2371d6dfb3ce2eb8c8c7a8c10,0,GitHub,2022-04-04 14:43:31+02:00,['ae45c59e61c34fcf1abb5d4731a99d400d2c79be'],1,1,2,2832773,1,,,,6248
74909e000aaab1f0300ae2e918a6fa361e38078e,0,GitHub,2022-04-04 17:27:34+02:00,['dd4afdeb6d5226e2371d6dfb3ce2eb8c8c7a8c10'],1,1,2,2832775,1,,,,6248
481cc13a132d33f23e737f88ae28a1aac135afed,0,GitHub,2022-04-05 15:27:32+08:00,['74909e000aaab1f0300ae2e918a6fa361e38078e'],6,12,18,2832793,2,0,1,1,6248
3ceedac79e58a4a457d36d75c1f4c5a5b36af3d2,1,GitHub,2022-04-05 09:48:21-07:00,['481cc13a132d33f23e737f88ae28a1aac135afed'],9,333,342,2833135,3,0.18,1,0.388,6248
4218fc61fedb02b78d35c88e56ab253baaf09f39,0,GitHub,2022-04-05 18:56:23+02:00,['3ceedac79e58a4a457d36d75c1f4c5a5b36af3d2'],3,68,71,2833206,3,0.12195122,1,0.87804878,6248
f0a2b62b0e7660ca9e0f0159da636463356206c5,1,GitHub,2022-04-05 10:03:33-07:00,['4218fc61fedb02b78d35c88e56ab253baaf09f39'],2,70,72,2833278,2,0.08,1,1,6248
88e5f133b5a572ba2ee786d10e74360fd62a104c,0,GitHub,2022-04-05 21:42:08+02:00,['f0a2b62b0e7660ca9e0f0159da636463356206c5'],683,618,1301,2834579,1,1,0,0.467889908,6248
29a6979c54fb835d5c1f252df839023fd3357f97,0,GitHub,2022-04-05 21:23:31-05:00,['88e5f133b5a572ba2ee786d10e74360fd62a104c'],1,1,2,2834581,1,,,,6248
9b8f6289bed11b070ec0366bf91d8aa0ec8e7c79,0,GitHub,2022-04-06 10:29:44+01:00,['29a6979c54fb835d5c1f252df839023fd3357f97'],0,3,3,2834584,1,,,,6248
b964c07a68fa385b1cce715e1814477e1e26ad39,0,GitHub,2022-04-06 07:27:03-07:00,['9b8f6289bed11b070ec0366bf91d8aa0ec8e7c79'],9,9,18,2834602,4,,,,6248
206ad4d2b530b1c0c776629256352cd044e68197,0,GitHub,2022-04-06 16:35:25+02:00,['b964c07a68fa385b1cce715e1814477e1e26ad39'],0,4,4,2834606,1,0,1,1,6248
92305c2cf26764de89fabcbe33401382f43610ff,0,GitHub,2022-04-06 08:48:43-07:00,['206ad4d2b530b1c0c776629256352cd044e68197'],4,67,71,2834677,2,0.533333333,0.533333333,0.977777778,6248
e7cfbad04f0166e6fe4862be2b893a69f3740ba1,0,GitHub,2022-04-07 14:24:23+08:00,['92305c2cf26764de89fabcbe33401382f43610ff'],15,5,20,2834697,2,0.111111111,0,0,6248
60c0916bfdc87ddf2e01f172d5455bfeaa8e8cc7,1,GitHub,2022-04-07 10:13:15+02:00,['e7cfbad04f0166e6fe4862be2b893a69f3740ba1'],3,11,14,2834711,2,1,1,1,6248
a2149c41786b6769df079e18d1f8078ef3c75832,0,GitHub,2022-04-07 18:16:12+08:00,['60c0916bfdc87ddf2e01f172d5455bfeaa8e8cc7'],3,3,6,2834717,2,,,,6248
ce4f2ad6060c76120d2a2a6a7ef3e6135b2c9932,0,GitHub,2022-04-08 08:55:52-07:00,['a2149c41786b6769df079e18d1f8078ef3c75832'],2,2,4,2834721,1,,,,6248
7a5f0cfaefb57cefa70c81d63c60316075c6dd97,0,GitHub,2022-04-08 12:54:09-07:00,['ce4f2ad6060c76120d2a2a6a7ef3e6135b2c9932'],3,30,33,2834754,2,0,1,1,6248
9596c7b9cfacb6aba961a328023c6572e8800837,1,GitHub,2022-04-09 10:58:16+08:00,['7a5f0cfaefb57cefa70c81d63c60316075c6dd97'],1,1,2,2834756,1,,,,6248
6e9cd0c7f58a24b5ecef9746881ebcccd7633a7e,0,GitHub,2022-04-09 11:42:42+02:00,['9596c7b9cfacb6aba961a328023c6572e8800837'],13,17,30,2834786,1,1,1,1,6248
4ad439c56db551697ea366dc4986eee5fc288706,0,GitHub,2022-04-11 10:06:56+08:00,['6e9cd0c7f58a24b5ecef9746881ebcccd7633a7e'],1,1,2,2834788,1,,,,6248
317fff9bb05fd7c7932f481fd200e56bff761459,0,GitHub,2022-04-11 13:37:47-07:00,['4ad439c56db551697ea366dc4986eee5fc288706'],9,9,18,2834806,1,1,1,1,6248
0d518aaed158896ee9ee6949b8f38128d1d73634,0,GitHub,2022-04-11 16:17:01-05:00,['317fff9bb05fd7c7932f481fd200e56bff761459'],9,11,20,2834826,2,1,1,0,6248
1df232c839f4568718a52c04aad72b69beb52026,0,GitHub,2022-04-12 21:24:57-07:00,['0d518aaed158896ee9ee6949b8f38128d1d73634'],5,24,29,2834855,5,1,1,1,6248
b9fc8935468e3eaa0385d35e2892d9df228701ec,0,GitHub,2022-04-13 12:51:34+02:00,['1df232c839f4568718a52c04aad72b69beb52026'],3,3,6,2834861,2,,,,6248
4eeb7071076fc5028cc0e48410819dea95fb1ba8,0,GitHub,2022-04-13 13:42:27+02:00,['b9fc8935468e3eaa0385d35e2892d9df228701ec'],13,26,39,2834900,2,1,1,1,6248
c93b717836b6d92d0f2e9fb101ea6ff3e823ffca,0,GitHub,2022-04-13 13:49:31+02:00,['4eeb7071076fc5028cc0e48410819dea95fb1ba8'],6,5,11,2834911,2,,,,6248
a6d86b9998b4cdcdda40cedc5da2f7e695e39ee1,0,GitHub,2022-04-13 09:05:27-07:00,['c93b717836b6d92d0f2e9fb101ea6ff3e823ffca'],0,8,8,2834919,1,0,1,0,6248
f97646488cff1984455ffb1fe9a147a522e6ac76,1,GitHub,2022-04-13 10:33:15-07:00,['a6d86b9998b4cdcdda40cedc5da2f7e695e39ee1'],69,347,416,2835335,5,0.424870466,1,0.590673575,6248
87aa8259ddf5d4e5ed75aa41c4ba2ad65e2624a6,0,Colin P. McCabe,2022-04-13 11:59:29-07:00,['f97646488cff1984455ffb1fe9a147a522e6ac76'],122,278,400,2835735,5,0.065789474,0.25,0.697368421,6248
01e4ceba52b7e2a4046b595f21b233c65060192e,0,GitHub,2022-04-14 11:58:57+02:00,['87aa8259ddf5d4e5ed75aa41c4ba2ad65e2624a6'],7,7,14,2835749,2,,,,6248
55ff5d360381af370fe5b3a215831beac49571a4,1,GitHub,2022-04-14 10:04:32-07:00,['01e4ceba52b7e2a4046b595f21b233c65060192e'],865,1027,1892,2837641,50,0.950819672,0.87431694,0.721311475,6249
a3a4323a5a2ea4ba1820da58a8c31532e8864f0d,0,GitHub,2022-04-14 22:23:52+02:00,['55ff5d360381af370fe5b3a215831beac49571a4'],37,40,77,2837718,1,,,,6249
f49cff412d3e15c5e7427b7ec09a89b3d157b2ec,0,GitHub,2022-04-14 17:25:37-07:00,['a3a4323a5a2ea4ba1820da58a8c31532e8864f0d'],1,1,2,2837720,1,,1,,6249
cf5e714a8bea8bb1de75201d0769bb1c246b9334,0,GitHub,2022-04-14 17:30:43-07:00,['f49cff412d3e15c5e7427b7ec09a89b3d157b2ec'],2,7,9,2837729,1,0,0,0,6249
b7f2d979d6e9be1ca542d42c6d79e3a9e14770ef,0,GitHub,2022-04-15 10:21:05+02:00,['cf5e714a8bea8bb1de75201d0769bb1c246b9334'],1,44,45,2837774,2,,,,6249
77cd8271047d5d099dde104e912161e0787a0f18,0,GitHub,2022-04-15 16:35:52+08:00,['b7f2d979d6e9be1ca542d42c6d79e3a9e14770ef'],221,289,510,2838284,4,0.333333333,1,1,6250
19b585356555374755a84f1651bef9024680df70,0,GitHub,2022-04-15 11:09:20+02:00,['77cd8271047d5d099dde104e912161e0787a0f18'],2,4,6,2838290,1,,,,6250
f4e3ccd81af453dae7cf0ec5b383882528a3a91f,0,GitHub,2022-04-15 21:00:11+08:00,['19b585356555374755a84f1651bef9024680df70'],1,1,2,2838292,1,,,,6250
2d2926cf8100888c151dbab4fd17f6bbbc87d9d8,0,GitHub,2022-04-15 16:22:16+02:00,['f4e3ccd81af453dae7cf0ec5b383882528a3a91f'],1,1,2,2838294,1,,,,6250
adf5cc5371db6253e070b11dc78dedc99c8065f9,1,GitHub,2022-04-15 11:28:43-07:00,['2d2926cf8100888c151dbab4fd17f6bbbc87d9d8'],67,458,525,2838819,15,0.271477663,0.742268041,0.896907216,6250
1521813a3a9710011b1ac7526ad3379f809032ca,1,GitHub,2022-04-15 16:07:23-07:00,['adf5cc5371db6253e070b11dc78dedc99c8065f9'],486,1190,1676,2840495,34,0.431865828,0.886792453,0.526205451,6253
51fb42bdfd62f9807368c9ecf2afde42a5dcfada,0,GitHub,2022-04-18 10:58:57-07:00,['1521813a3a9710011b1ac7526ad3379f809032ca'],1,1,2,2840497,1,,,,6253
6d36487b684fd41522cccd4da4fd88f0b89ff0b7,0,GitHub,2022-04-18 14:22:33-07:00,['51fb42bdfd62f9807368c9ecf2afde42a5dcfada'],8,15,23,2840520,2,1,1,0,6253
44906bdcdfbb09516e28f207ed0902d07f174cfd,0,GitHub,2022-04-19 14:13:21+08:00,['6d36487b684fd41522cccd4da4fd88f0b89ff0b7'],13,19,32,2840552,3,1,1,1,6253
9ec232fde850fc410d4adb07e1f259cab21336ad,0,GitHub,2022-04-19 15:08:29+08:00,['44906bdcdfbb09516e28f207ed0902d07f174cfd'],2,5,7,2840559,1,1,1,1,6253
fa0324485b1e76388bb15ea98170cfb9202aab1f,0,GitHub,2022-04-19 10:29:28-05:00,['9ec232fde850fc410d4adb07e1f259cab21336ad'],377,2210,2587,2843146,51,0.53021978,0.901098901,0.89010989,6262
9c3f605fc78f297ecf5accdcdec18471c19cf7d6,0,GitHub,2022-04-19 13:17:16-07:00,['fa0324485b1e76388bb15ea98170cfb9202aab1f'],32,162,194,2843340,5,0.260416667,0.760416667,1,6262
301c6f44d605f7152f25057c599eeb0b01b2aef9,0,GitHub,2022-04-20 12:45:03+02:00,['9c3f605fc78f297ecf5accdcdec18471c19cf7d6'],22,24,46,2843386,2,0,1,1,6262
2ed09db6c497185584e7e33044d0ce1945a61681,1,GitHub,2022-04-20 15:10:46+02:00,['301c6f44d605f7152f25057c599eeb0b01b2aef9'],125,121,246,2843632,39,1,1,0.052631579,6262
fb66b3668bd0a257a77ca43f7b1a31e8180f21f8,0,GitHub,2022-04-20 10:31:32-07:00,['2ed09db6c497185584e7e33044d0ce1945a61681'],0,3,3,2843635,1,,,,6262
d83fccd65f06a13c6245044ea5d1a2116bd67cbf,0,GitHub,2022-04-20 11:09:13-07:00,['fb66b3668bd0a257a77ca43f7b1a31e8180f21f8'],43,2262,2305,2845940,11,0.352067183,0.874031008,0.819767442,6264
c5077c679c372589215a1b58ca84360c683aa6e8,0,GitHub,2022-04-20 11:39:03-07:00,['d83fccd65f06a13c6245044ea5d1a2116bd67cbf'],113,49,162,2846102,7,0.407407407,0,0,6264
25457377e3883390b313fb3e6e7f8d1308e5a5ea,0,GitHub,2022-04-20 14:39:15-07:00,['c5077c679c372589215a1b58ca84360c683aa6e8'],8,9,17,2846119,1,1,1,0,6264
6b07f42ecd90148fce31aaa9910c1a3bede92a87,0,GitHub,2022-04-21 14:34:35+08:00,['25457377e3883390b313fb3e6e7f8d1308e5a5ea'],2,2,4,2846123,1,,,,6264
252e09501d08a36fa85e146239e114a71a944331,1,GitHub,2022-04-21 19:26:55+08:00,['6b07f42ecd90148fce31aaa9910c1a3bede92a87'],6,75,81,2846204,2,0.382978723,0.957446809,0.957446809,6264
32311bf369517ef9ad35a4db927067031ebdfafb,0,GitHub,2022-04-21 17:25:20+02:00,['252e09501d08a36fa85e146239e114a71a944331'],47,115,162,2846366,1,,,,6264
4380eae7ceb840dd93fee8ec90cd89a72bad7a3f,0,GitHub,2022-04-21 09:05:46-07:00,['32311bf369517ef9ad35a4db927067031ebdfafb'],0,25,25,2846391,3,0,0.928571429,1,6264
f28a2ee918423e402ad9ddca9451b973dddfc591,0,GitHub,2022-04-21 11:51:31-07:00,['4380eae7ceb840dd93fee8ec90cd89a72bad7a3f'],3,2,5,2846396,1,0,0,0,6264
d480c4aa6e513e36050d8e067931de2270525d18,0,GitHub,2022-04-21 14:58:02-07:00,['f28a2ee918423e402ad9ddca9451b973dddfc591'],8,48,56,2846452,4,0,0,1,6264
7c8c65fc54b9eb0386787632ff8315e097d99818,1,GitHub,2022-04-22 20:38:17+02:00,['d480c4aa6e513e36050d8e067931de2270525d18'],206,214,420,2846872,35,1,0,1,6264
ff3d42a18cc8dd91427411e6d0c71a3af8414764,0,GitHub,2022-04-24 16:50:44+08:00,['7c8c65fc54b9eb0386787632ff8315e097d99818'],10,10,20,2846892,2,,,,6264
e8c675ed56034f0cb04aebefd377239d7a43373c,1,GitHub,2022-04-24 17:06:19+08:00,['ff3d42a18cc8dd91427411e6d0c71a3af8414764'],7,19,26,2846918,1,0.142857143,1,1,6264
2b64f1a57160884754f0a3652c0bd34de21e9ad1,0,GitHub,2022-04-24 20:54:44+08:00,['e8c675ed56034f0cb04aebefd377239d7a43373c'],3,11,14,2846932,2,1,1,1,6264
25ee7f147c8b798a881538f59ba7b8544fbb2b1a,0,GitHub,2022-04-25 09:37:03-07:00,['2b64f1a57160884754f0a3652c0bd34de21e9ad1'],59,285,344,2847276,2,0,0.93258427,0.573033708,6264
a5f7c82a8674a3ae68b57571e8d9a564c87c7d54,1,GitHub,2022-04-25 21:43:32+01:00,['25ee7f147c8b798a881538f59ba7b8544fbb2b1a'],247,655,902,2848178,7,0.16,1,0.621538462,6264
2a7fdd76703189e6b081cfaf21b22945d1c59f8c,0,GitHub,2022-04-25 15:11:14-07:00,['a5f7c82a8674a3ae68b57571e8d9a564c87c7d54'],8,12,20,2848198,1,,,,6264
b020819ac415976bd09a8e5bfdfb43642837c64d,0,GitHub,2022-04-25 15:59:45-07:00,['2a7fdd76703189e6b081cfaf21b22945d1c59f8c'],7,15,22,2848220,3,0.125,0.75,1,6264
f2a782a4d7c71dabf79861f18c4bb14d2b2776ae,1,GitHub,2022-04-26 09:34:18-07:00,['b020819ac415976bd09a8e5bfdfb43642837c64d'],151,153,304,2848524,26,1,1,0,6264
6d7723f073ad0b935b02792be9aa4fd49b581b50,0,GitHub,2022-04-26 16:51:12-07:00,['f2a782a4d7c71dabf79861f18c4bb14d2b2776ae'],8,8,16,2848540,4,,,,6264
e026384ffb3170a2e71053a4163db58b9bd8fba6,0,GitHub,2022-04-27 11:27:54-07:00,['6d7723f073ad0b935b02792be9aa4fd49b581b50'],2,3,5,2848545,1,,,0,6264
4a367577b9886462cf8302dbd35bb9debad661e1,0,GitHub,2022-04-28 11:19:34+08:00,['e026384ffb3170a2e71053a4163db58b9bd8fba6'],1,1,2,2848547,1,,,,6264
c462a657ecbc4761e247c28159fa4055546f1be2,0,GitHub,2022-04-28 06:13:23-07:00,['4a367577b9886462cf8302dbd35bb9debad661e1'],5,8,13,2848560,1,0,0,0,6264
a673f2124218e524335ea13337bd3b49f52c52a3,0,GitHub,2022-04-29 13:35:25+08:00,['c462a657ecbc4761e247c28159fa4055546f1be2'],1,75,76,2848636,2,0.8,0.418181818,1,6264
53ad99309dd2c275c779000f4d36a4d0c9389043,0,GitHub,2022-04-29 17:44:39+02:00,['a673f2124218e524335ea13337bd3b49f52c52a3'],1,1,2,2848638,1,,,,6264
f0a09ea0036312b50321caacd2363818a4bc3859,0,GitHub,2022-04-29 10:02:25-07:00,['53ad99309dd2c275c779000f4d36a4d0c9389043'],22,34,56,2848694,2,0,0,1,6264
fbcff567d0612cc013a8327e05e74e075c670da4,0,GitHub,2022-05-02 17:02:53+08:00,['f0a09ea0036312b50321caacd2363818a4bc3859'],1,0,1,2848695,1,1,0,0,6264
4a6287e832c35593f851ce8ea427741bcb7d90d1,0,GitHub,2022-05-02 09:06:16-07:00,['fbcff567d0612cc013a8327e05e74e075c670da4'],2,2,4,2848699,1,,,,6264
8245c9a3d5af2ad891844194a5fa281af471b568,0,GitHub,2022-05-02 16:27:52-07:00,['4a6287e832c35593f851ce8ea427741bcb7d90d1'],1299,1407,2706,2851405,74,0.25,1,1,6268
3d087244d848b2b3b9cea1965d72aca9c5596fc1,0,GitHub,2022-05-03 12:24:53+02:00,['8245c9a3d5af2ad891844194a5fa281af471b568'],1,7,8,2851413,1,,,,6268
cc2aa96ae4063bdc50d692eaf5d11becbb94154b,0,GitHub,2022-05-03 09:42:23-07:00,['3d087244d848b2b3b9cea1965d72aca9c5596fc1'],259,1914,2173,2853586,13,0.122192273,0.683737646,0.766397125,6272
bf7cd675f8b35b806b1414c68479e69055df4a91,0,GitHub,2022-05-04 11:10:39+08:00,['cc2aa96ae4063bdc50d692eaf5d11becbb94154b'],120,42,162,2853748,4,0.862068966,0,0,6272
c6d3bcbd16a380e8a93a98c4fcbbc24a826dc0d5,0,GitHub,2022-05-04 11:15:29+08:00,['bf7cd675f8b35b806b1414c68479e69055df4a91'],1,1,2,2853750,1,,,,6272
18b84d0404d891263420628e12a2ce4f2ac85806,0,GitHub,2022-05-04 10:27:14-07:00,['c6d3bcbd16a380e8a93a98c4fcbbc24a826dc0d5'],6,7,13,2853763,2,,,,6272
430f75ba227b8f600ee7fafc2b83e2e97c38f03b,1,GitHub,2022-05-04 10:31:46-07:00,['18b84d0404d891263420628e12a2ce4f2ac85806'],44,139,183,2853946,8,0,0,0.494117647,6272
0a9893cac0db15d6de20f394bef46158410b4bcc,0,GitHub,2022-05-04 11:41:34-07:00,['430f75ba227b8f600ee7fafc2b83e2e97c38f03b'],57,118,175,2854121,5,0,0.837209302,1,6272
ced5989ff69f8a5e76518fdeb39f41ab20b2574f,0,GitHub,2022-05-05 16:00:35-07:00,['0a9893cac0db15d6de20f394bef46158410b4bcc'],6,804,810,2854931,6,0.475046211,0.950092421,0.957486137,6274
3b08deaa761c2387a41610893dc8302ab1d97338,0,GitHub,2022-05-05 16:09:16-07:00,['ced5989ff69f8a5e76518fdeb39f41ab20b2574f'],285,1757,2042,2856973,21,0.460196292,0.908396947,0.711014177,6280
a586c94af19ff6b825e974e26a241115defa6cda,0,GitHub,2022-05-06 11:13:59+02:00,['3b08deaa761c2387a41610893dc8302ab1d97338'],13,235,248,2857221,6,1,1,1,6283
16324448a2d3d52f6a3a0a2058c3ceec14e84d52,0,GitHub,2022-05-06 11:25:33+02:00,['a586c94af19ff6b825e974e26a241115defa6cda'],2,2,4,2857225,1,,,,6283
816d63b9086f5ad221a65bc52cb70f14b114abb4,0,GitHub,2022-05-06 11:43:30+02:00,['16324448a2d3d52f6a3a0a2058c3ceec14e84d52'],2,2,4,2857229,1,,,,6283
e3202b99999ef4c63aab2e5ab049978704282792,0,GitHub,2022-05-06 11:31:51-05:00,['816d63b9086f5ad221a65bc52cb70f14b114abb4'],1,1,2,2857231,1,,,,6283
f7db6031b84a136ad0e257df722b20faa7c37b8a,1,GitHub,2022-05-06 11:31:12-07:00,['e3202b99999ef4c63aab2e5ab049978704282792'],360,1571,1931,2859162,27,0.179661017,0.718644068,0.540677966,6285
1278e385c02a44861e9d00b32c0f476d4b149be5,0,GitHub,2022-05-09 21:43:47+08:00,['f7db6031b84a136ad0e257df722b20faa7c37b8a'],453,515,968,2860130,8,0.210526316,0.973684211,0.565789474,6285
df507e56e2d782b347fe51537153c33b599da55f,0,GitHub,2022-05-09 20:29:17+02:00,['1278e385c02a44861e9d00b32c0f476d4b149be5'],10,246,256,2860386,22,1,1,0.939393939,6285
b485f92647faecc3594bdf4164999d52c859b1bb,1,GitHub,2022-05-09 20:47:14+02:00,['df507e56e2d782b347fe51537153c33b599da55f'],78,510,588,2860974,4,0,0.822629969,1,6285
2a656aea27c7ed63acb40dae1ce710ddea50f46d,0,GitHub,2022-05-10 10:47:23+08:00,['b485f92647faecc3594bdf4164999d52c859b1bb'],1,1,2,2860976,1,,,,6285
989d3ce07f1848d4c0b9fbb116ff0cf9b3b382d7,0,GitHub,2022-05-10 14:49:56+08:00,['2a656aea27c7ed63acb40dae1ce710ddea50f46d'],19,19,38,2861014,5,,,,6285
eeb1e702eb7a43d88f11458f739672e2b7aa4871,0,GitHub,2022-05-10 11:36:42+01:00,['989d3ce07f1848d4c0b9fbb116ff0cf9b3b382d7'],22,48,70,2861084,3,0,1,1,6285
020ff2fe0ebb063bb40bca35286e1bd5e6ca42dd,0,GitHub,2022-05-10 14:47:46+02:00,['eeb1e702eb7a43d88f11458f739672e2b7aa4871'],0,6,6,2861090,3,,,,6285
0c1cde10802456b1bc3f5f12f5e4d3d6ae400edd,1,GitHub,2022-05-10 12:41:17-07:00,['020ff2fe0ebb063bb40bca35286e1bd5e6ca42dd'],24,170,194,2861284,8,0.293333333,0.92,0.946666667,6285
1cfc7c25fd7a9eee395b4d553ca469f9b3c5e271,0,GitHub,2022-05-10 12:44:39-07:00,['0c1cde10802456b1bc3f5f12f5e4d3d6ae400edd'],2,21,23,2861307,1,1,1,1,6285
773047660359bf6b551d06763eeff80bc551b58a,1,GitHub,2022-05-10 13:24:23-07:00,['1cfc7c25fd7a9eee395b4d553ca469f9b3c5e271'],461,538,999,2862306,12,0.173913043,1,0.630434783,6285
040b11d70594e0499e96014e17a307366b640444,0,GitHub,2022-05-10 15:26:57-07:00,['773047660359bf6b551d06763eeff80bc551b58a'],3,36,39,2862345,2,0,1,1,6285
2b14a0bb6dd11290d40c033c8c7ac203df72c988,0,GitHub,2022-05-10 20:14:21-07:00,['040b11d70594e0499e96014e17a307366b640444'],13,19,32,2862377,1,,,,6285
3ea7b418fb3d7e9fc74c27751c1b02b04877f197,0,GitHub,2022-05-11 09:30:46-07:00,['2b14a0bb6dd11290d40c033c8c7ac203df72c988'],131,183,314,2862691,3,1,1,1,6287
85cfa70f59162d3b7ae23c55bb3f3fe97e56ba80,0,GitHub,2022-05-11 09:46:37-07:00,['3ea7b418fb3d7e9fc74c27751c1b02b04877f197'],4,5,9,2862700,1,,,,6287
7268284699f84c7f61f5656167c36877b72d27f2,0,GitHub,2022-05-12 14:45:53+08:00,['85cfa70f59162d3b7ae23c55bb3f3fe97e56ba80'],28,365,393,2863093,7,0.362573099,1,0.98245614,6287
0007369581e8358ffb14234f7f9503ab6face4d2,0,GitHub,2022-05-12 14:51:27+08:00,['7268284699f84c7f61f5656167c36877b72d27f2'],1,1,2,2863095,1,,,,6287
6ab4d047d563e0fe42a7c0ed6f10ddecda135595,0,GitHub,2022-05-12 20:55:42+08:00,['0007369581e8358ffb14234f7f9503ab6face4d2'],2,11,13,2863108,1,0,1,1,6287
e94934b6b7275c64cf4b9a63d8de88f326e591cd,1,GitHub,2022-05-12 13:04:48-07:00,['6ab4d047d563e0fe42a7c0ed6f10ddecda135595'],34,91,125,2863233,7,0.333333333,1,1,6287
fa59be4e770627cd34cef85986b58ad7f606928d,0,GitHub,2022-05-12 14:48:33-07:00,['e94934b6b7275c64cf4b9a63d8de88f326e591cd'],392,837,1229,2864462,24,0.724770642,0.880733945,1,6288
467bce04ae4cc0bacedeb82a1d130bd8b4e19304,0,GitHub,2022-05-13 09:32:41+01:00,['fa59be4e770627cd34cef85986b58ad7f606928d'],7,8,15,2864477,4,,,,6288
f96e38138762c517e30c0406f974dd51ed26a2ab,0,GitHub,2022-05-13 17:09:47-07:00,['467bce04ae4cc0bacedeb82a1d130bd8b4e19304'],1,13,14,2864491,1,0,1,1,6288
78dd40123cc47e425264f516a4b8c6c2003c99b8,0,GitHub,2022-05-13 17:21:27-07:00,['f96e38138762c517e30c0406f974dd51ed26a2ab'],322,962,1284,2865775,18,0.376033058,1,0.384297521,6288
a3e0af94f2860a8d997017dcc2319396e62ff87f,0,GitHub,2022-05-13 17:29:47-07:00,['78dd40123cc47e425264f516a4b8c6c2003c99b8'],47,69,116,2865891,4,,,,6288
46efb72600e26ac4211a2defac1ff44f8734b404,0,GitHub,2022-05-13 19:29:00-07:00,['a3e0af94f2860a8d997017dcc2319396e62ff87f'],941,3247,4188,2870079,17,0.297360704,0.939589443,0.952492669,6291
1c02a764eca19d2606259a4efa58f6cfdfc8e70a,0,GitHub,2022-05-16 09:25:05+02:00,['46efb72600e26ac4211a2defac1ff44f8734b404'],21,14,35,2870114,5,1,1,1,6291
5fae84e4d138fd11d07cdf419c9fa2b3164570ea,0,GitHub,2022-05-16 15:50:50+08:00,['1c02a764eca19d2606259a4efa58f6cfdfc8e70a'],0,170,170,2870284,1,0.784810127,1,1,6292
354a4e9470856763e98fdd7b28fb413faffd5805,0,GitHub,2022-05-16 13:23:10+02:00,['5fae84e4d138fd11d07cdf419c9fa2b3164570ea'],1,1,2,2870286,1,,,,6292
cdd19a5326aae83d470eb8eab800b3e9ed21f013,0,GitHub,2022-05-16 17:44:14+02:00,['354a4e9470856763e98fdd7b28fb413faffd5805'],76,141,217,2870503,7,0.428571429,1,0.928571429,6292
06051988a2e3e6593eca21d8decbd59f2af46f90,0,GitHub,2022-05-16 09:38:06-07:00,['cdd19a5326aae83d470eb8eab800b3e9ed21f013'],2,4,6,2870509,1,,,,6292
1103c76d63a6bf14563eac8b5aaec4836061ff7e,1,GitHub,2022-05-16 17:41:23-07:00,['06051988a2e3e6593eca21d8decbd59f2af46f90'],63,123,186,2870695,5,0.291666667,0.9375,0.791666667,6292
972b76561a916158e8fef30e9af116465f1f567e,0,GitHub,2022-05-17 08:58:43+02:00,['1103c76d63a6bf14563eac8b5aaec4836061ff7e'],82,82,164,2870859,2,,,,6292
5f039bae1c74ac465a1a4f47a4721df7f15a4366,1,GitHub,2022-05-17 16:31:28+08:00,['972b76561a916158e8fef30e9af116465f1f567e'],11,23,34,2870893,1,1,1,1,6292
07459d2eb3e6c2278f22021854ae79c11cf6129b,0,GitHub,2022-05-17 11:19:26+02:00,['5f039bae1c74ac465a1a4f47a4721df7f15a4366'],1,1,2,2870895,1,,,,6292
f36de0744b915335de6b636e6bd6b5f1276f34f6,0,GitHub,2022-05-17 15:40:05-07:00,['07459d2eb3e6c2278f22021854ae79c11cf6129b'],45,31,76,2870971,1,1,1,0,6292
a1cd1d183900af787c8971c9af3a3546d02d4451,0,GitHub,2022-05-18 09:32:48+02:00,['f36de0744b915335de6b636e6bd6b5f1276f34f6'],27,120,147,2871118,5,0,0.975308642,0.975308642,6292
62ba4d3d4e42cf65174472f81caf3a18d8d7ed13,0,GitHub,2022-05-18 10:58:08-04:00,['a1cd1d183900af787c8971c9af3a3546d02d4451'],5,0,5,2871123,1,1,0,0,6292
67d00e25e941f73be8b959c6732ac4db1d1083bf,1,GitHub,2022-05-18 09:39:26-07:00,['62ba4d3d4e42cf65174472f81caf3a18d8d7ed13'],254,324,578,2871701,3,0.052631579,1,1,6292
cf34a2e4b083ae0b6fe43bee720d9347c0e18b86,0,GitHub,2022-05-18 11:31:15-07:00,['67d00e25e941f73be8b959c6732ac4db1d1083bf'],1,1,2,2871703,1,,,,6292
1135f22eaf404fdf76489302648199578876c4ac,1,GitHub,2022-05-18 12:08:36-07:00,['cf34a2e4b083ae0b6fe43bee720d9347c0e18b86'],236,1548,1784,2873487,72,0.553664921,0.744764398,0.854712042,6298
1802c6dcb59ea41322ad5a0226c3ae5c2a29b6fc,0,GitHub,2022-05-18 14:07:59-07:00,['1135f22eaf404fdf76489302648199578876c4ac'],82,96,178,2873665,1,0,0,0,6298
b4f35c9ce0ec902123fa6b5ad7c84c63118c7358,0,GitHub,2022-05-19 10:28:47+08:00,['1802c6dcb59ea41322ad5a0226c3ae5c2a29b6fc'],2,2,4,2873669,1,,,,6298
8efdbce5231f3b5ef61deb827c41b0a8c50aa84a,1,GitHub,2022-05-18 20:58:20-07:00,['b4f35c9ce0ec902123fa6b5ad7c84c63118c7358'],512,760,1272,2874941,14,0.672839506,1,0,6298
6380652a5a3c66bef4dc8231c3eb4842b3556148,0,GitHub,2022-05-19 09:46:48-07:00,['8efdbce5231f3b5ef61deb827c41b0a8c50aa84a'],27,87,114,2875055,6,0,0.566037736,1,6298
a8e3a259e5d4daf098a503a25aa6249e21ba557a,0,GitHub,2022-05-19 16:24:34-07:00,['6380652a5a3c66bef4dc8231c3eb4842b3556148'],1,149,150,2875205,2,0.75,1,1,6299
3f86a183bea5902785b4ddc6934030160d99095a,0,GitHub,2022-05-20 09:17:39-05:00,['a8e3a259e5d4daf098a503a25aa6249e21ba557a'],24,36,60,2875265,1,0,1,1,6299
f6ba10ef9c2c2d94473efd2fd596b172fcff494a,0,GitHub,2022-05-21 10:33:44-07:00,['3f86a183bea5902785b4ddc6934030160d99095a'],21,29,50,2875315,3,0,1,1,6299
4878653016c32e55d6e829ea1b4f80a825459706,0,GitHub,2022-05-21 18:14:02-07:00,['f6ba10ef9c2c2d94473efd2fd596b172fcff494a'],9,4,13,2875328,2,0.8,0,0,6299
b5699b5ccd68ae0b27530a6cfcf14a5f3099eef0,0,GitHub,2022-05-23 09:47:14-07:00,['4878653016c32e55d6e829ea1b4f80a825459706'],18,26,44,2875372,2,0,0,0,6299
9dc332f5ca34b80af369646f767c40c6b189f831,0,GitHub,2022-05-23 10:07:19-07:00,['b5699b5ccd68ae0b27530a6cfcf14a5f3099eef0'],0,276,276,2875648,2,0.233333333,1,1,6299
286bae4251fcea47de58a3e4b77e337201c5b64d,0,GitHub,2022-05-24 16:59:14-07:00,['9dc332f5ca34b80af369646f767c40c6b189f831'],82,290,372,2876020,4,0.743421053,1,1,6299
f7502f430aaf33bdfa0d9801254eba4fc078cbde,0,GitHub,2022-05-25 10:25:00-07:00,['286bae4251fcea47de58a3e4b77e337201c5b64d'],4,5,9,2876029,1,1,0,1,6299
6efde847ca1bbf25e6eb8a306e4ce584319c8c12,0,GitHub,2022-05-25 10:40:46-07:00,['f7502f430aaf33bdfa0d9801254eba4fc078cbde'],1,1,2,2876031,1,,,,6299
54d60ced869cbc31776f755c7f464ae2d2ee3e95,0,GitHub,2022-05-25 14:02:34-04:00,['6efde847ca1bbf25e6eb8a306e4ce584319c8c12'],559,404,963,2876994,23,0,0.526315789,0,6299
46630a0610746e2b59e7ee130fbc277c50c9d19e,0,GitHub,2022-05-25 20:03:06+02:00,['54d60ced869cbc31776f755c7f464ae2d2ee3e95'],0,1,1,2876995,1,,,,6299
76477ffd2d8a84803c57839fab6e0707045cd8f5,0,GitHub,2022-05-25 16:09:01-07:00,['46630a0610746e2b59e7ee130fbc277c50c9d19e'],61,218,279,2877274,4,0.036363636,0.909090909,0.918181818,6299
c22d320a5c85f38506839352d82d5fbbc0749878,0,GitHub,2022-05-25 16:25:16-07:00,['76477ffd2d8a84803c57839fab6e0707045cd8f5'],12,164,176,2877450,16,0.388888889,0.62962963,0.944444444,6299
02fc6e7d3ca6875251ee6974a62c826b186dcaf0,0,GitHub,2022-05-25 17:36:58-07:00,['c22d320a5c85f38506839352d82d5fbbc0749878'],0,3,3,2877453,1,,,,6299
43160bc4766891d072f2da8117a0bb65a018dfd8,0,GitHub,2022-05-26 16:07:54-04:00,['02fc6e7d3ca6875251ee6974a62c826b186dcaf0'],1,3,4,2877457,1,,,,6299
8fe73648e3dba4a50e08fb2ad8ea9e83076d1c94,0,GitHub,2022-05-26 16:09:39-04:00,['43160bc4766891d072f2da8117a0bb65a018dfd8'],14,48,62,2877519,1,,,,6299
4efdc1a31070b1d1d338e9908041697378af0d8e,1,GitHub,2022-05-26 16:25:58-04:00,['8fe73648e3dba4a50e08fb2ad8ea9e83076d1c94'],340,295,635,2878154,31,1,0,0,6299
7143267f71ca0c14957d8560fbc42a5f8aac564d,0,GitHub,2022-05-26 14:07:29-07:00,['4efdc1a31070b1d1d338e9908041697378af0d8e'],1,56,57,2878211,4,0.452830189,0.962264151,1,6299
24261b93bc20da6424b82b76d446b18b17771a66,0,GitHub,2022-05-27 13:22:07-07:00,['7143267f71ca0c14957d8560fbc42a5f8aac564d'],4,0,4,2878215,1,,,,6299
620ada9888f82756d6ed0eabe96bb9b54518b378,0,GitHub,2022-05-27 13:38:54-07:00,['24261b93bc20da6424b82b76d446b18b17771a66'],1,1,2,2878217,1,,,,6299
6b93652a5469b66419189336a6a96d5742a19043,0,GitHub,2022-05-28 09:15:22-07:00,['620ada9888f82756d6ed0eabe96bb9b54518b378'],19,22,41,2878258,1,0,0,1,6299
f980820e2b71dfa061c9d662b247caa5ea9c530f,0,GitHub,2022-05-30 09:21:41-07:00,['6b93652a5469b66419189336a6a96d5742a19043'],0,2,2,2878260,1,,,,6299
645c1ba526ec11049429dc5e9ba347fc386df58e,0,GitHub,2022-05-30 11:34:36-07:00,['f980820e2b71dfa061c9d662b247caa5ea9c530f'],100,98,198,2878458,4,0,1,1,6299
31a84dd72ee02ec54cfe4103c4c5612e95205b7d,0,GitHub,2022-05-30 15:55:07-07:00,['645c1ba526ec11049429dc5e9ba347fc386df58e'],1,1,2,2878460,1,,,,6299
8a05884343c0bae5e9af400c1742157753b4cf9a,0,GitHub,2022-05-30 15:57:46-07:00,['31a84dd72ee02ec54cfe4103c4c5612e95205b7d'],1,1,2,2878462,1,,,,6299
4c9eeef5b2dff9a4f0977fbc5ac7eaaf930d0d0e,0,GitHub,2022-05-31 14:22:13-07:00,['8a05884343c0bae5e9af400c1742157753b4cf9a'],21,254,275,2878737,72,,,,6299
283a9955cffc566e4396fda45b550019b0d1fb8d,0,GitHub,2022-06-01 09:48:31+02:00,['4c9eeef5b2dff9a4f0977fbc5ac7eaaf930d0d0e'],26,14,40,2878777,1,1,0,0,6299
7d1b0926fab104311a505826831ddc45864e9a6a,0,GitHub,2022-06-01 10:48:24-07:00,['283a9955cffc566e4396fda45b550019b0d1fb8d'],199,826,1025,2879802,26,0.331343284,0.928358209,0.83880597,6302
1d6e3d6cb3a798983cafb0367b90c3a51579c364,0,GitHub,2022-06-01 14:49:00-07:00,['7d1b0926fab104311a505826831ddc45864e9a6a'],21,106,127,2879929,5,0,0.849315068,0.849315068,6302
0ca9cd4d2d2a89510dbe357783a316f2f0789799,0,GitHub,2022-06-01 16:09:38-07:00,['1d6e3d6cb3a798983cafb0367b90c3a51579c364'],280,257,537,2880466,10,0,1,1,6302
65b4374203608dc4d68544bde16d4acd2e31efd1,0,GitHub,2022-06-01 16:33:01-07:00,['0ca9cd4d2d2a89510dbe357783a316f2f0789799'],76,265,341,2880807,11,0.468085106,0.70212766,0.542553191,6304
0f9f7e6c7863b87f20d6b133535c4f3b181b55bf,0,GitHub,2022-06-01 16:56:10-07:00,['65b4374203608dc4d68544bde16d4acd2e31efd1'],31,38,69,2880876,5,0,1,0,6304
fa33fb4d3ced39ee985a15c1e44650542a3b47d2,0,GitHub,2022-06-02 14:15:51+08:00,['0f9f7e6c7863b87f20d6b133535c4f3b181b55bf'],27,107,134,2881010,4,0.232142857,0.357142857,0.839285714,6304
61df3034fece16180a479ed8758f383f6523eac3,0,GitHub,2022-06-02 10:21:07+02:00,['fa33fb4d3ced39ee985a15c1e44650542a3b47d2'],12,9,21,2881031,2,0,0,0,6304
a110f1fe852ae8c958a8c64b0736a9bb0617338e,0,GitHub,2022-06-02 11:57:50+02:00,['61df3034fece16180a479ed8758f383f6523eac3'],66,466,532,2881563,3,0.317406143,0.733788396,0.737201365,6304
e4f4e50b7ba5a3b3837c33157c96c839dc57457f,0,GitHub,2022-06-02 12:05:30+02:00,['a110f1fe852ae8c958a8c64b0736a9bb0617338e'],4,4,8,2881571,1,,,,6304
d8d92f0f8014e5686e956a0c82bb2afdd41592d5,0,GitHub,2022-06-02 21:30:22+08:00,['e4f4e50b7ba5a3b3837c33157c96c839dc57457f'],54,43,97,2881668,3,,,,6304
0aea498b9a2e70bdd92859159c0a868e9b8900d9,0,GitHub,2022-06-02 20:21:23+02:00,['d8d92f0f8014e5686e956a0c82bb2afdd41592d5'],1,1,2,2881670,1,,,,6304
09f5d17e696aaba397980bc6bc2abf391aa25fa8,0,GitHub,2022-06-03 10:46:05+08:00,['0aea498b9a2e70bdd92859159c0a868e9b8900d9'],1,1,2,2881672,1,,,,6304
54243247228cf8da165897f9f7fd5289c4166099,0,GitHub,2022-06-03 09:13:10+02:00,['09f5d17e696aaba397980bc6bc2abf391aa25fa8'],5,24,29,2881701,5,,,,6304
7e71483aed3db3979688c8ad43529fddaa0bd601,0,GitHub,2022-06-03 15:56:13+08:00,['54243247228cf8da165897f9f7fd5289c4166099'],4,4,8,2881709,1,,,,6304
47bb93cfd79d0dda5305f1560b9c72ec7e505a90,0,GitHub,2022-06-03 17:50:49+02:00,['7e71483aed3db3979688c8ad43529fddaa0bd601'],2,2,4,2881713,2,,,,6304
3467036e017adc3ac0919bbc0c067b1bb1b621f3,0,GitHub,2022-06-03 09:12:06-07:00,['47bb93cfd79d0dda5305f1560b9c72ec7e505a90'],1071,1447,2518,2884231,20,0.277027027,1,0.736486486,6307
0b3ab4687eec8a463689dccee267361177a27ae7,0,GitHub,2022-06-03 11:39:30-07:00,['3467036e017adc3ac0919bbc0c067b1bb1b621f3'],1,1,2,2884233,1,,,,6307
a39d447677d2886c463bd11377896a0f7f5bf6dd,0,GitHub,2022-06-04 13:23:11+08:00,['0b3ab4687eec8a463689dccee267361177a27ae7'],7,7,14,2884247,1,,,,6307
04f23688e71f0076c2a44a53c3906bfb660fdaf5,0,GitHub,2022-06-05 15:08:37+08:00,['a39d447677d2886c463bd11377896a0f7f5bf6dd'],1,1,2,2884249,1,,,,6307
6ff2bf03a99290afe027e03e02ad8ca64a8cca78,0,GitHub,2022-06-05 15:13:02+08:00,['04f23688e71f0076c2a44a53c3906bfb660fdaf5'],1,1,2,2884251,1,,,,6307
af71375d6d720a264cbe9c9247da374f1a9309df,0,GitHub,2022-06-05 15:47:09+08:00,['6ff2bf03a99290afe027e03e02ad8ca64a8cca78'],50,45,95,2884346,5,1,0,0,6307
2047fc3715002899996ba3e41d16551d2067edad,0,GitHub,2022-06-06 11:05:41-07:00,['af71375d6d720a264cbe9c9247da374f1a9309df'],8,73,81,2884427,3,0,0.96875,1,6307
601051354b4a1c6dede521c2966bbf7eb189f99d,0,GitHub,2022-06-06 11:18:24-07:00,['2047fc3715002899996ba3e41d16551d2067edad'],2,10,12,2884439,5,,,,6307
5d593287c7db7030c444a469db72d59b3883d904,0,Guozhang Wang,2022-06-06 11:34:59-07:00,['601051354b4a1c6dede521c2966bbf7eb189f99d'],1,1,2,2884441,1,,,,6307
75223b668d24f630670ece03d29de631e6f8bd20,0,GitHub,2022-06-06 12:25:05-07:00,['5d593287c7db7030c444a469db72d59b3883d904'],3,1,4,2884445,2,,,,6307
09570f2540269cc1196c4c69cc7997d035159d1d,0,GitHub,2022-06-06 17:56:48-07:00,['75223b668d24f630670ece03d29de631e6f8bd20'],40,35,75,2884520,1,1,0,0,6307
603502bf5fb78983434a1a44ccc15a49ef6942b0,0,GitHub,2022-06-07 15:16:48+08:00,['09570f2540269cc1196c4c69cc7997d035159d1d'],138,657,795,2885315,30,0.431893688,0.750830565,0.913621262,6308
a6c5a74fdbdce9a992b47706913c920902cda28c,0,GitHub,2022-06-07 16:02:17+02:00,['603502bf5fb78983434a1a44ccc15a49ef6942b0'],262,1098,1360,2886675,33,0.1,0.948148148,0.666666667,6310
151ca12a56c854d78be07f9893ef7984277bb5c1,0,GitHub,2022-06-07 10:37:20-07:00,['a6c5a74fdbdce9a992b47706913c920902cda28c'],165,922,1087,2887762,20,0.13271028,0.945794393,0.938317757,6311
806098ffe1bd28e2ae12884a60f5bf14432b7e01,0,GitHub,2022-06-07 11:25:40-07:00,['151ca12a56c854d78be07f9893ef7984277bb5c1'],16,28,44,2887806,2,1,1,1,6311
49a0e0d72e510e683719bca662cd9ca7cabd0eab,0,GitHub,2022-06-07 17:50:45-07:00,['806098ffe1bd28e2ae12884a60f5bf14432b7e01'],6,3,9,2887815,1,0,0,0,6311
ae279a9d26c4d736ec830ff5e90c527312b54df8,0,GitHub,2022-06-07 17:54:20-07:00,['49a0e0d72e510e683719bca662cd9ca7cabd0eab'],5,7,12,2887827,1,,,,6311
4542acdc14d5ec3daa1f36d8dc24abc244ee24ff,0,GitHub,2022-06-07 20:59:24-07:00,['ae279a9d26c4d736ec830ff5e90c527312b54df8'],56,87,143,2887970,2,0,1,0.85,6311
1e2611aed4bd86ddba1631d9b2c3c5d4661b33d0,0,GitHub,2022-06-08 02:02:40-07:00,['4542acdc14d5ec3daa1f36d8dc24abc244ee24ff'],4,6,10,2887980,1,,,,6311
21490af989ec02916adcd64ea5cf439dbb682525,0,GitHub,2022-06-08 10:45:04-07:00,['1e2611aed4bd86ddba1631d9b2c3c5d4661b33d0'],1,11,12,2887992,2,0.333333333,1,1,6311
249cd4461faf003e6baa2327e9ceb130eb80c952,0,GitHub,2022-06-08 13:51:41-07:00,['21490af989ec02916adcd64ea5cf439dbb682525'],2,2,4,2887996,1,,,,6311
4f40883d02646564e3bdabbfa2b57ad58cc31dbd,0,GitHub,2022-06-09 09:39:23+08:00,['249cd4461faf003e6baa2327e9ceb130eb80c952'],2,6,8,2888004,2,,,,6311
51c9c7172b621d2368826f8ec01bce281fe5b9e6,0,GitHub,2022-06-09 05:54:57-07:00,['4f40883d02646564e3bdabbfa2b57ad58cc31dbd'],1,1,2,2888006,1,,,,6311
e67408c859fb2a80f1b3c208b7fef6ddc9a711fb,0,GitHub,2022-06-09 10:28:26-07:00,['51c9c7172b621d2368826f8ec01bce281fe5b9e6'],166,595,761,2888767,5,0.652777778,1,0.982638889,6313
f8f57960c69fe677b9192b841fb7a0361ef2cc83,0,GitHub,2022-06-10 12:05:05+08:00,['e67408c859fb2a80f1b3c208b7fef6ddc9a711fb'],3,2,5,2888772,1,,,,6313
4a0645863336bcdbcc71acc0d573af3791b2165d,0,GitHub,2022-06-10 11:35:22+02:00,['f8f57960c69fe677b9192b841fb7a0361ef2cc83'],19,107,126,2888898,9,1,1,1,6314
0a50005408b41fc8b3b26e2ed146b3e49d15af10,0,GitHub,2022-06-10 13:28:55+02:00,['4a0645863336bcdbcc71acc0d573af3791b2165d'],38,50,88,2888986,15,0.75,0.75,1,6314
6c90f3335ea3f8c786a45e599c0dd07ce2790487,0,GitHub,2022-06-10 13:55:52+02:00,['0a50005408b41fc8b3b26e2ed146b3e49d15af10'],17,17,34,2889020,8,,,,6314
6853d63e4de03d679978add576aa0977cecc053a,0,GitHub,2022-06-10 14:35:35+02:00,['6c90f3335ea3f8c786a45e599c0dd07ce2790487'],385,2022,2407,2891427,26,0.324626866,0.982276119,0.901119403,6315
3d5b41e05f0011dcf607f7d9cb269e8bb4558c57,0,GitHub,2022-06-10 21:33:33+08:00,['6853d63e4de03d679978add576aa0977cecc053a'],52,266,318,2891745,5,0.715277778,1,0.854166667,6315
7692643f593ec6574f6b5c49302d11c8d4315335,0,GitHub,2022-06-10 09:51:36-07:00,['3d5b41e05f0011dcf607f7d9cb269e8bb4558c57'],2,6,8,2891753,1,,,,6315
c23d60d56cd73118624192cf03f6e400f59027e7,0,GitHub,2022-06-13 10:39:54+08:00,['7692643f593ec6574f6b5c49302d11c8d4315335'],0,68,68,2891821,2,0.283018868,0.981132075,1,6315
9e8ef8bb317599c184ce8201d494edf109d9c528,1,GitHub,2022-06-13 16:25:29+02:00,['c23d60d56cd73118624192cf03f6e400f59027e7'],1262,4656,5918,2897739,26,0.408607595,0.868860759,0.72556962,6322
89c057397ec5ae320aee7e12e1a984b2c14a7fa5,0,GitHub,2022-06-13 16:46:19+02:00,['9e8ef8bb317599c184ce8201d494edf109d9c528'],18,43,61,2897800,1,,,,6322
4426b05e549e97c9d1f544083f4dcb71e109b819,0,GitHub,2022-06-13 17:25:40+02:00,['89c057397ec5ae320aee7e12e1a984b2c14a7fa5'],1,2,3,2897803,1,,,,6322
5cab11cf525f6c06fcf9eb43f7f95ef33fe1cdbb,0,GitHub,2022-06-13 10:36:39-07:00,['4426b05e549e97c9d1f544083f4dcb71e109b819'],12,92,104,2897907,4,0,0.64,0.7,6322
cc384054c6e63abd011f7687523b1292062b049d,1,GitHub,2022-06-13 14:23:28-04:00,['5cab11cf525f6c06fcf9eb43f7f95ef33fe1cdbb'],182,379,561,2898468,38,0.413793103,0.890804598,0.862068966,6322
3189a8648f3abf3e16c5932dfa37e0d28d97a016,0,GitHub,2022-06-13 22:27:06-07:00,['cc384054c6e63abd011f7687523b1292062b049d'],16,50,66,2898534,3,0.384615385,1,1,6322
f83d95d9a28267f7ef7a7b1e584dcdb4aa842210,1,GitHub,2022-06-14 13:12:45+02:00,['3189a8648f3abf3e16c5932dfa37e0d28d97a016'],597,1738,2335,2900869,32,0.146984925,0.565326633,0.728643216,6325
4fcfd9ddc4a8da3d4cfbb69268c06763352e29a9,0,GitHub,2022-06-14 14:20:29+02:00,['f83d95d9a28267f7ef7a7b1e584dcdb4aa842210'],7,167,174,2901043,10,0.222222222,0.948717949,0.760683761,6325
f421c008aa0495441ce6f017cdd041937a26d10f,0,GitHub,2022-06-14 09:10:18-07:00,['4fcfd9ddc4a8da3d4cfbb69268c06763352e29a9'],18,1,19,2901062,1,0.4,0,0.6,6325
39a555ba94a6a5d851b31e0a7f07e19c48327835,0,GitHub,2022-06-14 16:04:26-07:00,['f421c008aa0495441ce6f017cdd041937a26d10f'],12,9,21,2901083,4,0.5,0.25,0.25,6325
44edad5bb54ee23cb40b02180a84eb9edc052978,0,GitHub,2022-06-14 22:29:25-07:00,['39a555ba94a6a5d851b31e0a7f07e19c48327835'],1,3,4,2901087,1,,,,6325
b04937dc65e33e6e2867d259a8d3d4cc10ca6360,0,GitHub,2022-06-15 16:45:00+02:00,['44edad5bb54ee23cb40b02180a84eb9edc052978'],1,15,16,2901103,1,1,1,1,6325
a126e3a622f2b7142f3543b9dbee54b6412ba9d8,0,GitHub,2022-06-15 09:20:15-07:00,['b04937dc65e33e6e2867d259a8d3d4cc10ca6360'],32,524,556,2901659,12,0.357400722,0.577617329,0.83032491,6328
7ed3748a462cd1ce7c30bb9a331b94a3cd79a401,0,GitHub,2022-06-16 16:06:02+02:00,['a126e3a622f2b7142f3543b9dbee54b6412ba9d8'],49,1125,1174,2902833,20,0.590032154,0.993569132,0.879421222,6333
683d0bbc4ca7223e0ade55be58497af8aded6823,0,GitHub,2022-06-16 09:40:08-07:00,['7ed3748a462cd1ce7c30bb9a331b94a3cd79a401'],1,1,2,2902835,1,,,,6333
ee565f5f6b97c84d4f7f895fcb79188822284414,0,GitHub,2022-06-16 14:27:38-07:00,['683d0bbc4ca7223e0ade55be58497af8aded6823'],2,6,8,2902843,1,0,0.5,0.5,6333
17637c4ad590c681ab04bc6a444a32605ae940b0,0,GitHub,2022-06-16 16:46:07-07:00,['ee565f5f6b97c84d4f7f895fcb79188822284414'],65,68,133,2902976,6,1,0,0,6333
1e21201ea24389bdaccb8a462f3a53e356b58a58,0,GitHub,2022-06-17 16:31:13+02:00,['17637c4ad590c681ab04bc6a444a32605ae940b0'],2,2,4,2902980,1,,,,6333
cfdd567955588e134770a9145ba57800ca88313c,0,GitHub,2022-06-17 20:17:02-07:00,['1e21201ea24389bdaccb8a462f3a53e356b58a58'],21,29,50,2903030,6,1,1,0.2,6333
35ee09d43fe745abc224928b7b4e612c912fdb73,0,GitHub,2022-06-20 16:57:49+08:00,['cfdd567955588e134770a9145ba57800ca88313c'],14,14,28,2903058,1,,,,6333
30216ea1c58761e62f51af40033f24e3ae1c5c2a,0,GitHub,2022-06-20 16:47:02+02:00,['35ee09d43fe745abc224928b7b4e612c912fdb73'],4,8,12,2903070,2,0,0,1,6333
d65d8867983e54a36178c3a1227b68c8a468d415,0,GitHub,2022-06-21 12:39:08+05:18,['30216ea1c58761e62f51af40033f24e3ae1c5c2a'],123,435,558,2903628,32,0.534090909,0.511363636,0.857954545,6334
b7b7615db38d8a5d16fa13a227c4a09b4ea355e8,0,GitHub,2022-06-21 15:58:17+08:00,['d65d8867983e54a36178c3a1227b68c8a468d415'],181,1459,1640,2905268,17,0.13375,0.83,0.64875,6334
09286669877abaf17a1d9d52fa34c294e050f835,0,GitHub,2022-06-21 13:10:36+02:00,['b7b7615db38d8a5d16fa13a227c4a09b4ea355e8'],87,74,161,2905429,6,0.6,0,0,6334
4d53dd99720ca4605a2975d2f14c58b80a965550,0,GitHub,2022-06-21 16:33:40+02:00,['09286669877abaf17a1d9d52fa34c294e050f835'],10,1365,1375,2906804,13,0.214201183,0.668639053,0.582248521,6339
3072b3d23e43f3bc3478eca1087312edb620dc6b,0,GitHub,2022-06-21 18:24:33+02:00,['4d53dd99720ca4605a2975d2f14c58b80a965550'],8,18,26,2906830,2,0,1,1,6339
ead66451230f71fc85f8b5142e4d5d88dbcfcb68,0,GitHub,2022-06-22 13:27:47-07:00,['3072b3d23e43f3bc3478eca1087312edb620dc6b'],8,43,51,2906881,3,1,1,1,6339
6f5843dae65413de3dc5aca255113645a3da57aa,0,GitHub,2022-06-23 09:44:50+02:00,['ead66451230f71fc85f8b5142e4d5d88dbcfcb68'],151,198,349,2907230,1,0.30952381,1,1,6339
269277f73bd3c18c378ea3fa6ccc7eb79b914d15,0,GitHub,2022-06-23 09:45:22+02:00,['6f5843dae65413de3dc5aca255113645a3da57aa'],94,102,196,2907426,1,1,1,1,6339
8026a0edd8c309567ae075e5f4bcc4328ea91d9f,0,GitHub,2022-06-23 09:45:46+02:00,['269277f73bd3c18c378ea3fa6ccc7eb79b914d15'],14,20,34,2907460,1,0,1,1,6339
d00b7875e0ad7e005b9b54d39f47269c71e95fbe,0,GitHub,2022-06-23 16:56:53+02:00,['8026a0edd8c309567ae075e5f4bcc4328ea91d9f'],55,148,203,2907663,11,0.8,0.828571429,1,6340
c6c9da02a81fcc034ea916230ac8acea603d41b7,0,GitHub,2022-06-23 11:29:21-04:00,['d00b7875e0ad7e005b9b54d39f47269c71e95fbe'],10,105,115,2907778,3,0.067567568,0.986486486,0.878378378,6340
925c6281733662cd40fffaab54a6483b00f80ee6,0,GitHub,2022-06-23 10:46:14-07:00,['c6c9da02a81fcc034ea916230ac8acea603d41b7'],17,197,214,2907992,8,0.508064516,1,0.975806452,6340
cf9c3a2ecaf0b6abf00194334157a1e94ff9f618,0,GitHub,2022-06-24 11:48:09+02:00,['925c6281733662cd40fffaab54a6483b00f80ee6'],1,1,2,2907994,1,,,,6340
08e27914ccf492e32c7fff652f32236b2dce8928,0,GitHub,2022-06-24 12:19:22+02:00,['cf9c3a2ecaf0b6abf00194334157a1e94ff9f618'],1,3,4,2907998,1,1,1,1,6340
1ceaf30039e48199e40951c5a8d52894bb45e4d3,0,GitHub,2022-06-24 09:33:24-07:00,['08e27914ccf492e32c7fff652f32236b2dce8928'],106,436,542,2908540,3,0.414414414,0.815315315,1,6340
a3c7017ff7e543b50f84110195690a253f19d9cf,0,GitHub,2022-06-25 10:25:55-07:00,['1ceaf30039e48199e40951c5a8d52894bb45e4d3'],19,14,33,2908573,1,0,0,0,6340
d654bc1b15740acf8f1647a0f4533f4cd7f71271,0,GitHub,2022-06-27 16:01:15-07:00,['a3c7017ff7e543b50f84110195690a253f19d9cf'],50,78,128,2908701,4,1,1,1,6340
025e47b8334eb7125c7fdd2f725a2fef3c98344c,0,GitHub,2022-06-27 18:50:34-07:00,['d654bc1b15740acf8f1647a0f4533f4cd7f71271'],0,1,1,2908702,1,,,,6340
6ac7f4ea8f1dafdf644fcfb869fbf9f04238786e,0,GitHub,2022-06-28 21:39:32-04:00,['025e47b8334eb7125c7fdd2f725a2fef3c98344c'],21,21,42,2908744,2,,0,,6340
08e509459bd61f6aafb9f7d3902dccbbc7e13296,0,GitHub,2022-06-29 20:53:36+08:00,['6ac7f4ea8f1dafdf644fcfb869fbf9f04238786e'],31,194,225,2908969,4,0,1,0.676923077,6340
ababc4261bfa03ee9d29ae7254ddd0ba988f826d,0,GitHub,2022-06-29 09:22:37-07:00,['08e509459bd61f6aafb9f7d3902dccbbc7e13296'],406,676,1082,2910051,28,0.296460177,1,0.681415929,6340
3faa6cf6d060887288fcf68adb8c3f1e2090b8ed,0,GitHub,2022-06-29 12:33:00-07:00,['ababc4261bfa03ee9d29ae7254ddd0ba988f826d'],17,22,39,2910090,2,0,1,1,6340
1daa149730e3c56b7b6fe8f14369178273e8efc4,0,GitHub,2022-06-30 09:30:14-07:00,['3faa6cf6d060887288fcf68adb8c3f1e2090b8ed'],1,1,2,2910092,1,,,,6340
c19398ee6682f08ed12a2b7ca5ec58af25ede130,0,GitHub,2022-06-30 21:03:54-07:00,['1daa149730e3c56b7b6fe8f14369178273e8efc4'],9,32,41,2910133,2,1,1,1,6340
6bf5bfc2982158c3a1bfff4a0f65ea901ea84e7a,0,GitHub,2022-06-30 21:07:21-07:00,['c19398ee6682f08ed12a2b7ca5ec58af25ede130'],6,46,52,2910185,2,0,0.878787879,1,6340
c12348ac982378b755e104e95d7e1b2cba4c2948,0,GitHub,2022-07-01 10:28:37-07:00,['6bf5bfc2982158c3a1bfff4a0f65ea901ea84e7a'],65,0,65,2910250,2,0,0,0,6340
bad475166f0f0b27ec78d6ebe921b95749c4a3c1,0,GitHub,2022-07-01 10:30:32-07:00,['c12348ac982378b755e104e95d7e1b2cba4c2948'],4,4,8,2910258,1,,,,6340
a82a8e02cea72261d52b6764e94b93b085b038ac,0,GitHub,2022-07-02 18:48:07-07:00,['bad475166f0f0b27ec78d6ebe921b95749c4a3c1'],117,149,266,2910524,1,0,1,1,6340
ae570f59533ae941bbf5ab9ff5e739a5bd855fd6,0,GitHub,2022-07-03 10:02:59-07:00,['a82a8e02cea72261d52b6764e94b93b085b038ac'],13,22,35,2910559,5,0,0.111111111,0.777777778,6340
4e6326f889abbdcf1ad066f56af392165716659f,0,GitHub,2022-07-04 20:26:53+02:00,['ae570f59533ae941bbf5ab9ff5e739a5bd855fd6'],13,26,39,2910598,1,0,0,1,6340
aa735062eb420fbf964f1df6467d6e371c5a5794,0,GitHub,2022-07-05 14:16:18+08:00,['4e6326f889abbdcf1ad066f56af392165716659f'],3,3,6,2910604,1,,,,6340
ec22af94a6d7892c454fab97898bf68930bb61fc,0,GitHub,2022-07-05 12:34:23+02:00,['aa735062eb420fbf964f1df6467d6e371c5a5794'],32,229,261,2910865,2,0.459854015,1,0.948905109,6340
277c4c2e97d2aef096ab0e998fdd1ae513508798,0,GitHub,2022-07-05 17:17:31+05:18,['ec22af94a6d7892c454fab97898bf68930bb61fc'],9,33,42,2910907,1,,,,6340
448441a35d2f0c200c0f642f2bb618bd2d43df23,0,GitHub,2022-07-05 15:19:00-07:00,['277c4c2e97d2aef096ab0e998fdd1ae513508798'],61,128,189,2911096,14,0.72,0.74,1,6340
3ae1afa43838066e44ea78918050c6780c208042,0,GitHub,2022-07-06 10:35:05+08:00,['448441a35d2f0c200c0f642f2bb618bd2d43df23'],23,1418,1441,2912537,8,0.282238443,0.944038929,0.888077859,6341
5e4c8f704c28d9f60a49a2bf2fb4ea8b7f7e231d,0,GitHub,2022-07-05 20:08:28-07:00,['3ae1afa43838066e44ea78918050c6780c208042'],15,52,67,2912604,3,0,0.952380952,0.857142857,6341
00f395bb889252e3efb62cedfaa1209b58d5fd3c,0,GitHub,2022-07-06 12:36:15+02:00,['5e4c8f704c28d9f60a49a2bf2fb4ea8b7f7e231d'],35,9,44,2912648,2,0.695652174,1,0.52173913,6341
6495a0768cae1086d4b1dfa466967dfe178c1553,0,GitHub,2022-07-06 13:21:28-07:00,['00f395bb889252e3efb62cedfaa1209b58d5fd3c'],5,15,20,2912668,3,0,1,0.375,6341
915c781243933fe1a127eda6178d3db467e0bcf3,0,GitHub,2022-07-06 17:23:18-07:00,['6495a0768cae1086d4b1dfa466967dfe178c1553'],81,188,269,2912937,13,0,1,0.87654321,6341
ca8135b242a5d5fd71e5edffbcb85ada2f5d9bd2,0,Guozhang Wang,2022-07-06 22:00:31-07:00,['915c781243933fe1a127eda6178d3db467e0bcf3'],2,2,4,2912941,2,,,,6341
a521bbd7552f61af1fe956ef5d3f84567f8a4642,0,GitHub,2022-07-07 09:14:05+02:00,['ca8135b242a5d5fd71e5edffbcb85ada2f5d9bd2'],0,18,18,2912959,1,,,,6341
38b08dfd3384a04b73e236c83f1e3ce0fffeda45,0,GitHub,2022-07-07 11:19:37-07:00,['a521bbd7552f61af1fe956ef5d3f84567f8a4642'],1080,189,1269,2914228,75,0.815057283,0.080196399,0.158756137,6341
5a1bac2608c7c00a43d570a093860ce516be4e73,0,GitHub,2022-07-07 11:43:38-07:00,['38b08dfd3384a04b73e236c83f1e3ce0fffeda45'],8,19,27,2914255,2,,,,6341
63a6130af30536d67fca5802005695a84c875b5e,0,GitHub,2022-07-07 14:00:05-07:00,['5a1bac2608c7c00a43d570a093860ce516be4e73'],2,2,4,2914259,1,,,,6341
dc6f555492240c8c300fbbdf1d566c1b588760ab,0,GitHub,2022-07-08 15:35:48+05:18,['63a6130af30536d67fca5802005695a84c875b5e'],12,19,31,2914290,2,1,1,1,6341
e85500bbbef7c10ee6bd379ab1327e8abb858b6b,0,GitHub,2022-07-08 20:41:47+08:00,['dc6f555492240c8c300fbbdf1d566c1b588760ab'],8,95,103,2914393,4,0.196969697,1,1,6341
fc6e91e19920a41a56ff60c65e3b9719f4506977,0,GitHub,2022-07-09 18:06:02+08:00,['e85500bbbef7c10ee6bd379ab1327e8abb858b6b'],34,59,93,2914486,4,0.045454545,1,1,6341
0bc8da7aec8dfb7c61321b22e717a94565f4855d,0,GitHub,2022-07-10 10:16:39-07:00,['fc6e91e19920a41a56ff60c65e3b9719f4506977'],11,69,80,2914566,2,0.06,1,0.76,6341
23c92ce79366e86ca719e5e51c550c27324acd83,0,GitHub,2022-07-11 10:36:56+08:00,['0bc8da7aec8dfb7c61321b22e717a94565f4855d'],4,5,9,2914575,1,0,0,1,6341
a3f06d88140783a73e0301c4c1a521b2a4fc97b9,0,GitHub,2022-07-12 09:31:16+02:00,['23c92ce79366e86ca719e5e51c550c27324acd83'],8,58,66,2914641,5,0.742857143,1,0.485714286,6341
d3130f2e911473fcf1265dec14016c824499d9a7,0,GitHub,2022-07-12 14:16:19+05:18,['a3f06d88140783a73e0301c4c1a521b2a4fc97b9'],28,126,154,2914795,5,1,1,1,6341
7ec759d67cf9aceb4853db3986b1dd561ea956ac,0,GitHub,2022-07-12 16:51:18+02:00,['d3130f2e911473fcf1265dec14016c824499d9a7'],0,8,8,2914803,1,,,,6341
98726c2bac8bc221ec2df64b35ce15d0ee71893f,0,GitHub,2022-07-12 08:02:43-07:00,['7ec759d67cf9aceb4853db3986b1dd561ea956ac'],37,104,141,2914944,5,0.433333333,1,0.766666667,6341
b5d4fa7645eb75d2030eb8cac78545a681686a39,0,GitHub,2022-07-12 10:57:11-07:00,['98726c2bac8bc221ec2df64b35ce15d0ee71893f'],106,291,397,2915341,9,0,0.98540146,1,6341
8e9869a77704f4206e80aefc284c3139645e637d,0,GitHub,2022-07-13 08:46:04+02:00,['b5d4fa7645eb75d2030eb8cac78545a681686a39'],3,3,6,2915347,1,,,,6341
94d4fdeb28b3cd4d474d943448a7ef653eaa145d,0,GitHub,2022-07-13 17:47:34-07:00,['8e9869a77704f4206e80aefc284c3139645e637d'],0,20,20,2915367,1,,,,6341
beac86f049385932309158c1cb49c8657e53f45f,0,GitHub,2022-07-14 13:47:34+01:00,['94d4fdeb28b3cd4d474d943448a7ef653eaa145d'],157,813,970,2916337,20,0.603174603,0.911564626,0.929705215,6342
ddbc0300365dd1d9a2fb2c73faef8c4cbec0b316,0,GitHub,2022-07-15 09:21:35+01:00,['beac86f049385932309158c1cb49c8657e53f45f'],19,40,59,2916396,2,0.363636364,1,1,6342
c020c94e043ca4a997797da91a226735803774ab,0,GitHub,2022-07-15 15:48:35-04:00,['ddbc0300365dd1d9a2fb2c73faef8c4cbec0b316'],16,64,80,2916476,3,0.128205128,0.948717949,0.948717949,6342
ab9aaea3ce498db80ca55d0340f47abf1d975b07,0,GitHub,2022-07-18 14:19:01+08:00,['c020c94e043ca4a997797da91a226735803774ab'],3,31,34,2916510,2,1,1,1,6342
edad31811c49856cc1b8e76de6e3f3a6c02802cd,0,GitHub,2022-07-18 13:39:34+02:00,['ab9aaea3ce498db80ca55d0340f47abf1d975b07'],5,4,9,2916519,1,,,,6342
4eef28018a301fb0b858dce25d73b0f7c5f7dde7,0,GitHub,2022-07-18 14:10:02-07:00,['edad31811c49856cc1b8e76de6e3f3a6c02802cd'],1,1,2,2916521,1,,,,6342
81428226332005c27870aacfccc813950c84386c,0,GitHub,2022-07-18 17:07:20-05:00,['4eef28018a301fb0b858dce25d73b0f7c5f7dde7'],3,23,26,2916547,2,0,0.636363636,1,6342
309e0f986e97be966c797f7729eb1e94ef5400a9,0,GitHub,2022-07-18 16:42:48-07:00,['81428226332005c27870aacfccc813950c84386c'],10,379,389,2916936,6,0.239285714,0.925,1,6342
188b2bf2802c2bc5900a286a9ef023daaeb08c21,0,GitHub,2022-07-19 09:17:46-07:00,['309e0f986e97be966c797f7729eb1e94ef5400a9'],78,11,89,2917025,4,0,0,0,6342
693e283802590b724ef441d5bf7acb6eeced91c5,0,GitHub,2022-07-19 09:44:10-07:00,['188b2bf2802c2bc5900a286a9ef023daaeb08c21'],8,229,237,2917262,5,0.522012579,0.849056604,1,6342
b62d8b975cf97b5c1328b9b03a05fa09b07cf13a,0,GitHub,2022-07-19 13:35:26-07:00,['693e283802590b724ef441d5bf7acb6eeced91c5'],0,13,13,2917275,2,0.4,1,1,6342
eee40200df5c68963c0b534f95b5154bfd60e290,0,GitHub,2022-07-20 10:03:43+08:00,['b62d8b975cf97b5c1328b9b03a05fa09b07cf13a'],49,251,300,2917575,7,0.21192053,0.814569536,0.344370861,6342
ed77bebcaf8e4a8f74dd3823c905c8fd01dadf64,0,GitHub,2022-07-20 11:29:00+02:00,['eee40200df5c68963c0b534f95b5154bfd60e290'],10,274,284,2917859,2,0.919117647,1,0.919117647,6343
74a18bafaebbe9ccf81b2bacade442cdd3728537,0,GitHub,2022-07-20 18:11:51+08:00,['ed77bebcaf8e4a8f74dd3823c905c8fd01dadf64'],1,1,2,2917861,2,,,,6343
badfbacdd09a9ee8821847f4b28d98625f354ed7,0,GitHub,2022-07-20 08:19:31-07:00,['74a18bafaebbe9ccf81b2bacade442cdd3728537'],13,30,43,2917904,2,0.857142857,0.857142857,0.571428571,6343
df899a2d0845f2ccc38286c00819a4d9ca029c67,1,GitHub,2022-07-21 15:09:31+02:00,['badfbacdd09a9ee8821847f4b28d98625f354ed7'],5,5,10,2917914,2,,,,6343
c9b6e19b3b37499de17da19e82b1b98e3b9f6b5c,0,GitHub,2022-07-21 15:11:40+02:00,['df899a2d0845f2ccc38286c00819a4d9ca029c67'],451,452,903,2918817,16,0.8125,0.875,0.625,6343
ff7cbf264c0cb79ae56209ac381c51ef588ab97a,0,GitHub,2022-07-21 07:35:29-07:00,['c9b6e19b3b37499de17da19e82b1b98e3b9f6b5c'],36,231,267,2919084,2,0.457831325,0.963855422,0.409638554,6344
569a358a3f9c4d2aa7aaeb277f691ad0bae5db34,0,GitHub,2022-07-21 17:27:53+02:00,['ff7cbf264c0cb79ae56209ac381c51ef588ab97a'],332,296,628,2919712,15,0.318181818,1,0.818181818,6344
5e4ae06d129f01d94ed27f73ea311a2adb0477e7,0,GitHub,2022-07-21 12:12:29-07:00,['569a358a3f9c4d2aa7aaeb277f691ad0bae5db34'],10,9,19,2919731,1,,,,6344
5a52601691478857472333d8a13a07b09a7d13c5,0,GitHub,2022-07-21 12:37:17-07:00,['5e4ae06d129f01d94ed27f73ea311a2adb0477e7'],139,381,520,2920251,12,0.387323944,0.943661972,0.830985915,6345
06462c7be175cb730b20de0333d1ac48b3286282,0,GitHub,2022-07-21 16:59:05-07:00,['5a52601691478857472333d8a13a07b09a7d13c5'],15,46,61,2920312,2,0.05,0.85,0.2,6345
679e9e0cee67e7d3d2ece204a421ea7da31d73e9,0,GitHub,2022-07-22 11:00:15+08:00,['06462c7be175cb730b20de0333d1ac48b3286282'],39,319,358,2920670,8,0.298507463,0.751243781,0.746268657,6345
71d225d7c2489f4921e45bbc9d1f182a8419087e,0,GitHub,2022-07-25 15:30:38+02:00,['679e9e0cee67e7d3d2ece204a421ea7da31d73e9'],5,12,17,2920687,1,0.166666667,1,0.833333333,6345
6b76c01cf895db0651e2cdcc07c2c392f00a8ceb,0,GitHub,2022-07-25 19:47:08+02:00,['71d225d7c2489f4921e45bbc9d1f182a8419087e'],21,24,45,2920732,2,0.333333333,0,0,6345
a450fb70c12ba66257e8f61cc4903290f1e435ea,0,GitHub,2022-07-25 13:24:40-07:00,['6b76c01cf895db0651e2cdcc07c2c392f00a8ceb'],11,66,77,2920809,2,0,1,0.558823529,6345
f191e4781ee16d131a58e4bccf5eb1fbd476ada6,0,GitHub,2022-07-26 10:12:20+02:00,['a450fb70c12ba66257e8f61cc4903290f1e435ea'],170,125,295,2921104,2,0,0,0.142857143,6345
348474e2aee0767976bc5cfa8e42117cb41147ee,0,GitHub,2022-07-26 05:58:50-07:00,['f191e4781ee16d131a58e4bccf5eb1fbd476ada6'],5,7,12,2921116,4,,,,6345
25b914750dcd07ac4c74afbc42956a1affec59e8,0,GitHub,2022-07-26 09:39:27-04:00,['348474e2aee0767976bc5cfa8e42117cb41147ee'],39,48,87,2921203,2,0,0,0.3,6345
a63f464f5ec28cc4891b1b356355f4a0f08bb991,0,GitHub,2022-07-26 16:59:19+02:00,['25b914750dcd07ac4c74afbc42956a1affec59e8'],25,18,43,2921246,1,,,,6345
14d2269471141067dc3c45300187f20a0a051777,0,GitHub,2022-07-26 19:08:59-04:00,['a63f464f5ec28cc4891b1b356355f4a0f08bb991'],59,124,183,2921429,3,0.066666667,0.666666667,1,6345
6ac58ac6fcd53a512ea0bc0b3dc66f49870ff0cb,0,GitHub,2022-07-26 21:21:11-05:00,['14d2269471141067dc3c45300187f20a0a051777'],3,0,3,2921432,1,0,0,0,6345
160a6ab4cb0bd4c3e303329b5bb30a13c196b030,0,GitHub,2022-07-27 16:32:54+05:18,['6ac58ac6fcd53a512ea0bc0b3dc66f49870ff0cb'],2,42,44,2921476,3,0.923076923,0.884615385,1,6345
1914418c5ded2c318687ebaa887d72788dfb7b76,0,GitHub,2022-07-27 10:38:31-07:00,['160a6ab4cb0bd4c3e303329b5bb30a13c196b030'],51,64,115,2921591,4,0,1,1,6345
d076b7ad0ee3a2dba710ff79d6c4dd5840766e9f,0,GitHub,2022-07-27 13:58:12-05:00,['1914418c5ded2c318687ebaa887d72788dfb7b76'],12,416,428,2922019,4,0.087096774,0.95483871,1,6346
06f47c3b517f5c96c1bd981369843f3483947197,0,GitHub,2022-07-27 17:29:05-07:00,['d076b7ad0ee3a2dba710ff79d6c4dd5840766e9f'],553,512,1065,2923084,18,1,1,1,6346
0c5f5a7f8b3628e991459ba9cff414c675676b8b,0,GitHub,2022-07-27 22:31:07-04:00,['06f47c3b517f5c96c1bd981369843f3483947197'],2,42,44,2923128,10,0,1,1,6346
9e74f91e56dbc06f17c95fe80dd3923f7b713457,0,GitHub,2022-07-28 17:18:09+02:00,['0c5f5a7f8b3628e991459ba9cff414c675676b8b'],55,155,210,2923338,4,0,1,0.675324675,6346
2724cc99203d943c69f1fbddcb7b1ce16f62d287,0,GitHub,2022-07-28 13:28:47-07:00,['9e74f91e56dbc06f17c95fe80dd3923f7b713457'],100,212,312,2923650,6,0.134020619,0.298969072,0.051546392,6346
a5d71e1550c5a2b670347c0c3bafb0b195bf916c,0,GitHub,2022-07-28 13:32:46-07:00,['2724cc99203d943c69f1fbddcb7b1ce16f62d287'],198,224,422,2924072,1,0,1,1,6346
3ddb62316f287d74b9649e1821c62fe8f68bc6e6,0,GitHub,2022-07-28 16:44:19-04:00,['a5d71e1550c5a2b670347c0c3bafb0b195bf916c'],1,21,22,2924094,2,,,,6346
517e4d92785d136c4db5aa59af1d4a3eda0c4bfd,0,GitHub,2022-07-28 17:18:35-04:00,['3ddb62316f287d74b9649e1821c62fe8f68bc6e6'],5,3,8,2924102,1,1,1,0,6346
5f7c99dd77fc71982f8664d99bb3ce1b4924d34c,0,GitHub,2022-07-29 16:53:01+02:00,['517e4d92785d136c4db5aa59af1d4a3eda0c4bfd'],18,0,18,2924120,2,0,0,0,6346
54af64c33a1796bcea8a9990aa61c804d9fc0df4,0,GitHub,2022-07-29 17:21:25+02:00,['5f7c99dd77fc71982f8664d99bb3ce1b4924d34c'],50,56,106,2924226,15,,,,6346
e26772ef616d1095efb7e48baa44842df8aeb058,0,GitHub,2022-07-29 13:36:40-07:00,['54af64c33a1796bcea8a9990aa61c804d9fc0df4'],122,226,348,2924574,7,0.478873239,0.915492958,0.436619718,6346
f7ac5d3d00f3cd3caa25c3003900bdb245d5252e,0,GitHub,2022-07-29 14:47:25-07:00,['e26772ef616d1095efb7e48baa44842df8aeb058'],1,1,2,2924576,1,,,,6346
