sha,is_bug,committer_name,commit_time,parents,all_del,all_add,all_change_lines,all_lines,files_change_nums,dmm_unit_size,dmm_unit_complexity,dmm_unit_interfacing,file_nums
ff5a562e3ff2f30a73e9a064c3e1f8baace4cfab,1,Todd Lipcon,2012-10-11 00:29:12-07:00,[],0,6642,6642,6642,33,0.631329582,0.849866746,0.921824104,33
2d180a80cb4ac2d59614d2e9220167798b00ee35,0,Todd Lipcon,2012-10-11 01:07:29-07:00,['ff5a562e3ff2f30a73e9a064c3e1f8baace4cfab'],38,18,56,6698,2,1,1,0.130434783,33
fccc89c5e6771a5e492f3ad9956b7a30a2ad7033,0,Todd Lipcon,2012-10-11 01:14:39-07:00,['2d180a80cb4ac2d59614d2e9220167798b00ee35'],2651,0,2651,9349,2,0.327790974,0.16152019,0,33
86aab879f6c4fbce82cde554c6dc271a40473584,0,Todd Lipcon,2012-10-11 16:34:21-07:00,['fccc89c5e6771a5e492f3ad9956b7a30a2ad7033'],122,163,285,9634,3,1,1,1,34
290ce9a9f23e91c782b5c530408a216d0d34b33c,0,Todd Lipcon,2012-10-11 16:49:46-07:00,['86aab879f6c4fbce82cde554c6dc271a40473584'],0,75,75,9709,2,,,,35
20bb61e7ca56f760634087e22be13ebdb945e8f8,0,Todd Lipcon,2012-10-11 17:02:14-07:00,['290ce9a9f23e91c782b5c530408a216d0d34b33c'],1,0,1,9710,1,,,,35
df96307cccc2ec48eb982566ecf47860241cac1d,1,Todd Lipcon,2012-10-11 18:00:03-07:00,['20bb61e7ca56f760634087e22be13ebdb945e8f8'],11,239,250,9960,7,0.604166667,1,0.916666667,37
412a794ab44d018223d1871ab7a2bedeab00c27e,1,Todd Lipcon,2012-10-11 22:57:37-07:00,['df96307cccc2ec48eb982566ecf47860241cac1d'],30,212,242,10202,8,0.114583333,0.96875,0.364583333,37
0385807c1b454fb60d6cebd72a9630780e1240df,0,Todd Lipcon,2012-10-11 23:07:19-07:00,['412a794ab44d018223d1871ab7a2bedeab00c27e'],163,199,362,10564,5,,,,39
b72bb94a139c32c64c0e279e5b85daaa4729af0a,0,Todd Lipcon,2012-10-11 23:12:10-07:00,['0385807c1b454fb60d6cebd72a9630780e1240df'],46,70,116,10680,3,1,1,1,40
2e13c6c7e324ede887b7e720f7785e9a0c35fa03,0,Todd Lipcon,2012-10-11 23:42:19-07:00,['b72bb94a139c32c64c0e279e5b85daaa4729af0a'],8,106,114,10794,3,0.209302326,1,0.209302326,40
e07559569c7945605c758737e5538f5b1298a4bf,0,Todd Lipcon,2012-10-12 00:42:07-07:00,['2e13c6c7e324ede887b7e720f7785e9a0c35fa03'],11,162,173,10967,4,0.258426966,0.573033708,1,40
9142efdf9ae9241f904373931add5eeb500954dd,0,Todd Lipcon,2012-10-12 13:32:51-07:00,['e07559569c7945605c758737e5538f5b1298a4bf'],57,150,207,11174,3,0.753623188,1,1,40
6cb402633541708084b5675f8c3a15cedaefe5a8,1,Todd Lipcon,2012-10-12 17:26:23-07:00,['9142efdf9ae9241f904373931add5eeb500954dd'],30,310,340,11514,10,0.446969697,0.674242424,0.954545455,40
0b5efe732e7a69b8591553fe5c51acd2e06b4f55,0,Todd Lipcon,2012-10-12 17:28:11-07:00,['6cb402633541708084b5675f8c3a15cedaefe5a8'],8,8,16,11530,3,,,,40
5979b15a73f0ab675b5699af4ededbc0d2e6dd43,0,Todd Lipcon,2012-10-12 18:15:01-07:00,['0b5efe732e7a69b8591553fe5c51acd2e06b4f55'],18,139,157,11687,6,0.426666667,0.32,1,40
ad8b181a1c0badc639221bc225a7af18cb54d12b,0,Todd Lipcon,2012-10-16 15:50:03-07:00,['5979b15a73f0ab675b5699af4ededbc0d2e6dd43'],2,56,58,11745,4,0.380952381,1,1,40
ac9e21e9ab34e7bedcbda1b1b6a250b7c2ee3697,1,Todd Lipcon,2012-10-16 18:38:50-07:00,['ad8b181a1c0badc639221bc225a7af18cb54d12b'],0,48644,48644,60389,137,0.683876221,0.799728556,0.57844734,176
115898a752ff7fe187408404261e6b56f6052c1a,0,Todd Lipcon,2012-10-16 18:58:23-07:00,['ac9e21e9ab34e7bedcbda1b1b6a250b7c2ee3697'],6,13,19,60408,2,,,,176
84e8d7e54ff4a2a1ac769d4c85c6677696843b9b,1,Todd Lipcon,2012-10-16 20:10:23-07:00,['115898a752ff7fe187408404261e6b56f6052c1a'],175,93,268,60676,6,0.152173913,0,0,176
8ed138f5dee8efd784996639e2557bc038a47b9c,0,Todd Lipcon,2012-10-16 20:59:25-07:00,['84e8d7e54ff4a2a1ac769d4c85c6677696843b9b'],117,188,305,60981,6,0.84,1,1,176
b029442c2903315cbfb739a41006a249da982294,0,Todd Lipcon,2012-10-17 22:48:12-07:00,['8ed138f5dee8efd784996639e2557bc038a47b9c'],31,241,272,61253,10,0.049019608,1,1,177
82cd3034be8c44005d3983e8a1497490aadc363a,0,Todd Lipcon,2012-10-17 22:48:18-07:00,['b029442c2903315cbfb739a41006a249da982294'],44,109,153,61406,6,0.571428571,0.714285714,0,177
3984a3878d636fd77dfa51419ad97be2b0215537,0,Todd Lipcon,2012-10-17 22:48:18-07:00,['82cd3034be8c44005d3983e8a1497490aadc363a'],3,7,10,61416,5,,,,177
3ff4017df68ab6c89c844a4dc6cc071728b02b56,0,Todd Lipcon,2012-10-17 22:48:18-07:00,['3984a3878d636fd77dfa51419ad97be2b0215537'],2,1601,1603,63019,8,0.689604685,0.920937042,0.534407028,183
cc716053f24e3bc6979277688d3a8f3d1e829060,1,Todd Lipcon,2012-10-17 22:48:18-07:00,['3ff4017df68ab6c89c844a4dc6cc071728b02b56'],9,262,271,63290,4,0.503546099,0.65248227,0.929078014,183
dc8352c2f2a2e0957a1a6de06fa4eb5a9230f88e,1,Todd Lipcon,2012-10-18 00:59:17-07:00,['cc716053f24e3bc6979277688d3a8f3d1e829060'],19,308,327,63617,9,0.366906475,0.589928058,0.971223022,185
5401bd2e212b0a3e51e4f3852940bc598bdf808f,0,Todd Lipcon,2012-10-18 00:59:17-07:00,['dc8352c2f2a2e0957a1a6de06fa4eb5a9230f88e'],6,93,99,63716,4,1,1,1,186
21b35a567fc44ef7ab5ad91d6771320cb14baa0e,0,Todd Lipcon,2012-10-28 14:41:42-07:00,['5401bd2e212b0a3e51e4f3852940bc598bdf808f'],1,7,8,63724,1,1,1,1,186
b4fa5250f19cd043567dece458533da466d18f38,0,Todd Lipcon,2012-10-28 14:47:29-07:00,['21b35a567fc44ef7ab5ad91d6771320cb14baa0e'],1,54,55,63779,1,,,,186
db0592120ef9116c09c9d53d3cf1130effed94a7,0,Todd Lipcon,2012-10-28 14:47:43-07:00,['b4fa5250f19cd043567dece458533da466d18f38'],1,0,1,63780,1,,,,186
c6d74a860762448c0fee36f1bef05672cf33573e,0,Todd Lipcon,2012-10-28 15:07:52-07:00,['db0592120ef9116c09c9d53d3cf1130effed94a7'],9,29,38,63818,1,1,1,0,186
2b6bf31acda94f69021eb24c46bd3efecbf2ff79,0,Todd Lipcon,2012-10-28 15:24:26-07:00,['c6d74a860762448c0fee36f1bef05672cf33573e'],24,23,47,63865,2,1,1,0,186
5ebd9a845ab5f523b4272478e2e4d957158310f6,0,Todd Lipcon,2012-10-31 13:46:09-07:00,['2b6bf31acda94f69021eb24c46bd3efecbf2ff79'],120,188,308,64173,7,0,1,0.5,187
9f076dc5d5acf19c6f59d63022b955ca31f29636,1,Todd Lipcon,2012-10-31 14:14:50-07:00,['5ebd9a845ab5f523b4272478e2e4d957158310f6'],108,140,248,64421,3,1,1,1,188
7f64d4e61ebd7991f1fe12b09bdb148041501f1d,0,Todd Lipcon,2012-10-31 14:34:01-07:00,['9f076dc5d5acf19c6f59d63022b955ca31f29636'],155,189,344,64765,6,1,1,1,188
80d731127aed26377ba0449eee670376fbb17474,0,Todd Lipcon,2012-10-31 14:53:18-07:00,['7f64d4e61ebd7991f1fe12b09bdb148041501f1d'],163,183,346,65111,3,,,,189
69002044afafc93d4ab9318d120c8b80f6836d6f,0,Todd Lipcon,2012-10-31 15:32:29-07:00,['80d731127aed26377ba0449eee670376fbb17474'],0,70,70,65181,1,1,1,1,190
7518d8eb90b476393c3ca3a51d2304dd014449a1,0,Todd Lipcon,2012-10-31 17:12:40-07:00,['69002044afafc93d4ab9318d120c8b80f6836d6f'],0,80,80,65261,3,0,0,1,192
2610ef5ec0f8f86f170f282990b8040ad41fb26b,0,Todd Lipcon,2012-10-31 17:24:17-07:00,['7518d8eb90b476393c3ca3a51d2304dd014449a1'],59,268,327,65588,6,0.462809917,1,0.595041322,192
f8f3bc67772360079f4cd8563d3af51aa113fc6d,0,Todd Lipcon,2012-10-31 18:45:51-07:00,['2610ef5ec0f8f86f170f282990b8040ad41fb26b'],17,35,52,65640,4,1,1,1,192
5422f8acdb27cb37a3ca3b4167cab4877bae3bbe,1,Todd Lipcon,2012-10-31 18:46:43-07:00,['f8f3bc67772360079f4cd8563d3af51aa113fc6d'],21,138,159,65799,8,0.596153846,1,0.807692308,192
3efb833e0f67e97598047025dfb9121d2b99b52f,0,Todd Lipcon,2012-10-31 19:04:58-07:00,['5422f8acdb27cb37a3ca3b4167cab4877bae3bbe'],84,124,208,66007,6,1,1,1,193
d7c991ff5c1952fe96457b4e83a3c853b891d4d7,0,Todd Lipcon,2012-10-31 19:07:47-07:00,['3efb833e0f67e97598047025dfb9121d2b99b52f'],2,3,5,66012,1,0,1,1,193
ca79658bacd4445d760288d7f2b368dd4eb07a79,0,Todd Lipcon,2012-10-31 19:25:23-07:00,['d7c991ff5c1952fe96457b4e83a3c853b891d4d7'],14,50,64,66076,7,1,1,1,194
9b7238bd710a09078724c09d90b290be1c6bdd4f,0,Todd Lipcon,2012-10-31 23:08:54-07:00,['ca79658bacd4445d760288d7f2b368dd4eb07a79'],2,2,4,66080,2,,,,194
fe5725cf690cce64fbd163f2ba835f60ef4d7223,1,Todd Lipcon,2012-10-31 23:08:58-07:00,['9b7238bd710a09078724c09d90b290be1c6bdd4f'],110,130,240,66320,4,1,1,1,194
3c61ac1360765172dc0909e777482485f9357e81,1,Todd Lipcon,2012-11-01 16:55:06-07:00,['fe5725cf690cce64fbd163f2ba835f60ef4d7223'],61,339,400,66720,6,0.050314465,1,0.79245283,194
d7afd58330a6a9bb8d8538648afe0d6e01b2edd9,1,Todd Lipcon,2012-11-01 17:16:50-07:00,['3c61ac1360765172dc0909e777482485f9357e81'],8,31,39,66759,3,0.05,1,0,194
673f547538b38e8f5752b6a6bd09e97482ceabe9,0,Todd Lipcon,2012-11-02 15:35:46-07:00,['d7afd58330a6a9bb8d8538648afe0d6e01b2edd9'],14,170,184,66943,2,1,1,0.87654321,195
58e11e239a67b37e25537238ed1ba1def5652443,0,Todd Lipcon,2012-11-02 16:39:21-07:00,['673f547538b38e8f5752b6a6bd09e97482ceabe9'],6,14,20,66963,2,1,1,1,195
446d5d64ae5b53ff1916c8323a9feb06f7fbc42a,0,Todd Lipcon,2012-11-02 19:35:03-07:00,['58e11e239a67b37e25537238ed1ba1def5652443'],3,16,19,66982,2,1,1,1,195
9c80e57657532f4333e8c285c1a4318cde2cf0a6,0,Todd Lipcon,2012-11-04 15:39:16-08:00,['446d5d64ae5b53ff1916c8323a9feb06f7fbc42a'],30,176,206,67188,4,0,0.939759036,0.493975904,195
4f10dd0960048e66eb0c72da8e0ad7eb6ddd34c1,0,Todd Lipcon,2012-11-05 20:41:05-08:00,['9c80e57657532f4333e8c285c1a4318cde2cf0a6'],0,3,3,67191,1,,,,195
21dda9b48b6348cfc9947cafb82e137ecca62fc9,0,Todd Lipcon,2012-11-05 20:41:05-08:00,['4f10dd0960048e66eb0c72da8e0ad7eb6ddd34c1'],0,8,8,67199,2,,,,195
8c0b713828cb8a584f1ca07eee56ba06430a03b7,0,Todd Lipcon,2012-11-05 20:41:05-08:00,['21dda9b48b6348cfc9947cafb82e137ecca62fc9'],5,599,604,67803,9,0.589353612,0.863117871,1,201
a3c9dccb055059db48283af40674684b3229853b,0,Todd Lipcon,2012-11-05 20:41:05-08:00,['8c0b713828cb8a584f1ca07eee56ba06430a03b7'],0,6,6,67809,1,,,,201
aab34f4628e8b1ae9e106b125f4d5cdbb0abff6f,0,Todd Lipcon,2012-11-06 17:34:38-08:00,['a3c9dccb055059db48283af40674684b3229853b'],0,365,365,68174,1,,,,202
535972c4d227ef39df0ec9c8f0f99219eac81f2a,0,Todd Lipcon,2012-11-06 18:10:37-08:00,['aab34f4628e8b1ae9e106b125f4d5cdbb0abff6f'],17,17,34,68208,2,,,,202
1289f05465b2da84eaf974f8b903745ef7c4daa5,0,Todd Lipcon,2012-11-06 18:12:07-08:00,['535972c4d227ef39df0ec9c8f0f99219eac81f2a'],9,20,29,68237,2,0,1,1,202
b7a4982a65afc4e7968ee269b1c1654ca14f69c1,1,Todd Lipcon,2012-11-12 00:12:58-08:00,['1289f05465b2da84eaf974f8b903745ef7c4daa5'],8,380,388,68625,10,0.412903226,1,0.95483871,206
18e9bc08d64561a89dca4a73e9bea049c772356c,0,Todd Lipcon,2012-11-13 13:48:43-08:00,['b7a4982a65afc4e7968ee269b1c1654ca14f69c1'],73,92,165,68790,2,,,,207
37a1106f740c95c683a18b4d81b74e81f6c9de5f,0,Todd Lipcon,2012-11-13 17:07:28-08:00,['18e9bc08d64561a89dca4a73e9bea049c772356c'],5,163,168,68958,6,0.25,1,0.894736842,208
7e5f8e3c6ab15963b376fbe049a0c7b6c59ddc40,0,Todd Lipcon,2012-11-13 17:59:29-08:00,['37a1106f740c95c683a18b4d81b74e81f6c9de5f'],11,156,167,69125,6,0.5,1,1,208
068974c24b7dc99ffe914028e518641c57c790a9,0,Todd Lipcon,2012-11-13 18:41:57-08:00,['7e5f8e3c6ab15963b376fbe049a0c7b6c59ddc40'],25,89,114,69239,3,0.25,1,0.3125,208
978b065a9ed160c015c512185f5f486bad5a09ca,0,Todd Lipcon,2012-11-13 19:53:46-08:00,['068974c24b7dc99ffe914028e518641c57c790a9'],1,2,3,69242,1,0,1,1,208
b44a3722356d7ae036dd2bee4c3f2bb3f8fd9a33,0,Todd Lipcon,2012-11-13 21:08:02-08:00,['978b065a9ed160c015c512185f5f486bad5a09ca'],2,53,55,69297,4,0.424242424,1,1,208
dfc46d3eec4f92951beaed22c97f48946b1f46f0,0,Todd Lipcon,2012-11-13 21:08:02-08:00,['b44a3722356d7ae036dd2bee4c3f2bb3f8fd9a33'],2,2,4,69301,1,,,,208
690f3e34c7f725818cb1687ae4eaad4d5272cbb9,0,Todd Lipcon,2012-11-13 21:08:02-08:00,['dfc46d3eec4f92951beaed22c97f48946b1f46f0'],1,1,2,69303,1,,,,208
68f77fe877cd26d573401f7107341cfbedb5bef9,0,Todd Lipcon,2012-11-13 21:08:02-08:00,['690f3e34c7f725818cb1687ae4eaad4d5272cbb9'],0,1,1,69304,1,1,1,1,208
05ef737d7c9f1b9ec6de02290b6e81473ce0d24b,0,Todd Lipcon,2012-11-13 21:08:02-08:00,['68f77fe877cd26d573401f7107341cfbedb5bef9'],0,7,7,69311,1,,,,208
099cb3f008be0bd81680f844d3adf8598006e468,0,Todd Lipcon,2012-11-13 21:08:02-08:00,['05ef737d7c9f1b9ec6de02290b6e81473ce0d24b'],2,2,4,69315,3,,,,208
62ecf520329e2e430e27a360ffef6c74e18aba9c,1,Todd Lipcon,2012-11-13 21:08:02-08:00,['099cb3f008be0bd81680f844d3adf8598006e468'],11,193,204,69519,5,0.427184466,1,0.932038835,208
c5b20e3646e68d1dd57eeafb32d98e376179cca1,0,Todd Lipcon,2012-11-14 11:47:33-08:00,['62ecf520329e2e430e27a360ffef6c74e18aba9c'],2,4,6,69525,2,0,1,1,208
d3cb1beb726544bbcfbeec1fe7b45cfbd0e46d67,0,Todd Lipcon,2012-11-14 13:51:52-08:00,['c5b20e3646e68d1dd57eeafb32d98e376179cca1'],0,4,4,69529,1,,,,208
5bc5f03450c0990c13ae9114ac69e15dad07b3b0,0,Todd Lipcon,2012-11-14 15:57:55-08:00,['d3cb1beb726544bbcfbeec1fe7b45cfbd0e46d67'],107,193,300,69829,8,0.16,0.84,0.053333333,208
e1840fceaa433732105d8525f815642e7d284416,0,Todd Lipcon,2012-11-14 15:57:55-08:00,['5bc5f03450c0990c13ae9114ac69e15dad07b3b0'],5,1,6,69835,1,0,0,0,208
53796d215520e77cf30cb8afe9d8767b0e6df561,0,Todd Lipcon,2012-11-14 15:57:55-08:00,['e1840fceaa433732105d8525f815642e7d284416'],6,25,31,69866,1,0.416666667,1,1,208
87efc370f9502ef6e77426a6606fe2702a62d30e,0,Todd Lipcon,2012-11-14 16:22:16-08:00,['53796d215520e77cf30cb8afe9d8767b0e6df561'],58,72,130,69996,5,1,0,0,208
8d7f71b8af70f358caf8b04b13b6888f991c05f5,0,Todd Lipcon,2012-11-14 16:57:37-08:00,['87efc370f9502ef6e77426a6606fe2702a62d30e'],24,48,72,70068,3,0,1,0.142857143,208
13e4c7c800e6a02d568565333821d6ec1f9e958f,0,Todd Lipcon,2012-11-14 17:56:13-08:00,['8d7f71b8af70f358caf8b04b13b6888f991c05f5'],68,75,143,70211,2,,,,208
57f298b901fe971a7d2986134d5bbcc625ca3932,0,Todd Lipcon,2012-11-17 16:37:39-08:00,['13e4c7c800e6a02d568565333821d6ec1f9e958f'],0,3,3,70214,2,,,,208
9c0db5e3b2abc45cb62c4426aa619d90906b73f6,0,Todd Lipcon,2012-11-19 20:25:42-08:00,['57f298b901fe971a7d2986134d5bbcc625ca3932'],10,10,20,70234,5,,,,208
c73e4f49eb7334a1a6bc745999b14f4b54c2b810,1,Todd Lipcon,2012-11-19 23:18:46-08:00,['9c0db5e3b2abc45cb62c4426aa619d90906b73f6'],4,518,522,70756,6,0.573221757,1,0.769874477,212
049739c133d7e9871a46531ca6caebe30928f71d,1,Todd Lipcon,2012-11-20 14:36:47-08:00,['c73e4f49eb7334a1a6bc745999b14f4b54c2b810'],143,197,340,71096,26,1,1,1,214
5b0f7acfd3943a17069efe9f1aa47ce8dbba121e,0,Todd Lipcon,2012-11-20 19:36:06-08:00,['049739c133d7e9871a46531ca6caebe30928f71d'],2,5,7,71103,1,,,,214
1d06493416958bc66f58200593496186aee28839,1,Todd Lipcon,2012-11-20 20:29:21-08:00,['5b0f7acfd3943a17069efe9f1aa47ce8dbba121e'],125,259,384,71487,11,1,0.950819672,1,215
7f6943025fbaa1959fced95042c26bc9b644b739,0,Todd Lipcon,2012-11-20 20:29:21-08:00,['1d06493416958bc66f58200593496186aee28839'],4,26,30,71517,2,0,1,1,215
b052f1666197357b3a2797f4ed45222e9e09e80e,0,Todd Lipcon,2012-11-21 18:29:53-08:00,['7f6943025fbaa1959fced95042c26bc9b644b739'],23,103,126,71643,4,0.057692308,1,0.634615385,215
44c8a6811d1e443313a6c65e92fb982420a4b919,0,Todd Lipcon,2012-11-21 18:29:53-08:00,['b052f1666197357b3a2797f4ed45222e9e09e80e'],19,150,169,71812,4,0.436619718,1,0.985915493,216
2c39e4c6153718afb9888e1a2e124f0e6e7fe717,0,Todd Lipcon,2012-11-21 19:01:38-08:00,['44c8a6811d1e443313a6c65e92fb982420a4b919'],20,20,40,71852,3,,,,216
1d21b56a30b64dbeff6f5b489b126150a6ee32fd,0,Todd Lipcon,2012-11-21 20:24:23-08:00,['2c39e4c6153718afb9888e1a2e124f0e6e7fe717'],25,57,82,71934,6,0.095238095,0.857142857,1,216
73179fd908db05aaf34ad708b2ae2f84aa32bc2f,0,Todd Lipcon,2012-11-21 20:24:23-08:00,['1d21b56a30b64dbeff6f5b489b126150a6ee32fd'],39,53,92,72026,1,1,1,1,216
e39ccd17a4fd6f799c5443f6dc1ed0cd59adfe4e,0,Todd Lipcon,2012-11-21 20:24:23-08:00,['73179fd908db05aaf34ad708b2ae2f84aa32bc2f'],4,148,152,72178,3,0.260273973,1,0.835616438,216
6e93f3fcbcda1fa7ec65e48393963c3b5659c9d5,1,Todd Lipcon,2012-11-22 13:56:40-08:00,['e39ccd17a4fd6f799c5443f6dc1ed0cd59adfe4e'],35,72,107,72285,7,0,1,0.464285714,216
1b483af84a30f49bca343a0ae062367459218bae,0,Todd Lipcon,2012-11-22 14:31:41-08:00,['6e93f3fcbcda1fa7ec65e48393963c3b5659c9d5'],1,52,53,72338,4,0.041666667,1,1,216
0e3bd37ab8645a00001758fa5de84861ac443eef,1,Todd Lipcon,2012-11-22 15:04:07-08:00,['1b483af84a30f49bca343a0ae062367459218bae'],20,223,243,72581,8,0.588235294,1,0.811764706,218
a3fd1cf68124cc63d25fcbdbd1cc9b388c319ab8,0,Todd Lipcon,2012-11-22 16:08:30-08:00,['0e3bd37ab8645a00001758fa5de84861ac443eef'],27,0,27,72608,1,1,0,1,218
8895eefb5ebf74fc8f49435210f72010bf83e504,0,Todd Lipcon,2012-11-22 16:10:05-08:00,['a3fd1cf68124cc63d25fcbdbd1cc9b388c319ab8'],9,12,21,72629,2,1,1,1,218
b5f95cd6d1ed505339b8444136e134e3f326ffe1,1,Todd Lipcon,2012-11-22 17:14:07-08:00,['8895eefb5ebf74fc8f49435210f72010bf83e504'],2,63,65,72694,5,0.352941176,1,1,218
32f3b9c08629e8bd4f701f5856055701b5bf341d,1,Todd Lipcon,2012-11-22 17:58:41-08:00,['b5f95cd6d1ed505339b8444136e134e3f326ffe1'],33,320,353,73047,5,0.154320988,0.25308642,0.098765432,218
86e68e52fbd157751fa273a64399f009f837d5a2,0,Todd Lipcon,2012-11-26 07:06:46-08:00,['32f3b9c08629e8bd4f701f5856055701b5bf341d'],3,8,11,73058,1,1,1,1,218
cc49f059e74280da812967034791405144cff4bc,0,Todd Lipcon,2012-11-26 09:08:21-08:00,['86e68e52fbd157751fa273a64399f009f837d5a2'],55,198,253,73311,4,0.831168831,1,0.961038961,218
c5c5d33f8d4cfed1e93fbf06e4105f160c7d03ae,0,Todd Lipcon,2012-11-26 09:39:57-08:00,['cc49f059e74280da812967034791405144cff4bc'],32,40,72,73383,1,1,1,1,218
47fcc65ea6db6f94ad7da921ba307fb016f4b3b0,0,Todd Lipcon,2012-11-26 10:32:57-08:00,['c5c5d33f8d4cfed1e93fbf06e4105f160c7d03ae'],0,50,50,73433,3,0.423076923,1,1,218
a55b913b90b94b99850afd002f985467c3b77be2,0,Todd Lipcon,2012-11-26 10:33:59-08:00,['47fcc65ea6db6f94ad7da921ba307fb016f4b3b0'],1,1,2,73435,1,,,,218
9f6192c460da4ff730331f03921e1471f18a7b73,0,Todd Lipcon,2012-11-26 10:49:14-08:00,['a55b913b90b94b99850afd002f985467c3b77be2'],12,97,109,73544,6,0.166666667,1,1,218
4f9b97ba8b008f3e54f892bedb7a3ed8fc6a4ae4,0,Todd Lipcon,2012-11-26 11:14:30-08:00,['9f6192c460da4ff730331f03921e1471f18a7b73'],237,261,498,74042,5,,,,220
ff87292a5cdac2f71ca56268999c621a2a36bbfd,0,Todd Lipcon,2012-11-26 11:40:54-08:00,['4f9b97ba8b008f3e54f892bedb7a3ed8fc6a4ae4'],42,76,118,74160,3,1,1,1,221
2225522494ff69247ad10494a878adc38138539f,0,Todd Lipcon,2012-11-26 12:06:45-08:00,['ff87292a5cdac2f71ca56268999c621a2a36bbfd'],17,132,149,74309,5,0.73015873,1,0.73015873,221
d3e5871823a384146fe13cb439d0ad714ebd5bc9,0,Todd Lipcon,2012-11-27 14:14:45-08:00,['2225522494ff69247ad10494a878adc38138539f'],17,12,29,74338,1,1,0,0,221
f7aff7257bc3db1718029cd29de1b71cc1464dbd,0,Todd Lipcon,2012-11-27 14:24:44-08:00,['d3e5871823a384146fe13cb439d0ad714ebd5bc9'],2,9,11,74349,2,0,1,1,221
d1c8bb27f9795a7ba2fa0f2b31d5a2ca14d6757c,0,Todd Lipcon,2012-11-27 21:06:49-08:00,['f7aff7257bc3db1718029cd29de1b71cc1464dbd'],16,279,295,74644,6,0.398601399,0.776223776,0.426573427,221
5613f50f10b9d65cb28581abab69603a35145061,0,Todd Lipcon,2012-11-28 11:52:33-08:00,['d1c8bb27f9795a7ba2fa0f2b31d5a2ca14d6757c'],2,17,19,74663,4,0.692307692,1,1,221
091ed1f204779651a41987b0407b2d9f946e8b70,0,Todd Lipcon,2012-11-28 12:49:12-08:00,['5613f50f10b9d65cb28581abab69603a35145061'],12,52,64,74727,3,0.272727273,1,1,221
3f14cec72669e03d1eedc10a44ba9a94a0d2a942,0,Todd Lipcon,2012-11-28 12:50:56-08:00,['091ed1f204779651a41987b0407b2d9f946e8b70'],4,61,65,74792,2,0,1,1,221
320d7c8abaa33c260e5078068701bff372643880,0,Todd Lipcon,2012-11-28 12:58:39-08:00,['3f14cec72669e03d1eedc10a44ba9a94a0d2a942'],1,44,45,74837,3,0.56,0,1,221
3e532cd90982a9f3ef2bd9d9c1dbc81fe852afec,0,Todd Lipcon,2012-12-14 15:44:02-08:00,['320d7c8abaa33c260e5078068701bff372643880'],1,166,167,75004,3,0.597938144,0.597938144,0.597938144,223
0d21d14fa38f9ed2eb18f9f5a2256e9174b2c50f,0,Todd Lipcon,2012-12-14 15:51:53-08:00,['3e532cd90982a9f3ef2bd9d9c1dbc81fe852afec'],16,88,104,75108,4,0.408163265,1,0.979591837,223
4b6abe2ba31f03cd9cae29e60db04611fd5d9252,0,Todd Lipcon,2012-12-14 18:29:51-08:00,['0d21d14fa38f9ed2eb18f9f5a2256e9174b2c50f'],0,231,231,75339,3,0.284313725,1,0.637254902,225
8f2a99b32c55bde9801b3ced306aee6802084eaa,0,Todd Lipcon,2012-12-15 21:45:09-08:00,['4b6abe2ba31f03cd9cae29e60db04611fd5d9252'],51,198,249,75588,2,0.717948718,1,0.858974359,225
94361133602216eb292a2603487b25046a05ede8,0,Todd Lipcon,2012-12-17 22:58:55-08:00,['8f2a99b32c55bde9801b3ced306aee6802084eaa'],9,101,110,75698,2,0.333333333,1,1,225
279a16d887a89de9bbcf69ca5624734b6c28212e,0,Todd Lipcon,2012-12-19 19:26:21-08:00,['94361133602216eb292a2603487b25046a05ede8'],3,4,7,75705,1,,,,225
9c88d9da3c7a41b884ba97e9d31e83b5461256ca,0,Todd Lipcon,2012-12-23 10:55:32-08:00,['279a16d887a89de9bbcf69ca5624734b6c28212e'],9,15,24,75729,1,,,,225
06497b440b0b7085e9350517826288c1d76ac95d,1,Todd Lipcon,2012-12-23 10:55:32-08:00,['9c88d9da3c7a41b884ba97e9d31e83b5461256ca'],0,1563,1563,77292,4,0.429061785,0.949656751,0.708237986,227
25db91f64af632571b2b367d8a93ec800c801b81,0,Todd Lipcon,2012-12-23 13:10:16-08:00,['06497b440b0b7085e9350517826288c1d76ac95d'],12,21,33,77325,2,1,1,1,227
88d9e9a022de1cd43b1ea134804bb9076c5fd7b2,0,Todd Lipcon,2012-12-23 16:10:34-08:00,['25db91f64af632571b2b367d8a93ec800c801b81'],48,6,54,77379,2,0,0,0,227
1dfecb1312906bad6c28542622dbae764c7c43ea,0,Todd Lipcon,2012-12-27 12:46:28-08:00,['88d9e9a022de1cd43b1ea134804bb9076c5fd7b2'],1,2,3,77382,1,0,1,1,227
d18360e08d38994ec589ec30648659fc11a51f5d,0,Todd Lipcon,2012-12-27 12:46:31-08:00,['1dfecb1312906bad6c28542622dbae764c7c43ea'],11,367,378,77760,2,0.288973384,0.882129278,0.828897338,227
c5f922c5288b3a068656c8661d0835cc2ffb3d64,0,Todd Lipcon,2012-12-27 12:46:31-08:00,['d18360e08d38994ec589ec30648659fc11a51f5d'],10,25,35,77795,1,0,0,0,227
9e5f1654b109b25b7a368333120902b9f79d915e,0,Todd Lipcon,2012-12-27 12:46:31-08:00,['c5f922c5288b3a068656c8661d0835cc2ffb3d64'],12,37,49,77844,1,0.6,0,1,227
f2d4688824fbe22c159f6f6da5b465ab34cbbc9b,0,Todd Lipcon,2012-12-27 15:21:12-08:00,['9e5f1654b109b25b7a368333120902b9f79d915e'],25,55,80,77924,1,,,,227
d4a83d5a84588cbd2a51fa9cd4cc3066a85cbfa7,1,Todd Lipcon,2012-12-27 16:44:27-08:00,['f2d4688824fbe22c159f6f6da5b465ab34cbbc9b'],0,131,131,78055,3,0.068493151,0.561643836,1,228
7831eff8cef076af006b47e08eb32fe6259bb782,0,Todd Lipcon,2012-12-27 19:04:43-08:00,['d4a83d5a84588cbd2a51fa9cd4cc3066a85cbfa7'],8,17,25,78080,1,0,0,1,228
9a464163d7418e6d4efa6f54958b02ae4ccd3aa5,1,Todd Lipcon,2012-12-28 13:37:36-08:00,['7831eff8cef076af006b47e08eb32fe6259bb782'],61,199,260,78340,2,1,1,1,228
49444c6520071619b6bc4f1b0e85e1314b1deb1b,0,Todd Lipcon,2012-12-28 13:37:36-08:00,['9a464163d7418e6d4efa6f54958b02ae4ccd3aa5'],26,116,142,78482,2,0.634920635,1,0.873015873,228
78f38f186776b8a29582f6e223dc2dabc0831dc5,1,Todd Lipcon,2012-12-28 13:37:36-08:00,['49444c6520071619b6bc4f1b0e85e1314b1deb1b'],107,110,217,78699,4,0,1,1,228
7e2aba077157b7d49544fe2d5028d3ed640f72c9,0,Todd Lipcon,2012-12-28 13:47:39-08:00,['78f38f186776b8a29582f6e223dc2dabc0831dc5'],5,3,8,78707,1,1,0,1,228
f30ac8b85787676b99cbb0c58db0ae7c743d8a97,1,Todd Lipcon,2012-12-28 14:33:57-08:00,['7e2aba077157b7d49544fe2d5028d3ed640f72c9'],17,62,79,78786,6,,,,229
af0d7a62f9dfd8c9839079f3cfbb0539f7a38918,0,Todd Lipcon,2012-12-28 14:50:53-08:00,['f30ac8b85787676b99cbb0c58db0ae7c743d8a97'],0,34,34,78820,1,0.217391304,1,1,229
5db524b71d0e0ef2eee69e45575fc30792907636,0,Todd Lipcon,2012-12-28 16:37:49-08:00,['af0d7a62f9dfd8c9839079f3cfbb0539f7a38918'],2,5,7,78827,1,0,0,0,229
e96f34f78b9d7645092fffbee19fd456c09c66a3,0,Todd Lipcon,2012-12-28 16:37:56-08:00,['5db524b71d0e0ef2eee69e45575fc30792907636'],0,22,22,78849,1,0,1,1,229
6b256a87b7a66df687b6e805dd3d5cb2c5955bc7,0,Todd Lipcon,2012-12-28 16:37:56-08:00,['e96f34f78b9d7645092fffbee19fd456c09c66a3'],11,12,23,78872,1,0,1,1,229
8dcf0c3386b91b403a3e668acd0ad41f8ed12c4d,0,Todd Lipcon,2012-12-28 16:37:56-08:00,['6b256a87b7a66df687b6e805dd3d5cb2c5955bc7'],55,123,178,79050,8,0.357142857,1,0.714285714,229
01f98f4c20af7c15c0c5f15253adec7fb7d485f9,1,Todd Lipcon,2012-12-28 18:13:51-08:00,['8dcf0c3386b91b403a3e668acd0ad41f8ed12c4d'],6,63,69,79119,1,0.870967742,0.870967742,0.870967742,229
3b08e7e2a7f98e87db026f0261aa402236823e10,0,Todd Lipcon,2013-01-01 16:27:02-08:00,['01f98f4c20af7c15c0c5f15253adec7fb7d485f9'],1,1,2,79121,1,,,,229
4de6d8df55383370a0dc290448349ef853e1319b,0,Todd Lipcon,2013-01-01 19:11:29-08:00,['3b08e7e2a7f98e87db026f0261aa402236823e10'],200,226,426,79547,2,,,,230
3b01ca4875dde646893a22dc53bc35b80f7c12b7,0,Todd Lipcon,2013-01-01 21:05:45-08:00,['4de6d8df55383370a0dc290448349ef853e1319b'],17,128,145,79692,4,0.533333333,1,1,231
c3ef0f6461357570fa92dfba32b1ba499a50374a,0,Todd Lipcon,2013-01-01 21:08:15-08:00,['3b01ca4875dde646893a22dc53bc35b80f7c12b7'],2,61,63,79755,4,1,1,1,232
1019cb551157a43a26bbed53f7ab90c020b4c265,1,Todd Lipcon,2013-01-01 21:23:43-08:00,['c3ef0f6461357570fa92dfba32b1ba499a50374a'],56,29,85,79840,6,,,,232
4760a35dbeaf372267108447654b6db75e70bc79,0,Todd Lipcon,2013-01-01 22:23:46-08:00,['1019cb551157a43a26bbed53f7ab90c020b4c265'],1,1,2,79842,1,,,,232
1a926cfe5a135c621faaf2d338bbaa644edadb7e,0,Todd Lipcon,2013-01-01 22:29:34-08:00,['4760a35dbeaf372267108447654b6db75e70bc79'],2,19,21,79863,2,,,,232
3f2d2fc3934adba4db7c93f8d3c15c65ce4eb9e2,0,Todd Lipcon,2013-01-02 16:51:21-08:00,['1a926cfe5a135c621faaf2d338bbaa644edadb7e'],15,61,76,79939,3,,,,234
a88c9007c03f78a8a47b11af93d533970342a9a1,0,Todd Lipcon,2013-01-02 16:59:53-08:00,['3f2d2fc3934adba4db7c93f8d3c15c65ce4eb9e2'],0,1,1,79940,1,,,,234
e539cb856dabf917270e242f2ff3e905470309a5,0,Todd Lipcon,2013-01-02 16:59:53-08:00,['a88c9007c03f78a8a47b11af93d533970342a9a1'],1,8,9,79949,2,,,,235
dfe0e22375d07f6da314151563a26ac29214c938,0,Todd Lipcon,2013-01-02 17:02:35-08:00,['e539cb856dabf917270e242f2ff3e905470309a5'],9,1,10,79959,3,,,,235
da19377ca5314c0313c07365ca492cdea224e819,0,Todd Lipcon,2013-01-02 17:52:05-08:00,['dfe0e22375d07f6da314151563a26ac29214c938'],29,32,61,80020,6,0.5,0,0,235
f5881467905e859a9c36d595e9e9bf207c61d375,0,Todd Lipcon,2013-01-02 17:55:03-08:00,['da19377ca5314c0313c07365ca492cdea224e819'],0,38,38,80058,1,,,,236
cd9453faeeb54ed605a434a6c7312ded6faa5f89,0,Todd Lipcon,2013-01-02 18:09:14-08:00,['f5881467905e859a9c36d595e9e9bf207c61d375'],0,3,3,80061,1,,,,236
3fb00965139a7eaca55289fa408646d4063a3667,0,Todd Lipcon,2013-01-02 23:11:39-08:00,['cd9453faeeb54ed605a434a6c7312ded6faa5f89'],17,46,63,80124,6,0,1,0,237
0b045403db6af450a04f171eac88680badf06048,0,Todd Lipcon,2013-01-02 23:31:55-08:00,['3fb00965139a7eaca55289fa408646d4063a3667'],22,102,124,80248,5,0,0.346938776,0.979591837,237
25a501f446b912b7861751ba8007c3397a4edb44,0,Todd Lipcon,2013-01-02 23:44:04-08:00,['0b045403db6af450a04f171eac88680badf06048'],4,1,5,80253,1,1,0,0,237
9aa0886a5621c432d1c91981ecc7ea00515d330b,0,Todd Lipcon,2013-01-03 00:19:05-08:00,['25a501f446b912b7861751ba8007c3397a4edb44'],37,140,177,80430,3,0.280701754,1,0.842105263,237
8ef5fce2cfc0098846f631756e27e50311c1c6b2,0,Todd Lipcon,2013-01-03 00:28:21-08:00,['9aa0886a5621c432d1c91981ecc7ea00515d330b'],1,1,2,80432,1,,,,237
b8ab61903896b30970c2a770ce223b3024947843,0,Todd Lipcon,2013-01-03 00:31:09-08:00,['8ef5fce2cfc0098846f631756e27e50311c1c6b2'],1,4,5,80437,1,0,1,1,237
80050171b9b533c49dc54f76071c27f0e9180954,0,Todd Lipcon,2013-01-07 14:55:52-08:00,['b8ab61903896b30970c2a770ce223b3024947843'],14,20,34,80471,1,1,0,0,237
c40b4951f0c9ae7adade9b3e50e371761e96139a,0,Todd Lipcon,2013-01-07 14:55:52-08:00,['80050171b9b533c49dc54f76071c27f0e9180954'],17,19,36,80507,7,,,,237
df6b00d2ce86f3db434d34d635fb91e76620b676,0,Todd Lipcon,2013-01-07 15:16:07-08:00,['c40b4951f0c9ae7adade9b3e50e371761e96139a'],55,161,216,80723,4,1,1,1,239
78afc41a5f572024998497756549fb4266ff07ed,0,Todd Lipcon,2013-01-07 19:00:57-08:00,['df6b00d2ce86f3db434d34d635fb91e76620b676'],176,274,450,81173,11,1,1,1,240
574f9e925c6244ab6980cc1d60d2d28f5fb1b5db,1,Todd Lipcon,2013-01-10 16:26:44-08:00,['78afc41a5f572024998497756549fb4266ff07ed'],59,69,128,81301,11,1,1,1,240
cab5a521cd6e477820807ec96af07b1c5fa5834c,0,Todd Lipcon,2013-01-10 17:25:51-08:00,['574f9e925c6244ab6980cc1d60d2d28f5fb1b5db'],5,24,29,81330,5,1,0,0,240
b8361c5a96300ee7a1cf9cf4062ebf2df24df2e7,0,Todd Lipcon,2013-01-10 17:25:51-08:00,['cab5a521cd6e477820807ec96af07b1c5fa5834c'],4,4,8,81338,1,,,,240
13188836557ac5e8ee30d71e9b54b0826136a4a3,0,Todd Lipcon,2013-01-15 18:41:58-08:00,['b8361c5a96300ee7a1cf9cf4062ebf2df24df2e7'],0,30,30,81368,4,0.75,1,1,240
3b329672a564c93dfba73aa29d560ab0fe160510,0,Todd Lipcon,2013-01-15 19:12:00-08:00,['13188836557ac5e8ee30d71e9b54b0826136a4a3'],1,20,21,81389,3,0.4,1,1,240
0902b5289f9218b83470fa79224e1b9ddec5d474,0,Todd Lipcon,2013-01-15 20:16:36-08:00,['3b329672a564c93dfba73aa29d560ab0fe160510'],13,42,55,81444,3,0.380952381,0,1,240
02c6405e8736dbfcfbc8d2c8290fb4f3f7a063f1,0,Todd Lipcon,2013-01-15 20:16:36-08:00,['0902b5289f9218b83470fa79224e1b9ddec5d474'],0,81,81,81525,1,1,1,1,241
8fe1fb0b3cb9d892a936ee924d957c5d2096e873,0,Todd Lipcon,2013-01-15 20:16:36-08:00,['02c6405e8736dbfcfbc8d2c8290fb4f3f7a063f1'],2,70,72,81597,3,0.764705882,1,1,241
8f7ba4d75ff610b9a6985f8535b7268c423c96db,0,Todd Lipcon,2013-01-15 21:48:40-08:00,['8fe1fb0b3cb9d892a936ee924d957c5d2096e873'],0,1,1,81598,1,0,1,1,241
21293c33d7cbe44ae31cf8b1221270d4883347c4,1,Todd Lipcon,2013-01-16 00:00:39-08:00,['8f7ba4d75ff610b9a6985f8535b7268c423c96db'],4,23,27,81625,5,0.5,1,1,241
0f2a34129fd3cc84eb47e36045d02135c71431b9,1,Todd Lipcon,2013-01-16 00:00:39-08:00,['21293c33d7cbe44ae31cf8b1221270d4883347c4'],26,81,107,81732,8,0,1,1,241
459c3e9d7771e343aef637c24d1d51929b56822e,0,Todd Lipcon,2013-01-16 00:00:39-08:00,['0f2a34129fd3cc84eb47e36045d02135c71431b9'],1,26,27,81759,1,0.058823529,1,1,241
43562fc4e975cda05387afbae70b21ae59942aed,0,Todd Lipcon,2013-01-16 00:01:37-08:00,['459c3e9d7771e343aef637c24d1d51929b56822e'],29,40,69,81828,4,1,1,0,241
4ddb84711412c7917c91d5c14209c600f901e50c,1,Todd Lipcon,2013-01-17 19:07:59-08:00,['43562fc4e975cda05387afbae70b21ae59942aed'],330,461,791,82619,9,1,1,0,243
233e619a0b2fde72e5b7aa9b9b314f051e6a2d5b,0,Todd Lipcon,2013-01-17 23:02:51-08:00,['4ddb84711412c7917c91d5c14209c600f901e50c'],58,79,137,82756,6,1,1,0,243
c525e286e37b48e5925efd3a92160b7cc1f1c056,0,Todd Lipcon,2013-01-18 00:09:02-08:00,['233e619a0b2fde72e5b7aa9b9b314f051e6a2d5b'],92,266,358,83114,15,0.323232323,0.98989899,0.303030303,243
50539062b2554cfac85a42f5fcb804f37b21c54d,0,Todd Lipcon,2013-01-18 01:02:30-08:00,['c525e286e37b48e5925efd3a92160b7cc1f1c056'],1,1,2,83116,1,,,,243
98a4bed97de64836cf2d14c76d96674a5933d405,0,Todd Lipcon,2013-01-18 01:03:03-08:00,['50539062b2554cfac85a42f5fcb804f37b21c54d'],0,9,9,83125,1,0,1,1,243
dd0fc18f55fc6f674712c09dac9ce928d19affb7,0,Todd Lipcon,2013-01-18 01:04:02-08:00,['98a4bed97de64836cf2d14c76d96674a5933d405'],7,50,57,83182,6,0.147058824,1,1,243
b3ffbc797292980b3ee361a524e4031864509f13,0,Todd Lipcon,2013-01-18 14:10:01-08:00,['dd0fc18f55fc6f674712c09dac9ce928d19affb7'],12,29,41,83223,2,1,1,0.076923077,243
9b9c5358ad35fd14bdd08f0c06b958464b6155cd,0,Todd Lipcon,2013-01-18 14:27:12-08:00,['b3ffbc797292980b3ee361a524e4031864509f13'],0,6,6,83229,2,0.75,1,1,243
56d80eec92f82fb0cf9f49a4dd4501e928745ecd,0,Todd Lipcon,2013-01-18 14:27:38-08:00,['9b9c5358ad35fd14bdd08f0c06b958464b6155cd'],114,298,412,83641,13,0.738738739,0.981981982,0.522522523,243
c4cba6cc495908b2b5f79004d0c524aafb327b34,0,Todd Lipcon,2013-01-18 15:07:21-08:00,['56d80eec92f82fb0cf9f49a4dd4501e928745ecd'],2,8,10,83651,2,0,0,1,243
fd7cfd5cfb500eb8330b57879140a7dda7f00325,0,Todd Lipcon,2013-01-18 19:22:07-08:00,['c4cba6cc495908b2b5f79004d0c524aafb327b34'],6,12,18,83669,1,1,1,1,243
aeb78c0e387696bcb511fda7c18e3e937693a130,0,Todd Lipcon,2013-01-18 19:23:23-08:00,['fd7cfd5cfb500eb8330b57879140a7dda7f00325'],2,16,18,83687,1,1,1,1,243
346010a4dff10b226496e3130e6723e56ba63d35,0,Todd Lipcon,2013-01-18 19:23:23-08:00,['aeb78c0e387696bcb511fda7c18e3e937693a130'],1,12,13,83700,1,1,1,1,243
0f9d31087084d772c3d744407ff989b3a8af500e,0,Todd Lipcon,2013-01-18 19:23:24-08:00,['346010a4dff10b226496e3130e6723e56ba63d35'],1,10,11,83711,2,0.4,1,1,243
e03df2c45f94b91f1b8999e0aad1343659355ab0,0,Todd Lipcon,2013-01-18 19:23:24-08:00,['0f9d31087084d772c3d744407ff989b3a8af500e'],1,12,13,83724,1,0,1,1,243
7a8b06f6be64c11d98a10d37b371da388c36071b,0,Todd Lipcon,2013-01-18 19:23:24-08:00,['e03df2c45f94b91f1b8999e0aad1343659355ab0'],5,10,15,83739,2,0,1,0,243
b307389eeaebd87cd21f1b9a10da1bfc4d05e284,0,Todd Lipcon,2013-01-18 19:23:24-08:00,['7a8b06f6be64c11d98a10d37b371da388c36071b'],2,28,30,83769,3,0.846153846,1,1,243
1ed3afb45ba23238e2c0d27e9b2589eacfd1aaa7,0,Todd Lipcon,2013-01-18 19:23:24-08:00,['b307389eeaebd87cd21f1b9a10da1bfc4d05e284'],1,2,3,83772,1,,,,243
c0c131bba645510483901a0a90a1ac9894d329e0,0,Todd Lipcon,2013-01-18 20:36:47-08:00,['1ed3afb45ba23238e2c0d27e9b2589eacfd1aaa7'],2,2,4,83776,1,,,,243
f0c52cfa1c61f620b0f120d6e33fddfee4745669,0,Todd Lipcon,2013-01-18 20:37:23-08:00,['c0c131bba645510483901a0a90a1ac9894d329e0'],0,1,1,83777,1,1,1,1,243
797d700148ba92d5924a78f44e6aee957db9f3a9,0,Todd Lipcon,2013-01-18 20:37:55-08:00,['f0c52cfa1c61f620b0f120d6e33fddfee4745669'],8,80,88,83865,3,1,1,1,244
a2785aa175225c02e53f4c7a1354c0633a5acdfa,1,Todd Lipcon,2013-01-21 16:18:22-08:00,['797d700148ba92d5924a78f44e6aee957db9f3a9'],1,7,8,83873,3,1,1,1,244
1b20934e650f3b89d4467a3a22d22c58c7367ae3,0,Todd Lipcon,2013-01-21 16:18:36-08:00,['a2785aa175225c02e53f4c7a1354c0633a5acdfa'],0,1,1,83874,1,0,1,1,244
b03fa62116554969e24baf4790f5ea1f07be058d,0,Todd Lipcon,2013-01-22 17:06:42-08:00,['1b20934e650f3b89d4467a3a22d22c58c7367ae3'],0,136,136,84010,3,0.071428571,0.726190476,1,245
4bb35132c8b704743b01adf813a7584f743056ab,0,Todd Lipcon,2013-01-23 16:22:13-08:00,['b03fa62116554969e24baf4790f5ea1f07be058d'],1,1,2,84012,1,,,,245
df442ec50071a64c0c998f359355bd429ef8562e,0,Todd Lipcon,2013-01-23 16:22:19-08:00,['4bb35132c8b704743b01adf813a7584f743056ab'],61,128,189,84201,14,1,0.931034483,1,246
55aea9d4a26a8ce9cb105e383dde8ee9767b2248,0,Todd Lipcon,2013-02-01 21:14:43-08:00,['df442ec50071a64c0c998f359355bd429ef8562e'],18,85,103,84304,7,0.103448276,0.137931034,0,247
06c545a52462ef97fa8cdf7a13a82cc072d17734,0,Todd Lipcon,2013-02-01 21:15:32-08:00,['55aea9d4a26a8ce9cb105e383dde8ee9767b2248'],85,18,103,84407,7,0.896551724,0.862068966,1,247
315d97d5b4acbba3d66f9d6de98d014b49a5d99b,0,Todd Lipcon,2013-02-01 21:15:32-08:00,['06c545a52462ef97fa8cdf7a13a82cc072d17734'],0,19,19,84426,5,1,1,1,247
9eb61e2c4bc172e4ae02d7c38c94aa049e89a46c,1,Todd Lipcon,2013-02-01 21:15:32-08:00,['315d97d5b4acbba3d66f9d6de98d014b49a5d99b'],1,357,358,84784,5,0.619047619,0.619047619,1,250
b17a498e1ba6083369c999a879266bda04306be2,0,Todd Lipcon,2013-02-01 21:15:32-08:00,['9eb61e2c4bc172e4ae02d7c38c94aa049e89a46c'],4,18,22,84806,1,0.4,0.4,1,250
15bc4f1c396491b4722916482fe2677f5d47b33b,1,Todd Lipcon,2013-02-01 21:15:32-08:00,['b17a498e1ba6083369c999a879266bda04306be2'],52,232,284,85090,13,0.274509804,1,0.588235294,250
51395fc113488fc7c8b266506b109c15a98dfa46,0,Todd Lipcon,2013-02-02 19:28:34-08:00,['15bc4f1c396491b4722916482fe2677f5d47b33b'],2,91,93,85183,4,0.583333333,1,1,251
c27be695b973ef962b1e4877f191ea70a267e2c2,1,Todd Lipcon,2013-02-02 19:30:40-08:00,['51395fc113488fc7c8b266506b109c15a98dfa46'],6,113,119,85302,7,0.55,0,1,251
79d5d5a25d0f5fed267ffb59294a51460ecb2a79,0,Todd Lipcon,2013-02-02 19:35:18-08:00,['c27be695b973ef962b1e4877f191ea70a267e2c2'],8,29,37,85339,2,1,1,1,251
c23f45011503cd1429f0b880a88ab329494c5fc1,0,Todd Lipcon,2013-02-03 11:39:45-08:00,['79d5d5a25d0f5fed267ffb59294a51460ecb2a79'],3,11,14,85353,1,0,1,1,251
1bedd6bdcb7d53398de37342687363ea6dccaedc,0,Todd Lipcon,2013-02-03 11:40:05-08:00,['c23f45011503cd1429f0b880a88ab329494c5fc1'],30,92,122,85475,3,0.275,0,0.55,251
040ccaf5af680d5922312b5d44f9b61da72f9cd8,0,Todd Lipcon,2013-02-03 11:40:05-08:00,['1bedd6bdcb7d53398de37342687363ea6dccaedc'],111,180,291,85766,9,1,1,0.941176471,251
6a14c2d0beb5c69cb8addd307354e7d1314e5755,0,Todd Lipcon,2013-02-03 11:40:05-08:00,['040ccaf5af680d5922312b5d44f9b61da72f9cd8'],3,4,7,85773,1,1,1,1,251
c62a33f945705db102295f2d23e239f1a747f6ad,0,Todd Lipcon,2013-02-03 11:40:05-08:00,['6a14c2d0beb5c69cb8addd307354e7d1314e5755'],3,7,10,85783,2,,,,251
e324c666d9b2295e6804a2cd491a76bf10a42d78,0,Todd Lipcon,2013-02-03 11:40:05-08:00,['c62a33f945705db102295f2d23e239f1a747f6ad'],3,6,9,85792,1,0,1,1,251
71987a589750d1c663496519e4edb02006406e5f,1,Todd Lipcon,2013-02-03 11:40:05-08:00,['e324c666d9b2295e6804a2cd491a76bf10a42d78'],8,7,15,85807,2,,,,251
1685204d750f1143729765b0182fcc55b76daf6b,0,Todd Lipcon,2013-02-03 11:40:05-08:00,['71987a589750d1c663496519e4edb02006406e5f'],1,1,2,85809,1,,,,251
b49cb3953ffe8c26ac7eb4d0421ffeb941b66a1c,0,Todd Lipcon,2013-02-04 12:58:30-08:00,['1685204d750f1143729765b0182fcc55b76daf6b'],0,20,20,85829,1,0,1,1,251
f915d7abf782640123eb06e04dbc4c03965a4e4d,0,Todd Lipcon,2013-02-04 16:01:05-08:00,['b49cb3953ffe8c26ac7eb4d0421ffeb941b66a1c'],0,268,268,86097,4,0.801652893,1,0.851239669,254
f387e7eafdd9f3b77b18791ff5e0689c037abaec,0,Todd Lipcon,2013-02-04 16:46:39-08:00,['f915d7abf782640123eb06e04dbc4c03965a4e4d'],70,69,139,86236,8,,,,254
ceb79403275728562dc7aca11311fbba87b2aa09,0,Todd Lipcon,2013-02-04 17:54:38-08:00,['f387e7eafdd9f3b77b18791ff5e0689c037abaec'],3,10,13,86249,1,1,1,1,254
a3e6855b93f6dc0e4e664b035d3600a090001c1b,1,Todd Lipcon,2013-02-04 18:28:43-08:00,['ceb79403275728562dc7aca11311fbba87b2aa09'],810,893,1703,87952,17,1,1,0,260
d1856f9261c7dbc59d92b6efa1e0f12b2d747cbc,0,Todd Lipcon,2013-02-04 18:28:43-08:00,['a3e6855b93f6dc0e4e664b035d3600a090001c1b'],0,3,3,87955,1,,,,260
188a7d57d81dca3d5cea93ba0174d6c84bc48feb,0,Todd Lipcon,2013-02-04 19:49:13-08:00,['d1856f9261c7dbc59d92b6efa1e0f12b2d747cbc'],20,26,46,88001,1,1,1,0,260
280cc0ec23c8774f55a808940c26b79320dabe29,1,Todd Lipcon,2013-02-04 21:19:06-08:00,['188a7d57d81dca3d5cea93ba0174d6c84bc48feb'],196,212,408,88409,1,1,1,1,260
5a6dd2fefbcbb3790ab22e8d7b9b39936276571a,1,Todd Lipcon,2013-02-05 15:42:46-08:00,['280cc0ec23c8774f55a808940c26b79320dabe29'],24,439,463,88872,8,0.405660377,0.773584906,0.773584906,262
a7ec1697ef581c44a0c82da6f727f9b3c155f4e4,0,Todd Lipcon,2013-02-05 15:53:55-08:00,['5a6dd2fefbcbb3790ab22e8d7b9b39936276571a'],4,24,28,88900,2,0,1,1,262
8026132bcd62105c97c12cec0a998272f9b98dde,0,Todd Lipcon,2013-02-05 16:05:30-08:00,['a7ec1697ef581c44a0c82da6f727f9b3c155f4e4'],4,9,13,88913,3,0,0,1,262
5eb77584331f6104dc542df28e2299884299aa0e,0,Todd Lipcon,2013-02-05 16:06:05-08:00,['8026132bcd62105c97c12cec0a998272f9b98dde'],5,6,11,88924,2,0,1,1,262
09aabfe4cbce742f4d1e284a0fb021a72bfbbc7e,1,Todd Lipcon,2013-02-05 16:54:30-08:00,['5eb77584331f6104dc542df28e2299884299aa0e'],28,76,104,89028,3,0,1,0,262
7871b29a81c98eeb86f92997cf4c2a1e20f1cce5,0,Todd Lipcon,2013-02-05 17:25:16-08:00,['09aabfe4cbce742f4d1e284a0fb021a72bfbbc7e'],1,592,593,89621,4,0.563535912,0.906077348,0.875690608,265
733c86bd24c6188292ea6ee23d2d9ab90badceb5,0,Todd Lipcon,2013-02-05 17:45:37-08:00,['7871b29a81c98eeb86f92997cf4c2a1e20f1cce5'],16,51,67,89688,3,0.9375,1,1,265
6834ea89159a8159ebfab168124fc7da5d44b57c,1,Todd Lipcon,2013-02-05 18:59:28-08:00,['733c86bd24c6188292ea6ee23d2d9ab90badceb5'],5,358,363,90051,8,0.385542169,1,0.789156627,268
1d574497e5cd228751e45ff242ff8699f6c7572b,0,Todd Lipcon,2013-02-05 20:12:38-08:00,['6834ea89159a8159ebfab168124fc7da5d44b57c'],7,40,47,90098,1,0.25,1,1,268
2a1adbec4ddaa77938cbfc4de50b1cce773b588e,1,Todd Lipcon,2013-02-05 20:33:32-08:00,['1d574497e5cd228751e45ff242ff8699f6c7572b'],0,616,616,90714,4,0.600619195,0.931888545,0.885448916,271
7000ff96c561c6e1f2d24d0c053af5c74f629271,0,Todd Lipcon,2013-02-06 00:04:59-08:00,['2a1adbec4ddaa77938cbfc4de50b1cce773b588e'],0,224,224,90938,3,0.771084337,1,0.807228916,274
f67cec491f0902c1717690fdaf05f9f00755a97a,1,Todd Lipcon,2013-02-06 00:38:35-08:00,['7000ff96c561c6e1f2d24d0c053af5c74f629271'],66,90,156,91094,10,0,1,0,274
d11e1e18ba7dcc4101032e1eed0e77ee724b2ab3,0,Todd Lipcon,2013-02-06 00:41:24-08:00,['f67cec491f0902c1717690fdaf05f9f00755a97a'],1,1,2,91096,1,,,,274
b0f8c74352eefcef11083caa63c0ffefb5c6ee2b,0,Todd Lipcon,2013-02-06 01:01:08-08:00,['d11e1e18ba7dcc4101032e1eed0e77ee724b2ab3'],0,51,51,91147,1,1,1,0.75,274
8069bf24965e3b859c883b92c5e57ef993b1f9a6,1,Todd Lipcon,2013-02-06 01:40:55-08:00,['b0f8c74352eefcef11083caa63c0ffefb5c6ee2b'],63,81,144,91291,6,1,1,1,274
14625a7d3844309c674da20955cfed252b8228bf,1,Todd Lipcon,2013-02-06 01:43:57-08:00,['8069bf24965e3b859c883b92c5e57ef993b1f9a6'],7,9,16,91307,1,,,,274
6a09761d262d10bec97365ac7dae1c552ff7d464,0,Todd Lipcon,2013-02-06 02:51:41-08:00,['14625a7d3844309c674da20955cfed252b8228bf'],23,56,79,91386,1,1,1,0.6,274
68d51688372236bb03f044a4fa2c948388c9ba49,0,Todd Lipcon,2013-02-06 03:19:16-08:00,['6a09761d262d10bec97365ac7dae1c552ff7d464'],1,21,22,91408,1,0,0,1,274
2994c7f4c03c79ef0f3bec6d5982634108b67ef0,0,Todd Lipcon,2013-02-06 03:19:27-08:00,['68d51688372236bb03f044a4fa2c948388c9ba49'],1,38,39,91447,2,1,1,1,275
7899c066abc01dc81b355595c36714faf1e52655,0,Todd Lipcon,2013-02-06 03:34:04-08:00,['2994c7f4c03c79ef0f3bec6d5982634108b67ef0'],30,34,64,91511,2,0,1,1,275
d90c1a1c3e86b12e13a54e9117ebefe1e6dfc7db,0,Todd Lipcon,2013-02-06 12:57:42-08:00,['7899c066abc01dc81b355595c36714faf1e52655'],3,7,10,91521,1,1,1,0,275
3068bd1d550839efd36ca879b1bc1e612ad0f155,1,Todd Lipcon,2013-02-06 14:04:32-08:00,['d90c1a1c3e86b12e13a54e9117ebefe1e6dfc7db'],46,90,136,91657,5,0.833333333,0,1,275
79e75beea164021c82b8efe9b5e4e55b06e29b1c,1,Todd Lipcon,2013-02-06 15:19:56-08:00,['3068bd1d550839efd36ca879b1bc1e612ad0f155'],34,214,248,91905,10,0.656716418,1,0.611940299,277
809145ad128c331b08250bef074655dde2cf5ad6,1,Todd Lipcon,2013-02-06 16:36:54-08:00,['79e75beea164021c82b8efe9b5e4e55b06e29b1c'],249,252,501,92406,40,1,1,1,277
ae3a91846fd3a5e72f3c192b3fcc1f4cf6d830fd,0,Todd Lipcon,2013-02-06 17:35:03-08:00,['809145ad128c331b08250bef074655dde2cf5ad6'],0,4,4,92410,1,,,,277
cfa85c86214b6c37df37d3940e42021e586b7ac9,0,Todd Lipcon,2013-02-06 17:35:20-08:00,['ae3a91846fd3a5e72f3c192b3fcc1f4cf6d830fd'],18,44,62,92472,1,0.117647059,1,1,277
ae1fed0f371b7be25e6fc9a95d069d16b3321aea,0,Todd Lipcon,2013-02-06 17:59:02-08:00,['cfa85c86214b6c37df37d3940e42021e586b7ac9'],78,115,193,92665,7,0.05,0,1,277
b59b02955342ad3246ad54807d136a767ba2a1d2,1,Todd Lipcon,2013-02-06 22:37:43-08:00,['ae1fed0f371b7be25e6fc9a95d069d16b3321aea'],11,23,34,92699,2,0,1,1,277
220be4bb62faaf0ef8f4685aa68e2b3ad9fc524d,0,Todd Lipcon,2013-02-06 22:38:09-08:00,['b59b02955342ad3246ad54807d136a767ba2a1d2'],27,91,118,92817,10,0,0.2,1,277
38eb1e13ea3fc59e72fd47fbe597068739eea88b,0,Todd Lipcon,2013-02-07 00:43:17-08:00,['220be4bb62faaf0ef8f4685aa68e2b3ad9fc524d'],4,4,8,92825,1,,,,277
123266479f39668d80cf3718d7ac7dd3c2743607,0,Todd Lipcon,2013-02-07 00:44:07-08:00,['38eb1e13ea3fc59e72fd47fbe597068739eea88b'],1,10,11,92836,2,1,1,1,277
6d0e7bd00609f61ef370d9d97875901358f78aad,0,Todd Lipcon,2013-02-07 00:44:30-08:00,['123266479f39668d80cf3718d7ac7dd3c2743607'],0,18,18,92854,1,0,1,1,277
faeaf6f2f01037a7e30efd7695949ab7c0d09c3c,0,Todd Lipcon,2013-02-07 00:48:12-08:00,['6d0e7bd00609f61ef370d9d97875901358f78aad'],24,13,37,92891,2,0,0,0,277
a9eee54e923cb8bfc7385c7e8b431d74b5dd8312,0,Todd Lipcon,2013-02-07 02:26:44-08:00,['faeaf6f2f01037a7e30efd7695949ab7c0d09c3c'],1,1,2,92893,1,,,,277
20d017957ae5a0858459034198ac769679e6776b,0,Todd Lipcon,2013-02-07 02:27:29-08:00,['a9eee54e923cb8bfc7385c7e8b431d74b5dd8312'],6,11,17,92910,2,0,0.2,1,277
86fca4399304c4b30ce071df374e4d67614b7723,1,Todd Lipcon,2013-02-07 02:31:21-08:00,['20d017957ae5a0858459034198ac769679e6776b'],22,78,100,93010,4,0.322580645,0,1,277
c28bb95726d30709538f6d6bc9418fcd84bfadde,0,Todd Lipcon,2013-02-07 02:37:50-08:00,['86fca4399304c4b30ce071df374e4d67614b7723'],0,25,25,93035,1,0,1,1,277
0d07c61f603a4264f02ef48e96634b0763340866,0,Todd Lipcon,2013-02-07 03:08:08-08:00,['c28bb95726d30709538f6d6bc9418fcd84bfadde'],30,39,69,93104,1,0,1,0,277
e3643078870faac55952de39ab7d361ae6784339,0,Todd Lipcon,2013-02-07 03:11:06-08:00,['0d07c61f603a4264f02ef48e96634b0763340866'],5,21,26,93130,2,1,1,1,277
6c5f5fe0cb27a2138c33f1990edfeeb9ccdc4529,0,Todd Lipcon,2013-02-07 12:58:25-08:00,['e3643078870faac55952de39ab7d361ae6784339'],10,23,33,93163,1,0,1,1,277
df37c8d77ec4d0b30f35e7e8988468cf5064f3c9,0,Todd Lipcon,2013-02-07 13:00:08-08:00,['6c5f5fe0cb27a2138c33f1990edfeeb9ccdc4529'],3476,0,3476,96639,11,0.167587477,0,0.727900552,277
cf13373df8077e571bdf7bf71bb259366b165f3a,0,Todd Lipcon,2013-02-07 13:06:57-08:00,['df37c8d77ec4d0b30f35e7e8988468cf5064f3c9'],16,30,46,96685,1,0,1,1,277
8a986c639b2fff92e88acd748d0933fae5a5947d,0,Todd Lipcon,2013-02-07 14:58:36-08:00,['cf13373df8077e571bdf7bf71bb259366b165f3a'],0,21,21,96706,1,1,1,1,277
fd86b10b107a827e3e43e59cfd7ab4f401536531,1,Todd Lipcon,2013-02-07 16:55:09-08:00,['8a986c639b2fff92e88acd748d0933fae5a5947d'],10,29,39,96745,2,0.5,1,1,277
ff10a0515c6cb7b294efb52702efbf732f6e9bee,1,Todd Lipcon,2013-02-07 18:14:48-08:00,['fd86b10b107a827e3e43e59cfd7ab4f401536531'],0,120,120,96865,2,1,1,0.731707317,279
1efa1ef5e53d5b656053fbf28e3acca0c20dda1f,0,Todd Lipcon,2013-02-07 18:15:05-08:00,['ff10a0515c6cb7b294efb52702efbf732f6e9bee'],22,55,77,96942,1,0.095238095,0.952380952,0.285714286,279
017c914418c04ac9f02ff813e8065876620ff44b,0,Todd Lipcon,2013-02-07 19:09:35-08:00,['1efa1ef5e53d5b656053fbf28e3acca0c20dda1f'],10,39,49,96991,2,0.047619048,0.857142857,1,279
6f9db310e76d3ab34f7010f013c966c5b8f7c148,0,Todd Lipcon,2013-02-07 19:59:42-08:00,['017c914418c04ac9f02ff813e8065876620ff44b'],1,3,4,96995,1,0,0,1,279
24da119d92d146cac2f6d83a620175768738f3ef,0,Todd Lipcon,2013-02-07 21:41:42-08:00,['6f9db310e76d3ab34f7010f013c966c5b8f7c148'],133,237,370,97365,3,1,1,0.564102564,279
8b0e34bbd2f54b825773fcdb28ad2ebdb946d2e2,0,Todd Lipcon,2013-02-07 22:06:41-08:00,['24da119d92d146cac2f6d83a620175768738f3ef'],8,39,47,97412,2,0,1,1,279
a1b99cf874100f3348b2eb2a9f9901d5c63da100,0,Todd Lipcon,2013-02-08 00:50:25-08:00,['8b0e34bbd2f54b825773fcdb28ad2ebdb946d2e2'],1,55,56,97468,1,0.142857143,0.142857143,0.142857143,279
84da14209ac81a568ca2bbfaebac76ebde170151,0,Todd Lipcon,2013-02-08 00:53:21-08:00,['a1b99cf874100f3348b2eb2a9f9901d5c63da100'],24,74,98,97566,1,0,0,1,279
d05f9c1633387d4a65faf1bb93523522c18ce838,0,Todd Lipcon,2013-02-08 09:35:29-08:00,['84da14209ac81a568ca2bbfaebac76ebde170151'],1,1,2,97568,1,,,,279
31c30edc91be4b3756a7fee7f11721383b94f211,1,Todd Lipcon,2013-02-08 13:06:26-08:00,['d05f9c1633387d4a65faf1bb93523522c18ce838'],11,31,42,97610,3,0,0.461538462,0.615384615,279
4ac3a2f193f950b9e788170e182076f3d1960872,0,Todd Lipcon,2013-02-08 14:01:05-08:00,['31c30edc91be4b3756a7fee7f11721383b94f211'],4,4,8,97618,2,,,,279
195595bf9651285d742ad3daedc6e0a8530e2b91,0,Todd Lipcon,2013-02-08 22:30:37-08:00,['4ac3a2f193f950b9e788170e182076f3d1960872'],20,285,305,97923,8,0.763358779,1,0.877862595,281
3f8e6caf6a3437898fd2dfd836c1f732a1c0a426,0,Todd Lipcon,2013-02-08 22:31:06-08:00,['195595bf9651285d742ad3daedc6e0a8530e2b91'],0,82,82,98005,2,0.40625,0.40625,1,283
8225fd20806af7c6896bd7c863e02cb002f8badf,0,Todd Lipcon,2013-02-08 22:50:12-08:00,['3f8e6caf6a3437898fd2dfd836c1f732a1c0a426'],1,1,2,98007,1,,,,283
9a0b5cb16027662a1bb3e903310479cc7b3862dd,0,Todd Lipcon,2013-02-08 22:50:24-08:00,['8225fd20806af7c6896bd7c863e02cb002f8badf'],12,36,48,98055,1,,,,283
84cd6cc584d8b3324f5230d59972cb4746e9e777,0,Todd Lipcon,2013-02-09 21:16:12-08:00,['9a0b5cb16027662a1bb3e903310479cc7b3862dd'],2,1,3,98058,1,,,,283
b9bfeee2701f23162bb338e9e9d5d52e306e023d,0,Todd Lipcon,2013-02-09 21:57:17-08:00,['84cd6cc584d8b3324f5230d59972cb4746e9e777'],8,5,13,98071,1,,,,283
25120f42fd7518c7c2bea1e955e0daf472f79285,0,Todd Lipcon,2013-02-11 12:05:01-08:00,['b9bfeee2701f23162bb338e9e9d5d52e306e023d'],0,6,6,98077,1,0,0,1,283
86718eb0faedf4b4c49594272612514a74e735e7,0,Todd Lipcon,2013-02-11 12:09:36-08:00,['25120f42fd7518c7c2bea1e955e0daf472f79285'],2,1,3,98080,2,1,1,0,283
d38d2eb444e2ce07f76f6291cc35ccbbc1d68d5e,0,Todd Lipcon,2013-02-11 18:14:38-08:00,['86718eb0faedf4b4c49594272612514a74e735e7'],18,160,178,98258,4,0.34375,0.90625,0.958333333,283
daa8899994be97d5659c24fb23c320a7707841b0,0,Todd Lipcon,2013-02-11 18:36:15-08:00,['d38d2eb444e2ce07f76f6291cc35ccbbc1d68d5e'],104,123,227,98485,5,0,1,,283
5875f21ef45b9220aa59798dcbb63bcdbe4d0a63,0,Todd Lipcon,2013-02-11 23:40:55-08:00,['daa8899994be97d5659c24fb23c320a7707841b0'],17,113,130,98615,4,0.2,0,1,283
a77dc7a3539bae9fdfb8a68e6fb255fff649e129,0,Todd Lipcon,2013-02-12 00:19:28-08:00,['5875f21ef45b9220aa59798dcbb63bcdbe4d0a63'],18,52,70,98685,3,0.947368421,0.947368421,1,283
16943abdf892ad53682539608cfecc0204b8424c,0,Todd Lipcon,2013-02-12 15:46:20-08:00,['a77dc7a3539bae9fdfb8a68e6fb255fff649e129'],10,79,89,98774,6,1,1,0,285
4053686aaf18b1813dd391670eac9cf0ed72dc6a,0,Todd Lipcon,2013-02-12 17:03:14-08:00,['16943abdf892ad53682539608cfecc0204b8424c'],4,4,8,98782,5,,,,285
ddd2b42ea95ef9c86279aacc9f2ed1980fcd0106,0,Todd Lipcon,2013-02-12 17:03:14-08:00,['4053686aaf18b1813dd391670eac9cf0ed72dc6a'],129,192,321,99103,13,0.513513514,0.702702703,1,285
8ed2cb26de332f34624300df470f36fda0de6f3f,1,Todd Lipcon,2013-02-12 20:15:48-08:00,['ddd2b42ea95ef9c86279aacc9f2ed1980fcd0106'],293,397,690,99793,6,1,1,0.555555556,287
ac0e599fc9f4d89de15a9284fd9fb3e01332bfb2,1,Todd Lipcon,2013-02-12 20:15:48-08:00,['8ed2cb26de332f34624300df470f36fda0de6f3f'],250,243,493,100286,7,0,0.5,0.5,287
c4d864ab704a41f9cc01aef4db3bb46cd79b7199,0,Todd Lipcon,2013-02-12 20:15:48-08:00,['ac0e599fc9f4d89de15a9284fd9fb3e01332bfb2'],11,185,196,100482,5,0.83,0.93,0.73,287
e5e46bb54ca6d0a883a5f21b505197fd5a3e2847,0,Todd Lipcon,2013-02-12 23:27:34-08:00,['c4d864ab704a41f9cc01aef4db3bb46cd79b7199'],1,9,10,100492,1,0,0,1,287
22cdba15e549d69e6632db52429213ae7e38753d,0,Todd Lipcon,2013-02-12 23:47:39-08:00,['e5e46bb54ca6d0a883a5f21b505197fd5a3e2847'],0,3,3,100495,1,,,,287
b0431e2b5b222bcf1fee1733485660bee15c8320,0,Todd Lipcon,2013-02-16 21:52:45-08:00,['22cdba15e549d69e6632db52429213ae7e38753d'],30,180,210,100705,5,0,0,1,290
eca18b1bfe5655cc3555db0c502bbe9a25304096,0,Todd Lipcon,2013-02-16 21:53:08-08:00,['b0431e2b5b222bcf1fee1733485660bee15c8320'],26,38,64,100769,1,0,0,1,290
cd2e709681c6a13f5c4d2f554e01f5e77edf6d4e,0,Todd Lipcon,2013-02-22 12:57:24-08:00,['eca18b1bfe5655cc3555db0c502bbe9a25304096'],7,16,23,100792,1,,,,290
e7fb1fba5adde148ddcfd8c53ce2d9866bf9440c,0,Todd Lipcon,2013-02-22 13:17:03-08:00,['cd2e709681c6a13f5c4d2f554e01f5e77edf6d4e'],11767,9,11776,112568,47,0.275399543,0.148401826,0.275684932,290
e2f932a644b555025fa858ed6f3f9a8cf9f7efba,0,Todd Lipcon,2013-02-22 13:17:08-08:00,['e7fb1fba5adde148ddcfd8c53ce2d9866bf9440c'],19,164,183,112751,12,,,,290
5c3b8b396182657be433d25bf62d334cf6be1542,0,Todd Lipcon,2013-02-22 14:42:42-08:00,['e2f932a644b555025fa858ed6f3f9a8cf9f7efba'],4,3,7,112758,1,,,,290
677e42a61af2371f52777cdae29819fb24bae996,0,Todd Lipcon,2013-02-22 14:50:54-08:00,['5c3b8b396182657be433d25bf62d334cf6be1542'],1,1,2,112760,1,,,,290
3c034d5e13ec1dd5388bb2931f800072b1ef268d,0,Todd Lipcon,2013-02-22 15:01:51-08:00,['677e42a61af2371f52777cdae29819fb24bae996'],54,17,71,112831,7,0.12,0,0.04,290
09f25c49e91a91d0ea9c6c77cefd5c07d6101361,1,Todd Lipcon,2013-02-22 15:10:34-08:00,['3c034d5e13ec1dd5388bb2931f800072b1ef268d'],0,15,15,112846,1,,,,291
51096e9587ba4750b7aa5b159818661d8fc98750,0,Todd Lipcon,2013-02-22 16:22:26-08:00,['09f25c49e91a91d0ea9c6c77cefd5c07d6101361'],3,28,31,112877,1,0,1,1,291
ca85e34b3b6181c7676fd96078148f4abc744e7f,0,Todd Lipcon,2013-02-26 17:47:52-08:00,['51096e9587ba4750b7aa5b159818661d8fc98750'],196,421,617,113494,5,0.827586207,0.99137931,0.206896552,293
c933f74e597acde7241182966f773db047b83e4c,0,Todd Lipcon,2013-02-26 17:54:00-08:00,['ca85e34b3b6181c7676fd96078148f4abc744e7f'],478,1,479,113973,4,0.56504065,0,0.195121951,293
133d69484155bc73f4b8167785979960acf9730b,0,Todd Lipcon,2013-02-26 18:09:44-08:00,['c933f74e597acde7241182966f773db047b83e4c'],22,30,52,114025,1,1,1,1,293
eb41f37c9ef6b2ed86c66485653030e307ff6012,0,Todd Lipcon,2013-02-27 10:38:36-08:00,['133d69484155bc73f4b8167785979960acf9730b'],1,6,7,114032,1,,,,293
9d54acc3ce250c37d5cbea4386b91fcb37277941,0,Todd Lipcon,2013-03-08 15:16:33-08:00,['eb41f37c9ef6b2ed86c66485653030e307ff6012'],19,15,34,114066,4,1,1,0,293
168f09bfb1330934fea59e47f75de3eda61afc97,0,Todd Lipcon,2013-03-08 15:16:33-08:00,['9d54acc3ce250c37d5cbea4386b91fcb37277941'],0,100,100,114166,1,,,,294
5322534d73f3b72f498b9c0f4f24ff05ab1973be,0,Todd Lipcon,2013-03-09 23:23:03-08:00,['168f09bfb1330934fea59e47f75de3eda61afc97'],1,1,2,114168,1,,,,294
d39a68cc04e4693cae77c1077731a9ded6a19c97,1,Todd Lipcon,2013-03-09 23:32:32-08:00,['5322534d73f3b72f498b9c0f4f24ff05ab1973be'],2,189,191,114359,4,0.333333333,1,1,296
121d538c48cef2a50379fa2e75b3bc0824eecb32,1,Todd Lipcon,2013-03-09 23:33:16-08:00,['d39a68cc04e4693cae77c1077731a9ded6a19c97'],507,159,666,115025,26,0.765432099,0.382716049,0.388888889,296
cb64f7c5bfd1bc2f1c5b8c699fd0dcc716da1a3e,0,Todd Lipcon,2013-03-11 14:04:45-07:00,['121d538c48cef2a50379fa2e75b3bc0824eecb32'],0,36,36,115061,1,,,,297
ad6d8240fe1df30abc9cfc765ea76c72c9be532d,0,Todd Lipcon,2013-03-11 15:03:09-07:00,['cb64f7c5bfd1bc2f1c5b8c699fd0dcc716da1a3e'],1,3,4,115065,1,1,1,0,297
e8bfc1d02e341b760b7e54a1e874913c0dc799b7,0,Todd Lipcon,2013-03-11 17:02:28-07:00,['ad6d8240fe1df30abc9cfc765ea76c72c9be532d'],2,9,11,115076,1,,,,297
041caf9400bf81c53588822ff93d420cd52bded8,0,Todd Lipcon,2013-03-11 17:02:28-07:00,['e8bfc1d02e341b760b7e54a1e874913c0dc799b7'],3,5,8,115084,1,0,1,0,297
2a69d0ee51ee07fc0c49796a74a166d0c96ec71c,0,Todd Lipcon,2013-03-11 17:02:28-07:00,['041caf9400bf81c53588822ff93d420cd52bded8'],2,3,5,115089,1,,,,297
03e44168ad89b4c6f6027eb86c022df74272a6cb,0,Todd Lipcon,2013-03-11 17:02:28-07:00,['2a69d0ee51ee07fc0c49796a74a166d0c96ec71c'],3,2,5,115094,1,1,0,0,297
a7abed7f0a5a11f88617ea2bfcbdf71c10270f25,0,Todd Lipcon,2013-03-11 17:02:28-07:00,['03e44168ad89b4c6f6027eb86c022df74272a6cb'],1,1,2,115096,1,,,,297
1f414b4a44f41538f9c1b7a162cca5c245fcbf3a,0,Todd Lipcon,2013-03-11 17:02:28-07:00,['a7abed7f0a5a11f88617ea2bfcbdf71c10270f25'],8,8,16,115112,1,,,,297
9feeb506e0379d33b01207e51c426e99b7e82d86,0,Todd Lipcon,2013-03-11 18:10:03-07:00,['1f414b4a44f41538f9c1b7a162cca5c245fcbf3a'],10,13,23,115135,2,0,,,297
17bf419df51e76af6e273d1626662aacc8cf1f9b,1,Todd Lipcon,2013-03-11 18:10:52-07:00,['9feeb506e0379d33b01207e51c426e99b7e82d86'],7,57,64,115199,4,0.3,0.3,0.7,297
be606684f43809f999bdcd0146dcde315b4b3d7a,0,Todd Lipcon,2013-03-11 18:47:57-07:00,['17bf419df51e76af6e273d1626662aacc8cf1f9b'],25,16,41,115240,1,0,0,0,297
2007138aba1def2916524e292be8fafd83bd35d3,0,Todd Lipcon,2013-03-11 18:56:28-07:00,['be606684f43809f999bdcd0146dcde315b4b3d7a'],0,1,1,115241,1,,,,297
2c2b082407d32560193bfc92af5aab3f6b374baf,0,Todd Lipcon,2013-03-12 03:52:33-07:00,['2007138aba1def2916524e292be8fafd83bd35d3'],21,100,121,115362,6,0.672131148,0.68852459,0.918032787,297
ac37be352ed580baf6977f57260f9999a5ba25af,0,Todd Lipcon,2013-03-12 04:00:10-07:00,['2c2b082407d32560193bfc92af5aab3f6b374baf'],0,14,14,115376,3,,,,297
912be3274539241f07ee1c01bf624404844bffeb,0,Todd Lipcon,2013-03-12 04:00:10-07:00,['ac37be352ed580baf6977f57260f9999a5ba25af'],29,41,70,115446,1,,,,297
71a84641fe44f33e723dd36d88d518b746da4407,0,Todd Lipcon,2013-03-12 04:00:10-07:00,['912be3274539241f07ee1c01bf624404844bffeb'],1,1,2,115448,1,,,,297
36bfbb1b438685e740692b77a0d02840c120da8f,0,Todd Lipcon,2013-03-12 10:51:34-07:00,['71a84641fe44f33e723dd36d88d518b746da4407'],4,9,13,115461,2,1,0,1,297
5db8642344c09df0190dbacbbad4b6b6dfd74a5b,0,Todd Lipcon,2013-03-12 23:06:28-07:00,['36bfbb1b438685e740692b77a0d02840c120da8f'],0,1,1,115462,1,,,,297
6e39c4403257abe6602191242689731f06a24808,0,Todd Lipcon,2013-03-12 23:06:32-07:00,['5db8642344c09df0190dbacbbad4b6b6dfd74a5b'],3,17,20,115482,1,0,0,1,297
49ef4abc6340cb89befc8612b38dcad768eb3752,0,Todd Lipcon,2013-03-14 20:02:50-07:00,['6e39c4403257abe6602191242689731f06a24808'],1,1,2,115484,1,,,,297
99970fe93c1d6dc04a825e2282230be4491adc5a,0,Todd Lipcon,2013-03-14 20:05:33-07:00,['49ef4abc6340cb89befc8612b38dcad768eb3752'],0,12,12,115496,2,1,1,0,297
68b937ffbfc369777ed1c5e7aa2b4eef323af310,0,Todd Lipcon,2013-03-14 20:05:48-07:00,['99970fe93c1d6dc04a825e2282230be4491adc5a'],4,4,8,115504,1,,,,297
4cb7425fe92d851cbed20feb02f80baad492d1e9,0,Todd Lipcon,2013-03-14 20:05:54-07:00,['68b937ffbfc369777ed1c5e7aa2b4eef323af310'],0,12,12,115516,1,,,,297
358778a7773fc90533c6db970f61f951e60144b6,0,Todd Lipcon,2013-03-14 20:45:01-07:00,['4cb7425fe92d851cbed20feb02f80baad492d1e9'],2,4,6,115522,1,,,,297
59b77edb887c1f389a627a6c20488094a584891b,0,Todd Lipcon,2013-03-14 20:45:06-07:00,['358778a7773fc90533c6db970f61f951e60144b6'],6,11,17,115539,2,,,,297
3a08d183c66ef0cf86496171917d5bde12a41565,0,Todd Lipcon,2013-03-14 22:52:45-07:00,['59b77edb887c1f389a627a6c20488094a584891b'],1,1,2,115541,1,,,,297
4e893333bc98032da7e732c4e7aeb48e31995638,1,Todd Lipcon,2013-03-14 23:31:11-07:00,['3a08d183c66ef0cf86496171917d5bde12a41565'],270,259,529,116070,47,,,,297
0b88039c147d7fce022cd4a861b9063f2a0e4d90,0,Todd Lipcon,2013-03-15 00:10:20-07:00,['4e893333bc98032da7e732c4e7aeb48e31995638'],1,2,3,116073,1,1,1,1,297
0803884c93a7e1e5c8328e1a3cb9100a5023ce47,0,Todd Lipcon,2013-03-15 00:12:38-07:00,['0b88039c147d7fce022cd4a861b9063f2a0e4d90'],0,5,5,116078,2,1,1,1,297
b3b5187ca26c973725be802db1f790fdb8e10d4c,0,Todd Lipcon,2013-03-15 17:12:04-07:00,['0803884c93a7e1e5c8328e1a3cb9100a5023ce47'],5,73,78,116156,2,0,1,0.916666667,297
117bfe03c4c424797787a1397da7ed23ea55f6d8,0,Todd Lipcon,2013-03-17 10:33:56-07:00,['b3b5187ca26c973725be802db1f790fdb8e10d4c'],4,4,8,116164,4,,,,297
f0a8a7129ca5a7d360d7e40bca3196c38901e0df,0,Todd Lipcon,2013-03-17 15:39:11-07:00,['117bfe03c4c424797787a1397da7ed23ea55f6d8'],8,4,12,116176,1,1,0,0,297
cb060960bac6a3cb608052402006db5f5c910f32,1,Todd Lipcon,2013-03-17 16:49:03-07:00,['f0a8a7129ca5a7d360d7e40bca3196c38901e0df'],200,852,1052,117228,12,0.616487455,0.946236559,1,298
ad877e92e67ead73469b39285bbb3a1fc11b11ab,0,Todd Lipcon,2013-03-18 18:45:43-07:00,['cb060960bac6a3cb608052402006db5f5c910f32'],2,5,7,117235,1,0,1,1,298
6ea65253785f00b0bd8cc965aa01401342e7c578,0,Todd Lipcon,2013-03-18 21:36:48-07:00,['ad877e92e67ead73469b39285bbb3a1fc11b11ab'],4,7,11,117246,1,,,,298
e6a3ce1fb0440fd6e0c4de2819fa0dfed3e42c8d,0,Todd Lipcon,2013-03-19 13:28:07-07:00,['6ea65253785f00b0bd8cc965aa01401342e7c578'],0,173,173,117419,3,0.743902439,1,1,300
f02ef60f740b925136bb35631ad6c5ef0cefea88,1,Todd Lipcon,2013-03-19 14:02:56-07:00,['e6a3ce1fb0440fd6e0c4de2819fa0dfed3e42c8d'],385,590,975,118394,7,1,1,1,300
95420adc8c07117fcb98a682dea8a4250722f0c8,0,Todd Lipcon,2013-03-19 14:22:04-07:00,['f02ef60f740b925136bb35631ad6c5ef0cefea88'],2,48,50,118444,2,1,1,1,300
73ad6710d2af5d91e35cbd4dcc8b1540e89e9ee4,0,Todd Lipcon,2013-03-19 15:15:27-07:00,['95420adc8c07117fcb98a682dea8a4250722f0c8'],4,22,26,118470,2,,,,300
edc0dda97041dc8285a6d755d37a41bd32eb3e1f,0,Todd Lipcon,2013-03-19 15:15:30-07:00,['73ad6710d2af5d91e35cbd4dcc8b1540e89e9ee4'],13,10,23,118493,1,0,0,0,300
e69438a70c56b497e5243fd258fbd458b5c1491b,0,Todd Lipcon,2013-03-19 15:18:16-07:00,['edc0dda97041dc8285a6d755d37a41bd32eb3e1f'],3,3,6,118499,3,,,,300
f0837d00db52d42581830b3fcd78b0aaa60f047c,0,Todd Lipcon,2013-03-19 15:23:21-07:00,['e69438a70c56b497e5243fd258fbd458b5c1491b'],0,207,207,118706,1,,,,301
72ff23b3bdcdee69963410ecc18d11e68f3d9e56,0,Todd Lipcon,2013-03-19 17:25:11-07:00,['f0837d00db52d42581830b3fcd78b0aaa60f047c'],0,1,1,118707,1,1,1,1,301
4de91a73e0b3edfe75114c8437ab65ecc07f873a,1,Todd Lipcon,2013-03-19 17:33:48-07:00,['72ff23b3bdcdee69963410ecc18d11e68f3d9e56'],72,314,386,119093,4,0.175572519,0.511450382,0.977099237,301
25e310be6df4db40300eed62912d9b5e6a49d089,1,Todd Lipcon,2013-03-24 16:09:53-07:00,['4de91a73e0b3edfe75114c8437ab65ecc07f873a'],138,98,236,119329,13,1,0.244444444,0.466666667,301
6013b33db1ddc3e1f475b767f719a7842c1f5225,1,Todd Lipcon,2013-03-25 00:49:08-07:00,['25e310be6df4db40300eed62912d9b5e6a49d089'],2,99,101,119430,4,0.291666667,0.291666667,1,301
1aef999e967f2af8b79c3e5753210c19b74ca335,1,Todd Lipcon,2013-03-25 00:49:08-07:00,['6013b33db1ddc3e1f475b767f719a7842c1f5225'],125,137,262,119692,19,0,0,0,303
f5546effc66281f48f8c2625a30d3ab9fb50fa75,0,Todd Lipcon,2013-03-25 00:49:09-07:00,['1aef999e967f2af8b79c3e5753210c19b74ca335'],5,33,38,119730,2,1,1,0.214285714,303
34468995005aa9aa1e5af8309a3fd0f75641b1c6,0,Todd Lipcon,2013-03-25 00:55:22-07:00,['f5546effc66281f48f8c2625a30d3ab9fb50fa75'],3,3,6,119736,1,,,,303
7b2738f9248c47ce78d407f107d46f793ca5cc2c,1,Todd Lipcon,2013-03-25 10:12:05-07:00,['34468995005aa9aa1e5af8309a3fd0f75641b1c6'],182,2757,2939,122675,25,0.237204724,0.271653543,0.268700787,317
1c9db528a9b36bc8e38b13fb80fb75c53808a766,1,Todd Lipcon,2013-03-25 10:27:01-07:00,['7b2738f9248c47ce78d407f107d46f793ca5cc2c'],0,73,73,122748,3,,,,318
23861f9cdc161a7e87f2a77f47fe218da6f40ed6,0,Todd Lipcon,2013-03-25 10:30:23-07:00,['1c9db528a9b36bc8e38b13fb80fb75c53808a766'],0,3,3,122751,1,1,1,1,318
ed290a994a7cd562f8982be5221e8dfb60dbbbf5,0,Todd Lipcon,2013-03-25 10:51:50-07:00,['23861f9cdc161a7e87f2a77f47fe218da6f40ed6'],2,2,4,122755,1,,,,318
5bdc45ebf173ca07b1eadd7413b66161c5577825,0,Todd Lipcon,2013-03-25 10:51:50-07:00,['ed290a994a7cd562f8982be5221e8dfb60dbbbf5'],127,117,244,122999,3,0,0,0.307692308,318
c80d5716779f67b7e9565eebd5458aabd85d218f,0,Todd Lipcon,2013-03-26 12:49:25-07:00,['5bdc45ebf173ca07b1eadd7413b66161c5577825'],1,13,14,123013,1,,,,318
97153e8eb02c2b41ecf0fe34b7066fb02f01cff4,0,Todd Lipcon,2013-03-27 14:07:54-07:00,['c80d5716779f67b7e9565eebd5458aabd85d218f'],0,82,82,123095,2,0.255319149,1,1,318
56e74a5af7d1cfdbd4cd29bf5f175db687cf7ca5,1,Todd Lipcon,2013-03-28 20:50:33-07:00,['97153e8eb02c2b41ecf0fe34b7066fb02f01cff4'],354,597,951,124046,31,1,0.771428571,0.907142857,318
6bb37062cb9e3f60543b44eb375c1af40522d54f,1,Todd Lipcon,2013-03-28 20:52:31-07:00,['56e74a5af7d1cfdbd4cd29bf5f175db687cf7ca5'],39,42,81,124127,6,,,,318
900e70964658cdb48dfc0e1ac1f63b8063d72ac6,0,Todd Lipcon,2013-03-28 21:38:40-07:00,['6bb37062cb9e3f60543b44eb375c1af40522d54f'],1,2,3,124130,1,,,,318
68794804c5f125882693160a54e6ca06db47ee3d,1,Todd Lipcon,2013-03-28 22:01:46-07:00,['900e70964658cdb48dfc0e1ac1f63b8063d72ac6'],41,277,318,124448,7,0.422413793,0.767241379,1,319
8d8bb2929172ce4b4cb5e5e7477cf9c7bc89c019,0,Todd Lipcon,2013-04-01 16:46:38-07:00,['68794804c5f125882693160a54e6ca06db47ee3d'],14,12,26,124474,2,,,,319
375613839015dbe7e14c815b768b83c95b3a8dd9,1,Todd Lipcon,2013-04-01 16:52:05-07:00,['8d8bb2929172ce4b4cb5e5e7477cf9c7bc89c019'],64,542,606,125080,26,0.994413408,1,0.910614525,325
e2b5b45903b38bd3f50eec619525e3a5a1ae57cf,1,Todd Lipcon,2013-04-01 17:22:13-07:00,['375613839015dbe7e14c815b768b83c95b3a8dd9'],15,164,179,125259,5,0.024390244,0.585365854,0.987804878,325
1b80da42ff176e7e86bd49f5f2a436e5aef12e09,0,Todd Lipcon,2013-04-01 18:00:41-07:00,['e2b5b45903b38bd3f50eec619525e3a5a1ae57cf'],65,56,121,125380,13,0.142857143,0.071428571,0.785714286,325
30b9ef66a657ea39d145b61a81583024148ce5db,0,Todd Lipcon,2013-04-01 18:26:37-07:00,['1b80da42ff176e7e86bd49f5f2a436e5aef12e09'],54,88,142,125522,11,1,1,1,325
2325fb7c698ac175d375efed50daeee8ceb459a0,0,Todd Lipcon,2013-04-02 13:30:22-07:00,['30b9ef66a657ea39d145b61a81583024148ce5db'],30,408,438,125960,9,0.515463918,1,1,326
1138e645621db8aa5988f6f7f661941f877c57d4,0,Todd Lipcon,2013-04-02 14:29:22-07:00,['2325fb7c698ac175d375efed50daeee8ceb459a0'],8,5,13,125973,2,,,,326
e45d96eb7a7c7cd4c1067684d0d09f883e2f32c0,0,Colin Patrick Mccabe,2013-04-02 17:22:01-07:00,['1138e645621db8aa5988f6f7f661941f877c57d4'],23,79,102,126075,4,0.75,0.8125,0.1875,327
957dd846fc50e805e92bc0deb823ab5c567ab089,0,Colin Patrick Mccabe,2013-04-02 17:42:53-07:00,['e45d96eb7a7c7cd4c1067684d0d09f883e2f32c0'],2,27,29,126104,3,0.526315789,0.526315789,0.578947368,327
01e3a567d7efe49b00bfa61782a53ace9b89b4fd,0,Colin Patrick Mccabe,2013-04-02 17:42:55-07:00,['957dd846fc50e805e92bc0deb823ab5c567ab089'],1,48,49,126153,4,1,1,0.5,329
e55662e68468f384167f93901203d03057120ec1,0,Colin Patrick Mccabe,2013-04-02 17:43:14-07:00,['01e3a567d7efe49b00bfa61782a53ace9b89b4fd'],4,7,11,126164,3,,,,329
c37bcd81561aeea7598406251b28ccf3ae838851,0,Todd Lipcon,2013-04-02 19:08:48-07:00,['1138e645621db8aa5988f6f7f661941f877c57d4'],18,226,244,126408,4,0.158730159,0.396825397,0.785714286,329
a2d609556fb607667383f6dc960f8df4223c3078,0,Todd Lipcon,2013-04-03 09:51:07-07:00,"['c37bcd81561aeea7598406251b28ccf3ae838851', 'e55662e68468f384167f93901203d03057120ec1']",29,160,189,126597,10,,,,329
26257ce745c82adc5ed9d2c1a212f11656a95662,0,Todd Lipcon,2013-04-03 12:22:25-07:00,['a2d609556fb607667383f6dc960f8df4223c3078'],2,6,8,126605,1,1,1,0,329
7d48f115772fcd8c1469bd9144364a523922176c,0,Todd Lipcon,2013-04-03 15:06:01-07:00,['26257ce745c82adc5ed9d2c1a212f11656a95662'],9,12,21,126626,1,,,,329
9f1b331d181716883a241e8fc9799a815db4f118,1,Todd Lipcon,2013-04-09 17:47:15-07:00,['7d48f115772fcd8c1469bd9144364a523922176c'],0,96,96,126722,1,,,,330
d10c446501c4794c808043c1171ebdc21871e0e4,1,Todd Lipcon,2013-04-25 09:51:37-07:00,['9f1b331d181716883a241e8fc9799a815db4f118'],104,258,362,127084,5,0.787234043,0.957446809,0.957446809,331
fc91b2226b46e5196356d366e87b5b0e02cc9b8f,0,Todd Lipcon,2013-04-25 13:45:43-07:00,['d10c446501c4794c808043c1171ebdc21871e0e4'],126,159,285,127369,30,0,1,1,332
43afc3853bf262c98e55b7eb0deb7467f5036dc5,0,Todd Lipcon,2013-04-27 18:08:52-07:00,['fc91b2226b46e5196356d366e87b5b0e02cc9b8f'],29,26,55,127424,2,0,0,0,332
76e4638c7abd8df31af5be70182c2c9d56c6d992,0,Todd Lipcon,2013-04-27 18:18:33-07:00,['43afc3853bf262c98e55b7eb0deb7467f5036dc5'],0,28,28,127452,1,,,,332
9a8fd931310ae2688bc218330b2d34e02b9d3dd7,0,Todd Lipcon,2013-04-29 11:45:08-07:00,['76e4638c7abd8df31af5be70182c2c9d56c6d992'],1,1,2,127454,1,,,,332
85b93460d78259915507464460af7d708e1e313a,0,Todd Lipcon,2013-05-01 11:42:10-07:00,['9a8fd931310ae2688bc218330b2d34e02b9d3dd7'],0,421,421,127875,5,0.283653846,0.495192308,0.778846154,335
441f94eabefdab13c5020f8a9085527e65def695,0,Todd Lipcon,2013-05-01 12:32:08-07:00,['85b93460d78259915507464460af7d708e1e313a'],4,8,12,127887,1,0,1,1,335
cef7d94e5b214eaf24a7eaad78f10a015adebbb8,0,Todd Lipcon,2013-05-01 13:05:53-07:00,['441f94eabefdab13c5020f8a9085527e65def695'],0,1,1,127888,1,1,1,0,335
d5f8ddaf5543baf130b2da8ab3de2b280a6ac78b,0,Todd Lipcon,2013-05-02 17:47:45-07:00,['cef7d94e5b214eaf24a7eaad78f10a015adebbb8'],10,57,67,127955,3,0.027027027,1,1,335
7945ac4df36a29f24163315da3510643e4e09a41,1,Todd Lipcon,2013-05-10 11:39:33-07:00,['d5f8ddaf5543baf130b2da8ab3de2b280a6ac78b'],4,11,15,127970,4,1,1,0.5,335
0cfb756d03fe2b4ef6713a6f40fb1a602a84bba8,1,Todd Lipcon,2013-05-11 15:17:46-07:00,['7945ac4df36a29f24163315da3510643e4e09a41'],0,101,101,128071,6,0.236363636,1,1,335
9251a9b71e62948730f57506b546385db09b4c23,0,Todd Lipcon,2013-05-13 22:01:46-07:00,['0cfb756d03fe2b4ef6713a6f40fb1a602a84bba8'],2,2,4,128075,1,,,,335
96305636e563a6150b6d5ed868b28ba0d5dca5a1,0,Todd Lipcon,2013-05-14 00:46:52-07:00,['9251a9b71e62948730f57506b546385db09b4c23'],8,8,16,128091,1,,,,335
0665eb79a69f15811fe4ef87dc25d2c61aa2eaa6,1,Todd Lipcon,2013-05-14 12:37:53-07:00,['96305636e563a6150b6d5ed868b28ba0d5dca5a1'],23,214,237,128328,8,0.35915493,1,0.563380282,335
f0f4003b00d9b957be1626426dc906fc41201ff8,0,Todd Lipcon,2013-05-15 14:32:40-07:00,['0665eb79a69f15811fe4ef87dc25d2c61aa2eaa6'],1,1,2,128330,1,,,,335
34fe187bce28eb3658c95d344241420483b166f8,0,Todd Lipcon,2013-05-16 17:30:27-07:00,['f0f4003b00d9b957be1626426dc906fc41201ff8'],2,2,4,128334,1,,,,335
597119a4740b1b424f7c3aaae338156541425732,0,Todd Lipcon,2013-05-16 19:14:09-07:00,['34fe187bce28eb3658c95d344241420483b166f8'],11,21,32,128366,1,0,1,1,335
acf229b418a296643bdd403e206982b10e00a366,0,Todd Lipcon,2013-05-16 21:17:12-07:00,['597119a4740b1b424f7c3aaae338156541425732'],69,474,543,128909,1,,,,335
b000df8f3dda448a1151e3da7385b11886b90aa3,1,Todd Lipcon,2013-05-16 21:17:12-07:00,['acf229b418a296643bdd403e206982b10e00a366'],3,460,463,129372,5,0.414507772,1,1,338
afba809f7f7e262e4e54fba47e20067c6c1c16fe,1,Todd Lipcon,2013-05-16 21:17:12-07:00,['b000df8f3dda448a1151e3da7385b11886b90aa3'],261,1059,1320,130692,29,0.078328982,0.934725849,0.454308094,342
aba6647cc336637f01477df0f52ee82a155f82ba,0,Todd Lipcon,2013-05-16 21:17:12-07:00,['afba809f7f7e262e4e54fba47e20067c6c1c16fe'],40,163,203,130895,7,1,1,0.796610169,342
a9d00715f2ca9328106e385fe6464a29a3461ef2,1,Todd Lipcon,2013-05-16 21:17:12-07:00,['aba6647cc336637f01477df0f52ee82a155f82ba'],96,94,190,131085,2,1,0,0.066666667,342
c286deb27bbfad01d0c1218c871fb56c61ffb2c5,0,Todd Lipcon,2013-05-16 21:17:12-07:00,['a9d00715f2ca9328106e385fe6464a29a3461ef2'],49,50,99,131184,2,1,0,1,342
d6dd5af4f3ecf58bda195130ec2bc9aad7c7b410,1,Todd Lipcon,2013-05-16 21:17:12-07:00,['c286deb27bbfad01d0c1218c871fb56c61ffb2c5'],37,321,358,131542,15,0.271604938,1,0.882716049,342
95f6c98110516cbfc16cac946dee45b4aa0e9257,1,Todd Lipcon,2013-05-16 21:17:12-07:00,['d6dd5af4f3ecf58bda195130ec2bc9aad7c7b410'],636,1159,1795,133337,17,0.561151079,1,0.982014388,345
7c10a16618a1658add724e93f8468a53c83b237d,1,Todd Lipcon,2013-05-16 21:17:12-07:00,['95f6c98110516cbfc16cac946dee45b4aa0e9257'],93,105,198,133535,11,1,0,0.25,346
fe6f91b1a111db585b530e290dbade2bcd5b00a3,0,Todd Lipcon,2013-05-16 21:17:12-07:00,['7c10a16618a1658add724e93f8468a53c83b237d'],51,12,63,133598,2,0,0,0,346
9d51a366339c77cb09bbc245de7124bf6267b314,0,Todd Lipcon,2013-05-16 21:17:12-07:00,['fe6f91b1a111db585b530e290dbade2bcd5b00a3'],2,7,9,133607,2,0,1,0,346
5d06052e94f2c0eccafef2200d0d08d8a60d5e8b,0,Todd Lipcon,2013-05-16 21:17:12-07:00,['9d51a366339c77cb09bbc245de7124bf6267b314'],18,19,37,133644,2,0,0,0,346
28cc1e27c95070e4fe199dd3a7d53c1128cbe407,0,Todd Lipcon,2013-05-16 21:17:12-07:00,['5d06052e94f2c0eccafef2200d0d08d8a60d5e8b'],40,87,127,133771,6,0.641025641,1,1,346
9cb22adbefd5e3230fe530b4bd95eb21895cd668,0,Todd Lipcon,2013-05-16 21:17:12-07:00,['28cc1e27c95070e4fe199dd3a7d53c1128cbe407'],6,8,14,133785,2,,,,346
9b82eeca7079cd9d7b6cb59bb6ee585496eafbff,0,Todd Lipcon,2013-05-20 13:19:58-07:00,['9cb22adbefd5e3230fe530b4bd95eb21895cd668'],22,22,44,133829,20,,,,346
41a3cf19a7a598f7eca1bae65eab240980cdc465,1,Todd Lipcon,2013-05-20 13:21:38-07:00,['9b82eeca7079cd9d7b6cb59bb6ee585496eafbff'],539,539,1078,134907,24,,,,346
58a1093f894d4a3abd26bdf9faf9db2d08ac749a,1,Todd Lipcon,2013-05-20 13:21:38-07:00,['41a3cf19a7a598f7eca1bae65eab240980cdc465'],91,91,182,135089,15,,,,346
42b73faf50c2139416aafd1ab2de9f6a63d39d0e,0,Todd Lipcon,2013-05-20 13:21:38-07:00,['58a1093f894d4a3abd26bdf9faf9db2d08ac749a'],36,36,72,135161,10,,,,346
a1360e0445ed8a1d9c4a20e7f8496c7f78a37f59,0,Todd Lipcon,2013-05-20 13:21:38-07:00,['42b73faf50c2139416aafd1ab2de9f6a63d39d0e'],8,8,16,135177,8,,,,346
f7a989a57ef20bcbe741bf62d7b9de3d87709b5d,0,Todd Lipcon,2013-05-20 13:21:38-07:00,['a1360e0445ed8a1d9c4a20e7f8496c7f78a37f59'],205,205,410,135587,17,,,,346
20e2a37fcf04b014423fb72bb936f543dede06ab,0,Todd Lipcon,2013-05-20 13:21:38-07:00,['f7a989a57ef20bcbe741bf62d7b9de3d87709b5d'],26,26,52,135639,4,,,,346
3dc09387527c3b902ea609cda4f3fa74cb938849,1,Todd Lipcon,2013-05-20 13:21:38-07:00,['20e2a37fcf04b014423fb72bb936f543dede06ab'],147,147,294,135933,3,,,,346
778543798577014dd67f28df3a28480c6c2da4f6,1,Todd Lipcon,2013-05-21 16:56:10-07:00,['3dc09387527c3b902ea609cda4f3fa74cb938849'],203,340,543,136476,23,0.760869565,1,1,346
413f3fcae9944f1c238bb9f7643152966b32036e,1,Todd Lipcon,2013-05-21 17:06:34-07:00,['778543798577014dd67f28df3a28480c6c2da4f6'],41,44,85,136561,31,1,1,1,346
80d2c72b937a0b09d35f6c9ce8bfa8674f93b871,0,Todd Lipcon,2013-05-22 17:46:57-07:00,['413f3fcae9944f1c238bb9f7643152966b32036e'],47,0,47,136608,1,0,0,0,346
62c0f05deaaa6ad5b177a51ecab83e1c2a8b9d39,0,Todd Lipcon,2013-05-22 17:55:18-07:00,['80d2c72b937a0b09d35f6c9ce8bfa8674f93b871'],25,25,50,136658,9,,,,346
1447f8569bbbec834ddb2e802c2ec4e3a8cb5ecb,1,Todd Lipcon,2013-05-24 13:04:33-07:00,['62c0f05deaaa6ad5b177a51ecab83e1c2a8b9d39'],222,301,523,137181,11,0,0,0,348
bf8e06fc2e562f662e2ef1eb3a285510cd27fd9f,0,Todd Lipcon,2013-05-24 13:04:33-07:00,['1447f8569bbbec834ddb2e802c2ec4e3a8cb5ecb'],79,14,93,137274,2,0,0,0,348
26339b6372a98de1138e1b7a6aa37823856c3b7b,1,Todd Lipcon,2013-05-24 13:13:57-07:00,['bf8e06fc2e562f662e2ef1eb3a285510cd27fd9f'],168,179,347,137621,5,,,,349
81ec5b5fd549c98193e44e7a4fc2ad554d076da3,0,Todd Lipcon,2013-05-24 13:18:10-07:00,['26339b6372a98de1138e1b7a6aa37823856c3b7b'],40,40,80,137701,10,,,,349
598a9ada80ea101849052aa7faec282891bee998,0,Todd Lipcon,2013-05-24 18:02:44-07:00,['81ec5b5fd549c98193e44e7a4fc2ad554d076da3'],111,116,227,137928,2,,,,349
03a4ceb02d807527576c9bdaaff8236ad5898443,0,Todd Lipcon,2013-05-24 18:06:35-07:00,['598a9ada80ea101849052aa7faec282891bee998'],2,4,6,137934,3,,,,349
6e316532eb21df968193559cc7a48ce41df76525,0,Todd Lipcon,2013-05-25 10:59:29-07:00,['03a4ceb02d807527576c9bdaaff8236ad5898443'],18,11,29,137963,1,,,,349
60923815d11002e022efd6b42eff4524bfe6a404,1,Todd Lipcon,2013-05-28 22:39:46-07:00,['6e316532eb21df968193559cc7a48ce41df76525'],20,82,102,138065,11,1,1,1,349
58190cfec09ba25f8315513c41c7fd89c5ff5972,1,Todd Lipcon,2013-05-31 11:26:39-07:00,['60923815d11002e022efd6b42eff4524bfe6a404'],1,240,241,138306,3,0.85106383,1,1,351
535a9c876364b18d586a5f7d01defb231b012f5f,0,Todd Lipcon,2013-05-31 12:44:32-07:00,['58190cfec09ba25f8315513c41c7fd89c5ff5972'],1,1,2,138308,1,,,,351
64f9571178dbd2f6c7fa2aefbff061ba1abf9a12,0,Todd Lipcon,2013-05-31 15:48:24-07:00,['535a9c876364b18d586a5f7d01defb231b012f5f'],3,4,7,138315,1,0,1,1,351
a7ce518ecfacbef6ff0a2e35f3b57860331f5b04,0,Todd Lipcon,2013-05-31 15:48:24-07:00,['64f9571178dbd2f6c7fa2aefbff061ba1abf9a12'],86,69,155,138470,3,1,0.043478261,0,351
59f49fc86d4d83336f3082dcf983c5d2499ea915,1,Todd Lipcon,2013-05-31 15:48:24-07:00,['a7ce518ecfacbef6ff0a2e35f3b57860331f5b04'],26,25,51,138521,2,,,,351
91aef5a1ba0fc81f8256a26b1fe500c84f1c3855,0,Todd Lipcon,2013-05-31 16:43:22-07:00,['59f49fc86d4d83336f3082dcf983c5d2499ea915'],5,38,43,138564,5,0,0,1,351
ef737d7cd6b1e60ad31fcb1a9e837bc3efa2324d,0,Todd Lipcon,2013-05-31 16:55:42-07:00,['91aef5a1ba0fc81f8256a26b1fe500c84f1c3855'],0,0,0,138564,1,,,,351
4816027a593eab7b337c77679071efab14be3820,0,Todd Lipcon,2013-06-01 13:43:38-07:00,['ef737d7cd6b1e60ad31fcb1a9e837bc3efa2324d'],56,38,94,138658,13,0,0.111111111,1,351
c748c8c30702ec6ee97d08f91217a07f7ac8ec8d,0,Todd Lipcon,2013-06-01 15:24:33-07:00,['4816027a593eab7b337c77679071efab14be3820'],0,357,357,139015,4,0.119341564,0.283950617,0.654320988,352
7940e99d6eeb16f6c9f9792d801bd5193918f4e3,0,Todd Lipcon,2013-06-01 16:29:53-07:00,['c748c8c30702ec6ee97d08f91217a07f7ac8ec8d'],173,132,305,139320,4,1,0,0,352
5eb8fc4c7f8222fa2555ef71417578a4e321087c,0,Todd Lipcon,2013-06-01 16:29:53-07:00,['7940e99d6eeb16f6c9f9792d801bd5193918f4e3'],53,35,88,139408,9,1,0.133333333,1,352
4c80183a41455fbeab03848dc3358a423b544bae,1,Todd Lipcon,2013-06-03 10:58:49-07:00,['5eb8fc4c7f8222fa2555ef71417578a4e321087c'],11,59,70,139478,6,0.911764706,0.088235294,1,352
0fa290724bf7dbef189a3af2cba382642c803a2e,0,Todd Lipcon,2013-06-03 11:47:06-07:00,['4c80183a41455fbeab03848dc3358a423b544bae'],0,1004,1004,140482,5,0.321167883,0.700729927,0.959854015,356
c20c4e944fc1604596832d96bfe673c8d1490900,0,Todd Lipcon,2013-06-03 11:50:36-07:00,['0fa290724bf7dbef189a3af2cba382642c803a2e'],5,10,15,140497,1,0,0,1,356
9f2ad77e09df172166428985f2a3757b839d95ad,1,Todd Lipcon,2013-06-06 13:31:11-07:00,['c20c4e944fc1604596832d96bfe673c8d1490900'],9,229,238,140735,8,0.54,0.96,0.52,358
124fea957091dabf0047e98b87973e22327f781d,1,Todd Lipcon,2013-06-06 18:51:16-07:00,['9f2ad77e09df172166428985f2a3757b839d95ad'],35,233,268,141003,10,0.452380952,0.738095238,0.96031746,358
26985c7768c2de91d2103f4385ba721683b068aa,0,Todd Lipcon,2013-06-06 18:51:16-07:00,['124fea957091dabf0047e98b87973e22327f781d'],25,24,49,141052,14,,,,358
3168108c16e6989cb241be4a4e75ce08c72a6697,1,Todd Lipcon,2013-06-06 18:51:38-07:00,['26985c7768c2de91d2103f4385ba721683b068aa'],34,255,289,141341,7,0.43697479,0.68907563,0.638655462,358
54e280f9bb7c85a38c74b886c3e49ed71d5ce8ce,1,Todd Lipcon,2013-06-06 18:51:38-07:00,['3168108c16e6989cb241be4a4e75ce08c72a6697'],24,253,277,141618,16,0.333333333,1,0.869918699,358
d76535b030c1858e0a663fee3babbe06d41494cd,1,Todd Lipcon,2013-06-06 18:51:38-07:00,['54e280f9bb7c85a38c74b886c3e49ed71d5ce8ce'],58,239,297,141915,15,0.683168317,1,0.534653465,358
b710cdec78d4f84da9283faa313675999c715cbc,1,Todd Lipcon,2013-06-06 18:51:38-07:00,['d76535b030c1858e0a663fee3babbe06d41494cd'],24,205,229,142144,5,0.106382979,0.191489362,0.755319149,358
b4ea63b54756455b25e6e52f6f26dd884db146d3,0,Todd Lipcon,2013-06-06 18:51:38-07:00,['b710cdec78d4f84da9283faa313675999c715cbc'],4,19,23,142167,3,0,1,0.666666667,358
11eac8ec437487c325549641ea842b1cff825352,0,Todd Lipcon,2013-06-06 18:51:38-07:00,['b4ea63b54756455b25e6e52f6f26dd884db146d3'],29,94,123,142290,6,0.068181818,0.840909091,0,358
d94f40242b09372adfc8ee83eae325ce11fd8df0,1,Todd Lipcon,2013-06-06 18:51:38-07:00,['11eac8ec437487c325549641ea842b1cff825352'],14,84,98,142388,4,0.511627907,0.976744186,0.930232558,358
e161aad6ebd6fa53a14108137b4a4d70c52bad31,0,Todd Lipcon,2013-06-06 18:51:38-07:00,['d94f40242b09372adfc8ee83eae325ce11fd8df0'],4,2,6,142394,1,,,,358
0d3d70ca84c68affc09ffe13235e9135997d17cb,1,Todd Lipcon,2013-06-07 16:10:30-07:00,['9f2ad77e09df172166428985f2a3757b839d95ad'],304,1235,1539,143933,44,0.582945736,0.565891473,0.744186047,358
4b4fcd148683df2c57c7b5adae35cb67a78bd99f,0,Todd Lipcon,2013-06-07 17:50:24-07:00,"['e161aad6ebd6fa53a14108137b4a4d70c52bad31', '0d3d70ca84c68affc09ffe13235e9135997d17cb']",309,1237,1546,145479,44,,,,358
fe829b0427dd0ce94b8e08ca90889da2245af65e,0,Todd Lipcon,2013-06-07 18:18:04-07:00,['0d3d70ca84c68affc09ffe13235e9135997d17cb'],1,1,2,145481,1,,,,358
f83e8731a8d575b7ecd228ea453084442f9e3c44,0,Todd Lipcon,2013-06-10 19:19:28-07:00,['fe829b0427dd0ce94b8e08ca90889da2245af65e'],1,1,2,145483,1,,,,358
6e7be7e6034963c1a3b9cedc436876822c51eb99,0,Todd Lipcon,2013-06-10 19:21:20-07:00,['f83e8731a8d575b7ecd228ea453084442f9e3c44'],4,15,19,145502,3,0.666666667,1,0.666666667,358
3ffbca039a28ad134fe82f71b6d462ff7f6a420f,0,Todd Lipcon,2013-06-10 19:22:19-07:00,"['6e7be7e6034963c1a3b9cedc436876822c51eb99', '4b4fcd148683df2c57c7b5adae35cb67a78bd99f']",200,1354,1554,147056,38,,,,358
52a138cfee54455401bbad20b3929fd2823fa36f,0,Todd Lipcon,2013-06-12 10:28:56-07:00,['3ffbca039a28ad134fe82f71b6d462ff7f6a420f'],0,2,2,147058,1,,,,358
e5354013708338cb53431f2df8c756190b81fb1a,0,Todd Lipcon,2013-06-12 11:44:56-07:00,['52a138cfee54455401bbad20b3929fd2823fa36f'],27,27,54,147112,3,,,,358
bb5e454a6b218d0c6146c854e3899e71489b626a,0,Todd Lipcon,2013-06-12 11:44:56-07:00,['e5354013708338cb53431f2df8c756190b81fb1a'],1,1,2,147114,1,,,,358
727dd77deb5a93ed800407be28a7ce87c9f42d21,0,Todd Lipcon,2013-06-17 23:25:39-07:00,['bb5e454a6b218d0c6146c854e3899e71489b626a'],7,9,16,147130,2,,0,,358
076d8fd1745f39e3ff39446fd1a43bed5f86d0a0,0,Todd Lipcon,2013-06-17 23:25:39-07:00,['727dd77deb5a93ed800407be28a7ce87c9f42d21'],0,586,586,147716,5,0.593023256,0.755813953,0.69379845,361
0dcfe6e3fdb935d0eb36ca27b6ac618a782f095f,1,Todd Lipcon,2013-06-19 14:34:14-07:00,['076d8fd1745f39e3ff39446fd1a43bed5f86d0a0'],784,1159,1943,149659,26,0.300380228,0.711026616,1,362
9ced2108a065a99135a19272272b214db9088a74,0,David Alves,2013-06-19 16:52:34-07:00,['0dcfe6e3fdb935d0eb36ca27b6ac618a782f095f'],4,3,7,149666,1,,,,362
94b68e46a52e2d3eb54dda25f7b08d5aef603f40,0,Todd Lipcon,2013-06-25 13:54:43-07:00,['9ced2108a065a99135a19272272b214db9088a74'],0,1,1,149667,1,,,,362
3b598ab899a3c70ec1451bae3c2991ed01e17fce,0,Todd Lipcon,2013-06-25 15:01:34-07:00,['94b68e46a52e2d3eb54dda25f7b08d5aef603f40'],0,2,2,149669,1,,,,362
cbcd2a346831297157855a37a5dc39e34d236d18,0,Todd Lipcon,2013-06-25 15:09:52-07:00,['3b598ab899a3c70ec1451bae3c2991ed01e17fce'],0,1,1,149670,1,,,,362
e68612a1cb12188e1c41de8e228d4f56fd9483f6,0,Todd Lipcon,2013-06-25 15:12:10-07:00,['cbcd2a346831297157855a37a5dc39e34d236d18'],0,115,115,149785,4,0.588235294,1,1,365
ce3c8d2bc77ac6cbe3f07ad18b459c9275a69c82,0,Todd Lipcon,2013-06-25 15:16:14-07:00,['e68612a1cb12188e1c41de8e228d4f56fd9483f6'],0,61,61,149846,4,,,,366
c8d69d50b3564aa63c68faff60a544e097f98714,0,Todd Lipcon,2013-06-25 17:02:13-07:00,['ce3c8d2bc77ac6cbe3f07ad18b459c9275a69c82'],3,8,11,149857,1,1,1,1,366
91bf6e8bfa60a9ba932dfe2431977418db3c4fd3,0,Todd Lipcon,2013-06-25 17:03:27-07:00,['c8d69d50b3564aa63c68faff60a544e097f98714'],0,4,4,149861,1,1,1,1,366
920c807d1a75b90d7153e24220fac68cc26bda19,0,Todd Lipcon,2013-06-26 22:11:18-07:00,['91bf6e8bfa60a9ba932dfe2431977418db3c4fd3'],6,27,33,149894,1,1,1,1,366
0977c158782ca33c12b0474968acf861a3a9bf99,0,Todd Lipcon,2013-06-27 10:59:30-07:00,['920c807d1a75b90d7153e24220fac68cc26bda19'],0,249,249,150143,4,0.872,1,1,369
885eeac82ac3c35a6c454af095f23e5fe6e97ca7,1,David Alves,2013-06-27 11:45:13-07:00,['9ced2108a065a99135a19272272b214db9088a74'],92,474,566,150709,22,0.502183406,0.506550218,0.925764192,370
cf9bd99ef642b1a97c1e5d6e4fd74068e7afc899,1,Todd Lipcon,2013-06-28 11:48:24-07:00,['0977c158782ca33c12b0474968acf861a3a9bf99'],0,4648,4648,155357,35,0.592552617,0.905018888,0.890987588,404
84435081d23bb9800d1f0ff5d3abd252c13561e8,0,Todd Lipcon,2013-06-28 12:01:10-07:00,['cf9bd99ef642b1a97c1e5d6e4fd74068e7afc899'],10,32,42,155399,4,0,1,0.5,404
a61113053913aba63cea5562dce80f7fa3a6c1bf,0,Todd Lipcon,2013-06-30 22:14:19-07:00,['84435081d23bb9800d1f0ff5d3abd252c13561e8'],1,1,2,155401,1,,,,404
952960bf70ec298788237ebacaeab2eff01e7444,0,Matteo Bertozzi,2013-07-01 08:01:00+01:00,['885eeac82ac3c35a6c454af095f23e5fe6e97ca7'],3,3,6,155407,1,,,,404
51e5253925fc185d7e2abbe11c8f604dcf68153a,0,Todd Lipcon,2013-07-01 11:30:33-07:00,['a61113053913aba63cea5562dce80f7fa3a6c1bf'],6,16,22,155429,2,1,1,1,404
4cdf9cbfd6b60bd8bfcbea92199c92e7c6d3e5a8,0,David Alves,2013-07-01 13:44:39-07:00,['952960bf70ec298788237ebacaeab2eff01e7444'],7,13,20,155449,4,0.666666667,1,0.5,404
e2ddd81fef6b85ecbcfff127e67f29e0293243d7,1,Todd Lipcon,2013-07-01 15:19:19-07:00,['51e5253925fc185d7e2abbe11c8f604dcf68153a'],9,866,875,156324,10,0.431330472,1,0.409871245,407
aebc7847149d418a5b1736e8c96408469b0f219a,1,Todd Lipcon,2013-07-01 15:19:25-07:00,['e2ddd81fef6b85ecbcfff127e67f29e0293243d7'],0,117,117,156441,2,0.490909091,1,1,408
30cc403bd1f743ab5ada4a3b43b4aeb07bed0b89,0,Todd Lipcon,2013-07-01 15:19:33-07:00,['aebc7847149d418a5b1736e8c96408469b0f219a'],0,64,64,156505,3,0.181818182,1,0.818181818,408
df68d15f56dd141a6285ebbdf0ba7893e98d9a22,0,Todd Lipcon,2013-07-01 15:22:54-07:00,"['4cdf9cbfd6b60bd8bfcbea92199c92e7c6d3e5a8', '30cc403bd1f743ab5ada4a3b43b4aeb07bed0b89']",9,6186,6195,162700,56,,,,408
15b187c71f30f74da4100e8472a9ca06c0b1fed8,1,Todd Lipcon,2013-07-02 13:11:11-07:00,['df68d15f56dd141a6285ebbdf0ba7893e98d9a22'],87,192,279,162979,34,1,1,1,408
ff2ffd62b5ee0a8f0e96a7612140382fab32914e,0,Todd Lipcon,2013-07-02 14:37:03-07:00,['15b187c71f30f74da4100e8472a9ca06c0b1fed8'],1,1,2,162981,1,,,,408
c9265a6dc5ec931fcf21ab703d88cb035a1ff254,1,jdcryans,2013-07-02 16:32:38-07:00,['ff2ffd62b5ee0a8f0e96a7612140382fab32914e'],0,330,330,163311,3,0.264705882,0.535294118,0.982352941,410
ab1737a4495964cd4389b725a423671ec9953015,0,Todd Lipcon,2013-07-02 19:57:46-07:00,['c9265a6dc5ec931fcf21ab703d88cb035a1ff254'],0,39,39,163350,2,,,,411
6035131b76887b778e7a60ec9490444fd178ff97,0,Todd Lipcon,2013-07-02 22:12:42-07:00,['ab1737a4495964cd4389b725a423671ec9953015'],2,27,29,163379,2,1,1,1,411
99f692e5e3b803add6b14df0a9486dcf73b16714,1,Todd Lipcon,2013-07-03 17:41:59-07:00,['6035131b76887b778e7a60ec9490444fd178ff97'],25,11,36,163415,4,0.125,0,0,411
0b2eaad6860415e342b0fcbf1882e28b67f995d3,1,Todd Lipcon,2013-07-08 23:36:57-07:00,['99f692e5e3b803add6b14df0a9486dcf73b16714'],1181,1175,2356,165771,169,0.263736264,0.054945055,0.32967033,411
3e56cf02f633e55c8bfb1392f014d76ff331ee22,0,Todd Lipcon,2013-07-09 11:16:34-07:00,['0b2eaad6860415e342b0fcbf1882e28b67f995d3'],5,5,10,165781,2,,,,411
d53cb36698ea16bb9c0100bf79c53a77dd52e985,1,Todd Lipcon,2013-07-09 16:29:46-07:00,['3e56cf02f633e55c8bfb1392f014d76ff331ee22'],117,548,665,166446,23,0.580357143,0.973214286,1,414
2b11231d9ccf58c31878fc2d39286f731578f397,1,Todd Lipcon,2013-07-09 22:50:22-07:00,['d53cb36698ea16bb9c0100bf79c53a77dd52e985'],390,1074,1464,167910,25,1,1,0.740061162,417
fb2c19338b47e2d07d2c09edf520c96e9ceae631,0,Todd Lipcon,2013-07-09 23:12:59-07:00,['2b11231d9ccf58c31878fc2d39286f731578f397'],1,188,189,168099,2,0.564102564,1,1,417
4426106cc4ea2c98202864637bdc5f046f89885e,0,Todd Lipcon,2013-07-09 23:29:16-07:00,['fb2c19338b47e2d07d2c09edf520c96e9ceae631'],1,19,20,168119,2,0,1,0.9,417
c86bf243dec9371f04386d702ac6a4e199fed61c,1,Todd Lipcon,2013-07-10 00:13:39-07:00,['2b11231d9ccf58c31878fc2d39286f731578f397'],39,239,278,168397,10,0.861386139,1,0.861386139,417
4b8d87b643d8ed5d2a1746453475ab487f4b8616,1,Todd Lipcon,2013-07-10 00:49:22-07:00,['c86bf243dec9371f04386d702ac6a4e199fed61c'],98,202,300,168697,10,0.4375,0,0.609375,417
d8a7ad5cf9dcde4bd7b3a15fdeb2815637414f38,0,Todd Lipcon,2013-07-10 16:03:29-07:00,['4426106cc4ea2c98202864637bdc5f046f89885e'],3,36,39,168736,5,1,1,0.666666667,417
e7a0010db171f581b17cf3bbc78eab11152ea7f1,1,Todd Lipcon,2013-07-11 10:20:47-07:00,['d8a7ad5cf9dcde4bd7b3a15fdeb2815637414f38'],6,733,739,169475,7,0.725988701,1,0.576271186,423
ff4577324c3b0f78e0dfedf53488fb74a270c8a9,0,Eli Collins,2013-07-11 18:12:06-07:00,['e7a0010db171f581b17cf3bbc78eab11152ea7f1'],0,4,4,169479,1,,,,423
cd9aadbc1c8845b0663b22d3896d24d1d19d3bc5,0,Todd Lipcon,2013-07-11 23:32:25-07:00,['4b8d87b643d8ed5d2a1746453475ab487f4b8616'],36,116,152,169631,5,1,1,1,425
76b4d69b39efb3c48563fb658a2df2937408a1ac,0,Todd Lipcon,2013-07-11 23:34:04-07:00,['ff4577324c3b0f78e0dfedf53488fb74a270c8a9'],15,41,56,169687,1,,,,425
bde4fdc442bd1de6b4979154a88ef4d7d8baf94e,0,Todd Lipcon,2013-07-11 23:38:12-07:00,['76b4d69b39efb3c48563fb658a2df2937408a1ac'],9,48,57,169744,4,1,0,0,425
5e9d306fa2285a448f695d54e411e165264afc6c,1,Todd Lipcon,2013-07-16 21:26:28-07:00,['bde4fdc442bd1de6b4979154a88ef4d7d8baf94e'],228,283,511,170255,23,0.25,0.925,1,425
b28b6c1ff04b187a9d94ffb6fab36a7695f7267a,0,Todd Lipcon,2013-07-16 22:20:58-07:00,['cd9aadbc1c8845b0663b22d3896d24d1d19d3bc5'],0,350,350,170605,2,,,,426
7515e2a1142d3f8b52358544f6a31b16c5ddcb81,0,Todd Lipcon,2013-07-22 11:19:58-07:00,['5e9d306fa2285a448f695d54e411e165264afc6c'],31,42,73,170678,4,0,0,0,426
923fe0298edfca29800f187ce754f415eb501995,0,Todd Lipcon,2013-07-22 12:21:15-07:00,['7515e2a1142d3f8b52358544f6a31b16c5ddcb81'],1,1,2,170680,1,,,,426
ed35c732fcc5ab31f894735d00b2479650972154,1,Michael Percy,2013-07-22 15:09:59-07:00,['923fe0298edfca29800f187ce754f415eb501995'],125,208,333,171013,7,0.35483871,0.35483871,0.951612903,426
684428242efb3d62fb60283bfd50a95da0e8f69e,1,Alex Feinberg,2013-07-22 15:47:27-07:00,['ed35c732fcc5ab31f894735d00b2479650972154'],69,435,504,171517,15,0.400943396,0.731132075,0.816037736,426
ccc054b6d387af8838a761aa42ae4075544475f8,1,Todd Lipcon,2013-07-22 17:49:46-07:00,['b28b6c1ff04b187a9d94ffb6fab36a7695f7267a'],0,442,442,171959,7,0.297777778,0.777777778,0.631111111,429
ac49ce9e76451c1a12687d49ae13c04480f128ea,0,Todd Lipcon,2013-07-23 17:43:17-07:00,['684428242efb3d62fb60283bfd50a95da0e8f69e'],51,26,77,172036,3,1,1,1,429
70886428b50be82410c022b2d81c3c4d5e5aa828,1,Todd Lipcon,2013-07-23 17:55:43-07:00,"['ccc054b6d387af8838a761aa42ae4075544475f8', 'ac49ce9e76451c1a12687d49ae13c04480f128ea']",537,2061,2598,174634,64,,,,429
147104a64954cedb8552e6f9aded6985cf0f9301,0,Todd Lipcon,2013-07-24 09:20:24-07:00,['70886428b50be82410c022b2d81c3c4d5e5aa828'],1,1,2,174636,1,,,,429
a9b813275191b8df1e5fb5ca19917ae5b18964d7,0,Todd Lipcon,2013-07-24 10:13:25-07:00,['ac49ce9e76451c1a12687d49ae13c04480f128ea'],1,1,2,174638,1,,,,429
c327bd3d7f1cdcf17bc852c1acc4df536558fd07,0,Alex Feinberg,2013-07-24 12:57:33-07:00,['a9b813275191b8df1e5fb5ca19917ae5b18964d7'],56,112,168,174806,6,1,1,0.941176471,430
0f1f4e9f747def0f8d0bcfc128b579a2e5af2801,0,Todd Lipcon,2013-07-24 13:21:56-07:00,['147104a64954cedb8552e6f9aded6985cf0f9301'],4,8,12,174818,2,1,1,1,430
b0fee54a3ba8d4a762ace50173b82a481e5e8ee3,0,Todd Lipcon,2013-07-24 16:43:39-07:00,['c327bd3d7f1cdcf17bc852c1acc4df536558fd07'],23,122,145,174963,1,0.732142857,0.339285714,0.982142857,430
2cb312e925538433089d38eb1b0b8bf9f662e36c,0,Todd Lipcon,2013-07-25 08:51:40-07:00,['b0fee54a3ba8d4a762ace50173b82a481e5e8ee3'],26,110,136,175099,1,0.422222222,0.022222222,1,430
b6e36b2e4d4eb3208e01b18955255e081b7bcfc4,0,Todd Lipcon,2013-07-25 13:40:32-07:00,['2cb312e925538433089d38eb1b0b8bf9f662e36c'],3,18,21,175120,3,,,,431
08e1788520e4586bd242b4180788ce6fa8762868,0,Todd Lipcon,2013-07-29 13:57:58-07:00,['b6e36b2e4d4eb3208e01b18955255e081b7bcfc4'],55,100,155,175275,2,0,1,0.583333333,431
c698aa915c6c1b0477c428e89eb18acd439d0b72,0,Todd Lipcon,2013-07-29 18:57:47-07:00,"['0f1f4e9f747def0f8d0bcfc128b579a2e5af2801', '08e1788520e4586bd242b4180788ce6fa8762868']",164,463,627,175902,14,,,,431
62075b9379af7b66bb757ce69d55b654efc01a13,0,Todd Lipcon,2013-07-30 22:03:48-07:00,['08e1788520e4586bd242b4180788ce6fa8762868'],0,3,3,175905,1,1,1,1,431
c6ab43e98020f91493b45447093b7159dd03273f,0,Todd Lipcon,2013-07-31 14:28:25-07:00,['62075b9379af7b66bb757ce69d55b654efc01a13'],14,45,59,175964,3,,,,432
a9cd4557f7ee221b15ae405a2a568656c335e2b3,0,Todd Lipcon,2013-07-31 14:40:46-07:00,['c6ab43e98020f91493b45447093b7159dd03273f'],0,58,58,176022,1,,,,433
112fcb99a47d9924407f521deabdc4865f1ea97b,0,Todd Lipcon,2013-07-31 15:36:07-07:00,['a9cd4557f7ee221b15ae405a2a568656c335e2b3'],1,1,2,176024,1,,,,433
228615f8f84b36cf0bf56e8a8fb5e945a159bf07,0,Todd Lipcon,2013-07-31 15:41:36-07:00,['c698aa915c6c1b0477c428e89eb18acd439d0b72'],21,65,86,176110,4,0,1,1,433
9d3fcdaed2acc052139af2b126286528aa5c7fbf,0,Matteo Bertozzi,2013-08-01 00:26:14-07:00,['112fcb99a47d9924407f521deabdc4865f1ea97b'],13,19,32,176142,3,1,1,1,433
d7f6113597b559194e7dd4059f063687bbf42dd2,1,Todd Lipcon,2013-08-01 01:48:34-07:00,['228615f8f84b36cf0bf56e8a8fb5e945a159bf07'],69,396,465,176607,4,0.41025641,1,1,434
836e5dd502c40f2951d45908f45847dcec2a7375,0,Todd Lipcon,2013-08-01 01:52:32-07:00,"['d7f6113597b559194e7dd4059f063687bbf42dd2', '9d3fcdaed2acc052139af2b126286528aa5c7fbf']",27,125,152,176759,8,,,,434
55ebd80e5a67abd2d944d5fb87eba7846af7583a,1,Todd Lipcon,2013-08-01 07:52:02-07:00,['836e5dd502c40f2951d45908f45847dcec2a7375'],2,198,200,176959,3,0.407407407,0.407407407,0.916666667,434
8d93e1ebd6055db7147f2cb7747563e708b26525,1,Todd Lipcon,2013-08-01 11:12:59-07:00,['9d3fcdaed2acc052139af2b126286528aa5c7fbf'],640,1161,1801,178760,40,0.6,1,1,439
9e73ce9a7e9bf4ba8d16cd9dd77c20031293bddf,0,Todd Lipcon,2013-08-01 13:11:50-07:00,['8d93e1ebd6055db7147f2cb7747563e708b26525'],6,7,13,178773,1,0,1,1,439
a31861563c0b3d2d26be6b661e342175e1571651,0,Matteo Bertozzi,2013-08-01 15:23:25-07:00,['9e73ce9a7e9bf4ba8d16cd9dd77c20031293bddf'],2,5,7,178780,1,1,1,1,439
8323bb81488c309778701d0b3dc6fddb04205127,0,Matteo Bertozzi,2013-08-01 15:23:38-07:00,['a31861563c0b3d2d26be6b661e342175e1571651'],4,2,6,178786,1,0,0,0,439
c8274741072542b8cd3779b674d46b70c3255603,0,Michael Percy,2013-08-02 15:50:15-07:00,['8323bb81488c309778701d0b3dc6fddb04205127'],40,1,41,178827,3,,,,439
caba6f30566f2ab033d311cb475d3652679af6b9,1,Todd Lipcon,2013-08-02 16:09:15-07:00,"['55ebd80e5a67abd2d944d5fb87eba7846af7583a', '8d93e1ebd6055db7147f2cb7747563e708b26525']",665,1191,1856,180683,40,,,,439
cec8dfdf8b5c5a1ada8edd5d2231afef1e8dd1d3,0,Todd Lipcon,2013-08-02 18:12:15-07:00,['c8274741072542b8cd3779b674d46b70c3255603'],0,7,7,180690,1,,,,439
f86a820763fc64e7ee55492077b02d97bb649fd2,0,Todd Lipcon,2013-08-02 19:14:58-07:00,['cec8dfdf8b5c5a1ada8edd5d2231afef1e8dd1d3'],1,40,41,180731,3,,,,440
c4bb69cc59e71cf19b7c6e7f9d8cc04b3b99d0fc,0,Todd Lipcon,2013-08-03 10:33:38-07:00,['f86a820763fc64e7ee55492077b02d97bb649fd2'],164,247,411,181142,4,0,1,1,442
c153e2cc28dd41122453a9dfe165a72948aafbcd,0,Todd Lipcon,2013-08-04 11:37:49-07:00,['c4bb69cc59e71cf19b7c6e7f9d8cc04b3b99d0fc'],0,292,292,181434,4,0.679389313,0.809160305,1,445
27091285162a4aeddc02b2a493589525ae251666,0,Todd Lipcon,2013-08-04 14:23:34-07:00,['c153e2cc28dd41122453a9dfe165a72948aafbcd'],38,96,134,181568,4,,,,446
5dd3255fa2975fa49bd07249ed881514982ab751,0,Todd Lipcon,2013-08-05 13:13:49-07:00,"['caba6f30566f2ab033d311cb475d3652679af6b9', '27091285162a4aeddc02b2a493589525ae251666']",214,656,870,182438,15,,,,446
8c2fd202399b47bb0b83f33797558157436a4678,1,Todd Lipcon,2013-08-05 15:10:40-07:00,['5dd3255fa2975fa49bd07249ed881514982ab751'],27,57,84,182522,6,0,1,1,446
e10695219f9111a41d809dd94a43fb799e2fcc73,0,Todd Lipcon,2013-08-06 09:11:37-07:00,['8c2fd202399b47bb0b83f33797558157436a4678'],2,2,4,182526,1,,,,446
46e92b26eb79f67d89e68abbc5190da12f9b74a5,0,Todd Lipcon,2013-08-06 09:52:58-07:00,['e10695219f9111a41d809dd94a43fb799e2fcc73'],9,413,422,182948,11,0.155405405,0.27027027,0.641891892,450
cde55224525b326785d72a665009fc75ad471533,1,Todd Lipcon,2013-08-06 15:48:14-07:00,['46e92b26eb79f67d89e68abbc5190da12f9b74a5'],46,43,89,183037,23,,,,450
5b628ee0bbd9732f2807d6dea8078d285817d3cc,0,Todd Lipcon,2013-08-07 09:50:27-07:00,['cde55224525b326785d72a665009fc75ad471533'],1,0,1,183038,1,0,0,0,450
9b889e674f79aca32cb5250f420428efe861e4b3,0,Todd Lipcon,2013-08-07 09:50:57-07:00,['5b628ee0bbd9732f2807d6dea8078d285817d3cc'],0,11,11,183049,1,,,,450
09f1df4a4689697d89ec2953423b6824dc113a49,0,Todd Lipcon,2013-08-07 10:03:17-07:00,['9b889e674f79aca32cb5250f420428efe861e4b3'],1,1,2,183051,1,,,,450
84a514fc0970a479a049cc225174148ed1d56112,0,Todd Lipcon,2013-08-07 10:10:34-07:00,['09f1df4a4689697d89ec2953423b6824dc113a49'],1,1,2,183053,1,,,,450
ba6f2669e7f60f9ffd84bffefa4c3bec8cdbf7a6,0,Todd Lipcon,2013-08-07 11:45:50-07:00,['84a514fc0970a479a049cc225174148ed1d56112'],0,7,7,183060,1,,,,450
1c51efd48dbe0f73e4c8b2afa96686f7dab861e4,0,Todd Lipcon,2013-08-07 11:57:47-07:00,['ba6f2669e7f60f9ffd84bffefa4c3bec8cdbf7a6'],44,89,133,183193,1,,,,450
5b6b2d7746b5be21813e50c04edbf972474c209b,0,Todd Lipcon,2013-08-07 14:59:30-07:00,['1c51efd48dbe0f73e4c8b2afa96686f7dab861e4'],0,504,504,183697,10,0.651960784,1,0.970588235,459
ec2af0d81993bb7f881b1f4307edfa91e3c69da1,0,Todd Lipcon,2013-08-07 15:33:55-07:00,['5b6b2d7746b5be21813e50c04edbf972474c209b'],0,10,10,183707,2,,,,459
ae198024debffca4def83e00e69a2f474bca0926,1,Todd Lipcon,2013-08-07 16:54:15-07:00,['ec2af0d81993bb7f881b1f4307edfa91e3c69da1'],68,74,142,183849,33,1,0,1,459
5761ad341f67ce094a0bc497243d7f168e869e28,0,Todd Lipcon,2013-08-07 23:34:23-07:00,['ae198024debffca4def83e00e69a2f474bca0926'],0,69,69,183918,3,1,0.666666667,0.333333333,461
c3c889f8c07d3fbe6bdfabcd8e3a604d23674109,1,Todd Lipcon,2013-08-07 23:40:54-07:00,['5761ad341f67ce094a0bc497243d7f168e869e28'],185,265,450,184368,11,1,1,0,464
87b4fefba6807d5cd5ac71aa1283cdee3903963c,0,Todd Lipcon,2013-08-07 23:51:48-07:00,['c3c889f8c07d3fbe6bdfabcd8e3a604d23674109'],74,182,256,184624,4,0.586206897,1,1,465
99b695b1aa28c6904b1aa07a6acef8cab89b20d5,0,Todd Lipcon,2013-08-08 00:20:41-07:00,['87b4fefba6807d5cd5ac71aa1283cdee3903963c'],0,274,274,184898,6,0.639344262,1,0.836065574,468
547fdc758fc67a8920490ea00e2d5910db59d831,0,Todd Lipcon,2013-08-08 07:31:34-07:00,['99b695b1aa28c6904b1aa07a6acef8cab89b20d5'],15,23,38,184936,2,1,1,0,468
f2139fc1ea594ccad2863c3f0c8cc9d5384a1910,0,Todd Lipcon,2013-08-08 11:16:18-07:00,['547fdc758fc67a8920490ea00e2d5910db59d831'],7,31,38,184974,1,1,1,0,468
51aa3776bd52c775e4ca92a60d5b3be55a94759e,1,Todd Lipcon,2013-08-08 11:16:40-07:00,['f2139fc1ea594ccad2863c3f0c8cc9d5384a1910'],91,735,826,185800,12,0.188679245,0.691823899,0.855345912,472
2a87abf48ad8a518132cfdf6487e61c9bea40112,1,Todd Lipcon,2013-08-08 12:47:01-07:00,['51aa3776bd52c775e4ca92a60d5b3be55a94759e'],1,410,411,186211,10,0.688,1,0.96,481
9f82cb03108b8a3d4be5a55a010ba8a720d454cf,1,Todd Lipcon,2013-08-08 17:17:27-07:00,['2a87abf48ad8a518132cfdf6487e61c9bea40112'],0,20,20,186231,3,,,,481
f64792900decc66ee5e6af8c0127fb83c65bfbc5,0,Todd Lipcon,2013-08-08 18:16:46-07:00,['9f82cb03108b8a3d4be5a55a010ba8a720d454cf'],1,971,972,187203,7,0.414012739,1,0.72611465,486
7b68a9a9bb4bf2254f719d3437dd04501c06d2ed,0,Todd Lipcon,2013-08-08 18:23:06-07:00,['f64792900decc66ee5e6af8c0127fb83c65bfbc5'],10,10,20,187223,1,,,,486
b2813d62f82eb2fa43bf9143b86cc00505e09f42,1,Todd Lipcon,2013-08-08 23:07:06-07:00,['7b68a9a9bb4bf2254f719d3437dd04501c06d2ed'],247,879,1126,188349,23,0.228571429,0.883116883,0.958441558,492
98326792064b581e598a2221f645790fc6dcbddc,0,Todd Lipcon,2013-08-09 01:11:55-07:00,['b2813d62f82eb2fa43bf9143b86cc00505e09f42'],0,7,7,188356,1,0,1,1,492
44dd4b35d1b7118e79b5efce6f1e8739cb3ce4a4,0,Todd Lipcon,2013-08-09 08:52:48-07:00,['98326792064b581e598a2221f645790fc6dcbddc'],0,1,1,188357,1,,,,492
5f623e0825b0ee536ce6c2342a5bc6a2344fe46d,0,Todd Lipcon,2013-08-09 08:53:22-07:00,['44dd4b35d1b7118e79b5efce6f1e8739cb3ce4a4'],1,190,191,188548,4,0.636363636,1,1,495
241accb0b6c0f0b526adb54898a10e776cc226b8,1,Todd Lipcon,2013-08-09 09:34:36-07:00,['5f623e0825b0ee536ce6c2342a5bc6a2344fe46d'],2,365,367,188915,9,0.273743017,0.675977654,0.597765363,495
3e2504c018cfff5dc5581f280f49e656c95ef94b,0,Todd Lipcon,2013-08-09 09:38:35-07:00,['241accb0b6c0f0b526adb54898a10e776cc226b8'],26,32,58,188973,1,1,0,0,495
869dcbc3bd771912f38a187ea1591ea058fde582,0,Todd Lipcon,2013-08-09 12:18:45-07:00,['3e2504c018cfff5dc5581f280f49e656c95ef94b'],16,20,36,189009,7,0.5,1,1,495
ced0dc8e820f992c7c5a88f65fc80406f4a018f5,1,Todd Lipcon,2013-08-09 12:28:57-07:00,['869dcbc3bd771912f38a187ea1591ea058fde582'],0,411,411,189420,10,0.688,1,0.96,504
eee9b64fe64e34f7e6c1843ddc29b52fe9230c1b,0,David Alves,2013-08-09 13:33:47-07:00,['ced0dc8e820f992c7c5a88f65fc80406f4a018f5'],8,535,543,189963,7,0.717073171,1,1,507
776ee68b2d2454557799dd2853cb4b38e9abcdd2,1,Todd Lipcon,2013-08-10 21:55:27-07:00,['eee9b64fe64e34f7e6c1843ddc29b52fe9230c1b'],1,33,34,189997,3,0,1,1,507
f053f56ff974dec7c247c6382d34347ad52ef7f2,0,Alex Feinberg,2013-08-11 12:26:28-07:00,['776ee68b2d2454557799dd2853cb4b38e9abcdd2'],52,66,118,190115,8,1,0,0,507
cdef689d37e48e2bb0c22be13dd5b27da3032051,0,Todd Lipcon,2013-08-11 21:31:48-07:00,['f053f56ff974dec7c247c6382d34347ad52ef7f2'],0,76,76,190191,2,0.909090909,1,1,508
7fc45d73cd8b9363ca84acd954bfee632f0a63e2,0,Todd Lipcon,2013-08-11 22:14:00-07:00,['cdef689d37e48e2bb0c22be13dd5b27da3032051'],76,0,76,190267,2,0.090909091,0,0,508
6125b660e8e9bc0e505c207fcbdebfae2300c059,0,David Alves,2013-08-12 00:44:42-07:00,['7fc45d73cd8b9363ca84acd954bfee632f0a63e2'],12,15,27,190294,2,0.666666667,0.333333333,1,508
e30cf86ff99910ff1d33aaf0464019c44a0cced1,0,Todd Lipcon,2013-08-12 10:50:04-07:00,['6125b660e8e9bc0e505c207fcbdebfae2300c059'],169,235,404,190698,10,1,1,1,508
66a758d435857be190ea4fe771a8a9c0a10e9cf1,0,Todd Lipcon,2013-08-12 10:50:09-07:00,['e30cf86ff99910ff1d33aaf0464019c44a0cced1'],33,95,128,190826,4,0.8,1,1,508
da1f095525fd803c421a0d88833432b603749dd0,0,Todd Lipcon,2013-08-12 11:30:13-07:00,['66a758d435857be190ea4fe771a8a9c0a10e9cf1'],0,29,29,190855,1,1,1,1,508
ad3074dfc0540d99e326c6d75a0f8b15f0787b88,1,Todd Lipcon,2013-08-13 10:17:04-07:00,['da1f095525fd803c421a0d88833432b603749dd0'],174,194,368,191223,13,1,0,0,510
3d71d0f8193fdc4130ade053743713e4f404e8da,0,Todd Lipcon,2013-08-13 17:06:17-07:00,['ad3074dfc0540d99e326c6d75a0f8b15f0787b88'],110,193,303,191526,3,0,0,0.981481481,510
7fc70511c70ede0ccd6369b3e932d9f33f5d1e25,0,Todd Lipcon,2013-08-13 19:55:22-07:00,['3d71d0f8193fdc4130ade053743713e4f404e8da'],54,157,211,191737,7,0.19047619,1,1,512
4a8088e4d706bbf1c2cad9b82ba56c84ef359191,0,Todd Lipcon,2013-08-14 10:13:32-07:00,['7fc70511c70ede0ccd6369b3e932d9f33f5d1e25'],0,79,79,191816,2,0.911764706,1,1,513
3cd5496710351f76a72841f7a691fb1bfd50bb9a,1,Todd Lipcon,2013-08-14 10:32:49-07:00,['4a8088e4d706bbf1c2cad9b82ba56c84ef359191'],19,154,173,191989,5,0.433333333,0.244444444,0.488888889,513
a02326927409543e6322463878016d04a33f9b59,1,Todd Lipcon,2013-08-14 10:39:25-07:00,['3cd5496710351f76a72841f7a691fb1bfd50bb9a'],10,729,739,192728,11,0.17721519,0.653164557,0.478481013,513
2d90d2b018559f786060bf5b5481e4bf96324c68,0,Todd Lipcon,2013-08-14 11:21:59-07:00,['a02326927409543e6322463878016d04a33f9b59'],5,482,487,193215,7,0.752747253,1,1,517
62bffb9d695c05a3edcdd89755f9a07d19ad206a,0,Todd Lipcon,2013-08-14 11:42:05-07:00,['2d90d2b018559f786060bf5b5481e4bf96324c68'],3,181,184,193399,5,0,0.376623377,1,519
1e0a877d3960175fb6e8215e4ff1a272055d5953,0,Todd Lipcon,2013-08-14 12:49:09-07:00,['62bffb9d695c05a3edcdd89755f9a07d19ad206a'],22,58,80,193479,4,0.210526316,1,0.894736842,519
84c492310de4791cf96a0ff6568e925b53f6b650,0,Todd Lipcon,2013-08-14 13:46:54-07:00,['1e0a877d3960175fb6e8215e4ff1a272055d5953'],9,97,106,193585,6,0.676470588,0.852941176,1,519
21a97e3bc889e23936f278a9c6b5a29cce0b00eb,0,Todd Lipcon,2013-08-14 14:26:24-07:00,['84c492310de4791cf96a0ff6568e925b53f6b650'],0,29,29,193614,1,0.842105263,1,1,519
ff4b77c36ad76a835ac191c54d4ac770596fee3b,1,Todd Lipcon,2013-08-14 16:44:12-07:00,['21a97e3bc889e23936f278a9c6b5a29cce0b00eb'],14,102,116,193730,11,0.553571429,0.910714286,0.964285714,519
5774f27158acd497158d0984de5ea479dd4d4f04,0,Todd Lipcon,2013-08-15 08:32:40-07:00,['ff4b77c36ad76a835ac191c54d4ac770596fee3b'],2,14,16,193746,2,0,1,1,519
46e8a070f1e4953d06fba2512622e29ec0ca6cc6,0,Todd Lipcon,2013-08-15 08:36:23-07:00,['5774f27158acd497158d0984de5ea479dd4d4f04'],34,63,97,193843,2,0.625,1,1,519
f3d99b4a9acc8e62ab9d9a169fa143b76fed905a,0,Todd Lipcon,2013-08-15 10:56:12-07:00,['46e8a070f1e4953d06fba2512622e29ec0ca6cc6'],7,17,24,193867,3,0.333333333,0,1,519
010df967b28b620a2df38ab44aba4c99681289ef,0,Todd Lipcon,2013-08-19 23:20:35-07:00,['f3d99b4a9acc8e62ab9d9a169fa143b76fed905a'],1,106,107,193974,6,0.634920635,1,1,519
044360fe1058386502f9f1e9803736d9fcd64cba,1,Todd Lipcon,2013-08-20 09:10:49-07:00,['010df967b28b620a2df38ab44aba4c99681289ef'],63,72,135,194109,13,0.142857143,1,1,519
a268c03002d69cdd2cf650dcef41b177042762e6,1,Todd Lipcon,2013-08-20 16:39:12-07:00,['044360fe1058386502f9f1e9803736d9fcd64cba'],203,586,789,194898,12,0.161764706,0.81372549,0.916666667,522
4e25a8b805e421c0ad10d1e53a099cebb6409eaf,0,Todd Lipcon,2013-08-21 10:17:56-07:00,['a268c03002d69cdd2cf650dcef41b177042762e6'],0,1,1,194899,1,,,,522
c8f7b8d44a378a7a29603c4332554268e5e165ca,1,Todd Lipcon,2013-08-21 10:54:23-07:00,['4e25a8b805e421c0ad10d1e53a099cebb6409eaf'],193,979,1172,196071,34,0.617067834,0.868708972,0.382932166,524
da9646ecadce0ed5f0b9995c681fb499f6c3603b,1,Todd Lipcon,2013-08-21 14:48:56-07:00,['c8f7b8d44a378a7a29603c4332554268e5e165ca'],6,149,155,196226,2,0.23,0.46,0.46,524
7844869b01d7b4388bec95a17e6d733acf04d645,1,Todd Lipcon,2013-08-21 16:27:28-07:00,['da9646ecadce0ed5f0b9995c681fb499f6c3603b'],10,36,46,196272,4,0,1,1,524
c29748136d67762ea5a0da5d73803b55cbec6c9c,0,Todd Lipcon,2013-08-22 10:04:04-07:00,['7844869b01d7b4388bec95a17e6d733acf04d645'],13,21,34,196306,1,,,,524
f37cc30175fc73e1c9e08df617b908db0317b6bf,0,Todd Lipcon,2013-08-22 10:09:50-07:00,['c29748136d67762ea5a0da5d73803b55cbec6c9c'],2,0,2,196308,1,1,1,0,524
c7c46378b28ec6216cf7566de48eb1686a525319,0,Todd Lipcon,2013-08-22 14:52:36-07:00,['f37cc30175fc73e1c9e08df617b908db0317b6bf'],33,243,276,196584,13,1,1,1,525
584cf60a6cfd713ef406b14c522413596786392e,0,Michael Percy,2013-08-23 14:48:29-07:00,['c7c46378b28ec6216cf7566de48eb1686a525319'],1,83,84,196668,5,,,,526
a7f842e93ecdb29f66863264a82f30e65ae0026b,0,Todd Lipcon,2013-08-24 15:18:58-07:00,['584cf60a6cfd713ef406b14c522413596786392e'],65,121,186,196854,10,,,,526
10a0eb4bee003264a33d5df8d39a95bd6b60a4db,1,Michael Percy,2013-08-26 14:55:01-07:00,['a7f842e93ecdb29f66863264a82f30e65ae0026b'],7,396,403,197257,1,,,,526
1f470584ddbb97ff763df96b72787e01623a7e64,0,Michael Percy,2013-08-26 18:14:55-07:00,['10a0eb4bee003264a33d5df8d39a95bd6b60a4db'],151,37,188,197445,10,0.379310345,0.379310345,0,528
9e9827d0d3f331acb273ae61654c6cb66a927ce7,0,Michael Percy,2013-08-26 18:20:16-07:00,['1f470584ddbb97ff763df96b72787e01623a7e64'],2,151,153,197598,5,0.304347826,0.304347826,1,530
3a36cc1d098d46e2156dbd4114683836ae770771,0,Michael Percy,2013-08-26 18:23:54-07:00,['9e9827d0d3f331acb273ae61654c6cb66a927ce7'],20,41,61,197659,8,,,,530
a102a01358981271b4418c859853bf05c99bf31c,0,Todd Lipcon,2013-08-26 20:38:24-07:00,['3a36cc1d098d46e2156dbd4114683836ae770771'],2,3,5,197664,2,,,,530
1952d32900db92448cf6fd88819bbe97bf166ec2,0,Todd Lipcon,2013-08-26 20:39:53-07:00,['a102a01358981271b4418c859853bf05c99bf31c'],1,0,1,197665,1,,,,530
e50c002d8a5e9c111ef5dc6d596480922f9f7c20,0,Todd Lipcon,2013-08-26 23:06:54-07:00,['1952d32900db92448cf6fd88819bbe97bf166ec2'],60,132,192,197857,1,1,1,1,530
aa7e51b164a01fa4998ad3983e9274d20cc34e28,1,Todd Lipcon,2013-08-26 23:07:13-07:00,['e50c002d8a5e9c111ef5dc6d596480922f9f7c20'],92,259,351,198208,4,0.660714286,0.660714286,1,530
6b413925b1e936ccc58f95754ac4df9985fa539a,1,Todd Lipcon,2013-08-27 09:13:45-07:00,['aa7e51b164a01fa4998ad3983e9274d20cc34e28'],120,1942,2062,200270,19,0.575326216,0.778173191,0.736654804,538
ce4d760ca84a35dc20e4ec318c4585e788eba0bb,1,Michael Percy,2013-08-28 17:04:11-07:00,['6b413925b1e936ccc58f95754ac4df9985fa539a'],1,9964,9965,210235,24,0.639773895,0.748715313,0.931654676,553
20977bfdedbd126718380594cd17b25a1fb502e8,1,Michael Percy,2013-08-28 17:08:02-07:00,['ce4d760ca84a35dc20e4ec318c4585e788eba0bb'],4,350,354,210589,9,0.666666667,1,1,558
df825494557c7948536951fc20486af90f46f00e,1,Michael Percy,2013-08-28 18:26:29-07:00,['20977bfdedbd126718380594cd17b25a1fb502e8'],160,214,374,210963,102,1,,,559
36d971430d38cc8a27caf0405b5f35f94b78d657,1,David Alves,2013-08-29 14:47:45-07:00,['df825494557c7948536951fc20486af90f46f00e'],64,377,441,211404,7,0.060606061,0.974025974,0.437229437,559
56cac04e1b17cf5a0a434b57b3e0262bb4d9ab80,1,Michael Percy,2013-08-29 17:43:33-07:00,['36d971430d38cc8a27caf0405b5f35f94b78d657'],1,18,19,211423,2,,,,560
904037845023bddc43b2b72ce80291790b947dba,1,Michael Percy,2013-08-29 18:16:41-07:00,['56cac04e1b17cf5a0a434b57b3e0262bb4d9ab80'],9,14,23,211446,5,,,,560
426e24ceb075d331e24bd18ccc21a358fa03be26,0,Todd Lipcon,2013-09-01 23:24:55-07:00,['904037845023bddc43b2b72ce80291790b947dba'],18,31,49,211495,5,0.769230769,0.769230769,1,560
e3bedde78e8d017f31e93d3fe5b70729d27d1ecc,1,Todd Lipcon,2013-09-02 13:43:03-07:00,['426e24ceb075d331e24bd18ccc21a358fa03be26'],43,143,186,211681,7,0.416666667,1,0.333333333,562
14427160d108d7f6fc5f48bf26e94e5e4c373a12,0,Todd Lipcon,2013-09-02 13:46:30-07:00,['e3bedde78e8d017f31e93d3fe5b70729d27d1ecc'],43,46,89,211770,4,,,,562
7e3468012db820742361ee6c5ab4243d18d63ffe,0,Todd Lipcon,2013-09-03 08:54:02-07:00,['14427160d108d7f6fc5f48bf26e94e5e4c373a12'],22,89,111,211881,4,1,1,1,562
1799a7957a7bbc3ee804c8dc50eb6350e0a85015,1,Todd Lipcon,2013-09-03 09:20:37-07:00,['7e3468012db820742361ee6c5ab4243d18d63ffe'],0,99,99,211980,4,0.233333333,1,1,565
e4d8906e26a4ebb35671ff0dbf883e5e6cd4681e,0,Todd Lipcon,2013-09-03 13:25:30-07:00,['1799a7957a7bbc3ee804c8dc50eb6350e0a85015'],9,160,169,212149,6,0.551724138,1,1,565
f907fb2b19266c2a52cae0d3a593437a2b71fed2,1,Todd Lipcon,2013-09-03 17:43:12-07:00,['e4d8906e26a4ebb35671ff0dbf883e5e6cd4681e'],1,536,537,212686,6,0.602189781,0.759124088,0.857664234,568
b56bf5b413dd704423c163836f33fc6cd12d9f4e,1,Todd Lipcon,2013-09-04 12:19:01-07:00,['f907fb2b19266c2a52cae0d3a593437a2b71fed2'],121,402,523,213209,17,1,1,0.938053097,569
76816e94002a94bb62c71d948f447853b9998741,0,David Alves,2013-09-04 15:30:05-07:00,['b56bf5b413dd704423c163836f33fc6cd12d9f4e'],3,3,6,213215,2,,,,569
0409ff1d4bdd93a73d996c74a9b8004d8a6b62a5,0,David Alves,2013-09-04 19:55:07-07:00,['76816e94002a94bb62c71d948f447853b9998741'],0,1,1,213216,1,,,,569
f548cd00cbd7319ba1d5b64b883a12a62620ade2,0,David Alves,2013-09-04 20:13:30-07:00,['0409ff1d4bdd93a73d996c74a9b8004d8a6b62a5'],3,7,10,213226,4,,,,569
6c5e1bffeaab080335c27796b5a483b2c4053875,1,Todd Lipcon,2013-09-04 21:46:17-07:00,['f548cd00cbd7319ba1d5b64b883a12a62620ade2'],78,392,470,213696,15,0.673333333,1,0.66,569
625875d544312a1d971f861283151f1d2c31c982,0,Todd Lipcon,2013-09-04 21:51:16-07:00,['6c5e1bffeaab080335c27796b5a483b2c4053875'],10,9,19,213715,2,,,,569
d582d2c421e61c925c0c43db0779e8642d4a240b,0,Michael Percy,2013-09-04 22:24:51-07:00,['625875d544312a1d971f861283151f1d2c31c982'],1,1,2,213717,1,,,,569
92dc3f50f0a9804b68bf5413bcdc77f2e569c654,1,Todd Lipcon,2013-09-05 12:45:13-07:00,['d582d2c421e61c925c0c43db0779e8642d4a240b'],2,221,223,213940,5,0.535433071,0.57480315,0.984251969,569
108597ed9d85e82204f150f53c74bd16038fd47a,0,Todd Lipcon,2013-09-05 12:46:27-07:00,['92dc3f50f0a9804b68bf5413bcdc77f2e569c654'],14,40,54,213994,3,0,0,1,569
15793443f6a50f9353fc953b01ac464a5f4a59c8,1,Todd Lipcon,2013-09-05 12:59:13-07:00,['108597ed9d85e82204f150f53c74bd16038fd47a'],54,123,177,214171,6,0,1,0.9,569
cb7f638c214d6b8a9cb8c5b96f6b98743992c71d,0,Todd Lipcon,2013-09-05 14:45:55-07:00,['15793443f6a50f9353fc953b01ac464a5f4a59c8'],8,9,17,214188,3,,,,569
86991b5fd7413978af482a325fbe8ef470d9ef2d,1,Todd Lipcon,2013-09-05 14:46:07-07:00,['cb7f638c214d6b8a9cb8c5b96f6b98743992c71d'],37,333,370,214558,11,0.761061947,1,0.982300885,571
7489effd2770ddf021386f8cdbc3154dbb279f1b,0,Todd Lipcon,2013-09-05 14:46:19-07:00,['86991b5fd7413978af482a325fbe8ef470d9ef2d'],24,217,241,214799,18,0.477477477,0.684684685,0.990990991,571
d8ee3ca4c160cc9530717bcaa1882b84b4765cf6,0,Todd Lipcon,2013-09-05 16:32:04-07:00,['7489effd2770ddf021386f8cdbc3154dbb279f1b'],2,20,22,214821,1,,,,571
b7002badb3aa466c8d6556ce6935cdcea398b836,1,David Alves,2013-09-05 20:25:30-07:00,['d8ee3ca4c160cc9530717bcaa1882b84b4765cf6'],0,355,355,215176,6,1,1,0.64,576
d9d2de4823395e241c126c2019cc78fd294276c7,0,Eli Collins,2013-09-06 11:13:14-07:00,['b7002badb3aa466c8d6556ce6935cdcea398b836'],1,17,18,215194,1,0,0,1,576
fd38d277a411f66e34f597d90d1414b497ecd2ca,0,Michael Percy,2013-09-06 14:09:25-07:00,['d9d2de4823395e241c126c2019cc78fd294276c7'],43,331,374,215568,9,0.789473684,0.98245614,0.976608187,576
3d8092ed35665107591b169aaf258fa75041acc9,0,Michael Percy,2013-09-06 16:05:56-07:00,['fd38d277a411f66e34f597d90d1414b497ecd2ca'],5,46,51,215619,6,0,0.4,0,577
2ffd7de13cb2fc40edba6cf180d86fcbcc62a0b4,1,Michael Percy,2013-09-10 11:42:41-07:00,['3d8092ed35665107591b169aaf258fa75041acc9'],7,107,114,215733,7,,,,577
a44c7534c0a45c5378f5c52c2d4ace2b69cfb18f,0,Michael Percy,2013-09-10 11:43:30-07:00,['2ffd7de13cb2fc40edba6cf180d86fcbcc62a0b4'],6,17,23,215756,7,,,,577
f045cfca26453b3a77ddf6668384f9c0cb0b1443,1,Todd Lipcon,2013-09-10 17:52:44-07:00,['a44c7534c0a45c5378f5c52c2d4ace2b69cfb18f'],9,118,127,215883,6,0.567901235,1,0.654320988,577
e5a64ee77041644950527f3425e4b47b39666718,0,Todd Lipcon,2013-09-10 18:29:14-07:00,['f045cfca26453b3a77ddf6668384f9c0cb0b1443'],5,154,159,216042,5,0.310810811,1,0.986486486,578
5858b2f5f28f64d9d0a6f6d12b24e81de1b71288,1,Todd Lipcon,2013-09-11 10:41:34-07:00,['e5a64ee77041644950527f3425e4b47b39666718'],45,75,120,216162,12,0,1,0.428571429,578
8fe745b455b203cf939cd3e99ae9464791dcded3,1,Todd Lipcon,2013-09-11 12:35:50-07:00,['5858b2f5f28f64d9d0a6f6d12b24e81de1b71288'],110,559,669,216831,25,0.523076923,0.75,0.811538462,578
c17bf05ade0e1f9d8a6c6dd559e2a776e078cb78,0,Todd Lipcon,2013-09-11 13:09:38-07:00,['8fe745b455b203cf939cd3e99ae9464791dcded3'],1,1,2,216833,1,,,,578
c5b9399a074d618109c840baeaff52f85ff4eaf7,0,Michael Percy,2013-09-11 14:35:46-07:00,['c17bf05ade0e1f9d8a6c6dd559e2a776e078cb78'],1,6,7,216840,2,,,,578
0c49829b78842b26b66f792ed300759a550eb88d,0,Todd Lipcon,2013-09-11 23:07:13-07:00,['c5b9399a074d618109c840baeaff52f85ff4eaf7'],13,11,24,216864,7,0.5,0,0,578
441333cbf118e53d7b08bfec98ac3d83c6bb04e1,0,Michael Percy,2013-09-12 00:27:14-07:00,['0c49829b78842b26b66f792ed300759a550eb88d'],1,1,2,216866,1,,,,578
38b24459da2d1a7f43c2f3c9e790dd59e2ffee3a,1,Todd Lipcon,2013-09-12 16:06:07-07:00,['441333cbf118e53d7b08bfec98ac3d83c6bb04e1'],61,212,273,217139,13,0.155555556,0.233333333,0.977777778,578
783b41b03739ed25b3664eb4ae6f80d701c916ca,0,Todd Lipcon,2013-09-12 21:06:35-07:00,['38b24459da2d1a7f43c2f3c9e790dd59e2ffee3a'],74,117,191,217330,13,0,1,0,580
89319311b866f927590a94ed802092b369babbc5,1,Michael Percy,2013-09-12 21:35:08-07:00,['783b41b03739ed25b3664eb4ae6f80d701c916ca'],65,128,193,217523,16,1,1,0.65625,580
c1e6dba1ac78dc0b33f39b952960f1169e7b972b,0,Michael Percy,2013-09-12 21:35:14-07:00,['89319311b866f927590a94ed802092b369babbc5'],48,48,96,217619,10,,,,580
0b804afcbc69a113d7c2e3c7daaa4d36d804eb40,1,Michael Percy,2013-09-12 21:39:55-07:00,['c1e6dba1ac78dc0b33f39b952960f1169e7b972b'],0,29,29,217648,7,1,1,0.933333333,580
664923b4fa8ee2bc959c6e40209ba2ed399b8bc6,0,David Alves,2013-09-16 09:51:15-07:00,['0b804afcbc69a113d7c2e3c7daaa4d36d804eb40'],2,6,8,217656,3,,,,580
b29cb9c85968b7a5f3e417c45d41161dcbdb9867,0,Todd Lipcon,2013-09-16 09:54:06-07:00,['664923b4fa8ee2bc959c6e40209ba2ed399b8bc6'],86,68,154,217810,9,0,0,0,580
510a1d0f5e4a9735ca52984bb73281ea317bbd4a,0,Michael Percy,2013-09-16 14:24:32-07:00,['b29cb9c85968b7a5f3e417c45d41161dcbdb9867'],113,113,226,218036,8,,,,581
09fbbe136067077b6cd9cdd93d9cedc5005f284d,1,Michael Percy,2013-09-16 14:30:37-07:00,['510a1d0f5e4a9735ca52984bb73281ea317bbd4a'],38,86,124,218160,15,0.142857143,1,1,581
b3f853d6c7d32fd49377450a6e56143ef108bd7d,0,Michael Percy,2013-09-16 18:05:39-07:00,['09fbbe136067077b6cd9cdd93d9cedc5005f284d'],1,9,10,218170,2,,,,581
1c78dffd056c97934f3eb5c84e7baa106464e135,0,Alex Feinberg,2013-09-16 22:58:28-07:00,['b3f853d6c7d32fd49377450a6e56143ef108bd7d'],6,64,70,218240,3,1,1,1,581
a70c1c04af86fd0bd9a7d18a4f888c3a0ebff026,0,Michael Percy,2013-09-18 00:03:54-07:00,['1c78dffd056c97934f3eb5c84e7baa106464e135'],2,63,65,218305,4,,,,582
95296f55468a26419d6e8bb23a150c012c2af9f8,1,Todd Lipcon,2013-09-18 13:32:58-07:00,['a70c1c04af86fd0bd9a7d18a4f888c3a0ebff026'],551,394,945,219250,30,0,0.378378378,1,583
8bbe0118c01f0e05e04b0b8de72c90c44d32bb3b,1,David Alves,2013-09-18 14:02:05-07:00,['95296f55468a26419d6e8bb23a150c012c2af9f8'],4,579,583,219833,7,0.498007968,1,0.77689243,586
02edc1398750f578a2b7f82622d0c8dcc048a4b3,0,Todd Lipcon,2013-09-18 14:04:27-07:00,['8bbe0118c01f0e05e04b0b8de72c90c44d32bb3b'],1,1,2,219835,1,,,,586
36dec705fc73c67f0e7535119750b0284fda9944,1,Todd Lipcon,2013-09-18 14:56:33-07:00,['02edc1398750f578a2b7f82622d0c8dcc048a4b3'],62,168,230,220065,8,0,0.333333333,0.813333333,586
fdb9286d6f5836a2c71aed52b2e1af9844cee203,1,David Alves,2013-09-18 22:52:00-07:00,['36dec705fc73c67f0e7535119750b0284fda9944'],75,104,179,220244,2,1,1,0,587
6adca4c844ddc53caea2733012a53e950b233bc4,1,Todd Lipcon,2013-09-19 11:51:29-07:00,['fdb9286d6f5836a2c71aed52b2e1af9844cee203'],20,72,92,220336,8,1,1,1,587
9a029c372b5dac3c2e0443b632c7cb851ef10d34,0,David Alves,2013-09-22 21:42:14-07:00,['6adca4c844ddc53caea2733012a53e950b233bc4'],1,12,13,220349,2,1,1,0,587
c948266d07149759a940c9a1e140e8e18faae32b,0,David Alves,2013-09-22 22:26:15-07:00,['9a029c372b5dac3c2e0443b632c7cb851ef10d34'],38,66,104,220453,3,1,1,1,588
32d205f1a36d3cffffb452693511d3c57fc76cad,1,Todd Lipcon,2013-09-24 14:06:33-07:00,['c948266d07149759a940c9a1e140e8e18faae32b'],49,1135,1184,221637,10,0.296232877,0.941780822,0.710616438,593
16a65bfab9a6c60f7a70e02fe9a96aeed15060ff,1,Todd Lipcon,2013-09-24 17:01:15-07:00,['32d205f1a36d3cffffb452693511d3c57fc76cad'],92,186,278,221915,14,0.648148148,1,0.37037037,593
c1e27776139cac52f7c6f6cb1f841c2be391e668,0,Todd Lipcon,2013-09-24 22:10:11-07:00,['16a65bfab9a6c60f7a70e02fe9a96aeed15060ff'],1,3,4,221919,1,1,1,1,593
56170b01fcaf0a7aab3156bba2fba5d15327c359,0,David Alves,2013-09-25 11:56:46-07:00,['c1e27776139cac52f7c6f6cb1f841c2be391e668'],9,87,96,222015,2,1,1,0.75,594
746f71c6f8702e89a6c09490c00b448faaca3508,1,Todd Lipcon,2013-09-25 12:20:10-07:00,['56170b01fcaf0a7aab3156bba2fba5d15327c359'],69,407,476,222491,7,0.807453416,1,0.888198758,594
a04a202b7eae97f6073f53b60a1cdcedad95bedd,0,Todd Lipcon,2013-09-25 14:09:27-07:00,['746f71c6f8702e89a6c09490c00b448faaca3508'],1,239,240,222731,6,0.78313253,1,0.78313253,598
d29af6b9649d0577df7e95a604090cd5316ebc3f,1,Michael Percy,2013-09-25 18:59:04-07:00,['a04a202b7eae97f6073f53b60a1cdcedad95bedd'],4,209,213,222944,10,1,1,0.896551724,601
365146937891dc809dd7bb7d0f90c21eb8b6b504,1,Todd Lipcon,2013-09-26 14:41:47-07:00,['d29af6b9649d0577df7e95a604090cd5316ebc3f'],4,9,13,222957,3,1,1,1,601
351073aed3b28163a3633b2e68d1e116acfbf2fc,0,David Alves,2013-09-26 18:51:57-07:00,['365146937891dc809dd7bb7d0f90c21eb8b6b504'],8,203,211,223168,9,0.581395349,0.581395349,1,603
d635865b2959bbebcb896957737f19042d689439,0,Todd Lipcon,2013-09-27 17:28:52-07:00,['351073aed3b28163a3633b2e68d1e116acfbf2fc'],23,162,185,223353,6,0.419753086,1,0.456790123,603
e09ef5987aadf23cdfa5a77e1f19bd507d6a2dba,1,Todd Lipcon,2013-09-28 14:51:41-07:00,['d635865b2959bbebcb896957737f19042d689439'],108,213,321,223674,14,1,1,1,607
c5db95f1591f9bb6eb9a4d11d78c7b6b59bc2ab1,0,Michael Percy,2013-09-29 13:15:43-07:00,['e09ef5987aadf23cdfa5a77e1f19bd507d6a2dba'],1,20,21,223695,2,,,,607
be302ca9248e910004264dda20e370beb4792c57,1,Todd Lipcon,2013-10-01 00:11:18-07:00,['c5db95f1591f9bb6eb9a4d11d78c7b6b59bc2ab1'],58,200,258,223953,15,1,1,1,611
d1f10e070627c923cd7f5324b3e45b9fe43f5e1b,1,Todd Lipcon,2013-10-01 12:12:18-07:00,['be302ca9248e910004264dda20e370beb4792c57'],15,384,399,224352,10,0.402777778,1,0.740740741,612
45070cb946af2410004119de2a293aaee7bd1eaa,1,Todd Lipcon,2013-10-01 14:37:41-07:00,['d1f10e070627c923cd7f5324b3e45b9fe43f5e1b'],97,389,486,224838,17,0.02259887,0.242937853,0.451977401,612
7f1378a8557d2ec17c96ffcfebc46b4caeeb7e8c,0,Todd Lipcon,2013-10-02 11:07:51-07:00,['45070cb946af2410004119de2a293aaee7bd1eaa'],61,81,142,224980,12,0,,0,612
36408cf78ff8e867a960a727a19b2a91b24252bf,1,Todd Lipcon,2013-10-02 11:08:30-07:00,['7f1378a8557d2ec17c96ffcfebc46b4caeeb7e8c'],15,621,636,225616,14,0.437788018,0.820276498,0.622119816,616
1ae9d0e02aec8a17a06afd5f76b4827d1340f2ff,0,Todd Lipcon,2013-10-02 13:15:18-07:00,['36408cf78ff8e867a960a727a19b2a91b24252bf'],58,58,116,225732,11,,,,616
08cd1c8a4378ee1e9650bb0027cd2c4e7a1123ef,1,Todd Lipcon,2013-10-02 13:58:27-07:00,['1ae9d0e02aec8a17a06afd5f76b4827d1340f2ff'],61,154,215,225947,8,1,1,1,618
b757a56501806d5a2a990dcb50c57a3d8b6b60b7,1,David Alves,2013-10-02 14:46:49-07:00,['08cd1c8a4378ee1e9650bb0027cd2c4e7a1123ef'],9,32,41,225988,7,1,1,1,618
a35f2f1168b3c9c579fd80df040e907cca663c8e,1,Todd Lipcon,2013-10-03 11:20:43-07:00,['b757a56501806d5a2a990dcb50c57a3d8b6b60b7'],304,1013,1317,227305,30,0.458677686,0.950413223,1,622
067999be3dfb984e394008423644835ed5944749,1,Todd Lipcon,2013-10-03 23:58:45-07:00,['a35f2f1168b3c9c579fd80df040e907cca663c8e'],36,223,259,227564,25,0,0.962686567,0.611940299,622
27e2aee58cb8bd6bf77aab2bf8157308f8e0c6c9,0,Todd Lipcon,2013-10-04 13:51:24-07:00,['067999be3dfb984e394008423644835ed5944749'],0,1,1,227565,1,1,1,1,622
2a3c2c415a9527c1cc1a4a820a9da94a7930d05a,0,Todd Lipcon,2013-10-05 17:40:30-07:00,['27e2aee58cb8bd6bf77aab2bf8157308f8e0c6c9'],7,28,35,227600,2,0,1,1,622
8c11fc389648c819af6ab40cbd4af6b4370428cf,0,Todd Lipcon,2013-10-06 11:17:20-07:00,['2a3c2c415a9527c1cc1a4a820a9da94a7930d05a'],5,8,13,227613,2,0.5,1,1,622
64893a31894d6f6045feec05633245edffe4eddb,0,Todd Lipcon,2013-10-06 11:24:13-07:00,['8c11fc389648c819af6ab40cbd4af6b4370428cf'],37,112,149,227762,5,0,0.770833333,0.729166667,622
2d0e40c82ba0864a9d3bcab4dc1400085d9fb2d8,1,Todd Lipcon,2013-10-06 16:57:06-07:00,['64893a31894d6f6045feec05633245edffe4eddb'],48,155,203,227965,11,0.952380952,0.952380952,0.952380952,624
267ec4f90dca512d7859d920d7616416e4ce78c9,1,Todd Lipcon,2013-10-06 17:00:47-07:00,['2d0e40c82ba0864a9d3bcab4dc1400085d9fb2d8'],38,257,295,228260,15,0.2734375,0.9296875,0.6015625,625
cf9a8b818082d458831ebf786c10f458946ec8e9,0,Todd Lipcon,2013-10-06 22:56:13-07:00,['267ec4f90dca512d7859d920d7616416e4ce78c9'],3,7,10,228270,1,,,,625
e69f3eb161ed562c63c9d25e0e65313a5cf640ff,1,Todd Lipcon,2013-10-07 10:50:49-07:00,['cf9a8b818082d458831ebf786c10f458946ec8e9'],102,130,232,228502,9,1,1,1,625
7b8c26d3e4192d346c53e259f4f30eb451fab88d,0,Michael Percy,2013-10-07 11:09:31-07:00,['e69f3eb161ed562c63c9d25e0e65313a5cf640ff'],0,10,10,228512,1,,,,625
898005a2b57d05724c5c7a87cf0dd7f941c7e76f,1,Todd Lipcon,2013-10-07 12:21:47-07:00,['7b8c26d3e4192d346c53e259f4f30eb451fab88d'],2,11,13,228525,2,,,,625
9be6c8aa5a54f2863fce7dde76a6a8ee259a6dad,0,Todd Lipcon,2013-10-07 12:25:03-07:00,['898005a2b57d05724c5c7a87cf0dd7f941c7e76f'],6,5,11,228536,1,1,0,0,625
447b533442c752df82d26ebfdf25b6f854325b47,0,Todd Lipcon,2013-10-07 12:31:33-07:00,['9be6c8aa5a54f2863fce7dde76a6a8ee259a6dad'],0,1,1,228537,1,0,1,1,625
3c26f68e9efb40b50fa088d650e58eb8a903a217,0,Todd Lipcon,2013-10-07 12:46:25-07:00,['447b533442c752df82d26ebfdf25b6f854325b47'],4,6,10,228547,1,0,0,1,625
a7b59ce3b365698cefa7754bc9b65332d119f7eb,1,Todd Lipcon,2013-10-07 14:50:20-07:00,['3c26f68e9efb40b50fa088d650e58eb8a903a217'],30,593,623,229170,27,0.7,0.970833333,0.970833333,629
11dfafce87214cadfe56a9ac1af752e7e1d29e30,0,Todd Lipcon,2013-10-08 12:31:06-07:00,['a7b59ce3b365698cefa7754bc9b65332d119f7eb'],1,7,8,229178,2,1,1,1,629
ca393ec7794ea5b9f60351e569367476dc669455,1,Todd Lipcon,2013-10-08 12:37:41-07:00,['11dfafce87214cadfe56a9ac1af752e7e1d29e30'],20,41,61,229239,4,1,1,1,629
365fc5c9ecf46287ae1bdd164b52b7d911dd97d4,0,David Wang,2013-10-09 08:17:34-07:00,['ca393ec7794ea5b9f60351e569367476dc669455'],0,7,7,229246,1,,,,629
149794b7f407b4e24631df08c520bd2f1a2a999b,1,Todd Lipcon,2013-10-09 09:23:32-07:00,['365fc5c9ecf46287ae1bdd164b52b7d911dd97d4'],165,334,499,229745,17,0.746478873,1,0.112676056,629
17ce6de6a86323f8dd2664cfa23eb8a2d0f29801,0,Todd Lipcon,2013-10-09 09:24:00-07:00,['149794b7f407b4e24631df08c520bd2f1a2a999b'],4,4,8,229753,1,,,,629
701d646e146849612e25beb62cd7a5daa71e56f8,0,Todd Lipcon,2013-10-09 13:34:13-07:00,['17ce6de6a86323f8dd2664cfa23eb8a2d0f29801'],3,3,6,229759,2,,,,629
f5b9e32993deff00c8ae8d979e6d7d42a6749f92,1,Todd Lipcon,2013-10-09 13:34:38-07:00,['701d646e146849612e25beb62cd7a5daa71e56f8'],46,359,405,230164,14,0.630136986,1,0.842465753,630
18a953c566017595470bde89f51789634b881850,1,Todd Lipcon,2013-10-09 13:35:49-07:00,['f5b9e32993deff00c8ae8d979e6d7d42a6749f92'],9,205,214,230378,5,0.441176471,1,1,630
6a5f5320c6de8696a610bfca4c9fc05253cba076,1,Todd Lipcon,2013-10-09 17:08:53-07:00,['18a953c566017595470bde89f51789634b881850'],2,32,34,230412,4,1,1,1,630
cb3e1829507010ca1459797e604ebe0e14b27e51,1,Todd Lipcon,2013-10-09 17:12:36-07:00,['6a5f5320c6de8696a610bfca4c9fc05253cba076'],18,19,37,230449,6,1,1,1,630
d084a16d84cd2dbec7194d3674680f45d660e27b,0,Todd Lipcon,2013-10-09 17:17:42-07:00,['cb3e1829507010ca1459797e604ebe0e14b27e51'],7,32,39,230488,6,1,1,1,630
10c6aa12837d700325d3bcce72c4b46e001d30de,0,Todd Lipcon,2013-10-09 20:31:40-07:00,['d084a16d84cd2dbec7194d3674680f45d660e27b'],15,14,29,230517,2,,,,630
1be34f5d26f71768740bcc69c9b1ed3ace300c4b,1,David Alves,2013-10-10 11:05:44-07:00,['10c6aa12837d700325d3bcce72c4b46e001d30de'],4,82,86,230603,8,0.625,0.65625,0.46875,630
a3730acfb487188adaa79e277d117355dc60e14f,0,Michael Percy,2013-10-11 14:01:45-07:00,['1be34f5d26f71768740bcc69c9b1ed3ace300c4b'],1,1,2,230605,1,,,,630
9234aa97360a92f89ec54d9559ee2534453f94cd,1,Michael Percy,2013-10-11 17:14:04-07:00,['a3730acfb487188adaa79e277d117355dc60e14f'],4,900,904,231509,9,0.940251572,1,0.896226415,636
3dd87c7ed6608c16cb49f7de19f8d0803689bee9,1,David Alves,2013-10-18 02:53:06-07:00,['9234aa97360a92f89ec54d9559ee2534453f94cd'],76,13,89,231598,3,0.457142857,0,1,636
ea4f69a4bb4cb6b0ec35d2f6e5824ded3e1f15e1,1,Matteo Bertozzi,2013-10-18 02:59:22-07:00,['3dd87c7ed6608c16cb49f7de19f8d0803689bee9'],99,399,498,232096,23,0.481481481,0.941798942,0.613756614,636
758e30e8469a897e88131f0efe825704c185be4f,1,Matteo Bertozzi,2013-10-18 02:59:57-07:00,['ea4f69a4bb4cb6b0ec35d2f6e5824ded3e1f15e1'],70,300,370,232466,11,0.205673759,0.673758865,0.546099291,636
8eb56deb0cff913b0ba6e29b402c4e1c674ec4e0,0,David Alves,2013-10-18 03:22:12-07:00,['758e30e8469a897e88131f0efe825704c185be4f'],14,28,42,232508,5,0.555555556,1,0.666666667,636
50aeae179d3bd25277d6b84b26e9bd321dcbcbb4,1,David Alves,2013-10-18 12:24:24-07:00,['8eb56deb0cff913b0ba6e29b402c4e1c674ec4e0'],9,39,48,232556,3,0,1,0.214285714,636
0a936b199ebc1ca7becde846a6c0538916621508,1,David Alves,2013-10-18 14:21:06-07:00,['50aeae179d3bd25277d6b84b26e9bd321dcbcbb4'],8,31,39,232595,4,0,0,0,636
3329c6640673fc6f30b89dcb2cb3d9b2f7c1090f,0,David Alves,2013-10-21 13:07:55-07:00,['0a936b199ebc1ca7becde846a6c0538916621508'],6,5,11,232606,1,1,1,1,636
8bcacefb3b555214b883d0cb1113c5e65f5a9fda,0,Matteo Bertozzi,2013-10-23 02:35:05-07:00,['3329c6640673fc6f30b89dcb2cb3d9b2f7c1090f'],36,202,238,232844,4,0.333333333,1,0.91954023,636
b75d8e35176b6d22759f88cdfb77841b4756065d,0,David Alves,2013-10-23 02:35:50-07:00,['8bcacefb3b555214b883d0cb1113c5e65f5a9fda'],0,1,1,232845,1,0,1,0,636
789c69e956491130bc3057094cd20f5c89f752d5,0,Matteo Bertozzi,2013-10-23 14:40:34-07:00,['b75d8e35176b6d22759f88cdfb77841b4756065d'],1,0,1,232846,1,1,0,0,636
1f9f526a1fd13d595131b267dfaa7b336ec3515f,0,David Alves,2013-10-23 15:09:39-07:00,['789c69e956491130bc3057094cd20f5c89f752d5'],2,2,4,232850,2,,,,636
4dffef8cf4076e5d91955fc844c82b102c2eaef5,0,David Alves,2013-10-24 01:54:23-07:00,['1f9f526a1fd13d595131b267dfaa7b336ec3515f'],1,1,2,232852,1,,,,636
a2e31736d54951af2abf80cce4f175b8b2dbcdf4,1,David Alves,2013-10-24 01:54:41-07:00,['4dffef8cf4076e5d91955fc844c82b102c2eaef5'],1,2,3,232855,1,0,1,1,636
39947a81ba47168f6b440613eac24b5717257b61,0,David Alves,2013-10-24 01:54:59-07:00,['a2e31736d54951af2abf80cce4f175b8b2dbcdf4'],0,4,4,232859,1,1,1,1,636
9097efa4d18c9fc9972efe46458dacd93ab9b1a6,1,David Alves,2013-10-24 01:55:16-07:00,['39947a81ba47168f6b440613eac24b5717257b61'],157,286,443,233302,2,0,0.233333333,0,637
29d641befd715d458c9f3b77f9de887a28acb7d8,0,Michael Percy,2013-10-24 12:04:39-07:00,['9097efa4d18c9fc9972efe46458dacd93ab9b1a6'],4,14,18,233320,1,,,,637
105cfef01f9bbaba5c0fd57797f1951cf1f82259,0,Michael Percy,2013-10-24 12:23:18-07:00,['29d641befd715d458c9f3b77f9de887a28acb7d8'],0,4,4,233324,1,,,,637
65013be5709596c1192303acf46bae5e10b72667,1,Michael Percy,2013-10-24 13:51:40-07:00,['105cfef01f9bbaba5c0fd57797f1951cf1f82259'],27,149,176,233500,14,0.566037736,1,1,637
e31d9174088c433180b3e899a86ed64bf99eaaf8,1,David Alves,2013-10-28 08:38:41-07:00,['65013be5709596c1192303acf46bae5e10b72667'],14,161,175,233675,4,1,1,0.80952381,639
c94e3bec572e7f67ccae710b9080cacdcd978d6b,0,Todd Lipcon,2013-10-28 20:01:20-07:00,['e31d9174088c433180b3e899a86ed64bf99eaaf8'],5,2,7,233682,3,,,,639
f7cc9e7b132aa283d104d27b14bdb73f147f0ced,0,Todd Lipcon,2013-10-28 20:07:34-07:00,['c94e3bec572e7f67ccae710b9080cacdcd978d6b'],20,19,39,233721,2,0,1,1,639
254eb5aa4092dabaf541a6b0a7b9cd092a13664e,0,Todd Lipcon,2013-10-28 20:33:05-07:00,['f7cc9e7b132aa283d104d27b14bdb73f147f0ced'],1,3,4,233725,1,0,1,1,639
28137df3abaa9fded7d645f6fbb3fcbab51ac6ea,1,Todd Lipcon,2013-10-30 10:57:40-07:00,['254eb5aa4092dabaf541a6b0a7b9cd092a13664e'],11,11,22,233747,3,0,1,1,639
a610a9967ed363e99fca2161255b6c50d2e9b582,1,Todd Lipcon,2013-10-30 11:23:22-07:00,['28137df3abaa9fded7d645f6fbb3fcbab51ac6ea'],2,4,6,233753,1,0,0,0,639
cd89eb1cb056a5122ebf4ae7e382407fa01e7bc9,0,David Alves,2013-10-30 22:38:47-07:00,['a610a9967ed363e99fca2161255b6c50d2e9b582'],14,34,48,233801,7,,,,640
1d7e6864b4a31d3fe6897e4cb484dfcda6608d43,0,Brock Noland,2013-11-01 11:44:24-07:00,['cd89eb1cb056a5122ebf4ae7e382407fa01e7bc9'],1,1,2,233803,1,,,,640
ba6933b466336f67ae2ba7d6ee99b76afb2a4552,0,Brock Noland,2013-11-01 12:57:51-07:00,['1d7e6864b4a31d3fe6897e4cb484dfcda6608d43'],19,23,42,233845,2,,,,640
cf4c739277ccb755d2638b8823ed3f28010f729d,0,Todd Lipcon,2013-11-01 13:06:35-07:00,['ba6933b466336f67ae2ba7d6ee99b76afb2a4552'],0,2,2,233847,1,,,,640
2909db37a5bfa003d1d93e6d2be1b2f4958174f5,1,David Alves,2013-11-01 13:52:19-07:00,['cf4c739277ccb755d2638b8823ed3f28010f729d'],4,66,70,233917,5,1,1,0.807692308,641
a588de729774358c234556b567c47f6ed36a90da,1,Todd Lipcon,2013-11-01 18:20:12-07:00,['2909db37a5bfa003d1d93e6d2be1b2f4958174f5'],59,383,442,234359,17,0.64516129,0.991935484,0.709677419,643
706739996be87ed3b91ab6c434e291251f721b7b,0,Todd Lipcon,2013-11-04 15:40:26-08:00,['a588de729774358c234556b567c47f6ed36a90da'],3,3,6,234365,3,,,,643
946a796b8c333dd579221101687d8cf117951444,0,Todd Lipcon,2013-11-04 22:16:41-08:00,['706739996be87ed3b91ab6c434e291251f721b7b'],0,1,1,234366,1,,,,643
338a833df500c5733e57e890372f22bb3276f28f,0,Todd Lipcon,2013-11-04 22:17:09-08:00,['946a796b8c333dd579221101687d8cf117951444'],1,1,2,234368,1,,,,643
965e1382d89c9eb8357dce9f0594236edc82b69f,0,Todd Lipcon,2013-11-05 13:09:23-08:00,['338a833df500c5733e57e890372f22bb3276f28f'],2,2,4,234372,1,,,,643
bef110b289074d78f9e3443045bdb4f31d076cbf,1,Alex Feinberg,2013-11-05 17:06:41-08:00,['965e1382d89c9eb8357dce9f0594236edc82b69f'],0,455,455,234827,10,0.180851064,0.914893617,0.79787234,644
9c6e3a0cbaaa8cf3566e55df33fc5a0566e4d960,0,Todd Lipcon,2013-11-05 18:48:37-08:00,['bef110b289074d78f9e3443045bdb4f31d076cbf'],1,2,3,234830,1,1,1,1,644
24200712850c5f4e8c9ba7d2ad9bde860b285b80,1,Todd Lipcon,2013-11-05 19:05:44-08:00,['9c6e3a0cbaaa8cf3566e55df33fc5a0566e4d960'],71,1273,1344,236174,8,0.190140845,0.601408451,0.611267606,646
1687d5c412e08ee18763d374c690b7ca5147de94,1,Todd Lipcon,2013-11-05 19:44:05-08:00,['24200712850c5f4e8c9ba7d2ad9bde860b285b80'],51,77,128,236302,3,1,1,1,646
1d1d5e8bf03af7adc5ed893c1db45e1c075e59ec,0,Todd Lipcon,2013-11-06 17:34:08-08:00,['1687d5c412e08ee18763d374c690b7ca5147de94'],2,2,4,236306,1,,,,646
64091335446ef8702b28b7ba9ae37354391e806f,1,Todd Lipcon,2013-11-06 17:37:27-08:00,['1d1d5e8bf03af7adc5ed893c1db45e1c075e59ec'],1,132,133,236439,8,0.638297872,1,1,648
cae01ecd9eb795cab7188fef05578998b0ba83cc,1,Todd Lipcon,2013-11-06 18:02:35-08:00,['64091335446ef8702b28b7ba9ae37354391e806f'],41,135,176,236615,10,0,1,0.677966102,648
2379120c5697326d839bf029d1851373a4ecc27e,1,Todd Lipcon,2013-11-06 20:29:14-08:00,['cae01ecd9eb795cab7188fef05578998b0ba83cc'],4,4,8,236623,2,,,,648
fb870fb485abed279d2fe1fde96a5aa3421786cd,1,Todd Lipcon,2013-11-06 20:40:07-08:00,['2379120c5697326d839bf029d1851373a4ecc27e'],4,22,26,236649,3,0.636363636,1,1,648
b0ad68f448736d58a67caa3fe2a3274d2ab2b532,0,Jean-Daniel Cryans,2013-11-06 20:49:40-08:00,['fb870fb485abed279d2fe1fde96a5aa3421786cd'],12,136,148,236797,9,0,0,1,652
32c90a4da3f8458c22cbaf7960aab361e52080c8,1,David Alves,2013-11-06 20:52:54-08:00,['b0ad68f448736d58a67caa3fe2a3274d2ab2b532'],1,76,77,236874,2,0.322580645,1,1,653
33ef04877ca844843c877dae8d0b7381261d71d2,0,Todd Lipcon,2013-11-07 08:36:42-08:00,['32c90a4da3f8458c22cbaf7960aab361e52080c8'],7,46,53,236927,6,1,1,1,653
e6b87efb1c1ec4c1b21218b5f6edc340a255e92b,0,Todd Lipcon,2013-11-07 08:36:51-08:00,['33ef04877ca844843c877dae8d0b7381261d71d2'],2,9,11,236938,1,0,1,1,653
29cc3b071b418a0766d25078ece85ab3042a8635,1,Todd Lipcon,2013-11-07 10:29:37-08:00,['e6b87efb1c1ec4c1b21218b5f6edc340a255e92b'],32,511,543,237481,4,0.414965986,1,0.925170068,654
07804a046bdd4573d017bc1c778d51ec8271b55d,1,Todd Lipcon,2013-11-07 14:17:27-08:00,['29cc3b071b418a0766d25078ece85ab3042a8635'],47,59,106,237587,4,1,,0,654
d9d7738e0e91a672135296ef6dcdf9b6f92d6277,0,Todd Lipcon,2013-11-07 14:43:21-08:00,['07804a046bdd4573d017bc1c778d51ec8271b55d'],45,168,213,237800,14,0.963636364,1,0.854545455,654
efbcf874abf4814345e21238f2d74e492cfa8d11,0,Todd Lipcon,2013-11-07 15:04:56-08:00,['d9d7738e0e91a672135296ef6dcdf9b6f92d6277'],1,13,14,237814,2,0,1,1,654
c543c87942df316290c3be5b3feaadb6e3907f93,0,Jean-Daniel Cryans,2013-11-07 15:15:58-08:00,['efbcf874abf4814345e21238f2d74e492cfa8d11'],2,3,5,237819,1,1,1,1,654
53db713186069ca6029d4ef7a19ae52b8277f0f8,0,Todd Lipcon,2013-11-07 18:55:16-08:00,['c543c87942df316290c3be5b3feaadb6e3907f93'],0,386,386,238205,3,0.398523985,0.487084871,0.867158672,657
91a45ef0cff4577db8309f5f0c4f38144738c9ab,0,Todd Lipcon,2013-11-08 08:46:48-08:00,['53db713186069ca6029d4ef7a19ae52b8277f0f8'],1,1,2,238207,1,,,,657
d3e52ca5eb178367c96dc097aaf616b18b729d9f,1,Todd Lipcon,2013-11-08 09:05:54-08:00,['91a45ef0cff4577db8309f5f0c4f38144738c9ab'],55,113,168,238375,11,1,1,1,659
322935db44634893683e1da7381a64c7b1030d78,0,Todd Lipcon,2013-11-08 09:19:51-08:00,['d3e52ca5eb178367c96dc097aaf616b18b729d9f'],57,82,139,238514,3,0.333333333,0.972222222,0.583333333,660
d1f155d8adbb7e4d23ee419bdbe1914c741835fb,0,Todd Lipcon,2013-11-10 21:16:44-08:00,['322935db44634893683e1da7381a64c7b1030d78'],5,22,27,238541,4,0,1,1,660
51190c6f327776e3f49939e7f46914c64b083e1e,0,Todd Lipcon,2013-11-11 09:39:03-08:00,['d1f155d8adbb7e4d23ee419bdbe1914c741835fb'],0,581,581,239122,3,0.113043478,0.289855072,1,662
45721a6040a08d2b38b414adb7579f97507ab756,1,Todd Lipcon,2013-11-11 09:39:24-08:00,['51190c6f327776e3f49939e7f46914c64b083e1e'],1,212,213,239335,12,0.472222222,0.638888889,1,664
cd58bd93aa9c8a06a93b8445b5026d69bd743077,1,Todd Lipcon,2013-11-11 11:17:31-08:00,['45721a6040a08d2b38b414adb7579f97507ab756'],35,90,125,239460,7,0.2,1,0.04,664
8b6b02c5a40a3635b8768d7d32a08d4ae0c3aa92,1,Todd Lipcon,2013-11-11 15:12:28-08:00,['cd58bd93aa9c8a06a93b8445b5026d69bd743077'],31,145,176,239636,19,0.733333333,0.933333333,0,664
0d38e908a4c1a12550834af1eab1ffcfe17620fc,1,Jean-Daniel Cryans,2013-11-11 18:31:19-08:00,['8b6b02c5a40a3635b8768d7d32a08d4ae0c3aa92'],43,153,196,239832,5,1,1,1,667
efa492f8c18fa2db5c38df011a944ce581b6a44f,0,David Alves,2013-11-11 20:44:11-08:00,['0d38e908a4c1a12550834af1eab1ffcfe17620fc'],23,54,77,239909,4,1,1,0.363636364,668
419321bd3789626c77f1f81f3accf5c2871797ce,0,Todd Lipcon,2013-11-11 22:39:13-08:00,['efa492f8c18fa2db5c38df011a944ce581b6a44f'],0,6,6,239915,1,0,0,1,668
b6ee051b46301765c1cdef9f44af2e97886e647d,0,Brock Noland,2013-11-12 11:24:01-08:00,['419321bd3789626c77f1f81f3accf5c2871797ce'],6,2,8,239923,1,,,,668
3d383d1f1072fcb9d8673b4c8d41384f68d33f6d,1,Todd Lipcon,2013-11-12 15:02:37-08:00,['b6ee051b46301765c1cdef9f44af2e97886e647d'],35,39,74,239997,6,0,0,1,668
ccacb29c809a21282375527d48ea03dc1fa4af24,1,Brock Noland,2013-11-12 15:03:50-08:00,['3d383d1f1072fcb9d8673b4c8d41384f68d33f6d'],5,4,9,240006,3,0,1,1,668
c74eebdda33703a3cace64ae0e6be3e673575c80,1,Todd Lipcon,2013-11-12 15:26:18-08:00,['ccacb29c809a21282375527d48ea03dc1fa4af24'],69,192,261,240267,2,0.719298246,1,1,668
96c2cd6bcdd0260c604991ddb2e1fc755603abc9,1,Todd Lipcon,2013-11-12 22:01:18-08:00,['c74eebdda33703a3cace64ae0e6be3e673575c80'],30,7164,7194,247461,4,0.749464056,0.766328426,0.880520223,669
14032990059bc3d115e5c47fbbbdf8a66227e58b,1,Todd Lipcon,2013-11-12 23:31:22-08:00,['96c2cd6bcdd0260c604991ddb2e1fc755603abc9'],69,284,353,247814,5,1,1,0.547368421,669
91d98f6ad3da98ceaa675424e06aef5197c3d071,1,Todd Lipcon,2013-11-13 09:59:01-08:00,['14032990059bc3d115e5c47fbbbdf8a66227e58b'],0,96,96,247910,11,0.709677419,1,1,669
4e7d5c5270fa8b6e6e8ae04eea5563afdde91aba,1,Todd Lipcon,2013-11-13 11:13:02-08:00,['91d98f6ad3da98ceaa675424e06aef5197c3d071'],4,103,107,248017,5,0.304347826,1,1,671
b18a98bf15924db1a60c07857dfb0701307cb230,1,Jean-Daniel Cryans,2013-11-13 11:53:10-08:00,['4e7d5c5270fa8b6e6e8ae04eea5563afdde91aba'],18,216,234,248251,7,0.680851064,1,0.627659574,673
addb95791f4b17c325ebb4a9a1f39b392a8b2495,1,Matteo Bertozzi,2013-11-13 12:54:55-08:00,['b18a98bf15924db1a60c07857dfb0701307cb230'],365,396,761,249012,25,1,1,0,673
141035efddec3a1b3a581b9cf71002ef6f8bd0ed,0,Todd Lipcon,2013-11-13 15:03:16-08:00,['addb95791f4b17c325ebb4a9a1f39b392a8b2495'],0,0,0,249012,1,,,,673
7c48ca89f637efafa77963488f202fc717896bb4,0,Todd Lipcon,2013-11-13 15:45:11-08:00,['141035efddec3a1b3a581b9cf71002ef6f8bd0ed'],13,0,13,249025,1,,,,673
770131afedc37fc481ffadef1ce23298814c899a,1,Michael Percy,2013-11-13 17:12:39-08:00,['7c48ca89f637efafa77963488f202fc717896bb4'],24,525,549,249574,7,0.323529412,0.817647059,0.682352941,675
10f3dd3aea4fd2dda9675744598756a244d473c8,0,Michael Percy,2013-11-13 23:32:30-08:00,['770131afedc37fc481ffadef1ce23298814c899a'],4,28,32,249606,5,0.769230769,1,1,675
eebe9901cd6bbe651f450911636a2a0e8c5ba974,0,David Alves,2013-11-14 00:11:39-08:00,['10f3dd3aea4fd2dda9675744598756a244d473c8'],1,1,2,249608,1,,,,675
60872cb450245cb2bf58d98313131b3ba0b5eb12,0,David Alves,2013-11-14 04:54:22-08:00,['eebe9901cd6bbe651f450911636a2a0e8c5ba974'],0,5,5,249613,1,0,1,1,675
0ecab488800acf4f0c5440989c6562f73ad4525e,1,Todd Lipcon,2013-11-14 11:12:52-08:00,['60872cb450245cb2bf58d98313131b3ba0b5eb12'],23,82,105,249718,2,0,0.97826087,0.130434783,675
875e150bc1d0039120511cdfbd05fd52f33e573c,1,Michael Percy,2013-11-14 13:46:29-08:00,['0ecab488800acf4f0c5440989c6562f73ad4525e'],2,15,17,249735,2,0.875,1,1,675
8b17d3ae2a5a528777b4da4dcfe518076cf73f4e,0,Todd Lipcon,2013-11-14 15:16:20-08:00,['875e150bc1d0039120511cdfbd05fd52f33e573c'],9,4,13,249748,3,0,0,0,675
3fe5b8d45b3c6c125b776358adf69f0e84379cd1,0,Michael Percy,2013-11-14 15:24:40-08:00,['8b17d3ae2a5a528777b4da4dcfe518076cf73f4e'],1,1,2,249750,1,,,,675
9b95b7550f37cddb542c4a845f68fd0cac5e8135,1,Michael Percy,2013-11-14 15:53:28-08:00,['3fe5b8d45b3c6c125b776358adf69f0e84379cd1'],43,35,78,249828,4,1,0,0,675
d0364123d0c6fcf4d417d550d4e4187c14430549,1,Michael Percy,2013-11-14 15:55:41-08:00,['9b95b7550f37cddb542c4a845f68fd0cac5e8135'],3,22,25,249853,2,0,1,1,675
1bf3f3e6286fdf607d524620eb72efb040a04d94,0,Michael Percy,2013-11-14 19:47:54-08:00,['d0364123d0c6fcf4d417d550d4e4187c14430549'],3,19,22,249875,1,1,1,1,675
9e37072a8dbdd0059e36cf9af9084efb8da26d76,0,Todd Lipcon,2013-11-14 20:36:33-08:00,['1bf3f3e6286fdf607d524620eb72efb040a04d94'],2,10,12,249887,1,1,1,0,675
4e4e1aacbe836bc733213f037a66fed0ef34828b,0,Todd Lipcon,2013-11-14 21:04:29-08:00,['9e37072a8dbdd0059e36cf9af9084efb8da26d76'],2,2,4,249891,1,,,,675
c8fbf5472cc3f07731a7f8c618f5de3d83a18e6d,1,Todd Lipcon,2013-11-14 21:04:39-08:00,['4e4e1aacbe836bc733213f037a66fed0ef34828b'],1,26,27,249918,2,0.842105263,1,1,675
abe70872797cfa58f1738da6ecc78ad2735d9fa8,0,Todd Lipcon,2013-11-14 21:16:41-08:00,['c8fbf5472cc3f07731a7f8c618f5de3d83a18e6d'],1,11,12,249930,1,0,0,0,675
06a1c5778c55deb4b62aacc551f7987f466d8c49,1,Todd Lipcon,2013-11-14 21:19:17-08:00,['abe70872797cfa58f1738da6ecc78ad2735d9fa8'],11,87,98,250028,11,0.541666667,1,1,675
8f33625ee2bfece3b08d7684ec636642474e11cf,0,Todd Lipcon,2013-11-14 21:35:04-08:00,['06a1c5778c55deb4b62aacc551f7987f466d8c49'],9,2,11,250039,1,1,0,0,675
4b83a7926ed1f56a0ad6fe60c64c5a2e8435dd24,0,David Alves,2013-11-14 22:19:03-08:00,['8f33625ee2bfece3b08d7684ec636642474e11cf'],6,68,74,250113,3,0,0.191489362,1,675
e2d6e888439aedb7985c1195a921b9fbca995452,1,Todd Lipcon,2013-11-14 22:23:53-08:00,['4b83a7926ed1f56a0ad6fe60c64c5a2e8435dd24'],11,39,50,250163,12,0,0.772727273,0.5,675
95d63ace52d341a577e8e0a0d1848132562e071e,1,Todd Lipcon,2013-11-14 23:51:37-08:00,['e2d6e888439aedb7985c1195a921b9fbca995452'],1,861,862,251025,5,0.628841608,0.933806147,0.95035461,678
164305e1b171c2cb8adc94d6c80949fefb3caeae,0,Todd Lipcon,2013-11-15 00:23:02-08:00,['95d63ace52d341a577e8e0a0d1848132562e071e'],3,14,17,251042,2,0.5,1,0.5,678
88ec8e140491c370a5f46dc80d29fe3d853e44eb,1,Michael Percy,2013-11-15 02:36:35-08:00,['164305e1b171c2cb8adc94d6c80949fefb3caeae'],21,264,285,251327,6,0.616161616,1,1,681
790e905f415c0bb7d36f1223fee25ad6cd276112,1,Michael Percy,2013-11-15 02:49:02-08:00,['88ec8e140491c370a5f46dc80d29fe3d853e44eb'],2,80,82,251409,11,0.514285714,1,1,681
06bac8c5585532bc6b4d424a82b45f9453eab92e,1,Michael Percy,2013-11-15 02:50:25-08:00,['790e905f415c0bb7d36f1223fee25ad6cd276112'],0,7,7,251416,3,1,1,0.25,681
a6dd8def1c0350abf32b0e9f631d65f1044aebf6,0,Michael Percy,2013-11-15 02:51:08-08:00,['06bac8c5585532bc6b4d424a82b45f9453eab92e'],1,1,2,251418,1,,,,681
41d33d3de085866330f32c30c805a44d6e9fc30e,1,Todd Lipcon,2013-11-15 16:26:47-08:00,['a6dd8def1c0350abf32b0e9f631d65f1044aebf6'],10,221,231,251649,5,0.473214286,1,0.866071429,681
4dd43126d22ac7ba783171fc89aabd1a1399c4cf,0,Todd Lipcon,2013-11-15 16:59:38-08:00,['41d33d3de085866330f32c30c805a44d6e9fc30e'],3,49,52,251701,3,0.090909091,0,0.787878788,681
af7c19a5f8d7b1b1c3d17368c3889b1450b344bf,0,Todd Lipcon,2013-11-19 13:33:00-08:00,['4dd43126d22ac7ba783171fc89aabd1a1399c4cf'],8,29,37,251738,3,0.882352941,0.882352941,1,681
d3026529151dbe8950b1789d64b1566f91047578,0,Todd Lipcon,2013-11-19 14:05:22-08:00,['af7c19a5f8d7b1b1c3d17368c3889b1450b344bf'],1,1,2,251740,1,,,,681
9c99e9a539cc8559acbc3481f04c016042fde9b2,0,Todd Lipcon,2013-11-19 14:34:38-08:00,['d3026529151dbe8950b1789d64b1566f91047578'],12,42,54,251794,2,0.733333333,1,1,681
ca7cedc85d0b966fe5af1f7e759f511a65ae348d,0,Todd Lipcon,2013-11-19 16:59:18-08:00,['9c99e9a539cc8559acbc3481f04c016042fde9b2'],19,40,59,251853,4,0.941176471,1,0.941176471,681
078fb8e37bd63c61fc3c71269028f78019effb68,0,Jean-Daniel Cryans,2013-11-21 12:58:31-08:00,['ca7cedc85d0b966fe5af1f7e759f511a65ae348d'],0,2,2,251855,1,1,1,0,681
887ea0323603de3ca92ad8449ade4061772ddd7d,0,Alex Feinberg,2013-11-23 12:27:49-08:00,['078fb8e37bd63c61fc3c71269028f78019effb68'],2,2,4,251859,1,,,,681
481daa14e37fed6a0f0a5f6331cc08875c5367db,0,Todd Lipcon,2013-11-25 16:31:26-08:00,['887ea0323603de3ca92ad8449ade4061772ddd7d'],14,112,126,251985,1,,,,681
6e8a1cd99b1d1a18bfe12188508824bf6fd85058,1,Todd Lipcon,2013-11-25 19:19:55-08:00,['481daa14e37fed6a0f0a5f6331cc08875c5367db'],97,499,596,252581,9,0.582089552,1,1,684
e5ea2a85100eb618d0f61c09aa35920d3b108c3a,1,Todd Lipcon,2013-11-25 20:39:59-08:00,['6e8a1cd99b1d1a18bfe12188508824bf6fd85058'],432,505,937,253518,48,1,0,0,684
3552e1bdcbb4db9202f202d688d0d13d5648ae84,1,Todd Lipcon,2013-11-26 10:29:59-08:00,['e5ea2a85100eb618d0f61c09aa35920d3b108c3a'],2,3,5,253523,1,1,1,1,684
6d85894334a2a168127f745a773d3dea55b7eccd,1,Alex Feinberg,2013-11-26 15:19:49-08:00,['3552e1bdcbb4db9202f202d688d0d13d5648ae84'],42,569,611,254134,16,0.401960784,0.928104575,0.774509804,684
54f1a2df91f1605ff55fc56aa92e68fac0934e00,0,David Alves,2013-11-27 09:26:04-08:00,['6d85894334a2a168127f745a773d3dea55b7eccd'],28,130,158,254292,3,0.661016949,1,0.915254237,684
a64899a7f699262cc7139061b15db6afd33845e3,0,Todd Lipcon,2013-12-02 17:29:02-08:00,['54f1a2df91f1605ff55fc56aa92e68fac0934e00'],6,2,8,254300,2,0,0,0,684
6dec15829257354ebb86369f38c82f5e4eeb1e3c,1,Todd Lipcon,2013-12-03 00:02:04-08:00,['a64899a7f699262cc7139061b15db6afd33845e3'],923,1114,2037,256337,28,1,0.925925926,1,689
ab70ffa4f0814e1051ad3d11d762621e1680aeec,0,Todd Lipcon,2013-12-03 11:37:29-08:00,['6dec15829257354ebb86369f38c82f5e4eeb1e3c'],12,20,32,256369,2,1,0.4,1,689
6f6e7a6bc58eaa31f43835d2c63328441eca1b40,0,Todd Lipcon,2013-12-03 13:02:21-08:00,['ab70ffa4f0814e1051ad3d11d762621e1680aeec'],26,28,54,256423,7,1,1,1,689
21337a137c426357019a46e7d7abc40cd10dd381,1,Todd Lipcon,2013-12-03 18:49:47-08:00,['6f6e7a6bc58eaa31f43835d2c63328441eca1b40'],4,102,106,256529,5,0.34375,1,0.984375,689
76f6059d1a30fe1f821b4492c57f25f24a5c9e6d,1,Todd Lipcon,2013-12-03 19:28:07-08:00,['21337a137c426357019a46e7d7abc40cd10dd381'],97,152,249,256778,8,0,1,0,689
9e6b32e98bca504d4129217580dce29bc034f1e8,1,Todd Lipcon,2013-12-04 11:55:30-08:00,['76f6059d1a30fe1f821b4492c57f25f24a5c9e6d'],34,70,104,256882,12,0.928571429,0.928571429,0.928571429,689
873de061b2de18170282bb59e9849c2b9f2f5adf,0,Todd Lipcon,2013-12-04 12:19:57-08:00,['9e6b32e98bca504d4129217580dce29bc034f1e8'],14,19,33,256915,1,1,1,1,689
3fc80bd9a404553d76caa778198dfad6fb0f2d27,1,Colin McCabe,2013-12-04 13:15:03-08:00,['873de061b2de18170282bb59e9849c2b9f2f5adf'],33,223,256,257171,9,0.156862745,1,0.666666667,693
d4f78eff9a193170b5c9061cafc823fa3d7cd9ef,0,Todd Lipcon,2013-12-04 15:01:24-08:00,['3fc80bd9a404553d76caa778198dfad6fb0f2d27'],4,4,8,257179,3,,,,693
8a2e093b084ac0cdf73abf5f55daf5ceef0d4c69,1,Todd Lipcon,2013-12-05 08:56:12-08:00,['d4f78eff9a193170b5c9061cafc823fa3d7cd9ef'],0,37,37,257216,2,0,0.730769231,0.730769231,693
011e1afc4e5202625b370d58106064d5059c83eb,1,Todd Lipcon,2013-12-06 12:04:59-08:00,['8a2e093b084ac0cdf73abf5f55daf5ceef0d4c69'],197,283,480,257696,6,0,0,1,694
47e61e5a8ef1259625e9d8b1ce8a6a332afe6bdc,0,Todd Lipcon,2013-12-06 14:39:33-08:00,['011e1afc4e5202625b370d58106064d5059c83eb'],12,1410,1422,259118,25,0.496124031,0.648062016,1,704
066d1a9e29d5c2a07f04ac21f9f1bdd739033336,0,Todd Lipcon,2013-12-06 16:15:28-08:00,['47e61e5a8ef1259625e9d8b1ce8a6a332afe6bdc'],18,638,656,259774,9,0.618902439,0.783536585,0.899390244,707
568c7412cf13be2d213d2df33570ccf9ef6246a8,0,Todd Lipcon,2013-12-06 16:15:40-08:00,['066d1a9e29d5c2a07f04ac21f9f1bdd739033336'],18,56,74,259848,3,1,1,0.954545455,707
610496a1887643183d83027f5ffb889502bb72b6,0,Todd Lipcon,2013-12-06 19:10:41-08:00,['568c7412cf13be2d213d2df33570ccf9ef6246a8'],1,1,2,259850,1,,,,707
831bdad02d07ce1506ad27fd02e97e2d31ff5341,0,Todd Lipcon,2013-12-11 12:09:01-08:00,['610496a1887643183d83027f5ffb889502bb72b6'],0,1,1,259851,1,0,0,0,707
e5f5c560e45c9392b0da7a61cbce214b00f6b17b,1,Todd Lipcon,2013-12-11 13:07:41-08:00,['831bdad02d07ce1506ad27fd02e97e2d31ff5341'],38,69,107,259958,3,0.681818182,1,0.136363636,707
edf032bc92c1d4204ebc2132d91d0f32908b5423,0,David Alves,2013-12-11 18:38:53-08:00,['e5f5c560e45c9392b0da7a61cbce214b00f6b17b'],7,42,49,260007,35,,,,707
ca18ea9cc6e5b73a2ad5efa77d98ca6af697377e,1,David Alves,2013-12-12 09:12:16-08:00,['edf032bc92c1d4204ebc2132d91d0f32908b5423'],26,40,66,260073,3,0.75,1,0,707
3693fa07d071283d8bbdf0f96bf4a2341b711fcf,1,David Alves,2013-12-12 09:14:47-08:00,['ca18ea9cc6e5b73a2ad5efa77d98ca6af697377e'],108,541,649,260722,17,0.521327014,0.966824645,0.772511848,709
5a317babfa9d9b854296d20134686bf2e867208d,1,David Alves,2013-12-12 16:22:04-08:00,['3693fa07d071283d8bbdf0f96bf4a2341b711fcf'],167,202,369,261091,10,1,0,1,709
8d3bd0eec10de11507fc2b9f18fbb0a358d13e5a,0,Todd Lipcon,2013-12-13 16:13:39-08:00,['5a317babfa9d9b854296d20134686bf2e867208d'],1,1,2,261093,1,,,,709
721741ebbb3619f69913ec214c2e2351a2f948ed,1,Todd Lipcon,2013-12-16 16:59:22-08:00,['8d3bd0eec10de11507fc2b9f18fbb0a358d13e5a'],3,239,242,261335,8,0.987341772,1,0.987341772,711
cec6cb9c00cd18fc94c0e7b5d27d65a0297ed0bb,1,Todd Lipcon,2013-12-16 17:02:15-08:00,['721741ebbb3619f69913ec214c2e2351a2f948ed'],5,23,28,261363,3,1,1,1,711
6e9976f7e1285e1bde0d6f4abe1a438d801c57fe,0,Todd Lipcon,2013-12-16 18:13:37-08:00,['cec6cb9c00cd18fc94c0e7b5d27d65a0297ed0bb'],25,543,568,261931,7,0.736111111,1,0.777777778,713
720c450849741c6cd8beed277d1ca45621b54823,1,Michael Percy,2013-12-16 21:05:40-08:00,['6e9976f7e1285e1bde0d6f4abe1a438d801c57fe'],3,32,35,261966,2,0.166666667,1,1,713
7b72cd616e10ff79768405ad788e648078bcf139,0,David Alves,2013-12-17 08:21:24-08:00,['720c450849741c6cd8beed277d1ca45621b54823'],8,8,16,261982,4,,,,713
f7251b5f51bc4d62a1081f3e452c82664fcdb459,0,David Alves,2013-12-17 08:35:46-08:00,['7b72cd616e10ff79768405ad788e648078bcf139'],7,9,16,261998,1,,,,713
9b29fd7621594d7fe88931464ff8108c56faa7b8,0,Michael Percy,2013-12-18 05:25:03-08:00,['f7251b5f51bc4d62a1081f3e452c82664fcdb459'],9,9,18,262016,10,,,,713
e6307c5b999e8fb565d1cd928ad05e1f6da9db08,0,David Alves,2013-12-19 10:10:33-08:00,['9b29fd7621594d7fe88931464ff8108c56faa7b8'],7,8,15,262031,2,1,1,1,713
3dece7d461440d6525a2f02229645dc75a3379a5,0,Todd Lipcon,2013-12-19 14:01:40-08:00,['e6307c5b999e8fb565d1cd928ad05e1f6da9db08'],7,7,14,262045,1,0,0,0,713
5088c75e3e494ae37b057e46a7a82e3a1668ffae,1,Todd Lipcon,2013-12-19 17:29:08-08:00,['3dece7d461440d6525a2f02229645dc75a3379a5'],79,406,485,262530,27,0.387978142,0.37704918,0.568306011,714
31bcab725010d40350fe17806f0a74ebe542ba73,0,David Alves,2013-12-20 01:42:36-08:00,['5088c75e3e494ae37b057e46a7a82e3a1668ffae'],23,60,83,262613,4,,,,714
089e5dd21f827fdd5904dbb6313e277c881975ab,0,David Wang,2013-12-20 03:17:12-08:00,['31bcab725010d40350fe17806f0a74ebe542ba73'],3,3,6,262619,2,,,,714
b7ec8ec0f1fd30f0080934ae535e15f914b340a9,1,Todd Lipcon,2013-12-20 08:54:14-08:00,['089e5dd21f827fdd5904dbb6313e277c881975ab'],7,34,41,262660,2,0.692307692,0.692307692,1,714
b6c31b51af1948c8999d3fc0821911a377ff52da,0,Michael Percy,2013-12-20 14:33:40-08:00,['b7ec8ec0f1fd30f0080934ae535e15f914b340a9'],9,48,57,262717,3,,,,714
fca3af0e138cf1ab96532d419c961668c24baffa,1,Todd Lipcon,2013-12-21 14:53:50-08:00,['b6c31b51af1948c8999d3fc0821911a377ff52da'],1,1,2,262719,1,,,,714
98dd208b246cb02a31ecb84983c753b15aba6159,0,David Alves,2013-12-21 17:49:50-08:00,['fca3af0e138cf1ab96532d419c961668c24baffa'],1,4,5,262724,1,0,0,1,714
ec9b58f302e9c5dedaa3fd5ec6258de73faddfcc,0,Todd Lipcon,2013-12-23 08:02:35-08:00,['98dd208b246cb02a31ecb84983c753b15aba6159'],13,841,854,263578,8,1,1,1,718
dc642e3583fbe7d387998e5270e4b4b9919a7d3a,0,Todd Lipcon,2013-12-23 08:04:04-08:00,['ec9b58f302e9c5dedaa3fd5ec6258de73faddfcc'],21,108,129,263707,9,0.3,0.94,0.98,718
f12b9f67304cbd775107a026ea676e89112bbd81,0,Alex Feinberg,2013-12-23 10:32:11-08:00,['dc642e3583fbe7d387998e5270e4b4b9919a7d3a'],0,4,4,263711,1,,,,718
fcb6141533fcc627caaa1e47f539bdf864192ac1,0,David Alves,2013-12-23 16:20:48-08:00,['f12b9f67304cbd775107a026ea676e89112bbd81'],0,30,30,263741,1,1,1,1,718
2f831cbe8ba2eac36e26e315e377b225dbacb509,1,Todd Lipcon,2013-12-26 12:03:23-08:00,['fcb6141533fcc627caaa1e47f539bdf864192ac1'],1,31,32,263773,3,0.555555556,1,1,718
2e992b5657f7f62f1ad42551f43e02556e781229,0,Todd Lipcon,2013-12-27 10:42:30-08:00,['2f831cbe8ba2eac36e26e315e377b225dbacb509'],14,33,47,263820,3,1,1,1,718
fd54467dedcb1b8762dbf6ee68507d05b16a15b9,0,Todd Lipcon,2013-12-27 10:43:05-08:00,['2e992b5657f7f62f1ad42551f43e02556e781229'],0,39,39,263859,3,1,1,1,718
31be356ac4945c08beb3c901971f3da899b6fe48,1,Todd Lipcon,2013-12-27 11:48:50-08:00,['fd54467dedcb1b8762dbf6ee68507d05b16a15b9'],67,309,376,264235,14,0.523809524,0.952380952,0.79047619,720
996210f7ae92500a281068f695a7582fa2e80cfb,1,Todd Lipcon,2013-12-27 13:45:23-08:00,['31be356ac4945c08beb3c901971f3da899b6fe48'],15,95,110,264345,6,0.076923077,0.830769231,1,720
529b7f11db39e10828acd801443dd4bb9028adcb,1,Todd Lipcon,2013-12-27 13:46:01-08:00,['996210f7ae92500a281068f695a7582fa2e80cfb'],23,74,97,264442,14,0,0.9375,1,720
c18d46b3a5e575ee8604f8b7a5deae6735ceccc7,0,Todd Lipcon,2013-12-27 18:14:02-08:00,['529b7f11db39e10828acd801443dd4bb9028adcb'],2,16,18,264460,3,0.25,0.25,1,720
9bef16a0e93866c8c3ffa81ec6a9b3df8f83171d,0,Todd Lipcon,2013-12-27 19:08:53-08:00,['c18d46b3a5e575ee8604f8b7a5deae6735ceccc7'],0,149,149,264609,1,,,,721
7937ff7ca17b1586413cb6e0ac125fb3682e8a54,0,Brock Noland,2013-12-28 19:33:19-08:00,['9bef16a0e93866c8c3ffa81ec6a9b3df8f83171d'],1,3,4,264613,1,0,0,1,721
ba3addc67be610a06496a876d31595467c51231d,1,Todd Lipcon,2013-12-29 14:22:41-08:00,['7937ff7ca17b1586413cb6e0ac125fb3682e8a54'],181,196,377,264990,17,,,,721
6c9e294faf72f49b971f6f52d26b4dfdbdb371d6,0,Todd Lipcon,2013-12-30 10:31:03-08:00,['ba3addc67be610a06496a876d31595467c51231d'],16,27,43,265033,1,,,,721
8289c36d3dd1db205c840efd9e03529b1ebffbc2,0,Todd Lipcon,2013-12-30 12:32:13-08:00,['6c9e294faf72f49b971f6f52d26b4dfdbdb371d6'],1,1,2,265035,1,,,,721
e991e13ff6be96421017969541090306faa37cec,0,Michael Percy,2013-12-30 14:34:12-08:00,['8289c36d3dd1db205c840efd9e03529b1ebffbc2'],7,5,12,265047,4,0,0,1,721
2d5fdc744c197a835d640efd9914297f50cb98a0,1,Todd Lipcon,2014-01-02 11:53:16-08:00,['e991e13ff6be96421017969541090306faa37cec'],142,164,306,265353,51,0,0.863636364,0.636363636,721
67693b4ae9bf9deb9b8d1a827c072b3670b20977,0,Todd Lipcon,2014-01-02 14:10:00-08:00,['2d5fdc744c197a835d640efd9914297f50cb98a0'],0,399,399,265752,5,0.454545455,1,0.75,726
b0fd4d261b6092ca58c3eeb8fdb9e8984c719987,0,Todd Lipcon,2014-01-02 18:30:01-08:00,['67693b4ae9bf9deb9b8d1a827c072b3670b20977'],1,1,2,265754,1,,,,726
d814a56e9912850fd26d4428779c9f0ab67867e7,1,Todd Lipcon,2014-01-03 12:47:53-08:00,['b0fd4d261b6092ca58c3eeb8fdb9e8984c719987'],93,548,641,266395,28,0,1,0.522123894,726
861e5fbe22610e3075ac003d5e29df706d0b78b9,0,Todd Lipcon,2014-01-06 14:17:26-08:00,['d814a56e9912850fd26d4428779c9f0ab67867e7'],4,4,8,266403,2,,,,726
ef6a914761483e55db91c31968fdc1beb859fdf6,1,Todd Lipcon,2014-01-06 17:07:11-08:00,['861e5fbe22610e3075ac003d5e29df706d0b78b9'],198,383,581,266984,69,0,0.729032258,0.703225806,726
a2d2fb605ba46d9b5c830b015ccae9bc84f2557d,1,Todd Lipcon,2014-01-06 21:30:48-08:00,['ef6a914761483e55db91c31968fdc1beb859fdf6'],205,5089,5294,272278,19,0.317152104,0.462783172,0.987055016,734
6a368372db38b0c45b549b3f29ca251ccbf77756,0,Todd Lipcon,2014-01-06 21:31:14-08:00,['a2d2fb605ba46d9b5c830b015ccae9bc84f2557d'],5,22,27,272305,1,1,1,1,734
4569c9927f8c0cd7fb682bf68d299657626dd4d0,0,Michael Percy,2014-01-06 23:48:07-08:00,['6a368372db38b0c45b549b3f29ca251ccbf77756'],11,7,18,272323,1,,,,734
7623e5896269e44bf7c483f60c890e26de4e3822,0,Michael Percy,2014-01-06 23:50:23-08:00,['4569c9927f8c0cd7fb682bf68d299657626dd4d0'],12,16,28,272351,1,,,,734
87233326cc4b1b6d3bb0112031a1c15d57838701,1,Todd Lipcon,2014-01-07 14:48:03-08:00,['7623e5896269e44bf7c483f60c890e26de4e3822'],19,75,94,272445,5,0.268292683,0.634146341,0.634146341,734
087d728a394f8952cf77ec27c95406817ae060e9,1,Todd Lipcon,2014-01-07 14:50:40-08:00,['87233326cc4b1b6d3bb0112031a1c15d57838701'],101,1065,1166,273611,12,0.479830149,1,0.951167728,737
3043ec7b519e640d228ac19f1e8baa5cd9eec292,0,Todd Lipcon,2014-01-07 15:34:20-08:00,['087d728a394f8952cf77ec27c95406817ae060e9'],2,2,4,273615,2,,,,737
f7c1edfee38c4711be48b4feb7d46d729e9f2bc7,0,Todd Lipcon,2014-01-07 15:43:50-08:00,['3043ec7b519e640d228ac19f1e8baa5cd9eec292'],3,9,12,273627,1,0,1,1,737
1300fa51383d6a491a81b97f7934b86736932b23,0,Todd Lipcon,2014-01-07 15:48:29-08:00,['f7c1edfee38c4711be48b4feb7d46d729e9f2bc7'],15,0,15,273642,2,0,0,0,737
ec9cceb5b2057f89df29bb43555baf4b70739328,1,Todd Lipcon,2014-01-07 16:12:29-08:00,['1300fa51383d6a491a81b97f7934b86736932b23'],71,146,217,273859,11,1,1,1,737
0c31c6913f21b8b42406d3f52d3223fc7b234a15,0,Jean-Daniel Cryans,2014-01-07 16:44:11-08:00,['ec9cceb5b2057f89df29bb43555baf4b70739328'],0,33,33,273892,2,0.882352941,0,1,738
82f3c6f30e6b2870e9c87cf2b2ed69d4031923df,0,Todd Lipcon,2014-01-07 18:04:13-08:00,['0c31c6913f21b8b42406d3f52d3223fc7b234a15'],1,4,5,273897,1,,,,738
070a549732b6e057710880f58a17835e09d51bf9,1,Todd Lipcon,2014-01-08 09:49:58-08:00,['82f3c6f30e6b2870e9c87cf2b2ed69d4031923df'],161,192,353,274250,35,0,1,0.333333333,738
15d26e2411b78fc97243a03219494cef6008278f,0,Todd Lipcon,2014-01-08 11:55:22-08:00,['070a549732b6e057710880f58a17835e09d51bf9'],19,49,68,274318,3,0,0,0.5,738
1baf7d63cfed11c96877c3a73d527b0afb1a2122,1,Todd Lipcon,2014-01-08 14:21:13-08:00,['15d26e2411b78fc97243a03219494cef6008278f'],22,377,399,274717,11,0.399038462,0.735576923,0.985576923,739
de854591e59e2aad55b4cb4d0ca5cdf23b9336f5,0,Michael Percy,2014-01-08 15:31:48-08:00,['1baf7d63cfed11c96877c3a73d527b0afb1a2122'],2,0,2,274719,1,,,,739
fbb44cc84fbdbea3240fa5ed6d32e1ea6cf85a13,0,Todd Lipcon,2014-01-08 16:27:38-08:00,['de854591e59e2aad55b4cb4d0ca5cdf23b9336f5'],5,7,12,274731,1,1,0,0,739
b0af34c92a0ea0b9c9764798d514b6c5aadda7d4,1,Todd Lipcon,2014-01-09 08:39:39-08:00,['fbb44cc84fbdbea3240fa5ed6d32e1ea6cf85a13'],237,808,1045,275776,22,0.230519481,1,0.425324675,740
0a70458e48e35739067ecc778090afd58d9d781f,0,Todd Lipcon,2014-01-09 13:04:03-08:00,['b0af34c92a0ea0b9c9764798d514b6c5aadda7d4'],23,65,88,275864,3,1,1,1,741
4206dbf47b0a25f5220ad6da0364a1559f6a11fc,1,Todd Lipcon,2014-01-09 13:43:49-08:00,['0a70458e48e35739067ecc778090afd58d9d781f'],25,177,202,276066,12,0.716666667,1,0.566666667,741
d448eaa5793d0a67bf4802916eb6c2a196d2c7ca,1,Todd Lipcon,2014-01-09 13:44:52-08:00,['4206dbf47b0a25f5220ad6da0364a1559f6a11fc'],25,51,76,276142,7,0.625,1,1,741
f5ed33353b47234e8abaec3df58b070fbd41343a,0,Todd Lipcon,2014-01-09 14:14:46-08:00,['d448eaa5793d0a67bf4802916eb6c2a196d2c7ca'],2,2,4,276146,1,,,,741
5116f44cbda537c68688287919952914ba3bc099,0,Todd Lipcon,2014-01-10 10:39:02-08:00,['f5ed33353b47234e8abaec3df58b070fbd41343a'],45,491,536,276682,7,0.396296296,0.922222222,0.811111111,741
29e7c9019455e1e946e0cf3cef30ca6707773e1c,1,Todd Lipcon,2014-01-10 11:48:25-08:00,['5116f44cbda537c68688287919952914ba3bc099'],0,40,40,276722,2,0,1,1,741
b59126dc9fea205ee543bca0e36f8e374c29e61d,0,Jean-Daniel Cryans,2014-01-12 14:47:05-08:00,['29e7c9019455e1e946e0cf3cef30ca6707773e1c'],1,1,2,276724,1,,,,741
3738b583d7248cb0f913b69e3c9cfff68b837cdc,0,Todd Lipcon,2014-01-12 14:48:39-08:00,['b59126dc9fea205ee543bca0e36f8e374c29e61d'],2,2,4,276728,1,,,,741
cfd5e5e99709f4c0c2928ccb5880a8a6c3b3e75a,0,Todd Lipcon,2014-01-12 15:05:45-08:00,['3738b583d7248cb0f913b69e3c9cfff68b837cdc'],1,6,7,276735,1,0,0,0,741
a6c5d9fbb14bbb005d20eef309b57b769ad58721,0,Todd Lipcon,2014-01-12 15:17:53-08:00,['cfd5e5e99709f4c0c2928ccb5880a8a6c3b3e75a'],14,46,60,276795,1,0.962962963,0.962962963,1,741
8add16ab2831e546d51b34fac2fb2512fca5b04a,0,Michael Percy,2014-01-14 12:12:33-08:00,['a6c5d9fbb14bbb005d20eef309b57b769ad58721'],0,1,1,276796,1,1,1,0,741
7a60d0e87f0d9b2412177ddbb289132e186ae764,1,Michael Percy,2014-01-14 12:35:03-08:00,['8add16ab2831e546d51b34fac2fb2512fca5b04a'],15,108,123,276919,5,0.392857143,1,1,741
67011a5ebbd17c746b37deede8fda3394669bce9,1,Todd Lipcon,2014-01-14 12:48:59-08:00,['7a60d0e87f0d9b2412177ddbb289132e186ae764'],97,1533,1630,278549,15,0.504807692,0.924679487,0.942307692,744
4947034897e78bd2886fdc5a8536e3bd30194274,0,Todd Lipcon,2014-01-14 13:12:30-08:00,['67011a5ebbd17c746b37deede8fda3394669bce9'],1,10,11,278560,1,,,,744
04314c3947213769f6790e2e09b7b8cc56040a12,0,Todd Lipcon,2014-01-14 13:34:38-08:00,['4947034897e78bd2886fdc5a8536e3bd30194274'],66,80,146,278706,3,1,1,1,744
b30bb72c16076fa551722930d8cc99f7a6cddd58,1,Todd Lipcon,2014-01-14 13:44:01-08:00,['04314c3947213769f6790e2e09b7b8cc56040a12'],4,149,153,278859,10,0.641509434,1,1,747
79842cf00909251b4378da7cee094ff68331c4f7,0,Michael Percy,2014-01-15 17:14:34-08:00,['b30bb72c16076fa551722930d8cc99f7a6cddd58'],22,35,57,278916,5,0.857142857,1,1,747
dd22075d9a4739fb45e66b8abe00912ec2459eb3,0,Todd Lipcon,2014-01-16 15:34:55-08:00,['79842cf00909251b4378da7cee094ff68331c4f7'],1,1,2,278918,1,,,,747
1eea0a2abf98fb5de36f154c294a4141c76e5dab,1,Michael Percy,2014-01-16 21:40:56-08:00,['dd22075d9a4739fb45e66b8abe00912ec2459eb3'],35,60,95,279013,7,0,1,0,747
30cab06f5ef00f29fb38bb479f5c465d514b2999,0,Todd Lipcon,2014-01-20 15:36:22-08:00,['1eea0a2abf98fb5de36f154c294a4141c76e5dab'],61,293,354,279367,6,0.785123967,0.958677686,1,748
ec7f51944421485cba7e770ba5e2d96122c58d3d,0,Todd Lipcon,2014-01-20 15:40:18-08:00,['30cab06f5ef00f29fb38bb479f5c465d514b2999'],1,22,23,279390,2,0,0.785714286,1,748
38baf35390fdc4b046b1ddca1eb1ec37c61ca0ac,1,Todd Lipcon,2014-01-20 15:41:21-08:00,['ec7f51944421485cba7e770ba5e2d96122c58d3d'],9,25,34,279424,3,0,1,1,748
12d4d04aea635fca65aa9038bd9dc5b68306c05e,0,David Alves,2014-01-20 17:38:15-08:00,['38baf35390fdc4b046b1ddca1eb1ec37c61ca0ac'],4,6,10,279434,1,,,,748
7f7209a5c2b174b5bcdcff71310d6aea0e900e30,0,Todd Lipcon,2014-01-21 15:49:39-08:00,['12d4d04aea635fca65aa9038bd9dc5b68306c05e'],0,299,299,279733,4,0.814516129,1,1,751
1821964fbc2a7047f19089c01291ebf41296dadb,1,Todd Lipcon,2014-01-22 11:35:27-08:00,['7f7209a5c2b174b5bcdcff71310d6aea0e900e30'],17,26,43,279776,2,0,0,1,751
46c2601e8369f111289847aece49de56db92a3f6,1,Todd Lipcon,2014-01-22 11:35:41-08:00,['1821964fbc2a7047f19089c01291ebf41296dadb'],313,605,918,280694,6,0.550724638,1,0.934782609,752
0c2bc903a49e67057a45e81ce6314420f0215126,1,David Alves,2014-01-22 11:51:11-08:00,['46c2601e8369f111289847aece49de56db92a3f6'],33,105,138,280832,8,0.535714286,1,1,752
ec6198c05e3d39868ee7a8da5c0432c3d3d75cad,1,Todd Lipcon,2014-01-22 11:56:57-08:00,['0c2bc903a49e67057a45e81ce6314420f0215126'],0,79,79,280911,5,0.470588235,1,0.529411765,752
3f8db7e0dec8b54f0ec7d725b1fbcd263129a666,0,Michael Percy,2014-01-22 12:27:37-08:00,['ec6198c05e3d39868ee7a8da5c0432c3d3d75cad'],7,2,9,280920,1,0,0,0,752
ccd8651dcaa024fbf90e4cae514064708c5fbbd4,1,Todd Lipcon,2014-01-23 10:48:44-08:00,['3f8db7e0dec8b54f0ec7d725b1fbcd263129a666'],2,12,14,280934,3,0.333333333,1,1,752
9c21d75ec8bb59d8dbea0fc6612276ee671ccae4,1,Todd Lipcon,2014-01-23 10:49:05-08:00,['ccd8651dcaa024fbf90e4cae514064708c5fbbd4'],190,1014,1204,282138,17,0.185819071,0.601466993,0.723716381,753
0313adf45b2f518d787c7f0e55667af76348df82,1,Todd Lipcon,2014-01-23 11:07:39-08:00,['9c21d75ec8bb59d8dbea0fc6612276ee671ccae4'],2,7,9,282147,1,0,1,1,753
8038e8afd8255e4109bd09ffc8e06f26c786815f,1,Todd Lipcon,2014-01-24 15:23:36-08:00,['0313adf45b2f518d787c7f0e55667af76348df82'],65,146,211,282358,11,0.36,1,0.98,753
34329f1ed43823215ae7d0c491ccf13e65373167,0,Todd Lipcon,2014-01-25 22:09:17-08:00,['8038e8afd8255e4109bd09ffc8e06f26c786815f'],0,20,20,282378,2,1,1,1,753
5ba33fc075329daa61874c131190651d46738d7d,1,Todd Lipcon,2014-01-25 22:10:57-08:00,['34329f1ed43823215ae7d0c491ccf13e65373167'],24,67,91,282469,18,0.620689655,1,0.551724138,753
9e0e48abb5f779b465a410dc2466c6c2f506f66c,0,David Alves,2014-01-26 09:56:29-08:00,['5ba33fc075329daa61874c131190651d46738d7d'],2,2,4,282473,1,,,,753
24ce2459687547ff2dc6810b6c2e314ab205215c,1,Todd Lipcon,2014-01-27 11:28:00-08:00,['9e0e48abb5f779b465a410dc2466c6c2f506f66c'],55,222,277,282750,14,0.242105263,1,0.894736842,753
e7a72ca64af3838e62374498e91ca699adc918c1,1,Todd Lipcon,2014-01-27 11:28:14-08:00,['24ce2459687547ff2dc6810b6c2e314ab205215c'],34,505,539,283289,16,0.388185654,0.835443038,0.814345992,755
5b576d547e5d60bb3d36dd32b29083944b23b989,0,David Alves,2014-01-27 12:31:44-08:00,['e7a72ca64af3838e62374498e91ca699adc918c1'],95,134,229,283518,5,0.384615385,1,0,755
51b718aba929b1e00b59e97fa9291305a1306433,1,Todd Lipcon,2014-01-27 15:21:14-08:00,['5b576d547e5d60bb3d36dd32b29083944b23b989'],99,342,441,283959,7,0.633587786,1,0.938931298,756
12f240937a2555fdf6a8497282a111f07c5a5151,0,Todd Lipcon,2014-01-27 15:24:11-08:00,['51b718aba929b1e00b59e97fa9291305a1306433'],30,87,117,284076,4,0,1,0.181818182,756
653d52923daaa2d663dfa9430ea83064f883c932,0,Todd Lipcon,2014-01-27 15:24:15-08:00,['12f240937a2555fdf6a8497282a111f07c5a5151'],0,96,96,284172,3,0.56097561,1,1,758
5300958787d1fabdab46be3a669b0545875b3c63,1,Todd Lipcon,2014-01-27 17:22:03-08:00,['653d52923daaa2d663dfa9430ea83064f883c932'],9,8,17,284189,4,0,0,0,758
dc832dc87851284a8552364508a59257ee4f26bd,1,Todd Lipcon,2014-01-28 09:56:51-08:00,['5300958787d1fabdab46be3a669b0545875b3c63'],20,13,33,284222,8,,,,758
d138bdad35091ac9ee4189f948ff35d16f72a057,1,Todd Lipcon,2014-01-28 14:40:07-08:00,['dc832dc87851284a8552364508a59257ee4f26bd'],1,2,3,284225,1,0,1,1,758
cc637a1e75f2932bc98df47fb91459389e152423,0,Todd Lipcon,2014-01-28 14:46:33-08:00,['d138bdad35091ac9ee4189f948ff35d16f72a057'],85,0,85,284310,1,0.941176471,0,0.31372549,758
532e94f32f48db7e72304175a40ea8ebbd6b9ed3,1,Michael Percy,2014-01-28 16:07:10-08:00,['cc637a1e75f2932bc98df47fb91459389e152423'],2,91,93,284403,5,0,1,1,758
2bba2f7cc4d5b7f0064510efbe326ef8db680504,0,Todd Lipcon,2014-01-29 10:53:57-08:00,['532e94f32f48db7e72304175a40ea8ebbd6b9ed3'],0,87,87,284490,3,1,1,0.905660377,758
5f08e1ca48c239fae82de30100f4af61abbf2a09,0,Todd Lipcon,2014-01-29 10:54:20-08:00,['2bba2f7cc4d5b7f0064510efbe326ef8db680504'],8,30,38,284528,1,0,0,1,758
6610f6c9d49f665b9ad51b51416483a7194aee9d,1,Todd Lipcon,2014-01-29 10:54:36-08:00,['5f08e1ca48c239fae82de30100f4af61abbf2a09'],249,327,576,285104,28,1,1,0,758
ced9fb5c84e0783c7fe0448bba9f082e5705736e,1,Todd Lipcon,2014-01-29 10:55:52-08:00,['6610f6c9d49f665b9ad51b51416483a7194aee9d'],16,48,64,285168,3,0.607142857,1,1,758
4db62fe9527b6f07f9058431f2310108b6ce4d2d,1,Todd Lipcon,2014-01-29 11:15:11-08:00,['ced9fb5c84e0783c7fe0448bba9f082e5705736e'],74,401,475,285643,5,0.469194313,1,1,758
1992956d5779b075c4c75736fc2407163c52f252,1,David Alves,2014-01-29 11:23:31-08:00,['4db62fe9527b6f07f9058431f2310108b6ce4d2d'],76,98,174,285817,10,1,1,0,758
fe77f9121e72abdae73fd7b3bc1a213dad8bc0e6,0,David Alves,2014-01-30 13:41:09-08:00,['1992956d5779b075c4c75736fc2407163c52f252'],9,11,20,285837,7,0,1,1,758
5b4c282678eaf4c046e776fd5175e81a2289f92d,0,Todd Lipcon,2014-01-30 15:14:30-08:00,['fe77f9121e72abdae73fd7b3bc1a213dad8bc0e6'],9,210,219,286056,3,0.718181818,1,1,758
1fd5ebeabd11a0cb240941db554b7c147fcf35ad,0,Todd Lipcon,2014-01-31 17:11:32-08:00,['5b4c282678eaf4c046e776fd5175e81a2289f92d'],57,0,57,286113,3,0,0,0,758
b374c01af0939e69d3ba10a71ba7d6b14cb49e25,1,Todd Lipcon,2014-02-03 11:43:44-08:00,['1fd5ebeabd11a0cb240941db554b7c147fcf35ad'],23,699,722,286835,16,0.389784946,0.599462366,0.51344086,759
5e08f8490a3a89bb6aa11f51388132cb0d151f78,1,Michael Percy,2014-02-03 11:49:57-08:00,['b374c01af0939e69d3ba10a71ba7d6b14cb49e25'],0,8096,8096,294931,46,0.475935829,0.697593583,0.904545455,803
7caae51f88cd274017c966fd1dd01e62a0eb8f37,0,Todd Lipcon,2014-02-03 14:54:08-08:00,['5e08f8490a3a89bb6aa11f51388132cb0d151f78'],6,7,13,294944,2,1,1,1,803
7c850d0495af801c893cb3f162a1c28717c7606d,1,Todd Lipcon,2014-02-03 14:54:38-08:00,['7caae51f88cd274017c966fd1dd01e62a0eb8f37'],43,86,129,295073,4,0.733333333,0.9,0.8,803
7827277544e9a0c73d5f03b81af30c44169669d6,1,Todd Lipcon,2014-02-03 15:03:00-08:00,['7c850d0495af801c893cb3f162a1c28717c7606d'],40,30,70,295143,17,0,0,0,803
a6ec5794cde658f08af657818837bd390e90b222,0,Alex Feinberg,2014-02-03 15:45:21-08:00,['7827277544e9a0c73d5f03b81af30c44169669d6'],1,1,2,295145,1,,,,803
0ee87e5c62936419eee39f3a32f5f21decc7c2b5,0,Todd Lipcon,2014-02-03 15:47:03-08:00,['a6ec5794cde658f08af657818837bd390e90b222'],13,285,298,295443,5,0.038043478,0.554347826,0.554347826,803
50b07e64a0eb99c9d4f65ee728d336532bfc4eef,0,Todd Lipcon,2014-02-03 15:47:15-08:00,['0ee87e5c62936419eee39f3a32f5f21decc7c2b5'],13,168,181,295624,4,0.031914894,0.361702128,0.042553191,803
8636a6576a9bd2137e4a37e6cf145db2290bcc34,1,Todd Lipcon,2014-02-03 16:44:19-08:00,['50b07e64a0eb99c9d4f65ee728d336532bfc4eef'],102,206,308,295932,22,0.588235294,1,0.294117647,803
9bc7e746362344a521b63e88a1807877e58bdffa,0,Todd Lipcon,2014-02-03 17:16:05-08:00,['8636a6576a9bd2137e4a37e6cf145db2290bcc34'],1,1,2,295934,1,,,,803
7a9ab57892a6c1194b8d89bbbe9de6bc689fdeaf,1,David Alves,2014-02-04 15:15:38-08:00,['9bc7e746362344a521b63e88a1807877e58bdffa'],240,467,707,296641,19,0.529411765,0.955882353,0.838235294,807
22e7c7ae09362858f89d00588e3aec8bc405e62a,0,Todd Lipcon,2014-02-04 18:33:56-08:00,['7a9ab57892a6c1194b8d89bbbe9de6bc689fdeaf'],4,4,8,296649,1,,,,807
303c550c6c6d4a4389a3aa07aa95e9a4fda31168,0,Todd Lipcon,2014-02-05 10:35:41-08:00,['22e7c7ae09362858f89d00588e3aec8bc405e62a'],11,12,23,296672,4,0,0,0,807
18040aa3b68cf3227c234b9c21e8a1a2c2ed84b3,0,Todd Lipcon,2014-02-05 10:37:22-08:00,['303c550c6c6d4a4389a3aa07aa95e9a4fda31168'],1,2,3,296675,1,0,1,0,807
db6aae5f54ca88683537963a4c69352685f12a66,1,Todd Lipcon,2014-02-05 13:20:18-08:00,['18040aa3b68cf3227c234b9c21e8a1a2c2ed84b3'],1,45,46,296721,2,0,1,1,807
047d8ffce1ffa7bc0e6079d658d6c6e175f56561,0,Michael Percy,2014-02-05 15:22:53-08:00,['db6aae5f54ca88683537963a4c69352685f12a66'],0,3,3,296724,1,0,0,1,807
413f54f3715ee2013a397f03ab65bb4112187f45,1,Todd Lipcon,2014-02-05 15:42:24-08:00,['047d8ffce1ffa7bc0e6079d658d6c6e175f56561'],22,50,72,296796,1,0,0.25,0.142857143,807
3f2d4b6d857f3e787e6bafdcbfeb42dfa58b798c,0,Michael Percy,2014-02-05 15:45:54-08:00,['413f54f3715ee2013a397f03ab65bb4112187f45'],5,5,10,296806,3,,,,807
00bfc06ce9b3c1bca9c08efd39c7325bc3af3299,0,Todd Lipcon,2014-02-05 16:00:26-08:00,['3f2d4b6d857f3e787e6bafdcbfeb42dfa58b798c'],4,2,6,296812,3,,,,807
517b8fa606ef8d130b8249e1eceb70f8665d7ae8,0,Todd Lipcon,2014-02-05 17:23:07-08:00,['00bfc06ce9b3c1bca9c08efd39c7325bc3af3299'],6,6,12,296824,1,,,,807
e903a3b2c171af13fee727656a51a134921cbc64,0,Todd Lipcon,2014-02-05 17:23:33-08:00,['517b8fa606ef8d130b8249e1eceb70f8665d7ae8'],15,0,15,296839,1,,,,807
3ea983fdb591988b80e5e1ca3068000f8fff27bc,0,Todd Lipcon,2014-02-05 18:14:54-08:00,['e903a3b2c171af13fee727656a51a134921cbc64'],11,13,24,296863,1,,,,807
205e3b42501783548053b1b5aa81b0b2f654e446,0,Todd Lipcon,2014-02-05 18:19:49-08:00,['3ea983fdb591988b80e5e1ca3068000f8fff27bc'],6,198,204,297067,4,0.226277372,0.372262774,0.167883212,807
71f1c672ed5946ee8abaebe49f61a8f7e1ff8d78,1,Todd Lipcon,2014-02-05 21:00:37-08:00,['205e3b42501783548053b1b5aa81b0b2f654e446'],12,49,61,297128,2,0.115384615,1,0.538461538,807
b0cb87a0dc1bbb3f83d3cdfce3daa705d9fd948e,1,Todd Lipcon,2014-02-05 21:03:20-08:00,['71f1c672ed5946ee8abaebe49f61a8f7e1ff8d78'],23,66,89,297217,16,0.296296296,1,0.592592593,807
5f2ba544935dff010b5123a05f8daa3d048d7d8a,0,Todd Lipcon,2014-02-06 15:13:02-08:00,['b0cb87a0dc1bbb3f83d3cdfce3daa705d9fd948e'],1,1,2,297219,1,,,,807
c68f2bd80ade0fb76ef3d14177aaf54995a6d4f5,1,Todd Lipcon,2014-02-06 15:29:10-08:00,['5f2ba544935dff010b5123a05f8daa3d048d7d8a'],3,14,17,297236,5,0.666666667,0.666666667,0.5,807
591d29101cad889a81443e7d1381a99fd4662493,1,Todd Lipcon,2014-02-06 16:12:10-08:00,['c68f2bd80ade0fb76ef3d14177aaf54995a6d4f5'],0,210,210,297446,5,0.504,0.952,0.768,807
6f69af66b5bb8dbb51a48f845fe77ed5262799cf,1,Todd Lipcon,2014-02-06 18:47:32-08:00,['591d29101cad889a81443e7d1381a99fd4662493'],36,45,81,297527,7,0,0,1,808
62ea934f337032da49111c1eea4961fb9c1042fe,0,Todd Lipcon,2014-02-06 22:06:18-08:00,['6f69af66b5bb8dbb51a48f845fe77ed5262799cf'],2,13,15,297542,2,0.888888889,1,1,808
f49aba7df8f5469ebbca51ec6d48a0f114f26fe6,1,Todd Lipcon,2014-02-06 22:06:30-08:00,['62ea934f337032da49111c1eea4961fb9c1042fe'],7,20,27,297569,2,0,0,1,808
a4632d9ee662a2ee5ca4b34aba3a0748c2270317,0,Alex Feinberg,2014-02-06 22:31:03-08:00,['f49aba7df8f5469ebbca51ec6d48a0f114f26fe6'],1,1,2,297571,1,,,,808
d885e458da3df0338d5d6d9ec47a71bcc53db810,1,Michael Percy,2014-02-07 00:01:07-08:00,['a4632d9ee662a2ee5ca4b34aba3a0748c2270317'],4,58,62,297633,4,0.1875,1,0.6875,808
6a7506db972a8daf584be71d80101e713ac9607f,1,Michael Percy,2014-02-07 00:10:16-08:00,['d885e458da3df0338d5d6d9ec47a71bcc53db810'],2,284,286,297919,5,0.233532934,0.556886228,0.778443114,810
770eb92ff0f80f7062a2c2efcd127dd8d4b0273a,1,Michael Percy,2014-02-07 00:24:20-08:00,['6a7506db972a8daf584be71d80101e713ac9607f'],5,107,112,298031,6,0.219512195,1,1,812
a839afa0bab265b1223514338369b884035e1c02,1,Alex Feinberg,2014-02-07 01:27:59-08:00,['770eb92ff0f80f7062a2c2efcd127dd8d4b0273a'],1,404,405,298436,3,0.584,0.72,0.604,813
315811807f62862f6821c42516a8633be454ea68,0,Jean-Daniel Cryans,2014-02-07 09:06:01-08:00,['a839afa0bab265b1223514338369b884035e1c02'],3,2,5,298441,1,0,1,0,813
75c6613ce832bf644f38cc81b6e05f9fe0c31a5a,1,Todd Lipcon,2014-02-07 11:50:51-08:00,['315811807f62862f6821c42516a8633be454ea68'],23,36,59,298500,1,1,1,0.125,813
f88ca67401f80a8be4ad53ec76e94b146ab39af1,0,Todd Lipcon,2014-02-07 11:50:58-08:00,['75c6613ce832bf644f38cc81b6e05f9fe0c31a5a'],6,10,16,298516,1,0,0,0,813
7409b397c8755a7c37ba88a56ab1bc48e861bf0f,0,Todd Lipcon,2014-02-07 11:51:57-08:00,['f88ca67401f80a8be4ad53ec76e94b146ab39af1'],1,15,16,298532,3,0.333333333,0.333333333,0,813
7f48d11c8afcf41956f9f57e479966c7efbe0d7f,1,Alex Feinberg,2014-02-07 17:52:46-08:00,['7409b397c8755a7c37ba88a56ab1bc48e861bf0f'],206,319,525,299057,19,0.11627907,1,0.790697674,813
6b9e50112eb67216fab07c848f3a033aaadfab7c,1,Todd Lipcon,2014-02-10 10:58:09-08:00,['7f48d11c8afcf41956f9f57e479966c7efbe0d7f'],0,334,334,299391,4,0.552795031,1,1,816
9def8fe9299c2ecdb1985ddf1b243c8b1830913a,1,Todd Lipcon,2014-02-10 10:59:06-08:00,['6b9e50112eb67216fab07c848f3a033aaadfab7c'],0,100,100,299491,7,0.590163934,1,0.590163934,816
8b8da2da231e41bf2077dd4473e07d117dc0dfcf,0,Todd Lipcon,2014-02-11 12:49:38-08:00,['9def8fe9299c2ecdb1985ddf1b243c8b1830913a'],5,7,12,299503,1,1,0,0,816
da0a8bc72fc7614a9f4b82f0789a398449eca20e,1,Todd Lipcon,2014-02-11 17:20:52-08:00,['8b8da2da231e41bf2077dd4473e07d117dc0dfcf'],83,118,201,299704,5,,,,818
933f4e4a093d933643f2adc296927c7eb2e14bdb,1,Todd Lipcon,2014-02-11 17:20:58-08:00,['da0a8bc72fc7614a9f4b82f0789a398449eca20e'],4,7,11,299715,1,0,1,1,818
f70569f35c533777382b52edce9802b44437991d,1,Todd Lipcon,2014-02-11 17:21:01-08:00,['933f4e4a093d933643f2adc296927c7eb2e14bdb'],1,120,121,299836,4,0.227848101,1,1,818
cca975d06ce1fd348472f40e2688bab29b778e5c,1,Todd Lipcon,2014-02-12 15:53:07-08:00,['f70569f35c533777382b52edce9802b44437991d'],26,175,201,300037,6,0.518518519,0.567901235,0.938271605,819
c4741d7d978d51da980a2a2ed467e76d3dff29d7,1,Alex Feinberg,2014-02-12 17:47:09-08:00,['cca975d06ce1fd348472f40e2688bab29b778e5c'],21,21,42,300079,4,,,,819
a8e0ea169cd1eb2017b26b63d515eb2bcfe2d420,0,Todd Lipcon,2014-02-12 22:34:03-08:00,['c4741d7d978d51da980a2a2ed467e76d3dff29d7'],3,3,6,300085,2,,,,819
a4c9e708c34e71412b32b82def555fb13876dd66,0,Alex Feinberg,2014-02-13 01:21:35-08:00,['a8e0ea169cd1eb2017b26b63d515eb2bcfe2d420'],1,1,2,300087,1,,,,819
db3af0a91afbcc6de7e7c41004cb807c9be38390,1,Todd Lipcon,2014-02-14 14:00:44-08:00,['a4c9e708c34e71412b32b82def555fb13876dd66'],0,523,523,300610,4,0.380530973,0.85840708,0.831858407,822
63b8423a47e21bdc66a63efb919c19c775933274,1,Todd Lipcon,2014-02-14 14:51:54-08:00,['db3af0a91afbcc6de7e7c41004cb807c9be38390'],7,193,200,300810,5,0.547826087,0.730434783,0.782608696,822
ba7326441e142c231db8da929306df4a8400ba39,1,Todd Lipcon,2014-02-14 14:51:59-08:00,['63b8423a47e21bdc66a63efb919c19c775933274'],23,139,162,300972,13,0.28,0,0.6,822
3ab756a220e33a0ae140218f4a9cd27a86c0d7f4,0,Todd Lipcon,2014-02-14 15:08:04-08:00,['ba7326441e142c231db8da929306df4a8400ba39'],18,48,66,301038,3,0,1,1,822
6a7093575ed9fb3f272d746a9063c1f29cc5cace,0,Todd Lipcon,2014-02-18 14:30:26-08:00,['3ab756a220e33a0ae140218f4a9cd27a86c0d7f4'],0,1,1,301039,1,1,1,1,822
9961aa19208e474e793f6bf4973cab07df2c4227,0,David Alves,2014-02-18 14:48:54-08:00,['6a7093575ed9fb3f272d746a9063c1f29cc5cace'],74,160,234,301273,9,0.769230769,1,0.653846154,822
134192dcb7cd5e0ca5525dc109348e692b73e7ca,0,David Alves,2014-02-18 15:58:07-08:00,['9961aa19208e474e793f6bf4973cab07df2c4227'],9,9,18,301291,4,,,,822
b9dbae3113ae292637e17daebdc2f5c2fb030b83,1,David Alves,2014-02-18 21:31:33-08:00,['134192dcb7cd5e0ca5525dc109348e692b73e7ca'],64,46,110,301401,11,0,0,0.5,822
3fe3d4e35945dca291b8ba33c3ff7dc2b1d3073c,1,Alex Feinberg,2014-02-18 21:48:27-08:00,['b9dbae3113ae292637e17daebdc2f5c2fb030b83'],289,797,1086,302487,11,0.451104101,0.886435331,0.943217666,824
85cb8592c4979e48648bf6cff5e1f85f98b4ae77,0,Jean-Daniel Cryans,2014-02-19 09:28:45-08:00,['3fe3d4e35945dca291b8ba33c3ff7dc2b1d3073c'],2,2,4,302491,1,,,,824
80055a197c682f04ada0c333cc2f36d78275f93a,0,Jean-Daniel Cryans,2014-02-19 09:29:29-08:00,['85cb8592c4979e48648bf6cff5e1f85f98b4ae77'],0,8,8,302499,1,,,,825
60c43745cc778e4667c96570706cab104d34e06b,0,Todd Lipcon,2014-02-19 11:28:06-08:00,['80055a197c682f04ada0c333cc2f36d78275f93a'],0,5,5,302504,1,,,,825
882b423a01dcf40ed6a0b4aa187191762a51f8b9,1,Michael Percy,2014-02-19 14:07:45-08:00,['60c43745cc778e4667c96570706cab104d34e06b'],96,131,227,302731,18,0.6,1,1,825
f097207874e454ce19946e5c8ca14ad7eedc64f5,1,Michael Percy,2014-02-19 14:07:58-08:00,['882b423a01dcf40ed6a0b4aa187191762a51f8b9'],24,30,54,302785,3,,,,825
a4a9a79249fd2b89b300e1675a237bf4c40f0521,0,Michael Percy,2014-02-19 21:01:05-08:00,['f097207874e454ce19946e5c8ca14ad7eedc64f5'],0,7,7,302792,1,,,,825
a19891ee000a7d0fadb441b92c4f9c0a29cd0a32,1,Todd Lipcon,2014-02-20 14:58:02-08:00,['a4a9a79249fd2b89b300e1675a237bf4c40f0521'],1,44,45,302837,2,0,0.733333333,0.733333333,825
7bfade01a097acc158abc699f611196a6aa20ce4,1,Todd Lipcon,2014-02-20 16:15:10-08:00,['a19891ee000a7d0fadb441b92c4f9c0a29cd0a32'],19,64,83,302920,7,0.142857143,1,0.5,825
6ec2d3ecdba3dd9fb53f87a2878eaee61f4e399f,0,David Alves,2014-02-20 16:16:31-08:00,['7bfade01a097acc158abc699f611196a6aa20ce4'],30,52,82,303002,9,1,1,1,825
9c1ead6cb6b7ae590d43f22adc5245d11653c5dd,0,David Alves,2014-02-20 16:17:01-08:00,['6ec2d3ecdba3dd9fb53f87a2878eaee61f4e399f'],0,17,17,303019,3,1,1,1,825
b4cbbddfbba7e25113a826b0b570f8ceb6811b07,1,Todd Lipcon,2014-02-20 20:04:03-08:00,['9c1ead6cb6b7ae590d43f22adc5245d11653c5dd'],92,348,440,303459,7,0.440993789,0.857142857,0.652173913,825
79d98d70ce85d3c6277b99c596fdc5e5672395cd,0,David Alves,2014-02-21 14:51:36-08:00,['b4cbbddfbba7e25113a826b0b570f8ceb6811b07'],9,78,87,303546,3,1,1,1,825
d7c224fe08e97a471990fa9355be174c26ebf1d1,1,Jean-Daniel Cryans,2014-02-21 16:40:37-08:00,['79d98d70ce85d3c6277b99c596fdc5e5672395cd'],11,354,365,303911,9,0.559782609,0.559782609,0.842391304,828
8755a3c790916c7dd1e1fec3668e1e0c9cf8ee7c,1,Todd Lipcon,2014-02-24 14:18:50-08:00,['d7c224fe08e97a471990fa9355be174c26ebf1d1'],32,198,230,304141,8,0.403846154,0.653846154,0.798076923,828
01690b97b064d86f5791caf8868f9dcd412f60c6,0,Todd Lipcon,2014-02-24 14:18:57-08:00,['8755a3c790916c7dd1e1fec3668e1e0c9cf8ee7c'],1,2,3,304144,1,,,,828
b69c8380cfde186fb5067b9a9e49dbad944e585f,1,Todd Lipcon,2014-02-24 15:39:59-08:00,['01690b97b064d86f5791caf8868f9dcd412f60c6'],60,98,158,304302,15,0,0,0,830
6ecda5ce38605dbcfdd4924f39af3cbc347ca73e,0,Todd Lipcon,2014-02-24 15:40:03-08:00,['b69c8380cfde186fb5067b9a9e49dbad944e585f'],25,34,59,304361,4,1,1,1,830
4fdabf8bb8ad608b0f724e4db9aee3e3e934c236,1,Jean-Daniel Cryans,2014-02-24 16:05:41-08:00,['6ecda5ce38605dbcfdd4924f39af3cbc347ca73e'],1,54,55,304416,4,0,0.931818182,0.977272727,830
5c9858ab4e77d5de10fd07a12179e38976e01dd4,0,Jean-Daniel Cryans,2014-02-24 16:06:29-08:00,['4fdabf8bb8ad608b0f724e4db9aee3e3e934c236'],1,114,115,304531,3,0,0.402777778,1,831
b48bccf485274c51bbdfc33f2643426b7ae7ff8b,1,Todd Lipcon,2014-02-24 18:53:41-08:00,['5c9858ab4e77d5de10fd07a12179e38976e01dd4'],30,166,196,304727,5,0.560606061,0.848484848,0.96969697,831
21fc3bfe0beff57a9cda454fc080af2e7758af46,1,Todd Lipcon,2014-02-24 20:21:31-08:00,['b48bccf485274c51bbdfc33f2643426b7ae7ff8b'],70,82,152,304879,6,1,1,1,831
4ec53d1add5b3f69d8dab510981f8ced8de203fd,1,David Alves,2014-02-24 20:30:17-08:00,['21fc3bfe0beff57a9cda454fc080af2e7758af46'],45,204,249,305128,13,0,0.281818182,0.5,831
0bf851312c718e225b77f2487abb380226a6f13d,1,Jean-Daniel Cryans,2014-02-25 10:47:34-08:00,['4ec53d1add5b3f69d8dab510981f8ced8de203fd'],2,27,29,305157,3,0,1,1,831
da4a7bde9e2eb0dbb354f613e279e8c6816ed331,0,Alex Feinberg,2014-02-25 15:48:04-08:00,['0bf851312c718e225b77f2487abb380226a6f13d'],2,23,25,305182,3,0.9,1,0.8,831
1d716373d28c51ce8939d3425a6326a06792148d,0,Alex Feinberg,2014-02-25 17:45:27-08:00,['da4a7bde9e2eb0dbb354f613e279e8c6816ed331'],2,26,28,305210,2,0.647058824,1,1,831
5b2e8854c7873db2a132fdfddf09ebea3c1d0754,0,Michael Percy,2014-02-25 17:53:22-08:00,['1d716373d28c51ce8939d3425a6326a06792148d'],2,2,4,305214,1,,,,831
a004e3d6f1c8f51d09d5c86e49aff262a97229eb,1,Todd Lipcon,2014-02-25 21:36:56-08:00,['5b2e8854c7873db2a132fdfddf09ebea3c1d0754'],120,341,461,305675,10,0.980769231,1,1,836
4c80ae32191cc1969e8399aad359e7c38f7630b2,0,David Alves,2014-02-26 01:21:02-08:00,['a004e3d6f1c8f51d09d5c86e49aff262a97229eb'],2,2,4,305679,2,,,,836
e19afbd673f08ee1cf33f7235ae1cd1bc010f03a,0,Alex Feinberg,2014-02-26 10:59:07-08:00,['4c80ae32191cc1969e8399aad359e7c38f7630b2'],1,1,2,305681,1,,,,836
6fb25467c27184a57818dfcd11c1ec137e91e1d5,0,Michael Percy,2014-02-26 12:45:27-08:00,['e19afbd673f08ee1cf33f7235ae1cd1bc010f03a'],37,41,78,305759,12,0.666666667,0.666666667,0.666666667,836
b7b945a6c688d63c4968720e8bfeb93e36ae14fe,1,Todd Lipcon,2014-02-26 17:08:25-08:00,['6fb25467c27184a57818dfcd11c1ec137e91e1d5'],0,23,23,305782,6,0.785714286,1,1,836
0cc37a290dd17c902239aaf500c5c385040e954c,1,David Alves,2014-02-26 18:10:15-08:00,['b7b945a6c688d63c4968720e8bfeb93e36ae14fe'],406,398,804,306586,44,0.666666667,1,1,836
35804253d7d51f1140c3ea4158abdfd839b051bb,0,David Alves,2014-02-26 18:25:51-08:00,['0cc37a290dd17c902239aaf500c5c385040e954c'],86,99,185,306771,12,,,,837
4a0cf0440077ca9f192c98fb68b967ee59c613ef,1,Michael Percy,2014-02-27 14:59:43-08:00,['35804253d7d51f1140c3ea4158abdfd839b051bb'],83,83,166,306937,4,1,0,0,837
dccfb3f804f996b7680ae7410b8964e4f1247f6c,0,Michael Percy,2014-02-27 15:20:24-08:00,['4a0cf0440077ca9f192c98fb68b967ee59c613ef'],3,5,8,306945,3,,,,837
1b54f0e377060b1285f5ac617ce3f2e51497630a,1,Michael Percy,2014-02-27 21:47:42-08:00,['dccfb3f804f996b7680ae7410b8964e4f1247f6c'],0,271,271,307216,6,0.357798165,1,0.908256881,840
c278c084388e351d177c2adce5246edbe5da8f1b,0,Jean-Daniel Cryans,2014-02-28 14:05:27-08:00,['1b54f0e377060b1285f5ac617ce3f2e51497630a'],18,12,30,307246,6,0,0,0,840
7d6a0aece5867f5aa0c303729b7a5f9b0f74acea,0,Todd Lipcon,2014-03-01 18:42:01-08:00,['c278c084388e351d177c2adce5246edbe5da8f1b'],2,21,23,307269,3,0.833333333,1,1,840
2df35aa29099f111d3e277eb9404dc546c631671,1,Todd Lipcon,2014-03-03 14:24:51-08:00,['7d6a0aece5867f5aa0c303729b7a5f9b0f74acea'],71,255,326,307595,36,0.381578947,0.960526316,0.447368421,840
ea5dbb4dc6165edf0aace58c98a831453b645f4e,1,Todd Lipcon,2014-03-03 14:31:10-08:00,['2df35aa29099f111d3e277eb9404dc546c631671'],12,24,36,307631,4,0,0.25,0.75,840
68afac62337482438d218a923b016c5f1b70a299,0,Todd Lipcon,2014-03-03 17:24:27-08:00,['ea5dbb4dc6165edf0aace58c98a831453b645f4e'],0,110,110,307741,1,,,,840
9325fbbb6ddce336c4866092eca6c22de701c8d7,1,Alex Feinberg,2014-03-03 18:16:52-08:00,['68afac62337482438d218a923b016c5f1b70a299'],3,20,23,307764,1,0,0,1,840
c97f08f8b8320e03e8f3504ecf73754c3becd1a7,1,Todd Lipcon,2014-03-06 11:06:48-08:00,['9325fbbb6ddce336c4866092eca6c22de701c8d7'],0,64,64,307828,1,1,1,1,841
de3aa066f3cdb6a47405ccdbd804c1cbb7b34c4c,0,Todd Lipcon,2014-03-06 11:07:30-08:00,['c97f08f8b8320e03e8f3504ecf73754c3becd1a7'],26,0,26,307854,1,,,,841
e402ce477d7db1098f5dadbc3ac310edcfc9c991,0,Todd Lipcon,2014-03-06 11:09:59-08:00,['de3aa066f3cdb6a47405ccdbd804c1cbb7b34c4c'],48,53,101,307955,5,0.375,0.5,0.625,841
f40536e636a75db14695cf70ea5eec9cc51df428,0,Todd Lipcon,2014-03-06 11:10:37-08:00,['e402ce477d7db1098f5dadbc3ac310edcfc9c991'],0,5,5,307960,3,0.666666667,0.666666667,1,841
59422891bbf9d8e9fb882d6f024e5f2b6c3b5076,1,Todd Lipcon,2014-03-06 11:23:18-08:00,['f40536e636a75db14695cf70ea5eec9cc51df428'],2,527,529,308489,8,0.565400844,1,0.974683544,844
e77c0bcd7ec731f05eb3948a25e93df6dd356345,1,Todd Lipcon,2014-03-06 11:25:58-08:00,['59422891bbf9d8e9fb882d6f024e5f2b6c3b5076'],1,140,141,308630,9,0.256756757,1,0.810810811,844
7d95d500235eb6c576d77bf4b036549cadeab2fe,1,David Alves,2014-03-06 15:32:06-08:00,['e77c0bcd7ec731f05eb3948a25e93df6dd356345'],16,619,635,309265,9,0.534412955,0.692307692,1,847
33d9462f1e063b195014cb6f73fbe15b0f26c6d2,1,Todd Lipcon,2014-03-06 16:28:34-08:00,['7d95d500235eb6c576d77bf4b036549cadeab2fe'],8,64,72,309337,4,0.708333333,1,0.875,847
db056f25bfb4bc3c82ee11ce73abcbbcf9be094a,0,Todd Lipcon,2014-03-06 16:41:59-08:00,['33d9462f1e063b195014cb6f73fbe15b0f26c6d2'],57,87,144,309481,7,0.032258065,0.612903226,0.806451613,847
a6ab8bdfde2d87b82b95a4a251486a5ce8bcf1a7,1,Jean-Daniel Cryans,2014-03-06 17:15:02-08:00,['db056f25bfb4bc3c82ee11ce73abcbbcf9be094a'],3,364,367,309848,5,0.344444444,0.6,1,848
0305657efa18170919457c8eeff22c794e4b1536,0,Michael Percy,2014-03-06 18:45:49-08:00,['a6ab8bdfde2d87b82b95a4a251486a5ce8bcf1a7'],0,5,5,309853,2,0,0,1,848
e97da592adaf754477b4c54c99ee5ad102197e41,0,Todd Lipcon,2014-03-06 23:45:33-08:00,['0305657efa18170919457c8eeff22c794e4b1536'],3,0,3,309856,1,1,0,0,848
d42346ba98b3fc018c90661b1c63e766bd56d1de,0,Todd Lipcon,2014-03-06 23:52:46-08:00,['e97da592adaf754477b4c54c99ee5ad102197e41'],4,4,8,309864,1,,,,848
8a001a47ee1e3033ba676e1ae4375ebb78a4cd38,1,David Alves,2014-03-07 00:22:14-08:00,['d42346ba98b3fc018c90661b1c63e766bd56d1de'],43,52,95,309959,9,0.666666667,1,1,848
4aa08f6fdd888d40f2a8b56ec83ef7a679b1b31f,0,Jean-Daniel Cryans,2014-03-07 15:45:16-08:00,['8a001a47ee1e3033ba676e1ae4375ebb78a4cd38'],4,139,143,310102,6,0,0.8,0.694117647,848
c64f2f76cb93fd7047d6bb20381aa0485aec1339,1,Jean-Daniel Cryans,2014-03-07 15:46:59-08:00,['4aa08f6fdd888d40f2a8b56ec83ef7a679b1b31f'],0,18,18,310120,4,1,1,0,848
793a77ff1d6478ec6c9aa91335e25462e0d3abd1,1,David Alves,2014-03-10 12:09:15-07:00,['c64f2f76cb93fd7047d6bb20381aa0485aec1339'],1,52,53,310173,2,0.071428571,1,1,848
d0c4fe6111b199ebfea71c3c9e977c37148586fe,0,Todd Lipcon,2014-03-10 12:55:06-07:00,['793a77ff1d6478ec6c9aa91335e25462e0d3abd1'],8,8,16,310189,1,,,,848
b6924049493723b53d8b77c66435f5af1883f15d,0,Michael Percy,2014-03-10 14:19:04-07:00,['d0c4fe6111b199ebfea71c3c9e977c37148586fe'],0,384,384,310573,1,,,,849
a267ee806d70272090dbf8b0022400c531e178b9,0,Todd Lipcon,2014-03-10 18:18:46-07:00,['b6924049493723b53d8b77c66435f5af1883f15d'],0,1,1,310574,1,1,1,1,849
b0134e601f44aa611905412f2123497ccd8691ab,1,Todd Lipcon,2014-03-10 18:22:37-07:00,['a267ee806d70272090dbf8b0022400c531e178b9'],255,244,499,311073,4,0,1,0.285714286,849
7ef68e7efa92e7dd902050a3c6d09524466e2b7b,1,Todd Lipcon,2014-03-10 18:23:48-07:00,['b0134e601f44aa611905412f2123497ccd8691ab'],12,68,80,311153,3,0.555555556,1,0.916666667,849
d0cf7bd999334019c1929ea7451a213eb70abcb5,0,David Alves,2014-03-11 03:22:57-07:00,['7ef68e7efa92e7dd902050a3c6d09524466e2b7b'],1,1,2,311155,1,,,,849
04cdd800e02608a1aa6e5a57acc1819f5cee6da9,0,Michael Percy,2014-03-11 12:46:24-07:00,['d0cf7bd999334019c1929ea7451a213eb70abcb5'],39,46,85,311240,3,,,,849
e0ac8ad8d638e675bfbd0bf9a1098b2efef850d6,1,Jean-Daniel Cryans,2014-03-11 14:01:26-07:00,['04cdd800e02608a1aa6e5a57acc1819f5cee6da9'],419,1217,1636,312876,20,0.637469586,0.703163017,0.649635036,856
d0e24f2e88fd840928273a6f7d27c2f71aa01cf4,0,Jean-Daniel Cryans,2014-03-11 14:01:37-07:00,['e0ac8ad8d638e675bfbd0bf9a1098b2efef850d6'],39,51,90,312966,3,0.785714286,0.928571429,1,856
c591926bbb0204ea1d5adae4f3bdbf51b4d85693,1,Todd Lipcon,2014-03-11 20:50:31-07:00,['d0e24f2e88fd840928273a6f7d27c2f71aa01cf4'],5,51,56,313022,4,0.944444444,0.944444444,1,856
fa8a517ff90f537282907be2ec6f06631635b543,0,Todd Lipcon,2014-03-11 23:26:52-07:00,['c591926bbb0204ea1d5adae4f3bdbf51b4d85693'],2,2,4,313026,1,,,,856
aa594cdc677d913615c73db64832ce0a7a7f40e3,1,Todd Lipcon,2014-03-11 23:47:24-07:00,['fa8a517ff90f537282907be2ec6f06631635b543'],259,831,1090,314116,22,0.263888889,0.413888889,0.272222222,856
be36e33b9d05e293f580084802d49de92bf3b636,1,Michael Percy,2014-03-12 00:52:01-07:00,['aa594cdc677d913615c73db64832ce0a7a7f40e3'],1049,1351,2400,316516,51,1,0.64,0.38,856
255e6eb0a0f121b2b000e833ca2416bad4ddead2,1,Michael Percy,2014-03-12 01:04:33-07:00,['be36e33b9d05e293f580084802d49de92bf3b636'],1,67,68,316584,6,0.432432432,0.945945946,0.945945946,856
fda62865eb0edd2334aa67c0f47bd03ed6b5c724,0,Todd Lipcon,2014-03-12 18:22:00-07:00,['255e6eb0a0f121b2b000e833ca2416bad4ddead2'],3,2,5,316589,1,,,,856
bd3517092f9d7e5a27e0d44a085ec1b15c4e8310,1,Todd Lipcon,2014-03-12 18:31:09-07:00,['fda62865eb0edd2334aa67c0f47bd03ed6b5c724'],3,9,12,316601,2,0.6,0.6,1,856
e5d58afa3820c28fdb6ab7a37ea38502b419fc09,1,Michael Percy,2014-03-12 22:29:47-07:00,['bd3517092f9d7e5a27e0d44a085ec1b15c4e8310'],10,146,156,316757,4,0.402298851,1,0.793103448,857
8f0f7ae33f61c35b05f4456e1c467c1f6e448347,0,Michael Percy,2014-03-12 22:31:13-07:00,['e5d58afa3820c28fdb6ab7a37ea38502b419fc09'],1,2,3,316760,1,1,1,1,857
7b3724c6ff9d980e08ca045eccd81ead469bf07a,1,David Alves,2014-03-13 01:36:19-07:00,['8f0f7ae33f61c35b05f4456e1c467c1f6e448347'],8,28,36,316796,2,0,0,0.125,857
1686f0177bfd556f1b687037549f7f7394ff701d,0,Todd Lipcon,2014-03-13 14:54:26-07:00,['7b3724c6ff9d980e08ca045eccd81ead469bf07a'],4,14,18,316814,2,1,1,1,857
d66f16e1590d4fc3a970ad84a8dd878838958c39,0,Michael Percy,2014-03-13 15:03:12-07:00,['1686f0177bfd556f1b687037549f7f7394ff701d'],2,10,12,316826,1,0.666666667,1,1,857
1f54243ce1a9d9718725fc447f704a61c1823909,1,Jean-Daniel Cryans,2014-03-14 10:31:36-07:00,['d66f16e1590d4fc3a970ad84a8dd878838958c39'],70,183,253,317079,4,0.5,1,0.743902439,857
746b58d64e8afce9c116e4078c7f185a09f4aea3,1,Todd Lipcon,2014-03-14 19:22:32-07:00,['1f54243ce1a9d9718725fc447f704a61c1823909'],20,239,259,317338,5,0.264150943,0.855345912,0.805031447,857
74d030b28da385e9ed6e8842d37acb9c92dd978e,0,Todd Lipcon,2014-03-14 19:24:32-07:00,['746b58d64e8afce9c116e4078c7f185a09f4aea3'],4,4,8,317346,2,,,,857
36a588151ad0a494d5bfee05a9f302ae0f2624b7,0,David Alves,2014-03-16 15:42:26-07:00,['74d030b28da385e9ed6e8842d37acb9c92dd978e'],3,14,17,317363,2,1,1,1,857
ae043e462e5d9a706ae08dd3215b8dfd15a7017e,0,Michael Percy,2014-03-16 23:22:57-07:00,['36a588151ad0a494d5bfee05a9f302ae0f2624b7'],17,23,40,317403,1,0.5,1,0.5,857
6adc79690f7753dfceaba42d0035e9d815656afc,0,Todd Lipcon,2014-03-17 14:22:51-07:00,['ae043e462e5d9a706ae08dd3215b8dfd15a7017e'],1,4,5,317408,1,,,,857
d932ac42e052febac13fc37de436e16d6265ead5,1,David Alves,2014-03-17 16:10:46-07:00,['6adc79690f7753dfceaba42d0035e9d815656afc'],34,65,99,317507,2,0,1,0,858
86364eea4be59a3edcab1b9212eca3330582a28c,1,Todd Lipcon,2014-03-17 18:55:47-07:00,['d932ac42e052febac13fc37de436e16d6265ead5'],89,155,244,317751,9,0.620689655,1,1,858
152ff259de7ea44c81e17c59fd4a7c5f41ba712e,1,Todd Lipcon,2014-03-17 19:38:22-07:00,['86364eea4be59a3edcab1b9212eca3330582a28c'],258,185,443,318194,23,,,,858
5291d99a205db3398d301e6ad735d1e26221fadf,0,Todd Lipcon,2014-03-17 22:12:43-07:00,['152ff259de7ea44c81e17c59fd4a7c5f41ba712e'],23,15,38,318232,1,1,1,0,858
ea8b985b95d724a7147779f6eb424e87b0f49f75,1,Todd Lipcon,2014-03-17 22:33:38-07:00,['5291d99a205db3398d301e6ad735d1e26221fadf'],1,45,46,318278,2,0.904761905,1,0.904761905,858
e7bf46b391ff0069d7f19f5e015abde595e5b624,1,Michael Percy,2014-03-17 23:11:44-07:00,['ea8b985b95d724a7147779f6eb424e87b0f49f75'],0,497,497,318775,4,0.531400966,1,0.859903382,861
d031ae9ca8b6af05afd1beab66f62964cabcc26a,0,Jean-Daniel Cryans,2014-03-18 10:41:04-07:00,['e7bf46b391ff0069d7f19f5e015abde595e5b624'],1,1,2,318777,1,,,,861
f98099589858f1f07e6e218048df4415c5237e83,1,Todd Lipcon,2014-03-18 14:28:00-07:00,['d031ae9ca8b6af05afd1beab66f62964cabcc26a'],81,97,178,318955,3,1,0.833333333,0,861
cbb3e7e6e5b70041fcbf31f908177d4964689133,1,Alex Feinberg,2014-03-18 14:51:00-07:00,['f98099589858f1f07e6e218048df4415c5237e83'],4,147,151,319106,7,0.578947368,0.789473684,0.789473684,863
514a7ac25af835a358532bd74cae1ef9d09eab0f,0,Michael Percy,2014-03-18 15:24:29-07:00,['cbb3e7e6e5b70041fcbf31f908177d4964689133'],8,16,24,319130,4,0,1,1,863
4f9b76d64dca71317dd6525ff79382eeda64aefe,0,Jean-Daniel Cryans,2014-03-19 10:33:24-07:00,['514a7ac25af835a358532bd74cae1ef9d09eab0f'],12,23,35,319165,2,1,1,1,863
68e5f989d42415ddc62a49f3f5d9986d243af1c6,0,Todd Lipcon,2014-03-19 13:09:33-07:00,['4f9b76d64dca71317dd6525ff79382eeda64aefe'],2,2,4,319169,1,,,,863
d350371fdb8fd4649b1ed1454027a2bc1afdcbf1,0,Todd Lipcon,2014-03-19 13:12:08-07:00,['68e5f989d42415ddc62a49f3f5d9986d243af1c6'],4,2,6,319175,1,0,0,0,863
b246f94c0a8b0073eedf437d118e2e771746802e,1,Todd Lipcon,2014-03-19 13:14:54-07:00,['d350371fdb8fd4649b1ed1454027a2bc1afdcbf1'],42,30,72,319247,3,0,0.666666667,0,863
8e8b532e7dde896a7bdfe9281ad9b3087b339ee1,0,Todd Lipcon,2014-03-19 13:15:47-07:00,['b246f94c0a8b0073eedf437d118e2e771746802e'],0,41,41,319288,3,,,,866
72d9346e65d304d036846107a21eb5b4698ee344,1,Todd Lipcon,2014-03-19 13:28:04-07:00,['8e8b532e7dde896a7bdfe9281ad9b3087b339ee1'],25,754,779,320067,8,0.814241486,1,0.72755418,869
7c207d67edbf2066720dd5959aec0ea6aedcd48e,1,Jean-Daniel Cryans,2014-03-19 15:17:40-07:00,['72d9346e65d304d036846107a21eb5b4698ee344'],12,36,48,320115,5,0.2,0.7,0.7,869
c68a67f579762884811d2d975f789087b309bb35,0,Todd Lipcon,2014-03-19 23:06:40-07:00,['7c207d67edbf2066720dd5959aec0ea6aedcd48e'],10,7,17,320132,3,1,1,0,869
d4c1df459c00c3b4680267737a35d2589da32175,0,Todd Lipcon,2014-03-19 23:30:58-07:00,['c68a67f579762884811d2d975f789087b309bb35'],2,2,4,320136,1,,,,869
1b70c62acb4b97bd0335e72b7668298a236c40cc,1,David Alves,2014-03-20 10:02:55-07:00,['d4c1df459c00c3b4680267737a35d2589da32175'],15,24,39,320175,1,0.222222222,1,0,869
c5a7080cd4b3cd4cb595321bea31c02e3eee9334,0,Jean-Daniel Cryans,2014-03-20 10:26:40-07:00,['1b70c62acb4b97bd0335e72b7668298a236c40cc'],5,9,14,320189,3,0,1,1,869
305b0df7692e0b54bbfb382d592acd63aa1189c9,1,Todd Lipcon,2014-03-20 14:55:44-07:00,['c5a7080cd4b3cd4cb595321bea31c02e3eee9334'],12,24,36,320225,1,1,1,1,869
f3bc830f05f2e6a7accf4311d19992089b703e72,0,Jean-Daniel Cryans,2014-03-20 14:58:28-07:00,['305b0df7692e0b54bbfb382d592acd63aa1189c9'],2,63,65,320290,1,0.911764706,1,1,869
427b6dc3fd131c8eb4c587cbbbbb73d17f36b4bf,0,Todd Lipcon,2014-03-20 15:07:32-07:00,['f3bc830f05f2e6a7accf4311d19992089b703e72'],15,8,23,320313,2,0.125,0,0,869
5282b928d9a578da042a5362acf75a1bf5ad5ebf,1,Michael Percy,2014-03-21 00:34:11-07:00,['427b6dc3fd131c8eb4c587cbbbbb73d17f36b4bf'],109,141,250,320563,22,0.722222222,1,1,869
cd7fb107012bbe84d0575dba62c0fa4855d7af56,0,Todd Lipcon,2014-03-21 11:25:21-07:00,['5282b928d9a578da042a5362acf75a1bf5ad5ebf'],18,23,41,320604,4,0.5,1,0,869
a966e19c742af4d32796ffd61b94a8e422a3cfc7,0,Todd Lipcon,2014-03-21 13:55:09-07:00,['cd7fb107012bbe84d0575dba62c0fa4855d7af56'],0,3,3,320607,1,0,0,1,869
1bc3e3901ca543761d9659754b9a372c631415f2,0,Todd Lipcon,2014-03-21 14:01:29-07:00,['a966e19c742af4d32796ffd61b94a8e422a3cfc7'],3,1,4,320611,1,1,0,0,869
cc80e2be53303ef634dbd51a99f0eed9aa553d88,1,Jean-Daniel Cryans,2014-03-21 14:22:29-07:00,['1bc3e3901ca543761d9659754b9a372c631415f2'],23,213,236,320847,8,0.708860759,1,1,871
f71fa593bda38a8a223486985881fe2fd5b572ba,1,Todd Lipcon,2014-03-21 17:24:46-07:00,['cc80e2be53303ef634dbd51a99f0eed9aa553d88'],2,41,43,320890,4,0,1,1,871
4615fd8566564ad0ed436ae0725d0cceae1ff75e,1,Todd Lipcon,2014-03-21 17:25:50-07:00,['f71fa593bda38a8a223486985881fe2fd5b572ba'],2,64,66,320956,3,0.944444444,1,1,872
20fe1bf0414e35b9c90127453138aae3c24d1344,1,Michael Percy,2014-03-21 18:15:34-07:00,['4615fd8566564ad0ed436ae0725d0cceae1ff75e'],36,552,588,321544,15,1,1,0.652173913,875
e8d1c9b0a9c6750df1387478431c8330b4bd0226,0,Michael Percy,2014-03-21 20:58:13-07:00,['20fe1bf0414e35b9c90127453138aae3c24d1344'],0,1,1,321545,1,1,1,1,875
a50bc1a829b531ef23e65879e89d4174d510c841,0,Michael Percy,2014-03-21 21:23:16-07:00,['e8d1c9b0a9c6750df1387478431c8330b4bd0226'],5,9,14,321559,1,,,,875
2d1d01dfab51944eacb1eb11b28b6cb7d443c244,0,Michael Percy,2014-03-21 22:26:07-07:00,['a50bc1a829b531ef23e65879e89d4174d510c841'],3,13,16,321575,1,0.888888889,1,1,875
7a24d8300bd6a885ab6445cc103fd7ae2613a72d,0,Michael Percy,2014-03-21 22:27:26-07:00,['2d1d01dfab51944eacb1eb11b28b6cb7d443c244'],3,4,7,321582,1,,,,875
f855ca243079169ca35c15c1737528abfee5803c,0,Michael Percy,2014-03-21 22:35:30-07:00,['7a24d8300bd6a885ab6445cc103fd7ae2613a72d'],7,23,30,321612,2,0.888888889,1,1,875
2e7ef7469206454893f302284bd0711fdf8e49dd,0,Michael Percy,2014-03-21 22:36:27-07:00,['f855ca243079169ca35c15c1737528abfee5803c'],1,1,2,321614,1,,,,875
e6aaf0e199ac9eba48f68f7acaac9b6636758442,0,Todd Lipcon,2014-03-21 23:05:07-07:00,['2e7ef7469206454893f302284bd0711fdf8e49dd'],11,9,20,321634,2,0,0,0,875
b8fb0ce0d2b309cc66b742f88d82c90a6e1de0a2,0,Todd Lipcon,2014-03-21 23:05:22-07:00,['e6aaf0e199ac9eba48f68f7acaac9b6636758442'],17,86,103,321737,5,0.208333333,0.875,0.854166667,875
2721fc118f11dada54ce61de7e380a3208861438,0,Michael Percy,2014-03-23 22:53:44-07:00,['b8fb0ce0d2b309cc66b742f88d82c90a6e1de0a2'],1,2,3,321740,1,,,,875
d0febeecd047c4cd1bfcbb71f53a2e9b0fdfbcc4,0,Michael Percy,2014-03-23 23:20:32-07:00,['2721fc118f11dada54ce61de7e380a3208861438'],0,3,3,321743,1,1,1,0,875
da185e494b20c7f7fa51be03521fb4836bf3622d,0,Michael Percy,2014-03-23 23:21:14-07:00,['d0febeecd047c4cd1bfcbb71f53a2e9b0fdfbcc4'],2,9,11,321754,1,1,1,0,875
3b20406d444c8a51fc7fafb677de7c318b9248fc,0,Todd Lipcon,2014-03-24 09:12:16-07:00,['da185e494b20c7f7fa51be03521fb4836bf3622d'],1,1,2,321756,1,,,,875
f04575af565a299e347979c365a40e0f874b78b6,0,Todd Lipcon,2014-03-24 09:12:41-07:00,['3b20406d444c8a51fc7fafb677de7c318b9248fc'],1,1,2,321758,1,,,,875
2f590daeaf9236eeec8f1cd6b66719795473ce1d,1,Todd Lipcon,2014-03-24 16:26:16-07:00,['f04575af565a299e347979c365a40e0f874b78b6'],24,170,194,321952,15,0.288461538,0.596153846,0.826923077,877
8d1840799e8f4bb0fb3139138095917c83d60164,0,Todd Lipcon,2014-03-24 17:22:36-07:00,['2f590daeaf9236eeec8f1cd6b66719795473ce1d'],3,15,18,321970,3,,,,877
b787f2b59fa295e787bea8b4c2f9e82ad4b02cbf,0,Alex Feinberg,2014-03-24 18:10:20-07:00,['8d1840799e8f4bb0fb3139138095917c83d60164'],13,27,40,322010,2,0.230769231,1,1,877
069da26925c36edfccfe7ebcad7065cf607995f7,1,Todd Lipcon,2014-03-25 10:17:01-07:00,['b787f2b59fa295e787bea8b4c2f9e82ad4b02cbf'],50,67,117,322127,15,1,1,1,877
207ffa18f521efa093619cd6c2ebf37285f8926b,1,Jean-Daniel Cryans,2014-03-25 10:29:46-07:00,['069da26925c36edfccfe7ebcad7065cf607995f7'],9,36,45,322172,4,0.869565217,1,1,877
6d658965ea4a34844fbf8a559740785d35805623,0,Michael Percy,2014-03-25 14:32:07-07:00,['207ffa18f521efa093619cd6c2ebf37285f8926b'],8,32,40,322212,1,0.947368421,1,1,877
01edd7a8a698d0bc6de6cbd0093f22ccb7841b2f,1,Michael Percy,2014-03-25 16:43:09-07:00,['6d658965ea4a34844fbf8a559740785d35805623'],0,103,103,322315,4,0.25,1,0.826923077,878
961e529e1ad95bc0235a35d5225a5f38cba61722,1,Todd Lipcon,2014-03-25 17:09:37-07:00,['01edd7a8a698d0bc6de6cbd0093f22ccb7841b2f'],75,113,188,322503,7,0.297297297,0.135135135,0.945945946,878
3c5e206b96f04ccf1259a77970aac3c4c799142a,0,Todd Lipcon,2014-03-25 17:41:12-07:00,['961e529e1ad95bc0235a35d5225a5f38cba61722'],0,98,98,322601,1,0.728813559,0.728813559,0.881355932,879
8d20ca1d78dd80371a4b1c59514458897d9f82fd,1,Todd Lipcon,2014-03-26 10:03:07-07:00,['3c5e206b96f04ccf1259a77970aac3c4c799142a'],13,144,157,322758,6,1,1,1,881
b4909f041e4d593b21bc3e086e4286eab3014866,0,Jean-Daniel Cryans,2014-03-26 13:10:29-07:00,['8d20ca1d78dd80371a4b1c59514458897d9f82fd'],4,41,45,322803,2,,,,881
07db3407e2e5b4c47d1688c44c9bad288d0e2372,1,Todd Lipcon,2014-03-26 14:16:56-07:00,['b4909f041e4d593b21bc3e086e4286eab3014866'],333,80,413,323216,16,1,0.735849057,0.018867925,881
b5d374d11cec3b2660caf7b498d5cc19064ad504,0,Todd Lipcon,2014-03-26 16:44:50-07:00,['07db3407e2e5b4c47d1688c44c9bad288d0e2372'],2,2,4,323220,1,,,,881
2463a42173494c01560b4d68dac6b5b4b08d485b,0,Jean-Daniel Cryans,2014-03-27 14:30:00-07:00,['b5d374d11cec3b2660caf7b498d5cc19064ad504'],1,1,2,323222,1,,,,881
36551d621c5c4210990ea0c2ec00415fadd1f2da,0,Todd Lipcon,2014-03-27 15:27:24-07:00,['2463a42173494c01560b4d68dac6b5b4b08d485b'],2,2,4,323226,1,,,,881
c8eff4f4c983b50468e6d3752de3d282de17ec6c,0,Todd Lipcon,2014-03-27 15:36:48-07:00,['36551d621c5c4210990ea0c2ec00415fadd1f2da'],59,13,72,323298,7,0.318181818,0,0.045454545,881
53609a848c92c5c3d9d22ac8017bab7f54fe1828,0,Todd Lipcon,2014-03-27 16:01:51-07:00,['c8eff4f4c983b50468e6d3752de3d282de17ec6c'],2,8,10,323308,2,1,1,1,881
7b336e6e11c4e9fe3e855783e1f74341dbd80501,0,Todd Lipcon,2014-03-27 16:18:04-07:00,['53609a848c92c5c3d9d22ac8017bab7f54fe1828'],0,5,5,323313,1,,,,881
1a1429e6ba2eea79e1ca6c6438c25942772a3cd4,0,Matteo Bertozzi,2014-03-27 17:47:46-07:00,['7b336e6e11c4e9fe3e855783e1f74341dbd80501'],3,22,25,323338,1,0,0,1,881
7ad3b40f1f85a98e62f07fca6cf382b7fdd52d43,0,Todd Lipcon,2014-03-28 11:46:39-07:00,['1a1429e6ba2eea79e1ca6c6438c25942772a3cd4'],89,155,244,323582,2,1,1,1,882
5993f5a212fbdd34885f212b48bca7101478b60d,1,Todd Lipcon,2014-03-28 11:46:45-07:00,['7ad3b40f1f85a98e62f07fca6cf382b7fdd52d43'],30,30,60,323642,6,,,,882
cb3e45158b0abcdcb211f8e3b7c32df0fd91175e,0,Todd Lipcon,2014-03-28 11:48:35-07:00,['5993f5a212fbdd34885f212b48bca7101478b60d'],4,83,87,323729,3,0.564102564,1,1,883
c9144506219b1a6ba03811cdfc6a57d4d5a4042e,0,Todd Lipcon,2014-03-28 11:48:49-07:00,['cb3e45158b0abcdcb211f8e3b7c32df0fd91175e'],5,6,11,323740,2,1,1,1,883
b871cf6a73ac9d72e8952728c20a324e8afce09e,1,Todd Lipcon,2014-03-28 11:49:08-07:00,['c9144506219b1a6ba03811cdfc6a57d4d5a4042e'],8,9,17,323757,2,1,1,1,883
b51ceebffd98afbca37baef1881922ab6af9b784,0,Colin McCabe,2014-03-28 13:44:02-07:00,['b871cf6a73ac9d72e8952728c20a324e8afce09e'],7,14,21,323778,1,0.833333333,1,1,883
0f86fcc993e9abaad51dfc4214a1293432b68fd2,1,David Alves,2014-03-29 10:40:57-07:00,['b51ceebffd98afbca37baef1881922ab6af9b784'],1,13,14,323792,3,1,1,1,883
997ce4275b73ecf4adf087bc1924caa15def0e86,0,Todd Lipcon,2014-03-29 20:37:06-07:00,['0f86fcc993e9abaad51dfc4214a1293432b68fd2'],20,31,51,323843,5,1,1,1,883
6d278c12cb961373ff0d11809a1331f8d4c68a3d,1,Jean-Daniel Cryans,2014-03-31 14:13:10-07:00,['997ce4275b73ecf4adf087bc1924caa15def0e86'],29,287,316,324159,7,0.540740741,0.755555556,0.97037037,885
750b35643201148489939596de3f8add0954fff6,1,Todd Lipcon,2014-03-31 15:41:59-07:00,['6d278c12cb961373ff0d11809a1331f8d4c68a3d'],88,143,231,324390,15,0.388888889,0.388888889,0,885
ff547f0c88a7a1ca11d2e25a9557b69f116e8c5c,1,Todd Lipcon,2014-03-31 16:05:59-07:00,['750b35643201148489939596de3f8add0954fff6'],26,45,71,324461,5,1,1,1,885
25e2666efe5226f1f71dcb7e2abb2f7072e49582,0,Todd Lipcon,2014-03-31 16:06:35-07:00,['ff547f0c88a7a1ca11d2e25a9557b69f116e8c5c'],0,11,11,324472,1,0,1,1,885
b8634ef2fcaf3608ee95ddf6fe153b20426a0bdb,0,David Alves,2014-03-31 18:52:37-07:00,['25e2666efe5226f1f71dcb7e2abb2f7072e49582'],2,2,4,324476,1,,,,885
fe1d8389d71ba74b1c0d2d9c4d5d21e5ddb9efb7,0,Michael Percy,2014-03-31 20:07:49-07:00,['b8634ef2fcaf3608ee95ddf6fe153b20426a0bdb'],1,1,2,324478,1,,,,885
998591ebe95bcc8bf2ab2463145834a0883242bb,0,Todd Lipcon,2014-03-31 23:59:57-07:00,['fe1d8389d71ba74b1c0d2d9c4d5d21e5ddb9efb7'],0,8,8,324486,1,1,1,1,885
ed6bacce8a7ccc8c98a9a10214af178151f27d22,1,Michael Percy,2014-04-01 01:04:40-07:00,['998591ebe95bcc8bf2ab2463145834a0883242bb'],3,25,28,324514,2,,,,885
8c97273da1634f52c1f9fbd576244f21a9d7cc99,1,Todd Lipcon,2014-04-01 15:53:56-07:00,['ed6bacce8a7ccc8c98a9a10214af178151f27d22'],26,50,76,324590,5,0,1,1,885
da4dee23facd7e458edd3c91b5a50f433b2d584d,1,Todd Lipcon,2014-04-03 00:10:35-07:00,['8c97273da1634f52c1f9fbd576244f21a9d7cc99'],0,4,4,324594,2,0,0.75,0.75,885
da6ed49b5aa2aab6096cda46733e90be0e822ff8,0,Adar Dembo,2014-04-03 00:45:47-07:00,['da4dee23facd7e458edd3c91b5a50f433b2d584d'],3,9,12,324606,2,0,1,1,885
8759fad030f378ab1f4554406020acb906e7d978,0,Todd Lipcon,2014-04-03 13:43:37-07:00,['da6ed49b5aa2aab6096cda46733e90be0e822ff8'],3,1,4,324610,1,,,,885
83ee86098382406d25f1e5c3047dc703f1694924,0,Todd Lipcon,2014-04-03 16:55:21-07:00,['8759fad030f378ab1f4554406020acb906e7d978'],37,350,387,324997,6,0.65942029,0.985507246,0.869565217,886
0b0725d122646af5808283cb210933ebd595d523,0,Michael Percy,2014-04-03 20:43:07-07:00,['83ee86098382406d25f1e5c3047dc703f1694924'],9,11,20,325017,1,,,,886
d065019fdd7ff49b5a162e2fe9da8859130ad0da,0,Adar Dembo,2014-04-04 13:34:04-07:00,['0b0725d122646af5808283cb210933ebd595d523'],3,4,7,325024,1,,,,886
38378745901d75772c080a4d55776d2f19f4bf9e,1,Todd Lipcon,2014-04-04 16:32:02-07:00,['d065019fdd7ff49b5a162e2fe9da8859130ad0da'],4,199,203,325227,8,0.75,1,0.833333333,887
acdec3bbb796c83489ddffca82cd9ce44cc20475,0,Todd Lipcon,2014-04-04 17:50:08-07:00,['38378745901d75772c080a4d55776d2f19f4bf9e'],1,6,7,325234,1,,,,887
d20bbc832d77f643e50ba90f9621c4e00d21a0fd,0,Michael Percy,2014-04-04 19:35:13-07:00,['acdec3bbb796c83489ddffca82cd9ce44cc20475'],5,3,8,325242,1,,,,887
47e5b4db5c6c5b407c534b8ad18d5dde65e095e2,0,Todd Lipcon,2014-04-05 14:41:07-07:00,['d20bbc832d77f643e50ba90f9621c4e00d21a0fd'],18,133,151,325393,4,0.115384615,0.948717949,0.102564103,887
9799fb9920881c1ecad31a5966375da91e57b123,1,Todd Lipcon,2014-04-05 15:27:00-07:00,['47e5b4db5c6c5b407c534b8ad18d5dde65e095e2'],16,97,113,325506,10,0.339285714,0.839285714,0.910714286,887
c5bfc6ca1aa11351054c23d839d33572dfea59b5,1,Todd Lipcon,2014-04-06 23:03:26-07:00,['9799fb9920881c1ecad31a5966375da91e57b123'],303,316,619,326125,13,1,1,1,887
aaee2bc84794ec0f0672fb040a0c19c9cdc14b11,0,Adar Dembo,2014-04-07 12:25:33-07:00,['c5bfc6ca1aa11351054c23d839d33572dfea59b5'],4,6,10,326135,4,0,0,1,887
1e2c6060a06d24331ca31186c248c34ecfeaf763,1,Todd Lipcon,2014-04-07 12:42:09-07:00,['aaee2bc84794ec0f0672fb040a0c19c9cdc14b11'],6,34,40,326175,1,0,0,1,887
94b7e81c96ecce5dab7478e447ddc27b69f4ebd2,1,Todd Lipcon,2014-04-07 20:06:04-07:00,['1e2c6060a06d24331ca31186c248c34ecfeaf763'],1118,1052,2170,328345,14,1,1,1,890
0d0cc8cf9f56a4fe9e561928622d7ec8521b2ef9,0,Jean-Daniel Cryans,2014-04-09 10:43:55-07:00,['94b7e81c96ecce5dab7478e447ddc27b69f4ebd2'],2,5,7,328352,2,1,1,1,890
d6559254f4caa6586ef37129f7cf57f9e2d3bcd7,1,David Alves,2014-04-09 12:45:32-07:00,['0d0cc8cf9f56a4fe9e561928622d7ec8521b2ef9'],350,239,589,328941,26,0.631578947,0.315789474,1,890
c75993b2a6d917856187d1e467caadb7b90068be,0,Jean-Daniel Cryans,2014-04-09 13:18:35-07:00,['d6559254f4caa6586ef37129f7cf57f9e2d3bcd7'],24,12,36,328977,5,0.428571429,0.142857143,0,890
474d4575463015bff705e9ec96d274c87e629012,1,Jean-Daniel Cryans,2014-04-09 13:45:54-07:00,['c75993b2a6d917856187d1e467caadb7b90068be'],1066,440,1506,330483,32,0.979296066,0.354037267,0.300207039,890
63e2aad22e902c4ddcee9350b4aad3c816d3db06,0,Jean-Daniel Cryans,2014-04-09 14:11:25-07:00,['474d4575463015bff705e9ec96d274c87e629012'],4,49,53,330536,2,0,1,1,891
14a7676340267c0bc1f55468bd9d50402ba40adb,0,David Alves,2014-04-11 11:05:01-07:00,['63e2aad22e902c4ddcee9350b4aad3c816d3db06'],3,30,33,330569,4,0.266666667,0,1,891
3a40b31acbcaf50ae477c6a8ce1603d9581ec142,0,David Alves,2014-04-11 13:40:06-07:00,['14a7676340267c0bc1f55468bd9d50402ba40adb'],0,2,2,330571,1,0,1,1,891
09afc0309fdeb5e39db2143ad47d37eb6b38fc9f,1,Alex Feinberg,2014-04-14 14:10:05-07:00,['3a40b31acbcaf50ae477c6a8ce1603d9581ec142'],2,29,31,330602,3,0,0.789473684,0.736842105,891
24f5a5fc7ee4efb00a2327a2a85120ccfb7b6659,0,Todd Lipcon,2014-04-14 18:16:17-07:00,['09afc0309fdeb5e39db2143ad47d37eb6b38fc9f'],1,0,1,330603,1,1,0,1,891
cef771585d5883c00389aa10ca43abc6d2717aae,0,Todd Lipcon,2014-04-14 21:36:27-07:00,['24f5a5fc7ee4efb00a2327a2a85120ccfb7b6659'],0,2,2,330605,1,1,1,1,891
9625b44ee889a9d1622d7bd5017e31399e0ead8f,0,Todd Lipcon,2014-04-14 21:39:36-07:00,['cef771585d5883c00389aa10ca43abc6d2717aae'],2,2,4,330609,1,,,,891
6cc57b1d49281e3eb8a68e841bc3a5536cae72ba,1,David Alves,2014-04-15 14:50:27-07:00,['9625b44ee889a9d1622d7bd5017e31399e0ead8f'],31,27,58,330667,11,0,0,0,891
cb4805593424a4d59b014101237e5db7aa7168c3,0,Michael Percy,2014-04-16 14:18:51-07:00,['6cc57b1d49281e3eb8a68e841bc3a5536cae72ba'],1,1,2,330669,1,,,,891
de0e391d3ba2248c302a904fa3d4d286d5482c07,0,Colin McCabe,2014-04-16 15:02:05-07:00,['cb4805593424a4d59b014101237e5db7aa7168c3'],0,1,1,330670,1,0,1,1,891
7e3c74f3305d453660344effb44935ddab651207,1,Alex Feinberg,2014-04-16 15:41:10-07:00,['de0e391d3ba2248c302a904fa3d4d286d5482c07'],95,277,372,331042,9,0.574074074,0.601851852,0.759259259,891
950175b85f0c29868ec0e01a4432452eaf0df9fb,0,Todd Lipcon,2014-04-16 23:14:25-07:00,['7e3c74f3305d453660344effb44935ddab651207'],118,1,119,331161,2,0.258064516,0,0,891
da43dd1e814d320e5b418a99c78ad6751e2f4422,1,Michael Percy,2014-04-17 12:50:45-07:00,['950175b85f0c29868ec0e01a4432452eaf0df9fb'],153,306,459,331620,16,0.626666667,1,0.773333333,892
b3be585062837911b568a795676f3c16094afc58,0,Michael Percy,2014-04-17 12:50:56-07:00,['da43dd1e814d320e5b418a99c78ad6751e2f4422'],1,1,2,331622,1,,,,892
351d74c024c59e01715cdf23bcafb24b030e29d5,0,Michael Percy,2014-04-17 12:51:43-07:00,['b3be585062837911b568a795676f3c16094afc58'],0,117,117,331739,2,1,1,1,894
9e1816ae874ca9eda42951128a303f19fdb7f6e9,0,Michael Percy,2014-04-17 12:52:00-07:00,['351d74c024c59e01715cdf23bcafb24b030e29d5'],6,20,26,331765,1,,,,894
46066cf56ef27f263af0b76273423445dea2e766,0,Adar Dembo,2014-04-17 15:21:12-07:00,['9e1816ae874ca9eda42951128a303f19fdb7f6e9'],0,20,20,331785,1,,,,894
ba074e5ff807c24d1899018a6126b0ada2dbefd4,1,Todd Lipcon,2014-04-18 17:14:38-07:00,['46066cf56ef27f263af0b76273423445dea2e766'],12,650,662,332447,9,0.506224066,0.854771784,0.738589212,898
9264b68bce5faaa6f316b7c5289315539d2dd911,0,Todd Lipcon,2014-04-18 17:14:59-07:00,['ba074e5ff807c24d1899018a6126b0ada2dbefd4'],22,103,125,332572,4,0.214285714,1,0,899
d04d6dbafd7ed43e2d4bba81356a77d24c88457e,1,Michael Percy,2014-04-18 18:21:23-07:00,['9264b68bce5faaa6f316b7c5289315539d2dd911'],3,21,24,332596,2,1,1,1,899
4542c185aab651c104f3c0e3ac98e8f2182436f7,0,Todd Lipcon,2014-04-18 18:24:57-07:00,['d04d6dbafd7ed43e2d4bba81356a77d24c88457e'],3,40,43,332639,2,0,1,0.272727273,899
fa382e14f319c56b30e5e1861f815d72abdfb060,0,Todd Lipcon,2014-04-18 18:42:03-07:00,['4542c185aab651c104f3c0e3ac98e8f2182436f7'],3,19,22,332661,2,0.142857143,1,1,899
b4e7e1c9557ab30cfd8e4f5c8f9ee7232b747317,0,Todd Lipcon,2014-04-18 18:43:19-07:00,['fa382e14f319c56b30e5e1861f815d72abdfb060'],2,4,6,332667,1,,,,899
ccbc1731656d241f9eac6356e49470459b4eae66,0,Todd Lipcon,2014-04-19 18:21:55-07:00,['b4e7e1c9557ab30cfd8e4f5c8f9ee7232b747317'],0,11,11,332678,1,,,,899
9aba07d4c19aad26f7e162a047ca01c45131e5ff,0,Todd Lipcon,2014-04-19 18:51:44-07:00,['ccbc1731656d241f9eac6356e49470459b4eae66'],1,126,127,332805,2,0.333333333,0.333333333,1,899
e9e786cad9eb0e48774b030e76bc617381879f23,0,Todd Lipcon,2014-04-19 18:51:56-07:00,['9aba07d4c19aad26f7e162a047ca01c45131e5ff'],0,25,25,332830,1,0.9,1,0.9,899
126a904c8ef2fd5d11c5f353a8375de544b39c55,0,Todd Lipcon,2014-04-19 19:09:41-07:00,['e9e786cad9eb0e48774b030e76bc617381879f23'],0,7,7,332837,1,,,,900
54b380980c3760cb7355e92df358a8399630a055,0,Todd Lipcon,2014-04-21 16:07:41-07:00,['126a904c8ef2fd5d11c5f353a8375de544b39c55'],75,145,220,333057,3,1,0.972222222,0.444444444,901
6de3a43d35e11f76ee45c8a53267ebaca38b03c0,0,Todd Lipcon,2014-04-21 16:54:48-07:00,['54b380980c3760cb7355e92df358a8399630a055'],2,6,8,333065,2,,,,901
232757ac8213f64c7adbc795edacf40d312352d7,1,Todd Lipcon,2014-04-21 17:27:04-07:00,['6de3a43d35e11f76ee45c8a53267ebaca38b03c0'],0,73,73,333138,8,0.903225806,0.935483871,1,901
5fd2c9891f25e25d317df6cf6da45aa93281fb9a,0,Todd Lipcon,2014-04-21 17:37:37-07:00,['232757ac8213f64c7adbc795edacf40d312352d7'],2,13,15,333153,1,,,,901
0ed2d5708530f736dff408b8a3d6ecbebc1314c1,1,David Alves,2014-04-21 19:14:24-07:00,['5fd2c9891f25e25d317df6cf6da45aa93281fb9a'],28,370,398,333551,14,0.290322581,0.722580645,0.825806452,901
bd871ddd2fb4ef48bec07212caa965ff54629842,1,Michael Percy,2014-04-21 19:59:56-07:00,['0ed2d5708530f736dff408b8a3d6ecbebc1314c1'],35,25,60,333611,5,0.666666667,0,1,901
e1c97e0d33d661bc6a131f2be4258f3d51f823a4,1,David Alves,2014-04-21 20:05:34-07:00,['bd871ddd2fb4ef48bec07212caa965ff54629842'],8,98,106,333717,6,0.229166667,0.8125,0.541666667,902
d3cd158d48076febe3678a3227d5cb7900114fe6,1,David Alves,2014-04-21 20:39:37-07:00,['e1c97e0d33d661bc6a131f2be4258f3d51f823a4'],171,418,589,334306,8,0,0.205479452,0.671232877,902
091659cb994f9629712c27dab445b99cfc867077,0,Todd Lipcon,2014-04-21 23:07:30-07:00,['d3cd158d48076febe3678a3227d5cb7900114fe6'],41,43,84,334390,8,,,,902
cfa5f2e8cf5ad1d2555cfc27af76452cffc0f69b,1,Todd Lipcon,2014-04-22 11:33:58-07:00,['091659cb994f9629712c27dab445b99cfc867077'],4,4,8,334398,1,,,,902
7dc86546c9beafd4aeb37a86fd1c333c038ba0b0,0,Todd Lipcon,2014-04-22 11:36:30-07:00,['cfa5f2e8cf5ad1d2555cfc27af76452cffc0f69b'],2,3,5,334403,2,0,1,1,902
27423df79e47fe80493d28f798fcaabfa4028fe0,1,Todd Lipcon,2014-04-22 13:06:46-07:00,['7dc86546c9beafd4aeb37a86fd1c333c038ba0b0'],0,39,39,334442,3,0,0.954545455,0,902
d542d9e8161e9417ebbaae45fc34a03291d09f37,0,Todd Lipcon,2014-04-22 13:08:00-07:00,['27423df79e47fe80493d28f798fcaabfa4028fe0'],0,72,72,334514,2,0.529411765,1,0.764705882,902
cdc20dd2401066038eaa84afb03b7ae83d4edcf2,0,Todd Lipcon,2014-04-22 13:40:41-07:00,['d542d9e8161e9417ebbaae45fc34a03291d09f37'],17,16,33,334547,10,,,,902
60c46ca1c4388940010e5f7fed0c6e3fa9a5b62e,0,Todd Lipcon,2014-04-22 13:56:44-07:00,['cdc20dd2401066038eaa84afb03b7ae83d4edcf2'],54,54,108,334655,5,,,,902
7810246d9c4d051597574855c3c35d5092a78566,1,Todd Lipcon,2014-04-22 14:57:15-07:00,['60c46ca1c4388940010e5f7fed0c6e3fa9a5b62e'],96,96,192,334847,31,,,,902
f1fe9b81de2d33881e299d62d4ed0fff8ebfe146,1,Alex Feinberg,2014-04-22 15:31:09-07:00,['7810246d9c4d051597574855c3c35d5092a78566'],20,619,639,335486,10,0.364485981,0.866043614,0.84423676,905
3d784a895808519591fab9dde8cc03bd53ec17aa,0,Todd Lipcon,2014-04-22 16:33:36-07:00,['f1fe9b81de2d33881e299d62d4ed0fff8ebfe146'],18,24,42,335528,2,,,,905
76fa002e09c4ce1f2d14e0dae934edc515473b5f,1,Todd Lipcon,2014-04-22 17:33:50-07:00,['3d784a895808519591fab9dde8cc03bd53ec17aa'],31,54,85,335613,4,1,1,1,906
ac200b9bd37abafd78e3c7a8bcefd534ae22bb26,0,Todd Lipcon,2014-04-22 17:33:54-07:00,['76fa002e09c4ce1f2d14e0dae934edc515473b5f'],51,24,75,335688,2,0,0,1,906
ca78a2be45f080002aa33d7c1001f3c5cf473e3f,1,Todd Lipcon,2014-04-22 17:33:59-07:00,['ac200b9bd37abafd78e3c7a8bcefd534ae22bb26'],216,212,428,336116,31,1,0.25,1,906
be47e69b671172c372e1977018058121c3ddd9f9,0,Todd Lipcon,2014-04-22 17:34:06-07:00,['ca78a2be45f080002aa33d7c1001f3c5cf473e3f'],313,0,313,336429,5,0.288,0.288,0.056,906
aaed8f92be4882e2213aeb21f56fdace8270859f,0,Todd Lipcon,2014-04-22 17:34:11-07:00,['be47e69b671172c372e1977018058121c3ddd9f9'],1,8,9,336438,1,1,1,1,906
db177a387651d3c1fe90921ff7c4a5fcdd178438,0,Alex Feinberg,2014-04-22 18:43:11-07:00,['aaed8f92be4882e2213aeb21f56fdace8270859f'],3,26,29,336467,1,0.666666667,1,0.666666667,906
df7815900cb7bfc03a29d2816885e6da09f2c580,0,Todd Lipcon,2014-04-23 10:18:14-07:00,['db177a387651d3c1fe90921ff7c4a5fcdd178438'],1,1,2,336469,1,,,,906
be8776da3bf7b179f68c286b0909d7989828d37c,1,Todd Lipcon,2014-04-23 15:02:22-07:00,['df7815900cb7bfc03a29d2816885e6da09f2c580'],17,405,422,336891,8,0.014285714,0.904761905,0.771428571,906
3020d4df8f05598192ce340c7bab6d401d80461b,1,Todd Lipcon,2014-04-23 15:10:36-07:00,['be8776da3bf7b179f68c286b0909d7989828d37c'],1,231,232,337123,3,0.323529412,0.772058824,1,906
be6b81057eb43f1376f229af3029a723b022a850,1,David Alves,2014-04-23 15:11:04-07:00,['3020d4df8f05598192ce340c7bab6d401d80461b'],16,457,473,337596,11,0.588235294,0.754901961,0.887254902,909
85a731e406210a8b4a9a89a88efb231fe9b4f62e,1,Todd Lipcon,2014-04-23 15:15:39-07:00,['be6b81057eb43f1376f229af3029a723b022a850'],33,16,49,337645,4,,,,909
7929a65782524077242d71c7a0f109d2dde8f7c9,1,Todd Lipcon,2014-04-23 18:30:54-07:00,['85a731e406210a8b4a9a89a88efb231fe9b4f62e'],2,54,56,337701,4,0.294117647,0.823529412,0.823529412,909
6388c15fa4c97639b1851db071666b0a4b156160,0,Adar Dembo,2014-04-23 19:17:34-07:00,['7929a65782524077242d71c7a0f109d2dde8f7c9'],6,11,17,337718,1,,,,909
8e4666f1d51038f0237488fd8934bb50dd8df807,0,Adar Dembo,2014-04-23 19:19:42-07:00,['6388c15fa4c97639b1851db071666b0a4b156160'],9,14,23,337741,5,1,1,1,909
1c698b8be4d6411ed0d285d9e847787931adaf07,0,Todd Lipcon,2014-04-24 10:24:57-07:00,['8e4666f1d51038f0237488fd8934bb50dd8df807'],0,8,8,337749,1,,,,909
fad3fcc59745c1a5ad9e2b2ef8ff5bcb88ab97ae,0,Adar Dembo,2014-04-24 11:00:20-07:00,['1c698b8be4d6411ed0d285d9e847787931adaf07'],4,2,6,337755,1,0,0,0,909
254ad6f84c62fb7a3f0e1848206b8b877eb63b58,0,Michael Percy,2014-04-24 13:23:35-07:00,['fad3fcc59745c1a5ad9e2b2ef8ff5bcb88ab97ae'],2,4,6,337761,1,,,,909
015fa3f1010d7e217b0bdb3b8d3a1042d7b773d6,1,Todd Lipcon,2014-04-24 15:01:41-07:00,['254ad6f84c62fb7a3f0e1848206b8b877eb63b58'],76,77,153,337914,8,0.352941176,0.823529412,0.823529412,909
37e18e1782f5d49ef328789b380ab2adb84a97ef,0,Todd Lipcon,2014-04-24 15:01:51-07:00,['015fa3f1010d7e217b0bdb3b8d3a1042d7b773d6'],1,3,4,337918,2,,,,910
a699609cf349b9a627b95f5f2d3fca776a81af34,0,Todd Lipcon,2014-04-24 15:11:05-07:00,['37e18e1782f5d49ef328789b380ab2adb84a97ef'],10,8,18,337936,2,0,0,0,910
15da23b196bcd7adecb14bde089fbfa4fd4039c7,0,David Alves,2014-04-24 15:34:32-07:00,['a699609cf349b9a627b95f5f2d3fca776a81af34'],9,23,32,337968,3,0.285714286,1,0,910
3300e15d22e453e87712f6df42567b73e0154e69,0,Colin McCabe,2014-04-24 18:51:50-07:00,['15da23b196bcd7adecb14bde089fbfa4fd4039c7'],45,61,106,338074,3,1,1,1,910
1c24300dc3fb99e170dcb9eb5709b76fa7d5975b,0,Todd Lipcon,2014-04-24 21:00:08-07:00,['3300e15d22e453e87712f6df42567b73e0154e69'],15,20,35,338109,1,0,0,1,910
8611dcf5fcf237ff6767ff44295f6c0506a90544,1,Michael Percy,2014-04-24 21:11:56-07:00,['1c24300dc3fb99e170dcb9eb5709b76fa7d5975b'],78,473,551,338660,8,0.38277512,0.655502392,0.507177033,912
856104026aab4bfcd943852fbe93fb66dfaf38a9,0,Michael Percy,2014-04-24 21:28:52-07:00,['8611dcf5fcf237ff6767ff44295f6c0506a90544'],6,1,7,338667,2,,,,912
e1c515d45ae61e641180c8a395a6366c365dcc02,0,Michael Percy,2014-04-24 21:41:07-07:00,['856104026aab4bfcd943852fbe93fb66dfaf38a9'],0,1,1,338668,1,,,,912
e653b21966f5fac853f8b5dc9b7653e66394da59,1,Todd Lipcon,2014-04-24 21:53:20-07:00,['e1c515d45ae61e641180c8a395a6366c365dcc02'],0,6,6,338674,2,0,1,0,912
386bd5353bac31d1b409c406e20ed58e7b6c9817,0,Michael Percy,2014-04-24 22:43:57-07:00,['e653b21966f5fac853f8b5dc9b7653e66394da59'],7,15,22,338696,1,,,,912
371b144a69ae9bd38fe7c0bde685807464bea1b4,1,Todd Lipcon,2014-04-25 11:17:59-07:00,['386bd5353bac31d1b409c406e20ed58e7b6c9817'],4,4,8,338704,1,,,,912
febd6f7abe53698dc2a682584538bc38337b2eb9,1,Todd Lipcon,2014-04-25 11:21:19-07:00,['371b144a69ae9bd38fe7c0bde685807464bea1b4'],2,22,24,338728,5,1,1,1,912
c9c2f4a5ea272c07c14ce1b9b8ced791d65ff580,1,Michael Percy,2014-04-25 12:04:30-07:00,['febd6f7abe53698dc2a682584538bc38337b2eb9'],8,7,15,338743,1,,,,912
1498e2587d99169e301169f3d3ad3160ca055ae1,0,Todd Lipcon,2014-04-25 13:06:20-07:00,['c9c2f4a5ea272c07c14ce1b9b8ced791d65ff580'],2,2,4,338747,1,,,,912
d682d2c532a1003dc27788dd7455aa3f4eaed6a4,0,Alex Feinberg,2014-04-25 13:56:26-07:00,['1498e2587d99169e301169f3d3ad3160ca055ae1'],36,44,80,338827,1,1,1,0,912
7c328f1a897f61db5eee5a547a1849cf858b99b9,1,Michael Percy,2014-04-25 15:05:41-07:00,['d682d2c532a1003dc27788dd7455aa3f4eaed6a4'],21,29,50,338877,1,0,0,0,912
15a6e8e129d6fd8fc4776f712dba4aeb8de76466,1,Alex Feinberg,2014-04-25 16:26:27-07:00,['7c328f1a897f61db5eee5a547a1849cf858b99b9'],10,54,64,338941,3,0.260869565,1,1,912
91aa308ed6b817d24ce179a3ffd31a2712906e22,0,Colin McCabe,2014-04-28 11:19:11-07:00,['15a6e8e129d6fd8fc4776f712dba4aeb8de76466'],10,28,38,338979,2,1,1,1,912
bb6c9df03573551997308e60e9ff9aeb70e90958,0,Adar Dembo,2014-04-28 14:41:15-07:00,['91aa308ed6b817d24ce179a3ffd31a2712906e22'],7,11,18,338997,1,1,1,1,912
4cd42398a30970a2abe65bd39799341f26ee2c01,0,Colin McCabe,2014-04-28 14:54:47-07:00,['bb6c9df03573551997308e60e9ff9aeb70e90958'],2,4,6,339003,1,0,1,1,912
540e76ea1a396f82e392749bf6e13dad7b8bfc16,1,David Alves,2014-04-28 16:55:25-07:00,['4cd42398a30970a2abe65bd39799341f26ee2c01'],2,13,15,339018,3,0.25,1,0.25,912
d697e5a41ccd02e564703ee6a8ea570bd0b28d28,0,Todd Lipcon,2014-04-28 17:17:21-07:00,['540e76ea1a396f82e392749bf6e13dad7b8bfc16'],7,18,25,339043,1,0.5,0.5,1,912
f669e5b5c7ab23444c952dbb961b184068592b25,0,Michael Percy,2014-04-28 17:54:49-07:00,['d697e5a41ccd02e564703ee6a8ea570bd0b28d28'],0,370,370,339413,6,,,,914
3e0621df81a57fd6ff248ffe7c77ab104344512b,0,Michael Percy,2014-04-28 17:54:58-07:00,['f669e5b5c7ab23444c952dbb961b184068592b25'],4,136,140,339553,4,0.543859649,1,1,917
d0905b8fb82bd806c8e250709208233cfec2d916,0,Adar Dembo,2014-04-28 18:11:35-07:00,['3e0621df81a57fd6ff248ffe7c77ab104344512b'],21,168,189,339742,7,1,0,1,917
16c4fba5751f7cbfb1ef52ebbf709122274e0df2,1,Alex Feinberg,2014-04-28 19:57:50-07:00,['d0905b8fb82bd806c8e250709208233cfec2d916'],20,34,54,339796,3,1,1,1,917
e43cc299a28cc71b192dbb2ed5d344344d02532f,0,Alex Feinberg,2014-04-29 12:17:22-07:00,['16c4fba5751f7cbfb1ef52ebbf709122274e0df2'],1,1,2,339798,1,,,,917
3fd3e4cbf38e86158db4468cc36ce4f5fe4d54b3,0,Michael Percy,2014-04-29 13:28:01-07:00,['e43cc299a28cc71b192dbb2ed5d344344d02532f'],1,28,29,339827,3,,,,918
5ec98a018b8ede48a20755fbff86c4de0c730494,1,Alex Feinberg,2014-04-29 14:34:50-07:00,['3fd3e4cbf38e86158db4468cc36ce4f5fe4d54b3'],16,157,173,340000,3,0.117647059,1,0,918
592df314f5a7344c84e1e5f06d59e69455b42d2c,0,Michael Percy,2014-04-29 19:19:36-07:00,['5ec98a018b8ede48a20755fbff86c4de0c730494'],3,2,5,340005,1,,,,918
637b8d543c2985de4d13743c2bfcfe4c576891a6,0,Todd Lipcon,2014-04-30 11:24:07-07:00,['592df314f5a7344c84e1e5f06d59e69455b42d2c'],6,47,53,340058,1,0.461538462,0,1,918
e4f376f326ba3b02caffffdb11f62e5670ec07fb,0,Alex Feinberg,2014-04-30 18:48:47-07:00,['637b8d543c2985de4d13743c2bfcfe4c576891a6'],1,1,2,340060,1,,,,918
928d34902dd71e35f5db1b10faa96e0b0d47f42a,0,Jean-Daniel Cryans,2014-05-01 10:46:52-07:00,['e4f376f326ba3b02caffffdb11f62e5670ec07fb'],2,2,4,340064,1,,,,918
1584f42ed132e81b49675de71c2c9a3e63c7d0f7,1,Jean-Daniel Cryans,2014-05-01 15:52:47-07:00,['928d34902dd71e35f5db1b10faa96e0b0d47f42a'],53,294,347,340411,8,0.434285714,0.925714286,0.925714286,918
2350f035c32f06e40b90c0410da52b244190f85e,0,Jean-Daniel Cryans,2014-05-01 16:22:45-07:00,['1584f42ed132e81b49675de71c2c9a3e63c7d0f7'],1,5,6,340417,1,0,0,1,918
1ebf2c81ff90128733f370f834aa23619ade24a2,0,Jean-Daniel Cryans,2014-05-01 17:49:28-07:00,['2350f035c32f06e40b90c0410da52b244190f85e'],3,18,21,340438,2,0.333333333,1,1,918
c5012801f57bb8ba756e7c89871b873d679c7aa0,0,Jean-Daniel Cryans,2014-05-01 17:49:38-07:00,['1ebf2c81ff90128733f370f834aa23619ade24a2'],10,9,19,340457,3,1,0.666666667,0,918
84504847036fae39f4524450a06487f366324938,1,Jean-Daniel Cryans,2014-05-01 18:24:05-07:00,['c5012801f57bb8ba756e7c89871b873d679c7aa0'],24,22,46,340503,1,1,1,1,918
942ac2ff85aa3ef7f5f45863edaa8cc0c3b0b5da,0,David Alves,2014-05-02 15:51:49-07:00,['84504847036fae39f4524450a06487f366324938'],9,6,15,340518,2,0,0,0,918
d85b74b5e3d89ce90df1148513e697454443884b,0,Todd Lipcon,2014-05-02 18:48:48-07:00,['942ac2ff85aa3ef7f5f45863edaa8cc0c3b0b5da'],2,7,9,340527,2,,,,918
499d15d5294f6ea7812af4ef0287af7580a0cfb5,0,Adar Dembo,2014-05-05 14:17:14-07:00,['d85b74b5e3d89ce90df1148513e697454443884b'],0,18,18,340545,1,1,1,1,918
d29fe2760e0a60bbf9f79fdb0f040f0f0f6b9b99,1,Alex Feinberg,2014-05-06 15:57:16-07:00,['499d15d5294f6ea7812af4ef0287af7580a0cfb5'],121,347,468,341013,7,0.258333333,1,0.541666667,919
456caf1308c14c6550c9c415a3e1941271e7b37b,1,Alex Feinberg,2014-05-06 20:42:46-07:00,['d29fe2760e0a60bbf9f79fdb0f040f0f0f6b9b99'],53,98,151,341164,6,0,0,1,919
34379086841471ed071f98cbe5013b548a5c2cea,1,David Alves,2014-05-07 00:42:34-07:00,['456caf1308c14c6550c9c415a3e1941271e7b37b'],12,117,129,341293,5,0.575757576,0.909090909,0.833333333,919
1cdba7721ed8e43a143e494a923d04fac3636e1e,1,Michael Percy,2014-05-07 12:56:19-07:00,['34379086841471ed071f98cbe5013b548a5c2cea'],39,296,335,341628,17,0.381818182,1,0.9,922
39227ca53c3facbf026787fc4543fdd91a5972ef,1,Todd Lipcon,2014-05-07 23:18:00-07:00,['1cdba7721ed8e43a143e494a923d04fac3636e1e'],0,3,3,341631,1,,,,922
7a90eaaeba95f4fefa1f632e1b797d105e4219a0,1,Todd Lipcon,2014-05-07 23:41:53-07:00,['39227ca53c3facbf026787fc4543fdd91a5972ef'],105,894,999,342630,16,0.560386473,0.729468599,1,925
bdaabfa0b457d495b1d65f8d2e2fd00dd35382ed,0,Todd Lipcon,2014-05-08 01:07:31-07:00,['7a90eaaeba95f4fefa1f632e1b797d105e4219a0'],5,66,71,342701,2,,,,926
998cac2a3a6c3034eb445318ecbf198d1058b827,0,Michael Percy,2014-05-08 04:04:03-07:00,['bdaabfa0b457d495b1d65f8d2e2fd00dd35382ed'],56,62,118,342819,6,1,1,1,926
aba897cbb897079cf1bbdc7c5ebddbc4a6ba7528,0,Jean-Daniel Cryans,2014-05-08 11:00:41-07:00,['998cac2a3a6c3034eb445318ecbf198d1058b827'],1,0,1,342820,1,1,1,0,926
2a23497f80e562c10bdfb4c577ac39be2d63063a,1,Michael Percy,2014-05-08 14:11:10-07:00,['aba897cbb897079cf1bbdc7c5ebddbc4a6ba7528'],30,160,190,343010,6,0.741935484,1,1,929
00d7d0d0c499a45ba7c0bbad40347bf410f479ca,0,Jean-Daniel Cryans,2014-05-08 16:39:46-07:00,['2a23497f80e562c10bdfb4c577ac39be2d63063a'],6,30,36,343046,5,0,0.777777778,0.777777778,929
7aada5f677f31fa11c2eb981537e494d1e44d657,0,Alex Feinberg,2014-05-08 17:26:08-07:00,['00d7d0d0c499a45ba7c0bbad40347bf410f479ca'],4,5,9,343055,2,1,1,1,929
50cb2b7016e4a8c20830439c1d205bef6f123ec8,1,Jean-Daniel Cryans,2014-05-08 17:29:04-07:00,['7aada5f677f31fa11c2eb981537e494d1e44d657'],20,280,300,343355,5,0.255033557,0.322147651,0.44295302,930
b1e380e30341de59f83225d10c02ad08b3c4c6e2,1,David Alves,2014-05-08 22:58:48-07:00,['50cb2b7016e4a8c20830439c1d205bef6f123ec8'],1,39,40,343395,5,0,0,1,930
4ec5345c2c77dcf9d73581340a7c65c6a576f552,1,Jean-Daniel Cryans,2014-05-09 14:00:36-07:00,['b1e380e30341de59f83225d10c02ad08b3c4c6e2'],20,138,158,343553,11,0.506666667,0.786666667,1,931
f6cf572aad6cdbd20dda9dc377312295cba26027,1,Michael Percy,2014-05-09 14:11:08-07:00,['4ec5345c2c77dcf9d73581340a7c65c6a576f552'],118,140,258,343811,6,0,0,0,931
8542d88a0fbe6862d594dfade7e443b548d80690,1,Jean-Daniel Cryans,2014-05-09 16:34:31-07:00,['f6cf572aad6cdbd20dda9dc377312295cba26027'],12,75,87,343898,2,0.055555556,0.462962963,1,931
f12ce65952ff0b58c5336d10feee16c1b99be8b1,0,Todd Lipcon,2014-05-09 17:57:58-07:00,['8542d88a0fbe6862d594dfade7e443b548d80690'],5,3,8,343906,1,1,1,1,931
9cf148b5c0fee8881ed88dac39d0bb31979d24e7,0,Todd Lipcon,2014-05-09 18:02:25-07:00,['f12ce65952ff0b58c5336d10feee16c1b99be8b1'],18,63,81,343987,3,0,1,1,932
ecb2618fb1ab13ed9bd9b540de72c5eb4fd6440d,1,Michael Percy,2014-05-09 20:07:28-07:00,['9cf148b5c0fee8881ed88dac39d0bb31979d24e7'],6,51,57,344044,2,1,1,0,932
9973357817197d86b8cd2542bea74073f6786556,1,Todd Lipcon,2014-05-11 16:15:34-07:00,['ecb2618fb1ab13ed9bd9b540de72c5eb4fd6440d'],7,258,265,344309,6,0.392857143,0.414285714,1,935
480ec4523055169d8120bc4be15663ab1e3cab29,0,Adar Dembo,2014-05-12 15:11:32-07:00,['9973357817197d86b8cd2542bea74073f6786556'],8,123,131,344440,4,0.289855072,0.695652174,1,935
d5bf3e017cda394ee817c7ae3b57604b5f3734e9,0,Todd Lipcon,2014-05-12 15:15:25-07:00,['480ec4523055169d8120bc4be15663ab1e3cab29'],1,0,1,344441,1,0,0,0,935
9e0e093880e7a10830abfd50c4c1aac378e66fae,1,Michael Percy,2014-05-13 00:47:35-07:00,['d5bf3e017cda394ee817c7ae3b57604b5f3734e9'],13,28,41,344482,2,1,1,0,935
5b10902367efb7dd1a5d166b404012c0866ad372,0,Todd Lipcon,2014-05-13 10:46:37-07:00,['9e0e093880e7a10830abfd50c4c1aac378e66fae'],8,24,32,344514,4,0.333333333,0.583333333,0.583333333,935
989374bd467d8e7efb3e43e6ff2f5efe47fe84c5,1,Todd Lipcon,2014-05-13 10:54:35-07:00,['5b10902367efb7dd1a5d166b404012c0866ad372'],1,5,6,344520,1,,,,935
8c31fee3ac2ee3f47d4e17917425b8f0bdf36b9e,0,Colin McCabe,2014-05-13 15:27:43-07:00,['989374bd467d8e7efb3e43e6ff2f5efe47fe84c5'],3,3,6,344526,1,,,,935
6c39ea71909ab5b0a96d84478ee386283fdda54d,0,Michael Percy,2014-05-13 21:50:34-07:00,['8c31fee3ac2ee3f47d4e17917425b8f0bdf36b9e'],2,22,24,344550,4,0.823529412,1,1,935
350a827e680db006cd3a910bc265edf114d36ad5,1,Todd Lipcon,2014-05-14 11:26:09-07:00,['6c39ea71909ab5b0a96d84478ee386283fdda54d'],103,691,794,345344,21,0.364197531,1,0.959876543,936
8a488503922dade641b912220741c86268843e85,0,Michael Percy,2014-05-14 13:38:20-07:00,['350a827e680db006cd3a910bc265edf114d36ad5'],14,35,49,345393,3,0.928571429,1,1,936
67c78a34c59e7ca42dbf219587954f1887df167a,0,Todd Lipcon,2014-05-14 14:28:08-07:00,['8a488503922dade641b912220741c86268843e85'],0,5,5,345398,2,,,,936
5665819a60b1ed68de2345d10ec042e8500a3c2b,0,Jean-Daniel Cryans,2014-05-14 14:41:03-07:00,['67c78a34c59e7ca42dbf219587954f1887df167a'],7,5,12,345410,1,0,0,0,936
bfa015bbcc17b4536c0297bf4a314abe4ac13d72,0,Todd Lipcon,2014-05-14 15:01:26-07:00,['5665819a60b1ed68de2345d10ec042e8500a3c2b'],1,26,27,345437,2,0,1,1,936
f71ff34e6a4a6f784bf5cfb0918405998fdbc1c9,1,David Alves,2014-05-14 16:09:17-07:00,['bfa015bbcc17b4536c0297bf4a314abe4ac13d72'],50,2467,2517,347954,19,0.523462783,0.954692557,0.883495146,943
bf0422a6daf96a72b964c77606981d6abe104f66,0,Colin McCabe,2014-05-14 17:34:47-07:00,['f71ff34e6a4a6f784bf5cfb0918405998fdbc1c9'],5,15,20,347974,4,0.833333333,1,1,943
c924149de403068e14faff9297dbae5d4af3414a,0,Todd Lipcon,2014-05-14 17:46:22-07:00,['bf0422a6daf96a72b964c77606981d6abe104f66'],0,2,2,347976,1,,,,943
85a8474346b7662b362f90d62e029eb2bc18951c,0,Todd Lipcon,2014-05-14 17:54:12-07:00,['c924149de403068e14faff9297dbae5d4af3414a'],6,9,15,347991,2,1,1,1,943
eaad784c6d55c617a18afe078a7195580a16df9c,0,Todd Lipcon,2014-05-14 18:26:46-07:00,['85a8474346b7662b362f90d62e029eb2bc18951c'],2,2,4,347995,1,,,,943
8c2e0e38d25b28f8278644b2bd3db90aa7d503f7,0,Michael Percy,2014-05-15 01:07:28-07:00,['eaad784c6d55c617a18afe078a7195580a16df9c'],14,21,35,348030,2,0,0,1,943
4e00056edae88ee7cb3ea1332399b19671f4aa83,0,Todd Lipcon,2014-05-15 09:05:20-07:00,['8c2e0e38d25b28f8278644b2bd3db90aa7d503f7'],0,8,8,348038,2,1,1,1,943
f1fa70889771124a098315bb5940648b991c2953,0,Todd Lipcon,2014-05-15 09:05:59-07:00,['4e00056edae88ee7cb3ea1332399b19671f4aa83'],3,43,46,348084,4,0.138888889,0.138888889,0.888888889,943
b2378ea76b00da2b208a76eea6e0e21130e8a681,0,Jean-Daniel Cryans,2014-05-15 09:15:13-07:00,['f1fa70889771124a098315bb5940648b991c2953'],3,3,6,348090,1,,,,943
b164a55586f8436d29163fed9f003e9edf73adc7,0,Michael Percy,2014-05-15 11:10:55-07:00,['b2378ea76b00da2b208a76eea6e0e21130e8a681'],7,0,7,348097,1,,,,943
e452d246507239f73bf7a9156b6f7e51f746ffd6,0,Michael Percy,2014-05-15 12:58:28-07:00,['b164a55586f8436d29163fed9f003e9edf73adc7'],0,9,9,348106,2,1,1,1,943
8af8fc2294f8706b07f404995d4cb250ea14ad88,1,Adar Dembo,2014-05-15 18:09:16-07:00,['e452d246507239f73bf7a9156b6f7e51f746ffd6'],5,137,142,348248,5,0.177777778,1,0.833333333,944
297e0d65f93e28570ab83aea58a4e1b7ba71e9c9,0,Todd Lipcon,2014-05-16 12:08:00-07:00,['8af8fc2294f8706b07f404995d4cb250ea14ad88'],0,2,2,348250,2,0,0,0,944
ed11fe09c47adaf763739ed4075be92ba6efe33c,0,Todd Lipcon,2014-05-16 12:08:17-07:00,['297e0d65f93e28570ab83aea58a4e1b7ba71e9c9'],0,1,1,348251,1,1,1,1,944
7a62a15154ee62b3eff2aa6848e68e3d699bd23d,1,Jean-Daniel Cryans,2014-05-16 12:34:19-07:00,['ed11fe09c47adaf763739ed4075be92ba6efe33c'],42,960,1002,349253,13,0.562111801,0.872670807,0.885093168,953
3123b170097ecf4086612bb98f459d4c2ce5d71b,0,Todd Lipcon,2014-05-16 13:48:50-07:00,['7a62a15154ee62b3eff2aa6848e68e3d699bd23d'],40,55,95,349348,1,0.666666667,1,0.25,953
4701a7a4a4a0f6c4a86f744f9b27f1a2295bf7ee,0,Todd Lipcon,2014-05-16 14:37:09-07:00,['3123b170097ecf4086612bb98f459d4c2ce5d71b'],26,84,110,349458,2,0.731707317,0.853658537,1,953
aa257228d96f91b310cfa85b44e95e088858fd72,0,Todd Lipcon,2014-05-18 14:59:28-07:00,['4701a7a4a4a0f6c4a86f744f9b27f1a2295bf7ee'],46,64,110,349568,8,1,1,1,953
3c71c427d9595897854c3749ae0167bf34d1541c,0,Todd Lipcon,2014-05-18 14:59:34-07:00,['aa257228d96f91b310cfa85b44e95e088858fd72'],9,11,20,349588,6,,,,953
3d1c4d09563b372fa42aae77d8722c3b50721936,0,Todd Lipcon,2014-05-18 15:27:01-07:00,['3c71c427d9595897854c3749ae0167bf34d1541c'],29,35,64,349652,1,1,1,0,953
2b2d9bd1953840db5de81663e4d82381acb307fe,0,Alex Feinberg,2014-05-19 14:02:28-07:00,['3d1c4d09563b372fa42aae77d8722c3b50721936'],1,1,2,349654,1,,,,953
b5c958a69d083c98513f48a396e02d29fd57e4b4,0,Jean-Daniel Cryans,2014-05-19 15:26:54-07:00,['2b2d9bd1953840db5de81663e4d82381acb307fe'],73,678,751,350405,11,0.513888889,0.829861111,0.902777778,956
38aa8c54740b22b10d65e038de9c4e5501d18fcd,1,Todd Lipcon,2014-05-19 15:27:53-07:00,['b5c958a69d083c98513f48a396e02d29fd57e4b4'],12,47,59,350464,4,0,0,0.315789474,956
c36bba708884e843d0ade7a887945ad288ca32b5,1,David Alves,2014-05-19 15:33:17-07:00,['38aa8c54740b22b10d65e038de9c4e5501d18fcd'],625,625,1250,351714,47,1,1,1,956
52912fa1ddfee370ebe8cc55b192efb21d2d8348,0,Jean-Daniel Cryans,2014-05-19 18:30:13-07:00,['c36bba708884e843d0ade7a887945ad288ca32b5'],1,1,2,351716,1,,,,956
92f97057c70dae5ff35583a7a9faaaf310ef8245,0,Todd Lipcon,2014-05-19 18:58:23-07:00,['52912fa1ddfee370ebe8cc55b192efb21d2d8348'],31,54,85,351801,4,0.086956522,1,1,956
bf8e3ef588db4cadd3f0e6357829d1eb83f04ee5,1,David Alves,2014-05-19 19:08:02-07:00,['92f97057c70dae5ff35583a7a9faaaf310ef8245'],5,22,27,351828,2,0,1,1,956
d43e66af939098785394dfacefd94feeda1e5366,1,David Alves,2014-05-19 19:27:19-07:00,['bf8e3ef588db4cadd3f0e6357829d1eb83f04ee5'],853,908,1761,353589,22,0,0,1,958
47fbf5dea313b6a75edbce83bebb4ff3980e3a17,1,Todd Lipcon,2014-05-19 20:04:10-07:00,['d43e66af939098785394dfacefd94feeda1e5366'],15,26,41,353630,2,0,0.5,0,958
f6e40f49d6e66c79b677975bdd625674948dcc78,1,Michael Percy,2014-05-20 11:52:50-07:00,['47fbf5dea313b6a75edbce83bebb4ff3980e3a17'],204,159,363,353993,10,0,0.105263158,1,958
1870d9139063ecb571c62660f78e72a3b57d69ac,0,Michael Percy,2014-05-20 11:57:37-07:00,['f6e40f49d6e66c79b677975bdd625674948dcc78'],27,31,58,354051,12,1,1,1,958
3fe78a942fe09c368aafba6b5e4a48e3a3a45254,1,Michael Percy,2014-05-20 11:58:16-07:00,['1870d9139063ecb571c62660f78e72a3b57d69ac'],120,189,309,354360,13,0,1,0,958
1f43f5fad0575cf8b86ea20a8a2d0223911813ed,1,Jean-Daniel Cryans,2014-05-20 15:36:59-07:00,['3fe78a942fe09c368aafba6b5e4a48e3a3a45254'],0,506,506,354866,5,0.36199095,0.692307692,0.692307692,962
0d5f893f2a763405a656695d9791a34022b6ccae,0,Todd Lipcon,2014-05-20 16:20:16-07:00,['1f43f5fad0575cf8b86ea20a8a2d0223911813ed'],0,12,12,354878,1,0.5,1,1,962
f93c7b80adf52b99ae2b190682468f7798561855,0,David Alves,2014-05-20 17:53:01-07:00,['0d5f893f2a763405a656695d9791a34022b6ccae'],6,6,12,354890,1,,,,962
e382dc44fb5dff847f3c7477082f20dddc171178,1,Jean-Daniel Cryans,2014-05-20 18:20:15-07:00,['f93c7b80adf52b99ae2b190682468f7798561855'],44,41,85,354975,16,1,0,0,962
cc7ccf53bcffe9365cd0e7f092e97338ff1c1c0c,1,Alex Feinberg,2014-05-21 13:03:48-07:00,['e382dc44fb5dff847f3c7477082f20dddc171178'],2,442,444,355419,4,0.53776435,0.906344411,0.311178248,962
03b76edde749be7b481b471a6b96e9184359bda5,1,Alex Feinberg,2014-05-21 13:04:08-07:00,['cc7ccf53bcffe9365cd0e7f092e97338ff1c1c0c'],26,71,97,355516,10,1,1,1,962
555e48dc75b6ebd243b747bcd124ce1fae44853e,1,David Alves,2014-05-21 16:32:25-07:00,['03b76edde749be7b481b471a6b96e9184359bda5'],0,296,296,355812,4,0.644628099,1,0.884297521,965
29593af5c2726cc0fce91e0ea7a45218eb9efe83,0,Michael Percy,2014-05-21 21:30:20-07:00,['555e48dc75b6ebd243b747bcd124ce1fae44853e'],0,6,6,355818,2,1,1,1,965
37a28811fe27e2ddc63e1a560b8385f6bfafa1de,0,David Alves,2014-05-22 14:29:54-07:00,['29593af5c2726cc0fce91e0ea7a45218eb9efe83'],2,185,187,356005,1,1,1,1,965
a85e39e99b8a7940dab597701a7e6f18e53dc43c,1,Michael Percy,2014-05-22 14:42:47-07:00,['37a28811fe27e2ddc63e1a560b8385f6bfafa1de'],18,20,38,356043,2,1,1,1,965
3a34edaf4c863ac0da292cff04048196bf784b7d,0,Michael Percy,2014-05-22 18:38:43-07:00,['a85e39e99b8a7940dab597701a7e6f18e53dc43c'],10,92,102,356145,4,0,0.928571429,0.857142857,965
b1c74f3f3f4b4b8bb514146df68debbd19a9b54b,0,Todd Lipcon,2014-05-23 07:23:38-07:00,['3a34edaf4c863ac0da292cff04048196bf784b7d'],43,0,43,356188,2,,,,965
a1bd9435d8ab3217bfd7581250479d728842ade4,0,Todd Lipcon,2014-05-23 07:31:24-07:00,['b1c74f3f3f4b4b8bb514146df68debbd19a9b54b'],1,7,8,356196,1,0,0,0,965
adbaf2dcfd52e97e302b22f49a962b7f503a7776,0,Michael Percy,2014-05-23 11:28:27-07:00,['a1bd9435d8ab3217bfd7581250479d728842ade4'],0,6,6,356202,3,1,1,1,965
dcea9a9ee6311d882a93af77cfba5a76ba7b67a3,0,Michael Percy,2014-05-23 11:35:50-07:00,['adbaf2dcfd52e97e302b22f49a962b7f503a7776'],5,1,6,356208,1,,,,965
546d266e0211f920d4754e541f99b2360f267792,1,Michael Percy,2014-05-23 11:36:37-07:00,['dcea9a9ee6311d882a93af77cfba5a76ba7b67a3'],12,93,105,356313,5,0.173913043,1,0.173913043,967
493aa688b6838ebc10b3c1b1a9cc30a5ab2b94d0,0,Michael Percy,2014-05-23 12:26:01-07:00,['546d266e0211f920d4754e541f99b2360f267792'],0,10,10,356323,1,1,1,1,967
7d730921685bf65911a51ece42b8ba4e259f411f,0,Michael Percy,2014-05-23 12:26:36-07:00,['493aa688b6838ebc10b3c1b1a9cc30a5ab2b94d0'],0,7,7,356330,2,1,1,1,967
1c41c509dc3efa669f3038ec768888113ebdbe27,0,Jean-Daniel Cryans,2014-05-23 12:49:19-07:00,['7d730921685bf65911a51ece42b8ba4e259f411f'],0,6,6,356336,2,0,0,1,967
c9f31b4907344672fca59bf2b5cb04e74195683f,1,Jean-Daniel Cryans,2014-05-23 13:36:48-07:00,['1c41c509dc3efa669f3038ec768888113ebdbe27'],29,180,209,356545,4,0.850746269,1,0.940298507,969
352bdc330be58b61446651537ec32e5b1300a330,0,Michael Percy,2014-05-23 13:48:32-07:00,['c9f31b4907344672fca59bf2b5cb04e74195683f'],326,21,347,356892,6,,,,969
345416c3b0d075dde4483b34525a702a5bf6188c,0,Todd Lipcon,2014-05-23 13:50:19-07:00,['352bdc330be58b61446651537ec32e5b1300a330'],26,21,47,356939,3,1,0,1,969
eb321eb156c5f1ac9a8dab7d3eb23376392229d2,1,Michael Percy,2014-05-23 13:56:49-07:00,['345416c3b0d075dde4483b34525a702a5bf6188c'],36,33,69,357008,3,1,1,1,969
c515df1084263ba5de18593f8aa1038fe1a2b335,0,Michael Percy,2014-05-23 16:14:47-07:00,['eb321eb156c5f1ac9a8dab7d3eb23376392229d2'],1,2,3,357011,1,,,,969
a1b373c3ce810a487e93c1f7faab1d1c698414ac,0,Jean-Daniel Cryans,2014-05-23 20:25:46-07:00,['c515df1084263ba5de18593f8aa1038fe1a2b335'],2,6,8,357019,2,0.333333333,0.333333333,1,969
4a25353ab2bfbb08989999c721588b077db23984,0,David Alves,2014-05-24 14:24:17-07:00,['a1b373c3ce810a487e93c1f7faab1d1c698414ac'],5,14,19,357038,3,1,1,1,969
dc6a64c90b220f6a4654188f2f103cfdf100b057,1,Alex Feinberg,2014-05-27 14:40:14-07:00,['4a25353ab2bfbb08989999c721588b077db23984'],34,205,239,357277,13,0.948717949,1,0.897435897,969
3a73b24a40d4e9990cfc04eadc96849934ce2b8a,0,Adar Dembo,2014-05-27 14:45:13-07:00,['dc6a64c90b220f6a4654188f2f103cfdf100b057'],6,10,16,357293,1,1,1,1,969
b22927800d1f57413d07a839c3454771190e4d07,1,Jean-Daniel Cryans,2014-05-27 14:45:50-07:00,['3a73b24a40d4e9990cfc04eadc96849934ce2b8a'],60,278,338,357631,4,0.363636364,0.727272727,0.896103896,970
f65ea39c034d8aeeb6f22046fbdccb381ff57df8,1,Todd Lipcon,2014-05-27 16:32:48-07:00,['b22927800d1f57413d07a839c3454771190e4d07'],24,72,96,357727,8,0.764705882,1,0.941176471,970
b19fa2ae0e48501b89f6896467a77dd6723d08b0,1,Todd Lipcon,2014-05-27 16:34:10-07:00,['f65ea39c034d8aeeb6f22046fbdccb381ff57df8'],35,537,572,358299,9,0.347540984,0.868852459,0.954098361,971
ae02bbdc65c2c60347fb39492dcaa515f5a25af0,1,Jean-Daniel Cryans,2014-05-27 16:56:35-07:00,['b19fa2ae0e48501b89f6896467a77dd6723d08b0'],14,56,70,358369,3,0,0.714285714,1,971
0b3e3d25267e0fe5d49985cb0a2772f567359b80,1,Jean-Daniel Cryans,2014-05-27 16:56:50-07:00,['ae02bbdc65c2c60347fb39492dcaa515f5a25af0'],6,55,61,358430,1,0.892857143,1,1,971
e446bf50fe3af0700c389a07e7cc2ea78d35a1dc,0,Jean-Daniel Cryans,2014-05-27 16:57:08-07:00,['0b3e3d25267e0fe5d49985cb0a2772f567359b80'],11,12,23,358453,2,1,1,1,971
b32da5c23d2b0623a0cd83ac15e6b74023e47472,0,Michael Percy,2014-05-27 19:03:45-07:00,['e446bf50fe3af0700c389a07e7cc2ea78d35a1dc'],0,1,1,358454,1,,,,971
2221c0c1766eef957740edcba7805e500eeb0bbb,1,Alex Feinberg,2014-05-28 14:31:19-07:00,['b32da5c23d2b0623a0cd83ac15e6b74023e47472'],9,154,163,358617,14,0.353658537,1,0.987804878,971
7e2c4fe2f6ad57b3cc96a9775e47c5817a0f9648,0,Jean-Daniel Cryans,2014-05-28 15:26:36-07:00,['2221c0c1766eef957740edcba7805e500eeb0bbb'],17,133,150,358767,8,0,0.558441558,0.818181818,971
7da42a58e07e5bf1349e9b68ac5313f04cffe1d8,0,Jean-Daniel Cryans,2014-05-28 16:06:37-07:00,['7e2c4fe2f6ad57b3cc96a9775e47c5817a0f9648'],3,20,23,358790,2,0.5,0,1,971
a818af94c26e78eb161bb77a41e1936a83718eb5,0,David Alves,2014-05-28 16:20:30-07:00,['7da42a58e07e5bf1349e9b68ac5313f04cffe1d8'],58,91,149,358939,4,0.590909091,1,1,971
40fd8a266f2a43222f20c722b2fb92fa93e9492d,0,Michael Percy,2014-05-28 16:28:11-07:00,['a818af94c26e78eb161bb77a41e1936a83718eb5'],0,3,3,358942,1,1,1,1,971
9a793dc1c7cbb024d24a79b13b33604e900088b6,0,Todd Lipcon,2014-05-28 17:49:32-07:00,['40fd8a266f2a43222f20c722b2fb92fa93e9492d'],7,22,29,358971,3,0,0.857142857,1,971
420673dfbb3ff39efe8ae3b54138dac5f0f47682,0,Todd Lipcon,2014-05-28 17:59:30-07:00,['9a793dc1c7cbb024d24a79b13b33604e900088b6'],2,41,43,359014,4,1,1,1,971
a510729ed18c71abce659a28b7edf49a76a8ab3d,0,Alex Feinberg,2014-05-28 20:08:40-07:00,['420673dfbb3ff39efe8ae3b54138dac5f0f47682'],5,45,50,359064,7,0.058823529,0,0.941176471,971
64bfe16d2ac6b29cebaae4bf7a3b8cc99c289758,1,David Alves,2014-05-28 21:21:58-07:00,['a510729ed18c71abce659a28b7edf49a76a8ab3d'],3,57,60,359124,3,0.142857143,1,0.971428571,971
16469674c732b81e50897f4b7c21ea0224f64ba3,0,Michael Percy,2014-05-28 21:31:22-07:00,['64bfe16d2ac6b29cebaae4bf7a3b8cc99c289758'],1,6,7,359131,2,1,1,1,971
381fc17472ee354063158b77b30b1aecbe1b013e,1,Todd Lipcon,2014-05-29 00:43:23-07:00,['16469674c732b81e50897f4b7c21ea0224f64ba3'],386,707,1093,360224,13,0.381974249,0.875536481,0.811158798,972
c67d391cdda3e63d25fb374b3431949e92cf22d0,1,Michael Percy,2014-05-29 13:34:24-07:00,['381fc17472ee354063158b77b30b1aecbe1b013e'],25,25,50,360274,1,1,0,0,972
206ee373b28f6cf8bc32344c14588efd76ef52c1,1,Michael Percy,2014-05-29 13:34:31-07:00,['c67d391cdda3e63d25fb374b3431949e92cf22d0'],40,100,140,360414,6,1,1,0.307692308,972
03aaabd46f16ca9c1789182cb96c918724aad380,0,Todd Lipcon,2014-05-29 15:18:24-07:00,['206ee373b28f6cf8bc32344c14588efd76ef52c1'],2,53,55,360469,1,0.027777778,0.805555556,1,972
72f09cea47920c8a62302daca3683923ce5d3bd1,1,Todd Lipcon,2014-05-29 16:02:05-07:00,['03aaabd46f16ca9c1789182cb96c918724aad380'],18,40,58,360527,3,0,1,0,972
b656564697849dd1ff96d6333ce01eda9840067f,1,Jean-Daniel Cryans,2014-05-29 17:46:01-07:00,['72f09cea47920c8a62302daca3683923ce5d3bd1'],1,48,49,360576,2,1,1,1,973
2eb063565bcbee0f95b68fcfb423595db0cde23e,0,Todd Lipcon,2014-05-29 18:30:33-07:00,['b656564697849dd1ff96d6333ce01eda9840067f'],4,19,23,360599,1,1,1,1,973
19b9efa967f86a785e6f5052f6ead0e5b206d28a,0,Todd Lipcon,2014-05-29 20:08:59-07:00,['2eb063565bcbee0f95b68fcfb423595db0cde23e'],11,103,114,360713,4,,,,973
425ddae8017d1c8dc98b7791d0c0d00bac7df325,0,Todd Lipcon,2014-05-29 20:14:07-07:00,['19b9efa967f86a785e6f5052f6ead0e5b206d28a'],23,12,35,360748,2,0,0,0,973
cd523552635de5b1abfb5ad44e131c5420f84484,1,Michael Percy,2014-05-29 23:15:13-07:00,['425ddae8017d1c8dc98b7791d0c0d00bac7df325'],6,9,15,360763,1,0,1,1,973
3d1c9dd34a711962ea63ac0858f1633ed7c0b9ff,1,Todd Lipcon,2014-05-30 14:10:35-07:00,['cd523552635de5b1abfb5ad44e131c5420f84484'],27,24,51,360814,7,1,0,0.5,973
7ad3c4ac5a82eb03c7aef11afbfc01cf78fa0b29,1,Adar Dembo,2014-05-30 14:21:10-07:00,['3d1c9dd34a711962ea63ac0858f1633ed7c0b9ff'],0,207,207,361021,3,1,1,1,975
e1c039b45d97a08b0d262cfbf0ce9479db86c4e1,0,Adar Dembo,2014-05-30 14:21:17-07:00,['7ad3c4ac5a82eb03c7aef11afbfc01cf78fa0b29'],30,96,126,361147,4,1,1,1,976
ca627c9db4db69b5f18cc52e291f6b3ba64a8203,0,Jean-Daniel Cryans,2014-05-30 14:25:53-07:00,['e1c039b45d97a08b0d262cfbf0ce9479db86c4e1'],2,2,4,361151,2,,,,976
2e53d15f45fd070c4eb79af35138d045ca5eebe4,0,Michael Percy,2014-05-30 14:26:50-07:00,['ca627c9db4db69b5f18cc52e291f6b3ba64a8203'],21,0,21,361172,3,0.4,0,0.4,976
20e61c1bda81aae9e922e0052abbf6d3fe6620e8,0,Alex Feinberg,2014-05-30 15:05:25-07:00,['2e53d15f45fd070c4eb79af35138d045ca5eebe4'],83,129,212,361384,19,0,0.884615385,0.923076923,976
4a54e31605f555a1cd46fea8939ed2026665741f,1,Todd Lipcon,2014-05-30 15:52:45-07:00,['20e61c1bda81aae9e922e0052abbf6d3fe6620e8'],11,28,39,361423,4,0.454545455,0.727272727,0.181818182,976
f39366aca182475074791d814859f19e3d8dd575,0,Michael Percy,2014-05-30 16:37:02-07:00,['4a54e31605f555a1cd46fea8939ed2026665741f'],1,5,6,361429,2,0,1,0,976
2f42d1f31d3785012371d753636f805185b8de01,1,Todd Lipcon,2014-05-31 15:33:14-07:00,['f39366aca182475074791d814859f19e3d8dd575'],99,182,281,361710,16,1,0.805555556,0.944444444,976
97fa5f4a190ef4fa5705ae8cfc4ccb93e6f62353,1,Alex Feinberg,2014-05-31 16:39:12-07:00,['2f42d1f31d3785012371d753636f805185b8de01'],118,148,266,361976,19,1,1,0,976
7cb12f9f0df3c85ba2010ce622905aeb2e97d3fc,0,David Alves,2014-05-31 22:50:00-07:00,['97fa5f4a190ef4fa5705ae8cfc4ccb93e6f62353'],22,2,24,362000,4,0.176470588,0,0,976
b789a684938b3f922aff97e26f045ad449f1b2be,0,Todd Lipcon,2014-06-01 15:06:43-07:00,['7cb12f9f0df3c85ba2010ce622905aeb2e97d3fc'],0,4,4,362004,1,0,0.75,0,976
2283e8ea6f986dff3836403c1d14164895df54dd,1,Todd Lipcon,2014-06-01 17:15:59-07:00,['b789a684938b3f922aff97e26f045ad449f1b2be'],0,197,197,362201,4,0.484375,0.984375,1,978
4baa3f0f7cae42e53b218f4715b7274c22508ff2,0,Todd Lipcon,2014-06-02 00:08:37-07:00,['2283e8ea6f986dff3836403c1d14164895df54dd'],18,79,97,362298,6,0.340425532,0.914893617,1,978
313ecfb4795a1996148194fb31523fa861cfb986,1,Jean-Daniel Cryans,2014-06-02 09:26:55-07:00,['4baa3f0f7cae42e53b218f4715b7274c22508ff2'],17,77,94,362392,5,0,0.409090909,1,978
d8213967c8242308119e5ba2151cfd3e97cad773,0,Jean-Daniel Cryans,2014-06-02 10:18:11-07:00,['313ecfb4795a1996148194fb31523fa861cfb986'],6,14,20,362412,1,1,1,1,978
e426f5779db3a7e5fdcc32240e10ed0b6f9c6cfd,1,Alex Feinberg,2014-06-02 14:41:21-07:00,['d8213967c8242308119e5ba2151cfd3e97cad773'],9,61,70,362482,2,0.294117647,1,1,978
c466c172e5bb84ef594e3e5e40da347ea731694c,1,Jean-Daniel Cryans,2014-06-02 15:19:04-07:00,['e426f5779db3a7e5fdcc32240e10ed0b6f9c6cfd'],14,84,98,362580,2,0.578947368,1,1,978
2c82345f55d0b41bc838164c81759b888dcef5d5,0,Adar Dembo,2014-06-02 16:03:43-07:00,['c466c172e5bb84ef594e3e5e40da347ea731694c'],135,129,264,362844,12,0,1,0,978
3419309d1b002e58af3265d9b199dc871dd017a8,0,Adar Dembo,2014-06-02 16:03:52-07:00,['2c82345f55d0b41bc838164c81759b888dcef5d5'],8,6,14,362858,3,0.833333333,0,0,978
7c364a488c29e8b6012e0f6a6d679749a18765e1,1,Todd Lipcon,2014-06-02 16:51:22-07:00,['3419309d1b002e58af3265d9b199dc871dd017a8'],29,18,47,362905,4,0.9,0.2,0.3,978
b374d023fe0ff75362d99726b5b16385430ccbcc,0,Todd Lipcon,2014-06-02 19:19:30-07:00,['7c364a488c29e8b6012e0f6a6d679749a18765e1'],3,5,8,362913,1,,,,978
9ea5208586f65424d307717c625ef1edc09bdc17,0,Todd Lipcon,2014-06-02 19:19:40-07:00,['b374d023fe0ff75362d99726b5b16385430ccbcc'],3,4,7,362920,2,0,1,1,978
af55c60980b4d9342e0baed830076796378d46c2,1,Todd Lipcon,2014-06-02 19:20:42-07:00,['9ea5208586f65424d307717c625ef1edc09bdc17'],22,31,53,362973,8,0,1,1,978
0edf7e0dd1e936089a2c583ca7b1c9facde335cd,0,Todd Lipcon,2014-06-02 19:20:50-07:00,['af55c60980b4d9342e0baed830076796378d46c2'],118,147,265,363238,3,,,,979
160e85860bdfa8945d7884cbbb7858f97d9f79e8,0,Todd Lipcon,2014-06-02 19:21:35-07:00,['0edf7e0dd1e936089a2c583ca7b1c9facde335cd'],1,2,3,363241,1,0,1,1,979
c2890683f4ddcdcc34413eff83b1275aaf1e9cb9,0,David Alves,2014-06-02 23:39:43-07:00,['160e85860bdfa8945d7884cbbb7858f97d9f79e8'],1,1,2,363243,1,,,,979
08a24c96c2a69393ba1276d0f2ed4691f90710b8,0,David Alves,2014-06-02 23:42:36-07:00,['c2890683f4ddcdcc34413eff83b1275aaf1e9cb9'],1,6,7,363250,1,0,0,0,979
a65d3416be6767fd8df24030ee8788587cf717f7,0,David Alves,2014-06-02 23:49:25-07:00,['08a24c96c2a69393ba1276d0f2ed4691f90710b8'],21,72,93,363343,6,1,1,1,979
9c39abb9ac33f066c0e3bb02ae1fff3841c82be5,0,David Alves,2014-06-02 23:55:52-07:00,['a65d3416be6767fd8df24030ee8788587cf717f7'],5,11,16,363359,4,0,0.6,0.6,979
7d975b9fae039dae1da8e59ee898c7f87b2fece3,0,Todd Lipcon,2014-06-02 23:59:54-07:00,['9c39abb9ac33f066c0e3bb02ae1fff3841c82be5'],3,49,52,363411,1,0.46875,1,1,979
b582466f52e291723f889d25d8cccf1ba398cc92,1,Todd Lipcon,2014-06-03 00:44:06-07:00,['7d975b9fae039dae1da8e59ee898c7f87b2fece3'],0,21,21,363432,4,0,1,0.375,979
e11ea6535ccc3166053df59d9f53261fc929e55e,0,David Alves,2014-06-03 10:45:27-07:00,['b582466f52e291723f889d25d8cccf1ba398cc92'],1,1,2,363434,1,,,,979
69de919aef824f4000f4cc9a95689f71387eccc4,0,Jean-Daniel Cryans,2014-06-03 14:04:59-07:00,['e11ea6535ccc3166053df59d9f53261fc929e55e'],1,3,4,363438,1,,,,979
88dbd2821be769d2011548f70fbed12ed1fe721a,1,Todd Lipcon,2014-06-03 14:12:58-07:00,['69de919aef824f4000f4cc9a95689f71387eccc4'],27,37,64,363502,3,1,1,1,979
2efd522ce5f63661eaa37a68101e70717dd34579,0,Vladimir Feinberg,2014-06-03 15:15:44-07:00,['88dbd2821be769d2011548f70fbed12ed1fe721a'],1,3,4,363506,1,,,,979
bf0d956039508943e68599a1e9f25d8d41637a4e,0,Jean-Daniel Cryans,2014-06-03 15:17:22-07:00,['2efd522ce5f63661eaa37a68101e70717dd34579'],1,1,2,363508,1,,,,979
8bee53c9aca5bf36cdf194c7048e8aff8dff92d5,1,David Alves,2014-06-03 15:34:40-07:00,['bf0d956039508943e68599a1e9f25d8d41637a4e'],79,209,288,363796,14,0.444444444,0.37037037,0.555555556,979
501ff82dc5744f81c8786690c90b85997e49d541,0,Todd Lipcon,2014-06-03 15:35:20-07:00,['8bee53c9aca5bf36cdf194c7048e8aff8dff92d5'],17,52,69,363865,3,0,1,0.846153846,979
a97bffe15381165481bbf2b3d7f24c37cfa97ebf,1,Todd Lipcon,2014-06-03 15:38:28-07:00,['501ff82dc5744f81c8786690c90b85997e49d541'],3,101,104,363969,9,0.258064516,1,0.258064516,979
4e6bfe8775028dbbc68f70bade31157cdd9362cf,0,David Alves,2014-06-03 15:48:15-07:00,['a97bffe15381165481bbf2b3d7f24c37cfa97ebf'],0,10,10,363979,2,0,0.5,1,979
ed93d6722d6bd5aef09b6be9d1395e5beeac0b77,1,Todd Lipcon,2014-06-03 15:56:42-07:00,['4e6bfe8775028dbbc68f70bade31157cdd9362cf'],16,122,138,364117,1,0.191176471,0.455882353,0.882352941,979
475306e95016d1eef06a408a302d0c7fba949c6c,1,David Alves,2014-06-03 16:13:41-07:00,['ed93d6722d6bd5aef09b6be9d1395e5beeac0b77'],13,109,122,364239,6,0.111111111,0.777777778,1,979
545e0592b2391886a4b799a07ba240fc7803b13e,1,Todd Lipcon,2014-06-03 18:14:19-07:00,['475306e95016d1eef06a408a302d0c7fba949c6c'],22,152,174,364413,9,0.405797101,0.289855072,0.652173913,979
b3b3525b3a04d5568b17834ed7bf86e39d76e752,0,David Alves,2014-06-03 18:57:41-07:00,['545e0592b2391886a4b799a07ba240fc7803b13e'],2,2,4,364417,1,,,,979
17d0715d41df82b9837f7c4e821a4962ee5027df,0,David Alves,2014-06-03 19:07:51-07:00,['b3b3525b3a04d5568b17834ed7bf86e39d76e752'],0,21,21,364438,1,1,1,1,979
4f5cbd4ce502fb6bec58a0b7da3498a2da292af4,1,Adar Dembo,2014-06-04 08:12:42-07:00,['17d0715d41df82b9837f7c4e821a4962ee5027df'],30,144,174,364612,5,0.865384615,0.846153846,0.865384615,980
a512c3ca74a2564f6441314c51689c6705f7eda4,1,Alex Feinberg,2014-06-04 15:14:36-07:00,['4f5cbd4ce502fb6bec58a0b7da3498a2da292af4'],19,150,169,364781,6,0.253012048,0.987951807,0.746987952,980
e0b448b72fa72166d8a37a4893a46618b7ef432a,1,David Alves,2014-06-04 15:38:04-07:00,['a512c3ca74a2564f6441314c51689c6705f7eda4'],56,192,248,365029,16,0.659574468,0.978723404,0,980
f74753877d5692601cfa7efaa534cb6f746c5ae4,0,Jean-Daniel Cryans,2014-06-04 16:32:58-07:00,['e0b448b72fa72166d8a37a4893a46618b7ef432a'],3,6,9,365038,1,,,,980
c38b13382fc76604bd65511a0eb8f43f801456f7,0,David Alves,2014-06-04 18:47:22-07:00,['f74753877d5692601cfa7efaa534cb6f746c5ae4'],14,55,69,365107,4,0,0.894736842,1,980
43d4a75523dd78b3915dd1890075cb747ec6346b,0,David Alves,2014-06-04 19:13:14-07:00,['c38b13382fc76604bd65511a0eb8f43f801456f7'],0,1,1,365108,1,1,1,1,980
71c2ab621408500233d02fe458c56cc8660472a0,1,Todd Lipcon,2014-06-04 19:18:52-07:00,['43d4a75523dd78b3915dd1890075cb747ec6346b'],16,100,116,365224,5,0,0.603448276,1,980
c747b2f7ab8a69aee38d46fd4028fe9ac8a540ab,0,David Alves,2014-06-04 19:57:47-07:00,['71c2ab621408500233d02fe458c56cc8660472a0'],3,27,30,365254,5,0.538461538,1,0.923076923,980
a8e40f2926770d9bd27c93a5cc03ad0f482bdd44,0,David Alves,2014-06-04 21:19:28-07:00,['c747b2f7ab8a69aee38d46fd4028fe9ac8a540ab'],10,35,45,365299,3,1,1,1,980
1878613fcc70bfff2c2f579e0a83a3b687f5cc7f,0,Todd Lipcon,2014-06-04 23:38:25-07:00,['a8e40f2926770d9bd27c93a5cc03ad0f482bdd44'],3,4,7,365306,1,,,,980
3bcc0feed17122b67b21a41c691fd7c9efe7cfa9,1,Todd Lipcon,2014-06-04 23:38:35-07:00,['1878613fcc70bfff2c2f579e0a83a3b687f5cc7f'],124,124,248,365554,5,1,0,0.1,980
424da007b9ba445d71299b40d6f93b1e9fd567f0,1,Jean-Daniel Cryans,2014-06-05 08:17:07-07:00,['3bcc0feed17122b67b21a41c691fd7c9efe7cfa9'],18,38,56,365610,6,0.5,0.5,1,980
bf10fa747553648be0ac0d419322c62db232b5f7,1,Todd Lipcon,2014-06-05 10:26:06-07:00,['424da007b9ba445d71299b40d6f93b1e9fd567f0'],3,6,9,365619,1,0,1,1,980
85aef3f959c9f37c7f142e1502dcfc6a96aa2ce7,1,Michael Percy,2014-06-05 12:22:58-07:00,['bf10fa747553648be0ac0d419322c62db232b5f7'],20,21,41,365660,2,,,,980
913784140f2373ac4eec44c860bbc51a2a9968ac,1,Michael Percy,2014-06-05 12:24:23-07:00,['85aef3f959c9f37c7f142e1502dcfc6a96aa2ce7'],40,45,85,365745,3,0,0,0,980
335961a49cde59dc7f29ef7b460d017b056943d0,1,Alex Feinberg,2014-06-05 13:09:16-07:00,['913784140f2373ac4eec44c860bbc51a2a9968ac'],64,104,168,365913,11,1,1,1,982
e378318fa3d38c3addefad9d21e41ee82cb41044,1,Michael Percy,2014-06-05 13:35:37-07:00,['335961a49cde59dc7f29ef7b460d017b056943d0'],13,23,36,365949,2,1,1,1,982
50f93570f1db314019975acbf9b581f052f180fe,0,David Alves,2014-06-05 13:45:41-07:00,['e378318fa3d38c3addefad9d21e41ee82cb41044'],4,4,8,365957,1,,,,982
45cddd61d61db36935c973f0dfa441a793390dfa,0,Todd Lipcon,2014-06-05 18:26:52-07:00,['50f93570f1db314019975acbf9b581f052f180fe'],13,12,25,365982,2,0,0,0,982
fe33ff4fdaa2517d874a7080842fb583657dc116,1,Todd Lipcon,2014-06-05 18:27:06-07:00,['45cddd61d61db36935c973f0dfa441a793390dfa'],118,273,391,366373,9,0.536082474,0.371134021,0.762886598,982
b53461c934d0a36574a56246dd013e4167db0a70,1,Todd Lipcon,2014-06-05 18:31:38-07:00,['fe33ff4fdaa2517d874a7080842fb583657dc116'],45,70,115,366488,1,0,1,1,982
12f737f2acc7458eae8f12f1338e56535eb5ec41,0,Todd Lipcon,2014-06-05 18:54:15-07:00,['b53461c934d0a36574a56246dd013e4167db0a70'],2,3,5,366493,2,0,1,1,982
bfbfe0c3dff9a0433867b929e5c050ad5e0c0590,1,Todd Lipcon,2014-06-05 22:23:23-07:00,['12f737f2acc7458eae8f12f1338e56535eb5ec41'],109,120,229,366722,6,0.470588235,0,1,982
484bca16b0c3eea611bddcd80bd6d96a3ad8f5ed,1,Todd Lipcon,2014-06-05 22:25:57-07:00,['bfbfe0c3dff9a0433867b929e5c050ad5e0c0590'],19,172,191,366913,6,0.038834951,0.611650485,0.378640777,982
47d3fca98691556bc63a4007571a9dd3d901aae7,0,Todd Lipcon,2014-06-05 22:26:42-07:00,['484bca16b0c3eea611bddcd80bd6d96a3ad8f5ed'],14,61,75,366988,5,1,1,1,982
b3dfb734fdbacdd4ec15017191e38203f7aeb15b,0,Todd Lipcon,2014-06-05 22:36:08-07:00,['47d3fca98691556bc63a4007571a9dd3d901aae7'],2,2,4,366992,1,,,,982
3a5ca77d648acfcb61b0e5b5438e0fd905b5eace,0,Todd Lipcon,2014-06-09 12:12:58-07:00,['b3dfb734fdbacdd4ec15017191e38203f7aeb15b'],4,7,11,367003,1,,0,,982
cfca2f69bab4353afd901e984d188b91bceb79bf,1,Michael Percy,2014-06-09 18:29:40-07:00,['3a5ca77d648acfcb61b0e5b5438e0fd905b5eace'],12,59,71,367074,4,0.954545455,0.954545455,0.454545455,982
db7efbbfa40b9d60f2b555903ac7229a2f317005,1,Jean-Daniel Cryans,2014-06-09 21:12:10-07:00,['cfca2f69bab4353afd901e984d188b91bceb79bf'],0,17,17,367091,3,0.5,1,0.875,982
d5af9a59a0df4c31c2a7fda01ab657acedd81fe0,0,Todd Lipcon,2014-06-09 23:05:56-07:00,['db7efbbfa40b9d60f2b555903ac7229a2f317005'],1,3,4,367095,2,1,1,1,982
faac919b2b73b94ca8dc1d9ab90d0fd814e4c99a,0,Michael Percy,2014-06-10 11:06:14-07:00,['d5af9a59a0df4c31c2a7fda01ab657acedd81fe0'],2,4,6,367101,2,,,,982
12051086d720bf2f4370940a87ea743b0fe14e42,0,Michael Percy,2014-06-10 11:08:27-07:00,['faac919b2b73b94ca8dc1d9ab90d0fd814e4c99a'],5,0,5,367106,2,0,0,0,982
d26f827d502e12e61607dc9948fe2b9ab9160eb5,0,Michael Percy,2014-06-10 11:50:30-07:00,['12051086d720bf2f4370940a87ea743b0fe14e42'],2,59,61,367167,2,,,,983
2462b5f5c8af439838b02b5819daa717a9574b09,0,Michael Percy,2014-06-10 11:59:44-07:00,['d26f827d502e12e61607dc9948fe2b9ab9160eb5'],0,5,5,367172,1,0,1,1,983
05d2ae4c3a36387e9af31739a43fc7637a1d0e55,0,Michael Percy,2014-06-10 12:11:17-07:00,['2462b5f5c8af439838b02b5819daa717a9574b09'],6,6,12,367184,1,,,,983
6290e88f2d35070f806bfb1aa61656aabebf72f6,0,Todd Lipcon,2014-06-10 12:31:36-07:00,['05d2ae4c3a36387e9af31739a43fc7637a1d0e55'],1,2,3,367187,1,0,1,1,983
04bff3720c1b68f71a8e303e39e45b70f57ce461,1,Michael Percy,2014-06-10 13:35:07-07:00,['6290e88f2d35070f806bfb1aa61656aabebf72f6'],0,49,49,367236,2,0,0,1,983
29ed28693fd19989954c7b834aa6e13b9eee7d88,0,Todd Lipcon,2014-06-10 17:04:31-07:00,['04bff3720c1b68f71a8e303e39e45b70f57ce461'],4,3,7,367243,1,0,0,0,983
11ea2bf368271764713c1c44dcb1b180a53b6ad8,1,Todd Lipcon,2014-06-10 17:05:50-07:00,['29ed28693fd19989954c7b834aa6e13b9eee7d88'],86,83,169,367412,5,1,0,0,983
0f3f891e434f3f4aabb42c37e5985341f1a0c527,1,Todd Lipcon,2014-06-10 17:07:57-07:00,['11ea2bf368271764713c1c44dcb1b180a53b6ad8'],10,10,20,367432,1,,,,983
df2840990c76ed7cc3501ead73cb5e28e67e9a09,0,Todd Lipcon,2014-06-10 17:08:49-07:00,['0f3f891e434f3f4aabb42c37e5985341f1a0c527'],6,21,27,367459,3,1,1,1,983
df1111c2702f48173ae0669243c4f3fa47c07012,1,Todd Lipcon,2014-06-10 17:18:13-07:00,['df2840990c76ed7cc3501ead73cb5e28e67e9a09'],13,94,107,367566,6,0.641025641,0,0.641025641,983
7b17b0358688c62e1f3f3765758497f3c0e6fd1b,0,Todd Lipcon,2014-06-10 17:34:24-07:00,['df1111c2702f48173ae0669243c4f3fa47c07012'],11,3,14,367580,3,,,,983
ea15fabc4e8ed764486f055c679e3a0666cc0358,0,Todd Lipcon,2014-06-10 19:06:57-07:00,['7b17b0358688c62e1f3f3765758497f3c0e6fd1b'],6,31,37,367617,1,0,0.533333333,1,983
647753625e6110dafc49846a305140fe1956bd3c,0,David Alves,2014-06-10 19:24:47-07:00,['ea15fabc4e8ed764486f055c679e3a0666cc0358'],3,13,16,367633,1,0,0,1,983
2c1dc9426d05029840828a48fb5c4793c3c0ce91,0,David Wang,2014-06-10 20:51:25-07:00,['647753625e6110dafc49846a305140fe1956bd3c'],4,22,26,367659,4,1,1,1,983
f03be2a413898a325e9b2f09e9ad3a5c8d821fee,0,Jean-Daniel Cryans,2014-06-11 09:29:46-07:00,['2c1dc9426d05029840828a48fb5c4793c3c0ce91'],153,12,165,367824,2,0.806451613,0,0,983
ba6123ed514af5d7d9b3498a8448f9a25a0ff5be,0,Jean-Daniel Cryans,2014-06-11 09:30:11-07:00,['f03be2a413898a325e9b2f09e9ad3a5c8d821fee'],39,14,53,367877,1,0,0,0,983
7fce094ae3c45386cbd7105f749aedb95e5e7595,0,Jean-Daniel Cryans,2014-06-11 09:30:34-07:00,['ba6123ed514af5d7d9b3498a8448f9a25a0ff5be'],30,27,57,367934,4,0,0,0,983
241640eb45f69babbf5f16ba23aa76ed1b5677d2,1,Alex Feinberg,2014-06-11 12:03:18-07:00,['7fce094ae3c45386cbd7105f749aedb95e5e7595'],8,163,171,368105,15,0.673267327,0.524752475,1,983
b978466a4a76cb74dbf325473b11ca064ce9890d,1,Todd Lipcon,2014-06-11 12:35:59-07:00,['241640eb45f69babbf5f16ba23aa76ed1b5677d2'],106,181,287,368392,7,1,1,1,985
0a6891b211536841099ff57dc0b064e2395533e9,0,Todd Lipcon,2014-06-11 12:48:48-07:00,['b978466a4a76cb74dbf325473b11ca064ce9890d'],17,2,19,368411,5,1,0,1,985
7ce2e096330fb6b04f3e6a576624a716f2e00c30,1,Todd Lipcon,2014-06-11 12:53:28-07:00,['0a6891b211536841099ff57dc0b064e2395533e9'],12,27,39,368450,3,0.333333333,1,1,985
3914b1b75a70986ea0ac11910b8ac9380e70089a,0,Jean-Daniel Cryans,2014-06-11 12:53:30-07:00,['7ce2e096330fb6b04f3e6a576624a716f2e00c30'],5,9,14,368464,2,0,0,1,985
22b35d101fb62852b16fbd20c4403a386d269178,1,Adar Dembo,2014-06-11 15:05:55-07:00,['3914b1b75a70986ea0ac11910b8ac9380e70089a'],24,24,48,368512,2,,,,985
0652fba4cb9632091e03f911beb499aab2a18c3c,0,Jean-Daniel Cryans,2014-06-11 15:13:59-07:00,['22b35d101fb62852b16fbd20c4403a386d269178'],277,10,287,368799,2,0.343137255,0.18627451,0,985
919d634a6709e22aff09a8c07b1b21c430ed4b37,1,David Alves,2014-06-11 19:20:15-07:00,['0652fba4cb9632091e03f911beb499aab2a18c3c'],23,50,73,368872,6,0,0,1,985
c1b9c19e25f6e85a65a5723f4cd467e808a4bbf5,1,Todd Lipcon,2014-06-12 09:49:05-07:00,['919d634a6709e22aff09a8c07b1b21c430ed4b37'],11,490,501,369373,5,0.268361582,0.5,0.898305085,985
7ede90170df53a2d74f1b686e129c1725ca0aa0b,1,Alex Feinberg,2014-06-12 14:15:49-07:00,['c1b9c19e25f6e85a65a5723f4cd467e808a4bbf5'],7,105,112,369485,4,0.711864407,1,1,985
b8de5cbc1e07f856c7fb0031a52e672bb111bf37,0,Jean-Daniel Cryans,2014-06-12 15:53:23-07:00,['7ede90170df53a2d74f1b686e129c1725ca0aa0b'],4,6,10,369495,1,1,1,1,985
733c2dc10c23a192bdb56755a3704b65ff7b6cfb,0,Jean-Daniel Cryans,2014-06-12 16:48:10-07:00,['b8de5cbc1e07f856c7fb0031a52e672bb111bf37'],10,17,27,369522,2,1,1,1,985
f492fbff2584552def40ef721814e0bea9d3edec,1,Todd Lipcon,2014-06-12 17:00:07-07:00,['733c2dc10c23a192bdb56755a3704b65ff7b6cfb'],180,188,368,369890,11,1,0,0,985
24145b62232df293b54e4b2494540bdadd1b85ad,1,Adar Dembo,2014-06-12 18:47:10-07:00,['f492fbff2584552def40ef721814e0bea9d3edec'],9,13,22,369912,2,1,1,1,985
2fb7af65cd59bbe51b88f23b49492435249b3f52,0,Michael Percy,2014-06-13 01:52:39-07:00,['24145b62232df293b54e4b2494540bdadd1b85ad'],1,2,3,369915,1,0,1,1,985
f7332cbfeaa3bbb6176035ac8993c939ed49fca8,0,Todd Lipcon,2014-06-13 11:22:18-07:00,['2fb7af65cd59bbe51b88f23b49492435249b3f52'],5,25,30,369945,1,0,0,1,985
70d25d4e4078d529339f9802a2d238e5f081d1ef,0,Todd Lipcon,2014-06-13 13:14:58-07:00,['f7332cbfeaa3bbb6176035ac8993c939ed49fca8'],1,42,43,369988,2,0,0.92,1,985
b1e551f514950ed4be2df7773b0c12f3b6ed436f,1,Vladimir Feinberg,2014-06-13 13:15:02-07:00,['70d25d4e4078d529339f9802a2d238e5f081d1ef'],0,149,149,370137,1,0.264705882,0.480392157,0.666666667,985
df2ebef5c3c9c9b93abd403ba79fee9742ebb9e5,0,Vladimir Feinberg,2014-06-13 13:15:37-07:00,['b1e551f514950ed4be2df7773b0c12f3b6ed436f'],2,11,13,370150,1,,,,985
0295cd19bee7b7bab2a569e5423a958e29d4aaf3,1,Alex Feinberg,2014-06-13 13:20:07-07:00,['df2ebef5c3c9c9b93abd403ba79fee9742ebb9e5'],12,116,128,370278,11,0.923076923,0.923076923,0.923076923,987
f9da34d434246b53acffd089de3f5fc913f1416f,1,Adar Dembo,2014-06-13 13:33:11-07:00,['0295cd19bee7b7bab2a569e5423a958e29d4aaf3'],108,440,548,370826,14,0.782608696,1,1,989
642276d5ff9880ff8ac4d39d09dae07e7e793bb6,1,Vladimir Feinberg,2014-06-13 14:24:12-07:00,['f9da34d434246b53acffd089de3f5fc913f1416f'],11,18,29,370855,4,1,1,1,989
35a330831eec0e5878d3a676356f6edabc038146,1,Adar Dembo,2014-06-13 15:38:27-07:00,['642276d5ff9880ff8ac4d39d09dae07e7e793bb6'],10,15,25,370880,1,0.4,1,0.4,989
fbb11888adc6bf8859f921fc2ab0179515b95409,0,Alex Feinberg,2014-06-13 16:37:55-07:00,['35a330831eec0e5878d3a676356f6edabc038146'],1,1,2,370882,1,,,,989
87b662623029cf91eefb150d91e02ceab530ae4a,0,Jean-Daniel Cryans,2014-06-13 17:42:43-07:00,['fbb11888adc6bf8859f921fc2ab0179515b95409'],14,91,105,370987,2,0.302325581,0.302325581,1,989
5c22dd507510fd154a0fcf5ab19d140e66e48fb9,0,Jean-Daniel Cryans,2014-06-13 17:43:04-07:00,['87b662623029cf91eefb150d91e02ceab530ae4a'],16,71,87,371074,3,0.764705882,0.960784314,0.960784314,989
160dbd3fbf32a626cbd554eecd61be90f7c2eb0b,0,Adar Dembo,2014-06-13 17:54:52-07:00,['5c22dd507510fd154a0fcf5ab19d140e66e48fb9'],1,2,3,371077,1,1,1,1,989
4753cf9f5066bd61bd312d419fa51c64225a14c6,1,Adar Dembo,2014-06-14 00:13:37-07:00,['160dbd3fbf32a626cbd554eecd61be90f7c2eb0b'],4,16,20,371097,3,0,0.75,1,989
5e0b07eba00d04a4a4f66fc801b4af1a5700a132,1,David Alves,2014-06-16 12:47:54-07:00,['4753cf9f5066bd61bd312d419fa51c64225a14c6'],121,315,436,371533,15,0.1375,1,1,989
981d9ac5e6bd1adb192509c352ae4b745ae33e7b,1,Adar Dembo,2014-06-17 15:23:34-07:00,['5e0b07eba00d04a4a4f66fc801b4af1a5700a132'],220,427,647,372180,25,,,,989
5c8d77e23ea5276c51380cbc5993516b21579e39,0,David Wang,2014-06-17 16:05:50-07:00,['981d9ac5e6bd1adb192509c352ae4b745ae33e7b'],6,6,12,372192,1,,,,989
140a868fdb83dfbbe6289f4318c7d5dee8978644,0,Todd Lipcon,2014-06-17 16:39:01-07:00,['5c8d77e23ea5276c51380cbc5993516b21579e39'],2,4,6,372198,2,1,1,1,989
b5e9979b8b681d2357bd9c093bc5039034dd257b,0,Michael Percy,2014-06-17 16:50:03-07:00,['140a868fdb83dfbbe6289f4318c7d5dee8978644'],24,18,42,372240,7,0,1,1,989
72c6296be903b904833421e91c536100a5884e58,0,Todd Lipcon,2014-06-17 23:53:19-07:00,['b5e9979b8b681d2357bd9c093bc5039034dd257b'],10,58,68,372308,1,0.366666667,0.366666667,0.866666667,989
d11936a59670db988e3ef1d80c0b24a416ea82f7,0,Jean-Daniel Cryans,2014-06-18 09:35:16-07:00,['72c6296be903b904833421e91c536100a5884e58'],42,65,107,372415,3,,,0,989
06482e6d50de851bed5691eab370e5f6621bfa14,0,Jean-Daniel Cryans,2014-06-18 09:36:11-07:00,['d11936a59670db988e3ef1d80c0b24a416ea82f7'],9,13,22,372437,3,0,1,0,989
4cd787e1687b4f23c23b553115908a1b56d5bf20,0,Todd Lipcon,2014-06-18 10:55:10-07:00,['06482e6d50de851bed5691eab370e5f6621bfa14'],10,14,24,372461,3,0.666666667,1,1,989
a3401e218ec6f81935c32a7fc3db2ad34130395a,0,Todd Lipcon,2014-06-18 10:57:39-07:00,['4cd787e1687b4f23c23b553115908a1b56d5bf20'],1,5,6,372467,1,0,0,0,989
816b71fa2ba0a801cd01f356b8b4f7078c9ed98b,0,Todd Lipcon,2014-06-18 10:58:02-07:00,['a3401e218ec6f81935c32a7fc3db2ad34130395a'],1,2,3,372470,1,0,1,0,989
6d72ded12c4f83da5fddb8273ba478a840499674,0,Todd Lipcon,2014-06-18 11:01:03-07:00,['816b71fa2ba0a801cd01f356b8b4f7078c9ed98b'],8,10,18,372488,1,1,1,0,989
566e54d0c9d10ac18bde874966806d4da900a0a6,1,Vladimir Feinberg,2014-06-18 11:50:51-07:00,['6d72ded12c4f83da5fddb8273ba478a840499674'],5,9,14,372502,1,,,,989
a0536fea86e04b8d4736f1d74c50273b212940c8,0,David Alves,2014-06-18 13:09:44-07:00,['566e54d0c9d10ac18bde874966806d4da900a0a6'],4,8,12,372514,1,0,1,1,989
c1ee4e5df5e6f4d63cb53c5ba3b39b256b84293d,0,Todd Lipcon,2014-06-18 15:07:40-07:00,['a0536fea86e04b8d4736f1d74c50273b212940c8'],8,101,109,372623,3,1,1,1,989
cf3bea1189a37ac1086209d59880627c07a466e7,0,Todd Lipcon,2014-06-18 15:57:17-07:00,['c1ee4e5df5e6f4d63cb53c5ba3b39b256b84293d'],79,72,151,372774,1,1,1,0,989
d9a4f3dc6be8990f1be4435e85b6636787acecfd,1,Todd Lipcon,2014-06-18 15:57:42-07:00,['cf3bea1189a37ac1086209d59880627c07a466e7'],14,14,28,372802,3,,,,989
0ed735fc1a7c7220504ddd81016f7221522c72fe,0,Todd Lipcon,2014-06-18 15:58:34-07:00,['d9a4f3dc6be8990f1be4435e85b6636787acecfd'],63,45,108,372910,2,,,,989
5d46f16f7d15b9e2ca55c7913b56ce1e99b9fc9d,1,David Alves,2014-06-18 16:18:31-07:00,['0ed735fc1a7c7220504ddd81016f7221522c72fe'],9,162,171,373081,3,0.15942029,0.811594203,0.855072464,989
21806fe0e3974ebe919de1134dfdfe6b6ca7d900,0,Todd Lipcon,2014-06-18 17:02:28-07:00,['5d46f16f7d15b9e2ca55c7913b56ce1e99b9fc9d'],9,221,230,373311,7,0.794642857,1,1,990
b3e2806ed899daa26936564d9ff35fcd9ca77b6d,0,Jean-Daniel Cryans,2014-06-18 17:31:09-07:00,['21806fe0e3974ebe919de1134dfdfe6b6ca7d900'],1,1,2,373313,1,,,,990
0af4fc25d4040a35e0679e36f60fc5606b0c410a,1,Jean-Daniel Cryans,2014-06-18 17:32:53-07:00,['b3e2806ed899daa26936564d9ff35fcd9ca77b6d'],48,60,108,373421,2,1,1,0,990
44186c4849ba27cd36474254c3f7f233856ea31d,0,Adar Dembo,2014-06-18 17:40:07-07:00,['0af4fc25d4040a35e0679e36f60fc5606b0c410a'],2,2,4,373425,2,,,,990
12ea4c9a91c23abf4d5f73a611f7dfae19fdca26,0,Michael Percy,2014-06-18 18:39:10-07:00,['44186c4849ba27cd36474254c3f7f233856ea31d'],4,11,15,373440,3,1,1,1,990
259512fc18332d910310c964de418155339212f8,1,Michael Percy,2014-06-19 10:53:07-07:00,['12ea4c9a91c23abf4d5f73a611f7dfae19fdca26'],0,2,2,373442,1,0,0,1,990
9bf663604ab4ece5b86128575bd73b9b8b6d79f0,0,Todd Lipcon,2014-06-19 12:46:50-07:00,['259512fc18332d910310c964de418155339212f8'],2,1,3,373445,2,,,,990
ebc6d115114665a9b49f3206a591b03c0de8e44a,0,Jean-Daniel Cryans,2014-06-19 14:12:39-07:00,['9bf663604ab4ece5b86128575bd73b9b8b6d79f0'],14,24,38,373483,1,0,1,1,990
0b0361ef9194ebef4a1234f5927af12bb7fae971,0,Todd Lipcon,2014-06-19 14:27:09-07:00,['ebc6d115114665a9b49f3206a591b03c0de8e44a'],6,30,36,373519,4,0.2,1,1,990
77024567517001c993e6ee75ddaab985f4eb7723,1,Todd Lipcon,2014-06-19 15:18:51-07:00,['0b0361ef9194ebef4a1234f5927af12bb7fae971'],77,214,291,373810,7,1,1,1,992
7e464f4bd370e5f5d0b8078b7a5fecb5a803fe5a,0,Michael Percy,2014-06-19 15:48:58-07:00,['77024567517001c993e6ee75ddaab985f4eb7723'],1,10,11,373821,2,1,1,1,992
5a3f8415e0721179047844f13f6f2c6c65b8c5ad,1,Adar Dembo,2014-06-19 16:09:46-07:00,['7e464f4bd370e5f5d0b8078b7a5fecb5a803fe5a'],2,80,82,373903,6,,,,993
9823522d2b2dfec3f969c872665306597d7a5aa6,0,Michael Percy,2014-06-19 16:15:56-07:00,['5a3f8415e0721179047844f13f6f2c6c65b8c5ad'],0,1,1,373904,1,0,1,0,993
9f89fcaef53c32fef89ded913f86bd6680e65e33,1,Todd Lipcon,2014-06-19 16:32:46-07:00,['9823522d2b2dfec3f969c872665306597d7a5aa6'],694,704,1398,375302,92,1,1,0,993
d2cba15f9228bd34b94d7fab911dd897c68af254,1,Jean-Daniel Cryans,2014-06-19 16:51:13-07:00,['9f89fcaef53c32fef89ded913f86bd6680e65e33'],76,123,199,375501,2,1,1,1,994
c1f0467b9d3950243760cbdb2b63222b951b699e,0,Michael Percy,2014-06-19 21:50:19-07:00,['d2cba15f9228bd34b94d7fab911dd897c68af254'],16,28,44,375545,2,,,,994
4b4bb15f0b284623726792f2dda38225dc12b046,1,Michael Percy,2014-06-19 22:16:33-07:00,['c1f0467b9d3950243760cbdb2b63222b951b699e'],3,12,15,375560,1,,,,994
f5c24b56d55a5ba9177b2f0ed999e6d85ab10332,1,Todd Lipcon,2014-06-20 10:09:12-07:00,['4b4bb15f0b284623726792f2dda38225dc12b046'],44,99,143,375703,3,0,1,1,994
1d99434f6c3ad52362750790984fe802a8a36621,1,Todd Lipcon,2014-06-20 10:24:54-07:00,['f5c24b56d55a5ba9177b2f0ed999e6d85ab10332'],5,26,31,375734,3,0,1,1,994
2b57c52a6ffcbe2d6a01b4271534c7c49cfca7e3,1,Todd Lipcon,2014-06-20 10:25:40-07:00,['1d99434f6c3ad52362750790984fe802a8a36621'],156,287,443,376177,12,0.55,0.883333333,1,994
dbc533b65383961a1455741c7e2b857c6f95adbe,1,Todd Lipcon,2014-06-20 10:52:46-07:00,['2b57c52a6ffcbe2d6a01b4271534c7c49cfca7e3'],72,107,179,376356,46,,,,994
a385bd139d88982783d77e835a3603c350f05c01,1,Todd Lipcon,2014-06-20 10:54:12-07:00,['dbc533b65383961a1455741c7e2b857c6f95adbe'],290,352,642,376998,7,,,,997
888bdfbf89944af6e55dd020ec9e232bcabc7599,1,Todd Lipcon,2014-06-20 10:55:54-07:00,['a385bd139d88982783d77e835a3603c350f05c01'],24,104,128,377126,7,0.704545455,1,0,997
a4f38e517881e1f823f7ace10a628f8c56267250,0,Todd Lipcon,2014-06-20 11:06:15-07:00,['888bdfbf89944af6e55dd020ec9e232bcabc7599'],0,1,1,377127,1,,,,997
072954020678270ab83cf36bca811d16226617b9,0,Todd Lipcon,2014-06-20 11:19:39-07:00,['a4f38e517881e1f823f7ace10a628f8c56267250'],5,21,26,377153,1,,,,997
b28ebec6d6d97da474e9ad9fde3050f920c71305,0,Todd Lipcon,2014-06-20 11:23:59-07:00,['072954020678270ab83cf36bca811d16226617b9'],7,21,28,377181,1,,,,997
73d72c1980de054c54bda8b8b69f2421a35cf08f,0,Todd Lipcon,2014-06-20 11:30:47-07:00,['b28ebec6d6d97da474e9ad9fde3050f920c71305'],2,4,6,377187,1,,,,997
16ee8bb6f57c710e929a959e168065da77396de3,0,Adar Dembo,2014-06-20 13:33:48-07:00,['73d72c1980de054c54bda8b8b69f2421a35cf08f'],1,3,4,377191,1,,,,997
c41ffb2736e06b06a89222951bb28476fc93be05,0,Todd Lipcon,2014-06-20 13:52:13-07:00,['16ee8bb6f57c710e929a959e168065da77396de3'],20,77,97,377288,2,1,1,0.214285714,997
c9b8879d602cd72c13e2276be86e491742224313,0,Todd Lipcon,2014-06-20 13:52:26-07:00,['c41ffb2736e06b06a89222951bb28476fc93be05'],5,1,6,377294,2,1,0,1,997
cb7f0061453188476b7bab2eb16e58558c26f3f9,0,Michael Percy,2014-06-20 14:24:44-07:00,['c9b8879d602cd72c13e2276be86e491742224313'],0,1,1,377295,1,,,,997
e8d6068f31564168be582f24f31d3ddbb4c7d5c3,1,Michael Percy,2014-06-20 14:31:57-07:00,['cb7f0061453188476b7bab2eb16e58558c26f3f9'],2,3,5,377300,1,,,,997
23f8c4a75f748b11fa73de1f1801d7c72aee89bb,0,Todd Lipcon,2014-06-20 14:43:59-07:00,['e8d6068f31564168be582f24f31d3ddbb4c7d5c3'],5,31,36,377336,1,0,0.954545455,0.045454545,997
892a24c6f97cbd343cdddc74ae6b9bc65d68d95b,0,Adar Dembo,2014-06-20 14:49:40-07:00,['23f8c4a75f748b11fa73de1f1801d7c72aee89bb'],48,55,103,377439,10,0,0,0,997
e7740cc7fa1603feb95314bdf66ce6d525cd4a7c,0,David Alves,2014-06-20 15:33:47-07:00,['892a24c6f97cbd343cdddc74ae6b9bc65d68d95b'],1,13,14,377453,3,1,1,1,997
867904ba0b8ab85a716227ed23db60b5a6e0b2a0,1,Todd Lipcon,2014-06-20 16:20:23-07:00,['e7740cc7fa1603feb95314bdf66ce6d525cd4a7c'],10,32,42,377495,3,0.117647059,0.176470588,0.882352941,997
7f4542ef202367e7e22dffead07aa2b5c97eec9b,1,Todd Lipcon,2014-06-20 17:01:13-07:00,['867904ba0b8ab85a716227ed23db60b5a6e0b2a0'],3,856,859,378354,5,0.486363636,0.752272727,0.879545455,1000
3ff487d555b61932e101b62fbdeba03065a5f0a1,1,Michael Percy,2014-06-20 17:37:24-07:00,['7f4542ef202367e7e22dffead07aa2b5c97eec9b'],42,110,152,378506,5,0.518518519,0.407407407,1,1000
f242d54c6a7fc01490d2200a7236175c6620a302,0,Michael Percy,2014-06-20 19:30:58-07:00,['3ff487d555b61932e101b62fbdeba03065a5f0a1'],16,22,38,378544,3,,,,1000
5acf180da16115b80141c9e3a711388c9cc6a194,0,Adar Dembo,2014-06-22 23:42:55-07:00,['f242d54c6a7fc01490d2200a7236175c6620a302'],95,99,194,378738,1,,,,1000
e034db1dab3f437e7e75cbd341400c97e02f5f7e,0,Todd Lipcon,2014-06-23 15:34:56-07:00,['5acf180da16115b80141c9e3a711388c9cc6a194'],2,5,7,378745,1,,,,1000
d6f9bda1b4118bc54d96d977173654004c69cd04,1,Todd Lipcon,2014-06-23 15:36:01-07:00,['e034db1dab3f437e7e75cbd341400c97e02f5f7e'],3,9,12,378757,3,0.333333333,1,1,1000
f35e743cd64dba63c60046f1b0a0de44d9fa34fb,1,Michael Percy,2014-06-23 16:05:52-07:00,['d6f9bda1b4118bc54d96d977173654004c69cd04'],76,127,203,378960,10,0.821428571,1,1,1000
17c65231b2639d821fc75281452ed51c6788c3fe,1,Alex Feinberg,2014-06-24 01:22:03-07:00,['f35e743cd64dba63c60046f1b0a0de44d9fa34fb'],30,165,195,379155,8,0.426470588,0.926470588,0.867647059,1000
b6f141f37c917ff1bc2607dc6808a680ca2b2c7d,1,David Alves,2014-06-24 11:07:35-07:00,['17c65231b2639d821fc75281452ed51c6788c3fe'],94,148,242,379397,5,0.730769231,1,1,1000
c218e192821647daec9fb1cab47c0f323ddd0ca6,0,Adar Dembo,2014-06-24 13:24:37-07:00,['b6f141f37c917ff1bc2607dc6808a680ca2b2c7d'],206,183,389,379786,11,1,0.064516129,0,1000
cdc4987966ec7ba57079bea5f319f2523fc84f05,1,Michael Percy,2014-06-24 13:53:53-07:00,['c218e192821647daec9fb1cab47c0f323ddd0ca6'],2,32,34,379820,5,0.869565217,1,1,1000
858e25b14aabfddc64a1e224a55769e0c115528a,1,Jean-Daniel Cryans,2014-06-24 16:44:20-07:00,['cdc4987966ec7ba57079bea5f319f2523fc84f05'],7,8,15,379835,1,,,,1000
ba03fa7b9d83ea3cf4b807c5314ee71f7a973e63,1,Adar Dembo,2014-06-24 19:24:03-07:00,['858e25b14aabfddc64a1e224a55769e0c115528a'],77,62,139,379974,10,0,0,0,1000
163a3be01f0914c095956b9b3bd89ecc8296ffd6,0,Jean-Daniel Cryans,2014-06-25 10:00:53-07:00,['ba03fa7b9d83ea3cf4b807c5314ee71f7a973e63'],9,0,9,379983,1,0,0,0,1000
4b3483507bf3e6aa4df6a78a6c76797675de4a4e,0,Jean-Daniel Cryans,2014-06-25 10:01:00-07:00,['163a3be01f0914c095956b9b3bd89ecc8296ffd6'],11,9,20,380003,12,,,,1000
c3f1e6bd599beeae897ef5158f55068f3d756f0e,0,Michael Percy,2014-06-25 10:27:48-07:00,['4b3483507bf3e6aa4df6a78a6c76797675de4a4e'],1,12,13,380016,1,,,,1000
8af47d35f57e7a7196c11aec49a4d756131ec604,0,Michael Percy,2014-06-25 10:28:12-07:00,['c3f1e6bd599beeae897ef5158f55068f3d756f0e'],25,41,66,380082,1,,,,1000
a9f4d1387473f1c07cf084fad2b80afcad2cc64d,0,Michael Percy,2014-06-25 10:32:13-07:00,['8af47d35f57e7a7196c11aec49a4d756131ec604'],3,32,35,380117,1,0.090909091,1,1,1000
99e890a34b0571e3af4b52fe65690b327ac69e0a,1,Adar Dembo,2014-06-25 11:42:08-07:00,['a9f4d1387473f1c07cf084fad2b80afcad2cc64d'],176,159,335,380452,15,1,0.304347826,0,1000
616e58790fe6c6fbec84bcc499a84d2cccfbf537,1,Todd Lipcon,2014-06-25 12:23:32-07:00,['99e890a34b0571e3af4b52fe65690b327ac69e0a'],13,26,39,380491,3,0.272727273,0.909090909,0.272727273,1000
93dd29d70d6fc914b16d5942580af51e729e187c,0,Todd Lipcon,2014-06-25 12:23:40-07:00,['616e58790fe6c6fbec84bcc499a84d2cccfbf537'],9,15,24,380515,2,1,1,1,1000
1ef8ed56657c1e5c6f68517d4721c4fe9766e6e7,1,Todd Lipcon,2014-06-25 14:30:07-07:00,['93dd29d70d6fc914b16d5942580af51e729e187c'],20,26,46,380561,1,0,0,0,1000
1e88ef3b87018c57918e914a6d4cbeb94b32dca6,1,Todd Lipcon,2014-06-25 15:54:50-07:00,['1ef8ed56657c1e5c6f68517d4721c4fe9766e6e7'],272,394,666,381227,28,1,1,0.69047619,1002
fb4f6494dca8feedd7b9f007b5df874262542774,1,Todd Lipcon,2014-06-25 21:13:09-07:00,['1e88ef3b87018c57918e914a6d4cbeb94b32dca6'],1,15,16,381243,1,0,1,1,1002
3e70a51ff6450f94d3902b7b143d6071e5947ecd,0,Todd Lipcon,2014-06-25 21:13:13-07:00,['fb4f6494dca8feedd7b9f007b5df874262542774'],0,18,18,381261,1,,,,1002
6c7ed7b5f1488c7ec296d29e70f1d2009bb38711,0,Todd Lipcon,2014-06-25 21:30:27-07:00,['3e70a51ff6450f94d3902b7b143d6071e5947ecd'],35,1,36,381297,2,1,0.4375,0.375,1002
a59d389a5669f2b925cf11ecef6c5c63ecca5f3f,1,Todd Lipcon,2014-06-25 23:30:44-07:00,['6c7ed7b5f1488c7ec296d29e70f1d2009bb38711'],15,91,106,381403,10,0.536585366,1,1,1002
7eb6472d5060e4e22c2fcca36e668219c0df8fd4,1,Todd Lipcon,2014-06-26 00:54:24-07:00,['a59d389a5669f2b925cf11ecef6c5c63ecca5f3f'],70,106,176,381579,4,1,1,1,1002
e4c431ccc83d6655699717e9acdd68b03dd73a8f,0,Michael Percy,2014-06-26 00:56:58-07:00,['7eb6472d5060e4e22c2fcca36e668219c0df8fd4'],25,6,31,381610,1,1,1,0,1002
985a8b9d110cd8044b1d9e22907f28fed8242b28,0,Michael Percy,2014-06-26 01:23:08-07:00,['e4c431ccc83d6655699717e9acdd68b03dd73a8f'],1,1,2,381612,1,,,,1002
ecb0d9d5bc9008a466b6eaa88b6c6cdfb1df416d,1,David Alves,2014-06-26 14:24:30-07:00,['985a8b9d110cd8044b1d9e22907f28fed8242b28'],7,4,11,381623,2,1,1,0,1002
ea2a2c778e339191a0ea14aa6e652d7379d7cc05,0,Adar Dembo,2014-06-26 15:52:48-07:00,['ecb0d9d5bc9008a466b6eaa88b6c6cdfb1df416d'],3,3,6,381629,1,,,,1002
30d45461e9e3b24c2206146fd99264b15ea79fba,1,Jean-Daniel Cryans,2014-06-26 16:13:08-07:00,['ea2a2c778e339191a0ea14aa6e652d7379d7cc05'],16,44,60,381689,8,0.947368421,0.947368421,1,1002
b7cd20234242d621d60770b6479bf36939bbd7c9,0,Jean-Daniel Cryans,2014-06-26 16:13:35-07:00,['30d45461e9e3b24c2206146fd99264b15ea79fba'],2,4,6,381695,1,0,1,1,1002
efb192b556746f6c3609bcffe80553149c5fb9e4,0,Jean-Daniel Cryans,2014-06-26 16:14:09-07:00,['b7cd20234242d621d60770b6479bf36939bbd7c9'],3,19,22,381717,2,0.692307692,1,1,1002
e033773fed2788c1484e9368a8231a78cbcccd86,0,Todd Lipcon,2014-06-26 17:32:23-07:00,['efb192b556746f6c3609bcffe80553149c5fb9e4'],1,6,7,381724,1,,,,1002
d0b1be28466847aa9b5be62b9e49a75fba3bb0cf,0,David Alves,2014-06-26 17:49:28-07:00,['e033773fed2788c1484e9368a8231a78cbcccd86'],21,37,58,381782,4,1,1,1,1002
eb935c9e215801f4320298a4c3f21a8da61825c0,1,Adar Dembo,2014-06-27 12:15:22-07:00,['d0b1be28466847aa9b5be62b9e49a75fba3bb0cf'],215,223,438,382220,32,0.705882353,0,0,1003
9c0cceb6d6f58205ec55c8d549c5a6b6531f678b,1,Jean-Daniel Cryans,2014-06-27 13:20:37-07:00,['eb935c9e215801f4320298a4c3f21a8da61825c0'],83,254,337,382557,6,0,0,0.900990099,1003
b8abfc6fbf0379f149226101b10f5d097a2e13ba,1,Jean-Daniel Cryans,2014-06-27 13:21:06-07:00,['9c0cceb6d6f58205ec55c8d549c5a6b6531f678b'],28,63,91,382648,4,0.44,0.92,0.84,1003
e85e50069d47ba2f1ec8b5c8f63c0e3df4329e27,1,David Alves,2014-06-27 15:12:18-07:00,['b8abfc6fbf0379f149226101b10f5d097a2e13ba'],44,56,100,382748,10,0,1,0,1003
d48b491b9edb2c27c4ba3ce7a75044cc1aa79b86,1,David Alves,2014-06-27 15:12:37-07:00,['e85e50069d47ba2f1ec8b5c8f63c0e3df4329e27'],6,121,127,382875,5,0.714285714,0.968253968,0.968253968,1004
a44fa3395ee11d1b029d7af859e4da9fc84efc3d,1,Todd Lipcon,2014-06-29 16:18:45-07:00,['d48b491b9edb2c27c4ba3ce7a75044cc1aa79b86'],398,472,870,383745,13,0.516129032,1,0,1006
25746fd3eb0b880eb62fd8aa8290247f56c7afdc,1,Todd Lipcon,2014-06-29 16:20:19-07:00,['a44fa3395ee11d1b029d7af859e4da9fc84efc3d'],30,37,67,383812,3,1,1,0,1006
b8ca56224f4ee9371f9abf768c3cb1661e409bcf,0,Todd Lipcon,2014-06-29 16:20:57-07:00,['25746fd3eb0b880eb62fd8aa8290247f56c7afdc'],5,5,10,383822,4,,,,1006
1b6071314c2327a7a531eb1323208c030fb9400e,0,Todd Lipcon,2014-06-29 16:21:48-07:00,['b8ca56224f4ee9371f9abf768c3cb1661e409bcf'],3,3,6,383828,1,1,1,1,1006
07e8dc2c024a834c9a0dc225c19ef3b3baba5965,0,Todd Lipcon,2014-06-29 16:22:25-07:00,['1b6071314c2327a7a531eb1323208c030fb9400e'],28,28,56,383884,6,,,,1006
18505af1f5d8f040da649809f06a67f588430162,0,Todd Lipcon,2014-06-29 16:37:39-07:00,['07e8dc2c024a834c9a0dc225c19ef3b3baba5965'],9,49,58,383942,2,0.363636364,1,1,1006
f40b74bc1b8a83a4f62f15ef3de0f5cdc7039b5f,0,Todd Lipcon,2014-06-30 11:13:40-07:00,['18505af1f5d8f040da649809f06a67f588430162'],4,28,32,383974,2,1,,,1006
ffcea4139a129a830a407f4850a72b9bdf10295b,0,Todd Lipcon,2014-06-30 11:28:49-07:00,['f40b74bc1b8a83a4f62f15ef3de0f5cdc7039b5f'],6,18,24,383998,1,1,1,1,1006
bcdff8066ef7884eceba05fdf9979146f4fdac6f,1,Todd Lipcon,2014-06-30 12:45:22-07:00,['ffcea4139a129a830a407f4850a72b9bdf10295b'],175,461,636,384634,12,0.238095238,1,0.469387755,1009
6ea097f52c9366cdbacd2674de6ef1518d483a89,0,Todd Lipcon,2014-06-30 12:46:02-07:00,['bcdff8066ef7884eceba05fdf9979146f4fdac6f'],12,53,65,384699,1,1,1,1,1009
93975306d44cb5d4ff37249658ff36b72b11aad3,0,Adar Dembo,2014-06-30 12:53:11-07:00,['6ea097f52c9366cdbacd2674de6ef1518d483a89'],1,1,2,384701,1,,,,1009
196b1d149a0e527ba3e27e17e13246a9ee591e93,0,Todd Lipcon,2014-06-30 13:59:57-07:00,['93975306d44cb5d4ff37249658ff36b72b11aad3'],10,10,20,384721,1,,,,1009
78a107b5ea55c0433ca48c8560f7953b57c7eaa9,0,Vladimir Feinberg,2014-06-30 16:10:11-07:00,['196b1d149a0e527ba3e27e17e13246a9ee591e93'],1,10,11,384732,1,0,1,1,1009
bb6f7085dc2688ae52589056163099ba7d1e1688,0,Jean-Daniel Cryans,2014-06-30 17:21:39-07:00,['78a107b5ea55c0433ca48c8560f7953b57c7eaa9'],39,46,85,384817,1,1,0,1,1009
550a0e158829b5ae800063cfbd4879c8da3e5997,0,Jean-Daniel Cryans,2014-06-30 17:21:48-07:00,['bb6f7085dc2688ae52589056163099ba7d1e1688'],13,29,42,384859,1,1,1,1,1009
cd16f4829f0ba898ab4bb975fd8ccff3396d8ce1,1,Todd Lipcon,2014-06-30 17:41:03-07:00,['550a0e158829b5ae800063cfbd4879c8da3e5997'],5,51,56,384915,1,1,1,1,1009
49d7d5652e34efcd25da49f8bd628effa3a6c5a9,1,Todd Lipcon,2014-06-30 17:41:27-07:00,['cd16f4829f0ba898ab4bb975fd8ccff3396d8ce1'],503,461,964,385879,10,0.309859155,0,0,1009
ed805721db11ab04c584157ef81c67d504a3008d,1,Jean-Daniel Cryans,2014-06-30 20:01:49-07:00,['49d7d5652e34efcd25da49f8bd628effa3a6c5a9'],12,6,18,385897,2,1,1,0,1009
3c0745d2a8054bb7293bc20342c92905cfe8f5c7,1,Jean-Daniel Cryans,2014-07-01 08:07:28-07:00,['ed805721db11ab04c584157ef81c67d504a3008d'],0,153,153,386050,4,1,0.832599119,0.910425844,1012
9017a925a85e27a702a5486c2faa02273b37a994,0,Adar Dembo,2014-07-01 13:59:44-07:00,['3c0745d2a8054bb7293bc20342c92905cfe8f5c7'],2,2,4,386054,1,,,,1012
22983f18a15884442283b6d29a49398c7a933ad7,0,Adar Dembo,2014-07-01 14:00:38-07:00,['9017a925a85e27a702a5486c2faa02273b37a994'],13,56,69,386123,2,,,,1012
0d4a0bd089ab6f144a6d269c58579691f5ade118,1,David Alves,2014-07-01 14:20:27-07:00,['22983f18a15884442283b6d29a49398c7a933ad7'],0,17,17,386140,4,1,1,1,1012
8a394366723e8dd1ce46afac8ed3264e3f8c5ecf,1,Vladimir Feinberg,2014-07-01 14:35:47-07:00,['0d4a0bd089ab6f144a6d269c58579691f5ade118'],16,85,101,386241,3,0.319148936,1,1,1012
dcc439bf37875e6cf718d420038ae181bb22fae1,1,Todd Lipcon,2014-07-01 14:55:29-07:00,['8a394366723e8dd1ce46afac8ed3264e3f8c5ecf'],9,8,17,386258,3,,,,1012
31b5c949fc3cfde839a56d98f932ac889ac9ba66,0,Todd Lipcon,2014-07-01 15:35:45-07:00,['dcc439bf37875e6cf718d420038ae181bb22fae1'],0,1,1,386259,1,,,,1012
6384f42b03011cca2eb2ffd5fb4dc92f20e3baee,1,Todd Lipcon,2014-07-01 15:36:53-07:00,['31b5c949fc3cfde839a56d98f932ac889ac9ba66'],420,136,556,386815,8,0.546341463,0.819512195,0.043902439,1013
40af5369f97e016c13182c544dc7f0e29b2da5da,1,Adar Dembo,2014-07-01 15:52:14-07:00,['6384f42b03011cca2eb2ffd5fb4dc92f20e3baee'],81,112,193,387008,2,0,0,0.5,1013
9ff64eb6fd9fe0c84d1f52ffa0bb2a6652532bcf,1,David Alves,2014-07-01 18:32:11-07:00,['40af5369f97e016c13182c544dc7f0e29b2da5da'],9,16,25,387033,3,1,1,1,1013
d272714ee03ad4f9cbc5fa04be4a595004595a62,0,Adar Dembo,2014-07-02 11:35:11-07:00,['9ff64eb6fd9fe0c84d1f52ffa0bb2a6652532bcf'],8,25,33,387066,1,,,,1013
31f072096c3fd27bcc62f6c1bdd9a5a8c807ae35,0,Todd Lipcon,2014-07-02 12:23:50-07:00,['d272714ee03ad4f9cbc5fa04be4a595004595a62'],32,7347,7379,394445,16,0.601345669,0.934398654,0.341883936,1026
053486cbda2061bf9dcf302ba5a17c60067008d9,1,Todd Lipcon,2014-07-02 12:28:00-07:00,['31f072096c3fd27bcc62f6c1bdd9a5a8c807ae35'],24,39,63,394508,1,1,1,1,1026
66282df07744e830ee84144de861f419fa945e51,1,Adar Dembo,2014-07-02 12:33:07-07:00,['053486cbda2061bf9dcf302ba5a17c60067008d9'],112,119,231,394739,18,0.9,0.7,1,1026
d0b699d07f087c27b2723f644a41df50ed299267,0,Todd Lipcon,2014-07-02 13:02:38-07:00,['66282df07744e830ee84144de861f419fa945e51'],33,23,56,394795,2,0,0,0,1026
41836aaab9a11f05a4f361d9cffc99b6bdb7dd96,0,Adar Dembo,2014-07-02 15:41:36-07:00,['d0b699d07f087c27b2723f644a41df50ed299267'],56,54,110,394905,9,0.222222222,0.111111111,0.111111111,1026
ec4b7d75f21a23f2f0712cddd1aeeb7f6f6edac1,0,Todd Lipcon,2014-07-02 16:47:27-07:00,['41836aaab9a11f05a4f361d9cffc99b6bdb7dd96'],11,58,69,394974,2,1,1,1,1026
6ff71b956d88cf1b43a3a1966e61d9e0300c9acd,1,Jean-Daniel Cryans,2014-07-03 08:55:40-07:00,['ec4b7d75f21a23f2f0712cddd1aeeb7f6f6edac1'],156,279,435,395409,27,1,1,0.15625,1033
cfc852c1195ea3513ba36c59d608f37ee1e7c7d2,0,Jean-Daniel Cryans,2014-07-03 09:26:48-07:00,['6ff71b956d88cf1b43a3a1966e61d9e0300c9acd'],0,1,1,395410,1,,,,1033
0c277ae15b0f06eb4bbf33a1c987dfa55b9516fe,0,Todd Lipcon,2014-07-03 13:24:12-07:00,['cfc852c1195ea3513ba36c59d608f37ee1e7c7d2'],7,35,42,395452,2,0,1,1,1033
7613bc19586d07a32093001102623ff9e5725ecf,0,Todd Lipcon,2014-07-03 14:05:26-07:00,['0c277ae15b0f06eb4bbf33a1c987dfa55b9516fe'],1,18,19,395471,4,0.416666667,0.416666667,0.666666667,1033
b0ef5f1300892420225162518ee7a12fc9ee1f29,1,Todd Lipcon,2014-07-03 14:10:37-07:00,['7613bc19586d07a32093001102623ff9e5725ecf'],0,1,1,395472,1,0,1,1,1033
5caf0d1fa5dea0f145f00240d786aca8afbf05e7,0,Adar Dembo,2014-07-03 14:21:51-07:00,['b0ef5f1300892420225162518ee7a12fc9ee1f29'],17,3,20,395492,1,1,0.4,0.2,1033
16a47465ea493a6eaca9cedadd6153345197e921,0,Alex Feinberg,2014-07-03 14:32:15-07:00,['5caf0d1fa5dea0f145f00240d786aca8afbf05e7'],11,0,11,395503,2,0,0,0,1033
dba61126f8cb5d82de84d79ab73a519da686a3a6,0,Todd Lipcon,2014-07-03 15:59:53-07:00,['16a47465ea493a6eaca9cedadd6153345197e921'],2,3,5,395508,1,,,,1033
4d3dadf2e2d84dcb4e86a32359afb8702366a5a1,0,Jean-Daniel Cryans,2014-07-03 16:00:35-07:00,['dba61126f8cb5d82de84d79ab73a519da686a3a6'],67,10,77,395585,22,0.727272727,0.636363636,0,1033
39bf2905c7b732e52ea3c190dc87414f6bf0a383,0,Michael Percy,2014-07-03 17:13:36-07:00,['4d3dadf2e2d84dcb4e86a32359afb8702366a5a1'],15,49,64,395649,2,0,0.428571429,1,1033
6917fce8eda8b75080ba35c629609c8fee1ca628,1,Todd Lipcon,2014-07-03 19:44:23-07:00,['39bf2905c7b732e52ea3c190dc87414f6bf0a383'],310,362,672,396321,8,1,0.411764706,0.764705882,1033
19d54a72ebb7ad3a72a6cad4c7044def2c0492ec,1,Todd Lipcon,2014-07-03 20:16:03-07:00,['6917fce8eda8b75080ba35c629609c8fee1ca628'],18,13,31,396352,1,0.5,0.5,0,1033
bbada5c51421732176bc2add61703a63d5db5f53,0,Michael Percy,2014-07-04 14:43:34-07:00,['19d54a72ebb7ad3a72a6cad4c7044def2c0492ec'],7,6,13,396365,5,1,0,0,1033
c9f75184ffca9eea0f0484156a13f824b0d7566e,1,Todd Lipcon,2014-07-06 20:26:46-07:00,['bbada5c51421732176bc2add61703a63d5db5f53'],17,17,34,396399,2,,,,1033
63d412d9bf2a3f3459ac7ad662edf9ed1ed5a9e2,0,Todd Lipcon,2014-07-06 21:20:40-07:00,['c9f75184ffca9eea0f0484156a13f824b0d7566e'],2,7,9,396408,2,,,,1033
bf15064e3dee22729b0934132107ff1d0c09db62,0,Todd Lipcon,2014-07-07 09:47:17-07:00,['63d412d9bf2a3f3459ac7ad662edf9ed1ed5a9e2'],30,61,91,396499,10,1,1,1,1033
0aa8aec34e66a38bb1f61254d26477e6527d51c7,1,Vladimir Feinberg,2014-07-07 11:34:37-07:00,['bf15064e3dee22729b0934132107ff1d0c09db62'],133,209,342,396841,7,0.933333333,1,0.766666667,1035
1aaaeacfb9635cad99be848a39a95edf1a0446f8,0,Michael Percy,2014-07-07 11:51:43-07:00,['0aa8aec34e66a38bb1f61254d26477e6527d51c7'],0,4,4,396845,1,,,,1035
6e30831ee0d67038fbd43ab1bfb4dd4d0b3c8dc2,0,Michael Percy,2014-07-07 12:04:35-07:00,['1aaaeacfb9635cad99be848a39a95edf1a0446f8'],0,6,6,396851,1,,,,1035
004ebd6dece98ab8498353eefc20663f576b185d,0,Michael Percy,2014-07-07 12:06:23-07:00,['6e30831ee0d67038fbd43ab1bfb4dd4d0b3c8dc2'],12,3,15,396866,1,1,1,0,1035
c4941caee4cee21c4ca1baa91069962fcc35b761,0,Michael Percy,2014-07-07 12:20:14-07:00,['004ebd6dece98ab8498353eefc20663f576b185d'],11,40,51,396917,1,,,,1035
6f5e6e672de5185f2e41e45fd1d1371d37cd8dc8,1,Jean-Daniel Cryans,2014-07-07 12:44:31-07:00,['c4941caee4cee21c4ca1baa91069962fcc35b761'],117,147,264,397181,4,1,1,1,1037
d35cd980f2cca09d56a64914717f7eb0c213d9db,1,Adar Dembo,2014-07-07 12:53:23-07:00,['6f5e6e672de5185f2e41e45fd1d1371d37cd8dc8'],34,47,81,397262,1,0,1,1,1037
b4f71bd761fc892297384f3ad7a32b0d372a87d1,1,Vladimir Feinberg,2014-07-07 13:29:41-07:00,['d35cd980f2cca09d56a64914717f7eb0c213d9db'],1,1,2,397264,1,,,,1037
fed3be90676fbcb5dc2ea007ad60d748c077d0e7,1,David Alves,2014-07-07 13:55:52-07:00,['b4f71bd761fc892297384f3ad7a32b0d372a87d1'],101,96,197,397461,8,0,1,0,1037
a4ee40dd3461f091ad2e04169755dbfeecc4571a,0,Adar Dembo,2014-07-07 15:28:41-07:00,['fed3be90676fbcb5dc2ea007ad60d748c077d0e7'],17,14,31,397492,2,1,1,0,1037
8da2b703f80d70aa94bb5b72dab69032b04f5056,1,Alex Feinberg,2014-07-07 16:19:09-07:00,['a4ee40dd3461f091ad2e04169755dbfeecc4571a'],64,365,429,397921,15,0.547945205,1,0.5,1037
9bf7414d5c34094d70ba6bba38edf6d6e00bb12a,1,David Alves,2014-07-07 17:19:22-07:00,['8da2b703f80d70aa94bb5b72dab69032b04f5056'],8,115,123,398044,1,0.037974684,0.075949367,1,1037
2e9289f19e6b399df7683f4f11c6cd8a71db4215,0,Vladimir Feinberg,2014-07-08 11:19:49-07:00,['9bf7414d5c34094d70ba6bba38edf6d6e00bb12a'],1,1,2,398046,1,,,,1037
ec5c91ba9fbbf82beb30eb1ba42e0e73c455d462,1,Todd Lipcon,2014-07-08 11:33:25-07:00,['2e9289f19e6b399df7683f4f11c6cd8a71db4215'],201,275,476,398522,18,1,1,1,1038
2141466a96329b83f4ac8767674b72c5ce664130,1,Todd Lipcon,2014-07-08 12:04:15-07:00,['ec5c91ba9fbbf82beb30eb1ba42e0e73c455d462'],0,348,348,398870,2,0.645833333,1,0.807291667,1039
dda13415b734c51443bd964107b4be9dbc3d81fe,0,Michael Percy,2014-07-08 12:32:57-07:00,['2141466a96329b83f4ac8767674b72c5ce664130'],15,46,61,398931,2,,,,1039
e4d4321f56c3d388a58e9fa0fc321fbc57ea54c0,1,Adar Dembo,2014-07-08 13:16:40-07:00,['dda13415b734c51443bd964107b4be9dbc3d81fe'],22,220,242,399173,6,0.652631579,0.978947368,0.926315789,1041
909899126b795bf01f75b7a52d3b87eb38de5c57,0,Jean-Daniel Cryans,2014-07-08 13:18:11-07:00,['e4d4321f56c3d388a58e9fa0fc321fbc57ea54c0'],16,215,231,399404,6,0.561797753,0.775280899,1,1043
bd54a47592bdf78b48d274e10459f86e88e9d814,0,Jean-Daniel Cryans,2014-07-08 13:40:04-07:00,['909899126b795bf01f75b7a52d3b87eb38de5c57'],0,27,27,399431,1,,,,1043
ce16e6e8eda915445b4fc19ce6139d4efc47847c,0,Todd Lipcon,2014-07-08 14:12:23-07:00,['bd54a47592bdf78b48d274e10459f86e88e9d814'],4,8,12,399443,1,0,1,1,1043
fc2f7e64c8fc7a75f1d8dbb82890d3dd240f30b6,0,David Alves,2014-07-08 17:55:30-07:00,['ce16e6e8eda915445b4fc19ce6139d4efc47847c'],8,11,19,399462,3,,,,1043
27c66425a3640169e09a015c864829d0c528b4b1,0,Vladimir Feinberg,2014-07-08 18:05:13-07:00,['fc2f7e64c8fc7a75f1d8dbb82890d3dd240f30b6'],15,16,31,399493,1,0,1,1,1043
6419ff4a750223fbbca88b075067c25f9eb1c431,0,Michael Percy,2014-07-08 18:53:52-07:00,['27c66425a3640169e09a015c864829d0c528b4b1'],0,1,1,399494,1,,,,1043
905f3a373c83dab3e60106d5326005d3e3997aa4,0,Todd Lipcon,2014-07-08 19:28:45-07:00,['6419ff4a750223fbbca88b075067c25f9eb1c431'],21,22,43,399537,2,0,1,1,1043
e5a7c1e209408004dbd05d5f28166562e39c28e9,0,Todd Lipcon,2014-07-08 19:39:14-07:00,['905f3a373c83dab3e60106d5326005d3e3997aa4'],7,114,121,399658,9,0.157894737,1,1,1043
1606087146f9bb2a3e72ce9298e6c1c3aae6ff2a,1,Todd Lipcon,2014-07-08 20:32:41-07:00,['e5a7c1e209408004dbd05d5f28166562e39c28e9'],16,11,27,399685,5,1,0,0.666666667,1043
a017f80b524e19495cd99ed90af96f5026b118a9,1,Alex Feinberg,2014-07-08 20:42:51-07:00,['1606087146f9bb2a3e72ce9298e6c1c3aae6ff2a'],2,20,22,399707,2,1,1,1,1043
ca009694763f122a9fa8d97e0ba99d4d52019ddc,0,Todd Lipcon,2014-07-09 07:55:46-07:00,['a017f80b524e19495cd99ed90af96f5026b118a9'],68,71,139,399846,14,,,,1043
f54aeacc73c2c151746e35feb81ce39ce752c78b,1,Todd Lipcon,2014-07-09 07:57:46-07:00,['ca009694763f122a9fa8d97e0ba99d4d52019ddc'],7,59,66,399912,5,0.102564103,0.384615385,0.948717949,1043
0f4b5cba21067c2834bead023094dd104b0b7bbf,0,Todd Lipcon,2014-07-09 11:22:12-07:00,['f54aeacc73c2c151746e35feb81ce39ce752c78b'],5,11,16,399928,1,1,1,1,1043
b94bd6851ba987a1cd164fae5cc41a2baff7f139,0,Vladimir Feinberg,2014-07-09 11:49:20-07:00,['0f4b5cba21067c2834bead023094dd104b0b7bbf'],58,123,181,400109,7,0.954545455,1,0,1043
2e207c24624a2a48a7a7cf31b36f8cdcd9ea8a4e,0,Todd Lipcon,2014-07-09 13:15:38-07:00,['b94bd6851ba987a1cd164fae5cc41a2baff7f139'],9,17,26,400135,2,0,0,0,1043
f2d5e1f8e0b4f6c98d50cc3a498bd494d6fccc6e,1,Todd Lipcon,2014-07-09 13:15:49-07:00,['2e207c24624a2a48a7a7cf31b36f8cdcd9ea8a4e'],2,2,4,400139,1,,,,1043
9e5c77ffee1e9874efd649821ab606a35b200a02,0,David Alves,2014-07-09 14:16:32-07:00,['f2d5e1f8e0b4f6c98d50cc3a498bd494d6fccc6e'],1,2,3,400142,1,1,1,1,1043
2a7f8c47572c196522b70c7e54ce1ed2ad8654a6,0,Alex Feinberg,2014-07-09 17:07:58-07:00,['9e5c77ffee1e9874efd649821ab606a35b200a02'],22,78,100,400242,1,0.56,1,0.44,1043
8db5310bfe94b34054f8038829a8768290f587c8,1,Michael Percy,2014-07-10 23:41:34-07:00,['2a7f8c47572c196522b70c7e54ce1ed2ad8654a6'],2,14,16,400258,4,1,1,1,1043
336501de8ad8c02667fc90585ebc40347b2f82fc,0,Todd Lipcon,2014-07-11 09:36:55-07:00,['8db5310bfe94b34054f8038829a8768290f587c8'],0,58,58,400316,1,,,,1043
b1b183e9c3f1148d460707f655e314e2becd547e,0,Todd Lipcon,2014-07-11 14:17:46-07:00,['336501de8ad8c02667fc90585ebc40347b2f82fc'],4,4,8,400324,1,,,,1043
87340b7b77a59fdaff9ea7d84456acfe13326517,0,Todd Lipcon,2014-07-14 18:46:23-07:00,['b1b183e9c3f1148d460707f655e314e2becd547e'],1,1,2,400326,1,,,,1043
e528d940b95954537c873075482319a76f90bb85,0,Todd Lipcon,2014-07-15 12:45:28-07:00,['87340b7b77a59fdaff9ea7d84456acfe13326517'],1,6,7,400333,1,0,1,1,1043
326b8a2a7e736c30b923e7f8d67849438adf8f44,0,Todd Lipcon,2014-07-15 12:47:45-07:00,['e528d940b95954537c873075482319a76f90bb85'],1,51,52,400385,1,1,1,1,1043
355c9f4c6e903252dd19a56d4c4a717d0b92a1b0,0,Vladimir Feinberg,2014-07-15 14:33:16-07:00,['326b8a2a7e736c30b923e7f8d67849438adf8f44'],7,14,21,400406,1,0.833333333,1,0.166666667,1043
258cfc5deb944fc0f82c4a28e4c4157ce4673c0b,1,Todd Lipcon,2014-07-16 14:04:41-07:00,['355c9f4c6e903252dd19a56d4c4a717d0b92a1b0'],303,698,1001,401407,33,0.828767123,1,1,1049
9d42e25c6cc0ba66e833a3591a7c54fa5854b109,1,Todd Lipcon,2014-07-17 09:02:53-07:00,['258cfc5deb944fc0f82c4a28e4c4157ce4673c0b'],18,15,33,401440,5,0,0,0,1049
d5368fd6b8b1207a1f0c04cc2903333615b31a83,1,Todd Lipcon,2014-07-18 09:25:45-07:00,['9d42e25c6cc0ba66e833a3591a7c54fa5854b109'],320,316,636,402076,38,0,0,0,1049
95dd95fde5d550f5ce8374f440e850d2cc722bf4,0,Todd Lipcon,2014-07-18 09:27:42-07:00,['d5368fd6b8b1207a1f0c04cc2903333615b31a83'],8,14,22,402098,1,,,,1049
5d95a549f3a941771483c0b6934363336ab2f393,1,Todd Lipcon,2014-07-18 09:31:32-07:00,['95dd95fde5d550f5ce8374f440e850d2cc722bf4'],349,416,765,402863,11,0.555555556,0.888888889,1,1051
70300624189fb499540c8c6663ec2ec370eb3bb1,0,Adar Dembo,2014-07-21 12:20:28-07:00,['5d95a549f3a941771483c0b6934363336ab2f393'],2,2,4,402867,1,,,,1051
35c7138720504cf87fea5253641a8a63e8f03ab2,0,Adar Dembo,2014-07-21 12:21:48-07:00,['70300624189fb499540c8c6663ec2ec370eb3bb1'],11,3,14,402881,5,1,0,0,1051
cb3c72ff99dd8166820cfa39aed6a15ea311f22e,0,Todd Lipcon,2014-07-21 15:58:59-07:00,['35c7138720504cf87fea5253641a8a63e8f03ab2'],64,64,128,403009,7,0,,,1051
3588ee4cee6505c46082c410777c58a2a20be3f5,1,Todd Lipcon,2014-07-21 16:58:05-07:00,['cb3c72ff99dd8166820cfa39aed6a15ea311f22e'],229,191,420,403429,25,0,1,0.05,1051
842f91d7030664299db1651b084c959655ffc637,0,Todd Lipcon,2014-07-21 21:39:02-07:00,['3588ee4cee6505c46082c410777c58a2a20be3f5'],4,4,8,403437,2,,,,1051
88c27570e928fcf77227aeff23f636a75aae669b,0,Todd Lipcon,2014-07-21 23:58:02-07:00,['842f91d7030664299db1651b084c959655ffc637'],38,42,80,403517,2,,,,1051
3264bd7b2bf03a1df68466a12e017c262a4d29e6,0,Adar Dembo,2014-07-22 01:06:35-07:00,['88c27570e928fcf77227aeff23f636a75aae669b'],0,50,50,403567,1,,,,1052
2ab24eae828a55e710dbb0cdcd0dbbed5d8a29ba,1,Alex Feinberg,2014-07-22 11:12:07-07:00,['3264bd7b2bf03a1df68466a12e017c262a4d29e6'],42,260,302,403869,5,0.053763441,0.967741935,0.870967742,1052
02becfb8e911595d8a29230c29977320c85e753b,0,Todd Lipcon,2014-07-22 12:37:56-07:00,['2ab24eae828a55e710dbb0cdcd0dbbed5d8a29ba'],1,2,3,403872,1,,,,1052
d501d35d44f09a2e094c9abac0ab92eeffe8ae8c,1,Todd Lipcon,2014-07-22 12:38:51-07:00,['02becfb8e911595d8a29230c29977320c85e753b'],74,71,145,404017,27,,,,1052
e4d685860f351040547d49009ddf2f71c786a52f,0,Michael Percy,2014-07-22 19:22:05-07:00,['d501d35d44f09a2e094c9abac0ab92eeffe8ae8c'],6,18,24,404041,3,1,1,1,1052
3e4d22c213b5709deb9a8caa83d3f08a7e7515d5,0,Michael Percy,2014-07-22 22:00:23-07:00,['e4d685860f351040547d49009ddf2f71c786a52f'],127,153,280,404321,1,,,,1052
9beaef97c62e538a5050c1088d2864e8f4d95e2d,0,Michael Percy,2014-07-23 13:14:17-07:00,['3e4d22c213b5709deb9a8caa83d3f08a7e7515d5'],4,8,12,404333,2,1,1,1,1052
c55495f6a08a08b41c30fbeb36a8f9872a21ad05,0,Todd Lipcon,2014-07-23 17:18:57-07:00,['9beaef97c62e538a5050c1088d2864e8f4d95e2d'],94,155,249,404582,6,1,1,1,1054
93b86de35ad8356cbac8a48248a2c8b49fa0a080,1,Todd Lipcon,2014-07-23 17:28:00-07:00,['c55495f6a08a08b41c30fbeb36a8f9872a21ad05'],20,75,95,404677,5,1,1,1,1056
9a74be83bdaffda907f5c284517935367c51a012,1,Todd Lipcon,2014-07-23 17:28:45-07:00,['93b86de35ad8356cbac8a48248a2c8b49fa0a080'],48,122,170,404847,6,1,1,0.615384615,1058
61a25379f7cf6c2d0e1acd03f8019083896a95f9,1,Todd Lipcon,2014-07-23 17:31:37-07:00,['9a74be83bdaffda907f5c284517935367c51a012'],314,380,694,405541,11,0.5,0.833333333,0.833333333,1060
ed58144c1e55368b70dddf64fccc289a2a4f293e,0,Todd Lipcon,2014-07-23 17:41:06-07:00,['61a25379f7cf6c2d0e1acd03f8019083896a95f9'],67,54,121,405662,2,0.666666667,1,1,1060
0dce2fce7b6983d92db05c70f215ccd974a1a3c6,0,Adar Dembo,2014-07-23 18:27:39-07:00,['ed58144c1e55368b70dddf64fccc289a2a4f293e'],9,24,33,405695,6,,,,1061
40406e1fe516e92960dd7f3ab66e68888bba4656,1,Todd Lipcon,2014-07-23 22:18:21-07:00,['0dce2fce7b6983d92db05c70f215ccd974a1a3c6'],28,75,103,405798,1,0,1,1,1061
bc8ddf1347e72f5789e60a1ad4db0408656460d3,0,Todd Lipcon,2014-07-23 22:55:24-07:00,['40406e1fe516e92960dd7f3ab66e68888bba4656'],1,25,26,405824,6,1,1,1,1061
3b2ddaf0643f53bb4f559fe57e0b4a65f8a7126a,1,Todd Lipcon,2014-07-23 22:56:50-07:00,['bc8ddf1347e72f5789e60a1ad4db0408656460d3'],53,90,143,405967,13,1,1,1,1061
b63ffdac494049654d0798d9addd8551d5312300,0,Todd Lipcon,2014-07-23 22:57:22-07:00,['3b2ddaf0643f53bb4f559fe57e0b4a65f8a7126a'],0,9,9,405976,1,,,,1061
d07ba938f87794f4d52f5a19a1203c6669e46dff,0,Todd Lipcon,2014-07-24 01:17:16-07:00,['b63ffdac494049654d0798d9addd8551d5312300'],15,18,33,406009,6,1,1,0.5,1061
d80dfa1134e6cbeb5eec8aff1294d5a579491d24,0,Todd Lipcon,2014-07-24 01:17:28-07:00,['d07ba938f87794f4d52f5a19a1203c6669e46dff'],46,45,91,406100,5,0,0,,1061
d28b8d32952a522d0c6f640dac883dab26ee1d59,1,Michael Percy,2014-07-24 14:34:57-07:00,['d80dfa1134e6cbeb5eec8aff1294d5a579491d24'],7,8,15,406115,2,0,1,0,1061
19ccb31fdaa580fa015daa0e20a1657e29471ae8,0,Todd Lipcon,2014-07-24 16:13:37-07:00,['d28b8d32952a522d0c6f640dac883dab26ee1d59'],11,11,22,406137,3,,,,1061
b1cfdd68c0141106541aa90f4467c39df0ba6228,1,Michael Percy,2014-07-24 16:15:17-07:00,['19ccb31fdaa580fa015daa0e20a1657e29471ae8'],0,64,64,406201,2,0,0,1,1062
6d71ddf0d54d79029582590791686d6368ffbbd4,0,Todd Lipcon,2014-07-24 18:40:28-07:00,['b1cfdd68c0141106541aa90f4467c39df0ba6228'],11,77,88,406289,4,0.052631579,1,1,1062
bb5892432bdfa62e0c55e7a37c5961ad8182cf94,0,David Alves,2014-07-25 00:41:55-07:00,['6d71ddf0d54d79029582590791686d6368ffbbd4'],0,9,9,406298,2,1,1,1,1062
2058ab30dc7940c26d49361637b9366c45270fc7,0,David Alves,2014-07-25 01:25:11-07:00,['bb5892432bdfa62e0c55e7a37c5961ad8182cf94'],0,3,3,406301,1,1,1,1,1062
fbf99340dec2731077cd9ce4b5af81453bd6a2da,0,Jean-Daniel Cryans,2014-07-25 12:51:16-07:00,['2058ab30dc7940c26d49361637b9366c45270fc7'],3,22,25,406326,1,0,0,1,1062
84706ea38d968fb42113557c6631447944c83b71,1,Alex Feinberg,2014-07-25 13:31:29-07:00,['fbf99340dec2731077cd9ce4b5af81453bd6a2da'],23,120,143,406469,8,0,1,0.814814815,1062
22ce8e25f04eab62787660de2cf3cac4a8003852,0,Vladimir Feinberg,2014-07-25 13:45:50-07:00,['84706ea38d968fb42113557c6631447944c83b71'],2,5,7,406476,1,,,,1062
99f8b0b788532e8ebe7ff3b2540cd6b060c92ec1,1,Todd Lipcon,2014-07-27 11:49:57-07:00,['22ce8e25f04eab62787660de2cf3cac4a8003852'],30,525,555,407031,13,0.772727273,0.772727273,1,1067
8551f68f46a511d821088ebc423c76f3a76e3e40,0,Vladimir Feinberg,2014-07-28 17:15:23-07:00,['99f8b0b788532e8ebe7ff3b2540cd6b060c92ec1'],0,2,2,407033,2,0,0,0,1067
b2d9874905a1471ee5caca19d61bd570a52fed2c,1,David Alves,2014-07-28 19:08:45-07:00,['8551f68f46a511d821088ebc423c76f3a76e3e40'],56,142,198,407231,7,0,0.92,0,1067
93431debca3ed0a08bc8a47e5f281c7905949b83,1,Todd Lipcon,2014-07-28 20:06:12-07:00,['b2d9874905a1471ee5caca19d61bd570a52fed2c'],18,20,38,407269,6,0,0,0,1067
802ce85d25a2d88d66a97f71ca553882474173ad,1,Todd Lipcon,2014-07-28 20:08:35-07:00,['93431debca3ed0a08bc8a47e5f281c7905949b83'],28,13,41,407310,2,0.5,0.25,0,1067
e3a6360424f99907ce7ea38bc4afe092dc4fa39e,0,Todd Lipcon,2014-07-28 20:10:10-07:00,['802ce85d25a2d88d66a97f71ca553882474173ad'],52,27,79,407389,7,1,0,0,1067
4decc024d9d0311de546b08c154f81d89deed720,1,Todd Lipcon,2014-07-28 23:13:59-07:00,['e3a6360424f99907ce7ea38bc4afe092dc4fa39e'],61,28,89,407478,4,0.095238095,0.142857143,0,1067
77207f687ec4f0c8cf7c040fade13ca07a86d92d,1,Adar Dembo,2014-07-29 01:15:09-07:00,['4decc024d9d0311de546b08c154f81d89deed720'],365,84,449,407927,12,0.25,0,0.181034483,1067
a3a6e64cdad4539fbb44affed2ba50b7ad8df806,0,Adar Dembo,2014-07-29 09:50:12-07:00,['77207f687ec4f0c8cf7c040fade13ca07a86d92d'],9,11,20,407947,1,,,,1067
22bf5e11a02464904996c2fa359577879d3faa97,1,Jean-Daniel Cryans,2014-07-29 15:33:52-07:00,['a3a6e64cdad4539fbb44affed2ba50b7ad8df806'],122,192,314,408261,18,0.636363636,1,1,1069
0497f0cddef04773c37f4624a673d40c4bce191f,1,Jean-Daniel Cryans,2014-07-29 15:36:25-07:00,['22bf5e11a02464904996c2fa359577879d3faa97'],104,225,329,408590,14,0.195652174,0.152173913,1,1071
fa723a174e8b39947fb35c370c934c57f8e018dc,0,Jean-Daniel Cryans,2014-07-29 15:37:37-07:00,['0497f0cddef04773c37f4624a673d40c4bce191f'],116,232,348,408938,6,0.162790698,0.302325581,1,1073
f5468c72d7ca65f3d47b99e534c7d8da57c970b4,1,Michael Percy,2014-07-29 21:53:22-07:00,['fa723a174e8b39947fb35c370c934c57f8e018dc'],16,34,50,408988,3,0.090909091,1,1,1073
ba5bfc0d42455cca04fce8f24796ee0a57fa4450,1,Todd Lipcon,2014-07-30 13:53:59-07:00,['f5468c72d7ca65f3d47b99e534c7d8da57c970b4'],59,81,140,409128,34,,,,1075
6c021d787d4c71fcfb007c4db1ffe183b2691eff,1,Todd Lipcon,2014-07-30 15:37:07-07:00,['ba5bfc0d42455cca04fce8f24796ee0a57fa4450'],14,77,91,409219,7,,,,1075
4666b49e960a9a81d5fb3337d71472962ac9cfd5,1,Todd Lipcon,2014-07-30 15:40:29-07:00,['6c021d787d4c71fcfb007c4db1ffe183b2691eff'],240,269,509,409728,25,0,0,0,1078
e1f17a60bf9313b0fbcea2b3eb086a247980ba52,1,Todd Lipcon,2014-07-30 15:40:42-07:00,['4666b49e960a9a81d5fb3337d71472962ac9cfd5'],238,242,480,410208,50,0,1,1,1078
0784fc15ef919c9e2073e5a5e9208083fca02cd9,0,Todd Lipcon,2014-07-30 16:59:07-07:00,['e1f17a60bf9313b0fbcea2b3eb086a247980ba52'],0,1,1,410209,1,,,,1078
738c55e8574d50fe5b2a96cbc66ffb9938032a8e,0,Adar Dembo,2014-07-30 17:03:05-07:00,['0784fc15ef919c9e2073e5a5e9208083fca02cd9'],29,99,128,410337,4,,,,1079
cfd5002d10f08620b7455637eb4f701eb3fe678d,0,Todd Lipcon,2014-07-30 17:37:03-07:00,['738c55e8574d50fe5b2a96cbc66ffb9938032a8e'],3,8,11,410348,2,,,,1079
72506ec424929626e6c933cf504d971156489d1a,0,Adar Dembo,2014-07-30 17:52:28-07:00,['cfd5002d10f08620b7455637eb4f701eb3fe678d'],2,2,4,410352,1,,,,1079
ba16ff9d038ab3500570539a77f3e8e832cfdfcb,1,Todd Lipcon,2014-07-30 18:23:34-07:00,['72506ec424929626e6c933cf504d971156489d1a'],219,227,446,410798,38,1,1,1,1079
0b1d2c8c6ea4b886d5f70ffad1d28afb356d6c61,0,Todd Lipcon,2014-07-30 19:12:43-07:00,['ba16ff9d038ab3500570539a77f3e8e832cfdfcb'],9,12,21,410819,1,,,,1079
1fef5590192392552a3c725e5fc27e941dbb3837,1,Adar Dembo,2014-07-30 20:13:10-07:00,['0b1d2c8c6ea4b886d5f70ffad1d28afb356d6c61'],3810,3814,7624,418443,806,,,,1079
6385acd0eb095f3cf542f276d05cdffa3dee07bc,0,Adar Dembo,2014-07-30 21:28:06-07:00,['1fef5590192392552a3c725e5fc27e941dbb3837'],1,1,2,418445,1,,,,1079
cf9bdc8ad8fa1695cab35f7bb5bcf11d6e751564,0,Todd Lipcon,2014-07-30 23:09:08-07:00,['6385acd0eb095f3cf542f276d05cdffa3dee07bc'],1,1,2,418447,1,,,,1079
3bb5f75eed4a0e8c2b2b62bca94fb5d6a49388b4,1,Alex Feinberg,2014-07-31 03:56:37-07:00,['cf9bdc8ad8fa1695cab35f7bb5bcf11d6e751564'],720,105,825,419272,10,0.422572178,0.104986877,0.241469816,1079
0c80dee58d0337e54d4687672d710a5054e997ed,0,Vladimir Feinberg,2014-07-31 10:34:32-07:00,['3bb5f75eed4a0e8c2b2b62bca94fb5d6a49388b4'],50,210,260,419532,9,0.380434783,0,0,1079
290b7b03bdca5334f5c8d3d0bacb8c53d7d393c3,0,Vladimir Feinberg,2014-07-31 10:36:13-07:00,['0c80dee58d0337e54d4687672d710a5054e997ed'],7,35,42,419574,7,0.666666667,1,1,1079
8a893e7c1b9cb7466d7652f0f6b75dbb26ba47d2,0,David Alves,2014-07-31 11:55:18-07:00,['290b7b03bdca5334f5c8d3d0bacb8c53d7d393c3'],17,99,116,419690,11,0,0.918918919,0.891891892,1079
369493d5501a454b27f02f3134728c34bd2ddef9,1,Adar Dembo,2014-07-31 15:37:30-07:00,['8a893e7c1b9cb7466d7652f0f6b75dbb26ba47d2'],129,178,307,419997,4,0.928571429,0.928571429,1,1079
084d934379057d28e0947736131d9af6c7409fc5,1,Todd Lipcon,2014-07-31 15:49:47-07:00,['369493d5501a454b27f02f3134728c34bd2ddef9'],126,184,310,420307,29,1,1,1,1079
a4481fb3ca3b2f1515043e88180ae7285ce91886,0,Todd Lipcon,2014-07-31 15:50:13-07:00,['084d934379057d28e0947736131d9af6c7409fc5'],25,22,47,420354,23,,,,1079
0c440b0253e97209c6481608e941e6532db3bd20,1,Todd Lipcon,2014-07-31 18:48:47-07:00,['a4481fb3ca3b2f1515043e88180ae7285ce91886'],97,184,281,420635,5,1,1,0.674418605,1079
7a1102ac1a8c03da451c60aa62f75d3d02b03fd4,0,Todd Lipcon,2014-07-31 18:49:27-07:00,['0c440b0253e97209c6481608e941e6532db3bd20'],33,31,64,420699,2,1,0,0,1079
65211cbb705da5a5d3dbbdfc5502ef0fdebcbc81,1,Todd Lipcon,2014-07-31 18:52:25-07:00,['7a1102ac1a8c03da451c60aa62f75d3d02b03fd4'],107,310,417,421116,17,0.76744186,0.174418605,0.953488372,1081
87848bb65be880a15cf708190c87a4b243488f5d,1,Todd Lipcon,2014-07-31 18:53:48-07:00,['65211cbb705da5a5d3dbbdfc5502ef0fdebcbc81'],105,95,200,421316,6,0.333333333,0,0,1081
430d864d284c9e2cf213bbf558d6737212ddc5ab,0,Vladimir Feinberg,2014-08-01 11:42:29-07:00,['87848bb65be880a15cf708190c87a4b243488f5d'],99,17,116,421432,11,1,0.081081081,0.108108108,1081
15f2c9b11383fe1a42f948b06c58a7b07ccc5223,1,Todd Lipcon,2014-08-01 15:21:42-07:00,['430d864d284c9e2cf213bbf558d6737212ddc5ab'],14,19,33,421465,2,0.4,1,0.6,1081
9c76e4918b813c1f5eaa1ad9fef9bb53e750db84,0,Michael Percy,2014-08-01 16:19:32-07:00,['15f2c9b11383fe1a42f948b06c58a7b07ccc5223'],2,2,4,421469,1,,,,1081
c92da421cf1b27eaa0ea6113caaa1b5d5a4f637b,0,Todd Lipcon,2014-08-01 16:46:59-07:00,['9c76e4918b813c1f5eaa1ad9fef9bb53e750db84'],97,11,108,421577,2,0.737704918,0,0,1081
9a1d9ef435b9c6f52991f0148fdeefaf4b3ad1c0,1,Todd Lipcon,2014-08-03 16:50:53-07:00,['c92da421cf1b27eaa0ea6113caaa1b5d5a4f637b'],35,7,42,421619,7,0.333333333,0,0,1081
7707759e70133c9011cc5a105cc689107a6c88d9,0,Todd Lipcon,2014-08-03 16:50:58-07:00,['9a1d9ef435b9c6f52991f0148fdeefaf4b3ad1c0'],210,50,260,421879,9,0.619565217,1,1,1081
1afef7e56a609249ec350f97a046328e2cef8012,0,Todd Lipcon,2014-08-04 14:52:34-07:00,['7707759e70133c9011cc5a105cc689107a6c88d9'],0,326,326,422205,4,0.236024845,1,0.819875776,1084
a193746fb788e982cdfb8c3e08333396da027bfd,0,Todd Lipcon,2014-08-04 14:53:16-07:00,['1afef7e56a609249ec350f97a046328e2cef8012'],18,15,33,422238,4,1,0,0,1084
d160f040137a2b2425c6ceea4c31282ca75af70f,0,Todd Lipcon,2014-08-04 15:33:05-07:00,['a193746fb788e982cdfb8c3e08333396da027bfd'],0,205,205,422443,3,0.442622951,1,0.93442623,1086
34a3e93abc8735819710c92fc684757805423e2c,0,Adar Dembo,2014-08-04 17:32:55-07:00,['d160f040137a2b2425c6ceea4c31282ca75af70f'],3,3,6,422449,1,,,,1086
a7511ea47b2ae4ea677004079345a648a111a11e,0,Todd Lipcon,2014-08-04 18:19:56-07:00,['34a3e93abc8735819710c92fc684757805423e2c'],6,202,208,422657,1,0.075949367,1,0.987341772,1086
d30ff2751633493ee9e96d945d0ab4d8afa19798,0,Todd Lipcon,2014-08-04 18:20:19-07:00,['a7511ea47b2ae4ea677004079345a648a111a11e'],29,33,62,422719,1,0,1,1,1086
378178f74f5769e3b3540e3bbbcb5e7d57658ae5,0,Alex Feinberg,2014-08-04 18:50:21-07:00,['d30ff2751633493ee9e96d945d0ab4d8afa19798'],0,52,52,422771,1,,,,1086
69c53031a3213789dacf1a13b474dd6cab580191,0,Todd Lipcon,2014-08-04 19:56:31-07:00,['378178f74f5769e3b3540e3bbbcb5e7d57658ae5'],8,7,15,422786,4,1,0,0,1086
de6ca5ba780e6c99e5332712030db0d6c452f201,0,Michael Percy,2014-08-04 20:37:03-07:00,['69c53031a3213789dacf1a13b474dd6cab580191'],19,41,60,422846,3,,,,1086
df834ea665ee4782ef2064897df991c15205ab53,0,Michael Percy,2014-08-04 20:37:15-07:00,['de6ca5ba780e6c99e5332712030db0d6c452f201'],24,43,67,422913,13,,,,1086
a3c5a5111029f486212c48b50692fd5c456050be,1,Michael Percy,2014-08-04 21:26:35-07:00,['df834ea665ee4782ef2064897df991c15205ab53'],103,167,270,423183,8,1,1,1,1087
4a547c87a906716845d28088eaf5444b3e5848eb,1,Jean-Daniel Cryans,2014-08-05 05:07:05-07:00,['a3c5a5111029f486212c48b50692fd5c456050be'],11,21,32,423215,2,0.8,0.8,0,1087
4b6b6764f8d4dc30e47e6c1d9fed5e552960ec8b,1,Alex Feinberg,2014-08-05 13:15:24-07:00,['4a547c87a906716845d28088eaf5444b3e5848eb'],29,18,47,423262,2,1,0,0,1087
2f3293268adaee97aa65e37decce10efb3bf6b02,0,Michael Percy,2014-08-05 13:17:48-07:00,['4b6b6764f8d4dc30e47e6c1d9fed5e552960ec8b'],18,5,23,423285,2,1,0,0,1087
7c6359a06568194bf1de2e262a5e8c4eeffccd7c,1,Michael Percy,2014-08-05 13:18:58-07:00,['2f3293268adaee97aa65e37decce10efb3bf6b02'],32,80,112,423397,18,0,0.904761905,0.619047619,1087
4c89a771cfc2db5cf99e8a6e427cbe9da69bf5c8,1,Michael Percy,2014-08-05 13:19:33-07:00,['7c6359a06568194bf1de2e262a5e8c4eeffccd7c'],353,407,760,424157,2,0.083333333,1,0.041666667,1088
37dc989cead5e8b38b3bb71288896230ba8dbb51,0,Michael Percy,2014-08-05 15:04:49-07:00,['4c89a771cfc2db5cf99e8a6e427cbe9da69bf5c8'],13,26,39,424196,2,1,1,1,1088
872aba4e04b4932774f36124e85ca3ae17675333,1,Todd Lipcon,2014-08-05 18:17:06-07:00,['37dc989cead5e8b38b3bb71288896230ba8dbb51'],50,273,323,424519,19,,,,1090
2f9281d30b27c8e55cb8baf6ad9a6aec17b69f85,0,Todd Lipcon,2014-08-05 18:17:19-07:00,['872aba4e04b4932774f36124e85ca3ae17675333'],31,154,185,424704,16,1,1,1,1091
4a658d4c6febd9f15ce77c3533c597336aa36db8,0,Todd Lipcon,2014-08-05 18:17:45-07:00,['2f9281d30b27c8e55cb8baf6ad9a6aec17b69f85'],0,219,219,424923,1,0.269736842,1,0.776315789,1092
6361fc4f7be3ba3f6e8b2d03b9400bc04b708609,0,Todd Lipcon,2014-08-05 18:20:35-07:00,['4a658d4c6febd9f15ce77c3533c597336aa36db8'],0,46,46,424969,4,,,,1094
bb6da1946ea90e3b64bb7a38d9e5751cc95c557b,0,Todd Lipcon,2014-08-05 18:21:51-07:00,['6361fc4f7be3ba3f6e8b2d03b9400bc04b708609'],516,534,1050,426019,52,0,0.222222222,0,1094
75e43ce5b4a9c6136c69f474074ada573a1c0665,1,Todd Lipcon,2014-08-05 18:23:20-07:00,['bb6da1946ea90e3b64bb7a38d9e5751cc95c557b'],24,37,61,426080,3,,,,1094
ef1bf2adc00af176f2964998bf07c47b256f2af9,1,Todd Lipcon,2014-08-05 18:25:14-07:00,['75e43ce5b4a9c6136c69f474074ada573a1c0665'],25,26,51,426131,8,,,,1094
1da41fb83793616a89b2687d990d1e2b7b2228a6,0,Todd Lipcon,2014-08-05 18:25:32-07:00,['ef1bf2adc00af176f2964998bf07c47b256f2af9'],8,10,18,426149,4,,,,1094
0b232dcc73da3f9067195a2807da66e0afdfb14f,0,Todd Lipcon,2014-08-05 18:26:50-07:00,['1da41fb83793616a89b2687d990d1e2b7b2228a6'],13,83,96,426245,3,,,,1095
c87d0bff015c3a467bdfd66a8c0ebd54cdc98ed2,0,Todd Lipcon,2014-08-05 18:28:00-07:00,['0b232dcc73da3f9067195a2807da66e0afdfb14f'],2,3,5,426250,2,,,,1095
252ca76aca69677f0323a5ad8580ae22c9981542,0,Michael Percy,2014-08-05 21:17:06-07:00,['c87d0bff015c3a467bdfd66a8c0ebd54cdc98ed2'],0,4,4,426254,1,,,,1095
c875ce554f95d697fed6a79cc1e62647961f17b8,0,Jean-Daniel Cryans,2014-08-06 10:33:38-07:00,['252ca76aca69677f0323a5ad8580ae22c9981542'],31,75,106,426360,1,,,,1095
6c82d6f6741c69ac24276b4acf22cc27648612d1,1,Jean-Daniel Cryans,2014-08-06 12:37:01-07:00,['c875ce554f95d697fed6a79cc1e62647961f17b8'],17,29,46,426406,4,1,1,1,1095
52b535a36cf33967012be6cd93ad08267a4c1464,0,Alex Feinberg,2014-08-06 17:10:52-07:00,['6c82d6f6741c69ac24276b4acf22cc27648612d1'],46,125,171,426577,3,0.425,1,0.825,1095
0d57b603604497fcc1c5646a2f4969ec981178b2,0,Michael Percy,2014-08-07 02:33:31-07:00,['52b535a36cf33967012be6cd93ad08267a4c1464'],0,12,12,426589,2,1,1,1,1095
97e1d85669f7d32b1bb726eff822315bc8c78ddd,0,Michael Percy,2014-08-07 02:33:38-07:00,['0d57b603604497fcc1c5646a2f4969ec981178b2'],7,24,31,426620,2,0.5,1,1,1095
17fe6574779b37b4203e3b5a01aee85c99f0533a,0,Adar Dembo,2014-08-07 13:24:25-07:00,['97e1d85669f7d32b1bb726eff822315bc8c78ddd'],8,36,44,426664,1,,,,1095
359e7243475c293848ce9fed57ab1ed63c2b446d,1,Michael Percy,2014-08-07 16:04:19-07:00,['17fe6574779b37b4203e3b5a01aee85c99f0533a'],70,95,165,426829,4,0,1,1,1095
33ecb1c771ce054e399079cbbaa017620ff24b87,1,Todd Lipcon,2014-08-08 13:13:35-07:00,['359e7243475c293848ce9fed57ab1ed63c2b446d'],1,63,64,426893,3,,,,1096
2e2cd8d260046afe24e84d7bbbf6f5fac15f4c50,1,Todd Lipcon,2014-08-08 13:24:33-07:00,['33ecb1c771ce054e399079cbbaa017620ff24b87'],29,153,182,427075,6,0.62195122,0.317073171,0.914634146,1096
a587af978ea7e9b54849e91b39d056d2ad09eeba,0,Michael Percy,2014-08-08 15:49:20-07:00,['2e2cd8d260046afe24e84d7bbbf6f5fac15f4c50'],0,10,10,427085,2,,,,1096
204f6f8dedeb1ab89b2615753ccf04feb113f4e2,1,Todd Lipcon,2014-08-08 16:03:45-07:00,['a587af978ea7e9b54849e91b39d056d2ad09eeba'],43,2064,2107,429192,20,0.345226615,0.969141755,0.541947927,1104
90c05406287601f9ec85fdc6d4cbd23936a1d882,1,Adar Dembo,2014-08-08 18:00:53-07:00,['204f6f8dedeb1ab89b2615753ccf04feb113f4e2'],1,6,7,429199,1,,,,1104
9e7888489f99a8d8a5f59fb036da370df9f419e3,0,Todd Lipcon,2014-08-11 09:25:38-07:00,['90c05406287601f9ec85fdc6d4cbd23936a1d882'],16,40,56,429255,1,0.058823529,1,0,1104
e6bc6ff80f7f0d83c685aa873d94c61203725248,0,Todd Lipcon,2014-08-11 13:14:15-07:00,['9e7888489f99a8d8a5f59fb036da370df9f419e3'],1,3,4,429259,1,1,1,1,1104
c4d7bcd9dd4bf9a282c7f640a4034f54a695d3d1,0,Todd Lipcon,2014-08-11 13:14:57-07:00,['e6bc6ff80f7f0d83c685aa873d94c61203725248'],18,35,53,429312,11,,,,1104
673574736a7e648cf469e84ad51204a26a16a75b,0,Adar Dembo,2014-08-11 18:58:50-07:00,['c4d7bcd9dd4bf9a282c7f640a4034f54a695d3d1'],1,1,2,429314,1,,,,1104
0a545cc2f578f00e373471ec1f6778e02d1c778b,1,Todd Lipcon,2014-08-12 14:48:28-07:00,['673574736a7e648cf469e84ad51204a26a16a75b'],84,80,164,429478,4,0,0,0.142857143,1104
8125c2f71953b5be34921f148ceb2db01819629f,1,Jean-Daniel Cryans,2014-08-12 18:51:25-07:00,['0a545cc2f578f00e373471ec1f6778e02d1c778b'],491,459,950,430428,20,0.476190476,1,1,1106
c1254630d845e68b62934b5700bddfdaae43feca,1,Todd Lipcon,2014-08-12 18:59:36-07:00,['8125c2f71953b5be34921f148ceb2db01819629f'],23,170,193,430621,8,0.403225806,1,1,1106
b8c42dfb186744403de77272751717402c96c37d,1,Adar Dembo,2014-08-13 12:17:34-07:00,['c1254630d845e68b62934b5700bddfdaae43feca'],7,15,22,430643,3,1,1,1,1106
faf37fe1f95a83a7b9ff2a12efeb915a8e3aa814,1,Todd Lipcon,2014-08-13 14:31:08-07:00,['b8c42dfb186744403de77272751717402c96c37d'],12,13,25,430668,6,0,1,1,1106
44fb5a93fc45025b22908619faf7ead3cab2e573,1,Adar Dembo,2014-08-14 17:13:59-07:00,['faf37fe1f95a83a7b9ff2a12efeb915a8e3aa814'],15,42,57,430725,4,0,1,1,1106
1b880b92c81cd21c899f5dd0685fc42b44c00926,0,Todd Lipcon,2014-08-14 20:59:33-07:00,['44fb5a93fc45025b22908619faf7ead3cab2e573'],0,2,2,430727,1,,,,1106
f57959bcde1bc0094f1fd15b39b261c4edcaaab7,1,Todd Lipcon,2014-08-16 15:58:02-07:00,['1b880b92c81cd21c899f5dd0685fc42b44c00926'],2,5,7,430734,1,0,1,1,1106
c80674ca0763b5927073739587ce5fa1c3bfc365,0,Todd Lipcon,2014-08-16 15:58:25-07:00,['f57959bcde1bc0094f1fd15b39b261c4edcaaab7'],2,4,6,430740,1,0,0,0,1106
8adea3294a33882bd8f0642c43dd60c7012103dc,1,Todd Lipcon,2014-08-18 15:18:21-07:00,['c80674ca0763b5927073739587ce5fa1c3bfc365'],44,168,212,430952,12,0.153846154,1,1,1106
f835d921ce509608416b00e8f0cdd087cf1d5000,1,Adar Dembo,2014-08-18 15:25:20-07:00,['8adea3294a33882bd8f0642c43dd60c7012103dc'],348,511,859,431811,9,1,1,0,1108
416887379205a64ba20ef33ce7581d2c15847368,1,Vladimir Feinberg,2014-08-18 18:26:07-07:00,['f835d921ce509608416b00e8f0cdd087cf1d5000'],1,1327,1328,433139,11,0.621749409,0.822695035,0.624113475,1117
24f9ab6a1b67638ef149055c6a333e599e0bdab6,1,Todd Lipcon,2014-08-18 19:40:45-07:00,['416887379205a64ba20ef33ce7581d2c15847368'],115,126,241,433380,2,1,1,1,1117
691105a43f646b3ddea0f97c05127e6f9e3b5a15,0,Todd Lipcon,2014-08-18 20:07:32-07:00,['24f9ab6a1b67638ef149055c6a333e599e0bdab6'],0,12,12,433392,1,,,,1117
e0596697a8c3fbda53afa13cb909b32f9596fbe1,0,Todd Lipcon,2014-08-18 20:38:09-07:00,['691105a43f646b3ddea0f97c05127e6f9e3b5a15'],0,5,5,433397,1,,,,1117
245be8531c82a993d7d54c27f15344777024c6c8,1,Todd Lipcon,2014-08-19 12:36:12-07:00,['e0596697a8c3fbda53afa13cb909b32f9596fbe1'],31,86,117,433514,11,1,1,1,1117
4cf207b5fd58e9f62a7d3ce3b89302de9781dee9,1,Jean-Daniel Cryans,2014-08-19 12:37:26-07:00,['245be8531c82a993d7d54c27f15344777024c6c8'],145,173,318,433832,17,0.631578947,0.789473684,0.157894737,1117
885ce3c06e4d8e68bdcdfd978d49d7d20f1b4076,0,Todd Lipcon,2014-08-19 12:49:12-07:00,['4cf207b5fd58e9f62a7d3ce3b89302de9781dee9'],23,28,51,433883,8,,,,1118
d416faca6ac5a50e1bb6d95ca72e6a3fa49b177c,0,Todd Lipcon,2014-08-19 12:49:47-07:00,['885ce3c06e4d8e68bdcdfd978d49d7d20f1b4076'],1,7,8,433891,1,,,,1118
3dc4efd269a0e2ae4752b3366f0d9dadb9d438a6,0,Todd Lipcon,2014-08-19 12:59:35-07:00,['d416faca6ac5a50e1bb6d95ca72e6a3fa49b177c'],20,53,73,433964,2,0.148148148,1,0.592592593,1118
6f2299dd580aca7bd009cd027029dcd9f1cbd02c,1,Jean-Daniel Cryans,2014-08-19 14:13:23-07:00,['3dc4efd269a0e2ae4752b3366f0d9dadb9d438a6'],15,22,37,434001,2,1,1,1,1118
68fb11235881040c6409b4521ceb7befb24ccd90,0,Todd Lipcon,2014-08-19 17:18:43-07:00,['6f2299dd580aca7bd009cd027029dcd9f1cbd02c'],40,79,119,434120,6,0.818181818,0.909090909,0.909090909,1118
cdc464786711ae6181c6e871949f0e168e247bd2,0,David Alves,2014-08-19 21:11:57-07:00,['68fb11235881040c6409b4521ceb7befb24ccd90'],38,68,106,434226,10,0,0.7,1,1118
a95193aa97e3226f9d67a81fa78e536eef1f0f4b,1,Alex Feinberg,2014-08-19 21:18:37-07:00,['cdc464786711ae6181c6e871949f0e168e247bd2'],2,45,47,434273,5,1,1,1,1118
acebd9272fab1686e725f45a4b26e898b6fe0311,0,Todd Lipcon,2014-08-20 11:41:22-07:00,['a95193aa97e3226f9d67a81fa78e536eef1f0f4b'],71,1,72,434345,3,0.694444444,0,0.694444444,1118
d26ff8dca4da1d58a720fc33fda0e65283c563e0,0,David Alves,2014-08-20 13:03:21-07:00,['acebd9272fab1686e725f45a4b26e898b6fe0311'],0,1,1,434346,1,1,1,0,1118
7a958d2f14ef6c19dee6d6bed58ef8e7ffc597ed,0,Vladimir Feinberg,2014-08-20 14:00:09-07:00,['d26ff8dca4da1d58a720fc33fda0e65283c563e0'],63,300,363,434709,10,0.52,1,0.706666667,1120
a92e9e5b3f612bcd4aa85b557285374fa25c319e,0,Vladimir Feinberg,2014-08-20 14:00:37-07:00,['7a958d2f14ef6c19dee6d6bed58ef8e7ffc597ed'],49,75,124,434833,4,0.333333333,0.333333333,0,1120
1321482bc66e103f70155d51e04548efbdb2a02f,0,Vladimir Feinberg,2014-08-20 14:00:51-07:00,['a92e9e5b3f612bcd4aa85b557285374fa25c319e'],5,18,23,434856,2,1,1,0,1120
0e62b125d3d2e502fbfd7f17c471168fad7a6e51,0,Todd Lipcon,2014-08-20 15:11:23-07:00,['1321482bc66e103f70155d51e04548efbdb2a02f'],11,13,24,434880,2,0,,0,1120
e4a2ca3055fa160ef6af6c01da0f59bf63d76b93,1,Todd Lipcon,2014-08-20 15:55:03-07:00,['0e62b125d3d2e502fbfd7f17c471168fad7a6e51'],692,571,1263,436143,16,0.348993289,0,0,1121
230708986dd25205f8f69f28955a3a0565c15608,1,Todd Lipcon,2014-08-20 15:55:07-07:00,['e4a2ca3055fa160ef6af6c01da0f59bf63d76b93'],192,101,293,436436,9,1,0.017241379,0.327586207,1121
22deadded4882d1e05139a80650bfc06fa3a93d8,0,Todd Lipcon,2014-08-21 10:37:24-07:00,['230708986dd25205f8f69f28955a3a0565c15608'],15,48,63,436499,2,0.888888889,1,0,1121
883aa7ac7c3afdaedfa6ecbc4371811e8624f338,0,Vladimir Feinberg,2014-08-21 11:54:33-07:00,['22deadded4882d1e05139a80650bfc06fa3a93d8'],1,23,24,436523,2,1,1,0.777777778,1121
01104916856296055e791f2a5e83a51ce10cb19f,0,Adar Dembo,2014-08-21 14:59:26-07:00,['883aa7ac7c3afdaedfa6ecbc4371811e8624f338'],5,8,13,436536,1,,,,1121
68c363730fe37685f323d825334cf22c090ea0a4,0,Todd Lipcon,2014-08-21 15:01:23-07:00,['01104916856296055e791f2a5e83a51ce10cb19f'],1,64,65,436601,3,0,0.826086957,0.826086957,1121
0a9a326130a2024bd29efb28dbba1d5bd5688db1,1,Todd Lipcon,2014-08-21 15:07:37-07:00,['68c363730fe37685f323d825334cf22c090ea0a4'],119,163,282,436883,16,1,1,0.75,1122
ef5a605c914e8acb5e6a451df17f300c43ce17f8,0,Todd Lipcon,2014-08-21 15:25:02-07:00,['0a9a326130a2024bd29efb28dbba1d5bd5688db1'],150,136,286,437169,4,1,0,0,1122
2a01e12c82b3afd0898fbd75d251d55381d1e1bc,0,Todd Lipcon,2014-08-21 15:48:52-07:00,['ef5a605c914e8acb5e6a451df17f300c43ce17f8'],1,8,9,437178,1,0,0,0,1122
32d9965a192f7104ec729a3423d6bdfb853c5c99,0,Todd Lipcon,2014-08-21 15:49:05-07:00,['2a01e12c82b3afd0898fbd75d251d55381d1e1bc'],4,14,18,437196,1,1,1,1,1122
98aa19d720ac54d3885ccc845f398e2d0de6d8e0,0,Adar Dembo,2014-08-21 16:00:01-07:00,['32d9965a192f7104ec729a3423d6bdfb853c5c99'],1,1,2,437198,1,,,,1122
36986f5014882aabc1370be053953ec165cc1581,0,Jean-Daniel Cryans,2014-08-21 16:32:41-07:00,['98aa19d720ac54d3885ccc845f398e2d0de6d8e0'],27,76,103,437301,7,0.205882353,1,0.764705882,1122
cfe3cec0a11f37d154b083659c47c93f9fcc6b3e,1,Adar Dembo,2014-08-21 18:40:41-07:00,['36986f5014882aabc1370be053953ec165cc1581'],86,90,176,437477,27,0,0,0,1122
0d40905231a7b09a6df827bbc7ef4b8d9b2131ee,1,Todd Lipcon,2014-08-21 19:28:59-07:00,['cfe3cec0a11f37d154b083659c47c93f9fcc6b3e'],90,37,127,437604,14,1,0.146341463,1,1122
d8317d92a3935fbbc157b6f8224158d54ee1c098,0,Adar Dembo,2014-08-21 20:12:24-07:00,['0d40905231a7b09a6df827bbc7ef4b8d9b2131ee'],98,119,217,437821,13,1,1,1,1122
1101cfbfeadcb69fa1b6576b30814eedb82379e2,0,Todd Lipcon,2014-08-21 21:20:29-07:00,['d8317d92a3935fbbc157b6f8224158d54ee1c098'],3,60,63,437884,8,0,0,1,1122
ed4837b241eca8e10629851f220a966a1982cf67,1,Todd Lipcon,2014-08-22 15:19:18-07:00,['1101cfbfeadcb69fa1b6576b30814eedb82379e2'],95,155,250,438134,5,1,1,1,1124
1eb1998b61aca007a8ce77fc67744022de65a094,1,Todd Lipcon,2014-08-22 15:19:48-07:00,['ed4837b241eca8e10629851f220a966a1982cf67'],21,24,45,438179,2,1,1,0,1124
1d2e7fd3d324cb0974fddfe95b669bbe94485253,0,Todd Lipcon,2014-08-22 15:45:39-07:00,['1eb1998b61aca007a8ce77fc67744022de65a094'],0,35,35,438214,2,,,,1125
3989cef2455e2da6cd49fce366d018e8d48cdec4,0,Todd Lipcon,2014-08-22 15:46:01-07:00,['1d2e7fd3d324cb0974fddfe95b669bbe94485253'],29,17,46,438260,4,0,0,0,1125
7676b10608bbe411028797186cb7feed62487459,0,Todd Lipcon,2014-08-22 17:04:58-07:00,['3989cef2455e2da6cd49fce366d018e8d48cdec4'],108,0,108,438368,12,0,0,1,1125
0fda40cf6caba5aad2ca1867b5b5b735e920ac02,0,Adar Dembo,2014-08-22 17:35:52-07:00,['7676b10608bbe411028797186cb7feed62487459'],3,32,35,438403,2,1,1,0,1125
85a83a33ba55ef1343a2a6c01dcfef9b47e62b45,0,Todd Lipcon,2014-08-22 19:05:56-07:00,['0fda40cf6caba5aad2ca1867b5b5b735e920ac02'],3,19,22,438425,1,0,1,1,1125
06fea2c731496b14a8492060cdad22f48cb48a29,1,Todd Lipcon,2014-08-22 19:53:40-07:00,['85a83a33ba55ef1343a2a6c01dcfef9b47e62b45'],123,125,248,438673,10,0,1,0,1125
f164201ec8eb9204540f3e8eabef7ebae3909b9f,0,Todd Lipcon,2014-08-25 11:09:05-07:00,['06fea2c731496b14a8492060cdad22f48cb48a29'],1,1,2,438675,1,,,,1125
39440c1abcb24ffd5564fadd4eb88aaef53fd941,0,Todd Lipcon,2014-08-25 12:45:12-07:00,['f164201ec8eb9204540f3e8eabef7ebae3909b9f'],1,33,34,438709,2,0,1,1,1125
11e500afc72f6a5cdaa7b5cac013478739e07b93,0,Todd Lipcon,2014-08-25 12:49:22-07:00,['39440c1abcb24ffd5564fadd4eb88aaef53fd941'],3,13,16,438725,2,,,,1125
f7ebd2451f4cbce3c420a589bf1e4eb410628f8d,1,Todd Lipcon,2014-08-25 14:57:18-07:00,['11e500afc72f6a5cdaa7b5cac013478739e07b93'],98,115,213,438938,3,1,1,0.6,1125
f80b39313e138c0938478abab37662ade5b55540,0,Vladimir Feinberg,2014-08-25 15:38:49-07:00,['f7ebd2451f4cbce3c420a589bf1e4eb410628f8d'],15,39,54,438992,2,0.571428571,0.571428571,0,1125
e95db9874f4e8a8a29ddeff863aef9b0ec25a3a8,0,Vladimir Feinberg,2014-08-25 16:03:01-07:00,['f80b39313e138c0938478abab37662ade5b55540'],99,179,278,439270,9,1,1,0.384615385,1127
99c950f0686b0c4963e36233909cd2a88e0434e1,0,Vladimir Feinberg,2014-08-25 16:03:22-07:00,['e95db9874f4e8a8a29ddeff863aef9b0ec25a3a8'],5,121,126,439396,2,0.471698113,0.471698113,0.339622642,1127
c1d267fa066640b1cdafd6e099fa77f88ccfdd5e,0,Vladimir Feinberg,2014-08-25 16:03:34-07:00,['99c950f0686b0c4963e36233909cd2a88e0434e1'],3,14,17,439413,2,1,1,0,1127
214883841564c1fb3f6564cd000e7ff9098641d1,0,Vladimir Feinberg,2014-08-25 16:31:13-07:00,['c1d267fa066640b1cdafd6e099fa77f88ccfdd5e'],1,6,7,439420,1,,,,1127
b6a2395023a07dad17bb1d5a705a07a812c20dc5,0,Michael Percy,2014-08-25 16:40:22-07:00,['214883841564c1fb3f6564cd000e7ff9098641d1'],9,30,39,439459,3,0.5,1,0.875,1127
70c62c55c7afcb0865cafa34f223df1d3076984f,0,Todd Lipcon,2014-08-25 16:46:21-07:00,['b6a2395023a07dad17bb1d5a705a07a812c20dc5'],1,9,10,439469,1,0,1,1,1127
b3c04304210a0541c3b8373b4418296bcfbc91d8,0,Todd Lipcon,2014-08-26 11:36:05-07:00,['70c62c55c7afcb0865cafa34f223df1d3076984f'],1,1,2,439471,1,,0,,1127
973e2a10ab4dfefe0cf9e5e56549f6d510f70fea,1,Todd Lipcon,2014-08-26 11:37:22-07:00,['b3c04304210a0541c3b8373b4418296bcfbc91d8'],55,152,207,439678,1,0.538461538,1,0,1127
3d896b6ff578a591d5ebeae84799e6599a6b134f,0,Todd Lipcon,2014-08-26 11:37:34-07:00,['973e2a10ab4dfefe0cf9e5e56549f6d510f70fea'],0,11,11,439689,2,1,1,1,1127
485ad9525e30425356217ef147dbdd8f00dde694,0,Vladimir Feinberg,2014-08-26 13:52:59-07:00,['3d896b6ff578a591d5ebeae84799e6599a6b134f'],4,8,12,439701,1,,,,1127
1c124c99662f149bbeb427bbc28c5eedc874501a,0,Vladimir Feinberg,2014-08-26 19:17:32-07:00,['485ad9525e30425356217ef147dbdd8f00dde694'],3,0,3,439704,1,0,0,0,1127
f2df1620aea9be679187a8f34f78dc85b85794ed,0,Jean-Daniel Cryans,2014-08-27 13:06:03-07:00,['1c124c99662f149bbeb427bbc28c5eedc874501a'],56,139,195,439899,15,,,,1128
bea13947e8d490fa69253cbc0e513375ed2e935f,0,David Alves,2014-08-28 12:22:27-07:00,['f2df1620aea9be679187a8f34f78dc85b85794ed'],0,14,14,439913,2,1,1,1,1128
10645a1439a62afd37fc3c15519026c0f9cb9964,1,Todd Lipcon,2014-08-28 12:58:20-07:00,['bea13947e8d490fa69253cbc0e513375ed2e935f'],75,106,181,440094,13,0,1,1,1128
32a35cff945a9218ae169a3c57b0804aea881a2d,0,Todd Lipcon,2014-08-28 16:26:44-07:00,['10645a1439a62afd37fc3c15519026c0f9cb9964'],27,61,88,440182,3,0,1,1,1128
c833bb51b3355c60c9769770a6d6e3383a117cef,0,Vladimir Feinberg,2014-08-28 16:39:14-07:00,['32a35cff945a9218ae169a3c57b0804aea881a2d'],0,5,5,440187,1,,,,1128
6f48af723afec562d487d7b7e1d692182468cc93,0,Jean-Daniel Cryans,2014-08-28 16:52:01-07:00,['c833bb51b3355c60c9769770a6d6e3383a117cef'],0,3,3,440190,2,0,1,1,1128
60ffa8abe63fcd9a3b0cf5b19b77a0402b8438dd,0,Vladimir Feinberg,2014-08-28 17:07:55-07:00,['6f48af723afec562d487d7b7e1d692182468cc93'],12,156,168,440358,5,0.044776119,1,0.268656716,1128
40f90a1fcf37e26b44cbcf4b8aaf15efcabbfe01,0,David Alves,2014-08-28 20:04:16-07:00,['60ffa8abe63fcd9a3b0cf5b19b77a0402b8438dd'],3,6,9,440367,1,0,0,1,1128
4fc28e0fb3cca1f63e5225df7af26509341712a8,0,Todd Lipcon,2014-08-29 09:55:42-07:00,['40f90a1fcf37e26b44cbcf4b8aaf15efcabbfe01'],25,34,59,440426,2,1,1,0,1128
65cdffaf486affe097078ee226b938abfeb868a9,0,Todd Lipcon,2014-08-29 10:16:20-07:00,['4fc28e0fb3cca1f63e5225df7af26509341712a8'],199,247,446,440872,40,,,,1130
189f5c5ac5806bf84356fc9ca094195f3600778d,0,Todd Lipcon,2014-08-29 13:28:15-07:00,['65cdffaf486affe097078ee226b938abfeb868a9'],0,20,20,440892,2,0.666666667,1,1,1130
7ae047e25079431df403bc401e3ca0cce2b99daa,0,Todd Lipcon,2014-08-29 13:30:57-07:00,['189f5c5ac5806bf84356fc9ca094195f3600778d'],19,22,41,440933,3,1,1,0,1130
8a1cd8eecac0bd285f515e247528de4450ecead2,0,Todd Lipcon,2014-08-29 13:31:37-07:00,['7ae047e25079431df403bc401e3ca0cce2b99daa'],10,12,22,440955,3,,,,1130
0d2ea833f5b85fd381187a34b69d2890501d996d,1,Todd Lipcon,2014-08-29 14:08:08-07:00,['8a1cd8eecac0bd285f515e247528de4450ecead2'],12,45,57,441012,2,0.2,1,0.95,1130
1c06ba3fea0d3966462f3d3f777facb83b53c623,0,David Alves,2014-08-29 14:10:19-07:00,['0d2ea833f5b85fd381187a34b69d2890501d996d'],2,9,11,441023,2,0,0,0,1130
8d2786f93d1fe863e54326204af11091869ff3bc,1,David Alves,2014-08-29 14:49:20-07:00,['1c06ba3fea0d3966462f3d3f777facb83b53c623'],1,1,2,441025,1,,,,1130
e43ef4c388161a48b38739b70fe485abd339d235,1,Vladimir Feinberg,2014-08-29 17:32:18-07:00,['8d2786f93d1fe863e54326204af11091869ff3bc'],21,394,415,441440,10,0.465517241,1,0.586206897,1132
7b24d80c57b2516aefe9881162826f50729be917,1,Vladimir Feinberg,2014-08-29 18:58:21-07:00,['e43ef4c388161a48b38739b70fe485abd339d235'],0,54,54,441494,6,0.619047619,0.80952381,0.904761905,1132
eb45aeb5da860bdaf61d3a8f1c14d004d006b4d5,0,Jean-Daniel Cryans,2014-09-02 09:09:33-07:00,['7b24d80c57b2516aefe9881162826f50729be917'],5,5,10,441504,3,,,,1132
4d9e0d1eb53e3d2e002ec67ca3a08272dc1d0adc,0,Adar Dembo,2014-09-02 13:48:23-07:00,['eb45aeb5da860bdaf61d3a8f1c14d004d006b4d5'],0,13,13,441517,3,1,1,1,1132
bcf568c251ad7a1da447f200e73547911913f7ff,0,Vladimir Feinberg,2014-09-02 14:10:54-07:00,['4d9e0d1eb53e3d2e002ec67ca3a08272dc1d0adc'],273,353,626,442143,12,1,1,0,1134
d599c79b09d2423c6574e6322c8030e0bc13607f,0,Vladimir Feinberg,2014-09-02 14:11:13-07:00,['bcf568c251ad7a1da447f200e73547911913f7ff'],5,5,10,442153,3,,,,1134
50fe2838ecd8966f8c8fa6a4f6e8a91eb4a1d626,0,Michael Percy,2014-09-02 14:39:59-07:00,['d599c79b09d2423c6574e6322c8030e0bc13607f'],19,23,42,442195,1,1,1,0,1134
fa12555215f2f91ca1be7f735325c7229f7924fd,1,Michael Percy,2014-09-02 14:41:16-07:00,['50fe2838ecd8966f8c8fa6a4f6e8a91eb4a1d626'],0,19,19,442214,1,1,1,1,1134
b536616dc64185e863f7900de3e8fce35f26cc9d,1,Adar Dembo,2014-09-02 16:50:05-07:00,['fa12555215f2f91ca1be7f735325c7229f7924fd'],15,56,71,442285,6,1,1,1,1134
9a5ffe32bfd5441826ed132e5c228d3c23fa6810,1,Adar Dembo,2014-09-02 17:16:40-07:00,['b536616dc64185e863f7900de3e8fce35f26cc9d'],21,19,40,442325,3,1,0,0,1134
a8ba2dd4460695f680f908012dc25df06e4d12b1,1,Alex Feinberg,2014-09-02 19:36:14-07:00,['9a5ffe32bfd5441826ed132e5c228d3c23fa6810'],14,172,186,442511,14,0.505376344,1,0.784946237,1134
adf4be71114c539f9dfac0feb5cb54f005a44101,0,Todd Lipcon,2014-09-03 12:27:04-07:00,['a8ba2dd4460695f680f908012dc25df06e4d12b1'],1,33,34,442545,1,,,,1134
396a49ec6eccbbe611c5a3e03eac6f9e9ce4c99f,0,Adar Dembo,2014-09-03 12:44:16-07:00,['adf4be71114c539f9dfac0feb5cb54f005a44101'],0,2,2,442547,1,0,1,0,1134
d3cc50d8dd08a73618b4334c9db531ec935e447c,0,Adar Dembo,2014-09-03 12:44:57-07:00,['396a49ec6eccbbe611c5a3e03eac6f9e9ce4c99f'],32,40,72,442619,1,0,1,1,1134
79ab017e556dc77c11e1ec4e71fe4a312f7592ee,1,Adar Dembo,2014-09-03 12:45:56-07:00,['d3cc50d8dd08a73618b4334c9db531ec935e447c'],19,20,39,442658,3,,0,,1134
d9349bf82be7024df9f7617424af4c47105db238,1,Vladimir Feinberg,2014-09-03 16:31:42-07:00,['79ab017e556dc77c11e1ec4e71fe4a312f7592ee'],38,35,73,442731,3,1,1,1,1134
937f1a540a743dba00d45a0a92590a3a3c655d03,0,Michael Percy,2014-09-04 01:58:27-07:00,['d9349bf82be7024df9f7617424af4c47105db238'],11,28,39,442770,2,0,1,1,1134
65b5dc12b5da72bac0bebbd759e6b40332d80c22,0,Todd Lipcon,2014-09-04 23:10:43-07:00,['937f1a540a743dba00d45a0a92590a3a3c655d03'],0,14,14,442784,1,1,1,1,1134
bb66eb9ad669543fea3dfffebe306bc55400ee2c,0,Todd Lipcon,2014-09-04 23:26:20-07:00,['65b5dc12b5da72bac0bebbd759e6b40332d80c22'],3,3,6,442790,1,,,,1134
da51f865f4443ea30c16afe27cdb74eee3c1eec3,0,Todd Lipcon,2014-09-04 23:31:32-07:00,['bb66eb9ad669543fea3dfffebe306bc55400ee2c'],8,20,28,442818,1,0,1,1,1134
983f54fb362c04ca0af0e4d8e31b51fd308edecf,0,David Alves,2014-09-05 13:12:35-07:00,['da51f865f4443ea30c16afe27cdb74eee3c1eec3'],0,11,11,442829,1,1,1,1,1134
d89f37aa5c36bdd2ac637d7cf4209396fb492948,0,Michael Percy,2014-09-09 16:51:18-07:00,['983f54fb362c04ca0af0e4d8e31b51fd308edecf'],16,73,89,442918,6,0,1,0.447368421,1134
3e3c60d31d2cb70024d565ced2cee41628a98ad3,0,Adar Dembo,2014-09-10 11:50:39-07:00,['d89f37aa5c36bdd2ac637d7cf4209396fb492948'],1,7,8,442926,2,0.5,1,1,1134
da9d9f58d0a0fcb673472127c9697c0c483bbec1,0,Jean-Daniel Cryans,2014-09-10 12:16:54-07:00,['3e3c60d31d2cb70024d565ced2cee41628a98ad3'],0,1137,1137,444063,1,,,,1135
65ac609bd721fa1b0334f833ddf3af075f6f552c,0,Adar Dembo,2014-09-10 13:52:38-07:00,['da9d9f58d0a0fcb673472127c9697c0c483bbec1'],40,152,192,444255,6,1,1,0.586206897,1136
6fa07eb73e1dce9599c8f964cddc803ba9112a87,0,Michael Percy,2014-09-10 18:53:51-07:00,['65ac609bd721fa1b0334f833ddf3af075f6f552c'],8,18,26,444281,1,0.333333333,0,1,1136
8656b6a2b091096c6668750b3d8a85e87d11e4a1,0,Michael Percy,2014-09-10 18:55:45-07:00,['6fa07eb73e1dce9599c8f964cddc803ba9112a87'],3,19,22,444303,6,1,1,1,1136
bd07a00235881ab7a79bab529c84b538160f57a0,0,Michael Percy,2014-09-10 19:05:00-07:00,['8656b6a2b091096c6668750b3d8a85e87d11e4a1'],2,20,22,444325,2,1,1,1,1136
fa7d14eff192fc2089d73129768291c967af96e4,0,Michael Percy,2014-09-10 19:13:24-07:00,['bd07a00235881ab7a79bab529c84b538160f57a0'],8,36,44,444369,4,0.818181818,0.909090909,1,1136
9884fab000bed256703904803d5f09c53e50c18e,1,Todd Lipcon,2014-09-11 12:40:43-07:00,['fa7d14eff192fc2089d73129768291c967af96e4'],62,126,188,444557,11,0,0.902439024,0,1136
2b96fd2ce84c420ec44c911037bcb1877c687775,1,Adar Dembo,2014-09-11 15:45:59-07:00,['9884fab000bed256703904803d5f09c53e50c18e'],11,63,74,444631,4,0.24,0.92,1,1136
f43f53317be89a14963aa629b371436678e07cd2,1,Todd Lipcon,2014-09-11 15:46:29-07:00,['2b96fd2ce84c420ec44c911037bcb1877c687775'],71,204,275,444906,7,0,1,1,1138
499b989ad8db8c17acb7ae839726f0fbf49daa05,1,Todd Lipcon,2014-09-11 15:46:36-07:00,['f43f53317be89a14963aa629b371436678e07cd2'],0,108,108,445014,1,0.223880597,0.52238806,0.52238806,1138
b0f5bfd9a3f81a7e9a2305b7a3a63e898026a11f,1,Todd Lipcon,2014-09-11 15:46:41-07:00,['499b989ad8db8c17acb7ae839726f0fbf49daa05'],1,31,32,445046,1,0.75,0.75,0.75,1138
9fb538f1467f963115f33fc13a7a1978a2335385,0,Jean-Daniel Cryans,2014-09-11 16:53:44-07:00,['b0f5bfd9a3f81a7e9a2305b7a3a63e898026a11f'],9,60,69,445115,3,0,1,1,1138
9d32e17d2f0f789cbf373d047219781324a9078b,1,Jean-Daniel Cryans,2014-09-11 17:04:03-07:00,['9fb538f1467f963115f33fc13a7a1978a2335385'],4,131,135,445250,4,0.614285714,1,1,1140
c6c79539f1497596113161c91c5f387a8a0e92e8,0,Jean-Daniel Cryans,2014-09-12 12:22:12-07:00,['9d32e17d2f0f789cbf373d047219781324a9078b'],1,1,2,445252,1,,,,1140
4cd996e52fbe8d7749153e564be83e7beeeced66,0,David Alves,2014-09-12 16:12:30-07:00,['c6c79539f1497596113161c91c5f387a8a0e92e8'],3,12,15,445267,2,1,1,1,1140
dc4fe27acf9d00af884f5b1c624df1f5d6e9a625,0,Todd Lipcon,2014-09-12 16:13:47-07:00,['4cd996e52fbe8d7749153e564be83e7beeeced66'],24,23,47,445314,1,0,,0,1140
dbceda6cfc37fe67211468567d403fab14a043a3,0,Todd Lipcon,2014-09-12 17:06:24-07:00,['dc4fe27acf9d00af884f5b1c624df1f5d6e9a625'],0,14,14,445328,3,1,1,1,1140
a1055c65b11b8631b6dd92a24a76bb14e9d04ed1,0,Michael Percy,2014-09-12 17:20:46-07:00,['dbceda6cfc37fe67211468567d403fab14a043a3'],19,116,135,445463,8,0.654545455,0.890909091,0.545454545,1140
f0a69e17fc02c2985e14354b6aecef77e8eaceaa,0,Michael Percy,2014-09-12 17:21:04-07:00,['a1055c65b11b8631b6dd92a24a76bb14e9d04ed1'],2,15,17,445480,2,1,1,1,1140
b4edc86c2c8e660f8deee569da4f40261a27fd6c,1,Todd Lipcon,2014-09-13 16:27:05-07:00,['f0a69e17fc02c2985e14354b6aecef77e8eaceaa'],20,111,131,445611,2,0.490196078,1,1,1140
b657c933c68f27046f4be26aa1543f40708d51c6,1,Todd Lipcon,2014-09-15 12:36:59-07:00,['b4edc86c2c8e660f8deee569da4f40261a27fd6c'],31,175,206,445817,3,0,0,1,1140
27fb6cafa9d49953b11b88bd8c72155d936e202a,1,Todd Lipcon,2014-09-15 12:48:46-07:00,['b657c933c68f27046f4be26aa1543f40708d51c6'],81,120,201,446018,2,1,1,0,1141
8e139a92be24900f2847456acdb9ee9414ce3f90,0,David Alves,2014-09-15 12:49:10-07:00,['27fb6cafa9d49953b11b88bd8c72155d936e202a'],254,480,734,446752,24,0.397590361,1,1,1141
7b957e71cee315ba893b421251e9866cb44697d3,0,David Alves,2014-09-15 13:48:13-07:00,['8e139a92be24900f2847456acdb9ee9414ce3f90'],2,2,4,446756,1,,,,1141
0aa59197a6fe017cdd2792f4e320debc23bff9f2,1,Jean-Daniel Cryans,2014-09-15 14:29:31-07:00,['7b957e71cee315ba893b421251e9866cb44697d3'],12,38,50,446806,3,0.833333333,1,1,1141
bf55481196bb74a6259cd530bdbb1d7f4ccad76e,1,Michael Percy,2014-09-15 14:51:38-07:00,['0aa59197a6fe017cdd2792f4e320debc23bff9f2'],1,707,708,447514,8,0.361344538,1,0.792717087,1144
d9d17c5c8aea5c0c513bdc989f781bc3d09245cd,0,Todd Lipcon,2014-09-15 15:03:03-07:00,['bf55481196bb74a6259cd530bdbb1d7f4ccad76e'],46,2,48,447562,5,1,0,1,1144
1364b060dc72034b226900505c6772e1af07a473,0,Adar Dembo,2014-09-15 15:42:35-07:00,['d9d17c5c8aea5c0c513bdc989f781bc3d09245cd'],0,1,1,447563,1,,,,1144
9e43eab1afd3ce95f98f727e2b7b999da6c2e98f,0,Todd Lipcon,2014-09-15 15:42:35-07:00,['1364b060dc72034b226900505c6772e1af07a473'],0,134,134,447697,1,1,1,1,1145
9796c90df147fe9071d3104c6cf267cb7e20de86,1,Todd Lipcon,2014-09-15 17:35:52-07:00,['9e43eab1afd3ce95f98f727e2b7b999da6c2e98f'],1089,1111,2200,449897,69,1,1,1,1149
caa0d12ce5d55a36de20a51c6d91ca4a48511a90,1,Todd Lipcon,2014-09-15 17:35:59-07:00,['9796c90df147fe9071d3104c6cf267cb7e20de86'],91,73,164,450061,7,0,0,1,1149
227882da0bbcd3d4addd00d63c311308fe4efa72,1,Todd Lipcon,2014-09-15 17:36:04-07:00,['caa0d12ce5d55a36de20a51c6d91ca4a48511a90'],97,108,205,450266,6,0,0.857142857,1,1149
f872c6b8c3e97368379451c9a822de8c0235b4a1,0,David Alves,2014-09-15 21:50:13-07:00,['227882da0bbcd3d4addd00d63c311308fe4efa72'],2,4,6,450272,1,0,0,1,1149
3f18373983744d3c85cd39560be8a31824fa3950,1,Adar Dembo,2014-09-16 14:33:12-07:00,['f872c6b8c3e97368379451c9a822de8c0235b4a1'],0,1050,1050,451322,8,0.646428571,1,0.898214286,1156
0cd304a8d8abe0280322331f23649d8faf83805a,0,Todd Lipcon,2014-09-17 10:37:33-07:00,['3f18373983744d3c85cd39560be8a31824fa3950'],28,39,67,451389,2,1,1,1,1156
e9e43d096f492e87eb73e80dff0aee3434e78e9f,1,Jean-Daniel Cryans,2014-09-17 14:42:44-07:00,['0cd304a8d8abe0280322331f23649d8faf83805a'],302,443,745,452134,2,0.323076923,1,0,1156
fd9f4db780b74df0dadf60a9fe49443232c9c908,1,Michael Percy,2014-09-17 16:34:24-07:00,['e9e43d096f492e87eb73e80dff0aee3434e78e9f'],2,973,975,453109,7,0.416161616,0.888888889,0.892929293,1160
f26d36ed455b11f80dddac0b293d273a9ea606e2,0,Todd Lipcon,2014-09-17 17:28:57-07:00,['fd9f4db780b74df0dadf60a9fe49443232c9c908'],108,136,244,453353,12,1,1,1,1160
bd718b6cc295e0bd800968d3a5178cd5be188af7,0,Todd Lipcon,2014-09-17 17:34:02-07:00,['f26d36ed455b11f80dddac0b293d273a9ea606e2'],16,36,52,453405,5,1,1,1,1160
b52c452ac0e0a7bdd5382916fe0532099592f088,0,Todd Lipcon,2014-09-17 17:35:32-07:00,['bd718b6cc295e0bd800968d3a5178cd5be188af7'],1,8,9,453414,2,0.5,1,1,1160
2fffbe564c79b991cede6578e56cefb687e74fb3,0,Adar Dembo,2014-09-18 14:40:18-07:00,['b52c452ac0e0a7bdd5382916fe0532099592f088'],1,7,8,453422,1,,,,1160
9fd232cd69ea8eefae210277fd4bbcc138915f57,0,Adar Dembo,2014-09-19 17:38:41-07:00,['2fffbe564c79b991cede6578e56cefb687e74fb3'],2,4,6,453428,1,0,0,1,1160
2aa4b08749e44316d9a667af8200ac4b8ceffe94,1,Michael Percy,2014-09-22 16:51:29-07:00,['9fd232cd69ea8eefae210277fd4bbcc138915f57'],538,608,1146,454574,45,1,1,0.87804878,1160
98fc5a24c7f924299fee698e4724fad548bcdda9,1,Adar Dembo,2014-09-22 16:53:20-07:00,['2aa4b08749e44316d9a667af8200ac4b8ceffe94'],18,38,56,454630,5,1,1,1,1160
7d4fc061fddd2b1114e5b491eb09b82319bd0c5c,0,Michael Percy,2014-09-23 11:13:22-07:00,['98fc5a24c7f924299fee698e4724fad548bcdda9'],1,1,2,454632,1,,,,1160
a6322277250c8f4fb3dda8bac10ad2b873d5e793,0,David Alves,2014-09-23 11:29:13-07:00,['7d4fc061fddd2b1114e5b491eb09b82319bd0c5c'],9,10,19,454651,1,0,1,1,1160
855a95f85ea60d7331a9fef44517c4f9f512ddc9,0,Todd Lipcon,2014-09-23 12:31:54-07:00,['a6322277250c8f4fb3dda8bac10ad2b873d5e793'],2,37,39,454690,4,1,1,1,1160
1575e8849de7b7c68984a0cdedef165d0d82c11c,1,Adar Dembo,2014-09-23 16:24:22-07:00,['855a95f85ea60d7331a9fef44517c4f9f512ddc9'],18,23,41,454731,1,0,1,0,1160
82ce8dab3590b721fc90423c44d8cfe604ddc350,0,David Alves,2014-09-23 19:36:18-07:00,['1575e8849de7b7c68984a0cdedef165d0d82c11c'],0,122,122,454853,1,,,,1161
416d373301f7528b0dad3c7aad2e414347d9ff99,0,Todd Lipcon,2014-09-23 20:48:49-07:00,['82ce8dab3590b721fc90423c44d8cfe604ddc350'],1,36,37,454890,2,,,,1162
d0c6bfb59487892ed1a8aba2bf9605a25606affc,0,Michael Percy,2014-09-24 08:51:31-07:00,['416d373301f7528b0dad3c7aad2e414347d9ff99'],1,2,3,454893,1,1,1,0,1162
c616975b2a3d9d7f71226f92f96b8764d0b36356,1,Adar Dembo,2014-09-24 13:06:04-07:00,['d0c6bfb59487892ed1a8aba2bf9605a25606affc'],102,88,190,455083,9,0.461538462,0,0.384615385,1162
f4574a002e6b9507d985b159ae5fd7971f278c2d,1,Todd Lipcon,2014-09-24 13:10:25-07:00,['c616975b2a3d9d7f71226f92f96b8764d0b36356'],37,328,365,455448,20,0.674846626,0.963190184,0.901840491,1163
47f4bf6c9d75b37ac1e4c2ed73b50d3d376de4bc,1,Todd Lipcon,2014-09-24 13:11:15-07:00,['f4574a002e6b9507d985b159ae5fd7971f278c2d'],7,28,35,455483,1,0.058823529,1,1,1163
44c78ec90fd0eb4b4a5e9d3d7d845a6ef90517a6,1,Adar Dembo,2014-09-24 13:44:15-07:00,['47f4bf6c9d75b37ac1e4c2ed73b50d3d376de4bc'],122,471,593,456076,1,0.271875,0.46875,0.53125,1163
f98f3291b8341e73f12febe33eb97528536de79e,0,Adar Dembo,2014-09-24 16:01:03-07:00,['44c78ec90fd0eb4b4a5e9d3d7d845a6ef90517a6'],14,119,133,456209,4,0.278688525,0.836065574,1,1163
35c156fa54eca9a2ba56150050598bde7a95d98c,0,Adar Dembo,2014-09-24 16:01:21-07:00,['f98f3291b8341e73f12febe33eb97528536de79e'],15,42,57,456266,8,0,0.933333333,0.733333333,1163
7c496e99588b00372de3ca0befbf37ab218fdadf,1,Todd Lipcon,2014-09-25 12:41:26-07:00,['35c156fa54eca9a2ba56150050598bde7a95d98c'],18,54,72,456338,5,0,0.826086957,0.826086957,1163
dea871b46570dc54ca55cf551e25dc20f8e17d3a,1,David Alves,2014-09-25 13:29:00-07:00,['7c496e99588b00372de3ca0befbf37ab218fdadf'],78,89,167,456505,8,0,0,0.333333333,1163
df4d9565d0a41b49f1dbf65cba1caf525f8bc208,1,David Alves,2014-09-25 16:15:03-07:00,['dea871b46570dc54ca55cf551e25dc20f8e17d3a'],181,499,680,457185,8,0.641975309,0.734567901,0.950617284,1163
09fd760cc66f8c79c5d63c663661bc5b71f1b1dc,0,Michael Percy,2014-09-25 16:23:50-07:00,['df4d9565d0a41b49f1dbf65cba1caf525f8bc208'],73,99,172,457357,5,,,,1164
2762e2377abf88307b0295c6061d3a508c7c1b38,0,Todd Lipcon,2014-09-25 18:13:53-07:00,['09fd760cc66f8c79c5d63c663661bc5b71f1b1dc'],15,25,40,457397,1,1,1,1,1164
caa02198c117e525fa61b67499bec0ac777ebf98,1,Adar Dembo,2014-09-25 18:15:28-07:00,['2762e2377abf88307b0295c6061d3a508c7c1b38'],15,87,102,457499,2,0.4375,1,0.625,1164
edcc0571ba52409616ccab951811efe3a053f2b5,1,Michael Percy,2014-09-25 18:29:37-07:00,['caa02198c117e525fa61b67499bec0ac777ebf98'],30,463,493,457992,6,0.166666667,1,0.361904762,1165
5f0b3556059dd7598d403ff00b42d4e0669fddf5,1,Michael Percy,2014-09-25 18:30:41-07:00,['edcc0571ba52409616ccab951811efe3a053f2b5'],11,24,35,458027,4,0.857142857,1,0.857142857,1165
0982a88851c2cc5b04d4dd331203a5b87360a7e0,1,David Alves,2014-09-26 14:10:40-07:00,['5f0b3556059dd7598d403ff00b42d4e0669fddf5'],2,286,288,458315,8,0.681818182,1,0.7,1168
cabe41020872f8f317754785dccb4a7eb40cbdb8,0,Todd Lipcon,2014-09-26 14:14:21-07:00,['0982a88851c2cc5b04d4dd331203a5b87360a7e0'],0,18,18,458333,1,0,1,1,1168
94f69a1fecc1f7ec2b3886ea6e73b53f49a6c291,1,Michael Percy,2014-09-26 14:31:57-07:00,['cabe41020872f8f317754785dccb4a7eb40cbdb8'],36,452,488,458821,9,0.244444444,0.942222222,0.88,1168
1e20cadfe0fb23ad84c1901b1e816db12ffe65de,0,Todd Lipcon,2014-09-26 16:17:13-07:00,['94f69a1fecc1f7ec2b3886ea6e73b53f49a6c291'],3,3,6,458827,2,,,,1168
2bdfa0da3c5577a723c2f83863c37fb3f1d9b24d,0,Todd Lipcon,2014-09-26 16:17:19-07:00,['1e20cadfe0fb23ad84c1901b1e816db12ffe65de'],17,14,31,458858,3,0.333333333,0,1,1168
fea9617b5b2a51d600f5287872b9004723074422,0,Todd Lipcon,2014-09-26 17:01:14-07:00,['2bdfa0da3c5577a723c2f83863c37fb3f1d9b24d'],2,4,6,458864,1,1,1,1,1168
09f93148ec716c8c0d0adf57c46681b7c3b443fc,0,Todd Lipcon,2014-09-26 17:47:57-07:00,['fea9617b5b2a51d600f5287872b9004723074422'],143,71,214,459078,6,0.295454545,0,0.045454545,1168
8f222db92228a8cdfeab33ba557a8e4303fb5fad,0,Todd Lipcon,2014-09-26 17:48:07-07:00,['09f93148ec716c8c0d0adf57c46681b7c3b443fc'],22,64,86,459164,4,0.28,0.96,1,1168
d01dcad8854e219aa10a47bb3e4feecc840742ed,1,Todd Lipcon,2014-09-26 18:08:49-07:00,['8f222db92228a8cdfeab33ba557a8e4303fb5fad'],39,183,222,459386,17,0.662790698,0.895348837,0.918604651,1168
e803af9a8511f6cc09eb0b7d0e116ece8ea558fb,1,Todd Lipcon,2014-09-26 18:20:49-07:00,['d01dcad8854e219aa10a47bb3e4feecc840742ed'],134,208,342,459728,5,1,1,1,1170
b451931af5a8510402418482a08c64fa6be15b5d,0,Todd Lipcon,2014-09-26 18:22:18-07:00,['e803af9a8511f6cc09eb0b7d0e116ece8ea558fb'],31,76,107,459835,1,0.59375,0,0.59375,1170
7ac7f377732cd5d1a66a47e0d0e6142af7b159c2,0,Todd Lipcon,2014-09-29 11:21:45-07:00,['b451931af5a8510402418482a08c64fa6be15b5d'],1,21,22,459857,2,0,1,1,1170
7584198706177b7db9205e61d9fa03ecf56b029a,1,Todd Lipcon,2014-09-29 11:24:40-07:00,['7ac7f377732cd5d1a66a47e0d0e6142af7b159c2'],103,74,177,460034,10,0,0,0,1170
27485efb1fc2f35ae7db4aff1e6d6f6bdfe22d7e,1,Jean-Daniel Cryans,2014-09-29 12:24:08-07:00,['7584198706177b7db9205e61d9fa03ecf56b029a'],314,257,571,460605,3,0.528301887,0,0.58490566,1170
21caa271cf8f887303b02cadd3791d211ec92ec6,0,David Alves,2014-09-29 14:24:33-07:00,['27485efb1fc2f35ae7db4aff1e6d6f6bdfe22d7e'],17,20,37,460642,3,1,1,0,1170
643d2e8e00a542be5305d37806ffb46944529447,0,David Alves,2014-09-29 15:14:10-07:00,['21caa271cf8f887303b02cadd3791d211ec92ec6'],58,99,157,460799,1,0,1,0.818181818,1170
4b2f64a2b01ee33ba677e7ca3e6bccffdbc8ab46,0,David Alves,2014-09-29 15:14:16-07:00,['643d2e8e00a542be5305d37806ffb46944529447'],36,77,113,460912,1,0,0,0,1170
c3e70af7f6c7906785052f7127967d3ed22a33ba,0,Todd Lipcon,2014-09-29 15:33:50-07:00,['4b2f64a2b01ee33ba677e7ca3e6bccffdbc8ab46'],1,4,5,460917,1,0,0,1,1170
f106c8c343f8325c7b90ac4bff0a8deb4d8387cc,0,Todd Lipcon,2014-09-29 16:26:51-07:00,['c3e70af7f6c7906785052f7127967d3ed22a33ba'],2,48,50,460967,2,0,0.928571429,0.928571429,1170
64983c4540f1fb82421f4a0482062232bb76b696,1,Jean-Daniel Cryans,2014-09-29 16:31:12-07:00,['f106c8c343f8325c7b90ac4bff0a8deb4d8387cc'],0,22,22,460989,4,0.363636364,0,0.363636364,1170
dc72c8b4ace9690e6638e5f19ec98e6a0fc025fd,1,David Alves,2014-09-29 17:08:51-07:00,['64983c4540f1fb82421f4a0482062232bb76b696'],335,353,688,461677,20,0,0.866666667,1,1170
1c0bc3171fe6dcace2189a142edd0d583cbcd6d8,0,David Alves,2014-09-29 17:09:18-07:00,['dc72c8b4ace9690e6638e5f19ec98e6a0fc025fd'],7,29,36,461713,2,0,1,1,1170
402af49a86146196929608854d9df489bcfc6633,1,Alex Feinberg,2014-09-29 17:17:02-07:00,['1c0bc3171fe6dcace2189a142edd0d583cbcd6d8'],102,951,1053,462766,22,0.407331976,0.751527495,0.676171079,1171
9a916f703d22df0ae921f1d021908c9aef793a22,0,Todd Lipcon,2014-09-30 22:31:16-07:00,['402af49a86146196929608854d9df489bcfc6633'],3,16,19,462785,1,0.75,1,1,1171
a799f4a906fb7b3ae7be96cc232d7b96abe322ac,0,Alex Feinberg,2014-10-01 11:44:48-07:00,['9a916f703d22df0ae921f1d021908c9aef793a22'],0,5,5,462790,1,0,1,0,1171
3b19f7223e89fa359f6741c9668f097b075a1b5a,0,Todd Lipcon,2014-10-01 12:30:15-07:00,['a799f4a906fb7b3ae7be96cc232d7b96abe322ac'],10,31,41,462831,1,0,1,0,1171
bf63032d3b1923ce0914cbb31c5d71d9280b7134,0,David Alves,2014-10-01 12:44:06-07:00,['3b19f7223e89fa359f6741c9668f097b075a1b5a'],0,90,90,462921,3,0.01369863,0.01369863,1,1171
2476e724f9878304a4a999a686db28ed1b790624,0,David Alves,2014-10-01 18:47:32-07:00,['bf63032d3b1923ce0914cbb31c5d71d9280b7134'],58,175,233,463154,9,0,0.761904762,1,1171
f062bad95c1f81352654bf43f7b6ddb43fbc53e6,0,David Alves,2014-10-01 20:12:52-07:00,['2476e724f9878304a4a999a686db28ed1b790624'],20,77,97,463251,5,0.566666667,0,0,1171
21e9ffbe3d0e1c506239a68d5188d5a39d7c64c2,0,Todd Lipcon,2014-10-01 23:41:10-07:00,['f062bad95c1f81352654bf43f7b6ddb43fbc53e6'],2,21,23,463274,2,,,,1171
660aff7a8a120290ea9436747ba9f0f1a1d03182,1,David Alves,2014-10-02 09:14:27-07:00,['21e9ffbe3d0e1c506239a68d5188d5a39d7c64c2'],370,807,1177,464451,36,0.306748466,0.650306748,0.72392638,1172
5c7d4eda8e420ccffcdfeab970f37463dce5ea87,0,Michael Percy,2014-10-02 09:45:41-07:00,['660aff7a8a120290ea9436747ba9f0f1a1d03182'],4,2,6,464457,1,,,,1172
3ebfbbfaee044a6f93dafe431473c7bd947031c9,0,Todd Lipcon,2014-10-02 11:39:52-07:00,['5c7d4eda8e420ccffcdfeab970f37463dce5ea87'],7,6,13,464470,1,0,0,0,1172
0988336c017741ff5dd5ea9336a64f869cf374f6,0,David Alves,2014-10-02 15:53:42-07:00,['3ebfbbfaee044a6f93dafe431473c7bd947031c9'],17,22,39,464509,1,0,1,1,1172
c6306f5d1b49513d060ef06fdd3df79ca4904243,0,Todd Lipcon,2014-10-02 17:23:28-07:00,['0988336c017741ff5dd5ea9336a64f869cf374f6'],3,23,26,464535,3,0.75,1,1,1172
f53c98739f2ddf86b08be81d8bb94437f3fcc9a6,1,David Alves,2014-10-02 17:36:28-07:00,['c6306f5d1b49513d060ef06fdd3df79ca4904243'],66,217,283,464818,7,0.640776699,0.883495146,0.757281553,1172
a2c82c1f9a744913976af3a3fa864588e9466827,0,Todd Lipcon,2014-10-02 18:35:26-07:00,['f53c98739f2ddf86b08be81d8bb94437f3fcc9a6'],0,1,1,464819,1,0,1,1,1172
3a4c02cc9e787101724ba606c185766b27a216eb,0,Todd Lipcon,2014-10-02 19:24:06-07:00,['a2c82c1f9a744913976af3a3fa864588e9466827'],1,6,7,464826,3,1,1,1,1172
8438596eda1640b44e3a5d59a027bc808544a8bc,0,David Alves,2014-10-02 23:39:06-07:00,['3a4c02cc9e787101724ba606c185766b27a216eb'],0,12,12,464838,5,0.5,1,0.75,1172
1c0781d4d753af6a0176a2060d91db3d27bea695,0,Todd Lipcon,2014-10-03 11:10:35-07:00,['8438596eda1640b44e3a5d59a027bc808544a8bc'],3,8,11,464849,3,1,1,1,1172
adad2912f4382240a51e6acca6bd7e848539de8e,1,David Alves,2014-10-03 13:43:38-07:00,['1c0781d4d753af6a0176a2060d91db3d27bea695'],478,565,1043,465892,29,1,1,1,1172
684cd61dabcccc08c2eea4ce4fecfe54ed9393e7,0,David Alves,2014-10-03 13:45:22-07:00,['adad2912f4382240a51e6acca6bd7e848539de8e'],25,40,65,465957,2,0.166666667,1,1,1172
141e508fd3ce84d2ef1b1fabbd526ec15bf27527,0,David Alves,2014-10-03 14:44:42-07:00,['684cd61dabcccc08c2eea4ce4fecfe54ed9393e7'],24,7,31,465988,7,0.666666667,0,0,1172
dbeaea2f5f401347e4649248bb230627895ac0da,0,David Alves,2014-10-03 14:46:58-07:00,['141e508fd3ce84d2ef1b1fabbd526ec15bf27527'],4,97,101,466089,4,0,1,0.470588235,1172
f569cd54ce181c30e9381da72c832e01a8612e6b,0,Adar Dembo,2014-10-03 16:11:42-07:00,['dbeaea2f5f401347e4649248bb230627895ac0da'],29,93,122,466211,2,0,1,0.804347826,1172
a916569d20708088948420f858fef9c442771570,0,Michael Percy,2014-10-03 16:32:33-07:00,['f569cd54ce181c30e9381da72c832e01a8612e6b'],2,17,19,466230,1,1,1,1,1172
4612fbc917dab58e462ad4880041be785f103989,0,Todd Lipcon,2014-10-03 16:37:07-07:00,['a916569d20708088948420f858fef9c442771570'],29,13,42,466272,1,1,0,0,1172
92727b0fa0b897632fc68bfa606058e3e3e5de48,0,Todd Lipcon,2014-10-03 16:42:38-07:00,['4612fbc917dab58e462ad4880041be785f103989'],4,2,6,466278,2,1,0,0.5,1172
bb22af8258b532ad4c72a44a81cc98b673977875,0,Todd Lipcon,2014-10-03 16:45:18-07:00,['92727b0fa0b897632fc68bfa606058e3e3e5de48'],11,117,128,466406,5,0.088235294,0.426470588,0.882352941,1172
273c89def7b4abf8e60e5c690de41cde9970c2f3,0,David Alves,2014-10-03 21:13:13-07:00,['bb22af8258b532ad4c72a44a81cc98b673977875'],1,2,3,466409,1,1,1,1,1172
c563ac8a50f0331298176bbbf862af0868bc7a2a,0,David Alves,2014-10-03 21:16:28-07:00,['273c89def7b4abf8e60e5c690de41cde9970c2f3'],12,22,34,466443,1,,,,1172
83dc951d5daf18e452fd94e896f80c56358772ef,0,Michael Percy,2014-10-06 10:37:11-07:00,['c563ac8a50f0331298176bbbf862af0868bc7a2a'],1,7,8,466451,2,0.6,1,0.6,1172
4d8ab80c662111bff9180f016c2be37e46aa5f47,0,Michael Percy,2014-10-06 10:38:30-07:00,['83dc951d5daf18e452fd94e896f80c56358772ef'],10,12,22,466473,7,1,1,1,1172
98df7acacb03e1e0e7b7f7ae15c3b33e5ef70831,1,Jean-Daniel Cryans,2014-10-06 11:18:55-07:00,['4d8ab80c662111bff9180f016c2be37e46aa5f47'],2,108,110,466583,5,0,0.810344828,1,1172
e6726e5b7688e56dcad305d99a015130502de936,1,Todd Lipcon,2014-10-06 11:31:18-07:00,['98df7acacb03e1e0e7b7f7ae15c3b33e5ef70831'],0,7,7,466590,2,1,1,1,1172
8fb92ead68c99c7700fa5463279c7ea8bdb752a8,0,Todd Lipcon,2014-10-06 12:39:36-07:00,['e6726e5b7688e56dcad305d99a015130502de936'],1,3,4,466594,1,,,,1172
e692e9a69b986027a3badc6fc83eb413538a66f7,1,Todd Lipcon,2014-10-06 12:40:48-07:00,['8fb92ead68c99c7700fa5463279c7ea8bdb752a8'],28,29,57,466651,2,1,1,1,1172
dd27fa549f30edf049d776e7988ee3a40d521262,0,Todd Lipcon,2014-10-06 14:07:03-07:00,['e692e9a69b986027a3badc6fc83eb413538a66f7'],34,35,69,466720,6,,,,1172
7fedb5db8f29b572e0d532f9760006cfc35e8e6a,1,Jean-Daniel Cryans,2014-10-06 15:48:48-07:00,['dd27fa549f30edf049d776e7988ee3a40d521262'],5,20,25,466745,3,1,1,1,1172
3e985b847e3a80cc0b64394d1016dc47c11cbafb,0,Jean-Daniel Cryans,2014-10-06 15:58:08-07:00,['7fedb5db8f29b572e0d532f9760006cfc35e8e6a'],1,1,2,466747,1,,,,1172
2206fd8870c4129688034bc80aa64850fb22020d,0,Todd Lipcon,2014-10-06 23:20:20-07:00,['3e985b847e3a80cc0b64394d1016dc47c11cbafb'],0,266,266,467013,2,,,,1174
63060402e4ea52024ae7d23dbcb070b65907cb31,0,David Alves,2014-10-07 14:02:27-07:00,['2206fd8870c4129688034bc80aa64850fb22020d'],0,1,1,467014,1,,,,1174
9fcf2fab720139131648448f5d009eaa07f177b5,0,David Alves,2014-10-07 16:40:10-07:00,['63060402e4ea52024ae7d23dbcb070b65907cb31'],30,34,64,467078,1,1,1,0,1174
fdb36624e45e988cb5d30a290ecdf2455c209dee,0,David Alves,2014-10-07 18:21:59-07:00,['9fcf2fab720139131648448f5d009eaa07f177b5'],7,34,41,467119,3,0,1,0.857142857,1174
8204dbd0b25a002243b1a33e92607dfdba410123,1,Alex Feinberg,2014-10-07 23:55:08-07:00,['fdb36624e45e988cb5d30a290ecdf2455c209dee'],19,71,90,467209,13,0.384615385,0.923076923,0.038461538,1174
403bad498b611f53842a230625f2fac75ab3b75a,0,Jean-Daniel Cryans,2014-10-08 09:49:36-07:00,['8204dbd0b25a002243b1a33e92607dfdba410123'],17,29,46,467255,1,0,0.666666667,1,1174
380594569fe14bd16a53342c775c282dace97cfb,1,David Alves,2014-10-08 15:35:35-07:00,['403bad498b611f53842a230625f2fac75ab3b75a'],57,92,149,467404,3,0,0.708333333,0,1174
83e497458c4807815e742f903b30c44d054fcc80,1,David Alves,2014-10-08 16:05:02-07:00,['380594569fe14bd16a53342c775c282dace97cfb'],5,133,138,467542,3,0.12987013,1,0.961038961,1174
8818cec80905f3052067ce9ddf56e22a78a3b5aa,1,David Alves,2014-10-08 16:25:54-07:00,['83e497458c4807815e742f903b30c44d054fcc80'],162,85,247,467789,2,0.75,1,0.145833333,1174
b6a807509e78e0603801721b8fc6b40b6e27eb8e,0,David Alves,2014-10-08 16:30:48-07:00,['8818cec80905f3052067ce9ddf56e22a78a3b5aa'],30,0,30,467819,2,0,0,0,1174
b214e0e9f0b742d128ac94ff538c319bdd9a21d1,1,Michael Percy,2014-10-08 16:40:37-07:00,['b6a807509e78e0603801721b8fc6b40b6e27eb8e'],2,9,11,467830,3,0.5,1,1,1174
9c099f41ac9bb8b713d9d7738d3102f9b3560ec6,0,David Alves,2014-10-08 17:03:46-07:00,['b214e0e9f0b742d128ac94ff538c319bdd9a21d1'],50,92,142,467972,9,,,,1176
0bfb937f829cb2bf099b7de08ba37bec3711c4f8,0,David Alves,2014-10-08 17:33:19-07:00,['9c099f41ac9bb8b713d9d7738d3102f9b3560ec6'],7,108,115,468087,6,0.034482759,0.672413793,1,1176
aa636991709f7f0380b63acefe9dd9f179c8131c,1,Todd Lipcon,2014-10-08 17:58:31-07:00,['0bfb937f829cb2bf099b7de08ba37bec3711c4f8'],11,250,261,468348,7,0.184615385,1,0.669230769,1176
e75c5b1661e6be7a9c3c7db045c75c5303244255,1,Jean-Daniel Cryans,2014-10-09 10:03:24-07:00,['aa636991709f7f0380b63acefe9dd9f179c8131c'],3,103,106,468454,8,0.692307692,0.948717949,1,1176
794a8d2b62b9a3770f98e03861da6f77422b1c5d,0,Adar Dembo,2014-10-09 17:24:44-07:00,['e75c5b1661e6be7a9c3c7db045c75c5303244255'],0,30,30,468484,2,1,1,1,1176
ef34a936e95b803dc391e84174b246387b7b11fd,0,Todd Lipcon,2014-10-09 17:25:38-07:00,['794a8d2b62b9a3770f98e03861da6f77422b1c5d'],142,65,207,468691,8,0.342105263,0,0,1176
f453a2cfc5414bfda4edb9bbe13d77d60eed4dba,1,Adar Dembo,2014-10-09 18:05:20-07:00,['ef34a936e95b803dc391e84174b246387b7b11fd'],94,13,107,468798,1,1,0.736842105,0.736842105,1176
dbcdcba6e3a50798dbefdb6287257ef9ace5b6ab,1,Adar Dembo,2014-10-09 18:05:26-07:00,['f453a2cfc5414bfda4edb9bbe13d77d60eed4dba'],6,130,136,468934,4,0.474358974,1,0.705128205,1176
4ad0e29bd9493bb9f9a4fa6ee1ba7ce0f3eb5d2f,0,Adar Dembo,2014-10-09 18:59:46-07:00,['dbcdcba6e3a50798dbefdb6287257ef9ace5b6ab'],0,9,9,468943,1,,,,1176
e1974b31efde2bed07b5a00d0f6a8d4871ea5bcf,1,Adar Dembo,2014-10-09 19:01:11-07:00,['4ad0e29bd9493bb9f9a4fa6ee1ba7ce0f3eb5d2f'],66,106,172,469115,4,0,1,0.875,1176
09c1e28550ce7b1a6eb0040c4e9ac04b8b0b3253,0,Adar Dembo,2014-10-09 19:11:32-07:00,['e1974b31efde2bed07b5a00d0f6a8d4871ea5bcf'],0,9,9,469124,1,,,,1176
f86dac7846ee3fcb4db088729a86b21a2a622a7c,1,Jean-Daniel Cryans,2014-10-09 20:14:58-07:00,['09c1e28550ce7b1a6eb0040c4e9ac04b8b0b3253'],88,73,161,469285,6,0.909090909,0,1,1176
51d1c694a8aaa3dc00771ea91dad99add32fa409,1,Jean-Daniel Cryans,2014-10-09 20:16:30-07:00,['f86dac7846ee3fcb4db088729a86b21a2a622a7c'],11,33,44,469329,5,0,0.933333333,1,1176
cd26954e25b8033815dc86b6494477be95b6f399,1,Adar Dembo,2014-10-09 21:43:19-07:00,['51d1c694a8aaa3dc00771ea91dad99add32fa409'],40,102,142,469471,6,0.28,0.8,1,1176
063b7dc7e2e8556554a1bf89c374b9770db77a0c,0,David Alves,2014-10-09 22:00:27-07:00,['cd26954e25b8033815dc86b6494477be95b6f399'],4,5,9,469480,1,0,1,1,1176
4f91bed516c6a20aa80688749f0af74a496c662f,1,Michael Percy,2014-10-10 07:51:06-07:00,['063b7dc7e2e8556554a1bf89c374b9770db77a0c'],55,478,533,470013,6,0.4453125,0.87109375,0.921875,1176
6b333701bd0df9e4cc14f18de174e8b97fc23d36,1,Jean-Daniel Cryans,2014-10-10 08:39:55-07:00,['4f91bed516c6a20aa80688749f0af74a496c662f'],2,135,137,470150,12,0.885714286,0.885714286,0.942857143,1178
1886f6e15cabcd0ea7c2ca13314f75ce43d102f8,1,David Alves,2014-10-10 13:36:06-07:00,['6b333701bd0df9e4cc14f18de174e8b97fc23d36'],141,198,339,470489,10,1,0,0.5,1178
d10d770ab41e8440e2f232b2469d89d3e71a1afd,1,Todd Lipcon,2014-10-10 15:36:21-07:00,['1886f6e15cabcd0ea7c2ca13314f75ce43d102f8'],479,362,841,471330,25,1,0.585365854,0.609756098,1178
f198a1cb39e32df22a426af2d45c9bcd89534389,0,Michael Percy,2014-10-10 17:20:27-07:00,['d10d770ab41e8440e2f232b2469d89d3e71a1afd'],0,26,26,471356,1,1,1,0,1178
7b284f2eec36af32b298abcd9f457ae9393664db,0,Michael Percy,2014-10-10 17:20:46-07:00,['f198a1cb39e32df22a426af2d45c9bcd89534389'],0,358,358,471714,4,0.263736264,0.824175824,0.796703297,1181
2f6630ec1e17e2daf5c4bcf7a4f92dd75fe4408c,0,David Alves,2014-10-10 19:04:13-07:00,['7b284f2eec36af32b298abcd9f457ae9393664db'],51,56,107,471821,5,1,1,0,1181
5d78fc7a2938d6bb2e46ded7c61f3ab5c76c2a4d,0,David Alves,2014-10-11 16:34:05-07:00,['2f6630ec1e17e2daf5c4bcf7a4f92dd75fe4408c'],0,10,10,471831,2,0,0.125,0.875,1181
b4c38168400d3b8e3133150c7786b3b0c15f4432,0,Todd Lipcon,2014-10-11 17:58:56-07:00,['5d78fc7a2938d6bb2e46ded7c61f3ab5c76c2a4d'],51,71,122,471953,5,1,1,0,1181
0fd17e7c44e9379271dcb0c94b2086ecf0d74347,0,Michael Percy,2014-10-12 02:47:48-07:00,['b4c38168400d3b8e3133150c7786b3b0c15f4432'],13,15,28,471981,3,,,,1181
9da91c6144644d63f9b858728500a9981111c439,0,David Alves,2014-10-12 13:40:43-07:00,['0fd17e7c44e9379271dcb0c94b2086ecf0d74347'],3,4,7,471988,1,0,1,1,1181
91413aa0b70e0464e640091e128f9c3890029e8e,0,David Alves,2014-10-13 01:00:23-07:00,['9da91c6144644d63f9b858728500a9981111c439'],6,0,6,471994,1,1,1,0,1181
0cd1459bbe1e4c530f8503a452bbb9ef4b8076cd,0,David Alves,2014-10-13 10:57:02-07:00,['91413aa0b70e0464e640091e128f9c3890029e8e'],12,118,130,472124,4,0.275862069,0.275862069,0.982758621,1181
324e0ff894420bea69fb439886eb4074fff4a117,0,Todd Lipcon,2014-10-13 11:06:27-07:00,['0cd1459bbe1e4c530f8503a452bbb9ef4b8076cd'],6,1,7,472131,2,0,0,1,1181
3d7f28b7f4ea3a072facb1569495ceed016984e2,0,David Alves,2014-10-13 11:47:41-07:00,['324e0ff894420bea69fb439886eb4074fff4a117'],11,19,30,472161,5,1,1,1,1181
f777b460d4028f184b55ed88f8c26e9eb6b689c4,0,David Alves,2014-10-13 12:00:22-07:00,['3d7f28b7f4ea3a072facb1569495ceed016984e2'],17,28,45,472206,5,1,0.25,1,1181
d60ae61702defd6fbb1b14448b48eaa8b0898a8e,0,David Alves,2014-10-13 12:00:28-07:00,['f777b460d4028f184b55ed88f8c26e9eb6b689c4'],25,47,72,472278,4,0.466666667,0.666666667,0.533333333,1181
3d00ec506739ad3f40b3498a60a5f36dc2401f9d,1,Todd Lipcon,2014-10-13 16:24:05-07:00,['d60ae61702defd6fbb1b14448b48eaa8b0898a8e'],652,351,1003,473281,9,0.105263158,0,0.278195489,1181
40dfa377d419af909fc12c9014c7809d2062ca37,1,Michael Percy,2014-10-13 17:47:26-07:00,['3d00ec506739ad3f40b3498a60a5f36dc2401f9d'],268,255,523,473804,7,0.769230769,1,0,1181
d07733056186a7a616b1ef7c2bbc45ba2374bf88,0,Todd Lipcon,2014-10-14 12:06:23-07:00,['40dfa377d419af909fc12c9014c7809d2062ca37'],1,1,2,473806,1,,,,1181
1bcb20d787a8965f38ac251a38231078b38cef86,0,Todd Lipcon,2014-10-15 12:00:31-07:00,['d07733056186a7a616b1ef7c2bbc45ba2374bf88'],13,7,20,473826,2,0.333333333,0,0.333333333,1181
d34454c675eda764239e97b4b26edf6b99027222,0,Todd Lipcon,2014-10-16 12:13:31-07:00,['1bcb20d787a8965f38ac251a38231078b38cef86'],14,20,34,473860,1,1,1,1,1181
e3719f58164fb637524aff12db147dda979c5c0e,0,Todd Lipcon,2014-10-16 12:15:28-07:00,['d34454c675eda764239e97b4b26edf6b99027222'],3,2,5,473865,1,,,,1181
7742d7831b39ec0e2a688f049fa3d5632953e831,0,David Alves,2014-10-16 21:27:10-07:00,['e3719f58164fb637524aff12db147dda979c5c0e'],0,10,10,473875,2,1,1,1,1181
603c457fa5390c26da9d7aa4d0b34b676b746ee4,1,David Alves,2014-10-16 23:21:31-07:00,['7742d7831b39ec0e2a688f049fa3d5632953e831'],91,180,271,474146,7,0.061538462,0.384615385,0.507692308,1181
ee67081efbbc191bea7994415b538f793a7211aa,1,Todd Lipcon,2014-10-17 07:45:06-07:00,['603c457fa5390c26da9d7aa4d0b34b676b746ee4'],1,1,2,474148,1,,,,1181
118911016e64f4ed1e14e4a20e992f9acacdc31a,0,Todd Lipcon,2014-10-17 07:46:17-07:00,['ee67081efbbc191bea7994415b538f793a7211aa'],1,1,2,474150,1,,,,1181
9868ad0aa388cbd016941178da55ba516155e4bb,0,David Alves,2014-10-17 10:35:28-07:00,['118911016e64f4ed1e14e4a20e992f9acacdc31a'],0,9,9,474159,1,,,,1181
e4a429259987a00ff95240dfb196fa57afb0c04b,1,David Alves,2014-10-17 14:04:58-07:00,['9868ad0aa388cbd016941178da55ba516155e4bb'],18,30,48,474207,2,1,1,1,1181
093b3e796f052a5cd711ca0335ca43573f1a6167,0,David Alves,2014-10-17 15:50:09-07:00,['e4a429259987a00ff95240dfb196fa57afb0c04b'],2,19,21,474228,2,0,0,1,1181
01444896afc2ab058d15e3687f3b8eaab9c44264,1,David Alves,2014-10-17 15:56:11-07:00,['093b3e796f052a5cd711ca0335ca43573f1a6167'],24,41,65,474293,5,0,1,1,1181
9f5e3a9fa62b020862752a76303820aeddeea344,0,Todd Lipcon,2014-10-18 17:00:45-07:00,['01444896afc2ab058d15e3687f3b8eaab9c44264'],15,53,68,474361,1,1,1,0.842105263,1181
991ae94d9f69e0644e30ca5804e21148657865b8,1,David Alves,2014-10-18 17:45:05-07:00,['9f5e3a9fa62b020862752a76303820aeddeea344'],189,193,382,474743,9,0,1,1,1181
4ad6c906928af7fe3a167c558ce42109ec7e9e41,1,David Alves,2014-10-18 17:45:11-07:00,['991ae94d9f69e0644e30ca5804e21148657865b8'],574,417,991,475734,9,0,0.634146341,0,1181
801e1f10abd0acd9e668d44b7179886b2fa2ac3d,1,David Alves,2014-10-18 18:38:07-07:00,['4ad6c906928af7fe3a167c558ce42109ec7e9e41'],6,76,82,475816,5,0.302325581,1,0.860465116,1181
282b6920623077071eadcf50a4d3f2f8df82b751,1,David Alves,2014-10-18 18:38:13-07:00,['801e1f10abd0acd9e668d44b7179886b2fa2ac3d'],17,65,82,475898,4,0.36,1,0.96,1181
049ccc8f43c5f7f4010dff0e320b69dd9367429a,0,Michael Percy,2014-10-20 14:31:05-07:00,['282b6920623077071eadcf50a4d3f2f8df82b751'],17,64,81,475979,5,0.358974359,0.615384615,1,1181
cf0d0cbb66d281da9a0531563559a24dcba48f01,0,Michael Percy,2014-10-20 14:31:20-07:00,['049ccc8f43c5f7f4010dff0e320b69dd9367429a'],48,52,100,476079,1,0,1,1,1181
b2463cced12f2f8cda9c72876b9c18aa0557ae8e,1,Michael Percy,2014-10-20 14:47:01-07:00,['cf0d0cbb66d281da9a0531563559a24dcba48f01'],69,297,366,476445,4,0.649681529,1,0.50955414,1181
9267e3a576aacd21c8ba5b9c91a0a0a37497ee0f,1,David Alves,2014-10-20 15:56:19-07:00,['b2463cced12f2f8cda9c72876b9c18aa0557ae8e'],5,28,33,476478,5,1,0.875,1,1181
4616b66485d16fcf6cc4dead583edde3e4a69d1a,0,Todd Lipcon,2014-10-21 00:28:45-07:00,['9267e3a576aacd21c8ba5b9c91a0a0a37497ee0f'],2,4,6,476484,2,1,1,1,1181
85080efd4ec6f940b7d3750119f974c47dac8d5c,0,Todd Lipcon,2014-10-21 00:33:45-07:00,['4616b66485d16fcf6cc4dead583edde3e4a69d1a'],1,4,5,476489,1,,,,1181
b6bc72f2547986d4489c044b525b5667113064e3,0,Todd Lipcon,2014-10-21 00:52:19-07:00,['85080efd4ec6f940b7d3750119f974c47dac8d5c'],1,1,2,476491,1,,,,1181
d0565dc8bbdf33f1e2e26ee2fcc23bc3e8f0aa96,1,Michael Percy,2014-10-21 01:40:03-07:00,['b6bc72f2547986d4489c044b525b5667113064e3'],56,55,111,476602,1,0,0,0,1181
9a73e9b73ad70a95d17990137106b3a1417e4e4c,0,Todd Lipcon,2014-10-21 02:38:44-07:00,['d0565dc8bbdf33f1e2e26ee2fcc23bc3e8f0aa96'],8,11,19,476621,1,,,,1181
3db8d3d10e952c8e1528abe2a002ddb14cc40a50,1,Todd Lipcon,2014-10-21 02:38:51-07:00,['9a73e9b73ad70a95d17990137106b3a1417e4e4c'],48,734,782,477403,5,0.448753463,0.939058172,0.781163435,1181
b070bbbdcfc3239a3cb5736861e75475ae144759,0,Adar Dembo,2014-10-21 14:44:30-07:00,['3db8d3d10e952c8e1528abe2a002ddb14cc40a50'],1,1,2,477405,1,,,,1181
6a27fa66ead8b485b963689ec43225208b783e36,0,Alex Feinberg,2014-10-21 16:20:42-07:00,['b070bbbdcfc3239a3cb5736861e75475ae144759'],1,77,78,477483,4,0.769230769,0.884615385,0.057692308,1181
564cc7e5273de16540f428eb691c4f3c0b3cddf4,0,David Alves,2014-10-21 18:45:11-07:00,['6a27fa66ead8b485b963689ec43225208b783e36'],1,354,355,477838,6,0.23030303,0.727272727,0.363636364,1184
a417e3fa62e499804922b23870faa3a9bcca86a5,0,Todd Lipcon,2014-10-21 22:12:38-07:00,['564cc7e5273de16540f428eb691c4f3c0b3cddf4'],85,25,110,477948,1,0.051282051,0,0.564102564,1184
64ba701e8932e067d41396e075486bafc88431de,0,Todd Lipcon,2014-10-21 22:13:49-07:00,['a417e3fa62e499804922b23870faa3a9bcca86a5'],14,28,42,477990,3,0,0,0.142857143,1184
da2d7c4382fee4afd6fd7ce66b7ddfaa1b03aa9f,1,Todd Lipcon,2014-10-21 22:15:51-07:00,['64ba701e8932e067d41396e075486bafc88431de'],42,19,61,478051,4,0,0,0,1184
f536675ff12a53ce6952a391f7172f10243db0e9,1,David Alves,2014-10-22 02:36:30-07:00,['da2d7c4382fee4afd6fd7ce66b7ddfaa1b03aa9f'],94,276,370,478421,8,0.363636364,0.96969697,1,1184
5a733c1ee75ff00988fee1102a05ffcae49a706c,0,Michael Percy,2014-10-22 12:48:30-07:00,['f536675ff12a53ce6952a391f7172f10243db0e9'],6,6,12,478433,3,,,,1184
70e6993a36582fc66fdcc23809779ac1bed02345,1,Todd Lipcon,2014-10-22 13:32:55-07:00,['5a733c1ee75ff00988fee1102a05ffcae49a706c'],2,26,28,478461,4,0,1,1,1184
f3fbf43b776b6bbee5a9db34b813ed567836de6d,0,Todd Lipcon,2014-10-22 14:46:59-07:00,['70e6993a36582fc66fdcc23809779ac1bed02345'],6,12,18,478479,1,0,0,1,1184
bf3bec896995e96f99f6ee17751a50e24b4bbaf9,0,Michael Percy,2014-10-22 17:28:13-07:00,['f3fbf43b776b6bbee5a9db34b813ed567836de6d'],14,16,30,478509,3,,,,1184
fc707ff2c643dc1d2d5949cf1d92669a60e87142,1,Todd Lipcon,2014-10-23 14:00:05-07:00,['bf3bec896995e96f99f6ee17751a50e24b4bbaf9'],122,47,169,478678,8,0.032258065,0,0,1184
a3116acf400947b3118097d3343b3f0c42bda26b,0,Michael Percy,2014-10-23 14:04:48-07:00,['fc707ff2c643dc1d2d5949cf1d92669a60e87142'],0,456,456,479134,4,0.653631285,1,0.910614525,1187
832a35ceee1a5198975d6bb22ab3691c81c337ac,0,Todd Lipcon,2014-10-24 11:49:07-07:00,['a3116acf400947b3118097d3343b3f0c42bda26b'],2,4,6,479140,1,,,,1187
aea7590f6912dea7086ca0c47f2375d6f2afbb99,0,Todd Lipcon,2014-10-24 11:53:09-07:00,['832a35ceee1a5198975d6bb22ab3691c81c337ac'],12,12,24,479164,2,,,,1187
d2770958804df02b2634e9fe1588fcda32826bc6,0,David Alves,2014-10-24 12:42:11-07:00,['aea7590f6912dea7086ca0c47f2375d6f2afbb99'],2,2,4,479168,2,,,,1187
7e7e5764125578222e43f3dbe00963a75d73d0fa,0,Jean-Daniel Cryans,2014-10-24 16:24:29-07:00,['d2770958804df02b2634e9fe1588fcda32826bc6'],26,45,71,479239,3,0.111111111,1,0,1187
512c94616574d13435934a6aa60bd1033bc5f2cf,1,David Alves,2014-10-24 16:57:59-07:00,['7e7e5764125578222e43f3dbe00963a75d73d0fa'],76,249,325,479564,7,0.192982456,0.666666667,1,1187
e5ab10df1cadda3ff2b4f3d89ea2243e90448da7,0,David Alves,2014-10-24 17:24:41-07:00,['512c94616574d13435934a6aa60bd1033bc5f2cf'],20,115,135,479699,7,,,,1188
995c5e57067d7c89a8613df366c9a9e996cdff5b,1,Todd Lipcon,2014-10-24 17:40:00-07:00,['e5ab10df1cadda3ff2b4f3d89ea2243e90448da7'],0,20,20,479719,2,0.5,1,1,1188
bb5ea036620c6e1e6dbfc4d1389005eff4d36e22,1,Adar Dembo,2014-10-24 21:25:12-07:00,['995c5e57067d7c89a8613df366c9a9e996cdff5b'],149,198,347,480066,18,1,1,1,1189
9036ea591400b8756f6caae6bff3dbfe14ffc38a,0,Adar Dembo,2014-10-24 21:26:36-07:00,['bb5ea036620c6e1e6dbfc4d1389005eff4d36e22'],983,32,1015,481081,31,0.255555556,0,0.011111111,1189
0f88d68917437968c3f2aa7a41d4ff05ace1266c,1,Jean-Daniel Cryans,2014-10-27 09:49:36-07:00,['9036ea591400b8756f6caae6bff3dbfe14ffc38a'],70,81,151,481232,11,0,0,0,1189
7a2e1cffa58b4202fba3495f9d4f810fcf374e43,1,Michael Percy,2014-10-27 11:56:53-07:00,['0f88d68917437968c3f2aa7a41d4ff05ace1266c'],2,2,4,481236,1,,,,1189
ed19f0617c0fe6a925a8b8a3000c99495582e45e,1,Alex Feinberg,2014-10-27 12:45:25-07:00,['7a2e1cffa58b4202fba3495f9d4f810fcf374e43'],34,327,361,481597,8,0.704819277,0.722891566,0.969879518,1189
d9409d0bee9e895c7c76771b1334ae2bfd94d6e7,0,David Alves,2014-10-27 13:31:27-07:00,['ed19f0617c0fe6a925a8b8a3000c99495582e45e'],0,5,5,481602,1,,,,1189
c904ebc595376fe60a52931c1da9f2496aa7965b,0,Todd Lipcon,2014-10-27 14:20:51-07:00,['d9409d0bee9e895c7c76771b1334ae2bfd94d6e7'],0,6,6,481608,1,,,,1189
1c7ba0dbe59e456d093a4fb3474724104f2f5838,0,Todd Lipcon,2014-10-27 14:22:02-07:00,['c904ebc595376fe60a52931c1da9f2496aa7965b'],2,9,11,481619,2,1,1,1,1189
76ce98f7438a1685d400376f0af9c5746fac29c8,1,Todd Lipcon,2014-10-27 14:24:37-07:00,['1c7ba0dbe59e456d093a4fb3474724104f2f5838'],62,70,132,481751,8,0,1,1,1189
abb2324bad60e450093f08ec8c3e8075452e3eb4,0,Todd Lipcon,2014-10-27 14:27:32-07:00,['76ce98f7438a1685d400376f0af9c5746fac29c8'],16,26,42,481793,2,1,1,1,1189
0e809b57bb8e202c7bbeec10ebf01fd41d4e7754,0,Alex Feinberg,2014-10-27 14:27:41-07:00,['abb2324bad60e450093f08ec8c3e8075452e3eb4'],2,8,10,481803,1,0,1,1,1189
1cd93efcf8749b78da7a0b3808dfff19a5da702e,0,David Alves,2014-10-27 14:51:59-07:00,['0e809b57bb8e202c7bbeec10ebf01fd41d4e7754'],6,11,17,481820,1,1,1,1,1189
b704be5c820abb6a035094b3492840ae84304e73,0,David Alves,2014-10-27 16:53:32-07:00,['1cd93efcf8749b78da7a0b3808dfff19a5da702e'],24,22,46,481866,2,1,0,0,1189
417491c3d090174e4c2c16b40248da7fcc86c1e8,1,David Alves,2014-10-27 19:28:17-07:00,['b704be5c820abb6a035094b3492840ae84304e73'],92,171,263,482129,6,0.305555556,1,0.472222222,1189
4ed542c993a0b063bbf086f5549a5210309c5ee5,0,David Alves,2014-10-27 20:01:35-07:00,['417491c3d090174e4c2c16b40248da7fcc86c1e8'],2,35,37,482166,2,0.789473684,1,1,1189
c3794e42101b74aa12fcffb75bf18e258bbad821,1,Todd Lipcon,2014-10-28 20:49:46-07:00,['4ed542c993a0b063bbf086f5549a5210309c5ee5'],57,37,94,482260,2,1,0,0,1189
899bde406ef16e84b930c7232ba9b25e7fab44f6,0,Todd Lipcon,2014-10-29 09:17:01-07:00,['c3794e42101b74aa12fcffb75bf18e258bbad821'],179,110,289,482549,11,0,0,0,1189
3f9fdce6083ccdf5e0df8f780b5aef8f56fc935c,1,Adar Dembo,2014-10-29 11:48:24-07:00,['899bde406ef16e84b930c7232ba9b25e7fab44f6'],61,203,264,482813,6,0,0.5,0.761363636,1189
4d66bf7c20539711632fa56419ec11615daf1d90,1,Jean-Daniel Cryans,2014-10-29 14:00:33-07:00,['3f9fdce6083ccdf5e0df8f780b5aef8f56fc935c'],50,112,162,482975,5,1,1,1,1189
e7c92d911e263e84d30dad2329b698ba066e892a,0,Todd Lipcon,2014-10-29 17:19:07-07:00,['4d66bf7c20539711632fa56419ec11615daf1d90'],1,1,2,482977,1,,,,1189
0757a5f0e1b2aee3ae5f7ff58b662d13bc6d9eed,0,Todd Lipcon,2014-10-29 17:34:59-07:00,['e7c92d911e263e84d30dad2329b698ba066e892a'],0,13,13,482990,3,0.555555556,0.555555556,0.555555556,1189
2d3965fc523c042f4284b46829ecffd85e1abd65,1,Todd Lipcon,2014-10-30 00:46:30-07:00,['0757a5f0e1b2aee3ae5f7ff58b662d13bc6d9eed'],0,36,36,483026,3,0.769230769,1,1,1189
c5a3e2722f2f173239ccf2d6247216c916035547,0,Todd Lipcon,2014-10-30 00:47:02-07:00,['2d3965fc523c042f4284b46829ecffd85e1abd65'],0,3,3,483029,1,0,1,0,1189
a6e5cd8b62e0ee47b238dea592605174db8f1c8e,0,Todd Lipcon,2014-10-30 00:55:56-07:00,['c5a3e2722f2f173239ccf2d6247216c916035547'],0,1,1,483030,1,,,,1189
a7f63c030e52229f68271af4d92a8e0ac5eda216,0,Todd Lipcon,2014-10-30 01:03:36-07:00,['a6e5cd8b62e0ee47b238dea592605174db8f1c8e'],0,18,18,483048,2,1,1,1,1189
e3110619c5cb1c416431d76156a28d3f8259d186,0,David Alves,2014-10-30 01:18:48-07:00,['a7f63c030e52229f68271af4d92a8e0ac5eda216'],0,4,4,483052,1,1,1,1,1189
e477f0ec73b49d21aa39287a190196929467c528,0,Jean-Daniel Cryans,2014-10-30 09:20:51-07:00,['e3110619c5cb1c416431d76156a28d3f8259d186'],48,61,109,483161,2,,,,1189
e280f6b4222165e546773dd2a79d503af7799c3b,0,Todd Lipcon,2014-10-30 09:53:58-07:00,['e477f0ec73b49d21aa39287a190196929467c528'],4,4,8,483169,1,,,,1189
3d5f74ca85f94f27f28cb09fd98418c4d9b49900,0,Todd Lipcon,2014-10-30 12:31:45-07:00,['e280f6b4222165e546773dd2a79d503af7799c3b'],17,966,983,484152,893,0,1,0,1189
d5a2007e38d23f0cb7127d89d1b6422bdaea67c4,0,Todd Lipcon,2014-10-30 13:27:49-07:00,['3d5f74ca85f94f27f28cb09fd98418c4d9b49900'],14,20,34,484186,5,1,1,1,1189
7b7e6f48df0a8808d8dd5a3ea6186e9c850d69bd,0,Todd Lipcon,2014-10-30 13:27:52-07:00,['d5a2007e38d23f0cb7127d89d1b6422bdaea67c4'],4,34,38,484224,1,0,1,0.142857143,1189
b5398b6357a2e16ffad5f89a690a1b8c40d560c2,0,David Alves,2014-10-30 14:27:06-07:00,['7b7e6f48df0a8808d8dd5a3ea6186e9c850d69bd'],1,1,2,484226,1,,,,1189
bb83549d62d512cf573b9a94cdb4fc958ab94ab0,0,Todd Lipcon,2014-10-30 15:48:47-07:00,['b5398b6357a2e16ffad5f89a690a1b8c40d560c2'],4,61,65,484291,3,1,1,1,1190
fcc45e6a3018c504b781f6c3aed8eb6dab3933a5,1,Todd Lipcon,2014-10-30 20:44:45-07:00,['bb83549d62d512cf573b9a94cdb4fc958ab94ab0'],1,28,29,484320,3,1,1,1,1190
253fd1e36672e3b4414deaa4f37e12e435f048f6,1,Todd Lipcon,2014-10-30 21:01:23-07:00,['fcc45e6a3018c504b781f6c3aed8eb6dab3933a5'],0,55,55,484375,6,0.233333333,1,0.233333333,1190
2589f630ee65a6da3edc349473a7fce3736e7baf,0,Todd Lipcon,2014-10-30 21:15:17-07:00,['253fd1e36672e3b4414deaa4f37e12e435f048f6'],6,7,13,484388,1,1,1,1,1190
2146b53203bc39c205f3a2731932546f22e4c78c,1,David Alves,2014-10-30 21:48:15-07:00,['2589f630ee65a6da3edc349473a7fce3736e7baf'],140,150,290,484678,2,0,1,0.157894737,1190
ac170f037e50e5de6f1d6a37a653c3362d051987,1,Todd Lipcon,2014-10-31 09:50:14-07:00,['2146b53203bc39c205f3a2731932546f22e4c78c'],122,91,213,484891,14,1,0,0,1190
f641c23ca862a20f2f54d14b3e4b8e926e0339c9,0,David Alves,2014-10-31 13:17:33-07:00,['ac170f037e50e5de6f1d6a37a653c3362d051987'],1,0,1,484892,1,1,0,0,1190
0a340a150361508f90e84060d11d2763d1c63a69,1,David Alves,2014-10-31 13:54:28-07:00,['f641c23ca862a20f2f54d14b3e4b8e926e0339c9'],1,114,115,485007,2,0,1,1,1190
fe761b82c4a938e24cd1ca2bf4dc8c63c9209904,1,David Alves,2014-10-31 16:35:26-07:00,['0a340a150361508f90e84060d11d2763d1c63a69'],64,423,487,485494,11,0.346733668,0.939698492,0.994974874,1191
aeafb5da348648a74f105ee03147f0382185f6f5,0,Todd Lipcon,2014-11-02 15:17:36-08:00,['fe761b82c4a938e24cd1ca2bf4dc8c63c9209904'],6,10,16,485510,1,,,,1191
0a5f274f89e7445dfb25dccc9d93f9aa7d18b00e,1,Todd Lipcon,2014-11-02 18:08:38-08:00,['aeafb5da348648a74f105ee03147f0382185f6f5'],100,206,306,485816,15,0.119402985,1,1,1191
e9d51d8eea297bd4e27111cd41120b203226e695,1,David Alves,2014-11-02 20:18:06-08:00,['0a5f274f89e7445dfb25dccc9d93f9aa7d18b00e'],1,13,14,485830,1,0,0,0,1191
4484a83741e955be2c304133a54983220d1defb3,0,David Alves,2014-11-02 20:27:57-08:00,['e9d51d8eea297bd4e27111cd41120b203226e695'],26,32,58,485888,5,0.333333333,1,1,1191
d73314a6ba9d23efc9152d7aee47eb66147abbd7,0,Michael Percy,2014-11-03 11:41:47-08:00,['4484a83741e955be2c304133a54983220d1defb3'],208,195,403,486291,3,0,0,0,1191
1f970e98a5eb04227981d4119ee53749fa454076,0,Michael Percy,2014-11-03 11:43:02-08:00,['d73314a6ba9d23efc9152d7aee47eb66147abbd7'],0,12,12,486303,2,1,1,1,1191
bb85b0ce0de43d357eea2f505c7438866c83c0fa,1,David Alves,2014-11-03 13:28:10-08:00,['1f970e98a5eb04227981d4119ee53749fa454076'],623,908,1531,487834,11,1,1,0,1194
300cba2152bfcfa5884c3e23ae45be86a495c76f,1,David Alves,2014-11-03 14:23:46-08:00,['bb85b0ce0de43d357eea2f505c7438866c83c0fa'],15,12,27,487861,3,0,0,0,1194
87f9699828c7e50bf65ec0f12a6ef8c885941035,0,Todd Lipcon,2014-11-03 14:51:11-08:00,['300cba2152bfcfa5884c3e23ae45be86a495c76f'],0,4,4,487865,1,1,1,1,1194
5046194727fde57db21a14a91894016fbe865db3,0,Todd Lipcon,2014-11-03 15:00:41-08:00,['87f9699828c7e50bf65ec0f12a6ef8c885941035'],0,16,16,487881,2,1,1,1,1194
fd0a5e0d4cfd3b0e7b53e3bcda045867fcb47013,1,David Alves,2014-11-03 15:21:24-08:00,['5046194727fde57db21a14a91894016fbe865db3'],12,23,35,487916,2,0.5,0.5,1,1194
f8ee40179a80de3cc7abbfa95c926437ce6e6a65,1,Jean-Daniel Cryans,2014-11-03 15:58:15-08:00,['fd0a5e0d4cfd3b0e7b53e3bcda045867fcb47013'],0,115,115,488031,1,0.210526316,0.210526316,1,1195
5b6c35a95389fae360d154db7e1d5d739cc1ec0c,0,Todd Lipcon,2014-11-03 16:09:10-08:00,['f8ee40179a80de3cc7abbfa95c926437ce6e6a65'],6,30,36,488067,1,1,1,1,1195
b26e9662997569fbef6a8b64746892caf1ac00a0,0,Michael Percy,2014-11-03 16:45:29-08:00,['5b6c35a95389fae360d154db7e1d5d739cc1ec0c'],38,102,140,488207,9,1,1,0.75,1195
0f83191e76e29e6b3e55cdffda239ada026d1647,0,David Alves,2014-11-03 19:50:34-08:00,['b26e9662997569fbef6a8b64746892caf1ac00a0'],1,1,2,488209,1,,,,1195
b6ebac49dcf8c095e0eba830c34a01b8c05dd45d,0,Michael Percy,2014-11-03 20:55:23-08:00,['0f83191e76e29e6b3e55cdffda239ada026d1647'],6,17,23,488232,2,0.166666667,1,1,1195
7a2549fd947cd36e277425f744bce120cac0b986,0,David Alves,2014-11-03 21:31:49-08:00,['b6ebac49dcf8c095e0eba830c34a01b8c05dd45d'],1,1,2,488234,1,,,,1195
b1daac77fa4c5a498d004e2e9afd42e9b022b242,0,Todd Lipcon,2014-11-03 22:35:24-08:00,['7a2549fd947cd36e277425f744bce120cac0b986'],1,2,3,488237,1,0,1,0,1195
28e0dac7743a5f7ca4edc45267096606545b70ce,0,Todd Lipcon,2014-11-03 22:36:06-08:00,['b1daac77fa4c5a498d004e2e9afd42e9b022b242'],0,34,34,488271,1,1,1,1,1195
81106b599833bfc8acf9df17e75e51aa6c4f3f45,0,Todd Lipcon,2014-11-03 23:04:34-08:00,['28e0dac7743a5f7ca4edc45267096606545b70ce'],2,9,11,488282,2,0,1,0,1195
9dc9594e240b0a66fbb3715ce53085552a9d2a10,1,Todd Lipcon,2014-11-03 23:17:45-08:00,['81106b599833bfc8acf9df17e75e51aa6c4f3f45'],0,34,34,488316,2,1,1,1,1195
8caa467939f7f6e37466654a77a9040b02a1976e,0,Todd Lipcon,2014-11-03 23:17:51-08:00,['9dc9594e240b0a66fbb3715ce53085552a9d2a10'],12,5,17,488333,2,0.5,0,0,1195
4258c4115d265d7268b685d8f66a673d9b4b9755,0,Jean-Daniel Cryans,2014-11-04 08:46:00-08:00,['8caa467939f7f6e37466654a77a9040b02a1976e'],1,1,2,488335,1,,,,1195
10cc5a77cc2607d5cf159e3e66c4652c27a8098e,0,Adar Dembo,2014-11-04 13:31:27-08:00,['4258c4115d265d7268b685d8f66a673d9b4b9755'],1,2,3,488338,1,,,,1195
2041855019925a0f65b2b909b1385cc9513e6652,1,Adar Dembo,2014-11-04 13:32:38-08:00,['10cc5a77cc2607d5cf159e3e66c4652c27a8098e'],39,74,113,488451,4,0.555555556,0.611111111,0.888888889,1195
f78dd2e4758a4116d8841f19134e8eb26a9113dd,1,Adar Dembo,2014-11-04 13:33:11-08:00,['2041855019925a0f65b2b909b1385cc9513e6652'],18,71,89,488540,5,1,0,1,1195
a77810f2781df04f97aa0897151c09eabaece12f,0,Todd Lipcon,2014-11-04 21:24:22-08:00,['f78dd2e4758a4116d8841f19134e8eb26a9113dd'],5,25,30,488570,6,0.4,1,1,1195
0df37c03724b826f9a20cc36c0ed5512752eb39e,0,Todd Lipcon,2014-11-05 10:30:55-08:00,['a77810f2781df04f97aa0897151c09eabaece12f'],0,1,1,488571,1,0,1,1,1195
7311de2a17c7b9179c24a4a624e1242a7704efa6,0,Adar Dembo,2014-11-05 13:19:22-08:00,['0df37c03724b826f9a20cc36c0ed5512752eb39e'],34,0,34,488605,1,0.117647059,0.058823529,0.117647059,1195
341c5ba05708d726cbc8b9a539f11f1aec216fe0,0,David Alves,2014-11-05 14:20:05-08:00,['7311de2a17c7b9179c24a4a624e1242a7704efa6'],1,5,6,488611,2,0,1,1,1195
6fe26fd8ce46c1f15196b90fa03896f3a293f0b3,0,David Alves,2014-11-05 14:23:14-08:00,['341c5ba05708d726cbc8b9a539f11f1aec216fe0'],2,2,4,488615,2,,,,1195
da67497711276506f86118e25a6dcb3e6bbc98d3,0,Todd Lipcon,2014-11-05 14:24:25-08:00,['6fe26fd8ce46c1f15196b90fa03896f3a293f0b3'],2,5,7,488622,1,,,,1195
29bb1f1fdf48c93b9ddb28f763fa744f8f6d5e1a,1,Todd Lipcon,2014-11-05 15:09:56-08:00,['da67497711276506f86118e25a6dcb3e6bbc98d3'],2,3,5,488627,2,0,1,1,1195
d82641173205470fd453b37eefdf7d45b6e481b4,1,Todd Lipcon,2014-11-05 15:12:44-08:00,['29bb1f1fdf48c93b9ddb28f763fa744f8f6d5e1a'],347,470,817,489444,16,0.252631579,0,0.568421053,1195
10ceaf91be2f4697300a32493f61ad694f6c3c4f,0,David Alves,2014-11-05 15:17:49-08:00,['d82641173205470fd453b37eefdf7d45b6e481b4'],53,75,128,489572,2,0,0,0,1195
68d1cd98a23be08764bc3a83a76b2ecfb571650e,0,David Alves,2014-11-05 15:32:08-08:00,['10ceaf91be2f4697300a32493f61ad694f6c3c4f'],39,24,63,489635,2,,,,1195
14c3592e646035eed38b67f8d344e03a3078f795,0,Todd Lipcon,2014-11-05 15:36:38-08:00,['68d1cd98a23be08764bc3a83a76b2ecfb571650e'],0,7,7,489642,1,0,1,1,1195
76f386efce000c2e3dcae5d51b0fac740cc5f524,0,Todd Lipcon,2014-11-05 23:30:24-08:00,['14c3592e646035eed38b67f8d344e03a3078f795'],55,58,113,489755,10,0,1,1,1195
65d9f3d904078cdde3da8fb384e86626d07bd206,0,David Alves,2014-11-06 16:16:28-08:00,['76f386efce000c2e3dcae5d51b0fac740cc5f524'],1,1,2,489757,1,,,,1195
d3eee5a7685ca69d6b2a4b3b5ce1f9f925a82dd9,0,Adar Dembo,2014-11-10 13:01:58-08:00,['65d9f3d904078cdde3da8fb384e86626d07bd206'],0,2,2,489759,1,1,1,1,1195
e3e120e4394eb29f7af819160193ba22001a62bc,1,Alex Feinberg,2014-11-10 13:06:12-08:00,['d3eee5a7685ca69d6b2a4b3b5ce1f9f925a82dd9'],34,189,223,489982,7,0.833333333,0.619047619,0.666666667,1195
a56843acb6d70fc6fd11c808826888aedeca08bd,0,Todd Lipcon,2014-11-10 19:32:59-08:00,['e3e120e4394eb29f7af819160193ba22001a62bc'],30,22,52,490034,5,0,0,0,1195
1061c107d38e56497a0216eada3fb8f9aaebfd5f,1,Jean-Daniel Cryans,2014-11-11 08:39:42-08:00,['a56843acb6d70fc6fd11c808826888aedeca08bd'],6,31,37,490071,2,0.95,1,1,1195
ff7b17c04f7f2603122621410933fb606b586521,1,Todd Lipcon,2014-11-11 10:48:50-08:00,['1061c107d38e56497a0216eada3fb8f9aaebfd5f'],179,182,361,490432,18,1,0,0,1195
c9594c98ae4d01d05ab73874ca20760a3748b3df,0,Todd Lipcon,2014-11-11 11:07:20-08:00,['ff7b17c04f7f2603122621410933fb606b586521'],0,2,2,490434,1,1,1,1,1195
f594668682523462eda0dd069bca9b385422da6e,0,Jean-Daniel Cryans,2014-11-11 11:42:02-08:00,['c9594c98ae4d01d05ab73874ca20760a3748b3df'],0,43,43,490477,1,,,,1195
e9591201c602cc7a8089c32fe9f386a6d3864310,1,Alex Feinberg,2014-11-11 15:19:04-08:00,['f594668682523462eda0dd069bca9b385422da6e'],91,105,196,490673,11,1,1,0.333333333,1196
c23be5a89ad7a623f8fd702eec74431df7a0e23b,1,Todd Lipcon,2014-11-11 23:21:29-08:00,['e9591201c602cc7a8089c32fe9f386a6d3864310'],221,217,438,491111,36,,,,1196
802543312c760cdde11950f6284d53fbc5a6a2e2,0,Todd Lipcon,2014-11-11 23:43:58-08:00,['c23be5a89ad7a623f8fd702eec74431df7a0e23b'],1,1,2,491113,1,,,,1196
d4664c23bb8dd008d6dd530443381973fdac83a2,0,Michael Percy,2014-11-12 00:38:38-08:00,['802543312c760cdde11950f6284d53fbc5a6a2e2'],0,15,15,491128,3,0.5,1,1,1196
10f2d1ffa879d49e8d348ca1382c5768a09836ef,0,Michael Percy,2014-11-12 00:38:47-08:00,['d4664c23bb8dd008d6dd530443381973fdac83a2'],5,16,21,491149,4,0,0.5,0.75,1196
eec3c2472d7bb10edff1f062a3234a2efbafe212,1,Michael Percy,2014-11-12 00:39:16-08:00,['10f2d1ffa879d49e8d348ca1382c5768a09836ef'],82,273,355,491504,6,0.323809524,0.638095238,0.971428571,1196
7bdbca737a0a32bbcb04085fefd16b581d21188f,0,Todd Lipcon,2014-11-12 11:17:29-08:00,['eec3c2472d7bb10edff1f062a3234a2efbafe212'],25,0,25,491529,2,0,0,0,1196
eed28cea0b2e1faa9470bbce4f61ef4e299c8fda,0,Todd Lipcon,2014-11-12 17:17:16-08:00,['7bdbca737a0a32bbcb04085fefd16b581d21188f'],6,13,19,491548,1,1,1,1,1196
7f3455a48c0e09f7fd71ba95fd0f8894e101e764,0,Todd Lipcon,2014-11-13 15:34:59-08:00,['eed28cea0b2e1faa9470bbce4f61ef4e299c8fda'],11,32,43,491591,2,0,1,1,1196
6175190ee96454ce56030013bba96097cd31a301,0,Todd Lipcon,2014-11-13 15:40:14-08:00,['7f3455a48c0e09f7fd71ba95fd0f8894e101e764'],1,8,9,491600,2,1,1,1,1196
df9154309a95009aa2743cf1240f6469a65b6a1a,1,Todd Lipcon,2014-11-13 15:54:38-08:00,['6175190ee96454ce56030013bba96097cd31a301'],152,239,391,491991,10,0,1,0,1198
efda4b04e34fc463662794c05cc250b4118d7243,1,Todd Lipcon,2014-11-13 16:05:13-08:00,['df9154309a95009aa2743cf1240f6469a65b6a1a'],45,226,271,492262,16,0.292929293,0,0.858585859,1198
a5b57c8475610abb0bb671eb3b44c656d636c640,0,Todd Lipcon,2014-11-13 16:25:20-08:00,['efda4b04e34fc463662794c05cc250b4118d7243'],319,65,384,492646,11,0.627906977,0,0.244186047,1198
15efcabff0c0fc48d62fd6d62ecf948df2b6ef95,0,Todd Lipcon,2014-11-13 16:25:29-08:00,['a5b57c8475610abb0bb671eb3b44c656d636c640'],21,10,31,492677,3,0,0,0.5,1198
6d43c927a7d70d1ee77e226fda962f8cb4e920e8,1,Michael Percy,2014-11-13 16:36:13-08:00,['15efcabff0c0fc48d62fd6d62ecf948df2b6ef95'],133,346,479,493156,6,0.226804124,0.587628866,0.515463918,1198
465ff2617c67bac335019d51d416345235e4f42a,0,David Alves,2014-11-14 00:21:43-08:00,['6d43c927a7d70d1ee77e226fda962f8cb4e920e8'],0,3,3,493159,1,1,1,1,1198
b8b679b5394a67f07987ae077990226e93c734df,1,Adar Dembo,2014-11-14 11:10:51-08:00,['465ff2617c67bac335019d51d416345235e4f42a'],35,19,54,493213,7,,,,1198
f900ab513f5c4cb91d4be0f6872b9e30f47df551,1,Michael Percy,2014-11-14 16:29:52-08:00,['b8b679b5394a67f07987ae077990226e93c734df'],73,96,169,493382,7,0,1,0.692307692,1198
a8a79504cac6b120b234babecb48c9070dad3f4c,1,Alex Feinberg,2014-11-14 16:41:41-08:00,['f900ab513f5c4cb91d4be0f6872b9e30f47df551'],6,6,12,493394,1,,,,1198
79422c1783b3b901011a0213b345fa67c66df86e,0,Jean-Daniel Cryans,2014-11-14 17:22:24-08:00,['a8a79504cac6b120b234babecb48c9070dad3f4c'],1,0,1,493395,1,,,,1198
bcf4da1050085b22b0b4e88767959196a178b151,0,Jean-Daniel Cryans,2014-11-15 03:18:44-08:00,['79422c1783b3b901011a0213b345fa67c66df86e'],0,2,2,493397,2,,,,1198
ac267b8330215e700245bfbc3a95bdc094f7078f,0,David Alves,2014-11-17 11:09:51-08:00,['bcf4da1050085b22b0b4e88767959196a178b151'],0,10,10,493407,2,1,1,1,1198
a7c21cccce23220ec3403294acdde81dc8fa80c7,0,Michael Percy,2014-11-17 11:11:14-08:00,['ac267b8330215e700245bfbc3a95bdc094f7078f'],8,13,21,493428,1,0,1,0,1198
d3f4744a6e346d7f9854ed0d71cecca48135905d,0,Todd Lipcon,2014-11-17 20:22:03-08:00,['a7c21cccce23220ec3403294acdde81dc8fa80c7'],2,2,4,493432,1,,,,1198
31ffb76d878e4670d4d71ff1987f618fa5d73bc9,0,Todd Lipcon,2014-11-17 20:22:22-08:00,['d3f4744a6e346d7f9854ed0d71cecca48135905d'],2,2,4,493436,1,,,,1198
61b9c68f1ca3b96d7949b9a943d13293e4e69af8,0,Todd Lipcon,2014-11-17 20:23:34-08:00,['31ffb76d878e4670d4d71ff1987f618fa5d73bc9'],33,42,75,493511,9,1,1,0,1198
dada79afec96dcb4abaec530a638747f7a48470d,0,David Alves,2014-11-17 21:12:50-08:00,['61b9c68f1ca3b96d7949b9a943d13293e4e69af8'],17,21,38,493549,1,1,1,0,1198
e42249485f97884c9aecf77b2ec5ed8ebceef33c,0,David Alves,2014-11-17 22:23:58-08:00,['dada79afec96dcb4abaec530a638747f7a48470d'],19,18,37,493586,3,,,,1198
db02ec886dd9c69db39536293f2e2ed0b2ebfc1b,0,David Alves,2014-11-18 01:16:07-08:00,['e42249485f97884c9aecf77b2ec5ed8ebceef33c'],11,11,22,493608,3,,,,1198
3a882b130045a1f8445ed00d0846b434e7b9412f,0,Michael Percy,2014-11-18 10:32:49-08:00,['db02ec886dd9c69db39536293f2e2ed0b2ebfc1b'],3,8,11,493619,2,0,0.5,1,1198
7c8171ad577194228724af84cc07f49661d57722,0,David Alves,2014-11-18 12:40:02-08:00,['3a882b130045a1f8445ed00d0846b434e7b9412f'],0,13,13,493632,4,1,1,1,1198
f6b3cb093d1bc084c4a45d46b62c62106588738d,0,David Alves,2014-11-18 12:54:49-08:00,['7c8171ad577194228724af84cc07f49661d57722'],11,53,64,493696,6,0.681818182,1,0,1198
ac0cbc1b76eebd152a5f28ea621b7e81c54bf17d,0,David Alves,2014-11-18 12:55:03-08:00,['f6b3cb093d1bc084c4a45d46b62c62106588738d'],4,16,20,493716,2,0,0.75,0.75,1198
695790d7b3572a0e37cff17fd15502c285ca96ae,0,David Alves,2014-11-18 12:56:30-08:00,['ac0cbc1b76eebd152a5f28ea621b7e81c54bf17d'],15,82,97,493813,3,0,0.104166667,1,1198
620b4d3dd080a5284c1c7846188cfda585f57a6e,1,Todd Lipcon,2014-11-19 11:53:59-08:00,['695790d7b3572a0e37cff17fd15502c285ca96ae'],29,55,84,493897,10,0.933333333,1,0,1198
130022d1d7924873c3b5aa124aad3ac979a35ddc,1,Todd Lipcon,2014-11-19 17:31:41-08:00,['620b4d3dd080a5284c1c7846188cfda585f57a6e'],30,178,208,494105,3,0,0.287671233,0.671232877,1198
5f8c66f034ccfc4ee17a497de1623b4643a3ff18,1,Todd Lipcon,2014-11-19 17:33:17-08:00,['130022d1d7924873c3b5aa124aad3ac979a35ddc'],31,6,37,494142,4,0.181818182,0.090909091,0,1198
c720ef0d81f098114c6437c982b2c727766f412d,0,Michael Percy,2014-11-19 18:00:51-08:00,['5f8c66f034ccfc4ee17a497de1623b4643a3ff18'],3,21,24,494166,3,1,1,1,1198
085cc17e7cf6a376a0b3ba3b9dcc67a84ec27301,1,Michael Percy,2014-11-19 18:40:31-08:00,['c720ef0d81f098114c6437c982b2c727766f412d'],0,126,126,494292,3,0.233766234,0.233766234,1,1200
7d4e927e021e4ae7535cb8e681b2b8bff9d9506f,0,Todd Lipcon,2014-11-19 23:12:36-08:00,['085cc17e7cf6a376a0b3ba3b9dcc67a84ec27301'],1,93,94,494386,4,0.625,1,1,1201
86e16faf8a3de615e34199c9702b03a968665872,0,David Alves,2014-11-20 11:54:37-08:00,['7d4e927e021e4ae7535cb8e681b2b8bff9d9506f'],3,1,4,494390,1,1,0,0,1201
4955182b665db9738b997e140ad4d8d5c6814c0e,0,Todd Lipcon,2014-11-20 13:35:07-08:00,['86e16faf8a3de615e34199c9702b03a968665872'],3,2,5,494395,1,,,,1201
29e64aad482701f641c8d5214db5018b95703514,1,David Alves,2014-11-20 21:21:29-08:00,['4955182b665db9738b997e140ad4d8d5c6814c0e'],70,422,492,494887,7,0.164021164,0.788359788,1,1201
f69065012ed11342e330114791e172e6532040c7,0,David Alves,2014-11-20 22:51:22-08:00,['29e64aad482701f641c8d5214db5018b95703514'],9,109,118,495005,4,0.390625,0.4375,0.953125,1201
5caf1be6328a981ff9f31aedb0c1422efdcce823,0,David Alves,2014-11-20 22:51:28-08:00,['f69065012ed11342e330114791e172e6532040c7'],81,103,184,495189,9,1,1,1,1201
eb30a98e1c7779bdc14e9c8d0f9e48c0b9118cf2,0,David Alves,2014-11-20 22:51:48-08:00,['5caf1be6328a981ff9f31aedb0c1422efdcce823'],26,15,41,495230,4,1,0,1,1201
a80baa00a4a25a2a9ee26c186b0d5e86a3bad1be,0,Todd Lipcon,2014-11-20 22:59:16-08:00,['eb30a98e1c7779bdc14e9c8d0f9e48c0b9118cf2'],4,15,19,495249,3,0.5,1,0.9,1201
e658d80dbc8e7938b253e3b3a5f7205621700786,0,Todd Lipcon,2014-11-20 23:19:45-08:00,['a80baa00a4a25a2a9ee26c186b0d5e86a3bad1be'],3,41,44,495293,2,0.5,0.923076923,0.423076923,1201
20b7be720a80df8aaa643be3524513b590cac3cd,0,Jean-Daniel Cryans,2014-11-21 07:53:24-08:00,['e658d80dbc8e7938b253e3b3a5f7205621700786'],2,13,15,495308,1,0,1,1,1201
72a282169bdd96fe05088cdf08a138a61b8b5f4c,0,Todd Lipcon,2014-11-21 10:12:21-08:00,['20b7be720a80df8aaa643be3524513b590cac3cd'],1,3,4,495312,1,0,1,1,1201
a8f95b146d71e69f4a84e4d0fc809787bd95ed4e,0,David Alves,2014-11-21 10:15:45-08:00,['72a282169bdd96fe05088cdf08a138a61b8b5f4c'],10,12,22,495334,2,0,0,1,1201
f08de97a53479ac25c79fbc9ad58953a9208275a,0,Todd Lipcon,2014-11-21 11:28:17-08:00,['a8f95b146d71e69f4a84e4d0fc809787bd95ed4e'],4,8,12,495346,1,0,1,0,1201
3ee7e957420d194fefecfabfdaf42f177a4c2555,1,Todd Lipcon,2014-11-21 11:29:00-08:00,['f08de97a53479ac25c79fbc9ad58953a9208275a'],129,101,230,495576,8,,,,1201
00f58bfffcced5f95fce521f921795a9058c8c4e,1,David Alves,2014-11-21 12:30:58-08:00,['3ee7e957420d194fefecfabfdaf42f177a4c2555'],350,251,601,496177,13,0.378787879,0.454545455,0.636363636,1201
fc5bb1bcb32f576684d5d190b307807daec02a0a,0,Todd Lipcon,2014-11-21 13:52:56-08:00,['00f58bfffcced5f95fce521f921795a9058c8c4e'],114,0,114,496291,3,0.745762712,0.745762712,0,1201
b1688f348595802e6044881ba8e38a0127e921a7,1,Michael Percy,2014-11-21 16:05:10-08:00,['fc5bb1bcb32f576684d5d190b307807daec02a0a'],158,206,364,496655,3,0.806451613,1,0,1201
4fd41070b788e90831614b071c76c78901a7d88d,0,Adar Dembo,2014-11-21 17:51:55-08:00,['b1688f348595802e6044881ba8e38a0127e921a7'],7,7,14,496669,4,,,,1201
fc4d60651f1efff293d964974cb73d2349f4bff0,1,Todd Lipcon,2014-11-24 11:18:32-08:00,['4fd41070b788e90831614b071c76c78901a7d88d'],0,176,176,496845,2,0.064814815,0.064814815,0.62037037,1202
c803e3b2222077567da276a214ef1ff87110e743,0,Michael Percy,2014-11-24 11:27:53-08:00,['fc4d60651f1efff293d964974cb73d2349f4bff0'],3,5,8,496853,1,,,,1202
1036b8e9eae88379dce045713eba23f1dcc56604,0,Todd Lipcon,2014-11-24 11:48:56-08:00,['c803e3b2222077567da276a214ef1ff87110e743'],20,87,107,496960,4,0.130434783,1,1,1203
8347d4bcf83d17e68e292fb2a4a529fccad8043f,0,Todd Lipcon,2014-11-24 17:52:15-08:00,['1036b8e9eae88379dce045713eba23f1dcc56604'],7,17,24,496984,4,1,1,1,1203
cba825aaf07487bbadab59fe11195a40bf5cbeb0,0,Todd Lipcon,2014-11-24 18:02:03-08:00,['8347d4bcf83d17e68e292fb2a4a529fccad8043f'],4,27,31,497015,2,0,0,1,1203
a716f4cfcb4709099ba5c42b58f98c2ce427151d,0,Jean-Daniel Cryans,2014-11-24 18:05:28-08:00,['cba825aaf07487bbadab59fe11195a40bf5cbeb0'],3,3,6,497021,1,,,,1203
9d3c3699ceeeec2683717f07a7367ec39e909bcd,0,David Alves,2014-11-25 11:59:32-08:00,['a716f4cfcb4709099ba5c42b58f98c2ce427151d'],3,5,8,497029,1,0,1,1,1203
83b40345565951626fdc5030c15eaf9986a21b64,0,Jean-Daniel Cryans,2014-11-25 14:33:19-08:00,['9d3c3699ceeeec2683717f07a7367ec39e909bcd'],0,38,38,497067,3,,,,1204
ec25eaa5a6991282d849ac3eb948709a6102ed26,1,Michael Percy,2014-11-26 13:56:28-08:00,['83b40345565951626fdc5030c15eaf9986a21b64'],124,186,310,497377,3,1,0,1,1204
600412d657d9c259c492a20c452c70eb6b6749eb,0,Michael Percy,2014-11-26 13:59:31-08:00,['ec25eaa5a6991282d849ac3eb948709a6102ed26'],1,8,9,497386,2,0,0.75,1,1204
8ee9ba897b87b5ceb7cb76ddb73ba13fb4f883fd,1,Michael Percy,2014-11-26 14:00:46-08:00,['600412d657d9c259c492a20c452c70eb6b6749eb'],58,100,158,497544,7,1,0.833333333,1,1204
b20bfa1d9bc03af164cc8584e3eb4edb03280f4f,0,Todd Lipcon,2014-12-01 14:46:19-08:00,['8ee9ba897b87b5ceb7cb76ddb73ba13fb4f883fd'],6,20,26,497570,4,0,1,1,1204
acddde447fab365a7a3379aa3f5b0254d6c3b529,0,Todd Lipcon,2014-12-01 23:49:44-08:00,['b20bfa1d9bc03af164cc8584e3eb4edb03280f4f'],0,15,15,497585,3,1,1,1,1205
77fab0e20c8641aea751daa5ce05eae879fcec09,1,Todd Lipcon,2014-12-02 11:50:33-08:00,['acddde447fab365a7a3379aa3f5b0254d6c3b529'],368,356,724,498309,10,0,0,0.5,1205
2f656ea896a144e44b4a9eba100e155309168b6c,0,Todd Lipcon,2014-12-02 22:12:54-08:00,['77fab0e20c8641aea751daa5ce05eae879fcec09'],2,1,3,498312,1,1,0,0,1205
c9cce7114e73a7cb88ffdb0c45dae5a7c975a0fc,0,Michael Percy,2014-12-03 11:07:45-08:00,['2f656ea896a144e44b4a9eba100e155309168b6c'],6,7,13,498325,1,1,1,1,1205
30c6f9c9fe38e50896506a0abf4e4bf9859b3160,1,David Alves,2014-12-03 11:55:49-08:00,['c9cce7114e73a7cb88ffdb0c45dae5a7c975a0fc'],60,143,203,498528,13,0.480769231,0.980769231,0.826923077,1205
be7871394088543aa3e6eacb2438a5e656c2b91a,1,David Alves,2014-12-03 11:55:56-08:00,['30c6f9c9fe38e50896506a0abf4e4bf9859b3160'],362,563,925,499453,15,0.454545455,0,0.752066116,1205
fe27824bf362ebf40587e6d066410d1c9454bcdc,0,David Alves,2014-12-03 11:56:03-08:00,['be7871394088543aa3e6eacb2438a5e656c2b91a'],79,25,104,499557,3,0.681818182,0,0.409090909,1205
1f6f818f13e1f67bc3095ae21e1fd0b010944c4d,0,Todd Lipcon,2014-12-03 12:38:26-08:00,['fe27824bf362ebf40587e6d066410d1c9454bcdc'],1,4,5,499562,1,,,,1205
ea04ecbe2c6f718ea154b65628ea1b1027e2049c,1,Todd Lipcon,2014-12-03 16:46:09-08:00,['1f6f818f13e1f67bc3095ae21e1fd0b010944c4d'],22,20,42,499604,1,0,0.5,1,1205
6f6d61f985de5443a0c665b4cf553c9510e38388,1,David Alves,2014-12-03 18:56:59-08:00,['ea04ecbe2c6f718ea154b65628ea1b1027e2049c'],101,322,423,500027,8,0.569105691,0.837398374,0.910569106,1205
93ffe1f0bcc96b54871b07a1de915aaf62b85efa,0,David Alves,2014-12-03 21:01:08-08:00,['6f6d61f985de5443a0c665b4cf553c9510e38388'],2,10,12,500039,1,1,1,1,1205
07501402aa96c431c74e1f8063c00ec323b1c641,0,David Alves,2014-12-03 23:17:53-08:00,['93ffe1f0bcc96b54871b07a1de915aaf62b85efa'],1,1,2,500041,1,,,,1205
4e8cef0a9355c7d748cada62b92b147ae918181b,1,Alex Feinberg,2014-12-04 13:02:03-08:00,['07501402aa96c431c74e1f8063c00ec323b1c641'],227,532,759,500800,14,0.233333333,1,1,1207
b7b6ba090ca4541e5759257f7c10c83a9681d1d8,1,David Alves,2014-12-04 15:50:02-08:00,['4e8cef0a9355c7d748cada62b92b147ae918181b'],2,2,4,500804,1,,,,1207
0ec2a97041c98b0d030438ad464e4c6d3b2cfce2,1,David Alves,2014-12-04 15:50:09-08:00,['b7b6ba090ca4541e5759257f7c10c83a9681d1d8'],5,34,39,500843,3,1,1,1,1207
88a6c8e763aa5a15427e5aba98b1170a0a9e0bc0,1,David Alves,2014-12-04 16:58:13-08:00,['0ec2a97041c98b0d030438ad464e4c6d3b2cfce2'],15,16,31,500874,1,,,,1207
cf273f2eed5ec57a57764f63ababb1737df41b06,0,David Alves,2014-12-04 16:58:42-08:00,['88a6c8e763aa5a15427e5aba98b1170a0a9e0bc0'],4,4,8,500882,1,,0,,1207
928f37750f3ca16946a5f0a4ee957cd09d3ad63e,0,David Alves,2014-12-04 18:07:06-08:00,['cf273f2eed5ec57a57764f63ababb1737df41b06'],5,1,6,500888,1,1,0,0,1207
87278941b16ef7b2afe1d28d3a95225ced74b2a1,0,David Alves,2014-12-04 20:41:53-08:00,['928f37750f3ca16946a5f0a4ee957cd09d3ad63e'],12,18,30,500918,2,1,,,1207
98574f8dd554823389f33b99ec41af69799f1a13,0,Todd Lipcon,2014-12-05 14:40:26-08:00,['87278941b16ef7b2afe1d28d3a95225ced74b2a1'],10,0,10,500928,2,0,0,0,1207
b7434853886ccad5780375f610f78561cda8575d,0,Todd Lipcon,2014-12-05 17:35:52-08:00,['98574f8dd554823389f33b99ec41af69799f1a13'],274,79,353,501281,3,0,0,0.789115646,1207
3d57f47e3f55d39938090c1e0d4ba1ef36d091ac,0,Todd Lipcon,2014-12-05 17:37:05-08:00,['b7434853886ccad5780375f610f78561cda8575d'],1,3,4,501285,1,1,1,1,1207
009e9e019d85a56837df0d1f206fec4d996a8fc7,1,Todd Lipcon,2014-12-05 17:40:56-08:00,['3d57f47e3f55d39938090c1e0d4ba1ef36d091ac'],121,72,193,501478,3,1,0,1,1207
64e227b6b585aeda11d98e4944581ee1934a1d1b,1,Todd Lipcon,2014-12-05 17:41:00-08:00,['009e9e019d85a56837df0d1f206fec4d996a8fc7'],27,60,87,501565,12,0,0.958333333,0.75,1207
4fb5dfdb0d4d8d8afcb30c6635cee5a196c1ffaf,1,Todd Lipcon,2014-12-05 17:41:45-08:00,['64e227b6b585aeda11d98e4944581ee1934a1d1b'],29,62,91,501656,4,0,0.896551724,0.655172414,1207
0452527c76ce2db0056b660e11f130ad303f171c,0,Michael Percy,2014-12-05 17:45:56-08:00,['4fb5dfdb0d4d8d8afcb30c6635cee5a196c1ffaf'],6,16,22,501678,1,0,0.333333333,0,1207
e391d9c0c303d9a1e76759700ed842aac2387669,0,Todd Lipcon,2014-12-05 18:15:46-08:00,['0452527c76ce2db0056b660e11f130ad303f171c'],252,150,402,502080,15,1,0.691176471,0.044117647,1207
7e582a17e88ab33dfbe54824052dda2bde84eb2d,1,Todd Lipcon,2014-12-09 09:32:07-08:00,['e391d9c0c303d9a1e76759700ed842aac2387669'],96,276,372,502452,35,0.431578947,0.905263158,0.147368421,1208
749de72354648283c1fbeef5334e041885e29c22,0,Todd Lipcon,2014-12-10 12:52:19-08:00,['7e582a17e88ab33dfbe54824052dda2bde84eb2d'],4,3,7,502459,1,0,0,0,1208
c43ccabe665fbf53f7806078caa34f9668f02813,0,Todd Lipcon,2014-12-10 14:13:08-08:00,['749de72354648283c1fbeef5334e041885e29c22'],11,7,18,502477,1,0,0,0,1208
3d6aa80905731c34de97dd8cdfdacfcfe762abf7,0,Todd Lipcon,2014-12-11 15:18:43-08:00,['c43ccabe665fbf53f7806078caa34f9668f02813'],3,4,7,502484,2,1,1,1,1208
10c7757585a1bf778254d369957cbb53d38acbd1,0,Todd Lipcon,2014-12-11 15:19:27-08:00,['3d6aa80905731c34de97dd8cdfdacfcfe762abf7'],0,17,17,502501,4,0.555555556,0.555555556,1,1208
e4a6920a0fb7528203f844da168b0595f2c60544,1,Todd Lipcon,2014-12-11 15:20:21-08:00,['10c7757585a1bf778254d369957cbb53d38acbd1'],87,90,177,502678,7,,,,1208
813846cca714ef6f0d82c36d70815cebd921a9f7,0,Todd Lipcon,2014-12-11 15:51:23-08:00,['e4a6920a0fb7528203f844da168b0595f2c60544'],1,8,9,502687,1,1,1,1,1208
8a8d8da8ef387afdf33c3aa011fb03a756cc2131,0,Todd Lipcon,2014-12-11 15:51:50-08:00,['813846cca714ef6f0d82c36d70815cebd921a9f7'],2,5,7,502694,1,0,1,1,1208
e4ad3e02c590dc3c3abad7f1c8ae26a5f12170b7,0,Todd Lipcon,2014-12-11 15:56:24-08:00,['8a8d8da8ef387afdf33c3aa011fb03a756cc2131'],4,5,9,502703,1,0,0,1,1208
fe5625afbc3e0c9e95aefc5b26ad221f4f887690,0,Todd Lipcon,2014-12-11 16:11:53-08:00,['e4ad3e02c590dc3c3abad7f1c8ae26a5f12170b7'],0,13,13,502716,4,1,1,1,1208
0f8228c6e5acb31e02ff8d62a24e996f719f316e,1,Michael Percy,2014-12-11 16:49:28-08:00,['fe5625afbc3e0c9e95aefc5b26ad221f4f887690'],6,13,19,502735,1,0.25,0.75,1,1208
213fabc9958c050308766db8592020579fc20098,0,Todd Lipcon,2014-12-11 17:00:57-08:00,['0f8228c6e5acb31e02ff8d62a24e996f719f316e'],2,10,12,502747,2,1,1,1,1208
4426813827ceb2aee425b5f4a489a7d3d99d4d59,1,Todd Lipcon,2014-12-11 17:03:31-08:00,['213fabc9958c050308766db8592020579fc20098'],42,218,260,503007,8,0.156521739,1,0.617391304,1208
4ea81862c3ec8394a4237eb3cf6e386a27e47f7f,1,Todd Lipcon,2014-12-11 17:03:49-08:00,['4426813827ceb2aee425b5f4a489a7d3d99d4d59'],21,152,173,503180,5,0.196078431,0.862745098,1,1208
adcab0f1a3fceecd1bbcc84d2f6e8d6560464773,1,David Alves,2014-12-11 19:58:45-08:00,['4ea81862c3ec8394a4237eb3cf6e386a27e47f7f'],293,289,582,503762,21,1,1,1,1209
992d3e79f72a9a8f5629502442132ab84573dd23,0,Jean-Daniel Cryans,2014-12-12 08:43:08-08:00,['adcab0f1a3fceecd1bbcc84d2f6e8d6560464773'],25,35,60,503822,1,0.142857143,0,0.142857143,1209
5e77082e5ff6971b962938959f566d5239b6afea,0,Jean-Daniel Cryans,2014-12-12 08:43:32-08:00,['992d3e79f72a9a8f5629502442132ab84573dd23'],2,2,4,503826,2,,,,1209
aae545729a60d11438321f60543b1daa531cbe08,0,Todd Lipcon,2014-12-12 15:31:00-08:00,['5e77082e5ff6971b962938959f566d5239b6afea'],0,1,1,503827,1,,,,1209
7cd7a6d3ad9ebeb1e15d5a9f9903f8d80852ff85,1,Todd Lipcon,2014-12-12 17:27:13-08:00,['aae545729a60d11438321f60543b1daa531cbe08'],236,220,456,504283,34,1,0,1,1209
ffd2fc3de1fffd0b9258dc63feb01f1ef16c3574,1,Michael Percy,2014-12-12 19:58:22-08:00,['7cd7a6d3ad9ebeb1e15d5a9f9903f8d80852ff85'],43,120,163,504446,4,0.543859649,0.298245614,0.964912281,1209
fb17f221b388e4cf7d1ca7a1b2b6ac2130c09731,1,Jean-Daniel Cryans,2014-12-14 14:39:15-08:00,['ffd2fc3de1fffd0b9258dc63feb01f1ef16c3574'],33,160,193,504639,5,0.615384615,1,0.846153846,1209
bb30128faf70505fb444052531f12fed971499b5,1,Todd Lipcon,2014-12-15 15:49:31-08:00,['fb17f221b388e4cf7d1ca7a1b2b6ac2130c09731'],15,23,38,504677,6,0.8,0.8,1,1209
74853db52bd1edc7482ba2cc7318148e6a9ec4ee,1,Todd Lipcon,2014-12-15 17:45:38-08:00,['bb30128faf70505fb444052531f12fed971499b5'],1,72,73,504750,3,0.641025641,1,1,1209
d48f4f778a04db3532d526ccf1bdfebf25ee7adb,0,Todd Lipcon,2014-12-15 17:45:57-08:00,['74853db52bd1edc7482ba2cc7318148e6a9ec4ee'],0,6,6,504756,1,1,1,1,1209
1fa9ee663f1a532a923b044a495c70849d172749,0,Todd Lipcon,2014-12-15 17:55:46-08:00,['d48f4f778a04db3532d526ccf1bdfebf25ee7adb'],4,4,8,504764,2,,,,1209
d47a37ee825ee8b5126c75f9cf6dd4439273dd92,0,Vladimir Feinberg,2014-12-15 18:51:10-08:00,['1fa9ee663f1a532a923b044a495c70849d172749'],1,4,5,504769,1,,,,1209
cdeb544d7ecf295c6076b92d3ea8688aeaca13d4,0,Michael Percy,2014-12-16 12:54:32-08:00,['d47a37ee825ee8b5126c75f9cf6dd4439273dd92'],157,0,157,504926,1,0.581632653,0.397959184,0.285714286,1209
cfe91b1865999cf7dc9d18c330619de3320ae4c0,1,Jean-Daniel Cryans,2014-12-16 14:43:56-08:00,['cdeb544d7ecf295c6076b92d3ea8688aeaca13d4'],19,194,213,505139,6,0.290697674,0.395348837,1,1211
ffc30579f908f9cb606e705e86110ba3035ccf45,0,Alex Feinberg,2014-12-16 14:45:25-08:00,['cfe91b1865999cf7dc9d18c330619de3320ae4c0'],0,169,169,505308,2,0.512195122,1,1,1212
3c6283ca30dac3ec257dd0d8d13ec98d82e6f029,0,Michael Percy,2014-12-16 15:32:31-08:00,['ffc30579f908f9cb606e705e86110ba3035ccf45'],4,4,8,505316,5,,,,1212
cc7222c157729381f44dce5235220488bdaafc90,0,Michael Percy,2014-12-16 15:32:36-08:00,['3c6283ca30dac3ec257dd0d8d13ec98d82e6f029'],4,10,14,505330,2,,,,1212
32ed73fff28d85cbcd30edca4a67ae316daf0c90,1,Michael Percy,2014-12-16 15:32:41-08:00,['cc7222c157729381f44dce5235220488bdaafc90'],14,34,48,505378,4,0.538461538,1,1,1212
93865bda257cf1e1d5f7a64414023b43c2c5ae29,0,Todd Lipcon,2014-12-16 15:49:13-08:00,['32ed73fff28d85cbcd30edca4a67ae316daf0c90'],1,11,12,505390,1,0,0,1,1212
c734081a4c4cb4c89eb367dabafec346fb5713fc,0,Todd Lipcon,2014-12-16 16:00:25-08:00,['93865bda257cf1e1d5f7a64414023b43c2c5ae29'],6,7,13,505403,1,1,1,1,1212
70a85ab612d96b1cfcafff794a6347320bee0598,0,Adar Dembo,2014-12-16 17:19:35-08:00,['c734081a4c4cb4c89eb367dabafec346fb5713fc'],56,89,145,505548,9,,,,1213
4cbd65ee87631a35608f918df6e8cc319514830e,0,Todd Lipcon,2014-12-16 19:40:00-08:00,['70a85ab612d96b1cfcafff794a6347320bee0598'],100,12,112,505660,3,0.677966102,0,0,1213
030ce7c3786e84fb9fee73ba3c955b9c1ebd14c7,0,David Alves,2014-12-16 22:35:19-08:00,['4cbd65ee87631a35608f918df6e8cc319514830e'],0,1,1,505661,1,,,,1213
a842ccfa0ccd9893fb6f706977c38c622c6133eb,0,Adar Dembo,2014-12-17 01:09:24-08:00,['030ce7c3786e84fb9fee73ba3c955b9c1ebd14c7'],1,44,45,505706,6,0.823529412,0.823529412,0.941176471,1213
1bfd694c29218531ea562a080b104f06a6cfc334,1,Todd Lipcon,2014-12-17 11:53:11-08:00,['a842ccfa0ccd9893fb6f706977c38c622c6133eb'],580,615,1195,506901,38,1,0.576923077,1,1214
acacb978ac013f13656b1d24d6ef9947dcddc18a,1,Todd Lipcon,2014-12-17 11:59:10-08:00,['1bfd694c29218531ea562a080b104f06a6cfc334'],22,131,153,507054,3,0.101694915,0.101694915,0.237288136,1215
fc2a9e50fe7facc0b54ec685f25c284457d65a11,0,David Alves,2014-12-17 13:17:37-08:00,['acacb978ac013f13656b1d24d6ef9947dcddc18a'],9,17,26,507080,1,0,1,1,1215
5c870d62b9a14b45ec67d5dabc0c3f573e7a9a29,0,Michael Percy,2014-12-17 19:39:38-08:00,['fc2a9e50fe7facc0b54ec685f25c284457d65a11'],1,6,7,507087,1,,,,1215
b6bba3f2b849bbc3ba8c2a9920b6e13519134545,0,Todd Lipcon,2014-12-18 10:01:31-08:00,['5c870d62b9a14b45ec67d5dabc0c3f573e7a9a29'],0,25,25,507112,1,0.058823529,1,1,1215
bef588c89ae2293c7b8bee544c3582a25125aacb,0,Todd Lipcon,2014-12-18 12:59:40-08:00,['b6bba3f2b849bbc3ba8c2a9920b6e13519134545'],1,1,2,507114,1,,,,1215
a1384694138e64b988ce0b1368e23bc8944b55ae,0,Todd Lipcon,2014-12-18 13:00:30-08:00,['bef588c89ae2293c7b8bee544c3582a25125aacb'],0,33,33,507147,1,,,,1215
b959616cb40ee3fb78e35f0d1862652edf62a7fa,0,Todd Lipcon,2014-12-18 19:57:22-08:00,['a1384694138e64b988ce0b1368e23bc8944b55ae'],14,14,28,507175,4,,,,1215
ec391061a7410663cbf04b6e9a61db202e22c66e,0,David Alves,2014-12-18 20:37:10-08:00,['b959616cb40ee3fb78e35f0d1862652edf62a7fa'],7,15,22,507197,3,1,1,1,1215
c9516ec645a75a8d3d0070324b0928a0bcdc8e9b,1,David Alves,2014-12-18 20:37:19-08:00,['ec391061a7410663cbf04b6e9a61db202e22c66e'],13,20,33,507230,1,1,1,1,1215
60b05eff34010cccbb0f58dab79258ff67d93ab6,0,Todd Lipcon,2014-12-18 22:47:00-08:00,['c9516ec645a75a8d3d0070324b0928a0bcdc8e9b'],2,6,8,507238,1,,,,1215
c7b44bf89c1ec7d83533bf9d11d22bebab7950b1,0,Adar Dembo,2014-12-19 12:08:06-08:00,['60b05eff34010cccbb0f58dab79258ff67d93ab6'],1,1,2,507240,1,,,,1215
9455cb5e1148a82d29847fb701568c48bbcc9126,0,Todd Lipcon,2014-12-22 12:02:19-08:00,['c7b44bf89c1ec7d83533bf9d11d22bebab7950b1'],2,10,12,507252,1,,,,1215
9befdeb279936de553ecaa9fe1768085b366351f,1,David Alves,2014-12-22 12:02:25-08:00,['9455cb5e1148a82d29847fb701568c48bbcc9126'],79,258,337,507589,6,0.225806452,0.612903226,0,1215
ba2ec6fae2a6fee8d47c356fd271740e1d0049bc,0,David Alves,2014-12-22 13:46:05-08:00,['9befdeb279936de553ecaa9fe1768085b366351f'],56,126,182,507771,5,0,1,1,1215
197e8805eee6a84d43d84583ac768fbdbd934b78,1,David Alves,2014-12-22 13:46:12-08:00,['ba2ec6fae2a6fee8d47c356fd271740e1d0049bc'],4,2,6,507777,1,,,,1215
0529de11a5704468859e8f5d169beded9dee6b6a,1,Adar Dembo,2014-12-22 14:06:15-08:00,['197e8805eee6a84d43d84583ac768fbdbd934b78'],11,64,75,507852,4,0.541666667,0.541666667,1,1215
42f1a481bd151edf96751ddb055962258437098d,0,Adar Dembo,2014-12-22 14:47:52-08:00,['0529de11a5704468859e8f5d169beded9dee6b6a'],2,2,4,507856,2,,,,1215
c9fbbeb88efb4a5581be645fd84ab8e1ce2d04ba,0,Adar Dembo,2014-12-22 19:24:17-08:00,['42f1a481bd151edf96751ddb055962258437098d'],0,39,39,507895,3,1,1,1,1215
1732894cf36f633e075622eff76b1f79796146a7,1,Jean-Daniel Cryans,2014-12-23 06:55:06-08:00,['c9fbbeb88efb4a5581be645fd84ab8e1ce2d04ba'],32,53,85,507980,1,0,0,1,1215
2f5e757230ad6ffdb8a080f29ce6d52942636b59,1,Jean-Daniel Cryans,2014-12-23 06:56:15-08:00,['1732894cf36f633e075622eff76b1f79796146a7'],58,99,157,508137,24,0.791666667,1,0,1215
3896e23f953e9a9770398ce3b6eef1e0c81cacf7,1,Todd Lipcon,2014-12-23 08:02:50-08:00,['2f5e757230ad6ffdb8a080f29ce6d52942636b59'],0,461,461,508598,4,0.63546798,1,0.798029557,1218
8476282a0ea711d5b2959e4b4e377995021c72bb,0,Todd Lipcon,2014-12-23 08:15:54-08:00,['3896e23f953e9a9770398ce3b6eef1e0c81cacf7'],27,48,75,508673,2,1,1,1,1218
03d7ed0c67211240ef090c0df78774b5aa6ce8d5,0,Jean-Daniel Cryans,2014-12-23 10:46:29-08:00,['8476282a0ea711d5b2959e4b4e377995021c72bb'],0,1,1,508674,1,,,,1218
1d42f222ec96974602178948d86d2c7fc53d4fdf,0,Jean-Daniel Cryans,2014-12-23 11:47:46-08:00,['03d7ed0c67211240ef090c0df78774b5aa6ce8d5'],0,7,7,508681,1,0,0,0,1218
8bd8b56bf5d9f5a3c519bc0387521e1cf01a3404,0,Jean-Daniel Cryans,2014-12-23 14:31:40-08:00,['1d42f222ec96974602178948d86d2c7fc53d4fdf'],1,19,20,508701,3,0.333333333,0.333333333,1,1218
fa42e9250c08d3f72eaca12bc6ad6d792f3de936,0,Todd Lipcon,2014-12-23 16:03:50-08:00,['8bd8b56bf5d9f5a3c519bc0387521e1cf01a3404'],0,275,275,508976,2,0.191616766,0.323353293,0.832335329,1219
ac3f08713b7fcde68c0503b1c17ad088adfa9e15,0,Jean-Daniel Cryans,2014-12-24 11:02:50-08:00,['fa42e9250c08d3f72eaca12bc6ad6d792f3de936'],8,0,8,508984,1,1,1,1,1219
47187037e1c085013303338103484a73c5f71c0f,1,Todd Lipcon,2014-12-24 21:14:17-08:00,['ac3f08713b7fcde68c0503b1c17ad088adfa9e15'],28,325,353,509337,19,0.435897436,0.64957265,0.752136752,1220
eb7d10ce1cfa203e5b28c2387642a4af792591d2,1,David Alves,2014-12-25 01:14:38-08:00,['47187037e1c085013303338103484a73c5f71c0f'],347,484,831,510168,2,0.203125,0.625,0.78125,1221
072af4a536fc3477ef5c8ed2f81d8a2038780f41,0,Todd Lipcon,2014-12-29 12:40:21-08:00,['eb7d10ce1cfa203e5b28c2387642a4af792591d2'],1,2,3,510171,1,0,0,1,1221
65309f10fa8a3d7476e5fc97216aec80d7134d38,0,Todd Lipcon,2014-12-29 12:52:51-08:00,['072af4a536fc3477ef5c8ed2f81d8a2038780f41'],1,1,2,510173,1,,,,1221
58f11bc33a34bdeb49502da23152c12bd02eba2f,0,Todd Lipcon,2014-12-29 14:37:22-08:00,['65309f10fa8a3d7476e5fc97216aec80d7134d38'],0,57,57,510230,2,0,0,1,1222
8331f4b4d5f9440b0a445e6921d37db1d1ddb781,0,Adar Dembo,2014-12-29 14:44:08-08:00,['58f11bc33a34bdeb49502da23152c12bd02eba2f'],2,12,14,510244,1,1,1,1,1222
77c534633f3114089fd6b68bf5113963fd1321aa,0,David Alves,2014-12-29 14:57:50-08:00,['8331f4b4d5f9440b0a445e6921d37db1d1ddb781'],48,38,86,510330,1,1,0,1,1222
abd32cadc58248f42f5a7418365fc18200af672c,0,Jean-Daniel Cryans,2014-12-29 21:53:44-08:00,['77c534633f3114089fd6b68bf5113963fd1321aa'],8,14,22,510352,9,1,1,1,1222
6cb3ce5a553c166e847adba537fdee18a3487d10,1,Todd Lipcon,2014-12-30 00:21:51-08:00,['abd32cadc58248f42f5a7418365fc18200af672c'],20,141,161,510513,8,0.01,0.59,0.94,1222
cdb725387f408ee1de427ceea1ba52aa9d2c956e,1,Todd Lipcon,2014-12-30 12:35:16-08:00,['6cb3ce5a553c166e847adba537fdee18a3487d10'],72,348,420,510933,3,0.426035503,0.449704142,1,1222
484693cd7835ae2d17c972a3a6b2d9332cd85cbd,0,Todd Lipcon,2014-12-30 14:14:29-08:00,['cdb725387f408ee1de427ceea1ba52aa9d2c956e'],14,64,78,511011,1,0.285714286,1,0.914285714,1222
fe86d4458ef08de0f591c365f85f4ff8d7e825dd,1,Todd Lipcon,2014-12-30 14:31:14-08:00,['484693cd7835ae2d17c972a3a6b2d9332cd85cbd'],30,94,124,511135,10,1,1,0.722222222,1222
b12566dbfe766984c389d05c4212eaaefb775806,1,Vladimir Feinberg,2015-01-04 17:43:23-08:00,['fe86d4458ef08de0f591c365f85f4ff8d7e825dd'],143,428,571,511706,3,0.303703704,1,1,1222
961940fc828a6af82044eaadb9e5753973079cd5,0,Adar Dembo,2015-01-05 09:39:35-08:00,['b12566dbfe766984c389d05c4212eaaefb775806'],0,1,1,511707,1,0,1,1,1222
9b91baca0ec45189040adfe1f23544f908e005a3,0,Todd Lipcon,2015-01-05 14:34:24-08:00,['961940fc828a6af82044eaadb9e5753973079cd5'],2,2,4,511711,2,,,,1222
83274638d3c3e1a995d4e6916eef65f4227db820,0,Todd Lipcon,2015-01-05 18:08:38-08:00,['9b91baca0ec45189040adfe1f23544f908e005a3'],1,11,12,511723,1,,,,1222
f016dadc98fe08b5508a5cb1d2c07a0f6582c536,0,Jean-Daniel Cryans,2015-01-05 18:17:42-08:00,['83274638d3c3e1a995d4e6916eef65f4227db820'],15,17,32,511755,1,0,0,1,1222
e5b17a3b22650a13d843a23388c220594fba907a,1,Todd Lipcon,2015-01-05 19:05:19-08:00,['f016dadc98fe08b5508a5cb1d2c07a0f6582c536'],166,405,571,512326,25,0.451612903,0.435483871,0.483870968,1223
f85e6d5c270a75afa4728405843f9153a83a80a3,1,Todd Lipcon,2015-01-05 21:58:24-08:00,['e5b17a3b22650a13d843a23388c220594fba907a'],9,21,30,512356,1,1,1,1,1223
bf15dea6d168349768e46e3115d11d9181de9666,0,Vladimir Feinberg,2015-01-05 22:19:35-08:00,['f85e6d5c270a75afa4728405843f9153a83a80a3'],29,60,89,512445,4,0,1,0,1223
7c6ba1cb34107383077d8985354f716791cc8622,0,Jean-Daniel Cryans,2015-01-06 07:58:18-08:00,['bf15dea6d168349768e46e3115d11d9181de9666'],3,56,59,512504,1,0.625,0.78125,0.9375,1223
16a1a46e7823b29746cef6f189fa3566b5d5038a,1,Jean-Daniel Cryans,2015-01-06 07:58:30-08:00,['7c6ba1cb34107383077d8985354f716791cc8622'],16,19,35,512539,6,0,1,1,1223
e21d12a650d20330fa12c65a049a36c57d24e632,1,Michael Percy,2015-01-06 12:17:07-08:00,['16a1a46e7823b29746cef6f189fa3566b5d5038a'],1,9,10,512549,1,0,0,0.4,1223
d7b9ad68f132b3adaab6497d6ff7c3e15ed63e10,0,Michael Percy,2015-01-06 12:17:44-08:00,['e21d12a650d20330fa12c65a049a36c57d24e632'],5,8,13,512562,2,1,1,1,1223
409285f289faeb353be8f017a675c0f9a89c2210,0,Todd Lipcon,2015-01-06 12:21:54-08:00,['d7b9ad68f132b3adaab6497d6ff7c3e15ed63e10'],21,103,124,512686,4,0,0.956521739,0.782608696,1223
717329756df48d5fe95aa449b311cf843d6a0cc1,1,David Alves,2015-01-06 12:23:54-08:00,['409285f289faeb353be8f017a675c0f9a89c2210'],127,133,260,512946,7,1,0.090909091,0,1223
05dc17c77b96c67a4e4936d6a72f8e0d22c7297e,1,Todd Lipcon,2015-01-06 12:27:57-08:00,['717329756df48d5fe95aa449b311cf843d6a0cc1'],72,119,191,513137,4,0,1,0.65,1223
0db98dcdd82b7e38bcb73c8347331efafa990edc,1,Todd Lipcon,2015-01-06 12:28:02-08:00,['05dc17c77b96c67a4e4936d6a72f8e0d22c7297e'],13,13,26,513163,4,,,,1223
42a3f14c37390b906892a1b56791e586efd420a0,0,Todd Lipcon,2015-01-06 13:45:58-08:00,['0db98dcdd82b7e38bcb73c8347331efafa990edc'],487,374,861,514024,16,0.105263158,0.105263158,0.526315789,1224
df61cba430f91414ce43ad540e08f96ca932495f,0,Todd Lipcon,2015-01-06 13:50:40-08:00,['42a3f14c37390b906892a1b56791e586efd420a0'],12,5,17,514041,2,,,,1224
4444f030625025602a8477b9bcad419766cc1e8f,0,Todd Lipcon,2015-01-06 13:51:53-08:00,['df61cba430f91414ce43ad540e08f96ca932495f'],0,237,237,514278,1,,,,1225
fb65712637cbc0f8a359d2b3c4744e2f463696cc,1,Todd Lipcon,2015-01-06 15:09:58-08:00,['4444f030625025602a8477b9bcad419766cc1e8f'],10,36,46,514324,7,0.857142857,1,0,1225
5ab2739cb4e1654b08669d51cb676fa201bcf92e,0,Todd Lipcon,2015-01-06 15:10:33-08:00,['fb65712637cbc0f8a359d2b3c4744e2f463696cc'],31,120,151,514475,10,0.19047619,0.333333333,0.333333333,1225
9d03074e0d2b60aaeafc3dc2d48a37428d27d081,0,Jean-Daniel Cryans,2015-01-06 15:11:59-08:00,['5ab2739cb4e1654b08669d51cb676fa201bcf92e'],10,42,52,514527,3,0,0,1,1225
61f4c45f3c8aa8e9e5bb54e3740d2adea9a83f17,0,Adar Dembo,2015-01-06 15:54:22-08:00,['9d03074e0d2b60aaeafc3dc2d48a37428d27d081'],1,1,2,514529,1,,,,1225
68a2b2033364044d5fb4e1281f5bc033876c5010,0,Jean-Daniel Cryans,2015-01-06 16:10:26-08:00,['61f4c45f3c8aa8e9e5bb54e3740d2adea9a83f17'],31,30,61,514590,1,1,1,,1225
508861ef12a29d75c35580f559b52300cbfe1a9c,1,Jean-Daniel Cryans,2015-01-06 16:18:32-08:00,['68a2b2033364044d5fb4e1281f5bc033876c5010'],6,11,17,514607,4,0,1,0.333333333,1225
7bc74bd7cafaaf59b220ea5a6d73469364d17ed7,0,Todd Lipcon,2015-01-06 17:49:49-08:00,['508861ef12a29d75c35580f559b52300cbfe1a9c'],0,6,6,514613,1,,,,1225
2f5790995a93dd2d1719781859cfde6db115e2d4,0,Todd Lipcon,2015-01-06 17:50:14-08:00,['7bc74bd7cafaaf59b220ea5a6d73469364d17ed7'],6,5,11,514624,3,,,,1225
543eba474187eb210233fa20ae9fb08043ec4347,0,Todd Lipcon,2015-01-06 22:43:09-08:00,['2f5790995a93dd2d1719781859cfde6db115e2d4'],1,1,2,514626,1,,,,1225
37e51b663e1f51ee0d3b4f1368f0ddcfe83adfb7,0,Todd Lipcon,2015-01-06 23:54:19-08:00,['543eba474187eb210233fa20ae9fb08043ec4347'],20,0,20,514646,2,0,0,0,1225
c603ac5da3fb4f76c0ac3ed3ad25744a686e896a,0,Todd Lipcon,2015-01-07 13:36:02-08:00,['37e51b663e1f51ee0d3b4f1368f0ddcfe83adfb7'],5,4,9,514655,4,,,,1225
ca9e2b5b9f45d203205fb8598e9d02d6f24fed27,0,Jean-Daniel Cryans,2015-01-07 14:42:32-08:00,['c603ac5da3fb4f76c0ac3ed3ad25744a686e896a'],22,71,93,514748,6,0.952380952,1,0.952380952,1225
916f30afebe4bbb91f1c834ec8b64602eed3325e,0,Jean-Daniel Cryans,2015-01-07 14:42:47-08:00,['ca9e2b5b9f45d203205fb8598e9d02d6f24fed27'],1,30,31,514779,2,0.526315789,1,1,1225
619efc7fa8101843371acc10dceaea7f872e632d,0,Adar Dembo,2015-01-07 15:05:16-08:00,['916f30afebe4bbb91f1c834ec8b64602eed3325e'],4,8,12,514791,1,,,,1225
dc113222d3dc204aed66f7c68d04613e007b6917,0,Andrew Wang,2015-01-07 15:33:45-08:00,['619efc7fa8101843371acc10dceaea7f872e632d'],0,5,5,514796,1,,,,1226
c0237babf5915969812c805225b8bd7e687e07ad,0,Todd Lipcon,2015-01-07 15:43:58-08:00,['dc113222d3dc204aed66f7c68d04613e007b6917'],7,32,39,514835,4,0.277777778,0.277777778,1,1226
e112408c44ecf0317021be155007a0f022e6eebe,0,Todd Lipcon,2015-01-08 08:18:03-08:00,['c0237babf5915969812c805225b8bd7e687e07ad'],12,20,32,514867,1,,,,1226
4ff30576893001c123e023459d0d49b95699af26,0,Adar Dembo,2015-01-09 14:45:09-08:00,['e112408c44ecf0317021be155007a0f022e6eebe'],5,31,36,514903,1,,,,1226
b2f6de9ded958d1bffb68fad4a11a68a8aee97cf,1,Todd Lipcon,2015-01-12 12:20:45-08:00,['4ff30576893001c123e023459d0d49b95699af26'],108,89,197,515100,8,1,0.142857143,1,1226
1fd66b1b951d5c1b628e1d31f467de799e6783bb,0,Todd Lipcon,2015-01-12 12:20:58-08:00,['b2f6de9ded958d1bffb68fad4a11a68a8aee97cf'],38,57,95,515195,2,,,,1226
b0f6752215d81fc062f7d79ae2d28d74e6cae51b,0,Jean-Daniel Cryans,2015-01-12 15:54:58-08:00,['1fd66b1b951d5c1b628e1d31f467de799e6783bb'],1,1,2,515197,1,,,,1226
03c722972f20ad26ebfd02f4d0a8c8cf10295252,1,Michael Percy,2015-01-12 16:30:15-08:00,['b0f6752215d81fc062f7d79ae2d28d74e6cae51b'],0,46,46,515243,2,0,1,1,1226
85ace8270fcb5344832508e3cee7cbe3d7082ca5,0,Jean-Daniel Cryans,2015-01-12 17:59:35-08:00,['03c722972f20ad26ebfd02f4d0a8c8cf10295252'],2,3,5,515248,3,0,1,1,1226
bcb1cb2b7769954db765e5c226132bef0f8be837,0,Andrew Wang,2015-01-13 10:25:41-08:00,['85ace8270fcb5344832508e3cee7cbe3d7082ca5'],12,129,141,515389,7,0.390804598,0.988505747,1,1226
17984ce681e234c064102773c9b2f6f03f3e4521,0,Andrew Wang,2015-01-13 15:27:36-08:00,['bcb1cb2b7769954db765e5c226132bef0f8be837'],3,17,20,515409,1,0,1,0,1226
a9cc21c5dd4ef1a9e016ce4bdc427cc5276213e2,0,Todd Lipcon,2015-01-13 17:18:00-08:00,['17984ce681e234c064102773c9b2f6f03f3e4521'],1,2,3,515412,1,1,1,1,1226
6be4c23bac2388242ee9be684742582e9be9f33b,1,Adar Dembo,2015-01-13 17:34:28-08:00,['a9cc21c5dd4ef1a9e016ce4bdc427cc5276213e2'],130,556,686,516098,9,0.011450382,0.366412214,0.446564885,1226
a547825ae0cfddce1210905ae9d11a21f32147fe,1,Adar Dembo,2015-01-13 17:35:45-08:00,['6be4c23bac2388242ee9be684742582e9be9f33b'],16,81,97,516195,6,0,1,0.285714286,1226
72a81bfa137e8d2a3c6e15b870c320100fa1f67b,0,Alex Feinberg,2015-01-14 08:27:13-08:00,['a547825ae0cfddce1210905ae9d11a21f32147fe'],57,42,99,516294,3,1,0,1,1226
3bf57913c1f0ce7f88914af6e30573da0020940f,0,Adar Dembo,2015-01-14 11:16:24-08:00,['72a81bfa137e8d2a3c6e15b870c320100fa1f67b'],2,2,4,516298,1,,,,1226
ab1ce63973fd801744f2a92f71d2bed230b15271,1,Todd Lipcon,2015-01-14 14:54:31-08:00,['3bf57913c1f0ce7f88914af6e30573da0020940f'],12,24,36,516334,3,0,0.916666667,1,1226
4752ac34a5c81216787d463830f71c18debf7c79,1,Todd Lipcon,2015-01-14 15:19:13-08:00,['ab1ce63973fd801744f2a92f71d2bed230b15271'],2,5359,5361,521695,9,0.490238612,0.639479393,0.69197397,1234
a9019b8212077dd71250bb916369619c822c1da1,1,Todd Lipcon,2015-01-14 15:31:38-08:00,['4752ac34a5c81216787d463830f71c18debf7c79'],2,69,71,521766,3,1,1,1,1234
3e2afc0363a941e104403eb3fa59f7dadf17f114,0,Todd Lipcon,2015-01-14 15:31:43-08:00,['a9019b8212077dd71250bb916369619c822c1da1'],3,251,254,522020,5,0.314285714,0.478571429,0.335714286,1235
9d61106a32dd90ed1d607d32ecba72cd1df936dd,0,Alex Feinberg,2015-01-14 22:24:29-08:00,['3e2afc0363a941e104403eb3fa59f7dadf17f114'],0,97,97,522117,2,1,1,1,1237
2902695bcc1f9d986a9f160eb0258e1fa958b3df,0,Todd Lipcon,2015-01-15 20:06:36-08:00,['9d61106a32dd90ed1d607d32ecba72cd1df936dd'],238,86,324,522441,15,0.136842105,0.031578947,0,1237
0ee3218b9edcd7e5e9d450307bc22d0eadfb53be,1,Adar Dembo,2015-01-20 10:55:18-08:00,['2902695bcc1f9d986a9f160eb0258e1fa958b3df'],745,884,1629,524070,11,0.532467532,1,1,1238
dcdc1f2c5ab7bb47941f3d0cd71e514568f31575,1,Todd Lipcon,2015-01-20 11:51:22-08:00,['0ee3218b9edcd7e5e9d450307bc22d0eadfb53be'],0,53,53,524123,5,,,,1238
65b7e5b2cc5c9e7fde64e6658a6334094a739403,1,Adar Dembo,2015-01-20 11:54:04-08:00,['dcdc1f2c5ab7bb47941f3d0cd71e514568f31575'],72,252,324,524447,14,0.03125,0.40625,1,1240
4af12e12e9a4e616ea63f36f27c86254b9df5995,0,Todd Lipcon,2015-01-20 12:35:39-08:00,['65b7e5b2cc5c9e7fde64e6658a6334094a739403'],8,8,16,524463,1,,,,1240
bd31b328f146014d96296cc285f25e8769565e74,0,Adar Dembo,2015-01-20 13:24:54-08:00,['4af12e12e9a4e616ea63f36f27c86254b9df5995'],2,0,2,524465,1,,,,1240
a375ae88c452711d63dddf86454de2ea52946981,0,Todd Lipcon,2015-01-20 15:04:18-08:00,['bd31b328f146014d96296cc285f25e8769565e74'],0,1,1,524466,1,,,,1240
8d80652cff0f3dcbca59dc7b02ebb2a8157cd394,0,Todd Lipcon,2015-01-20 15:14:27-08:00,['a375ae88c452711d63dddf86454de2ea52946981'],11,15,26,524492,3,0,0,0,1240
0c55ebed1c1d0bb6475992671f14c4251b0fe707,1,Michael Percy,2015-01-21 15:48:04-08:00,['8d80652cff0f3dcbca59dc7b02ebb2a8157cd394'],6,100,106,524598,4,0.137931034,1,0.931034483,1240
ed635e43b18f493dca7892999cc1a748dd3cebe1,1,Adar Dembo,2015-01-23 09:48:21-08:00,['0c55ebed1c1d0bb6475992671f14c4251b0fe707'],68,94,162,524760,3,1,0,0.727272727,1240
57e402417ddad42d3305423eb1a85881241b4d43,1,Michael Percy,2015-01-23 10:51:08-08:00,['ed635e43b18f493dca7892999cc1a748dd3cebe1'],63,259,322,525082,8,0.086538462,1,1,1242
a1bf05d5039d486afcfed526ded92be1fcfe6a0b,0,Todd Lipcon,2015-01-24 06:10:04-08:00,['57e402417ddad42d3305423eb1a85881241b4d43'],3,8,11,525093,3,,,,1242
01698dfa043ad297239deb9a0cb6c17741e56a0b,1,Todd Lipcon,2015-01-24 06:10:43-08:00,['a1bf05d5039d486afcfed526ded92be1fcfe6a0b'],1,11,12,525105,1,,,,1242
575730e4a9321b991188f9c2365eff72a4e3faff,0,Andrew Wang,2015-01-26 11:08:41-08:00,['01698dfa043ad297239deb9a0cb6c17741e56a0b'],0,24,24,525129,2,1,1,1,1242
4779a2c5e1f2735be88bd3119b9e874f6a644b28,0,Adar Dembo,2015-01-27 19:22:11-08:00,['575730e4a9321b991188f9c2365eff72a4e3faff'],91,93,184,525313,2,,,,1242
516582e32b83e9628a0378436516a49ac2d11610,1,Alex Feinberg,2015-01-28 16:46:06-08:00,['4779a2c5e1f2735be88bd3119b9e874f6a644b28'],4,1,5,525318,1,1,0,0,1242
b390179c0f949a971b626b2ba27060b4ea9f8107,1,Michael Percy,2015-01-28 17:12:10-08:00,['516582e32b83e9628a0378436516a49ac2d11610'],35,1470,1505,526823,11,0.47634584,0.820554649,0.717781403,1245
05ed814b61f2531d8ab3a3b81317f56942b5492b,0,Andrew Wang,2015-01-28 17:19:37-08:00,['b390179c0f949a971b626b2ba27060b4ea9f8107'],8,31,39,526862,5,1,1,1,1245
6e24216199a652392c6a1a8626ddb940c89885ad,0,Andrew Wang,2015-01-29 12:53:37-08:00,['05ed814b61f2531d8ab3a3b81317f56942b5492b'],17,18,35,526897,1,,,,1245
32d34e124cfa1a9536b26d8f558df4cbc0c70d72,1,Andrew Wang,2015-01-29 13:08:12-08:00,['6e24216199a652392c6a1a8626ddb940c89885ad'],103,113,216,527113,49,0,,1,1245
65c3397d5459ae34c68967381aaae1155b9dbc8e,0,Andrew Wang,2015-01-29 13:08:43-08:00,['32d34e124cfa1a9536b26d8f558df4cbc0c70d72'],0,10,10,527123,1,0,1,1,1245
4f6f5898becb57882bf35f0f5febb2821478bc82,1,Jean-Daniel Cryans,2015-01-30 15:15:10-08:00,['65c3397d5459ae34c68967381aaae1155b9dbc8e'],136,593,729,527852,21,0.398190045,0.828054299,0.809954751,1248
4e4e5440dfa8fedcfe46d54e92e6bcffaa3995f4,1,Michael Percy,2015-01-30 16:16:38-08:00,['4f6f5898becb57882bf35f0f5febb2821478bc82'],18,22,40,527892,5,0,1,0,1248
951262471adc506ff49195589df332e0050f6288,0,Adar Dembo,2015-01-30 17:09:28-08:00,['4e4e5440dfa8fedcfe46d54e92e6bcffaa3995f4'],121,430,551,528443,8,1,1,0.931034483,1252
f682fa90d32636f1609316db8de5911d97972a97,0,Jean-Daniel Cryans,2015-02-02 10:53:43-08:00,['951262471adc506ff49195589df332e0050f6288'],18,18,36,528479,5,0,0,0,1252
5bb626c2251c6ba829e491cc62cbb30f5bcfe86b,1,Jean-Daniel Cryans,2015-02-02 10:53:55-08:00,['f682fa90d32636f1609316db8de5911d97972a97'],37,45,82,528561,5,1,1,1,1252
8d6a0abe81dce531bd5b46aa8cd04cfdff354ef1,1,Adar Dembo,2015-02-02 14:39:00-08:00,['5bb626c2251c6ba829e491cc62cbb30f5bcfe86b'],22,22,44,528605,4,0,0,0,1252
7e6383dcfb66c65944efd96d5078069aba9fe611,0,Alex Feinberg,2015-02-02 16:13:41-08:00,['8d6a0abe81dce531bd5b46aa8cd04cfdff354ef1'],7,8,15,528620,2,1,1,0,1252
e3888892c1955deb3d25b9d80fe178b9eff08bad,1,Michael Percy,2015-02-02 16:54:56-08:00,['7e6383dcfb66c65944efd96d5078069aba9fe611'],39,177,216,528836,6,0.065217391,0.923913043,0.858695652,1252
c97fbbde153044b36970325e9250674e0a4dbe19,1,Michael Percy,2015-02-02 16:55:44-08:00,['e3888892c1955deb3d25b9d80fe178b9eff08bad'],176,58,234,529070,10,0.338709677,0,1,1252
92f8d94f0ed621c4126dfc264fad54bd020b8135,0,Todd Lipcon,2015-02-03 06:49:42-08:00,['c97fbbde153044b36970325e9250674e0a4dbe19'],2,2,4,529074,2,,,,1252
7d367598daf032ca94fce7bd59860adffa486683,1,Alex Feinberg,2015-02-03 15:30:18-08:00,['92f8d94f0ed621c4126dfc264fad54bd020b8135'],20,107,127,529201,6,0,0.948275862,0.206896552,1252
1ec392551e05e5a55a0768b29b3c4962eddfb4e1,0,Adar Dembo,2015-02-04 10:29:51-08:00,['7d367598daf032ca94fce7bd59860adffa486683'],15,0,15,529216,2,0,0,0,1252
ee5bc8e9253420d6298726a57510af4e194c13dd,0,Adar Dembo,2015-02-04 15:55:59-08:00,['1ec392551e05e5a55a0768b29b3c4962eddfb4e1'],21,8,29,529245,1,1,1,0,1252
16be2d725f6f4656ffaee0f6dcb81881b6373566,0,Alex Feinberg,2015-02-04 16:04:25-08:00,['ee5bc8e9253420d6298726a57510af4e194c13dd'],11,17,28,529273,2,1,1,1,1252
729403381adb69ce9f078a26615c674915b44623,0,Michael Percy,2015-02-04 16:55:28-08:00,['16be2d725f6f4656ffaee0f6dcb81881b6373566'],1,116,117,529390,7,0.292307692,1,0.753846154,1252
ca7f418d15c5c05cb9422b1e4ff1355a0dd378e7,1,Michael Percy,2015-02-04 16:55:34-08:00,['729403381adb69ce9f078a26615c674915b44623'],84,99,183,529573,5,1,0,1,1252
fb4eab557d1b237abbea2f54955e62475c962803,1,Michael Percy,2015-02-04 16:55:51-08:00,['ca7f418d15c5c05cb9422b1e4ff1355a0dd378e7'],155,256,411,529984,7,1,1,1,1254
e584985312c46c2710c19b041fdab907e8b5d09e,0,Michael Percy,2015-02-04 17:14:49-08:00,['fb4eab557d1b237abbea2f54955e62475c962803'],4,6,10,529994,1,0,0,0,1254
c838c0b59d54f09606d58e27b1b90814998218d4,0,Adar Dembo,2015-02-04 21:31:28-08:00,['e584985312c46c2710c19b041fdab907e8b5d09e'],3,9,12,530006,1,,,,1254
ee4c152a4259c333a5d3526e41642e6abd2fef21,1,Jean-Daniel Cryans,2015-02-05 06:41:21-08:00,['c838c0b59d54f09606d58e27b1b90814998218d4'],10,195,205,530211,15,0.32173913,1,0.895652174,1254
f134fb87531808bc1ee39a5ec145990b451180f4,0,Jean-Daniel Cryans,2015-02-05 15:54:29-08:00,['ee4c152a4259c333a5d3526e41642e6abd2fef21'],4,22,26,530237,3,1,1,1,1254
b4727f41d33f1e50033c69bf206883ad43f3a5f7,0,Adar Dembo,2015-02-05 16:39:03-08:00,['f134fb87531808bc1ee39a5ec145990b451180f4'],1,0,1,530238,1,,,,1254
5744d441d78b00a33e5ab4647fa9013acdad570c,0,David Alves,2015-02-06 15:08:05-08:00,['b4727f41d33f1e50033c69bf206883ad43f3a5f7'],33,10,43,530281,1,0,0,0,1254
9689272e45bdeabe89fdbf675d2e49e71837feb8,1,Andrew Wang,2015-02-09 12:50:31-08:00,['5744d441d78b00a33e5ab4647fa9013acdad570c'],32,96,128,530409,13,0.411764706,1,0.411764706,1254
1c17f61a5c7488ba7e31eb7d2580f9890c7404da,0,David Alves,2015-02-09 15:39:04-08:00,['9689272e45bdeabe89fdbf675d2e49e71837feb8'],2,11,13,530422,2,1,1,1,1254
ac5d60e9f7079d2948186e20f908dcac757eb0f3,0,David Alves,2015-02-09 15:57:27-08:00,['1c17f61a5c7488ba7e31eb7d2580f9890c7404da'],1,2,3,530425,1,0,1,1,1254
0844479537409262b64c57a412f8dce52e865ecd,0,David Alves,2015-02-09 17:17:30-08:00,['ac5d60e9f7079d2948186e20f908dcac757eb0f3'],2,1,3,530428,1,1,0,0,1254
3525ecc2a453499d516645fcf2ae6b657a9e9ad8,0,David Alves,2015-02-09 19:14:00-08:00,['0844479537409262b64c57a412f8dce52e865ecd'],14,23,37,530465,6,1,1,1,1254
b24fc16f6c0ed75fd58455e3e1fb790f8f2d1d14,0,David Alves,2015-02-09 19:14:07-08:00,['3525ecc2a453499d516645fcf2ae6b657a9e9ad8'],0,31,31,530496,2,0,0.814814815,1,1254
43533ecb5d15ed16eb1c0d7ac68676689c6fc7eb,1,Michael Percy,2015-02-10 12:08:58-08:00,['b24fc16f6c0ed75fd58455e3e1fb790f8f2d1d14'],98,87,185,530681,5,0.125,0,0,1254
d028ab043a6f718e54d15746e23807a2e6918ab0,1,Michael Percy,2015-02-10 12:10:38-08:00,['43533ecb5d15ed16eb1c0d7ac68676689c6fc7eb'],35,61,96,530777,4,0,1,1,1254
5389b00a5aa73eed1351fc9b08466eff0773aaa1,0,Adar Dembo,2015-02-11 11:31:28-08:00,['d028ab043a6f718e54d15746e23807a2e6918ab0'],1,5,6,530783,1,1,1,1,1254
b86837def67461687378f6c3ad0db4f0897be71c,0,David Alves,2015-02-11 11:33:59-08:00,['5389b00a5aa73eed1351fc9b08466eff0773aaa1'],4,19,23,530806,3,1,1,1,1254
af7055c626636eaa938dd966d084d244b5f85aff,0,Todd Lipcon,2015-02-11 12:07:46-08:00,['b86837def67461687378f6c3ad0db4f0897be71c'],31,30,61,530867,5,,,,1254
7c806ad46e5e92cbcc2b4d90cfe940c9dd782f91,1,Andrew Wang,2015-02-11 12:35:39-08:00,['af7055c626636eaa938dd966d084d244b5f85aff'],1,11,12,530879,3,0,1,1,1254
01233222e594c9e460e541a29875998e1e3b873c,1,Andrew Wang,2015-02-11 16:44:56-08:00,['7c806ad46e5e92cbcc2b4d90cfe940c9dd782f91'],5,466,471,531350,6,0.56424581,0.793296089,1,1257
32bde89f1fcf0d29ac565cc82d7efdc417e50a91,0,Michael Percy,2015-02-11 16:47:19-08:00,['01233222e594c9e460e541a29875998e1e3b873c'],11,4,15,531365,1,1,1,0,1257
822f6b6ae574f8eaf4e1640f9f02af8768965d61,1,Michael Percy,2015-02-11 19:43:10-08:00,['32bde89f1fcf0d29ac565cc82d7efdc417e50a91'],127,207,334,531699,2,0.516129032,0,0.322580645,1257
31057e1031c55f61f0af4a628473ea60c9250999,0,Michael Percy,2015-02-11 21:00:49-08:00,['822f6b6ae574f8eaf4e1640f9f02af8768965d61'],5,29,34,531733,3,1,1,0.235294118,1257
474000ae74857b749e7c6b2471866cc8d51d6e19,1,Todd Lipcon,2015-02-12 08:32:50-08:00,['31057e1031c55f61f0af4a628473ea60c9250999'],1,2,3,531736,1,,,,1257
0366a04c42a8f46e22db18e8a147b91f8ae22579,0,Andrew Wang,2015-02-12 12:52:11-08:00,['474000ae74857b749e7c6b2471866cc8d51d6e19'],6,9,15,531751,1,0.333333333,0.333333333,1,1257
28bccdbfe04ed63475ddb5cc629d6b781cd34b1c,0,Todd Lipcon,2015-02-13 12:29:36-08:00,['0366a04c42a8f46e22db18e8a147b91f8ae22579'],2,12,14,531765,1,1,1,1,1257
670f5209722c075a9a74a250ac178f41c0851f6c,1,Todd Lipcon,2015-02-15 10:28:45-08:00,['28bccdbfe04ed63475ddb5cc629d6b781cd34b1c'],174,705,879,532644,15,0.585062241,1,0.763485477,1260
691f97d3f8e87ea163a2fe700bd43246025b5036,1,Todd Lipcon,2015-02-15 10:34:52-08:00,['670f5209722c075a9a74a250ac178f41c0851f6c'],137,288,425,533069,21,0.180722892,0.987951807,0.807228916,1260
68b4e4b21152ef583a5aa6b5b3cd67892dc1e8cd,1,Todd Lipcon,2015-02-15 11:06:16-08:00,['691f97d3f8e87ea163a2fe700bd43246025b5036'],10,336,346,533415,6,0.014018692,0.593457944,0.448598131,1260
2d6d79307c500ce31d981ed5c9f54249f8ccb459,0,Todd Lipcon,2015-02-15 11:07:08-08:00,['68b4e4b21152ef583a5aa6b5b3cd67892dc1e8cd'],0,22,22,533437,1,1,1,1,1261
6f2b36429dc8415c05cdd5f41a842655bf7811b1,1,Todd Lipcon,2015-02-17 14:17:46-08:00,['2d6d79307c500ce31d981ed5c9f54249f8ccb459'],60,258,318,533755,4,0.611570248,0.966942149,0.115702479,1261
85887a73f5e4469589092f0771ce2059ed22a69b,1,Todd Lipcon,2015-02-17 14:18:14-08:00,['6f2b36429dc8415c05cdd5f41a842655bf7811b1'],225,260,485,534240,13,1,1,0,1261
91724707dfad084854accc5333b547ed3420bdef,0,Todd Lipcon,2015-02-18 10:39:11-08:00,['85887a73f5e4469589092f0771ce2059ed22a69b'],10,41,51,534291,3,0.666666667,0.666666667,1,1261
d857f0f2e442b01bbb15913801e280ae9ba66e5c,0,Todd Lipcon,2015-02-18 10:39:17-08:00,['91724707dfad084854accc5333b547ed3420bdef'],17,24,41,534332,1,0,1,0,1261
341c3546f2394fecd6220751d035b6e1f5cbb0de,0,Todd Lipcon,2015-02-18 14:36:47-08:00,['d857f0f2e442b01bbb15913801e280ae9ba66e5c'],16,22,38,534370,3,1,1,1,1261
07c779ee550492326ecbc0a4c2bcc1a1b859b67b,0,Todd Lipcon,2015-02-18 15:31:25-08:00,['341c3546f2394fecd6220751d035b6e1f5cbb0de'],37,64,101,534471,3,0.5,0.875,1,1261
10cae2e6be8c4c2e0154ecdf1afb399a86c5c703,1,Michael Percy,2015-02-18 16:21:55-08:00,['07c779ee550492326ecbc0a4c2bcc1a1b859b67b'],49,122,171,534642,6,1,1,0.76744186,1261
49a3a1fec51fa395daa1a9b56252b516c3421499,1,Adar Dembo,2015-02-18 19:55:47-08:00,['10cae2e6be8c4c2e0154ecdf1afb399a86c5c703'],17,470,487,535129,6,0.324324324,0.521235521,0.362934363,1261
17f9e0234843639832dd69e75e07b6945fd1f83b,0,Adar Dembo,2015-02-18 19:59:39-08:00,['49a3a1fec51fa395daa1a9b56252b516c3421499'],58,77,135,535264,3,0,1,1,1261
0fbded2db70d0cf66f82ef1c050ac2fc3e269a19,0,Adar Dembo,2015-02-19 17:51:45-08:00,['17f9e0234843639832dd69e75e07b6945fd1f83b'],0,2,2,535266,1,0,1,1,1261
2edb842cf15295931bf3afe3032de00859de825a,0,Jean-Daniel Cryans,2015-02-19 19:46:46-08:00,['0fbded2db70d0cf66f82ef1c050ac2fc3e269a19'],3,13,16,535282,1,0,1,0,1261
81381dc4cb7033a8c452cb9268e37f57b9d08347,1,Michael Percy,2015-02-19 20:12:37-08:00,['2edb842cf15295931bf3afe3032de00859de825a'],3,9,12,535294,2,0,0,0,1261
24b6f4256c6579bb2bde4218e640ff0c8381245c,0,David Alves,2015-02-19 20:29:25-08:00,['81381dc4cb7033a8c452cb9268e37f57b9d08347'],14,0,14,535308,4,0.25,0,0,1261
a4237f31988553be3c1ed33009f77420e2e15eb7,1,Adar Dembo,2015-02-20 16:38:49-08:00,['24b6f4256c6579bb2bde4218e640ff0c8381245c'],83,202,285,535593,11,1,1,0.659574468,1263
888f8c946c3f5378ca52d85d0955e2614cd95318,0,Todd Lipcon,2015-02-21 13:55:13-08:00,['a4237f31988553be3c1ed33009f77420e2e15eb7'],4,2,6,535599,1,,,,1263
6bc17a1b6f7a379ec81dd53cf25e1d54db74a500,1,Todd Lipcon,2015-02-21 13:56:14-08:00,['888f8c946c3f5378ca52d85d0955e2614cd95318'],0,9,9,535608,2,1,1,1,1263
c98c977a23f2c3441659dab530594cc939e0de72,0,Todd Lipcon,2015-02-21 13:57:50-08:00,['6bc17a1b6f7a379ec81dd53cf25e1d54db74a500'],1,16,17,535625,1,1,1,1,1263
ee840b446ef90c7cd6f3a03c0bceb7cb365abb58,0,Todd Lipcon,2015-02-21 14:02:42-08:00,['c98c977a23f2c3441659dab530594cc939e0de72'],1,1,2,535627,1,,,,1263
1515389d5bed09ff83806477464bf5f424ef3ffe,0,Todd Lipcon,2015-02-21 14:07:40-08:00,['ee840b446ef90c7cd6f3a03c0bceb7cb365abb58'],18,16,34,535661,6,0,1,1,1263
f45caaad3ebe2998ac629102ac55fc5a4f7d8fd3,0,Todd Lipcon,2015-02-21 14:12:36-08:00,['1515389d5bed09ff83806477464bf5f424ef3ffe'],40,55,95,535756,2,0.545454545,1,1,1263
7cc9fcd9632dc44eeff55b5dc93fbc642a739e60,1,Adar Dembo,2015-02-23 14:10:11-08:00,['f45caaad3ebe2998ac629102ac55fc5a4f7d8fd3'],41,80,121,535877,4,0,0.78125,0.65625,1263
90bd040aee0dbe6f94de233732cd932c7d696a83,0,Michael Percy,2015-02-23 16:26:12-08:00,['7cc9fcd9632dc44eeff55b5dc93fbc642a739e60'],10,93,103,535980,4,1,1,1,1263
b5b829d4dd0b70434e1eef4000a8194fd608f035,0,Todd Lipcon,2015-02-23 23:37:08-08:00,['90bd040aee0dbe6f94de233732cd932c7d696a83'],5,19,24,536004,2,0.333333333,1,1,1263
a92d7ba3aa4b9ec2c9cb3b066462813599750b02,0,Todd Lipcon,2015-02-23 23:38:01-08:00,['b5b829d4dd0b70434e1eef4000a8194fd608f035'],9,0,9,536013,2,0,0,0,1263
8c61f239392502b81e878756d038074c2365d695,1,David Alves,2015-02-24 00:08:31-08:00,['a92d7ba3aa4b9ec2c9cb3b066462813599750b02'],9,217,226,536239,9,0.291666667,0.986111111,0.972222222,1265
d36cd08a5b22143e782e6dbdca48091f80569b46,0,David Alves,2015-02-24 00:08:40-08:00,['8c61f239392502b81e878756d038074c2365d695'],14,84,98,536337,6,0.542857143,1,0.971428571,1265
6ca6f1e74a892ea9ff91159c33084c09a59da204,0,Todd Lipcon,2015-02-24 14:03:40-08:00,['d36cd08a5b22143e782e6dbdca48091f80569b46'],47,64,111,536448,7,1,1,1,1265
d3d1656f739b77b6b47815e3f5acb0895c516633,1,Todd Lipcon,2015-02-24 18:14:11-08:00,['6ca6f1e74a892ea9ff91159c33084c09a59da204'],13,90,103,536551,3,1,1,1,1265
7f1dc20ff7adb7dec242079096adba450b0e20e7,1,David Alves,2015-02-24 18:38:05-08:00,['d3d1656f739b77b6b47815e3f5acb0895c516633'],30,79,109,536660,10,0.5,0.785714286,1,1265
3b90881db8c684943e7b0f650e23f21ee7856556,0,David Alves,2015-02-24 18:38:11-08:00,['7f1dc20ff7adb7dec242079096adba450b0e20e7'],25,25,50,536710,5,0.2,1,0,1265
5693f691035ea1a8675848dd5a06bf6e96ae81a5,0,Todd Lipcon,2015-02-25 14:01:42-08:00,['3b90881db8c684943e7b0f650e23f21ee7856556'],11,51,62,536772,2,0.857142857,1,0.571428571,1265
324375c6987daf76d62a818ae977827dc0a67cf9,0,David Alves,2015-02-25 14:40:29-08:00,['5693f691035ea1a8675848dd5a06bf6e96ae81a5'],35,46,81,536853,7,1,1,1,1265
2ffda1f47bac9475c476a0c6c9ab0036a542868f,0,David Alves,2015-02-25 14:53:34-08:00,['324375c6987daf76d62a818ae977827dc0a67cf9'],5,9,14,536867,3,0,1,1,1265
ae5efab3e564c51b7306e025f82c5ed63fa648d5,1,Todd Lipcon,2015-02-25 15:23:38-08:00,['2ffda1f47bac9475c476a0c6c9ab0036a542868f'],17,53,70,536937,3,0.291666667,1,1,1265
e67c31a26e930a2bf186e6600132ea3d76b0c7da,1,David Alves,2015-02-25 15:33:42-08:00,['ae5efab3e564c51b7306e025f82c5ed63fa648d5'],104,390,494,537431,37,0,0.476821192,0.238410596,1265
f3bfa01f80ca10c5a6262333c181c388e657b04f,0,David Alves,2015-02-25 15:33:50-08:00,['e67c31a26e930a2bf186e6600132ea3d76b0c7da'],1,2,3,537434,1,0,1,1,1265
1a6b80a310a7de3519d78a2f5e90ecaae1cf405a,1,David Alves,2015-02-25 15:33:57-08:00,['f3bfa01f80ca10c5a6262333c181c388e657b04f'],18,69,87,537521,6,0.925925926,0.851851852,1,1265
203e00a4b0e67a384da784e842f072b61dd5db79,0,Andrew Wang,2015-02-25 18:14:21-08:00,['1a6b80a310a7de3519d78a2f5e90ecaae1cf405a'],9,3,12,537533,1,,,,1265
3b074a0c40e354d01fbe2abb06fb3b1801bc85b7,0,Andrew Wang,2015-02-25 18:15:17-08:00,['203e00a4b0e67a384da784e842f072b61dd5db79'],1,0,1,537534,1,0,0,0,1265
e5b2260fabcee4915c9a14bdcf11202565471470,0,Todd Lipcon,2015-02-26 13:25:36-08:00,['3b074a0c40e354d01fbe2abb06fb3b1801bc85b7'],1,19,20,537554,2,0,1,1,1265
31679f93105f9c6d547bbd88822aa7d3f1311c1c,0,Todd Lipcon,2015-02-26 13:27:20-08:00,['e5b2260fabcee4915c9a14bdcf11202565471470'],3,5,8,537562,2,0,1,1,1265
728d96fc174a65eae807f77b01df540065cc9e61,1,Michael Percy,2015-02-26 13:59:42-08:00,['31679f93105f9c6d547bbd88822aa7d3f1311c1c'],27,27,54,537616,7,,,,1265
c0400523ffa113d1eb7cc70952a2b65610014afb,0,Todd Lipcon,2015-02-26 17:01:19-08:00,['728d96fc174a65eae807f77b01df540065cc9e61'],1,5,6,537622,1,0,1,1,1265
16b5cfbf19a0a6f6dec24e301d416d33d1e0bb4f,1,Jean-Daniel Cryans,2015-02-27 08:11:33-08:00,['c0400523ffa113d1eb7cc70952a2b65610014afb'],4,46,50,537672,8,1,1,1,1265
b2a6851850efda7f17be90c204a225b3696d7eb5,0,David Alves,2015-02-27 11:29:32-08:00,['16b5cfbf19a0a6f6dec24e301d416d33d1e0bb4f'],0,23,23,537695,3,1,1,1,1265
aebe86a5ade635c41d633a04c392b22af05e8a1e,1,Jean-Daniel Cryans,2015-03-02 11:42:56-08:00,['b2a6851850efda7f17be90c204a225b3696d7eb5'],21,162,183,537878,11,0.794871795,1,1,1265
5951bd705124cb5a87ebff00888200135c56643f,1,Michael Percy,2015-03-02 11:50:34-08:00,['aebe86a5ade635c41d633a04c392b22af05e8a1e'],1,16,17,537895,3,0.857142857,1,1,1265
af3b00365a5849eb6883ca7e5fb9e4f588f2e0ed,0,David Alves,2015-03-02 22:37:58-08:00,['5951bd705124cb5a87ebff00888200135c56643f'],22,125,147,538042,2,0.222222222,1,0.682539683,1265
30d026ed7ef6a533fb41fe74563cf9da8a3976d2,1,David Alves,2015-03-02 23:06:24-08:00,['af3b00365a5849eb6883ca7e5fb9e4f588f2e0ed'],40,66,106,538148,1,0.785714286,1,0,1265
e640a8b4b4caac6ac4421148be70c3a42c861101,1,David Alves,2015-03-02 23:06:32-08:00,['30d026ed7ef6a533fb41fe74563cf9da8a3976d2'],13,77,90,538238,5,0.2,0.857142857,0.8,1265
e8ab74d089e0a955c25a5cf1175ae7aa54e363df,0,Adar Dembo,2015-03-03 14:11:28-08:00,['e640a8b4b4caac6ac4421148be70c3a42c861101'],17,33,50,538288,4,1,1,0.909090909,1265
3abad553f2b15b1ba4f08c5d128f3f0868fdba31,1,David Alves,2015-03-03 16:41:26-08:00,['e8ab74d089e0a955c25a5cf1175ae7aa54e363df'],1,2,3,538291,1,0,,,1265
d8c6729b30f1f16b83d24aefe6187c9d5c1c5ec0,0,Jean-Daniel Cryans,2015-03-03 19:48:24-08:00,['3abad553f2b15b1ba4f08c5d128f3f0868fdba31'],8,16,24,538315,3,0,0.666666667,0.666666667,1265
7d92ed62b252a2c85f72c26792c067d65f5e0b06,0,Adar Dembo,2015-03-03 20:13:26-08:00,['d8c6729b30f1f16b83d24aefe6187c9d5c1c5ec0'],0,13,13,538328,1,0,1,1,1265
a1ae8ab83543c700b3c1a469e544955b81796b92,0,Adar Dembo,2015-03-03 20:14:10-08:00,['7d92ed62b252a2c85f72c26792c067d65f5e0b06'],2,42,44,538372,4,1,1,1,1265
ed6bb7cab79a9b17ef6107351897a23d8e72b3cf,1,Adar Dembo,2015-03-03 20:15:05-08:00,['a1ae8ab83543c700b3c1a469e544955b81796b92'],28,275,303,538675,16,0.310344828,0.931034483,0.396551724,1267
c5ed8b893fa3dc4b0ae65044b5354cc7ecb7c756,1,Adar Dembo,2015-03-03 20:15:10-08:00,['ed6bb7cab79a9b17ef6107351897a23d8e72b3cf'],24,191,215,538890,5,0.33,0.97,0.82,1267
7abdbdf48affd38fb7d6f358cff5d8fe787e289c,0,Todd Lipcon,2015-03-04 00:03:03-08:00,['c5ed8b893fa3dc4b0ae65044b5354cc7ecb7c756'],50,5,55,538945,12,0.285714286,1,0,1267
079e8549dfe06e828d2c5839ea4afeb490cc1458,1,Todd Lipcon,2015-03-04 10:27:05-08:00,['7abdbdf48affd38fb7d6f358cff5d8fe787e289c'],0,11,11,538956,3,0,0.1,0,1267
45508bca0620eff7779856da8443da089e077839,0,Todd Lipcon,2015-03-05 09:50:39-08:00,['079e8549dfe06e828d2c5839ea4afeb490cc1458'],25,12,37,538993,2,0.333333333,0,1,1267
ca56c386b3226438c93147d5378f6ccfc6b4f29d,1,Todd Lipcon,2015-03-05 09:52:47-08:00,['45508bca0620eff7779856da8443da089e077839'],11,32,43,539036,4,0,0.916666667,0.916666667,1267
8733d256a024eac0819fb4009d499edc3183b559,0,Todd Lipcon,2015-03-05 11:22:49-08:00,['ca56c386b3226438c93147d5378f6ccfc6b4f29d'],1,1,2,539038,1,,,,1267
f3bee5b017db8bb9c699dd823abb11c54a81456b,1,Andrew Wang,2015-03-05 18:33:54-08:00,['8733d256a024eac0819fb4009d499edc3183b559'],5,5,10,539048,2,,,,1267
a15c795360e32885c00442efacd2a345f993f425,1,Jean-Daniel Cryans,2015-03-06 13:20:55-08:00,['f3bee5b017db8bb9c699dd823abb11c54a81456b'],70,510,580,539628,8,0.664122137,0.988549618,0.671755725,1267
bef59f6cd4e182f2ec74a1f683b3a69216aa3373,1,Jean-Daniel Cryans,2015-03-06 13:21:32-08:00,['a15c795360e32885c00442efacd2a345f993f425'],55,54,109,539737,3,1,1,1,1267
9ac072bcf4695953130775922acc337de35c2f4c,1,Jean-Daniel Cryans,2015-03-06 13:22:39-08:00,['bef59f6cd4e182f2ec74a1f683b3a69216aa3373'],12,75,87,539824,4,0,0.88,0.68,1267
59f7509de1146106afde0312a1568f4d717f1cab,1,Jean-Daniel Cryans,2015-03-06 13:23:29-08:00,['9ac072bcf4695953130775922acc337de35c2f4c'],124,70,194,540018,5,0,0,0.766666667,1267
5c7bc2cca80d98a29efa2134c3ea0d5b3a599f5a,0,Todd Lipcon,2015-03-09 17:00:52-07:00,['59f7509de1146106afde0312a1568f4d717f1cab'],49,50,99,540117,3,0.333333333,0,0,1267
ca3549f248a03fb2ce8e3bf41d3fd4ad5959cad7,0,Todd Lipcon,2015-03-09 17:01:02-07:00,['5c7bc2cca80d98a29efa2134c3ea0d5b3a599f5a'],2,5,7,540124,1,,,,1267
ec4c6e936399f3f9e4c9d74a9e38f014de3b4369,1,Jean-Daniel Cryans,2015-03-09 21:19:48-07:00,['ca3549f248a03fb2ce8e3bf41d3fd4ad5959cad7'],2,157,159,540283,1,0.247706422,1,0.862385321,1267
56b70f6ace05949ca86927856719327f5f17bc1c,1,Jean-Daniel Cryans,2015-03-09 21:19:52-07:00,['ec4c6e936399f3f9e4c9d74a9e38f014de3b4369'],34,11,45,540328,3,0.571428571,0.071428571,0,1267
0f50cccb10c5ea1a76f8f34820085fdea5e13264,1,David Alves,2015-03-09 21:38:17-07:00,['56b70f6ace05949ca86927856719327f5f17bc1c'],0,21,21,540349,2,0,0,0.533333333,1267
e88393e07f27b87cf36c8b2db21ebc816f4a9b55,1,Andrew Wang,2015-03-09 22:58:28-07:00,['0f50cccb10c5ea1a76f8f34820085fdea5e13264'],40,92,132,540481,3,0,0.735294118,1,1267
82cf3724077a8fb639a44dd86f04d10ecbedabf4,1,Todd Lipcon,2015-03-10 14:45:18-07:00,['e88393e07f27b87cf36c8b2db21ebc816f4a9b55'],7,44,51,540532,2,0.2,1,1,1267
a70fd8a2753d65712f68373f0fea43cc5794b161,1,Jean-Daniel Cryans,2015-03-10 15:19:41-07:00,['82cf3724077a8fb639a44dd86f04d10ecbedabf4'],24,53,77,540609,5,1,1,1,1267
8cdd7213a28cd78de40c73c925ccd2f148590912,1,Jean-Daniel Cryans,2015-03-10 15:27:06-07:00,['a70fd8a2753d65712f68373f0fea43cc5794b161'],58,53,111,540720,3,1,1,0,1267
3027c7d1a781d468fa1d4fb7a47a013203bf6a47,0,Jean-Daniel Cryans,2015-03-10 15:37:57-07:00,['8cdd7213a28cd78de40c73c925ccd2f148590912'],5,5,10,540730,2,,,,1267
99e34ac43316598a35e5cd45a1cceb09acf1f669,0,Todd Lipcon,2015-03-10 15:53:02-07:00,['3027c7d1a781d468fa1d4fb7a47a013203bf6a47'],5,0,5,540735,1,,,,1267
dbf06caf63c5b9a87212c47a5aa6df89a05ae3f2,1,Jean-Daniel Cryans,2015-03-10 20:04:10-07:00,['99e34ac43316598a35e5cd45a1cceb09acf1f669'],68,130,198,540933,3,0.222222222,1,1,1267
0fe926f08603b3f37f5aa5002332240b56f4b50e,0,Adar Dembo,2015-03-10 21:34:15-07:00,['dbf06caf63c5b9a87212c47a5aa6df89a05ae3f2'],11,44,55,540988,3,0,1,1,1268
cb4ce2c2517ea700438dcb220e3501871c15acad,1,David Alves,2015-03-11 10:00:51-07:00,['0fe926f08603b3f37f5aa5002332240b56f4b50e'],918,444,1362,542350,20,0.632286996,0.565022422,0.174887892,1268
2639a081bb08d000fceab019123835f040a2997d,0,Jean-Daniel Cryans,2015-03-11 12:24:14-07:00,['cb4ce2c2517ea700438dcb220e3501871c15acad'],14,52,66,542416,3,1,1,1,1269
5b5bc61cdbea1f65055768b5519d13c3d787508d,1,Adar Dembo,2015-03-11 16:54:45-07:00,['2639a081bb08d000fceab019123835f040a2997d'],0,47,47,542463,4,0.46875,1,1,1269
cc94a783f85370611f775803f26078bfb1625000,1,Michael Percy,2015-03-11 20:06:12-07:00,['5b5bc61cdbea1f65055768b5519d13c3d787508d'],71,157,228,542691,6,0.377358491,0.075471698,0.962264151,1269
bea4a278a7e79a68d858bc68567edabbd45cfa10,1,Jean-Daniel Cryans,2015-03-12 15:15:58-07:00,['cc94a783f85370611f775803f26078bfb1625000'],34,62,96,542787,3,0.3,1,1,1269
f833ae241f3e7b9bb12b8b95ab9a0b0f22433ef4,1,Todd Lipcon,2015-03-12 16:27:15-07:00,['bea4a278a7e79a68d858bc68567edabbd45cfa10'],34,92,126,542913,5,0.289473684,0,0.657894737,1269
c11b7a41f1a3be53aad3de46e5bf88e10d5e758b,1,Michael Percy,2015-03-12 17:21:06-07:00,['f833ae241f3e7b9bb12b8b95ab9a0b0f22433ef4'],58,57,115,543028,13,0,1,0.75,1269
ed3caaa6b34e53e8f977d774414227b025c7982e,0,Adar Dembo,2015-03-12 18:54:20-07:00,['c11b7a41f1a3be53aad3de46e5bf88e10d5e758b'],2,2,4,543032,1,,,,1269
b76cce3d693e8f18e28c8da9ea7da62a250c4fa3,0,Todd Lipcon,2015-03-13 14:14:27-07:00,['ed3caaa6b34e53e8f977d774414227b025c7982e'],1,10,11,543043,2,0,1,0.75,1269
f8690f59d1e166097ea2f67eaf3f3ab9fd04ee34,1,David Alves,2015-03-13 15:23:58-07:00,['b76cce3d693e8f18e28c8da9ea7da62a250c4fa3'],14,125,139,543182,7,1,1,0.955555556,1269
3568fdbf504495f2001bd43ddfec2babf740fe0e,0,David Alves,2015-03-15 20:56:43-07:00,['f8690f59d1e166097ea2f67eaf3f3ab9fd04ee34'],2,11,13,543195,2,0,1,0,1269
38be13b914a0b78403300feb51c3bbf63ca644ca,0,David Alves,2015-03-15 21:18:16-07:00,['3568fdbf504495f2001bd43ddfec2babf740fe0e'],0,10,10,543205,2,1,1,1,1269
6439d8d1b2fc685e400dc4992a96f0db1f2fa900,1,Andrew Wang,2015-03-16 15:22:34-07:00,['38be13b914a0b78403300feb51c3bbf63ca644ca'],142,233,375,543580,16,0.529411765,0.980392157,1,1269
769bcb67b5beb187511e000e6ecfa5cd8c0c85de,1,David Alves,2015-03-16 19:50:02-07:00,['6439d8d1b2fc685e400dc4992a96f0db1f2fa900'],58,59,117,543697,25,1,0,0.5,1269
782ffc04975e5e92601ec4e4b602a8994e8e4529,1,David Alves,2015-03-16 19:50:07-07:00,['769bcb67b5beb187511e000e6ecfa5cd8c0c85de'],7,18,25,543722,1,1,1,0,1269
b9955cc2fc9c2114fdb8a78f5eb168830e21c916,0,Michael Percy,2015-03-17 12:42:20-07:00,['782ffc04975e5e92601ec4e4b602a8994e8e4529'],39,43,82,543804,6,0,1,1,1269
b6f3446ca1dae692415eb1649a24da4a944ba14a,0,Todd Lipcon,2015-03-17 15:03:08-07:00,['b9955cc2fc9c2114fdb8a78f5eb168830e21c916'],119,190,309,544113,1,,,,1269
422611451eb522a53f23156b1f7c3f7f81f1eaf8,1,Michael Percy,2015-03-17 16:45:37-07:00,['b6f3446ca1dae692415eb1649a24da4a944ba14a'],90,38,128,544241,10,0,0,1,1269
a0730b555b33ed16530009a59c1435534b8e3567,0,Misty Stanley-Jones,2015-03-17 17:54:22-07:00,['422611451eb522a53f23156b1f7c3f7f81f1eaf8'],0,0,0,544241,1,,,,1269
11fe8c9f5a95541c094eb86b37ed3406ec50977e,1,Jean-Daniel Cryans,2015-03-17 19:28:12-07:00,['a0730b555b33ed16530009a59c1435534b8e3567'],108,229,337,544578,37,1,1,1,1271
de2a51c08a915213e784eaae80194450804c1a96,0,David Alves,2015-03-19 09:49:12-07:00,['11fe8c9f5a95541c094eb86b37ed3406ec50977e'],1,3,4,544582,1,1,1,1,1271
c82138038c32ced5d27d8e79336c29876466b513,0,David Alves,2015-03-19 09:49:19-07:00,['de2a51c08a915213e784eaae80194450804c1a96'],4,3,7,544589,1,,,,1271
3e1cdb6e3c7c0374d3c3fafa72898b0aae99ce37,0,David Alves,2015-03-19 11:10:07-07:00,['c82138038c32ced5d27d8e79336c29876466b513'],6,15,21,544610,4,0.6,1,0.6,1271
c0de7bdea0ad0e1967695004156a1d817d2e2b38,0,Todd Lipcon,2015-03-19 11:10:27-07:00,['3e1cdb6e3c7c0374d3c3fafa72898b0aae99ce37'],9,17,26,544636,1,,,,1271
2cb5b7823c587926485d630c86a9e4a3a5af38d7,0,David Alves,2015-03-19 11:13:19-07:00,['c0de7bdea0ad0e1967695004156a1d817d2e2b38'],0,101,101,544737,1,0.418604651,1,1,1271
c9ad4daf5ca22aa9e65180015b1cbc4323df3120,0,Adar Dembo,2015-03-19 14:06:34-07:00,['2cb5b7823c587926485d630c86a9e4a3a5af38d7'],0,46,46,544783,1,,,,1271
02b428fd23a5e8e76601ac00ad1fa6aa7b3f368a,0,Adar Dembo,2015-03-19 14:07:16-07:00,['c9ad4daf5ca22aa9e65180015b1cbc4323df3120'],10,13,23,544806,1,,,,1271
ce7ce085bc1961dbce293636611faa81b6e5cf75,1,Adar Dembo,2015-03-19 14:07:22-07:00,['02b428fd23a5e8e76601ac00ad1fa6aa7b3f368a'],36,217,253,545059,2,0.503875969,0.271317829,0.503875969,1271
e4ba41581f7c32c44d1f314451f82863415868c7,0,Adar Dembo,2015-03-19 15:08:03-07:00,['ce7ce085bc1961dbce293636611faa81b6e5cf75'],7,62,69,545128,5,0.8,0.8,1,1271
ac75ca29cf7e905675f16086be4c9b0e88af205e,1,Andrew Wang,2015-03-19 15:40:06-07:00,['e4ba41581f7c32c44d1f314451f82863415868c7'],28,302,330,545458,11,0.113513514,0.156756757,0.756756757,1271
c3f6e22891353b854e8ecf162a41f6e0037b9f7e,0,Adar Dembo,2015-03-19 16:36:31-07:00,['ac75ca29cf7e905675f16086be4c9b0e88af205e'],13,27,40,545498,4,0,0.5,0,1271
32c547385a8e7a5f971ad1268427afcc3f783f6d,0,David Alves,2015-03-20 08:54:27-07:00,['c3f6e22891353b854e8ecf162a41f6e0037b9f7e'],0,6,6,545504,1,0,1,1,1271
9752f1d218782b0aad61d492a3bfa6ad263b5146,1,David Alves,2015-03-20 19:39:45-07:00,['32c547385a8e7a5f971ad1268427afcc3f783f6d'],1,46,47,545551,3,1,1,0.85,1271
f5ce3f2619a494d30ca566634f8a9126647c9a98,0,Jean-Daniel Cryans,2015-03-21 09:18:43-07:00,['9752f1d218782b0aad61d492a3bfa6ad263b5146'],0,31,31,545582,1,,,,1271
c816dd8778e5154cf3108bc36adfe0a12d0baca2,0,Todd Lipcon,2015-03-22 21:40:58-07:00,['f5ce3f2619a494d30ca566634f8a9126647c9a98'],2,2,4,545586,2,,,,1271
0cc64343e22c3149be5c1ce1d28243de6b9c902a,0,Todd Lipcon,2015-03-22 23:27:36-07:00,['c816dd8778e5154cf3108bc36adfe0a12d0baca2'],21,13,34,545620,4,0.222222222,0,0,1271
42a4e9ff3ae5faaaa10d058a9e66a3d6c4431658,0,Todd Lipcon,2015-03-23 12:13:04-07:00,['0cc64343e22c3149be5c1ce1d28243de6b9c902a'],1,8,9,545629,1,0,0,1,1271
d9014d4103ac9c5bedac5ec9d73d85cd348430e0,0,Todd Lipcon,2015-03-23 19:17:06-07:00,['42a4e9ff3ae5faaaa10d058a9e66a3d6c4431658'],12,7,19,545648,2,,,,1271
dbdbb2d28a2ace516684a709cd7c1a62856a047e,0,Jean-Daniel Cryans,2015-03-24 12:16:42-07:00,['d9014d4103ac9c5bedac5ec9d73d85cd348430e0'],0,1,1,545649,1,0,1,1,1271
7d98482b8a0f435dab77619bb60c897fcfe67bdd,0,Todd Lipcon,2015-03-25 10:22:45-07:00,['dbdbb2d28a2ace516684a709cd7c1a62856a047e'],6,171,177,545826,7,0.637681159,1,0.449275362,1272
e49e2186d5a4373a9c0f8eca20a1c9fcbc7c08a9,0,Jean-Daniel Cryans,2015-03-25 11:32:24-07:00,['7d98482b8a0f435dab77619bb60c897fcfe67bdd'],0,1,1,545827,1,,,,1272
2138fa0e745ad7b2150f28bd981ce9d6b6b3ca3c,0,Todd Lipcon,2015-03-25 13:26:27-07:00,['e49e2186d5a4373a9c0f8eca20a1c9fcbc7c08a9'],1,27,28,545855,2,,,,1273
b7ff4f1c15bf1d4ab658bf0026bfc661d376dafb,0,Adar Dembo,2015-03-25 13:33:17-07:00,['2138fa0e745ad7b2150f28bd981ce9d6b6b3ca3c'],0,21,21,545876,3,0.6,1,1,1273
24269412091cda16b8121ce3d921c8d68a5fb47e,1,Adar Dembo,2015-03-25 14:48:24-07:00,['b7ff4f1c15bf1d4ab658bf0026bfc661d376dafb'],86,306,392,546268,19,0.215686275,1,0.990196078,1273
4b4fa90dea2e5aa98c82354b4806db661bd71e4f,1,Adar Dembo,2015-03-25 14:48:31-07:00,['24269412091cda16b8121ce3d921c8d68a5fb47e'],237,295,532,546800,33,1,1,0.75,1273
e3764bd989b6965072ec201b38e33a2b8b69fc67,1,Todd Lipcon,2015-03-25 17:58:03-07:00,['4b4fa90dea2e5aa98c82354b4806db661bd71e4f'],7,7,14,546814,5,,,,1273
abf85fb0d4457dd97d4c27cd2e7c8ab4a7a9152a,1,Todd Lipcon,2015-03-25 18:17:00-07:00,['e3764bd989b6965072ec201b38e33a2b8b69fc67'],20,184,204,547018,6,0,1,0.975609756,1273
f6edf775e9d8797b3267e2ceb7ce5ba5e4186c63,1,Todd Lipcon,2015-03-25 18:29:40-07:00,['abf85fb0d4457dd97d4c27cd2e7c8ab4a7a9152a'],0,131,131,547149,5,0.43877551,1,0.43877551,1273
43686affe41ce72c8e6626d2ff1580bba5cbe09f,1,Adar Dembo,2015-03-25 21:55:48-07:00,['f6edf775e9d8797b3267e2ceb7ce5ba5e4186c63'],4,14,18,547167,3,0.666666667,1,1,1273
f97d3d6a39e9079ba3336bf616090bab9725d7a1,0,Adar Dembo,2015-03-26 00:20:23-07:00,['43686affe41ce72c8e6626d2ff1580bba5cbe09f'],1,1,2,547169,1,,,,1273
14d08f1372f28a27701943dbee4016febc90c8c1,0,Jean-Daniel Cryans,2015-03-26 09:12:15-07:00,['f97d3d6a39e9079ba3336bf616090bab9725d7a1'],1,1,2,547171,1,,,,1273
3adecef9ff4165abd9350f0599319ca0ee7ad172,1,Andrew Wang,2015-03-26 17:07:23-07:00,['14d08f1372f28a27701943dbee4016febc90c8c1'],36,227,263,547434,9,0,0.194690265,0.955752212,1273
673992eead4183fbd5ebe2f2a5f54a12e695eb99,0,Jean-Daniel Cryans,2015-03-26 20:38:30-07:00,['3adecef9ff4165abd9350f0599319ca0ee7ad172'],1,2,3,547437,1,,,,1273
7d27609611c4aa90d2b198d24cbaecc883f3cc06,0,Adar Dembo,2015-03-30 17:47:53-07:00,['673992eead4183fbd5ebe2f2a5f54a12e695eb99'],13,35,48,547485,2,0.333333333,1,1,1273
509cae3a7528c16763fb07522cdc7d59b19fdde9,0,Todd Lipcon,2015-03-31 00:26:28-07:00,['7d27609611c4aa90d2b198d24cbaecc883f3cc06'],0,318,318,547803,1,,,,1274
5769df0e2369b9a40fa20023e07b24ee5409829a,1,Jean-Daniel Cryans,2015-03-31 10:33:30-07:00,['509cae3a7528c16763fb07522cdc7d59b19fdde9'],92,197,289,548092,8,1,1,1,1276
9c10683437dc7584692756bca1286b3a953c541f,0,Todd Lipcon,2015-03-31 12:53:10-07:00,['5769df0e2369b9a40fa20023e07b24ee5409829a'],0,1,1,548093,1,,,,1276
59a2aa6bdc7ac7caa0bbbf20ce0c423dbbc85b8f,0,Adar Dembo,2015-03-31 14:18:14-07:00,['9c10683437dc7584692756bca1286b3a953c541f'],1,2,3,548096,1,,,,1276
2c8aa9e2f8a5b5a9535ee090ba0840fffe7f0a09,1,Jean-Daniel Cryans,2015-03-31 16:38:46-07:00,['59a2aa6bdc7ac7caa0bbbf20ce0c423dbbc85b8f'],183,206,389,548485,15,0,0.083333333,0,1276
c16d649e80fd3db3e4663c24cd1a38b596caaad5,0,Todd Lipcon,2015-03-31 17:10:09-07:00,['2c8aa9e2f8a5b5a9535ee090ba0840fffe7f0a09'],73,226,299,548784,5,1,1,1,1276
19505fd72b6102887ce36f9f98f4e6835fffa604,1,Adar Dembo,2015-03-31 17:10:44-07:00,['c16d649e80fd3db3e4663c24cd1a38b596caaad5'],6,39,45,548829,5,0,0.75,1,1276
2eb0c233a3006416b922c696c5e492b9e4510106,0,Todd Lipcon,2015-03-31 17:11:40-07:00,['19505fd72b6102887ce36f9f98f4e6835fffa604'],84,392,476,549305,4,0.212,0.912,0.904,1276
232ec68297b999ad7e7b48ea70fb0637896e8362,1,Adar Dembo,2015-03-31 17:38:14-07:00,['2eb0c233a3006416b922c696c5e492b9e4510106'],129,459,588,549893,14,0.02020202,0.388888889,0.828282828,1276
01c59a79fdf2ccf5d97ced88b1994abc660187dd,0,Todd Lipcon,2015-03-31 18:15:12-07:00,['232ec68297b999ad7e7b48ea70fb0637896e8362'],8,46,54,549947,3,0.4375,0,0.625,1276
639d8d90dac699fff4db12504dbbd3b6ca5350bd,1,Todd Lipcon,2015-03-31 23:15:39-07:00,['01c59a79fdf2ccf5d97ced88b1994abc660187dd'],16,52,68,550015,2,0,0.625,1,1276
837178ca4117faea2e041dbca125a408d587bf6b,0,Adar Dembo,2015-04-01 15:06:28-07:00,['639d8d90dac699fff4db12504dbbd3b6ca5350bd'],4,3,7,550022,3,,,,1276
b0b37b078e480c9d4fcf6db0fd11fd2ae8107249,0,Adar Dembo,2015-04-01 16:22:29-07:00,['837178ca4117faea2e041dbca125a408d587bf6b'],9,1,10,550032,3,,,,1276
0ee63292713e8a7dd8beee62918a95b36abd0961,1,Todd Lipcon,2015-04-01 19:45:02-07:00,['b0b37b078e480c9d4fcf6db0fd11fd2ae8107249'],1242,1236,2478,552510,86,,,,1276
1eb57205573f35c8d096ad561ad2dad4a05de0cf,0,Adar Dembo,2015-04-01 20:06:07-07:00,['0ee63292713e8a7dd8beee62918a95b36abd0961'],3,5,8,552518,1,,,,1276
1d4296aea202c7ab8f689238c0454c8afe3b8104,1,Todd Lipcon,2015-04-01 20:40:22-07:00,['1eb57205573f35c8d096ad561ad2dad4a05de0cf'],74,422,496,553014,7,0.754098361,1,1,1280
c449576bb4c60d5fa44efeb2a3eb280219adf324,1,Todd Lipcon,2015-04-02 00:36:32-07:00,['1d4296aea202c7ab8f689238c0454c8afe3b8104'],3,63,66,553080,3,0.958333333,1,1,1281
324e15d5a361cf6dcf7cb50f70fe0cd257d82e8b,1,Todd Lipcon,2015-04-02 01:03:31-07:00,['c449576bb4c60d5fa44efeb2a3eb280219adf324'],89,286,375,553455,14,0.616666667,0.95,0.916666667,1283
8084816c84c59c4b122a7169a93440fcf9c4782c,1,Adar Dembo,2015-04-02 02:26:40-07:00,['324e15d5a361cf6dcf7cb50f70fe0cd257d82e8b'],10,10,20,553475,4,,,,1283
dff684f14b43b098c257eb28a193f5c7543ab257,0,Adar Dembo,2015-04-02 03:20:50-07:00,['8084816c84c59c4b122a7169a93440fcf9c4782c'],1,1,2,553477,1,,,,1283
892e8f44deb25771fee09928fe86612994bc965a,0,Todd Lipcon,2015-04-02 11:56:31-07:00,['dff684f14b43b098c257eb28a193f5c7543ab257'],8,0,8,553485,1,0,0,0,1283
c6ed250e7fc1ccc389a8f2cc97d7932f10e16766,0,Todd Lipcon,2015-04-02 11:56:48-07:00,['892e8f44deb25771fee09928fe86612994bc965a'],4,0,4,553489,1,0,0,0,1283
6654ce0f7e2612d042ac5b9ab21297046adbcc2f,0,Todd Lipcon,2015-04-02 11:57:20-07:00,['c6ed250e7fc1ccc389a8f2cc97d7932f10e16766'],4,5,9,553498,1,0,0,1,1283
aaa3b722bd31e8bd8732d9ba4c03ffd488135130,0,Todd Lipcon,2015-04-02 16:06:31-07:00,['6654ce0f7e2612d042ac5b9ab21297046adbcc2f'],1,103,104,553602,5,0.180555556,0,1,1283
8a3ac3b11cdae8354eec5f3d427c8d2cf4228325,0,Michael Percy,2015-04-02 17:24:16-07:00,['aaa3b722bd31e8bd8732d9ba4c03ffd488135130'],0,6,6,553608,1,,,,1283
82c6d04d53a42182548312b945213f4d5642df43,0,Todd Lipcon,2015-04-02 18:45:09-07:00,['8a3ac3b11cdae8354eec5f3d427c8d2cf4228325'],5,5,10,553618,1,,,,1283
e4d0152b517a1f23b86f3f44b8a269c5f2c1fb73,1,Jean-Daniel Cryans,2015-04-02 20:02:48-07:00,['82c6d04d53a42182548312b945213f4d5642df43'],81,184,265,553883,12,0.16,0.866666667,0.746666667,1283
b5fe445c6980d5c0127f389d3db93acecb8eb5a9,0,Jean-Daniel Cryans,2015-04-02 20:06:47-07:00,['e4d0152b517a1f23b86f3f44b8a269c5f2c1fb73'],21,64,85,553968,5,0,1,1,1283
d5fc4a989c9516fa56123ede2e9812e96c4ee742,1,Jean-Daniel Cryans,2015-04-02 20:39:50-07:00,['b5fe445c6980d5c0127f389d3db93acecb8eb5a9'],1,178,179,554147,6,0.112676056,1,0.633802817,1285
f12bbb014b1cffbffc50a621f92bbd3f7bba3d2f,0,Michael Percy,2015-04-02 23:11:48-07:00,['d5fc4a989c9516fa56123ede2e9812e96c4ee742'],1,20,21,554168,2,1,1,1,1285
b51698b873f2a270f1e8f75e620ff7016ea47a41,1,Todd Lipcon,2015-04-03 00:58:31-07:00,['f12bbb014b1cffbffc50a621f92bbd3f7bba3d2f'],15,32,47,554215,3,1,1,0.5,1285
02c783754e3fe4df6ca81a9a5299c52c6c172c1b,0,Jean-Daniel Cryans,2015-04-03 08:00:47-07:00,['b51698b873f2a270f1e8f75e620ff7016ea47a41'],0,24,24,554239,1,0,0,1,1285
dcfa75bec720f65a0457758b1b54da54b0bf8baf,0,Todd Lipcon,2015-04-03 15:16:31-07:00,['02c783754e3fe4df6ca81a9a5299c52c6c172c1b'],27,112,139,554378,6,0.962962963,0.962962963,0.962962963,1285
fb530ac30fb89c949abc8221f74fa35b083e4961,1,Adar Dembo,2015-04-03 15:49:46-07:00,['dcfa75bec720f65a0457758b1b54da54b0bf8baf'],11,30,41,554419,6,1,0,0.176470588,1285
92228c35874af9396a3a8da0663b18f791eb7909,0,Todd Lipcon,2015-04-04 20:03:00-07:00,['fb530ac30fb89c949abc8221f74fa35b083e4961'],10,20,30,554449,10,1,0,0,1285
4f03fb105c4c32b2ec5d85e6f433d1bcfa19aa5b,0,Todd Lipcon,2015-04-06 18:41:34-07:00,['92228c35874af9396a3a8da0663b18f791eb7909'],0,22,22,554471,1,1,1,1,1285
58f000d6df21d4b3ab18ae10fa435dc84b6688b5,1,Todd Lipcon,2015-04-07 10:49:05-07:00,['4f03fb105c4c32b2ec5d85e6f433d1bcfa19aa5b'],37,81,118,554589,3,0,0.875,0.34375,1285
bb23429073ef7159ef51d25a71df14f41e90dda2,1,Todd Lipcon,2015-04-07 10:49:39-07:00,['58f000d6df21d4b3ab18ae10fa435dc84b6688b5'],3,3,6,554595,1,,,,1285
0a47a3fc55a3e90b4ce0c61c384c9555147336a8,1,Todd Lipcon,2015-04-08 13:56:18-07:00,['bb23429073ef7159ef51d25a71df14f41e90dda2'],10,337,347,554942,6,0.563909774,0.706766917,1,1286
e5b2510004512618d452636dfd8c255e427cec5b,1,Michael Percy,2015-04-08 14:08:21-07:00,['0a47a3fc55a3e90b4ce0c61c384c9555147336a8'],17,76,93,555035,8,0.5,1,0.705882353,1286
ed4d2196bb8aff44cad4395f98d623cb56eede97,1,Adar Dembo,2015-04-08 15:59:04-07:00,['e5b2510004512618d452636dfd8c255e427cec5b'],42,44,86,555121,2,1,1,1,1286
d4788eee039c1e238f11b51f0435572e9e0fc566,0,Todd Lipcon,2015-04-08 18:10:34-07:00,['ed4d2196bb8aff44cad4395f98d623cb56eede97'],0,319,319,555440,9,0.589041096,1,0.821917808,1289
fcfa57701f3357c71981daae51c5c8d5cb89f543,0,Todd Lipcon,2015-04-08 19:55:30-07:00,['d4788eee039c1e238f11b51f0435572e9e0fc566'],19,290,309,555749,18,0.604651163,1,0.720930233,1291
d9dbe61e203d91b58b139e212e98835e7bbd0f9d,0,Todd Lipcon,2015-04-08 19:55:34-07:00,['fcfa57701f3357c71981daae51c5c8d5cb89f543'],0,14,14,555763,1,,,,1291
dc0bcf0f917bf729ca6feda2b11ccaae0ab43385,0,Andrew Wang,2015-04-09 14:11:53-07:00,['d9dbe61e203d91b58b139e212e98835e7bbd0f9d'],10,27,37,555800,3,0,0.8,1,1291
96155cdad4e8f76d840f240b589d1d41892b76b6,1,Andrew Wang,2015-04-09 14:12:11-07:00,['dc0bcf0f917bf729ca6feda2b11ccaae0ab43385'],166,481,647,556447,11,0.080188679,0.523584906,0,1291
481de36cabbedd9890d9543e3bea0780264695b2,0,Andrew Wang,2015-04-09 15:10:30-07:00,['96155cdad4e8f76d840f240b589d1d41892b76b6'],30,137,167,556614,4,0.493670886,0.139240506,0.126582278,1291
eceadf1d40e7187951853d47edb0b0dc8d9046cd,0,Todd Lipcon,2015-04-09 16:15:49-07:00,['481de36cabbedd9890d9543e3bea0780264695b2'],2,9,11,556625,2,1,1,1,1291
0572a9042af31fc7ea9a462ab70f7c8542fc9f57,0,Todd Lipcon,2015-04-09 17:37:11-07:00,['eceadf1d40e7187951853d47edb0b0dc8d9046cd'],7,8,15,556640,2,0,1,0,1291
6deccde78cebeff6c80c9e7f6ce0d7aebef13384,0,Todd Lipcon,2015-04-09 17:37:34-07:00,['0572a9042af31fc7ea9a462ab70f7c8542fc9f57'],0,5,5,556645,1,0,1,0,1291
a1b55c97da1e85870037f5ecac0cb5a7826b1835,0,Adar Dembo,2015-04-10 16:07:15-07:00,['6deccde78cebeff6c80c9e7f6ce0d7aebef13384'],2,2,4,556649,1,,,,1291
c17c0b4f670ecdb5aa37a4040ebcd3768829d7fa,1,Todd Lipcon,2015-04-10 17:11:01-07:00,['a1b55c97da1e85870037f5ecac0cb5a7826b1835'],89,394,483,557132,6,0.487179487,0.692307692,1,1292
78b3258e698be91169ed0558f60dbb62d922d57e,1,Todd Lipcon,2015-04-10 17:18:28-07:00,['c17c0b4f670ecdb5aa37a4040ebcd3768829d7fa'],16,42,58,557190,4,0.733333333,0.733333333,0.266666667,1292
1cf2be7030b410c8dddbc10c87a46198645326e9,0,Jean-Daniel Cryans,2015-04-14 07:34:07-07:00,['78b3258e698be91169ed0558f60dbb62d922d57e'],4,6,10,557200,1,,,,1292
621ce2a4664bcf9e54bedd3e9fd2a9c7b29bb08c,0,David Alves,2015-04-14 11:16:39-07:00,['1cf2be7030b410c8dddbc10c87a46198645326e9'],1,6,7,557207,1,1,1,1,1292
da526c6b88a31b5a6c20750748afa3e2d291973c,0,Jean-Daniel Cryans,2015-04-14 13:05:48-07:00,['621ce2a4664bcf9e54bedd3e9fd2a9c7b29bb08c'],2,1,3,557210,2,,,,1292
815b60f180519a268dbd9154fa7ac9d3317f4ea4,0,Todd Lipcon,2015-04-14 22:42:13-07:00,['da526c6b88a31b5a6c20750748afa3e2d291973c'],39,78,117,557327,2,1,1,0.740740741,1292
4543af42073113728c17e76eaefb1814ca03e4b9,1,Todd Lipcon,2015-04-14 22:44:01-07:00,['815b60f180519a268dbd9154fa7ac9d3317f4ea4'],21,21,42,557369,5,0,1,1,1292
6a137fae5b0b5b39f30796e6beb4df5bc5c59f55,0,Todd Lipcon,2015-04-14 23:50:59-07:00,['4543af42073113728c17e76eaefb1814ca03e4b9'],4,327,331,557700,7,0.319796954,0.695431472,0.644670051,1294
2a9d3cd987ec521f780a73693a9908ec89d70e1e,1,Todd Lipcon,2015-04-14 23:54:38-07:00,['6a137fae5b0b5b39f30796e6beb4df5bc5c59f55'],11,10,21,557721,2,,,,1294
f362abd7af62146fbfbf8a6a8ec2c6264e2868e7,1,Adar Dembo,2015-04-15 11:44:49-07:00,['2a9d3cd987ec521f780a73693a9908ec89d70e1e'],21,168,189,557910,16,0.184,0.752,0.832,1294
c315f6f19cdc2148d35f5960073fce6b524a3b81,0,Adar Dembo,2015-04-15 14:46:24-07:00,['f362abd7af62146fbfbf8a6a8ec2c6264e2868e7'],2,0,2,557912,1,,,,1294
b217f5272d34ffc14d8a4ea27f27ccc85500b936,0,Todd Lipcon,2015-04-15 18:05:47-07:00,['c315f6f19cdc2148d35f5960073fce6b524a3b81'],0,63,63,557975,2,1,1,1,1294
cac9adf04eaca2a74d021a030856a6d380456c71,0,Todd Lipcon,2015-04-15 18:14:24-07:00,['b217f5272d34ffc14d8a4ea27f27ccc85500b936'],16,332,348,558323,5,0.314465409,1,1,1295
fc59e25150fc0d016415164a729aff59c4c206e7,0,Jean-Daniel Cryans,2015-04-16 11:29:10-07:00,['cac9adf04eaca2a74d021a030856a6d380456c71'],0,25,25,558348,1,,,,1295
3535803214f5bf3ba5a274c1e82619c00b6268f8,1,Adar Dembo,2015-04-16 17:51:56-07:00,['fc59e25150fc0d016415164a729aff59c4c206e7'],1162,1299,2461,560809,105,0.538461538,0,1,1296
ba36b98f0c14c8e4c03e39468ef3dc1837c8b3df,1,Adar Dembo,2015-04-17 00:01:51-07:00,['3535803214f5bf3ba5a274c1e82619c00b6268f8'],0,298,298,561107,5,,,,1300
71ce4da1fdceeebbde543af39589aa87d1041e4f,0,Jean-Daniel Cryans,2015-04-17 14:19:20-07:00,['ba36b98f0c14c8e4c03e39468ef3dc1837c8b3df'],46,64,110,561217,1,0,0,1,1300
e6ca9e83a24890cd17e0442b91935afe09e6963b,1,David Alves,2015-04-17 14:30:25-07:00,['71ce4da1fdceeebbde543af39589aa87d1041e4f'],1,18,19,561236,2,0,0.647058824,0.764705882,1300
6dc4e9d877e93894432ec62fb385d0d5e128fb55,0,Todd Lipcon,2015-04-17 14:47:36-07:00,['e6ca9e83a24890cd17e0442b91935afe09e6963b'],2,7,9,561245,2,0.666666667,1,1,1300
b01348fe6e4e516afc3ba8716579f440d2b610f7,0,Todd Lipcon,2015-04-17 14:47:43-07:00,['6dc4e9d877e93894432ec62fb385d0d5e128fb55'],1,4,5,561250,1,1,1,1,1300
b7cea08a8279d10ce6a7895e9a3408e9378dbcbd,1,Jean-Daniel Cryans,2015-04-17 15:18:05-07:00,['b01348fe6e4e516afc3ba8716579f440d2b610f7'],12,57,69,561319,5,0,0.583333333,0.638888889,1300
21c9a822204ed86dcf22e83a531340d8ed31d7f1,0,Adar Dembo,2015-04-17 16:28:20-07:00,['b7cea08a8279d10ce6a7895e9a3408e9378dbcbd'],1,1,2,561321,1,,,,1300
c464c05380469bec02aad4b7bc0348a458622803,0,Adar Dembo,2015-04-18 14:18:15-07:00,['21c9a822204ed86dcf22e83a531340d8ed31d7f1'],10,26,36,561357,4,,,,1300
68d011ea80b4521f840c9f88264590cab8afc0a5,0,Todd Lipcon,2015-04-19 11:34:35-07:00,['c464c05380469bec02aad4b7bc0348a458622803'],0,184,184,561541,3,0.714285714,1,1,1302
f89eb6402e8ffc1c1f5ec7cc4ef8dc28a2a29ea0,1,Todd Lipcon,2015-04-19 11:35:02-07:00,['68d011ea80b4521f840c9f88264590cab8afc0a5'],55,296,351,561892,10,0.638095238,0.99047619,0.704761905,1303
af4746fe54aeee4200e98a932b984ac7df563c94,1,Todd Lipcon,2015-04-19 11:36:20-07:00,['f89eb6402e8ffc1c1f5ec7cc4ef8dc28a2a29ea0'],184,395,579,562471,26,0.056910569,0.764227642,0,1303
c559a7d48f3c7367fb28a7f42fd429c8b8a461f4,0,Todd Lipcon,2015-04-19 12:28:00-07:00,['af4746fe54aeee4200e98a932b984ac7df563c94'],4,6,10,562481,5,,1,,1303
8f8d948aaa5b72ba7c8afa602b59fb9108d26e4a,0,Todd Lipcon,2015-04-19 12:28:11-07:00,['c559a7d48f3c7367fb28a7f42fd429c8b8a461f4'],17,25,42,562523,2,1,1,1,1303
18dcacaf27cde71fbda7f5b7c859ec0f65919a9d,0,Jean-Daniel Cryans,2015-04-20 08:12:48-07:00,['8f8d948aaa5b72ba7c8afa602b59fb9108d26e4a'],52,44,96,562619,2,0,0,0,1303
009849fe5b8b914affb4d84342170d281fba56aa,1,Michael Percy,2015-04-20 13:22:41-07:00,['18dcacaf27cde71fbda7f5b7c859ec0f65919a9d'],66,117,183,562802,6,0.545454545,1,1,1303
c2e0b9761b3818a0a40486a48f40a6f4ec778a7e,0,Michael Percy,2015-04-20 13:23:15-07:00,['009849fe5b8b914affb4d84342170d281fba56aa'],5,1,6,562808,3,0,0,0,1303
f1f9d4f9c1b9544c0ac2ed52e1ca556df3922cf9,0,Todd Lipcon,2015-04-20 14:39:13-07:00,['c2e0b9761b3818a0a40486a48f40a6f4ec778a7e'],1,2,3,562811,1,,,,1303
ace60df985075743993f78007da8f80f7505bd96,0,Todd Lipcon,2015-04-20 18:41:50-07:00,['f1f9d4f9c1b9544c0ac2ed52e1ca556df3922cf9'],72,26,98,562909,9,0,0,0,1303
298953377c8cf10493322091608e95382e2fd903,1,Todd Lipcon,2015-04-20 18:41:53-07:00,['ace60df985075743993f78007da8f80f7505bd96'],18,34,52,562961,5,1,1,0,1303
c6650c557ce8e9f9bf152d097c6093bf523aa9b7,1,Adar Dembo,2015-04-20 18:56:06-07:00,['298953377c8cf10493322091608e95382e2fd903'],88,336,424,563385,21,0.373239437,0.816901408,0.943661972,1303
0d9cf6a903524d5716425f7b6d197b8d9cfc2f5c,1,Jean-Daniel Cryans,2015-04-20 20:07:42-07:00,['c6650c557ce8e9f9bf152d097c6093bf523aa9b7'],0,247,247,563632,2,0.720588235,1,0.875,1304
84430cdddb394b114f16e4303e20f4310e9ebab1,0,Jean-Daniel Cryans,2015-04-20 20:10:57-07:00,['0d9cf6a903524d5716425f7b6d197b8d9cfc2f5c'],5,9,14,563646,1,0,1,1,1304
d3ad3ff4e890cf931f28170db15dbe6acb5c0229,0,Jean-Daniel Cryans,2015-04-21 15:04:24-07:00,['84430cdddb394b114f16e4303e20f4310e9ebab1'],0,3,3,563649,1,0,1,1,1304
ab6e113181093bb67a4b14d0362ba3f60e915a40,0,Todd Lipcon,2015-04-22 15:16:05-07:00,['d3ad3ff4e890cf931f28170db15dbe6acb5c0229'],3,3,6,563655,1,,,,1304
313f463644d53c2001010634be9b81ad377c7b26,0,Andrew Wang,2015-04-22 16:55:01-07:00,['ab6e113181093bb67a4b14d0362ba3f60e915a40'],6,14,20,563675,1,,,,1304
c0001e8255cdb19fffc75f0e819d3c2544a365cd,0,Andrew Wang,2015-04-22 16:55:10-07:00,['313f463644d53c2001010634be9b81ad377c7b26'],10,10,20,563695,1,,,,1304
a142fea21ec9ccd77e2b1a740dc34a27b85744cf,0,Todd Lipcon,2015-04-22 17:34:09-07:00,['c0001e8255cdb19fffc75f0e819d3c2544a365cd'],1,26,27,563722,3,,,,1305
e48fe7c91332a252a40de4d5865cac85484f34d5,1,Jean-Daniel Cryans,2015-04-23 10:01:45-07:00,['a142fea21ec9ccd77e2b1a740dc34a27b85744cf'],9,141,150,563872,18,0.693333333,0.853333333,0.933333333,1305
9dff36067a096e34f9c3bb6cefba26d67c8c0c05,1,Todd Lipcon,2015-04-23 13:44:09-07:00,['e48fe7c91332a252a40de4d5865cac85484f34d5'],113,117,230,564102,10,0.222222222,0.555555556,0.888888889,1305
87cc2b0edccc96c18846aec368fb50ba627905d3,1,Todd Lipcon,2015-04-23 13:54:26-07:00,['9dff36067a096e34f9c3bb6cefba26d67c8c0c05'],253,389,642,564744,35,0.5,0.583333333,0.75,1305
878271c1f38738cfab1603dd8cd1fcdb7852a986,1,Todd Lipcon,2015-04-23 15:35:03-07:00,['87cc2b0edccc96c18846aec368fb50ba627905d3'],54,139,193,564937,11,0,1,1,1305
dc20efa0b66c798f73aafdc694a3566317366fd6,1,Todd Lipcon,2015-04-23 21:37:04-07:00,['878271c1f38738cfab1603dd8cd1fcdb7852a986'],561,173,734,565671,26,0.818965517,0.232758621,0.275862069,1305
355e05d390054fea43235340b10a2013921e6ede,0,Todd Lipcon,2015-04-23 21:37:35-07:00,['dc20efa0b66c798f73aafdc694a3566317366fd6'],30,27,57,565728,2,,,,1305
e7ce8a2a8424ed1caddbc651b973216e775952bc,0,Todd Lipcon,2015-04-24 11:23:41-07:00,['355e05d390054fea43235340b10a2013921e6ede'],0,3,3,565731,1,,,,1305
4415218628fe6b1ec1df85d57d1df614bd0eec4f,1,Jean-Daniel Cryans,2015-04-24 13:32:54-07:00,['e7ce8a2a8424ed1caddbc651b973216e775952bc'],283,322,605,566336,19,0,0.6875,0.625,1305
e824d752e66d1aacdb676f085049f363d80161cd,0,Michael Percy,2015-04-24 13:47:53-07:00,['4415218628fe6b1ec1df85d57d1df614bd0eec4f'],8,88,96,566432,5,1,1,1,1307
4573170a4e7c49fc86d4d8e6633552f504ca9279,0,Jean-Daniel Cryans,2015-04-24 14:17:28-07:00,['e824d752e66d1aacdb676f085049f363d80161cd'],92,268,360,566792,6,0.6875,1,1,1307
7d4653484cc56a1208180123a20f281220901a9d,0,Todd Lipcon,2015-04-24 15:03:33-07:00,['4573170a4e7c49fc86d4d8e6633552f504ca9279'],0,6,6,566798,1,,,,1307
ce4ee83b372e4363007b2eeada00a5c240b5d0db,0,Adar Dembo,2015-04-24 15:30:12-07:00,['7d4653484cc56a1208180123a20f281220901a9d'],0,6,6,566804,2,1,1,1,1307
9ef0244faeba58e18c1c00b31ff05ed8fa208b6e,1,Todd Lipcon,2015-04-24 15:47:32-07:00,['ce4ee83b372e4363007b2eeada00a5c240b5d0db'],212,254,466,567270,28,0.75,1,0.45,1307
2cd3da2b307123b7a86bf8f706522db1e0a7c85f,0,Adar Dembo,2015-04-24 16:59:00-07:00,['9ef0244faeba58e18c1c00b31ff05ed8fa208b6e'],1,1,2,567272,1,,,,1307
c0757d402a5e0cfc1dea477f0b2f4c73e29622a3,1,Todd Lipcon,2015-04-24 17:45:33-07:00,['2cd3da2b307123b7a86bf8f706522db1e0a7c85f'],3,3,6,567278,1,,,,1307
d5ebb702b6f9b2e35333dcc2f2bc8a4f7dfe8d79,0,Todd Lipcon,2015-04-24 17:47:12-07:00,['c0757d402a5e0cfc1dea477f0b2f4c73e29622a3'],75,89,164,567442,7,0.714285714,1,1,1307
1493e9a5d6501129020bf3b763768058c826bbe7,0,Todd Lipcon,2015-04-24 22:50:59-07:00,['d5ebb702b6f9b2e35333dcc2f2bc8a4f7dfe8d79'],1,1,2,567444,1,,,,1307
700ff30b4a53acd0435f32eda6f53607db825c4e,0,Todd Lipcon,2015-04-25 13:50:05-07:00,['1493e9a5d6501129020bf3b763768058c826bbe7'],154,199,353,567797,12,0.104166667,0.541666667,0.1875,1307
48bb6feac9732dc0ce87e0a56e7a67373dfdecb6,1,Todd Lipcon,2015-04-25 13:52:31-07:00,['700ff30b4a53acd0435f32eda6f53607db825c4e'],317,277,594,568391,86,,,,1307
af27091c8be5e7460b8f53a05ad7e26b2a0c41e7,0,Adar Dembo,2015-04-25 23:56:52-07:00,['48bb6feac9732dc0ce87e0a56e7a67373dfdecb6'],1,1,2,568393,1,,,,1307
ca3c5f62319144833db9ec81851d45bec15b62c1,0,Adar Dembo,2015-04-25 23:58:11-07:00,['af27091c8be5e7460b8f53a05ad7e26b2a0c41e7'],36,25,61,568454,9,,,,1307
a932e3c437a39d9569445e7687606a69e4784417,1,Todd Lipcon,2015-04-27 11:07:57-07:00,['ca3c5f62319144833db9ec81851d45bec15b62c1'],26,114,140,568594,6,0.96875,1,0.5,1307
7205ae71edf19e683f83538e19c4cad7c856f954,1,Jean-Daniel Cryans,2015-04-27 20:08:22-07:00,['a932e3c437a39d9569445e7687606a69e4784417'],2,23,25,568619,2,0,1,1,1307
502d23efb247284f1eee9766fb48154271b7a31f,1,Todd Lipcon,2015-04-28 09:26:04-07:00,['7205ae71edf19e683f83538e19c4cad7c856f954'],141,523,664,569283,16,0.176706827,0.518072289,0.875502008,1307
c923991f97994651aeb7e702bdec7addae5143e8,0,Jean-Daniel Cryans,2015-04-28 13:12:25-07:00,['502d23efb247284f1eee9766fb48154271b7a31f'],8,107,115,569398,10,,,,1308
f19e61e8087d8f09a220f97ac84d4303089c9eff,0,Jean-Daniel Cryans,2015-04-28 13:12:34-07:00,['c923991f97994651aeb7e702bdec7addae5143e8'],241,0,241,569639,5,0.89010989,0.67032967,0,1308
b2a6bcdbf868231fafab4598f5e6669c2ec229c9,0,Todd Lipcon,2015-04-28 13:47:21-07:00,['f19e61e8087d8f09a220f97ac84d4303089c9eff'],2,24,26,569665,2,0,1,1,1308
396510192b4b8a7974529116d7c97ea461d84a9b,1,Todd Lipcon,2015-04-28 13:49:31-07:00,['b2a6bcdbf868231fafab4598f5e6669c2ec229c9'],318,449,767,570432,37,0.189473684,0.978947368,0.652631579,1308
3e8a0ef3c63f5117ad6e721a5274f30f319410f8,1,Todd Lipcon,2015-04-28 13:53:00-07:00,['396510192b4b8a7974529116d7c97ea461d84a9b'],52,270,322,570754,17,0.6015625,0.9921875,0.7421875,1308
c43d28fad0d34fd5f49b5d69d71144ef46dfb348,0,Michael Percy,2015-04-28 16:23:50-07:00,['3e8a0ef3c63f5117ad6e721a5274f30f319410f8'],30,27,57,570811,3,0,0,1,1308
38c82fad387a6670c88ebe91408db9ece8c78ccf,0,Adar Dembo,2015-04-28 17:49:52-07:00,['c43d28fad0d34fd5f49b5d69d71144ef46dfb348'],0,4,4,570815,1,1,1,1,1308
08349d89a3797ea3f1a198d9ad5140354a9f519a,0,Todd Lipcon,2015-04-28 22:16:24-07:00,['38c82fad387a6670c88ebe91408db9ece8c78ccf'],69,48,117,570932,3,0.916666667,0,0,1308
f42e83cdac501cca4f47e9ae22238986c1ce5a5d,0,Todd Lipcon,2015-04-29 12:08:58-07:00,['08349d89a3797ea3f1a198d9ad5140354a9f519a'],6,6,12,570944,1,,,,1308
c7a79aed0ae285c128236c39be11b6b0e60a9db7,0,Jean-Daniel Cryans,2015-04-29 12:15:23-07:00,['f42e83cdac501cca4f47e9ae22238986c1ce5a5d'],1,1,2,570946,1,,,,1308
abb2865ea8a3dda0086413e38059e21b91f05886,0,Todd Lipcon,2015-04-29 13:03:05-07:00,['c7a79aed0ae285c128236c39be11b6b0e60a9db7'],34,29,63,571009,1,1,0.333333333,1,1308
96219807ff9b719402d66418029fdde506c4bd56,0,Jean-Daniel Cryans,2015-04-29 13:51:16-07:00,['abb2865ea8a3dda0086413e38059e21b91f05886'],24,69,93,571102,17,0.787878788,1,1,1308
4ece99957294375f9bef7bea2005bbaa74ac36c9,0,Todd Lipcon,2015-04-29 14:18:33-07:00,['96219807ff9b719402d66418029fdde506c4bd56'],0,320,320,571422,4,0.435483871,1,0.935483871,1311
bd4b9cb52906781e2cdbf653ddfc995ea1773b41,0,Todd Lipcon,2015-04-29 14:19:04-07:00,['4ece99957294375f9bef7bea2005bbaa74ac36c9'],3,91,94,571516,6,0.260869565,1,0.97826087,1311
b3609087abfa679158e8fab266ae2076f79905a2,0,Todd Lipcon,2015-04-29 14:19:25-07:00,['bd4b9cb52906781e2cdbf653ddfc995ea1773b41'],5,146,151,571667,5,0.235955056,0.808988764,0.988764045,1311
05d469c5cccb0d04ffc0c57ca8df148a75655586,0,Adar Dembo,2015-04-29 14:37:00-07:00,['b3609087abfa679158e8fab266ae2076f79905a2'],0,2,2,571669,1,,,,1311
8812b83593119b3e6edc805cf4dbfcb405c17a33,0,Andrew Wang,2015-04-29 17:17:34-07:00,['05d469c5cccb0d04ffc0c57ca8df148a75655586'],21,29,50,571719,4,,,,1311
8504a3335550b46e71fe4b72d8a85d8fa414bfbc,0,Todd Lipcon,2015-04-29 18:58:44-07:00,['8812b83593119b3e6edc805cf4dbfcb405c17a33'],15,52,67,571786,4,0.4,1,1,1311
7ba706e85d50f627d39f287c6dfc9a54e51508aa,1,Todd Lipcon,2015-04-29 18:59:31-07:00,['8504a3335550b46e71fe4b72d8a85d8fa414bfbc'],850,639,1489,573275,43,0.328571429,0.142857143,0.228571429,1311
76c6206a1bfd837aa86453d27fa662c7a8f23da6,1,Todd Lipcon,2015-04-29 19:00:45-07:00,['7ba706e85d50f627d39f287c6dfc9a54e51508aa'],187,6,193,573468,8,0.597938144,0.463917526,0.175257732,1311
cb6bc612e736788878055692dc8e90e1ffa88456,0,Andrew Wang,2015-04-29 21:28:02-07:00,['76c6206a1bfd837aa86453d27fa662c7a8f23da6'],24,256,280,573748,10,0.780952381,0.819047619,0.914285714,1311
7b74ca2fb598b585ae99ebedbf9df9913ddb915e,0,Adar Dembo,2015-04-30 00:02:22-07:00,['cb6bc612e736788878055692dc8e90e1ffa88456'],3,56,59,573807,3,,,,1311
80786dd7f5a212f9893f5b3b67f344edd721656f,0,Adar Dembo,2015-04-30 00:02:39-07:00,['7b74ca2fb598b585ae99ebedbf9df9913ddb915e'],6,7,13,573820,1,,,,1311
42c7993027e3ef14455965be85d86629320a97a9,0,Adar Dembo,2015-04-30 01:22:39-07:00,['80786dd7f5a212f9893f5b3b67f344edd721656f'],2,2,4,573824,1,,,,1311
01b1622f10a747f68016fe81a2632f02a29c87ac,0,Todd Lipcon,2015-04-30 16:04:18-07:00,['42c7993027e3ef14455965be85d86629320a97a9'],1,1,2,573826,1,,,,1311
38da66f54d0de2fa286f9b8d3e137897ed6b0e69,0,Todd Lipcon,2015-04-30 16:33:33-07:00,['01b1622f10a747f68016fe81a2632f02a29c87ac'],32,35,67,573893,1,0,1,0,1311
4d5423473f2b4dfce0eff122253a7204de71bc89,0,Adar Dembo,2015-04-30 16:45:52-07:00,['38da66f54d0de2fa286f9b8d3e137897ed6b0e69'],3,4,7,573900,1,,,,1311
544ce9c3f4874eaa30ab7717ed05538599453530,0,Adar Dembo,2015-04-30 18:03:59-07:00,['4d5423473f2b4dfce0eff122253a7204de71bc89'],1,1,2,573902,1,,,,1311
2c11755066569f3000342c05c1d44a68e602452e,1,Jean-Daniel Cryans,2015-05-01 10:47:45-07:00,['544ce9c3f4874eaa30ab7717ed05538599453530'],72,163,235,574137,11,0,1,1,1311
060da57c43e8adbde27b873067abedf99ca7757c,1,Jean-Daniel Cryans,2015-05-01 14:17:55-07:00,['2c11755066569f3000342c05c1d44a68e602452e'],316,315,631,574768,106,,,,1311
48e755087fe58a8dd91f175c9653b22a0ee54d1b,1,Jean-Daniel Cryans,2015-05-04 09:15:41-07:00,['060da57c43e8adbde27b873067abedf99ca7757c'],1279,1273,2552,577320,29,,,,1313
b10a798ac9622848d562b9812c42533d023d63aa,0,Adar Dembo,2015-05-04 15:18:00-07:00,['48e755087fe58a8dd91f175c9653b22a0ee54d1b'],2,5,7,577327,4,1,1,1,1313
2c67e27b71466776f95dbe284c012f981dbde374,0,Todd Lipcon,2015-05-04 16:39:56-07:00,['b10a798ac9622848d562b9812c42533d023d63aa'],1,3,4,577331,1,,,,1313
e3215f0e144c944a2de060f96115f411f067ce20,1,Todd Lipcon,2015-05-04 16:51:37-07:00,['2c67e27b71466776f95dbe284c012f981dbde374'],74,40,114,577445,10,0.875,1,0.041666667,1313
d1b6881f45286f58aaa66ece03f339632886e2c2,0,Todd Lipcon,2015-05-04 16:52:53-07:00,['e3215f0e144c944a2de060f96115f411f067ce20'],243,165,408,577853,23,0.256410256,0,0.743589744,1313
264b6b6df261beacb3c64363b334f153ed8af49e,1,Adar Dembo,2015-05-04 18:03:47-07:00,['d1b6881f45286f58aaa66ece03f339632886e2c2'],18,48,66,577919,8,0.846153846,1,0.846153846,1313
53e02acdfbe545f371a2a47b87db3f0a6c73674b,0,Adar Dembo,2015-05-04 18:58:41-07:00,['264b6b6df261beacb3c64363b334f153ed8af49e'],5,16,21,577940,1,1,1,1,1313
b5e9f04a2cc8e7b9cd912e347f6fc48ee4c075ee,0,Adar Dembo,2015-05-04 18:59:32-07:00,['53e02acdfbe545f371a2a47b87db3f0a6c73674b'],0,5,5,577945,1,,,,1313
bf06f49c4131bc38dd376b7fe22452c95019228b,0,Todd Lipcon,2015-05-04 19:25:18-07:00,['b5e9f04a2cc8e7b9cd912e347f6fc48ee4c075ee'],8,8,16,577961,1,,,,1313
1390f70e392f638165198da9446cf31949b2f0e2,0,Michael Percy,2015-05-05 13:21:03-07:00,['bf06f49c4131bc38dd376b7fe22452c95019228b'],1,9,10,577971,1,0,1,0.714285714,1313
db9f3971c6e78a9649f13b8b2e465f54dee66fb1,0,Michael Percy,2015-05-05 13:37:29-07:00,['1390f70e392f638165198da9446cf31949b2f0e2'],44,24,68,578039,1,,,,1313
74e122a44a6643e0a03c027e08c7b04892b2ee34,1,Jean-Daniel Cryans,2015-05-05 15:00:16-07:00,['db9f3971c6e78a9649f13b8b2e465f54dee66fb1'],125,403,528,578567,16,1,1,0.882352941,1316
3c133db245e9a84e6750483f888d316c1413a84e,1,Todd Lipcon,2015-05-05 15:42:16-07:00,['74e122a44a6643e0a03c027e08c7b04892b2ee34'],158,179,337,578904,30,0.888888889,1,0.777777778,1316
d97de6e887819f9bd43ed4cc7b422b8a91b8cc4e,1,Todd Lipcon,2015-05-05 16:08:08-07:00,['3c133db245e9a84e6750483f888d316c1413a84e'],45,170,215,579119,10,0.205479452,1,1,1316
4be937f2bdf4fab393afac181f15d26c5ff7fe1f,0,Michael Percy,2015-05-05 16:18:18-07:00,['d97de6e887819f9bd43ed4cc7b422b8a91b8cc4e'],1,1,2,579121,1,,,,1316
aa7661cb38d8fc1867a2d02aea142ed0418ea4e4,0,Adar Dembo,2015-05-05 17:35:29-07:00,['4be937f2bdf4fab393afac181f15d26c5ff7fe1f'],34,196,230,579351,4,0.303797468,1,0.974683544,1316
b865a7d08325898e855ac16a5b9c58ada3342fc3,1,Adar Dembo,2015-05-05 18:00:14-07:00,['aa7661cb38d8fc1867a2d02aea142ed0418ea4e4'],47,27,74,579425,8,1,0,0.384615385,1316
92a0403f979a303d6b31db6ddd12efd09c37ed64,1,Michael Percy,2015-05-05 18:12:59-07:00,['b865a7d08325898e855ac16a5b9c58ada3342fc3'],99,100,199,579624,14,0,0,0,1316
2bb6e7aa0a3bcd84e1cd3208f19c39843e8a4feb,0,Michael Percy,2015-05-05 18:55:20-07:00,['92a0403f979a303d6b31db6ddd12efd09c37ed64'],16,24,40,579664,3,1,1,1,1316
faabdb42e2d4c6dad650011ad9dea063a7aabab3,1,Michael Percy,2015-05-05 18:55:45-07:00,['2bb6e7aa0a3bcd84e1cd3208f19c39843e8a4feb'],22,29,51,579715,5,0,0.75,0.75,1316
8b0ed6f30ad78de722f4aad8e69615d7e3215c2d,0,Michael Percy,2015-05-05 18:56:42-07:00,['faabdb42e2d4c6dad650011ad9dea063a7aabab3'],1,6,7,579722,1,0.25,1,1,1316
8195bb2fe1585a7997f5f7053549abec175a0de7,1,Adar Dembo,2015-05-05 18:59:23-07:00,['8b0ed6f30ad78de722f4aad8e69615d7e3215c2d'],1,13,14,579736,1,0,1,1,1316
e105a800bf1ac9eb50e53547e57d0f65e6e43bf6,0,Michael Percy,2015-05-05 21:30:48-07:00,['8195bb2fe1585a7997f5f7053549abec175a0de7'],3,4,7,579743,1,0,0,1,1316
c2ee2e5091fa5c85d1ed79b5fd948b6633ad1e67,0,Jean-Daniel Cryans,2015-05-06 14:24:30-07:00,['e105a800bf1ac9eb50e53547e57d0f65e6e43bf6'],0,1,1,579744,1,,,,1316
512e4c702d8158c793444c7709d1b11a520ae02e,0,Adar Dembo,2015-05-06 19:12:42-07:00,['c2ee2e5091fa5c85d1ed79b5fd948b6633ad1e67'],0,13,13,579757,1,,,,1316
0374d1e1e6f43ea57225ab2c1767c2e5d1b05e0c,1,Todd Lipcon,2015-05-06 21:25:01-07:00,['512e4c702d8158c793444c7709d1b11a520ae02e'],46,85,131,579888,7,0.730769231,0.730769231,0.730769231,1316
9dc1645bc5a32bfbc626f32cb7048081f3edd4eb,0,Todd Lipcon,2015-05-06 22:04:42-07:00,['0374d1e1e6f43ea57225ab2c1767c2e5d1b05e0c'],10,4,14,579902,2,0,0,0,1316
3b889f3d5d8add51db545c8fc0c64a05190719b2,1,Todd Lipcon,2015-05-07 10:12:08-07:00,['9dc1645bc5a32bfbc626f32cb7048081f3edd4eb'],38,117,155,580057,3,0,0,0,1316
6330b27d6e342faaca45c76156208ef44d8c84e1,1,Todd Lipcon,2015-05-07 10:12:35-07:00,['3b889f3d5d8add51db545c8fc0c64a05190719b2'],87,134,221,580278,2,0.714285714,1,0.428571429,1316
5bd61d04f0acd657ce1a9d11302dc46d821272f5,1,Todd Lipcon,2015-05-07 13:53:53-07:00,['6330b27d6e342faaca45c76156208ef44d8c84e1'],49,88,137,580415,10,0,1,1,1316
d239b2b247fe0cbba147787a04d0ed55694ec18d,1,Todd Lipcon,2015-05-07 14:11:11-07:00,['5bd61d04f0acd657ce1a9d11302dc46d821272f5'],50,89,139,580554,15,0.454545455,1,0.681818182,1316
fae84cec64aeb5d7daf84510a8caedaa8232ec93,0,Todd Lipcon,2015-05-07 14:14:48-07:00,['d239b2b247fe0cbba147787a04d0ed55694ec18d'],67,50,117,580671,8,0,0,0,1316
0c41cbbac3e31040b37169a5ad52fc91273c0aef,0,Jean-Daniel Cryans,2015-05-08 08:53:50-07:00,['fae84cec64aeb5d7daf84510a8caedaa8232ec93'],0,168,168,580839,1,0.209302326,0.209302326,0.627906977,1317
3309952efbec3a6254654e47ceca4839015e6e22,1,Adar Dembo,2015-05-08 12:12:16-07:00,['0c41cbbac3e31040b37169a5ad52fc91273c0aef'],956,1046,2002,582841,16,0.914285714,0.942857143,0.8,1319
d5a6ab55c7ead699b8c2278b1a2fb498db0474eb,0,Adar Dembo,2015-05-08 12:12:45-07:00,['3309952efbec3a6254654e47ceca4839015e6e22'],10,10,20,582861,5,,,,1319
96c042024ec32ded442ac9a766cd2e4dfbc3032a,0,Adar Dembo,2015-05-08 17:11:21-07:00,['d5a6ab55c7ead699b8c2278b1a2fb498db0474eb'],6,75,81,582942,3,,,,1320
696805f189e45d118b146e3c3d180e4278c6636e,0,Jean-Daniel Cryans,2015-05-11 10:50:50-07:00,['96c042024ec32ded442ac9a766cd2e4dfbc3032a'],36,32,68,583010,1,1,1,0,1320
b7f05eb1c05a927fc1f0ba7a87db3666eab59f6a,1,Jean-Daniel Cryans,2015-05-11 11:07:32-07:00,['696805f189e45d118b146e3c3d180e4278c6636e'],7,6,13,583023,1,,,,1320
4a280f736bac1cdaa8f61870bb493605ca84cd57,0,Todd Lipcon,2015-05-11 14:21:01-07:00,['b7f05eb1c05a927fc1f0ba7a87db3666eab59f6a'],2,15,17,583040,2,1,1,1,1320
1843d7d119881c1b7f656f88554119f9536c2c06,0,Adar Dembo,2015-05-11 17:23:04-07:00,['4a280f736bac1cdaa8f61870bb493605ca84cd57'],0,8,8,583048,1,,,,1321
3065b7db7f38b07ebfe44fe08914ae2eef1bbab2,1,Todd Lipcon,2015-05-12 11:23:00-07:00,['1843d7d119881c1b7f656f88554119f9536c2c06'],210,490,700,583748,15,0.833333333,1,0.238095238,1325
abb21ed54dee22ebf2cdac29e2182c3ae237662d,1,Todd Lipcon,2015-05-12 13:42:39-07:00,['3065b7db7f38b07ebfe44fe08914ae2eef1bbab2'],12,88,100,583848,5,0.525,1,0,1325
c02ea0393682043efe4c4ba7b3d26a4479ddc72d,0,Adar Dembo,2015-05-12 14:10:05-07:00,['abb21ed54dee22ebf2cdac29e2182c3ae237662d'],2,2,4,583852,1,,,,1325
35ccec07fc822345d3218e776c9a15d404c3bfed,0,Adar Dembo,2015-05-12 16:03:40-07:00,['c02ea0393682043efe4c4ba7b3d26a4479ddc72d'],12,12,24,583876,1,,,,1325
c1da42c6caf76b1ce843cbcf1b035a5afe7020ae,0,Jean-Daniel Cryans,2015-05-12 16:41:05-07:00,['35ccec07fc822345d3218e776c9a15d404c3bfed'],97,167,264,584140,4,0,0.466666667,0.933333333,1325
071ac35c4d95f0462934519af88601bc7aad59ea,1,Jean-Daniel Cryans,2015-05-13 09:45:02-07:00,['c1da42c6caf76b1ce843cbcf1b035a5afe7020ae'],2,13,15,584155,5,,,,1325
ebe4d1fb588dabdad3c8e9b57c9c09cb9eec505e,1,Todd Lipcon,2015-05-13 13:24:27-07:00,['071ac35c4d95f0462934519af88601bc7aad59ea'],532,992,1524,585679,41,0.721393035,0.487562189,0.895522388,1326
cb498de62696b2f71cafdb9cb64e9d342d499d7e,0,Todd Lipcon,2015-05-13 13:50:11-07:00,['ebe4d1fb588dabdad3c8e9b57c9c09cb9eec505e'],2,2,4,585683,1,,,,1326
4faadb14a41f2720a27c305f734520936881beac,0,Todd Lipcon,2015-05-13 13:52:46-07:00,['cb498de62696b2f71cafdb9cb64e9d342d499d7e'],44,24,68,585751,1,0.952380952,1,0,1326
81235bdcd014001037f2cb7bb81bb09ff8add30d,0,Todd Lipcon,2015-05-13 15:56:37-07:00,['4faadb14a41f2720a27c305f734520936881beac'],9,9,18,585769,1,,,,1326
176d4b9d474dc2833f4e09bbe66d1d237ec38de0,0,David Alves,2015-05-13 16:04:25-07:00,['81235bdcd014001037f2cb7bb81bb09ff8add30d'],0,7,7,585776,2,1,1,1,1326
42c6517e1ad2c42e2d8bc578fd56f7140b8d51b8,0,Todd Lipcon,2015-05-13 19:01:09-07:00,['176d4b9d474dc2833f4e09bbe66d1d237ec38de0'],25,90,115,585891,2,0.288888889,0.733333333,0.555555556,1326
a252da00868b442014840d6ff1ed85e2f330e1e1,1,Todd Lipcon,2015-05-13 19:01:13-07:00,['42c6517e1ad2c42e2d8bc578fd56f7140b8d51b8'],27,124,151,586042,6,0.423728814,0.779661017,0.271186441,1326
fb267e6f050aa67d87904bd91a54d9dd14de81e8,0,Adar Dembo,2015-05-13 19:19:42-07:00,['a252da00868b442014840d6ff1ed85e2f330e1e1'],67,39,106,586148,1,0.6,1,0,1326
cedd66445aef83cbfb96d657c687e2b42f8b50ff,1,Michael Percy,2015-05-13 19:31:04-07:00,['fb267e6f050aa67d87904bd91a54d9dd14de81e8'],10,20,30,586178,3,1,1,1,1326
66d538da6535d9d0963ed3bc1452a59d14345be7,0,Dan Burkert,2015-05-13 23:19:23-07:00,['cedd66445aef83cbfb96d657c687e2b42f8b50ff'],15,22,37,586215,4,0,0,0,1326
891880c48cb6bb36fd1d7e322e091389a34f5c99,0,Adar Dembo,2015-05-13 23:58:27-07:00,['66d538da6535d9d0963ed3bc1452a59d14345be7'],6,10,16,586231,1,0,0,1,1326
26c8554afa7a6b19601f4410fb0bae4d62e9f357,0,Adar Dembo,2015-05-14 00:19:35-07:00,['891880c48cb6bb36fd1d7e322e091389a34f5c99'],3,15,18,586249,2,1,1,1,1326
25876a6d18d888e2b2eec8b6061c1df9315778b1,0,Adar Dembo,2015-05-14 00:20:04-07:00,['26c8554afa7a6b19601f4410fb0bae4d62e9f357'],1,1,2,586251,1,,,,1326
4da57df3eff11740fd093edc2cf7d85f439c5aa5,0,Jean-Daniel Cryans,2015-05-14 09:40:23-07:00,['25876a6d18d888e2b2eec8b6061c1df9315778b1'],56,140,196,586447,6,0.65,1,0.966666667,1326
df02bb4af961817028e152ec7767423d87958ab0,1,Jean-Daniel Cryans,2015-05-14 09:40:37-07:00,['4da57df3eff11740fd093edc2cf7d85f439c5aa5'],77,304,381,586828,5,0.25,1,1,1327
a1d5198e48a3e20165b513891111aa840283e143,1,Todd Lipcon,2015-05-14 15:50:56-07:00,['df02bb4af961817028e152ec7767423d87958ab0'],0,159,159,586987,1,0.275229358,1,1,1328
c3d7bc501d285c8c0ac89794b900b9ed618ab35b,0,Dan Burkert,2015-05-14 16:49:24-07:00,['a1d5198e48a3e20165b513891111aa840283e143'],1,28,29,587016,2,0.882352941,0.882352941,0.882352941,1328
1a7733db30f47ae4cd63729cb666f2deec6fa769,0,Todd Lipcon,2015-05-14 18:06:58-07:00,['c3d7bc501d285c8c0ac89794b900b9ed618ab35b'],1,35,36,587052,2,0.2,0,0.9,1328
b6a63530bf7c3332c2b37a58b23d7bd7c46c92ac,1,Dan Burkert,2015-05-14 18:55:59-07:00,['1a7733db30f47ae4cd63729cb666f2deec6fa769'],23,51,74,587126,4,0,0.689655172,1,1328
3f0263b5f8307e86118631b841b7d26b946050c1,0,Todd Lipcon,2015-05-15 00:03:41-07:00,['b6a63530bf7c3332c2b37a58b23d7bd7c46c92ac'],0,4,4,587130,1,0,1,1,1328
3b1b061e8a033864b665e085821fcdb33e4d9c91,0,Todd Lipcon,2015-05-15 00:05:14-07:00,['3f0263b5f8307e86118631b841b7d26b946050c1'],14,21,35,587165,2,,,0,1328
9e8194fd6fb2b25d36bb972559acd3e7c2c3efe0,1,Michael Percy,2015-05-15 01:33:59-07:00,['3b1b061e8a033864b665e085821fcdb33e4d9c91'],40,124,164,587329,8,0.095238095,1,0.952380952,1328
3fe9b66f2c8b0ba037158fd149dea4bcd811752b,1,Michael Percy,2015-05-15 01:34:10-07:00,['9e8194fd6fb2b25d36bb972559acd3e7c2c3efe0'],251,423,674,588003,16,0.435185185,0.574074074,0.574074074,1328
e310c267686869e499e51ea0af8d2a8a8ec97a1e,1,Jean-Daniel Cryans,2015-05-15 09:35:41-07:00,['3fe9b66f2c8b0ba037158fd149dea4bcd811752b'],123,125,248,588251,8,1,0,0,1329
10107f419de805c2fcf7d88734f47e9a7598652d,1,Adar Dembo,2015-05-15 12:53:02-07:00,['e310c267686869e499e51ea0af8d2a8a8ec97a1e'],7,1757,1764,590015,9,0.738461538,1,1,1335
d6e466513a14b75059b6202b224751b2f82bc1d6,1,Todd Lipcon,2015-05-15 13:08:25-07:00,['10107f419de805c2fcf7d88734f47e9a7598652d'],13,109,122,590137,4,0.195121951,0.853658537,1,1335
3b6763dcb1651288e4d9166a1e58481e47ec82b1,0,Jean-Daniel Cryans,2015-05-15 13:16:49-07:00,['d6e466513a14b75059b6202b224751b2f82bc1d6'],4,3,7,590144,1,,,,1335
ac3a8c7f836e80381979f2c68cb1d73064fc5ad7,1,Jean-Daniel Cryans,2015-05-15 13:16:57-07:00,['3b6763dcb1651288e4d9166a1e58481e47ec82b1'],15,23,38,590182,2,1,1,1,1335
3dc3ddabbcc2ea90f613c3b9f67e58925e7b806e,0,Adar Dembo,2015-05-15 14:04:46-07:00,['ac3a8c7f836e80381979f2c68cb1d73064fc5ad7'],5,5,10,590192,1,,,,1335
fc8302fac4301f4af35ff94d86dfefe22c615404,0,Adar Dembo,2015-05-15 14:04:51-07:00,['3dc3ddabbcc2ea90f613c3b9f67e58925e7b806e'],1,1,2,590194,1,,,,1335
1aedb2bfb0f1e58666e34e28cf12d1648300419d,0,Michael Percy,2015-05-15 14:43:33-07:00,['fc8302fac4301f4af35ff94d86dfefe22c615404'],398,11,409,590603,14,0.554945055,0.164835165,0.153846154,1335
d1617dc00ed628ed599b53ae2d3a36f885d51426,0,Jean-Daniel Cryans,2015-05-15 17:16:54-07:00,['1aedb2bfb0f1e58666e34e28cf12d1648300419d'],1,1,2,590605,1,,,,1335
6b5ac3593b9a4e649c069b2cb5313e4747006a6a,1,Jean-Daniel Cryans,2015-05-15 17:16:58-07:00,['d1617dc00ed628ed599b53ae2d3a36f885d51426'],1,17,18,590623,3,0,1,1,1335
035f223af4ac98f7454630bc23369c4d3f42c59e,0,David Wang,2015-05-16 06:43:26-07:00,['6b5ac3593b9a4e649c069b2cb5313e4747006a6a'],72,64,136,590759,2,,,,1335
0481e1a9c3928af2bd51363a816014a590ee0a98,0,Adar Dembo,2015-05-16 23:57:02-07:00,['035f223af4ac98f7454630bc23369c4d3f42c59e'],4,4,8,590767,1,,,,1335
652d105593db74f13a93a490567a64fcbebec5e8,0,Todd Lipcon,2015-05-17 11:40:17-07:00,['0481e1a9c3928af2bd51363a816014a590ee0a98'],2,4,6,590773,1,,,,1335
e579d72e9e69e21c9f12ff2f70c4f7dfd5fb83e6,0,Todd Lipcon,2015-05-18 10:59:33-07:00,['652d105593db74f13a93a490567a64fcbebec5e8'],2,14,16,590789,1,1,0,1,1335
689c221fc117a7bdcd014e5be17c7406052e1da5,0,Andrew Wang,2015-05-18 11:16:10-07:00,['e579d72e9e69e21c9f12ff2f70c4f7dfd5fb83e6'],2,4,6,590795,1,,,,1335
1551a28dc5a83c06a2825ca398569c3ec6dd7815,0,Todd Lipcon,2015-05-18 12:57:26-07:00,['689c221fc117a7bdcd014e5be17c7406052e1da5'],2,1,3,590798,1,,,,1335
c5eb17daf6587d99f7868c42b1c8f9ba21d8fb85,0,Todd Lipcon,2015-05-18 12:58:28-07:00,['1551a28dc5a83c06a2825ca398569c3ec6dd7815'],2,0,2,590800,1,1,0,0,1335
41044dcee791b8f86819f4284e9f7f5ae66b2f21,0,Jean-Daniel Cryans,2015-05-18 15:39:55-07:00,['c5eb17daf6587d99f7868c42b1c8f9ba21d8fb85'],12,21,33,590833,1,0.5,0.625,1,1335
6e237af70dbe1a45b4e16ffd45190ed95b23b976,0,Todd Lipcon,2015-05-19 13:23:04-07:00,['41044dcee791b8f86819f4284e9f7f5ae66b2f21'],0,127,127,590960,2,1,1,0.720930233,1336
800a77dd9ca938620b2d17e39c2aadfb0c0d35d8,0,Dan Burkert,2015-05-19 13:57:53-07:00,['6e237af70dbe1a45b4e16ffd45190ed95b23b976'],16,100,116,591076,6,0.169811321,0.849056604,0.773584906,1336
5503c90b75d2a9533926b78e32ae6f8e2ce51458,0,Todd Lipcon,2015-05-19 17:57:51-07:00,['800a77dd9ca938620b2d17e39c2aadfb0c0d35d8'],14,44,58,591134,3,0.375,1,1,1336
abe8071a48f34c60b31316385be05637160049a3,1,Todd Lipcon,2015-05-19 17:58:01-07:00,['5503c90b75d2a9533926b78e32ae6f8e2ce51458'],26,152,178,591312,4,0.373134328,0.895522388,0.895522388,1336
4870ef20b9a0c729c1d7f16c016c7d91b193e46f,1,Todd Lipcon,2015-05-19 18:03:42-07:00,['abe8071a48f34c60b31316385be05637160049a3'],19,134,153,591465,8,0.489361702,0.85106383,0.978723404,1336
4155b48e6de33500cc17071a4b6c4997411c9320,1,Jean-Daniel Cryans,2015-05-20 15:27:34-07:00,['4870ef20b9a0c729c1d7f16c016c7d91b193e46f'],27,36,63,591528,4,0,0,1,1336
261c1dd425d400550b512ee5f08643cbabc27f78,1,Todd Lipcon,2015-05-20 16:56:43-07:00,['4155b48e6de33500cc17071a4b6c4997411c9320'],15,16,31,591559,7,,,,1336
5ac8d26d2e051af638d73e97c28090f7d475cb06,1,David Alves,2015-05-20 17:46:55-07:00,['261c1dd425d400550b512ee5f08643cbabc27f78'],5,5,10,591569,2,,,,1336
6980c635e6d087a1315d1e8e779a23e1c98a2109,0,Adar Dembo,2015-05-21 11:26:03-07:00,['5ac8d26d2e051af638d73e97c28090f7d475cb06'],5,90,95,591664,4,0,1,1,1336
9f4f45c684c1002208a85b8ba63030d0952b7112,1,Adar Dembo,2015-05-21 11:35:42-07:00,['6980c635e6d087a1315d1e8e779a23e1c98a2109'],246,233,479,592143,12,1,1,0,1336
444e2cce1efef52be44c43bd9822312549f0784e,1,Adar Dembo,2015-05-21 11:35:46-07:00,['9f4f45c684c1002208a85b8ba63030d0952b7112'],192,296,488,592631,14,0.222222222,0.972222222,0.277777778,1338
c3c026a12a0b62b641bb8df7967d743839188f8c,0,Todd Lipcon,2015-05-21 12:32:03-07:00,['444e2cce1efef52be44c43bd9822312549f0784e'],0,1,1,592632,1,0,1,0,1338
97d72d6025ce03d89eca4cb78beb5792c14aa1d4,1,Todd Lipcon,2015-05-21 14:42:44-07:00,['c3c026a12a0b62b641bb8df7967d743839188f8c'],6,51,57,592689,3,1,1,1,1338
b501b620cfbda244709974452f2fb6c60f31b5ac,1,Todd Lipcon,2015-05-21 15:30:16-07:00,['97d72d6025ce03d89eca4cb78beb5792c14aa1d4'],16,54,70,592759,3,0.5,0,0.5,1338
214b606ab224d0400fdb17ebede0112d57425b7a,0,Todd Lipcon,2015-05-21 15:30:22-07:00,['b501b620cfbda244709974452f2fb6c60f31b5ac'],0,7,7,592766,1,0,0.5,1,1338
6dbaff0e00df01986b4a7029a3fcfe55ba5a4161,0,Todd Lipcon,2015-05-21 15:30:32-07:00,['214b606ab224d0400fdb17ebede0112d57425b7a'],1,9,10,592776,1,,,,1338
40601d2dc5851dde868ca3424de92b35867d1633,0,Todd Lipcon,2015-05-21 15:30:37-07:00,['6dbaff0e00df01986b4a7029a3fcfe55ba5a4161'],0,4,4,592780,1,0,0,1,1338
1f8df1b3dec3e3a32efa1836f2d1ab212b18534e,1,Michael Percy,2015-05-21 15:42:21-07:00,['40601d2dc5851dde868ca3424de92b35867d1633'],91,83,174,592954,6,0.555555556,0,0.444444444,1338
cf6adae60ff85ace336e536522326811b8128b00,1,Michael Percy,2015-05-21 15:42:32-07:00,['1f8df1b3dec3e3a32efa1836f2d1ab212b18534e'],2,24,26,592980,2,0,1,1,1338
6358036582277b2b22b669523cf974c5e60af96e,0,Todd Lipcon,2015-05-21 16:04:51-07:00,['cf6adae60ff85ace336e536522326811b8128b00'],0,414,414,593394,2,0.471111111,0.724444444,0.804444444,1340
136b08544ee27ee5ef1c8951eb7a0ee6c31e47b2,0,Andrew Wang,2015-05-21 16:22:37-07:00,['6358036582277b2b22b669523cf974c5e60af96e'],3,2,5,593399,1,0,0,0,1340
2296c235d95fa154a00eac55846ed18bf1ee5f1e,0,Adar Dembo,2015-05-21 16:41:20-07:00,['136b08544ee27ee5ef1c8951eb7a0ee6c31e47b2'],1,26,27,593426,2,,,,1340
d9ef61b5160db930a3e85bd5493c1f285ceb5478,0,Michael Percy,2015-05-21 22:05:00-07:00,['2296c235d95fa154a00eac55846ed18bf1ee5f1e'],0,4,4,593430,1,0,1,1,1340
53902a63efd11ae3c0290119517a7988d1bfdf1c,0,Michael Percy,2015-05-21 22:05:28-07:00,['d9ef61b5160db930a3e85bd5493c1f285ceb5478'],14,14,28,593458,1,,,,1340
201e4c5de519f642f71bb9f0978934be203aef48,0,Michael Percy,2015-05-21 22:05:49-07:00,['53902a63efd11ae3c0290119517a7988d1bfdf1c'],0,6,6,593464,1,,,,1340
c1a0090d6a3c4986777aa86f1c7f5dcb73f00644,0,Jean-Daniel Cryans,2015-05-22 10:57:39-07:00,['201e4c5de519f642f71bb9f0978934be203aef48'],0,3,3,593467,1,0,1,1,1340
2499a990a486525aeead16fd65013ab2b923fe3e,0,Jean-Daniel Cryans,2015-05-22 11:16:30-07:00,['c1a0090d6a3c4986777aa86f1c7f5dcb73f00644'],2,1,3,593470,1,,,,1340
a693ebb3c0870bdfb4cdc62e3f4c8373ff636f21,0,Adar Dembo,2015-05-22 13:22:29-07:00,['2499a990a486525aeead16fd65013ab2b923fe3e'],0,2,2,593472,1,0,1,1,1340
03f99a776a6821a48704694c71713f8a1398633d,0,Todd Lipcon,2015-05-22 14:24:39-07:00,['a693ebb3c0870bdfb4cdc62e3f4c8373ff636f21'],4,9,13,593485,2,0,1,0,1340
8e93695f58a31e4e7e89da36068887bae48131f3,0,Andrew Wang,2015-05-26 10:44:22-07:00,['03f99a776a6821a48704694c71713f8a1398633d'],1,5,6,593491,1,1,1,1,1340
737fb3cfb23184b7a3653cc6e43efada65c560d2,1,David Alves,2015-05-26 11:03:07-07:00,['8e93695f58a31e4e7e89da36068887bae48131f3'],176,347,523,594014,11,0.455445545,1,1,1340
b637c28cb99d23de8277cb788bb0ace856095339,0,Jean-Daniel Cryans,2015-05-26 11:18:35-07:00,['737fb3cfb23184b7a3653cc6e43efada65c560d2'],22,22,44,594058,5,,,,1340
b4a341733db0310f557ff7f0cefe6d4cb49c8fb9,1,Jean-Daniel Cryans,2015-05-26 11:29:12-07:00,['b637c28cb99d23de8277cb788bb0ace856095339'],52,85,137,594195,6,1,1,1,1340
a5fd9ab334cde0d1c78202dab698a2cdf9080efa,0,Jean-Daniel Cryans,2015-05-26 11:31:33-07:00,['b4a341733db0310f557ff7f0cefe6d4cb49c8fb9'],119,204,323,594518,2,,,,1341
89e7df77c3bd4a9027b0207a65813408ebd485fc,0,Todd Lipcon,2015-05-26 11:57:04-07:00,['a5fd9ab334cde0d1c78202dab698a2cdf9080efa'],1,1,2,594520,1,,,,1341
4d880ed21a873205e5ba3b34915678e1a50e1686,0,Todd Lipcon,2015-05-26 11:57:28-07:00,['89e7df77c3bd4a9027b0207a65813408ebd485fc'],1,1,2,594522,1,,,,1341
eceecdd42eee9fda3c9005897326a7feb5405c4e,1,Michael Percy,2015-05-26 14:13:44-07:00,['4d880ed21a873205e5ba3b34915678e1a50e1686'],4,7,11,594533,2,0,1,1,1341
766c1484962907996989f7f247959622abce9b9d,1,Michael Percy,2015-05-26 18:09:01-07:00,['eceecdd42eee9fda3c9005897326a7feb5405c4e'],102,96,198,594731,7,0,0,1,1341
eaa145dc25a9b3a7ddd4d49d43f9435d414bb339,1,Adar Dembo,2015-05-26 18:36:58-07:00,['766c1484962907996989f7f247959622abce9b9d'],14,14,28,594759,1,,,,1341
91143a8407928986f66ba64eada8d38106402ac7,1,Adar Dembo,2015-05-26 18:37:03-07:00,['eaa145dc25a9b3a7ddd4d49d43f9435d414bb339'],27,24,51,594810,3,,,,1341
4002746e8a095a601e6daf6df4e01cde8b857c48,1,Todd Lipcon,2015-05-26 18:38:16-07:00,['91143a8407928986f66ba64eada8d38106402ac7'],7,10,17,594827,4,,,,1341
5b7c9f773c35dcbe2134c76fe2d05214bee76a18,0,Adar Dembo,2015-05-26 18:54:52-07:00,['4002746e8a095a601e6daf6df4e01cde8b857c48'],0,1,1,594828,1,1,1,1,1341
b6d450105cce566e4df863e2ed3ceeb2afee1bda,0,Jean-Daniel Cryans,2015-05-27 08:50:27-07:00,['5b7c9f773c35dcbe2134c76fe2d05214bee76a18'],1,2,3,594831,1,1,1,1,1341
b61eaf7fd9a0caf2b20c9b10b7971756a7c4051a,1,Jean-Daniel Cryans,2015-05-27 11:18:08-07:00,['b6d450105cce566e4df863e2ed3ceeb2afee1bda'],38,53,91,594922,6,0,0,1,1341
da7107c2c2a8ab8e426dcdcb8106f570d51b036c,0,Jean-Daniel Cryans,2015-05-27 11:20:46-07:00,['b61eaf7fd9a0caf2b20c9b10b7971756a7c4051a'],46,54,100,595022,8,1,0,1,1341
c042b8951c08c91fa7b75fd019fbb7b56cb214db,0,Michael Percy,2015-05-27 12:51:04-07:00,['da7107c2c2a8ab8e426dcdcb8106f570d51b036c'],0,15,15,595037,2,,,,1342
5e1f45ee25d296ab5302f19e31e581ce0cca0d5e,0,Jean-Daniel Cryans,2015-05-27 12:56:35-07:00,['c042b8951c08c91fa7b75fd019fbb7b56cb214db'],10,44,54,595091,2,0.875,0.875,1,1342
99c417048e5779b5234c14437ceb031fc5a5ae0e,0,Michael Percy,2015-05-27 13:12:10-07:00,['5e1f45ee25d296ab5302f19e31e581ce0cca0d5e'],3,27,30,595121,2,1,1,1,1342
9ba43d5c231ebbe4fe86b1039e05208ba9cc348a,0,Michael Percy,2015-05-27 13:18:19-07:00,['99c417048e5779b5234c14437ceb031fc5a5ae0e'],1,1,2,595123,1,,,,1342
cf4bf1fd36deb1b676a25d1e5eb7924d67e4249e,0,Michael Percy,2015-05-27 13:19:14-07:00,['9ba43d5c231ebbe4fe86b1039e05208ba9cc348a'],2,1,3,595126,1,,,,1342
ab17fa280882b83a84d44fccdc7ba5254c9dc1d6,0,Jean-Daniel Cryans,2015-05-27 13:20:54-07:00,['cf4bf1fd36deb1b676a25d1e5eb7924d67e4249e'],21,1,22,595148,1,1,0,0.888888889,1342
3a6b265d54a923c6c8748148e506e9044caa5a4b,0,Michael Percy,2015-05-27 14:46:18-07:00,['ab17fa280882b83a84d44fccdc7ba5254c9dc1d6'],30,126,156,595304,6,0,0.614035088,0.228070175,1342
a82c2321c68d14aa335a155779f289b0c9072036,0,Adar Dembo,2015-05-27 14:50:57-07:00,['3a6b265d54a923c6c8748148e506e9044caa5a4b'],9,2,11,595315,1,,,,1342
e7fe0c1a94cac364522c09b8208c98480947d794,0,Jean-Daniel Cryans,2015-05-27 15:06:39-07:00,['a82c2321c68d14aa335a155779f289b0c9072036'],27,236,263,595578,4,0.433566434,0.566433566,1,1343
1012885e00f63b54b91ed7fc556d117d88e4f9e6,0,Jean-Daniel Cryans,2015-05-27 15:32:30-07:00,['e7fe0c1a94cac364522c09b8208c98480947d794'],0,59,59,595637,9,0,1,1,1343
2fc87696cb8307dcf3c5dcd3faf851f2888ea086,0,Adar Dembo,2015-05-27 16:29:24-07:00,['1012885e00f63b54b91ed7fc556d117d88e4f9e6'],1,2,3,595640,1,,,,1343
6c53d0bfe22b105edef5af4213287363ba4a76df,0,Adar Dembo,2015-05-27 17:27:36-07:00,['2fc87696cb8307dcf3c5dcd3faf851f2888ea086'],1,2,3,595643,1,0,1,1,1343
956e0951331d206fb1a5f6df5b64dffaa996ad2b,0,Adar Dembo,2015-05-27 17:27:41-07:00,['6c53d0bfe22b105edef5af4213287363ba4a76df'],15,51,66,595709,4,0.142857143,0,0.761904762,1343
33744e4266a6e0ddd22a08bc51a9e5bcfebaed52,1,Michael Percy,2015-05-27 19:22:08-07:00,['956e0951331d206fb1a5f6df5b64dffaa996ad2b'],12,58,70,595779,5,0.482758621,0.482758621,1,1343
e18951bcaf3736e64bf94a342ddd7ef439db02b8,0,Todd Lipcon,2015-05-28 11:35:45-07:00,['33744e4266a6e0ddd22a08bc51a9e5bcfebaed52'],2,2,4,595783,1,,,,1343
dd81cd4d4d3c5758a40edba047673f5bd033e902,0,Todd Lipcon,2015-05-28 12:50:30-07:00,['e18951bcaf3736e64bf94a342ddd7ef439db02b8'],21,256,277,596060,14,0.242718447,0.466019417,0.747572816,1345
93f27ce18239329c29ef22df8e8ebaf3d4e8cf23,1,Adar Dembo,2015-05-28 13:44:36-07:00,['dd81cd4d4d3c5758a40edba047673f5bd033e902'],1,1,2,596062,1,,,,1345
e59bdc77ce4b4974f8393e5f8489ff8daf0e8946,1,Jean-Daniel Cryans,2015-05-28 16:51:41-07:00,['93f27ce18239329c29ef22df8e8ebaf3d4e8cf23'],48,106,154,596216,6,0.45,0.45,0.4,1345
64d757138e68e79a50d5e80c730eca4138ae9c1f,0,Jean-Daniel Cryans,2015-05-28 16:51:58-07:00,['e59bdc77ce4b4974f8393e5f8489ff8daf0e8946'],3,7,10,596226,1,0.5,0.5,1,1345
d589e8a6227034c15c1b23b43a7819aee25a8e2d,1,Jean-Daniel Cryans,2015-05-28 16:52:05-07:00,['64d757138e68e79a50d5e80c730eca4138ae9c1f'],16,24,40,596266,1,0.428571429,0.857142857,0.857142857,1345
4d6b0580a35b0b7872b754259a4740339702bf7f,0,Todd Lipcon,2015-05-28 17:04:12-07:00,['d589e8a6227034c15c1b23b43a7819aee25a8e2d'],2,2,4,596270,2,,,,1345
fcf6c3c22cec23ab77c90fe0b380f9672c93f0b7,0,Jean-Daniel Cryans,2015-05-28 17:35:13-07:00,['4d6b0580a35b0b7872b754259a4740339702bf7f'],8,54,62,596332,4,0,1,1,1345
5d82368da70029e9e409e5ee7507519e2c152776,1,Michael Percy,2015-05-28 19:04:44-07:00,['fcf6c3c22cec23ab77c90fe0b380f9672c93f0b7'],10,65,75,596407,5,0.194444444,1,1,1345
19cd0e9e78b01532c88b7a73687e1394a0155b31,1,Michael Percy,2015-05-28 19:04:54-07:00,['5d82368da70029e9e409e5ee7507519e2c152776'],6,22,28,596435,2,0.8,1,0.8,1345
0f1fe0f7102f1862d81127f81a75ae68d59e24a9,0,Jean-Daniel Cryans,2015-05-28 19:33:35-07:00,['19cd0e9e78b01532c88b7a73687e1394a0155b31'],1,9,10,596445,2,1,1,1,1345
3294ae7ee079224dc7a3c69e4b75642717a4d541,1,Jean-Daniel Cryans,2015-05-28 20:13:02-07:00,['0f1fe0f7102f1862d81127f81a75ae68d59e24a9'],0,7,7,596452,2,,,,1345
a8a47fe47d871669ed676eba41904f8482b17592,1,Todd Lipcon,2015-05-28 22:15:43-07:00,['3294ae7ee079224dc7a3c69e4b75642717a4d541'],2,12,14,596466,1,1,1,1,1345
067fdc52591e28b6b3d8c80100c9b5f5e4d0a632,1,Adar Dembo,2015-05-29 00:46:39-07:00,['a8a47fe47d871669ed676eba41904f8482b17592'],0,7,7,596473,1,,,,1345
7163a779df7d992fb270abcb3ed85c51c25fe744,0,Todd Lipcon,2015-05-29 12:49:36-07:00,['067fdc52591e28b6b3d8c80100c9b5f5e4d0a632'],1,6,7,596480,1,1,1,1,1345
e1fb317782f482c1e6e8c5d5078d9adcb0b731a4,1,Adar Dembo,2015-05-29 13:07:32-07:00,['7163a779df7d992fb270abcb3ed85c51c25fe744'],69,94,163,596643,54,,,,1345
b4438bbc46704763ca0eb23321ef9674f34ac731,0,Dan Burkert,2015-05-29 15:51:28-07:00,['e1fb317782f482c1e6e8c5d5078d9adcb0b731a4'],28,91,119,596762,3,1,1,1,1345
11ea8cd2f561183afc4b0e277ac664b4eb1137ae,0,Dan Burkert,2015-05-29 15:54:06-07:00,['b4438bbc46704763ca0eb23321ef9674f34ac731'],5,68,73,596835,7,0.263157895,0.921052632,0.921052632,1345
fb58895a7bb7d84f3408b92e41cb6e807936aca6,1,Todd Lipcon,2015-05-29 18:13:57-07:00,['11ea8cd2f561183afc4b0e277ac664b4eb1137ae'],212,236,448,597283,16,1,0,1,1345
ed441dbf01c73e3b41aaa4207580c54f2492ab34,1,Todd Lipcon,2015-05-29 18:14:03-07:00,['fb58895a7bb7d84f3408b92e41cb6e807936aca6'],6,173,179,597462,4,1,1,1,1346
d60eccd9f1540ba053e0946425beb8e4e0999193,0,Todd Lipcon,2015-05-29 18:14:37-07:00,['ed441dbf01c73e3b41aaa4207580c54f2492ab34'],2,15,17,597479,2,1,1,1,1346
7a1bc446a97496db6020a5535a0842991553facf,0,Todd Lipcon,2015-05-31 12:13:50-07:00,['d60eccd9f1540ba053e0946425beb8e4e0999193'],3,3,6,597485,1,,,,1346
4e36a35a1343204e3de0b9f840a2c2704ed4dbcb,0,Todd Lipcon,2015-06-01 10:21:35-07:00,['7a1bc446a97496db6020a5535a0842991553facf'],10,33,43,597528,7,1,1,0.636363636,1346
4f8b56f5650808cbcb40bac411b083979dc7b04d,0,Todd Lipcon,2015-06-01 10:22:49-07:00,['4e36a35a1343204e3de0b9f840a2c2704ed4dbcb'],15,20,35,597563,6,1,0,0,1346
76fb3873fb189ce9de90f5e0bbdd1662bf7e09f4,0,Jean-Daniel Cryans,2015-06-01 10:36:26-07:00,['4f8b56f5650808cbcb40bac411b083979dc7b04d'],3,30,33,597596,3,1,1,1,1346
26bd7455211af9fe2bc011ec2aae9fae45e5fa9a,0,Jean-Daniel Cryans,2015-06-01 11:31:16-07:00,['76fb3873fb189ce9de90f5e0bbdd1662bf7e09f4'],0,1,1,597597,1,0,1,0,1346
79179d4edb9cb2d9b9453d5050b6f995f0e0781f,0,David Alves,2015-06-01 11:35:56-07:00,['26bd7455211af9fe2bc011ec2aae9fae45e5fa9a'],3,9,12,597609,1,0,1,1,1346
78cdd4130314316ac74fd41332b03c50578e1a57,0,David Alves,2015-06-01 13:09:52-07:00,['79179d4edb9cb2d9b9453d5050b6f995f0e0781f'],8,7,15,597624,1,1,0,0,1346
022e6a20cd8fda0dbf8fa1cf482985bdc24ea732,0,Andrew Wang,2015-06-01 14:23:05-07:00,['78cdd4130314316ac74fd41332b03c50578e1a57'],19,12,31,597655,2,1,0,0,1346
aac18f2d4bf84e47ea2bb334e3f3ddb792d2ab50,0,Adar Dembo,2015-06-01 15:50:08-07:00,['022e6a20cd8fda0dbf8fa1cf482985bdc24ea732'],0,5,5,597660,1,,,,1346
b94e0247dd103e2ae344ab658c56ebab2dfe7654,0,Michael Percy,2015-06-01 18:12:55-07:00,['aac18f2d4bf84e47ea2bb334e3f3ddb792d2ab50'],1,8,9,597669,2,0,0,1,1346
138100f92a358c3dc0a34c29cc18fc5a62298d03,1,Michael Percy,2015-06-01 18:17:56-07:00,['b94e0247dd103e2ae344ab658c56ebab2dfe7654'],3,16,19,597688,5,0,1,0.666666667,1346
186252e6ac54932166cedb728b14ac90fc30c2a1,0,Todd Lipcon,2015-06-01 20:24:35-07:00,['138100f92a358c3dc0a34c29cc18fc5a62298d03'],9,44,53,597741,2,0.272727273,0.772727273,0.5,1346
a1bc91c3adbe3e660bd2c8d52a4a24f054a40fbc,0,Todd Lipcon,2015-06-01 20:27:17-07:00,['186252e6ac54932166cedb728b14ac90fc30c2a1'],0,2,2,597743,1,,,,1346
96c8e105d618564463185463b938d1224685d693,0,Jean-Daniel Cryans,2015-06-01 20:59:36-07:00,['a1bc91c3adbe3e660bd2c8d52a4a24f054a40fbc'],0,27,27,597770,4,1,1,1,1346
6b08f455e5318ef81252ae105d3e27262faa5aeb,1,Jean-Daniel Cryans,2015-06-01 20:59:49-07:00,['96c8e105d618564463185463b938d1224685d693'],97,68,165,597935,6,0.25,0.0625,0,1346
0a7f9bcd8017b83e93a7a21cbcae19b08b229337,1,Michael Percy,2015-06-02 00:44:45-07:00,['6b08f455e5318ef81252ae105d3e27262faa5aeb'],55,286,341,598276,11,0.131782946,0.984496124,0.093023256,1346
8443ff936a729f8d12a7ff310eb58f9a93b9a215,0,Michael Percy,2015-06-02 00:44:56-07:00,['0a7f9bcd8017b83e93a7a21cbcae19b08b229337'],2,3,5,598281,1,,,,1346
7ece4a0943445a5ae300e096cb451e2aeb6ba2ff,1,Todd Lipcon,2015-06-02 12:46:37-07:00,['8443ff936a729f8d12a7ff310eb58f9a93b9a215'],17,31,48,598329,3,0,1,0,1346
535daec8ec1b4b6645c4d91065503f926b8ac1b2,1,Todd Lipcon,2015-06-02 13:27:21-07:00,['7ece4a0943445a5ae300e096cb451e2aeb6ba2ff'],159,917,1076,599405,18,0.116772824,0.815286624,0.543524416,1346
aba13d7d4d995fb74848f20f72b42127572e3069,1,Michael Percy,2015-06-02 13:51:45-07:00,['535daec8ec1b4b6645c4d91065503f926b8ac1b2'],2,9,11,599416,1,0,0,1,1346
24cd11417b52b4998e82b0a5d85c25a89f814972,1,Adar Dembo,2015-06-03 03:48:41-07:00,['aba13d7d4d995fb74848f20f72b42127572e3069'],5,24,29,599445,2,0,0.642857143,0.642857143,1346
11818b42539c68ba764b7926e598edc52c7e6c9e,0,Jean-Daniel Cryans,2015-06-03 08:36:19-07:00,['24cd11417b52b4998e82b0a5d85c25a89f814972'],14,0,14,599459,2,,,,1346
0bc8345756422625fe410cb3017921c383b13166,0,Todd Lipcon,2015-06-03 10:49:36-07:00,['11818b42539c68ba764b7926e598edc52c7e6c9e'],2,3,5,599464,2,,,,1346
ac70b82d8a6f8fcbada0989555172b8651d18766,0,Todd Lipcon,2015-06-03 10:49:49-07:00,['0bc8345756422625fe410cb3017921c383b13166'],2,0,2,599466,1,,,,1346
d50f967e0f84fa061fa6fce537a09590a2d65aac,0,Todd Lipcon,2015-06-03 10:50:20-07:00,['ac70b82d8a6f8fcbada0989555172b8651d18766'],4,4,8,599474,1,,,,1346
c03835054d3310d644ac537a7d8966f0d77bd997,0,Todd Lipcon,2015-06-03 10:51:15-07:00,['d50f967e0f84fa061fa6fce537a09590a2d65aac'],3,6,9,599483,2,1,1,1,1346
8a3aeb3b1a96b55f1949c6f12c1d06d9ef709cb5,1,Todd Lipcon,2015-06-03 14:13:40-07:00,['c03835054d3310d644ac537a7d8966f0d77bd997'],1104,1104,2208,601691,109,,,,1346
da8e0425a57199d43a8b57a11cd3024df7821f64,0,Todd Lipcon,2015-06-03 14:41:20-07:00,['8a3aeb3b1a96b55f1949c6f12c1d06d9ef709cb5'],1,1,2,601693,1,,,,1346
c721cf8a9dbd1cf64f81d567edab69bebe464d00,0,Todd Lipcon,2015-06-03 21:07:43-07:00,['da8e0425a57199d43a8b57a11cd3024df7821f64'],16,23,39,601732,1,1,1,1,1346
8095f98b727a894b623006396080a1db35c7fcda,1,Todd Lipcon,2015-06-04 16:04:54-07:00,['c721cf8a9dbd1cf64f81d567edab69bebe464d00'],2,31,33,601765,5,1,1,1,1346
15bc88706e3a837a6cf57028a2b4be0d6fe9709a,1,Dan Burkert,2015-06-04 16:07:19-07:00,['8095f98b727a894b623006396080a1db35c7fcda'],14,66,80,601845,10,0.9375,1,0.4375,1346
da608eb302d69946fcf0d0ea3616104b66b0151a,0,Todd Lipcon,2015-06-04 18:30:08-07:00,['15bc88706e3a837a6cf57028a2b4be0d6fe9709a'],3,9,12,601857,1,1,1,1,1346
f6b39f4041590a9136677c5be553c5815405f955,0,Todd Lipcon,2015-06-04 18:30:22-07:00,['da608eb302d69946fcf0d0ea3616104b66b0151a'],8,11,19,601876,3,,,,1346
7d14c3da23ab03f2c36df7366b44a2dc213683dd,0,Todd Lipcon,2015-06-04 21:18:34-07:00,['f6b39f4041590a9136677c5be553c5815405f955'],11,9,20,601896,1,1,1,1,1346
936d636316cf0e0836c97a453bd4e6f018c84674,1,Adar Dembo,2015-06-05 01:49:33-07:00,['7d14c3da23ab03f2c36df7366b44a2dc213683dd'],155,8,163,602059,9,0,0,0,1346
5a4c7eb2b7a4757d11cdbb47efc9263299b6effc,0,Adar Dembo,2015-06-05 01:49:58-07:00,['936d636316cf0e0836c97a453bd4e6f018c84674'],7,0,7,602066,2,0,0,1,1346
eed57b1d2512289fd539400f8e668a83b31fb619,0,Adar Dembo,2015-06-05 01:51:33-07:00,['5a4c7eb2b7a4757d11cdbb47efc9263299b6effc'],207,140,347,602413,19,1,1,1,1346
738253e8c6d498796f640aff5123307149228473,0,Adar Dembo,2015-06-05 01:52:59-07:00,['eed57b1d2512289fd539400f8e668a83b31fb619'],41,371,412,602825,10,0.274390244,0.713414634,0.658536585,1349
41f5da87fdab2bde67f0f96d0e4259155ef492c3,0,Adar Dembo,2015-06-05 01:58:29-07:00,['738253e8c6d498796f640aff5123307149228473'],428,859,1287,604112,34,0.655430712,0.842696629,0.846441948,1349
3af0207f9e44e9e70508faa01e3386915f1bb68c,0,Dan Burkert,2015-06-05 09:47:48-07:00,['41f5da87fdab2bde67f0f96d0e4259155ef492c3'],7,28,35,604147,1,0.8,0.733333333,1,1349
025a0c33bd695625fa56536525cf704f44243ae8,0,David Alves,2015-06-05 11:30:50-07:00,['3af0207f9e44e9e70508faa01e3386915f1bb68c'],5,37,42,604189,5,0.944444444,1,1,1349
c3b87b67c7be0aa087751f462c306fd4f7dce9f5,1,Jean-Daniel Cryans,2015-06-05 13:22:27-07:00,['025a0c33bd695625fa56536525cf704f44243ae8'],139,316,455,604644,13,0.753424658,1,0.863013699,1350
5fd9168c63a1f8676ee822029b9b0472241b3fe0,1,Adar Dembo,2015-06-05 15:11:26-07:00,['c3b87b67c7be0aa087751f462c306fd4f7dce9f5'],30,41,71,604715,2,1,1,1,1350
23f95e7b7687fb0b650cab95078361c4b44575be,0,Jean-Daniel Cryans,2015-06-05 16:04:07-07:00,['5fd9168c63a1f8676ee822029b9b0472241b3fe0'],47,111,158,604873,6,0.523809524,0.976190476,0.023809524,1350
96b55b821a41196495c63b33c02e1b87db54f6a3,0,Michael Percy,2015-06-05 16:25:29-07:00,['23f95e7b7687fb0b650cab95078361c4b44575be'],0,8,8,604881,1,1,1,1,1350
26c9799c3b8c176691314f3d60d8ad529ea5e775,1,Adar Dembo,2015-06-05 17:45:20-07:00,['96b55b821a41196495c63b33c02e1b87db54f6a3'],107,222,329,605210,9,0,0.588235294,0.482352941,1350
3261756993ecb99b13b820011bec6e144c8ed3f6,0,Jean-Daniel Cryans,2015-06-09 08:00:35-07:00,['26c9799c3b8c176691314f3d60d8ad529ea5e775'],7,7,14,605224,1,1,0,0,1350
1405079643a63cabc80b76a34cc360bfe662fc3c,1,Jean-Daniel Cryans,2015-06-09 13:41:33-07:00,['3261756993ecb99b13b820011bec6e144c8ed3f6'],15,100,115,605339,3,0,0.149253731,1,1350
12c21c6080c8bfb109f6c4d291aa3f95096e88ce,1,Todd Lipcon,2015-06-09 16:52:10-07:00,['1405079643a63cabc80b76a34cc360bfe662fc3c'],292,342,634,605973,30,0.828571429,0.942857143,0.885714286,1350
a6338dc934de9b61519db8f430ba82577821f7a1,1,Todd Lipcon,2015-06-09 16:52:46-07:00,['12c21c6080c8bfb109f6c4d291aa3f95096e88ce'],73,70,143,606116,19,,,,1350
888877426abfe99fb27dd62a1ac2b19e3bebc81d,1,Todd Lipcon,2015-06-09 16:53:32-07:00,['a6338dc934de9b61519db8f430ba82577821f7a1'],73,321,394,606510,15,0.292134831,1,0.460674157,1351
495817d9f3431a504419fd920fef31fd3d351630,0,Todd Lipcon,2015-06-09 16:54:32-07:00,['888877426abfe99fb27dd62a1ac2b19e3bebc81d'],6,41,47,606557,2,1,1,0.272727273,1351
6520e13d98febed5c6e513c46ff79d7ee8729e62,0,Todd Lipcon,2015-06-09 16:57:03-07:00,['495817d9f3431a504419fd920fef31fd3d351630'],51,3,54,606611,3,,,,1351
de7796f68bdd34389d5854707da14f00ea81aa1c,0,Todd Lipcon,2015-06-09 16:57:18-07:00,['6520e13d98febed5c6e513c46ff79d7ee8729e62'],13,13,26,606637,12,,,,1351
fcc13bc2b39622b734e08fdbc4a3705bd4ab016d,0,Todd Lipcon,2015-06-10 11:39:32-07:00,['de7796f68bdd34389d5854707da14f00ea81aa1c'],32,94,126,606763,5,0,1,1,1351
4227aeec9b3d415e5fae010d33573c023016030b,0,Todd Lipcon,2015-06-10 11:40:01-07:00,['fcc13bc2b39622b734e08fdbc4a3705bd4ab016d'],0,33,33,606796,3,0,0,1,1351
7fc29d2a2eac927855441baa37af7f0c25ab855f,0,Todd Lipcon,2015-06-10 12:59:47-07:00,['4227aeec9b3d415e5fae010d33573c023016030b'],208,267,475,607271,26,1,1,1,1352
d4b1c5262523eedd68ead40b373223ce9885c0a7,0,Todd Lipcon,2015-06-10 15:12:46-07:00,['7fc29d2a2eac927855441baa37af7f0c25ab855f'],28,22,50,607321,3,,,,1352
f99e67ba4fb976cf67e841eb3aabe1e0f0ec1b30,0,Todd Lipcon,2015-06-10 15:19:34-07:00,['d4b1c5262523eedd68ead40b373223ce9885c0a7'],1,5,6,607327,1,,,,1352
e13142aa5f50a22e8d529bde177cce30adc14a55,1,Adar Dembo,2015-06-11 16:05:25-07:00,['f99e67ba4fb976cf67e841eb3aabe1e0f0ec1b30'],16,24,40,607367,4,0.6,0.6,1,1352
849330144a25f8cf56d1a3f6d330813b6e4e8df5,0,Adar Dembo,2015-06-11 18:20:02-07:00,['e13142aa5f50a22e8d529bde177cce30adc14a55'],110,157,267,607634,6,0,1,1,1353
787f6137c83de12b49b38623fb4eb19cdaf56aa3,1,Jean-Daniel Cryans,2015-06-12 09:00:58-07:00,['849330144a25f8cf56d1a3f6d330813b6e4e8df5'],22,25,47,607681,6,1,1,0,1353
11b394ff93930a90d0224a64ca214b24700cbc94,0,Jean-Daniel Cryans,2015-06-12 15:39:38-07:00,['787f6137c83de12b49b38623fb4eb19cdaf56aa3'],2,2,4,607685,1,,,,1353
1ef86b3e2050bee8564cb880fa38eaa69226c1ed,0,Jean-Daniel Cryans,2015-06-12 15:50:55-07:00,['11b394ff93930a90d0224a64ca214b24700cbc94'],39,25,64,607749,1,1,1,0,1353
27bfa5090884eaa00540f0eb9142c8a4f647d3b1,1,Jean-Daniel Cryans,2015-06-15 08:57:02-07:00,['1ef86b3e2050bee8564cb880fa38eaa69226c1ed'],13,121,134,607883,7,0.285714286,0.693877551,1,1353
3b0ff19d76fd40a0505fdd7ac6b50dc40a87ccf6,1,Jean-Daniel Cryans,2015-06-15 09:10:21-07:00,['27bfa5090884eaa00540f0eb9142c8a4f647d3b1'],0,57,57,607940,2,0,1,0,1353
dd74f42292e3bcee5cfdf9dd67248f345919abc8,0,Todd Lipcon,2015-06-15 15:06:25-07:00,['3b0ff19d76fd40a0505fdd7ac6b50dc40a87ccf6'],6,59,65,608005,4,0.166666667,1,1,1353
1221087195c5a1dc6e3470ac866d459dfca33ef6,0,Adar Dembo,2015-06-15 15:38:52-07:00,['dd74f42292e3bcee5cfdf9dd67248f345919abc8'],1838,0,1838,609843,1,0.147713951,0.028135991,0.058616647,1353
55e7ba1ffef1c34f24229b5d3288bf82dee2dd16,1,Todd Lipcon,2015-06-15 16:53:25-07:00,['1221087195c5a1dc6e3470ac866d459dfca33ef6'],190,269,459,610302,45,0.666666667,0,0.948717949,1353
83800b5047e8fca95245f49fa8245a7912af461b,0,Todd Lipcon,2015-06-15 18:04:26-07:00,['55e7ba1ffef1c34f24229b5d3288bf82dee2dd16'],54,10,64,610366,7,0.0625,0,0,1353
5df4c50c6db76cff467b3446983e277fe4f48ef0,0,Adar Dembo,2015-06-15 19:26:44-07:00,['83800b5047e8fca95245f49fa8245a7912af461b'],5,22,27,610393,1,,,,1353
56af0c5ef2387faf28568911f7552d1d45b24274,0,Todd Lipcon,2015-06-15 19:33:10-07:00,['5df4c50c6db76cff467b3446983e277fe4f48ef0'],1,5,6,610399,1,,,,1353
fb8bafa17647502651cc3a2d1cc937c6b1772c5e,0,Todd Lipcon,2015-06-15 19:33:27-07:00,['56af0c5ef2387faf28568911f7552d1d45b24274'],23,325,348,610747,8,0.323741007,0.611510791,0.776978417,1353
4ec6dac9a57e38bccc207383b17cb794be1bd8e2,0,Todd Lipcon,2015-06-15 19:33:37-07:00,['fb8bafa17647502651cc3a2d1cc937c6b1772c5e'],22,190,212,610959,6,0.010204082,0.704081633,0.448979592,1353
3932617da0bb0026938df538a8365c0b3b2bc8d6,0,Adar Dembo,2015-06-17 11:05:00-07:00,['4ec6dac9a57e38bccc207383b17cb794be1bd8e2'],107,47,154,611113,9,0,1,0,1353
01698c39369b2d27e8b3180353322124bbf7e88b,1,Adar Dembo,2015-06-17 11:08:22-07:00,['3932617da0bb0026938df538a8365c0b3b2bc8d6'],40,135,175,611288,4,0.341463415,0,1,1353
2cfb74d6c5f1f2cb4d695f0cd103b01e8a09f5d1,0,Todd Lipcon,2015-06-17 14:38:46-07:00,['01698c39369b2d27e8b3180353322124bbf7e88b'],2,5,7,611295,1,,,,1353
7a632c64d8cd3596b2d39b78b52cfe49c05099e2,0,Todd Lipcon,2015-06-17 16:10:59-07:00,['2cfb74d6c5f1f2cb4d695f0cd103b01e8a09f5d1'],5,5,10,611305,1,,,,1353
89f8495fd3b5130b0c5b913eafb811bfc9dc2733,0,Todd Lipcon,2015-06-17 16:11:19-07:00,['7a632c64d8cd3596b2d39b78b52cfe49c05099e2'],2,15,17,611322,2,0.444444444,1,1,1353
cd90c1ddb45c1d4da663f4d9d51f9f72e1168a8b,0,Todd Lipcon,2015-06-17 20:32:48-07:00,['89f8495fd3b5130b0c5b913eafb811bfc9dc2733'],7,7,14,611336,1,,,,1353
dde7c8fced5b8e671fe65cbedcfb00446b08e41b,1,Todd Lipcon,2015-06-18 12:28:09-07:00,['cd90c1ddb45c1d4da663f4d9d51f9f72e1168a8b'],89,717,806,612142,25,0.549488055,0.795221843,0.836177474,1355
d92077ae93f095ff686d0dc7977712f4b55da0a0,0,Dan Burkert,2015-06-19 10:31:11-07:00,['dde7c8fced5b8e671fe65cbedcfb00446b08e41b'],218,63,281,612423,17,,,,1355
ad97428d2d80f62b68262a5a9b8e014defb43265,0,Jean-Daniel Cryans,2015-06-19 11:06:56-07:00,['d92077ae93f095ff686d0dc7977712f4b55da0a0'],0,5,5,612428,1,,,,1355
5d8d2dc34ab8ec59f035fabdcf8a6c384e66c004,0,Adar Dembo,2015-06-19 16:14:28-07:00,['ad97428d2d80f62b68262a5a9b8e014defb43265'],6,27,33,612461,1,,,,1355
ce05de71f51c6e2c3c91813712351fa45ea08d74,1,Adar Dembo,2015-06-22 15:18:28-07:00,['5d8d2dc34ab8ec59f035fabdcf8a6c384e66c004'],28,32,60,612521,4,0,1,0,1355
9679fe10f6d5546e4db84137d97bfbb59e8a3100,0,Adar Dembo,2015-06-22 17:00:32-07:00,['ce05de71f51c6e2c3c91813712351fa45ea08d74'],0,2,2,612523,1,,,,1355
07fae1ddd2f1afcffb3239b852c79fa6082d8bb7,1,Todd Lipcon,2015-06-23 08:41:44-07:00,['9679fe10f6d5546e4db84137d97bfbb59e8a3100'],225,551,776,613299,11,,,,1365
9ce4c99299fb963cf37daf2c6eabed01aa2c8fe2,0,Todd Lipcon,2015-06-23 08:44:02-07:00,['07fae1ddd2f1afcffb3239b852c79fa6082d8bb7'],0,243,243,613542,1,,,,1366
d8c5081670c9ff5f7455a7ebc641d4d355b511b1,1,Todd Lipcon,2015-06-24 21:16:11-07:00,['9ce4c99299fb963cf37daf2c6eabed01aa2c8fe2'],283,474,757,614299,18,0.4,0.9,0.29,1366
e758506ee463b1da5b8ddf7d37eaa3e5548e00a9,1,Adar Dembo,2015-06-24 21:34:06-07:00,['d8c5081670c9ff5f7455a7ebc641d4d355b511b1'],267,185,452,614751,16,0.765625,0.40625,0.6875,1366
897f685e6d694fbb417d64abd9b2fe9c343c9e81,0,Todd Lipcon,2015-06-24 22:27:50-07:00,['e758506ee463b1da5b8ddf7d37eaa3e5548e00a9'],182,199,381,615132,11,,,,1367
59fa1930dc1401c4f8af9b7c76ad3b08c30617b9,1,Adar Dembo,2015-06-24 22:41:40-07:00,['897f685e6d694fbb417d64abd9b2fe9c343c9e81'],42,43,85,615217,12,1,1,0,1367
b6306163bd1b9dcc12a2e9d572305ec96a79083f,1,Adar Dembo,2015-06-24 22:41:45-07:00,['59fa1930dc1401c4f8af9b7c76ad3b08c30617b9'],135,17,152,615369,16,0.265060241,0.072289157,0.277108434,1367
7b3d471083fba6edd15362035549ab997ae2c965,0,Adar Dembo,2015-06-25 13:59:03-07:00,['b6306163bd1b9dcc12a2e9d572305ec96a79083f'],1849,10,1859,617228,10,0.89507772,0.914507772,0.862694301,1367
a3fd29088d3b293e3b6a8a5395148429a10cdb28,0,Todd Lipcon,2015-06-25 15:58:53-07:00,['7b3d471083fba6edd15362035549ab997ae2c965'],0,58,58,617286,2,,,,1368
c4d0c21dea6528dfc100319abfe7ae512429cda6,0,Adar Dembo,2015-06-26 13:59:22-07:00,['a3fd29088d3b293e3b6a8a5395148429a10cdb28'],1,83,84,617370,6,,,,1369
835a096a699787a6252be927dcd8860448a114e7,1,Adar Dembo,2015-06-29 15:03:20-07:00,['c4d0c21dea6528dfc100319abfe7ae512429cda6'],293,320,613,617983,25,1,1,1,1369
4e1aae7953860cf3b04a427cb4ccd23af4d34aa1,0,Adar Dembo,2015-06-29 17:57:34-07:00,['835a096a699787a6252be927dcd8860448a114e7'],0,2,2,617985,1,,,,1369
ab909d2db690ba269a4f3a8fbf2bc0903d5a9ea8,1,Todd Lipcon,2015-06-29 21:09:08-07:00,['4e1aae7953860cf3b04a427cb4ccd23af4d34aa1'],7,39,46,618031,4,0.304347826,0.304347826,0.304347826,1369
f15cf1b15d63b05b90992409a73ffdb3b183ee1d,1,Todd Lipcon,2015-06-29 21:09:38-07:00,['ab909d2db690ba269a4f3a8fbf2bc0903d5a9ea8'],0,56,56,618087,1,0,1,1,1369
e38f86107d34952dfd0f365d27ddddd11e5a402b,0,Adar Dembo,2015-06-30 13:47:55-07:00,['f15cf1b15d63b05b90992409a73ffdb3b183ee1d'],25,74,99,618186,4,,,,1369
8c43b5b165b85237dae9d5b26b7cf32bff3cbc12,1,Todd Lipcon,2015-06-30 17:35:48-07:00,['e38f86107d34952dfd0f365d27ddddd11e5a402b'],40,282,322,618508,6,0,0.46875,0.875,1369
0d81ad790af69f35951c9f5a1b0806cc815c1b16,1,Todd Lipcon,2015-06-30 17:36:09-07:00,['8c43b5b165b85237dae9d5b26b7cf32bff3cbc12'],237,205,442,618950,16,0.769230769,0.307692308,1,1369
55e019fbd8b80b64c0c4c719ac66a4ac380d1f9a,1,Todd Lipcon,2015-06-30 23:33:04-07:00,['0d81ad790af69f35951c9f5a1b0806cc815c1b16'],50,51,101,619051,7,1,,0,1369
1c1af1db716280ebae0f363c1ec852dab08022be,0,Todd Lipcon,2015-06-30 23:33:48-07:00,['55e019fbd8b80b64c0c4c719ac66a4ac380d1f9a'],0,121,121,619172,10,1,1,1,1373
bb5d2f0123cc20c026486766797de4a0ff7f63b0,1,Todd Lipcon,2015-06-30 23:36:54-07:00,['1c1af1db716280ebae0f363c1ec852dab08022be'],36,160,196,619368,7,0.92,1,0.9,1375
1fe2f58b55553e56b9677100ef59cf768a8a0c9d,1,Todd Lipcon,2015-07-01 11:10:11-07:00,['bb5d2f0123cc20c026486766797de4a0ff7f63b0'],26,131,157,619525,12,0.75,1,0.65,1375
270dcb5b495e7ccfca715bc287e7c46a8d000328,1,Todd Lipcon,2015-07-01 11:16:48-07:00,['1fe2f58b55553e56b9677100ef59cf768a8a0c9d'],74,94,168,619693,12,0.8,1,1,1375
fd740b6d6e963ea6ac7620e2d291d877972e651e,0,Todd Lipcon,2015-07-01 11:23:34-07:00,['270dcb5b495e7ccfca715bc287e7c46a8d000328'],22,59,81,619774,6,0,0.958333333,1,1375
4798818a542553103c1c479d68d04a2b8a31fbf7,1,Adar Dembo,2015-07-01 13:40:48-07:00,['fd740b6d6e963ea6ac7620e2d291d877972e651e'],193,128,321,620095,16,0,0,0.692307692,1375
5a24ffa1fba046fc6c3b6128fe89b1ff5dd4a281,0,Adar Dembo,2015-07-01 13:40:53-07:00,['4798818a542553103c1c479d68d04a2b8a31fbf7'],9,7,16,620111,1,1,1,1,1375
6523a87e974e39f7da24e1b12659be7d49e0dd4e,1,Todd Lipcon,2015-07-01 14:10:54-07:00,['5a24ffa1fba046fc6c3b6128fe89b1ff5dd4a281'],16,14,30,620141,3,1,1,1,1375
a05962cc09300c4f3097556529531fc6659a9419,0,Todd Lipcon,2015-07-01 15:12:10-07:00,[],0,202,202,620343,1,,,,1376
3f4faff857e4313cc3ce7e16829ec4c2507b612a,0,Todd Lipcon,2015-07-01 15:12:28-07:00,['a05962cc09300c4f3097556529531fc6659a9419'],0,207,207,620550,5,0.526315789,0.526315789,1,1381
b9e756c9afbbeb533b36a252f7517579aeb321ac,0,Todd Lipcon,2015-07-01 18:02:08-07:00,['3f4faff857e4313cc3ce7e16829ec4c2507b612a'],0,31,31,620581,1,,,,1381
bc6aa4fb7a1477de58a9f7db3b71122007d79448,0,Todd Lipcon,2015-07-01 18:02:17-07:00,['b9e756c9afbbeb533b36a252f7517579aeb321ac'],1,4,5,620586,1,1,1,1,1381
eb7dbe3fe244698bc24c674d0b89416379722bae,0,Todd Lipcon,2015-07-02 03:24:05-07:00,['bc6aa4fb7a1477de58a9f7db3b71122007d79448'],1,44,45,620631,1,0.821428571,0.821428571,1,1381
eebd670db3d1b71363d7ca06af116f3af991dae2,0,Todd Lipcon,2015-07-02 03:24:34-07:00,['eb7dbe3fe244698bc24c674d0b89416379722bae'],0,318,318,620949,4,0.268421053,0.268421053,0.552631579,1385
4ac1083126c442a105aa0db793be437dc875d055,0,Adar Dembo,2015-07-02 11:49:36-07:00,['6523a87e974e39f7da24e1b12659be7d49e0dd4e'],0,1,1,620950,1,0,1,1,1385
4350d64df609fd18330537eca79173d3b1e5b057,0,Adar Dembo,2015-07-02 11:59:00-07:00,['4ac1083126c442a105aa0db793be437dc875d055'],1,7,8,620958,2,0.6,1,1,1385
cde0f80d4bb7e734617094d8690cea1f83cca53d,0,Todd Lipcon,2015-07-02 17:30:57-07:00,['4350d64df609fd18330537eca79173d3b1e5b057'],4,36,40,620998,2,1,1,1,1385
5f704a09bfabb205767de3a040191892b12af894,0,Todd Lipcon,2015-07-05 13:59:45-07:00,['cde0f80d4bb7e734617094d8690cea1f83cca53d'],5,3,8,621006,1,0,0,0,1385
681f495d4a6fbbf4a8c409d79119aa264b6131a3,0,Todd Lipcon,2015-07-05 14:00:13-07:00,['5f704a09bfabb205767de3a040191892b12af894'],4,29,33,621039,2,0,1,0.7,1385
f3a5498487022a941c1562191cad052fa9aee497,1,Misty Stanley-Jones,2015-07-05 19:18:11-07:00,['681f495d4a6fbbf4a8c409d79119aa264b6131a3'],16,48,64,621103,1,,,,1385
4a2fc124b3d708ed403e7f71e4e40faeb52b8159,0,Adar Dembo,2015-07-06 01:35:53-07:00,['f3a5498487022a941c1562191cad052fa9aee497'],1,1,2,621105,1,,,,1385
5f0d464fc577361ade774683eef5836694e693c5,0,Adar Dembo,2015-07-06 01:48:01-07:00,['4a2fc124b3d708ed403e7f71e4e40faeb52b8159'],2,2,4,621109,1,,,,1385
926e924c5d4c984f459dbe07ca858c745c37250a,0,Adar Dembo,2015-07-06 01:56:34-07:00,['5f0d464fc577361ade774683eef5836694e693c5'],3,9,12,621121,1,1,1,1,1385
cf31a5cabe2b005c063e3535d0f2987609fb1207,1,Todd Lipcon,2015-07-06 10:39:37-07:00,['926e924c5d4c984f459dbe07ca858c745c37250a'],67,50,117,621238,10,0.571428571,0.214285714,1,1385
361a3fa2dc322ab26374d875310f7fdb1e8802fa,0,Dan Burkert,2015-07-06 14:09:59-07:00,['cf31a5cabe2b005c063e3535d0f2987609fb1207'],2,126,128,621366,6,0.391304348,0.391304348,0.391304348,1388
78aed1c7c51bf6ee4cf03f630a123a203c95660c,0,Adar Dembo,2015-07-06 14:31:31-07:00,['361a3fa2dc322ab26374d875310f7fdb1e8802fa'],8,41,49,621415,2,1,1,1,1388
6d47a476d1286bc9f2b9fa7546cd8a53d84b14ee,1,Adar Dembo,2015-07-06 14:34:18-07:00,['78aed1c7c51bf6ee4cf03f630a123a203c95660c'],29,61,90,621505,2,1,0.923076923,0.923076923,1388
dde6e9e30eb487983931d39ebc034f3eecbbf192,0,Adar Dembo,2015-07-06 14:34:57-07:00,['6d47a476d1286bc9f2b9fa7546cd8a53d84b14ee'],17,124,141,621646,3,0.173913043,0.188405797,0.724637681,1388
3c8103eaf39a6aae093ba83ba2238226db8cde91,0,Adar Dembo,2015-07-06 14:43:08-07:00,['dde6e9e30eb487983931d39ebc034f3eecbbf192'],2,6,8,621654,1,1,1,1,1388
784ca1ef9446dcb522e29072e49f79e9608ff668,0,Adar Dembo,2015-07-06 23:31:27-07:00,['3c8103eaf39a6aae093ba83ba2238226db8cde91'],49,105,154,621808,7,0.172413793,1,1,1388
e02f30271f7b6658d61aecc6261b06aaa007d79a,1,Adar Dembo,2015-07-06 23:33:21-07:00,['784ca1ef9446dcb522e29072e49f79e9608ff668'],5,24,29,621837,5,0.75,1,1,1388
2f86f1dc677fb9b4a21310aaf9a047d816cb60b6,1,Adar Dembo,2015-07-06 23:34:36-07:00,['e02f30271f7b6658d61aecc6261b06aaa007d79a'],4,40,44,621881,2,0,0,1,1388
13135e375b49a5a31ae35e2c7b0fa4ac277269e5,0,Adar Dembo,2015-07-06 23:34:42-07:00,['2f86f1dc677fb9b4a21310aaf9a047d816cb60b6'],24,40,64,621945,1,0,1,1,1388
753256a144a34eea20cd463af866706b59ba383b,0,Dan Burkert,2015-07-07 15:17:45-07:00,['13135e375b49a5a31ae35e2c7b0fa4ac277269e5'],3,83,86,622031,3,0.127272727,1,1,1388
84eefa89bf9d738b79e6ec96b5ff72a74135966d,0,Adar Dembo,2015-07-07 16:42:30-07:00,['753256a144a34eea20cd463af866706b59ba383b'],17,17,34,622065,1,,,,1388
a8a6c7649890344935fbf8c4eec8a902b9600196,0,Adar Dembo,2015-07-08 19:23:30-07:00,['84eefa89bf9d738b79e6ec96b5ff72a74135966d'],2,2,4,622069,1,,,,1388
13fd2fc7c3a9cf968d67c828fceeda6e54a2bb6c,1,Todd Lipcon,2015-07-09 15:32:07-07:00,['a8a6c7649890344935fbf8c4eec8a902b9600196'],10,13,23,622092,4,0,1,1,1388
c91434027af79d15c719549e77d452fb98b727d6,0,Todd Lipcon,2015-07-09 15:34:27-07:00,['13fd2fc7c3a9cf968d67c828fceeda6e54a2bb6c'],90,12,102,622194,7,0.709677419,0,0,1388
2fcf999b57fb89703bd8dda9ba78b096d08d9f32,1,Todd Lipcon,2015-07-09 15:37:16-07:00,['c91434027af79d15c719549e77d452fb98b727d6'],3,136,139,622333,8,0.4,1,0.707692308,1389
64bd49dc4bfa21895ca18d5ef9be746284dab5c7,1,Adar Dembo,2015-07-09 16:56:45-07:00,['2fcf999b57fb89703bd8dda9ba78b096d08d9f32'],307,494,801,623134,20,,,,1390
cb49d85aefdf4a99168edc707cf99b3a8aa9a93a,1,Todd Lipcon,2015-07-09 17:23:13-07:00,['64bd49dc4bfa21895ca18d5ef9be746284dab5c7'],40,52,92,623226,2,0.75,0,0,1390
29f86de3a77557db9a275259fa0776ffdde97059,0,Todd Lipcon,2015-07-09 23:54:32-07:00,['cb49d85aefdf4a99168edc707cf99b3a8aa9a93a'],172,0,172,623398,2,0.630952381,0,0.107142857,1390
0beb1797ebda15019fa90611a54eedba95da7abc,0,Todd Lipcon,2015-07-09 23:57:30-07:00,['29f86de3a77557db9a275259fa0776ffdde97059'],16,238,254,623652,10,0.128205128,0.598290598,1,1390
a1e44477ce10b34ca8b8a2f8bb4f9c17f75c2ad2,1,Todd Lipcon,2015-07-09 23:57:42-07:00,['0beb1797ebda15019fa90611a54eedba95da7abc'],3,398,401,624053,4,0.699588477,0.695473251,0.967078189,1391
aff05b2973efd1840387b7f2b984973c217db025,0,Todd Lipcon,2015-07-10 09:51:52-07:00,['a1e44477ce10b34ca8b8a2f8bb4f9c17f75c2ad2'],10,233,243,624296,7,0.288288288,0.459459459,0.981981982,1394
e9c7365c5b5f31bfa93b8d45aa94fbcd79eac832,0,Todd Lipcon,2015-07-10 12:06:28-07:00,['aff05b2973efd1840387b7f2b984973c217db025'],1,2,3,624299,1,,,,1394
5335eebbb793d0badd81bc00cece7ed7f41dc4a9,0,Todd Lipcon,2015-07-10 12:54:46-07:00,['e9c7365c5b5f31bfa93b8d45aa94fbcd79eac832'],161,647,808,625107,19,0.540909091,0.790909091,0.918181818,1398
9e2b5d8054d26167204c2f3b6843138a1b2c158e,0,Todd Lipcon,2015-07-13 11:54:55-07:00,['5335eebbb793d0badd81bc00cece7ed7f41dc4a9'],2,2,4,625111,1,,,,1398
a72b9f5b480c47c0d818a8cad0314ab85b65db7d,0,Todd Lipcon,2015-07-13 17:57:33-07:00,['9e2b5d8054d26167204c2f3b6843138a1b2c158e'],10,34,44,625155,4,0,0.470588235,0.470588235,1398
b7c288d0bfeb1c630befd7d37300da1ea74d8e93,1,David Alves,2015-07-13 20:12:13-07:00,['a72b9f5b480c47c0d818a8cad0314ab85b65db7d'],185,231,416,625571,37,1,1,1,1398
2754c9bf96825fe780ffc2f1a3e4933fc1e94703,1,Adar Dembo,2015-07-14 11:15:52-07:00,['b7c288d0bfeb1c630befd7d37300da1ea74d8e93'],14,119,133,625704,12,0.789473684,0.894736842,0.842105263,1399
36fd7e05ab0926bdd18a5fb42b601d9dd7a970b8,1,Adar Dembo,2015-07-14 12:46:08-07:00,['2754c9bf96825fe780ffc2f1a3e4933fc1e94703'],54,183,237,625941,20,0.08974359,0.871794872,0.923076923,1399
db685b7395cee5b98028adc05355501725e9133f,0,Adar Dembo,2015-07-14 14:10:02-07:00,['36fd7e05ab0926bdd18a5fb42b601d9dd7a970b8'],11,2,13,625954,5,,,,1399
dbefc3fcbd09750f88f2b5c3c215767d2c35e273,0,Adar Dembo,2015-07-14 14:28:12-07:00,['db685b7395cee5b98028adc05355501725e9133f'],3,2,5,625959,1,,,,1399
06009ab3338068747428ed8337c08929fddf6702,0,Todd Lipcon,2015-07-15 14:28:09-07:00,['dbefc3fcbd09750f88f2b5c3c215767d2c35e273'],20,705,725,626684,13,0.419047619,0.602380952,0.94047619,1401
3954d31ac088c9081b706942388ccec9d6ffd5c8,0,Misty Stanley-Jones,2015-07-15 15:17:18-07:00,['06009ab3338068747428ed8337c08929fddf6702'],5,232,237,626921,6,,,,1405
d48197e2ef4da1d13dd2cc735d6e91ab27e3f687,0,Adar Dembo,2015-07-15 15:35:19-07:00,['3954d31ac088c9081b706942388ccec9d6ffd5c8'],15,28,43,626964,2,0,0,1,1405
c7385a9a30626bad3b8aef70049c3190092b1d47,0,Adar Dembo,2015-07-15 15:35:33-07:00,['d48197e2ef4da1d13dd2cc735d6e91ab27e3f687'],3,18,21,626985,1,,,,1405
77e5359b4575ea37fd0b4ac962afa127d9979716,0,Todd Lipcon,2015-07-15 15:55:53-07:00,['c7385a9a30626bad3b8aef70049c3190092b1d47'],8,8,16,627001,3,1,0,1,1405
658e62445426108e0256b809d9f804a231084614,0,Adar Dembo,2015-07-15 16:15:36-07:00,['77e5359b4575ea37fd0b4ac962afa127d9979716'],97,80,177,627178,2,1,1,0,1405
455c20fb0d20cfd096a8e7e5d43a10e8ac6e2552,0,Adar Dembo,2015-07-15 16:40:27-07:00,['658e62445426108e0256b809d9f804a231084614'],5,0,5,627183,1,,,,1405
6a25e81763208b9fe09426bdb47a216c4a046f6a,0,Todd Lipcon,2015-07-15 17:00:48-07:00,['455c20fb0d20cfd096a8e7e5d43a10e8ac6e2552'],192,221,413,627596,10,0,1,1,1405
35f053383539602d0547c4b6011535a84c8e3f4e,0,Adar Dembo,2015-07-15 17:14:31-07:00,['6a25e81763208b9fe09426bdb47a216c4a046f6a'],0,6,6,627602,2,,,,1405
8ffdf04c8a03a41b601b39ce1e45ea05df64dc19,0,Michael Percy,2015-07-17 03:04:46-07:00,['35f053383539602d0547c4b6011535a84c8e3f4e'],11,18,29,627631,1,,,,1405
e4747e7007a7fe17597ab9ee667364bfeca2d7e9,0,Todd Lipcon,2015-07-17 12:14:15-07:00,['8ffdf04c8a03a41b601b39ce1e45ea05df64dc19'],34,109,143,627774,3,0.566666667,0,0.933333333,1405
4ce99f01d4b229a538a92c408b6610f7330828c9,0,Adar Dembo,2015-07-17 15:30:16-07:00,['e4747e7007a7fe17597ab9ee667364bfeca2d7e9'],6,140,146,627920,4,0.261904762,1,0.595238095,1405
8547ea4de0e5ec4aa713ffc656f4ae11edfca06c,0,Michael Percy,2015-07-17 16:12:12-07:00,['4ce99f01d4b229a538a92c408b6610f7330828c9'],13,15,28,627948,1,0,1,1,1405
6d605c5d59bde30b4887031d9ea76c582510af5f,1,Michael Percy,2015-07-17 16:24:14-07:00,['8547ea4de0e5ec4aa713ffc656f4ae11edfca06c'],0,44,44,627992,3,0.068965517,1,1,1405
b7c5098b5254e6cd4d4bf85136c5b39bd6e58402,0,Adar Dembo,2015-07-17 17:25:20-07:00,['6d605c5d59bde30b4887031d9ea76c582510af5f'],2,2,4,627996,2,,,,1405
64b2fb729d85d12628b6d80b6bbd6b46181d78c5,0,Adar Dembo,2015-07-20 17:32:18-07:00,['b7c5098b5254e6cd4d4bf85136c5b39bd6e58402'],7,39,46,628042,3,0,1,1,1405
fb5d86b11ed28994123ed895458c7cb3a5638886,0,Michael Percy,2015-07-23 13:21:42-07:00,['64b2fb729d85d12628b6d80b6bbd6b46181d78c5'],2,2,4,628046,1,,,,1405
ef4707ac6abbc03f726bd0647d454de575821f53,0,Adar Dembo,2015-07-23 13:21:44-07:00,['fb5d86b11ed28994123ed895458c7cb3a5638886'],3,4,7,628053,1,0,1,1,1405
e2b83adbfc008ebd66ede4c5bcda3186843bf4b9,0,Michael Percy,2015-07-23 13:22:44-07:00,['ef4707ac6abbc03f726bd0647d454de575821f53'],1,1,2,628055,1,,,,1405
5d3edb14e566149d2183e7f31dc0c34ec64549da,0,Michael Percy,2015-07-23 13:23:08-07:00,['e2b83adbfc008ebd66ede4c5bcda3186843bf4b9'],13,16,29,628084,1,0.5,1,1,1405
fb85eecb16ab3c7b6fe8d5fd0f9ce50edf12244c,0,Michael Percy,2015-07-23 16:58:38-07:00,['5d3edb14e566149d2183e7f31dc0c34ec64549da'],1,79,80,628164,4,0.56097561,1,0.585365854,1406
112bdef0356f3ff0b4120d56df86be39ca398690,0,Michael Percy,2015-07-23 16:58:45-07:00,['fb85eecb16ab3c7b6fe8d5fd0f9ce50edf12244c'],2,2,4,628168,1,,,,1406
f900b52458d0bbfc4c4b5773f37f6fbb9140ec35,0,Jean-Daniel Cryans,2015-07-24 13:24:43-07:00,['112bdef0356f3ff0b4120d56df86be39ca398690'],44,6,50,628218,3,0.392857143,1,0.107142857,1406
4a98d4b0ce54bda87ff3f8f4f63940a8d998fb63,0,Todd Lipcon,2015-07-27 16:27:17-07:00,['f900b52458d0bbfc4c4b5773f37f6fbb9140ec35'],8,6,14,628232,1,0,1,1,1406
71e88d65d4f732751519da34c8e5974969bdfa96,1,Michael Percy,2015-07-28 11:31:33-07:00,['4a98d4b0ce54bda87ff3f8f4f63940a8d998fb63'],0,22,22,628254,3,1,1,1,1406
bf3d827c9ba6348d39ed34c62d06952a889b1ea0,0,Jean-Daniel Cryans,2015-07-28 13:35:00-07:00,['71e88d65d4f732751519da34c8e5974969bdfa96'],3,5,8,628262,2,1,1,1,1406
16f78086957623f848f7b149111c6e1bbe1851e5,0,Todd Lipcon,2015-07-28 13:57:43-07:00,['bf3d827c9ba6348d39ed34c62d06952a889b1ea0'],0,4,4,628266,1,0,1,1,1406
bae10fcd8ae06ec012e25b4862f3b2e32f2c04f4,0,Adar Dembo,2015-07-28 15:58:10-07:00,['16f78086957623f848f7b149111c6e1bbe1851e5'],6,6,12,628278,3,,,,1406
3b51f45905291c42627a35a53cb6cbc50c44de96,0,Todd Lipcon,2015-07-28 16:10:41-07:00,['bae10fcd8ae06ec012e25b4862f3b2e32f2c04f4'],0,3,3,628281,1,,,,1406
3e25c65702e5c46b215dce5a90db7920fb6743e7,0,David Alves,2015-07-28 17:41:43-07:00,['3b51f45905291c42627a35a53cb6cbc50c44de96'],77,5,82,628363,15,0.476190476,0.142857143,0.142857143,1406
78e4c740e6be71f2504528a6c6cd4ac497be0439,1,Todd Lipcon,2015-07-28 19:53:04-07:00,['3e25c65702e5c46b215dce5a90db7920fb6743e7'],8,42,50,628413,8,0,0.933333333,0.8,1406
e782807273b27804bb02abdb6f1099146310d245,0,Todd Lipcon,2015-07-29 02:12:19-07:00,['78e4c740e6be71f2504528a6c6cd4ac497be0439'],12,10,22,628435,1,,,,1406
2c2b46f61b34860b58edfb7a7bb4f9467c2f775a,1,Todd Lipcon,2015-07-29 02:18:07-07:00,['e782807273b27804bb02abdb6f1099146310d245'],43,98,141,628576,14,1,1,1,1406
66115ce0bafe570eae6cded2e11a498cdad9e3da,0,Todd Lipcon,2015-07-29 13:14:59-07:00,['2c2b46f61b34860b58edfb7a7bb4f9467c2f775a'],12,76,88,628664,3,0,0.382978723,0.659574468,1406
6fea86aa18a3a23bc33b8597cc14b618f5f265e2,1,Todd Lipcon,2015-07-29 15:12:53-07:00,['66115ce0bafe570eae6cded2e11a498cdad9e3da'],7,28,35,628699,3,0.307692308,1,1,1406
8a3a4fa056199e7310bf6b4a620c18da8da1a027,0,Michael Percy,2015-07-29 18:11:59-07:00,['6fea86aa18a3a23bc33b8597cc14b618f5f265e2'],25,89,114,628813,18,0.578947368,1,0.815789474,1406
fce23dcf81e442199491216740a7a92b89966099,0,Todd Lipcon,2015-07-29 19:17:34-07:00,['8a3a4fa056199e7310bf6b4a620c18da8da1a027'],1,5,6,628819,1,0,1,1,1406
1275da54997981ff06e222ff1de94c852df7ad60,1,Michael Percy,2015-07-29 23:40:01-07:00,['fce23dcf81e442199491216740a7a92b89966099'],10,40,50,628869,4,0.047619048,0.857142857,1,1406
80fa3f2d5866f80d837af52c242157a245a5ded2,0,Todd Lipcon,2015-07-30 08:41:22-07:00,['1275da54997981ff06e222ff1de94c852df7ad60'],39,61,100,628969,4,,,,1406
36bdea645e8ec7b9303c2564900cea6499cf39b5,0,Todd Lipcon,2015-07-30 08:42:10-07:00,['80fa3f2d5866f80d837af52c242157a245a5ded2'],119,403,522,629491,9,0.55704698,1,0.704697987,1409
bda74b0f1c665ee310f2b0be7241ce5346867c35,1,Todd Lipcon,2015-07-30 08:43:41-07:00,['36bdea645e8ec7b9303c2564900cea6499cf39b5'],5,118,123,629614,4,0.14084507,0.309859155,0.309859155,1409
851917c514151115225af31d6c633c50b58f697a,0,Todd Lipcon,2015-07-30 18:36:35-07:00,['bda74b0f1c665ee310f2b0be7241ce5346867c35'],17,24,41,629655,5,,,,1409
a1d9a3cdbce5045dfe150f9a84762695358697ae,1,Todd Lipcon,2015-07-30 19:53:45-07:00,['851917c514151115225af31d6c633c50b58f697a'],37,98,135,629790,1,0.947368421,1,0.473684211,1409
fdcb5d287fa39867b133d9bbaf693aea3b46da44,1,Todd Lipcon,2015-07-30 22:17:02-07:00,['a1d9a3cdbce5045dfe150f9a84762695358697ae'],76,71,147,629937,2,0,1,1,1409
d6ba369ef0438760d832d4810e6c903ab194f108,1,Michael Percy,2015-07-30 23:44:37-07:00,['fdcb5d287fa39867b133d9bbaf693aea3b46da44'],78,362,440,630377,15,0.277777778,0.666666667,0.00617284,1409
07f707de1f7667cd691f1350a68a4673188a8914,0,Todd Lipcon,2015-07-31 10:12:39-07:00,['d6ba369ef0438760d832d4810e6c903ab194f108'],57,40,97,630474,5,1,0,0,1409
ca71b366ce7aeea4efd2fce1c1634af45786c740,0,Todd Lipcon,2015-07-31 15:28:46-07:00,['07f707de1f7667cd691f1350a68a4673188a8914'],13,140,153,630627,5,0.064935065,0.324675325,0.961038961,1409
1bf7b88f158a6b6a8bda33dfe495c51a14db6800,1,Todd Lipcon,2015-07-31 15:28:51-07:00,['ca71b366ce7aeea4efd2fce1c1634af45786c740'],30,260,290,630917,13,0.186440678,0.805084746,0.86440678,1409
04841b25dd16ee85c88f27ebcc10d462a34a5d22,0,Todd Lipcon,2015-07-31 15:29:50-07:00,['1bf7b88f158a6b6a8bda33dfe495c51a14db6800'],30,2,32,630949,2,0.133333333,0,0.133333333,1409
000a8d8a4a122a1b2afe70f59e86730d52abb6a9,1,Todd Lipcon,2015-07-31 15:30:15-07:00,['04841b25dd16ee85c88f27ebcc10d462a34a5d22'],56,43,99,631048,2,1,1,1,1409
792e559c27e3b6b8f221166575a5222c5a788526,1,Todd Lipcon,2015-07-31 21:43:17-07:00,['000a8d8a4a122a1b2afe70f59e86730d52abb6a9'],21,103,124,631172,9,0.685185185,1,0.740740741,1409
e5e8768964a86531643463392fd52fc9aed0d566,1,Todd Lipcon,2015-07-31 21:43:22-07:00,['792e559c27e3b6b8f221166575a5222c5a788526'],147,178,325,631497,5,1,1,1,1409
fd19488c05e400f874efdee04bc6d6235f2f74d0,1,Todd Lipcon,2015-07-31 21:43:38-07:00,['e5e8768964a86531643463392fd52fc9aed0d566'],24,187,211,631708,5,0.036697248,0.71559633,0.71559633,1409
5831908d822bd7911adb889b2c45f0ddf4e75a2d,0,Todd Lipcon,2015-07-31 21:45:11-07:00,['fd19488c05e400f874efdee04bc6d6235f2f74d0'],4,6,10,631718,1,,,,1409
b28ba7870df9b2a2a34e0b7de4c178e775b9afe2,0,Michael Percy,2015-07-31 23:16:12-07:00,['5831908d822bd7911adb889b2c45f0ddf4e75a2d'],23,11,34,631752,6,0.666666667,0,0.5,1409
ed0a976ea6d0b9ac5fc3916572683e922c437a26,0,Michael Percy,2015-07-31 23:16:38-07:00,['b28ba7870df9b2a2a34e0b7de4c178e775b9afe2'],1,1,2,631754,1,,,,1409
a3409549e676df4e3a8ffe5e43c4d41922818158,0,Michael Percy,2015-08-02 18:50:29-07:00,['ed0a976ea6d0b9ac5fc3916572683e922c437a26'],1,7,8,631762,2,1,1,1,1409
f8bf18fa52281b874a02324828a5931a7df46c70,0,Michael Percy,2015-08-02 18:54:58-07:00,['a3409549e676df4e3a8ffe5e43c4d41922818158'],33,23,56,631818,5,0,0,1,1409
394eb90e5b5771ee62b376b485fa21696f295943,0,Todd Lipcon,2015-08-02 19:36:07-07:00,['f8bf18fa52281b874a02324828a5931a7df46c70'],31,10,41,631859,1,,,,1409
f63eb55350f0f277f3df9ee28a4a52ea86d424cc,0,Todd Lipcon,2015-08-03 12:40:19-07:00,['394eb90e5b5771ee62b376b485fa21696f295943'],8,520,528,632387,4,0.218181818,0.796363636,0.796363636,1411
8b57ef70332e6701ad257b3e91ba88a73628ba02,1,David Alves,2015-08-03 16:46:40-07:00,['f63eb55350f0f277f3df9ee28a4a52ea86d424cc'],16,28,44,632431,6,0,1,1,1411
f583ae24313657095baeba28c59fe4e5eaef3054,0,Michael Percy,2015-08-03 18:38:55-07:00,['8b57ef70332e6701ad257b3e91ba88a73628ba02'],1,11,12,632443,2,,,,1411
8e618507379f321ca308ff9a1c2a71a1d29e26f2,0,Michael Percy,2015-08-03 18:39:07-07:00,['f583ae24313657095baeba28c59fe4e5eaef3054'],10,2,12,632455,1,,,,1411
c7822458e9957bd7fa8b02d9fb0a0aa6ed6370b8,1,David Alves,2015-08-03 18:52:23-07:00,['8e618507379f321ca308ff9a1c2a71a1d29e26f2'],83,33,116,632571,12,0.647058824,0.588235294,0.411764706,1411
5dd46866138e0d3b34d6cc11f3b578764563fbbc,0,Todd Lipcon,2015-08-03 20:19:56-07:00,['c7822458e9957bd7fa8b02d9fb0a0aa6ed6370b8'],46,123,169,632740,13,,,,1411
b44cc693b4909965d143e8c909e791ef65a1ca8f,0,Todd Lipcon,2015-08-03 20:38:26-07:00,['5dd46866138e0d3b34d6cc11f3b578764563fbbc'],47,46,93,632833,9,,,,1411
2f5f6bf342b5010146f465659a086499d2c6938d,0,Michael Percy,2015-08-04 08:41:35-07:00,['b44cc693b4909965d143e8c909e791ef65a1ca8f'],20,45,65,632898,7,0.375,0,0,1411
9169afa3d9a760938d9fb3fbfcfcf2c0cb08bd47,1,Todd Lipcon,2015-08-04 15:06:20-07:00,['2f5f6bf342b5010146f465659a086499d2c6938d'],72,150,222,633120,6,0.324324324,0.864864865,0.864864865,1411
919a2397f8b86f3d1dec0264a400a4c32fab14ea,1,Todd Lipcon,2015-08-04 19:42:21-07:00,['9169afa3d9a760938d9fb3fbfcfcf2c0cb08bd47'],6,8,14,633134,1,,,,1411
e8187c01cecb432c28b7ab4cbe65438ff60d166e,0,Todd Lipcon,2015-08-04 19:52:41-07:00,['919a2397f8b86f3d1dec0264a400a4c32fab14ea'],5,59,64,633198,2,0.024390244,1,1,1411
f7526b1560f5f1e43808c3cd6aa9c533ff3f850f,0,Adar Dembo,2015-08-05 12:06:34-07:00,['e8187c01cecb432c28b7ab4cbe65438ff60d166e'],1,3,4,633202,1,,,,1411
90a9f218f75b7002029c4fa7d772f17fb0d93640,1,Jean-Daniel Cryans,2015-08-05 12:22:43-07:00,['f7526b1560f5f1e43808c3cd6aa9c533ff3f850f'],348,490,838,634040,18,0.489795918,0.367346939,0.918367347,1412
a1e1e727c92edd85f14113ada9171655ca481f49,1,Todd Lipcon,2015-08-05 14:56:27-07:00,['90a9f218f75b7002029c4fa7d772f17fb0d93640'],25,32,57,634097,3,0.6,1,1,1412
27948a362b3c3f85abd8826a5a05b7d637c57ad5,1,Michael Percy,2015-08-05 15:33:25-07:00,['a1e1e727c92edd85f14113ada9171655ca481f49'],59,411,470,634567,21,0.226744186,1,1,1413
1b795e1ca5da06fb9f3b2ff7439b7be0cf5fd7b5,0,Michael Percy,2015-08-05 15:36:12-07:00,['27948a362b3c3f85abd8826a5a05b7d637c57ad5'],15,80,95,634662,8,1,1,1,1413
2b1d1ad12d5f3471b427703f8a4f45b3a10d292e,0,Todd Lipcon,2015-08-05 16:11:39-07:00,['1b795e1ca5da06fb9f3b2ff7439b7be0cf5fd7b5'],25,64,89,634751,1,,,,1413
d1e4baa38c64aa031d1c4b90cecc26f9931e9cbe,0,Martin Grund,2015-08-05 16:41:05-07:00,['eebd670db3d1b71363d7ca06af116f3af991dae2'],0,162,162,634913,2,1,1,0.535714286,1415
07456db3f728f3cd08820bc0ec71f71850d6ffa1,0,Jean-Daniel Cryans,2015-08-05 18:47:34-07:00,['2b1d1ad12d5f3471b427703f8a4f45b3a10d292e'],6,11,17,634930,1,0,0,1,1415
6778edd7a8d636c5c85c1a4b2ddea79ce067daa3,0,Adar Dembo,2015-08-05 19:50:14-07:00,['07456db3f728f3cd08820bc0ec71f71850d6ffa1'],10,24,34,634964,1,0,0,1,1415
86086d27db89e3202e07051a580348fb09ecad66,1,Martin Grund,2015-08-05 22:08:41-07:00,['6778edd7a8d636c5c85c1a4b2ddea79ce067daa3'],2,4,6,634970,1,0,0,0,1415
f905833f06d5c4a00f8c4d061b2f3d0fd286698e,0,Todd Lipcon,2015-08-06 13:31:42-07:00,['86086d27db89e3202e07051a580348fb09ecad66'],103,142,245,635215,6,0.166666667,1,0,1415
be7a50b10f97ecff8584c368027acc2bbc905c51,0,Adar Dembo,2015-08-06 14:09:16-07:00,['f905833f06d5c4a00f8c4d061b2f3d0fd286698e'],1,10,11,635226,1,1,1,0,1415
d56744f33dde87b0eb551e76a2029fb08f92b7dd,0,Adar Dembo,2015-08-06 14:49:24-07:00,['be7a50b10f97ecff8584c368027acc2bbc905c51'],186,197,383,635609,8,0,1,0,1415
9386e7addeee07f6733ac7168b3d6f69a96eb9f3,0,Jean-Daniel Cryans,2015-08-06 15:17:18-07:00,['d56744f33dde87b0eb551e76a2029fb08f92b7dd'],48,191,239,635848,3,1,1,1,1415
ad41e8998316e0a185a5484ab263d2930b6afdc8,1,Jean-Daniel Cryans,2015-08-06 15:17:27-07:00,['9386e7addeee07f6733ac7168b3d6f69a96eb9f3'],50,31,81,635929,6,0,0,0,1415
30ffcce763c9eeced1a2672cd97d78301c81dd3a,0,David Alves,2015-08-06 17:01:44-07:00,['ad41e8998316e0a185a5484ab263d2930b6afdc8'],7,39,46,635975,3,0.647058824,0.647058824,0.882352941,1415
70b9a4bb052e07340cdc7041b9de0a812ff54b16,1,David Alves,2015-08-06 17:01:51-07:00,['30ffcce763c9eeced1a2672cd97d78301c81dd3a'],78,68,146,636121,26,0.333333333,0.222222222,0.888888889,1415
f7423f7f3c7b7f68d1192b9fad1eaa19a1499107,0,Todd Lipcon,2015-08-06 17:17:53-07:00,['70b9a4bb052e07340cdc7041b9de0a812ff54b16'],37,58,95,636216,22,1,1,1,1415
a12821476ee6f294cac9d9d9fc6ec39e35a6c43e,1,Todd Lipcon,2015-08-06 18:30:14-07:00,['f7423f7f3c7b7f68d1192b9fad1eaa19a1499107'],2,69,71,636287,7,0.282051282,1,0.743589744,1415
e5bd08d0304df81bc64c2f6e0a1b2fd36c25ca82,1,Todd Lipcon,2015-08-06 18:39:07-07:00,['a12821476ee6f294cac9d9d9fc6ec39e35a6c43e'],30,62,92,636379,11,0.4,1,0.666666667,1415
39fb5db1b04e3b845fcb79cc086bc56fe6b5d67a,0,Todd Lipcon,2015-08-06 19:06:23-07:00,['e5bd08d0304df81bc64c2f6e0a1b2fd36c25ca82'],32,609,641,637020,8,0.679715302,0.679715302,1,1416
c3f0bbd55b670837d9f2563c3290a5ddd6678b8c,0,Todd Lipcon,2015-08-06 19:07:33-07:00,['39fb5db1b04e3b845fcb79cc086bc56fe6b5d67a'],182,173,355,637375,18,0.206896552,0,0,1416
bef00db6e7d08eca4171eb9d8883a67c5645c386,0,Adar Dembo,2015-08-06 19:35:35-07:00,['c3f0bbd55b670837d9f2563c3290a5ddd6678b8c'],58,77,135,637510,7,0.875,1,1,1416
d34dcbfe7eda9204c879a51cebb322f14c3f913f,0,Todd Lipcon,2015-08-06 20:13:23-07:00,['bef00db6e7d08eca4171eb9d8883a67c5645c386'],1,18,19,637529,1,0,0,0,1416
8c749ac5a16ae3b91fa8fd0ee48839043010f2ee,1,David Alves,2015-08-06 20:40:36-07:00,['d34dcbfe7eda9204c879a51cebb322f14c3f913f'],127,144,271,637800,29,1,1,1,1416
27c0ef875e733cb91418c62aaeddc56ca7610d90,0,Adar Dembo,2015-08-06 21:59:14-07:00,['8c749ac5a16ae3b91fa8fd0ee48839043010f2ee'],0,11,11,637811,1,1,1,1,1416
b1b27b34c057480c6a5929efdd50cdec60039e40,0,Todd Lipcon,2015-08-08 17:47:21-07:00,['27c0ef875e733cb91418c62aaeddc56ca7610d90'],1,0,1,637812,1,,,,1416
b3e64c36264ce06a31890d9c79f30a253432d716,1,Todd Lipcon,2015-08-08 18:12:58-07:00,['b1b27b34c057480c6a5929efdd50cdec60039e40'],133,134,267,638079,14,,,,1416
84b1bca7824e55fc4392bea9081ff1ee0fc9ad25,1,Todd Lipcon,2015-08-08 18:15:23-07:00,['b3e64c36264ce06a31890d9c79f30a253432d716'],23,115,138,638217,9,0.723076923,0.923076923,0.953846154,1416
5c708d14b9d5535e143935373910e682c93bb16d,0,Todd Lipcon,2015-08-08 18:15:40-07:00,['84b1bca7824e55fc4392bea9081ff1ee0fc9ad25'],1,0,1,638218,1,1,0,0,1416
0410abc8c485e3a523b07e2843d2c9869ec48289,0,Todd Lipcon,2015-08-09 17:50:56-07:00,['5c708d14b9d5535e143935373910e682c93bb16d'],40,64,104,638322,9,,,,1417
06b6c79ce890acbad0fa7962f50611429483e9ff,1,Todd Lipcon,2015-08-09 19:55:18-07:00,['0410abc8c485e3a523b07e2843d2c9869ec48289'],47,199,246,638568,2,,,,1417
1380bbbac0f3285cbd413825998bf94c7237b1bd,1,Todd Lipcon,2015-08-09 21:10:22-07:00,['06b6c79ce890acbad0fa7962f50611429483e9ff'],127,361,488,639056,13,0.523809524,1,0.976190476,1417
3b8a3b6e20f8a649e1113e2e8afc578a227c40fc,0,Martin Grund,2015-08-10 10:56:47-07:00,['eebd670db3d1b71363d7ca06af116f3af991dae2'],0,1860,1860,640916,12,0.601010101,1,1,1429
e286b4fa4477328a7feab7285fa95c9591017d59,0,Todd Lipcon,2015-08-10 13:23:00-07:00,['1380bbbac0f3285cbd413825998bf94c7237b1bd'],0,9,9,640925,1,1,1,1,1429
45c67912aba8711692fc9b9ebdc9b58c5028beff,0,Todd Lipcon,2015-08-10 13:23:32-07:00,['e286b4fa4477328a7feab7285fa95c9591017d59'],4,4,8,640933,1,,,,1429
d3fc252a12f08ba56ad68e97240ec1d2390788fc,0,Todd Lipcon,2015-08-10 14:12:31-07:00,['45c67912aba8711692fc9b9ebdc9b58c5028beff'],0,12,12,640945,1,0,1,1,1429
b3f4caa9f0bc35a7d98a59c129b92175657754b1,0,Jean-Daniel Cryans,2015-08-10 14:26:31-07:00,['d3fc252a12f08ba56ad68e97240ec1d2390788fc'],4,15,19,640964,2,0,1,1,1429
5dd4bb9a207a53c3b6aaf3e5a28a35b07b01dc18,1,Todd Lipcon,2015-08-10 16:26:36-07:00,['b3f4caa9f0bc35a7d98a59c129b92175657754b1'],81,476,557,641521,23,0.361702128,0.834042553,0.757446809,1429
a168ea1017cc021e1a45efdd01824a2258ff9920,0,Todd Lipcon,2015-08-10 16:35:22-07:00,['5dd4bb9a207a53c3b6aaf3e5a28a35b07b01dc18'],0,108,108,641629,1,,,,1429
1f54b0c1bc3692559ecd271a00aac761f8d707cb,1,Adar Dembo,2015-08-10 17:17:47-07:00,['a168ea1017cc021e1a45efdd01824a2258ff9920'],78,78,156,641785,20,,,,1429
286edeed1f64a6583592cb497fa9bbc88a1e0b43,1,Adar Dembo,2015-08-10 17:17:51-07:00,['1f54b0c1bc3692559ecd271a00aac761f8d707cb'],257,220,477,642262,28,0,0.4,1,1429
a2a799eed900c86f5ba0ce1d24a2eb5c7cb3f979,1,Todd Lipcon,2015-08-10 19:05:50-07:00,['286edeed1f64a6583592cb497fa9bbc88a1e0b43'],29,105,134,642396,3,0.519230769,0.346153846,0.846153846,1429
857683eb85326735181509bedb06c21fc36b0659,0,David Alves,2015-08-10 22:32:18-07:00,['a2a799eed900c86f5ba0ce1d24a2eb5c7cb3f979'],2,2,4,642400,1,,,,1429
ca5f805073921737ac8aaa8c33981779de387227,0,Jean-Daniel Cryans,2015-08-11 06:21:19-07:00,['857683eb85326735181509bedb06c21fc36b0659'],0,0,0,642400,1,,,,1429
84d8262e8180c5d84dddd0089422443cbb152d27,0,Martin Grund,2015-08-11 11:04:59-07:00,['eebd670db3d1b71363d7ca06af116f3af991dae2'],1,156,157,642557,7,,,,1435
d182df30d6b8efa88e202ec65bf9cce5cb77bedd,1,Todd Lipcon,2015-08-11 14:13:06-07:00,['ca5f805073921737ac8aaa8c33981779de387227'],0,80,80,642637,2,0.436363636,1,1,1435
3d86785cb9d0aefa3992eeb01f59ad097186d71a,1,David Alves,2015-08-11 16:46:30-07:00,['d182df30d6b8efa88e202ec65bf9cce5cb77bedd'],47,53,100,642737,4,1,1,1,1435
c4ba7beb7a27e61db3e52f09b31ad68afde08e08,0,David Alves,2015-08-11 16:46:39-07:00,['3d86785cb9d0aefa3992eeb01f59ad097186d71a'],0,2,2,642739,1,0,0,1,1435
20c54c00f6685bffd2d3fcf9161eedd4e6c029fa,1,Todd Lipcon,2015-08-11 17:44:22-07:00,['c4ba7beb7a27e61db3e52f09b31ad68afde08e08'],68,87,155,642894,12,1,1,1,1435
95f3eb2a789585d4dfcdd0fafdbadc8fc98ce293,1,Michael Percy,2015-08-11 19:11:41-07:00,['20c54c00f6685bffd2d3fcf9161eedd4e6c029fa'],64,318,382,643276,6,0.410852713,1,0.573643411,1435
d1483d7d03b092c8d89c24bb6a57b92064285c05,1,Todd Lipcon,2015-08-11 23:16:18-07:00,['95f3eb2a789585d4dfcdd0fafdbadc8fc98ce293'],0,423,423,643699,4,0.560137457,0.862542955,0.690721649,1436
efa7ba58d8a8a4d374c65a2a8b56ab6709f51d97,1,Todd Lipcon,2015-08-11 23:16:26-07:00,['d1483d7d03b092c8d89c24bb6a57b92064285c05'],1,71,72,643771,13,0,0.825,0.8,1436
ee8cb8730f5e27434f6ad3fb09905ce7ad038f9e,0,Jean-Daniel Cryans,2015-08-12 14:38:06-07:00,['efa7ba58d8a8a4d374c65a2a8b56ab6709f51d97'],17,33,50,643821,1,0,0,1,1436
f0ea0b5d322648281e5b003b253a84428ad32869,1,David Alves,2015-08-12 15:22:00-07:00,['ee8cb8730f5e27434f6ad3fb09905ce7ad038f9e'],51,217,268,644089,9,0.382978723,0.542553191,0.989361702,1436
e06dc48cf0a41ae44bf39dcfc5c765c68205e5f1,0,Jean-Daniel Cryans,2015-08-12 15:27:55-07:00,['f0ea0b5d322648281e5b003b253a84428ad32869'],3,8,11,644100,4,,,,1436
74d827259a3fca930e48ee755a26fbf7a998928e,0,Todd Lipcon,2015-08-12 15:41:29-07:00,['e06dc48cf0a41ae44bf39dcfc5c765c68205e5f1'],4,1,5,644105,2,1,0.5,0,1436
18db39a80bfc7e6cc6b2a5a046dc61e2af2841d9,0,Todd Lipcon,2015-08-12 15:44:20-07:00,['74d827259a3fca930e48ee755a26fbf7a998928e'],39,23,62,644167,13,0.9,0.1,0.4,1436
93c32f796d0b60381e42243de3aa1d1a87173559,0,David Alves,2015-08-12 16:29:27-07:00,['18db39a80bfc7e6cc6b2a5a046dc61e2af2841d9'],95,25,120,644287,2,0.605263158,0.210526316,0,1436
ce59be88cb31aab249307f4451652ba7b6f975eb,1,David Alves,2015-08-12 17:21:18-07:00,['93c32f796d0b60381e42243de3aa1d1a87173559'],17,95,112,644399,7,0,0.166666667,0.979166667,1436
b84f56fe86492aa138c9e73faa47f2869e221821,1,Todd Lipcon,2015-08-12 18:39:29-07:00,['ce59be88cb31aab249307f4451652ba7b6f975eb'],446,715,1161,645560,36,0,0.176029963,1,1437
2d8c7875e5ce80377a12599de8d91f26b66baeb1,0,Adar Dembo,2015-08-12 18:48:22-07:00,['b84f56fe86492aa138c9e73faa47f2869e221821'],2,9,11,645571,1,1,0,0,1437
9174e56b15ac94d7f0dd72fcfde4908979bd34e4,1,Adar Dembo,2015-08-12 19:26:37-07:00,['2d8c7875e5ce80377a12599de8d91f26b66baeb1'],1,1,2,645573,1,,,,1437
c733a44adb15b2d8ab032f4117e4bd5f9e1eb89a,1,Todd Lipcon,2015-08-13 00:05:08-07:00,['9174e56b15ac94d7f0dd72fcfde4908979bd34e4'],94,812,906,646479,21,0.254545455,0.206818182,0.790909091,1438
3da89b60ed4d2369d7ad5752b0c6be37ff0b2e5c,1,Todd Lipcon,2015-08-13 00:11:19-07:00,['c733a44adb15b2d8ab032f4117e4bd5f9e1eb89a'],216,337,553,647032,5,0,1,0.815789474,1440
016bb59ea456fe98e14b7a20f8b4c15b606f80f3,0,Todd Lipcon,2015-08-13 01:11:48-07:00,['3da89b60ed4d2369d7ad5752b0c6be37ff0b2e5c'],3,0,3,647035,1,,,,1440
d6d190cbca845d8e9ab0bee89da48762ff51f5ac,1,Todd Lipcon,2015-08-13 01:12:00-07:00,['016bb59ea456fe98e14b7a20f8b4c15b606f80f3'],280,304,584,647619,16,1,0,1,1440
59265c14483f443eb302d3b9fca0fe0c61e5e79b,0,Jean-Daniel Cryans,2015-08-13 08:51:42-07:00,"['eebd670db3d1b71363d7ca06af116f3af991dae2', '84d8262e8180c5d84dddd0089422443cbb152d27']",1,156,157,647776,7,,,,1440
757742bce2ffdab5f322c931e4e32fe6e5a6ca7e,0,Jean-Daniel Cryans,2015-08-13 11:04:36-07:00,"['59265c14483f443eb302d3b9fca0fe0c61e5e79b', 'd1e4baa38c64aa031d1c4b90cecc26f9931e9cbe']",0,162,162,647938,2,,,,1440
0d363b4588ca2b571a4c62cc6b06e24ee34ec675,0,Jean-Daniel Cryans,2015-08-13 11:04:55-07:00,"['757742bce2ffdab5f322c931e4e32fe6e5a6ca7e', '3b8a3b6e20f8a649e1113e2e8afc578a227c40fc']",0,1860,1860,649798,12,,,,1440
55a364a4f806a4acf17c594f1697caf1fba02656,1,Todd Lipcon,2015-08-13 11:25:42-07:00,['d6d190cbca845d8e9ab0bee89da48762ff51f5ac'],184,404,588,650386,13,0.330508475,0.686440678,1,1440
c3356fa7d4fc9851c131f4ea83ba5bfcb9ec749f,0,Todd Lipcon,2015-08-13 11:26:01-07:00,['55a364a4f806a4acf17c594f1697caf1fba02656'],3,12,15,650401,1,0,1,1,1440
747b657f45c3bb81a690a6ef7a526771ce29eb07,0,Jean-Daniel Cryans,2015-08-13 15:00:11-07:00,['0d363b4588ca2b571a4c62cc6b06e24ee34ec675'],0,126,126,650527,3,0,0,1,1443
493e04e2edcfb157c541e85625f741f69181ef93,0,Todd Lipcon,2015-08-13 15:14:13-07:00,['747b657f45c3bb81a690a6ef7a526771ce29eb07'],1,14,15,650542,2,,,,1443
42eff07a225cf3b7ca23d413d72974831404ade8,0,Martin Grund,2015-08-13 17:04:35-07:00,['493e04e2edcfb157c541e85625f741f69181ef93'],0,1,1,650543,1,,,,1443
16f6c4191841969862232c80f1345657611f5680,0,Martin Grund,2015-08-13 17:05:32-07:00,['493e04e2edcfb157c541e85625f741f69181ef93'],0,1,1,650544,1,,,,1443
e8bbaded0ee7787e5af8557d963e6a3e2b39ac9e,0,todd,2015-08-13 18:31:48-07:00,"['493e04e2edcfb157c541e85625f741f69181ef93', '16f6c4191841969862232c80f1345657611f5680']",0,1,1,650545,1,,,,1443
92cfa0d571e872d60411b94176e623ddf159588f,0,todd,2015-08-13 18:32:15-07:00,"['e8bbaded0ee7787e5af8557d963e6a3e2b39ac9e', '42eff07a225cf3b7ca23d413d72974831404ade8']",0,1,1,650546,1,,,,1443
a0dc3724d282a751f7a7f3cac4eae01403f5db15,0,Michael Percy,2015-08-13 19:35:35-07:00,['c3356fa7d4fc9851c131f4ea83ba5bfcb9ec749f'],2,2,4,650550,1,,,,1443
9d54134528a583448b9fdd8a319cbe63ffe314a9,0,Jean-Daniel Cryans,2015-08-13 19:55:50-07:00,['a0dc3724d282a751f7a7f3cac4eae01403f5db15'],15,18,33,650583,8,,,,1443
5bf03fa9c6e7545c3669826202053a9555f988a0,1,Todd Lipcon,2015-08-13 21:01:47-07:00,['9d54134528a583448b9fdd8a319cbe63ffe314a9'],46,73,119,650702,7,0,0.95,0.7,1443
d9e116f280b3f1cbd246e9f8be11fead54f04ac1,0,David Alves,2015-08-13 21:20:54-07:00,['5bf03fa9c6e7545c3669826202053a9555f988a0'],1,1,2,650704,1,,,,1443
3aba3d5660f573944690b05fddcd2f804784763e,0,Adar Dembo,2015-08-13 22:33:47-07:00,['d9e116f280b3f1cbd246e9f8be11fead54f04ac1'],1,1,2,650706,1,,,,1443
262f87e3633acd5221dba3ab65d256347280075e,0,Todd Lipcon,2015-08-13 23:39:40-07:00,['3aba3d5660f573944690b05fddcd2f804784763e'],1,1,2,650708,1,,,,1443
3839a0293bf21e2ab9978050dcafe3a6ef643f26,0,Todd Lipcon,2015-08-13 23:42:57-07:00,['262f87e3633acd5221dba3ab65d256347280075e'],9,23,32,650740,1,1,1,1,1443
cab1696c1bb41e8cf1a707df1f81bd691f3509da,1,Todd Lipcon,2015-08-13 23:43:59-07:00,['3839a0293bf21e2ab9978050dcafe3a6ef643f26'],1,6,7,650747,1,0,1,0,1443
d76b564626bcf4947c3e7071e47c04d43edd6a60,0,Todd Lipcon,2015-08-14 00:36:24-07:00,['92cfa0d571e872d60411b94176e623ddf159588f'],11,15,26,650773,1,,,,1443
422b050f7b38cec48bd55e11212564311d3e7311,0,Todd Lipcon,2015-08-14 00:51:51-07:00,['d76b564626bcf4947c3e7071e47c04d43edd6a60'],2,1,3,650776,1,,,,1443
5d6fa5b5352cb25868ce25790c2fb075bce8628b,0,Todd Lipcon,2015-08-14 00:54:21-07:00,['422b050f7b38cec48bd55e11212564311d3e7311'],6,23,29,650805,4,0,0,1,1443
c5610769ec1d8cfd598cf157012cee3ce69d1430,0,Todd Lipcon,2015-08-14 00:57:37-07:00,['5d6fa5b5352cb25868ce25790c2fb075bce8628b'],6,6,12,650817,1,,,,1443
61f23b8ab6b0c5301cdbe5b9f00861ffcc2862d3,0,Todd Lipcon,2015-08-14 01:10:39-07:00,['c5610769ec1d8cfd598cf157012cee3ce69d1430'],20,58,78,650895,1,,,,1443
aa6f3e3d55544896c96013f36ad436fd441338cf,0,Jean-Daniel Cryans,2015-08-14 11:40:06-07:00,['61f23b8ab6b0c5301cdbe5b9f00861ffcc2862d3'],1,1,2,650897,1,,,,1443
5cec8a8279a7612b81a78972b8dec49fa7222ce1,0,Adar Dembo,2015-08-17 11:31:20-07:00,['cab1696c1bb41e8cf1a707df1f81bd691f3509da'],1,9,10,650907,1,,,,1443
e0c88334940b361502a64ae2fe7731dafa5e07eb,1,Adar Dembo,2015-08-17 15:21:25-07:00,['5cec8a8279a7612b81a78972b8dec49fa7222ce1'],0,51,51,650958,4,0.236842105,1,1,1443
915f48a0964f80a3f23165cd87e81dbc208403bb,0,Michael Percy,2015-08-17 19:31:50-07:00,['e0c88334940b361502a64ae2fe7731dafa5e07eb'],0,42,42,651000,1,0.074074074,0.703703704,1,1443
cfb8479febe0f4e0e260cdad626065dac383b442,1,Michael Percy,2015-08-18 15:30:17-07:00,['915f48a0964f80a3f23165cd87e81dbc208403bb'],22,97,119,651119,12,0.46875,1,1,1443
18c71e7a27d41af60d595fab1868024750e02a12,1,Michael Percy,2015-08-18 15:30:33-07:00,['cfb8479febe0f4e0e260cdad626065dac383b442'],38,281,319,651438,12,0.111940299,1,0.865671642,1443
bd859d3b6d70f1e58df8fca1ad81d0ace553014a,1,Todd Lipcon,2015-08-18 15:56:40-07:00,['18c71e7a27d41af60d595fab1868024750e02a12'],1,21,22,651460,3,0.083333333,1,0.833333333,1443
d66477f2d17b7ce2ff76d8b0759593d0c0db5433,0,Todd Lipcon,2015-08-18 16:46:06-07:00,['bd859d3b6d70f1e58df8fca1ad81d0ace553014a'],33,45,78,651538,6,0,,1,1443
037d1e1e413f9ea582fa8c46fa39336c001ce9c7,1,Todd Lipcon,2015-08-18 16:47:11-07:00,['d66477f2d17b7ce2ff76d8b0759593d0c0db5433'],7,86,93,651631,3,0.08,1,1,1443
2e36247d4b913506a5971e46a20dd63341e55f90,0,Todd Lipcon,2015-08-18 16:52:21-07:00,['037d1e1e413f9ea582fa8c46fa39336c001ce9c7'],0,88,88,651719,3,0.375,1,0.825,1444
b2504eafd494bca8a396561c01c651f21c9d80f3,0,Michael Percy,2015-08-18 17:41:30-07:00,['2e36247d4b913506a5971e46a20dd63341e55f90'],15,26,41,651760,3,,,,1445
b70fe8931ae8b339d0f2f439a0a078ed7bd97ec4,0,Adar Dembo,2015-08-18 18:08:56-07:00,['b2504eafd494bca8a396561c01c651f21c9d80f3'],1,2,3,651763,1,1,1,1,1445
d4bded5ac67ea9e4719b451997f289889c241d39,1,Todd Lipcon,2015-08-18 18:13:50-07:00,['b70fe8931ae8b339d0f2f439a0a078ed7bd97ec4'],8,31,39,651802,3,0,1,1,1445
be1e476df107786732373850047db378636a9f5a,1,Todd Lipcon,2015-08-18 18:46:45-07:00,['d4bded5ac67ea9e4719b451997f289889c241d39'],64,270,334,652136,10,0,1,1,1445
fa429e4decda72167e8f5e065b94c00d2f0aa793,1,Michael Percy,2015-08-18 21:43:01-07:00,['be1e476df107786732373850047db378636a9f5a'],56,172,228,652364,8,0,1,0.976190476,1445
c5a02b76c6c2e3becc15696a3c6e27e4f2684454,0,Todd Lipcon,2015-08-19 10:29:15-07:00,['fa429e4decda72167e8f5e065b94c00d2f0aa793'],1,12,13,652377,2,0.5,0.5,1,1445
4b46ede17fce488ff8d3b43ab10291c4cd3a8bda,0,Todd Lipcon,2015-08-19 10:30:24-07:00,['c5a02b76c6c2e3becc15696a3c6e27e4f2684454'],0,58,58,652435,1,,,,1445
e402d5ed79a9c98283b6612ac3d3eb152e20ca38,0,Michael Percy,2015-08-19 18:17:47-07:00,['4b46ede17fce488ff8d3b43ab10291c4cd3a8bda'],39,48,87,652522,3,1,1,1,1445
a4e4492ad00b2a5d1b00152a378757af854a9163,0,Todd Lipcon,2015-08-20 00:03:44-07:00,['e402d5ed79a9c98283b6612ac3d3eb152e20ca38'],2,94,96,652618,6,,,,1446
ec46e8ab76ad64f09aeba3805eb6f7102676532e,0,Todd Lipcon,2015-08-20 00:03:52-07:00,['a4e4492ad00b2a5d1b00152a378757af854a9163'],40,71,111,652729,7,1,1,1,1446
08c1ac388dd83b172be9f1f35df41fa81c854032,0,Todd Lipcon,2015-08-20 01:29:05-07:00,['ec46e8ab76ad64f09aeba3805eb6f7102676532e'],0,72,72,652801,5,1,1,0.923076923,1448
a00689c6f971c1a0dd36822192213fef557e751a,0,Michael Percy,2015-08-20 02:22:02-07:00,['08c1ac388dd83b172be9f1f35df41fa81c854032'],1,2,3,652804,1,1,1,1,1448
65f3accab43c99aeb6d5834b4bb51e1da18fc848,0,Michael Percy,2015-08-20 02:38:11-07:00,['a00689c6f971c1a0dd36822192213fef557e751a'],0,3,3,652807,1,,,,1448
fdbff193910e2492709631fb55bd4548a68fc6c4,0,Todd Lipcon,2015-08-20 10:09:30-07:00,['65f3accab43c99aeb6d5834b4bb51e1da18fc848'],0,20,20,652827,3,1,1,1,1448
1d250ef48913a248cc07c102c1070f8a9bea9580,0,Todd Lipcon,2015-08-20 10:46:19-07:00,['fdbff193910e2492709631fb55bd4548a68fc6c4'],2,32,34,652861,3,,,,1449
51c3703030c4082eb206617f595196d315d87809,1,Michael Percy,2015-08-20 16:20:25-07:00,['1d250ef48913a248cc07c102c1070f8a9bea9580'],28,46,74,652935,3,0.111111111,0.111111111,0.111111111,1449
8c34f6766927591a2a70edcecc5ec705a58dc5e2,1,Michael Percy,2015-08-20 17:22:04-07:00,['51c3703030c4082eb206617f595196d315d87809'],36,37,73,653008,16,,,,1449
680472b37741c14603a89779fb77ba50a720e12b,0,Adar Dembo,2015-08-20 18:12:00-07:00,['8c34f6766927591a2a70edcecc5ec705a58dc5e2'],56,74,130,653138,8,0.5,0,0.5,1449
987c09a5d81453d3aeb1d53629425d752bb4cdd5,0,Adar Dembo,2015-08-20 18:27:31-07:00,['680472b37741c14603a89779fb77ba50a720e12b'],8,0,8,653146,1,,,,1449
0bc20017b4d00dfb351f18ef3929afa9e2e8a9e3,0,Todd Lipcon,2015-08-20 21:15:27-07:00,['987c09a5d81453d3aeb1d53629425d752bb4cdd5'],1,1,2,653148,1,,,,1449
2dd37d472e27b1febda85a7ea3c3440bf9c701d6,1,Michael Percy,2015-08-20 23:13:26-07:00,['0bc20017b4d00dfb351f18ef3929afa9e2e8a9e3'],33,60,93,653241,1,,,,1449
12a381e4c23c32ae788a6bea852574d893d5d30a,1,Todd Lipcon,2015-08-21 00:00:35-07:00,['2dd37d472e27b1febda85a7ea3c3440bf9c701d6'],85,96,181,653422,4,0,0,0.571428571,1449
f9e0d4ae8b78d15337912db2f9e62a4e5fa06418,1,Michael Percy,2015-08-21 16:11:47-07:00,['12a381e4c23c32ae788a6bea852574d893d5d30a'],2,76,78,653500,3,0,0.926829268,1,1449
c716194ee8a36175283b7d5cf2760158e9f20dcf,0,Todd Lipcon,2015-08-21 17:59:28-07:00,['f9e0d4ae8b78d15337912db2f9e62a4e5fa06418'],4,4,8,653508,1,,,,1449
2b036f2ae5e0afbb6363a7a486a8d1b94e866ac2,1,Michael Percy,2015-08-21 19:03:18-07:00,['c716194ee8a36175283b7d5cf2760158e9f20dcf'],47,61,108,653616,1,0.3,1,1,1449
127322969eeb80ed1a0cf7d9cb84414cbc31d4a1,0,Michael Percy,2015-08-21 19:03:41-07:00,['2b036f2ae5e0afbb6363a7a486a8d1b94e866ac2'],5,7,12,653628,3,,,,1449
fa3c0acf94c40437bb0cbbe4c03a0f96fbafac71,1,Todd Lipcon,2015-08-23 21:17:25-07:00,['127322969eeb80ed1a0cf7d9cb84414cbc31d4a1'],54,202,256,653884,7,0.021276596,0.617021277,0.638297872,1449
1d5b2916ced7258f5efc5122ac516033752d2b32,0,Todd Lipcon,2015-08-24 09:08:18-07:00,['fa3c0acf94c40437bb0cbbe4c03a0f96fbafac71'],0,15,15,653899,1,,,,1449
9df52fa2b078db3f8c9402992f5c3f1ad6cedfdf,1,Todd Lipcon,2015-08-24 10:19:33-07:00,['1d5b2916ced7258f5efc5122ac516033752d2b32'],65,60,125,654024,2,1,1,1,1449
a55a248e4e8632bac4c91fa7235e8f885aa72b69,0,Todd Lipcon,2015-08-24 11:00:57-07:00,['9df52fa2b078db3f8c9402992f5c3f1ad6cedfdf'],1,6,7,654031,1,1,1,1,1449
e1b42e9337b400c48d48389052a8747a4854fb26,0,Michael Percy,2015-08-24 12:19:27-07:00,['a55a248e4e8632bac4c91fa7235e8f885aa72b69'],1,121,122,654153,8,0.333333333,0.944444444,0.444444444,1451
8186cc18db6f2879e6148ab1eff3a30f272e3e83,1,Michael Percy,2015-08-24 12:28:54-07:00,['e1b42e9337b400c48d48389052a8747a4854fb26'],1,1,2,654155,1,,,,1451
bbdb02262fd405cbd7d519edd6f7b491571bb276,1,Adar Dembo,2015-08-24 12:36:00-07:00,['8186cc18db6f2879e6148ab1eff3a30f272e3e83'],12,89,101,654256,2,,,,1451
4964fcb6ca0cf107decc2811cff9561cb93152d6,1,Adar Dembo,2015-08-24 12:53:08-07:00,['bbdb02262fd405cbd7d519edd6f7b491571bb276'],20,72,92,654348,11,0.035714286,0.928571429,0.785714286,1451
78a0552849385ad8f96d7fe7957794500410fc8d,0,Michael Percy,2015-08-24 14:16:46-07:00,['4964fcb6ca0cf107decc2811cff9561cb93152d6'],13,65,78,654426,3,0.178571429,0,0.071428571,1451
864f9d62acbca707793ba91f5453c3bd493432db,0,Misty Stanley-Jones,2015-08-24 14:22:32-07:00,['78a0552849385ad8f96d7fe7957794500410fc8d'],2,47,49,654475,1,,,,1451
af24c488735519ff05b4119d07ef43dc31465705,1,Michael Percy,2015-08-24 14:24:21-07:00,['864f9d62acbca707793ba91f5453c3bd493432db'],9,18,27,654502,1,0,1,1,1451
6cc55b1c2621ee898cbbe3cdb2736baacfc4b63e,1,Michael Percy,2015-08-24 14:58:06-07:00,['af24c488735519ff05b4119d07ef43dc31465705'],29,76,105,654607,3,0.035714286,1,1,1451
91708b0aae7bf291486f27801b88e3c31b735c18,1,Michael Percy,2015-08-24 15:37:48-07:00,['6cc55b1c2621ee898cbbe3cdb2736baacfc4b63e'],5,27,32,654639,1,0,1,1,1451
e0e31c0ee5e4ee93c9def13f0255d820276a251f,1,Michael Percy,2015-08-24 16:13:26-07:00,['91708b0aae7bf291486f27801b88e3c31b735c18'],5,97,102,654741,3,0.293103448,0.586206897,0.931034483,1451
e1b1d738061645bf8cd64c5c9773a60bfdb7f21c,0,Adar Dembo,2015-08-24 18:17:27-07:00,['e0e31c0ee5e4ee93c9def13f0255d820276a251f'],1,5,6,654747,1,,,,1451
2f28a2b7e4d5fc3ac73044f76da6247d6ae6d803,0,Todd Lipcon,2015-08-24 19:44:19-07:00,['e1b1d738061645bf8cd64c5c9773a60bfdb7f21c'],1,1,2,654749,1,,,,1451
ec178760edc7ff8910fc7c48be9d9672ed547121,1,Michael Percy,2015-08-24 23:25:21-07:00,['2f28a2b7e4d5fc3ac73044f76da6247d6ae6d803'],5,19,24,654773,1,1,1,1,1451
cc1b6a4bc9df8536a62533a460f56c3379e75b76,0,Todd Lipcon,2015-08-24 23:43:14-07:00,['ec178760edc7ff8910fc7c48be9d9672ed547121'],7,68,75,654848,1,0,0,1,1451
ce199574330ffb34bd68db009f623ba5ef98ed04,0,Todd Lipcon,2015-08-24 23:43:18-07:00,['cc1b6a4bc9df8536a62533a460f56c3379e75b76'],2,2,4,654852,1,,,,1451
21db13563e6b4589b30dfc3f0aaf90c8a481cc8c,0,Todd Lipcon,2015-08-25 02:17:26-07:00,['ce199574330ffb34bd68db009f623ba5ef98ed04'],1,13,14,654866,1,1,1,1,1451
bcfbc47b69b6385448c7b5e7b5586f823511e12c,1,Todd Lipcon,2015-08-25 02:17:41-07:00,['21db13563e6b4589b30dfc3f0aaf90c8a481cc8c'],7,37,44,654910,1,0.555555556,1,0,1451
bda789a5f00a9de73643c1f79cd8eb3c38c57a49,0,Michael Percy,2015-08-25 02:26:37-07:00,['bcfbc47b69b6385448c7b5e7b5586f823511e12c'],0,3,3,654913,1,0,1,1,1451
a280c8afc14353f47e85e41791606149a30bf644,1,Todd Lipcon,2015-08-25 12:45:44-07:00,['bda789a5f00a9de73643c1f79cd8eb3c38c57a49'],15,21,36,654949,1,0,1,1,1451
025818b4dd52f538da15ed0aaae87520e983315c,0,Adar Dembo,2015-08-25 15:06:57-07:00,['a280c8afc14353f47e85e41791606149a30bf644'],1,9,10,654959,1,0,1,1,1451
99663d6e717e2d523bc48f3561ce5fbe2683185c,0,Todd Lipcon,2015-08-25 17:50:12-07:00,['025818b4dd52f538da15ed0aaae87520e983315c'],13,66,79,655038,5,0.941176471,1,1,1452
049846eeeb23f67490308522573d4cb93c1e299f,0,Todd Lipcon,2015-08-25 18:17:49-07:00,['99663d6e717e2d523bc48f3561ce5fbe2683185c'],1,1,2,655040,1,,,,1452
a6afbd39a94c9509a1bc51ca3ed1f3e3a531c56d,1,Todd Lipcon,2015-08-25 19:13:58-07:00,['049846eeeb23f67490308522573d4cb93c1e299f'],43,238,281,655321,16,0.26744186,0.709302326,0.709302326,1452
e13d27e5196b6e9222e734a8e39e35665c90218b,0,Adar Dembo,2015-08-25 19:57:34-07:00,['a6afbd39a94c9509a1bc51ca3ed1f3e3a531c56d'],4,59,63,655384,2,,,,1452
af71c67a4ce11c1a8d0b3c346cb66bf6f2429a1a,1,Adar Dembo,2015-08-25 20:53:15-07:00,['e13d27e5196b6e9222e734a8e39e35665c90218b'],1,293,294,655678,4,0.390625,1,1,1453
df93ad3884f797be66e4d0bf24990dce13e898ca,1,Michael Percy,2015-08-25 22:07:15-07:00,['af71c67a4ce11c1a8d0b3c346cb66bf6f2429a1a'],21,157,178,655856,9,0.11627907,0.872093023,0.965116279,1453
05b0b1ebd318335ea6b29a28db6b69c173950aaa,0,Todd Lipcon,2015-08-26 12:05:48-07:00,['df93ad3884f797be66e4d0bf24990dce13e898ca'],1,22,23,655879,2,0,0,0.05,1453
a40fdb968bd50480e3080222960fdf3f555bc70b,0,Adar Dembo,2015-08-26 15:30:07-07:00,['05b0b1ebd318335ea6b29a28db6b69c173950aaa'],5,205,210,656089,15,,,,1454
aec774736bb3f56035fc373cef989db14f8dc432,0,Todd Lipcon,2015-08-26 18:18:37-07:00,['a40fdb968bd50480e3080222960fdf3f555bc70b'],6,29,35,656124,2,0,1,1,1454
b95367994d52a94336ab8ba1911670756ff63610,0,Todd Lipcon,2015-08-26 21:04:28-07:00,['aec774736bb3f56035fc373cef989db14f8dc432'],2,29,31,656155,5,0,1,1,1454
3b528967f06628974da6a839104b329c2e3db33e,0,Todd Lipcon,2015-08-26 21:21:32-07:00,['b95367994d52a94336ab8ba1911670756ff63610'],19,97,116,656271,8,0,0.96,0.86,1454
85ffb65960e351c59e569dc668dd35b51dff5324,1,Todd Lipcon,2015-08-27 11:35:46-07:00,['3b528967f06628974da6a839104b329c2e3db33e'],21,139,160,656431,5,0.184210526,0.368421053,0.368421053,1454
a221343b7c4b6ac5d7a0323ef6488a964a544ac5,0,Adar Dembo,2015-08-27 13:17:01-07:00,['85ffb65960e351c59e569dc668dd35b51dff5324'],12,27,39,656470,1,0,0,1,1454
5a704edc822403c609fa3f8710d6cc8cd9eb2373,0,Adar Dembo,2015-08-27 13:17:20-07:00,['a221343b7c4b6ac5d7a0323ef6488a964a544ac5'],22,82,104,656574,2,,,,1454
5e696250785ddc497c44289ada6f10c374d11cfa,0,Jean-Daniel Cryans,2015-08-27 13:22:57-07:00,['5a704edc822403c609fa3f8710d6cc8cd9eb2373'],5,39,44,656618,2,0.642857143,0.642857143,1,1454
e349a430252a816a04ef639ef01d8ec63985c879,1,Adar Dembo,2015-08-27 13:41:18-07:00,['5e696250785ddc497c44289ada6f10c374d11cfa'],3,53,56,656674,5,0,1,1,1455
a758b4664e8dc2082c50f28c02d4d9f75945b7bc,0,Todd Lipcon,2015-08-27 15:16:23-07:00,['e349a430252a816a04ef639ef01d8ec63985c879'],25,25,50,656724,1,,,,1455
1572c86b40459d430f9876c039536d738b898fd4,0,Misty Stanley-Jones,2015-08-27 15:16:32-07:00,['a758b4664e8dc2082c50f28c02d4d9f75945b7bc'],28,73,101,656825,2,,,,1455
1c12140879dbce0c60bc340defa799129224cdad,1,Todd Lipcon,2015-08-27 16:19:18-07:00,['1572c86b40459d430f9876c039536d738b898fd4'],7,165,172,656997,3,0,0.513513514,0.333333333,1455
439b0c342af1fdc5ba4b2c350e640787f2adf28c,0,Todd Lipcon,2015-08-27 16:25:36-07:00,['1c12140879dbce0c60bc340defa799129224cdad'],3,33,36,657033,4,0,0.857142857,0.857142857,1455
6bec42c7d5030d4fb8301de0b78aa481abc1ec7d,1,Michael Percy,2015-08-27 18:36:17-07:00,['439b0c342af1fdc5ba4b2c350e640787f2adf28c'],32,81,113,657146,2,0.047619048,1,1,1455
07b506f3df80166bdfc67527b5de51feb23e19a1,0,Todd Lipcon,2015-08-27 18:41:48-07:00,['6bec42c7d5030d4fb8301de0b78aa481abc1ec7d'],6,6,12,657158,2,,,,1455
7d167f8e76e472166fbf3a8c33f69e9cba72d224,0,Todd Lipcon,2015-08-27 19:57:06-07:00,['07b506f3df80166bdfc67527b5de51feb23e19a1'],1,45,46,657204,2,0,1,1,1455
5b974296b5c8d698db90f4249dbf8141db7d04bf,0,Todd Lipcon,2015-08-27 20:45:46-07:00,['7d167f8e76e472166fbf3a8c33f69e9cba72d224'],1,1,2,657206,1,,,,1455
9c16ce733ae3ee817434655a50594015982bcd4e,1,Todd Lipcon,2015-08-27 21:20:23-07:00,['5b974296b5c8d698db90f4249dbf8141db7d04bf'],50,62,112,657318,12,0,0.909090909,0.363636364,1455
35420fb04aa617f5fa9b979e4688c6b10830866d,0,Todd Lipcon,2015-08-27 22:31:09-07:00,['9c16ce733ae3ee817434655a50594015982bcd4e'],0,3,3,657321,1,0,1,1,1455
bcb46101d0773655b92ce768b9f004a29eb082a2,1,Adar Dembo,2015-08-28 14:43:30-07:00,['35420fb04aa617f5fa9b979e4688c6b10830866d'],8,40,48,657369,3,1,1,1,1455
14934641b1636aac28661b2f8fd782c7f024dc2f,0,Todd Lipcon,2015-08-30 19:23:58-07:00,['bcb46101d0773655b92ce768b9f004a29eb082a2'],3,15,18,657387,1,0,1,1,1455
e7356567eb579d07dc81721c5698adfca7e53b76,0,Todd Lipcon,2015-08-30 19:24:31-07:00,['14934641b1636aac28661b2f8fd782c7f024dc2f'],1,5,6,657393,1,1,0,0,1455
35d852cbeaa4db4bbf396af42afaffe472712675,1,Todd Lipcon,2015-08-30 22:20:47-07:00,['e7356567eb579d07dc81721c5698adfca7e53b76'],52,213,265,657658,7,0.204819277,0.915662651,0.518072289,1455
6a6aa13670d5c1c54ed4af08956a02d2a8bb2d59,1,Todd Lipcon,2015-08-30 22:22:06-07:00,['35d852cbeaa4db4bbf396af42afaffe472712675'],48,71,119,657777,2,0.526315789,0.526315789,0,1455
fc03b716981690cc563e8167de9d62dd1e3e4146,0,Michael Percy,2015-08-30 23:28:52-07:00,['6a6aa13670d5c1c54ed4af08956a02d2a8bb2d59'],7,8,15,657792,1,,,,1455
784b6bfb1a88d5842d2c2878f394169ba7f11b7a,1,Todd Lipcon,2015-08-31 12:45:43-07:00,['fc03b716981690cc563e8167de9d62dd1e3e4146'],2,164,166,657958,15,0,0.386792453,0.349056604,1455
e85593f7a8921cbdbfdc5f2104b7d8fcac5f5d5c,1,Todd Lipcon,2015-08-31 14:25:30-07:00,['784b6bfb1a88d5842d2c2878f394169ba7f11b7a'],24,145,169,658127,4,0.166666667,0.510416667,1,1455
563114ed622452354b0be7d5048d457b197ca1f0,1,Adar Dembo,2015-08-31 14:26:07-07:00,['e85593f7a8921cbdbfdc5f2104b7d8fcac5f5d5c'],0,447,447,658574,1,0.620300752,0.714285714,0.695488722,1456
2d8ec0a89f36cfa00575a14ce36a7291b2db95fb,1,Todd Lipcon,2015-08-31 14:26:42-07:00,['563114ed622452354b0be7d5048d457b197ca1f0'],175,652,827,659401,14,0.783251232,0.931034483,0.78817734,1457
807b15759919f21afce8688945e952aaef28612c,0,Todd Lipcon,2015-08-31 17:03:47-07:00,['2d8ec0a89f36cfa00575a14ce36a7291b2db95fb'],7,3,10,659411,2,1,0,0,1457
25fcb6477477615fc4d0adf88da4069238996c64,0,Todd Lipcon,2015-08-31 20:05:35-07:00,['807b15759919f21afce8688945e952aaef28612c'],2,6,8,659419,1,0,0,0,1457
b88adfbdac43dec9cc1087602e732b176a7943aa,0,Todd Lipcon,2015-08-31 21:41:26-07:00,['25fcb6477477615fc4d0adf88da4069238996c64'],7,15,22,659441,1,0,0,0,1457
2f88945de3dfa54c1933ec82e8503e35115b8e68,0,Todd Lipcon,2015-08-31 22:19:44-07:00,['b88adfbdac43dec9cc1087602e732b176a7943aa'],21,60,81,659522,5,1,1,0.818181818,1457
9ea2d4201e359a7fd919d344758ec85dba3de1d9,0,Michael Percy,2015-08-31 22:57:20-07:00,['2f88945de3dfa54c1933ec82e8503e35115b8e68'],1,3,4,659526,2,,,,1457
6f20162ad1b2929a0cb2c65fa02c196c76e65b24,1,Todd Lipcon,2015-08-31 23:30:27-07:00,['9ea2d4201e359a7fd919d344758ec85dba3de1d9'],0,6,6,659532,1,0,1,0,1457
b114099eebd446c9ce36c70d12e8099ee32fe115,1,Dan Burkert,2015-09-01 15:44:30-07:00,['6f20162ad1b2929a0cb2c65fa02c196c76e65b24'],0,1489,1489,661021,6,0.202797203,0.808857809,0.713286713,1460
8cbdda6e4a09df7c93d148798f30f39dc4d31e27,1,Dan Burkert,2015-09-01 17:14:16-07:00,['b114099eebd446c9ce36c70d12e8099ee32fe115'],513,350,863,661884,19,1,1,0,1460
7e54b14311d53ae0953dfeb7a9b25efa44f6f603,0,Todd Lipcon,2015-09-01 18:29:53-07:00,['8cbdda6e4a09df7c93d148798f30f39dc4d31e27'],4,64,68,661952,6,0.086956522,0,1,1460
c2b2eb0eb304f3d55900668fdddfb6581c1a9115,1,Michael Percy,2015-09-02 17:45:09-07:00,['7e54b14311d53ae0953dfeb7a9b25efa44f6f603'],13,40,53,662005,4,0.6,0.8,1,1460
6a5c7ab543a22b909aee148d51cf49146d777ae1,0,Todd Lipcon,2015-09-02 18:19:14-07:00,['c2b2eb0eb304f3d55900668fdddfb6581c1a9115'],39,42,81,662086,8,0,0,0,1460
0a0396630170b19d70befc0c89f52f89dd93eeae,1,Todd Lipcon,2015-09-02 18:19:28-07:00,['6a5c7ab543a22b909aee148d51cf49146d777ae1'],44,45,89,662175,13,0,0,0.714285714,1460
1451fa28d725b2dbf3ba7883d3a18812dc606996,0,Todd Lipcon,2015-09-02 19:29:57-07:00,['0a0396630170b19d70befc0c89f52f89dd93eeae'],2,17,19,662194,1,1,1,1,1460
9613929ca71648d503311f52d5a95b38b34670f7,1,Todd Lipcon,2015-09-03 11:10:13-07:00,['1451fa28d725b2dbf3ba7883d3a18812dc606996'],21,29,50,662244,2,0.5,1,1,1460
d60073c5f8a8fc1d8d1cc65a8db9a2289d884292,1,Todd Lipcon,2015-09-03 20:26:58-07:00,['9613929ca71648d503311f52d5a95b38b34670f7'],65,172,237,662481,23,0.632653061,0,0.632653061,1460
e68c0feea05a3867c547b27042015f569340691b,0,Todd Lipcon,2015-09-05 12:01:19-07:00,['d60073c5f8a8fc1d8d1cc65a8db9a2289d884292'],11,19,30,662511,1,0,0,1,1460
a54cff1d7ab4f3f553bba65e47b7d00e706da928,1,Todd Lipcon,2015-09-05 19:10:22-07:00,['e68c0feea05a3867c547b27042015f569340691b'],0,780,780,663291,10,0.441605839,0.441605839,0.737226277,1469
08b2fc0740a92f2765c5ba6f2b295fee5365ca4b,0,Todd Lipcon,2015-09-07 11:04:23-07:00,['a54cff1d7ab4f3f553bba65e47b7d00e706da928'],1,6,7,663298,1,,,,1469
88f1849d3f8a7c502338a6b2ca158c4928fbdf7b,0,Todd Lipcon,2015-09-07 17:02:18-07:00,['08b2fc0740a92f2765c5ba6f2b295fee5365ca4b'],26,25,51,663349,2,1,0,1,1469
982dfa0e2fb982768e0176361d38e1006d88a71e,0,Jean-Daniel Cryans,2015-09-07 18:33:16-07:00,['88f1849d3f8a7c502338a6b2ca158c4928fbdf7b'],2,57,59,663408,4,0.238095238,1,0.952380952,1469
15581a59ad4c329d80a2d933a9dce5175d41f28f,0,Jean-Daniel Cryans,2015-09-07 18:41:55-07:00,['982dfa0e2fb982768e0176361d38e1006d88a71e'],8,53,61,663469,1,,,,1469
77417a210031df4523af17cd4e3495841b54f67a,0,Todd Lipcon,2015-09-07 19:25:46-07:00,['15581a59ad4c329d80a2d933a9dce5175d41f28f'],0,11,11,663480,2,0,0,0.5,1469
d6cdbee898c6b0a267a7c7027c731d98f675bbfa,0,Todd Lipcon,2015-09-07 19:26:32-07:00,['77417a210031df4523af17cd4e3495841b54f67a'],1,1,2,663482,1,,,,1469
7fec0273a3ec03d0be869ad16600ead337a739a5,0,Todd Lipcon,2015-09-07 19:32:15-07:00,['d6cdbee898c6b0a267a7c7027c731d98f675bbfa'],1,5,6,663488,3,,,,1469
c19b51f06783707b49bbff53aae250c8d936efa2,0,Todd Lipcon,2015-09-08 00:03:21-07:00,['7fec0273a3ec03d0be869ad16600ead337a739a5'],0,94,94,663582,4,0.275862069,0.879310345,0.810344828,1469
88d51dbbc2546a2f5a3d8eee6add257857f8a67b,0,Todd Lipcon,2015-09-08 00:24:11-07:00,['c19b51f06783707b49bbff53aae250c8d936efa2'],0,41,41,663623,2,,,,1469
6159c3ff72c54b96d2817bbb93bb8e5010271ba1,0,Todd Lipcon,2015-09-08 10:05:34-07:00,['88d51dbbc2546a2f5a3d8eee6add257857f8a67b'],1,1,2,663625,1,,,,1469
8f64ffb0e68d58a99e4b28aac60c113ad16b2472,1,Todd Lipcon,2015-09-08 12:11:51-07:00,['6159c3ff72c54b96d2817bbb93bb8e5010271ba1'],16,21,37,663662,4,1,1,1,1469
eea66af89cbf03d8e7cce9a41e527c7fb5698c1e,0,Todd Lipcon,2015-09-08 12:12:11-07:00,['8f64ffb0e68d58a99e4b28aac60c113ad16b2472'],29,87,116,663778,4,0.128205128,1,1,1469
51bc0d585962a18a39ad6db3935426d9681afd2f,0,Michael Percy,2015-09-08 12:47:40-07:00,['eea66af89cbf03d8e7cce9a41e527c7fb5698c1e'],11,135,146,663924,5,0.029411765,0.455882353,1,1469
df9d82c0e214159c55a0e8b8307b36513bd1d599,1,Todd Lipcon,2015-09-08 12:53:09-07:00,['51bc0d585962a18a39ad6db3935426d9681afd2f'],10,56,66,663990,3,0,1,1,1469
91f4f0ff8a3b5df3574ce85f9ce9daeac8c9413a,1,Todd Lipcon,2015-09-08 18:44:55-07:00,['df9d82c0e214159c55a0e8b8307b36513bd1d599'],17,106,123,664113,8,0.833333333,0.833333333,0.833333333,1469
0114c392f5ae97c95211305b818f607a03534fc6,1,Todd Lipcon,2015-09-08 18:52:43-07:00,['91f4f0ff8a3b5df3574ce85f9ce9daeac8c9413a'],236,263,499,664612,19,0,0,0,1469
15e3f3e8d018d9597f0e9ecb5428578c90d6a0f0,0,Todd Lipcon,2015-09-08 23:38:26-07:00,['0114c392f5ae97c95211305b818f607a03534fc6'],65,105,170,664782,8,0.192307692,0.923076923,0.653846154,1469
4bae74b04e4d065058f2141a0fd761c9d221b3c9,1,Todd Lipcon,2015-09-08 23:42:30-07:00,['15e3f3e8d018d9597f0e9ecb5428578c90d6a0f0'],46,159,205,664987,10,0,0.774647887,0.61971831,1469
9e660b35e8fbbdbec20d17b140557ab9b1fa740a,1,Todd Lipcon,2015-09-08 23:45:53-07:00,['4bae74b04e4d065058f2141a0fd761c9d221b3c9'],100,326,426,665413,9,0.301282051,0.621794872,0,1469
f2d96437cc55a10caa4c9be6d0a6e62282db081a,1,Todd Lipcon,2015-09-09 00:03:18-07:00,['9e660b35e8fbbdbec20d17b140557ab9b1fa740a'],50,91,141,665554,11,0.133333333,1,0.866666667,1469
ec621d20130fe2eb447c7504410593df9bd13b41,0,Michael Percy,2015-09-09 12:29:02-07:00,['f2d96437cc55a10caa4c9be6d0a6e62282db081a'],0,3,3,665557,3,,,,1469
272e64952ab05ec5ddb0a609e9ce165710a5f5b9,1,Jean-Daniel Cryans,2015-09-09 13:06:33-07:00,['ec621d20130fe2eb447c7504410593df9bd13b41'],30,49,79,665636,1,1,1,1,1469
4ccac1d7d6ce7ab0d92514298edb70fe79e9512d,0,Jean-Daniel Cryans,2015-09-09 13:06:46-07:00,['272e64952ab05ec5ddb0a609e9ce165710a5f5b9'],58,58,116,665752,4,,,,1469
35ed70d5802719bec9952b32f3af0b1248ee446e,0,David Alves,2015-09-09 13:42:41-07:00,['4ccac1d7d6ce7ab0d92514298edb70fe79e9512d'],1,1,2,665754,1,,,,1469
33ffdd4af4c743177facc3b1772d6affaff41a1e,0,David Alves,2015-09-09 13:43:39-07:00,['35ed70d5802719bec9952b32f3af0b1248ee446e'],20,101,121,665875,7,0.254901961,0.294117647,0.117647059,1469
7c61a013d0c108c450555cf59780c2f58793ea51,1,Todd Lipcon,2015-09-09 13:57:54-07:00,['33ffdd4af4c743177facc3b1772d6affaff41a1e'],22,88,110,665985,4,0,0.533333333,0.733333333,1469
02bf48ba417ed08cbfb59d13aefa28fed20cb2d8,0,Todd Lipcon,2015-09-09 16:26:50-07:00,['7c61a013d0c108c450555cf59780c2f58793ea51'],41,52,93,666078,1,,,,1469
4f598c02fb727ed09207e6d16a92a83ce5bb7576,0,Todd Lipcon,2015-09-09 16:57:53-07:00,['02bf48ba417ed08cbfb59d13aefa28fed20cb2d8'],36,35,71,666149,10,,,,1469
c94c708cbf0b9f43e432bcef5100fe8495224c2c,1,Todd Lipcon,2015-09-09 17:26:40-07:00,['4f598c02fb727ed09207e6d16a92a83ce5bb7576'],10,312,322,666471,85,,,,1469
84889281481a5fc160744a7c2e5595dd0e8f9161,0,Todd Lipcon,2015-09-09 17:26:46-07:00,['c94c708cbf0b9f43e432bcef5100fe8495224c2c'],38,240,278,666749,9,0.425742574,0.98019802,0.742574257,1470
de8061c177fe8196f0c5d547b89a3d153a046d59,0,Misty Stanley-Jones,2015-09-09 17:48:49-07:00,['84889281481a5fc160744a7c2e5595dd0e8f9161'],5,24,29,666778,1,,,,1470
b5abadbc8ed410cad6fa833713dab75da7a7c1ef,0,Jean-Daniel Cryans,2015-09-09 19:54:29-07:00,['de8061c177fe8196f0c5d547b89a3d153a046d59'],0,0,0,666778,2,,,,1471
af06c3290975353b18540b0c3544800879311a71,0,Todd Lipcon,2015-09-09 20:51:25-07:00,['b5abadbc8ed410cad6fa833713dab75da7a7c1ef'],1,21,22,666800,2,0,1,1,1471
321ebe418ac596fe89a654e4cc85e8e0d5c199de,1,Todd Lipcon,2015-09-10 15:34:04-07:00,['af06c3290975353b18540b0c3544800879311a71'],88,300,388,667188,66,1,1,1,1471
2a7261749bb7edce0e10271b336042737c3b319d,1,Todd Lipcon,2015-09-10 15:43:17-07:00,['321ebe418ac596fe89a654e4cc85e8e0d5c199de'],17,37,54,667242,7,1,1,1,1471
5edec4d79e587e2c306dc9ea8aa05a08cb39e924,0,Jean-Daniel Cryans,2015-09-10 15:43:50-07:00,['2a7261749bb7edce0e10271b336042737c3b319d'],4,1,5,667247,1,,,,1471
bada9e698a8e8fcbf1ef616191330e32148ec0b3,0,Jean-Daniel Cryans,2015-09-10 16:49:02-07:00,['5edec4d79e587e2c306dc9ea8aa05a08cb39e924'],0,30,30,667277,1,,,,1471
0a8bd13beee56e504322439b1911e48b19be24f1,0,Misty Stanley-Jones,2015-09-10 18:40:55-07:00,['bada9e698a8e8fcbf1ef616191330e32148ec0b3'],264,199,463,667740,19,,,,1472
d98314d8e0cf39639b9413603d377ecb0aeba2de,1,Jean-Daniel Cryans,2015-09-11 13:25:09-07:00,['0a8bd13beee56e504322439b1911e48b19be24f1'],66,72,138,667878,8,1,1,1,1472
9fa1baf7dc878d98f6093cda6bda2a575c2fc500,0,Jean-Daniel Cryans,2015-09-11 13:25:19-07:00,['d98314d8e0cf39639b9413603d377ecb0aeba2de'],8,5,13,667891,1,0,0,0,1472
40176dd158ecd0ff2cd217e05ace563f1d24549e,1,Todd Lipcon,2015-09-11 15:57:28-07:00,['9fa1baf7dc878d98f6093cda6bda2a575c2fc500'],44,147,191,668082,8,0.203389831,1,0,1472
9bf532ba78dfbb0d8cb6c9cb3434b756b784eabb,1,Todd Lipcon,2015-09-11 15:58:08-07:00,['40176dd158ecd0ff2cd217e05ace563f1d24549e'],107,142,249,668331,6,1,1,1,1472
d632dabbc928a80b88a78b257769e7d0427cdcb2,0,Todd Lipcon,2015-09-11 15:58:14-07:00,['9bf532ba78dfbb0d8cb6c9cb3434b756b784eabb'],14,12,26,668357,2,0,0,0,1472
2476bdcf6fc19522b94c8c60236a49944dec5414,0,Todd Lipcon,2015-09-11 15:58:17-07:00,['d632dabbc928a80b88a78b257769e7d0427cdcb2'],6,6,12,668369,3,,,,1472
063ef02e8f89fd8e35a40f6c7f9f2f49ec338af2,1,Todd Lipcon,2015-09-11 15:58:35-07:00,['2476bdcf6fc19522b94c8c60236a49944dec5414'],23,87,110,668479,3,0,1,1,1472
3269ffb7a71fff2d696a1d05097f043b4d529e8c,0,Michael Percy,2015-09-11 16:30:49-07:00,['063ef02e8f89fd8e35a40f6c7f9f2f49ec338af2'],0,1,1,668480,1,,,,1472
2345eec44b8b3d1fcd6a0aeacb2f056e73296948,0,Dan Burkert,2015-09-11 18:14:52-07:00,['3269ffb7a71fff2d696a1d05097f043b4d529e8c'],0,1,1,668481,1,1,1,1,1472
3721be1723f2402e5fe75898349a03d348ace7c1,1,Todd Lipcon,2015-09-12 17:32:27-07:00,['2345eec44b8b3d1fcd6a0aeacb2f056e73296948'],745,1894,2639,671120,79,0.478547855,0.504950495,0.823432343,1475
d6c328d06c42dff3237f937ae33aa9ca58d0b2cc,1,Todd Lipcon,2015-09-12 17:36:27-07:00,['3721be1723f2402e5fe75898349a03d348ace7c1'],11,545,556,671676,7,0.469964664,0.996466431,0.752650177,1476
688ae81bbf478736bfc2429139a864e1aeb08847,1,Todd Lipcon,2015-09-12 20:40:42-07:00,['d6c328d06c42dff3237f937ae33aa9ca58d0b2cc'],3,2,5,671681,1,,,,1476
b5cb38a006c209883234881812a73f2f63d8c634,1,Michael Percy,2015-09-13 13:53:44-07:00,['688ae81bbf478736bfc2429139a864e1aeb08847'],48,411,459,672140,11,0.005025126,0.572864322,0.557788945,1478
ef0fa3bcb502b0a483f02e6154c1e578e835159a,0,Jean-Daniel Cryans,2015-09-13 14:10:52-07:00,['b5cb38a006c209883234881812a73f2f63d8c634'],2,2,4,672144,1,,,,1478
c01823d7c2e0c801a3e5ff6756fe1976ab217a3b,0,Michael Percy,2015-09-13 16:28:59-07:00,['ef0fa3bcb502b0a483f02e6154c1e578e835159a'],1,1,2,672146,1,,,,1478
ebf25f6dcca56b8910d496d930f3b04d503796e1,1,Todd Lipcon,2015-09-13 17:30:21-07:00,['c01823d7c2e0c801a3e5ff6756fe1976ab217a3b'],68,304,372,672518,7,0.125,1,0.68125,1478
38f4bd2d131542f0512e6c56a04240ee8f298011,0,Todd Lipcon,2015-09-13 18:05:51-07:00,['ebf25f6dcca56b8910d496d930f3b04d503796e1'],24,11,35,672553,1,,,,1478
b9aec367adc9d3e6f3cd9ded669b12fac2c4868f,0,Todd Lipcon,2015-09-13 20:15:03-07:00,['38f4bd2d131542f0512e6c56a04240ee8f298011'],16,6,22,672575,1,0,0,0,1478
7ac4d0d6328282465da085d30b31281a43dd6d3f,0,Todd Lipcon,2015-09-13 20:15:07-07:00,['b9aec367adc9d3e6f3cd9ded669b12fac2c4868f'],0,40,40,672615,4,0,0.84375,0.75,1478
4a1c72017ce5f23d184542b463b6e5e2dcd9bdc7,1,Todd Lipcon,2015-09-13 21:02:21-07:00,['7ac4d0d6328282465da085d30b31281a43dd6d3f'],1,142,143,672758,7,0.086419753,0.555555556,0.481481481,1478
e6b7715a9e985d6adb5744a46597e06ce5812afc,0,Todd Lipcon,2015-09-13 21:02:32-07:00,['4a1c72017ce5f23d184542b463b6e5e2dcd9bdc7'],2,5,7,672765,1,0,1,0,1478
458685eef1279d806e95e15daeff77c3acf10ec2,0,Todd Lipcon,2015-09-13 21:02:35-07:00,['e6b7715a9e985d6adb5744a46597e06ce5812afc'],1,1,2,672767,1,,,,1478
2fa718f5a51b17df55e1c080a74739b7c8248e16,0,Misty Stanley-Jones,2015-09-13 21:48:12-07:00,['458685eef1279d806e95e15daeff77c3acf10ec2'],1,1,2,672769,1,,,,1478
9c3fc8fe6d40e7f6cfc6c6de4517e4acd25fa05d,0,Michael Percy,2015-09-13 21:50:47-07:00,['2fa718f5a51b17df55e1c080a74739b7c8248e16'],7,17,24,672793,1,1,1,1,1478
e0daf639cb1a92ee806393cf3c09561148435533,0,Michael Percy,2015-09-13 23:00:50-07:00,['9c3fc8fe6d40e7f6cfc6c6de4517e4acd25fa05d'],11,46,57,672850,1,,,,1478
f77be257f0ac5300487909c0aaee0b59e2650301,0,Michael Percy,2015-09-14 02:20:43-07:00,['e0daf639cb1a92ee806393cf3c09561148435533'],3,13,16,672866,2,0,1,1,1478
82ed752b39adb059f0ee7e280fad6d20ca35921e,0,Todd Lipcon,2015-09-14 03:01:20-07:00,['f77be257f0ac5300487909c0aaee0b59e2650301'],1,4,5,672871,1,,,,1478
f0f90fb134760d179d94cbd2ad7bd9aeab0f2fe8,1,Michael Percy,2015-09-14 04:16:56-07:00,['82ed752b39adb059f0ee7e280fad6d20ca35921e'],2,11,13,672884,1,0,1,1,1478
a9c313b3ee21ade6cfdd5523d31290ee890b402c,0,Todd Lipcon,2015-09-14 12:46:24-07:00,['f0f90fb134760d179d94cbd2ad7bd9aeab0f2fe8'],1,1,2,672886,1,,,,1478
93dd596b8394eb15e655bac2e54b3014083a7099,0,Todd Lipcon,2015-09-14 13:58:13-07:00,['a9c313b3ee21ade6cfdd5523d31290ee890b402c'],1,1,2,672888,1,,,,1478
55b32d1d347ab1dbbe2ce5afda2621e1e9ddea06,0,Todd Lipcon,2015-09-14 14:50:30-07:00,['93dd596b8394eb15e655bac2e54b3014083a7099'],15,108,123,673011,7,0,1,0.967213115,1478
1ed02e3ac836afa9456d28de619a5788555a6dac,0,Jean-Daniel Cryans,2015-09-15 09:12:29-07:00,['55b32d1d347ab1dbbe2ce5afda2621e1e9ddea06'],0,3,3,673014,1,,,,1478
ed277912037e01796341a49486600e60aa4c0687,0,Jean-Daniel Cryans,2015-09-15 09:14:33-07:00,['1ed02e3ac836afa9456d28de619a5788555a6dac'],0,5,5,673019,1,0,0,1,1478
8d62c00bd316916a0259db802df3fac088430a56,0,Todd Lipcon,2015-09-15 10:11:31-07:00,['ed277912037e01796341a49486600e60aa4c0687'],0,12,12,673031,3,0,1,0.125,1478
ce462bcf02cd9e17093ae09097f613f953613231,0,Jean-Daniel Cryans,2015-09-15 11:00:31-07:00,['8d62c00bd316916a0259db802df3fac088430a56'],1,1,2,673033,1,,,,1478
a6cb557af74b806a9092373a05dd7e7c70d66343,0,Dan Burkert,2015-09-15 15:02:10-07:00,['ce462bcf02cd9e17093ae09097f613f953613231'],1,6,7,673040,1,,,,1478
f8e4f946b4ef7b47a7e7352fff05adaba7318742,0,Michael Percy,2015-09-15 15:27:12-07:00,['a6cb557af74b806a9092373a05dd7e7c70d66343'],54,96,150,673190,23,0,0,0.277777778,1478
0b7a4fe82703535035146d821cb8183e5d1782fd,0,Michael Percy,2015-09-15 15:27:43-07:00,['f8e4f946b4ef7b47a7e7352fff05adaba7318742'],7,76,83,673273,4,0.25,0.96875,0.96875,1478
3afa488f604724f65c0b48b168a63884c6e17614,1,Misty Stanley-Jones,2015-09-15 15:48:31-07:00,['0b7a4fe82703535035146d821cb8183e5d1782fd'],0,399,399,673672,2,,,,1479
6c8fd9f733a47c04d00cbb9aec4a63307d060545,0,Misty Stanley-Jones,2015-09-15 15:48:51-07:00,['3afa488f604724f65c0b48b168a63884c6e17614'],3,25,28,673700,1,,,,1479
89609382eaecbaa78a40e11365aaeb6ed788e5a8,0,Todd Lipcon,2015-09-15 17:57:58-07:00,['6c8fd9f733a47c04d00cbb9aec4a63307d060545'],1,7,8,673708,1,0,1,1,1479
9f70edae82305e44a8340daa25cdb62384af9f16,0,Jean-Daniel Cryans,2015-09-15 18:46:34-07:00,['89609382eaecbaa78a40e11365aaeb6ed788e5a8'],1,23,24,673732,4,0.666666667,0.733333333,0.666666667,1479
0195d9bc9bce394d53bd15cece8410bad4be5c74,0,Jean-Daniel Cryans,2015-09-15 19:16:53-07:00,['9f70edae82305e44a8340daa25cdb62384af9f16'],1,8,9,673741,1,1,1,1,1479
b77ea4761e8885c07e021c1a65ef4827a8245a6f,0,Dan Burkert,2015-09-15 19:24:14-07:00,['0195d9bc9bce394d53bd15cece8410bad4be5c74'],9,4,13,673754,1,0,0,0,1479
9f5a391a997808fc64f3195aeda8ca987de2708a,1,Jean-Daniel Cryans,2015-09-15 19:35:07-07:00,['b77ea4761e8885c07e021c1a65ef4827a8245a6f'],10,96,106,673860,5,0,1,0.967213115,1479
86440ef3dcc95d7c902bd908a4e61cea05370d4a,0,Todd Lipcon,2015-09-16 00:43:31-07:00,['9f5a391a997808fc64f3195aeda8ca987de2708a'],2,67,69,673929,2,0,1,1,1479
0d64f8cb2c332bafa29f32861d249b5cc07d193a,0,Michael Percy,2015-09-16 00:44:41-07:00,['86440ef3dcc95d7c902bd908a4e61cea05370d4a'],6,15,21,673950,2,0,0,1,1479
2e1ebfe8fd0c32cbddbb077e211613aedd29ce9e,0,Jean-Daniel Cryans,2015-09-16 10:23:16-07:00,['0d64f8cb2c332bafa29f32861d249b5cc07d193a'],22,35,57,674007,8,,,,1479
ab26ac69e59840bf1e0f6eb6aeb3d011ef74b52a,0,Todd Lipcon,2015-09-16 12:16:18-07:00,['2e1ebfe8fd0c32cbddbb077e211613aedd29ce9e'],0,10,10,674017,2,0,1,1,1479
a143f5ba36fdee7a8a7769ccfe3c61244b8056c5,1,Jean-Daniel Cryans,2015-09-16 12:22:55-07:00,['ab26ac69e59840bf1e0f6eb6aeb3d011ef74b52a'],63,72,135,674152,4,0,1,1,1479
108abc3dbfeb73d0d021f8b22e232cafe101f75b,0,Todd Lipcon,2015-09-16 16:05:38-07:00,['a143f5ba36fdee7a8a7769ccfe3c61244b8056c5'],1,4,5,674157,1,1,1,1,1479
5ed73105bef4a43608f979ee0cf45ab8627369b4,1,Jean-Daniel Cryans,2015-09-16 19:33:24-07:00,['108abc3dbfeb73d0d021f8b22e232cafe101f75b'],2,42,44,674201,3,1,1,1,1479
810322d92a041b51b7f3a6eebdcbabf768ab249e,0,Michael Percy,2015-09-16 19:49:45-07:00,['5ed73105bef4a43608f979ee0cf45ab8627369b4'],1,1,2,674203,1,,,,1479
64e05b69ccfb58374f9c1faeaa5582e58ddf9aad,0,David Alves,2015-09-16 19:50:25-07:00,['810322d92a041b51b7f3a6eebdcbabf768ab249e'],0,6,6,674209,1,1,1,1,1479
fa908363962d1064b12f0f8cbda75ef3305af87f,0,David Alves,2015-09-16 19:51:23-07:00,['64e05b69ccfb58374f9c1faeaa5582e58ddf9aad'],1,1,2,674211,1,,,,1479
50f157d74734ec00abaeeda372faa5daf7c7ed56,0,David Alves,2015-09-16 19:52:28-07:00,['fa908363962d1064b12f0f8cbda75ef3305af87f'],1,12,13,674224,2,1,1,1,1479
e4e79ce72dbece3b83b99f3a6e3cca9721f8742b,1,Todd Lipcon,2015-09-16 23:46:05-07:00,['50f157d74734ec00abaeeda372faa5daf7c7ed56'],74,428,502,674726,16,0.283018868,0.787735849,0.849056604,1479
ed0fbc2705c631f4365505a7d90906ec21590cd6,1,Todd Lipcon,2015-09-17 14:30:02-07:00,['e4e79ce72dbece3b83b99f3a6e3cca9721f8742b'],22,5,27,674753,10,0.85,0.1,0.2,1479
5593779f6e52fd32aa05e362527e0f3c6339aac2,1,Michael Percy,2015-09-17 15:26:06-07:00,['ed0fbc2705c631f4365505a7d90906ec21590cd6'],32,49,81,674834,2,1,1,0,1479
4517691ee99e8eedbee15e006ecb3a489ea182a2,0,Jean-Daniel Cryans,2015-09-17 15:47:40-07:00,['5593779f6e52fd32aa05e362527e0f3c6339aac2'],91,135,226,675060,11,0.518518519,0.740740741,0.814814815,1479
f5a9d620d6fc2c793771b7a809895f31a6cde295,0,Jean-Daniel Cryans,2015-09-17 16:44:40-07:00,['4517691ee99e8eedbee15e006ecb3a489ea182a2'],36,36,72,675132,10,0,1,0,1479
ae5ca9fd55e7dbc359aaf3fbe24546af2c1cec69,0,Todd Lipcon,2015-09-17 20:16:41-07:00,['f5a9d620d6fc2c793771b7a809895f31a6cde295'],4,21,25,675157,2,0,0,1,1479
929391bef8134b2aca76bcd0af18c4148e42e33c,0,Misty Stanley-Jones,2015-09-17 21:08:11-07:00,['ae5ca9fd55e7dbc359aaf3fbe24546af2c1cec69'],1,6,7,675164,1,,,,1479
5016dcaabee205567cd1b6c37539976dd8bc6171,0,Todd Lipcon,2015-09-17 22:06:56-07:00,['929391bef8134b2aca76bcd0af18c4148e42e33c'],1,1,2,675166,1,,,,1479
1b78a7960616230f5cf77e3512cb7f9f34c45be8,1,Michael Percy,2015-09-18 12:41:57-07:00,['5016dcaabee205567cd1b6c37539976dd8bc6171'],3,41,44,675210,5,0.7,0.75,1,1479
152695ecf0a63652fb3ed4bea42a80941dfcdcc4,1,Jean-Daniel Cryans,2015-09-19 14:28:22-07:00,['1b78a7960616230f5cf77e3512cb7f9f34c45be8'],18,79,97,675307,3,0.1875,1,0.875,1479
125bc1520dc8bbd78ff1d9fa6519834db62c60fd,1,Todd Lipcon,2015-09-19 16:43:26-07:00,['152695ecf0a63652fb3ed4bea42a80941dfcdcc4'],5,146,151,675458,10,0.225,0.7625,0.8,1479
db1d40ffdfb75d67a340bae7066784d23bf66a9d,0,Todd Lipcon,2015-09-19 17:28:10-07:00,['125bc1520dc8bbd78ff1d9fa6519834db62c60fd'],0,57,57,675515,2,0.032258065,1,0.967741935,1479
ad67d34c2332a502d74dae8e24b3d7c66d9e536f,0,Todd Lipcon,2015-09-20 13:10:24-07:00,['db1d40ffdfb75d67a340bae7066784d23bf66a9d'],1,2,3,675518,1,1,1,0,1479
f6669e3899f426186a91b929bc176cb14fbbbd96,0,Todd Lipcon,2015-09-20 13:10:31-07:00,['ad67d34c2332a502d74dae8e24b3d7c66d9e536f'],1,4,5,675523,1,1,1,1,1479
46eed959e82ab6bcaab6bcedcb18fb52f541a2ad,0,Todd Lipcon,2015-09-20 14:30:08-07:00,['f6669e3899f426186a91b929bc176cb14fbbbd96'],20,45,65,675588,6,0,0.294117647,0,1479
eb7e30f214892e815de36b985885fcb0a37cb2d0,1,Todd Lipcon,2015-09-20 17:11:36-07:00,['46eed959e82ab6bcaab6bcedcb18fb52f541a2ad'],27,54,81,675669,2,0,0,1,1479
1d8a2f4941a4ec8935d0eebc2155638aec682038,0,Todd Lipcon,2015-09-20 17:29:27-07:00,['eb7e30f214892e815de36b985885fcb0a37cb2d0'],2,32,34,675703,2,,,,1479
ffe078ee79dba23b3c59348e38113b366f03f521,1,Todd Lipcon,2015-09-20 17:54:13-07:00,['1d8a2f4941a4ec8935d0eebc2155638aec682038'],74,121,195,675898,7,0.827586207,0.586206897,0.793103448,1479
ba9c6e66c797349165c6e8bbb40311d3b28a6e9e,0,Michael Percy,2015-09-20 19:30:04-07:00,['ffe078ee79dba23b3c59348e38113b366f03f521'],2,14,16,675914,1,0,1,1,1479
d89ec6341d5458338e9aa11cb0ac036291e47c38,0,Todd Lipcon,2015-09-20 21:45:09-07:00,['ba9c6e66c797349165c6e8bbb40311d3b28a6e9e'],26,57,83,675997,3,1,1,0.769230769,1479
af8e6dbef3c32a50270bb9a42799fd6f7eca5855,0,Todd Lipcon,2015-09-20 22:21:30-07:00,['d89ec6341d5458338e9aa11cb0ac036291e47c38'],0,204,204,676201,2,,,,1480
dd5637cf7b3b14c056020d58fe6887d4cf4fe6bb,1,Todd Lipcon,2015-09-20 23:19:38-07:00,['af8e6dbef3c32a50270bb9a42799fd6f7eca5855'],38,128,166,676367,9,0,0.659090909,0.772727273,1480
91c3690f297fff494d359f1598e7b2fe4d72d97e,1,David Alves,2015-09-21 11:58:42-07:00,['dd5637cf7b3b14c056020d58fe6887d4cf4fe6bb'],27,41,68,676435,4,1,0,1,1480
39fd93774febed6a186bf82eca41bb7e4ebb6659,1,Todd Lipcon,2015-09-21 16:14:25-07:00,['91c3690f297fff494d359f1598e7b2fe4d72d97e'],0,19,19,676454,2,0,0,0.5,1480
2300004a210bf22530915c6f4275455f3c4b12c2,0,Michael Percy,2015-09-21 18:38:55-07:00,['39fd93774febed6a186bf82eca41bb7e4ebb6659'],12,79,91,676545,8,0.064516129,0.709677419,0.677419355,1480
29b285664d31d5406f389337f67e6260d3a9f35a,0,Misty Stanley-Jones,2015-09-21 20:46:04-07:00,['2300004a210bf22530915c6f4275455f3c4b12c2'],0,9,9,676554,1,,,,1480
e1cec14b928348e7b953a56cb5ef8c466bf3a9d5,0,Todd Lipcon,2015-09-22 00:53:39-07:00,['29b285664d31d5406f389337f67e6260d3a9f35a'],7,19,26,676580,3,1,1,1,1480
b28d0f39f8f50290f1df00baf4a53dee04833e1d,0,Jean-Daniel Cryans,2015-09-22 10:10:02-07:00,['e1cec14b928348e7b953a56cb5ef8c466bf3a9d5'],2,221,223,676803,2,,,,1481
41b787da0fc047be66ae8f945db3c026637e9416,0,David Alves,2015-09-22 14:09:26-07:00,['b28d0f39f8f50290f1df00baf4a53dee04833e1d'],3,32,35,676838,2,0.727272727,0.727272727,1,1481
0bd7acb9c08007a876932fb519cdc976da76ed31,0,Todd Lipcon,2015-09-22 17:23:51-07:00,['41b787da0fc047be66ae8f945db3c026637e9416'],12,12,24,676862,10,,,,1481
8f7950d41a754392b1eea4db43b4ec6604d609d5,0,Dan Burkert,2015-09-22 17:37:43-07:00,['0bd7acb9c08007a876932fb519cdc976da76ed31'],18,15,33,676895,2,,,,1481
691f6e985113810a7173f76bfdfffea5f16a6177,0,Todd Lipcon,2015-09-22 18:02:13-07:00,['8f7950d41a754392b1eea4db43b4ec6604d609d5'],12,12,24,676919,4,,,,1481
71bb20d05fc47e6f96fc36ae7a086c3aca837b83,0,Jean-Daniel Cryans,2015-09-22 18:45:47-07:00,['691f6e985113810a7173f76bfdfffea5f16a6177'],1,1,2,676921,1,,,,1481
d53512f76ff75e8b88de66940fa1da26dcd76497,0,Jean-Daniel Cryans,2015-09-22 20:28:16-07:00,['71bb20d05fc47e6f96fc36ae7a086c3aca837b83'],27,20,47,676968,2,,,,1481
ec31c9db788ccd2c9a2da2aa6d2ea8461a019845,0,Jean-Daniel Cryans,2015-09-23 11:28:15-07:00,['d53512f76ff75e8b88de66940fa1da26dcd76497'],1,1,2,676970,1,,,,1481
495f2be1340748639f621b45e2df95d6ffa2b076,0,Jean-Daniel Cryans,2015-09-23 11:35:58-07:00,['ec31c9db788ccd2c9a2da2aa6d2ea8461a019845'],1,1,2,676972,1,,,,1481
5e81e77507c46bc88660dc25fb3c1ed921dc6775,0,Todd Lipcon,2015-09-23 11:40:23-07:00,['495f2be1340748639f621b45e2df95d6ffa2b076'],14,15,29,677001,3,,,,1481
ee84759e6d58decaaccdf312c6c7db0c36639f68,1,Todd Lipcon,2015-09-23 11:41:21-07:00,['5e81e77507c46bc88660dc25fb3c1ed921dc6775'],66,214,280,677281,10,0,0.959459459,0.540540541,1482
ccf1f207565595145c00f277aa008674a428e8db,0,Todd Lipcon,2015-09-23 12:56:42-07:00,['ee84759e6d58decaaccdf312c6c7db0c36639f68'],3,232,235,677516,1,,,,1482
f069be2dda62af1127d53be0c82bfdd2d11297d9,0,Dan Burkert,2015-09-23 16:26:37-07:00,['ccf1f207565595145c00f277aa008674a428e8db'],19,59,78,677594,4,0,0,0.171428571,1482
28cf37b3b757b1c6ea3ded351c17c89b60123681,0,Jean-Daniel Cryans,2015-09-23 16:36:43-07:00,['f069be2dda62af1127d53be0c82bfdd2d11297d9'],4,4,8,677602,1,,,,1482
ab5966227b0494298849f081a249544f24aed915,1,Dan Burkert,2015-09-23 16:50:05-07:00,['28cf37b3b757b1c6ea3ded351c17c89b60123681'],5,88,93,677695,4,0,0.615384615,0.653846154,1482
9f71d86c1145ef141428e30ab15dfc92864970f0,0,Martin Grund,2015-09-23 17:17:34-07:00,['aa6f3e3d55544896c96013f36ad436fd441338cf'],3,3,6,677701,2,,,,1482
83c93360422615f9386d8cb70b42140915fa7610,0,Michael Percy,2015-09-23 17:38:14-07:00,['ab5966227b0494298849f081a249544f24aed915'],4,4,8,677709,1,,,,1482
0f02d17b7535d9d7c2963243906ccde357216e96,0,jdcryans,2015-09-23 17:50:40-07:00,"['aa6f3e3d55544896c96013f36ad436fd441338cf', '9f71d86c1145ef141428e30ab15dfc92864970f0']",3,3,6,677715,2,,,,1482
444c6412e1eac493e08b2724207ab50604ce49f3,0,Misty Stanley-Jones,2015-09-24 11:34:39+10:00,['0f02d17b7535d9d7c2963243906ccde357216e96'],10,17,27,677742,1,,,,1482
11be149cbfe8e100d6939ea988310def9a900dff,0,jdcryans,2015-09-23 18:52:14-07:00,"['0f02d17b7535d9d7c2963243906ccde357216e96', '444c6412e1eac493e08b2724207ab50604ce49f3']",10,17,27,677769,1,,,,1482
575adbc1e743e14a77261d0e16cce916cb005114,0,David Alves,2015-09-23 19:53:27-07:00,['83c93360422615f9386d8cb70b42140915fa7610'],2,4,6,677775,2,0.5,1,1,1482
c6c409d036d47a29007985e1a0920474e285d6af,1,Misty Stanley-Jones,2015-09-24 00:57:51-07:00,['575adbc1e743e14a77261d0e16cce916cb005114'],15,227,242,678017,1,,,,1482
89d2cf6fc8a38f1baf160f469334621336eb4728,0,Todd Lipcon,2015-09-24 09:57:22-07:00,['c6c409d036d47a29007985e1a0920474e285d6af'],9,212,221,678238,2,,,,1483
9d25ab4dac842f228b8fbc258af2054e74a63512,0,Todd Lipcon,2015-09-24 09:57:39-07:00,['89d2cf6fc8a38f1baf160f469334621336eb4728'],2112,13320,15432,693670,1025,,,,1483
5c3078eb26cab915474a3ebc3357b7d11a872c39,0,Todd Lipcon,2015-09-24 09:58:20-07:00,['9d25ab4dac842f228b8fbc258af2054e74a63512'],130,90,220,693890,64,,,,1483
bf0d3079997375ee43ece00b072483d377cca82d,0,Todd Lipcon,2015-09-24 09:58:30-07:00,['5c3078eb26cab915474a3ebc3357b7d11a872c39'],0,284,284,694174,18,,,,1483
6bee7c864f4fd2024e0b419ef71fa1dbbe54d567,0,Jean-Daniel Cryans,2015-09-24 13:09:46-07:00,['bf0d3079997375ee43ece00b072483d377cca82d'],2,2,4,694178,1,,,,1483
ec8b05b171f16511e9c65d1a70b66090f757e9c9,0,Martin Grund,2015-09-24 13:18:44-07:00,['9f71d86c1145ef141428e30ab15dfc92864970f0'],14,10,24,694202,1,,,,1483
014e7ef48fcaef1a6c07e2b173334f02dde0086c,0,jdcryans,2015-09-24 13:20:16-07:00,"['11be149cbfe8e100d6939ea988310def9a900dff', 'ec8b05b171f16511e9c65d1a70b66090f757e9c9']",14,10,24,694226,1,,,,1483
24aa78ff3730fd5704b21f9cd87c0d85a472305c,1,Jean-Daniel Cryans,2015-09-24 14:36:39-07:00,['6bee7c864f4fd2024e0b419ef71fa1dbbe54d567'],269,95,364,694590,8,,,,1483
b894aea04368d4774a43f98f284fef4c5bf7a7ff,0,Martin Grund,2015-09-24 14:39:22-07:00,['ec8b05b171f16511e9c65d1a70b66090f757e9c9'],37,89,126,694716,5,0,1,1,1483
401602477e62d331ccfa7d4b2a63ae56653dae54,0,jdcryans,2015-09-24 14:46:08-07:00,"['014e7ef48fcaef1a6c07e2b173334f02dde0086c', 'b894aea04368d4774a43f98f284fef4c5bf7a7ff']",37,89,126,694842,5,,,,1483
1534dbd9578ff26994ef3c1193ac74c15a87e31a,0,Todd Lipcon,2015-09-24 14:59:42-07:00,['24aa78ff3730fd5704b21f9cd87c0d85a472305c'],15,0,15,694857,1,,,,1483
0cc0b46e5161226c60c9e0b54e0fd4373caa3592,0,Todd Lipcon,2015-09-24 15:16:45-07:00,['1534dbd9578ff26994ef3c1193ac74c15a87e31a'],1,16,17,694874,1,,,,1483
778548e4a9357810ef3e16667f7a696d48877be5,0,Misty Stanley-Jones,2015-09-24 16:57:28-07:00,['0cc0b46e5161226c60c9e0b54e0fd4373caa3592'],0,17,17,694891,1,,,,1483
0a6a0e6cf7bf7b059fe73c86e1f8447b5f67f1e6,0,Todd Lipcon,2015-09-24 17:24:00-07:00,['778548e4a9357810ef3e16667f7a696d48877be5'],14,14,28,694919,1,,,,1483
0efe1e9edf784bbd5a8b6fd653c708bf44752826,0,Dan Burkert,2015-09-24 18:07:44-07:00,['0a6a0e6cf7bf7b059fe73c86e1f8447b5f67f1e6'],11,19,30,694949,3,0.5,1,1,1483
17e56c3ee0e8d87c463ff1874e44441b47fcfa33,0,Todd Lipcon,2015-09-24 18:10:40-07:00,['0efe1e9edf784bbd5a8b6fd653c708bf44752826'],10,10,20,694969,9,,,,1483
5c43f0029275ed41a32e40aae4d84c87ad6ad0c5,0,Todd Lipcon,2015-09-24 18:55:18-07:00,['17e56c3ee0e8d87c463ff1874e44441b47fcfa33'],0,4,4,694973,1,,,,1483
88d128f2762d38f40ce55e900e792645e9b8feb0,0,Todd Lipcon,2015-09-24 18:55:49-07:00,['5c43f0029275ed41a32e40aae4d84c87ad6ad0c5'],10,2,12,694985,1,,,,1483
ef5a5a59265cffc977aaf704fe083a479695c218,0,Todd Lipcon,2015-09-24 21:15:11-07:00,['88d128f2762d38f40ce55e900e792645e9b8feb0'],10,272,282,695267,3,,,,1483
8d83a914dcc77241ce712aa77e42e223e272cf85,0,Michael Percy,2015-09-24 22:24:21-07:00,['ef5a5a59265cffc977aaf704fe083a479695c218'],3,2,5,695272,2,,,,1483
88da8a6f3835758334d54bb9aef91b09eb0a6066,0,Michael Percy,2015-09-24 22:27:53-07:00,['8d83a914dcc77241ce712aa77e42e223e272cf85'],3,1,4,695276,1,,,,1483
f72f288eedefde34f894f925b1ea8b327891ace2,0,Todd Lipcon,2015-09-24 23:53:32-07:00,['88da8a6f3835758334d54bb9aef91b09eb0a6066'],4,4,8,695284,4,,,,1483
fca287be555127c6044cf83123c5c7909bec8047,0,Todd Lipcon,2015-09-25 13:36:48-07:00,['f72f288eedefde34f894f925b1ea8b327891ace2'],13,66,79,695363,1,,,,1483
62102ce67fe088a97f5862f53cc28ab86291c78b,1,David Alves,2015-09-25 16:05:45-07:00,['fca287be555127c6044cf83123c5c7909bec8047'],2,2,4,695367,1,,,,1483
fa0f1c6e60881c3d356412db2d1082799cd9f1d4,0,Todd Lipcon,2015-09-25 23:24:43+00:00,['62102ce67fe088a97f5862f53cc28ab86291c78b'],2,1,3,695370,1,,,,1483
8fa3ca9b90f191d04e6c5ff225196ab41d834fd5,0,Mike Percy,2015-09-26 08:14:13+00:00,['fa0f1c6e60881c3d356412db2d1082799cd9f1d4'],4,4,8,695378,1,,,,1483
87a29ef290e70708b8dc4f7a47cfc6881af99ddd,0,Todd Lipcon,2015-09-26 12:12:59+00:00,['8fa3ca9b90f191d04e6c5ff225196ab41d834fd5'],1,1,2,695380,1,,,,1483
5d2109b27d00ad5063d5d666df09052193e37643,0,Todd Lipcon,2015-09-26 12:17:28+00:00,['87a29ef290e70708b8dc4f7a47cfc6881af99ddd'],1,8,9,695389,2,0.666666667,1,1,1483
1915a272926d4a2c755964ae617f6ce1cfe1c2aa,0,Mike Percy,2015-09-26 21:39:55+00:00,['5d2109b27d00ad5063d5d666df09052193e37643'],3,4,7,695396,1,,,,1483
7ce36ed83908a6c3e05e683332f1c3fb205cfac3,0,Todd Lipcon,2015-09-26 22:48:45+00:00,['1915a272926d4a2c755964ae617f6ce1cfe1c2aa'],0,15,15,695411,3,0.571428571,1,1,1483
1b2b8b7d2f41016cd034dc590afef04ccfc59429,0,David Ribeiro Alves,2015-09-26 23:07:06+00:00,['7ce36ed83908a6c3e05e683332f1c3fb205cfac3'],0,240,240,695651,1,,,,1484
6f3a017ddd16cc72a978a9bef0f3a9a8c6f7485b,0,Misty Stanley-Jones,2015-09-26 23:55:51+00:00,['1b2b8b7d2f41016cd034dc590afef04ccfc59429'],0,6921,6921,702572,5,,,,1489
214ef1e2aec79e8b86b6165d4fbd2b2f47d40503,0,Misty Stanley-Jones,2015-09-27 01:50:57+00:00,['6f3a017ddd16cc72a978a9bef0f3a9a8c6f7485b'],0,3,3,702575,1,,,,1489
aef66f483ab28049165eb6e129a0b88aa64ccd14,0,David Ribeiro Alves,2015-09-27 03:37:52+00:00,['214ef1e2aec79e8b86b6165d4fbd2b2f47d40503'],1,48,49,702624,1,,,,1489
426e4914bd359f7e9f842fdb97eba899d29d7872,1,Misty Stanley-Jones,2015-09-27 05:13:40+00:00,['aef66f483ab28049165eb6e129a0b88aa64ccd14'],11,220,231,702855,1,,,,1489
c40c4b857ede956bdc9a6c7423fa85c21cb6e2fc,0,David Alves,2015-09-27 11:23:53-07:00,['401602477e62d331ccfa7d4b2a63ae56653dae54'],2,2,4,702859,2,,,,1489
43c59d3672336b7c3a3053232556fbf205eddece,0,jdcryans,2015-09-27 14:28:32-04:00,"['401602477e62d331ccfa7d4b2a63ae56653dae54', 'c40c4b857ede956bdc9a6c7423fa85c21cb6e2fc']",2,2,4,702863,2,,,,1489
19b4c60897167ad01cb2865a3cd873e4848d74c7,0,David Ribeiro Alves,2015-09-27 18:33:15+00:00,['426e4914bd359f7e9f842fdb97eba899d29d7872'],5,5,10,702873,1,,,,1489
f93cba28bfb56179f3c93313269e247dec9e88a5,0,Dan Burkert,2015-09-27 12:29:58-07:00,['43c59d3672336b7c3a3053232556fbf205eddece'],6,6,12,702885,2,,,,1489
e45733c521d0950f008917579791db41ba6a62eb,0,jdcryans,2015-09-27 15:40:16-04:00,"['43c59d3672336b7c3a3053232556fbf205eddece', 'f93cba28bfb56179f3c93313269e247dec9e88a5']",6,6,12,702897,2,,,,1489
6accfd9a2d46f922c53e4c39854d6c1f66648d82,0,Todd Lipcon,2015-09-27 20:30:45+00:00,['19b4c60897167ad01cb2865a3cd873e4848d74c7'],2,14,16,702913,1,,,,1489
1928a41c5e6713c259c964dc4e39e6d4df29ff29,0,Mike Percy,2015-09-27 21:12:21+00:00,['6accfd9a2d46f922c53e4c39854d6c1f66648d82'],0,127,127,703040,1,0.767123288,1,1,1490
0dd20320c48e9c2dc5df719885a0abd67e42d84a,0,Martin Grund,2015-09-27 14:22:26-07:00,['e45733c521d0950f008917579791db41ba6a62eb'],4,4,8,703048,3,,,,1490
8aa7d06e9837f499d7a7868e38e95db40f836a14,0,jdcryans,2015-09-27 17:28:35-04:00,"['e45733c521d0950f008917579791db41ba6a62eb', '0dd20320c48e9c2dc5df719885a0abd67e42d84a']",4,4,8,703056,3,,,,1490
afc5f1a8222095911a8394b944ef6d8f9d9f7eb3,0,Martin Grund,2015-09-27 14:30:56-07:00,['0dd20320c48e9c2dc5df719885a0abd67e42d84a'],2,3,5,703061,2,,,,1490
aefb1abf0a70f5a1038309a7817e1821ec0908b9,0,jdcryans,2015-09-27 17:32:17-04:00,"['8aa7d06e9837f499d7a7868e38e95db40f836a14', 'afc5f1a8222095911a8394b944ef6d8f9d9f7eb3']",2,3,5,703066,2,,,,1490
6bda4dfbecb9056a7c857de5ed1ecac193ad4990,0,Mike Percy,2015-09-27 21:56:05+00:00,['1928a41c5e6713c259c964dc4e39e6d4df29ff29'],1,13,14,703080,3,,,,1491
e4fc37ac129de39a3f3f5855d2c750093d1b0e39,0,Mike Percy,2015-09-27 18:39:43-04:00,['aefb1abf0a70f5a1038309a7817e1821ec0908b9'],25,36,61,703141,3,1,1,0,1491
e8065efc54e29c4c34cff77d08344c5bb7c8959a,0,Mike Percy,2015-09-27 21:36:39-04:00,['e4fc37ac129de39a3f3f5855d2c750093d1b0e39'],27,29,56,703197,1,,,,1491
0a66e237b7f4d3c04c627e62a629fcde8eb108e1,0,Mike Percy,2015-09-27 21:56:16-04:00,['e8065efc54e29c4c34cff77d08344c5bb7c8959a'],1,19,20,703217,3,,,,1491
aac4a91e8f891f34c06bf0ab539ff113207a184b,0,jdcryans,2015-09-27 22:11:12-04:00,"['aefb1abf0a70f5a1038309a7817e1821ec0908b9', '0a66e237b7f4d3c04c627e62a629fcde8eb108e1']",53,84,137,703354,5,,,,1491
4cc7cac7325d0bec2c78ac217cc443401def1257,0,Todd Lipcon,2015-09-28 02:40:21+00:00,['6bda4dfbecb9056a7c857de5ed1ecac193ad4990'],0,3006,3006,706360,5,,,,1496
5cbd589309d84fef5ba9a2713effe7b8f2db1f09,1,Todd Lipcon,2015-09-28 02:40:39+00:00,['4cc7cac7325d0bec2c78ac217cc443401def1257'],273,339,612,706972,13,,,,1496
75b08098e9449f6f5f3f162aa944783cfe10d681,0,David Alves,2015-09-27 19:41:23-07:00,['aac4a91e8f891f34c06bf0ab539ff113207a184b'],12,18,30,707002,1,0.666666667,0.666666667,1,1496
88f3be4d825cbec6ef360d7787a624de11055f88,0,Todd Lipcon,2015-09-28 02:42:40+00:00,['5cbd589309d84fef5ba9a2713effe7b8f2db1f09'],0,1745,1745,708747,27,,,,1523
25a123c0ef441097c1ed6860e46a7cc41b1ee2df,0,jdcryans,2015-09-27 22:46:48-04:00,"['aac4a91e8f891f34c06bf0ab539ff113207a184b', '75b08098e9449f6f5f3f162aa944783cfe10d681']",12,18,30,708777,1,,,,1523
d66973fc4a5ef41b40858f79fad9b20695163218,0,Todd Lipcon,2015-09-28 03:25:22+00:00,['88f3be4d825cbec6ef360d7787a624de11055f88'],13,3,16,708793,1,,,,1523
4e24b88ebd81b832aab902198b7f377f9cb066b8,1,Misty Stanley-Jones,2015-09-28 03:29:47+00:00,['d66973fc4a5ef41b40858f79fad9b20695163218'],33,1,34,708827,3,,,,1523
c5cfe17f421648a26241d39c7a67df9429870e78,0,Mike Percy,2015-09-27 23:38:57-04:00,['0a66e237b7f4d3c04c627e62a629fcde8eb108e1'],4,2,6,708833,2,,,,1523
4de32011fbb3a759ec95fb2fc6ce25a9e66a477d,0,David Ribeiro Alves,2015-09-27 20:49:20-07:00,"['25a123c0ef441097c1ed6860e46a7cc41b1ee2df', 'c5cfe17f421648a26241d39c7a67df9429870e78']",4,2,6,708839,2,,,,1523
1bd473de49d9c0b7e9f7b1e9289169c25260fd14,0,Todd Lipcon,2015-09-28 04:33:15+00:00,['4e24b88ebd81b832aab902198b7f377f9cb066b8'],2,1,3,708842,1,,,,1523
bffa881425f3c78d67822da33086645aa8c8091d,0,Todd Lipcon,2015-09-28 04:58:10+00:00,['1bd473de49d9c0b7e9f7b1e9289169c25260fd14'],0,3,3,708845,1,,,,1523
63bf6f129e9383519646563721933771a7e7199e,0,Todd Lipcon,2015-09-28 13:20:53+00:00,['bffa881425f3c78d67822da33086645aa8c8091d'],3,3,6,708851,1,,,,1523
d4cc274a81a79d46b6dc6d380fdb0459d23eb65e,0,Todd Lipcon,2015-09-28 21:01:06+00:00,['63bf6f129e9383519646563721933771a7e7199e'],1,0,1,708852,1,,,,1523
9cf4b62377a56494e40bccbe55d52e99f5bd76df,1,Todd Lipcon,2015-09-28 21:41:52+00:00,['d4cc274a81a79d46b6dc6d380fdb0459d23eb65e'],4,4,8,708860,1,,,,1523
7cb990a29fd40c7accedeaa94ada720842954a9a,0,Misty Stanley-Jones,2015-09-28 23:32:27+00:00,['9cf4b62377a56494e40bccbe55d52e99f5bd76df'],0,4,4,708864,1,,,,1523
23b64cfd35d728d0793ca7e3ced345da9027d0f9,0,Jean-Daniel Cryans,2015-09-29 17:11:48+00:00,['7cb990a29fd40c7accedeaa94ada720842954a9a'],1,1,2,708866,1,,,,1523
cc62cbcf6f6943eec1d3ddd7f69ea3d8f69c1164,0,Jean-Daniel Cryans,2015-09-29 18:48:36+00:00,['23b64cfd35d728d0793ca7e3ced345da9027d0f9'],119,0,119,708985,4,,,,1523
7ab690f442cb3a2aaf24562d8474a36f0ca03d4d,0,Jean-Daniel Cryans,2015-09-29 19:01:23+00:00,['cc62cbcf6f6943eec1d3ddd7f69ea3d8f69c1164'],20,31,51,709036,2,,,,1523
5b4d63029fb29b16c9115929430ee4ff4d13909c,0,Jean-Daniel Cryans,2015-09-29 19:02:04+00:00,['7ab690f442cb3a2aaf24562d8474a36f0ca03d4d'],2,8,10,709046,1,,,,1523
6550fde40624f6ba6b83d0b53a39edd004afc393,1,Jean-Daniel Cryans,2015-09-29 19:04:20+00:00,['5b4d63029fb29b16c9115929430ee4ff4d13909c'],10,14,24,709070,1,,,,1523
1ba9de5b7b53c6f2c51ac2f9c0a69716b5833ae2,0,Todd Lipcon,2015-09-30 03:25:10+00:00,['6550fde40624f6ba6b83d0b53a39edd004afc393'],4,4,8,709078,2,,,,1523
d758a2db59e6c50f52cb6c39a092229c7272fdef,1,Todd Lipcon,2015-09-30 03:25:47+00:00,['1ba9de5b7b53c6f2c51ac2f9c0a69716b5833ae2'],5,3,8,709086,1,,,,1523
f219fbd3269cd623336b329fe3c4c528b8d86c8c,0,Todd Lipcon,2015-09-30 03:26:14+00:00,['d758a2db59e6c50f52cb6c39a092229c7272fdef'],2,2,4,709090,1,,,,1523
89d3a375b9e9c38d95b21ca15db1e6c380974e31,0,Todd Lipcon,2015-09-30 04:56:11+00:00,['f219fbd3269cd623336b329fe3c4c528b8d86c8c'],2,13,15,709105,1,,,,1523
6e6be4af952fcfb75269ad362eba317965e90455,0,Jean-Daniel Cryans,2015-10-01 19:12:31+00:00,['89d3a375b9e9c38d95b21ca15db1e6c380974e31'],1,1,2,709107,1,,,,1523
e35b2eba7bac8ba1a0140be4f8a5ccc178d731b7,0,Todd Lipcon,2015-10-05 23:18:41+00:00,['6e6be4af952fcfb75269ad362eba317965e90455'],109,18,127,709234,6,0,0,0.684210526,1523
21dc41eb0d7bd54bb1a5b989208192ea00822b50,0,Misty Stanley-Jones,2015-10-06 04:28:03+00:00,['e35b2eba7bac8ba1a0140be4f8a5ccc178d731b7'],70,7,77,709311,1,,,,1523
9dbe0d0b61d2e574ff2c26c5e7d480f226fc995d,0,David Ribeiro Alves,2015-10-06 21:17:19+00:00,['21dc41eb0d7bd54bb1a5b989208192ea00822b50'],6,6,12,709323,1,,,,1523
c13c87d87daffe289a8e3902dd12e46a0b7f306f,0,Dan Burkert,2015-10-06 23:39:12+00:00,['9dbe0d0b61d2e574ff2c26c5e7d480f226fc995d'],33,166,199,709522,14,0.660714286,1,1,1523
8ecb9cf2a6515927285768b6c3bc4420c22655b6,1,Misty Stanley-Jones,2015-10-07 00:34:58+00:00,['c13c87d87daffe289a8e3902dd12e46a0b7f306f'],2,6,8,709530,1,,,,1523
3059c5b7b91c6e4ff1199ca57e77c13854af0eed,0,Todd Lipcon,2015-10-08 01:24:57+00:00,['8ecb9cf2a6515927285768b6c3bc4420c22655b6'],1,2,3,709533,1,,,,1523
55ad648af30d79af645a0f946b9934964e44f399,0,Todd Lipcon,2015-10-08 01:25:29+00:00,['3059c5b7b91c6e4ff1199ca57e77c13854af0eed'],1,8,9,709542,1,0,0,1,1523
5f1b83e45c7917d4607cbc01815e36fc17a16605,1,Todd Lipcon,2015-10-08 02:21:13+00:00,['55ad648af30d79af645a0f946b9934964e44f399'],0,30,30,709572,1,,,,1523
571289d2286f6e3c8c47a008f2f0b289a12b87fe,0,Misty Stanley-Jones,2015-10-09 00:40:19+00:00,['5f1b83e45c7917d4607cbc01815e36fc17a16605'],1,1,2,709574,1,,,,1523
fa389698a23bd07238cb4c9029acdeef82b6e35b,0,Todd Lipcon,2015-10-12 04:27:25+00:00,['571289d2286f6e3c8c47a008f2f0b289a12b87fe'],3,8,11,709585,1,0,1,1,1523
dc469896db7514af8d12d93e6b5c5b04f6a79558,0,Misty Stanley-Jones,2015-10-15 04:35:45+00:00,['fa389698a23bd07238cb4c9029acdeef82b6e35b'],7,15,22,709607,1,,,,1523
32bc2dcee3c28b76943d5bf03d3e94634773c708,1,Dan Burkert,2015-10-15 19:25:07+00:00,['dc469896db7514af8d12d93e6b5c5b04f6a79558'],40,69,109,709716,3,1,1,1,1523
888ec3abc2731e82bc749e83f8150b294be88ff5,0,Dan Burkert,2015-10-15 22:24:08+00:00,['32bc2dcee3c28b76943d5bf03d3e94634773c708'],91,91,182,709898,5,1,0,0,1525
1d8f3b6f98f1bf564a18214d60dacdd02e3d5573,0,Misty Stanley-Jones,2015-10-16 00:47:01+00:00,['888ec3abc2731e82bc749e83f8150b294be88ff5'],2,112,114,710012,1,,,,1525
a315058ad58542d4de6b343034965e6d2942b82e,0,Jean-Daniel Cryans,2015-10-16 16:09:38+00:00,['1d8f3b6f98f1bf564a18214d60dacdd02e3d5573'],1,22,23,710035,4,0.166666667,1,0.416666667,1525
9f3f31ae2ee26b62f5a553ab9aaba97b8325c024,0,Misty Stanley-Jones,2015-10-19 01:24:38+00:00,['a315058ad58542d4de6b343034965e6d2942b82e'],0,13,13,710048,1,,,,1525
73fbe5e9f1bd4deaa32a86a8fc0b01217260ef17,0,Jean-Daniel Cryans,2015-10-20 15:31:53+00:00,['9f3f31ae2ee26b62f5a553ab9aaba97b8325c024'],1,4,5,710053,1,0,1,1,1525
9325a71f3f66c6a574046489a28a3e711b34fec4,1,Jean-Daniel Cryans,2015-10-20 15:46:13+00:00,['73fbe5e9f1bd4deaa32a86a8fc0b01217260ef17'],3,16,19,710072,3,0,1,1,1525
24bfdd287b0c948abef565b774a1d6d67f89350d,0,Mike Percy,2015-10-21 02:41:20+00:00,['9325a71f3f66c6a574046489a28a3e711b34fec4'],0,2,2,710074,1,,,,1525
54d795c2759cc952728bbe0e3585aed84d81cad5,1,Todd Lipcon,2015-10-21 08:10:57+00:00,['24bfdd287b0c948abef565b774a1d6d67f89350d'],87,436,523,710597,28,0.426573427,0.426573427,0.811188811,1526
ab7089a32c5d119c8fc39be736d526182da5f87d,1,Todd Lipcon,2015-10-21 08:12:49+00:00,['54d795c2759cc952728bbe0e3585aed84d81cad5'],11,13,24,710621,2,1,1,1,1526
e31a0dcb805a214cdcf0281a0850ae3a9b95b871,0,Mike Percy,2015-10-21 17:53:08+00:00,['ab7089a32c5d119c8fc39be736d526182da5f87d'],6,7,13,710634,2,,,,1526
307faf259239864659f2fef79e82679c7931702c,1,Dan Burkert,2015-10-21 19:22:14+00:00,['e31a0dcb805a214cdcf0281a0850ae3a9b95b871'],52,93,145,710779,31,0,0,1,1526
879cd9ab7e55f70c00851e45b6682870bab9f4b1,1,Todd Lipcon,2015-10-21 22:16:13+00:00,['307faf259239864659f2fef79e82679c7931702c'],10,30,40,710819,5,1,1,1,1526
3d312af4c42e334e373458f27efa46555382fa85,0,Todd Lipcon,2015-10-21 22:18:30+00:00,['879cd9ab7e55f70c00851e45b6682870bab9f4b1'],1,74,75,710894,2,,,,1527
8a758f7c292764ffcb737c61c643cc34517e836e,0,Mike Percy,2015-10-22 03:25:04+00:00,['3d312af4c42e334e373458f27efa46555382fa85'],3,2,5,710899,2,,,,1527
4494dc00b7aa0911d6d6e62ae23958f9fe2b040f,0,Mike Percy,2015-10-22 03:25:32+00:00,['8a758f7c292764ffcb737c61c643cc34517e836e'],3,3,6,710905,2,,,,1527
538e2b371c92f646a4e7d6dfb8f4e38393718137,0,Mike Percy,2015-10-22 03:25:53+00:00,['4494dc00b7aa0911d6d6e62ae23958f9fe2b040f'],5,7,12,710917,1,,,,1527
3717e14364da494b90a4279f2c292560baf0b8a4,0,Dan Burkert,2015-10-22 19:38:19+00:00,['538e2b371c92f646a4e7d6dfb8f4e38393718137'],16,13,29,710946,6,1,0.75,0,1527
57f7d513c9ed46dda8e3c72c8cee8500a383d6a3,0,Jean-Daniel Cryans,2015-10-22 20:13:03+00:00,['3717e14364da494b90a4279f2c292560baf0b8a4'],1,45,46,710992,2,0,1,1,1527
35613d1ec50df1a344cc95cb557a82d6f69f9e31,1,Jean-Daniel Cryans,2015-10-22 20:14:08+00:00,['57f7d513c9ed46dda8e3c72c8cee8500a383d6a3'],1,1,2,710994,1,,,,1527
79aaae6f851c73900c5bd568daa939499a5a4e65,1,Dan Burkert,2015-10-22 21:56:18+00:00,['35613d1ec50df1a344cc95cb557a82d6f69f9e31'],0,65,65,711059,1,,,,1527
5b31165359bdb413b00517b026f3a3684c4d219d,0,Todd Lipcon,2015-10-22 22:49:37+00:00,['79aaae6f851c73900c5bd568daa939499a5a4e65'],9,14,23,711082,1,0,1,1,1527
8bccade5f1b969eca0fda1fa72907c1062d9dce3,1,Todd Lipcon,2015-10-23 00:17:43+00:00,['5b31165359bdb413b00517b026f3a3684c4d219d'],41,155,196,711278,5,0.466666667,0.866666667,0.55,1527
a1588eadf48cee44cf2b18f096699c2ee695fed9,0,Todd Lipcon,2015-10-23 00:18:03+00:00,['8bccade5f1b969eca0fda1fa72907c1062d9dce3'],0,7,7,711285,1,0.8,1,1,1527
c4db6521e6c6d43a9b60140a0e6f8f688b1a2095,1,Todd Lipcon,2015-10-23 00:18:13+00:00,['a1588eadf48cee44cf2b18f096699c2ee695fed9'],19,63,82,711367,3,0.5,0,0.8,1527
337669681ee49a2fa814e8f88e4b37974c25ba53,1,Todd Lipcon,2015-10-23 00:32:40+00:00,['c4db6521e6c6d43a9b60140a0e6f8f688b1a2095'],40,54,94,711461,5,1,1,0.5,1527
94b8975caeb5a11ae5e0798baf71ed82f45be5e5,0,Todd Lipcon,2015-10-23 00:34:51+00:00,['337669681ee49a2fa814e8f88e4b37974c25ba53'],1,1,2,711463,1,,,,1527
a8bfdfa2555d0d1675b0230ff7a8df2ceee73490,0,Todd Lipcon,2015-10-23 00:39:51+00:00,['94b8975caeb5a11ae5e0798baf71ed82f45be5e5'],3,3,6,711469,1,,,,1527
d434e63ed58dd589f77860d65275f3628adf8d2d,0,Todd Lipcon,2015-10-23 16:43:33+00:00,['a8bfdfa2555d0d1675b0230ff7a8df2ceee73490'],1,1,2,711471,1,,,,1527
58a9920c617980b8c0e7b9ad09efe7fa5c957788,0,Dan Burkert,2015-10-23 21:08:07+00:00,['d434e63ed58dd589f77860d65275f3628adf8d2d'],1,1,2,711473,1,,,,1527
7cfeaff59f0771aa3cb65db340ee53be6249ddca,0,Dan Burkert,2015-10-23 21:32:10+00:00,['58a9920c617980b8c0e7b9ad09efe7fa5c957788'],21,20,41,711514,1,1,0,0,1527
7287431464dac3431ac8ea2e27b4f9a703f65b7b,0,Dan Burkert,2015-10-23 21:32:16+00:00,['7cfeaff59f0771aa3cb65db340ee53be6249ddca'],14,14,28,711542,5,,,,1527
25275d8526ff8e3dfd7b7b2d3c165a6411027fa1,0,Dan Burkert,2015-10-23 21:32:20+00:00,['7287431464dac3431ac8ea2e27b4f9a703f65b7b'],1,3,4,711546,2,,,,1527
5f391921f976bfe2bf019ce22bc392eb163f3bc8,0,Dan Burkert,2015-10-23 21:32:24+00:00,['25275d8526ff8e3dfd7b7b2d3c165a6411027fa1'],1,1,2,711548,1,,,,1527
5a93485dcebfe70b4c8fbb7af14f399cc2b4784b,0,Todd Lipcon,2015-10-24 00:24:19+00:00,['5f391921f976bfe2bf019ce22bc392eb163f3bc8'],18,11,29,711577,2,0,0,0,1527
4d675ac06fa73fedc174cae05038325cf83c8dee,1,Todd Lipcon,2015-10-26 05:14:28+00:00,['5a93485dcebfe70b4c8fbb7af14f399cc2b4784b'],40,58,98,711675,11,1,1,1,1527
2a637988c5201fc8329a6d2a025fc84b65a81f18,0,Todd Lipcon,2015-10-26 05:17:35+00:00,['4d675ac06fa73fedc174cae05038325cf83c8dee'],0,12,12,711687,1,1,1,1,1527
9ffbe22db98f3aaeecc23c4181c8b72e585eda3d,0,Jean-Daniel Cryans,2015-10-26 15:44:46+00:00,['2a637988c5201fc8329a6d2a025fc84b65a81f18'],3,3,6,711693,3,,,,1527
276114986c89b63b1fba166f86f51184e869221f,0,Jean-Daniel Cryans,2015-10-26 16:03:23+00:00,['9ffbe22db98f3aaeecc23c4181c8b72e585eda3d'],2,2,4,711697,2,,,,1527
b360d230008f7b91c98750b37476ad6c4795906b,0,Todd Lipcon,2015-10-26 16:26:54+00:00,['276114986c89b63b1fba166f86f51184e869221f'],1,12,13,711710,1,,,,1527
e176666022b6188a9e7cf541a9a312902c01ac95,0,Mike Percy,2015-10-27 18:24:45+00:00,['b360d230008f7b91c98750b37476ad6c4795906b'],20,0,20,711730,1,0,0,0,1527
40c3606a736b8b97ffbdce443929b93c2bf402d2,0,Dan Burkert,2015-10-27 19:18:38+00:00,['e176666022b6188a9e7cf541a9a312902c01ac95'],3,5,8,711738,1,1,1,1,1527
337ad7a1c161906c4272fc7bbf83f6aadbe2096e,0,Dan Burkert,2015-10-27 19:18:43+00:00,['40c3606a736b8b97ffbdce443929b93c2bf402d2'],2,8,10,711748,2,0,1,1,1527
2afc4ed537b2dcb6056ae1afddd82a76b8e7fce7,0,Jean-Daniel Cryans,2015-10-27 19:43:11+00:00,['337ad7a1c161906c4272fc7bbf83f6aadbe2096e'],6,66,72,711820,4,0.75,0.75,0.75,1527
5d23840343db31be56ed04cf30ff9dab942c62ca,0,Mike Percy,2015-10-27 23:48:02+00:00,['2afc4ed537b2dcb6056ae1afddd82a76b8e7fce7'],0,384,384,712204,2,0.291457286,0.351758794,1,1529
37b4ddaced648ec02f696d4ef8c22bb565437d9f,0,Mike Percy,2015-10-27 23:48:21+00:00,['5d23840343db31be56ed04cf30ff9dab942c62ca'],15,103,118,712322,9,0.863636364,1,1,1531
3186e7bdb490167958b8e5d29a21832f7402fe72,0,Mike Percy,2015-10-27 23:48:42+00:00,['37b4ddaced648ec02f696d4ef8c22bb565437d9f'],1,1,2,712324,1,,,,1531
f3e5e5aa015dfdce7379ea64d320ec65679a4480,0,Todd Lipcon,2015-10-28 00:34:02+00:00,['3186e7bdb490167958b8e5d29a21832f7402fe72'],0,45,45,712369,1,0,1,1,1531
f05042f8a0a2cba93a3ae49f1401b82397217dad,0,Todd Lipcon,2015-10-28 00:34:33+00:00,['f3e5e5aa015dfdce7379ea64d320ec65679a4480'],0,20,20,712389,2,1,1,1,1531
d0c43abc1904245751b8ae7b9462f9e582df4a56,0,Todd Lipcon,2015-10-28 01:45:55+00:00,['f05042f8a0a2cba93a3ae49f1401b82397217dad'],0,2,2,712391,1,0,1,1,1531
e9482d608d87bd1dcc1f092fb68fd1070f072298,0,Mike Percy,2015-10-28 02:52:46+00:00,['d0c43abc1904245751b8ae7b9462f9e582df4a56'],9,9,18,712409,4,,,,1531
9dbc789c0f1a6f2a0048c91752a44ff5990d5120,0,Dan Burkert,2015-10-29 03:06:51+00:00,['e9482d608d87bd1dcc1f092fb68fd1070f072298'],1,1,2,712411,1,,,,1531
2855b2841e6ed0e1a8c268bed36cfd0071802264,1,Jean-Daniel Cryans,2015-10-29 16:43:01+00:00,['9dbc789c0f1a6f2a0048c91752a44ff5990d5120'],1,1,2,712413,1,,,,1531
b3e7d32717bf523ed777fdd171cdbc2e13c34c99,0,Todd Lipcon,2015-10-29 18:25:41+00:00,['2855b2841e6ed0e1a8c268bed36cfd0071802264'],1,1,2,712415,1,,,,1531
6ebe0b30973886fb4b6b1c0cbb30938df651a4be,1,Todd Lipcon,2015-10-30 01:49:44+00:00,['b3e7d32717bf523ed777fdd171cdbc2e13c34c99'],34,99,133,712548,9,0.25,0.8125,1,1531
632c3740d2b141afe170fae9fe51714a2d79a4e7,0,Dan Burkert,2015-10-30 18:21:40+00:00,['6ebe0b30973886fb4b6b1c0cbb30938df651a4be'],3,4,7,712555,1,0,1,1,1531
a8f23d32de65782e0053979fb2e99d19d1affee9,0,Mike Percy,2015-10-30 18:47:47+00:00,['632c3740d2b141afe170fae9fe51714a2d79a4e7'],0,19,19,712574,3,0.272727273,1,1,1531
4b615f43303477b3ffcc401486e908e01f42e3f2,0,Mike Percy,2015-10-30 20:36:46+00:00,['a8f23d32de65782e0053979fb2e99d19d1affee9'],18,11,29,712603,2,0,0,0,1531
bd3f64168d748ce8f0bc7f97d67cadfa59f8f855,0,Dan Burkert,2015-10-30 23:27:17+00:00,['4b615f43303477b3ffcc401486e908e01f42e3f2'],2,15,17,712620,2,0,1,1,1531
354f0ff6b0df6763fcad0f437dd57363abbce2f7,0,Todd Lipcon,2015-10-30 23:55:34+00:00,['bd3f64168d748ce8f0bc7f97d67cadfa59f8f855'],11,19,30,712650,2,0,1,1,1531
2d615e70126ccd0d7bd8af7967dacb284076d13f,0,Todd Lipcon,2015-10-31 00:19:35+00:00,['354f0ff6b0df6763fcad0f437dd57363abbce2f7'],2,11,13,712663,1,0,0,0,1531
42d8feb164d11a65593ae6cf791edfce722cbb4d,0,Mike Percy,2015-10-31 08:11:22+00:00,['2d615e70126ccd0d7bd8af7967dacb284076d13f'],66,3,69,712732,2,0.896551724,0.068965517,0.068965517,1531
8e4a5e43fd5f94587a096968a244bb03dd6787d2,1,Mike Percy,2015-11-02 22:41:56+00:00,['42d8feb164d11a65593ae6cf791edfce722cbb4d'],1,9,10,712742,2,,,,1531
80a9705b4d17c6023d04ea0a4f65b7fcebd5e6f8,0,Todd Lipcon,2015-11-03 21:56:26+00:00,['8e4a5e43fd5f94587a096968a244bb03dd6787d2'],0,9,9,712751,1,0,0,1,1531
9ca198de110cf893ef355b370e3732b511f0b3a5,0,Todd Lipcon,2015-11-03 21:56:35+00:00,['80a9705b4d17c6023d04ea0a4f65b7fcebd5e6f8'],1,5,6,712757,1,1,1,1,1531
e9d4b879da3d7dcbc19d931f34490eab25006339,1,Todd Lipcon,2015-11-03 22:02:15+00:00,['9ca198de110cf893ef355b370e3732b511f0b3a5'],75,143,218,712975,15,0.178571429,1,1,1531
dd2e9d23fddbabad7a1c7d67725f33b13c6472c2,1,Todd Lipcon,2015-11-03 22:12:43+00:00,['e9d4b879da3d7dcbc19d931f34490eab25006339'],77,131,208,713183,27,0.04,1,0.92,1531
7f5e16fbf116f4dbcdd6daa7bcb02c25fff6c9b2,0,Todd Lipcon,2015-11-03 22:14:28+00:00,['dd2e9d23fddbabad7a1c7d67725f33b13c6472c2'],21,52,73,713256,7,1,1,1,1531
ce6426f5401591a0e01d2bbc530fd9995e1a52ec,0,Todd Lipcon,2015-11-03 22:15:17+00:00,['7f5e16fbf116f4dbcdd6daa7bcb02c25fff6c9b2'],20,13,33,713289,3,1,0,1,1531
d0dd897e05deb19511d3bbe7f385940fbc8ee1c2,1,Todd Lipcon,2015-11-03 22:38:54+00:00,['ce6426f5401591a0e01d2bbc530fd9995e1a52ec'],14,49,63,713352,4,0,0,0,1531
62193d14eccc5e3be40c767efd24bfca28a3abcf,1,Dan Burkert,2015-11-03 23:15:14+00:00,['d0dd897e05deb19511d3bbe7f385940fbc8ee1c2'],149,177,326,713678,40,1,1,0.9375,1531
e0e1e16ce0325b216bbce0d884e23e877e189a53,0,Todd Lipcon,2015-11-04 02:01:13+00:00,['62193d14eccc5e3be40c767efd24bfca28a3abcf'],35,69,104,713782,2,0.894736842,1,0.947368421,1531
c9b97e6fd89589084d3a3be42da128e86119f8ae,0,Todd Lipcon,2015-11-04 20:09:27+00:00,['e0e1e16ce0325b216bbce0d884e23e877e189a53'],1,10,11,713793,1,,,,1531
28ce46fe34b3e71e37be3a824173b7f221a61647,0,Dan Burkert,2015-11-04 22:18:20+00:00,['c9b97e6fd89589084d3a3be42da128e86119f8ae'],1,7,8,713801,1,0,0,1,1531
092b21793fb91475c89d3e9a5ddf8da942e24f37,0,Dan Burkert,2015-11-04 23:50:02+00:00,['28ce46fe34b3e71e37be3a824173b7f221a61647'],0,7,7,713808,2,,,,1531
4b96d87983d0a61bf41c6bc2ca581d414e616fa0,0,Dan Burkert,2015-11-04 23:50:05+00:00,['092b21793fb91475c89d3e9a5ddf8da942e24f37'],1,9,10,713818,1,1,1,1,1531
40599c3101f8adedc762875a77b607821d4e224b,0,Misty Stanley-Jones,2015-11-05 21:08:42+00:00,['4b96d87983d0a61bf41c6bc2ca581d414e616fa0'],3,3,6,713824,1,,,,1531
c8db7b57a607b1670df64ff95b30b9737678839f,0,Dan Burkert,2015-11-06 00:54:34+00:00,['40599c3101f8adedc762875a77b607821d4e224b'],1,5,6,713830,1,,,,1531
565743a4ca4ed52af25b3b7275de1a1e3467d1f3,0,Mike Percy,2015-11-06 16:46:12-08:00,['4de32011fbb3a759ec95fb2fc6ce25a9e66a477d'],0,231,231,714061,4,0.052631579,0.315789474,1,1534
6d1ee0f78964755870cd8768a18d4d726bbc2e69,1,Todd Lipcon,2015-11-09 06:21:30+00:00,['c8db7b57a607b1670df64ff95b30b9737678839f'],7,183,190,714251,8,0.782608696,0.811594203,0.826086957,1535
fa6e94394daaf594812cf5535233599ba2dfbaa5,0,Dan Burkert,2015-11-09 23:50:40+00:00,['6d1ee0f78964755870cd8768a18d4d726bbc2e69'],7,14,21,714272,3,,,,1535
d84d860243c5ff30158cddb02c477925774f7db5,0,Dan Burkert,2015-11-12 18:08:58+00:00,['fa6e94394daaf594812cf5535233599ba2dfbaa5'],226,300,526,714798,75,0,,,1535
ccc17e4c4a9b63c0e5da1024ef83c344e00d8f89,0,Jean-Daniel Cryans,2015-11-12 18:54:55+00:00,['d84d860243c5ff30158cddb02c477925774f7db5'],0,3,3,714801,1,0.666666667,1,1,1535
d6a448ad20c094d6b4db5afd25346cd04821bb69,0,David Ribeiro Alves,2015-11-12 19:28:49+00:00,['ccc17e4c4a9b63c0e5da1024ef83c344e00d8f89'],3,34,37,714838,2,0.157894737,1,1,1535
06afacfc323678dd41d6c6277f27834dbeecc880,0,David Ribeiro Alves,2015-11-12 20:10:05+00:00,['d6a448ad20c094d6b4db5afd25346cd04821bb69'],2,5,7,714845,2,,,,1535
9f599edaf30048d9f86c4d85aaeb717585157d9f,0,David Ribeiro Alves,2015-11-12 20:10:12+00:00,['06afacfc323678dd41d6c6277f27834dbeecc880'],2,2,4,714849,2,,,,1535
a9e0e191b05eea0883b43c1730ba094b5c0bbb98,0,Misty Stanley-Jones,2015-11-12 21:12:40+00:00,['9f599edaf30048d9f86c4d85aaeb717585157d9f'],12,34,46,714895,1,,,,1535
3cbae3392e923516098cc1ebea68bd4f0ca75f9a,0,David Ribeiro Alves,2015-11-12 21:33:39+00:00,['a9e0e191b05eea0883b43c1730ba094b5c0bbb98'],19,19,38,714933,4,,,,1535
f5dd9f061732bfdf640bb8bbe98259a27f8d5f20,1,David Ribeiro Alves,2015-11-12 21:33:44+00:00,['3cbae3392e923516098cc1ebea68bd4f0ca75f9a'],35,15,50,714983,3,0.923076923,1,0,1535
b1a7307dc117cacf2fceee91083799851ec71ef1,1,David Ribeiro Alves,2015-11-12 21:51:08+00:00,['f5dd9f061732bfdf640bb8bbe98259a27f8d5f20'],8,36,44,715027,2,0,0.428571429,1,1535
756d560eb256a87fd609047f68b8ab1728bc1e33,0,Todd Lipcon,2015-11-12 23:37:02+00:00,['b1a7307dc117cacf2fceee91083799851ec71ef1'],9,9,18,715045,5,0,,0,1535
354dcf3530859ad7fc4295dee4effe83d348a965,1,Jean-Daniel Cryans,2015-11-13 00:26:15+00:00,['756d560eb256a87fd609047f68b8ab1728bc1e33'],224,357,581,715626,2,1,1,1,1536
f897dee29474cfbc2f0518a3ce81c83277c83b7f,0,David Ribeiro Alves,2015-11-13 00:58:07+00:00,['354dcf3530859ad7fc4295dee4effe83d348a965'],8,90,98,715724,3,0.369565217,1,1,1536
29141971cbb4d98f3e45080aa990771d87adc49a,0,David Ribeiro Alves,2015-11-13 02:00:10+00:00,['f897dee29474cfbc2f0518a3ce81c83277c83b7f'],0,6,6,715730,2,1,1,1,1536
a8be990e1ccaaad747cecb9971ad037186f51d38,0,David Ribeiro Alves,2015-11-13 03:12:51+00:00,['29141971cbb4d98f3e45080aa990771d87adc49a'],7,0,7,715737,1,,,,1536
6fa1873d6537b5584d61b772140a8cb870c60a4e,0,David Ribeiro Alves,2015-11-13 20:30:01+00:00,['a8be990e1ccaaad747cecb9971ad037186f51d38'],0,48,48,715785,4,0,1,0.142857143,1536
0caa06cf137f2e00f78a241af76aecf7a2136e7d,0,Mike Percy,2015-11-13 21:35:13+00:00,['6fa1873d6537b5584d61b772140a8cb870c60a4e'],0,3,3,715788,1,0,0.333333333,1,1536
292b4ff04d2ef9f3107c1bc35262deb87eecfdfe,0,Todd Lipcon,2015-11-13 23:44:17+00:00,['0caa06cf137f2e00f78a241af76aecf7a2136e7d'],1,1,2,715790,1,,,,1536
7274bf4ed8c0a3f73a07992fac57bc8f69782019,0,Todd Lipcon,2015-11-14 01:07:08+00:00,['292b4ff04d2ef9f3107c1bc35262deb87eecfdfe'],1,2,3,715793,1,,,,1536
9a5b5e066bfef2c68f545950f80f7ae4b6c6ab9e,0,Todd Lipcon,2015-11-14 01:07:59+00:00,['7274bf4ed8c0a3f73a07992fac57bc8f69782019'],2,0,2,715795,1,,,,1536
4bd4c29efee6f15bdb56c0a4f0fe45b377c38a0c,0,Todd Lipcon,2015-11-14 01:08:07+00:00,['9a5b5e066bfef2c68f545950f80f7ae4b6c6ab9e'],0,1,1,715796,1,,,,1536
09e3cabc7e2384e835ca7d96d677ed58d81f01b5,0,Mike Percy,2015-11-17 00:17:22+00:00,['4bd4c29efee6f15bdb56c0a4f0fe45b377c38a0c'],6,140,146,715942,3,0,0.7625,1,1536
d12dd7097a75740e6b8d4c5510ce9dad8ceca23a,1,David Ribeiro Alves,2015-11-17 00:25:29+00:00,['09e3cabc7e2384e835ca7d96d677ed58d81f01b5'],6,8,14,715956,3,0,0,0,1536
c557320de9c55affbebfd949a037976605cefad8,0,David Ribeiro Alves,2015-11-17 00:25:36+00:00,['d12dd7097a75740e6b8d4c5510ce9dad8ceca23a'],1,18,19,715975,1,1,1,1,1536
c6220948c04047d4e221547e1a197963e73b6bf2,0,Jean-Daniel Cryans,2015-11-17 00:44:44+00:00,['c557320de9c55affbebfd949a037976605cefad8'],0,18,18,715993,1,,,,1536
a85cce7e3de6352169ef4da3dd6b238afd08f58f,0,Mike Percy,2015-11-17 01:08:56+00:00,['c6220948c04047d4e221547e1a197963e73b6bf2'],14,12,26,716019,1,0,0,0,1536
9bbc0bebc3815d2645624a25b407881e48cba19c,0,Mike Percy,2015-11-17 01:09:25+00:00,['a85cce7e3de6352169ef4da3dd6b238afd08f58f'],1,1,2,716021,1,,,,1536
c62f40dac22cda71407818ba7bbfeeca30319c76,0,David Ribeiro Alves,2015-11-17 05:54:15+00:00,['9bbc0bebc3815d2645624a25b407881e48cba19c'],26,45,71,716092,2,,,,1536
b08e8f8581d6de44c7bfdc90f8c1e1a7499fc310,0,David Ribeiro Alves,2015-11-17 05:54:25+00:00,['c62f40dac22cda71407818ba7bbfeeca30319c76'],4,99,103,716195,6,0.161290323,1,0.612903226,1536
5c71a084c005ef3644b442b1d5734ce2715124ee,0,Jean-Daniel Cryans,2015-11-17 19:07:59+00:00,['b08e8f8581d6de44c7bfdc90f8c1e1a7499fc310'],3,7,10,716205,2,0.666666667,1,1,1536
b853815d3493430495dd7b4625c9e7b07bf04bde,0,jdcryans,2015-11-17 11:18:24-08:00,"['4de32011fbb3a759ec95fb2fc6ce25a9e66a477d', '565743a4ca4ed52af25b3b7275de1a1e3467d1f3']",0,231,231,716436,4,,,,1536
5f9c65d7c78419a5d9867acd893c0f3f8deb7c2d,0,Jean-Daniel Cryans,2015-11-17 21:08:57+00:00,['5c71a084c005ef3644b442b1d5734ce2715124ee'],3,27,30,716466,2,0.333333333,1,1,1536
ab01ed76224d19736e5e81d10d1698507888dcb3,0,Mike Percy,2015-11-18 01:40:09+00:00,['5f9c65d7c78419a5d9867acd893c0f3f8deb7c2d'],0,49,49,716515,3,0.333333333,1,0.333333333,1536
b429cdc078a8b21957e9ddc9d398afaea9e60058,1,Mike Percy,2015-11-18 01:40:21+00:00,['ab01ed76224d19736e5e81d10d1698507888dcb3'],3,36,39,716554,2,0,0.944444444,0.888888889,1536
21c34f9eb366f06a5b85fa6c28747bf4edfd5b29,1,Mike Percy,2015-11-18 01:40:31+00:00,['b429cdc078a8b21957e9ddc9d398afaea9e60058'],77,38,115,716669,1,0.09375,0.09375,0.09375,1536
63f749ef3e9b8984da014a371a1f7effbf83073f,0,Todd Lipcon,2015-11-18 17:47:48+00:00,['21c34f9eb366f06a5b85fa6c28747bf4edfd5b29'],0,1,1,716670,1,,,,1536
d59b926b5e5541d125e1c6b576381eac92fc3b75,1,Jean-Daniel Cryans,2015-11-19 00:17:14+00:00,['63f749ef3e9b8984da014a371a1f7effbf83073f'],8,8,16,716686,7,,,,1536
61786291ca9d95d08ca5aa394a5bc130dd83cc22,0,Todd Lipcon,2015-11-19 03:52:14+00:00,['d59b926b5e5541d125e1c6b576381eac92fc3b75'],1,7,8,716694,1,0,1,1,1536
3d9f611130b498511af71134f14c7560875a437d,0,Jean-Daniel Cryans,2015-11-19 05:27:27+00:00,['61786291ca9d95d08ca5aa394a5bc130dd83cc22'],20,30,50,716744,3,,,,1536
61e6cd19f3b350448e6ea649d34a43962fb6f345,0,Jean-Daniel Cryans,2015-11-19 05:28:22+00:00,['3d9f611130b498511af71134f14c7560875a437d'],2,85,87,716831,2,0.275862069,0.120689655,1,1536
ff502b6f22ef9eadf3674a08fa4078d802923a0e,0,Jean-Daniel Cryans,2015-11-19 14:47:55+00:00,['61e6cd19f3b350448e6ea649d34a43962fb6f345'],1,8,9,716840,1,,,,1536
effecd97334c8e8a16cc8b68c9300cc24e19da4f,0,Jean-Daniel Cryans,2015-11-19 22:45:05+00:00,['ff502b6f22ef9eadf3674a08fa4078d802923a0e'],4,3,7,716847,1,,,,1536
88a99036dda648f1ddbe7e17098de523994c0631,0,Todd Lipcon,2015-11-19 23:12:07+00:00,['effecd97334c8e8a16cc8b68c9300cc24e19da4f'],1,1,2,716849,1,,,,1536
2e83053f461acc92ad2118bb4d0a15103403ccc7,0,Mike Percy,2015-11-20 02:57:01+00:00,['88a99036dda648f1ddbe7e17098de523994c0631'],2,2,4,716853,1,,,,1536
85508a51682b96ca14ced898560c7f21bdb537e4,0,Mike Percy,2015-11-20 19:13:06+00:00,['2e83053f461acc92ad2118bb4d0a15103403ccc7'],0,1,1,716854,1,0,1,1,1536
7d5e56a8d582279601efa1325a2048dc43c83718,0,Mike Percy,2015-11-20 19:13:51+00:00,['85508a51682b96ca14ced898560c7f21bdb537e4'],0,4,4,716858,1,0,1,0,1536
21907c7c5e55043edd4e8726b52f72149e1fc5db,0,Todd Lipcon,2015-11-20 21:54:17+00:00,['7d5e56a8d582279601efa1325a2048dc43c83718'],12,18,30,716888,6,,,,1536
09521d59c9dc45f8ba99ad88aad5c4f13be89322,0,David Ribeiro Alves,2015-11-20 23:02:53+00:00,['21907c7c5e55043edd4e8726b52f72149e1fc5db'],0,16,16,716904,2,,,,1536
af71d5603fc1958c06457ae4fe282a9525d04afc,0,Todd Lipcon,2015-11-21 00:38:17+00:00,['09521d59c9dc45f8ba99ad88aad5c4f13be89322'],13,11,24,716928,1,,,,1536
dad285e59157fd7161715a6b7c7dbe68cdaa247d,0,Mike Percy,2015-11-21 01:29:47+00:00,['af71d5603fc1958c06457ae4fe282a9525d04afc'],15,67,82,717010,2,,,,1536
271f9829bc02eaca2d3ee97b673ec4b629c0bde6,1,Todd Lipcon,2015-11-21 02:06:57+00:00,['dad285e59157fd7161715a6b7c7dbe68cdaa247d'],24,154,178,717188,7,0.615384615,0.961538462,0.865384615,1537
46da1940b8ff0b65bdea37fae548ae2d7c92a569,0,Todd Lipcon,2015-11-21 02:07:06+00:00,['271f9829bc02eaca2d3ee97b673ec4b629c0bde6'],8,54,62,717250,9,0.607142857,0.892857143,0.928571429,1537
fb06b575cecc33e2626b68e32a936a7ac0272dfd,0,Misty Stanley-Jones,2015-11-22 23:36:30+00:00,['46da1940b8ff0b65bdea37fae548ae2d7c92a569'],1,15,16,717266,2,,,,1538
f1a5e02e6c11c9bacc693fc49af7f8186b7b43a2,0,Jean-Daniel Cryans,2015-11-23 18:43:54+00:00,['fb06b575cecc33e2626b68e32a936a7ac0272dfd'],1,88,89,717355,2,,,,1538
29b002d150831e467cf0f72e48bc552cc9480a2a,1,Jean-Daniel Cryans,2015-11-23 22:47:35+00:00,['f1a5e02e6c11c9bacc693fc49af7f8186b7b43a2'],1,1,2,717357,1,,,,1538
77713fb9847dc072e7fd27a1e58178456fd13da8,0,Mike Percy,2015-11-23 15:58:18-08:00,['b853815d3493430495dd7b4625c9e7b07bf04bde'],3,3,6,717363,3,,,,1538
6e8c96c4297dd7a8e0db8104cb6c5679f148e7bc,0,Todd Lipcon,2015-11-24 00:32:37+00:00,['29b002d150831e467cf0f72e48bc552cc9480a2a'],3,5,8,717371,1,1,1,1,1538
579f7dbdeba2eb33d32fd21f6d82ff3eb097baad,0,jdcryans,2015-11-23 17:27:24-08:00,"['b853815d3493430495dd7b4625c9e7b07bf04bde', '77713fb9847dc072e7fd27a1e58178456fd13da8']",3,3,6,717377,3,,,,1538
72d4f85f00018839561ee04e49937b4812ec5d15,1,Todd Lipcon,2015-11-24 01:45:27+00:00,['6e8c96c4297dd7a8e0db8104cb6c5679f148e7bc'],11,247,258,717635,3,0.54954955,0.873873874,0.810810811,1540
32db0cbf30f8a4f067fe7434a8b5e8f9addc2838,0,Jean-Daniel Cryans,2015-11-24 01:48:42+00:00,['72d4f85f00018839561ee04e49937b4812ec5d15'],5,6,11,717646,1,,,,1540
37c3d14b6b4bbc55440be3606a8cb6f3ec3d60ac,1,Todd Lipcon,2015-11-24 03:04:45+00:00,['32db0cbf30f8a4f067fe7434a8b5e8f9addc2838'],1,106,107,717753,3,0.372881356,1,1,1540
81d5008e970fc9260125a5dc09746899c8490777,0,Dan Burkert,2015-11-24 19:03:30+00:00,['37c3d14b6b4bbc55440be3606a8cb6f3ec3d60ac'],1,1,2,717755,1,,,,1540
9ceeb66ec8de9147bbb25c9a4a63248d28f4e03c,0,Todd Lipcon,2015-11-24 21:04:04+00:00,['81d5008e970fc9260125a5dc09746899c8490777'],204,58,262,718017,3,,,,1540
a5c5dcfb0692ada1c0182b1ca236f66bffc083af,0,Misty Stanley-Jones,2015-11-25 23:47:07+00:00,['9ceeb66ec8de9147bbb25c9a4a63248d28f4e03c'],8,31,39,718056,1,,,,1540
8cd3ca53396a7cdf05de5dcff5e29c818283d67d,0,Misty Stanley-Jones,2015-11-26 00:01:43+00:00,['a5c5dcfb0692ada1c0182b1ca236f66bffc083af'],2,11,13,718069,1,,,,1540
8d2f8d9d6e28be9f2ff254aa0f0ffe0bd3912830,1,Mike Percy,2015-11-26 00:50:42+00:00,['8cd3ca53396a7cdf05de5dcff5e29c818283d67d'],76,297,373,718442,6,,,,1543
bb654de87177c38decd0a5567b8078b80047c14b,1,Mike Percy,2015-12-02 03:01:13+00:00,['8d2f8d9d6e28be9f2ff254aa0f0ffe0bd3912830'],4,4,8,718450,1,,,,1543
8cd04ad336b585bd0f9e770f00fb4ff2fcb8d37e,0,Mike Percy,2015-12-02 03:02:18+00:00,['bb654de87177c38decd0a5567b8078b80047c14b'],1,1,2,718452,1,,,,1543
8bf6e40d78344de99ed7d4a1c9921544e7d54ee9,1,Mike Percy,2015-12-02 03:03:00+00:00,['8cd04ad336b585bd0f9e770f00fb4ff2fcb8d37e'],14,14,28,718480,3,,,,1543
f68c4b18c9fc57bec4c43ec2abdaf287e6a42b4b,1,Mike Percy,2015-12-02 03:06:51+00:00,['8bf6e40d78344de99ed7d4a1c9921544e7d54ee9'],13,27,40,718520,6,0.428571429,0,1,1543
ca7bcf33b72121148bd2b2278c6b47eeffb1a56b,0,Mike Percy,2015-12-02 07:23:46+00:00,['f68c4b18c9fc57bec4c43ec2abdaf287e6a42b4b'],2,2,4,718524,1,,,,1543
4af0489673544d6c6c7338a170bb636be41fdb30,0,Mike Percy,2015-12-02 08:30:14+00:00,['ca7bcf33b72121148bd2b2278c6b47eeffb1a56b'],0,32,32,718556,2,0.894736842,0.894736842,1,1543
89067cead50797dbf41718deedc2c13484aa80cf,0,Mike Percy,2015-12-02 08:58:44+00:00,['4af0489673544d6c6c7338a170bb636be41fdb30'],5,31,36,718592,2,0,0,1,1543
da3629aef49966fce7f455347991a4b6be059018,1,Mike Percy,2015-12-02 09:56:46+00:00,['89067cead50797dbf41718deedc2c13484aa80cf'],6,55,61,718653,3,1,1,0.785714286,1543
4901711de363419e746b306c67ad9f2d382bd64b,0,Jean-Daniel Cryans,2015-12-04 16:52:57+00:00,['da3629aef49966fce7f455347991a4b6be059018'],2,2,4,718657,1,,,,1543
82dd9adbe36f690d3448820042f4bf270e065b04,1,Jean-Daniel Cryans,2015-12-04 16:55:10+00:00,['4901711de363419e746b306c67ad9f2d382bd64b'],28,50,78,718735,4,,,,1543
a25d80c0610dfb5026a5788c134d2fa8a52744d5,0,Dan Burkert,2015-12-05 02:00:15+00:00,['82dd9adbe36f690d3448820042f4bf270e065b04'],3,7,10,718745,1,0,1,1,1543
57a0f60f026254dab4ce3986a8bb91c814a9ff7d,0,Misty Stanley-Jones,2015-12-07 21:07:52+00:00,['a25d80c0610dfb5026a5788c134d2fa8a52744d5'],1,33,34,718779,1,,,,1543
b8d6afc82298ef1352deb9aed55dceacdb38affd,0,Mike Percy,2015-12-07 22:49:52+00:00,['57a0f60f026254dab4ce3986a8bb91c814a9ff7d'],113,38,151,718930,2,,,,1543
d20b44704033d46be76ce4bfa55df09251b45520,0,Dan Burkert,2015-12-07 23:09:43+00:00,['b8d6afc82298ef1352deb9aed55dceacdb38affd'],4,3,7,718937,1,1,0,0,1543
2635bd26b67c717fc8d7afea8aee8e050fe9d4d3,0,Dan Burkert,2015-12-07 23:09:58+00:00,['d20b44704033d46be76ce4bfa55df09251b45520'],2,2,4,718941,2,,,,1543
251defb69b1a252cedd5d707d9c84b67cf63726d,0,Mike Percy,2015-12-09 17:54:47+00:00,['2635bd26b67c717fc8d7afea8aee8e050fe9d4d3'],22,22,44,718985,16,,,,1543
541d61b56f5eb55ef052b2f242d72788c3be9d20,0,Todd Lipcon,2015-12-15 18:54:56+00:00,['251defb69b1a252cedd5d707d9c84b67cf63726d'],1,1,2,718987,1,,,,1543
10004e2143fc78c872d2e497d51511d7baef569b,1,Mike Percy,2015-12-15 23:41:24+00:00,['541d61b56f5eb55ef052b2f242d72788c3be9d20'],1,193,194,719181,3,0.581818182,0.581818182,1,1544
921b5d39179eab72ed98cb765f40db6e1ba81999,0,Misty Stanley-Jones,2015-12-16 22:49:45+00:00,['10004e2143fc78c872d2e497d51511d7baef569b'],1,1,2,719183,1,,,,1544
fc24e8e1c2d144fe5193d43e5c87e4447bedf794,0,Todd Lipcon,2015-12-17 00:08:53+00:00,['921b5d39179eab72ed98cb765f40db6e1ba81999'],2,2,4,719187,1,,,,1544
cf0d211a36a371bc35a5a462abbaa71225d6f283,1,Todd Lipcon,2015-12-17 00:11:16+00:00,['fc24e8e1c2d144fe5193d43e5c87e4447bedf794'],34,67,101,719288,5,0.315789474,0,1,1544
5d5270411f4cb12d5882d83133e57f7d751e4dc0,0,Jean-Daniel Cryans,2015-12-18 00:01:21+00:00,['cf0d211a36a371bc35a5a462abbaa71225d6f283'],1,6,7,719295,2,,,,1544
a26e0749bf0f6ecaf80222cea0b1baa589ddf13c,0,Todd Lipcon,2015-12-18 01:48:29+00:00,['5d5270411f4cb12d5882d83133e57f7d751e4dc0'],531,135,666,719961,9,0.602272727,0.390151515,0.208333333,1544
29b11636fd8d100b314e14ec787e8edc1802f4be,0,Dan Burkert,2015-12-18 20:10:07+00:00,['a26e0749bf0f6ecaf80222cea0b1baa589ddf13c'],1,1,2,719963,1,,,,1544
cba61b5b36dbb746ac9e3aecb130963d4861c5d3,0,Dan Burkert,2015-12-19 20:19:56+00:00,['29b11636fd8d100b314e14ec787e8edc1802f4be'],2754,2317,5071,725034,401,1,0.049079755,0.239263804,1547
07bededa779f486bf598b7a060095e12a95ae974,1,Dan Burkert,2015-12-19 23:27:35+00:00,['cba61b5b36dbb746ac9e3aecb130963d4861c5d3'],2317,2754,5071,730105,401,0,0.950920245,0.760736196,1550
170c32c08dc8afb9c3d0e067f7ba35244ed42e2e,0,Jean-Daniel Cryans,2015-12-23 16:42:21+00:00,['07bededa779f486bf598b7a060095e12a95ae974'],70,135,205,730310,6,0.111111111,1,1,1550
c367baa61a7e1b6c69fbde1fd13be5885277c19b,0,Jean-Daniel Cryans,2015-12-23 16:44:57+00:00,['170c32c08dc8afb9c3d0e067f7ba35244ed42e2e'],3,9,12,730322,2,0,0,0.833333333,1550
63b9268f90221570cf753ca706f1d22d0932f408,0,Mike Percy,2016-01-05 09:34:36+00:00,['c367baa61a7e1b6c69fbde1fd13be5885277c19b'],9,153,162,730484,3,0.428571429,0.452380952,1,1550
f85ee5fed915122755f68b49668868758dc11059,0,Jean-Daniel Cryans,2016-01-05 19:06:21+00:00,['63b9268f90221570cf753ca706f1d22d0932f408'],6,14,20,730504,1,0,1,0,1550
bf1f244fb740664027cea3d7e32c213e04f4041c,1,Todd Lipcon,2016-01-05 21:39:41+00:00,['f85ee5fed915122755f68b49668868758dc11059'],2,21,23,730527,3,0,0.818181818,0.818181818,1550
8ff679fb6aae253a82655a2029aa4dd8581bcb74,0,Dan Burkert,2016-01-05 22:07:16+00:00,['bf1f244fb740664027cea3d7e32c213e04f4041c'],0,5,5,730532,1,0,1,1,1550
8b04bf9753e400575e8497457feade91d2920103,0,Dan Burkert,2016-01-05 22:46:48+00:00,['8ff679fb6aae253a82655a2029aa4dd8581bcb74'],2,24,26,730558,3,,,,1550
dca76cadeb7a0c7ba6d08608ae42ec388584c0d0,0,Todd Lipcon,2016-01-06 20:17:17+00:00,['8b04bf9753e400575e8497457feade91d2920103'],65,2,67,730625,1,1,0,0.485714286,1550
183e81612317c521ab4e7a51080e5c15c192b036,1,Todd Lipcon,2016-01-06 20:19:10+00:00,['dca76cadeb7a0c7ba6d08608ae42ec388584c0d0'],40,48,88,730713,3,0,1,1,1550
4b6aec3a06b1b8c94763d6bb348787c3d493c8cd,0,Todd Lipcon,2016-01-06 20:25:23+00:00,['183e81612317c521ab4e7a51080e5c15c192b036'],4,3,7,730720,1,,,,1550
9a1d0a3736186ee151b8a4a5355a8e57011baeda,1,Dan Burkert,2016-01-06 20:48:06+00:00,['4b6aec3a06b1b8c94763d6bb348787c3d493c8cd'],383,21,404,731124,6,0.422924901,0.288537549,0.391304348,1550
abe94483483713465c3928259d4f70348125234d,0,Todd Lipcon,2016-01-06 21:31:38+00:00,['9a1d0a3736186ee151b8a4a5355a8e57011baeda'],0,1,1,731125,1,1,1,1,1550
2187df374c032e737c59fa70e32bdde58babfde5,0,Dan Burkert,2016-01-06 22:46:22+00:00,['abe94483483713465c3928259d4f70348125234d'],3,1,4,731129,1,0,0,0,1550
5dac2ab29dcf6e52f3181dbbc0d2863c136ad3ed,0,Dan Burkert,2016-01-07 03:53:38+00:00,['2187df374c032e737c59fa70e32bdde58babfde5'],0,28,28,731157,1,,,,1551
de157fa6a6b423d02ab4708aee872869db990da5,0,Todd Lipcon,2016-01-07 22:33:13+00:00,['5dac2ab29dcf6e52f3181dbbc0d2863c136ad3ed'],1101,1,1102,732259,1093,1,0.4,0.8,1551
772fb0e9efce14840d857b3cc3985f7082b90792,0,Todd Lipcon,2016-01-07 22:33:33+00:00,['de157fa6a6b423d02ab4708aee872869db990da5'],10463,14739,25202,757461,1052,,,,1551
db430f50a77deee3cdfe46841c7c259959294e4a,0,Jean-Daniel Cryans,2016-01-07 23:57:10+00:00,['772fb0e9efce14840d857b3cc3985f7082b90792'],4,0,4,757465,2,,,,1551
31278211f1934890e6835c9db164a7dea87d826a,1,Mike Percy,2016-01-08 02:56:17+00:00,['db430f50a77deee3cdfe46841c7c259959294e4a'],7,11,18,757483,1,1,1,1,1551
e6cbd2171b979bfc8b6d3a582f76b3b20987e224,0,Todd Lipcon,2016-01-08 03:10:43+00:00,['31278211f1934890e6835c9db164a7dea87d826a'],2,1,3,757486,1,,,,1551
794aaca58bbc7ebc1c8ddafb35a2249a1b128540,0,Todd Lipcon,2016-01-08 03:11:05+00:00,['e6cbd2171b979bfc8b6d3a582f76b3b20987e224'],1,1,2,757488,1,,,,1551
b9b265d952bc93e1051df9c146d6b88369eea3ee,0,Todd Lipcon,2016-01-08 03:11:15+00:00,['794aaca58bbc7ebc1c8ddafb35a2249a1b128540'],4,7,11,757499,1,0,0,1,1551
55a5be984556dce20fce04cf089430696e084c5a,1,Todd Lipcon,2016-01-08 19:42:11+00:00,['b9b265d952bc93e1051df9c146d6b88369eea3ee'],30,273,303,757802,3,0.47008547,0.692307692,0.692307692,1552
1e033109e08a2882a93d230faa624802b3166edc,0,Todd Lipcon,2016-01-08 19:42:45+00:00,['55a5be984556dce20fce04cf089430696e084c5a'],0,3,3,757805,1,,,,1552
d4de1cd6170c07b1828b3a3855897139c790e2dd,0,Todd Lipcon,2016-01-08 19:43:27+00:00,['1e033109e08a2882a93d230faa624802b3166edc'],2,6,8,757813,1,,,,1552
ad9943376c0435d39968f8ea8840070de1a988b4,0,Todd Lipcon,2016-01-11 09:18:49+00:00,['d4de1cd6170c07b1828b3a3855897139c790e2dd'],0,65,65,757878,3,0.147058824,0.941176471,1,1552
556bf3b8d9cd8bfd4322456f6e3989bcac528a95,1,Todd Lipcon,2016-01-12 01:49:34+00:00,['ad9943376c0435d39968f8ea8840070de1a988b4'],3,10,13,757891,1,1,1,1,1552
b14ea5165c3772be8834cf70473788eaa7ee62d6,0,Todd Lipcon,2016-01-12 02:16:28+00:00,['556bf3b8d9cd8bfd4322456f6e3989bcac528a95'],0,3,3,757894,1,0,1,1,1552
815b02dbac8e2075c5de47931e1838531e9e9e35,0,Todd Lipcon,2016-01-12 03:40:06+00:00,['b14ea5165c3772be8834cf70473788eaa7ee62d6'],9,44,53,757947,1,1,1,1,1552
9806863e78107505a622b44112a897189d9b3c24,1,Dan Burkert,2016-01-13 16:49:49+00:00,['815b02dbac8e2075c5de47931e1838531e9e9e35'],3656,2943,6599,764546,421,1,0.043209877,0.240740741,1556
8ed68d7a5eda93f567992f8501c36fcece6dce05,0,Dan Burkert,2016-01-13 19:55:08+00:00,['9806863e78107505a622b44112a897189d9b3c24'],4,4,8,764554,2,,,,1556
160cb18f984769c9ed3b47fa180f0d5cfc20b010,0,Dan Burkert,2016-01-13 21:34:45+00:00,['8ed68d7a5eda93f567992f8501c36fcece6dce05'],2,9,11,764565,1,,,,1556
43bdbdcdead20df5e7adb5664e9cad1a4542722c,0,Dan Burkert,2016-01-14 01:37:37+00:00,['160cb18f984769c9ed3b47fa180f0d5cfc20b010'],2,2,4,764569,1,,,,1556
6f0a51bae1ba75169757869607e2243acce29d48,0,Todd Lipcon,2016-01-15 07:02:04+00:00,['43bdbdcdead20df5e7adb5664e9cad1a4542722c'],5,4,9,764578,2,,,,1556
3eafca50f30f56b699d5bb388fa6c9daa54a27a5,0,Todd Lipcon,2016-01-15 07:05:58+00:00,['6f0a51bae1ba75169757869607e2243acce29d48'],1,9,10,764588,1,,,,1556
9daafa5e795f1a2fc0cf571285caddc06ffbc5da,1,Dan Burkert,2016-01-15 19:59:28+00:00,['3eafca50f30f56b699d5bb388fa6c9daa54a27a5'],1127,944,2071,766659,255,1,0,1,1556
c8049c19faf5432a04a1cb795b9032d2859c648b,0,Todd Lipcon,2016-01-16 00:42:29+00:00,['9daafa5e795f1a2fc0cf571285caddc06ffbc5da'],1,47,48,766707,3,,,,1558
a80b83fe5e6a3cac1c310c2764fca0b6ca4a60e3,0,Todd Lipcon,2016-01-16 00:42:45+00:00,['c8049c19faf5432a04a1cb795b9032d2859c648b'],12,16,28,766735,3,0,0,1,1558
994fa40ec36f8874fb59585213b0363a9ecaa9be,0,Todd Lipcon,2016-01-16 00:43:09+00:00,['a80b83fe5e6a3cac1c310c2764fca0b6ca4a60e3'],5,18,23,766758,3,0,1,1,1558
704496559510972960e39c9e65e1091073d46d50,0,Todd Lipcon,2016-01-16 01:32:44+00:00,['994fa40ec36f8874fb59585213b0363a9ecaa9be'],1,1,2,766760,1,,,,1558
79130fc0afff08d3476794d0bb0d8e76fde54340,0,Todd Lipcon,2016-01-16 02:16:46+00:00,['704496559510972960e39c9e65e1091073d46d50'],0,2,2,766762,1,,,,1558
56f97d5577c2d7f7c6b9715aff250a0ca8d4fb1e,0,Todd Lipcon,2016-01-16 02:44:19+00:00,['79130fc0afff08d3476794d0bb0d8e76fde54340'],2,13,15,766777,4,0.5,0,1,1558
2cd52ba63562d04c76470a43f08ade0afcd625ca,0,Todd Lipcon,2016-01-16 05:55:15+00:00,['56f97d5577c2d7f7c6b9715aff250a0ca8d4fb1e'],4,10,14,766791,1,,,,1558
53f976f03eb88ea8487a7309cf08b7c9f9fb5fd7,1,Todd Lipcon,2016-01-16 21:25:21+00:00,['2cd52ba63562d04c76470a43f08ade0afcd625ca'],790,2514,3304,770095,23,0.962264151,1,0.95754717,1574
5489476ea2ebfada9e25a7b52beb67ae43413510,0,Todd Lipcon,2016-01-18 23:35:50+00:00,['53f976f03eb88ea8487a7309cf08b7c9f9fb5fd7'],3,54,57,770152,1,0.777777778,0.888888889,0.888888889,1574
35b49cc5a8af676d242b4f58306ccdde05097eb1,1,Dan Burkert,2016-01-19 22:27:49+00:00,['5489476ea2ebfada9e25a7b52beb67ae43413510'],916,919,1835,771987,201,0.333333333,0.666666667,1,1574
6193411835079dbf0098229e1975d77d4c9ee95a,1,Dan Burkert,2016-01-20 00:34:56+00:00,['35b49cc5a8af676d242b4f58306ccdde05097eb1'],1345,1046,2391,774378,200,0.390350877,0,0.543859649,1574
4bff0cc3cb65eeb4bd3a72d8ff6589fd542833f8,0,Dan Burkert,2016-01-20 00:35:06+00:00,['6193411835079dbf0098229e1975d77d4c9ee95a'],16,17,33,774411,7,1,1,1,1574
309afa48b8316cc4304852ac5e073bf60616e363,1,Dan Burkert,2016-01-20 01:43:00+00:00,['4bff0cc3cb65eeb4bd3a72d8ff6589fd542833f8'],183,152,335,774746,76,0.516129032,0.290322581,0.064516129,1574
2758065207c3ed5b610c12cf1753649642f38829,0,Mike Percy,2016-01-20 02:36:46+00:00,['309afa48b8316cc4304852ac5e073bf60616e363'],4,4,8,774754,1,,,,1574
bd7750c36de9d86cef3ad5e38414d8f42465403d,0,Dan Burkert,2016-01-20 21:49:47+00:00,['2758065207c3ed5b610c12cf1753649642f38829'],1,1,2,774756,1,,,,1574
52c0f28f8650b4d26788e407c2b1c0f193962245,0,Todd Lipcon,2016-01-20 23:47:09+00:00,['bd7750c36de9d86cef3ad5e38414d8f42465403d'],2,2,4,774760,1,,,,1574
3e8d29f4dd6d56da7be440730f6015b932e54b4b,1,Adar Dembo,2016-01-20 23:47:49+00:00,['52c0f28f8650b4d26788e407c2b1c0f193962245'],299,332,631,775391,21,,,,1574
3a31cfcb0e0c8142fa793bccb4222ce4c822ee12,1,Adar Dembo,2016-01-20 23:48:04+00:00,['3e8d29f4dd6d56da7be440730f6015b932e54b4b'],11,13,24,775415,1,,,,1574
4d8fbe7ee018543db25cc6f82fd98d4546deae3c,0,Dan Burkert,2016-01-21 05:02:59+00:00,['3a31cfcb0e0c8142fa793bccb4222ce4c822ee12'],26,7,33,775448,5,,,,1574
0d8da0850a53ed77e9ab848669224c3333c31635,0,Adar Dembo,2016-01-21 19:30:57+00:00,['4d8fbe7ee018543db25cc6f82fd98d4546deae3c'],10,14,24,775472,1,,,,1574
ed01385a7bbdc40161f93cd42da7f59301c2c06e,0,Todd Lipcon,2016-01-21 20:42:16+00:00,['0d8da0850a53ed77e9ab848669224c3333c31635'],28,61,89,775561,2,0.866666667,0.866666667,0.8,1574
21a61646af60832c33f472986c2699cc3eeb2bc6,0,Mike Percy,2016-01-22 00:15:49+00:00,['ed01385a7bbdc40161f93cd42da7f59301c2c06e'],0,2,2,775563,1,,,,1574
1c26565341d603e97956c95e7865036b7509c475,0,Todd Lipcon,2016-01-22 01:17:48+00:00,['21a61646af60832c33f472986c2699cc3eeb2bc6'],9,22,31,775594,1,1,1,0,1574
173e1fde4ea9f25a3d3aa9dc39706f0ad31834d0,0,Todd Lipcon,2016-01-22 01:17:55+00:00,['1c26565341d603e97956c95e7865036b7509c475'],4,4,8,775602,2,,,,1574
113d5b092097b6f9df20fdfc2cba3a551f906c07,0,Todd Lipcon,2016-01-22 01:20:54+00:00,['173e1fde4ea9f25a3d3aa9dc39706f0ad31834d0'],68,201,269,775871,6,0.528301887,0.943396226,0.41509434,1574
47d69dd6e66e61966ec83a44e3f25d90c9ed60cc,0,Todd Lipcon,2016-01-22 01:26:08+00:00,['113d5b092097b6f9df20fdfc2cba3a551f906c07'],187,158,345,776216,34,1,0.310344828,0.275862069,1574
efa7e825d574f04df85e486e0e2bff553293dc77,0,Todd Lipcon,2016-01-22 02:32:23+00:00,['47d69dd6e66e61966ec83a44e3f25d90c9ed60cc'],7,3,10,776226,1,,,,1574
8260093b9e53445801c8b69d9b69700721c965ce,0,Todd Lipcon,2016-01-22 02:32:29+00:00,['efa7e825d574f04df85e486e0e2bff553293dc77'],2,56,58,776284,2,1,1,1,1574
ae865a536a50e4c12daec39c24e053fe768e9c01,1,Jean-Daniel Cryans,2016-01-22 02:33:10+00:00,['8260093b9e53445801c8b69d9b69700721c965ce'],2,76,78,776362,4,0.08,0.72,1,1574
23c6c66d60c9addbd6c58f2bc73c71d496fb80a9,0,Todd Lipcon,2016-01-22 04:21:26+00:00,['ae865a536a50e4c12daec39c24e053fe768e9c01'],10,20,30,776392,3,,,,1574
89380b53d48b085dfe394b9966360d1ef1a4b038,0,Todd Lipcon,2016-01-22 04:21:52+00:00,['23c6c66d60c9addbd6c58f2bc73c71d496fb80a9'],10,14,24,776416,1,,,,1574
3d4e0ce8af061eb574ca0bbe735e99c59e444266,0,Todd Lipcon,2016-01-22 04:23:03+00:00,['89380b53d48b085dfe394b9966360d1ef1a4b038'],64,77,141,776557,1,,,,1574
02df16604babe92d030c9b930e73bc7c1dfac1fa,1,Todd Lipcon,2016-01-22 04:39:46+00:00,['3d4e0ce8af061eb574ca0bbe735e99c59e444266'],15,74,89,776646,4,1,1,0.5,1574
353b5ec48e0ac44b7c5e1a3f6d4e281eeb22a02e,0,Dan Burkert,2016-01-22 17:12:46+00:00,['02df16604babe92d030c9b930e73bc7c1dfac1fa'],9,30,39,776685,3,,,,1574
a65bbcc8e939ae48e5f8b3aa7bde9a46169a874c,1,Dan Burkert,2016-01-22 17:12:51+00:00,['353b5ec48e0ac44b7c5e1a3f6d4e281eeb22a02e'],8,109,117,776802,1,,,,1574
dda74081f91b1086c85b4b9a2aaa9fc392c62c9c,0,Dan Burkert,2016-01-22 17:19:47+00:00,['a65bbcc8e939ae48e5f8b3aa7bde9a46169a874c'],25,15,40,776842,1,,,,1574
e503538af271ba078fa357a516f549a4d91a24f7,0,Adar Dembo,2016-01-22 20:56:01+00:00,['dda74081f91b1086c85b4b9a2aaa9fc392c62c9c'],1,3,4,776846,1,,,,1574
e2d60150da8c34718e2997d82b7de593e8a95fe9,0,Todd Lipcon,2016-01-22 21:05:33+00:00,['e503538af271ba078fa357a516f549a4d91a24f7'],1,6,7,776853,1,,,,1574
77d101b74451003ad15882c6327eb35227fb31c2,0,Todd Lipcon,2016-01-22 21:06:11+00:00,['e2d60150da8c34718e2997d82b7de593e8a95fe9'],11,62,73,776926,1,,,,1574
4edf27fd62bfb90469022082b85f25439fd0d809,0,Adar Dembo,2016-01-22 21:14:19+00:00,['77d101b74451003ad15882c6327eb35227fb31c2'],39,8,47,776973,3,0.5,0,0,1574
0e8864632e9a31d1c1d4c297266622046717ef6d,0,Todd Lipcon,2016-01-22 22:52:07+00:00,['4edf27fd62bfb90469022082b85f25439fd0d809'],3,3,6,776979,1,,,,1574
05add04e1b560c537ccb759f3ea272dfef7bf2d0,0,Todd Lipcon,2016-01-22 23:05:01+00:00,['0e8864632e9a31d1c1d4c297266622046717ef6d'],0,71,71,777050,2,0.510638298,1,1,1574
75d72445161ccdb75fe4a8aa86ad8500335d1149,1,Todd Lipcon,2016-01-23 00:03:30+00:00,['05add04e1b560c537ccb759f3ea272dfef7bf2d0'],303,537,840,777890,12,0.985507246,1,1,1575
690f3594db9f27bc77186a1216d20e5c83e4bb27,0,Todd Lipcon,2016-01-23 02:33:49+00:00,['75d72445161ccdb75fe4a8aa86ad8500335d1149'],0,19,19,777909,1,1,1,1,1575
be3ea35bc7c9cc7e412acf9c426effae91e72467,0,Adar Dembo,2016-01-23 02:47:39+00:00,['690f3594db9f27bc77186a1216d20e5c83e4bb27'],4,5,9,777918,1,,,,1575
faeffdc9d2496fd4cf98d6fabfaff0c7b582572f,0,Dan Burkert,2016-01-23 19:01:44+00:00,['be3ea35bc7c9cc7e412acf9c426effae91e72467'],4,12,16,777934,2,,,,1575
687fabf40e9dd420bf7846a7f5e02a4ea6b62f53,0,Todd Lipcon,2016-01-25 03:43:33+00:00,['faeffdc9d2496fd4cf98d6fabfaff0c7b582572f'],2,3,5,777939,2,1,1,1,1575
c5d748198df48007b2a6fe07c2a214a885fc41ee,0,Todd Lipcon,2016-01-25 03:46:19+00:00,['687fabf40e9dd420bf7846a7f5e02a4ea6b62f53'],8,39,47,777986,3,1,0.736842105,1,1575
0d891c1baff8d9fdc7041c2b4a65a73853128da5,0,Todd Lipcon,2016-01-25 04:05:24+00:00,['c5d748198df48007b2a6fe07c2a214a885fc41ee'],1,1,2,777988,1,,,,1575
a10e3739a0e1b75289b49f31e094a095e2fd7bea,0,Todd Lipcon,2016-01-25 04:05:46+00:00,['0d891c1baff8d9fdc7041c2b4a65a73853128da5'],46,27,73,778061,7,0.5,0.1,1,1575
ffd84cf9c34b1c4fee74cafc04515ba313b6fd9b,1,Todd Lipcon,2016-01-25 05:55:41+00:00,['a10e3739a0e1b75289b49f31e094a095e2fd7bea'],10,89,99,778160,4,0.464285714,1,1,1575
76e285e7f267da5b14f87cebf12cc28b4b28bd3b,0,Todd Lipcon,2016-01-25 19:58:10+00:00,['ffd84cf9c34b1c4fee74cafc04515ba313b6fd9b'],21,44,65,778225,2,0.875,1,0,1575
7900bd5ce73a203aff565aae0996a8e53c4926ea,0,Todd Lipcon,2016-01-26 01:28:58+00:00,['76e285e7f267da5b14f87cebf12cc28b4b28bd3b'],4,25,29,778254,2,,,,1575
a724818c52774584b5966e201abefeae1dcdf04f,0,Todd Lipcon,2016-01-26 01:47:22+00:00,['7900bd5ce73a203aff565aae0996a8e53c4926ea'],135,191,326,778580,33,0,1,0.571428571,1576
21df2bab4c2ba3101fa00571745386f07627964f,0,David Ribeiro Alves,2016-01-26 04:20:54+00:00,['a724818c52774584b5966e201abefeae1dcdf04f'],1,10,11,778591,1,,,,1576
3df123ac7f71b44f64393c6637cebfffa38e623d,0,Todd Lipcon,2016-01-26 16:34:14+00:00,['21df2bab4c2ba3101fa00571745386f07627964f'],0,9,9,778600,1,,,,1576
242e5da4652b0a8808240278d5a86556d4e59164,0,Jean-Daniel Cryans,2016-01-26 17:05:06+00:00,['3df123ac7f71b44f64393c6637cebfffa38e623d'],1,9,10,778610,1,0,0,1,1576
f090254322c5445f0d1d7098cadb279ad78250e0,1,Todd Lipcon,2016-01-26 17:13:16+00:00,['242e5da4652b0a8808240278d5a86556d4e59164'],6,8,14,778624,1,1,1,0,1576
1204c0a9afb28687e8b2312429d71fa8589cc62f,1,Todd Lipcon,2016-01-26 20:46:14+00:00,['f090254322c5445f0d1d7098cadb279ad78250e0'],30,238,268,778892,10,0.18627451,0.696078431,0.882352941,1577
c7a9b1211d0b5c1f2102021260e8f14acb511182,0,Todd Lipcon,2016-01-26 21:24:12+00:00,['1204c0a9afb28687e8b2312429d71fa8589cc62f'],23,36,59,778951,3,,,,1578
c555103cd9589f98fd025ce1f6dff705ddc4f057,0,Adar Dembo,2016-01-26 22:16:58+00:00,['c7a9b1211d0b5c1f2102021260e8f14acb511182'],1,1,2,778953,1,,,,1578
a12d87e4939221bdbfe372ea906840e053e39335,0,Todd Lipcon,2016-01-27 01:30:13+00:00,['c555103cd9589f98fd025ce1f6dff705ddc4f057'],8,6,14,778967,2,1,0,1,1578
de6df2e9cf17a88829afbfc52018f3271c874aa4,0,Todd Lipcon,2016-01-27 19:41:46+00:00,['a12d87e4939221bdbfe372ea906840e053e39335'],4,26,30,778997,2,0,1,1,1578
b8ccfd06f9ebc1035462230676acb9b6b6baf031,0,Todd Lipcon,2016-01-27 21:51:23+00:00,['de6df2e9cf17a88829afbfc52018f3271c874aa4'],0,20,20,779017,2,,,,1579
1aeb75bbe57a347b5e60b184d6916309845ff3d0,1,Todd Lipcon,2016-01-27 22:51:02+00:00,['b8ccfd06f9ebc1035462230676acb9b6b6baf031'],729,863,1592,780609,3,,,,1581
8325d5d7ef90c54ea106e47efd24ad83d5b4a56d,0,Todd Lipcon,2016-01-27 23:31:48+00:00,['1aeb75bbe57a347b5e60b184d6916309845ff3d0'],1,1,2,780611,1,,,,1581
fefa29cae7698ffc7833138a78228f93a2d1d2ce,0,Todd Lipcon,2016-01-28 00:47:00+00:00,['8325d5d7ef90c54ea106e47efd24ad83d5b4a56d'],34,208,242,780853,6,0.807228916,1,1,1583
143826e88c26ed4347177453caecdf193e6f8b7a,0,Todd Lipcon,2016-01-28 02:08:24+00:00,['fefa29cae7698ffc7833138a78228f93a2d1d2ce'],20,50,70,780923,1,,,,1583
67f2ed946d28bf1b16db92fa164735a1e1ffc07c,1,Todd Lipcon,2016-01-28 02:22:16+00:00,['143826e88c26ed4347177453caecdf193e6f8b7a'],1,228,229,781152,4,0.494117647,1,1,1586
b7067c6453b1b866853a9e3b29f3017ab6d1b973,1,Todd Lipcon,2016-01-28 18:41:37+00:00,['67f2ed946d28bf1b16db92fa164735a1e1ffc07c'],4,59,63,781215,3,0.15625,0.78125,0.78125,1586
3fe66efdc9cf5b4beab17cd565eca1b30417771e,0,Jean-Daniel Cryans,2016-01-28 19:42:32+00:00,['b7067c6453b1b866853a9e3b29f3017ab6d1b973'],1,1,2,781217,1,,,,1586
396bbae5799433abf1d14e489d5af2386fbe3a10,0,Todd Lipcon,2016-01-28 20:49:52+00:00,['3fe66efdc9cf5b4beab17cd565eca1b30417771e'],1,1,2,781219,1,,,,1586
222ba7352495c5a73328a31a20d50af737ea4df0,0,Adar Dembo,2016-01-28 21:34:56+00:00,['396bbae5799433abf1d14e489d5af2386fbe3a10'],0,3,3,781222,1,,,,1586
eb592b298c25232505a1d749e06bb84c78186c74,0,Dan Burkert,2016-01-29 00:28:47+00:00,['222ba7352495c5a73328a31a20d50af737ea4df0'],2,3,5,781227,1,0,0,0,1586
48a7b2f0be477d897573d46f135daeb5f90abf8b,0,Jean-Daniel Cryans,2016-01-29 18:39:48+00:00,['eb592b298c25232505a1d749e06bb84c78186c74'],43,106,149,781376,3,0.777777778,1,0.481481481,1586
d70305c4f03015ffff8292446b0c9c580fc4dbc0,0,Jean-Daniel Cryans,2016-01-29 18:45:35+00:00,['48a7b2f0be477d897573d46f135daeb5f90abf8b'],24,87,111,781487,4,0.8125,0,1,1586
588abf6fa9d572ae907407e3fe0e7c62fb5d1e4f,0,Misty Stanley-Jones,2016-01-29 18:50:52+00:00,['d70305c4f03015ffff8292446b0c9c580fc4dbc0'],1,1,2,781489,1,,,,1586
f3f3996a61494db9cff29dd2e84397478fb8edc3,0,Adar Dembo,2016-01-29 20:05:46+00:00,['588abf6fa9d572ae907407e3fe0e7c62fb5d1e4f'],95,157,252,781741,22,0,1,1,1586
2277d8d786268973292e98d5847f2877a8af66f6,0,Adar Dembo,2016-01-29 20:05:57+00:00,['f3f3996a61494db9cff29dd2e84397478fb8edc3'],1,0,1,781742,1,,,,1586
dd9f9d2ff5ae26ceedd6eba26a52232ab869498e,0,Adar Dembo,2016-01-29 20:28:58+00:00,['2277d8d786268973292e98d5847f2877a8af66f6'],5,5,10,781752,1,,,,1586
f461e0a5e6a5b2a936c253065f078c8fc83e070a,0,Adar Dembo,2016-01-29 20:49:20+00:00,['dd9f9d2ff5ae26ceedd6eba26a52232ab869498e'],0,16,16,781768,1,,,,1586
82fdeb64e19dc7f5c5183866b4242a17e58e686a,0,David Ribeiro Alves,2016-01-29 21:15:31+00:00,['f461e0a5e6a5b2a936c253065f078c8fc83e070a'],2,5,7,781775,1,,,,1586
da637d20d47ded557188edf44865e159dee7202e,0,Dan Burkert,2016-01-29 21:39:31+00:00,['82fdeb64e19dc7f5c5183866b4242a17e58e686a'],0,1,1,781776,1,0,1,1,1586
18dbc453a38c9e43839dbd063e60e4e679ad80cd,0,Todd Lipcon,2016-01-29 22:28:03+00:00,['da637d20d47ded557188edf44865e159dee7202e'],0,13,13,781789,1,,,,1586
30773866cfec5c112e1b3f385808d88eeaa1d586,1,Todd Lipcon,2016-01-29 23:52:10+00:00,['18dbc453a38c9e43839dbd063e60e4e679ad80cd'],12,376,388,782177,12,0.412935323,0.527363184,0.855721393,1586
7e34050c1b35cd51f39fe228aabc7ed4a9a2db7a,0,Todd Lipcon,2016-01-30 02:18:44+00:00,['30773866cfec5c112e1b3f385808d88eeaa1d586'],13,17,30,782207,10,1,1,0.5,1586
ee13c00a5df5d4ad1cac05b49048a9eae256e2f2,0,Dan Burkert,2016-01-30 02:53:05+00:00,['7e34050c1b35cd51f39fe228aabc7ed4a9a2db7a'],34,0,34,782241,1,,,,1586
7a68e1f8baee04eaf259f7567ddc39e09a0f0938,0,Dan Burkert,2016-01-30 02:54:36+00:00,['ee13c00a5df5d4ad1cac05b49048a9eae256e2f2'],8,11,19,782260,4,,,,1586
4cc1a03b9c9ca2dd0452960ded6e0c541e58df14,0,Dan Burkert,2016-01-30 17:19:04+00:00,['7a68e1f8baee04eaf259f7567ddc39e09a0f0938'],0,11,11,782271,1,,,,1586
cecdb47ce4887bf4903acd825e26158b200e14e9,0,Todd Lipcon,2016-02-02 01:58:49+00:00,['4cc1a03b9c9ca2dd0452960ded6e0c541e58df14'],0,3,3,782274,1,0,1,1,1586
64bd51c5795ac9726734f29b4060e9fae9dd2b72,0,Todd Lipcon,2016-02-02 02:00:19+00:00,['cecdb47ce4887bf4903acd825e26158b200e14e9'],0,7,7,782281,1,,,,1586
197b5fa1a754510a01ac934e8ed5b966de8da29f,0,Todd Lipcon,2016-02-02 02:55:13+00:00,['64bd51c5795ac9726734f29b4060e9fae9dd2b72'],0,6,6,782287,1,0,1,1,1586
e078f77e159a50d5c11788da59262e0f27831b47,0,Todd Lipcon,2016-02-02 02:55:46+00:00,['197b5fa1a754510a01ac934e8ed5b966de8da29f'],4,1,5,782292,1,0,0,0,1586
0b5545bc30518f895dd4c6936188831453252a7f,0,Todd Lipcon,2016-02-02 06:54:55+00:00,['e078f77e159a50d5c11788da59262e0f27831b47'],33,65,98,782390,5,1,1,1,1586
266d214b123dfe2db610ec41de00908495eae6ba,0,Todd Lipcon,2016-02-02 07:04:24+00:00,['0b5545bc30518f895dd4c6936188831453252a7f'],14,33,47,782437,3,1,1,1,1586
ba3a17a2f12ae546d290fd03e75b5e0c347787dc,1,Dan Burkert,2016-02-02 18:11:33+00:00,['266d214b123dfe2db610ec41de00908495eae6ba'],0,598,598,783035,8,0.772151899,0.772151899,0.810126582,1593
0f609bd3916e55e2f4594caadcfde5909a0cdb84,0,Todd Lipcon,2016-02-02 20:08:34+00:00,['ba3a17a2f12ae546d290fd03e75b5e0c347787dc'],10,84,94,783129,4,,,,1595
ab2c673d9928a3e035ba6b15a9853587f56cc3af,1,Adar Dembo,2016-02-02 21:03:38+00:00,['0f609bd3916e55e2f4594caadcfde5909a0cdb84'],34,80,114,783243,7,0,0.285714286,0.542857143,1595
744138a5e6507b00324ac030fc276c3d3a9d3337,0,Todd Lipcon,2016-02-02 21:48:46+00:00,['ab2c673d9928a3e035ba6b15a9853587f56cc3af'],6,4,10,783253,3,,,,1595
fd6d805fa4f86a4ff0decd7890e3766c3d0cd7ca,0,David Ribeiro Alves,2016-02-02 22:23:21+00:00,['744138a5e6507b00324ac030fc276c3d3a9d3337'],2,3,5,783258,3,1,,1,1595
c613d89bab646fd5df6add7ede047b7b6533a102,1,Dan Burkert,2016-02-03 00:20:44+00:00,['fd6d805fa4f86a4ff0decd7890e3766c3d0cd7ca'],43,10,53,783311,3,,,,1595
b2d0ecbd6cba85c010efb2d08dbc7e9a9ffe96fe,0,Jean-Daniel Cryans,2016-02-03 01:21:21+00:00,['c613d89bab646fd5df6add7ede047b7b6533a102'],9,9,18,783329,8,,,,1595
cf1acc6bee8352898a5a164790a26dd2dcc25071,0,Adar Dembo,2016-02-03 08:30:45+00:00,['b2d0ecbd6cba85c010efb2d08dbc7e9a9ffe96fe'],46,37,83,783412,1,,,,1595
72d4b04477583238c2e2a60dc7cc27ad619722b8,0,David Ribeiro Alves,2016-02-03 19:35:48+00:00,['cf1acc6bee8352898a5a164790a26dd2dcc25071'],7,87,94,783506,3,0,1,1,1596
affa0e4fe764c6d247741f4df98c6f8c0925472b,0,Todd Lipcon,2016-02-03 23:01:49+00:00,['72d4b04477583238c2e2a60dc7cc27ad619722b8'],61,3,64,783570,7,,,,1596
bd4927265e3e56722e5f2b9a41f6a3dc450c9b9b,0,Todd Lipcon,2016-02-03 23:02:38+00:00,['affa0e4fe764c6d247741f4df98c6f8c0925472b'],6,7,13,783583,2,,,,1596
f00d20c76973975cfbf7c681bc9caf849c4f22e1,1,Jean-Daniel Cryans,2016-02-03 23:44:07+00:00,['bd4927265e3e56722e5f2b9a41f6a3dc450c9b9b'],28,113,141,783724,5,0.070422535,0.309859155,1,1596
403f9da9619aba0f84fb6729868edf2a88063cc9,1,David Ribeiro Alves,2016-02-04 03:55:10+00:00,['f00d20c76973975cfbf7c681bc9caf849c4f22e1'],8,57,65,783789,7,0.619047619,0.714285714,0.571428571,1596
b6fb4498c012323dfe5b041737a6e06f89550219,0,David Ribeiro Alves,2016-02-04 04:11:48+00:00,['403f9da9619aba0f84fb6729868edf2a88063cc9'],0,10,10,783799,3,0.5,1,1,1596
acbb5b75fb1104ef4d0b1c78b57e3efd2619c07a,1,David Ribeiro Alves,2016-02-04 04:13:29+00:00,['b6fb4498c012323dfe5b041737a6e06f89550219'],6,14,20,783819,2,0,1,1,1596
262838322871f69085ab8ef9dedda19dac593fb1,0,David Ribeiro Alves,2016-02-04 04:25:44+00:00,['acbb5b75fb1104ef4d0b1c78b57e3efd2619c07a'],1,16,17,783836,3,1,1,1,1596
1a24338ad60a8842d1ae5e227f8f03e58faea8c0,1,Todd Lipcon,2016-02-04 05:14:05+00:00,['262838322871f69085ab8ef9dedda19dac593fb1'],44,119,163,783999,12,0,0.84,0.24,1596
a0fe4eb2dc3579f7434a3fd3c94da06d4f43bb3e,0,Dan Burkert,2016-02-04 06:21:19+00:00,['1a24338ad60a8842d1ae5e227f8f03e58faea8c0'],0,2,2,784001,1,,,,1596
68a0aff59bc769656f7d10b0b7a93b6fcfac3edf,0,Jean-Daniel Cryans,2016-02-04 21:02:32+00:00,['a0fe4eb2dc3579f7434a3fd3c94da06d4f43bb3e'],8,11,19,784020,4,,,,1596
dcfb985a30856ba2ff9f35b13fb5a27455596370,0,Jean-Daniel Cryans,2016-02-04 22:11:06+00:00,['68a0aff59bc769656f7d10b0b7a93b6fcfac3edf'],21,34,55,784075,1,0,0.833333333,0.166666667,1596
b0b051b9af90352023c11019b06e260fcfa171e2,0,Jean-Daniel Cryans,2016-02-04 23:39:20+00:00,['dcfb985a30856ba2ff9f35b13fb5a27455596370'],3,18,21,784096,2,0,1,0.769230769,1596
1ad16aa0b742a75b86152cd7034f150674070606,1,Jean-Daniel Cryans,2016-02-04 23:39:30+00:00,['b0b051b9af90352023c11019b06e260fcfa171e2'],7,34,41,784137,2,1,1,1,1596
c0f6fdd834fd499f10eecbdc726da438a6202bf5,0,David Ribeiro Alves,2016-02-05 00:24:21+00:00,['1ad16aa0b742a75b86152cd7034f150674070606'],15,28,43,784180,3,1,1,1,1596
4294cbe594c7febd6a763ed6e336bc3bf979d6b1,0,David Ribeiro Alves,2016-02-05 20:40:53+00:00,['c0f6fdd834fd499f10eecbdc726da438a6202bf5'],3,72,75,784255,4,1,1,1,1596
6d74508a922b8d3d8ba0518b5eb63acd10c222ae,1,David Ribeiro Alves,2016-02-05 20:41:20+00:00,['4294cbe594c7febd6a763ed6e336bc3bf979d6b1'],1,6,7,784262,2,0,1,1,1596
786834d1d4b4313535c2763db7022a25ce1e1dd0,0,David Ribeiro Alves,2016-02-05 20:41:26+00:00,['6d74508a922b8d3d8ba0518b5eb63acd10c222ae'],2,20,22,784284,2,1,1,1,1596
8581923d4702fc16d8eaee47471532129a449c75,0,David Ribeiro Alves,2016-02-05 20:41:33+00:00,['786834d1d4b4313535c2763db7022a25ce1e1dd0'],19,16,35,784319,2,,,,1596
c68509b4d29d050d6264f5ef189f86e3fe221997,0,David Ribeiro Alves,2016-02-05 20:44:11+00:00,['8581923d4702fc16d8eaee47471532129a449c75'],11,2,13,784332,4,0,0,1,1596
4a9e2ca0713741bbb7edc8925dadb8b36d8d5560,1,David Ribeiro Alves,2016-02-05 23:32:44+00:00,['c68509b4d29d050d6264f5ef189f86e3fe221997'],0,71,71,784403,2,0,1,1,1596
b8415129204d26508b5e45b57dce020280bdbc69,1,David Ribeiro Alves,2016-02-05 23:32:54+00:00,['4a9e2ca0713741bbb7edc8925dadb8b36d8d5560'],17,44,61,784464,11,0,0.647058824,0.941176471,1596
802d0e4c53f12b4392544ee10dfb530a25812d4f,0,Jean-Daniel Cryans,2016-02-06 18:40:14+00:00,['b8415129204d26508b5e45b57dce020280bdbc69'],3,3,6,784470,1,,,,1596
2d029b34e78b0f880f85abf63499fa9dc4037f50,0,Adar Dembo,2016-02-06 22:24:06+00:00,['802d0e4c53f12b4392544ee10dfb530a25812d4f'],3,79,82,784552,1,,,,1596
e77f8d1e529fd9d5067748d1d1f5a91f2d7d7e0a,0,Dan Burkert,2016-02-10 21:41:27+00:00,['2d029b34e78b0f880f85abf63499fa9dc4037f50'],5,2,7,784559,2,,,,1596
ce7dfd9a21e695f09c13e0babc56aa5ecede9803,1,Jean-Daniel Cryans,2016-02-11 23:26:57+00:00,['e77f8d1e529fd9d5067748d1d1f5a91f2d7d7e0a'],13,41,54,784613,1,,,,1596
983de45f1b64730d917dd98907f381f7d196f92c,0,Jean-Daniel Cryans,2016-02-11 23:27:22+00:00,['ce7dfd9a21e695f09c13e0babc56aa5ecede9803'],1,1,2,784615,1,,,,1596
241e650c5aff36dad3c15d0331c4ceb33038d6e3,0,Jean-Daniel Cryans,2016-02-11 23:28:56+00:00,['983de45f1b64730d917dd98907f381f7d196f92c'],1,5,6,784621,1,,,,1596
2567ed0087ed6664a93ce1400e5f4f89c730cb14,0,Jean-Daniel Cryans,2016-02-11 23:29:25+00:00,['241e650c5aff36dad3c15d0331c4ceb33038d6e3'],2,22,24,784645,1,,,,1596
715722bc989d5db441d04839110a601178416515,0,Misty Stanley-Jones,2016-02-11 23:48:39+00:00,['2567ed0087ed6664a93ce1400e5f4f89c730cb14'],75,118,193,784838,1,,,,1596
6bb2cfbd1501dd828d9d137c6a4134f6cd16d099,0,Todd Lipcon,2016-02-12 03:46:58+00:00,['715722bc989d5db441d04839110a601178416515'],0,6,6,784844,1,,,,1596
d179a7e53ab8c9773b3203772fcb1c53d55fac24,0,Todd Lipcon,2016-02-12 03:47:03+00:00,['6bb2cfbd1501dd828d9d137c6a4134f6cd16d099'],1,29,30,784874,2,,,,1596
88ddc9d281b936a6cfc02de3439ef0775d6b21ef,0,Jean-Daniel Cryans,2016-02-12 16:02:39+00:00,['d179a7e53ab8c9773b3203772fcb1c53d55fac24'],0,1,1,784875,1,0,1,0,1596
682c664d54111dc923c5960779231a93e3bf098f,0,Todd Lipcon,2016-02-13 00:59:42+00:00,['88ddc9d281b936a6cfc02de3439ef0775d6b21ef'],2,1,3,784878,1,,,,1596
1ba703035c8d1b5327321d5b6a3f28d6bb3c1158,0,David Ribeiro Alves,2016-02-16 20:26:21+00:00,['682c664d54111dc923c5960779231a93e3bf098f'],5,6,11,784889,1,1,1,1,1596
31058c6cf3593c66d7b2e0c696cd533fb1db8510,0,Jean-Daniel Cryans,2016-02-17 00:03:16+00:00,['1ba703035c8d1b5327321d5b6a3f28d6bb3c1158'],13,580,593,785482,35,,,,1596
3378c7c0658b26da61ba186a2c92c949c6efb22a,0,Jean-Daniel Cryans,2016-02-17 00:21:08+00:00,['31058c6cf3593c66d7b2e0c696cd533fb1db8510'],40,29,69,785551,2,,,,1596
a2a2f3f7106aa625471cfa93db000f6452818dee,0,Dan Burkert,2016-02-17 01:33:16+00:00,['3378c7c0658b26da61ba186a2c92c949c6efb22a'],3,147,150,785701,3,0.848214286,1,1,1596
7b1ea74ee7ed617a78fdc807ac41505fcea64535,0,Jean-Daniel Cryans,2016-02-17 01:34:07+00:00,['a2a2f3f7106aa625471cfa93db000f6452818dee'],4,3,7,785708,1,1,0,0,1596
444007746895122687fb9c8ea5274fb15974fe37,0,Misty Stanley-Jones,2016-02-17 18:25:30+00:00,['7b1ea74ee7ed617a78fdc807ac41505fcea64535'],0,10,10,785718,1,,,,1597
e284a93c40740ad8bd3b5b95ee31e98c24aa4a6f,0,Todd Lipcon,2016-02-18 02:12:04+00:00,['444007746895122687fb9c8ea5274fb15974fe37'],14,42,56,785774,3,0.173913043,1,0.956521739,1597
9ca41277167240084f0731a97255ccfce0bf3e80,0,Todd Lipcon,2016-02-18 02:14:51+00:00,['e284a93c40740ad8bd3b5b95ee31e98c24aa4a6f'],15,17,32,785806,2,1,1,1,1597
3e6c303375eb82e59d86bcd4c6bdf999336342ff,0,Todd Lipcon,2016-02-18 02:14:55+00:00,['9ca41277167240084f0731a97255ccfce0bf3e80'],1,1,2,785808,1,,,,1597
e2b019e6b22e47455d4521741aaac3095a4a2547,0,Todd Lipcon,2016-02-18 02:49:39+00:00,['3e6c303375eb82e59d86bcd4c6bdf999336342ff'],1,107,108,785916,2,0,0.612903226,0.64516129,1597
fc86225c55b445a269ec9d9d3ad63a5c2dd7282c,0,Todd Lipcon,2016-02-18 04:18:30+00:00,['e2b019e6b22e47455d4521741aaac3095a4a2547'],0,218,218,786134,2,,,,1598
c004cedc6cd5e32ec2d7ee9cd3c26e2f4d4d89ab,0,David Ribeiro Alves,2016-02-18 21:03:02+00:00,['fc86225c55b445a269ec9d9d3ad63a5c2dd7282c'],98,121,219,786353,10,,,,1598
59db0e0f2816299d4b61b1b6cb0eecca0452acb7,0,Misty Stanley-Jones,2016-02-18 21:09:06+00:00,['c004cedc6cd5e32ec2d7ee9cd3c26e2f4d4d89ab'],3,4,7,786360,1,,,,1598
7ec173f7bda03f9bd09d3945b3e2fbb4f43b83c4,0,Dan Burkert,2016-02-18 22:29:24+00:00,['59db0e0f2816299d4b61b1b6cb0eecca0452acb7'],5,4,9,786369,1,,,,1598
6991cd432d0be35743995b3ca7cb5eedc072e3cb,0,Todd Lipcon,2016-02-18 23:44:32+00:00,['7ec173f7bda03f9bd09d3945b3e2fbb4f43b83c4'],0,4,4,786373,1,,,,1598
d43ec1e9d5408c146c48bd4f74c1e6ccedb9611b,1,Todd Lipcon,2016-02-19 04:46:08+00:00,['6991cd432d0be35743995b3ca7cb5eedc072e3cb'],8,4,12,786385,2,1,1,1,1598
dbc1de3f5346f14fddf4b5d99f7ce381075a31f9,0,Todd Lipcon,2016-02-21 23:16:20+00:00,['d43ec1e9d5408c146c48bd4f74c1e6ccedb9611b'],1,4,5,786390,1,0,1,1,1598
b3efaf029a5259f535cded5b21e9c1003bb75726,0,Jean-Daniel Cryans,2016-02-22 23:43:20+00:00,['dbc1de3f5346f14fddf4b5d99f7ce381075a31f9'],0,265,265,786655,3,,,,1601
2878c586259ecf00d7f2623c27b27e640cc799bd,1,Jean-Daniel Cryans,2016-02-22 23:44:39+00:00,['b3efaf029a5259f535cded5b21e9c1003bb75726'],68,138,206,786861,4,0.142857143,0,1,1601
6a6a9c27603f28cb77726f974d3b61e886cd7f77,0,Todd Lipcon,2016-02-22 23:52:00+00:00,['2878c586259ecf00d7f2623c27b27e640cc799bd'],7,6,13,786874,2,,,,1601
6737d78e8e8d294af21d31ab46e92e91d7466dd8,1,Todd Lipcon,2016-02-22 23:52:09+00:00,['6a6a9c27603f28cb77726f974d3b61e886cd7f77'],37,34,71,786945,4,1,1,1,1601
7b157c5c1b494de41cfbabd35f44eff2bf4bf8c8,0,Todd Lipcon,2016-02-22 23:52:16+00:00,['6737d78e8e8d294af21d31ab46e92e91d7466dd8'],21,19,40,786985,4,0,0,0,1601
86f922864e6ebc14c959028294b095aa6b2e576f,0,Todd Lipcon,2016-02-23 00:08:57+00:00,['7b157c5c1b494de41cfbabd35f44eff2bf4bf8c8'],0,10,10,786995,1,,,,1601
ff3626697cc71e6e3579daf80faa97b2488f976e,0,Todd Lipcon,2016-02-23 00:09:57+00:00,['86f922864e6ebc14c959028294b095aa6b2e576f'],6,7,13,787008,1,,,,1601
d0a02cd42081d2182652fd1d246227ebae3543fd,1,Todd Lipcon,2016-02-23 00:10:05+00:00,['ff3626697cc71e6e3579daf80faa97b2488f976e'],244,245,489,787497,80,0,1,0,1601
c9a20d01382fc9920116c85178e27ce69bf5609a,0,Todd Lipcon,2016-02-23 00:10:17+00:00,['d0a02cd42081d2182652fd1d246227ebae3543fd'],12,10,22,787519,7,1,0,0,1601
534768f6b1ad85286cc8fdf05ab3a52202704cbd,0,Todd Lipcon,2016-02-23 04:22:21+00:00,['c9a20d01382fc9920116c85178e27ce69bf5609a'],1,1,2,787521,1,,,,1601
8514b9e0fed13ec48b9fe8ca3feb298b07133e42,0,Todd Lipcon,2016-02-23 04:22:34+00:00,['534768f6b1ad85286cc8fdf05ab3a52202704cbd'],29,70,99,787620,3,0.555555556,1,1,1601
b48d9f633d21fce7d45c94db39750aff460747c5,0,Jean-Daniel Cryans,2016-02-23 23:05:52+00:00,['8514b9e0fed13ec48b9fe8ca3feb298b07133e42'],4,73,77,787697,2,0.225806452,1,1,1602
cd37e8d1d40c6ec2e4e638259429f5024e309f2a,0,Todd Lipcon,2016-02-25 22:09:11+00:00,['b48d9f633d21fce7d45c94db39750aff460747c5'],1,5,6,787703,1,0,1,1,1602
d64ee4a2d548a1d4b3997eea7f546ef290f5d366,0,Todd Lipcon,2016-02-25 22:10:43+00:00,['cd37e8d1d40c6ec2e4e638259429f5024e309f2a'],2,56,58,787761,3,0.368421053,0.973684211,1,1602
a393b9c6876c2a114f18ef582d186a7d4180d140,0,Adar Dembo,2016-02-25 22:13:38+00:00,['d64ee4a2d548a1d4b3997eea7f546ef290f5d366'],56,34,90,787851,4,,,,1602
0548324a855c1fe8dff8c224b010a45fcbb6eabd,0,Todd Lipcon,2016-02-25 23:20:02+00:00,['a393b9c6876c2a114f18ef582d186a7d4180d140'],0,97,97,787948,2,0,1,1,1603
d43a91f6692fd8eb32c429932f10d2654222289f,0,Adar Dembo,2016-02-25 23:29:04+00:00,['0548324a855c1fe8dff8c224b010a45fcbb6eabd'],1,1,2,787950,1,,,,1603
7a0244c8c539dd800b7269c32a6826d2fdad43d9,0,Adar Dembo,2016-02-26 02:50:28+00:00,['d43a91f6692fd8eb32c429932f10d2654222289f'],37,34,71,788021,2,,,,1603
25cac568ba5b60615bd9cc719dc5a46194ac9802,0,Adar Dembo,2016-02-26 06:48:24+00:00,['7a0244c8c539dd800b7269c32a6826d2fdad43d9'],93,174,267,788288,16,0,1,1,1604
d17c74f321a1670dfb63a68d8123f7530a249cde,0,Todd Lipcon,2016-02-26 08:25:53+00:00,['25cac568ba5b60615bd9cc719dc5a46194ac9802'],1,1,2,788290,1,,,,1604
9d2b7a8bb5c57d20ada12290a547578eea23954e,0,Todd Lipcon,2016-02-26 23:40:15+00:00,['d17c74f321a1670dfb63a68d8123f7530a249cde'],16,18,34,788324,2,,,,1604
470aeb06905f7ff8d6647609e0c44c2bd1dd60c8,1,Todd Lipcon,2016-03-01 00:55:47+00:00,['9d2b7a8bb5c57d20ada12290a547578eea23954e'],58,38,96,788420,5,0,0.1,0,1604
9a22e9f6280094f029c049a7776cce3458150e7f,0,Adar Dembo,2016-02-29 18:05:21-08:00,['579f7dbdeba2eb33d32fd21f6d82ff3eb097baad'],4,4,8,788428,4,,,,1604
b17d0d5393ba031cc6a2e0932e72b4580d1ec0ea,0,Todd Lipcon,2016-03-01 04:12:16+00:00,['470aeb06905f7ff8d6647609e0c44c2bd1dd60c8'],0,12,12,788440,1,,,,1604
ffbe5a66eb61a8af990ed98a84c01e044533d376,0,Adar Dembo,2016-03-01 07:36:35+00:00,['b17d0d5393ba031cc6a2e0932e72b4580d1ec0ea'],13,17,30,788470,3,0,0,0,1604
fdfa218c37e3dc0163daea2108d556d7e6697c99,0,Adar Dembo,2016-03-01 07:36:37+00:00,['ffbe5a66eb61a8af990ed98a84c01e044533d376'],1,1,2,788472,1,,,,1604
e765f1cd255e86f2fc146379adad8394a6052825,1,Todd Lipcon,2016-03-01 07:43:35+00:00,['fdfa218c37e3dc0163daea2108d556d7e6697c99'],322,535,857,789329,3,0.886363636,1,1,1605
1ff209e85b4c2cc4beda7560d328b7ed05e008d2,1,Todd Lipcon,2016-03-01 07:43:46+00:00,['e765f1cd255e86f2fc146379adad8394a6052825'],99,296,395,789724,10,0.086956522,0.556521739,1,1605
a8c6de95fa4e5251c8929b40b6ba98767e5bff98,0,Todd Lipcon,2016-03-01 18:36:13+00:00,['1ff209e85b4c2cc4beda7560d328b7ed05e008d2'],1,1,2,789726,1,,,,1605
0ffa754a741fad11061b3efa6eed27fa308d1191,1,Todd Lipcon,2016-03-01 22:01:00+00:00,['a8c6de95fa4e5251c8929b40b6ba98767e5bff98'],1,9,10,789736,2,,,,1605
44546bb63f0e1c96aadec898c3bc4ddec6e35a4e,1,Todd Lipcon,2016-03-01 22:01:08+00:00,['0ffa754a741fad11061b3efa6eed27fa308d1191'],36,44,80,789816,2,0.75,0.75,1,1605
b250bc013c77a6a8db500ef6f3859b502999e17e,0,Todd Lipcon,2016-03-01 23:51:52+00:00,['44546bb63f0e1c96aadec898c3bc4ddec6e35a4e'],1413,13,1426,791242,3,,,,1605
8eec83f9579e80afa8e8b2c6293433ce68e77d39,0,Jean-Daniel Cryans,2016-03-02 00:30:57+00:00,['b250bc013c77a6a8db500ef6f3859b502999e17e'],14,16,30,791272,2,,,,1605
4425e9f1a9cf6c3e1f760d14b8cb52a04f335280,0,jdcryans,2016-03-01 16:42:12-08:00,"['579f7dbdeba2eb33d32fd21f6d82ff3eb097baad', '9a22e9f6280094f029c049a7776cce3458150e7f']",4,4,8,791280,4,,,,1605
dd6dbda35246722dd28e565252fd4f23c2c8dcad,0,Jean-Daniel Cryans,2016-03-02 03:42:17+00:00,['8eec83f9579e80afa8e8b2c6293433ce68e77d39'],6,23,29,791309,3,0.5,0.5,1,1605
817d63f5707ed33295f793d29b9d4869e64c328d,0,Todd Lipcon,2016-03-02 17:38:13+00:00,['dd6dbda35246722dd28e565252fd4f23c2c8dcad'],2,9,11,791320,1,1,1,1,1605
74af46bd68b65a8ec27e7776a3cccb0279f5de10,0,Mike Percy,2016-03-02 20:55:01+00:00,['817d63f5707ed33295f793d29b9d4869e64c328d'],1,1,2,791322,1,,,,1605
ac3771f4078c1f23545494f63384c724f73cc0af,0,Todd Lipcon,2016-03-02 22:43:42+00:00,['74af46bd68b65a8ec27e7776a3cccb0279f5de10'],54,99,153,791475,5,0,1,0,1605
a3419b84ccffe60736ac45a5e750feeadc4548b2,0,Todd Lipcon,2016-03-02 22:48:06+00:00,['ac3771f4078c1f23545494f63384c724f73cc0af'],1,2,3,791478,1,0,1,0,1605
cd3aa0ee636ce7008750922d5b55620aab03a97e,0,Todd Lipcon,2016-03-02 23:34:15+00:00,['a3419b84ccffe60736ac45a5e750feeadc4548b2'],182,118,300,791778,9,,,,1606
5f17cb57e3207c2ab2609289390ea9a945e44f2b,0,Todd Lipcon,2016-03-03 01:15:00+00:00,['cd3aa0ee636ce7008750922d5b55620aab03a97e'],5,16,21,791799,1,,,,1606
eb0360439e5b2f3c67e5438a420a2eb412dd3708,0,Adar Dembo,2016-03-03 19:13:36+00:00,['5f17cb57e3207c2ab2609289390ea9a945e44f2b'],1,29,30,791829,2,0.047619048,1,1,1606
826b7720f8998796b0a6b84ca6ab8f96aa8ba603,1,Todd Lipcon,2016-03-04 03:51:01+00:00,['eb0360439e5b2f3c67e5438a420a2eb412dd3708'],73,298,371,792200,6,0.622222222,0.933333333,0.922222222,1606
394d6ce923fb18264e2210df5770c6aadf4e32ae,0,Mike Percy,2016-03-04 09:44:26+00:00,['826b7720f8998796b0a6b84ca6ab8f96aa8ba603'],1,1,2,792202,1,,,,1606
f12748f8d5c6f26940cec4a1e647ff8048ab8919,0,Todd Lipcon,2016-03-04 19:39:48+00:00,['394d6ce923fb18264e2210df5770c6aadf4e32ae'],1,3,4,792206,1,,,,1606
e01760261a8c55b8f74c7ccc6c5ae7666ec4d659,0,Mike Percy,2016-03-04 21:20:02+00:00,['f12748f8d5c6f26940cec4a1e647ff8048ab8919'],11,11,22,792228,4,,,,1606
07e8422f962e9448d18cbbf1405d4740ed8b4a25,0,Mike Percy,2016-03-04 21:34:41+00:00,['e01760261a8c55b8f74c7ccc6c5ae7666ec4d659'],8,9,17,792245,1,,,,1606
e8969ff9b5e365fbbd3ed89dc87aada0fc6c7918,0,Jean-Daniel Cryans,2016-03-04 21:43:23+00:00,['07e8422f962e9448d18cbbf1405d4740ed8b4a25'],0,31,31,792276,1,,,,1606
48799d3fed53c79a5163fd9c4cd9cbae80a9f2d6,0,Todd Lipcon,2016-03-05 21:04:04+00:00,['e8969ff9b5e365fbbd3ed89dc87aada0fc6c7918'],41,148,189,792465,8,0.897435897,0.897435897,0.923076923,1607
0c9262ef5a2b8751ed3436e991671ba46a067275,0,Todd Lipcon,2016-03-05 22:45:50+00:00,['48799d3fed53c79a5163fd9c4cd9cbae80a9f2d6'],0,2,2,792467,1,0,1,1,1607
eb71ec75d139be2c8bc47a135d8cd034d873e1ca,1,Dan Burkert,2016-03-07 19:15:14+00:00,['0c9262ef5a2b8751ed3436e991671ba46a067275'],2,802,804,793271,6,0.1675,0.585,0.8125,1610
1cea8b7e911ed3554c915d93b5e55598ca07917e,0,Todd Lipcon,2016-03-08 02:38:48+00:00,['eb71ec75d139be2c8bc47a135d8cd034d873e1ca'],2,84,86,793357,3,0,0.975,0.85,1610
cef399c10c2ee0b30a849f26a3a22ee21ef0956f,0,Todd Lipcon,2016-03-08 02:40:13+00:00,['1cea8b7e911ed3554c915d93b5e55598ca07917e'],0,18,18,793375,3,0.75,1,1,1610
429311c5ef09e34bd8d1b11148822908aa31b0f8,0,Todd Lipcon,2016-03-08 19:15:59+00:00,['cef399c10c2ee0b30a849f26a3a22ee21ef0956f'],4,11,15,793390,1,,,,1610
fc9612fec0e718f20e5fbdbe9cd6a36536d78706,0,Todd Lipcon,2016-03-08 19:16:11+00:00,['429311c5ef09e34bd8d1b11148822908aa31b0f8'],46,30,76,793466,2,1,1,1,1610
3ea58ab6c3051cfcb7ad9880d37dc32ad46c6e49,0,Todd Lipcon,2016-03-08 19:16:24+00:00,['fc9612fec0e718f20e5fbdbe9cd6a36536d78706'],6,1,7,793473,1,0.5,0,1,1610
daac342d38120745bfa485c6d72c3ac757f5b80f,0,Todd Lipcon,2016-03-08 19:24:38+00:00,['3ea58ab6c3051cfcb7ad9880d37dc32ad46c6e49'],1367,10,1377,794850,3,0,0,0.86438152,1610
b37003420fa2c1004b09170eca30428cbb92caa2,0,Todd Lipcon,2016-03-08 19:24:50+00:00,['daac342d38120745bfa485c6d72c3ac757f5b80f'],449,0,449,795299,9,0.293269231,0.201923077,0.894230769,1610
51463bcf6cca7e99439bb796a35d43560bfc9bcc,0,Todd Lipcon,2016-03-08 20:25:06+00:00,['b37003420fa2c1004b09170eca30428cbb92caa2'],321,20,341,795640,24,,,,1610
d24aa18d634be50f11035630accaa0761cad7735,0,Todd Lipcon,2016-03-08 20:25:39+00:00,['51463bcf6cca7e99439bb796a35d43560bfc9bcc'],33,91,124,795764,12,,,,1612
ebb371335c3ccc481d2e6f16da8b1193bb2c7af0,0,Todd Lipcon,2016-03-08 20:26:30+00:00,['d24aa18d634be50f11035630accaa0761cad7735'],0,10,10,795774,2,0,0,1,1612
044b2c1bd34f61f84d740549a888f79a4b609342,1,Mike Percy,2016-03-08 21:11:12+00:00,['ebb371335c3ccc481d2e6f16da8b1193bb2c7af0'],4,13,17,795791,1,0,1,1,1612
5f2f40dfe33b31e501b72412c4c6fe7fea9fa9ee,0,Dan Burkert,2016-03-09 02:09:35+00:00,['044b2c1bd34f61f84d740549a888f79a4b609342'],4,3,7,795798,1,,,,1612
c3125591086996226971ceebaaa8dbfd77ac8681,0,Dan Burkert,2016-03-09 02:09:39+00:00,['5f2f40dfe33b31e501b72412c4c6fe7fea9fa9ee'],0,9,9,795807,1,,,,1612
6b0e5d757bc18a7c5f8ac78b6568cd68ab0c2a8b,1,Adar Dembo,2016-03-09 20:06:57+00:00,['c3125591086996226971ceebaaa8dbfd77ac8681'],2,2,4,795811,1,,,,1612
54839984932bca0c0ba49cdd8fa199a5711e589e,1,Todd Lipcon,2016-03-09 22:23:57+00:00,['6b0e5d757bc18a7c5f8ac78b6568cd68ab0c2a8b'],33,52,85,795896,6,0,1,0.25,1612
920e8aa842a743a24b4c1d4403a0bc162209a367,0,Todd Lipcon,2016-03-09 22:51:18+00:00,['54839984932bca0c0ba49cdd8fa199a5711e589e'],1,1,2,795898,1,,,,1612
5b5eff30e3f973b6b0651068031bc30838defede,1,Todd Lipcon,2016-03-10 02:53:50+00:00,['920e8aa842a743a24b4c1d4403a0bc162209a367'],20,4,24,795922,1,1,0,1,1612
8b96035f96d47214eeaea7a46baab109f673e51f,0,Todd Lipcon,2016-03-10 02:54:07+00:00,['5b5eff30e3f973b6b0651068031bc30838defede'],1,2,3,795925,1,0,1,1,1612
03b2f1d2677fbe0c31ac1595d9eba2fc8fefcfc9,0,Adar Dembo,2016-03-10 21:14:48+00:00,['8b96035f96d47214eeaea7a46baab109f673e51f'],2,2,4,795929,2,,,,1612
b7f859ed11d891b51257b26761b9fe4897ed723f,0,Mike Percy,2016-03-10 21:24:47+00:00,['03b2f1d2677fbe0c31ac1595d9eba2fc8fefcfc9'],70,103,173,796102,5,,,,1612
a4506028a64620a65b614ab6587f6217cf0a01f9,0,Adar Dembo,2016-03-10 22:38:50+00:00,['b7f859ed11d891b51257b26761b9fe4897ed723f'],1,1,2,796104,1,,,,1612
ce28d2616201107080c0dbd0799a721fe364d228,0,Adar Dembo,2016-03-10 22:55:54+00:00,['a4506028a64620a65b614ab6587f6217cf0a01f9'],1,165,166,796270,2,,,,1613
0157ef606252261683056e471e1a3506e3bfc0b3,0,Adar Dembo,2016-03-11 03:30:50+00:00,['ce28d2616201107080c0dbd0799a721fe364d228'],52,50,102,796372,3,1,1,,1613
4ec85eec3ff3ecc93e50db1ca7125d87449fc396,0,Adar Dembo,2016-03-14 21:32:48+00:00,['0157ef606252261683056e471e1a3506e3bfc0b3'],0,1,1,796373,1,,,,1613
c549302e843825dcdf22eed93db7b42861c24993,0,Adar Dembo,2016-03-14 14:39:19-07:00,['4425e9f1a9cf6c3e1f760d14b8cb52a04f335280'],3,3,6,796379,3,,,,1613
fa7845442efd1e480293bf953ff5b1c941e29bb1,0,Todd Lipcon,2016-03-14 15:43:18-07:00,"['4425e9f1a9cf6c3e1f760d14b8cb52a04f335280', 'c549302e843825dcdf22eed93db7b42861c24993']",3,3,6,796385,3,,,,1613
86a510a39f290cee59bfecf242d4a804d88cee46,0,Dan Burkert,2016-03-15 06:03:19+00:00,['4ec85eec3ff3ecc93e50db1ca7125d87449fc396'],18,132,150,796535,9,0.035714286,0.75,1,1613
f82919ed595a415053b7f4180f70a59674a32730,1,Todd Lipcon,2016-03-15 16:15:50+00:00,['86a510a39f290cee59bfecf242d4a804d88cee46'],51,384,435,796970,21,0.158273381,0.604316547,0.949640288,1615
158c26991854cde9bc1bbf9e5d7b9039c8416035,0,Todd Lipcon,2016-03-15 16:19:46+00:00,['f82919ed595a415053b7f4180f70a59674a32730'],0,7,7,796977,1,,,,1615
75c277b3b4afce89a9691b9dedf58e0d455077b0,0,Todd Lipcon,2016-03-16 03:42:18+00:00,['158c26991854cde9bc1bbf9e5d7b9039c8416035'],4,13,17,796994,2,0,0,1,1615
830c3e4feb01528107a4bc4f67177959ac4dc33c,0,Dan Burkert,2016-03-16 16:02:48+00:00,['75c277b3b4afce89a9691b9dedf58e0d455077b0'],3,5,8,797002,2,0,1,1,1615
9f93dd4f0f07696fb8140a58bd88a1acb6b04261,0,Misty Stanley-Jones,2016-03-17 02:30:02+00:00,['830c3e4feb01528107a4bc4f67177959ac4dc33c'],38,62,100,797102,1,,,,1615
99856b73ec6d776ca40a7abf46d0691bb64e95b1,0,Todd Lipcon,2016-03-17 03:30:39+00:00,['9f93dd4f0f07696fb8140a58bd88a1acb6b04261'],0,28,28,797130,2,0,1,1,1615
d7de2100941bf6c3f472fe8f1022ff83b828d83c,0,Todd Lipcon,2016-03-17 03:31:12+00:00,['99856b73ec6d776ca40a7abf46d0691bb64e95b1'],6,17,23,797153,1,1,1,1,1615
64f007c76226f9040afc7c555c42c9aede238022,1,Dan Burkert,2016-03-17 21:29:50+00:00,['d7de2100941bf6c3f472fe8f1022ff83b828d83c'],5,38,43,797196,2,0,1,1,1615
9c798f45c955e94690fc4a77ef139cd5f00f5650,0,Todd Lipcon,2016-03-18 18:34:10+00:00,['64f007c76226f9040afc7c555c42c9aede238022'],11,1,12,797208,1,0.2,0.2,0,1615
53e67e9eb7b4fc940a14a17119041871e80bcc3f,1,Todd Lipcon,2016-03-20 20:27:49+00:00,['9c798f45c955e94690fc4a77ef139cd5f00f5650'],1182,1778,2960,800168,42,0.312087912,0.637362637,0.52967033,1618
570611b246319dffb338b9f21e2c0fadc4deb78f,1,Todd Lipcon,2016-03-20 20:42:33+00:00,['53e67e9eb7b4fc940a14a17119041871e80bcc3f'],12,60,72,800240,3,0.517241379,0,1,1618
90be132b9fdf8fc898a69186ca80d1fcce9ba109,0,Todd Lipcon,2016-03-20 20:43:14+00:00,['570611b246319dffb338b9f21e2c0fadc4deb78f'],0,159,159,800399,2,1,1,0.927710843,1619
8f72630cfbe6b81a0f156952eb42a14305533839,0,Todd Lipcon,2016-03-20 20:51:46+00:00,['90be132b9fdf8fc898a69186ca80d1fcce9ba109'],7,5,12,800411,1,,,,1619
9d305af79952396a12c507e4459d373287fb3464,0,Todd Lipcon,2016-03-21 01:56:30+00:00,['8f72630cfbe6b81a0f156952eb42a14305533839'],159,0,159,800570,2,0,0,0.072289157,1619
85fd60deada8c039ea532bb38f5e527d3a0b780a,0,Mike Percy,2016-03-22 00:52:14+00:00,['9d305af79952396a12c507e4459d373287fb3464'],1,1,2,800572,1,,,,1619
f8a677b1fea197bb88672fb944e89b39b1b80829,0,Todd Lipcon,2016-03-22 18:43:49+00:00,['85fd60deada8c039ea532bb38f5e527d3a0b780a'],1,464,465,801037,12,0.527173913,0.85326087,0.766304348,1624
c9afb77359562a62263a7a304ca20f9eeca994e9,0,Mike Percy,2016-03-22 20:27:36+00:00,['f8a677b1fea197bb88672fb944e89b39b1b80829'],5,15,20,801057,2,,,,1624
e88b989c7fea016d9ded169ffc526097cfa2a077,0,Todd Lipcon,2016-03-23 17:45:02+00:00,['c9afb77359562a62263a7a304ca20f9eeca994e9'],4,7,11,801068,2,0.5,1,1,1624
f97197185d358d3c251def1740d97573323e1611,0,Todd Lipcon,2016-03-23 17:46:41+00:00,['e88b989c7fea016d9ded169ffc526097cfa2a077'],29,83,112,801180,2,0.40625,1,0.375,1624
3337124e7d10b9d4cf235fd12b2f1a5e5f841d1c,0,Todd Lipcon,2016-03-23 21:18:40+00:00,['f97197185d358d3c251def1740d97573323e1611'],0,5,5,801185,1,,,,1624
ef2b64b9fbddf8bb69926fa61ea691fa509bc3f1,0,Todd Lipcon,2016-03-23 22:53:24+00:00,['3337124e7d10b9d4cf235fd12b2f1a5e5f841d1c'],0,158,158,801343,2,1,1,0.927710843,1625
7f3691a826b9d27199319409f8d721ec1d08a8ba,1,Adar Dembo,2016-03-24 20:13:21+00:00,['ef2b64b9fbddf8bb69926fa61ea691fa509bc3f1'],0,49,49,801392,3,0,0.189189189,1,1625
96b7291ff2533a01f14f0722cfa196948bfd3006,1,Dan Burkert,2016-03-25 17:40:01+00:00,['7f3691a826b9d27199319409f8d721ec1d08a8ba'],124,1229,1353,802745,13,0.092081031,0.810313076,0.651933702,1628
1ad79bccd6a59c99e23cfe6dd58ae488a5cf5e55,0,Todd Lipcon,2016-03-25 19:45:55+00:00,['96b7291ff2533a01f14f0722cfa196948bfd3006'],1,4,5,802750,1,1,1,1,1628
e317be64f9f449621af17e476e1485e5fa783a82,0,Todd Lipcon,2016-03-25 21:27:41+00:00,['1ad79bccd6a59c99e23cfe6dd58ae488a5cf5e55'],0,21,21,802771,3,0.6,1,1,1628
457f6fb0d6621dfd007c8c0f022b50606c77b8ec,0,Adar Dembo,2016-03-28 19:59:10+00:00,['e317be64f9f449621af17e476e1485e5fa783a82'],1,9,10,802781,1,,,,1628
0f48f5e2fc465b0486b270f7cc5e791cb5cdae41,1,Todd Lipcon,2016-03-28 22:20:18+00:00,['457f6fb0d6621dfd007c8c0f022b50606c77b8ec'],0,278,278,803059,1,,,,1629
c693d878fdebae81c987466a1b38327cb015e8c3,0,Todd Lipcon,2016-03-28 22:20:31+00:00,['0f48f5e2fc465b0486b270f7cc5e791cb5cdae41'],7,29,36,803095,4,0,1,1,1629
1b768723f0c5342e3a1b981b8021e92dbf62a5c8,0,Todd Lipcon,2016-03-28 22:22:44+00:00,['c693d878fdebae81c987466a1b38327cb015e8c3'],4,34,38,803133,1,0.909090909,0.909090909,0.909090909,1629
c8598ff04325da0ac7e1a04b768bf33724acf5f3,0,Mike Percy,2016-03-29 01:04:54+00:00,['1b768723f0c5342e3a1b981b8021e92dbf62a5c8'],20,424,444,803577,7,0.84057971,0.84057971,0.97826087,1631
fa70abe8559b4d8ed9438aae1c3e1027c8662997,1,Mike Percy,2016-03-30 01:53:59+00:00,['c8598ff04325da0ac7e1a04b768bf33724acf5f3'],0,786,786,804363,7,0.321311475,0.675409836,1,1637
6018145594464d77f4910f888528544fe9ce14d9,0,Todd Lipcon,2016-03-30 22:51:58+00:00,['fa70abe8559b4d8ed9438aae1c3e1027c8662997'],1,16,17,804380,2,0.833333333,0.833333333,1,1637
d5938e951fa6e145808eb16bd28516f63f5b8bef,0,Dan Burkert,2016-03-31 01:17:22+00:00,['6018145594464d77f4910f888528544fe9ce14d9'],382,0,382,804762,9,0.5,0.146666667,0.093333333,1637
9b8b020210905b0cc4dd81e0ca905e098d0cad33,0,Dan Burkert,2016-03-31 03:49:45+00:00,['d5938e951fa6e145808eb16bd28516f63f5b8bef'],8,120,128,804890,7,0,0.28358209,0.880597015,1637
8f4726d83e6b6b7d76c59d06fde9231f0bb113b9,0,Dan Burkert,2016-03-31 03:49:51+00:00,['9b8b020210905b0cc4dd81e0ca905e098d0cad33'],3,8,11,804901,2,1,1,1,1637
7e2fe2a04ffab42b9e3915e87819e14d6d8a15d8,0,Jean-Daniel Cryans,2016-03-31 17:14:26+00:00,['8f4726d83e6b6b7d76c59d06fde9231f0bb113b9'],10,10,20,804921,9,,,,1637
959952a93c86292f45ded234065c75b430d42c4b,0,Misty Stanley-Jones,2016-03-31 22:39:16+00:00,['7e2fe2a04ffab42b9e3915e87819e14d6d8a15d8'],35,111,146,805067,2,,,,1637
5eb9fcf9ecc646c36c95c1fa041ee485c74824c8,0,Dan Burkert,2016-04-01 01:19:31+00:00,['959952a93c86292f45ded234065c75b430d42c4b'],1,1,2,805069,1,,,,1637
74c6ae907ea2a701a9e21a5bbb1d94f331fe7c86,0,Dan Burkert,2016-04-01 01:20:01+00:00,['5eb9fcf9ecc646c36c95c1fa041ee485c74824c8'],0,733,733,805802,2,0.094982079,1,1,1638
626c3a83988efe2de4dcdaccafe71742a37af9c6,0,Adar Dembo,2016-04-01 03:12:59+00:00,['74c6ae907ea2a701a9e21a5bbb1d94f331fe7c86'],114,132,246,806048,4,1,0.444444444,1,1638
7ffbbf9e04a07988839a8e55ade31dd6fd9d364b,0,Jean-Daniel Cryans,2016-04-01 03:52:09+00:00,['626c3a83988efe2de4dcdaccafe71742a37af9c6'],1,1,2,806050,1,,,,1638
d79c1cf8020b1e577daecd2880ca7713af20c4b7,1,Todd Lipcon,2016-04-01 04:51:34+00:00,['7ffbbf9e04a07988839a8e55ade31dd6fd9d364b'],21,325,346,806396,7,0.54,0.7,1,1639
dc580690741acca27112b728ea23bcac87c50081,0,Misty Stanley-Jones,2016-04-01 16:04:43+00:00,['d79c1cf8020b1e577daecd2880ca7713af20c4b7'],1,1,2,806398,1,,,,1639
16c03cda041f901247d83bf37c1958697a3a96dc,1,Dan Burkert,2016-04-01 19:56:59+00:00,['dc580690741acca27112b728ea23bcac87c50081'],62,2154,2216,808614,13,0.17147311,0.676539361,0.816835542,1642
2079c81f26c7ddebd519241926b351c55b2c700b,0,Dan Burkert,2016-04-01 20:09:18+00:00,['16c03cda041f901247d83bf37c1958697a3a96dc'],8,4,12,808626,1,,,,1642
c6e709f6e7def678ce8d5ea40a36b952c8cb7ad9,0,Mike Percy,2016-04-01 22:11:53+00:00,['2079c81f26c7ddebd519241926b351c55b2c700b'],3,24,27,808653,2,1,1,1,1642
1f014124d1dbd4a546976721062cfef251a19187,1,Mike Percy,2016-04-01 23:24:17+00:00,['c6e709f6e7def678ce8d5ea40a36b952c8cb7ad9'],12,99,111,808764,5,0.351851852,0.925925926,0.962962963,1642
563313d15e922db4255736ed1423bb418bbcd6fd,1,Todd Lipcon,2016-04-02 01:04:59+00:00,['1f014124d1dbd4a546976721062cfef251a19187'],9,34,43,808807,2,1,1,1,1642
fd556b2fd2a4e4cf044843ab251fa3855d3e3a13,1,Todd Lipcon,2016-04-02 01:27:56+00:00,['563313d15e922db4255736ed1423bb418bbcd6fd'],198,263,461,809268,4,0,0.592592593,0.296296296,1642
90af0ea581cb8a2fd4af1f3dcf4c29585f50f719,0,Jean-Daniel Cryans,2016-04-03 00:23:38+00:00,['fd556b2fd2a4e4cf044843ab251fa3855d3e3a13'],6,32,38,809306,1,,,,1642
a6dfbf6de09889d56c39e2c23357799778df9bbb,0,Jean-Daniel Cryans,2016-04-03 00:24:52+00:00,['90af0ea581cb8a2fd4af1f3dcf4c29585f50f719'],9,33,42,809348,2,,,,1642
e0b3940839c58402799d75e278f257bd0b7e1180,0,Mike Percy,2016-04-06 19:20:56+00:00,['a6dfbf6de09889d56c39e2c23357799778df9bbb'],5,52,57,809405,2,0.034482759,1,1,1642
4c4c3ae59e81d2b80209b94e0dfe49768f21ba8e,0,Todd Lipcon,2016-04-06 21:22:58+00:00,['e0b3940839c58402799d75e278f257bd0b7e1180'],46,66,112,809517,5,0.4,1,1,1642
3339ce06b0d8212fc5e3a2fa1ff5605bbca1d76a,0,Todd Lipcon,2016-04-07 03:53:30+00:00,['4c4c3ae59e81d2b80209b94e0dfe49768f21ba8e'],12,14,26,809543,2,,,,1642
1cda5dcd0bc4a9fd41ffd4d13b60c473c04a9ff5,1,Todd Lipcon,2016-04-08 06:05:59+00:00,['3339ce06b0d8212fc5e3a2fa1ff5605bbca1d76a'],64,63,127,809670,13,0.2,0.4,0,1642
637b2e62cac8571879710b4442b31e85eec4bfef,0,Todd Lipcon,2016-04-10 05:55:51+00:00,['1cda5dcd0bc4a9fd41ffd4d13b60c473c04a9ff5'],1,1,2,809672,1,,,,1642
0bab4ac1cd1511b3a80b3f53612aabf5533241b5,0,Todd Lipcon,2016-04-11 00:30:04+00:00,['637b2e62cac8571879710b4442b31e85eec4bfef'],1,2,3,809675,1,0,0,1,1642
08092e494319f9437a25f21ab89ab696e9d520d8,0,Misty Stanley-Jones,2016-04-11 16:28:29+00:00,['0bab4ac1cd1511b3a80b3f53612aabf5533241b5'],23,26,49,809724,5,,,,1642
00ac42f54e13ad33a102c3a67f85c54468b8a909,0,Dan Burkert,2016-04-11 18:49:36+00:00,['08092e494319f9437a25f21ab89ab696e9d520d8'],0,3,3,809727,1,,,,1642
ce11938a2e0ad839989a9b13fd4b6ccfdb42f419,0,Todd Lipcon,2016-04-12 16:20:11+00:00,['00ac42f54e13ad33a102c3a67f85c54468b8a909'],5,7,12,809739,2,,,,1642
8a3e461f8619dda6f2f85135bb94143e9ae2926f,1,Dan Burkert,2016-04-14 18:45:34+00:00,['ce11938a2e0ad839989a9b13fd4b6ccfdb42f419'],171,428,599,810338,8,1,1,1,1644
2d3b64365d4ab27ac603b4e4c7722fc1d737ac3a,0,Jean-Daniel Cryans,2016-04-15 03:15:17+00:00,['8a3e461f8619dda6f2f85135bb94143e9ae2926f'],4,110,114,810452,2,,,,1645
22160e33cdb62de9342c1208fc7d03f681623055,0,Jean-Daniel Cryans,2016-04-16 14:47:31+00:00,['2d3b64365d4ab27ac603b4e4c7722fc1d737ac3a'],4,7,11,810463,1,,,,1645
051e1325a99ae1e871e8a259b14d9080fbea25b4,0,Jean-Daniel Cryans,2016-04-18 18:08:12+00:00,['22160e33cdb62de9342c1208fc7d03f681623055'],1,84,85,810548,2,,,,1646
d50964eb4492c8d78504313f8b84af8ae501c4a2,1,Jean-Daniel Cryans,2016-04-18 18:11:34+00:00,['051e1325a99ae1e871e8a259b14d9080fbea25b4'],147,593,740,811288,14,0.254464286,0.294642857,1,1647
43c9c87604f3b6f3dd286c63344bf18a2db08c21,0,Todd Lipcon,2016-04-18 18:39:09+00:00,['d50964eb4492c8d78504313f8b84af8ae501c4a2'],2,53,55,811343,3,0,1,1,1647
06f94fba6fef87601ef9e30e07521b6812a942c5,1,Dan Burkert,2016-04-19 18:05:57+00:00,['43c9c87604f3b6f3dd286c63344bf18a2db08c21'],122,1002,1124,812467,14,0.326139089,0.613908873,0.709832134,1650
75d5c82642334e44cdced1ac77a2927b57c8cfa4,0,Dan Burkert,2016-04-19 21:43:31+00:00,['06f94fba6fef87601ef9e30e07521b6812a942c5'],5,7,12,812479,1,,,,1650
832030a89b6b17330744ae20e29d2eaff643e403,0,Mike Percy,2016-04-19 22:09:23+00:00,['75d5c82642334e44cdced1ac77a2927b57c8cfa4'],21,75,96,812575,4,1,1,0.238095238,1650
6b6a697e4d7cf0327339911b30377766cfd75037,1,Todd Lipcon,2016-04-20 01:52:46+00:00,['832030a89b6b17330744ae20e29d2eaff643e403'],35,394,429,813004,26,0,0.577777778,0.837037037,1652
5c2a85a0c391db29da220251bdeb75a2f03caa02,1,Todd Lipcon,2016-04-20 05:28:12+00:00,['6b6a697e4d7cf0327339911b30377766cfd75037'],90,92,182,813186,3,0.903225806,1,1,1652
38e16b71b881ad1f276da918cae8977a383906a5,0,Todd Lipcon,2016-04-20 06:04:38+00:00,['5c2a85a0c391db29da220251bdeb75a2f03caa02'],34,85,119,813305,11,1,1,1,1652
05f816e9b54a14b57617e6b5cb857e0736bb8483,1,Todd Lipcon,2016-04-20 06:04:52+00:00,['38e16b71b881ad1f276da918cae8977a383906a5'],41,148,189,813494,9,1,1,1,1654
3cb45e9696f87775ea1dcd6ee27137326d88e451,1,Adar Dembo,2016-04-20 18:28:58+00:00,['05f816e9b54a14b57617e6b5cb857e0736bb8483'],15,265,280,813774,7,0.13559322,1,0.898305085,1654
fd0f6f398d9e0809b9575ebd4846fea8dfe2bafb,1,Mike Percy,2016-04-20 19:41:45+00:00,['3cb45e9696f87775ea1dcd6ee27137326d88e451'],7,22,29,813803,1,0,0.5,0.25,1654
2eba21c933b4b2628eb9a1a3a9a2a9c53cbeb866,0,Todd Lipcon,2016-04-20 22:09:08+00:00,['fd0f6f398d9e0809b9575ebd4846fea8dfe2bafb'],1,1,2,813805,1,,,,1654
596a3018a3ef1e5702959477d768d0d5a409178c,0,Dan Burkert,2016-04-20 22:34:16+00:00,['2eba21c933b4b2628eb9a1a3a9a2a9c53cbeb866'],1,2,3,813808,2,,,,1654
e6052ac19958df48d0d9045ef2c0e10d39e02d91,1,Mike Percy,2016-04-21 03:31:16+00:00,['596a3018a3ef1e5702959477d768d0d5a409178c'],303,797,1100,814908,5,0.569672131,0.782786885,0.483606557,1654
bde7294fc0b0f9423a77c88c51ffa5e7915017ac,1,Mike Percy,2016-04-21 03:31:53+00:00,['e6052ac19958df48d0d9045ef2c0e10d39e02d91'],56,265,321,815229,3,0.015748031,1,1,1654
b6bab20922def643c9b57edef7313ea940dda068,0,Todd Lipcon,2016-04-21 21:10:25+00:00,['bde7294fc0b0f9423a77c88c51ffa5e7915017ac'],7,8,15,815244,3,,,,1654
aa9bf3a6ab28d5facfaf0c129ce6d3deaafffdc9,0,Jean-Daniel Cryans,2016-04-22 03:14:41+00:00,['b6bab20922def643c9b57edef7313ea940dda068'],6,8,14,815258,1,,,,1654
1fa4b10a67171a783b1555ea0b90165d38d78ed7,0,Todd Lipcon,2016-04-26 06:10:32+00:00,['aa9bf3a6ab28d5facfaf0c129ce6d3deaafffdc9'],3,0,3,815261,1,,,,1654
4ed147b7a143a4098c764ec6550214d4012e1fd6,0,Mike Percy,2016-04-26 08:47:34+00:00,['1fa4b10a67171a783b1555ea0b90165d38d78ed7'],49,47,96,815357,1,,,,1654
342b7a704a89d2f6d5a2dfbf107497cfacb0b9af,0,Todd Lipcon,2016-04-26 20:37:45+00:00,['4ed147b7a143a4098c764ec6550214d4012e1fd6'],3,10,13,815370,1,0,1,0,1654
938f7feaf90d76bc7f4d2823c61808a9b140168f,1,Dan Burkert,2016-04-26 22:45:10+00:00,['342b7a704a89d2f6d5a2dfbf107497cfacb0b9af'],238,645,883,816253,12,0.431578947,0.557894737,0.894736842,1657
af8a4af09175e22ca6d0f24c244c2700ed88e436,1,Adar Dembo,2016-04-27 01:07:59+00:00,['938f7feaf90d76bc7f4d2823c61808a9b140168f'],237,619,856,817109,7,0.216326531,0,0.975510204,1657
6e7a04aa54d34864b5bbdd486a96024342f6f302,1,Adar Dembo,2016-04-27 01:08:02+00:00,['af8a4af09175e22ca6d0f24c244c2700ed88e436'],64,101,165,817274,3,0,0.529411765,0,1657
73b8cc07ec0fda38a2627d5b7de70b07b7943c1e,0,Adar Dembo,2016-04-27 01:09:52+00:00,['6e7a04aa54d34864b5bbdd486a96024342f6f302'],0,615,615,817889,2,,,,1658
39441221a0f847c547df691d60e11860e4052b71,1,Jean-Daniel Cryans,2016-04-28 01:48:40+00:00,['73b8cc07ec0fda38a2627d5b7de70b07b7943c1e'],81,300,381,818270,4,0.58,0.8,0.81,1659
c4180bb03bf3425756ea09966f004153a8a31f72,1,Jean-Daniel Cryans,2016-04-28 01:48:53+00:00,['39441221a0f847c547df691d60e11860e4052b71'],66,591,657,818927,5,0.280141844,0.70212766,0.953900709,1660
01e8329cfaf4384377b1499ea6be0a04adc92631,1,Jean-Daniel Cryans,2016-04-28 02:31:25+00:00,['c4180bb03bf3425756ea09966f004153a8a31f72'],19,23,42,818969,9,1,0.2,0,1660
0eefc4937583ee4d9a234cf0024d4c358e35689a,0,Jean-Daniel Cryans,2016-04-28 02:31:38+00:00,['01e8329cfaf4384377b1499ea6be0a04adc92631'],1,9,10,818979,1,0,1,1,1660
c2aed1b7ca71819c768bc94280c9067872f755cb,0,Jean-Daniel Cryans,2016-04-28 02:32:03+00:00,['0eefc4937583ee4d9a234cf0024d4c358e35689a'],0,6,6,818985,3,,,,1660
59ff89dbcb21700fc50bca03b7cbf932c5fa3898,1,Adar Dembo,2016-04-28 06:40:08+00:00,['c2aed1b7ca71819c768bc94280c9067872f755cb'],34,32,66,819051,3,1,1,0.666666667,1660
d0ec5205ad47b54c66bc8fa8f3cfd0241abe20b7,1,Todd Lipcon,2016-04-30 20:57:11+00:00,['59ff89dbcb21700fc50bca03b7cbf932c5fa3898'],6,103,109,819160,6,0,1,1,1660
20e62835d2c79ad97db4f24ba8567313df6215c7,1,Todd Lipcon,2016-05-02 17:28:56+00:00,['d0ec5205ad47b54c66bc8fa8f3cfd0241abe20b7'],13,37,50,819210,5,0.636363636,0.909090909,1,1660
071c0391ddca1bd9f470eaa00e34e0b329a2ee53,1,Todd Lipcon,2016-05-02 17:29:18+00:00,['20e62835d2c79ad97db4f24ba8567313df6215c7'],18,34,52,819262,3,1,1,1,1660
57ccc9a713447c1b7327d8628a190691901b6c79,0,Adar Dembo,2016-05-02 20:08:27+00:00,['071c0391ddca1bd9f470eaa00e34e0b329a2ee53'],1,1,2,819264,1,,,,1660
4cb3b3afeecb41966895c50a03399cb03d9decc6,0,Todd Lipcon,2016-05-03 00:16:56+00:00,['57ccc9a713447c1b7327d8628a190691901b6c79'],56,0,56,819320,5,0.289473684,0.763157895,0.184210526,1660
1681d9a73eedaf5bf73fbec91caa81796123af8d,0,Todd Lipcon,2016-05-03 00:17:11+00:00,['4cb3b3afeecb41966895c50a03399cb03d9decc6'],2,12,14,819334,1,0,1,1,1660
40900879fd7ff4fd49ec59ffa48558ae22639a92,0,Todd Lipcon,2016-05-03 00:17:15+00:00,['1681d9a73eedaf5bf73fbec91caa81796123af8d'],1,6,7,819341,1,0,1,1,1660
95eb5d59141f0591222cce1353c5ebcf4297286b,0,Todd Lipcon,2016-05-03 00:17:20+00:00,['40900879fd7ff4fd49ec59ffa48558ae22639a92'],5,5,10,819351,1,,,,1660
b6883332d3a5ac538ae987c602a64bbc8416b791,1,Todd Lipcon,2016-05-03 22:36:20+00:00,['95eb5d59141f0591222cce1353c5ebcf4297286b'],61,95,156,819507,13,1,1,1,1660
d3eb2d8f44a6e2e8cc9e6c8c01955eacba4ca0f3,1,Todd Lipcon,2016-05-03 22:36:38+00:00,['b6883332d3a5ac538ae987c602a64bbc8416b791'],9,32,41,819548,5,0.866666667,1,0.6,1660
2b86e94d992468e6ee92733662af5fc959da57e3,0,Todd Lipcon,2016-05-03 23:11:26+00:00,['d3eb2d8f44a6e2e8cc9e6c8c01955eacba4ca0f3'],4,12,16,819564,2,0,0,0.875,1660
90edeabb3dc06ca13e1df6c787611aeca623a6e4,0,Jean-Daniel Cryans,2016-05-03 23:32:29+00:00,['2b86e94d992468e6ee92733662af5fc959da57e3'],2,11,13,819577,1,0,1,1,1660
a98ae004ed1bffb8b13f5aef64926777ca7e6f45,1,Todd Lipcon,2016-05-04 19:09:59+00:00,['90edeabb3dc06ca13e1df6c787611aeca623a6e4'],35,66,101,819678,5,0.409090909,1,1,1660
3b94aa217a4b0a5b7fefb7bf739ef333eac9942c,1,Todd Lipcon,2016-05-04 19:39:08+00:00,['a98ae004ed1bffb8b13f5aef64926777ca7e6f45'],79,131,210,819888,10,1,0.6,1,1660
1536f2fd70c06101551cb36bcef428bee45f450a,0,Jean-Daniel Cryans,2016-05-04 20:11:31+00:00,['3b94aa217a4b0a5b7fefb7bf739ef333eac9942c'],0,503,503,820391,8,0.607758621,0.974137931,0.974137931,1662
ce18b47ecc4bb89946a9bd66cc05b92ef492b182,0,Dan Burkert,2016-05-04 20:21:22+00:00,['1536f2fd70c06101551cb36bcef428bee45f450a'],0,11,11,820402,1,1,1,1,1662
e9fa79f462de32fd9ad722e0ec002e541174854f,0,Todd Lipcon,2016-05-04 23:38:19+00:00,['ce18b47ecc4bb89946a9bd66cc05b92ef492b182'],29,37,66,820468,4,0,0,0,1662
ae6b8abfef30a999b540e71069dc91c44d3ce445,1,Todd Lipcon,2016-05-04 23:40:01+00:00,['e9fa79f462de32fd9ad722e0ec002e541174854f'],21,151,172,820640,3,0.256410256,1,0.743589744,1662
e88e0a7bf4934ef9b9001324a7a0ce1671a70fd5,0,Todd Lipcon,2016-05-05 20:22:58+00:00,['ae6b8abfef30a999b540e71069dc91c44d3ce445'],1,1,2,820642,1,,,,1662
20d221796d3c7f4c9a89586adbb169c95625c348,0,Dan Burkert,2016-05-06 01:27:11+00:00,['e88e0a7bf4934ef9b9001324a7a0ce1671a70fd5'],3,12,15,820657,1,1,1,1,1662
93ff8fc5c4c4afc322a7039c0151987dd22df27e,0,Jean-Daniel Cryans,2016-05-06 02:35:26+00:00,['20d221796d3c7f4c9a89586adbb169c95625c348'],1,3,4,820661,1,,,,1662
97669cdfc85ec46187929d99a148be8aa7592921,0,Dan Burkert,2016-05-06 04:13:51+00:00,['93ff8fc5c4c4afc322a7039c0151987dd22df27e'],50,45,95,820756,15,,,,1662
97d48691e74a674e5f5af66be2f8eaf1ca0e29a4,0,Jean-Daniel Cryans,2016-05-06 21:32:26+00:00,['97669cdfc85ec46187929d99a148be8aa7592921'],14,83,97,820853,5,0.228571429,0.8,0.828571429,1662
a11ec5b523cf911b7fcea78e92d3a9e5ecc70430,0,Jean-Daniel Cryans,2016-05-06 21:32:35+00:00,['97d48691e74a674e5f5af66be2f8eaf1ca0e29a4'],1,1,2,820855,1,,,,1662
345fc0cd0ff7e7ea1c3d372c395088e5e17ddff8,0,Jean-Daniel Cryans,2016-05-06 21:32:40+00:00,['a11ec5b523cf911b7fcea78e92d3a9e5ecc70430'],1,9,10,820865,1,0,0,1,1662
a48642213b9dde8406551106dc4959f6e47786c2,0,Jean-Daniel Cryans,2016-05-06 21:35:03+00:00,['345fc0cd0ff7e7ea1c3d372c395088e5e17ddff8'],0,1,1,820866,1,,,,1662
9c334d2021dfd297ab677a403cc8a07099cc475b,0,Todd Lipcon,2016-05-06 21:45:38+00:00,['a48642213b9dde8406551106dc4959f6e47786c2'],1,12,13,820879,1,0,1,1,1662
db235c165e0e5857ced10cabc4e7a9f28ff5253f,0,Todd Lipcon,2016-05-06 21:45:59+00:00,['9c334d2021dfd297ab677a403cc8a07099cc475b'],0,9,9,820888,1,0,1,1,1662
4ebe756659d563f42150b1047bf7ddf83434db1d,1,Todd Lipcon,2016-05-09 16:29:40+00:00,['db235c165e0e5857ced10cabc4e7a9f28ff5253f'],0,3,3,820891,1,0,0,0,1662
eabcdab610e34a78bf34949a0d5407362f1fb683,1,Todd Lipcon,2016-05-09 20:36:43+00:00,['4ebe756659d563f42150b1047bf7ddf83434db1d'],7,15,22,820913,2,0,1,0,1662
5d82edb2ebe01a3ea73d851b80f36cc61c4002ae,1,Todd Lipcon,2016-05-09 21:17:15+00:00,['eabcdab610e34a78bf34949a0d5407362f1fb683'],10,76,86,820999,4,0.41025641,1,0.846153846,1662
7f2c5ac71e759e11712a9d7aaba8626d83785ce9,0,Binglin Chang,2016-05-11 07:06:32+00:00,['5d82edb2ebe01a3ea73d851b80f36cc61c4002ae'],82,406,488,821487,7,0.239130435,0.094202899,1,1664
f6691e744b9cb796e1bbc6e07953f21f387c9a88,0,Todd Lipcon,2016-05-11 07:14:53+00:00,['7f2c5ac71e759e11712a9d7aaba8626d83785ce9'],3,78,81,821568,4,1,1,1,1664
07d35077c0d37ff304a194f9242d7036f7afd209,1,Todd Lipcon,2016-05-11 07:15:42+00:00,['f6691e744b9cb796e1bbc6e07953f21f387c9a88'],53,116,169,821737,5,,,,1665
f9708338a1bfa8efcaf829c897fc745e7d7b744f,0,Todd Lipcon,2016-05-11 07:16:30+00:00,['07d35077c0d37ff304a194f9242d7036f7afd209'],3,4,7,821744,1,,,,1665
c9910207068e30bbb431c5516a4a9e459c711105,0,Jean-Daniel Cryans,2016-05-11 17:36:42+00:00,['f9708338a1bfa8efcaf829c897fc745e7d7b744f'],2,4,6,821750,1,,,,1665
659cfc42dd58fc15c7a67dceb3506ac5d40caf14,0,Todd Lipcon,2016-05-11 18:11:38+00:00,['c9910207068e30bbb431c5516a4a9e459c711105'],30,31,61,821811,4,1,1,0,1665
71e27799fe789d3f6f6f4f9852cbf9e47851753f,1,Todd Lipcon,2016-05-11 19:05:40+00:00,['659cfc42dd58fc15c7a67dceb3506ac5d40caf14'],364,438,802,822613,11,0.536585366,1,1,1665
df040987fadb8326bf2e3d415de804208cfcfbfe,0,Todd Lipcon,2016-05-11 19:10:18+00:00,['71e27799fe789d3f6f6f4f9852cbf9e47851753f'],15,45,60,822673,4,0.818181818,1,0.363636364,1665
568c12c197a9c4019ded5ae2a9903be521840c98,0,Todd Lipcon,2016-05-11 19:12:05+00:00,['df040987fadb8326bf2e3d415de804208cfcfbfe'],0,39,39,822712,3,0,0,1,1665
aa20b7b07edb912e04b6ad1b500a48b350994741,1,David Ribeiro Alves,2016-05-11 21:28:14+00:00,['568c12c197a9c4019ded5ae2a9903be521840c98'],1,38,39,822751,3,0,1,1,1665
999e7c908c5fd522d686451942a9f62106598bdd,0,Todd Lipcon,2016-05-12 03:55:21+00:00,['aa20b7b07edb912e04b6ad1b500a48b350994741'],1,1,2,822753,1,,,,1665
7d57b8b9204a0b170fc204cb7aaa98ad995cf635,0,Jean-Daniel Cryans,2016-05-12 18:45:11+00:00,['999e7c908c5fd522d686451942a9f62106598bdd'],27,30,57,822810,4,0,1,1,1665
2c0ac84e1de6c2df2768eb664cdb1f7f43e74119,0,Todd Lipcon,2016-05-12 18:48:34+00:00,['7d57b8b9204a0b170fc204cb7aaa98ad995cf635'],27,23,50,822860,2,0,0,0,1665
2c0f805f75d4aa02bf1dcf0faf169b4fa60019eb,0,David Ribeiro Alves,2016-05-12 21:49:44+00:00,['2c0ac84e1de6c2df2768eb664cdb1f7f43e74119'],52,137,189,823049,2,0,1,1,1665
6774d361927da77b8d21e2c76270fabad10a5e3c,0,David Ribeiro Alves,2016-05-12 23:49:30+00:00,['2c0f805f75d4aa02bf1dcf0faf169b4fa60019eb'],7,4,11,823060,2,1,0,0,1665
92f237ba9f1ae27bfe658237c0d285a971e50ed2,0,Todd Lipcon,2016-05-13 00:03:52+00:00,['6774d361927da77b8d21e2c76270fabad10a5e3c'],35,4,39,823099,2,1,1,0,1665
45fc3a589cb92df24dbd526e730cb11d2a6f9d63,0,David Ribeiro Alves,2016-05-13 00:11:57+00:00,['92f237ba9f1ae27bfe658237c0d285a971e50ed2'],1,3,4,823103,1,,,,1665
1eadbeb7ff3f95bf9e8dcace736fe1232147b048,1,Todd Lipcon,2016-05-13 02:05:16+00:00,['45fc3a589cb92df24dbd526e730cb11d2a6f9d63'],109,130,239,823342,2,1,1,1,1665
b8a1970320bf67f2e92c0bc0682835750d1c2b42,0,Dan Burkert,2016-05-13 15:52:33+00:00,['1eadbeb7ff3f95bf9e8dcace736fe1232147b048'],1,3,4,823346,2,,,,1665
02d9bd44af2af50833a299f2607ca1d58078afc1,1,Misty Stanley-Jones,2016-05-13 20:19:53+00:00,['b8a1970320bf67f2e92c0bc0682835750d1c2b42'],5,4,9,823355,1,,,,1665
205e66632d1e4afdb389bfac836de06618d2aed3,0,Dan Burkert,2016-05-13 23:42:43+00:00,['02d9bd44af2af50833a299f2607ca1d58078afc1'],1,1,2,823357,1,,,,1665
6ea07fb42b2a2b09fd73fc3562b88bd4e3b5cefb,0,David Ribeiro Alves,2016-05-14 21:56:16+00:00,['205e66632d1e4afdb389bfac836de06618d2aed3'],149,272,421,823778,2,0.545454545,0.8,0.509090909,1665
47ac6b3e3fabf52ef4e4cafa8f19819b7305f675,0,Mike Percy,2016-05-15 20:37:35+00:00,['6ea07fb42b2a2b09fd73fc3562b88bd4e3b5cefb'],1,1,2,823780,1,,,,1665
48ab4cf0d5b8904a9a2fd0a33ce9143d8c43500a,0,Mike Percy,2016-05-15 20:37:49+00:00,['47ac6b3e3fabf52ef4e4cafa8f19819b7305f675'],1,1,2,823782,1,,,,1665
ba3ccbe7ca4d153d79c8729fca6fd955c47d1a1d,1,Todd Lipcon,2016-05-16 19:06:16+00:00,['48ab4cf0d5b8904a9a2fd0a33ce9143d8c43500a'],38,57,95,823877,10,0,0.8,0.8,1665
e70a06046782424863c71c1f5652636039bba3e5,0,Todd Lipcon,2016-05-16 19:06:20+00:00,['ba3ccbe7ca4d153d79c8729fca6fd955c47d1a1d'],2,3,5,823882,1,,,,1665
7cf64cdcd28ec0d4528c0336ca4b853ca8f87375,0,Todd Lipcon,2016-05-16 19:06:23+00:00,['e70a06046782424863c71c1f5652636039bba3e5'],44,18,62,823944,13,,,,1665
889593d2f310ba404d1784e4e15d53c737f8d20d,0,Todd Lipcon,2016-05-16 21:26:30+00:00,['7cf64cdcd28ec0d4528c0336ca4b853ca8f87375'],4,4,8,823952,1,,,,1665
f8370efa00607022836edf465222b096c2dec7b6,0,Todd Lipcon,2016-05-16 21:26:41+00:00,['889593d2f310ba404d1784e4e15d53c737f8d20d'],139,235,374,824326,2,1,1,1,1665
d138dba61c2a889fde4c0467d5429a671fb950f9,0,Todd Lipcon,2016-05-16 21:26:47+00:00,['f8370efa00607022836edf465222b096c2dec7b6'],27,25,52,824378,1,0,0,1,1665
76c88a6fc12475638e60543b9f9aa7b3d1a9073e,0,Todd Lipcon,2016-05-16 21:26:51+00:00,['d138dba61c2a889fde4c0467d5429a671fb950f9'],51,40,91,824469,4,1,1,0,1665
c3553ac5ba6284cfd3be5ab97b2fc90d6288ac88,0,Todd Lipcon,2016-05-16 21:26:56+00:00,['76c88a6fc12475638e60543b9f9aa7b3d1a9073e'],8,10,18,824487,1,0,0,1,1665
3512b1ac68f92ebe1e4e632d9c9dd11396edf1b3,1,Todd Lipcon,2016-05-17 01:18:30+00:00,['c3553ac5ba6284cfd3be5ab97b2fc90d6288ac88'],57,46,103,824590,3,1,0,0,1665
66541f36ebff2a0e521f3fc8c9f0b08f77d2b597,0,David Ribeiro Alves,2016-05-17 01:52:46+00:00,['3512b1ac68f92ebe1e4e632d9c9dd11396edf1b3'],2,1,3,824593,1,,,,1665
492102e4bed26b5625754b4ada5738dde6fbd8d7,0,Todd Lipcon,2016-05-17 04:47:12+00:00,['66541f36ebff2a0e521f3fc8c9f0b08f77d2b597'],1,49,50,824643,4,0,1,0.9,1665
06f77c07f5abb922a0fa1286688c5f73c0e8714e,0,Todd Lipcon,2016-05-17 04:47:18+00:00,['492102e4bed26b5625754b4ada5738dde6fbd8d7'],4,11,15,824658,2,0,1,1,1665
3aedf35384d97e7c5190ce065a59e99bef1cc2fc,0,Todd Lipcon,2016-05-17 17:50:29+00:00,['06f77c07f5abb922a0fa1286688c5f73c0e8714e'],20,22,42,824700,3,1,1,1,1665
6d6013b9124299206bcc266bb0c3201e88815a0d,0,Todd Lipcon,2016-05-17 17:50:56+00:00,['3aedf35384d97e7c5190ce065a59e99bef1cc2fc'],49,56,105,824805,12,0,1,0,1665
e53fa21a2b32ebcbb9033a3aeb6d26a2a453f68c,0,Todd Lipcon,2016-05-17 17:51:02+00:00,['6d6013b9124299206bcc266bb0c3201e88815a0d'],6,10,16,824821,2,1,1,1,1665
769170714a2ccb877b79df22aee7db743903a91c,0,Dan Burkert,2016-05-18 18:05:32+00:00,['e53fa21a2b32ebcbb9033a3aeb6d26a2a453f68c'],2,2,4,824825,1,,,,1665
f2822846f24bb77e97f09798e387bff731075c44,1,Jean-Daniel Cryans,2016-05-18 18:21:42+00:00,['769170714a2ccb877b79df22aee7db743903a91c'],19,18,37,824862,2,0.5,1,1,1665
e25348cbb4e2afbac056a586557cd7e43ddd6eef,0,Todd Lipcon,2016-05-18 19:39:09+00:00,['f2822846f24bb77e97f09798e387bff731075c44'],24,17,41,824903,2,1,1,1,1665
f9ab2d22f301d8c2577f0ff6b40b7fd97fc7b1b4,0,Todd Lipcon,2016-05-18 19:39:19+00:00,['e25348cbb4e2afbac056a586557cd7e43ddd6eef'],11,6,17,824920,1,0,1,1,1665
8d377ac0fe2be0f9176526e9db745ea6dd70ce86,1,Todd Lipcon,2016-05-18 20:35:13+00:00,['f9ab2d22f301d8c2577f0ff6b40b7fd97fc7b1b4'],15,45,60,824980,6,0.863636364,1,1,1665
07f940c51c13be3e92d17671ae8f97598625156a,0,Jean-Daniel Cryans,2016-05-18 20:53:29+00:00,['8d377ac0fe2be0f9176526e9db745ea6dd70ce86'],0,1,1,824981,1,0,0,1,1665
efe40a3340c5d812b1fbf1599c934f7001c977b0,0,Todd Lipcon,2016-05-18 22:34:55+00:00,['07f940c51c13be3e92d17671ae8f97598625156a'],2,2,4,824985,1,,,,1665
56c431585ed7ad07ef53d4d8ad254f855769749a,1,Todd Lipcon,2016-05-19 01:55:31+00:00,['efe40a3340c5d812b1fbf1599c934f7001c977b0'],70,372,442,825427,22,0.227722772,0.202970297,0.485148515,1665
591c9ccb2a08bcfa4cf7cce32fc60b05b0d2ca86,0,Todd Lipcon,2016-05-19 06:26:40+00:00,['56c431585ed7ad07ef53d4d8ad254f855769749a'],1,87,88,825515,4,0.56097561,1,0.658536585,1666
069a38fb4e7728023542309521db9aa6e5cb2aee,1,Dan Burkert,2016-05-19 18:48:10+00:00,['591c9ccb2a08bcfa4cf7cce32fc60b05b0d2ca86'],19,312,331,825846,7,0.491071429,0.517857143,0.25,1666
be10f8514c48950b64c7d59bbce848f3792ec52d,1,Jean-Daniel Cryans,2016-05-19 19:21:58+00:00,['069a38fb4e7728023542309521db9aa6e5cb2aee'],29,52,81,825927,4,0,1,1,1667
f19f606236d4d809a5797418725d0b4d6535088b,0,Dan Burkert,2016-05-20 20:16:38+00:00,['be10f8514c48950b64c7d59bbce848f3792ec52d'],24,53,77,826004,2,1,1,1,1667
86ddcd18a174540b4e288211ba8513e17076edff,0,Todd Lipcon,2016-05-23 16:46:45+00:00,['f19f606236d4d809a5797418725d0b4d6535088b'],1,1,2,826006,1,,,,1667
d55bc48ebc760495b645c597c33266ffc2d8e346,0,Todd Lipcon,2016-05-23 18:14:59+00:00,['86ddcd18a174540b4e288211ba8513e17076edff'],3,6,9,826015,2,,,,1667
578b51375f06a30970c5c76f1595cfabdba4d5ed,0,Todd Lipcon,2016-05-23 18:33:16+00:00,['d55bc48ebc760495b645c597c33266ffc2d8e346'],9,17,26,826041,2,,,,1667
fd20b30f60f98ef2c66c0c6fad6ff5adb4277a6d,0,Dan Burkert,2016-05-24 00:12:58+00:00,['578b51375f06a30970c5c76f1595cfabdba4d5ed'],2,2,4,826045,1,,,,1667
2a34d81f84529bc307dd494dbc2c952b3256aa65,0,Todd Lipcon,2016-05-24 04:32:18+00:00,['fd20b30f60f98ef2c66c0c6fad6ff5adb4277a6d'],8,8,16,826061,1,,,,1667
2dbd249895d20da8e4d0676d838aae5c627e3cd4,0,Todd Lipcon,2016-05-24 04:32:35+00:00,['2a34d81f84529bc307dd494dbc2c952b3256aa65'],4,2,6,826067,1,,,,1667
0346d029dfc0b369e6eeec5eb5f530f50d73a011,0,Todd Lipcon,2016-05-24 05:40:25+00:00,['2dbd249895d20da8e4d0676d838aae5c627e3cd4'],1,6,7,826074,2,1,1,1,1667
9f939ca5c96fbe9edc123aaf0dfc16493eecb03c,0,Jean-Daniel Cryans,2016-05-24 17:53:54+00:00,['0346d029dfc0b369e6eeec5eb5f530f50d73a011'],10,10,20,826094,9,,,,1667
18739b2205a555c5c497d2787e14df51fdaeb533,1,David Ribeiro Alves,2016-05-24 18:09:59+00:00,['9f939ca5c96fbe9edc123aaf0dfc16493eecb03c'],181,205,386,826480,3,0,0,1,1667
f4a644c8ad2f47183e43b022e8ce982e3242d9cb,1,David Ribeiro Alves,2016-05-24 18:11:29+00:00,['18739b2205a555c5c497d2787e14df51fdaeb533'],114,213,327,826807,2,1,1,0.8125,1668
08b66007c7eee301ba7e77ed11a7c48e3eefd72c,0,Todd Lipcon,2016-05-24 19:05:58+00:00,['f4a644c8ad2f47183e43b022e8ce982e3242d9cb'],3,77,80,826887,6,0.285714286,1,0.571428571,1668
7843c953549bb9363259c04f194e8184e2f8b9ba,0,Dan Burkert,2016-05-24 19:29:46+00:00,['08b66007c7eee301ba7e77ed11a7c48e3eefd72c'],1,1,2,826889,1,,,,1668
298806fa32c44e986c2401fa5ac416bcbc491523,0,Todd Lipcon,2016-05-24 20:17:10+00:00,['7843c953549bb9363259c04f194e8184e2f8b9ba'],1,2,3,826892,1,,,,1668
8094b73147e0238cdfd96a141554b5344c801cdb,0,Todd Lipcon,2016-05-24 20:17:26+00:00,['298806fa32c44e986c2401fa5ac416bcbc491523'],2,3,5,826897,1,1,1,1,1668
a25401254499b1e7ae03ec2522eaad9399de0f80,0,Dan Burkert,2016-05-24 21:05:45+00:00,['8094b73147e0238cdfd96a141554b5344c801cdb'],1,1,2,826899,1,,,,1668
ab500fc223866ad49a9f1ec50e61482a36896312,0,David Ribeiro Alves,2016-05-25 03:07:41+00:00,['a25401254499b1e7ae03ec2522eaad9399de0f80'],0,22,22,826921,1,,,,1668
9d5ce0027eeede5ef906545d9abc258041309d7d,0,David Ribeiro Alves,2016-05-25 03:08:02+00:00,['ab500fc223866ad49a9f1ec50e61482a36896312'],0,224,224,827145,4,0.381818182,1,1,1671
57c4b47f8b09fee4dac682b70bd923ed6b4960f8,0,David Ribeiro Alves,2016-05-25 03:08:52+00:00,['9d5ce0027eeede5ef906545d9abc258041309d7d'],36,54,90,827235,3,,,,1671
c11b8cf96acbd5be56b5e35c1e59da2f92b601fe,0,Todd Lipcon,2016-05-25 06:30:25+00:00,['57c4b47f8b09fee4dac682b70bd923ed6b4960f8'],5,20,25,827260,10,0.090909091,0.909090909,0.363636364,1671
8c213396a71d43079fc0a4c893775a7510853cb3,0,Todd Lipcon,2016-05-25 07:17:17+00:00,['c11b8cf96acbd5be56b5e35c1e59da2f92b601fe'],1,0,1,827261,1,0,0,0,1671
f9aa4ee37c07dd03af792fa99f138b9b5ca8a557,1,Todd Lipcon,2016-05-25 18:19:29+00:00,['8c213396a71d43079fc0a4c893775a7510853cb3'],10,26,36,827297,3,0,1,1,1671
b27bb312b5f12126e3a150d0885cd9b178f42336,0,Todd Lipcon,2016-05-25 20:10:09+00:00,['f9aa4ee37c07dd03af792fa99f138b9b5ca8a557'],16,25,41,827338,5,0,1,1,1671
1bf93714d84be1bc8bfbd85f3d2ed6c82942578d,0,Jean-Daniel Cryans,2016-05-25 20:41:25+00:00,['b27bb312b5f12126e3a150d0885cd9b178f42336'],10,309,319,827657,4,0.111702128,0.521276596,0.670212766,1673
7d6913cd0f3f6e7065dbbf0f61bd86553cdffab6,0,Dan Burkert,2016-05-25 20:49:23+00:00,['1bf93714d84be1bc8bfbd85f3d2ed6c82942578d'],5,105,110,827767,3,0,1,1,1673
c7178e97e842f42e9ed9d5e9e2a4f521fbe70b6b,0,Todd Lipcon,2016-05-26 01:06:19+00:00,['7d6913cd0f3f6e7065dbbf0f61bd86553cdffab6'],44,40,84,827851,10,0.571428571,0.857142857,1,1673
637f89d740b76617d7ef81f82a0d3416e121f955,0,Adar Dembo,2016-05-26 01:11:49+00:00,['c7178e97e842f42e9ed9d5e9e2a4f521fbe70b6b'],1,32,33,827884,2,0.64,1,1,1673
3ab902eb33bb6f0d7e5ac56892ddcf4d0f1f1300,1,Todd Lipcon,2016-05-26 06:57:03+00:00,['637f89d740b76617d7ef81f82a0d3416e121f955'],30,46,76,827960,5,0.8,0.8,1,1673
eff3a590d2854e544a8353b0dd2756b1b3e37309,0,Dan Burkert,2016-05-26 17:01:00+00:00,['3ab902eb33bb6f0d7e5ac56892ddcf4d0f1f1300'],11,9,20,827980,3,0,0,0,1673
4ef25249e2f723cb4286031c0c4777a579cd6d83,0,Dan Burkert,2016-05-26 22:15:42+00:00,['eff3a590d2854e544a8353b0dd2756b1b3e37309'],0,217,217,828197,2,,,,1674
0e7c257f950e8875fe9d6a541cc03918ae23912e,1,Misty Stanley-Jones,2016-05-26 22:24:20+00:00,['4ef25249e2f723cb4286031c0c4777a579cd6d83'],140,226,366,828563,56,0.8,0.8,1,1674
6fff1b2a2e0927e738bea5216352d14f73ac182e,0,Mike Percy,2016-05-27 19:57:40+00:00,['0e7c257f950e8875fe9d6a541cc03918ae23912e'],0,4,4,828567,1,0,0,1,1674
8721f95391c9cad15ef46a2357e12fe9323e88dd,0,Mike Percy,2016-05-27 23:35:07+00:00,['6fff1b2a2e0927e738bea5216352d14f73ac182e'],36,37,73,828640,4,,,,1674
71420f00e0de5bec20562681b2b3ef46dc4f069e,0,David Ribeiro Alves,2016-05-30 23:02:46+00:00,['8721f95391c9cad15ef46a2357e12fe9323e88dd'],0,26,26,828666,4,1,1,1,1674
cc658cac1b8be86a18839ea5c7a89c1a768c8516,0,Dan Burkert,2016-05-31 17:16:01+00:00,['71420f00e0de5bec20562681b2b3ef46dc4f069e'],3,6,9,828675,1,1,1,1,1674
5efc46772b36e0fa9b43c0b3db361a56eb49506d,1,Dan Burkert,2016-05-31 19:59:17+00:00,['cc658cac1b8be86a18839ea5c7a89c1a768c8516'],156,807,963,829638,19,0.083538084,0.628992629,0.523341523,1675
30d76a36cc4715ee1cea26f80cdd9207239a996c,0,Dan Burkert,2016-05-31 19:59:23+00:00,['5efc46772b36e0fa9b43c0b3db361a56eb49506d'],24,58,82,829720,4,0,1,1,1675
975eeff467891be0abea23e2c4f6c304156e8785,0,Mike Percy,2016-05-31 21:37:46+00:00,['30d76a36cc4715ee1cea26f80cdd9207239a996c'],8,6,14,829734,1,0,0,0,1675
5805fb71cf07634edcad1096d1616a8a729268bc,0,Misty Stanley-Jones,2016-05-31 22:39:09+00:00,['975eeff467891be0abea23e2c4f6c304156e8785'],21,42,63,829797,2,,,,1675
e5600027ab0100fcb8d3d95bd4c5810f0c810d4e,0,Misty Stanley-Jones,2016-05-31 22:42:19+00:00,['5805fb71cf07634edcad1096d1616a8a729268bc'],1,14,15,829812,1,,,,1675
5bec538a5d915460d266af0e5a523359f39fa900,0,Dan Burkert,2016-06-01 00:01:22+00:00,['e5600027ab0100fcb8d3d95bd4c5810f0c810d4e'],148,121,269,830081,18,1,0.393939394,0.424242424,1675
02c4c7eda2c597089e26e52b034e633bd554fab3,0,Mike Percy,2016-06-01 02:02:13+00:00,['5bec538a5d915460d266af0e5a523359f39fa900'],0,15,15,830096,2,,,,1675
3d5572075bf07f35ed631c09571465d6493a28b1,0,Mike Percy,2016-06-01 02:26:03+00:00,['02c4c7eda2c597089e26e52b034e633bd554fab3'],10,6,16,830112,2,,,,1675
f20c99dec40f4f5e562f6de887022aa3e74e9c5a,0,Mike Percy,2016-06-01 02:26:16+00:00,['3d5572075bf07f35ed631c09571465d6493a28b1'],975,0,975,831087,7,0.45800317,0.091917591,0.217115689,1675
48e09ab953494779e54963948696d1bcbb77c744,0,Jean-Daniel Cryans,2016-06-01 20:50:58+00:00,['f20c99dec40f4f5e562f6de887022aa3e74e9c5a'],1,3,4,831091,1,,,,1675
0e9fd8c155e895af0c652267575c88b55172ce9e,0,Jean-Daniel Cryans,2016-06-02 00:48:50+00:00,['48e09ab953494779e54963948696d1bcbb77c744'],0,22,22,831113,1,,,,1675
cfa9a99f92d486c9d9afda82ce06f4f7f7efee4d,1,Dan Burkert,2016-06-02 00:51:53+00:00,['0e9fd8c155e895af0c652267575c88b55172ce9e'],426,431,857,831970,56,1,0.333333333,0,1675
8a75ceeee5d17b387b10134197023694ccaf289a,1,Dan Burkert,2016-06-02 00:51:59+00:00,['cfa9a99f92d486c9d9afda82ce06f4f7f7efee4d'],372,354,726,832696,54,0,0,0,1675
c820c775e3335909f69b31cd8402dada129cdaad,0,Dan Burkert,2016-06-02 03:01:37+00:00,['8a75ceeee5d17b387b10134197023694ccaf289a'],7,7,14,832710,1,,,,1675
fc1619be9cd3151ce78ba57412049884b01c4ba9,0,Dan Burkert,2016-06-02 17:22:20+00:00,['c820c775e3335909f69b31cd8402dada129cdaad'],30,43,73,832783,5,0.666666667,0.5,0.666666667,1675
244c92ea3301f9faf9e205d9cf2b811579826162,0,Dan Burkert,2016-06-02 23:28:16+00:00,['fc1619be9cd3151ce78ba57412049884b01c4ba9'],1,1,2,832785,1,,,,1675
776f6e0c1e076b3a8ff0357fd4da73f7e933433b,0,David Ribeiro Alves,2016-06-03 01:40:16+00:00,['244c92ea3301f9faf9e205d9cf2b811579826162'],3,0,3,832788,1,,,,1675
6034b8557387ad45aa12f332d6bed784569efb13,0,David Ribeiro Alves,2016-06-03 01:40:28+00:00,['776f6e0c1e076b3a8ff0357fd4da73f7e933433b'],9,4,13,832801,2,0,0,1,1675
ece7b5653998db318e4baa5d57f27ba3a836731d,0,Todd Lipcon,2016-06-03 13:49:55+00:00,['6034b8557387ad45aa12f332d6bed784569efb13'],11,289,300,833101,13,0.721518987,1,0.949367089,1678
7d7776414f9d014c2cf1b59ebf5946788489a486,0,Todd Lipcon,2016-06-03 14:21:37+00:00,['ece7b5653998db318e4baa5d57f27ba3a836731d'],1,1,2,833103,1,,,,1678
738e99384d4fa3c153922f2debeac3b5772e4c3e,0,Todd Lipcon,2016-06-03 14:45:09+00:00,['7d7776414f9d014c2cf1b59ebf5946788489a486'],267,189,456,833559,3,,,,1678
c24478b8384f20d0477f7901c0962c55999345fb,1,Dan Burkert,2016-06-03 20:16:26+00:00,['738e99384d4fa3c153922f2debeac3b5772e4c3e'],319,612,931,834490,16,0,0.383259912,0.986784141,1678
a2e24ba5c8c4f2432fa95ee1529f5b82cb523057,0,Todd Lipcon,2016-06-03 22:17:20+00:00,['c24478b8384f20d0477f7901c0962c55999345fb'],5,49,54,834544,2,0.055555556,1,1,1678
4044b94f8eb9481a7e25945d7bb270c40dfc7eaf,0,Mike Percy,2016-06-06 22:03:17+00:00,['a2e24ba5c8c4f2432fa95ee1529f5b82cb523057'],8,12,20,834564,2,0,0,1,1678
9cdfc66f6b1b4e926a00de33fc51ac60b9f286a2,0,Jean-Daniel Cryans,2016-06-07 22:44:51+00:00,['4044b94f8eb9481a7e25945d7bb270c40dfc7eaf'],28,36,64,834628,1,0,1,1,1678
e4833d2df35721c03955ef0902a70c2de2536f99,0,Dan Burkert,2016-06-08 01:32:28+00:00,['9cdfc66f6b1b4e926a00de33fc51ac60b9f286a2'],3,3,6,834634,2,,,,1678
d002e3257d49fe8e420c3d50eac54bb2d1952722,0,Dan Burkert,2016-06-08 01:58:27+00:00,['e4833d2df35721c03955ef0902a70c2de2536f99'],4,5,9,834643,1,,,,1678
5df10036974126f6a579467db25c6e1791504ebb,0,Jean-Daniel Cryans,2016-06-08 02:17:35+00:00,['d002e3257d49fe8e420c3d50eac54bb2d1952722'],25,17,42,834685,6,1,1,0,1678
5be6858d7f5b6d01c5c0115eae107489bcdbc04d,0,Jean-Daniel Cryans,2016-06-08 20:33:37+00:00,['5df10036974126f6a579467db25c6e1791504ebb'],14,50,64,834749,5,0,0,0,1678
f180051a85905ccef1a6b4b48f6a253c203af72f,0,Adar Dembo,2016-06-09 17:24:30+00:00,['5be6858d7f5b6d01c5c0115eae107489bcdbc04d'],6,6,12,834761,1,,,,1678
5f7823fe7f94edeb0f8dbb2b9d7a2201614e5e16,1,Mike Percy,2016-06-10 01:28:25+00:00,['f180051a85905ccef1a6b4b48f6a253c203af72f'],304,172,476,835237,13,0.363636364,0.74025974,0.532467532,1678
679c6b2c93313bd4371916678b4ea8f52b621a50,0,Adar Dembo,2016-06-10 02:24:15+00:00,['5f7823fe7f94edeb0f8dbb2b9d7a2201614e5e16'],26,41,67,835304,2,0.142857143,0.428571429,0,1678
d2f5b725c1620e17424fa3933f00499150478439,0,Jean-Daniel Cryans,2016-06-10 17:26:49+00:00,['679c6b2c93313bd4371916678b4ea8f52b621a50'],0,4,4,835308,1,,,,1678
04dd0e97ceed0546d10ec57387102ff5fd1de2c8,0,Adar Dembo,2016-06-10 19:09:20+00:00,['d2f5b725c1620e17424fa3933f00499150478439'],21,32,53,835361,1,0,0,1,1678
3844042cfabcaed5532b3f383ac0ad533daaad6a,0,David Ribeiro Alves,2016-06-10 21:05:28+00:00,['04dd0e97ceed0546d10ec57387102ff5fd1de2c8'],1,13,14,835375,1,,,,1678
db93ff68208fa94db98bb51d762d8377542a781e,0,Jean-Daniel Cryans,2016-06-13 18:01:37+00:00,['3844042cfabcaed5532b3f383ac0ad533daaad6a'],13,13,26,835401,1,,,,1678
1ead68156e455d9102ea7029fdeb16829bc8dbe1,0,Jean-Daniel Cryans,2016-06-13 18:01:52+00:00,['db93ff68208fa94db98bb51d762d8377542a781e'],0,1,1,835402,1,0,1,1,1678
00562f6bd8eab2fb2f8ad23863e628e743d9da2d,0,Jean-Daniel Cryans,2016-06-14 15:23:42+00:00,['1ead68156e455d9102ea7029fdeb16829bc8dbe1'],1,1,2,835404,1,,,,1678
5bf7455d82246af45d612bb2b86c611176472572,0,Jean-Daniel Cryans,2016-06-15 21:03:06-07:00,['fa7845442efd1e480293bf953ff5b1c941e29bb1'],1,1,2,835406,1,,,,1678
5d3e245ca16024a88470defe1d7c519d53350033,0,Jean-Daniel Cryans,2016-06-15 21:18:40-07:00,['5bf7455d82246af45d612bb2b86c611176472572'],7,25,32,835438,5,0,0.75,1,1678
ee4fc9f6b7b7d81127ec623a630c9221511444f8,1,Mike Percy,2016-06-16 22:34:27+00:00,['00562f6bd8eab2fb2f8ad23863e628e743d9da2d'],3,28,31,835469,3,0.666666667,0,1,1678
99f4be13d81b4bb7d5db2f78f465ff61a390a3db,0,Mike Percy,2016-06-16 22:39:32+00:00,['ee4fc9f6b7b7d81127ec623a630c9221511444f8'],1,3,4,835473,1,0,1,1,1678
670b8a84008064830b6ffb640a62c20c6fd6d013,0,Mike Percy,2016-06-16 23:55:53+00:00,['99f4be13d81b4bb7d5db2f78f465ff61a390a3db'],0,1,1,835474,1,,,,1678
e8990015e937e4a55730a29375556b6967501eef,0,Mike Percy,2016-06-17 06:28:07+00:00,['670b8a84008064830b6ffb640a62c20c6fd6d013'],39,68,107,835581,13,0.739130435,1,0.956521739,1678
35a92b49913ceea80d9c0c61cb7af2ebcf007751,1,Mike Percy,2016-06-17 06:28:33+00:00,['e8990015e937e4a55730a29375556b6967501eef'],406,31,437,836018,20,0.524691358,0.117283951,0.166666667,1678
1fe49562d114299e908cbcb0888ed16412fa8641,0,Adar Dembo,2016-06-17 19:05:10+00:00,['35a92b49913ceea80d9c0c61cb7af2ebcf007751'],0,344,344,836362,2,,,,1679
e18f6ab217fcc9c910284021c6ed998e5ce70ee4,0,Mike Percy,2016-06-17 19:39:25+00:00,['1fe49562d114299e908cbcb0888ed16412fa8641'],179,148,327,836689,1,,,,1679
c0ba5359068a69722cd35b9b5bd95d30d902cc74,0,Jean-Daniel Cryans,2016-06-17 21:06:44+00:00,['e18f6ab217fcc9c910284021c6ed998e5ce70ee4'],93,134,227,836916,5,0.5,0,0.5,1679
1a97c42c678c22ac1aebfbb159402958e5c93952,0,Jean-Daniel Cryans,2016-06-17 21:06:59+00:00,['c0ba5359068a69722cd35b9b5bd95d30d902cc74'],29,45,74,836990,2,1,1,0,1679
bd549e13743a51013585ba8446265bada5b56ed6,0,Adar Dembo,2016-06-18 00:33:55+00:00,['1a97c42c678c22ac1aebfbb159402958e5c93952'],0,18,18,837008,1,,,,1679
0c8f72b4c5d637dba4c0c0da4f55ea918c287d88,1,Jean-Daniel Cryans,2016-06-21 01:11:32+00:00,['bd549e13743a51013585ba8446265bada5b56ed6'],4,157,161,837169,4,0.338235294,1,0.941176471,1681
8e7e449f48dc2c7b96b9b41282129a5751052adf,0,David Ribeiro Alves,2016-06-21 02:59:27+00:00,['0c8f72b4c5d637dba4c0c0da4f55ea918c287d88'],2,3,5,837174,1,,,,1681
021658dfbc30f79254271cf80d43080462e129e2,0,David Ribeiro Alves,2016-06-21 02:59:36+00:00,['8e7e449f48dc2c7b96b9b41282129a5751052adf'],0,4,4,837178,1,,,,1681
3bfe7127778f7a855c3599c3cf58439140edbdc9,1,David Ribeiro Alves,2016-06-21 18:17:40+00:00,['021658dfbc30f79254271cf80d43080462e129e2'],3,3,6,837184,3,,,,1681
a35d556d0cab6c6520d0d08a78f103cb7d3bf0bc,0,Adar Dembo,2016-06-22 01:53:32+00:00,['3bfe7127778f7a855c3599c3cf58439140edbdc9'],0,19,19,837203,1,,,,1681
5f7d79910d8da492195b5c22a6d9a7911f950107,0,Adar Dembo,2016-06-22 02:52:39+00:00,['a35d556d0cab6c6520d0d08a78f103cb7d3bf0bc'],1,1,2,837205,1,,,,1681
0bb59836fb3e4b92e2d88674e8b88546faac5c8b,0,Todd Lipcon,2016-06-22 15:17:48+00:00,['5f7d79910d8da492195b5c22a6d9a7911f950107'],3,23,26,837231,1,1,1,1,1681
869d5205fde17ea53f75e85e5c3df9952430ec67,0,Todd Lipcon,2016-06-22 20:18:19+00:00,['0bb59836fb3e4b92e2d88674e8b88546faac5c8b'],15,25,40,837271,6,0.666666667,0.833333333,0.833333333,1681
4983a79827a8b674fe139250b7171d361e1b47b9,0,Todd Lipcon,2016-06-22 20:18:25+00:00,['869d5205fde17ea53f75e85e5c3df9952430ec67'],2,0,2,837273,1,,,,1681
c2d68da783315c79162870328da5761484eeabf8,0,Mike Percy,2016-06-22 20:19:37+00:00,['4983a79827a8b674fe139250b7171d361e1b47b9'],9,139,148,837421,9,0,0.139240506,0.987341772,1681
7d5788225e4fc21bc376e7732502e8789aad698f,0,Mike Percy,2016-06-22 21:26:02+00:00,['c2d68da783315c79162870328da5761484eeabf8'],26,50,76,837497,8,1,1,1,1681
d952b70f670247709ede7832d870657eb636143b,0,Mike Percy,2016-06-22 22:46:38+00:00,['7d5788225e4fc21bc376e7732502e8789aad698f'],1,57,58,837555,3,0.534883721,1,1,1681
d685747426472d428b1d071df00d112d9f775117,1,Mike Percy,2016-06-22 23:37:10+00:00,['d952b70f670247709ede7832d870657eb636143b'],24,158,182,837737,8,0,1,0.555555556,1681
7b280a0adb2cf3c1dd2f1256f6a47c89ab77a362,0,Todd Lipcon,2016-06-23 00:28:47+00:00,['d685747426472d428b1d071df00d112d9f775117'],3,9,12,837749,1,,,,1681
19e78f727fa66316833c513b528f389b006ce419,0,Todd Lipcon,2016-06-23 00:47:42+00:00,['7b280a0adb2cf3c1dd2f1256f6a47c89ab77a362'],3,4,7,837756,1,1,1,1,1681
dceb0015d43e81b1ab0450c69fd81e440412d574,0,David Ribeiro Alves,2016-06-23 01:06:17+00:00,['19e78f727fa66316833c513b528f389b006ce419'],1,34,35,837791,3,0.769230769,1,0.769230769,1681
6894438a406a635dc8a8f3bd77862294163cc7fb,1,Todd Lipcon,2016-06-23 02:54:52+00:00,['dceb0015d43e81b1ab0450c69fd81e440412d574'],23,148,171,837962,7,0.274509804,0.607843137,1,1681
5c0a762ab5d4920d9ab5d03fa8c22c5b63609c7a,0,Todd Lipcon,2016-06-23 19:49:08+00:00,['6894438a406a635dc8a8f3bd77862294163cc7fb'],1,1,2,837964,1,,,,1681
e45fc7b4d4bc3deac57aa5d31fb08b60e8fd2999,0,Todd Lipcon,2016-06-23 21:20:02+00:00,['5c0a762ab5d4920d9ab5d03fa8c22c5b63609c7a'],3,34,37,838001,2,,,,1681
194c9a0f7cd8b0955c13ebc9ab321e6190de9acb,1,Adar Dembo,2016-06-23 21:52:11+00:00,['e45fc7b4d4bc3deac57aa5d31fb08b60e8fd2999'],1,1,2,838003,1,,,,1681
630a83bd52ad2cbac1b598de8d07be50e9923a1e,1,Todd Lipcon,2016-06-23 23:17:06+00:00,['194c9a0f7cd8b0955c13ebc9ab321e6190de9acb'],71,234,305,838308,23,0.708333333,0.604166667,0.979166667,1681
c266702b908bb2a537fd30d8c4bb2e5cf8144cfc,0,Mike Percy,2016-06-24 00:40:44+00:00,['630a83bd52ad2cbac1b598de8d07be50e9923a1e'],48,82,130,838438,5,0.857142857,1,0.642857143,1681
47c023f5eba708a184666e53d4a3000177a32fbc,1,Mike Percy,2016-06-24 00:41:00+00:00,['c266702b908bb2a537fd30d8c4bb2e5cf8144cfc'],73,610,683,839121,14,0.209677419,0.375,0.838709677,1683
4b48dad1e9e6bb596d590c77eeaaf00b4b241bde,0,Dan Burkert,2016-06-24 18:44:08+00:00,['47c023f5eba708a184666e53d4a3000177a32fbc'],1,1,2,839123,1,,,,1683
ea9dedbd1b2520319006b59181d1b1d2f445f202,0,Dan Burkert,2016-06-24 23:08:04+00:00,['4b48dad1e9e6bb596d590c77eeaaf00b4b241bde'],86,68,154,839277,31,1,0,0.25,1683
f38cfc8e9262781af7f9d42046ac46b01a69b1d9,0,Todd Lipcon,2016-06-25 00:27:43+00:00,['ea9dedbd1b2520319006b59181d1b1d2f445f202'],1,3,4,839281,2,0,0,0.5,1683
11de5f2d120afc4edd1ccee03c5aca2899f12832,0,Adar Dembo,2016-06-26 23:33:36+00:00,['f38cfc8e9262781af7f9d42046ac46b01a69b1d9'],19,86,105,839386,2,1,1,1,1684
cb8f175894862e33fc3ec58879b4a6f7d4e24e1a,0,Todd Lipcon,2016-06-27 17:10:58+00:00,['11de5f2d120afc4edd1ccee03c5aca2899f12832'],8,12,20,839406,1,0,0,1,1684
9cc3c7022efef8a29aebf61629f3ee9147029d2d,0,David Ribeiro Alves,2016-06-27 20:14:20+00:00,['cb8f175894862e33fc3ec58879b4a6f7d4e24e1a'],0,8,8,839414,1,,,,1684
cef102d9928237cb4914420345f0965b160cb046,0,Adar Dembo,2016-06-27 21:26:37+00:00,['9cc3c7022efef8a29aebf61629f3ee9147029d2d'],14,13,27,839441,4,0,0,0,1684
bb16e36af6d792f84df1932c18fc3a3855917a88,0,Jean-Daniel Cryans,2016-06-27 23:44:29+00:00,['cef102d9928237cb4914420345f0965b160cb046'],5,6,11,839452,1,1,1,1,1684
4cac79f3ff4edf745b5b0679c3e4f1bb128e6e41,0,Todd Lipcon,2016-06-28 18:42:34+00:00,['bb16e36af6d792f84df1932c18fc3a3855917a88'],1,10,11,839463,2,,,,1684
e71b18fbfa900a99023a0bdcc1b344c0b1b4c489,0,Mike Percy,2016-06-28 20:02:46+00:00,['4cac79f3ff4edf745b5b0679c3e4f1bb128e6e41'],1,1,2,839465,1,,,,1684
8858b22ac7e8d832901bfc7642aafde848bb0b7b,0,Adar Dembo,2016-06-29 00:31:15+00:00,['e71b18fbfa900a99023a0bdcc1b344c0b1b4c489'],5,122,127,839592,5,0.967741935,1,1,1686
49e60de28aede0adbe82268924283c133fd85e8b,0,Todd Lipcon,2016-06-29 00:31:16+00:00,['8858b22ac7e8d832901bfc7642aafde848bb0b7b'],1,1,2,839594,1,,,,1686
7a60a073c7f42f26a04c42e3c03df8a06ba87f92,0,Adar Dembo,2016-06-29 00:31:20+00:00,['49e60de28aede0adbe82268924283c133fd85e8b'],20,20,40,839634,9,,,,1686
89b14675db7990fc3726fb9cf7bbd3122a212569,1,Adar Dembo,2016-06-29 00:31:24+00:00,['7a60a073c7f42f26a04c42e3c03df8a06ba87f92'],64,56,120,839754,10,,,,1686
e84cfdf3ccf78ca62912e425869fb708affbf0fe,0,Adar Dembo,2016-06-29 00:32:55+00:00,['89b14675db7990fc3726fb9cf7bbd3122a212569'],27,24,51,839805,8,,,,1686
5b83695bcfda9499701ac1974a5c169e1bcfbc60,0,Adar Dembo,2016-06-29 00:32:58+00:00,['e84cfdf3ccf78ca62912e425869fb708affbf0fe'],1560,100,1660,841465,26,0.493171472,0.344461305,0,1687
8b332e678546ec0c6621af333dd0f3d6e3adaa90,0,Adar Dembo,2016-06-29 18:27:08+00:00,['5b83695bcfda9499701ac1974a5c169e1bcfbc60'],2,5,7,841472,1,,,,1687
1c82e59b16150dcaf9c35cde4b58e03f9d09639c,0,Todd Lipcon,2016-06-29 20:38:30+00:00,['8b332e678546ec0c6621af333dd0f3d6e3adaa90'],33,0,33,841505,2,1,0,0,1687
133767185047987e1d7f768d09db950dc8e38897,1,Todd Lipcon,2016-06-29 22:05:08+00:00,['1c82e59b16150dcaf9c35cde4b58e03f9d09639c'],18,46,64,841569,6,1,0.777777778,1,1687
1b7abe081817b5f9af979407df105a08dd226521,1,Todd Lipcon,2016-06-29 22:12:28+00:00,['133767185047987e1d7f768d09db950dc8e38897'],2,9,11,841580,3,1,1,1,1687
6583dffef68ae6bf13aa682a366ced92f222391d,0,Jean-Daniel Cryans,2016-06-30 17:20:24+00:00,['1b7abe081817b5f9af979407df105a08dd226521'],11,20,31,841611,1,0,1,1,1687
e0257ea41193694259342859ca10bd710953cdb6,0,Dan Burkert,2016-06-30 17:22:42+00:00,['6583dffef68ae6bf13aa682a366ced92f222391d'],0,5,5,841616,3,0,1,0.5,1687
9f9e3b80dfcb6df7cea07b10af47674c1383a25a,0,Mike Percy,2016-06-30 20:14:49+00:00,['e0257ea41193694259342859ca10bd710953cdb6'],20,41,61,841677,2,0.294117647,1,1,1687
aa3d4473d229807fa8ee27c6ffb5b4b6fb2893a4,1,Dan Burkert,2016-06-30 20:57:56+00:00,['9f9e3b80dfcb6df7cea07b10af47674c1383a25a'],598,552,1150,842827,9,0.383333333,0.55,0,1687
88acae32aa8f28407a97a79525e8858e7ceb3cbc,0,Jean-Daniel Cryans,2016-07-01 00:10:53+00:00,['aa3d4473d229807fa8ee27c6ffb5b4b6fb2893a4'],0,6,6,842833,2,0,1,1,1687
3e3917344f4cd8cede7451aebbd459d46055315f,0,Mike Percy,2016-07-01 01:22:41+00:00,['88acae32aa8f28407a97a79525e8858e7ceb3cbc'],1,4,5,842838,1,,,,1687
6ff6f289b2ac63e97ca97760825be18ffb0a7c0c,0,Adar Dembo,2016-07-01 02:01:31+00:00,['3e3917344f4cd8cede7451aebbd459d46055315f'],5,9,14,842852,1,1,1,1,1687
200b8c286de416b97d136606964a1bfa5d55c17e,0,Adar Dembo,2016-07-01 18:07:30+00:00,['6ff6f289b2ac63e97ca97760825be18ffb0a7c0c'],32,45,77,842929,1,0.5,1,1,1687
c7ecdf0ef6e771711a51f7384e31bec5ae9daa0b,0,Jean-Daniel Cryans,2016-07-01 18:09:51+00:00,['200b8c286de416b97d136606964a1bfa5d55c17e'],4,3,7,842936,1,1,1,0,1687
1ebfa6c6632674b20e13d6ef125d07c459a73d61,0,Todd Lipcon,2016-07-01 18:53:30+00:00,['c7ecdf0ef6e771711a51f7384e31bec5ae9daa0b'],11,11,22,842958,2,0,0,0,1687
3692233b8d27f2f5841871bdca57a1801c982a69,1,Dan Burkert,2016-07-05 17:12:04+00:00,['1ebfa6c6632674b20e13d6ef125d07c459a73d61'],3,66,69,843027,4,0.473684211,1,1,1687
a8a2e1983392370358610c5ea237423efaa11c12,1,Jean-Daniel Cryans,2016-07-06 01:56:41+00:00,['3692233b8d27f2f5841871bdca57a1801c982a69'],138,839,977,844004,22,0.103194103,0.656019656,0.835380835,1689
abd4a13acea00d6c98558b36673fe1a3a5298314,0,David Ribeiro Alves,2016-07-07 03:44:32+00:00,['a8a2e1983392370358610c5ea237423efaa11c12'],2,2,4,844008,2,,,,1689
070ea6b9d6b3325d6b4fbda1c58d26376a0bbefd,0,David Ribeiro Alves,2016-07-07 04:21:19+00:00,['abd4a13acea00d6c98558b36673fe1a3a5298314'],1,1,2,844010,1,,,,1689
998414caa2bc09df40d963a6112ad9c826010176,0,David Ribeiro Alves,2016-07-07 04:21:36+00:00,['070ea6b9d6b3325d6b4fbda1c58d26376a0bbefd'],2,10,12,844022,1,0,1,0.571428571,1689
dd341b7ee8fac06033d9b34f5ba594c3bfca74e7,0,David Ribeiro Alves,2016-07-07 05:24:36+00:00,['998414caa2bc09df40d963a6112ad9c826010176'],10,2,12,844034,1,1,0,0.428571429,1689
b130c5ad47d0dd84b1deb3c7551a62468360bdb1,0,Jean-Daniel Cryans,2016-07-07 18:16:02+00:00,['dd341b7ee8fac06033d9b34f5ba594c3bfca74e7'],1,2,3,844037,1,,,,1689
fb41e96d2405337696f76b5af532bd2770f839ad,0,Adar Dembo,2016-07-07 18:32:40+00:00,['b130c5ad47d0dd84b1deb3c7551a62468360bdb1'],7,13,20,844057,3,1,1,1,1689
0212b7ecd59e1ae0054cfd6d227dbf7d8e8028f2,0,Adar Dembo,2016-07-07 18:32:45+00:00,['fb41e96d2405337696f76b5af532bd2770f839ad'],34,16,50,844107,2,0.071428571,0,1,1689
1a971a1c71d83453db3b8f76029d81d695fad270,0,Adar Dembo,2016-07-10 22:20:29+00:00,['0212b7ecd59e1ae0054cfd6d227dbf7d8e8028f2'],108,86,194,844301,1,0,0,1,1689
a22795aa6fd2be93ad3fc22892849c808eade007,1,David Ribeiro Alves,2016-07-11 18:09:53+00:00,['1a971a1c71d83453db3b8f76029d81d695fad270'],0,70,70,844371,2,1,1,0.484848485,1689
48fc399ebc76e5b4958a809a72f2674def5cebb7,0,David Ribeiro Alves,2016-07-11 18:10:03+00:00,['a22795aa6fd2be93ad3fc22892849c808eade007'],0,27,27,844398,2,1,1,1,1689
2e34e315e677df76b2365bd76f01252478d67326,0,David Ribeiro Alves,2016-07-11 18:18:49+00:00,['48fc399ebc76e5b4958a809a72f2674def5cebb7'],2,27,29,844427,2,0,1,1,1689
1f8ab62ff86b5be48a6072606f7cd9b59150ca56,0,Adar Dembo,2016-07-12 01:42:11+00:00,['2e34e315e677df76b2365bd76f01252478d67326'],4,40,44,844471,3,1,1,1,1689
45a87a9371e0885389f0c6b2a4e3875a9e1ea5ff,0,Mike Percy,2016-07-12 07:45:10+00:00,['1f8ab62ff86b5be48a6072606f7cd9b59150ca56'],5,7,12,844483,1,,,,1689
074f849c8e5967bb4265b0dc83e244354263b105,0,Mike Percy,2016-07-12 07:45:18+00:00,['45a87a9371e0885389f0c6b2a4e3875a9e1ea5ff'],0,1,1,844484,1,,,,1689
90d610fe75d198dd9c35d2855023726a41b670ac,0,Todd Lipcon,2016-07-13 03:52:04+00:00,['074f849c8e5967bb4265b0dc83e244354263b105'],0,599,599,845083,4,0.502304147,0.649769585,0.589861751,1691
3c01d4c058ab07f2346d83a8750bcb0839a4bd97,0,Todd Lipcon,2016-07-13 03:54:57+00:00,['90d610fe75d198dd9c35d2855023726a41b670ac'],0,12,12,845095,3,1,1,1,1691
374527a83f17a420ea337e99b6a99c40efd95dce,0,Todd Lipcon,2016-07-13 04:13:03+00:00,['3c01d4c058ab07f2346d83a8750bcb0839a4bd97'],0,28,28,845123,1,,,,1691
1a1d3a8d2353766bacff17e745554c61ed1d3286,0,David Ribeiro Alves,2016-07-13 05:15:41+00:00,['374527a83f17a420ea337e99b6a99c40efd95dce'],20,16,36,845159,3,0.857142857,0,0,1691
146fe826bd9cf9c4c4203cd6a561919fbe303e7b,0,Mike Percy,2016-07-14 16:16:22+00:00,['1a1d3a8d2353766bacff17e745554c61ed1d3286'],1,1,2,845161,1,,,,1691
4e99544d64e59ca9c0525fc0faf06546977c3055,1,Dan Burkert,2016-07-14 17:42:45+00:00,['146fe826bd9cf9c4c4203cd6a561919fbe303e7b'],5,5,10,845171,1,,,,1691
8c68d35061aece52203c6eb0bb8de75474245a95,0,Adar Dembo,2016-07-14 18:01:14+00:00,['4e99544d64e59ca9c0525fc0faf06546977c3055'],31,44,75,845246,3,0.7,0.8,0.9,1691
71a5bb5070f144f8df356f5e28dd4e063de3df5e,0,Adar Dembo,2016-07-14 18:02:27+00:00,['8c68d35061aece52203c6eb0bb8de75474245a95'],0,54,54,845300,2,0.083333333,1,1,1691
37f160475cc2de545c7f1dea93bc45057cfb8d7f,1,Adar Dembo,2016-07-14 20:54:51+00:00,['71a5bb5070f144f8df356f5e28dd4e063de3df5e'],68,34,102,845402,4,1,1,1,1691
2525ad094234e6bc901b8bc544801ca00e8f411e,0,Adar Dembo,2016-07-14 20:55:22+00:00,['37f160475cc2de545c7f1dea93bc45057cfb8d7f'],1,3,4,845406,1,1,1,1,1691
d1d3cfe77d4fcd4e208cb6214deb654b9e8765fb,1,Adar Dembo,2016-07-14 21:09:50+00:00,['2525ad094234e6bc901b8bc544801ca00e8f411e'],146,336,482,845888,6,0.037037037,0.5,1,1691
05369115d4c4f73eb5dec53ef155ea5fabdf8c87,0,Adar Dembo,2016-07-14 21:10:10+00:00,['d1d3cfe77d4fcd4e208cb6214deb654b9e8765fb'],30,231,261,846149,3,0,0.215277778,0.847222222,1691
5d4d2b1cb78df72c918c612c97309fbef2947c41,1,David Ribeiro Alves,2016-07-14 21:28:41+00:00,['05369115d4c4f73eb5dec53ef155ea5fabdf8c87'],53,372,425,846574,21,0.162921348,0.629213483,0.691011236,1692
16b5bd27ced666e774ad8fcceccd662cd634a4dc,1,David Ribeiro Alves,2016-07-14 21:29:00+00:00,['5d4d2b1cb78df72c918c612c97309fbef2947c41'],6,244,250,846824,10,0.184931507,0.815068493,0.767123288,1692
dfd4d66482123a74a7f6cc76f538606adde67f31,0,David Ribeiro Alves,2016-07-14 21:36:01+00:00,['16b5bd27ced666e774ad8fcceccd662cd634a4dc'],5,69,74,846898,2,0.906976744,0.906976744,1,1692
b666cc07e35d3468158555af9e61cc74bc0930b5,0,Jean-Daniel Cryans,2016-07-14 22:36:26+00:00,['dfd4d66482123a74a7f6cc76f538606adde67f31'],10,10,20,846918,9,,,,1692
257ba2923ad962193fbca49b3d22b9fb6a578509,1,David Ribeiro Alves,2016-07-14 22:57:20+00:00,['b666cc07e35d3468158555af9e61cc74bc0930b5'],1,26,27,846945,6,0.285714286,0.714285714,0.571428571,1692
ee38093949fd7ccb773025e6ec7e8e60daa31149,0,David Ribeiro Alves,2016-07-14 23:48:30+00:00,['257ba2923ad962193fbca49b3d22b9fb6a578509'],59,85,144,847089,18,,,,1693
0412fa7686d70720b7ac67b66ae85dc832963636,0,David Ribeiro Alves,2016-07-15 00:05:41+00:00,['ee38093949fd7ccb773025e6ec7e8e60daa31149'],2,10,12,847101,1,0,1,0.571428571,1693
6d2679bd14fdf454f2b194c83cd90316776d4dfe,1,David Ribeiro Alves,2016-07-15 00:10:44+00:00,['0412fa7686d70720b7ac67b66ae85dc832963636'],41,399,440,847541,25,0.209459459,0.506756757,0.736486486,1693
59ab14b9a8927dd08b34c3e4e6be9649f6e7dd9c,0,Mike Percy,2016-07-15 00:57:01+00:00,['6d2679bd14fdf454f2b194c83cd90316776d4dfe'],4,3,7,847548,1,,,,1693
d0cff255f84e75b70c0c39ccd34a35f348e3c722,1,David Ribeiro Alves,2016-07-15 01:48:49+00:00,['59ab14b9a8927dd08b34c3e4e6be9649f6e7dd9c'],33,326,359,847907,6,0.028248588,0.231638418,0.237288136,1694
17e2ae570b825a54d793e6537acca8f9cb7f8f54,1,Jean-Daniel Cryans,2016-07-15 23:35:43+00:00,['d0cff255f84e75b70c0c39ccd34a35f348e3c722'],4,11,15,847922,2,0.142857143,1,1,1694
df1c7a5a4335421d749506be7b9fe3e1cfa5f829,0,Mike Percy,2016-07-15 23:50:20+00:00,['17e2ae570b825a54d793e6537acca8f9cb7f8f54'],0,195,195,848117,1,,,,1695
7e3794c47959c2f106fbd59daaa702e9f7243a9f,0,Mike Percy,2016-07-18 19:16:05+00:00,['df1c7a5a4335421d749506be7b9fe3e1cfa5f829'],0,7,7,848124,1,1,1,1,1695
2a3d898cef167cda57570f963a46f626d59651e6,0,Adar Dembo,2016-07-18 23:00:48+00:00,['7e3794c47959c2f106fbd59daaa702e9f7243a9f'],4,314,318,848442,4,0.284090909,0.738636364,1,1696
0a10606379b08b731ef680afd2291e44c671315a,0,Adar Dembo,2016-07-18 23:01:00+00:00,['2a3d898cef167cda57570f963a46f626d59651e6'],41,78,119,848561,9,0.051282051,1,0.333333333,1696
2521554b3f30b8711519c20292b933f15ce2a529,0,Todd Lipcon,2016-07-18 23:12:12+00:00,['0a10606379b08b731ef680afd2291e44c671315a'],29,61,90,848651,2,0.142857143,0.714285714,1,1696
5668d2c48103c654cada3a921569a444580f3b9f,0,Mike Percy,2016-07-19 19:25:43+00:00,['2521554b3f30b8711519c20292b933f15ce2a529'],4,2,6,848657,1,,,,1696
7e2783c673d4559f74e205a797ae42b67ffb689c,0,Dan Burkert,2016-07-19 21:25:42+00:00,['5668d2c48103c654cada3a921569a444580f3b9f'],2,194,196,848853,6,0,0.745098039,0.888888889,1696
e831ab4303640443143c4635796bc24262314637,1,Dan Burkert,2016-07-19 21:31:50+00:00,['7e2783c673d4559f74e205a797ae42b67ffb689c'],134,433,567,849420,10,0.450980392,0.830065359,0.993464052,1696
53c3b2c66a4cf00efa63660df4f81c288aee7775,0,Dan Burkert,2016-07-19 23:21:31+00:00,['e831ab4303640443143c4635796bc24262314637'],0,3,3,849423,1,0,0,1,1696
3ee54af7b5809d4489e6e8d5a28cef59ae39e4b9,0,Mike Percy,2016-07-20 02:47:59+00:00,['53c3b2c66a4cf00efa63660df4f81c288aee7775'],3,14,17,849440,1,0,0,1,1696
c637abe1ce3646360f272c39c30959ea23626a93,1,Todd Lipcon,2016-07-20 18:28:15+00:00,['3ee54af7b5809d4489e6e8d5a28cef59ae39e4b9'],8,22,30,849470,4,0,1,1,1696
5ded9a68ac10115fe6228e49f81fb43058a9f617,1,Todd Lipcon,2016-07-20 18:50:48+00:00,['c637abe1ce3646360f272c39c30959ea23626a93'],2,7,9,849479,1,1,1,1,1696
bb46137638e69205505efd5ee174edeb01cb3ef1,0,Todd Lipcon,2016-07-20 19:04:26+00:00,['5ded9a68ac10115fe6228e49f81fb43058a9f617'],1,1,2,849481,1,,,,1696
30721c7066db8f999e399a966592e490481b621f,0,Mike Percy,2016-07-20 23:15:59+00:00,['bb46137638e69205505efd5ee174edeb01cb3ef1'],1,1,2,849483,1,,,,1696
83d692304a6ecb0d04dcd757ffcceb2a63c61132,0,Mike Percy,2016-07-21 01:17:34+00:00,['30721c7066db8f999e399a966592e490481b621f'],1,8,9,849492,1,0,1,1,1696
0a792366ea44beff17f3bec659b3def8cb669e68,1,Jean-Daniel Cryans,2016-07-21 22:37:59+00:00,['83d692304a6ecb0d04dcd757ffcceb2a63c61132'],520,406,926,850418,26,0,0.938461538,0.876923077,1696
b57b02b947512e1f40fd19df13cb89542eddb2c5,1,Jean-Daniel Cryans,2016-07-21 22:38:17+00:00,['0a792366ea44beff17f3bec659b3def8cb669e68'],3,214,217,850635,11,0.543209877,0.87654321,0.987654321,1698
496135ab3b34b17a2ceb25a3f50cd7c26b771dd8,0,Jean-Daniel Cryans,2016-07-22 14:42:42+00:00,['b57b02b947512e1f40fd19df13cb89542eddb2c5'],4,1,5,850640,1,1,0,0,1698
3dd0ad2aa7192e03f36feb3f27092369329247c1,0,Todd Lipcon,2016-07-22 16:48:41+00:00,['496135ab3b34b17a2ceb25a3f50cd7c26b771dd8'],75,45,120,850760,20,,,,1698
3cb390e380e120c4895ed3a57cad2a05506e83fe,0,Dan Burkert,2016-07-22 18:25:45+00:00,['3dd0ad2aa7192e03f36feb3f27092369329247c1'],726,1303,2029,852789,5,,,,1699
ea02b1a3bbd5f9dc4cdbf18ed302ab56c91843ff,0,Mike Percy,2016-07-22 18:35:12+00:00,['3cb390e380e120c4895ed3a57cad2a05506e83fe'],3,3,6,852795,2,,,,1699
c0b4f508d234a890f0cee6e3f997fba3d40cb6cb,1,Adar Dembo,2016-07-22 20:20:38+00:00,['ea02b1a3bbd5f9dc4cdbf18ed302ab56c91843ff'],38,63,101,852896,5,0,0.833333333,0.75,1699
513d6e9f5d42242edb3c3f40f0c5c968873160ea,1,Jean-Daniel Cryans,2016-07-22 20:22:43+00:00,['c0b4f508d234a890f0cee6e3f997fba3d40cb6cb'],130,402,532,853428,12,0,0.680203046,0.852791878,1699
7ba9d994448dade702c959febe51abebce65920c,1,Jean-Daniel Cryans,2016-07-22 20:23:31+00:00,['513d6e9f5d42242edb3c3f40f0c5c968873160ea'],19,30,49,853477,4,1,1,1,1699
9cc2e041f3440fe9a731644bbc269b2fdace8fab,0,Jean-Daniel Cryans,2016-07-22 20:24:56+00:00,['7ba9d994448dade702c959febe51abebce65920c'],7,22,29,853506,1,0,1,1,1699
2e04bf54c562d1d75f5ad50760affc0aeb5ed7c2,0,Jean-Daniel Cryans,2016-07-22 20:28:45+00:00,['9cc2e041f3440fe9a731644bbc269b2fdace8fab'],4,17,21,853527,2,0,0.545454545,1,1699
bcf1adc1b88fe28bf89b4b8c1a4daac96c7f0242,1,Jean-Daniel Cryans,2016-07-22 20:34:58+00:00,['2e04bf54c562d1d75f5ad50760affc0aeb5ed7c2'],10,17,27,853554,2,0,1,1,1699
f9928e8a1012d8f7ff28ba0c963db5c4f33df25b,1,Jean-Daniel Cryans,2016-07-22 20:42:47+00:00,['bcf1adc1b88fe28bf89b4b8c1a4daac96c7f0242'],61,179,240,853794,9,0.916666667,1,1,1699
e8ddee8047b33e3dd1d97f25ef8773242f64212d,1,Jean-Daniel Cryans,2016-07-22 20:43:08+00:00,['f9928e8a1012d8f7ff28ba0c963db5c4f33df25b'],60,110,170,853964,6,0.642857143,0.214285714,1,1699
14524f84db49ea44d5f51b873d2b875a2a2dbd75,0,Jean-Daniel Cryans,2016-07-22 20:59:54+00:00,['e8ddee8047b33e3dd1d97f25ef8773242f64212d'],7,8,15,853979,1,1,1,0,1699
ddc2047f57ba4b541cc7156d6b9aa7558ca3818e,0,Mike Percy,2016-07-23 00:22:56+00:00,['14524f84db49ea44d5f51b873d2b875a2a2dbd75'],2,6,8,853987,1,,,,1699
88a1cf0db2d4cb912a65be239492a3d3fceed69c,0,Todd Lipcon,2016-07-23 01:58:13+00:00,['ddc2047f57ba4b541cc7156d6b9aa7558ca3818e'],10,50,60,854047,6,0.090909091,0.363636364,0.727272727,1699
5c305689b301140c8e656af16175e9b3c841cd5c,0,Jean-Daniel Cryans,2016-07-25 17:13:53+00:00,['88a1cf0db2d4cb912a65be239492a3d3fceed69c'],0,0,0,854047,159,,,,1699
81b2d9a7c925174c525a85c04a6ffd5a6d8537f6,1,Jean-Daniel Cryans,2016-07-25 17:14:23+00:00,['5c305689b301140c8e656af16175e9b3c841cd5c'],698,698,1396,855443,191,,,,1699
96c096010ffe945b58aa722bb0a01149f157a15a,0,Mike Percy,2016-07-26 00:39:41+00:00,['81b2d9a7c925174c525a85c04a6ffd5a6d8537f6'],13,42,55,855498,2,,,,1699
9cd3936073572dac93157a9a79e4811df3b60bb4,0,Mike Percy,2016-07-26 22:36:04+00:00,['96c096010ffe945b58aa722bb0a01149f157a15a'],9,22,31,855529,1,,,,1699
8d89d5fcb4bf6641dbbc53607530efd08da1e8f1,0,Todd Lipcon,2016-07-31 23:35:00+00:00,['9cd3936073572dac93157a9a79e4811df3b60bb4'],4,3,7,855536,2,0,0,1,1699
8618ae2d6ce867879fe550c107f6178b167d507f,1,Todd Lipcon,2016-07-31 23:44:58+00:00,['8d89d5fcb4bf6641dbbc53607530efd08da1e8f1'],122,223,345,855881,13,0,1,0.677419355,1699
284591a866cc893ee596784298eaac296f0e1eac,1,Todd Lipcon,2016-07-31 23:45:56+00:00,['8618ae2d6ce867879fe550c107f6178b167d507f'],264,311,575,856456,7,1,1,1,1699
232474a51f727dc19a6cbbb56fc7d174553f196d,1,Dan Burkert,2016-08-01 15:31:08+00:00,['284591a866cc893ee596784298eaac296f0e1eac'],213,1215,1428,857884,20,0.128467153,0.55620438,0.665693431,1699
fb2022c4297945dcf6141e65f579b2172345adf9,1,Todd Lipcon,2016-08-01 21:13:32+00:00,['232474a51f727dc19a6cbbb56fc7d174553f196d'],13,419,432,858316,2,0.200956938,0.727272727,1,1700
d648141c86b5f1a8e8cf7a678c345c0ccf17a253,0,Todd Lipcon,2016-08-01 21:16:42+00:00,['fb2022c4297945dcf6141e65f579b2172345adf9'],7,97,104,858420,3,0.021276596,0.765957447,1,1700
42b65b039a66b0d9ee191c8228a2463966d3b282,0,Todd Lipcon,2016-08-01 21:17:09+00:00,['d648141c86b5f1a8e8cf7a678c345c0ccf17a253'],17,78,95,858515,3,0,1,1,1700
8301d27d4d516f218ba6942bd17e779af0a4a334,0,Adar Dembo,2016-08-01 22:05:20+00:00,['42b65b039a66b0d9ee191c8228a2463966d3b282'],2,1,3,858518,1,,,,1700
980b75193f3fc23bc7d4052caa9b4cecea88e39d,0,Adar Dembo,2016-08-01 22:39:44+00:00,['8301d27d4d516f218ba6942bd17e779af0a4a334'],1,1,2,858520,1,,,,1700
2ed1f37d42aa81214d9105d914f1d33ffa5d4a66,0,Adar Dembo,2016-08-01 22:43:14+00:00,['980b75193f3fc23bc7d4052caa9b4cecea88e39d'],1,1,2,858522,1,,,,1700
c9be27119c083d72d47903d44021c36436c963fc,0,Mike Percy,2016-08-02 00:18:25+00:00,['2ed1f37d42aa81214d9105d914f1d33ffa5d4a66'],3,315,318,858840,4,0.479452055,1,1,1702
085ceab3edc5f1d43582ebca94f3d340e01a9c9a,0,Adar Dembo,2016-08-02 00:37:05+00:00,['c9be27119c083d72d47903d44021c36436c963fc'],1,1,2,858842,1,,,,1702
fee3f672b17c381a0802d2f0a9fd74c772a5ee92,0,Todd Lipcon,2016-08-02 17:44:28+00:00,['085ceab3edc5f1d43582ebca94f3d340e01a9c9a'],1,1,2,858844,1,,,,1702
a9265d92424dc305c480d6c44d006b8545bd2227,0,Adar Dembo,2016-08-02 20:33:38+00:00,['fee3f672b17c381a0802d2f0a9fd74c772a5ee92'],8,81,89,858933,7,0.75,1,1,1704
9650ac7fa040379c0b81d61ad3ee063f2e2d795d,0,Adar Dembo,2016-08-02 20:37:19+00:00,['a9265d92424dc305c480d6c44d006b8545bd2227'],4,2,6,858939,1,1,0,0,1704
fda036ca94ec3a0a4f496cd9f84c7a7d7b7fb93a,0,Adar Dembo,2016-08-03 20:23:47+00:00,['9650ac7fa040379c0b81d61ad3ee063f2e2d795d'],3,3,6,858945,1,,,,1704
ec39756ef6f6cd25e15a9816d8bce631cb577c1c,0,Todd Lipcon,2016-08-03 22:37:05+00:00,['fda036ca94ec3a0a4f496cd9f84c7a7d7b7fb93a'],0,1,1,858946,1,,,,1704
7766e9270bb8351153656c1d70d2674434d420ab,1,Todd Lipcon,2016-08-03 22:46:21+00:00,['ec39756ef6f6cd25e15a9816d8bce631cb577c1c'],304,34,338,859284,4,0.873563218,0.729885057,0.034482759,1704
7ca727396408b72e465ad2920beb85c6f8b01234,0,Todd Lipcon,2016-08-03 22:58:41+00:00,['7766e9270bb8351153656c1d70d2674434d420ab'],7,123,130,859414,2,0.074074074,1,1,1704
993a686ee04bfd4f9374c510e1084cb6fdd9e0ce,1,Adar Dembo,2016-08-04 23:29:53+00:00,['7ca727396408b72e465ad2920beb85c6f8b01234'],54,51,105,859519,7,0,0,1,1704
65b18fa6fe27ad531dbdbbaa8f27c445fe11e4ca,0,Todd Lipcon,2016-08-05 04:49:46+00:00,['993a686ee04bfd4f9374c510e1084cb6fdd9e0ce'],0,8,8,859527,1,,,,1704
cf009d431bd8c2bf936ba1a2a246c91bc6dc5675,0,Todd Lipcon,2016-08-05 04:51:57+00:00,['65b18fa6fe27ad531dbdbbaa8f27c445fe11e4ca'],109,155,264,859791,10,0,0.19047619,0.833333333,1704
c61c9230a32ba99dafb7d8bb3c6a27eaf58a46b9,0,Dan Burkert,2016-08-05 17:47:15+00:00,['cf009d431bd8c2bf936ba1a2a246c91bc6dc5675'],0,1,1,859792,1,,,,1704
a9a919a608c0d906954ec86301fc7ab49320c99c,0,Dan Burkert,2016-08-05 18:37:11+00:00,['c61c9230a32ba99dafb7d8bb3c6a27eaf58a46b9'],1,2,3,859795,1,,,,1704
c8e29959d46a37eef82914f7f5055c4210d29f2f,0,Dan Burkert,2016-08-05 18:38:58+00:00,['a9a919a608c0d906954ec86301fc7ab49320c99c'],19,20,39,859834,4,,,,1704
a6cb942e855a7a5a022a9f55f1b888df5dbc0d36,1,Todd Lipcon,2016-08-05 21:56:48+00:00,['c8e29959d46a37eef82914f7f5055c4210d29f2f'],640,640,1280,861114,46,,,,1704
7a08b25a0a6e15c8519ace42826ee5d127faf8a0,0,Adar Dembo,2016-08-05 22:02:35+00:00,['a6cb942e855a7a5a022a9f55f1b888df5dbc0d36'],1,1,2,861116,1,,,,1704
9c82e61f58cfd88579b9c3f83b4dd2419978afdf,1,Adar Dembo,2016-08-05 22:09:24+00:00,['7a08b25a0a6e15c8519ace42826ee5d127faf8a0'],34,252,286,861402,6,0.11023622,0.88976378,0.716535433,1705
7ee61f84d71f707f297d6a959fd74dfa1a9dd072,1,Todd Lipcon,2016-08-07 03:56:26+00:00,['9c82e61f58cfd88579b9c3f83b4dd2419978afdf'],167,167,334,861736,21,,,,1705
647f904b5d59a1342bd777a07c04245c590b7201,0,Todd Lipcon,2016-08-07 03:56:31+00:00,['7ee61f84d71f707f297d6a959fd74dfa1a9dd072'],31,31,62,861798,18,,,,1705
5f98cdb8c7235ee937618149d618a73e9adc67f6,0,Todd Lipcon,2016-08-08 18:36:23+00:00,['647f904b5d59a1342bd777a07c04245c590b7201'],2,2,4,861802,1,,,,1705
d60923c910a105be42026accdef786e1d7046ef8,0,Todd Lipcon,2016-08-08 18:37:48+00:00,['5f98cdb8c7235ee937618149d618a73e9adc67f6'],7,7,14,861816,1,,,,1705
eaa15dea662a978d246f5f99321215a7f08416c8,0,Todd Lipcon,2016-08-08 19:09:18+00:00,['d60923c910a105be42026accdef786e1d7046ef8'],1,7,8,861824,1,,,,1705
935fa923618922c1bd81957e471c7b49b442f000,0,Todd Lipcon,2016-08-08 19:13:05+00:00,['eaa15dea662a978d246f5f99321215a7f08416c8'],2,2,4,861828,1,,,,1705
1bef82399839e50307d31664aefd21903e218dff,0,Todd Lipcon,2016-08-08 22:58:28+00:00,['935fa923618922c1bd81957e471c7b49b442f000'],1,1,2,861830,1,,,,1705
0348499e3a235df21ed4bc83cc4f12fce9f5bce4,0,Mike Percy,2016-08-09 22:03:20+00:00,['1bef82399839e50307d31664aefd21903e218dff'],0,24,24,861854,2,,,,1705
cee7bddf03d6287002d21ffcf4e8330cb08c9c6d,0,Todd Lipcon,2016-08-09 22:03:58+00:00,['0348499e3a235df21ed4bc83cc4f12fce9f5bce4'],22,37,59,861913,2,1,1,1,1705
acf093c18860c6812f6759f0e9680db25e37ef99,1,Dan Burkert,2016-08-10 02:52:55+00:00,['cee7bddf03d6287002d21ffcf4e8330cb08c9c6d'],295,880,1175,863088,13,0.175141243,0.638418079,0.703389831,1707
0f899ebd374aebbe17947b7842a559a4cf129feb,1,Dan Burkert,2016-08-10 06:06:06+00:00,['acf093c18860c6812f6759f0e9680db25e37ef99'],9,44,53,863141,5,0.263157895,0.947368421,0.736842105,1707
1dbfb75508040824cc261b1c9127c86727d42087,0,Dan Burkert,2016-08-10 06:06:12+00:00,['0f899ebd374aebbe17947b7842a559a4cf129feb'],58,110,168,863309,3,0.166666667,0.761904762,1,1707
88fe33c99c8f69584334e83506bf710d885f6957,0,Todd Lipcon,2016-08-10 17:45:56+00:00,['1dbfb75508040824cc261b1c9127c86727d42087'],432,1323,1755,865064,15,,,,1707
b9c59cdceb3825556759b0305ecfb615ece391e4,0,Todd Lipcon,2016-08-10 21:19:42+00:00,['88fe33c99c8f69584334e83506bf710d885f6957'],13,29,42,865106,1,1,0.461538462,1,1707
76ec7e66e9227542a3986799599bd04bc7b51fb9,0,Todd Lipcon,2016-08-10 21:21:50+00:00,['b9c59cdceb3825556759b0305ecfb615ece391e4'],2,116,118,865224,1,,,,1707
48766a4ce17d422ced9a6ec78c9a9969ac44d8c9,0,Mike Percy,2016-08-10 23:11:19+00:00,['76ec7e66e9227542a3986799599bd04bc7b51fb9'],72,266,338,865562,12,0.564705882,1,0.564705882,1707
78d36da2455eb2a33a9318a4bac0ba8a204d0593,0,Mike Percy,2016-08-11 06:08:04+00:00,['48766a4ce17d422ced9a6ec78c9a9969ac44d8c9'],1,1,2,865564,2,,,,1707
7a508942f05681750990d065f398bbf027ca6977,0,Mike Percy,2016-08-11 20:44:19+00:00,['78d36da2455eb2a33a9318a4bac0ba8a204d0593'],7,5,12,865576,4,0,0,0,1707
b811cbc7ef1b6223d1458ff9cfb3fa9c5a5ea7db,0,Mike Percy,2016-08-11 20:44:27+00:00,['7a508942f05681750990d065f398bbf027ca6977'],18,24,42,865618,5,,,,1707
1a589960328bcddf067e727538452e2518bc1f2e,0,Todd Lipcon,2016-08-12 01:01:33+00:00,['b811cbc7ef1b6223d1458ff9cfb3fa9c5a5ea7db'],3,3,6,865624,1,,,,1707
564eb4ed1440aeadc0c3948168be8fe12888a46d,0,Todd Lipcon,2016-08-12 01:59:06+00:00,['1a589960328bcddf067e727538452e2518bc1f2e'],7,204,211,865835,5,0.064748201,0.438848921,0.985611511,1707
af5c0592ff654171eb4cd9305ab3626f9bd22e22,0,Todd Lipcon,2016-08-12 02:13:12+00:00,['564eb4ed1440aeadc0c3948168be8fe12888a46d'],1,1,2,865837,1,,,,1707
953219721744dcae6d6f6776ffab67a989c44f17,1,Dan Burkert,2016-08-12 19:32:40+00:00,['af5c0592ff654171eb4cd9305ab3626f9bd22e22'],103,239,342,866179,6,1,1,1,1707
883785c6ad27a7cbcf0cf92cce7864bdb5e7cf80,0,Todd Lipcon,2016-08-12 20:06:37+00:00,['953219721744dcae6d6f6776ffab67a989c44f17'],24,43,67,866246,1,0.857142857,0,1,1707
609054cd8cff886bd9709b7fb652d0c102c7a2e9,0,Todd Lipcon,2016-08-12 20:07:20+00:00,['883785c6ad27a7cbcf0cf92cce7864bdb5e7cf80'],4,157,161,866407,2,0,1,1,1707
13dde92b0fc42275c9bcc2954d0559830ac640e8,0,Todd Lipcon,2016-08-13 02:08:18+00:00,['609054cd8cff886bd9709b7fb652d0c102c7a2e9'],3,6,9,866416,1,0,0.333333333,0.333333333,1707
587f33ddffe4bd07d0702582015d2379f938d446,0,Todd Lipcon,2016-08-13 02:15:52+00:00,['13dde92b0fc42275c9bcc2954d0559830ac640e8'],2,2,4,866420,1,,,,1707
b489f6edc63a6a7126af6ff44b31edb03435a2d3,0,Todd Lipcon,2016-08-13 03:34:36+00:00,['587f33ddffe4bd07d0702582015d2379f938d446'],1,1,2,866422,1,,,,1707
bcc4bbf1c8584d547602b02e380c151f71e3b42e,0,Mike Percy,2016-08-14 04:19:59+00:00,['b489f6edc63a6a7126af6ff44b31edb03435a2d3'],23,41,64,866486,1,,,,1707
3cec55ae665a5451a9e32439a0e58a953aad7e20,1,Todd Lipcon,2016-08-14 22:33:06+00:00,['bcc4bbf1c8584d547602b02e380c151f71e3b42e'],45,39,84,866570,2,0,0,1,1707
9d897e692620a3272a03c63336190cf5a09f739b,0,Todd Lipcon,2016-08-14 22:33:10+00:00,['3cec55ae665a5451a9e32439a0e58a953aad7e20'],16,4,20,866590,1,0,0,0,1707
ea81e0528b8c4ece51656ea9b8ceb1341d31910f,1,Todd Lipcon,2016-08-14 22:33:16+00:00,['9d897e692620a3272a03c63336190cf5a09f739b'],320,293,613,867203,88,1,0,0,1707
ff589b52b867bc127bb671da87112c2881d6e99e,1,Todd Lipcon,2016-08-14 22:33:42+00:00,['ea81e0528b8c4ece51656ea9b8ceb1341d31910f'],188,836,1024,868227,20,0.010845987,0.377440347,0.585683297,1707
5be08fd799b0186025f2e94e2f96fa55fe3717f3,0,Todd Lipcon,2016-08-14 22:33:49+00:00,['ff589b52b867bc127bb671da87112c2881d6e99e'],61,290,351,868578,7,0.457943925,0.934579439,0.327102804,1708
b7e4f1212f7ec69a9eb1a379555f4174a5c8040c,0,Mike Percy,2016-08-15 02:55:24+00:00,['5be08fd799b0186025f2e94e2f96fa55fe3717f3'],11,11,22,868600,2,,,,1708
28a9902ceeb4ae7be20342c0cdc5af698ea02992,1,Adar Dembo,2016-08-15 06:09:31+00:00,['b7e4f1212f7ec69a9eb1a379555f4174a5c8040c'],56,82,138,868738,19,0,1,0,1708
3dcf28f162445582810789b10098425494c4dee5,0,Todd Lipcon,2016-08-15 07:18:37+00:00,['28a9902ceeb4ae7be20342c0cdc5af698ea02992'],1,1,2,868740,1,,,,1708
7132b56cc48d0e4451174580030085af49256644,0,Todd Lipcon,2016-08-15 17:08:50+00:00,['3dcf28f162445582810789b10098425494c4dee5'],2,5,7,868747,2,0,0.666666667,1,1708
865d1606cfafd478a6d16dc5cc31a8de8d9734a1,1,Todd Lipcon,2016-08-15 19:14:08+00:00,['7132b56cc48d0e4451174580030085af49256644'],44,61,105,868852,2,1,1,1,1708
74210b2546df9fd5dec7bb926eeb524362d2da90,0,Todd Lipcon,2016-08-15 19:28:04+00:00,['865d1606cfafd478a6d16dc5cc31a8de8d9734a1'],0,8,8,868860,2,0,1,1,1708
0fb44093fd64893d8333488fad763edc997393a7,0,Todd Lipcon,2016-08-15 19:39:25+00:00,['74210b2546df9fd5dec7bb926eeb524362d2da90'],17,234,251,869111,7,0.330434783,0.530434783,0.904347826,1708
274dfb05944edef1fac3be78ea0c699b048c5b31,0,Misty Stanley-Jones,2016-08-15 22:10:56+00:00,['0fb44093fd64893d8333488fad763edc997393a7'],80,168,248,869359,2,,,,1708
5a707994290e5d601985bf2f2ea6c822b6c0c330,0,Misty Stanley-Jones,2016-08-15 23:42:33+00:00,['274dfb05944edef1fac3be78ea0c699b048c5b31'],30,36,66,869425,1,,,,1708
2c3fc7c27f37ba3986f1d09eb79c7d4969c31f83,1,Adar Dembo,2016-08-16 00:21:33+00:00,['5a707994290e5d601985bf2f2ea6c822b6c0c330'],31,95,126,869551,4,0.181818182,0.236363636,1,1708
aa9418585864588abc5cadcc753bbde0cb327798,0,Todd Lipcon,2016-08-16 00:43:15+00:00,['2c3fc7c27f37ba3986f1d09eb79c7d4969c31f83'],10,49,59,869610,1,,,,1708
1bce73126799cb046755c0555bbe5be7622c9ace,1,Adar Dembo,2016-08-16 01:32:58+00:00,['aa9418585864588abc5cadcc753bbde0cb327798'],14,139,153,869763,7,0.290909091,1,1,1709
98fe55f5c492fbf1a77021d160336e4d8164795f,1,Adar Dembo,2016-08-16 01:33:07+00:00,['1bce73126799cb046755c0555bbe5be7622c9ace'],11,926,937,870700,15,0.303317536,0.644549763,0.812796209,1715
401985ebef2e2b7a122f9476f02e07bd5e1155b5,0,Todd Lipcon,2016-08-16 05:02:25+00:00,['98fe55f5c492fbf1a77021d160336e4d8164795f'],31,218,249,870949,8,0,0.4,1,1715
5ef374388cfe88e7efec26121a2fe02e7d32eba5,1,Todd Lipcon,2016-08-16 05:57:18+00:00,['401985ebef2e2b7a122f9476f02e07bd5e1155b5'],200,333,533,871482,5,1,0.777777778,0,1715
fc09ddcd7771b1cdffe8bcc8a112866c1d02d2e1,0,Todd Lipcon,2016-08-16 05:58:54+00:00,['5ef374388cfe88e7efec26121a2fe02e7d32eba5'],60,429,489,871971,10,0.23853211,0.729357798,0.853211009,1715
dccca07cf14c3d32a80084d0f38d4fe8f0ae1d27,0,Todd Lipcon,2016-08-16 05:58:58+00:00,['fc09ddcd7771b1cdffe8bcc8a112866c1d02d2e1'],25,54,79,872050,5,1,1,1,1715
188058d0b6337df970257c99a52fd8af0f70ee0b,0,Todd Lipcon,2016-08-16 06:57:39+00:00,['dccca07cf14c3d32a80084d0f38d4fe8f0ae1d27'],10,10,20,872070,9,,,,1715
60f7851601707e8e5059d1c100c69f5d55cb1c9b,0,Todd Lipcon,2016-08-16 07:53:10+00:00,['188058d0b6337df970257c99a52fd8af0f70ee0b'],19,4,23,872093,7,0.666666667,0,0.5,1715
f7201a93294dd41f03a0a39f6ba38c969d50d6d7,0,Adar Dembo,2016-08-16 18:41:10+00:00,['60f7851601707e8e5059d1c100c69f5d55cb1c9b'],9,5,14,872107,1,0,0,0,1715
a5a192a48f12cc8ae87ad3c7568d41bf6e657d0b,0,Adar Dembo,2016-08-16 18:41:11+00:00,['f7201a93294dd41f03a0a39f6ba38c969d50d6d7'],6,12,18,872125,1,0.4,1,1,1715
5239d43cf84dfa84e0d123137e258697c8aea63c,0,Misty Stanley-Jones,2016-08-16 21:38:28+00:00,['a5a192a48f12cc8ae87ad3c7568d41bf6e657d0b'],1,1,2,872127,1,,,,1715
854b71563dee5791a3a593947fe1b7233b59cba1,1,Dan Burkert,2016-08-16 23:40:39+00:00,['5239d43cf84dfa84e0d123137e258697c8aea63c'],37,265,302,872429,4,0,1,0.864705882,1715
5066504412cd350a34db4e8f5de0688b9cf0b777,0,Todd Lipcon,2016-08-16 17:00:21-07:00,['5d3e245ca16024a88470defe1d7c519d53350033'],0,4,4,872433,1,,,,1715
b5aa19de62650da83ebb145cbedf04bf5b39d352,0,Misty Stanley-Jones,2016-08-17 00:39:06+00:00,['854b71563dee5791a3a593947fe1b7233b59cba1'],61,55,116,872549,2,,,,1715
34b7f1eb596bd7112f3c3ca53721a2554ca3fe6b,1,Todd Lipcon,2016-08-17 19:12:00+00:00,['b5aa19de62650da83ebb145cbedf04bf5b39d352'],370,736,1106,873655,84,0.445255474,1,1,1715
0174fda21257ef7c9ba7901671f97a58b3f1521e,1,Todd Lipcon,2016-08-17 21:29:40+00:00,['34b7f1eb596bd7112f3c3ca53721a2554ca3fe6b'],9,54,63,873718,4,0.875,0.958333333,1,1715
07c50b803476f17728dd0c9ad1bfab12caf924e2,0,Todd Lipcon,2016-08-17 23:01:13+00:00,['0174fda21257ef7c9ba7901671f97a58b3f1521e'],23,61,84,873802,4,0.2,0.2,0.9,1715
13ea28029773c042c77f6a0325e21c30f298bb62,0,Todd Lipcon,2016-08-17 23:02:04+00:00,['07c50b803476f17728dd0c9ad1bfab12caf924e2'],0,112,112,873914,2,,,,1716
3acfe912ed44f3a2acd0841b191ba01d631a1037,0,Todd Lipcon,2016-08-18 05:29:55+00:00,['13ea28029773c042c77f6a0325e21c30f298bb62'],4,0,4,873918,1,,,,1716
8e099101f0b457dffdce05cedb518184284d32d0,0,Todd Lipcon,2016-08-18 19:06:58+00:00,['3acfe912ed44f3a2acd0841b191ba01d631a1037'],2,4,6,873924,1,0,1,1,1716
9acba45ac147fbae5349b7bc559a75ca41c4084b,1,Dan Burkert,2016-08-18 19:26:55+00:00,['8e099101f0b457dffdce05cedb518184284d32d0'],48,131,179,874103,6,0,0,1,1717
1bc9f803f882d0608f794a2f69f529c5fe2c6b68,0,Todd Lipcon,2016-08-19 02:15:26+00:00,['9acba45ac147fbae5349b7bc559a75ca41c4084b'],8,17,25,874128,1,,,,1717
00dd9fde71f6f8afd52e3e4a953b9eae331fb543,1,Todd Lipcon,2016-08-19 18:48:20+00:00,['1bc9f803f882d0608f794a2f69f529c5fe2c6b68'],129,241,370,874498,6,0.170731707,0,1,1717
30bad3d2c3471af6e295312bdfab02375653bae2,0,Todd Lipcon,2016-08-19 18:48:28+00:00,['00dd9fde71f6f8afd52e3e4a953b9eae331fb543'],3,12,15,874513,3,1,1,1,1717
2504dafdcd356da8cb398a46afeb86020b4bddb6,0,Todd Lipcon,2016-08-21 01:18:36+00:00,['30bad3d2c3471af6e295312bdfab02375653bae2'],1,1,2,874515,1,,,,1717
b3371aba3c1bd24e4be56abdb47be9d2cadbd747,0,Todd Lipcon,2016-08-22 07:34:02+00:00,['2504dafdcd356da8cb398a46afeb86020b4bddb6'],89,135,224,874739,3,,,,1717
062996ad7d1c3aa90cd9ea5ec11b73dc17e085d6,1,Todd Lipcon,2016-08-22 07:36:37+00:00,['b3371aba3c1bd24e4be56abdb47be9d2cadbd747'],17,4831,4848,879587,7,0.68852459,1,0.704918033,1722
4adb277711aad07c184bc0d51dbc94f60f2a756c,0,Todd Lipcon,2016-08-22 22:41:36+00:00,['062996ad7d1c3aa90cd9ea5ec11b73dc17e085d6'],3,3,6,879593,2,,,,1722
157ff14d85083906e7475378a54c5dd78f19127e,0,Todd Lipcon,2016-08-23 05:51:34+00:00,['4adb277711aad07c184bc0d51dbc94f60f2a756c'],1,3,4,879597,1,,,,1722
0233fc2586d31ab4ccc106739fa13147e4d5fc3c,0,Todd Lipcon,2016-08-23 06:18:42+00:00,['157ff14d85083906e7475378a54c5dd78f19127e'],10,10,20,879617,1,,,,1722
29904c04aaaf6660b3d69180e2f4600315a3557f,0,Todd Lipcon,2016-08-22 23:34:43-07:00,['0233fc2586d31ab4ccc106739fa13147e4d5fc3c'],2,2,4,879621,1,,,,1722
02d6eaa47c5e6f78678aab7ae344e0a489f01708,0,Todd Lipcon,2016-08-23 11:45:53-07:00,['5066504412cd350a34db4e8f5de0688b9cf0b777'],1,1,2,879623,1,,,,1722
3349b9a690da22524551da6f4aa410941acbfa52,0,Todd Lipcon,2016-08-23 12:10:00-07:00,['02d6eaa47c5e6f78678aab7ae344e0a489f01708'],49,43,92,879715,7,,,,1722
b69bb7dab3b858d65f70728d77de9d098a2b2414,0,Todd Lipcon,2016-08-23 12:11:53-07:00,['3349b9a690da22524551da6f4aa410941acbfa52'],2,3,5,879720,1,,,,1722
8bf183963c44d83198be2e21b60fd6dfeee84261,0,GitHub,2016-08-23 12:52:18-07:00,"['02d6eaa47c5e6f78678aab7ae344e0a489f01708', 'b69bb7dab3b858d65f70728d77de9d098a2b2414']",51,46,97,879817,8,,,,1722
e216aff1cda41dd910ce13e655fae4daac61b2dc,1,Todd Lipcon,2016-08-23 22:52:28+00:00,['29904c04aaaf6660b3d69180e2f4600315a3557f'],35,34,69,879886,4,0,0,0,1722
8c9962438eacd0d49caf662c29c1e8d191ba7b9c,0,Todd Lipcon,2016-08-23 22:52:31+00:00,['e216aff1cda41dd910ce13e655fae4daac61b2dc'],13,38,51,879937,1,0,0.529411765,1,1722
c4f8cb3ebd66e4dcb202421d10590be87d8a777d,0,Todd Lipcon,2016-08-23 22:52:48+00:00,['8c9962438eacd0d49caf662c29c1e8d191ba7b9c'],0,11,11,879948,1,,,,1722
cbc86510805d16ea1b2820b8a8d96982303e6c13,0,Todd Lipcon,2016-08-23 23:28:17+00:00,['c4f8cb3ebd66e4dcb202421d10590be87d8a777d'],1,1,2,879950,1,,,,1722
535070248eda5ca1483546197ff7d935ff1bd5a4,0,Todd Lipcon,2016-08-24 00:54:08+00:00,['cbc86510805d16ea1b2820b8a8d96982303e6c13'],9,12,21,879971,3,,,,1722
df3d070e569d33875dc5d64180acbf913a2e2288,0,Mike Percy,2016-08-24 18:47:18+00:00,['535070248eda5ca1483546197ff7d935ff1bd5a4'],0,19,19,879990,1,1,1,1,1722
d911b304d7f4e2c345a01d4e6a7637cf71835a4a,0,Todd Lipcon,2016-08-24 19:17:04+00:00,['df3d070e569d33875dc5d64180acbf913a2e2288'],18,14,32,880022,3,1,1,0,1722
c1aecf217eb183b378359b53fecea93a265a51a6,0,Dan Burkert,2016-08-24 19:19:22+00:00,['d911b304d7f4e2c345a01d4e6a7637cf71835a4a'],17,17,34,880056,5,,,,1722
2976b2a2c14a70e28b44ceed92742fd9913284df,0,Dan Burkert,2016-08-24 19:20:49+00:00,['c1aecf217eb183b378359b53fecea93a265a51a6'],13,4,17,880073,2,,,,1722
effcd2c9624196bb5626cb853f0f19ce06d036c0,0,Adar Dembo,2016-08-24 22:21:28+00:00,['2976b2a2c14a70e28b44ceed92742fd9913284df'],11,9,20,880093,3,,,,1722
666ae1ed1f47fab7a67f0f53f48ccaeee7f11654,1,Todd Lipcon,2016-08-25 05:32:48+00:00,['effcd2c9624196bb5626cb853f0f19ce06d036c0'],61,160,221,880314,4,0.42,0.8,0,1722
a1e6b884a681e33aa4755267cb14602cf97b4b97,0,Mike Percy,2016-08-25 07:43:38+00:00,['666ae1ed1f47fab7a67f0f53f48ccaeee7f11654'],1,1,2,880316,1,,,,1722
7321b38be0303876fcc71b5c73e3e6eddbbdf012,1,Todd Lipcon,2016-08-25 21:46:35+00:00,['a1e6b884a681e33aa4755267cb14602cf97b4b97'],3,188,191,880507,4,0.292929293,0.95959596,0.575757576,1723
86afadc7fc6f9274402edcb3599c243ec2de0ccb,1,Todd Lipcon,2016-08-25 21:46:47+00:00,['7321b38be0303876fcc71b5c73e3e6eddbbdf012'],156,162,318,880825,7,0,1,0.75,1724
ebe4d78bf4bb9402a717493d051a304eb1bf3086,0,Adar Dembo,2016-08-25 22:24:34+00:00,['86afadc7fc6f9274402edcb3599c243ec2de0ccb'],26,65,91,880916,7,0.516129032,0,0.548387097,1724
43d2749ddb096d5534507d71314a558cbf420537,0,Mike Percy,2016-08-25 23:02:50+00:00,['ebe4d78bf4bb9402a717493d051a304eb1bf3086'],1,70,71,880987,4,0.340909091,0.295454545,1,1724
d4b6520b655a7c53af2d7ae08ea70c44baaeae85,0,Adar Dembo,2016-08-26 20:32:39+00:00,['43d2749ddb096d5534507d71314a558cbf420537'],58,63,121,881108,17,0.8,1,1,1724
07c1b00c33b9f0142b0a04b280f48c8621f4e232,1,Todd Lipcon,2016-08-26 20:58:00+00:00,['d4b6520b655a7c53af2d7ae08ea70c44baaeae85'],9,58,67,881175,1,0.166666667,0.222222222,0.277777778,1724
362743c34f9b8572f576f3f06c74be4794706e51,0,Todd Lipcon,2016-08-26 20:59:30+00:00,['07c1b00c33b9f0142b0a04b280f48c8621f4e232'],28,8,36,881211,1,,,,1724
cf0eb4ddae4fbcff23cc1a39171ce7ae997f1997,1,Adar Dembo,2016-08-26 22:24:05+00:00,['362743c34f9b8572f576f3f06c74be4794706e51'],147,299,446,881657,7,0.733333333,0.666666667,1,1726
db6d22da4d75bfb723dabab25a9ef8603f3a9a19,1,Adar Dembo,2016-08-26 22:25:42+00:00,['cf0eb4ddae4fbcff23cc1a39171ce7ae997f1997'],50,66,116,881773,4,0.2,0.3,1,1726
25a66cd27680bcc07a52783d18dc0b5be5ac1a38,0,Mike Percy,2016-08-27 00:27:59+00:00,['db6d22da4d75bfb723dabab25a9ef8603f3a9a19'],2,4,6,881779,2,0,1,1,1726
62fd25466712129dc83a06877658c1a98379223f,0,Todd Lipcon,2016-08-27 02:25:07+00:00,['25a66cd27680bcc07a52783d18dc0b5be5ac1a38'],1,1,2,881781,1,,,,1726
56aec48db89084e6d9c6c3bbf6d2954160db3eea,0,Todd Lipcon,2016-08-29 02:12:58+00:00,['62fd25466712129dc83a06877658c1a98379223f'],0,3,3,881784,1,,,,1726
6a92db4d08a635238c866df8ee6198f590347cda,1,Todd Lipcon,2016-08-29 21:18:24+00:00,['56aec48db89084e6d9c6c3bbf6d2954160db3eea'],94,444,538,882322,15,0.566666667,0.855555556,0.988888889,1730
b5aa4a76c172f4cc2160c6cef7795977218b0d4c,0,Todd Lipcon,2016-08-29 21:18:28+00:00,['6a92db4d08a635238c866df8ee6198f590347cda'],167,164,331,882653,11,1,0,1,1730
f5021e0619a838d94beea24be015952122712c2f,0,Todd Lipcon,2016-08-29 21:19:46+00:00,['b5aa4a76c172f4cc2160c6cef7795977218b0d4c'],52,27,79,882732,4,1,0.2,0.2,1730
25f5c215e0027f9121f5a16f1b82ff7e5c7f9430,1,Adar Dembo,2016-08-29 21:42:41+00:00,['f5021e0619a838d94beea24be015952122712c2f'],102,266,368,883100,8,0.472868217,0.968992248,1,1730
b7d2780ffee2b5d8b88ff1801d3e40d54c773f06,1,Adar Dembo,2016-08-29 22:23:44+00:00,['25f5c215e0027f9121f5a16f1b82ff7e5c7f9430'],106,131,237,883337,5,0,1,1,1730
11ad075a113dc4c63e3074b58667b587e7308a06,1,Todd Lipcon,2016-08-29 22:27:43+00:00,['b7d2780ffee2b5d8b88ff1801d3e40d54c773f06'],14,46,60,883397,4,0.136363636,1,1,1730
ed216bcdf4dc62926eef7776dcf6d97129214c97,0,Todd Lipcon,2016-08-30 01:15:14+00:00,['11ad075a113dc4c63e3074b58667b587e7308a06'],5,136,141,883538,8,0.106666667,0.68,1,1730
f78d1c840a703d0f36c2bcf299b87d44f2a9fb0e,0,Mike Percy,2016-08-30 06:24:53+00:00,['ed216bcdf4dc62926eef7776dcf6d97129214c97'],21,1,22,883560,1,1,1,1,1730
5e368488b10b28444e03517283beb8ecb958573d,0,Mike Percy,2016-08-30 06:24:58+00:00,['f78d1c840a703d0f36c2bcf299b87d44f2a9fb0e'],40,0,40,883600,1,1,0,0,1730
0d18a0b026f850ded6647814e63183d897616535,1,Mike Percy,2016-08-30 06:25:06+00:00,['5e368488b10b28444e03517283beb8ecb958573d'],0,5,5,883605,1,0,0,1,1730
5ba18b623095170b55c2bab90a09258853cce1b8,0,Todd Lipcon,2016-08-30 18:05:28+00:00,['0d18a0b026f850ded6647814e63183d897616535'],1,7,8,883613,2,1,1,1,1730
3b539b36de990e16d2ccee7636ed90eff60b484b,0,Adar Dembo,2016-08-30 22:36:53+00:00,['5ba18b623095170b55c2bab90a09258853cce1b8'],6,42,48,883661,4,,,,1731
362a307e4cd117a1082d2e708bc4c9cd734a39be,1,Todd Lipcon,2016-08-31 00:35:25+00:00,['3b539b36de990e16d2ccee7636ed90eff60b484b'],10,30,40,883701,3,1,1,1,1731
1f660ee9fd23520cdded155c1d7a18f5331cec5b,1,Todd Lipcon,2016-08-31 01:23:05+00:00,['362a307e4cd117a1082d2e708bc4c9cd734a39be'],160,440,600,884301,13,0.25,0.964285714,0.907142857,1733
4fd0572eef60b163f9fb02742a3f5661117e8c8b,1,Dan Burkert,2016-09-01 18:17:45+00:00,['1f660ee9fd23520cdded155c1d7a18f5331cec5b'],81,454,535,884836,10,0.189189189,0.405405405,0.625482625,1733
8a4bb33c3d54775ff8520b97e18b3fc94021185d,1,Todd Lipcon,2016-09-01 21:56:03+00:00,['4fd0572eef60b163f9fb02742a3f5661117e8c8b'],13,210,223,885059,6,0.072164948,0,0.824742268,1735
075c42cb78a80042040850eb5746c28e663a4622,0,Todd Lipcon,2016-09-01 21:57:51+00:00,['8a4bb33c3d54775ff8520b97e18b3fc94021185d'],13,16,29,885088,1,0,0,1,1735
ade0192f0ba789d1e2dd4ecc9b21308d171133f8,0,Todd Lipcon,2016-09-01 21:58:26+00:00,['075c42cb78a80042040850eb5746c28e663a4622'],2,3,5,885093,1,0,1,1,1735
e1f54cbe7c3e72ea2711edf354af6b8481639a6f,1,Adar Dembo,2016-09-01 22:00:48+00:00,['ade0192f0ba789d1e2dd4ecc9b21308d171133f8'],96,68,164,885257,12,0.047619048,0,0.047619048,1735
680cec6bbf104dcba0d3d350e34af98756a5d974,1,Adar Dembo,2016-09-01 22:44:18+00:00,['e1f54cbe7c3e72ea2711edf354af6b8481639a6f'],10,18,28,885285,3,0.142857143,1,0.857142857,1735
000791109f64be139bb04e325c83b3ed7ea21d1b,1,Todd Lipcon,2016-09-02 01:02:08+00:00,['680cec6bbf104dcba0d3d350e34af98756a5d974'],20,66,86,885371,1,,,,1735
d5a1f2d42b48bb5e852de3a57221ad25e178b169,1,Todd Lipcon,2016-09-02 01:16:59+00:00,['000791109f64be139bb04e325c83b3ed7ea21d1b'],60,38,98,885469,1,0,0,0.105263158,1735
da73a2bf70c9015c131d4a39128e09fbcbeabc07,0,Todd Lipcon,2016-09-02 01:31:29+00:00,['d5a1f2d42b48bb5e852de3a57221ad25e178b169'],6,8,14,885483,1,0,1,1,1735
93be1310d227cf05025864654ca3f6713c2ddc2c,1,Todd Lipcon,2016-09-02 01:47:26+00:00,['da73a2bf70c9015c131d4a39128e09fbcbeabc07'],247,1505,1752,887235,13,0.266982622,0.68878357,0.835703002,1735
531e7d99c68a7767cfc900447179fcc116f32f1c,1,Todd Lipcon,2016-09-02 01:56:12+00:00,['93be1310d227cf05025864654ca3f6713c2ddc2c'],7,74,81,887316,4,0.970588235,1,0.970588235,1735
22d68a0c30a72e29b3fe83e31bd80a417a2f1101,0,Todd Lipcon,2016-09-02 01:56:15+00:00,['531e7d99c68a7767cfc900447179fcc116f32f1c'],3,8,11,887327,2,0,0,1,1735
bfb6f2338cd57a1c7f8405c97b66c3050c8920ff,1,Todd Lipcon,2016-09-02 01:57:37+00:00,['22d68a0c30a72e29b3fe83e31bd80a417a2f1101'],7,19,26,887353,1,1,1,1,1735
d13ac79a46602b135cb7dffcf484c65ccb898099,0,Adar Dembo,2016-09-02 02:35:57+00:00,['bfb6f2338cd57a1c7f8405c97b66c3050c8920ff'],5,11,16,887369,1,,,,1735
efb60241bbc1caf1bcda47b2605f6773d2d0dded,0,Adar Dembo,2016-09-02 18:50:22+00:00,['d13ac79a46602b135cb7dffcf484c65ccb898099'],20,57,77,887446,4,0,1,1,1735
4d5fb0d3dfbb611c768d19e1ed67ee5d18668feb,0,Adar Dembo,2016-09-02 20:56:56+00:00,['efb60241bbc1caf1bcda47b2605f6773d2d0dded'],82,99,181,887627,4,0,1,1,1735
45523bb7e9a485a60bdd211cb6eba37b6e6c6292,1,Adar Dembo,2016-09-02 21:15:47+00:00,['4d5fb0d3dfbb611c768d19e1ed67ee5d18668feb'],30,91,121,887748,2,0,1,1,1735
07b1e81b04a1e0fceea81a575230091385a400f5,0,Adar Dembo,2016-09-02 21:16:38+00:00,['45523bb7e9a485a60bdd211cb6eba37b6e6c6292'],4,3,7,887755,1,,,,1735
d69b68d718b91a48a7d4c6bc2e4911c12b10dbdd,0,David Ribeiro Alves,2016-09-02 21:21:52+00:00,['07b1e81b04a1e0fceea81a575230091385a400f5'],1,1,2,887757,1,,,,1735
346b63d9cbf30aeb603920904b3cbb02074d9c75,1,Mike Percy,2016-09-06 05:55:17+00:00,['d69b68d718b91a48a7d4c6bc2e4911c12b10dbdd'],0,560,560,888317,4,0.349137931,0.672413793,0.892241379,1738
551676116a5d15cdbce06c98821a69bc3e5df1b5,0,Todd Lipcon,2016-09-06 18:10:43+00:00,['346b63d9cbf30aeb603920904b3cbb02074d9c75'],2,8,10,888327,2,0,0,0,1738
15671a12abe4cbaa984a587dce5e20106923ee49,0,Todd Lipcon,2016-09-06 21:28:18+00:00,['551676116a5d15cdbce06c98821a69bc3e5df1b5'],2,5,7,888334,1,,,,1738
3dcd7de20e50373b2c08c4afca73a95b9e523b40,1,Todd Lipcon,2016-09-06 21:28:47+00:00,['15671a12abe4cbaa984a587dce5e20106923ee49'],12,69,81,888415,4,0,0.916666667,0.25,1738
352605dbb1ddd9fe63a106ab0047089b579705df,0,Mike Percy,2016-09-06 22:55:55+00:00,['3dcd7de20e50373b2c08c4afca73a95b9e523b40'],4,10,14,888429,1,0,1,1,1738
2f12d83a8bcdf7015ba50bc02917e215837f3c9a,0,Todd Lipcon,2016-09-06 23:16:58+00:00,['352605dbb1ddd9fe63a106ab0047089b579705df'],5,6,11,888440,1,0,1,1,1738
c4e3ff67b14954f00570b65861fc9bdbd61e7999,1,Todd Lipcon,2016-09-06 23:17:11+00:00,['2f12d83a8bcdf7015ba50bc02917e215837f3c9a'],99,7144,7243,895683,5,0.22,0.64,0.64,1739
6a12ba3f7d66dcf748e8864aae8139813c1c4746,1,Todd Lipcon,2016-09-07 00:17:55+00:00,['c4e3ff67b14954f00570b65861fc9bdbd61e7999'],16,116,132,895815,7,0,0.736842105,0.315789474,1739
859cf31d13228d5e07d5ed35bdeb6e237dc1701f,1,Todd Lipcon,2016-09-07 06:28:44+00:00,['6a12ba3f7d66dcf748e8864aae8139813c1c4746'],6,13,19,895834,2,1,1,1,1739
94ec3d515261b877617460be07f1639d2ef17f85,0,Todd Lipcon,2016-09-07 18:47:36+00:00,['859cf31d13228d5e07d5ed35bdeb6e237dc1701f'],1,1,2,895836,1,,,,1739
b1f1388e2525bb236a4154762718aabd86e3b51f,0,Adar Dembo,2016-09-07 21:08:59+00:00,['94ec3d515261b877617460be07f1639d2ef17f85'],3,3,6,895842,1,,,,1739
ce0fcd4dd65a23aebf2601570e335c1b6ce2a0c9,1,Todd Lipcon,2016-09-08 01:03:45+00:00,['b1f1388e2525bb236a4154762718aabd86e3b51f'],592,464,1056,896898,15,0.817391304,0.156521739,0.139130435,1739
2876683bc9f2798f1acc7d73b1939d7134718578,0,Todd Lipcon,2016-09-08 02:03:46+00:00,['ce0fcd4dd65a23aebf2601570e335c1b6ce2a0c9'],2,2,4,896902,1,,,,1739
46d9ed7aa86e7bcd9649ec37af1fbd8369d5c0fe,0,Todd Lipcon,2016-09-08 02:06:54+00:00,['2876683bc9f2798f1acc7d73b1939d7134718578'],9,32,41,896943,2,0,1,1,1739
211a5e4a3f3ea44ed297337a26e657866c5830df,0,Todd Lipcon,2016-09-08 02:13:02+00:00,['46d9ed7aa86e7bcd9649ec37af1fbd8369d5c0fe'],1,28,29,896972,3,1,0,1,1739
c0f37278cb09a7781d9073279ea54b08db6e2010,1,Todd Lipcon,2016-09-08 15:45:27+00:00,['211a5e4a3f3ea44ed297337a26e657866c5830df'],125,931,1056,898028,35,0.357446809,0.568085106,0.480851064,1741
d807034dd22d47dbbaec002391ffef79ca5ea4c3,1,Adar Dembo,2016-09-08 16:30:03+00:00,['c0f37278cb09a7781d9073279ea54b08db6e2010'],191,227,418,898446,43,,,,1741
fdfcdba21f1c70b882d763e47a4d7d028bf6e2ea,1,Mike Percy,2016-09-08 19:20:58+00:00,['d807034dd22d47dbbaec002391ffef79ca5ea4c3'],279,333,612,899058,11,0,0.916666667,1,1742
ec80fdb37be44d380046a823b5e6d8e2241ec3da,1,Todd Lipcon,2016-09-08 20:46:42+00:00,['fdfcdba21f1c70b882d763e47a4d7d028bf6e2ea'],41,57,98,899156,4,0,0,1,1742
1de46297f1d1a9bc45cb8ce0a8567dc7c9c23ca4,0,Todd Lipcon,2016-09-08 21:02:55+00:00,['ec80fdb37be44d380046a823b5e6d8e2241ec3da'],17,0,17,899173,1,,,,1742
e33bac441c7d90fc22796b651622928d5043c66b,1,Adar Dembo,2016-09-08 21:05:21+00:00,['1de46297f1d1a9bc45cb8ce0a8567dc7c9c23ca4'],9,141,150,899323,4,0,1,1,1742
c7dab48ebc1dd05ff05a872ed7c3ab2a92f72a0d,1,Adar Dembo,2016-09-08 23:42:17+00:00,['e33bac441c7d90fc22796b651622928d5043c66b'],198,1722,1920,901243,17,0.36204576,0.644683715,0.826379542,1746
202e9124929b2a0d9b33d62af1c773e69772a9e8,0,Todd Lipcon,2016-09-09 02:14:58+00:00,['c7dab48ebc1dd05ff05a872ed7c3ab2a92f72a0d'],0,77,77,901320,4,0,1,1,1746
45a970a490b72b12af7fa0596bac9b0d80604b5b,0,Mike Percy,2016-09-09 04:39:25+00:00,['202e9124929b2a0d9b33d62af1c773e69772a9e8'],2,18,20,901340,2,0,0,0.545454545,1746
814b08237b3e215bcb435cc19f5fbe0fe626f484,1,Mike Percy,2016-09-09 04:39:30+00:00,['45a970a490b72b12af7fa0596bac9b0d80604b5b'],1,5,6,901346,1,0,0,1,1746
30a8337f05a8b92faff9400298aae640b6ebbecb,0,Mike Percy,2016-09-09 04:39:34+00:00,['814b08237b3e215bcb435cc19f5fbe0fe626f484'],0,3,3,901349,1,0,1,1,1746
e21523f5fac41ae272886c89a6a45049173aa94b,0,Todd Lipcon,2016-09-09 18:20:46+00:00,['30a8337f05a8b92faff9400298aae640b6ebbecb'],335,326,661,902010,23,0.25,0,0.321428571,1746
d5cc572750cc604e9d1c0e6cd04c8f440cc8b790,1,Todd Lipcon,2016-09-09 19:13:12+00:00,['e21523f5fac41ae272886c89a6a45049173aa94b'],147,156,303,902313,29,0.631578947,0,0.105263158,1747
be719edc3581802e094c3af6a88d67acba44ba71,1,Todd Lipcon,2016-09-09 19:13:18+00:00,['d5cc572750cc604e9d1c0e6cd04c8f440cc8b790'],168,1047,1215,903528,24,0.300429185,0.723175966,0.731759657,1749
7eaeb6d902a59428780a91a460ded537afe3c4d4,1,Todd Lipcon,2016-09-09 20:34:37+00:00,['be719edc3581802e094c3af6a88d67acba44ba71'],117,130,247,903775,43,1,1,1,1749
c386f73a979c06eea0a9944ce8544c7d1dcb566a,0,Mike Percy,2016-09-09 21:25:29+00:00,['7eaeb6d902a59428780a91a460ded537afe3c4d4'],16,129,145,903920,4,0.107692308,0.923076923,1,1749
d5082d8ec1218e3f3bd2143d117ddd64772a6162,0,David Ribeiro Alves,2016-09-09 23:47:56+00:00,['c386f73a979c06eea0a9944ce8544c7d1dcb566a'],5,72,77,903997,4,0.368421053,1,0.973684211,1749
b5fc3a64b845220328720a57626fae5b0921eb6e,0,Adar Dembo,2016-09-10 00:44:49+00:00,['d5082d8ec1218e3f3bd2143d117ddd64772a6162'],1,2,3,904000,1,,,,1749
2e30b2a8fca48d472143a9782b2f2449dcd6cfc2,1,Adar Dembo,2016-09-10 00:48:34+00:00,['b5fc3a64b845220328720a57626fae5b0921eb6e'],23,24,47,904047,8,0,1,1,1749
61557b327f78f644d6ca37f2d739168937627527,0,Adar Dembo,2016-09-10 00:48:50+00:00,['2e30b2a8fca48d472143a9782b2f2449dcd6cfc2'],7,21,28,904075,1,0,1,1,1749
d46ac5f64c9eb5069a44dbbb6545a3dcc4a6d997,1,Todd Lipcon,2016-09-10 04:23:12+00:00,['61557b327f78f644d6ca37f2d739168937627527'],485,459,944,905019,13,0,1,1,1751
2ecf034c8dff6d2edb3ea7ee046ea621b2910906,0,Mike Percy,2016-09-10 16:53:38+00:00,['d46ac5f64c9eb5069a44dbbb6545a3dcc4a6d997'],8,10,18,905037,2,0,0,1,1751
c06cdcedb16c8ba0b8a8c7465bdf786cb2e68245,1,Todd Lipcon,2016-09-10 18:53:47+00:00,['2ecf034c8dff6d2edb3ea7ee046ea621b2910906'],10,41,51,905088,4,0.541666667,0,1,1751
89b54c9f9e6789a8f6b758127625029aafa17589,1,Todd Lipcon,2016-09-10 18:56:26+00:00,['c06cdcedb16c8ba0b8a8c7465bdf786cb2e68245'],3,602,605,905693,2,0.248677249,0.291005291,0.817460317,1752
e2f5e250f50b983f7ab10dac134246fc46870f32,0,Todd Lipcon,2016-09-10 19:09:08+00:00,['89b54c9f9e6789a8f6b758127625029aafa17589'],1,1,2,905695,1,,,,1752
54b45704fee978854acafa827e1e010ecc1c7e4c,0,Todd Lipcon,2016-09-10 23:38:10+00:00,['e2f5e250f50b983f7ab10dac134246fc46870f32'],0,18,18,905713,1,,,,1752
328e1176448822251b0d4090490d047437349aec,0,Todd Lipcon,2016-09-11 23:12:45+00:00,['54b45704fee978854acafa827e1e010ecc1c7e4c'],1,1,2,905715,1,,,,1752
cf1bd0dc90940030330f6803e934da805a2eb1fb,0,Todd Lipcon,2016-09-11 23:12:53+00:00,['328e1176448822251b0d4090490d047437349aec'],2,2,4,905719,1,,,,1752
455e1b7460984afb9ffcae8cae7bb85b9c0837a7,0,Mike Percy,2016-09-12 05:38:40+00:00,['cf1bd0dc90940030330f6803e934da805a2eb1fb'],10,4,14,905733,1,0,0,0,1752
3a9ea63b9f210b64124b2d9d2b5f14ed1214f272,0,Mike Percy,2016-09-12 05:38:44+00:00,['455e1b7460984afb9ffcae8cae7bb85b9c0837a7'],1,4,5,905738,1,1,1,1,1752
81ee6c3f3b3b05f8f145b823a2db5b1e7f80233e,0,Mike Percy,2016-09-12 05:47:20+00:00,['3a9ea63b9f210b64124b2d9d2b5f14ed1214f272'],0,3,3,905741,1,0,1,1,1752
30099cf9e62bcfe9344bcd76807b080d423ef0e1,0,Mike Percy,2016-09-12 05:52:51+00:00,['81ee6c3f3b3b05f8f145b823a2db5b1e7f80233e'],0,498,498,906239,2,0.204724409,0.393700787,0.492125984,1754
708f38b2b932ef88dda2f990ac95a8de1cd226cb,0,Mike Percy,2016-09-12 05:54:51+00:00,['30099cf9e62bcfe9344bcd76807b080d423ef0e1'],13,13,26,906265,2,,,,1754
17f49b0fabda090801bfcc51978ae8076356ff32,0,David Ribeiro Alves,2016-09-12 17:57:37+00:00,['708f38b2b932ef88dda2f990ac95a8de1cd226cb'],1,1,2,906267,1,,,,1754
64f3795960db0ea1ffb6b8fba83156f0a2977539,1,David Ribeiro Alves,2016-09-12 17:57:53+00:00,['17f49b0fabda090801bfcc51978ae8076356ff32'],12,15,27,906294,2,1,1,1,1754
6ab1b5611cced0bce4e3fd660c10595171a89a22,0,David Ribeiro Alves,2016-09-12 17:58:20+00:00,['64f3795960db0ea1ffb6b8fba83156f0a2977539'],0,86,86,906380,4,0,1,1,1754
43bc07bbd7e288236f09effb9301e378532cdf43,0,Todd Lipcon,2016-09-12 18:12:22+00:00,['6ab1b5611cced0bce4e3fd660c10595171a89a22'],43,60,103,906483,1,1,0,0,1754
c1d16f221c021b117c7b7a2d17b0e934137a17b9,0,Todd Lipcon,2016-09-12 19:41:54+00:00,['43bc07bbd7e288236f09effb9301e378532cdf43'],11,13,24,906507,1,0,0,0,1754
c32db686f80c3e96a1c8affa28b9996618516f5a,0,Todd Lipcon,2016-09-12 21:41:03+00:00,['c1d16f221c021b117c7b7a2d17b0e934137a17b9'],744,903,1647,908154,2,,,,1755
9e37db1772dea3dfb86aac45de69fd3a5a424034,0,David Ribeiro Alves,2016-09-12 22:43:36+00:00,['c32db686f80c3e96a1c8affa28b9996618516f5a'],2,3,5,908159,1,,,,1755
df5c7a1ed49e6fb9f5f831f0c98c650aa2646475,0,Todd Lipcon,2016-09-12 22:59:01+00:00,['9e37db1772dea3dfb86aac45de69fd3a5a424034'],0,34,34,908193,1,,,,1755
2628ec0d7c3362f94e000b021d3963a080ebd739,0,Mike Percy,2016-09-13 00:27:01+00:00,['df5c7a1ed49e6fb9f5f831f0c98c650aa2646475'],3,5,8,908201,1,0,0,,1755
b150c052a8c663cbc5bcfcc3b8fa5fe26c900fb2,0,Todd Lipcon,2016-09-13 01:24:08+00:00,['2628ec0d7c3362f94e000b021d3963a080ebd739'],1,0,1,908202,1,1,0,0,1755
9cb1bcacf1449a41ebd6a2c13faead2665ea38f9,1,Todd Lipcon,2016-09-13 02:14:23+00:00,['b150c052a8c663cbc5bcfcc3b8fa5fe26c900fb2'],820,763,1583,909785,11,0,0.68852459,1,1755
14cd22a10b33545c5136ad68ebcf5cc0543ac525,1,Todd Lipcon,2016-09-13 02:14:29+00:00,['9cb1bcacf1449a41ebd6a2c13faead2665ea38f9'],522,758,1280,911065,18,0,1,0.306306306,1758
695383f1fdfa9149c5771f18ae2208d7b183024b,1,Todd Lipcon,2016-09-13 03:19:37+00:00,['14cd22a10b33545c5136ad68ebcf5cc0543ac525'],53,153,206,911271,7,0,0.938461538,1,1758
0ea34746939187dc8909a0c7c243484f8ddbdf5e,0,Todd Lipcon,2016-09-13 03:19:46+00:00,['695383f1fdfa9149c5771f18ae2208d7b183024b'],40,13,53,911324,1,,,,1758
e4213d5905d0ab69aa78b056d37b124f5c434d82,0,Todd Lipcon,2016-09-13 03:20:08+00:00,['0ea34746939187dc8909a0c7c243484f8ddbdf5e'],0,2,2,911326,1,,,,1758
048e396705c3c53379ac8a3993109142ca7baf14,0,Adar Dembo,2016-09-13 03:33:43+00:00,['e4213d5905d0ab69aa78b056d37b124f5c434d82'],7,3,10,911336,1,1,0,0,1758
e1108ba01682af90b16bec6c8400b4b102df8815,0,Todd Lipcon,2016-09-13 04:19:27+00:00,['048e396705c3c53379ac8a3993109142ca7baf14'],11,11,22,911358,10,,,,1758
ac02b204584725f50b00797748e5d94f327f70bf,0,Todd Lipcon,2016-09-13 04:20:10+00:00,['e1108ba01682af90b16bec6c8400b4b102df8815'],18,10,28,911386,2,0,0,0,1758
1a062253e3fdc900a4b0b418520d2870b6de8846,0,Todd Lipcon,2016-09-13 06:52:14+00:00,['ac02b204584725f50b00797748e5d94f327f70bf'],15,15,30,911416,2,,,,1758
609546dbc2f0f7ed9daeb0eaff2bbc07042b0ed8,1,Dan Burkert,2016-09-13 16:58:23+00:00,['1a062253e3fdc900a4b0b418520d2870b6de8846'],8,604,612,912028,5,0.558139535,1,0.895348837,1759
74065d1cac9635da2f0a80e99a545e12658251a9,0,Adar Dembo,2016-09-13 19:13:00+00:00,['609546dbc2f0f7ed9daeb0eaff2bbc07042b0ed8'],21,38,59,912087,1,,,,1759
4dbfb6247553d3396c51a0a8be8df9a0cadec129,0,Jean-Daniel Cryans,2016-09-14 03:42:21+00:00,['74065d1cac9635da2f0a80e99a545e12658251a9'],5,0,5,912092,1,0,0,1,1759
cf38b52185c6592d127d2f6b44f013703bd313b2,0,Jean-Daniel Cryans,2016-09-14 03:49:16+00:00,['4dbfb6247553d3396c51a0a8be8df9a0cadec129'],21,13,34,912126,1,0,0,0,1759
21a01cff6e0eddc82a519b80a0da3ec7a7ab57ea,0,Jean-Daniel Cryans,2016-09-14 17:56:17+00:00,['cf38b52185c6592d127d2f6b44f013703bd313b2'],0,2,2,912128,1,0,1,1,1759
f9dcf6bb19a64fd38a2045a329c5cf2fa317440d,0,Todd Lipcon,2016-09-14 19:59:43+00:00,['21a01cff6e0eddc82a519b80a0da3ec7a7ab57ea'],33,16,49,912177,1,0,0,0,1759
9a12926f8cd3ef1639ec3952a6c1ac695576022d,0,Todd Lipcon,2016-09-14 19:59:46+00:00,['f9dcf6bb19a64fd38a2045a329c5cf2fa317440d'],0,4,4,912181,1,0,0,1,1759
590207debbad4bda7165c877be6e1aa636763224,0,Todd Lipcon,2016-09-15 03:36:49+00:00,['9a12926f8cd3ef1639ec3952a6c1ac695576022d'],1,1,2,912183,1,,,,1759
136184cdfc5c015fd3dccd2a97c43af241366e2b,0,Todd Lipcon,2016-09-15 05:06:37+00:00,['590207debbad4bda7165c877be6e1aa636763224'],11,4,15,912198,3,1,0,0,1759
4b9d2f6976f45ea57e9a2c2648f31b3a0941a569,1,Todd Lipcon,2016-09-15 05:10:13+00:00,['136184cdfc5c015fd3dccd2a97c43af241366e2b'],145,177,322,912520,22,0,0,0,1760
1eb24183a540f4e3bbbc8a399e440ecf905f6129,1,Todd Lipcon,2016-09-15 06:56:58+00:00,['4b9d2f6976f45ea57e9a2c2648f31b3a0941a569'],22,351,373,912893,15,0.253424658,0.45890411,0.787671233,1762
b0b273e8271752b6eb04ba163981aad1c792e413,0,Adar Dembo,2016-09-15 23:51:10+00:00,['1eb24183a540f4e3bbbc8a399e440ecf905f6129'],5,12,17,912910,1,1,1,1,1762
af7f9c805c96b6ce6854105b369b6d02fbe7105a,0,Adar Dembo,2016-09-15 23:51:18+00:00,['b0b273e8271752b6eb04ba163981aad1c792e413'],3,3,6,912916,1,,,,1762
7959cd403c13d1f40c0b8e90ad66a6940e510ba5,0,Alexey Serbin,2016-09-16 01:05:24+00:00,['af7f9c805c96b6ce6854105b369b6d02fbe7105a'],13,10,23,912939,5,1,1,0,1762
1610b4ac42a9958dc2d79294cb860e1f998301ce,0,Adar Dembo,2016-09-16 01:34:44+00:00,['7959cd403c13d1f40c0b8e90ad66a6940e510ba5'],0,160,160,913099,1,,,,1762
a98f095810621e6941984cb7bdb9912728cc60ff,0,David Ribeiro Alves,2016-09-16 03:02:56+00:00,['1610b4ac42a9958dc2d79294cb860e1f998301ce'],4,4,8,913107,1,,,,1762
c6994d19ccd7dd89127b102ac3c9d3e30a83df5c,0,Todd Lipcon,2016-09-16 03:07:44+00:00,['a98f095810621e6941984cb7bdb9912728cc60ff'],1,1,2,913109,1,,,,1762
09b1e09cb5f896f48ed7e27015488d48b66718e3,0,Jean-Daniel Cryans,2016-09-16 14:57:27+00:00,['c6994d19ccd7dd89127b102ac3c9d3e30a83df5c'],6,0,6,913115,1,1,1,0,1762
1961305d89b93382c485dc7c62a4d506530d28a7,0,Adar Dembo,2016-09-16 17:12:15+00:00,['09b1e09cb5f896f48ed7e27015488d48b66718e3'],19,43,62,913177,1,1,1,1,1762
dd49515f38da49e2fb8670a23d5485b27c0200b1,0,Dan Burkert,2016-09-16 21:05:54+00:00,['1961305d89b93382c485dc7c62a4d506530d28a7'],13,10,23,913200,5,0,0,1,1762
b069dd28b5ef52a4b2f096ef7601b24a55e49117,1,Dan Burkert,2016-09-16 21:41:49+00:00,['dd49515f38da49e2fb8670a23d5485b27c0200b1'],1,1,2,913202,1,,,,1762
ffb8fd967ae9fc31c6a33f814a1f02aa5472bbd8,0,Adar Dembo,2016-09-16 23:09:06+00:00,['b069dd28b5ef52a4b2f096ef7601b24a55e49117'],6,8,14,913216,1,0,0,0,1762
09bf03401e2ff6b1b2c041a2e94268ec5351d7b0,0,David Ribeiro Alves,2016-09-16 23:22:21+00:00,['ffb8fd967ae9fc31c6a33f814a1f02aa5472bbd8'],7,7,14,913230,2,,,,1762
1f639da62d1c995ad9a7b596160b42054757f5e1,0,Alexey Serbin,2016-09-19 04:22:57+00:00,['09bf03401e2ff6b1b2c041a2e94268ec5351d7b0'],51,45,96,913326,5,0,0.2,0,1762
4ba39e4d2694b87eac0cc65f762ba0de293b72ad,0,Todd Lipcon,2016-09-19 18:40:33+00:00,['1f639da62d1c995ad9a7b596160b42054757f5e1'],1,1,2,913328,1,,,,1762
9911c489c45b3a261ee50ad1f837387b4953421b,1,Todd Lipcon,2016-09-19 21:10:54+00:00,['4ba39e4d2694b87eac0cc65f762ba0de293b72ad'],73,229,302,913630,5,0,0.329113924,0.53164557,1763
d87e3ff6036ba070710ecf383448bdfb8380378f,0,Todd Lipcon,2016-09-19 21:24:57+00:00,['9911c489c45b3a261ee50ad1f837387b4953421b'],14,80,94,913724,7,0,0.925,0.975,1763
9aab93f05d7569130c57c11d9a934bd38a0f066f,1,David Ribeiro Alves,2016-09-19 23:35:41+00:00,['d87e3ff6036ba070710ecf383448bdfb8380378f'],1,3,4,913728,1,1,0,1,1763
c9b1fefd25162ae79fac76d1670bc6f08234d139,0,Todd Lipcon,2016-09-20 02:01:11+00:00,['9aab93f05d7569130c57c11d9a934bd38a0f066f'],12,0,12,913740,1,,,,1763
b1ef84e7bfda8d2c62876bab45c77abc053a8d29,0,Todd Lipcon,2016-09-20 02:01:20+00:00,['c9b1fefd25162ae79fac76d1670bc6f08234d139'],1,7,8,913748,1,0,0,1,1763
1069aaae2f46cdefa8586dc9373eb431182b72d3,1,Jean-Daniel Cryans,2016-09-20 18:18:36+00:00,['b1ef84e7bfda8d2c62876bab45c77abc053a8d29'],7,11,18,913766,2,0,0,1,1763
2e0f669ea0e75df87bbbdc631895538d0b6303e3,0,David Ribeiro Alves,2016-09-20 22:59:56+00:00,['1069aaae2f46cdefa8586dc9373eb431182b72d3'],0,5,5,913771,1,,,,1763
7327c28b2f445d3756da34273c5dca7e4ee8d69d,0,Dan Burkert,2016-09-21 17:13:32+00:00,['2e0f669ea0e75df87bbbdc631895538d0b6303e3'],10,89,99,913870,3,0,0.421052632,1,1763
bc14b2f9d775c9f27f2e2be36d4b03080977e8fa,0,Alexey Serbin,2016-09-21 19:09:55+00:00,['7327c28b2f445d3756da34273c5dca7e4ee8d69d'],101,91,192,914062,11,1,1,0,1763
80923d6904f80d8e7d56cc7eee2c11e88b9329bd,0,David Ribeiro Alves,2016-09-21 20:01:00+00:00,['bc14b2f9d775c9f27f2e2be36d4b03080977e8fa'],1,50,51,914113,2,,,,1764
519b2227d91936f10412a4fa509e4defe503d53c,0,Jean-Daniel Cryans,2016-09-22 00:33:14+00:00,['80923d6904f80d8e7d56cc7eee2c11e88b9329bd'],8,8,16,914129,3,,,,1764
8fc75a5c654e100871316e61878b141df4707d0e,0,Jean-Daniel Cryans,2016-09-22 00:33:20+00:00,['519b2227d91936f10412a4fa509e4defe503d53c'],3,6,9,914138,1,0,0,1,1764
0ce5ba594412de4365625485ea7b3c1ee21bf28d,1,Jean-Daniel Cryans,2016-09-22 00:33:27+00:00,['8fc75a5c654e100871316e61878b141df4707d0e'],26,68,94,914232,2,0.083333333,0.75,1,1764
bad910100a4ad3c44b944462838fdee31335e029,1,Alexey Serbin,2016-09-22 04:30:27+00:00,['0ce5ba594412de4365625485ea7b3c1ee21bf28d'],64,62,126,914358,6,,,1,1764
1c668742679bb00b5c851c80071c3232aa68441a,0,Todd Lipcon,2016-09-22 07:33:34+00:00,['bad910100a4ad3c44b944462838fdee31335e029'],67,287,354,914712,10,0.75,0.533333333,1,1765
36b71d2c5a6833da27db8c23be5180faaaad04ab,0,Jean-Daniel Cryans,2016-09-22 15:42:06+00:00,['1c668742679bb00b5c851c80071c3232aa68441a'],1,1,2,914714,1,,,,1765
21aa44398c1ceb0f2c5b464ba3b36b7d85b7165b,0,Dan Burkert,2016-09-22 18:01:18+00:00,['36b71d2c5a6833da27db8c23be5180faaaad04ab'],2,2,4,914718,1,,,,1765
376f95b6dc19ceb13221f02851cf58366f71825d,0,Alexey Serbin,2016-09-23 05:23:46+00:00,['21aa44398c1ceb0f2c5b464ba3b36b7d85b7165b'],11,24,35,914753,1,0,1,1,1765
fd3a05ca12fec0b803cedbf15c03fd498724ee42,0,Alexey Serbin,2016-09-23 19:08:12+00:00,['376f95b6dc19ceb13221f02851cf58366f71825d'],115,61,176,914929,3,0.461538462,0,0,1765
3cc4cdac1ddaba8a4a5ba74dfd5d5aa86197e3dc,0,Todd Lipcon,2016-09-23 19:08:57+00:00,['fd3a05ca12fec0b803cedbf15c03fd498724ee42'],0,19,19,914948,1,,,,1766
c5b07fa8ff73bc2d26668946dc6e7e677d549d22,1,Todd Lipcon,2016-09-23 19:09:04+00:00,['3cc4cdac1ddaba8a4a5ba74dfd5d5aa86197e3dc'],218,188,406,915354,39,1,0.333333333,0,1766
799e067b4ad9446d22a4c00796ccda909a69a91b,0,Alexey Serbin,2016-09-23 19:11:18+00:00,['c5b07fa8ff73bc2d26668946dc6e7e677d549d22'],0,22,22,915376,1,0,1,1,1766
4e3d25502cff273c67b4a408cb2d4716a50c6560,0,Alexey Serbin,2016-09-23 20:14:12+00:00,['799e067b4ad9446d22a4c00796ccda909a69a91b'],10,7,17,915393,4,1,0,0,1766
8da741f215919dd15be1c63546bee9b3e5afe776,0,David Ribeiro Alves,2016-09-23 22:30:27+00:00,['4e3d25502cff273c67b4a408cb2d4716a50c6560'],4,4,8,915401,2,,,,1766
4824f6458ccb680209c537f5967a8a42d2a6dd76,0,Alexey Serbin,2016-09-24 05:35:24+00:00,['8da741f215919dd15be1c63546bee9b3e5afe776'],14,29,43,915444,3,0,0,1,1766
92f7c1914ab29061d324a9a38aa5bb05ca598d47,0,Will Berkeley,2016-09-24 16:14:40+00:00,['4824f6458ccb680209c537f5967a8a42d2a6dd76'],0,36,36,915480,2,,,,1766
e14bb60ccd8290b0162bc701837f4d137625d912,0,Jean-Daniel Cryans,2016-09-26 00:05:10+00:00,['92f7c1914ab29061d324a9a38aa5bb05ca598d47'],40,23,63,915543,2,0.529411765,1,0,1766
bafbc4a2ca56080c8426e5ca7bcde87feb516e4b,0,Adar Dembo,2016-09-26 19:20:20+00:00,['e14bb60ccd8290b0162bc701837f4d137625d912'],14,24,38,915581,4,0.142857143,0.142857143,0,1766
36001f40c683d213aa1e8b35270c9796ce51979c,0,Adar Dembo,2016-09-26 19:20:52+00:00,['bafbc4a2ca56080c8426e5ca7bcde87feb516e4b'],10,7,17,915598,1,,,,1766
a3b54bb6780a2537a03c555a90d58fedb014a4b6,0,Adar Dembo,2016-09-26 19:21:28+00:00,['36001f40c683d213aa1e8b35270c9796ce51979c'],1,149,150,915748,2,,,,1767
1670a89f4c1aff9a839efd0cb9d7eb59a355e6f1,0,Adar Dembo,2016-09-26 19:22:31+00:00,['a3b54bb6780a2537a03c555a90d58fedb014a4b6'],4,4,8,915756,2,,,,1767
9bcd522a06fcd8326132c67cf99eedb7b732dc68,0,Adar Dembo,2016-09-26 19:23:14+00:00,['1670a89f4c1aff9a839efd0cb9d7eb59a355e6f1'],133,151,284,916040,2,,,,1767
dba7cddf7c0867eaae24916c709c1d4405b822b6,0,Adar Dembo,2016-09-26 19:24:10+00:00,['9bcd522a06fcd8326132c67cf99eedb7b732dc68'],72,66,138,916178,11,,,,1767
69e65780843040c085ca34901803b97b59595c0e,0,Adar Dembo,2016-09-26 19:27:25+00:00,['dba7cddf7c0867eaae24916c709c1d4405b822b6'],1,3,4,916182,1,,,,1767
643c922128f09854e08e0970707aa344215fa898,0,Adar Dembo,2016-09-26 19:29:22+00:00,['69e65780843040c085ca34901803b97b59595c0e'],19,42,61,916243,3,0,0,1,1767
1f40913de6d3427847f3d435e1b84fb928a6f6a9,0,Dan Burkert,2016-09-26 20:59:39+00:00,['643c922128f09854e08e0970707aa344215fa898'],10,19,29,916272,3,0.5,0.5,0.833333333,1767
9b9188b7ca5052effab014e2ce43b0545eccc374,0,Alexey Serbin,2016-09-27 01:56:03+00:00,['1f40913de6d3427847f3d435e1b84fb928a6f6a9'],0,8,8,916280,1,,,,1767
ed048e83a12f9917fbb692d00a833eca69a9a684,0,Mike Percy,2016-09-27 07:58:55+00:00,['9b9188b7ca5052effab014e2ce43b0545eccc374'],5,174,179,916459,5,0.301587302,1,0.650793651,1768
ce17a9c4eb34dcfe63c8d4321d38d18a0cb8c5c2,0,Dan Burkert,2016-09-27 17:33:14+00:00,['ed048e83a12f9917fbb692d00a833eca69a9a684'],61,99,160,916619,7,0.2,0,0.433333333,1768
56cc69226fa6a053e6f038ac2b1d12b6fc533e37,0,Dan Burkert,2016-09-27 17:34:11+00:00,['ce17a9c4eb34dcfe63c8d4321d38d18a0cb8c5c2'],1,2,3,916622,1,,,,1768
591e6ddfdda0e685dba3ce4ca3ebaa9bc6731c0c,0,Jean-Daniel Cryans,2016-09-27 22:34:50+00:00,['56cc69226fa6a053e6f038ac2b1d12b6fc533e37'],1,10,11,916633,1,1,1,1,1768
dfe96efda39dfa13a68c7465a4cd963275559baa,0,Adar Dembo,2016-09-28 02:17:26+00:00,['591e6ddfdda0e685dba3ce4ca3ebaa9bc6731c0c'],34,38,72,916705,7,0,1,0,1768
a03a2f380c177fa6ba490c792829897f02d7689f,0,Alexey Serbin,2016-09-28 02:47:24+00:00,['dfe96efda39dfa13a68c7465a4cd963275559baa'],46,97,143,916848,6,0,0,0,1770
01bf011cd49e132a8333bf8ea7272b8354e8cab2,0,Todd Lipcon,2016-09-28 04:26:08+00:00,['a03a2f380c177fa6ba490c792829897f02d7689f'],3,9,12,916860,4,,,,1770
1c4dcabddc1188e0881d6b35141cee1ec7171e7b,0,Todd Lipcon,2016-09-28 04:26:42+00:00,['01bf011cd49e132a8333bf8ea7272b8354e8cab2'],2,2,4,916864,1,,,,1770
d6c5507049757735cc88659f919a5a5d12092da6,0,Adar Dembo,2016-09-28 21:05:41+00:00,['1c4dcabddc1188e0881d6b35141cee1ec7171e7b'],14,165,179,917043,1,,,,1770
17d1367e12378a1dbfcc977fd673ad4c374d5f55,0,Adar Dembo,2016-09-28 22:23:27+00:00,['d6c5507049757735cc88659f919a5a5d12092da6'],1,2,3,917046,1,,,,1770
9b50bd585f62834f9d65787344e545bd6846404c,0,Dan Burkert,2016-09-29 01:30:20+00:00,['17d1367e12378a1dbfcc977fd673ad4c374d5f55'],37,1000,1037,918083,16,0.180300501,0.041736227,0.923205342,1770
cb92799baf195d70b80535d11e54447e25b71c42,0,Dan Burkert,2016-09-29 01:30:31+00:00,['9b50bd585f62834f9d65787344e545bd6846404c'],117,615,732,918815,5,0.098726115,0.579617834,0.878980892,1770
26b81875168b2ccfd87c965e873bc876f1ad16ef,0,Jordan Birdsell,2016-09-28 23:20:23-04:00,['8bf183963c44d83198be2e21b60fd6dfeee84261'],15,15,30,918845,1,0,1,0,1770
f9a005f8586d5d2b32cf89107c14fabb6213aa5a,1,Adar Dembo,2016-09-29 16:55:46+00:00,['cb92799baf195d70b80535d11e54447e25b71c42'],217,334,551,919396,18,,,,1770
fd8a50a81ade1f4f43e3f186514919a68ad830bc,0,Adar Dembo,2016-09-29 17:43:30+00:00,['f9a005f8586d5d2b32cf89107c14fabb6213aa5a'],219,179,398,919794,12,,,,1770
3625a0c1704fad8302d0aa0801033d3be5287f00,0,Adar Dembo,2016-09-29 17:46:31+00:00,['fd8a50a81ade1f4f43e3f186514919a68ad830bc'],0,136,136,919930,3,0.384615385,1,1,1771
b208e6303d6a3edc08d73cbb075d55c4c321cc3f,0,Adar Dembo,2016-09-29 17:47:29+00:00,['3625a0c1704fad8302d0aa0801033d3be5287f00'],185,254,439,920369,5,,,,1771
0d1f85a3a4992ddd0c0b82db418ec239e0a2c209,0,Dan Burkert,2016-09-29 17:47:50+00:00,['b208e6303d6a3edc08d73cbb075d55c4c321cc3f'],22,36,58,920427,2,,,,1771
9689068f46322aed137f66bd715e0c8d8f578690,1,Dan Burkert,2016-09-29 17:48:11+00:00,['0d1f85a3a4992ddd0c0b82db418ec239e0a2c209'],115,138,253,920680,4,,,,1771
33e98ce4973aaa49b6033004038dafdbdf808348,0,Dan Burkert,2016-09-29 17:48:26+00:00,['9689068f46322aed137f66bd715e0c8d8f578690'],51,9,60,920740,8,,,,1771
9a3ea4caad5ee9e6932d9b63e6fde109151c98fe,0,Jean-Daniel Cryans,2016-09-29 21:22:17+00:00,['33e98ce4973aaa49b6033004038dafdbdf808348'],0,4,4,920744,1,,,,1771
fcbfa90e4a594c473901297a47dfa2d01f1229e1,1,Jean-Daniel Cryans,2016-09-29 21:22:23+00:00,['9a3ea4caad5ee9e6932d9b63e6fde109151c98fe'],7,5,12,920756,3,,,,1771
742d85c5b92a8f541d9a22e5b96e0f1ce8102169,0,Adar Dembo,2016-09-29 21:50:49+00:00,['fcbfa90e4a594c473901297a47dfa2d01f1229e1'],1,1,2,920758,1,,,,1771
5385af86dc61e56dbe601f0ad6c2bc8fba30ed7c,1,Alexey Serbin,2016-09-30 01:49:16+00:00,['742d85c5b92a8f541d9a22e5b96e0f1ce8102169'],183,751,934,921692,17,0.2,0.311764706,0.391176471,1772
74c9e67ce326e851c39677e44cca7ab7d4955e0a,0,Dan Burkert,2016-09-30 02:55:49+00:00,['5385af86dc61e56dbe601f0ad6c2bc8fba30ed7c'],3,21,24,921716,2,1,1,1,1772
70211f84c9888e2ed8ed9ec87c4718e1e091dad0,1,Dan Burkert,2016-09-30 04:41:42+00:00,['74c9e67ce326e851c39677e44cca7ab7d4955e0a'],1,158,159,921875,3,0.169230769,0,1,1773
40460660dabbd63d48e1eaf2b24a2cc499b6c18f,0,Alexey Serbin,2016-09-30 05:40:51+00:00,['70211f84c9888e2ed8ed9ec87c4718e1e091dad0'],0,1,1,921876,1,0,0,0,1773
95654d82d4420a6c745207b9a52039de5fadcb1d,0,GitHub,2016-09-30 12:25:39-07:00,"['8bf183963c44d83198be2e21b60fd6dfeee84261', '26b81875168b2ccfd87c965e873bc876f1ad16ef']",15,15,30,921906,1,,,,1773
41e0b0af23aadbca5a38dca8ccf8d42ac7eb5bee,0,Adar Dembo,2016-09-30 20:00:48+00:00,['40460660dabbd63d48e1eaf2b24a2cc499b6c18f'],8,7,15,921921,1,1,0,1,1773
a6d7a5c6d896a6893340e937be60a396b30e1e43,0,Dan Burkert,2016-09-30 22:04:50+00:00,['41e0b0af23aadbca5a38dca8ccf8d42ac7eb5bee'],1,1,2,921923,1,,,,1773
ad2fd4c69f3dccbac232f5d40a45389556c4a7a1,0,Mike Percy,2016-10-03 11:55:40+00:00,['a6d7a5c6d896a6893340e937be60a396b30e1e43'],2,1,3,921926,1,1,1,0,1773
1dba44167574855e88ff12074c8134b4e2e1a1cd,0,Mike Percy,2016-10-03 15:47:46+00:00,['ad2fd4c69f3dccbac232f5d40a45389556c4a7a1'],7,5,12,921938,1,,,,1773
3cb16ff32e3a053664a1947055f6e66e0a5dd87d,0,Alexey Serbin,2016-10-03 16:42:52+00:00,['1dba44167574855e88ff12074c8134b4e2e1a1cd'],75,75,150,922088,1,,,,1773
407f95da12540de00d23c32fb9cdf853f36021c7,0,Todd Lipcon,2016-10-03 18:00:47+00:00,['3cb16ff32e3a053664a1947055f6e66e0a5dd87d'],15,24,39,922127,5,0,0.8,0.8,1773
26ef3360280bc4c4e37a31dc38c8500b8b3e4010,0,Dan Burkert,2016-10-03 19:28:37+00:00,['407f95da12540de00d23c32fb9cdf853f36021c7'],3,5,8,922135,1,0,0,1,1773
fb512261fcc322e8fdb2a2489db68d892d4beeba,0,Jean-Daniel Cryans,2016-10-03 22:29:37+00:00,['26ef3360280bc4c4e37a31dc38c8500b8b3e4010'],14,66,80,922215,1,,,,1773
5935697e073b698f96f1c3a981347a8c949ca6ad,0,Todd Lipcon,2016-10-04 00:58:02+00:00,['fb512261fcc322e8fdb2a2489db68d892d4beeba'],6,7,13,922228,2,,,,1773
ddaf9b3956ec6864ae164551ffd0339f654b03b1,0,Todd Lipcon,2016-10-04 00:58:50+00:00,['5935697e073b698f96f1c3a981347a8c949ca6ad'],2,6,8,922236,1,,,,1773
e0c6ced3e848e490f24780488bebd0c46c6804a1,0,Todd Lipcon,2016-10-04 00:59:19+00:00,['ddaf9b3956ec6864ae164551ffd0339f654b03b1'],9,4,13,922249,1,0,0,0,1773
6d696bcf7522fb5dfbc3188fe01b3d0ddbd03df6,0,Mike Percy,2016-10-04 12:51:08+00:00,['e0c6ced3e848e490f24780488bebd0c46c6804a1'],1,1,2,922251,1,,,,1773
624a88b18718ea0abc39e32923bb48339398a429,1,Dan Burkert,2016-10-04 19:42:54+00:00,['6d696bcf7522fb5dfbc3188fe01b3d0ddbd03df6'],8,26,34,922285,3,0,1,0.384615385,1773
1a60ed7d2dacc840aa28e43eaee29d26401941de,0,Dan Burkert,2016-10-04 19:43:08+00:00,['624a88b18718ea0abc39e32923bb48339398a429'],0,3,3,922288,1,,,,1773
d87486c47153cfc42c5a8ed7496e746aafdc2bdd,1,Jean-Daniel Cryans,2016-10-04 23:19:08+00:00,['1a60ed7d2dacc840aa28e43eaee29d26401941de'],19,100,119,922407,3,0.083333333,0.895833333,0.895833333,1774
2a1a6c073bfb3dfb0d310d07f11aab10641665b6,0,Todd Lipcon,2016-10-05 04:41:04+00:00,['d87486c47153cfc42c5a8ed7496e746aafdc2bdd'],0,15,15,922422,1,,,,1774
2528edf28489569f4d4625a8eb1e92fb4df37753,0,Todd Lipcon,2016-10-05 04:41:41+00:00,['2a1a6c073bfb3dfb0d310d07f11aab10641665b6'],213,245,458,922880,4,,,,1775
b70d3625b88ef4ad5d15ef68865e933a73c9069c,0,David Ribeiro Alves,2016-10-05 07:06:11+00:00,['2528edf28489569f4d4625a8eb1e92fb4df37753'],1,43,44,922924,1,,,,1775
07d190c3e47661e762c56c8405370e37b9e989ac,0,Todd Lipcon,2016-10-05 17:06:13+00:00,['b70d3625b88ef4ad5d15ef68865e933a73c9069c'],1,5,6,922930,1,0,1,1,1775
3830fc972b0a810529c87cd4de0bf026668b9b5c,0,Dan Burkert,2016-10-05 18:24:57+00:00,['07d190c3e47661e762c56c8405370e37b9e989ac'],24,124,148,923078,4,1,1,1,1775
0f99d403da61a5304d1e2b01516d949ecd311334,0,Alexey Serbin,2016-10-05 19:22:58+00:00,['3830fc972b0a810529c87cd4de0bf026668b9b5c'],4,28,32,923110,2,0.916666667,0.916666667,0.916666667,1775
98f42cdd878caa429377625a2288d22ed0d114f2,0,David Ribeiro Alves,2016-10-05 20:26:40+00:00,['0f99d403da61a5304d1e2b01516d949ecd311334'],2,10,12,923122,1,0,1,1,1775
0558aaa48ed9bbfe1e680b2be9f9f3f60f7dd6c0,1,Todd Lipcon,2016-10-05 20:58:33+00:00,['98f42cdd878caa429377625a2288d22ed0d114f2'],36,64,100,923222,2,0.2,0.2,1,1775
64f9ab34ffbc249cf72fc187308a1402888ba994,0,Todd Lipcon,2016-10-05 21:29:23+00:00,['0558aaa48ed9bbfe1e680b2be9f9f3f60f7dd6c0'],56,78,134,923356,5,0,0.818181818,1,1775
4bcbb4a405c037162954cba218c2316e517cdbf3,1,Todd Lipcon,2016-10-05 21:41:26+00:00,['64f9ab34ffbc249cf72fc187308a1402888ba994'],801,61,862,924218,10,0.710144928,0.173913043,0.142512077,1775
bda9b94e88b2602dcc029e763c8a9e0eecff8e08,1,Todd Lipcon,2016-10-05 21:41:36+00:00,['4bcbb4a405c037162954cba218c2316e517cdbf3'],64,45,109,924327,3,0,0,0,1775
4db8851cf31f68f2db8dafc41a4609017371501b,0,David Ribeiro Alves,2016-10-05 21:53:07+00:00,['bda9b94e88b2602dcc029e763c8a9e0eecff8e08'],7,289,296,924623,7,0.035087719,0.98245614,1,1775
07ce9fbce4fcdcfafe01db0347b69c0283df5e2c,0,Todd Lipcon,2016-10-05 22:26:33+00:00,['4db8851cf31f68f2db8dafc41a4609017371501b'],2,10,12,924635,1,1,1,0.666666667,1775
f26ab7d5c28979b2cda9860faac1039920fd7a15,0,Jean-Daniel Cryans,2016-10-05 22:34:42+00:00,['07ce9fbce4fcdcfafe01db0347b69c0283df5e2c'],46,14,60,924695,6,0,0,0,1775
98130e3c40780e80dd46e9c729424554f2c77a4f,0,Jean-Daniel Cryans,2016-10-05 23:30:18+00:00,['f26ab7d5c28979b2cda9860faac1039920fd7a15'],12,26,38,924733,1,0,0,1,1775
3c33847fc5f70ab6d65fa2fe93d5bde185e4365e,0,Jean-Daniel Cryans,2016-10-05 23:36:45+00:00,['98130e3c40780e80dd46e9c729424554f2c77a4f'],3,2,5,924738,1,1,0.5,0,1775
bce1dd7772c28a5521d97ffbcf02ee17216174a3,0,Jean-Daniel Cryans,2016-10-05 23:46:16+00:00,['3c33847fc5f70ab6d65fa2fe93d5bde185e4365e'],9,27,36,924774,1,0.1,0.1,1,1775
4d1b1e973655b783f2e7b338b6574b2e2166e08f,1,David Ribeiro Alves,2016-10-06 00:55:43+00:00,['bce1dd7772c28a5521d97ffbcf02ee17216174a3'],28,182,210,924984,6,0.68,0.29,0.79,1775
0ee10ea34cb3f68ba911524b873773a45031aa68,0,Todd Lipcon,2016-10-06 01:15:19+00:00,['4d1b1e973655b783f2e7b338b6574b2e2166e08f'],0,1,1,924985,1,0,1,0,1775
127438af30356f1afedb862166c907ff754d1c55,1,Todd Lipcon,2016-10-06 01:15:30+00:00,['0ee10ea34cb3f68ba911524b873773a45031aa68'],139,183,322,925307,12,0,1,1,1775
cae2f98998629e682d5c6618b3a2854eec703fd4,0,Todd Lipcon,2016-10-06 02:56:35+00:00,['127438af30356f1afedb862166c907ff754d1c55'],13,13,26,925333,2,,,,1775
fc5e6a3e7921b9a475848117063e2d7db56f8ee4,0,Dan Burkert,2016-10-06 19:16:41+00:00,['cae2f98998629e682d5c6618b3a2854eec703fd4'],5,14,19,925352,3,1,1,1,1775
833abea787d3ac4bde3e5292c82b3408aad9ba92,0,Alexey Serbin,2016-10-07 22:11:16+00:00,['fc5e6a3e7921b9a475848117063e2d7db56f8ee4'],66,190,256,925608,10,0,1,0.817204301,1775
5233e498b3ad79bf5f5b8f51af23b1838777d72d,0,Todd Lipcon,2016-10-07 23:09:43+00:00,['833abea787d3ac4bde3e5292c82b3408aad9ba92'],3,5,8,925616,1,0,1,1,1775
ac519fde8a2e1f1097346416518c57dcd2b9238c,0,Alexey Serbin,2016-10-08 08:34:03+00:00,['5233e498b3ad79bf5f5b8f51af23b1838777d72d'],76,124,200,925816,1,0,0,0.172413793,1775
1956c9d8739b8374a53fceb2a5753de6151bba31,0,David Ribeiro Alves,2016-10-10 18:27:05+00:00,['ac519fde8a2e1f1097346416518c57dcd2b9238c'],10,24,34,925850,1,0,1,1,1775
64ec121498f603fb3c4e5291f5a43eac2bcd0f8f,0,Dan Burkert,2016-10-11 00:30:51+00:00,['1956c9d8739b8374a53fceb2a5753de6151bba31'],235,3660,3895,929745,6,,,,1780
5962de1580966a8a0f45700134f1e02a4b92dba6,0,Alexey Serbin,2016-10-11 00:44:27+00:00,['64ec121498f603fb3c4e5291f5a43eac2bcd0f8f'],0,167,167,929912,1,,,,1781
8f853d7a3ac56ac884c67b37744d0eeb237c69ef,0,Todd Lipcon,2016-10-11 05:16:55+00:00,['5962de1580966a8a0f45700134f1e02a4b92dba6'],1,5,6,929918,1,,,,1781
1ca7ccfb4d0440ad09077f1f8f2bb2571dec3dc9,0,Todd Lipcon,2016-10-11 06:19:05+00:00,['8f853d7a3ac56ac884c67b37744d0eeb237c69ef'],259,15,274,930192,6,0.183544304,0.126582278,0,1781
71f21f0abfed0175c9708a393c7dd74a505954ec,0,Alexey Serbin,2016-10-12 01:06:59+00:00,['1ca7ccfb4d0440ad09077f1f8f2bb2571dec3dc9'],13,12,25,930217,1,,,,1781
7bcfcf64ccc2300f482e11e73d9703b92093394b,0,Adar Dembo,2016-10-12 18:05:40+00:00,['71f21f0abfed0175c9708a393c7dd74a505954ec'],10,18,28,930245,1,0.25,0.25,0,1781
5195ce573850653e0e53094cdd35a1da93d33444,0,Alexey Serbin,2016-10-13 00:18:09+00:00,['7bcfcf64ccc2300f482e11e73d9703b92093394b'],1,1,2,930247,1,,,,1781
fb9526f9ddd53066b617a6d7b6d1478eaa50fe96,0,Jean-Daniel Cryans,2016-10-13 15:52:36+00:00,['5195ce573850653e0e53094cdd35a1da93d33444'],6,23,29,930276,1,0,0,0.5,1781
1746ae0210ef1340346edae7e154ab5254fccda8,1,Jean-Daniel Cryans,2016-10-13 23:11:34+00:00,['fb9526f9ddd53066b617a6d7b6d1478eaa50fe96'],80,22,102,930378,2,1,0.4,0.72,1781
d065e3316eb631e98f8c5da0b5223392da7e719e,1,Todd Lipcon,2016-10-14 06:37:31+00:00,['1746ae0210ef1340346edae7e154ab5254fccda8'],11,7,18,930396,2,0,0,0,1781
9341d22daa24ababa971ce896de5d3b65becef5c,0,Dan Burkert,2016-10-14 20:54:00+00:00,['d065e3316eb631e98f8c5da0b5223392da7e719e'],0,42,42,930438,1,,,,1781
0c52f161b4504480adcb9e06b7bb0bc5b3e192b0,0,Dan Burkert,2016-10-14 20:54:04+00:00,['9341d22daa24ababa971ce896de5d3b65becef5c'],0,4720,4720,935158,4,,,,1785
e5b7ebf8daa4b17a475814e62ed87d9dff4f6095,0,Jean-Daniel Cryans,2016-10-14 21:38:26+00:00,['0c52f161b4504480adcb9e06b7bb0bc5b3e192b0'],355,417,772,935930,3,1,1,0.875,1786
0c44223ea9e8561d9c48299007094f6f0d3f495f,0,Todd Lipcon,2016-10-17 17:13:25+00:00,['e5b7ebf8daa4b17a475814e62ed87d9dff4f6095'],2,45,47,935977,1,1,1,1,1786
8613415b2eafd5457a68a91c1c0e22b96e8c6f1d,0,Jean-Daniel Cryans,2016-10-17 22:16:06+00:00,['0c44223ea9e8561d9c48299007094f6f0d3f495f'],5,17,22,935999,1,,,,1786
4923a74d768e903761ebf96cd5ef5f1286dafca4,1,Adar Dembo,2016-10-18 01:04:21+00:00,['8613415b2eafd5457a68a91c1c0e22b96e8c6f1d'],0,234,234,936233,2,0,0,1,1788
45c1512fcc42772173490be4e7aefcf45129fed2,1,Todd Lipcon,2016-10-18 04:45:18+00:00,['4923a74d768e903761ebf96cd5ef5f1286dafca4'],144,309,453,936686,10,0.544303797,0.683544304,1,1788
717c70d59552195d90960a3e45f9bdcd5c08af98,0,Todd Lipcon,2016-10-18 05:19:54+00:00,['45c1512fcc42772173490be4e7aefcf45129fed2'],12,12,24,936710,3,0,1,1,1788
b3ab84979bf6908e0c330503d908f70b6419f879,0,Todd Lipcon,2016-10-18 05:20:08+00:00,['717c70d59552195d90960a3e45f9bdcd5c08af98'],67,23,90,936800,4,0,0,0,1788
0b0cc92d296be928feb2bd38622c2f8cc06a9ef0,0,Alexey Serbin,2016-10-18 20:39:36+00:00,['b3ab84979bf6908e0c330503d908f70b6419f879'],38,62,100,936900,1,0,0,1,1788
bd56e021c401fcc0d08ae52d1ba0800dc9bc32d3,1,Alexey Serbin,2016-10-19 00:05:59+00:00,['0b0cc92d296be928feb2bd38622c2f8cc06a9ef0'],101,257,358,937258,7,0.131147541,0.254098361,1,1788
46d4d78bc63690d6ee7109d14d462f76d05fb4c5,1,Jean-Daniel Cryans,2016-10-19 15:53:48+00:00,['bd56e021c401fcc0d08ae52d1ba0800dc9bc32d3'],318,345,663,937921,8,1,1,0,1789
f2776c892de9631dfe4ee62d1321889751572b21,1,Todd Lipcon,2016-10-19 22:07:45+00:00,['46d4d78bc63690d6ee7109d14d462f76d05fb4c5'],100,129,229,938150,7,0.833333333,1,0.166666667,1789
01e9168f0052f87ff759867b7d46b0b656bf74ec,1,Todd Lipcon,2016-10-19 22:07:51+00:00,['f2776c892de9631dfe4ee62d1321889751572b21'],36,34,70,938220,1,,,,1789
03d967ae27f3d00690c33ac4dbe0a8bcc49651f4,1,Todd Lipcon,2016-10-19 22:07:55+00:00,['01e9168f0052f87ff759867b7d46b0b656bf74ec'],34,11,45,938265,6,0.090909091,0,0.181818182,1789
af2ba10c215bd15d6d9bd6d3942c63b1961ebd52,0,Todd Lipcon,2016-10-19 22:08:00+00:00,['03d967ae27f3d00690c33ac4dbe0a8bcc49651f4'],47,4,51,938316,3,0.64,0,0,1789
676c0d0cfade74a7a7f10c7f49603e686947e23b,0,Mike Percy,2016-10-20 14:05:18+00:00,['af2ba10c215bd15d6d9bd6d3942c63b1961ebd52'],0,24,24,938340,1,0,1,1,1789
6bc075385f71784cca09120ed9ca3d2c34d7b4d7,1,Adar Dembo,2016-10-20 18:09:48+00:00,['676c0d0cfade74a7a7f10c7f49603e686947e23b'],276,488,764,939104,29,0.510791367,0.956834532,0.661870504,1790
abd87164fbaed626f6a374f49959bbba57dead67,0,Dan Burkert,2016-10-20 18:15:14+00:00,['6bc075385f71784cca09120ed9ca3d2c34d7b4d7'],1,1,2,939106,1,,,,1790
ba36a0b7d122545ae99fb2a2e7e9c7e0035669b1,0,Todd Lipcon,2016-10-20 20:31:26+00:00,['abd87164fbaed626f6a374f49959bbba57dead67'],0,166,166,939272,7,0.12,0.76,1,1791
cd40d1c5126d0fd541d95370cdb2998b60f2f82c,1,Todd Lipcon,2016-10-20 21:01:19+00:00,['ba36a0b7d122545ae99fb2a2e7e9c7e0035669b1'],0,23,23,939295,1,0.933333333,1,1,1791
65cb2edf5661599f689e28f4eec161fe062f7cb5,1,Adar Dembo,2016-10-20 21:19:32+00:00,['cd40d1c5126d0fd541d95370cdb2998b60f2f82c'],520,623,1143,940438,17,1,1,0,1795
27992c120e1aebe5597665d981e8efc0586aab55,1,Todd Lipcon,2016-10-20 21:28:45+00:00,['65cb2edf5661599f689e28f4eec161fe062f7cb5'],225,219,444,940882,5,1,0,0.333333333,1795
7138468a567962dd0bbf9419df4c0b853660b913,1,Adar Dembo,2016-10-20 21:53:26+00:00,['27992c120e1aebe5597665d981e8efc0586aab55'],33,588,621,941503,17,0.334763948,0.836909871,0.901287554,1800
1096d663f36da19b211dd4fdf76fca10f842b8b8,0,Todd Lipcon,2016-10-20 22:02:24+00:00,['7138468a567962dd0bbf9419df4c0b853660b913'],1,21,22,941525,4,0,0,1,1800
49d0d7f48897adb7bea3031ab7e13ddb80fe7b14,0,Todd Lipcon,2016-10-21 17:13:51+00:00,['1096d663f36da19b211dd4fdf76fca10f842b8b8'],1,1,2,941527,1,,,,1800
2426ef30650318bafd72cc49984aa7b5719b58e0,0,Todd Lipcon,2016-10-21 21:22:14+00:00,['49d0d7f48897adb7bea3031ab7e13ddb80fe7b14'],2,3,5,941532,1,,,,1800
4b5425aa3cfa70e6ec20e2b67c7976b36ca5d2d9,0,Todd Lipcon,2016-10-21 21:35:35+00:00,['2426ef30650318bafd72cc49984aa7b5719b58e0'],0,42,42,941574,3,1,1,1,1800
1a8ce4269870acaf758e9140e719a496d0246631,1,Dan Burkert,2016-10-24 22:01:31+00:00,['4b5425aa3cfa70e6ec20e2b67c7976b36ca5d2d9'],8,411,419,941993,3,0.710900474,1,0.971563981,1802
ff24651cb9cb7f78ee2806b8624e61fed132b516,0,Jean-Daniel Cryans,2016-10-24 23:16:54+00:00,['1a8ce4269870acaf758e9140e719a496d0246631'],43,97,140,942133,6,1,1,0.76,1802
a07c5adac0aa68390fa6a34a625cb0236986f611,0,David Ribeiro Alves,2016-10-25 01:14:07+00:00,['ff24651cb9cb7f78ee2806b8624e61fed132b516'],0,233,233,942366,2,,,,1803
8972e9ef45edd9214f921b5b93a4c2cdf8fef8fc,0,Dan Burkert,2016-10-25 19:39:23+00:00,['a07c5adac0aa68390fa6a34a625cb0236986f611'],3,1,4,942370,2,,,,1803
6ed6989ab99a415b9442559261cdee719b2eff57,0,Dan Burkert,2016-10-25 19:39:32+00:00,['8972e9ef45edd9214f921b5b93a4c2cdf8fef8fc'],1,15,16,942386,3,1,1,1,1803
5a46e6076d8b26971202d31ab04326339c961796,0,Todd Lipcon,2016-10-25 22:50:44+00:00,['6ed6989ab99a415b9442559261cdee719b2eff57'],125,87,212,942598,18,1,0.064516129,0.064516129,1803
f2a39c624abcd605d64d6301c3d5e307557c4127,0,David Ribeiro Alves,2016-10-26 02:32:40+00:00,['5a46e6076d8b26971202d31ab04326339c961796'],6,2,8,942606,1,0,0,0,1803
96c2e2a83cf4a371e4ca179248bb05773359e985,1,Jean-Daniel Cryans,2016-10-27 15:40:55+00:00,['f2a39c624abcd605d64d6301c3d5e307557c4127'],25,56,81,942687,2,0,1,0,1803
a326fc950681c7187c096b5899186932e6e8d080,0,Jean-Daniel Cryans,2016-10-27 18:18:13+00:00,['96c2e2a83cf4a371e4ca179248bb05773359e985'],88,178,266,942953,7,0.846153846,0.948717949,1,1804
a7fd4fc85c0878570a5ab51a8e28275fd4459ff5,0,Jean-Daniel Cryans,2016-10-27 18:40:35+00:00,['a326fc950681c7187c096b5899186932e6e8d080'],17,115,132,943085,9,0.916666667,0.944444444,0.944444444,1805
b333a36f12d019dbecb734cf2020d5f6f71fa26b,0,Jean-Daniel Cryans,2016-10-27 23:07:45+00:00,['a7fd4fc85c0878570a5ab51a8e28275fd4459ff5'],38,35,73,943158,18,,,,1805
b7497b304f65b814a2338e75ac3d277c0bebdb0b,0,Will Berkeley,2016-10-28 13:42:54+00:00,['b333a36f12d019dbecb734cf2020d5f6f71fa26b'],83,248,331,943489,9,0.636363636,0.181818182,0,1806
d38a17d9be48fbe2ad3fc5aa9c034157b6b0a456,0,David Ribeiro Alves,2016-10-28 17:01:50+00:00,['b7497b304f65b814a2338e75ac3d277c0bebdb0b'],3,126,129,943618,5,1,1,1,1806
be1c25e875dcd6693603a90a9a6cc23d393444bf,0,Todd Lipcon,2016-10-28 21:04:22+00:00,['d38a17d9be48fbe2ad3fc5aa9c034157b6b0a456'],48,341,389,944007,19,0.547945205,0.95890411,1,1806
1b7f5314bab61cc36945ca962c952f4b8472aa13,0,Todd Lipcon,2016-10-28 21:04:38+00:00,['be1c25e875dcd6693603a90a9a6cc23d393444bf'],105,192,297,944304,7,0,0.351851852,0.962962963,1806
316b5f75d3573b46466f74a24187973a25849c97,0,Jean-Daniel Cryans,2016-10-28 22:13:42+00:00,['1b7f5314bab61cc36945ca962c952f4b8472aa13'],33,17,50,944354,5,0,0,0,1806
732a5052acadc19b999553b4a96979f8801d5963,0,Todd Lipcon,2016-10-29 00:00:25+00:00,['316b5f75d3573b46466f74a24187973a25849c97'],266,54,320,944674,15,0.333333333,0.380952381,0.333333333,1806
fd89792a89a551902f69bb8d40f128df6dbe7bc4,0,Todd Lipcon,2016-10-29 00:00:36+00:00,['732a5052acadc19b999553b4a96979f8801d5963'],11,85,96,944770,4,0.041666667,1,1,1806
a1a8eef23a3cdab198cbae88a999cefb38ff2aea,0,Todd Lipcon,2016-10-29 00:16:57+00:00,['fd89792a89a551902f69bb8d40f128df6dbe7bc4'],17,61,78,944848,4,0.4,0.428571429,1,1806
6c30e2a05785b042d10de9cc5f827762bc6cd958,0,Alexey Serbin,2016-10-28 17:34:31-07:00,['95654d82d4420a6c745207b9a52039de5fadcb1d'],5,8,13,944861,1,,,,1806
c91d04aeec4c2ed0062593d1866fad45a4b0abc0,0,Will Berkeley,2016-10-30 15:48:28+00:00,['a1a8eef23a3cdab198cbae88a999cefb38ff2aea'],6,25,31,944892,3,0,1,1,1806
6f54154fdec76cbab966d0d222b5c24b27f8c7ba,1,Will Berkeley,2016-10-30 16:10:20+00:00,['c91d04aeec4c2ed0062593d1866fad45a4b0abc0'],60,84,144,945036,5,0,0,0,1806
81157cc5e952134faf3192a0b51d6ca210e51228,0,GitHub,2016-10-31 09:28:46-07:00,"['95654d82d4420a6c745207b9a52039de5fadcb1d', '6c30e2a05785b042d10de9cc5f827762bc6cd958']",5,8,13,945049,1,,,,1806
b2f3803458f9aae2668a756861be3a207932b0cd,1,Todd Lipcon,2016-10-31 22:44:57+00:00,['6f54154fdec76cbab966d0d222b5c24b27f8c7ba'],10,47,57,945106,5,0.6875,0.6875,1,1806
4ed84b9560ef16839fad063a79b59b40361c6916,0,Todd Lipcon,2016-10-31 22:47:21+00:00,['b2f3803458f9aae2668a756861be3a207932b0cd'],1,30,31,945137,2,1,1,1,1806
fa1a48febbdfd619a5d74008fe387764384a0dac,0,Todd Lipcon,2016-11-01 19:32:52+00:00,['4ed84b9560ef16839fad063a79b59b40361c6916'],2,9,11,945148,3,1,1,1,1806
71ba4975ed5434a30c623da953bd77fd1dbb9cde,0,Todd Lipcon,2016-11-01 22:16:32+00:00,['fa1a48febbdfd619a5d74008fe387764384a0dac'],1,65,66,945214,3,,,,1807
758a5c45a525cda10a26f95f4ddca804897dd097,1,Todd Lipcon,2016-11-01 22:22:11+00:00,['71ba4975ed5434a30c623da953bd77fd1dbb9cde'],17,198,215,945429,12,0.511363636,0.5,1,1807
401a592742228ca9b8419021f87904e70689990b,0,Todd Lipcon,2016-11-02 00:03:18+00:00,['758a5c45a525cda10a26f95f4ddca804897dd097'],1,1,2,945431,1,,,,1807
3a3f714e4df4ed1ddef5fdf7c55086d1dd0f4794,1,Adar Dembo,2016-11-02 18:11:03+00:00,['401a592742228ca9b8419021f87904e70689990b'],470,609,1079,946510,9,1,1,1,1809
e46e9518b12471efdd65e3a989e05d4ffbbc96c9,1,Will Berkeley,2016-11-02 18:15:54+00:00,['3a3f714e4df4ed1ddef5fdf7c55086d1dd0f4794'],1,91,92,946602,5,,,,1810
e6cb2ef74c6ea314cbb68e9318b516d1d204aa74,0,Todd Lipcon,2016-11-02 18:33:48+00:00,['e46e9518b12471efdd65e3a989e05d4ffbbc96c9'],4,29,33,946635,4,0,0.538461538,1,1810
d5d9afbfc7a7aef375494f2f2971d30312b82a20,0,Todd Lipcon,2016-11-02 20:31:20+00:00,['e6cb2ef74c6ea314cbb68e9318b516d1d204aa74'],10,94,104,946739,6,0,1,1,1810
bd4361254d5c360fc103e6d2a4433c6e369cf49b,1,Todd Lipcon,2016-11-02 21:39:13+00:00,['d5d9afbfc7a7aef375494f2f2971d30312b82a20'],122,1373,1495,948234,27,0.238636364,0.516233766,0.383116883,1816
de1b959296d982dd4ecee9d6c5d7fe8a177a63d2,0,Adar Dembo,2016-11-02 21:41:28+00:00,['bd4361254d5c360fc103e6d2a4433c6e369cf49b'],7,9,16,948250,1,,,,1816
059d1732a5709c1c251cca80703b4a2045e880b5,0,Todd Lipcon,2016-11-02 22:18:22+00:00,['de1b959296d982dd4ecee9d6c5d7fe8a177a63d2'],2,2,4,948254,1,,,,1816
4b61a3a4f2809286cc28c0b65bff3204339b3b94,0,Adar Dembo,2016-11-02 23:02:17+00:00,['059d1732a5709c1c251cca80703b4a2045e880b5'],0,1,1,948255,1,,,,1816
63059a9034fd9c08b973107a47d882b4640daaf8,0,Jean-Daniel Cryans,2016-11-03 16:32:32+00:00,['4b61a3a4f2809286cc28c0b65bff3204339b3b94'],12,14,26,948281,3,,,,1816
1f35e1eb507ec1bb0061497dde6c9798b35467c8,1,Mike Percy,2016-11-04 14:04:35+00:00,['63059a9034fd9c08b973107a47d882b4640daaf8'],240,270,510,948791,8,0,1,0.631578947,1816
a833a157314dceed9791727576db107c6449dd44,1,Adar Dembo,2016-11-04 19:26:26+00:00,['1f35e1eb507ec1bb0061497dde6c9798b35467c8'],63,52,115,948906,5,1,1,0,1816
43966599752830dcb584c1ee78263cae17c88ea0,0,Adar Dembo,2016-11-04 19:34:40+00:00,['a833a157314dceed9791727576db107c6449dd44'],1,1,2,948908,1,,,,1816
c44c6f3c6b99a881b04e13a5d58e13034c4a6e5a,0,Adar Dembo,2016-11-04 19:35:31+00:00,['43966599752830dcb584c1ee78263cae17c88ea0'],2,2,4,948912,1,,,,1816
0a397b2f7edf839decddbf7a89ff24386a028adb,1,Adar Dembo,2016-11-04 19:45:27+00:00,['c44c6f3c6b99a881b04e13a5d58e13034c4a6e5a'],45,38,83,948995,3,1,0.5,1,1816
abea8c69f786cc884c50be810a7eee7200caec03,1,Jean-Daniel Cryans,2016-11-04 19:46:35+00:00,['0a397b2f7edf839decddbf7a89ff24386a028adb'],63,124,187,949182,2,0.348837209,1,0.930232558,1816
ce80f4ebd09d04aeb7160fe7a0a33368a7b0cb1e,0,Adar Dembo,2016-11-04 20:08:18+00:00,['abea8c69f786cc884c50be810a7eee7200caec03'],13,18,31,949213,1,,,,1816
bdbee44e029b2ada382c09ccb63a522b6de66186,1,Jean-Daniel Cryans,2016-11-04 22:09:52+00:00,['ce80f4ebd09d04aeb7160fe7a0a33368a7b0cb1e'],35,387,422,949635,8,0.29015544,0.860103627,0.554404145,1818
c53d9694fab44068e131ca398458287f66b3abf0,0,Dan Burkert,2016-11-04 22:15:30+00:00,['bdbee44e029b2ada382c09ccb63a522b6de66186'],19,21,40,949675,2,,,,1818
19d6731ac62a4301c04d043f6adda7771b173d7b,0,Todd Lipcon,2016-11-04 22:43:39+00:00,['c53d9694fab44068e131ca398458287f66b3abf0'],1,1,2,949677,1,,,,1818
d4b1ea9d556953b20336f1060c51afaaaaf9b588,0,Jean-Daniel Cryans,2016-11-04 22:56:48+00:00,['19d6731ac62a4301c04d043f6adda7771b173d7b'],6,68,74,949751,2,0.416666667,1,1,1818
81f645c56e1aba2743c014c67a61b71208b057ae,0,Todd Lipcon,2016-11-04 23:18:01+00:00,['d4b1ea9d556953b20336f1060c51afaaaaf9b588'],4,12,16,949767,1,0,0,0,1818
c25aea49f2eca58b01c6b5b95bc6830b5c784a44,0,Will Berkeley,2016-11-05 14:30:15+00:00,['81f645c56e1aba2743c014c67a61b71208b057ae'],7,7,14,949781,7,,,,1818
13ffec6eae6f498b7c21ccdd2fdb66f53df07afb,0,Jean-Daniel Cryans,2016-11-07 19:59:21+00:00,['c25aea49f2eca58b01c6b5b95bc6830b5c784a44'],19,113,132,949913,4,1,1,1,1818
0f87b044e53a0eae062a28764154141097d3871e,1,Jean-Daniel Cryans,2016-11-07 20:02:29+00:00,['13ffec6eae6f498b7c21ccdd2fdb66f53df07afb'],11,174,185,950098,5,0.433333333,0.6,1,1818
8389f482b4a8eb8464781bda967537da608765a9,0,Jean-Daniel Cryans,2016-11-07 20:24:27+00:00,['0f87b044e53a0eae062a28764154141097d3871e'],50,87,137,950235,6,0,0,1,1818
46f52bcde47d48cecbe847f66718e3492488d569,0,Jean-Daniel Cryans,2016-11-07 20:40:36+00:00,['8389f482b4a8eb8464781bda967537da608765a9'],1,48,49,950284,2,1,1,1,1818
a97004a9117b9c46e20a1e34de77af7f9478fe74,1,Adar Dembo,2016-11-07 22:30:35+00:00,['46f52bcde47d48cecbe847f66718e3492488d569'],10,30,40,950324,5,0.75,1,1,1818
e85e44c78ee78e016f78584f7332d626875bfabb,1,Adar Dembo,2016-11-07 22:36:18+00:00,['a97004a9117b9c46e20a1e34de77af7f9478fe74'],69,136,205,950529,6,0.95,0.6,1,1818
fd34f45326d51df8338c0bcf79398a6e0167a19e,0,Todd Lipcon,2016-11-07 22:48:53+00:00,['e85e44c78ee78e016f78584f7332d626875bfabb'],1,14,15,950544,1,,,,1818
ae07d0dc4ebecdfd60f72d37f83eae02652f0eee,0,Alexey Serbin,2016-11-07 23:40:44+00:00,['fd34f45326d51df8338c0bcf79398a6e0167a19e'],1,7,8,950552,1,1,1,1,1818
123b9918c7005f65010c5d431f4e3cac459e7a31,0,Dan Burkert,2016-11-08 00:27:34+00:00,['ae07d0dc4ebecdfd60f72d37f83eae02652f0eee'],20,34,54,950606,6,0,,,1818
2adb3aeb1296a6d28063872eef60ffe4b70bd0af,0,Dan Burkert,2016-11-08 00:27:38+00:00,['123b9918c7005f65010c5d431f4e3cac459e7a31'],16,23,39,950645,1,,,,1818
25d2efb064291601d87f6d6f89daa3548bbee62f,1,Todd Lipcon,2016-11-08 01:19:49+00:00,['2adb3aeb1296a6d28063872eef60ffe4b70bd0af'],1,4,5,950650,1,,,,1818
f65924de7b2b707a5a248e63c202dcc8a4540837,0,Todd Lipcon,2016-11-08 02:07:23+00:00,['25d2efb064291601d87f6d6f89daa3548bbee62f'],86,129,215,950865,18,0.266666667,0.466666667,1,1818
c7090f9c00cbaf08ed871d40cd002fa7c70c96de,1,Todd Lipcon,2016-11-08 02:07:49+00:00,['f65924de7b2b707a5a248e63c202dcc8a4540837'],8,39,47,950912,3,0,0.571428571,0.571428571,1818
141de3377e6bdd95b8a455d262c00066f23bc021,0,Jean-Daniel Cryans,2016-11-08 16:53:48+00:00,['c7090f9c00cbaf08ed871d40cd002fa7c70c96de'],10,73,83,950995,9,0.676470588,0.117647059,1,1818
cf976a40e05389dd2f3de098835c09c50a7526b5,0,Todd Lipcon,2016-11-08 17:36:20+00:00,['141de3377e6bdd95b8a455d262c00066f23bc021'],175,119,294,951289,8,0.19047619,0.285714286,0,1818
cf757c12b8d65bbf33047dd0697de3c932d94096,0,Jordan Birdsell,2016-11-08 17:36:44+00:00,['cf976a40e05389dd2f3de098835c09c50a7526b5'],3,3,6,951295,1,,,,1818
ada18ac99b7f340317de43ea5382d04dc4a999e6,0,Jordan Birdsell,2016-11-08 17:44:09+00:00,['cf757c12b8d65bbf33047dd0697de3c932d94096'],1,13,14,951309,1,,,,1818
40628a5a862ee0b426bd4be70dab9f8d5bdc534b,0,Todd Lipcon,2016-11-08 18:48:41+00:00,['ada18ac99b7f340317de43ea5382d04dc4a999e6'],3,3,6,951315,1,,,,1818
20c5477919a44990b9063a6d86083b6f9ff6015b,0,Adar Dembo,2016-11-08 20:09:08+00:00,['40628a5a862ee0b426bd4be70dab9f8d5bdc534b'],3,2,5,951320,1,,,,1818
87c1a5f50395a1913348be3d72bff1465985a77d,0,Adar Dembo,2016-11-08 20:19:40+00:00,['20c5477919a44990b9063a6d86083b6f9ff6015b'],1,2,3,951323,1,,,,1818
2fc0e2e132a66e9bad93c9fcfea9e0c47261202a,0,Todd Lipcon,2016-11-08 23:12:56+00:00,['87c1a5f50395a1913348be3d72bff1465985a77d'],2,6,8,951331,1,1,1,1,1818
2fcbe1812459947cc09cb5dfb1ce640bccb3437b,0,Todd Lipcon,2016-11-08 23:22:08+00:00,['2fc0e2e132a66e9bad93c9fcfea9e0c47261202a'],1,2,3,951334,1,1,1,1,1818
9544ea0881f5c6379146068ddc33784bbd407bfe,0,David Ribeiro Alves,2016-11-08 23:36:54+00:00,['2fcbe1812459947cc09cb5dfb1ce640bccb3437b'],17,9,26,951360,2,0.5,0.5,0,1818
279b72916789d8aeb04740b7b081edb0595d4e92,0,Dan Burkert,2016-11-08 23:37:16+00:00,['9544ea0881f5c6379146068ddc33784bbd407bfe'],0,4,4,951364,1,,,,1818
3c68deacc05f6b5a9b82522baa38e046744b1815,0,David Ribeiro Alves,2016-11-08 23:38:14+00:00,['279b72916789d8aeb04740b7b081edb0595d4e92'],15,46,61,951425,3,0.470588235,0.470588235,1,1818
4a6493d4db30de9dffde8003c1d844320f1b00d2,1,Alexey Serbin,2016-11-08 23:41:25+00:00,['3c68deacc05f6b5a9b82522baa38e046744b1815'],65,456,521,951946,11,0.203125,0.9921875,0.95703125,1818
ef30f1d2d69350943d65ebd88389bea7af4ac045,0,David Ribeiro Alves,2016-11-09 01:00:55+00:00,['4a6493d4db30de9dffde8003c1d844320f1b00d2'],0,4,4,951950,1,1,1,1,1818
1b30c601aaac56f0393178a9799bd377fc8e33bc,0,Alexey Serbin,2016-11-09 01:27:11+00:00,['ef30f1d2d69350943d65ebd88389bea7af4ac045'],2,9,11,951961,1,,,,1818
e3a8f64b91a6783990f5d3f5ca0b1afc14d8022b,0,Adar Dembo,2016-11-09 07:39:55+00:00,['1b30c601aaac56f0393178a9799bd377fc8e33bc'],0,7,7,951968,1,,,,1818
5d57cd18df14d82712c77cef81ecaae7ae6c57c7,0,Jean-Daniel Cryans,2016-11-09 19:09:55+00:00,['e3a8f64b91a6783990f5d3f5ca0b1afc14d8022b'],1,20,21,951989,1,,,,1818
ac6311a09cba7492d59e39e974dccbcd43aec422,0,Adar Dembo,2016-11-09 20:01:12+00:00,['5d57cd18df14d82712c77cef81ecaae7ae6c57c7'],0,4,4,951993,1,,,,1818
10f525519f5f3efb47fe89af22c188247cd9e37d,1,Adar Dembo,2016-11-09 20:37:11+00:00,['ac6311a09cba7492d59e39e974dccbcd43aec422'],0,101,101,952094,4,,,,1819
29f1543cc62793c58ee6ba73a48089b6e2d49e7b,0,Jordan Birdsell,2016-11-09 20:43:21+00:00,['10f525519f5f3efb47fe89af22c188247cd9e37d'],0,6,6,952100,1,,,,1819
dbac80fd373c782d60f7dbb031832dc81f5024a2,0,David Ribeiro Alves,2016-11-09 22:28:24+00:00,['29f1543cc62793c58ee6ba73a48089b6e2d49e7b'],0,10,10,952110,1,,,,1819
388908c0d5f2fc810a92ccc3ab0adca17f79358e,0,Adar Dembo,2016-11-09 23:48:55+00:00,['dbac80fd373c782d60f7dbb031832dc81f5024a2'],0,1,1,952111,1,,,,1819
af9fc13cfc277faa0078b2502f4baa25fd0d9102,1,Adar Dembo,2016-11-09 23:48:59+00:00,['388908c0d5f2fc810a92ccc3ab0adca17f79358e'],8,29,37,952148,2,1,1,1,1819
6b60bfdd3e361e87a255938bcb58d930fe8fdcf4,0,Todd Lipcon,2016-11-10 04:48:18+00:00,['af9fc13cfc277faa0078b2502f4baa25fd0d9102'],0,29,29,952177,1,1,1,1,1819
b1b6c88e3e55fe2fe3eed9012425388d21bd92b4,0,Will Berkeley,2016-11-10 15:30:14+00:00,['6b60bfdd3e361e87a255938bcb58d930fe8fdcf4'],1,1,2,952179,1,,,,1819
ba2ae3de4a7c43ff2f5873e822410e066ea99667,1,Todd Lipcon,2016-11-10 17:06:33+00:00,['b1b6c88e3e55fe2fe3eed9012425388d21bd92b4'],41,416,457,952636,16,0.307692308,1,0.75,1823
ff7d5621d9a73f5dceb2326e59bdc1b2bcdcc5fa,0,David Ribeiro Alves,2016-11-10 18:47:31+00:00,['ba2ae3de4a7c43ff2f5873e822410e066ea99667'],29,24,53,952689,3,1,1,0.25,1823
e640f0ee26f696320421e5479309529b50ea50e8,0,David Ribeiro Alves,2016-11-10 18:47:37+00:00,['ff7d5621d9a73f5dceb2326e59bdc1b2bcdcc5fa'],13,29,42,952731,4,0.25,0.25,0,1823
9c8c08009be80d4ed3b37ca0b0b9f0345eaba7b6,0,David Ribeiro Alves,2016-11-10 18:49:36+00:00,['e640f0ee26f696320421e5479309529b50ea50e8'],6,6,12,952743,2,,,,1823
63fdc0c9f49e55ac043c9ba25e9b755b696d405d,0,Jordan Birdsell,2016-11-10 21:34:37+00:00,['9c8c08009be80d4ed3b37ca0b0b9f0345eaba7b6'],7,72,79,952822,1,,,,1823
1db453f5485ad0743f826a8cf21c7913e4c61751,1,Todd Lipcon,2016-11-11 01:49:23+00:00,['63fdc0c9f49e55ac043c9ba25e9b755b696d405d'],40,199,239,953061,8,0.102040816,0.183673469,0.959183673,1823
ed01e91aa3b3754984618f0e677a75fb640b6fa8,0,Todd Lipcon,2016-11-11 02:06:14+00:00,['1db453f5485ad0743f826a8cf21c7913e4c61751'],34,32,66,953127,2,1,1,1,1823
e1433ff6c29a3a8fab4843cf922e376f7faeb9e8,0,Todd Lipcon,2016-11-11 02:06:21+00:00,['ed01e91aa3b3754984618f0e677a75fb640b6fa8'],1,34,35,953162,2,0,1,1,1823
fec9b8879608c54a6b61d404d65bbd8798b917e7,1,Todd Lipcon,2016-11-11 05:02:23+00:00,['e1433ff6c29a3a8fab4843cf922e376f7faeb9e8'],42,393,435,953597,6,1,1,1,1823
88b02349d88d335caac18bf8b930eac6d327ed40,0,Alexey Serbin,2016-11-11 06:51:36+00:00,['fec9b8879608c54a6b61d404d65bbd8798b917e7'],19,115,134,953731,6,0.12,1,0.88,1823
cce47a635d015aa813f68182f57f89b76841c4bb,0,Will Berkeley,2016-11-14 15:55:35+00:00,['88b02349d88d335caac18bf8b930eac6d327ed40'],1,1,2,953733,1,,,,1823
8592efc5ffa4f69854e0133c9673317a24c932c5,0,Jean-Daniel Cryans,2016-11-14 16:04:25+00:00,['cce47a635d015aa813f68182f57f89b76841c4bb'],12,12,24,953757,11,,,,1823
ff0bbbcbdc0277411afcfc05416428a22ac488fc,0,Will Berkeley,2016-11-14 16:08:04+00:00,['8592efc5ffa4f69854e0133c9673317a24c932c5'],16,20,36,953793,1,,,,1823
08fb45fb37b0d991b1090d82b4e7b574088b5472,0,Alexey Serbin,2016-11-14 18:21:24+00:00,['ff0bbbcbdc0277411afcfc05416428a22ac488fc'],1,1,2,953795,1,,,,1823
fdde054b6acc8e98a42a1443687b339098a3e410,0,Dan Burkert,2016-11-14 19:31:55+00:00,['08fb45fb37b0d991b1090d82b4e7b574088b5472'],1,4,5,953800,1,,,,1823
7f4aaaf17158aeab2b348e8a8231d66c5ecdc1b1,0,Dan Burkert,2016-11-14 19:54:17+00:00,['fdde054b6acc8e98a42a1443687b339098a3e410'],1,3,4,953804,1,,,,1823
e0cfa7573ca200d1f016a3053598aa1e7b4290ac,0,Dan Burkert,2016-11-14 20:32:31+00:00,['7f4aaaf17158aeab2b348e8a8231d66c5ecdc1b1'],0,5,5,953809,1,,,,1823
637b6c226df213d2c29b69b2a0d55649c833dd36,1,Dan Burkert,2016-11-14 20:32:36+00:00,['e0cfa7573ca200d1f016a3053598aa1e7b4290ac'],27,46,73,953882,2,0,1,1,1823
3975c1d3dc6857c072c16ede91762d8be26f8770,0,Todd Lipcon,2016-11-14 22:43:57+00:00,['637b6c226df213d2c29b69b2a0d55649c833dd36'],0,18,18,953900,2,,,,1823
b46c4ecf9826de35a2a68d7a18a9dfc117cd7613,0,Todd Lipcon,2016-11-14 23:50:37+00:00,['3975c1d3dc6857c072c16ede91762d8be26f8770'],13,29,42,953942,1,,,,1823
c516e141255ce1de4eca8a3f6989440e2f4eda70,1,Adar Dembo,2016-11-15 03:10:15+00:00,['b46c4ecf9826de35a2a68d7a18a9dfc117cd7613'],230,101,331,954273,44,0.037037037,0,0.268518519,1823
23cbc63387c066eff513a5a7c3a66a01ff491e79,0,Jordan Birdsell,2016-11-15 03:24:45+00:00,['c516e141255ce1de4eca8a3f6989440e2f4eda70'],1,46,47,954320,2,,,,1823
866e861d0c81b4f0a92835bdd3000a1e61a38e3a,0,Todd Lipcon,2016-11-15 06:24:48+00:00,['23cbc63387c066eff513a5a7c3a66a01ff491e79'],2,2,4,954324,2,,,,1823
af14f44c84d09183838ed26e1e1fb132750773c0,0,Alexey Serbin,2016-11-15 19:03:17+00:00,['866e861d0c81b4f0a92835bdd3000a1e61a38e3a'],9,9,18,954342,5,,,,1823
11ae3171c5fa813c22635105df0a880c79bfcf3f,0,Jordan Birdsell,2016-11-15 20:40:26+00:00,['af14f44c84d09183838ed26e1e1fb132750773c0'],12,16,28,954370,2,1,1,1,1823
e05a82f5f02a0915d64609e6ac20166516b14108,0,Todd Lipcon,2016-11-15 22:54:49+00:00,['11ae3171c5fa813c22635105df0a880c79bfcf3f'],6,65,71,954441,6,0.115384615,0,1,1823
2cd07929ac773ca82f6a47e837f6ad0c4788fe75,1,Adar Dembo,2016-11-16 01:59:56+00:00,['e05a82f5f02a0915d64609e6ac20166516b14108'],61,57,118,954559,12,0.333333333,0,0,1823
583aa2247b664ad06b18a6bb472665f6fab4aab1,1,Adar Dembo,2016-11-16 01:59:59+00:00,['2cd07929ac773ca82f6a47e837f6ad0c4788fe75'],46,55,101,954660,5,0,0,0,1823
e836ac18df2ec2405a61aa7a9a90d61ee30716c5,0,Adar Dembo,2016-11-16 02:00:20+00:00,['583aa2247b664ad06b18a6bb472665f6fab4aab1'],11,11,22,954682,5,,,,1823
22067edb431e9ebf7317bf7821b90bb095f78f2c,1,Dan Burkert,2016-11-16 19:41:09+00:00,['e836ac18df2ec2405a61aa7a9a90d61ee30716c5'],1575,2416,3991,958673,183,0.073059361,0.223744292,0.826484018,1824
6be3f328a07c1748c4928e87e28b62e6b07c1e4d,0,Dan Burkert,2016-11-16 21:54:12+00:00,['22067edb431e9ebf7317bf7821b90bb095f78f2c'],58,690,748,959421,9,0.146341463,0.521064302,0.689578714,1826
895a4b766fafd7e661dff9c3427727b46ab51ffb,0,Dan Burkert,2016-11-17 00:16:45+00:00,['6be3f328a07c1748c4928e87e28b62e6b07c1e4d'],1,4,5,959426,1,0,1,1,1826
1bee345a14c84bc233312ee1515742b02535b4b9,0,Todd Lipcon,2016-11-17 18:00:32+00:00,['895a4b766fafd7e661dff9c3427727b46ab51ffb'],0,4,4,959430,1,,,,1826
85404f67bb7b25f0e2f4adc4b1903975d9c4aa5a,1,Adar Dembo,2016-11-17 19:31:52+00:00,['1bee345a14c84bc233312ee1515742b02535b4b9'],6,154,160,959590,3,0.08490566,0.386792453,0.716981132,1826
b1d02ee1a6b45745df9668af52c133580defda45,0,Dan Burkert,2016-11-17 21:12:00+00:00,['85404f67bb7b25f0e2f4adc4b1903975d9c4aa5a'],38,39,77,959667,11,0,0,0,1826
7a4fafe79da19c6838c96955fbb39276f5675bd4,0,Jordan Birdsell,2016-11-17 21:18:03+00:00,['b1d02ee1a6b45745df9668af52c133580defda45'],3,39,42,959709,2,0,0.709677419,0.709677419,1826
b9453a258711ff81d71c7435a0e2e949dbb16aa7,0,Dan Burkert,2016-11-18 01:58:29+00:00,['7a4fafe79da19c6838c96955fbb39276f5675bd4'],2,196,198,959907,2,0,1,1,1826
f2aeba6c059ea61f9cf8984d3e84d6c27b64d463,0,Todd Lipcon,2016-11-18 04:48:33+00:00,['b9453a258711ff81d71c7435a0e2e949dbb16aa7'],10,212,222,960129,5,0.672413793,0.637931034,1,1826
318b72c5328a9ebc0d46744334e19ea0a9a550ef,0,David Ribeiro Alves,2016-11-18 09:40:38+00:00,['f2aeba6c059ea61f9cf8984d3e84d6c27b64d463'],54,75,129,960258,9,0,1,1,1826
6a0ccdf3954011b69f285791247dba8c4b6adae0,0,Alexey Serbin,2016-11-18 22:41:52+00:00,['318b72c5328a9ebc0d46744334e19ea0a9a550ef'],0,401,401,960659,4,0.251207729,0.821256039,0.743961353,1827
06bb52d2acc6d311144aa905101ec5d846096611,0,David Ribeiro Alves,2016-11-19 17:45:13+00:00,['6a0ccdf3954011b69f285791247dba8c4b6adae0'],57,204,261,960920,9,0.037037037,0.805555556,0.694444444,1827
d8ce43893061e7571ac9ea5a2a10b481342ff633,0,Todd Lipcon,2016-11-20 17:45:27+00:00,['06bb52d2acc6d311144aa905101ec5d846096611'],1,1,2,960922,1,,,,1827
0233ceb6011c5c7cd3c267d68d0e821dd9e8fd1c,1,Todd Lipcon,2016-11-21 02:57:21+00:00,['d8ce43893061e7571ac9ea5a2a10b481342ff633'],233,290,523,961445,6,0.125,1,1,1827
fd81373177dbd159861df38b25ebec73d0efd0de,0,Jordan Birdsell,2016-11-21 03:17:31+00:00,['0233ceb6011c5c7cd3c267d68d0e821dd9e8fd1c'],26,28,54,961499,2,0,1,1,1827
01b1366e44766b61d9f562be004f0299d516b121,0,David Ribeiro Alves,2016-11-21 05:43:51+00:00,['fd81373177dbd159861df38b25ebec73d0efd0de'],13,13,26,961525,3,0,1,0,1827
949d1958f8754f4d27213d5f0a19fd6c02af7fcc,0,David Ribeiro Alves,2016-11-21 05:44:08+00:00,['01b1366e44766b61d9f562be004f0299d516b121'],96,72,168,961693,3,1,0,0,1827
92e426bf04fb154ec55108ee4e1df2d3463acdac,1,Todd Lipcon,2016-11-21 14:35:42+00:00,['949d1958f8754f4d27213d5f0a19fd6c02af7fcc'],3,6,9,961702,2,,,,1827
cb90d0b18c7a0aa76eb69903e64e3c2d999d8b80,1,Todd Lipcon,2016-11-21 15:21:20+00:00,['92e426bf04fb154ec55108ee4e1df2d3463acdac'],142,187,329,962031,23,,,,1827
b60508a93d25714f060b3e4e38affd8f19afd673,0,David Ribeiro Alves,2016-11-21 18:50:03+00:00,['cb90d0b18c7a0aa76eb69903e64e3c2d999d8b80'],0,3,3,962034,1,1,1,1,1827
ade9da7176bb6ab0a29c2c6a7a6abdeb3adee849,0,Alexey Serbin,2016-11-22 02:13:03+00:00,['b60508a93d25714f060b3e4e38affd8f19afd673'],4,6,10,962044,1,0,1,1,1827
ecf5f4c42589b1f3ca74f0e0eb01e7e7a09cab8f,0,Jean-Daniel Cryans,2016-11-22 19:53:26+00:00,['ade9da7176bb6ab0a29c2c6a7a6abdeb3adee849'],1,0,1,962045,1,1,1,0,1827
f10ab4a1d7ac0735890dcab6685a9fba7edac74e,0,Todd Lipcon,2016-11-23 00:48:48+00:00,['ecf5f4c42589b1f3ca74f0e0eb01e7e7a09cab8f'],12,178,190,962235,7,1,1,0.5,1829
d6dd01f98009c6918fb8d1c55415c55d51cd91f3,0,Todd Lipcon,2016-11-23 04:00:28+00:00,['f10ab4a1d7ac0735890dcab6685a9fba7edac74e'],1,1,2,962237,1,,,,1829
61d22e28f5f7eb490f4892e929ee2174c1dd78a1,0,Alexey Serbin,2016-11-23 18:22:35+00:00,['d6dd01f98009c6918fb8d1c55415c55d51cd91f3'],30,41,71,962308,1,0,0,1,1829
b3a3420af5bce6ec25ebcb6ed544456cbc3a988f,0,David Ribeiro Alves,2016-11-23 20:14:30+00:00,['61d22e28f5f7eb490f4892e929ee2174c1dd78a1'],26,201,227,962535,2,0.155172414,1,1,1829
71768bf465f42ff93cd26b631c445fb1c97151bc,0,David Ribeiro Alves,2016-11-23 20:14:37+00:00,['b3a3420af5bce6ec25ebcb6ed544456cbc3a988f'],7,79,86,962621,4,0,0.933333333,0.933333333,1829
805d1cf84fa8be5a1ea3d8569778757e17fce978,0,Adar Dembo,2016-11-23 21:19:11+00:00,['71768bf465f42ff93cd26b631c445fb1c97151bc'],1,1,2,962623,1,,,,1829
164368b2f407e0a3e2e9fe51d8b21475892e0c1d,0,Adar Dembo,2016-11-23 21:23:23+00:00,['805d1cf84fa8be5a1ea3d8569778757e17fce978'],10,0,10,962633,2,1,0,0,1829
0e7928037cd85047bfa26937e57d643ef8c0c00d,0,Todd Lipcon,2016-11-24 03:57:16+00:00,['164368b2f407e0a3e2e9fe51d8b21475892e0c1d'],0,6,6,962639,1,1,0,0,1829
60886a34f0a35088fb4e90caddbff7f905c0a53c,0,Todd Lipcon,2016-11-24 03:57:26+00:00,['0e7928037cd85047bfa26937e57d643ef8c0c00d'],0,5,5,962644,1,0,1,1,1829
25771c21f694461b6de535f7d1ab0eeedfc62f20,1,Mike Percy,2016-11-24 18:23:49+00:00,['60886a34f0a35088fb4e90caddbff7f905c0a53c'],38,36,74,962718,5,,,,1829
11fa207232cf2a4389919faa21c45ed4ebbcc2cb,0,Dan Burkert,2016-11-26 00:38:24+00:00,['25771c21f694461b6de535f7d1ab0eeedfc62f20'],4,33,37,962755,3,,,,1830
1f16eba632c8b8e538e318162bff98aeba0edfe3,0,Todd Lipcon,2016-11-28 18:14:19+00:00,['11fa207232cf2a4389919faa21c45ed4ebbcc2cb'],3,0,3,962758,1,,,,1830
c7b03722f6d11526905dc219c33e4f05645dd470,0,David Ribeiro Alves,2016-11-28 19:18:34+00:00,['1f16eba632c8b8e538e318162bff98aeba0edfe3'],0,6,6,962764,1,0,1,1,1830
0cb045574c2537257b002eefb16f585ddda4fa10,0,David Ribeiro Alves,2016-11-28 19:18:45+00:00,['c7b03722f6d11526905dc219c33e4f05645dd470'],2,3,5,962769,1,,,,1830
4c4c215ab1094f12156b0c05c220df920a832238,0,David Ribeiro Alves,2016-11-28 19:31:52+00:00,['0cb045574c2537257b002eefb16f585ddda4fa10'],6,3,9,962778,1,1,1,0,1830
8d29d107c411928307b0d559e8daa754119a0796,0,David Ribeiro Alves,2016-11-28 19:41:30+00:00,['4c4c215ab1094f12156b0c05c220df920a832238'],18,18,36,962814,1,,,,1830
dad80bd504bd7065c93721846df70086345ab68a,1,Dan Burkert,2016-11-28 19:57:18+00:00,['8d29d107c411928307b0d559e8daa754119a0796'],182,314,496,963310,12,0,1,0.222222222,1830
f0247724191d4a7f6b3ada8b961b96e0649cce8a,0,David Ribeiro Alves,2016-11-28 20:12:13+00:00,['dad80bd504bd7065c93721846df70086345ab68a'],4,4,8,963318,1,,,,1830
4cc48d887f690ab79feda69cf0986d8608067499,1,David Ribeiro Alves,2016-11-28 20:28:50+00:00,['f0247724191d4a7f6b3ada8b961b96e0649cce8a'],7,8,15,963333,2,0,0,0,1830
5abff6d75204573a85cdee907a9e1f462f345ecb,0,David Ribeiro Alves,2016-11-28 20:36:52+00:00,['4cc48d887f690ab79feda69cf0986d8608067499'],59,58,117,963450,4,0,0,0,1830
ac3cf12930d76f7ae5d3cdbc71baa3758705bd02,0,Todd Lipcon,2016-11-28 23:03:18+00:00,['5abff6d75204573a85cdee907a9e1f462f345ecb'],2,2,4,963454,1,,,,1830
e177ae8fc7ff3aacc5993a660479a0a706a4e840,0,Todd Lipcon,2016-11-28 23:03:36+00:00,['ac3cf12930d76f7ae5d3cdbc71baa3758705bd02'],62,2,64,963518,1,1,1,1,1830
04eeacddd0efb07eac7b07eaa3175f731a77fb51,0,Todd Lipcon,2016-11-28 23:07:14+00:00,['e177ae8fc7ff3aacc5993a660479a0a706a4e840'],178,12,190,963708,7,0,0,0.5,1830
88755e98d4692368639f563bcd1c02cfbd71178f,0,Adar Dembo,2016-11-28 23:39:39+00:00,['04eeacddd0efb07eac7b07eaa3175f731a77fb51'],12,167,179,963887,7,1,1,0.541666667,1832
1a0099f91e6409d80484e58eefe33d68f1891d83,0,David Ribeiro Alves,2016-11-29 01:46:54+00:00,['88755e98d4692368639f563bcd1c02cfbd71178f'],0,6,6,963893,1,1,1,1,1832
16ce5e02466a18e591672a84bc9a4bd6db7d00ea,0,Alexey Serbin,2016-11-29 02:23:50+00:00,['1a0099f91e6409d80484e58eefe33d68f1891d83'],6,64,70,963963,2,0.21875,0.8125,0.9375,1832
2f1a2a06d4fe719ef9f35338bc7403915517718a,0,Alexey Serbin,2016-11-29 03:19:28+00:00,['16ce5e02466a18e591672a84bc9a4bd6db7d00ea'],9,49,58,964021,3,0.08,0.8,0.92,1832
f2dac5d3cebd0ab462ff16ff4c42fe680b0feeef,0,Mike Percy,2016-11-29 20:03:47+00:00,['2f1a2a06d4fe719ef9f35338bc7403915517718a'],5,5,10,964031,5,,,,1832
a0f425f7636541422e97b39b89f9fe39e9dbd4f6,0,Mike Percy,2016-11-29 20:04:03+00:00,['f2dac5d3cebd0ab462ff16ff4c42fe680b0feeef'],12,5,17,964048,2,,,,1832
edf36ebe00b0c4e2da23386e8e92e36fdaae91d2,0,Adar Dembo,2016-11-29 21:38:53+00:00,['a0f425f7636541422e97b39b89f9fe39e9dbd4f6'],1,3,4,964052,1,,,,1832
447330c1d4ce5000ba44d8fea42d8d56e66c9c1e,0,Todd Lipcon,2016-11-29 21:45:58+00:00,['edf36ebe00b0c4e2da23386e8e92e36fdaae91d2'],3,3,6,964058,1,,,,1832
c19f3022556d7147407777169af29cc4238aa67d,0,Todd Lipcon,2016-11-29 21:48:08+00:00,['447330c1d4ce5000ba44d8fea42d8d56e66c9c1e'],20,20,40,964098,1,,,,1832
b8093f033504bb0cd2de94500a59225e61f5e7bd,0,David Ribeiro Alves,2016-11-29 21:53:56+00:00,['c19f3022556d7147407777169af29cc4238aa67d'],58,93,151,964249,7,0.411764706,0.588235294,0.882352941,1832
cc120dac79fe2d8e8f5b8656ad7d6ad0f29732cd,0,David Ribeiro Alves,2016-11-29 21:54:09+00:00,['b8093f033504bb0cd2de94500a59225e61f5e7bd'],294,196,490,964739,13,0,0,0,1832
b43c6c6d6a8ff4c672b1818c0051158e93c9302e,0,Todd Lipcon,2016-11-29 23:19:26+00:00,['cc120dac79fe2d8e8f5b8656ad7d6ad0f29732cd'],79,88,167,964906,2,0.142857143,0.214285714,0,1832
1e6d4adae2c5b0ed8f414d70636c8681ec89fb97,0,Todd Lipcon,2016-11-29 23:24:16+00:00,['b43c6c6d6a8ff4c672b1818c0051158e93c9302e'],48,60,108,965014,16,0.5,0.75,1,1832
3d3c6f03351b1b27d179229614516ed8a6513c86,1,Todd Lipcon,2016-11-30 00:09:23+00:00,['1e6d4adae2c5b0ed8f414d70636c8681ec89fb97'],11,49,60,965074,3,0.533333333,0.733333333,0.933333333,1832
5de4837b3eb666f0cf4f56903e9e449666e5be34,0,Todd Lipcon,2016-11-30 01:31:32+00:00,['3d3c6f03351b1b27d179229614516ed8a6513c86'],1,5,6,965080,1,0,1,1,1832
f441b45bfb6f34aec7757f3e0fb143c4f9063fe5,0,Adar Dembo,2016-11-30 02:19:56+00:00,['5de4837b3eb666f0cf4f56903e9e449666e5be34'],3,47,50,965130,3,0,0.909090909,0.909090909,1832
ca3b162e1beaba2309e3ed750ccc73489ad0d9d1,0,Adar Dembo,2016-11-30 02:28:49+00:00,['f441b45bfb6f34aec7757f3e0fb143c4f9063fe5'],26,10,36,965166,1,0,0,0,1832
8ff4d1211d2a9f20203774bd263112ec0d7333e1,0,Adar Dembo,2016-11-30 03:42:39+00:00,['ca3b162e1beaba2309e3ed750ccc73489ad0d9d1'],22,25,47,965213,10,0.333333333,1,0,1832
ecff49afb95de2cea37987797fe0c115920d2a41,0,David Ribeiro Alves,2016-11-30 10:14:19+00:00,['8ff4d1211d2a9f20203774bd263112ec0d7333e1'],62,185,247,965460,2,0.538461538,0.538461538,0.989010989,1832
abab2ced14c2166ca057573b78b738b0ebc113b2,0,David Ribeiro Alves,2016-11-30 10:14:29+00:00,['ecff49afb95de2cea37987797fe0c115920d2a41'],131,631,762,966222,8,0.20668693,0.541033435,0.689969605,1832
10f2ce208fd646c6d2db0f8277ab0342b52cd080,1,David Ribeiro Alves,2016-11-30 10:14:38+00:00,['abab2ced14c2166ca057573b78b738b0ebc113b2'],48,206,254,966476,3,0.032,0.032,0.576,1832
6f423302d18460355f6b6111ba283a54ca2d9faa,0,David Ribeiro Alves,2016-11-30 10:14:48+00:00,['10f2ce208fd646c6d2db0f8277ab0342b52cd080'],37,121,158,966634,1,0.057142857,0.157142857,1,1832
eb4b46b800a92d4964e5d0eaec4a4fd011463901,0,Todd Lipcon,2016-11-30 17:06:35+00:00,['6f423302d18460355f6b6111ba283a54ca2d9faa'],22,19,41,966675,9,1,0,0,1832
d74888c56d175b37f2b3c1ac90d28607653bc023,0,Dan Burkert,2016-11-30 17:25:54+00:00,['eb4b46b800a92d4964e5d0eaec4a4fd011463901'],44,137,181,966856,4,0,0.539325843,0.539325843,1832
835cf6c1e38175c0bb019e62a294ed2bd9dc8102,0,Dan Burkert,2016-11-30 17:25:59+00:00,['d74888c56d175b37f2b3c1ac90d28607653bc023'],12,184,196,967052,5,0.28313253,0.897590361,1,1832
2b5ad4a9b7a98cd3bb618f90572e504ff192f246,0,Todd Lipcon,2016-11-30 17:33:11+00:00,['835cf6c1e38175c0bb019e62a294ed2bd9dc8102'],629,14,643,967695,11,0.472789116,0.397959184,0.017006803,1832
c553a9a59ce664c38041fbb3809ab6402cdbc89b,1,Todd Lipcon,2016-11-30 18:38:54+00:00,['2b5ad4a9b7a98cd3bb618f90572e504ff192f246'],15,62,77,967772,8,0.344827586,0.620689655,0.827586207,1832
885d2e90a8c9e5ceb8ff330478a8b08c7ba3b2a0,0,Todd Lipcon,2016-11-30 20:50:26+00:00,['c553a9a59ce664c38041fbb3809ab6402cdbc89b'],4,50,54,967826,2,0,1,1,1832
85245160b73055b548f8a0b79be1786212cc6afb,0,Todd Lipcon,2016-11-30 21:21:46+00:00,['885d2e90a8c9e5ceb8ff330478a8b08c7ba3b2a0'],0,7,7,967833,1,,,,1832
4aacaf6fc57b26195634c09c0433a24f5d4a778e,1,Todd Lipcon,2016-11-30 21:24:01+00:00,['85245160b73055b548f8a0b79be1786212cc6afb'],12,92,104,967937,2,0.173913043,0.869565217,1,1832
b4764f98cc99a8b4f37e0be2c1ad90dc3c645903,1,Todd Lipcon,2016-11-30 21:31:18+00:00,['4aacaf6fc57b26195634c09c0433a24f5d4a778e'],14,66,80,968017,5,0,0.772727273,1,1832
68dc1ffeff2f6ad7ad8654da0df66162cb286cca,0,Alexey Serbin,2016-11-30 21:33:27+00:00,['b4764f98cc99a8b4f37e0be2c1ad90dc3c645903'],4,107,111,968128,1,0,1,1,1832
d81aa80a98bcec4b928e4a50c3c0a95f09bb57af,0,Alexey Serbin,2016-11-30 21:33:34+00:00,['68dc1ffeff2f6ad7ad8654da0df66162cb286cca'],8,86,94,968222,5,0,0.965517241,0.982758621,1832
eb1f45404745d30a5de62eda407862b701c7fb26,0,Alexey Serbin,2016-11-30 22:34:17+00:00,['d81aa80a98bcec4b928e4a50c3c0a95f09bb57af'],0,80,80,968302,1,0,1,1,1832
e4f7e926c4205ffec04b651afc178bd0b447a9ae,0,David Ribeiro Alves,2016-11-30 22:53:27+00:00,['eb1f45404745d30a5de62eda407862b701c7fb26'],4,11,15,968317,2,0,0,0.2,1832
b39491de611eb7a36be46816c66fa3a85590a656,0,Todd Lipcon,2016-12-01 01:14:03+00:00,['e4f7e926c4205ffec04b651afc178bd0b447a9ae'],35,52,87,968404,6,0,0,0,1832
730bae3b5828875dab818eac191f526ec61b6424,0,Todd Lipcon,2016-12-01 01:48:19+00:00,['b39491de611eb7a36be46816c66fa3a85590a656'],2,5,7,968411,1,0,1,1,1832
c52cc1630d76c123619e40578b82cb2c7e8560c9,0,Todd Lipcon,2016-12-01 01:48:24+00:00,['730bae3b5828875dab818eac191f526ec61b6424'],17,35,52,968463,2,0.764705882,0.882352941,1,1832
8ffc6d1843fefe0b5f932ed4c00b086355b05cad,1,Adar Dembo,2016-12-01 02:58:50+00:00,['c52cc1630d76c123619e40578b82cb2c7e8560c9'],1,5,6,968469,3,1,1,1,1832
016ae9c23c28ea5a690247c85d1f680d87a1b8c9,0,Mike Percy,2016-12-01 14:12:58+00:00,['8ffc6d1843fefe0b5f932ed4c00b086355b05cad'],0,16,16,968485,4,,,,1832
b0209c16d2f1c328c7412e0d749ee4227cfa730c,0,Mike Percy,2016-12-01 16:43:50+00:00,['016ae9c23c28ea5a690247c85d1f680d87a1b8c9'],3,41,44,968529,2,0.6,0.933333333,0.666666667,1832
b30d4fc154151aaa5583dbbd8ef83ac044236ee9,1,Todd Lipcon,2016-12-01 18:50:14+00:00,['b0209c16d2f1c328c7412e0d749ee4227cfa730c'],59,225,284,968813,6,0.191304348,0.8,1,1832
f165ef7d653137d29efea01d991945d65bef16d8,1,Dan Burkert,2016-12-01 22:46:56+00:00,['b30d4fc154151aaa5583dbbd8ef83ac044236ee9'],430,465,895,969708,25,1,1,1,1832
b28c6dd683bfeddde0876ddb6b228395e0763798,0,Todd Lipcon,2016-12-01 22:48:56+00:00,['f165ef7d653137d29efea01d991945d65bef16d8'],15,43,58,969766,2,0,0,1,1832
648d69e7e16a54b7ab38c3242732a7fd03e07e74,0,Adar Dembo,2016-12-01 23:50:26+00:00,['b28c6dd683bfeddde0876ddb6b228395e0763798'],29,28,57,969823,3,,,,1832
06569f218675893948e61b427d7ffe9155c7fffa,1,Mike Percy,2016-12-01 23:51:13+00:00,['648d69e7e16a54b7ab38c3242732a7fd03e07e74'],2,26,28,969851,2,0.25,0.875,0.875,1832
388dd2955f5995e265a4d2ee4ba9bb339338c8e7,0,Todd Lipcon,2016-12-02 01:17:43+00:00,['06569f218675893948e61b427d7ffe9155c7fffa'],15,2,17,969868,2,1,0,0,1832
6be01642b25ecf7c407238537b51014a66a4f61f,1,Mike Percy,2016-12-02 13:15:00+00:00,['388dd2955f5995e265a4d2ee4ba9bb339338c8e7'],53,144,197,970065,2,0,0.641791045,0.641791045,1832
a6c17552ae7b1a591d0b8760c5a4530c15690680,0,Mike Percy,2016-12-02 17:23:29+00:00,['6be01642b25ecf7c407238537b51014a66a4f61f'],24,7,31,970096,1,,,,1832
5813f2d8f115eb69d210f1021ab4442d26eaec19,0,Alexey Serbin,2016-12-02 17:29:10+00:00,['a6c17552ae7b1a591d0b8760c5a4530c15690680'],6,3,9,970105,2,0,0,0,1832
fd7048e21211bb76b215572231245125e6b48c75,0,Mike Percy,2016-12-02 18:40:54+00:00,['5813f2d8f115eb69d210f1021ab4442d26eaec19'],1,1,2,970107,1,1,1,1,1832
b15c0f6e3fe0550da07a6665f17415acec0bb042,1,Todd Lipcon,2016-12-02 19:01:30+00:00,['fd7048e21211bb76b215572231245125e6b48c75'],34,155,189,970296,8,0.189189189,1,0.783783784,1832
7cb65591e18dd6394272d8cca4d653b49d6dd4b9,0,Adar Dembo,2016-12-02 21:37:17+00:00,['b15c0f6e3fe0550da07a6665f17415acec0bb042'],3,3,6,970302,1,1,1,0,1832
60aa54e21b715a4e7a1931570c9736a2c7f211c6,0,Adar Dembo,2016-12-02 21:42:08+00:00,['7cb65591e18dd6394272d8cca4d653b49d6dd4b9'],14,206,220,970522,9,0.370786517,1,1,1832
8b99141006770131ede015a546aa3bfe6ca752f9,0,David Ribeiro Alves,2016-12-02 23:40:33+00:00,['60aa54e21b715a4e7a1931570c9736a2c7f211c6'],12,23,35,970557,3,1,1,1,1832
fffe5765543d36ea9b62b52b7b657dd2c7f787fd,0,David Ribeiro Alves,2016-12-03 01:25:20+00:00,['8b99141006770131ede015a546aa3bfe6ca752f9'],7,31,38,970595,4,1,1,1,1832
7e3071e3ce92aa15ea4f21d891e1e366ff421b4e,0,David Ribeiro Alves,2016-12-03 01:25:35+00:00,['fffe5765543d36ea9b62b52b7b657dd2c7f787fd'],2,3,5,970600,2,0,0,1,1832
44579480490279ae0b7edbf6511f2b99b563e63b,1,David Ribeiro Alves,2016-12-03 01:57:39+00:00,['7e3071e3ce92aa15ea4f21d891e1e366ff421b4e'],2,72,74,970674,1,0.130434783,1,0.695652174,1832
02a96c7904801ecd8be088f44863d68fb9989fb2,0,David Ribeiro Alves,2016-12-04 05:33:18+00:00,['44579480490279ae0b7edbf6511f2b99b563e63b'],75,126,201,970875,2,1,1,0.909090909,1832
f9e5993c9390d56700d7ae29d418035b152f6858,0,David Ribeiro Alves,2016-12-04 05:33:32+00:00,['02a96c7904801ecd8be088f44863d68fb9989fb2'],40,60,100,970975,5,1,1,1,1832
80ac8bae335b490c7b75351e6d4c321a58183c73,0,Todd Lipcon,2016-12-05 01:57:10+00:00,['f9e5993c9390d56700d7ae29d418035b152f6858'],31,90,121,971096,8,0,1,0.103448276,1832
f0c27b5aa0616be8dd4db30a0682eab0a6218f51,1,Todd Lipcon,2016-12-05 04:51:19+00:00,['80ac8bae335b490c7b75351e6d4c321a58183c73'],17,22,39,971135,3,0,0,0,1832
47c25ceae1ad2a35bc30bfa94dc16d88c1a10035,0,Todd Lipcon,2016-12-05 04:51:45+00:00,['f0c27b5aa0616be8dd4db30a0682eab0a6218f51'],1,2,3,971138,1,0,1,1,1832
a6cf13f4a3d448fff0cd049cf18196c20696d940,0,Todd Lipcon,2016-12-05 07:04:28+00:00,['47c25ceae1ad2a35bc30bfa94dc16d88c1a10035'],7,5,12,971150,1,0,0,0,1832
0ac14a564157de2968dbd97a5cc560e427f2d8d6,0,Todd Lipcon,2016-12-05 07:04:39+00:00,['a6cf13f4a3d448fff0cd049cf18196c20696d940'],3,3,6,971156,1,,,,1832
0a898331120aabd37c82a18259dc498f27a6527a,0,Todd Lipcon,2016-12-05 14:20:14+00:00,['0ac14a564157de2968dbd97a5cc560e427f2d8d6'],12,23,35,971191,1,0,0.5,1,1832
916c21be1846effb5325614f278eb4ace23f7f37,0,Adar Dembo,2016-12-05 17:32:38+00:00,['0a898331120aabd37c82a18259dc498f27a6527a'],2,2,4,971195,1,,,,1832
85b86d12c7ee1238a23f7745bb477b66b000a236,0,Adar Dembo,2016-12-05 17:34:10+00:00,['916c21be1846effb5325614f278eb4ace23f7f37'],2,461,463,971658,6,0.544378698,0.846153846,0.834319527,1834
4a8c86b409367df27a743920b74cd93a54c499d2,0,Adar Dembo,2016-12-05 17:34:50+00:00,['85b86d12c7ee1238a23f7745bb477b66b000a236'],1,4,5,971663,1,,,,1834
e14b82496da992c40af3fbf2c24a97f38b1d96cc,0,Mike Percy,2016-12-05 17:39:32+00:00,['4a8c86b409367df27a743920b74cd93a54c499d2'],1,1,2,971665,1,,,,1834
5924a74629ff9b121cd1fdf29761cb5981db9945,0,Mike Percy,2016-12-05 18:08:31+00:00,['e14b82496da992c40af3fbf2c24a97f38b1d96cc'],15,37,52,971717,1,1,1,1,1834
13966917ef1b4562061150b523c861512830f4a9,0,Alexey Serbin,2016-12-05 22:18:15+00:00,['5924a74629ff9b121cd1fdf29761cb5981db9945'],1,1,2,971719,1,,,,1834
25d6a49901fd61e004a8943c2c8d28484418a6b1,0,Adar Dembo,2016-12-05 23:25:32+00:00,['13966917ef1b4562061150b523c861512830f4a9'],11,11,22,971741,5,,,,1834
82644176bc6640f10a256a786c2349d5aafbd327,0,Dan Burkert,2016-12-06 01:21:00+00:00,['25d6a49901fd61e004a8943c2c8d28484418a6b1'],0,57,57,971798,3,0,1,1,1834
44c73d5b685b43f7dc938eb7196127ff3c397970,0,Dan Burkert,2016-12-06 01:21:05+00:00,['82644176bc6640f10a256a786c2349d5aafbd327'],8,46,54,971852,4,1,1,1,1834
e98e4b6d826c8a76d532e85e254981ba5298e991,0,Todd Lipcon,2016-12-06 01:53:54+00:00,['44c73d5b685b43f7dc938eb7196127ff3c397970'],93,102,195,972047,2,0,0,1,1834
35d1b014251bb541f9cb8f87ea27098e4b89c79f,1,Dan Burkert,2016-12-06 04:45:42+00:00,['e98e4b6d826c8a76d532e85e254981ba5298e991'],65,291,356,972403,9,0.49122807,0.175438596,0.815789474,1835
bacd946731f07a5fc390c26b3285e7560b8ef497,0,David Ribeiro Alves,2016-12-06 07:45:39+00:00,['35d1b014251bb541f9cb8f87ea27098e4b89c79f'],0,634,634,973037,4,0.459227468,0.871244635,1,1838
881cc8e981dbe51ba21fffdb575abd3cf8fe3e5e,0,Mike Percy,2016-12-06 14:39:40+00:00,['bacd946731f07a5fc390c26b3285e7560b8ef497'],4,9,13,973050,1,0,0,0,1838
7959c7af7032249755c9331892330f59e6b89faf,1,Mike Percy,2016-12-06 17:02:02+00:00,['881cc8e981dbe51ba21fffdb575abd3cf8fe3e5e'],54,111,165,973215,7,0,1,0.666666667,1839
4201d370ab599f9741b10ab543468335a6b876bf,0,Dan Burkert,2016-12-06 17:03:37+00:00,['7959c7af7032249755c9331892330f59e6b89faf'],5,5,10,973225,3,,,,1839
3af7ee27b1336c0e075e40d61a4486ccddd34cd1,0,David Ribeiro Alves,2016-12-06 17:32:15+00:00,['4201d370ab599f9741b10ab543468335a6b876bf'],0,1,1,973226,1,1,1,1,1839
8877b83d5916ef2bfbc8168793af8a17b25f80d4,1,Adar Dembo,2016-12-06 18:37:46+00:00,['3af7ee27b1336c0e075e40d61a4486ccddd34cd1'],0,15,15,973241,2,1,1,0.909090909,1839
aaca775da7f5e9d191627159417695848285790d,1,Adar Dembo,2016-12-06 18:38:19+00:00,['8877b83d5916ef2bfbc8168793af8a17b25f80d4'],7,9,16,973257,2,0,0,1,1839
2453a67310f62c01216e5a0ed08f192a08adc005,0,Adar Dembo,2016-12-06 23:49:49+00:00,['aaca775da7f5e9d191627159417695848285790d'],26,41,67,973324,2,0,0,0.5,1839
ead37caf3e6fc2b01346198176c21a19d2cf6224,1,Mike Percy,2016-12-07 16:02:05+00:00,['2453a67310f62c01216e5a0ed08f192a08adc005'],9,71,80,973404,4,0,0,1,1839
7bd9bac670da27a526b5746f7b89f4d3808af986,0,Mike Percy,2016-12-07 16:02:44+00:00,['ead37caf3e6fc2b01346198176c21a19d2cf6224'],1,1,2,973406,1,,,,1839
75b1c1578ec6503e02b934a9058f08a1f63e3b4f,0,Jean-Daniel Cryans,2016-12-07 16:40:52+00:00,['7bd9bac670da27a526b5746f7b89f4d3808af986'],21,86,107,973513,3,0.125,1,1,1839
93649c46933980ee2dfccb45a99f0a608da8fbe1,0,Jean-Daniel Cryans,2016-12-07 16:43:05+00:00,['75b1c1578ec6503e02b934a9058f08a1f63e3b4f'],1,1,2,973515,1,,,,1839
4d2c46f236562f0631ce5c6020431e0f93a5f55a,0,Dan Burkert,2016-12-07 09:51:56-08:00,['81157cc5e952134faf3192a0b51d6ca210e51228'],52,22,74,973589,4,1,0,0,1839
bd72a38cd144a8beb1b1a320010c19adb9ca1eee,0,Dan Burkert,2016-12-07 19:48:48+00:00,['93649c46933980ee2dfccb45a99f0a608da8fbe1'],4,329,333,973922,3,0,0.013157895,0.973684211,1839
a70c9050069863cf64a1db9ab5ab6da3de4e0504,0,Dan Burkert,2016-12-07 19:49:08+00:00,['bd72a38cd144a8beb1b1a320010c19adb9ca1eee'],5,5,10,973932,4,,,,1839
6a124f040c8ee2797b3a45c88f4a2a56176ca339,1,Adar Dembo,2016-12-07 21:15:01+00:00,['a70c9050069863cf64a1db9ab5ab6da3de4e0504'],4,1628,1632,975564,10,0.44598338,0.849030471,0.873961219,1844
3fa9db761e35210a9e83b0be279bc44c95f6ccbf,1,Adar Dembo,2016-12-07 21:46:29+00:00,['6a124f040c8ee2797b3a45c88f4a2a56176ca339'],121,317,438,976002,13,0.085106383,1,0.723404255,1844
1e957ae61eee748b53cd6e3d630ac7fb3abf4744,0,Mike Percy,2016-12-08 00:17:16+00:00,['3fa9db761e35210a9e83b0be279bc44c95f6ccbf'],21,214,235,976237,6,0.054945055,0.813186813,0.615384615,1845
b4d1fac808059ec72258a65c09955a56cdc78c66,0,Adar Dembo,2016-12-08 00:22:25+00:00,['1e957ae61eee748b53cd6e3d630ac7fb3abf4744'],5,8,13,976250,2,0,1,1,1845
e16a541aedc171eadb738e969a48852ba9ed2909,0,Dan Burkert,2016-12-08 00:42:45+00:00,['b4d1fac808059ec72258a65c09955a56cdc78c66'],94,914,1008,977258,19,0.184482759,0.639655172,0.967241379,1845
b61bd02beb6c286e086a14bb1e3abe487fde81f7,0,Dan Burkert,2016-12-08 00:45:08+00:00,['e16a541aedc171eadb738e969a48852ba9ed2909'],1,2,3,977261,1,1,1,1,1845
2bf0e396169d8079080da8dbc50afc7bce77b3af,0,Todd Lipcon,2016-12-08 03:09:56+00:00,['b61bd02beb6c286e086a14bb1e3abe487fde81f7'],0,4,4,977265,1,,,,1845
2acf1bacfb0d90978dd8ac41e25fa1e5f0384485,1,Todd Lipcon,2016-12-08 03:27:43+00:00,['2bf0e396169d8079080da8dbc50afc7bce77b3af'],0,5,5,977270,1,,,,1845
bec5f9b34fb773a230c72f0a7fe2b988078933d8,1,Todd Lipcon,2016-12-08 03:41:20+00:00,['2acf1bacfb0d90978dd8ac41e25fa1e5f0384485'],89,341,430,977700,10,0.35971223,0.956834532,0.964028777,1845
85de6862204d79b30ea3684a276d00a32651937c,0,Todd Lipcon,2016-12-08 03:41:32+00:00,['bec5f9b34fb773a230c72f0a7fe2b988078933d8'],2,5,7,977707,1,0,0,1,1845
1b3eeb3c7b733e0432daea7bf04fa8253de9b15f,1,Todd Lipcon,2016-12-08 03:50:55+00:00,['85de6862204d79b30ea3684a276d00a32651937c'],2,4,6,977713,2,,,,1845
faa587c639aa9e5dcf3fac04259f46ba1921140a,1,Todd Lipcon,2016-12-08 04:07:39+00:00,['1b3eeb3c7b733e0432daea7bf04fa8253de9b15f'],63,242,305,978018,6,0,0.130841121,0.728971963,1845
db4d0a653caea6f9be47072555c70ba601d6004b,0,Todd Lipcon,2016-12-08 04:09:55+00:00,['faa587c639aa9e5dcf3fac04259f46ba1921140a'],15,16,31,978049,1,,,,1845
cbe80ea81b319616df4054094afe990a6f32c5ba,0,Jean-Daniel Cryans,2016-12-08 04:31:05+00:00,['db4d0a653caea6f9be47072555c70ba601d6004b'],4,4,8,978057,1,,,,1845
4d8fe6cf2a1804bae142ddfb5e672af37dad036e,1,David Ribeiro Alves,2016-12-08 05:17:57+00:00,['cbe80ea81b319616df4054094afe990a6f32c5ba'],275,592,867,978924,41,0.447058824,0.729411765,0.647058824,1845
839bd6f9abe3dedf439628e80fd7111763c11b52,0,Mike Percy,2016-12-08 15:49:41+00:00,['4d8fe6cf2a1804bae142ddfb5e672af37dad036e'],15,15,30,978954,1,,,,1845
fe4f157b1348d24a215a9e8135c9b94ed0128e71,1,Jean-Daniel Cryans,2016-12-08 16:53:46+00:00,['839bd6f9abe3dedf439628e80fd7111763c11b52'],914,94,1008,979962,19,0.815517241,0.360344828,0.032758621,1845
2c43f95963c19ed56f2d0857d5cbae17a6932f06,0,Mike Percy,2016-12-08 17:25:15+00:00,['fe4f157b1348d24a215a9e8135c9b94ed0128e71'],6,19,25,979987,2,0.307692308,0.769230769,0.769230769,1845
65695a30345913d69fec7ef777d990e549719e09,0,Adar Dembo,2016-12-08 22:24:26+00:00,['2c43f95963c19ed56f2d0857d5cbae17a6932f06'],11,322,333,980320,6,0.384615385,0.816568047,0.982248521,1845
98548571b0050be3b4fcfa979d7f129d21b5b78b,0,Todd Lipcon,2016-12-08 23:34:59+00:00,['65695a30345913d69fec7ef777d990e549719e09'],2,8,10,980330,1,0,1,1,1845
e1acdfba66913819f9c5d604ad5449e1eca83766,1,Todd Lipcon,2016-12-08 23:38:14+00:00,['98548571b0050be3b4fcfa979d7f129d21b5b78b'],27,34,61,980391,4,0,0,0,1845
f17562fd0aa31dc61d6fe6ea877de5cd54f95c41,0,Todd Lipcon,2016-12-08 23:46:40+00:00,['e1acdfba66913819f9c5d604ad5449e1eca83766'],1,1,2,980393,1,,,,1845
18a8a90f765dffde08165bc2aea2921a008ae351,0,Dan Burkert,2016-12-09 00:00:15+00:00,['f17562fd0aa31dc61d6fe6ea877de5cd54f95c41'],3,92,95,980488,3,0,1,1,1846
0f6562723a4d69f45a78f0ed2859abbc5f447d06,0,Todd Lipcon,2016-12-09 00:03:10+00:00,['18a8a90f765dffde08165bc2aea2921a008ae351'],1,4,5,980493,1,0,1,1,1846
a69e390a6370dd7118c918fe366b27038971e991,1,Alexey Serbin,2016-12-09 00:03:47+00:00,['0f6562723a4d69f45a78f0ed2859abbc5f447d06'],32,182,214,980707,3,0.052631579,0.063157895,1,1846
4bd36c46cdd1ff9c337baadbb05edd2a5f87b94e,1,Todd Lipcon,2016-12-09 00:13:29+00:00,['a69e390a6370dd7118c918fe366b27038971e991'],37,56,93,980800,9,0,1,1,1846
4b4329909c39a69f1d9f7b8a0132d34f83a08a7e,0,Alexey Serbin,2016-12-09 00:37:37+00:00,['4bd36c46cdd1ff9c337baadbb05edd2a5f87b94e'],16,30,46,980846,2,0,0,0,1846
8195e5b375fa515dda53705fe8155b33f97ca464,0,Mike Percy,2016-12-09 14:30:26+00:00,['4b4329909c39a69f1d9f7b8a0132d34f83a08a7e'],12,12,24,980870,11,,,,1846
8a7871c47897d801d7be2697a28c2ff006a696ee,1,Mike Percy,2016-12-09 19:57:27+00:00,['8195e5b375fa515dda53705fe8155b33f97ca464'],41,89,130,981000,5,0,1,0.954545455,1846
2161005fbc47845ee8e4d211a514318b8b194b24,0,Dan Burkert,2016-12-09 22:03:38+00:00,['8a7871c47897d801d7be2697a28c2ff006a696ee'],2,2,4,981004,1,,,,1846
a991e426f0e3396af1685286ca63cf71c0b176b4,0,Adar Dembo,2016-12-09 22:42:32+00:00,['2161005fbc47845ee8e4d211a514318b8b194b24'],1,0,1,981005,1,1,0,0,1846
8e1a8c550408bbd9c580d2dfe6fb22ce8e8c958c,0,Dan Burkert,2016-12-09 23:00:57+00:00,['a991e426f0e3396af1685286ca63cf71c0b176b4'],0,24,24,981029,2,0,1,1,1846
251860b36fae96807c625f54d96c67e578685ab4,0,Jean-Daniel Cryans,2016-12-09 23:34:26+00:00,['8e1a8c550408bbd9c580d2dfe6fb22ce8e8c958c'],15,23,38,981067,1,,,,1846
e018a837ce4808dfeb828ed3ac268fa4cac93a8f,0,Dan Burkert,2016-12-10 00:35:24+00:00,['251860b36fae96807c625f54d96c67e578685ab4'],60,71,131,981198,1,1,1,1,1846
2d74f7c062f6795c6be811d8c8bb9ed17f0240d1,0,Todd Lipcon,2016-12-11 14:56:00+00:00,['e018a837ce4808dfeb828ed3ac268fa4cac93a8f'],2,21,23,981221,1,0,0.166666667,1,1846
47905c7e985d0895af3eb16d41247bc1ed81e18f,0,Todd Lipcon,2016-12-12 01:53:36+00:00,['2d74f7c062f6795c6be811d8c8bb9ed17f0240d1'],5,0,5,981226,1,,,,1846
28a07bf7a3055ebdc526abb176458ba9145959dc,0,Todd Lipcon,2016-12-12 04:39:12+00:00,['47905c7e985d0895af3eb16d41247bc1ed81e18f'],57,3,60,981286,1,1,0,0.457142857,1846
88745f32ca5ba69041170173ecede34c2ed85a39,0,Todd Lipcon,2016-12-12 04:39:21+00:00,['28a07bf7a3055ebdc526abb176458ba9145959dc'],3,8,11,981297,1,0,1,1,1846
770f8e134a2d4d38619ee15505474a742607247f,0,Todd Lipcon,2016-12-12 04:49:48+00:00,['88745f32ca5ba69041170173ecede34c2ed85a39'],6,13,19,981316,1,0,0,1,1846
2eba7b8846dba70577483f2df1baf0813564383a,0,Todd Lipcon,2016-12-12 04:50:32+00:00,['770f8e134a2d4d38619ee15505474a742607247f'],2,2,4,981320,2,,,,1846
2e403f232af835e51107c20883678306e169f90d,0,Todd Lipcon,2016-12-12 06:55:26+00:00,['2eba7b8846dba70577483f2df1baf0813564383a'],7,49,56,981376,5,0.59375,0.65625,0.6875,1846
244c6feaed418a4d38eca3d328db4d77d7552471,0,Todd Lipcon,2016-12-12 06:57:40+00:00,['2e403f232af835e51107c20883678306e169f90d'],2,2,4,981380,1,,,,1846
305b8c96e5fdad1ab14881e77f88900a0bb2b174,0,Mike Percy,2016-12-12 12:45:41+00:00,['244c6feaed418a4d38eca3d328db4d77d7552471'],1,1,2,981382,1,,,,1846
ee4672bbe0ec3544070d0bb48cd24ae9516be633,0,Mike Percy,2016-12-12 12:46:04+00:00,['305b8c96e5fdad1ab14881e77f88900a0bb2b174'],1,1,2,981384,1,,,,1846
6f7df3513c38023906fe744616ac2dacd9ef0524,0,Dan Burkert,2016-12-12 18:13:35+00:00,['ee4672bbe0ec3544070d0bb48cd24ae9516be633'],1,45,46,981430,2,0.714285714,0.714285714,1,1846
11f4121a93f0051cce588e145bf3aef68eda44c4,0,Adar Dembo,2016-12-12 19:41:15+00:00,['6f7df3513c38023906fe744616ac2dacd9ef0524'],2,2,4,981434,1,,,,1846
d5567724a210cbbd5425f2de683b413e01b533a4,0,Adar Dembo,2016-12-12 20:46:02+00:00,['11f4121a93f0051cce588e145bf3aef68eda44c4'],3,4,7,981441,1,,,,1846
c681f93480f23914a0c45c5fa6a3829838d81643,0,Adar Dembo,2016-12-12 22:03:11+00:00,['d5567724a210cbbd5425f2de683b413e01b533a4'],111,49,160,981601,29,1,0.173913043,0.086956522,1846
9e72f055b57d2662828cadc249234f31057c22fd,0,Adar Dembo,2016-12-12 22:29:43+00:00,['c681f93480f23914a0c45c5fa6a3829838d81643'],2,3,5,981606,1,0,0,1,1846
c2c76b4c8a75d5563feecbb68fbcace8eb8b6ca2,0,Dan Burkert,2016-12-12 23:41:35+00:00,['9e72f055b57d2662828cadc249234f31057c22fd'],2,2,4,981610,1,,,,1846
d59a9653a46d40c868c78fac6502e9a24e253731,0,Todd Lipcon,2016-12-13 01:31:14+00:00,['c2c76b4c8a75d5563feecbb68fbcace8eb8b6ca2'],16,16,32,981642,2,,,,1846
cc03c6b1d21190099c4dea7cffcfd91e5ccc3da5,0,Adar Dembo,2016-12-13 21:29:22+00:00,['d59a9653a46d40c868c78fac6502e9a24e253731'],13,11,24,981666,2,1,1,1,1846
0259586af3611862645ffcbccca9e4f928e1095b,1,Todd Lipcon,2016-12-14 07:59:21+00:00,['cc03c6b1d21190099c4dea7cffcfd91e5ccc3da5'],41,276,317,981983,9,0,0.643835616,0.993150685,1846
a684b7aa604eff8eaf4450198bae3e68cfbc0ff6,0,Mike Percy,2016-12-14 14:18:47+00:00,['0259586af3611862645ffcbccca9e4f928e1095b'],3,20,23,982006,2,0.2,0.2,1,1846
2b0bb51167666f9beb26a7fe442b3a744bf8cacf,0,Mike Percy,2016-12-14 14:19:01+00:00,['a684b7aa604eff8eaf4450198bae3e68cfbc0ff6'],4,10,14,982020,1,0,1,1,1846
a38977ec5b99976d4e61e5c5c67552ae1a7c8224,0,Jean-Daniel Cryans,2016-12-14 18:38:20+00:00,['2b0bb51167666f9beb26a7fe442b3a744bf8cacf'],0,1,1,982021,1,,,,1846
94719b558357a692615d86e5daf180702ef188a7,1,Todd Lipcon,2016-12-15 01:54:09+00:00,['a38977ec5b99976d4e61e5c5c67552ae1a7c8224'],14,97,111,982132,6,0.34375,1,1,1846
4e4ea79823b341f8059ff9d18252734f7fcb78a2,0,Dan Burkert,2016-12-15 03:42:02+00:00,['94719b558357a692615d86e5daf180702ef188a7'],0,2,2,982134,1,,,,1846
01e6871bca38ea2bed5c17290d43739a0c88094e,1,Todd Lipcon,2016-12-15 03:53:27+00:00,['4e4ea79823b341f8059ff9d18252734f7fcb78a2'],53,107,160,982294,6,0.344827586,0.827586207,0.206896552,1846
2ed179a7a188b4748a43a829940764ab5dddbc1c,0,Todd Lipcon,2016-12-15 08:27:17+00:00,['01e6871bca38ea2bed5c17290d43739a0c88094e'],2,2,4,982298,2,,,,1846
5890e5cb1ddf2af75dd6f5955bb7e9f8490a2067,0,Adar Dembo,2016-12-16 00:14:09+00:00,['2ed179a7a188b4748a43a829940764ab5dddbc1c'],0,1,1,982299,1,0,1,0,1846
00acc92a891587eef518211c5d14906160600ecc,0,Adar Dembo,2016-12-17 02:56:18+00:00,['5890e5cb1ddf2af75dd6f5955bb7e9f8490a2067'],4,4,8,982307,1,,,,1846
cd02f9d409f4d7b06863b92d5d9d325bb05b8d55,0,Todd Lipcon,2016-12-19 05:12:43+00:00,['00acc92a891587eef518211c5d14906160600ecc'],2,2,4,982311,1,,,,1846
2840a586d57012fc4bd805f6aca810e4f48dd37b,0,Todd Lipcon,2016-12-19 08:45:20+00:00,['cd02f9d409f4d7b06863b92d5d9d325bb05b8d55'],15,48,63,982374,3,0,0.933333333,1,1846
a32ea34148249b92c4428322f5778665b6fb1357,0,Todd Lipcon,2016-12-19 09:08:50+00:00,['2840a586d57012fc4bd805f6aca810e4f48dd37b'],125,175,300,982674,6,0.333333333,0.909090909,1,1846
b9dadad6b2a42bf6c862c0602fd51ff076810df5,0,Todd Lipcon,2016-12-19 09:10:47+00:00,['a32ea34148249b92c4428322f5778665b6fb1357'],1,7,8,982682,1,,,,1846
ca2be41ef91bd5545f91090fb390a9e779e29e8e,0,Alexey Serbin,2016-12-19 19:02:43+00:00,['b9dadad6b2a42bf6c862c0602fd51ff076810df5'],0,5,5,982687,1,0,0,1,1846
a4e95c448d5d02927b73470ddb3febed291f011d,0,Alexey Serbin,2016-12-20 19:08:29+00:00,['ca2be41ef91bd5545f91090fb390a9e779e29e8e'],89,102,191,982878,1,1,1,0,1846
1179bbdb43e637e431c9327f46734c7cf7d5c39c,1,Alexey Serbin,2016-12-22 08:24:36+00:00,['a4e95c448d5d02927b73470ddb3febed291f011d'],80,340,420,983298,32,0.273972603,0.95890411,0.98630137,1846
cef7b10239a1cf860bfcb526d503b07503442a49,1,Adar Dembo,2016-12-23 00:02:43+00:00,['1179bbdb43e637e431c9327f46734c7cf7d5c39c'],30,180,210,983508,17,0.666666667,1,0.883333333,1847
f3447a104fd5b6ca71122914838ea5f7d73c8efe,0,Dan Burkert,2016-12-23 00:14:46+00:00,['cef7b10239a1cf860bfcb526d503b07503442a49'],10,35,45,983553,8,0.181818182,1,1,1847
c09751508b1e20638fae4ad474d0a41b12321eab,1,Dan Burkert,2016-12-23 00:28:39+00:00,['f3447a104fd5b6ca71122914838ea5f7d73c8efe'],525,620,1145,984698,78,0,0.541666667,0.75,1847
47f09e30fde1726531544ba530651af39d9aa29e,0,Dan Burkert,2016-12-23 00:39:32+00:00,['c09751508b1e20638fae4ad474d0a41b12321eab'],5,12,17,984715,2,0,0,1,1847
a5a33b3ac8c8729d5dd5b790ba490720fba0b6de,1,Dan Burkert,2016-12-23 02:00:18+00:00,['47f09e30fde1726531544ba530651af39d9aa29e'],79,117,196,984911,21,0.277777778,1,0.944444444,1847
9efb2f8640b8135a935fb3497282f48a3c13bd3a,0,Dan Burkert,2016-12-23 02:23:46+00:00,['a5a33b3ac8c8729d5dd5b790ba490720fba0b6de'],5,5,10,984921,1,0,0,0,1847
a68779bc4b0187e649ce1210716881f346b05981,0,Dan Burkert,2016-12-23 03:36:39+00:00,['9efb2f8640b8135a935fb3497282f48a3c13bd3a'],28,11,39,984960,7,1,0.25,0.125,1847
33b1de3eebc19c1be908f6f2d56cda2fe3cde995,0,Dan Burkert,2017-01-03 20:53:02+00:00,['a68779bc4b0187e649ce1210716881f346b05981'],11,15,26,984986,1,,,,1847
be81fe60c9aa8183c1ae69d5a49eec66cac30972,0,Adar Dembo,2017-01-03 22:14:05+00:00,['33b1de3eebc19c1be908f6f2d56cda2fe3cde995'],4,5,9,984995,4,,,,1847
bf2e6015ddcab212201317fc7915ea87d5eb3819,0,Adar Dembo,2017-01-03 22:44:52+00:00,['be81fe60c9aa8183c1ae69d5a49eec66cac30972'],21,22,43,985038,2,,,,1847
ddb2c16bf0e20f84da1778124efa673f55b43bde,0,Adar Dembo,2017-01-04 01:09:14+00:00,['bf2e6015ddcab212201317fc7915ea87d5eb3819'],1,5,6,985044,1,0,1,1,1847
eaf108a65425da5c8bd573c2442a6dd6f82143e2,0,Mike Percy,2017-01-04 01:15:05+00:00,['ddb2c16bf0e20f84da1778124efa673f55b43bde'],9,7,16,985060,2,,,,1847
106a23ac368000d7faa183fdd49f83528d7de0cd,0,Mike Percy,2017-01-04 01:22:03+00:00,['eaf108a65425da5c8bd573c2442a6dd6f82143e2'],1,3,4,985064,1,,,,1847
286f2356260bd747109daf2c14301b3e5b7719f0,0,Todd Lipcon,2017-01-04 22:00:16+00:00,['106a23ac368000d7faa183fdd49f83528d7de0cd'],22,18,40,985104,1,,,,1847
bdd8e484d48b927f56b1379abddb2568cac47941,0,Todd Lipcon,2017-01-05 14:51:09+00:00,['286f2356260bd747109daf2c14301b3e5b7719f0'],1,1,2,985106,1,,,,1847
4412492c9b553a3300aa16996537b9ec225791fa,0,Adar Dembo,2017-01-05 19:21:48+00:00,['bdd8e484d48b927f56b1379abddb2568cac47941'],5,21,26,985132,1,,,,1847
f3e6af79adb25542536faaa1a990370ba2a0d6ae,0,Todd Lipcon,2017-01-05 21:15:22+00:00,['4412492c9b553a3300aa16996537b9ec225791fa'],0,4,4,985136,2,,,,1847
5bb5cdbe8544af4b670b5b4aa456b49f2f14762c,0,Todd Lipcon,2017-01-05 21:16:49+00:00,['f3e6af79adb25542536faaa1a990370ba2a0d6ae'],1,67,68,985204,1,0.148148148,1,1,1847
75806ea2e91e2e1f11eeb6959f373fc7cf1728e5,0,Mike Percy,2017-01-06 02:47:30+00:00,['5bb5cdbe8544af4b670b5b4aa456b49f2f14762c'],1,20,21,985225,1,,,,1847
e126bde8ddfc59f3be238c8a01b0d6392f4c0d19,0,Dan Burkert,2017-01-06 19:58:27+00:00,['75806ea2e91e2e1f11eeb6959f373fc7cf1728e5'],5,70,75,985300,2,0.533333333,0.533333333,1,1847
443b724e8858bc88747cbf33ec34afd5dbd3be2a,0,Dan Burkert,2017-01-06 22:25:39+00:00,['e126bde8ddfc59f3be238c8a01b0d6392f4c0d19'],22,221,243,985543,4,0.167567568,0.72972973,0.972972973,1847
3d634777e5750faba2a5d91c6967f7fecc5ff151,0,Todd Lipcon,2017-01-06 23:45:49+00:00,['443b724e8858bc88747cbf33ec34afd5dbd3be2a'],410,235,645,986188,4,,,,1848
ab76440e9c2447ba1c572b957a958e90e9e9b87b,0,Dan Burkert,2017-01-09 19:17:09+00:00,['3d634777e5750faba2a5d91c6967f7fecc5ff151'],50,278,328,986516,3,0,0.777777778,0.777777778,1848
5dd962f82f21a8e9876d356f15b293409949a084,0,Todd Lipcon,2017-01-09 20:59:00+00:00,['ab76440e9c2447ba1c572b957a958e90e9e9b87b'],3,3,6,986522,1,,,,1848
adad9b81b41feb84bee4c8419817a8666c7555f3,0,Adar Dembo,2017-01-09 22:01:46+00:00,['5dd962f82f21a8e9876d356f15b293409949a084'],8,32,40,986562,2,0,1,1,1848
67fc54e4dd80fa7ec3544d8d2b071ec374191f75,0,Todd Lipcon,2017-01-09 23:06:41+00:00,['adad9b81b41feb84bee4c8419817a8666c7555f3'],0,10,10,986572,5,0.454545455,1,1,1848
ccb34a7eaed7d9a01e8a3908ad9a089e4101eaac,0,Jean-Daniel Cryans,2017-01-10 00:17:06+00:00,['67fc54e4dd80fa7ec3544d8d2b071ec374191f75'],13,191,204,986776,3,,,,1848
1ceaa7b2b1777449775809c2653fb16a84518fbd,0,Adar Dembo,2017-01-10 00:42:24+00:00,['ccb34a7eaed7d9a01e8a3908ad9a089e4101eaac'],1,1,2,986778,1,,,,1848
217dfe475a4745a017cc9946455ffa01c95e1cad,0,Adar Dembo,2017-01-10 20:34:18+00:00,['1ceaa7b2b1777449775809c2653fb16a84518fbd'],2,7,9,986787,1,0,0,1,1848
78feb330095d83f9dbbb566159573f63c38fd94b,0,Todd Lipcon,2017-01-11 00:25:42+00:00,['217dfe475a4745a017cc9946455ffa01c95e1cad'],56,62,118,986905,1,,,,1848
4114ba9bf1cdfbd03eef2a13d6e51b6094527997,0,Alexey Serbin,2017-01-11 02:06:56+00:00,['78feb330095d83f9dbbb566159573f63c38fd94b'],10,17,27,986932,9,0,0.625,0.875,1848
f82cf6918c00dff6aecad5a6b50836b7eb5db508,0,Todd Lipcon,2017-01-12 06:15:30+00:00,['4114ba9bf1cdfbd03eef2a13d6e51b6094527997'],24,81,105,987037,7,0,1,0,1848
8d026474be4ba4477fdedd6f070a2028879e3c78,0,Adar Dembo,2017-01-12 08:17:50+00:00,['f82cf6918c00dff6aecad5a6b50836b7eb5db508'],3,7,10,987047,1,,,,1848
d9bd5b8752efd4ae407043e491b7fd1e0b885a92,1,Adar Dembo,2017-01-12 08:20:40+00:00,['8d026474be4ba4477fdedd6f070a2028879e3c78'],115,216,331,987378,6,0.088235294,0,1,1848
1fec58a2d92067a86edda61f96ad85df0f8bf2a5,0,Adar Dembo,2017-01-12 08:21:26+00:00,['d9bd5b8752efd4ae407043e491b7fd1e0b885a92'],3,5,8,987386,1,0,0,1,1848
23c3e0d79bd05d67f60f4ba6b83dcb0c156b6e12,0,Adar Dembo,2017-01-12 08:22:01+00:00,['1fec58a2d92067a86edda61f96ad85df0f8bf2a5'],14,14,28,987414,3,,,,1848
9d29424e790b54e9c0d8d44dbdf954f16aba5377,0,Adar Dembo,2017-01-12 08:22:14+00:00,['23c3e0d79bd05d67f60f4ba6b83dcb0c156b6e12'],8,9,17,987431,1,0,1,1,1848
2505094c698c5a74fafde5f1d1ee6cd489ce836b,0,Todd Lipcon,2017-01-12 19:54:20+00:00,['9d29424e790b54e9c0d8d44dbdf954f16aba5377'],259,145,404,987835,5,,,,1848
eb039566cb5a7e14d68e3c2e207c2b5187044522,0,Todd Lipcon,2017-01-12 20:43:37+00:00,['2505094c698c5a74fafde5f1d1ee6cd489ce836b'],57,132,189,988024,5,,,,1848
77e38401c979062ee805e6246a697f751cc8123d,0,Todd Lipcon,2017-01-13 00:53:45+00:00,['eb039566cb5a7e14d68e3c2e207c2b5187044522'],100,83,183,988207,1,,,,1848
71638f5d604255461747f3dfa917db638492d49c,0,Dan Burkert,2017-01-13 03:00:37+00:00,['77e38401c979062ee805e6246a697f751cc8123d'],44,47,91,988298,13,,,,1848
f907db137c05da5e10353fb53f5a431efdac62c0,1,Dan Burkert,2017-01-13 03:00:43+00:00,['71638f5d604255461747f3dfa917db638492d49c'],41,155,196,988494,6,0.322580645,1,0.903225806,1850
ef710cd00c3fa93ab63c175ed32e946ca057702e,0,Jean-Daniel Cryans,2017-01-13 16:32:35+00:00,['f907db137c05da5e10353fb53f5a431efdac62c0'],8,10,18,988512,1,,,,1850
b7e2089f870cf35d3bb95ac0a099e661df392cdc,0,Jean-Daniel Cryans,2017-01-13 16:35:38+00:00,['ef710cd00c3fa93ab63c175ed32e946ca057702e'],2,1,3,988515,1,0,0,0,1850
5e932ae572621920eefdb1a5ee6883a8f0084f8e,0,Adar Dembo,2017-01-13 23:51:01+00:00,['b7e2089f870cf35d3bb95ac0a099e661df392cdc'],0,1,1,988516,1,,,,1850
b6acf36cc27c1a70744d0bee433314a650d795f0,0,Adar Dembo,2017-01-14 19:40:25+00:00,['5e932ae572621920eefdb1a5ee6883a8f0084f8e'],41,45,86,988602,2,,,,1850
6e683a00d726e3ab45f592d85a9b72a5a9d42321,0,Adar Dembo,2017-01-15 02:02:30+00:00,['b6acf36cc27c1a70744d0bee433314a650d795f0'],15,30,45,988647,4,,,,1850
7d16929c4fdc0504c33c60805c044ecc451e8323,0,Adar Dembo,2017-01-19 00:11:10+00:00,['6e683a00d726e3ab45f592d85a9b72a5a9d42321'],1,3,4,988651,1,,,,1850
7679f9b7ef70982885c8141aa8136d4a2a237305,0,Adar Dembo,2017-01-19 10:54:24+00:00,['7d16929c4fdc0504c33c60805c044ecc451e8323'],6,17,23,988674,1,,,,1850
8598bd94779aa9da966b5b4cb5e613db46a60b5a,0,Mike Percy,2017-01-19 19:09:15+00:00,['7679f9b7ef70982885c8141aa8136d4a2a237305'],11,176,187,988861,9,0.485714286,0.828571429,1,1850
d47ce5dc28b561f9a8d72bcb5133a8e1b30a0d1e,0,Adar Dembo,2017-01-19 22:17:39+00:00,['8598bd94779aa9da966b5b4cb5e613db46a60b5a'],116,81,197,989058,4,0.096774194,0.129032258,1,1850
6c90e5dae76c7b4cabd5b3ea93528796a630f391,0,Adar Dembo,2017-01-20 01:26:19+00:00,['d47ce5dc28b561f9a8d72bcb5133a8e1b30a0d1e'],1,3,4,989062,1,0,1,1,1850
e8381bb4433df84c3b0994e2e269ce073a94c874,0,Mike Percy,2017-01-20 05:19:42+00:00,['6c90e5dae76c7b4cabd5b3ea93528796a630f391'],1,96,97,989159,2,,,,1851
6985a544342014e29fe2615ddcb02ccdf4f8bd39,0,David Ribeiro Alves,2017-01-20 21:05:28+00:00,['e8381bb4433df84c3b0994e2e269ce073a94c874'],0,1557,1557,990716,15,,,,1865
fb3bbbc8ce8527a63144b268cbad4aee92da4c1f,0,Adar Dembo,2017-01-20 21:10:47+00:00,['6985a544342014e29fe2615ddcb02ccdf4f8bd39'],26,81,107,990823,4,0.37037037,1,0.259259259,1865
c8ca20fa7be5e2a934f10df9f748a5556a8ad45b,0,Alexey Serbin,2017-01-21 01:42:04+00:00,['fb3bbbc8ce8527a63144b268cbad4aee92da4c1f'],0,140,140,990963,1,,,,1866
36445904cb16b69a01b0ae7ddb55144197ad44a7,0,Todd Lipcon,2017-01-22 23:57:59+00:00,['c8ca20fa7be5e2a934f10df9f748a5556a8ad45b'],3,10,13,990976,1,,,,1866
4a5f1392bbddb6a5eefd5fa23c098e7dc1a027d0,1,Todd Lipcon,2017-01-23 04:16:36+00:00,['36445904cb16b69a01b0ae7ddb55144197ad44a7'],4,1661,1665,992641,7,0.274630542,0.841133005,0.869458128,1871
13014cac649b4da47a64acfac318bb3fdf6f4347,0,Dan Burkert,2017-01-23 18:17:30+00:00,['4a5f1392bbddb6a5eefd5fa23c098e7dc1a027d0'],20,4,24,992665,3,0.75,0.75,0,1871
73dcce642e85518d619ec3a4e9efcbef87a54c5c,0,Dan Burkert,2017-01-23 18:17:38+00:00,['13014cac649b4da47a64acfac318bb3fdf6f4347'],84,15,99,992764,10,0.461538462,0.051282051,0.051282051,1871
45b7dba1ccf3c9ef455662d4b250c8e9e28fc79f,0,Todd Lipcon,2017-01-23 22:46:03+00:00,['73dcce642e85518d619ec3a4e9efcbef87a54c5c'],99,123,222,992986,16,1,0,0,1872
ef57bda2c55154ca44c40e00602e9e3de891fa85,1,Todd Lipcon,2017-01-23 22:46:37+00:00,['45b7dba1ccf3c9ef455662d4b250c8e9e28fc79f'],0,7,7,992993,1,1,1,1,1872
2960e6927137fc8ccd175001810d292066c4dac6,0,Todd Lipcon,2017-01-23 23:14:55+00:00,['ef57bda2c55154ca44c40e00602e9e3de891fa85'],135,143,278,993271,11,0.6,1,0.2,1872
9d0421e807887a83f011e9cdc265901593b2fdf8,0,Dan Burkert,2017-01-23 23:25:36+00:00,['2960e6927137fc8ccd175001810d292066c4dac6'],40,48,88,993359,4,,,,1872
41c45523f7d34d7800fd29d4cbe40330cac13e6a,0,Todd Lipcon,2017-01-23 23:37:18+00:00,['9d0421e807887a83f011e9cdc265901593b2fdf8'],26,27,53,993412,10,0,0,1,1872
bbf75306127e99b070b214dcc1c9896b8de3989f,0,Adar Dembo,2017-01-23 23:59:55+00:00,['41c45523f7d34d7800fd29d4cbe40330cac13e6a'],366,0,366,993778,2,0.641304348,0.641304348,0.173913043,1872
a1a778c031c73c74eaa6ff5111ea6ef15385fc9a,0,Alexey Serbin,2017-01-24 04:33:39+00:00,['bbf75306127e99b070b214dcc1c9896b8de3989f'],136,123,259,994037,1,1,0,0,1872
3ef4fba27df094ec6e119a0176fd46cde13e5ff5,1,Todd Lipcon,2017-01-24 05:44:41+00:00,['a1a778c031c73c74eaa6ff5111ea6ef15385fc9a'],109,167,276,994313,3,1,1,1,1872
ff38c6b5a69333a9aba47a0862b3d05b500acebb,0,Todd Lipcon,2017-01-24 17:08:09+00:00,['3ef4fba27df094ec6e119a0176fd46cde13e5ff5'],1,4,5,994318,1,,,,1872
6719da0449e22dfc1055ded08f276b351003a3f3,0,Todd Lipcon,2017-01-24 21:46:01+00:00,['ff38c6b5a69333a9aba47a0862b3d05b500acebb'],12,1,13,994331,1,,,,1872
e367b4e0b6e1cae60ffb8cbf2a661589b92fa9c5,0,Alexey Serbin,2017-01-24 23:29:09+00:00,['6719da0449e22dfc1055ded08f276b351003a3f3'],309,347,656,994987,4,0,1,0.714285714,1872
b9aa5dd31ae9de4e95627220fc79741eecfd9de2,0,Todd Lipcon,2017-01-25 02:10:31+00:00,['e367b4e0b6e1cae60ffb8cbf2a661589b92fa9c5'],11,3,14,995001,4,0.5,0,0.5,1872
5eb22e43560744db08e10d5813379ebcd143ba18,0,Dinesh Bhat,2017-01-24 18:18:02-08:00,['81157cc5e952134faf3192a0b51d6ca210e51228'],7,22,29,995030,1,,,,1872
59eb7042d07e7135b6fb81ceef63cba175df5fd4,0,GitHub,2017-01-25 12:56:07-08:00,"['81157cc5e952134faf3192a0b51d6ca210e51228', '5eb22e43560744db08e10d5813379ebcd143ba18']",7,22,29,995059,1,,,,1872
dc8525358f48df4142e3347b389612704a9312d1,1,Dan Burkert,2017-01-26 02:19:25+00:00,['b9aa5dd31ae9de4e95627220fc79741eecfd9de2'],1123,951,2074,997133,19,0.495934959,0.43902439,0.349593496,1872
8a2ea8bddc88e8de60952b369f112b32710ee19b,0,Todd Lipcon,2017-01-26 02:59:55+00:00,['dc8525358f48df4142e3347b389612704a9312d1'],0,13,13,997146,2,0,0.454545455,0.454545455,1872
72b2ffdace5ffe0aff925392230e3cbd3813e326,1,Todd Lipcon,2017-01-26 17:41:00+00:00,['8a2ea8bddc88e8de60952b369f112b32710ee19b'],74,832,906,998052,12,0.260377358,0.8,0.811320755,1880
0a4541bbad3817be568b9bc95604d46a0318f7bd,1,Todd Lipcon,2017-01-26 18:17:46+00:00,['72b2ffdace5ffe0aff925392230e3cbd3813e326'],590,372,962,999014,17,0.346534653,0,0.534653465,1880
472770cce58699f816a5501e978f44128390448b,0,Todd Lipcon,2017-01-26 11:14:46-08:00,['59eb7042d07e7135b6fb81ceef63cba175df5fd4'],22,7,29,999043,1,,,,1880
5d12bdb904388f0e6a50b41b60138f3dff2efe00,0,Todd Lipcon,2017-01-26 21:15:01+00:00,['0a4541bbad3817be568b9bc95604d46a0318f7bd'],1,47,48,999091,2,0.375,1,1,1880
1ee003113ce32fa1379e7e0656516f41b839dcd3,1,Todd Lipcon,2017-01-26 21:44:36+00:00,['5d12bdb904388f0e6a50b41b60138f3dff2efe00'],11,511,522,999613,15,0.482014388,0.856115108,0.928057554,1884
7b01d81325e77447325315f5ebd166f52e6d8bc8,0,Todd Lipcon,2017-01-26 21:44:43+00:00,['1ee003113ce32fa1379e7e0656516f41b839dcd3'],2,924,926,1000539,9,0.559183673,0.853061224,0.975510204,1892
b235487e1da52be3840657d6c46852912625c6bb,1,Todd Lipcon,2017-01-26 22:14:50+00:00,['7b01d81325e77447325315f5ebd166f52e6d8bc8'],16,213,229,1000768,8,0.351648352,0.10989011,0.769230769,1892
2c052fcb4cd66cd901d40cf053be0c01d0ebc84e,1,Todd Lipcon,2017-01-26 23:38:29+00:00,['b235487e1da52be3840657d6c46852912625c6bb'],21,245,266,1001034,10,0.367346939,0.843537415,0.523809524,1892
ce04fe5f1cc67a268842ee7870a4f6ea6ae1fcc9,0,Todd Lipcon,2017-01-27 00:07:38+00:00,['2c052fcb4cd66cd901d40cf053be0c01d0ebc84e'],27,27,54,1001088,4,0,0,1,1892
d2c823c9db64a4ca7ac07501b3ff9ce0488794ad,0,Jean-Daniel Cryans,2017-01-27 16:28:05+00:00,['ce04fe5f1cc67a268842ee7870a4f6ea6ae1fcc9'],2,30,32,1001120,3,0,1,1,1892
cf20c0e59668b41a03341471dbe58964ef184389,0,Todd Lipcon,2017-01-30 23:57:43+00:00,['d2c823c9db64a4ca7ac07501b3ff9ce0488794ad'],106,274,380,1001500,15,0.296296296,0.864197531,0.864197531,1892
2882f0f3e255ed28769aa444f4d999ff796ebd7d,0,Todd Lipcon,2017-01-31 02:25:34+00:00,['cf20c0e59668b41a03341471dbe58964ef184389'],5,24,29,1001529,2,1,1,1,1892
e87fb79076d5ae2838cad6b63a78066a7853fb20,0,Mike Percy,2017-01-31 02:55:40+00:00,['2882f0f3e255ed28769aa444f4d999ff796ebd7d'],15,43,58,1001587,3,1,1,1,1892
72541b47eb55b2df4eab5d6050f517476ed6d370,1,Mike Percy,2017-01-31 03:16:53+00:00,['e87fb79076d5ae2838cad6b63a78066a7853fb20'],132,224,356,1001943,9,0.698113208,1,1,1892
d84c35b5862bd73e007e5b47fd8a7af334fa44f4,0,Todd Lipcon,2017-01-31 03:23:01+00:00,['72541b47eb55b2df4eab5d6050f517476ed6d370'],9,17,26,1001969,4,1,1,1,1892
defd6e8316c9c2c28acd8ccf54133a901d155c0f,0,Dan Burkert,2017-01-31 19:47:12+00:00,['d84c35b5862bd73e007e5b47fd8a7af334fa44f4'],4,9,13,1001982,1,,,,1892
99fcc31edd9e61b87a12c852c120179e9e771805,0,Mike Percy,2017-01-31 20:42:51+00:00,['defd6e8316c9c2c28acd8ccf54133a901d155c0f'],3,4,7,1001989,1,0,1,1,1892
19e88d57d5c686a88fbc063f96e2965bc74fe703,0,Mike Percy,2017-01-31 20:43:28+00:00,['99fcc31edd9e61b87a12c852c120179e9e771805'],34,47,81,1002070,2,1,1,1,1892
f994ee96c73fd16352d046e2ee085688c5840c83,0,Mike Percy,2017-01-31 20:43:49+00:00,['19e88d57d5c686a88fbc063f96e2965bc74fe703'],8,37,45,1002115,2,1,1,1,1892
89b703995d11d6cf58e0489fd9f372679715636c,0,Mike Percy,2017-01-31 21:47:00+00:00,['f994ee96c73fd16352d046e2ee085688c5840c83'],2,4,6,1002121,1,0,1,1,1892
269e00f86a9a1d7c8bdeded22d6be0c4aa74887f,0,Jean-Daniel Cryans,2017-01-31 22:37:26+00:00,['89b703995d11d6cf58e0489fd9f372679715636c'],15,15,30,1002151,3,,,,1892
99b9bf3b4949d889cc68123253f575022164d49b,0,Jean-Daniel Cryans,2017-01-31 22:45:55+00:00,['269e00f86a9a1d7c8bdeded22d6be0c4aa74887f'],1,6,7,1002158,1,0,1,1,1892
e2cf460307d70f8cfd40a1a42e6c1133177b27ef,0,Todd Lipcon,2017-01-31 23:55:53+00:00,['99b9bf3b4949d889cc68123253f575022164d49b'],1,1,2,1002160,1,,,,1892
d91313d6147bf3214d8954d810a2d4f6f4b5e123,1,Todd Lipcon,2017-02-01 01:08:26+00:00,['e2cf460307d70f8cfd40a1a42e6c1133177b27ef'],350,703,1053,1003213,23,0.911392405,1,0.632911392,1897
9136c8ad61d3751b8569029e0ad6eaa0a4154db1,0,Alexey Serbin,2017-02-01 01:15:33+00:00,['d91313d6147bf3214d8954d810a2d4f6f4b5e123'],70,192,262,1003475,5,1,1,1,1898
e6e3029c2f460fe838af70e07faa138962ee3b55,1,Alexey Serbin,2017-02-01 02:01:16+00:00,['9136c8ad61d3751b8569029e0ad6eaa0a4154db1'],7,234,241,1003716,5,0.082568807,1,0.403669725,1898
e67289edfbca4b1d189c1b42406a5a8bc5602fc5,0,Alexey Serbin,2017-02-01 02:20:01+00:00,['e6e3029c2f460fe838af70e07faa138962ee3b55'],9,20,29,1003745,3,0,0,1,1898
20f7d86f379f2291306f521b819d61d957b3294f,0,Adar Dembo,2017-01-31 18:29:26-08:00,['472770cce58699f816a5501e978f44128390448b'],1,1,2,1003747,1,,,,1898
53a882c02d9fcb0eea33a83f785bce0c63e75347,0,GitHub,2017-01-31 18:53:10-08:00,"['472770cce58699f816a5501e978f44128390448b', '20f7d86f379f2291306f521b819d61d957b3294f']",1,1,2,1003749,1,,,,1898
8cf39203658570ad5010943b0984a083b7610d5a,0,Alexey Serbin,2017-02-01 07:15:10+00:00,['e67289edfbca4b1d189c1b42406a5a8bc5602fc5'],19,41,60,1003809,3,0.933333333,0.933333333,0.8,1898
63ce3ec632c92a3d215cf49ace29a73d51023401,1,Todd Lipcon,2017-02-01 18:39:36+00:00,['8cf39203658570ad5010943b0984a083b7610d5a'],23,227,250,1004059,4,0.105769231,0.288461538,1,1898
588538da02c224e9b6adbd8823bc7bff421ff21a,1,Todd Lipcon,2017-02-01 19:14:24+00:00,['63ce3ec632c92a3d215cf49ace29a73d51023401'],10,7,17,1004076,1,0,0,0.333333333,1898
431aee53fd269b5699095fb1e7fd5402644fe454,0,Will Berkeley,2017-02-01 20:42:21+00:00,['588538da02c224e9b6adbd8823bc7bff421ff21a'],109,897,1006,1005082,22,0.137931034,0.536637931,0.959051724,1898
86714152d3122580984a28ad0fc46ed942d5020c,1,Todd Lipcon,2017-02-01 21:24:31+00:00,['431aee53fd269b5699095fb1e7fd5402644fe454'],54,112,166,1005248,7,1,1,0,1899
8d9fd9c4b31599667deab0544e6a26742b9aa0aa,0,Will Berkeley,2017-02-01 21:45:10+00:00,['86714152d3122580984a28ad0fc46ed942d5020c'],13,8,21,1005269,2,0,0,1,1899
b30d68a9bb8880edd43caaac9de34351571c8edb,0,Jean-Daniel Cryans,2017-02-01 22:11:36+00:00,['8d9fd9c4b31599667deab0544e6a26742b9aa0aa'],403,156,559,1005828,2,,,,1899
8993716d70f326a0a782b7f943c0b9492eab9c0f,1,Todd Lipcon,2017-02-01 22:36:32+00:00,['b30d68a9bb8880edd43caaac9de34351571c8edb'],3,9,12,1005840,2,0,0,1,1899
26a6a51661e4aa5c906ffa990f0c7d70976bf56c,0,Todd Lipcon,2017-02-02 01:07:27+00:00,['8993716d70f326a0a782b7f943c0b9492eab9c0f'],0,12,12,1005852,2,0.2,1,0.2,1899
67fcfccd435b414d8c98647d2d6d041049407c72,0,Dan Burkert,2017-02-02 01:31:15+00:00,['26a6a51661e4aa5c906ffa990f0c7d70976bf56c'],1,2,3,1005855,1,,,,1899
ae32aea390d7959af0d6f59006d26277b6af5623,0,Dinesh Bhat,2017-02-01 18:58:47-08:00,['53a882c02d9fcb0eea33a83f785bce0c63e75347'],7,23,30,1005885,1,,,,1899
6bf862997f4a3497efbea1c3d77178c0eff84e3d,0,GitHub,2017-02-01 19:15:21-08:00,"['53a882c02d9fcb0eea33a83f785bce0c63e75347', 'ae32aea390d7959af0d6f59006d26277b6af5623']",7,23,30,1005915,1,,,,1899
8f2a8f9187c50e39752b5abb231ca41a613c6791,0,Alexey Serbin,2017-02-02 18:59:32+00:00,['67fcfccd435b414d8c98647d2d6d041049407c72'],6,16,22,1005937,3,0.333333333,0.333333333,1,1899
d3e37868f60089e928a06502fba951359c9b96d4,0,Todd Lipcon,2017-02-02 21:45:49+00:00,['8f2a8f9187c50e39752b5abb231ca41a613c6791'],51,18,69,1006006,3,0,0,0,1899
e4a649c205d46a3f2b06fba475f1325127ade555,0,Todd Lipcon,2017-02-02 21:49:07+00:00,['d3e37868f60089e928a06502fba951359c9b96d4'],77,66,143,1006149,9,,,,1899
4ae35c295c02737663ec80f36580c7caa38b1479,1,Todd Lipcon,2017-02-02 23:25:33+00:00,['e4a649c205d46a3f2b06fba475f1325127ade555'],73,181,254,1006403,10,0.367647059,0.632352941,1,1899
85fd90996bbe8b5af08662fb9737280ce0bba2c2,0,Dan Burkert,2017-02-02 23:58:44+00:00,['4ae35c295c02737663ec80f36580c7caa38b1479'],47,25,72,1006475,1,0.916666667,0,0.916666667,1899
6aba5eff8e5a541fcd4b57460d5d33938327aecc,1,Todd Lipcon,2017-02-03 01:06:59+00:00,['85fd90996bbe8b5af08662fb9737280ce0bba2c2'],46,46,92,1006567,15,1,1,,1899
1ce41a4a5efc19d33e02b7179a98681b1ead43af,1,Todd Lipcon,2017-02-03 01:08:12+00:00,['6aba5eff8e5a541fcd4b57460d5d33938327aecc'],73,75,148,1006715,8,,,,1899
cb06dd12a83d6184741689a351de58eec8fd4370,1,Todd Lipcon,2017-02-03 01:41:14+00:00,['1ce41a4a5efc19d33e02b7179a98681b1ead43af'],43,59,102,1006817,2,0.5,1,0.4,1899
d25430e28e3e9441408acd2b58d4320bc9f3e17b,1,Todd Lipcon,2017-02-03 05:07:00+00:00,['cb06dd12a83d6184741689a351de58eec8fd4370'],52,166,218,1007035,9,0.3,0.68,1,1899
70bbcfc6ad7f117c77f8c24ac0bf544ba1f25dc6,1,Todd Lipcon,2017-02-03 17:32:07+00:00,['d25430e28e3e9441408acd2b58d4320bc9f3e17b'],42,143,185,1007220,8,0.833333333,1,1,1899
848180654d5954255b1ac4fac7a19b0a7ad669bd,1,Todd Lipcon,2017-02-03 17:32:33+00:00,['70bbcfc6ad7f117c77f8c24ac0bf544ba1f25dc6'],329,123,452,1007672,9,0.822695035,0.319148936,0.34751773,1899
6fec9dd52ecfd0248a46c5c5d6987e2ac2e0a4cf,1,Dan Burkert,2017-02-03 19:12:54+00:00,['848180654d5954255b1ac4fac7a19b0a7ad669bd'],65,369,434,1008106,17,0.504,0.936,1,1899
a4b181cbf2a01ae778b8015579cbbbf794913836,0,Todd Lipcon,2017-02-03 21:05:06+00:00,['6fec9dd52ecfd0248a46c5c5d6987e2ac2e0a4cf'],1,1,2,1008108,1,,,,1899
00cf84ccbd851ba56c5eaded36cc69b79190872e,0,Adar Dembo,2017-02-03 22:54:18+00:00,['a4b181cbf2a01ae778b8015579cbbbf794913836'],0,3,3,1008111,3,0,1,1,1899
f3ec97bd16d99052420bd3b92ce7cdf92aa7fbe7,1,Adar Dembo,2017-02-03 22:54:52+00:00,['00cf84ccbd851ba56c5eaded36cc69b79190872e'],0,45,45,1008156,2,,,,1900
27e05ee84cb5f3abae0d36d1a2425f5d7701d1f8,0,Todd Lipcon,2017-02-04 04:39:57+00:00,['f3ec97bd16d99052420bd3b92ce7cdf92aa7fbe7'],77,74,151,1008307,2,1,0,0,1900
8329bdc8887fc72c07a792922c13f25521e8af21,1,Alexey Serbin,2017-02-04 06:26:22+00:00,['27e05ee84cb5f3abae0d36d1a2425f5d7701d1f8'],49,547,596,1008903,12,0.302681992,1,0.862068966,1901
cd7b0dd4d89f270822adf77a81d883fe40773f14,0,Alexey Serbin,2017-02-06 06:08:50+00:00,['8329bdc8887fc72c07a792922c13f25521e8af21'],0,1,1,1008904,1,,,,1901
a9d716aa3b51c7b3f1f44b4083afd7cf725a1885,0,Will Berkeley,2017-02-06 15:53:00+00:00,['cd7b0dd4d89f270822adf77a81d883fe40773f14'],0,17,17,1008921,1,,,,1901
d1fb71cf06f52fc735c8f7fa19dfb2df7ecde529,0,Will Berkeley,2017-02-06 18:43:52+00:00,['a9d716aa3b51c7b3f1f44b4083afd7cf725a1885'],1,40,41,1008962,2,0.833333333,0.833333333,1,1901
e11e09a624922e8ec836a286442cd4dfa2ccde44,0,Will Berkeley,2017-02-06 22:42:30+00:00,['d1fb71cf06f52fc735c8f7fa19dfb2df7ecde529'],1,0,1,1008963,1,,,,1901
aa90fc02ca8208bdc1524e89707a61559b23e664,0,Adar Dembo,2017-02-06 23:10:17+00:00,['e11e09a624922e8ec836a286442cd4dfa2ccde44'],5,18,23,1008986,1,,,,1901
d47c13872061e66924c6d9033df59638fe5ceea0,0,Dan Burkert,2017-02-06 23:22:23+00:00,['aa90fc02ca8208bdc1524e89707a61559b23e664'],30,27,57,1009043,5,1,1,0,1901
7d43460109899af9ef40eb2bebb6f532f5dd0055,1,Todd Lipcon,2017-02-07 18:36:16+00:00,['d47c13872061e66924c6d9033df59638fe5ceea0'],4,257,261,1009304,12,0.397058824,1,1,1903
e95c29b685bcd9d3d444ba46f8977a93fc8901a2,1,Todd Lipcon,2017-02-07 18:36:29+00:00,['7d43460109899af9ef40eb2bebb6f532f5dd0055'],56,63,119,1009423,5,0,0,1,1903
8971bc53514ac228852bcab971ac6f0320fdd426,0,Dan Burkert,2017-02-07 18:58:51+00:00,['e95c29b685bcd9d3d444ba46f8977a93fc8901a2'],1,2,3,1009426,1,0,1,1,1903
32abe5bc1cc80f10ddb0c080db0bc806a3364384,0,Jean-Daniel Cryans,2017-02-07 19:08:55+00:00,['8971bc53514ac228852bcab971ac6f0320fdd426'],25,43,68,1009494,4,1,1,0.428571429,1903
a72ed600c0916906359025b2afc0668ffb9d0f5d,1,Mike Percy,2017-02-07 19:44:34+00:00,['32abe5bc1cc80f10ddb0c080db0bc806a3364384'],16,87,103,1009597,5,0.206896552,0.793103448,0.172413793,1903
e7e65954bdc7992d281151fa36c1218e8417da08,1,Adar Dembo,2017-02-07 21:16:46+00:00,['a72ed600c0916906359025b2afc0668ffb9d0f5d'],28,124,152,1009749,4,,,,1904
4f0677f84d1c74fe69d53ef0531d0460e63f3a37,1,Dan Burkert,2017-02-07 23:35:48+00:00,['e7e65954bdc7992d281151fa36c1218e8417da08'],344,540,884,1010633,7,0,0.637096774,0.693548387,1904
93df70337edbe123eceb5e42ebc3875e2e1daddd,0,David Ribeiro Alves,2017-02-08 00:34:30+00:00,['4f0677f84d1c74fe69d53ef0531d0460e63f3a37'],1,1,2,1010635,1,,,,1904
c4c770a45c19d564b1df8ce2ccd21f5e10254b2c,1,Dan Burkert,2017-02-08 20:01:12+00:00,['93df70337edbe123eceb5e42ebc3875e2e1daddd'],4,79,83,1010718,8,0.025,0,0,1904
f369fcfaf768d0561f5209115355328c72b04620,1,Alexey Serbin,2017-02-08 20:10:10+00:00,['c4c770a45c19d564b1df8ce2ccd21f5e10254b2c'],0,95,95,1010813,4,1,1,1,1905
dffbf6f395498cd37d044c4ca859f8571d5bd951,0,Alexey Serbin,2017-02-08 20:10:20+00:00,['f369fcfaf768d0561f5209115355328c72b04620'],11,22,33,1010846,7,0,1,1,1905
959a7835d9e1dd9b95af86af456928547269a59b,0,Todd Lipcon,2017-02-08 20:44:49+00:00,['dffbf6f395498cd37d044c4ca859f8571d5bd951'],1,1,2,1010848,1,,,,1905
716a1fa1ea6bdae0268394c84eca27af0a01b6f2,1,Todd Lipcon,2017-02-08 21:27:02+00:00,['959a7835d9e1dd9b95af86af456928547269a59b'],128,284,412,1011260,11,0.50877193,0.877192982,1,1906
5f4bd61b0ebe75402789d20e441966080383916a,0,Todd Lipcon,2017-02-08 21:27:09+00:00,['716a1fa1ea6bdae0268394c84eca27af0a01b6f2'],52,3,55,1011315,2,0.529411765,0.029411765,0,1906
24b06245090292589df4093c4080bfedb17f76ca,0,Todd Lipcon,2017-02-08 21:27:48+00:00,['5f4bd61b0ebe75402789d20e441966080383916a'],122,48,170,1011485,5,0,0,1,1906
a25162abb068519df3fdb44751ffd18cb9fe630e,0,Todd Lipcon,2017-02-08 21:27:55+00:00,['24b06245090292589df4093c4080bfedb17f76ca'],83,116,199,1011684,4,1,1,0,1906
3642e1ff81934e497d39f0b1d1336e461aa53ebd,0,Todd Lipcon,2017-02-08 21:35:12+00:00,['a25162abb068519df3fdb44751ffd18cb9fe630e'],2,3,5,1011689,2,,,,1906
67f2486891378c8344ac3f68f9e8f344b74881af,0,Todd Lipcon,2017-02-08 21:56:30+00:00,['3642e1ff81934e497d39f0b1d1336e461aa53ebd'],12,17,29,1011718,2,,,,1906
b7b418b5e5a74a65e5e07621934c4f8a8a67753c,0,Dan Burkert,2017-02-08 22:02:30+00:00,['67f2486891378c8344ac3f68f9e8f344b74881af'],291,0,291,1012009,6,0,0,0,1906
54f529dd40f1690b078e570bb340c06c336f9979,0,Alexey Serbin,2017-02-08 22:04:42+00:00,['b7b418b5e5a74a65e5e07621934c4f8a8a67753c'],62,22,84,1012093,2,0,0,0,1906
a806ce00347701062e43d0bd709ca4c97c2a7fc2,1,Mike Percy,2017-02-08 22:42:32+00:00,['54f529dd40f1690b078e570bb340c06c336f9979'],85,1028,1113,1013206,30,0.635451505,0.889632107,0.929765886,1912
88a6e1402db1e980dce964396a44a0c62752c60e,0,Todd Lipcon,2017-02-09 03:40:01+00:00,['a806ce00347701062e43d0bd709ca4c97c2a7fc2'],10,182,192,1013398,6,0.466666667,1,0.866666667,1914
0430ea630dd60b4bde2456e4d82f8e991188cc96,1,Todd Lipcon,2017-02-09 03:44:09+00:00,['88a6e1402db1e980dce964396a44a0c62752c60e'],31,75,106,1013504,7,0,1,0,1914
18a2ea555c90531bd06c9410d0e97f20c6af6c68,0,Todd Lipcon,2017-02-10 04:50:45+00:00,['0430ea630dd60b4bde2456e4d82f8e991188cc96'],1,2,3,1013507,1,1,1,0,1914
60aedaaf4b20a725d7ca2b0f774f73adc5992427,1,Dan Burkert,2017-02-10 20:42:35+00:00,['18a2ea555c90531bd06c9410d0e97f20c6af6c68'],66,74,140,1013647,8,0.714285714,0.857142857,1,1914
5833debe325a1db2a05ce9f5b2084fda7bba9449,1,Todd Lipcon,2017-02-11 00:51:51+00:00,['60aedaaf4b20a725d7ca2b0f774f73adc5992427'],22,348,370,1014017,3,0.635802469,1,1,1914
41dd9d41a1e6a8a0b60104e26ed1f0ece04158e6,1,Todd Lipcon,2017-02-11 00:51:58+00:00,['5833debe325a1db2a05ce9f5b2084fda7bba9449'],22,143,165,1014182,4,0.158730159,1,1,1915
a9287093954bf2de64642605c7f9522f281830db,0,Jean-Daniel Cryans,2017-02-11 03:32:37+00:00,['41dd9d41a1e6a8a0b60104e26ed1f0ece04158e6'],38,87,125,1014307,3,0.047619048,1,0.952380952,1915
594c212451d9089a6e518f03f999201e71aafcb7,0,Todd Lipcon,2017-02-13 05:26:08+00:00,['a9287093954bf2de64642605c7f9522f281830db'],62,6,68,1014375,6,0,0,0,1915
61f95748b5e49c7afd02fa281254303aa797a2ea,0,Jean-Daniel Cryans,2017-02-13 15:57:12+00:00,['594c212451d9089a6e518f03f999201e71aafcb7'],7,7,14,1014389,1,,,,1915
49c48174d17ae74925bebab0be3ef2a02a0d786b,1,Todd Lipcon,2017-02-13 22:09:37+00:00,['61f95748b5e49c7afd02fa281254303aa797a2ea'],52,194,246,1014635,16,0.482142857,0,1,1915
f7d5c73dd06f0388bd4cb46ef3c24c94886baa09,0,Adar Dembo,2017-02-13 23:39:33+00:00,['49c48174d17ae74925bebab0be3ef2a02a0d786b'],10343,1,10344,1024979,19,0.689655172,0,0.088669951,1915
098a1e58192cbd012828d9436e4c61fd79c53d38,1,Todd Lipcon,2017-02-14 05:55:51+00:00,['f7d5c73dd06f0388bd4cb46ef3c24c94886baa09'],360,619,979,1025958,22,0,0.75,0.775641026,1915
186ac44c24bd074606d3cbbbabbd054570640377,1,Todd Lipcon,2017-02-14 08:50:01+00:00,['098a1e58192cbd012828d9436e4c61fd79c53d38'],1,71,72,1026030,3,0,0,1,1915
a094504655b645b1585a5611f1ecf29c9b04ec65,0,Alexey Serbin,2017-02-14 16:02:45+00:00,['186ac44c24bd074606d3cbbbabbd054570640377'],41,40,81,1026111,4,,,,1915
c4b44dc141dbd03bf332e86db9a7ea73197679dd,0,Todd Lipcon,2017-02-14 17:20:22+00:00,['a094504655b645b1585a5611f1ecf29c9b04ec65'],66,123,189,1026300,6,,,,1917
a29871f306464c5ef5f586431ac6f4f1bed026ae,0,Todd Lipcon,2017-02-14 18:41:38+00:00,['c4b44dc141dbd03bf332e86db9a7ea73197679dd'],1,3,4,1026304,3,0,0,1,1917
3e659dcd914adfbdc544b083dfd1e0686b9018c4,0,Todd Lipcon,2017-02-14 22:09:40+00:00,['a29871f306464c5ef5f586431ac6f4f1bed026ae'],8,15,23,1026327,1,,,,1917
0898a5bbca96066410c5c11e2aff9ec6d334d54b,0,Alexey Serbin,2017-02-14 23:51:31+00:00,['3e659dcd914adfbdc544b083dfd1e0686b9018c4'],0,87,87,1026414,2,0,1,1,1917
07c6efb58eace6564e28280536441a8df05f7757,1,Alexey Serbin,2017-02-14 23:51:40+00:00,['0898a5bbca96066410c5c11e2aff9ec6d334d54b'],72,68,140,1026554,4,1,1,1,1917
91c93d317d359ebe48f7ecc71d7b9f6b6fd75faa,0,Todd Lipcon,2017-02-15 18:11:14+00:00,['07c6efb58eace6564e28280536441a8df05f7757'],6,54,60,1026614,5,0,0.931034483,1,1917
4a5ab7368c9c3be39779d44f6bf701b1a925ce09,0,Todd Lipcon,2017-02-15 18:24:51+00:00,['91c93d317d359ebe48f7ecc71d7b9f6b6fd75faa'],3,26,29,1026643,1,0,0,0,1917
56402bd1a48efaed486c2f92f5897096bce2ddbb,0,Todd Lipcon,2017-02-15 18:36:05+00:00,['4a5ab7368c9c3be39779d44f6bf701b1a925ce09'],1,4,5,1026648,1,,,,1917
daf289d6b20376f7207445c5d270e73eb1995126,1,Adar Dembo,2017-02-15 20:59:20+00:00,['56402bd1a48efaed486c2f92f5897096bce2ddbb'],7,159,166,1026814,7,0.234567901,0.987654321,0.950617284,1917
79ffb17d7f4f324b4cace9cd4255cad4f11bef4d,0,Todd Lipcon,2017-02-15 21:16:59+00:00,['daf289d6b20376f7207445c5d270e73eb1995126'],93,63,156,1026970,20,0.210526316,0.210526316,0,1917
987cbc23f35e424fbfb1b5a7f9df3377d7dc46da,0,Mike Percy,2017-02-15 22:48:09+00:00,['79ffb17d7f4f324b4cace9cd4255cad4f11bef4d'],38,46,84,1027054,2,1,0,0,1917
9c2b73290fcccfb9cc99634d6a376b1f050ff5a2,0,Adar Dembo,2017-02-16 00:43:44+00:00,['987cbc23f35e424fbfb1b5a7f9df3377d7dc46da'],1,1,2,1027056,1,,,,1917
fc7255a57e8ff4ce3d30dbab586ed2c08ef65875,1,Todd Lipcon,2017-02-16 07:15:08+00:00,['9c2b73290fcccfb9cc99634d6a376b1f050ff5a2'],287,257,544,1027600,6,0.954545455,0.227272727,0,1917
7027a168b2f2eeba7f22e3ec5d3b1d3eaadf2df2,0,Todd Lipcon,2017-02-16 07:15:24+00:00,['fc7255a57e8ff4ce3d30dbab586ed2c08ef65875'],37,37,74,1027674,6,,,,1917
a23341acd77b39f709d7bb2b7748aeb9edd29f44,0,Todd Lipcon,2017-02-16 07:29:55+00:00,['7027a168b2f2eeba7f22e3ec5d3b1d3eaadf2df2'],2,2,4,1027678,1,,,,1917
8067304f673492742262b57f0fb23c1334a97274,0,Todd Lipcon,2017-02-16 07:38:00+00:00,['a23341acd77b39f709d7bb2b7748aeb9edd29f44'],43,318,361,1028039,8,0.611940299,0.544776119,1,1917
93ec241a9cb105d1e7bb680d29ef42ebe173ff8e,0,Dan Burkert,2017-02-17 00:45:55+00:00,['8067304f673492742262b57f0fb23c1334a97274'],2,28,30,1028069,4,0.571428571,0.571428571,1,1917
b73a714b97a32b2a9cd90e7e89c5b1be65eb31c1,0,Todd Lipcon,2017-02-17 04:58:04+00:00,['93ec241a9cb105d1e7bb680d29ef42ebe173ff8e'],22,159,181,1028250,15,0.368421053,1,1,1917
0b0781beeb7a15adf060ca46141ecabe70737f72,0,Dan Burkert,2017-02-17 06:16:26+00:00,['b73a714b97a32b2a9cd90e7e89c5b1be65eb31c1'],12,180,192,1028442,4,0,0.899224806,0.953488372,1917
4bac532799de315e0720af167403b38be0e3e421,1,Todd Lipcon,2017-02-17 08:02:35+00:00,['0b0781beeb7a15adf060ca46141ecabe70737f72'],448,1256,1704,1030146,28,0.02739726,0.01369863,0.817351598,1917
7b695d955e2d97ccc015869d9dfa7f3cb562d454,0,Todd Lipcon,2017-02-17 17:29:22+00:00,['4bac532799de315e0720af167403b38be0e3e421'],20,10,30,1030176,1,1,1,0,1917
f0af095e575e383269e5b47f5f197a91b1b2d675,0,Jean-Daniel Cryans,2017-02-17 17:37:46+00:00,['7b695d955e2d97ccc015869d9dfa7f3cb562d454'],2,4,6,1030182,1,0.5,0.5,1,1917
866287c53a0c3ef14f83fafe3f9454e0685fb7aa,1,Todd Lipcon,2017-02-17 17:40:34+00:00,['f0af095e575e383269e5b47f5f197a91b1b2d675'],75,83,158,1030340,5,0.714285714,1,0,1917
de69932749e33663bb8d49db5a4d2f3fc74bbbaf,0,Todd Lipcon,2017-02-17 17:41:42+00:00,['866287c53a0c3ef14f83fafe3f9454e0685fb7aa'],4,5,9,1030349,1,,,,1917
47409f4a59a9d52ca69618534793cb3eb0b0e748,0,Todd Lipcon,2017-02-17 17:45:19+00:00,['de69932749e33663bb8d49db5a4d2f3fc74bbbaf'],3,2,5,1030354,1,,,,1917
2ec86e28dab691df8461443074535e8670a02af8,1,Todd Lipcon,2017-02-17 17:47:12+00:00,['47409f4a59a9d52ca69618534793cb3eb0b0e748'],45,165,210,1030564,6,0,1,0.746031746,1918
e522d90f0f018a7ad6f51b9f0b6bcfdfdac78581,0,Jean-Daniel Cryans,2017-02-17 18:43:56+00:00,['2ec86e28dab691df8461443074535e8670a02af8'],5,13,18,1030582,1,,,,1918
b1c1da617d0fc5d64849b62b6521a63f613235ea,0,Jean-Daniel Cryans,2017-02-17 18:45:27+00:00,['e522d90f0f018a7ad6f51b9f0b6bcfdfdac78581'],1,1,2,1030584,1,,,,1918
6abafd7b723bf1452797fd461976a408ddc52099,1,Adar Dembo,2017-02-17 20:42:09+00:00,['b1c1da617d0fc5d64849b62b6521a63f613235ea'],12,95,107,1030691,9,0.888888889,0.972222222,1,1918
50801300fd3e954a0224050d1f3d3811f187ee09,0,Adar Dembo,2017-02-17 20:44:47+00:00,['6abafd7b723bf1452797fd461976a408ddc52099'],12,10,22,1030713,1,1,1,1,1918
1ff368465d3df4e2ced7fa87b87faa4303ceaeee,0,Jean-Daniel Cryans,2017-02-17 21:23:57+00:00,['50801300fd3e954a0224050d1f3d3811f187ee09'],0,15,15,1030728,1,1,1,1,1918
750b8979c17d290d6f2c67ae65a13edefd8da9a2,1,Alexey Serbin,2017-02-18 02:39:06+00:00,['1ff368465d3df4e2ced7fa87b87faa4303ceaeee'],28,52,80,1030808,8,0,1,0.692307692,1918
f5274584ac422172936e8d12ba0eebada374b8d7,0,Mike Percy,2017-02-20 19:05:25+00:00,['750b8979c17d290d6f2c67ae65a13edefd8da9a2'],2,3,5,1030813,2,,,,1918
0767cd78007dc4073f32511a6a194f925d52f614,0,Todd Lipcon,2017-02-21 02:10:17+00:00,['f5274584ac422172936e8d12ba0eebada374b8d7'],8,7,15,1030828,1,,,,1918
2b0edbe31ee6e75bc454d6398ac2974fc275b1d5,0,Mike Percy,2017-02-21 10:23:19+00:00,['0767cd78007dc4073f32511a6a194f925d52f614'],7,7,14,1030842,1,,,,1918
d03d374ac0de84dad0a502b16a02e4040240f72b,0,Adar Dembo,2017-02-21 19:10:31+00:00,['2b0edbe31ee6e75bc454d6398ac2974fc275b1d5'],1,90,91,1030933,2,,,,1919
6098da159dc04e8637d1ccf06349ddf5d03bbe46,1,Todd Lipcon,2017-02-21 21:49:11+00:00,['d03d374ac0de84dad0a502b16a02e4040240f72b'],1,43,44,1030977,1,0,1,1,1919
1140567010ffbb7522d7ceacc246fd0983d1e178,1,Todd Lipcon,2017-02-21 21:51:31+00:00,['6098da159dc04e8637d1ccf06349ddf5d03bbe46'],3,31,34,1031011,1,0,0,1,1919
1bf12cf929a6aaf2d50aed618f69b55dc8e822af,0,Todd Lipcon,2017-02-21 21:52:28+00:00,['1140567010ffbb7522d7ceacc246fd0983d1e178'],2,2,4,1031015,1,,,,1919
a099e85e20f0b104d092b03168c2bdf5f892aeb8,0,Todd Lipcon,2017-02-21 22:21:48+00:00,['1bf12cf929a6aaf2d50aed618f69b55dc8e822af'],1,7,8,1031023,1,,,,1919
91a35784efa1bf3a294ae3da483d89f7ffe1d70b,0,Adar Dembo,2017-02-21 22:30:28+00:00,['a099e85e20f0b104d092b03168c2bdf5f892aeb8'],1,1,2,1031025,1,,,,1919
48cc975f5ff05da565cde82961cfdd5271b1bcf9,1,Todd Lipcon,2017-02-21 22:56:09+00:00,['91a35784efa1bf3a294ae3da483d89f7ffe1d70b'],330,797,1127,1032152,17,0.036764706,0.830882353,0.911764706,1919
c06a3bc66e59e9467b599e85714825347aacf7ec,0,Todd Lipcon,2017-02-21 23:00:55+00:00,['48cc975f5ff05da565cde82961cfdd5271b1bcf9'],42,587,629,1032781,11,0.542857143,0.564285714,0.978571429,1920
b5734eadd4835df2f116b45a052a1adeb2dabc59,0,Todd Lipcon,2017-02-22 01:18:49+00:00,['c06a3bc66e59e9467b599e85714825347aacf7ec'],127,518,645,1033426,7,0.53038674,1,1,1921
6ec831234fd1682c22a6a2cb547dbaff96188f95,0,Alexey Serbin,2017-02-22 01:44:09+00:00,['b5734eadd4835df2f116b45a052a1adeb2dabc59'],2,20,22,1033448,3,0.461538462,0.461538462,0.461538462,1921
11ba0ccfa196dd44db1dff1f803275cd2aea3421,0,Todd Lipcon,2017-02-22 01:46:40+00:00,['6ec831234fd1682c22a6a2cb547dbaff96188f95'],1,1,2,1033450,1,,,,1921
2f95904fc39fbe767b18cb193a271dcba5538215,0,Alexey Serbin,2017-02-22 01:48:22+00:00,['11ba0ccfa196dd44db1dff1f803275cd2aea3421'],52,0,52,1033502,2,1,0,0,1921
4c9ea94a57f3aeac2f499d70b4a6b8935738a2f3,0,Mike Percy,2017-02-22 03:07:15+00:00,['2f95904fc39fbe767b18cb193a271dcba5538215'],0,3,3,1033505,1,0,0,1,1921
77e884935400a1c26994bbbe8c9b9d758b2592f3,0,Todd Lipcon,2017-02-22 04:48:57+00:00,['4c9ea94a57f3aeac2f499d70b4a6b8935738a2f3'],8,17,25,1033530,4,0.6,0.6,1,1921
66e57564be49f1bfb701b51655a1fe3a1a8178d7,0,Todd Lipcon,2017-02-22 04:49:23+00:00,['77e884935400a1c26994bbbe8c9b9d758b2592f3'],0,93,93,1033623,2,0.964285714,1,1,1922
3102e3833bcf32a290b63e8d6cae917b62194ac6,1,Todd Lipcon,2017-02-22 04:51:37+00:00,['66e57564be49f1bfb701b51655a1fe3a1a8178d7'],158,149,307,1033930,5,1,0,0.454545455,1922
dc454dcd082d0ca879aef911391751254d96c3f2,1,Todd Lipcon,2017-02-22 05:53:26+00:00,['3102e3833bcf32a290b63e8d6cae917b62194ac6'],33,96,129,1034059,16,0.459459459,1,0.756756757,1922
70ea7fb19cbd4474a0c4bc09e84f2f6276a1e917,1,Todd Lipcon,2017-02-22 17:09:28+00:00,['dc454dcd082d0ca879aef911391751254d96c3f2'],49,122,171,1034230,7,0,0,1,1922
dc1e45a9a8571b6c93f1357a61322ad0d6b6cea9,0,Alexey Serbin,2017-02-22 17:58:44+00:00,['70ea7fb19cbd4474a0c4bc09e84f2f6276a1e917'],45,58,103,1034333,5,0.714285714,1,0.428571429,1922
07e55ed0b93f13bab89c1f19c33e94add69edc00,0,Alexey Serbin,2017-02-22 21:32:11+00:00,['dc1e45a9a8571b6c93f1357a61322ad0d6b6cea9'],10,10,20,1034353,6,,,,1922
73aa301342200c3f5e06dacdcf59fdb5eb722925,0,Todd Lipcon,2017-02-22 21:45:04+00:00,['07e55ed0b93f13bab89c1f19c33e94add69edc00'],10,77,87,1034440,2,0,0.365853659,1,1922
ed44a20dfe23d3c52cd2ae72d72a5886f563a6d8,0,Dan Burkert,2017-02-22 22:35:29+00:00,['73aa301342200c3f5e06dacdcf59fdb5eb722925'],28,32,60,1034500,9,,,,1922
3cd434e51af9d092baea34dd8cdd21317edcb168,1,Todd Lipcon,2017-02-22 23:51:58+00:00,['ed44a20dfe23d3c52cd2ae72d72a5886f563a6d8'],23,284,307,1034807,9,0.551181102,1,1,1923
914ed3b98533f18513a0ea9a6c47162c8b464100,1,Todd Lipcon,2017-02-23 01:01:24+00:00,['3cd434e51af9d092baea34dd8cdd21317edcb168'],181,28,209,1035016,7,0.957983193,0.445378151,0.168067227,1923
0bd10cb881d389eded337eb188a0bf30cc2483f3,0,Alexey Serbin,2017-02-23 01:27:32+00:00,['914ed3b98533f18513a0ea9a6c47162c8b464100'],3,29,32,1035048,1,,,,1923
69f2619d059e6aeb45f947b8367069b12f3b1bb9,0,Dan Burkert,2017-02-23 01:36:37+00:00,['0bd10cb881d389eded337eb188a0bf30cc2483f3'],28,85,113,1035161,2,1,1,0.230769231,1923
ed9ce952d8fcdf2110ce590b1ceb299918ec2536,1,Todd Lipcon,2017-02-23 01:58:56+00:00,['69f2619d059e6aeb45f947b8367069b12f3b1bb9'],62,315,377,1035538,18,0.393103448,1,1,1923
d6dac682b7cf515fb9fae78bf4daf12b9df164ce,1,Todd Lipcon,2017-02-23 01:59:16+00:00,['ed9ce952d8fcdf2110ce590b1ceb299918ec2536'],72,154,226,1035764,19,0.875,0.875,1,1925
a9137c0d2027e7f634436be797732f4e13b9e998,0,Todd Lipcon,2017-02-23 02:32:34+00:00,['d6dac682b7cf515fb9fae78bf4daf12b9df164ce'],19,114,133,1035897,4,0.519480519,0.662337662,1,1925
000cf8286890fa023dc39bf96bd8a461c4e77f74,1,Todd Lipcon,2017-02-23 02:51:07+00:00,['a9137c0d2027e7f634436be797732f4e13b9e998'],5,135,140,1036037,6,0,0.703703704,1,1925
4a0fa092121986a950aa30374dda15515ac02dc3,0,Alexey Serbin,2017-02-23 03:39:57+00:00,['000cf8286890fa023dc39bf96bd8a461c4e77f74'],0,11,11,1036048,2,0,1,1,1925
362eb53efffe05c13fdff824ea4656a458b79230,1,Todd Lipcon,2017-02-23 04:00:04+00:00,['4a0fa092121986a950aa30374dda15515ac02dc3'],46,100,146,1036194,7,0,0,0.230769231,1925
38df0f197f14907cbdf228517a045611e1a19df6,0,Todd Lipcon,2017-02-23 04:00:08+00:00,['362eb53efffe05c13fdff824ea4656a458b79230'],16,15,31,1036225,1,0,1,1,1925
ae5ed629a5bd5fc2240d9fd6403c02435e901148,0,Alexey Serbin,2017-02-23 04:57:48+00:00,['38df0f197f14907cbdf228517a045611e1a19df6'],2,2,4,1036229,1,,,,1925
1010bb4e9da941c0ba9254857081f5d4198bd4e4,0,Mike Percy,2017-02-23 21:36:42+00:00,['ae5ed629a5bd5fc2240d9fd6403c02435e901148'],1,1,2,1036231,1,,,,1925
1959e6f8ee53497fb29bde1d750c83636a02d9d2,0,Alexey Serbin,2017-02-24 00:08:22+00:00,['1010bb4e9da941c0ba9254857081f5d4198bd4e4'],7,9,16,1036247,1,0,1,1,1925
ac85351b377556bcda208ead7f1f3e1b82cfe2b9,1,Dan Burkert,2017-02-24 00:18:11+00:00,['1959e6f8ee53497fb29bde1d750c83636a02d9d2'],35,96,131,1036378,2,0.755555556,1,0.688888889,1925
fea449ace2f774ba648f4a847299bd290cd104d6,1,Mike Percy,2017-02-24 04:06:26+00:00,['ac85351b377556bcda208ead7f1f3e1b82cfe2b9'],144,1353,1497,1037875,26,0.33006993,0.574825175,0.793006993,1925
f76facd40f3473733f6c7c7f2f268bb799c44c3b,0,Dan Burkert,2017-02-24 23:35:39+00:00,['fea449ace2f774ba648f4a847299bd290cd104d6'],5,5,10,1037885,3,0,1,0,1925
758cf8b8d65973b650c3262f79ff7e0c843736ce,1,Todd Lipcon,2017-02-24 23:56:04+00:00,['f76facd40f3473733f6c7c7f2f268bb799c44c3b'],74,801,875,1038760,32,0.610655738,0.831967213,1,1930
981c5e1abeb6b02b69dc291781c10d5571af464d,0,Adar Dembo,2017-02-25 02:55:24+00:00,['758cf8b8d65973b650c3262f79ff7e0c843736ce'],4,7,11,1038771,2,0,1,1,1930
ed2bc18de1e7318b621bb957aaf6ffbc850ef1b8,1,Alexey Serbin,2017-02-25 03:37:12+00:00,['981c5e1abeb6b02b69dc291781c10d5571af464d'],70,68,138,1038909,14,1,0,0,1930
085f1e04a8e9daca1bc5aa35666be507c7a800c8,0,Todd Lipcon,2017-02-26 21:43:48+00:00,['ed2bc18de1e7318b621bb957aaf6ffbc850ef1b8'],3,4,7,1038916,1,,,,1930
0c3f82db1f8602f8a9047dbf5493b3d4eb9d9524,1,Todd Lipcon,2017-02-26 22:36:07+00:00,['085f1e04a8e9daca1bc5aa35666be507c7a800c8'],1,4,5,1038921,1,1,1,1,1930
b2fc399f65411c537194aee68018178938bab855,0,Alexey Serbin,2017-02-28 01:43:09+00:00,['0c3f82db1f8602f8a9047dbf5493b3d4eb9d9524'],10,34,44,1038965,1,0.666666667,1,1,1930
b39bfcb4c919024abe2bd6e92ad7e4d9444c54f6,0,Alexey Serbin,2017-02-28 01:57:23+00:00,['b2fc399f65411c537194aee68018178938bab855'],14,15,29,1038994,1,0,0,0,1930
99ed6297244e009c9b7a371c1517ee7b733a30d1,0,Alexey Serbin,2017-02-28 02:42:48+00:00,['b39bfcb4c919024abe2bd6e92ad7e4d9444c54f6'],8,12,20,1039014,2,,,,1930
2730f8bd5a00de9e9f0efa6059607cfae434336a,0,Todd Lipcon,2017-02-28 05:49:13+00:00,['99ed6297244e009c9b7a371c1517ee7b733a30d1'],1,3,4,1039018,1,,,,1930
50274c8f8bc4da19323694be8793612942002509,0,Todd Lipcon,2017-02-28 06:19:46+00:00,['2730f8bd5a00de9e9f0efa6059607cfae434336a'],5,10,15,1039033,1,1,1,1,1930
8f54f6049434196e80f3f4adeb450348a013bad4,0,Todd Lipcon,2017-02-28 06:43:32+00:00,['50274c8f8bc4da19323694be8793612942002509'],5,9,14,1039047,1,,,,1930
c11a315e73a20211caf71f2b3797e71af8449af4,0,Todd Lipcon,2017-02-28 20:52:51+00:00,['8f54f6049434196e80f3f4adeb450348a013bad4'],2,81,83,1039130,2,0,1,1,1930
92fe87f5e2db57f520ba96fc4b63f1d13a48b185,0,Todd Lipcon,2017-02-28 21:13:04+00:00,['c11a315e73a20211caf71f2b3797e71af8449af4'],5,57,62,1039192,7,0,0.939393939,0.96969697,1930
cbb07d23f18c055ff1ae659cfec19f734eeb0403,0,Todd Lipcon,2017-02-28 21:24:41+00:00,['92fe87f5e2db57f520ba96fc4b63f1d13a48b185'],25,42,67,1039259,2,1,1,1,1930
368f4f734e4acbab2bdb19b824e2ba26cb2cfaa6,0,Todd Lipcon,2017-02-28 21:24:47+00:00,['cbb07d23f18c055ff1ae659cfec19f734eeb0403'],5,16,21,1039280,2,1,1,1,1930
5fe0787f62939c96c416dc00f5f447843b1f0ea6,0,Dan Burkert,2017-03-01 01:44:18+00:00,['368f4f734e4acbab2bdb19b824e2ba26cb2cfaa6'],33,62,95,1039375,5,0.875,1,0.125,1930
75279b54682d71e37f9a2cc720180e8c690520a0,0,David Ribeiro Alves,2017-03-01 01:59:56+00:00,['5fe0787f62939c96c416dc00f5f447843b1f0ea6'],1,10,11,1039386,1,0,1,1,1930
3ae7fe1c93b24f88049db3fcd1a9d7bf5278942d,0,Todd Lipcon,2017-03-01 02:25:11+00:00,['75279b54682d71e37f9a2cc720180e8c690520a0'],5,0,5,1039391,1,1,0,0,1930
79706b0ab3e746f94519a1b49c8960c3c75fd36d,0,Todd Lipcon,2017-03-01 03:06:39+00:00,['3ae7fe1c93b24f88049db3fcd1a9d7bf5278942d'],0,4,4,1039395,1,0,1,1,1930
1e7aafd2a0f5d67c54eb0f5748c563267812a2fc,1,Todd Lipcon,2017-03-01 03:06:43+00:00,['79706b0ab3e746f94519a1b49c8960c3c75fd36d'],1,314,315,1039710,5,0.50867052,0.895953757,0.670520231,1931
02ce2a8a23fb127697c10dffea84dcfa2f2b3933,0,Todd Lipcon,2017-03-01 05:45:06+00:00,['1e7aafd2a0f5d67c54eb0f5748c563267812a2fc'],1,4,5,1039715,1,1,0,0,1931
815fd0ac87952fcfbbffcc2e3e936b49827c53c4,0,Todd Lipcon,2017-03-01 05:57:11+00:00,['02ce2a8a23fb127697c10dffea84dcfa2f2b3933'],5,5,10,1039725,1,,,,1931
9591957b80f1a5c4f7b785dbcd051100f8ee5b85,1,Dan Burkert,2017-03-01 05:58:49+00:00,['815fd0ac87952fcfbbffcc2e3e936b49827c53c4'],18,73,91,1039816,5,0.028571429,0.057142857,1,1931
8f8dfe174a943bbe833f6be1ebdbfc4313f5c1ec,0,Dan Burkert,2017-03-01 07:17:01+00:00,['9591957b80f1a5c4f7b785dbcd051100f8ee5b85'],22,49,71,1039887,3,0.555555556,0.555555556,1,1931
82882f6a3e5b853951266b83a8fa500e44bf726a,0,David Ribeiro Alves,2017-03-01 07:43:39+00:00,['8f8dfe174a943bbe833f6be1ebdbfc4313f5c1ec'],1,3,4,1039891,1,0,0.5,1,1931
0efc1e26a9a00feff35b5fd27a19558fb8758054,0,Dan Burkert,2017-03-01 18:34:29+00:00,['82882f6a3e5b853951266b83a8fa500e44bf726a'],52,100,152,1040043,17,0,0,1,1931
f726f6ab4a94948cef8233eb45220bcf8eb4771f,0,Todd Lipcon,2017-03-01 18:57:03+00:00,['0efc1e26a9a00feff35b5fd27a19558fb8758054'],27,85,112,1040155,3,0.028571429,1,1,1931
0609277c4209c02fd94d7c6fd6c23abd8b1d3b67,0,Todd Lipcon,2017-03-01 18:57:13+00:00,['f726f6ab4a94948cef8233eb45220bcf8eb4771f'],0,16,16,1040171,1,0,1,1,1931
5fdad79aaec56766ef8c0310e27ad433d2508c1e,1,Todd Lipcon,2017-03-01 20:00:10+00:00,['0609277c4209c02fd94d7c6fd6c23abd8b1d3b67'],28,60,88,1040259,4,1,1,1,1931
0ee93e31a1febb987c72e7392a69b2584e6f38ed,0,Todd Lipcon,2017-03-01 20:00:24+00:00,['5fdad79aaec56766ef8c0310e27ad433d2508c1e'],32,49,81,1040340,8,0,0,0,1931
93b54f0fff4df90e43bf6874122d47b325678356,0,Todd Lipcon,2017-03-01 20:01:29+00:00,['0ee93e31a1febb987c72e7392a69b2584e6f38ed'],24,47,71,1040411,5,0,1,1,1931
1716d61ceac946cbd35e3517a9006d663d8bd1bc,0,Dan Burkert,2017-03-01 20:49:02+00:00,['93b54f0fff4df90e43bf6874122d47b325678356'],1,1,2,1040413,1,,,,1931
abbd09a57bf8ce3208c4403e18c8f914a8c91247,0,Dan Burkert,2017-03-01 21:03:15+00:00,['1716d61ceac946cbd35e3517a9006d663d8bd1bc'],2,2,4,1040417,1,,,,1931
55c3db350bd77d849f7cbba091b2a5f0c213cf29,1,Dan Burkert,2017-03-01 21:38:54+00:00,['abbd09a57bf8ce3208c4403e18c8f914a8c91247'],11,13,24,1040441,2,1,1,1,1931
479cf7f4b33c0d0b77cbf537c8fa77b2110101c0,0,Todd Lipcon,2017-03-01 23:36:10+00:00,['55c3db350bd77d849f7cbba091b2a5f0c213cf29'],0,12,12,1040453,2,0.666666667,0.833333333,1,1931
13ea03146195f26d31eb113010976a0d4d86ce87,0,Todd Lipcon,2017-03-02 06:23:29+00:00,['479cf7f4b33c0d0b77cbf537c8fa77b2110101c0'],1,0,1,1040454,1,,,,1931
3907340a28bad494cc28a0c93431372a811159d0,0,David Ribeiro Alves,2017-03-02 17:22:55+00:00,['13ea03146195f26d31eb113010976a0d4d86ce87'],58,368,426,1040880,4,0.113636364,0.877272727,0.795454545,1931
ef6e5b58b1ac1425202aaa16dd32bb447f60d814,1,Todd Lipcon,2017-03-02 21:11:10+00:00,['3907340a28bad494cc28a0c93431372a811159d0'],106,254,360,1041240,13,0,0.2875,0.65,1931
18b15d6c788e0ba4aa937c8cff8b79d8d539e6a7,0,Jean-Daniel Cryans,2017-03-02 21:22:12+00:00,['ef6e5b58b1ac1425202aaa16dd32bb447f60d814'],10,10,20,1041260,10,,,,1931
f6a1a60760296e7014d5d7b04ce68d0835721da8,0,Todd Lipcon,2017-03-03 00:07:24+00:00,['18b15d6c788e0ba4aa937c8cff8b79d8d539e6a7'],12,29,41,1041301,4,0.714285714,1,0.714285714,1931
9cb5b24f7f957a3ecca1ae1bf034d3ad9defa03a,1,Todd Lipcon,2017-03-03 00:09:10+00:00,['f6a1a60760296e7014d5d7b04ce68d0835721da8'],46,100,146,1041447,11,0,1,0.914285714,1931
8db89686fcbacbd6df453a8ac465fa24781af6ef,0,Todd Lipcon,2017-03-03 00:11:44+00:00,['9cb5b24f7f957a3ecca1ae1bf034d3ad9defa03a'],2,2,4,1041451,1,,,,1931
889a04ad9f5d4c28758c0ad1f5dbe52f43d93550,0,David Ribeiro Alves,2017-03-03 00:38:38+00:00,['8db89686fcbacbd6df453a8ac465fa24781af6ef'],1,1,2,1041453,1,,,,1931
28e9349fb775b0215cd2f7ae9a7531390f79d267,1,Dan Burkert,2017-03-03 02:09:01+00:00,['889a04ad9f5d4c28758c0ad1f5dbe52f43d93550'],29,61,90,1041543,5,0.074074074,0,0,1931
7c108db640753927b8ec5c98087144051437ea98,0,Alexey Serbin,2017-03-03 03:01:54+00:00,['28e9349fb775b0215cd2f7ae9a7531390f79d267'],4,9,13,1041556,1,1,1,1,1931
2f94fb665ca1e4fb750215f7522d06c5dfb0631f,0,Todd Lipcon,2017-03-03 05:40:39+00:00,['7c108db640753927b8ec5c98087144051437ea98'],39,44,83,1041639,1,1,1,0,1931
e9dfbe1e5dd38d4f77ab79537e7e5c6d30e56a1d,1,Todd Lipcon,2017-03-03 05:40:45+00:00,['2f94fb665ca1e4fb750215f7522d06c5dfb0631f'],2,128,130,1041769,7,0.196428571,0.517857143,0.982142857,1931
f1da1eb450cb77878d44d1115d64c05f652378f1,0,Todd Lipcon,2017-03-03 05:49:33+00:00,['e9dfbe1e5dd38d4f77ab79537e7e5c6d30e56a1d'],0,22,22,1041791,2,0,1,1,1931
7f2624ae4e0132aee24f6b7b2af31e2219ac31f0,0,Jean-Daniel Cryans,2017-03-03 15:44:54+00:00,['f1da1eb450cb77878d44d1115d64c05f652378f1'],2,10,12,1041803,4,0,0.857142857,1,1931
fff5cbda80b6cc2016c4bce012d2e183d3c3e2bb,1,Todd Lipcon,2017-03-06 18:44:59+00:00,['7f2624ae4e0132aee24f6b7b2af31e2219ac31f0'],31,118,149,1041952,3,0.571428571,0.095238095,0,1931
f65feff685099d0b166c4faf219c528476df4578,1,Mike Percy,2017-03-06 19:52:37+00:00,['fff5cbda80b6cc2016c4bce012d2e183d3c3e2bb'],36,110,146,1042098,7,0,0,0,1933
45548c90c788b6e482ceaa12789eaa2789232efc,0,Dan Burkert,2017-03-06 22:45:30+00:00,['f65feff685099d0b166c4faf219c528476df4578'],0,6,6,1042104,1,1,1,1,1933
573e232de129bc9b6afff524bfae7f4e5bfc9e7b,0,Mike Percy,2017-03-07 00:56:13+00:00,['45548c90c788b6e482ceaa12789eaa2789232efc'],32,49,81,1042185,4,1,1,0.8,1933
578bf84bb24ad386708c12cb598dbcb5c5b5c150,0,Mike Percy,2017-03-07 00:56:21+00:00,['573e232de129bc9b6afff524bfae7f4e5bfc9e7b'],12,49,61,1042246,5,0,0,0.75,1933
475920a21e9f8c13f48c453eefa3b7ad9be18e15,0,Alexey Serbin,2017-03-07 01:51:41+00:00,['578bf84bb24ad386708c12cb598dbcb5c5b5c150'],1,39,40,1042286,3,0.269230769,1,1,1933
f7fa057bd0527b19c6e100d412efe851be68b1db,0,David Ribeiro Alves,2017-03-07 02:06:31+00:00,['475920a21e9f8c13f48c453eefa3b7ad9be18e15'],3,37,40,1042326,4,0,0.642857143,1,1933
6c2c7c3a2954e0ac9a84fa366fc12d914a44cf4f,0,David Ribeiro Alves,2017-03-07 02:06:36+00:00,['f7fa057bd0527b19c6e100d412efe851be68b1db'],1,1,2,1042328,1,,,,1933
97831eadf1511449daebe25d3431472b55e3c21c,0,Alexey Serbin,2017-03-07 04:28:54+00:00,['6c2c7c3a2954e0ac9a84fa366fc12d914a44cf4f'],1,2,3,1042331,1,,,,1933
b6cf6b6b877062f2888d94493abe9c3bf97a29a5,0,Jean-Daniel Cryans,2017-03-07 18:17:17+00:00,['97831eadf1511449daebe25d3431472b55e3c21c'],1,1,2,1042333,1,,,,1933
f24307db4deda6e9da037514afc5573f1231cdfb,0,Dan Burkert,2017-03-07 23:50:37+00:00,['b6cf6b6b877062f2888d94493abe9c3bf97a29a5'],9,3,12,1042345,1,1,1,0,1933
5566bc902ef94a9ce825f7c2f939cf87428941df,1,Todd Lipcon,2017-03-08 00:34:29+00:00,['f24307db4deda6e9da037514afc5573f1231cdfb'],0,117,117,1042462,3,0.897435897,0.435897436,1,1934
72895966c6458d6f33e68d53450d9bd43a2c57b1,1,Todd Lipcon,2017-03-08 00:49:34+00:00,['5566bc902ef94a9ce825f7c2f939cf87428941df'],126,429,555,1043017,20,0.340909091,1,0.598484848,1935
62553e0b6dcbdc9822680afd35bba07855d1059a,0,Todd Lipcon,2017-03-08 18:37:26+00:00,['72895966c6458d6f33e68d53450d9bd43a2c57b1'],1,25,26,1043043,5,0.888888889,1,1,1935
5a24fe6742611c71fe272b37a1fd6afcc089c998,0,Alexey Serbin,2017-03-08 23:16:15+00:00,['62553e0b6dcbdc9822680afd35bba07855d1059a'],8,10,18,1043061,1,1,0,0,1935
937064f9187e07d2d1880d61cf67792eefe9a82d,0,Dan Burkert,2017-03-08 23:37:00+00:00,['5a24fe6742611c71fe272b37a1fd6afcc089c998'],2,96,98,1043159,5,1,1,1,1937
57a26b199571d0bb39ede709e8ee569370340417,0,Todd Lipcon,2017-03-09 19:13:57+00:00,['937064f9187e07d2d1880d61cf67792eefe9a82d'],66,78,144,1043303,1,0.777777778,0,1,1937
fc50b98aafd960d09c81d2837816285a4a0cf86d,0,Todd Lipcon,2017-03-09 20:37:25+00:00,['57a26b199571d0bb39ede709e8ee569370340417'],4,37,41,1043344,4,,,,1937
6db540070a9326190c30996851207dfa0fb8066d,1,Todd Lipcon,2017-03-10 00:51:33+00:00,['fc50b98aafd960d09c81d2837816285a4a0cf86d'],22,44,66,1043410,2,0,0,0,1938
abf772c7cc5ade8e0fbfc09a8a500f88be5d21c4,0,Todd Lipcon,2017-03-10 01:13:22+00:00,['6db540070a9326190c30996851207dfa0fb8066d'],37,26,63,1043473,15,,,,1938
542ba4ed78de05d78b2723bda79dda813bd7c74a,0,Todd Lipcon,2017-03-10 01:16:15+00:00,['abf772c7cc5ade8e0fbfc09a8a500f88be5d21c4'],172,358,530,1044003,3,,,,1938
5759a08d37b8f6e11160d024879a04b005e2c8f8,0,Todd Lipcon,2017-03-10 06:05:15+00:00,['542ba4ed78de05d78b2723bda79dda813bd7c74a'],37,177,214,1044217,11,0.442307692,0.519230769,0.826923077,1938
c5ec0ddb01da87de4a037a4879a4ef92c434930f,0,Dan Burkert,2017-03-10 21:56:19+00:00,['5759a08d37b8f6e11160d024879a04b005e2c8f8'],27,13,40,1044257,4,0,0,1,1938
80f951236323797c9166b285c693f0ce3d3898d9,0,Adar Dembo,2017-03-10 23:49:25+00:00,['c5ec0ddb01da87de4a037a4879a4ef92c434930f'],0,1,1,1044258,1,,,,1938
4a33783ee07f88a3bfc08f97e3f6d15fe1b73700,1,David Ribeiro Alves,2017-03-11 00:23:19+00:00,['80f951236323797c9166b285c693f0ce3d3898d9'],32,42,74,1044332,3,0,0.166666667,0.166666667,1938
fb9298a6bf3d199d68d5bd925a638929c2e8dfd5,0,Alexey Serbin,2017-03-11 08:30:15+00:00,['4a33783ee07f88a3bfc08f97e3f6d15fe1b73700'],1,0,1,1044333,1,1,1,0,1938
7034bffc1c851024759c8d6f644ee48bb43a1d67,0,Mike Percy,2017-03-11 08:37:32+00:00,['fb9298a6bf3d199d68d5bd925a638929c2e8dfd5'],4,4,8,1044341,2,,,,1938
c658c869689b9589e653e8a24568b9f95d6ff65d,0,Adar Dembo,2017-03-13 23:32:05+00:00,['7034bffc1c851024759c8d6f644ee48bb43a1d67'],1,38,39,1044380,3,0.888888889,1,1,1938
f4caa6371f34456fe322731ede9c39b8f840f9ff,0,Alexey Serbin,2017-03-15 04:06:02+00:00,['c658c869689b9589e653e8a24568b9f95d6ff65d'],8,10,18,1044398,1,1,1,1,1938
b42e9e519e8411f3be7d121c5976d45c27f438a6,1,Adar Dembo,2017-03-16 00:02:02+00:00,['f4caa6371f34456fe322731ede9c39b8f840f9ff'],22,161,183,1044581,13,0,1,0.674418605,1938
587173d26a6cb4a5c374724b23fdb064b8396c9d,0,Alexey Serbin,2017-03-16 03:01:38+00:00,['b42e9e519e8411f3be7d121c5976d45c27f438a6'],20,69,89,1044670,4,0,0.870967742,1,1938
d552c49308f545d9b007462d9030b4f4c3c5979f,1,Alexey Serbin,2017-03-16 03:04:48+00:00,['587173d26a6cb4a5c374724b23fdb064b8396c9d'],0,226,226,1044896,2,0.042105263,1,1,1939
2e462afc8f974f61e3ece556e44780455807888d,0,Will Berkeley,2017-03-16 05:40:46+00:00,['d552c49308f545d9b007462d9030b4f4c3c5979f'],1,7,8,1044904,1,1,1,1,1939
206a3f1f567cca961bb71c3061883c0484e64d3e,0,Jean-Daniel Cryans,2017-03-16 19:57:10+00:00,['2e462afc8f974f61e3ece556e44780455807888d'],121,67,188,1045092,1,0.452380952,0.119047619,0.380952381,1939
16dd6e4aa1c660120c331245bdefe2498a425957,0,Dan Burkert,2017-03-17 00:00:48+00:00,['206a3f1f567cca961bb71c3061883c0484e64d3e'],2,14,16,1045108,1,0,1,1,1939
a1bfd7bac1b83f1a37611b7f571e8c637f9ee9ec,0,Adar Dembo,2017-03-17 00:28:26+00:00,['16dd6e4aa1c660120c331245bdefe2498a425957'],0,11,11,1045119,3,0.666666667,1,1,1939
a72c28e699763cfeabadc4575b792e8d6cc1b191,0,Adar Dembo,2017-03-17 18:43:12+00:00,['a1bfd7bac1b83f1a37611b7f571e8c637f9ee9ec'],14,233,247,1045366,5,0.067901235,0.648148148,0.882716049,1939
8363b74506f8513e2fa9dbf772e30d0abce4e444,1,Mike Percy,2017-03-17 18:48:53+00:00,['a72c28e699763cfeabadc4575b792e8d6cc1b191'],28,237,265,1045631,11,0.2265625,0.9921875,1,1939
5df142fa35bf04231ee92b622482a1be0b18b294,0,Adar Dembo,2017-03-18 00:02:44+00:00,['8363b74506f8513e2fa9dbf772e30d0abce4e444'],22,32,54,1045685,2,0,1,1,1939
9b52ae1484642b0dce53a93e26aa13a6814ca783,0,Todd Lipcon,2017-03-18 00:03:04+00:00,['5df142fa35bf04231ee92b622482a1be0b18b294'],1,0,1,1045686,1,0,0,0,1939
6e13ede46428124d0c323d139f1a506a4ce093dc,0,Alexey Serbin,2017-03-18 02:15:54+00:00,['9b52ae1484642b0dce53a93e26aa13a6814ca783'],8,10,18,1045704,4,1,1,0,1939
af730a3573e82f5440437d0e4cf80defe18a7718,1,Alexey Serbin,2017-03-18 04:11:45+00:00,['6e13ede46428124d0c323d139f1a506a4ce093dc'],59,87,146,1045850,1,0.615384615,0,0,1939
4447803a22c3eb78adc7b4403e0fc3baea1e2223,0,Alexey Serbin,2017-03-18 20:15:57+00:00,['af730a3573e82f5440437d0e4cf80defe18a7718'],1,1,2,1045852,1,,,,1939
87bd862cb63785158affc065724b57bda7a5a7f4,0,Jean-Daniel Cryans,2017-03-21 23:24:14+00:00,['4447803a22c3eb78adc7b4403e0fc3baea1e2223'],0,18,18,1045870,1,,,,1939
0450f77f69c74cc6dec08ad36bb89ac12c17608f,1,Mike Percy,2017-03-22 00:37:32+00:00,['87bd862cb63785158affc065724b57bda7a5a7f4'],48,224,272,1046142,10,0.109756098,0.756097561,0.829268293,1940
889d1524650480ba7506152ac6df154267f9da08,0,Mike Percy,2017-03-22 00:37:40+00:00,['0450f77f69c74cc6dec08ad36bb89ac12c17608f'],29,27,56,1046198,2,,,,1940
fd90897c7c585365021d302bed614244edc63a71,0,Todd Lipcon,2017-03-22 07:22:38+00:00,['889d1524650480ba7506152ac6df154267f9da08'],10,11,21,1046219,3,,,,1940
4f51c66c56457955cbedec0d7ba5f8de785a6280,0,Todd Lipcon,2017-03-22 07:22:54+00:00,['fd90897c7c585365021d302bed614244edc63a71'],0,1,1,1046220,1,0,0,0,1940
3679eadb2c71b5ffa543862bf83fa69e49aecc7c,0,Todd Lipcon,2017-03-22 07:23:00+00:00,['4f51c66c56457955cbedec0d7ba5f8de785a6280'],10,17,27,1046247,2,1,1,1,1940
6ce5129479b44ad05c8cc37f35f0c279bc2eff4d,0,Todd Lipcon,2017-03-22 07:23:05+00:00,['3679eadb2c71b5ffa543862bf83fa69e49aecc7c'],30,67,97,1046344,6,1,1,1,1940
47520a7e8822a5fbbfd44155475ed2b8a540f768,0,Todd Lipcon,2017-03-22 22:28:53+00:00,['6ce5129479b44ad05c8cc37f35f0c279bc2eff4d'],8,6,14,1046358,2,,,,1940
02cbf8835d72157c348d8b4c1e34611b0bc05f44,0,Todd Lipcon,2017-03-24 18:46:12+00:00,['47520a7e8822a5fbbfd44155475ed2b8a540f768'],6,9,15,1046373,2,0,,,1940
cf25ec5c4436907ac03a16903c37506591cf272c,1,Todd Lipcon,2017-03-24 18:47:14+00:00,['02cbf8835d72157c348d8b4c1e34611b0bc05f44'],204,224,428,1046801,43,,,,1940
80026a34f66949da77bddf209579f51cfc997e2a,1,Mike Percy,2017-03-24 22:08:17+00:00,['cf25ec5c4436907ac03a16903c37506591cf272c'],111,1216,1327,1048128,17,0.018691589,0.493991989,0.93858478,1940
e4495d662fff444db646f1e5f67cf52c1d901e8b,0,Mike Percy,2017-03-24 22:46:07+00:00,['80026a34f66949da77bddf209579f51cfc997e2a'],15,84,99,1048227,7,0.64,0.92,0.92,1940
c3953ad01e91bfd5b10d2851c7db5cdf424eec8e,0,Todd Lipcon,2017-03-24 23:11:56+00:00,['e4495d662fff444db646f1e5f67cf52c1d901e8b'],9,21,30,1048257,4,0.666666667,0.666666667,1,1940
286de539213602f502f0a25fddde27f97ab9665b,1,Todd Lipcon,2017-03-24 23:12:03+00:00,['c3953ad01e91bfd5b10d2851c7db5cdf424eec8e'],11,11,22,1048279,2,,,,1940
4d2ea24b45aa35a1a6f17e17ccec19c106a4478e,0,Todd Lipcon,2017-03-24 23:48:17+00:00,['286de539213602f502f0a25fddde27f97ab9665b'],176,64,240,1048519,4,0.558139535,0.046511628,0.255813953,1940
86da259a6867674749209d7e07f89b4b9820cb42,1,Mike Percy,2017-03-26 00:28:03+00:00,['4d2ea24b45aa35a1a6f17e17ccec19c106a4478e'],691,697,1388,1049907,3,1,0,0,1941
0e188a309533028f2814cee47a3cfb66aefbd46f,1,Todd Lipcon,2017-03-27 17:08:46+00:00,['86da259a6867674749209d7e07f89b4b9820cb42'],43,99,142,1050049,1,,,,1941
0254216c18af036a62a11fcfae8a77b781d74aa2,0,Todd Lipcon,2017-03-27 18:07:11+00:00,['0e188a309533028f2814cee47a3cfb66aefbd46f'],2,65,67,1050116,4,0,1,1,1942
b719b1e7c7e2a78f8e818a9c8275b5d030835811,0,Todd Lipcon,2017-03-27 18:39:34+00:00,['0254216c18af036a62a11fcfae8a77b781d74aa2'],4,4,8,1050124,2,,,,1942
58e1d26d831a25835eb83aa21ac964f48792fdfb,0,Will Berkeley,2017-03-27 20:27:55+00:00,['b719b1e7c7e2a78f8e818a9c8275b5d030835811'],5,6,11,1050135,4,,,,1942
a51c9b0237dc7719e8103e33389ada5072d9631a,0,Todd Lipcon,2017-03-28 04:11:32+00:00,['58e1d26d831a25835eb83aa21ac964f48792fdfb'],44,22,66,1050201,2,0,0,0.833333333,1942
473221e20298f17d6416143ce7ce48013dbf2f8f,0,Todd Lipcon,2017-03-28 04:11:44+00:00,['a51c9b0237dc7719e8103e33389ada5072d9631a'],13,19,32,1050233,3,1,1,1,1942
824b0f46dc3d1443ad10db1b07cb085cb5bd7a4e,0,Will Berkeley,2017-03-28 16:45:42+00:00,['473221e20298f17d6416143ce7ce48013dbf2f8f'],20,64,84,1050317,4,,,,1942
023629af2788f473f18bd2a6ee38152c8bf437f2,0,Will Berkeley,2017-03-29 15:35:56+00:00,['824b0f46dc3d1443ad10db1b07cb085cb5bd7a4e'],17,33,50,1050367,1,,,,1942
6e74cefda7ce8e325ae4275ae3a7f2eb801a862f,0,Mike Percy,2017-03-29 21:26:35+00:00,['023629af2788f473f18bd2a6ee38152c8bf437f2'],13,0,13,1050380,1,,,,1942
4be39feef4907550c16f9d2b34430d098b9f1b21,1,Todd Lipcon,2017-03-29 21:52:20+00:00,['6e74cefda7ce8e325ae4275ae3a7f2eb801a862f'],48,219,267,1050647,13,0.074626866,0.97761194,1,1942
f8e88fa0be3bb64c5f05e755e3db55f3ac7cb998,0,Todd Lipcon,2017-03-30 01:20:43+00:00,['4be39feef4907550c16f9d2b34430d098b9f1b21'],31,33,64,1050711,1,1,1,0,1942
08b8ec9e1a7949bf569353eafdf029b6d0276473,0,Todd Lipcon,2017-03-30 01:21:59+00:00,['f8e88fa0be3bb64c5f05e755e3db55f3ac7cb998'],6,7,13,1050724,1,0,1,1,1942
bee8e875e21acb1d36f104f8388fc9ed6c963821,1,Todd Lipcon,2017-03-30 21:03:17+00:00,['08b8ec9e1a7949bf569353eafdf029b6d0276473'],36,160,196,1050920,8,0.403225806,0.580645161,0.967741935,1943
7206041f937f6c1dbd515e7cff4cd006573dc7d5,0,Dan Burkert,2017-04-03 18:54:49+00:00,['bee8e875e21acb1d36f104f8388fc9ed6c963821'],1,1,2,1050922,2,,,,1943
2407c2cb1e413c705ceb2b9479fe74d9cc432883,0,Adar Dembo,2017-04-04 01:02:23+00:00,['7206041f937f6c1dbd515e7cff4cd006573dc7d5'],24,496,520,1051442,10,0.047368421,0.721052632,1,1946
2bc2c322e7be7af456ce26b0022b35dff8e654d6,0,Jean-Daniel Cryans,2017-04-04 19:42:51+00:00,['2407c2cb1e413c705ceb2b9479fe74d9cc432883'],20,2,22,1051464,2,1,0,0.1,1946
ac6e24fc2299430b5f70146324bef2d2e8a4b8bc,0,Jean-Daniel Cryans,2017-04-04 19:45:04+00:00,['2bc2c322e7be7af456ce26b0022b35dff8e654d6'],4,19,23,1051487,1,0,0.4,1,1946
fcb150c1adcdd4595261433ad81358be7c0cc3a0,0,Jean-Daniel Cryans,2017-04-04 19:58:02+00:00,['ac6e24fc2299430b5f70146324bef2d2e8a4b8bc'],1,105,106,1051593,2,,,,1947
f4272eb5cebf0d2f5e38b457cfe536cc5b25d537,1,Mike Percy,2017-04-04 20:11:22+00:00,['fcb150c1adcdd4595261433ad81358be7c0cc3a0'],208,233,441,1052034,2,0,1,0.5,1947
055ea58bf94e6fdc7df1902fcb73b288d6f7316b,0,Todd Lipcon,2017-04-04 22:41:39+00:00,['f4272eb5cebf0d2f5e38b457cfe536cc5b25d537'],1,6,7,1052041,1,0.5,1,0.5,1947
71deb95efb73435850a19f4513b3023fbbe0ea34,1,Dan Burkert,2017-04-05 17:48:57+00:00,['055ea58bf94e6fdc7df1902fcb73b288d6f7316b'],62,20,82,1052123,3,,,,1947
94899aad07e067d6895915e2bb6b5770edd69d7e,1,Dan Burkert,2017-04-05 17:51:25+00:00,['71deb95efb73435850a19f4513b3023fbbe0ea34'],210,1025,1235,1053358,10,0.352459016,0.852459016,0.942622951,1952
34310a8e9f050165ce9c93ae36f575ac408b6312,0,Dan Burkert,2017-04-05 17:51:29+00:00,['94899aad07e067d6895915e2bb6b5770edd69d7e'],14,14,28,1053386,2,,,,1952
516d67eb119d7e1b361eb017a00909f89b645e13,0,Todd Lipcon,2017-04-05 19:20:13+00:00,['34310a8e9f050165ce9c93ae36f575ac408b6312'],22,36,58,1053444,3,1,1,1,1952
df451907eabea62145226be5bb303a10a6c01004,0,Todd Lipcon,2017-04-05 23:10:27+00:00,['516d67eb119d7e1b361eb017a00909f89b645e13'],28,347,375,1053819,3,0.278481013,0.164556962,0.670886076,1952
27b3de7ab81b03e41422cac56e65f5e86cd0f0ee,0,Todd Lipcon,2017-04-05 23:10:37+00:00,['df451907eabea62145226be5bb303a10a6c01004'],14,130,144,1053963,3,0.089552239,0.134328358,1,1952
a3362eec8652fc18117440ef2a15ae0adc2020d8,0,Todd Lipcon,2017-04-05 23:21:19+00:00,['27b3de7ab81b03e41422cac56e65f5e86cd0f0ee'],82,106,188,1054151,7,1,0,0,1952
eca51710825b49175a7da324485e0d3fa1f255aa,0,Dan Burkert,2017-04-06 01:22:21+00:00,['a3362eec8652fc18117440ef2a15ae0adc2020d8'],1,5,6,1054157,1,,,,1952
4568f2a4cbd999d5a2ab64d285205b8d30997339,1,Todd Lipcon,2017-04-06 05:00:16+00:00,['eca51710825b49175a7da324485e0d3fa1f255aa'],83,304,387,1054544,6,0.293103448,0.379310345,1,1952
678a309b5d88e2fe9c6a0674ba7de00daee35cac,0,Alexey Serbin,2017-04-06 18:24:35+00:00,['4568f2a4cbd999d5a2ab64d285205b8d30997339'],17,16,33,1054577,1,,,,1952
cc6b8fbd9a22b60aaa6ee0b22db3c3ef92cdc186,0,Alexey Serbin,2017-04-06 19:40:19+00:00,['678a309b5d88e2fe9c6a0674ba7de00daee35cac'],19,5,24,1054601,5,,,,1952
2eba7001a393e8fbc1da81dccdbfe6eb52dbadd3,0,Alexey Serbin,2017-04-06 21:16:27+00:00,['cc6b8fbd9a22b60aaa6ee0b22db3c3ef92cdc186'],9,9,18,1054619,1,,,,1952
9badc5003adc6312469c9256b34f325a74bedb24,0,Alexey Serbin,2017-04-06 22:33:39+00:00,['2eba7001a393e8fbc1da81dccdbfe6eb52dbadd3'],5,6,11,1054630,2,,,,1952
b95d3a4facec6785fe00d0763ae79b0eed462991,0,Alexey Serbin,2017-04-07 18:45:13+00:00,['9badc5003adc6312469c9256b34f325a74bedb24'],4,11,15,1054645,1,0,1,1,1952
f304dd32f74d03e4b8d8d88b8cd56e2089c84879,0,Dan Burkert,2017-04-07 19:58:36+00:00,['b95d3a4facec6785fe00d0763ae79b0eed462991'],38,26,64,1054709,1,1,1,0,1952
31f4589bab563c853b1677f8e06096265b0110f1,0,Alexey Serbin,2017-04-07 20:15:48+00:00,['f304dd32f74d03e4b8d8d88b8cd56e2089c84879'],5,6,11,1054720,1,,,,1952
960a061c40a6e25797078e3fb16890e887ec67c3,0,Todd Lipcon,2017-04-07 21:04:51+00:00,['31f4589bab563c853b1677f8e06096265b0110f1'],2,2,4,1054724,1,,,,1952
795f5ee948e525941c575b231e2c1f9456c160ac,0,Alexey Serbin,2017-04-07 21:38:03+00:00,['960a061c40a6e25797078e3fb16890e887ec67c3'],39,190,229,1054953,4,0,0,1,1952
5f1ca4f3948a61b22946255e4ada895c77bc6adf,0,Todd Lipcon,2017-04-07 22:49:05+00:00,['795f5ee948e525941c575b231e2c1f9456c160ac'],19,111,130,1055083,7,0.490566038,0.962264151,0.962264151,1952
bd24f04fb43db9f1fcbf9a60ecc31824c3c79bfd,0,Dan Burkert,2017-04-10 17:24:43+00:00,['5f1ca4f3948a61b22946255e4ada895c77bc6adf'],34,60,94,1055177,2,0,0.6,1,1952
9d03677e45dfa5722d816645200071e4d78fb845,0,Dan Burkert,2017-04-10 19:48:00+00:00,['bd24f04fb43db9f1fcbf9a60ecc31824c3c79bfd'],4,70,74,1055251,1,,,,1952
1767eba471b5177a4198e73ddb60484e5fcce7cd,0,Alexey Serbin,2017-04-10 22:59:16+00:00,['9d03677e45dfa5722d816645200071e4d78fb845'],2,2,4,1055255,2,,,,1952
d5ac00c792616a6935e9786dd0183b33b3e6dfc9,0,Dan Burkert,2017-04-10 23:35:36+00:00,['1767eba471b5177a4198e73ddb60484e5fcce7cd'],0,243,243,1055498,1,,,,1953
c47730a377aef550f2d7a8ee1ded4bd5a2d40245,0,Todd Lipcon,2017-04-11 00:40:03+00:00,['d5ac00c792616a6935e9786dd0183b33b3e6dfc9'],0,391,391,1055889,6,0.371794872,1,1,1955
ee8592a1f48a95a58b60772fb9f4cdf63acc2186,1,Alexey Serbin,2017-04-11 17:41:33+00:00,['c47730a377aef550f2d7a8ee1ded4bd5a2d40245'],1,5,6,1055895,1,0,1,1,1955
02ca419bd158ad90a74e2cc66c8c5f7425e93b14,0,Jean-Daniel Cryans,2017-04-11 18:36:32+00:00,['ee8592a1f48a95a58b60772fb9f4cdf63acc2186'],89,713,802,1056697,3,0.694864048,0.806646526,0.806646526,1955
da75b66d2fee1b8dc9fd815c4c8192fe9dae789a,0,Alexey Serbin,2017-04-11 21:20:29+00:00,['02ca419bd158ad90a74e2cc66c8c5f7425e93b14'],32,50,82,1056779,1,0,1,1,1955
d91740006fb37eecc61d855b77f7314bdcc1025b,0,Todd Lipcon,2017-04-11 21:26:07+00:00,['da75b66d2fee1b8dc9fd815c4c8192fe9dae789a'],30,36,66,1056845,1,1,1,0.4,1955
87154f4a39c77ab92d80f3effa58de3000921127,0,Dan Burkert,2017-04-11 21:27:43+00:00,['d91740006fb37eecc61d855b77f7314bdcc1025b'],0,35,35,1056880,1,,,,1955
4649cd8af9c1fb3867639fa75d89ac1bddd35f66,0,Dan Burkert,2017-04-12 01:29:24+00:00,['87154f4a39c77ab92d80f3effa58de3000921127'],6,6,12,1056892,1,,,,1955
9adbd90d170a0a525e8aef05939ba211ca6c3a41,0,Todd Lipcon,2017-04-12 02:57:20+00:00,['4649cd8af9c1fb3867639fa75d89ac1bddd35f66'],87,234,321,1057213,8,1,1,1,1956
ab0f44565e421088aaa444d93873f52c6ba006f7,1,Jean-Daniel Cryans,2017-04-12 20:15:26+00:00,['9adbd90d170a0a525e8aef05939ba211ca6c3a41'],224,132,356,1057569,9,0.301886792,0,0,1956
548721090e313c4d67af9453cf8a34e89dd31259,0,Jean-Daniel Cryans,2017-04-12 23:23:24+00:00,['ab0f44565e421088aaa444d93873f52c6ba006f7'],0,87,87,1057656,1,0,1,1,1957
642e01190ca19882b5052739bae5508b0b38b32e,0,Dan Burkert,2017-04-13 00:24:42+00:00,['548721090e313c4d67af9453cf8a34e89dd31259'],6,171,177,1057833,8,0.333333333,0,0.466666667,1957
b204477a41542291caecb35c23e4a51da7386157,0,David Ribeiro Alves,2017-04-13 05:53:50+00:00,['642e01190ca19882b5052739bae5508b0b38b32e'],3,84,87,1057920,6,0.139534884,1,0.279069767,1957
b89dc9a28e7f49a1b429ca0b976643f3b16d1563,0,Alexey Serbin,2017-04-13 22:40:51+00:00,['b204477a41542291caecb35c23e4a51da7386157'],0,2,2,1057922,2,0.5,1,1,1957
83ce8e7534b8576781be3bc21e5ab6747e0eb032,0,Alexey Serbin,2017-04-14 18:58:24+00:00,['b89dc9a28e7f49a1b429ca0b976643f3b16d1563'],31,273,304,1058226,4,0.079470199,1,0.847682119,1957
5bdb694093887020f9ca607f57c0e7f32c5503e1,0,Alexey Serbin,2017-04-14 23:44:00+00:00,['83ce8e7534b8576781be3bc21e5ab6747e0eb032'],1,0,1,1058227,1,1,1,0,1957
6ed469079605b44d7bfe300b8ee6d4167a844c86,0,Todd Lipcon,2017-04-17 23:54:38+00:00,['5bdb694093887020f9ca607f57c0e7f32c5503e1'],0,10,10,1058237,1,0,1,1,1957
238249c962f9ffed0c691ce5a3f02b652b62b67e,0,Todd Lipcon,2017-04-18 01:39:16+00:00,['6ed469079605b44d7bfe300b8ee6d4167a844c86'],1,3,4,1058241,1,,,,1957
b5004e1886eb96839ec120da582f0a06ce869db2,0,Todd Lipcon,2017-04-18 18:31:33+00:00,['238249c962f9ffed0c691ce5a3f02b652b62b67e'],35,11,46,1058287,4,0.115384615,0.115384615,0.230769231,1957
3de172d6519a5ab0c74fbab75349eb17214502d9,1,Alexey Serbin,2017-04-18 18:41:12+00:00,['b5004e1886eb96839ec120da582f0a06ce869db2'],26,31,57,1058344,6,0,1,1,1957
5132624f260da959f0cb1d1c8944f33da886c08d,0,Alexey Serbin,2017-04-18 20:57:25+00:00,['3de172d6519a5ab0c74fbab75349eb17214502d9'],6,2,8,1058352,1,,,,1957
b5592dc3df630f8ece857ea5444943c9e1beec33,0,Adar Dembo,2017-04-18 21:29:42+00:00,['5132624f260da959f0cb1d1c8944f33da886c08d'],11,35,46,1058398,4,0.884615385,0.884615385,0.769230769,1957
1a5998e918dc6d964aa8a157b4f70b33874bba80,0,Adar Dembo,2017-04-18 23:57:38+00:00,['b5592dc3df630f8ece857ea5444943c9e1beec33'],1,1,2,1058400,1,,,,1957
d5b98946a2c6d060a33054fff9314bac3f012c20,0,Todd Lipcon,2017-04-19 00:46:19+00:00,['1a5998e918dc6d964aa8a157b4f70b33874bba80'],1,2,3,1058403,1,,,,1957
6200da9807007a01d22812b47f937354811c370a,0,Todd Lipcon,2017-04-19 00:46:46+00:00,['d5b98946a2c6d060a33054fff9314bac3f012c20'],1,3,4,1058407,2,,,,1957
e56f81b5d4e97deff3d071e1e3bfa421485d73ff,0,Mike Percy,2017-04-19 01:01:43+00:00,['6200da9807007a01d22812b47f937354811c370a'],0,1,1,1058408,1,0,1,1,1957
a342d6533df653cb5f946b78eab74b2abf7e6410,0,Todd Lipcon,2017-04-19 01:22:21+00:00,['e56f81b5d4e97deff3d071e1e3bfa421485d73ff'],46,11,57,1058465,3,0.1,0.1,0.2,1957
95db53ab890bc9db6d4aceb73083364c9289cadd,0,Alexey Serbin,2017-04-19 17:54:04+00:00,['a342d6533df653cb5f946b78eab74b2abf7e6410'],2,2,4,1058469,1,,,,1957
49363aae5e90abaea0118d836b7c34ce4ab7ef53,0,Todd Lipcon,2017-04-19 19:16:28+00:00,['95db53ab890bc9db6d4aceb73083364c9289cadd'],1,3,4,1058473,2,,,,1957
998e4cabeb19828c15984102816006f09c155af4,0,Adar Dembo,2017-04-19 20:00:14+00:00,['49363aae5e90abaea0118d836b7c34ce4ab7ef53'],1,1,2,1058475,1,,,,1957
b2843ee5ef9a666a2376cfe4ae44a8d0ceb4503f,0,Jean-Daniel Cryans,2017-04-20 16:23:09+00:00,['998e4cabeb19828c15984102816006f09c155af4'],1,1,2,1058477,1,,,,1957
319a1bc15923b7859a93d6ee8258f03df60a2385,1,Dan Burkert,2017-04-20 20:40:38+00:00,['b2843ee5ef9a666a2376cfe4ae44a8d0ceb4503f'],28,447,475,1058952,7,0.192982456,0.513157895,0.907894737,1957
baf86dcc58fa65a4736f50d0236ef70549fc5999,0,Jean-Daniel Cryans,2017-04-20 22:34:47-07:00,['6bf862997f4a3497efbea1c3d77178c0eff84e3d'],1,1,2,1058954,1,,,,1957
54348ce1c9670d8118dc493be8a8a5c263fe2970,0,GitHub,2017-04-21 10:27:31-07:00,"['6bf862997f4a3497efbea1c3d77178c0eff84e3d', 'baf86dcc58fa65a4736f50d0236ef70549fc5999']",1,1,2,1058956,1,,,,1957
7e7feb7764ae3c9b3713488f4f5d9cab2c5d0981,0,Dan Burkert,2017-04-21 20:02:11+00:00,['319a1bc15923b7859a93d6ee8258f03df60a2385'],6,10,16,1058972,3,0,1,0,1957
37081565821de90892eb2ff20b4a44aef26ece05,1,Dan Burkert,2017-04-21 20:02:17+00:00,['7e7feb7764ae3c9b3713488f4f5d9cab2c5d0981'],5,146,151,1059123,5,0.122222222,0.266666667,1,1957
21f5ae0d53f9e1a299529cb4c481634a0bdafbf1,0,Dan Burkert,2017-04-24 22:41:30+00:00,['37081565821de90892eb2ff20b4a44aef26ece05'],1,1,2,1059125,1,,,,1957
df9da6a84381795e2334bf21d8337f6f72333571,0,Jean-Daniel Cryans,2017-04-26 17:52:39+00:00,['21f5ae0d53f9e1a299529cb4c481634a0bdafbf1'],21,107,128,1059253,4,,,,1957
ec10fd36585a5553a943823e8144a3078aa1a61f,1,Alexey Serbin,2017-04-26 20:24:56+00:00,['df9da6a84381795e2334bf21d8337f6f72333571'],24,102,126,1059379,5,0.513513514,1,1,1957
f03d47ed4698623df1f308f0fddab4e8ccbc86db,0,Todd Lipcon,2017-04-26 21:22:48+00:00,['ec10fd36585a5553a943823e8144a3078aa1a61f'],15,59,74,1059453,5,0.32,0.92,0.84,1957
2be32d5441827e0914ad9b5008545003bfda4575,1,Todd Lipcon,2017-04-26 21:25:47+00:00,['f03d47ed4698623df1f308f0fddab4e8ccbc86db'],613,373,986,1060439,14,1,0.627777778,0.138888889,1959
1edaee01f55f83eb1c8cb5f21daa11c3753d183b,0,Jean-Daniel Cryans,2017-04-27 03:17:36+00:00,['2be32d5441827e0914ad9b5008545003bfda4575'],2,6,8,1060447,1,0,0,1,1959
89f39c59e09a5abcdf8a28dacb468ca11b048fde,0,David Ribeiro Alves,2017-04-27 19:30:39+00:00,['1edaee01f55f83eb1c8cb5f21daa11c3753d183b'],47,199,246,1060693,3,0,0.634408602,0.634408602,1959
bcb08fcd92095f540b2df3b82e78660932d3a556,0,Jean-Daniel Cryans,2017-04-27 19:39:26+00:00,['89f39c59e09a5abcdf8a28dacb468ca11b048fde'],0,10,10,1060703,1,,,,1959
0b1adf1f6a1790b0d18af32c081a94994e56c110,0,Todd Lipcon,2017-04-27 21:24:41+00:00,['bcb08fcd92095f540b2df3b82e78660932d3a556'],1,44,45,1060748,2,1,1,0.615384615,1960
d521eac7894c05fa4fa6de0b542504670f78ecc7,0,Adar Dembo,2017-04-28 00:28:40+00:00,['0b1adf1f6a1790b0d18af32c081a94994e56c110'],46,33,79,1060827,10,1,0,0,1960
75dd83a46364a828b549f6404b646f42262d01b9,1,Adar Dembo,2017-04-28 00:28:52+00:00,['d521eac7894c05fa4fa6de0b542504670f78ecc7'],214,1101,1315,1062142,17,0.434017595,0.680351906,0.706744868,1962
9beedf965647e616c652c92fbababc1a9263846c,1,Adar Dembo,2017-04-28 00:29:02+00:00,['75dd83a46364a828b549f6404b646f42262d01b9'],38,856,894,1063036,5,0.043103448,0.700431034,0.987068966,1964
7b582a8969c1e67b24e1a81bc6f1490f6338d53a,0,Adar Dembo,2017-04-28 00:31:02+00:00,['9beedf965647e616c652c92fbababc1a9263846c'],2,2,4,1063040,1,,,,1964
31751df1ee8d05f620ff6dbf73e70fd7fd09a467,0,Alexey Serbin,2017-04-28 06:05:36+00:00,['7b582a8969c1e67b24e1a81bc6f1490f6338d53a'],0,1,1,1063041,1,,,,1964
b36b84ddb70a909873b8fb26a96d2adab68919b7,0,Jean-Daniel Cryans,2017-04-28 18:34:02+00:00,['31751df1ee8d05f620ff6dbf73e70fd7fd09a467'],93,462,555,1063596,12,0.474820144,0.503597122,0.582733813,1967
fdc022fe6231af20e307012d98c35b16cbfa7b33,0,Dan Burkert,2017-04-28 21:41:41+00:00,['b36b84ddb70a909873b8fb26a96d2adab68919b7'],0,96,96,1063692,5,0.245901639,1,1,1967
401baedf1586ee99e73478ccfe4618b0c663ced0,0,Adar Dembo,2017-04-28 22:17:00+00:00,['fdc022fe6231af20e307012d98c35b16cbfa7b33'],25,35,60,1063752,16,1,1,1,1967
63c68add1145a64e3a546eccf7cc98c16bba638a,1,Adar Dembo,2017-04-28 23:53:24+00:00,['401baedf1586ee99e73478ccfe4618b0c663ced0'],42,180,222,1063974,4,0.095238095,0.178571429,0.988095238,1967
abd09397fbd2919be83e280aa0c7a55e78b96c00,0,Adar Dembo,2017-04-29 00:10:51+00:00,['63c68add1145a64e3a546eccf7cc98c16bba638a'],53,90,143,1064117,1,0,0.769230769,1,1967
eccafbcfbd41324164f7df10219a2b9c3d161269,1,Alexey Serbin,2017-04-29 00:44:05+00:00,['abd09397fbd2919be83e280aa0c7a55e78b96c00'],74,232,306,1064423,10,0.522222222,0.777777778,0.911111111,1967
a57cb4ba7c714d8743bd80b04b33675718418bfe,0,Adar Dembo,2017-04-29 00:53:44+00:00,['eccafbcfbd41324164f7df10219a2b9c3d161269'],3,145,148,1064571,4,0.058139535,0.523255814,1,1967
eb79a7183bb4dc69562dbc5e24006be777d23d62,0,Adar Dembo,2017-04-29 00:53:46+00:00,['a57cb4ba7c714d8743bd80b04b33675718418bfe'],8,113,121,1064692,3,0,0.548387097,1,1967
d4cffa503ae8d913bf3834bcc92f75f80d1f640f,1,Alexey Serbin,2017-04-29 02:43:11+00:00,['eb79a7183bb4dc69562dbc5e24006be777d23d62'],35,529,564,1065256,16,0.211453744,0.629955947,0.898678414,1968
2a1aeb642c8f08fc9886b104709061fc228fd37d,0,Alexey Serbin,2017-04-29 19:28:12+00:00,['d4cffa503ae8d913bf3834bcc92f75f80d1f640f'],2,3,5,1065261,1,,,,1968
948770425bc66a0a86d34b129c7d5fe1fdf86eda,0,Mike Percy,2017-04-29 19:38:04+00:00,['2a1aeb642c8f08fc9886b104709061fc228fd37d'],15,16,31,1065292,3,0,0,1,1968
3663e9a9dd8a1b1a9f77a4bb1cbdec9159c313bf,0,Adar Dembo,2017-05-01 03:54:21+00:00,['948770425bc66a0a86d34b129c7d5fe1fdf86eda'],164,78,242,1065534,13,0.431372549,0,0.745098039,1968
a17efaa36f9d8efc42f191d1258d7f36ed3c2add,0,Will Berkeley,2017-05-01 17:39:52+00:00,['3663e9a9dd8a1b1a9f77a4bb1cbdec9159c313bf'],96,910,1006,1066540,18,0.167820069,0.624567474,0.972318339,1968
28869e08618af83261b9a698d9445cb954967771,0,Adar Dembo,2017-05-02 01:27:56+00:00,['a17efaa36f9d8efc42f191d1258d7f36ed3c2add'],32,61,93,1066633,3,0,0,1,1968
50b84ae6b30a62db3d5d40e2e8f78545883e155a,0,Mike Percy,2017-05-02 02:32:09+00:00,['28869e08618af83261b9a698d9445cb954967771'],51,61,112,1066745,23,1,0,0,1968
b2e664a3746279ca2ee08818bf613d8af758d3a9,1,Mike Percy,2017-05-02 20:54:07+00:00,['50b84ae6b30a62db3d5d40e2e8f78545883e155a'],21,33,54,1066799,2,0.714285714,1,0.428571429,1968
6a118594cdb90350d1c0d4754f27b883a96aba56,1,Adar Dembo,2017-05-02 21:11:30+00:00,['b2e664a3746279ca2ee08818bf613d8af758d3a9'],81,297,378,1067177,8,0.273504274,0.752136752,0.641025641,1968
72e58eca93c36ed2dcce23032503b3d964a34236,0,Adar Dembo,2017-05-02 21:11:41+00:00,['6a118594cdb90350d1c0d4754f27b883a96aba56'],241,238,479,1067656,2,1,0.666666667,0,1968
867fc91cb89def6a46ad1f8173e87ca6970cfa85,0,Adar Dembo,2017-05-02 21:12:11+00:00,['72e58eca93c36ed2dcce23032503b3d964a34236'],0,43,43,1067699,3,1,1,1,1968
986ade9b0fc5eed892a7e63399745aed2ca82e98,0,Adar Dembo,2017-05-02 22:16:00+00:00,['867fc91cb89def6a46ad1f8173e87ca6970cfa85'],205,155,360,1068059,28,0.208333333,0.166666667,1,1968
20b3d5191c5b17321f04e5aea231d9023944562c,0,Alexey Serbin,2017-05-03 17:43:01+00:00,['986ade9b0fc5eed892a7e63399745aed2ca82e98'],1,1,2,1068061,1,,,,1968
10ab56ffe7aab4fc05e9a1f0ac8e3c2e3510b491,0,Mike Percy,2017-05-03 18:17:02+00:00,['20b3d5191c5b17321f04e5aea231d9023944562c'],0,86,86,1068147,2,,,,1969
ca7fffec94bd1e81dcc9ee819b3658fc7993ea8e,0,Jean-Daniel Cryans,2017-05-03 19:25:24+00:00,['10ab56ffe7aab4fc05e9a1f0ac8e3c2e3510b491'],80,148,228,1068375,6,0.588235294,0.882352941,0.705882353,1969
899e6a5e50586d3936b0c1f3e355ef463571585a,0,Adar Dembo,2017-05-03 21:59:05+00:00,['ca7fffec94bd1e81dcc9ee819b3658fc7993ea8e'],15,326,341,1068716,9,0.208121827,0.736040609,0.654822335,1969
75333640b6c07ee330450253bcb0787f6e9bc986,1,David Ribeiro Alves,2017-05-03 22:17:47+00:00,['899e6a5e50586d3936b0c1f3e355ef463571585a'],69,387,456,1069172,13,0.328042328,0.534391534,0.841269841,1969
b797913a60c21d75f2c816101a8ff7bb57137c39,0,Jean-Daniel Cryans,2017-05-03 23:52:00+00:00,['75333640b6c07ee330450253bcb0787f6e9bc986'],3,25,28,1069200,3,0.5,0.875,0.875,1969
c6af71856a23522ac3fae46a17d9d027cc6ee5c9,0,Todd Lipcon,2017-05-03 23:58:12+00:00,['b797913a60c21d75f2c816101a8ff7bb57137c39'],1,1,2,1069202,1,,,,1969
d07ecd6ded01201c912d2e336611a6a941f48d98,1,Todd Lipcon,2017-05-04 00:10:28+00:00,['c6af71856a23522ac3fae46a17d9d027cc6ee5c9'],4,79,83,1069285,4,0.239130435,1,1,1969
579cb0b145ad141cd3b49324406c85fe2ca96b15,0,Todd Lipcon,2017-05-04 00:30:09+00:00,['d07ecd6ded01201c912d2e336611a6a941f48d98'],28,26,54,1069339,2,1,1,1,1969
b15ea202d6a2be427614a876aa56d03b9c8b3a1b,0,Todd Lipcon,2017-05-04 02:32:53+00:00,['579cb0b145ad141cd3b49324406c85fe2ca96b15'],27,152,179,1069518,5,0.42,1,1,1970
a3c5983d8fa71f99e743bf384507baa5161332e4,0,Adar Dembo,2017-05-04 18:13:39+00:00,['b15ea202d6a2be427614a876aa56d03b9c8b3a1b'],76,10,86,1069604,4,1,0.58490566,0.58490566,1970
c36e6c40568e64a75a75dc208238b0c8ea6bd870,0,Todd Lipcon,2017-05-04 19:37:51+00:00,['a3c5983d8fa71f99e743bf384507baa5161332e4'],2,64,66,1069670,2,0,1,1,1970
621787943ad2b3c300408b17250fc28ae0e70dec,0,David Ribeiro Alves,2017-05-04 20:08:50+00:00,['c36e6c40568e64a75a75dc208238b0c8ea6bd870'],0,7,7,1069677,1,,,,1970
174a058e29750d27f4a873332d8cdde3b260292e,1,Adar Dembo,2017-05-04 20:11:53+00:00,['621787943ad2b3c300408b17250fc28ae0e70dec'],133,200,333,1070010,10,0.914285714,0.914285714,0.514285714,1970
dcd029eca777f44bc8dff922a2dedfaa8a99a6a9,0,David Ribeiro Alves,2017-05-04 20:38:12+00:00,['174a058e29750d27f4a873332d8cdde3b260292e'],0,8,8,1070018,2,1,1,1,1970
89806c6f69e28343beef99f31c1c81118e4019a1,1,Mike Percy,2017-05-04 20:44:41+00:00,['dcd029eca777f44bc8dff922a2dedfaa8a99a6a9'],26,299,325,1070343,13,0.18128655,0.304093567,0.590643275,1970
5ae27d733fed878f4a8c110e93ef7e57bb48f30e,1,Mike Percy,2017-05-04 20:44:46+00:00,['89806c6f69e28343beef99f31c1c81118e4019a1'],204,374,578,1070921,8,0.583333333,0.21875,1,1970
1fe2e9877c29f7b92a3a2745138432471146a5dd,0,Todd Lipcon,2017-05-04 20:47:47+00:00,['5ae27d733fed878f4a8c110e93ef7e57bb48f30e'],0,50,50,1070971,1,,,,1970
14e9d3d26bd4af68b761f65e179e39d1dab35312,0,Mike Percy,2017-05-04 20:50:15+00:00,['1fe2e9877c29f7b92a3a2745138432471146a5dd'],3,5,8,1070979,1,,,,1970
7f72105b79b36480d132e0ed10f4cc7fbabd6dca,1,Mike Percy,2017-05-04 22:14:08+00:00,['14e9d3d26bd4af68b761f65e179e39d1dab35312'],927,930,1857,1072836,61,0,1,1,1970
e7334c2e6607ac0fa778499eda2df3f4cfcd3fe3,1,Alexey Serbin,2017-05-05 04:35:48+00:00,['7f72105b79b36480d132e0ed10f4cc7fbabd6dca'],35,414,449,1073285,8,0.64,0.993333333,1,1973
46a886cd22e86d3fdfee62aa6115054138db3a33,0,Alexey Serbin,2017-05-05 05:44:09+00:00,['e7334c2e6607ac0fa778499eda2df3f4cfcd3fe3'],7,30,37,1073322,1,,,,1973
da2055f64d9ed717be6a3ca62868964aa54dc57d,0,Todd Lipcon,2017-05-05 18:26:56+00:00,['46a886cd22e86d3fdfee62aa6115054138db3a33'],2,31,33,1073355,3,0.733333333,1,1,1973
7169b8b7ac86ac27a7d89f44fb82f87eae4394bb,0,Todd Lipcon,2017-05-05 18:27:04+00:00,['da2055f64d9ed717be6a3ca62868964aa54dc57d'],24,33,57,1073412,3,0,0.375,0,1973
30d9e72cd504f20a5c1435c2c8dc822415756544,0,David Ribeiro Alves,2017-05-05 20:35:51+00:00,['7169b8b7ac86ac27a7d89f44fb82f87eae4394bb'],3,10,13,1073425,2,0,1,1,1973
4df9f59698dbc4808dfe055dba99b1f8745ede95,1,Todd Lipcon,2017-05-05 20:48:33+00:00,['30d9e72cd504f20a5c1435c2c8dc822415756544'],115,123,238,1073663,5,1,0,0,1973
d0ffa4ac6e2b383832ebe1ca377081aa93b01d77,1,Mike Percy,2017-05-05 22:11:52+00:00,['4df9f59698dbc4808dfe055dba99b1f8745ede95'],61,102,163,1073826,4,0,0,0,1973
04e8ea244d7d8793d876082381b5797625b16b44,0,Adar Dembo,2017-05-06 00:40:08+00:00,['d0ffa4ac6e2b383832ebe1ca377081aa93b01d77'],48,355,403,1074229,13,0.428571429,0.114285714,1,1974
ddd898106b9582c17f48843710722e2f9547cfeb,1,Alexey Serbin,2017-05-09 00:00:14+00:00,['04e8ea244d7d8793d876082381b5797625b16b44'],1,3,4,1074233,1,,,,1974
17e24812c96d7e64bcb06b201d37b5a160672e05,0,David Ribeiro Alves,2017-05-09 19:55:23+00:00,['ddd898106b9582c17f48843710722e2f9547cfeb'],18,12,30,1074263,2,,,,1974
b1aacd91c26654479cfce828519098ed63be600e,0,Todd Lipcon,2017-05-09 20:47:35+00:00,['17e24812c96d7e64bcb06b201d37b5a160672e05'],0,9,9,1074272,1,0,0.888888889,1,1974
40aa4c3c271c9df20a17a1d353ce582ee3fda742,0,Todd Lipcon,2017-05-09 20:47:46+00:00,['b1aacd91c26654479cfce828519098ed63be600e'],7,21,28,1074300,1,0,0.166666667,1,1974
c4c796a250b697c6e25b0b8be14887027c9e1d37,0,Alexey Serbin,2017-05-09 21:02:42+00:00,['40aa4c3c271c9df20a17a1d353ce582ee3fda742'],4,0,4,1074304,1,0,0,0,1974
a877566e9477242c015758d105c8e616248af7c6,0,Dan Burkert,2017-05-10 00:22:08+00:00,['c4c796a250b697c6e25b0b8be14887027c9e1d37'],16,80,96,1074400,5,1,1,1,1974
dfa13cd84da6474f926adb13b899da0d8cd271d7,0,David Ribeiro Alves,2017-05-10 01:08:58+00:00,['a877566e9477242c015758d105c8e616248af7c6'],1,1,2,1074402,1,,,,1974
a50ca5d9070efc9166265f5503ff3dc0bc27e68d,0,Will Berkeley,2017-05-10 01:56:26+00:00,['dfa13cd84da6474f926adb13b899da0d8cd271d7'],2,5,7,1074409,2,0,0.333333333,0.333333333,1974
d3f7b385c8041cb03568095f2ffe8f030f73f9bb,0,Will Berkeley,2017-05-10 17:32:28+00:00,['a50ca5d9070efc9166265f5503ff3dc0bc27e68d'],1,4,5,1074414,1,0,1,1,1974
b927e80a805a0ac078c22c49071e35962f7141d3,1,Adar Dembo,2017-05-10 18:43:42+00:00,['d3f7b385c8041cb03568095f2ffe8f030f73f9bb'],56,325,381,1074795,10,0.06626506,0.445783133,0.656626506,1974
6b6593a0ce9dff6d4adf35084d3e4aba24816a26,1,David Ribeiro Alves,2017-05-10 22:46:27+00:00,['b927e80a805a0ac078c22c49071e35962f7141d3'],140,497,637,1075432,7,0.214285714,0.807142857,0.971428571,1975
ca642204fa88ad26e7855af34efae331ea50c74a,0,Adar Dembo,2017-05-10 23:26:35+00:00,['6b6593a0ce9dff6d4adf35084d3e4aba24816a26'],3,2,5,1075437,1,,,,1975
f0580499dc50e8a47ff6251301cdc15b9b79edcb,0,David Ribeiro Alves,2017-05-10 23:44:39+00:00,['ca642204fa88ad26e7855af34efae331ea50c74a'],0,28,28,1075465,1,0,0,1,1975
501e4cd71d9f861a6fd05cadd1717ec4c220b324,0,Adar Dembo,2017-05-11 00:43:42+00:00,['f0580499dc50e8a47ff6251301cdc15b9b79edcb'],27,19,46,1075511,2,,,,1975
e4e59bb5a349514236778926bcc77c8f033da04d,1,Adar Dembo,2017-05-11 00:43:52+00:00,['501e4cd71d9f861a6fd05cadd1717ec4c220b324'],20,157,177,1075688,3,0.151898734,0.379746835,0,1975
83885ffffa47a77a7206414987d07d5945525e66,0,Alexey Serbin,2017-05-11 01:20:44+00:00,['e4e59bb5a349514236778926bcc77c8f033da04d'],6,25,31,1075719,3,0.714285714,0.714285714,1,1975
87ddf0ae2584f2394bb26d36c01c16e6719659db,0,Alexey Serbin,2017-05-11 01:39:00+00:00,['83885ffffa47a77a7206414987d07d5945525e66'],2,11,13,1075732,1,0,0,1,1975
ae7cfa04a64e8f9a494db36c4f20e11cea311845,0,Alexey Serbin,2017-05-11 02:20:07+00:00,['87ddf0ae2584f2394bb26d36c01c16e6719659db'],4,3,7,1075739,1,,,,1975
e6141a0adf6e3c5a54be8cfdf5acd0f1ff65f714,0,David Ribeiro Alves,2017-05-11 04:18:44+00:00,['ae7cfa04a64e8f9a494db36c4f20e11cea311845'],28,20,48,1075787,2,1,0.125,0,1975
43fbfdff9abc1516c8489e2f477e8b9fca22878f,0,Todd Lipcon,2017-05-11 06:01:15+00:00,['e6141a0adf6e3c5a54be8cfdf5acd0f1ff65f714'],10,35,45,1075832,3,1,1,1,1975
dce25916f428659072fd1e140a9081829956468e,0,Todd Lipcon,2017-05-11 16:25:10+00:00,['43fbfdff9abc1516c8489e2f477e8b9fca22878f'],6,96,102,1075934,4,0.652173913,1,1,1976
de1daf282f1d045ab2fe3652771f545e67551367,0,Alexey Serbin,2017-05-11 18:12:08+00:00,['dce25916f428659072fd1e140a9081829956468e'],4,9,13,1075947,1,0,1,1,1976
a0006dbaa77c276c6498dc4edc0228cae049738c,0,Alexey Serbin,2017-05-11 20:29:23+00:00,['de1daf282f1d045ab2fe3652771f545e67551367'],5,78,83,1076030,2,0,1,1,1976
293a971fb7669a095472d77c26a9f5bedabeb331,0,Adar Dembo,2017-05-11 21:13:40+00:00,['a0006dbaa77c276c6498dc4edc0228cae049738c'],254,61,315,1076345,15,0,0,0,1976
b2d247fa4a49e68436d88e5b7519b0708cf4ff08,0,Adar Dembo,2017-05-11 21:13:44+00:00,['293a971fb7669a095472d77c26a9f5bedabeb331'],2,33,35,1076380,33,,,,1976
a7e8994e446035897a79e26f4cfd12258b62e0cd,0,Dan Burkert,2017-05-11 23:05:20+00:00,['b2d247fa4a49e68436d88e5b7519b0708cf4ff08'],1,1,2,1076382,1,,,,1976
4ec6280c96b8900d0d587526b999f3a03e8ebec6,0,Dan Burkert,2017-05-12 06:00:44+00:00,['a7e8994e446035897a79e26f4cfd12258b62e0cd'],97,2,99,1076481,3,,,,1976
6fc8cc3a6c1b5f27d404bf7d8db17f3ac7101939,0,Jean-Daniel Cryans,2017-05-12 15:01:46+00:00,['4ec6280c96b8900d0d587526b999f3a03e8ebec6'],6,1,7,1076488,1,,,,1976
c26e09ef510f2fd4cfab7cde0bb811127ee14b7c,1,Adar Dembo,2017-05-13 00:05:40+00:00,['6fc8cc3a6c1b5f27d404bf7d8db17f3ac7101939'],57,67,124,1076612,5,1,1,0,1976
4af33ba134372f6887bff288b882dd00c4fd8b43,0,Adar Dembo,2017-05-13 01:38:37+00:00,['c26e09ef510f2fd4cfab7cde0bb811127ee14b7c'],100,54,154,1076766,5,1,1,0.756097561,1976
e2705897bc56bb4daab87e9169be56a3292211c2,1,Dan Burkert,2017-05-15 21:03:44+00:00,['4af33ba134372f6887bff288b882dd00c4fd8b43'],8,37,45,1076811,4,1,1,0.5,1976
b28a59266ca842a5e6e6ced44af4160fab4b528f,0,Todd Lipcon,2017-05-15 21:38:10+00:00,['e2705897bc56bb4daab87e9169be56a3292211c2'],4,0,4,1076815,1,1,1,0,1976
af9bcf29e99671c2a5e8e28895f30db22583efdc,0,Alexey Serbin,2017-05-15 22:47:04+00:00,['b28a59266ca842a5e6e6ced44af4160fab4b528f'],10,21,31,1076846,2,0.333333333,0.333333333,0.333333333,1976
0230ca58a4fa4351e0067995adc136a1d79c7147,0,Alexey Serbin,2017-05-15 22:47:15+00:00,['af9bcf29e99671c2a5e8e28895f30db22583efdc'],0,4,4,1076850,1,1,1,1,1976
85817f72b2703c3e9c4b584dfb3c55f8eadd933d,0,Adar Dembo,2017-05-15 23:10:31+00:00,['0230ca58a4fa4351e0067995adc136a1d79c7147'],40,33,73,1076923,6,0,0,0,1976
91f1f3715d4c13ef66bbb757ba9ff896298540da,1,Adar Dembo,2017-05-15 23:10:33+00:00,['85817f72b2703c3e9c4b584dfb3c55f8eadd933d'],44,331,375,1077298,8,0,0.52173913,0.341614907,1976
2f62443e1afb8c582e2ddd841219d15878e4bf92,0,Will Berkeley,2017-05-16 20:11:32+00:00,['91f1f3715d4c13ef66bbb757ba9ff896298540da'],1,5,6,1077304,1,0,1,0,1976
b492d8ed3cc66e8fafe6e97f45ac9731de1e584f,0,Will Berkeley,2017-05-16 20:12:24+00:00,['2f62443e1afb8c582e2ddd841219d15878e4bf92'],59,130,189,1077493,6,0.047619048,0.174603175,1,1976
58f1a21696aa5b65ad1e5086cb5d6800f50fe367,1,Alexey Serbin,2017-05-16 20:21:24+00:00,['b492d8ed3cc66e8fafe6e97f45ac9731de1e584f'],74,304,378,1077871,13,0.122641509,0,0.377358491,1976
a4b71fafc1ed6e2b9b7c6969376f5e6fb7d1e707,0,Will Berkeley,2017-05-16 22:51:19+00:00,['58f1a21696aa5b65ad1e5086cb5d6800f50fe367'],2,31,33,1077904,2,0,1,1,1976
edd9840b0252e59313495a99ec35d996b6808248,0,Alexey Serbin,2017-05-16 23:04:21+00:00,['a4b71fafc1ed6e2b9b7c6969376f5e6fb7d1e707'],12,7,19,1077923,1,0,0,0,1976
c82c0f48c96f281b0d6988d367f95ea1b511711d,0,Todd Lipcon,2017-05-16 23:24:42+00:00,['edd9840b0252e59313495a99ec35d996b6808248'],0,2,2,1077925,1,0,1,1,1976
6311acb2faf4f78964fe95cb07ab9331bc2657f7,0,Todd Lipcon,2017-05-16 23:31:13+00:00,['c82c0f48c96f281b0d6988d367f95ea1b511711d'],99,298,397,1078322,8,0.527777778,0.805555556,1,1976
80700aaf5f65c67afeab86c3ee4c1280ca094f7f,0,Todd Lipcon,2017-05-17 01:11:21+00:00,['6311acb2faf4f78964fe95cb07ab9331bc2657f7'],3,12,15,1078337,1,1,1,1,1976
3db551f7b31def26c0fa04184843d3dfa6161d9a,1,Alexey Serbin,2017-05-17 01:35:59+00:00,['80700aaf5f65c67afeab86c3ee4c1280ca094f7f'],139,751,890,1079227,24,0.250773994,0.622291022,0.476780186,1977
1d74c73e12fbe308e59bf1e175aa234e865daac1,1,Todd Lipcon,2017-05-17 18:25:53+00:00,['3db551f7b31def26c0fa04184843d3dfa6161d9a'],307,335,642,1079869,34,0.72,0.62,1,1977
0d7e2c63052517cca6be3478c288565bda46e2b4,0,Dan Burkert,2017-05-17 19:55:30+00:00,['1d74c73e12fbe308e59bf1e175aa234e865daac1'],0,5,5,1079874,1,0,1,1,1977
fd1f1699fda1d5e7031b7613fbc211d9d3ed4140,0,Dan Burkert,2017-05-17 20:45:38+00:00,['0d7e2c63052517cca6be3478c288565bda46e2b4'],20,10,30,1079904,2,0,0,0,1977
30d7592747a40feb8319d57f002583e80654855e,0,Todd Lipcon,2017-05-17 21:12:19+00:00,['fd1f1699fda1d5e7031b7613fbc211d9d3ed4140'],3,35,38,1079942,3,0.888888889,0.888888889,0.888888889,1977
7dd30b1c9c2e362efe2b81eb3acccd5c3b003e78,0,Todd Lipcon,2017-05-17 21:53:56+00:00,['30d7592747a40feb8319d57f002583e80654855e'],5,6,11,1079953,3,0,1,1,1977
c178563f646f1b0e9a9a562d02a252cbe20d820d,1,Dan Burkert,2017-05-18 00:25:11+00:00,['7dd30b1c9c2e362efe2b81eb3acccd5c3b003e78'],7,337,344,1080297,7,0.36,0.746666667,1,1977
1c5d91b588895009b516359cf59f76c9165bd2cc,0,Todd Lipcon,2017-05-18 03:28:26+00:00,['c178563f646f1b0e9a9a562d02a252cbe20d820d'],41,28,69,1080366,2,0,0,0,1977
e1104e4b8e64459d6a90c24d41ccc764d377c85c,0,Todd Lipcon,2017-05-18 05:04:14+00:00,['1c5d91b588895009b516359cf59f76c9165bd2cc'],6,7,13,1080379,2,1,1,1,1977
352c0e3bdaf36e44f5de6f5be2b9fbe9def1d6b2,0,Todd Lipcon,2017-05-18 05:04:19+00:00,['e1104e4b8e64459d6a90c24d41ccc764d377c85c'],3,1,4,1080383,1,,,,1977
36debad5fcbd6be3ab82c33e6cda1f7f349c643f,0,Todd Lipcon,2017-05-18 05:16:39+00:00,['352c0e3bdaf36e44f5de6f5be2b9fbe9def1d6b2'],1,1,2,1080385,1,,,,1977
4347174d7e78f27a69c28ef1c8e551649d2173c5,0,Dan Burkert,2017-05-18 15:57:10+00:00,['36debad5fcbd6be3ab82c33e6cda1f7f349c643f'],1,1,2,1080387,1,,,,1977
733afeb82d2c38332ee8e03ded4d93fb26a55517,1,Todd Lipcon,2017-05-18 16:46:57+00:00,['4347174d7e78f27a69c28ef1c8e551649d2173c5'],50,126,176,1080563,7,0,0.288888889,0.355555556,1977
068767b815ee75f988a406bfe4541e9602e0d831,0,Todd Lipcon,2017-05-18 17:10:49+00:00,['733afeb82d2c38332ee8e03ded4d93fb26a55517'],1,6,7,1080570,1,0,1,1,1977
1aa0ebb91fc072b4cd3ed629721b8263a6ba1ffe,1,Will Berkeley,2017-05-18 20:05:42+00:00,['068767b815ee75f988a406bfe4541e9602e0d831'],15,101,116,1080686,12,0.611111111,1,1,1977
65c3aec9aeb7cb684cac98add6f48b737ae0de85,0,Todd Lipcon,2017-05-19 00:32:28+00:00,['1aa0ebb91fc072b4cd3ed629721b8263a6ba1ffe'],4,48,52,1080738,4,0,1,1,1977
c45f4552420b18223dc8ce9dbc1b9398cd1d4f3d,0,Todd Lipcon,2017-05-19 19:12:27+00:00,['65c3aec9aeb7cb684cac98add6f48b737ae0de85'],4,4,8,1080746,1,,,,1977
b21911a577de7bb0a92b484260b4f254587c69ed,0,Will Berkeley,2017-05-19 20:14:56+00:00,['c45f4552420b18223dc8ce9dbc1b9398cd1d4f3d'],1,4,5,1080751,1,,,,1977
b46a2a22dcdcc290d51a8da5810a78272b52f716,0,Adar Dembo,2017-05-19 20:59:59+00:00,['b21911a577de7bb0a92b484260b4f254587c69ed'],5,13,18,1080769,1,0.25,0.25,1,1977
aeb7bf98b06d3a3539583f7c706954121af16f30,0,David Ribeiro Alves,2017-05-19 21:16:12+00:00,['b46a2a22dcdcc290d51a8da5810a78272b52f716'],5,67,72,1080841,4,0.708333333,1,1,1977
11f0775e828319c2d27eb530ae54400aa8d02206,0,Adar Dembo,2017-05-19 22:18:06+00:00,['aeb7bf98b06d3a3539583f7c706954121af16f30'],2,4,6,1080847,1,0,0,1,1977
795c43550ab1a0695d3c3b60d41699af2d5a7231,0,Todd Lipcon,2017-05-19 23:47:59+00:00,['11f0775e828319c2d27eb530ae54400aa8d02206'],4,0,4,1080851,1,,,,1977
952222b524a8ebe960a34d9012fd58d348512d58,1,Adar Dembo,2017-05-23 00:29:59+00:00,['795c43550ab1a0695d3c3b60d41699af2d5a7231'],149,140,289,1081140,2,1,0,0.227272727,1977
d354693c17b802fa34ef9362a8bf9e748b887a6b,0,Dan Burkert,2017-05-23 01:18:47+00:00,['952222b524a8ebe960a34d9012fd58d348512d58'],164,212,376,1081516,3,,,,1977
fb6cc895b9936dd6d4636be9a7eac59ef0590c80,0,Mike Percy,2017-05-23 23:50:54+00:00,['d354693c17b802fa34ef9362a8bf9e748b887a6b'],19,10,29,1081545,5,,,,1977
d84fc1072ffcd45a969afa043fb97c92537db79e,1,Dan Burkert,2017-05-24 01:33:17+00:00,['fb6cc895b9936dd6d4636be9a7eac59ef0590c80'],60,150,210,1081755,8,0,0,0.862068966,1977
f4b72c89278470dfb5be2faed8d0ffd7ddcfd314,1,Todd Lipcon,2017-05-24 02:13:46+00:00,['d84fc1072ffcd45a969afa043fb97c92537db79e'],48,23,71,1081826,1,0.55,0.2,0,1977
c5fe583e974ac3cc96ea212d3da6e4312385b0f5,0,Dan Burkert,2017-05-24 21:49:46+00:00,['f4b72c89278470dfb5be2faed8d0ffd7ddcfd314'],7,8,15,1081841,2,,,,1977
e2097c8b93ad7860712cc489ef9dcd64a0ac09f8,1,Mike Percy,2017-05-24 21:56:12+00:00,['c5fe583e974ac3cc96ea212d3da6e4312385b0f5'],71,521,592,1082433,14,0.056962025,0.287974684,0.648734177,1977
12683435f0e578957ee18c4e141e376532a8a927,1,Dan Burkert,2017-05-24 23:26:27+00:00,['e2097c8b93ad7860712cc489ef9dcd64a0ac09f8'],13,333,346,1082779,11,0.627118644,0.768361582,1,1978
4263b037844fca595a35f99479fbb5765ba7a443,0,Alexey Serbin,2017-05-25 01:07:43+00:00,['12683435f0e578957ee18c4e141e376532a8a927'],3,125,128,1082907,4,0.473684211,0.842105263,1,1978
e3c5dd18c22b9e20358f05dcd301e7736c0a3321,1,Alexey Serbin,2017-05-25 01:07:52+00:00,['4263b037844fca595a35f99479fbb5765ba7a443'],39,265,304,1083211,12,0.055944056,0.538461538,0.713286713,1978
5d4bf0c1586b60a23aebe47daa67d4f8bf8874f4,0,Mike Percy,2017-05-25 20:23:15+00:00,['e3c5dd18c22b9e20358f05dcd301e7736c0a3321'],2,6,8,1083219,1,,,,1978
68a4b0a2d083b47750b0d37ebfc185140df0f871,0,Adar Dembo,2017-05-25 22:59:43+00:00,['5d4bf0c1586b60a23aebe47daa67d4f8bf8874f4'],11,11,22,1083241,11,,,,1978
7e02ede3300ac180f393c93bf781a4b74556140b,0,Alexey Serbin,2017-05-26 02:49:33+00:00,['68a4b0a2d083b47750b0d37ebfc185140df0f871'],130,276,406,1083647,3,0.018181818,1,1,1979
86fac3fa270b22820c1599770bb06b1de89cb618,0,Dan Burkert,2017-05-26 18:22:51+00:00,['7e02ede3300ac180f393c93bf781a4b74556140b'],2,24,26,1083673,2,0.944444444,0.944444444,0.388888889,1979
1b89ec813d0aed604f7e79bd4c45dd8b9d81b8ba,1,Alexey Serbin,2017-05-26 23:06:26+00:00,['86fac3fa270b22820c1599770bb06b1de89cb618'],83,80,163,1083836,5,0.2,0.2,0,1979
d0270172e91bf6bcb045cb63a731609472fa6be4,0,Alexey Serbin,2017-05-27 00:45:13+00:00,['1b89ec813d0aed604f7e79bd4c45dd8b9d81b8ba'],6,31,37,1083873,2,1,1,1,1979
15d2fbaf45eddd5cb4ea954218e0ddd041540922,1,Mike Percy,2017-05-27 02:12:47+00:00,['d0270172e91bf6bcb045cb63a731609472fa6be4'],305,349,654,1084527,6,,,,1981
41e2b71c2fe6850fa877d991482e86614cbc8807,0,Alexey Serbin,2017-05-27 02:55:42+00:00,['15d2fbaf45eddd5cb4ea954218e0ddd041540922'],11,19,30,1084557,1,0,1,1,1981
314c9d8c102118dda6879eee538e2bb32d18ecd1,0,Mike Percy,2017-05-27 19:53:29+00:00,['41e2b71c2fe6850fa877d991482e86614cbc8807'],1,1,2,1084559,1,,,,1981
09543976c284eb05d93ce7d8c3254f7309d13869,1,Will Berkeley,2017-05-30 18:19:31+00:00,['314c9d8c102118dda6879eee538e2bb32d18ecd1'],66,153,219,1084778,26,0.520833333,0.979166667,1,1981
85465837732e608f1873958b7e8f97b95a9ff0f3,0,Mike Percy,2017-05-30 23:18:42+00:00,['09543976c284eb05d93ce7d8c3254f7309d13869'],1,3,4,1084782,1,0,0,1,1981
f5e0024e07645841fafabb8eae8351872516e79d,0,Alexey Serbin,2017-05-31 01:25:18+00:00,['85465837732e608f1873958b7e8f97b95a9ff0f3'],13,36,49,1084831,1,1,1,1,1981
3b6ab64497bb091d0a94d6085c4fbd68da5cecda,0,Todd Lipcon,2017-05-31 18:24:50+00:00,['f5e0024e07645841fafabb8eae8351872516e79d'],17,106,123,1084954,5,0,1,0.8125,1981
7f91a11939e0e09bd02de2c1ac0ce4bce218f3d9,0,Todd Lipcon,2017-05-31 18:31:54+00:00,['3b6ab64497bb091d0a94d6085c4fbd68da5cecda'],4,16,20,1084974,4,0.833333333,1,0.833333333,1981
3b934aeb240059907f113127072b04db05f9c880,0,Todd Lipcon,2017-05-31 19:59:26+00:00,['7f91a11939e0e09bd02de2c1ac0ce4bce218f3d9'],59,69,128,1085102,2,,,,1981
ca2704c7dd46b9dbbafa89e68fe977259448b8fa,0,Alexey Serbin,2017-05-31 20:11:24+00:00,['3b934aeb240059907f113127072b04db05f9c880'],41,41,82,1085184,7,1,1,1,1981
9e40867cc9a0d9a7cdc912140a6554eaec5a8d1e,1,Mike Percy,2017-05-31 21:27:42+00:00,['ca2704c7dd46b9dbbafa89e68fe977259448b8fa'],876,700,1576,1086760,7,0,0,0.155555556,1981
ec81bd9d28e057ed21528b9132f8acce14640770,0,Alexey Serbin,2017-05-31 21:53:41+00:00,['9e40867cc9a0d9a7cdc912140a6554eaec5a8d1e'],3,68,71,1086831,1,0,1,1,1981
30682fd13ffc68ebaeb8200e7450f8317b89bf85,1,Will Berkeley,2017-06-01 19:50:28+00:00,['ec81bd9d28e057ed21528b9132f8acce14640770'],140,107,247,1087078,6,0.909090909,1,0,1981
3846861ab258a0ac0497893865875b2138964fe3,0,Mike Percy,2017-06-01 20:44:45+00:00,['30682fd13ffc68ebaeb8200e7450f8317b89bf85'],206,169,375,1087453,3,0,0,0.071428571,1981
fbaa7dce968e2a6965effaa9d1097c34649d65f4,0,Mike Percy,2017-06-01 20:45:17+00:00,['3846861ab258a0ac0497893865875b2138964fe3'],2,44,46,1087499,2,0.1875,0.90625,0.9375,1981
a71a443d2e732c40392a5f2d4499469737361154,0,Alexey Serbin,2017-06-01 22:58:22+00:00,['fbaa7dce968e2a6965effaa9d1097c34649d65f4'],21,23,44,1087543,1,,,,1981
5f8442ff67fe87b019c71a09f0556bdcb6868428,0,Alexey Serbin,2017-06-01 22:58:30+00:00,['a71a443d2e732c40392a5f2d4499469737361154'],16,24,40,1087583,2,0,1,1,1981
6ea3acd2ec248fa24e4e1e53e73166a01a60a4b9,0,Todd Lipcon,2017-06-02 01:24:48+00:00,['5f8442ff67fe87b019c71a09f0556bdcb6868428'],2,2,4,1087587,1,,,,1981
037f72b375ecfa3b0cf4e7b393f1093332c2dfbc,1,Mike Percy,2017-06-02 02:26:41+00:00,['6ea3acd2ec248fa24e4e1e53e73166a01a60a4b9'],77,59,136,1087723,9,,,0,1981
e3b7d4dc1a6be020f3f126a66192ca1451e95e6f,1,Mike Percy,2017-06-02 18:46:53+00:00,['037f72b375ecfa3b0cf4e7b393f1093332c2dfbc'],621,448,1069,1088792,23,0,0,0.3125,1981
ce83b6cefe199c2170a76e2735e6b17e04970ca8,0,Dan Burkert,2017-06-03 02:23:07+00:00,['e3b7d4dc1a6be020f3f126a66192ca1451e95e6f'],106,58,164,1088956,4,,,,1982
732ee211a31335a1b146428b15887d1f26468a3a,1,David Ribeiro Alves,2017-06-05 17:27:44+00:00,['ce83b6cefe199c2170a76e2735e6b17e04970ca8'],199,1050,1249,1090205,36,0.363834423,0.679738562,0.928104575,1983
0f31386d26ffe614a66f5bc57f73cfa78f8a326b,0,Mike Percy,2017-06-05 21:05:49+00:00,['732ee211a31335a1b146428b15887d1f26468a3a'],1,15,16,1090221,1,1,1,1,1983
f329e089f6ac1ee2fcb4a4e65fb34ef0d3d374d5,0,Dan Burkert,2017-06-06 00:23:10+00:00,['0f31386d26ffe614a66f5bc57f73cfa78f8a326b'],10,6,16,1090237,3,,,,1983
fc98b1ae77f6fd869863191fcb7fa5d5363d9fc5,0,Mike Percy,2017-06-06 01:38:15+00:00,['f329e089f6ac1ee2fcb4a4e65fb34ef0d3d374d5'],60,230,290,1090527,15,0.422222222,0.933333333,0.955555556,1984
bf378b4bd139665ae08cabf7c31464ea07dd2fac,1,Todd Lipcon,2017-06-06 05:48:15+00:00,['fc98b1ae77f6fd869863191fcb7fa5d5363d9fc5'],49,341,390,1090917,5,0,0.858585859,0.994949495,1984
68962df0e58fd9ff96212b7265f8a943fd24e792,0,Todd Lipcon,2017-06-06 05:55:23+00:00,['bf378b4bd139665ae08cabf7c31464ea07dd2fac'],33,241,274,1091191,4,0.734513274,0.89380531,1,1986
86116e4c515a9c89e728dd699decaf20d097edac,0,Alexey Serbin,2017-06-06 06:55:18+00:00,['68962df0e58fd9ff96212b7265f8a943fd24e792'],38,50,88,1091279,6,1,1,1,1986
cdf0fee49d08e74e7215a9e2a8fbd2baf2d9c2b3,0,Adar Dembo,2017-06-06 20:29:44+00:00,['86116e4c515a9c89e728dd699decaf20d097edac'],7,13,20,1091299,1,,,,1986
851e8470ef0b7a5859c7af968af3f67d52cda495,0,David Ribeiro Alves,2017-06-07 13:47:21+00:00,['cdf0fee49d08e74e7215a9e2a8fbd2baf2d9c2b3'],2,31,33,1091332,1,0,1,1,1986
10aeb28776214f0e36f1d647ed466b6f95b142ee,1,David Ribeiro Alves,2017-06-07 14:17:39+00:00,['851e8470ef0b7a5859c7af968af3f67d52cda495'],64,186,250,1091582,6,0.093333333,0.946666667,1,1986
0c1b52fdf9d0707e98395ef04aa851609c26e0cf,0,David Ribeiro Alves,2017-06-07 14:21:17+00:00,['10aeb28776214f0e36f1d647ed466b6f95b142ee'],1,3,4,1091586,1,,,,1986
3296c076d19538f27e012e724ad5b26fec147b9b,0,Todd Lipcon,2017-06-07 19:07:28+00:00,['0c1b52fdf9d0707e98395ef04aa851609c26e0cf'],1,1,2,1091588,1,,,,1986
3ed4a007c4b5994afbbd6bbba86d8ca128b97748,0,Todd Lipcon,2017-06-08 03:00:55+00:00,['3296c076d19538f27e012e724ad5b26fec147b9b'],12,189,201,1091789,2,,,,1986
cf6862406a9bb4cddf0c96114b13bcc7890abff6,0,Alexey Serbin,2017-06-08 19:26:04+00:00,['3ed4a007c4b5994afbbd6bbba86d8ca128b97748'],5,0,5,1091794,1,1,0,0,1986
2d30f3a96dd416e7991f552c9bf5189d178d8945,0,Todd Lipcon,2017-06-08 20:28:08+00:00,['cf6862406a9bb4cddf0c96114b13bcc7890abff6'],12,53,65,1091859,4,0.625,1,1,1986
a9ac82ff42738e759df21145dda0382b2996bf43,0,Todd Lipcon,2017-06-08 21:45:28+00:00,['2d30f3a96dd416e7991f552c9bf5189d178d8945'],1,104,105,1091964,2,,,,1987
693f675c580364f0a94f58c161074590a09913da,0,Todd Lipcon,2017-06-08 22:00:17+00:00,['a9ac82ff42738e759df21145dda0382b2996bf43'],1,6,7,1091971,1,,,,1987
8be2a59103da46472062f47f89efa6e1bddd0a5c,0,Todd Lipcon,2017-06-08 22:04:19+00:00,['693f675c580364f0a94f58c161074590a09913da'],1,7,8,1091979,1,0,0,1,1987
e77538b541b112555ee62cff1506bf7fd1f0e461,0,Todd Lipcon,2017-06-08 22:47:26+00:00,['8be2a59103da46472062f47f89efa6e1bddd0a5c'],66,218,284,1092263,6,0.125,0.988636364,0.977272727,1987
9ae11e6d86eb33321fbb219927b27424e58f6e2c,0,Todd Lipcon,2017-06-08 22:54:59+00:00,['e77538b541b112555ee62cff1506bf7fd1f0e461'],11,122,133,1092396,2,0.144578313,1,1,1987
557f19ea40d7910cbac004a2b45a1949c90f30cc,0,Todd Lipcon,2017-06-08 23:13:30+00:00,['9ae11e6d86eb33321fbb219927b27424e58f6e2c'],0,3,3,1092399,1,,,,1987
6dade2aa02238f88e78f3fc7c2fc25e972d3ea00,1,Alexey Serbin,2017-06-09 01:34:59+00:00,['557f19ea40d7910cbac004a2b45a1949c90f30cc'],1,2,3,1092402,1,0,1,1,1987
f1e75b728e351d73b5439a8a46eec59977588dc1,0,Todd Lipcon,2017-06-09 20:27:10+00:00,['6dade2aa02238f88e78f3fc7c2fc25e972d3ea00'],17,18,35,1092437,9,1,1,1,1987
1632d16aa599334f175b91cebb01da3bf44839c3,0,Todd Lipcon,2017-06-09 20:27:54+00:00,['f1e75b728e351d73b5439a8a46eec59977588dc1'],2,13,15,1092452,3,,,,1987
3e249697a506918319e89b1b1aecdb7cb5a634f5,0,Todd Lipcon,2017-06-09 20:28:06+00:00,['1632d16aa599334f175b91cebb01da3bf44839c3'],6,6,12,1092464,2,,,,1987
8d2ca982fe24170c6a8b899e4751a29f05d05f39,0,Dan Burkert,2017-06-09 20:28:15+00:00,['3e249697a506918319e89b1b1aecdb7cb5a634f5'],14,11,25,1092489,1,,,,1987
4af55a80501ccf6e23709ea348a7c52a69bc620d,0,Will Berkeley,2017-06-09 21:28:53+00:00,['8d2ca982fe24170c6a8b899e4751a29f05d05f39'],6,6,12,1092501,1,,,,1987
66a33a04a5eecc9e7ace0d4130fa703ff5d02fc2,0,Will Berkeley,2017-06-09 21:30:00+00:00,['4af55a80501ccf6e23709ea348a7c52a69bc620d'],20,20,40,1092541,5,,,,1987
8e04eebc61944169a3910fa1029e0e9364a3886d,0,Todd Lipcon,2017-06-09 23:05:08+00:00,['66a33a04a5eecc9e7ace0d4130fa703ff5d02fc2'],3,3,6,1092547,3,,,,1987
65c1edaf054ba1772a7fd2c5e46c78168cd325fe,0,Adar Dembo,2017-06-10 00:28:43+00:00,['8e04eebc61944169a3910fa1029e0e9364a3886d'],0,10,10,1092557,1,0,0,0,1987
681f05b431a6fe62370feb439dd0756d9eefe07d,0,Todd Lipcon,2017-06-10 01:18:20+00:00,['65c1edaf054ba1772a7fd2c5e46c78168cd325fe'],1,1,2,1092559,1,,,,1987
636e2a9d29ff9a80ee601717f6789da972acd123,0,Will Berkeley,2017-06-12 18:57:55+00:00,['681f05b431a6fe62370feb439dd0756d9eefe07d'],1,6,7,1092566,2,,,,1987
850ebef628650bbce193376343b8c468facf294b,0,Todd Lipcon,2017-06-12 23:12:07+00:00,['636e2a9d29ff9a80ee601717f6789da972acd123'],57,70,127,1092693,13,,,,1987
e719b5eff2a47f61f9e6ee1f18d2055247f45847,1,Todd Lipcon,2017-06-12 23:12:25+00:00,['850ebef628650bbce193376343b8c468facf294b'],179,183,362,1093055,35,,,,1987
7ac7762ff470ade1c6be3426e05d322d34dc3b2b,0,Will Berkeley,2017-06-12 23:18:56+00:00,['e719b5eff2a47f61f9e6ee1f18d2055247f45847'],123,108,231,1093286,2,0,0,0,1987
be62673d9c0ae6778972f857cf55aef5b62a1065,0,Mike Percy,2017-06-13 00:58:51+00:00,['7ac7762ff470ade1c6be3426e05d322d34dc3b2b'],0,10,10,1093296,2,0,1,0,1987
9533c57e8b487f09d2a933545280e9ff1e42fbef,0,Todd Lipcon,2017-06-13 02:06:45+00:00,['be62673d9c0ae6778972f857cf55aef5b62a1065'],1,10,11,1093307,2,0.75,0.75,1,1987
6b4284ddf93a6f14845d61fb0160794bb7d34e93,1,Todd Lipcon,2017-06-13 16:03:59+00:00,['9533c57e8b487f09d2a933545280e9ff1e42fbef'],19,21,40,1093347,10,1,0,0,1987
3ff6c9bac3071fa478984900a544c50002ae537c,1,Todd Lipcon,2017-06-13 16:04:38+00:00,['6b4284ddf93a6f14845d61fb0160794bb7d34e93'],273,274,547,1093894,62,0,1,1,1987
50c7d3249ab5ca19fb4d3c0c8748a4a1c5945a12,1,Todd Lipcon,2017-06-13 16:04:48+00:00,['3ff6c9bac3071fa478984900a544c50002ae537c'],64,82,146,1094040,33,,,,1987
e68a7953a7710155342dcdd03d59c7e1833fbc13,0,Alexey Serbin,2017-06-13 18:56:56+00:00,['50c7d3249ab5ca19fb4d3c0c8748a4a1c5945a12'],16,34,50,1094090,7,1,1,1,1987
312492d55e57a89a527e949b5cc191b7714f01c6,0,Todd Lipcon,2017-06-13 22:41:57+00:00,['e68a7953a7710155342dcdd03d59c7e1833fbc13'],4,0,4,1094094,2,0,0,0,1987
01deeab47be415fd09e089d4ba833585b8d07f14,1,Todd Lipcon,2017-06-13 22:54:25+00:00,['312492d55e57a89a527e949b5cc191b7714f01c6'],44,44,88,1094182,34,,,,1987
b4de65a8a7e398157cfbc64d4f4f5ee08ab953ed,0,Adar Dembo,2017-06-14 00:17:26+00:00,['01deeab47be415fd09e089d4ba833585b8d07f14'],3,4,7,1094189,3,1,1,1,1987
e81db65a427d5394329420e7edc430a677b77705,1,Dan Burkert,2017-06-14 20:20:10+00:00,['b4de65a8a7e398157cfbc64d4f4f5ee08ab953ed'],2,40,42,1094231,3,0.869565217,0.869565217,1,1987
863a9b56dd766e91e84f033e3238f4bc8d014081,0,Dan Burkert,2017-06-16 00:12:58+00:00,['e81db65a427d5394329420e7edc430a677b77705'],1,1,2,1094233,1,,,,1987
3b62dc4f35e8fbf44f46654512c6c4345c6bf983,0,Dan Burkert,2017-06-16 00:13:05+00:00,['863a9b56dd766e91e84f033e3238f4bc8d014081'],29,0,29,1094262,2,,,,1987
834bb35e8fc2828b3d6bda2f53ef4a456f358926,0,Dan Burkert,2017-06-16 17:22:14+00:00,['3b62dc4f35e8fbf44f46654512c6c4345c6bf983'],0,1,1,1094263,1,0,1,1,1987
722f80399a748478c295d180459d1136c59edc14,0,Alexey Serbin,2017-06-16 21:23:23+00:00,['834bb35e8fc2828b3d6bda2f53ef4a456f358926'],50,58,108,1094371,1,,0,0,1987
5808e6d9fe2ef278cef2b6bd6b87a43d8f69d82d,0,Todd Lipcon,2017-06-16 21:27:19+00:00,['722f80399a748478c295d180459d1136c59edc14'],21,32,53,1094424,1,0,0,1,1987
c0798a9426581629d285ebf164f112d9a6a2f7ea,0,Todd Lipcon,2017-06-16 21:27:53+00:00,['5808e6d9fe2ef278cef2b6bd6b87a43d8f69d82d'],16,24,40,1094464,2,0.5,1,1,1987
677de010e39325ada1e9c150f87731da3b8698fb,1,Todd Lipcon,2017-06-18 20:24:31+00:00,['c0798a9426581629d285ebf164f112d9a6a2f7ea'],10,65,75,1094539,5,0.315789474,1,0.342105263,1987
d39781a5e510ba0faa87898ea140d30227921d65,1,Todd Lipcon,2017-06-18 21:43:07+00:00,['677de010e39325ada1e9c150f87731da3b8698fb'],8,27,35,1094574,4,1,1,1,1987
870343f0b1e9dc1117d5243682bf34b6e1b54acc,0,Alexey Serbin,2017-06-19 17:37:03+00:00,['d39781a5e510ba0faa87898ea140d30227921d65'],13,19,32,1094606,1,0,1,1,1987
f3f75ab5a409ab2c2faf646cd70de3c7fb35f914,1,Todd Lipcon,2017-06-19 18:26:24+00:00,['870343f0b1e9dc1117d5243682bf34b6e1b54acc'],8,21,29,1094635,3,0.4,1,1,1987
a5b7ece1b1132cdda968349a9844d7389e8cff2c,0,Dan Burkert,2017-06-21 21:11:11+00:00,['f3f75ab5a409ab2c2faf646cd70de3c7fb35f914'],2,10,12,1094647,1,,,,1987
c2577858c62afa24469b0ba6f47071506bf790ad,0,Will Berkeley,2017-06-22 20:33:38+00:00,['a5b7ece1b1132cdda968349a9844d7389e8cff2c'],1053,287,1340,1095987,152,0.550724638,0.550724638,0.257246377,1987
d2b8205941d22ba8ffc5d105b3612ecdc58e9fd7,0,Alexey Serbin,2017-06-22 21:08:14+00:00,['c2577858c62afa24469b0ba6f47071506bf790ad'],3,11,14,1096001,1,0,0,0.875,1987
d623942935e22aa2f22815a9b37397d84ffba46f,0,Alexey Serbin,2017-06-22 22:35:17+00:00,['d2b8205941d22ba8ffc5d105b3612ecdc58e9fd7'],71,46,117,1096118,6,0,0,0.181818182,1987
def06d8b8155d2aa5838d19f00cce940d2233ad1,1,David Ribeiro Alves,2017-06-23 08:54:41+00:00,['d623942935e22aa2f22815a9b37397d84ffba46f'],2,17,19,1096137,2,0.777777778,0.777777778,1,1987
c25d127ad3512ed9c9a2565681ffce9de639639f,0,Alexey Serbin,2017-06-23 18:12:32+00:00,['def06d8b8155d2aa5838d19f00cce940d2233ad1'],4,13,17,1096154,1,,,,1987
f9e51ca636fdcc29071be7f76868fa7b4509803d,0,Will Berkeley,2017-06-23 19:37:19+00:00,['c25d127ad3512ed9c9a2565681ffce9de639639f'],3,13,16,1096170,2,0,1,1,1987
5121df65e1b0edceb361f3d8cace240520da6949,0,Dan Burkert,2017-06-23 21:21:46+00:00,['f9e51ca636fdcc29071be7f76868fa7b4509803d'],5,128,133,1096303,5,0.256097561,0.658536585,1,1987
44bd94268c7beb08dda88bad182e177439a55c98,0,Alexey Serbin,2017-06-23 23:08:31+00:00,['5121df65e1b0edceb361f3d8cace240520da6949'],1,3,4,1096307,1,0,1,1,1987
9fdf77a6a50905819a77efa1a1a2ab74c3b6aff9,1,Adar Dembo,2017-06-23 23:48:11+00:00,['44bd94268c7beb08dda88bad182e177439a55c98'],5,61,66,1096373,5,0.653846154,0.653846154,0.923076923,1987
410763afa61252fa8c7125f66429bad602db795a,0,Adar Dembo,2017-06-23 23:48:13+00:00,['9fdf77a6a50905819a77efa1a1a2ab74c3b6aff9'],1,23,24,1096397,3,0,0.166666667,0.666666667,1987
ca8ed1d48beaf492231c0a69d030bf22b473d007,1,Adar Dembo,2017-06-24 02:52:32+00:00,['410763afa61252fa8c7125f66429bad602db795a'],17,126,143,1096540,2,0.096774194,0.677419355,0.983870968,1987
c96d6680b004bdbec16b05b9ba21dc7314fa270c,0,Adar Dembo,2017-06-24 02:52:36+00:00,['ca8ed1d48beaf492231c0a69d030bf22b473d007'],23,1,24,1096564,3,1,0.833333333,0.333333333,1987
ecdc6c0e2d5b5eeb7be638db9381c11158774b09,0,Todd Lipcon,2017-06-25 02:17:32+00:00,['c96d6680b004bdbec16b05b9ba21dc7314fa270c'],30,75,105,1096669,2,0,0,0,1987
aa0bac0ccb8993cbbf4260154ae1ea920c8f7998,0,Alexey Serbin,2017-06-25 19:09:56+00:00,['ecdc6c0e2d5b5eeb7be638db9381c11158774b09'],8,8,16,1096685,3,,,,1987
d5fe274dcdfa3e8716372e41266e00ccb6f769d5,0,Todd Lipcon,2017-06-26 19:35:33+00:00,['aa0bac0ccb8993cbbf4260154ae1ea920c8f7998'],13,20,33,1096718,1,0,1,1,1987
684f1fa81c16725f0054e4c848a6dc59cec327c5,1,Alexey Serbin,2017-06-26 20:48:13+00:00,['d5fe274dcdfa3e8716372e41266e00ccb6f769d5'],149,205,354,1097072,4,0,1,1,1987
0f8649f1ba593f12d787315a9bb8b13e889ceb3c,0,Todd Lipcon,2017-06-26 21:29:13+00:00,['684f1fa81c16725f0054e4c848a6dc59cec327c5'],5,4,9,1097081,1,,,,1987
3c3cd3215ba5d2d07d08a47ae9a5abe9b3f2e244,1,Dan Burkert,2017-06-26 23:29:01+00:00,['0f8649f1ba593f12d787315a9bb8b13e889ceb3c'],129,134,263,1097344,6,,,,1987
96ad3b07cf1dc694ddcfd72405aeb662440199b5,1,Todd Lipcon,2017-06-27 00:16:46+00:00,['3c3cd3215ba5d2d07d08a47ae9a5abe9b3f2e244'],29,75,104,1097448,5,1,1,1,1987
c19b8f4a1a271af1efb5a01bdf05005d79bb85f6,0,Todd Lipcon,2017-06-27 00:28:43+00:00,['96ad3b07cf1dc694ddcfd72405aeb662440199b5'],2,191,193,1097641,2,0.058441558,0.655844156,0.746753247,1987
78ef92ec807b8c2f5e91c0ddb70dbba0ebe542b9,0,Todd Lipcon,2017-06-27 00:28:51+00:00,['c19b8f4a1a271af1efb5a01bdf05005d79bb85f6'],2,73,75,1097716,2,0.183333333,1,1,1987
baa8d17167340d6ac0302e44ceef40262f820e47,0,Adar Dembo,2017-06-27 02:25:04+00:00,['78ef92ec807b8c2f5e91c0ddb70dbba0ebe542b9'],1,2,3,1097719,1,0,0,1,1987
ab07952fb511527053f9336a416a361b8b51dbd3,0,Dan Burkert,2017-06-27 03:19:05+00:00,['baa8d17167340d6ac0302e44ceef40262f820e47'],0,82,82,1097801,8,,,,1988
52e63d8aaad5b5c4b58f819eb3569e7094a1b0f0,0,Mike Percy,2017-06-27 03:27:50+00:00,['ab07952fb511527053f9336a416a361b8b51dbd3'],1,1,2,1097803,1,,,,1988
a85b294fb9b2d620fa961cd20857d52d59e8ec1c,0,Dan Burkert,2017-06-27 17:09:17+00:00,['52e63d8aaad5b5c4b58f819eb3569e7094a1b0f0'],6,0,6,1097809,1,,,,1988
5a258508f8d560f630512c237711a65cd137c6b3,0,Dan Burkert,2017-06-27 18:19:09+00:00,['a85b294fb9b2d620fa961cd20857d52d59e8ec1c'],64,38,102,1097911,6,,,,1988
57a07ae7217b63c51651611427f1af029d54d4fe,1,Dan Burkert,2017-06-27 21:29:00+00:00,['5a258508f8d560f630512c237711a65cd137c6b3'],164,339,503,1098414,17,0.344537815,1,0,1988
1a7630e84715480e93e2d1caae34865f517ef831,1,Todd Lipcon,2017-06-27 22:45:54+00:00,['57a07ae7217b63c51651611427f1af029d54d4fe'],43,192,235,1098649,11,1,1,0.6875,1991
4c5c51264a89c309c4c8927052a233aa3ba2aa43,0,Todd Lipcon,2017-06-27 22:53:02+00:00,['1a7630e84715480e93e2d1caae34865f517ef831'],64,175,239,1098888,9,0.76,1,1,1991
74f99e40da6ccab0b9042e7f38a50176db1d8899,1,Todd Lipcon,2017-06-27 22:53:23+00:00,['4c5c51264a89c309c4c8927052a233aa3ba2aa43'],59,65,124,1099012,8,1,1,1,1991
428a34ba0aecfb81178d821732feac694a9b35c1,1,Todd Lipcon,2017-06-27 22:54:56+00:00,['74f99e40da6ccab0b9042e7f38a50176db1d8899'],86,986,1072,1100084,4,0.246031746,0.386904762,1,1991
cbd2fb6730ec4f2fabc97fc60757c4ce2203d7b4,0,Todd Lipcon,2017-06-27 22:55:10+00:00,['428a34ba0aecfb81178d821732feac694a9b35c1'],17,66,83,1100167,2,0.090909091,1,1,1991
3fb84a7f9d235b3fa44393a0f197411922538e8c,1,Todd Lipcon,2017-06-27 23:56:49+00:00,['cbd2fb6730ec4f2fabc97fc60757c4ce2203d7b4'],123,193,316,1100483,19,0,0.958333333,0.875,1991
31b852f4ae3979401e6cee0f021e4ff20c467d2c,1,Todd Lipcon,2017-06-27 23:58:59+00:00,['3fb84a7f9d235b3fa44393a0f197411922538e8c'],73,117,190,1100673,5,0,0.666666667,0.555555556,1991
74d67fd2b7c8ad9c315f0b9894a49616e00e235d,1,Todd Lipcon,2017-06-28 00:03:14+00:00,['31b852f4ae3979401e6cee0f021e4ff20c467d2c'],40,59,99,1100772,11,0.428571429,0.928571429,1,1991
600d01a5a575558a30707eec4a62de40bc5615bb,1,Mike Percy,2017-06-28 00:09:20+00:00,['74d67fd2b7c8ad9c315f0b9894a49616e00e235d'],121,114,235,1101007,29,,,,1991
bbed78cbd198019591ca4ffe4bc5d0b4abfd430f,0,Mike Percy,2017-06-28 01:28:08+00:00,['600d01a5a575558a30707eec4a62de40bc5615bb'],12,12,24,1101031,5,,,,1991
15e33c1229237881d8867040ca3421eee49577a4,0,Dan Burkert,2017-06-28 16:35:44+00:00,['bbed78cbd198019591ca4ffe4bc5d0b4abfd430f'],75,70,145,1101176,18,1,1,0,1991
42a07499cd5b2b255a3734a26c9af7000f3cbd89,0,Jean-Daniel Cryans,2017-06-28 17:38:07+00:00,['15e33c1229237881d8867040ca3421eee49577a4'],0,9,9,1101185,1,,,,1991
e6758739a90adeb2e4d0c6cf76185cf90cc7d2b0,0,Todd Lipcon,2017-06-28 18:12:42+00:00,['42a07499cd5b2b255a3734a26c9af7000f3cbd89'],192,316,508,1101693,20,0,0.16,0.94,1992
4f9b0e32fccf88af6b454a705fdba698a8afc9ba,0,Todd Lipcon,2017-06-28 18:12:53+00:00,['e6758739a90adeb2e4d0c6cf76185cf90cc7d2b0'],2,3,5,1101698,1,0,1,1,1992
cd8e7afb47042fd00e073b9d2c54aee6f549fb5a,0,Todd Lipcon,2017-06-28 18:42:44+00:00,['4f9b0e32fccf88af6b454a705fdba698a8afc9ba'],25,25,50,1101748,21,,,,1992
e9622028cb9b54d3b93af2a2a35db64e02052749,1,Mike Percy,2017-06-28 18:42:50+00:00,['cd8e7afb47042fd00e073b9d2c54aee6f549fb5a'],18,48,66,1101814,4,1,1,1,1992
63ee6f5d95cdcca6a703a7c984b5cb21455d8a4b,0,Dan Burkert,2017-06-29 20:07:38+00:00,['e9622028cb9b54d3b93af2a2a35db64e02052749'],0,16,16,1101830,2,,,,1992
8d29412c83be16dd30fd6d45eddd0c4f24b3824c,1,Mike Percy,2017-06-29 20:10:46+00:00,['63ee6f5d95cdcca6a703a7c984b5cb21455d8a4b'],157,315,472,1102302,18,0.833333333,1,0.990196078,1992
bf8e1c7b8f21a01148588951a53da66bda070113,1,Mike Percy,2017-06-29 20:11:15+00:00,['8d29412c83be16dd30fd6d45eddd0c4f24b3824c'],84,33,117,1102419,2,0,0,0,1992
feaa4e36c1b4d72e27a015c4ef519dc1f71c7984,1,Mike Percy,2017-06-29 21:24:38+00:00,['bf8e1c7b8f21a01148588951a53da66bda070113'],35,29,64,1102483,2,0.333333333,0.333333333,0,1992
371a00b7aeba244aa63d92bf479cbb356b4dfbca,1,Mike Percy,2017-06-29 22:40:04+00:00,['feaa4e36c1b4d72e27a015c4ef519dc1f71c7984'],19,42,61,1102544,1,0.25,1,1,1992
b33689e70db2ccb17bc16bc8c5e63c85b0399f49,0,Todd Lipcon,2017-06-30 01:37:54+00:00,['371a00b7aeba244aa63d92bf479cbb356b4dfbca'],12,40,52,1102596,3,0,1,1,1992
41a3aeabb902f5b46e97ea0edaaa2efd9f7cc006,0,Todd Lipcon,2017-06-30 01:38:35+00:00,['b33689e70db2ccb17bc16bc8c5e63c85b0399f49'],1,4,5,1102601,1,,,,1992
332ebcd063b55923806b1704113d0623f7aae745,0,Todd Lipcon,2017-06-30 01:39:09+00:00,['41a3aeabb902f5b46e97ea0edaaa2efd9f7cc006'],11,13,24,1102625,2,0,1,1,1992
3548895a27ee65982acd4bd1d6ca1bf33bf39288,0,Alexey Serbin,2017-06-30 04:46:06+00:00,['332ebcd063b55923806b1704113d0623f7aae745'],1,2,3,1102628,1,0,0,1,1992
9a3071a9a8c913960cf6d3b62bfcc04e21fa1504,0,Todd Lipcon,2017-06-30 18:44:20+00:00,['3548895a27ee65982acd4bd1d6ca1bf33bf39288'],1,5,6,1102634,1,,,,1992
794285592600d5c1a4dbc88ab67119763e0c4c9f,0,Adar Dembo,2017-06-30 21:37:19+00:00,['9a3071a9a8c913960cf6d3b62bfcc04e21fa1504'],8,8,16,1102650,1,,,,1992
26749aff06e1ef27e58f1ec81db3b097ecdb34d9,1,Todd Lipcon,2017-06-30 22:01:20+00:00,['794285592600d5c1a4dbc88ab67119763e0c4c9f'],12,15,27,1102677,7,1,0,0,1992
1070e764d97ce496325a277b9093f0ab3b9ee167,0,Todd Lipcon,2017-06-30 23:28:49+00:00,['26749aff06e1ef27e58f1ec81db3b097ecdb34d9'],57,199,256,1102933,8,0.1875,1,0.9375,1992
7e7452704bb5295196f04423c86d0bc317c25311,1,Alexey Serbin,2017-07-05 19:32:07+00:00,['1070e764d97ce496325a277b9093f0ab3b9ee167'],60,52,112,1103045,13,1,,1,1992
58248841f213a64683ee217f025f0a38a8450f74,1,Alexey Serbin,2017-07-05 20:58:46+00:00,['7e7452704bb5295196f04423c86d0bc317c25311'],1333,1504,2837,1105882,21,1,0.555555556,0,1994
030e1a1cda097b38c58fde3868e1c3afacb3abff,0,Alexey Serbin,2017-07-06 02:38:54+00:00,['58248841f213a64683ee217f025f0a38a8450f74'],1,0,1,1105883,1,1,1,0,1994
0e64b7de5f758bf0e72b1dfcee51809800ee8024,0,Jean-Daniel Cryans,2017-07-06 17:50:07+00:00,['030e1a1cda097b38c58fde3868e1c3afacb3abff'],5,3,8,1105891,1,,,,1994
2fc07eb811f351757a0085a7e318affd120fbaf9,0,Todd Lipcon,2017-07-07 00:11:07+00:00,['0e64b7de5f758bf0e72b1dfcee51809800ee8024'],14,69,83,1105974,1,,,,1994
a3773b42c41d3208dcc8fb26f4d9ff106e3e8cfe,0,Alexey Serbin,2017-07-07 17:23:03+00:00,['2fc07eb811f351757a0085a7e318affd120fbaf9'],31,44,75,1106049,1,0,1,0,1994
04f84020f3eb88b482d63f2177780549403bae9c,0,Alexey Serbin,2017-07-07 22:16:46+00:00,['a3773b42c41d3208dcc8fb26f4d9ff106e3e8cfe'],2,2,4,1106053,2,,,,1994
2c0237469b2d43668317c25019d500745fb6e9f4,0,Alexey Serbin,2017-07-07 22:58:51+00:00,['04f84020f3eb88b482d63f2177780549403bae9c'],10,37,47,1106100,1,,,,1994
5b18be1a707d76abedc0f6542015a9dfa3d1387f,0,Dan Burkert,2017-07-10 23:39:57+00:00,['2c0237469b2d43668317c25019d500745fb6e9f4'],100,110,210,1106310,4,1,1,0,1994
af39a2aa0d1506856d763033b13675d347a7cb15,0,Mike Percy,2017-07-11 19:31:58+00:00,['5b18be1a707d76abedc0f6542015a9dfa3d1387f'],122,233,355,1106665,16,0,1,0.512820513,1996
15e66d3f6bbc4173ac41a31521dfd7a1821110ec,0,Todd Lipcon,2017-07-11 22:38:10+00:00,['af39a2aa0d1506856d763033b13675d347a7cb15'],41,221,262,1106927,4,0.264,0.52,1,1996
bce46e12f14c08b9d3a41ee83cc3de179d5b7a5e,0,Alexey Serbin,2017-07-12 02:49:11+00:00,['15e66d3f6bbc4173ac41a31521dfd7a1821110ec'],1,1,2,1106929,1,,,,1996
ac2a2852ed6b593f9ea6a56190b2e1bea4122964,0,Jean-Daniel Cryans,2017-07-12 18:13:07+00:00,['bce46e12f14c08b9d3a41ee83cc3de179d5b7a5e'],29,55,84,1107013,1,0,1,0,1996
96cdcbd00b148e123d25bc63969b43ad14d67551,0,Jean-Daniel Cryans,2017-07-12 18:14:49+00:00,['ac2a2852ed6b593f9ea6a56190b2e1bea4122964'],3,56,59,1107072,1,0,1,0.956521739,1996
69ee17dc795cab630e67d686cc66276547cc3ebd,0,Dan Burkert,2017-07-12 18:26:39+00:00,['96cdcbd00b148e123d25bc63969b43ad14d67551'],2,60,62,1107134,3,0.413793103,1,1,1996
81939782a21d195371fb2fdf511c3e8cda203826,0,Dan Burkert,2017-07-12 18:32:38+00:00,['69ee17dc795cab630e67d686cc66276547cc3ebd'],0,412,412,1107546,4,1,1,1,1999
603c1578c78c0377ffafdd9c427ebfd8a206bda3,1,Alexey Serbin,2017-07-12 21:49:15+00:00,['81939782a21d195371fb2fdf511c3e8cda203826'],152,872,1024,1108570,15,0.199312715,0.567010309,0.941580756,2003
fa5d56cb65c490be7ef1fa714c38bda3b8e18a56,1,Mike Percy,2017-07-13 04:43:06+00:00,['603c1578c78c0377ffafdd9c427ebfd8a206bda3'],210,786,996,1109566,26,0.222222222,0.467592593,0.87962963,2007
4f16320abf59a8d07ffbe0fdb94a9887c3b510d2,1,Mike Percy,2017-07-13 06:32:22+00:00,['fa5d56cb65c490be7ef1fa714c38bda3b8e18a56'],259,212,471,1110037,4,0.295454545,0,0,2007
bbea22e1950868de1c3cf3e9dab0eef03979b53a,1,Mike Percy,2017-07-13 06:32:32+00:00,['4f16320abf59a8d07ffbe0fdb94a9887c3b510d2'],175,166,341,1110378,8,1,1,0,2007
b62608a8e1fa1406f7ffcd7a35cd70c177c67b2c,0,Mike Percy,2017-07-13 06:32:50+00:00,['bbea22e1950868de1c3cf3e9dab0eef03979b53a'],25,82,107,1110485,6,1,1,1,2008
f144d572d6434abdb0e65f86c80b48a23428b061,0,Jean-Daniel Cryans,2017-07-13 18:29:46+00:00,['b62608a8e1fa1406f7ffcd7a35cd70c177c67b2c'],1,1,2,1110487,1,,,,2008
e4e1b8ed86e5dfe7193de2809973fe216432750a,0,Todd Lipcon,2017-07-19 06:46:58+00:00,['f144d572d6434abdb0e65f86c80b48a23428b061'],1,1,2,1110489,1,,,,2008
bd61f2d57f195baa5b88c7f3183a50099b828eaf,0,Adar Dembo,2017-07-19 17:59:03+00:00,['e4e1b8ed86e5dfe7193de2809973fe216432750a'],7,21,28,1110517,3,,,,2008
27854fd4950466c09adebd9b3cf56c7d93bde0b5,0,Adar Dembo,2017-07-20 17:16:26+00:00,['bd61f2d57f195baa5b88c7f3183a50099b828eaf'],4,19,23,1110540,2,,,,2008
6d6c7ccb93c8acd23da308054e1ecc8da1210338,0,Todd Lipcon,2017-07-24 21:57:20+00:00,['27854fd4950466c09adebd9b3cf56c7d93bde0b5'],6,28,34,1110574,2,,,,2008
be8e3c22b9a3a71b2c365e2b9ed306ea23d60058,0,Todd Lipcon,2017-07-25 16:48:40+00:00,['6d6c7ccb93c8acd23da308054e1ecc8da1210338'],11,70,81,1110655,2,0.333333333,1,1,2008
0fe3a288d63a1b49cc615ec1346fcaef7a17b7c7,0,Jean-Daniel Cryans,2017-07-25 21:39:03+00:00,['be8e3c22b9a3a71b2c365e2b9ed306ea23d60058'],1,5,6,1110661,1,1,1,1,2008
107b9cdf88ba419d4b7efad1f9b338e957985ce5,0,Dan Burkert,2017-07-26 19:00:16+00:00,['0fe3a288d63a1b49cc615ec1346fcaef7a17b7c7'],185,436,621,1111282,16,0.683544304,0.962025316,0.721518987,2010
cb9a6b84dae186dcf5b38b12ccfc93613824dcee,0,Dan Burkert,2017-07-26 19:02:01+00:00,['107b9cdf88ba419d4b7efad1f9b338e957985ce5'],9049,34,9083,1120365,13,0.407550077,0.244992296,0.020801233,2012
634e1cc673e5cd5fd563ba526a0a655c5718e4e3,0,Dan Burkert,2017-07-26 19:07:11+00:00,['cb9a6b84dae186dcf5b38b12ccfc93613824dcee'],0,85,85,1120450,3,0.0625,1,1,2013
9285f2b44edb23a906cc3a697d9289ee3b3c5673,1,Dan Burkert,2017-07-26 19:07:55+00:00,['634e1cc673e5cd5fd563ba526a0a655c5718e4e3'],24,56,80,1120530,3,1,0,0,2014
0c6aa525680d4f927c11b7dc85f9d79abf036b87,0,Todd Lipcon,2017-07-27 04:03:12+00:00,['9285f2b44edb23a906cc3a697d9289ee3b3c5673'],48,59,107,1120637,8,0.875,1,0.375,2014
0ec793e32dd70da501ff6e967ad775ca3244eeae,1,Todd Lipcon,2017-07-27 04:03:55+00:00,['0c6aa525680d4f927c11b7dc85f9d79abf036b87'],24,444,468,1121105,16,0.325,0.683333333,0.9375,2014
5b7626e3a8250d797f2fc2001c8ee7634a39d18b,0,Mike Percy,2017-07-27 18:39:02+00:00,['0ec793e32dd70da501ff6e967ad775ca3244eeae'],105,371,476,1121581,7,0.152380952,0.852380952,0.319047619,2014
ef8e46b401e782fc17462779b703d16e10e82402,0,Adar Dembo,2017-07-28 00:11:42+00:00,['5b7626e3a8250d797f2fc2001c8ee7634a39d18b'],6,20,26,1121607,1,,,,2014
0e41d4cce5ca96cb08612475f76539f6c8bc58f1,0,Todd Lipcon,2017-07-28 16:16:21+00:00,['ef8e46b401e782fc17462779b703d16e10e82402'],3,3,6,1121613,1,,,,2014
230ed20d54a3bf2a9e01481e68d06da3d67e42d5,0,Adar Dembo,2017-07-28 19:53:23+00:00,['0e41d4cce5ca96cb08612475f76539f6c8bc58f1'],0,1,1,1121614,1,1,1,1,2014
12efb85e13391c0230105a47ca949959b2e7639f,0,Adar Dembo,2017-07-31 20:52:35+00:00,['230ed20d54a3bf2a9e01481e68d06da3d67e42d5'],28,184,212,1121826,15,0.441860465,1,0,2015
a21a50f878034767f42af58f1892dfc893d683f9,0,Adar Dembo,2017-07-31 21:45:11+00:00,['12efb85e13391c0230105a47ca949959b2e7639f'],112,257,369,1122195,7,0.592592593,0.703703704,0.851851852,2015
1c0276a98cad2fbb91ac1b21a68961bd50265f9c,1,Adar Dembo,2017-08-01 00:15:11+00:00,['a21a50f878034767f42af58f1892dfc893d683f9'],137,207,344,1122539,18,0.372093023,0.906976744,0.581395349,2015
57a1962aad7f53f3e8e7a490d6acfd108e4f0ebf,0,Adar Dembo,2017-08-01 20:31:37+00:00,['1c0276a98cad2fbb91ac1b21a68961bd50265f9c'],48,122,170,1122709,3,0,0.871794872,0.974358974,2015
ed827e0f0c23f154c06c43b4d43219cdd321e221,0,Todd Lipcon,2017-08-01 20:54:57+00:00,['57a1962aad7f53f3e8e7a490d6acfd108e4f0ebf'],1,5,6,1122715,1,,0,,2015
af343140b081bf5b324198c2c840d0da4c7ffb40,0,Todd Lipcon,2017-08-01 21:00:11+00:00,['ed827e0f0c23f154c06c43b4d43219cdd321e221'],8,14,22,1122737,3,0,1,1,2015
ec93064c921b56d0a6c79427eb313d5d1f5c24f1,0,Todd Lipcon,2017-08-01 21:08:20+00:00,['af343140b081bf5b324198c2c840d0da4c7ffb40'],6,5,11,1122748,1,,,,2015
de43ffe778d47e458037cf7ed950899fdb65ab83,0,Todd Lipcon,2017-08-01 21:09:57+00:00,['ec93064c921b56d0a6c79427eb313d5d1f5c24f1'],19,64,83,1122831,1,,,,2015
9f7fed68c1e72b6878940e2d876eb66023e48f72,0,Adar Dembo,2017-08-01 22:01:33+00:00,['de43ffe778d47e458037cf7ed950899fdb65ab83'],28,32,60,1122891,2,0.333333333,0,1,2015
7e0a56b2a7ac80d345da660fdc619b7fcff84512,0,Todd Lipcon,2017-08-01 23:03:48+00:00,['9f7fed68c1e72b6878940e2d876eb66023e48f72'],15,38,53,1122944,4,0.133333333,0,0.266666667,2015
443a3512eead1632b728e35bae1784888f6a5f6d,0,Adar Dembo,2017-08-01 23:04:35+00:00,['7e0a56b2a7ac80d345da660fdc619b7fcff84512'],5,10,15,1122959,1,0,0,1,2015
c38631097a466f50209e211218c6668789f4b445,0,Adar Dembo,2017-08-02 01:36:03+00:00,['443a3512eead1632b728e35bae1784888f6a5f6d'],1,2,3,1122962,1,0,0,1,2015
7ff27dcf1191d4cbca297fdfdbfdd99d8eec7182,0,Todd Lipcon,2017-08-02 18:55:27+00:00,['c38631097a466f50209e211218c6668789f4b445'],242,231,473,1123435,63,,,,2016
de8b92eb6469f843d43c432678e52732a861014b,1,Adar Dembo,2017-08-03 21:09:05+00:00,['7ff27dcf1191d4cbca297fdfdbfdd99d8eec7182'],179,534,713,1124148,16,1,0.976190476,0.976190476,2023
e5202d30a6ab89ec800931030728ed7827a137da,1,Adar Dembo,2017-08-03 21:09:15+00:00,['de8b92eb6469f843d43c432678e52732a861014b'],6,1453,1459,1125607,34,,,,2047
b04490b8647e17ba4028a1765b5608b38e53490b,0,Alexey Serbin,2017-08-03 21:16:18+00:00,['e5202d30a6ab89ec800931030728ed7827a137da'],2,2,4,1125611,1,,,,2047
d0acb55510c0552605953e07740f46d6be66c9c1,0,Jean-Daniel Cryans,2017-08-04 20:29:38+00:00,['b04490b8647e17ba4028a1765b5608b38e53490b'],1,5,6,1125617,2,,,,2047
943b1ae26e62a0c823276013f2e3d3b8705a08c6,0,Jean-Daniel Cryans,2017-08-04 22:39:31+00:00,['d0acb55510c0552605953e07740f46d6be66c9c1'],46,114,160,1125777,5,0.325,1,1,2047
6bdbd26bc7d0c680f81ac38a05a65a080c63af55,0,Todd Lipcon,2017-08-05 01:29:35+00:00,['943b1ae26e62a0c823276013f2e3d3b8705a08c6'],3,0,3,1125780,1,,,,2047
1678b3dc9b5bc81f57ebac03f2893835744ff098,0,Alexey Serbin,2017-08-07 18:59:33+00:00,['6bdbd26bc7d0c680f81ac38a05a65a080c63af55'],0,5,5,1125785,1,,,,2047
d1f53cc323d5d07e79304765fe171f535c1d548a,1,Todd Lipcon,2017-08-07 23:13:21+00:00,['1678b3dc9b5bc81f57ebac03f2893835744ff098'],9,48,57,1125842,2,0.652173913,1,1,2047
4a0417018b2833ee9f308a294b319d8c7570990f,0,Mike Percy,2017-08-08 18:34:11+00:00,['d1f53cc323d5d07e79304765fe171f535c1d548a'],1,137,138,1125980,3,0.440677966,1,0.610169492,2049
28c4b8c28a7006cbeeab7b7179938d4eae96f85f,0,Todd Lipcon,2017-08-08 21:12:51+00:00,['4a0417018b2833ee9f308a294b319d8c7570990f'],2,6,8,1125988,2,0,1,1,2049
4b045c1d301fd9e805ac333feac5315962385307,1,Todd Lipcon,2017-08-09 02:47:58+00:00,['28c4b8c28a7006cbeeab7b7179938d4eae96f85f'],60,55,115,1126103,6,0.6,0,1,2049
5d53a3b7146c6bcf330ddae036cfc42eeb7b7849,0,Jean-Daniel Cryans,2017-08-09 22:02:13+00:00,['4b045c1d301fd9e805ac333feac5315962385307'],7,1200,1207,1127310,13,0.286821705,0.571705426,0.823643411,2059
b0839fcdbf4a391adbc3b224d58a1ad667901637,0,Jean-Daniel Cryans,2017-08-09 22:03:24+00:00,['5d53a3b7146c6bcf330ddae036cfc42eeb7b7849'],9,10,19,1127329,2,0,1,1,2059
154b07de73ca2b949fceacef6798411dc4a3c6eb,1,Alexey Serbin,2017-08-10 00:01:03+00:00,['b0839fcdbf4a391adbc3b224d58a1ad667901637'],1169,1377,2546,1129875,340,0.444444444,0.722222222,0.666666667,2059
dd68c62555a2b8a977a7a2052233a990a43afb8f,1,Alexey Serbin,2017-08-10 03:38:15+00:00,['154b07de73ca2b949fceacef6798411dc4a3c6eb'],122,189,311,1130186,79,0,0.6,1,2059
7eb58663f2876415244f0f5f322135afedc98458,0,Dan Burkert,2017-08-10 17:56:29+00:00,['dd68c62555a2b8a977a7a2052233a990a43afb8f'],17,30,47,1130233,3,0,0.25,1,2059
ecd67486b8ee50afc15438c8a0c4ba484f0f7362,0,Jean-Daniel Cryans,2017-08-10 18:09:02+00:00,['7eb58663f2876415244f0f5f322135afedc98458'],47,119,166,1130399,4,1,1,0,2060
2a99bb3e5864ae4ae4dd6d2dcdff557fed81aa1d,0,Todd Lipcon,2017-08-10 18:47:58+00:00,['ecd67486b8ee50afc15438c8a0c4ba484f0f7362'],0,18,18,1130417,1,1,1,0.75,2060
6de378296105a2310295231a79004b0e1a0bc0e4,0,Todd Lipcon,2017-08-10 19:00:44+00:00,['2a99bb3e5864ae4ae4dd6d2dcdff557fed81aa1d'],14,0,14,1130431,1,0,0,0,2060
88e73f4f44d81fe7a235528b8fbd2243734a7961,0,Jean-Daniel Cryans,2017-08-10 19:23:46+00:00,['6de378296105a2310295231a79004b0e1a0bc0e4'],8,8,16,1130447,1,,,,2060
1b939c21bb6cc94d8541b7f63a10f698239cc2a9,0,Jean-Daniel Cryans,2017-08-10 20:18:49+00:00,['88e73f4f44d81fe7a235528b8fbd2243734a7961'],0,6,6,1130453,3,,,,2060
bc73f88cc66f5c3f3faaaefd44def242f342f0ed,0,Alexey Serbin,2017-08-10 22:52:24+00:00,['1b939c21bb6cc94d8541b7f63a10f698239cc2a9'],1,0,1,1130454,1,,,,2060
71454b69a5eb9b0e27bfa18af205ac92e4fe8d5a,0,Alexey Serbin,2017-08-11 00:08:22+00:00,['bc73f88cc66f5c3f3faaaefd44def242f342f0ed'],88,26,114,1130568,11,,,,2060
12084b3b9fad4019ab5a29b039d74844d2224368,0,Todd Lipcon,2017-08-11 05:43:01+00:00,['71454b69a5eb9b0e27bfa18af205ac92e4fe8d5a'],2,2,4,1130572,2,,,,2060
ce6ecc5a51ae2c25b5b47fe9a05b989586cbfd93,0,Adar Dembo,2017-08-11 21:49:17+00:00,['12084b3b9fad4019ab5a29b039d74844d2224368'],65,69,134,1130706,1,,,,2060
b198ed8ff6a603816892c8bc7fd80679a014aaf1,0,Jean-Daniel Cryans,2017-08-12 15:50:15+00:00,['ce6ecc5a51ae2c25b5b47fe9a05b989586cbfd93'],19,24,43,1130749,2,,,,2060
82e6e3c8c868d5e960bb99a18bde18e7d6631047,0,Alexey Serbin,2017-08-15 21:02:43+00:00,['b198ed8ff6a603816892c8bc7fd80679a014aaf1'],2,39,41,1130790,5,,,,2063
1e5d334adec8332039b56c78e19e1d04c85e3d1c,0,Alexey Serbin,2017-08-15 21:02:50+00:00,['82e6e3c8c868d5e960bb99a18bde18e7d6631047'],0,10295,10295,1141085,7,,,,2069
18d6f7f4c112ba890a1ba8722dce85aa3340b1d7,1,Todd Lipcon,2017-08-16 00:21:03+00:00,['1e5d334adec8332039b56c78e19e1d04c85e3d1c'],55,431,486,1141571,10,0.25087108,1,0.31358885,2069
88d15116be4fab0d30081d3f92c60ecc32b3c819,0,Todd Lipcon,2017-08-17 02:16:25+00:00,['18d6f7f4c112ba890a1ba8722dce85aa3340b1d7'],126,40,166,1141737,9,0,0,0,2069
e4c7c812cdef66f3ff1f87ea792d80945cbdad75,1,Todd Lipcon,2017-08-17 02:16:39+00:00,['88d15116be4fab0d30081d3f92c60ecc32b3c819'],120,174,294,1142031,8,,,,2071
f2675b2cd95e74942ebefe1fb95101d812476ce8,0,Jean-Daniel Cryans,2017-08-17 16:24:55+00:00,['e4c7c812cdef66f3ff1f87ea792d80945cbdad75'],38,42,80,1142111,9,,,,2071
a15f1863e42fb308fcb13dba651f72d1cbe9e1c4,0,Todd Lipcon,2017-08-17 16:28:56+00:00,['f2675b2cd95e74942ebefe1fb95101d812476ce8'],1,2,3,1142114,1,,,,2071
e32faf92dd8560eb398f719de370624a51cf4a2d,1,Todd Lipcon,2017-08-18 00:38:41+00:00,['a15f1863e42fb308fcb13dba651f72d1cbe9e1c4'],36,13,49,1142163,5,0,0,0,2071
351337ee2d92361e2c87699d1c87a49774a3ab4d,0,Todd Lipcon,2017-08-18 02:38:48+00:00,['e32faf92dd8560eb398f719de370624a51cf4a2d'],158,531,689,1142852,19,0.529761905,0.505952381,0.910714286,2071
ecfcb312161a4bc6f8da0ebb837169a2acf08eef,0,Alexey Serbin,2017-08-18 18:04:43+00:00,['351337ee2d92361e2c87699d1c87a49774a3ab4d'],0,3,3,1142855,1,1,1,1,2071
f9a8cd9098e3fa753ebef26305e7f803b5198ac6,0,Alexey Serbin,2017-08-18 19:23:38+00:00,['ecfcb312161a4bc6f8da0ebb837169a2acf08eef'],7,10,17,1142872,1,1,1,1,2071
44a820bff358194482ddbd0c9b67077aae2f9635,0,Jean-Daniel Cryans,2017-08-18 20:28:11+00:00,['f9a8cd9098e3fa753ebef26305e7f803b5198ac6'],195,269,464,1143336,4,,,,2071
b4cb9eaa74411bee811b4b3d782b2dc1a9ed427d,0,Todd Lipcon,2017-08-19 00:25:55+00:00,['44a820bff358194482ddbd0c9b67077aae2f9635'],4,6,10,1143346,3,,,,2071
055425245997a3b9a7615f14530164fad5a7ebb6,0,Jean-Daniel Cryans,2017-08-21 17:24:25+00:00,['b4cb9eaa74411bee811b4b3d782b2dc1a9ed427d'],32,150,182,1143528,3,0.168316832,0.198019802,1,2071
84096d89bfb86a2021e9c62867a01cdd524a0473,0,Dan Burkert,2017-08-21 19:35:36+00:00,['055425245997a3b9a7615f14530164fad5a7ebb6'],4,14,18,1143546,6,,,,2071
f9ed787531851f6d841a2b458c17e0180141638c,0,Mike Percy,2017-08-21 19:39:02+00:00,['84096d89bfb86a2021e9c62867a01cdd524a0473'],6,3,9,1143555,1,,,,2071
0f6dcf8388e626aeedff1836e1234971107b3a8d,1,Alexey Serbin,2017-08-21 20:53:32+00:00,['f9ed787531851f6d841a2b458c17e0180141638c'],2819,8769,11588,1155143,932,0,1,0,2071
1d56066454efd0da30b58c514f08c03cbb38f8ee,0,Alexey Serbin,2017-08-21 20:54:08+00:00,['0f6dcf8388e626aeedff1836e1234971107b3a8d'],211,44,255,1155398,4,,,,2072
efb5395bdf8b89077b403c8a01528e63b346c49a,1,Todd Lipcon,2017-08-21 21:26:55+00:00,['1d56066454efd0da30b58c514f08c03cbb38f8ee'],139,220,359,1155757,42,0.301587302,0.920634921,0.761904762,2072
7986ee02854df2c323e27b111142ca57cfe771f2,0,Todd Lipcon,2017-08-21 22:33:11+00:00,['efb5395bdf8b89077b403c8a01528e63b346c49a'],0,2,2,1155759,2,,,,2072
fa2757763285cacf9f7fdd759953d678b8b8edc2,0,Dan Burkert,2017-08-21 23:23:53+00:00,['7986ee02854df2c323e27b111142ca57cfe771f2'],2,10,12,1155771,3,,,,2072
dc65abbab208120288a8c26b1099f45c488b865e,1,Mike Percy,2017-08-22 00:26:52+00:00,['fa2757763285cacf9f7fdd759953d678b8b8edc2'],243,245,488,1156259,19,0,0,0,2072
a7d589635bd889fe31205a600739ae938b803d97,0,Mike Percy,2017-08-22 00:26:58+00:00,['dc65abbab208120288a8c26b1099f45c488b865e'],0,66,66,1156325,3,0.065217391,1,1,2072
9d12910a41c1660275d6cd9366f515c03b0ec5b5,0,Todd Lipcon,2017-08-22 04:32:56+00:00,['a7d589635bd889fe31205a600739ae938b803d97'],39,56,95,1156420,5,0.285714286,0.285714286,0.285714286,2072
8f6812047a2fe50dabfcb26093385b33f9960a7c,0,Alexey Serbin,2017-08-22 14:12:38+00:00,['9d12910a41c1660275d6cd9366f515c03b0ec5b5'],18,361,379,1156799,5,0.31496063,0.496062992,0.653543307,2074
e1c753e58f52afafa6fc86c7640eec1490cf97a7,0,Alexey Serbin,2017-08-22 19:41:07+00:00,['8f6812047a2fe50dabfcb26093385b33f9960a7c'],37,38,75,1156874,29,,,,2074
61a227735032974ea0c5c3045be7f092a41ac350,0,Adar Dembo,2017-08-22 23:17:06+00:00,['e1c753e58f52afafa6fc86c7640eec1490cf97a7'],303,440,743,1157617,16,0.360655738,0.196721311,0.721311475,2074
780a392542cf6f20ace64ddc168eefcbde2dc3b3,0,Adar Dembo,2017-08-23 01:15:10+00:00,['61a227735032974ea0c5c3045be7f092a41ac350'],0,465,465,1158082,4,0.798611111,0.798611111,0.847222222,2077
c8e0407770bd395cd4bca5096c4cad56ab575cd6,0,Adar Dembo,2017-08-23 01:15:14+00:00,['780a392542cf6f20ace64ddc168eefcbde2dc3b3'],90,24,114,1158196,3,0.448275862,1,0.034482759,2077
21b0f3d5e255760535e281efe5879fe657df1f1c,1,Adar Dembo,2017-08-23 01:15:17+00:00,['c8e0407770bd395cd4bca5096c4cad56ab575cd6'],183,109,292,1158488,4,0.926829268,0.048780488,0,2077
e869396543c0d6dba984e0d515a726c3e29747f2,0,Adar Dembo,2017-08-23 01:15:20+00:00,['21b0f3d5e255760535e281efe5879fe657df1f1c'],891,0,891,1159379,8,0.364779874,0.188679245,0.116352201,2077
a6443b2cbfa498198fb5a237b5164274f875e8f8,0,Todd Lipcon,2017-08-23 02:16:25+00:00,['e869396543c0d6dba984e0d515a726c3e29747f2'],0,3,3,1159382,1,0,0,1,2077
65b7bf9707e4b893e230b64b5aba89b39905edbb,1,Alexey Serbin,2017-08-23 16:13:25+00:00,['a6443b2cbfa498198fb5a237b5164274f875e8f8'],0,90,90,1159472,1,0.390243902,1,0.707317073,2078
a9d17c00af8ebd32e8a93eb8a3e98f989d0feda7,1,Mike Percy,2017-08-23 21:29:45+00:00,['65b7bf9707e4b893e230b64b5aba89b39905edbb'],58,154,212,1159684,13,0.180327869,0.721311475,0.950819672,2078
145c01da49037e9999d057898891dee0734afd93,0,Adar Dembo,2017-08-24 00:47:45+00:00,['a9d17c00af8ebd32e8a93eb8a3e98f989d0feda7'],0,3,3,1159687,2,1,1,1,2078
b2f5837f0e88f6bcddfae9bd3ca1ab668093c147,0,Adar Dembo,2017-08-24 00:47:59+00:00,['145c01da49037e9999d057898891dee0734afd93'],0,21,21,1159708,1,,,,2078
df2fa4f7cf88b44b1dbf07ba5e8859f73af0b617,0,Adar Dembo,2017-08-24 00:48:31+00:00,['b2f5837f0e88f6bcddfae9bd3ca1ab668093c147'],2,21,23,1159731,2,,,,2078
55c40fc72241a0569d311bdb2f0268389512a807,1,Todd Lipcon,2017-08-24 01:03:35+00:00,['df2fa4f7cf88b44b1dbf07ba5e8859f73af0b617'],531,158,689,1160420,19,0.470238095,0.494047619,0.089285714,2078
71f5fbdaa25f7d8665288a872bcdc19a7655a307,0,Adar Dembo,2017-08-24 01:14:20+00:00,['55c40fc72241a0569d311bdb2f0268389512a807'],2,6,8,1160428,2,0,1,1,2078
f33a13c128140cb046cc71c47287d7cd0f4e9a2d,0,Alexey Serbin,2017-08-24 02:14:03+00:00,['71f5fbdaa25f7d8665288a872bcdc19a7655a307'],0,23,23,1160451,3,,,,2078
dbfb92f3ada84f68ed3f05dd0c9ea24fca9d334e,0,Todd Lipcon,2017-08-24 03:34:40+00:00,['f33a13c128140cb046cc71c47287d7cd0f4e9a2d'],19,52,71,1160522,4,0.107142857,0.5,0.785714286,2078
b37bde72c47370293827a306532d9be15b1c5f40,0,Adar Dembo,2017-08-24 03:56:47+00:00,['dbfb92f3ada84f68ed3f05dd0c9ea24fca9d334e'],2,2,4,1160526,2,,,,2078
5bca7d8ba185d62952fb3e3163cbe88d20453da0,1,Todd Lipcon,2017-08-24 04:43:25+00:00,['b37bde72c47370293827a306532d9be15b1c5f40'],296,1439,1735,1162261,27,0.150337838,0.41722973,0.724662162,2080
0dab9796d53747cef0f2fcd8100d0e912f682c32,0,Adar Dembo,2017-08-24 05:03:09+00:00,['5bca7d8ba185d62952fb3e3163cbe88d20453da0'],2,3,5,1162266,1,0,1,1,2080
58394f9f2e2fab8e44814a72326649f84b713ae2,0,Adar Dembo,2017-08-24 05:48:32+00:00,['0dab9796d53747cef0f2fcd8100d0e912f682c32'],11,113,124,1162390,4,0.035714286,0.392857143,1,2080
22f4a0e62a4faf0a291669518bfc761a9ff70b31,1,Mike Percy,2017-08-24 08:20:28+00:00,['58394f9f2e2fab8e44814a72326649f84b713ae2'],173,645,818,1163208,13,0.177777778,0.603703704,0.933333333,2080
11dfe78e6181351a77ccb5efd0a74ff37b94b844,0,Mike Percy,2017-08-24 08:20:41+00:00,['22f4a0e62a4faf0a291669518bfc761a9ff70b31'],13,185,198,1163406,8,0,0.840909091,1,2081
36d888bd5360c7f711d1bdfb52415750b74e5031,0,Todd Lipcon,2017-08-24 18:44:52+00:00,['11dfe78e6181351a77ccb5efd0a74ff37b94b844'],6,91,97,1163503,4,1,1,0.790697674,2081
f9a6a1b2d15feb8e2c044f20248774105a3a62bf,0,Alexey Serbin,2017-08-24 21:03:10+00:00,['36d888bd5360c7f711d1bdfb52415750b74e5031'],143,222,365,1163868,68,,,,2081
81fad4da9c1101ef9d6868d444c2d70a826d7aa8,0,Dan Burkert,2017-08-25 00:59:36+00:00,['f9a6a1b2d15feb8e2c044f20248774105a3a62bf'],5,7,12,1163880,2,,,,2081
59ca360bff394fa18da32487c44ec876feea9510,0,Adar Dembo,2017-08-25 02:16:14+00:00,['81fad4da9c1101ef9d6868d444c2d70a826d7aa8'],451,613,1064,1164944,20,0.594594595,1,0.963963964,2081
3d42a264c15ded1001284a851b7f30a2b4465411,1,Adar Dembo,2017-08-25 02:16:43+00:00,['59ca360bff394fa18da32487c44ec876feea9510'],17,71,88,1165032,7,0,0.08,0.24,2081
c77d70f3e88973aa82f06ec97cb2b19b6507b3af,0,Todd Lipcon,2017-08-25 03:37:26+00:00,['3d42a264c15ded1001284a851b7f30a2b4465411'],4,46,50,1165082,3,,,,2081
1177c8e1fcae62f081f506aeada98f67591c0ac9,1,Todd Lipcon,2017-08-25 18:46:08+00:00,['c77d70f3e88973aa82f06ec97cb2b19b6507b3af'],47,53,100,1165182,4,0.071428571,0.357142857,0.214285714,2081
bd5cb8b466e5b0f26e3c8c975baa4fe7504b7ce5,0,Mike Percy,2017-08-25 19:13:31+00:00,['1177c8e1fcae62f081f506aeada98f67591c0ac9'],5,4,9,1165191,2,1,1,1,2081
6080a5f72ee774283f590da4a60df1905090002c,0,Todd Lipcon,2017-08-25 19:45:14+00:00,['bd5cb8b466e5b0f26e3c8c975baa4fe7504b7ce5'],73,32,105,1165296,4,0.666666667,0.666666667,0,2081
48aba1a866c7d679debe9773dac23077c6a79e74,0,Mike Percy,2017-08-25 20:39:31+00:00,['6080a5f72ee774283f590da4a60df1905090002c'],16,31,47,1165343,1,0,1,1,2081
ddb95e5fdfa06c1e099df640786c494ab841c9fd,1,Adar Dembo,2017-08-25 22:45:02+00:00,['48aba1a866c7d679debe9773dac23077c6a79e74'],219,204,423,1165766,3,1,0.294117647,0.352941176,2081
64c0b15e940801bacd31d670e6e73de52e1232bb,0,Alexey Serbin,2017-08-25 23:37:13+00:00,['ddb95e5fdfa06c1e099df640786c494ab841c9fd'],10,0,10,1165776,2,,,,2081
2895538e97f8631aa1ab718115e43174e0a14859,0,Dan Burkert,2017-08-26 00:04:35+00:00,['64c0b15e940801bacd31d670e6e73de52e1232bb'],0,4,4,1165780,1,,,,2081
9a07b2fedcc0beacc76cb1c656be84c0c99c9da9,0,Dan Burkert,2017-08-26 00:08:20+00:00,['2895538e97f8631aa1ab718115e43174e0a14859'],8,0,8,1165788,1,0,0,0.2,2081
bde730f6ba8f90893604edcdd803191d4f0a5d4d,0,Todd Lipcon,2017-08-26 01:25:52+00:00,['9a07b2fedcc0beacc76cb1c656be84c0c99c9da9'],1,1,2,1165790,1,,,,2081
a07d01ea54876b7ceea63edf9b6a9859cead84d9,0,Todd Lipcon,2017-08-26 01:26:24+00:00,['bde730f6ba8f90893604edcdd803191d4f0a5d4d'],1,1,2,1165792,1,,,,2081
faa0b14effb6e15f9989d686e5a1f8e1040a1dd6,0,Todd Lipcon,2017-08-26 01:28:26+00:00,['a07d01ea54876b7ceea63edf9b6a9859cead84d9'],1,1,2,1165794,1,,,,2081
3cd95f190f286b64b9b68f0fd3c925fd79bdcae9,0,Dan Burkert,2017-08-26 01:35:09+00:00,['faa0b14effb6e15f9989d686e5a1f8e1040a1dd6'],3,4,7,1165801,1,0,0,1,2081
017fdcfb2bf10a666d88edef56c2894be77830ea,0,Dan Burkert,2017-08-26 01:35:14+00:00,['3cd95f190f286b64b9b68f0fd3c925fd79bdcae9'],0,5,5,1165806,1,,,,2081
1c70e5df829c2fbb4db6307627f8e096a6da8e08,0,Dan Burkert,2017-08-26 01:35:17+00:00,['017fdcfb2bf10a666d88edef56c2894be77830ea'],0,14,14,1165820,1,,,,2081
22a19d93ab9f1df339b8fe0fde094c406ce5cb2b,1,Mike Percy,2017-08-27 18:09:15+00:00,['1c70e5df829c2fbb4db6307627f8e096a6da8e08'],15,152,167,1165987,2,0,0,0.979381443,2081
c7a22fa6b51d8b54a3eb49800a575993a460adc4,0,Todd Lipcon,2017-08-28 19:20:43+00:00,['22a19d93ab9f1df339b8fe0fde094c406ce5cb2b'],6,6,12,1165999,1,,,,2081
31ddbcf0bc04d5ab631108b7bffef8da26ce7ee6,0,Dan Burkert,2017-08-28 19:42:14+00:00,['c7a22fa6b51d8b54a3eb49800a575993a460adc4'],0,8,8,1166007,1,,,,2081
b365ad0bd6372d459f547da0f1cb82e36148c541,0,David Ribeiro Alves,2017-08-28 20:14:37+00:00,['31ddbcf0bc04d5ab631108b7bffef8da26ce7ee6'],0,1,1,1166008,1,0,0,1,2081
82a8e9f990c9f4d7713d0ce3cc166b44ee2a9b3e,1,Jean-Daniel Cryans,2017-08-28 21:58:22+00:00,['b365ad0bd6372d459f547da0f1cb82e36148c541'],21,54,75,1166083,1,0,0,1,2081
334dcbe2bbcf8a0a1fb25fdbd4740fc252763e62,0,Adar Dembo,2017-08-28 22:52:03+00:00,['82a8e9f990c9f4d7713d0ce3cc166b44ee2a9b3e'],3,7,10,1166093,1,,,,2081
975cb5cdbe0e75c28a05544357d6779bfcbf6463,0,Dan Burkert,2017-08-28 23:52:28+00:00,['334dcbe2bbcf8a0a1fb25fdbd4740fc252763e62'],0,4,4,1166097,1,,,,2081
ed76e0b2c040753d570ffd08fd352decc3d52d31,0,Dan Burkert,2017-08-29 00:15:37+00:00,['975cb5cdbe0e75c28a05544357d6779bfcbf6463'],0,8,8,1166105,1,,,,2081
655cf1d5e37156c6e2170f1033024cec175c93fb,0,Dan Burkert,2017-08-29 00:35:18+00:00,['ed76e0b2c040753d570ffd08fd352decc3d52d31'],0,16,16,1166121,1,,,,2081
15e28176f11dfb87b1a43d280018e58350074981,0,Dan Burkert,2017-08-29 01:58:29+00:00,['655cf1d5e37156c6e2170f1033024cec175c93fb'],11,11,22,1166143,11,,,,2081
5f34a7d09e21670e0450266e8e7fa8a8d151aebc,0,Alexey Serbin,2017-08-29 02:10:46+00:00,['15e28176f11dfb87b1a43d280018e58350074981'],43,44,87,1166230,40,,,,2082
b54eab1f31dd2180e103f1cddbaa2194396396c5,0,Will Berkeley,2017-08-29 16:22:46+00:00,['5f34a7d09e21670e0450266e8e7fa8a8d151aebc'],15,48,63,1166293,3,0,1,1,2082
c9b9315a04a943cbfeb3ce94979b21e80e363e10,1,Will Berkeley,2017-08-29 16:59:54+00:00,['b54eab1f31dd2180e103f1cddbaa2194396396c5'],27,271,298,1166591,17,0.366906475,0.964028777,0.884892086,2082
2247931fd3297bb619d798b763767c5b0dd50b64,0,Dan Burkert,2017-08-29 18:37:07+00:00,['c9b9315a04a943cbfeb3ce94979b21e80e363e10'],0,8,8,1166599,1,,,,2082
2d6a2ac7f1255fd6084a42244174eb94d55df57e,0,Mike Percy,2017-08-29 18:45:25+00:00,['2247931fd3297bb619d798b763767c5b0dd50b64'],1,4,5,1166604,1,0,0,1,2082
1e332fe6eea05ee418f2a7dc96873e552b748135,0,Alexey Serbin,2017-08-29 23:36:27+00:00,['2d6a2ac7f1255fd6084a42244174eb94d55df57e'],0,6,6,1166610,2,0,0,1,2082
2f78643e4979fc8a9499498aa04c7f4ffa0deb61,0,Mike Percy,2017-08-30 01:55:35+00:00,['1e332fe6eea05ee418f2a7dc96873e552b748135'],5,59,64,1166674,2,0,0.971428571,0.971428571,2082
595af7cdfb6b5e3c2d8adcd74ffb97032bae4ff3,0,Dan Burkert,2017-08-30 22:24:22+00:00,['2f78643e4979fc8a9499498aa04c7f4ffa0deb61'],0,11,11,1166685,1,,,,2082
738f345a19047ae07bbcc9704f2243f9e9c8bd40,0,Dan Burkert,2017-08-30 22:26:59+00:00,['595af7cdfb6b5e3c2d8adcd74ffb97032bae4ff3'],14,31,45,1166730,3,0,0.714285714,0,2082
763b1b1fa6efb0d7a18513ae14c5e5088c909803,0,Mike Percy,2017-08-31 02:27:50+00:00,['738f345a19047ae07bbcc9704f2243f9e9c8bd40'],13,81,94,1166824,5,0.380952381,0.928571429,0.976190476,2082
c35e4f0093dcdec625d1f647924d854c7bc9f3de,0,Mike Percy,2017-08-31 02:27:56+00:00,['763b1b1fa6efb0d7a18513ae14c5e5088c909803'],0,85,85,1166909,2,0,0.981132075,1,2082
986e8de63d8687421c476de07c4e889129062637,1,Dan Burkert,2017-08-31 04:46:09+00:00,['c35e4f0093dcdec625d1f647924d854c7bc9f3de'],78,110,188,1167097,4,0,0.181818182,1,2082
2942760708d9bd252dc266434127d7eaa5107f55,0,Mike Percy,2017-08-31 18:02:06+00:00,['986e8de63d8687421c476de07c4e889129062637'],5,6,11,1167108,1,0,1,1,2082
463d59ce79b5f7d69e9e80b87c90df5ed68a4270,0,Dan Burkert,2017-08-31 20:01:05+00:00,['2942760708d9bd252dc266434127d7eaa5107f55'],35,60,95,1167203,2,,,,2082
1cfdf36fcbaf72102f04c0a0e009cfd6a1d1ec68,0,Mike Percy,2017-08-31 23:50:59+00:00,['463d59ce79b5f7d69e9e80b87c90df5ed68a4270'],0,21,21,1167224,2,,,,2082
22835062f0c9b77a5a5786411a9f22f1d6a58a06,0,Adar Dembo,2017-09-01 00:25:52+00:00,['1cfdf36fcbaf72102f04c0a0e009cfd6a1d1ec68'],251,191,442,1167666,6,0.047619048,0.214285714,0.380952381,2082
c6592eef990d6ba8c9b3461e12330211566a3a9d,0,Mike Percy,2017-09-01 00:32:43+00:00,['22835062f0c9b77a5a5786411a9f22f1d6a58a06'],2,18,20,1167686,1,,,,2082
cc0b19e912de7126a25695466215803c3efbaa4c,0,Dan Burkert,2017-09-01 16:06:04+00:00,['c6592eef990d6ba8c9b3461e12330211566a3a9d'],10,31,41,1167727,5,,,,2082
ea58982e51fd3f701c734e0ac52b0ee218d7eda3,0,Dan Burkert,2017-09-01 16:14:13+00:00,['cc0b19e912de7126a25695466215803c3efbaa4c'],10,7,17,1167744,2,,,,2082
fa953d05ef933a1dc97f06a958ca30ed2eae1772,0,Dan Burkert,2017-09-01 19:31:51+00:00,['ea58982e51fd3f701c734e0ac52b0ee218d7eda3'],248,85,333,1168077,18,0,0,1,2082
f09bd015f142c0b254d6e274088b64897ce4ed9e,0,Alexey Serbin,2017-09-01 19:38:07+00:00,['fa953d05ef933a1dc97f06a958ca30ed2eae1772'],52,87,139,1168216,2,0,1,1,2082
c8ad6668e8ebe17ff12c70cc77a8ed351595d1e3,0,Adar Dembo,2017-09-01 21:29:57+00:00,['f09bd015f142c0b254d6e274088b64897ce4ed9e'],0,2,2,1168218,2,,,,2082
43833f939695734ce4d6370bc30f115d5006e2cd,0,Alexey Serbin,2017-09-01 21:54:16+00:00,['c8ad6668e8ebe17ff12c70cc77a8ed351595d1e3'],7,8,15,1168233,1,0,0,0,2082
311755895e48a5d52b9f398c8b89847aa808fa19,0,Dan Burkert,2017-09-01 22:27:27+00:00,['43833f939695734ce4d6370bc30f115d5006e2cd'],197,230,427,1168660,17,,,,2082
e0cd85e24b8cf7a1accffa6d7e25e65d1bd774b9,0,Adar Dembo,2017-09-01 23:52:05+00:00,['311755895e48a5d52b9f398c8b89847aa808fa19'],16,29,45,1168705,4,,,,2082
a14ba2afb1cd0baf044a89980f264236c2b10af3,0,Alexey Serbin,2017-09-02 00:30:51+00:00,['e0cd85e24b8cf7a1accffa6d7e25e65d1bd774b9'],5,45,50,1168755,3,,,,2083
d8115386765fd3dafdb23830592246d1c57277e6,0,Adar Dembo,2017-09-05 04:10:39+00:00,['a14ba2afb1cd0baf044a89980f264236c2b10af3'],9,52,61,1168816,5,0,1,1,2083
ba3cceea699a8a1416a58e7ae705944c0ad87ea8,0,Dan Burkert,2017-09-05 17:49:58+00:00,['d8115386765fd3dafdb23830592246d1c57277e6'],0,3,3,1168819,1,,,,2083
5583d620002a2b13a5ed8b8f90dc1dd1355ca174,0,Dan Burkert,2017-09-05 19:12:34+00:00,['ba3cceea699a8a1416a58e7ae705944c0ad87ea8'],1,3,4,1168823,1,0,1,1,2083
f0aa3b3f194146760597e6ab88c304c6f408073c,0,Alexey Serbin,2017-09-05 22:25:35+00:00,['5583d620002a2b13a5ed8b8f90dc1dd1355ca174'],4,9,13,1168836,1,0,0,1,2083
f41a5c2beeee3afc8b4703c8047b347490b24c19,0,Dan Burkert,2017-09-06 00:33:57+00:00,['f0aa3b3f194146760597e6ab88c304c6f408073c'],8,22,30,1168866,2,0,0.384615385,0.846153846,2083
72dc8fbb1ca01a5ae069ee9576adb2a00d626885,0,Adar Dembo,2017-09-06 01:41:57+00:00,['f41a5c2beeee3afc8b4703c8047b347490b24c19'],15,21,36,1168902,2,1,1,1,2083
a71ecfd4a232c82ccf6f3b8fb452eaed3528ad46,0,Adar Dembo,2017-09-06 01:42:00+00:00,['72dc8fbb1ca01a5ae069ee9576adb2a00d626885'],22,105,127,1169029,2,0.137931034,1,1,2083
2211afcb3c283209c71e26c845bd9ad6c2a13119,0,Todd Lipcon,2017-09-06 22:20:03+00:00,['a71ecfd4a232c82ccf6f3b8fb452eaed3528ad46'],37,48,85,1169114,3,0,,,2083
4f41a3cb68019f5a56764a126de5debffe5b58d6,0,Mike Percy,2017-09-06 23:35:51+00:00,['2211afcb3c283209c71e26c845bd9ad6c2a13119'],35,182,217,1169331,11,0,0.94047619,0.916666667,2083
4ee3efed54aa38d110df2a0cd3c1652cdfbcb628,0,Adar Dembo,2017-09-07 02:15:12+00:00,['4f41a3cb68019f5a56764a126de5debffe5b58d6'],3,20,23,1169354,1,0,0,1,2083
4935b1b298782aabcdac5b8a5c49c3c15d80d8f6,0,Alexey Serbin,2017-09-07 04:21:55+00:00,['4ee3efed54aa38d110df2a0cd3c1652cdfbcb628'],16,30,46,1169400,2,,,0,2083
9af2046e610156a9064c87976eec2b5a42e0693b,0,Alexey Serbin,2017-09-07 20:18:56+00:00,['4935b1b298782aabcdac5b8a5c49c3c15d80d8f6'],3,3,6,1169406,2,,,,2083
01003ee6b4ece19c5e803dcac9d777a421d7c520,0,Alexey Serbin,2017-09-07 22:16:34+00:00,['9af2046e610156a9064c87976eec2b5a42e0693b'],18,56,74,1169480,4,,,,2084
59e9a9287d75daec43e69a0fbcb886c2d4543f73,0,Mike Percy,2017-09-07 22:23:45+00:00,['01003ee6b4ece19c5e803dcac9d777a421d7c520'],7,16,23,1169503,1,0,1,1,2084
2f2565b25a654ca239970a0575361f825e990471,0,Mike Percy,2017-09-07 22:46:19+00:00,['59e9a9287d75daec43e69a0fbcb886c2d4543f73'],10,10,20,1169523,2,,,,2084
cd6eee7a375e053f1f9bed338e603bf9ca91e709,0,Mike Percy,2017-09-07 23:50:08+00:00,['2f2565b25a654ca239970a0575361f825e990471'],23,102,125,1169648,2,0,0.946428571,0.946428571,2084
c85ac94b1c91cbe58b0bbfa4147681087eb98837,1,Mike Percy,2017-09-08 00:10:02+00:00,['cd6eee7a375e053f1f9bed338e603bf9ca91e709'],36,40,76,1169724,3,1,0,1,2084
98b308fd82df5ee9b0f3cdcfc1748137e23c3efc,0,Todd Lipcon,2017-09-08 00:58:01+00:00,['c85ac94b1c91cbe58b0bbfa4147681087eb98837'],1,1,2,1169726,1,,,,2084
2108767bf5331e0f3beccd56a987cb413cca380a,1,Mike Percy,2017-09-08 04:49:14+00:00,['98b308fd82df5ee9b0f3cdcfc1748137e23c3efc'],67,370,437,1170163,15,0.014084507,0.971830986,0.838028169,2085
7e391c4734a53f3a9e448aa3eeb97bbc57ec6847,0,Adar Dembo,2017-09-08 21:09:20+00:00,['2108767bf5331e0f3beccd56a987cb413cca380a'],37,51,88,1170251,2,0,0,0,2085
c0e18fd743e36b20ef3ab364c33ff0954fb4898e,0,Adar Dembo,2017-09-08 22:54:03+00:00,['7e391c4734a53f3a9e448aa3eeb97bbc57ec6847'],22,96,118,1170369,6,0.063829787,0.340425532,0.425531915,2085
9f064944816f154af079713adc79a0dff8270742,0,Adar Dembo,2017-09-08 22:54:06+00:00,['c0e18fd743e36b20ef3ab364c33ff0954fb4898e'],2,21,23,1170392,1,0,1,1,2085
3f4972408ede6232436e60bcc8a86837411ea617,0,Mike Percy,2017-09-09 03:43:12+00:00,['9f064944816f154af079713adc79a0dff8270742'],10,31,41,1170433,2,0.636363636,1,1,2085
6fef9ca5c9d1dcf571795c514cb9fecc493d0714,1,Will Berkeley,2017-09-14 02:38:16+00:00,['3f4972408ede6232436e60bcc8a86837411ea617'],7,380,387,1170820,8,0.338797814,0.775956284,1,2087
eed74ee6c640221b050fe188b5473f95366ac0e2,0,Adar Dembo,2017-09-14 03:26:50+00:00,['6fef9ca5c9d1dcf571795c514cb9fecc493d0714'],18,18,36,1170856,8,,,,2087
d45eb27006756780d38ed0e019842c4223f2dffd,0,Adar Dembo,2017-09-14 04:32:39+00:00,['eed74ee6c640221b050fe188b5473f95366ac0e2'],21,34,55,1170911,1,,,,2087
0ed75067cf805dda8784cca5ea7a3e7a43616ac6,0,Alexey Serbin,2017-09-14 05:25:46+00:00,['d45eb27006756780d38ed0e019842c4223f2dffd'],4,5,9,1170920,1,,,,2087
449b5f59c5e5c19f7e9136c5bbf76200a90f23c4,0,Dan Burkert,2017-09-14 19:50:39+00:00,['0ed75067cf805dda8784cca5ea7a3e7a43616ac6'],62,243,305,1171225,11,0.053097345,0,0.699115044,2087
e2c0e1dbdc4fa15a6477a82fda5495928a26a508,0,Dan Burkert,2017-09-14 19:50:43+00:00,['449b5f59c5e5c19f7e9136c5bbf76200a90f23c4'],33,139,172,1171397,5,0,0.552238806,0.850746269,2087
fa8620cc7b4dd4205a5a58737a7cc3c21957fe05,0,Alexey Serbin,2017-09-14 19:58:43+00:00,['e2c0e1dbdc4fa15a6477a82fda5495928a26a508'],13,48,61,1171458,4,,,,2088
2c5f24b05c2823bd764a82f3dcb63c9af3edf135,0,Todd Lipcon,2017-09-14 22:08:07+00:00,['fa8620cc7b4dd4205a5a58737a7cc3c21957fe05'],2,12,14,1171472,1,1,1,1,2088
71a44b4c29ab8506c688ad26635dc4d2672ba948,0,Todd Lipcon,2017-09-15 03:07:08+00:00,['2c5f24b05c2823bd764a82f3dcb63c9af3edf135'],2,133,135,1171607,4,0.37037037,1,0.777777778,2088
07c31347fd81a2441825f9efb47edf39d85f85fa,0,Todd Lipcon,2017-09-15 05:56:39+00:00,['71a44b4c29ab8506c688ad26635dc4d2672ba948'],0,48,48,1171655,2,0,1,1,2088
3c26cc3c2d745afa905888576ac392f5dbc86a66,0,Todd Lipcon,2017-09-15 05:56:43+00:00,['07c31347fd81a2441825f9efb47edf39d85f85fa'],2,35,37,1171692,5,,,,2088
0f0f54eef51ad822bb937175ea14bf2a5f5491e3,0,Todd Lipcon,2017-09-15 06:02:16+00:00,['3c26cc3c2d745afa905888576ac392f5dbc86a66'],6,14,20,1171712,2,0,0.666666667,0.666666667,2088
41a41fdf79f641f3d43f4730d533a3df4796a689,0,Mike Percy,2017-09-18 19:31:04+00:00,['0f0f54eef51ad822bb937175ea14bf2a5f5491e3'],9,77,86,1171798,1,,,,2088
e171466e8064b1c4d24d387eb51014ad77bb65fa,1,Adar Dembo,2017-09-18 21:21:44+00:00,['41a41fdf79f641f3d43f4730d533a3df4796a689'],60,113,173,1171971,6,0.153846154,0.923076923,0.948717949,2088
57de48d2007a3ca5be40e5c3f268223abe8dc64e,0,Dan Burkert,2017-09-18 21:24:49+00:00,['e171466e8064b1c4d24d387eb51014ad77bb65fa'],15,5,20,1171991,5,,,,2088
a9a1b80ae67b7e75b76a4b8862c77357d450d43b,0,Jean-Daniel Cryans,2017-09-18 22:19:24+00:00,['57de48d2007a3ca5be40e5c3f268223abe8dc64e'],5,30,35,1172026,1,,,,2088
2b95bf1699accca7a938743917aaae776b5b861d,0,Adar Dembo,2017-09-18 23:07:12+00:00,['a9a1b80ae67b7e75b76a4b8862c77357d450d43b'],16,3,19,1172045,3,1,0,0.909090909,2088
c1f78ffb59af28c0f453cb8485ed946465f19f43,1,Adar Dembo,2017-09-18 23:07:15+00:00,['2b95bf1699accca7a938743917aaae776b5b861d'],405,708,1113,1173158,18,0.780701754,1,0.01754386,2089
23f0b514fa25d03ecd0558d4e531cd1c2c94269c,0,Adar Dembo,2017-09-18 23:07:45+00:00,['c1f78ffb59af28c0f453cb8485ed946465f19f43'],1,2,3,1173161,1,0,0,1,2089
052d1def8c39a4e50f4957a95ae19764deb30938,0,Adar Dembo,2017-09-18 23:46:12+00:00,['23f0b514fa25d03ecd0558d4e531cd1c2c94269c'],4,3,7,1173168,1,,,,2089
5c8a8a2ab9d20ef89e6264cc43b0a3747567434e,0,Alexey Serbin,2017-09-19 18:26:19+00:00,['052d1def8c39a4e50f4957a95ae19764deb30938'],101,80,181,1173349,35,,,,2089
501112b5d779464210326b219ad1929a74ae2aed,0,Adar Dembo,2017-09-19 18:41:01+00:00,['5c8a8a2ab9d20ef89e6264cc43b0a3747567434e'],15,145,160,1173509,14,0.857142857,0.857142857,1,2091
142464e8bb76ccb42006c9f2fceb39119d895a53,0,Todd Lipcon,2017-09-19 20:27:18+00:00,['501112b5d779464210326b219ad1929a74ae2aed'],148,348,496,1174005,30,1,1,1,2092
adedbc746a4d2e4c32f5d2a3e2dd7fb3cdc19706,0,Todd Lipcon,2017-09-19 22:43:22+00:00,['142464e8bb76ccb42006c9f2fceb39119d895a53'],28,15,43,1174048,1,1,0.2,1,2092
a77c33d91665a56b04da881cd5d8c3ef2fa80d01,0,Adar Dembo,2017-09-19 22:54:03+00:00,['adedbc746a4d2e4c32f5d2a3e2dd7fb3cdc19706'],1,1,2,1174050,1,,,,2092
adabde59d1c44888614724b4ed79b3de063b7b1e,1,Will Berkeley,2017-09-20 15:32:16+00:00,['a77c33d91665a56b04da881cd5d8c3ef2fa80d01'],114,343,457,1174507,31,0.5,1,0.953125,2092
fb74d34597d80e91bb6188d51b04e5a6707a12c2,0,Will Berkeley,2017-09-20 17:28:22+00:00,['adabde59d1c44888614724b4ed79b3de063b7b1e'],273,106,379,1174886,5,0.424242424,0.590909091,0,2092
02ba0ec6ca0ae1903dee2af69b6dc8c365772b16,0,Adar Dembo,2017-09-20 18:36:55+00:00,['fb74d34597d80e91bb6188d51b04e5a6707a12c2'],44,46,90,1174976,15,1,1,1,2092
3e6e12a9f41abb0f354a81af46698b697c2dcb6f,0,Alexey Serbin,2017-09-20 19:25:59+00:00,['02ba0ec6ca0ae1903dee2af69b6dc8c365772b16'],347,325,672,1175648,155,0.666666667,0,0,2093
3ab3f45094c32d903ea179be959e4c862b05f668,0,Todd Lipcon,2017-09-20 20:23:20+00:00,['3e6e12a9f41abb0f354a81af46698b697c2dcb6f'],20,91,111,1175759,1,0.2,0.2,0.933333333,2093
5a0015e75c6bde8ddb6f113083c3e7d46e48c5de,1,Dan Burkert,2017-09-20 21:25:57+00:00,['3ab3f45094c32d903ea179be959e4c862b05f668'],13,23,36,1175795,3,0,0,0,2093
6b364a24c9b5acff3aa539d0ad8a6ca1ce9d8c67,0,Mike Percy,2017-09-21 01:13:13+00:00,['5a0015e75c6bde8ddb6f113083c3e7d46e48c5de'],39,216,255,1176050,12,0.039215686,1,1,2094
edd41cb40fbad206e2c356983baba8fbc57199b5,1,Adar Dembo,2017-09-21 01:46:40+00:00,['6b364a24c9b5acff3aa539d0ad8a6ca1ce9d8c67'],3,23,26,1176076,2,1,1,1,2094
e66fb10da44dfd1b5bd5611b9714fe594c0df7d0,1,Will Berkeley,2017-09-21 19:24:53+00:00,['edd41cb40fbad206e2c356983baba8fbc57199b5'],182,315,497,1176573,6,1,1,0.681818182,2095
4daa3ce8742280495c7b6f9a9b2a828e3572ea2c,0,Will Berkeley,2017-09-21 20:05:23+00:00,['e66fb10da44dfd1b5bd5611b9714fe594c0df7d0'],9,107,116,1176689,6,0.158730159,0.571428571,0.698412698,2095
315a464c192d04e37f75a84aaceae22cc8f4425f,0,Dan Burkert,2017-09-21 20:15:26+00:00,['4daa3ce8742280495c7b6f9a9b2a828e3572ea2c'],0,13,13,1176702,1,,,,2095
9c5d6d4dfdd20c7c00896a2ddce1582971aeffe4,0,Adar Dembo,2017-09-22 21:03:18+00:00,['315a464c192d04e37f75a84aaceae22cc8f4425f'],0,2,2,1176704,1,,,,2095
06a19bd25a964664db08ef89ab0ebe26369519ab,0,Will Berkeley,2017-09-22 22:22:29+00:00,['9c5d6d4dfdd20c7c00896a2ddce1582971aeffe4'],3,3,6,1176710,2,,,,2095
9c1997ad3473ab3ce29061c4cd2aa11552967a98,0,Alexey Serbin,2017-09-22 22:46:34+00:00,['06a19bd25a964664db08ef89ab0ebe26369519ab'],1,1,2,1176712,1,,,,2095
26a32fc4b01a2bb9c552ae586060bc0ba97b53c1,0,Dan Burkert,2017-09-25 18:51:48+00:00,['9c1997ad3473ab3ce29061c4cd2aa11552967a98'],20,109,129,1176841,11,0.20754717,0,0.962264151,2095
98b66574b06838347e323b997778f964acba1abd,0,Alexey Serbin,2017-09-25 23:24:44+00:00,['26a32fc4b01a2bb9c552ae586060bc0ba97b53c1'],13,11,24,1176865,2,1,0,0.5,2095
bab96a2b299de4f1f911e23c80167938ed69394d,0,Alexey Serbin,2017-09-26 00:56:27+00:00,['98b66574b06838347e323b997778f964acba1abd'],21,17,38,1176903,6,,,,2095
36f4259f425d2e756153863deb83ca40478331cd,1,Adar Dembo,2017-09-27 20:59:59+00:00,['bab96a2b299de4f1f911e23c80167938ed69394d'],1,1,2,1176905,1,,,,2095
9b0544ae3466235cb5bc699ec1a4def3d2aa1f02,0,Alexey Serbin,2017-09-27 23:18:04+00:00,['36f4259f425d2e756153863deb83ca40478331cd'],2,2,4,1176909,1,,,,2095
aa52b05e783f45ec8d04f61352216df56fa9e13e,0,Adar Dembo,2017-09-28 04:49:03+00:00,['9b0544ae3466235cb5bc699ec1a4def3d2aa1f02'],1,3,4,1176913,1,0,0,1,2095
37571b19952958320be2518ddbe1a35cf266cca4,0,Adar Dembo,2017-09-28 04:49:07+00:00,['aa52b05e783f45ec8d04f61352216df56fa9e13e'],0,2,2,1176915,1,1,1,1,2095
54aef924a4fab41d1fc939a479894ecd561b8d43,0,Adar Dembo,2017-09-28 04:49:09+00:00,['37571b19952958320be2518ddbe1a35cf266cca4'],1,2,3,1176918,1,1,1,1,2095
aeb1d53892fee01b93cff304cc91a95268eb7a74,0,Dan Burkert,2017-09-28 23:49:32+00:00,['54aef924a4fab41d1fc939a479894ecd561b8d43'],0,194,194,1177112,3,0.414285714,0.671428571,1,2097
461cd1fddfcb37fd85244e2f683d9a1cd2149c5a,0,Adar Dembo,2017-09-29 18:13:16+00:00,['aeb1d53892fee01b93cff304cc91a95268eb7a74'],35,63,98,1177210,2,0.590909091,0.909090909,1,2097
0340a4376a9f6b11f8769ec034d3b9f71cbd51ef,0,Adar Dembo,2017-09-29 18:13:57+00:00,['461cd1fddfcb37fd85244e2f683d9a1cd2149c5a'],306,439,745,1177955,10,0.540540541,1,1,2098
8f6ef48ea6cb178e5e5b3c88edf5bfc221d9354a,0,Adar Dembo,2017-09-29 20:30:39+00:00,['0340a4376a9f6b11f8769ec034d3b9f71cbd51ef'],38,143,181,1178136,4,0,0.897435897,0.948717949,2098
bec2a2463df0dc23b9ed2e1e8b2fc2ad03686950,0,Adar Dembo,2017-09-29 20:55:52+00:00,['8f6ef48ea6cb178e5e5b3c88edf5bfc221d9354a'],12,12,24,1178160,1,,,,2098
3ec8834a43ba3ee5728fba0a3ed774c945279b7b,0,Will Berkeley,2017-10-02 16:30:48+00:00,['bec2a2463df0dc23b9ed2e1e8b2fc2ad03686950'],2,18,20,1178180,4,0,0.625,0.625,2098
5ca7deae7483d9e6427d795b806680ec3c08a73c,0,Will Berkeley,2017-10-02 18:58:16+00:00,['3ec8834a43ba3ee5728fba0a3ed774c945279b7b'],1,21,22,1178202,4,1,1,1,2098
c0be2370d543f749a783d594b3e33919f9818877,1,Adar Dembo,2017-10-02 19:24:54+00:00,['5ca7deae7483d9e6427d795b806680ec3c08a73c'],19,33,52,1178254,2,0,0,1,2098
350c8a79c87c9d841ce36065687080e5a0a4ab1e,1,Adar Dembo,2017-10-02 19:24:57+00:00,['c0be2370d543f749a783d594b3e33919f9818877'],169,342,511,1178765,86,,,,2099
4c7d8e0402ff9a226b5b7c8f4b3c5641829602ef,0,Adar Dembo,2017-10-03 21:08:03+00:00,['350c8a79c87c9d841ce36065687080e5a0a4ab1e'],0,5,5,1178770,1,,,,2099
77dea331d8d0919d3b9ba2c8cc7f776b5d5f3a6f,0,Alexey Serbin,2017-10-04 01:26:20+00:00,['4c7d8e0402ff9a226b5b7c8f4b3c5641829602ef'],1,1,2,1178772,1,,,,2099
3b0ef599b2fc3fc9b895937548e98c57552b021f,0,Alexey Serbin,2017-10-04 18:30:55+00:00,['77dea331d8d0919d3b9ba2c8cc7f776b5d5f3a6f'],0,33,33,1178805,1,,,,2099
e51211997e47d88ea0ed5b6476c0655f84eebfb7,0,Adar Dembo,2017-10-04 22:28:40+00:00,['3b0ef599b2fc3fc9b895937548e98c57552b021f'],18,138,156,1178961,3,0.5,0.9,1,2099
dca65a02e03356890fe7d6017375e7b0b58028ce,0,Will Berkeley,2017-10-05 01:52:16+00:00,['e51211997e47d88ea0ed5b6476c0655f84eebfb7'],0,2,2,1178963,1,,,,2099
3f2bf6df5ddd2221d40913619707033cc6627625,0,Adar Dembo,2017-10-05 04:15:00+00:00,['dca65a02e03356890fe7d6017375e7b0b58028ce'],36,53,89,1179052,6,,,,2099
8101bad58a3c4a38182427988ed3fae7bfbc2b5f,0,Adar Dembo,2017-10-05 04:15:06+00:00,['3f2bf6df5ddd2221d40913619707033cc6627625'],17,34,51,1179103,4,0.5,1,1,2099
a2485f501c5e1aba43730abbbf32ee4393732fd0,1,Adar Dembo,2017-10-05 04:43:31+00:00,['8101bad58a3c4a38182427988ed3fae7bfbc2b5f'],15,15,30,1179133,5,,,,2099
caff45f5d6e38d21625122b5755fee10cc94df9d,0,Todd Lipcon,2017-10-05 17:36:45+00:00,['a2485f501c5e1aba43730abbbf32ee4393732fd0'],1,1,2,1179135,1,,,,2099
1ee495255d5e01e22f6675d93e46f9080bf6a6aa,0,Will Berkeley,2017-10-05 22:18:07+00:00,['caff45f5d6e38d21625122b5755fee10cc94df9d'],137,269,406,1179541,12,0.0375,0.475,0.7125,2099
858bf73b380d10f16e7aca04a780a0adae705e9a,0,Adar Dembo,2017-10-06 04:30:50+00:00,['1ee495255d5e01e22f6675d93e46f9080bf6a6aa'],47,71,118,1179659,3,0,1,1,2099
31d58522b50aea948f977c7cbc8b64f1b849f323,1,Dan Burkert,2017-10-06 21:32:38+00:00,['858bf73b380d10f16e7aca04a780a0adae705e9a'],28,59,87,1179746,10,0.444444444,0.777777778,0.666666667,2099
0e713aadb9ba83df4d986dfe6bcdde1c1d30206b,0,Adar Dembo,2017-10-06 22:09:58+00:00,['31d58522b50aea948f977c7cbc8b64f1b849f323'],31,47,78,1179824,2,,,,2099
761ce10b797c4f6345f0b84cfe30bcc92e346893,1,Adar Dembo,2017-10-06 22:50:18+00:00,['0e713aadb9ba83df4d986dfe6bcdde1c1d30206b'],14,1209,1223,1181047,10,0.100449775,0.296851574,0.713643178,2101
29a7568ddb5d24b1faf583b45d38884bfeb2b260,0,Adar Dembo,2017-10-09 00:07:08+00:00,['761ce10b797c4f6345f0b84cfe30bcc92e346893'],444,391,835,1181882,3,0.659090909,0,0.022727273,2101
0c823987fd17698e523b812ba8e923ca0085b1e4,0,Todd Lipcon,2017-10-09 23:22:08+00:00,['29a7568ddb5d24b1faf583b45d38884bfeb2b260'],42,320,362,1182244,6,0.012658228,0.924050633,0.85443038,2101
1d928951e375c0cdb6c3c151c5bacb3779805f5f,1,Adar Dembo,2017-10-09 23:52:19+00:00,['0c823987fd17698e523b812ba8e923ca0085b1e4'],99,45,144,1182388,2,1,1,0,2101
1680d23bee0a3c95e20a7b84a52a075d06af1e6c,0,Adar Dembo,2017-10-10 00:54:38+00:00,['1d928951e375c0cdb6c3c151c5bacb3779805f5f'],16,18,34,1182422,1,0,1,1,2101
8455f0374eed60950679500d3faac70213b8ff2d,1,Adar Dembo,2017-10-10 04:17:55+00:00,['1680d23bee0a3c95e20a7b84a52a075d06af1e6c'],1214,380,1594,1184016,10,0.545454545,0.114832536,0.299043062,2101
c929a06052d6a77d1abba52cec57214f6225fb0f,0,Adar Dembo,2017-10-10 18:04:50+00:00,['8455f0374eed60950679500d3faac70213b8ff2d'],4,3,7,1184023,1,,,,2101
2a802f9f376de5175170a933bc8c35154f6eda92,0,Todd Lipcon,2017-10-10 19:00:15+00:00,['c929a06052d6a77d1abba52cec57214f6225fb0f'],22,62,84,1184107,5,0.846153846,0.384615385,0.538461538,2101
6523a773eda899fd376dd0b68871c3dcd5737b8e,1,Adar Dembo,2017-10-10 20:23:21+00:00,['2a802f9f376de5175170a933bc8c35154f6eda92'],116,165,281,1184388,14,0.142857143,0.952380952,1,2101
afdeb9ea218216631ae325b3205c23adb1061037,0,Adar Dembo,2017-10-10 22:30:41+00:00,['6523a773eda899fd376dd0b68871c3dcd5737b8e'],1,12,13,1184401,1,,,,2101
3e8f1af30b9e2b1d81d654293b4019cf6ef51db9,0,Adar Dembo,2017-10-11 17:20:04+00:00,['afdeb9ea218216631ae325b3205c23adb1061037'],3,13,16,1184417,2,0,1,1,2101
82708e9a49f28112a48230e0380843480f69e016,0,GitHub,2017-10-11 12:32:14-07:00,"['54348ce1c9670d8118dc493be8a8a5c263fe2970', '4d2c46f236562f0631ce5c6020431e0f93a5f55a']",52,22,74,1184491,4,,,,2101
cd58992e9080836d4fef334ab0ea62dbed53bf4e,0,Adar Dembo,2017-10-11 12:56:49-07:00,['82708e9a49f28112a48230e0380843480f69e016'],1,1,2,1184493,1,,,,2101
0174c2678c632809778daaeaf5566b1d91650059,1,Adar Dembo,2017-10-12 00:01:57+00:00,['3e8f1af30b9e2b1d81d654293b4019cf6ef51db9'],177,340,517,1185010,18,0,0.549019608,0.960784314,2101
9583cad6e9e227ddded9eae66019d392a6998094,0,Dan Burkert,2017-10-12 02:43:13+00:00,['0174c2678c632809778daaeaf5566b1d91650059'],65,225,290,1185300,4,0.06779661,0.830508475,0.847457627,2101
7545deccb8e12effa17a955ab5b841bdcc5afe85,0,GitHub,2017-10-12 08:03:43-07:00,"['82708e9a49f28112a48230e0380843480f69e016', 'cd58992e9080836d4fef334ab0ea62dbed53bf4e']",1,1,2,1185302,1,,,,2101
f373af07da4995872d37c6817f214bc39f9d8e4d,0,Dan Burkert,2017-10-12 18:26:49+00:00,['9583cad6e9e227ddded9eae66019d392a6998094'],62,140,202,1185504,13,0,1,1,2101
b6f727ea29707c16e90f9d584ac8ae70ecf3050b,0,Adar Dembo,2017-10-12 19:18:11+00:00,['f373af07da4995872d37c6817f214bc39f9d8e4d'],2,49,51,1185555,4,,,,2101
eb5c7e2f0c73729a4486bc71512739b0788b1574,0,Todd Lipcon,2017-10-13 01:58:04+00:00,['b6f727ea29707c16e90f9d584ac8ae70ecf3050b'],20,19,39,1185594,12,0,0,0,2101
83b693150d0c5772ae52cf9bc2bad58a46c25a92,0,Todd Lipcon,2017-10-14 00:46:29+00:00,['eb5c7e2f0c73729a4486bc71512739b0788b1574'],1,1,2,1185596,1,,,,2101
24308aa1a5fd05e616dad2e8ee7482a74b9350de,0,Alexey Serbin,2017-10-15 04:09:19+00:00,['83b693150d0c5772ae52cf9bc2bad58a46c25a92'],0,3,3,1185599,1,,,,2101
78843dd81c628239a5fdd962208f949c63273384,0,Alexey Serbin,2017-10-16 18:21:49+00:00,['24308aa1a5fd05e616dad2e8ee7482a74b9350de'],1,1,2,1185601,1,,,,2101
92064c023b432f07161dd06eee26b9d2100eb55b,0,Adar Dembo,2017-10-16 19:59:19+00:00,['78843dd81c628239a5fdd962208f949c63273384'],1,2,3,1185604,1,0,0,1,2101
3a7342a31b2c0e30f5175a2b26b6fdb6acac0dff,1,Alexey Serbin,2017-10-16 20:42:25+00:00,['92064c023b432f07161dd06eee26b9d2100eb55b'],968,1271,2239,1187843,13,1,0.75,0.6875,2103
4414089085876b6acfc4025391cd2b96bf833944,1,Alexey Serbin,2017-10-16 21:50:29+00:00,['3a7342a31b2c0e30f5175a2b26b6fdb6acac0dff'],13,11,24,1187867,2,1,1,1,2103
ab77ce025d9fe68c993d26e15b604c4188e36860,1,Alexey Serbin,2017-10-17 01:09:23+00:00,['4414089085876b6acfc4025391cd2b96bf833944'],1071,1316,2387,1190254,8,0.285714286,0.857142857,0.714285714,2106
29514389ab629a9827c40b9d08acb378adc44801,0,Dan Burkert,2017-10-17 01:17:09+00:00,['ab77ce025d9fe68c993d26e15b604c4188e36860'],70,58,128,1190382,10,1,0.631578947,0.157894737,2106
57b8b8fdf33b312ab4a5d70e98dfe5e98a491b17,0,Dan Burkert,2017-10-17 01:38:31+00:00,['29514389ab629a9827c40b9d08acb378adc44801'],1,30,31,1190413,4,0.333333333,0.333333333,1,2106
f5e1203a344c031e357075c900740da33f4d736e,1,Todd Lipcon,2017-10-17 04:11:54+00:00,['57b8b8fdf33b312ab4a5d70e98dfe5e98a491b17'],56,164,220,1190633,4,0,0,0.9,2106
c18815f1edd3fc23abc874ffe9fe564c3114fc8e,0,Todd Lipcon,2017-10-17 04:21:34+00:00,['f5e1203a344c031e357075c900740da33f4d736e'],12,19,31,1190664,2,0,1,1,2106
33c06692e60d0347063fb92a0affddd471e06b3f,1,Todd Lipcon,2017-10-17 04:36:24+00:00,['c18815f1edd3fc23abc874ffe9fe564c3114fc8e'],94,185,279,1190943,5,0.586206897,0,0,2108
60ea4a64366d46a7b2e86aef5c9b38c32e6af15b,0,Todd Lipcon,2017-10-17 04:39:03+00:00,['33c06692e60d0347063fb92a0affddd471e06b3f'],17,96,113,1191056,5,0,1,0.866666667,2108
8c23c97b82708b96e163e75e0002ce96adf8d8fc,0,Will Berkeley,2017-10-17 14:54:51+00:00,['60ea4a64366d46a7b2e86aef5c9b38c32e6af15b'],11,146,157,1191213,5,0.094736842,0.705263158,0.957894737,2108
fe23710c63c90e561b2622f6f67563572d10dbf9,0,Alexey Serbin,2017-10-17 15:20:31+00:00,['8c23c97b82708b96e163e75e0002ce96adf8d8fc'],82,671,753,1191966,13,0.13961039,0.003246753,0.896103896,2109
9fa9cf181ded1736c6014792fe619f5e0b9a94b4,0,Adar Dembo,2017-10-17 16:36:27+00:00,['fe23710c63c90e561b2622f6f67563572d10dbf9'],53,105,158,1192124,4,0.708333333,1,1,2109
d7622024579b93956a86dbe1b61dedd890adcbfc,0,Adar Dembo,2017-10-17 16:38:40+00:00,['9fa9cf181ded1736c6014792fe619f5e0b9a94b4'],53,134,187,1192311,12,0.039215686,1,0.823529412,2109
294a8fa65b41c539dc4590f2f050568f1d1d747a,0,Dan Burkert,2017-10-17 18:14:41+00:00,['d7622024579b93956a86dbe1b61dedd890adcbfc'],1,1,2,1192313,1,,,,2109
827c35bc356640ef13d85278043f9e10b5d30079,0,Adar Dembo,2017-10-17 19:40:57+00:00,['294a8fa65b41c539dc4590f2f050568f1d1d747a'],9,11,20,1192333,1,,,,2109
abbfa49dee52d49dc4658c1ef57ed8467e43bb5d,0,Alexey Serbin,2017-10-17 21:50:28+00:00,['827c35bc356640ef13d85278043f9e10b5d30079'],6,7,13,1192346,3,0,0,0,2109
1c90b2f5c4e998d1db773ff2a2e67d8d93edfeea,0,Will Berkeley,2017-10-17 22:14:57+00:00,['abbfa49dee52d49dc4658c1ef57ed8467e43bb5d'],26,23,49,1192395,17,,,1,2109
57d5a31513aabd1b7f8b5e0b6d5c0aba408d0fc7,0,Dan Burkert,2017-10-17 23:58:49+00:00,['1c90b2f5c4e998d1db773ff2a2e67d8d93edfeea'],6,680,686,1193081,9,0.188235294,0.929411765,1,2115
aa7d6a97bc8561ae4bc96a5c923736cb4676ecfa,1,Alexey Serbin,2017-10-18 02:12:48+00:00,['57d5a31513aabd1b7f8b5e0b6d5c0aba408d0fc7'],20,24,44,1193125,5,0,1,1,2115
42ed9bd7e4d72d752ad9e06fda171231710a79ad,0,Todd Lipcon,2017-10-18 19:22:37+00:00,['aa7d6a97bc8561ae4bc96a5c923736cb4676ecfa'],2169,0,2169,1195294,22,0.511111111,0,0.034343434,2115
892a5fc03d164b652ee1cef0353be0e6dd1da559,0,Todd Lipcon,2017-10-18 19:23:09+00:00,['42ed9bd7e4d72d752ad9e06fda171231710a79ad'],136,159,295,1195589,57,0.25,0,1,2115
f96ab36adea6d653641cd09fdb9ed92ee8d0c8bc,0,Todd Lipcon,2017-10-18 19:23:55+00:00,['892a5fc03d164b652ee1cef0353be0e6dd1da559'],77,80,157,1195746,8,1,1,0,2115
27a62b0ca510bc682703b4c5da0b0160c4d4e5b3,0,Todd Lipcon,2017-10-18 19:33:35+00:00,['f96ab36adea6d653641cd09fdb9ed92ee8d0c8bc'],81,65,146,1195892,7,0,0,0,2115
7a460f0455e64ca001994f66e0ce0142fc6f1980,0,Todd Lipcon,2017-10-18 19:33:54+00:00,['27a62b0ca510bc682703b4c5da0b0160c4d4e5b3'],22,37,59,1195951,5,1,1,0,2115
67382e9a408086a9ad25598d4f0d68650c176ed1,0,Jean-Daniel Cryans,2017-10-18 20:54:19+00:00,['7a460f0455e64ca001994f66e0ce0142fc6f1980'],0,6,6,1195957,1,,,,2115
20118c7e45b701927174f8efdac37dc3b4cc2fb1,0,Adar Dembo,2017-10-18 21:13:58+00:00,['67382e9a408086a9ad25598d4f0d68650c176ed1'],6,7,13,1195970,1,1,1,1,2115
bba425e8de0f6fcbd78013960faa327fa0be7b85,0,Alexey Serbin,2017-10-18 22:16:22+00:00,['20118c7e45b701927174f8efdac37dc3b4cc2fb1'],7,17,24,1195994,2,0,1,1,2115
c60990c2754b8239cf4e8284781a794841feff20,0,Todd Lipcon,2017-10-18 23:36:34+00:00,['bba425e8de0f6fcbd78013960faa327fa0be7b85'],1,1,2,1195996,1,,,,2115
43a64f8bf43721539a8b82789eb7fb44547638e8,0,Adar Dembo,2017-10-19 00:59:28+00:00,['c60990c2754b8239cf4e8284781a794841feff20'],5,6,11,1196007,1,0,1,0,2115
edb5ae3c955fece83a079d0161ab92e03404308a,0,Adar Dembo,2017-10-19 18:29:54+00:00,['43a64f8bf43721539a8b82789eb7fb44547638e8'],3,3,6,1196013,2,,,,2115
d33075ebc798999c9fe6ed546ad8426e97e3ff7f,0,Adar Dembo,2017-10-19 18:29:55+00:00,['edb5ae3c955fece83a079d0161ab92e03404308a'],10,7,17,1196030,2,,,,2115
741bdfa415c5ca11b5bb973b7fba4697a278e4d8,0,Todd Lipcon,2017-10-19 18:44:36+00:00,['d33075ebc798999c9fe6ed546ad8426e97e3ff7f'],10,10,20,1196050,5,0,0,0,2115
4d84eeea1695734f2723af0e200f134b9fe72005,0,Todd Lipcon,2017-10-19 18:49:33+00:00,['741bdfa415c5ca11b5bb973b7fba4697a278e4d8'],17,36,53,1196103,4,0,1,0,2115
a6f2322b241189d0a32d1d07165dee8268e4dcaa,1,Alexey Serbin,2017-10-19 21:47:22+00:00,['4d84eeea1695734f2723af0e200f134b9fe72005'],76,89,165,1196268,5,1,0.5,0,2115
f2eb6c277860890b1177071ae265bace5837a0f1,0,Adar Dembo,2017-10-19 22:31:24+00:00,['a6f2322b241189d0a32d1d07165dee8268e4dcaa'],7,26,33,1196301,3,0.875,0.875,1,2115
c7fa4aaf704e4035843bc8fe20e5ecada2ed1acc,1,Will Berkeley,2017-10-20 00:37:55+00:00,['f2eb6c277860890b1177071ae265bace5837a0f1'],3,24,27,1196328,2,0,0.384615385,1,2115
4172983fd29f5e2fd9b322ff10c2b016f89a5acb,0,Adar Dembo,2017-10-20 00:40:38+00:00,['c7fa4aaf704e4035843bc8fe20e5ecada2ed1acc'],16,8,24,1196352,3,0,0,0,2115
ac18aca755daae6b9f2826b71f4a458e2b0fefa1,0,Adar Dembo,2017-10-21 01:10:02+00:00,['4172983fd29f5e2fd9b322ff10c2b016f89a5acb'],44,123,167,1196519,3,0.256410256,0.076923077,1,2115
407f55327e34008929edabbceda3a16a349e9045,0,Alexey Serbin,2017-10-23 17:49:43+00:00,['ac18aca755daae6b9f2826b71f4a458e2b0fefa1'],260,227,487,1197006,18,1,0.0625,0,2115
ace9685dc1fbda0e161c76f546b2e9892b4f7739,0,Dan Burkert,2017-10-23 19:31:14+00:00,['407f55327e34008929edabbceda3a16a349e9045'],3,4,7,1197013,1,,,,2115
ae033247a2c0a7392c11ff4c0ad4825f51385d48,0,Todd Lipcon,2017-10-23 22:23:22+00:00,['ace9685dc1fbda0e161c76f546b2e9892b4f7739'],26,20,46,1197059,1,0,0,1,2115
09ac5bfd6288825345ce6a3ce51c2dccd28dccaa,0,Adar Dembo,2017-10-23 23:43:02+00:00,['ae033247a2c0a7392c11ff4c0ad4825f51385d48'],188,205,393,1197452,19,1,1,1,2115
e938aaa212b5825294dbc79fd5bad81aacc3dcad,0,Todd Lipcon,2017-10-24 17:24:01+00:00,['09ac5bfd6288825345ce6a3ce51c2dccd28dccaa'],5,15,20,1197472,2,0,0,0,2115
28a671365d6d38da966481daf937b3776e3d4852,1,Todd Lipcon,2017-10-24 18:16:36+00:00,['e938aaa212b5825294dbc79fd5bad81aacc3dcad'],14,345,359,1197831,8,0.080717489,0.264573991,0.721973094,2115
dfaaf9ade5721550d95b4da861fd24faeca5b6ec,0,Todd Lipcon,2017-10-24 20:44:24+00:00,['28a671365d6d38da966481daf937b3776e3d4852'],11,24,35,1197866,1,0,0,1,2115
15f3f9b2f7421b27dfb2bbdd8f6314939ef7c993,1,Adar Dembo,2017-10-25 18:48:47+00:00,['dfaaf9ade5721550d95b4da861fd24faeca5b6ec'],187,434,621,1198487,9,0.157608696,0.027173913,0.739130435,2115
e63d2be624f46a37cbf7ceda5c2affdab0d3281c,0,Dan Burkert,2017-10-25 19:09:36+00:00,['15f3f9b2f7421b27dfb2bbdd8f6314939ef7c993'],41,51,92,1198579,12,0.5,0.75,0,2115
69b82b5cc7548519f4474af1d0436ac5ffb8c943,0,Todd Lipcon,2017-10-25 20:28:46+00:00,['e63d2be624f46a37cbf7ceda5c2affdab0d3281c'],1,5,6,1198585,1,,,,2115
e03b8e4437920239ca5542143d36c7bd5a496eb2,0,Adar Dembo,2017-10-26 16:11:42+00:00,['69b82b5cc7548519f4474af1d0436ac5ffb8c943'],14,15,29,1198614,2,0,0,1,2115
d2be2834abccb831df63c3f978f32becbed32ee9,0,Adar Dembo,2017-10-26 16:11:56+00:00,['e03b8e4437920239ca5542143d36c7bd5a496eb2'],2,2,4,1198618,1,,,,2115
c8603ab77bfc9906dcf1affdd7b0b1c77d21537b,0,Adar Dembo,2017-10-26 16:12:11+00:00,['d2be2834abccb831df63c3f978f32becbed32ee9'],2,3,5,1198623,1,,,,2115
49a7d9712bf367b89946e0b81f5db26a85ef00aa,0,Todd Lipcon,2017-10-26 20:39:40+00:00,['c8603ab77bfc9906dcf1affdd7b0b1c77d21537b'],0,6,6,1198629,1,,,,2115
6097e2d1a4287563ef22a4f6e32e6f4ee2604031,0,Alexey Serbin,2017-10-26 20:43:51+00:00,['49a7d9712bf367b89946e0b81f5db26a85ef00aa'],11,41,52,1198681,1,0,0.5,0.5,2115
13908bd9f74e47ea4ff095e2ee45c5632b6fdd8c,0,Adar Dembo,2017-10-26 21:44:11+00:00,['6097e2d1a4287563ef22a4f6e32e6f4ee2604031'],4,84,88,1198769,4,,,,2118
9a4ea1c7fa1cc6c7345f012f35e7681364ed3534,0,Todd Lipcon,2017-10-26 23:04:50+00:00,['13908bd9f74e47ea4ff095e2ee45c5632b6fdd8c'],6,38,44,1198813,3,0,0.538461538,1,2118
c08f27fc583cbce2c99e4b28c9ddb91e9c9e1e69,0,Jean-Daniel Cryans,2017-10-30 16:02:20+00:00,['9a4ea1c7fa1cc6c7345f012f35e7681364ed3534'],3,42,45,1198858,2,,,,2118
9f85f04a91c38229649ccb4aa4773a45fc742dc3,0,Alexey Serbin,2017-10-30 19:33:07+00:00,['c08f27fc583cbce2c99e4b28c9ddb91e9c9e1e69'],2,1,3,1198861,1,,,,2118
cb4b1c090da07c4f1c74c6c97665e564d3af2abe,0,Todd Lipcon,2017-10-30 19:55:58+00:00,['9f85f04a91c38229649ccb4aa4773a45fc742dc3'],1,21,22,1198883,2,0.647058824,0,1,2118
563f41b5cb2c3b490377d1c1cf6a26c24811d035,0,Adar Dembo,2017-10-31 01:04:11+00:00,['cb4b1c090da07c4f1c74c6c97665e564d3af2abe'],26,53,79,1198962,16,1,1,1,2118
354f4c44562de03e20064a5349c306f3dd05fa19,0,Alexey Serbin,2017-10-31 16:02:53+00:00,['563f41b5cb2c3b490377d1c1cf6a26c24811d035'],3,2,5,1198967,1,,,,2118
edae025c450e100bef2b21bc8ed0dde13ed838aa,0,Adar Dembo,2017-10-31 22:43:19+00:00,['354f4c44562de03e20064a5349c306f3dd05fa19'],1,37,38,1199005,2,0,0.869565217,0.869565217,2118
0bd8800b77a5de53b5db896df20abb83ff2e1779,0,Todd Lipcon,2017-11-01 04:43:07+00:00,['edae025c450e100bef2b21bc8ed0dde13ed838aa'],7,20,27,1199032,1,0,0,0,2118
94bf699645120bbe2a0e9f3d3a33ff65b8214dce,1,Todd Lipcon,2017-11-01 04:43:50+00:00,['0bd8800b77a5de53b5db896df20abb83ff2e1779'],24,25,49,1199081,2,,,,2118
f2c21b4fac15fcaa5f53a6c7960ecd19a0664c45,0,Todd Lipcon,2017-11-01 04:44:02+00:00,['94bf699645120bbe2a0e9f3d3a33ff65b8214dce'],18,31,49,1199130,2,0.428571429,1,1,2118
b2a5bc82b4848467a3173fe303d107836c2d6e57,0,Dan Burkert,2017-11-01 17:22:31+00:00,['f2c21b4fac15fcaa5f53a6c7960ecd19a0664c45'],19,22,41,1199171,3,0,0,1,2118
bf91ac400c02560f69b33619bbf1357adb7ee00c,1,Adar Dembo,2017-11-01 18:25:58+00:00,['b2a5bc82b4848467a3173fe303d107836c2d6e57'],185,171,356,1199527,26,0,0,0,2118
6696b4eb4c19c9d06f736e6d8d0d8f21d123071f,0,Adar Dembo,2017-11-01 18:29:00+00:00,['bf91ac400c02560f69b33619bbf1357adb7ee00c'],0,53,53,1199580,1,0,1,1,2118
55dcdd05883004b18f2f8cb9e29414d358a6621b,0,Todd Lipcon,2017-11-01 23:11:40+00:00,['6696b4eb4c19c9d06f736e6d8d0d8f21d123071f'],14,87,101,1199681,1,0.381818182,1,0.836363636,2118
db3894f6fa6a96da1118341d2ee40c71f863e570,0,Todd Lipcon,2017-11-01 23:17:20+00:00,['55dcdd05883004b18f2f8cb9e29414d358a6621b'],3,22,25,1199706,1,0,0,0,2118
810b9603a0b36778ee99862bc653ee59c53d1eda,0,Todd Lipcon,2017-11-01 23:18:29+00:00,['db3894f6fa6a96da1118341d2ee40c71f863e570'],3,13,16,1199722,1,,,,2118
9dd64e1b3a3ab1a732fb6e0ababe66858cfbfa86,1,Todd Lipcon,2017-11-01 23:41:57+00:00,['810b9603a0b36778ee99862bc653ee59c53d1eda'],30,46,76,1199798,3,1,1,1,2118
3e86797e6e73365c26b8826083c447494c7fa7eb,0,Todd Lipcon,2017-11-02 05:39:01+00:00,['9dd64e1b3a3ab1a732fb6e0ababe66858cfbfa86'],9,256,265,1200063,10,0.093333333,0.506666667,1,2118
d8c39d24b4d88786e7294b9c002c72219a946ca5,0,Todd Lipcon,2017-11-03 00:05:41+00:00,['3e86797e6e73365c26b8826083c447494c7fa7eb'],3,19,22,1200085,1,,,,2118
31d16f7493544c850e019f1d2fdc7eef6e2c2258,1,Todd Lipcon,2017-11-03 00:07:53+00:00,['d8c39d24b4d88786e7294b9c002c72219a946ca5'],7,2928,2935,1203020,18,0.433908046,0.994252874,0.784482759,2127
b418e88b657c91fd53c78cb5567e93a7348042f6,0,Todd Lipcon,2017-11-03 00:09:20+00:00,['31d16f7493544c850e019f1d2fdc7eef6e2c2258'],9,78,87,1203107,6,0.5625,0.5625,0.96875,2127
10f6164b1217e0299bcfedc061d2c57581c389bd,0,Alexey Serbin,2017-11-03 05:12:00+00:00,['b418e88b657c91fd53c78cb5567e93a7348042f6'],53,21,74,1203181,2,1,0,0,2127
e2509a4bdd807d83535e28f94a3986c4510aa7df,0,Adar Dembo,2017-11-03 18:44:02+00:00,['10f6164b1217e0299bcfedc061d2c57581c389bd'],36,33,69,1203250,6,0.25,0.25,0.25,2127
3e821ced2a79e4281b05b8903ee5305979ef322e,0,Dan Burkert,2017-11-03 20:52:52+00:00,['e2509a4bdd807d83535e28f94a3986c4510aa7df'],8,6,14,1203264,1,,,,2127
b167b98e41538f565c6e5d00002ab9df9ed7a845,0,Adar Dembo,2017-11-04 05:08:54+00:00,['3e821ced2a79e4281b05b8903ee5305979ef322e'],15,14,29,1203293,6,0,0,0,2127
10ed76cc1e31e0d226ee5411e738d6675072956a,0,Todd Lipcon,2017-11-06 05:26:15+00:00,['b167b98e41538f565c6e5d00002ab9df9ed7a845'],1,1,2,1203295,1,,,,2127
7f5104586fa381347c582260df539b8cbb02f08b,0,Todd Lipcon,2017-11-06 05:26:38+00:00,['10ed76cc1e31e0d226ee5411e738d6675072956a'],12,119,131,1203426,4,0,0.2,1,2127
f7b54d85b28e59a065fb6d644a9364a69ea578b4,0,Todd Lipcon,2017-11-06 05:27:32+00:00,['7f5104586fa381347c582260df539b8cbb02f08b'],1,1,2,1203428,1,,,,2127
ed45d72070bb4c3f70357d4c67077023c6d186fa,0,Alexey Serbin,2017-11-06 05:45:30+00:00,['f7b54d85b28e59a065fb6d644a9364a69ea578b4'],15,11,26,1203454,1,1,1,0,2127
26b06c5c583591de062be8388172ab6edabf9768,0,Dan Burkert,2017-11-06 17:21:33+00:00,['ed45d72070bb4c3f70357d4c67077023c6d186fa'],1,48,49,1203503,7,0,0.642857143,0.892857143,2127
1520b39585e0bdc4a9b64bf1b900f3ecb05e0276,0,Alexey Serbin,2017-11-06 18:18:11+00:00,['26b06c5c583591de062be8388172ab6edabf9768'],10,12,22,1203525,2,0,1,1,2127
18e024cf8bcaea192efb63780802cc4c799bbb9c,1,Alexey Serbin,2017-11-06 19:20:09+00:00,['1520b39585e0bdc4a9b64bf1b900f3ecb05e0276'],7,227,234,1203759,5,0.057377049,0.131147541,0.631147541,2128
e1d9f0e8ce28e082200de955038d1fd0cde4e8f4,0,Todd Lipcon,2017-11-06 21:57:52+00:00,['18e024cf8bcaea192efb63780802cc4c799bbb9c'],4,2,6,1203765,2,,,,2128
b7afa9caef8263c1d9e9dc39d00f06995de6b5a7,0,Todd Lipcon,2017-11-06 22:20:07+00:00,['e1d9f0e8ce28e082200de955038d1fd0cde4e8f4'],8,12,20,1203785,1,,,,2128
47b81c452194e75da7fd966f07766de4bdcdeab0,0,Andrew Wong,2017-11-06 23:17:22+00:00,['b7afa9caef8263c1d9e9dc39d00f06995de6b5a7'],58,247,305,1204090,15,0.079365079,0.214285714,1,2128
c326afaee4d20f902db18e36897869bc47863428,0,Todd Lipcon,2017-11-07 00:09:25+00:00,['47b81c452194e75da7fd966f07766de4bdcdeab0'],0,1,1,1204091,1,,,,2128
fde2b56cd2dba0e8291a6813e54a1cf6cd921575,0,Will Berkeley,2017-11-07 16:03:38+00:00,['c326afaee4d20f902db18e36897869bc47863428'],0,7,7,1204098,1,,,,2128
0e3b0cecfe40e62f4a5d75e7e6e0bae026b34275,0,Todd Lipcon,2017-11-07 17:44:34+00:00,['fde2b56cd2dba0e8291a6813e54a1cf6cd921575'],2,5,7,1204105,1,0,1,1,2128
9748fd2c802e694d3432e7a111490ac8812c07b5,0,Dan Burkert,2017-11-07 19:14:19+00:00,['0e3b0cecfe40e62f4a5d75e7e6e0bae026b34275'],2,41,43,1204148,2,0.136363636,0.909090909,1,2128
28fdec4053c86f08f410d0ef460e4c82a78f9e1c,0,Alexey Serbin,2017-11-08 18:34:40+00:00,['9748fd2c802e694d3432e7a111490ac8812c07b5'],11,20,31,1204179,3,1,1,1,2128
b02252ad5a8cfc3895c4856e3256c57d76d2cc4e,0,Mike Percy,2017-11-08 18:58:57+00:00,['28fdec4053c86f08f410d0ef460e4c82a78f9e1c'],5,9,14,1204193,1,,,,2128
d3bde5d113d81480b48671d68211e654f170a810,0,Todd Lipcon,2017-11-09 06:51:33+00:00,['b02252ad5a8cfc3895c4856e3256c57d76d2cc4e'],1,1,2,1204195,1,,,,2128
0ca288b917c64207e9e81dd8764f4cb3f0d147c0,0,Mike Percy,2017-11-09 08:34:49+00:00,['d3bde5d113d81480b48671d68211e654f170a810'],11,9,20,1204215,4,1,0,1,2128
c5fa3ed7287d6c3c96e5e8686d26573d49e2e120,0,Mike Percy,2017-11-09 08:37:44+00:00,['0ca288b917c64207e9e81dd8764f4cb3f0d147c0'],1,1,2,1204217,1,1,1,1,2128
04c23bc84efc48a75d44a2a8dce03d317ac4bb66,0,Mike Percy,2017-11-09 08:51:00+00:00,['c5fa3ed7287d6c3c96e5e8686d26573d49e2e120'],1,42,43,1204260,3,0.058823529,1,1,2128
b8e7dd423a66aa19958470a51be74768ef4103a1,0,Alexey Serbin,2017-11-09 17:18:21+00:00,['04c23bc84efc48a75d44a2a8dce03d317ac4bb66'],3,3,6,1204266,3,,,,2128
bf1fcb0df5f2fbb6d1557b6b932bc67045fff531,0,Alexey Serbin,2017-11-10 06:12:45+00:00,['b8e7dd423a66aa19958470a51be74768ef4103a1'],129,294,423,1204689,5,0,0.336363636,0.7,2128
a0af0e224532b86009e6deb693739a0d570c1657,0,Dan Burkert,2017-11-13 23:02:57+00:00,['bf1fcb0df5f2fbb6d1557b6b932bc67045fff531'],5,7,12,1204701,1,0,1,1,2128
c4ad758a238e0d0d53c5dccf5dcee61cd6c8342c,0,Dan Burkert,2017-11-13 23:22:38+00:00,['a0af0e224532b86009e6deb693739a0d570c1657'],9,106,115,1204816,5,,,,2130
a47b0403030bafc6fb808b13517c191a9d60b389,0,Todd Lipcon,2017-11-14 02:26:16+00:00,['c4ad758a238e0d0d53c5dccf5dcee61cd6c8342c'],10,10,20,1204836,3,,,,2130
044d5fe684b07a66749188168701ff7b5b2b0789,1,Todd Lipcon,2017-11-14 07:40:35+00:00,['a47b0403030bafc6fb808b13517c191a9d60b389'],169,730,899,1205735,11,0.06043956,0.42032967,0.774725275,2130
bb90de0edb57b5be733b6bb83d6eebf2c5f0f855,0,Todd Lipcon,2017-11-15 20:12:46+00:00,['044d5fe684b07a66749188168701ff7b5b2b0789'],0,4,4,1205739,1,,,,2130
48bc4054846f1809d7c8945c4222772beedf9cbb,0,Todd Lipcon,2017-11-15 22:30:36+00:00,['bb90de0edb57b5be733b6bb83d6eebf2c5f0f855'],2,3,5,1205744,1,,,,2130
1e4db3148a1cb4e340aa96edaea85c733cfdbf5a,1,Mike Percy,2017-11-16 22:30:13+00:00,['48bc4054846f1809d7c8945c4222772beedf9cbb'],111,320,431,1206175,5,0.027027027,0.234234234,0.756756757,2130
338cf61cb7ec4357e91b9f55d9fe4ed9b3ee641c,0,Todd Lipcon,2017-11-16 22:44:22+00:00,['1e4db3148a1cb4e340aa96edaea85c733cfdbf5a'],11,20,31,1206206,1,0,1,1,2130
471feccd073e90ac767ce6d6339b4fda71f72ff0,0,Alexey Serbin,2017-11-17 07:40:36+00:00,['338cf61cb7ec4357e91b9f55d9fe4ed9b3ee641c'],2,2,4,1206210,1,,,,2130
64eb9f37b171419ed12a3795efe28faf2fd33b3d,1,Alexey Serbin,2017-11-17 17:42:14+00:00,['471feccd073e90ac767ce6d6339b4fda71f72ff0'],70,219,289,1206499,3,0.494736842,1,0.842105263,2130
c4006ae028b44e9b7f8f006d64ed7a3a3f34fe9a,0,Todd Lipcon,2017-11-17 21:26:12+00:00,['64eb9f37b171419ed12a3795efe28faf2fd33b3d'],1,4,5,1206504,1,,,,2130
8e6bfa9fb8aa7292e75a9fd3dcf9c50c8ea5191e,0,Alexey Serbin,2017-11-17 23:43:13+00:00,['c4006ae028b44e9b7f8f006d64ed7a3a3f34fe9a'],20,46,66,1206570,1,0,1,1,2130
a8a7773cf28f0069b691d412f9dd23e72e3833fa,0,Mike Percy,2017-11-20 05:51:18+00:00,['8e6bfa9fb8aa7292e75a9fd3dcf9c50c8ea5191e'],7,48,55,1206625,2,0,1,1,2130
5bb3f430d01babe231b7d84ed42fe49a641af2ae,0,Mike Percy,2017-11-20 06:03:25+00:00,['a8a7773cf28f0069b691d412f9dd23e72e3833fa'],0,34,34,1206659,1,,,,2130
fb637ce9259a4e087ac5f6840ba977806c2bf6b0,1,Todd Lipcon,2017-11-20 18:17:13+00:00,['5bb3f430d01babe231b7d84ed42fe49a641af2ae'],21,149,170,1206829,5,0.508474576,0.881355932,1,2130
338d8a800ceeac6e0bc59b1cf2f976886218f8bd,0,Todd Lipcon,2017-11-20 19:43:47+00:00,['fb637ce9259a4e087ac5f6840ba977806c2bf6b0'],4,10,14,1206843,1,,,,2130
f9d85f53b3aa25d7ec17ca9a247c9c7cc7d1a6d6,0,Andrew Wong,2017-11-20 20:39:34+00:00,['338d8a800ceeac6e0bc59b1cf2f976886218f8bd'],48,69,117,1206960,1,0,0,0,2130
a4642a41e5db7a7a887b39c1cb661a6de1dca47e,0,Alexey Serbin,2017-11-21 01:07:35+00:00,['f9d85f53b3aa25d7ec17ca9a247c9c7cc7d1a6d6'],2,2,4,1206964,1,,,,2130
63b53ad2c9a26a3a9eab348471d4f247eb228315,0,Todd Lipcon,2017-11-21 04:37:34+00:00,['a4642a41e5db7a7a887b39c1cb661a6de1dca47e'],1,3,4,1206968,1,,,,2130
36a5e7669551d0f79c340eadb02ce8d51defb590,0,Todd Lipcon,2017-11-21 18:07:54+00:00,['63b53ad2c9a26a3a9eab348471d4f247eb228315'],0,5,5,1206973,1,0,1,1,2130
3e59fd7b14b4a2ba2846621df04093cce9024688,1,Todd Lipcon,2017-11-21 18:24:28+00:00,['36a5e7669551d0f79c340eadb02ce8d51defb590'],22,65,87,1207060,7,0,1,0,2130
034b2af860eca7a88d52a77f6d9cd4a1f0ec10f7,0,Mike Percy,2017-11-21 19:58:42+00:00,['3e59fd7b14b4a2ba2846621df04093cce9024688'],4,4,8,1207068,2,,,,2130
f0d52ab64404156bab73eca9abcc0e982ee79eee,0,Mike Percy,2017-11-21 20:51:16+00:00,['034b2af860eca7a88d52a77f6d9cd4a1f0ec10f7'],0,5,5,1207073,1,1,1,1,2130
48eab213ca9014f445e41ee7d9d8b5b43aff8f42,0,Dan Burkert,2017-11-21 21:08:18+00:00,['f0d52ab64404156bab73eca9abcc0e982ee79eee'],22,1,23,1207096,2,0,0,0,2130
9f26c9d159e37b27b0c6f60dbcec796b14ded605,0,Dan Burkert,2017-11-21 21:09:59+00:00,['48eab213ca9014f445e41ee7d9d8b5b43aff8f42'],5,98,103,1207199,3,0.863636364,0.863636364,0.772727273,2130
3abca98c58b540f6ba341f5b983ecbd90da43dcf,0,Dan Burkert,2017-11-21 21:12:33+00:00,['9f26c9d159e37b27b0c6f60dbcec796b14ded605'],6,47,53,1207252,4,1,1,0.909090909,2130
f343a67306790bdcbd6688a472199d2bb25afa2c,0,Todd Lipcon,2017-11-21 22:41:13+00:00,['3abca98c58b540f6ba341f5b983ecbd90da43dcf'],31,21,52,1207304,4,0,0,1,2130
9269e0abc39c5143e5c7e5fff5facc2d61192fd2,0,Dan Burkert,2017-11-21 23:05:15+00:00,['f343a67306790bdcbd6688a472199d2bb25afa2c'],0,50,50,1207354,4,0.357142857,0.357142857,1,2130
adfab44c04ea734831f052b8e7cb9e4abb7848d0,1,Andrew Wong,2017-11-22 00:28:31+00:00,['9269e0abc39c5143e5c7e5fff5facc2d61192fd2'],136,734,870,1208224,17,0.249240122,0.656534954,0.963525836,2131
44608be087b122de4d7b4837eb37694a942139bb,0,Andrew Wong,2017-11-22 01:17:05+00:00,['adfab44c04ea734831f052b8e7cb9e4abb7848d0'],15,81,96,1208320,8,0,0.934782609,1,2131
3a2243774e00d834dfa967171a4f527c881a9e96,0,Todd Lipcon,2017-11-22 01:32:21+00:00,['44608be087b122de4d7b4837eb37694a942139bb'],1,1,2,1208322,1,,,,2131
0362ec7681040231394eabf9026f10743d6d28be,0,Todd Lipcon,2017-11-22 02:29:30+00:00,['3a2243774e00d834dfa967171a4f527c881a9e96'],0,5,5,1208327,1,0.75,0.75,1,2131
9ffad1eb08297d70571d9afe31e93697b82d47e2,0,Todd Lipcon,2017-11-22 02:29:39+00:00,['0362ec7681040231394eabf9026f10743d6d28be'],42,154,196,1208523,12,0.344827586,0.655172414,1,2131
fe89fa66fdeb9ac297173669d11125957f293fd1,0,Andrew Wong,2017-11-22 05:02:46+00:00,['9ffad1eb08297d70571d9afe31e93697b82d47e2'],5,11,16,1208539,1,0,0,0,2131
fb0eced0cd291c1dd4811dddab9c8ace9787e958,1,Andrew Wong,2017-11-22 06:38:04+00:00,['fe89fa66fdeb9ac297173669d11125957f293fd1'],165,220,385,1208924,9,0.263157895,1,1,2131
ae0143ca5dca54a527c905043f96ebf2b293629b,1,Andrew Wong,2017-11-22 06:39:16+00:00,['fb0eced0cd291c1dd4811dddab9c8ace9787e958'],8,34,42,1208966,5,0.733333333,0.933333333,1,2131
8a81f4ff18ee30951a25bab247fa5a3c20058e49,0,Andrew Wong,2017-11-22 06:39:38+00:00,['ae0143ca5dca54a527c905043f96ebf2b293629b'],7,124,131,1209097,7,0.295774648,0.971830986,0.943661972,2131
6c02bea97db29ef178b2f907c6d7fb561d9ac82c,0,Alexey Serbin,2017-11-22 19:35:30+00:00,['8a81f4ff18ee30951a25bab247fa5a3c20058e49'],0,7,7,1209104,1,,,,2131
09fb50224bfbecea539ddbdf960f6037255a4333,0,Mike Percy,2017-11-22 21:50:03+00:00,['6c02bea97db29ef178b2f907c6d7fb561d9ac82c'],133,38,171,1209275,1,,,,2131
22987c739ed131861f156c3014eb4e429a53dd2a,0,Andrew Wong,2017-11-23 00:27:52+00:00,['09fb50224bfbecea539ddbdf960f6037255a4333'],5,36,41,1209316,3,0.470588235,0.941176471,0.882352941,2131
1c7424706a22ec93ab98086025e4154b815f32b3,0,Andrew Wong,2017-11-23 00:43:02+00:00,['22987c739ed131861f156c3014eb4e429a53dd2a'],61,392,453,1209769,12,0.57480315,0.960629921,0.992125984,2133
b3904330ac84373ec4564d165a32e64273cee841,0,Andrew Wong,2017-11-23 02:38:58+00:00,['1c7424706a22ec93ab98086025e4154b815f32b3'],2,2,4,1209773,1,,,,2133
5523b0a307133e5e6827f56d9e6045609936a039,0,Andrew Wong,2017-11-23 03:48:21+00:00,['b3904330ac84373ec4564d165a32e64273cee841'],13,24,37,1209810,2,0.416666667,1,1,2133
b436845989d7519fe473ca3579d3385c4a2bdaf3,0,Andrew Wong,2017-11-23 04:41:55+00:00,['5523b0a307133e5e6827f56d9e6045609936a039'],42,152,194,1210004,7,0.073529412,0.691176471,0.691176471,2133
88e39bad14cfab17882d72b69d3382c219b93c23,1,Mike Percy,2017-11-27 06:13:55+00:00,['b436845989d7519fe473ca3579d3385c4a2bdaf3'],42,224,266,1210270,6,0.009615385,0.673076923,1,2133
87dcaf34d3495f87164b80e03b757efc12be2fe0,1,Alexey Serbin,2017-11-27 06:17:45+00:00,['88e39bad14cfab17882d72b69d3382c219b93c23'],124,1015,1139,1211409,6,0.026200873,0.639010189,0.767103348,2133
37b89924ee807f39ae30343b84e837daa7a979b3,1,Alexey Serbin,2017-11-27 06:33:39+00:00,['87dcaf34d3495f87164b80e03b757efc12be2fe0'],49,291,340,1211749,1,0.098765432,0.580246914,1,2133
79a255bbf4bf52f5d62feba213b21c9ad2fd9ffe,1,Mike Percy,2017-11-27 09:08:04+00:00,['37b89924ee807f39ae30343b84e837daa7a979b3'],5,232,237,1211986,8,0.218309859,0.852112676,0.295774648,2133
fc143c01dd9091ef212f9b572752875f11524567,0,Alexey Serbin,2017-11-27 19:41:44+00:00,['79a255bbf4bf52f5d62feba213b21c9ad2fd9ffe'],31,31,62,1212048,7,,,,2133
7ec808f156e726feb0585e2ce9804a5908aab7da,0,Mike Percy,2017-11-27 22:03:18+00:00,['fc143c01dd9091ef212f9b572752875f11524567'],1,385,386,1212434,4,0.489208633,0.928057554,0.791366906,2135
f2d1dad67bfec9ce40cc2811f815e1feca9f96db,0,Mike Percy,2017-11-28 00:01:58+00:00,['7ec808f156e726feb0585e2ce9804a5908aab7da'],2,13,15,1212449,1,,,,2135
0aa4af56c6a7e9d33e7dda3a64412aadf6c4c300,0,Dan Burkert,2017-11-28 00:21:37+00:00,['f2d1dad67bfec9ce40cc2811f815e1feca9f96db'],5,18,23,1212472,2,0.833333333,1,1,2135
34ca99b62af38d1b98d419e4f7b32b8f7e7fc565,0,Mike Percy,2017-11-28 00:41:48+00:00,['0aa4af56c6a7e9d33e7dda3a64412aadf6c4c300'],5,10,15,1212487,2,0,1,1,2135
b29c9373471927d3f2dfbdab03a8bd728c73d82f,0,Andrew Wong,2017-11-28 01:05:57+00:00,['34ca99b62af38d1b98d419e4f7b32b8f7e7fc565'],4,4,8,1212495,1,,,,2135
fa65d647a450c6895bac279dd5e5ad5fb6f8d228,0,Alexey Serbin,2017-11-28 02:00:39+00:00,['b29c9373471927d3f2dfbdab03a8bd728c73d82f'],3,7,10,1212505,2,1,1,1,2135
58b514d88f51cdf8924c8322226b64aa63c1159a,0,Andrew Wong,2017-11-28 17:45:18+00:00,['fa65d647a450c6895bac279dd5e5ad5fb6f8d228'],0,4,4,1212509,1,0,1,1,2135
68fa8010dddad81dd702c6f05fda7d561d9beef9,1,Dan Burkert,2017-11-28 18:35:14+00:00,['58b514d88f51cdf8924c8322226b64aa63c1159a'],56,69,125,1212634,6,,,,2135
32aacb4e7c9a13afa5c80237ac181d940e7fa3d2,0,Mike Percy,2017-11-28 21:10:49+00:00,['68fa8010dddad81dd702c6f05fda7d561d9beef9'],12,14,26,1212660,1,,,,2135
e3cf62fbbcdfdb7c1cea5aa6d662c6055b5764f6,0,Mike Percy,2017-11-29 00:55:34+00:00,['32aacb4e7c9a13afa5c80237ac181d940e7fa3d2'],10,106,116,1212776,1,0,1,1,2135
27da8323d37bcf9f2075763d51e3adfbb75c73f4,0,Mike Percy,2017-11-29 01:15:27+00:00,['e3cf62fbbcdfdb7c1cea5aa6d662c6055b5764f6'],3,122,125,1212901,1,0.138888889,1,1,2135
a18710cba8cd44f6bc759ebf93e6c6bbca25be53,0,Andrew Wong,2017-11-29 04:07:34+00:00,['27da8323d37bcf9f2075763d51e3adfbb75c73f4'],36,142,178,1213079,6,0.125,0.125,1,2135
d74b98fbb96ab7b59ae7777a5cec6faea058099b,0,Mike Percy,2017-11-29 06:22:51+00:00,['a18710cba8cd44f6bc759ebf93e6c6bbca25be53'],4,43,47,1213126,1,,,,2135
3f658629b49d9ccc04fa8bd7a2e4acc0542994d8,0,Mike Percy,2017-11-29 07:19:59+00:00,['d74b98fbb96ab7b59ae7777a5cec6faea058099b'],0,109,109,1213235,2,,,,2136
eb0718e16895b4f851d232f26662b6c16ec51b2f,0,Mike Percy,2017-11-29 07:20:45+00:00,['3f658629b49d9ccc04fa8bd7a2e4acc0542994d8'],89,537,626,1213861,9,0,0.324232082,0.563139932,2136
9120cdd1d288ef6b3e03e2cd8445436712a7d4a9,0,Mike Percy,2017-11-29 07:20:56+00:00,['eb0718e16895b4f851d232f26662b6c16ec51b2f'],29,185,214,1214075,5,0.171428571,0,0.885714286,2136
63083020118b578f5a5da5269701999c0b68651c,0,Mike Percy,2017-11-29 07:49:23+00:00,['9120cdd1d288ef6b3e03e2cd8445436712a7d4a9'],2,6,8,1214083,1,0,0,1,2136
5d8dc02b3786954b256ef0abd78463fc82806bf2,0,Mike Percy,2017-11-29 08:02:49+00:00,['63083020118b578f5a5da5269701999c0b68651c'],1,7,8,1214091,1,,,,2136
5c87c22be1559e2670624ea8cdf7e2f0d065855e,0,Mike Percy,2017-11-29 08:23:07+00:00,['5d8dc02b3786954b256ef0abd78463fc82806bf2'],59,67,126,1214217,3,,,,2136
aafed6d1d749978899a78dae84dd25c028a1763a,0,Alexey Serbin,2017-11-29 10:28:17+00:00,['5c87c22be1559e2670624ea8cdf7e2f0d065855e'],15,202,217,1214434,9,0.007462687,0.611940299,0.962686567,2136
336235cea777021f887ba9917431ca8567f33d78,0,Mike Percy,2017-11-29 23:11:20+00:00,['aafed6d1d749978899a78dae84dd25c028a1763a'],1,1,2,1214436,1,,,,2136
8929f1240cb7dbdbb69455dd91fd74cbb7c2f4af,0,Mike Percy,2017-11-30 00:22:08+00:00,['336235cea777021f887ba9917431ca8567f33d78'],1,17,18,1214454,1,,,,2136
12d7732596efb4194c8e39353c30f45c30138bb8,0,Mike Percy,2017-11-30 04:07:51+00:00,['8929f1240cb7dbdbb69455dd91fd74cbb7c2f4af'],0,1,1,1214455,1,,,,2136
0086760615d8eddf5cd8a9bcbe194e7e9f8f6e15,0,Jean-Daniel Cryans,2017-11-30 04:14:12+00:00,['12d7732596efb4194c8e39353c30f45c30138bb8'],12,12,24,1214479,12,,,,2136
9e506fcafa089859e340a970677267879678373d,0,Dan Burkert,2017-11-30 17:48:07+00:00,['0086760615d8eddf5cd8a9bcbe194e7e9f8f6e15'],5,7,12,1214491,3,0,1,1,2136
ded4305f202209128ffb1681bc3255eb3745f2cf,0,Mike Percy,2017-12-01 05:35:58+00:00,['9e506fcafa089859e340a970677267879678373d'],2,4,6,1214497,1,1,1,1,2136
fd8a3d57d72a8888b92cf8a55fd7df3fdc40bb29,0,Mike Percy,2017-12-01 09:02:33+00:00,['ded4305f202209128ffb1681bc3255eb3745f2cf'],0,4,4,1214501,1,,,,2136
4c22e9121b1ca148e334a7481093304139d0dfdf,0,Mike Percy,2017-12-01 09:04:29+00:00,['fd8a3d57d72a8888b92cf8a55fd7df3fdc40bb29'],0,7,7,1214508,1,,,,2136
b9cce6e0136b5d1f79e96ab34546751a4efc8f66,0,Mike Percy,2017-12-01 09:05:41+00:00,['4c22e9121b1ca148e334a7481093304139d0dfdf'],64,242,306,1214814,18,0,0,0.462686567,2136
946004aeed4ce2844c2cd14bbf2077b419de3c49,0,Dan Burkert,2017-12-01 18:21:25+00:00,['b9cce6e0136b5d1f79e96ab34546751a4efc8f66'],4,4,8,1214822,1,,,,2136
8409e9d22dd81fd4b41dda2eb803c1b5b42e96f8,0,Mike Percy,2017-12-01 19:58:11+00:00,['946004aeed4ce2844c2cd14bbf2077b419de3c49'],0,18,18,1214840,1,,,,2136
059ee895fe75376a046c17a10771eb5b97bf7805,0,Mike Percy,2017-12-01 19:59:02+00:00,['8409e9d22dd81fd4b41dda2eb803c1b5b42e96f8'],8,8,16,1214856,3,,,,2136
3f4253753288b2a6edab482f7d2519bcbb206a50,0,Mike Percy,2017-12-01 21:26:41+00:00,['059ee895fe75376a046c17a10771eb5b97bf7805'],0,9,9,1214865,1,,,,2136
dc497fec2cb1cabec17eb250ca7d8a7e3d6a9e8f,0,Alexey Serbin,2017-12-01 22:47:21+00:00,['3f4253753288b2a6edab482f7d2519bcbb206a50'],35,84,119,1214984,2,0,0,1,2136
1c9e424c251d6b47fa8a161a94358634fbd13549,0,Alexey Serbin,2017-12-01 23:15:12+00:00,['dc497fec2cb1cabec17eb250ca7d8a7e3d6a9e8f'],22,206,228,1215212,10,0.277777778,0.277777778,1,2137
d9754746b64098fdd4fe0e35d9344ba62d8c7a25,0,Alexey Serbin,2017-12-01 23:28:22+00:00,['1c9e424c251d6b47fa8a161a94358634fbd13549'],149,428,577,1215789,19,0.203125,0.1640625,0.875,2139
072685c207f878f9b824201d397e1a8a2eee6a11,0,Mike Percy,2017-12-02 00:59:38+00:00,['d9754746b64098fdd4fe0e35d9344ba62d8c7a25'],1,1,2,1215791,1,,,,2139
d1d35601aa2b281880f6612ddef499686cf8233c,0,Mike Percy,2017-12-02 01:45:29+00:00,['072685c207f878f9b824201d397e1a8a2eee6a11'],20,24,44,1215835,1,0,0,0,2139
4d44c9fe756d92997f71e5d8f2a25443afef0045,0,Mike Percy,2017-12-02 01:45:37+00:00,['d1d35601aa2b281880f6612ddef499686cf8233c'],48,80,128,1215963,4,0.590909091,0.590909091,0.590909091,2139
98f669d5d125ac34da2df794ddb7725c4ffab78b,0,Mike Percy,2017-12-02 01:45:45+00:00,['4d44c9fe756d92997f71e5d8f2a25443afef0045'],1,11,12,1215975,1,0,0,0,2139
c32f736cd85dd8fa6645dd5161a4837bf5ccbb96,0,Mike Percy,2017-12-02 02:33:44+00:00,['98f669d5d125ac34da2df794ddb7725c4ffab78b'],14,12,26,1216001,1,0,0,1,2139
24f8de6596c513acece01eb15b4e6a51da9c6b44,0,Mike Percy,2017-12-02 02:44:14+00:00,['c32f736cd85dd8fa6645dd5161a4837bf5ccbb96'],1,28,29,1216030,2,0,1,1,2139
6be33bf3f841857566349c5859b09d4f81d843f2,0,Mike Percy,2017-12-02 02:56:17+00:00,['24f8de6596c513acece01eb15b4e6a51da9c6b44'],0,163,163,1216193,1,,,,2139
a193905b24b314fb69712a6b7a9d402778a64756,0,Mike Percy,2017-12-02 02:56:32+00:00,['6be33bf3f841857566349c5859b09d4f81d843f2'],28,33,61,1216254,1,,,,2139
2c77f95b564e087d1f83bfdcf9d7e3d016d73b33,0,Mike Percy,2017-12-02 06:25:50+00:00,['a193905b24b314fb69712a6b7a9d402778a64756'],1,1,2,1216256,1,,,,2139
d42c2916467b83347f064ddea59f7a65202f7247,0,Dan Burkert,2017-12-04 23:17:10+00:00,['2c77f95b564e087d1f83bfdcf9d7e3d016d73b33'],23,30,53,1216309,4,0,,0,2139
84d019e611abc643e9138d6d0f9726a131643367,0,Dan Burkert,2017-12-04 23:56:00+00:00,['d42c2916467b83347f064ddea59f7a65202f7247'],0,8,8,1216317,1,,,,2139
9baebd6dab18c378551fcdd9048cb519db21e644,1,Andrew Wong,2017-12-06 06:28:50+00:00,['84d019e611abc643e9138d6d0f9726a131643367'],6,15,21,1216338,2,0,1,1,2139
fbed0d683f634dd92e1a02874e705ecce66bfbc2,1,Dan Burkert,2017-12-07 20:55:30+00:00,['9baebd6dab18c378551fcdd9048cb519db21e644'],96,331,427,1216765,18,0.237288136,0.754237288,0.93220339,2141
6549a417b69747d1ef8472568e32026e0d96e464,0,Dan Burkert,2017-12-08 00:39:00+00:00,['fbed0d683f634dd92e1a02874e705ecce66bfbc2'],0,1,1,1216766,1,,,,2141
add943f025347823f7f7f34de292efc2664961bb,0,Mike Percy,2017-12-08 03:48:30+00:00,['6549a417b69747d1ef8472568e32026e0d96e464'],29,113,142,1216908,1,,,,2141
157228a4db9f81f434b09f73addf183ee6a8bdbe,0,Dan Burkert,2017-12-08 23:59:41+00:00,['add943f025347823f7f7f34de292efc2664961bb'],10,5,15,1216923,1,1,1,0.8,2141
b02bf2d955247681b2cb6dd9f7e76579d8ee3c4b,0,Dan Burkert,2017-12-11 20:04:28+00:00,['157228a4db9f81f434b09f73addf183ee6a8bdbe'],12,16,28,1216951,1,,,,2141
ff535b521ec2cc80f4b430bf1feee842a3691f37,0,Andrew Wong,2017-12-12 00:34:24+00:00,['b02bf2d955247681b2cb6dd9f7e76579d8ee3c4b'],19,35,54,1217005,1,,,,2141
2a6de8ea46ae699bffb0435119fc62a15200eab7,1,Alexey Serbin,2017-12-12 19:20:25+00:00,['ff535b521ec2cc80f4b430bf1feee842a3691f37'],96,847,943,1217948,5,0.040590406,0.487084871,0.935424354,2141
22d5fbdb2bfc393ab78f624e624dae2ee54c2017,0,Grant Henke,2017-12-12 19:29:45+00:00,['2a6de8ea46ae699bffb0435119fc62a15200eab7'],0,423,423,1218371,21,0.838709677,0.946236559,0.97311828,2145
83b19ef320dba9a85a86845dc515587ce28c9ac3,0,Mike Percy,2017-12-12 21:14:25+00:00,['22d5fbdb2bfc393ab78f624e624dae2ee54c2017'],196,198,394,1218765,4,,,,2145
887443e0d44d462f7a57507917a4a77b3495c4c7,0,Alexey Serbin,2017-12-12 23:11:23+00:00,['83b19ef320dba9a85a86845dc515587ce28c9ac3'],10,10,20,1218785,1,,,,2145
7c8fc625e72ec2bf6ef614df2ec25346e1a0f7b7,0,Mike Percy,2017-12-14 18:24:20+00:00,['887443e0d44d462f7a57507917a4a77b3495c4c7'],0,159,159,1218944,1,0,0,1,2145
bb2620299c45b3db90590236298a497a619c0bda,0,Mike Percy,2017-12-14 18:26:34+00:00,['7c8fc625e72ec2bf6ef614df2ec25346e1a0f7b7'],50,56,106,1219050,3,1,1,1,2145
dbc84a2d7469e2de97fe9e35f5b5443e94f2a790,0,Alexey Serbin,2017-12-14 19:01:37+00:00,['bb2620299c45b3db90590236298a497a619c0bda'],6,5,11,1219061,1,,,,2145
14bf71e73a3523f907162265b8bfa9c55c7bcc7c,0,Mike Percy,2017-12-14 19:09:33+00:00,['dbc84a2d7469e2de97fe9e35f5b5443e94f2a790'],0,93,93,1219154,1,0,1,1,2145
b357fa9b729ce52627a862e08ebac822ae470bc9,1,Dan Burkert,2017-12-18 20:58:56+00:00,['14bf71e73a3523f907162265b8bfa9c55c7bcc7c'],334,580,914,1220068,25,0.504761905,1,0.780952381,2147
538736c6a7aeac1914b86b142d5c94d0af98484c,1,David Ribeiro Alves,2017-12-19 21:35:20+00:00,['b357fa9b729ce52627a862e08ebac822ae470bc9'],1,19,20,1220088,2,,,,2148
f2184c1d3a80d3ec13774868c14e251a5e1c1489,0,Todd Lipcon,2017-12-21 04:31:18+00:00,['538736c6a7aeac1914b86b142d5c94d0af98484c'],1,1,2,1220090,1,,,,2148
948ac0eb45b83cbba476cf722dd5c043ddac5de3,0,Todd Lipcon,2017-12-21 04:48:14+00:00,['f2184c1d3a80d3ec13774868c14e251a5e1c1489'],28,75,103,1220193,6,0,0.931034483,0.965517241,2148
36ecb300901daf4006fae0c9be5657f2f6127233,0,Dan Burkert,2017-12-21 05:57:41+00:00,['948ac0eb45b83cbba476cf722dd5c043ddac5de3'],23,106,129,1220322,2,0.089285714,0.303571429,1,2148
d78b2727d1246069b2006ee652c3ff9a2005601c,1,Andrew Wong,2017-12-21 17:24:22+00:00,['36ecb300901daf4006fae0c9be5657f2f6127233'],4,6,10,1220332,1,1,1,1,2148
5356334ef3b4949c9dba7bc6a9f7f9d5262c4281,1,Dan Burkert,2017-12-22 19:41:34+00:00,['d78b2727d1246069b2006ee652c3ff9a2005601c'],248,505,753,1221085,17,0.054945055,0.802197802,1,2149
a89c8f39544337c6ff36cdd28edec4fadac8427c,0,Alexey Serbin,2017-12-23 02:00:02+00:00,['5356334ef3b4949c9dba7bc6a9f7f9d5262c4281'],5,3,8,1221093,1,0,0,0,2149
63025ef6ddf580504e88d45bd588f2934a18bd4c,0,Mike Percy,2017-12-23 18:30:20+00:00,['a89c8f39544337c6ff36cdd28edec4fadac8427c'],20,67,87,1221180,2,0,0.730769231,1,2149
ae62b86977eaff2556b1e94df986d3f3e4f50ca2,0,Mike Percy,2017-12-24 17:57:42+00:00,['63025ef6ddf580504e88d45bd588f2934a18bd4c'],55,192,247,1221427,4,0,0,0.961538462,2149
07e4cbd4d1edb0d1ce9bd0e9c2dac7b8ce321539,0,Alexey Serbin,2017-12-28 00:03:21+00:00,['ae62b86977eaff2556b1e94df986d3f3e4f50ca2'],12,1,13,1221440,1,0,0,0,2149
2b413ee6cf20570f2ffdcf507bb6b0e8304176d9,0,Dan Burkert,2018-01-03 00:12:49+00:00,['07e4cbd4d1edb0d1ce9bd0e9c2dac7b8ce321539'],1,6,7,1221447,1,1,1,1,2149
b87a7bbedf6f1bf8a951922fc2a4456cd02315bd,0,Mike Percy,2018-01-03 07:49:44+00:00,['2b413ee6cf20570f2ffdcf507bb6b0e8304176d9'],170,323,493,1221940,4,0.148648649,0.810810811,1,2149
3c0f80b9e8a829bb233a0804fe355c5d4f5e81f7,0,Adar Dembo,2018-01-03 20:49:37+00:00,['b87a7bbedf6f1bf8a951922fc2a4456cd02315bd'],1,1,2,1221942,1,,,,2149
cc236542e1df53b31659d1e8f98cde8b2428c63c,0,Jean-Daniel Cryans,2018-01-04 16:57:51+00:00,['3c0f80b9e8a829bb233a0804fe355c5d4f5e81f7'],6,7,13,1221955,1,,,,2149
9bdeddf3373369e1406972861682f2a61889040d,0,Alexey Serbin,2018-01-04 20:33:20+00:00,['cc236542e1df53b31659d1e8f98cde8b2428c63c'],1,1,2,1221957,1,,,,2149
bddbb34e2e28fd4affae3d4d37d6509922ffb4fb,0,Alexey Serbin,2018-01-05 21:34:23+00:00,['9bdeddf3373369e1406972861682f2a61889040d'],0,1,1,1221958,1,,,,2149
4f630d91318b02fd8820ca7ffafb8b6bc426dfe3,0,Adar Dembo,2018-01-06 01:16:26+00:00,['bddbb34e2e28fd4affae3d4d37d6509922ffb4fb'],1,1,2,1221960,1,,,,2149
36995e26022d9e54692e04e3428c5993b523a733,0,Dan Burkert,2018-01-06 01:26:53+00:00,['4f630d91318b02fd8820ca7ffafb8b6bc426dfe3'],23,587,610,1222570,8,0.203753351,0.495978552,0.699731903,2149
391e3255d6f0ae59f375e5532cea985384f636f8,1,Alexey Serbin,2018-01-06 03:22:24+00:00,['36995e26022d9e54692e04e3428c5993b523a733'],49,120,169,1222739,3,0,0.918367347,1,2149
7f4157c416c1f17e6326753f2138bd17fa79ad66,0,David Ribeiro Alves,2018-01-08 18:57:11+00:00,['391e3255d6f0ae59f375e5532cea985384f636f8'],21,45,66,1222805,1,1,1,1,2149
710b238e775ae5d4b59cd0664e05972fcc0a7b2d,0,Mike Percy,2018-01-08 19:38:08+00:00,['7f4157c416c1f17e6326753f2138bd17fa79ad66'],0,108,108,1222913,1,0,0,1,2149
1277f69a1feb3715750552991bc19444282f652e,1,Mike Percy,2018-01-08 19:38:17+00:00,['710b238e775ae5d4b59cd0664e05972fcc0a7b2d'],86,231,317,1223230,8,0.048192771,0.927710843,0.951807229,2149
72c83c571120b0949c0e576fb8af0089861436e1,0,Hao Hao,2018-01-08 20:01:19+00:00,['1277f69a1feb3715750552991bc19444282f652e'],12,48,60,1223290,5,0.333333333,0.5,1,2149
1ac10d5364db507e5052f5dc13c19d32f62dc4f6,0,Alexey Serbin,2018-01-09 01:13:07+00:00,['72c83c571120b0949c0e576fb8af0089861436e1'],1,1,2,1223292,1,,,,2149
6efc50d58100d25cd2df461722c362506328e8c1,0,Mike Percy,2018-01-09 01:21:49+00:00,['1ac10d5364db507e5052f5dc13c19d32f62dc4f6'],373,504,877,1224169,7,0.204819277,0,0.43373494,2149
1769eed53ee2c21a88a766cb72bf8c9ae622099d,0,Mike Percy,2018-01-09 01:35:19+00:00,['6efc50d58100d25cd2df461722c362506328e8c1'],15,182,197,1224366,6,0,0.463768116,0.637681159,2150
e37bd1cf5d2ca26facf5cfba1850af2e648bbfb4,0,Mike Percy,2018-01-09 01:38:55+00:00,['1769eed53ee2c21a88a766cb72bf8c9ae622099d'],48,61,109,1224475,4,0,1,0,2150
ff63b434c25574595105fb480bcd01c9334008c7,0,Mike Percy,2018-01-09 03:18:06+00:00,['e37bd1cf5d2ca26facf5cfba1850af2e648bbfb4'],83,35,118,1224593,2,0,0,0.611111111,2150
f932547b294605153bbb680a64fb461403033fde,0,Mike Percy,2018-01-09 03:18:32+00:00,['ff63b434c25574595105fb480bcd01c9334008c7'],6,6,12,1224605,3,,,,2150
8b873a1257d11510cdbf80fe4c39ae26398e364a,0,Todd Lipcon,2018-01-09 20:30:55+00:00,['f932547b294605153bbb680a64fb461403033fde'],2,21,23,1224628,3,0.05,0.4,0.95,2150
ad3b6a63a41c5b3d2f9907654f505bf76dba14ab,0,Todd Lipcon,2018-01-09 20:31:02+00:00,['8b873a1257d11510cdbf80fe4c39ae26398e364a'],1,50,51,1224679,3,0,0,1,2150
746d0a5cd53c8252af0c0b6ad294cdb6b39a0319,1,Alexey Serbin,2018-01-09 21:17:26+00:00,['ad3b6a63a41c5b3d2f9907654f505bf76dba14ab'],23,101,124,1224803,3,0,1,1,2150
8bcc80eec075321fa4444ef26b2a0ccac12ac9d7,0,Alexey Serbin,2018-01-09 23:19:05+00:00,['746d0a5cd53c8252af0c0b6ad294cdb6b39a0319'],0,6,6,1224809,1,0,1,1,2150
80eca49d5e03c4515ff58ea0e92376193482739f,0,Todd Lipcon,2018-01-10 01:56:27+00:00,['8bcc80eec075321fa4444ef26b2a0ccac12ac9d7'],12,8,20,1224829,1,0,0,0,2150
f2adee0046c553ca2a697b661da11846d34559fd,0,Todd Lipcon,2018-01-10 01:58:43+00:00,['80eca49d5e03c4515ff58ea0e92376193482739f'],77,170,247,1225076,9,0.442622951,0.950819672,0.967213115,2150
1cf30effc13827ec4f2e739e7ca3afdbc0051437,1,Will Berkeley,2018-01-11 02:22:40+00:00,['f2adee0046c553ca2a697b661da11846d34559fd'],6,56,62,1225138,4,0.21875,0.8125,1,2150
236fc67e1c8168b72e19db29af45bdb7ef115e6c,0,Andrew Wong,2018-01-11 18:52:02+00:00,['1cf30effc13827ec4f2e739e7ca3afdbc0051437'],4,8,12,1225150,1,0,0,1,2150
56107ac806a171db33f09c6bdce7909bb8c9bd4b,0,Dan Burkert,2018-01-11 20:59:43+00:00,['236fc67e1c8168b72e19db29af45bdb7ef115e6c'],6,24,30,1225180,3,1,1,1,2150
35fc7b7e558fabaac0a126b45cd513a52d60d15b,0,Todd Lipcon,2018-01-12 05:20:08+00:00,['56107ac806a171db33f09c6bdce7909bb8c9bd4b'],0,11,11,1225191,3,1,1,0.75,2150
26fd153b055b10bee90275d4f4c9e5f7088d4e83,0,Todd Lipcon,2018-01-12 05:28:47+00:00,['35fc7b7e558fabaac0a126b45cd513a52d60d15b'],4,0,4,1225195,1,1,1,0,2150
8058825ba8cd02897e0a1b592d74bdfe6e2a3f62,0,Dan Burkert,2018-01-13 01:00:01+00:00,['26fd153b055b10bee90275d4f4c9e5f7088d4e83'],35,72,107,1225302,8,0,0.789473684,0.789473684,2150
dc0621d7673723cd417aa9ffb7e59b2c279971b9,0,Mike Percy,2018-01-13 03:18:56+00:00,['8058825ba8cd02897e0a1b592d74bdfe6e2a3f62'],25,91,116,1225418,2,0,0,1,2150
b0d27d3f5e3a26cdf2d987d3f82270de4ed4376f,0,Dan Burkert,2018-01-17 00:44:34+00:00,['dc0621d7673723cd417aa9ffb7e59b2c279971b9'],0,245,245,1225663,2,0.490740741,0.490740741,1,2151
5806b807a712116e79e8a67dc4dcc55d51ea6b2a,0,Andrew Wong,2018-01-17 01:06:54+00:00,['b0d27d3f5e3a26cdf2d987d3f82270de4ed4376f'],42,42,84,1225747,10,,,,2151
c40e0587bf6a6aa55e5bd72dd2dd9356b1507f2e,0,Alexey Serbin,2018-01-17 03:18:11+00:00,['5806b807a712116e79e8a67dc4dcc55d51ea6b2a'],9,41,50,1225797,3,0,0,1,2151
e453f7e5a20fc9bd9a9c906cca341fac4b16393c,1,Todd Lipcon,2018-01-17 07:30:36+00:00,['c40e0587bf6a6aa55e5bd72dd2dd9356b1507f2e'],22,77,99,1225896,6,0.078947368,0.947368421,1,2151
bec5a200c0b7e5349a488a71985547820feebbdc,0,Todd Lipcon,2018-01-17 23:26:13+00:00,['e453f7e5a20fc9bd9a9c906cca341fac4b16393c'],15,114,129,1226025,5,0.043478261,0.47826087,0.086956522,2151
b88117415a02699c12a6eacbf065c4140ee0963c,0,Dan Burkert,2018-01-17 23:30:27+00:00,['bec5a200c0b7e5349a488a71985547820feebbdc'],12,36,48,1226073,1,0,0,1,2151
6ace408eeb6331f7cdbe674067dc7e5834f2314a,0,Adar Dembo,2018-01-18 01:09:10+00:00,['b88117415a02699c12a6eacbf065c4140ee0963c'],17,90,107,1226180,7,0.14,0.28,1,2151
df65df65d4f3030d93720e11531d224ff0bcff94,0,Todd Lipcon,2018-01-18 01:26:15+00:00,['6ace408eeb6331f7cdbe674067dc7e5834f2314a'],7,7,14,1226194,4,,,,2151
d3165ed2b511d40a34c9f27a41bfe041b9c45bdc,0,Dan Burkert,2018-01-18 02:50:15+00:00,['df65df65d4f3030d93720e11531d224ff0bcff94'],17,6,23,1226217,1,0.375,0.25,0.25,2151
1f346a1bec3db99877a4ace0d3682e5341bec9c6,1,Alexey Serbin,2018-01-18 05:31:15+00:00,['d3165ed2b511d40a34c9f27a41bfe041b9c45bdc'],2,143,145,1226362,7,0.169811321,0.905660377,0.905660377,2151
64926335fe263b43f1493c03a91ea999759dfc71,1,Todd Lipcon,2018-01-18 20:08:08+00:00,['1f346a1bec3db99877a4ace0d3682e5341bec9c6'],87,347,434,1226796,11,0.005494505,0.824175824,1,2151
8bfc2a1e6764aea8d6439413103af732f67a1cfb,0,Dan Burkert,2018-01-18 20:45:59+00:00,['64926335fe263b43f1493c03a91ea999759dfc71'],2,2,4,1226800,1,,,,2151
04af620c34a67347d7ded73c9a11259d632e5a69,0,Dan Burkert,2018-01-18 20:47:32+00:00,['8bfc2a1e6764aea8d6439413103af732f67a1cfb'],58,174,232,1227032,34,0.5,0,1,2152
918db2d667b8722d906801dcf4980bcd939f0eba,0,Dan Burkert,2018-01-18 21:41:35+00:00,['04af620c34a67347d7ded73c9a11259d632e5a69'],2,1,3,1227035,1,,,,2152
ee58617c0cfd56340bbd6e4751ae82b9e441ca30,0,Jean-Daniel Cryans,2018-01-18 23:33:20+00:00,['918db2d667b8722d906801dcf4980bcd939f0eba'],0,36,36,1227071,1,,,,2152
81be8c45bc8d77ae69a822f361fa08124f777a65,0,Jean-Daniel Cryans,2018-01-18 23:34:20+00:00,['ee58617c0cfd56340bbd6e4751ae82b9e441ca30'],0,13,13,1227084,1,,,,2152
31a720fc3a84d09204e46a5dae42e968a4730f7c,0,Jean-Daniel Cryans,2018-01-18 23:34:54+00:00,['81be8c45bc8d77ae69a822f361fa08124f777a65'],5,0,5,1227089,1,,,,2152
b6889d7aced7e4b6ad40b63fbe2da117294f3803,1,Todd Lipcon,2018-01-19 00:24:43+00:00,['31a720fc3a84d09204e46a5dae42e968a4730f7c'],10,71,81,1227170,4,0,0.860465116,0.953488372,2152
f8d18693546cd518c8873b7a5f4c08579f85199a,0,Todd Lipcon,2018-01-19 00:33:37+00:00,['b6889d7aced7e4b6ad40b63fbe2da117294f3803'],8,18,26,1227196,3,0,0,1,2152
57b148a019b09006a840e3cd6f3d0c2ac7fb5e7e,0,David Ribeiro Alves,2018-01-19 21:13:45+00:00,['f8d18693546cd518c8873b7a5f4c08579f85199a'],0,9,9,1227205,1,1,1,1,2152
6626e109d4c2d729c1efef22ae90d800a2a23bd2,0,Andrew Wong,2018-01-20 01:15:48+00:00,['57b148a019b09006a840e3cd6f3d0c2ac7fb5e7e'],15,25,40,1227245,2,,,,2152
b81d5569a0fa9ee4d787b93703f210c2e2f8d93d,1,Adar Dembo,2018-01-21 20:05:22+00:00,['6626e109d4c2d729c1efef22ae90d800a2a23bd2'],70,137,207,1227452,10,0.789473684,0.894736842,0.631578947,2152
4151708087cbd385765cd160afb693c78a688ca5,1,Adar Dembo,2018-01-22 05:38:37+00:00,['b81d5569a0fa9ee4d787b93703f210c2e2f8d93d'],90,439,529,1227981,7,0.043290043,0.887445887,0.995670996,2152
80e58a7eea810978d5bb0b150e7a04e0b50e477d,0,Todd Lipcon,2018-01-22 23:23:55+00:00,['4151708087cbd385765cd160afb693c78a688ca5'],2,0,2,1227983,1,1,1,0,2152
7465c91b84656281535fa825a9befb6bee172a9d,0,Todd Lipcon,2018-01-22 23:24:46+00:00,['80e58a7eea810978d5bb0b150e7a04e0b50e477d'],0,69,69,1228052,4,0.125,0.925,0.9,2152
3b51bf33771cc548376f18823dd1855e4d899d19,0,Dan Burkert,2018-01-24 18:14:03+00:00,['7465c91b84656281535fa825a9befb6bee172a9d'],5,1,6,1228058,1,,,,2152
9961902d8b4f18a5e5d68aeb624e27167651b837,0,Todd Lipcon,2018-01-24 19:07:17+00:00,['3b51bf33771cc548376f18823dd1855e4d899d19'],0,6,6,1228064,1,0,1,1,2152
e0a743d24c8f46bbf0b921fc262dacc976d6cbb9,1,Todd Lipcon,2018-01-24 19:07:22+00:00,['9961902d8b4f18a5e5d68aeb624e27167651b837'],165,1704,1869,1229933,13,,,,2153
c497c69bb2128a8a62738b9b6bb97a5b83da0323,1,Alexey Serbin,2018-01-24 19:24:32+00:00,['e0a743d24c8f46bbf0b921fc262dacc976d6cbb9'],18,177,195,1230128,7,0.370967742,0.903225806,1,2154
656ed6a844174d4faacd64702f16c6d9948f3eee,0,Todd Lipcon,2018-01-24 19:35:40+00:00,['c497c69bb2128a8a62738b9b6bb97a5b83da0323'],1,9,10,1230138,2,,,,2154
60276c54a221d554287c6645df7df542fe6d6443,0,Todd Lipcon,2018-01-24 20:48:58+00:00,['656ed6a844174d4faacd64702f16c6d9948f3eee'],10,13,23,1230161,2,0,0,1,2154
f755f8aa56f4154088bc1644a409df1f3299689d,0,Todd Lipcon,2018-01-24 22:06:42+00:00,['60276c54a221d554287c6645df7df542fe6d6443'],32,73,105,1230266,4,0.818181818,0.818181818,1,2154
a0d348adcbfca5bae3191f40f31dc918808b01ad,0,Todd Lipcon,2018-01-25 00:08:02+00:00,['f755f8aa56f4154088bc1644a409df1f3299689d'],6,2,8,1230274,1,,,,2154
f62e4cd0e19cdb3f9dc66d0809cc178e9569b3fa,0,Hao Hao,2018-01-25 00:17:42+00:00,['a0d348adcbfca5bae3191f40f31dc918808b01ad'],2,38,40,1230314,2,0.8,0.8,1,2154
0f0e42144a0d37f57394b373eb75eeb18bc28174,0,Hao Hao,2018-01-25 03:05:16+00:00,['f62e4cd0e19cdb3f9dc66d0809cc178e9569b3fa'],6,59,65,1230379,3,0.472222222,1,0.833333333,2154
cd7166cb778aed0a26f8e76d4023ff4054c58d76,0,Dan Burkert,2018-01-25 19:05:54+00:00,['0f0e42144a0d37f57394b373eb75eeb18bc28174'],149,253,402,1230781,2,,,,2154
9941b56bfc0610302a10cc887efe7ada5e6e14c6,1,Dan Burkert,2018-01-29 18:23:01+00:00,['cd7166cb778aed0a26f8e76d4023ff4054c58d76'],77,76,153,1230934,10,,,,2154
471e0a137cfe33736d8c2b5a23ad6102bcb22e79,0,Todd Lipcon,2018-01-29 19:36:26+00:00,['9941b56bfc0610302a10cc887efe7ada5e6e14c6'],1,1,2,1230936,1,,,,2154
54081ce18ffff42a2a04f55d892aba3523ba9df9,0,Alexey Serbin,2018-01-29 20:13:57+00:00,['471e0a137cfe33736d8c2b5a23ad6102bcb22e79'],63,197,260,1231196,7,0.712328767,0.890410959,0.890410959,2154
eef0e39424febe665432ac3e90db00a8da6b71b3,0,Mike Percy,2018-01-31 03:12:22+00:00,['54081ce18ffff42a2a04f55d892aba3523ba9df9'],12,29,41,1231237,1,0,0.25,1,2154
42711bac4017b3ad11ce4d20ff9e61b6eb0d69f9,0,Andrew Wong,2018-01-31 20:58:52+00:00,['eef0e39424febe665432ac3e90db00a8da6b71b3'],26,32,58,1231295,5,1,1,0,2154
dd57be8c1235d5df19ef3d3349b789156b662202,0,Andrew Wong,2018-01-31 20:59:04+00:00,['42711bac4017b3ad11ce4d20ff9e61b6eb0d69f9'],7,95,102,1231397,3,0.017241379,0.913793103,1,2154
b315d0ed078f4ca8d26ece082c0bf90f23fe63c1,0,Todd Lipcon,2018-01-31 21:02:51+00:00,['dd57be8c1235d5df19ef3d3349b789156b662202'],23,191,214,1231611,6,0.358024691,1,0.987654321,2154
078346787f0a7b90c0b9b85664b609b4aa96eab7,0,David Ribeiro Alves,2018-02-02 07:24:52+00:00,['b315d0ed078f4ca8d26ece082c0bf90f23fe63c1'],5,5,10,1231621,1,,,,2154
7b6cc8459d7f497b947ca091920f76324dc9505b,0,Grant Henke,2018-02-02 22:04:21+00:00,['078346787f0a7b90c0b9b85664b609b4aa96eab7'],171,1356,1527,1233148,32,0.062251656,0.594701987,0.936423841,2158
6d8694cac2a601e97693afc81eb01bf189b7886f,0,Andrew Wong,2018-02-02 22:35:06+00:00,['7b6cc8459d7f497b947ca091920f76324dc9505b'],3,4,7,1233155,1,,,,2158
3e49fe2f7ca9afa603da600872cf3649346a0c22,0,Todd Lipcon,2018-02-03 00:57:34+00:00,['6d8694cac2a601e97693afc81eb01bf189b7886f'],37,81,118,1233273,3,1,1,0.972972973,2158
afae5c75112c9938ed9f2b335a75a92ea63f5587,0,Todd Lipcon,2018-02-03 01:08:32+00:00,['3e49fe2f7ca9afa603da600872cf3649346a0c22'],22,38,60,1233333,2,0,1,1,2158
2bff29b5949825515dfa827a98973a9dbdc32b86,0,Todd Lipcon,2018-02-03 01:08:49+00:00,['afae5c75112c9938ed9f2b335a75a92ea63f5587'],21,77,98,1233431,2,0.361111111,1,1,2158
f27f5adaedabf5aac53583a2cd425c6a38484b78,0,Todd Lipcon,2018-02-03 01:53:02+00:00,['2bff29b5949825515dfa827a98973a9dbdc32b86'],11,36,47,1233478,3,1,1,0,2158
bf6c2c07b1edfc8d38d64ffb242b3f303d54144b,0,Todd Lipcon,2018-02-05 04:21:34+00:00,['f27f5adaedabf5aac53583a2cd425c6a38484b78'],10,48,58,1233536,3,0.071428571,1,1,2158
2c89bd71cfaa4005095cfb44d46a222c48614a34,0,Grant Henke,2018-02-05 18:14:50+00:00,['bf6c2c07b1edfc8d38d64ffb242b3f303d54144b'],8,66,74,1233610,6,0.913043478,0.913043478,1,2158
c19a42170576699d6f346faa716ae6f2fa665a97,0,Dan Burkert,2018-02-05 18:27:33+00:00,['2c89bd71cfaa4005095cfb44d46a222c48614a34'],19,65,84,1233694,1,,,,2158
839e3b3a67619bc327801e128293347fb59e1091,0,Mike Percy,2018-02-05 19:49:32+00:00,['c19a42170576699d6f346faa716ae6f2fa665a97'],54,34,88,1233782,4,0.4,0.2,1,2158
471cd13113241ee6880dde38ea4baa0ccd4b655a,0,Grant Henke,2018-02-05 20:33:51+00:00,['839e3b3a67619bc327801e128293347fb59e1091'],16,128,144,1233926,10,0.387096774,0.666666667,0.903225806,2158
adb90a02d8ffc7174414608fc71639e8748ca86f,0,Todd Lipcon,2018-02-06 01:40:36+00:00,['471cd13113241ee6880dde38ea4baa0ccd4b655a'],6,11,17,1233943,3,0.75,1,1,2158
ab5387403e42df3161492d6f48b9b51bc85c7499,0,Todd Lipcon,2018-02-06 07:58:18+00:00,['adb90a02d8ffc7174414608fc71639e8748ca86f'],26,141,167,1234110,4,0.563636364,0.963636364,0.963636364,2158
a29704e2067fc28c6d0b54b8ae5a28102b788f4f,0,Todd Lipcon,2018-02-06 07:58:40+00:00,['ab5387403e42df3161492d6f48b9b51bc85c7499'],3,68,71,1234181,4,0.384615385,0.897435897,0.897435897,2158
2572c4fa92965f2478415e6c98f250381f69abf4,0,Todd Lipcon,2018-02-06 07:58:52+00:00,['a29704e2067fc28c6d0b54b8ae5a28102b788f4f'],1,1,2,1234183,1,,,,2158
7579da22adb758a680b2ab09d94a86a92b4e18c5,0,Todd Lipcon,2018-02-06 07:59:14+00:00,['2572c4fa92965f2478415e6c98f250381f69abf4'],6,15,21,1234204,3,0,0.333333333,0.333333333,2158
6e5b15770ee223bfd225f384369b80e1b8475fa6,0,Todd Lipcon,2018-02-06 07:59:26+00:00,['7579da22adb758a680b2ab09d94a86a92b4e18c5'],1,3,4,1234208,1,,,,2158
c1b9f1088f830235f9d4e6830f59b1a200a65ab6,0,Todd Lipcon,2018-02-06 08:01:09+00:00,['6e5b15770ee223bfd225f384369b80e1b8475fa6'],7,49,56,1234264,3,,,,2159
1c8c0ad12f52147f7238329f73218086916fef88,0,Mike Percy,2018-02-07 01:15:01+00:00,['c1b9f1088f830235f9d4e6830f59b1a200a65ab6'],1,26,27,1234291,1,,,,2159
c5b2002e62b630fe320b637c6e6649a67446136e,0,Mike Percy,2018-02-07 03:36:22+00:00,['1c8c0ad12f52147f7238329f73218086916fef88'],0,4,4,1234295,1,1,1,1,2159
cfecb1c917b38bce106eb1a9ca52bed91aa1d2ae,0,Todd Lipcon,2018-02-07 19:58:38+00:00,['c5b2002e62b630fe320b637c6e6649a67446136e'],1,3,4,1234299,1,,,,2159
be16a81a2d51bd9c9cd5b3829d0d4429359516da,0,Mike Percy,2018-02-07 22:59:33+00:00,['cfecb1c917b38bce106eb1a9ca52bed91aa1d2ae'],15,18,33,1234332,2,1,1,1,2159
9b1281c9551af1d390a59f9d199be7f845f9b9b2,0,Mike Percy,2018-02-07 22:59:38+00:00,['be16a81a2d51bd9c9cd5b3829d0d4429359516da'],1,1,2,1234334,1,,,,2159
f5d7292fa70a0a6a5461d419c187a5e65354d404,0,Alexey Serbin,2018-02-09 01:04:50+00:00,['9b1281c9551af1d390a59f9d199be7f845f9b9b2'],2,4,6,1234340,1,0,0,0,2159
c8a1c0f977c122e4da0e12deec9e23f7ce6a9e74,0,Mike Percy,2018-02-09 06:04:20+00:00,['f5d7292fa70a0a6a5461d419c187a5e65354d404'],14,75,89,1234429,3,0.35,1,0.475,2159
526ee84976e89293cff744b1c94e3e663174ef70,0,Todd Lipcon,2018-02-09 19:57:46+00:00,['c8a1c0f977c122e4da0e12deec9e23f7ce6a9e74'],14,0,14,1234443,2,1,1,0,2159
ba33f0346877c8d606ae97a42a6403a001e384bb,0,Todd Lipcon,2018-02-10 00:26:59+00:00,['526ee84976e89293cff744b1c94e3e663174ef70'],20,39,59,1234502,12,,,,2159
194fd8b169f29aafbd78a47709ac51d2e8354a1a,0,Mike Percy,2018-02-10 02:06:37+00:00,['ba33f0346877c8d606ae97a42a6403a001e384bb'],0,17,17,1234519,3,0,1,1,2159
d1d7572b364e06320e7afab8724242508709625d,0,Todd Lipcon,2018-02-12 19:27:31+00:00,['194fd8b169f29aafbd78a47709ac51d2e8354a1a'],5,19,24,1234543,5,1,1,1,2159
306c86a36513dfa1a6dc647418937df847c66f71,0,Todd Lipcon,2018-02-12 20:24:59+00:00,['d1d7572b364e06320e7afab8724242508709625d'],27,27,54,1234597,4,,,,2159
c61ed9b3fb0a6646ec182005d3a640d31c6b31e3,0,Todd Lipcon,2018-02-12 23:07:29+00:00,['306c86a36513dfa1a6dc647418937df847c66f71'],0,3,3,1234600,1,,,,2159
d977d1cf16d5b8e82d84396a0a82351582258fa1,1,Mike Percy,2018-02-12 23:29:07+00:00,['c61ed9b3fb0a6646ec182005d3a640d31c6b31e3'],28,88,116,1234716,11,0.285714286,0,0.897959184,2159
17f97531e2e333836c55c8df0bbe27974005b4a6,0,Mike Percy,2018-02-12 23:29:31+00:00,['d977d1cf16d5b8e82d84396a0a82351582258fa1'],155,87,242,1234958,6,0,0,0,2159
8760bb0b787b8b457ae77c7bd42b90284b226b9b,0,Mike Percy,2018-02-12 23:29:46+00:00,['17f97531e2e333836c55c8df0bbe27974005b4a6'],3,3,6,1234964,1,,,,2159
84e0f30335554a0c459bb54535ff9ab2334ec235,1,Mike Percy,2018-02-12 23:29:59+00:00,['8760bb0b787b8b457ae77c7bd42b90284b226b9b'],37,35,72,1235036,2,1,1,0,2159
c9c86f4788c42b864bf0e8aaebcd03d75f5a6e9b,0,Todd Lipcon,2018-02-13 00:12:41+00:00,['84e0f30335554a0c459bb54535ff9ab2334ec235'],1,1,2,1235038,1,,,,2159
60eca0125c9383fa67b304b15b64728b8f153ceb,0,Todd Lipcon,2018-02-13 01:09:08+00:00,['c9c86f4788c42b864bf0e8aaebcd03d75f5a6e9b'],8,143,151,1235189,1,,,,2159
136b8058fb1b7206216c1962b6b1f8a6927b8e3b,0,Mike Percy,2018-02-13 01:27:27+00:00,['60eca0125c9383fa67b304b15b64728b8f153ceb'],15,74,89,1235278,1,,,,2159
f9b2ccc874a9e643cf38966b3e25d927f4b19b1a,0,Todd Lipcon,2018-02-13 20:33:44+00:00,['136b8058fb1b7206216c1962b6b1f8a6927b8e3b'],9,52,61,1235339,3,0.266666667,1,1,2159
6f30a3118e351bcb11a8ca2aa3f0e2ee8d882cc6,0,Grant Henke,2018-02-13 21:04:11+00:00,['f9b2ccc874a9e643cf38966b3e25d927f4b19b1a'],2,6,8,1235347,2,,,,2159
5d10a56f9d06dc695f2a4469edbabce978912eb4,0,Alexey Serbin,2018-02-13 21:05:40+00:00,['6f30a3118e351bcb11a8ca2aa3f0e2ee8d882cc6'],9,11,20,1235367,1,0,0,0,2159
51218713a1084c9e6d50e2a93bd79f81a4a9aea0,0,Will Berkeley,2018-02-13 21:07:53+00:00,['5d10a56f9d06dc695f2a4469edbabce978912eb4'],0,65,65,1235432,1,,,,2159
c9e3bd846d6d0403c688a8e7d178f31966a3bfd3,0,Will Berkeley,2018-02-13 21:08:07+00:00,['51218713a1084c9e6d50e2a93bd79f81a4a9aea0'],0,182,182,1235614,1,,,,2160
118e8f34c6d72c049e422df827f53341687dd275,0,Grant Henke,2018-02-13 21:52:14+00:00,['c9e3bd846d6d0403c688a8e7d178f31966a3bfd3'],0,33,33,1235647,2,0,0,1,2160
4f34b69d4969c5a63885067a131c4d85016a173e,1,Grant Henke,2018-02-13 22:20:03+00:00,['118e8f34c6d72c049e422df827f53341687dd275'],62,1502,1564,1237211,24,0.368480726,0.756235828,0.756235828,2162
cbd34fa850036b4e22e3ff5be92238677e99adb3,0,Grant Henke,2018-02-13 22:20:22+00:00,['4f34b69d4969c5a63885067a131c4d85016a173e'],25,84,109,1237320,6,0,0.708333333,0.75,2162
a7f5e8388e8e63b681200ccd2e8423edf76e3dc8,0,Todd Lipcon,2018-02-13 22:34:25+00:00,['cbd34fa850036b4e22e3ff5be92238677e99adb3'],0,4,4,1237324,1,0,0,0,2162
cd419906204b77a5b548f61f93b72d5388b7c037,0,Will Berkeley,2018-02-14 21:13:57+00:00,['a7f5e8388e8e63b681200ccd2e8423edf76e3dc8'],11,11,22,1237346,1,,,,2162
0396cca5bd7e2ba6b038813ed70fd82c707d9861,0,Alexey Serbin,2018-02-14 22:40:13+00:00,['cd419906204b77a5b548f61f93b72d5388b7c037'],2,0,2,1237348,1,1,0,1,2162
0eef8e077fd21e871dabcb24aa1f9ce7e4f1cadf,0,Alexey Serbin,2018-02-15 21:39:19+00:00,['0396cca5bd7e2ba6b038813ed70fd82c707d9861'],11,27,38,1237386,1,,,,2162
3bd1aad6d27a9ffee4d5df56749b718efb48dcf2,0,Grant Henke,2018-02-16 13:28:13+00:00,['0eef8e077fd21e871dabcb24aa1f9ce7e4f1cadf'],138,204,342,1237728,2,,,,2162
fc2e8787008445e087c0684fc612ace1964e9c24,0,Todd Lipcon,2018-02-16 21:27:51+00:00,['3bd1aad6d27a9ffee4d5df56749b718efb48dcf2'],1,1,2,1237730,1,,,,2162
a1854325b1c769bafcd20504b5f50c72195bc790,0,Hao Hao,2018-02-16 23:26:33+00:00,['fc2e8787008445e087c0684fc612ace1964e9c24'],4,12,16,1237746,2,,,,2162
9c70e0751395c0418f23e90200882eb312fee5e9,0,Alexey Serbin,2018-02-17 01:46:36+00:00,['a1854325b1c769bafcd20504b5f50c72195bc790'],3,4,7,1237753,1,,,,2162
e0e440eff66b3da7f456ae01b15eefae3fccfd45,0,Grant Henke,2018-02-20 20:29:04+00:00,['9c70e0751395c0418f23e90200882eb312fee5e9'],0,23,23,1237776,2,0,0.428571429,0,2162
c182d626c111dde30d5602aaba102fb47b7404df,0,Todd Lipcon,2018-02-20 21:34:47+00:00,['e0e440eff66b3da7f456ae01b15eefae3fccfd45'],4,61,65,1237841,4,1,1,1,2163
270dd999683e930d89cfa7865a1f85239b525183,0,Mike Percy,2018-02-21 00:07:25+00:00,['c182d626c111dde30d5602aaba102fb47b7404df'],8,105,113,1237954,3,0,0.343283582,0.970149254,2163
2165ce577e208f27a18d3a98fdf97b9f3333b7d5,0,Andrew Wong,2018-02-21 00:10:38+00:00,['270dd999683e930d89cfa7865a1f85239b525183'],303,311,614,1238568,37,1,0.260869565,0.391304348,2163
a964b0e36c7bb16bdbbd7f8aa98c67e1da5a99eb,0,Todd Lipcon,2018-02-21 01:48:58+00:00,['2165ce577e208f27a18d3a98fdf97b9f3333b7d5'],59,22,81,1238649,5,0.023809524,0.023809524,0.047619048,2163
a66585398e3873a3b8a38f6a3a1becb644979a50,0,Alexey Serbin,2018-02-21 02:14:04+00:00,['a964b0e36c7bb16bdbbd7f8aa98c67e1da5a99eb'],4,305,309,1238958,4,0,0,1,2164
5a52480580ff82ff0d5ceaab7e080c091fe95c92,0,Alexey Serbin,2018-02-21 02:33:14+00:00,['a66585398e3873a3b8a38f6a3a1becb644979a50'],16,36,52,1239010,1,0,0,0,2164
5b575f2bc1c4e9c3d4d4823ddb0212adcdd2ccfe,0,Todd Lipcon,2018-02-21 06:07:18+00:00,['5a52480580ff82ff0d5ceaab7e080c091fe95c92'],16,70,86,1239096,1,0.448275862,1,1,2164
d9e7037138646e3efb331af98c6982de13294c4b,1,Todd Lipcon,2018-02-21 06:08:03+00:00,['5b575f2bc1c4e9c3d4d4823ddb0212adcdd2ccfe'],10,291,301,1239397,6,0.727272727,0.727272727,1,2166
723ced836aa5e9729fa2891d558f0f70171c4db1,1,Hao Hao,2018-02-21 19:20:28+00:00,['d9e7037138646e3efb331af98c6982de13294c4b'],98,326,424,1239821,6,0,1,0.846153846,2166
0815a1238d18e3a82c33018ea07014d202a16018,0,Grant Henke,2018-02-21 19:40:35+00:00,['723ced836aa5e9729fa2891d558f0f70171c4db1'],10,156,166,1239987,5,0.084745763,0.830508475,0.889830508,2166
19c47e6596cc4a58541dcbf9d900bd37eaff618b,0,Alexey Serbin,2018-02-21 20:55:15+00:00,['0815a1238d18e3a82c33018ea07014d202a16018'],0,5,5,1239992,1,0,0,1,2166
0798037c32a3b40134e1f45cd6d458df6b3255da,0,Mike Percy,2018-02-21 21:14:48+00:00,['19c47e6596cc4a58541dcbf9d900bd37eaff618b'],23,64,87,1240079,6,0,0.833333333,0,2166
50931e291188000d0caf0493f39b1e4a395e1243,0,Hao Hao,2018-02-21 22:04:25+00:00,['0798037c32a3b40134e1f45cd6d458df6b3255da'],8,21,29,1240108,1,,,,2166
c20b84bb600575e4f6a34846c07acf4603b1bf26,1,Todd Lipcon,2018-02-21 23:54:49+00:00,['50931e291188000d0caf0493f39b1e4a395e1243'],109,317,426,1240534,4,0.419047619,0.533333333,1,2166
0ee40b6618df235fa7d31eeba3caede93b2a3852,0,Todd Lipcon,2018-02-21 23:54:55+00:00,['c20b84bb600575e4f6a34846c07acf4603b1bf26'],17,81,98,1240632,5,0,0,1,2167
68d797da1c11e15ebde06b16bb7e6ef3f36f9994,0,Todd Lipcon,2018-02-22 18:06:22+00:00,['0ee40b6618df235fa7d31eeba3caede93b2a3852'],3,68,71,1240703,5,0.076923077,0.974358974,1,2167
1ae56048b8ad62f1f7d11a4e6bdd290f9c753191,0,Todd Lipcon,2018-02-22 20:15:52+00:00,['68d797da1c11e15ebde06b16bb7e6ef3f36f9994'],51,571,622,1241325,3,,,,2168
2b0c1c019921e485f06c4be280fedba3d5279672,1,Dan Burkert,2018-02-22 20:52:27+00:00,['1ae56048b8ad62f1f7d11a4e6bdd290f9c753191'],9,19,28,1241353,4,0,1,0.333333333,2168
b0dc9ea903365d54b9daf9c1b53d8ab2cc921fa6,0,Alexey Serbin,2018-02-22 20:56:31+00:00,['2b0c1c019921e485f06c4be280fedba3d5279672'],7,9,16,1241369,1,0,0,1,2168
15f49edd64bdb7b1714287c5e3f8af59eb1593a6,0,Todd Lipcon,2018-02-22 21:02:08+00:00,['b0dc9ea903365d54b9daf9c1b53d8ab2cc921fa6'],26,95,121,1241490,3,0,0.4,1,2168
f92f65c44e3e7c7815731c8aee2f1dc869ec2fbc,0,Todd Lipcon,2018-02-22 21:02:25+00:00,['15f49edd64bdb7b1714287c5e3f8af59eb1593a6'],0,2,2,1241492,1,0,1,1,2168
8ea955d7645ae9a1ef6a816b2f28b2661f2f87d2,1,Todd Lipcon,2018-02-22 21:02:34+00:00,['f92f65c44e3e7c7815731c8aee2f1dc869ec2fbc'],0,39,39,1241531,1,0,0,1,2168
40ba6c1436abc2785516160326af4b156e418580,0,Todd Lipcon,2018-02-23 00:17:54+00:00,['8ea955d7645ae9a1ef6a816b2f28b2661f2f87d2'],5,23,28,1241559,1,0,0,1,2168
1f26176748911ccc7104e932440f44c74bd3d006,0,Todd Lipcon,2018-02-23 00:22:00+00:00,['40ba6c1436abc2785516160326af4b156e418580'],37,49,86,1241645,5,0.181818182,0.545454545,0.363636364,2168
a3ecd1a99a8da094da12d5b94efa8e5cf40debad,1,Todd Lipcon,2018-02-23 02:37:13+00:00,['1f26176748911ccc7104e932440f44c74bd3d006'],8,19,27,1241672,2,0.5,1,1,2168
a8b51b291883c0ab4fbfa5ee86525d4b9cc3a66a,0,Todd Lipcon,2018-02-23 02:37:30+00:00,['a3ecd1a99a8da094da12d5b94efa8e5cf40debad'],73,241,314,1241986,6,0.931818182,1,1,2170
6309fb182070761da0ec75930b293fdec69cdb5a,0,Todd Lipcon,2018-02-23 02:37:36+00:00,['a8b51b291883c0ab4fbfa5ee86525d4b9cc3a66a'],29,46,75,1242061,5,1,1,1,2170
ab6296fdd3d852d20845565884b34880c5db5320,0,Todd Lipcon,2018-02-23 02:50:57+00:00,['6309fb182070761da0ec75930b293fdec69cdb5a'],5,8,13,1242074,1,,,,2170
1cf8ad189719eda84c1a28e7b9dcddfd972c7b98,0,Alexey Serbin,2018-02-23 05:36:28+00:00,['ab6296fdd3d852d20845565884b34880c5db5320'],17,17,34,1242108,7,,,,2170
52ca55ac29282a15213803c23946b6ee17c1c134,0,Andrew Wong,2018-02-23 06:38:30+00:00,['1cf8ad189719eda84c1a28e7b9dcddfd972c7b98'],2,6,8,1242116,1,0,1,1,2170
e94556ef767b11f7508d7dae3a92e124769f800e,0,Grant Henke,2018-02-23 17:48:16+00:00,['52ca55ac29282a15213803c23946b6ee17c1c134'],2,63,65,1242181,2,1,1,1,2170
2a5a12fbd69882b387f83e1da71d8a0fd19b6a63,0,Andrew Wong,2018-02-23 19:09:02+00:00,['e94556ef767b11f7508d7dae3a92e124769f800e'],8,21,29,1242210,3,0,0.7,0.7,2170
20ba3c7ba6c64c4a1521e7aab06a99a93cc01d45,0,Todd Lipcon,2018-02-23 20:42:19+00:00,['2a5a12fbd69882b387f83e1da71d8a0fd19b6a63'],5,26,31,1242241,2,0.714285714,0.857142857,1,2170
57fe0c3db086c9fc61fbcef9b2d879422b387a7e,1,Dan Burkert,2018-02-23 21:09:17+00:00,['20ba3c7ba6c64c4a1521e7aab06a99a93cc01d45'],83,994,1077,1243318,14,0.326180258,0.82832618,0.80472103,2172
416b3018a415e9a6515e5a7ffb0f3f51c0482757,0,Alexey Serbin,2018-02-23 21:10:06+00:00,['57fe0c3db086c9fc61fbcef9b2d879422b387a7e'],4,4,8,1243326,1,,,,2172
831483b47fd0e2165c3612811fdbf6337e3891b8,1,Todd Lipcon,2018-02-23 23:06:30+00:00,['416b3018a415e9a6515e5a7ffb0f3f51c0482757'],113,191,304,1243630,5,0.894736842,1,1,2172
09298f3b6756f10a7d598b4de77676d49c38f117,1,Todd Lipcon,2018-02-23 23:06:40+00:00,['831483b47fd0e2165c3612811fdbf6337e3891b8'],42,236,278,1243908,7,0.116504854,0.106796117,1,2172
00815045fc3295c12023fd7ae7ad220645a10c3a,0,David Ribeiro Alves,2018-02-23 23:06:45+00:00,['09298f3b6756f10a7d598b4de77676d49c38f117'],0,7,7,1243915,1,0,1,1,2172
03e49899a6bbd2ccc3559900ae67e23bffd8498e,0,Alexey Serbin,2018-02-24 20:27:36+00:00,['00815045fc3295c12023fd7ae7ad220645a10c3a'],1,1,2,1243917,1,,,,2172
f3382a9b873a262e00099536157b9f0f10c339f4,0,Todd Lipcon,2018-02-26 07:11:57+00:00,['03e49899a6bbd2ccc3559900ae67e23bffd8498e'],38,112,150,1244067,2,0.416666667,0,1,2172
c04981d81d547819416155f2295e1210d9d7c39a,0,Adar Dembo,2018-02-26 20:00:20+00:00,['f3382a9b873a262e00099536157b9f0f10c339f4'],2,32,34,1244101,4,0.230769231,0.769230769,0.615384615,2172
3b2df01c0d75b1244bb45953953144937af8fd1c,0,Alexey Serbin,2018-02-27 06:20:30+00:00,['c04981d81d547819416155f2295e1210d9d7c39a'],127,170,297,1244398,7,0,0.951219512,0.87804878,2172
e9448dac5d4d70a4c6e05c3d8e98c4c5d8c3fc14,0,Todd Lipcon,2018-02-28 09:08:55+00:00,['3b2df01c0d75b1244bb45953953144937af8fd1c'],11,27,38,1244436,1,1,1,1,2172
7e54a17ec63f3d2a01c21aa53fc8f94adf7f1909,0,Alexey Serbin,2018-03-02 20:22:34+00:00,['e9448dac5d4d70a4c6e05c3d8e98c4c5d8c3fc14'],24,233,257,1244693,5,0.424,0.992,1,2172
9bc0d9e3f2d1483f7f51399500f8121fd39d12e1,0,Hao Hao,2018-03-02 23:18:59+00:00,['7e54a17ec63f3d2a01c21aa53fc8f94adf7f1909'],8,22,30,1244723,2,0,1,0.428571429,2172
0a9d1aac2a328500b702d7739b13fe3e590e5c86,0,Adar Dembo,2018-03-02 23:44:08+00:00,['9bc0d9e3f2d1483f7f51399500f8121fd39d12e1'],0,8,8,1244731,1,,,,2172
b6682c7ece2170a0524676a9ebc4fd75b45e8304,0,Todd Lipcon,2018-03-04 18:15:03+00:00,['0a9d1aac2a328500b702d7739b13fe3e590e5c86'],2,3,5,1244736,1,0,1,1,2172
726514abfe309b0b88a5d868129f494c379af954,0,Todd Lipcon,2018-03-04 18:15:06+00:00,['b6682c7ece2170a0524676a9ebc4fd75b45e8304'],0,9,9,1244745,1,,,,2172
5047f091d312698b5e1d2d9db75fbccfde24f687,0,Hao Hao,2018-03-04 20:24:43+00:00,['726514abfe309b0b88a5d868129f494c379af954'],96,406,502,1245247,10,0.219354839,0.612903226,0.580645161,2172
11241754b9c5758d8a82fbd16ca53526f4238839,0,Todd Lipcon,2018-03-05 06:35:03+00:00,['5047f091d312698b5e1d2d9db75fbccfde24f687'],4,4,8,1245255,1,,,,2172
2b2b2dd1c3d156e71294177a33c36f45084d9ae8,0,Todd Lipcon,2018-03-05 06:35:19+00:00,['11241754b9c5758d8a82fbd16ca53526f4238839'],142,229,371,1245626,11,0,0.377777778,0.955555556,2172
9b6034b4ecc4d08870edaad366ab24a0f3fd2728,0,Todd Lipcon,2018-03-05 06:35:30+00:00,['2b2b2dd1c3d156e71294177a33c36f45084d9ae8'],4,7,11,1245637,1,0,0,1,2172
cdc73b900608000ff2d2f8bc74c05893338454ba,0,Todd Lipcon,2018-03-05 07:33:19+00:00,['9b6034b4ecc4d08870edaad366ab24a0f3fd2728'],11,83,94,1245731,3,0,0.377777778,0.777777778,2172
f81690d76a4ab8a20829be664f6dce4084e2320d,0,Grant Henke,2018-03-05 18:09:51+00:00,['cdc73b900608000ff2d2f8bc74c05893338454ba'],0,10,10,1245741,1,,,,2172
29e795d58fc1a59102f358b4edb4faa39aa5d02b,0,Todd Lipcon,2018-03-05 18:22:07+00:00,['f81690d76a4ab8a20829be664f6dce4084e2320d'],51,76,127,1245868,4,0.25,1,0.75,2172
f38213d8dcf233891cc1d0f18b3c68d9ad67f429,0,Alexey Serbin,2018-03-05 19:03:57+00:00,['29e795d58fc1a59102f358b4edb4faa39aa5d02b'],2,11,13,1245881,1,0,0,0.111111111,2172
cc4e3957ba29bb42112dc21bfa8242e3f7afeac6,0,Mike Percy,2018-03-05 19:06:19+00:00,['f38213d8dcf233891cc1d0f18b3c68d9ad67f429'],0,399,399,1246280,1,,,,2173
249af9a101462bb0ca840e20a3dc8b4a76e929fd,0,Dan Burkert,2018-03-05 20:28:37+00:00,['cc4e3957ba29bb42112dc21bfa8242e3f7afeac6'],74,84,158,1246438,4,1,1,1,2173
3bfcbd8ad27c9bd89fc72f2f6c49ee01f3382063,0,Dan Burkert,2018-03-05 20:28:40+00:00,['249af9a101462bb0ca840e20a3dc8b4a76e929fd'],2,3,5,1246443,1,,,,2173
1eb15683b41e80f49ce7a51c9a9d222301d23723,0,Dan Burkert,2018-03-05 21:22:57+00:00,['3bfcbd8ad27c9bd89fc72f2f6c49ee01f3382063'],3,3,6,1246449,2,,,,2173
cf67b59ec6fdfa02d4fc00e55ca00b5dfa83cce1,0,Todd Lipcon,2018-03-06 18:26:10+00:00,['1eb15683b41e80f49ce7a51c9a9d222301d23723'],0,2,2,1246451,1,0,1,1,2173
2aa1b883c3a875f554d787ccebabdf7450d56a58,0,Dan Burkert,2018-03-06 19:15:58+00:00,['cf67b59ec6fdfa02d4fc00e55ca00b5dfa83cce1'],20,117,137,1246588,5,0.19047619,0.984126984,1,2173
d5b3b5196407402efd86ba7ffee5a890d23fe0d2,0,Will Berkeley,2018-03-06 20:21:50+00:00,['2aa1b883c3a875f554d787ccebabdf7450d56a58'],2,18,20,1246608,2,0.4,1,1,2173
72eb86fabe2cb1d145faca07df1200c04bd160df,0,Todd Lipcon,2018-03-06 20:42:12+00:00,['d5b3b5196407402efd86ba7ffee5a890d23fe0d2'],10,0,10,1246618,2,,,,2173
dbcd6218010ef71cb32b0774a8a7da0d48969962,0,Will Berkeley,2018-03-06 22:23:55+00:00,['72eb86fabe2cb1d145faca07df1200c04bd160df'],0,9,9,1246627,3,0,0,1,2173
13fc0666d6eecff021ca92348644d674c994cee1,0,Will Berkeley,2018-03-06 22:32:49+00:00,['dbcd6218010ef71cb32b0774a8a7da0d48969962'],27,53,80,1246707,4,0,0,1,2173
9f93e97a676a93db33b8dc57e0f9d2be8147a189,0,Todd Lipcon,2018-03-06 22:44:08+00:00,['13fc0666d6eecff021ca92348644d674c994cee1'],0,5,5,1246712,1,,,,2173
e7c7d4a1203d4869713ec2d912dadb3f43c60bdb,0,Will Berkeley,2018-03-06 22:58:15+00:00,['9f93e97a676a93db33b8dc57e0f9d2be8147a189'],38,46,84,1246796,1,,,,2173
1c1d3ba1cebb6b02cea9603c952931fd8261200a,0,Todd Lipcon,2018-03-06 22:59:06+00:00,['e7c7d4a1203d4869713ec2d912dadb3f43c60bdb'],48,80,128,1246924,14,,,,2173
940e60f0f844782fa01ba449ce6a38e08f721d06,0,Todd Lipcon,2018-03-06 22:59:17+00:00,['1c1d3ba1cebb6b02cea9603c952931fd8261200a'],14,11,25,1246949,1,0,0,0,2173
c8724c61501a0e940fbcda6cc4d13716b65f8a8a,0,Adar Dembo,2018-03-06 23:09:51+00:00,['940e60f0f844782fa01ba449ce6a38e08f721d06'],2,17,19,1246968,2,,,,2173
97e1cbfc92b710d4ef9dfb3ed559b175073982b3,0,Dan Burkert,2018-03-07 01:09:28+00:00,['c8724c61501a0e940fbcda6cc4d13716b65f8a8a'],3,7,10,1246978,3,,,,2173
2b6804014916e2ef6bae5f2be14fc3ca49e92e9d,0,Andrew Wong,2018-03-07 02:36:42+00:00,['97e1cbfc92b710d4ef9dfb3ed559b175073982b3'],78,70,148,1247126,2,,,,2173
e6aedc99d25ba8bc8f1fc37259404d55c802953f,1,David Ribeiro Alves,2018-03-07 19:46:57+00:00,['2b6804014916e2ef6bae5f2be14fc3ca49e92e9d'],11,368,379,1247505,11,0.685714286,0.99047619,0.961904762,2174
74dc5da86ab2e5c8bfe524599d4a9e7a04d3cd27,0,Todd Lipcon,2018-03-07 20:17:15+00:00,['e6aedc99d25ba8bc8f1fc37259404d55c802953f'],1,1,2,1247507,1,,,,2174
954d9f71b50e2fae24a6e3acfe094b4d24dc5c2c,0,Dan Burkert,2018-03-08 00:39:23+00:00,['74dc5da86ab2e5c8bfe524599d4a9e7a04d3cd27'],14,20,34,1247541,4,1,1,1,2174
ede0cf0ec3924a067f82b625eb61410e8b734183,0,Adar Dembo,2018-03-08 02:43:31+00:00,['954d9f71b50e2fae24a6e3acfe094b4d24dc5c2c'],33,106,139,1247680,5,0.888888889,1,1,2174
debcb8ea21e95b57f5a9924b07acf43ca7a4a389,0,Adar Dembo,2018-03-08 02:43:34+00:00,['ede0cf0ec3924a067f82b625eb61410e8b734183'],11,57,68,1247748,1,0.28,1,1,2174
b525378c550a8227257ffac2a8d45a6d519f33f7,0,Dan Burkert,2018-03-08 04:29:21+00:00,['debcb8ea21e95b57f5a9924b07acf43ca7a4a389'],3,5,8,1247756,3,,,,2174
96b3b63a48c270a77819e6fc80d1dfdb381a0df7,1,Todd Lipcon,2018-03-08 18:53:03+00:00,['b525378c550a8227257ffac2a8d45a6d519f33f7'],19,185,204,1247960,10,0,0.829268293,1,2174
0c39ed7e302f08e3030e9e708739dc6a6862bf4b,1,Todd Lipcon,2018-03-08 18:53:07+00:00,['96b3b63a48c270a77819e6fc80d1dfdb381a0df7'],49,77,126,1248086,2,0,1,1,2174
5d016e1a775caae6b11a7d8b74fbbc547de7feae,0,Grant Henke,2018-03-08 19:48:36+00:00,['0c39ed7e302f08e3030e9e708739dc6a6862bf4b'],1,25,26,1248112,1,,,,2174
55e611d3006084db0d32d33fc38ca55fbf206b9a,1,Todd Lipcon,2018-03-08 23:59:05+00:00,['5d016e1a775caae6b11a7d8b74fbbc547de7feae'],102,796,898,1249010,14,0.251655629,0.844370861,0.960264901,2174
d869b8033ac0026d585ab1d5bc69a1ba205357fa,0,Andrew Wong,2018-03-09 02:18:03+00:00,['55e611d3006084db0d32d33fc38ca55fbf206b9a'],90,189,279,1249289,4,0.084507042,1,0.76056338,2174
0ba702c20f89f3d776e243b1f35b9c1486898564,0,Grant Henke,2018-03-09 19:38:24+00:00,['d869b8033ac0026d585ab1d5bc69a1ba205357fa'],0,5,5,1249294,1,,,,2174
92486c83d5663108ba6ffb63a081fa55ba38bb03,0,Alexey Serbin,2018-03-09 22:37:07+00:00,['0ba702c20f89f3d776e243b1f35b9c1486898564'],30,110,140,1249434,5,0.069767442,0.488372093,1,2174
29dbc7e411bbd1d0e542185880163642703ca5ba,0,Alexey Serbin,2018-03-10 01:05:46+00:00,['92486c83d5663108ba6ffb63a081fa55ba38bb03'],1,2,3,1249437,1,0,0,1,2174
8aa75d8cfced3a88f9ae2c5ed9bb4afaec15cec7,0,Alexey Serbin,2018-03-12 18:19:44+00:00,['29dbc7e411bbd1d0e542185880163642703ca5ba'],1,4,5,1249442,1,0,1,1,2174
0c05e8375d005a91d37acd3102a22ddbe92382d5,1,Hao Hao,2018-03-12 21:12:36+00:00,['8aa75d8cfced3a88f9ae2c5ed9bb4afaec15cec7'],7,236,243,1249685,4,0.186567164,0.447761194,0.97761194,2174
fbf6062cacd2a14cb9497bc29bf821b0578431dc,0,Adar Dembo,2018-03-12 22:26:32+00:00,['0c05e8375d005a91d37acd3102a22ddbe92382d5'],3,12,15,1249700,2,,,,2174
06704ec20f7adde0369f4ccca45f32976e0abe86,0,Todd Lipcon,2018-03-12 23:28:13+00:00,['fbf6062cacd2a14cb9497bc29bf821b0578431dc'],1,10,11,1249711,2,0.333333333,1,1,2174
cda07be91bdb9ea537dc19768db54fd345ce7bf0,0,Andrew Wong,2018-03-12 23:40:48+00:00,['06704ec20f7adde0369f4ccca45f32976e0abe86'],0,14,14,1249725,1,,,,2174
038c3ebe77f41e3d2ebfc1d08ea8cf849edb2a5d,0,Todd Lipcon,2018-03-12 23:47:08+00:00,['cda07be91bdb9ea537dc19768db54fd345ce7bf0'],91,88,179,1249904,14,1,1,0,2174
fa2b495487e520f911a0ddbd8b2bf52bfe01e28e,0,Alexey Serbin,2018-03-13 00:01:01+00:00,['038c3ebe77f41e3d2ebfc1d08ea8cf849edb2a5d'],14,15,29,1249933,2,,,,2174
68c185747ddefb0f085ac2e5a4f460e957e802d8,0,Andrew Wong,2018-03-13 00:22:19+00:00,['fa2b495487e520f911a0ddbd8b2bf52bfe01e28e'],1,4,5,1249938,1,,,,2174
4cd6338e60101b7c442ee7f8c28215ea3558cbf1,0,Todd Lipcon,2018-03-13 01:39:24+00:00,['68c185747ddefb0f085ac2e5a4f460e957e802d8'],1,4,5,1249943,1,,,,2174
0a37d1f3be2ec08a3e295b03e5907a7d878eb753,0,Grant Henke,2018-03-13 02:19:46+00:00,['4cd6338e60101b7c442ee7f8c28215ea3558cbf1'],8,65,73,1250016,5,,,,2174
9749d4cde4c475783b0e936d641749b3394c5aad,0,Grant Henke,2018-03-13 03:42:58+00:00,['0a37d1f3be2ec08a3e295b03e5907a7d878eb753'],0,20,20,1250036,2,0.933333333,0.933333333,0.933333333,2174
287dc540848561f6fc043e7bb810f44f94d4b419,0,Mike Percy,2018-03-13 05:42:45+00:00,['9749d4cde4c475783b0e936d641749b3394c5aad'],3,13,16,1250052,1,0,0,0,2174
de57e3c924fbb2521743ef9762a556b871691a03,0,Todd Lipcon,2018-03-13 15:11:11+00:00,['287dc540848561f6fc043e7bb810f44f94d4b419'],1,84,85,1250137,4,0,1,0.942307692,2174
13155d4a2f79f522b8213fbb99588109cc04b175,0,Will Berkeley,2018-03-13 17:21:23+00:00,['de57e3c924fbb2521743ef9762a556b871691a03'],33,60,93,1250230,2,0,0,1,2174
4889a9156a7e1f51b076f4bc9f44621a1b2f46e4,0,Todd Lipcon,2018-03-13 18:16:30+00:00,['13155d4a2f79f522b8213fbb99588109cc04b175'],103,7,110,1250340,7,0,0,0,2174
d856107e0b58067f0bbebbbda52f4f67c674897a,0,Alexey Serbin,2018-03-13 18:30:15+00:00,['4889a9156a7e1f51b076f4bc9f44621a1b2f46e4'],26,36,62,1250402,5,0.5,0.5,0.25,2174
ce0db915787b58a79109e6faecc6f1daef9f2850,0,Todd Lipcon,2018-03-13 18:32:11+00:00,['d856107e0b58067f0bbebbbda52f4f67c674897a'],6,30,36,1250438,2,0.444444444,0.666666667,1,2174
217715aae6eafdebb15fc33a103dea07e3bb37c1,0,Hao Hao,2018-03-13 22:09:48+00:00,['ce0db915787b58a79109e6faecc6f1daef9f2850'],0,9,9,1250447,1,,,,2174
846a78563ec3417a405763c5a2c2460317b63b92,0,Alexey Serbin,2018-03-13 23:04:22+00:00,['217715aae6eafdebb15fc33a103dea07e3bb37c1'],1,8,9,1250456,1,,,,2174
d88e5772ee323c8a305250c7d0aa0b49f67475dc,1,Todd Lipcon,2018-03-13 23:40:05+00:00,['846a78563ec3417a405763c5a2c2460317b63b92'],24,49,73,1250529,6,0.181818182,0.818181818,0.636363636,2174
4c2bb92f14e1346928ef16dacd63812602683ed2,0,Todd Lipcon,2018-03-13 23:42:46+00:00,['d88e5772ee323c8a305250c7d0aa0b49f67475dc'],19,65,84,1250613,6,0.75,1,1,2174
706b3c3b186b5d196d396fbcb66b8ad005084b25,0,Grant Henke,2018-03-14 16:07:50+00:00,['4c2bb92f14e1346928ef16dacd63812602683ed2'],12,12,24,1250637,12,,,,2174
84244461d0aa5df1c041869ecbd2d18a0cca7659,0,Grant Henke,2018-03-14 16:09:40+00:00,['706b3c3b186b5d196d396fbcb66b8ad005084b25'],2,38,40,1250677,1,,,,2174
9d233f457af6bea7f30779fe0b9c812859d90a02,0,Hao Hao,2018-03-14 20:48:36+00:00,['84244461d0aa5df1c041869ecbd2d18a0cca7659'],9,31,40,1250717,5,0,1,1,2174
30cf9002879c48e190260d115d0e5dacd0fad8bb,0,Hao Hao,2018-03-14 22:15:33+00:00,['9d233f457af6bea7f30779fe0b9c812859d90a02'],1,1,2,1250719,1,,,,2174
e684de3371941cc5ae8fc4a546ecda7dbe9f4f2f,0,Dan Burkert,2018-03-15 02:47:42+00:00,['30cf9002879c48e190260d115d0e5dacd0fad8bb'],33,235,268,1250987,17,0.314606742,0.898876404,0.606741573,2175
a74f9a0dcaf88315c8563b95cdeb5701d9ce5438,1,Alexey Serbin,2018-03-15 05:19:07+00:00,['e684de3371941cc5ae8fc4a546ecda7dbe9f4f2f'],164,455,619,1251606,6,0,0.144329897,0.917525773,2175
4c1788eae5bfd4cf4a714f1ca0ab775b005303b3,1,Alexey Serbin,2018-03-15 06:02:00+00:00,['a74f9a0dcaf88315c8563b95cdeb5701d9ce5438'],72,100,172,1251778,2,0,1,0,2175
f2479e21d5a3002ebf5b1012fde83a6cffc2db82,0,Alexey Serbin,2018-03-15 06:51:25+00:00,['4c1788eae5bfd4cf4a714f1ca0ab775b005303b3'],14,21,35,1251813,1,0,0,0,2175
8204f43f0204c172c4a799f9ccda0592d3b02138,0,Grant Henke,2018-03-15 16:13:09+00:00,['f2479e21d5a3002ebf5b1012fde83a6cffc2db82'],87,167,254,1252067,10,1,1,0.96,2176
ead756844ce9ada904fcc3666df25692f63e76b8,1,Grant Henke,2018-03-15 16:14:23+00:00,['8204f43f0204c172c4a799f9ccda0592d3b02138'],7,78,85,1252152,5,0.444444444,0.911111111,0.844444444,2176
4e30d6cce76fec355e60e69963712c1cc78fee84,0,Grant Henke,2018-03-15 20:02:05+00:00,['ead756844ce9ada904fcc3666df25692f63e76b8'],0,35,35,1252187,2,,,,2176
e35bba0fee8ca0f8d396edbd58b621f29e507f91,0,Grant Henke,2018-03-15 21:14:04+00:00,['4e30d6cce76fec355e60e69963712c1cc78fee84'],1,1,2,1252189,1,,,,2176
4a6bb1ac21de56fd75f981fdb820742df18c62cb,0,Adar Dembo,2018-03-15 23:38:13+00:00,['e35bba0fee8ca0f8d396edbd58b621f29e507f91'],14,16,30,1252219,2,,,,2176
ec7460a29f34dd129f6dfb0e10db719e7c0dda6d,0,Grant Henke,2018-03-16 02:27:55+00:00,['4a6bb1ac21de56fd75f981fdb820742df18c62cb'],2,5,7,1252226,1,,,,2176
889d5927cc9f5e2fbdbec9e535605404ba1fc19d,0,Grant Henke,2018-03-16 18:33:28+00:00,['ec7460a29f34dd129f6dfb0e10db719e7c0dda6d'],22,170,192,1252418,1,,,,2176
708d0f736c5a9d60ca02041bdb3b753e11478b6d,0,Will Berkeley,2018-03-16 22:37:15+00:00,['889d5927cc9f5e2fbdbec9e535605404ba1fc19d'],1,75,76,1252494,5,0,0.614035088,1,2176
a469506115fbc13c1fe835ae9c1a75a5544bf64e,0,Adar Dembo,2018-03-16 22:57:38+00:00,['708d0f736c5a9d60ca02041bdb3b753e11478b6d'],1,13,14,1252508,1,0,0,1,2176
02d9578406c955d70a59c6676c044dac42e0d9bd,0,Grant Henke,2018-03-17 00:23:27+00:00,['a469506115fbc13c1fe835ae9c1a75a5544bf64e'],64,46,110,1252618,1,,,,2176
9f6b7f16828250a89e0e331026eeb05687c6eeab,0,Alexey Serbin,2018-03-19 04:53:25+00:00,['02d9578406c955d70a59c6676c044dac42e0d9bd'],2,1,3,1252621,1,,,,2176
1bfb0c025fcdf5497006ce67a21aed75238d13cf,0,Grant Henke,2018-03-19 16:09:59+00:00,['9f6b7f16828250a89e0e331026eeb05687c6eeab'],18,30,48,1252669,1,,,,2176
250375f9783bd5558b4cdb5460dca030e9099168,0,Todd Lipcon,2018-03-20 15:01:15+00:00,['1bfb0c025fcdf5497006ce67a21aed75238d13cf'],596,20,616,1253285,5,,,,2176
bc8a5029675e30962ec5126afe3cf12f3143d4d3,0,Alexey Serbin,2018-03-20 17:42:23+00:00,['250375f9783bd5558b4cdb5460dca030e9099168'],1,3,4,1253289,1,0,1,1,2176
e391e8a9c2c92daab4124ab9d2c9803a8df6afd7,0,Alexey Serbin,2018-03-20 17:42:30+00:00,['bc8a5029675e30962ec5126afe3cf12f3143d4d3'],1,4,5,1253294,1,,,,2176
5d7b68d59ae78560d0997168a27a73c4e5280ecc,0,Alexey Serbin,2018-03-20 17:43:34+00:00,['e391e8a9c2c92daab4124ab9d2c9803a8df6afd7'],18,30,48,1253342,1,0,1,1,2176
f1805324c9ff0c52c1baee13c1ee353ca996e36a,0,Todd Lipcon,2018-03-20 22:30:09+00:00,['5d7b68d59ae78560d0997168a27a73c4e5280ecc'],5,5,10,1253352,1,,,,2176
91e207fccf95230476b4455b825e9eadd106a19f,0,Alexey Serbin,2018-03-21 00:31:03+00:00,['f1805324c9ff0c52c1baee13c1ee353ca996e36a'],1,8,9,1253361,1,0,0,1,2176
662c86c5f974579b334398375abba37fb17ae090,0,Grant Henke,2018-03-21 18:30:18+00:00,['91e207fccf95230476b4455b825e9eadd106a19f'],3,4,7,1253368,1,,,,2176
82e9a877e13b5447d502ab8c93fa157545a1be43,0,Grant Henke,2018-03-21 18:39:03+00:00,['662c86c5f974579b334398375abba37fb17ae090'],1,6,7,1253375,1,,,,2176
f9f0583fd88185a216f27dfa289da2954cbeacd6,0,Andrew Wong,2018-03-21 19:11:04+00:00,['82e9a877e13b5447d502ab8c93fa157545a1be43'],5,12,17,1253392,2,,,,2176
ac75b9ed6fa66cce100a1493e18d7eb74f5e1dd7,1,Todd Lipcon,2018-03-21 22:11:02+00:00,['f9f0583fd88185a216f27dfa289da2954cbeacd6'],38,138,176,1253568,16,0,0.781818182,0.781818182,2176
0fa3cc7cda2aaf7eb4d6763019e42b28fc3f58e6,1,Adar Dembo,2018-03-21 22:42:46+00:00,['ac75b9ed6fa66cce100a1493e18d7eb74f5e1dd7'],2,8,10,1253578,1,,,,2176
541dd5f6aadbfd31eb0c2dbdf070ff5038140b06,0,Todd Lipcon,2018-03-21 22:54:38+00:00,['0fa3cc7cda2aaf7eb4d6763019e42b28fc3f58e6'],1,1,2,1253580,1,,,,2176
b2f690d59b36a8e8c81398d2082414d5f85b047f,0,Andrew Wong,2018-03-21 23:19:49+00:00,['541dd5f6aadbfd31eb0c2dbdf070ff5038140b06'],1,66,67,1253647,3,0,0.933333333,1,2176
1bd98c7d4553e291cb57481e51ed68e4d2fe55a2,0,Grant Henke,2018-03-22 15:48:07+00:00,['b2f690d59b36a8e8c81398d2082414d5f85b047f'],1,1,2,1253649,1,,,,2176
e03375eb04945f172692ca6c4677e3442ed0b295,0,Todd Lipcon,2018-03-22 16:40:07+00:00,['1bd98c7d4553e291cb57481e51ed68e4d2fe55a2'],0,23,23,1253672,5,0,1,1,2176
9ecf7d769acebd94fdcbe4bc14ed5c75d38f2f52,0,Todd Lipcon,2018-03-22 18:33:32+00:00,['e03375eb04945f172692ca6c4677e3442ed0b295'],82,61,143,1253815,11,0,0,0,2176
ffcadd5a60107c5e150c0083f1008a745e976280,0,Todd Lipcon,2018-03-22 18:34:48+00:00,['9ecf7d769acebd94fdcbe4bc14ed5c75d38f2f52'],9,7,16,1253831,1,0,0,0,2176
600723e0e954a1b199e6a0bf1dfd63fe7289a6a8,0,Todd Lipcon,2018-03-22 18:51:47+00:00,['ffcadd5a60107c5e150c0083f1008a745e976280'],11,28,39,1253870,5,0.5,0.714285714,0.714285714,2176
9df14d362487c97de2d5e46cb190296c188f66e9,1,Todd Lipcon,2018-03-23 00:51:49+00:00,['600723e0e954a1b199e6a0bf1dfd63fe7289a6a8'],15,60,75,1253945,6,0.333333333,1,0.933333333,2176
c73f023da32015bd2d51d50099a2737cd749ceb2,0,Mike Percy,2018-03-23 04:57:46+00:00,['9df14d362487c97de2d5e46cb190296c188f66e9'],24,191,215,1254160,3,0,0,0.76635514,2176
fcb0be6381a47155e171eb50a333af502bbf506f,0,Mike Percy,2018-03-23 05:30:52+00:00,['c73f023da32015bd2d51d50099a2737cd749ceb2'],25,137,162,1254322,6,0,0.824561404,0.929824561,2176
7b88a42332540ace18ea033439ceac0e7cb68411,0,Alexey Serbin,2018-03-23 05:51:43+00:00,['fcb0be6381a47155e171eb50a333af502bbf506f'],2,16,18,1254340,2,0,0,1,2176
b531da26acf23d6f2969c66d458d598d56d37bd5,0,Mike Percy,2018-03-24 02:26:24+00:00,['7b88a42332540ace18ea033439ceac0e7cb68411'],14,2,16,1254356,2,1,1,0,2176
38a5c49f66d6a7b3ac2f0b19c58b79a7192d9597,1,Mike Percy,2018-03-24 03:03:52+00:00,['b531da26acf23d6f2969c66d458d598d56d37bd5'],32,61,93,1254449,13,0.142857143,0.571428571,0.285714286,2176
f2d2a328880a3b7e4b28dbedf675e2fc4eec3045,0,Mike Percy,2018-03-24 03:03:58+00:00,['38a5c49f66d6a7b3ac2f0b19c58b79a7192d9597'],11,252,263,1254712,5,0.131578947,0.131578947,0.868421053,2177
56a86481fde6c18b4cc1f0d802534f50947b2329,0,Todd Lipcon,2018-03-26 16:33:48+00:00,['f2d2a328880a3b7e4b28dbedf675e2fc4eec3045'],0,10,10,1254722,3,0,1,1,2177
a781710264da43a1938aff2fffd112342efd41c9,0,Alexey Serbin,2018-03-26 23:09:27+00:00,['56a86481fde6c18b4cc1f0d802534f50947b2329'],14,31,45,1254767,1,,,,2177
8728dfc680d60f3482938f8c2876cc53301aab58,0,Will Berkeley,2018-03-27 17:18:01+00:00,['a781710264da43a1938aff2fffd112342efd41c9'],0,48,48,1254815,1,,,,2177
43bc1abe282c5cab5b6e9956b0cae98750ec7cd3,0,Will Berkeley,2018-03-27 17:18:10+00:00,['8728dfc680d60f3482938f8c2876cc53301aab58'],17,17,34,1254849,2,,,,2177
12ae13b03596e4dc3dee21cd86ae59c905c5fff2,0,Adar Dembo,2018-03-27 19:17:55+00:00,['43bc1abe282c5cab5b6e9956b0cae98750ec7cd3'],23,0,23,1254872,5,1,0,0,2177
17aceda39d486a8f3ed6ddf5ae0e32611154a5ef,0,Adar Dembo,2018-03-27 19:25:42+00:00,['12ae13b03596e4dc3dee21cd86ae59c905c5fff2'],1,8,9,1254881,2,,,,2177
fc833ca729f255a182cf2ca0cd63b54eac98f582,0,Grant Henke,2018-03-27 21:23:45+00:00,['17aceda39d486a8f3ed6ddf5ae0e32611154a5ef'],0,16,16,1254897,1,,,,2177
aa94d16fda6cd6f3f413decf46bf9353680480c7,1,Todd Lipcon,2018-03-27 23:16:48+00:00,['fc833ca729f255a182cf2ca0cd63b54eac98f582'],4,38,42,1254939,3,0,0,1,2177
d364f01b5eea438c04e7b4cdf8c4b99e79c3fa77,1,Grant Henke,2018-03-28 04:39:53+00:00,['aa94d16fda6cd6f3f413decf46bf9353680480c7'],220,219,439,1255378,2,,,,2177
6a323db4681ae350edbabbe130e35ccd338817dc,0,Grant Henke,2018-03-28 17:21:50+00:00,['d364f01b5eea438c04e7b4cdf8c4b99e79c3fa77'],14,15,29,1255407,6,,,,2177
f7ab95e7d70faa07a64e73d9d0bda367e9d4fafc,0,Todd Lipcon,2018-03-28 20:39:10+00:00,['6a323db4681ae350edbabbe130e35ccd338817dc'],1,1,2,1255409,1,,,,2177
9bf32a42486bdb4f97834737283c30129ffe71a6,0,Will Berkeley,2018-03-28 21:42:38+00:00,['f7ab95e7d70faa07a64e73d9d0bda367e9d4fafc'],49,49,98,1255507,5,,,,2177
32d276e08fe7bf7a0e68236e01312813b68d0eee,0,Will Berkeley,2018-03-28 21:42:51+00:00,['9bf32a42486bdb4f97834737283c30129ffe71a6'],151,149,300,1255807,4,0,1,1,2177
c83f6eb35da5708e893ed4dc1540c01da074ea08,0,Will Berkeley,2018-03-28 14:49:39-07:00,"['32d276e08fe7bf7a0e68236e01312813b68d0eee', '7545deccb8e12effa17a955ab5b841bdcc5afe85']",0,1209,1209,1257016,17,,,,2177
030a4d330ead310adc2d66cde6af11cc334a175f,1,Will Berkeley,2018-03-29 08:28:38+00:00,['c83f6eb35da5708e893ed4dc1540c01da074ea08'],4,138,142,1257158,5,0,0.425287356,1,2177
61d3fff2fd93358b6c71aaec14189bf7f55de99a,0,Todd Lipcon,2018-03-29 16:57:04+00:00,['030a4d330ead310adc2d66cde6af11cc334a175f'],86,82,168,1257326,13,1,1,1,2177
bae6170c77e12b45c83cea3ef15d8047029f47db,0,Todd Lipcon,2018-03-30 01:29:39+00:00,['61d3fff2fd93358b6c71aaec14189bf7f55de99a'],29,58,87,1257413,4,0.111111111,1,1,2177
5508ae7c7e81a026abd2786bd958de4774d56458,0,Todd Lipcon,2018-03-30 01:58:04+00:00,['bae6170c77e12b45c83cea3ef15d8047029f47db'],2,6,8,1257421,1,0,0,1,2177
b2b8fb74dc564b5e55af6406982e80f2efa19f3c,0,Todd Lipcon,2018-03-30 03:16:08+00:00,['5508ae7c7e81a026abd2786bd958de4774d56458'],98,140,238,1257659,8,1,1,0.380952381,2177
51e2ca40d17d34e953d188432afa1d4025d45b99,1,Todd Lipcon,2018-03-30 16:06:16+00:00,['b2b8fb74dc564b5e55af6406982e80f2efa19f3c'],16,24,40,1257699,5,0,1,1,2177
3634672e8381037d84bf516adbff6f6d62a226d1,0,Todd Lipcon,2018-03-30 16:07:40+00:00,['51e2ca40d17d34e953d188432afa1d4025d45b99'],6,30,36,1257735,1,0,0,1,2177
bfad4a610b964c6c028bf93987b4315916331de5,0,Todd Lipcon,2018-03-30 19:36:34+00:00,['3634672e8381037d84bf516adbff6f6d62a226d1'],1,30,31,1257766,2,,,,2178
e36a674481bc0bbbac6375024f25d7eeda8f3498,0,Todd Lipcon,2018-03-30 21:06:22+00:00,['bfad4a610b964c6c028bf93987b4315916331de5'],10,26,36,1257802,2,0,1,1,2178
4ebfbe4182d7b9ccbe0bed1b2a3746467c42f05f,0,Todd Lipcon,2018-03-30 21:06:44+00:00,['e36a674481bc0bbbac6375024f25d7eeda8f3498'],17,25,42,1257844,3,1,1,1,2178
ba955733d07dda66d4b1c9191966e8db12744762,0,Adar Dembo,2018-03-30 21:46:19+00:00,['4ebfbe4182d7b9ccbe0bed1b2a3746467c42f05f'],6,13,19,1257863,1,,,,2178
357ef6c9f736a77ae1cec786088adff4d8ac5091,0,Will Berkeley,2018-04-02 04:26:44+00:00,['ba955733d07dda66d4b1c9191966e8db12744762'],3,108,111,1257974,7,,,,2179
4db748f3021711a67017fe51f30097350f343101,0,Todd Lipcon,2018-04-02 05:04:29+00:00,['357ef6c9f736a77ae1cec786088adff4d8ac5091'],7,82,89,1258063,6,0.09375,0.8125,1,2179
fff4185e0f88954c67841a13b0924db4eab4c761,0,Dan Burkert,2018-04-02 21:39:49+00:00,['4db748f3021711a67017fe51f30097350f343101'],11,79,90,1258153,5,0.136363636,1,1,2179
96951f68f53fc44e97de99c2c7dfb036a59bd9fb,0,Dan Burkert,2018-04-02 22:07:03+00:00,['fff4185e0f88954c67841a13b0924db4eab4c761'],5,3,8,1258161,2,,,,2179
fe4d962c09012e779dd3746c2514df4f0ef70a9a,0,Dan Burkert,2018-04-02 22:59:36+00:00,['96951f68f53fc44e97de99c2c7dfb036a59bd9fb'],2,1111,1113,1259274,8,0.27755102,0.793877551,0.793877551,2182
0804136ab19d4902b0704906a0437b3a3eb35b5d,0,Will Berkeley,2018-04-03 00:06:15+00:00,['fe4d962c09012e779dd3746c2514df4f0ef70a9a'],106,145,251,1259525,4,,,,2183
cc8c5e3e8783c81f10233d531a361723fdceb3f9,0,Will Berkeley,2018-04-03 04:29:44+00:00,['0804136ab19d4902b0704906a0437b3a3eb35b5d'],42,99,141,1259666,4,0,0,1,2184
c3684b6e10ece50dd382d178e392a25e3130a86e,0,Will Berkeley,2018-04-03 04:30:29+00:00,['cc8c5e3e8783c81f10233d531a361723fdceb3f9'],115,290,405,1260071,5,0,0.644736842,0,2186
1a24020ecf60f4fa244679710bba80861a8b918b,0,Grant Henke,2018-04-03 17:32:48+00:00,['c3684b6e10ece50dd382d178e392a25e3130a86e'],114,0,114,1260185,1,0,0,0,2186
dbc943f7bf374f86ea5785dca98d7a3dfde39bbe,0,Grant Henke,2018-04-03 17:34:45+00:00,['1a24020ecf60f4fa244679710bba80861a8b918b'],9,8,17,1260202,1,,,,2186
613fe93e6048f34828660adf4d010c2e67398cf5,0,Grant Henke,2018-04-03 17:35:00+00:00,['dbc943f7bf374f86ea5785dca98d7a3dfde39bbe'],8,6,14,1260216,1,,,,2186
5fc31db007c805fc83db10220f5d051a7f200f8b,0,Grant Henke,2018-04-03 18:26:49+00:00,['613fe93e6048f34828660adf4d010c2e67398cf5'],13,9,22,1260238,5,,,,2186
02560c188f6b76714ee1908420e539f28bce99e8,0,Dan Burkert,2018-04-03 19:23:58+00:00,['5fc31db007c805fc83db10220f5d051a7f200f8b'],89,655,744,1260982,15,0.145772595,0.571428571,0.801749271,2187
9e918bf7766c2b4a4d36156891836b167a0563ff,0,Mike Percy,2018-04-03 19:45:49+00:00,['02560c188f6b76714ee1908420e539f28bce99e8'],9,9,18,1261000,5,,,,2187
de067f792afc051500a622b77d8c556511ae64f0,0,Dan Burkert,2018-04-03 23:00:47+00:00,['9e918bf7766c2b4a4d36156891836b167a0563ff'],1,2,3,1261003,1,,,,2187
161c25c41b2063518638dd5a64c62334054bf28d,0,Todd Lipcon,2018-04-03 23:59:51+00:00,['de067f792afc051500a622b77d8c556511ae64f0'],4,4,8,1261011,1,,,,2187
52b50b7a91c61925a7bc42992fe1001e74425d4d,0,Todd Lipcon,2018-04-04 00:21:27+00:00,['161c25c41b2063518638dd5a64c62334054bf28d'],2,23,25,1261036,1,1,1,1,2187
d7203522445d337aa01a32b8ca23b5aa081a2dec,0,Todd Lipcon,2018-04-04 00:22:00+00:00,['52b50b7a91c61925a7bc42992fe1001e74425d4d'],32,184,216,1261252,9,0.101851852,0.444444444,0.907407407,2187
725c6ce6391b42331e4ab4210ae4117779cba4a2,0,Todd Lipcon,2018-04-04 00:22:05+00:00,['d7203522445d337aa01a32b8ca23b5aa081a2dec'],41,186,227,1261479,7,0.14,0.88,0.89,2187
0402c33e95dec0607ad8d547d250e9dd4ce9fcaf,0,Todd Lipcon,2018-04-04 05:24:07+00:00,['725c6ce6391b42331e4ab4210ae4117779cba4a2'],3,3,6,1261485,1,,,,2187
c127477b52e9443bfc07c4c30f55b92b74713b1c,0,Todd Lipcon,2018-04-04 05:28:42+00:00,['0402c33e95dec0607ad8d547d250e9dd4ce9fcaf'],18,139,157,1261642,7,0.513888889,0,1,2187
b7e2a3601731ad74804c011b6659534911ca6c05,0,Todd Lipcon,2018-04-05 05:11:57+00:00,['c127477b52e9443bfc07c4c30f55b92b74713b1c'],2,4,6,1261648,1,1,1,1,2187
030630ac0043b73752d27b535c8b6497eb4ee5aa,0,Todd Lipcon,2018-04-05 05:15:10+00:00,['b7e2a3601731ad74804c011b6659534911ca6c05'],2,4,6,1261654,1,,,,2187
5360339df6d2e6e0a143dfab2ea971c91d3af143,0,Grant Henke,2018-04-05 14:04:24+00:00,['030630ac0043b73752d27b535c8b6497eb4ee5aa'],0,27,27,1261681,3,1,1,1,2187
7e35aee9626bf3370d9b1d89fd1f3440b47ff7a8,1,Will Berkeley,2018-04-05 18:20:27+00:00,['5360339df6d2e6e0a143dfab2ea971c91d3af143'],178,113,291,1261972,10,0,0,0,2187
165688f83bbb00a41090e909ae4e17c463fa75e4,0,Will Berkeley,2018-04-05 19:52:34+00:00,['7e35aee9626bf3370d9b1d89fd1f3440b47ff7a8'],44,147,191,1262163,4,0.714285714,0,0.387755102,2187
3d734055c2d9184fed3597dc7e08eed72c9a7ec7,0,Jean-Daniel Cryans,2018-04-05 20:16:18+00:00,['165688f83bbb00a41090e909ae4e17c463fa75e4'],1,5,6,1262169,1,,,,2187
91dd090518dceb15977b9294b3aec001825e68bc,0,Will Berkeley,2018-04-05 21:27:58+00:00,['3d734055c2d9184fed3597dc7e08eed72c9a7ec7'],115,402,517,1262686,8,0.598901099,1,0.917582418,2187
d1c99e02fd47662edf2784c22aa2e6b0264ab7a7,1,Will Berkeley,2018-04-05 21:28:08+00:00,['91dd090518dceb15977b9294b3aec001825e68bc'],9,494,503,1263189,14,0.199186992,0.735772358,0.947154472,2188
109fdc84e45523fdbd8b1ca29110965187b10323,0,Dan Burkert,2018-04-06 00:23:00+00:00,['d1c99e02fd47662edf2784c22aa2e6b0264ab7a7'],4,263,267,1263456,4,0,1,0.104545455,2188
15afb649521438ca85119bec799e39e9dd3afcb0,0,Adar Dembo,2018-04-06 19:56:00+00:00,['109fdc84e45523fdbd8b1ca29110965187b10323'],0,1,1,1263457,1,1,1,1,2188
3f194c3a17f11a70e64bf2668a96e1e93fed00df,0,Adar Dembo,2018-04-06 21:03:38+00:00,['15afb649521438ca85119bec799e39e9dd3afcb0'],28,31,59,1263516,7,1,0,0,2188
a95441846bb1381ff2543ffcddf3854184a111ea,1,Andrew Wong,2018-04-07 00:15:23+00:00,['3f194c3a17f11a70e64bf2668a96e1e93fed00df'],7,57,64,1263580,3,0.025641026,0.025641026,1,2188
13ea10485c966c8407574226652c3abad6ffeda3,0,Will Berkeley,2018-04-07 05:34:09+00:00,['a95441846bb1381ff2543ffcddf3854184a111ea'],1,1,2,1263582,1,,,,2188
337a731c47bbc58f320ca32fe50fea6722d01b94,0,Mike Percy,2018-04-09 19:06:47+00:00,['13ea10485c966c8407574226652c3abad6ffeda3'],12,13,25,1263607,3,1,1,1,2188
21f651db1c51d80c9ce2761e3d07aa1129d1faca,0,Will Berkeley,2018-04-10 18:44:49+00:00,['337a731c47bbc58f320ca32fe50fea6722d01b94'],14,273,287,1263894,11,0.045454545,0.840909091,0.840909091,2188
00c2754cae8bd58bf3fa61ea95da74eed4133149,0,Dan Burkert,2018-04-10 18:55:45+00:00,['21f651db1c51d80c9ce2761e3d07aa1129d1faca'],85,134,219,1264113,6,0,1,0.157894737,2188
702210106d42433a9c255f94b488f8d4bdd9986a,0,Will Berkeley,2018-04-10 19:46:29+00:00,['00c2754cae8bd58bf3fa61ea95da74eed4133149'],102,306,408,1264521,8,0,0.48502994,1,2188
d18be566aeda331bb7e28fe14f336e2ae95c3a53,0,Will Berkeley,2018-04-10 20:18:03+00:00,['702210106d42433a9c255f94b488f8d4bdd9986a'],20,107,127,1264648,3,0.484848485,0.484848485,1,2188
05bec2c1c0740ad6319d65cb5e4d5507e9b6c818,0,Adar Dembo,2018-04-10 20:52:46+00:00,['d18be566aeda331bb7e28fe14f336e2ae95c3a53'],4,5,9,1264657,1,1,0,0,2188
745ebab2f4fed88af72bce0c6e1b8a369abd4779,0,Alexey Serbin,2018-04-10 22:37:54+00:00,['05bec2c1c0740ad6319d65cb5e4d5507e9b6c818'],1,1,2,1264659,1,,,,2188
03d1fcb1467e4e29ead191d875a53e490f1d1372,0,Andrew Wong,2018-04-11 02:46:31+00:00,['745ebab2f4fed88af72bce0c6e1b8a369abd4779'],42,272,314,1264973,6,0.1,1,1,2188
c09a6296181ecbb7d91687536f70fdbaac9fff5e,0,Dan Burkert,2018-04-11 17:52:09+00:00,['03d1fcb1467e4e29ead191d875a53e490f1d1372'],6,7,13,1264986,2,,,,2188
8c8b16d4cf23c97c7861afea6f7604ea0a895673,1,Grant Henke,2018-04-11 17:53:34+00:00,['c09a6296181ecbb7d91687536f70fdbaac9fff5e'],257,320,577,1265563,2,,,,2188
f06a072e5f512814f02afdd531567e1063e2daea,0,Grant Henke,2018-04-11 20:35:33+00:00,['8c8b16d4cf23c97c7861afea6f7604ea0a895673'],5,4,9,1265572,4,,,,2188
70e1a9caa08cab94bd36f5ddc2817f28f6028ec8,0,Adar Dembo,2018-04-12 16:55:22+00:00,['f06a072e5f512814f02afdd531567e1063e2daea'],19,69,88,1265660,2,0,1,1,2188
133ef7e9dc469927a5b5e6ecec2cb24af91719ac,0,Grant Henke,2018-04-12 17:51:13+00:00,['70e1a9caa08cab94bd36f5ddc2817f28f6028ec8'],47,68,115,1265775,8,1,1,1,2188
361ee99f07cc5fa5219c384539eac3e4e003be08,0,Dan Burkert,2018-04-12 22:06:40+00:00,['133ef7e9dc469927a5b5e6ecec2cb24af91719ac'],18,31,49,1265824,3,0,1,1,2188
0d167529ae86463e3916e942930c4bedcd61817c,0,Grant Henke,2018-04-13 17:36:20+00:00,['361ee99f07cc5fa5219c384539eac3e4e003be08'],1,1,2,1265826,1,,,,2188
0ddb860d0f331fa79617ae192b62cae6c653c3a9,1,Grant Henke,2018-04-13 18:33:02+00:00,['0d167529ae86463e3916e942930c4bedcd61817c'],18,72,90,1265916,9,,,,2189
3aa1070eef3bf981b87084c2a9ea91ca881829f6,0,Todd Lipcon,2018-04-13 19:53:59+00:00,['0ddb860d0f331fa79617ae192b62cae6c653c3a9'],0,9,9,1265925,1,,,,2189
5df9c9e0f50537f7ba73424469b3c6f1af37acdb,0,Todd Lipcon,2018-04-13 19:54:01+00:00,['3aa1070eef3bf981b87084c2a9ea91ca881829f6'],1,19,20,1265945,1,0,1,1,2189
e0e6d5a3074aed1f45be402840f9aa93695649ae,0,Todd Lipcon,2018-04-13 22:55:33+00:00,['5df9c9e0f50537f7ba73424469b3c6f1af37acdb'],26,38,64,1266009,1,,,,2189
baa1e677fd858a2be17a316fd768746a8e076f88,0,Todd Lipcon,2018-04-14 01:00:35+00:00,['c260a32504e15a196665e6cf087774434fb5bc56'],1,10,11,1266031,1,0,0,1,2189
62a82964724642afd51f0dbdf5b0d732489e52f9,0,Grant Henke,2018-04-16 22:08:16+00:00,['baa1e677fd858a2be17a316fd768746a8e076f88'],7,1,8,1266039,2,,,,2189
b8cf59a2fe10aa218a4ab5b210e64cb839f3bf48,0,Dan Burkert,2018-04-16 22:22:11+00:00,['62a82964724642afd51f0dbdf5b0d732489e52f9'],2,2,4,1266043,1,,,,2189
a9bc168f81f7fbd628569e1d0b5e0124399882f7,0,Will Berkeley,2018-04-16 23:12:25+00:00,['b8cf59a2fe10aa218a4ab5b210e64cb839f3bf48'],0,17,17,1266060,1,,,,2189
f3913658cf7a65668f2f9592122190aa0b093751,0,Todd Lipcon,2018-04-17 17:16:59+00:00,['a9bc168f81f7fbd628569e1d0b5e0124399882f7'],9,23,32,1266092,1,0,1,1,2189
35940a12aa38dedeff7e932f91448d2562163302,1,Todd Lipcon,2018-04-17 19:29:10+00:00,['f3913658cf7a65668f2f9592122190aa0b093751'],44,92,136,1266228,8,0,1,1,2189
344fea89bab882f5b685ecf9b690516906676178,0,Todd Lipcon,2018-04-17 20:04:40+00:00,['35940a12aa38dedeff7e932f91448d2562163302'],0,2,2,1266230,1,,,,2189
8478f026e99e12ca53f519935d3a777a46f02cf3,0,Grant Henke,2018-04-17 20:25:27+00:00,['344fea89bab882f5b685ecf9b690516906676178'],49,52,101,1266331,3,,,,2189
bba339b11795d84da9c9d1473366ca561730c141,0,Todd Lipcon,2018-04-18 02:07:03+00:00,['8478f026e99e12ca53f519935d3a777a46f02cf3'],141,271,412,1266743,14,0.769230769,1,1,2192
bf835b0ea8fd28b083edb773c66217b2e0842985,0,Todd Lipcon,2018-04-18 21:36:13+00:00,['bba339b11795d84da9c9d1473366ca561730c141'],1,1,2,1266745,1,,,,2192
c25b7cbd8d2c2746effc4b6866ea5764bcdef157,0,Dan Burkert,2018-04-18 23:32:00+00:00,['bf835b0ea8fd28b083edb773c66217b2e0842985'],26,237,263,1267008,6,0,0.782608696,0,2193
6321615289c4dd35eeb0ca85b74bf6be778251aa,0,Todd Lipcon,2018-04-18 23:50:58+00:00,['c25b7cbd8d2c2746effc4b6866ea5764bcdef157'],10,22,32,1267040,1,0.333333333,0.333333333,0.333333333,2193
b87b026fafd9390eb573d489d28edaea1f4386b3,0,Todd Lipcon,2018-04-18 23:51:02+00:00,['6321615289c4dd35eeb0ca85b74bf6be778251aa'],0,2232,2232,1269272,2,0.302702703,0.238918919,0.677837838,2194
a9271b05d1de4d922ce9c1bc40dc2baa5e4c7f7a,0,Todd Lipcon,2018-04-18 23:51:38+00:00,['b87b026fafd9390eb573d489d28edaea1f4386b3'],14,35,49,1269321,1,0,0.133333333,1,2194
abbde75e12f2275e1a286df60d788e9c5b411bcb,0,Grant Henke,2018-04-19 19:41:23+00:00,['a9271b05d1de4d922ce9c1bc40dc2baa5e4c7f7a'],64,51,115,1269436,25,,,,2194
1f380f27960021b267766fcefb6764e95e1d98dc,1,Dan Burkert,2018-04-19 20:07:16+00:00,['abbde75e12f2275e1a286df60d788e9c5b411bcb'],5,138,143,1269579,5,0.088235294,0.867647059,0.867647059,2195
e6061b205415ad77160ad2e2bb934f62e1f1607c,0,Grant Henke,2018-04-19 20:47:04+00:00,['1f380f27960021b267766fcefb6764e95e1d98dc'],2,2,4,1269583,1,,,,2195
934e343288836025d8bb571d27d7f33130e4e5b4,0,Grant Henke,2018-04-20 03:49:11+00:00,['e6061b205415ad77160ad2e2bb934f62e1f1607c'],41,55,96,1269679,14,,,,2195
767005c5760f5664e8c2ac8508ad3181fe7a27ca,0,Alexey Serbin,2018-04-20 04:36:38+00:00,['934e343288836025d8bb571d27d7f33130e4e5b4'],72,28,100,1269779,65,,,,2195
b463969044c8d0b434650ff7540026d0011b7fe2,0,Todd Lipcon,2018-04-20 05:16:34+00:00,['767005c5760f5664e8c2ac8508ad3181fe7a27ca'],254,416,670,1270449,11,0.40625,0.9,0.95,2197
953a7070f6a743410f9b8dc74e85b66023d8ab56,0,Alexey Serbin,2018-04-20 05:52:05+00:00,['b463969044c8d0b434650ff7540026d0011b7fe2'],23,42,65,1270514,8,1,1,1,2197
f9d0afb76291c0791c99c7bcbe21cdb260ac1786,0,Todd Lipcon,2018-04-20 18:32:48+00:00,['953a7070f6a743410f9b8dc74e85b66023d8ab56'],0,6,6,1270520,1,0,0,1,2197
3a801d10438d7e247bf21c4923d46f386c4aa965,0,Grant Henke,2018-04-20 22:07:32+00:00,['f9d0afb76291c0791c99c7bcbe21cdb260ac1786'],34,127,161,1270681,10,0.135135135,0.135135135,1,2198
650e39e234142c69d4ff7adc56ad6359b790741b,1,Grant Henke,2018-04-23 16:18:47+00:00,['3a801d10438d7e247bf21c4923d46f386c4aa965'],3,71,74,1270755,8,,,,2198
08b01ecf30e257f822bdb318424c2288cf693b96,0,Grant Henke,2018-04-23 18:14:55+00:00,['650e39e234142c69d4ff7adc56ad6359b790741b'],51,59,110,1270865,5,1,1,0,2199
28d847513c1f435a114931c0c3cb51450ad42762,0,Grant Henke,2018-04-23 19:39:24+00:00,['08b01ecf30e257f822bdb318424c2288cf693b96'],22,18,40,1270905,5,,,,2199
90c1e1c26bbad4c402b575562504b41aa3bd4b7f,0,Grant Henke,2018-04-23 21:11:42+00:00,['28d847513c1f435a114931c0c3cb51450ad42762'],17,20,37,1270942,1,,,,2199
b69f288e9ee67df97cd16eb838425f82ff080762,1,Todd Lipcon,2018-04-23 21:44:35+00:00,['90c1e1c26bbad4c402b575562504b41aa3bd4b7f'],314,344,658,1271600,95,0.2,0.733333333,0.2,2199
4b75386342c05fe43df69924f04e05c435f685d0,0,Todd Lipcon,2018-04-23 22:41:20+00:00,['b69f288e9ee67df97cd16eb838425f82ff080762'],16,15,31,1271631,2,0,0,0,2199
1a3911c2e832056c61faaffb353488902244a1f9,0,Todd Lipcon,2018-04-23 22:43:40+00:00,['4b75386342c05fe43df69924f04e05c435f685d0'],0,22,22,1271653,3,0.571428571,1,1,2199
7f04873975d73bb335e09ee2a9bbbb9fd4b0cd89,0,Grant Henke,2018-04-24 00:47:03+00:00,['1a3911c2e832056c61faaffb353488902244a1f9'],70,166,236,1271889,20,,,,2199
9f70f766152b9b84b28d51938ab8b187dd1572eb,0,Todd Lipcon,2018-04-24 00:55:04+00:00,['7f04873975d73bb335e09ee2a9bbbb9fd4b0cd89'],1,1,2,1271891,1,,,,2199
281ed6525261a88e0d6806af63c5a12b07e6418d,0,Todd Lipcon,2018-04-24 00:55:43+00:00,['9f70f766152b9b84b28d51938ab8b187dd1572eb'],9,67,76,1271967,4,0,0.757575758,0.787878788,2199
9278580018dd2934845ac0afd26b65a80ef31c99,0,Todd Lipcon,2018-04-24 05:38:52+00:00,['281ed6525261a88e0d6806af63c5a12b07e6418d'],526,0,526,1272493,6,0.709090909,0.281818182,0.290909091,2199
b17798b5b5054ff6b7147048a234fffdc80942a2,0,Todd Lipcon,2018-04-24 05:39:49+00:00,['9278580018dd2934845ac0afd26b65a80ef31c99'],87,92,179,1272672,3,1,1,1,2199
a6280bc5a1091d421c612e1eeb3de4ab733abfb7,0,Todd Lipcon,2018-04-24 05:40:33+00:00,['b17798b5b5054ff6b7147048a234fffdc80942a2'],29,65,94,1272766,3,0,0,0,2199
138284eda4ff098e6e62ae5e6ff45fc4334a1c75,0,Todd Lipcon,2018-04-24 16:43:47+00:00,['a6280bc5a1091d421c612e1eeb3de4ab733abfb7'],14,24,38,1272804,2,0.222222222,0,1,2199
11127ebfa8a54f1cb56ffcb03d986e3515c27a43,0,Todd Lipcon,2018-04-24 16:43:52+00:00,['138284eda4ff098e6e62ae5e6ff45fc4334a1c75'],1,44,45,1272849,1,1,1,1,2199
c4b8804ac16ebfe373efa33f82d86a0e3d677e72,0,Todd Lipcon,2018-04-24 16:44:21+00:00,['11127ebfa8a54f1cb56ffcb03d986e3515c27a43'],1,1,2,1272851,1,,,,2199
72847ab5607b64d64bbe43edd942889e4e9f9fbf,0,Alexey Serbin,2018-04-24 19:59:42+00:00,['c4b8804ac16ebfe373efa33f82d86a0e3d677e72'],5,19,24,1272875,2,0,0,1,2199
1f379d7af8aa833c54885f02a68b55eb0065c378,0,Alexey Serbin,2018-04-25 02:29:26+00:00,['72847ab5607b64d64bbe43edd942889e4e9f9fbf'],37,43,80,1272955,8,1,0,1,2199
fc47272c7fac31c32178d71bfa5bf732d95b7f13,0,Grant Henke,2018-04-25 02:57:41+00:00,['1f379d7af8aa833c54885f02a68b55eb0065c378'],0,1,1,1272956,1,,,,2199
7bd582ab78afebc1f338900b5e2ccf3e97fb3c66,0,Grant Henke,2018-04-25 17:52:50+00:00,['fc47272c7fac31c32178d71bfa5bf732d95b7f13'],1,22,23,1272979,2,0,0.947368421,1,2199
e8fefd5e421dadc1e69a558ecd5c67d4296f82f8,0,Will Berkeley,2018-04-25 21:15:31+00:00,['7bd582ab78afebc1f338900b5e2ccf3e97fb3c66'],0,51,51,1273030,1,,,,2199
7f8187d13cb7294de74ebd918ee99c81df64c69f,0,Todd Lipcon,2018-04-26 00:50:11+00:00,['e8fefd5e421dadc1e69a558ecd5c67d4296f82f8'],0,192,192,1273222,2,0.38961039,1,1,2200
2ba52a115097a8d870abdd910ca9a1e9c9b59f1d,0,Grant Henke,2018-04-26 01:41:53+00:00,['7f8187d13cb7294de74ebd918ee99c81df64c69f'],12,16,28,1273250,3,,,,2200
09ec62ca6801819c9a18841ab7e8a78294cf835c,0,Will Berkeley,2018-04-26 17:47:36+00:00,['2ba52a115097a8d870abdd910ca9a1e9c9b59f1d'],8,0,8,1273258,1,,,,2200
1bf0e2a2e9971a7da97dda68a86314c34c1f5dda,0,Will Berkeley,2018-04-26 18:23:01+00:00,['09ec62ca6801819c9a18841ab7e8a78294cf835c'],20,65,85,1273343,1,,,,2200
c55ddd9bc85094c5f780427c3fc82b2219015d24,0,Todd Lipcon,2018-04-26 22:18:10+00:00,['1bf0e2a2e9971a7da97dda68a86314c34c1f5dda'],0,19,19,1273362,3,,,,2200
597b907f8ef468cb17e75d76c1a1a77a82491bae,0,Todd Lipcon,2018-04-26 22:18:15+00:00,['c55ddd9bc85094c5f780427c3fc82b2219015d24'],0,46,46,1273408,16,0,0.866666667,0.866666667,2200
4969989fd0cc02c26993c6a897bd274833800a5c,0,Todd Lipcon,2018-04-26 22:18:20+00:00,['597b907f8ef468cb17e75d76c1a1a77a82491bae'],5,5,10,1273418,1,0,0,1,2200
7a2c7e3a9158994eb2f2749813fc53ea2363b694,0,Todd Lipcon,2018-04-26 22:19:00+00:00,['4969989fd0cc02c26993c6a897bd274833800a5c'],11,11,22,1273440,8,,,,2200
8d7e3056bdeee183b2aaf6ad067ef2e29eee0c33,0,Todd Lipcon,2018-04-26 22:19:46+00:00,['7a2c7e3a9158994eb2f2749813fc53ea2363b694'],5,5,10,1273450,4,,,,2200
ed2758d977502d54f84e3704f0dac56cb4171d46,0,Todd Lipcon,2018-04-26 22:20:38+00:00,['8d7e3056bdeee183b2aaf6ad067ef2e29eee0c33'],32,9,41,1273491,6,0,0,0,2200
4b91889f4a5c945991c89bc3d75b926bde189618,0,Todd Lipcon,2018-04-26 22:20:43+00:00,['ed2758d977502d54f84e3704f0dac56cb4171d46'],23,30,53,1273544,8,0,0,1,2200
c5521d99b574f270d0a97bc082a177259c9f2f54,1,Todd Lipcon,2018-04-26 22:21:17+00:00,['4b91889f4a5c945991c89bc3d75b926bde189618'],30,27,57,1273601,11,0,0,0,2200
6a32001c25527586ba5ba0bf71abdf6b14743f32,0,Todd Lipcon,2018-04-26 22:22:20+00:00,['c5521d99b574f270d0a97bc082a177259c9f2f54'],1,1,2,1273603,1,,,,2200
3ee87a00fb4516bc5db298d8acb7cb7e9c15fb4c,0,Todd Lipcon,2018-04-26 22:24:13+00:00,['6a32001c25527586ba5ba0bf71abdf6b14743f32'],8,12,20,1273623,5,,,,2200
d52fc396af5b15868e8d00bafb2cf626a0813993,0,Will Berkeley,2018-04-27 04:12:41+00:00,['3ee87a00fb4516bc5db298d8acb7cb7e9c15fb4c'],1,1,2,1273625,1,,,,2200
bf9e305781c4c13c1a9ccc65a38267f6339c750c,0,Will Berkeley,2018-04-27 04:12:43+00:00,['d52fc396af5b15868e8d00bafb2cf626a0813993'],1,5,6,1273631,1,0,0,1,2200
08287b032278adf53e9d954d8f308bfa6b5a126f,0,Grant Henke,2018-04-27 16:28:57+00:00,['bf9e305781c4c13c1a9ccc65a38267f6339c750c'],30,56,86,1273717,4,,,,2201
64d6d38ba101b08506677ca0e8c2ffafec0b1459,0,Todd Lipcon,2018-04-27 19:59:23+00:00,['08287b032278adf53e9d954d8f308bfa6b5a126f'],4,65,69,1273786,3,0.933333333,1,1,2201
0aa220303276af8979448507c74e3e2820db6fbc,0,Todd Lipcon,2018-04-27 19:59:30+00:00,['64d6d38ba101b08506677ca0e8c2ffafec0b1459'],12,11,23,1273809,1,1,1,1,2201
f8517483935358aa6f7cf21b11717102476ab87d,0,Todd Lipcon,2018-04-27 21:55:59+00:00,['0aa220303276af8979448507c74e3e2820db6fbc'],9,10,19,1273828,3,,,,2201
eef20da6506efabd8874f554e45b2477f3c8096c,0,Alexey Serbin,2018-04-30 15:29:48+00:00,['f8517483935358aa6f7cf21b11717102476ab87d'],1,1,2,1273830,1,,,,2201
60acdb99667f112894365ae24b65c247ed950f4a,1,Todd Lipcon,2018-04-30 18:12:44+00:00,['eef20da6506efabd8874f554e45b2477f3c8096c'],2,56,58,1273888,2,,,,2202
9173015808074c6f771d08be25812446f6a87d48,0,Todd Lipcon,2018-04-30 18:58:22+00:00,['60acdb99667f112894365ae24b65c247ed950f4a'],3,5,8,1273896,1,,,,2202
3bf125f469a2929f7fe20e4e31f073376f37575d,0,Grant Henke,2018-04-30 19:58:11+00:00,['9173015808074c6f771d08be25812446f6a87d48'],10,93,103,1273999,5,1,1,1,2202
3adac3160039b5cc5d60cba17ee134aa6c1c23cc,1,Todd Lipcon,2018-04-30 20:55:35+00:00,['3bf125f469a2929f7fe20e4e31f073376f37575d'],54,100,154,1274153,9,1,0.714285714,1,2202
eac9d172de571e72d0a2652f891dfe9e43c373aa,0,Todd Lipcon,2018-04-30 20:56:02+00:00,['3adac3160039b5cc5d60cba17ee134aa6c1c23cc'],5,5,10,1274163,5,,,,2202
69fb524c413ee39f87e8a908171274ba9727e194,0,Todd Lipcon,2018-04-30 20:56:51+00:00,['eac9d172de571e72d0a2652f891dfe9e43c373aa'],5,16,21,1274184,4,1,1,1,2202
235998b6e41cd6074c6007c0af4f9cc7fbe4e2d2,0,Alexey Serbin,2018-04-30 22:52:53+00:00,['69fb524c413ee39f87e8a908171274ba9727e194'],2,6,8,1274192,1,0,0,1,2202
0355d373a744b0109f56058cefc0c6dd0f862044,1,Will Berkeley,2018-05-01 18:04:42+00:00,['235998b6e41cd6074c6007c0af4f9cc7fbe4e2d2'],875,1191,2066,1276258,10,0.885714286,1,0,2204
7201b0635a448cd244dc598158b13226f14aa0fb,0,Will Berkeley,2018-05-02 05:29:41+00:00,['0355d373a744b0109f56058cefc0c6dd0f862044'],0,11,11,1276269,2,0.2,0.2,1,2204
e45fbd1b038a27df7dde866e8b992c030d2471b6,0,Will Berkeley,2018-05-02 18:50:19+00:00,['7201b0635a448cd244dc598158b13226f14aa0fb'],1,5,6,1276275,1,,,,2204
610b1aefbce3fc8f727043f31b49d618cc86be03,0,Alexey Serbin,2018-05-03 16:11:50+00:00,['e45fbd1b038a27df7dde866e8b992c030d2471b6'],9,11,20,1276295,1,,,,2204
96fa805030f859fd0d8d25243191534222163eb5,0,Grant Henke,2018-05-03 16:49:20+00:00,['610b1aefbce3fc8f727043f31b49d618cc86be03'],47,68,115,1276410,18,0.125,1,1,2204
eded05723e6166b676074c5a548ac1278c7c4401,1,Dan Burkert,2018-05-03 16:52:50+00:00,['96fa805030f859fd0d8d25243191534222163eb5'],70,88,158,1276568,9,1,0.5,0.5,2204
d19844f33817c511476746b7a7ec07e6826d52a0,0,Todd Lipcon,2018-05-03 18:05:27+00:00,['eded05723e6166b676074c5a548ac1278c7c4401'],217,23,240,1276808,2,1,0.992248062,1,2204
7767679a6643743e6db672e68d61b3a0eb70bdca,0,Mike Percy,2018-05-03 20:17:47+00:00,['d19844f33817c511476746b7a7ec07e6826d52a0'],16,53,69,1276877,5,0.133333333,0.733333333,0.733333333,2204
f54dbb89183db5559f7dcf76e86239e127f7f023,0,Dan Burkert,2018-05-03 20:31:04+00:00,['7767679a6643743e6db672e68d61b3a0eb70bdca'],37,125,162,1277039,8,0,0,0.916666667,2204
06afa8f04a8df5563935344a8127ff6a2cd60f8c,0,Adar Dembo,2018-05-03 21:39:28+00:00,['f54dbb89183db5559f7dcf76e86239e127f7f023'],0,29,29,1277068,1,,,,2204
ff4b67e3b72f08d0e77d1803027ebaad965f6403,0,Grant Henke,2018-05-03 21:40:58+00:00,['06afa8f04a8df5563935344a8127ff6a2cd60f8c'],0,6,6,1277074,1,1,1,1,2204
eb4d88f0a376b13294c8985d76b3114eaa2e84ca,0,Dan Burkert,2018-05-03 21:43:01+00:00,['ff4b67e3b72f08d0e77d1803027ebaad965f6403'],325,248,573,1277647,27,0.516666667,0,0,2204
297b72bd26cdd546f0a73cda7487c80566388492,0,Will Berkeley,2018-05-03 22:49:54+00:00,['eb4d88f0a376b13294c8985d76b3114eaa2e84ca'],10,76,86,1277733,6,0.814814815,1,1,2204
ea286417afeb4109ea7db6a2bdc4ce9dbcaebdf7,0,Todd Lipcon,2018-05-04 15:15:34+00:00,['297b72bd26cdd546f0a73cda7487c80566388492'],0,23,23,1277756,1,0.272727273,1,1,2204
0061f32d157dacd0cc1e6af341d6d5bf1e82378c,0,Todd Lipcon,2018-05-04 15:16:03+00:00,['ea286417afeb4109ea7db6a2bdc4ce9dbcaebdf7'],2,6,8,1277764,1,0,0,1,2204
8e11defa118d88551ad4b8837f73c9ca01f6907f,0,Alexey Serbin,2018-05-04 19:44:09+00:00,['0061f32d157dacd0cc1e6af341d6d5bf1e82378c'],1,8,9,1277773,1,,,,2204
53d1b2807b1f8c3eb08d5193684b77791388bf56,0,Grant Henke,2018-05-07 04:48:48+00:00,['8e11defa118d88551ad4b8837f73c9ca01f6907f'],11,24,35,1277808,3,,,,2204
1fe10eb38978c71b7dc0aad3925faa7951025f3a,0,Grant Henke,2018-05-07 16:05:42+00:00,['53d1b2807b1f8c3eb08d5193684b77791388bf56'],12,18,30,1277838,1,,,,2204
9ad7cf3e5a510a8b5103b51d123e931d7b7d6767,0,Grant Henke,2018-05-07 16:06:01+00:00,['1fe10eb38978c71b7dc0aad3925faa7951025f3a'],1,1,2,1277840,1,,,,2204
3f07d059246579950b0584bfaf7394898b8cdf6c,0,Grant Henke,2018-05-07 19:57:27+00:00,['9ad7cf3e5a510a8b5103b51d123e931d7b7d6767'],8,9,17,1277857,1,1,1,1,2204
8cd7c05b62483a7cf9481f5ae117f9d4e79cc61d,0,Grant Henke,2018-05-07 20:24:48+00:00,['3f07d059246579950b0584bfaf7394898b8cdf6c'],17,98,115,1277972,2,0,1,0.772727273,2204
3d344ecefee7764955dca186e2624357faab69af,0,Grant Henke,2018-05-07 21:00:04+00:00,['8cd7c05b62483a7cf9481f5ae117f9d4e79cc61d'],1,5,6,1277978,1,,,,2204
17b443fa005ae17d2c493b198e10bb876e493343,0,Todd Lipcon,2018-05-08 15:22:58+00:00,['3d344ecefee7764955dca186e2624357faab69af'],13,9,22,1278000,2,1,0,0,2204
e7ee667868af798015936cad94173d9779d6b470,0,Mike Percy,2018-05-08 16:42:35+00:00,['17b443fa005ae17d2c493b198e10bb876e493343'],54,81,135,1278135,6,0.705882353,1,0.941176471,2204
fcb71942daaef4c8bdd60366d6c7a2930fdad116,0,Will Berkeley,2018-05-08 17:23:42+00:00,['e7ee667868af798015936cad94173d9779d6b470'],7,44,51,1278186,3,0.516129032,1,0.580645161,2204
34421f567a3797acdc22203a81e2956fc946f1a9,0,Mike Percy,2018-05-08 19:22:48+00:00,['fcb71942daaef4c8bdd60366d6c7a2930fdad116'],1,4,5,1278191,1,,,,2204
d83cd11a9ae6b6038190244e8882f090d650aebf,0,Grant Henke,2018-05-08 20:28:03+00:00,['34421f567a3797acdc22203a81e2956fc946f1a9'],1,48,49,1278240,2,1,1,1,2205
60c8e305bef9ace8688aabbf18e2f500e8d9135c,0,Dan Burkert,2018-05-09 16:50:08+00:00,['d83cd11a9ae6b6038190244e8882f090d650aebf'],1,10,11,1278251,1,0,1,1,2205
38b0c8f27022801957ac30018aefabe447bb3410,0,Hao Hao,2018-05-09 18:19:42+00:00,['60c8e305bef9ace8688aabbf18e2f500e8d9135c'],5,58,63,1278314,2,0.317073171,1,1,2205
26af97c8f28d3953e7506cf96ef3991d7eee6734,0,Mike Percy,2018-05-09 20:38:49+00:00,['38b0c8f27022801957ac30018aefabe447bb3410'],8,8,16,1278330,1,,,,2205
3f43c03a1e4130cde6556a298ad8bb3f32897993,0,Alexey Serbin,2018-05-10 19:05:50+00:00,['26af97c8f28d3953e7506cf96ef3991d7eee6734'],42,50,92,1278422,10,0,0,,2205
525943fd189acc20a3199f84431d62a776dd8f30,0,Will Berkeley,2018-05-10 20:07:41+00:00,['3f43c03a1e4130cde6556a298ad8bb3f32897993'],6,24,30,1278452,5,0,0.666666667,0.75,2205
07d6b5f2ba384e10288d5926af93933f0a74185d,0,David Ribeiro Alves,2018-05-10 22:38:23+00:00,['525943fd189acc20a3199f84431d62a776dd8f30'],2,13,15,1278467,1,1,1,1,2205
3855328b73c28d9ce4dbe5e1773bd6abde2e935a,0,Dan Burkert,2018-05-10 22:53:24+00:00,['07d6b5f2ba384e10288d5926af93933f0a74185d'],13,16,29,1278496,1,,,,2205
c18e7e1a6c811fc432ecc5f0bce66afc91bf4cce,0,Hao Hao,2018-05-10 23:24:02+00:00,['3855328b73c28d9ce4dbe5e1773bd6abde2e935a'],5,67,72,1278568,2,0.192307692,1,1,2205
72df429ecf95eaa01dee4743290395b650ec2ed4,0,Dan Burkert,2018-05-11 17:04:20+00:00,['c18e7e1a6c811fc432ecc5f0bce66afc91bf4cce'],1,0,1,1278569,1,,,,2205
ee0a75c5a22751241ff25c8f7b9c0a2654fbd767,0,Will Berkeley,2018-05-11 21:32:01+00:00,['72df429ecf95eaa01dee4743290395b650ec2ed4'],75,819,894,1279463,7,0.21,0.642,0.454,2205
ba0a8126fb95778a9964864b55fc189441393052,0,Hao Hao,2018-05-11 21:35:51+00:00,['ee0a75c5a22751241ff25c8f7b9c0a2654fbd767'],3,234,237,1279700,3,,,,2206
05d594867c6a442691274b9b9a402b804eca1516,0,Mike Percy,2018-05-11 23:25:27+00:00,['ba0a8126fb95778a9964864b55fc189441393052'],0,16,16,1279716,1,,,,2206
1a707b991785a5a7d4d316d721d813f49d0bb7e5,0,Dan Burkert,2018-05-14 18:35:12+00:00,['05d594867c6a442691274b9b9a402b804eca1516'],141,117,258,1279974,2,0.961538462,0.961538462,0.923076923,2206
a65e58ec0612e6c20757fa51fe4e37056d5a4815,0,Dan Burkert,2018-05-14 19:17:04+00:00,['1a707b991785a5a7d4d316d721d813f49d0bb7e5'],54,36,90,1280064,2,1,0.375,0.375,2206
ca3e387591d1947c24f9af814bb6429447902db5,0,Dan Burkert,2018-05-14 19:20:05+00:00,['a65e58ec0612e6c20757fa51fe4e37056d5a4815'],44,62,106,1280170,4,1,1,1,2206
5d113ec3c3a7296cc7a704bad415c74aab9f49fa,0,Dan Burkert,2018-05-14 19:44:24+00:00,['ca3e387591d1947c24f9af814bb6429447902db5'],19,19,38,1280208,3,,,,2206
61cd9510ff07229280499ec0155fb6ca6b46d510,0,Hao Hao,2018-05-14 22:35:01+00:00,['5d113ec3c3a7296cc7a704bad415c74aab9f49fa'],216,58,274,1280482,4,1,0.426829268,0.536585366,2206
93caf4473f2fb22fbb4cdc42d5f3b24f5d26f475,0,Alexey Serbin,2018-05-15 22:30:34+00:00,['61cd9510ff07229280499ec0155fb6ca6b46d510'],10,2,12,1280494,1,1,1,0.625,2206
eb81a04db9a9d3f9eaf5bc685d787bd4f908daea,0,Grant Henke,2018-05-16 02:42:22+00:00,['93caf4473f2fb22fbb4cdc42d5f3b24f5d26f475'],1,15,16,1280510,1,1,1,1,2206
caea85d501742a2bf2c4cfc74fead46167d7a5f3,0,Andrew Wong,2018-05-16 17:25:45+00:00,['eb81a04db9a9d3f9eaf5bc685d787bd4f908daea'],8,2,10,1280520,2,1,0.5,0.5,2206
0442d47d55282ad438ab6293646dfb34a8f01f86,0,Grant Henke,2018-05-16 17:35:13+00:00,['caea85d501742a2bf2c4cfc74fead46167d7a5f3'],7,49,56,1280576,7,0.956521739,1,0.826086957,2206
a587848f2dae241602da66abfaadb85e4c39a317,0,Grant Henke,2018-05-16 17:40:59+00:00,['0442d47d55282ad438ab6293646dfb34a8f01f86'],12,38,50,1280626,3,1,1,1,2206
da9f97e7fe492c7493f0c7e1027cb1e701002353,0,Grant Henke,2018-05-16 17:41:07+00:00,['a587848f2dae241602da66abfaadb85e4c39a317'],0,6,6,1280632,2,,,,2206
f57d73321897850acdbf0fbfaafc7ba3a8605a72,0,Adar Dembo,2018-05-17 03:22:19+00:00,['da9f97e7fe492c7493f0c7e1027cb1e701002353'],5,9,14,1280646,3,0,0,0,2206
5aca86284967770048da6440b54ce0daea2d18eb,0,Adar Dembo,2018-05-17 03:28:35+00:00,['f57d73321897850acdbf0fbfaafc7ba3a8605a72'],3,10,13,1280659,2,1,1,1,2206
ba3cdea53d005c65dd9baa36f5d139b571ed0ffb,0,Adar Dembo,2018-05-17 17:41:59+00:00,['5aca86284967770048da6440b54ce0daea2d18eb'],1,1,2,1280661,1,,,,2206
726dedacd1203cbefa20f82c9eba529a28f44013,0,Adar Dembo,2018-05-17 18:07:07+00:00,['ba3cdea53d005c65dd9baa36f5d139b571ed0ffb'],1,3,4,1280665,1,,,,2206
8489fa8168432461dcb3b3f3aa13a818426ed4d9,0,Adar Dembo,2018-05-17 18:07:31+00:00,['726dedacd1203cbefa20f82c9eba529a28f44013'],1,214,215,1280880,2,,,,2207
b621f9c1a3949dc31ca4836b0767b2840fa73f29,0,Adar Dembo,2018-05-17 18:08:13+00:00,['8489fa8168432461dcb3b3f3aa13a818426ed4d9'],6,33,39,1280919,1,,,,2207
cfff4bb180d3ef73725f9ae7bb46321ce1179f29,0,Mike Percy,2018-05-17 21:30:31+00:00,['b621f9c1a3949dc31ca4836b0767b2840fa73f29'],0,15,15,1280934,1,,,,2207
cb203729255dba06120d2a2f8702032a2ffd9694,0,Alexey Serbin,2018-05-18 02:41:30+00:00,['cfff4bb180d3ef73725f9ae7bb46321ce1179f29'],1,86,87,1281021,2,0.191780822,0.191780822,0.98630137,2207
1a7f8c78e7c632f810c2395db4922b6a55a9b96e,0,Adar Dembo,2018-05-18 02:51:24+00:00,['cb203729255dba06120d2a2f8702032a2ffd9694'],20,86,106,1281127,2,,,,2207
185781f6ced48f1b4a7216034285f772a1efb30b,0,Adar Dembo,2018-05-18 02:51:56+00:00,['1a7f8c78e7c632f810c2395db4922b6a55a9b96e'],1,1,2,1281129,1,,,,2207
8f525829dcfc49edea9fadbe7514db2ea64f2087,0,Will Berkeley,2018-05-18 21:23:08+00:00,['185781f6ced48f1b4a7216034285f772a1efb30b'],7,113,120,1281249,5,0.01754386,0.473684211,0.456140351,2207
10a7f2a9b32c7ed00c55322b27b61e6d46ef17bd,0,Hao Hao,2018-05-19 00:43:16+00:00,['8f525829dcfc49edea9fadbe7514db2ea64f2087'],59,775,834,1282083,26,0.162679426,0.839712919,0.600478469,2208
b73dec1e4975843a434cb84ab618aabedbfaa3b2,0,Alexey Serbin,2018-05-19 19:36:24+00:00,['10a7f2a9b32c7ed00c55322b27b61e6d46ef17bd'],15,28,43,1282126,1,0,0,1,2208
9de558c2ff0c53f9abb8940b7d9ce0e2befde051,0,Alexey Serbin,2018-05-19 19:50:40+00:00,['b73dec1e4975843a434cb84ab618aabedbfaa3b2'],0,47,47,1282173,2,0,0,1,2208
14080bb0f49b1fb0cc95f3f13c4e893ac9992252,1,Adar Dembo,2018-05-21 17:06:33+00:00,['9de558c2ff0c53f9abb8940b7d9ce0e2befde051'],25,124,149,1282322,11,1,0,1,2208
83f3a7e9347462c11bb6c3c6b58d91cf6dfc52ed,0,Andrew Wong,2018-05-21 23:14:24+00:00,['14080bb0f49b1fb0cc95f3f13c4e893ac9992252'],5,5,10,1282332,2,1,1,,2208
0e19cf77295224d001553b4070ccbe6929a4cd83,0,Will Berkeley,2018-05-22 16:32:06+00:00,['83f3a7e9347462c11bb6c3c6b58d91cf6dfc52ed'],180,256,436,1282768,4,1,1,0,2209
b7cf3b2e44f8ef560c67e901efc7c59a091ddefd,1,Adar Dembo,2018-05-23 23:16:48+00:00,['0e19cf77295224d001553b4070ccbe6929a4cd83'],138,253,391,1283159,15,0,0.688679245,0.820754717,2209
006937d3338caeab76cac4768eedf685106ee4d6,0,Andrew Wong,2018-05-23 23:18:34+00:00,['b7cf3b2e44f8ef560c67e901efc7c59a091ddefd'],142,267,409,1283568,7,0,0.934210526,1,2209
7c5d28849032116fb6861e5827d610aa0e4fe927,0,Andrew Wong,2018-05-24 06:40:19+00:00,['006937d3338caeab76cac4768eedf685106ee4d6'],1,19,20,1283588,3,0.25,0.5,1,2209
70fcb5ec7070d8cda1bffd9a79e7a2745195be6a,1,Will Berkeley,2018-05-24 20:07:18+00:00,['7c5d28849032116fb6861e5827d610aa0e4fe927'],0,12,12,1283600,1,,,,2209
2f61b72ca470eab9ee73f7c445582b50a9435ca7,0,Will Berkeley,2018-05-24 22:10:08+00:00,['70fcb5ec7070d8cda1bffd9a79e7a2745195be6a'],29,62,91,1283691,7,0,1,0.941176471,2209
e04fd4e4d935a062235d6f7451db0ce56773206a,0,Will Berkeley,2018-05-25 21:03:59+00:00,['2f61b72ca470eab9ee73f7c445582b50a9435ca7'],3,77,80,1283771,5,0.13559322,0.169491525,1,2209
98ef3c03b2c07cbbde69c039a0d04ad208358fc0,0,Will Berkeley,2018-05-25 21:36:31+00:00,['e04fd4e4d935a062235d6f7451db0ce56773206a'],9,42,51,1283822,5,0.761904762,1,1,2209
66e41bda1d628f11b4ae121fd2da63c78ba89c83,0,Will Berkeley,2018-05-29 17:11:50+00:00,['98ef3c03b2c07cbbde69c039a0d04ad208358fc0'],4,459,463,1284285,8,0.276450512,0.866894198,0.887372014,2209
6662a907b75b3731f5066ae1c2c6592e8197949f,0,Grant Henke,2018-05-29 21:31:13+00:00,['66e41bda1d628f11b4ae121fd2da63c78ba89c83'],2,6,8,1284293,2,,,,2209
e840ad7e914bcfaf188470e35634cbf4f477d148,0,Mike Percy,2018-05-29 23:06:20+00:00,['6662a907b75b3731f5066ae1c2c6592e8197949f'],9,9,18,1284311,3,,0,0,2209
f7d1f39dadd9c8bb76359169243c13b2073bc6c0,0,Dan Burkert,2018-05-30 22:04:42+00:00,['e840ad7e914bcfaf188470e35634cbf4f477d148'],0,12,12,1284323,1,,,,2209
d7af95bd1ffb62338c051343dece68e7d849a718,0,Adar Dembo,2018-05-30 22:41:40+00:00,['f7d1f39dadd9c8bb76359169243c13b2073bc6c0'],18,36,54,1284377,2,,,,2209
4883eeef5249f87f827c8193456b33cc506f5aa4,0,Hao Hao,2018-05-31 00:51:00+00:00,['d7af95bd1ffb62338c051343dece68e7d849a718'],1,0,1,1284378,1,1,0,1,2209
5f9a2f523a58990af63b1b6eaef16dfc35eabddd,0,Grant Henke,2018-05-31 15:54:01+00:00,['4883eeef5249f87f827c8193456b33cc506f5aa4'],104,304,408,1284786,13,0.726027397,1,0.904109589,2211
91881e2b5fdf853f3c1b76879ba3702e6460bf22,0,Will Berkeley,2018-06-01 21:12:50+00:00,['5f9a2f523a58990af63b1b6eaef16dfc35eabddd'],6,131,137,1284923,3,0.381578947,0.894736842,0.921052632,2211
46dd4cd4cb9a66b6b974460ef2565830481f886b,0,Will Berkeley,2018-06-05 01:08:52+00:00,['91881e2b5fdf853f3c1b76879ba3702e6460bf22'],9,118,127,1285050,7,0.1375,0.1375,0.725,2211
1c3cbb1c7d27bd659719a45c5904f1c06df65e45,0,Will Berkeley,2018-06-05 17:32:33+00:00,['46dd4cd4cb9a66b6b974460ef2565830481f886b'],2,58,60,1285110,1,0,1,1,2211
76bbdd4a0b6cdbbf6985504b3e6d0aa4b229b05a,0,Todd Lipcon,2018-06-05 17:33:14+00:00,['1c3cbb1c7d27bd659719a45c5904f1c06df65e45'],10,819,829,1285939,15,0.20984456,0.748704663,1,2217
d6bdcff48fef5d0982fe068997de188939c42f3d,0,Alexey Serbin,2018-06-06 02:09:19+00:00,['76bbdd4a0b6cdbbf6985504b3e6d0aa4b229b05a'],22,19,41,1285980,2,,,,2217
e82dc1e2a66c1cd84eda7395911c8e4aa8ada615,0,Grant Henke,2018-06-06 15:24:00+00:00,['d6bdcff48fef5d0982fe068997de188939c42f3d'],80,131,211,1286191,3,1,0.956521739,1,2218
8719014f2523671b33fde92c110f219107d14a99,0,Todd Lipcon,2018-06-06 19:17:31+00:00,['e82dc1e2a66c1cd84eda7395911c8e4aa8ada615'],25,84,109,1286300,6,0,0,0.787878788,2218
ccdcf6cea99d1b0fa0ba1106e793b31aa607ba06,0,Alexey Serbin,2018-06-07 04:09:18+00:00,['8719014f2523671b33fde92c110f219107d14a99'],0,1213,1213,1287513,4,0.045092838,0.75994695,0.842175066,2221
044c210de1c2a89d954e620a5543d9ef20d08283,0,Alexey Serbin,2018-06-07 05:41:23+00:00,['ccdcf6cea99d1b0fa0ba1106e793b31aa607ba06'],2,2,4,1287517,1,,,,2221
a0a61bd70f68ab303c1f87d3b5c113414d4144be,0,Alexey Serbin,2018-06-07 07:05:27+00:00,['044c210de1c2a89d954e620a5543d9ef20d08283'],2,94,96,1287613,2,0.12,0.346666667,1,2221
220cd66f22aab2c9b0696fb2333943ba7889eb6d,1,Alexey Serbin,2018-06-07 21:45:17+00:00,['a0a61bd70f68ab303c1f87d3b5c113414d4144be'],435,2595,3030,1290643,15,0.05734767,0.465053763,0.663082437,2226
dd71ddc3ef5e201378bd151d884c377c085a94fa,0,Grant Henke,2018-06-07 23:55:46+00:00,['220cd66f22aab2c9b0696fb2333943ba7889eb6d'],5,113,118,1290761,4,0.527777778,1,1,2226
a9a54ec94be852c6733dc533c517ce931458949d,0,Mike Percy,2018-06-09 01:01:56+00:00,['dd71ddc3ef5e201378bd151d884c377c085a94fa'],3,5,8,1290769,2,1,1,0,2226
112a60f37e07a96e1ab11c224dc6d58a9dc1cf76,0,Will Berkeley,2018-06-11 17:56:43+00:00,['a9a54ec94be852c6733dc533c517ce931458949d'],3,8,11,1290780,2,0,0,1,2226
382ee120620484cdc800a15bedbf59573b6606ac,0,Mike Percy,2018-06-11 19:28:46+00:00,['112a60f37e07a96e1ab11c224dc6d58a9dc1cf76'],38,139,177,1290957,5,0,0.964285714,0.964285714,2226
37f3a95d8e20ca73f34b21c9d3fe1c25e2e4f66d,1,Andrew Wong,2018-06-11 20:27:48+00:00,['382ee120620484cdc800a15bedbf59573b6606ac'],1,1,2,1290959,1,,,,2226
c1c15ad5fd6dd1d96dae4695880680f91130d7a0,0,Dan Burkert,2018-06-12 18:53:01+00:00,['37f3a95d8e20ca73f34b21c9d3fe1c25e2e4f66d'],3,8,11,1290970,2,,,,2226
930c7f40fc18be16b2a905ea7f5d630c8e124fe0,0,Dan Burkert,2018-06-13 02:26:09+00:00,['c1c15ad5fd6dd1d96dae4695880680f91130d7a0'],3,3,6,1290976,1,,,,2226
8bec7d35a5e9edd434914dc8a71049b67d15f0fc,0,Mike Percy,2018-06-13 16:59:31+00:00,['930c7f40fc18be16b2a905ea7f5d630c8e124fe0'],16,28,44,1291020,3,0.428571429,1,1,2226
c00873171cca50414676219720f194747aa89a92,0,Will Berkeley,2018-06-13 21:30:29+00:00,['8bec7d35a5e9edd434914dc8a71049b67d15f0fc'],35,69,104,1291124,1,,,,2226
5e705530cc34bedde1215dd5f50a624cabd658e8,0,Will Berkeley,2018-06-14 17:29:32+00:00,['c00873171cca50414676219720f194747aa89a92'],6,25,31,1291155,2,0.857142857,1,1,2226
c12e63528a2f2c265136e702a48cbc6c93b7f2fd,0,Will Berkeley,2018-06-14 19:55:57+00:00,['5e705530cc34bedde1215dd5f50a624cabd658e8'],0,209,209,1291364,4,0.181818182,0.590909091,1,2229
b5f3d1a10aa51c623f074eb6852149d304676c7b,0,Mike Percy,2018-06-14 23:39:26+00:00,['c12e63528a2f2c265136e702a48cbc6c93b7f2fd'],2,11,13,1291377,1,,,,2229
5f1ca32f347d9ae76e34dc3ea8a3004de27de5b9,0,Dan Burkert,2018-06-15 17:15:41+00:00,['b5f3d1a10aa51c623f074eb6852149d304676c7b'],226,1267,1493,1292870,19,0.484184915,0.827250608,0.180048662,2232
e3474f4ce7b1ebc88d12c8ffe1837df8e8211603,0,Hao Hao,2018-06-15 18:18:40+00:00,['5f1ca32f347d9ae76e34dc3ea8a3004de27de5b9'],8,41,49,1292919,7,0.357142857,0.928571429,1,2232
f2089195d635ea73e7268a9b46db2feac2eeed2d,0,Hao Hao,2018-06-15 20:07:45+00:00,['e3474f4ce7b1ebc88d12c8ffe1837df8e8211603'],10,32,42,1292961,3,1,1,0.6,2232
f6668ecac27492cbe6ba7682beff6d347650d689,0,Will Berkeley,2018-06-16 00:28:12+00:00,['f2089195d635ea73e7268a9b46db2feac2eeed2d'],0,85,85,1293046,1,,,,2232
a4fd712eb5418c9262f9ac1dec6a813614777eef,0,Jordan Birdsell,2018-06-18 16:31:07+00:00,['f6668ecac27492cbe6ba7682beff6d347650d689'],3,1,4,1293050,1,,,,2232
4ea99dd079cd5d95c3e7f2e8653ae26e4896a3b6,0,Andrew Wong,2018-06-18 23:40:32+00:00,['a4fd712eb5418c9262f9ac1dec6a813614777eef'],6,21,27,1293077,2,1,1,1,2232
06e0f4b0ff7d7c072b64450a578b9e403b57c96c,0,Mike Percy,2018-06-19 21:46:29+00:00,['4ea99dd079cd5d95c3e7f2e8653ae26e4896a3b6'],0,14,14,1293091,1,,,,2232
3ae0b23a726ad679e4fa8e486d4c396c519062d7,0,Dan Burkert,2018-06-19 22:52:23+00:00,['06e0f4b0ff7d7c072b64450a578b9e403b57c96c'],2,0,2,1293093,1,0,0,0,2232
61fb6dc30a59047aee097ce4e8f82bf6d268effe,0,Adar Dembo,2018-06-20 20:01:54+00:00,['3ae0b23a726ad679e4fa8e486d4c396c519062d7'],3,12,15,1293108,2,,,,2232
c7918e87bf1aeb25d5b08f7b340d1ae15806568d,0,Dan Burkert,2018-06-21 20:15:22+00:00,['61fb6dc30a59047aee097ce4e8f82bf6d268effe'],26,67,93,1293201,3,0,0.344827586,0.931034483,2232
009cfe23ab37e8c8ac5949f365ab424f34a4f520,0,Will Berkeley,2018-06-22 17:58:01+00:00,['c7918e87bf1aeb25d5b08f7b340d1ae15806568d'],51,134,185,1293386,6,0,0.45,0.466666667,2232
f1e652b23c2bd76033868fe6a30484cb30098649,0,Alexey Serbin,2018-06-22 18:05:06+00:00,['009cfe23ab37e8c8ac5949f365ab424f34a4f520'],17,17,34,1293420,3,,1,0,2232
f6e8fe6c6bb6dd83e6485bc1b56364b11b250e94,0,Dan Burkert,2018-06-22 22:15:55+00:00,['f1e652b23c2bd76033868fe6a30484cb30098649'],31,170,201,1293621,3,0.341463415,1,1,2233
7192d7ff8a6d6f5eaa928a976d2f8b4fd1486770,0,Andrew Wong,2018-06-25 17:15:06+00:00,['f6e8fe6c6bb6dd83e6485bc1b56364b11b250e94'],16,244,260,1293881,2,0.164948454,0.896907216,1,2233
148a0c7bec6554724339a2235cbd723fb74be339,1,Grant Henke,2018-06-25 19:43:51+00:00,['7192d7ff8a6d6f5eaa928a976d2f8b4fd1486770'],7,1594,1601,1295482,18,0.333910035,0.581314879,0.925605536,2244
b52c343b4c570ae70f8e53303188d8ef7a8bbfb2,0,Todd Lipcon,2018-06-25 22:39:47+00:00,['148a0c7bec6554724339a2235cbd723fb74be339'],6,2,8,1295490,2,,,,2244
5162a6ce2e0b951e4fc91a6dae44b738ca75d27c,0,Andrew Wong,2018-06-26 00:42:30+00:00,['b52c343b4c570ae70f8e53303188d8ef7a8bbfb2'],68,125,193,1295683,1,0.121212121,0.121212121,1,2244
985c6698aaefa3b53581598545788d19a5b90283,1,Hao Hao,2018-06-26 01:00:57+00:00,['5162a6ce2e0b951e4fc91a6dae44b738ca75d27c'],45,405,450,1296133,4,0.186813187,0.787545788,0.721611722,2244
b174d6e538cb1a1df47f662640aadfb0d1236c1c,0,Alexey Serbin,2018-06-26 14:26:49+00:00,['985c6698aaefa3b53581598545788d19a5b90283'],4,36,40,1296173,2,0,0.739130435,0.739130435,2244
a935f70fb5113ce5eec2604385ea2e79ce4ed725,1,Mike Percy,2018-06-26 21:07:39+00:00,['b174d6e538cb1a1df47f662640aadfb0d1236c1c'],3,59,62,1296235,4,0,0,1,2244
97210811b6118a3a57712262acfb2c561762ebe2,0,Mike Percy,2018-06-26 21:07:48+00:00,['a935f70fb5113ce5eec2604385ea2e79ce4ed725'],79,89,168,1296403,4,1,,1,2244
43f076f513008832e571132fc1c7faf905b675c8,0,Andrew Wong,2018-06-26 23:23:43+00:00,['97210811b6118a3a57712262acfb2c561762ebe2'],2,0,2,1296405,1,,,,2244
96b2f58baaa33d47263205549273e881dc51eef0,0,Hao Hao,2018-06-26 23:41:31+00:00,['43f076f513008832e571132fc1c7faf905b675c8'],27,250,277,1296682,3,0,1,0.523809524,2244
f252a029f40b06fe595f3f334fad34fc8acc8511,0,Mike Percy,2018-06-27 00:09:11+00:00,['96b2f58baaa33d47263205549273e881dc51eef0'],220,342,562,1297244,40,0.428571429,1,0,2245
4479c20bbfa738ab46876f0de949441d573ba777,0,Dan Burkert,2018-06-27 00:13:58+00:00,['f252a029f40b06fe595f3f334fad34fc8acc8511'],0,6,6,1297250,1,0,1,1,2245
81828ba64f6348da2a4aec3fab3e7833f7ad01f0,0,Grant Henke,2018-06-27 13:03:22+00:00,['4479c20bbfa738ab46876f0de949441d573ba777'],22,50,72,1297322,2,0.6,1,1,2245
e0a4c6cfa122f6263c068d59ba8566c1a786967a,0,Grant Henke,2018-06-27 13:03:28+00:00,['81828ba64f6348da2a4aec3fab3e7833f7ad01f0'],2,2,4,1297326,1,,,,2245
9c89c2a9aad6956c39f04454467789fa6d8288ef,0,Alexey Serbin,2018-06-27 17:32:03+00:00,['e0a4c6cfa122f6263c068d59ba8566c1a786967a'],7,64,71,1297397,1,0.046511628,0.046511628,1,2245
72d0981aa5930d3e0762dad988a991b35603b2f9,0,Will Berkeley,2018-06-27 18:26:52+00:00,['9c89c2a9aad6956c39f04454467789fa6d8288ef'],3,129,132,1297529,4,1,1,0.47761194,2246
29c66db48b635b7a1d708c7ddb7e0fcd3c8c33fd,0,Dan Burkert,2018-06-27 20:50:36+00:00,['72d0981aa5930d3e0762dad988a991b35603b2f9'],2,26,28,1297557,3,0.333333333,1,0.6,2246
214dbc249225499e49975923cd84e0294b4c6a58,0,Hao Hao,2018-06-28 01:00:19+00:00,['29c66db48b635b7a1d708c7ddb7e0fcd3c8c33fd'],10,154,164,1297721,6,0.140186916,0.878504673,1,2246
36a764679b950d995919aabfeffa086d391f303e,0,Dan Burkert,2018-06-28 01:34:54+00:00,['214dbc249225499e49975923cd84e0294b4c6a58'],0,15,15,1297736,1,0,1,1,2246
545a814479c79fde017d1d69613fdc598c507cda,0,Grant Henke,2018-06-28 03:05:26+00:00,['36a764679b950d995919aabfeffa086d391f303e'],30,21,51,1297787,5,,,,2246
f5c802ced7ba3b719873dc677b0489a597d6909a,0,Alexey Serbin,2018-06-28 13:53:26+00:00,['545a814479c79fde017d1d69613fdc598c507cda'],22,21,43,1297830,1,1,0.2,0,2246
95182a6dff9da1f268d60aed705a267ed2946df6,0,Hao Hao,2018-07-02 22:34:30+00:00,['f5c802ced7ba3b719873dc677b0489a597d6909a'],14,15,29,1297859,1,,,,2246
90bc81275cd781700934c8e6b4975aec78d0ae76,1,Mike Percy,2018-07-03 02:53:38+00:00,['95182a6dff9da1f268d60aed705a267ed2946df6'],56,73,129,1297988,2,0,0,0,2246
8155d8c4102d1c36465ab83e680bd1314f80be1f,0,Mike Percy,2018-07-03 02:57:48+00:00,['90bc81275cd781700934c8e6b4975aec78d0ae76'],79,83,162,1298150,4,1,0.285714286,0,2246
0cda8c8ee9dbd982763c3706a6defde1fffc6d00,0,Mike Percy,2018-07-03 02:58:04+00:00,['8155d8c4102d1c36465ab83e680bd1314f80be1f'],228,280,508,1298658,3,0.375,1,0,2247
1ae050e4d57bc333de28bcbc62e072e8bafd04b3,0,Mike Percy,2018-07-03 02:58:35+00:00,['0cda8c8ee9dbd982763c3706a6defde1fffc6d00'],0,99,99,1298757,8,0.564516129,0.870967742,0.774193548,2247
7b048b8dbe2562e68dd2b2b7f1a4db83b1ae10bf,0,Dan Burkert,2018-07-03 23:23:32+00:00,['1ae050e4d57bc333de28bcbc62e072e8bafd04b3'],117,422,539,1299296,10,0.151832461,0.795811518,0.827225131,2247
a81d80a7987cd66c4d0e697058ecd817d2707a9e,0,Alexey Serbin,2018-07-04 01:24:17+00:00,['7b048b8dbe2562e68dd2b2b7f1a4db83b1ae10bf'],47,610,657,1299953,2,0.103448276,0.888594164,0.848806366,2247
0dcf166730c81fa07039788215279ef0bcfc03fe,0,Alexey Serbin,2018-07-04 01:49:32+00:00,['a81d80a7987cd66c4d0e697058ecd817d2707a9e'],0,6,6,1299959,1,1,1,0,2247
a1558eeded3d5140fc7ef9ac84d722117dec822c,0,Alexey Serbin,2018-07-04 05:29:37+00:00,['0dcf166730c81fa07039788215279ef0bcfc03fe'],96,528,624,1300583,7,0.063694268,0.608280255,0.878980892,2247
c5df00c8f5a63115d0545f254605658676f3bc88,0,Jordan Birdsell,2018-07-05 17:48:10+00:00,['a1558eeded3d5140fc7ef9ac84d722117dec822c'],0,139,139,1300722,2,,,,2249
c35c423c17a6a86a01f17f3731c181bc46602339,0,Alexey Serbin,2018-07-05 23:36:02+00:00,['c5df00c8f5a63115d0545f254605658676f3bc88'],1,1,2,1300724,1,,,,2249
910fd0baccf35d29a6403034927dcebe919dd81d,0,Alexey Serbin,2018-07-06 06:21:53+00:00,['c35c423c17a6a86a01f17f3731c181bc46602339'],3,8,11,1300735,2,0.75,0.75,1,2249
7177fc35992daabdb93d9920fb1cc46c1a07619a,0,Jordan Birdsell,2018-07-06 15:30:45+00:00,['910fd0baccf35d29a6403034927dcebe919dd81d'],2,154,156,1300891,3,1,1,1,2249
334ecafd014d9ece739ebd03d3b8ccb32032bb26,1,Todd Lipcon,2018-07-06 17:04:53+00:00,['7177fc35992daabdb93d9920fb1cc46c1a07619a'],12,31,43,1300934,7,,,,2249
e157663ba7cbe1ba6cc904dbaa76e97f8c6e31cf,0,Adar Dembo,2018-07-06 18:20:01+00:00,['334ecafd014d9ece739ebd03d3b8ccb32032bb26'],35,48,83,1301017,3,1,0,1,2249
8c744afa99e294864718c06be2dc099dd14fea81,0,Adar Dembo,2018-07-06 20:17:03+00:00,['e157663ba7cbe1ba6cc904dbaa76e97f8c6e31cf'],4,8,12,1301029,1,0,1,0.75,2249
af8bb879c0a2dd7cd228fad055cd20e14f783842,0,Dan Burkert,2018-07-06 23:09:27+00:00,['8c744afa99e294864718c06be2dc099dd14fea81'],4,8,12,1301041,1,1,1,1,2249
32fabd3a4bfeda144ab3c7d680266d0dc2d190f7,0,Adar Dembo,2018-07-09 18:22:57+00:00,['af8bb879c0a2dd7cd228fad055cd20e14f783842'],3,21,24,1301065,3,0,1,1,2249
eb9c6442778d22eb2e6137fe0723d832b5cbedcb,1,Grant Henke,2018-07-09 19:20:06+00:00,['32fabd3a4bfeda144ab3c7d680266d0dc2d190f7'],424,270,694,1301759,39,0.272727273,0,0,2249
c727118320b03fc87befd9941841cdddf8b30762,0,Grant Henke,2018-07-09 19:20:11+00:00,['eb9c6442778d22eb2e6137fe0723d832b5cbedcb'],2,93,95,1301854,4,0,1,0.852941176,2250
22f35e80f5520cf2bf3c02a2430bbe6c46b87f25,0,Andrew Wong,2018-07-10 02:59:43+00:00,['c727118320b03fc87befd9941841cdddf8b30762'],2,1,3,1301857,1,,,,2250
03a3c68126c894eae02f0ff8f6b5a999e03c7562,0,Grant Henke,2018-07-10 19:46:01+00:00,['22f35e80f5520cf2bf3c02a2430bbe6c46b87f25'],75,45,120,1301977,4,0,1,1,2250
077fe576288bfaa1aadc42596b3594c65ecf16e2,0,Alexey Serbin,2018-07-11 19:42:22+00:00,['03a3c68126c894eae02f0ff8f6b5a999e03c7562'],26,120,146,1302123,2,0,0.157894737,1,2250
4eefc8d4e362806957cf92de12e1c456a8b01a7d,0,Alexey Serbin,2018-07-11 20:36:22+00:00,['077fe576288bfaa1aadc42596b3594c65ecf16e2'],0,120,120,1302243,1,0,0.826666667,1,2250
cee17c03bc30037bf2a7d97c6bb3aa39cec34a4c,0,Dan Burkert,2018-07-11 23:01:51+00:00,['4eefc8d4e362806957cf92de12e1c456a8b01a7d'],64,46,110,1302353,2,1,0.636363636,0.545454545,2250
2692ac4ad750e29e9ca146df3b378a72a1e84a0b,0,Alexey Serbin,2018-07-12 03:07:42+00:00,['cee17c03bc30037bf2a7d97c6bb3aa39cec34a4c'],11,26,37,1302390,2,0,0,0,2250
978cf39124e1d5b637618384afd985cd3a002526,0,Mike Percy,2018-07-12 16:37:53+00:00,['2692ac4ad750e29e9ca146df3b378a72a1e84a0b'],2,6,8,1302398,1,0,0,1,2250
fff3cf0923782cab8a43e081caeccc88a53f11f9,0,Grant Henke,2018-07-12 17:14:53+00:00,['978cf39124e1d5b637618384afd985cd3a002526'],15,26,41,1302439,5,1,0,0.5,2250
f62bbdd64d1c039b91edbd1d55a1607abd023f43,0,Grant Henke,2018-07-12 19:17:09+00:00,['fff3cf0923782cab8a43e081caeccc88a53f11f9'],18,42,60,1302499,5,1,0,0,2250
d074de85dd19697444bb48eabe5b5c577a579d07,0,Dan Burkert,2018-07-13 02:34:34+00:00,['f62bbdd64d1c039b91edbd1d55a1607abd023f43'],94,167,261,1302760,10,0.707317073,1,0.609756098,2250
daee5550953d2596ed3f970f7027dffc695b6abe,0,Grant Henke,2018-07-13 14:54:20+00:00,['d074de85dd19697444bb48eabe5b5c577a579d07'],27,24,51,1302811,6,,,,2250
5a91629e5f2c524023105c5d39ee23a0f8416a87,1,Mike Percy,2018-07-13 22:00:18+00:00,['daee5550953d2596ed3f970f7027dffc695b6abe'],7,50,57,1302868,4,1,1,0.923076923,2250
eaed285d0319009e23d4c62e551de4e458aa2ea6,0,Todd Lipcon,2018-07-16 04:34:53+00:00,['5a91629e5f2c524023105c5d39ee23a0f8416a87'],1,1,2,1302870,1,0,0,0,2250
eee82d90a54108f2d7e18e84ec0bbd391fcc129a,1,Mike Percy,2018-07-16 19:26:47+00:00,['eaed285d0319009e23d4c62e551de4e458aa2ea6'],27,61,88,1302958,5,0,1,0.933333333,2250
825b964fa8786b87569a5896e16972fd231fd3ec,0,Mike Percy,2018-07-17 04:37:54+00:00,['eee82d90a54108f2d7e18e84ec0bbd391fcc129a'],1,0,1,1302959,1,,,,2250
2ff946030113860447931a49cfe69e8469efe5cc,0,Alexey Serbin,2018-07-17 23:00:07+00:00,['825b964fa8786b87569a5896e16972fd231fd3ec'],14,19,33,1302992,2,1,1,1,2250
f5117d294a32ea9e4035bb4f8e9fb376dea68646,0,Grant Henke,2018-07-18 14:57:07+00:00,['2ff946030113860447931a49cfe69e8469efe5cc'],52,468,520,1303512,7,0.489010989,0.494505495,0.763736264,2252
296b05ef40c947b6e2da404953db490967239a9e,0,Grant Henke,2018-07-18 14:57:37+00:00,['f5117d294a32ea9e4035bb4f8e9fb376dea68646'],5,5,10,1303522,1,,,,2252
c2cecb005c97efc8067475b603171a68f6875ebe,0,Grant Henke,2018-07-18 16:26:28+00:00,['296b05ef40c947b6e2da404953db490967239a9e'],2,16,18,1303540,1,1,1,1,2252
cb03085b355a02586f0f4a808e32f5c21b92b532,0,Dan Burkert,2018-07-18 22:46:06+00:00,['c2cecb005c97efc8067475b603171a68f6875ebe'],6,0,6,1303546,1,,,,2252
521189744471b7f8c4168a814f64943c776a82b1,0,Dan Burkert,2018-07-18 22:46:09+00:00,['cb03085b355a02586f0f4a808e32f5c21b92b532'],2,4,6,1303552,1,,,,2252
0fbebd67c2ec5dd93775a3c3454a1e08496e5179,0,Adar Dembo,2018-07-19 18:53:13+00:00,['521189744471b7f8c4168a814f64943c776a82b1'],246,272,518,1304070,27,0.136363636,0.818181818,1,2252
a68c9355bfeb9d16964b97f6b1ade98a513dac54,0,Mike Percy,2018-07-19 22:06:17+00:00,['0fbebd67c2ec5dd93775a3c3454a1e08496e5179'],33,41,74,1304144,12,,,,2252
ec1e47f41f25d926609e395d77d0009e210ac17d,0,Dan Burkert,2018-07-23 22:54:28+00:00,['a68c9355bfeb9d16964b97f6b1ade98a513dac54'],16,20,36,1304180,1,0,1,0,2252
6b429e8a42ad9fb12a97cc26e33ca19ac2626533,0,Alexey Serbin,2018-07-24 04:40:20+00:00,['ec1e47f41f25d926609e395d77d0009e210ac17d'],3,74,77,1304257,2,0,1,1,2252
5b09a693dd651203512abf9faaddcc21aad92e59,0,Alexey Serbin,2018-07-24 04:42:49+00:00,['6b429e8a42ad9fb12a97cc26e33ca19ac2626533'],93,95,188,1304445,3,0,1,0.5,2252
7aab411d3187ea066c935af0215f894c5eca6aae,0,Attila Bukor,2018-07-24 15:39:17+00:00,['5b09a693dd651203512abf9faaddcc21aad92e59'],1,1,2,1304447,1,,,,2252
ccdb6b557d440423843952cace3e7d351a743fa6,0,Alexey Serbin,2018-07-24 20:24:57+00:00,['7aab411d3187ea066c935af0215f894c5eca6aae'],239,256,495,1304942,11,0,0.388888889,0,2252
7fe04438ecd8e100509ba224826e753ffc851d49,0,Dan Burkert,2018-07-24 21:14:07+00:00,['ccdb6b557d440423843952cace3e7d351a743fa6'],13,49,62,1305004,3,0,0.95,0.95,2252
141ee5a52f005033d957bd73973dce913be0504b,0,Grant Henke,2018-07-24 21:36:57+00:00,['7fe04438ecd8e100509ba224826e753ffc851d49'],0,5,5,1305009,1,,,,2252
d6ee0047cef6fc5e3777045d50b1cfe861f745e9,0,Dan Burkert,2018-07-24 23:54:18+00:00,['141ee5a52f005033d957bd73973dce913be0504b'],17,27,44,1305053,6,0.571428571,1,1,2252
524485ebc797bf3e7e53d5b931cc0193e140ed41,1,Grant Henke,2018-07-25 00:22:21+00:00,['d6ee0047cef6fc5e3777045d50b1cfe861f745e9'],125,196,321,1305374,13,0.584084084,1,1,2252
5ba57a0728dad13bd0caa1ea5621f7e122497284,1,Adar Dembo,2018-07-25 20:29:37+00:00,['524485ebc797bf3e7e53d5b931cc0193e140ed41'],40,173,213,1305587,5,0,0.792207792,0.961038961,2252
0418b225e93fd7eb2e1342850f559314d23a9a7b,0,Adar Dembo,2018-07-25 20:29:46+00:00,['5ba57a0728dad13bd0caa1ea5621f7e122497284'],16,80,96,1305683,4,0,1,1,2252
fb79471c26ddd5d325febd2d40456ca8e83b6f04,0,Grant Henke,2018-07-26 21:50:40+00:00,['0418b225e93fd7eb2e1342850f559314d23a9a7b'],5,13,18,1305701,3,,,,2252
34b058b8b89a49e93de61457d67fe9b57f29b0bb,0,Dan Burkert,2018-07-26 22:13:55+00:00,['fb79471c26ddd5d325febd2d40456ca8e83b6f04'],1,1,2,1305703,1,,,,2252
7e733a73652db68342859d03d02763ef5e3de79d,0,Alexey Serbin,2018-07-30 01:55:52+00:00,['34b058b8b89a49e93de61457d67fe9b57f29b0bb'],30,98,128,1305831,3,0.166666667,0.981481481,1,2252
660ee80bb4c0f81cb6f0a08365a7e2abd0a3e409,0,Alexey Serbin,2018-07-30 15:06:44+00:00,['7e733a73652db68342859d03d02763ef5e3de79d'],33,47,80,1305911,1,0.636363636,0.727272727,0.363636364,2252
8e40dfdb97ee54906dfa519e28fbcffc290095ac,1,Dan Burkert,2018-07-30 18:46:28+00:00,['660ee80bb4c0f81cb6f0a08365a7e2abd0a3e409'],822,891,1713,1307624,6,0,0,1,2252
349b81057ac21b3a614ad9bb8133c188a8f80b64,0,Will Berkeley,2018-07-30 18:58:19+00:00,['8e40dfdb97ee54906dfa519e28fbcffc290095ac'],4,14,18,1307642,1,,,,2252
79166955f96a50a3ba76afe95d1b52d1b866053e,1,Grant Henke,2018-07-30 20:31:55+00:00,['349b81057ac21b3a614ad9bb8133c188a8f80b64'],767,1117,1884,1309526,24,0,0.747474747,0.560606061,2253
6a432c6a4cea7eb5495c42d470ff9a4e4f7f128a,0,Dan Burkert,2018-07-31 19:06:45+00:00,['79166955f96a50a3ba76afe95d1b52d1b866053e'],1,27,28,1309554,2,0.833333333,0.888888889,1,2253
a417127add0c0b07da9bfead2b2acf55212153bd,1,Grant Henke,2018-07-31 21:37:55+00:00,['6a432c6a4cea7eb5495c42d470ff9a4e4f7f128a'],467,653,1120,1310674,23,0,0.991869919,1,2253
2c4dca71d99b29fe16b98231854bace80ffd648f,0,Grant Henke,2018-07-31 21:44:27+00:00,['a417127add0c0b07da9bfead2b2acf55212153bd'],0,19,19,1310693,4,1,1,1,2253
6c68e64d852fbf6fd0b43907e4235ccd39b43c21,0,Grant Henke,2018-07-31 22:25:10+00:00,['2c4dca71d99b29fe16b98231854bace80ffd648f'],9,9,18,1310711,6,,,,2253
85a1808c530f4cf857b4fe7fc5be2f7c00c6ed82,0,Alexey Serbin,2018-08-01 19:33:53+00:00,['6c68e64d852fbf6fd0b43907e4235ccd39b43c21'],0,47,47,1310758,2,0,1,1,2253
d2afaec640b062d8ecf7de432b3a6618265a1673,0,Dan Burkert,2018-08-01 19:46:55+00:00,['85a1808c530f4cf857b4fe7fc5be2f7c00c6ed82'],65,158,223,1310981,6,0,0.942307692,0.269230769,2253
f847726780498b1a0ef1b9a7d95a50b4f327b36d,0,Dan Burkert,2018-08-01 19:47:03+00:00,['d2afaec640b062d8ecf7de432b3a6618265a1673'],15,144,159,1311140,2,0,0.574257426,1,2253
b2c6428909f468fa7dc106f601ee8c790060ac99,0,Dan Burkert,2018-08-01 19:47:32+00:00,['f847726780498b1a0ef1b9a7d95a50b4f327b36d'],22,55,77,1311217,6,0.571428571,0.714285714,0.571428571,2253
c5a93d030cef9bd8844ad2bf263bc70a8cf68c18,0,Adar Dembo,2018-08-01 20:37:56+00:00,['b2c6428909f468fa7dc106f601ee8c790060ac99'],0,3,3,1311220,1,,,,2253
a7a85027824c1fb6b3af37130d86ccf1e4ffeb02,0,Adar Dembo,2018-08-02 17:34:51+00:00,['c5a93d030cef9bd8844ad2bf263bc70a8cf68c18'],1,28,29,1311249,2,0,0,1,2253
703db4141ca912193439636fb0931510f9b27de0,0,Alexey Serbin,2018-08-02 23:12:55+00:00,['a7a85027824c1fb6b3af37130d86ccf1e4ffeb02'],0,155,155,1311404,1,0,0,1,2253
1fcce42200d22597e7e69baa7232b4de93d5e2a3,0,Alexey Serbin,2018-08-03 20:43:58+00:00,['703db4141ca912193439636fb0931510f9b27de0'],14,9,23,1311427,1,1,1,1,2253
f6777db35dfb3880ea188990809102d167c6d557,0,Alexey Serbin,2018-08-06 05:58:08+00:00,['1fcce42200d22597e7e69baa7232b4de93d5e2a3'],23,35,58,1311485,3,0,1,1,2253
997ad765fb4a0b19c87e29424c46f72c23c51bd0,0,Jordan Birdsell,2018-08-06 17:56:02+00:00,['f6777db35dfb3880ea188990809102d167c6d557'],2,153,155,1311640,4,0.414634146,1,1,2253
07c9962cbf9660812a2cb6f984c98e29c735840e,0,Mike Percy,2018-08-06 18:02:51+00:00,['997ad765fb4a0b19c87e29424c46f72c23c51bd0'],1,1,2,1311642,1,,,,2253
c93f08393d6232d9e8472cb50188bcc88409a510,0,Adar Dembo,2018-08-06 18:03:29+00:00,['07c9962cbf9660812a2cb6f984c98e29c735840e'],23,37,60,1311702,2,,,,2253
602b451abd60e0d02995107be6f3e0cb13c2906b,0,Todd Lipcon,2018-08-06 19:41:38+00:00,['c93f08393d6232d9e8472cb50188bcc88409a510'],135,2341,2476,1314178,21,1,1,1,2272
f9f16fa53525f44167ebd3da469eb7dc804418e1,0,Grant Henke,2018-08-06 20:24:45+00:00,['602b451abd60e0d02995107be6f3e0cb13c2906b'],53,5,58,1314236,3,,,,2272
3e61d754c2f91b4293ca8b1178cae681272841a4,0,Mike Percy,2018-08-07 00:10:46+00:00,['f9f16fa53525f44167ebd3da469eb7dc804418e1'],27,120,147,1314383,6,0.649350649,0.922077922,1,2272
cec6aa370ada43fc0d3893df4e4342515470de25,1,Mike Percy,2018-08-07 00:25:21+00:00,['3e61d754c2f91b4293ca8b1178cae681272841a4'],49,146,195,1314578,3,0.059701493,0,0.850746269,2272
60b140e2622d5b7ddb93ee02d39767bccae3371d,0,Adar Dembo,2018-08-07 03:24:03+00:00,['cec6aa370ada43fc0d3893df4e4342515470de25'],1,10,11,1314589,1,1,1,1,2272
9939a5136dc4197f44881daec3de00336e6957df,0,Grant Henke,2018-08-07 14:41:11+00:00,['60b140e2622d5b7ddb93ee02d39767bccae3371d'],175,190,365,1314954,5,,,,2273
65aec714f68b83cde4730ab340f8a5a227bf7075,0,Adar Dembo,2018-08-07 18:56:09+00:00,['9939a5136dc4197f44881daec3de00336e6957df'],14,0,14,1314968,1,0,0,0,2273
d62cde400d91e11122781f2b3940c8a714c66d01,0,Adar Dembo,2018-08-07 22:25:05+00:00,['65aec714f68b83cde4730ab340f8a5a227bf7075'],6,6,12,1314980,1,,,,2273
cf662826ba8b735f93bd1d855216e4037e8ccd0c,0,Adar Dembo,2018-08-08 04:21:06+00:00,['d62cde400d91e11122781f2b3940c8a714c66d01'],0,6,6,1314986,2,,,,2273
d6c80b773020e7e2a5387f0f3419a504d2eef8eb,0,Adar Dembo,2018-08-08 05:24:33+00:00,['cf662826ba8b735f93bd1d855216e4037e8ccd0c'],5,28,33,1315019,3,,,,2273
37d0c35bcf43aef92fdde82c629f732f1466d8ae,0,Adar Dembo,2018-08-08 17:26:14+00:00,['d6c80b773020e7e2a5387f0f3419a504d2eef8eb'],2,2,4,1315023,2,,,,2273
3bdc320542579be018212320ce556ed1220b3110,0,Adar Dembo,2018-08-08 21:28:21+00:00,['37d0c35bcf43aef92fdde82c629f732f1466d8ae'],3,10,13,1315036,1,,,,2273
4fea7a3cadeaedfb0c1dd53e4a7b3c135317328b,0,Alexey Serbin,2018-08-10 22:05:19+00:00,['3bdc320542579be018212320ce556ed1220b3110'],2,2,4,1315040,1,,,,2273
c866f4762de0de2c78fb11fa8a08e8acc17443c3,0,Attila Bukor,2018-08-11 16:53:22+00:00,['4fea7a3cadeaedfb0c1dd53e4a7b3c135317328b'],0,82,82,1315122,1,,,,2273
2cbddb3ca4c13519e3582c1cf6c40b7a8b82913a,0,Grant Henke,2018-08-14 19:53:29+00:00,['c866f4762de0de2c78fb11fa8a08e8acc17443c3'],5,5,10,1315132,2,,,,2273
2d92370d984d8277f1727cf108d3e6199fcca7ea,0,Grant Henke,2018-08-14 19:53:33+00:00,['2cbddb3ca4c13519e3582c1cf6c40b7a8b82913a'],7,23,30,1315162,2,,,,2273
e795d5a82c0c27c8a2ba1f82ac6695402aa42885,0,Dan Burkert,2018-08-14 21:20:30+00:00,['2d92370d984d8277f1727cf108d3e6199fcca7ea'],22,47,69,1315231,4,0.142857143,1,1,2273
8654a21159d6150c685c7311abc7c1110cda99e0,0,Grant Henke,2018-08-15 15:21:23+00:00,['e795d5a82c0c27c8a2ba1f82ac6695402aa42885'],0,40,40,1315271,1,,,,2273
08637705ae6ad8d3426cb7f8ed016cc1c0fbea46,0,Todd Lipcon,2018-08-15 18:49:07+00:00,['8654a21159d6150c685c7311abc7c1110cda99e0'],4,4,8,1315279,1,,,,2273
dfa465265c44098fc741da173e150fae0253501f,0,Adar Dembo,2018-08-15 19:02:55+00:00,['08637705ae6ad8d3426cb7f8ed016cc1c0fbea46'],46,54,100,1315379,3,0,0,0,2273
37a81b82cc2e5e1ca9ad7291740b4e963e609bcc,0,Attila Bukor,2018-08-17 15:14:04+00:00,['dfa465265c44098fc741da173e150fae0253501f'],38,39,77,1315456,8,,,,2273
4ee1c4fd7a716182abbe4bab7a8a20089158a894,0,Alexey Serbin,2018-08-18 00:17:05+00:00,['37a81b82cc2e5e1ca9ad7291740b4e963e609bcc'],3,7,10,1315466,2,,,,2273
354c84bc80425307b24e788b15439f8c5d3f597d,0,Grant Henke,2018-08-20 02:23:51+00:00,['4ee1c4fd7a716182abbe4bab7a8a20089158a894'],0,1,1,1315467,1,,,,2273
9199d164600fc046c9bab7e702b18faeb8a191bb,0,Grant Henke,2018-08-21 01:30:42+00:00,['354c84bc80425307b24e788b15439f8c5d3f597d'],35,37,72,1315539,4,0,1,1,2273
6d7d8f555e85bd2809fe9dea0630e2820ac2a892,0,Grant Henke,2018-08-21 03:31:53+00:00,['9199d164600fc046c9bab7e702b18faeb8a191bb'],15,36,51,1315590,3,0,1,1,2273
36899014032ea05d1cd6177df0d9dd73f8d91b1e,0,Grant Henke,2018-08-21 03:31:55+00:00,['6d7d8f555e85bd2809fe9dea0630e2820ac2a892'],12,50,62,1315652,2,0.428571429,1,1,2273
60020cf329aed49624a9a3e4001c3fe4f55816f5,0,Dan Burkert,2018-08-21 20:19:00+00:00,['36899014032ea05d1cd6177df0d9dd73f8d91b1e'],5,8,13,1315665,3,,,,2273
434144527bd68367f54f3a10e08b9500962dcd42,0,Hao Hao,2018-08-21 21:53:38+00:00,['60020cf329aed49624a9a3e4001c3fe4f55816f5'],0,2,2,1315667,1,0,1,1,2273
9ad90eebe6324a30c17deaaf8593d82ba038db49,0,Hao Hao,2018-08-21 21:53:44+00:00,['434144527bd68367f54f3a10e08b9500962dcd42'],1,2,3,1315670,1,0,1,1,2273
a6baa721076f9e7a91d0f108ef5b4a443c731f7c,0,Will Berkeley,2018-08-22 22:12:25+00:00,['9ad90eebe6324a30c17deaaf8593d82ba038db49'],129,201,330,1316000,7,0.791666667,0,0,2277
ec419c64e74834082a894bb3e87975bc86478f6d,0,Will Berkeley,2018-08-22 22:13:00+00:00,['a6baa721076f9e7a91d0f108ef5b4a443c731f7c'],1,11,12,1316012,2,0,1,1,2277
9a01205ce10b468698c76aedbf51016a90045620,0,Will Berkeley,2018-08-22 22:29:10+00:00,['ec419c64e74834082a894bb3e87975bc86478f6d'],62,67,129,1316141,6,1,0.824561404,0.969298246,2279
6ae9ecbe2595090c78e7afd271aae9d04dd4d0b5,0,Will Berkeley,2018-08-22 22:29:12+00:00,['9a01205ce10b468698c76aedbf51016a90045620'],3,3,6,1316147,1,,,,2279
a8e3335653aef465ff6c3a900c92d9788f1dc8a8,0,Grant Henke,2018-08-23 18:45:48+00:00,['6ae9ecbe2595090c78e7afd271aae9d04dd4d0b5'],4,5,9,1316156,1,0,1,1,2279
36187ef62e9fb892ea286af8e9547790a3fd34ba,0,Dan Burkert,2018-08-23 22:50:44+00:00,['a8e3335653aef465ff6c3a900c92d9788f1dc8a8'],21,5,26,1316182,4,,,,2279
4fe8967dd9aaca37f835a0199324e5f7158e8210,0,Hao Hao,2018-08-23 23:18:16+00:00,['36187ef62e9fb892ea286af8e9547790a3fd34ba'],28,155,183,1316365,2,,,,2279
51519e65bd3701b7549bc780c3d0fad45d799854,0,Hao Hao,2018-08-23 23:18:21+00:00,['4fe8967dd9aaca37f835a0199324e5f7158e8210'],19,47,66,1316431,2,,,,2279
d3ef58b71c83f5e6afa7c9f6cc5d42be82e5f7d8,0,Alexey Serbin,2018-08-24 00:41:58+00:00,['51519e65bd3701b7549bc780c3d0fad45d799854'],1,1,2,1316433,1,,,,2279
a8d088e11b8b901a91e4820dcfdca9537a1e801a,1,Grant Henke,2018-08-24 20:57:19+00:00,['d3ef58b71c83f5e6afa7c9f6cc5d42be82e5f7d8'],241,312,553,1316986,29,0.46031746,0.936507937,1,2280
2c572cbd4dbf4c35d5d85521cae6067722e346a0,1,Dan Burkert,2018-08-24 22:25:00+00:00,['a8d088e11b8b901a91e4820dcfdca9537a1e801a'],43,271,314,1317300,15,0.418604651,0.872093023,0.976744186,2281
264b5b20ff0a9b74d3406c7eedbfce24be0a97a1,0,Adar Dembo,2018-08-25 00:09:42+00:00,['2c572cbd4dbf4c35d5d85521cae6067722e346a0'],28,27,55,1317355,5,,,,2281
245f0a7e0d412c9a820746987f64c034a710ef1e,0,Grant Henke,2018-08-25 02:33:20+00:00,['264b5b20ff0a9b74d3406c7eedbfce24be0a97a1'],4,46,50,1317405,3,,,,2281
2e1d95cb23e18541d610444483717810ec671bb6,0,Grant Henke,2018-08-25 02:33:54+00:00,['245f0a7e0d412c9a820746987f64c034a710ef1e'],2,1,3,1317408,1,1,0,0,2281
be360bf0122e23f55a12c1ef367cad5329efe274,0,Grant Henke,2018-08-25 03:02:05+00:00,['2e1d95cb23e18541d610444483717810ec671bb6'],24,72,96,1317504,3,1,0,1,2281
0dc19bfb37cf9a20b9e1d7122084c199720d5ca4,0,Alexey Serbin,2018-08-25 08:06:19+00:00,['be360bf0122e23f55a12c1ef367cad5329efe274'],0,1,1,1317505,1,,,,2281
30abac028604f4d1fefab9e7e3729715bfedbc74,0,Grant Henke,2018-08-25 19:39:34+00:00,['0dc19bfb37cf9a20b9e1d7122084c199720d5ca4'],4,1,5,1317510,2,,,,2281
1308db96877a5a2d73510486d973d2093a17a936,0,Andrew Wong,2018-08-25 21:13:41+00:00,['30abac028604f4d1fefab9e7e3729715bfedbc74'],1,1,2,1317512,1,,,,2281
f5ffcb4d7b2ebd2ca134f9a72c396c82ffcb36b4,0,Grant Henke,2018-08-27 19:31:48+00:00,['1308db96877a5a2d73510486d973d2093a17a936'],2,21,23,1317535,1,,,,2281
bb78520a7a636926bba3c68fc85bdca157524ef0,0,Alexey Serbin,2018-08-27 20:06:41+00:00,['f5ffcb4d7b2ebd2ca134f9a72c396c82ffcb36b4'],1,1,2,1317537,1,,,,2281
54afea093dd2f82aea6cc289e4f5409972c487b3,0,Andrew Wong,2018-08-28 00:21:53+00:00,['bb78520a7a636926bba3c68fc85bdca157524ef0'],30,94,124,1317661,9,1,1,1,2281
3bb5f56cf0929fc80ad98672d15baf0263f84a18,0,Alexey Serbin,2018-08-28 03:08:59+00:00,['54afea093dd2f82aea6cc289e4f5409972c487b3'],2,4,6,1317667,1,,,,2281
5d69deb36925113796cd69f51061b8396b0174fc,0,Andrew Wong,2018-08-28 15:39:46+00:00,['3bb5f56cf0929fc80ad98672d15baf0263f84a18'],16,28,44,1317711,2,0,1,1,2281
d55df3c6e6f3c6540d5eec9b42f3138b6ebe51c5,0,Adar Dembo,2018-08-28 21:23:13+00:00,['5d69deb36925113796cd69f51061b8396b0174fc'],4,9,13,1317724,2,,,,2281
81ab99b399114ad75c8d58def6964019a8908432,0,Will Berkeley,2018-08-28 23:04:23+00:00,['d55df3c6e6f3c6540d5eec9b42f3138b6ebe51c5'],1,1,2,1317726,1,,,,2281
846eb7f9705812515fadffe1eacb69bf60ad5a9b,1,Dan Burkert,2018-08-28 23:34:17+00:00,['81ab99b399114ad75c8d58def6964019a8908432'],8,717,725,1318451,13,1,0.633333333,1,2290
2974f5a50c95862960d09f3f18831ca259d921b2,1,Andrew Wong,2018-08-29 00:40:15+00:00,['846eb7f9705812515fadffe1eacb69bf60ad5a9b'],381,658,1039,1319490,45,0.272,0.792,0,2291
6ec77092808e2ddaec2d2cfd8a44b740b43dafa9,0,Andrew Wong,2018-08-29 01:52:14+00:00,['2974f5a50c95862960d09f3f18831ca259d921b2'],108,120,228,1319718,10,0,0,0,2291
b3eb06a01efbc8d9a7eb71b4aa3cf732c5567688,0,Andrew Wong,2018-08-29 22:22:50+00:00,['6ec77092808e2ddaec2d2cfd8a44b740b43dafa9'],13,11,24,1319742,1,,,,2291
1d9ce56251bb41e21d58cb5b8904ba0aa35110be,0,Alexey Serbin,2018-08-30 01:16:30+00:00,['b3eb06a01efbc8d9a7eb71b4aa3cf732c5567688'],9,8,17,1319759,2,,,,2291
eb15beabd2d4d86649a35dcd027e1749cc695866,0,Alexey Serbin,2018-08-31 18:16:44+00:00,['1d9ce56251bb41e21d58cb5b8904ba0aa35110be'],35,93,128,1319887,3,0.0625,0.8125,1,2291
4e7f0da4f2b383383d66f01c27a68dadbd0750eb,0,Will Berkeley,2018-08-31 18:31:56+00:00,['eb15beabd2d4d86649a35dcd027e1749cc695866'],2,3,5,1319892,2,0,0.5,0.5,2291
1da6501e4d1686c2a96e119094aa419d3aecc8db,0,Will Berkeley,2018-08-31 18:44:49+00:00,['4e7f0da4f2b383383d66f01c27a68dadbd0750eb'],18,64,82,1319974,6,0,0.942857143,0.914285714,2291
cf6927cb153f384afb649b664de1d4276bd6d83f,0,Andrew Wong,2018-09-04 17:04:08+00:00,['1da6501e4d1686c2a96e119094aa419d3aecc8db'],77,342,419,1320393,13,0.583333333,0.893939394,0.871212121,2291
060d7b0f59b287c18c0690a7795ae225a1f534ee,0,Will Berkeley,2018-09-04 18:23:11+00:00,['cf6927cb153f384afb649b664de1d4276bd6d83f'],1,26,27,1320420,2,0.785714286,1,0.785714286,2291
a58867c59c0ecbdd2c74d8ac6744b7b3cd304a36,0,Alexey Serbin,2018-09-04 20:06:18+00:00,['060d7b0f59b287c18c0690a7795ae225a1f534ee'],0,1,1,1320421,1,1,1,1,2291
dcc39d53d8c36a3f4896ce4c208b855abee8da83,0,Will Berkeley,2018-09-04 21:50:47+00:00,['a58867c59c0ecbdd2c74d8ac6744b7b3cd304a36'],12,342,354,1320775,9,0.183431953,0.964497041,0.710059172,2293
459be18fab2d722eafd03e03c608d9f86a4eb990,0,Grant Henke,2018-09-04 22:49:03+00:00,['dcc39d53d8c36a3f4896ce4c208b855abee8da83'],2,5,7,1320782,1,,,,2293
224f4792d9d443066be6a4a7f6442211a340c59b,0,Grant Henke,2018-09-05 01:29:43+00:00,['459be18fab2d722eafd03e03c608d9f86a4eb990'],4,5,9,1320791,1,,,,2293
17c5d73dcd4902ef7f9e55c1fcaaaf836bda31ba,0,Andrew Wong,2018-09-05 06:11:47+00:00,['224f4792d9d443066be6a4a7f6442211a340c59b'],3,5,8,1320799,2,0,1,0,2293
6b70c275f6636e5e07a56d4ffa371cd8604a6c50,0,Will Berkeley,2018-09-05 14:39:31+00:00,['17c5d73dcd4902ef7f9e55c1fcaaaf836bda31ba'],1,61,62,1320861,6,0.821428571,0.821428571,0.964285714,2294
4fceeae3f314ef794bd58c47439033941a1aa568,0,Adar Dembo,2018-09-05 16:00:18+00:00,['6b70c275f6636e5e07a56d4ffa371cd8604a6c50'],19,152,171,1321032,6,0,0.225806452,1,2294
257dd585a9dfa865a57d961bb4a50c1a19acafa7,0,Hao Hao,2018-09-06 23:43:00+00:00,['4fceeae3f314ef794bd58c47439033941a1aa568'],3,1,4,1321036,1,,,,2294
0653dcdebb8a5dbe0463341c8f12bbc5ae14fec8,0,Alexey Serbin,2018-09-07 20:29:31+00:00,['257dd585a9dfa865a57d961bb4a50c1a19acafa7'],2,2,4,1321040,1,,,,2294
885d8bdafd46b7a4d48cabb8ae929431b78b7cab,0,Alexey Serbin,2018-09-07 21:07:38+00:00,['0653dcdebb8a5dbe0463341c8f12bbc5ae14fec8'],2,68,70,1321110,2,0.325,1,0.675,2294
b552d9118717a00023264e30f1d749db98a388f9,0,Hao Hao,2018-09-07 21:31:35+00:00,['885d8bdafd46b7a4d48cabb8ae929431b78b7cab'],51,79,130,1321240,14,0.25,1,0.833333333,2294
e3570519b200a0ffbd713798bc8aabd6f36ed3b7,0,Will Berkeley,2018-09-10 18:43:43+00:00,['b552d9118717a00023264e30f1d749db98a388f9'],0,17,17,1321257,1,,,,2294
953a09b826b4a0ccd379480f7aac441186f8bacb,0,Alexey Serbin,2018-09-10 20:35:04+00:00,['e3570519b200a0ffbd713798bc8aabd6f36ed3b7'],16,11,27,1321284,1,1,1,0,2294
38a48476ee98e180d09e71cd0547119ff43423e4,0,Alexey Serbin,2018-09-10 21:18:25+00:00,['953a09b826b4a0ccd379480f7aac441186f8bacb'],0,74,74,1321358,2,0.056603774,1,1,2294
edde4bebea8e309a43e3316f78c45df6e6c8c9fe,0,Alexey Serbin,2018-09-10 22:18:21+00:00,['38a48476ee98e180d09e71cd0547119ff43423e4'],3,3,6,1321364,1,,,,2294
e709db1f379e2375841a2c6357cd3b6a6ce4618b,0,Alexey Serbin,2018-09-11 05:34:53+00:00,['edde4bebea8e309a43e3316f78c45df6e6c8c9fe'],5,19,24,1321388,1,,,,2294
f02a0c0f29b6ef5468137869764119b1a8f8b3ae,0,Will Berkeley,2018-09-11 16:25:48+00:00,['e709db1f379e2375841a2c6357cd3b6a6ce4618b'],82,349,431,1321819,7,0.201058201,0.603174603,0.518518519,2294
f0716cc521554bc6c4b785d339ecf17b8ca983e6,0,Alexey Serbin,2018-09-11 18:15:39+00:00,['f02a0c0f29b6ef5468137869764119b1a8f8b3ae'],5,0,5,1321824,1,,,,2294
7856ec9174c16c212ce944983124954fe4d325fa,0,Alexey Serbin,2018-09-11 20:35:18+00:00,['f0716cc521554bc6c4b785d339ecf17b8ca983e6'],1,1,2,1321826,1,,,,2294
d91a2525060d52bc27661b2b5978a288a71bcec2,0,Andrew Wong,2018-09-11 21:24:22+00:00,['7856ec9174c16c212ce944983124954fe4d325fa'],12,21,33,1321859,1,,,,2294
ed60c11a3e2fa78e32edbb4f5d3cf844d23d8f00,0,Dan Burkert,2018-09-11 22:32:50+00:00,['d91a2525060d52bc27661b2b5978a288a71bcec2'],8,8,16,1321875,1,,,,2294
97dbffb95228b29b35ecba4be6708a33522ec152,1,Dan Burkert,2018-09-11 22:45:28+00:00,['ed60c11a3e2fa78e32edbb4f5d3cf844d23d8f00'],55,145,200,1322075,7,0.086206897,0.672413793,0.724137931,2294
eb109116bc6e1c89489b503a36951b53dfabd933,1,Alexey Serbin,2018-09-12 06:43:51+00:00,['97dbffb95228b29b35ecba4be6708a33522ec152'],12,21,33,1322108,1,0,0,1,2294
a7590d49c10e29b914daa10b111e13ecd08e2172,0,Alexey Serbin,2018-09-12 17:01:52+00:00,['eb109116bc6e1c89489b503a36951b53dfabd933'],6,3,9,1322117,3,,,,2294
ebb2852d99ed27c26e65c3569d5cb515754b2937,1,Alexey Serbin,2018-09-12 23:13:30+00:00,['a7590d49c10e29b914daa10b111e13ecd08e2172'],223,1227,1450,1323567,11,0.124780316,0.845342707,0.957820738,2297
f31e5cbc7c3b545a0eb388afd1733541a88037ba,0,Alexey Serbin,2018-09-13 01:04:35+00:00,['ebb2852d99ed27c26e65c3569d5cb515754b2937'],6,5,11,1323578,1,1,1,0,2297
a643a5ceca75d9a2d89fd937757a9d142a29c83f,0,Will Berkeley,2018-09-13 18:04:17+00:00,['f31e5cbc7c3b545a0eb388afd1733541a88037ba'],32,47,79,1323657,1,1,0.4,0,2297
72a77bfbf34831b8b1ea39d243bd46a34e7ba1f7,0,Adar Dembo,2018-09-14 18:02:50+00:00,['a643a5ceca75d9a2d89fd937757a9d142a29c83f'],0,588,588,1324245,2,0.948717949,1,0.935897436,2299
42db87b0b128c573b96e39615e7fa41227fea368,1,Grant Henke,2018-09-15 22:12:37+00:00,['72a77bfbf34831b8b1ea39d243bd46a34e7ba1f7'],63,347,410,1324655,6,0.4,0.693333333,1,2299
c36a9fe903a4705012d1205206401bf9101803d4,0,Will Berkeley,2018-09-17 17:41:27+00:00,['42db87b0b128c573b96e39615e7fa41227fea368'],9,78,87,1324742,1,,,,2299
c2054ae89c2e8217e655c71a1f83b38947fa438d,0,Alexey Serbin,2018-09-17 23:31:12+00:00,['c36a9fe903a4705012d1205206401bf9101803d4'],10,10,20,1324762,1,,,,2299
d4ded71bc0edadcbe2564d5677d319f35e48dad8,0,Adar Dembo,2018-09-18 17:03:10+00:00,['c2054ae89c2e8217e655c71a1f83b38947fa438d'],3,734,737,1325499,23,0.181623932,0.675213675,0.58974359,2301
80ebaeda8a8cbe2b39f6b686badf860bc30cac21,0,Adar Dembo,2018-09-18 20:21:14+00:00,['d4ded71bc0edadcbe2564d5677d319f35e48dad8'],1,5,6,1325505,1,,,,2301
42dd8f842bc242a19bfe569baa97112daf180e55,0,Hao Hao,2018-09-19 01:38:39+00:00,['80ebaeda8a8cbe2b39f6b686badf860bc30cac21'],1,5,6,1325511,1,,,,2301
cc5c7601c99eea9535f61a4ee4cbd35fe8939d1d,1,Alexey Serbin,2018-09-19 20:46:06+00:00,['42dd8f842bc242a19bfe569baa97112daf180e55'],14,175,189,1325700,1,0.16,1,0.853333333,2301
ffb1f22a70c8ef67fd4f8ab8d8a7203020674c4e,1,Alexey Serbin,2018-09-19 20:46:14+00:00,['cc5c7601c99eea9535f61a4ee4cbd35fe8939d1d'],17,53,70,1325770,3,0,0,0,2301
f3cd878dcdf2536e30995c466a09b933dc00eaa4,0,Grant Henke,2018-09-19 20:48:28+00:00,['ffb1f22a70c8ef67fd4f8ab8d8a7203020674c4e'],14,49,63,1325833,8,,,,2301
df93255d9e0db86d797dabfb6e56dfc586c73f28,0,Hao Hao,2018-09-19 21:46:10+00:00,['f3cd878dcdf2536e30995c466a09b933dc00eaa4'],0,9,9,1325842,1,0,1,1,2301
816bc6fd8a8e9a75c4cbd40de9e0d37fac6f7b74,0,Alexey Serbin,2018-09-20 18:07:58+00:00,['df93255d9e0db86d797dabfb6e56dfc586c73f28'],0,8,8,1325850,1,,,,2301
3a033d829cd6aab17995b68371e7e136c47cc9b8,0,Will Berkeley,2018-09-20 21:32:51+00:00,['816bc6fd8a8e9a75c4cbd40de9e0d37fac6f7b74'],0,37,37,1325887,1,,,,2301
e48157a0e6d1d4d3ee5fb700e020f0c648ff0560,0,Will Berkeley,2018-09-20 22:29:08+00:00,['3a033d829cd6aab17995b68371e7e136c47cc9b8'],14,25,39,1325926,3,0,0.75,1,2301
fd1ffd0fb65e138f1f015a55aa96ae870c1d51cd,0,Grant Henke,2018-09-21 13:42:35+00:00,['e48157a0e6d1d4d3ee5fb700e020f0c648ff0560'],292,415,707,1326633,48,0.964285714,1,1,2302
34e88d3dafc421ccaabae5767aad2fd9fa015d39,0,Grant Henke,2018-09-21 16:07:20+00:00,['fd1ffd0fb65e138f1f015a55aa96ae870c1d51cd'],365,232,597,1327230,14,0.16091954,0,0,2305
6129467d964a073f3e68474200452a8c3f639996,1,Mike Percy,2018-09-21 19:55:23+00:00,['34e88d3dafc421ccaabae5767aad2fd9fa015d39'],9,276,285,1327515,6,0.086206897,0.637931034,0.637931034,2306
ddaa766e2fdf177a86ed3eb57e6b917730b75843,0,Dan Burkert,2018-09-22 00:39:23+00:00,['6129467d964a073f3e68474200452a8c3f639996'],105,233,338,1327853,16,1,1,1,2309
24b38f73739ef76f69fbe950ff103dc6c1b3e6a8,0,David Ribeiro Alves,2018-09-24 15:03:30+00:00,['ddaa766e2fdf177a86ed3eb57e6b917730b75843'],16,16,32,1327885,1,,,,2309
a09c89abc1c0df62cffc9bdf3b36eede9150c4b9,0,Dan Burkert,2018-09-25 17:42:49+00:00,['24b38f73739ef76f69fbe950ff103dc6c1b3e6a8'],7,36,43,1327928,10,0.076923077,0.846153846,0.846153846,2309
4fba6e8a16378ffc00bd399ca65161e96f9ce20e,0,Alexey Serbin,2018-09-25 18:14:03+00:00,['a09c89abc1c0df62cffc9bdf3b36eede9150c4b9'],3,1,4,1327932,1,,,,2309
6030c5a32dd0e0c825e8c4f9152a66253de5474c,0,Mike Percy,2018-09-25 21:35:06+00:00,['4fba6e8a16378ffc00bd399ca65161e96f9ce20e'],21,393,414,1328346,2,0.844559585,0.994818653,0.777202073,2310
9130bb0e15d25ea8e1dfde28bebc752793100618,0,Mike Percy,2018-09-25 21:42:10+00:00,['6030c5a32dd0e0c825e8c4f9152a66253de5474c'],1,1,2,1328348,1,,,,2310
8020cbf2760483c46ed0766dfdebe3c12d0107f1,0,Grant Henke,2018-09-26 15:45:21+00:00,['9130bb0e15d25ea8e1dfde28bebc752793100618'],6,126,132,1328480,5,0.557692308,0.961538462,0.846153846,2311
801d00536acacf922241544df1590968b88eb8b1,0,Grant Henke,2018-09-26 20:32:39+00:00,['8020cbf2760483c46ed0766dfdebe3c12d0107f1'],2,2,4,1328484,1,,,,2311
c9f1772e7683d8e2d2467c565091aeb8d12d6af3,0,Adar Dembo,2018-09-26 21:35:28+00:00,['801d00536acacf922241544df1590968b88eb8b1'],4,19,23,1328507,1,0,1,1,2311
bfdcd973f2338f1326456cccdb62fbee9530ece5,0,Alexey Serbin,2018-09-26 22:28:31+00:00,['c9f1772e7683d8e2d2467c565091aeb8d12d6af3'],2,2,4,1328511,1,,,,2311
fad56a6f85a4707f075f2334de21fb9025011795,0,Dan Burkert,2018-09-27 00:34:17+00:00,['bfdcd973f2338f1326456cccdb62fbee9530ece5'],43,281,324,1328835,12,0.323809524,0.99047619,0.99047619,2311
14f3e6f60b9fbfc7c7b41c6b5ce4ba8612088869,0,Dan Burkert,2018-09-27 00:34:24+00:00,['fad56a6f85a4707f075f2334de21fb9025011795'],10,300,310,1329145,6,0.296,0.784,1,2311
ecc4998cb921b97d919ce6acef2b0f623a75d653,0,Dan Burkert,2018-09-27 00:34:32+00:00,['14f3e6f60b9fbfc7c7b41c6b5ce4ba8612088869'],10,95,105,1329250,4,0.25,1,0.803571429,2311
ad620415af0b7da700eb1ffdd5f864d33e984d12,0,Grant Henke,2018-09-27 00:41:06+00:00,['ecc4998cb921b97d919ce6acef2b0f623a75d653'],7,5,12,1329262,3,,,,2311
7db4d82f4bcb98aba05853249fd4c84677c57227,0,Mike Percy,2018-09-28 18:43:34+00:00,['ad620415af0b7da700eb1ffdd5f864d33e984d12'],247,365,612,1329874,13,1,1,1,2313
2de096ccbb245d801a1fd179cdcc1fc6c832bedd,0,Adar Dembo,2018-09-28 23:54:05+00:00,['7db4d82f4bcb98aba05853249fd4c84677c57227'],3,11,14,1329888,1,,,,2313
9f9070a4d4c89727e823066a47edff40bbeb3187,0,Will Berkeley,2018-10-01 18:52:25+00:00,['2de096ccbb245d801a1fd179cdcc1fc6c832bedd'],37,69,106,1329994,1,0,0,0,2313
7f5f57f5d73c3b583478210d9b704d7b3793ffe6,0,Will Berkeley,2018-10-02 14:38:54+00:00,['9f9070a4d4c89727e823066a47edff40bbeb3187'],237,363,600,1330594,11,0,0.5,1,2315
6466c0d7de099a7dd6a8368c7cf058af36b9cba4,0,Mike Percy,2018-10-02 18:52:02+00:00,['7f5f57f5d73c3b583478210d9b704d7b3793ffe6'],20,48,68,1330662,5,0,0.789473684,0.578947368,2315
dc8ae79961f71b8bdc344781fc89d38d94152fc4,1,Grant Henke,2018-10-02 19:00:56+00:00,['6466c0d7de099a7dd6a8368c7cf058af36b9cba4'],805,1268,2073,1332735,56,0,0.88,1,2315
545afa7a4c952457b11889b6b552685dadb0750b,1,Grant Henke,2018-10-02 19:01:16+00:00,['dc8ae79961f71b8bdc344781fc89d38d94152fc4'],133,170,303,1333038,7,1,0,0.291666667,2316
8513685babb1b4a055af4222d990948a48e1aae7,0,Grant Henke,2018-10-02 19:01:30+00:00,['545afa7a4c952457b11889b6b552685dadb0750b'],16,16,32,1333070,5,,,,2316
ec654c49f2814b4677015788d7a8ea13ca405317,1,Grant Henke,2018-10-02 19:03:59+00:00,['8513685babb1b4a055af4222d990948a48e1aae7'],50,34,84,1333154,7,0.4,0,0,2316
63e4a0a700eeb2677f232bc472b36769be3e0382,0,Will Berkeley,2018-10-03 18:04:36+00:00,['ec654c49f2814b4677015788d7a8ea13ca405317'],188,337,525,1333679,4,0.476923077,0.538461538,0,2316
ce2b52770be4a81800fb5eb155b952d5211e2017,0,Hao Hao,2018-10-03 18:24:32+00:00,['63e4a0a700eeb2677f232bc472b36769be3e0382'],2,30,32,1333711,3,0,0,1,2316
da28d0aee42445791183d0ff5bc021c347cf5f9d,0,Grant Henke,2018-10-03 21:24:15+00:00,['ce2b52770be4a81800fb5eb155b952d5211e2017'],35,53,88,1333799,6,,,,2316
131c5d7af0a7c4b398ef01aaaea8378f18f84014,1,Adar Dembo,2018-10-04 18:17:25+00:00,['da28d0aee42445791183d0ff5bc021c347cf5f9d'],12,23,35,1333834,4,,,,2316
75472c82b1c0a2a2a91472e405b3ee4639e26575,0,Andrew Wong,2018-10-04 20:44:48+00:00,['131c5d7af0a7c4b398ef01aaaea8378f18f84014'],5,7,12,1333846,1,,,,2316
fb79f8fccf6c6000f2569afb7fa2e41b02fdfe00,0,Andrew Wong,2018-10-04 22:58:49+00:00,['75472c82b1c0a2a2a91472e405b3ee4639e26575'],1,5,6,1333852,1,,,,2316
cf1b1f42cbcc3ee67477ddc44cd0ff5070f1caac,0,Grant Henke,2018-10-05 02:24:04+00:00,['fb79f8fccf6c6000f2569afb7fa2e41b02fdfe00'],11,139,150,1334002,6,0.32,1,1,2316
b848488d9bd2efcfc63ddc073c3addece33793b6,0,Will Berkeley,2018-10-05 18:38:54+00:00,['cf1b1f42cbcc3ee67477ddc44cd0ff5070f1caac'],56,115,171,1334173,4,0,1,1,2316
f1f192ca3abead4055e7ab6e6bba84d3d6e9866b,0,Attila Bukor,2018-10-05 18:40:27+00:00,['b848488d9bd2efcfc63ddc073c3addece33793b6'],9,28,37,1334210,3,,,,2316
42b75278a8d226b0235736aae735edeeeb55ab21,1,Dan Burkert,2018-10-05 21:42:43+00:00,['f1f192ca3abead4055e7ab6e6bba84d3d6e9866b'],247,343,590,1334800,9,0.375,0.925,1,2316
88229a52bdebdfbaa103c553d77a7a6118e87122,0,Andrew Wong,2018-10-05 21:53:09+00:00,['42b75278a8d226b0235736aae735edeeeb55ab21'],1,1,2,1334802,1,,,,2316
2d6f8ffa9d14aacb0096d9d62fe4f5d71741fb4f,0,Will Berkeley,2018-10-08 15:46:28+00:00,['88229a52bdebdfbaa103c553d77a7a6118e87122'],0,10,10,1334812,1,,,,2316
8d6cfe10d47bdb422c6cc0e770afbd70d6ec7adf,0,Dan Burkert,2018-10-08 17:59:17+00:00,['2d6f8ffa9d14aacb0096d9d62fe4f5d71741fb4f'],10,99,109,1334921,3,,,,2316
0d4740b7692c0cb5c39cca73276b395921bd3ae4,0,Will Berkeley,2018-10-08 22:23:04+00:00,['8d6cfe10d47bdb422c6cc0e770afbd70d6ec7adf'],270,863,1133,1336054,7,0.232492997,0.68627451,0.80952381,2316
4de4347a3fd28a8bad3d481fdfa90acecd584520,0,Andrew Wong,2018-10-09 00:35:30+00:00,['0d4740b7692c0cb5c39cca73276b395921bd3ae4'],1,1,2,1336056,1,,,,2316
31e3d4616042093d1a621e6de820ba76f1cc767a,0,Andrew Wong,2018-10-09 01:24:23+00:00,['4de4347a3fd28a8bad3d481fdfa90acecd584520'],1,1,2,1336058,1,,,,2316
89206ed9195bd37a405658856b3463611382810a,0,Alexey Serbin,2018-10-09 02:33:13+00:00,['31e3d4616042093d1a621e6de820ba76f1cc767a'],2,0,2,1336060,2,,,,2316
891a8e3beca417007933bcae7c08067e4a3bdfb8,0,Will Berkeley,2018-10-09 14:54:01+00:00,['89206ed9195bd37a405658856b3463611382810a'],0,27,27,1336087,1,,,,2316
77ead354b6ac86e3d251e35d9b0cf9da62979054,0,Will Berkeley,2018-10-09 15:10:20+00:00,['891a8e3beca417007933bcae7c08067e4a3bdfb8'],104,95,199,1336286,4,1,1,1,2316
0c91532e742df3b8f09d94ede5d7cde701b3857c,0,Will Berkeley,2018-10-09 16:44:00+00:00,['77ead354b6ac86e3d251e35d9b0cf9da62979054'],65,131,196,1336482,1,1,1,1,2316
9ec8d28dbed301c3d0bd3d9daab183d802f6a58d,0,Will Berkeley,2018-10-09 16:44:10+00:00,['0c91532e742df3b8f09d94ede5d7cde701b3857c'],12,106,118,1336600,3,0.3,0.075,1,2316
91faf2a1205e32e9d8293e263300718499bdf575,0,Andrew Wong,2018-10-09 17:37:53+00:00,['9ec8d28dbed301c3d0bd3d9daab183d802f6a58d'],9,69,78,1336678,3,0,0,1,2316
b193e3786861686590b6bf67bc507d8d4d18d8e3,1,Alexey Serbin,2018-10-09 17:42:50+00:00,['91faf2a1205e32e9d8293e263300718499bdf575'],6,428,434,1337112,8,0.193548387,0.655913978,0.731182796,2318
5d8f4797786c8afbdc6e93dd71eb8d73657e7591,0,Will Berkeley,2018-10-09 17:55:29+00:00,['b193e3786861686590b6bf67bc507d8d4d18d8e3'],1,1,2,1337114,1,,,,2318
ab38f6825dccf95710ba48d775aa74282dca1b84,0,Attila Bukor,2018-10-09 21:03:07+00:00,['5d8f4797786c8afbdc6e93dd71eb8d73657e7591'],13,13,26,1337140,13,,,,2318
88edfc36a888d53445b0e24159a10bf7de8b5213,0,Attila Bukor,2018-10-09 22:06:28+00:00,['ab38f6825dccf95710ba48d775aa74282dca1b84'],1,73,74,1337214,5,,,,2318
61aed1a58d1510d65cb9a3370ffbe93431e54d58,0,Dan Burkert,2018-10-10 00:31:17+00:00,['88edfc36a888d53445b0e24159a10bf7de8b5213'],6,64,70,1337284,3,0,1,1,2318
b1102d757c35d409aed840a5fe0834ea9f7812a2,0,Will Berkeley,2018-10-11 01:54:01+00:00,['61aed1a58d1510d65cb9a3370ffbe93431e54d58'],1,1,2,1337286,1,,,,2318
159c695a8eae62df27fbd2ba97ee1734934f1e50,0,Alexey Serbin,2018-10-11 17:00:48+00:00,['b1102d757c35d409aed840a5fe0834ea9f7812a2'],5,200,205,1337491,2,0,0.714285714,1,2318
66b0a4ccaa714834cd65c0f391a37007f0268b98,0,Alexey Serbin,2018-10-11 17:00:54+00:00,['159c695a8eae62df27fbd2ba97ee1734934f1e50'],1015,1163,2178,1339669,4,1,1,1,2319
3ff47118da7cae08fefb4ddf951e811f6725b80f,0,Andrew Wong,2018-10-11 17:37:52+00:00,['66b0a4ccaa714834cd65c0f391a37007f0268b98'],1,1,2,1339671,1,,,,2319
c8dd7b53fc380289e0191da30394ffe127e9de9f,0,Alexey Serbin,2018-10-11 18:15:11+00:00,['3ff47118da7cae08fefb4ddf951e811f6725b80f'],28,35,63,1339734,5,0.8,1,0,2319
8af288a26a204e2acfc3aa4e642fba7de56b43bb,0,Dan Burkert,2018-10-11 22:50:37+00:00,['c8dd7b53fc380289e0191da30394ffe127e9de9f'],39,1068,1107,1340841,10,0.122047244,0.593175853,0.614173228,2319
fdc215c84bfc7b7bf04153c346a1191ebea3e0b5,0,Andrew Wong,2018-10-12 05:34:28+00:00,['8af288a26a204e2acfc3aa4e642fba7de56b43bb'],2,2,4,1340845,1,,,,2319
bc817a44867c586bf4e0539aa564b282c666a49d,0,Andrew Wong,2018-10-12 05:35:21+00:00,['fdc215c84bfc7b7bf04153c346a1191ebea3e0b5'],81,204,285,1341130,11,0,0.714285714,0.910714286,2319
5894af6ff12291ffab2d3304b34f77fe6d112771,0,Andrew Wong,2018-10-12 06:08:01+00:00,['bc817a44867c586bf4e0539aa564b282c666a49d'],62,231,293,1341423,12,0.75,0.907894737,0.907894737,2319
df5fc241e5e459a0978afe5035eca1a24f66d017,0,Will Berkeley,2018-10-12 22:05:03+00:00,['5894af6ff12291ffab2d3304b34f77fe6d112771'],6,49,55,1341478,5,1,1,1,2319
3570c638681d8f13e890c9c48fef61a566cbbffd,0,Hao Hao,2018-10-16 03:41:04+00:00,['df5fc241e5e459a0978afe5035eca1a24f66d017'],0,270,270,1341748,4,0.376470588,0.682352941,1,2322
f6eddf2873214147a5f9cfd25a69d558253101ca,0,Hao Hao,2018-10-16 03:41:19+00:00,['3570c638681d8f13e890c9c48fef61a566cbbffd'],86,179,265,1342013,8,1,0,0,2325
1197eb01a21519c71a19f15d5133485a6aa82ec3,0,Andrew Wong,2018-10-16 03:55:40+00:00,['f6eddf2873214147a5f9cfd25a69d558253101ca'],1,5,6,1342019,1,0,0,1,2325
614b446e1f9291189657b265830d05d0395c5d1c,1,Will Berkeley,2018-10-16 05:39:39+00:00,['1197eb01a21519c71a19f15d5133485a6aa82ec3'],130,375,505,1342524,17,0,0.989637306,1,2325
02e82ca14f5c3c89f201224ea5b18dc0052ab835,0,Will Berkeley,2018-10-16 17:39:10+00:00,['614b446e1f9291189657b265830d05d0395c5d1c'],0,139,139,1342663,3,0.23364486,1,0.76635514,2325
e3b1e05990c88ae2d330738f512af59202cbe87d,0,Hao Hao,2018-10-16 18:06:58+00:00,['02e82ca14f5c3c89f201224ea5b18dc0052ab835'],44,229,273,1342936,4,0.269565217,1,1,2325
fa5a0db5a21c0f9d6554857ce6641b95b670f25e,0,Will Berkeley,2018-10-16 19:39:06+00:00,['e3b1e05990c88ae2d330738f512af59202cbe87d'],1,391,392,1343328,2,0,0.722741433,1,2325
acf1dee87ce347398ca86cc4959e38bf8794efe3,0,Will Berkeley,2018-10-16 19:41:54+00:00,['fa5a0db5a21c0f9d6554857ce6641b95b670f25e'],0,99,99,1343427,2,0,0.774647887,1,2325
8c184e2a972729cbb026b6962d6bf558b86e9cf5,0,Grant Henke,2018-10-16 19:55:53+00:00,['acf1dee87ce347398ca86cc4959e38bf8794efe3'],2222,60,2282,1345709,18,,,,2325
d3684a7b2add8f06b7189adb9ce9222b8ae1eff5,1,Will Berkeley,2018-10-16 20:47:13+00:00,['8c184e2a972729cbb026b6962d6bf558b86e9cf5'],53,287,340,1346049,7,0.086538462,0.346153846,0.778846154,2325
09848055b089be98754b82f6cae74ddc777778f6,0,Dan Burkert,2018-10-16 20:58:27+00:00,['d3684a7b2add8f06b7189adb9ce9222b8ae1eff5'],1,2,3,1346052,1,,,,2325
58ecdd15553178b25612f65de71ef25d07058079,1,Dan Burkert,2018-10-17 00:01:56+00:00,['09848055b089be98754b82f6cae74ddc777778f6'],14,127,141,1346193,3,0.162790698,1,1,2326
7072a85c5e0cb872c3369b80903ec5a978e92e1b,0,Will Berkeley,2018-10-17 04:10:54+00:00,['58ecdd15553178b25612f65de71ef25d07058079'],1,1,2,1346195,1,,,,2326
15f1416f67dcb714842d02647a1f2e06e675660d,1,Grant Henke,2018-10-17 20:40:42+00:00,['7072a85c5e0cb872c3369b80903ec5a978e92e1b'],182,218,400,1346595,70,,,,2327
fbe43129fe8edbb8a504996e9155b62aa65d336b,0,Grant Henke,2018-10-17 20:41:04+00:00,['15f1416f67dcb714842d02647a1f2e06e675660d'],9,0,9,1346604,1,,,,2327
36d09f1876a7a1c9bd27f71b194e61aebd5237c9,0,Adar Dembo,2018-10-17 22:28:13+00:00,['fbe43129fe8edbb8a504996e9155b62aa65d336b'],0,2,2,1346606,1,0,0,0,2327
7607e2354bf61957e4d3168d75d4990169dc2472,1,Dan Burkert,2018-10-17 23:02:24+00:00,['36d09f1876a7a1c9bd27f71b194e61aebd5237c9'],65,79,144,1346750,3,0.25,0.25,0,2327
1e8ef0eac6d411a225bd3a4101a7e19346eb1048,1,Dan Burkert,2018-10-17 23:02:28+00:00,['7607e2354bf61957e4d3168d75d4990169dc2472'],20,36,56,1346806,1,0,1,1,2327
082bbfe2048279518a9103e4edcd91f815705294,0,Dan Burkert,2018-10-17 23:02:37+00:00,['1e8ef0eac6d411a225bd3a4101a7e19346eb1048'],2,102,104,1346910,5,0.333333333,1,1,2328
117e7d9065961cebeb86addba1262d3f2741bcc8,0,Mike Percy,2018-10-17 23:42:05+00:00,['082bbfe2048279518a9103e4edcd91f815705294'],17,20,37,1346947,3,1,1,1,2328
f0ed88bbe728d7a739a0a0ecce35aaf7535f4933,0,Will Berkeley,2018-10-18 00:18:25+00:00,['117e7d9065961cebeb86addba1262d3f2741bcc8'],143,71,214,1347161,2,1,0,0,2328
e61de497c487f33fe1a99c9df6dfb697e8efb757,1,Will Berkeley,2018-10-18 00:44:53+00:00,['f0ed88bbe728d7a739a0a0ecce35aaf7535f4933'],68,840,908,1348069,17,0.204933586,0.700189753,0.920303605,2328
8386ef9e2962ee5692c0e646fdd63f9826b3b47c,0,Mike Percy,2018-10-18 02:08:50+00:00,['e61de497c487f33fe1a99c9df6dfb697e8efb757'],8,53,61,1348130,4,0.96,0.96,0.96,2328
7a4caf9660617c8dad2f95b939adec9eb1f9fd04,0,Alexey Serbin,2018-10-18 02:23:41+00:00,['8386ef9e2962ee5692c0e646fdd63f9826b3b47c'],21,10,31,1348161,2,,,,2328
53e02879885ef2e1598549b5655f610f12810011,0,Mike Percy,2018-10-18 18:29:23+00:00,['7a4caf9660617c8dad2f95b939adec9eb1f9fd04'],4,2,6,1348167,1,1,1,0,2328
64d5fe5267d3f936e9b366d6fa3de8e5a7a42212,0,Andrew Wong,2018-10-18 18:47:50+00:00,['53e02879885ef2e1598549b5655f610f12810011'],2,15,17,1348184,1,0,1,1,2328
1d34ae66524cc5a61bd7e0edf942039d989a5c09,0,Alexey Serbin,2018-10-18 21:06:59+00:00,['64d5fe5267d3f936e9b366d6fa3de8e5a7a42212'],33,37,70,1348254,1,0,1,1,2328
785490ce509e68029f8062882bb7021895e3b446,0,Grant Henke,2018-10-18 21:11:31+00:00,['1d34ae66524cc5a61bd7e0edf942039d989a5c09'],1,1,2,1348256,1,,,,2328
0a7940d687980d1451cd70f7a4b5b80e62797808,0,Will Berkeley,2018-10-19 18:34:46+00:00,['785490ce509e68029f8062882bb7021895e3b446'],17,103,120,1348376,4,0.257142857,0.714285714,0.828571429,2328
b3486d99a1e1bb5debef82912728d522f58621b7,0,Dan Burkert,2018-10-19 19:23:54+00:00,['0a7940d687980d1451cd70f7a4b5b80e62797808'],0,5,5,1348381,2,,,,2328
ef714838a8ba4e2a0dbf1d2f7998f8909d591402,0,Will Berkeley,2018-10-19 20:19:44+00:00,['b3486d99a1e1bb5debef82912728d522f58621b7'],65,65,130,1348511,6,1,0,0,2328
8a0d1602c0097b55e8fc9047bc659397e75f29d3,0,Will Berkeley,2018-10-19 21:28:08+00:00,['ef714838a8ba4e2a0dbf1d2f7998f8909d591402'],0,32,32,1348543,1,0,0,1,2328
a33e5733c16bf7da7eae2b813086faf7d01b0e2f,0,Mike Percy,2018-10-19 23:16:35+00:00,['8a0d1602c0097b55e8fc9047bc659397e75f29d3'],7,19,26,1348569,1,0,0,0,2328
4aabf46b4299dd46d6a4744f15b2a7b0c711ab9e,0,Alexey Serbin,2018-10-20 01:31:25+00:00,['a33e5733c16bf7da7eae2b813086faf7d01b0e2f'],3,1,4,1348573,1,,,,2328
9c763a6a7c40b744da65d7355babec231b4809a3,0,Adar Dembo,2018-10-22 20:18:03+00:00,['4aabf46b4299dd46d6a4744f15b2a7b0c711ab9e'],2,16,18,1348591,1,,,,2328
4abc211f6af7598c338cea4b8e8f913cde89c326,0,Hao Hao,2018-10-22 20:55:20+00:00,['9c763a6a7c40b744da65d7355babec231b4809a3'],40,68,108,1348699,3,0.117647059,0.117647059,1,2328
7d65f495db9f663f9626caba9b6880288d6cd83b,0,Will Berkeley,2018-10-22 21:58:51+00:00,['4abc211f6af7598c338cea4b8e8f913cde89c326'],4,13,17,1348716,1,0,1,1,2328
b22138783b96927b689ea14dc3c96a311e643970,0,Adar Dembo,2018-10-23 19:09:14+00:00,['7d65f495db9f663f9626caba9b6880288d6cd83b'],26,40,66,1348782,4,0,0.75,0.5,2328
d1f8c23b45492c3f1f49bf8cac2ee4d7e32f116f,0,Will Berkeley,2018-10-23 23:25:20+00:00,['b22138783b96927b689ea14dc3c96a311e643970'],13,23,36,1348818,2,,,,2328
fff0da8408abc70b192c303085f3e45175d495a6,0,Adar Dembo,2018-10-24 17:54:40+00:00,['d1f8c23b45492c3f1f49bf8cac2ee4d7e32f116f'],9,12,21,1348839,2,0,1,1,2328
53183f1e5b7d88a0d996f59a6259fe7ae48e7be9,0,Adar Dembo,2018-10-24 19:38:27+00:00,['fff0da8408abc70b192c303085f3e45175d495a6'],5,6,11,1348850,2,0,1,1,2328
95d9798886cc8ecbfcaf84a86a610b4fcb656a60,0,Alexey Serbin,2018-10-24 21:30:02+00:00,['53183f1e5b7d88a0d996f59a6259fe7ae48e7be9'],0,0,0,1348850,3,,,,2328
7f4a1a628838ae91615888df4a6923a08b8bde5b,0,Attila Bukor,2018-10-24 22:21:49+00:00,['95d9798886cc8ecbfcaf84a86a610b4fcb656a60'],28,381,409,1349259,2,,,,2328
9db90210522e66b665a792e2f710c9d8d63d713c,0,Alexey Serbin,2018-10-25 04:02:26+00:00,['7f4a1a628838ae91615888df4a6923a08b8bde5b'],1,1,2,1349261,1,,,,2328
a30c9211e8e73ead70acdb6108e5a0eac90cb5cb,0,Alexey Serbin,2018-10-25 04:03:24+00:00,['9db90210522e66b665a792e2f710c9d8d63d713c'],23,55,78,1349339,1,,,,2328
c09699ba8445be8d93aabea8a1cbed1772f374c3,0,Alexey Serbin,2018-10-25 06:19:16+00:00,['a30c9211e8e73ead70acdb6108e5a0eac90cb5cb'],27,118,145,1349484,5,0.173913043,0.97826087,0.97826087,2329
9042eda2c6c055c364f9c441c9b7fab3ecd15649,0,Alexey Serbin,2018-10-25 18:38:02+00:00,['c09699ba8445be8d93aabea8a1cbed1772f374c3'],1,10,11,1349495,3,,,,2329
eb6f4e8a8c56ca4e39de5e265e7de20a2e12263e,0,Alexey Serbin,2018-10-25 20:54:04+00:00,['9042eda2c6c055c364f9c441c9b7fab3ecd15649'],7,34,41,1349536,7,0.8,0.9,0.5,2329
be64560fe44c0466684cb9627e8bf515a7b96726,0,Will Berkeley,2018-10-26 20:45:33+00:00,['eb6f4e8a8c56ca4e39de5e265e7de20a2e12263e'],10,22,32,1349568,4,0,1,1,2329
2c5c9d06bce6897d78f31178ad6a437d7c48f29b,0,Alexey Serbin,2018-10-29 18:32:12+00:00,['be64560fe44c0466684cb9627e8bf515a7b96726'],5,137,142,1349710,3,0,0.963636364,0.963636364,2329
81d0109b461fc29c427c1fc81598c286318a95b9,1,Alexey Serbin,2018-10-29 23:05:24+00:00,['2c5c9d06bce6897d78f31178ad6a437d7c48f29b'],5,1001,1006,1350716,7,0.135283364,0.555758684,0.680073126,2332
fd507235b531419f6bc2447263278eee315177ab,0,Alexey Serbin,2018-10-29 23:05:31+00:00,['81d0109b461fc29c427c1fc81598c286318a95b9'],21,13,34,1350750,2,1,1,0,2332
43161e5aa75764a7f1748f85e0500fc454a301d8,1,Alexey Serbin,2018-10-29 23:05:42+00:00,['fd507235b531419f6bc2447263278eee315177ab'],108,135,243,1350993,6,0.45,0.45,0.95,2332
34bb7f93b4bcb8d39803d0f0718148f84f5cca22,0,Alexey Serbin,2018-10-29 23:05:50+00:00,['43161e5aa75764a7f1748f85e0500fc454a301d8'],368,481,849,1351842,2,0.941176471,1,0.382352941,2332
87084c108e1836ebb7811eace93836ee872a253e,0,Alexey Serbin,2018-10-29 23:26:48+00:00,['34bb7f93b4bcb8d39803d0f0718148f84f5cca22'],4,623,627,1352469,3,0.023696682,0.687203791,0.893364929,2332
f731ea004590217fe21b133ed093a7e9d21e7d42,0,Alexey Serbin,2018-10-29 23:27:01+00:00,['87084c108e1836ebb7811eace93836ee872a253e'],0,157,157,1352626,2,0,0,0,2332
d0205b9d57ae87b8a9e3610a0dfd84822ca200a9,0,Adar Dembo,2018-10-30 04:20:19+00:00,['f731ea004590217fe21b133ed093a7e9d21e7d42'],1,7,8,1352634,1,,,,2332
3a77ba131b68d0ef5affc043c29c81f4d07a2659,0,Adar Dembo,2018-10-30 04:20:21+00:00,['d0205b9d57ae87b8a9e3610a0dfd84822ca200a9'],46,48,94,1352728,1,0,1,1,2332
94e484da8686d830f64134400a7fa7b2b3ac5394,0,Andrew Wong,2018-10-30 17:26:18+00:00,['3a77ba131b68d0ef5affc043c29c81f4d07a2659'],74,387,461,1353189,9,0,1,0.715976331,2332
b022887306ca3815e12815f9d65ef0e2a7a13b1e,1,Will Berkeley,2018-10-30 18:23:30+00:00,['94e484da8686d830f64134400a7fa7b2b3ac5394'],83,84,167,1353356,25,0,0,1,2332
a2decad12bf84c91caf26d1963b99b3067dbd132,0,Adar Dembo,2018-10-30 21:00:21+00:00,['b022887306ca3815e12815f9d65ef0e2a7a13b1e'],4,0,4,1353360,1,0,0,0,2332
7d972a8ae7313c8a6be414a3272f3b297b5c66db,1,Grant Henke,2018-10-30 21:17:10+00:00,['a2decad12bf84c91caf26d1963b99b3067dbd132'],3,28,31,1353391,2,1,1,1,2332
6064884950f7bb5cb5ca1c4767ac0f34e1c631c9,0,Alexey Serbin,2018-10-30 23:24:00+00:00,['7d972a8ae7313c8a6be414a3272f3b297b5c66db'],7,21,28,1353419,4,,,,2332
973fc9a08596692fd9770959da5992b518fca5ec,0,Will Berkeley,2018-10-30 23:34:45+00:00,['6064884950f7bb5cb5ca1c4767ac0f34e1c631c9'],28,147,175,1353594,9,0.06741573,0.550561798,0.730337079,2332
0b2fef41d8d0b4ffc1afe566597d764299620e72,0,Adar Dembo,2018-10-31 04:47:19+00:00,['973fc9a08596692fd9770959da5992b518fca5ec'],1,21,22,1353616,1,,,,2332
dc71ab7eaf37b2924ca508567e11eca482a4fec5,0,Grant Henke,2018-10-31 18:44:22+00:00,['0b2fef41d8d0b4ffc1afe566597d764299620e72'],24,31,55,1353671,7,1,1,1,2334
75e264cb28c89c119e90c9637580cc260521f533,0,Adar Dembo,2018-10-31 23:18:52+00:00,['dc71ab7eaf37b2924ca508567e11eca482a4fec5'],2,160,162,1353833,6,0.4,0.7,1,2336
04468d0b4f9cc8d9dd2ba2e5654b7edd96513c33,1,Adar Dembo,2018-10-31 23:57:57+00:00,['75e264cb28c89c119e90c9637580cc260521f533'],20,810,830,1354663,9,0.192640693,0.584415584,0.24025974,2337
bd8d747ed57b3cfa53c0c1b4465589b7ec5f1663,1,Adar Dembo,2018-10-31 23:58:08+00:00,['04468d0b4f9cc8d9dd2ba2e5654b7edd96513c33'],274,420,694,1355357,8,0.658536585,1,1,2337
1043f3193371d9829bf6d85221bdc19607662440,1,Adar Dembo,2018-10-31 23:58:16+00:00,['bd8d747ed57b3cfa53c0c1b4465589b7ec5f1663'],403,525,928,1356285,12,0,0,0.954545455,2337
fec218bf644bb8f8a4b3edccf9a559600ab38659,0,Alexey Serbin,2018-11-01 01:54:03+00:00,['1043f3193371d9829bf6d85221bdc19607662440'],66,19,85,1356370,11,,,,2337
81bba2472b469996c3a0d8ed9f6412fe29cd4771,1,Alexey Serbin,2018-11-01 03:32:45+00:00,['fec218bf644bb8f8a4b3edccf9a559600ab38659'],68,740,808,1357178,5,0.088942308,0.125,0.646634615,2337
4ec2598a355bbbd1c00c4bdc03d37bafe04d0d5f,0,Alexey Serbin,2018-11-01 03:32:50+00:00,['81bba2472b469996c3a0d8ed9f6412fe29cd4771'],3,222,225,1357403,2,0,0.983695652,0.983695652,2337
32a4fe168aab97a0905283506da498304774748f,0,Hao Hao,2018-11-01 20:03:56+00:00,['4ec2598a355bbbd1c00c4bdc03d37bafe04d0d5f'],6,104,110,1357513,3,0.234375,1,0.765625,2337
137775bdd81aa60ba0949537d0acc5b044ebc8ea,1,Will Berkeley,2018-11-02 17:43:09+00:00,['32a4fe168aab97a0905283506da498304774748f'],272,295,567,1358080,6,0,0,0,2337
6548ea5b22dee052cee80f328f1afdbdf0ab15f4,0,Adar Dembo,2018-11-02 21:06:57+00:00,['137775bdd81aa60ba0949537d0acc5b044ebc8ea'],19,55,74,1358154,5,,,,2338
71c1aa6800e3919bab611e21886d3afaab2fd124,0,Alexey Serbin,2018-11-02 21:07:58+00:00,['6548ea5b22dee052cee80f328f1afdbdf0ab15f4'],12,24,36,1358190,2,0,1,0.375,2338
086d8a02a1d67c9e8d579df754ba4668cca4f649,0,Grant Henke,2018-11-05 18:21:48+00:00,['71c1aa6800e3919bab611e21886d3afaab2fd124'],0,287,287,1358477,3,0,1,1,2341
000f2cde16a5d318927c9180333bb6937b04cb6e,0,Hao Hao,2018-11-05 19:21:05+00:00,['086d8a02a1d67c9e8d579df754ba4668cca4f649'],117,994,1111,1359588,14,0.372013652,0.819112628,0.645051195,2347
d63fbc9b2ebd6b08634f127261c089ea3c1643bb,0,Will Berkeley,2018-11-05 21:05:21+00:00,['000f2cde16a5d318927c9180333bb6937b04cb6e'],7,8,15,1359603,1,,,,2347
038c6bc05794653ccba4e8290d7858c20c07e5c3,0,Will Berkeley,2018-11-06 16:30:57+00:00,['d63fbc9b2ebd6b08634f127261c089ea3c1643bb'],3,6,9,1359612,1,0,0,1,2347
e172df405aef47b1339c9879b835baf69b539f8c,0,Andrew Wong,2018-11-06 20:55:31+00:00,['038c6bc05794653ccba4e8290d7858c20c07e5c3'],56,272,328,1359940,13,0.0125,0.9625,0.74375,2347
8e9345a79849ed3e96a85dc5240e0a4e709b2055,1,Alexey Serbin,2018-11-06 21:59:21+00:00,['e172df405aef47b1339c9879b835baf69b539f8c'],140,456,596,1360536,6,0.037190083,0.673553719,0.520661157,2347
6ce61d6e67f3cb54ed034fda9c5dd443970ea454,0,Alexey Serbin,2018-11-06 22:28:12+00:00,['8e9345a79849ed3e96a85dc5240e0a4e709b2055'],4,59,63,1360599,1,0,1,1,2347
aa20ef0576cd9e2cf4a035ecdf6dbd746d94c586,0,Grant Henke,2018-11-06 23:07:14+00:00,['6ce61d6e67f3cb54ed034fda9c5dd443970ea454'],8,30,38,1360637,4,0,1,1,2347
af00c4c9b86772e8d26608b21774e7fc21a88425,1,Adar Dembo,2018-11-07 17:32:24+00:00,['aa20ef0576cd9e2cf4a035ecdf6dbd746d94c586'],3,5,8,1360645,1,0,1,0,2347
43e7bb1f8135f37375f5188cd8252b0cbd809fd5,0,Hao Hao,2018-11-07 17:46:26+00:00,['af00c4c9b86772e8d26608b21774e7fc21a88425'],1,13,14,1360659,2,0,1,1,2347
ee817a85e6844b00226f09c31930d10fdcba91c2,0,Will Berkeley,2018-11-07 18:27:15+00:00,['43e7bb1f8135f37375f5188cd8252b0cbd809fd5'],0,19,19,1360678,1,0,0,1,2347
ecdeac7d3814ba4785b3ed1ba41aeef7079debdc,0,Mike Percy,2018-11-07 19:06:01+00:00,['ee817a85e6844b00226f09c31930d10fdcba91c2'],3,5,8,1360686,1,,,,2347
17061dd13a43a3a82d05ad92d2535b0d421cd835,0,Alexey Serbin,2018-11-07 21:48:32+00:00,['ecdeac7d3814ba4785b3ed1ba41aeef7079debdc'],7,15,22,1360708,4,1,1,1,2347
c5665046cb9f441e096650b8d10154598cf80fb8,0,Andrew Wong,2018-11-08 03:10:39+00:00,['17061dd13a43a3a82d05ad92d2535b0d421cd835'],5,15,20,1360728,2,0,0,1,2347
3906d94a462b9a5b6af50010c48f5a23de54477c,0,Alexey Serbin,2018-11-08 16:52:12+00:00,['c5665046cb9f441e096650b8d10154598cf80fb8'],2,4,6,1360734,1,,,,2347
2083695473ee1635e0298049044a9f28b3459644,0,Adar Dembo,2018-11-08 19:02:10+00:00,['3906d94a462b9a5b6af50010c48f5a23de54477c'],31,138,169,1360903,7,0.014705882,1,1,2347
f1eac9c5ac87b00c45814c4714c639e889928bc7,0,Grant Henke,2018-11-08 19:04:39+00:00,['2083695473ee1635e0298049044a9f28b3459644'],41,47,88,1360991,1,1,1,1,2347
2fbdef6688ab76c508d360a04cf6f75890242e6f,0,Adar Dembo,2018-11-08 19:28:10+00:00,['f1eac9c5ac87b00c45814c4714c639e889928bc7'],0,7,7,1360998,1,,,,2347
af86a1fbd6c6944dfe55a6e472ad0351faf9a74e,0,Alexey Serbin,2018-11-08 20:42:22+00:00,['2fbdef6688ab76c508d360a04cf6f75890242e6f'],20,54,74,1361072,1,0,0,1,2347
1fc87e9930258384b981ab166b3c2fca93d5e21c,1,Adar Dembo,2018-11-09 04:20:13+00:00,['af86a1fbd6c6944dfe55a6e472ad0351faf9a74e'],1,11,12,1361084,2,1,1,1,2347
1e27c9fc4ca9d92d0a053a24e76f1420aac0abbf,1,Adar Dembo,2018-11-09 04:23:04+00:00,['1fc87e9930258384b981ab166b3c2fca93d5e21c'],46,116,162,1361246,13,0,0,0.071428571,2347
51736f330935a516c14e923e286c7b3f7e73de02,1,Grant Henke,2018-11-13 14:27:39+00:00,['1e27c9fc4ca9d92d0a053a24e76f1420aac0abbf'],4,8,12,1361258,1,,,,2347
c136efe47a0ebacebe6774701ffa06fc9d41a189,0,Grant Henke,2018-11-13 14:28:37+00:00,['51736f330935a516c14e923e286c7b3f7e73de02'],26,96,122,1361380,2,0.634146341,1,0.243902439,2347
7621a6d5ce78e462cfeb4b667d6d96d3c12f1624,0,Grant Henke,2018-11-13 18:53:01+00:00,['c136efe47a0ebacebe6774701ffa06fc9d41a189'],0,1,1,1361381,1,1,1,1,2347
eec20423b113392f6901b2c56da5646340ca878b,0,Adar Dembo,2018-11-14 17:57:50+00:00,['7621a6d5ce78e462cfeb4b667d6d96d3c12f1624'],3,2,5,1361386,1,,,,2347
240695332bef5e3e50d4473ad4c19f7b4786bc1b,0,Adar Dembo,2018-11-14 23:42:31+00:00,['eec20423b113392f6901b2c56da5646340ca878b'],8,21,29,1361415,3,0,0,1,2347
b22f9d7e86a05c559bffcfd6b897da5bc2aba4ce,0,Alexey Serbin,2018-11-15 01:41:04+00:00,['240695332bef5e3e50d4473ad4c19f7b4786bc1b'],4,5,9,1361424,1,,,,2347
3efc113bed03e72408e2d7d792d8267d86575f81,0,Adar Dembo,2018-11-16 18:28:07+00:00,['b22f9d7e86a05c559bffcfd6b897da5bc2aba4ce'],2,8,10,1361434,2,0.833333333,1,1,2347
0f3696448b3f4eba40b094192b3fb52d8b19517e,0,Alexey Serbin,2018-11-16 21:59:28+00:00,['3efc113bed03e72408e2d7d792d8267d86575f81'],13,15,28,1361462,1,,,,2347
b8e6498987731cfa4cbabcf817e1de600f96101f,0,Will Berkeley,2018-11-20 10:12:43+00:00,['0f3696448b3f4eba40b094192b3fb52d8b19517e'],0,131,131,1361593,2,0,0,0.009803922,2347
77c729d58360d56de7b2bdab9304b867faee02a8,0,Will Berkeley,2018-11-20 10:12:53+00:00,['b8e6498987731cfa4cbabcf817e1de600f96101f'],5,10,15,1361608,2,0,1,1,2347
e2cfbbf6bc56f1dcf6d7402b813f41c09711a3e8,0,Alexey Serbin,2018-11-20 16:59:58+00:00,['77c729d58360d56de7b2bdab9304b867faee02a8'],1,6,7,1361615,1,1,1,1,2347
1eb82924a44ad710259186bc0fc88c65d0e4878e,0,Will Berkeley,2018-11-20 19:18:35+00:00,['e2cfbbf6bc56f1dcf6d7402b813f41c09711a3e8'],0,3,3,1361618,1,,,,2347
27baa0c99a4f4f075e2a9cc70323a358081e09e5,0,Alexey Serbin,2018-11-20 23:59:44+00:00,['1eb82924a44ad710259186bc0fc88c65d0e4878e'],0,8,8,1361626,1,,,,2347
b8595f8fcb34e42c649b9f90dd5ddec527747d44,0,Andrew Wong,2018-11-21 01:21:50+00:00,['27baa0c99a4f4f075e2a9cc70323a358081e09e5'],0,40,40,1361666,2,,,,2347
7437626f42b30811720d59e792bc905662efd2b3,0,Will Berkeley,2018-11-21 01:31:15+00:00,['b8595f8fcb34e42c649b9f90dd5ddec527747d44'],13,90,103,1361769,5,0,0.196428571,1,2348
66b06de7b14621f821141ac7f9ec4ba96cad5af1,0,Andrew Wong,2018-11-21 01:41:57+00:00,['7437626f42b30811720d59e792bc905662efd2b3'],4,4,8,1361777,3,,,,2348
307de65bd219bdad78dfc9f52e3638fbcd8cb730,0,Andrew Wong,2018-11-21 05:12:52+00:00,['66b06de7b14621f821141ac7f9ec4ba96cad5af1'],2,2,4,1361781,1,,,,2348
b8e3299746fa6571d660eef705d17c65ef55d16b,0,Andrew Wong,2018-11-21 16:40:16+00:00,['307de65bd219bdad78dfc9f52e3638fbcd8cb730'],10,17,27,1361808,1,,,,2348
f28e8bb81ee760fda8462738e3bc4d54f414a282,0,Andrew Wong,2018-11-22 01:45:14+00:00,['b8e3299746fa6571d660eef705d17c65ef55d16b'],12,12,24,1361832,1,0,1,1,2348
b37f264fbb4f798ee9743ed87e145cd92a7fc63d,0,Alexey Serbin,2018-11-26 14:23:26+00:00,['f28e8bb81ee760fda8462738e3bc4d54f414a282'],28,22,50,1361882,1,1,1,0,2348
f65211ba415d43dd6615bc28cfe2576bc0a43489,1,Will Berkeley,2018-11-26 16:52:58+00:00,['b37f264fbb4f798ee9743ed87e145cd92a7fc63d'],45,297,342,1362224,4,0,0.991869919,0.991869919,2348
b2097e4b9e2eb3cfca6435b1ec05971215494d36,0,Alexey Serbin,2018-11-26 20:29:01+00:00,['f65211ba415d43dd6615bc28cfe2576bc0a43489'],53,88,141,1362365,3,0,0,0.875,2348
74aa53f1347eb3d4a2b37bc898cd516143ff76d3,0,Mike Percy,2018-11-26 21:23:00+00:00,['b2097e4b9e2eb3cfca6435b1ec05971215494d36'],11,1,12,1362377,1,0.833333333,0.666666667,0.833333333,2348
7fee0ec15384f8301866d45788c31a058116df04,0,Attila Bukor,2018-11-28 09:20:20+00:00,['74aa53f1347eb3d4a2b37bc898cd516143ff76d3'],0,97,97,1362474,1,,,,2348
e60e9bfe6e3a81f90639f74c4a10790e46938d03,0,Will Berkeley,2018-11-29 22:21:24+00:00,['7fee0ec15384f8301866d45788c31a058116df04'],12,411,423,1362897,15,0.051851852,0.855555556,1,2349
94b066bb3623ee386f24e1ac567303cdd5ee91a6,0,Adar Dembo,2018-12-03 18:57:59+00:00,['e60e9bfe6e3a81f90639f74c4a10790e46938d03'],15,15,30,1362927,1,,,,2349
0008990b6591d8859c5a3ef60f120a5afc7c4406,0,Grant Henke,2018-12-06 19:07:50+00:00,['94b066bb3623ee386f24e1ac567303cdd5ee91a6'],0,3,3,1362930,1,,,,2349
d927675b0af52adfd03a52265337ee1dc1609fa4,0,Mike Percy,2018-12-07 03:43:24+00:00,['0008990b6591d8859c5a3ef60f120a5afc7c4406'],80,55,135,1363065,9,1,0.5,0.5,2349
9f4657ab56366df541eddce12850726038d95fd0,1,Mike Percy,2018-12-07 03:45:13+00:00,['d927675b0af52adfd03a52265337ee1dc1609fa4'],92,473,565,1363630,11,0.182795699,0.456989247,0.306451613,2350
c931e57076d2cd9a0bcc6adf6b59a21a37116b3e,0,Mike Percy,2018-12-07 03:45:28+00:00,['9f4657ab56366df541eddce12850726038d95fd0'],26,112,138,1363768,7,0.268292683,0,0.317073171,2350
ae5eeedba49bc1db86e5f63f1e642cc0068dcf81,1,Mike Percy,2018-12-07 03:47:32+00:00,['c931e57076d2cd9a0bcc6adf6b59a21a37116b3e'],9,294,303,1364071,5,0.138297872,0.138297872,0.962765957,2350
164ec90d743f65495b42ad8eb8631e2e4b88d187,0,Mike Percy,2018-12-07 22:41:22+00:00,['ae5eeedba49bc1db86e5f63f1e642cc0068dcf81'],17,67,84,1364155,2,1,1,1,2351
77eadefa15cf976bd45d322ef3bc66726fadd1c8,0,Adar Dembo,2018-12-11 20:25:14+00:00,['164ec90d743f65495b42ad8eb8631e2e4b88d187'],4,33,37,1364192,1,,,,2351
93211b34c6864e8755964d7ba4658ae5476571a4,0,Grant Henke,2018-12-12 22:12:45+00:00,['77eadefa15cf976bd45d322ef3bc66726fadd1c8'],29,26,55,1364247,7,,,,2351
5395dce782d16094c006d5bc023e4c457e5b8bb4,0,Adar Dembo,2018-12-12 23:45:59+00:00,['93211b34c6864e8755964d7ba4658ae5476571a4'],152,622,774,1365021,4,0.724299065,0.901869159,0.612149533,2353
90096493df3c5af68fa85585819e9f45e8af3159,0,Grant Henke,2018-12-14 00:34:58+00:00,['5395dce782d16094c006d5bc023e4c457e5b8bb4'],1,3,4,1365025,1,,,,2353
72328e9de0450a85174f7710daf3c792ca768929,0,Will Berkeley,2018-12-14 18:48:41+00:00,['90096493df3c5af68fa85585819e9f45e8af3159'],1,0,1,1365026,1,,,,2353
9be2911c908acfa8b8cc30775599a4607660d3ac,0,Alexey Serbin,2018-12-14 21:00:01+00:00,['72328e9de0450a85174f7710daf3c792ca768929'],2,5,7,1365033,1,0,0,1,2353
ce52b150e8a8879c9ef2ec577c0e6665d75539a6,0,Alexey Serbin,2018-12-14 21:00:07+00:00,['9be2911c908acfa8b8cc30775599a4607660d3ac'],3,3,6,1365039,1,,,,2353
7663c94db22cfadd1d2049b1c8f0128bf6fb4e4f,0,Alexey Serbin,2018-12-15 00:13:43+00:00,['ce52b150e8a8879c9ef2ec577c0e6665d75539a6'],11,14,25,1365064,1,,,,2353
421f7ecd4def40f0eb90b9916f8c0f63eadaa7c7,0,Andrew Wong,2018-12-15 06:18:01+00:00,['7663c94db22cfadd1d2049b1c8f0128bf6fb4e4f'],1,1,2,1365066,1,,,,2353
aeda712e2a48029eb36265e418bdc041eed97cff,0,Mike Percy,2018-12-18 23:25:19+00:00,['421f7ecd4def40f0eb90b9916f8c0f63eadaa7c7'],14,29,43,1365109,3,0,0.615384615,0.615384615,2353
0c73cada0450b9f90f6afcf954c8f8fd0e1186ac,1,Grant Henke,2018-12-19 21:23:12+00:00,['aeda712e2a48029eb36265e418bdc041eed97cff'],63,109,172,1365281,9,0.75,1,1,2354
97a42f69bae008a04cb837def07965bc13586ade,0,Alexey Serbin,2018-12-20 17:16:46+00:00,['0c73cada0450b9f90f6afcf954c8f8fd0e1186ac'],34,59,93,1365374,3,0,0,0.5,2354
b3b008bda91880ec0577b909572ddd80255508bf,0,Grant Henke,2018-12-20 19:29:37+00:00,['97a42f69bae008a04cb837def07965bc13586ade'],4,385,389,1365763,5,0.511764706,0.547058824,0.741176471,2356
ae98ccacc24da9a9b023c902d05f2cbd2543a98b,1,Adar Dembo,2018-12-20 22:11:19+00:00,['b3b008bda91880ec0577b909572ddd80255508bf'],24,159,183,1365946,3,0.288888889,1,1,2356
f63539f950f64579726c6126058e21331df031cc,0,Mike Percy,2018-12-21 01:22:10+00:00,['ae98ccacc24da9a9b023c902d05f2cbd2543a98b'],0,23,23,1365969,1,,,,2357
fc947fd7ddc8db5bebd81cf7a8ef7c35f88a4cdc,0,Mike Percy,2018-12-21 01:22:26+00:00,['f63539f950f64579726c6126058e21331df031cc'],20,360,380,1366349,7,0.173553719,1,0.73553719,2362
8525a9336b2bea0023d9eba7cc4beb97ea99cf1f,0,Attila Bukor,2018-12-21 19:18:04+00:00,['fc947fd7ddc8db5bebd81cf7a8ef7c35f88a4cdc'],0,16,16,1366365,1,,,,2362
236fdfe83ded3098d16380c9e11f65f93f25144f,0,Mike Percy,2018-12-21 22:43:56+00:00,['8525a9336b2bea0023d9eba7cc4beb97ea99cf1f'],82,221,303,1366668,11,0.16,1,1,2363
4a3e7c0006555c872d0e3a0d78b94a1edfab0d21,0,Will Berkeley,2018-12-21 23:03:08+00:00,['236fdfe83ded3098d16380c9e11f65f93f25144f'],13,130,143,1366811,12,0.279411765,0.779411765,0.985294118,2363
7337cf5fbffa954dab9f21fe6115f6df3ba7c6c7,0,Alexey Serbin,2019-01-02 20:17:04+00:00,['4a3e7c0006555c872d0e3a0d78b94a1edfab0d21'],3,4,7,1366818,1,,,,2363
c7a2d69fbd4f0a6f3b0938c31a439049f3733767,0,Alexey Serbin,2019-01-03 01:53:05+00:00,['7337cf5fbffa954dab9f21fe6115f6df3ba7c6c7'],98,131,229,1367047,2,0,0,0.933333333,2363
91f104d3c2ee4965a4c81564e2851acf4cc0cdf2,1,Andrew Wong,2019-01-03 02:36:05+00:00,['c7a2d69fbd4f0a6f3b0938c31a439049f3733767'],592,735,1327,1368374,22,1,1,1,2365
2fa5884a1ba27e518de579811d36b84a25616656,0,Andrew Wong,2019-01-03 02:43:38+00:00,['91f104d3c2ee4965a4c81564e2851acf4cc0cdf2'],10,22,32,1368406,1,,,,2365
8864cb284877aa8e2dafb2ca25d6d8b3b82c9ced,0,Mike Percy,2019-01-03 17:40:16+00:00,['2fa5884a1ba27e518de579811d36b84a25616656'],20,60,80,1368486,2,1,1,1,2365
3ce9af404a1081b02404316ab49b4a323bedbaf7,0,Adar Dembo,2019-01-03 23:12:04+00:00,['8864cb284877aa8e2dafb2ca25d6d8b3b82c9ced'],21,35,56,1368542,1,,,,2365
83b70f8a95f3411587ed00fba6f9e0e75a583cfd,0,Will Berkeley,2019-01-04 17:35:15+00:00,['3ce9af404a1081b02404316ab49b4a323bedbaf7'],137,444,581,1369123,7,0.063829787,0.395744681,0.038297872,2365
d4481c03c34172bcd44f80b98112a8bed4956844,0,Mike Percy,2019-01-04 19:03:16+00:00,['83b70f8a95f3411587ed00fba6f9e0e75a583cfd'],59,140,199,1369322,2,1,1,1,2366
5a4309eb01b659dfe0912f381c79e1ddb179da6c,1,Adar Dembo,2019-01-04 20:10:03+00:00,['d4481c03c34172bcd44f80b98112a8bed4956844'],30,34,64,1369386,1,0,0,1,2366
861ecc12f4a67dc5988240fe1149d2f7572cb0de,0,Alexey Serbin,2019-01-04 20:51:23+00:00,['5a4309eb01b659dfe0912f381c79e1ddb179da6c'],65,60,125,1369511,1,,,,2366
08dadc9f6cb5726165719436696b52bf2689b3d9,1,Mike Percy,2019-01-04 23:14:27+00:00,['861ecc12f4a67dc5988240fe1149d2f7572cb0de'],0,470,470,1369981,2,0.509677419,0.716129032,0.787096774,2368
678dbac6fb05d0370e40e6645d4b1ec530fa0180,0,Alexey Serbin,2019-01-05 01:21:37+00:00,['08dadc9f6cb5726165719436696b52bf2689b3d9'],146,216,362,1370343,22,,,,2368
22b1bc35f5c6e80f6ec34013c88cbe88848f5fd3,0,Will Berkeley,2019-01-07 18:14:14+00:00,['678dbac6fb05d0370e40e6645d4b1ec530fa0180'],1,1,2,1370345,2,,,,2368
f6761b947637b143543dc8d42d1056f0128815f9,0,Adar Dembo,2019-01-08 05:16:39+00:00,['22b1bc35f5c6e80f6ec34013c88cbe88848f5fd3'],6,7,13,1370358,1,,,,2368
af21add028e8d35665af226ed5043a0035043dd7,0,Alexey Serbin,2019-01-08 23:10:20+00:00,['f6761b947637b143543dc8d42d1056f0128815f9'],38,38,76,1370434,1,,,,2368
7ca5fc6aebd2d543ba9d53a3f802c12a0ea6cc84,0,Alexey Serbin,2019-01-09 00:42:41+00:00,['af21add028e8d35665af226ed5043a0035043dd7'],0,85,85,1370519,8,,,,2368
1147921160738f690615026afe44452e1a5bdb6c,0,Andrew Wong,2019-01-09 05:41:30+00:00,['7ca5fc6aebd2d543ba9d53a3f802c12a0ea6cc84'],0,3,3,1370522,1,0,0,1,2368
b63d9219eb6c20d76f61f072af958940891b5c48,0,Adar Dembo,2019-01-09 06:21:36+00:00,['1147921160738f690615026afe44452e1a5bdb6c'],141,129,270,1370792,3,1,0.428571429,0.428571429,2368
920c21aa123feb04b40df4d310f469678d26a8c4,1,Adar Dembo,2019-01-09 07:03:42+00:00,['b63d9219eb6c20d76f61f072af958940891b5c48'],64,89,153,1370945,1,1,1,1,2368
17b5efd4784caf6847f3b786632b79b9893a47c1,0,Andrew Wong,2019-01-09 08:29:35+00:00,['920c21aa123feb04b40df4d310f469678d26a8c4'],13,60,73,1371018,6,0.125,0.916666667,0.208333333,2368
6103f8786358df1766ba41c8d8dc2feb9c8c6f53,0,Will Berkeley,2019-01-09 09:16:26+00:00,['17b5efd4784caf6847f3b786632b79b9893a47c1'],5,6,11,1371029,1,,,,2368
5e334de24e016192413c23ea2554d49406df1985,0,Mike Percy,2019-01-09 17:29:38+00:00,['6103f8786358df1766ba41c8d8dc2feb9c8c6f53'],1,10,11,1371040,1,,,,2368
b0086fe1b9bcc1e22cb5ed134cd5c3ffa9a9e2d7,0,Attila Bukor,2019-01-09 18:10:04+00:00,['5e334de24e016192413c23ea2554d49406df1985'],2,2,4,1371044,2,,,,2368
2831c91ac75c5b950dc918e80ef47750f9eaa893,0,Will Berkeley,2019-01-09 19:09:10+00:00,['b0086fe1b9bcc1e22cb5ed134cd5c3ffa9a9e2d7'],24,156,180,1371224,7,0.058823529,0.058823529,0.794117647,2368
8fb302289b7fe8eefa9aa3cd9fb1ae97ac4ae5ec,0,Will Berkeley,2019-01-09 23:53:29+00:00,['2831c91ac75c5b950dc918e80ef47750f9eaa893'],13,48,61,1371285,3,0.066666667,0.8,1,2368
eae3504a05fd4931418398b99d6d8a97d16d7ed1,1,Will Berkeley,2019-01-10 02:15:01+00:00,['8fb302289b7fe8eefa9aa3cd9fb1ae97ac4ae5ec'],37,170,207,1371492,10,0.525423729,0.406779661,0.93220339,2369
7c17dc2ceeec0c27f7b36ff24bd5a725026d8da8,0,Will Berkeley,2019-01-10 02:16:11+00:00,['eae3504a05fd4931418398b99d6d8a97d16d7ed1'],61,75,136,1371628,11,1,1,1,2369
7274710bb9210ae812619545540ccf08b052d3c8,0,Will Berkeley,2019-01-10 02:56:15+00:00,['7c17dc2ceeec0c27f7b36ff24bd5a725026d8da8'],38,143,181,1371809,7,0,0.392156863,0.411764706,2369
5646a05917230fa3f4156099c29a77559fdd2cea,0,Will Berkeley,2019-01-10 02:56:18+00:00,['7274710bb9210ae812619545540ccf08b052d3c8'],81,81,162,1371971,1,,,,2369
0fcb8890c64e948099a2bd156452ecfe15376b5f,0,Alexey Serbin,2019-01-10 21:53:29+00:00,['5646a05917230fa3f4156099c29a77559fdd2cea'],7,11,18,1371989,1,,,,2369
441fc769661d32ab846dbb44bc9b668145eee7b2,0,Grant Henke,2019-01-10 22:21:36+00:00,['0fcb8890c64e948099a2bd156452ecfe15376b5f'],1,5,6,1371995,1,0,1,1,2369
61c44785763219df1225108dbde6ac6ada70e087,1,Grant Henke,2019-01-10 22:21:43+00:00,['441fc769661d32ab846dbb44bc9b668145eee7b2'],8,11,19,1372014,3,0,1,1,2369
d51889f70beaac138ece3a3ea00633d1165038d3,0,Grant Henke,2019-01-10 23:01:27+00:00,['61c44785763219df1225108dbde6ac6ada70e087'],2,2,4,1372018,1,,,,2369
969c46e0dc59c04537282ddc5c2d377f09b8fc17,1,Grant Henke,2019-01-11 01:25:18+00:00,['d51889f70beaac138ece3a3ea00633d1165038d3'],37,70,107,1372125,2,0.304347826,1,0.565217391,2369
389f997ed4c83f045a6dbc6823805cc5fc61b5e8,0,Mike Percy,2019-01-11 02:32:32+00:00,['969c46e0dc59c04537282ddc5c2d377f09b8fc17'],0,1,1,1372126,1,0,0,1,2369
6b9719cb48b4c8b932fadd0f37299179b03b9f32,0,Will Berkeley,2019-01-12 05:12:32+00:00,['389f997ed4c83f045a6dbc6823805cc5fc61b5e8'],0,100,100,1372226,1,,,,2369
3450c78d2990dfc65c38e47661901fc68fdf8ced,0,Andrew Wong,2019-01-14 08:15:05+00:00,['6b9719cb48b4c8b932fadd0f37299179b03b9f32'],4,8,12,1372238,1,,,,2369
3277fe3f9990a10faae08a218db7ec6d6577a8dc,0,Mike Percy,2019-01-16 17:03:26+00:00,['3450c78d2990dfc65c38e47661901fc68fdf8ced'],8,37,45,1372283,1,,,,2369
0c501979bea01cfb834be0e2c9e456c6d5751e53,1,Adar Dembo,2019-01-17 21:54:34+00:00,['3277fe3f9990a10faae08a218db7ec6d6577a8dc'],61,269,330,1372613,3,0.141791045,0.895522388,1,2369
f336020da4d12d135813c4ab68954ef104885d77,0,Will Berkeley,2019-01-18 02:45:17+00:00,['0c501979bea01cfb834be0e2c9e456c6d5751e53'],30,61,91,1372704,6,0.904761905,1,0.428571429,2369
110716dee6800d79491564b995c18ddc5183704d,0,Will Berkeley,2019-01-18 04:58:17+00:00,['f336020da4d12d135813c4ab68954ef104885d77'],5,5,10,1372714,1,,,,2369
190404016ffb916f0e00bb254adfa68ae529aaed,0,Will Berkeley,2019-01-19 00:08:19+00:00,['110716dee6800d79491564b995c18ddc5183704d'],23,39,62,1372776,3,0,0.466666667,1,2369
530dd2239455a400e3adc0036c07d1194791b76a,0,Will Berkeley,2019-01-19 00:08:24+00:00,['190404016ffb916f0e00bb254adfa68ae529aaed'],5,13,18,1372794,1,0,1,0.125,2369
c1c187aa620fbcd0cb51781907ff6fefe08b0853,1,Will Berkeley,2019-01-19 00:08:30+00:00,['530dd2239455a400e3adc0036c07d1194791b76a'],92,105,197,1372991,3,0,0.25,1,2369
7f1d02f90ba8236f441ad8fe2fa63f07ed3c200d,0,Alexey Serbin,2019-01-19 00:28:05+00:00,['c1c187aa620fbcd0cb51781907ff6fefe08b0853'],17,54,71,1373062,1,0,0,1,2369
04bfc8c3b81e7c3ee816f607383a4eaaef92c8a2,0,Adar Dembo,2019-01-23 07:00:38+00:00,['7f1d02f90ba8236f441ad8fe2fa63f07ed3c200d'],0,5,5,1373067,1,0,1,1,2369
5b1d17f228d8c948390e25f2d439560270855bc5,0,Adar Dembo,2019-01-23 17:35:37+00:00,['04bfc8c3b81e7c3ee816f607383a4eaaef92c8a2'],1,8,9,1373076,1,,,,2369
9ea54330645af044817894dbf1c0d5b8a5185822,0,Will Berkeley,2019-01-23 21:40:44+00:00,['5b1d17f228d8c948390e25f2d439560270855bc5'],23,74,97,1373173,6,0,0.9,0.9,2369
9443a69b0d81c65a174874661e90a13e5792d55b,0,Adar Dembo,2019-01-23 22:33:03+00:00,['9ea54330645af044817894dbf1c0d5b8a5185822'],2,30,32,1373205,2,0,0.904761905,1,2369
bc2369ea50f5b4b4cc6371444871b44f04ed62d1,0,Will Berkeley,2019-01-23 22:54:43+00:00,['9443a69b0d81c65a174874661e90a13e5792d55b'],3,26,29,1373234,2,0.904761905,0.904761905,0.523809524,2369
9098f442e3bc727ab7fc57508de6dd092fffd522,0,Hao Hao,2019-01-23 23:07:52+00:00,['bc2369ea50f5b4b4cc6371444871b44f04ed62d1'],78,533,611,1373845,15,0.226086957,0.556521739,0.882608696,2370
4677fd71a3c95b1fc4ab1fbbfecacda54ff8a532,1,Hao Hao,2019-01-23 23:52:35+00:00,['9098f442e3bc727ab7fc57508de6dd092fffd522'],142,168,310,1374155,13,0.375,1,1,2370
111f1843084dedf378898310fcf3e85f1e38a7e1,1,Adar Dembo,2019-01-24 01:10:53+00:00,['4677fd71a3c95b1fc4ab1fbbfecacda54ff8a532'],74,100,174,1374329,5,0,1,1,2370
371fc8dc99dc2cba5aa53e7181564951d1be6151,1,Adar Dembo,2019-01-24 01:10:57+00:00,['111f1843084dedf378898310fcf3e85f1e38a7e1'],36,97,133,1374462,3,0.333333333,0.688888889,1,2370
a9f0f767080172e14cc746c5ea3ca64f945f9d39,0,Andrew Wong,2019-01-24 02:41:07+00:00,['371fc8dc99dc2cba5aa53e7181564951d1be6151'],3,4,7,1374469,1,0,0,0,2370
daf04ea1d2baf6374c6e63bd92c2b23b3f167c7e,0,Adar Dembo,2019-01-25 00:09:37+00:00,['a9f0f767080172e14cc746c5ea3ca64f945f9d39'],29,349,378,1374847,2,0,0.643274854,0.754385965,2370
a7e3df11b239a9b54fe8accc0156129b43b33ac7,0,Adar Dembo,2019-01-25 00:56:42+00:00,['daf04ea1d2baf6374c6e63bd92c2b23b3f167c7e'],21,38,59,1374906,4,1,1,1,2370
33d387866d7f1ce2f7b51d8173d6f4833c2416fc,0,Adar Dembo,2019-01-25 00:57:36+00:00,['a7e3df11b239a9b54fe8accc0156129b43b33ac7'],302,294,596,1375502,57,1,0.333333333,1,2370
432c3a1f1fc403b4869a57d92dd91ddffa4712da,1,Adar Dembo,2019-01-25 05:14:38+00:00,['33d387866d7f1ce2f7b51d8173d6f4833c2416fc'],316,345,661,1376163,9,1,1,1,2370
5629cc7c9c780a035536fe355170e53cc6231cb2,1,Adar Dembo,2019-01-25 05:14:41+00:00,['432c3a1f1fc403b4869a57d92dd91ddffa4712da'],7,49,56,1376219,3,0.423076923,0.423076923,1,2370
847ceb84d16af822375eb44eaee83403ee4f82e7,0,Hao Hao,2019-01-25 19:56:52+00:00,['5629cc7c9c780a035536fe355170e53cc6231cb2'],16,40,56,1376275,6,0.333333333,1,1,2370
bf41627f6f2f4993a99bc7181b1d2d74d70ee90d,0,Grant Henke,2019-01-25 23:15:20+00:00,['847ceb84d16af822375eb44eaee83403ee4f82e7'],0,817,817,1377092,8,,,,2377
628322523420c6024f911357dec33626af9a915a,0,Grant Henke,2019-01-25 23:15:26+00:00,['bf41627f6f2f4993a99bc7181b1d2d74d70ee90d'],1,3,4,1377096,1,,,,2377
f1a6335ab3a55b3838338c4591a634d761c7344f,0,Grant Henke,2019-01-26 01:28:11+00:00,['628322523420c6024f911357dec33626af9a915a'],3,7,10,1377106,1,0,0,1,2377
3988ab934a0d34a4342fd3b6a97720944b7e5aeb,0,Hao Hao,2019-01-28 18:30:59+00:00,['f1a6335ab3a55b3838338c4591a634d761c7344f'],5,8,13,1377119,1,1,1,1,2377
174aa26fe17ea7b8d90e64372bfa3d27cb4b9bd5,0,Will Berkeley,2019-01-28 19:53:39+00:00,['3988ab934a0d34a4342fd3b6a97720944b7e5aeb'],0,5,5,1377124,1,,,,2377
1f1f875cfb6a26b55821edd236f81f28ce06759b,0,Will Berkeley,2019-01-28 23:28:03+00:00,['174aa26fe17ea7b8d90e64372bfa3d27cb4b9bd5'],1,12,13,1377137,2,,,,2377
c7c902a08b8229612078357c7bb65927e4e4dbac,0,Hao Hao,2019-01-28 23:46:45+00:00,['1f1f875cfb6a26b55821edd236f81f28ce06759b'],8,15,23,1377160,2,0,0,1,2377
0f6d33b4a29873197952335a5777ccf9163fc307,0,Alexey Serbin,2019-01-28 23:55:28+00:00,['c7c902a08b8229612078357c7bb65927e4e4dbac'],45,313,358,1377518,14,0,0.126984127,1,2377
0afeddf9e530762e0e47beb7428982763715c746,0,Will Berkeley,2019-01-29 17:39:00+00:00,['0f6d33b4a29873197952335a5777ccf9163fc307'],29,694,723,1378241,9,0.115646259,0.648526077,0.73015873,2379
3047db9283432746a3282b180d41f08a97d4aa3f,0,Will Berkeley,2019-01-29 17:40:29+00:00,['0afeddf9e530762e0e47beb7428982763715c746'],28,118,146,1378387,10,0.140625,0.9375,1,2379
ebe62653101e670a4d4c8358ec9fa7a1824c4420,0,Mike Percy,2019-01-29 22:15:38+00:00,['3047db9283432746a3282b180d41f08a97d4aa3f'],32,62,94,1378481,7,0,0,1,2379
f46d2202e19939d137be0e7ff1aad9525f2f54fa,0,Grant Henke,2019-01-30 20:28:41+00:00,['ebe62653101e670a4d4c8358ec9fa7a1824c4420'],2,4,6,1378487,1,0,1,1,2379
4d4c5e1f4b2348cd2552fe1d78372412bca134e7,0,Grant Henke,2019-01-30 20:28:45+00:00,['f46d2202e19939d137be0e7ff1aad9525f2f54fa'],3,10,13,1378500,2,1,1,1,2379
9ac3b295a9cf41316e100f5f1745d3c6120d6c48,0,Grant Henke,2019-01-30 20:28:54+00:00,['4d4c5e1f4b2348cd2552fe1d78372412bca134e7'],0,2,2,1378502,1,,,,2379
caf8f7dce0c8d3bfd5761c7d5c59e25e64f9352c,0,Andrew Wong,2019-01-30 23:49:33+00:00,['9ac3b295a9cf41316e100f5f1745d3c6120d6c48'],3,47,50,1378552,2,0,1,1,2379
03827b13337dd2dc06a9478f12c5cfd4eda3c164,0,Mike Percy,2019-01-31 00:10:08+00:00,['caf8f7dce0c8d3bfd5761c7d5c59e25e64f9352c'],1,63,64,1378616,1,,,,2379
588416694c0543f33d3287f7d8547875a8adf51d,0,Alexey Serbin,2019-01-31 00:31:21+00:00,['03827b13337dd2dc06a9478f12c5cfd4eda3c164'],7,125,132,1378748,3,,,,2379
4f7544fda7f5e2b66752f6ef046eb421fe5b1fd9,0,Andrew Wong,2019-01-31 18:33:29+00:00,['588416694c0543f33d3287f7d8547875a8adf51d'],28,74,102,1378850,6,0,1,1,2379
146d1a8af8c874fce5b82d8d45bffe6afdab1b5d,0,Alexey Serbin,2019-01-31 19:07:45+00:00,['4f7544fda7f5e2b66752f6ef046eb421fe5b1fd9'],28,71,99,1378949,5,0,0,0.757575758,2379
32c4627a8a0641efd6c155c9b24e39c1a4776f8d,0,Grant Henke,2019-01-31 20:09:22+00:00,['146d1a8af8c874fce5b82d8d45bffe6afdab1b5d'],7,11,18,1378967,2,1,1,1,2379
f167cc686311748648514e07cb77b5a22ae98433,0,Grant Henke,2019-01-31 20:58:16+00:00,['32c4627a8a0641efd6c155c9b24e39c1a4776f8d'],3,3,6,1378973,2,,,,2380
d0490b34dddfb1ca4dcb9255c5fc94b5cc4cfb2e,0,Adar Dembo,2019-02-01 00:24:46+00:00,['f167cc686311748648514e07cb77b5a22ae98433'],0,26,26,1378999,1,,,,2380
0b80b0abae99c56db20e96249981a48886c56d33,1,Adar Dembo,2019-02-01 00:26:23+00:00,['d0490b34dddfb1ca4dcb9255c5fc94b5cc4cfb2e'],23,34,57,1379056,1,1,1,1,2380
919a4814da26d70644d1fb8f356027a879917438,1,Adar Dembo,2019-02-01 00:26:27+00:00,['0b80b0abae99c56db20e96249981a48886c56d33'],204,200,404,1379460,10,1,0,0,2380
990bb4d134c8fd9bd4621cd2fb9827d47f623db7,0,Grant Henke,2019-02-01 21:17:46+00:00,['919a4814da26d70644d1fb8f356027a879917438'],6,254,260,1379720,4,,,,2382
530b852c8d8e13e0559a4cfa847e55baae31cac8,0,Will Berkeley,2019-02-02 01:02:14+00:00,['990bb4d134c8fd9bd4621cd2fb9827d47f623db7'],2,13,15,1379735,2,0,0,1,2382
1f45141f63488548fde19735582b715af6a45e95,0,Andrew Wong,2019-02-02 01:13:08+00:00,['530b852c8d8e13e0559a4cfa847e55baae31cac8'],14,14,28,1379763,4,,,,2382
2107f23064704bee07bee317b6b131fdf63b151f,0,Adar Dembo,2019-02-02 18:49:05+00:00,['1f45141f63488548fde19735582b715af6a45e95'],19,103,122,1379885,2,0.127272727,0.509090909,0.963636364,2382
4fcd3e895188fffc73adcfa9eae0df33bfca0b07,0,Grant Henke,2019-02-03 05:15:15+00:00,['2107f23064704bee07bee317b6b131fdf63b151f'],152,289,441,1380326,4,,,,2382
2551c7786c8c8383d3d7be51928da866919b6133,0,Mike Percy,2019-02-03 05:21:09+00:00,['4fcd3e895188fffc73adcfa9eae0df33bfca0b07'],36,56,92,1380418,1,1,1,1,2382
725ad7e981e2f59e7224cf0c81853daa9fae4171,0,Grant Henke,2019-02-04 15:43:38+00:00,['2551c7786c8c8383d3d7be51928da866919b6133'],0,17,17,1380435,2,,,,2382
ce653d465bc0f89a212de25280788d420d20f79d,0,Grant Henke,2019-02-04 15:43:44+00:00,['725ad7e981e2f59e7224cf0c81853daa9fae4171'],7,98,105,1380540,3,,,,2383
47a96ae53f4aa712c6a79c04a54a442aeedc8d4d,0,Mike Percy,2019-02-04 18:17:26+00:00,['ce653d465bc0f89a212de25280788d420d20f79d'],2,27,29,1380569,1,,,,2383
37cf6dd2a8cceee5e3b28bc0276580446f6b4ddd,0,Will Berkeley,2019-02-04 19:31:08+00:00,['47a96ae53f4aa712c6a79c04a54a442aeedc8d4d'],3,7,10,1380579,2,0,0.75,1,2383
ddfe8f7f6ebc18330e24e375f9b70183c64dcaeb,0,Grant Henke,2019-02-04 22:27:34+00:00,['37cf6dd2a8cceee5e3b28bc0276580446f6b4ddd'],26,52,78,1380657,1,,,,2383
8dc7904951a9950dc7729f992441c693d4413bfb,0,Andrew Wong,2019-02-05 19:23:32+00:00,['ddfe8f7f6ebc18330e24e375f9b70183c64dcaeb'],1,19,20,1380677,2,0.25,0.75,1,2383
7263cd86c372d4ca71816ab97cbbf11bacf8e456,1,Will Berkeley,2019-02-05 21:18:47+00:00,['8dc7904951a9950dc7729f992441c693d4413bfb'],1,113,114,1380791,4,0.846153846,0.884615385,0.846153846,2384
fd089bf259d3e17f2801ee3122c6fe7844efd4ae,0,Alexey Serbin,2019-02-05 22:10:16+00:00,['7263cd86c372d4ca71816ab97cbbf11bacf8e456'],23,25,48,1380839,1,0,0,1,2384
453e008e6a57f631d8660101630b4dda60129d65,0,Alexey Serbin,2019-02-05 22:10:25+00:00,['fd089bf259d3e17f2801ee3122c6fe7844efd4ae'],1,11,12,1380851,1,0,0,1,2384
73cda9f611246902b982708ffa0baeed63c220b2,0,Grant Henke,2019-02-05 22:14:24+00:00,['453e008e6a57f631d8660101630b4dda60129d65'],94,226,320,1381171,6,,,,2385
10487386a15dd1882c4bbe81876e2bb7eb1b272c,0,Will Berkeley,2019-02-05 22:40:20+00:00,['73cda9f611246902b982708ffa0baeed63c220b2'],2,3,5,1381176,1,0,0,1,2385
2b9b579bbde4956f8bd4f4e2c3dd08a49b9b8bc0,0,Alexey Serbin,2019-02-05 22:40:21+00:00,['10487386a15dd1882c4bbe81876e2bb7eb1b272c'],0,57,57,1381233,2,0,0.843137255,0.843137255,2385
8772540d9d7ac95785e370714e58e2f8ddd81804,0,Will Berkeley,2019-02-05 23:21:11+00:00,['2b9b579bbde4956f8bd4f4e2c3dd08a49b9b8bc0'],21,19,40,1381273,4,0.666666667,0,0,2385
bf84ea1ec17cb267d0221d97669b2e491be8d65b,0,Andrew Wong,2019-02-06 04:12:47+00:00,['8772540d9d7ac95785e370714e58e2f8ddd81804'],27,93,120,1381393,2,0.139534884,0,1,2385
238f46c7fb293eabff31f7b2e397a5e4986249f3,0,Andrew Wong,2019-02-06 04:54:21+00:00,['bf84ea1ec17cb267d0221d97669b2e491be8d65b'],6,35,41,1381434,1,,,,2385
72fe3d8a0617f18c9a4563bc250b3041e3fff7ca,0,Andrew Wong,2019-02-06 04:54:27+00:00,['238f46c7fb293eabff31f7b2e397a5e4986249f3'],0,1,1,1381435,1,,,,2385
0c02110fd2f1c7ca0eef127ba6c3ac1b051f07ab,0,Andrew Wong,2019-02-06 05:22:27+00:00,['72fe3d8a0617f18c9a4563bc250b3041e3fff7ca'],36,133,169,1381604,5,0.666666667,0.1,1,2386
b2d95c625dc08f9d8af080bd1b192cc0a3b710b4,0,Mike Percy,2019-02-06 05:24:29+00:00,['0c02110fd2f1c7ca0eef127ba6c3ac1b051f07ab'],9,52,61,1381665,4,0.909090909,0.954545455,0.954545455,2386
57481a8398a3239cbd7cd38b7d873d6dad64ad18,0,Andrew Wong,2019-02-06 17:07:29+00:00,['b2d95c625dc08f9d8af080bd1b192cc0a3b710b4'],31,31,62,1381727,3,,,,2386
936694acf47f923d623d80e287cfc44faeb0de72,0,Andrew Wong,2019-02-06 20:00:45+00:00,['57481a8398a3239cbd7cd38b7d873d6dad64ad18'],1,2,3,1381730,1,1,1,1,2386
a8367e862d5a71d920cbc94ea58d3bf5135418c6,0,Alexey Serbin,2019-02-06 22:42:19+00:00,['936694acf47f923d623d80e287cfc44faeb0de72'],6,40,46,1381776,1,0,1,1,2386
ce60d6408f5ac0dd4f9f53ce2ab9a9ce76aad211,0,Will Berkeley,2019-02-07 21:24:56+00:00,['a8367e862d5a71d920cbc94ea58d3bf5135418c6'],15,92,107,1381883,3,0.578947368,1,0.649122807,2386
02792a8a1a740d8eeef98c35bebb492666c143eb,0,Alexey Serbin,2019-02-07 22:15:50+00:00,['ce60d6408f5ac0dd4f9f53ce2ab9a9ce76aad211'],26,63,89,1381972,6,0.363636364,0.727272727,0.727272727,2386
4433fa5c787df13f95c595af15c470f89bd2957d,0,Alexey Serbin,2019-02-07 22:16:02+00:00,['02792a8a1a740d8eeef98c35bebb492666c143eb'],56,367,423,1382395,7,0.280821918,0.280821918,0.130136986,2386
ccb92b18988240ca8192cf622f6fc617a00d0646,0,Andrew Wong,2019-02-07 22:22:17+00:00,['4433fa5c787df13f95c595af15c470f89bd2957d'],37,600,637,1383032,12,0.294915254,0.718644068,0.440677966,2389
5f637f7030cf41411ac651b6b289735f0c367a56,0,Grant Henke,2019-02-08 17:41:30+00:00,['ccb92b18988240ca8192cf622f6fc617a00d0646'],2,10,12,1383044,3,,,,2389
09d53a50993ef0fc5bbe42291e0c98ed2217280e,0,Grant Henke,2019-02-11 18:40:33+00:00,['5f637f7030cf41411ac651b6b289735f0c367a56'],4,4,8,1383052,2,,,,2389
4f3baf7ef3d2bd2156709188cdb8d0a030ab8070,0,Grant Henke,2019-02-11 18:40:40+00:00,['09d53a50993ef0fc5bbe42291e0c98ed2217280e'],6,19,25,1383077,3,1,1,1,2389
420eba8fe517403c5cd49f102b413a5b1347fc10,0,Mike Percy,2019-02-11 22:16:30+00:00,['4f3baf7ef3d2bd2156709188cdb8d0a030ab8070'],12,660,672,1383749,9,,,,2394
626938ed8b9a5bcfe2c1c4a6be44af81f1eafb6b,0,Mike Percy,2019-02-11 22:16:39+00:00,['420eba8fe517403c5cd49f102b413a5b1347fc10'],1,2,3,1383752,1,,,,2394
5f3470a77aba10d8c784405bda987a01d6b33035,0,Todd Lipcon,2019-02-12 05:38:37+00:00,['626938ed8b9a5bcfe2c1c4a6be44af81f1eafb6b'],1,1,2,1383754,1,,,,2394
714a680ad73afc06fb64fc2966c176d8608b5068,0,Grant Henke,2019-02-12 22:33:25+00:00,['5f3470a77aba10d8c784405bda987a01d6b33035'],1,26,27,1383781,3,0.461538462,1,1,2394
d760b27e4a27d0836b1f80c4a058e5f176b149eb,0,Adar Dembo,2019-02-12 23:11:17+00:00,['714a680ad73afc06fb64fc2966c176d8608b5068'],1,1,2,1383783,1,,,,2394
3e0fcc943b12517667347222d5708a6c46477e7e,0,Andrew Wong,2019-02-12 23:12:59+00:00,['d760b27e4a27d0836b1f80c4a058e5f176b149eb'],0,4,4,1383787,1,0,1,1,2394
1b138a06a4222ad822a2b5cf05dcd0bf988371ef,0,Alexey Serbin,2019-02-13 00:46:44+00:00,['3e0fcc943b12517667347222d5708a6c46477e7e'],8,43,51,1383838,2,1,1,1,2394
5cfd81f7ed89b46dfdacc2389159fadbb59f0d8b,0,Alexey Serbin,2019-02-13 02:05:01+00:00,['1b138a06a4222ad822a2b5cf05dcd0bf988371ef'],1,1,2,1383840,1,,,,2394
3db5c2151fb99c9ca834d6651a893610bc6e4ccd,1,Grant Henke,2019-02-13 17:01:28+00:00,['5cfd81f7ed89b46dfdacc2389159fadbb59f0d8b'],8,430,438,1384278,6,0.279792746,0.740932642,0.911917098,2396
562b5f12f721b533cc2cb868c15a2f85d9e0114b,0,Grant Henke,2019-02-13 17:28:30+00:00,['3db5c2151fb99c9ca834d6651a893610bc6e4ccd'],48,188,236,1384514,6,0.130434783,1,1,2396
9b698e98e87024e64f8fd515fd8241c21ba130bb,0,Grant Henke,2019-02-13 17:52:37+00:00,['562b5f12f721b533cc2cb868c15a2f85d9e0114b'],1,24,25,1384539,1,1,1,1,2396
4a6cf6deb1fb100b1183ca02e1f9a5d7a8bc3cb0,0,Grant Henke,2019-02-13 19:25:07+00:00,['9b698e98e87024e64f8fd515fd8241c21ba130bb'],46,121,167,1384706,2,1,1,1,2397
a98186406b90ea5a53e06e7e98c34f6c5810de52,0,Andrew Wong,2019-02-13 19:43:49+00:00,['4a6cf6deb1fb100b1183ca02e1f9a5d7a8bc3cb0'],95,1347,1442,1386148,20,0.4,0.753703704,0.831481481,2400
57f0dae3678b7514d1fcf9231f21930287ac3e13,0,Andrew Wong,2019-02-14 00:51:41+00:00,['a98186406b90ea5a53e06e7e98c34f6c5810de52'],1,1,2,1386150,1,,,,2400
4e2451dbf18db1faf9545ac1f9663d378b9f5efe,0,Alexey Serbin,2019-02-14 01:30:40+00:00,['57f0dae3678b7514d1fcf9231f21930287ac3e13'],6,28,34,1386184,2,,,,2400
b289960e81d58c377cc9a7c23f2746ecf9eb5057,0,Alexey Serbin,2019-02-14 21:49:07+00:00,['4e2451dbf18db1faf9545ac1f9663d378b9f5efe'],2,2,4,1386188,1,,,,2400
3574e3eb55a6bc815a9095636c4e08edcfa7c6b0,0,Will Berkeley,2019-02-15 01:25:25+00:00,['b289960e81d58c377cc9a7c23f2746ecf9eb5057'],3,4,7,1386195,1,1,0,1,2400
8f6d2f9a492d9ab3e92e6e24d2b9810ab108379a,0,Alexey Serbin,2019-02-15 02:32:43+00:00,['3574e3eb55a6bc815a9095636c4e08edcfa7c6b0'],6,20,26,1386221,2,0,1,1,2400
d76422c080fe5ded3acec3dab8f16148396c7468,0,Andrew Wong,2019-02-15 05:15:48+00:00,['8f6d2f9a492d9ab3e92e6e24d2b9810ab108379a'],18,4,22,1386243,2,1,0,1,2400
812955ee0983a5b0dfba2d50529f8972c25bf411,0,Will Berkeley,2019-02-15 18:03:58+00:00,['d76422c080fe5ded3acec3dab8f16148396c7468'],4,4,8,1386251,1,,,,2400
c23dc847d1daf54c41bf03618f06fd7f9b1277bd,0,Adar Dembo,2019-02-15 18:06:58+00:00,['812955ee0983a5b0dfba2d50529f8972c25bf411'],23,44,67,1386318,22,0,0.363636364,0.818181818,2400
3e5fb43cd4349cfc019b717bce5876c802f97683,0,Will Berkeley,2019-02-15 18:10:18+00:00,['c23dc847d1daf54c41bf03618f06fd7f9b1277bd'],1,100,101,1386419,4,0.152941176,1,1,2400
bd5926ee50cbde7b86cbd2342b61e8370836fd4a,0,Will Berkeley,2019-02-15 18:10:36+00:00,['3e5fb43cd4349cfc019b717bce5876c802f97683'],1,68,69,1386488,4,0,1,1,2400
794a9ecf8a23652ab8d5f65b4536f3850de1d445,0,Grant Henke,2019-02-15 18:15:12+00:00,['bd5926ee50cbde7b86cbd2342b61e8370836fd4a'],2,2,4,1386492,1,,,,2400
c72a45c49435b6800fa435aab6ed73adac288baf,1,Todd Lipcon,2019-02-15 19:40:42+00:00,['794a9ecf8a23652ab8d5f65b4536f3850de1d445'],12,109,121,1386613,17,0.442622951,0.770491803,0.983606557,2400
df105295b3da8515992815c6cddabb031fc7b089,0,Will Berkeley,2019-02-15 23:37:24+00:00,['c72a45c49435b6800fa435aab6ed73adac288baf'],24,108,132,1386745,2,0,0.222222222,1,2400
2be008763cda5eb28c0dfa8863e396575fce91ab,0,Grant Henke,2019-02-16 15:40:26+00:00,['df105295b3da8515992815c6cddabb031fc7b089'],3,9,12,1386757,1,,,,2400
30ebeee99217760eeec08d0de8b2f75a26aa8b92,0,Grant Henke,2019-02-19 22:49:34+00:00,['2be008763cda5eb28c0dfa8863e396575fce91ab'],1,8,9,1386766,3,,,,2400
3e3bd1ccbc2b4b070c733b36b1971de63977428b,0,Andrew Wong,2019-02-20 01:55:36+00:00,['30ebeee99217760eeec08d0de8b2f75a26aa8b92'],17,28,45,1386811,3,1,1,1,2400
083ab136f2864624d7d59f9cbf819251d1dfba88,0,Alexey Serbin,2019-02-20 15:23:01+00:00,['3e3bd1ccbc2b4b070c733b36b1971de63977428b'],8,16,24,1386835,2,,,,2400
aca61daa38f49be977315fd2dbb021f1b085f848,0,Adar Dembo,2019-02-20 18:28:55+00:00,['083ab136f2864624d7d59f9cbf819251d1dfba88'],7,12,19,1386854,7,,,,2400
b21671890d36e7e858d631927acd7b16268f7f2a,0,Adar Dembo,2019-02-20 18:29:07+00:00,['aca61daa38f49be977315fd2dbb021f1b085f848'],0,7,7,1386861,1,,,,2400
6278a2e0590c17ff2c56d0f3d3070c9c4acd10db,0,Adar Dembo,2019-02-20 18:29:08+00:00,['b21671890d36e7e858d631927acd7b16268f7f2a'],32,163,195,1387056,5,0.857142857,1,1,2400
87084f44d0a91fa0380a4cfa81c2dc7897efef01,0,Alexey Serbin,2019-02-20 22:05:04+00:00,['6278a2e0590c17ff2c56d0f3d3070c9c4acd10db'],2,5,7,1387063,1,0,1,1,2400
fad69bb5104ebb8cf335f345475ffb02cec71329,0,Will Berkeley,2019-02-20 22:08:04+00:00,['87084f44d0a91fa0380a4cfa81c2dc7897efef01'],1,37,38,1387101,2,0,1,1,2400
cdb5a0f3a0d8659225bdb4ff6437a0cf3448d3c6,0,Alexey Serbin,2019-02-21 01:52:07+00:00,['fad69bb5104ebb8cf335f345475ffb02cec71329'],9,151,160,1387261,4,0.375,1,1,2400
25af98eaf4c712bef9033721ea58b3f0d0a78c32,0,Alexey Serbin,2019-02-21 21:55:27+00:00,['cdb5a0f3a0d8659225bdb4ff6437a0cf3448d3c6'],0,12,12,1387273,1,1,1,1,2400
8b251ea3e31e2c3fd3a4e8d7b2094ddb21acc814,0,Adar Dembo,2019-02-25 19:32:20+00:00,['25af98eaf4c712bef9033721ea58b3f0d0a78c32'],2,12,14,1387287,1,1,1,1,2400
6eec549f052b49bc7f53673c67d23c389cc24314,0,Alexey Serbin,2019-02-25 21:05:56+00:00,['8b251ea3e31e2c3fd3a4e8d7b2094ddb21acc814'],34,50,84,1387371,1,0,1,1,2400
c557576195f6283718fa8baf1279ee1e2ad52b74,0,Will Berkeley,2019-02-26 06:26:20+00:00,['6eec549f052b49bc7f53673c67d23c389cc24314'],1,5,6,1387377,2,0,1,0,2400
16d9a863d0f31069965aee1a71912a65339a4160,0,Andrew Wong,2019-02-26 18:54:30+00:00,['c557576195f6283718fa8baf1279ee1e2ad52b74'],82,296,378,1387755,6,0.314685315,1,1,2400
877b9f64d8b93353647e7dab2e66b4783322f7ad,1,Will Berkeley,2019-02-26 20:53:54+00:00,['16d9a863d0f31069965aee1a71912a65339a4160'],183,421,604,1388359,33,0.262411348,0.957446809,0.070921986,2400
06f8c1750148334bc893f2dd8c6f9042094d09bf,0,Andrew Wong,2019-02-26 22:54:30+00:00,['877b9f64d8b93353647e7dab2e66b4783322f7ad'],1,0,1,1388360,1,,,,2400
6302811eb73efdfd2a3da84c25f5d6589302dee1,0,Grant Henke,2019-02-26 22:55:36+00:00,['06f8c1750148334bc893f2dd8c6f9042094d09bf'],1,36,37,1388397,3,0.444444444,0.444444444,0.722222222,2400
c1330bc2f71cd2e84ac16fdcdc4373841afc7bdb,0,Will Berkeley,2019-02-26 23:33:40+00:00,['6302811eb73efdfd2a3da84c25f5d6589302dee1'],8,16,24,1388421,1,0,1,1,2400
e144c14813d8df4c7c0477b1eabbcb9be9a9a9e8,0,Andrew Wong,2019-02-26 23:47:30+00:00,['c1330bc2f71cd2e84ac16fdcdc4373841afc7bdb'],0,3,3,1388424,1,0,1,1,2400
2711b5c02b4d46c055cbf734ade99e8837f361a1,0,Will Berkeley,2019-02-27 00:52:54+00:00,['e144c14813d8df4c7c0477b1eabbcb9be9a9a9e8'],37,33,70,1388494,5,0,0,,2400
3698f387c46372eb47ef4d2d4f7c48dacc2e39c3,0,Will Berkeley,2019-02-27 01:29:39+00:00,['2711b5c02b4d46c055cbf734ade99e8837f361a1'],2,2,4,1388498,2,,,,2400
853d3bfd1f5c5c00a069da3b04706e4ef0914b7d,1,Will Berkeley,2019-02-27 01:29:49+00:00,['3698f387c46372eb47ef4d2d4f7c48dacc2e39c3'],143,98,241,1388739,12,1,1,0.148148148,2400
dc77bb514b6df7cdb00a6c64185c509443c0217f,0,Will Berkeley,2019-02-27 07:20:32+00:00,['853d3bfd1f5c5c00a069da3b04706e4ef0914b7d'],1,1,2,1388741,1,,,,2400
1aae0784f675adf103de5fab19ae6cfb44723635,0,Attila Bukor,2019-02-27 19:27:24+00:00,['dc77bb514b6df7cdb00a6c64185c509443c0217f'],2,7,9,1388750,1,,,,2400
cfc7b9d45ada5b3f36be045ec0dfa81c16b2cc99,0,Mike Percy,2019-02-28 00:12:17+00:00,['1aae0784f675adf103de5fab19ae6cfb44723635'],27,68,95,1388845,3,0,0.526315789,1,2400
e3da9518787732f84d29ea7e9622745088ecdbba,0,Mike Percy,2019-02-28 01:12:42+00:00,['cfc7b9d45ada5b3f36be045ec0dfa81c16b2cc99'],11,87,98,1388943,8,0.630434783,1,1,2400
7cb582ccbf6a87de3a1f25ae5e5b9776a338f183,0,Mike Percy,2019-02-28 01:12:49+00:00,['e3da9518787732f84d29ea7e9622745088ecdbba'],1,46,47,1388990,2,0,0.903225806,1,2400
8f850190c5255ab2d072af1155bc674f84986b41,0,Mike Percy,2019-02-28 01:12:55+00:00,['7cb582ccbf6a87de3a1f25ae5e5b9776a338f183'],1,33,34,1389024,3,0,1,1,2400
8fbf1cc2bbae3b9967e3c89bd20a254364d25edc,0,Will Berkeley,2019-02-28 18:07:48+00:00,['8f850190c5255ab2d072af1155bc674f84986b41'],233,232,465,1389489,26,,,,2401
ae6bbcaabd20955119f1d945d276589538dae928,0,Alexey Serbin,2019-02-28 20:28:31+00:00,['8fbf1cc2bbae3b9967e3c89bd20a254364d25edc'],0,421,421,1389910,4,0.418848168,1,0.848167539,2404
4ace91713ad81e72135cca7679e8a6e63b4382b5,1,Alexey Serbin,2019-02-28 20:28:39+00:00,['ae6bbcaabd20955119f1d945d276589538dae928'],127,210,337,1390247,12,0,1,1,2404
4d4552d06934f14ed608cf6eb330428df6e8368d,0,Alexey Serbin,2019-03-01 22:10:34+00:00,['4ace91713ad81e72135cca7679e8a6e63b4382b5'],0,2,2,1390249,1,0,1,0,2404
e2c611b583a50864d997056ae2786a586a656d54,0,Grant Henke,2019-03-05 22:49:35+00:00,['4d4552d06934f14ed608cf6eb330428df6e8368d'],498,12,510,1390759,11,,,,2404
5953357c486062781ac04db7e61fea0ea0a3cc07,1,Mike Percy,2019-03-06 07:15:15+00:00,['e2c611b583a50864d997056ae2786a586a656d54'],80,309,389,1391148,8,0.099236641,0.221374046,0,2404
cd66342f581307522b3718237db15b252ff59a3e,0,Mike Percy,2019-03-06 07:15:23+00:00,['5953357c486062781ac04db7e61fea0ea0a3cc07'],12,6,18,1391166,2,1,0,0,2404
3e2fcf23663e8667ed97b4a275bbcbafaca9c40c,0,Attila Bukor,2019-03-06 08:58:04+00:00,['cd66342f581307522b3718237db15b252ff59a3e'],1,6,7,1391173,1,,,,2404
feebbb2649a659bbd6b2fdcfc6a347eafbccba2b,0,Todd Lipcon,2019-03-07 03:43:25+00:00,['3e2fcf23663e8667ed97b4a275bbcbafaca9c40c'],13,140,153,1391326,4,0,0.515625,1,2405
0a05f613e44885ad1be2759ad4944233e5e6df74,0,Adar Dembo,2019-03-07 04:45:52+00:00,['feebbb2649a659bbd6b2fdcfc6a347eafbccba2b'],3,10,13,1391339,2,0,1,1,2405
1dca63d778a9cb2e90d78af48ea97595607fc517,0,Mike Percy,2019-03-07 17:45:33+00:00,['0a05f613e44885ad1be2759ad4944233e5e6df74'],1,132,133,1391472,1,,,,2405
e0557a26843085a7264800ec2d5ff92e125375c0,0,Adar Dembo,2019-03-07 18:58:17+00:00,['1dca63d778a9cb2e90d78af48ea97595607fc517'],27,252,279,1391751,11,1,1,1,2406
78d2c2f33cd914b3fd392f49bf93a8596724a073,0,Will Berkeley,2019-03-07 19:05:42+00:00,['e0557a26843085a7264800ec2d5ff92e125375c0'],6,93,99,1391850,6,0.769230769,0.948717949,0.974358974,2406
cfef3f6fdb0188bc2fa8c63c4c94ee1a49fa90ea,0,Adar Dembo,2019-03-07 21:23:20+00:00,['78d2c2f33cd914b3fd392f49bf93a8596724a073'],2,2,4,1391854,1,,,,2406
c74e67830ea88942029433aa6ebacc45b924369d,0,Will Berkeley,2019-03-07 21:29:07+00:00,['cfef3f6fdb0188bc2fa8c63c4c94ee1a49fa90ea'],28,113,141,1391995,6,0.274509804,0.019607843,1,2406
3fb02043a369d6ae3af87b914dad97b685bfda02,0,Todd Lipcon,2019-03-08 05:45:00+00:00,['c74e67830ea88942029433aa6ebacc45b924369d'],1,1,2,1391997,1,,,,2406
701f2f4fc9c0ce002a3f72fcdc537610be4e7ac5,0,Alexey Serbin,2019-03-08 19:15:15+00:00,['3fb02043a369d6ae3af87b914dad97b685bfda02'],1,5,6,1392003,1,,,,2406
cae0a621a39d68a297780d9557dcdf8ab3d87aca,0,Attila Bukor,2019-03-11 15:24:56+00:00,['701f2f4fc9c0ce002a3f72fcdc537610be4e7ac5'],1,1,2,1392005,1,,,,2406
9d4ed7add75b20fa46fa38cfe246fa40ba2a3cba,0,Andrew Wong,2019-03-11 17:45:26+00:00,['cae0a621a39d68a297780d9557dcdf8ab3d87aca'],3,29,32,1392037,2,0,1,1,2406
7645f5b2ea1f54777ce88c61df54422b068142e5,0,Andrew Wong,2019-03-11 17:45:33+00:00,['9d4ed7add75b20fa46fa38cfe246fa40ba2a3cba'],43,872,915,1392952,15,0.411924119,0.650406504,0.848238482,2410
717349b4e9ee7666b43a491bc5d07d55ec5de003,0,Will Berkeley,2019-03-11 18:16:33+00:00,['7645f5b2ea1f54777ce88c61df54422b068142e5'],19,20,39,1392991,2,,,,2410
0d5176412208304630a33342452cd0dfff408643,0,Adar Dembo,2019-03-12 03:41:57+00:00,['717349b4e9ee7666b43a491bc5d07d55ec5de003'],1,1,2,1392993,1,,,,2410
17fb5a10319d2bc19e8e54aa9c088335b04926e9,1,Grant Henke,2019-03-12 19:59:52+00:00,['0d5176412208304630a33342452cd0dfff408643'],5,45,50,1393043,2,0,0.740740741,1,2410
89a6a142ff9243cb986750e962fdfe6e7bfb4e78,0,Andrew Wong,2019-03-12 21:13:02+00:00,['17fb5a10319d2bc19e8e54aa9c088335b04926e9'],24,26,50,1393093,1,1,1,1,2410
549f1fb352f7de2b5b88073934d12330484741d4,0,Mike Percy,2019-03-13 00:40:56+00:00,['89a6a142ff9243cb986750e962fdfe6e7bfb4e78'],7,10,17,1393110,1,,,,2410
d17e3ef345498777e32f2b275f952abac1369a7a,0,Mike Percy,2019-03-13 04:49:59+00:00,['549f1fb352f7de2b5b88073934d12330484741d4'],40,59,99,1393209,1,0,0,0,2410
33479893bd6037c463e7cb89b08e1e016565e2c3,1,Alexey Serbin,2019-03-13 20:31:57+00:00,['d17e3ef345498777e32f2b275f952abac1369a7a'],0,46,46,1393255,1,0,1,1,2410
d56930fbcdceff911efc8ec30b5c769901888d3d,0,Alexey Serbin,2019-03-13 20:53:03+00:00,['33479893bd6037c463e7cb89b08e1e016565e2c3'],20,78,98,1393353,3,0.448275862,0.448275862,1,2410
c480a58607ad3b13c45ba0db031f3aa298bba2e0,0,Andrew Wong,2019-03-14 04:42:25+00:00,['d56930fbcdceff911efc8ec30b5c769901888d3d'],0,200,200,1393553,1,,,,2410
8f946f4d8d33755a65121d4c49b05db36bdb14f9,0,Andrew Wong,2019-03-14 04:46:14+00:00,['c480a58607ad3b13c45ba0db031f3aa298bba2e0'],31,37,68,1393621,1,,,,2410
5735f07f8b6aaf5134c66863519052936aa7487f,0,Grant Henke,2019-03-14 13:01:12+00:00,['8f946f4d8d33755a65121d4c49b05db36bdb14f9'],156,412,568,1394189,19,0.560747664,1,0.953271028,2412
dc56ca54c3b838c0d15fb26969a6db3b8123007b,0,Grant Henke,2019-03-14 14:28:13+00:00,['5735f07f8b6aaf5134c66863519052936aa7487f'],4,87,91,1394280,3,1,1,1,2413
c01796cdbd32be39ad8d82ddb80d94190010e9c4,1,Alexey Serbin,2019-03-14 22:48:15+00:00,['dc56ca54c3b838c0d15fb26969a6db3b8123007b'],143,124,267,1394547,6,1,0,0,2413
df4fd91fdf19a72f881eff2ec33d2c1417109292,0,Will Berkeley,2019-03-14 23:50:49+00:00,['c01796cdbd32be39ad8d82ddb80d94190010e9c4'],29,40,69,1394616,1,0,1,1,2413
beaae491f407d5746f509f1d2dce872e8a9ae803,0,Hao Hao,2019-03-15 05:53:27+00:00,['df4fd91fdf19a72f881eff2ec33d2c1417109292'],157,653,810,1395426,12,0.544642857,0.504464286,0.852678571,2416
bedc701f28d57414a5ef10b1947cc149b8d3240d,0,Will Berkeley,2019-03-15 17:11:31+00:00,['beaae491f407d5746f509f1d2dce872e8a9ae803'],4,8,12,1395438,1,0,0,0,2416
04e584c62e52f8d196ddbba93783007d2fc02a01,0,Will Berkeley,2019-03-15 17:11:33+00:00,['bedc701f28d57414a5ef10b1947cc149b8d3240d'],1,1,2,1395440,1,,,,2416
d5a0ac23da9d271aa3263bcd6a66a5e2a693d8c0,0,Adar Dembo,2019-03-15 17:44:55+00:00,['04e584c62e52f8d196ddbba93783007d2fc02a01'],4,4,8,1395448,1,,,,2416
3410e7f4b2dc3fb1f6c11691f16bc536fc42d375,0,Andrew Wong,2019-03-17 08:11:22+00:00,['d5a0ac23da9d271aa3263bcd6a66a5e2a693d8c0'],6,14,20,1395468,1,,,,2416
d140511fb10242993fe8d226f49c902393831865,0,Adar Dembo,2019-03-18 18:04:13+00:00,['3410e7f4b2dc3fb1f6c11691f16bc536fc42d375'],0,8,8,1395476,1,1,1,1,2416
d9be1f6623c068524e9bd65a89e25146d9b70dd5,1,Grant Henke,2019-03-18 21:42:29+00:00,['d140511fb10242993fe8d226f49c902393831865'],22,184,206,1395682,5,0.285714286,1,0.901785714,2416
be04a398c1e373ebbe56347e1eb5b4885deecaa0,0,Attila Bukor,2019-03-19 09:10:47+00:00,['d9be1f6623c068524e9bd65a89e25146d9b70dd5'],8,14,22,1395704,4,,,,2416
6889b14be66c2e276a3878da5e88b01e73a9c45d,1,Alexey Serbin,2019-03-20 04:12:56+00:00,['be04a398c1e373ebbe56347e1eb5b4885deecaa0'],49,193,242,1395946,12,0,1,0.933333333,2419
f1a3242e650848f9dd36d00189a475a26c4d4f10,1,Alexey Serbin,2019-03-20 16:04:57+00:00,['6889b14be66c2e276a3878da5e88b01e73a9c45d'],253,368,621,1396567,10,0.787234043,1,1,2419
2be6869ddfd8b0f4c22c25eab5d293b2e33f108f,0,Hao Hao,2019-03-20 16:41:07+00:00,['f1a3242e650848f9dd36d00189a475a26c4d4f10'],35,3,38,1396605,1,,,,2419
39f4637559ac29791cc385308bd63d77a5f18e56,1,Alexey Serbin,2019-03-20 19:01:14+00:00,['2be6869ddfd8b0f4c22c25eab5d293b2e33f108f'],70,273,343,1396948,7,0.56,0.5,0.61,2419
7a8c21048f0aad9ecab686782c60eeb4985643e8,1,Alexey Serbin,2019-03-21 00:23:55+00:00,['39f4637559ac29791cc385308bd63d77a5f18e56'],0,8,8,1396956,2,0.5,0.5,0.5,2419
28c706722891d20aada5d8bee4cfafe456c89561,0,Will Berkeley,2019-03-21 00:53:14+00:00,['7a8c21048f0aad9ecab686782c60eeb4985643e8'],2,9,11,1396967,1,0,1,0,2419
71f0e779554c0c3580af22df6280856e3900c294,0,Grant Henke,2019-03-21 18:52:21+00:00,['28c706722891d20aada5d8bee4cfafe456c89561'],3,3,6,1396973,1,,,,2419
7acbdb30c45e9253cdbb86193b5cb65f4f3c95a4,0,Adar Dembo,2019-03-22 00:11:50+00:00,['71f0e779554c0c3580af22df6280856e3900c294'],26,41,67,1397040,2,0.4,1,1,2419
13567924fcb4d0605d63c1ab96b7182755ea3ce5,0,Grant Henke,2019-03-22 18:06:11+00:00,['7acbdb30c45e9253cdbb86193b5cb65f4f3c95a4'],0,343,343,1397383,1,0.279816514,0.775229358,1,2420
61546c02517663bd4ac5879a9a4189e0a81e963b,1,Grant Henke,2019-03-22 18:06:16+00:00,['13567924fcb4d0605d63c1ab96b7182755ea3ce5'],71,209,280,1397663,3,0.297619048,1,1,2420
ddc83aca4daf7a02a6861e0589d32611417423e8,0,Adar Dembo,2019-03-23 22:59:02+00:00,['61546c02517663bd4ac5879a9a4189e0a81e963b'],129,161,290,1397953,7,1,0,1,2420
28f8e972fcd042a26a502cbb1f1102c487c9398d,0,Adar Dembo,2019-03-24 18:19:05+00:00,['ddc83aca4daf7a02a6861e0589d32611417423e8'],69,813,882,1398835,16,0.118867925,0.5,0.769811321,2420
4ac1d9f4b4fd477e79859d81a58e2dacbe979b2d,0,Andrew Wong,2019-03-25 17:18:50+00:00,['28f8e972fcd042a26a502cbb1f1102c487c9398d'],43,138,181,1399016,7,0.047619048,0.984126984,0.333333333,2420
66f4bb136e1bc42e8c031548b56ee1927002ac09,1,Andrew Wong,2019-03-25 17:19:32+00:00,['4ac1d9f4b4fd477e79859d81a58e2dacbe979b2d'],57,1047,1104,1400120,4,0.204334365,0.549535604,0.513931889,2420
bc63454ee7fabf46298dfd5801a8ecd5d1bab787,0,Hao Hao,2019-03-25 18:04:04+00:00,['66f4bb136e1bc42e8c031548b56ee1927002ac09'],484,1552,2036,1402156,33,0.291866029,0.66507177,0.344497608,2424
4127186583c1110d01e906a0eda49989dd26ac34,1,Todd Lipcon,2019-03-26 04:38:00+00:00,['bc63454ee7fabf46298dfd5801a8ecd5d1bab787'],0,25,25,1402181,4,0,0,0.857142857,2424
603c8845354fe8d22a103f66adae27a237785e06,0,Adar Dembo,2019-03-26 05:03:32+00:00,['4127186583c1110d01e906a0eda49989dd26ac34'],8,3,11,1402192,3,,,,2424
140163057228393edb9ddbaa0b773cd130d79119,0,Mike Percy,2019-03-26 07:06:55+00:00,['603c8845354fe8d22a103f66adae27a237785e06'],30,30,60,1402252,3,,,,2424
0a1ff196ff152c56655129666c39450b5ca5b8f7,0,Adar Dembo,2019-03-26 18:39:30+00:00,['140163057228393edb9ddbaa0b773cd130d79119'],2,2,4,1402256,1,,,,2424
f1533afeec1029649b7176c67f03b4210265d7dc,0,Adar Dembo,2019-03-26 18:39:32+00:00,['0a1ff196ff152c56655129666c39450b5ca5b8f7'],0,4,4,1402260,1,0,1,1,2424
cf8cb39f69e0818a868886413ba2ed905dd33915,0,Adar Dembo,2019-03-26 18:39:37+00:00,['f1533afeec1029649b7176c67f03b4210265d7dc'],21,22,43,1402303,7,,,,2424
d533dcbe7e8c314b1551d09a115b2f0370b8bcd7,0,Mike Percy,2019-03-26 22:58:19+00:00,['cf8cb39f69e0818a868886413ba2ed905dd33915'],0,4,4,1402307,1,0,0,1,2424
c355e8ed77b823783d670ba7c090b12355d6340e,0,Mike Percy,2019-03-26 22:58:34+00:00,['d533dcbe7e8c314b1551d09a115b2f0370b8bcd7'],59,81,140,1402447,7,1,1,0.923076923,2424
e8be768c1b7f3a1cc67596e0b554f947c41f47bb,0,Mike Percy,2019-03-26 22:58:46+00:00,['c355e8ed77b823783d670ba7c090b12355d6340e'],23,309,332,1402779,6,0.005347594,0.379679144,0.759358289,2424
5e78e4a5c0a100a6f9e0c0d6cb84450a4abfada1,1,Grant Henke,2019-03-27 12:38:18+00:00,['e8be768c1b7f3a1cc67596e0b554f947c41f47bb'],55,509,564,1403343,15,0.185483871,0.411290323,0.774193548,2424
b1acaea9dc90f2439f63f78447e1be50b8c5c4dc,0,Grant Henke,2019-03-27 13:41:13+00:00,['5e78e4a5c0a100a6f9e0c0d6cb84450a4abfada1'],1,1,2,1403345,1,,,,2424
6db10a4b99e498e2927e5844cb20f6f996938d93,0,Grant Henke,2019-03-27 20:24:00+00:00,['b1acaea9dc90f2439f63f78447e1be50b8c5c4dc'],47,133,180,1403525,4,,,,2424
60ea656b314a0daec41a0e14fd25ff2c55c3f4b5,0,Andrew Wong,2019-03-28 00:30:10+00:00,['6db10a4b99e498e2927e5844cb20f6f996938d93'],1,373,374,1403899,3,0.726256983,0.854748603,1,2426
6027f4c5cf6f9a15a7c79bf6e597f580cdb7b8c3,0,Adar Dembo,2019-03-28 04:24:35+00:00,['60ea656b314a0daec41a0e14fd25ff2c55c3f4b5'],1,1,2,1403901,1,,,,2426
610c81046de5db122decc1a0f88948fb447b9b52,0,Adar Dembo,2019-03-28 04:24:37+00:00,['6027f4c5cf6f9a15a7c79bf6e597f580cdb7b8c3'],0,69,69,1403970,3,,,,2429
ef900efdc7fe781c59e2c33d3a95d9d79ba6f6da,0,Adar Dembo,2019-03-28 04:24:43+00:00,['610c81046de5db122decc1a0f88948fb447b9b52'],11,15,26,1403996,3,1,0,0,2429
e34b410d215e9485f0b60c25b348a3b512a12b3c,0,Adar Dembo,2019-03-28 04:40:37+00:00,['ef900efdc7fe781c59e2c33d3a95d9d79ba6f6da'],0,1,1,1403997,1,0,1,1,2429
74a1d7706d99db2d9a14ed5d7c64afbcef853b20,0,Alexey Serbin,2019-03-28 06:09:04+00:00,['e34b410d215e9485f0b60c25b348a3b512a12b3c'],78,96,174,1404171,10,0.5,1,0.5,2429
7f8c6f6fc6fda1bfbeb8cac41eb023911d4eb75f,0,Andrew Wong,2019-03-28 17:15:19+00:00,['74a1d7706d99db2d9a14ed5d7c64afbcef853b20'],116,474,590,1404761,5,0.36440678,0.923728814,0.915254237,2429
319a8b3742b3ea71403ad3ae6629ee4c4eeafe66,0,Grant Henke,2019-03-28 21:33:18+00:00,['7f8c6f6fc6fda1bfbeb8cac41eb023911d4eb75f'],45,39,84,1404845,25,0.857142857,1,0.142857143,2429
2389f192725cf5cbd4d73a97ec20e02d66259e4b,0,Grant Henke,2019-03-28 21:59:28+00:00,['319a8b3742b3ea71403ad3ae6629ee4c4eeafe66'],94,47,141,1404986,8,,,,2429
e267662da792b24f6ff00ac049a27533facc1a79,0,Alexey Serbin,2019-03-29 02:12:18+00:00,['2389f192725cf5cbd4d73a97ec20e02d66259e4b'],1,776,777,1405763,8,0.397810219,0.649635036,0.912408759,2434
d486737b3f8820cb8a67d657a5755e657f76700d,0,Todd Lipcon,2019-03-29 03:10:21+00:00,['e267662da792b24f6ff00ac049a27533facc1a79'],2,2,4,1405767,1,,,,2434
20a3976d7eafc038f2b118d53066c26ddd2d4903,0,Todd Lipcon,2019-03-29 03:10:44+00:00,['d486737b3f8820cb8a67d657a5755e657f76700d'],0,9,9,1405776,1,0,0,1,2434
62d1dec5d5a5c31647d3a92ff203e103198a92d1,0,Adar Dembo,2019-03-29 04:14:16+00:00,['20a3976d7eafc038f2b118d53066c26ddd2d4903'],26,253,279,1406055,16,0.149659864,0.93877551,0.93877551,2434
13d596f86efe322e62efde0f41efed1ae3eebacc,0,Adar Dembo,2019-03-31 18:47:47+00:00,['62d1dec5d5a5c31647d3a92ff203e103198a92d1'],150,91,241,1406296,3,0.96969697,0.454545455,0,2434
44ad18c4ad0c7f25c88e3724116ebe54ce7c64a1,0,Andrew Wong,2019-03-31 19:18:20+00:00,['13d596f86efe322e62efde0f41efed1ae3eebacc'],51,58,109,1406405,1,1,1,1,2434
577caf8691fc90de688a851e663bd41873c5f45f,0,Grant Henke,2019-04-01 17:30:29+00:00,['44ad18c4ad0c7f25c88e3724116ebe54ce7c64a1'],1,5,6,1406411,1,,,,2434
23db50d3fc4cf19eccf91abc8fbd3c34c3e400d2,0,Adar Dembo,2019-04-01 18:20:09+00:00,['577caf8691fc90de688a851e663bd41873c5f45f'],0,51,51,1406462,3,1,1,1,2435
9a98aa061acc13b2636769047e930cd9bb6d4035,0,Andrew Wong,2019-04-01 21:55:26+00:00,['23db50d3fc4cf19eccf91abc8fbd3c34c3e400d2'],1,1,2,1406464,1,,,,2435
49f019668c1d148565e85a8b1b396b018d932a9f,0,Adar Dembo,2019-04-02 04:25:26+00:00,['9a98aa061acc13b2636769047e930cd9bb6d4035'],1,1,2,1406466,1,,,,2435
0ce9b05d046da01b7b098818fe5e42c1f40e9ac2,0,Alexey Serbin,2019-04-02 17:04:09+00:00,['49f019668c1d148565e85a8b1b396b018d932a9f'],3,16,19,1406485,1,0,0,1,2435
de5e98b4bbfc88f3cae20ba67231a5da83e4cbc7,0,Alexey Serbin,2019-04-02 21:17:01+00:00,['0ce9b05d046da01b7b098818fe5e42c1f40e9ac2'],129,144,273,1406758,1,1,1,1,2435
984a3e1a1240c5f36d7c0e29d065a829ca1083e0,0,Hao Hao,2019-04-03 01:04:23+00:00,['de5e98b4bbfc88f3cae20ba67231a5da83e4cbc7'],6,16,22,1406780,1,,,,2435
d929aac91831c12e7675faf2dbfd6c578996f84f,0,Adar Dembo,2019-04-03 20:44:42+00:00,['984a3e1a1240c5f36d7c0e29d065a829ca1083e0'],18,721,739,1407519,8,0.612307692,0.867692308,0.889230769,2438
8532311f2739de0ebcfa68666f6a2d7ece3ef226,0,Adar Dembo,2019-04-03 20:44:44+00:00,['d929aac91831c12e7675faf2dbfd6c578996f84f'],32,53,85,1407604,2,,,,2438
16cfb7a19aa0e817dceeb44d70062c880f701375,0,Adar Dembo,2019-04-03 20:44:47+00:00,['8532311f2739de0ebcfa68666f6a2d7ece3ef226'],43,190,233,1407837,27,,,,2438
c550fe8f55ee0a4c6838d246e00e541ef4cff460,0,Adar Dembo,2019-04-03 20:45:18+00:00,['16cfb7a19aa0e817dceeb44d70062c880f701375'],31,145,176,1408013,4,0.409836066,0.704918033,1,2438
c80a6e3ee26825692af4fefcd05725eaf1fe9669,0,Grant Henke,2019-04-03 21:10:10+00:00,['c550fe8f55ee0a4c6838d246e00e541ef4cff460'],3,5,8,1408021,1,,,,2438
2217dc78600ba3456f5e4318298739d3a480d161,0,Adar Dembo,2019-04-03 22:09:49+00:00,['c80a6e3ee26825692af4fefcd05725eaf1fe9669'],14,37,51,1408072,3,0.8125,0.8125,0.8125,2438
4fc493da48358386b9b4855e5598ff867c696ab2,0,Andrew Wong,2019-04-04 18:56:09+00:00,['2217dc78600ba3456f5e4318298739d3a480d161'],78,80,158,1408230,5,0,0,0,2438
3175ed07df9c9280adec08fea18d15acbd45a4dc,1,Will Berkeley,2019-04-04 20:47:59+00:00,['4fc493da48358386b9b4855e5598ff867c696ab2'],4,2,6,1408236,1,,,,2438
e2870925f9a07da43658447248a4e64acde398b4,1,Adar Dembo,2019-04-05 01:00:17+00:00,['3175ed07df9c9280adec08fea18d15acbd45a4dc'],68,201,269,1408505,14,0.463414634,0.780487805,0.62195122,2438
2a93f98d71bedf045b7e4a1800e047f8498dee38,0,Alexey Serbin,2019-04-05 01:33:34+00:00,['e2870925f9a07da43658447248a4e64acde398b4'],84,714,798,1409303,6,0.059278351,0.56443299,0.448453608,2438
1ae941ca51ef427fa18bef92eb0a91bfae3bfe7f,0,Adar Dembo,2019-04-05 16:02:07+00:00,['2a93f98d71bedf045b7e4a1800e047f8498dee38'],25,30,55,1409358,1,,,,2438
7fa52e0412777d5b19786f4af58770dc1036a73d,0,Adar Dembo,2019-04-05 16:06:30+00:00,['1ae941ca51ef427fa18bef92eb0a91bfae3bfe7f'],11,11,22,1409380,1,0,0,0,2438
0046d90cc5246ecda6f0c4a14c9577465279162b,0,Attila Bukor,2019-04-05 18:52:16+00:00,['7fa52e0412777d5b19786f4af58770dc1036a73d'],4,4,8,1409388,1,,,,2438
73fa1f89b450aa979add6c08b7ffe621bb6c920a,0,Adar Dembo,2019-04-08 04:26:04+00:00,['0046d90cc5246ecda6f0c4a14c9577465279162b'],1,1,2,1409390,1,,,,2438
0f61255989fa92925433187b2eaaf900c8092f5c,1,Andrew Wong,2019-04-09 06:37:21+00:00,['73fa1f89b450aa979add6c08b7ffe621bb6c920a'],1,46,47,1409437,4,1,1,0.703703704,2438
9382d072111117dc7e9410e8eeb85781e9702384,0,Alexey Serbin,2019-04-09 20:37:33+00:00,['0f61255989fa92925433187b2eaaf900c8092f5c'],15,313,328,1409765,9,0.23364486,0.785046729,1,2441
16dc218b5a26fa18dee9e36e09e86c9c38f0d55c,0,Andrew Wong,2019-04-09 20:38:14+00:00,['9382d072111117dc7e9410e8eeb85781e9702384'],48,17,65,1409830,2,0.071428571,0,0,2441
66485e18697adf108f885d9d6bde4df0ea265b00,0,Andrew Wong,2019-04-09 22:15:47+00:00,['16dc218b5a26fa18dee9e36e09e86c9c38f0d55c'],8,1,9,1409839,1,0,0,0,2441
216dc377c92c983b4693d16ef880f9ec0ebb1d8d,0,Grant Henke,2019-04-09 23:37:21+00:00,['66485e18697adf108f885d9d6bde4df0ea265b00'],0,33,33,1409872,1,,,,2441
424f1dcf41ca121406b46507356db7ca44ffd2a5,0,Andrew Wong,2019-04-10 00:01:22+00:00,['216dc377c92c983b4693d16ef880f9ec0ebb1d8d'],25,271,296,1410168,5,0,0,0.586206897,2441
49d3438f0a5ac21d8875916ad437da71752f8ddd,0,Adar Dembo,2019-04-10 00:06:42+00:00,['424f1dcf41ca121406b46507356db7ca44ffd2a5'],143,178,321,1410489,31,0.230769231,0.923076923,0.692307692,2441
36146d56c302374f75d03b22a5076def76b24199,0,Adar Dembo,2019-04-10 00:06:45+00:00,['49d3438f0a5ac21d8875916ad437da71752f8ddd'],9,144,153,1410642,2,0,1,1,2441
28f7dacd9d07f68a7bd7dbe40dda365de8b26eb8,1,Adar Dembo,2019-04-10 03:46:30+00:00,['36146d56c302374f75d03b22a5076def76b24199'],67,89,156,1410798,2,0.333333333,1,0.833333333,2441
02b614c690ac2e25065132760aaee92b26d51904,0,Grant Henke,2019-04-10 18:16:12+00:00,['28f7dacd9d07f68a7bd7dbe40dda365de8b26eb8'],3,0,3,1410801,1,,,,2441
8c4fedc1d1ecf3aede8c21231a46f1ef7e328c6f,0,Andrew Wong,2019-04-10 18:54:47+00:00,['02b614c690ac2e25065132760aaee92b26d51904'],2,3,5,1410806,1,0,0,1,2441
511d5bb536b90d1fedfec49fd48b786e5b8e9119,0,Alexey Serbin,2019-04-10 23:44:23+00:00,['8c4fedc1d1ecf3aede8c21231a46f1ef7e328c6f'],642,1232,1874,1412680,12,0.378787879,0.742424242,0.924242424,2445
945148372270f2dc56a76d5d76705cc472a3a6f0,0,Alexey Serbin,2019-04-11 01:15:56+00:00,['511d5bb536b90d1fedfec49fd48b786e5b8e9119'],20,197,217,1412897,4,0,0.010638298,0.680851064,2445
a0100eecd7f90f7e2d7a7ab509a9050e63140fcb,0,Alexey Serbin,2019-04-11 02:39:10+00:00,['945148372270f2dc56a76d5d76705cc472a3a6f0'],5,5,10,1412907,1,,,,2445
84e1e8de3da32d3a4c20930272f237e0c35aa735,0,Adar Dembo,2019-04-11 02:54:13+00:00,['a0100eecd7f90f7e2d7a7ab509a9050e63140fcb'],57,163,220,1413127,2,0,0,0.436781609,2445
054084fb69e2e55ad8ddd4b858ad5d4902db2d37,0,Adar Dembo,2019-04-11 02:54:14+00:00,['84e1e8de3da32d3a4c20930272f237e0c35aa735'],0,519,519,1413646,1,0.618012422,0.885093168,0.776397516,2446
18c32f0132721ed659fdfd9129d5f42c3aeda69a,0,Alexey Serbin,2019-04-11 23:04:19+00:00,['054084fb69e2e55ad8ddd4b858ad5d4902db2d37'],1,11,12,1413658,1,0,1,1,2446
be8fcc6879ed23c79e562a15e46310b1e9522432,0,Alexey Serbin,2019-04-12 20:16:02+00:00,['18c32f0132721ed659fdfd9129d5f42c3aeda69a'],0,386,386,1414044,1,,,,2447
db71eeb25d70253d968da27bcae92fcf2a067abe,0,Grant Henke,2019-04-12 21:47:56+00:00,['be8fcc6879ed23c79e562a15e46310b1e9522432'],3,7,10,1414054,1,,,,2447
55d2faed94077ced16b736ca5e499022b0aa4789,0,Grant Henke,2019-04-12 21:48:15+00:00,['db71eeb25d70253d968da27bcae92fcf2a067abe'],4,6,10,1414064,1,,,,2447
777338f5650ecfff76faf88050f1d9363138a095,0,Andrew Wong,2019-04-12 22:21:36+00:00,['55d2faed94077ced16b736ca5e499022b0aa4789'],8,11,19,1414083,3,0,0.666666667,1,2447
f324ba257ae1b256bf6f4f4b33e25d7937e7b086,1,Adar Dembo,2019-04-15 21:24:28+00:00,['777338f5650ecfff76faf88050f1d9363138a095'],83,171,254,1414337,7,0.365384615,0.480769231,0.480769231,2447
1567dec0865586ef93d8a8f555eea30a21228347,1,Adar Dembo,2019-04-15 22:01:22+00:00,['f324ba257ae1b256bf6f4f4b33e25d7937e7b086'],129,422,551,1414888,6,0.345238095,0.130952381,1,2447
8f8bfadcca640c308ff7b8510dec7f5522816fd5,0,Adar Dembo,2019-04-16 19:50:45+00:00,['1567dec0865586ef93d8a8f555eea30a21228347'],15,1,16,1414904,3,1,0.25,0,2447
8a85813913b9c258cbaadb0b65cef508bdee30fd,1,Grant Henke,2019-04-16 21:36:45+00:00,['8f8bfadcca640c308ff7b8510dec7f5522816fd5'],395,1123,1518,1416422,18,0.369402985,0.764925373,0.876865672,2452
b0807667134330b4ba617454aa88e05a84c0faf5,0,Adar Dembo,2019-04-17 00:58:37+00:00,['8a85813913b9c258cbaadb0b65cef508bdee30fd'],10,130,140,1416562,4,0.1875,0.75,0.75,2452
8b727489eb787f9d0667192bb1160ed64e2aa70b,0,Grant Henke,2019-04-17 02:06:42+00:00,['b0807667134330b4ba617454aa88e05a84c0faf5'],0,2,2,1416564,1,,,,2452
f2ce76f7ab4d8e2b801daef3895cefdaa4b72909,0,Alexey Serbin,2019-04-17 18:30:48+00:00,['8b727489eb787f9d0667192bb1160ed64e2aa70b'],2,1,3,1416567,1,,,,2452
b27db958c5bd99b778f739171d0bfe4d66ec9715,0,Adar Dembo,2019-04-17 21:09:50+00:00,['f2ce76f7ab4d8e2b801daef3895cefdaa4b72909'],8,262,270,1416837,6,0.125984252,0.606299213,0.57480315,2453
423814d2e4eb2281a0ccf5fc4702153a608e542a,0,Adar Dembo,2019-04-17 21:09:53+00:00,['b27db958c5bd99b778f739171d0bfe4d66ec9715'],14,41,55,1416892,3,1,1,1,2453
a4f37461dbb9655f13bbc8447d6c46b2d27e0d03,1,Adar Dembo,2019-04-17 21:09:54+00:00,['423814d2e4eb2281a0ccf5fc4702153a608e542a'],123,128,251,1417143,1,0,1,1,2453
ecc292e1b0b506b089acea1a4f5e99e56c711915,0,Adar Dembo,2019-04-17 21:46:16+00:00,['a4f37461dbb9655f13bbc8447d6c46b2d27e0d03'],62,129,191,1417334,4,0.84375,0.1875,0.4375,2453
1f61479715e9f9bc22d7e6262db030ed5b7fae8f,0,Alexey Serbin,2019-04-18 22:50:55+00:00,['ecc292e1b0b506b089acea1a4f5e99e56c711915'],11,8,19,1417353,3,0,,,2453
51a14eacfa1148bb10513a3a8a6b2ecb2e148cad,0,Alexey Serbin,2019-04-19 05:57:39+00:00,['1f61479715e9f9bc22d7e6262db030ed5b7fae8f'],79,83,162,1417515,4,,,,2453
d17f9fce684272df28e6291839f162b33796bc5c,0,Adar Dembo,2019-04-19 16:42:39+00:00,['51a14eacfa1148bb10513a3a8a6b2ecb2e148cad'],113,195,308,1417823,6,0.396226415,0.849056604,1,2453
345ce27da0d7d16ec37a56502d0939aef87f671f,0,Andrew Wong,2019-04-19 17:42:44+00:00,['d17f9fce684272df28e6291839f162b33796bc5c'],16,39,55,1417878,6,1,1,1,2453
64cdf302eee1172242fb3a76ec8f2ac3bb75d6cb,0,Adar Dembo,2019-04-21 20:58:23+00:00,['345ce27da0d7d16ec37a56502d0939aef87f671f'],3,6,9,1417887,2,0,0,1,2453
73182b0665e336e2c864235c4aceb75db081dfe2,0,Andrew Wong,2019-04-23 05:05:50+00:00,['64cdf302eee1172242fb3a76ec8f2ac3bb75d6cb'],35,581,616,1418503,7,0.109965636,0.663230241,0.759450172,2454
6be025faa8f2e36d31bcc6c4e4f65324d07a3926,0,Hao Hao,2019-04-23 06:50:04+00:00,['73182b0665e336e2c864235c4aceb75db081dfe2'],107,204,311,1418814,9,0,1,1,2454
2b023b979358cf3716c3b282ff21879bd97cec4a,1,Grant Henke,2019-04-23 17:14:53+00:00,['6be025faa8f2e36d31bcc6c4e4f65324d07a3926'],20,58,78,1418892,4,0.631578947,1,1,2454
a2265547f671f5efc5a36b8a140aa47aeb1a8be2,0,Grant Henke,2019-04-23 19:38:28+00:00,['2b023b979358cf3716c3b282ff21879bd97cec4a'],81,152,233,1419125,10,0.4,1,1,2455
963a358c7745eb5173e5168c6072242a400b2184,0,Grant Henke,2019-04-23 21:11:43+00:00,['a2265547f671f5efc5a36b8a140aa47aeb1a8be2'],16,11,27,1419152,2,0,0,0,2455
70c2992bfa6658636939d4952794de882eff1037,0,Attila Bukor,2019-04-24 08:10:23+00:00,['963a358c7745eb5173e5168c6072242a400b2184'],0,4,4,1419156,1,,,,2455
f02bd5d423fce63a9288c97a58798829f52665c2,0,Adar Dembo,2019-04-24 16:39:30+00:00,['70c2992bfa6658636939d4952794de882eff1037'],2,6,8,1419164,1,1,1,1,2455
3707cf33ccbcb015130de356e4e82d1f54636c6e,0,Adar Dembo,2019-04-24 16:39:41+00:00,['f02bd5d423fce63a9288c97a58798829f52665c2'],14,58,72,1419236,3,0.166666667,0.166666667,0.638888889,2455
10ea0ce5a636a050a1207f7ab5ecf63d178683f5,0,Adar Dembo,2019-04-24 16:39:46+00:00,['3707cf33ccbcb015130de356e4e82d1f54636c6e'],18,30,48,1419284,3,0.363636364,0.363636364,1,2455
14d4255141dbe9797283209d55a05010400ac1ca,0,Grant Henke,2019-04-24 22:40:33+00:00,['10ea0ce5a636a050a1207f7ab5ecf63d178683f5'],15,18,33,1419317,4,0.111111111,1,1,2455
b820b2469e6f45b936d765e729cf1f9ac86799b3,0,Adar Dembo,2019-04-25 03:46:12+00:00,['14d4255141dbe9797283209d55a05010400ac1ca'],9,20,29,1419346,1,,,,2455
a10d025dc13012c1a387de0607f1bd554b2038c0,0,Alexey Serbin,2019-04-25 16:31:21+00:00,['b820b2469e6f45b936d765e729cf1f9ac86799b3'],59,423,482,1419828,3,0.064516129,0.677419355,0.801843318,2455
5a8fc504dfff3004bbbd7f9441297fb78085bd83,0,Grant Henke,2019-04-25 19:55:50+00:00,['a10d025dc13012c1a387de0607f1bd554b2038c0'],2,57,59,1419887,1,0,1,1,2455
ef3fd09f16817f7fa56f1eb8ca95be671401770e,0,Grant Henke,2019-04-25 21:01:19+00:00,['5a8fc504dfff3004bbbd7f9441297fb78085bd83'],0,4,4,1419891,1,0,0,1,2455
e76864f577b34816bbbf354a85baef225307da43,0,Grant Henke,2019-04-25 21:58:48+00:00,['ef3fd09f16817f7fa56f1eb8ca95be671401770e'],151,265,416,1420307,4,1,1,0.477777778,2455
89edd3150730478a1c3b864fa13a27831a0c1eea,0,Mike Percy,2019-04-25 23:47:42+00:00,['e76864f577b34816bbbf354a85baef225307da43'],5,4,9,1420316,2,,,,2455
7ac1ed6d30a3053cb436f34b0f7b94084cb8bb31,0,Alexey Serbin,2019-04-26 04:57:24+00:00,['89edd3150730478a1c3b864fa13a27831a0c1eea'],8,171,179,1420495,4,0.084507042,1,1,2455
bacc1f3d968db00f7e6db4988c5cc9c27981755e,0,Andrew Wong,2019-04-26 17:29:56+00:00,['7ac1ed6d30a3053cb436f34b0f7b94084cb8bb31'],1,1,2,1420497,1,,,,2455
fdf2ae03216146208fff08a9b191e761fe0fe8fc,0,Alexey Serbin,2019-04-26 22:00:06+00:00,['bacc1f3d968db00f7e6db4988c5cc9c27981755e'],63,354,417,1420914,14,0.219101124,0.657303371,0.91011236,2455
b03411cf2091ace8daf5ba08b2153d8ad13ad658,0,Andrew Wong,2019-04-26 22:46:28+00:00,['fdf2ae03216146208fff08a9b191e761fe0fe8fc'],11,0,11,1420925,1,,,,2455
ecfc874319d0243b078a40cf849d6dca3a11bd3b,0,Andrew Wong,2019-04-26 22:46:36+00:00,['b03411cf2091ace8daf5ba08b2153d8ad13ad658'],10,0,10,1420935,2,,,,2455
073d9ab48d2ef341c64854a4844b8bb0a0025540,0,Attila Bukor,2019-04-27 16:44:13+00:00,['ecfc874319d0243b078a40cf849d6dca3a11bd3b'],1,1,2,1420937,1,,,,2455
9660d43069b0cda587da81232b363fda3858194e,0,Andrew Wong,2019-04-28 07:00:33+00:00,['073d9ab48d2ef341c64854a4844b8bb0a0025540'],0,1,1,1420938,1,,,,2455
9ba901a051cb281e69205abf92741bd158f40b67,0,Alexey Serbin,2019-04-28 21:51:32+00:00,['9660d43069b0cda587da81232b363fda3858194e'],112,123,235,1421173,1,0,0,0,2455
072c00c12e91be59e98183ff9b67e44af08c6045,0,Andrew Wong,2019-04-29 17:29:09+00:00,['9ba901a051cb281e69205abf92741bd158f40b67'],11,8,19,1421192,1,1,1,1,2455
762ae0f87025441edeba65004cfbead8aa67346b,0,Will Berkeley,2019-04-30 22:28:01+00:00,['072c00c12e91be59e98183ff9b67e44af08c6045'],2,3,5,1421197,2,1,0,0,2455
d4f16fc6bc3df2afa49813d9ce73f6b7233648aa,0,Will Berkeley,2019-04-30 23:15:23+00:00,['762ae0f87025441edeba65004cfbead8aa67346b'],0,4,4,1421201,1,0,0,1,2455
1610f6907f2973ddb5e3df7465faebd9af9f3855,0,Adar Dembo,2019-05-01 05:20:31+00:00,['d4f16fc6bc3df2afa49813d9ce73f6b7233648aa'],3,3,6,1421207,1,,,,2455
2a0a5ef2193a8e83bd8374772bc491594c1c0aa8,0,Adar Dembo,2019-05-01 15:56:55+00:00,['1610f6907f2973ddb5e3df7465faebd9af9f3855'],1,21,22,1421229,1,0.666666667,1,1,2455
70bbf01cec2d6a14f1b2c850f04d9298933bc518,0,Hao Hao,2019-05-01 17:14:17+00:00,['2a0a5ef2193a8e83bd8374772bc491594c1c0aa8'],2,2,4,1421233,2,,,,2455
889086d44d72e6157e08e7089af6e946af5e6955,0,Grant Henke,2019-05-02 12:44:37+00:00,['70bbf01cec2d6a14f1b2c850f04d9298933bc518'],5,42,47,1421280,5,0.25,0.5625,0.9375,2455
9b8be6ab480d28c19e867762b4f3049d4ff48512,0,Grant Henke,2019-05-02 12:44:40+00:00,['889086d44d72e6157e08e7089af6e946af5e6955'],4,11,15,1421295,2,0.333333333,0.333333333,1,2455
d256cd1e40570820ab460210a92cd5f347617b10,0,Grant Henke,2019-05-02 12:44:43+00:00,['9b8be6ab480d28c19e867762b4f3049d4ff48512'],8,7,15,1421310,2,1,0,0,2455
70e575fb706290a059c0b8ad5b0c3b4be436f3b2,0,Grant Henke,2019-05-02 12:44:46+00:00,['d256cd1e40570820ab460210a92cd5f347617b10'],2,121,123,1421433,2,0,0.686046512,0.697674419,2455
8a6faaa93f3e206ac75e8087731daccaf7ab646a,0,Grant Henke,2019-05-02 12:48:29+00:00,['70e575fb706290a059c0b8ad5b0c3b4be436f3b2'],3,14,17,1421450,3,,,,2455
5312dd8fb058066c93c7b0c81e050dc4a28dc10c,0,Grant Henke,2019-05-02 13:35:07+00:00,['8a6faaa93f3e206ac75e8087731daccaf7ab646a'],63,256,319,1421769,8,0.205357143,0.982142857,1,2455
09cb51212313b811e11218b51f82855dca257a68,0,Alexey Serbin,2019-05-02 18:59:04+00:00,['5312dd8fb058066c93c7b0c81e050dc4a28dc10c'],25,23,48,1421817,1,,,,2455
0a8bdd42705f84e58df263a192ccb4cc2109dbf1,0,Alexey Serbin,2019-05-02 20:52:59+00:00,['09cb51212313b811e11218b51f82855dca257a68'],4,354,358,1422175,6,0.255434783,0.673913043,1,2455
806d7ba4f725a599ac80355de4f6ee21ad7905af,0,Alexey Serbin,2019-05-03 01:37:32+00:00,['0a8bdd42705f84e58df263a192ccb4cc2109dbf1'],13,276,289,1422464,3,0,0.685897436,0.91025641,2455
754de05b8d6e513624a2a4b8cc4b5dbb00cd1e07,0,Alexey Serbin,2019-05-03 01:37:38+00:00,['806d7ba4f725a599ac80355de4f6ee21ad7905af'],3,28,31,1422495,1,0,1,1,2455
98d9765e0514f8753731e04bddf7789c5bf2ca64,0,Alexey Serbin,2019-05-03 06:48:58+00:00,['754de05b8d6e513624a2a4b8cc4b5dbb00cd1e07'],1,1,2,1422497,1,,,,2455
8005afcc6f0e882facedec1f3b81047acb74a326,0,Andrew Wong,2019-05-03 17:32:54+00:00,['98d9765e0514f8753731e04bddf7789c5bf2ca64'],1,0,1,1422498,1,,,,2455
cc6b812530ed312df4201ace62881f8c505297bb,0,Alexey Serbin,2019-05-03 18:21:28+00:00,['8005afcc6f0e882facedec1f3b81047acb74a326'],0,50,50,1422548,2,1,1,1,2455
aa0e52d2ac58bb900486a6bdd694eff1191881a9,0,Grant Henke,2019-05-06 12:56:13+00:00,['cc6b812530ed312df4201ace62881f8c505297bb'],67,285,352,1422900,7,0.607407407,0.503703704,0.962962963,2455
c2150b836818209646f6ff27a03010079bbd50fa,0,Grant Henke,2019-05-06 17:46:56+00:00,['aa0e52d2ac58bb900486a6bdd694eff1191881a9'],3,4,7,1422907,1,,,,2455
81d715d555355d7af928c24e164a626f75713afe,0,Grant Henke,2019-05-06 18:09:03+00:00,['c2150b836818209646f6ff27a03010079bbd50fa'],12,25,37,1422944,2,0,0.454545455,0.545454545,2455
f1c691ead23b310e2506596b21409c29426f259f,0,Alexey Serbin,2019-05-06 18:16:02+00:00,['81d715d555355d7af928c24e164a626f75713afe'],72,326,398,1423342,3,0.137055838,0.583756345,1,2455
db3a05c5177e241ac761daa782ca7ded914bea3f,0,Alexey Serbin,2019-05-06 18:44:09+00:00,['f1c691ead23b310e2506596b21409c29426f259f'],0,1,1,1423343,1,0,0,0,2455
f9263e446ffb84604f12d782530050fc08245e72,0,Will Berkeley,2019-05-06 20:16:24+00:00,['db3a05c5177e241ac761daa782ca7ded914bea3f'],4,10,14,1423357,2,0,1,1,2455
11a6a06d646fc852f26e9ac6cfda8f3c5c09b9b0,0,Grant Henke,2019-05-06 22:09:23+00:00,['f9263e446ffb84604f12d782530050fc08245e72'],23,172,195,1423552,8,0.488372093,0.453488372,0.860465116,2455
586e957f76a547340f2ab93a7eebc3f116ff825e,1,Will Berkeley,2019-05-06 22:15:44+00:00,['11a6a06d646fc852f26e9ac6cfda8f3c5c09b9b0'],49,233,282,1423834,12,0,0,0.382608696,2455
2286f51687f8b6c4cdf8386040008754f92c6d45,0,Alexey Serbin,2019-05-07 05:16:37+00:00,['586e957f76a547340f2ab93a7eebc3f116ff825e'],6,6,12,1423846,1,,,,2455
5e3af4e2ae45ee5f700b9c6c28d56ff84ffeb319,0,Alexey Serbin,2019-05-07 05:51:54+00:00,['2286f51687f8b6c4cdf8386040008754f92c6d45'],236,219,455,1424301,13,1,0,0,2455
fd6155fc00de48d17a65aafd79fbbad584a4f837,0,Adar Dembo,2019-05-07 07:50:45+00:00,['5e3af4e2ae45ee5f700b9c6c28d56ff84ffeb319'],0,2,2,1424303,2,0,0,1,2455
16eae97117f230b25638cf66544318fce25a19ef,0,Grant Henke,2019-05-07 15:27:20+00:00,['fd6155fc00de48d17a65aafd79fbbad584a4f837'],0,1,1,1424304,1,1,1,1,2455
7fffbc8bb0f2255c06fc553954f1d13543c4936c,0,Adar Dembo,2019-05-07 20:11:15+00:00,['16eae97117f230b25638cf66544318fce25a19ef'],0,46,46,1424350,1,,,,2455
5c776b0fa74c3938849a91c0afc5c9d8a4f40087,0,Will Berkeley,2019-05-08 14:45:46+00:00,['7fffbc8bb0f2255c06fc553954f1d13543c4936c'],1,6,7,1424357,1,,,,2455
085093081bc8a7a57b52bae0b04d7ee3cf63b755,0,Alexey Serbin,2019-05-08 18:21:55+00:00,['5c776b0fa74c3938849a91c0afc5c9d8a4f40087'],38,35,73,1424430,1,1,0,0,2455
fa1e67f19484a94f9e5f266cf5d622c90b6069b6,0,Will Berkeley,2019-05-08 22:11:10+00:00,['085093081bc8a7a57b52bae0b04d7ee3cf63b755'],4,6,10,1424440,1,,,,2455
252b6965dd816587ddccdffa5fe5f83e28504bac,0,Grant Henke,2019-05-09 18:56:26+00:00,['fa1e67f19484a94f9e5f266cf5d622c90b6069b6'],37,74,111,1424551,3,0,1,1,2456
58f189dac6aa691bd7b8e5ebc1e89756385147a8,1,Will Berkeley,2019-05-09 21:18:20+00:00,['252b6965dd816587ddccdffa5fe5f83e28504bac'],22,63,85,1424636,6,0.033333333,0.2,0.133333333,2456
2acfd25b849a40e30654178b312d5d0bf720ffca,0,Grant Henke,2019-05-10 13:27:35+00:00,['58f189dac6aa691bd7b8e5ebc1e89756385147a8'],29,68,97,1424733,3,,,,2456
762f0fcc30803c20158cc1a75f6eac2fa530a44f,0,Alexey Serbin,2019-05-11 02:28:31+00:00,['2acfd25b849a40e30654178b312d5d0bf720ffca'],26,75,101,1424834,3,0.193548387,1,1,2456
f6f8bbf35aa33e668f9cc5ce9b1e80d202a7f736,1,Will Berkeley,2019-05-13 18:26:44+00:00,['762f0fcc30803c20158cc1a75f6eac2fa530a44f'],28,36,64,1424898,3,1,1,1,2456
9379be841b42414c59e26d5479d810bad7d65a04,0,Hao Hao,2019-05-13 20:23:14+00:00,['f6f8bbf35aa33e668f9cc5ce9b1e80d202a7f736'],4,1,5,1424903,1,,,,2456
88db1982ab0790363ad2e016a6fc83d67e6b088f,0,Alexey Serbin,2019-05-14 01:17:19+00:00,['9379be841b42414c59e26d5479d810bad7d65a04'],17,172,189,1425092,6,0.055555556,1,0.361111111,2456
7a6df6aa18ff31b7947890cbc44b49189a23a5bf,0,Adar Dembo,2019-05-14 21:00:33+00:00,['88db1982ab0790363ad2e016a6fc83d67e6b088f'],27,18,45,1425137,1,1,0,0,2456
b9a590a34ac219f1d5d1fe34176aece8d9f79d30,0,Adar Dembo,2019-05-14 21:01:40+00:00,['7a6df6aa18ff31b7947890cbc44b49189a23a5bf'],1,3,4,1425141,1,1,1,1,2456
39a598741f008fbc3cba830e2644160ce799ac7e,0,Andrew Wong,2019-05-15 07:01:32+00:00,['b9a590a34ac219f1d5d1fe34176aece8d9f79d30'],2,6,8,1425149,1,0,1,1,2456
4ac5e5074112574bb980a5644c711daa5ab615fa,0,Adar Dembo,2019-05-15 10:11:32+00:00,['39a598741f008fbc3cba830e2644160ce799ac7e'],1,495,496,1425645,10,0.401913876,0.918660287,0.66507177,2460
96d6cc6333083fdff0760a1c1c8571ab9b27ce78,0,Alexey Serbin,2019-05-15 22:51:59+00:00,['4ac5e5074112574bb980a5644c711daa5ab615fa'],1,4,5,1425650,1,,,,2460
64365d3fe116b8217f93731b1443cb85d67c8918,0,Will Berkeley,2019-05-15 23:19:54+00:00,['96d6cc6333083fdff0760a1c1c8571ab9b27ce78'],94,211,305,1425955,15,0,0.75,0,2463
d38c47a693b8455b731e84d48f66658f8dcd1e5f,0,Hao Hao,2019-05-16 17:08:52+00:00,['64365d3fe116b8217f93731b1443cb85d67c8918'],1,1,2,1425957,1,,,,2463
80ab2db9fc9ab2ac678333278c2425b7a84a9e63,0,Adar Dembo,2019-05-16 19:40:12+00:00,['d38c47a693b8455b731e84d48f66658f8dcd1e5f'],4,19,23,1425980,2,0,0,0.333333333,2463
0114ce1d0ebbec41eef971be341432a0f8f28a76,0,Grant Henke,2019-05-17 14:26:55+00:00,['80ab2db9fc9ab2ac678333278c2425b7a84a9e63'],230,327,557,1426537,30,1,1,1,2469
c3dad582c9fd1acf38a743a1a92cabf813efdeb1,0,Grant Henke,2019-05-17 14:27:11+00:00,['0114ce1d0ebbec41eef971be341432a0f8f28a76'],15,11,26,1426563,3,,,,2469
08b916d4b168d8843d663d8b2805910131c2e3cc,0,Adar Dembo,2019-05-17 22:09:28+00:00,['c3dad582c9fd1acf38a743a1a92cabf813efdeb1'],4,3,7,1426570,2,,,,2469
c33bc336ef1257f364ee0466c88f1fe387c4ae2d,0,Adar Dembo,2019-05-20 17:47:47+00:00,['08b916d4b168d8843d663d8b2805910131c2e3cc'],1,1,2,1426572,1,,,,2469
722678db690084c511afff19c643a549857c04fe,0,Grant Henke,2019-05-21 16:47:21+00:00,['c33bc336ef1257f364ee0466c88f1fe387c4ae2d'],1,12,13,1426585,3,0.125,1,0.75,2469
c584d0def49ac545121247794d80c8e0fefd8f6c,0,Adar Dembo,2019-05-21 20:22:18+00:00,['722678db690084c511afff19c643a549857c04fe'],153,408,561,1427146,13,0.418918919,1,0.864864865,2469
12f5eeefd2f1b3deacc0d12ec8e9240893d884b8,0,Adar Dembo,2019-05-21 20:25:06+00:00,['c584d0def49ac545121247794d80c8e0fefd8f6c'],2,2,4,1427150,1,,,,2469
38c2e122292b262a4a2ee1af931b27dd272bd862,0,Alexey Serbin,2019-05-21 20:47:23+00:00,['12f5eeefd2f1b3deacc0d12ec8e9240893d884b8'],105,101,206,1427356,3,1,0.5,0,2469
2bf80b5147f09c980c2f2268ee3467a5b3305a57,1,Will Berkeley,2019-05-22 07:07:45+00:00,['38c2e122292b262a4a2ee1af931b27dd272bd862'],172,114,286,1427642,4,1,0.844827586,0,2469
80737497466985fd87268b6f608aa22a112f7d53,0,Adar Dembo,2019-05-22 16:55:08+00:00,['2bf80b5147f09c980c2f2268ee3467a5b3305a57'],8,17,25,1427667,1,0,1,1,2469
53ddc88463c9785c1f7acc517c0a01ef70187cf6,0,Alexey Serbin,2019-05-22 17:04:14+00:00,['80737497466985fd87268b6f608aa22a112f7d53'],102,145,247,1427914,3,0.30952381,0.928571429,0.904761905,2469
8776b742d8c2cbabaaab280b8654ecf3020b14a9,0,Will Berkeley,2019-05-22 17:53:43+00:00,['53ddc88463c9785c1f7acc517c0a01ef70187cf6'],4,430,434,1428348,4,0.235294118,0.866666667,0.925490196,2471
b36ea67d33ab7098d79d8bfb4e57e1308eee983d,0,Hao Hao,2019-05-22 17:57:32+00:00,['8776b742d8c2cbabaaab280b8654ecf3020b14a9'],40,91,131,1428479,2,0.25,0.821428571,0.75,2471
d267b8b22191c0bb219a9a6a33c1dbecf3894dbe,0,Alexey Serbin,2019-05-22 18:29:56+00:00,['b36ea67d33ab7098d79d8bfb4e57e1308eee983d'],0,41,41,1428520,1,0,1,1,2471
6a8d1d29e5c395a61d84733a39793e28950a3693,1,Andrew Wong,2019-05-22 22:46:52+00:00,['d267b8b22191c0bb219a9a6a33c1dbecf3894dbe'],188,379,567,1429087,14,0.031007752,0.465116279,0.488372093,2471
2b5b7372f27a1009209bd30f86b2a725e9ba58eb,0,Will Berkeley,2019-05-22 23:37:41+00:00,['6a8d1d29e5c395a61d84733a39793e28950a3693'],3,14,17,1429104,2,0.111111111,1,0,2471
d29af67ab06204292ab0ea23fe16a79fe46df169,0,Grant Henke,2019-05-23 13:01:09+00:00,['2b5b7372f27a1009209bd30f86b2a725e9ba58eb'],8,2,10,1429114,2,,,,2471
4fed496872dfd57e2022d9f8c387988f82d5e203,0,Andrew Wong,2019-05-24 01:04:26+00:00,['d29af67ab06204292ab0ea23fe16a79fe46df169'],29,66,95,1429209,4,0,1,1,2471
49ee3fc3ca3fbdd89a53906eb230ffc7f543c2c8,0,Hao Hao,2019-05-24 01:17:05+00:00,['4fed496872dfd57e2022d9f8c387988f82d5e203'],2,33,35,1429244,1,0,0.647058824,1,2471
c10bae9ed9c063cffab3e45204e9f9e3fbdb95e8,0,Andrew Wong,2019-05-24 01:33:00+00:00,['49ee3fc3ca3fbdd89a53906eb230ffc7f543c2c8'],0,38,38,1429282,1,0,0.35,1,2471
37e53bf1d99e2ff44f0288ed65321f9004736813,0,Adar Dembo,2019-05-24 04:33:07+00:00,['c10bae9ed9c063cffab3e45204e9f9e3fbdb95e8'],8,174,182,1429464,3,0.155844156,1,1,2472
5135865befeede150dba850dc72a95a016d5d077,0,Adar Dembo,2019-05-24 04:34:28+00:00,['37e53bf1d99e2ff44f0288ed65321f9004736813'],10,10,20,1429484,10,,,,2472
22a6faa44364dec3a171ec79c15b814ad9277d8f,0,Adar Dembo,2019-05-24 05:15:58+00:00,['5135865befeede150dba850dc72a95a016d5d077'],16,743,759,1430243,13,0.286783042,0.795511222,0.53117207,2476
2a3305e3667fb29624e8cee1f448f45883812b82,0,Attila Bukor,2019-05-24 15:52:14+00:00,['22a6faa44364dec3a171ec79c15b814ad9277d8f'],14,15,29,1430272,7,,,,2476
22ed238cde8ffc0a93dd5edc4af11d1f13e634e0,0,Hao Hao,2019-05-24 16:43:25+00:00,['2a3305e3667fb29624e8cee1f448f45883812b82'],1,1,2,1430274,1,,,,2476
8410f0ca44e17ef6242cc9b25da49b568ddb0955,0,Adar Dembo,2019-05-26 18:10:24+00:00,['22ed238cde8ffc0a93dd5edc4af11d1f13e634e0'],87,271,358,1430632,6,0.082278481,0.886075949,1,2476
946e2bc05419e3a552fed5a9d28e83861ff1eea1,1,Adar Dembo,2019-05-26 18:12:38+00:00,['8410f0ca44e17ef6242cc9b25da49b568ddb0955'],198,291,489,1431121,15,1,1,1,2477
de12c3da9de4251fb1380560964954a98286e4aa,0,Andrew Wong,2019-05-26 18:47:17+00:00,['946e2bc05419e3a552fed5a9d28e83861ff1eea1'],9,9,18,1431139,1,0,0,1,2477
3ae2e1ace73bc05d5cc739e166ec64b1a719c5e4,0,Adar Dembo,2019-05-27 22:03:30+00:00,['de12c3da9de4251fb1380560964954a98286e4aa'],3,1,4,1431143,2,,,,2477
58d8772e97e26e47ca7c87a257daedb556e0785d,0,Adar Dembo,2019-05-27 22:04:18+00:00,['3ae2e1ace73bc05d5cc739e166ec64b1a719c5e4'],3,2,5,1431148,1,,,,2477
84a6137a879d61fd468cc605a771f507419a6820,0,Adar Dembo,2019-05-27 22:05:17+00:00,['58d8772e97e26e47ca7c87a257daedb556e0785d'],46,2,48,1431196,3,,,,2477
7c3d45f000c08579c861fed0dc67dfbec707cdb8,1,Andrew Wong,2019-05-28 01:04:32+00:00,['84a6137a879d61fd468cc605a771f507419a6820'],2,97,99,1431295,4,,,,2480
68cddfdd4e83aabe7b6d7dd76368dbf7997d2444,0,Adar Dembo,2019-05-28 04:51:41+00:00,['7c3d45f000c08579c861fed0dc67dfbec707cdb8'],10,8,18,1431313,1,0,0,0,2480
fc8218463fc8b58a606314af71b6b9b3b78aa5ce,0,Adar Dembo,2019-05-28 04:52:51+00:00,['68cddfdd4e83aabe7b6d7dd76368dbf7997d2444'],3,9,12,1431325,1,0,0,1,2480
eb9cc53095a53a9dabc985b2fab91f76be013d47,0,Will Berkeley,2019-05-28 19:59:20+00:00,['fc8218463fc8b58a606314af71b6b9b3b78aa5ce'],79,64,143,1431468,1,1,0,0,2480
a5a8da655ca8f0088dcd39301bd9bd87e182c460,0,Mike Percy,2019-05-28 22:16:52+00:00,['eb9cc53095a53a9dabc985b2fab91f76be013d47'],30,337,367,1431835,7,0.396694215,0.702479339,1,2483
3b58cfb3bd7ff39ed3f7382d8cca5e00d44d9c2d,0,Adar Dembo,2019-05-29 16:36:09+00:00,['a5a8da655ca8f0088dcd39301bd9bd87e182c460'],53,282,335,1432170,9,0.482993197,1,0.755102041,2483
7b80b5a44f80c9cd6734e7fd0b709d787558c4d1,0,Will Berkeley,2019-05-29 17:20:31+00:00,['3b58cfb3bd7ff39ed3f7382d8cca5e00d44d9c2d'],10,6,16,1432186,2,1,1,0,2483
96ce5d4d15f800ac98bdbb53ac3b36c15a36ad95,0,Adar Dembo,2019-05-29 20:09:11+00:00,['7b80b5a44f80c9cd6734e7fd0b709d787558c4d1'],3,0,3,1432189,1,,,,2483
2db92e322c42145be04a55cb4e8cf64606c96610,0,Adar Dembo,2019-05-29 21:40:48+00:00,['96ce5d4d15f800ac98bdbb53ac3b36c15a36ad95'],48,85,133,1432322,5,0.56,1,0.96,2483
f07778b341031630e202d281eb268f7b6c23d05e,0,Will Berkeley,2019-05-29 21:51:03+00:00,['2db92e322c42145be04a55cb4e8cf64606c96610'],108,77,185,1432507,1,1,0,0,2483
a1bbd3d042322cef3cee0af8713a4bd247699113,0,Will Berkeley,2019-05-29 23:24:39+00:00,['f07778b341031630e202d281eb268f7b6c23d05e'],267,126,393,1432900,1,1,1,0.084507042,2483
3cbc025869494be2a1fa91582dfabc95d7bc88f9,0,Will Berkeley,2019-05-30 03:15:00+00:00,['a1bbd3d042322cef3cee0af8713a4bd247699113'],3,9,12,1432912,1,0,1,1,2483
62123b097abf14d5a71fb3d26c0909ce2bfde9f4,0,Alexey Serbin,2019-05-30 04:59:06+00:00,['3cbc025869494be2a1fa91582dfabc95d7bc88f9'],28,28,56,1432968,19,,,,2483
c467d6046a36269fc6bdd2967fa45d7d4f95e645,0,Will Berkeley,2019-05-30 07:40:53+00:00,['62123b097abf14d5a71fb3d26c0909ce2bfde9f4'],2,1,3,1432971,1,1,0,0,2483
5533478b0b50bddd648334e69bad35cda321e9da,0,Will Berkeley,2019-05-30 16:10:10+00:00,['c467d6046a36269fc6bdd2967fa45d7d4f95e645'],2,22,24,1432995,1,0,0,1,2483
ace932663a81740ecc283f631503d0ead47b06d1,1,Mike Percy,2019-05-30 16:51:34+00:00,['5533478b0b50bddd648334e69bad35cda321e9da'],60,134,194,1433189,4,0.347826087,1,0.043478261,2483
b406853c279ee48471e0ce800d285a99a247458e,1,Mike Percy,2019-05-30 16:54:48+00:00,['ace932663a81740ecc283f631503d0ead47b06d1'],106,168,274,1433463,4,0.230769231,0.230769231,0,2483
84086fe6a59850d3e194ab7a6b0c76594974658c,1,Mike Percy,2019-05-30 17:23:31+00:00,['b406853c279ee48471e0ce800d285a99a247458e'],14,69,83,1433546,4,1,0.619047619,1,2483
fe0889eddc279b1deecc07e7fe6d745edf92047a,1,Hao Hao,2019-05-30 18:21:39+00:00,['84086fe6a59850d3e194ab7a6b0c76594974658c'],5,143,148,1433694,2,0,0.793478261,0.641304348,2483
ff828ac91a335292c7c659fe3eb59a7f00cc7561,1,Alexey Serbin,2019-05-31 05:11:34+00:00,['fe0889eddc279b1deecc07e7fe6d745edf92047a'],42,47,89,1433783,6,0,0,0,2483
1cf86dfd4b503958daeda94164c4730a697556aa,0,Alexey Serbin,2019-05-31 05:11:41+00:00,['ff828ac91a335292c7c659fe3eb59a7f00cc7561'],60,233,293,1434076,8,0.234042553,0.989361702,0.819148936,2483
6ecafb43992f4af9c6e740a6c7198feb9440110e,0,Will Berkeley,2019-05-31 16:39:30+00:00,['1cf86dfd4b503958daeda94164c4730a697556aa'],14,22,36,1434112,2,1,1,1,2483
11a29a9e8d6c095a0200dfabe0afb6d203559342,0,Grant Henke,2019-06-02 02:17:36+00:00,['6ecafb43992f4af9c6e740a6c7198feb9440110e'],3,155,158,1434270,2,0.069767442,0.666666667,1,2483
5248b2e425c2ba77ce555a1db6a1e520bf4964fe,0,Adar Dembo,2019-06-02 05:34:49+00:00,['11a29a9e8d6c095a0200dfabe0afb6d203559342'],9,27,36,1434306,1,0,1,1,2483
48467ccf4c7a6135453708e3ea5123738fef19b3,1,Alexey Serbin,2019-06-03 03:40:59+00:00,['5248b2e425c2ba77ce555a1db6a1e520bf4964fe'],127,169,296,1434602,22,0,0,0,2483
072260b6f91989128cb3284b17cefc506dec38a4,1,Will Berkeley,2019-06-03 06:55:28+00:00,['48467ccf4c7a6135453708e3ea5123738fef19b3'],14,32,46,1434648,2,0.5,0.5,0.5,2483
1a0452a3192debe39e6b4c5150c2994b7027a127,0,Will Berkeley,2019-06-03 16:49:49+00:00,['072260b6f91989128cb3284b17cefc506dec38a4'],2,2,4,1434652,1,,,,2483
1b4910977763efbfe9bc569414703f53c77d0d34,0,Will Berkeley,2019-06-03 16:51:11+00:00,['1a0452a3192debe39e6b4c5150c2994b7027a127'],1,1,2,1434654,1,,,,2483
9b6bcaee4ec48aaf6971f59cf7e68db60e807a75,0,Will Berkeley,2019-06-03 16:51:20+00:00,['1b4910977763efbfe9bc569414703f53c77d0d34'],28,30,58,1434712,1,0,0,1,2483
761589e9fa4e4687893e0b5361355dc1bb46a68a,1,Will Berkeley,2019-06-03 16:51:25+00:00,['9b6bcaee4ec48aaf6971f59cf7e68db60e807a75'],5,9,14,1434726,1,0,1,1,2483
1ccebcc43e28b86d58a6642d844958413a2f1354,0,Grant Henke,2019-06-03 17:53:15+00:00,['761589e9fa4e4687893e0b5361355dc1bb46a68a'],18,84,102,1434828,8,0.465116279,0.488372093,0.906976744,2483
966452659e40b5cb699860b4124dc7714ee895a0,0,Adar Dembo,2019-06-03 22:29:14+00:00,['1ccebcc43e28b86d58a6642d844958413a2f1354'],2,2,4,1434832,2,,,,2483
c45002dfe4fcba5715ab2763820c9730ec8030ad,0,Adar Dembo,2019-06-04 07:57:14+00:00,['966452659e40b5cb699860b4124dc7714ee895a0'],4,1,5,1434837,2,,,,2483
fa176193795041d04839386d5bd8a92eb0a08041,0,Grant Henke,2019-06-04 13:23:39+00:00,['c45002dfe4fcba5715ab2763820c9730ec8030ad'],0,212,212,1435049,1,,,,2484
ee2898e18ae87625e2e6180210348ea069de8c5e,1,Adar Dembo,2019-06-04 22:37:25+00:00,['fa176193795041d04839386d5bd8a92eb0a08041'],1,2,3,1435052,1,,,,2484
4cda69f0c29c083147ae7805d124cb95627bde70,0,Hao Hao,2019-06-05 00:40:32+00:00,['ee2898e18ae87625e2e6180210348ea069de8c5e'],0,5,5,1435057,2,0,0,0,2484
90d1378c92c6bd310a6dfe72ccf410450262962c,0,Grant Henke,2019-06-05 23:03:35+00:00,['4cda69f0c29c083147ae7805d124cb95627bde70'],13,91,104,1435161,6,0.638888889,0,0.805555556,2484
c1c8e25bbc2e783446f1dd257cd99a16a79ccb16,0,Andrew Wong,2019-06-06 02:13:37+00:00,['90d1378c92c6bd310a6dfe72ccf410450262962c'],33,388,421,1435582,31,0.206477733,0.939271255,0.87854251,2484
cfceb48511a5aa814dc8a76a51c340ff6edfaaed,0,Adar Dembo,2019-06-06 04:55:26+00:00,['c1c8e25bbc2e783446f1dd257cd99a16a79ccb16'],5,13,18,1435600,2,1,1,1,2484
85c85f97d058606cb5a8d2a72849814daa1bb21f,0,Adar Dembo,2019-06-06 05:44:34+00:00,['cfceb48511a5aa814dc8a76a51c340ff6edfaaed'],6,1,7,1435607,1,,,,2484
7c8797f3dcc703de96ad790458e42622633e26a0,0,Adar Dembo,2019-06-06 07:48:27+00:00,['85c85f97d058606cb5a8d2a72849814daa1bb21f'],1,1,2,1435609,1,,,,2484
3f480941156068342dc2c66e38553712623d959e,0,Grant Henke,2019-06-06 13:01:44+00:00,['7c8797f3dcc703de96ad790458e42622633e26a0'],5,44,49,1435658,2,0.318181818,0.318181818,1,2484
6a14790405e8f550fbbd050ad2b61d7e11ae5024,0,Grant Henke,2019-06-06 17:39:40+00:00,['3f480941156068342dc2c66e38553712623d959e'],27,89,116,1435774,3,0.189189189,1,0.837837838,2484
ef1e772d8d3263fef99fb579a98f491ba6ec02fc,0,Grant Henke,2019-06-06 17:39:46+00:00,['6a14790405e8f550fbbd050ad2b61d7e11ae5024'],23,163,186,1435960,3,0.076923077,0.384615385,0.923076923,2484
253e136061834484c19518de4f1741d5ee5ab7df,0,Adar Dembo,2019-06-06 20:23:03+00:00,['ef1e772d8d3263fef99fb579a98f491ba6ec02fc'],1,1,2,1435962,1,,,,2484
4fe36192412bd74dd3b3518bff1f9a36a8d60155,0,Grant Henke,2019-06-06 21:49:57+00:00,['253e136061834484c19518de4f1741d5ee5ab7df'],6,204,210,1436172,3,0,0.559210526,1,2484
76984687850abd80a74e3191a91d2b40c29fb6fa,0,Adar Dembo,2019-06-06 21:59:42+00:00,['4fe36192412bd74dd3b3518bff1f9a36a8d60155'],31,66,97,1436269,1,0,0.857142857,0.857142857,2484
1865bfa208cd38b59c71765fd74488bf61ed7a1e,0,Mike Percy,2019-06-06 22:39:56+00:00,['76984687850abd80a74e3191a91d2b40c29fb6fa'],2,5,7,1436276,1,,,,2484
a76177f615ab1936ff37679e551986526ba062bd,1,Hao Hao,2019-06-06 22:56:44+00:00,['1865bfa208cd38b59c71765fd74488bf61ed7a1e'],62,118,180,1436456,15,0.285714286,0.523809524,1,2484
60cc7f3c83e52bc58b9a31d222a2f86e3ccc4059,0,Hao Hao,2019-06-06 22:59:43+00:00,['a76177f615ab1936ff37679e551986526ba062bd'],17,68,85,1436541,3,0.346153846,1,0.653846154,2484
5c87afd4f2160344d651948e90234ee512adcfd8,1,Grant Henke,2019-06-06 23:54:17+00:00,['60cc7f3c83e52bc58b9a31d222a2f86e3ccc4059'],1,50,51,1436592,3,1,1,1,2484
0deeafee3a66422d0242e0e3e7d60020a011802a,1,Adar Dembo,2019-06-07 07:41:46+00:00,['5c87afd4f2160344d651948e90234ee512adcfd8'],116,142,258,1436850,1,0.041666667,0.041666667,1,2484
f9f9526d3e02f226c0e6fb160726b7d566eeca23,0,Todd Lipcon,2019-06-07 16:45:01+00:00,['0deeafee3a66422d0242e0e3e7d60020a011802a'],26,126,152,1437002,3,0,0.661538462,0.661538462,2484
086089ab91c70753eb632289fad2a4e30d51dddb,0,Adar Dembo,2019-06-07 16:50:28+00:00,['f9f9526d3e02f226c0e6fb160726b7d566eeca23'],3,9,12,1437014,1,0,0,0,2484
f88fc0cb7a0d6c22f36dac613044ea50e0b9255b,0,Will Berkeley,2019-06-07 21:11:08+00:00,['086089ab91c70753eb632289fad2a4e30d51dddb'],13,90,103,1437117,7,0.41025641,0.205128205,0.948717949,2484
1f291b77ef0868ac888a850678adc2d7cce65529,0,Todd Lipcon,2019-06-07 21:11:37+00:00,['f88fc0cb7a0d6c22f36dac613044ea50e0b9255b'],65,623,688,1437805,16,0.315384615,0.65,0.7,2486
b4128848ccc8f56299d181c4a193970c2f59429a,0,Grant Henke,2019-06-07 21:40:38+00:00,['1f291b77ef0868ac888a850678adc2d7cce65529'],37,160,197,1438002,14,,,,2489
76c72ee9f9b168782e4630edf99e7d7425e64680,0,Grant Henke,2019-06-07 22:26:34+00:00,['b4128848ccc8f56299d181c4a193970c2f59429a'],230,276,506,1438508,6,1,0.8,0,2490
bf2b3e8d81b3a137a279cbf808badf1eaa8d9d9c,0,Adar Dembo,2019-06-07 23:47:51+00:00,['76c72ee9f9b168782e4630edf99e7d7425e64680'],61,72,133,1438641,10,0,0.857142857,0.928571429,2490
5aa69318ff57b7f3455d7e4e3317778170e927ac,1,Adar Dembo,2019-06-08 00:21:18+00:00,['bf2b3e8d81b3a137a279cbf808badf1eaa8d9d9c'],0,2,2,1438643,1,,,,2490
3afbb4af1313a0556c6534c7736746f5a5181342,0,Adar Dembo,2019-06-08 00:21:22+00:00,['5aa69318ff57b7f3455d7e4e3317778170e927ac'],11,132,143,1438786,4,0,0.885245902,0.901639344,2490
552e7f66a6b584ff7c9971c14bab16f32214ddd5,0,Adar Dembo,2019-06-08 00:21:25+00:00,['3afbb4af1313a0556c6534c7736746f5a5181342'],11,146,157,1438943,8,0.575342466,0.835616438,0.917808219,2490
ff656763a3d24623964c6a7cc7074899b83441ea,1,Adar Dembo,2019-06-08 00:21:30+00:00,['552e7f66a6b584ff7c9971c14bab16f32214ddd5'],60,387,447,1439390,15,0.461538462,0.579881657,0.781065089,2490
9dfe8f8e671b436996867083a4e9d82df5e1997f,0,Adar Dembo,2019-06-08 00:21:33+00:00,['ff656763a3d24623964c6a7cc7074899b83441ea'],18,262,280,1439670,2,0.222891566,0.331325301,0.740963855,2490
b0ee39962d0b9766a7d9de9b7207524495319631,0,Will Berkeley,2019-06-08 02:06:55+00:00,['9dfe8f8e671b436996867083a4e9d82df5e1997f'],31,132,163,1439833,5,0.157142857,0.742857143,0.385714286,2490
ecd3612edd59c75cc119a8a234b6fe72a0e8c7fe,0,Andrew Wong,2019-06-08 04:59:50+00:00,['b0ee39962d0b9766a7d9de9b7207524495319631'],61,443,504,1440337,37,0.218009479,0.677725118,0.819905213,2490
0a03bba148d91da218d7ae8ac5208d635a029a16,0,Adar Dembo,2019-06-09 21:25:21+00:00,['ecd3612edd59c75cc119a8a234b6fe72a0e8c7fe'],8,42,50,1440387,1,0,1,1,2490
89f6ad4cbce85084b4f4cc351df694b867f5d49f,0,Adar Dembo,2019-06-10 03:58:07+00:00,['0a03bba148d91da218d7ae8ac5208d635a029a16'],0,2,2,1440389,1,,,,2490
4b60b5280ed2fc317b95a60f257053df27d70fa5,0,Alexey Serbin,2019-06-10 17:48:57+00:00,['89f6ad4cbce85084b4f4cc351df694b867f5d49f'],1,1,2,1440391,1,,,,2490
71b094000cb3569d49f0fdf016ae5d17ff1f119e,0,Grant Henke,2019-06-10 18:29:14+00:00,['4b60b5280ed2fc317b95a60f257053df27d70fa5'],10,35,45,1440436,5,1,1,1,2490
3c4635fc51da932b8a6f8c779a1c4f3c09e5b7ca,0,Hao Hao,2019-06-10 19:15:52+00:00,['71b094000cb3569d49f0fdf016ae5d17ff1f119e'],16,109,125,1440561,7,0.274509804,0.588235294,0.31372549,2490
d3820b3c4458abe768ced6ee683470dc2cc39b50,0,Hao Hao,2019-06-10 19:34:28+00:00,['3c4635fc51da932b8a6f8c779a1c4f3c09e5b7ca'],63,106,169,1440730,5,0,0.666666667,0.222222222,2490
ec1a1f301b6f8b5ca8428d755e7658ec1c3d22a7,0,Grant Henke,2019-06-10 20:58:30+00:00,['d3820b3c4458abe768ced6ee683470dc2cc39b50'],0,11,11,1440741,1,,,,2490
69645c198766499e257eacd1cdf44f7856d093b8,0,Andrew Wong,2019-06-10 22:12:33+00:00,['ec1a1f301b6f8b5ca8428d755e7658ec1c3d22a7'],2,123,125,1440866,2,0,0.4875,0.6625,2490
13fdac8e55e635d049d2a0c3a0232d229e630da8,0,Andrew Wong,2019-06-11 00:20:14+00:00,['69645c198766499e257eacd1cdf44f7856d093b8'],3,8,11,1440877,2,0,1,0.4,2490
04e3e7d78ca919641759d8ee29891f7929d45747,0,Grant Henke,2019-06-11 17:05:49+00:00,['13fdac8e55e635d049d2a0c3a0232d229e630da8'],1,1,2,1440879,1,,,,2490
0212da22aa3c170439ab59d6d2fc52ac7aa42caf,0,Alexey Serbin,2019-06-11 17:38:19+00:00,['04e3e7d78ca919641759d8ee29891f7929d45747'],30,116,146,1441025,5,0.36,0.78,0.6,2490
988296dcd1e2d5876f41ca2d481b126523f5a457,0,Grant Henke,2019-06-11 18:02:29+00:00,['0212da22aa3c170439ab59d6d2fc52ac7aa42caf'],8,31,39,1441064,6,,,,2490
21067ffcd1be94dc73f289631fd59ce8d76cfe33,1,Andrew Wong,2019-06-11 20:10:13+00:00,['988296dcd1e2d5876f41ca2d481b126523f5a457'],2,79,81,1441145,10,0.261904762,0.714285714,1,2490
7767abcbcb092b8449a02d985d25c0e3b12023fa,0,Will Berkeley,2019-06-12 00:00:44+00:00,['21067ffcd1be94dc73f289631fd59ce8d76cfe33'],293,216,509,1441654,1,0.918918919,0.175675676,0.418918919,2490
7b68bbd6f4696471077f876917724ab5262e9eb8,0,Adar Dembo,2019-06-12 03:43:48+00:00,['7767abcbcb092b8449a02d985d25c0e3b12023fa'],30,194,224,1441878,12,0.009803922,0.666666667,0.901960784,2490
53ea7c648d8908e8587412757093777945b68369,0,Adar Dembo,2019-06-12 04:13:22+00:00,['7b68bbd6f4696471077f876917724ab5262e9eb8'],2,2,4,1441882,1,,,,2490
d25c6f11ca8611bbe30b6951fbda7397b0a3ac88,0,Grant Henke,2019-06-12 14:02:55+00:00,['53ea7c648d8908e8587412757093777945b68369'],9,28,37,1441919,1,,,,2490
9e3a9fb1fc0a9a85bb1c948edb8a6b37f98ba2d0,0,Grant Henke,2019-06-12 15:22:47+00:00,['d25c6f11ca8611bbe30b6951fbda7397b0a3ac88'],17,84,101,1442020,3,0,1,1,2490
3083dc11090f02f791d5d00733dfff4680fe5089,0,Grant Henke,2019-06-12 18:43:42+00:00,['9e3a9fb1fc0a9a85bb1c948edb8a6b37f98ba2d0'],2,2,4,1442024,1,,,,2490
ad798391fdf22c1632a641dbb6be80085636602a,0,Grant Henke,2019-06-12 20:29:48+00:00,['3083dc11090f02f791d5d00733dfff4680fe5089'],63,869,932,1442956,13,,,,2501
bfcb653c343e275e27c61c54baa29fcf3e95f8f3,0,Grant Henke,2019-06-13 02:19:25+00:00,['ad798391fdf22c1632a641dbb6be80085636602a'],13,2,15,1442971,3,0,0,0,2501
dfd516dd0697e30eb810b249bb87ad9358bb8545,0,Adar Dembo,2019-06-13 03:40:16+00:00,['bfcb653c343e275e27c61c54baa29fcf3e95f8f3'],0,36,36,1443007,1,,,,2501
1aa2af4c38ce19c28a516d971c770ff1c1eedf6a,0,Grant Henke,2019-06-13 11:40:48+00:00,['dfd516dd0697e30eb810b249bb87ad9358bb8545'],30,30,60,1443067,3,,,,2501
349aeaab33d33ba1ed323a6a4ff1bd6eee971d85,0,Andrew Wong,2019-06-13 16:23:02+00:00,['1aa2af4c38ce19c28a516d971c770ff1c1eedf6a'],12,146,158,1443225,3,0.24,0.48,0.666666667,2501
efb648e913452d02496d3cf63f843b8795b7dc12,0,Grant Henke,2019-06-13 17:04:25+00:00,['349aeaab33d33ba1ed323a6a4ff1bd6eee971d85'],32,81,113,1443338,2,0.75,1,1,2501
73285f6fd1978570144dd0974d85780db2d6478f,0,Grant Henke,2019-06-13 17:15:18+00:00,['efb648e913452d02496d3cf63f843b8795b7dc12'],5,24,29,1443367,3,,,,2501
c4308869580c6cb8b57a809395883a0b2614f883,0,Will Berkeley,2019-06-13 20:13:58+00:00,['73285f6fd1978570144dd0974d85780db2d6478f'],1,67,68,1443435,1,0,1,1,2501
a7bdd06373a3862b3572db4690013c7c20a6166e,0,Alexey Serbin,2019-06-14 00:05:37+00:00,['c4308869580c6cb8b57a809395883a0b2614f883'],17,35,52,1443487,2,0.692307692,1,1,2501
0f2946b74ea138b29b00f68047c50f44674ddc5a,0,Mike Percy,2019-06-14 01:46:24+00:00,['a7bdd06373a3862b3572db4690013c7c20a6166e'],67,229,296,1443783,7,0.192307692,0.778846154,0.538461538,2501
fe7c1575946f8ace3eaaea8adf1d03caf4da3c34,0,Andrew Wong,2019-06-14 03:46:56+00:00,['0f2946b74ea138b29b00f68047c50f44674ddc5a'],24,42,66,1443849,2,1,1,1,2501
d76ae349a500c9d505009c79ee128b7d7bf1e126,0,Grant Henke,2019-06-14 17:16:17+00:00,['fe7c1575946f8ace3eaaea8adf1d03caf4da3c34'],2,13,15,1443864,2,,,,2501
ff6cefa1d1099c4e1784673628c2ae53a3612ff8,0,Will Berkeley,2019-06-14 18:48:03+00:00,['d76ae349a500c9d505009c79ee128b7d7bf1e126'],311,318,629,1444493,76,,,,2501
45f03d69bdc73d1c7e08f249b4a40ecfbfd7f810,0,Hao Hao,2019-06-16 19:38:59+00:00,['ff6cefa1d1099c4e1784673628c2ae53a3612ff8'],1,18,19,1444512,2,0,1,1,2501
ab0746292e8a1e37db22f94bce21097e562d3969,0,Andrew Wong,2019-06-17 01:46:38+00:00,['45f03d69bdc73d1c7e08f249b4a40ecfbfd7f810'],1,0,1,1444513,1,1,1,0,2501
598a8c1116535333008800e1b222721674646650,0,Todd Lipcon,2019-06-18 07:06:58+00:00,['ab0746292e8a1e37db22f94bce21097e562d3969'],20,202,222,1444735,9,0.358974359,0.756410256,0.974358974,2502
523ec8b64d344e6b400b961b3ec4eb67b791f0fc,0,Todd Lipcon,2019-06-18 07:35:53+00:00,['598a8c1116535333008800e1b222721674646650'],17,29,46,1444781,2,0,0,0.5,2502
d0db4c4cd36c1388e36576742cc7fe8c3adfcb77,0,Alexey Serbin,2019-06-19 01:30:59+00:00,['523ec8b64d344e6b400b961b3ec4eb67b791f0fc'],1,1,2,1444783,1,,,,2502
c9a925b1766faf5a77e0e56aaccd5923bc980530,0,Todd Lipcon,2019-06-19 06:09:06+00:00,['d0db4c4cd36c1388e36576742cc7fe8c3adfcb77'],4,4,8,1444791,1,,,,2502
92f077389dec2b1d9b0bd62ef54d6f9da974b583,0,Todd Lipcon,2019-06-19 17:07:32+00:00,['c9a925b1766faf5a77e0e56aaccd5923bc980530'],6,4,10,1444801,1,,,,2502
efc3f372e8b9254ab6b65d1f884381016329611c,1,Alexey Serbin,2019-06-20 07:17:03+00:00,['92f077389dec2b1d9b0bd62ef54d6f9da974b583'],1,10,11,1444812,2,0,0,1,2502
5dca59eba4cb2717a2cf1dfbc5bd750fd2535366,0,Andrew Wong,2019-06-20 08:33:52+00:00,['efc3f372e8b9254ab6b65d1f884381016329611c'],14,109,123,1444935,5,0.803278689,0.983606557,0.967213115,2502
1d1abbfb6a421df39843d6c3e4f18089b86e632e,0,Andrew Wong,2019-06-20 08:34:46+00:00,['5dca59eba4cb2717a2cf1dfbc5bd750fd2535366'],0,158,158,1445093,3,0.078125,1,1,2502
02fa2d639f7ab8f50af21cd23967da42a4f7cde0,0,Grant Henke,2019-06-20 12:44:04+00:00,['1d1abbfb6a421df39843d6c3e4f18089b86e632e'],2,2,4,1445097,1,,,,2502
648b5b85aad0df92ab86ac1a9130d3ffdc7d92d9,0,Will Berkeley,2019-06-20 22:18:11+00:00,['02fa2d639f7ab8f50af21cd23967da42a4f7cde0'],2,2,4,1445101,1,,,,2502
8c68c946d467a466fa2d7f21c283fc083d380d29,0,Andrew Wong,2019-06-21 00:04:03+00:00,['648b5b85aad0df92ab86ac1a9130d3ffdc7d92d9'],1,31,32,1445133,2,0,0,1,2502
ef921b2c35589e75de4c3fcb2673e38123d9fb94,0,Grant Henke,2019-06-21 16:44:56+00:00,['8c68c946d467a466fa2d7f21c283fc083d380d29'],80,99,179,1445312,7,1,1,1,2502
e165e324597925e256fe819ab1e330cf8d3a72d0,0,Grant Henke,2019-06-21 20:23:02+00:00,['ef921b2c35589e75de4c3fcb2673e38123d9fb94'],1,4,5,1445317,1,,,,2502
2c3a6223872e742da58c1b410a2a28a0285034ff,0,Andrew Wong,2019-06-25 06:56:28+00:00,['e165e324597925e256fe819ab1e330cf8d3a72d0'],0,11,11,1445328,1,,,,2502
dcb8c394d968ee4b25baea0c2cc0e35a17c263d9,0,Andrew Wong,2019-06-25 23:21:06+00:00,['2c3a6223872e742da58c1b410a2a28a0285034ff'],4,1,5,1445333,1,,,,2502
30b88b464f0b13ede2099832d40f50f4ed4a1b1b,0,Grant Henke,2019-06-26 18:02:26+00:00,['dcb8c394d968ee4b25baea0c2cc0e35a17c263d9'],0,21,21,1445354,2,0.769230769,1,1,2502
7f7d425eadc10886108a00ee0249d7c3d8372ee0,0,Todd Lipcon,2019-06-26 23:54:11+00:00,['30b88b464f0b13ede2099832d40f50f4ed4a1b1b'],6,20,26,1445380,2,1,1,1,2502
dd49c0354fcbb253de05713b01db7fed7a85b394,0,Alexey Serbin,2019-06-27 02:52:26+00:00,['7f7d425eadc10886108a00ee0249d7c3d8372ee0'],14,19,33,1445413,1,0,0,1,2502
ac8462f55715d7bf40770f6553bf52805a7d451d,0,Andrew Wong,2019-06-27 17:59:44+00:00,['dd49c0354fcbb253de05713b01db7fed7a85b394'],16,87,103,1445516,3,0.35,0.8,1,2502
89c02fded7595b4712b465bfb939e4f3035b2e75,0,Todd Lipcon,2019-06-27 23:29:31+00:00,['ac8462f55715d7bf40770f6553bf52805a7d451d'],2,112,114,1445630,7,0.407407407,0.981481481,0.388888889,2502
9ebcb77aa911aae76c48e717af24e643cb81908d,0,Hao Hao,2019-06-28 05:33:16+00:00,['89c02fded7595b4712b465bfb939e4f3035b2e75'],0,162,162,1445792,1,,,,2503
86cf87686ad1165a18a284a99e2bda5b75de4a20,0,Todd Lipcon,2019-06-28 18:34:08+00:00,['9ebcb77aa911aae76c48e717af24e643cb81908d'],22,16,38,1445830,2,0.25,1,0,2503
5c652defff422f908dacc11011dc6ae59bf49be5,0,Grant Henke,2019-06-28 21:28:01+00:00,['86cf87686ad1165a18a284a99e2bda5b75de4a20'],19,19,38,1445868,1,,,,2503
841cc7cd7b2aa0b738118097132bada486ac5b1f,0,Grant Henke,2019-07-01 17:11:40+00:00,['5c652defff422f908dacc11011dc6ae59bf49be5'],22,4,26,1445894,3,,,,2503
70f8131423323004b42e70d85308c0fa07753935,0,Grant Henke,2019-07-01 17:15:21+00:00,['841cc7cd7b2aa0b738118097132bada486ac5b1f'],2,59,61,1445955,2,,,,2504
c82ba1cf7a55156f1b58e9c42eb287a93849f328,0,Todd Lipcon,2019-07-01 22:11:52+00:00,['70f8131423323004b42e70d85308c0fa07753935'],26,29,55,1446010,3,0.333333333,0.333333333,0.666666667,2504
c46efd29b78ddf3461886f3479d18e76a109c9b8,0,Grant Henke,2019-07-02 01:28:08+00:00,['c82ba1cf7a55156f1b58e9c42eb287a93849f328'],0,395,395,1446405,6,,,,2506
81f0dbf99ac2114a29431f49fa2ef480e7ef26c4,0,Grant Henke,2019-07-02 15:55:02+00:00,['c46efd29b78ddf3461886f3479d18e76a109c9b8'],1,2,3,1446408,2,,,,2506
2af0983941f79daae1964972b66dc736ee8d8713,0,Grant Henke,2019-07-03 01:05:56+00:00,['81f0dbf99ac2114a29431f49fa2ef480e7ef26c4'],23,34,57,1446465,1,,,,2506
aaea17b0ffbc27f76cdf337818a7178d334902da,0,Grant Henke,2019-07-03 01:06:16+00:00,['2af0983941f79daae1964972b66dc736ee8d8713'],29,191,220,1446685,1,,,,2506
84098234dd787ccedc2717d95b22bdfd43a1429f,0,Alexey Serbin,2019-07-03 01:11:33+00:00,['aaea17b0ffbc27f76cdf337818a7178d334902da'],4,9,13,1446698,2,1,1,1,2506
cb09474f72b74f8bbb12b89a89450335991aabfa,0,Grant Henke,2019-07-03 11:28:37+00:00,['84098234dd787ccedc2717d95b22bdfd43a1429f'],9,221,230,1446928,1,,,,2506
1a1e405a980601ff35c6d2d9990f5f2a14330f3a,0,Andrew Wong,2019-07-08 16:08:45+00:00,['cb09474f72b74f8bbb12b89a89450335991aabfa'],33,248,281,1447209,3,,,,2506
b612181916be426b18e5cc5490ac1a2d23355936,0,Grant Henke,2019-07-09 16:39:30+00:00,['1a1e405a980601ff35c6d2d9990f5f2a14330f3a'],1,4,5,1447214,1,,,,2506
43f112ec3e9c2285988fb56abe09fe8e3287eecf,0,Grant Henke,2019-07-09 16:39:45+00:00,['b612181916be426b18e5cc5490ac1a2d23355936'],0,281,281,1447495,1,,,,2506
0892c19425bd1a9e3eb293d93a43e1ce38dc3d2d,0,Grant Henke,2019-07-09 21:11:27+00:00,['43f112ec3e9c2285988fb56abe09fe8e3287eecf'],2,1,3,1447498,1,,,,2506
3cbc0d4fbe295748d6ffdf1e5e7edeaf94ef0911,0,Todd Lipcon,2019-07-10 04:03:41+00:00,['0892c19425bd1a9e3eb293d93a43e1ce38dc3d2d'],13,90,103,1447601,1,0.047619048,1,1,2506
daf2572ad107bc50bb8a4e534a5e1414aa71bbe6,1,Adar Dembo,2019-07-10 05:41:28+00:00,['3cbc0d4fbe295748d6ffdf1e5e7edeaf94ef0911'],3,1,4,1447605,2,,,,2506
09e089bfafb9a1fa2099bd43cd0bd786dad0e771,0,Andrew Wong,2019-07-10 19:19:11+00:00,['daf2572ad107bc50bb8a4e534a5e1414aa71bbe6'],0,1,1,1447606,1,,,,2506
0b4948ea3beac43a0dcd2ae2933440d089e337fd,0,Grant Henke,2019-07-10 21:49:44+00:00,['09e089bfafb9a1fa2099bd43cd0bd786dad0e771'],1,18,19,1447625,1,,,,2506
819a85fbb1d836f70a50c136dfcdaebc37faf7a8,0,Grant Henke,2019-07-10 21:49:46+00:00,['0b4948ea3beac43a0dcd2ae2933440d089e337fd'],11,54,65,1447690,2,,,,2506
26bd0fdc4ba74d130f709837e33eb258633c51ce,0,Alexey Serbin,2019-07-11 01:30:07+00:00,['819a85fbb1d836f70a50c136dfcdaebc37faf7a8'],16,1,17,1447707,1,,,,2506
8973a285eaebee0736a6dac29de5eca39746eb0c,0,Adar Dembo,2019-07-11 04:58:55+00:00,['26bd0fdc4ba74d130f709837e33eb258633c51ce'],43,72,115,1447822,4,0.944444444,0,0.277777778,2506
f8d11f22be66b3b7a241bfcdc4778eff7daa6a89,0,Todd Lipcon,2019-07-11 17:07:22+00:00,['8973a285eaebee0736a6dac29de5eca39746eb0c'],14,14,28,1447850,2,0,0,0,2506
99d1bc82034698b5fc7d74e4bd2117a2ce9fc96b,0,Grant Henke,2019-07-11 21:09:30+00:00,['f8d11f22be66b3b7a241bfcdc4778eff7daa6a89'],7,59,66,1447916,2,,,,2507
c1d16856bd4b3bb4b6242fa098d600b6ef321e6a,0,Grant Henke,2019-07-12 18:33:56+00:00,['99d1bc82034698b5fc7d74e4bd2117a2ce9fc96b'],1,1,2,1447918,1,,,,2507
5a4c345ecc791612ee8b4a0fee6cc6bc352afbbd,0,Grant Henke,2019-07-14 23:27:04+00:00,['c1d16856bd4b3bb4b6242fa098d600b6ef321e6a'],2,217,219,1448137,2,,,,2508
192cf7df31503a6d2a5bffc54619ba239639891b,1,Adar Dembo,2019-07-15 21:51:56+00:00,['5a4c345ecc791612ee8b4a0fee6cc6bc352afbbd'],46,98,144,1448281,5,0.020408163,0.612244898,0.836734694,2508
ceee153a4793a851667b27c36f2c16b23036259b,0,Alexey Serbin,2019-07-15 21:57:53+00:00,['192cf7df31503a6d2a5bffc54619ba239639891b'],1,3,4,1448285,1,,,,2508
32cbf9d6bf37ee2df21837e0f62bd15064b1b4ed,0,Alexey Serbin,2019-07-16 02:48:58+00:00,['ceee153a4793a851667b27c36f2c16b23036259b'],130,643,773,1449058,31,0.110032362,0.161812298,0.563106796,2508
10b7d37c8486f48fd14818477235af03090d7895,0,Alexey Serbin,2019-07-16 05:06:20+00:00,['32cbf9d6bf37ee2df21837e0f62bd15064b1b4ed'],3,6,9,1449067,1,,,,2508
c7bf122f3abcb48f6c0ab52ba1b24f1c64174f7a,1,Andrew Wong,2019-07-16 21:33:36+00:00,['10b7d37c8486f48fd14818477235af03090d7895'],96,116,212,1449279,13,1,0,0.125,2508
899f7a101d5713e8e010377d81c06a28e5095973,0,Andrew Wong,2019-07-16 21:50:50+00:00,['c7bf122f3abcb48f6c0ab52ba1b24f1c64174f7a'],2,52,54,1449333,1,,,,2508
bec75e5ac03eec74da8c091a99a4b9f9a27e2b2b,0,Andrew Wong,2019-07-17 00:01:41+00:00,['899f7a101d5713e8e010377d81c06a28e5095973'],2,31,33,1449366,2,0,1,1,2508
99e94efeae33271910348a388531f58e460174a6,0,Alexey Serbin,2019-07-17 01:12:15+00:00,['bec75e5ac03eec74da8c091a99a4b9f9a27e2b2b'],2,2,4,1449370,1,,,,2508
786d45d2ba76230ccd25e7fe24dcebb3828b48c2,0,Adar Dembo,2019-07-18 22:20:08+00:00,['99e94efeae33271910348a388531f58e460174a6'],2,61,63,1449433,5,0.742857143,1,0.914285714,2508
a61d88dbc6b9874f1628c0870c6db90104f513e8,0,Andrew Wong,2019-07-18 22:21:12+00:00,['786d45d2ba76230ccd25e7fe24dcebb3828b48c2'],2,2,4,1449437,1,,,,2508
e1593f0cf85eeb8ea6e4cb75d610dbff67b89002,0,Alexey Serbin,2019-07-19 22:01:17+00:00,['a61d88dbc6b9874f1628c0870c6db90104f513e8'],0,3,3,1449440,1,,,,2508
c6fa43362f79b4adc1b489d04d5b0820b44b68ff,0,Adar Dembo,2019-07-22 19:10:47+00:00,['e1593f0cf85eeb8ea6e4cb75d610dbff67b89002'],1,111,112,1449552,7,0.277777778,0.814814815,0.62962963,2508
54a4a667a1968518977b1eb41c667bcd3507fe1d,0,Adar Dembo,2019-07-24 00:16:35+00:00,['c6fa43362f79b4adc1b489d04d5b0820b44b68ff'],1,1,2,1449554,1,,,,2508
7a8d3aa2164c9cc2955438347ecae9abcb09ccb5,0,Adar Dembo,2019-07-24 03:23:25+00:00,['54a4a667a1968518977b1eb41c667bcd3507fe1d'],24,46,70,1449624,3,0,1,1,2508
8fa502352395016ab97a2f32926a586441fa8ab2,0,Hao Hao,2019-07-24 17:47:57+00:00,['7a8d3aa2164c9cc2955438347ecae9abcb09ccb5'],0,14,14,1449638,1,,,,2508
7cdbac9ec54fad258f9d4d52ce7df5dde3bbb8f9,0,Adar Dembo,2019-07-24 18:16:32+00:00,['8fa502352395016ab97a2f32926a586441fa8ab2'],17,31,48,1449686,3,0.2,1,1,2508
64e27a28110fb7e9c36b0e14c0bb5663b3cafa5a,0,Adar Dembo,2019-07-25 21:21:20+00:00,['7cdbac9ec54fad258f9d4d52ce7df5dde3bbb8f9'],5,0,5,1449691,2,,,,2508
0c8e7ca4ff0e4984cf53ad9250ea1b4b38d8ec63,0,Adar Dembo,2019-07-25 23:15:13+00:00,['64e27a28110fb7e9c36b0e14c0bb5663b3cafa5a'],2,2,4,1449695,2,,,,2508
4669afc237738003431c0cf849ee2da26870b441,0,Yingchun Lai,2019-07-26 01:48:19+00:00,['0c8e7ca4ff0e4984cf53ad9250ea1b4b38d8ec63'],120,439,559,1450254,11,0.100806452,0.931451613,0.911290323,2508
d8aeab7f97a76275e6f7f647099c5b339961c623,0,Adar Dembo,2019-07-29 18:21:08+00:00,['4669afc237738003431c0cf849ee2da26870b441'],237,316,553,1450807,27,0,0,0.838709677,2508
f98748c8dd33bac2595b66f281944094f0754d16,0,Adar Dembo,2019-07-30 04:05:07+00:00,['d8aeab7f97a76275e6f7f647099c5b339961c623'],1,1,2,1450809,1,,,,2508
58e01492320f954cd173d5ad3638d8f0530eb086,0,Andrew Wong,2019-07-30 04:06:27+00:00,['f98748c8dd33bac2595b66f281944094f0754d16'],0,752,752,1451561,4,0.034671533,0.72810219,0.762773723,2508
51a0d066900fa1e9a35ab0f0fc5eff92099c8a88,0,Andrew Wong,2019-07-30 18:30:56+00:00,['58e01492320f954cd173d5ad3638d8f0530eb086'],4,6,10,1451571,1,,,,2508
e65b6d77a1afec28e3fe8cf592d61a1e4ea8656c,0,Grant Henke,2019-07-31 01:15:16+00:00,['51a0d066900fa1e9a35ab0f0fc5eff92099c8a88'],7,1174,1181,1452752,4,,,,2510
de49f8e20638da4fc016609e9324445a5ce528c6,0,Yingchun Lai,2019-07-31 02:32:37+00:00,['e65b6d77a1afec28e3fe8cf592d61a1e4ea8656c'],50,49,99,1452851,7,0,0,1,2510
536b3fe2a3637da98dcd95309287fbc5e7647a7f,0,Adar Dembo,2019-07-31 21:33:53+00:00,['de49f8e20638da4fc016609e9324445a5ce528c6'],13,21,34,1452885,2,0,0,1,2510
50713864195df24e1777ee592887b88c57f6985b,0,Grant Henke,2019-07-31 21:34:55+00:00,['536b3fe2a3637da98dcd95309287fbc5e7647a7f'],2,2,4,1452889,1,,,,2510
ff9d377c04374999514aa48e8b3470126893fc30,0,Grant Henke,2019-08-01 13:24:02+00:00,['50713864195df24e1777ee592887b88c57f6985b'],2,2,4,1452893,1,,,,2510
d5eb6832704fc11a624e5d02a5910dc96245ca3c,0,Adar Dembo,2019-08-02 03:00:15+00:00,['ff9d377c04374999514aa48e8b3470126893fc30'],2,2,4,1452897,2,,,,2510
bc80ccc5b630cfa2c8d29889553780f0a1c7e5ef,0,Adar Dembo,2019-08-02 03:00:24+00:00,['d5eb6832704fc11a624e5d02a5910dc96245ca3c'],7,7,14,1452911,1,,,,2510
46d186718f64e2c80fdd0bea8216a78e2a27af8f,0,Adar Dembo,2019-08-03 04:43:42+00:00,['bc80ccc5b630cfa2c8d29889553780f0a1c7e5ef'],49,15,64,1452975,3,0.25,0,0.75,2510
8c14875659b7edd0f4353e945351eada8d5fb9e3,0,Adar Dembo,2019-08-03 04:44:40+00:00,['46d186718f64e2c80fdd0bea8216a78e2a27af8f'],4,15,19,1452994,1,0,1,1,2510
344f635b7bd47d609502ed64a1aec74e72c88619,0,Andrew Wong,2019-08-07 00:43:38+00:00,['8c14875659b7edd0f4353e945351eada8d5fb9e3'],287,261,548,1453542,26,0.8,0,0.066666667,2510
00c60a2de9a652233b2f5fbbcfd5d14ede326b88,0,Grant Henke,2019-08-07 23:36:05+00:00,['344f635b7bd47d609502ed64a1aec74e72c88619'],0,40,40,1453582,2,,,,2510
76b80ec01e152f1f9b54ac5a959d7f0cf5ac9f93,0,Grant Henke,2019-08-08 20:57:24+00:00,['00c60a2de9a652233b2f5fbbcfd5d14ede326b88'],23,58,81,1453663,8,0,0.692307692,0.692307692,2510
6f04bc1edd3e652013af7f67c8ec0a7df41cc224,0,Andrew Wong,2019-08-12 18:19:42+00:00,['76b80ec01e152f1f9b54ac5a959d7f0cf5ac9f93'],1,0,1,1453664,1,,,,2510
68a4e7492367e36fc117969b4c39f666d66d8f63,0,Adar Dembo,2019-08-12 19:48:34+00:00,['6f04bc1edd3e652013af7f67c8ec0a7df41cc224'],89,242,331,1453995,9,0.523809524,0.865079365,0,2510
b107b420f8824a789d8513e2e3ff5a756f8ab898,0,Adar Dembo,2019-08-13 18:46:12+00:00,['68a4e7492367e36fc117969b4c39f666d66d8f63'],40,122,162,1454157,8,1,0.37704918,1,2510
01033aba27bb3bd846394849d854cf5f027f9b31,0,Adar Dembo,2019-08-14 03:28:55+00:00,['b107b420f8824a789d8513e2e3ff5a756f8ab898'],87,107,194,1454351,9,0,0,0.777777778,2510
0d48cad4976d670c22182ca8d838a568f3b7034b,1,Adar Dembo,2019-08-15 04:25:06+00:00,['01033aba27bb3bd846394849d854cf5f027f9b31'],35,765,800,1455151,22,0.180878553,0.472868217,0.88630491,2512
fe6e5cc0c9c1573de174d1ce7838b449373ae36e,0,Adar Dembo,2019-08-15 16:30:14+00:00,['0d48cad4976d670c22182ca8d838a568f3b7034b'],176,874,1050,1456201,7,0.37,1,0.742,2512
49a7fee6c545e11b5e08fac6fea69c868e1d6b54,0,Adar Dembo,2019-08-15 23:54:42+00:00,['fe6e5cc0c9c1573de174d1ce7838b449373ae36e'],9,18,27,1456228,1,0,1,1,2512
250e6f14dd27d34cc88a910d27de2015b07c00ca,0,Alexey Serbin,2019-08-16 17:09:49+00:00,['49a7fee6c545e11b5e08fac6fea69c868e1d6b54'],2,120,122,1456350,2,,,,2513
b04cb34e6da79842d0239a3a9cf565d68090c32b,0,Adar Dembo,2019-08-16 19:15:21+00:00,['250e6f14dd27d34cc88a910d27de2015b07c00ca'],59,12,71,1456421,5,,,,2513
191e329a11f6ea3695ea5ee3e1009cbdcc44ec9e,0,Alexey Serbin,2019-08-17 00:10:01+00:00,['b04cb34e6da79842d0239a3a9cf565d68090c32b'],0,3,3,1456424,1,0,1,1,2513
8db3476444e6af608cca3cea3f75923b6e53d2dd,0,Alexey Serbin,2019-08-17 03:44:05+00:00,['191e329a11f6ea3695ea5ee3e1009cbdcc44ec9e'],0,5,5,1456429,1,0,1,1,2513
9e9c950df8255c6fa423b08170ce9e886c5c111c,0,Alexey Serbin,2019-08-19 06:46:29+00:00,['8db3476444e6af608cca3cea3f75923b6e53d2dd'],4,10,14,1456443,1,,,,2513
8c977a8a5a660b6ddd92b67776bc9698ce9fa947,0,Alexey Serbin,2019-08-20 03:30:21+00:00,['9e9c950df8255c6fa423b08170ce9e886c5c111c'],13,84,97,1456540,1,0.039215686,1,1,2513
dc3cbb795218b9b05da78f65249cbaf61395cc50,0,Andrew Wong,2019-08-20 04:25:55+00:00,['8c977a8a5a660b6ddd92b67776bc9698ce9fa947'],3,534,537,1457077,4,0.061032864,0.845070423,0.845070423,2513
d0a93831ce39418c7d5c7d854a32aeb40b29dee7,0,Alexey Serbin,2019-08-20 15:57:53+00:00,['dc3cbb795218b9b05da78f65249cbaf61395cc50'],105,98,203,1457280,33,,,,2513
413396c85d7dd56830f563ec754653b2b0ae26fd,0,Alexey Serbin,2019-08-20 16:34:13+00:00,['d0a93831ce39418c7d5c7d854a32aeb40b29dee7'],2,2,4,1457284,2,,,,2513
0c9204c41cad73e64ef5427c67034f0a6a2265e9,0,Alexey Serbin,2019-08-20 22:28:42+00:00,['413396c85d7dd56830f563ec754653b2b0ae26fd'],1,0,1,1457285,1,1,0,0,2513
b9c429c6831cf7aa948490136eeedc984cf7e4c1,0,Adar Dembo,2019-08-21 17:59:13+00:00,['0c9204c41cad73e64ef5427c67034f0a6a2265e9'],80,177,257,1457542,10,0,0.484848485,0.787878788,2513
98b6faae52c2bc787443f242e238a2e43d57ad81,0,Grant Henke,2019-08-22 01:19:40+00:00,['b9c429c6831cf7aa948490136eeedc984cf7e4c1'],7,7,14,1457556,4,,,,2513
0f38821c4867b86044be22dbceb80c7bc04b5d33,0,Alexey Serbin,2019-08-22 01:33:36+00:00,['98b6faae52c2bc787443f242e238a2e43d57ad81'],0,86,86,1457642,5,,,,2514
ba809891e723c056b7b4f95f180a861536ec60ae,0,Alexey Serbin,2019-08-22 04:30:08+00:00,['0f38821c4867b86044be22dbceb80c7bc04b5d33'],72,78,150,1457792,5,1,,0,2514
8124d94825e3573a95d87d48d2c3326eb499cab3,0,Andrew Wong,2019-08-23 06:20:41+00:00,['ba809891e723c056b7b4f95f180a861536ec60ae'],2,2,4,1457796,1,,,,2514
7116a0841ca4dcd62d3e6338cfbd6672df86770a,0,Andrew Wong,2019-08-23 06:24:33+00:00,['8124d94825e3573a95d87d48d2c3326eb499cab3'],54,108,162,1457958,5,0,1,1,2514
81353eb38d86694eefeb5fbacef300079f2f58c6,0,Andrew Wong,2019-08-23 07:27:58+00:00,['7116a0841ca4dcd62d3e6338cfbd6672df86770a'],13,103,116,1458074,4,0.142857143,1,0.753246753,2514
8af4883be0d49d4fe69ef697345d1feee799c935,0,Andrew Wong,2019-08-24 00:55:14+00:00,['81353eb38d86694eefeb5fbacef300079f2f58c6'],4,8,12,1458086,1,0,1,1,2514
d46c14179312a756620eb373fcccfb429c51cb2d,0,Alexey Serbin,2019-08-26 14:04:50+00:00,['8af4883be0d49d4fe69ef697345d1feee799c935'],18,25,43,1458129,1,0,0,1,2514
efda91850e57a904f1b0e7858a3e2d8c4e2b7241,1,Alexey Serbin,2019-08-26 22:35:26+00:00,['d46c14179312a756620eb373fcccfb429c51cb2d'],2,802,804,1458933,8,0.307471264,0.853448276,0.974137931,2517
8bce2bc26635355c8d4d3fb955ee481bbfbbf6c8,0,Adar Dembo,2019-08-27 04:16:22+00:00,['efda91850e57a904f1b0e7858a3e2d8c4e2b7241'],171,230,401,1459334,2,0,1,1,2517
ae80d16037a5df14b4d35a76655564dae7dffe24,0,Andrew Wong,2019-08-27 22:31:40+00:00,['8bce2bc26635355c8d4d3fb955ee481bbfbbf6c8'],74,336,410,1459744,7,0.12962963,0.660493827,0.574074074,2517
e2567b69ed3947f7b75a7d3bf2a7b65b3885bcec,1,Alexey Serbin,2019-08-28 00:40:24+00:00,['ae80d16037a5df14b4d35a76655564dae7dffe24'],1326,1617,2943,1462687,25,0,0,0,2522
e253bb88c667c8337decda188bef85898661aadb,0,Adar Dembo,2019-08-28 18:39:02+00:00,['e2567b69ed3947f7b75a7d3bf2a7b65b3885bcec'],4,4,8,1462695,1,0,0,0,2522
a20da815da5660c163afc98370b0b51dd90a6fdb,0,Alexey Serbin,2019-08-29 00:31:44+00:00,['e253bb88c667c8337decda188bef85898661aadb'],2,2,4,1462699,1,,,,2522
220391f850847232d9aff1dbd72caa2ce7ec3a1e,0,Grant Henke,2019-08-29 15:19:49+00:00,['a20da815da5660c163afc98370b0b51dd90a6fdb'],10,10,20,1462719,2,,,,2522
d268e0d455494f5b78a57b65310f6075b4b48739,0,Alexey Serbin,2019-09-03 21:24:35+00:00,['220391f850847232d9aff1dbd72caa2ce7ec3a1e'],18,30,48,1462767,1,,,,2522
0cbb9103896f037b88c7a82cc09f35661949e780,0,Grant Henke,2019-09-04 01:31:40+00:00,['d268e0d455494f5b78a57b65310f6075b4b48739'],13,20,33,1462800,1,,,,2522
41bd37cd13268ab67c701adea6aecc8cc010890e,0,Alexey Serbin,2019-09-05 16:00:19+00:00,['0cbb9103896f037b88c7a82cc09f35661949e780'],8,28,36,1462836,1,1,1,1,2522
9f6e9576bcca8bf6d6ac1803d3d69c2de135e911,0,Alexey Serbin,2019-09-06 20:08:55+00:00,['41bd37cd13268ab67c701adea6aecc8cc010890e'],7,7,14,1462850,3,,,,2522
20dffb3659d7e577bd421d89c938d72be0b10b93,0,Alexey Serbin,2019-09-09 18:59:42+00:00,['9f6e9576bcca8bf6d6ac1803d3d69c2de135e911'],2,2,4,1462854,1,,,,2522
e233e7c127db1f593be1b0f477267c060f7dd6f3,1,Adar Dembo,2019-09-10 03:54:21+00:00,['20dffb3659d7e577bd421d89c938d72be0b10b93'],0,516,516,1463370,20,0.493087558,1,0.769585253,2525
56f8d6b363d4f14ede7bb9415f715f60eeea4273,0,Adar Dembo,2019-09-10 17:47:45+00:00,['e233e7c127db1f593be1b0f477267c060f7dd6f3'],5,85,90,1463460,2,0.350877193,0.350877193,1,2525
59c2de495a16f6c252196e91a9b4beeba28ed969,1,Alexey Serbin,2019-09-10 20:45:27+00:00,['56f8d6b363d4f14ede7bb9415f715f60eeea4273'],11,49,60,1463520,7,0.55,0,0.65,2525
ab69837059136dff64df33d5c1eedbc6d93b2357,1,Grant Henke,2019-09-10 23:08:43+00:00,['59c2de495a16f6c252196e91a9b4beeba28ed969'],71,281,352,1463872,11,0.311594203,0.231884058,0.971014493,2525
8258595030fea07906fce91eeff0b18e695402c2,0,Yingchun Lai,2019-09-11 02:00:42+00:00,['ab69837059136dff64df33d5c1eedbc6d93b2357'],1,28,29,1463901,2,1,1,1,2525
50f9347ceef2e09c56acb5b73b382a49285d6451,0,Alexey Serbin,2019-09-11 18:26:31+00:00,['8258595030fea07906fce91eeff0b18e695402c2'],11,230,241,1464142,3,0.026315789,0.210526316,1,2525
b08e80618e6b562db7897d853d9b2b5cf65a6a4f,0,Grant Henke,2019-09-12 18:46:00+00:00,['50f9347ceef2e09c56acb5b73b382a49285d6451'],1,3,4,1464146,2,,,,2525
32f622b4075f9a221c9e376c01c2db9303dacf2b,0,Alexey Serbin,2019-09-13 00:11:42+00:00,['b08e80618e6b562db7897d853d9b2b5cf65a6a4f'],0,3,3,1464149,1,,,,2525
36d7e909539e5f0f70a9460dde31d0bba58089c8,0,Adar Dembo,2019-09-13 22:56:51+00:00,['32f622b4075f9a221c9e376c01c2db9303dacf2b'],0,13,13,1464162,1,,,,2525
96f4cbe7dc62f68910f42da2f161e953e4bcabee,0,Adar Dembo,2019-09-13 23:03:02+00:00,['36d7e909539e5f0f70a9460dde31d0bba58089c8'],0,28,28,1464190,2,0.428571429,1,1,2525
324b8f2dabe6686dc98cb36455ad16825730b034,0,Adar Dembo,2019-09-13 23:04:23+00:00,['96f4cbe7dc62f68910f42da2f161e953e4bcabee'],3,27,30,1464220,3,0.833333333,1,1,2525
b9847ff0841e3a4019181cbf61cdb531fecede71,0,Adar Dembo,2019-09-14 00:23:00+00:00,['324b8f2dabe6686dc98cb36455ad16825730b034'],0,231,231,1464451,3,,,,2528
bf1a07e8557e09cda8a7fddf4930d0bc2ce8efa9,1,Adar Dembo,2019-09-16 18:48:55+00:00,['b9847ff0841e3a4019181cbf61cdb531fecede71'],0,150,150,1464601,5,0.566037736,1,1,2529
b6103f263f43229c09d7cae2df3c9e1a7506728f,0,Alexey Serbin,2019-09-16 23:34:49+00:00,['bf1a07e8557e09cda8a7fddf4930d0bc2ce8efa9'],2,36,38,1464639,2,,,,2530
1bdae88faefe9b0d43b6897d96cd853bc5dd7353,0,Alexey Serbin,2019-09-16 23:39:11+00:00,['b6103f263f43229c09d7cae2df3c9e1a7506728f'],2,2,4,1464643,1,,,,2530
ff8ee5de8e0ba48456a132464e57e0feb49e8815,0,Adar Dembo,2019-09-17 20:43:53+00:00,['1bdae88faefe9b0d43b6897d96cd853bc5dd7353'],1,1,2,1464645,1,,,,2530
f0b21498fb20a08724abcf8ecae62c2a7ed57507,0,Andrew Wong,2019-09-18 02:13:36+00:00,['ff8ee5de8e0ba48456a132464e57e0feb49e8815'],28,55,83,1464728,4,0,0,1,2530
c55b6b5f79eb15943ac9e49ae935acd5fe28f161,1,Adar Dembo,2019-09-18 16:12:10+00:00,['f0b21498fb20a08724abcf8ecae62c2a7ed57507'],29,29,58,1464786,5,0,0,0,2530
518402c00ca41457ce4ea23b90759fdf1dae91fb,0,Adar Dembo,2019-09-18 16:42:53+00:00,['c55b6b5f79eb15943ac9e49ae935acd5fe28f161'],12,10,22,1464808,5,0,0,1,2530
0ecc2c7715505fa6d5a03f8ef967a1a96d4f55d5,1,Adar Dembo,2019-09-18 18:06:44+00:00,['518402c00ca41457ce4ea23b90759fdf1dae91fb'],7,3,10,1464818,1,0,0,0,2530
f5658f2d9cb28eedbd30ab44e57363427df877c5,1,Andrew Wong,2019-09-18 22:06:17+00:00,['0ecc2c7715505fa6d5a03f8ef967a1a96d4f55d5'],21,444,465,1465283,8,0.382075472,0.816037736,0.896226415,2531
e20487a19bd5c2446a64abc22540537a392ab752,0,Andrew Wong,2019-09-18 22:21:17+00:00,['f5658f2d9cb28eedbd30ab44e57363427df877c5'],14,16,30,1465313,1,,,,2531
fda08769c658a592198e0d9ae35f16dd1fb0ef9d,0,Andrew Wong,2019-09-18 22:26:07+00:00,['e20487a19bd5c2446a64abc22540537a392ab752'],1,3,4,1465317,1,0,1,1,2531
e8362ca1bb48ed0150cf134d93899d7a2f74caf3,1,Andrew Wong,2019-09-18 22:58:54+00:00,['fda08769c658a592198e0d9ae35f16dd1fb0ef9d'],21,117,138,1465455,4,0.456140351,1,1,2531
053d2e1c94ab1ae79b9c17a475a0e3d9a25fd0d0,1,Andrew Wong,2019-09-18 23:26:33+00:00,['e8362ca1bb48ed0150cf134d93899d7a2f74caf3'],0,158,158,1465613,5,0.147727273,0.465909091,0.465909091,2531
49308a199bfc39b080d8d65190fb63b2a287cb7b,0,Adar Dembo,2019-09-19 00:46:53+00:00,['053d2e1c94ab1ae79b9c17a475a0e3d9a25fd0d0'],3,11,14,1465627,1,1,1,1,2531
f5a69ca0871deaf9c0f0915addea53b5aacfa12b,0,Adar Dembo,2019-09-19 03:50:53+00:00,['49308a199bfc39b080d8d65190fb63b2a287cb7b'],0,1,1,1465628,1,1,1,1,2531
4c157da6ceb203420d530c41f760c075360928ed,0,Adar Dembo,2019-09-19 20:03:58+00:00,['f5a69ca0871deaf9c0f0915addea53b5aacfa12b'],31,25,56,1465684,3,0,0,0,2531
9339f6dda1c30e007bab3cfb0f37a9dcb327e683,0,Adar Dembo,2019-09-20 04:14:27+00:00,['4c157da6ceb203420d530c41f760c075360928ed'],20,167,187,1465871,10,0.578431373,0.921568627,0.980392157,2531
0e39aae7ee09559a37774a53e84a37a89a9b22ce,0,Alexey Serbin,2019-09-20 05:49:28+00:00,['9339f6dda1c30e007bab3cfb0f37a9dcb327e683'],11,11,22,1465893,1,,,,2531
3b74ec7d532151488d86443f7af721ce4cd61b6c,0,Alexey Serbin,2019-09-20 05:50:13+00:00,['0e39aae7ee09559a37774a53e84a37a89a9b22ce'],10,10,20,1465913,2,,,,2531
15ecb240d8055743090f8739e8e29dd8b9fea0b3,1,Andrew Wong,2019-09-20 21:28:09+00:00,['3b74ec7d532151488d86443f7af721ce4cd61b6c'],50,199,249,1466162,4,0.558441558,0.987012987,0.818181818,2531
77ba022fcd811903680eafa616c3cbf3f69ff06c,0,Alexey Serbin,2019-09-20 22:42:19+00:00,['15ecb240d8055743090f8739e8e29dd8b9fea0b3'],60,19,79,1466241,1,1,1,0,2531
ee22ddcc734ab4947218c670d5cfddd61fe90fbb,0,Alexey Serbin,2019-09-21 04:37:22+00:00,['77ba022fcd811903680eafa616c3cbf3f69ff06c'],4,188,192,1466433,3,0.044247788,0.044247788,0.991150442,2531
cc70b3b965cbb86ddf96c2040b3e6a55721adc00,1,Andrew Wong,2019-09-24 01:48:36+00:00,['ee22ddcc734ab4947218c670d5cfddd61fe90fbb'],524,366,890,1467323,6,0.711538462,0.134615385,0.490384615,2531
e64aa5f5ec401deaee47399e409bd3c5119b8efd,0,Alexey Serbin,2019-09-24 02:15:21+00:00,['cc70b3b965cbb86ddf96c2040b3e6a55721adc00'],2,3,5,1467328,1,,,,2531
b35cf4fa5fe305d0a915c9c70d05ec112969fb6d,0,Adar Dembo,2019-09-24 17:15:39+00:00,['e64aa5f5ec401deaee47399e409bd3c5119b8efd'],2,2,4,1467332,2,,,,2531
aa3d7134eb5cce0556ce427d9398f1257bb51984,1,Alexey Serbin,2019-09-24 17:53:44+00:00,['b35cf4fa5fe305d0a915c9c70d05ec112969fb6d'],38,150,188,1467520,4,1,1,0.285714286,2533
4dcbcf1c95420fbc9f9dff72c49ed2c43c71eb6a,0,Andrew Wong,2019-09-24 18:45:23+00:00,['aa3d7134eb5cce0556ce427d9398f1257bb51984'],17,55,72,1467592,3,0,1,1,2533
dfd2ed2d10e354833e9438a285ce25727151b0d7,1,Andrew Wong,2019-09-25 17:58:26+00:00,['4dcbcf1c95420fbc9f9dff72c49ed2c43c71eb6a'],5,71,76,1467668,6,0.47826087,1,1,2533
e110cb88b145edb6d536ae0806e02736f5bf51e5,0,Alexey Serbin,2019-09-26 05:03:28+00:00,['dfd2ed2d10e354833e9438a285ce25727151b0d7'],64,52,116,1467784,3,0.2,0,0,2533
69cbf8526b4ef5f5b19e7a19f1993a7a9bcd536a,0,Alexey Serbin,2019-09-26 05:05:07+00:00,['e110cb88b145edb6d536ae0806e02736f5bf51e5'],2,2,4,1467788,1,,,,2533
a8947936fa68223c31ca557c11ddd8851b6544c6,0,Adar Dembo,2019-09-26 17:11:34+00:00,['69cbf8526b4ef5f5b19e7a19f1993a7a9bcd536a'],1,1,2,1467790,1,,,,2533
ddcc5599137a23b014ab3835d01a1450ffa6756e,0,Andrew Wong,2019-09-26 23:09:16+00:00,['a8947936fa68223c31ca557c11ddd8851b6544c6'],1,1,2,1467792,1,,,,2533
883367ee371bbc0ef10ee05e8272d0cda5ca2914,0,Adar Dembo,2019-09-27 22:25:40+00:00,['ddcc5599137a23b014ab3835d01a1450ffa6756e'],18,13,31,1467823,1,,,,2533
5b2259a79ca52a6bbbd72386c157d3b37bfec489,0,Alexey Serbin,2019-09-27 23:10:53+00:00,['883367ee371bbc0ef10ee05e8272d0cda5ca2914'],6,7,13,1467836,2,1,1,1,2533
fcbca3dd1234a2c0a41b6dcf9f1d7b6410f33c34,0,Alexey Serbin,2019-09-28 00:44:22+00:00,['5b2259a79ca52a6bbbd72386c157d3b37bfec489'],50,51,101,1467937,6,0,0,1,2533
c103d51a52d00c3a9d062e06e20a5cc8c98df9a0,0,Alexey Serbin,2019-10-01 04:10:50+00:00,['fcbca3dd1234a2c0a41b6dcf9f1d7b6410f33c34'],5,1651,1656,1469593,5,0.357429719,0.779116466,1,2536
12922d8d89416f362c55945d8e50797776731ee2,0,Alexey Serbin,2019-10-01 04:11:24+00:00,['c103d51a52d00c3a9d062e06e20a5cc8c98df9a0'],84,511,595,1470188,6,0,1,0.846491228,2538
1efa619a22cb48b69de180a067008644dca878f8,1,Alexey Serbin,2019-10-01 04:11:33+00:00,['12922d8d89416f362c55945d8e50797776731ee2'],47,117,164,1470352,4,0.311111111,0.733333333,1,2538
5316a89dfd13c36eef078b32043f161e6d0bbf01,1,Andrew Wong,2019-10-01 04:34:32+00:00,['1efa619a22cb48b69de180a067008644dca878f8'],24,657,681,1471033,8,0.181333333,0.872,0.845333333,2539
3cd6bd0b6b2eaba1027974eabc1490d90691ce82,0,Andrew Wong,2019-10-01 05:14:25+00:00,['5316a89dfd13c36eef078b32043f161e6d0bbf01'],2,74,76,1471109,7,0.428571429,0.657142857,0.8,2539
8ef7e18f3528000f656cb9a467a6787e6ed080c9,0,Adar Dembo,2019-10-01 06:04:25+00:00,['3cd6bd0b6b2eaba1027974eabc1490d90691ce82'],13,23,36,1471145,2,0,1,1,2539
2e1c6794662ad8f7cc718ebff5361c570e96102a,0,Adar Dembo,2019-10-01 06:05:07+00:00,['8ef7e18f3528000f656cb9a467a6787e6ed080c9'],0,1,1,1471146,1,0,0,1,2539
8ddeda605c3378220efb506cf24158978f87928b,0,Alexey Serbin,2019-10-01 06:13:23+00:00,['2e1c6794662ad8f7cc718ebff5361c570e96102a'],40,39,79,1471225,6,0,0,0,2539
e7d9d02479d5e3801b711164a157c51a2c9109c5,0,Adar Dembo,2019-10-01 17:51:45+00:00,['8ddeda605c3378220efb506cf24158978f87928b'],2,8,10,1471235,1,,,,2539
62c2fddcdc65f2092ee335ac1a35288dd3f7e4a5,0,Andrew Wong,2019-10-01 23:54:12+00:00,['e7d9d02479d5e3801b711164a157c51a2c9109c5'],20,40,60,1471295,5,0.666666667,0.933333333,0.333333333,2539
09ffff48d4122f4ea44fa4ff841cc089a2fc1aea,0,Adar Dembo,2019-10-02 04:02:52+00:00,['62c2fddcdc65f2092ee335ac1a35288dd3f7e4a5'],1,1,2,1471297,1,,,,2539
3f6d3c46e8ca4cf5898eec50d61dbe91caa170e5,0,Adar Dembo,2019-10-02 04:02:56+00:00,['09ffff48d4122f4ea44fa4ff841cc089a2fc1aea'],1,2,3,1471300,1,0,0,0,2539
f73671a5a619d543dcda61179388c496a7ca1352,0,Adar Dembo,2019-10-02 04:11:01+00:00,['3f6d3c46e8ca4cf5898eec50d61dbe91caa170e5'],1,3,4,1471304,1,0,1,1,2539
51ccb1165a1ca6f243dfdcbf86fe6af3abe7fc77,0,Andrew Wong,2019-10-02 05:20:20+00:00,['f73671a5a619d543dcda61179388c496a7ca1352'],0,4,4,1471308,1,0,1,1,2539
d5447c12c4676c2b176c45ed6a863a1ae9082726,0,Andrew Wong,2019-10-02 05:31:47+00:00,['51ccb1165a1ca6f243dfdcbf86fe6af3abe7fc77'],1,1,2,1471310,1,,,,2539
fc0e973ed056c21f19492239f9be9199bbafa4f9,0,Andrew Wong,2019-10-02 06:31:14+00:00,['d5447c12c4676c2b176c45ed6a863a1ae9082726'],18,38,56,1471366,1,0.125,0.375,0,2539
493eb10eca9050c42f877049d003c941fcd1f1e8,0,Alexey Serbin,2019-10-02 18:42:57+00:00,['fc0e973ed056c21f19492239f9be9199bbafa4f9'],1,12,13,1471379,1,1,1,1,2539
6bdcc4ef536c413615030b37520f6f1dfec65970,0,Alexey Serbin,2019-10-02 20:09:33+00:00,['493eb10eca9050c42f877049d003c941fcd1f1e8'],1,4,5,1471384,1,0,1,1,2539
708f2501aa36acfdbdd7951c455d96397ccda523,0,Alexey Serbin,2019-10-02 22:19:35+00:00,['6bdcc4ef536c413615030b37520f6f1dfec65970'],12,16,28,1471412,3,,,,2539
d119d529beb691a84134d02e33ecdce6102a7a35,0,Alexey Serbin,2019-10-03 15:43:55+00:00,['708f2501aa36acfdbdd7951c455d96397ccda523'],7,9,16,1471428,1,1,0,0,2539
f9adfd16b8d03b350b8dacf7bbb95fc1975dca14,0,Alexey Serbin,2019-10-03 16:36:39+00:00,['d119d529beb691a84134d02e33ecdce6102a7a35'],19,27,46,1471474,5,1,1,1,2539
fa6d5a228e7d27e7bc8749d425596fecd8c8ca1e,0,Alexey Serbin,2019-10-03 19:43:11+00:00,['f9adfd16b8d03b350b8dacf7bbb95fc1975dca14'],53,90,143,1471617,4,0,1,0,2539
d41293969d4cd908b7b030ac8a136fb457b50037,0,Alexey Serbin,2019-10-04 17:09:26+00:00,['fa6d5a228e7d27e7bc8749d425596fecd8c8ca1e'],5,13,18,1471635,2,0.666666667,0.666666667,1,2539
03e2ada694290cafce0bea6ebbf092709aa64a2a,1,Alexey Serbin,2019-10-04 17:09:36+00:00,['d41293969d4cd908b7b030ac8a136fb457b50037'],6,26,32,1471667,3,0.857142857,0.857142857,1,2539
8c439410df562979bb88f937771a144c4a6537f2,0,Alexey Serbin,2019-10-04 20:52:23+00:00,['03e2ada694290cafce0bea6ebbf092709aa64a2a'],7,8,15,1471682,1,,,,2539
68302a6cb40f1b325c891194eef6cc148310bf82,0,Andrew Wong,2019-10-04 21:37:55+00:00,['8c439410df562979bb88f937771a144c4a6537f2'],15,0,15,1471697,3,0.833333333,0.666666667,0.666666667,2539
991ad543ac75d6c38c052ef25cbe8fbf667dc3bc,0,Alexey Serbin,2019-10-07 06:20:07+00:00,['68302a6cb40f1b325c891194eef6cc148310bf82'],70,77,147,1471844,4,0,1,1,2539
396e41280bc4eb5a1282db9e500feaadd09d5c4f,0,Adar Dembo,2019-10-07 23:56:18+00:00,['991ad543ac75d6c38c052ef25cbe8fbf667dc3bc'],9,26,35,1471879,1,0,0,1,2539
7667aa2a3486283fe4e976944bc056d7a0e25eac,0,Alexey Serbin,2019-10-08 14:45:08+00:00,['396e41280bc4eb5a1282db9e500feaadd09d5c4f'],2,2,4,1471883,1,,,,2539
ecc89cf10d849c56c941984a9f74d6eb8ffb81c1,0,Andrew Wong,2019-10-08 22:56:07+00:00,['7667aa2a3486283fe4e976944bc056d7a0e25eac'],2,179,181,1472064,9,0.064220183,0.688073394,0.899082569,2539
1f4d473c74e7d57eeae3b384a46f4eb088e16223,1,Andrew Wong,2019-10-08 22:56:09+00:00,['ecc89cf10d849c56c941984a9f74d6eb8ffb81c1'],8,108,116,1472180,6,0,0.841269841,0.714285714,2539
32ab113869aad8dd7b158836658669ab15d217b4,0,Andrew Wong,2019-10-09 00:45:54+00:00,['1f4d473c74e7d57eeae3b384a46f4eb088e16223'],3,4,7,1472187,2,,,,2539
6b7b40b2835598a96ea85900840db48f4d6fcc5b,0,Adar Dembo,2019-10-09 05:03:25+00:00,['32ab113869aad8dd7b158836658669ab15d217b4'],51,43,94,1472281,2,0,1,1,2539
ac235e3f7ad90ccfd9478abdfc5c7523896d37c8,0,Andrew Wong,2019-10-09 05:54:34+00:00,['6b7b40b2835598a96ea85900840db48f4d6fcc5b'],33,132,165,1472446,8,0.088888889,0.066666667,0.955555556,2539
2618ef370d2848fc949bc6f8da01e74ae871f26e,0,Alexey Serbin,2019-10-09 16:00:49+00:00,['ac235e3f7ad90ccfd9478abdfc5c7523896d37c8'],4,3,7,1472453,1,,,,2539
c29ee5556a76bda9d8c15ae9b25164296a7d0ad9,0,Adar Dembo,2019-10-09 18:32:54+00:00,['2618ef370d2848fc949bc6f8da01e74ae871f26e'],6,28,34,1472487,2,0.571428571,0.571428571,0.571428571,2539
b6e4672092292acf7316a700c71fad3bb54ffa77,0,Alexey Serbin,2019-10-10 17:49:10+00:00,['c29ee5556a76bda9d8c15ae9b25164296a7d0ad9'],5,1,6,1472493,1,,,,2539
25d92848ad7dc0852b23b9e967aa695005b8b374,0,Andrew Wong,2019-10-10 22:48:59+00:00,['b6e4672092292acf7316a700c71fad3bb54ffa77'],3,52,55,1472548,2,0.107142857,0.857142857,1,2539
6f49b2dc076603d83d4ce2abaab47eab960b47bd,0,Alexey Serbin,2019-10-11 04:12:59+00:00,['25d92848ad7dc0852b23b9e967aa695005b8b374'],6,8,14,1472562,1,,,,2539
06621af23fc29366f33e4950e035502457f1a3b6,0,Alexey Serbin,2019-10-11 16:48:25+00:00,['6f49b2dc076603d83d4ce2abaab47eab960b47bd'],1,1,2,1472564,1,,,,2539
2768c156186e3da9693ddeff78a8d3206827fb88,0,Alexey Serbin,2019-10-11 20:20:34+00:00,['06621af23fc29366f33e4950e035502457f1a3b6'],12,8,20,1472584,1,0.75,0.75,0,2539
4d667403e55b70de74557643af455ff21438bf70,0,Alexey Serbin,2019-10-11 20:20:42+00:00,['2768c156186e3da9693ddeff78a8d3206827fb88'],40,30,70,1472654,3,,,,2539
bd7416aec2f865fe4c3d187801cc775b549cc84d,0,Andrew Wong,2019-10-12 01:57:19+00:00,['4d667403e55b70de74557643af455ff21438bf70'],89,66,155,1472809,29,0,0,0,2539
4c4abfe875bf949613f3f0fef5941ed60039ee62,0,Adar Dembo,2019-10-14 19:13:08+00:00,['bd7416aec2f865fe4c3d187801cc775b549cc84d'],2,13,15,1472824,4,0,0.666666667,0.333333333,2539
90ec2715171bbf3fca294d5b1d230f951c71e75c,0,Alexey Serbin,2019-10-14 19:18:50+00:00,['4c4abfe875bf949613f3f0fef5941ed60039ee62'],0,163,163,1472987,2,0.382978723,0.946808511,0.882978723,2539
e516347d7010f1d033d8cc44ec6d3c964e204d63,0,Alexey Serbin,2019-10-14 20:19:46+00:00,['90ec2715171bbf3fca294d5b1d230f951c71e75c'],1,1,2,1472989,1,,,,2539
384a535a0079ec634d57b55593962cae4cb6f19a,0,Andrew Wong,2019-10-14 23:46:03+00:00,['e516347d7010f1d033d8cc44ec6d3c964e204d63'],53,274,327,1473316,3,0.109090909,0.612121212,0.478787879,2539
b731ecf760332b4a397efc69c40d465f50ca007f,0,Alexey Serbin,2019-10-15 01:53:50+00:00,['384a535a0079ec634d57b55593962cae4cb6f19a'],0,70,70,1473386,4,,,,2539
8d3d3784ff26292f4aedb4c3a7fc2303bc9958b0,0,Adar Dembo,2019-10-15 04:50:07+00:00,['b731ecf760332b4a397efc69c40d465f50ca007f'],13,13,26,1473412,1,,,,2539
6a0826ae38c86d9075fb4b5f61c4cecf4f1af681,0,Adar Dembo,2019-10-15 22:11:48+00:00,['8d3d3784ff26292f4aedb4c3a7fc2303bc9958b0'],62,39,101,1473513,1,0.208333333,0,0,2539
b5716b71854cee432d188b46f5d66d200484f4f0,0,Andrew Wong,2019-10-16 00:01:32+00:00,['6a0826ae38c86d9075fb4b5f61c4cecf4f1af681'],31,137,168,1473681,10,0.442622951,0.868852459,0.655737705,2539
3bd293d0f32003e877e7f160365ffd238927e164,0,Alexey Serbin,2019-10-16 00:50:50+00:00,['b5716b71854cee432d188b46f5d66d200484f4f0'],8,12,20,1473701,1,0,1,1,2539
0894eba26380036d6d6d59c29c3efc5b3a817641,0,Adar Dembo,2019-10-16 16:11:51+00:00,['3bd293d0f32003e877e7f160365ffd238927e164'],4,12,16,1473717,2,,,,2539
d525c11d441143eeb40389ab920f5f651ddff54f,1,Adar Dembo,2019-10-16 20:36:35+00:00,['0894eba26380036d6d6d59c29c3efc5b3a817641'],2,8,10,1473727,2,1,1,1,2539
7e8f37f8ddf46b965b0af4eba3f31c02b11b8fba,0,Adar Dembo,2019-10-16 20:46:38+00:00,['d525c11d441143eeb40389ab920f5f651ddff54f'],4,19,23,1473750,2,0,0.25,0.5,2539
adecebd9e22b50254d69c94c784d5cba3657890b,1,Adar Dembo,2019-10-16 20:46:50+00:00,['7e8f37f8ddf46b965b0af4eba3f31c02b11b8fba'],7,24,31,1473781,3,0,1,1,2539
d6a6b54b175032c7d13d231ef6d156ef9d0e3ab0,0,Alexey Serbin,2019-10-16 20:47:30+00:00,['adecebd9e22b50254d69c94c784d5cba3657890b'],8,55,63,1473844,5,0.695652174,0.695652174,0.826086957,2539
1bb267bd8587473c567ca76426689e33ff4c9b89,0,Alexey Serbin,2019-10-17 00:57:03+00:00,['d6a6b54b175032c7d13d231ef6d156ef9d0e3ab0'],1,3,4,1473848,1,0,0,1,2539
eedcbb1bffa32ee25573673ae55db27118d1d732,0,Adar Dembo,2019-10-17 05:01:24+00:00,['1bb267bd8587473c567ca76426689e33ff4c9b89'],10,7,17,1473865,1,0,0,0,2539
22f0ea360a5f8b820631248a60fd8c1c879d81e4,0,Alexey Serbin,2019-10-17 05:44:06+00:00,['eedcbb1bffa32ee25573673ae55db27118d1d732'],22,23,45,1473910,1,0,1,1,2539
625a6f33576233f1b0178cb8bb93f7b425eeed24,0,Adar Dembo,2019-10-17 08:58:46+00:00,['22f0ea360a5f8b820631248a60fd8c1c879d81e4'],1,1,2,1473912,1,,,,2539
a45192f06610b1db7fefd5bcd57f365eee6c92e1,0,Adar Dembo,2019-10-17 18:18:57+00:00,['625a6f33576233f1b0178cb8bb93f7b425eeed24'],2,1,3,1473915,1,,,,2539
d96f8fca55222da2a8a9e4c98bf4bebee3525989,0,Grant Henke,2019-10-17 18:33:18+00:00,['a45192f06610b1db7fefd5bcd57f365eee6c92e1'],5,30,35,1473950,1,0,0.153846154,1,2539
91f638f1d0b5206fdde23b6645741c0d5617975c,0,Adar Dembo,2019-10-17 18:47:51+00:00,['d96f8fca55222da2a8a9e4c98bf4bebee3525989'],6,6,12,1473962,1,,,,2539
fd66fc5ec83bf0d14fe391dddd74793bde532e5f,0,Grant Henke,2019-10-17 19:37:29+00:00,['91f638f1d0b5206fdde23b6645741c0d5617975c'],1,1,2,1473964,1,,,,2539
24aebbaa77f68c813e604eb157b73e0c9bc7433f,0,Alexey Serbin,2019-10-18 01:23:54+00:00,['fd66fc5ec83bf0d14fe391dddd74793bde532e5f'],1,1,2,1473966,1,,,,2539
930d54483a8ae850175ef1f1aff94a8f4342705f,0,Alexey Serbin,2019-10-18 03:28:51+00:00,['24aebbaa77f68c813e604eb157b73e0c9bc7433f'],497,548,1045,1475011,3,1,1,1,2540
5ca01ce0ccc3f4d15b8d9aff41dd5c6bd00ec1a7,0,Adar Dembo,2019-10-18 03:29:46+00:00,['930d54483a8ae850175ef1f1aff94a8f4342705f'],174,200,374,1475385,13,0.166666667,0.222222222,1,2540
03cbd7559cf24e916924ddd747438f8f7e362cde,0,Adar Dembo,2019-10-18 03:29:50+00:00,['5ca01ce0ccc3f4d15b8d9aff41dd5c6bd00ec1a7'],107,192,299,1475684,7,1,0.388888889,0.444444444,2542
a0ad526dc0d998c2956ed42c78278b15da71455e,0,Adar Dembo,2019-10-18 17:34:17+00:00,['03cbd7559cf24e916924ddd747438f8f7e362cde'],5,0,5,1475689,1,,,,2542
524ed47e3f56fdb90f384fd8454efe179d5aa920,0,Andrew Wong,2019-10-18 17:48:29+00:00,['a0ad526dc0d998c2956ed42c78278b15da71455e'],36,38,74,1475763,2,,,,2542
f5e657dc56c1488c60801c5c4736404bb9bc6e18,0,Andrew Wong,2019-10-18 21:06:00+00:00,['524ed47e3f56fdb90f384fd8454efe179d5aa920'],32,72,104,1475867,2,1,1,0.6,2542
eb06559f50281a8b4dede2d2aaf8088e45f20069,0,Alexey Serbin,2019-10-18 21:41:36+00:00,['f5e657dc56c1488c60801c5c4736404bb9bc6e18'],0,3,3,1475870,1,,,,2542
d4c14f6c1f6aae526390e868ecc3d5f8c5d2d47d,0,Alexey Serbin,2019-10-21 02:25:48+00:00,['eb06559f50281a8b4dede2d2aaf8088e45f20069'],1,1,2,1475872,1,,,,2542
2f8778c40edd0114777054a7c2a6b79cc6949f56,0,Adar Dembo,2019-10-21 04:40:45+00:00,['d4c14f6c1f6aae526390e868ecc3d5f8c5d2d47d'],2,121,123,1475995,7,0,0.957894737,0.915789474,2542
d7e7ad00f0a658fc81c87ca6325080b112ba6896,0,Adar Dembo,2019-10-22 17:12:28+00:00,['2f8778c40edd0114777054a7c2a6b79cc6949f56'],3,7,10,1476005,1,,,,2542
de74056dd4d5d01e86a56958623e0362d97d0ab7,0,Adar Dembo,2019-10-22 20:35:14+00:00,['d7e7ad00f0a658fc81c87ca6325080b112ba6896'],112,134,246,1476251,5,0,1,1,2542
f54ac28bc4f21da19daae6108f4323c5577d534c,0,Grant Henke,2019-10-22 21:01:39+00:00,['de74056dd4d5d01e86a56958623e0362d97d0ab7'],0,16,16,1476267,1,,,,2542
caa8d6d2fc9988dbd8c6331b2ab14f1a5cf63e56,0,Attila Bukor,2019-10-22 21:23:40+00:00,['f54ac28bc4f21da19daae6108f4323c5577d534c'],28,256,284,1476551,13,0.085714286,0.771428571,0.980952381,2544
4343fb746766b166f5532d36afbe903fdf092b95,0,Attila Bukor,2019-10-22 21:23:48+00:00,['caa8d6d2fc9988dbd8c6331b2ab14f1a5cf63e56'],70,318,388,1476939,10,0.246153846,0.7,0.892307692,2545
9067963c94a5263e5c1cb0c87d839ac7b6f0f449,0,Attila Bukor,2019-10-23 08:45:05+00:00,['4343fb746766b166f5532d36afbe903fdf092b95'],0,88,88,1477027,3,0.5,1,1,2545
e2b2fb25335fe517e46cdd61924698b36e9cc652,0,Attila Bukor,2019-10-23 08:45:15+00:00,['9067963c94a5263e5c1cb0c87d839ac7b6f0f449'],33,500,533,1477560,29,0.317406143,0.703071672,0.880546075,2546
85fe726794c1f0f4cc4a3add4afbdf14fc3544ce,0,Attila Bukor,2019-10-23 08:45:22+00:00,['e2b2fb25335fe517e46cdd61924698b36e9cc652'],0,3,3,1477563,2,0,0.333333333,1,2546
768b6885485dcb74f2731ba59fdebf2e28d0a3a3,0,Attila Bukor,2019-10-23 08:45:32+00:00,['85fe726794c1f0f4cc4a3add4afbdf14fc3544ce'],3,125,128,1477691,4,0.029411765,0.441176471,0.921568627,2546
899c8bfa648becb6729b744e81ab95aef3871c31,0,Adar Dembo,2019-10-23 16:26:29+00:00,['768b6885485dcb74f2731ba59fdebf2e28d0a3a3'],22,13,35,1477726,8,,,,2546
67fbb7c0367e12629da8a14a21362c0e256e1f89,1,Adar Dembo,2019-10-23 16:56:38+00:00,['899c8bfa648becb6729b744e81ab95aef3871c31'],111,270,381,1478107,26,0.723809524,0.79047619,0.780952381,2546
e23e52a1b2040f12361824fde5334b46c879b142,0,Adar Dembo,2019-10-23 21:08:41+00:00,['67fbb7c0367e12629da8a14a21362c0e256e1f89'],32,195,227,1478334,7,0.047619048,0.047619048,0.952380952,2546
a20089faa0ed4bcc9aa3cf01d5b7d55c273faa12,0,Alexey Serbin,2019-10-23 22:07:22+00:00,['e23e52a1b2040f12361824fde5334b46c879b142'],27,45,72,1478406,2,0.076923077,1,1,2546
6af6e0c01443463f5527219b497ea447690c2146,0,Adar Dembo,2019-10-24 03:45:34+00:00,['a20089faa0ed4bcc9aa3cf01d5b7d55c273faa12'],42,69,111,1478517,2,,,,2546
5975eb9ace115d8a4783cc4cb7438387397e46da,0,Andrew Wong,2019-10-24 22:06:04+00:00,['6af6e0c01443463f5527219b497ea447690c2146'],15,160,175,1478692,3,0,0.315315315,0.45045045,2546
314762d32d0e21167f3148a603d6d912c6c75353,0,Andrew Wong,2019-10-25 01:02:20+00:00,['5975eb9ace115d8a4783cc4cb7438387397e46da'],63,1848,1911,1480603,7,0.027229408,0.818243703,0.938733833,2547
f5578f84691233fc9a9320337dd0d86ddbb3b637,0,Andrew Wong,2019-10-25 23:26:34+00:00,['314762d32d0e21167f3148a603d6d912c6c75353'],30,19,49,1480652,1,,,,2547
27e207b02c28d5ac23835a96a0823078def14a8b,0,Alexey Serbin,2019-10-25 23:27:54+00:00,['f5578f84691233fc9a9320337dd0d86ddbb3b637'],0,40,40,1480692,1,1,1,1,2548
a85c3302abf935457e4d0f9d5326f0b612e0b614,0,Andrew Wong,2019-10-28 04:24:51+00:00,['27e207b02c28d5ac23835a96a0823078def14a8b'],6,40,46,1480738,6,0,1,1,2548
ec8102cd3cccd3af2f5c042518c9283447c96eef,0,Alexey Serbin,2019-10-28 05:36:17+00:00,['a85c3302abf935457e4d0f9d5326f0b612e0b614'],3,3,6,1480744,1,,,,2548
2af4132ebf2dc67c3c1299aa80c8abd5c63fd778,0,Adar Dembo,2019-10-28 19:52:54+00:00,['ec8102cd3cccd3af2f5c042518c9283447c96eef'],1,1,2,1480746,1,,,,2548
6ca599195922b27ec42c6a18eba09c0e8197121a,0,Adar Dembo,2019-10-28 20:46:40+00:00,['2af4132ebf2dc67c3c1299aa80c8abd5c63fd778'],0,40,40,1480786,3,0,1,0.413793103,2548
bc0a91c145fbd1e2e9a97e710835493248212c5c,0,Alexey Serbin,2019-10-28 22:04:45+00:00,['6ca599195922b27ec42c6a18eba09c0e8197121a'],4,8,12,1480798,1,,,,2548
7c857fd5e17186f334b076e2e0d61261b5f33b09,0,Alexey Serbin,2019-10-29 05:32:44+00:00,['bc0a91c145fbd1e2e9a97e710835493248212c5c'],2,0,2,1480800,2,,,,2548
d11bc7c127cdb8b06719abfacc6ac217d5be4f6d,0,Alexey Serbin,2019-10-29 21:59:51+00:00,['7c857fd5e17186f334b076e2e0d61261b5f33b09'],0,5,5,1480805,1,,,,2548
6ecfe60518803d3963674bf6172f242b5de54780,0,Alexey Serbin,2019-10-29 22:23:26+00:00,['d11bc7c127cdb8b06719abfacc6ac217d5be4f6d'],3,5,8,1480813,1,,,,2548
1b24801e4d45ff743ce17c87c4ae1131e7832c42,0,Alexey Serbin,2019-10-30 03:26:10+00:00,['6ecfe60518803d3963674bf6172f242b5de54780'],1,14,15,1480828,1,,,,2548
0870259456f785c4efdf5826350166d8d6dff5cc,0,Alexey Serbin,2019-10-30 04:15:11+00:00,['1b24801e4d45ff743ce17c87c4ae1131e7832c42'],2,3,5,1480833,2,,,,2548
9f01e7632d912b635caf8073a3e63fb8b8407b2a,0,Alexey Serbin,2019-10-31 00:10:20+00:00,['0870259456f785c4efdf5826350166d8d6dff5cc'],45,46,91,1480924,6,,,,2548
698a7f94f12913b27947a4855a1b82a2d74823e4,0,Alexey Serbin,2019-10-31 05:09:39+00:00,['9f01e7632d912b635caf8073a3e63fb8b8407b2a'],27,62,89,1481013,1,0.346153846,0,1,2548
973e5cdf8fbcedcdcc659d980f3a3a69dc4f109f,0,Grant Henke,2019-10-31 13:28:08+00:00,['698a7f94f12913b27947a4855a1b82a2d74823e4'],0,30,30,1481043,1,,,,2548
5e37e599e7d13be1d88bd70de5aab00b6f8a93e9,0,Andrew Wong,2019-10-31 17:58:35+00:00,['973e5cdf8fbcedcdcc659d980f3a3a69dc4f109f'],1,3,4,1481047,1,,,,2548
232c5a9e04edd56a23b4df214f98dfa62165e294,0,Adar Dembo,2019-10-31 19:28:59+00:00,['5e37e599e7d13be1d88bd70de5aab00b6f8a93e9'],22,39,61,1481108,3,1,1,1,2548
63412be06719d71104806f792a821de2ff68b887,0,Adar Dembo,2019-10-31 19:29:02+00:00,['232c5a9e04edd56a23b4df214f98dfa62165e294'],67,73,140,1481248,2,0.714285714,1,1,2548
719418a60235a5155efe95c37e9fc6e319f41e0c,0,Alexey Serbin,2019-10-31 20:40:25+00:00,['63412be06719d71104806f792a821de2ff68b887'],1,1,2,1481250,1,,,,2548
8166dd7100b99e3ea5d6ae3502b4f43c4ecd560e,0,Adar Dembo,2019-10-31 23:24:07+00:00,['719418a60235a5155efe95c37e9fc6e319f41e0c'],7,8,15,1481265,1,1,1,0,2548
87d90b2e5a7b593164d3a13ae40bf1948c3ad914,0,Adar Dembo,2019-11-01 00:24:49+00:00,['8166dd7100b99e3ea5d6ae3502b4f43c4ecd560e'],36,32,68,1481333,5,0,0,0,2548
26dcf68c7080933d48fb38b564aac41f4bcd2eeb,0,Adar Dembo,2019-11-01 04:04:33+00:00,['87d90b2e5a7b593164d3a13ae40bf1948c3ad914'],1,11,12,1481345,2,1,1,1,2548
111b13775193820b3e3551368fe00a8f00387007,0,Todd Lipcon,2019-11-01 16:20:36+00:00,['26dcf68c7080933d48fb38b564aac41f4bcd2eeb'],1,14,15,1481360,1,0,1,1,2548
c6dae7c02557d4ff38a8068b9a2074e0f4d6f5a4,0,Attila Bukor,2019-11-01 16:33:44+00:00,['111b13775193820b3e3551368fe00a8f00387007'],5,5,10,1481370,1,,,,2548
0ce460bc90a7f788e3d916bd717f1dbf42f3efe3,0,Alexey Serbin,2019-11-01 19:43:19+00:00,['c6dae7c02557d4ff38a8068b9a2074e0f4d6f5a4'],2,5,7,1481377,1,,,,2548
a035869886bb5de37cde7b2bf48bdd3def3123ff,0,Adar Dembo,2019-11-01 20:59:25+00:00,['0ce460bc90a7f788e3d916bd717f1dbf42f3efe3'],13,76,89,1481466,3,0.581395349,1,1,2548
93d836ad8a71e4a4ed7f4c1c4473fc831901ec6b,0,Alexey Serbin,2019-11-02 05:06:14+00:00,['a035869886bb5de37cde7b2bf48bdd3def3123ff'],3,9,12,1481478,1,,,,2548
8f509b2f7dbf3857ac838192368eb5c30c58ca9a,0,Adar Dembo,2019-11-02 05:21:46+00:00,['93d836ad8a71e4a4ed7f4c1c4473fc831901ec6b'],10,7,17,1481495,3,,,,2548
716256b92957c6f24d1e5cbca2257b16e2d256ab,0,Alexey Serbin,2019-11-02 13:33:38+00:00,['8f509b2f7dbf3857ac838192368eb5c30c58ca9a'],57,35,92,1481587,1,,,,2548
951dea688d73768942d05a1ec71337de83bf4939,1,Adar Dembo,2019-11-03 21:29:33+00:00,['716256b92957c6f24d1e5cbca2257b16e2d256ab'],14,36,50,1481637,6,0,1,0.777777778,2548
dc32b679401d227ed9b95a4ac17d018a3e33e6dd,0,Alexey Serbin,2019-11-04 08:50:13+00:00,['951dea688d73768942d05a1ec71337de83bf4939'],0,11,11,1481648,1,,,,2548
49ac6c150d647cec957a10328c913ba97dc5adcb,0,Alexey Serbin,2019-11-05 17:40:56+00:00,['dc32b679401d227ed9b95a4ac17d018a3e33e6dd'],6,37,43,1481691,1,,,,2548
9e6e729dfa9ab8613c4f0daf78c4b4a7feeef38c,0,Alexey Serbin,2019-11-06 14:50:10+00:00,['49ac6c150d647cec957a10328c913ba97dc5adcb'],0,30,30,1481721,1,,,,2548
34efee128945fe1577499acf8eda31d39807ab3b,0,Andrew Wong,2019-11-06 22:05:57+00:00,['9e6e729dfa9ab8613c4f0daf78c4b4a7feeef38c'],37,118,155,1481876,3,0.186046512,1,1,2548
ba908efa15774bb24b5bfa4ea88915161d1100d1,1,Adar Dembo,2019-11-07 00:36:04+00:00,['34efee128945fe1577499acf8eda31d39807ab3b'],397,197,594,1482470,17,0.151898734,1,0.835443038,2548
6133878108256174e580115b4738f29da3fa58d7,0,Adar Dembo,2019-11-07 03:57:37+00:00,['ba908efa15774bb24b5bfa4ea88915161d1100d1'],2,1,3,1482473,1,,,,2548
6c646937b1fe1f4ab0aeb9ed638f00c5dd39257c,0,Adar Dembo,2019-11-07 03:57:48+00:00,['6133878108256174e580115b4738f29da3fa58d7'],0,21,21,1482494,1,,,,2548
0e41d5afed0c0ab99106339f1494beb44a2b6617,0,Alexey Serbin,2019-11-07 13:22:15+00:00,['6c646937b1fe1f4ab0aeb9ed638f00c5dd39257c'],2,2,4,1482498,2,,,,2548
5b182a356c5825f95a2956924e7143e27a0be2aa,0,Adar Dembo,2019-11-07 16:54:44+00:00,['0e41d5afed0c0ab99106339f1494beb44a2b6617'],10,11,21,1482519,2,,,,2548
f1046cf120908a03e5edfa731c7a0e6b9abddf07,0,Adar Dembo,2019-11-07 17:10:03+00:00,['5b182a356c5825f95a2956924e7143e27a0be2aa'],5,0,5,1482524,1,,,,2548
13f226b1400b122af16b9d1edb607fbd492546b8,0,Adar Dembo,2019-11-08 01:50:35+00:00,['f1046cf120908a03e5edfa731c7a0e6b9abddf07'],0,533,533,1483057,10,,,,2552
58177651a4e3ba3da9ddee46ec5e79bc011f8406,0,Adar Dembo,2019-11-08 01:50:55+00:00,['13f226b1400b122af16b9d1edb607fbd492546b8'],72,463,535,1483592,24,0.162921348,0.269662921,0.848314607,2554
811eab514883390a729ed0f3f991df4a1a7fea67,0,Grant Henke,2019-11-08 03:24:36+00:00,['58177651a4e3ba3da9ddee46ec5e79bc011f8406'],1,1,2,1483594,1,,,,2554
163f825ec8dd3b0caf6032d4e19f0060c4111c49,0,Adar Dembo,2019-11-08 23:11:07+00:00,['811eab514883390a729ed0f3f991df4a1a7fea67'],1,2,3,1483597,1,,,,2554
bc4850f271236ef8722379ed1727568aff198fd9,0,Andrew Wong,2019-11-09 06:29:10+00:00,['163f825ec8dd3b0caf6032d4e19f0060c4111c49'],10,72,82,1483679,3,0.709677419,1,1,2554
188fb4260d1609e4adfb7dca5867a40d94550f93,0,Andrew Wong,2019-11-09 06:29:14+00:00,['bc4850f271236ef8722379ed1727568aff198fd9'],374,480,854,1484533,5,0.684210526,1,1,2554
0fea1cb8ede852a87efc422b394ffe8d1e89bc6c,0,Alexey Serbin,2019-11-10 13:14:24+00:00,['188fb4260d1609e4adfb7dca5867a40d94550f93'],3,120,123,1484656,2,0.105263158,0.605263158,0.223684211,2554
0fdfdc8283a76c3ea6078ebc950d98e8b59b69d8,0,Adar Dembo,2019-11-12 08:06:38+00:00,['0fea1cb8ede852a87efc422b394ffe8d1e89bc6c'],9,2,11,1484667,1,,,,2554
ad3c1c017b272148e69d7bed18dca3cb0a50fe04,0,Adar Dembo,2019-11-12 08:09:40+00:00,['0fdfdc8283a76c3ea6078ebc950d98e8b59b69d8'],40,5,45,1484712,1,1,0,0,2554
b97c2f6ca78097186c3c77e759cf43bab966cc7b,0,Adar Dembo,2019-11-12 08:50:33+00:00,['ad3c1c017b272148e69d7bed18dca3cb0a50fe04'],1,40,41,1484753,2,,,,2554
74bf0859c01f20de777e499805ddc256b5e9a6a1,0,Alexey Serbin,2019-11-12 15:33:03+00:00,['b97c2f6ca78097186c3c77e759cf43bab966cc7b'],35,107,142,1484895,8,1,1,1,2554
0b99f37ea4d97a4a671c20a0a5db7488fc27ed39,0,Adar Dembo,2019-11-12 21:21:55+00:00,['74bf0859c01f20de777e499805ddc256b5e9a6a1'],4,14,18,1484913,2,0,0,1,2554
b3147d871a097065ac91c1b8f675e02076c4b011,0,Alexey Serbin,2019-11-12 22:08:01+00:00,['0b99f37ea4d97a4a671c20a0a5db7488fc27ed39'],1,1,2,1484915,1,,,,2554
98f44f4537ceddffedaf9afce26b634c4ab2142a,0,Adar Dembo,2019-11-13 07:12:41+00:00,['b3147d871a097065ac91c1b8f675e02076c4b011'],103,153,256,1485171,3,0,1,0.547619048,2554
7e1bcb63958ad3e672322a005f441e5dd3a9d087,0,Alexey Serbin,2019-11-13 15:00:44+00:00,['98f44f4537ceddffedaf9afce26b634c4ab2142a'],60,0,60,1485231,1,,,,2554
f769f1db64076809486ec4bb6b4f39ff6c5bb1b7,0,Alexey Serbin,2019-11-13 15:01:13+00:00,['7e1bcb63958ad3e672322a005f441e5dd3a9d087'],9,17,26,1485257,2,0,0,1,2554
c8d36a9f9424c8bb8ef20e86a576caea818689b0,0,Grant Henke,2019-11-13 18:31:56+00:00,['f769f1db64076809486ec4bb6b4f39ff6c5bb1b7'],2804,0,2804,1488061,20,0.639585134,0.282627485,0.228176318,2554
6406123924c3900e8edd65eebbb3d93963fd2a7b,0,Alexey Serbin,2019-11-13 18:52:42+00:00,['c8d36a9f9424c8bb8ef20e86a576caea818689b0'],1,18,19,1488080,1,,,,2554
b293343df44c0d002bb4dd3ce6334d03e7197124,0,Alexey Serbin,2019-11-13 19:53:58+00:00,['6406123924c3900e8edd65eebbb3d93963fd2a7b'],6,9,15,1488095,2,,,,2554
9a418e8497466fc3d6bf66eec84cc268ab725581,0,Grant Henke,2019-11-14 18:57:20+00:00,['b293343df44c0d002bb4dd3ce6334d03e7197124'],208,565,773,1488868,50,0.183908046,0.770114943,0.712643678,2554
3ca7db0dbce89b2938d4c2cd5f2189767d5676f3,0,Adar Dembo,2019-11-15 20:33:59+00:00,['9a418e8497466fc3d6bf66eec84cc268ab725581'],38,80,118,1488986,11,0,0,1,2554
9b1ff304ca5f9f2e1ea08646c7307fcbe0486015,0,Alexey Serbin,2019-11-16 00:44:08+00:00,['3ca7db0dbce89b2938d4c2cd5f2189767d5676f3'],0,130,130,1489116,4,0.25,0.25,0.572916667,2554
a0e896475c139d308e3b6e32110e97168b9562c6,0,Alexey Serbin,2019-11-16 00:44:12+00:00,['9b1ff304ca5f9f2e1ea08646c7307fcbe0486015'],3,84,87,1489203,4,0.119047619,0.880952381,0.880952381,2554
200509b497a028f7d700152ca4c92818ce5b9f0e,0,Andrew Wong,2019-11-16 07:02:48+00:00,['a0e896475c139d308e3b6e32110e97168b9562c6'],8,37,45,1489248,1,,,,2554
24cf1c948d07676cfc567b73cef7792a38d1809e,0,Adar Dembo,2019-11-18 05:22:20+00:00,['200509b497a028f7d700152ca4c92818ce5b9f0e'],6,0,6,1489254,1,1,1,1,2554
9c6d8dc7b76fbe66acd4dae08196cd056ab466c1,0,Andrew Wong,2019-11-18 17:41:17+00:00,['24cf1c948d07676cfc567b73cef7792a38d1809e'],253,253,506,1489760,2,,,,2554
93ba778a7e72cbc55a706f7d61d5ee1cd2721c56,0,Alexey Serbin,2019-11-19 07:21:18+00:00,['9c6d8dc7b76fbe66acd4dae08196cd056ab466c1'],6,8,14,1489774,1,,,,2554
8369380c880846a590d6a779e056293005de3a4e,0,Alexey Serbin,2019-11-19 23:46:18+00:00,['93ba778a7e72cbc55a706f7d61d5ee1cd2721c56'],62,114,176,1489950,1,,,,2554
68f9fbc420a7ade895ffa639971978713fbbee4f,0,Hao Hao,2019-11-20 00:02:29+00:00,['8369380c880846a590d6a779e056293005de3a4e'],265,374,639,1490589,9,1,1,0,2557
93b4561e36a3b06003b75f0c5f1ba691811605bc,0,Alexey Serbin,2019-11-20 04:47:41+00:00,['68f9fbc420a7ade895ffa639971978713fbbee4f'],20,36,56,1490645,3,0,0,0,2557
80e28503be8391cae07e77e616c576a01386581d,0,Alexey Serbin,2019-11-20 18:30:36+00:00,['93b4561e36a3b06003b75f0c5f1ba691811605bc'],2,2,4,1490649,1,,,,2557
29b2b4d27a62eeb92d52e61cafdee6ac333de316,0,Grant Henke,2019-11-20 18:55:40+00:00,['80e28503be8391cae07e77e616c576a01386581d'],45,43,88,1490737,6,,,,2557
74b9ac67a1d3378e0fc38bd2ce827bacafde4775,1,Grant Henke,2019-11-20 18:55:44+00:00,['29b2b4d27a62eeb92d52e61cafdee6ac333de316'],182,407,589,1491326,54,1,1,0.2,2558
44446b09f2b159c36d56f6a363ff5658ee28a31f,0,Andrew Wong,2019-11-21 02:23:24+00:00,['74b9ac67a1d3378e0fc38bd2ce827bacafde4775'],1,1,2,1491328,1,,,,2558
9b7669f6ac5b615d172557aa438ed2518fbee3f0,1,Alexey Serbin,2019-11-21 03:15:10+00:00,['44446b09f2b159c36d56f6a363ff5658ee28a31f'],102,801,903,1492231,8,0.121338912,0.765690377,0.751046025,2558
c8409bbdab8d36d6d864ea16a329569414340f0e,0,Grant Henke,2019-11-21 03:26:02+00:00,['9b7669f6ac5b615d172557aa438ed2518fbee3f0'],1,53,54,1492285,2,1,1,1,2559
0eb0a60f23251afbbe987e9bf88036b0b95f97ab,0,Adar Dembo,2019-11-21 06:00:36+00:00,['c8409bbdab8d36d6d864ea16a329569414340f0e'],39,56,95,1492380,3,0,1,1,2559
b58b37a1ffe359f8237e1ff7a834080cab111339,0,Adar Dembo,2019-11-21 22:39:12+00:00,['0eb0a60f23251afbbe987e9bf88036b0b95f97ab'],14,242,256,1492636,13,0.644444444,0.933333333,0.766666667,2560
c0508096153e313b616d0f26cac362e3a3196a5e,0,Alexey Serbin,2019-11-21 23:25:41+00:00,['b58b37a1ffe359f8237e1ff7a834080cab111339'],8,19,27,1492663,7,,,,2560
a5e58406ae9195e66f4fbc91c56d49bbaca5dd98,0,Andrew Wong,2019-11-22 04:32:56+00:00,['c0508096153e313b616d0f26cac362e3a3196a5e'],1,6,7,1492670,2,0,0,1,2560
1d382435d1d2e46d279503ab64225342cf0068ea,0,Grant Henke,2019-11-25 01:59:00+00:00,['a5e58406ae9195e66f4fbc91c56d49bbaca5dd98'],0,37,37,1492707,1,0,1,1,2560
1cfca5c17e76c3760b57152c1fde6befc7676e0d,0,Alexey Serbin,2019-11-25 17:19:32+00:00,['1d382435d1d2e46d279503ab64225342cf0068ea'],25,41,66,1492773,1,,,,2560
8a30baea1a89749d9bd7aab90ac34db031094dd3,0,Alexey Serbin,2019-11-25 17:23:52+00:00,['1cfca5c17e76c3760b57152c1fde6befc7676e0d'],5,46,51,1492824,2,0,1,1,2560
d98f4c83b8119ecca3c1f2107184d5c603c479f7,0,Grant Henke,2019-11-26 14:04:26+00:00,['8a30baea1a89749d9bd7aab90ac34db031094dd3'],871,1209,2080,1494904,112,0.026785714,0.571428571,0.745535714,2560
0a555961c6dfa672bfc2d90d4fb26d0bff21c299,0,Grant Henke,2019-11-26 14:04:29+00:00,['d98f4c83b8119ecca3c1f2107184d5c603c479f7'],590,713,1303,1496207,75,0.333333333,0.984126984,0.920634921,2560
25ab6797b72715c90abc0bb5b68e68fdbf021137,0,Alexey Serbin,2019-11-26 20:09:29+00:00,['0a555961c6dfa672bfc2d90d4fb26d0bff21c299'],1,2,3,1496210,1,,,,2560
3d57198663f3ed6980f4d92720963ddd0f3a1471,0,Grant Henke,2019-11-27 00:53:56+00:00,['25ab6797b72715c90abc0bb5b68e68fdbf021137'],13,0,13,1496223,2,,,,2560
25ae6c5108cc84289f69c467d862e298d3361ea8,1,Grant Henke,2019-11-27 18:23:51+00:00,['3d57198663f3ed6980f4d92720963ddd0f3a1471'],219,392,611,1496834,35,1,0.5,1,2560
7c5455a0ca213e46280b4fcab1a83e4bb52679eb,0,Andrew Wong,2019-11-27 23:39:57+00:00,['25ae6c5108cc84289f69c467d862e298d3361ea8'],1,1,2,1496836,1,,,,2560
59c5efbbdaf77e2d3767d6631180bf0cb558575f,0,Adar Dembo,2019-11-28 02:20:02+00:00,['7c5455a0ca213e46280b4fcab1a83e4bb52679eb'],0,3,3,1496839,2,0,1,1,2560
5dbfe8ea182e87418095123782a262863be92dc6,0,Alexey Serbin,2019-12-01 01:51:36+00:00,['59c5efbbdaf77e2d3767d6631180bf0cb558575f'],10,26,36,1496875,3,0,1,1,2560
d8a8ac7aca0af3a62fc87209e8b3a6677b4f953c,0,Adar Dembo,2019-12-02 18:16:37+00:00,['5dbfe8ea182e87418095123782a262863be92dc6'],4,56,60,1496935,2,0.217391304,1,1,2560
a5848a4c3c8c72a1ac823182e87cd1f6c31ddc15,0,Adar Dembo,2019-12-02 18:20:16+00:00,['d8a8ac7aca0af3a62fc87209e8b3a6677b4f953c'],16,30,46,1496981,2,0.25,1,1,2560
f4fe87430349a3f2f33c539329180104755e622e,0,Adar Dembo,2019-12-03 20:42:39+00:00,['a5848a4c3c8c72a1ac823182e87cd1f6c31ddc15'],40,37,77,1497058,7,0,0,,2560
618b711ca0f42f2b891dcdd9a2d1583a95bbe1b5,0,Adar Dembo,2019-12-03 21:43:00+00:00,['f4fe87430349a3f2f33c539329180104755e622e'],2,2,4,1497062,1,,,,2560
7917a819c15f94bdaa070682a47d60f47821f45d,0,Adar Dembo,2019-12-03 23:13:05+00:00,['618b711ca0f42f2b891dcdd9a2d1583a95bbe1b5'],8,13,21,1497083,2,0.5,0.5,1,2560
d5ac2f2e6f1003ff2f5163631e2be2f88f5c97d5,0,Attila Bukor,2019-12-03 23:35:54+00:00,['7917a819c15f94bdaa070682a47d60f47821f45d'],11,421,432,1497515,5,0.796610169,0.508474576,0.93220339,2563
e45f893981a36d721752f1e0c743cdf18a6f5428,0,Adar Dembo,2019-12-04 00:21:34+00:00,['d5ac2f2e6f1003ff2f5163631e2be2f88f5c97d5'],4,36,40,1497555,2,0.555555556,0.555555556,1,2563
7ea1f53f8b97226e9edd744add1ea2ae40e96781,0,Alexey Serbin,2019-12-04 05:56:42+00:00,['e45f893981a36d721752f1e0c743cdf18a6f5428'],2,2,4,1497559,1,,,,2563
eb2b70d4b96be2fc2fdd6b3625acc284ac5774be,0,Alexey Serbin,2019-12-04 05:58:14+00:00,['7ea1f53f8b97226e9edd744add1ea2ae40e96781'],42,59,101,1497660,8,0,0.428571429,1,2563
13200733d0102018bafaada80ff1b22d858836ec,0,Adar Dembo,2019-12-04 17:36:21+00:00,['eb2b70d4b96be2fc2fdd6b3625acc284ac5774be'],77,69,146,1497806,15,0.333333333,0,0,2563
4061b80c2e290a5615ed8196d8a381accd1a6af9,0,Adar Dembo,2019-12-04 17:37:52+00:00,['13200733d0102018bafaada80ff1b22d858836ec'],342,8,350,1498156,12,,,,2563
ae53824dc2c270fdcece6aeadc908dbfa437531e,0,Adar Dembo,2019-12-04 19:23:10+00:00,['4061b80c2e290a5615ed8196d8a381accd1a6af9'],42,62,104,1498260,13,0,0,0.8,2563
5cc9114cc757e84f51fa5ad4e263fbb7e8f9fe18,0,Adar Dembo,2019-12-04 19:23:12+00:00,['ae53824dc2c270fdcece6aeadc908dbfa437531e'],96,72,168,1498428,5,0,0,0,2563
9d14d74aaf61d916f01ccc736ec416dc087aa658,0,Adar Dembo,2019-12-04 22:57:07+00:00,['5cc9114cc757e84f51fa5ad4e263fbb7e8f9fe18'],0,8,8,1498436,1,0,1,1,2563
c29d144547df20ee626bed16a4a2aa0a6085cded,0,Adar Dembo,2019-12-04 22:57:13+00:00,['9d14d74aaf61d916f01ccc736ec416dc087aa658'],185,206,391,1498827,12,0,0,0,2563
ac6198f5055e62979f79660a81443844262c7d2e,0,Adar Dembo,2019-12-05 00:14:03+00:00,['c29d144547df20ee626bed16a4a2aa0a6085cded'],2,8,10,1498837,2,1,1,1,2563
89ce529e945731c48445db4a6f8af11f9f905aab,0,Adar Dembo,2019-12-05 00:15:23+00:00,['ac6198f5055e62979f79660a81443844262c7d2e'],2,2,4,1498841,1,,,,2563
caf2b50529ce59bb4847e76c3e32f2574bae7809,1,Alexey Serbin,2019-12-05 02:06:19+00:00,['89ce529e945731c48445db4a6f8af11f9f905aab'],10,106,116,1498957,3,0,0.178082192,0.95890411,2563
ddaf67d8b7a5f560fcd5645e14739da4ba478869,0,Alexey Serbin,2019-12-05 04:56:41+00:00,['caf2b50529ce59bb4847e76c3e32f2574bae7809'],0,19,19,1498976,1,,,,2563
24f5f646777cf487f14af587e04a24046158b012,0,Alexey Serbin,2019-12-05 05:30:22+00:00,['ddaf67d8b7a5f560fcd5645e14739da4ba478869'],5,5,10,1498986,5,,,,2563
4ab2e7564619b80555a8ddc60a9162cffe75084e,0,Alexey Serbin,2019-12-05 07:03:13+00:00,['24f5f646777cf487f14af587e04a24046158b012'],2,2,4,1498990,1,,,,2563
83f65ffc187638b376a06b7fc3888369764e9333,0,Andrew Wong,2019-12-05 08:06:52+00:00,['4ab2e7564619b80555a8ddc60a9162cffe75084e'],698,863,1561,1500551,15,0.054794521,0.794520548,1,2563
dd2682c1fba8e690ca50c13dff877bd02008b0fd,0,Adar Dembo,2019-12-05 18:55:27+00:00,['83f65ffc187638b376a06b7fc3888369764e9333'],13,11,24,1500575,2,1,0,0,2563
164d8d20935e4adfb1f99e17ca81b3178d695a2b,0,Adar Dembo,2019-12-05 18:57:53+00:00,['dd2682c1fba8e690ca50c13dff877bd02008b0fd'],3,0,3,1500578,1,,,,2563
450dc527a5bcbb6d4ab458508c92ada8a66b9cde,0,Alexey Serbin,2019-12-05 22:00:36+00:00,['164d8d20935e4adfb1f99e17ca81b3178d695a2b'],3,4,7,1500585,1,,,,2563
9639f037b4380325147751a1c5b3569f614231a2,0,Attila Bukor,2019-12-05 22:35:10+00:00,['450dc527a5bcbb6d4ab458508c92ada8a66b9cde'],105,306,411,1500996,2,0,0.228346457,0.645669291,2563
5b9289a6c90bfe7ebed5510aacf45f7005c64490,0,Alexey Serbin,2019-12-06 02:58:13+00:00,['9639f037b4380325147751a1c5b3569f614231a2'],1,1,2,1500998,1,,,,2563
e5ab399e0f2545214d9fdc6f6c04a67540a9aadc,0,Andrew Wong,2019-12-06 21:52:05+00:00,['5b9289a6c90bfe7ebed5510aacf45f7005c64490'],1,2,3,1501001,1,,,,2563
b5e07be0598d5836ddff05996a4b1274cd8184ec,0,Andrew Wong,2019-12-06 21:52:09+00:00,['e5ab399e0f2545214d9fdc6f6c04a67540a9aadc'],130,124,254,1501255,13,,,,2563
7f0a4a2dc4de9c1afed979552015fcd66c294f77,0,Attila Bukor,2019-12-07 01:19:37+00:00,['b5e07be0598d5836ddff05996a4b1274cd8184ec'],4,31,35,1501290,3,0.32,0,0.4,2563
6b6910870ce2c35bf8b9be9408f44a8cec6b580a,0,Adar Dembo,2019-12-09 04:15:09+00:00,['7f0a4a2dc4de9c1afed979552015fcd66c294f77'],229,318,547,1501837,4,0.35,0.3,1,2563
c9dd2b520a8b82500eb6a56961b9da0ccd2ed752,0,Todd Lipcon,2019-12-09 20:05:18+00:00,['6b6910870ce2c35bf8b9be9408f44a8cec6b580a'],11,19,30,1501867,2,0,0,1,2563
dff0349f9f9c6dde759bcd97e2f76957d8043df7,0,Todd Lipcon,2019-12-09 21:40:52+00:00,['c9dd2b520a8b82500eb6a56961b9da0ccd2ed752'],3,80,83,1501950,2,0,0,1,2563
3175c35c7d721aef0c4c6b358cc3b422089c1ba7,0,Attila Bukor,2019-12-09 22:33:37+00:00,['dff0349f9f9c6dde759bcd97e2f76957d8043df7'],5,5,10,1501960,2,,,,2563
22d1f66ed1b9ae70a0118fdb6d645e1899878442,0,Adar Dembo,2019-12-10 18:33:41+00:00,['3175c35c7d721aef0c4c6b358cc3b422089c1ba7'],2,9,11,1501971,2,0,1,1,2563
6ac9191c731d6955a97f08d4add02a96198f6fbf,0,Adar Dembo,2019-12-10 23:34:10+00:00,['22d1f66ed1b9ae70a0118fdb6d645e1899878442'],7,10,17,1501988,1,,,,2563
1a0cd330b7ffff61b05848ad005e1c740446997b,0,Attila Bukor,2019-12-11 19:16:55+00:00,['6ac9191c731d6955a97f08d4add02a96198f6fbf'],1,1,2,1501990,1,,,,2563
46b4d6f24fdacb79aa574a016bf5a6cb51d5e3b8,0,Alexey Serbin,2019-12-11 19:54:31+00:00,['1a0cd330b7ffff61b05848ad005e1c740446997b'],41,47,88,1502078,3,0.666666667,0.333333333,0,2563
a8c6ea258c06407c1a4fef260da3a1cb70529bd9,0,Attila Bukor,2019-12-12 01:07:59+00:00,['46b4d6f24fdacb79aa574a016bf5a6cb51d5e3b8'],0,2,2,1502080,2,0,0,0,2563
4327b6e17e6d673fa6800a2a7ff2843508a4da68,0,Attila Bukor,2019-12-13 18:47:08+00:00,['a8c6ea258c06407c1a4fef260da3a1cb70529bd9'],3,7,10,1502090,2,0,0,1,2563
5588a729c9769fad3a0ff6b1dfa4b8bb5c5505e0,0,Alexey Serbin,2019-12-13 20:50:09+00:00,['4327b6e17e6d673fa6800a2a7ff2843508a4da68'],9,8,17,1502107,2,,,,2563
8c069b3f9d9ac6cb664e0f30b879461d6b40efee,0,Attila Bukor,2019-12-13 22:57:35+00:00,['5588a729c9769fad3a0ff6b1dfa4b8bb5c5505e0'],14,141,155,1502262,8,0.944444444,0.981481481,1,2563
e671e81ce170c4595fed497a5a518a50eb700b69,0,Andrew Wong,2019-12-16 19:34:24+00:00,['8c069b3f9d9ac6cb664e0f30b879461d6b40efee'],0,777,777,1503039,6,0.722222222,0.875816993,1,2567
9ad36b40c683d09e2fe2d40c962a65e4c8b1f2ea,0,Andrew Wong,2019-12-16 19:38:46+00:00,['e671e81ce170c4595fed497a5a518a50eb700b69'],1,1,2,1503041,1,,,,2567
eaf1b6d773e8b56413ddffa5be728a603f4c90e8,0,Adar Dembo,2019-12-16 21:17:12+00:00,['9ad36b40c683d09e2fe2d40c962a65e4c8b1f2ea'],1244,1470,2714,1505755,22,1,1,0.125,2569
23e07e3a93ad42c1e44cd077acf0ef041b78258a,0,Adar Dembo,2019-12-16 21:20:01+00:00,['eaf1b6d773e8b56413ddffa5be728a603f4c90e8'],57,197,254,1506009,4,0.119266055,0.623853211,1,2569
111e54c0c8f254fb110919150c1f5d60dca37682,0,Andrew Wong,2019-12-17 20:10:03+00:00,['23e07e3a93ad42c1e44cd077acf0ef041b78258a'],18,117,135,1506144,4,0.035087719,1,1,2569
f43257c353d75fbd5d21e323b0b413b45ca9ed8b,0,Adar Dembo,2019-12-17 22:50:34+00:00,['111e54c0c8f254fb110919150c1f5d60dca37682'],2,2,4,1506148,1,,,,2569
aea815f1fe21c23284592fa365d7fa7fc1dbdd93,0,Adar Dembo,2019-12-17 22:50:40+00:00,['f43257c353d75fbd5d21e323b0b413b45ca9ed8b'],20,312,332,1506480,24,0.635514019,0.785046729,0.714953271,2569
6d24321c102562bfbce675c17735e108745743a4,0,Alexey Serbin,2019-12-18 00:06:00+00:00,['aea815f1fe21c23284592fa365d7fa7fc1dbdd93'],31,39,70,1506550,6,1,0,0,2569
541e7c9a377f349f0a2228c0e098555b8bc9207a,0,Andrew Wong,2019-12-18 02:16:20+00:00,['6d24321c102562bfbce675c17735e108745743a4'],126,64,190,1506740,4,,,,2569
51ae0ea4cfcf04365876289b1067f7c51921a96d,0,Andrew Wong,2019-12-18 02:29:43+00:00,['541e7c9a377f349f0a2228c0e098555b8bc9207a'],26,109,135,1506875,2,0.338709677,0.64516129,0,2569
441d8bdb781786d42ab664813faff15a363cbb5a,0,Adar Dembo,2019-12-18 17:25:23+00:00,['51ae0ea4cfcf04365876289b1067f7c51921a96d'],2,5,7,1506882,2,,,,2569
b0b014b1a4bd0e87524e2ffcff43fba999fefeaa,0,Adar Dembo,2019-12-19 06:21:19+00:00,['441d8bdb781786d42ab664813faff15a363cbb5a'],1,3,4,1506886,1,,,,2569
684725fd457e308ee71889d92d8346dd081d4e5a,0,Adar Dembo,2019-12-19 22:03:02+00:00,['b0b014b1a4bd0e87524e2ffcff43fba999fefeaa'],28,51,79,1506965,2,1,0,0,2569
643bf32bb82e6f08c02cae94d0dab5cac9d61216,0,Alexey Serbin,2019-12-19 23:08:43+00:00,['684725fd457e308ee71889d92d8346dd081d4e5a'],25,24,49,1507014,7,0,0,0,2569
fc02008c6e5bfb592a9eb60f2a600e1d989cdfd9,0,Alexey Serbin,2019-12-20 06:32:21+00:00,['643bf32bb82e6f08c02cae94d0dab5cac9d61216'],1,22,23,1507037,1,,,1,2569
702e33e89d873f4b1ab22ac8b9957da39766ffd7,0,Adar Dembo,2019-12-20 18:52:34+00:00,['fc02008c6e5bfb592a9eb60f2a600e1d989cdfd9'],151,147,298,1507335,8,0,0,0,2569
beca18bb2f4b371cf08447e1dfbcea00821fa386,0,Adar Dembo,2019-12-20 18:56:11+00:00,['702e33e89d873f4b1ab22ac8b9957da39766ffd7'],3,3,6,1507341,1,,,,2569
c1084a8792330b1a1331d326eac9b110b5260ca9,0,Adar Dembo,2019-12-20 20:57:46+00:00,['beca18bb2f4b371cf08447e1dfbcea00821fa386'],21,4,25,1507366,3,,,,2569
6876aec4b6c2547f39d80462a3fe9a6fc12b9257,0,Alexey Serbin,2019-12-20 23:48:11+00:00,['c1084a8792330b1a1331d326eac9b110b5260ca9'],18,24,42,1507408,1,,,,2569
ac960b220e6e80ee427c6dc747d66c8cf7c4f956,0,Adar Dembo,2019-12-20 23:49:59+00:00,['6876aec4b6c2547f39d80462a3fe9a6fc12b9257'],3,6,9,1507417,1,0,0,0,2569
bf3586f2a59e8fd845c092bba8a91537c410231d,0,Adar Dembo,2019-12-24 04:41:08+00:00,['ac960b220e6e80ee427c6dc747d66c8cf7c4f956'],0,33,33,1507450,2,0.142857143,1,1,2569
a195d0fd84389437640ca356a30b6679d4aae424,0,Adar Dembo,2019-12-29 18:06:19+00:00,['bf3586f2a59e8fd845c092bba8a91537c410231d'],14,12,26,1507476,4,0,1,1,2569
ca957fb86736b1e07b18d80fdfa4e41c191e7072,0,Adar Dembo,2019-12-29 18:36:20+00:00,['a195d0fd84389437640ca356a30b6679d4aae424'],16,78,94,1507570,4,0.56,1,0.72,2569
cfe9a3f6a0f8aa4148a23fddcc74b849c7bf20a6,0,Adar Dembo,2019-12-29 18:36:43+00:00,['ca957fb86736b1e07b18d80fdfa4e41c191e7072'],6,4,10,1507580,1,0,0,0,2569
bc4a5aa8065c0fdf6c136396b3ca898847095b55,0,Adar Dembo,2019-12-29 18:37:10+00:00,['cfe9a3f6a0f8aa4148a23fddcc74b849c7bf20a6'],12,6,18,1507598,4,,,,2569
f9304fddcdf96f27d4f9c9895efb7487afaca6e5,0,Adar Dembo,2019-12-29 18:37:34+00:00,['bc4a5aa8065c0fdf6c136396b3ca898847095b55'],0,12,12,1507610,1,1,1,1,2569
e9656d0bcc060572be58b8248b3e14611ec79113,0,Adar Dembo,2019-12-29 18:38:28+00:00,['f9304fddcdf96f27d4f9c9895efb7487afaca6e5'],28,72,100,1507710,6,0,0,0.85,2569
8a36055bc0f96258e006475f33ecff29ab7caee0,0,Adar Dembo,2019-12-29 18:39:34+00:00,['e9656d0bcc060572be58b8248b3e14611ec79113'],5,6,11,1507721,1,0,1,1,2569
c767bd1149757094d8df96eaca879c06a5c1b648,0,Adar Dembo,2020-01-06 05:19:09+00:00,['8a36055bc0f96258e006475f33ecff29ab7caee0'],23,145,168,1507889,5,0.247311828,1,1,2569
a98d1fda0b148787eabbf25b71eb931e64314491,0,Alexey Serbin,2020-01-06 18:25:03+00:00,['c767bd1149757094d8df96eaca879c06a5c1b648'],88,85,173,1508062,5,0.6,0,0.6,2569
b6ac4c7aa3e2bdc04d85135b8eac06ec215cbbcc,0,Alexey Serbin,2020-01-06 18:25:50+00:00,['a98d1fda0b148787eabbf25b71eb931e64314491'],33,59,92,1508154,2,1,1,0.111111111,2569
db26b72b9fed8a14a87d2a582a5a2cda57dc440b,0,Alexey Serbin,2020-01-06 21:28:06+00:00,['b6ac4c7aa3e2bdc04d85135b8eac06ec215cbbcc'],20,19,39,1508193,3,0,0,0,2569
80e1d82c6ff10d5b6e507b68c6f5149dd65bb525,0,Alexey Serbin,2020-01-06 21:29:14+00:00,['db26b72b9fed8a14a87d2a582a5a2cda57dc440b'],64,93,157,1508350,4,1,1,0,2569
4f22c0f9a6e8d41ec5efa0bba25aed55936a9f91,1,Andrew Wong,2020-01-06 22:00:01+00:00,['80e1d82c6ff10d5b6e507b68c6f5149dd65bb525'],36,163,199,1508549,13,0,0.923076923,0.974358974,2569
a6d1033a0f48b33f6932bcdd1b4d95588fb85401,0,Adar Dembo,2020-01-07 05:35:23+00:00,['4f22c0f9a6e8d41ec5efa0bba25aed55936a9f91'],140,109,249,1508798,2,1,0.0625,0,2569
5b4085619747b074d89c2762f39ac1eae3580ace,1,Andrew Wong,2020-01-07 07:37:51+00:00,['a6d1033a0f48b33f6932bcdd1b4d95588fb85401'],12,264,276,1509074,11,0.157024793,0.966942149,0.983471074,2570
790c66f9302ac645aafe81b394538b1e5e07e724,0,Andrew Wong,2020-01-07 08:23:12+00:00,['5b4085619747b074d89c2762f39ac1eae3580ace'],9,20,29,1509103,5,,,,2570
50a4b763f09ff6a4a8955dd213e0e37a94e38b92,0,Andrew Wong,2020-01-07 08:23:15+00:00,['790c66f9302ac645aafe81b394538b1e5e07e724'],2,4,6,1509109,1,0,0,1,2570
4619473b9a83dce2b6a60a79802fde33c8686238,1,Andrew Wong,2020-01-08 01:21:36+00:00,['50a4b763f09ff6a4a8955dd213e0e37a94e38b92'],4,207,211,1509320,5,0.251968504,0.755905512,0.874015748,2570
da55638394d78830b3440b2272f8161afae08ca0,1,Andrew Wong,2020-01-08 04:34:21+00:00,['4619473b9a83dce2b6a60a79802fde33c8686238'],6,13,19,1509339,2,,,,2570
c033425b3d579591ebb15c75de1f193604b8e95b,0,Andrew Wong,2020-01-08 04:34:24+00:00,['da55638394d78830b3440b2272f8161afae08ca0'],6,18,24,1509363,3,0,1,1,2570
5bf1f73f71175a7d7903c4f1f991f94d615258f9,0,Adar Dembo,2020-01-08 17:55:09+00:00,['c033425b3d579591ebb15c75de1f193604b8e95b'],48,24,72,1509435,3,0,0,0,2570
69d4e8116a928cef556b5447e30f4b0ed4ea0978,0,Grant Henke,2020-01-08 19:21:28+00:00,['5bf1f73f71175a7d7903c4f1f991f94d615258f9'],9,34,43,1509478,4,0,0.652173913,1,2570
4dca6b02a5e7b2e589646e79bc6e509f27c13c3d,0,Adar Dembo,2020-01-08 23:17:00+00:00,['69d4e8116a928cef556b5447e30f4b0ed4ea0978'],198,355,553,1510031,6,0.117647059,0.784313725,0.784313725,2570
bc013dfb65128943b9a49473d9d7b969d949a09b,0,Grant Henke,2020-01-09 19:27:03+00:00,['4dca6b02a5e7b2e589646e79bc6e509f27c13c3d'],1,1,2,1510033,1,,,,2570
58b6a4150e86d653d30f548019bf8541d9fbdc78,0,Grant Henke,2020-01-09 19:57:34+00:00,['bc013dfb65128943b9a49473d9d7b969d949a09b'],0,1,1,1510034,1,,,,2570
1b945e16b29bb445932c5e59853ac73e9aba69c1,0,Adar Dembo,2020-01-10 08:12:31+00:00,['58b6a4150e86d653d30f548019bf8541d9fbdc78'],50,83,133,1510167,4,0.55,1,1,2570
2596000cacf373fc1532f95f8e1f519b4b0c7b50,0,Adar Dembo,2020-01-10 18:51:35+00:00,['1b945e16b29bb445932c5e59853ac73e9aba69c1'],8,16,24,1510191,1,,,,2570
39df95e5fa2ffec1462431e4fddc3bcdbebf2bdd,0,Adar Dembo,2020-01-10 19:25:39+00:00,['2596000cacf373fc1532f95f8e1f519b4b0c7b50'],95,16,111,1510302,3,0.882352941,0,0,2570
c9182296186205bb0bfca06173f2e1095a57c6dc,0,Alexey Serbin,2020-01-10 22:33:55+00:00,['39df95e5fa2ffec1462431e4fddc3bcdbebf2bdd'],25,18,43,1510345,2,1,0.4,0,2570
e11f0151a2d22d2658995e27c8dcde4d3441f561,0,Adar Dembo,2020-01-10 22:45:54+00:00,['c9182296186205bb0bfca06173f2e1095a57c6dc'],211,195,406,1510751,40,0,0,0,2570
9c7d955c828be6eb4d4a2bf9c1e648be8590377b,0,Adar Dembo,2020-01-10 22:45:56+00:00,['e11f0151a2d22d2658995e27c8dcde4d3441f561'],203,113,316,1511067,38,1,0,0,2570
ad7f5914a943e60b829508468666e6f5d9c64b3d,0,Adar Dembo,2020-01-10 23:03:10+00:00,['9c7d955c828be6eb4d4a2bf9c1e648be8590377b'],35,37,72,1511139,14,0,,,2570
76cba44964be5e50a8c9a8d009580939b2515fb6,0,Adar Dembo,2020-01-10 23:27:05+00:00,['ad7f5914a943e60b829508468666e6f5d9c64b3d'],6,4,10,1511149,3,1,1,0,2570
5067abbdd2dc95eea74072dec1b07e3c0eb98423,0,Andrew Wong,2020-01-13 19:29:59+00:00,['76cba44964be5e50a8c9a8d009580939b2515fb6'],3,260,263,1511412,4,0.462809917,0.462809917,0.396694215,2572
b6a298558ef1fc1218c16b68b3031b3646f7e6db,0,Adar Dembo,2020-01-13 21:49:55+00:00,['5067abbdd2dc95eea74072dec1b07e3c0eb98423'],41,38,79,1511491,17,0,0,0,2572
69172e80ce2c1c1eaed19242d08037372f38ed19,0,Adar Dembo,2020-01-13 23:01:18+00:00,['b6a298558ef1fc1218c16b68b3031b3646f7e6db'],178,230,408,1511899,13,0,0.98,0.62,2572
d5fab3e808357ff7f7af77934cc5ff0b641f35ab,0,Adar Dembo,2020-01-14 00:33:05+00:00,['69172e80ce2c1c1eaed19242d08037372f38ed19'],12,22,34,1511933,2,0,0.5,0.5,2572
c20aecce285e05500a49925502f4a9a259fd20c7,0,Adar Dembo,2020-01-14 00:33:14+00:00,['d5fab3e808357ff7f7af77934cc5ff0b641f35ab'],11,46,57,1511990,1,0.266666667,1,1,2572
90c12dc27ef716e7ba8397e74251b69ef38f1984,0,Adar Dembo,2020-01-14 01:13:54+00:00,['c20aecce285e05500a49925502f4a9a259fd20c7'],0,3,3,1511993,1,1,1,1,2572
ef0d3bdd7ff823a7c84f072b3e4476a864d1c17f,0,Adar Dembo,2020-01-14 05:08:54+00:00,['90c12dc27ef716e7ba8397e74251b69ef38f1984'],72,160,232,1512225,2,0,0.5625,0.203125,2572
c0bf8cab5263b2cd2c3b847d2188c0647098e445,0,Adar Dembo,2020-01-14 05:09:31+00:00,['ef0d3bdd7ff823a7c84f072b3e4476a864d1c17f'],2,20,22,1512247,1,1,1,1,2572
0d7ce6906d42a17a7cfabc958e672ddc39e9ea7b,0,Andrew Wong,2020-01-14 05:53:35+00:00,['c0bf8cab5263b2cd2c3b847d2188c0647098e445'],33,35,68,1512315,2,0,0,1,2572
b4c317299f39ae0530cb10702e540cd22393656c,0,Alexey Serbin,2020-01-14 06:43:52+00:00,['0d7ce6906d42a17a7cfabc958e672ddc39e9ea7b'],6,203,209,1512524,6,0.237113402,1,1,2572
4f82a46da97d9987139aee26614e904118bce4a9,1,Grant Henke,2020-01-14 19:39:58+00:00,['b4c317299f39ae0530cb10702e540cd22393656c'],187,439,626,1513150,29,1,1,0.78021978,2576
11b9f6529a29b391e02a45957a74c507b8f5e8dd,0,Grant Henke,2020-01-14 19:40:11+00:00,['4f82a46da97d9987139aee26614e904118bce4a9'],7,3,10,1513160,2,,,,2576
1650e2f39449a1b89d4c3abba1106b5ad6bf824a,0,Grant Henke,2020-01-14 19:40:35+00:00,['11b9f6529a29b391e02a45957a74c507b8f5e8dd'],37,110,147,1513307,4,,,,2577
12b907e5411913eb511d7df008c4e6697bdc58bb,0,Grant Henke,2020-01-14 20:51:49+00:00,['1650e2f39449a1b89d4c3abba1106b5ad6bf824a'],5,5,10,1513317,1,,,,2577
e2e86eab9a6544cac9b51c83b86831510ee210d7,0,Andrew Wong,2020-01-14 23:50:10+00:00,['12b907e5411913eb511d7df008c4e6697bdc58bb'],9,11,20,1513337,1,1,1,1,2577
3a30cc22684512e3f2934cde57bc10bebf7dd156,0,Alexey Serbin,2020-01-15 00:16:04+00:00,['e2e86eab9a6544cac9b51c83b86831510ee210d7'],169,501,670,1514007,7,0.021505376,0.397849462,0.327956989,2577
c235ba188d282ebba6c83e19a0aab07846d4b91a,0,Alexey Serbin,2020-01-15 00:32:22+00:00,['3a30cc22684512e3f2934cde57bc10bebf7dd156'],5,37,42,1514049,2,0.869565217,0.869565217,1,2577
965e59f5a3d8dfaef70f30e08ddbec82f7ef3234,0,Grant Henke,2020-01-15 03:06:08+00:00,['c235ba188d282ebba6c83e19a0aab07846d4b91a'],6,5,11,1514060,1,,,,2577
926bca85827e597f2923652c3b3b017c7c071f3b,0,Adar Dembo,2020-01-15 19:40:00+00:00,['965e59f5a3d8dfaef70f30e08ddbec82f7ef3234'],8,24,32,1514092,8,0.2,0,1,2577
54db215511e84785a8649ba1e52911f8adfb11e4,1,Andrew Wong,2020-01-16 02:05:21+00:00,['926bca85827e597f2923652c3b3b017c7c071f3b'],25,306,331,1514423,6,0.06779661,0.97740113,0.983050847,2577
31ed4a11de3f5a158d90d76b306c2d96fe07a55d,0,Andrew Wong,2020-01-16 03:28:09+00:00,['54db215511e84785a8649ba1e52911f8adfb11e4'],1,56,57,1514480,6,0.137931034,0.896551724,1,2577
ad8fc5316ad1459509fa3433d0798c22ecf642dc,0,Adar Dembo,2020-01-16 04:37:28+00:00,['31ed4a11de3f5a158d90d76b306c2d96fe07a55d'],0,2,2,1514482,1,,,,2577
8463663ca9d6b0f4440dc2d4d321de62b7b6f909,0,Adar Dembo,2020-01-16 04:39:35+00:00,['ad8fc5316ad1459509fa3433d0798c22ecf642dc'],48,63,111,1514593,19,0,1,0.75,2577
50ac527ec1b046884eade2216f28dc3893eef95d,0,Alexey Serbin,2020-01-16 07:09:58+00:00,['8463663ca9d6b0f4440dc2d4d321de62b7b6f909'],9,8,17,1514610,2,,,,2577
b924d18850cbf7fe98402265a0305acab32937fc,0,Grant Henke,2020-01-16 17:09:30+00:00,['50ac527ec1b046884eade2216f28dc3893eef95d'],2,2,4,1514614,1,,,,2577
c8384a04029c3e1b4ce23888355a850721d0f8e7,0,Alexey Serbin,2020-01-16 17:58:30+00:00,['b924d18850cbf7fe98402265a0305acab32937fc'],44,39,83,1514697,3,,,,2577
6325c4edcc389aa2ee1d8f028f367978047b8be6,0,Todd Lipcon,2020-01-16 21:20:26+00:00,['c8384a04029c3e1b4ce23888355a850721d0f8e7'],15,6,21,1514718,2,0,0,0,2577
5818a839e6219347ea28385dd7b3bbf2ab475e27,0,Grant Henke,2020-01-16 22:41:37+00:00,['6325c4edcc389aa2ee1d8f028f367978047b8be6'],0,8,8,1514726,3,,,,2577
f37afe2578404716a7149221a69d8fc16c2f335c,0,Alexey Serbin,2020-01-17 00:45:19+00:00,['5818a839e6219347ea28385dd7b3bbf2ab475e27'],7,2,9,1514735,3,,,,2577
0bd417b40e4dfea9bb454414c836ce589a16ca5d,0,Alexey Serbin,2020-01-17 01:27:20+00:00,['f37afe2578404716a7149221a69d8fc16c2f335c'],9,22,31,1514766,3,0.2,0.7,0.5,2577
2e50335112aab5ffc706414c5873400b8177bd5b,0,Todd Lipcon,2020-01-17 08:04:46+00:00,['0bd417b40e4dfea9bb454414c836ce589a16ca5d'],4,7,11,1514777,2,0,1,0,2577
32d1ac04bbd4b1bb8eecb35e05bde3bfa384a3ed,0,Grant Henke,2020-01-17 20:16:21+00:00,['2e50335112aab5ffc706414c5873400b8177bd5b'],3,2,5,1514782,1,,,,2577
4bf7e457b054d9bfb002e3971113e2152b92951a,0,Adar Dembo,2020-01-17 20:19:25+00:00,['32d1ac04bbd4b1bb8eecb35e05bde3bfa384a3ed'],20,86,106,1514888,7,0.388888889,0,0.111111111,2577
9106a3ca8d5b44a8305cb01a012064358bf5dcb9,0,Todd Lipcon,2020-01-17 21:42:20+00:00,['4bf7e457b054d9bfb002e3971113e2152b92951a'],2,10,12,1514900,3,1,1,0,2577
e6ac21838acf077b617bc8829511045dff3c859b,0,Grant Henke,2020-01-18 01:00:21+00:00,['9106a3ca8d5b44a8305cb01a012064358bf5dcb9'],19,24,43,1514943,2,,,,2577
3f52d9ae0bde7bacf61d52ea82a898e035d4402e,0,Andrew Wong,2020-01-18 07:23:19+00:00,['e6ac21838acf077b617bc8829511045dff3c859b'],36,83,119,1515062,4,0.277777778,0.777777778,0.5,2577
0cded868fd3d8ff088cd290dccdd9d90fdc0817c,0,Andrew Wong,2020-01-18 08:46:02+00:00,['3f52d9ae0bde7bacf61d52ea82a898e035d4402e'],2,14,16,1515078,2,0.2,0.2,1,2577
950d9bfb8f451f3d3ba1b920ada31c9add6e5e4e,0,Grant Henke,2020-01-21 18:15:23+00:00,['0cded868fd3d8ff088cd290dccdd9d90fdc0817c'],0,19,19,1515097,1,1,1,1,2577
773bfe39f778f659871c987bdb4dc93eeef96408,0,Grant Henke,2020-01-21 18:44:58+00:00,['950d9bfb8f451f3d3ba1b920ada31c9add6e5e4e'],8,8,16,1515113,5,,,,2577
45af2ad42232c8559bba47c027c6cd41fa3dd9a4,0,Grant Henke,2020-01-21 21:53:21+00:00,['773bfe39f778f659871c987bdb4dc93eeef96408'],1,1,2,1515115,1,,,,2577
07e36221b8d8b3ce48690e40181a51a6953323b8,0,Adar Dembo,2020-01-21 22:38:35+00:00,['45af2ad42232c8559bba47c027c6cd41fa3dd9a4'],8,9,17,1515132,2,1,0,0,2577
37c3a960e9b0f86069876f049e9a073d4b5fd907,0,Adar Dembo,2020-01-21 22:38:37+00:00,['07e36221b8d8b3ce48690e40181a51a6953323b8'],23,13,36,1515168,8,1,0,0,2577
ceeabc5460bf4d791441bc1b2d37347475c1b399,0,Adar Dembo,2020-01-21 22:38:47+00:00,['37c3a960e9b0f86069876f049e9a073d4b5fd907'],1,3,4,1515172,1,0,1,0,2577
0f22f1268c4fda855456d6245c28024daf881d00,0,Adar Dembo,2020-01-21 22:40:50+00:00,['ceeabc5460bf4d791441bc1b2d37347475c1b399'],16,24,40,1515212,3,,,,2577
638d95d295da0bddf3fa157792ec7de8889ac919,0,Todd Lipcon,2020-01-21 22:53:13+00:00,['0f22f1268c4fda855456d6245c28024daf881d00'],120,191,311,1515523,2,,,,2578
c3170a9fc6b5c30e85b94be615d8064ed7d26cd6,0,Todd Lipcon,2020-01-21 23:36:59+00:00,['638d95d295da0bddf3fa157792ec7de8889ac919'],86,88,174,1515697,6,1,0,0,2579
53533bbc88183710329285789db5572e173a9abb,0,Alexey Serbin,2020-01-22 19:21:18+00:00,['c3170a9fc6b5c30e85b94be615d8064ed7d26cd6'],13,719,732,1516429,6,0.502415459,0.666666667,0.942028986,2584
69cf2065805163799d85dc38b812eb73388d3a02,0,Alexey Serbin,2020-01-22 19:21:20+00:00,['53533bbc88183710329285789db5572e173a9abb'],11,121,132,1516561,5,0.029411765,0.279411765,1,2584
21073b06ce30171b10ed09bee133fcafe650f022,0,Adar Dembo,2020-01-22 22:25:33+00:00,['69cf2065805163799d85dc38b812eb73388d3a02'],102,259,361,1516922,6,0.536082474,0.948453608,0.463917526,2584
fc4ab691a502067bc4d5bdff30507cac7feb7cfe,0,Adar Dembo,2020-01-22 22:25:35+00:00,['21073b06ce30171b10ed09bee133fcafe650f022'],112,259,371,1517293,31,0,0.82,0.6,2584
d64ac1c4edb61f15e9b7268044017ca138e0dd05,0,Adar Dembo,2020-01-23 19:27:49+00:00,['fc4ab691a502067bc4d5bdff30507cac7feb7cfe'],5,7,12,1517305,1,1,1,1,2584
14cbaeea009d5787dbf1b830a7e62964dad7a53a,0,Andrew Wong,2020-01-23 21:55:26+00:00,['d64ac1c4edb61f15e9b7268044017ca138e0dd05'],55,651,706,1518011,12,0.220630372,0.911174785,0.896848138,2584
eb7fb1f40dd4c700aae83b21e4a2e4d4cbf4b41c,0,Alexey Serbin,2020-01-24 04:34:17+00:00,['14cbaeea009d5787dbf1b830a7e62964dad7a53a'],21,25,46,1518057,1,0.333333333,0.333333333,1,2584
eb48992c27a490ca30d740f82f3da6995a2855e4,0,Andrew Wong,2020-01-24 23:55:13+00:00,['eb7fb1f40dd4c700aae83b21e4a2e4d4cbf4b41c'],5,72,77,1518134,5,0,1,0.981481481,2584
e371d80f3e2ab171f704db198125ae8f8a860a6d,0,Alexey Serbin,2020-01-25 06:13:28+00:00,['eb48992c27a490ca30d740f82f3da6995a2855e4'],37,56,93,1518227,2,1,1,1,2584
092d0e535ac1c86d9f85f2987f42cb92fb352984,0,Alexey Serbin,2020-01-27 17:46:00+00:00,['e371d80f3e2ab171f704db198125ae8f8a860a6d'],31,58,89,1518316,1,,,,2584
3ba5ec5d0ab3e56428d990afbff92e3dde241578,0,Alexey Serbin,2020-01-28 04:39:48+00:00,['092d0e535ac1c86d9f85f2987f42cb92fb352984'],7,4,11,1518327,1,1,0,0,2584
d014360c66cf3b35708c0eb794ade9f454dcf687,0,Alexey Serbin,2020-01-28 17:57:27+00:00,['3ba5ec5d0ab3e56428d990afbff92e3dde241578'],2,7,9,1518336,1,0,0,1,2584
6b7355d12c1ce10eb1e361003ebd6b87ce2d7009,0,Alexey Serbin,2020-01-28 18:01:27+00:00,['d014360c66cf3b35708c0eb794ade9f454dcf687'],1,1,2,1518338,1,,,,2584
6e4dd49a4716f1aed4f533a85b794dfd04f3ab96,0,Andrew Wong,2020-01-28 22:48:56+00:00,['6b7355d12c1ce10eb1e361003ebd6b87ce2d7009'],11,43,54,1518392,1,0,1,1,2584
cbf02aa3dac297ec1ddb8e91f71cd6de99589463,0,Alexey Serbin,2020-01-28 23:39:30+00:00,['6e4dd49a4716f1aed4f533a85b794dfd04f3ab96'],1,1,2,1518394,1,,,,2584
0f3bb6508d97227aba7dd6320c2b1f49ef7bd418,0,Grant Henke,2020-01-29 17:58:24+00:00,['cbf02aa3dac297ec1ddb8e91f71cd6de99589463'],1,2,3,1518397,1,,,,2584
c80080d365aa478a951cbbd76475a52a0767ac82,0,Grant Henke,2020-01-29 17:58:28+00:00,['0f3bb6508d97227aba7dd6320c2b1f49ef7bd418'],2,2,4,1518401,1,,,,2584
e730ebd7ee0577e43098af697d2bace4c7384da3,0,Alexey Serbin,2020-01-29 19:06:00+00:00,['c80080d365aa478a951cbbd76475a52a0767ac82'],3,4,7,1518408,2,1,1,1,2584
ce73377a42c92edd1677a842af9598ccdfbd39ae,0,Alexey Serbin,2020-01-29 19:06:05+00:00,['e730ebd7ee0577e43098af697d2bace4c7384da3'],10,25,35,1518443,1,0,1,1,2584
2ba4edcd454f9362591d1df4fa6dda148d7cae62,0,Alexey Serbin,2020-01-29 19:37:03+00:00,['ce73377a42c92edd1677a842af9598ccdfbd39ae'],4,18,22,1518465,1,,,,2584
477608e4141d63c51f89377fddcefcd19d38a5e5,0,Alexey Serbin,2020-01-30 20:12:18+00:00,['2ba4edcd454f9362591d1df4fa6dda148d7cae62'],1,1,2,1518467,1,,,,2584
37f780f00a5a5fdb754ac952896f6c3368d4256d,0,Alexey Serbin,2020-01-31 00:38:29+00:00,['477608e4141d63c51f89377fddcefcd19d38a5e5'],0,11,11,1518478,1,,,,2584
b8c8ac4da087ecd8793cc6b8b7fcef2444983005,0,Andrew Wong,2020-02-02 00:00:55+00:00,['37f780f00a5a5fdb754ac952896f6c3368d4256d'],28,27,55,1518533,1,,,,2584
06a62ec681009b146de3f73808711161c5bed12d,0,Alexey Serbin,2020-02-03 06:01:42+00:00,['b8c8ac4da087ecd8793cc6b8b7fcef2444983005'],94,232,326,1518859,13,0.262135922,0,0.601941748,2584
a27de78de2de7b15e18ff0e9e6a4b3e57c398ac7,0,Alexey Serbin,2020-02-03 17:53:48+00:00,['06a62ec681009b146de3f73808711161c5bed12d'],14,9,23,1518882,2,1,0,0,2584
66515e7a3e2dce54aa5e9e31cd1dc902207f8a16,0,Alexey Serbin,2020-02-03 17:53:54+00:00,['a27de78de2de7b15e18ff0e9e6a4b3e57c398ac7'],88,198,286,1519168,1,,,,2584
b32283d2e5ce3d88e4f6afdeedf1c616721cce3a,0,Adar Dembo,2020-02-04 23:19:55+00:00,['66515e7a3e2dce54aa5e9e31cd1dc902207f8a16'],61,77,138,1519306,2,0.545454545,0.545454545,0.909090909,2584
e72208436a625391739217394c67d783e992367a,0,Alexey Serbin,2020-02-05 00:23:17+00:00,['b32283d2e5ce3d88e4f6afdeedf1c616721cce3a'],50,62,112,1519418,4,1,1,1,2584
6f626f2baef0519cbae6546ec15f939419c489b6,0,Alexey Serbin,2020-02-05 19:13:22+00:00,['e72208436a625391739217394c67d783e992367a'],16,22,38,1519456,1,1,0,0,2584
cfe589ca8dc4e6ead0b49ed372ea06f63bacda52,0,Alexey Serbin,2020-02-05 19:13:29+00:00,['6f626f2baef0519cbae6546ec15f939419c489b6'],3,3,6,1519462,2,,,,2584
5623b9b55c222582aa6394c990111326a4488f55,0,Grant Henke,2020-02-05 22:39:17+00:00,['cfe589ca8dc4e6ead0b49ed372ea06f63bacda52'],0,8,8,1519470,1,,,,2584
79a856aa2500061573096b155c17d01c0a47fcb2,0,Alexey Serbin,2020-02-06 04:45:34+00:00,['5623b9b55c222582aa6394c990111326a4488f55'],98,79,177,1519647,6,0,1,1,2584
9050941663e532db29bd25cb7170712a80d945ea,0,Alexey Serbin,2020-02-06 04:48:00+00:00,['79a856aa2500061573096b155c17d01c0a47fcb2'],0,15,15,1519662,3,0.428571429,0.571428571,0.571428571,2584
d941dd5c4f1caba6c105ce1137bd18cc789d5bc2,0,Adar Dembo,2020-02-06 07:15:48+00:00,['9050941663e532db29bd25cb7170712a80d945ea'],19,35,54,1519716,1,0,1,1,2584
807c3e50e44ee9b2ed70e5fb4ef3bee0f323bfc4,0,Alexey Serbin,2020-02-06 16:43:29+00:00,['d941dd5c4f1caba6c105ce1137bd18cc789d5bc2'],2,2,4,1519720,1,,,,2584
e97e8947f7edced314a9e22084a2738e8474451b,0,Adar Dembo,2020-02-07 00:48:25+00:00,['807c3e50e44ee9b2ed70e5fb4ef3bee0f323bfc4'],2,4,6,1519726,1,,,,2584
5c610bf40543feca7ed934e9fe1ebbbcccd6c265,0,Alexey Serbin,2020-02-07 21:06:19+00:00,['e97e8947f7edced314a9e22084a2738e8474451b'],1,36,37,1519763,3,,,,2585
a20461d76aeac56db54d4ba6c6c05dafe4153999,0,Alexey Serbin,2020-02-07 23:44:37+00:00,['5c610bf40543feca7ed934e9fe1ebbbcccd6c265'],27,28,55,1519818,1,0,,,2585
57dda5d4868d29f68de4aa0ac516ca390333e6be,0,Grant Henke,2020-02-07 23:55:54+00:00,['a20461d76aeac56db54d4ba6c6c05dafe4153999'],485,501,986,1520804,39,0.761904762,1,1,2585
9f6b653aba9618a0f4220913436effb3b486cfe6,0,Hao Hao,2020-02-08 02:01:58+00:00,['57dda5d4868d29f68de4aa0ac516ca390333e6be'],0,74,74,1520878,2,,,,2586
622260415fe2b0d2dd5f14f8e1b0e4a03eff2662,0,Hao Hao,2020-02-08 02:02:09+00:00,['9f6b653aba9618a0f4220913436effb3b486cfe6'],0,1395,1395,1522273,17,0.723004695,0.9342723,0.828638498,2602
2c0f7243da2a403143637e1b841d6f3b3b0bc05a,0,Alexey Serbin,2020-02-08 06:42:21+00:00,['622260415fe2b0d2dd5f14f8e1b0e4a03eff2662'],5,54,59,1522332,2,,,,2602
995c9a76cc4aaeb7e91b0f894a13e5d1ac1f8fe4,0,Alexey Serbin,2020-02-08 06:42:27+00:00,['2c0f7243da2a403143637e1b841d6f3b3b0bc05a'],0,23,23,1522355,2,1,1,1,2602
1a401df1d56fb6d2b453561162fb5f14634b22ff,0,Hao Hao,2020-02-10 17:30:53+00:00,['995c9a76cc4aaeb7e91b0f894a13e5d1ac1f8fe4'],0,18,18,1522373,2,,,,2602
99ade859168c7d6c53caf45905a665b3eade8d23,0,Alexey Serbin,2020-02-10 18:02:51+00:00,['1a401df1d56fb6d2b453561162fb5f14634b22ff'],0,2,2,1522375,1,,,,2602
62f6a300a5c092a6c61c91fe1546014eb8787b6e,1,Grant Henke,2020-02-10 19:07:56+00:00,['99ade859168c7d6c53caf45905a665b3eade8d23'],18,490,508,1522883,25,0.428571429,0.551020408,0.844897959,2604
914efea217b0c80b1454a7664e61b7c00bf8a8a5,0,Alexey Serbin,2020-02-11 01:31:29+00:00,['62f6a300a5c092a6c61c91fe1546014eb8787b6e'],1,2,3,1522886,1,,,,2604
de3b76466ff8dc8cd85ce2f218f54e71067d013b,0,Tim Armstrong,2020-02-11 04:09:55+00:00,['914efea217b0c80b1454a7664e61b7c00bf8a8a5'],6,6,12,1522898,1,,,,2604
1179cfb8a2dbfee5cb1e955c9917bdbddc2827f6,0,Grant Henke,2020-02-11 14:17:20+00:00,['de3b76466ff8dc8cd85ce2f218f54e71067d013b'],91,136,227,1523125,17,0.8,0.866666667,0.133333333,2604
a30481c4a690d09e62f35c29b162f934d1af74a3,0,Grant Henke,2020-02-11 14:17:22+00:00,['1179cfb8a2dbfee5cb1e955c9917bdbddc2827f6'],15,15,30,1523155,2,,,,2604
964b333d6a0c8441ee5577812e6aee9d6388f055,0,Grant Henke,2020-02-11 15:15:39+00:00,['a30481c4a690d09e62f35c29b162f934d1af74a3'],69,82,151,1523306,4,0,1,1,2604
c48e45e27fb3b95b92ac26e980fc467d15c3ac48,0,Alexey Serbin,2020-02-11 18:07:10+00:00,['964b333d6a0c8441ee5577812e6aee9d6388f055'],6,36,42,1523348,3,,,,2604
b915df7f335ec947cfc8339aa8f59be0188e4469,0,Grant Henke,2020-02-11 20:08:44+00:00,['c48e45e27fb3b95b92ac26e980fc467d15c3ac48'],0,98,98,1523446,1,,,,2605
f392503972e41fe57d80fefb3779a82c9a92229f,0,Attila Bukor,2020-02-11 21:14:08+00:00,['b915df7f335ec947cfc8339aa8f59be0188e4469'],8,152,160,1523606,4,0,0.714285714,0.714285714,2605
4bbe2c07b7334a6d657f3ca17d3abb60d3e83ebb,0,Alexey Serbin,2020-02-12 02:21:11+00:00,['f392503972e41fe57d80fefb3779a82c9a92229f'],13,14,27,1523633,2,1,1,0,2605
759f04c7ec868bb1cec4a196e47cf988af8875fd,0,Grant Henke,2020-02-12 03:05:14+00:00,['4bbe2c07b7334a6d657f3ca17d3abb60d3e83ebb'],2,204,206,1523839,6,0,0.612903226,0.858064516,2605
91a9c453fbe372ba4f5c74b82669297bd5c0f0f8,0,Hao Hao,2020-02-12 19:58:56+00:00,['759f04c7ec868bb1cec4a196e47cf988af8875fd'],0,10,10,1523849,2,1,1,1,2605
8808b041c9db0af7642311390d7d9189032cc36a,0,Alexey Serbin,2020-02-14 17:45:58+00:00,['91a9c453fbe372ba4f5c74b82669297bd5c0f0f8'],315,336,651,1524500,25,0,0.88,0.96,2605
1cc18b057ed706238e71123ae7c0cd4a8778613c,0,Hao Hao,2020-02-14 19:44:30+00:00,['8808b041c9db0af7642311390d7d9189032cc36a'],127,289,416,1524916,8,0.950819672,1,0.721311475,2607
9c84920811881873733655d6c95fc7740456c4d7,0,Alexey Serbin,2020-02-14 19:58:17+00:00,['1cc18b057ed706238e71123ae7c0cd4a8778613c'],100,96,196,1525112,4,1,0,0,2607
6371ffdb54fa09f891e01a120e74993f38286c9f,0,Alexey Serbin,2020-02-14 21:34:28+00:00,['9c84920811881873733655d6c95fc7740456c4d7'],17,75,92,1525204,4,0,0.315789474,1,2607
bd8e8f8b805bec5673590dffa67e48fbc9cfe208,0,Alexey Serbin,2020-02-14 21:34:32+00:00,['6371ffdb54fa09f891e01a120e74993f38286c9f'],126,271,397,1525601,5,0.540983607,0.983606557,1,2607
0a7787f6563ae316a4a6207a9244c19ba8a7731f,0,Todd Lipcon,2020-02-14 21:40:28+00:00,['bd8e8f8b805bec5673590dffa67e48fbc9cfe208'],94,203,297,1525898,14,0.875,1,1,2607
c219733298eebc14240507459a51f312215b6524,0,Alexey Serbin,2020-02-16 23:35:07+00:00,['0a7787f6563ae316a4a6207a9244c19ba8a7731f'],1,1,2,1525900,1,,,,2607
b984851f704808f5ee07182811527e811389aa57,0,Alexey Serbin,2020-02-18 19:08:48+00:00,['c219733298eebc14240507459a51f312215b6524'],33,76,109,1526009,5,0,0.304347826,1,2607
731f5f3b144e93fdc5b55313a71cc9cec920692e,0,Grant Henke,2020-02-18 21:45:44+00:00,['b984851f704808f5ee07182811527e811389aa57'],79,359,438,1526447,24,0.286458333,0.484375,0.734375,2607
14234a62c6dec587d5a8cb6a0ff3e3b3a9154409,0,Grant Henke,2020-02-18 21:45:48+00:00,['731f5f3b144e93fdc5b55313a71cc9cec920692e'],1,126,127,1526574,4,0.271428571,1,1,2608
48709dea9880240b37f2341e3361b1016883658d,0,Grant Henke,2020-02-18 21:45:52+00:00,['14234a62c6dec587d5a8cb6a0ff3e3b3a9154409'],2,44,46,1526620,4,0,1,1,2608
ba7c64f255eebbffe540cdb0c7b5779eb8a564ab,0,Alexey Serbin,2020-02-19 08:24:33+00:00,['48709dea9880240b37f2341e3361b1016883658d'],11,66,77,1526697,2,0.066666667,0,1,2608
961888dd14e5bd306d3e5b741bc4443620617664,0,Alexey Serbin,2020-02-19 17:23:28+00:00,['ba7c64f255eebbffe540cdb0c7b5779eb8a564ab'],376,491,867,1527564,15,1,0,1,2609
9285726facf783d41d8f8b81181070d1f356b420,0,Alexey Serbin,2020-02-19 17:24:10+00:00,['961888dd14e5bd306d3e5b741bc4443620617664'],14,113,127,1527691,3,0.673469388,1,1,2609
9668525c725a9dced7b6ace93967a8156df0c94c,0,Alexey Serbin,2020-02-19 17:24:19+00:00,['9285726facf783d41d8f8b81181070d1f356b420'],2,75,77,1527768,3,0.571428571,0.571428571,0.571428571,2609
3e6d6221e1149a9a068f7d3668fddee5967e196a,0,Alexey Serbin,2020-02-19 17:25:11+00:00,['9668525c725a9dced7b6ace93967a8156df0c94c'],11,679,690,1528458,11,0.46440678,0.922033898,0.850847458,2612
a65745e5e9c189f13ac966deb542a1ac22870654,0,Adar Dembo,2020-02-19 19:11:54+00:00,['3e6d6221e1149a9a068f7d3668fddee5967e196a'],4,21,25,1528483,2,,,,2612
4aa0c7c0bc7d91af8be9a837b64f2a53fe31dd44,0,Alexey Serbin,2020-02-19 19:39:53+00:00,['a65745e5e9c189f13ac966deb542a1ac22870654'],5,156,161,1528644,4,0.105263158,0.105263158,0.98245614,2613
0094751fbf4b7cf81c0a4bd5c62335e0fcd904c7,0,Alexey Serbin,2020-02-19 21:10:57+00:00,['4aa0c7c0bc7d91af8be9a837b64f2a53fe31dd44'],1,1,2,1528646,1,,,,2613
88ebbea77cf41d2082aaee30c9f8d4b88a1859c6,0,Adar Dembo,2020-02-19 21:59:49+00:00,['0094751fbf4b7cf81c0a4bd5c62335e0fcd904c7'],73,40,113,1528759,7,1,0,1,2613
7d9d7009ac288327a54ea694d171f8c2ad23165d,0,Alexey Serbin,2020-02-20 05:10:03+00:00,['88ebbea77cf41d2082aaee30c9f8d4b88a1859c6'],25,135,160,1528919,5,0.916666667,0.944444444,1,2613
ef5ed59760280537ad532c93d73ca2a7afcb74d3,0,Alexey Serbin,2020-02-20 06:02:41+00:00,['7d9d7009ac288327a54ea694d171f8c2ad23165d'],2,4,6,1528925,2,,,,2613
df7b2a63f8475d1e8d4268cba5568abb397396fe,0,Grant Henke,2020-02-20 21:33:00+00:00,['ef5ed59760280537ad532c93d73ca2a7afcb74d3'],1,1,2,1528927,1,,,,2613
5f199c16d46fc6bd6003f00d4e56ba75923f192c,0,Grant Henke,2020-02-20 21:33:09+00:00,['df7b2a63f8475d1e8d4268cba5568abb397396fe'],27,72,99,1529026,2,1,1,1,2613
52c59352f8c06be359edb95d2a68ad06252e2031,0,Grant Henke,2020-02-20 23:42:16+00:00,['5f199c16d46fc6bd6003f00d4e56ba75923f192c'],6,6,12,1529038,1,1,1,0,2613
16ad354482151e8cc27f4640250b0337e5219fd7,0,Alexey Serbin,2020-02-21 05:00:33+00:00,['52c59352f8c06be359edb95d2a68ad06252e2031'],69,89,158,1529196,7,1,1,1,2613
e72a3acebb53c19edfc0a74052bc275f0f024831,0,Alexey Serbin,2020-02-21 06:41:34+00:00,['16ad354482151e8cc27f4640250b0337e5219fd7'],1,2,3,1529199,2,,,,2613
20be5d957ab80c7c0ed8eaf62324ac70940d7543,0,Andrew Wong,2020-02-22 02:23:46+00:00,['e72a3acebb53c19edfc0a74052bc275f0f024831'],3,903,906,1530105,8,0.325581395,0.661498708,0.981912145,2616
b0a819e52ba9d04ae3d561e2e611628c5b40c033,0,Andrew Wong,2020-02-22 07:16:34+00:00,['20be5d957ab80c7c0ed8eaf62324ac70940d7543'],22,26,48,1530153,3,0,0,1,2616
26188671cc305757ac34f7c58105a6eea72cc430,0,Andrew Wong,2020-02-23 23:21:35+00:00,['b0a819e52ba9d04ae3d561e2e611628c5b40c033'],224,204,428,1530581,4,1,0,0,2616
9cb3224333e88d56232fae97a4bef02069c67ac9,0,Andrew Wong,2020-02-23 23:22:45+00:00,['26188671cc305757ac34f7c58105a6eea72cc430'],120,141,261,1530842,11,1,1,1,2616
7cfcab629c51df521aff688d111b3691a317011b,0,Alexey Serbin,2020-02-24 21:13:55+00:00,['9cb3224333e88d56232fae97a4bef02069c67ac9'],112,205,317,1531159,6,1,1,1,2618
9968aaa3b96193664338f194208c333835cd88e7,0,Alexey Serbin,2020-02-24 21:14:03+00:00,['7cfcab629c51df521aff688d111b3691a317011b'],0,20,20,1531179,2,1,1,1,2618
bdb991a6b3ed2c989248dbbcfda983bda4d488bf,0,Alexey Serbin,2020-02-24 21:14:08+00:00,['9968aaa3b96193664338f194208c333835cd88e7'],80,201,281,1531460,6,0.342105263,1,1,2618
067290fe7fc34fed0da7102c7e38f2f9c00652ca,0,Andrew Wong,2020-02-24 21:14:15+00:00,['bdb991a6b3ed2c989248dbbcfda983bda4d488bf'],12,16,28,1531488,2,,,,2618
8057eed03487da642f0fb40d6159dca82fde40f2,0,Alexey Serbin,2020-02-24 21:16:31+00:00,['067290fe7fc34fed0da7102c7e38f2f9c00652ca'],2,17,19,1531507,1,1,1,0,2618
3adc2882a15af4e777cb8cd0bc7785f002a9402a,0,Alexey Serbin,2020-02-24 21:54:25+00:00,['8057eed03487da642f0fb40d6159dca82fde40f2'],19,49,68,1531575,4,0,1,1,2618
393b4b57725886a2cfe2ddce92cd9a188c3ccba4,0,Alexey Serbin,2020-02-25 00:51:43+00:00,['3adc2882a15af4e777cb8cd0bc7785f002a9402a'],14,3,17,1531592,2,,,,2618
8b043e8971f97274c620ba1c235ff47a3c5344ce,0,Adar Dembo,2020-02-26 19:15:44+00:00,['393b4b57725886a2cfe2ddce92cd9a188c3ccba4'],0,6,6,1531598,1,1,1,1,2618
7648cb9e8f17ba2b22a58f229fc3c3e0ebdb4414,0,Alexey Serbin,2020-02-26 19:46:53+00:00,['8b043e8971f97274c620ba1c235ff47a3c5344ce'],45,143,188,1531786,4,0.111111111,0.888888889,1,2618
b6e74d8b463f5cf4412635a2cd2954e2105a5267,0,Grant Henke,2020-02-27 14:39:23+00:00,['7648cb9e8f17ba2b22a58f229fc3c3e0ebdb4414'],1,1,2,1531788,1,,,,2618
01b667407f0f36732c67451825ea6e0434b191de,0,Grant Henke,2020-02-27 20:52:11+00:00,['b6e74d8b463f5cf4412635a2cd2954e2105a5267'],1,11,12,1531800,1,0,1,1,2618
df390618efba75bd010dbc45ae38649d5b19a959,0,Alexey Serbin,2020-02-29 02:26:46+00:00,['01b667407f0f36732c67451825ea6e0434b191de'],5,6,11,1531811,3,,,,2618
9ebaa8f5349ec88cbe990d88321cba2b3e5ddc9a,0,Alexey Serbin,2020-03-01 05:29:38+00:00,['df390618efba75bd010dbc45ae38649d5b19a959'],12,18,30,1531841,2,,,,2618
386b04a8b0c8a3b9ff2db8b13bf7bedd8800d14f,0,Grant Henke,2020-03-02 20:14:29+00:00,['9ebaa8f5349ec88cbe990d88321cba2b3e5ddc9a'],111,121,232,1532073,1,1,1,0,2618
f2af57db50ec68ceb1af97c9788776c1911a8fb6,0,Mike Percy,2020-03-03 03:02:31+00:00,['386b04a8b0c8a3b9ff2db8b13bf7bedd8800d14f'],1,1,2,1532075,1,,,,2618
f5a09064f8824faa4be6a5d0edf81d839c8e0740,0,Mike Percy,2020-03-03 03:02:34+00:00,['f2af57db50ec68ceb1af97c9788776c1911a8fb6'],1,1,2,1532077,1,,,,2618
e9c1899173e3baa99c859a32b55b257599b6fc95,0,Alexey Serbin,2020-03-03 06:01:25+00:00,['f5a09064f8824faa4be6a5d0edf81d839c8e0740'],102,94,196,1532273,2,1,0,0,2618
93e85876f472b2668604ce5c15eafb17ce303989,0,Alexey Serbin,2020-03-03 06:04:39+00:00,['e9c1899173e3baa99c859a32b55b257599b6fc95'],0,34,34,1532307,3,0,0.111111111,1,2618
0b6889d109208493a006381555cb7a1cc2576e62,1,Andrew Wong,2020-03-03 06:19:14+00:00,['93e85876f472b2668604ce5c15eafb17ce303989'],159,590,749,1533056,12,0.669172932,0.819548872,0.947368421,2621
e2301c04e40eb55d81435327efa44ccefccc807d,0,Andrew Wong,2020-03-03 06:42:00+00:00,['0b6889d109208493a006381555cb7a1cc2576e62'],77,152,229,1533285,7,0,0.487804878,1,2621
8fb170b004b8298429ada0ec5622d6f566477285,0,Grant Henke,2020-03-03 22:01:25+00:00,['e2301c04e40eb55d81435327efa44ccefccc807d'],4,7,11,1533296,1,0,0,1,2621
c35871df7983a4a1273310483c3cde67553bc8bd,0,Grant Henke,2020-03-03 23:08:52+00:00,['8fb170b004b8298429ada0ec5622d6f566477285'],66,18,84,1533380,10,0,1,1,2621
2a3fe540f3a98bf715ef82ab189759c61a419a2b,0,Alexey Serbin,2020-03-04 00:33:11+00:00,['c35871df7983a4a1273310483c3cde67553bc8bd'],0,2,2,1533382,1,,,,2621
c3122b689a684b6a7503b46836ee645b9bbed8e8,0,Alexey Serbin,2020-03-04 07:11:34+00:00,['2a3fe540f3a98bf715ef82ab189759c61a419a2b'],37,38,75,1533457,4,,,,2621
f4176b1ad00c3fa01b808bbdd58f08f0aa4ab471,0,Andrew Wong,2020-03-04 08:23:08+00:00,['c3122b689a684b6a7503b46836ee645b9bbed8e8'],0,270,270,1533727,3,0.47826087,1,1,2623
bc2efa1ae97fcc4e592c93d38592206d48d6f8f5,0,Andrew Wong,2020-03-04 09:15:38+00:00,['f4176b1ad00c3fa01b808bbdd58f08f0aa4ab471'],17,164,181,1533908,13,0.17,0.67,0.68,2623
9c0a7339465902afd25263edc3c8b27392141e49,0,Grant Henke,2020-03-04 13:59:37+00:00,['bc2efa1ae97fcc4e592c93d38592206d48d6f8f5'],1,2,3,1533911,1,1,1,1,2623
ac7fc9645a140eb56f685666b9df832fe8751f44,0,Alexey Serbin,2020-03-04 17:26:17+00:00,['9c0a7339465902afd25263edc3c8b27392141e49'],88,244,332,1534243,1,,,,2623
4ed0dbbd1a05cb337a0baebeb4c59de3e7bd5da1,0,Grant Henke,2020-03-04 19:57:23+00:00,['ac7fc9645a140eb56f685666b9df832fe8751f44'],2,2,4,1534247,1,,,,2623
61ddfe31bf8abe95484d4bd83e2ecee0155e7b13,0,Adar Dembo,2020-03-04 23:39:22+00:00,['4ed0dbbd1a05cb337a0baebeb4c59de3e7bd5da1'],17,21,38,1534285,2,,,,2623
148c169d46d2cdccc7434e827162552279bc3e4a,0,Andrew Wong,2020-03-05 02:42:09+00:00,['61ddfe31bf8abe95484d4bd83e2ecee0155e7b13'],2,3,5,1534290,1,,,,2623
2ea8478d256b156a9257f5f51ad88a29a36872de,0,Hao Hao,2020-03-05 02:43:43+00:00,['148c169d46d2cdccc7434e827162552279bc3e4a'],102,728,830,1535120,13,0.466292135,1,0.859550562,2630
2d858f66a0ac91a56128e4e2a90b6c81db05df41,0,Grant Henke,2020-03-05 02:55:14+00:00,['2ea8478d256b156a9257f5f51ad88a29a36872de'],18,36,54,1535174,4,0,0,1,2630
e901424abf7d54f9e3060bf3f6c1a5cc0d42874d,0,Grant Henke,2020-03-05 02:55:35+00:00,['2d858f66a0ac91a56128e4e2a90b6c81db05df41'],4,4,8,1535182,2,,,,2630
e13fd4a489bb252ae80f1a2d8dd39991cfdc2a88,0,Andrew Wong,2020-03-05 03:34:19+00:00,['e901424abf7d54f9e3060bf3f6c1a5cc0d42874d'],60,832,892,1536074,13,0.491758242,0.593406593,0.593406593,2633
e37c9f83b0144971b8d081ac1b3ba8e53abff859,0,Hao Hao,2020-03-05 05:13:02+00:00,['e13fd4a489bb252ae80f1a2d8dd39991cfdc2a88'],22,48,70,1536144,3,1,1,0.272727273,2633
0702fc5e099478ceba9e3f6f6b25f2ffae2afc82,0,Andrew Wong,2020-03-05 06:22:23+00:00,['e37c9f83b0144971b8d081ac1b3ba8e53abff859'],91,198,289,1536433,9,0.4375,0.5,1,2635
6f016678cbf8fa32714685cd5166bced87eb28e9,0,Andrew Wong,2020-03-05 22:13:43+00:00,['0702fc5e099478ceba9e3f6f6b25f2ffae2afc82'],48,141,189,1536622,5,0.292682927,0.902439024,1,2635
0d29977c688ffeffb80785fe8966a4ffc3ee6a43,0,Hao Hao,2020-03-06 00:12:20+00:00,['6f016678cbf8fa32714685cd5166bced87eb28e9'],2,317,319,1536941,5,0.536764706,0.551470588,0.389705882,2637
771d36f84ef86c80334b9c322bf0748397cd8dd9,0,Andrew Wong,2020-03-06 02:03:44+00:00,['0d29977c688ffeffb80785fe8966a4ffc3ee6a43'],45,107,152,1537093,7,0.4,1,1,2637
fd4c4771d1a146b75c4648f1807b0e3417c42bf9,0,Adar Dembo,2020-03-06 05:12:18+00:00,['771d36f84ef86c80334b9c322bf0748397cd8dd9'],189,167,356,1537449,29,1,1,0,2637
f4bab12093a527ea6d6ba71cedc6c86ae37db561,0,Adar Dembo,2020-03-08 22:06:07+00:00,['fd4c4771d1a146b75c4648f1807b0e3417c42bf9'],124,105,229,1537678,25,0.333333333,0.333333333,0.333333333,2637
f2ebb30d161df319050170114eb8e54561de91bb,0,Andrew Wong,2020-03-08 22:56:02+00:00,['f4bab12093a527ea6d6ba71cedc6c86ae37db561'],4,6,10,1537688,2,0,1,1,2637
05dd6f8d8c9ea8c10012bc7e90b19beabc74d303,0,Alexey Serbin,2020-03-09 04:08:17+00:00,['f2ebb30d161df319050170114eb8e54561de91bb'],1,9,10,1537698,1,1,1,0,2637
fb0411f1d0810e896f18ebb92f7547e630bb12c0,0,Alexey Serbin,2020-03-09 07:06:19+00:00,['05dd6f8d8c9ea8c10012bc7e90b19beabc74d303'],9,94,103,1537801,4,0.112903226,0.887096774,1,2637
e18f32f46a3c27e269346b47f48c30033f69382f,0,Grant Henke,2020-03-09 19:51:32+00:00,['fb0411f1d0810e896f18ebb92f7547e630bb12c0'],7,11,18,1537819,3,,,,2637
c1b7d76bbe91fa9d024358c2923051fb9df91a5c,0,Grant Henke,2020-03-09 19:51:37+00:00,['e18f32f46a3c27e269346b47f48c30033f69382f'],22,31,53,1537872,3,,,,2637
ef8696ac436776cf52181e9d94afb3c9608c9efa,0,Grant Henke,2020-03-09 19:51:40+00:00,['c1b7d76bbe91fa9d024358c2923051fb9df91a5c'],0,7,7,1537879,1,,,,2637
eaed5fb514e70a837cdd1ef8f39f371fddabc25a,0,Adar Dembo,2020-03-10 06:44:06+00:00,['ef8696ac436776cf52181e9d94afb3c9608c9efa'],818,679,1497,1539376,146,0.8,0.933333333,1,2637
cf555cecc0d0bd86862dd47ad7c9f075192cf000,0,Adar Dembo,2020-03-10 21:40:04+00:00,['eaed5fb514e70a837cdd1ef8f39f371fddabc25a'],52,167,219,1539595,5,0.577464789,0.591549296,0.366197183,2637
885d7946c771ea875919d479c67b2ddac5c5103e,0,Adar Dembo,2020-03-10 21:40:14+00:00,['cf555cecc0d0bd86862dd47ad7c9f075192cf000'],3,134,137,1539732,4,0.38028169,0.676056338,0.661971831,2637
1b3b26d957e2944ff3197eea4ee99dec22640721,0,Adar Dembo,2020-03-10 21:41:34+00:00,['885d7946c771ea875919d479c67b2ddac5c5103e'],8,23,31,1539763,3,0.6,0.8,1,2637
3f14af36507fddddf8ba735af7c7ac56396d1ecb,0,Andrew Wong,2020-03-11 01:28:44+00:00,['1b3b26d957e2944ff3197eea4ee99dec22640721'],2,4,6,1539769,1,1,1,1,2637
39bd47462d7c3d57f7207e9eebd4a8102484f568,0,Andrew Wong,2020-03-11 03:45:25+00:00,['3f14af36507fddddf8ba735af7c7ac56396d1ecb'],1,45,46,1539815,3,0.703703704,0.888888889,1,2637
1cb4a0ae3e253fbab26a9c4664550c9ca473ca98,0,Andrew Wong,2020-03-11 03:45:27+00:00,['39bd47462d7c3d57f7207e9eebd4a8102484f568'],1,1,2,1539817,1,,,,2637
3782dd6d74d558d9d7d9ce37a023ae290a26385c,0,Grant Henke,2020-03-11 16:06:35+00:00,['1cb4a0ae3e253fbab26a9c4664550c9ca473ca98'],1,1,2,1539819,1,,,,2637
0b858e67f0ab3a41789490d00a6ebcebe342798d,0,Grant Henke,2020-03-11 16:12:03+00:00,['3782dd6d74d558d9d7d9ce37a023ae290a26385c'],2,13,15,1539834,1,0,0.555555556,1,2637
d74ad32df7e41f6c9b03edb8b7be27706b507c2c,0,Tim Armstrong,2020-03-11 16:28:26+00:00,['0b858e67f0ab3a41789490d00a6ebcebe342798d'],62,200,262,1540096,6,0.313432836,0.805970149,1,2638
a9afbce14454f9b03b9cc5a699a09f4f9935da58,0,Alexey Serbin,2020-03-11 16:31:02+00:00,['d74ad32df7e41f6c9b03edb8b7be27706b507c2c'],174,582,756,1540852,10,0.311827957,0.401433692,0.759856631,2638
cf54e04db79a71b5fdbd6e04cd55014153c2a2f1,0,Grant Henke,2020-03-11 17:43:08+00:00,['a9afbce14454f9b03b9cc5a699a09f4f9935da58'],3,16,19,1540871,1,,,,2638
2649865b39723407236b15deddee9d15890f9f95,0,Grant Henke,2020-03-11 21:58:21+00:00,['cf54e04db79a71b5fdbd6e04cd55014153c2a2f1'],46,68,114,1540985,13,0.5,0,0,2638
b2daddda9422dacb457b0afcf2e25c4804cb0f54,0,Alexey Serbin,2020-03-12 00:31:32+00:00,['2649865b39723407236b15deddee9d15890f9f95'],6,5,11,1540996,3,,,,2638
9e0d17e0e9f7f2a2aa49c4c533ec5fa93f0443e0,0,Adar Dembo,2020-03-12 22:55:34+00:00,['b2daddda9422dacb457b0afcf2e25c4804cb0f54'],3,1,4,1541000,1,,,,2638
e13315794e911556fc1702247d169c5aa29786c5,1,Adar Dembo,2020-03-12 23:40:30+00:00,['9e0d17e0e9f7f2a2aa49c4c533ec5fa93f0443e0'],360,264,624,1541624,27,0,0,0,2638
5b0fc45d610237983ac860e9ad88fe01424802eb,0,Grant Henke,2020-03-13 00:19:40+00:00,['e13315794e911556fc1702247d169c5aa29786c5'],8,45,53,1541677,2,,,,2638
84eadd637cd890c8b0384f2d88b288dd73b28fd6,0,Grant Henke,2020-03-13 02:23:58+00:00,['5b0fc45d610237983ac860e9ad88fe01424802eb'],8,12,20,1541697,4,0,1,1,2638
1fb586a1899f4de139aa1c1688a2e34895517b93,0,Alexey Serbin,2020-03-13 03:50:19+00:00,['84eadd637cd890c8b0384f2d88b288dd73b28fd6'],1,12,13,1541710,1,,,,2638
de2bf2177926c66001853d3de555a297bafa2bb9,0,Alexey Serbin,2020-03-13 06:50:31+00:00,['1fb586a1899f4de139aa1c1688a2e34895517b93'],1,30,31,1541741,1,0.944444444,1,0.944444444,2638
30c8287d7b1c8790fda0b6acadbb649178c212a3,0,Grant Henke,2020-03-13 13:43:36+00:00,['de2bf2177926c66001853d3de555a297bafa2bb9'],1,1,2,1541743,1,,,,2638
3343144fefaad5a30e95e21297c64c78e308fa1f,0,Alexey Serbin,2020-03-13 15:32:34+00:00,['30c8287d7b1c8790fda0b6acadbb649178c212a3'],21,27,48,1541791,4,0,1,0,2638
84745c30253aee48da4f4a05da1fb187281bf0e6,0,Alexey Serbin,2020-03-13 15:32:40+00:00,['3343144fefaad5a30e95e21297c64c78e308fa1f'],7,0,7,1541798,1,,,,2638
c3453058d87ebf5672ddd9e1b7e333206e4812c7,0,Grant Henke,2020-03-13 19:05:51+00:00,['84745c30253aee48da4f4a05da1fb187281bf0e6'],15,19,34,1541832,8,,,,2638
ffa292c77a85bf7f01352eb3278c48ad5dd0f373,0,Alexey Serbin,2020-03-13 19:15:52+00:00,['c3453058d87ebf5672ddd9e1b7e333206e4812c7'],43,23,66,1541898,2,0.375,0,0.0625,2638
b1fe7d495eebd64685498b741974542275f58b5c,0,Grant Henke,2020-03-13 19:46:26+00:00,['ffa292c77a85bf7f01352eb3278c48ad5dd0f373'],33,493,526,1542424,12,,,,2643
1394746becb905ff460e0fcc615376d967bdc4c1,0,Adar Dembo,2020-03-14 09:20:43+00:00,['b1fe7d495eebd64685498b741974542275f58b5c'],21,39,60,1542484,3,1,1,0,2643
af7595bbff5a1578fc1978a8ec00f9946458c43e,0,Adar Dembo,2020-03-14 09:21:47+00:00,['1394746becb905ff460e0fcc615376d967bdc4c1'],59,54,113,1542597,1,1,0,0,2643
6bf82d40f8799ddc110fc83f479b72a45c3a0c49,0,Adar Dembo,2020-03-14 09:23:18+00:00,['af7595bbff5a1578fc1978a8ec00f9946458c43e'],21,17,38,1542635,1,1,0,0,2643
c4e256198da842a4600afd5111d78e7480d6cdd6,0,Adar Dembo,2020-03-16 09:12:40+00:00,['6bf82d40f8799ddc110fc83f479b72a45c3a0c49'],2,4,6,1542641,1,,,,2643
acabee5514573475aa944492dd763b219a3f0d60,0,Yifan Zhang,2020-03-16 10:34:14+00:00,['c4e256198da842a4600afd5111d78e7480d6cdd6'],0,16,16,1542657,2,0.75,0.75,1,2643
b198692abacd913db0ce64b5961fc05d0fb2951d,0,Alexey Serbin,2020-03-16 21:51:52+00:00,['acabee5514573475aa944492dd763b219a3f0d60'],4,4,8,1542665,2,,,,2643
f374cb650a5b06efbc02c090f67fead21c4a77b3,0,Adar Dembo,2020-03-16 23:05:47+00:00,['b198692abacd913db0ce64b5961fc05d0fb2951d'],2,2,4,1542669,1,,,,2643
d84b743391ce53a0b3d766ab9c6c9bd72b24ca8b,0,Grant Henke,2020-03-16 23:52:43+00:00,['f374cb650a5b06efbc02c090f67fead21c4a77b3'],0,2,2,1542671,1,,,,2643
867bf8b4257da69a6bb67bb36655a3ffdf947806,0,Hao Hao,2020-03-17 01:50:52+00:00,['d84b743391ce53a0b3d766ab9c6c9bd72b24ca8b'],12,4,16,1542687,3,1,1,0,2643
1c60956335675ea0b6ba87a5548cce37634e8306,0,Adar Dembo,2020-03-17 04:06:31+00:00,['867bf8b4257da69a6bb67bb36655a3ffdf947806'],30,100,130,1542817,5,1,0.730769231,0.538461538,2643
2c01b808884098e9fb247010d61ac8e2da48ffbf,0,Adar Dembo,2020-03-17 05:11:24+00:00,['1c60956335675ea0b6ba87a5548cce37634e8306'],97,173,270,1543087,4,1,1,1,2644
5fce4225a3e315bd0c8ad0e2e7fd9b068edef240,0,Hao Hao,2020-03-17 16:13:47+00:00,['2c01b808884098e9fb247010d61ac8e2da48ffbf'],20,101,121,1543208,9,0.239130435,0,1,2644
895e34ec7fa2dc1957f793c04d696a869d932f86,0,Adar Dembo,2020-03-17 17:01:55+00:00,['5fce4225a3e315bd0c8ad0e2e7fd9b068edef240'],1,2,3,1543211,1,,,,2644
6c10c668c28f2127d9000793f41b1cee065efa00,0,Alexey Serbin,2020-03-17 19:58:25+00:00,['895e34ec7fa2dc1957f793c04d696a869d932f86'],4,156,160,1543371,2,0,1,1,2644
33fdea56517463b9c61b51b2618059f5ec8e0fda,0,Grant Henke,2020-03-17 22:16:29+00:00,['6c10c668c28f2127d9000793f41b1cee065efa00'],0,8,8,1543379,2,,,,2644
2bfc1b03c59eae95423faa97d8c7715247e19bc7,0,Hao Hao,2020-03-18 01:47:31+00:00,['33fdea56517463b9c61b51b2618059f5ec8e0fda'],1,28,29,1543408,1,1,1,1,2644
9a0ad9569286dedc3ba699d37f95e96070b548cc,0,Adar Dembo,2020-03-18 06:44:57+00:00,['2bfc1b03c59eae95423faa97d8c7715247e19bc7'],793,619,1412,1544820,48,1,0.858108108,0.081081081,2644
f37e7a6e0a249d32568707bdd2f5305c3663e0b3,0,Adar Dembo,2020-03-18 06:44:59+00:00,['9a0ad9569286dedc3ba699d37f95e96070b548cc'],172,132,304,1545124,28,0,0,1,2644
3bfc9e64f98ac289331c2a1f7011241029d91c1e,0,Andrew Wong,2020-03-18 20:35:59+00:00,['f37e7a6e0a249d32568707bdd2f5305c3663e0b3'],8,8,16,1545140,1,,,,2644
e7e7899e3aad7f6118eee9309b2a45ee8d11aa1c,0,Andrew Wong,2020-03-18 20:36:01+00:00,['3bfc9e64f98ac289331c2a1f7011241029d91c1e'],1,1,2,1545142,1,,,,2644
a626e27e85e2dab780164c5d3bd075a856b11a55,0,Grant Henke,2020-03-18 21:54:40+00:00,['e7e7899e3aad7f6118eee9309b2a45ee8d11aa1c'],4,25,29,1545171,1,,,,2644
7dd10ba35d3db36f25b2920c6aa098eddeacc3e5,0,Adar Dembo,2020-03-19 06:08:42+00:00,['a626e27e85e2dab780164c5d3bd075a856b11a55'],157,131,288,1545459,21,1,1,0,2644
a80d7472110ae2349a82c2150aad61079969b337,0,Alexey Serbin,2020-03-19 15:55:25+00:00,['7dd10ba35d3db36f25b2920c6aa098eddeacc3e5'],10,89,99,1545558,4,0.6,0.7,1,2644
74e0be274da1df2653f7a72175b3e30e0c7a527e,0,Attila Bukor,2020-03-19 16:50:38+00:00,['a80d7472110ae2349a82c2150aad61079969b337'],57,322,379,1545937,5,0.826446281,1,0.628099174,2644
c0e922d24d451fed66e309c954900d7035856c9a,0,Attila Bukor,2020-03-19 16:50:42+00:00,['74e0be274da1df2653f7a72175b3e30e0c7a527e'],0,2,2,1545939,1,,,,2644
332d4bb0bcda04276be1ec25123f204877664966,0,Hao Hao,2020-03-19 18:50:54+00:00,['c0e922d24d451fed66e309c954900d7035856c9a'],22,32,54,1545993,1,0,1,1,2644
0923488fda7ce8d2222fa9ea676a0ece5f1d313b,0,Adar Dembo,2020-03-19 19:03:00+00:00,['332d4bb0bcda04276be1ec25123f204877664966'],11,16,27,1546020,4,,,,2644
802623741e163333e20ad57e059f4ce20701973e,0,Hao Hao,2020-03-19 20:57:27+00:00,['0923488fda7ce8d2222fa9ea676a0ece5f1d313b'],76,113,189,1546209,6,0.857142857,0.892857143,0.857142857,2644
1a21e92057f61bd3b0581ac590a84bc7d7a21ac6,0,Todd Lipcon,2020-03-20 03:52:49+00:00,['802623741e163333e20ad57e059f4ce20701973e'],35,69,104,1546313,4,0,0.37037037,1,2644
fefb433917252ead0c78f7f6c674050514505cba,0,Todd Lipcon,2020-03-20 04:50:42+00:00,['1a21e92057f61bd3b0581ac590a84bc7d7a21ac6'],6,142,148,1546461,2,0.578947368,1,1,2645
9f382f7aefb6a66a6962b0bdc4509f530975c56e,0,Todd Lipcon,2020-03-20 04:53:11+00:00,['fefb433917252ead0c78f7f6c674050514505cba'],1,1,2,1546463,1,,,,2645
60a47781aa05550b7f8ea9d46b6b2a32f754d19f,0,Adar Dembo,2020-03-20 04:59:54+00:00,['9f382f7aefb6a66a6962b0bdc4509f530975c56e'],90,97,187,1546650,84,,,,2645
ca64aa2ed33c90d7a9d2d8552d6f060b596e9c3f,0,Todd Lipcon,2020-03-20 05:41:30+00:00,['60a47781aa05550b7f8ea9d46b6b2a32f754d19f'],12,62,74,1546724,8,1,1,1,2645
a2ee327a88c23c039544a4e82be10ed8f2f51503,0,Alexey Serbin,2020-03-20 06:01:34+00:00,['ca64aa2ed33c90d7a9d2d8552d6f060b596e9c3f'],5,9,14,1546738,2,,,,2645
664d7fec8e603d930e7ca2c8302130103f4fbcac,1,Andrew Wong,2020-03-20 08:02:14+00:00,['a2ee327a88c23c039544a4e82be10ed8f2f51503'],107,1755,1862,1548600,15,0.209026128,0.614014252,0.828978622,2648
9d2ae8b2114f0add8e63c6ccd63ac0b9a49079d6,0,Todd Lipcon,2020-03-20 19:00:58+00:00,['664d7fec8e603d930e7ca2c8302130103f4fbcac'],5,3,8,1548608,1,0,0,0,2648
d3b55212b9fdecc1b66c5f1163e65ec654a7bb77,0,Todd Lipcon,2020-03-20 19:02:02+00:00,['9d2ae8b2114f0add8e63c6ccd63ac0b9a49079d6'],6,11,17,1548625,1,1,1,1,2648
407c93a04bc2914524295c352afd1cfc4afb19e4,0,Alexey Serbin,2020-03-20 22:55:23+00:00,['d3b55212b9fdecc1b66c5f1163e65ec654a7bb77'],0,6,6,1548631,1,,,,2648
4672c7511ef673409548cdaa39ae1ab61416f6f6,0,Alexey Serbin,2020-03-20 23:56:41+00:00,['407c93a04bc2914524295c352afd1cfc4afb19e4'],1,20,21,1548652,1,0,1,1,2648
7dff767a8ebd6ea4d61c78ea84ebaeb85e0f07d4,0,Andrew Wong,2020-03-21 05:07:49+00:00,['4672c7511ef673409548cdaa39ae1ab61416f6f6'],2,5,7,1548659,1,0,1,1,2648
705954872dc86238556456abed0a879bb1462e51,0,Andrew Wong,2020-03-21 05:16:19+00:00,['7dff767a8ebd6ea4d61c78ea84ebaeb85e0f07d4'],110,664,774,1549433,21,0.32208589,0.825153374,0.923312883,2648
f4508ff2ceea073197eb07b85c1c4bd28a9c7b3d,0,Andrew Wong,2020-03-21 05:16:22+00:00,['705954872dc86238556456abed0a879bb1462e51'],39,76,115,1549548,9,0.576923077,1,0.576923077,2648
58f7a3015c967e7590e91d729cea5327d253d74d,0,Andrew Wong,2020-03-21 05:16:24+00:00,['f4508ff2ceea073197eb07b85c1c4bd28a9c7b3d'],85,147,232,1549780,16,0.441860465,1,0.837209302,2648
84d23679905f6953a976f2baedcc1cb18c641cfc,0,Hao Hao,2020-03-22 22:15:05+00:00,['58f7a3015c967e7590e91d729cea5327d253d74d'],10,48,58,1549838,4,0.769230769,1,0.692307692,2648
647a3d2f18576ca4f17c0a80f10590ca0187e6b6,0,Alexey Serbin,2020-03-23 03:33:39+00:00,['84d23679905f6953a976f2baedcc1cb18c641cfc'],3,2,5,1549843,2,1,0,0,2648
22c5402b0f0b9957e307a7ad032ab118b2399c49,0,Attila Bukor,2020-03-23 22:01:23+00:00,['647a3d2f18576ca4f17c0a80f10590ca0187e6b6'],7,468,475,1550318,19,0.830985915,0.943661972,1,2652
29ee2ed14b5578e915d288cd07d32c5f42486366,0,Todd Lipcon,2020-03-23 22:09:11+00:00,['22c5402b0f0b9957e307a7ad032ab118b2399c49'],0,12,12,1550330,2,0.333333333,0.666666667,1,2652
ee86f568cb405f8636ae56f3b69f8009f8f481da,0,Alexey Serbin,2020-03-23 22:46:29+00:00,['29ee2ed14b5578e915d288cd07d32c5f42486366'],2,7,9,1550339,1,0,0,1,2652
a33b0951d91ecb0b84871bbf9d4b4b3550196af5,0,Grant Henke,2020-03-24 13:42:50+00:00,['ee86f568cb405f8636ae56f3b69f8009f8f481da'],1,21,22,1550361,2,0.571428571,0.571428571,0.571428571,2652
8ba5f3e0e8c6157bf6b731f01b0c71549192d2e6,0,Grant Henke,2020-03-24 15:10:54+00:00,['a33b0951d91ecb0b84871bbf9d4b4b3550196af5'],3,23,26,1550387,2,,,,2652
e4596ae406c2d0fb621d0e4b8e002c4c600ef291,0,Grant Henke,2020-03-24 15:11:02+00:00,['8ba5f3e0e8c6157bf6b731f01b0c71549192d2e6'],5,257,262,1550649,5,,,,2653
5b290cd4439d19ad8e5773cf69f7b994adc1f2e9,0,Adar Dembo,2020-03-24 17:25:34+00:00,['e4596ae406c2d0fb621d0e4b8e002c4c600ef291'],75,134,209,1550858,2,0,0,0,2653
6dd3fc104198ced9849711c1ed4c860eff75f3bd,0,Adar Dembo,2020-03-24 17:29:11+00:00,['5b290cd4439d19ad8e5773cf69f7b994adc1f2e9'],1,153,154,1551012,2,,,,2654
ffef96b26c0c72b458b3be2c26437d1f95ecaf8f,0,Todd Lipcon,2020-03-24 20:05:52+00:00,['6dd3fc104198ced9849711c1ed4c860eff75f3bd'],87,92,179,1551191,20,1,1,1,2654
c8daf9a6cdc2fd002b82d3e01a2f58ff714f30d6,0,Andrew Wong,2020-03-24 21:31:51+00:00,['ffef96b26c0c72b458b3be2c26437d1f95ecaf8f'],0,25,25,1551216,5,0.533333333,0.533333333,1,2654
9945954a3f329a808d39bddad4c816de064f8f75,0,Todd Lipcon,2020-03-25 03:27:36+00:00,['c8daf9a6cdc2fd002b82d3e01a2f58ff714f30d6'],2,30,32,1551248,4,0,0.933333333,1,2654
a4b28812f43e6b8a85e1d61b48a2dbba70d56d1b,0,Todd Lipcon,2020-03-25 03:27:45+00:00,['9945954a3f329a808d39bddad4c816de064f8f75'],74,104,178,1551426,11,1,0.866666667,1,2654
d42c1439390bbf99a74e8ec046539bbd730e146c,0,Adar Dembo,2020-03-25 04:45:22+00:00,['a4b28812f43e6b8a85e1d61b48a2dbba70d56d1b'],2,8,10,1551436,2,,,,2654
3ae02a92ccb99aa1a6b0c3d05deea75756aaa6e3,0,Todd Lipcon,2020-03-25 17:34:44+00:00,['d42c1439390bbf99a74e8ec046539bbd730e146c'],68,90,158,1551594,7,1,0,0,2654
11d6686432b7ce980310447f4b8e44150d3f6f93,0,Adar Dembo,2020-03-25 20:07:08+00:00,['3ae02a92ccb99aa1a6b0c3d05deea75756aaa6e3'],1,15,16,1551610,1,0,1,1,2654
2612fc77bb4be1da0fba090e004217821e116a49,0,Adar Dembo,2020-03-25 20:07:48+00:00,['11d6686432b7ce980310447f4b8e44150d3f6f93'],2,30,32,1551642,1,0,1,1,2654
c0cb960bd39fcbf573247596e81acf5068b924db,0,Adar Dembo,2020-03-25 20:12:22+00:00,['2612fc77bb4be1da0fba090e004217821e116a49'],1,1,2,1551644,1,,,,2654
b417479266ef0f09570d4536738ca18cf48d7ff2,0,Andrew Wong,2020-03-25 21:41:08+00:00,['c0cb960bd39fcbf573247596e81acf5068b924db'],31,1779,1810,1553454,27,0.353293413,0.775449102,0.871257485,2660
0a46332b2129cb256cf9d55c091643d96267724f,0,Alexey Serbin,2020-03-26 20:53:38+00:00,['b417479266ef0f09570d4536738ca18cf48d7ff2'],946,1801,2747,1556201,4,0.711229947,1,0.203208556,2660
0ba6cb8d6b38a992786e5027528349a43802fd31,0,Todd Lipcon,2020-03-27 04:11:33+00:00,['0a46332b2129cb256cf9d55c091643d96267724f'],1,842,843,1557044,7,0.687306502,1,0.659442724,2665
4fb09d686a4a06fd30ee9787b8b65de559893531,0,Todd Lipcon,2020-03-27 04:14:44+00:00,['0ba6cb8d6b38a992786e5027528349a43802fd31'],33,89,122,1557166,4,1,1,1,2665
557f0703e0a98d3d38b00f9416bfbcbc742478c1,0,Grant Henke,2020-03-27 14:18:59+00:00,['4fb09d686a4a06fd30ee9787b8b65de559893531'],0,300,300,1557466,7,1,1,1,2672
458e6ced2f7c092c403d5d6ef3502fe94d0d98cc,0,Adar Dembo,2020-03-27 20:01:14+00:00,['557f0703e0a98d3d38b00f9416bfbcbc742478c1'],45,283,328,1557794,8,0.041666667,0.791666667,0.958333333,2675
092cecc26b8725a532a53a4bf50a5e6d19c769c2,0,Adar Dembo,2020-03-27 20:01:16+00:00,['458e6ced2f7c092c403d5d6ef3502fe94d0d98cc'],329,623,952,1558746,324,,,,2676
7ec2a0f7f0a9fc4147ac482b41b7ee26b924a2e6,0,Hao Hao,2020-03-27 20:40:23+00:00,['092cecc26b8725a532a53a4bf50a5e6d19c769c2'],2,10,12,1558758,1,,,,2676
5ce3a022f99ee3f99e086292487e390e3334d247,0,Adar Dembo,2020-03-28 06:22:18+00:00,['7ec2a0f7f0a9fc4147ac482b41b7ee26b924a2e6'],4,9,13,1558771,1,0,1,1,2676
be2d7c5882a9f4842e6387c4c4cef50b2e4bae75,0,Adar Dembo,2020-03-28 06:32:16+00:00,['5ce3a022f99ee3f99e086292487e390e3334d247'],161,133,294,1559065,30,0.2,1,0.6,2676
daced7ec446ea8e7e1a8eeebe21e08ee038f285a,0,Adar Dembo,2020-03-28 08:13:18+00:00,['be2d7c5882a9f4842e6387c4c4cef50b2e4bae75'],89,74,163,1559228,4,1,1,0,2676
4e24702ed349d3041c83888ed9262496518d79a6,0,Alexey Serbin,2020-03-29 21:51:56+00:00,['daced7ec446ea8e7e1a8eeebe21e08ee038f285a'],4,13,17,1559245,1,,,,2676
b9faf6c23ac1499bddf7b32b6433268d12df642b,0,Hao Hao,2020-03-30 06:28:41+00:00,['4e24702ed349d3041c83888ed9262496518d79a6'],20,32,52,1559297,3,,,,2676
5660d9583e88c4ece2c73efc2cfcb51bd3d22523,0,Hao Hao,2020-03-30 17:31:30+00:00,['b9faf6c23ac1499bddf7b32b6433268d12df642b'],1,8,9,1559306,2,1,1,1,2676
697301fb076e9649e7f8eb4556c91e59ab9b185f,0,Andrew Wong,2020-03-30 18:52:50+00:00,['5660d9583e88c4ece2c73efc2cfcb51bd3d22523'],46,221,267,1559573,13,0,0.755102041,0.530612245,2676
5cd26cfad9a5796080d1242fff2090c05eaa1f4a,0,Andrew Wong,2020-03-30 18:52:57+00:00,['697301fb076e9649e7f8eb4556c91e59ab9b185f'],21,132,153,1559726,3,0.672131148,1,0.852459016,2676
08464561d95651470957ddeceb94a1ad3170df3d,0,Adar Dembo,2020-03-30 18:55:56+00:00,['5cd26cfad9a5796080d1242fff2090c05eaa1f4a'],38,50,88,1559814,8,0.80952381,1,0.857142857,2676
5db82975fd9729d90551b7a4c8f4b28b5375deef,0,Adar Dembo,2020-03-30 18:56:00+00:00,['08464561d95651470957ddeceb94a1ad3170df3d'],54,33,87,1559901,8,,,,2676
8d92905a472e5b010d8f1bdfbe1770fd564ce082,0,Adar Dembo,2020-03-30 18:56:03+00:00,['5db82975fd9729d90551b7a4c8f4b28b5375deef'],17,15,32,1559933,3,1,1,1,2676
56ec81e06dd7e25f5513521256085d40309446b0,0,Adar Dembo,2020-03-30 18:56:05+00:00,['8d92905a472e5b010d8f1bdfbe1770fd564ce082'],20,18,38,1559971,6,1,1,1,2676
ea9243a10cfa7d67547d3e1996af35b0455d1e97,0,Adar Dembo,2020-03-30 18:56:07+00:00,['56ec81e06dd7e25f5513521256085d40309446b0'],42,48,90,1560061,7,0,0.833333333,1,2676
c497253f0d95313dc6ea5d3a6dbf64ef0787115b,0,Adar Dembo,2020-03-30 18:56:09+00:00,['ea9243a10cfa7d67547d3e1996af35b0455d1e97'],23,24,47,1560108,2,1,1,1,2676
676a765f2f8744bd7273b7358ab3a8b22c148edb,0,Adar Dembo,2020-03-30 18:56:13+00:00,['c497253f0d95313dc6ea5d3a6dbf64ef0787115b'],32,33,65,1560173,4,0,0.2,0.6,2676
8d1b6e191011a7eb6aa52930e2f2f59dc80e3c44,1,Adar Dembo,2020-03-30 20:16:14+00:00,['676a765f2f8744bd7273b7358ab3a8b22c148edb'],61,37,98,1560271,16,0,1,1,2676
1d28104cac0866c83b3022e3ddf3b7237962c1da,0,Todd Lipcon,2020-03-30 20:47:29+00:00,['8d1b6e191011a7eb6aa52930e2f2f59dc80e3c44'],116,510,626,1560897,5,0.084033613,0.403361345,0.571428571,2676
1de208dcf19468bbf3f7a67818006ea7a98c1889,0,Alexey Serbin,2020-03-30 23:03:39+00:00,['1d28104cac0866c83b3022e3ddf3b7237962c1da'],2,3,5,1560902,1,,,,2676
270746e845317ed2d0a53acec94a1877798e9d88,0,Adar Dembo,2020-03-31 05:23:51+00:00,['1de208dcf19468bbf3f7a67818006ea7a98c1889'],14,79,93,1560995,4,0.666666667,0.666666667,1,2676
56ee4225a304763cc6f5949e0b5497402860d614,0,Adar Dembo,2020-03-31 05:24:07+00:00,['270746e845317ed2d0a53acec94a1877798e9d88'],6047,12,6059,1567054,16,0.553287982,0.100907029,0.571428571,2676
37bda7be50f5b0e280612c3dfa0cf10bd8cb6dcf,0,Adar Dembo,2020-03-31 05:24:10+00:00,['56ee4225a304763cc6f5949e0b5497402860d614'],54,53,107,1567161,27,1,1,0,2676
ce82af1171099e00606c67a351362a0b68549141,0,Adar Dembo,2020-03-31 05:24:12+00:00,['37bda7be50f5b0e280612c3dfa0cf10bd8cb6dcf'],1,5,6,1567167,1,0,1,1,2676
263c3aa894c087691ef2c4463d46a52a94f12c2b,0,Adar Dembo,2020-03-31 05:24:14+00:00,['ce82af1171099e00606c67a351362a0b68549141'],5,12,17,1567184,1,0,1,1,2676
03d79bdfda04a07fb7c820b1843ff069cb54e7a1,0,Adar Dembo,2020-03-31 05:26:52+00:00,['263c3aa894c087691ef2c4463d46a52a94f12c2b'],0,1,1,1567185,1,,,,2676
d16e7e149d941addb20064148ec4853e5b002fc8,0,Alexey Serbin,2020-03-31 07:50:52+00:00,['03d79bdfda04a07fb7c820b1843ff069cb54e7a1'],4,49,53,1567238,4,,,,2678
00e7ca6437876e9ac95abfa96eaa7b86a785aa5c,0,Todd Lipcon,2020-03-31 20:22:36+00:00,['d16e7e149d941addb20064148ec4853e5b002fc8'],72,298,370,1567608,5,0.488888889,0.97037037,1,2678
abd29cc98af31d57251f19de1b68037afce2aff1,0,Hao Hao,2020-04-01 00:19:36+00:00,['00e7ca6437876e9ac95abfa96eaa7b86a785aa5c'],21,14,35,1567643,4,1,1,0.833333333,2678
fa2d4c756646b3f8428d2931113e8dfc3bc5af79,0,Todd Lipcon,2020-04-01 20:26:35+00:00,['abd29cc98af31d57251f19de1b68037afce2aff1'],23,421,444,1568087,9,0.315068493,0.712328767,0.801369863,2680
e6fa761a4a60118bb61883fe8342943253f350d2,0,Grant Henke,2020-04-02 00:11:10+00:00,['fa2d4c756646b3f8428d2931113e8dfc3bc5af79'],2,22,24,1568111,2,,,,2681
f155ae4732b06064b37871fca7fa30b645145f0c,0,Alexey Serbin,2020-04-02 14:31:04+00:00,['e6fa761a4a60118bb61883fe8342943253f350d2'],6,6,12,1568123,2,,,,2681
897eb377ce91a19614626ac177f4315c5c5dac69,0,Attila Bukor,2020-04-02 21:53:21+00:00,['f155ae4732b06064b37871fca7fa30b645145f0c'],139,429,568,1568691,12,0.097664544,0.942675159,0.630573248,2681
fc3db8fef17c600ea5cbe14f6f1fc2fe61a4063d,0,Attila Bukor,2020-04-02 21:53:26+00:00,['897eb377ce91a19614626ac177f4315c5c5dac69'],31,51,82,1568773,10,0.666666667,1,1,2681
73934d2bbfa476261845e2817cc65b38f7cfc832,0,Attila Bukor,2020-04-02 21:53:30+00:00,['fc3db8fef17c600ea5cbe14f6f1fc2fe61a4063d'],3,28,31,1568804,2,0,1,1,2681
243878d41a12c2b29a29c34c7c5f153610612a6f,0,Attila Bukor,2020-04-02 21:53:36+00:00,['73934d2bbfa476261845e2817cc65b38f7cfc832'],1,12,13,1568817,2,0,1,0,2681
447b45dce77019e0738cf3d13f022b2be6a48cb7,0,Grant Henke,2020-04-03 18:02:57+00:00,['243878d41a12c2b29a29c34c7c5f153610612a6f'],2,2,4,1568821,2,,,,2681
5739add189361ddf0607df84c258c542159719e8,0,Adar Dembo,2020-04-04 00:47:08+00:00,['447b45dce77019e0738cf3d13f022b2be6a48cb7'],556,528,1084,1569905,57,0.211538462,1,0.923076923,2681
882ae5861ef5de451b39568547f7c77b6909ec05,0,Adar Dembo,2020-04-04 01:22:13+00:00,['5739add189361ddf0607df84c258c542159719e8'],1,1,2,1569907,1,,,,2681
c0a9fdc7384ac24258411949303ae1881358c3f3,0,Andrew Wong,2020-04-04 20:21:09+00:00,['882ae5861ef5de451b39568547f7c77b6909ec05'],65,374,439,1570346,9,0.279069767,1,0.519379845,2682
e37b3401d008f98a159187b46cc2f1b650152db1,0,Andrew Wong,2020-04-04 20:21:48+00:00,['c0a9fdc7384ac24258411949303ae1881358c3f3'],10,16,26,1570372,1,,,,2682
0bc19d2df62efe60ecb7bd7bd5e63cc210a17550,0,Adar Dembo,2020-04-04 22:16:57+00:00,['e37b3401d008f98a159187b46cc2f1b650152db1'],0,1,1,1570373,1,0,1,1,2682
b08fb2615ba58024b60fb177c2cc311ba96f189f,0,Andrew Wong,2020-04-06 06:58:16+00:00,['0bc19d2df62efe60ecb7bd7bd5e63cc210a17550'],31,132,163,1570536,2,0.015384615,0.2,0.769230769,2682
e524334ff04253f38eda7ab3bc589ce76c0934ae,0,Todd Lipcon,2020-04-06 16:37:03+00:00,['b08fb2615ba58024b60fb177c2cc311ba96f189f'],3,19,22,1570558,1,0,1,1,2682
f89a0ced376019a27bcdee58fb2874bf4854406b,0,Hao Hao,2020-04-06 17:30:42+00:00,['e524334ff04253f38eda7ab3bc589ce76c0934ae'],3,0,3,1570561,1,,,,2682
aef3d4291b0051184249d03bd3ee828ec7739189,0,Todd Lipcon,2020-04-06 18:19:28+00:00,['f89a0ced376019a27bcdee58fb2874bf4854406b'],9,93,102,1570663,1,0,1,0,2682
5432d316a1c0e012b247b0c83ce86a481a4597dc,0,Grant Henke,2020-04-06 19:06:20+00:00,['aef3d4291b0051184249d03bd3ee828ec7739189'],33,37,70,1570733,3,1,1,1,2682
5bc210ba7d1243f31c2fa211faefad707f9d286d,0,Alexey Serbin,2020-04-06 22:53:24+00:00,['5432d316a1c0e012b247b0c83ce86a481a4597dc'],2,3,5,1570738,1,0,1,1,2682
53fb9459599fa55cbc095fd37202e93e1f279018,0,Grant Henke,2020-04-06 22:54:22+00:00,['5bc210ba7d1243f31c2fa211faefad707f9d286d'],0,2,2,1570740,1,,,,2682
63776bcabf5f22f305e429620941a2958f6087d5,0,Alexey Serbin,2020-04-07 01:17:37+00:00,['53fb9459599fa55cbc095fd37202e93e1f279018'],4,23,27,1570767,3,1,1,1,2682
80fb9a8da031c2768a3bd7afbcf652a271a1759d,0,Grant Henke,2020-04-07 13:17:46+00:00,['63776bcabf5f22f305e429620941a2958f6087d5'],11,113,124,1570891,9,0.9,0.966666667,1,2682
ffa33473bb0c459ec35cbc68e1ea578938b0bd6b,0,Todd Lipcon,2020-04-07 16:57:33+00:00,['80fb9a8da031c2768a3bd7afbcf652a271a1759d'],1,8,9,1570900,1,0,1,1,2682
cd65d50a464dba0aef0738f02cf4b08378099fb9,0,Hao Hao,2020-04-07 18:15:16+00:00,['ffa33473bb0c459ec35cbc68e1ea578938b0bd6b'],12,15,27,1570927,1,,,,2682
96259c889a73516c021adf1051627c2946be05bb,0,Andrew Wong,2020-04-07 18:52:49+00:00,['cd65d50a464dba0aef0738f02cf4b08378099fb9'],10,13,23,1570950,1,0.333333333,1,1,2682
36a21d6ee4de8828417d7884cf87cd5e2ba15a21,0,Todd Lipcon,2020-04-07 22:17:39+00:00,['96259c889a73516c021adf1051627c2946be05bb'],118,253,371,1571321,12,0.158415842,0.742574257,0.118811881,2682
b386b71b6733bae903f6a051376b49a727e8b3bb,0,Grant Henke,2020-04-08 00:43:12+00:00,['36a21d6ee4de8828417d7884cf87cd5e2ba15a21'],2,5,7,1571328,1,0,1,0,2682
4c2ec0b4d90d368ff775c5114580ca69fbeea5ae,0,Hao Hao,2020-04-08 04:25:38+00:00,['b386b71b6733bae903f6a051376b49a727e8b3bb'],29,29,58,1571386,2,,,,2682
40e4d4f52168690cfbeaeaccc8537558f29f28d2,0,Andrew Wong,2020-04-09 01:21:40+00:00,['4c2ec0b4d90d368ff775c5114580ca69fbeea5ae'],107,115,222,1571608,14,1,1,1,2682
972edb9332dde7cc6fba542343c7a7434ef6cbff,0,Andrew Wong,2020-04-09 04:02:19+00:00,['40e4d4f52168690cfbeaeaccc8537558f29f28d2'],34,158,192,1571800,4,1,1,0.657534247,2682
3e0e81906ad654131fb3faf141e726e3630e3898,0,Grant Henke,2020-04-09 17:35:07+00:00,['972edb9332dde7cc6fba542343c7a7434ef6cbff'],6,28,34,1571834,3,,,,2682
2d18e8dfa49d81431e670a807425e3a7ad37502a,0,Andrew Wong,2020-04-09 22:11:19+00:00,['3e0e81906ad654131fb3faf141e726e3630e3898'],320,270,590,1572424,5,0.727272727,0,0,2682
14912a1fd78ba7cf4d62bf934ae64d6f6f229ee6,0,Alexey Serbin,2020-04-10 01:03:45+00:00,['2d18e8dfa49d81431e670a807425e3a7ad37502a'],7,11,18,1572442,1,0,0,1,2682
e7044a5cbe1d1f9d36204279c73901d37451a570,0,Attila Bukor,2020-04-10 18:18:34+00:00,['14912a1fd78ba7cf4d62bf934ae64d6f6f229ee6'],166,219,385,1572827,4,0,1,1,2682
dacb8203f05ca2d873d524501214bfe5144ac9bb,0,Attila Bukor,2020-04-10 18:18:41+00:00,['e7044a5cbe1d1f9d36204279c73901d37451a570'],469,1047,1516,1574343,9,0.970899471,0.962962963,0.693121693,2682
e6c742ec72d5da84554f1ab5f0e5c5603ab6307b,0,Andrew Wong,2020-04-13 07:13:10+00:00,['dacb8203f05ca2d873d524501214bfe5144ac9bb'],92,247,339,1574682,2,0.9375,0.916666667,0.645833333,2682
8528ac70245efb6d7fec2d18dfa17e45b80421a9,0,Alexey Serbin,2020-04-13 19:51:09+00:00,['e6c742ec72d5da84554f1ab5f0e5c5603ab6307b'],94,53,147,1574829,24,1,0.341463415,0.12195122,2682
b2e4d952b6134a47db383fa2a0a88ac47cbaecc1,0,Alexey Serbin,2020-04-13 19:51:15+00:00,['8528ac70245efb6d7fec2d18dfa17e45b80421a9'],20,24,44,1574873,5,1,1,0,2682
57a4ea30931dc140c3cff25623cd0bd664122321,0,Todd Lipcon,2020-04-14 15:32:29+00:00,['b2e4d952b6134a47db383fa2a0a88ac47cbaecc1'],13,42,55,1574928,3,0.2,1,1,2682
79079b6b64295b06c5a0f05ed200a55d89bccc47,1,Todd Lipcon,2020-04-14 22:18:11+00:00,['57a4ea30931dc140c3cff25623cd0bd664122321'],84,216,300,1575228,13,1,0.985714286,0.971428571,2682
499001a0251fc2cf5355b9bea10717704760dad3,0,Hao Hao,2020-04-14 22:37:31+00:00,['79079b6b64295b06c5a0f05ed200a55d89bccc47'],0,1,1,1575229,1,,,,2682
b4559dbf6d55a7506982e218af069e94cf05237e,0,Alexey Serbin,2020-04-15 04:39:20+00:00,['499001a0251fc2cf5355b9bea10717704760dad3'],8,10,18,1575247,1,0,1,1,2682
fbde23718211f9912067d33fd09b4177263263a1,1,Todd Lipcon,2020-04-15 22:10:42+00:00,['b4559dbf6d55a7506982e218af069e94cf05237e'],263,575,838,1576085,25,0.461928934,0.604060914,0.959390863,2682
c7c4d47ecca0ea0d90435dac736d22f4063d5507,0,Todd Lipcon,2020-04-15 23:59:50+00:00,['fbde23718211f9912067d33fd09b4177263263a1'],79,112,191,1576276,4,1,1,1,2682
adf5d9f5e847b4aadb82c540c98ac9ac707bfa1c,0,Todd Lipcon,2020-04-15 23:59:57+00:00,['c7c4d47ecca0ea0d90435dac736d22f4063d5507'],11,25,36,1576312,4,0.571428571,0.857142857,0,2682
cd95fef01d19674a8c43784bc4f3cd0ef1f4b5ac,0,Hao Hao,2020-04-16 00:46:34+00:00,['adf5d9f5e847b4aadb82c540c98ac9ac707bfa1c'],1,4,5,1576317,1,,,,2682
be68ce81beeb708edfc0545695e72282506f3845,0,Todd Lipcon,2020-04-16 09:50:24+00:00,['cd95fef01d19674a8c43784bc4f3cd0ef1f4b5ac'],9,163,172,1576489,15,0.532467532,0,0.922077922,2682
459bd355c0dc678267f229d09f1fd863cafac3b1,0,Andrew Wong,2020-04-16 21:15:30+00:00,['be68ce81beeb708edfc0545695e72282506f3845'],111,42,153,1576642,1,0,0,0,2682
163cd256ae7ef8ef0d05c8595de5ebf7ae558cf7,0,Todd Lipcon,2020-04-16 22:07:07+00:00,['459bd355c0dc678267f229d09f1fd863cafac3b1'],131,276,407,1577049,5,0.436781609,0.482758621,0.942528736,2682
faae74ce4af6b0c30a7ebd4ff81233576b20162e,0,Alexey Serbin,2020-04-17 19:46:20+00:00,['163cd256ae7ef8ef0d05c8595de5ebf7ae558cf7'],0,16,16,1577065,2,0.769230769,0.769230769,0.769230769,2682
2800155f6a61c11f3493ccd472eebc626c4dc56c,0,Andrew Wong,2020-04-17 22:23:05+00:00,['faae74ce4af6b0c30a7ebd4ff81233576b20162e'],20,54,74,1577139,1,0,0.321428571,1,2682
27288e243b8f51b7dd5f76729b57d825a753ae3b,0,Grant Henke,2020-04-19 13:10:37+00:00,['2800155f6a61c11f3493ccd472eebc626c4dc56c'],1,1,2,1577141,1,,,,2682
9ec5727c7a6411c1a2799445d5a08074907ff5cb,0,Alexey Serbin,2020-04-20 14:57:16+00:00,['27288e243b8f51b7dd5f76729b57d825a753ae3b'],0,67,67,1577208,1,,,,2682
386cc74c1a15d10e85989b67e92cfe3d6b134f44,0,Grant Henke,2020-04-21 13:33:20+00:00,['9ec5727c7a6411c1a2799445d5a08074907ff5cb'],10,29,39,1577247,1,,,,2682
98b1c5d843d4df306373a6aad4885658e07719f1,0,Grant Henke,2020-04-21 14:54:30+00:00,['386cc74c1a15d10e85989b67e92cfe3d6b134f44'],33,77,110,1577357,2,,,,2682
d7a3cddd217d0de513483b3a9f911d83e1eeb5d2,0,Grant Henke,2020-04-21 18:43:23+00:00,['98b1c5d843d4df306373a6aad4885658e07719f1'],0,5,5,1577362,1,0,1,1,2682
3ff21bbd3bea76422d888866fbaa327f23188eae,0,Alexey Serbin,2020-04-21 18:45:54+00:00,['d7a3cddd217d0de513483b3a9f911d83e1eeb5d2'],0,5,5,1577367,1,,,,2682
ec3e5307590cdd69172b20a5304dc316e95a70ff,0,Alexey Serbin,2020-04-21 20:14:51+00:00,['3ff21bbd3bea76422d888866fbaa327f23188eae'],2,10,12,1577379,1,1,1,1,2682
2fdda9904aab082207e12325424dd52c5ad7c616,0,Alexey Serbin,2020-04-22 15:14:08+00:00,['ec3e5307590cdd69172b20a5304dc316e95a70ff'],1,5,6,1577385,1,1,1,1,2682
5b12fa9039d5e5c9c8985bff5927aa88537c924e,0,Alexey Serbin,2020-04-22 15:44:16+00:00,['2fdda9904aab082207e12325424dd52c5ad7c616'],0,2,2,1577387,1,,,,2682
9c5d8c97915376de4fb6027a3f73d00e160fd1d7,0,Todd Lipcon,2020-04-23 05:34:19+00:00,['5b12fa9039d5e5c9c8985bff5927aa88537c924e'],2,2,4,1577391,1,,,,2682
b0d5852591b2452cd12b46ab4070752014b2e954,0,Hao Hao,2020-04-23 17:47:24+00:00,['9c5d8c97915376de4fb6027a3f73d00e160fd1d7'],7,10,17,1577408,1,0,1,1,2682
1bdfbac5737411ee2de5a557eb198eaa12cf4873,0,Todd Lipcon,2020-04-23 20:35:37+00:00,['b0d5852591b2452cd12b46ab4070752014b2e954'],3,3,6,1577414,1,,,,2682
411c63f82805b442a1e14fe21cf5c438472578b2,0,Alexey Serbin,2020-04-23 23:07:40+00:00,['1bdfbac5737411ee2de5a557eb198eaa12cf4873'],2,1,3,1577417,1,,,,2682
1d1a85804b8ce132021661a8fdb053141c2781c2,0,Andrew Wong,2020-04-24 04:56:16+00:00,['411c63f82805b442a1e14fe21cf5c438472578b2'],3,33,36,1577453,1,0,0,1,2682
389d4f1e1c78bf3ddffade99eddd30f07ed982bd,0,Bankim Bhavsar,2020-04-24 18:57:25+00:00,['1d1a85804b8ce132021661a8fdb053141c2781c2'],45,37,82,1577535,3,0,,0,2682
8d4853f1525fb189a9ca232544ffd01ac2a39c57,0,Alexey Serbin,2020-04-25 15:04:38+00:00,['389d4f1e1c78bf3ddffade99eddd30f07ed982bd'],38,69,107,1577642,4,0,0.5,0.9,2682
cc0ee37b6b82918897bb2ed4786c32aeda1711ee,0,Grant Henke,2020-04-26 20:54:48+00:00,['8d4853f1525fb189a9ca232544ffd01ac2a39c57'],2,2,4,1577646,1,,,,2682
ae4b71548726314a0bc0a5258de454d1a65d08a3,0,Grant Henke,2020-04-27 00:43:11+00:00,['cc0ee37b6b82918897bb2ed4786c32aeda1711ee'],1,5,6,1577652,2,,,,2682
c5fd2e44245502c3c7f8dd0f2cd7639815fef0aa,0,Bankim Bhavsar,2020-04-27 23:08:54+00:00,['ae4b71548726314a0bc0a5258de454d1a65d08a3'],2,25,27,1577679,2,,,,2683
38832f17633b186952a677d2653504a7333ef31b,0,Grant Henke,2020-05-01 20:56:56+00:00,['c5fd2e44245502c3c7f8dd0f2cd7639815fef0aa'],1,1,2,1577681,1,,,,2683
92e95657b49d7d0a54590f2ddea3cea2cf1ac91f,0,Andrew Wong,2020-05-07 04:46:31+00:00,['38832f17633b186952a677d2653504a7333ef31b'],110,184,294,1577975,2,0.014492754,0.971014493,0.898550725,2683
fda493d3038661ab2bfcd9d54ff67eef0de9fa9d,0,Alexey Serbin,2020-05-07 15:08:14+00:00,['92e95657b49d7d0a54590f2ddea3cea2cf1ac91f'],2,161,163,1578138,1,0.066666667,0.066666667,1,2683
1ab6d50a891aa2efdb39d74af2ffe6f478c8b013,0,Grant Henke,2020-05-08 14:02:46+00:00,['fda493d3038661ab2bfcd9d54ff67eef0de9fa9d'],7648,70,7718,1585856,60,0.749413146,0.296068075,0.190140845,2683
d641d5dc596d9afc283554ac438033d686c77756,0,Grant Henke,2020-05-08 14:02:49+00:00,['1ab6d50a891aa2efdb39d74af2ffe6f478c8b013'],97,810,907,1586763,5,,,,2683
b53d088d9ad22491ee638a815e7b22e550c4b56f,0,Alexey Serbin,2020-05-08 21:02:08+00:00,['d641d5dc596d9afc283554ac438033d686c77756'],2,4,6,1586769,1,1,1,1,2683
0fc95d621a5a6a1ee2efd9d58bd331c68a765b40,0,Grant Henke,2020-05-11 15:42:51+00:00,['b53d088d9ad22491ee638a815e7b22e550c4b56f'],9,9,18,1586787,2,,,,2683
ade1b3c3848592cb702fb5f83f2a7fdb0f97b777,0,Alexey Serbin,2020-05-11 18:33:39+00:00,['0fc95d621a5a6a1ee2efd9d58bd331c68a765b40'],0,1,1,1586788,1,,,,2683
74459bd1b3ba311360a8b832873d9e3273dfc83a,0,Alexey Serbin,2020-05-11 19:03:04+00:00,['ade1b3c3848592cb702fb5f83f2a7fdb0f97b777'],0,3289,3289,1590077,2,0.865622424,1,0.926628195,2684
425449ff2afd60b21e8c39028276b7370591f650,0,Alexey Serbin,2020-05-11 19:22:22+00:00,['74459bd1b3ba311360a8b832873d9e3273dfc83a'],0,358,358,1590435,2,0.540322581,1,0.709677419,2685
25408b18c4836ae01fd7fa2b649facec2492d931,0,Alexey Serbin,2020-05-11 21:37:53+00:00,['425449ff2afd60b21e8c39028276b7370591f650'],1,28,29,1590464,1,0,0,1,2685
eae52ea669aa63f440d9e452fd01caed3f85330a,0,Andrew Wong,2020-05-13 00:42:14+00:00,['25408b18c4836ae01fd7fa2b649facec2492d931'],2025,2006,4031,1594495,86,0.5,0.5,0.5,2685
589620257b82fbb9c20fe6d6dfa7f5a97e6c06ae,0,Alexey Serbin,2020-05-13 03:00:34+00:00,['eae52ea669aa63f440d9e452fd01caed3f85330a'],18,208,226,1594721,1,0.22556391,0.609022556,1,2685
3286c7856931e204ee90ccee62c37bbedda8b665,0,Andrew Wong,2020-05-13 03:29:05+00:00,['589620257b82fbb9c20fe6d6dfa7f5a97e6c06ae'],59,59,118,1594839,29,,,,2685
f5d2899a6483fc08a17ade8d9b26b3e6930da4e4,0,Alexey Serbin,2020-05-13 03:56:29+00:00,['3286c7856931e204ee90ccee62c37bbedda8b665'],20,155,175,1595014,28,0,0,0.952380952,2685
7d6f7fd4fa92bab52abaa3b2948811c8d5475686,0,Alexey Serbin,2020-05-13 06:21:30+00:00,['f5d2899a6483fc08a17ade8d9b26b3e6930da4e4'],0,1,1,1595015,1,,,,2685
54b9a5987ef649806f830a4d1276902d145ab162,0,Andrew Wong,2020-05-13 07:38:53+00:00,['7d6f7fd4fa92bab52abaa3b2948811c8d5475686'],0,2,2,1595017,1,1,1,1,2685
a961fbc7cac61737d03a0c9cf8898199a101f67e,0,Hao Hao,2020-05-13 18:28:03+00:00,['54b9a5987ef649806f830a4d1276902d145ab162'],17,218,235,1595252,2,,,,2685
b7ef3d25db63c41a7cb08369ecec1bbfc82d553f,0,Alexey Serbin,2020-05-14 19:37:36+00:00,['a961fbc7cac61737d03a0c9cf8898199a101f67e'],17,94,111,1595363,4,0,1,0.5,2685
e70d806d1d410b3f1b623e21465061ebe0f62682,0,Alexey Serbin,2020-05-14 19:45:51+00:00,['b7ef3d25db63c41a7cb08369ecec1bbfc82d553f'],5,39,44,1595407,2,0,0,0.692307692,2685
9704898994762d87806e1ecec3c8c335258ff6f7,0,Grant Henke,2020-05-14 20:02:05+00:00,['e70d806d1d410b3f1b623e21465061ebe0f62682'],0,1,1,1595408,1,,,,2685
93006dce92cb8c7cf716a87312d3cc9493c62d2b,0,Alexey Serbin,2020-05-14 21:50:42+00:00,['9704898994762d87806e1ecec3c8c335258ff6f7'],0,13,13,1595421,2,1,1,1,2685
7d1f3fbb40984b6917e6e76f252bf6a0924fd70d,0,Alexey Serbin,2020-05-14 23:15:28+00:00,['93006dce92cb8c7cf716a87312d3cc9493c62d2b'],13,28,41,1595462,1,,,,2685
af561c6f4e6ff08aea1bb7a6a30aff7892604978,0,Grant Henke,2020-05-15 14:16:04+00:00,['7d1f3fbb40984b6917e6e76f252bf6a0924fd70d'],2,2,4,1595466,1,1,0,0,2685
679c0b37b1184a7c80f748207ae5980d1f4a6c57,0,Bankim Bhavsar,2020-05-15 19:53:20+00:00,['af561c6f4e6ff08aea1bb7a6a30aff7892604978'],90,115,205,1595671,2,0,1,0.166666667,2685
55619631cae7f0afd7aa2270bd51b731dc5ad415,0,Grant Henke,2020-05-15 21:25:09+00:00,['679c0b37b1184a7c80f748207ae5980d1f4a6c57'],1,1,2,1595673,1,,,,2685
90450e47e75ace558a04c98e19f2089d21d71c31,0,Andrew Wong,2020-05-18 01:27:10+00:00,['55619631cae7f0afd7aa2270bd51b731dc5ad415'],25,40,65,1595738,1,,,,2685
3b60ddf1a3f039647db589aa641995cc81dd6857,0,Andrew Wong,2020-05-18 01:27:14+00:00,['90450e47e75ace558a04c98e19f2089d21d71c31'],7,26,33,1595771,1,,,,2685
161dec90a10aa96fcc1d2ad789743f6bb37e0d48,0,Andrew Wong,2020-05-18 01:28:01+00:00,['3b60ddf1a3f039647db589aa641995cc81dd6857'],2,35,37,1595808,1,,,,2685
2494029be8d2b7942cfec9287a23746b09b707cd,0,Grant Henke,2020-05-18 02:11:00+00:00,['161dec90a10aa96fcc1d2ad789743f6bb37e0d48'],1,1,2,1595810,1,,,,2685
0e866f093944fbfc89c82314f521980de7b93d6c,0,Grant Henke,2020-05-18 02:11:14+00:00,['2494029be8d2b7942cfec9287a23746b09b707cd'],2,1,3,1595813,1,,,,2685
f87fdfefe7ff893deb3eb1062e8ba76babeae530,0,Grant Henke,2020-05-18 02:11:19+00:00,['0e866f093944fbfc89c82314f521980de7b93d6c'],1,1,2,1595815,1,,,,2685
3a8e9c0f20b801f4d81211c67f26b69152547dc9,0,Grant Henke,2020-05-18 12:48:36+00:00,['f87fdfefe7ff893deb3eb1062e8ba76babeae530'],1,1,2,1595817,1,,,,2685
e63bed4811b73e6255a881effdf5eab707700131,0,Grant Henke,2020-05-18 21:00:32+00:00,['3a8e9c0f20b801f4d81211c67f26b69152547dc9'],11,11,22,1595839,3,,,,2685
f24b224a8af0d033e9eca8561fc280807c686ba4,0,Grant Henke,2020-05-18 21:00:43+00:00,['e63bed4811b73e6255a881effdf5eab707700131'],1,1,2,1595841,1,,,,2685
3801c3329ae71c271e46ddbb7eeaba69fc101f6b,0,Hao Hao,2020-05-18 23:57:01+00:00,['f24b224a8af0d033e9eca8561fc280807c686ba4'],1,1,2,1595843,1,,,,2685
47ffe046d2b4ba8904236491193ad6081df20db8,0,Hao Hao,2020-05-18 23:57:06+00:00,['3801c3329ae71c271e46ddbb7eeaba69fc101f6b'],1,1,2,1595845,1,,,,2685
799ba6e61f7534d0c86765d8f6b7d5575c27f379,0,Hao Hao,2020-05-19 04:41:41+00:00,['47ffe046d2b4ba8904236491193ad6081df20db8'],0,3,3,1595848,1,,,,2685
775c0e1ea803e20de9fe910151df88c17e6c73e7,0,Hao Hao,2020-05-19 04:41:49+00:00,['799ba6e61f7534d0c86765d8f6b7d5575c27f379'],14,14,28,1595876,9,,,,2685
3fc3ffdfffbedb4334f362511be68c02bc31cf95,0,Alexey Serbin,2020-05-19 16:36:45+00:00,['775c0e1ea803e20de9fe910151df88c17e6c73e7'],1,2,3,1595879,1,,,,2685
940f6d136286feef1e101e47f1d14e6ce5f95d61,0,Grant Henke,2020-05-20 15:14:47+00:00,['3fc3ffdfffbedb4334f362511be68c02bc31cf95'],455,43,498,1596377,10,,,,2685
adf45415a80d70a04225972e3c851af0b2a81f7e,0,Andrew Wong,2020-05-20 17:45:30+00:00,['940f6d136286feef1e101e47f1d14e6ce5f95d61'],2,2,4,1596381,1,,,,2685
926802ba848dc571a087eb3a92249fa500fd0da7,0,Andrew Wong,2020-05-20 20:55:30+00:00,['adf45415a80d70a04225972e3c851af0b2a81f7e'],33,158,191,1596572,3,0.586206897,1,0.620689655,2686
b3d231cf5672dcd8e851253f02dbab243861987a,0,Andrew Wong,2020-05-20 23:26:20+00:00,['926802ba848dc571a087eb3a92249fa500fd0da7'],11,16,27,1596599,2,0,0,0,2686
775a130963a9a7915b6be9fbd727274d152caed4,0,Andrew Wong,2020-05-21 05:43:32+00:00,['b3d231cf5672dcd8e851253f02dbab243861987a'],15,104,119,1596718,2,0,0.948275862,1,2686
f9aef3036816eb88c280b2055b4aabcc9afdb114,0,Alexey Serbin,2020-05-21 20:49:22+00:00,['775a130963a9a7915b6be9fbd727274d152caed4'],0,334,334,1597052,1,,,,2686
8a45bee7e45eb42a6a1a47fd7226821c2f717810,0,Alexey Serbin,2020-05-21 20:49:25+00:00,['f9aef3036816eb88c280b2055b4aabcc9afdb114'],0,2,2,1597054,1,,,,2686
d652cab17d52bc7959b6766c2e1cc9db7807e2a5,0,Bankim Bhavsar,2020-05-21 21:19:51+00:00,['8a45bee7e45eb42a6a1a47fd7226821c2f717810'],40,18,58,1597112,5,0.692307692,0,1,2686
6ffac57ee0552880a4248329fc299dbfc61f844b,0,Andrew Wong,2020-05-22 00:15:50+00:00,['d652cab17d52bc7959b6766c2e1cc9db7807e2a5'],43,455,498,1597610,10,,,,2689
8770e722fa99fb3d4c971d78bf8e95e08e2be68a,0,Alexey Serbin,2020-05-22 03:27:28+00:00,['6ffac57ee0552880a4248329fc299dbfc61f844b'],0,7,7,1597617,1,,,,2689
84db20735f696212510a026d13656c9458009bb2,0,Alexey Serbin,2020-05-22 05:46:31+00:00,['8770e722fa99fb3d4c971d78bf8e95e08e2be68a'],28,4,32,1597649,3,0.608695652,0.304347826,0.52173913,2689
72b3bf43e577fb060fed6e0e05b47ed24e237ac5,0,Alexey Serbin,2020-05-23 18:12:04+00:00,['84db20735f696212510a026d13656c9458009bb2'],227,241,468,1598117,26,0,0.5,0,2689
ba10906449e682aacb0b52b1c7b34a23a0c2476f,0,Alexey Serbin,2020-05-27 17:42:49+00:00,['72b3bf43e577fb060fed6e0e05b47ed24e237ac5'],6,6,12,1598129,3,,,,2689
386de6caeb19dd490654abff1195e11b5d9625ca,0,Todd Lipcon,2020-05-27 22:50:08+00:00,['ba10906449e682aacb0b52b1c7b34a23a0c2476f'],13,14,27,1598156,3,0,0,0,2689
4482781a1d46ec3460704313fee2f65c84c9bfbc,0,Alexey Serbin,2020-05-28 04:36:54+00:00,['386de6caeb19dd490654abff1195e11b5d9625ca'],25,24,49,1598205,2,0,0,0,2689
46d2cdf2b52a9511783d28b4fbecda847047070b,0,Alexey Serbin,2020-05-30 02:30:04+00:00,['4482781a1d46ec3460704313fee2f65c84c9bfbc'],2,2,4,1598209,1,,,,2689
12d9a84b49675a20ad10f1f330cb3ed083ea4e92,0,Alexey Serbin,2020-06-03 01:50:59+00:00,['46d2cdf2b52a9511783d28b4fbecda847047070b'],6,6,12,1598221,1,,,,2689
3492cd818768b03baab411d90356e7fa21e58cf5,0,Todd Lipcon,2020-06-03 18:07:26+00:00,['12d9a84b49675a20ad10f1f330cb3ed083ea4e92'],0,2,2,1598223,1,,,,2689
97d775ae883181645dfcbbf1c4c18affc130ea78,0,Andrew Wong,2020-06-03 22:11:18+00:00,['3492cd818768b03baab411d90356e7fa21e58cf5'],168,290,458,1598681,6,0,,,2691
710bd6efaa796db4b95ab2c9a13b53abcf5174a2,0,Alexey Serbin,2020-06-04 01:40:22+00:00,['97d775ae883181645dfcbbf1c4c18affc130ea78'],46,55,101,1598782,6,1,1,0,2691
4457c1a66b57db6252ff9a07f0fcf57239114af6,0,Andrew Wong,2020-06-05 00:41:30+00:00,['710bd6efaa796db4b95ab2c9a13b53abcf5174a2'],19,20,39,1598821,2,,,,2691
df1a5d90f68730af9c89ad47cb668516b6822d5b,0,Alexey Serbin,2020-06-05 16:14:28+00:00,['4457c1a66b57db6252ff9a07f0fcf57239114af6'],12,13,25,1598846,2,1,1,1,2691
c3945267348f7792753d561a1bded943eb608fa7,0,Andrew Wong,2020-06-05 19:15:47+00:00,['df1a5d90f68730af9c89ad47cb668516b6822d5b'],0,1,1,1598847,1,,,,2691
7142a4f1c3f6d281968b1f4506a1a3007f00cad3,0,Alexey Serbin,2020-06-11 04:56:25+00:00,['c3945267348f7792753d561a1bded943eb608fa7'],13,10,23,1598870,1,,,,2691
621cc24b19b0b1bf5f11d31791a3a115be62b5af,0,Alexey Serbin,2020-06-11 22:14:17+00:00,['7142a4f1c3f6d281968b1f4506a1a3007f00cad3'],1,156,157,1599027,1,0.336448598,1,1,2691
3d50fb1191cfb6c50640992efb23ed1202ce5441,0,Alexey Serbin,2020-06-12 07:03:08+00:00,['621cc24b19b0b1bf5f11d31791a3a115be62b5af'],13,13,26,1599053,1,,,,2691
15af717e8c200d4e7a33a25171a6bfe58d70aa65,0,Alexey Serbin,2020-06-12 07:30:24+00:00,['3d50fb1191cfb6c50640992efb23ed1202ce5441'],88,78,166,1599219,6,0,0,0,2691
db0681061a44fae7b6206994ceedc5367da63692,0,Alexey Serbin,2020-06-12 16:48:08+00:00,['15af717e8c200d4e7a33a25171a6bfe58d70aa65'],0,7,7,1599226,1,,,,2691
34e85622f37f88b0436d9ba51df7592bf0e159de,0,Grant Henke,2020-06-13 13:33:36+00:00,['db0681061a44fae7b6206994ceedc5367da63692'],412,1403,1815,1601041,11,0.693150685,0.967123288,0.783561644,2696
8c633e2eb20fca9f45882b291069000c6451c97a,0,Alexey Serbin,2020-06-15 16:23:45+00:00,['34e85622f37f88b0436d9ba51df7592bf0e159de'],71,70,141,1601182,11,0.333333333,0.333333333,0,2696
4e3cf3ef8f19c0df649bbe6f190e8d21c48ee898,0,Grant Henke,2020-06-16 03:45:51+00:00,['8c633e2eb20fca9f45882b291069000c6451c97a'],12,37,49,1601231,4,,,,2697
0dc3e9e0a7306ce9b618158b8a20af9b10f4a482,0,Grant Henke,2020-06-16 12:34:46+00:00,['4e3cf3ef8f19c0df649bbe6f190e8d21c48ee898'],3,508,511,1601742,10,0.547368421,0.973684211,0.736842105,2700
13ce789016310bb3b76fc21bf907a4e5f25c18f5,0,Alexey Serbin,2020-06-19 22:28:29+00:00,['0dc3e9e0a7306ce9b618158b8a20af9b10f4a482'],1,0,1,1601743,1,0,0,0,2700
da1c66b61c4924a4726aaeb171e79cc0b03ca65c,0,Alexey Serbin,2020-06-22 19:02:48+00:00,['13ce789016310bb3b76fc21bf907a4e5f25c18f5'],45,202,247,1601990,6,0.117948718,0,0.215384615,2700
fb53b1b18d1f0950b31a668c05a313e271b6864c,0,Alexey Serbin,2020-06-23 23:12:32+00:00,['da1c66b61c4924a4726aaeb171e79cc0b03ca65c'],0,11,11,1602001,1,,,,2700
2bd3d8281fc6260c441657d378fd4d023d526b6b,0,Alexey Serbin,2020-06-24 04:20:07+00:00,['fb53b1b18d1f0950b31a668c05a313e271b6864c'],14,23,37,1602038,1,0,1,1,2700
cd37d7cbcae4ff9112ee66123ead62b404f656ef,0,Alexey Serbin,2020-06-24 04:21:57+00:00,['2bd3d8281fc6260c441657d378fd4d023d526b6b'],2,10,12,1602050,1,0,0,1,2700
594cf2662a98192d099d271bd744019c659bd5a9,0,Grant Henke,2020-06-24 22:10:47+00:00,['cd37d7cbcae4ff9112ee66123ead62b404f656ef'],3,63,66,1602116,2,0,0.78,0.96,2700
396b70b24b80b1b0b362910e56e4da3f09c441e0,0,Andrew Wong,2020-06-25 19:56:17+00:00,['594cf2662a98192d099d271bd744019c659bd5a9'],1,871,872,1602988,8,0.497474747,0.722222222,0.878787879,2705
27cf7d881f1ab68b7c022d88c5f28160a0d0e518,0,Alexey Serbin,2020-06-26 00:20:21+00:00,['396b70b24b80b1b0b362910e56e4da3f09c441e0'],53,60,113,1603101,6,0,0.25,0.25,2705
51900735075fca92e67cd9dd290b304604d70a84,0,Alexey Serbin,2020-06-26 00:20:24+00:00,['27cf7d881f1ab68b7c022d88c5f28160a0d0e518'],1,1,2,1603103,1,,,,2705
f1905eb2713418294daf71f67b48ea67fb09403e,0,Bankim Bhavsar,2020-06-26 20:38:58+00:00,['51900735075fca92e67cd9dd290b304604d70a84'],75,768,843,1603946,17,0.371681416,0.442477876,0.949852507,2707
23f67ae0d98735bd244ab9a4df2cced1a3f58ec5,0,Alexey Serbin,2020-06-29 17:41:49+00:00,['f1905eb2713418294daf71f67b48ea67fb09403e'],0,35,35,1603981,1,,,,2707
d23ee5d38ddc4317f431dd65df0c825c00cc968a,0,Grant Henke,2020-06-30 12:45:44+00:00,['23f67ae0d98735bd244ab9a4df2cced1a3f58ec5'],135,1023,1158,1605139,19,0.174147217,0.624775583,0.867145422,2707
8a564024a9580d89826e5dc12520ea9a816c65f3,0,Alexey Serbin,2020-07-02 02:05:13+00:00,['d23ee5d38ddc4317f431dd65df0c825c00cc968a'],0,20,20,1605159,2,1,1,1,2707
19c0f7b19b623bc91ebcd7b6451300dc45364b0b,0,Andrew Wong,2020-07-06 22:26:00+00:00,['8a564024a9580d89826e5dc12520ea9a816c65f3'],10,17,27,1605186,2,0,0.285714286,0.285714286,2707
f8dcf3a14ac5f07babdad334f4e6307c851d9b81,0,Todd Lipcon,2020-07-08 05:11:51+00:00,['19c0f7b19b623bc91ebcd7b6451300dc45364b0b'],84,122,206,1605392,28,0,1,0.444444444,2707
59ea81869643f7c41e73133344f7a04ce6d5c08e,0,Bankim Bhavsar,2020-07-08 17:46:11+00:00,['f8dcf3a14ac5f07babdad334f4e6307c851d9b81'],13,9,22,1605414,2,,,,2707
e29dbb23ef4fcff1dcf620016e6d497117f16375,0,Grant Henke,2020-07-08 19:26:00+00:00,['59ea81869643f7c41e73133344f7a04ce6d5c08e'],7,5,12,1605426,5,0,0.183139535,0.171511628,2708
fe15af8496af524b6de3392772edeec88dc8a626,0,Todd Lipcon,2020-07-09 04:33:12+00:00,['e29dbb23ef4fcff1dcf620016e6d497117f16375'],32,25,57,1605483,6,1,1,1,2708
74a58cf4efa517b2dd2bb0d25757d834ce0ab98b,0,Alexey Serbin,2020-07-09 07:17:38+00:00,['fe15af8496af524b6de3392772edeec88dc8a626'],1,1,2,1605485,1,,,,2708
f0446b73630d75f6bf9c11b3fcce8953c557b578,0,Attila Bukor,2020-07-09 13:35:41+00:00,['74a58cf4efa517b2dd2bb0d25757d834ce0ab98b'],91,410,501,1605986,26,0.102325581,0.465116279,0.404651163,2708
101ed5b938af31b69f99a187c894261891459e09,1,Alexey Serbin,2020-07-09 15:53:10+00:00,['f0446b73630d75f6bf9c11b3fcce8953c557b578'],27,45,72,1606058,3,0,1,1,2708
9287bc2095bfea2713cd743dc3f5bb4cd0f41476,0,Alexey Serbin,2020-07-09 20:48:12+00:00,['101ed5b938af31b69f99a187c894261891459e09'],197,206,403,1606461,23,0,0,0,2708
efd8c4f165460b7fa337b8ebd1856b10bc274311,0,Andrew Wong,2020-07-09 21:34:54+00:00,['9287bc2095bfea2713cd743dc3f5bb4cd0f41476'],16,1075,1091,1607552,8,0.157024793,0.673553719,0.865702479,2713
cfde052f965388e595640e204aec559e196b6d4c,0,Alexey Serbin,2020-07-10 07:01:30+00:00,['efd8c4f165460b7fa337b8ebd1856b10bc274311'],5,5,10,1607562,2,,,,2713
59813014099a3c433734c7c58268ddfb80d69055,0,Attila Bukor,2020-07-10 14:01:35+00:00,['cfde052f965388e595640e204aec559e196b6d4c'],95,77,172,1607734,12,1,0.9,0.6,2713
fad779cf7a73722fe670d4eee2f67b3691602bf0,0,Attila Bukor,2020-07-10 14:01:40+00:00,['59813014099a3c433734c7c58268ddfb80d69055'],2,10,12,1607746,4,0.6,0.8,0.8,2713
880ffe4db635e11e45b22256c7626c80b81ccbc0,0,Attila Bukor,2020-07-10 14:01:45+00:00,['fad779cf7a73722fe670d4eee2f67b3691602bf0'],133,254,387,1608133,14,0.258928571,0.616071429,0.75,2713
341605597f7ed1ab7a36bfefb2e181102c173302,0,Grant Henke,2020-07-10 16:49:18+00:00,['880ffe4db635e11e45b22256c7626c80b81ccbc0'],254,332,586,1608719,5,0.331550802,0.609625668,0.882352941,2714
5291221ecea6b892364720342eb15c64bcf41e95,0,Andrew Wong,2020-07-10 17:25:02+00:00,['341605597f7ed1ab7a36bfefb2e181102c173302'],0,13,13,1608732,1,1,1,1,2714
a600f386aa2c341522638acb9af53fd45c469431,0,Todd Lipcon,2020-07-10 18:55:21+00:00,['5291221ecea6b892364720342eb15c64bcf41e95'],330,265,595,1609327,28,0.555555556,0.177777778,0.4,2714
e55ee9d38abeec9f80998c9af1c7864d5fef4e9b,0,Alexey Serbin,2020-07-10 21:16:07+00:00,['a600f386aa2c341522638acb9af53fd45c469431'],35,1098,1133,1610460,9,0.332068311,0.677419355,0.819734345,2718
1a64489eed984e0220a49da9b8a182cbb6f0556a,0,Alexey Serbin,2020-07-10 21:17:19+00:00,['e55ee9d38abeec9f80998c9af1c7864d5fef4e9b'],3,1,4,1610464,1,0,0,0,2718
7ed3cfe225ac6812df45ebb8e34f8dbc8c20533a,0,Grant Henke,2020-07-13 17:21:39+00:00,['1a64489eed984e0220a49da9b8a182cbb6f0556a'],2,4,6,1610470,1,,,,2718
f08d524ac73dbbac6962a8fa857eaaa5701a6809,0,Andrew Wong,2020-07-14 06:12:24+00:00,['7ed3cfe225ac6812df45ebb8e34f8dbc8c20533a'],57,442,499,1610969,29,0.183673469,0.93877551,0.734693878,2719
f7caae03dc61ef48cfcc86cc279b63c46adee46a,0,Todd Lipcon,2020-07-14 16:15:25+00:00,['f08d524ac73dbbac6962a8fa857eaaa5701a6809'],9,10,19,1610988,2,1,0,0,2719
fcdffd4c0e5d980341653bf180b8a234244c2f48,0,Attila Bukor,2020-07-14 23:21:22+00:00,['f7caae03dc61ef48cfcc86cc279b63c46adee46a'],84,446,530,1611518,19,0.318584071,0.646017699,1,2719
0e94aa78465c6e7e83dca1da9015afb5ac95cb09,0,Attila Bukor,2020-07-15 22:01:05+00:00,['fcdffd4c0e5d980341653bf180b8a234244c2f48'],163,323,486,1612004,12,0.063157895,0.621052632,0,2719
6f0e858ba929deacf297a116e1d99a678a3d231c,0,Attila Bukor,2020-07-16 08:13:23+00:00,['0e94aa78465c6e7e83dca1da9015afb5ac95cb09'],3,123,126,1612130,6,0.666666667,0.927536232,0.666666667,2719
60db4aeea0c47e6d7b7557b850cf6378b5ad67ce,0,Grant Henke,2020-07-16 12:38:40+00:00,['6f0e858ba929deacf297a116e1d99a678a3d231c'],1,1,2,1612132,1,,,,2719
e81caa843bb1c18c66c901193100355d5b43029f,0,Grant Henke,2020-07-16 13:08:15+00:00,['60db4aeea0c47e6d7b7557b850cf6378b5ad67ce'],13,40,53,1612185,3,,,,2719
713879ab3dfd055fbaede1741e05e2696081c497,0,Todd Lipcon,2020-07-16 16:26:05+00:00,['e81caa843bb1c18c66c901193100355d5b43029f'],247,252,499,1612684,8,0,0,1,2719
9131bd185aaa760754a662101907f82c404d1ce1,0,Todd Lipcon,2020-07-16 22:04:11+00:00,['713879ab3dfd055fbaede1741e05e2696081c497'],98,119,217,1612901,1,0,0.428571429,1,2719
0914eb527e82acc727828d951559981c905a7f0c,1,Alexey Serbin,2020-07-20 16:29:10+00:00,['9131bd185aaa760754a662101907f82c404d1ce1'],0,336,336,1613237,2,0.184397163,0.496453901,0.687943262,2720
8593d9180819e3f6f611c7b43df77b3f6713a9fc,0,Alexey Serbin,2020-07-20 16:29:23+00:00,['0914eb527e82acc727828d951559981c905a7f0c'],1,1,2,1613239,1,,,,2720
fd381f19f3bee14a25962f67f3bf3e6188d78af0,0,Andrew Wong,2020-07-21 03:18:13+00:00,['8593d9180819e3f6f611c7b43df77b3f6713a9fc'],3,4,7,1613246,1,,,,2720
4fbfbcdda3005200b6570a48379c43bedfa0618b,0,Attila Bukor,2020-07-22 10:55:32+00:00,['fd381f19f3bee14a25962f67f3bf3e6188d78af0'],1,59,60,1613306,3,1,1,1,2720
9602f77fdf5057627101b19f18d41c48027cadbf,0,Attila Bukor,2020-07-22 13:11:06+00:00,['4fbfbcdda3005200b6570a48379c43bedfa0618b'],152,22,174,1613480,2,,,,2720
5c104fe51ad7d56106446c6b32dde48dfee2cc0c,1,Todd Lipcon,2020-07-24 03:13:05+00:00,['9602f77fdf5057627101b19f18d41c48027cadbf'],4,62,66,1613546,3,0,0,0.095238095,2720
e77733ef37e981a9e1b1d2787868ed08b87e2603,0,Todd Lipcon,2020-07-24 19:37:49+00:00,['5c104fe51ad7d56106446c6b32dde48dfee2cc0c'],4,8,12,1613558,1,0,0,1,2720
36c251a99e2243beb6be5173eb9cdad6fb74e4ed,0,Andrew Wong,2020-07-25 05:41:52+00:00,['e77733ef37e981a9e1b1d2787868ed08b87e2603'],50,673,723,1614281,20,0.415224913,0.910034602,0.851211073,2723
95f4109518e7b81b9115a4e8bacbd157dcecad0c,0,Andrew Wong,2020-07-25 23:32:36+00:00,['36c251a99e2243beb6be5173eb9cdad6fb74e4ed'],11,339,350,1614631,4,0.081196581,0.645299145,0.58974359,2723
f52ee7c4df53466df07bf6cbd2241d088a04fc04,0,Grant Henke,2020-07-27 16:13:47+00:00,['95f4109518e7b81b9115a4e8bacbd157dcecad0c'],2,94,96,1614727,6,0.096774194,1,1,2723
8297b52c29bcd3ef6e9ddc675ef4dd0707657977,0,Alexey Serbin,2020-07-28 17:49:51+00:00,['f52ee7c4df53466df07bf6cbd2241d088a04fc04'],0,3,3,1614730,1,,,,2723
fd9fc8073da8536546df8defba968df1d25515e3,0,Alexey Serbin,2020-07-28 17:49:54+00:00,['8297b52c29bcd3ef6e9ddc675ef4dd0707657977'],0,36,36,1614766,1,,,,2723
4bee886c2cb092531a7af0f49420471a2203af2b,0,Alexey Serbin,2020-07-28 17:49:57+00:00,['fd9fc8073da8536546df8defba968df1d25515e3'],0,42,42,1614808,1,,,,2723
55213388126574db9b9bee297a521035aa4e9d3e,0,Alexey Serbin,2020-07-28 18:47:22+00:00,['4bee886c2cb092531a7af0f49420471a2203af2b'],0,21,21,1614829,1,,,,2723
4bed2723490135dc1afa2a609f9d56fc6e82098a,0,Attila Bukor,2020-07-29 11:59:08+00:00,['55213388126574db9b9bee297a521035aa4e9d3e'],7,44,51,1614880,6,0,0.818181818,0.136363636,2723
b8826dfa7caa552c733e013b276cd1e03e3f33d1,0,Attila Bukor,2020-07-29 11:59:12+00:00,['4bed2723490135dc1afa2a609f9d56fc6e82098a'],15,41,56,1614936,1,,,,2723
5ad5d3d6606bbca33fc5909f7a96c7fefd0299e0,0,Grant Henke,2020-07-30 00:16:33+00:00,['b8826dfa7caa552c733e013b276cd1e03e3f33d1'],0,15,15,1614951,3,1,1,1,2723
2f722aaab98b3cb63eb1aa1221eae8f8ed2effd1,0,Todd Lipcon,2020-07-30 02:27:58+00:00,['5ad5d3d6606bbca33fc5909f7a96c7fefd0299e0'],2,9,11,1614962,1,1,1,1,2723
ce58706a49d25f85dd11a6a9486668a1712c3985,0,Andrew Wong,2020-07-30 02:49:06+00:00,['2f722aaab98b3cb63eb1aa1221eae8f8ed2effd1'],2,2,4,1614966,1,,,,2723
1fd79720ed5e6d430784f2dce9ebd387acfc48f8,0,Alexey Serbin,2020-07-30 05:53:19+00:00,['ce58706a49d25f85dd11a6a9486668a1712c3985'],1,2,3,1614969,1,0,0,1,2723
924244c303edd2fc4917204fa0a30163feea0f99,0,Alexey Serbin,2020-07-30 23:14:11+00:00,['1fd79720ed5e6d430784f2dce9ebd387acfc48f8'],29,126,155,1615124,8,0,1,0.871428571,2723
4f7b1aaf88d848b45083ab62d50c1c457c943954,0,Alexey Serbin,2020-07-31 00:40:52+00:00,['924244c303edd2fc4917204fa0a30163feea0f99'],873,13,886,1616010,7,0,0,0,2723
ac8e2281419a5aab975478595cf0f7c1c206ece0,0,Bankim Bhavsar,2020-07-31 17:11:51+00:00,['4f7b1aaf88d848b45083ab62d50c1c457c943954'],20,98,118,1616128,2,0.744680851,0.787234043,0.787234043,2723
162d7f5ded8f6cd62540b2d8ad2a2b7b5a8c887f,0,Alexey Serbin,2020-07-31 18:15:01+00:00,['ac8e2281419a5aab975478595cf0f7c1c206ece0'],40,98,138,1616266,7,1,1,1,2723
2095f8c25ba7973cab360ec4791d939f2c4bf615,0,Alexey Serbin,2020-07-31 20:05:57+00:00,['162d7f5ded8f6cd62540b2d8ad2a2b7b5a8c887f'],1,2,3,1616269,2,1,1,1,2723
9a9ea0f2f8acb39b06cc49f0a3a53cba26f4aae9,1,Yifan Zhang,2020-08-03 10:11:34+00:00,['2095f8c25ba7973cab360ec4791d939f2c4bf615'],44,308,352,1616621,13,0.075471698,0.534591195,0.79245283,2723
cb1c2efb59373453e734074a02021f14c403257d,0,Andrew Wong,2020-08-03 17:13:13+00:00,['9a9ea0f2f8acb39b06cc49f0a3a53cba26f4aae9'],135,972,1107,1617728,21,0.582338902,0.8424821,0.474940334,2725
e58cfb7608410ec0ea6bd058baba50b8470eae53,0,Alexey Serbin,2020-08-04 17:29:37+00:00,['cb1c2efb59373453e734074a02021f14c403257d'],2,4,6,1617734,1,,,,2725
40289e2a2faa021826b9424864ab2935507bef33,0,Grant Henke,2020-08-04 17:59:26+00:00,['e58cfb7608410ec0ea6bd058baba50b8470eae53'],3,100,103,1617837,5,0.628205128,1,1,2725
433c1771f05d25474554e1dd628f6a3d89c8f704,0,Alexey Serbin,2020-08-06 04:42:18+00:00,['40289e2a2faa021826b9424864ab2935507bef33'],1,2,3,1617840,1,1,1,1,2725
f3c7b3f866d3f1f6505264e27b035e8d2798c2d1,0,Alexey Serbin,2020-08-06 19:28:12+00:00,['433c1771f05d25474554e1dd628f6a3d89c8f704'],3,11,14,1617854,1,,,,2725
7e5069525a807dd64ce43b7c978739ccc642be0f,0,Alexey Serbin,2020-08-07 01:31:50+00:00,['f3c7b3f866d3f1f6505264e27b035e8d2798c2d1'],25,32,57,1617911,1,,,,2725
79fd2c8d2797b4e11e78be8c9cb78fdacaa82786,0,Alexey Serbin,2020-08-07 23:02:32+00:00,['7e5069525a807dd64ce43b7c978739ccc642be0f'],9,9,18,1617929,2,,,,2725
0cc190f9b149ade571162fe43937ca7dcce8a116,0,Alexey Serbin,2020-08-07 23:47:24+00:00,['79fd2c8d2797b4e11e78be8c9cb78fdacaa82786'],0,2,2,1617931,1,,,,2725
2187f9c1c8d8b98ffbeb464f16d2f52f8c76d3ba,0,Alexey Serbin,2020-08-10 23:52:13+00:00,['0cc190f9b149ade571162fe43937ca7dcce8a116'],5,4,9,1617940,1,,,,2725
1cd6fe4f500777def1446ee5dcc93c40dd2f3812,0,Alexey Serbin,2020-08-10 23:54:28+00:00,['2187f9c1c8d8b98ffbeb464f16d2f52f8c76d3ba'],7,73,80,1618020,3,0.195121951,1,1,2725
1c5a04f7774f348b3c9fc4fd39de98c858c87c5f,0,Alexey Serbin,2020-08-11 01:22:46+00:00,['1cd6fe4f500777def1446ee5dcc93c40dd2f3812'],121,241,362,1618382,1,,,,2725
14d4117afa42d0ddf75bfda1926bb2c47cc6e322,1,Andrew Wong,2020-08-13 23:56:19+00:00,['1c5a04f7774f348b3c9fc4fd39de98c858c87c5f'],9,1333,1342,1619724,16,0.308980213,0.570776256,0.925418569,2732
a69a1d68e31e0c0eec9a47f7669098ca872baaa3,0,Andrew Wong,2020-08-13 23:56:21+00:00,['14d4117afa42d0ddf75bfda1926bb2c47cc6e322'],60,188,248,1619972,7,0.724137931,1,0.931034483,2732
42aff29360bf5be0a141902dac707e865933473f,0,Yifan Zhang,2020-08-14 07:01:02+00:00,['a69a1d68e31e0c0eec9a47f7669098ca872baaa3'],27,37,64,1620036,2,1,1,1,2732
c444e8dcbc9dbdef3d599fe4858d740ff91b2045,0,Alexey Serbin,2020-08-14 18:27:54+00:00,['42aff29360bf5be0a141902dac707e865933473f'],3,9,12,1620048,1,1,1,1,2732
7b832c9c31975d691c4dc005631f1bb47aa6ed30,0,Todd Lipcon,2020-08-14 20:53:58+00:00,['c444e8dcbc9dbdef3d599fe4858d740ff91b2045'],220,295,515,1620563,23,0,0.7,0,2732
fb0f4bc3bf63614a831fedc6cc29cf860dddaf49,0,Todd Lipcon,2020-08-14 20:54:04+00:00,['7b832c9c31975d691c4dc005631f1bb47aa6ed30'],257,351,608,1621171,38,0.066666667,0.533333333,0.8,2734
b1f2b79b1fc56e6d50b0a770ce09ec5fa96ad05e,0,Andrew Wong,2020-08-14 21:18:56+00:00,['fb0f4bc3bf63614a831fedc6cc29cf860dddaf49'],0,3,3,1621174,1,,,,2734
6ab55f6e13c09ab688ab23ee2164b98929ccf26c,0,Alexey Serbin,2020-08-14 23:42:38+00:00,['b1f2b79b1fc56e6d50b0a770ce09ec5fa96ad05e'],0,81,81,1621255,3,0.111111111,1,1,2734
d1190c2b06a6eef91b21fd4a0b5fb76534b4e9f9,0,Bankim Bhavsar,2020-08-25 04:58:56+00:00,['6ab55f6e13c09ab688ab23ee2164b98929ccf26c'],32,106,138,1621393,2,0,0,1,2734
fc9b614b3ae729a6f76ec2e47945e6331863c015,0,Todd Lipcon,2020-08-25 22:29:30+00:00,['d1190c2b06a6eef91b21fd4a0b5fb76534b4e9f9'],2,94,96,1621489,3,,,,2736
4b3e884c09f0b4e8871273a29590e8c56f3c5df7,0,Todd Lipcon,2020-08-26 01:36:27+00:00,['fc9b614b3ae729a6f76ec2e47945e6331863c015'],24,101,125,1621614,6,0.027777778,0.888888889,0,2736
bcb2b2e390eb8fb17f347087bb847af4158e64d6,0,Grant Henke,2020-08-26 14:34:37+00:00,['4b3e884c09f0b4e8871273a29590e8c56f3c5df7'],1,1,2,1621616,1,,,,2736
1ffef3e5faca254c43799773caa7abe6d47d9645,0,Grant Henke,2020-08-26 21:19:24+00:00,['bcb2b2e390eb8fb17f347087bb847af4158e64d6'],52,42,94,1621710,1,1,1,0,2736
141dfab4f65f9f4083ee5d62d4033a1ade9f232b,0,Grant Henke,2020-08-26 21:19:27+00:00,['1ffef3e5faca254c43799773caa7abe6d47d9645'],14,20,34,1621744,1,,,,2736
5e328d38519d656b881219db8087b8eb8af1d4d8,0,Grant Henke,2020-08-26 21:19:29+00:00,['141dfab4f65f9f4083ee5d62d4033a1ade9f232b'],15,38,53,1621797,1,0.75,1,1,2736
de312377d2fa71a4a39f7f9b8cf78615e8d47715,0,Attila Bukor,2020-08-27 10:32:37+00:00,['5e328d38519d656b881219db8087b8eb8af1d4d8'],67,112,179,1621976,7,,,,2736
c590a05778443bb6112e831d0b0ad0dce4b74724,0,Attila Bukor,2020-08-27 13:51:45+00:00,['de312377d2fa71a4a39f7f9b8cf78615e8d47715'],147,255,402,1622378,8,1,1,1,2736
4eff1e7434a2c63f645b9996fa6de03b3701b80a,0,Bankim Bhavsar,2020-08-27 23:15:23+00:00,['c590a05778443bb6112e831d0b0ad0dce4b74724'],4,8,12,1622390,2,0,1,1,2736
c6d438ab417009e8007a1de274178d0bcf0dfb63,1,Alexey Serbin,2020-08-28 06:15:23+00:00,['4eff1e7434a2c63f645b9996fa6de03b3701b80a'],0,133,133,1622523,1,0.064102564,1,1,2736
fc8615c37eb4e28f3cc6bea0fcd5a8732451e883,0,Alexey Serbin,2020-08-28 06:15:27+00:00,['c6d438ab417009e8007a1de274178d0bcf0dfb63'],28,603,631,1623154,3,0.132307692,0.175384615,0.827692308,2736
e4c2cb91020d67a97195e0b7745cc2a98562e4c4,0,Andrew Wong,2020-08-28 07:06:10+00:00,['fc8615c37eb4e28f3cc6bea0fcd5a8732451e883'],448,449,897,1624051,26,0,0,0,2736
ee3bb83575a051c2feade1f8c159b2902a7160d5,0,Alexey Serbin,2020-08-31 17:08:24+00:00,['e4c2cb91020d67a97195e0b7745cc2a98562e4c4'],107,352,459,1624510,13,0.196261682,1,0.579439252,2737
68ee03c2bd0bae950c08582910e675cda54b6ca7,0,Andrew Wong,2020-09-01 21:07:56+00:00,['ee3bb83575a051c2feade1f8c159b2902a7160d5'],76,449,525,1625035,16,0.169082126,1,0.913043478,2737
dcb9b71e04d8c8894040ac261fc2dfc704f3c819,0,Attila Bukor,2020-09-02 17:47:16+00:00,['68ee03c2bd0bae950c08582910e675cda54b6ca7'],54,93,147,1625182,6,0.032258065,0.935483871,1,2737
a59d3821bfbc87ac3c910c602d2bdf037eeb9d9b,0,Bankim Bhavsar,2020-09-03 17:53:47+00:00,['dcb9b71e04d8c8894040ac261fc2dfc704f3c819'],18,305,323,1625505,13,0.255172414,0.737931034,1,2738
6689ba3c81be193309afd27de016dd35c0db71de,0,Grant Henke,2020-09-03 19:45:21+00:00,['a59d3821bfbc87ac3c910c602d2bdf037eeb9d9b'],2,271,273,1625778,16,0.418300654,0.908496732,0.895424837,2738
45d1e6612f5cb273137f7240136f78b5a944d9e7,0,Alexey Serbin,2020-09-03 22:12:32+00:00,['6689ba3c81be193309afd27de016dd35c0db71de'],4,84,88,1625866,1,0,0,1,2738
ae776c12895b1f2a60b95749d7a8cb31d0e841ad,0,Attila Bukor,2020-09-04 13:25:02+00:00,['45d1e6612f5cb273137f7240136f78b5a944d9e7'],1,1,2,1625868,1,,,,2738
c4997af4b90b4a102597775e575320c95eb3c1ba,0,Alexey Serbin,2020-09-08 20:58:29+00:00,['ae776c12895b1f2a60b95749d7a8cb31d0e841ad'],15,24,39,1625907,2,1,1,,2738
0c4f1f91e3c1ff57360025731f519324a9550730,0,Bankim Bhavsar,2020-09-09 19:06:46+00:00,['c4997af4b90b4a102597775e575320c95eb3c1ba'],8,5,13,1625920,1,,,,2738
bd966e2b99a2b5f2a9752f61c8fe84a56d5d2307,0,Grant Henke,2020-09-09 20:20:44+00:00,['0c4f1f91e3c1ff57360025731f519324a9550730'],34,134,168,1626088,5,0.245901639,0.590163934,1,2738
56ce1ad8bda24dbaed36c0f059e13a3d8e25b1d0,0,Alexey Serbin,2020-09-10 02:34:22+00:00,['bd966e2b99a2b5f2a9752f61c8fe84a56d5d2307'],63,183,246,1626334,3,0.217391304,0.724637681,0,2738
8fc3ce7040b485424d196e6f9032c7b22b43b122,0,Grant Henke,2020-09-11 01:42:43+00:00,['56ce1ad8bda24dbaed36c0f059e13a3d8e25b1d0'],1,384,385,1626719,3,0.834586466,1,0.436090226,2740
98c6e6b4187d2d05483aeee8ea0c7b3c6c5e3bb9,0,Alexey Serbin,2020-09-12 00:59:21+00:00,['8fc3ce7040b485424d196e6f9032c7b22b43b122'],5,0,5,1626724,1,1,0,1,2740
fb59235e2099e1ffacd9cf91b7e605f8d53f24cc,0,Alexey Serbin,2020-09-14 14:41:57+00:00,['98c6e6b4187d2d05483aeee8ea0c7b3c6c5e3bb9'],13,10,23,1626747,2,0,0,0,2740
eaf558527a9f996e68515bf190dc7cf1ab9931a3,0,Alexey Serbin,2020-09-14 14:51:34+00:00,['fb59235e2099e1ffacd9cf91b7e605f8d53f24cc'],33,74,107,1626854,2,0.742857143,0.771428571,0.828571429,2740
0f9ff5ff043125be4a1150be0306373619b4ca89,0,Alexey Serbin,2020-09-14 16:35:50+00:00,['eaf558527a9f996e68515bf190dc7cf1ab9931a3'],6,115,121,1626975,3,0.215189873,1,0.670886076,2740
dc28392314605880583ba9b8926e2b86d15768f6,0,Grant Henke,2020-09-15 18:18:35+00:00,['0f9ff5ff043125be4a1150be0306373619b4ca89'],0,2,2,1626977,1,,,,2740
c29359d3730828764677d76ef33819dd75e7a0ad,0,Alexey Serbin,2020-09-15 18:49:30+00:00,['dc28392314605880583ba9b8926e2b86d15768f6'],4,4,8,1626985,1,,,,2740
e9d62d39f657a08d9ee5846e7b6f00fdc1c75c1c,0,Grant Henke,2020-09-15 19:00:48+00:00,['c29359d3730828764677d76ef33819dd75e7a0ad'],0,5,5,1626990,2,,,,2740
6953f53fb1f0ef617f596ec89690ab0e1adfc4e4,0,Grant Henke,2020-09-15 19:15:16+00:00,['e9d62d39f657a08d9ee5846e7b6f00fdc1c75c1c'],0,20,20,1627010,2,,,,2740
09463d31f4c3a26b534e0eb51621d3341b03466d,0,Grant Henke,2020-09-15 19:15:20+00:00,['6953f53fb1f0ef617f596ec89690ab0e1adfc4e4'],6,8,14,1627024,1,,,,2740
4cbee427475396c9cf1e05a402c3f952d3fafde7,0,Grant Henke,2020-09-15 20:32:46+00:00,['09463d31f4c3a26b534e0eb51621d3341b03466d'],59,79,138,1627162,22,,,,2740
f63ca3b6e7a61fbb0f56664d772e4e9237475671,0,Alexey Serbin,2020-09-16 19:18:42+00:00,['4cbee427475396c9cf1e05a402c3f952d3fafde7'],1,1,2,1627164,1,,,,2740
7d6655d40a839bbd43f9472cb509e04ebb4f3fb8,0,Andrew Wong,2020-09-16 23:17:37+00:00,['f63ca3b6e7a61fbb0f56664d772e4e9237475671'],50,54,104,1627268,3,1,0,0,2740
2c0bb26bab0110659b37ba7c31ebd761ffc9980b,0,Andrew Wong,2020-09-16 23:17:40+00:00,['7d6655d40a839bbd43f9472cb509e04ebb4f3fb8'],3,8,11,1627279,1,0,1,1,2740
5c22c99d5902a56bab64f19329a8fd1e12d186fd,0,Grant Henke,2020-09-16 23:32:37+00:00,['2c0bb26bab0110659b37ba7c31ebd761ffc9980b'],3,2,5,1627284,1,,,,2740
17940718507542e54150fa6e9e916b72f4ad1908,0,Andrew Wong,2020-09-17 01:39:57+00:00,['5c22c99d5902a56bab64f19329a8fd1e12d186fd'],1,5,6,1627290,1,,,,2740
4e5ac1cb59305381325cca9daeca985bd2f05db2,0,Grant Henke,2020-09-17 02:00:53+00:00,['17940718507542e54150fa6e9e916b72f4ad1908'],1,15,16,1627306,1,1,1,1,2740
7bc5d4e415d44aca6af4acd08aaaf1cf5a6860a1,0,Andrew Wong,2020-09-17 17:57:39+00:00,['4e5ac1cb59305381325cca9daeca985bd2f05db2'],0,17,17,1627323,1,,,,2740
6b021dac1112e90488d1d6fb710d97a8f9085e76,0,Alexey Serbin,2020-09-17 21:21:10+00:00,['7bc5d4e415d44aca6af4acd08aaaf1cf5a6860a1'],2,25,27,1627350,1,1,1,1,2740
efb254e27448b1c18c124a7320913bce687e59b6,0,Alexey Serbin,2020-09-17 21:21:16+00:00,['6b021dac1112e90488d1d6fb710d97a8f9085e76'],7,13,20,1627370,1,1,1,1,2740
c7bf1c140e00ba8895ec6a14fa918c190dff2e1f,0,Alexey Serbin,2020-09-18 19:56:44+00:00,['efb254e27448b1c18c124a7320913bce687e59b6'],91,60,151,1627521,14,0,0,0,2740
34ba52cdd7c099c85646fee92ec71fbe67978df8,0,Attila Bukor,2020-09-21 14:19:50+00:00,['c7bf1c140e00ba8895ec6a14fa918c190dff2e1f'],1,1,2,1627523,1,,,,2740
0ef2cc88f62a30e21d6363ff2c5183a820c82632,0,Attila Bukor,2020-09-21 14:20:17+00:00,['34ba52cdd7c099c85646fee92ec71fbe67978df8'],1,1,2,1627525,1,,,,2740
851495c976681af54466d74d32f53c559be8a2d4,0,Alexey Serbin,2020-09-21 17:01:33+00:00,['0ef2cc88f62a30e21d6363ff2c5183a820c82632'],10,9,19,1627544,3,,,,2740
2bed4068c53fcc6084e8e8742437846cf417a746,0,Alexey Serbin,2020-09-21 17:05:47+00:00,['851495c976681af54466d74d32f53c559be8a2d4'],2,84,86,1627630,2,,,,2741
d8ab44c6864172d4b990adf31f7d84fd33e4ae15,0,Alexey Serbin,2020-09-21 17:05:50+00:00,['2bed4068c53fcc6084e8e8742437846cf417a746'],9,4,13,1627643,1,1,0,0,2741
fcceb8b1a20afff30e15b6248a56ab3e06b61e79,0,Andrew Wong,2020-09-22 06:01:32+00:00,['d8ab44c6864172d4b990adf31f7d84fd33e4ae15'],75,258,333,1627976,10,0.296610169,0.533898305,0.86440678,2741
d03448530b6c301dbaf242cce3553db716a8b58f,0,Grant Henke,2020-09-22 16:07:11+00:00,['fcceb8b1a20afff30e15b6248a56ab3e06b61e79'],10,41,51,1628027,5,0.846153846,0.846153846,1,2741
13f5694e993284db7d8c85bbccc05db9e6f2eb03,0,Alexey Serbin,2020-09-22 17:16:45+00:00,['d03448530b6c301dbaf242cce3553db716a8b58f'],1,0,1,1628028,1,,,,2741
9fc6c772aff2bbfa008f52da8e7ba6e2c2d9012f,0,Bankim Bhavsar,2020-09-24 18:07:12+00:00,['13f5694e993284db7d8c85bbccc05db9e6f2eb03'],53,984,1037,1629065,20,0.20537428,0.60268714,0.863723608,2742
20fde59bca1f9df5a3cdee48f7794e0e8f16784a,0,Alexey Serbin,2020-09-28 19:36:32+00:00,['9fc6c772aff2bbfa008f52da8e7ba6e2c2d9012f'],9,169,178,1629243,10,0.121212121,0.929292929,0.787878788,2742
01a9a5a9ca4000862fa92c7cbff42967a067c326,0,Alexey Serbin,2020-09-28 21:56:19+00:00,['20fde59bca1f9df5a3cdee48f7794e0e8f16784a'],19,136,155,1629398,5,0,0.85,0.5875,2742
6597422c25b4ffc6133610a5fd89c9acc2c7983b,0,Grant Henke,2020-09-29 17:36:47+00:00,['01a9a5a9ca4000862fa92c7cbff42967a067c326'],0,1,1,1629399,1,,,,2742
cc1e091904ceb6b6c527498d8ff849bb42412115,0,Grant Henke,2020-09-29 21:15:21+00:00,['6597422c25b4ffc6133610a5fd89c9acc2c7983b'],15,119,134,1629533,14,0.372093023,0.953488372,0.76744186,2742
f7c4bbc84a8afe3ed0d269bb909abe91cfcef6d6,0,Alexey Serbin,2020-10-01 19:26:52+00:00,['cc1e091904ceb6b6c527498d8ff849bb42412115'],4,8,12,1629545,1,0,0,0,2742
e5579c9b7465f9d9a164d42709f1a9a07acdff59,0,Grant Henke,2020-10-01 23:15:59+00:00,['f7c4bbc84a8afe3ed0d269bb909abe91cfcef6d6'],126,264,390,1629935,17,0,0.445454545,1,2742
f191638bca891b36a6ef396fb9aa1f5c8f6af776,0,Andrew Wong,2020-10-01 23:46:13+00:00,['e5579c9b7465f9d9a164d42709f1a9a07acdff59'],2,34,36,1629971,1,0.363636364,0.363636364,1,2742
ca1c1077fe29c5c0d617cc86c164abdfb3bd7629,0,Alexey Serbin,2020-10-02 17:27:18+00:00,['f191638bca891b36a6ef396fb9aa1f5c8f6af776'],1,3,4,1629975,1,0,0,0,2742
a772c0926919735d143f42f34a960a1308eb251d,0,Alexey Serbin,2020-10-03 03:47:35+00:00,['ca1c1077fe29c5c0d617cc86c164abdfb3bd7629'],0,3,3,1629978,1,0,1,0,2742
b2fae6d0aec813c9a82c4cd1cbb3e5d495d6e35a,0,Alexey Serbin,2020-10-06 18:16:08+00:00,['a772c0926919735d143f42f34a960a1308eb251d'],102,148,250,1630228,4,0,0.090909091,0.393939394,2742
9b4a83ac71621211582b9eb0c471d8ac4fd9b984,0,Alexey Serbin,2020-10-07 05:06:32+00:00,['b2fae6d0aec813c9a82c4cd1cbb3e5d495d6e35a'],12,139,151,1630379,4,0.129032258,1,0.887096774,2742
fa3b5712ec7495e89b32e91c6c8d09d558f7d4f9,0,Andrew Wong,2020-10-07 07:23:15+00:00,['9b4a83ac71621211582b9eb0c471d8ac4fd9b984'],83,487,570,1630949,14,0.343283582,0.960199005,0.92039801,2742
90aa4fa7d1527f376803440a4642668e3d798748,0,Andrew Wong,2020-10-07 07:23:20+00:00,['fa3b5712ec7495e89b32e91c6c8d09d558f7d4f9'],121,727,848,1631797,13,0.288828338,0.435967302,0.934604905,2742
faa8c5d4f21ab8bc3e42995d0202246e2a5417b6,0,Grant Henke,2020-10-07 18:31:03+00:00,['90aa4fa7d1527f376803440a4642668e3d798748'],43,239,282,1632079,7,0.62745098,0.617647059,1,2742
536ccdaac556bdfa0447915275ed8458f525b389,0,Alexey Serbin,2020-10-07 23:36:15+00:00,['faa8c5d4f21ab8bc3e42995d0202246e2a5417b6'],10,138,148,1632227,3,0.02173913,0.836956522,0.72826087,2742
c400daebdbcb7da336d9be8fa1c872369ab1e65d,0,Alexey Serbin,2020-10-08 03:21:18+00:00,['536ccdaac556bdfa0447915275ed8458f525b389'],48,177,225,1632452,10,0,0.273809524,0.619047619,2742
6208c01abbb29acd8306dfdd831fe56fe2cf2a30,0,Attila Bukor,2020-10-09 18:26:18+00:00,['c400daebdbcb7da336d9be8fa1c872369ab1e65d'],7,14,21,1632473,5,0,0.182926829,0.073170732,2745
81720a4a26b740c3df4e770f122e90b639fee2a8,0,Attila Bukor,2020-10-09 18:26:26+00:00,['6208c01abbb29acd8306dfdd831fe56fe2cf2a30'],15,15,30,1632503,10,,,,2745
ea48c9b181e3256cb96940c8d6bbf2f5ec3c3607,0,Grant Henke,2020-10-09 19:13:25+00:00,['81720a4a26b740c3df4e770f122e90b639fee2a8'],2,50,52,1632555,2,0,0,1,2745
164d78464d731c14a3f06db0635f138e2ad215a9,0,Grant Henke,2020-10-09 19:13:33+00:00,['ea48c9b181e3256cb96940c8d6bbf2f5ec3c3607'],7,5,12,1632567,1,0,0,0,2745
0a3d12c0340346ae5adfe92b5d809bbbc31be089,0,Alexey Serbin,2020-10-09 19:26:10+00:00,['164d78464d731c14a3f06db0635f138e2ad215a9'],16,67,83,1632650,1,0,1,1,2745
6b20440f4c51a6b69c1382db51139bf8d3467b05,0,Grant Henke,2020-10-09 21:23:01+00:00,['0a3d12c0340346ae5adfe92b5d809bbbc31be089'],30,107,137,1632787,4,0.424242424,0.363636364,1,2745
18964fd29bce0cd9c949ae059c89ea8ee4901ca2,0,Andrew Wong,2020-10-10 01:05:42+00:00,['6b20440f4c51a6b69c1382db51139bf8d3467b05'],1,1,2,1632789,1,,,,2745
3f0008bf67df5630835711f848805d488d9ccc99,0,Andrew Wong,2020-10-12 06:27:25+00:00,['18964fd29bce0cd9c949ae059c89ea8ee4901ca2'],1,1,2,1632791,1,,,,2745
c0cd1045f7905826c59a33cb3dd196eb2e582d48,0,Alexey Serbin,2020-10-13 16:18:39+00:00,['3f0008bf67df5630835711f848805d488d9ccc99'],0,15,15,1632806,2,0.7,0.7,0.7,2745
b2039d515bba83fa874f6d5ee7ad2bfc56e1e267,0,Grant Henke,2020-10-13 19:49:20+00:00,['c0cd1045f7905826c59a33cb3dd196eb2e582d48'],8,42,50,1632856,6,0,0,0,2745
cccc64098bc788b6084540dae890ca57f2239494,0,Grant Henke,2020-10-13 19:49:24+00:00,['b2039d515bba83fa874f6d5ee7ad2bfc56e1e267'],7,7,14,1632870,2,,,,2745
a6c93313aae7f40fb8d6b87fb6f6d875b42c068b,0,Grant Henke,2020-10-13 19:49:34+00:00,['cccc64098bc788b6084540dae890ca57f2239494'],4,39,43,1632913,2,,,,2746
640a84ecff857c3d0447c690c68e2361eb3e9c3b,0,Andrew Wong,2020-10-14 02:33:51+00:00,['a6c93313aae7f40fb8d6b87fb6f6d875b42c068b'],150,234,384,1633297,14,0.159090909,0,0.318181818,2746
9306e41c32c8a03e1aedd682b9e158066baba7f4,0,Alexey Serbin,2020-10-14 18:40:06+00:00,['640a84ecff857c3d0447c690c68e2361eb3e9c3b'],15,1203,1218,1634515,11,0.42791762,0.942791762,0.775743707,2752
41a7c4e4e8165ec42312afa919550f815b3e808d,0,Grant Henke,2020-10-14 19:00:31+00:00,['9306e41c32c8a03e1aedd682b9e158066baba7f4'],9,30,39,1634554,10,1,0.5,0.5,2752
97b9827199e8190656ddf356695f06a2e54e39b5,0,Alexey Serbin,2020-10-14 19:33:33+00:00,['41a7c4e4e8165ec42312afa919550f815b3e808d'],23,301,324,1634878,5,0,0.2,0.794594595,2752
bd18cd1cf196e0fa4b9051e51deed789090b1721,0,Alexey Serbin,2020-10-14 19:52:23+00:00,['97b9827199e8190656ddf356695f06a2e54e39b5'],16,17,33,1634911,1,,,,2752
d01145b982517dd7a5aa507543e6ffc1dfa1e584,0,Grant Henke,2020-10-19 14:41:56+00:00,['bd18cd1cf196e0fa4b9051e51deed789090b1721'],6,48,54,1634965,2,0.133333333,1,1,2752
b4c1775ed269cd86df81708a67f202127dfa9161,0,Grant Henke,2020-10-19 17:52:45+00:00,['d01145b982517dd7a5aa507543e6ffc1dfa1e584'],7,254,261,1635226,8,0,0.88,1,2754
483807a622bbb10558f9905e87ab0ab1b7abca35,0,Andrew Wong,2020-10-19 23:24:06+00:00,['b4c1775ed269cd86df81708a67f202127dfa9161'],29,164,193,1635419,4,0.285714286,0.971428571,0.942857143,2754
d8b8d0ead5b534ee7a9b901050e0d16d87efe3d1,0,Alexey Serbin,2020-10-21 18:31:19+00:00,['483807a622bbb10558f9905e87ab0ab1b7abca35'],15,15,30,1635449,1,,,,2754
14dec6d9b185066fda0f584f538a894937679371,0,Alexey Serbin,2020-10-22 15:23:42+00:00,['d8b8d0ead5b534ee7a9b901050e0d16d87efe3d1'],45,38,83,1635532,2,,,,2754
303f4253ee5d5e18d2dbfa73e55091d2e50cdfb6,0,Grant Henke,2020-10-22 19:01:05+00:00,['14dec6d9b185066fda0f584f538a894937679371'],4,2,6,1635538,2,,,,2754
185d2c9faa403a6214520ea2d98d8833ab7d36ea,0,Alexey Serbin,2020-10-22 23:27:09+00:00,['303f4253ee5d5e18d2dbfa73e55091d2e50cdfb6'],0,219,219,1635757,4,0.473684211,1,1,2757
e64eb7c7ceceec76aeb5cceac9dc42cc0e78f1ec,0,Alexey Serbin,2020-10-23 02:43:19+00:00,['185d2c9faa403a6214520ea2d98d8833ab7d36ea'],21,107,128,1635885,8,0.159090909,0,0.454545455,2757
5a7dfbcdd0d7728c6a7acfaf822f4059261aa8be,0,Alexey Serbin,2020-10-24 00:35:36+00:00,['e64eb7c7ceceec76aeb5cceac9dc42cc0e78f1ec'],46,52,98,1635983,3,1,0,0,2757
2ca437e25e93dba3d3678dd20d92ffa0b4ba2e29,0,Andrew Wong,2020-10-24 05:47:28+00:00,['5a7dfbcdd0d7728c6a7acfaf822f4059261aa8be'],154,653,807,1636790,12,0.237762238,0.867132867,0.884615385,2758
63dbe6f9be3399ea83f6ffda5f6de1d84d5c8b96,0,Andrew Wong,2020-10-24 05:49:22+00:00,['2ca437e25e93dba3d3678dd20d92ffa0b4ba2e29'],30,48,78,1636868,3,0,1,1,2758
17cede9da2c7213e05dcca921a0e767dda54f131,0,Alexey Serbin,2020-10-25 06:40:02+00:00,['63dbe6f9be3399ea83f6ffda5f6de1d84d5c8b96'],2,47,49,1636917,4,0,1,0.956521739,2758
0e86d4fce538fd2ed1fb21ac07c073eea15aaa39,0,Attila Bukor,2020-10-26 13:57:05+00:00,['17cede9da2c7213e05dcca921a0e767dda54f131'],3,7,10,1636927,1,1,0,0,2758
2f5605dfc9f6aed3bfdf5f3e6adad633658b7791,0,Andrew Wong,2020-10-26 20:20:10+00:00,['0e86d4fce538fd2ed1fb21ac07c073eea15aaa39'],2,2,4,1636931,1,,,,2758
c7dfac7b784984a13e0707bc391c057dd8122bf2,0,Hao Hao,2020-10-26 21:12:42+00:00,['2f5605dfc9f6aed3bfdf5f3e6adad633658b7791'],1,1,2,1636933,1,,,,2758
ae5374893b4d0a5e1e6a84a41057ccb616f7acd4,0,Hao Hao,2020-10-26 21:12:49+00:00,['c7dfac7b784984a13e0707bc391c057dd8122bf2'],1,0,1,1636934,1,,,,2758
7a347a7792a0dd317aece63f8a9d6aee0b2b680d,0,Alexey Serbin,2020-10-28 07:07:10+00:00,['ae5374893b4d0a5e1e6a84a41057ccb616f7acd4'],27,34,61,1636995,2,0,0,0,2758
fe65185d9bc23489dc693d5214fb0d2172325737,0,Grant Henke,2020-10-28 12:39:21+00:00,['7a347a7792a0dd317aece63f8a9d6aee0b2b680d'],60,507,567,1637562,22,0.029508197,0.462295082,0.740983607,2758
17d569b870e8fb3978a8c02bc1170057a42ca7cc,0,Grant Henke,2020-10-28 12:39:28+00:00,['fe65185d9bc23489dc693d5214fb0d2172325737'],7,165,172,1637734,8,1,1,0.857142857,2760
ea1695885067dc5d39ad1f794a91a9d9e0540b1a,0,Hao Hao,2020-10-29 01:18:27+00:00,['17d569b870e8fb3978a8c02bc1170057a42ca7cc'],9,180,189,1637923,9,0.165137615,0.403669725,0.788990826,2760
ff6d80f3e91ae9011545edc9b94b25753908d790,0,Grant Henke,2020-10-30 19:59:47+00:00,['ea1695885067dc5d39ad1f794a91a9d9e0540b1a'],2,80,82,1638005,4,0,0,1,2760
24943aa5e51d25c532f20887fd21b246c973021c,0,Grant Henke,2020-10-31 00:59:28+00:00,['ff6d80f3e91ae9011545edc9b94b25753908d790'],3,13,16,1638021,2,0,0.5,1,2760
6d2c79a4f266932b644f1cf7165ad3b6ccc49404,0,Attila Bukor,2020-11-02 14:05:35+00:00,['24943aa5e51d25c532f20887fd21b246c973021c'],41,48,89,1638110,4,1,1,1,2760
b3de5e38c128277a7e9e48bd8c1d0f0a691157a5,0,Andrew Wong,2020-11-03 05:36:57+00:00,['6d2c79a4f266932b644f1cf7165ad3b6ccc49404'],18,73,91,1638201,2,0.70212766,0.914893617,1,2760
46231c52f5f16c1613d92f3393724f3c4c15db22,0,Attila Bukor,2020-11-03 22:36:40+00:00,['b3de5e38c128277a7e9e48bd8c1d0f0a691157a5'],10,34,44,1638245,3,0.7,0.8,1,2760
75b113eafbf93a93fc1ec0c8e15d29fccd65b477,0,Attila Bukor,2020-11-03 22:36:50+00:00,['46231c52f5f16c1613d92f3393724f3c4c15db22'],42,64,106,1638351,10,0.571428571,0.857142857,1,2760
f9f3189a6dbe0636d578d80b1d8e60cf7b2e6686,0,Grant Henke,2020-11-04 01:52:22+00:00,['75b113eafbf93a93fc1ec0c8e15d29fccd65b477'],13,96,109,1638460,6,0.666666667,0,0.904761905,2760
62ec1e474167d79de298cd14d9e1b975bcdbdd8a,0,Alexey Serbin,2020-11-04 04:54:09+00:00,['f9f3189a6dbe0636d578d80b1d8e60cf7b2e6686'],34,111,145,1638605,8,0.285714286,1,1,2760
1a22d50fdd7018ed7d277a229cfd26c90451d68d,0,Alexey Serbin,2020-11-04 04:54:12+00:00,['62ec1e474167d79de298cd14d9e1b975bcdbdd8a'],28,31,59,1638664,1,1,,,2760
dbbc48893a743bb5d96a7b17007450f1a94463cb,0,Alexey Serbin,2020-11-04 05:35:53+00:00,['1a22d50fdd7018ed7d277a229cfd26c90451d68d'],0,12,12,1638676,4,,,,2760
d422dcdd11a177d0f0b1d56d4320d00430ff8b8b,0,Grant Henke,2020-11-04 14:15:44+00:00,['dbbc48893a743bb5d96a7b17007450f1a94463cb'],27,27,54,1638730,5,,,,2760
85b7095d5fdabae75e4d5136ebc93b29e0322e8b,0,Grant Henke,2020-11-09 14:01:50+00:00,['d422dcdd11a177d0f0b1d56d4320d00430ff8b8b'],1,1,2,1638732,1,,,,2760
07cdc32eb70303a1abc628d14669c3208ab202cc,0,Grant Henke,2020-11-09 14:01:57+00:00,['85b7095d5fdabae75e4d5136ebc93b29e0322e8b'],2,104,106,1638838,6,0.954545455,0.954545455,0.863636364,2760
7fbe341e51a9e4245d8b3017cecf11e393c3a22b,0,Grant Henke,2020-11-09 15:07:15+00:00,['07cdc32eb70303a1abc628d14669c3208ab202cc'],5,83,88,1638926,4,0.056603774,0.566037736,0.754716981,2760
5faf79726605e3a5d8b33bd18ce94c8c09241d3f,0,Grant Henke,2020-11-09 15:07:36+00:00,['7fbe341e51a9e4245d8b3017cecf11e393c3a22b'],4,26,30,1638956,2,0.571428571,0.571428571,0.571428571,2760
3c6438d94b9d71ad97c15b8b44893631fe4b66a9,0,Andrew Wong,2020-11-09 18:28:08+00:00,['5faf79726605e3a5d8b33bd18ce94c8c09241d3f'],4,5,9,1638965,1,0,0,1,2760
75bb0ea1b1a543a32d87b0f14671aa9eb7571dfb,0,Alexey Serbin,2020-11-10 00:46:37+00:00,['3c6438d94b9d71ad97c15b8b44893631fe4b66a9'],9,12,21,1638986,3,0,0.8,0,2760
6a7cadc7eddeaaa374971d5ba16fec8422e33db9,0,Andrew Wong,2020-11-12 06:58:44+00:00,['75bb0ea1b1a543a32d87b0f14671aa9eb7571dfb'],26,552,578,1639564,11,0.065753425,0.915068493,0.819178082,2760
7caa088462e6fccd50ef62434c1d4eca1f4c16c9,0,Andrew Wong,2020-11-12 18:41:56+00:00,['6a7cadc7eddeaaa374971d5ba16fec8422e33db9'],10,5,15,1639579,1,,,,2760
6d9f257ad48c11a4546545dee096c484623cc392,0,Alexey Serbin,2020-11-13 22:52:19+00:00,['7caa088462e6fccd50ef62434c1d4eca1f4c16c9'],17,53,70,1639649,1,0,0,0,2760
3cdc56dce7e548ddf08c2ebe15036491ce3cfb98,0,Attila Bukor,2020-11-14 11:34:55+00:00,['6d9f257ad48c11a4546545dee096c484623cc392'],2,10,12,1639661,1,,,,2760
fab3a38d1da0d5d13d8e9c91fd306e03b65da4e6,0,Grant Henke,2020-11-16 19:25:53+00:00,['3cdc56dce7e548ddf08c2ebe15036491ce3cfb98'],3,68,71,1639732,3,0.394736842,0,1,2760
d1285eb3855ca1125dab4aac318e8acaf3edf58a,0,Grant Henke,2020-11-17 03:48:50+00:00,['fab3a38d1da0d5d13d8e9c91fd306e03b65da4e6'],0,9,9,1639741,1,0.75,1,1,2760
a026b5fbbabf067cb65f7228daaa7dabbe87996e,0,Grant Henke,2020-11-17 03:51:57+00:00,['d1285eb3855ca1125dab4aac318e8acaf3edf58a'],96,13,109,1639850,6,0.333333333,1,0.095238095,2760
0f133b9aed0dcf5622361fdfdd67f1bdff26809d,0,Alexey Serbin,2020-11-17 04:58:08+00:00,['a026b5fbbabf067cb65f7228daaa7dabbe87996e'],13,23,36,1639886,3,1,,,2760
0df4eaaa6590aabfc212c2faa5c73db00c9452fb,0,Alexey Serbin,2020-11-17 17:36:53+00:00,['0f133b9aed0dcf5622361fdfdd67f1bdff26809d'],1,3,4,1639890,1,0,1,1,2760
38aee4b1407b04b8c299768be0ae40d84a8e2a3a,0,Alexey Serbin,2020-11-18 19:40:17+00:00,['0df4eaaa6590aabfc212c2faa5c73db00c9452fb'],23,1430,1453,1641343,12,0.197101449,0.807246377,0.836231884,2764
2d0631fe289968094c9dc6a7b16fcc6df9a269ba,0,Alexey Serbin,2020-11-18 19:40:24+00:00,['38aee4b1407b04b8c299768be0ae40d84a8e2a3a'],29,78,107,1641450,11,0,0.766666667,0.5,2764
a3e6b9f2e6ed5356080df5a4f372f58734db070e,0,Grant Henke,2020-11-19 00:52:43+00:00,['2d0631fe289968094c9dc6a7b16fcc6df9a269ba'],0,9,9,1641459,1,,,,2764
0c6afda4ce30703fdb49248d0ac4a8fdd89be466,0,Alexey Serbin,2020-11-20 04:18:39+00:00,['a3e6b9f2e6ed5356080df5a4f372f58734db070e'],1,15,16,1641475,3,0.666666667,1,1,2764
fd7a40367a81555230eac62a1a8d1467433ed100,0,Andrew Wong,2020-11-20 04:33:47+00:00,['0c6afda4ce30703fdb49248d0ac4a8fdd89be466'],221,1351,1572,1643047,23,0.181112549,0.492884864,0.636481242,2764
b1ec07c0e13d24d096dfc3baf4f8e6710652d8d1,0,Andrew Wong,2020-11-21 01:27:00+00:00,['fd7a40367a81555230eac62a1a8d1467433ed100'],0,26,26,1643073,1,0.933333333,1,1,2764
88d4edfc66d728a643ed2e40959156686b06a8df,0,Andrew Wong,2020-11-21 01:27:02+00:00,['b1ec07c0e13d24d096dfc3baf4f8e6710652d8d1'],1,1,2,1643075,1,,,,2764
0faa2a6fbea19ae91e5bd9fe0f6c16d58137e475,0,Alexey Serbin,2020-11-23 02:24:59+00:00,['88d4edfc66d728a643ed2e40959156686b06a8df'],1,1,2,1643077,1,,,,2764
2161ef77de6626488630da7a99633aeec6b68595,0,Alexey Serbin,2020-11-23 06:41:08+00:00,['0faa2a6fbea19ae91e5bd9fe0f6c16d58137e475'],5,27,32,1643109,2,0,0,0,2764
89bac5989e3582afb791cedf494443a7c934dade,0,Alexey Serbin,2020-11-24 03:52:55+00:00,['2161ef77de6626488630da7a99633aeec6b68595'],9,16,25,1643134,1,,,,2764
b7aa01f8687d2f7f3b1478bb7824dec056ded18c,0,Grant Henke,2020-11-24 19:27:00+00:00,['89bac5989e3582afb791cedf494443a7c934dade'],0,4,4,1643138,1,1,1,1,2764
e0a439ba75e6ded0921b3da0c430fd8e1f7d5128,0,Grant Henke,2020-11-24 20:36:29+00:00,['b7aa01f8687d2f7f3b1478bb7824dec056ded18c'],7,4,11,1643149,3,,,,2764
fd863bb674c01bc792571032f7233ed45e9c9b12,0,Grant Henke,2020-11-25 17:43:37+00:00,['e0a439ba75e6ded0921b3da0c430fd8e1f7d5128'],2,2,4,1643153,2,,,,2764
64592274ac4ee5bff4c01807602e6e39714a0f80,0,Andrew Wong,2020-11-26 02:12:52+00:00,['fd863bb674c01bc792571032f7233ed45e9c9b12'],23,290,313,1643466,5,0.0625,0.99375,0.99375,2764
39dba1fd2272b7508043b4fa52066d6123132f4e,0,Alexey Serbin,2020-11-26 06:23:49+00:00,['64592274ac4ee5bff4c01807602e6e39714a0f80'],4,69,73,1643539,4,0.481481481,0.481481481,1,2764
4c661c78dcf87025032542fbbc8476e088138b23,0,Alexey Serbin,2020-11-28 22:23:50+00:00,['39dba1fd2272b7508043b4fa52066d6123132f4e'],1,1,2,1643541,1,,,,2764
42425c044078a904089f360b0fd5e0c81d88dc2d,0,Alexey Serbin,2020-11-28 22:23:57+00:00,['4c661c78dcf87025032542fbbc8476e088138b23'],40,46,86,1643627,3,0,1,1,2764
f47caaf3ee4339f5e34b9ad75ba4cbcef686c508,0,Andrew Wong,2020-11-29 04:55:43+00:00,['42425c044078a904089f360b0fd5e0c81d88dc2d'],44,18,62,1643689,8,0.52,0,0,2764
0e2c28864c27727c9723db7f319a5d7ebcbeead7,0,Grant Henke,2020-11-30 00:18:48+00:00,['f47caaf3ee4339f5e34b9ad75ba4cbcef686c508'],9,14,23,1643712,4,,,,2764
802057f3f243a6fa92c90b4da4c229307761762f,0,Alexey Serbin,2020-11-30 18:15:51+00:00,['0e2c28864c27727c9723db7f319a5d7ebcbeead7'],365,545,910,1644622,20,0.551020408,1,0.795918367,2764
6f807b136dfc072b019bdb4a5f1719603096898f,0,Andrew Wong,2020-11-30 18:23:20+00:00,['802057f3f243a6fa92c90b4da4c229307761762f'],62,132,194,1644816,3,0,1,1,2764
e432e637e282ba87d41c02088a801f0838571edc,0,Grant Henke,2020-11-30 19:29:58+00:00,['6f807b136dfc072b019bdb4a5f1719603096898f'],93,145,238,1645054,28,0,0.117647059,1,2765
3b984171bd4a249c4e848062d1e62d1e4c6a1b14,0,Alexey Serbin,2020-11-30 22:10:24+00:00,['e432e637e282ba87d41c02088a801f0838571edc'],3,3,6,1645060,1,,,,2765
17575e0b693cf97a6ec5d74e78d89343de4781eb,0,Andrew Wong,2020-12-01 01:32:25+00:00,['3b984171bd4a249c4e848062d1e62d1e4c6a1b14'],127,456,583,1645643,10,0,0.840163934,0.827868852,2765
05411bd8b365e975e02afa4777300c00559bc578,0,Alexey Serbin,2020-12-02 03:38:41+00:00,['17575e0b693cf97a6ec5d74e78d89343de4781eb'],0,8,8,1645651,1,,,,2765
5aacd6c64ddd2669005d0b3ca57801a7a7124033,0,Grant Henke,2020-12-02 15:53:26+00:00,['05411bd8b365e975e02afa4777300c00559bc578'],3,6,9,1645660,1,,,,2765
ef5b5abdcefbc5b7d7edb7170d55b82843926b25,0,Grant Henke,2020-12-02 18:34:18+00:00,['5aacd6c64ddd2669005d0b3ca57801a7a7124033'],4,3,7,1645667,1,1,1,0,2765
bd09924aa43bdb9701508d673fa088eb4f98217c,0,Grant Henke,2020-12-02 21:59:36+00:00,['ef5b5abdcefbc5b7d7edb7170d55b82843926b25'],1,9,10,1645677,1,,,,2765
420b07e6490e14f26107088bc1b09866b6d43bba,0,Andrew Wong,2020-12-03 06:09:11+00:00,['bd09924aa43bdb9701508d673fa088eb4f98217c'],7,33,40,1645717,6,1,1,1,2765
71941276d2dadd94397eabea30e357176e819d88,0,Alexey Serbin,2020-12-03 22:00:56+00:00,['420b07e6490e14f26107088bc1b09866b6d43bba'],1,7,8,1645725,1,0,1,1,2765
713fee390d0241bf466f490d5b2c678f7ebe5175,0,Grant Henke,2020-12-03 22:05:56+00:00,['71941276d2dadd94397eabea30e357176e819d88'],30,23,53,1645778,4,,,,2766
2943aa701ee092158c2084c614a91f92513ef7c4,0,Grant Henke,2020-12-03 22:06:00+00:00,['713fee390d0241bf466f490d5b2c678f7ebe5175'],455,43,498,1646276,10,,,,2766
2a558768f8aa00068e72ccd1327081f07ba46b03,1,Andrew Wong,2020-12-07 06:53:01+00:00,['2943aa701ee092158c2084c614a91f92513ef7c4'],51,508,559,1646835,5,0.269480519,1,0.698051948,2766
e5ec5b50e1f762f20e0716db4ef1aba10125a842,0,Grant Henke,2020-12-07 18:31:35+00:00,['2a558768f8aa00068e72ccd1327081f07ba46b03'],43,455,498,1647333,10,,,,2769
bd6c6dfe42cbc5c19117840ff8dfc4023fd6b8d0,0,Grant Henke,2020-12-07 19:49:15+00:00,['e5ec5b50e1f762f20e0716db4ef1aba10125a842'],0,277,277,1647610,1,,,,2769
3e6d061c0eff0cdc15a72682527ea4b04895f30c,0,Alexey Serbin,2020-12-08 07:44:09+00:00,['bd6c6dfe42cbc5c19117840ff8dfc4023fd6b8d0'],74,178,252,1647862,7,0,0.805970149,0.895522388,2769
3e02cce2f2a424529ca5c9a88017a40731acf974,0,Grant Henke,2020-12-08 18:24:47+00:00,['3e6d061c0eff0cdc15a72682527ea4b04895f30c'],1,1,2,1647864,1,,,,2769
70bce76af3008031e1dd9559bfa6dca1763d895f,0,Andrew Wong,2020-12-08 18:58:08+00:00,['3e02cce2f2a424529ca5c9a88017a40731acf974'],1,280,281,1648145,4,0.268867925,1,0.735849057,2769
be4fb8383eeda269234e99de07316b5ec422d403,1,Grant Henke,2020-12-08 20:07:10+00:00,['70bce76af3008031e1dd9559bfa6dca1763d895f'],108,164,272,1648417,22,0.558139535,1,1,2769
42e3ae332ab91a713a31c84acb3d256d9b23edd1,0,Grant Henke,2020-12-08 21:14:08+00:00,['be4fb8383eeda269234e99de07316b5ec422d403'],3,13,16,1648433,2,,,,2769
57c757d084956710143b8d85fddb4d6f1fc87211,0,Andrew Wong,2020-12-08 21:14:59+00:00,['42e3ae332ab91a713a31c84acb3d256d9b23edd1'],88,159,247,1648680,5,0,0.857142857,0.948051948,2769
ae45cd15c2703e3cfaf62aabb20ba79b961b3135,0,Alexey Serbin,2020-12-09 07:23:10+00:00,['57c757d084956710143b8d85fddb4d6f1fc87211'],15,65,80,1648760,4,0,1,1,2769
fa21bf61821199aedb4fbcdc1b09d0cf3ee56f51,0,Alexey Serbin,2020-12-11 06:18:46+00:00,['ae45cd15c2703e3cfaf62aabb20ba79b961b3135'],58,1023,1081,1649841,18,0.120879121,0.661172161,0.906593407,2770
78bb24126d4ba93272a35c08d2220c4de2b87f85,0,Grant Henke,2020-12-11 14:16:16+00:00,['fa21bf61821199aedb4fbcdc1b09d0cf3ee56f51'],3,7,10,1649851,1,,,,2770
2bf900dd26043edf026b59cba568503d33d8bd71,0,Grant Henke,2020-12-11 18:49:41+00:00,['78bb24126d4ba93272a35c08d2220c4de2b87f85'],7,12,19,1649870,1,0,0,0,2770
0ddb503ae4cb4e48329a23983bab8f553aaca887,0,Grant Henke,2020-12-11 21:52:00+00:00,['2bf900dd26043edf026b59cba568503d33d8bd71'],2,10,12,1649882,2,,,,2770
9197e2d5c96b94f227407e5c135c53f1b0182a65,0,Andrew Wong,2020-12-11 21:57:55+00:00,['0ddb503ae4cb4e48329a23983bab8f553aaca887'],114,582,696,1650578,2,0.034482759,0.144200627,0.492163009,2770
c1d1b9ccebe73bd60d3f6c8c8d8f9c3c426bdb6b,0,Alexey Serbin,2020-12-12 02:54:40+00:00,['9197e2d5c96b94f227407e5c135c53f1b0182a65'],5,3,8,1650586,1,1,1,0,2770
e75aad09a8dbe295a11cc2042903b74faf72623e,0,Alexey Serbin,2020-12-12 02:57:47+00:00,['c1d1b9ccebe73bd60d3f6c8c8d8f9c3c426bdb6b'],71,514,585,1651171,9,0.061904762,0.671428571,0.904761905,2770
b003609acc189e5443fbe4869ce7ab539b0cb0bc,0,Alexey Serbin,2020-12-12 05:09:59+00:00,['e75aad09a8dbe295a11cc2042903b74faf72623e'],27,58,85,1651256,6,0.5,1,0.9,2770
a05254904eff894261134674c246a6311c0adce4,0,Andrew Wong,2020-12-12 22:41:13+00:00,['b003609acc189e5443fbe4869ce7ab539b0cb0bc'],133,217,350,1651606,10,0,0.169491525,0.93220339,2770
7ecc6c7505000e7934ad4687c5987b6b6f0949b1,0,Grant Henke,2020-12-14 14:12:42+00:00,['a05254904eff894261134674c246a6311c0adce4'],670,2,672,1652278,3,,,,2770
808881ecae8bdb9f3b17733dbe15a5cec2475cc2,0,Grant Henke,2020-12-14 14:12:44+00:00,['7ecc6c7505000e7934ad4687c5987b6b6f0949b1'],1,2,3,1652281,1,,,,2770
fcd737e6ccedd5a91367dc119e773f0b1904b4fa,0,Alexey Serbin,2020-12-14 19:57:10+00:00,['808881ecae8bdb9f3b17733dbe15a5cec2475cc2'],36,64,100,1652381,6,0.277777778,0.722222222,0,2770
49c922b5cc3e5d7ee885c6f355eec973a5334441,0,Alexey Serbin,2020-12-15 02:19:29+00:00,['fcd737e6ccedd5a91367dc119e773f0b1904b4fa'],62,70,132,1652513,3,0,0.666666667,0.666666667,2770
59b3836a9a5b16fc68819a377cf8a5021a43b176,0,Andrew Wong,2020-12-15 07:06:29+00:00,['49c922b5cc3e5d7ee885c6f355eec973a5334441'],9,52,61,1652574,4,0.032258065,1,1,2770
de0a1df8efb141641d8e65846b45708261a7de6f,0,Alexey Serbin,2020-12-15 16:44:24+00:00,['59b3836a9a5b16fc68819a377cf8a5021a43b176'],10,17,27,1652601,1,,,,2770
7c2b003b1cf2a812be5d4de8d469ece27b2f3fc9,1,Andrew Wong,2020-12-15 20:13:52+00:00,['de0a1df8efb141641d8e65846b45708261a7de6f'],11,96,107,1652708,5,0,1,1,2770
dd6a1f830c0fe72d3ef3bc08d4685b6823c5e0c4,0,Grant Henke,2020-12-16 21:31:13+00:00,['7c2b003b1cf2a812be5d4de8d469ece27b2f3fc9'],0,6,6,1652714,1,,,,2770
ac75ea826f3a6f04bc31d0d487ae924917e64f8c,0,Alexey Serbin,2020-12-18 06:51:53+00:00,['dd6a1f830c0fe72d3ef3bc08d4685b6823c5e0c4'],1,95,96,1652810,2,0,1,1,2770
5b113b68645bd221414f9a975271df2fdc762c27,0,Alexey Serbin,2020-12-21 18:38:18+00:00,['ac75ea826f3a6f04bc31d0d487ae924917e64f8c'],0,7,7,1652817,1,,,,2770
cece57bcdf5d8d8ce596a3c1da4c2c26472784bc,0,Andrew Wong,2020-12-22 19:42:50+00:00,['5b113b68645bd221414f9a975271df2fdc762c27'],36,806,842,1653659,9,0.21691974,0.811279826,0.813449024,2772
2884df180c83b06652f93a6d1b1275ec2ed30f04,0,Grant Henke,2020-12-23 18:28:15+00:00,['cece57bcdf5d8d8ce596a3c1da4c2c26472784bc'],23,1,24,1653683,3,,,,2772
5b2287aa3c1a2858f918aec25054eb9ce523572e,0,Alexey Serbin,2021-01-04 16:30:14+00:00,['2884df180c83b06652f93a6d1b1275ec2ed30f04'],8,8,16,1653699,1,,,,2772
23ab89db1a1546d93fc3848052d076a9026b3068,0,Andrew Wong,2021-01-05 02:44:12+00:00,['5b2287aa3c1a2858f918aec25054eb9ce523572e'],47,254,301,1654000,7,0.093959732,0.543624161,0.624161074,2772
7f794e3ac8c389af4c74faeac11274e4ef0a55c0,0,Alexey Serbin,2021-01-05 18:48:19+00:00,['23ab89db1a1546d93fc3848052d076a9026b3068'],271,278,549,1654549,7,1,0.538461538,0.076923077,2772
df5e0231fce7d6b1e0cb66de16980cb73312b8f0,0,Alexey Serbin,2021-01-06 04:46:36+00:00,['7f794e3ac8c389af4c74faeac11274e4ef0a55c0'],1,1,2,1654551,1,,,,2772
b284a0acba30c48d20c34a55d576195e1d8e4d2b,0,Grant Henke,2021-01-06 15:08:21+00:00,['df5e0231fce7d6b1e0cb66de16980cb73312b8f0'],26,27,53,1654604,5,0,1,1,2772
e28b1c65b325b469eb624fda4cda3f7960d2a9eb,0,Bankim Bhavsar,2021-01-06 17:16:46+00:00,['b284a0acba30c48d20c34a55d576195e1d8e4d2b'],10,92,102,1654706,5,0.047619048,0.833333333,0.785714286,2772
737877d3456d1b031222ba4825b6913bafac8495,0,Grant Henke,2021-01-06 18:20:10+00:00,['e28b1c65b325b469eb624fda4cda3f7960d2a9eb'],16,92,108,1654814,5,,,,2774
5c19386ab45430665ce3852729525499c93fb4ff,0,Attila Bukor,2021-01-06 21:43:59+00:00,['737877d3456d1b031222ba4825b6913bafac8495'],0,3,3,1654817,1,,,,2774
ac391b621649e85cd202e53437a63cfbdedf5179,0,Alexey Serbin,2021-01-07 03:12:52+00:00,['5c19386ab45430665ce3852729525499c93fb4ff'],22,9,31,1654848,3,0.5,0,0.375,2774
47075a180ca46366a56af2ff97f65b199b4a1f4e,0,Bankim Bhavsar,2021-01-07 13:42:26+00:00,['ac391b621649e85cd202e53437a63cfbdedf5179'],140,299,439,1655287,2,0,1,1,2774
92b20a0f9bffa3a729795d130b338eaef995aa52,0,Grant Henke,2021-01-07 14:17:08+00:00,['47075a180ca46366a56af2ff97f65b199b4a1f4e'],3,113,116,1655403,5,0.8,1,1,2774
a60b4881aac6ba364e2c6f17c55fcbca647796bc,0,Grant Henke,2021-01-08 17:46:15+00:00,['92b20a0f9bffa3a729795d130b338eaef995aa52'],2,23,25,1655428,3,,,,2774
83b8caf4f1d60c021ef1e5a5f930847fb96c5ff4,0,Andrew Wong,2021-01-11 08:54:04+00:00,['a60b4881aac6ba364e2c6f17c55fcbca647796bc'],295,680,975,1656403,7,0.142857143,0.967261905,0.869047619,2774
b2e320497fe57e2202f4b6318d0898d4273d9fcc,0,Grant Henke,2021-01-11 15:02:30+00:00,['83b8caf4f1d60c021ef1e5a5f930847fb96c5ff4'],6,5,11,1656414,1,1,0,0,2774
9e4664d44ca994484d79d970e7c7e929d0dba055,0,Alexey Serbin,2021-01-11 16:12:05+00:00,['b2e320497fe57e2202f4b6318d0898d4273d9fcc'],132,174,306,1656720,2,0.15,0,1,2774
0c1445784343c546358dee3d909b832daed3f0f5,0,Grant Henke,2021-01-11 22:52:30+00:00,['9e4664d44ca994484d79d970e7c7e929d0dba055'],95,115,210,1656930,2,1,1,1,2774
72ab7ea3bbcb39383607a9de91ea80eb86cd3507,0,Attila Bukor,2021-01-13 13:08:06+00:00,['0c1445784343c546358dee3d909b832daed3f0f5'],6,36,42,1656972,1,,,,2774
929cb67da52f9bd30827527bb440b83d2260f608,0,Grant Henke,2021-01-13 18:02:04+00:00,['72ab7ea3bbcb39383607a9de91ea80eb86cd3507'],0,55,55,1657027,4,0,0.892857143,1,2774
90acf3eabfe1cb4992d96f33c5f981cc7c2d7f6d,0,Grant Henke,2021-01-13 19:53:48+00:00,['929cb67da52f9bd30827527bb440b83d2260f608'],34,49,83,1657110,1,0,0,0,2774
2880d3a0dc0fc07d20fab79f1d0df3a6a622e398,0,Alexey Serbin,2021-01-13 21:15:51+00:00,['90acf3eabfe1cb4992d96f33c5f981cc7c2d7f6d'],10,141,151,1657261,8,0.592592593,0.777777778,0,2776
6f5f100c8443353c007ecf375b76ba940c687f98,0,Alexey Serbin,2021-01-14 21:15:48+00:00,['2880d3a0dc0fc07d20fab79f1d0df3a6a622e398'],163,170,333,1657594,5,0,0,0,2776
1dc7c83dcab376ae25626c9095d3bf66341c4c2d,0,Alexey Serbin,2021-01-15 05:07:17+00:00,['6f5f100c8443353c007ecf375b76ba940c687f98'],1,414,415,1658009,3,0.847619048,1,0.876190476,2777
2a02629d8a2f06fbb063b57b0a539dd7cc9c02c8,0,Grant Henke,2021-01-18 04:42:47+00:00,['1dc7c83dcab376ae25626c9095d3bf66341c4c2d'],26,46,72,1658081,5,1,0,1,2778
55b10e82a62c21c6d9162f41483b956f28528d07,0,Grant Henke,2021-01-18 04:42:50+00:00,['2a02629d8a2f06fbb063b57b0a539dd7cc9c02c8'],0,22,22,1658103,4,,,,2778
62f19e71c8ab430cc4ce18af13b1d9ec0c9c8482,0,Grant Henke,2021-01-19 14:33:43+00:00,['55b10e82a62c21c6d9162f41483b956f28528d07'],29,29,58,1658161,2,,,,2778
c6a770ee54d5d5ef0861594476b40bb14cfe0623,0,Alexey Serbin,2021-01-19 20:07:45+00:00,['62f19e71c8ab430cc4ce18af13b1d9ec0c9c8482'],75,270,345,1658506,2,0.119047619,0.595238095,0.984126984,2778
dedc52a0226cb6d42481510f10cefb3c9f167d2a,0,Andrew Wong,2021-01-23 08:32:30+00:00,['c6a770ee54d5d5ef0861594476b40bb14cfe0623'],11,33,44,1658550,1,,,,2778
0ab94e91936d6b41f730e9b38c28c4bff44925c2,0,Alexey Serbin,2021-01-25 22:09:55+00:00,['dedc52a0226cb6d42481510f10cefb3c9f167d2a'],16,14,30,1658580,5,1,1,1,2778
202bcae7f12ca0d7ac43e0a07e57f3236c8f968d,0,Grant Henke,2021-01-26 15:25:56+00:00,['0ab94e91936d6b41f730e9b38c28c4bff44925c2'],2,13,15,1658595,3,,,,2778
922ab9e7d46f683a5e04b4e36b1af9b95e96e025,0,Grant Henke,2021-01-26 22:21:13+00:00,['202bcae7f12ca0d7ac43e0a07e57f3236c8f968d'],2,2,4,1658599,1,,,,2778
7432a7a8aa0c98f8d2177c25b99576b51ff33a93,0,Alexey Serbin,2021-01-28 03:55:13+00:00,['922ab9e7d46f683a5e04b4e36b1af9b95e96e025'],16,1200,1216,1659815,15,0.67047619,0.971428571,0.838095238,2787
6b39d88f11abd6e52cf91999aa66ce0642372599,0,Alexey Serbin,2021-01-28 04:59:26+00:00,['7432a7a8aa0c98f8d2177c25b99576b51ff33a93'],9,497,506,1660321,5,0.248,1,0.964,2789
43ec35847be54197fe0ca83123629a101088a396,0,Grant Henke,2021-01-28 15:36:18+00:00,['6b39d88f11abd6e52cf91999aa66ce0642372599'],0,197,197,1660518,1,,,,2789
cbb8db7711785e85e7c74fe86b93d7c1ba9c9c24,0,Alexey Serbin,2021-01-28 15:55:22+00:00,['43ec35847be54197fe0ca83123629a101088a396'],13,21,34,1660552,1,0,1,1,2789
0a6d5c57646f138e76df446dd22b79106e5e6648,0,Grant Henke,2021-01-28 17:35:11+00:00,['cbb8db7711785e85e7c74fe86b93d7c1ba9c9c24'],15,15,30,1660582,10,,,,2789
a62bfa305cd0d421183247349255b4032c56e7a3,0,Grant Henke,2021-01-28 17:35:15+00:00,['0a6d5c57646f138e76df446dd22b79106e5e6648'],9,9,18,1660600,3,,,,2789
b5e7362e69a5d7a9c9e88fa144e0366a2b22a83a,0,Grant Henke,2021-01-28 17:42:30+00:00,['a62bfa305cd0d421183247349255b4032c56e7a3'],8,7,15,1660615,2,,,,2789
948f92e787136f12dbfb3e7195fef24db0be0088,0,Andrew Wong,2021-01-28 18:55:32+00:00,['b5e7362e69a5d7a9c9e88fa144e0366a2b22a83a'],2,214,216,1660831,9,0.1,0.5,1,2789
c033487fd1765f9b3c5045d7c51719ed7e1c4418,0,Hao Hao,2021-01-31 06:53:19+00:00,['948f92e787136f12dbfb3e7195fef24db0be0088'],136,846,982,1661813,17,0.23019802,0.537128713,0.955445545,2789
8c5e655d2d29e7758f26a373ea240631722ea1cf,0,Andrew Wong,2021-01-31 21:27:39+00:00,['c033487fd1765f9b3c5045d7c51719ed7e1c4418'],19,123,142,1661955,5,0,0.472527473,0.714285714,2789
361f9aac615e9da021926cd5c82947a7f4b46320,1,Alexey Serbin,2021-02-01 15:51:23+00:00,['8c5e655d2d29e7758f26a373ea240631722ea1cf'],170,200,370,1662325,30,1,1,1,2789
3ac06337db360189539600ae4aa7c340a4ac8083,0,Alexey Serbin,2021-02-01 15:51:28+00:00,['361f9aac615e9da021926cd5c82947a7f4b46320'],4,7,11,1662336,1,,,,2789
2e580fe863b086cf16fd9d285dd56ba817f64cd3,0,Grant Henke,2021-02-02 15:43:33+00:00,['3ac06337db360189539600ae4aa7c340a4ac8083'],28,25,53,1662389,5,0.4,1,1,2789
7abbedf4db1dbc16253d626e3cb85fa66d118908,0,Grant Henke,2021-02-02 15:43:43+00:00,['2e580fe863b086cf16fd9d285dd56ba817f64cd3'],0,235,235,1662624,1,,,,2789
eba54241ab54fd8522fa7a48561000ec7917d7df,0,Hao Hao,2021-02-02 19:52:34+00:00,['7abbedf4db1dbc16253d626e3cb85fa66d118908'],3,4,7,1662631,2,0,0,0,2789
4a47e086a2edd37e725a12df7f8c11d9c8984ebd,0,Alexey Serbin,2021-02-04 17:26:50+00:00,['eba54241ab54fd8522fa7a48561000ec7917d7df'],3,3,6,1662637,1,,,,2789
b9a8f2e633af891b6e2b268a71e18a8e7e1ff34d,0,Andrew Wong,2021-02-05 07:20:29+00:00,['4a47e086a2edd37e725a12df7f8c11d9c8984ebd'],113,1366,1479,1664116,18,0.249329759,0.540214477,0.868632708,2790
546e68cfd39e2a6f1b16bd1ddb580d1ebc97c9a4,0,Hao Hao,2021-02-06 04:58:39+00:00,['b9a8f2e633af891b6e2b268a71e18a8e7e1ff34d'],7,8,15,1664131,1,0,1,1,2790
4b0524f0bf8e81c004dd3f03a2467e9b0824b617,0,Andrew Wong,2021-02-06 05:43:03+00:00,['546e68cfd39e2a6f1b16bd1ddb580d1ebc97c9a4'],1,2,3,1664134,1,,,,2790
70b69cc3c168e9f49a9aa62890fb3c095adeb78b,0,Andrew Wong,2021-02-06 05:43:05+00:00,['4b0524f0bf8e81c004dd3f03a2467e9b0824b617'],1,3,4,1664138,1,0,0,1,2790
d49085093f3b01a9ee1da6c37bdce0924ee536f2,0,Alexey Serbin,2021-02-06 05:43:57+00:00,['70b69cc3c168e9f49a9aa62890fb3c095adeb78b'],70,72,142,1664280,1,0,1,0,2790
d30dbd205fb7c59444a6adcdd670eefd048fb8b0,0,Alexey Serbin,2021-02-08 18:54:28+00:00,['d49085093f3b01a9ee1da6c37bdce0924ee536f2'],6,53,59,1664339,2,1,1,1,2790
1a998fe71dcf174efd12244f4580111e29037bfc,0,Alexey Serbin,2021-02-08 21:38:31+00:00,['d30dbd205fb7c59444a6adcdd670eefd048fb8b0'],24,35,59,1664398,1,0,0,1,2790
3c363d499ec5c0d675d78d871712e579d966548c,0,Bankim Bhavsar,2021-02-08 22:26:33+00:00,['1a998fe71dcf174efd12244f4580111e29037bfc'],38,575,613,1665011,10,0.179941003,0.474926254,0.687315634,2790
9592762f175c068ba6c1b8e4458871fb78153e68,0,Alexey Serbin,2021-02-09 05:01:37+00:00,['3c363d499ec5c0d675d78d871712e579d966548c'],146,49,195,1665206,8,0,0,0,2790
7afdac0155f1c0730242594b6d13a549c3084d5d,0,Andrew Wong,2021-02-09 21:35:05+00:00,['9592762f175c068ba6c1b8e4458871fb78153e68'],20,27,47,1665253,3,0.75,0.25,0.5,2790
49f2a734e773de836ba714dff38a99f41d608788,0,Grant Henke,2021-02-10 02:12:07+00:00,['7afdac0155f1c0730242594b6d13a549c3084d5d'],1,1,2,1665255,1,,,,2790
cb6e0112909bd66127efae6bc2210869940e77c8,0,Grant Henke,2021-02-10 03:49:49+00:00,['49f2a734e773de836ba714dff38a99f41d608788'],1,8,9,1665264,1,1,1,1,2790
37bc427a60f9cb3ab687d3610b50199f12875a08,0,Grant Henke,2021-02-10 03:49:58+00:00,['cb6e0112909bd66127efae6bc2210869940e77c8'],0,29,29,1665293,4,0.4,0.7,0.7,2790
32c5b9c60bc923e27f0a4c78508fc3e2d1276e28,0,Alexey Serbin,2021-02-10 03:56:01+00:00,['37bc427a60f9cb3ab687d3610b50199f12875a08'],4,19,23,1665316,5,0.2,0.4,1,2790
451a4c61eed132e00b6dc50dcaf4cfeca348be2a,0,Andrew Wong,2021-02-10 04:00:33+00:00,['32c5b9c60bc923e27f0a4c78508fc3e2d1276e28'],59,420,479,1665795,12,0.046428571,0.514285714,0.839285714,2790
9fa923947c461325fafb28496903905413a58564,0,Grant Henke,2021-02-10 19:17:25+00:00,['451a4c61eed132e00b6dc50dcaf4cfeca348be2a'],1,1,2,1665797,1,,,,2790
da2890729a51276b367783f06d792dbddffaf49d,0,Alexey Serbin,2021-02-10 20:03:15+00:00,['9fa923947c461325fafb28496903905413a58564'],0,6,6,1665803,1,,,,2790
9acdc525c6816ab83ad71f25220c428792fe36ad,0,Bankim Bhavsar,2021-02-10 23:16:56+00:00,['da2890729a51276b367783f06d792dbddffaf49d'],24,24,48,1665851,24,,,,2790
fd6d1e19f40e8cf67545cbe910b7e689eba73bde,0,Alexey Serbin,2021-02-11 02:16:46+00:00,['9acdc525c6816ab83ad71f25220c428792fe36ad'],0,118,118,1665969,3,0,1,1,2790
fa5fdd8532efa3a634eaba1fea4552f66d881623,0,Alexey Serbin,2021-02-12 15:32:09+00:00,['fd6d1e19f40e8cf67545cbe910b7e689eba73bde'],3,2,5,1665974,2,1,1,0,2790
7b0648f1520eef768368ed8b4924f4bb560d41a9,0,Grant Henke,2021-02-12 18:33:28+00:00,['fa5fdd8532efa3a634eaba1fea4552f66d881623'],1,8,9,1665983,1,,,,2790
36c5a2e29e95e9133adbaf8e1b82d4bdc8d74435,0,Alexey Serbin,2021-02-16 06:04:10+00:00,['7b0648f1520eef768368ed8b4924f4bb560d41a9'],23,65,88,1666071,2,0.181818182,0.272727273,1,2790
a1ea45ecb5ca7ab8d257a6b22a36fb85ca9353d6,0,Alexey Serbin,2021-02-16 06:04:13+00:00,['36c5a2e29e95e9133adbaf8e1b82d4bdc8d74435'],1,1,2,1666073,1,,,,2790
67018be8ba27480b050c11504df8a732f6a52daf,0,Alexey Serbin,2021-02-16 19:18:36+00:00,['a1ea45ecb5ca7ab8d257a6b22a36fb85ca9353d6'],0,1,1,1666074,1,0,1,1,2790
0bda51a9b851f0692f757d743548a823f9f1888b,0,Alexey Serbin,2021-02-16 19:18:39+00:00,['67018be8ba27480b050c11504df8a732f6a52daf'],2,1,3,1666077,1,1,1,0,2790
b73f75927f703eb7a5fbaaed525fd9c6b8c140f1,0,Andrew Wong,2021-02-17 01:37:18+00:00,['0bda51a9b851f0692f757d743548a823f9f1888b'],8,4,12,1666089,3,1,0,0,2790
f24ec6a7757af421f6da3e5f4b93f3a6761d23bb,0,Andrew Wong,2021-02-17 02:30:35+00:00,['b73f75927f703eb7a5fbaaed525fd9c6b8c140f1'],1,4,5,1666094,1,,,,2790
4a88bdeb603888b1217581b5c1f868059d7d86f3,0,Alexey Serbin,2021-02-17 21:40:58+00:00,['f24ec6a7757af421f6da3e5f4b93f3a6761d23bb'],1,1,2,1666096,1,,,,2790
df61b71f0093008f6f2cdc88b4380a575f42bf18,0,Bankim Bhavsar,2021-02-19 20:08:51+00:00,['4a88bdeb603888b1217581b5c1f868059d7d86f3'],62,241,303,1666399,8,0,0,0.754098361,2790
645f9dc72f62bc4cca8f59f9e043c37586e87f63,0,Bankim Bhavsar,2021-02-19 20:08:55+00:00,['df61b71f0093008f6f2cdc88b4380a575f42bf18'],56,141,197,1666596,5,0.035714286,1,0.660714286,2790
91f332a6936b8f9efd5e4a53768d4489f6ba79e1,0,Alexey Serbin,2021-02-20 07:25:09+00:00,['645f9dc72f62bc4cca8f59f9e043c37586e87f63'],11,16,27,1666623,1,0.5,0.5,1,2790
e74cdb3f8c33212618c090d90075b8d928f942f7,0,Bankim Bhavsar,2021-02-22 05:34:52+00:00,['91f332a6936b8f9efd5e4a53768d4489f6ba79e1'],396,371,767,1667390,99,,,,2790
78bd6c04ef37ca8906379a587140bc646433e28c,0,Bankim Bhavsar,2021-02-22 05:34:59+00:00,['e74cdb3f8c33212618c090d90075b8d928f942f7'],304,86,390,1667780,37,1,1,0,2790
28f30f0eb70421feee8d4e7b775483d47e9ce888,0,Bankim Bhavsar,2021-02-22 22:03:19+00:00,['78bd6c04ef37ca8906379a587140bc646433e28c'],17,40,57,1667837,1,0,0.266666667,1,2790
d7b5abc027d492a60ebf5059b27541fc04cfaab3,0,Andrew Wong,2021-02-24 00:08:09+00:00,['28f30f0eb70421feee8d4e7b775483d47e9ce888'],5,172,177,1668014,2,0,0.897637795,0.897637795,2790
f16973890c31042ec5770e2735708577b8192959,0,Bankim Bhavsar,2021-02-24 05:33:47+00:00,['d7b5abc027d492a60ebf5059b27541fc04cfaab3'],6,34,40,1668054,3,0,0,1,2790
1d3cb5cba6fa09d646af3e93ce92632b129cab27,0,Alexey Serbin,2021-02-24 05:51:01+00:00,['f16973890c31042ec5770e2735708577b8192959'],9,9,18,1668072,3,,,,2790
71871acbb802a22f145236d9e744ffa18afc77c3,0,Grant Henke,2021-02-25 19:29:08+00:00,['1d3cb5cba6fa09d646af3e93ce92632b129cab27'],3,3,6,1668078,1,,,,2790
1ba4a4b767ef62d1182d7091043a42cd0a1ac970,0,Alexey Serbin,2021-02-26 03:09:42+00:00,['71871acbb802a22f145236d9e744ffa18afc77c3'],42,105,147,1668225,1,0,0.319148936,0.914893617,2790
930fe5bf8f02f97061bddcfa4199ab5a25f15419,0,Andrew Wong,2021-02-26 21:56:53+00:00,['1ba4a4b767ef62d1182d7091043a42cd0a1ac970'],22,173,195,1668420,7,0,0.847222222,0.388888889,2790
70e0998fb1003763e596595c1b3ebb57c3d32bf3,0,Andrew Wong,2021-02-26 22:03:02+00:00,['930fe5bf8f02f97061bddcfa4199ab5a25f15419'],27,33,60,1668480,3,,,,2790
3faeb3d9c6c87e4d6815e06945f331a4a14402ba,0,Andrew Wong,2021-02-26 22:07:40+00:00,['70e0998fb1003763e596595c1b3ebb57c3d32bf3'],3,3,6,1668486,2,,,,2790
38bad954c2d903a8a61ddd728f8c58dc00412925,0,Alexey Serbin,2021-02-26 22:13:18+00:00,['3faeb3d9c6c87e4d6815e06945f331a4a14402ba'],3,15,18,1668504,1,0,1,1,2790
e9ea9840d30cc223e3a8f746169c11353e23ffa8,0,Andrew Wong,2021-02-27 00:19:27+00:00,['38bad954c2d903a8a61ddd728f8c58dc00412925'],81,608,689,1669193,5,0.149501661,0.624584718,0.707641196,2790
9c0cd1a6b4a3a35040b0cd4f5e9524cdb855d059,0,Alexey Serbin,2021-03-01 17:03:22+00:00,['e9ea9840d30cc223e3a8f746169c11353e23ffa8'],7,8,15,1669208,1,,,,2790
8b2bd18c6624301ad45ce361c90bfd29691afea7,0,Alexey Serbin,2021-03-02 02:37:54+00:00,['9c0cd1a6b4a3a35040b0cd4f5e9524cdb855d059'],30,45,75,1669283,1,0,1,1,2790
ceca6abc506fc4c1012ced6e8a6564897b3af4ad,0,Alexey Serbin,2021-03-02 23:07:34+00:00,['8b2bd18c6624301ad45ce361c90bfd29691afea7'],127,2318,2445,1671728,12,0.149517685,0.798231511,0.942926045,2791
740e9150d7072d95599951ee998df58d8ffe55b6,0,Alexey Serbin,2021-03-03 00:54:40+00:00,['ceca6abc506fc4c1012ced6e8a6564897b3af4ad'],1,190,191,1671919,1,0.084507042,0.084507042,1,2791
8858c02ba7cfcb5f4e501d1726b5ef3819d61424,0,Grant Henke,2021-03-03 18:08:36+00:00,['740e9150d7072d95599951ee998df58d8ffe55b6'],1,1,2,1671921,1,,,,2791
c167c1dc39d7089c4b1216bc62e423f3e2638479,0,Andrew Wong,2021-03-06 23:33:22+00:00,['8858c02ba7cfcb5f4e501d1726b5ef3819d61424'],4,59,63,1671984,3,0,1,1,2791
b3136bd43fbf98b76f4d45ac6112e90c5a926929,0,Alexey Serbin,2021-03-07 06:23:54+00:00,['c167c1dc39d7089c4b1216bc62e423f3e2638479'],98,73,171,1672155,1,1,0,0,2791
c89ec08d6a9e92f15d7c6846fae57f82d0616eb8,0,Alexey Serbin,2021-03-08 06:43:34+00:00,['b3136bd43fbf98b76f4d45ac6112e90c5a926929'],116,60,176,1672331,14,1,1,0,2791
4897758e83764086939ad575a42dc1b403bd49e8,0,Alexey Serbin,2021-03-08 06:55:42+00:00,['c89ec08d6a9e92f15d7c6846fae57f82d0616eb8'],16,0,16,1672347,1,1,1,1,2791
074e7e9a08d3aa392df068e23c425326161cf38b,0,Alexey Serbin,2021-03-08 18:24:03+00:00,['4897758e83764086939ad575a42dc1b403bd49e8'],2,239,241,1672588,2,0,0.105882353,0.888235294,2791
4abb4eae4375fd25fa21c5a4469937cca4795672,0,Alexey Serbin,2021-03-09 04:07:08+00:00,['074e7e9a08d3aa392df068e23c425326161cf38b'],5,3,8,1672596,1,,,,2791
29f294c3d6f998830b12fe675af70dba610ce34d,0,Attila Bukor,2021-03-09 21:27:09+00:00,['4abb4eae4375fd25fa21c5a4469937cca4795672'],202,196,398,1672994,3,0,0,0,2791
de5378ba4b454e9b696f6dbee8d4e3f95bf2a5a6,0,Grant Henke,2021-03-10 15:25:14+00:00,['29f294c3d6f998830b12fe675af70dba610ce34d'],1,1,2,1672996,1,,,,2791
8ebe032847f618d76459b59c84b150c997016ee9,0,Andrew Wong,2021-03-12 01:05:09+00:00,['de5378ba4b454e9b696f6dbee8d4e3f95bf2a5a6'],14,43,57,1673053,3,0.6875,0.875,1,2791
fae223ecb139e0f54161279ee8970098067629c9,0,Andrew Wong,2021-03-12 05:28:49+00:00,['8ebe032847f618d76459b59c84b150c997016ee9'],10,43,53,1673106,3,0.071428571,1,0.464285714,2791
4b4a8c0f2fdfd15524510821b27fc9c3b5d26b6b,0,Bankim Bhavsar,2021-03-15 16:41:36+00:00,['fae223ecb139e0f54161279ee8970098067629c9'],163,328,491,1673597,1,0.0625,1,0.025,2791
83f1f367b12893b71f928a1b91e23b0088ee1cd4,0,Bankim Bhavsar,2021-03-15 21:27:55+00:00,['4b4a8c0f2fdfd15524510821b27fc9c3b5d26b6b'],2,5,7,1673604,2,1,1,1,2791
f69a05487ec15635395cbd88ad4287412813a4e4,0,Alexey Serbin,2021-03-16 16:26:29+00:00,['83f1f367b12893b71f928a1b91e23b0088ee1cd4'],1,1,2,1673606,1,0,0,0,2791
de0e0ef1b35fe666f46139510d11721ea9183dc4,0,Alexey Serbin,2021-03-18 16:21:17+00:00,['f69a05487ec15635395cbd88ad4287412813a4e4'],3,3,6,1673612,2,,,,2791
bdeaa122f6b14c41b3640ab5d575b11d4c5ffe1c,1,Alexey Serbin,2021-03-18 16:21:23+00:00,['de0e0ef1b35fe666f46139510d11721ea9183dc4'],63,84,147,1673759,8,0.684210526,0,0.894736842,2791
5966364d4c022507faa7f51e2ffed154ed3bb167,1,Alexey Serbin,2021-03-18 16:21:38+00:00,['bdeaa122f6b14c41b3640ab5d575b11d4c5ffe1c'],0,9,9,1673768,1,0,0,1,2791
6f4c534a08c78184330f8b44416e2b4d8b6c6ccc,1,Alexey Serbin,2021-03-18 16:23:19+00:00,['5966364d4c022507faa7f51e2ffed154ed3bb167'],20,98,118,1673886,5,0.1,1,0.96,2791
c4e30bfe4d67e7cc8b6b29abdc5ffb1f3143336d,0,Grant Henke,2021-03-18 19:23:37+00:00,['6f4c534a08c78184330f8b44416e2b4d8b6c6ccc'],6,2,8,1673894,1,,,,2791
f8d060bd1d9066b0a6d4afa9bd7eb4d4f082037f,0,Grant Henke,2021-03-19 13:04:01+00:00,['c4e30bfe4d67e7cc8b6b29abdc5ffb1f3143336d'],6023,7,6030,1679924,39,0.605130198,0.286436067,0.219976681,2791
fc739b91e0c414bfbcd71669518801484fd021c0,0,Alexey Serbin,2021-03-19 17:40:29+00:00,['f8d060bd1d9066b0a6d4afa9bd7eb4d4f082037f'],3,11,14,1679938,1,,,,2791
bd84107015ebff513c65f524f7a2234744044560,0,Grant Henke,2021-03-21 01:19:58+00:00,['fc739b91e0c414bfbcd71669518801484fd021c0'],21,23,44,1679982,5,,,,2791
a0db990e08173293e42a7490322f08681abaa5d3,0,Andrew Wong,2021-03-21 05:31:30+00:00,['bd84107015ebff513c65f524f7a2234744044560'],0,1,1,1679983,1,0,0,0,2791
32eca230f5c0198113568f87c8d54e08579ee0e7,0,Alexey Serbin,2021-03-22 18:13:09+00:00,['a0db990e08173293e42a7490322f08681abaa5d3'],11,19,30,1680013,2,,,,2791
d0c0483a15db03c2bb4217d9c9ce15e39c858629,0,Alexey Serbin,2021-03-23 02:23:18+00:00,['32eca230f5c0198113568f87c8d54e08579ee0e7'],2,25,27,1680040,1,0.5,0.5,1,2791
93c1a743c4d60c63588ad7cc6b071e7ead707458,1,Alexey Serbin,2021-03-23 06:45:03+00:00,['d0c0483a15db03c2bb4217d9c9ce15e39c858629'],169,117,286,1680326,8,0,0,0,2791
ac09d6205486908df05af4d64dc7618aae7c37bf,0,Bankim Bhavsar,2021-03-23 16:43:56+00:00,['93c1a743c4d60c63588ad7cc6b071e7ead707458'],3,13,16,1680342,1,0,0,1,2791
058ec9a2baa9edb75904e8aa83716dd2734f3bbd,0,Andrew Wong,2021-03-23 17:50:35+00:00,['ac09d6205486908df05af4d64dc7618aae7c37bf'],166,681,847,1681189,11,0,0.433021807,0.875389408,2791
6983d25c35df8569c1851bf27e2c75e98036c10d,0,Andrew Wong,2021-03-23 19:33:28+00:00,['058ec9a2baa9edb75904e8aa83716dd2734f3bbd'],16,540,556,1681745,4,0.330033003,0.716171617,0.792079208,2791
44d687caf3633d75b0cc64f1a25f444484ce43ad,0,Alexey Serbin,2021-03-24 16:09:36+00:00,['6983d25c35df8569c1851bf27e2c75e98036c10d'],5,12,17,1681762,1,0.5,0.833333333,0.5,2791
1eb2a2fbca329721ec7152714b7c95374754044b,0,Alexey Serbin,2021-03-25 17:17:14+00:00,['44d687caf3633d75b0cc64f1a25f444484ce43ad'],10,11,21,1681783,1,0,0,0,2791
1dfd0253d375b3012b0cd67a93dd111871814a0c,0,Alexey Serbin,2021-03-29 23:48:22+00:00,['1eb2a2fbca329721ec7152714b7c95374754044b'],14,19,33,1681816,2,0,0.25,0.25,2791
c2b4eb2b65edd0911916d54fcda1208134f902a6,0,Alexey Serbin,2021-03-31 16:18:19+00:00,['1dfd0253d375b3012b0cd67a93dd111871814a0c'],1,1,2,1681818,1,,,,2791
72489cd65885af731b73d180596bf7854273f891,0,Bankim Bhavsar,2021-03-31 20:00:49+00:00,['c2b4eb2b65edd0911916d54fcda1208134f902a6'],17,11,28,1681846,3,1,0,0,2791
ed3d916e92decf7333f4200e88c93fbcc211404d,0,Bankim Bhavsar,2021-03-31 20:00:56+00:00,['72489cd65885af731b73d180596bf7854273f891'],2,21,23,1681869,2,0,1,1,2791
6be9794f91a2eebb291e4db2daf63a0f12c3ae2a,0,Andrew Wong,2021-04-03 04:31:44+00:00,['ed3d916e92decf7333f4200e88c93fbcc211404d'],54,119,173,1682042,6,0,0.914893617,1,2791
78fb2047da74a1ebd051dbfa29c4d188056b47bc,0,Andrew Wong,2021-04-03 04:31:46+00:00,['6be9794f91a2eebb291e4db2daf63a0f12c3ae2a'],96,94,190,1682232,10,0,0.75,0.1875,2791
879c1dd50c72e160041478543e7e1362bb17bd27,0,Alexey Serbin,2021-04-05 16:12:34+00:00,['78fb2047da74a1ebd051dbfa29c4d188056b47bc'],130,0,130,1682362,8,,,,2791
c79560adb09b26da0037f3e018c0154fadf2105c,0,Alexey Serbin,2021-04-06 16:59:56+00:00,['879c1dd50c72e160041478543e7e1362bb17bd27'],2,2,4,1682366,1,,,0,2791
7c99e8178f5d3edf7cae627a2403e59903360819,0,Alexey Serbin,2021-04-06 17:00:03+00:00,['c79560adb09b26da0037f3e018c0154fadf2105c'],1,1,2,1682368,1,,,,2791
83c97c0e35b8bd7a2f871e18fec685355dbbbd9b,0,Andrew Wong,2021-04-07 05:58:04+00:00,['7c99e8178f5d3edf7cae627a2403e59903360819'],4,11,15,1682383,1,0,0,1,2791
df6590d26de51d67e178c59b50dfcda6ea1244a7,0,Alexey Serbin,2021-04-07 14:51:35+00:00,['83c97c0e35b8bd7a2f871e18fec685355dbbbd9b'],99,529,628,1683011,13,0.155778894,0.673366834,0.929648241,2791
0e1a1545b827d9a3d5d50fd3d54f60bdea83f40c,0,Alexey Serbin,2021-04-07 14:51:39+00:00,['df6590d26de51d67e178c59b50dfcda6ea1244a7'],34,303,337,1683348,3,0.264705882,0.480392157,1,2792
c2e5373493afe43766b0d5b6f04dfbcd340d633d,0,Andrew Wong,2021-04-08 05:51:41+00:00,['0e1a1545b827d9a3d5d50fd3d54f60bdea83f40c'],5,15,20,1683368,1,1,1,1,2792
6aeb466c538d8cc566031c4a82200f18f088e18a,0,Andrew Wong,2021-04-09 00:35:03+00:00,['c2e5373493afe43766b0d5b6f04dfbcd340d633d'],2,25,27,1683395,2,0.666666667,0.666666667,1,2792
d546588da6d90c72a8dfcb8256e2a898ab55e96d,0,Attila Bukor,2021-04-09 13:52:04+00:00,['6aeb466c538d8cc566031c4a82200f18f088e18a'],33,143,176,1683571,12,0.774647887,0.323943662,0.718309859,2792
e69b3c652d0c21393015aad8e5acd5ece2098573,0,Attila Bukor,2021-04-09 13:52:13+00:00,['d546588da6d90c72a8dfcb8256e2a898ab55e96d'],12,92,104,1683675,8,0.363636364,0.954545455,0.704545455,2792
308673dea705a3c4216e3e967b75eea70f39a850,0,Attila Bukor,2021-04-09 13:52:18+00:00,['e69b3c652d0c21393015aad8e5acd5ece2098573'],1,6,7,1683682,2,,,,2792
ccbbfb3006314f2c37f3a40bfec355db9fc90e02,0,Grant Henke,2021-04-09 14:49:50+00:00,['308673dea705a3c4216e3e967b75eea70f39a850'],19,105,124,1683806,7,0.12,1,0.8,2792
ea370f12d6c3f9fe8de9d3e7e7e8fda1d3cad7ca,0,Andrew Wong,2021-04-09 21:25:05+00:00,['ccbbfb3006314f2c37f3a40bfec355db9fc90e02'],11,25,36,1683842,1,0,0,1,2792
0a32542ca5669c842e91b1b736d108a7ae84ec5c,0,Alexey Serbin,2021-04-09 23:01:31+00:00,['ea370f12d6c3f9fe8de9d3e7e7e8fda1d3cad7ca'],5,177,182,1684024,3,0,1,1,2792
0767c0ad1b2d84cdcf958484bfe88adbe15ddf60,0,Alexey Serbin,2021-04-12 17:04:37+00:00,['0a32542ca5669c842e91b1b736d108a7ae84ec5c'],13,360,373,1684397,6,0.226337449,0.259259259,0.860082305,2792
bf03c423db1569674e9904b2684d4d51feb00be8,0,Grant Henke,2021-04-12 21:20:39+00:00,['0767c0ad1b2d84cdcf958484bfe88adbe15ddf60'],0,21,21,1684418,2,0.666666667,1,1,2792
096f1ddf09047ea11d78a661010dd549ffa9af51,0,Alexey Serbin,2021-04-13 05:59:38+00:00,['bf03c423db1569674e9904b2684d4d51feb00be8'],60,192,252,1684670,3,0.461538462,0.461538462,0.815384615,2792
7fa9beb0f8a6f8902610515d894f7fb79a144154,0,Alexey Serbin,2021-04-13 06:44:34+00:00,['096f1ddf09047ea11d78a661010dd549ffa9af51'],14,44,58,1684728,2,1,0.666666667,1,2792
8093f95e6b8eb496043562f69df3a66e078ad731,0,Andrew Wong,2021-04-14 01:59:10+00:00,['7fa9beb0f8a6f8902610515d894f7fb79a144154'],16,600,616,1685344,16,0.06231454,0.762611276,0.982195846,2792
2dda869456659a36247eb89f5b9e5e3837e5f8a3,0,Andrew Wong,2021-04-14 01:59:15+00:00,['8093f95e6b8eb496043562f69df3a66e078ad731'],90,453,543,1685887,22,0.034482759,0.762931034,0.732758621,2793
9bad2491cf91535eb1125a2b6bbe061ab4d41924,0,Alexey Serbin,2021-04-15 01:30:45+00:00,['2dda869456659a36247eb89f5b9e5e3837e5f8a3'],1,21,22,1685909,2,,,,2794
5443c570639a010e91636a370384e47695846a33,0,Alexey Serbin,2021-04-15 04:55:24+00:00,['9bad2491cf91535eb1125a2b6bbe061ab4d41924'],16,49,65,1685974,1,1,1,1,2794
ee79cdfa9906d14a63d4ec4b487c6eece77cc50f,0,Alexey Serbin,2021-04-15 06:05:37+00:00,['5443c570639a010e91636a370384e47695846a33'],9,113,122,1686096,1,0,1,1,2794
5cd8d574c020925e8257dc6d11af4ee516f329b7,0,Grant Henke,2021-04-15 13:45:48+00:00,['ee79cdfa9906d14a63d4ec4b487c6eece77cc50f'],0,9,9,1686105,1,1,1,1,2794
a354ce3dd7ed8aca88a372ba9a8b6b6f5d60979c,0,Bankim Bhavsar,2021-04-19 18:52:05+00:00,['5cd8d574c020925e8257dc6d11af4ee516f329b7'],74,106,180,1686285,2,0,1,1,2794
bdb6d0643ec7b68f11cefc038dc256824ce96f5e,1,Andrew Wong,2021-04-19 20:36:23+00:00,['a354ce3dd7ed8aca88a372ba9a8b6b6f5d60979c'],94,247,341,1686626,11,0,0.386554622,0.605042017,2794
d5d8fadadac750bd9a71c4bc928dc7de05168a9a,0,Bankim Bhavsar,2021-04-20 19:07:55+00:00,['bdb6d0643ec7b68f11cefc038dc256824ce96f5e'],373,610,983,1687609,10,0.139784946,0.344086022,0.086021505,2794
1e5150bc95f79a9ad73a3fea8d4658fe2eacf20e,0,Attila Bukor,2021-04-22 19:53:32+00:00,['d5d8fadadac750bd9a71c4bc928dc7de05168a9a'],3,41,44,1687653,3,0.538461538,0.615384615,1,2794
dc5b5bd899755faa506363bd00d3bbbac8d594d3,0,Attila Bukor,2021-04-23 13:41:02+00:00,['1e5150bc95f79a9ad73a3fea8d4658fe2eacf20e'],8,52,60,1687713,4,0,1,0.878787879,2794
a9f0547fbb9d4d99c8f9106ae26aad22e222127f,0,Bankim Bhavsar,2021-04-23 22:00:43+00:00,['dc5b5bd899755faa506363bd00d3bbbac8d594d3'],0,1,1,1687714,1,,,,2794
37cb2b378807e2025fbcab41d08f4eb5fa87a86a,0,Andrew Wong,2021-04-24 01:00:50+00:00,['a9f0547fbb9d4d99c8f9106ae26aad22e222127f'],1,1,2,1687716,1,,,,2794
b9d144abd4b6becc7d2f0b64ea8b5f90871a54f0,0,Alexey Serbin,2021-04-24 02:48:41+00:00,['37cb2b378807e2025fbcab41d08f4eb5fa87a86a'],2,2,4,1687720,1,,,,2794
d21a0d38373b84f66fa2d37732b7ec7b8fee5f16,0,Andrew Wong,2021-04-24 04:55:55+00:00,['b9d144abd4b6becc7d2f0b64ea8b5f90871a54f0'],20,84,104,1687824,4,0.23255814,0.906976744,0.790697674,2794
de65aa60b6ec8bec705b9226bc7a713296d6117e,0,Bankim Bhavsar,2021-04-26 15:44:41+00:00,['d21a0d38373b84f66fa2d37732b7ec7b8fee5f16'],8,7,15,1687839,5,,,,2794
2ce5def8746acae6229dba7b2fd362069eccd1fe,0,Alexey Serbin,2021-04-26 23:53:20+00:00,['de65aa60b6ec8bec705b9226bc7a713296d6117e'],5,7,12,1687851,1,,,,2794
e495d6bb759fdae7cd001d86df3bae5c4f5f2b36,0,Alexey Serbin,2021-04-27 19:12:19+00:00,['2ce5def8746acae6229dba7b2fd362069eccd1fe'],12,142,154,1688005,6,0.012345679,0.950617284,0.87654321,2794
d1a7044f8c76f6e1504459325afa516d3a4d5f4f,0,Grant Henke,2021-04-28 03:19:09+00:00,['e495d6bb759fdae7cd001d86df3bae5c4f5f2b36'],13,46,59,1688064,4,0,0.958333333,1,2794
96047a8d861d61673b9e2589930eccd78a16e483,0,Andrew Wong,2021-04-28 04:59:21+00:00,['d1a7044f8c76f6e1504459325afa516d3a4d5f4f'],72,97,169,1688233,7,0,1,1,2794
79c99ea20a5c978a91037a4e1540ea744a83725e,0,Alexey Serbin,2021-04-28 08:10:03+00:00,['96047a8d861d61673b9e2589930eccd78a16e483'],31,35,66,1688299,1,0,1,1,2794
73310d955b4d5d7ec413217d99517cc4b7794975,0,Andrew Wong,2021-04-28 22:20:06+00:00,['79c99ea20a5c978a91037a4e1540ea744a83725e'],11,116,127,1688426,4,0,0.592105263,0.473684211,2794
28f2f35fa1ff0e490043a9308b011d8fb5709283,0,Alexey Serbin,2021-04-28 22:49:10+00:00,['73310d955b4d5d7ec413217d99517cc4b7794975'],3,138,141,1688567,4,0.171052632,0.960526316,0.947368421,2794
4c53ce892a083ff660f4b7af2374fd6b273329f8,0,Andrew Wong,2021-04-29 07:02:12+00:00,['28f2f35fa1ff0e490043a9308b011d8fb5709283'],0,23,23,1688590,3,0.1,1,1,2794
10d8e320bdc6902ae223038c8c406cc6774a6075,0,Andrew Wong,2021-04-30 07:10:29+00:00,['4c53ce892a083ff660f4b7af2374fd6b273329f8'],2,6,8,1688598,2,0,0,1,2794
fcfe6dbb3466df0edf368f5d7257a7766f9a1dc5,0,Andrew Wong,2021-04-30 17:23:36+00:00,['10d8e320bdc6902ae223038c8c406cc6774a6075'],10,251,261,1688859,3,0.110497238,0.933701657,1,2794
00c1b674545541a8a2a17aaca0738136540eb8b8,0,Grant Henke,2021-04-30 17:28:58+00:00,['fcfe6dbb3466df0edf368f5d7257a7766f9a1dc5'],1,1,2,1688861,1,,,,2794
c7ede99d71ef9343f2ccdd57c147d0895223b1b7,0,Grant Henke,2021-04-30 17:29:10+00:00,['00c1b674545541a8a2a17aaca0738136540eb8b8'],1,2,3,1688864,1,,,,2794
fb4017ca876c20b7a04b4cb1756479daf8874db7,0,Alexey Serbin,2021-04-30 21:08:57+00:00,['c7ede99d71ef9343f2ccdd57c147d0895223b1b7'],5,123,128,1688992,7,0.192307692,0.923076923,1,2794
6e7f02da5bb5eb120725d643b948366ac1cfd8ed,0,Alexey Serbin,2021-05-03 04:15:05+00:00,['fb4017ca876c20b7a04b4cb1756479daf8874db7'],4,4,8,1689000,1,1,0,0,2794
e01538b84ec14a49857c119d172e084a979775db,0,Alexey Serbin,2021-05-03 04:15:13+00:00,['6e7f02da5bb5eb120725d643b948366ac1cfd8ed'],1,1,2,1689002,1,,,,2794
f6bff905941b0c5a3fea3e94319e919cb94c8c47,0,Alexey Serbin,2021-05-03 04:32:15+00:00,['e01538b84ec14a49857c119d172e084a979775db'],3,2,5,1689007,1,1,0,0,2794
28a3baab6149ee9317c71a4afc04ad4f3c8da2f9,0,Alexey Serbin,2021-05-03 23:46:21+00:00,['f6bff905941b0c5a3fea3e94319e919cb94c8c47'],2,2,4,1689011,1,,,,2794
07e85f4e3c4f99a68d4fd4f5d799de60a28150e4,0,Alexey Serbin,2021-05-05 04:57:28+00:00,['28a3baab6149ee9317c71a4afc04ad4f3c8da2f9'],3,4,7,1689018,3,,,,2794
dec30269cac84e0cbc589145a7685f24e0976592,0,Alexey Serbin,2021-05-07 05:40:07+00:00,['07e85f4e3c4f99a68d4fd4f5d799de60a28150e4'],3,60,63,1689081,4,0.875,0.875,0.65625,2794
a9b8a772bfe4f7be827068b0cf571d8f5f1d362e,0,Andrew Wong,2021-05-07 06:51:15+00:00,['dec30269cac84e0cbc589145a7685f24e0976592'],11,753,764,1689845,10,0.363849765,0.382629108,0.73943662,2795
0875f79471a384efb28453a0aff98e5e2eb6c576,0,Alexey Serbin,2021-05-07 07:06:47+00:00,['a9b8a772bfe4f7be827068b0cf571d8f5f1d362e'],48,71,119,1689964,8,1,1,1,2795
ac91eb51009636a0b68dbc7271f63b62ab6f3350,0,Alexey Serbin,2021-05-07 07:06:53+00:00,['0875f79471a384efb28453a0aff98e5e2eb6c576'],58,87,145,1690109,2,1,1,0.857142857,2795
ad59ceaeff158111f4b8b723ce12870527839343,0,Alexey Serbin,2021-05-07 19:22:10+00:00,['ac91eb51009636a0b68dbc7271f63b62ab6f3350'],2,5,7,1690116,1,0,1,1,2795
a7018179125c49f519600c7f8b284e8bd83e0a38,0,Grant Henke,2021-05-08 19:00:21+00:00,['ad59ceaeff158111f4b8b723ce12870527839343'],119,442,561,1690677,31,0.295964126,0.6367713,0.713004484,2795
27418145bc60ceb009c663626a88e57748a85c9f,0,Grant Henke,2021-05-09 22:28:06+00:00,['a7018179125c49f519600c7f8b284e8bd83e0a38'],0,8,8,1690685,1,,,,2795
8e1d5ba4a8af06e82bbdb194393755554ae8e55d,0,Grant Henke,2021-05-10 12:57:44+00:00,['27418145bc60ceb009c663626a88e57748a85c9f'],10,83,93,1690778,14,0.4,0.95,0.85,2795
04d3ba7a0a60817d8142b70a222a9ed3b6724f6f,0,Grant Henke,2021-05-10 12:57:49+00:00,['8e1d5ba4a8af06e82bbdb194393755554ae8e55d'],1,57,58,1690836,3,1,1,1,2795
23fd58c39177110fa64047d566a4a1c375e061f5,0,Bankim Bhavsar,2021-05-10 14:59:17+00:00,['04d3ba7a0a60817d8142b70a222a9ed3b6724f6f'],21,40,61,1690897,3,1,1,1,2795
f486f0813a73739d4fd4e69ec290aeb820079abe,0,Bankim Bhavsar,2021-05-10 17:38:15+00:00,['23fd58c39177110fa64047d566a4a1c375e061f5'],4,1,5,1690902,1,0,0,0,2795
c3588b4bd978c8d65a0f917d71d1ffe498b0461e,0,Andrew Wong,2021-05-13 08:02:04+00:00,['f486f0813a73739d4fd4e69ec290aeb820079abe'],0,390,390,1691292,6,0.018181818,0.581818182,1,2797
ba10e9266e3c609f5fffc94b24e797a0f53a7378,0,Andrew Wong,2021-05-13 08:10:24+00:00,['c3588b4bd978c8d65a0f917d71d1ffe498b0461e'],18,82,100,1691392,2,0,0.931818182,1,2797
990976d38ded648b39c1db2e4241d6eda82aee63,0,Andrew Wong,2021-05-13 17:23:33+00:00,['ba10e9266e3c609f5fffc94b24e797a0f53a7378'],23,58,81,1691473,7,0,1,0.785714286,2797
0df93bcd8923029eb479e70d7253237c81309dd2,0,Grant Henke,2021-05-14 16:28:52+00:00,['990976d38ded648b39c1db2e4241d6eda82aee63'],22,34,56,1691529,2,0,0,1,2797
45ca93f0ef90a8524d0fcd9c3e56e10d5328ca24,0,Alexey Serbin,2021-05-14 20:31:14+00:00,['0df93bcd8923029eb479e70d7253237c81309dd2'],62,658,720,1692249,5,0.013667426,0.997722096,1,2797
336c65bfd84a5115dc5c6be6521751d53aa0c286,0,Bankim Bhavsar,2021-05-14 20:33:00+00:00,['45ca93f0ef90a8524d0fcd9c3e56e10d5328ca24'],231,97,328,1692577,1,,,,2797
207e4e693beb37c1f44c7621b244198bdbe895c1,0,Bankim Bhavsar,2021-05-14 21:47:52+00:00,['336c65bfd84a5115dc5c6be6521751d53aa0c286'],23,27,50,1692627,3,1,1,0,2797
b784a41290365d7eacb10048b45ea86708b5b314,0,Alexey Serbin,2021-05-15 06:19:28+00:00,['207e4e693beb37c1f44c7621b244198bdbe895c1'],5,64,69,1692696,3,0.128205128,1,1,2797
163799c385a1e69d281d8c33de9fdccc64bf4b6d,0,Bankim Bhavsar,2021-05-16 04:56:18+00:00,['b784a41290365d7eacb10048b45ea86708b5b314'],3,79,82,1692778,16,,,,2798
f418ce2de3670408ece1daf84b31d8e400e5bcf9,0,Bankim Bhavsar,2021-05-17 16:36:08+00:00,['163799c385a1e69d281d8c33de9fdccc64bf4b6d'],29,29,58,1692836,2,,,,2798
e5202c0fc04f97d22ea3eb88625d0bd9d86d07f0,0,Andrew Wong,2021-05-17 17:28:05+00:00,['f418ce2de3670408ece1daf84b31d8e400e5bcf9'],39,232,271,1693107,11,0.095890411,0.664383562,0.773972603,2798
b2633cac57e171e1ee0d98e1ecc3e41b8a2f8cd2,0,Andrew Wong,2021-05-17 17:28:07+00:00,['e5202c0fc04f97d22ea3eb88625d0bd9d86d07f0'],56,392,448,1693555,2,0.026923077,0.515384615,0.784615385,2798
1f30113f8f8471cecd10caba9c43f6390c135ae7,0,Alexey Serbin,2021-05-17 21:59:45+00:00,['b2633cac57e171e1ee0d98e1ecc3e41b8a2f8cd2'],3,445,448,1694003,2,0.063333333,0.86,1,2798
0720f6da1f7cb49b56bfc587c45e7221663ad4c6,0,Bankim Bhavsar,2021-05-17 23:05:22+00:00,['1f30113f8f8471cecd10caba9c43f6390c135ae7'],32,99,131,1694134,9,0,0.820512821,0.923076923,2798
48068c7cbf4066e3d2081960b50d466baf01543d,0,Alexey Serbin,2021-05-18 18:33:39+00:00,['0720f6da1f7cb49b56bfc587c45e7221663ad4c6'],4,6,10,1694144,1,0,1,1,2798
1a8e8c39a7bb378da6d10e88aae80bf4eeb2a057,0,Andrew Wong,2021-05-19 05:34:28+00:00,['48068c7cbf4066e3d2081960b50d466baf01543d'],36,87,123,1694267,7,0,0.621621622,0.405405405,2798
7cdc9f7c735efe99b2d39d61ac4034d41473522e,0,Alexey Serbin,2021-05-21 01:58:44+00:00,['1a8e8c39a7bb378da6d10e88aae80bf4eeb2a057'],0,4,4,1694271,1,,,,2798
323d8ea7312678b7a910e55ed4f74acaf3813ffc,0,Andrew Wong,2021-05-21 04:34:01+00:00,['7cdc9f7c735efe99b2d39d61ac4034d41473522e'],4,240,244,1694515,3,0,0.895238095,0.895238095,2798
6a0752420fdf46b821038d2f789cc9742a2ac864,0,Alexey Serbin,2021-05-23 22:20:57+00:00,['323d8ea7312678b7a910e55ed4f74acaf3813ffc'],0,80,80,1694595,1,0,0,1,2798
d1969e2623e30bfd62f2463f15e0bf02422d1d84,0,Alexey Serbin,2021-05-23 22:21:01+00:00,['6a0752420fdf46b821038d2f789cc9742a2ac864'],8,170,178,1694773,2,0.025641026,0.179487179,1,2798
68f0f1a1d1d9beaff60243b77b64f4b1b359702c,0,Alexey Serbin,2021-05-24 18:45:09+00:00,['d1969e2623e30bfd62f2463f15e0bf02422d1d84'],10,9,19,1694792,4,,,,2798
35de43051b65c8eab0f348bfd7c8a0d6e49c8067,0,Alexey Serbin,2021-05-24 21:41:36+00:00,['68f0f1a1d1d9beaff60243b77b64f4b1b359702c'],20,64,84,1694876,4,0,1,1,2798
923245291fade95febc36265cfba8cc92ee457d5,0,Andrew Wong,2021-05-25 17:28:07+00:00,['35de43051b65c8eab0f348bfd7c8a0d6e49c8067'],32,144,176,1695052,14,0,0.733333333,0.766666667,2798
0569c7055cfd22be86a95fabb41e27afd570d784,0,Alexey Serbin,2021-05-25 19:24:55+00:00,['923245291fade95febc36265cfba8cc92ee457d5'],61,140,201,1695253,13,0,0.892857143,0.714285714,2798
8ffa18196dcd3917ae624f9dc9679040e65967cb,0,Alexey Serbin,2021-05-25 21:28:31+00:00,['0569c7055cfd22be86a95fabb41e27afd570d784'],17,16,33,1695286,4,0,0,0,2798
725c8b728a4c9fd582114aa529d7f8fba186bc9d,0,Alexey Serbin,2021-05-25 21:28:38+00:00,['8ffa18196dcd3917ae624f9dc9679040e65967cb'],6,6,12,1695298,1,1,1,0,2798
bd37d601d36bcf51c595baad52b5d24b5e20d684,0,Grant Henke,2021-05-26 02:38:00+00:00,['725c8b728a4c9fd582114aa529d7f8fba186bc9d'],4,126,130,1695428,4,0.012195122,1,1,2798
a0bda0989d97fac182f409ecaef3357a1fb5329f,0,Grant Henke,2021-05-26 02:40:08+00:00,['bd37d601d36bcf51c595baad52b5d24b5e20d684'],13,7,20,1695448,1,1,0,0,2798
eda678de47856910c3b2aaef6e0e9e11473eb5ff,0,Bankim Bhavsar,2021-05-26 19:16:44+00:00,['a0bda0989d97fac182f409ecaef3357a1fb5329f'],12,27,39,1695487,4,0.571428571,0.571428571,0.428571429,2798
bf7a9535a264c7579bd783a7136bf3becb1a37a9,0,Alexey Serbin,2021-05-26 19:32:12+00:00,['eda678de47856910c3b2aaef6e0e9e11473eb5ff'],17,106,123,1695610,2,0,1,1,2798
0a8c84a53b4bbe916f9afca3280eb863840ece2a,0,Alexey Serbin,2021-05-27 16:06:30+00:00,['bf7a9535a264c7579bd783a7136bf3becb1a37a9'],0,1,1,1695611,1,,,,2798
4e724988fb9dc6eeb8cd4b91f46760a03cfa5fde,0,Alexey Serbin,2021-06-02 00:43:47+00:00,['0a8c84a53b4bbe916f9afca3280eb863840ece2a'],10,273,283,1695894,2,0.139784946,0.752688172,0.967741935,2798
cae3ec8df5037f560defe5b121f197f27c7065f1,0,Alexey Serbin,2021-06-02 01:16:16+00:00,['4e724988fb9dc6eeb8cd4b91f46760a03cfa5fde'],13,59,72,1695966,4,0.2,0.975,1,2798
be80cb291b06616702a599b12534822345f73302,0,Andrew Wong,2021-06-02 23:30:32+00:00,['cae3ec8df5037f560defe5b121f197f27c7065f1'],0,431,431,1696397,2,,,,2800
3667428d9071cbcf6825b07983529eddffc86dd5,0,Grant Henke,2021-06-02 23:32:10+00:00,['be80cb291b06616702a599b12534822345f73302'],8,184,192,1696589,2,0,0.570175439,1,2800
e574903ace741a531c49aba15f97e856ea80ca4b,0,Alexey Serbin,2021-06-03 23:33:23+00:00,['3667428d9071cbcf6825b07983529eddffc86dd5'],28,262,290,1696879,2,0,0.722891566,0.981927711,2800
79bd57546996c6e3c130960ba099fb637d58d51f,0,Alexey Serbin,2021-06-08 14:42:18+00:00,['e574903ace741a531c49aba15f97e856ea80ca4b'],44,117,161,1697040,11,0.212121212,0.606060606,0.96969697,2800
3a1ce304b3762166ba069767b842a42ea9af1009,0,Andrew Wong,2021-06-08 17:11:04+00:00,['79bd57546996c6e3c130960ba099fb637d58d51f'],33,158,191,1697231,8,0.246753247,1,0.883116883,2800
598304262439fed0819169d6b1a6bc56020a5eea,0,Alexey Serbin,2021-06-08 17:28:41+00:00,['3a1ce304b3762166ba069767b842a42ea9af1009'],0,14,14,1697245,1,0,1,1,2800
a1fe8b67a242870b007e40ef5b2d836b4773524c,0,Andrew Wong,2021-06-09 17:14:24+00:00,['598304262439fed0819169d6b1a6bc56020a5eea'],54,51,105,1697350,4,1,0,0.5,2800
76cb0dd808aaef548ef80682e13a00711e7dd6a4,0,Grant Henke,2021-06-10 01:43:08+00:00,['a1fe8b67a242870b007e40ef5b2d836b4773524c'],17,56,73,1697423,3,0.095238095,0.19047619,0.571428571,2800
5f97bd2970dc4469d85c162f32649dbb8d8b4f02,0,Bankim Bhavsar,2021-06-10 19:54:58+00:00,['76cb0dd808aaef548ef80682e13a00711e7dd6a4'],2,1,3,1697426,3,,,,2801
7673e0a687a3584c30a341bd2a8aa1dc7fc9a9b4,0,Alexey Serbin,2021-06-11 21:39:07+00:00,['5f97bd2970dc4469d85c162f32649dbb8d8b4f02'],2,2,4,1697430,1,,,,2801
c2f4cf7b8b3240feef6ec0060c99f78d3744d76d,0,Andrew Wong,2021-06-12 18:14:29+00:00,['7673e0a687a3584c30a341bd2a8aa1dc7fc9a9b4'],2,61,63,1697493,2,0,0,1,2801
f9647149a49ddb87ea0ecf069eab3b5ec0217136,0,Andrew Wong,2021-06-12 18:14:31+00:00,['c2f4cf7b8b3240feef6ec0060c99f78d3744d76d'],43,233,276,1697769,11,0.089430894,0.243902439,0.975609756,2801
56c0132aa4a1f372d13213c150c4bbca23c0efbc,0,Grant Henke,2021-06-14 17:11:14+00:00,['f9647149a49ddb87ea0ecf069eab3b5ec0217136'],2,5,7,1697776,1,0,1,1,2801
2e00269a70ff17ecc2e3d8c87f74c67c2825968f,0,Grant Henke,2021-06-14 23:03:24+00:00,['56c0132aa4a1f372d13213c150c4bbca23c0efbc'],0,10,10,1697786,1,,,,2801
51b0e91232b25b676316a0dc724bc1b0e77f0e2e,0,Alexey Serbin,2021-06-16 13:59:13+00:00,['2e00269a70ff17ecc2e3d8c87f74c67c2825968f'],52,56,108,1697894,4,,,,2801
f26fa17968f4b323a42b61ebeace5be9e12057c0,0,Alexey Serbin,2021-06-17 04:28:17+00:00,['51b0e91232b25b676316a0dc724bc1b0e77f0e2e'],14,146,160,1698054,5,0.166666667,0.637254902,1,2801
5f845189ef48e143e27641de86ae71d423464af2,0,Andrew Wong,2021-06-17 22:18:09+00:00,['f26fa17968f4b323a42b61ebeace5be9e12057c0'],0,82,82,1698136,2,0.25,1,1,2801
bb5129444162e66ecaafe1f3396df16f11e10dbb,0,Alexey Serbin,2021-06-17 23:10:01+00:00,['5f845189ef48e143e27641de86ae71d423464af2'],32,31,63,1698199,21,,,,2801
8f0020fe22bc9f026d563155503be981111b202a,0,Alexey Serbin,2021-06-21 19:07:00+00:00,['bb5129444162e66ecaafe1f3396df16f11e10dbb'],61,211,272,1698471,5,0.398230088,0.955752212,0.805309735,2801
576d9baecd4a5b7cfd80d273f5f4cd84a219de37,0,Alexey Serbin,2021-06-21 19:55:03+00:00,['8f0020fe22bc9f026d563155503be981111b202a'],0,7,7,1698478,1,,,,2801
fff48ea4e5eadd365a85a05a82f66b3eb76d0b0b,0,Alexey Serbin,2021-06-22 20:40:01+00:00,['576d9baecd4a5b7cfd80d273f5f4cd84a219de37'],7,7,14,1698492,1,,,,2801
a0f6665d90175168c999bfcb021e2d359ff3ecac,0,Bankim Bhavsar,2021-06-23 03:03:18+00:00,['fff48ea4e5eadd365a85a05a82f66b3eb76d0b0b'],0,184,184,1698676,1,,,,2801
0d6bbad914114cbf373f62a11a79ad732ec6ad2b,0,Bankim Bhavsar,2021-06-23 03:03:24+00:00,['a0f6665d90175168c999bfcb021e2d359ff3ecac'],15,15,30,1698706,10,,,,2801
89391ca87c4d77ba70358615a29efa150c4b0ffb,0,Bankim Bhavsar,2021-06-23 03:03:27+00:00,['0d6bbad914114cbf373f62a11a79ad732ec6ad2b'],7,15,22,1698728,1,,,,2801
ae95d6d5c10e375627d8b0aeab37b089933ccc92,0,Alexey Serbin,2021-06-24 05:22:05+00:00,['89391ca87c4d77ba70358615a29efa150c4b0ffb'],6,7,13,1698741,3,,,,2801
c37196badd1bd7dd950ef7fd49debbf8becf3cbc,0,Grant Henke,2021-06-24 15:23:03+00:00,['ae95d6d5c10e375627d8b0aeab37b089933ccc92'],4,6,10,1698751,1,0,0,1,2801
eb086d9af32dd4d5b593111618467ac7a06cfe91,0,Alexey Serbin,2021-06-25 06:44:29+00:00,['c37196badd1bd7dd950ef7fd49debbf8becf3cbc'],0,35,35,1698786,3,0.857142857,1,1,2801
038b8c15b43e6071ca1fbd8f91202168ef492dc7,0,Alexey Serbin,2021-06-25 18:24:54+00:00,['eb086d9af32dd4d5b593111618467ac7a06cfe91'],2,3,5,1698791,3,1,1,1,2801
5fc302c0e4bcd977af51f0fa9a86d043b2263b55,0,Alexey Serbin,2021-06-25 18:25:36+00:00,['038b8c15b43e6071ca1fbd8f91202168ef492dc7'],1,34,35,1698826,2,,,,2802
c91763c8a88d562a32763c4ae8c19644bd2f5468,0,Alexey Serbin,2021-07-07 01:14:25+00:00,['5fc302c0e4bcd977af51f0fa9a86d043b2263b55'],0,13,13,1698839,2,1,1,0.916666667,2802
422f1305ff9dab5d4bb0446aa6fe1e1c40c5b44c,0,Andrew Wong,2021-07-07 02:29:25+00:00,['c91763c8a88d562a32763c4ae8c19644bd2f5468'],18,101,119,1698958,13,0.342105263,1,1,2802
f53e730686685a807f303ef03d721f55041b2b55,0,Alexey Serbin,2021-07-07 23:09:56+00:00,['422f1305ff9dab5d4bb0446aa6fe1e1c40c5b44c'],1,1,2,1698960,1,,,,2802
4943e338307bd7e886a10fb6f8bccb2377f88d27,0,Alexey Serbin,2021-07-09 23:36:10+00:00,['f53e730686685a807f303ef03d721f55041b2b55'],42,0,42,1699002,1,0.757575758,0.757575758,0,2802
eb55189eec3cb30bf10a5f0778ac5bc46164de7b,0,Alexey Serbin,2021-07-12 18:03:57+00:00,['4943e338307bd7e886a10fb6f8bccb2377f88d27'],71,63,134,1699136,6,0,0.777777778,1,2802
b3f2467eb66c6ce840453f82c8c376f3ef94372d,0,Alexey Serbin,2021-07-13 03:12:50+00:00,['eb55189eec3cb30bf10a5f0778ac5bc46164de7b'],36,47,83,1699219,1,,,,2802
fc4daf6ee16b1939397718cc5f1cfc9d1ca4a31a,0,Alexey Serbin,2021-07-13 18:30:05+00:00,['b3f2467eb66c6ce840453f82c8c376f3ef94372d'],60,146,206,1699425,7,0.11627907,1,1,2802
7e66534d0e62fb850bf300d52da4a0a76889f4b8,0,Andrew Wong,2021-07-13 22:16:12+00:00,['fc4daf6ee16b1939397718cc5f1cfc9d1ca4a31a'],243,1043,1286,1700711,9,0.011299435,0.444444444,0.50094162,2802
817c395d4db8ab5dc5709b05765563d68249a682,0,Alexey Serbin,2021-07-13 23:19:02+00:00,['7e66534d0e62fb850bf300d52da4a0a76889f4b8'],203,337,540,1701251,3,0,0.982608696,0.991304348,2802
35b5664f908cd1250c9f01e5dff77b653cfd12b7,0,Alexey Serbin,2021-07-16 07:43:40+00:00,['817c395d4db8ab5dc5709b05765563d68249a682'],2,9,11,1701262,2,,,,2802
6cb15486cdbeacb722e69b81d563b6f05d840650,0,Alexey Serbin,2021-07-16 17:22:22+00:00,['35b5664f908cd1250c9f01e5dff77b653cfd12b7'],57,226,283,1701545,3,0.166666667,0.614035088,0.973684211,2802
748106216ec7170e85c969cdc97e7c784ffae512,0,Alexey Serbin,2021-07-17 01:38:10+00:00,['6cb15486cdbeacb722e69b81d563b6f05d840650'],1,1,2,1701547,1,,,,2802
586b7913258df2d0ee75470ddfb2b88d472ba235,0,Alexey Serbin,2021-07-20 15:56:17+00:00,['748106216ec7170e85c969cdc97e7c784ffae512'],69,695,764,1702311,11,0.377358491,0.927672956,0.77672956,2803
5e895c642d28a1c5e3ee0845bb0775fe2e106d29,0,Alexey Serbin,2021-07-20 17:48:11+00:00,['586b7913258df2d0ee75470ddfb2b88d472ba235'],12,38,50,1702361,4,0,0.176470588,0.176470588,2803
2d98e75ee62a89846c1dd29302ac590a1461c9de,0,Alexey Serbin,2021-07-21 20:59:31+00:00,['5e895c642d28a1c5e3ee0845bb0775fe2e106d29'],0,98,98,1702459,5,0,0.960526316,0.986842105,2803
960e30055b12870ad425e746b907b9b7d9459194,0,Attila Bukor,2021-07-22 14:15:59+00:00,['2d98e75ee62a89846c1dd29302ac590a1461c9de'],0,32,32,1702491,2,0,1,1,2803
f40a39c75709b0f2ecc714e45cc832906554fb8c,0,Alexey Serbin,2021-07-26 23:56:11+00:00,['960e30055b12870ad425e746b907b9b7d9459194'],19,8,27,1702518,4,0.2,0.2,1,2803
fad7dd457aa5a35dddfa0e6086b3dce9b03d42b7,0,Andrew Wong,2021-07-27 01:56:46+00:00,['f40a39c75709b0f2ecc714e45cc832906554fb8c'],7,58,65,1702583,4,0,0,0.555555556,2803
d0734a1bf8bd45b016fbffa983fbb8c483ed94c9,0,Alexey Serbin,2021-07-27 02:32:27+00:00,['fad7dd457aa5a35dddfa0e6086b3dce9b03d42b7'],22,33,55,1702638,1,0,0.142857143,0.714285714,2803
392f43f8233f80d993c9b2bf35dbf43930969ff5,0,Alexey Serbin,2021-07-27 21:26:41+00:00,['d0734a1bf8bd45b016fbffa983fbb8c483ed94c9'],169,261,430,1703068,9,0.129411765,0.564705882,0.6,2803
084640a4027a7bc09a3975d0d9d528d64c68f512,0,Alexey Serbin,2021-07-27 22:01:47+00:00,['392f43f8233f80d993c9b2bf35dbf43930969ff5'],71,73,144,1703212,6,1,0.5,0.5,2803
4ba1ca2b17210ee686513c3e02c91d6232b9a86c,0,Alexey Serbin,2021-07-28 07:40:00+00:00,['084640a4027a7bc09a3975d0d9d528d64c68f512'],124,160,284,1703496,1,0.56,0.96,0.52,2803
dda258785bbdfef8a14bc27c7cb1c9ebd61d3035,0,Attila Bukor,2021-07-28 09:19:48+00:00,['4ba1ca2b17210ee686513c3e02c91d6232b9a86c'],0,308,308,1703804,9,,,,2807
1ec8b209e6b81768c56223f89931e4aed56b1f50,0,Alexey Serbin,2021-07-30 05:02:51+00:00,['dda258785bbdfef8a14bc27c7cb1c9ebd61d3035'],78,120,198,1704002,23,1,1,1,2807
e7cd1f6cfab4d8448ad4ebd834727c83f23f4899,0,Andrew Wong,2021-07-30 18:18:38+00:00,['1ec8b209e6b81768c56223f89931e4aed56b1f50'],6,43,49,1704051,1,,,,2807
2d62c427bf0e4d62df2f0cb355ebfc03705070a1,0,Andrew Wong,2021-07-30 18:18:52+00:00,['e7cd1f6cfab4d8448ad4ebd834727c83f23f4899'],24,110,134,1704185,4,,,,2807
add7cb99fc8d6ab586e27d0ecd7d1698f0f45ae3,0,Alexey Serbin,2021-07-30 21:49:01+00:00,['2d62c427bf0e4d62df2f0cb355ebfc03705070a1'],86,82,168,1704353,3,0,1,0.333333333,2807
846ec3812fbedcbe1eff77b520469f7ba0efc0a3,0,Alexey Serbin,2021-08-02 22:53:48+00:00,['add7cb99fc8d6ab586e27d0ecd7d1698f0f45ae3'],3,6,9,1704362,1,,,,2807
e5e22422356dc9ab2d3af8631e6646e0c2dc003b,0,Andrew Wong,2021-08-03 02:59:28+00:00,['846ec3812fbedcbe1eff77b520469f7ba0efc0a3'],3,3,6,1704368,1,,,,2807
bca9d73f90d02209e67615c140cd9c5311a6d8fb,0,Andrew Wong,2021-08-04 22:55:20+00:00,['e5e22422356dc9ab2d3af8631e6646e0c2dc003b'],389,1051,1440,1705808,4,0,0.656167979,0.669291339,2807
0367a53a6385470e21246fbab61ecd3084f20cf8,0,Alexey Serbin,2021-08-05 02:28:50+00:00,['bca9d73f90d02209e67615c140cd9c5311a6d8fb'],179,131,310,1706118,9,0.5,0.21875,1,2807
11cad7f7b7a9953850cc6cccef08c2b19fafbdac,0,Alexey Serbin,2021-08-05 19:37:06+00:00,['0367a53a6385470e21246fbab61ecd3084f20cf8'],18,164,182,1706300,4,0.203883495,0.912621359,1,2807
adb8fbd7b724b0a5c04ac967a917f610383a8a80,0,Alexey Serbin,2021-08-07 05:01:26+00:00,['11cad7f7b7a9953850cc6cccef08c2b19fafbdac'],83,11,94,1706394,4,1,0.698113208,0.698113208,2807
a5307b3427e5122d40b450927b423c35eb334924,0,Alexey Serbin,2021-08-07 05:01:40+00:00,['adb8fbd7b724b0a5c04ac967a917f610383a8a80'],17,38,55,1706449,1,0,0,1,2807
6be5282d09d3c9d4c465f43fd292c6914182e7d5,0,Andrew Wong,2021-08-10 16:44:23+00:00,['a5307b3427e5122d40b450927b423c35eb334924'],45,36,81,1706530,11,0,0,0,2807
592ba3c5f7abfba43ee5ef1b339a4743006b6e3b,0,Attila Bukor,2021-08-10 18:29:12+00:00,['6be5282d09d3c9d4c465f43fd292c6914182e7d5'],19,192,211,1706741,15,0.720430108,0.817204301,0.892473118,2807
d65d75fb6473e1ce1db108758289456a71101690,0,Attila Bukor,2021-08-10 18:29:19+00:00,['592ba3c5f7abfba43ee5ef1b339a4743006b6e3b'],10,201,211,1706952,7,0.578947368,0.652631579,0.810526316,2807
607d9d0a7e95e220864f43b88a64644bb6402163,0,Alexey Serbin,2021-08-11 02:14:31+00:00,['d65d75fb6473e1ce1db108758289456a71101690'],602,462,1064,1708016,5,0.838926174,0,0.040268456,2807
ab0421b13b81798548b7dc2f7acd8f7362d459c5,1,Andrew Wong,2021-08-11 18:01:29+00:00,['607d9d0a7e95e220864f43b88a64644bb6402163'],14,852,866,1708882,12,0.174840085,0.880597015,0.923240938,2809
ecbd8700e49bf60f15a9d261f0de425f2ba5413e,0,Alexey Serbin,2021-08-13 20:31:30+00:00,['ab0421b13b81798548b7dc2f7acd8f7362d459c5'],105,338,443,1709325,12,0.182352941,0.676470588,0.888235294,2809
b5cf9d9a5738d77f692a4dc1a33dd9c1a7a367e2,0,Alexey Serbin,2021-08-18 06:21:28+00:00,['ecbd8700e49bf60f15a9d261f0de425f2ba5413e'],389,421,810,1710135,18,0.444444444,0.777777778,0.333333333,2809
679c90c81492d1ba46964a5258679fd4ed028d6c,0,Attila Bukor,2021-08-18 18:41:28+00:00,['b5cf9d9a5738d77f692a4dc1a33dd9c1a7a367e2'],8,54,62,1710197,4,0.625,0.625,0.625,2809
25d71738c05972eba1383a9b93883a7f5617b7c9,0,Andrew Wong,2021-08-19 19:06:00+00:00,['679c90c81492d1ba46964a5258679fd4ed028d6c'],2,36,38,1710235,3,0,0.533333333,0.333333333,2809
888f42a7760377c21237643a0c2396870663f79c,0,Alexey Serbin,2021-08-20 17:29:30+00:00,['25d71738c05972eba1383a9b93883a7f5617b7c9'],93,94,187,1710422,7,0.285714286,1,0.285714286,2809
7feceaa32fa3df5a531ad8f034ee39a9b25e17a2,0,Attila Bukor,2021-08-24 08:25:52+00:00,['888f42a7760377c21237643a0c2396870663f79c'],8,110,118,1710540,4,0.6,1,0.573333333,2809
8f47992bbd4436f645e98c3d67e21f24df03fcce,0,Alexey Serbin,2021-08-24 19:15:40+00:00,['7feceaa32fa3df5a531ad8f034ee39a9b25e17a2'],4,10,14,1710554,1,,,,2809
87a03ec9c6eeaf815cc03354937fb8fb24a79610,0,Alexey Serbin,2021-08-24 19:16:05+00:00,['8f47992bbd4436f645e98c3d67e21f24df03fcce'],18,33,51,1710605,1,,,,2809
1b499ebe9978e7d77615255862f0cf8ca1054c69,0,Alexey Serbin,2021-08-25 18:02:06+00:00,['87a03ec9c6eeaf815cc03354937fb8fb24a79610'],100,641,741,1711346,15,0.058524173,0.798982188,0.877862595,2809
e554db14d25d9a927ccfec56433f20aeca574bde,0,Andrew Wong,2021-08-26 06:32:38+00:00,['1b499ebe9978e7d77615255862f0cf8ca1054c69'],3,14,17,1711363,1,,,,2809
47450aa5b637a8f273636b0d8d6496e82a0dc4fe,0,Andrew Wong,2021-08-26 20:27:46+00:00,['e554db14d25d9a927ccfec56433f20aeca574bde'],60,128,188,1711551,3,0,0,1,2809
1faed4beffdebb92e4142e96880d21c13e7fe1ac,0,Alexey Serbin,2021-08-28 13:38:55+00:00,['47450aa5b637a8f273636b0d8d6496e82a0dc4fe'],2,0,2,1711553,1,,,,2809
4c5b67d68b8207f95cd35e30d5ff193b6ac6be12,0,Alexey Serbin,2021-08-28 13:39:11+00:00,['1faed4beffdebb92e4142e96880d21c13e7fe1ac'],0,13,13,1711566,1,,,,2809
1e8376f4397a24b981216e88d8d4deb8ab154a1d,0,Alexey Serbin,2021-08-31 01:23:45+00:00,['4c5b67d68b8207f95cd35e30d5ff193b6ac6be12'],228,254,482,1712048,15,1,0,0,2809
e60ac3ca93532fdffa71999e90661e42d7dcc0b0,0,Andrew Wong,2021-08-31 17:39:04+00:00,['1e8376f4397a24b981216e88d8d4deb8ab154a1d'],10,191,201,1712249,8,0.105769231,1,0.903846154,2809
05ae60adc6d16e8d63a41ec62bd8edaf5f5967c5,0,Andrew Wong,2021-08-31 17:39:40+00:00,['e60ac3ca93532fdffa71999e90661e42d7dcc0b0'],0,25,25,1712274,2,0.8,1,1,2809
0bfc533bea668ac0769fd0411da06eb9eb812904,0,Alexey Serbin,2021-08-31 23:38:54+00:00,['05ae60adc6d16e8d63a41ec62bd8edaf5f5967c5'],8,0,8,1712282,2,,,,2809
ab54c39f11a9b045348cc2f864cab120839ba6b5,0,Alexey Serbin,2021-09-01 01:16:17+00:00,['0bfc533bea668ac0769fd0411da06eb9eb812904'],2,42,44,1712326,2,0,1,1,2809
4d50656f867a6e68724e232609e4ff7d538af6eb,0,Yingchun Lai,2021-09-01 07:52:53+00:00,['ab54c39f11a9b045348cc2f864cab120839ba6b5'],49,370,419,1712745,4,0,0.645833333,1,2809
a9850d7dbbc3ff85d981eb8be6e29220aba4161e,0,Alexey Serbin,2021-09-07 17:21:10+00:00,['4d50656f867a6e68724e232609e4ff7d538af6eb'],1,1,2,1712747,1,,,,2809
03451904a20123ca27eaa4e9773b94c0532fd342,0,Alexey Serbin,2021-09-08 23:44:11+00:00,['a9850d7dbbc3ff85d981eb8be6e29220aba4161e'],268,271,539,1713286,10,0.166666667,1,1,2809
646fbaacf31857a314b4589196523b04d3ae3f49,0,Attila Bukor,2021-09-10 06:21:37+00:00,['03451904a20123ca27eaa4e9773b94c0532fd342'],36,38,74,1713360,36,,,,2809
7bc6c379210617f051c5726a6d5325e23b18409c,0,Alexey Serbin,2021-09-10 22:10:42+00:00,['646fbaacf31857a314b4589196523b04d3ae3f49'],0,4,4,1713364,1,0,1,1,2809
8c3d9fa0a52bd1e556229b7de7687c0a41bc47a2,0,Alexey Serbin,2021-09-11 00:40:25+00:00,['7bc6c379210617f051c5726a6d5325e23b18409c'],5,221,226,1713590,2,0.039548023,1,1,2809
1fd35847e0e4a444455802927c141b8015207ddf,0,Alexey Serbin,2021-09-11 03:35:08+00:00,['8c3d9fa0a52bd1e556229b7de7687c0a41bc47a2'],1,9,10,1713600,1,,,,2809
966cc2c102e9eacc811d9e0c02cb8404f0b74b23,0,Alexey Serbin,2021-09-11 05:17:52+00:00,['1fd35847e0e4a444455802927c141b8015207ddf'],285,307,592,1714192,4,1,0,0,2809
eee765e8f9164f9b4a76b5fc98e7bae77dba83d9,0,Alexey Serbin,2021-09-13 17:22:16+00:00,['966cc2c102e9eacc811d9e0c02cb8404f0b74b23'],1,1,2,1714194,1,0,0,0,2809
49abc3a6788bc29c8c023cafff0f0955142a2409,0,Yingchun Lai,2021-09-14 07:09:35+00:00,['eee765e8f9164f9b4a76b5fc98e7bae77dba83d9'],3,57,60,1714254,4,0.214285714,1,1,2809
d552d7e1f65c1d68e7de57a376adfb9802cb9211,0,Yingchun Lai,2021-09-16 02:52:56+00:00,['49abc3a6788bc29c8c023cafff0f0955142a2409'],100,92,192,1714446,9,1,0.4,0,2809
7a4061e87e9c3f47807a8983872d1384414a854e,0,Yingchun Lai,2021-09-16 02:55:26+00:00,['d552d7e1f65c1d68e7de57a376adfb9802cb9211'],2,9,11,1714457,2,1,1,1,2809
63a3293dde23d32b8012f3b4765d380f817f23b0,0,Alexey Serbin,2021-09-17 14:46:50+00:00,['7a4061e87e9c3f47807a8983872d1384414a854e'],48,37,85,1714542,2,1,1,1,2809
246505b538a6449eda7a9936609e9fec4632fe5d,0,Andrew Wong,2021-09-21 22:35:33+00:00,['63a3293dde23d32b8012f3b4765d380f817f23b0'],2,145,147,1714689,5,0.026548673,0.495575221,0.849557522,2809
41ebabf2eb618b33fd30ad1821ccbda9d6390010,0,Andrew Wong,2021-09-21 22:36:29+00:00,['246505b538a6449eda7a9936609e9fec4632fe5d'],74,517,591,1715280,13,0.282786885,0.905737705,0.639344262,2810
35c1afbca639664f72c213f7a631b3d36f128efc,0,Alexey Serbin,2021-09-23 16:44:24+00:00,['41ebabf2eb618b33fd30ad1821ccbda9d6390010'],4,5,9,1715289,1,0,0,0,2810
acf6de866c878dc2f09fb5bd7cccf0312375e7c7,0,Andrew Wong,2021-09-24 05:57:01+00:00,['35c1afbca639664f72c213f7a631b3d36f128efc'],58,350,408,1715697,17,0.23566879,0.757961783,0.974522293,2811
4438a15f9238f818e9af1230521e8d7c4924f92b,0,Alexey Serbin,2021-09-24 07:10:27+00:00,['acf6de866c878dc2f09fb5bd7cccf0312375e7c7'],1,47,48,1715745,6,0.259259259,1,0.962962963,2811
7b0a94d72de4475c6e6c3d7d78569403407cb278,0,Alexey Serbin,2021-10-05 00:06:37+00:00,['4438a15f9238f818e9af1230521e8d7c4924f92b'],0,79,79,1715824,2,0.049180328,1,1,2811
4fe61a26ad5bbb0a41bb7be002a6b32d9c0ea916,0,Andrew Wong,2021-10-08 00:17:44+00:00,['7b0a94d72de4475c6e6c3d7d78569403407cb278'],82,272,354,1716178,9,0.52173913,1,0.608695652,2811
3884a6388b2696a826b8903144ae555faa595473,0,Andrew Wong,2021-10-08 00:18:44+00:00,['4fe61a26ad5bbb0a41bb7be002a6b32d9c0ea916'],19,209,228,1716406,8,0,0.778688525,0.942622951,2811
a50091e2d4509feac2f29128107102ec52fcb7b0,0,Alexey Serbin,2021-10-08 00:46:54+00:00,['3884a6388b2696a826b8903144ae555faa595473'],699,1079,1778,1718184,31,0.274193548,0.838709677,0.786290323,2811
9c7f67325972b50d68ca836f83c96554222d4b9c,0,Alexey Serbin,2021-10-08 03:53:13+00:00,['a50091e2d4509feac2f29128107102ec52fcb7b0'],6,63,69,1718253,4,0,0.906976744,0.953488372,2811
1584e4325cfce37f89fd1dbebff5f24ed980780f,0,Andrew Wong,2021-10-08 21:40:57+00:00,['9c7f67325972b50d68ca836f83c96554222d4b9c'],9,92,101,1718354,4,0.037037037,0.981481481,1,2811
345fce81aa52fa378a57d6b610d42e751a1387a4,0,Andrew Wong,2021-10-13 04:50:17+00:00,['1584e4325cfce37f89fd1dbebff5f24ed980780f'],35,389,424,1718778,2,0.344827586,0.827586207,1,2812
5588962fb4e6acb54c1e5cab5edce4aa543a73a7,0,Yingchun Lai,2021-10-18 09:38:32+00:00,['345fce81aa52fa378a57d6b610d42e751a1387a4'],2,2,4,1718782,2,,,,2812
b981b2305f8b4a92ed9394ac37ca659a1335c688,0,Alexey Serbin,2021-10-18 18:24:44+00:00,['5588962fb4e6acb54c1e5cab5edce4aa543a73a7'],4,34,38,1718820,2,0,0.739130435,1,2812
e8ad446f44a465c8b208a983c946a01fb1ba6357,0,Alexey Serbin,2021-10-21 17:32:18+00:00,['b981b2305f8b4a92ed9394ac37ca659a1335c688'],0,24,24,1718844,1,,,,2812
0ade8c6f21f0887e90b261ae6b1a57f4a6d1eff1,0,Alexey Serbin,2021-10-21 18:46:22+00:00,['e8ad446f44a465c8b208a983c946a01fb1ba6357'],11,14,25,1718869,2,1,1,0,2812
3ccc434ea6dcbef15a12bd1734c8e66b69a611c5,0,Bankim Bhavsar,2021-10-25 20:30:11+00:00,['0ade8c6f21f0887e90b261ae6b1a57f4a6d1eff1'],5,101,106,1718975,6,0,0.015151515,0.893939394,2812
4aef722348a39f0038a5669f41706052ca678619,0,Alexey Serbin,2021-10-25 20:43:53+00:00,['3ccc434ea6dcbef15a12bd1734c8e66b69a611c5'],0,24,24,1718999,2,1,1,1,2812
96aa6ee65f6beae0ed2a2c00d1f43c742428325c,0,Alexey Serbin,2021-10-25 20:44:10+00:00,['4aef722348a39f0038a5669f41706052ca678619'],1,1,2,1719001,1,,,,2812
50cc6f99e2ed272208d01d663bc54e872e46e68b,0,Alexey Serbin,2021-10-26 04:50:42+00:00,['96aa6ee65f6beae0ed2a2c00d1f43c742428325c'],2,4,6,1719007,1,0,1,0,2812
de02a34390f9bdb722be39f96ef9ad9573c0eeeb,0,Attila Bukor,2021-10-26 07:18:50+00:00,['50cc6f99e2ed272208d01d663bc54e872e46e68b'],36,321,357,1719364,5,0.143564356,0.851485149,0.420792079,2812
5ce41d9075b04a39014ec8445b7cdf0cd2e64b10,0,Andrew Wong,2021-10-26 20:20:07+00:00,['de02a34390f9bdb722be39f96ef9ad9573c0eeeb'],1,14,15,1719379,2,1,1,1,2812
9015ccc162122b0d0a55431957c03fb085bc26c3,0,Andrew Wong,2021-10-26 20:20:22+00:00,['5ce41d9075b04a39014ec8445b7cdf0cd2e64b10'],3,4,7,1719386,1,0,0,1,2812
9e70182d28bebddc7adcbac60a0482225382c27a,0,Alexey Serbin,2021-10-26 23:12:44+00:00,['9015ccc162122b0d0a55431957c03fb085bc26c3'],104,88,192,1719578,6,1,0,0,2812
94159e5c6713834d86bb89ecb681224cf6eeaf01,0,Alexey Serbin,2021-10-27 05:01:52+00:00,['9e70182d28bebddc7adcbac60a0482225382c27a'],1,55,56,1719634,2,0,0.795454545,0.795454545,2812
bd5f72e0ed03b614d49b8125160bf555d11dcf9c,0,Andrew Wong,2021-10-27 17:03:23+00:00,['94159e5c6713834d86bb89ecb681224cf6eeaf01'],71,637,708,1720342,25,0.38317757,0.841121495,0,2816
b4da33b6c4df8eb8137cbf7663982822260ee301,0,Bankim Bhavsar,2021-10-28 22:32:59+00:00,['bd5f72e0ed03b614d49b8125160bf555d11dcf9c'],0,13,13,1720355,2,1,1,1,2816
a31b96edee11c08c909a717b9195c42b5e678a47,0,Andrew Wong,2021-11-01 18:20:59+00:00,['b4da33b6c4df8eb8137cbf7663982822260ee301'],17,82,99,1720454,4,0,1,1,2816
59070bf5bd5924c6e4deb68434744cac3b062dcc,0,Andrew Wong,2021-11-03 06:54:24+00:00,['a31b96edee11c08c909a717b9195c42b5e678a47'],3,60,63,1720517,3,1,0.580645161,1,2816
3e24e1be4362ba9efb6d295ff96d3a18893f2733,0,Andrew Wong,2021-11-03 06:57:44+00:00,['59070bf5bd5924c6e4deb68434744cac3b062dcc'],0,67,67,1720584,4,0.277777778,0.388888889,0.222222222,2816
f334e6e083203c96e56957e3d331adbc33d3c8a4,0,Andrew Wong,2021-11-03 19:21:31+00:00,['3e24e1be4362ba9efb6d295ff96d3a18893f2733'],120,121,241,1720825,12,0,1,1,2816
032d1d90147139db62a7cea8700d5373332bde9a,0,Andrew Wong,2021-11-03 22:05:30+00:00,['f334e6e083203c96e56957e3d331adbc33d3c8a4'],26,106,132,1720957,2,0,0,0.446808511,2816
5d39a74a19ecf03071105ac0065dc1124cfd4ea6,0,Alexey Serbin,2021-11-05 21:21:17+00:00,['032d1d90147139db62a7cea8700d5373332bde9a'],2,4,6,1720963,1,,,,2816
3dcb51190792c360c3718ff48ebfb8797a1b19b3,0,Alexey Serbin,2021-11-10 18:03:49+00:00,['5d39a74a19ecf03071105ac0065dc1124cfd4ea6'],1,1,2,1720965,1,,,,2816
1754f517b279f349da8c648251ce47a552d54794,0,Alexey Serbin,2021-11-15 18:55:20+00:00,['3dcb51190792c360c3718ff48ebfb8797a1b19b3'],15,154,169,1721134,4,0.171052632,1,1,2816
cb69bb12eb07104c7d7c5333484534d997d65195,0,Andrew Wong,2021-11-15 21:21:35+00:00,['1754f517b279f349da8c648251ce47a552d54794'],4,47,51,1721185,2,0,1,1,2816
dfb3ce9efe51ced39e3c83e229725e26abeb0136,0,Andrew Wong,2021-11-16 19:33:42+00:00,['cb69bb12eb07104c7d7c5333484534d997d65195'],37,66,103,1721288,17,1,1,1,2816
c423172ca60383a63b3e5ca00f767ccc11001180,0,Attila Bukor,2021-11-16 20:45:20+00:00,['dfb3ce9efe51ced39e3c83e229725e26abeb0136'],6,22,28,1721316,3,0.833333333,0.833333333,1,2816
7ef0bfec72b7b06074a7187b76ec1771beb4e206,0,Andrew Wong,2021-11-19 02:48:00+00:00,['c423172ca60383a63b3e5ca00f767ccc11001180'],1,1,2,1721318,1,,,,2816
e05ff65951e72dcb216abf5472af9577fbe38fce,0,Alexey Serbin,2021-11-19 18:54:26+00:00,['7ef0bfec72b7b06074a7187b76ec1771beb4e206'],3,54,57,1721375,2,0,1,1,2816
454740094d9bf8ffc8478faded2ff282a84f232f,0,Alexey Serbin,2021-11-19 22:08:13+00:00,['e05ff65951e72dcb216abf5472af9577fbe38fce'],12,9,21,1721396,1,1,0,0,2816
b6d8c1db5847c636ccc9bb6d801f37da08d4560b,0,Alexey Serbin,2021-11-23 03:46:10+00:00,['454740094d9bf8ffc8478faded2ff282a84f232f'],12,26,38,1721434,2,0,1,1,2816
e3bcd743d6c2d8791591c69260e7d9e6bc59fef9,0,Andrew Wong,2021-11-23 21:32:53+00:00,['b6d8c1db5847c636ccc9bb6d801f37da08d4560b'],15,141,156,1721590,5,0.020408163,0.867346939,1,2816
6998193e69eeda497f912d1d806470c95b591ad4,0,Alexey Serbin,2021-11-24 07:18:28+00:00,['e3bcd743d6c2d8791591c69260e7d9e6bc59fef9'],80,423,503,1722093,5,0.410596026,0.940397351,0.940397351,2816
e266f7139983fd8316ec97f046db6125124c77de,0,Alexey Serbin,2021-11-24 17:09:32+00:00,['6998193e69eeda497f912d1d806470c95b591ad4'],0,38,38,1722131,1,,,,2816
6d81fe44b51844942bc8433931d663531547c4b8,0,Andrew Wong,2021-11-29 23:41:25+00:00,['e266f7139983fd8316ec97f046db6125124c77de'],4,219,223,1722354,3,0.25308642,1,0.969135802,2816
cac9b48ccee922b5d88cac20f496cd77b409f0bc,0,Andrew Wong,2021-11-30 05:50:45+00:00,['6d81fe44b51844942bc8433931d663531547c4b8'],11,30,41,1722395,2,0,0,1,2816
150f3ee1a4c7a19ec46797928dc8b84e14b6c4a8,0,Attila Bukor,2021-11-30 13:41:13+00:00,['cac9b48ccee922b5d88cac20f496cd77b409f0bc'],6,22,28,1722423,1,,,,2816
0222c3163129b1d6c1c37b216482aa64f921c415,0,Yifan Zhang,2021-12-02 16:04:22+00:00,['150f3ee1a4c7a19ec46797928dc8b84e14b6c4a8'],11,97,108,1722531,4,0.508474576,0.898305085,1,2816
5932b9c35dd50df3412ad3a63aef27b6b41506e5,0,Alexey Serbin,2021-12-02 22:01:49+00:00,['0222c3163129b1d6c1c37b216482aa64f921c415'],8,50,58,1722589,1,,,,2816
fdf83f7624b797f1f63d4bc0c63a2ebb45966d1d,0,Alexey Serbin,2021-12-02 22:02:12+00:00,['5932b9c35dd50df3412ad3a63aef27b6b41506e5'],1,1,2,1722591,1,,,,2816
3779690f2eabe91da7f3c3abf5119579f2294ecf,0,Alexey Serbin,2021-12-07 17:50:54+00:00,['fdf83f7624b797f1f63d4bc0c63a2ebb45966d1d'],91,183,274,1722865,7,0.245283019,0.58490566,0.188679245,2816
370e58c2fa4169e72dc4857dee5318d5c4d49bda,0,Alexey Serbin,2021-12-10 17:51:54+00:00,['3779690f2eabe91da7f3c3abf5119579f2294ecf'],2,34,36,1722901,2,0,1,1,2816
58ee81bcf8d1da1a10918deedf2a14ae9104bed6,0,Alexey Serbin,2021-12-10 19:37:23+00:00,['370e58c2fa4169e72dc4857dee5318d5c4d49bda'],48,44,92,1722993,3,0,0,0,2816
d0243afe2ed93aeb18e318068df1bc02de72ad1a,0,Alexey Serbin,2021-12-10 19:38:58+00:00,['58ee81bcf8d1da1a10918deedf2a14ae9104bed6'],58,46,104,1723097,2,0,0,0,2816
44e517519e1507eafe58bd9179940160e6934079,0,Alexey Serbin,2021-12-10 20:41:05+00:00,['d0243afe2ed93aeb18e318068df1bc02de72ad1a'],1,1,2,1723099,1,,,,2816
60d34b68f4c42da04dd0a064db135568c5d75af9,0,Andrew Wong,2021-12-13 18:16:12+00:00,['44e517519e1507eafe58bd9179940160e6934079'],1,0,1,1723100,1,0,1,0,2816
ea67260aad998db7d34a94d25261e121a668faec,0,Alexey Serbin,2021-12-14 02:40:29+00:00,['60d34b68f4c42da04dd0a064db135568c5d75af9'],1,1,2,1723102,1,,,,2816
41a4d03f72f842dfb5450242739498d49a6526e2,0,Alexey Serbin,2021-12-14 18:18:09+00:00,['ea67260aad998db7d34a94d25261e121a668faec'],8,8,16,1723118,6,,,,2816
21d25d23fc6d0696592668fa56a02a884458982f,0,Alexey Serbin,2021-12-14 22:45:19+00:00,['41a4d03f72f842dfb5450242739498d49a6526e2'],6,13,19,1723137,2,0,1,0.666666667,2816
0741fd3a3b6db561465840192888072762a0a926,0,Alexey Serbin,2021-12-16 00:19:46+00:00,['21d25d23fc6d0696592668fa56a02a884458982f'],22,20,42,1723179,2,0,1,1,2816
7f6d81925fb9062df5d6c4b7b5ba5807419d7b05,0,Alexey Serbin,2021-12-16 04:14:13+00:00,['0741fd3a3b6db561465840192888072762a0a926'],0,9,9,1723188,2,0,0.666666667,1,2816
6908620821ab93cb964f0f7a3674abf9843a9b5f,0,Andrew Wong,2021-12-16 23:24:56+00:00,['7f6d81925fb9062df5d6c4b7b5ba5807419d7b05'],3,36,39,1723227,3,0.25,0.25,1,2816
46891a0a36bc034bfbcf1f2205105e52fd658efa,0,Alexey Serbin,2021-12-18 01:23:22+00:00,['6908620821ab93cb964f0f7a3674abf9843a9b5f'],0,1,1,1723228,1,0,1,1,2816
84600f495e8cff24aa8794d7974d0b6fe77b95db,0,Alexey Serbin,2021-12-20 19:54:07+00:00,['46891a0a36bc034bfbcf1f2205105e52fd658efa'],1,1,2,1723230,1,,,,2816
958248adf3ea70f12ab033e0041bfc5c922956af,0,Yingchun Lai,2021-12-21 02:29:05+00:00,['84600f495e8cff24aa8794d7974d0b6fe77b95db'],0,155,155,1723385,4,0.106557377,1,1,2816
80c8dde02310c94a65bed5acdfc28e332e334569,0,Yingchun Lai,2021-12-29 03:04:56+00:00,['958248adf3ea70f12ab033e0041bfc5c922956af'],18,95,113,1723498,7,0.018518519,0.203703704,0.981481481,2816
67ba3cae45143d083bdac119f45278ce0d2bfefb,0,Attila Bukor,2022-01-01 15:53:16+00:00,['80c8dde02310c94a65bed5acdfc28e332e334569'],1,1,2,1723500,1,,,,2816
5ef0168cf0ae4471632d63cad223d7301f415982,0,Yifan Zhang,2022-01-05 03:12:39+00:00,['67ba3cae45143d083bdac119f45278ce0d2bfefb'],46,151,197,1723697,4,0,0.762886598,0.87628866,2816
f94ff25d42822cd82be859bdfc585f873536660e,0,Yifan Zhang,2022-01-05 03:23:29+00:00,['5ef0168cf0ae4471632d63cad223d7301f415982'],10,23,33,1723730,1,,,,2816
a157dece2f7bd8636eb90148edeb202537c9b6a8,0,Yifan Zhang,2022-01-06 12:41:33+00:00,['f94ff25d42822cd82be859bdfc585f873536660e'],97,163,260,1723990,7,0.18,1,0.84,2816
0becb2484041210182afef511ced5f4a883075c8,0,Attila Bukor,2022-01-07 07:54:31+00:00,['a157dece2f7bd8636eb90148edeb202537c9b6a8'],3,6,9,1723999,1,,,,2816
0cb2b7c6225b7502101f350a878216cbbaa7acc2,0,Alexey Serbin,2022-01-10 18:00:48+00:00,['0becb2484041210182afef511ced5f4a883075c8'],5,20,25,1724024,4,0,0.666666667,0.444444444,2816
034b85f9c93ac2d54b23fa9f8358421b4795d217,0,Alexey Serbin,2022-01-10 20:56:23+00:00,['0cb2b7c6225b7502101f350a878216cbbaa7acc2'],9,5,14,1724038,3,1,0,1,2816
b1fa1a65a008591475b95f8bc0c90b3283826c5d,0,Attila Bukor,2022-01-11 07:59:29+00:00,['034b85f9c93ac2d54b23fa9f8358421b4795d217'],190,460,650,1724688,41,0.109947644,0.827225131,0.722513089,2816
1487467194075aaa285e4249f8e9552a756e9f01,0,Attila Bukor,2022-01-11 07:59:32+00:00,['b1fa1a65a008591475b95f8bc0c90b3283826c5d'],0,11,11,1724699,2,0.25,1,1,2816
55cab441c2d66c92f0c769e98d6a2f079e5563b2,0,Bankim Bhavsar,2022-01-11 18:12:14+00:00,['1487467194075aaa285e4249f8e9552a756e9f01'],2,190,192,1724891,2,0.0625,0.653409091,0.590909091,2816
1e5fadb029310f87193550126d8f6e448cddc27a,0,Alexey Serbin,2022-01-13 04:11:08+00:00,['55cab441c2d66c92f0c769e98d6a2f079e5563b2'],7,152,159,1725050,8,0.586538462,0.903846154,0.903846154,2816
234b498943c51e9801e00703ae6e2de21180919a,0,Alexey Serbin,2022-01-13 06:52:12+00:00,['1e5fadb029310f87193550126d8f6e448cddc27a'],0,22,22,1725072,1,0.769230769,1,1,2816
c146454dfa6a840b79a33f16bc2df6a3b6c93600,0,Alexey Serbin,2022-01-14 15:26:13+00:00,['234b498943c51e9801e00703ae6e2de21180919a'],5,11,16,1725088,1,,,,2816
7dc2c22c6bc88481fdd075507670d946cc4e6a91,0,Alexey Serbin,2022-01-18 18:57:56+00:00,['c146454dfa6a840b79a33f16bc2df6a3b6c93600'],1,8,9,1725097,1,0,0,0,2816
c9d7db6e48a4f32075363e33e412a16133b1e49b,0,Alexey Serbin,2022-01-18 19:37:08+00:00,['7dc2c22c6bc88481fdd075507670d946cc4e6a91'],32,85,117,1725214,2,0.074074074,0.944444444,0.574074074,2816
03f80e2b884b14fccd2ebc1b2c4284238b91ec5c,0,Alexey Serbin,2022-01-19 21:40:32+00:00,['c9d7db6e48a4f32075363e33e412a16133b1e49b'],2,5,7,1725221,1,,,,2816
a379e5447d63a9c675d888f88e062ec62859e922,0,Andrew Wong,2022-01-19 23:44:53+00:00,['03f80e2b884b14fccd2ebc1b2c4284238b91ec5c'],37,88,125,1725346,1,,,,2816
a0fd40fd5fe71f10ceb8f9966b43df2b8a40b68c,0,Andrew Wong,2022-01-20 00:14:44+00:00,['a379e5447d63a9c675d888f88e062ec62859e922'],0,1,1,1725347,1,,,,2816
320ba7282d171b07b8ddd03749a264d95a6649ec,0,Alexey Serbin,2022-01-21 05:32:20+00:00,['a0fd40fd5fe71f10ceb8f9966b43df2b8a40b68c'],0,16,16,1725363,1,,,,2816
9f7c80d630ebd7a7e2da2edacd910bcbd00f29ee,0,Alexey Serbin,2022-01-21 07:04:40+00:00,['320ba7282d171b07b8ddd03749a264d95a6649ec'],83,106,189,1725552,5,0.444444444,1,0,2816
96a6a8b91bd069ed5ebe3dfd4eb8179708eacda9,0,Alexey Serbin,2022-01-21 22:03:33+00:00,['9f7c80d630ebd7a7e2da2edacd910bcbd00f29ee'],1,110,111,1725663,2,,,,2816
9d01e1046249a815f26c7b5ebb1ceb2b67f72b9e,0,Andrew Wong,2022-01-22 20:20:31+00:00,['96a6a8b91bd069ed5ebe3dfd4eb8179708eacda9'],63,319,382,1726045,11,0.229813665,0.838509317,0.925465839,2816
791502b821f55f510a8d98170fcd4e1dba4d123a,0,Alexey Serbin,2022-01-25 07:27:37+00:00,['9d01e1046249a815f26c7b5ebb1ceb2b67f72b9e'],4,4,8,1726053,2,,,,2816
1489f817371ca7b7a1ed5ee3501f1089a888d73c,0,Alexey Serbin,2022-01-25 21:53:25+00:00,['791502b821f55f510a8d98170fcd4e1dba4d123a'],1,43,44,1726097,2,,,,2817
27ac602108ab5e6b4e2211c2bfae3b36badc3121,0,Alexey Serbin,2022-01-25 22:24:53+00:00,['1489f817371ca7b7a1ed5ee3501f1089a888d73c'],1,7,8,1726105,1,,,,2817
10e3cec12716a80d9e4afda397acfcb7ce498df0,0,Attila Bukor,2022-01-26 12:14:25+00:00,['27ac602108ab5e6b4e2211c2bfae3b36badc3121'],41,42,83,1726188,10,1,1,1,2817
6f3087ba6bb16ceb8c9904246761524373292489,0,Alexey Serbin,2022-01-26 22:01:56+00:00,['10e3cec12716a80d9e4afda397acfcb7ce498df0'],0,64,64,1726252,6,,,,2818
c2e3efdcefd1de65d805749ba3198adfe9dba79d,0,Alexey Serbin,2022-01-29 19:30:45+00:00,['6f3087ba6bb16ceb8c9904246761524373292489'],0,4,4,1726256,1,,,,2818
e8bc5ce92462ad4145f966f4cb589adffbd64405,0,Alexey Serbin,2022-01-30 02:38:30+00:00,['c2e3efdcefd1de65d805749ba3198adfe9dba79d'],0,2,2,1726258,1,,,,2818
feaccee2b82ebd47d8244a1fdf346c1394c8ae91,0,Attila Bukor,2022-01-31 08:51:32+00:00,['e8bc5ce92462ad4145f966f4cb589adffbd64405'],255,715,970,1727228,28,0.022082019,0.438485804,0.463722397,2818
a760429a6479fdd71dd8e25bc35c39e46a9dd8f4,0,Alexey Serbin,2022-01-31 18:47:07+00:00,['feaccee2b82ebd47d8244a1fdf346c1394c8ae91'],15,12,27,1727255,2,1,1,0,2818
ee5e856b93e6efff415a81955071465dce0e2ded,0,Alexey Serbin,2022-02-01 19:19:23+00:00,['a760429a6479fdd71dd8e25bc35c39e46a9dd8f4'],14,41,55,1727310,5,0.785714286,0.928571429,0.714285714,2818
3a5cc4409fac2e264da5553d7ec8defce9457397,0,Alexey Serbin,2022-02-01 21:54:00+00:00,['ee5e856b93e6efff415a81955071465dce0e2ded'],39,44,83,1727393,1,0,1,1,2818
bac76fcf9d496995591e968dffa822fe0fb21d5d,0,Alexey Serbin,2022-02-01 21:54:15+00:00,['3a5cc4409fac2e264da5553d7ec8defce9457397'],12,55,67,1727460,6,0.588235294,1,1,2818
f4fa4d22f2dc122c2c130fd08142317869729e28,0,Alexey Serbin,2022-02-01 21:57:15+00:00,['bac76fcf9d496995591e968dffa822fe0fb21d5d'],27,68,95,1727555,4,0.9375,0.9375,1,2818
2392bf72a0abc0cb02b0e67633e29f69be3baf2f,0,Alexey Serbin,2022-02-05 05:35:55+00:00,['f4fa4d22f2dc122c2c130fd08142317869729e28'],1,1,2,1727557,1,,,,2818
205710c9246ea847b19d6d923297bcf5002cd70b,0,Alexey Serbin,2022-02-05 05:36:31+00:00,['2392bf72a0abc0cb02b0e67633e29f69be3baf2f'],76,80,156,1727713,9,0,1,0.75,2818
90895ce76590f10730ad7aac3613b69d89ff5422,0,Alexey Serbin,2022-02-10 05:44:55+00:00,['205710c9246ea847b19d6d923297bcf5002cd70b'],24,172,196,1727909,2,0,0.464285714,0.75,2818
136a8c21549c9d81d96d8ef3cfa4d200b9325f32,0,Alexey Serbin,2022-02-14 21:41:24+00:00,['90895ce76590f10730ad7aac3613b69d89ff5422'],6,79,85,1727994,3,0,1,1,2818
426d2ecb04d0f76ac50fe0868f40398ba6848582,0,Alexey Serbin,2022-02-15 16:29:01+00:00,['136a8c21549c9d81d96d8ef3cfa4d200b9325f32'],0,13,13,1728007,2,0,0.916666667,0.916666667,2818
c7afc431861fbd3e1947d2358795cade1ab2f71e,0,Alexey Serbin,2022-02-15 19:26:34+00:00,['426d2ecb04d0f76ac50fe0868f40398ba6848582'],0,99,99,1728106,2,0.468085106,1,0.787234043,2818
31a9b0158984fc000f35cff483856eaec5338132,0,Yingchun Lai,2022-02-16 02:57:46+00:00,['c7afc431861fbd3e1947d2358795cade1ab2f71e'],29,25,54,1728160,1,0,0,0,2818
9f164b3c542a2e44c963c43488b4fc5b0d0f0f65,0,Andrew Wong,2022-02-16 18:39:19+00:00,['31a9b0158984fc000f35cff483856eaec5338132'],4,269,273,1728433,3,0.063241107,0.897233202,0.889328063,2818
5557c488e1c4264c20b764235b4830456f73ce3b,0,Alexey Serbin,2022-02-16 21:24:39+00:00,['9f164b3c542a2e44c963c43488b4fc5b0d0f0f65'],80,98,178,1728611,13,0,0,1,2818
e260d546d8765a90cfa9b08b2e35af212c11a429,0,Alexey Serbin,2022-02-16 21:52:11+00:00,['5557c488e1c4264c20b764235b4830456f73ce3b'],0,6,6,1728617,1,,,,2818
5f0964a5ca7476b9bbb6d56fdb131eec50699d21,0,Alexey Serbin,2022-02-17 02:14:04+00:00,['e260d546d8765a90cfa9b08b2e35af212c11a429'],9,9,18,1728635,2,,,,2818
d2b1d2f40f6fc4aacf73b2cc865a9e5c35e00c10,0,Alexey Serbin,2022-02-17 22:37:20+00:00,['5f0964a5ca7476b9bbb6d56fdb131eec50699d21'],1,1,2,1728637,1,,,,2818
b18e07a18fec1ecc868e18acbf06a19f4d8a410f,0,Alexey Serbin,2022-02-18 00:22:19+00:00,['d2b1d2f40f6fc4aacf73b2cc865a9e5c35e00c10'],1,1,2,1728639,1,,,,2818
8a26e843a1ff5a807a4b6f1c77f6146bc5156398,0,Alexey Serbin,2022-02-18 00:24:07+00:00,['b18e07a18fec1ecc868e18acbf06a19f4d8a410f'],1,3,4,1728643,1,0,1,1,2818
d1cfc20dc4523784f11f9d60ee2ca9d2546c13db,0,Alexey Serbin,2022-02-18 01:48:04+00:00,['8a26e843a1ff5a807a4b6f1c77f6146bc5156398'],1,2,3,1728646,2,,,,2818
7db93eba9ad84ddc276256a4d72faa941c182344,0,Alexey Serbin,2022-02-18 16:02:21+00:00,['d1cfc20dc4523784f11f9d60ee2ca9d2546c13db'],2,2,4,1728650,1,,0,,2818
2de290d1b342696cd22c0a800aee5b1bf684a0fa,0,Alexey Serbin,2022-02-21 18:23:45+00:00,['7db93eba9ad84ddc276256a4d72faa941c182344'],24,267,291,1728941,8,0.036585366,0.536585366,0.951219512,2818
78ee89ef6218038d05e004f341092650741f8132,0,Yifan Zhang,2022-02-22 13:36:21+00:00,['2de290d1b342696cd22c0a800aee5b1bf684a0fa'],7,7,14,1728955,4,,,,2818
cd48ce74025dd2d8287eb66b9d615a492b2267bb,0,Alexey Serbin,2022-02-24 03:10:54+00:00,['78ee89ef6218038d05e004f341092650741f8132'],120,121,241,1729196,42,,,,2818
2d070cd1e11d1d9943f8ee20eb9fc17f61e4cb42,0,Attila Bukor,2022-02-25 19:00:35+00:00,['cd48ce74025dd2d8287eb66b9d615a492b2267bb'],29,29,58,1729254,2,,,,2818
24f85cedcd47e585ea9c308c317da963c5ab8fa9,0,Alexey Serbin,2022-02-25 22:26:50+00:00,['2d070cd1e11d1d9943f8ee20eb9fc17f61e4cb42'],8,14,22,1729276,1,0,0,1,2818
0335f3ea6356011ac88c25a9a353b4fbec952a42,0,Andrew Wong,2022-02-25 23:01:39+00:00,['24f85cedcd47e585ea9c308c317da963c5ab8fa9'],3,7,10,1729286,1,,,,2818
a2ba855deaba72846362c95d3614bdb3dd282a87,0,Alexey Serbin,2022-03-01 01:08:02+00:00,['0335f3ea6356011ac88c25a9a353b4fbec952a42'],13,15,28,1729314,2,1,1,,2818
43905d86bdbd2dd4a4bf9d0cea52453a3a7d9d31,0,Alexey Serbin,2022-03-01 02:23:06+00:00,['a2ba855deaba72846362c95d3614bdb3dd282a87'],4,10,14,1729328,2,0,0,1,2818
f4b6d8917b79b9de53957174ade1a7ffc76e0090,0,Andrew Wong,2022-03-03 23:53:03+00:00,['43905d86bdbd2dd4a4bf9d0cea52453a3a7d9d31'],149,161,310,1729638,30,0,0.263157895,0.263157895,2818
1750aedbbe20134b7dec52cd52ac6c2e330d77e0,0,Alexey Serbin,2022-03-04 00:02:52+00:00,['f4b6d8917b79b9de53957174ade1a7ffc76e0090'],0,1,1,1729639,1,,,,2818
9e952ad9d87eefc9ef840cd3edbdd62dd9f0243e,0,Alexey Serbin,2022-03-09 19:15:44+00:00,['1750aedbbe20134b7dec52cd52ac6c2e330d77e0'],1,7,8,1729647,1,0,0,1,2818
8e704f28b172e211477bd06409a429b20a1e55a1,0,Alexey Serbin,2022-03-09 22:02:24+00:00,['9e952ad9d87eefc9ef840cd3edbdd62dd9f0243e'],5,71,76,1729723,2,0.069767442,1,1,2818
2a5e56594a9dac28df9b02365d340bbd6a8e480f,0,Alexey Serbin,2022-03-14 22:24:16+00:00,['8e704f28b172e211477bd06409a429b20a1e55a1'],19,20,39,1729762,2,0,0,1,2818
7189b519625d8f6ef7f70bc259733a672a28267f,0,Alexey Serbin,2022-03-14 22:57:11+00:00,['2a5e56594a9dac28df9b02365d340bbd6a8e480f'],0,28,28,1729790,2,0.52173913,0.695652174,0.826086957,2818
c45eba48ed37c04700b25ffd8664ce7c9c27135b,0,Alexey Serbin,2022-03-16 21:20:44+00:00,['7189b519625d8f6ef7f70bc259733a672a28267f'],4,4,8,1729798,1,,,,2818
df65b3a3d04115fc38bdb739207123816999557d,0,Alexey Serbin,2022-03-17 21:06:04+00:00,['c45eba48ed37c04700b25ffd8664ce7c9c27135b'],1,1,2,1729800,1,,,,2818
91d3101008961338078d0b80e5f2e3d1dc552133,0,Alexey Serbin,2022-03-17 23:03:05+00:00,['df65b3a3d04115fc38bdb739207123816999557d'],28,191,219,1730019,6,0,0.436363636,0.972727273,2818
9a53fec14b9aaa811732f2b7a87da36d893203da,0,Andrew Wong,2022-03-17 23:13:15+00:00,['91d3101008961338078d0b80e5f2e3d1dc552133'],4,21,25,1730044,1,0,0,0.578947368,2818
8409d28a5ace591f635b029cb37ebd70f3b8eb10,0,Yingchun Lai,2022-03-18 02:29:42+00:00,['9a53fec14b9aaa811732f2b7a87da36d893203da'],9,90,99,1730143,5,0.153846154,0.961538462,0.961538462,2818
b8105124af9291edd0108f43a01fcb4cd51e049c,0,Alexey Serbin,2022-03-21 15:25:30+00:00,['8409d28a5ace591f635b029cb37ebd70f3b8eb10'],1,1,2,1730145,1,,,,2818
a8fb42dc34e8f1f876db5b26fc3f5eb3196ce854,0,Alexey Serbin,2022-03-24 04:06:35+00:00,['b8105124af9291edd0108f43a01fcb4cd51e049c'],39,33,72,1730217,2,,,,2818
a31a2512c90193a2d972c6826a3ad30ab23c95c8,0,Yingchun Lai,2022-03-24 07:25:59+00:00,['a8fb42dc34e8f1f876db5b26fc3f5eb3196ce854'],71,321,392,1730609,2,0.184971098,0.208092486,0.976878613,2818
0fc1d8be8ba95a4e3b10e2479d3d73f0b2e10fd7,0,Alexey Serbin,2022-03-24 17:52:26+00:00,['a31a2512c90193a2d972c6826a3ad30ab23c95c8'],0,30,30,1730639,1,,,,2818
66fe33642ac9662b8d2a3e52a90168b2184e4d88,0,Alexey Serbin,2022-04-01 04:38:52+00:00,['0fc1d8be8ba95a4e3b10e2479d3d73f0b2e10fd7'],13,236,249,1730888,12,0.053763441,0.279569892,0.795698925,2820
2bf2b2d5dcd61a80f928e9f4a20fe70c42f00592,0,Alexey Serbin,2022-04-04 16:36:39+00:00,['66fe33642ac9662b8d2a3e52a90168b2184e4d88'],26,24,50,1730938,3,1,1,1,2820
fb6dc60621aa49f214b06d70527860c6a26c0e15,0,Alexey Serbin,2022-04-04 16:40:21+00:00,['2bf2b2d5dcd61a80f928e9f4a20fe70c42f00592'],4,156,160,1731098,4,,,,2823
01ca8c3f2bb38bc8b738d86d3d88aa8d1ffaad87,0,Alexey Serbin,2022-04-04 18:22:03+00:00,['fb6dc60621aa49f214b06d70527860c6a26c0e15'],329,1233,1562,1732660,10,0.047979798,0.689393939,0.851010101,2823
ed04c8b6f70c6dd5b63cc517e33fb8e52c1c3ce9,0,Alexey Serbin,2022-04-06 19:05:31+00:00,['01ca8c3f2bb38bc8b738d86d3d88aa8d1ffaad87'],3,3,6,1732666,1,,,,2823
fe2ba596dda3872789de8d42ccc2b82b6db42d47,0,Alexey Serbin,2022-04-08 15:06:36+00:00,['ed04c8b6f70c6dd5b63cc517e33fb8e52c1c3ce9'],1,1,2,1732668,1,,,,2823
49e0d6d428eed80dd8d96ab191c2d5062a9ed5dd,0,Alexey Serbin,2022-04-08 15:07:28+00:00,['fe2ba596dda3872789de8d42ccc2b82b6db42d47'],6,10,16,1732684,1,0,0,1,2823
6521248a2f4df4f98fa3b876609408617bc9d701,0,Andrew Wong,2022-04-14 21:38:54+00:00,['49e0d6d428eed80dd8d96ab191c2d5062a9ed5dd'],243,1040,1283,1733967,19,0.197530864,1,0.812757202,2823
c71f8abbbebb6e8c003090c0bb5866b443b8955f,0,Alexey Serbin,2022-04-19 03:23:19+00:00,['6521248a2f4df4f98fa3b876609408617bc9d701'],4,7,11,1733978,1,0,1,1,2823
42fbe6b2e0085d934068e1687de1d3c936e89ed1,0,Alexey Serbin,2022-04-20 23:48:04+00:00,['c71f8abbbebb6e8c003090c0bb5866b443b8955f'],0,1,1,1733979,1,1,1,1,2823
88148d37ab2ecb3ffc512cc756f4baf7d502bb5f,0,Yifan Zhang,2022-04-21 09:10:49+00:00,['42fbe6b2e0085d934068e1687de1d3c936e89ed1'],1,1,2,1733981,1,,,,2823
285e26a0cce308d2fff8859e6bc593b0b0d41f61,0,Yingchun Lai,2022-04-24 06:48:02+00:00,['88148d37ab2ecb3ffc512cc756f4baf7d502bb5f'],0,1,1,1733982,1,0,1,1,2823
66923d9ed55b43637f4d9d08519619188fba2bc0,0,Yingchun Lai,2022-04-25 06:14:54+00:00,['285e26a0cce308d2fff8859e6bc593b0b0d41f61'],28,28,56,1734038,1,,,,2823
d216e417f7fa7daef59ec7eb2c15aadfd4e1c563,0,Alexey Serbin,2022-04-26 16:50:24+00:00,['66923d9ed55b43637f4d9d08519619188fba2bc0'],4,15,19,1734057,1,0,1,1,2823
50b1cc45f9fde3deac5aa0fef216f4950246b2c9,0,Alexey Serbin,2022-04-27 19:09:54+00:00,['d216e417f7fa7daef59ec7eb2c15aadfd4e1c563'],12,62,74,1734131,3,0.216216216,0.351351351,0.945945946,2823
0616d9604588875364ce1380107a4ecd55440a9c,0,Yingchun Lai,2022-04-29 02:35:30+00:00,['50b1cc45f9fde3deac5aa0fef216f4950246b2c9'],6,7,13,1734144,1,1,1,1,2823
0ddcaaabc97c85a4715ae79ff5604feb9b342779,0,Alexey Serbin,2022-04-30 05:00:51+00:00,['0616d9604588875364ce1380107a4ecd55440a9c'],2,138,140,1734284,11,0.414285714,0.871428571,0.714285714,2823
f736c6bbab1ca6290808bbe8fad205958a955bd7,0,Yifan Zhang,2022-05-01 03:33:04+00:00,['0ddcaaabc97c85a4715ae79ff5604feb9b342779'],13,9,22,1734306,1,1,1,0,2823
54d0f0b227b82a5ae5bb6095877858e6cbb7c9c8,0,Alexey Serbin,2022-05-02 17:44:04+00:00,['f736c6bbab1ca6290808bbe8fad205958a955bd7'],3,57,60,1734366,4,0.047619048,1,1,2823
9ff042b734e617f1a7fac4a6a205210798dbe04e,0,Attila Bukor,2022-05-03 23:23:36+00:00,['54d0f0b227b82a5ae5bb6095877858e6cbb7c9c8'],7,65,72,1734438,1,,,,2823
d411dd1b41a47a5d9f1ee9b68911aa5952475896,0,Alexey Serbin,2022-05-05 16:21:26+00:00,['9ff042b734e617f1a7fac4a6a205210798dbe04e'],5,4,9,1734447,1,,,,2823
03f266854a6ab7ff1732d380c722ba64c018ecc1,0,Alexey Serbin,2022-05-05 22:12:33+00:00,['d411dd1b41a47a5d9f1ee9b68911aa5952475896'],5,120,125,1734572,9,0.043478261,0.898550725,0.666666667,2823
d32ea18f017582e1d052ded617a2c13608b0d54b,0,Yingchun Lai,2022-05-07 02:43:35+00:00,['03f266854a6ab7ff1732d380c722ba64c018ecc1'],42,120,162,1734734,3,0,0,1,2823
becef62700744e961d8450c39776f6d4a43ec145,0,Andrew Wong,2022-05-07 05:05:04+00:00,['d32ea18f017582e1d052ded617a2c13608b0d54b'],3,160,163,1734897,4,0.140350877,0.298245614,1,2823
11db3f28b36d92ce1515bcaace51a3586838abcb,0,Alexey Serbin,2022-05-10 15:01:45+00:00,['becef62700744e961d8450c39776f6d4a43ec145'],0,3,3,1734900,1,,,,2823
2b2a199077a2eb6e813a4b33601477a25491049e,0,Alexey Serbin,2022-05-10 16:16:29+00:00,['11db3f28b36d92ce1515bcaace51a3586838abcb'],33,30,63,1734963,1,,,,2823
50395ff74cb47e9ac126e4bca38de1d7e48511c3,0,Alexey Serbin,2022-05-10 17:45:43+00:00,['2b2a199077a2eb6e813a4b33601477a25491049e'],2,6,8,1734971,1,,,,2823
948417a460587a655773ed4bb1869b4bc5aa83f8,0,Alexey Serbin,2022-05-10 17:46:06+00:00,['50395ff74cb47e9ac126e4bca38de1d7e48511c3'],0,7,7,1734978,2,,,,2823
09a6c8833e085dd46c18acec611191e6374c73b5,0,Alexey Serbin,2022-05-10 17:49:37+00:00,['948417a460587a655773ed4bb1869b4bc5aa83f8'],12,39,51,1735029,2,0,1,1,2823
1e19a68221fbdc4151cac077f6a147e415430c30,0,Alexey Serbin,2022-05-12 01:35:55+00:00,['09a6c8833e085dd46c18acec611191e6374c73b5'],20,506,526,1735555,4,0.021108179,0.73878628,1,2823
d3a628eb14cbfc78bc89d196def8f5ce491f32ba,0,Yifan Zhang,2022-05-16 02:49:13+00:00,['1e19a68221fbdc4151cac077f6a147e415430c30'],0,1,1,1735556,1,,,,2823
e2f0d8fb056d9834199ec2feab8888a30daefae7,0,Alexey Serbin,2022-05-16 17:10:40+00:00,['d3a628eb14cbfc78bc89d196def8f5ce491f32ba'],21,28,49,1735605,1,1,1,1,2823
5f29e04230dadd840b12887423fb76ac62d96538,0,Alexey Serbin,2022-05-17 01:53:31+00:00,['e2f0d8fb056d9834199ec2feab8888a30daefae7'],44,125,169,1735774,2,0,0.678571429,0.946428571,2823
54855326b66dea649215702dc936988638205345,0,Yifan Zhang,2022-05-19 09:41:54+00:00,['5f29e04230dadd840b12887423fb76ac62d96538'],2,178,180,1735954,3,0,0.344370861,1,2823
17fd93255e124191c840702dab3eed961aadee7f,0,Yifan Zhang,2022-05-19 10:33:45+00:00,['54855326b66dea649215702dc936988638205345'],0,38,38,1735992,2,0,0,1,2823
ce499cec329874db03317ad57a165959fb8893b4,0,Alexey Serbin,2022-05-23 16:21:32+00:00,['17fd93255e124191c840702dab3eed961aadee7f'],30,64,94,1736086,2,0,1,1,2823
b60b724ce033a8956508701a7d58b94a60184313,0,Yingchun Lai,2022-05-24 03:28:33+00:00,['ce499cec329874db03317ad57a165959fb8893b4'],5,257,262,1736348,3,0.312883436,0.969325153,0.975460123,2823
b6aaf2b71da05c5427e1bee0dccc0e66101c684d,0,Attila Bukor,2022-05-26 15:03:59+00:00,['b60b724ce033a8956508701a7d58b94a60184313'],110,413,523,1736871,35,0.288135593,0.898305085,0.762711864,2823
abe2a73cdbe6438e34f825594d66aec53a329840,0,Attila Bukor,2022-06-02 08:54:42+00:00,['b6aaf2b71da05c5427e1bee0dccc0e66101c684d'],14,193,207,1737078,12,0.828571429,0.942857143,0.828571429,2826
9699f5885ca18a1760d5d150b3ba82424d8948b3,0,Alexey Serbin,2022-06-02 20:26:42+00:00,['abe2a73cdbe6438e34f825594d66aec53a329840'],9,15,24,1737102,1,1,1,1,2826
3f34163156cfe47a9b4994dda38e5af4d2f5c0c1,0,Yingchun Lai,2022-06-07 06:40:57+00:00,['9699f5885ca18a1760d5d150b3ba82424d8948b3'],1,7,8,1737110,1,0,0,0,2826
60184dd725b912ac2b714c1fd17401c10691fe8d,0,Alexey Serbin,2022-06-07 14:26:56+00:00,['3f34163156cfe47a9b4994dda38e5af4d2f5c0c1'],4,17,21,1737131,2,1,1,1,2826
fae44610a8af0d26463f4342847a4e37c7808f91,0,Alexey Serbin,2022-06-07 17:28:45+00:00,['60184dd725b912ac2b714c1fd17401c10691fe8d'],2,5,7,1737138,1,0,1,1,2826
250eb90bc0e1f4f472f44de8a23ce213595d5ee7,0,Alexey Serbin,2022-06-09 17:07:38+00:00,['fae44610a8af0d26463f4342847a4e37c7808f91'],10,134,144,1737282,2,0.02020202,0.777777778,0.757575758,2826
687bef89764640746deb27b3279e936acae4446e,0,Alexey Serbin,2022-06-10 15:07:10+00:00,['250eb90bc0e1f4f472f44de8a23ce213595d5ee7'],0,2,2,1737284,1,1,1,1,2826
236a589140f46b7a0138c2b26620f596139f2777,0,Alexey Serbin,2022-06-13 16:58:03+00:00,['687bef89764640746deb27b3279e936acae4446e'],53,93,146,1737430,2,0.909090909,1,1,2826
9091f31cfc5c102b6a734fa20b015735251392d4,0,Alexey Serbin,2022-06-14 17:13:20+00:00,['236a589140f46b7a0138c2b26620f596139f2777'],575,531,1106,1738536,11,1,1,0.108695652,2826
295b4903bc69fabb3cb36f618022d465c91954c7,0,Alexey Serbin,2022-06-16 15:21:32+00:00,['9091f31cfc5c102b6a734fa20b015735251392d4'],90,101,191,1738727,4,0,1,1,2826
6909ee4f800da192b72e59680916e5004527b6db,0,Alexey Serbin,2022-06-16 15:21:56+00:00,['295b4903bc69fabb3cb36f618022d465c91954c7'],28,181,209,1738936,3,0,0.875,0.875,2826
45a7857b494703ef5cf9da8671c75da88d5fc16d,0,Alexey Serbin,2022-06-17 18:24:22+00:00,['6909ee4f800da192b72e59680916e5004527b6db'],12,34,46,1738982,4,0.05,0.15,1,2826
ed5d5a11e54211c46560e3136bece6532e6d3b72,0,Alexey Serbin,2022-06-21 17:33:27+00:00,['45a7857b494703ef5cf9da8671c75da88d5fc16d'],19,22,41,1739023,1,0,0,0,2826
554edeca2cb47ee14c73f84a228be670faf342f2,0,Yifan Zhang,2022-06-22 13:17:50+00:00,['ed5d5a11e54211c46560e3136bece6532e6d3b72'],63,172,235,1739258,4,0,0.907894737,0.907894737,2826
3f0c434143ad6daa8ed4f39d8ceacbe58604dd29,0,Alexey Serbin,2022-06-24 18:06:48+00:00,['554edeca2cb47ee14c73f84a228be670faf342f2'],1873,1935,3808,1743066,249,0.405405405,0.972972973,0.837837838,2826
f55dd22bfea4beee99d72891efbbc67307b19d1e,0,Alexey Serbin,2022-06-29 16:22:55+00:00,['3f0c434143ad6daa8ed4f39d8ceacbe58604dd29'],172,855,1027,1744093,8,0.007858546,0.671905697,0.805500982,2826
3c415ea2f4418d60d94ff870154b3128100a7d77,0,Alexey Serbin,2022-06-29 17:47:57+00:00,['f55dd22bfea4beee99d72891efbbc67307b19d1e'],57,765,822,1744915,5,0.021702838,0.919866444,0.919866444,2826
936d7edc4e4b69d2e1f1dffc96760cb3fd57a934,0,Yingchun Lai,2022-06-30 12:09:42+00:00,['3c415ea2f4418d60d94ff870154b3128100a7d77'],39,247,286,1745201,6,0.39375,0.6875,0.76875,2826
00a2c7f29408968ab989215d56fc01dab4edac5b,0,Yingchun Lai,2022-06-30 12:11:28+00:00,['936d7edc4e4b69d2e1f1dffc96760cb3fd57a934'],4,11,15,1745216,2,0,0,1,2826
1889d4c44385fec5efeeb2d287d9ab7a3544dcfe,0,Alexey Serbin,2022-06-30 18:46:52+00:00,['00a2c7f29408968ab989215d56fc01dab4edac5b'],30,290,320,1745536,5,0,0.774834437,0.887417219,2826
76f475abad0194464fd2e46383be7467f50aedd3,0,Alexey Serbin,2022-07-01 15:35:05+00:00,['1889d4c44385fec5efeeb2d287d9ab7a3544dcfe'],10,175,185,1745721,7,0,0.91509434,0.924528302,2826
8b31a0ed48a8ee830c68dc74143c924f4b1f2116,0,Alexey Serbin,2022-07-01 22:53:08+00:00,['76f475abad0194464fd2e46383be7467f50aedd3'],169,1969,2138,1747859,14,0.054721977,0.859664607,0.859664607,2828
248d9f8cecd947d700f9e1135db17a30ea1e194a,0,Alexey Serbin,2022-07-01 23:16:36+00:00,['8b31a0ed48a8ee830c68dc74143c924f4b1f2116'],7,567,574,1748433,3,0,0.617577197,1,2828
e696b8a1a4936d5703a9d5d26469ea997a0b2d90,0,Alexey Serbin,2022-07-02 00:40:21+00:00,['248d9f8cecd947d700f9e1135db17a30ea1e194a'],10,121,131,1748564,6,0.162790698,1,1,2828
357dd89f7acc645456eea1c46d233f94aaa4e150,0,Alexey Serbin,2022-07-02 20:35:25+00:00,['e696b8a1a4936d5703a9d5d26469ea997a0b2d90'],1,2,3,1748567,1,,,,2828
75045fa10619c5674ca9b6405332be97e43bfeba,0,Alexey Serbin,2022-07-02 21:18:46+00:00,['357dd89f7acc645456eea1c46d233f94aaa4e150'],6,39,45,1748612,2,0,1,1,2828
b746978c71ce4a95b69d49c43d0ac852909a8b4e,0,Alexey Serbin,2022-07-03 22:31:24+00:00,['75045fa10619c5674ca9b6405332be97e43bfeba'],122,582,704,1749316,8,0.061797753,1,0.926966292,2828
05903d96296f9d06423deaddcfbeb5f22461dc76,0,Alexey Serbin,2022-07-04 05:07:51+00:00,['b746978c71ce4a95b69d49c43d0ac852909a8b4e'],9,155,164,1749480,3,0,0.00729927,0.737226277,2828
a50aa5bfdcebd9e842a357e47caa307e5db2bae0,0,Alexey Serbin,2022-07-07 05:09:45+00:00,['05903d96296f9d06423deaddcfbeb5f22461dc76'],3,41,44,1749524,4,0.791666667,0.833333333,1,2828
aba975b2c0ea676b8637c7935e749dbf2478b750,0,Yingchun Lai,2022-07-08 02:56:19+00:00,['a50aa5bfdcebd9e842a357e47caa307e5db2bae0'],0,7,7,1749531,1,0,1,1,2828
1609ecc72487a3237ccc464e3fa6f82b3d173e17,0,Alexey Serbin,2022-07-11 23:02:11+00:00,['aba975b2c0ea676b8637c7935e749dbf2478b750'],31,299,330,1749861,3,0,0.955223881,0.955223881,2828
8c8f393a4dc772a3dae2c14e59952ab1569884ec,0,Alexey Serbin,2022-07-11 23:02:32+00:00,['1609ecc72487a3237ccc464e3fa6f82b3d173e17'],11,12,23,1749884,1,0,0.333333333,1,2828
23908bdbe753c25aa2a33796559ecf64f0197949,0,Alexey Serbin,2022-07-11 23:02:51+00:00,['8c8f393a4dc772a3dae2c14e59952ab1569884ec'],24,17,41,1749925,3,0,0.916666667,0.958333333,2828
2696d5d044a44f35abf906ac371eebd627c98d08,0,Alexey Serbin,2022-07-12 01:06:00+00:00,['23908bdbe753c25aa2a33796559ecf64f0197949'],19,76,95,1750020,3,0.2,0.333333333,1,2828
e0f96b9c838e33b93690a76f771d1eeaf3a99222,0,Alexey Serbin,2022-07-12 02:25:54+00:00,['2696d5d044a44f35abf906ac371eebd627c98d08'],15,24,39,1750059,5,1,0,0,2828
8c20126d8a648f3fed15b4f41527089947d80d11,0,Alexey Serbin,2022-07-13 02:09:48+00:00,['e0f96b9c838e33b93690a76f771d1eeaf3a99222'],10,208,218,1750277,2,0,1,1,2828
317ff2a1763211d399e2c6c3afa47cad766d5a03,0,Alexey Serbin,2022-07-13 05:48:53+00:00,['8c20126d8a648f3fed15b4f41527089947d80d11'],6,234,240,1750517,2,0,1,1,2828
b60b6fd7751b3b67156f460fb46dabd2db00d9d7,0,Yingchun Lai,2022-07-13 15:20:38+00:00,['317ff2a1763211d399e2c6c3afa47cad766d5a03'],1,1,2,1750519,1,,,,2828
9c547a6a43335565b615bb91301ee03b9f555fdb,0,Alexey Serbin,2022-07-13 19:42:56+00:00,['b60b6fd7751b3b67156f460fb46dabd2db00d9d7'],1,1,2,1750521,1,,,,2828
f1522c716f37e6a9db80de77a9783e0c48027a61,0,Yingchun Lai,2022-07-14 01:09:48+00:00,['9c547a6a43335565b615bb91301ee03b9f555fdb'],7,4,11,1750532,1,,,,2828
5664e280a7cdbce055227da2e556f937952dd89f,0,Yingchun Lai,2022-07-14 01:21:16+00:00,['f1522c716f37e6a9db80de77a9783e0c48027a61'],68,3,71,1750603,10,0.916666667,0,0,2828
708fdff19073dbe9dc4eb9492551443aa38111f9,0,Alexey Serbin,2022-07-14 05:10:03+00:00,['5664e280a7cdbce055227da2e556f937952dd89f'],89,78,167,1750770,20,1,0,0,2828
e8ce3a9bff9d3a0c00af7e71592e552c33ce5b24,0,Alexey Serbin,2022-07-14 21:39:44+00:00,['708fdff19073dbe9dc4eb9492551443aa38111f9'],16,413,429,1751199,6,0,0.185897436,0.875,2828
43ee785b2d793fe9abaae91ad152c50813e9aa59,0,Alexey Serbin,2022-07-14 22:18:30+00:00,['e8ce3a9bff9d3a0c00af7e71592e552c33ce5b24'],5,50,55,1751254,4,0.647058824,0.647058824,0.647058824,2828
dc4031f693382df08c0fab1d0c5ac6bc3c203c35,0,Alexey Serbin,2022-07-15 18:39:06+00:00,['43ee785b2d793fe9abaae91ad152c50813e9aa59'],110,276,386,1751640,5,0.04109589,0.993150685,0.910958904,2828
6fe47b5ecc5bdafdb17aa7722d296c4e5d4d32bf,0,Yifan Zhang,2022-07-20 07:30:31+00:00,['dc4031f693382df08c0fab1d0c5ac6bc3c203c35'],1,94,95,1751735,1,0.176470588,1,1,2828
7618d34e4c60ee1c14f5cb734ea0c4cfa581dfde,0,Yifan Zhang,2022-07-20 14:04:43+00:00,['6fe47b5ecc5bdafdb17aa7722d296c4e5d4d32bf'],12,31,43,1751778,2,0,1,1,2828
1bde51fa0d5800ee76160258a8e879f7cce66a75,0,Alexey Serbin,2022-07-21 14:37:03+00:00,['7618d34e4c60ee1c14f5cb734ea0c4cfa581dfde'],6,61,67,1751845,3,0,1,1,2828
54ee2103d9dde5347891d4cf4a4dbd674774f475,0,Attila Bukor,2022-07-21 14:58:35+00:00,['1bde51fa0d5800ee76160258a8e879f7cce66a75'],1,24,25,1751870,3,,,,2828
9aa17addd132956a2a09bf522aa5d565a4098775,0,Alexey Serbin,2022-07-21 15:26:25+00:00,['54ee2103d9dde5347891d4cf4a4dbd674774f475'],21,22,43,1751913,1,,,,2828
6fdd9190592fe47c2202e75edd2773832bf29968,0,Alexey Serbin,2022-07-21 20:20:31+00:00,['9aa17addd132956a2a09bf522aa5d565a4098775'],110,103,213,1752126,7,0.666666667,0.333333333,0.5,2828
55d711d78a21c76718b06dede79de2e9b9d5e8e8,0,Alexey Serbin,2022-07-22 02:15:24+00:00,['6fdd9190592fe47c2202e75edd2773832bf29968'],0,191,191,1752317,3,0,1,1,2828
81f7c5b43fe4546ee1b7526b51a13126da706980,0,Yifan Zhang,2022-07-22 06:41:25+00:00,['55d711d78a21c76718b06dede79de2e9b9d5e8e8'],80,342,422,1752739,7,0.014778325,0.463054187,0.487684729,2828
8902ca6911b348ec3737da0e5f670726642f9fb0,0,Attila Bukor,2022-07-22 08:40:45+00:00,['81f7c5b43fe4546ee1b7526b51a13126da706980'],1,16,17,1752756,1,,,,2828
3946ce5f89604477b2a4af03f38de97d384affd2,0,Alexey Serbin,2022-07-22 21:40:33+00:00,['8902ca6911b348ec3737da0e5f670726642f9fb0'],1,259,260,1753016,3,0,1,1,2828
f9517b181101bd122b73d9826d80d3b31641542d,0,Alexey Serbin,2022-07-22 21:52:07+00:00,['3946ce5f89604477b2a4af03f38de97d384affd2'],42,1385,1427,1754443,16,0.100105374,0.656480506,0.579557429,2832
a699e6a95e32459467270b389633d1fe2f815145,0,Attila Bukor,2022-07-22 22:04:07+00:00,['f9517b181101bd122b73d9826d80d3b31641542d'],178,993,1171,1755614,42,0.004056795,0.640973631,0.545638945,2836
483738566d6879f01e85e6f5c96d9a379f6128d7,0,Alexey Serbin,2022-07-22 22:58:32+00:00,['a699e6a95e32459467270b389633d1fe2f815145'],4,137,141,1755755,5,0,0.658227848,1,2836
6e48a43c4505b4a4d281f7f732c63f51cec6bc63,0,Alexey Serbin,2022-07-26 15:35:24+00:00,['483738566d6879f01e85e6f5c96d9a379f6128d7'],19,82,101,1755856,3,0.518518519,0,0.925925926,2836
df51b540bb1f5fb40790389b77a90df589bf1363,0,Alexey Serbin,2022-07-27 14:19:50+00:00,['6e48a43c4505b4a4d281f7f732c63f51cec6bc63'],0,91,91,1755947,1,0.090909091,1,1,2836
a6e8aa2fd5063abb2cc5c8944c9d19fdb38b8aa0,0,Alexey Serbin,2022-07-27 14:27:58+00:00,['df51b540bb1f5fb40790389b77a90df589bf1363'],20,248,268,1756215,10,0.050314465,0.911949686,0.610062893,2836
3b91db407d9973f154567e0b280f7fe39899c557,0,Alexey Serbin,2022-07-27 15:27:22+00:00,['a6e8aa2fd5063abb2cc5c8944c9d19fdb38b8aa0'],4,206,210,1756425,3,0,1,1,2836
e572e59673f6dade62f96eb38b6417ef018bc7bf,0,Alexey Serbin,2022-07-28 17:13:25+00:00,['3b91db407d9973f154567e0b280f7fe39899c557'],40,137,177,1756602,3,0,1,0.467532468,2836
9d571f954302a52249435726cc67dd0b8fd582f7,0,Alexey Serbin,2022-07-28 21:09:27+00:00,['e572e59673f6dade62f96eb38b6417ef018bc7bf'],3,61,64,1756666,2,0,1,1,2836
7ea5fe5eae2e03fe2dc88e69a0dfe82d3f2d7088,0,Alexey Serbin,2022-07-29 18:53:46+00:00,['9d571f954302a52249435726cc67dd0b8fd582f7'],49,98,147,1756813,2,1,0,0,2836
