sha,is_bug,committer_name,commit_time,parents,all_del,all_add,all_change_lines,all_lines,files_change_nums,dmm_unit_size,dmm_unit_complexity,dmm_unit_interfacing,file_nums
cda0b8d2f2bf5ea6c91d02cb68346958dc9e0a84,0,Luke Han,2014-05-13 16:23:13-07:00,[],0,217,217,217,3,,,,3
0c8283e402eab30488577f487c7f72274feed2cd,0,Luke Han,2014-05-14 10:49:47+08:00,[],0,3382,3382,3599,42,0.518171161,0.668229777,0.974208675,45
36a49c1ffa6b99e39e1ca32bc529165e29282eb4,0,Luke Han,2014-10-01 14:22:46-07:00,['cda0b8d2f2bf5ea6c91d02cb68346958dc9e0a84'],201,0,201,3800,1,,,,45
e1c4335f751b8caddd838f0a1ed87bd9c5aed17e,0,Luke Han,2014-10-01 14:23:50-07:00,['36a49c1ffa6b99e39e1ca32bc529165e29282eb4'],0,54,54,3854,1,,,,46
4cefb032d5c5e2e59dd12b7363c849a50aca6968,0,Luke Han,2014-10-01 16:40:15-07:00,['e1c4335f751b8caddd838f0a1ed87bd9c5aed17e'],54,0,54,3908,1,,,,46
a381078bc661c7ea36857f702cd242504bba173c,0,Luke Han,2014-10-01 16:40:42-07:00,['4cefb032d5c5e2e59dd12b7363c849a50aca6968'],0,54,54,3962,1,,,,47
42c644510562eb688901eb872244aa51ff7bcbef,0,Luke Han,2014-10-01 23:51:31-07:00,['a381078bc661c7ea36857f702cd242504bba173c'],3,111,114,4076,2,,,,47
72138e235a307ac71061421d31b802969263e4ab,1,Luke Han,2014-10-01 23:54:14-07:00,['42c644510562eb688901eb872244aa51ff7bcbef'],0,675063,675063,679139,728,0.492640475,0.730383927,0.828492277,775
b1f414180cb5714ab957dfd5a4c55f69dccbff0f,0,Luke Han,2014-10-02 22:14:24-07:00,['72138e235a307ac71061421d31b802969263e4ab'],1,10,11,679150,1,,,,775
20eb24dae7c23ca045a5e27449f23e33a667f3f0,0,Luke Han,2014-10-02 22:21:53-07:00,['0c8283e402eab30488577f487c7f72274feed2cd'],0,0,0,679150,1,,,,776
ddbab420131e7c049ce3562247af55dd2fe687e5,0,Luke Han,2014-10-02 22:38:35-07:00,['b1f414180cb5714ab957dfd5a4c55f69dccbff0f'],4,12,16,679166,1,,,,776
ce1cebd10875f314bf368773fbd66fdb066b5a98,0,Luke Han,2014-10-02 22:42:25-07:00,['ddbab420131e7c049ce3562247af55dd2fe687e5'],2,2,4,679170,1,,,,776
a210f69fc470b2b5ff259b7c402804707986893c,0,Luke Han,2014-10-03 01:48:01-07:00,['20eb24dae7c23ca045a5e27449f23e33a667f3f0'],3376,13717,17093,696263,68,0.768224299,0.411214953,0,803
81247603e37bf063a4406c4bc9e0e6536eb70e76,0,Luke Han,2014-10-03 01:48:09-07:00,['a210f69fc470b2b5ff259b7c402804707986893c'],2,2,4,696267,1,,,,803
212b59ad74c3a2af3b55b78ec60f908b0290b4fe,0,Luke Han,2014-10-03 10:26:27-07:00,['81247603e37bf063a4406c4bc9e0e6536eb70e76'],4,7,11,696278,1,,,,803
883ec97c22a935cc4ab87c12eb9d0738cfef45c6,0,fengrui129,2014-10-03 11:24:24-07:00,"['ce1cebd10875f314bf368773fbd66fdb066b5a98', '212b59ad74c3a2af3b55b78ec60f908b0290b4fe']",0,13726,13726,710004,30,,,,803
f4ea602c45c7da2f10675f8ec41ab3871b3492ba,1,xjiang,2014-10-09 10:04:20+08:00,['883ec97c22a935cc4ab87c12eb9d0738cfef45c6'],0,3854,3854,713858,29,0.661083194,0.83305416,0.810161921,832
3d5e8e08499f42e2725c5f82cf16c7570e5e84c9,1,ysong1,2014-10-09 11:12:01+08:00,['883ec97c22a935cc4ab87c12eb9d0738cfef45c6'],0,5351,5351,719209,118,,,,950
7c15913edeb46168ebd69384f8c5e52a30bb7e26,0,ysong1,2014-10-09 11:12:41+08:00,"['3d5e8e08499f42e2725c5f82cf16c7570e5e84c9', 'f4ea602c45c7da2f10675f8ec41ab3871b3492ba']",0,3854,3854,723063,29,,,,950
3e2e359b724fe1a738284054050f138108e9dab7,0,xduo,2014-10-09 11:56:33+08:00,['7c15913edeb46168ebd69384f8c5e52a30bb7e26'],0,2,2,723065,1,,,,950
b1bdc3f5b6d821688f6a50793e4cf7ffae4f881b,0,honma,2014-10-09 13:14:56+08:00,['3e2e359b724fe1a738284054050f138108e9dab7'],0,1,1,723066,1,,,,950
b56335bdb4cda47a1e071eea2d6cb818fac0ee66,1,Li Yang,2014-10-09 13:54:53+08:00,['b1bdc3f5b6d821688f6a50793e4cf7ffae4f881b'],182037,183864,365901,1088967,559,0.392781316,0.670912951,0.857749469,960
415532aba49e3bd0d9ec38b0b6cdf9c4e9e54022,0,xjiang,2014-10-09 15:57:35+08:00,['b56335bdb4cda47a1e071eea2d6cb818fac0ee66'],0,1,1,1088968,2,,,,961
318b9afd1be2a7f6e89ac411fabb342c5dc12302,0,xjiang,2014-10-09 15:59:55+08:00,['415532aba49e3bd0d9ec38b0b6cdf9c4e9e54022'],1,1,2,1088970,1,,,,961
78b9fc087c5b67339ca5bbe25fb353c0129da820,1,"Xiaodong, Duo",2014-10-09 17:35:51+08:00,['318b9afd1be2a7f6e89ac411fabb342c5dc12302'],0,960862,960862,2049832,2680,0.416679974,0.691057593,0.710058039,3641
c4f8d1bbcb1f58381a19eb527ec137130e8d9770,1,Li Yang,2014-10-09 17:37:06+08:00,['b56335bdb4cda47a1e071eea2d6cb818fac0ee66'],26,557,583,2050415,13,0.954022989,0.83908046,1,3648
b52e4d400145c2b3c1802108a8c4dc56da2e0bb9,0,Li Yang,2014-10-09 17:37:39+08:00,"['c4f8d1bbcb1f58381a19eb527ec137130e8d9770', '318b9afd1be2a7f6e89ac411fabb342c5dc12302']",0,1,1,2050416,2,,,,3648
6606c8877008fedf4a1a12bf7c503ad30aca508d,0,"Xiaodong, Duo",2014-10-09 17:40:24+08:00,"['78b9fc087c5b67339ca5bbe25fb353c0129da820', 'b52e4d400145c2b3c1802108a8c4dc56da2e0bb9']",26,557,583,2050999,13,,,,3648
22d6cad4690d97e5403acc290bacf602fe991667,0,honma,2014-10-09 17:51:20+08:00,['b52e4d400145c2b3c1802108a8c4dc56da2e0bb9'],38,0,38,2051037,2,,,,3648
a38839fa610d38dd9256f8aa58d053c019668496,0,"Xiaodong, Duo",2014-10-09 17:59:40+08:00,"['6606c8877008fedf4a1a12bf7c503ad30aca508d', '22d6cad4690d97e5403acc290bacf602fe991667']",38,0,38,2051075,2,,,,3648
fc3beb77c151002718c9424038dc282d66c69204,0,honma,2014-10-10 09:47:04+08:00,['a38839fa610d38dd9256f8aa58d053c019668496'],0,13,13,2051088,1,,,,3648
2231a5d130867da82178d0d81024da3b66ce1672,0,honma,2014-10-10 10:17:25+08:00,['fc3beb77c151002718c9424038dc282d66c69204'],4,6,10,2051098,2,1,1,1,3648
a95c32055a49053b206ed2df2efe0fdb2f613eca,0,honma,2014-10-10 10:18:45+08:00,['2231a5d130867da82178d0d81024da3b66ce1672'],1,1,2,2051100,1,,,,3648
ed0983d98d9d31fd10a44f5f893d43a81e6dae56,1,honma,2014-10-10 11:00:30+08:00,['a95c32055a49053b206ed2df2efe0fdb2f613eca'],8,10,18,2051118,5,,,,3648
416ee5e249efb385a830148fa697ddc636e38c59,0,"Xiaodong, Duo",2014-10-10 11:02:29+08:00,['ed0983d98d9d31fd10a44f5f893d43a81e6dae56'],2,6,8,2051126,1,1,1,1,3648
42d36109906e5ab62d66bb36edb95d2c62dabebc,0,honma,2014-10-10 11:57:29+08:00,['416ee5e249efb385a830148fa697ddc636e38c59'],5,4,9,2051135,2,0,0,0,3648
3856f160b58ef2f812d31f8f4f2de5d7b73007c0,0,"Xiaodong, Duo",2014-10-10 12:20:31+08:00,['416ee5e249efb385a830148fa697ddc636e38c59'],58,214,272,2051407,5,,,,3650
f5113ae61f8bd4e8d70e7cf78b20a5680a0ca0fe,0,"Xiaodong, Duo",2014-10-10 12:20:47+08:00,"['3856f160b58ef2f812d31f8f4f2de5d7b73007c0', '42d36109906e5ab62d66bb36edb95d2c62dabebc']",5,4,9,2051416,2,,,,3650
34aa2c19aa73e516f257898a817a30fcd677c2ba,0,"Xiaodong, Duo",2014-10-10 13:27:05+08:00,['f5113ae61f8bd4e8d70e7cf78b20a5680a0ca0fe'],2,7,9,2051425,2,,,,3650
3fdc6a7a190caab321cefbc267eae1e87209f09e,0,"Xiaodong, Duo",2014-10-10 13:27:34+08:00,['34aa2c19aa73e516f257898a817a30fcd677c2ba'],186,0,186,2051611,2,,,,3650
6c93ff00ec56b1d35ba0d9e92ba26e742bf2945a,0,honma,2014-10-10 13:34:34+08:00,['3fdc6a7a190caab321cefbc267eae1e87209f09e'],2,3,5,2051616,2,,,,3650
8875f19796b775c197027160c9a1245604536976,0,"Xiaodong, Duo",2014-10-10 14:14:29+08:00,['3fdc6a7a190caab321cefbc267eae1e87209f09e'],5,6,11,2051627,2,,,,3650
a398db046d259a83098c13d77cd57517d32746d4,0,"Xiaodong, Duo",2014-10-10 14:15:02+08:00,"['8875f19796b775c197027160c9a1245604536976', '6c93ff00ec56b1d35ba0d9e92ba26e742bf2945a']",2,3,5,2051632,2,,,,3650
2deed814b024ba411cbee36d3739a8f6d59e455d,0,"Xiaodong, Duo",2014-10-10 14:17:40+08:00,['a398db046d259a83098c13d77cd57517d32746d4'],3,2,5,2051637,3,,,,3650
c91578cf5536b69a609c276dc128054937e99680,0,George Song,2014-10-10 15:23:53+08:00,['2deed814b024ba411cbee36d3739a8f6d59e455d'],731,0,731,2052368,1,,,,3650
33341441b01b377ed350c9648ea04b288bcc180f,0,George Song,2014-10-10 15:24:02+08:00,['c91578cf5536b69a609c276dc128054937e99680'],144,0,144,2052512,1,,,,3650
e38c12231ab37bf82039da063cb69abed5afa615,0,George Song,2014-10-10 15:24:16+08:00,['33341441b01b377ed350c9648ea04b288bcc180f'],402,0,402,2052914,1,,,,3650
8aba6ac9e280acce2488008b7eea17608ee02489,0,George Song,2014-10-10 15:24:22+08:00,['e38c12231ab37bf82039da063cb69abed5afa615'],8,0,8,2052922,1,,,,3650
d0477aa9de6c165d135b07a959292c93f01d5079,0,George Song,2014-10-10 15:24:29+08:00,['8aba6ac9e280acce2488008b7eea17608ee02489'],262,0,262,2053184,1,,,,3650
ed7db463322a7e4e90e270593a80985dbaf5715b,1,"Xiaodong, Duo",2014-10-10 16:01:51+08:00,['2deed814b024ba411cbee36d3739a8f6d59e455d'],89,114,203,2053387,4,,,,3650
539e7ab2407d616a8086fbaa115c64d499c5cbe9,0,"Xiaodong, Duo",2014-10-10 16:02:29+08:00,['ed7db463322a7e4e90e270593a80985dbaf5715b'],39,0,39,2053426,1,,,,3650
f4677a7ca5e74cd3f1ed55d97a5f3b1f26ce77a6,0,"Xiaodong, Duo",2014-10-10 16:02:55+08:00,"['539e7ab2407d616a8086fbaa115c64d499c5cbe9', 'd0477aa9de6c165d135b07a959292c93f01d5079']",1547,0,1547,2054973,5,,,,3650
016a42726801fc6ad08101bfcc6f765b6aa5a6da,0,xjiang,2014-10-10 16:11:57+08:00,['318b9afd1be2a7f6e89ac411fabb342c5dc12302'],0,0,0,2054973,1,,,,3650
663a11b54ca9ccc36c66b48905a9a9cf6eaf27bb,0,xjiang,2014-10-10 16:12:13+08:00,"['016a42726801fc6ad08101bfcc6f765b6aa5a6da', 'f4677a7ca5e74cd3f1ed55d97a5f3b1f26ce77a6']",1781,961571,963352,3018325,2709,,,,3650
04bc8d1dc4592f66f52de0ffd79f1b0d241d79e7,0,honma,2014-10-10 16:29:09+08:00,['663a11b54ca9ccc36c66b48905a9a9cf6eaf27bb'],0,0,0,3018325,1,,,,3650
99feb4d6b95cedc31482352ac24a05bc99e1407e,0,honma,2014-10-10 16:29:09+08:00,['04bc8d1dc4592f66f52de0ffd79f1b0d241d79e7'],3,0,3,3018328,1,,,,3650
a50ea52573cf0243ed3c712c0a11fff1b4f9c762,0,honma,2014-10-10 16:29:09+08:00,['99feb4d6b95cedc31482352ac24a05bc99e1407e'],29,1576,1605,3019933,6,,,,3655
19181b984a8d92d62c9025d1502d9fc88d58244a,1,Li Yang,2014-10-10 16:37:05+08:00,['b52e4d400145c2b3c1802108a8c4dc56da2e0bb9'],49181,55272,104453,3124386,526,0.002392344,0.674242424,0.725279107,3683
0d911efb23f80d2dc75e52dcca675b2cc327f2b6,1,Li Yang,2014-10-10 16:43:26+08:00,"['19181b984a8d92d62c9025d1502d9fc88d58244a', 'a50ea52573cf0243ed3c712c0a11fff1b4f9c762']",51070,1007462,1058532,4182918,3132,,,,3683
7544caa528eecbba0f3b35e608d12532e5cdc8bb,0,Li Yang,2014-10-10 16:44:28+08:00,['0d911efb23f80d2dc75e52dcca675b2cc327f2b6'],0,1,1,4182919,1,,,,3683
accad0f7699878d8ff7cac8296d55cdddd6e7812,0,honma,2014-10-10 17:09:44+08:00,['7544caa528eecbba0f3b35e608d12532e5cdc8bb'],1164,1165,2329,4185248,5,,,,3683
f68d263d4d583ec29fe4a70bad61a0f2b7c74108,0,honma,2014-10-10 17:26:07+08:00,['accad0f7699878d8ff7cac8296d55cdddd6e7812'],0,1,1,4185249,1,,,,3683
54999200d8a938d0ec9b7df7f403cf3e6f960ea7,0,George Song,2014-10-10 17:35:06+08:00,['f68d263d4d583ec29fe4a70bad61a0f2b7c74108'],1,1,2,4185251,1,,,,3683
3371dc568098363f793c8b5b8b6c67e4a597bc7f,0,honma,2014-10-10 18:37:24+08:00,['54999200d8a938d0ec9b7df7f403cf3e6f960ea7'],0,0,0,4185251,1,,,,3684
195843aa41fab99e840ae0a6e14a359671b3b871,0,honma,2014-10-10 18:37:24+08:00,['3371dc568098363f793c8b5b8b6c67e4a597bc7f'],0,15,15,4185266,1,,,,3684
b3ce6127dd75708471720709552af180c81cdba5,1,"Xiaodong, Duo",2014-10-10 19:42:30+08:00,['f4677a7ca5e74cd3f1ed55d97a5f3b1f26ce77a6'],2081,2212,4293,4189559,21,0.310606061,0.954545455,0.75,3684
7004c5fa0d714178ef335b22cacdf1dc0d2b4021,0,xjiang,2014-10-10 19:55:05+08:00,['195843aa41fab99e840ae0a6e14a359671b3b871'],27,37,64,4189623,16,1,1,1,3684
df7489b7ead5810363624f5258bc44be1788e1d1,1,xjiang,2014-10-10 20:05:57+08:00,['7004c5fa0d714178ef335b22cacdf1dc0d2b4021'],13,13,26,4189649,2,0,0,0,3685
b737dafce50ab3f4dc6dd5bbdc0526d02b67ab6f,0,xjiang,2014-10-10 20:09:44+08:00,['df7489b7ead5810363624f5258bc44be1788e1d1'],0,8,8,4189657,1,,,,3685
ef509bd56bc2836ea2b47eed4b0db94db2a772a9,0,ysong1,2014-10-11 09:06:02+08:00,['b737dafce50ab3f4dc6dd5bbdc0526d02b67ab6f'],0,5,5,4189662,1,,,,3685
51bde079fb2da32645933f54d0fbb19daccc26f3,0,ysong1,2014-10-11 09:53:50+08:00,['ef509bd56bc2836ea2b47eed4b0db94db2a772a9'],3,5,8,4189670,1,,,,3685
fc3ac9873132e43a53f980ebab76231883f77cb6,0,"Xiaodong, Duo",2014-10-11 11:24:29+08:00,['b3ce6127dd75708471720709552af180c81cdba5'],15,0,15,4189685,1,,,,3685
d044884b91b67c61e75caef4361dae75e71beea7,0,"Xiaodong, Duo",2014-10-11 11:34:16+08:00,"['fc3ac9873132e43a53f980ebab76231883f77cb6', '51bde079fb2da32645933f54d0fbb19daccc26f3']",6220,9487,15707,4205392,505,,,,3685
74f7f214a8d4b2e244b0e18d143ade80a8c41698,0,honma,2014-10-11 13:30:32+08:00,['d044884b91b67c61e75caef4361dae75e71beea7'],23,19,42,4205434,1,,,,3685
5f8abd21409da0585e312ef3997c14645f4d60dc,0,honma,2014-10-11 13:32:13+08:00,['74f7f214a8d4b2e244b0e18d143ade80a8c41698'],1,1,2,4205436,1,,,,3685
8a802d87d50712ceb61a60928f2cc1bf1975fb92,0,honma,2014-10-11 13:34:41+08:00,['5f8abd21409da0585e312ef3997c14645f4d60dc'],2,2,4,4205440,1,,,,3685
e5cb430e586b27137fa20fd0562106ceaecb627a,0,honma,2014-10-11 13:45:45+08:00,['8a802d87d50712ceb61a60928f2cc1bf1975fb92'],5,7,12,4205452,1,,,,3685
75a07732b004124a188c50cd77278856c69a6df0,0,honma,2014-10-11 14:43:35+08:00,['e5cb430e586b27137fa20fd0562106ceaecb627a'],1,1,2,4205454,1,,,,3685
efe5237c7d2bc43ff597c58b8859c1aab832c58d,1,"Xiaodong, Duo",2014-10-13 17:04:58+08:00,['d044884b91b67c61e75caef4361dae75e71beea7'],2704,2556,5260,4210714,26,0.888888889,0,0.62745098,3685
44ad13802ce0751c999b343d4ce56a965c54e459,0,"Xiaodong, Duo",2014-10-13 17:06:26+08:00,['efe5237c7d2bc43ff597c58b8859c1aab832c58d'],68,0,68,4210782,1,0,0,0.347826087,3685
62747a5c11cab301dd96645daf696ff638531d5e,0,"Xiaodong, Duo",2014-10-13 17:06:46+08:00,"['44ad13802ce0751c999b343d4ce56a965c54e459', '75a07732b004124a188c50cd77278856c69a6df0']",24,22,46,4210828,1,,,,3685
32dca006c21eb7164ec8a7414005afa02eae5181,1,"Xiaodong, Duo",2014-10-14 14:07:07+08:00,['62747a5c11cab301dd96645daf696ff638531d5e'],228,231,459,4211287,7,1,1,1,3685
48bfaa6327a7c212abacff789ec4b3f81eab1643,0,"Xiaodong, Duo",2014-10-14 14:08:38+08:00,['32dca006c21eb7164ec8a7414005afa02eae5181'],2,1,3,4211290,1,,,,3685
ecd5678d10030182de547dc98188b66f7768e10e,1,"Xiaodong, Duo",2014-10-14 14:13:33+08:00,['48bfaa6327a7c212abacff789ec4b3f81eab1643'],28,27,55,4211345,3,0,0,0,3685
4c228eb9a2ae2e702292637302016023541d5f1b,0,"Xiaodong, Duo",2014-10-14 14:43:36+08:00,['ecd5678d10030182de547dc98188b66f7768e10e'],4,4,8,4211353,3,,,,3685
74d74f028adcb5fcfb22f610c0b3a26217a1b9b4,1,"Xiaodong, Duo",2014-10-14 15:33:47+08:00,['4c228eb9a2ae2e702292637302016023541d5f1b'],52,80,132,4211485,5,0,0,0,3686
e1d069d78dea9ce4a3844e441bea195c8bedd92b,0,Li Yang,2014-10-14 16:59:13+08:00,['7544caa528eecbba0f3b35e608d12532e5cdc8bb'],17,5,22,4211507,1,1,1,1,3686
fae8d4ce737d4f4d6fd813b837be13bb362de288,0,Li Yang,2014-10-14 17:00:09+08:00,"['e1d069d78dea9ce4a3844e441bea195c8bedd92b', '74d74f028adcb5fcfb22f610c0b3a26217a1b9b4']",2634,2603,5237,4216744,71,,,,3686
4777c93b9c98bfb8c5428c4d76c1be969f88cfbd,1,Li Yang,2014-10-14 17:19:22+08:00,['fae8d4ce737d4f4d6fd813b837be13bb362de288'],1,2,3,4216747,2,,,,3686
4daa70c673dd67edba90d277abf4493740e643f5,0,Li Yang,2014-10-14 17:20:55+08:00,['4777c93b9c98bfb8c5428c4d76c1be969f88cfbd'],24,24,48,4216795,8,,,,3686
245991fb922262c705daa58896a6b11d24c6450c,0,honma,2014-10-14 17:32:41+08:00,['4daa70c673dd67edba90d277abf4493740e643f5'],2,2,4,4216799,1,,,,3686
ed2d0c6323acb8db426056515906d4a2a27ee592,1,"Xiaodong, Duo",2014-10-15 11:29:26+08:00,['74d74f028adcb5fcfb22f610c0b3a26217a1b9b4'],131,5910,6041,4222840,129,0.834437086,0.900662252,1,3808
8535fabb766781f78261b3da0cd87774d3b173d6,0,honma,2014-10-15 12:05:03+08:00,['245991fb922262c705daa58896a6b11d24c6450c'],3,3,6,4222846,1,,,,3808
d39e001bab8e436b475fee95cc8b6e5a532a0dbe,0,Li Yang,2014-10-15 12:06:19+08:00,['245991fb922262c705daa58896a6b11d24c6450c'],0,1,1,4222847,2,,,,3809
343871dc2ecb8647676e092dc9770ff47884441d,0,"Xiaodong, Duo",2014-10-15 13:13:08+08:00,"['ed2d0c6323acb8db426056515906d4a2a27ee592', '8535fabb766781f78261b3da0cd87774d3b173d6']",47,36,83,4222930,13,,,,3809
503026fb9a32643c0dbc4cca4391c1e0c80b058f,0,honma,2014-10-15 13:37:56+08:00,['245991fb922262c705daa58896a6b11d24c6450c'],3,3,6,4222936,1,,,,3809
e90435d65372734c06802938cf1167eaed52ac13,0,Li Yang,2014-10-15 13:42:52+08:00,['d39e001bab8e436b475fee95cc8b6e5a532a0dbe'],5,0,5,4222941,1,,,,3809
93213630d89f29556727799be7fecf49c3aeb213,0,Li Yang,2014-10-15 13:43:17+08:00,"['e90435d65372734c06802938cf1167eaed52ac13', '503026fb9a32643c0dbc4cca4391c1e0c80b058f']",3,3,6,4222947,1,,,,3809
83f5b246c5fdf40a88c30d538d8141710cb29d39,1,"Xiaodong, Duo",2014-10-15 13:45:44+08:00,['503026fb9a32643c0dbc4cca4391c1e0c80b058f'],7,16,23,4222970,3,1,1,1,3809
fc7cd83c74684a89ad7b43a8e8280064ff52e0a1,0,"Xiaodong, Duo",2014-10-15 13:48:01+08:00,"['83f5b246c5fdf40a88c30d538d8141710cb29d39', '93213630d89f29556727799be7fecf49c3aeb213']",5,1,6,4222976,3,,,,3809
eaa81dbb3c812f0f5ee5fae799bf57a1882442bd,0,Li Yang,2014-10-15 13:58:54+08:00,['93213630d89f29556727799be7fecf49c3aeb213'],1,1,2,4222978,1,,,,3809
a19c9ffa5d9901b1dabe202acb22fccbd91ff581,0,Li Yang,2014-10-15 13:59:32+08:00,"['eaa81dbb3c812f0f5ee5fae799bf57a1882442bd', 'fc7cd83c74684a89ad7b43a8e8280064ff52e0a1']",7,16,23,4223001,3,,,,3809
fc03da8d571c68cded18e845dda5278cb7be729e,0,Li Yang,2014-10-15 14:15:10+08:00,['a19c9ffa5d9901b1dabe202acb22fccbd91ff581'],7,0,7,4223008,1,1,1,0,3809
ecf719167549965281902ec2f3ea0eac66af7600,0,honma,2014-10-15 14:41:34+08:00,['fc03da8d571c68cded18e845dda5278cb7be729e'],7,33,40,4223048,2,,,,3809
0281b24c3cb0b62d7675fc0e3f8c2755fca39ef3,0,honma,2014-10-15 15:08:43+08:00,['ecf719167549965281902ec2f3ea0eac66af7600'],5,5,10,4223058,2,0,0,0,3809
85478e79888786fdf8b25df6678ba1e748b1032e,0,Li Yang,2014-10-15 15:28:55+08:00,['fc03da8d571c68cded18e845dda5278cb7be729e'],30,31,61,4223119,10,,,,3810
14aa8bb84b90578798f265be9cde2ac791bac744,0,Li Yang,2014-10-15 15:30:04+08:00,['85478e79888786fdf8b25df6678ba1e748b1032e'],2,5,7,4223126,2,0,0,1,3810
2cb974fbee20b69b27f8c30b5c544a920a43865b,0,Li Yang,2014-10-15 15:31:56+08:00,['14aa8bb84b90578798f265be9cde2ac791bac744'],29,1,30,4223156,2,,,,3811
d04b5bb4f9477fbb1303ce7cd57475ab419209e8,0,Li Yang,2014-10-15 15:34:13+08:00,"['2cb974fbee20b69b27f8c30b5c544a920a43865b', '0281b24c3cb0b62d7675fc0e3f8c2755fca39ef3']",10,36,46,4223202,3,,,,3811
4a4d8fcc34fb5df2d73fdb75f98bca07558472b0,0,honma,2014-10-15 17:35:33+08:00,['d04b5bb4f9477fbb1303ce7cd57475ab419209e8'],5,5,10,4223212,2,1,1,1,3811
93b22f81aaba505e76a37d595b4a37968ee13dc7,1,honma,2014-10-15 17:35:33+08:00,['4a4d8fcc34fb5df2d73fdb75f98bca07558472b0'],20,73,93,4223305,4,1,1,1,3811
7644cef0ff102b86ffd42dc782775b29de9ccb6d,0,honma,2014-10-15 17:45:11+08:00,['93b22f81aaba505e76a37d595b4a37968ee13dc7'],11,13,24,4223329,3,1,1,1,3811
2ceeed52789644bf311dc66bf01ef308391ad694,0,honma,2014-10-15 17:52:32+08:00,['7644cef0ff102b86ffd42dc782775b29de9ccb6d'],2,6,8,4223337,2,,,,3811
d000c35db53d8fee396bbafd0fd97a8c1eaeb595,1,honma,2014-10-15 18:05:48+08:00,['2ceeed52789644bf311dc66bf01ef308391ad694'],3,3,6,4223343,2,,,,3811
62e7206f9e3116c40c91b5a44171493aaa9a6040,0,honma,2014-10-15 20:27:22+08:00,['d000c35db53d8fee396bbafd0fd97a8c1eaeb595'],296,299,595,4223938,5,0.363636364,0,0,3812
3b74ab57aa85e3f01da3dcda9e99d6cc046a50a4,0,honma,2014-10-15 20:48:40+08:00,['62e7206f9e3116c40c91b5a44171493aaa9a6040'],12,0,12,4223950,1,0,0,0,3812
7f3e66449c5dae80cf6b8b9292f9f01fcca42194,1,honma,2014-10-16 09:17:40+08:00,['3b74ab57aa85e3f01da3dcda9e99d6cc046a50a4'],2,2,4,4223954,2,,,,3812
f14373439f85899af7f9ade4f39ef54affad7814,0,honma,2014-10-16 10:50:50+08:00,['7f3e66449c5dae80cf6b8b9292f9f01fcca42194'],1,1,2,4223956,1,,,,3812
4ab1c41bf460570c667c3cd3ef65adfab902e131,0,"Xiaodong, Duo",2014-10-16 10:53:39+08:00,"['343871dc2ecb8647676e092dc9770ff47884441d', 'f14373439f85899af7f9ade4f39ef54affad7814']",406,456,862,4224818,30,,,,3812
3e916b1a12ed7e9453913b441af4b00de8de8733,0,Li Yang,2014-10-16 11:23:49+08:00,['d04b5bb4f9477fbb1303ce7cd57475ab419209e8'],1,5,6,4224824,2,,,,3813
bdfaf34794c742841893a5c9fc18c781072427a1,0,Li Yang,2014-10-16 11:25:32+08:00,"['3e916b1a12ed7e9453913b441af4b00de8de8733', 'f14373439f85899af7f9ade4f39ef54affad7814']",339,389,728,4225552,10,,,,3813
2f68c360318d8759a84a8d251b6f5a6fad23099c,1,honma,2014-10-16 11:31:52+08:00,['bdfaf34794c742841893a5c9fc18c781072427a1'],6,11,17,4225569,1,,,,3813
96d1e90d8a22fa0432be6e99cc0a62aa8d84b6f4,1,Li Yang,2014-10-16 15:34:43+08:00,['bdfaf34794c742841893a5c9fc18c781072427a1'],75,64,139,4225708,4,1,1,0,3813
83f539a5eacd4869637a20d1d8a7aa47fa94eaa4,0,Li Yang,2014-10-16 15:35:08+08:00,"['96d1e90d8a22fa0432be6e99cc0a62aa8d84b6f4', '2f68c360318d8759a84a8d251b6f5a6fad23099c']",6,11,17,4225725,1,,,,3813
28c83c851a4959a7f712fd0827c39b56e0a42d30,0,Li Yang,2014-10-17 10:45:58+08:00,['83f539a5eacd4869637a20d1d8a7aa47fa94eaa4'],73,0,73,4225798,1,1,1,0,3813
685eb8dc39bc393f7da2644b99d557d174298722,1,"Xiaodong, Duo",2014-10-17 16:19:29+08:00,['4ab1c41bf460570c667c3cd3ef65adfab902e131'],81,680,761,4226559,11,0.440613027,0.77394636,1,3816
e75a2c37a3b10d3f1b892bd2271abc914a1c5545,0,"Xiaodong, Duo",2014-10-17 16:21:57+08:00,"['685eb8dc39bc393f7da2644b99d557d174298722', '28c83c851a4959a7f712fd0827c39b56e0a42d30']",222,77,299,4226858,9,,,,3816
db8e7fdda17dcb2df1e3bdce64e91204af67bca8,0,Li Yang,2014-10-17 18:03:45+08:00,['28c83c851a4959a7f712fd0827c39b56e0a42d30'],6,6,12,4226870,1,1,1,1,3816
dc55812d2a6ebec20ceb5d4bb46ea5e4cfb7f765,0,"Xiaodong, Duo",2014-10-20 10:32:41+08:00,"['e75a2c37a3b10d3f1b892bd2271abc914a1c5545', 'db8e7fdda17dcb2df1e3bdce64e91204af67bca8']",6,6,12,4226882,1,,,,3816
90e0d48b020ce6fc90c2b0b24523b65ceecdf6a3,0,"Xiaodong, Duo",2014-10-20 10:43:15+08:00,['dc55812d2a6ebec20ceb5d4bb46ea5e4cfb7f765'],86,1934,2020,4228902,8,0.571428571,0.857142857,0,3819
ef1314d6a928aedf704f5c35f380a50c249ecb67,0,"Xiaodong, Duo",2014-10-20 10:44:44+08:00,['db8e7fdda17dcb2df1e3bdce64e91204af67bca8'],0,1847,1847,4230749,3,,,,3822
1c679643067af0a5a39c95b5cd2c5bed47e5263d,0,"Xiaodong, Duo",2014-10-20 10:48:59+08:00,"['90e0d48b020ce6fc90c2b0b24523b65ceecdf6a3', 'ef1314d6a928aedf704f5c35f380a50c249ecb67']",0,0,0,4230749,0,,,,3822
7527bb0274c174474fba2dfd82e95e54aaa22ea2,0,Li Yang,2014-10-20 12:50:56+08:00,['db8e7fdda17dcb2df1e3bdce64e91204af67bca8'],62,62,124,4230873,1,0,0,0,3822
9163b32fc055d19674d975e9dda5a58240782549,0,Li Yang,2014-10-20 12:51:26+08:00,"['7527bb0274c174474fba2dfd82e95e54aaa22ea2', 'ef1314d6a928aedf704f5c35f380a50c249ecb67']",0,1847,1847,4232720,3,,,,3822
b9e49fea3cd16b67ad3b0915ab609695eef27690,1,Li Yang,2014-10-20 14:52:30+08:00,['9163b32fc055d19674d975e9dda5a58240782549'],255,244,499,4233219,11,0,1,0,3822
5339f254870ea48fbad894c14898a1dc277b26af,0,Li Yang,2014-10-20 17:42:36+08:00,['b9e49fea3cd16b67ad3b0915ab609695eef27690'],10,27,37,4233256,2,1,0.571428571,0.5,3822
b19d4e0f3b6f42530bb17708f9d203c694d2b9dd,1,honma,2014-10-20 18:24:45+08:00,['5339f254870ea48fbad894c14898a1dc277b26af'],51,195,246,4233502,8,0.402173913,0.402173913,1,3823
567d3763cb0eb24c5ef87939bcf18844f5f059ad,0,honma,2014-10-20 18:24:45+08:00,['b19d4e0f3b6f42530bb17708f9d203c694d2b9dd'],139,82,221,4233723,9,0.818181818,0.848484848,1,3823
55fba296ca014592c1eca533d700896234929b46,1,honma,2014-10-20 21:27:36+08:00,['567d3763cb0eb24c5ef87939bcf18844f5f059ad'],5,5,10,4233733,4,,,1,3823
0da34fdbb336108621560a9602ef6cfe0d52c0a6,0,honma,2014-10-21 09:02:34+08:00,['55fba296ca014592c1eca533d700896234929b46'],1,1,2,4233735,1,,,,3823
4b49755c886fecce8f7a2604b7e431ecb0146f75,1,honma,2014-10-21 10:30:46+08:00,['0da34fdbb336108621560a9602ef6cfe0d52c0a6'],4,4,8,4233743,1,,,,3823
6025408e21d3e19b80af162465ddadfa32009854,1,Li Yang,2014-10-21 10:44:23+08:00,['5339f254870ea48fbad894c14898a1dc277b26af'],3,7,10,4233753,1,1,1,1,3823
b5fefa32e6e2eabc4a207c9686f04fda1f212399,0,Li Yang,2014-10-21 10:44:48+08:00,"['6025408e21d3e19b80af162465ddadfa32009854', '4b49755c886fecce8f7a2604b7e431ecb0146f75']",200,287,487,4234240,22,,,,3823
b575d950f711624a6f535f27b82194d939f92d81,0,Li Yang,2014-10-21 10:50:33+08:00,['b5fefa32e6e2eabc4a207c9686f04fda1f212399'],22,6,28,4234268,7,0,0,0,3823
ffe0e04c435e832bd2bff72feed4d783665fa73f,0,xduo,2014-10-21 10:51:59+08:00,['b575d950f711624a6f535f27b82194d939f92d81'],6,6,12,4234280,1,,,,3823
2e71a44b2941fd8acb5b33c50b990d294b40c69d,0,xduo,2014-10-21 10:54:42+08:00,['ffe0e04c435e832bd2bff72feed4d783665fa73f'],22,0,22,4234302,1,,,,3823
0cb5affb10f981e530d28d3e8520ae699fc8a1a3,0,xduo,2014-10-21 10:54:49+08:00,['2e71a44b2941fd8acb5b33c50b990d294b40c69d'],1783,0,1783,4236085,1,,,,3823
c6ff1d511c09eaeaecae71e595009bfee8ccf54f,1,"Xiaodong, Duo",2014-10-21 11:11:36+08:00,['1c679643067af0a5a39c95b5cd2c5bed47e5263d'],93,932,1025,4237110,8,0.378657487,0.743545611,0.929432014,3825
937348812a7b4282b45525ef50fb2b34db7be288,0,"Xiaodong, Duo",2014-10-21 11:12:55+08:00,"['c6ff1d511c09eaeaecae71e595009bfee8ccf54f', '0cb5affb10f981e530d28d3e8520ae699fc8a1a3']",3969,615,4584,4241694,45,,,,3825
3dd7af3942222f839f92397efc133c74e042f892,0,"Xiaodong, Duo",2014-10-21 12:11:17+08:00,['937348812a7b4282b45525ef50fb2b34db7be288'],36,70,106,4241800,5,0,0,0,3825
f4bde09fd680afa5add8df6e04014e1e50a760f4,0,Li Yang,2014-10-21 14:11:55+08:00,['b575d950f711624a6f535f27b82194d939f92d81'],0,2,2,4241802,1,,,,3825
7c685002bc983d5a16cb4370e2eedeb0f8c04d8a,0,Li Yang,2014-10-21 14:12:15+08:00,"['f4bde09fd680afa5add8df6e04014e1e50a760f4', '0cb5affb10f981e530d28d3e8520ae699fc8a1a3']",1805,0,1805,4243607,2,,,,3825
1db0d22afac309247779b3fcd8b181529cf4a397,0,"Xiaodong, Duo",2014-10-21 15:14:06+08:00,['3dd7af3942222f839f92397efc133c74e042f892'],46,33,79,4243686,2,1,0.857142857,0,3825
e655b391d253f03d37ce7617fc09a2c0ba40b472,0,"Xiaodong, Duo",2014-10-21 15:14:44+08:00,"['1db0d22afac309247779b3fcd8b181529cf4a397', '7c685002bc983d5a16cb4370e2eedeb0f8c04d8a']",0,2,2,4243688,1,,,,3825
860c84e4d36092fab81fba6b5b93d5a769a5f898,0,honma,2014-10-21 16:15:50+08:00,['7c685002bc983d5a16cb4370e2eedeb0f8c04d8a'],3,30,33,4243721,5,1,0.0625,1,3825
6dd53b55c50832331750d22d69387542eec13d91,0,"Xiaodong, Duo",2014-10-21 16:37:09+08:00,['e655b391d253f03d37ce7617fc09a2c0ba40b472'],1,7,8,4243729,1,0,0.666666667,1,3825
f695973250eff582bebcbb23298d024fd8a7f6bf,0,"Xiaodong, Duo",2014-10-21 16:37:23+08:00,"['6dd53b55c50832331750d22d69387542eec13d91', '860c84e4d36092fab81fba6b5b93d5a769a5f898']",3,30,33,4243762,5,,,,3825
1cbe3b8b57dce88e85799eb3e32e0500080cb9ce,0,"Xiaodong, Duo",2014-10-21 17:30:41+08:00,['f695973250eff582bebcbb23298d024fd8a7f6bf'],5351,8,5359,4249121,120,1,1,1,3825
d2b186b88e811348bad6118e5af4f9692b81beaf,0,"Xiaodong, Duo",2014-10-21 17:37:39+08:00,['1cbe3b8b57dce88e85799eb3e32e0500080cb9ce'],2,9,11,4249132,2,1,1,1,3825
2e765da82cf793a8fd09cf9453cd04e784adb676,0,"Xiaodong, Duo",2014-10-21 17:43:07+08:00,['d2b186b88e811348bad6118e5af4f9692b81beaf'],5,11,16,4249148,1,0,1,1,3825
1f9990316db1a1ccf92040e988712be324b085f8,1,honma,2014-10-21 20:39:35+08:00,['860c84e4d36092fab81fba6b5b93d5a769a5f898'],8,12,20,4249168,2,0,1,1,3825
e1b13855fde2f21dbb422d586eb1e82392c64fdb,1,honma,2014-10-21 21:04:36+08:00,['1f9990316db1a1ccf92040e988712be324b085f8'],16,39,55,4249223,4,0.5,0.6,1,3826
8878de17d356b7dea2b54d765f7b5b5ea506dd65,0,honma,2014-10-21 21:21:11+08:00,['e1b13855fde2f21dbb422d586eb1e82392c64fdb'],11,29,40,4249263,2,1,1,1,3826
580ad7657105447e6f1f91720323c094db0d89f7,0,honma,2014-10-21 21:41:28+08:00,['8878de17d356b7dea2b54d765f7b5b5ea506dd65'],6,20,26,4249289,1,0,1,1,3826
9b84abaf9aece204d3e2b5f9ea0d967a4faee42f,0,honma,2014-10-21 21:52:15+08:00,['580ad7657105447e6f1f91720323c094db0d89f7'],9,9,18,4249307,1,,,,3826
42a10397401683df2d4b309fd8075875129038ec,0,honma,2014-10-21 22:06:14+08:00,['9b84abaf9aece204d3e2b5f9ea0d967a4faee42f'],7,7,14,4249321,1,,,,3826
8c052d0c862d42f566819cd1dabddf73c3f45e87,0,honma,2014-10-21 22:29:41+08:00,['42a10397401683df2d4b309fd8075875129038ec'],1,0,1,4249322,1,,,,3826
a4f1ca3b1a05be9a12cd145e5decdad645ddf984,0,Li Yang,2014-10-22 11:23:38+08:00,['8c052d0c862d42f566819cd1dabddf73c3f45e87'],27,9,36,4249358,5,,,,3826
eea6de481b2dbde381fee2fc581dc548dbd99982,0,honma,2014-10-22 11:41:15+08:00,['8c052d0c862d42f566819cd1dabddf73c3f45e87'],1,19,20,4249378,2,1,1,1,3826
14f4a7af3ebef2807e52a3a8c9a34fe07b534e6e,0,"Xiaodong, Duo",2014-10-22 12:58:11+08:00,"['2e765da82cf793a8fd09cf9453cd04e784adb676', 'eea6de481b2dbde381fee2fc581dc548dbd99982']",40,116,156,4249534,7,,,,3826
4f14df1146418c86dbcefe5a3ff566458c1bfa02,0,honma,2014-10-22 13:34:26+08:00,['eea6de481b2dbde381fee2fc581dc548dbd99982'],2,2,4,4249538,1,,,,3826
c9553fe1c1be7e6c9624261c0a2defa396e45ea9,0,"Xiaodong, Duo",2014-10-22 17:35:16+08:00,['4f14df1146418c86dbcefe5a3ff566458c1bfa02'],0,5,5,4249543,1,1,1,1,3826
ebf69445a472c9e9b6bc919fbd7b34a7bb68f4b6,0,honma,2014-10-22 17:36:14+08:00,['c9553fe1c1be7e6c9624261c0a2defa396e45ea9'],0,4626,4626,4254169,2,,,,3827
080cca20cb2b69c3334c701ce1f6649c6eaaa6b5,0,Li Yang,2014-10-22 18:21:58+08:00,['a4f1ca3b1a05be9a12cd145e5decdad645ddf984'],68,0,68,4254237,16,,,,3827
f7754b56dc3ab3900358b30d8eac5491de3cc7f0,1,Li Yang,2014-10-22 18:24:42+08:00,['080cca20cb2b69c3334c701ce1f6649c6eaaa6b5'],52,110,162,4254399,9,1,1,1,3828
8498955780bec15419db6097f333b07d215e60b5,0,Li Yang,2014-10-22 18:24:59+08:00,"['f7754b56dc3ab3900358b30d8eac5491de3cc7f0', 'ebf69445a472c9e9b6bc919fbd7b34a7bb68f4b6']",3,4652,4655,4259054,6,,,,3828
93d5f025e243b0ff2c71f34be05c92a6e4bb0a83,0,honma,2014-10-22 20:45:30+08:00,['8498955780bec15419db6097f333b07d215e60b5'],4,13,17,4259071,2,,,,3828
ed1296c7b94ba18c499678dbe0e80497b656fa2c,0,Luke Han,2014-10-23 11:30:23+08:00,['93d5f025e243b0ff2c71f34be05c92a6e4bb0a83'],13728,0,13728,4272799,28,0,0.198113208,0.132075472,3828
7d4dce5ac543517fc6bdbd876cb571883b1b2348,0,Luke Han,2014-10-23 11:31:06+08:00,['ed1296c7b94ba18c499678dbe0e80497b656fa2c'],1,0,1,4272800,1,,,,3828
5aacb9ed37142de5f9d44d8768bb28ff4954a670,0,Li Yang,2014-10-23 11:36:54+08:00,['8498955780bec15419db6097f333b07d215e60b5'],0,1,1,4272801,1,,,,3828
01bacd791290a48e32ab57078bb3f7df1629da13,0,Li Yang,2014-10-23 11:37:10+08:00,"['5aacb9ed37142de5f9d44d8768bb28ff4954a670', '7d4dce5ac543517fc6bdbd876cb571883b1b2348']",13733,13,13746,4286547,31,,,,3828
759d926ea3d12736c8c9a812e09fdb90122c4928,0,Li Yang,2014-10-23 11:37:56+08:00,['01bacd791290a48e32ab57078bb3f7df1629da13'],1,0,1,4286548,1,,,,3828
a1587f1076dafc032d90afae8ea8de7dd217bcba,0,honma,2014-10-23 14:41:08+08:00,['01bacd791290a48e32ab57078bb3f7df1629da13'],12,17,29,4286577,4,0,1,0,3828
152e270b8ecb3ba982f86f3e1b9882e1c8a83f81,0,honma,2014-10-23 14:44:02+08:00,['a1587f1076dafc032d90afae8ea8de7dd217bcba'],2,6,8,4286585,1,0,0,0,3828
2e35d3d04a8fda0a63d3999a4f1876a03c9ccaac,0,honma,2014-10-23 14:49:21+08:00,['152e270b8ecb3ba982f86f3e1b9882e1c8a83f81'],3,0,3,4286588,1,,,,3828
a4ab73e3115fdddd7013be55a68587a6a5535bcc,0,honma,2014-10-23 15:10:15+08:00,['2e35d3d04a8fda0a63d3999a4f1876a03c9ccaac'],2,2,4,4286592,1,,,,3828
4aeb4f3ad2f3d8f125bdf07945be1ed521d9d15c,0,Trevor Hartman,2014-10-23 15:06:08-06:00,['a4ab73e3115fdddd7013be55a68587a6a5535bcc'],1,1,2,4286594,1,,,,3828
93bb7a7df2d858351b6ab5cf2d70d841579c794c,0,Luke Han,2014-10-24 09:21:01+08:00,"['a4ab73e3115fdddd7013be55a68587a6a5535bcc', '4aeb4f3ad2f3d8f125bdf07945be1ed521d9d15c']",1,1,2,4286596,1,,,,3828
295ddf002833c6d35563a57f40b39b88ce7ebbbb,0,honma,2014-10-24 09:28:22+08:00,['93bb7a7df2d858351b6ab5cf2d70d841579c794c'],1,1,2,4286598,1,,,,3828
3514cb2d92cda131a76c672ef44fbd5530d654db,0,"Xiaodong, Duo",2014-10-24 11:04:16+08:00,['295ddf002833c6d35563a57f40b39b88ce7ebbbb'],1,1,2,4286600,1,,,,3828
eb28233edd02f1b421bdb2b14ae34e10cefa8a5c,0,"Xiaodong, Duo",2014-10-24 11:04:56+08:00,"['14f4a7af3ebef2807e52a3a8c9a34fe07b534e6e', '3514cb2d92cda131a76c672ef44fbd5530d654db']",13897,4787,18684,4305284,69,,,,3828
9e901bf4dd144b665c84e4030de8b03b142f4566,0,"Xiaodong, Duo",2014-10-24 11:29:05+08:00,['3514cb2d92cda131a76c672ef44fbd5530d654db'],1,4,5,4305289,2,,,,3828
0a84cec26f45f696111e0590254700176c13f6f8,0,"Xiaodong, Duo",2014-10-24 12:38:59+08:00,['9e901bf4dd144b665c84e4030de8b03b142f4566'],1,1,2,4305291,1,,,,3828
d11ea364b7ab4c3af8681b2b80044b0c307800c2,0,"Xiaodong, Duo",2014-10-24 12:41:29+08:00,"['eb28233edd02f1b421bdb2b14ae34e10cefa8a5c', '0a84cec26f45f696111e0590254700176c13f6f8']",1,4,5,4305296,2,,,,3828
f9e3f49b48ee735acb5e4b1035cbe77d4b010d2d,0,"Xiaodong, Duo",2014-10-24 12:57:24+08:00,['d11ea364b7ab4c3af8681b2b80044b0c307800c2'],242,0,242,4305538,4,,,,3828
430b325f6e5c0c432f6b06ccaec76938aa813d3a,1,"Xiaodong, Duo",2014-10-24 16:43:22+08:00,['0a84cec26f45f696111e0590254700176c13f6f8'],0,1,1,4305539,1,0,1,1,3828
1ab90d2dc62460e48bbb6ac0b14724ef6c97245d,0,"Xiaodong, Duo",2014-10-24 16:44:54+08:00,['430b325f6e5c0c432f6b06ccaec76938aa813d3a'],2,2,4,4305543,1,,,,3828
38e3488f107922efd72238192c818d95b3275b0d,1,Zhong Jian,2014-10-24 17:14:18+08:00,['a4ab73e3115fdddd7013be55a68587a6a5535bcc'],46,46,92,4305635,3,,,,3828
734dd716ee35d98e75464e3bb46772ecf71834f2,0,Zhong Jian,2014-10-24 17:18:09+08:00,"['38e3488f107922efd72238192c818d95b3275b0d', '0a84cec26f45f696111e0590254700176c13f6f8']",2,5,7,4305642,3,,,,3828
d17b319555b13a3b0b0e45428506e0e910c62cb1,0,Li Yang,2014-10-24 17:24:38+08:00,"['1ab90d2dc62460e48bbb6ac0b14724ef6c97245d', '734dd716ee35d98e75464e3bb46772ecf71834f2']",46,46,92,4305734,3,,,,3828
dcd0d502b7d60cd9fc8958c4c9382fe934e56651,0,Li Yang,2014-10-26 12:16:48+08:00,['759d926ea3d12736c8c9a812e09fdb90122c4928'],0,7,7,4305741,1,0.666666667,0.666666667,1,3828
269801b674fda412ba53577ace66602b83c80e44,0,Li Yang,2014-10-26 12:19:47+08:00,['dcd0d502b7d60cd9fc8958c4c9382fe934e56651'],2,12,14,4305755,1,1,1,1,3828
5a221f7aa32f8603610310f90f5d97b2b099dff0,0,Li Yang,2014-10-26 12:22:26+08:00,['269801b674fda412ba53577ace66602b83c80e44'],2,1,3,4305758,1,,,,3828
2417dc7d023039aae30486a9e4b71216b48b1189,0,Li Yang,2014-10-26 12:24:17+08:00,['5a221f7aa32f8603610310f90f5d97b2b099dff0'],1,12,13,4305771,1,0,1,1,3828
c6ab86a906ec6f32d4eecc1f9163179eab6892e5,0,Li Yang,2014-10-26 12:37:22+08:00,['2417dc7d023039aae30486a9e4b71216b48b1189'],1,2,3,4305774,1,,,,3828
2dddd0d323c927baf411a685407d7be470e8cde0,0,Li Yang,2014-10-26 12:40:36+08:00,['c6ab86a906ec6f32d4eecc1f9163179eab6892e5'],2,1,3,4305777,1,,,,3828
d4c8b778f802364ea7a6fa835eabd4d82b19f76d,1,Li Yang,2014-10-26 12:41:54+08:00,['2dddd0d323c927baf411a685407d7be470e8cde0'],2,3,5,4305782,1,,,,3828
3563df6d58633c19263e996d432f5565f29cebe4,0,honma,2014-10-27 13:39:06+08:00,['d17b319555b13a3b0b0e45428506e0e910c62cb1'],2,7,9,4305791,1,,,,3828
5c9c1af682d52e30d90dc001f3520bc95cea083b,0,Li Yang,2014-10-27 18:09:33+08:00,"['d4c8b778f802364ea7a6fa835eabd4d82b19f76d', '3563df6d58633c19263e996d432f5565f29cebe4']",70,85,155,4305946,12,,,,3828
34faeec806e45dec2215aa967af38b4b716c8f01,0,honma,2014-10-27 19:32:38+08:00,['5c9c1af682d52e30d90dc001f3520bc95cea083b'],5,2,7,4305953,1,,,,3828
95eeb065db0c52e9b9b5aece21afe6dbfd212387,0,honma,2014-10-28 10:41:45+08:00,['34faeec806e45dec2215aa967af38b4b716c8f01'],29,18,47,4306000,3,,,,3828
2854f6a7a6d8d29dfa333bb60c7ec2f1222087f4,0,Li Yang,2014-10-28 10:59:45+08:00,"['34faeec806e45dec2215aa967af38b4b716c8f01', 'f9e3f49b48ee735acb5e4b1035cbe77d4b010d2d']",1163,1136,2299,4308299,28,,,,3828
12c2ec4cc0a6f868eb4603c748924add09d7e012,1,honma,2014-10-28 11:30:43+08:00,['95eeb065db0c52e9b9b5aece21afe6dbfd212387'],22,28,50,4308349,2,1,1,1,3828
e25ea23cbcc8772740bd33e06e7de82157da6f71,0,Li Yang,2014-10-28 13:12:35+08:00,['2854f6a7a6d8d29dfa333bb60c7ec2f1222087f4'],59,34,93,4308442,5,0,0,0,3828
f3afca3f8c314f6cf75f61ee83d4cf5c6a144efa,0,honma,2014-10-28 13:54:44+08:00,['12c2ec4cc0a6f868eb4603c748924add09d7e012'],4,28,32,4308474,2,,,,3828
ac093a2be0b118ac9b203102684d39c9df58ba35,0,honma,2014-10-28 13:56:20+08:00,['f3afca3f8c314f6cf75f61ee83d4cf5c6a144efa'],2,2,4,4308478,1,,,,3828
2fbc13b444b365041d88cfc10c5d7b5b61eea129,1,honma,2014-10-28 14:00:45+08:00,['e25ea23cbcc8772740bd33e06e7de82157da6f71'],29,18,47,4308525,3,,,,3828
4019be8137f50de010914aa0c695b89279084e71,1,honma,2014-10-28 14:00:46+08:00,['2fbc13b444b365041d88cfc10c5d7b5b61eea129'],22,28,50,4308575,2,1,1,1,3828
baf3680e918cde96df26ca259602d8c204aaa671,0,honma,2014-10-28 14:00:46+08:00,['4019be8137f50de010914aa0c695b89279084e71'],4,28,32,4308607,2,,,,3828
4af5d44db9efa3aee16209b8a29b5fe62c77bf6e,0,honma,2014-10-28 14:00:46+08:00,['baf3680e918cde96df26ca259602d8c204aaa671'],2,2,4,4308611,1,,,,3828
792e25d8a7dc0785af76b3d5b1f87a0bc846159b,0,honma,2014-10-28 14:04:46+08:00,"['ac093a2be0b118ac9b203102684d39c9df58ba35', '4af5d44db9efa3aee16209b8a29b5fe62c77bf6e']",1200,1148,2348,4310959,32,,,,3828
7dd9572a255a3b0564a032ec05c334c9b05a3313,0,honma,2014-10-28 15:31:34+08:00,['792e25d8a7dc0785af76b3d5b1f87a0bc846159b'],13,10,23,4310982,2,0,0,0,3828
cfa7eb343854dd33ca0846812d740fe8da711a53,0,Li Yang,2014-10-28 15:45:31+08:00,['4af5d44db9efa3aee16209b8a29b5fe62c77bf6e'],1,1,2,4310984,1,,,,3828
3f6c21e74bdefc3e1688a9dfd8a4c417e374ee4f,0,Li Yang,2014-10-28 15:58:52+08:00,['cfa7eb343854dd33ca0846812d740fe8da711a53'],22,27,49,4311033,1,1,0,1,3828
f1a6dc5bb1051af754f08bd18da80323a365b327,0,Li Yang,2014-10-28 09:20:36+01:00,"['792e25d8a7dc0785af76b3d5b1f87a0bc846159b', '3f6c21e74bdefc3e1688a9dfd8a4c417e374ee4f']",23,28,51,4311084,2,,,,3828
63abc902aec9519eb0d1a4eea930868ddbeaab39,0,Li Yang,2014-10-28 16:53:17+08:00,['f1a6dc5bb1051af754f08bd18da80323a365b327'],119,57,176,4311260,5,1,0.063829787,0,3828
a4db415b3c0d2c96c5ace30b4ed0ff18367b7a88,1,Li Yang,2014-10-28 16:56:37+08:00,['3f6c21e74bdefc3e1688a9dfd8a4c417e374ee4f'],50,48,98,4311358,5,,,,3828
1b261b083f1696db809665ec83c54976b53777ac,0,honma,2014-10-28 17:13:29+08:00,"['7dd9572a255a3b0564a032ec05c334c9b05a3313', 'a4db415b3c0d2c96c5ace30b4ed0ff18367b7a88']",73,76,149,4311507,7,,,,3828
4a4194c86e07e0e63f368e5eb1bfc1f3df1a7021,1,Li Yang,2014-10-28 17:59:10+08:00,"['63abc902aec9519eb0d1a4eea930868ddbeaab39', 'a4db415b3c0d2c96c5ace30b4ed0ff18367b7a88']",87,67,154,4311661,10,,,,3828
9e72f23c2e199190800cb55be684d5a27c25ef93,0,Li Yang,2014-10-28 18:04:29+08:00,"['4a4194c86e07e0e63f368e5eb1bfc1f3df1a7021', '1b261b083f1696db809665ec83c54976b53777ac']",13,10,23,4311684,2,,,,3828
0527350aed4528ae2f80dc79690b16a06210246e,1,Krisztian Horvath,2014-10-28 16:17:26+01:00,['a4db415b3c0d2c96c5ace30b4ed0ff18367b7a88'],6,7,13,4311697,1,,,,3828
3430b5099b2c02f0fea69fc5ecb3ab1c8870a8c6,1,honma,2014-10-29 13:39:53+08:00,['a4db415b3c0d2c96c5ace30b4ed0ff18367b7a88'],2,10,12,4311709,3,0,0,1,3828
4dcae6f4e365360a0d11a27257d78b5e8c09f147,0,Zhong Jian,2014-10-29 14:12:37+08:00,['2854f6a7a6d8d29dfa333bb60c7ec2f1222087f4'],61,67,128,4311837,10,0,1,1,3828
b831b20e34c46e38cdd1dd54bd0a6b6eb1a8f6b8,1,honma,2014-10-29 14:24:58+08:00,['3430b5099b2c02f0fea69fc5ecb3ab1c8870a8c6'],0,2,2,4311839,1,0,0,1,3828
41d5cb6b2b322d4f0a8b0ffe898e72c5274e9f46,0,honma,2014-10-29 14:46:04+08:00,['b831b20e34c46e38cdd1dd54bd0a6b6eb1a8f6b8'],1,6,7,4311846,1,0,1,0,3828
47ca0bb7683b4913a8308203060c180253531db6,0,honma,2014-10-29 15:13:03+08:00,['41d5cb6b2b322d4f0a8b0ffe898e72c5274e9f46'],5,3,8,4311854,1,1,0,1,3828
964dd9f2e99c75ab97ef3d22c75f5d1db9daefeb,1,honma,2014-10-29 22:18:53+08:00,['47ca0bb7683b4913a8308203060c180253531db6'],17,35,52,4311906,7,0.55,1,1,3828
b8dd4566e2fcdf0ba95af7449542a674dc934644,0,honma,2014-10-30 11:41:34+08:00,['964dd9f2e99c75ab97ef3d22c75f5d1db9daefeb'],1,1,2,4311908,1,1,0,1,3828
c50d713ff1c68fd0873bddf691ee442c41fa6bfd,1,Li Yang,2014-10-30 11:48:39+08:00,['9e72f23c2e199190800cb55be684d5a27c25ef93'],9,19,28,4311936,3,1,1,0,3828
076b5cb28f16dbca1fc70062686cd350afd937f7,0,Li Yang,2014-10-30 11:50:12+08:00,"['c50d713ff1c68fd0873bddf691ee442c41fa6bfd', 'b8dd4566e2fcdf0ba95af7449542a674dc934644']",22,53,75,4312011,8,,,,3828
5e8faf308c7352b811dcad7f010a93f28ad7b664,0,Li Yang,2014-10-30 11:50:58+08:00,['076b5cb28f16dbca1fc70062686cd350afd937f7'],0,1,1,4312012,1,,,,3828
ed3ba31b1ee62c8e8ea0e13a059990aead11834b,0,Li Yang,2014-10-30 16:32:19+08:00,['5e8faf308c7352b811dcad7f010a93f28ad7b664'],3,3,6,4312018,1,,,,3828
7a18d0d63b225f76d5fd25fd7b58f2f3df49cc35,1,Li Yang,2014-10-30 16:34:58+08:00,['ed3ba31b1ee62c8e8ea0e13a059990aead11834b'],0,2,2,4312020,1,1,1,1,3828
6e29f2be90b2d4cd2163adca8e1342008f8c758e,0,honma,2014-11-03 11:35:35+08:00,['7a18d0d63b225f76d5fd25fd7b58f2f3df49cc35'],1,1,2,4312022,1,,,,3828
e263009dfeb456729561ac187c08cba626378258,0,honma,2014-11-03 11:35:35+08:00,['6e29f2be90b2d4cd2163adca8e1342008f8c758e'],0,7,7,4312029,1,0,1,1,3828
d6cdb65fb6c26adbceff2f56e2c06067c2cd9aaa,1,ysong1,2014-11-03 13:45:20+08:00,['e263009dfeb456729561ac187c08cba626378258'],1,1,2,4312031,1,,,,3828
a203e9af7c135a9db43677339054069042189152,0,Li Yang,2014-11-03 15:30:03+08:00,['7a18d0d63b225f76d5fd25fd7b58f2f3df49cc35'],38,38,76,4312107,17,,,,3836
9b5d6afb0054bedcf79a37ba186b03be319ea90f,0,Li Yang,2014-11-03 15:31:07+08:00,['a203e9af7c135a9db43677339054069042189152'],3,3,6,4312113,2,,,,3836
5932d4deaae6209c50cf53bcb0673334f7def9b3,0,Zhong Jian,2014-11-03 18:30:56+08:00,['7a18d0d63b225f76d5fd25fd7b58f2f3df49cc35'],12,33,45,4312158,8,0,0.083333333,1,3836
c5eebb39be09c018e7ff1b0ef953adcb2c085f82,0,Zhong Jian,2014-11-03 18:31:22+08:00,"['5932d4deaae6209c50cf53bcb0673334f7def9b3', 'd6cdb65fb6c26adbceff2f56e2c06067c2cd9aaa']",2,9,11,4312169,3,,,,3836
a6648c2ed0185c4474373aa12b9be2bada3ac269,0,Zhong Jian,2014-11-03 19:03:56+08:00,['c5eebb39be09c018e7ff1b0ef953adcb2c085f82'],2,2,4,4312173,1,,,,3836
ec089637914988a501c64d99b993b006526a9952,1,Zhong Jian,2014-11-04 13:28:24+08:00,['a6648c2ed0185c4474373aa12b9be2bada3ac269'],15,23,38,4312211,3,,,,3836
0ccfb3628a6c944b0df93fd385f32203350cfc36,1,Zhong Jian,2014-11-04 16:49:17+08:00,['4dcae6f4e365360a0d11a27257d78b5e8c09f147'],36,84,120,4312331,8,0.952380952,1,1,3836
67a86f1632b2a0c5a64636f4eb3c82a69184eafe,0,Zhong Jian,2014-11-05 11:51:49+08:00,['0ccfb3628a6c944b0df93fd385f32203350cfc36'],4,5,9,4312340,2,0.25,0,0.25,3836
363c73913d4525e9042702972219ca141d081cf6,0,Zhong Jian,2014-11-05 12:59:00+08:00,['ec089637914988a501c64d99b993b006526a9952'],5,5,10,4312350,4,,,,3836
6f241f4c712136c4daa952991418d58fd0fe0f8d,1,Li Yang,2014-11-05 17:11:19+08:00,['9b5d6afb0054bedcf79a37ba186b03be319ea90f'],223,276,499,4312849,17,0.1,1,0.3,3838
16d111d1720b4cabcfb5fd60692f07c72f51f961,0,Zhong Jian,2014-11-05 21:00:35+08:00,['67a86f1632b2a0c5a64636f4eb3c82a69184eafe'],40,59,99,4312948,10,0,1,0,3838
b4dbef6b8acc755ebc4fa19e581dcac5613c736e,0,honma,2014-11-06 09:47:35+08:00,['6f241f4c712136c4daa952991418d58fd0fe0f8d'],3,1442,1445,4314393,7,0.598091198,0.768822906,0.873806999,3842
40d34ae5797b8cbd3d39439b56bba0a310eb7525,0,Li Yang,2014-11-06 10:57:00+08:00,['6f241f4c712136c4daa952991418d58fd0fe0f8d'],32,38,70,4314463,22,,,,3842
4a288580c97905b887b4428acc9a97fcaf269799,0,Zhong Jian,2014-11-06 15:02:14+08:00,['16d111d1720b4cabcfb5fd60692f07c72f51f961'],0,11,11,4314474,1,,,,3842
c8539313d034fa26f6972735f88db753864cf250,0,Zhong Jian,2014-11-06 15:23:37+08:00,['363c73913d4525e9042702972219ca141d081cf6'],0,3,3,4314477,1,,,,3842
baa03e42a84ce9b6779e6a103f242e9e2263c824,0,honma,2014-11-06 16:33:41+08:00,['b4dbef6b8acc755ebc4fa19e581dcac5613c736e'],4,1018,1022,4315499,7,0.623511905,0.803571429,1,3845
3d4fed93de8f71a48ae7e7b577324ace269f8a5b,0,honma,2014-11-06 17:44:33+08:00,['baa03e42a84ce9b6779e6a103f242e9e2263c824'],22,19,41,4315540,3,,,,3845
26260cdb0cf355dcf00fdf4b5fa61241ae66abd0,1,Zhong Jian,2014-11-06 19:16:06+08:00,['4a288580c97905b887b4428acc9a97fcaf269799'],5,29,34,4315574,4,0.047619048,1,0.904761905,3845
5bc24b183d5f28bcf971c1a936afefa0ed1a268a,0,Ankur Bansal,2014-11-06 17:01:39-08:00,['c8539313d034fa26f6972735f88db753864cf250'],1,1,2,4315576,1,,,,3845
302bfba03d32f798d892105add4a3d1d95ff173d,0,Zhong Jian,2014-11-07 16:31:50+08:00,['26260cdb0cf355dcf00fdf4b5fa61241ae66abd0'],8,14,22,4315598,4,0,1,1,3845
dfc1bf987499cb6ac699f439ff650e0db6458d6d,0,Zhong Jian,2014-11-07 16:54:02+08:00,['302bfba03d32f798d892105add4a3d1d95ff173d'],2,2,4,4315602,1,,,,3845
92fa72fdedfba92c8317a9f4f3b3ef827e5d1ef4,0,honma,2014-11-07 17:49:48+08:00,['3d4fed93de8f71a48ae7e7b577324ace269f8a5b'],32,26,58,4315660,6,1,0,0,3845
64978362b271ab3e593a8a76c9587622baf88864,0,Li Yang,2014-11-10 09:49:08+08:00,['40d34ae5797b8cbd3d39439b56bba0a310eb7525'],61,272,333,4315993,19,0.794871795,0.820512821,1,3848
4ee644f5e7157348c11f6b13b9e87cdb702b91dc,0,Li Yang,2014-11-10 01:52:36+00:00,"['64978362b271ab3e593a8a76c9587622baf88864', '92fa72fdedfba92c8317a9f4f3b3ef827e5d1ef4']",58,2499,2557,4318550,20,,,,3848
066268939d98e456ab039a133f3a2d0d8c85fae7,0,Li Yang,2014-11-10 09:55:56+08:00,"['c8539313d034fa26f6972735f88db753864cf250', '5bc24b183d5f28bcf971c1a936afefa0ed1a268a']",1,1,2,4318552,1,,,,3848
a2af73b34fd929e027679d172db43d6f248f80fb,0,Li Yang,2014-11-10 11:03:40+08:00,['c8539313d034fa26f6972735f88db753864cf250'],3,27,30,4318582,1,0.7,0.7,0.7,3848
719b9ac18ca1ca1f33520d675c1a914c72ee2cfe,0,Li Yang,2014-11-10 11:04:47+08:00,"['066268939d98e456ab039a133f3a2d0d8c85fae7', 'a2af73b34fd929e027679d172db43d6f248f80fb']",3,27,30,4318612,1,,,,3848
10608d4ce46c30759e665042d91afe9965011349,0,Li Yang,2014-11-10 11:44:39+08:00,['719b9ac18ca1ca1f33520d675c1a914c72ee2cfe'],1,1,2,4318614,1,,,,3848
106a07a762d0f80df17f149773120e5043dbe52c,0,Li Yang,2014-11-10 14:14:42+08:00,['10608d4ce46c30759e665042d91afe9965011349'],1,1,2,4318616,1,,,,3848
01843f958f3df15594c5135c217bec914cf709fc,0,Li Yang,2014-11-10 14:59:22+08:00,['106a07a762d0f80df17f149773120e5043dbe52c'],11,26,37,4318653,2,1,1,0.5,3848
f3b1df40a89bb159dbb594a0ce6076cc1080cac2,0,Zhong Jian,2014-11-10 17:00:34+08:00,['dfc1bf987499cb6ac699f439ff650e0db6458d6d'],3,9,12,4318665,3,1,1,1,3848
d02148e7ddbcb0935f7ed29f408f992231e0ae23,0,Zhong Jian,2014-11-10 17:13:11+08:00,['01843f958f3df15594c5135c217bec914cf709fc'],1,8,9,4318674,2,1,1,1,3848
eedc26249f5c739c669caf8cd4ba428c020c5f1d,0,Li Yang,2014-11-11 14:04:51+08:00,['01843f958f3df15594c5135c217bec914cf709fc'],2,1,3,4318677,1,,,,3848
aed461cba6cb6ffa33ffcf4254395efecd8bcbd7,0,Li Yang,2014-11-11 14:05:17+08:00,['eedc26249f5c739c669caf8cd4ba428c020c5f1d'],0,1,1,4318678,1,0,1,1,3848
6ab79414b2f735164d2d71d57d5844e7fd489730,0,Li Yang,2014-11-11 14:07:30+08:00,"['aed461cba6cb6ffa33ffcf4254395efecd8bcbd7', 'd02148e7ddbcb0935f7ed29f408f992231e0ae23']",1,8,9,4318687,2,,,,3848
bffca8b971361ef63283d02be513af981213ad22,0,Li Yang,2014-11-11 06:10:44+00:00,"['4ee644f5e7157348c11f6b13b9e87cdb702b91dc', '6ab79414b2f735164d2d71d57d5844e7fd489730']",51,136,187,4318874,22,,,,3848
44c73ed97577cba200f291d94c0a35abbdbcf54f,0,Li Yang,2014-11-11 14:31:02+08:00,['bffca8b971361ef63283d02be513af981213ad22'],1,2,3,4318877,1,,,,3848
333c7989e87e24cc0237ce2074ee55a58409168b,0,honma,2014-11-11 15:07:41+08:00,['44c73ed97577cba200f291d94c0a35abbdbcf54f'],502,2266,2768,4321645,26,0.655923345,0.800522648,0.93554007,3857
bebe636eb132016c331ae6c0b61d58faaa75f08e,1,honma,2014-11-11 15:18:21+08:00,['6ab79414b2f735164d2d71d57d5844e7fd489730'],0,7,7,4321652,1,,,,3858
be84a007ffad9a0b12290ad1412c4f9cc8d6e87d,1,honma,2014-11-11 15:18:36+08:00,['bebe636eb132016c331ae6c0b61d58faaa75f08e'],0,56,56,4321708,1,0.483870968,1,1,3858
bcb74e80d861e76420fa8bf02d6b9c32a2fd85dd,0,Li Yang,2014-11-11 15:25:27+08:00,['44c73ed97577cba200f291d94c0a35abbdbcf54f'],0,1,1,4321709,1,,,,3858
3da30f72f3dafea40c8ed78e1937c39b64e61e56,0,Li Yang,2014-11-11 15:25:53+08:00,['bcb74e80d861e76420fa8bf02d6b9c32a2fd85dd'],2,11,13,4321722,1,,,,3858
1e590e70977a44d45643c06ddef669bced2381d2,0,Li Yang,2014-11-11 15:26:33+08:00,['3da30f72f3dafea40c8ed78e1937c39b64e61e56'],13,3,16,4321738,1,,,,3858
ab54898c69f434b49abe007acccdd10691eda8d6,0,Li Yang,2014-11-11 15:28:57+08:00,['1e590e70977a44d45643c06ddef669bced2381d2'],5,2,7,4321745,1,1,0,0,3858
03dbcec9ea5b387407875e504c42f8475f53f075,0,Li Yang,2014-11-11 15:45:27+08:00,['6ab79414b2f735164d2d71d57d5844e7fd489730'],2,2,4,4321749,1,,,,3858
ef5717e6cd5711b6b09de26b9dc080df3ef114f3,0,Li Yang,2014-11-11 15:45:51+08:00,"['03dbcec9ea5b387407875e504c42f8475f53f075', 'be84a007ffad9a0b12290ad1412c4f9cc8d6e87d']",0,63,63,4321812,1,,,,3858
ee4b7a40aa6de48668c4c9ee4a4df62d0e93639a,0,Li Yang,2014-11-11 15:58:46+08:00,['ef5717e6cd5711b6b09de26b9dc080df3ef114f3'],2,4,6,4321818,1,,,,3858
872fc4c626b96ba597a5c974b1f84bde754c0f0a,0,honma,2014-11-11 16:14:38+08:00,['ee4b7a40aa6de48668c4c9ee4a4df62d0e93639a'],113,38,151,4321969,4,1,0.757142857,0.014285714,3858
df979949690379cdab493c47d666322e7895173c,0,Zhong Jian,2014-11-11 16:45:55+08:00,['ee4b7a40aa6de48668c4c9ee4a4df62d0e93639a'],2,8,10,4321979,2,1,1,0.75,3858
d1a671d3b853165ffec3e0a2daec367d17128152,0,Zhong Jian,2014-11-11 16:46:11+08:00,"['df979949690379cdab493c47d666322e7895173c', '872fc4c626b96ba597a5c974b1f84bde754c0f0a']",113,38,151,4322130,4,,,,3858
ffdab74ba5141499ee6dd61120941316352b90ba,1,honma,2014-11-11 16:55:52+08:00,['d1a671d3b853165ffec3e0a2daec367d17128152'],30,50,80,4322210,5,0.384615385,0.846153846,0.538461538,3858
33f9d156d4982a40cfb7c71c54baba13a5a1f986,1,honma,2014-11-11 17:01:27+08:00,['ffdab74ba5141499ee6dd61120941316352b90ba'],3,14,17,4322227,1,0,0,1,3858
499e350ae93a5759bf1a94f42660acfe07c1820e,0,honma,2014-11-11 17:17:39+08:00,['33f9d156d4982a40cfb7c71c54baba13a5a1f986'],6,5,11,4322238,1,0,0,0,3858
fd75896b929f2d9000f3d0273a185baf7df2839d,0,honma,2014-11-11 17:24:06+08:00,['499e350ae93a5759bf1a94f42660acfe07c1820e'],2,2,4,4322242,1,,,,3858
760eae5549b1f0b8a2e543ef0d3d7fd9fb03d32d,0,Li Yang,2014-11-11 17:43:57+08:00,['ab54898c69f434b49abe007acccdd10691eda8d6'],5,1,6,4322248,1,,,,3858
a56c1eab428ac682b9844d66cb0273b0c1e0f9be,0,Li Yang,2014-11-11 17:59:58+08:00,['ee4b7a40aa6de48668c4c9ee4a4df62d0e93639a'],32,19,51,4322299,1,1,1,0,3858
6ac92ef41c3305966ba3bac66214095fe431f717,0,honma,2014-11-11 18:00:20+08:00,['fd75896b929f2d9000f3d0273a185baf7df2839d'],0,1,1,4322300,1,,,,3858
0a16b32fbe02884b6cd58b99f4e84a3e262aaf17,0,Li Yang,2014-11-11 18:01:36+08:00,"['a56c1eab428ac682b9844d66cb0273b0c1e0f9be', '6ac92ef41c3305966ba3bac66214095fe431f717']",129,91,220,4322520,8,,,,3858
68a9255ce363f4d5ed4698809478f63f3b8b0083,1,honma,2014-11-11 19:46:38+08:00,['0a16b32fbe02884b6cd58b99f4e84a3e262aaf17'],2,4,6,4322526,1,0,0,1,3858
f69f6bfe8fb558c477692f42219d247c28173e27,1,honma,2014-11-11 20:16:54+08:00,['68a9255ce363f4d5ed4698809478f63f3b8b0083'],0,73,73,4322599,2,0.40625,1,1,3859
9aeeb1253f96c9f8454c814f5f0145393ecbc2b9,0,honma,2014-11-11 21:42:12+08:00,['f69f6bfe8fb558c477692f42219d247c28173e27'],0,2,2,4322601,1,1,1,1,3859
b75f2b87f828c99d54bcacace5d873dc33d94ba1,0,honma,2014-11-12 09:27:23+08:00,"['333c7989e87e24cc0237ce2074ee55a58409168b', 'ab54898c69f434b49abe007acccdd10691eda8d6']",52,29,81,4322682,6,,,,3859
510d901eba3deba857ecf7bf432f0d4cc6084342,0,Zhong Jian,2014-11-12 13:29:56+08:00,['d1a671d3b853165ffec3e0a2daec367d17128152'],1,1,2,4322684,1,,,,3859
6ddb7f3bdef7225b7a91dbe461b37a38a07258a4,0,Zhong Jian,2014-11-12 13:30:15+08:00,"['510d901eba3deba857ecf7bf432f0d4cc6084342', '9aeeb1253f96c9f8454c814f5f0145393ecbc2b9']",63,158,221,4322905,7,,,,3859
b1aa585eae5a922815d528cd93ebc82144de8fa8,1,Li Yang,2014-11-12 13:35:03+08:00,['0a16b32fbe02884b6cd58b99f4e84a3e262aaf17'],0,2,2,4322907,1,0.5,1,1,3859
d2bc7b08045e6f21413fa0c0d8b74a25a5bdb539,1,Zhong Jian,2014-11-12 13:37:29+08:00,['6ddb7f3bdef7225b7a91dbe461b37a38a07258a4'],1,1,2,4322909,1,,,,3859
d69f369a0a3c2e7517606593105f247b2a7d973a,0,Li Yang,2014-11-12 13:40:36+08:00,['b1aa585eae5a922815d528cd93ebc82144de8fa8'],0,1,1,4322910,1,1,1,1,3859
036a517b9908baa72d8addb54698a40fa6214280,0,Li Yang,2014-11-12 13:41:13+08:00,"['d69f369a0a3c2e7517606593105f247b2a7d973a', 'd2bc7b08045e6f21413fa0c0d8b74a25a5bdb539']",3,79,82,4322992,4,,,,3859
41c92793e63e0c8211a1990a4ccf0c3929554faa,0,Li Yang,2014-11-12 13:52:00+08:00,['036a517b9908baa72d8addb54698a40fa6214280'],27,22,49,4323041,6,1,1,1,3859
2da8c14fefa278c05ed291f779a4fe354ea500b8,1,honma,2014-11-12 17:36:42+08:00,['41c92793e63e0c8211a1990a4ccf0c3929554faa'],129,90,219,4323260,23,0.363636364,1,0,3859
fdbbc4fa83b3e5b9971390dcaf5bb651455407d8,1,Li Yang,2014-11-12 18:57:20+08:00,['2da8c14fefa278c05ed291f779a4fe354ea500b8'],5508,6219,11727,4334987,19,0.100684262,0.438905181,0.497556207,3859
4dd96e0ef21ae0b2ee3981d1e0d1f645dd2c9de2,0,Zhong Jian,2014-11-12 19:05:33+08:00,['f3b1df40a89bb159dbb594a0ce6076cc1080cac2'],5,90,95,4335082,5,0.403508772,1,0.649122807,3859
6165787aed622ea21c7d8d2598508202aa9df00f,0,honma,2014-11-12 19:12:25+08:00,['b75f2b87f828c99d54bcacace5d873dc33d94ba1'],6,14,20,4335102,3,0,0,1,3859
06df56ddf7d61ad80557e1684dd7a95172afe0cc,0,hongbin ma,2014-11-13 09:44:32+08:00,"['2da8c14fefa278c05ed291f779a4fe354ea500b8', '0527350aed4528ae2f80dc79690b16a06210246e']",6,7,13,4335115,1,,,,3859
b3129a8e2f9b73537f7aad975d84583f089e1fda,0,honma,2014-11-13 10:41:04+08:00,['06df56ddf7d61ad80557e1684dd7a95172afe0cc'],19,26,45,4335160,3,1,1,1,3859
7277631cb20633170a3569a2bfc83fdc0e656411,1,honma,2014-11-13 10:59:14+08:00,['b3129a8e2f9b73537f7aad975d84583f089e1fda'],28,47,75,4335235,4,0.5,1,1,3859
e01ed0639d01926027a699988a19f2830f9e7bd7,0,honma,2014-11-13 11:30:26+08:00,"['6165787aed622ea21c7d8d2598508202aa9df00f', '7277631cb20633170a3569a2bfc83fdc0e656411']",365,373,738,4335973,41,,,,3859
98c6a231715f7119f98bb45fa3b2f4852d79c7d4,1,Zhong Jian,2014-11-13 13:17:35+08:00,['4dd96e0ef21ae0b2ee3981d1e0d1f645dd2c9de2'],20,31,51,4336024,4,1,1,1,3859
278f122e50477c47063d421929b6dedcb9c0e292,0,Li Yang,2014-11-13 13:18:47+08:00,['fdbbc4fa83b3e5b9971390dcaf5bb651455407d8'],16,0,16,4336040,1,,,,3859
3fd0039899a382f1d741ad26aa015593e6adeb8f,1,Li Yang,2014-11-13 14:21:56+08:00,"['7277631cb20633170a3569a2bfc83fdc0e656411', '278f122e50477c47063d421929b6dedcb9c0e292']",5533,6252,11785,4347825,20,,,,3859
292aa0a8d998579265409b2d7a0b477018a652e5,1,Li Yang,2014-11-13 16:30:01+08:00,['3fd0039899a382f1d741ad26aa015593e6adeb8f'],62,49,111,4347936,3,1,0,0,3859
7cde5cba401712501d02701fe3112b222aa27bf3,1,honma,2014-11-13 16:49:52+08:00,['292aa0a8d998579265409b2d7a0b477018a652e5'],25,59,84,4348020,3,1,1,1,3859
1c325338b53e60c9c8fb79386e5e8d4a70c204f5,0,Zhong Jian,2014-11-13 17:15:03+08:00,['98c6a231715f7119f98bb45fa3b2f4852d79c7d4'],23,57,80,4348100,4,0.208333333,0.208333333,1,3859
85091b0e59733473261cd14af275f64bd84f995a,1,Zhong Jian,2014-11-13 17:24:06+08:00,['d2bc7b08045e6f21413fa0c0d8b74a25a5bdb539'],0,11,11,4348111,3,0.8,1,0.9,3859
7dce38a61cb90c8913603ace6083c79fd9879102,0,Zhong Jian,2014-11-13 17:24:57+08:00,"['85091b0e59733473261cd14af275f64bd84f995a', '7cde5cba401712501d02701fe3112b222aa27bf3']",5824,6549,12373,4360484,56,,,,3859
84056f2419d2fc287f250007797a4f909e708eb1,0,Li Yang,2014-11-13 17:27:57+08:00,['292aa0a8d998579265409b2d7a0b477018a652e5'],0,1,1,4360485,1,,,,3859
406f6a89e3341f5d05508b14aeb3c7cfec55af24,0,Li Yang,2014-11-13 17:28:43+08:00,['84056f2419d2fc287f250007797a4f909e708eb1'],58,66,124,4360609,25,,,,3859
28cae269f552b8b87388658c92c1168088cf2262,0,Li Yang,2014-11-13 17:30:47+08:00,"['406f6a89e3341f5d05508b14aeb3c7cfec55af24', '7cde5cba401712501d02701fe3112b222aa27bf3']",25,59,84,4360693,3,,,,3859
31c46a7d11934d65d790643e0553011e448ad6d5,0,Zhong Jian,2014-11-13 17:52:45+08:00,"['7dce38a61cb90c8913603ace6083c79fd9879102', '28cae269f552b8b87388658c92c1168088cf2262']",58,67,125,4360818,26,,,,3859
6ae3c37fb9e7fc432e7999a2db6fd32c43451afd,0,Zhong Jian,2014-11-13 19:17:24+08:00,['31c46a7d11934d65d790643e0553011e448ad6d5'],0,2,2,4360820,1,1,1,1,3859
3cecbcbdfd140b87f0df6653ff0a88b3485877f4,0,Zhong Jian,2014-11-13 20:18:55+08:00,['6ae3c37fb9e7fc432e7999a2db6fd32c43451afd'],2,2,4,4360824,1,,,,3859
fa105d22dd432d867890ae3ea9680a61567be9d1,0,honma,2014-11-13 21:06:47+08:00,['3cecbcbdfd140b87f0df6653ff0a88b3485877f4'],2,17,19,4360843,1,0,0,1,3859
abb546f0e3ea9107a42fbb64b1b3792a4f2e0fb1,0,Li Yang,2014-11-14 10:45:51+08:00,['28cae269f552b8b87388658c92c1168088cf2262'],37,1,38,4360881,6,0,0,0,3859
5ca82109773c7fc8d3fd0f470013afd788638eb0,0,Li Yang,2014-11-14 10:46:35+08:00,"['abb546f0e3ea9107a42fbb64b1b3792a4f2e0fb1', 'fa105d22dd432d867890ae3ea9680a61567be9d1']",4,32,36,4360917,5,,,,3859
d6a9de8f169cc2f235efdebfa28ee77b90b85e2a,0,Li Yang,2014-11-14 14:38:15+08:00,['5ca82109773c7fc8d3fd0f470013afd788638eb0'],2,1,3,4360920,1,,,,3859
d6938336dae9bed6f06758b38ad0bec3c9d4ef37,0,honma,2014-11-14 15:02:04+08:00,['e01ed0639d01926027a699988a19f2830f9e7bd7'],15,131,146,4361066,4,0.378378378,0.945945946,0.945945946,3860
03eae9e63c13ea3c07ed365ff122ee17f988e4ad,0,honma,2014-11-14 15:31:51+08:00,['d6a9de8f169cc2f235efdebfa28ee77b90b85e2a'],17,2,19,4361085,1,1,1,0,3860
d1eee6ea10759c7e7fc0b525569e5683775925b4,0,honma,2014-11-14 16:11:54+08:00,['d6938336dae9bed6f06758b38ad0bec3c9d4ef37'],4,13,17,4361102,1,0,1,1,3860
b66086f4111ea83c9a9c3e7e397f94ee5e81305d,0,qhzhou,2014-11-14 17:28:43+08:00,['fa105d22dd432d867890ae3ea9680a61567be9d1'],74,66,140,4361242,5,1,0,0,3860
565f7e4e164391e315a5db03065a44c3fecc33af,0,honma,2014-11-14 17:51:08+08:00,['d1eee6ea10759c7e7fc0b525569e5683775925b4'],9,121,130,4361372,7,0.227272727,1,1,3866
41065a6871e920f6ba643f04e0230da3a9d064dd,0,honma,2014-11-14 18:03:32+08:00,['03eae9e63c13ea3c07ed365ff122ee17f988e4ad'],18,23,41,4361413,1,,,,3866
ad18bce25c975e938c69c3a00ff6b75d28d47862,0,qhzhou,2014-11-14 18:07:09+08:00,['b66086f4111ea83c9a9c3e7e397f94ee5e81305d'],11,6,17,4361430,1,0,0,0,3866
b3407ab70e8146ab7dd581a95d6fe3d4f5ab6530,0,Li Yang,2014-11-14 18:20:18+08:00,"['292aa0a8d998579265409b2d7a0b477018a652e5', 'ad18bce25c975e938c69c3a00ff6b75d28d47862']",170,228,398,4361828,39,,,,3866
7a2c2ec7d446be6cf4e4d6a56464f8799a2df3f7,0,Li Yang,2014-11-14 18:28:16+08:00,['760eae5549b1f0b8a2e543ef0d3d7fd9fb03d32d'],15,266,281,4362109,6,0.82208589,0.82208589,0.957055215,3868
a4bda1dcd42c625f0efa39682b1e753e0cc01291,0,Li Yang,2014-11-14 18:33:45+08:00,['d6a9de8f169cc2f235efdebfa28ee77b90b85e2a'],18,23,41,4362150,1,,,,3868
3080306fe4e35069ad195fe58cac7f21f01b6401,0,Li Yang,2014-11-14 18:34:47+08:00,"['a4bda1dcd42c625f0efa39682b1e753e0cc01291', '41065a6871e920f6ba643f04e0230da3a9d064dd']",17,2,19,4362169,1,,,,3868
1555ff2b9c5c505ab9cfbbf713b2ddd7d615ef6d,0,Zhong Jian,2014-11-14 20:36:12+08:00,['1c325338b53e60c9c8fb79386e5e8d4a70c204f5'],73,95,168,4362337,10,0,1,1,3869
e923ee7513a7eb06f5aaab00e1ce52ac83c91267,0,qhzhou,2014-11-17 10:07:36+08:00,['ad18bce25c975e938c69c3a00ff6b75d28d47862'],7,2,9,4362346,2,1,0,0,3869
006c8ea203fe6b9184c499f627f9b1e374708aae,0,qhzhou,2014-11-17 10:11:02+08:00,['e923ee7513a7eb06f5aaab00e1ce52ac83c91267'],6,4,10,4362356,1,,,,3869
c5ea936f1df05fad485b01773460acb1ba454ae0,0,Zhong Jian,2014-11-17 14:08:11+08:00,['3080306fe4e35069ad195fe58cac7f21f01b6401'],2,9,11,4362367,1,0,0,1,3869
cccec8030eb008fbe349e2c36e7a28e35258f236,1,honma,2014-11-17 14:31:56+08:00,['c5ea936f1df05fad485b01773460acb1ba454ae0'],1,1,2,4362369,1,,,,3869
cde7155c3a62b609b52097a513a334f95f691908,0,honma,2014-11-17 18:07:46+08:00,['cccec8030eb008fbe349e2c36e7a28e35258f236'],5,14,19,4362388,3,1,1,1,3869
78c29b4a2c1b0c05ca620c2e62cff9a9d63ea566,0,honma,2014-11-18 09:20:29+08:00,['cde7155c3a62b609b52097a513a334f95f691908'],5,6,11,4362399,1,0,0,0,3869
803fa2f5c6d8a6d78e75b2a612b7991bb52851ed,0,qianhao.zhou,2014-11-18 09:38:32+08:00,"['006c8ea203fe6b9184c499f627f9b1e374708aae', '78c29b4a2c1b0c05ca620c2e62cff9a9d63ea566']",84,54,138,4362537,13,,,,3869
ec4d401701c44d55c4e345e19719d82d3ef9d854,0,honma,2014-11-18 09:49:55+08:00,"['565f7e4e164391e315a5db03065a44c3fecc33af', '78c29b4a2c1b0c05ca620c2e62cff9a9d63ea566']",6278,7024,13302,4375839,61,,,,3869
efa7e64fe4e737732e74292425fa771fadca6471,0,honma,2014-11-18 10:21:46+08:00,['ec4d401701c44d55c4e345e19719d82d3ef9d854'],307,300,607,4376446,11,,,,3869
f7183c8b181b3169a98cd41621bbf653d2f44771,0,Li Yang,2014-11-18 13:16:25+08:00,"['7a2c2ec7d446be6cf4e4d6a56464f8799a2df3f7', 'e01ed0639d01926027a699988a19f2830f9e7bd7']",862,2622,3484,4379930,63,,,,3869
3a596220b5f1ff0e63d79f782b1fb522cd45376e,0,Zhong Jian,2014-11-18 13:21:15+08:00,['1555ff2b9c5c505ab9cfbbf713b2ddd7d615ef6d'],10,4,14,4379944,3,0,0,0,3869
bde376f9ad0afd4f94dbd8ab554513f09f12e579,1,Li Yang,2014-11-18 13:23:19+08:00,"['f7183c8b181b3169a98cd41621bbf653d2f44771', '78c29b4a2c1b0c05ca620c2e62cff9a9d63ea566']",5751,6497,12248,4392192,63,,,,3869
6e566881df203d0d39d9d34b9f1f5946d2ce61a0,0,Zhong Jian,2014-11-18 13:44:10+08:00,"['3a596220b5f1ff0e63d79f782b1fb522cd45376e', 'b3407ab70e8146ab7dd581a95d6fe3d4f5ab6530']",6506,7387,13893,4406085,130,,,,3869
a72188070d1475a7df6ae6fd74d088e746fbec7f,0,honma,2014-11-18 13:49:16+08:00,['78c29b4a2c1b0c05ca620c2e62cff9a9d63ea566'],0,2,2,4406087,2,0.5,0.5,0.5,3869
aadb585b1f8edb3c9a646d066f9d26e23c954ec4,0,honma,2014-11-18 14:37:35+08:00,['a72188070d1475a7df6ae6fd74d088e746fbec7f'],2,0,2,4406089,2,0.5,0.5,0.5,3869
633009ce1caf11a1490aec12967cddc0a9fc232c,0,Zhong Jian,2014-11-18 15:24:52+08:00,"['6e566881df203d0d39d9d34b9f1f5946d2ce61a0', 'aadb585b1f8edb3c9a646d066f9d26e23c954ec4']",84,54,138,4406227,13,,,,3869
fe5580482a26884472aa8424ffa81d2901075bc1,0,Li Yang,2014-11-18 16:05:08+08:00,['bde376f9ad0afd4f94dbd8ab554513f09f12e579'],18,204,222,4406449,3,0.816666667,0.966666667,0.9,3869
70473ba589b185eaa4e1d5d4df5f7df567dd989f,0,Zhong Jian,2014-11-18 16:07:21+08:00,['633009ce1caf11a1490aec12967cddc0a9fc232c'],50,48,98,4406547,6,0,0,0,3869
872dfbb171843e673a9d245e4e2a47fbcc8db8ba,0,Zhong Jian,2014-11-18 16:10:30+08:00,"['b3407ab70e8146ab7dd581a95d6fe3d4f5ab6530', '70473ba589b185eaa4e1d5d4df5f7df567dd989f']",274,507,781,4407328,40,,,,3869
606d4e7f96777eb1c662a16b7bb0d2862ee21ef1,0,honma,2014-11-18 16:10:33+08:00,['efa7e64fe4e737732e74292425fa771fadca6471'],5,15,20,4407348,3,1,1,1,3869
f551163f3e315cd9158d1cfda3b8c51c70cb0dee,0,honma,2014-11-18 16:11:47+08:00,"['606d4e7f96777eb1c662a16b7bb0d2862ee21ef1', 'fe5580482a26884472aa8424ffa81d2901075bc1']",27,460,487,4407835,11,,,,3869
5305c8ea88ac567c621762e59548e041422d36ef,0,Li Yang,2014-11-18 16:44:27+08:00,"['872dfbb171843e673a9d245e4e2a47fbcc8db8ba', '006c8ea203fe6b9184c499f627f9b1e374708aae']",12,5,17,4407852,2,,,,3869
7bbadf0b66582b3e5fd6116f707bf3d9c88d5895,0,Zhong Jian,2014-11-18 16:51:09+08:00,['872dfbb171843e673a9d245e4e2a47fbcc8db8ba'],2,2,4,4407856,2,,,,3869
0108aa21028a6448a5ab9c2f662e7cfeb9c71ac0,0,Zhong Jian,2014-11-18 16:57:26+08:00,"['5305c8ea88ac567c621762e59548e041422d36ef', '7bbadf0b66582b3e5fd6116f707bf3d9c88d5895']",2,2,4,4407860,2,,,,3869
904a7d6547bc4adbd482891e8fa27f753ab6b6f8,0,Zhong Jian,2014-11-18 17:44:26+08:00,['7bbadf0b66582b3e5fd6116f707bf3d9c88d5895'],1,0,1,4407861,1,0,0,0,3869
01f9f16aed0a89f706166b5075007549c6993f12,0,Zhong Jian,2014-11-18 17:46:24+08:00,"['0108aa21028a6448a5ab9c2f662e7cfeb9c71ac0', '904a7d6547bc4adbd482891e8fa27f753ab6b6f8']",1,0,1,4407862,1,,,,3869
792543dab8aea5941fcace5dd9bc85f000340009,0,Zhong Jian,2014-11-18 20:36:09+08:00,['904a7d6547bc4adbd482891e8fa27f753ab6b6f8'],2,2,4,4407866,1,,,,3869
4b6011b9ef458f1411af036eed0dfae35a4f34fa,0,Zhong Jian,2014-11-18 20:38:02+08:00,"['01f9f16aed0a89f706166b5075007549c6993f12', '792543dab8aea5941fcace5dd9bc85f000340009']",2,2,4,4407870,1,,,,3869
b8acf68c439f84d2832e95e38c5b36926ed28502,1,Zhong Jian,2014-11-18 21:04:13+08:00,['792543dab8aea5941fcace5dd9bc85f000340009'],51,10,61,4407931,7,0.039215686,0,0.058823529,3869
290e5cf1488c1ea9c028d558588ca58b924c6a34,0,Zhong Jian,2014-11-18 21:06:11+08:00,"['4b6011b9ef458f1411af036eed0dfae35a4f34fa', 'b8acf68c439f84d2832e95e38c5b36926ed28502']",51,10,61,4407992,7,,,,3869
16f60dbca7c938e82990593fb3165c0cc77d2193,0,honma,2014-11-19 10:05:12+08:00,['f551163f3e315cd9158d1cfda3b8c51c70cb0dee'],4,14,18,4408010,7,1,1,1,3869
4a3c0290d0e9a998ea8328a260a6c522da6cff71,0,honma,2014-11-19 10:15:25+08:00,['aadb585b1f8edb3c9a646d066f9d26e23c954ec4'],6,13,19,4408029,3,1,1,0.166666667,3869
b7dc318f16ee4dd2e71d84a73f1d7c417f9ce964,0,Li Yang,2014-11-19 10:44:06+08:00,['fe5580482a26884472aa8424ffa81d2901075bc1'],0,17,17,4408046,1,1,1,1,3870
6c209b12b4952e146b5860e676adceb9d3cc5631,0,Zhong Jian,2014-11-19 10:50:42+08:00,['b8acf68c439f84d2832e95e38c5b36926ed28502'],7,6,13,4408059,2,1,0,1,3870
bec1c77dcddf868d02672521e467e1c549fa6348,0,Zhong Jian,2014-11-19 10:52:06+08:00,"['290e5cf1488c1ea9c028d558588ca58b924c6a34', '6c209b12b4952e146b5860e676adceb9d3cc5631']",7,6,13,4408072,2,,,,3870
7ada1c40abf32bcdb3706420f9a00858be6f39a5,0,Zhong Jian,2014-11-19 14:12:40+08:00,['6c209b12b4952e146b5860e676adceb9d3cc5631'],1,8,9,4408081,4,,,,3870
4eb821c0ed8265a48b3bc63720970442fb468a2f,0,Zhong Jian,2014-11-19 14:17:24+08:00,"['7ada1c40abf32bcdb3706420f9a00858be6f39a5', 'bec1c77dcddf868d02672521e467e1c549fa6348']",12,5,17,4408098,2,,,,3870
b8951d3d1b124db1ee9572f85693021fce242d99,0,honma,2014-11-19 14:29:23+08:00,['16f60dbca7c938e82990593fb3165c0cc77d2193'],8,14,22,4408120,5,0,1,1,3870
3f37023c459e7b135ab3089b9262963b4097d667,0,honma,2014-11-19 14:33:19+08:00,['4a3c0290d0e9a998ea8328a260a6c522da6cff71'],1,2,3,4408123,1,1,1,0,3870
906bc6802ec4461c40d8d722b12545624e2c7f0e,0,Zhong Jian,2014-11-19 14:38:33+08:00,"['bec1c77dcddf868d02672521e467e1c549fa6348', '7ada1c40abf32bcdb3706420f9a00858be6f39a5']",1,8,9,4408132,4,,,,3870
1a0dfe3362efae0f36e3c3d22b64f47b9f99397d,0,honma,2014-11-19 14:39:22+08:00,['b8951d3d1b124db1ee9572f85693021fce242d99'],2,1,3,4408135,2,,,,3870
8368cae564aab411a54aa8d284aefced5ab62621,0,honma,2014-11-19 15:04:33+08:00,['1a0dfe3362efae0f36e3c3d22b64f47b9f99397d'],29,7,36,4408171,1,1,1,1,3870
db11f3a1db119d9e35ab05e31aaeb9d59eff9151,1,Li Yang,2014-11-19 15:27:20+08:00,['290e5cf1488c1ea9c028d558588ca58b924c6a34'],603,247,850,4409021,7,0.817427386,0.680497925,0,3871
f71a0d287cef3252dc75e01cef2d55f9af695b2e,0,Li Yang,2014-11-19 15:37:49+08:00,['db11f3a1db119d9e35ab05e31aaeb9d59eff9151'],4,2,6,4409027,1,1,1,0,3871
4e15456a21d5d563a26ed7f58da13e45abc0cfad,0,Li Yang,2014-11-19 15:38:41+08:00,"['f71a0d287cef3252dc75e01cef2d55f9af695b2e', '906bc6802ec4461c40d8d722b12545624e2c7f0e']",8,14,22,4409049,6,,,,3871
793d6777939a0ca9591b417a21507d7ead0b4a49,1,Li Yang,2014-11-19 15:58:42+08:00,['4e15456a21d5d563a26ed7f58da13e45abc0cfad'],16,20,36,4409085,3,1,1,1,3871
d41f0a2503500af0307f770aace690fadd19283b,1,Zhong Jian,2014-11-19 16:48:11+08:00,['4eb821c0ed8265a48b3bc63720970442fb468a2f'],41,41,82,4409167,4,0.875,1,1,3871
a83c5c069681922dc7db0892ab93d9222db6d639,0,Zhong Jian,2014-11-19 16:49:24+08:00,"['d41f0a2503500af0307f770aace690fadd19283b', '793d6777939a0ca9591b417a21507d7ead0b4a49']",619,265,884,4410051,10,,,,3871
dc1975e1dca22a413462cc0a725dbaecbca23bdb,0,Zhong Jian,2014-11-19 17:24:00+08:00,['a83c5c069681922dc7db0892ab93d9222db6d639'],1,1,2,4410053,1,,,,3871
47b71b28be737db5da7f87aca578887fed948010,0,Zhong Jian,2014-11-19 17:27:20+08:00,"['793d6777939a0ca9591b417a21507d7ead0b4a49', 'dc1975e1dca22a413462cc0a725dbaecbca23bdb']",42,42,84,4410137,5,,,,3871
abe31f487bb66dad05f6c9d7e9019833f4753f20,0,qianhao.zhou,2014-11-19 18:05:15+08:00,['803fa2f5c6d8a6d78e75b2a612b7991bb52851ed'],17,20,37,4410174,4,0,,,3871
3e3d1cb816fd786fcb30ecc23f720dec1157ff73,0,Zhong Jian,2014-11-19 19:15:27+08:00,['dc1975e1dca22a413462cc0a725dbaecbca23bdb'],14,6,20,4410194,4,0,1,0,3871
094dc1c330ea9c4c4233e3fe0431587ad93a1bd2,0,qianhao.zhou,2014-11-19 20:38:07+08:00,['abe31f487bb66dad05f6c9d7e9019833f4753f20'],15,18,33,4410227,1,0,1,1,3871
20bac006057f773df49b14aea00927af2983f929,0,honma,2014-11-20 09:56:30+08:00,['8368cae564aab411a54aa8d284aefced5ab62621'],5,5,10,4410237,4,,,,3871
47030bb18cd2e4f9f8f4f53dff9d4d8b47f8d6f5,0,honma,2014-11-20 10:00:14+08:00,['3f37023c459e7b135ab3089b9262963b4097d667'],7,6,13,4410250,2,,,,3871
5d77b8ae3f7b6400419308d5c5867e7f4f41a0ef,0,Zhong Jian,2014-11-20 10:51:39+08:00,"['3e3d1cb816fd786fcb30ecc23f720dec1157ff73', '47b71b28be737db5da7f87aca578887fed948010']",0,0,0,4410250,0,,,,3871
4a1ac284162793b0d6bd682780776ddaed64b723,1,Li Yang,2014-11-20 11:08:51+08:00,['793d6777939a0ca9591b417a21507d7ead0b4a49'],1,3,4,4410254,1,0,0,0,3871
4c0910216127d43d45caedd0034a011bda4af127,0,Li Yang,2014-11-20 11:09:10+08:00,['4a1ac284162793b0d6bd682780776ddaed64b723'],1,1,2,4410256,1,,,,3871
97d34dbe540bbb5d704337b85a94142e847931c2,1,Li Yang,2014-11-20 11:10:40+08:00,['4c0910216127d43d45caedd0034a011bda4af127'],2,4,6,4410262,3,1,1,1,3871
5934078f1073e7a4850546ddf974144195f34629,0,Li Yang,2014-11-20 11:19:59+08:00,"['97d34dbe540bbb5d704337b85a94142e847931c2', '47b71b28be737db5da7f87aca578887fed948010']",42,42,84,4410346,5,,,,3871
3ff640e8b370557c6643d71e2da63c3138b28383,0,Li Yang,2014-11-20 11:22:59+08:00,"['47030bb18cd2e4f9f8f4f53dff9d4d8b47f8d6f5', '5934078f1073e7a4850546ddf974144195f34629']",929,786,1715,4412061,45,,,,3871
48d866bc8ead09ed47d633301ff59f63165621ec,0,Zhong Jian,2014-11-20 11:25:25+08:00,"['5934078f1073e7a4850546ddf974144195f34629', '3e3d1cb816fd786fcb30ecc23f720dec1157ff73']",14,6,20,4412081,4,,,,3871
f915e0d96333f15151e93348a24437e3f3b8a38f,0,Li Yang,2014-11-20 11:35:32+08:00,"['3ff640e8b370557c6643d71e2da63c3138b28383', '48d866bc8ead09ed47d633301ff59f63165621ec']",14,6,20,4412101,4,,,,3871
6b479fab778247398fae30b4c45c896cb2dfa57b,1,honma,2014-11-20 15:13:22+08:00,['47030bb18cd2e4f9f8f4f53dff9d4d8b47f8d6f5'],32,42,74,4412175,10,0,0,1,3872
1a9f1aff4dd97a8759d680c5e23a255f89164ed4,0,Li Yang,2014-11-20 15:38:07+08:00,['b7dc318f16ee4dd2e71d84a73f1d7c417f9ce964'],493,3,496,4412671,6,0.755656109,0.153846154,0.167420814,3872
bae4b50f277efcffed52e459bb54d407eb239df2,0,Li Yang,2014-11-20 15:51:47+08:00,['1a9f1aff4dd97a8759d680c5e23a255f89164ed4'],0,0,0,4412671,116,,,,3872
60470c075b9b4d51be1fa6a8e35add7cd1276f5b,0,Li Yang,2014-11-20 15:52:11+08:00,['bae4b50f277efcffed52e459bb54d407eb239df2'],10,1,11,4412682,2,,,,3872
ff278864875b5e51a8565b670b7807d2734ba4fe,0,Li Yang,2014-11-20 15:56:06+08:00,['60470c075b9b4d51be1fa6a8e35add7cd1276f5b'],3,3,6,4412688,2,,,,3872
0a587fc00787a765f30cae212a2fc210bb41b573,0,honma,2014-11-20 16:13:31+08:00,['f915e0d96333f15151e93348a24437e3f3b8a38f'],19,22,41,4412729,1,0,1,1,3872
47eb7d05f87f9d74cc4c161b3faafeb39ffb4d14,0,Li Yang,2014-11-20 16:19:47+08:00,['ff278864875b5e51a8565b670b7807d2734ba4fe'],31,19,50,4412779,11,0.333333333,0,0,3872
def92aada212322a661c1c1c8e2742fa55a7d14c,0,qianhao.zhou,2014-11-20 16:24:13+08:00,"['094dc1c330ea9c4c4233e3fe0431587ad93a1bd2', '0a587fc00787a765f30cae212a2fc210bb41b573']",864,743,1607,4414386,45,,,,3872
0ef5bd6010d55a0484a874e03d4e4fb0dadc9874,0,honma,2014-11-20 16:25:40+08:00,['6b479fab778247398fae30b4c45c896cb2dfa57b'],1,1,2,4414388,1,,,,3872
1b82ed79d0d608beb0a01580ad6e0f2500a40291,0,honma,2014-11-20 16:26:48+08:00,"['0a587fc00787a765f30cae212a2fc210bb41b573', '0ef5bd6010d55a0484a874e03d4e4fb0dadc9874']",32,42,74,4414462,10,,,,3872
9aa29833579c0ae76cd51d51d96c8b4fe402cf06,0,honma,2014-11-20 16:59:31+08:00,"['20bac006057f773df49b14aea00927af2983f929', '1b82ed79d0d608beb0a01580ad6e0f2500a40291']",983,851,1834,4416296,57,,,,3872
99cc852def38b37208def40b6be8ada858ba9bd2,0,honma,2014-11-20 17:47:37+08:00,['9aa29833579c0ae76cd51d51d96c8b4fe402cf06'],7,7,14,4416310,4,,,,3872
7e2d51b85052ba1cee4bd136efb16007e2e4e6c1,0,honma,2014-11-20 17:50:33+08:00,['1a9f1aff4dd97a8759d680c5e23a255f89164ed4'],1,1,2,4416312,1,,,,3872
23ae17fcf5111c5d90df21f4181ac55dcbcc18d8,0,Luke Han,2014-11-20 18:39:38+08:00,['1b82ed79d0d608beb0a01580ad6e0f2500a40291'],1910,1912,3822,4420134,10,,,,3872
d8c82397a815ade5b1636db6fd3f26eb73684940,0,qianhao.zhou,2014-11-20 18:47:37+08:00,['def92aada212322a661c1c1c8e2742fa55a7d14c'],55,131,186,4420320,7,0.171428571,0.014285714,0.757142857,3872
c66f86cf5388e2ce1f5d711185a15a4cf4511968,0,Luke Han,2014-11-20 18:59:07+08:00,['23ae17fcf5111c5d90df21f4181ac55dcbcc18d8'],19,17,36,4420356,10,,,,3872
0df91e64fd8e868c69fb6370cbfa4113cabb2ba2,0,Luke Han,2014-11-20 19:01:01+08:00,['c66f86cf5388e2ce1f5d711185a15a4cf4511968'],0,0,0,4420356,1,,,,3873
6af8635aa30a791c1b7cf453bbe481dd87615a70,1,Luke Han,2014-11-20 20:15:54+08:00,['0df91e64fd8e868c69fb6370cbfa4113cabb2ba2'],6,6,12,4420368,1,,,,3873
cf69b970ed3af170855668ab52435256acbb2699,0,Luke Han,2014-11-20 20:29:57+08:00,['6af8635aa30a791c1b7cf453bbe481dd87615a70'],1,2,3,4420371,1,,,,3873
878cbe25a47cf99fbdbbfea173dc88ae2e708354,0,Luke Han,2014-11-20 20:31:11+08:00,['cf69b970ed3af170855668ab52435256acbb2699'],11,12,23,4420394,10,,,,3873
83d3171c35020e7f70893e10a4ccb334c73c2ae2,0,Luke Han,2014-11-20 20:31:32+08:00,['878cbe25a47cf99fbdbbfea173dc88ae2e708354'],11,11,22,4420416,10,,,,3873
8c611035a282a2e5c38cf5b41ace84275a3e0986,1,Zhong Jian,2014-11-20 23:21:03+08:00,['5d77b8ae3f7b6400419308d5c5867e7f4f41a0ef'],9,190,199,4420615,6,0.319526627,0.810650888,0.964497041,3873
5ce458e7cb0cbd254ad8fb414fe55f8bc0105c24,0,Zhong Jian,2014-11-20 23:29:41+08:00,"['48d866bc8ead09ed47d633301ff59f63165621ec', '8c611035a282a2e5c38cf5b41ace84275a3e0986']",9,190,199,4420814,6,,,,3873
80846b52f02dfeae0ec74c4c03c8dfdf06efb36f,0,root,2014-11-20 07:39:38-08:00,['83d3171c35020e7f70893e10a4ccb334c73c2ae2'],0,7,7,4420821,1,0,0,1,3873
421c83f12143ca66d80c75cba80e0bd6a37aebdc,0,Zhong Jian,2014-11-20 23:44:05+08:00,['8c611035a282a2e5c38cf5b41ace84275a3e0986'],3,4,7,4420828,2,0,1,0,3873
4295878596be25a45440ebc60c0bacab2622c17f,0,Zhong Jian,2014-11-20 23:47:40+08:00,"['5ce458e7cb0cbd254ad8fb414fe55f8bc0105c24', '421c83f12143ca66d80c75cba80e0bd6a37aebdc']",3,4,7,4420835,2,,,,3873
6fd5d789d6a0ddaf3ef2cdc0193322956f730894,0,Luke Han,2014-11-21 08:09:46+08:00,['83d3171c35020e7f70893e10a4ccb334c73c2ae2'],1,1,2,4420837,1,,,,3873
925f31338b70e7afbe1e0b4d57f2c3e773e35ee6,0,Luke Han,2014-11-21 08:52:38+08:00,['6fd5d789d6a0ddaf3ef2cdc0193322956f730894'],1,2,3,4420840,1,1,0,1,3873
6213ea38da11814c0d7ea50c15355cec0b410bc5,0,qianhao.zhou,2014-11-21 10:10:25+08:00,"['d8c82397a815ade5b1636db6fd3f26eb73684940', '925f31338b70e7afbe1e0b4d57f2c3e773e35ee6']",1944,1957,3901,4424741,23,,,,3873
524681f6036494fbf27d428d2f1c15ff1d26cfbc,1,Li Yang,2014-11-21 10:52:08+08:00,['47eb7d05f87f9d74cc4c161b3faafeb39ffb4d14'],122,382,504,4425245,28,0.545454545,1,1,3875
7517a96970288c55e7b68170c7bc1200d6eac7c6,0,Li Yang,2014-11-21 10:52:47+08:00,"['524681f6036494fbf27d428d2f1c15ff1d26cfbc', '7e2d51b85052ba1cee4bd136efb16007e2e4e6c1']",1,1,2,4425247,1,,,,3875
18618994550e45d6ceac5aeefe8ad8dda667d385,0,Zhong Jian,2014-11-21 11:26:33+08:00,['4295878596be25a45440ebc60c0bacab2622c17f'],6,12,18,4425265,3,0,1,0.75,3875
5692b276b9e2acaf5d48eba450b998c9fb39bbf2,0,Zhong Jian,2014-11-21 11:28:46+08:00,"['4295878596be25a45440ebc60c0bacab2622c17f', '18618994550e45d6ceac5aeefe8ad8dda667d385']",6,12,18,4425283,3,,,,3875
736f70d98289cda21136b49e5d0fa99bffaade6e,0,Li Yang,2014-11-21 11:35:44+08:00,['7517a96970288c55e7b68170c7bc1200d6eac7c6'],3,4,7,4425290,2,,,,3875
9dda6c79c4ca5ea218cd2acdb831ebe7830ad5ca,0,Li Yang,2014-11-21 14:47:36+08:00,['736f70d98289cda21136b49e5d0fa99bffaade6e'],2,1,3,4425293,1,,,,3875
2ee1a3135e91052664abdeefe51145de7c1a123f,0,Li Yang,2014-11-21 14:52:16+08:00,"['9dda6c79c4ca5ea218cd2acdb831ebe7830ad5ca', '5692b276b9e2acaf5d48eba450b998c9fb39bbf2']",947,983,1930,4427223,48,,,,3875
a6e188f746663dd26c561505831a59a1db1350d6,0,Li Yang,2014-11-21 14:54:05+08:00,['2ee1a3135e91052664abdeefe51145de7c1a123f'],3,3,6,4427229,1,,,,3875
f6e96ddb46ea3f26c11aa308f6f0eca391b205c2,1,Zhong Jian,2014-11-21 14:54:42+08:00,['18618994550e45d6ceac5aeefe8ad8dda667d385'],11,9,20,4427249,4,,,,3875
841622cc8fe1d76a90e29a6c3ac8d71ed2518a22,0,Zhong Jian,2014-11-21 14:58:21+08:00,"['5692b276b9e2acaf5d48eba450b998c9fb39bbf2', 'f6e96ddb46ea3f26c11aa308f6f0eca391b205c2']",11,9,20,4427269,4,,,,3875
e76de892eb0549779ed78178800c6ee7840ca5d8,0,Li Yang,2014-11-21 15:04:17+08:00,['a6e188f746663dd26c561505831a59a1db1350d6'],1,1,2,4427271,1,,,,3875
7f569cbaab87cb602f5cc6de0bc8440e4da02586,0,qianhao.zhou,2014-11-21 15:16:10+08:00,['6213ea38da11814c0d7ea50c15355cec0b410bc5'],3,11,14,4427285,2,0,0,1,3875
96b9dff67da801ecae7b795b07c3a020c46b6fd7,0,Zhong Jian,2014-11-21 16:28:36+08:00,['f6e96ddb46ea3f26c11aa308f6f0eca391b205c2'],2,5,7,4427292,1,1,1,1,3875
1e4d9e983485f3821adb3d50ed82425fc7aaf637,0,Zhong Jian,2014-11-21 16:29:40+08:00,"['841622cc8fe1d76a90e29a6c3ac8d71ed2518a22', '96b9dff67da801ecae7b795b07c3a020c46b6fd7']",2,5,7,4427299,1,,,,3875
a2d62abe6408fc824fb00a96182c96a5a9426157,1,Li Yang,2014-11-21 17:18:20+08:00,['e76de892eb0549779ed78178800c6ee7840ca5d8'],847,682,1529,4428828,5,,,,3875
c3045258a495ee1add052c99fc78a01ca59d0637,0,Li Yang,2014-11-21 17:20:15+08:00,['a2d62abe6408fc824fb00a96182c96a5a9426157'],0,27,27,4428855,1,0,1,1,3875
b56ee4810c57d975496abc1d52ed7ec079e5b770,0,Li Yang,2014-11-21 17:23:04+08:00,['5934078f1073e7a4850546ddf974144195f34629'],5,5,10,4428865,3,,,,3875
a9084a6bf917f202b0f3f767b8febcea4868aae0,0,Li Yang,2014-11-21 17:23:44+08:00,"['b56ee4810c57d975496abc1d52ed7ec079e5b770', '1e4d9e983485f3821adb3d50ed82425fc7aaf637']",40,221,261,4429126,12,,,,3875
4fe9a5cab4062f3d64e708d04eddda71e5966cea,0,Li Yang,2014-11-21 09:25:13+00:00,"['c3045258a495ee1add052c99fc78a01ca59d0637', 'a9084a6bf917f202b0f3f767b8febcea4868aae0']",18,19,37,4429163,7,,,,3875
2adccde8b27a364b7f09e22c39742d8666f13fe9,1,Li Yang,2014-11-21 17:31:42+08:00,['a9084a6bf917f202b0f3f767b8febcea4868aae0'],1,1,2,4429165,1,,,,3875
3a14b8a52d9a1bf014d67c179342c6cda1ef2823,0,Li Yang,2014-11-21 09:32:55+00:00,"['4fe9a5cab4062f3d64e708d04eddda71e5966cea', '2adccde8b27a364b7f09e22c39742d8666f13fe9']",1,1,2,4429167,1,,,,3875
60bd9bd0e4daf76694173bdf376d02d716f63846,0,Zhong Jian,2014-11-21 18:46:21+08:00,['96b9dff67da801ecae7b795b07c3a020c46b6fd7'],10,14,24,4429191,2,,,,3875
64179c3962eb9b059b96b2f00d76744c77d7d4f1,0,Zhong Jian,2014-11-21 18:48:24+08:00,"['2adccde8b27a364b7f09e22c39742d8666f13fe9', '60bd9bd0e4daf76694173bdf376d02d716f63846']",10,14,24,4429215,2,,,,3875
096dc7afd3da7f16817dae00c452d8caded3cb72,0,Luke Han,2014-11-21 20:11:07+08:00,"['925f31338b70e7afbe1e0b4d57f2c3e773e35ee6', '80846b52f02dfeae0ec74c4c03c8dfdf06efb36f']",0,7,7,4429222,1,,,,3875
e67a3441c1e7ab24f3dfd84c7b30e53b42ec3283,1,Luke Han,2014-11-21 22:09:17+08:00,['096dc7afd3da7f16817dae00c452d8caded3cb72'],12,189,201,4429423,2,0.31097561,0.859756098,0.969512195,3875
4082c34a7ecc112f95fa8baabc111b4c084db15e,1,Li Yang,2014-11-23 12:37:13+08:00,['3a14b8a52d9a1bf014d67c179342c6cda1ef2823'],2,144,146,4429569,6,1,1,1,3877
bfac7933d1c44142ac61dd9887f39c89270878c0,0,Li Yang,2014-11-23 13:17:44+00:00,"['64179c3962eb9b059b96b2f00d76744c77d7d4f1', '4082c34a7ecc112f95fa8baabc111b4c084db15e']",2350,6944,9294,4438863,261,,,,3877
e4a643261e4113780c48aeed995988c763544985,0,Li Yang,2014-11-23 21:35:38+08:00,['4082c34a7ecc112f95fa8baabc111b4c084db15e'],626,0,626,4439489,4,0.578666667,0.181333333,0.082666667,3877
4f991310bf46616e76d66afab487dbae45b4052e,0,Li Yang,2014-11-23 13:36:48+00:00,"['bfac7933d1c44142ac61dd9887f39c89270878c0', 'e4a643261e4113780c48aeed995988c763544985']",626,0,626,4440115,4,,,,3877
8521e7d04b0b68a11c58c6ad3c2ce409af986a0d,0,honma,2014-11-24 09:08:28+08:00,['99cc852def38b37208def40b6be8ada858ba9bd2'],40,3,43,4440158,3,0.944444444,0,0,3877
ab4078687d81cd36814e894ef5609cf1e6ad5d47,0,Zhong Jian,2014-11-24 10:30:22+08:00,['60bd9bd0e4daf76694173bdf376d02d716f63846'],0,4,4,4440162,1,0,0,1,3877
7ba82c31bbae93b7538286fc1c97c78d3ced7cbd,1,Li Yang,2014-11-24 10:48:22+08:00,['4f991310bf46616e76d66afab487dbae45b4052e'],3,4,7,4440169,1,,,,3877
c73e21d5ebdf1d3f270d043e3cd7342f4566683b,0,Zhong Jian,2014-11-24 13:11:31+08:00,['ab4078687d81cd36814e894ef5609cf1e6ad5d47'],28,12,40,4440209,4,0,1,1,3877
b2ea392c54625137d19044903e00653861837c23,0,Zhong Jian,2014-11-24 13:13:41+08:00,"['7ba82c31bbae93b7538286fc1c97c78d3ced7cbd', 'c73e21d5ebdf1d3f270d043e3cd7342f4566683b']",28,16,44,4440253,5,,,,3877
f206a682d3b259a165d478bca3cd1ecb437cc8ce,0,qianhao.zhou,2014-11-24 13:20:49+08:00,"['7f569cbaab87cb602f5cc6de0bc8440e4da02586', 'e67a3441c1e7ab24f3dfd84c7b30e53b42ec3283']",12,196,208,4440461,3,,,,3877
56ae2f1ca8aae7ec5267e5fa4fff16e3adb8c927,0,Li Yang,2014-11-25 11:20:08+08:00,['7ba82c31bbae93b7538286fc1c97c78d3ced7cbd'],1,1,2,4440463,1,,,,3877
492fb590d03f572fef2c4bf84d7d8654fa2322b9,0,Li Yang,2014-11-25 11:20:28+08:00,['56ae2f1ca8aae7ec5267e5fa4fff16e3adb8c927'],1,1,2,4440465,1,,,,3877
4b0cf4832c412efdb16b0006598be1349320ccfa,0,Li Yang,2014-11-25 11:21:09+08:00,['492fb590d03f572fef2c4bf84d7d8654fa2322b9'],1,1,2,4440467,1,,,,3877
9d7f741f930c6140de3f472458037eb44c92b197,0,qianhao.zhou,2014-11-25 11:22:27+08:00,['e67a3441c1e7ab24f3dfd84c7b30e53b42ec3283'],4,12,16,4440483,2,0.714285714,0.714285714,1,3877
251ffac9c3e96f1ba388b58129b55b734f703cb0,0,Li Yang,2014-11-25 11:40:57+08:00,"['e67a3441c1e7ab24f3dfd84c7b30e53b42ec3283', '9d7f741f930c6140de3f472458037eb44c92b197']",4,12,16,4440499,2,,,,3877
60f24d478b045d6ac2bfa7bda41b88f48191c5a2,0,Li Yang,2014-11-25 14:04:17+08:00,['4b0cf4832c412efdb16b0006598be1349320ccfa'],1,1,2,4440501,1,,,,3877
5b96a1b2eb44e222304d76557e68b826af22ab6c,0,Li Yang,2014-11-25 14:53:48+08:00,"['60f24d478b045d6ac2bfa7bda41b88f48191c5a2', 'b2ea392c54625137d19044903e00653861837c23']",28,16,44,4440545,5,,,,3877
6ffff46750d17d7a885f2c0ba6d6fef9800e77d2,1,qianhao.zhou,2014-11-25 15:02:06+08:00,['9d7f741f930c6140de3f472458037eb44c92b197'],5,9,14,4440559,2,0,1,1,3878
efd98417373537811d3590bafb973eb1fc58dfca,0,qianhao.zhou,2014-11-25 15:09:05+08:00,['6ffff46750d17d7a885f2c0ba6d6fef9800e77d2'],1,1,2,4440561,1,,,,3878
42c08e90e357a9dfe7e324578a93960f6caabefb,0,Li Yang,2014-11-25 15:10:53+08:00,"['251ffac9c3e96f1ba388b58129b55b734f703cb0', 'efd98417373537811d3590bafb973eb1fc58dfca']",5,9,14,4440575,2,,,,3878
515219f381b16a950dac0e925a30b809f140e319,0,honma,2014-11-25 15:18:02+08:00,['8521e7d04b0b68a11c58c6ad3c2ce409af986a0d'],104,729,833,4441408,14,0.48655914,0.481182796,0.924731183,3879
b63d03c7581fd693d81fdbd4b61a7e766d6efa63,0,qianhao.zhou,2014-11-25 15:19:20+08:00,"['7f569cbaab87cb602f5cc6de0bc8440e4da02586', '42c08e90e357a9dfe7e324578a93960f6caabefb']",21,217,238,4441646,7,,,,3879
401ee5323803295bf77dc9ab47bd30fc4bd20906,0,qianhao.zhou,2014-11-25 15:21:33+08:00,"['b63d03c7581fd693d81fdbd4b61a7e766d6efa63', 'f206a682d3b259a165d478bca3cd1ecb437cc8ce']",0,0,0,4441646,0,,,,3879
84342f5f64fd67eb7106e0e837b1d5783b118c5e,0,qianhao.zhou,2014-11-25 15:27:37+08:00,"['401ee5323803295bf77dc9ab47bd30fc4bd20906', '5b96a1b2eb44e222304d76557e68b826af22ab6c']",3070,7676,10746,4452392,278,,,,3879
0f8c0c73979c103579b1a081d0839dc2f3ad6b7d,0,Li Yang,2014-11-25 15:47:48+08:00,"['5b96a1b2eb44e222304d76557e68b826af22ab6c', '84342f5f64fd67eb7106e0e837b1d5783b118c5e']",1409,2174,3583,4455975,44,,,,3879
13481fafa4a8bc3fdf8c7307140dcf9db44d1f76,1,Li Yang,2014-11-25 15:57:30+08:00,['5b96a1b2eb44e222304d76557e68b826af22ab6c'],3,35,38,4456013,2,0.28,1,1,3879
720e413031e8cfd4c5509ebc7a1b1e66fe4ffe8c,0,Li Yang,2014-11-25 15:58:33+08:00,"['13481fafa4a8bc3fdf8c7307140dcf9db44d1f76', '0f8c0c73979c103579b1a081d0839dc2f3ad6b7d']",1409,2174,3583,4459596,44,,,,3879
c01cd7f2a5871a07a20654e1f8cd8cadb579b072,0,Li Yang,2014-11-25 16:15:03+08:00,['720e413031e8cfd4c5509ebc7a1b1e66fe4ffe8c'],325,16,341,4459937,2,0.376190476,0,0.076190476,3879
f4ab0e7a7c14f8f78a68b11074c3e7a7a7c3aa3c,1,Zhong Jian,2014-11-25 16:42:43+08:00,['c73e21d5ebdf1d3f270d043e3cd7342f4566683b'],24,50,74,4460011,1,1,0,0.666666667,3879
44a1579a96e7bfe59ce0c40e103d8845bdb5cb9f,0,Li Yang,2014-11-25 16:58:51+08:00,['c01cd7f2a5871a07a20654e1f8cd8cadb579b072'],3,2,5,4460016,1,0,0,0,3879
b4cc317fe6cf55667f9969db7cbe95265462b340,0,qianhao.zhou,2014-11-25 17:06:31+08:00,['42c08e90e357a9dfe7e324578a93960f6caabefb'],25,49,74,4460090,8,0.933333333,0.933333333,0.8,3879
74a48dac95e0d0eb6a81aaec3f593505f6891ca6,0,Li Yang,2014-11-25 17:13:02+08:00,['44a1579a96e7bfe59ce0c40e103d8845bdb5cb9f'],6,7,13,4460103,6,,,,3879
cb3d7cf5ddaafbda46854f03e22a3c9d949f5199,0,Li Yang,2014-11-25 17:14:43+08:00,['74a48dac95e0d0eb6a81aaec3f593505f6891ca6'],1,1,2,4460105,1,,,,3879
f72eb665dc101dbfcc7211c2d59f0e689144f3d9,0,Zhong Jian,2014-11-25 17:22:57+08:00,"['f4ab0e7a7c14f8f78a68b11074c3e7a7a7c3aa3c', 'c01cd7f2a5871a07a20654e1f8cd8cadb579b072']",4011,8466,12477,4472582,296,,,,3879
5a2b0cce2859ab1aa68fb96aacaffbaf5b14a876,0,Zhong Jian,2014-11-25 17:24:50+08:00,"['74a48dac95e0d0eb6a81aaec3f593505f6891ca6', 'f72eb665dc101dbfcc7211c2d59f0e689144f3d9']",24,48,72,4472654,1,,,,3879
af95cc5bc82e71e501dfe022a4ac5750da7b8551,0,Li Yang,2014-11-25 17:31:52+08:00,"['cb3d7cf5ddaafbda46854f03e22a3c9d949f5199', '5a2b0cce2859ab1aa68fb96aacaffbaf5b14a876']",24,48,72,4472726,1,,,,3879
4a0dae34b84970966af38d9458862a5cf982449f,0,Li Yang,2014-11-25 21:53:01+08:00,['af95cc5bc82e71e501dfe022a4ac5750da7b8551'],15,26,41,4472767,1,1,1,0,3879
d3fbe7854c27b567a3e5bd7e951dfd6635435324,0,Zhong Jian,2014-11-25 22:19:55+08:00,['f72eb665dc101dbfcc7211c2d59f0e689144f3d9'],34,62,96,4472863,3,0.219512195,0.853658537,0.87804878,3879
042ac1a5f417408bfa12c721ac587ecf4a6aa531,0,Zhong Jian,2014-11-25 22:21:26+08:00,"['4a0dae34b84970966af38d9458862a5cf982449f', 'd3fbe7854c27b567a3e5bd7e951dfd6635435324']",34,62,96,4472959,3,,,,3879
5bf4fce860aef0c0a1d6b95280d57302c0994690,0,Luke Han,2014-11-25 23:06:21+08:00,['042ac1a5f417408bfa12c721ac587ecf4a6aa531'],1,1,2,4472961,1,,,,3879
c699283a89935a36ba2c716f50c00620f8275d96,0,qianhao.zhou,2014-11-26 09:43:26+08:00,"['5a2b0cce2859ab1aa68fb96aacaffbaf5b14a876', 'b4cc317fe6cf55667f9969db7cbe95265462b340']",25,48,73,4473034,8,,,,3879
e63881a2a70ab4112f0425fbbe06102af2ae8273,0,qianhao.zhou,2014-11-26 09:43:38+08:00,"['c699283a89935a36ba2c716f50c00620f8275d96', '5bf4fce860aef0c0a1d6b95280d57302c0994690']",51,90,141,4473175,6,,,,3879
5d280cda9ae10e2734c3f7e069d35c3e60950411,0,Li Yang,2014-11-26 09:49:41+08:00,['4a0dae34b84970966af38d9458862a5cf982449f'],1,2,3,4473178,1,,,,3879
97839890f1375325c73baf6291edebc0194e17b9,0,Li Yang,2014-11-26 10:26:00+08:00,"['5d280cda9ae10e2734c3f7e069d35c3e60950411', '5bf4fce860aef0c0a1d6b95280d57302c0994690']",35,63,98,4473276,4,,,,3879
4e50cecf790b3cdb913830caefed8e71eee953a6,0,Li Yang,2014-11-26 14:29:26+08:00,['97839890f1375325c73baf6291edebc0194e17b9'],2,2,4,4473280,1,1,1,1,3879
24a1d6e0ced7365318d021bf5048d26448fc4a38,0,honma,2014-11-26 14:42:31+08:00,['4e50cecf790b3cdb913830caefed8e71eee953a6'],3,4,7,4473287,1,1,0,0,3879
87e18af13f5144b59591167192d2d09fa22f5cd1,0,qianhao.zhou,2014-11-26 15:30:34+08:00,"['e63881a2a70ab4112f0425fbbe06102af2ae8273', '24a1d6e0ced7365318d021bf5048d26448fc4a38']",6,8,14,4473301,3,,,,3879
922a31eb7942fa5b7a20042643776249bd7b3a15,0,Zhong Jian,2014-11-26 16:27:16+08:00,['d3fbe7854c27b567a3e5bd7e951dfd6635435324'],14,28,42,4473343,5,0.4,1,0.4,3879
a76cdde8b06733ee14702e4f2979c6dd3fd25098,0,Zhong Jian,2014-11-26 16:43:21+08:00,"['24a1d6e0ced7365318d021bf5048d26448fc4a38', '922a31eb7942fa5b7a20042643776249bd7b3a15']",14,28,42,4473385,5,,,,3879
0ad4f0c7691112bafcfc5b8b96e0fe5353aa4df5,0,qianhao.zhou,2014-11-26 17:06:56+08:00,['87e18af13f5144b59591167192d2d09fa22f5cd1'],6,13,19,4473404,1,0,1,0,3879
1717dde5918d9dd284e58b9fa670bb8f3ca501da,0,qhzhou,2014-11-26 17:17:03+08:00,"['a76cdde8b06733ee14702e4f2979c6dd3fd25098', '0ad4f0c7691112bafcfc5b8b96e0fe5353aa4df5']",30,60,90,4473494,8,,,,3879
8ac16cac086588a03e6e9141909bfbd9ac32401c,1,qianhao.zhou,2014-11-26 19:13:23+08:00,['0ad4f0c7691112bafcfc5b8b96e0fe5353aa4df5'],24,39,63,4473557,9,1,1,1,3879
fcc579a640e55ff9680dae3c69446cd422466a46,0,qhzhou,2014-11-26 19:29:01+08:00,"['1717dde5918d9dd284e58b9fa670bb8f3ca501da', '8ac16cac086588a03e6e9141909bfbd9ac32401c']",24,39,63,4473620,9,,,,3879
847d1a1dfec61274082116d51a486054c34058dc,0,qianhao.zhou,2014-11-26 20:01:40+08:00,['8ac16cac086588a03e6e9141909bfbd9ac32401c'],4,11,15,4473635,1,1,1,1,3879
f4ad9e801c210e73976b3bb67189d2430d2c322d,0,qianhao.zhou,2014-11-26 20:01:50+08:00,"['847d1a1dfec61274082116d51a486054c34058dc', 'fcc579a640e55ff9680dae3c69446cd422466a46']",14,28,42,4473677,5,,,,3879
0dd6b703c777c77b780f3cfd7979956a1d8c9bad,0,qianhao.zhou,2014-11-26 20:15:48+08:00,['f4ad9e801c210e73976b3bb67189d2430d2c322d'],1,6,7,4473684,3,0,0.4,0.2,3879
7dd98644c4a2ae9ee0f695f8f5b4309afc4c3661,0,qhzhou,2014-11-26 20:18:51+08:00,"['fcc579a640e55ff9680dae3c69446cd422466a46', '0dd6b703c777c77b780f3cfd7979956a1d8c9bad']",5,17,22,4473706,4,,,,3879
5485ca89fb7fddad97a45f3703719697acca8e50,1,qianhao.zhou,2014-11-26 20:44:59+08:00,['7dd98644c4a2ae9ee0f695f8f5b4309afc4c3661'],6,6,12,4473718,1,,,,3879
94f87b478d6cfafa8b1f71b29fedaff70e1dc091,0,qhzhou,2014-11-26 20:48:41+08:00,"['7dd98644c4a2ae9ee0f695f8f5b4309afc4c3661', '5485ca89fb7fddad97a45f3703719697acca8e50']",6,6,12,4473730,1,,,,3879
93609bb11ca5b45ff37e29c9aee7d2bca03ba7d8,1,Zhong Jian,2014-11-26 20:49:03+08:00,['922a31eb7942fa5b7a20042643776249bd7b3a15'],17,41,58,4473788,2,0,1,1,3879
dbbbcb545ff63064b57de7cbeb03ef4202c273df,0,Zhong Jian,2014-11-26 20:49:48+08:00,"['93609bb11ca5b45ff37e29c9aee7d2bca03ba7d8', '94f87b478d6cfafa8b1f71b29fedaff70e1dc091']",74,144,218,4474006,21,,,,3879
214acec3347274ed92b4a75ba618477c58ca2dfa,0,Zhong Jian,2014-11-26 21:14:57+08:00,['dbbbcb545ff63064b57de7cbeb03ef4202c273df'],77,0,77,4474083,1,0.393442623,0.37704918,0.016393443,3879
0255c3a689870c388853f8baa4ef754653e4a2f2,0,Zhong Jian,2014-11-26 21:18:27+08:00,"['94f87b478d6cfafa8b1f71b29fedaff70e1dc091', '214acec3347274ed92b4a75ba618477c58ca2dfa']",78,25,103,4474186,2,,,,3879
de5ac95734f68ad362e679dce09e4fc87f0f80c8,0,Li Yang,2014-11-27 10:36:32+08:00,['0255c3a689870c388853f8baa4ef754653e4a2f2'],0,3,3,4474189,1,,,,3879
e1b853f06bf0edc277590dc5f33164644510bf31,0,Li Yang,2014-11-27 11:08:03+08:00,['de5ac95734f68ad362e679dce09e4fc87f0f80c8'],0,5,5,4474194,1,,,,3879
50c2867c7742281787e9f9090134159017123af1,0,qianhao.zhou,2014-11-27 15:42:58+08:00,['de5ac95734f68ad362e679dce09e4fc87f0f80c8'],18,40,58,4474252,8,0.315789474,0.210526316,1,3879
861414f8aaf7c850a86242cf34c9b59f6a3367ec,1,Zhong Jian,2014-11-27 15:59:49+08:00,['214acec3347274ed92b4a75ba618477c58ca2dfa'],5,4,9,4474261,2,,,,3879
704a5fbc88542a4d4c3668f06aa36bf0f47a7bb9,0,Zhong Jian,2014-11-27 16:01:02+08:00,"['e1b853f06bf0edc277590dc5f33164644510bf31', '861414f8aaf7c850a86242cf34c9b59f6a3367ec']",5,4,9,4474270,2,,,,3879
5556f6beeb3b61875c146f08b9e7643ad08f38ab,1,shaofengshi,2014-11-27 16:25:00+08:00,['a6e188f746663dd26c561505831a59a1db1350d6'],8,1130,1138,4475408,21,0.444743935,1,0.948787062,3892
7cf56c50d7662e6bd696419a77ebc6773c83c796,0,shaofengshi,2014-11-27 16:27:07+08:00,"['5556f6beeb3b61875c146f08b9e7643ad08f38ab', 'e4a643261e4113780c48aeed995988c763544985']",1495,874,2369,4477777,25,,,,3892
7ca1e0895a4ee92d4d308cdc83345ab857634cfb,0,qianhao.zhou,2014-11-27 16:34:20+08:00,['50c2867c7742281787e9f9090134159017123af1'],13,16,29,4477806,2,1,1,1,3892
9e6952e10f2ac0f285865c87c3c9628d1c73bc49,0,qhzhou,2014-11-27 16:35:57+08:00,"['704a5fbc88542a4d4c3668f06aa36bf0f47a7bb9', '7ca1e0895a4ee92d4d308cdc83345ab857634cfb']",31,56,87,4477893,8,,,,3892
b420bf3af06ab626f3bd23a205e9c7f8bfbabd0c,0,Li Yang,2014-11-27 18:28:04+08:00,['fe5580482a26884472aa8424ffa81d2901075bc1'],185,246,431,4478324,119,,,,3895
43cffabda87b9e93844b98e5ac82b04491757f9d,0,Li Yang,2014-11-27 10:46:02+00:00,"['b420bf3af06ab626f3bd23a205e9c7f8bfbabd0c', '515219f381b16a950dac0e925a30b809f140e319']",1980,2672,4652,4482976,95,,,,3895
a642924d1c022ff0f54e3b9a18d6fff18c2d3d7e,0,Li Yang,2014-11-27 18:47:07+08:00,['43cffabda87b9e93844b98e5ac82b04491757f9d'],1,0,1,4482977,1,,,,3895
7fa00815fb5f1c0cf6601e7a1acfd6448e6d431b,0,qianhao.zhou,2014-11-27 19:05:59+08:00,['7ca1e0895a4ee92d4d308cdc83345ab857634cfb'],24,34,58,4483035,4,0,0,0,3895
006d7e28e2e2cae8878c1169e872b8fce593c71d,0,Zhong Jian,2014-11-27 19:07:09+08:00,['861414f8aaf7c850a86242cf34c9b59f6a3367ec'],27,27,54,4483089,6,0,1,1,3895
7095b9a5c466f9f97e1d2b482e85ab4bcf51cb39,0,qhzhou,2014-11-27 19:09:08+08:00,"['9e6952e10f2ac0f285865c87c3c9628d1c73bc49', '7fa00815fb5f1c0cf6601e7a1acfd6448e6d431b']",24,34,58,4483147,4,,,,3895
aef5a469dcceadf57075e4bcd96958ce2243e260,0,Zhong Jian,2014-11-27 19:15:45+08:00,"['7095b9a5c466f9f97e1d2b482e85ab4bcf51cb39', '006d7e28e2e2cae8878c1169e872b8fce593c71d']",27,27,54,4483201,6,,,,3895
8aca0fc9b8eaa51239a212b7fcbc9bfca66dff0a,0,qianhao.zhou,2014-11-28 09:51:35+08:00,['aef5a469dcceadf57075e4bcd96958ce2243e260'],82,47,129,4483330,8,0.129032258,0.677419355,1,3895
1c193c4ba1882681fde1d8533ab9a810ae5904aa,0,qianhao.zhou,2014-11-28 10:57:02+08:00,['8aca0fc9b8eaa51239a212b7fcbc9bfca66dff0a'],21,74,95,4483425,7,0.816326531,0.510204082,0.081632653,3895
5b9de1ad447b3f9f0686e6db730571793399999e,0,qhzhou,2014-11-28 10:58:09+08:00,"['aef5a469dcceadf57075e4bcd96958ce2243e260', '1c193c4ba1882681fde1d8533ab9a810ae5904aa']",56,74,130,4483555,9,,,,3895
ed2539f327b05a9364872ab2d17a673bce9d23ef,0,qianhao.zhou,2014-11-28 11:10:29+08:00,['5b9de1ad447b3f9f0686e6db730571793399999e'],4,6,10,4483565,3,0,0,1,3895
d83bb25620eaa358eac3b2ed1f0af9645a6c7413,0,qianhao.zhou,2014-11-28 11:12:44+08:00,"['5b9de1ad447b3f9f0686e6db730571793399999e', 'ed2539f327b05a9364872ab2d17a673bce9d23ef']",4,6,10,4483575,3,,,,3895
463d157dfd7e7b5e41998fffe63b51c8477ffc35,0,Li Yang,2014-11-28 03:15:42+00:00,['a642924d1c022ff0f54e3b9a18d6fff18c2d3d7e'],1,3,4,4483579,1,,,,3895
79406dff3dd5a53e94703e195d01cf09a15e273d,0,qianhao.zhou,2014-11-28 14:10:31+08:00,['d83bb25620eaa358eac3b2ed1f0af9645a6c7413'],1,1,2,4483581,1,,,,3895
b54ad34d52a7df3d90766e014ee4ef8842806708,0,qianhao.zhou,2014-11-28 14:11:17+08:00,"['d83bb25620eaa358eac3b2ed1f0af9645a6c7413', '79406dff3dd5a53e94703e195d01cf09a15e273d']",1,1,2,4483583,1,,,,3895
315f97996463ad22e75cf78da5750cb76574ec1a,0,Li Yang,2014-11-28 14:11:38+08:00,['d83bb25620eaa358eac3b2ed1f0af9645a6c7413'],6,2,8,4483591,1,,,,3895
812c9d1a232c0daa6b075b30f2ed118424679b5e,0,Li Yang,2014-11-28 14:14:57+08:00,"['e4a643261e4113780c48aeed995988c763544985', '7cf56c50d7662e6bd696419a77ebc6773c83c796']",8,1130,1138,4484729,21,,,,3895
e34e56ff190f1bcb64f01b369baccc72a16b13dd,0,Li Yang,2014-11-28 14:47:47+08:00,"['315f97996463ad22e75cf78da5750cb76574ec1a', 'b54ad34d52a7df3d90766e014ee4ef8842806708']",1,1,2,4484731,1,,,,3895
9880ec1d0b5b694d6967c56a16a6e055196926e0,0,Zhong Jian,2014-11-28 15:17:56+08:00,['006d7e28e2e2cae8878c1169e872b8fce593c71d'],2,2,4,4484735,2,,,,3895
37b23d4b4f5b2f8fca8620b480882e42542748c4,0,Zhong Jian,2014-11-28 15:19:26+08:00,"['e34e56ff190f1bcb64f01b369baccc72a16b13dd', '9880ec1d0b5b694d6967c56a16a6e055196926e0']",2,2,4,4484739,2,,,,3895
8be5ce92996c18ad4f9f937fdcf2d6b088b23e1f,0,Li Yang,2014-11-28 15:40:43+08:00,['463d157dfd7e7b5e41998fffe63b51c8477ffc35'],9,25,34,4484773,8,,,,3895
469a04bef7305eb0f79664fdf8ae05078ca662ce,0,Li Yang,2014-11-28 07:52:51+00:00,"['8be5ce92996c18ad4f9f937fdcf2d6b088b23e1f', 'e34e56ff190f1bcb64f01b369baccc72a16b13dd']",3676,3607,7283,4492056,230,,,,3895
ac1b3f519bafee5de8cf643f508141df798a50ea,0,Li Yang,2014-11-28 15:55:13+08:00,['469a04bef7305eb0f79664fdf8ae05078ca662ce'],2,2,4,4492060,1,,,,3895
64101d8f79121a8aee48b7a140f2f52f227b452d,0,honma,2014-11-28 15:59:37+08:00,['ac1b3f519bafee5de8cf643f508141df798a50ea'],44,42,86,4492146,2,1,1,1,3895
22d706cb87c1a751b9c934230e64285c73097e03,0,honma,2014-11-28 16:02:29+08:00,['64101d8f79121a8aee48b7a140f2f52f227b452d'],447,432,879,4493025,17,,,,3895
36daef9668959ba9aec7d3434875e45992112abe,0,honma,2014-11-28 16:05:39+08:00,['22d706cb87c1a751b9c934230e64285c73097e03'],520,673,1193,4494218,37,0.753424658,1,1,3897
50a432babee45404a5bbad565aebb652a00d60a2,0,honma,2014-11-28 16:06:19+08:00,['36daef9668959ba9aec7d3434875e45992112abe'],196,264,460,4494678,14,1,1,0.710526316,3898
5e95819d689fcb4cc772279a8eb216c84ca955c4,0,honma,2014-11-28 16:06:19+08:00,['50a432babee45404a5bbad565aebb652a00d60a2'],78,285,363,4495041,14,0.53125,1,1,3901
410f83518d88f992165e154508f3bd3f2ecfef56,0,honma,2014-11-28 16:06:19+08:00,['5e95819d689fcb4cc772279a8eb216c84ca955c4'],0,40,40,4495081,1,1,1,1,3901
808c7c58ff2805d872b85e6077ad63a6ca709b5c,0,honma,2014-11-28 16:13:26+08:00,['410f83518d88f992165e154508f3bd3f2ecfef56'],15,15,30,4495111,8,,,,3901
42412a59eb4c1b872ef8c21eda038e01b047d364,0,Zhong Jian,2014-11-28 16:24:42+08:00,['9880ec1d0b5b694d6967c56a16a6e055196926e0'],3,3,6,4495117,3,,,,3901
80974909da399e38adf83af9520e1f75909cc2ff,0,Zhong Jian,2014-11-28 16:25:50+08:00,"['37b23d4b4f5b2f8fca8620b480882e42542748c4', '42412a59eb4c1b872ef8c21eda038e01b047d364']",3,3,6,4495123,3,,,,3901
fb35fd60f439c95fc53420125510888185846511,0,Luke Han,2014-11-28 16:27:33+08:00,['37b23d4b4f5b2f8fca8620b480882e42542748c4'],742,742,1484,4496607,10,,,,3901
c213a420b64356e6449070e92c4f146faeaf48f8,0,Luke Han,2014-11-28 16:39:07+08:00,"['fb35fd60f439c95fc53420125510888185846511', '80974909da399e38adf83af9520e1f75909cc2ff']",3,3,6,4496613,3,,,,3901
45672a13dbcfa70a915d763d159aaa4cb2cf6000,0,Luke Han,2014-11-28 16:40:32+08:00,['c213a420b64356e6449070e92c4f146faeaf48f8'],11,11,22,4496635,10,,,,3901
0c53e4aaae35eea71ea16890b73d6cfbb8248ae3,0,Li Yang,2014-11-28 17:00:58+08:00,['808c7c58ff2805d872b85e6077ad63a6ca709b5c'],352,372,724,4497359,96,1,1,1,3901
9e0f585ffbc00b85de10ee4667ff39a4d8b3a375,0,Luke Han,2014-11-28 17:03:13+08:00,['45672a13dbcfa70a915d763d159aaa4cb2cf6000'],1,1,2,4497361,1,,,,3901
dfde1cd63834d56b02002ada0481dd991309ccd7,1,shaofengshi,2014-11-28 17:03:32+08:00,['7cf56c50d7662e6bd696419a77ebc6773c83c796'],35,38409,38444,4535805,252,0.318367347,1,0.746938776,4146
0fde6485dbabacb701f882566af70fd2a7fd64db,0,shaofengshi,2014-11-28 17:04:01+08:00,"['dfde1cd63834d56b02002ada0481dd991309ccd7', '812c9d1a232c0daa6b075b30f2ed118424679b5e']",0,0,0,4535805,0,,,,4146
8321b5b895052ae588e9dd69e2fa198378d7de0c,1,shaofengshi,2014-11-28 17:30:32+08:00,['9e0f585ffbc00b85de10ee4667ff39a4d8b3a375'],35,59,94,4535899,5,0,0,0,4146
b34e04d396fe8944c3f965a75e5033af5cf382ce,1,shaofengshi,2014-11-28 17:51:17+08:00,['8321b5b895052ae588e9dd69e2fa198378d7de0c'],3,73,76,4535975,2,0.952380952,0.952380952,0.952380952,4147
bb9210b5bbde27c0651c4d736a3901c7ccc72fe9,0,honma,2014-11-28 18:42:26+08:00,['b54ad34d52a7df3d90766e014ee4ef8842806708'],9,10,19,4535994,1,1,1,1,4147
50997fe0867516c4af738bbba04758c4a529ef19,0,Zhong Jian,2014-11-28 19:11:23+08:00,['42412a59eb4c1b872ef8c21eda038e01b047d364'],4,7,11,4536005,4,0,0,1,4147
6286cf74d1026f7352fa998e8d8ca46408d18738,0,Zhong Jian,2014-11-28 19:13:04+08:00,"['9e0f585ffbc00b85de10ee4667ff39a4d8b3a375', '50997fe0867516c4af738bbba04758c4a529ef19']",4,7,11,4536016,4,,,,4147
b038b088a00d1a6fc5cb6cf9e840f3776f70d754,1,shaofengshi,2014-11-28 19:18:43+08:00,['0c53e4aaae35eea71ea16890b73d6cfbb8248ae3'],111,226,337,4536353,26,0.946428571,0.946428571,0.964285714,4147
b7b6607221578db7476a329817a1f26c30bed3d7,0,shaofengshi,2014-11-28 19:21:21+08:00,"['0c53e4aaae35eea71ea16890b73d6cfbb8248ae3', 'b038b088a00d1a6fc5cb6cf9e840f3776f70d754']",111,226,337,4536690,26,,,,4147
6df7ab7bf598bad52dc1c75c42a0b03af4a85c98,0,shaofengshi,2014-11-28 19:22:05+08:00,"['6286cf74d1026f7352fa998e8d8ca46408d18738', 'b34e04d396fe8944c3f965a75e5033af5cf382ce']",94,188,282,4536972,7,,,,4147
bb7579cb37d5ef0c5b13b3d3db4bdba6d87964f0,0,Li Yang,2014-11-28 20:21:42+08:00,['6df7ab7bf598bad52dc1c75c42a0b03af4a85c98'],0,4,4,4536976,1,1,1,1,4147
8e5bb6c9577c347adb0e66270f30ce34e97b5283,0,Li Yang,2014-11-28 20:37:55+08:00,['bb7579cb37d5ef0c5b13b3d3db4bdba6d87964f0'],5,8,13,4536989,2,0.333333333,0.333333333,1,4147
d224a341e3441f2b28167a43f045465eb254ebd7,0,Li Yang,2014-11-28 20:50:50+08:00,['8e5bb6c9577c347adb0e66270f30ce34e97b5283'],4,0,4,4536993,1,0,0,0,4147
8f7386a8da6b4b7642c7062dacc915afb24c9e43,1,Li Yang,2014-11-28 21:07:35+08:00,['d224a341e3441f2b28167a43f045465eb254ebd7'],6494,6912,13406,4550399,8,,,,4151
9c0c5d9258aa30002321f82387b921c300dd0de0,0,Li Yang,2014-11-28 13:13:33+00:00,"['8f7386a8da6b4b7642c7062dacc915afb24c9e43', 'bb9210b5bbde27c0651c4d736a3901c7ccc72fe9']",9,10,19,4550418,1,,,,4151
c09a94d9fd698fca331060558881723f48dc2a2b,0,qianhao.zhou,2014-12-01 09:34:11+08:00,['b7b6607221578db7476a329817a1f26c30bed3d7'],0,17,17,4550435,1,1,1,1,4151
940375ddc0b8f7fd4c8260afef4715a8909839f4,0,qianhao.zhou,2014-12-01 10:05:16+08:00,"['b7b6607221578db7476a329817a1f26c30bed3d7', 'c09a94d9fd698fca331060558881723f48dc2a2b']",0,17,17,4550452,1,,,,4151
ce6555556cfefff3526b0578464fc82d86ad3582,0,honma,2014-12-01 10:56:24+08:00,['940375ddc0b8f7fd4c8260afef4715a8909839f4'],0,1,1,4550453,1,,,,4151
6fbc4b59c388cf9d37443906ae3500b5b1ef53cc,0,honma,2014-12-01 11:35:56+08:00,['808c7c58ff2805d872b85e6077ad63a6ca709b5c'],1,5,6,4550459,1,1,1,1,4151
0fcc7d56fd47c9b8d20548062729c0e1f93e3035,0,shaofengshi,2014-12-01 11:43:21+08:00,['b7b6607221578db7476a329817a1f26c30bed3d7'],39,39,78,4550537,3,0,1,1,4151
9ef15875bbbe296d24b38961adeb90b83b7b83de,0,shaofengshi,2014-12-01 11:46:03+08:00,"['ce6555556cfefff3526b0578464fc82d86ad3582', '0fcc7d56fd47c9b8d20548062729c0e1f93e3035']",39,39,78,4550615,3,,,,4151
53ce7338f93dfecf7c06b8d1243cf18a52aecd9b,0,shaofengshi,2014-12-01 13:38:51+08:00,['9c0c5d9258aa30002321f82387b921c300dd0de0'],2,1,3,4550618,2,,,,4151
c89cb9a8c0c523a5750325700098b72775504b13,1,shaofengshi,2014-12-01 14:15:11+08:00,['9ef15875bbbe296d24b38961adeb90b83b7b83de'],242,344,586,4551204,14,0.371428571,1,1,4152
d33820a4ce45748ab48a89ee9da146b514700b10,1,shaofengshi,2014-12-01 16:05:46+08:00,['c89cb9a8c0c523a5750325700098b72775504b13'],32,49,81,4551285,4,0.5,1,1,4153
5c86e2d9c2640670cf2f0384fbcc588e070d0f20,1,qianhao.zhou,2014-12-01 16:17:53+08:00,['9c0c5d9258aa30002321f82387b921c300dd0de0'],0,15,15,4551300,1,0,0,1,4153
ea239b32802574e1bf0c3b0cce3e2e4d772223b6,0,hongbin ma,2014-12-01 16:28:51+08:00,"['9c0c5d9258aa30002321f82387b921c300dd0de0', '5c86e2d9c2640670cf2f0384fbcc588e070d0f20']",0,15,15,4551315,1,,,,4153
a35cd332767d7c0e9004477d2be5072caf6aedab,0,honma,2014-12-01 19:52:29+08:00,['6fbc4b59c388cf9d37443906ae3500b5b1ef53cc'],60,141,201,4551516,6,0,1,0.984375,4153
efa2fd3c13e90e1e9e23cf8a9b826e4fbd730ead,0,Li Yang,2014-12-01 22:12:33+08:00,['ea239b32802574e1bf0c3b0cce3e2e4d772223b6'],3,2,5,4551521,3,1,1,1,4153
8d3b644c1af4ecf959035931fda184f14009cd9b,0,shaofengshi,2014-12-02 09:40:12+08:00,['0fde6485dbabacb701f882566af70fd2a7fd64db'],0,155,155,4551676,1,0.802469136,1,0.814814815,4154
b9173ab25cc949854773df4bc891a31776849960,1,Zhong Jian,2014-12-02 17:22:02+08:00,['006d7e28e2e2cae8878c1169e872b8fce593c71d'],8,44,52,4551728,7,0.647058824,1,1,4154
caa02203eb3a228d3503dd64b6509027460c9f5e,1,shaofengshi,2014-12-02 17:49:57+08:00,['d33820a4ce45748ab48a89ee9da146b514700b10'],469,556,1025,4552753,21,0.25862069,0.525862069,1,4158
11be1e0923e7a3993497fb273ef49d0f3bcf9989,0,shaofengshi,2014-12-02 17:57:26+08:00,"['9ef15875bbbe296d24b38961adeb90b83b7b83de', 'caa02203eb3a228d3503dd64b6509027460c9f5e']",736,942,1678,4554431,35,,,,4158
002a4e6a0ceb9c42f6c3c3c7e6d6a84ccec1bea7,0,shaofengshi,2014-12-02 18:08:44+08:00,['caa02203eb3a228d3503dd64b6509027460c9f5e'],64,21,85,4554516,3,,,,4158
4d87afac0b7d093cad34809f3a243d1b4df6a267,1,qianhao.zhou,2014-12-02 18:53:35+08:00,['11be1e0923e7a3993497fb273ef49d0f3bcf9989'],59,46,105,4554621,3,0.3125,0.375,0,4158
032581e4161857892d13980d52ec864c670c2729,0,qianhao.zhou,2014-12-02 20:05:25+08:00,['4d87afac0b7d093cad34809f3a243d1b4df6a267'],118,9,127,4554748,1,0.88,0.57,0.07,4158
ebbc42589aae647e7fb572a89861f097aebe10ae,0,qianhao.zhou,2014-12-02 20:07:38+08:00,['032581e4161857892d13980d52ec864c670c2729'],25,9,34,4554782,2,,,,4158
967267518e1d641de1eff0f1d65fa1cdd2c7f349,0,qianhao.zhou,2014-12-02 20:09:47+08:00,"['11be1e0923e7a3993497fb273ef49d0f3bcf9989', 'ebbc42589aae647e7fb572a89861f097aebe10ae']",201,63,264,4555046,5,,,,4158
d4f4ffddf19a30266f56f938d0f5e713e618d3bd,0,Akash Mishra,2014-12-02 18:57:12+05:18,['9c0c5d9258aa30002321f82387b921c300dd0de0'],1,1,2,4555048,1,,,,4158
9cc120869a7388252818bb4b29db7a81be1527ab,0,hongbin ma,2014-12-02 21:42:28+08:00,"['9c0c5d9258aa30002321f82387b921c300dd0de0', 'd4f4ffddf19a30266f56f938d0f5e713e618d3bd']",1,1,2,4555050,1,,,,4158
8fa88d9a0a61f3741043dd0963924aa00f471c58,0,shaofengshi,2014-12-02 22:29:55+08:00,"['967267518e1d641de1eff0f1d65fa1cdd2c7f349', '002a4e6a0ceb9c42f6c3c3c7e6d6a84ccec1bea7']",64,21,85,4555135,3,,,,4158
76d0174040d0729f8d093350812d6f9f8e3f3818,0,Li Yang,2014-12-02 11:49:41-08:00,['efa2fd3c13e90e1e9e23cf8a9b826e4fbd730ead'],32,26,58,4555193,2,1,1,0.75,4158
3b1b2ab1f214df557931145985a7579ff245ebd8,0,Li Yang,2014-12-02 12:01:41-08:00,['76d0174040d0729f8d093350812d6f9f8e3f3818'],0,2,2,4555195,1,0,0,0,4158
17edec60f0a98dc40b48f413e29171b185ce4b77,0,Li Yang,2014-12-02 13:24:21-08:00,['3b1b2ab1f214df557931145985a7579ff245ebd8'],1,1,2,4555197,1,,,,4158
d732388a07ee0b840cc671c3c98037b30b1edad9,0,Li Yang,2014-12-02 14:05:35-08:00,['17edec60f0a98dc40b48f413e29171b185ce4b77'],3,19,22,4555219,3,0.818181818,0.818181818,0.272727273,4158
2d289e4e11c55d16193dae370a714848af1c22a2,1,Li Yang,2014-12-02 15:58:44-08:00,['d732388a07ee0b840cc671c3c98037b30b1edad9'],1,2,3,4555222,1,0,0,0,4158
d22eff8f9ad20002bc694b70e7e202bcabb2cc55,0,Li Yang,2014-12-02 16:09:34-08:00,['2d289e4e11c55d16193dae370a714848af1c22a2'],4,9,13,4555235,1,0,0,0,4158
4d7a6c0e30fa3642c0898264fc77c09fd6756cae,1,honma,2014-12-03 09:39:13+08:00,['a35cd332767d7c0e9004477d2be5072caf6aedab'],484,1467,1951,4557186,21,0.717522659,0.832326284,0.909365559,4159
37e45b0311707fc76358d3efd454be012b1fa288,0,qianhao.zhou,2014-12-03 10:58:36+08:00,['ebbc42589aae647e7fb572a89861f097aebe10ae'],4,12,16,4557202,1,0,1,1,4159
37c30d73fc78e4c3e982a0f56c0531896cc63c6a,0,qianhao.zhou,2014-12-03 10:58:42+08:00,"['37e45b0311707fc76358d3efd454be012b1fa288', '8fa88d9a0a61f3741043dd0963924aa00f471c58']",64,21,85,4557287,3,,,,4159
b54c4b56c8c6d536b6741abb36d0b1f52f787b3b,0,shaofengshi,2014-12-03 11:25:28+08:00,['002a4e6a0ceb9c42f6c3c3c7e6d6a84ccec1bea7'],5,5,10,4557297,3,0,1,1,4159
b25ecc686e0bc5d071737552f191b85d2e07a09d,0,shaofengshi,2014-12-03 11:26:56+08:00,"['8fa88d9a0a61f3741043dd0963924aa00f471c58', 'b54c4b56c8c6d536b6741abb36d0b1f52f787b3b']",5,5,10,4557307,3,,,,4159
84bfc335dfe4d29ee816f7a3da06acbdebd870b5,0,Kejia-Wang,2014-12-03 12:46:37+08:00,['9c0c5d9258aa30002321f82387b921c300dd0de0'],43,72,115,4557422,3,0.875,1,0.875,4159
b51ff729b30df71a3b688431463f4012de0ee053,0,Kejia-Wang,2014-12-03 12:51:53+08:00,"['84bfc335dfe4d29ee816f7a3da06acbdebd870b5', 'd22eff8f9ad20002bc694b70e7e202bcabb2cc55']",42,74,116,4557538,9,,,,4159
a295bef791d0a6d16d513b511661f64c0175faba,0,qianhao.zhou,2014-12-03 14:16:22+08:00,"['37c30d73fc78e4c3e982a0f56c0531896cc63c6a', 'b25ecc686e0bc5d071737552f191b85d2e07a09d']",5,5,10,4557548,3,,,,4159
d5cc150989af106ea6de7e378a0b16b1883539f6,1,Zhong Jian,2014-12-03 14:59:05+08:00,['b9173ab25cc949854773df4bc891a31776849960'],20,36,56,4557604,6,0,1,1,4159
b2c6a19c9fb96ebf3932aad53eda8f1e9d5578bb,0,Zhong Jian,2014-12-03 15:03:04+08:00,"['d5cc150989af106ea6de7e378a0b16b1883539f6', 'd22eff8f9ad20002bc694b70e7e202bcabb2cc55']",7405,8016,15421,4573025,38,,,,4159
0db8c81660e594e761ec3c80235717c687248ab7,0,Zhong Jian,2014-12-03 16:03:12+08:00,['b2c6a19c9fb96ebf3932aad53eda8f1e9d5578bb'],14,34,48,4573073,9,0.777777778,0.888888889,0.888888889,4159
43f01d4ec672317a000395aff6606ee6a09cc9c1,1,shaofengshi,2014-12-03 16:10:36+08:00,['b54c4b56c8c6d536b6741abb36d0b1f52f787b3b'],21,48,69,4573142,4,0,0.04,0,4159
808b7b6f9623b5a782056be01f59ed9d7a24ba85,0,shaofengshi,2014-12-03 16:20:08+08:00,"['b25ecc686e0bc5d071737552f191b85d2e07a09d', '43f01d4ec672317a000395aff6606ee6a09cc9c1']",21,48,69,4573211,4,,,,4159
38d08074219c35917eda44019312513cfb6f4abd,0,qianhao.zhou,2014-12-03 16:27:02+08:00,"['a295bef791d0a6d16d513b511661f64c0175faba', '808b7b6f9623b5a782056be01f59ed9d7a24ba85']",21,48,69,4573280,4,,,,4159
74feab391898db82e74c9cc09ea310eb9279044b,1,Kejia-Wang,2014-12-03 16:28:14+08:00,['b51ff729b30df71a3b688431463f4012de0ee053'],67,55,122,4573402,3,0.142857143,0,0.142857143,4159
f4e3b49f2857af1b9a3c89035781013633f409b9,0,Zhong Jian,2014-12-03 16:42:48+08:00,"['d22eff8f9ad20002bc694b70e7e202bcabb2cc55', '74feab391898db82e74c9cc09ea310eb9279044b']",71,88,159,4573561,4,,,,4159
f6c054394cb75c27da1961c9319906175dbc1a71,0,qianhao.zhou,2014-12-03 16:58:11+08:00,['38d08074219c35917eda44019312513cfb6f4abd'],32,94,126,4573687,5,0.113636364,1,0.977272727,4160
ddc75b0ae66760f11794774b319ef86eeeabc91e,0,Zhong Jian,2014-12-03 17:31:10+08:00,['0db8c81660e594e761ec3c80235717c687248ab7'],9,20,29,4573716,4,1,1,1,4160
2c1acba7f915a45e51590698d8effccb12e7ca43,0,Kejia-Wang,2014-12-03 17:31:30+08:00,['74feab391898db82e74c9cc09ea310eb9279044b'],5,10,15,4573731,1,,,,4160
0514b9e78e9d2520f823926af74ed1a354506ad4,0,honma,2014-12-03 17:39:17+08:00,['4d7a6c0e30fa3642c0898264fc77c09fd6756cae'],104,328,432,4574163,12,0.714285714,1,1,4161
699ad3fa0408cf0ad828ee2d6eaa9f22a883e3ce,0,qianhao.zhou,2014-12-03 17:41:37+08:00,['f6c054394cb75c27da1961c9319906175dbc1a71'],29,28,57,4574220,11,0,0,0,4161
e0a863a95fccdddf8a5e5f288d625bf4eaa3d49e,0,qianhao.zhou,2014-12-03 17:42:39+08:00,"['808b7b6f9623b5a782056be01f59ed9d7a24ba85', '699ad3fa0408cf0ad828ee2d6eaa9f22a883e3ce']",65,134,199,4574419,17,,,,4161
12d9cd933a7f2d617ebad83cd8bf9909520ca393,0,Zhong Jian,2014-12-03 19:36:05+08:00,['ddc75b0ae66760f11794774b319ef86eeeabc91e'],30,19,49,4574468,6,0.428571429,0,0,4161
7e06e783452d81b920ddc8fddd1a4084a9482625,0,Zhong Jian,2014-12-03 19:42:00+08:00,"['12d9cd933a7f2d617ebad83cd8bf9909520ca393', 'f4e3b49f2857af1b9a3c89035781013633f409b9']",71,88,159,4574627,4,,,,4161
d6f697abffd6be3b2b75829a12a0cdb5d1142962,0,Zhong Jian,2014-12-03 19:59:15+08:00,['7e06e783452d81b920ddc8fddd1a4084a9482625'],2,181,183,4574810,5,0.904761905,0.873015873,0.952380952,4164
2cfac9b349b4fc20e0e30d28fa1bbb1037136ca1,0,Li Yang,2014-12-03 15:11:29-08:00,['f4e3b49f2857af1b9a3c89035781013633f409b9'],1,1,2,4574812,1,,,,4164
41393a546ea5792cab27df677e7e626860029b3e,0,unknown,2014-12-03 23:12:45+00:00,"['2cfac9b349b4fc20e0e30d28fa1bbb1037136ca1', '9cc120869a7388252818bb4b29db7a81be1527ab']",1,1,2,4574814,1,,,,4164
285730b0f661bb480bca93676a2304fbaee8a0cd,0,Luke Han,2014-12-03 16:06:17-08:00,['41393a546ea5792cab27df677e7e626860029b3e'],12,12,24,4574838,11,,,,4164
bebf566ed1586d02931c8c9f14428e68eac72396,0,Luke Han,2014-12-03 16:06:20-08:00,['285730b0f661bb480bca93676a2304fbaee8a0cd'],12,12,24,4574862,11,,,,4164
19d0c284650735ac9af07e874cda20ad06658964,0,Luke Han,2014-12-03 16:54:31-08:00,['bebf566ed1586d02931c8c9f14428e68eac72396'],11,11,22,4574884,11,,,,4164
41b60ec76978f60badc44b115be6ef03e6d34d06,0,Kejia-Wang,2014-12-04 10:49:31+08:00,"['2c1acba7f915a45e51590698d8effccb12e7ca43', '41393a546ea5792cab27df677e7e626860029b3e']",2,2,4,4574888,2,,,,4164
ceab9ca8a662f48933a463e2c68c1b0fe09df648,0,qianhao.zhou,2014-12-04 11:18:11+08:00,['e0a863a95fccdddf8a5e5f288d625bf4eaa3d49e'],131,161,292,4575180,27,0.962962963,1,1,4165
2d5bfe7b27eb234dc65f686830f5b0c239acf589,0,qianhao.zhou,2014-12-04 11:20:44+08:00,"['e0a863a95fccdddf8a5e5f288d625bf4eaa3d49e', 'ceab9ca8a662f48933a463e2c68c1b0fe09df648']",131,161,292,4575472,27,,,,4165
47936fadca3dc360ed05186fb1e387c65198fce6,0,shaofengshi,2014-12-04 11:21:38+08:00,['e0a863a95fccdddf8a5e5f288d625bf4eaa3d49e'],35,97,132,4575604,3,0.071428571,0.071428571,0.333333333,4165
bb1327c47eba98f672ac8ae9a43199ad433e1e79,0,shaofengshi,2014-12-04 11:25:40+08:00,"['47936fadca3dc360ed05186fb1e387c65198fce6', '2d5bfe7b27eb234dc65f686830f5b0c239acf589']",129,159,288,4575892,27,,,,4165
002bbae5ace0c6e9bfe66359c520bbef986e2a32,0,shaofengshi,2014-12-04 11:27:25+08:00,"['2d5bfe7b27eb234dc65f686830f5b0c239acf589', 'bb1327c47eba98f672ac8ae9a43199ad433e1e79']",35,97,132,4576024,3,,,,4165
fd2490b6885c4c31dbd7b4b647c182323e150e17,0,Kejia-Wang,2014-12-04 11:32:03+08:00,['41b60ec76978f60badc44b115be6ef03e6d34d06'],9,10,19,4576043,1,,,,4165
16e08b3d35266b792182e6716b02105fdae63e7d,1,Zhong Jian,2014-12-04 14:34:21+08:00,['d6f697abffd6be3b2b75829a12a0cdb5d1142962'],6,5,11,4576054,3,,,,4165
68d4793b3a2120674619d3c42b2a49d83a10ee74,1,qianhao.zhou,2014-12-04 17:06:12+08:00,['002bbae5ace0c6e9bfe66359c520bbef986e2a32'],15,15,30,4576084,5,0.666666667,1,1,4165
3f554d2ec57b801565885540473f0410f6d00525,0,honma,2014-12-04 17:29:31+08:00,['0514b9e78e9d2520f823926af74ed1a354506ad4'],56,147,203,4576287,8,0.692307692,0.107692308,0.815384615,4165
ea34d804cddfa0900d32047edae7902793b9e27e,1,qianhao.zhou,2014-12-04 17:34:39+08:00,['68d4793b3a2120674619d3c42b2a49d83a10ee74'],33,50,83,4576370,9,0.454545455,1,0,4166
900677d6836337dd18cb843719f3e4c345cee93d,0,honma,2014-12-04 18:43:28+08:00,['3f554d2ec57b801565885540473f0410f6d00525'],58,83,141,4576511,6,0,1,0,4166
afa21e2a17e64947f48178b720539c31208968a4,1,shaofengshi,2014-12-04 19:42:42+08:00,['002bbae5ace0c6e9bfe66359c520bbef986e2a32'],101,120,221,4576732,10,0.621621622,0.648648649,0.945945946,4166
254749437dcecc28cd3e02b30617ec20ca0e9738,0,shaofengshi,2014-12-04 20:58:26+08:00,"['002bbae5ace0c6e9bfe66359c520bbef986e2a32', 'afa21e2a17e64947f48178b720539c31208968a4']",101,120,221,4576953,10,,,,4166
a5d2ded4ac6f86fbfbe5f8af2842ba3bb1cb7041,1,Zhong Jian,2014-12-04 22:02:04+08:00,['16e08b3d35266b792182e6716b02105fdae63e7d'],126,267,393,4577346,14,1,1,0.99047619,4166
ebdcd47cc343a1fbccb3edfc6fde6745c838ac04,0,Luke Han,2014-12-04 06:36:30-08:00,['19d0c284650735ac9af07e874cda20ad06658964'],12,12,24,4577370,11,,,,4166
d68d0985ee70c09f2dbf5c9cbcbf39d7eae31496,1,Zhong Jian,2014-12-04 22:36:57+08:00,['a5d2ded4ac6f86fbfbe5f8af2842ba3bb1cb7041'],135,4884,5019,4582389,62,0.817460317,0.745535714,0.881944444,4215
5778c22933da9996c7668985bee28919649e2793,1,Luke Han,2014-12-04 06:40:30-08:00,['ebdcd47cc343a1fbccb3edfc6fde6745c838ac04'],12,12,24,4582413,11,,,,4215
f0c15962239b07173b8abd0a91d15baf5894acf1,0,Zhong Jian,2014-12-04 22:41:23+08:00,['d68d0985ee70c09f2dbf5c9cbcbf39d7eae31496'],23,4,27,4582440,1,0.166666667,0,0,4215
8d9314c5c2941ee7b5a9017d3cafb1813ce4d35a,0,Zhong Jian,2014-12-04 22:44:23+08:00,"['41393a546ea5792cab27df677e7e626860029b3e', 'f0c15962239b07173b8abd0a91d15baf5894acf1']",161,5283,5444,4587884,83,,,,4215
6de05428744964981ebaed6c195a448ddd083fdd,0,Luke Han,2014-12-04 06:46:35-08:00,['5778c22933da9996c7668985bee28919649e2793'],11,11,22,4587906,11,,,,4215
a4e11ea9114fe9b779ae297dd1218e95ff305996,0,Zhong Jian,2014-12-04 22:53:12+08:00,['f0c15962239b07173b8abd0a91d15baf5894acf1'],0,1870,1870,4589776,7,0.579423868,0.705349794,0.596707819,4222
45e5ace93c2739c9da6e786d7067517cd69cfa05,0,Zhong Jian,2014-12-04 22:59:02+08:00,"['8d9314c5c2941ee7b5a9017d3cafb1813ce4d35a', 'a4e11ea9114fe9b779ae297dd1218e95ff305996']",0,1870,1870,4591646,7,,,,4222
c8a97885d2f819b65767e79282b64dc1aa455625,0,abansal,2014-12-04 11:16:53-08:00,['6de05428744964981ebaed6c195a448ddd083fdd'],3,10,13,4591659,1,,,,4222
9f23a00f19ff924340158395410ce8f5cde35a87,0,Ankur Bansal,2014-12-04 11:47:29-08:00,['c8a97885d2f819b65767e79282b64dc1aa455625'],4,10,14,4591673,1,,,,4222
9ce493b120ab0dbfccfceedc450be91338157eaa,0,Ankur Bansal,2014-12-04 11:54:48-08:00,['9f23a00f19ff924340158395410ce8f5cde35a87'],2,7,9,4591682,1,,,,4222
a9b0d1be55734a74c5321939f76c63c08925b77c,0,Li Yang,2014-12-04 14:06:45-08:00,"['6de05428744964981ebaed6c195a448ddd083fdd', '9ce493b120ab0dbfccfceedc450be91338157eaa']",4,22,26,4591708,1,,,,4222
163f4cb8d0de7d8bef19411a1126c45a37ed5b37,0,qianhao.zhou,2014-12-05 09:33:44+08:00,"['ea34d804cddfa0900d32047edae7902793b9e27e', '254749437dcecc28cd3e02b30617ec20ca0e9738']",101,120,221,4591929,10,,,,4222
bc7eca5c6f671b61de3eed846b2faf1852a06ed3,0,qianhao.zhou,2014-12-05 09:35:30+08:00,"['254749437dcecc28cd3e02b30617ec20ca0e9738', '163f4cb8d0de7d8bef19411a1126c45a37ed5b37']",47,64,111,4592040,11,,,,4222
43b0b2b01726ff9b942d5670d99dc81584cf62b3,0,shaofengshi,2014-12-05 10:04:10+08:00,['254749437dcecc28cd3e02b30617ec20ca0e9738'],61,53,114,4592154,7,0.84,0.84,0.68,4222
33c0137c2c3a280c039715a5a515ac33bd276597,0,shaofengshi,2014-12-05 10:04:29+08:00,"['43b0b2b01726ff9b942d5670d99dc81584cf62b3', 'bc7eca5c6f671b61de3eed846b2faf1852a06ed3']",47,64,111,4592265,11,,,,4222
0342a8256872750e463a95e4e358451c779abc7b,0,qianhao.zhou,2014-12-05 10:08:08+08:00,['163f4cb8d0de7d8bef19411a1126c45a37ed5b37'],2,2,4,4592269,1,,,,4222
2469d345c8b3ccef19e2db3057b0f484cc2498da,0,qianhao.zhou,2014-12-05 10:08:42+08:00,"['bc7eca5c6f671b61de3eed846b2faf1852a06ed3', '0342a8256872750e463a95e4e358451c779abc7b']",2,2,4,4592273,1,,,,4222
e6bdc4017316e58ad3640dbef2946e31806ca51d,0,shaofengshi,2014-12-05 10:08:54+08:00,"['33c0137c2c3a280c039715a5a515ac33bd276597', '2469d345c8b3ccef19e2db3057b0f484cc2498da']",2,2,4,4592277,1,,,,4222
147e6d910e2ddacd1b6dafe7104e379c2345d95e,0,Zhong Jian,2014-12-05 11:08:53+08:00,['45e5ace93c2739c9da6e786d7067517cd69cfa05'],1521,18,1539,4593816,36,0,0.163859112,0.179173047,4222
5cb8a6085b9c1bed64ed5433367e62ae51baab83,0,Zhong Jian,2014-12-05 11:10:37+08:00,"['45e5ace93c2739c9da6e786d7067517cd69cfa05', '147e6d910e2ddacd1b6dafe7104e379c2345d95e']",1521,18,1539,4595355,36,,,,4222
8d57b5bfbdbc1431c749fa29d5ccfba1497730f1,0,Zhong Jian,2014-12-05 11:59:35+08:00,['147e6d910e2ddacd1b6dafe7104e379c2345d95e'],0,3,3,4595358,1,,,,4222
372789209b9f7ffa5375f3c192d70de0e9da40a3,0,Zhong Jian,2014-12-05 12:00:57+08:00,"['5cb8a6085b9c1bed64ed5433367e62ae51baab83', '8d57b5bfbdbc1431c749fa29d5ccfba1497730f1']",0,3,3,4595361,1,,,,4222
cb50806ebafd7cb9ee61ff7a0151594ffd66e110,1,shaofengshi,2014-12-05 13:03:09+08:00,['e6bdc4017316e58ad3640dbef2946e31806ca51d'],7,16,23,4595384,3,0,1,1,4222
65384597b681414ca8c212f97255d6fb96f6c647,0,shaofengshi,2014-12-05 13:04:43+08:00,"['2469d345c8b3ccef19e2db3057b0f484cc2498da', 'cb50806ebafd7cb9ee61ff7a0151594ffd66e110']",68,69,137,4595521,10,,,,4222
a7a4e5239b48fe83a62f4222026481c0135edf11,0,Zhong Jian,2014-12-05 13:46:04+08:00,['8d57b5bfbdbc1431c749fa29d5ccfba1497730f1'],0,5,5,4595526,1,0.4,1,0.4,4222
739ab9e7f1c374eb7ec48300c465327ac4473a8b,0,honma,2014-12-05 15:01:33+08:00,['65384597b681414ca8c212f97255d6fb96f6c647'],1,1,2,4595528,1,,,,4222
96133f778171aa65dd582244cd2a55e24cd8e591,0,Zhong Jian,2014-12-05 15:25:44+08:00,['a7a4e5239b48fe83a62f4222026481c0135edf11'],33,43,76,4595604,4,1,1,1,4222
79662f88624b08238378fc5ca569954e2ddcb308,0,Zhong Jian,2014-12-05 15:30:04+08:00,"['372789209b9f7ffa5375f3c192d70de0e9da40a3', '96133f778171aa65dd582244cd2a55e24cd8e591']",33,48,81,4595685,5,,,,4222
342556f020486bebdf2bb93908cc9095382e041f,0,honma,2014-12-05 15:46:32+08:00,['739ab9e7f1c374eb7ec48300c465327ac4473a8b'],7,22,29,4595714,4,0.333333333,0.333333333,1,4222
651574862edbac95dd9101c20508b2613e55f72d,0,honma,2014-12-05 17:03:18+08:00,['900677d6836337dd18cb843719f3e4c345cee93d'],3,2,5,4595719,2,,,,4222
d6ab76c2a9c987136e4c42e3e97ea247442d1209,0,qianhao.zhou,2014-12-05 17:38:39+08:00,['65384597b681414ca8c212f97255d6fb96f6c647'],0,46,46,4595765,3,,,,4222
67cc6e74ff28915f7ac745472a919b4a0fae030e,0,qianhao.zhou,2014-12-05 17:53:05+08:00,['d6ab76c2a9c987136e4c42e3e97ea247442d1209'],1,56,57,4595822,2,1,1,1,4223
a1987965f87f57900aba7ba7af72f65255327550,0,qianhao.zhou,2014-12-05 17:55:05+08:00,"['67cc6e74ff28915f7ac745472a919b4a0fae030e', '342556f020486bebdf2bb93908cc9095382e041f']",7,22,29,4595851,4,,,,4223
ef17a810dac0c93bb59fd5a689b37142e528579f,0,shaofengshi,2014-12-05 18:02:08+08:00,['342556f020486bebdf2bb93908cc9095382e041f'],125,127,252,4596103,9,,,,4223
cad5820a4459b9d5ab2d430caf1b72aa1fd7faea,0,shaofengshi,2014-12-05 18:05:09+08:00,"['342556f020486bebdf2bb93908cc9095382e041f', 'ef17a810dac0c93bb59fd5a689b37142e528579f']",125,127,252,4596355,9,,,,4223
8ae82642ba25ac649ae19c1394f99453d7d20633,0,qianhao.zhou,2014-12-05 18:05:41+08:00,"['cad5820a4459b9d5ab2d430caf1b72aa1fd7faea', 'a1987965f87f57900aba7ba7af72f65255327550']",1,102,103,4596458,5,,,,4223
6a6d58c611770c8f7b860d0d6f20d19945d8cedc,1,Zhong Jian,2014-12-05 18:27:34+08:00,['96133f778171aa65dd582244cd2a55e24cd8e591'],8,24,32,4596490,2,1,1,1,4223
4739480e506337caa16d208b66bc628656fd543f,0,honma,2014-12-08 09:49:35+08:00,['651574862edbac95dd9101c20508b2613e55f72d'],223,138,361,4596851,15,0.3,1,0.18,4227
ef3d7d262c1138acb60e30e384d5e7c1e70230c3,1,honma,2014-12-08 10:13:50+08:00,['4739480e506337caa16d208b66bc628656fd543f'],5,10,15,4596866,1,0,1,0.25,4227
7259df1f8fef57b06b5a34ba2df6c7dc637de38b,0,qianhao.zhou,2014-12-08 11:18:11+08:00,"['8ae82642ba25ac649ae19c1394f99453d7d20633', 'a9b0d1be55734a74c5321939f76c63c08925b77c']",7432,8021,15453,4612319,35,,,,4227
9dc8ebb9702091d05881a9a93d2b30a016cf7d81,0,shaofengshi,2014-12-08 13:09:58+08:00,['ef17a810dac0c93bb59fd5a689b37142e528579f'],132,150,282,4612601,94,0.866666667,1,1,4227
178a0f03b0a4692c19f3d9c81ac298a75d8aa330,0,shaofengshi,2014-12-08 13:11:37+08:00,"['8ae82642ba25ac649ae19c1394f99453d7d20633', '9dc8ebb9702091d05881a9a93d2b30a016cf7d81']",132,150,282,4612883,94,,,,4227
798b4b160ede247fb7eb8ac4d1baac1a72fd31c7,0,qianhao.zhou,2014-12-08 13:32:36+08:00,"['7259df1f8fef57b06b5a34ba2df6c7dc637de38b', '178a0f03b0a4692c19f3d9c81ac298a75d8aa330']",132,150,282,4613165,94,,,,4227
97aed9fab6a3f596228acdeb570ae3340cf2ebaa,0,qianhao.zhou,2014-12-08 15:34:54+08:00,['798b4b160ede247fb7eb8ac4d1baac1a72fd31c7'],11,578,589,4613754,8,0.872274143,1,0.794392523,4231
eedbb31395b627ca21986c6469f9883a48bd4c77,0,qianhao.zhou,2014-12-08 15:38:48+08:00,"['178a0f03b0a4692c19f3d9c81ac298a75d8aa330', '97aed9fab6a3f596228acdeb570ae3340cf2ebaa']",7443,8599,16042,4629796,43,,,,4231
6d979be0832faa53a4211d9a7d37bab602bba94f,0,qianhao.zhou,2014-12-08 16:29:52+08:00,['eedbb31395b627ca21986c6469f9883a48bd4c77'],280,25,305,4630101,8,0,0,0.1484375,4231
221e95ee783311c630b13a5556a6ffe3411c3234,0,honma,2014-12-08 16:30:46+08:00,['ef3d7d262c1138acb60e30e384d5e7c1e70230c3'],27,94,121,4630222,10,1,1,0.913043478,4233
5cd5e9750865456900cae37dea62f9267ec5f54a,0,Zhong Jian,2014-12-08 16:38:08+08:00,['6a6d58c611770c8f7b860d0d6f20d19945d8cedc'],12,22,34,4630256,11,1,1,1,4233
1ea54c57b54fda863c7afe5935b146b6a5743858,0,Zhong Jian,2014-12-08 16:41:10+08:00,['6a6d58c611770c8f7b860d0d6f20d19945d8cedc'],12,22,34,4630290,11,1,1,1,4233
90f9f57d89c8aeb1c42777be9d795d1c70f98d18,0,Zhong Jian,2014-12-08 16:42:39+08:00,"['1ea54c57b54fda863c7afe5935b146b6a5743858', '5cd5e9750865456900cae37dea62f9267ec5f54a']",0,0,0,4630290,0,,,,4233
65ee5443c1b738d40c2020ed8f87fb61be0d9334,0,qianhao.zhou,2014-12-08 16:43:51+08:00,['6d979be0832faa53a4211d9a7d37bab602bba94f'],36,31,67,4630357,20,,,,4233
77b8e8e9b30088c28772f698956a42833b873eb5,0,Zhong Jian,2014-12-08 16:52:26+08:00,"['79662f88624b08238378fc5ca569954e2ddcb308', '90f9f57d89c8aeb1c42777be9d795d1c70f98d18']",20,46,66,4630423,12,,,,4233
e469eb1d98b7c08577ae659b865327d7ee761d55,0,qianhao.zhou,2014-12-08 17:20:38+08:00,['65ee5443c1b738d40c2020ed8f87fb61be0d9334'],33,40,73,4630496,10,1,1,0.428571429,4233
5cfdc6e1f35edb114cbf34bd4f7a3051623b1220,0,qianhao.zhou,2014-12-08 17:44:48+08:00,['e469eb1d98b7c08577ae659b865327d7ee761d55'],62,106,168,4630664,14,0,0.966666667,1,4233
3285d6d426c9b2d733761407c7b34c9317e9fa8d,0,qianhao.zhou,2014-12-08 18:02:38+08:00,"['eedbb31395b627ca21986c6469f9883a48bd4c77', '5cfdc6e1f35edb114cbf34bd4f7a3051623b1220']",407,198,605,4631269,36,,,,4233
bbad35c64ceb4b4236f7e9638f6a6dc5bde45b6d,1,shaofengshi,2014-12-08 18:13:05+08:00,['8d3b644c1af4ecf959035931fda184f14009cd9b'],1,228,229,4631498,3,0.182539683,0.349206349,1,4234
60c05648260c07ca414b0c8925097f404dfedb5f,1,Zhong Jian,2014-12-08 18:48:52+08:00,['5cd5e9750865456900cae37dea62f9267ec5f54a'],1,1,2,4631500,1,,,,4234
8e74e553d38b0bac6629f4ff3e1492731bff535f,0,Zhong Jian,2014-12-09 10:27:50+08:00,['60c05648260c07ca414b0c8925097f404dfedb5f'],9,9,18,4631518,3,1,1,1,4234
7d9dbf95e444f18134705e5f4723b8c6c47c2cc7,0,Zhong Jian,2014-12-09 10:28:29+08:00,"['8e74e553d38b0bac6629f4ff3e1492731bff535f', '90f9f57d89c8aeb1c42777be9d795d1c70f98d18']",0,0,0,4631518,0,,,,4234
4fd1a55147f7331574365ed242c0310f2cda1e83,0,Zhong Jian,2014-12-09 10:30:13+08:00,"['77b8e8e9b30088c28772f698956a42833b873eb5', '7d9dbf95e444f18134705e5f4723b8c6c47c2cc7']",10,10,20,4631538,4,,,,4234
fa40129ed93c9bf6ead43900034a566e13872e85,0,shaofengshi,2014-12-09 10:33:01+08:00,['3285d6d426c9b2d733761407c7b34c9317e9fa8d'],0,5,5,4631543,1,0,1,1,4234
e6550241c0fa9bec6eb9ca312e8d7e6fee0ec696,0,shaofengshi,2014-12-09 10:52:42+08:00,['bbad35c64ceb4b4236f7e9638f6a6dc5bde45b6d'],24,34,58,4631601,2,0.28125,0.28125,1,4235
a62df1daf036179364494e04021eb08292d22a1a,0,shaofengshi,2014-12-09 11:16:08+08:00,"['e6550241c0fa9bec6eb9ca312e8d7e6fee0ec696', 'fa40129ed93c9bf6ead43900034a566e13872e85']",11727,15198,26925,4658526,427,,,,4235
d29545652d7cfaa344180a359b6f5d6788a98fa5,1,qianhao.zhou,2014-12-09 11:38:06+08:00,['5cfdc6e1f35edb114cbf34bd4f7a3051623b1220'],235,79,314,4658840,7,0.297029703,0,0.435643564,4235
8c3f4931cada86a44f08540cb9e93441778806ff,0,qianhao.zhou,2014-12-09 11:51:47+08:00,"['d29545652d7cfaa344180a359b6f5d6788a98fa5', '3285d6d426c9b2d733761407c7b34c9317e9fa8d']",0,0,0,4658840,0,,,,4235
412fcbd89376d50b4ca7eeb2dc039c9b719b82cf,0,Zhong Jian,2014-12-09 12:44:29+08:00,['7d9dbf95e444f18134705e5f4723b8c6c47c2cc7'],5,8,13,4658853,2,0,0,1,4235
d391839d0ae268b761a3c5ea98c0d10bd43c9bea,0,Zhong Jian,2014-12-09 12:46:19+08:00,"['4fd1a55147f7331574365ed242c0310f2cda1e83', '412fcbd89376d50b4ca7eeb2dc039c9b719b82cf']",5,8,13,4658866,2,,,,4235
d5ca946b305bf4152a9cca97f474871180d5a8c1,0,qianhao.zhou,2014-12-09 14:39:56+08:00,"['3285d6d426c9b2d733761407c7b34c9317e9fa8d', '8c3f4931cada86a44f08540cb9e93441778806ff']",235,79,314,4659180,7,,,,4235
07c2715d80b3b0de0a63e3b54662f74f24434aee,1,honma,2014-12-09 17:17:10+08:00,['221e95ee783311c630b13a5556a6ffe3411c3234'],48,173,221,4659401,15,0.5,0.806451613,0.983870968,4241
4252629b2991f6560e9b37b8225925e55ce75889,0,honma,2014-12-09 17:50:39+08:00,['07c2715d80b3b0de0a63e3b54662f74f24434aee'],112,134,246,4659647,1,1,1,0.25,4241
23c58d39f546098b945bc06c3087794538369617,1,qianhao.zhou,2014-12-09 20:16:02+08:00,['d5ca946b305bf4152a9cca97f474871180d5a8c1'],17,46,63,4659710,2,0.363636364,1,1,4241
c318b58bb88738a344031d0f6bac81597c53bd06,0,qianhao.zhou,2014-12-09 20:36:14+08:00,"['d5ca946b305bf4152a9cca97f474871180d5a8c1', '23c58d39f546098b945bc06c3087794538369617']",17,46,63,4659773,2,,,,4241
dd009ce9d5c0dbc6a7e7bfc9ac39f740598b176f,0,Zhong Jian,2014-12-09 21:50:20+08:00,['412fcbd89376d50b4ca7eeb2dc039c9b719b82cf'],23,2567,2590,4662363,32,0.391373802,0.501597444,1,4262
3c2017c7fc2bc9eb1ffea72e637ab731462af0c6,0,Zhong Jian,2014-12-09 21:59:56+08:00,"['d391839d0ae268b761a3c5ea98c0d10bd43c9bea', 'dd009ce9d5c0dbc6a7e7bfc9ac39f740598b176f']",23,2567,2590,4664953,32,,,,4262
15d758b596e78a7dbb20d81cc821631dc0e3211b,0,honma,2014-12-10 10:28:41+08:00,['4252629b2991f6560e9b37b8225925e55ce75889'],30,66,96,4665049,9,0.208333333,0.916666667,1,4264
7d1004a2afb9688e84373db44bc45a6a2db2ccca,0,qianhao.zhou,2014-12-10 10:36:21+08:00,"['a9b0d1be55734a74c5321939f76c63c08925b77c', '42ed8b730be7b797cd29d8382d357c268772dfeb']",3573,5694,9267,4674316,371,,,,4264
42ed8b730be7b797cd29d8382d357c268772dfeb,0,qianhao.zhou,2014-12-10 10:36:40+08:00,['23c58d39f546098b945bc06c3087794538369617'],8,7,15,4674331,1,1,0,0,4264
e3a06a7fc1ba785b666210cc15fc5613983cafc1,0,honma,2014-12-10 11:08:19+08:00,['15d758b596e78a7dbb20d81cc821631dc0e3211b'],6,11,17,4674348,2,1,1,1,4264
b0228f47cc6e949990dfb836eb8288d89383b75a,0,honma,2014-12-10 11:30:43+08:00,['e3a06a7fc1ba785b666210cc15fc5613983cafc1'],12,15,27,4674375,3,0,0,0,4264
069f74720d3bac274c365b60ed8c79820b863bde,0,Zhong Jian,2014-12-10 12:41:13+08:00,['dd009ce9d5c0dbc6a7e7bfc9ac39f740598b176f'],9,12,21,4674396,4,1,1,1,4264
70e91466e5f0cde2d98c4edeaf522e1ce310ab7a,0,honma,2014-12-10 12:51:15+08:00,['c318b58bb88738a344031d0f6bac81597c53bd06'],1,5,6,4674402,1,1,1,1,4264
ad619c397d2dda47804baf2965347f56f182c429,1,honma,2014-12-10 12:52:15+08:00,['70e91466e5f0cde2d98c4edeaf522e1ce310ab7a'],60,147,207,4674609,6,0,1,0.984375,4264
adde1c1815fd2619c75a47e9614ac4e63a69c42e,0,honma,2014-12-10 12:54:21+08:00,['ad619c397d2dda47804baf2965347f56f182c429'],558,1528,2086,4676695,21,0.717522659,0.832326284,0.909365559,4265
105a7cab20c717ca2dad584884f4b39c56bbd2cb,0,honma,2014-12-10 12:54:21+08:00,['adde1c1815fd2619c75a47e9614ac4e63a69c42e'],104,328,432,4677127,12,0.714285714,1,1,4266
ff19ff83202f890bf8f320aafbcdb52e12021acb,1,honma,2014-12-10 12:54:21+08:00,['105a7cab20c717ca2dad584884f4b39c56bbd2cb'],56,147,203,4677330,8,0.692307692,0.107692308,0.815384615,4266
fe07a77804875069718ed69e1baa8564c861fc80,0,honma,2014-12-10 12:54:21+08:00,['ff19ff83202f890bf8f320aafbcdb52e12021acb'],58,83,141,4677471,6,0,1,0,4266
c10c6be089ea7755681379a839382d471f6a1e51,0,Zhong Jian,2014-12-10 12:58:00+08:00,"['3c2017c7fc2bc9eb1ffea72e637ab731462af0c6', '069f74720d3bac274c365b60ed8c79820b863bde']",9,12,21,4677492,4,,,,4266
91638ed22af04725c4f0f655736711260a499c21,0,honma,2014-12-10 13:05:46+08:00,"['fe07a77804875069718ed69e1baa8564c861fc80', 'b0228f47cc6e949990dfb836eb8288d89383b75a']",411,731,1142,4678634,39,,,,4266
c1de7c70abbad6d8a74d3cf08d2cecda0b55e75a,1,Zhong Jian,2014-12-10 16:48:47+08:00,['069f74720d3bac274c365b60ed8c79820b863bde'],14,10,24,4678658,5,0,0,0,4266
57a5deec927e690fd7b5e4de13fe0bbc853bcb74,1,shaofengshi,2014-12-10 18:36:20+08:00,['a62df1daf036179364494e04021eb08292d22a1a'],264,504,768,4679426,23,0.226851852,0.810185185,1,4268
a8935956340c013c07d50f2b36766be6ca9bb76b,0,shaofengshi,2014-12-10 18:44:37+08:00,['57a5deec927e690fd7b5e4de13fe0bbc853bcb74'],8,123,131,4679557,2,0.540983607,1,1,4268
ab7c7fcfeb1bbf3b7c3e0fb085ed35e2717af881,0,shaofengshi,2014-12-11 09:24:13+08:00,"['c318b58bb88738a344031d0f6bac81597c53bd06', 'fa40129ed93c9bf6ead43900034a566e13872e85']",0,5,5,4679562,1,,,,4268
e34ee8eccf793e1e80a2d87a0568369a79311490,0,shaofengshi,2014-12-11 09:26:50+08:00,"['812c9d1a232c0daa6b075b30f2ed118424679b5e', 'a8935956340c013c07d50f2b36766be6ca9bb76b']",11636,54228,65864,4745426,688,,,,4268
dcca0e672181a6fb2694aee1bdf9bda1af80e0d0,0,qianhao.zhou,2014-12-11 09:34:49+08:00,"['42ed8b730be7b797cd29d8382d357c268772dfeb', 'ab7c7fcfeb1bbf3b7c3e0fb085ed35e2717af881']",0,5,5,4745431,1,,,,4268
5d08ea67a6af205452019bbee8cb4017b2b7fe7f,1,honma,2014-12-11 10:40:48+08:00,['91638ed22af04725c4f0f655736711260a499c21'],939,2274,3213,4748644,198,0.813874788,0.886632826,0.96108291,4274
9d754a0d259a9516f252925225c781f4563dc6cc,0,shaofengshi,2014-12-11 11:14:08+08:00,['e34ee8eccf793e1e80a2d87a0568369a79311490'],1,1,2,4748646,1,,,,4274
460d3c371117c4142601663e275147041b134d02,0,shaofengshi,2014-12-11 11:15:32+08:00,"['9d754a0d259a9516f252925225c781f4563dc6cc', 'ab7c7fcfeb1bbf3b7c3e0fb085ed35e2717af881']",251,125,376,4749022,9,,,,4274
5c922601522446dfb673ec6fac5e52924fe9ea00,0,qianhao.zhou,2014-12-11 14:20:02+08:00,['dcca0e672181a6fb2694aee1bdf9bda1af80e0d0'],25,28,53,4749075,1,1,1,1,4274
beeaf51956eb8b8a27e29887a6f73184549bdf4c,0,qianhao.zhou,2014-12-11 14:21:08+08:00,"['ab7c7fcfeb1bbf3b7c3e0fb085ed35e2717af881', '5c922601522446dfb673ec6fac5e52924fe9ea00']",28,30,58,4749133,1,,,,4274
bb7f6ac0223b5c54a06892980d0c1bc6331c2098,0,Zhong Jian,2014-12-11 14:22:53+08:00,['c1de7c70abbad6d8a74d3cf08d2cecda0b55e75a'],2,1,3,4749136,1,0,0,0,4274
963818cd44681cd112330d773d4cbed00ce108e8,1,cxiao,2014-12-11 17:18:02+08:00,['c10c6be089ea7755681379a839382d471f6a1e51'],8,35,43,4749179,2,1,1,1,4274
fd57b78ce1d1697276db5c382e4af64b8931e848,0,Zhong Jian,2014-12-11 17:18:20+08:00,['bb7f6ac0223b5c54a06892980d0c1bc6331c2098'],3303,64,3367,4752546,32,0.516605166,0.398523985,0.011070111,4274
5ca31bd14079f04f9d7b2aaa2a29308b3c12338b,0,cxiao,2014-12-11 17:24:52+08:00,['963818cd44681cd112330d773d4cbed00ce108e8'],1,1,2,4752548,1,,,,4274
cb8780ecfcee0adca8b1689c247ffdad8eb1ff54,0,Zhong Jian,2014-12-11 17:27:10+08:00,['fd57b78ce1d1697276db5c382e4af64b8931e848'],1,1,2,4752550,1,,,,4274
1498aa1a4bf55e708c79d29f039f0bba6bb21e85,0,Zhong Jian,2014-12-11 17:28:06+08:00,"['c10c6be089ea7755681379a839382d471f6a1e51', 'cb8780ecfcee0adca8b1689c247ffdad8eb1ff54']",3317,73,3390,4755940,36,,,,4274
aef3d2e925704eed2338fe4e760834f55cf867d5,0,cxiao,2014-12-11 17:30:11+08:00,"['5ca31bd14079f04f9d7b2aaa2a29308b3c12338b', '1498aa1a4bf55e708c79d29f039f0bba6bb21e85']",3317,73,3390,4759330,36,,,,4274
a42a31dc6daf87d8d426bc409a9d9742d7757cdb,0,Zhong Jian,2014-12-11 18:29:13+08:00,"['1498aa1a4bf55e708c79d29f039f0bba6bb21e85', '5ca31bd14079f04f9d7b2aaa2a29308b3c12338b']",9,36,45,4759375,2,,,,4274
69237e3f80dd7c8300cd73aac3e7e82c9ed9655a,1,Zhong Jian,2014-12-11 19:29:10+08:00,['a42a31dc6daf87d8d426bc409a9d9742d7757cdb'],21,270,291,4759666,13,0.950757576,1,1,4274
f3d75b8983a556873203bc614eb7d7c43bf43dfe,0,shaofengshi,2014-12-12 10:12:27+08:00,['460d3c371117c4142601663e275147041b134d02'],3,12,15,4759681,2,0,1,1,4274
c3c12ed8b9a2972b1dbad30e449c11f78f95a69e,0,cxiao,2014-12-12 10:22:17+08:00,"['aef3d2e925704eed2338fe4e760834f55cf867d5', 'a42a31dc6daf87d8d426bc409a9d9742d7757cdb']",0,0,0,4759681,0,,,,4274
25345957ebf13fd7c3aa886a3acaef8381d4f489,0,Zhong Jian,2014-12-12 10:28:39+08:00,"['a42a31dc6daf87d8d426bc409a9d9742d7757cdb', '69237e3f80dd7c8300cd73aac3e7e82c9ed9655a']",21,270,291,4759972,13,,,,4274
e5f34ddfd06015dbc473011445229389f9a9810b,1,Zhong Jian,2014-12-12 15:04:31+08:00,['69237e3f80dd7c8300cd73aac3e7e82c9ed9655a'],8,8,16,4759988,3,,,,4274
c43b385ef7d0167e10ef320b41c810123bae3f47,0,Zhong Jian,2014-12-12 15:10:10+08:00,"['25345957ebf13fd7c3aa886a3acaef8381d4f489', 'e5f34ddfd06015dbc473011445229389f9a9810b']",8,8,16,4760004,3,,,,4274
ab073bc5c58c1aa07143b237f3cb0e844e23b909,1,shaofengshi,2014-12-12 17:11:59+08:00,['f3d75b8983a556873203bc614eb7d7c43bf43dfe'],135,89,224,4760228,14,1,0,0,4274
437a66d6bde927d49bf99e9ee2978d5176ecb508,0,cxiao,2014-12-12 17:29:28+08:00,"['c3c12ed8b9a2972b1dbad30e449c11f78f95a69e', '25345957ebf13fd7c3aa886a3acaef8381d4f489']",40,312,352,4760580,16,,,,4274
5dc38520ecc81592bd654fba2b581758f9c9891f,0,Zhong Jian,2014-12-12 17:37:15+08:00,"['c43b385ef7d0167e10ef320b41c810123bae3f47', '437a66d6bde927d49bf99e9ee2978d5176ecb508']",34,57,91,4760671,5,,,,4274
0524ff49055653c829c0d680ebc477c6bcbd4de2,1,Zhong Jian,2014-12-12 17:39:24+08:00,['e5f34ddfd06015dbc473011445229389f9a9810b'],50,46,96,4760767,8,0,0,0,4274
096cf878277975809f836aa1c4f15c53b7b9a600,0,Zhong Jian,2014-12-12 17:44:05+08:00,"['0524ff49055653c829c0d680ebc477c6bcbd4de2', '5dc38520ecc81592bd654fba2b581758f9c9891f']",29,48,77,4760844,5,,,,4274
05d43fc8666b0a7f5c875b6640cf3b540f97f6e8,0,cxiao,2014-12-12 18:23:47+08:00,['437a66d6bde927d49bf99e9ee2978d5176ecb508'],12,28,40,4760884,2,1,0,0.5,4274
d6830d148908b630ea3fd298863ca29db1ffd3b5,0,Zhong Jian,2014-12-12 18:28:33+08:00,"['5dc38520ecc81592bd654fba2b581758f9c9891f', '05d43fc8666b0a7f5c875b6640cf3b540f97f6e8']",12,28,40,4760924,2,,,,4274
67b2b24886d8b4eb1730ac53296fb0cccedf8489,1,Zhong Jian,2014-12-12 18:29:45+08:00,['096cf878277975809f836aa1c4f15c53b7b9a600'],44,31,75,4760999,8,0,0,0,4274
d7738dbb466056e9b48d84740091b3dc89348e98,0,Zhong Jian,2014-12-12 18:42:09+08:00,"['67b2b24886d8b4eb1730ac53296fb0cccedf8489', 'd6830d148908b630ea3fd298863ca29db1ffd3b5']",35,35,70,4761069,3,,,,4274
f975ffddfaf88011275045f66c45f65c6e5066d2,0,Zhong Jian,2014-12-12 19:08:22+08:00,['d7738dbb466056e9b48d84740091b3dc89348e98'],14,1,15,4761084,1,0,0,0,4274
5d02e19598fe9deb3b3256287eaf0d4762f720bb,0,Zhong Jian,2014-12-12 19:09:10+08:00,['f975ffddfaf88011275045f66c45f65c6e5066d2'],0,19,19,4761103,1,,,,4274
6f413609888abb2894c727ebedc21ea27832362f,0,Zhong Jian,2014-12-12 19:11:28+08:00,"['d6830d148908b630ea3fd298863ca29db1ffd3b5', '5d02e19598fe9deb3b3256287eaf0d4762f720bb']",120,89,209,4761312,11,,,,4274
b9dde1d904ddddf044e78a8617cb1b9bc7a01aea,0,shaofengshi,2014-12-12 22:34:51+08:00,['ab073bc5c58c1aa07143b237f3cb0e844e23b909'],10,228,238,4761550,16,0.371681416,1,1,4274
c3a0f172e062acffbee4b899ffda02008203d5ff,0,shaofengshi,2014-12-12 22:55:56+08:00,"['e34ee8eccf793e1e80a2d87a0568369a79311490', 'b9dde1d904ddddf044e78a8617cb1b9bc7a01aea']",392,447,839,4762389,29,,,,4274
91de118f6d861c048eadd35d2677128edf76e8cc,0,honma,2014-12-12 23:57:16+08:00,['5d08ea67a6af205452019bbee8cb4017b2b7fe7f'],3,16,19,4762408,3,,,,4274
2b7fb202e84fae76bcefdf970b956d0925a247a6,0,Luke Han,2014-12-13 11:13:57-08:00,['7d1004a2afb9688e84373db44bc45a6a2db2ccca'],14,15,29,4762437,1,,,,4274
93418cbba81f74327a6da5ec1976f5d6fc41fbe4,0,Luke Han,2014-12-13 11:21:24-08:00,['2b7fb202e84fae76bcefdf970b956d0925a247a6'],1,1,2,4762439,1,,,,4274
177c9495ada993f877ca6773b942b9c3c585c761,0,Zhong Jian,2014-12-15 10:11:02+08:00,['5d02e19598fe9deb3b3256287eaf0d4762f720bb'],9,0,9,4762448,3,,,,4274
2983148afc6d0a7edf1b0f0dfda25cf5e1bd65c4,0,Zhong Jian,2014-12-15 10:12:56+08:00,"['6f413609888abb2894c727ebedc21ea27832362f', '177c9495ada993f877ca6773b942b9c3c585c761']",9,0,9,4762457,3,,,,4274
e44398f0f0d188c00b6655fc3b605de4da54e0a2,0,qianhao.zhou,2014-12-15 10:49:40+08:00,"['beeaf51956eb8b8a27e29887a6f73184549bdf4c', '93418cbba81f74327a6da5ec1976f5d6fc41fbe4']",14,15,29,4762486,1,,,,4274
f517e8a390ec41bddf81878e6afb649f55768c95,0,Zhong Jian,2014-12-15 11:11:25+08:00,['177c9495ada993f877ca6773b942b9c3c585c761'],37,26,63,4762549,5,1,1,1,4274
3d2b706f724fcb26f90ff855e3ce43a505153fc9,0,Zhong Jian,2014-12-15 11:17:05+08:00,"['2983148afc6d0a7edf1b0f0dfda25cf5e1bd65c4', 'f517e8a390ec41bddf81878e6afb649f55768c95']",37,26,63,4762612,5,,,,4274
89460a066a9e7a82eb8e301f5049ec67b2ed560a,0,shaofengshi,2014-12-15 13:33:06+08:00,"['c3a0f172e062acffbee4b899ffda02008203d5ff', 'beeaf51956eb8b8a27e29887a6f73184549bdf4c']",26,28,54,4762666,1,,,,4274
949cdcbfe3ee46c6e7ee22a3c1cf809c687dbfc5,0,Zhong Jian,2014-12-15 15:17:07+08:00,['3d2b706f724fcb26f90ff855e3ce43a505153fc9'],2,36,38,4762704,1,1,1,1,4274
adce93053076fbbe59549961630b8456cd3f38b5,0,Zhong Jian,2014-12-15 15:30:16+08:00,"['3d2b706f724fcb26f90ff855e3ce43a505153fc9', '949cdcbfe3ee46c6e7ee22a3c1cf809c687dbfc5']",2,36,38,4762742,1,,,,4274
c6b00ab3427c7e4a13e08fc9fbcd7b0dc231d8de,0,Kejia-Wang,2014-12-15 17:09:20+08:00,"['fd2490b6885c4c31dbd7b4b647c182323e150e17', 'adce93053076fbbe59549961630b8456cd3f38b5']",277,5414,5691,4768433,83,,,,4274
f862f25567eaf1b10dce10a6770205455156b74e,0,Zhong Jian,2014-12-15 18:09:41+08:00,['adce93053076fbbe59549961630b8456cd3f38b5'],2,6,8,4768441,1,,,,4274
3b22d31e9ad83b16f2780aa4e19f7556b4a0e38a,0,qianhao.zhou,2014-12-16 10:41:57+08:00,['e44398f0f0d188c00b6655fc3b605de4da54e0a2'],1,273,274,4768715,15,1,1,0.911764706,4288
bea5c1c12c8eb76689c3c65521c1567b55939e19,0,qianhao.zhou,2014-12-16 11:02:39+08:00,['a9b0d1be55734a74c5321939f76c63c08925b77c'],14,15,29,4768744,1,,,,4288
08c10c1d54c4f1c36f90d3351983e07042a44f2e,1,cxiao,2014-12-16 15:54:39+08:00,['2983148afc6d0a7edf1b0f0dfda25cf5e1bd65c4'],0,6,6,4768750,1,,,,4288
ab7a40f4f03507b1e70667fa750210b5ef73fbb1,0,Zhong Jian,2014-12-16 15:59:45+08:00,"['adce93053076fbbe59549961630b8456cd3f38b5', '08c10c1d54c4f1c36f90d3351983e07042a44f2e']",0,6,6,4768756,1,,,,4288
40f4d2f66e08cddfe3e5c8bae5312870c2546bda,0,Zhong Jian,2014-12-16 17:05:41+08:00,['f862f25567eaf1b10dce10a6770205455156b74e'],7,19,26,4768782,3,0.9,1,1,4288
a835332d4ffe5462c9710efc487577d249616503,0,Zhong Jian,2014-12-16 17:13:10+08:00,"['ab7a40f4f03507b1e70667fa750210b5ef73fbb1', '40f4d2f66e08cddfe3e5c8bae5312870c2546bda']",9,25,34,4768816,4,,,,4288
189791365a04b361e77582d142a0ac983af98278,0,Zhong Jian,2014-12-16 17:37:55+08:00,['a835332d4ffe5462c9710efc487577d249616503'],1,1,2,4768818,1,,,,4288
ea904dc00d516b95d910f27f3a874a253530df5b,0,Zhong Jian,2014-12-16 17:40:02+08:00,"['a835332d4ffe5462c9710efc487577d249616503', '189791365a04b361e77582d142a0ac983af98278']",1,1,2,4768820,1,,,,4288
94beb0c10fc945acd5798fa30b96335a498440a4,1,Zhong Jian,2014-12-16 19:29:23+08:00,['189791365a04b361e77582d142a0ac983af98278'],9,22,31,4768851,3,0,0.285714286,1,4288
dc4e90051fb00d413792a6515b29fb52669ade64,0,Zhong Jian,2014-12-16 19:32:28+08:00,"['ea904dc00d516b95d910f27f3a874a253530df5b', '94beb0c10fc945acd5798fa30b96335a498440a4']",9,22,31,4768882,3,,,,4288
f1cb1e865495828101a15455ff1a285919e9b527,1,qianhao.zhou,2014-12-16 20:46:09+08:00,['3b22d31e9ad83b16f2780aa4e19f7556b4a0e38a'],68,769,837,4769719,19,0.819587629,1,1,4298
85a8077b7e5077dcbb8ad6302fddcd13fefeee8d,1,Zhong Jian,2014-12-16 22:20:23+08:00,['94beb0c10fc945acd5798fa30b96335a498440a4'],3,9,12,4769731,3,1,1,1,4298
37c8949ca02820a6a02dfef9524b671cd2c4fe59,0,Zhong Jian,2014-12-17 13:10:41+08:00,"['dc4e90051fb00d413792a6515b29fb52669ade64', '85a8077b7e5077dcbb8ad6302fddcd13fefeee8d']",3,9,12,4769743,3,,,,4298
01bc634fb5c139ef0cfecc0dc5efa15bdbc00099,0,Li Yang,2014-12-17 13:43:22+08:00,['37c8949ca02820a6a02dfef9524b671cd2c4fe59'],8,1,9,4769752,3,0.714285714,0.285714286,0,4298
37b94b1cc34074de0ac60a994a86c646b25d9fde,1,qianhao.zhou,2014-12-17 14:03:41+08:00,['f1cb1e865495828101a15455ff1a285919e9b527'],117,241,358,4770110,10,0.346153846,0.717948718,0.961538462,4300
e39d3165c7655ad06ece36a774024811f690a7a9,0,honma,2014-12-17 15:27:15+08:00,['91de118f6d861c048eadd35d2677128edf76e8cc'],122,257,379,4770489,18,0.552238806,0.373134328,0.910447761,4302
cbf77cc1371efb6f6b3f2f8db274c4c4ef28712f,0,shaofengshi,2014-12-17 15:29:51+08:00,['89460a066a9e7a82eb8e301f5049ec67b2ed560a'],0,10,10,4770499,1,1,1,1,4302
3dfbf88e2e33aff856df83d61225bea8baad5b91,0,honma,2014-12-17 16:00:08+08:00,"['91de118f6d861c048eadd35d2677128edf76e8cc', 'beeaf51956eb8b8a27e29887a6f73184549bdf4c']",28,35,63,4770562,2,,,,4302
0a805edee11b79310d66f2e574e6134a56d02204,0,honma,2014-12-17 16:00:58+08:00,"['e39d3165c7655ad06ece36a774024811f690a7a9', '3dfbf88e2e33aff856df83d61225bea8baad5b91']",28,35,63,4770625,2,,,,4302
b1114a4de1041a032909f9e7288d00db90ac30d3,0,Li Yang,2014-12-17 16:33:23+08:00,['01bc634fb5c139ef0cfecc0dc5efa15bdbc00099'],5,37,42,4770667,2,0,0.153846154,0.846153846,4302
a3abf47110a537de965d5d2ed50def5854557d41,0,shaofengshi,2014-12-17 17:31:40+08:00,['cbf77cc1371efb6f6b3f2f8db274c4c4ef28712f'],20,29,49,4770716,2,1,1,1,4302
f2585d841cf80f3b4da372d2dddb327040a390de,0,Li Yang,2014-12-17 17:52:02+08:00,['b1114a4de1041a032909f9e7288d00db90ac30d3'],0,0,0,4770716,2,,,,4303
d431c2251340178f06cd994cfc9f8aaa56e1def7,0,Li Yang,2014-12-17 18:07:56+08:00,['f2585d841cf80f3b4da372d2dddb327040a390de'],1,1,2,4770718,1,,,,4303
95ad8d3af9c40a232528f0e38e69695117458f57,0,Li Yang,2014-12-17 18:09:34+08:00,['d431c2251340178f06cd994cfc9f8aaa56e1def7'],1,1,2,4770720,1,,,,4303
d72cb77c7d2a4a47feae085ca99ac977cead13e4,0,Li Yang,2014-12-18 10:04:29+08:00,['95ad8d3af9c40a232528f0e38e69695117458f57'],1,2,3,4770723,1,1,1,1,4303
f31da18517ca930cfb125ba0f10440dbfdf30a07,0,Li Yang,2014-12-18 10:17:38+08:00,['d72cb77c7d2a4a47feae085ca99ac977cead13e4'],6,8,14,4770737,2,1,1,1,4303
8a89ca893accaa2ec7eadfbdc565b6648b4190f6,1,Li Yang,2014-12-18 11:26:47+08:00,['f31da18517ca930cfb125ba0f10440dbfdf30a07'],3,6,9,4770746,1,0,0,0,4303
16c34c4297a594b1c5709f033cdee31e596faad8,0,Li Yang,2014-12-18 05:09:12+00:00,"['bea5c1c12c8eb76689c3c65521c1567b55939e19', '8a89ca893accaa2ec7eadfbdc565b6648b4190f6']",305,5514,5819,4776565,94,,,,4303
b14a22abf1e70c7cdb9417f4e3e1cd3e957fd5d8,0,Li Yang,2014-12-18 14:47:43+08:00,['8a89ca893accaa2ec7eadfbdc565b6648b4190f6'],50,88,138,4776703,5,1,1,0.791666667,4303
ddd7dea3043265c71752e3eb19b3c75275244d76,0,Li Yang,2014-12-18 14:51:43+08:00,['b14a22abf1e70c7cdb9417f4e3e1cd3e957fd5d8'],4,0,4,4776707,1,0,0,0.25,4303
5923152427573c811383a71c61888e257889f961,1,honma,2014-12-18 15:45:45+08:00,['0a805edee11b79310d66f2e574e6134a56d02204'],651,591,1242,4777949,36,1,0.530612245,0.081632653,4304
b24b56bfd2d6b85619e079ec792228d320788049,0,Kejia-Wang,2014-12-18 17:36:19+08:00,"['c6b00ab3427c7e4a13e08fc9fbcd7b0dc231d8de', 'ddd7dea3043265c71752e3eb19b3c75275244d76']",79,185,264,4778213,25,,,,4304
abe9243b04173dcead2182fc0e7920c554e2d07e,1,qianhao.zhou,2014-12-18 17:39:48+08:00,['37b94b1cc34074de0ac60a994a86c646b25d9fde'],82,99,181,4778394,10,0,1,0.8125,4304
8f15d966416d9750b40b6141ff661f57164338ae,1,shaofengshi,2014-12-18 17:50:12+08:00,['a3abf47110a537de965d5d2ed50def5854557d41'],4,24,28,4778422,2,1,1,1,4304
da6c56907c01273d1c727c7bdeafa88015f501b8,0,shaofengshi,2014-12-18 18:04:30+08:00,"['c3a0f172e062acffbee4b899ffda02008203d5ff', '8f15d966416d9750b40b6141ff661f57164338ae']",41,82,123,4778545,5,,,,4304
dea95efbe4d4f7663b32cb24f45e397ca5bb9566,0,shaofengshi,2014-12-18 18:05:18+08:00,"['beeaf51956eb8b8a27e29887a6f73184549bdf4c', '8f15d966416d9750b40b6141ff661f57164338ae']",276,40749,41025,4819570,290,,,,4304
152851a8a9d33f94127f5fbf3a5669ca11c20308,0,honma,2014-12-19 09:19:22+08:00,['5923152427573c811383a71c61888e257889f961'],25,38,63,4819633,9,0,1,1,4304
41898f9da9c86b5a3250972e4866d1161b352e87,0,honma,2014-12-19 10:49:17+08:00,['152851a8a9d33f94127f5fbf3a5669ca11c20308'],12,39,51,4819684,4,0,0,1,4304
6ff56102f0ee18cd6be420c42c703c2d785e261b,0,honma,2014-12-19 10:58:14+08:00,['41898f9da9c86b5a3250972e4866d1161b352e87'],4,2,6,4819690,2,0,0,0,4304
4275fe898cf3dcae76dcc98e2084d0a1ad348b9e,0,honma,2014-12-19 11:26:01+08:00,['6ff56102f0ee18cd6be420c42c703c2d785e261b'],4,8,12,4819702,2,0,1,0,4304
fee962e3162e981ad897641b0056c7d99df85006,0,shaofengshi,2014-12-19 11:45:48+08:00,['da6c56907c01273d1c727c7bdeafa88015f501b8'],34,84,118,4819820,5,0.3,0,0,4304
0d5828d359c7f8eacce0d0edbd11a9af0a83cee4,0,shaofengshi,2014-12-19 13:11:44+08:00,"['dea95efbe4d4f7663b32cb24f45e397ca5bb9566', 'fee962e3162e981ad897641b0056c7d99df85006']",34,84,118,4819938,5,,,,4304
46c14ba26fda614379c614793fad1b9f4808d0fc,0,shaofengshi,2014-12-19 13:21:15+08:00,"['dea95efbe4d4f7663b32cb24f45e397ca5bb9566', '0d5828d359c7f8eacce0d0edbd11a9af0a83cee4']",34,84,118,4820056,5,,,,4304
5e3943655203c036853ef123738e98a9e6c224be,0,shaofengshi,2014-12-19 13:57:08+08:00,"['0d5828d359c7f8eacce0d0edbd11a9af0a83cee4', '46c14ba26fda614379c614793fad1b9f4808d0fc']",0,0,0,4820056,0,,,,4304
bbf03392a31456398f5d69c70cdfdc3d7b5cecdb,0,shaofengshi,2014-12-19 13:57:43+08:00,"['46c14ba26fda614379c614793fad1b9f4808d0fc', '5e3943655203c036853ef123738e98a9e6c224be']",0,0,0,4820056,0,,,,4304
e1683bd199d25e574cac310f1704d7e5adb58fef,0,shaofengshi,2014-12-19 13:58:33+08:00,"['53ce7338f93dfecf7c06b8d1243cf18a52aecd9b', 'ddd7dea3043265c71752e3eb19b3c75275244d76']",454,5746,6200,4826256,105,,,,4304
74fb9dc35f460549b5cad4d9e02cadbb05f47927,0,shaofengshi,2014-12-19 14:00:51+08:00,"['ddd7dea3043265c71752e3eb19b3c75275244d76', 'e1683bd199d25e574cac310f1704d7e5adb58fef']",2,1,3,4826259,2,,,,4304
aca22fcb862fcb28e3acf17d3d62c5fbd9234d9a,0,qianhao.zhou,2014-12-19 14:19:46+08:00,"['abe9243b04173dcead2182fc0e7920c554e2d07e', 'bbf03392a31456398f5d69c70cdfdc3d7b5cecdb']",277,40800,41077,4867336,293,,,,4304
5ca69f693e5c61c37d773ba02d4c2e7aacde205c,1,qianhao.zhou,2014-12-19 15:22:51+08:00,['aca22fcb862fcb28e3acf17d3d62c5fbd9234d9a'],27,129,156,4867492,6,1,1,0.985507246,4305
41ca1afb5af6219c471164b9bd2c77bb2e6c1ab8,1,honma,2014-12-19 16:57:27+08:00,['4275fe898cf3dcae76dcc98e2084d0a1ad348b9e'],131,130,261,4867753,10,0,0,1,4305
57f09fa7f1a354b7e1b9252baefa2fb589dabd5b,0,honma,2014-12-19 17:08:08+08:00,['41ca1afb5af6219c471164b9bd2c77bb2e6c1ab8'],0,1,1,4867754,1,1,1,1,4305
b0baa497e2b057cceab14bb08901b637bf19a523,1,honma,2014-12-19 18:11:31+08:00,['57f09fa7f1a354b7e1b9252baefa2fb589dabd5b'],8,10,18,4867772,6,0,0,0,4305
bc47c06290c28237d9a893b448efaed7329f7827,0,qianhao.zhou,2014-12-19 18:23:55+08:00,['5ca69f693e5c61c37d773ba02d4c2e7aacde205c'],17,139,156,4867928,5,0.48,0.666666667,1,4306
7ceb1aa842b12f9844c7f06e953bde5813d76843,0,honma,2014-12-19 18:26:16+08:00,['b0baa497e2b057cceab14bb08901b637bf19a523'],2,2,4,4867932,1,,,,4306
b173a250eb61e470e2d2233989853c8e8bf9a3eb,0,Zhong Jian,2014-12-19 19:08:36+08:00,['85a8077b7e5077dcbb8ad6302fddcd13fefeee8d'],14,1903,1917,4869849,19,0.690442225,0.661911555,0.537089872,4323
40b0102a80880bc655732c9936e55b25bae0a944,0,Zhong Jian,2014-12-19 19:11:02+08:00,['b173a250eb61e470e2d2233989853c8e8bf9a3eb'],41,97,138,4869987,17,0.1,0.15,1,4323
53ed9f36b5a7f8a427c87becc3d2d8888bd14329,0,cxiao,2014-12-22 11:37:46+08:00,['adce93053076fbbe59549961630b8456cd3f38b5'],199,705,904,4870891,13,0.558974359,1,0.841025641,4328
bda53f6e99bcc4d8643d343888042fca755575a8,1,honma,2014-12-22 11:42:49+08:00,['7ceb1aa842b12f9844c7f06e953bde5813d76843'],15,26,41,4870932,12,1,1,1,4328
c92954dba3d26d693e71b76e00d008c9b6c06011,1,qianhao.zhou,2014-12-22 13:34:40+08:00,['bc47c06290c28237d9a893b448efaed7329f7827'],100,262,362,4871294,13,1,0.680412371,0.969072165,4331
607b98e9a403d534bfb0523ca62c3c61eebb6be8,1,qianhao.zhou,2014-12-22 15:28:28+08:00,['c92954dba3d26d693e71b76e00d008c9b6c06011'],57,85,142,4871436,5,0.818181818,1,1,4331
5243189e1eafd7e4733874c6981994a0114adc5f,0,honma,2014-12-22 15:49:26+08:00,['bda53f6e99bcc4d8643d343888042fca755575a8'],320,277,597,4872033,25,0,1,0,4332
c901fbb8b74eca469fcfd4a6ce686636f857b4ed,0,honma,2014-12-22 15:58:49+08:00,['5243189e1eafd7e4733874c6981994a0114adc5f'],1,3,4,4872037,1,,,,4332
c0d5e4b4ba7f84ee5cf257614be4429bab27ad3a,0,honma,2014-12-22 16:03:57+08:00,"['3dfbf88e2e33aff856df83d61225bea8baad5b91', 'bbf03392a31456398f5d69c70cdfdc3d7b5cecdb']",164,40805,40969,4913006,293,,,,4332
2d1684cb56718595b62ef0c5f5e8c7d459955533,0,honma,2014-12-22 16:05:22+08:00,"['c0d5e4b4ba7f84ee5cf257614be4429bab27ad3a', 'c901fbb8b74eca469fcfd4a6ce686636f857b4ed']",1242,1332,2574,4915580,85,,,,4332
fa6ec7492b89226a86cd495f3c1bd9c3a6230827,0,qianhao.zhou,2014-12-22 16:17:30+08:00,['607b98e9a403d534bfb0523ca62c3c61eebb6be8'],9,5,14,4915594,4,0,0,0,4332
ada53857133fd5319621ce08b30f6a718d84c687,0,honma,2014-12-22 16:19:57+08:00,['2d1684cb56718595b62ef0c5f5e8c7d459955533'],136,16,152,4915746,4,,,,4332
a45524ad0425ac7cf3eb1bfd4c77f6f46c470c13,0,cxiao,2014-12-22 16:43:10+08:00,['53ed9f36b5a7f8a427c87becc3d2d8888bd14329'],0,1,1,4915747,1,,,,4332
a40b07b850dc922e3223f10212d792da4fb89ccc,0,qianhao.zhou,2014-12-22 16:51:03+08:00,"['e44398f0f0d188c00b6655fc3b605de4da54e0a2', 'ada53857133fd5319621ce08b30f6a718d84c687']",3127,46807,49934,4965681,535,,,,4332
98cdc308f25e8ef700148ff3fdc30adce28d0e5a,1,shaofengshi,2014-12-22 16:56:58+08:00,['74fb9dc35f460549b5cad4d9e02cadbb05f47927'],17,35,52,4965733,4,1,0,0,4332
d1db15e5c9859ad99f9c098474668ac63b7fc3dd,1,Li Yang,2014-12-22 16:58:27+08:00,['ddd7dea3043265c71752e3eb19b3c75275244d76'],3,6,9,4965742,1,0,0,1,4332
c0243c21359cca67f93c6fe9408a1f111291cd24,0,Li Yang,2014-12-22 16:58:51+08:00,"['d1db15e5c9859ad99f9c098474668ac63b7fc3dd', '74fb9dc35f460549b5cad4d9e02cadbb05f47927']",2,1,3,4965745,2,,,,4332
7bbb09b6e90875fce9bab094479ff5a04c54284f,0,honma,2014-12-22 17:15:48+08:00,['ada53857133fd5319621ce08b30f6a718d84c687'],3,9,12,4965757,2,0,1,1,4332
393a6626e9a86c9afb79e29b0ff11b4b30df313a,0,qianhao.zhou,2014-12-22 17:41:22+08:00,"['a40b07b850dc922e3223f10212d792da4fb89ccc', '7bbb09b6e90875fce9bab094479ff5a04c54284f']",3,9,12,4965769,2,,,,4332
75655cdcf9e0d7005ff5daeda53bb8396a9a5bed,0,qianhao.zhou,2014-12-22 17:44:42+08:00,['393a6626e9a86c9afb79e29b0ff11b4b30df313a'],1,1,2,4965771,1,,,,4332
24e9eebe8a3c2f3a4460820ffcc8193cad1fd452,0,qianhao.zhou,2014-12-22 17:45:43+08:00,"['7bbb09b6e90875fce9bab094479ff5a04c54284f', '75655cdcf9e0d7005ff5daeda53bb8396a9a5bed']",15,16,31,4965802,2,,,,4332
1dce80595df376e17f75a5da5cd74ba93a62df67,1,Zhong Jian,2014-12-22 19:11:07+08:00,['40b0102a80880bc655732c9936e55b25bae0a944'],56,43,99,4965901,12,1,1,0,4332
b0c1955e53c088ff1636e7909e481856cf2536f9,1,honma,2014-12-23 10:01:26+08:00,['24e9eebe8a3c2f3a4460820ffcc8193cad1fd452'],14,26,40,4965941,6,1,1,1,4332
734380c616fb64c99f8c53b836571344596eac84,0,qianhao.zhou,2014-12-23 10:23:14+08:00,"['fa6ec7492b89226a86cd495f3c1bd9c3a6230827', 'b0c1955e53c088ff1636e7909e481856cf2536f9']",3111,6286,9397,4975338,254,,,,4332
d521b693844a7d9d17b80044fdf2f0327d4afcde,0,binmahone,2014-12-22 18:48:17-08:00,['b0c1955e53c088ff1636e7909e481856cf2536f9'],0,0,0,4975338,20,,,,4332
ff9b31e0d1d4ead7ffc78d95900726fa0b3fb3c0,0,Kejia-Wang,2014-12-23 11:33:50+08:00,"['b24b56bfd2d6b85619e079ec792228d320788049', 'c0243c21359cca67f93c6fe9408a1f111291cd24']",5,7,12,4975350,3,,,,4332
e37622db1421c481f169acce5ea0a591e55867ba,0,Zhong Jian,2014-12-23 12:56:36+08:00,['1dce80595df376e17f75a5da5cd74ba93a62df67'],6,4,10,4975360,3,1,1,1,4332
59e913af9df267830b9f84873a95ae26e4f91dae,0,Zhong Jian,2014-12-23 13:19:22+08:00,"['c0243c21359cca67f93c6fe9408a1f111291cd24', 'e37622db1421c481f169acce5ea0a591e55867ba']",83,2013,2096,4977456,37,,,,4332
a0e918d6f310e82e0010b36f097c64b960d33415,0,honma,2014-12-23 14:02:16+08:00,['b0c1955e53c088ff1636e7909e481856cf2536f9'],23,27,50,4977506,8,,,,4332
4192d08cdf58b725815abbf7c45276f2872c3264,0,binmahone,2014-12-22 22:03:47-08:00,"['d521b693844a7d9d17b80044fdf2f0327d4afcde', 'a0e918d6f310e82e0010b36f097c64b960d33415']",23,27,50,4977556,8,,,,4332
6d22368167cbdd16d9981b6565dfcc331a00498a,0,shaofengshi,2014-12-23 14:40:55+08:00,['98cdc308f25e8ef700148ff3fdc30adce28d0e5a'],10,26,36,4977592,6,0,1,1,4332
1225f04f4a455ad8d3bb7a3f3fc2c4f903684250,0,Zhong Jian,2014-12-23 14:55:35+08:00,['e37622db1421c481f169acce5ea0a591e55867ba'],7,8,15,4977607,3,0,1,1,4332
8863d188d70d917279b3ad0cac59c40af7f491a7,0,Zhong Jian,2014-12-23 14:57:02+08:00,"['59e913af9df267830b9f84873a95ae26e4f91dae', '1225f04f4a455ad8d3bb7a3f3fc2c4f903684250']",7,8,15,4977622,3,,,,4332
500f5d6fe1f55846f7cf72863325f2b1239e1115,0,Kejia-Wang,2014-12-23 15:13:45+08:00,['ff9b31e0d1d4ead7ffc78d95900726fa0b3fb3c0'],0,219,219,4977841,2,,,,4334
f0069a8ed06c27df749fec37311028554cddf521,0,Zhong Jian,2014-12-23 15:25:40+08:00,['1225f04f4a455ad8d3bb7a3f3fc2c4f903684250'],10,12,22,4977863,3,1,1,1,4334
baf4fa579e1b3fa2149a5df08dab8d5ba00a4aac,0,Zhong Jian,2014-12-23 15:26:55+08:00,"['8863d188d70d917279b3ad0cac59c40af7f491a7', 'f0069a8ed06c27df749fec37311028554cddf521']",10,12,22,4977885,3,,,,4334
7d0ef0463e40a265c573d8151ae9ee9d8893ea9c,0,honma,2014-12-23 15:54:12+08:00,['a0e918d6f310e82e0010b36f097c64b960d33415'],14,16,30,4977915,3,0.875,1,1,4334
be2489ffe46e623cbbf4707ec4471a2c4ea1291e,0,Zhong Jian,2014-12-23 15:54:37+08:00,['f0069a8ed06c27df749fec37311028554cddf521'],1,7,8,4977923,2,1,1,1,4334
d7a55c6670b3497c7a07c51a8f7e6b59b41aeef1,0,Zhong Jian,2014-12-23 15:55:55+08:00,"['baf4fa579e1b3fa2149a5df08dab8d5ba00a4aac', 'be2489ffe46e623cbbf4707ec4471a2c4ea1291e']",1,7,8,4977931,2,,,,4334
338a5254076956b8269764352357073afa715505,0,binmahone,2014-12-23 00:01:25-08:00,"['4192d08cdf58b725815abbf7c45276f2872c3264', '7d0ef0463e40a265c573d8151ae9ee9d8893ea9c']",14,16,30,4977961,3,,,,4334
2a673ebf399f2dc16755bdab4e87c33f0115c8b1,0,Kejia-Wang,2014-12-23 16:33:15+08:00,['500f5d6fe1f55846f7cf72863325f2b1239e1115'],197,111,308,4978269,5,,,,4337
2d907ee271e2e5ec4e198c631f5fe1ff7c4d544f,0,Kejia-Wang,2014-12-23 16:49:39+08:00,['2a673ebf399f2dc16755bdab4e87c33f0115c8b1'],0,60,60,4978329,2,,,,4339
c95d7b58ad07aa48cc511221e3d6ecc5b0548808,0,Zhong Jian,2014-12-23 16:50:58+08:00,['1225f04f4a455ad8d3bb7a3f3fc2c4f903684250'],8,10,18,4978347,3,1,1,1,4339
1db974f5f1c1e6ea7e28975e4e9d63c0aee45a76,0,Zhong Jian,2014-12-23 17:02:22+08:00,"['c95d7b58ad07aa48cc511221e3d6ecc5b0548808', 'be2489ffe46e623cbbf4707ec4471a2c4ea1291e']",13,14,27,4978374,3,,,,4339
a3734f3ffe8fe756e82a49c996aa95e2da51496c,0,Zhong Jian,2014-12-23 17:05:49+08:00,['1db974f5f1c1e6ea7e28975e4e9d63c0aee45a76'],9,0,9,4978383,2,0,0,0,4339
ef58328991efe06dea67d34b303d93aeddf8414d,0,Zhong Jian,2014-12-23 17:06:40+08:00,"['a3734f3ffe8fe756e82a49c996aa95e2da51496c', 'd7a55c6670b3497c7a07c51a8f7e6b59b41aeef1']",65,132,197,4978580,18,,,,4339
3ae79b4de1c5bdb23dd99d62c24d24aef98ffc98,0,Zhong Jian,2014-12-23 17:09:27+08:00,"['d7a55c6670b3497c7a07c51a8f7e6b59b41aeef1', 'ef58328991efe06dea67d34b303d93aeddf8414d']",20,6,26,4978606,3,,,,4339
369cf9061ca51bdd0548f1d79d91643760faa52f,0,Kejia-Wang,2014-12-23 17:12:41+08:00,['2d907ee271e2e5ec4e198c631f5fe1ff7c4d544f'],18,140,158,4978764,3,,,,4341
dcd96e0e93f3ce6cd94aed42acd877e708c0164a,0,Kejia-Wang,2014-12-23 17:22:12+08:00,['369cf9061ca51bdd0548f1d79d91643760faa52f'],0,133,133,4978897,2,,,,4343
fa09760bc8d8c542cce2883bf4aa34152ee18386,0,Kejia-Wang,2014-12-23 17:26:13+08:00,['dcd96e0e93f3ce6cd94aed42acd877e708c0164a'],0,30,30,4978927,2,,,,4345
febaa75fbbb25e3d9c1285cfa8d102f99d72d12a,0,Kejia-Wang,2014-12-23 17:34:12+08:00,"['3ae79b4de1c5bdb23dd99d62c24d24aef98ffc98', 'fa09760bc8d8c542cce2883bf4aa34152ee18386']",10,494,504,4979431,13,,,,4345
eff3d0ec3ecf5a16af343af0b3eab48e9412def4,0,Li Yang,2014-12-23 17:40:38+08:00,['c0243c21359cca67f93c6fe9408a1f111291cd24'],0,0,0,4979431,1,,,,4346
0f693412c1d09b1ae6fecc6e0030b9373f2b21a1,0,Zhong Jian,2014-12-23 17:40:49+08:00,['ef58328991efe06dea67d34b303d93aeddf8414d'],2,7,9,4979440,3,1,1,1,4346
9e31b1a7427307b93e3e08c185f3b82996798fcf,0,Zhong Jian,2014-12-23 17:42:16+08:00,"['febaa75fbbb25e3d9c1285cfa8d102f99d72d12a', '0f693412c1d09b1ae6fecc6e0030b9373f2b21a1']",2,7,9,4979449,3,,,,4346
5ee7b4e42c29e9dcbfc615155dc9afb01a145998,1,qianhao.zhou,2014-12-23 18:21:17+08:00,['734380c616fb64c99f8c53b836571344596eac84'],27,143,170,4979619,6,0,0,0.139534884,4346
e0c657b760736d76df71cc2ba42d8bbeda86def5,1,cxiao,2014-12-23 23:48:34+08:00,['a45524ad0425ac7cf3eb1bfd4c77f6f46c470c13'],16,639,655,4980274,6,0.61,1,1,4349
888c82ae5d46cdb7fa12a64fc9353244c8eb8247,1,shaofengshi,2014-12-24 11:28:37+08:00,['338a5254076956b8269764352357073afa715505'],35,190,225,4980499,4,0.569767442,1,1,4350
c760dc2fdce0db1b8af822d788faacbe35bdd325,0,shaofengshi,2014-12-24 11:29:51+08:00,"['338a5254076956b8269764352357073afa715505', '888c82ae5d46cdb7fa12a64fc9353244c8eb8247']",35,190,225,4980724,4,,,,4350
1911963198d8341c06c75baddb4909e153c42cfe,0,qianhao.zhou,2014-12-24 16:21:07+08:00,['5ee7b4e42c29e9dcbfc615155dc9afb01a145998'],105,151,256,4980980,5,1,1,0,4350
3edcdfc4e32cc9367b230a6ee159cf6cf20a8595,1,shaofengshi,2014-12-24 18:08:58+08:00,['888c82ae5d46cdb7fa12a64fc9353244c8eb8247'],3,8,11,4980991,2,0,1,1,4350
8eb44d1ce2d98a6f57176dbbc90e9f988e98df64,0,shaofengshi,2014-12-24 18:10:16+08:00,"['c760dc2fdce0db1b8af822d788faacbe35bdd325', '3edcdfc4e32cc9367b230a6ee159cf6cf20a8595']",3,8,11,4981002,2,,,,4350
e99efc31f0385209497743a1ad060e25ac879de7,0,honma,2014-12-25 10:01:41+08:00,['8eb44d1ce2d98a6f57176dbbc90e9f988e98df64'],118,553,671,4981673,11,1,1,0.388888889,4351
a780bd19bb04f2c23cf17f8e6ea20f6bb8a6ad43,0,honma,2014-12-25 10:01:41+08:00,['e99efc31f0385209497743a1ad060e25ac879de7'],15,11,26,4981699,6,1,,,4351
526be29aa5a12112a81ed9492764d5cc117f767e,1,honma,2014-12-25 10:01:42+08:00,['a780bd19bb04f2c23cf17f8e6ea20f6bb8a6ad43'],164,125,289,4981988,25,0,1,1,4351
4db672175f01a6f167d2be5d38fb455589a26674,1,honma,2014-12-25 10:51:54+08:00,['526be29aa5a12112a81ed9492764d5cc117f767e'],21,25,46,4982034,2,1,1,1,4351
874f45c590d0125ac3e8e7c189d3c265389ab7ee,1,shaofengshi,2014-12-25 10:59:38+08:00,['8eb44d1ce2d98a6f57176dbbc90e9f988e98df64'],46,43,89,4982123,7,1,1,1,4351
3eb926c9da63c82335a06f25f278fde5c583af73,0,honma,2014-12-25 11:11:08+08:00,['4db672175f01a6f167d2be5d38fb455589a26674'],2,1,3,4982126,2,,,,4351
6dc91c89a4c908aaed6c258b80dd697f0425f0be,0,Kejia-Wang,2014-12-25 11:12:40+08:00,['fa09760bc8d8c542cce2883bf4aa34152ee18386'],0,102,102,4982228,2,,,,4353
084c18773b3abadf7997651df09b0f8d921a5dbf,0,shaofengshi,2014-12-25 11:12:49+08:00,"['874f45c590d0125ac3e8e7c189d3c265389ab7ee', '4db672175f01a6f167d2be5d38fb455589a26674']",293,690,983,4983211,41,,,,4353
31720710936539b27561ad092111b8e1cb73a376,0,shaofengshi,2014-12-25 11:13:06+08:00,"['084c18773b3abadf7997651df09b0f8d921a5dbf', '3eb926c9da63c82335a06f25f278fde5c583af73']",2,1,3,4983214,2,,,,4353
070d9bd834e08de0ab4e688af7deb48602bb36e1,0,Kejia-Wang,2014-12-25 11:19:16+08:00,['6dc91c89a4c908aaed6c258b80dd697f0425f0be'],0,76,76,4983290,2,,,,4355
d65c13343e4b5941963331163acff6c284b669fe,0,Kejia-Wang,2014-12-25 11:20:22+08:00,['070d9bd834e08de0ab4e688af7deb48602bb36e1'],0,26,26,4983316,2,,,,4357
be96919a035be00cfe84584bd5401d5ab7f3bc9e,0,Kejia-Wang,2014-12-25 11:33:28+08:00,['d65c13343e4b5941963331163acff6c284b669fe'],0,40,40,4983356,2,,,,4359
1c9d4665eb8f54f119e579c06010362e0e3b7afb,0,qianhao.zhou,2014-12-25 11:34:20+08:00,['1911963198d8341c06c75baddb4909e153c42cfe'],3,3,6,4983362,1,,,,4359
9d5774a0cbcfbe594e85b111187916dad6ba3b21,0,qianhao.zhou,2014-12-25 11:35:30+08:00,"['1c9d4665eb8f54f119e579c06010362e0e3b7afb', '3eb926c9da63c82335a06f25f278fde5c583af73']",360,921,1281,4984643,60,,,,4359
02ba8ae367d45016c44753f974f4ccc0794ea7ce,0,honma,2014-12-25 13:38:07+08:00,['3eb926c9da63c82335a06f25f278fde5c583af73'],422,10018,10440,4995083,13,0,1,1,4366
c2a9717ef86d7980c847452416ed6c5308ac125a,0,Kejia-Wang,2014-12-25 15:14:18+08:00,"['9e31b1a7427307b93e3e08c185f3b82996798fcf', 'be96919a035be00cfe84584bd5401d5ab7f3bc9e']",0,244,244,4995327,8,,,,4366
002528aa5c39f6638beb381b257830df7a11f5a8,0,Li Yang,2014-12-25 16:24:29+08:00,['eff3d0ec3ecf5a16af343af0b3eab48e9412def4'],1,1,2,4995329,1,,,,4366
c0738c450e6a07076b9dc8f8d9611ab9d49253d0,0,Li Yang,2014-12-25 16:24:50+08:00,['002528aa5c39f6638beb381b257830df7a11f5a8'],0,25,25,4995354,1,,,,4367
5d5359c40bc1bcbad62717f3f4629f3b1e35c6aa,1,Li Yang,2014-12-25 16:26:04+08:00,['c0738c450e6a07076b9dc8f8d9611ab9d49253d0'],33,32,65,4995419,3,1,1,1,4367
21383b617b3cb2a3527cade8bca89c76d53533da,0,honma,2014-12-25 16:46:43+08:00,['02ba8ae367d45016c44753f974f4ccc0794ea7ce'],23,31,54,4995473,7,0.125,0.625,1,4367
c49b85327eff9f51b84e8d7dcab2e5330ec00fcf,0,Li Yang,2014-12-25 17:08:02+08:00,['21383b617b3cb2a3527cade8bca89c76d53533da'],10951,9424,20375,5015848,129,0.948559671,0.449931413,0.386831276,4367
764618748d32d12410ba035a2968a2d06b883c01,0,Li Yang,2014-12-25 17:13:22+08:00,['c49b85327eff9f51b84e8d7dcab2e5330ec00fcf'],2905,3388,6293,5022141,22,0,0.834862385,0.834862385,4370
56fa23675fd17898c7737a1b6a5e1d9cb71bd751,1,shaofengshi,2014-12-25 17:28:19+08:00,['31720710936539b27561ad092111b8e1cb73a376'],79,69,148,5022289,6,0.166666667,0.166666667,0,4370
61a54dcb0e8b053da074e941153ef2748dbf337d,0,shaofengshi,2014-12-25 17:35:17+08:00,"['56fa23675fd17898c7737a1b6a5e1d9cb71bd751', '764618748d32d12410ba035a2968a2d06b883c01']",14283,22844,37127,5059416,160,,,,4370
297a1ffbb0390f3f708346b1b4b24d51990a83b5,0,shaofengshi,2014-12-25 17:38:19+08:00,"['764618748d32d12410ba035a2968a2d06b883c01', '61a54dcb0e8b053da074e941153ef2748dbf337d']",116,105,221,5059637,17,,,,4370
eafc6e36f2489e061098094d35ab108003dc073a,0,Li Yang,2014-12-26 10:15:11+08:00,['5d5359c40bc1bcbad62717f3f4629f3b1e35c6aa'],4,4,8,5059645,1,,,,4370
32ae3ac31ba222c7cfc971868d7e0c523734634b,0,Li Yang,2014-12-26 10:15:30+08:00,"['eafc6e36f2489e061098094d35ab108003dc073a', 'c2a9717ef86d7980c847452416ed6c5308ac125a']",93,2751,2844,5062489,58,,,,4370
466cce3e60f42b18b2e068df5459cf50e700b8c9,0,honma,2014-12-26 10:43:16+08:00,['297a1ffbb0390f3f708346b1b4b24d51990a83b5'],6,9,15,5062504,4,1,1,1,4370
fa2cbc6ae0cbe053d86575b8cdd5044ca5153590,0,shaofengshi,2014-12-26 11:31:28+08:00,['6d22368167cbdd16d9981b6565dfcc331a00498a'],2,27,29,5062533,2,,,,4370
f7b998b3314c5db13c2ffa2419d707c20bbefd17,0,honma,2014-12-26 12:50:25+08:00,['466cce3e60f42b18b2e068df5459cf50e700b8c9'],2,2,4,5062537,2,1,1,0,4370
b95db45d5c025ce493e75364e0e76b7b8d0c10cb,0,Li Yang,2014-12-26 13:19:40+08:00,['32ae3ac31ba222c7cfc971868d7e0c523734634b'],6,14,20,5062557,1,,,,4370
6e13e05403511db01c3cea81f2cbe513aedae53a,0,honma,2014-12-26 13:20:26+08:00,['f7b998b3314c5db13c2ffa2419d707c20bbefd17'],0,5,5,5062562,3,0,1,1,4370
f19d06d4e775c800808a0499c4f48180e2940e92,1,Li Yang,2014-12-26 13:35:23+08:00,['b95db45d5c025ce493e75364e0e76b7b8d0c10cb'],1,2,3,5062565,1,1,1,1,4370
75578d5fbb2ba6322bb0d461427ae3a7c8f76df9,0,Li Yang,2014-12-26 13:35:40+08:00,['f19d06d4e775c800808a0499c4f48180e2940e92'],2,4,6,5062571,1,1,1,1,4370
5ec06ab3fd13fe8fa81f347a0092eaca5a5b6494,0,cxiao,2014-12-26 13:47:15+08:00,['e0c657b760736d76df71cc2ba42d8bbeda86def5'],67,38,105,5062676,4,0.083333333,0,0,4370
f69ffb64d6ad3881e997ff0d3b7d38fadcb61e83,1,qianhao.zhou,2014-12-26 15:26:50+08:00,['9d5774a0cbcfbe594e85b111187916dad6ba3b21'],189,559,748,5063424,23,1,0.680555556,0.923611111,4378
ac2903fa3e0c11a6b870af3e69c59c723ac69ca4,0,qianhao.zhou,2014-12-26 16:17:46+08:00,['f69ffb64d6ad3881e997ff0d3b7d38fadcb61e83'],8,17,25,5063449,5,0.75,0.75,1,4378
320a072bfa498e380669af7becb0bcc74866f443,0,shaofengshi,2014-12-26 16:36:46+08:00,['297a1ffbb0390f3f708346b1b4b24d51990a83b5'],0,2,2,5063451,1,,,,4378
7bf4dd30f5d1ae1a843fde643bc38ba5268a9522,0,shaofengshi,2014-12-26 16:39:33+08:00,"['6e13e05403511db01c3cea81f2cbe513aedae53a', '320a072bfa498e380669af7becb0bcc74866f443']",0,2,2,5063453,1,,,,4378
8b26ce43fa41f725b6dfc29624bcbeaab2ded681,0,Li Yang,2014-12-26 17:40:29+08:00,['75578d5fbb2ba6322bb0d461427ae3a7c8f76df9'],1,1,2,5063455,1,,,,4378
ded5e89328f983aad45862cb784b5c7d34cae0c2,0,cxiao,2014-12-26 17:55:01+08:00,['5ec06ab3fd13fe8fa81f347a0092eaca5a5b6494'],19,294,313,5063768,6,0.703296703,0.93956044,0.846153846,4380
82c61a18f6f4fd44da61038ec6c0e2cac694a99b,1,qianhao.zhou,2014-12-26 19:07:18+08:00,['ac2903fa3e0c11a6b870af3e69c59c723ac69ca4'],112,311,423,5064191,16,0.643478261,1,0.991304348,4383
4190152bdff4dee8f3424623ba604b8013c0cbd6,1,Li Yang,2014-12-29 10:36:24+08:00,['8b26ce43fa41f725b6dfc29624bcbeaab2ded681'],2,6,8,5064199,2,0,1,1,4383
540de58dd6f63fcb5e6e3d9b208ed539ef35b3b2,0,cxiao,2014-12-29 17:18:08+08:00,['ded5e89328f983aad45862cb784b5c7d34cae0c2'],226,24,250,5064449,6,0.268456376,0.046979866,0.187919463,4383
347544973dd0a502941fb1e4d1deb3a7647c6ee3,1,honma,2014-12-30 10:42:35+08:00,['f7b998b3314c5db13c2ffa2419d707c20bbefd17'],732,833,1565,5066014,12,1,0.555555556,0.333333333,4384
7cfa4d2ee795d845a495f1839d5559372e0ec5e3,0,shaofengshi,2014-12-30 11:03:32+08:00,"['4190152bdff4dee8f3424623ba604b8013c0cbd6', 'fa2cbc6ae0cbe053d86575b8cdd5044ca5153590']",19,78,97,5066111,7,,,,4384
a2a83bdecd5d00df253ae0dac9ebb0996a0806a9,0,honma,2014-12-30 11:04:39+08:00,['7bf4dd30f5d1ae1a843fde643bc38ba5268a9522'],2,2,4,5066115,1,,,,4384
e92cea50063dbc76cd4d462c5e9c6c3fbda4fda8,0,honma,2014-12-30 11:04:58+08:00,"['a2a83bdecd5d00df253ae0dac9ebb0996a0806a9', '347544973dd0a502941fb1e4d1deb3a7647c6ee3']",732,833,1565,5067680,12,,,,4384
b2ec677a3f9ca1cd823f62785af2c52e8e1a0236,1,shaofengshi,2014-12-30 11:47:14+08:00,['7cfa4d2ee795d845a495f1839d5559372e0ec5e3'],40,43,83,5067763,6,0,0,1,4384
7dce81da76f01ca056187b64c300f6a5ace24dd8,0,honma,2014-12-30 13:17:57+08:00,['e92cea50063dbc76cd4d462c5e9c6c3fbda4fda8'],5,3,8,5067771,2,0,0,0,4384
effeaf4b08e1eb686840b3555811da29e358c5da,0,honma,2014-12-30 14:04:38+08:00,['7dce81da76f01ca056187b64c300f6a5ace24dd8'],37,48,85,5067856,10,1,1,1,4384
060d231027daad1533fc951b17cd14394cb6acb5,0,Li Yang,2014-12-30 14:56:51+08:00,['4190152bdff4dee8f3424623ba604b8013c0cbd6'],2,1,3,5067859,1,,,,4384
ca6d1b67a8db86fc5ae022621734c6f56210e5a3,0,Li Yang,2014-12-30 14:57:43+08:00,['060d231027daad1533fc951b17cd14394cb6acb5'],4,6,10,5067869,2,0,0,1,4384
b592149752e7a721daaa933fd2f913a1d280ce13,1,shaofengshi,2014-12-30 15:13:29+08:00,['b2ec677a3f9ca1cd823f62785af2c52e8e1a0236'],5,22,27,5067896,3,0,0,1,4384
7cee22372ebc6acf680b3988707e00646e578dd0,0,Li Yang,2014-12-30 15:25:32+08:00,['ca6d1b67a8db86fc5ae022621734c6f56210e5a3'],4,15,19,5067915,1,1,0,1,4384
2735bf8fdf6a0e190131444a20d8969249085e65,1,honma,2014-12-30 15:38:56+08:00,['effeaf4b08e1eb686840b3555811da29e358c5da'],100,295,395,5068310,15,0.607142857,0.952380952,1,4388
262f4df97600cb75f58c4242060aba559424272b,0,shaofengshi,2014-12-30 16:13:18+08:00,['b592149752e7a721daaa933fd2f913a1d280ce13'],88,4,92,5068402,3,0.808510638,1,0.446808511,4388
38dfb97398ddcd7885a1d1850dcaf7e2b0a648f2,0,shaofengshi,2014-12-30 16:15:16+08:00,"['4190152bdff4dee8f3424623ba604b8013c0cbd6', '262f4df97600cb75f58c4242060aba559424272b']",98,93,191,5068593,12,,,,4388
f3e5c43b66231211fa3eb28659102d22a2479adf,0,honma,2014-12-30 18:12:04+08:00,['2735bf8fdf6a0e190131444a20d8969249085e65'],211,210,421,5069014,2,0.333333333,0,0,4388
f5b334e08142204d0c43ac5fd62e97377aa7e3e1,0,Li Yang,2014-12-30 18:19:06+08:00,['16c34c4297a594b1c5709f033cdee31e596faad8'],2,2,4,5069018,2,,,,4388
2bcfa913b769b8871a49fd062ef6e5eba382b246,0,honma,2014-12-30 18:39:11+08:00,['f3e5c43b66231211fa3eb28659102d22a2479adf'],3,3,6,5069024,2,,,,4388
74eb916051d014819c3dab043e3fbc5361a7ebdb,0,honma,2014-12-30 18:58:31+08:00,['2bcfa913b769b8871a49fd062ef6e5eba382b246'],3,4,7,5069031,2,0,1,1,4388
c9f05b2688570fe6fee04587f6e4047d8525c0ed,0,honma,2014-12-30 20:02:23+08:00,['74eb916051d014819c3dab043e3fbc5361a7ebdb'],8,10,18,5069049,2,0,1,1,4388
b9e95eae1c702f5fa741f97f83114e2dcd447f3d,0,Ted Dunning,2014-12-30 17:58:00-08:00,[],0,3,3,5069052,1,,,,4389
197833640c1a945f0d6354898b4ca45d2101f3e4,1,qianhao.zhou,2014-12-31 10:09:44+08:00,['82c61a18f6f4fd44da61038ec6c0e2cac694a99b'],100,352,452,5069504,15,0.568047337,0.763313609,0.99408284,4390
6dab2da28decc37db896de8d11bdba5caa454aa1,0,qianhao.zhou,2014-12-31 10:10:13+08:00,"['197833640c1a945f0d6354898b4ca45d2101f3e4', 'c9f05b2688570fe6fee04587f6e4047d8525c0ed']",13823,22689,36512,5106016,190,,,,4390
32f8158aa8fb2df29640fc265c1948c083a23659,0,Li Yang,2014-12-31 10:13:24+08:00,['7cee22372ebc6acf680b3988707e00646e578dd0'],1,1,2,5106018,1,,,,4390
3259a8e243e138ada369797f8668dd3c63f4a6da,0,honma,2014-12-31 11:20:46+08:00,['c9f05b2688570fe6fee04587f6e4047d8525c0ed'],175,173,348,5106366,2,0,0,0,4390
29937bd1a0633acff4bbbfba334bd7d909f71bfb,0,shaofengshi,2014-12-31 11:39:35+08:00,['262f4df97600cb75f58c4242060aba559424272b'],0,30,30,5106396,2,0,1,1,4390
6be353ae9d6e4538a29fa18f6b1703cd8f5e05ce,0,shaofengshi,2014-12-31 11:46:23+08:00,"['38dfb97398ddcd7885a1d1850dcaf7e2b0a648f2', '29937bd1a0633acff4bbbfba334bd7d909f71bfb']",0,30,30,5106426,2,,,,4390
8fabc84e79d3c907ffd67dd004b9d44f8aff2677,0,honma,2014-12-31 14:13:21+08:00,['3259a8e243e138ada369797f8668dd3c63f4a6da'],0,7,7,5106433,1,,,,4391
cae84e58978110a4aad3bdb5828aafa21f06eacf,0,honma,2014-12-31 15:29:20+08:00,['8fabc84e79d3c907ffd67dd004b9d44f8aff2677'],4,25,29,5106462,3,0,1,1,4391
43a5b202d011d6ff4a8dbf8334405713d75e91c9,1,qianhao.zhou,2014-12-31 15:48:48+08:00,['6dab2da28decc37db896de8d11bdba5caa454aa1'],332,381,713,5107175,27,0.583333333,0.763888889,0.736111111,4393
6628119a78aa33dd8109c02fa868e1f2dd92a76b,0,Li Yang,2014-12-31 08:32:40+00:00,"['3259a8e243e138ada369797f8668dd3c63f4a6da', '32f8158aa8fb2df29640fc265c1948c083a23659']",623,8571,9194,5116369,150,,,,4393
1e6fcffb4eb9579456b054de4f752e8514f1ce24,0,qianhao.zhou,2014-12-31 16:59:04+08:00,['43a5b202d011d6ff4a8dbf8334405713d75e91c9'],2,89,91,5116460,4,0.591836735,1,1,4394
8bd40216de8e4593fadf4c2f18b839f737ad8045,1,Li Yang,2014-12-31 16:59:30+08:00,['6628119a78aa33dd8109c02fa868e1f2dd92a76b'],4521,4787,9308,5125768,25,0,0.160401003,0.393483709,4394
d405842e06f0797a56035f3f8488ba7ce48c9411,0,Li Yang,2014-12-31 16:59:52+08:00,"['8bd40216de8e4593fadf4c2f18b839f737ad8045', 'cae84e58978110a4aad3bdb5828aafa21f06eacf']",4,32,36,5125804,3,,,,4394
c9a792328dfd81ca52486d69178d471a07335f05,0,Li Yang,2014-12-31 17:05:26+08:00,['d405842e06f0797a56035f3f8488ba7ce48c9411'],61,6,67,5125871,9,0.88372093,0.906976744,0.906976744,4394
96855dffedd828611ced7636a8f2a5132bdfacc0,0,shaofengshi,2014-12-31 17:17:37+08:00,['29937bd1a0633acff4bbbfba334bd7d909f71bfb'],1,6,7,5125878,1,1,1,0,4394
30ef5f23ab7d004eda7484246df7490d24a5a3e9,0,shaofengshi,2014-12-31 17:20:06+08:00,"['6be353ae9d6e4538a29fa18f6b1703cd8f5e05ce', '96855dffedd828611ced7636a8f2a5132bdfacc0']",1,6,7,5125885,1,,,,4394
2a543aaedcea8fe952c6a014faec164c4dad0b62,0,Li Yang,2014-12-31 18:34:47+08:00,['c9a792328dfd81ca52486d69178d471a07335f05'],106,82,188,5126073,1,1,0,0,4394
a0b1e448640c3e6c1ee18b2575862007e3e4ec01,0,shaofengshi,2014-12-31 21:17:22+08:00,['96855dffedd828611ced7636a8f2a5132bdfacc0'],3,4,7,5126080,1,0,0,1,4394
1e871749067dbf7acf009203a11672c68e07da76,0,shaofengshi,2014-12-31 21:21:41+08:00,"['30ef5f23ab7d004eda7484246df7490d24a5a3e9', 'a0b1e448640c3e6c1ee18b2575862007e3e4ec01']",3,4,7,5126087,1,,,,4394
b9da215064e824252cc83e509497ee2fd5cd32fb,0,shaofengshi,2014-12-31 23:10:28+08:00,['a0b1e448640c3e6c1ee18b2575862007e3e4ec01'],2,2,4,5126091,1,,,,4394
238399ee54f353c2d2edbb72e62256ff43f5e383,0,shaofengshi,2015-01-01 17:51:07+08:00,['b9da215064e824252cc83e509497ee2fd5cd32fb'],1,1,2,5126093,1,,,,4394
5a863f2a3735a64b3aa14ffc3125edd99563f1e2,0,shaofengshi,2015-01-01 17:52:25+08:00,"['1e871749067dbf7acf009203a11672c68e07da76', '238399ee54f353c2d2edbb72e62256ff43f5e383']",2,2,4,5126097,1,,,,4394
b721ded8411dda3f8263d2b95bceff467175ec5b,0,shaofengshi,2015-01-03 20:20:48+08:00,['238399ee54f353c2d2edbb72e62256ff43f5e383'],0,24,24,5126121,1,0,1,0,4394
dc5bfd7302d3830545974041a7db25313c036621,0,shaofengshi,2015-01-03 20:21:57+08:00,"['5a863f2a3735a64b3aa14ffc3125edd99563f1e2', 'b721ded8411dda3f8263d2b95bceff467175ec5b']",0,24,24,5126145,1,,,,4394
21d584b3f501c0f2bcc312b405a966c87d5e5bd4,0,shaofengshi,2015-01-03 22:01:08+08:00,['b721ded8411dda3f8263d2b95bceff467175ec5b'],27,16,43,5126188,3,1,0,0.333333333,4394
dfa4df4d8a13d5c7a2c0dcdd63ee5b0c177f277e,0,shaofengshi,2015-01-03 22:04:04+08:00,"['dc5bfd7302d3830545974041a7db25313c036621', '21d584b3f501c0f2bcc312b405a966c87d5e5bd4']",27,16,43,5126231,3,,,,4394
474c57735b89f82d6c9213bbab812941fe67d895,1,shaofengshi,2015-01-04 10:26:53+08:00,['21d584b3f501c0f2bcc312b405a966c87d5e5bd4'],194,244,438,5126669,9,0.387755102,0.346938776,0.551020408,4395
38e523923565c651bac384dae3078ca5c27029f7,0,honma,2015-01-04 11:19:11+08:00,['2a543aaedcea8fe952c6a014faec164c4dad0b62'],10012,432,10444,5137113,26,0,1,0,4414
0754d015e87f724bc54117e6a65f23d064afe676,1,cxiao,2015-01-04 11:34:44+08:00,['540de58dd6f63fcb5e6e3d9b208ed539ef35b3b2'],328,445,773,5137886,9,1,0.959459459,0.905405405,4416
47427ab0067a93bca237cb92e8a19ac97853261c,0,honma,2015-01-04 13:06:10+08:00,['38e523923565c651bac384dae3078ca5c27029f7'],37,46,83,5137969,1,0,1,1,4416
db0cf0f8babdd4a372f94c2e73d88031c04768e7,0,honma,2015-01-04 13:08:43+08:00,['47427ab0067a93bca237cb92e8a19ac97853261c'],1,1,2,5137971,1,,,,4416
0ea6af7beef665edb7e2de5f53ebf3879a2bccd6,0,Li Yang,2015-01-04 13:59:52+08:00,['db0cf0f8babdd4a372f94c2e73d88031c04768e7'],25,0,25,5137996,1,,,,4416
4f1d7c15c5bd7f051f3673b84e89a5c4878ec046,0,Zhong Jian,2015-01-04 14:07:52+08:00,['32f8158aa8fb2df29640fc265c1948c083a23659'],3,2,5,5138001,2,0,0,0,4416
575906b2d0ff365d7ed8eaa73e4753cbbbef162a,0,Zhong Jian,2015-01-04 14:08:59+08:00,['4f1d7c15c5bd7f051f3673b84e89a5c4878ec046'],24,2,26,5138027,3,,,,4416
ce4cdfcb0d4c88b0bbdc02e09de716564d353a4a,1,shaofengshi,2015-01-04 14:11:38+08:00,['474c57735b89f82d6c9213bbab812941fe67d895'],5,150,155,5138182,3,0.905405405,1,0.918918919,4417
43103801e3b6ce4c263bfaedc9edcda08d67b9eb,0,Li Yang,2015-01-04 14:14:35+08:00,['0ea6af7beef665edb7e2de5f53ebf3879a2bccd6'],111,131,242,5138424,35,,,,4417
30873f0430f1ed8dcb39b5c1d93713380e2a0a80,0,Li Yang,2015-01-04 14:15:26+08:00,['43103801e3b6ce4c263bfaedc9edcda08d67b9eb'],1,1,2,5138426,1,,,,4417
e3ebf3004360b276d96dc61194cc75d20c75c334,0,Li Yang,2015-01-04 14:16:58+08:00,['30873f0430f1ed8dcb39b5c1d93713380e2a0a80'],2,3,5,5138431,1,1,1,1,4417
3ecd6806187b02805fb0f10b78e41503f3238e75,0,honma,2015-01-04 14:25:55+08:00,['30873f0430f1ed8dcb39b5c1d93713380e2a0a80'],9,16,25,5138456,3,0.5,0.5,1,4417
0b677072878a113a981c417b805c600f0194e074,0,shaofengshi,2015-01-04 14:51:18+08:00,['db0cf0f8babdd4a372f94c2e73d88031c04768e7'],5,4,9,5138465,1,0,0,1,4417
e8941ce5a960d76ae416200217039afb307eab8f,1,shaofengshi,2015-01-04 14:52:22+08:00,['db0cf0f8babdd4a372f94c2e73d88031c04768e7'],6,5,11,5138476,1,0,0,1,4417
60164430e27fce8b5cdd229d95bf4917e1344002,0,shaofengshi,2015-01-04 14:53:19+08:00,"['e8941ce5a960d76ae416200217039afb307eab8f', '3ecd6806187b02805fb0f10b78e41503f3238e75']",146,148,294,5138770,39,,,,4417
a853557d9ac1a69995a62a8be9341ede4d8c9bc5,0,shaofengshi,2015-01-04 14:54:38+08:00,"['60164430e27fce8b5cdd229d95bf4917e1344002', '0b677072878a113a981c417b805c600f0194e074']",0,0,0,5138770,0,,,,4417
1c8fad7ec80d0d737be4594adf760cef58aad3c6,0,Li Yang,2015-01-04 15:08:21+08:00,['e3ebf3004360b276d96dc61194cc75d20c75c334'],63,51,114,5138884,4,1,1,0,4417
955385f3259179be2a486814723dd98de51983c8,0,Li Yang,2015-01-04 15:08:44+08:00,"['1c8fad7ec80d0d737be4594adf760cef58aad3c6', 'a853557d9ac1a69995a62a8be9341ede4d8c9bc5']",15,21,36,5138920,4,,,,4417
05c40b8de48119a14494b0594416236ac4424ac9,0,honma,2015-01-04 15:17:59+08:00,['955385f3259179be2a486814723dd98de51983c8'],11,11,22,5138942,3,,,,4417
bd9278ca54f561d9d2e9d225634bd85378715c8c,0,Li Yang,2015-01-04 15:24:58+08:00,['955385f3259179be2a486814723dd98de51983c8'],10,5,15,5138957,1,0,0,0,4417
18ff60be5288dc257e57ed3c4df84522d2b89b9a,0,shaofengshi,2015-01-04 16:20:40+08:00,['60164430e27fce8b5cdd229d95bf4917e1344002'],71,26,97,5139054,11,0.702702703,0.027027027,0.027027027,4417
b790675b1aa3c58490b2c8b0a5469d1d54c1f931,0,shaofengshi,2015-01-04 16:20:57+08:00,"['18ff60be5288dc257e57ed3c4df84522d2b89b9a', '955385f3259179be2a486814723dd98de51983c8']",65,54,119,5139173,5,,,,4417
5da3dac3a3a2fe270a4b95ca0c6f7e6e9c0924a1,0,Zhong Jian,2015-01-04 16:36:23+08:00,['575906b2d0ff365d7ed8eaa73e4753cbbbef162a'],0,28,28,5139201,1,1,1,0.2,4418
6ef600f06c35bc9f4831073d680db4197db60bec,0,Zhong Jian,2015-01-04 16:41:28+08:00,"['32f8158aa8fb2df29640fc265c1948c083a23659', '5da3dac3a3a2fe270a4b95ca0c6f7e6e9c0924a1']",27,32,59,5139260,6,,,,4418
bb646e3e44b44f567f2539fc24415df20adfb223,0,qianhao.zhou,2015-01-04 17:06:14+08:00,['1e6fcffb4eb9579456b054de4f752e8514f1ce24'],32,187,219,5139479,2,0.777777778,1,0.75,4418
f7ba0a7f44a2d78b87f1906b7f4e9e006f506049,1,shaofengshi,2015-01-04 17:08:18+08:00,['b790675b1aa3c58490b2c8b0a5469d1d54c1f931'],1,5,6,5139485,2,0,0,1,4418
6f11fdea5d1e7715d032c82c0b0be39bc3606b37,0,Li Yang,2015-01-04 17:09:02+08:00,['bd9278ca54f561d9d2e9d225634bd85378715c8c'],39,24,63,5139548,6,1,1,0,4418
5c908ea65c3a2be022b23e2cac9dc8f207657398,0,honma,2015-01-04 17:09:23+08:00,['05c40b8de48119a14494b0594416236ac4424ac9'],3,5,8,5139556,2,,,,4418
390df26495126a0748990a060bae5a7a38009873,0,shaofengshi,2015-01-04 17:09:31+08:00,"['f7ba0a7f44a2d78b87f1906b7f4e9e006f506049', '6f11fdea5d1e7715d032c82c0b0be39bc3606b37']",49,29,78,5139634,7,,,,4418
d41e81b61c8f77f8ed32b88297f4ae1e3abed0d3,0,shaofengshi,2015-01-04 17:11:53+08:00,"['6f11fdea5d1e7715d032c82c0b0be39bc3606b37', 'f7ba0a7f44a2d78b87f1906b7f4e9e006f506049']",72,31,103,5139737,13,,,,4418
84d4a2a672f0e6bca9cbd1615ae3eb54f85cdd6e,0,honma,2015-01-04 17:35:38+08:00,['6ef600f06c35bc9f4831073d680db4197db60bec'],3,3,6,5139743,2,,,,4418
2e1c074ff34b9be4ff52ef1b8c57234633e2c379,0,Li Yang,2015-01-04 17:48:33+08:00,['6f11fdea5d1e7715d032c82c0b0be39bc3606b37'],25,40,65,5139808,4,1,0,0,4419
ad5ad9dbb29bcc4f8550a778d5ffaba42ea9b212,0,Li Yang,2015-01-04 17:48:52+08:00,"['2e1c074ff34b9be4ff52ef1b8c57234633e2c379', 'd41e81b61c8f77f8ed32b88297f4ae1e3abed0d3']",72,31,103,5139911,13,,,,4419
2fbb8937a768f2a402b067f126c7689a29ae4775,0,Li Yang,2015-01-04 17:49:56+08:00,['ad5ad9dbb29bcc4f8550a778d5ffaba42ea9b212'],1,0,1,5139912,1,,,,4419
77bd84f602af4fec393fe04bbbb6f33ba95d1f48,1,shaofengshi,2015-01-04 17:59:14+08:00,['390df26495126a0748990a060bae5a7a38009873'],0,1,1,5139913,1,1,1,1,4419
9552ad613cd7c9f12847b4e0119652ebb9370ba6,0,qianhao.zhou,2015-01-04 18:02:53+08:00,['bb646e3e44b44f567f2539fc24415df20adfb223'],1,1,2,5139915,1,,,,4419
cae040ff76e8c0c297e02491ceeae3a68c93fd42,0,shaofengshi,2015-01-04 19:57:55+08:00,"['ad5ad9dbb29bcc4f8550a778d5ffaba42ea9b212', '77bd84f602af4fec393fe04bbbb6f33ba95d1f48']",0,1,1,5139916,1,,,,4419
3fa1ea97b246b672ed9bfd7b6481505587bdc45d,0,Luke Han,2015-01-04 21:09:59+08:00,['b9e95eae1c702f5fa741f97f83114e2dcd447f3d'],0,4,4,5139920,1,,,,4419
b9fa416cdbacd5af929d5889d2bc7052302d87d8,1,shaofengshi,2015-01-04 22:22:28+08:00,['77bd84f602af4fec393fe04bbbb6f33ba95d1f48'],3,3,6,5139926,1,,,,4419
1d33fc595948eddaffae981f2006c11403f5877f,0,shaofengshi,2015-01-04 22:24:42+08:00,"['cae040ff76e8c0c297e02491ceeae3a68c93fd42', 'b9fa416cdbacd5af929d5889d2bc7052302d87d8']",3,3,6,5139932,1,,,,4419
d2c902f6efff6dc0dd0d4b36288d49dcf403016c,0,shaofengshi,2015-01-05 09:04:54+08:00,['b9fa416cdbacd5af929d5889d2bc7052302d87d8'],2,4,6,5139938,2,,,,4419
b12aa86b9483bf0039269c1c5efbed0fc29cf38b,0,shaofengshi,2015-01-05 09:05:28+08:00,"['1d33fc595948eddaffae981f2006c11403f5877f', 'd2c902f6efff6dc0dd0d4b36288d49dcf403016c']",2,4,6,5139944,2,,,,4419
862cad8f9c33daea74892f6494b1844091ca0e4f,0,shaofengshi,2015-01-05 09:08:46+08:00,"['dfa4df4d8a13d5c7a2c0dcdd63ee5b0c177f277e', 'ce4cdfcb0d4c88b0bbdc02e09de716564d353a4a']",170,365,535,5140479,10,,,,4419
cba83c3a96372d35e489ddef13e58d0fcc91d7a3,0,cxiao,2015-01-05 10:29:06+08:00,"['0754d015e87f724bc54117e6a65f23d064afe676', '84d4a2a672f0e6bca9cbd1615ae3eb54f85cdd6e']",235,3051,3286,5143765,99,,,,4419
97dcb6ba3486bc43c1e9bc3107dd243643c763b6,0,qianhao.zhou,2015-01-05 10:31:33+08:00,['9552ad613cd7c9f12847b4e0119652ebb9370ba6'],21,256,277,5144042,8,0.475177305,0.687943262,0.936170213,4421
26449e6512ecbb16519e10f6b04593f496635267,0,shaofengshi,2015-01-05 11:13:19+08:00,['862cad8f9c33daea74892f6494b1844091ca0e4f'],43,99,142,5144184,4,0.448275862,1,0.896551724,4422
e5871bd2e3d88f35962ba7528b7aa7e9057f9937,0,qianhao.zhou,2015-01-05 11:38:11+08:00,['97dcb6ba3486bc43c1e9bc3107dd243643c763b6'],3,4,7,5144191,1,,,,4422
2dd7fb84c1aba79c09b566b63a86cb3fee7945da,0,qianhao.zhou,2015-01-05 13:02:00+08:00,"['e5871bd2e3d88f35962ba7528b7aa7e9057f9937', 'b12aa86b9483bf0039269c1c5efbed0fc29cf38b']",15897,14429,30326,5174517,258,,,,4422
9a92e43deb3ad03c0d30bff2dc1405807e08674d,1,qianhao.zhou,2015-01-05 13:02:30+08:00,['2dd7fb84c1aba79c09b566b63a86cb3fee7945da'],2,2,4,5174521,1,,,,4422
45543e9387cbeadf67d9e189b493d8e7322f0561,1,qianhao.zhou,2015-01-05 14:49:43+08:00,['9a92e43deb3ad03c0d30bff2dc1405807e08674d'],24,23,47,5174568,7,,,,4422
070a5352edb122596a7ed36035468afb8fac8403,1,cxiao,2015-01-05 15:43:15+08:00,['cba83c3a96372d35e489ddef13e58d0fcc91d7a3'],51,56,107,5174675,2,0,1,0,4422
58acef088fad44448568d4280c281183936652fd,1,honma,2015-01-05 15:59:27+08:00,['5c908ea65c3a2be022b23e2cac9dc8f207657398'],695,1012,1707,5176382,23,0.791208791,1,1,4432
6f1c6abc1cd3bc814922d7f5a9fa5d5d9ae28bbd,0,honma,2015-01-05 16:34:44+08:00,"['58acef088fad44448568d4280c281183936652fd', 'b12aa86b9483bf0039269c1c5efbed0fc29cf38b']",150,107,257,5176639,23,,,,4432
100a33efeba248a221864b5f90f695a9995466a5,0,honma,2015-01-05 16:48:15+08:00,['6f1c6abc1cd3bc814922d7f5a9fa5d5d9ae28bbd'],8,11,19,5176658,2,0.666666667,0.666666667,1,4432
3520f944d2d3852343d30dae09f89887e4ab511a,0,honma,2015-01-05 16:51:01+08:00,['100a33efeba248a221864b5f90f695a9995466a5'],3,3,6,5176664,2,,,,4432
b83900e901120ce4a45d0ce85d55450a2a152b07,1,qianhao.zhou,2015-01-05 19:12:38+08:00,['45543e9387cbeadf67d9e189b493d8e7322f0561'],156,178,334,5176998,7,1,1,0,4432
d05a2e8034ce274f3767041f66631295227982f9,1,shaofengshi,2015-01-05 21:55:26+08:00,"['b12aa86b9483bf0039269c1c5efbed0fc29cf38b', '26449e6512ecbb16519e10f6b04593f496635267']",294,581,875,5177873,28,,,,4432
9d2556da6bdd9634f236665479dd268c58fef182,0,shaofengshi,2015-01-05 22:04:08+08:00,"['3520f944d2d3852343d30dae09f89887e4ab511a', 'd05a2e8034ce274f3767041f66631295227982f9']",294,581,875,5178748,28,,,,4432
e06d61825ce2b8302e85689af880034fc032a6aa,0,shaofengshi,2015-01-06 09:49:09+08:00,['9d2556da6bdd9634f236665479dd268c58fef182'],0,4,4,5178752,1,1,1,1,4432
1b504f7484ba0c0cb4227025fb85b5e4ab9bceb6,0,shaofengshi,2015-01-06 09:50:32+08:00,"['9d2556da6bdd9634f236665479dd268c58fef182', 'e06d61825ce2b8302e85689af880034fc032a6aa']",0,4,4,5178756,1,,,,4432
c599491e038a0dbd888e2ab32c9195c78a42c4a7,0,shaofengshi,2015-01-06 10:34:01+08:00,['e06d61825ce2b8302e85689af880034fc032a6aa'],1,3,4,5178760,1,1,1,1,4432
46c1305c20f1c18e057baf36942918f7e632ef93,0,shaofengshi,2015-01-06 10:34:26+08:00,"['c599491e038a0dbd888e2ab32c9195c78a42c4a7', '1b504f7484ba0c0cb4227025fb85b5e4ab9bceb6']",0,0,0,5178760,0,,,,4432
c9cb2d5e54e109518bf50b3d5faa3f2ae41bb5d4,1,qianhao.zhou,2015-01-06 11:11:24+08:00,['b83900e901120ce4a45d0ce85d55450a2a152b07'],5,98,103,5178863,7,0.185714286,0.742857143,0.928571429,4432
b1386e1f29b991d91d333e2105f6f2d92315d72d,1,shaofengshi,2015-01-06 13:50:50+08:00,['46c1305c20f1c18e057baf36942918f7e632ef93'],112,134,246,5179109,9,1,1,1,4432
a3903c15f51f5617b3bbeb4035728e61e0c7bdbc,0,qianhao.zhou,2015-01-06 15:03:25+08:00,['c9cb2d5e54e109518bf50b3d5faa3f2ae41bb5d4'],74,141,215,5179324,15,0.217391304,1,1,4434
5dd77bffae8b46247a9ed2dd210c4043c08939da,1,Li Yang,2015-01-06 15:41:01+08:00,['2fbb8937a768f2a402b067f126c7689a29ae4775'],473,506,979,5180303,21,0,0,1,4435
0ee07d6eb2757e7ed2d9ec5a579704fa73443147,0,Li Yang,2015-01-06 16:04:29+08:00,"['5dd77bffae8b46247a9ed2dd210c4043c08939da', '1b504f7484ba0c0cb4227025fb85b5e4ab9bceb6']",1004,1615,2619,5182922,59,,,,4435
0bd82a505607fba4f51f36e889a3b83a5891a788,0,Li Yang,2015-01-06 16:06:56+08:00,['0ee07d6eb2757e7ed2d9ec5a579704fa73443147'],10,5,15,5182937,5,,,,4435
dabb87bf7cdd5ba8ab72ecbfdba95da16eb2e971,0,Li Yang,2015-01-06 16:21:59+08:00,['0bd82a505607fba4f51f36e889a3b83a5891a788'],5,11,16,5182953,4,1,1,1,4435
ffb58c8354794a26ed6e4b286945efede9d5f963,1,qianhao.zhou,2015-01-06 16:50:06+08:00,['a3903c15f51f5617b3bbeb4035728e61e0c7bdbc'],84,170,254,5183207,8,0.692307692,0.711538462,0.826923077,4435
c203146575ce3fd09deeefeb44d3e89dc658022c,0,qianhao.zhou,2015-01-06 16:50:21+08:00,"['ffb58c8354794a26ed6e4b286945efede9d5f963', '1b504f7484ba0c0cb4227025fb85b5e4ab9bceb6']",998,1611,2609,5185816,54,,,,4435
76eaef5534d9cf9499f3a396c33cd2df05b25c63,1,Li Yang,2015-01-06 16:55:26+08:00,['dabb87bf7cdd5ba8ab72ecbfdba95da16eb2e971'],23,16,39,5185855,3,0,0,0,4435
51a84011ac8bb8b58b5f1ded9fda644fc2159fd6,0,Li Yang,2015-01-06 17:16:34+08:00,['76eaef5534d9cf9499f3a396c33cd2df05b25c63'],2,2,4,5185859,1,,,,4435
71faab845323d3c3d857a3047ff1436e665f027b,0,shaofengshi,2015-01-06 17:28:48+08:00,['b1386e1f29b991d91d333e2105f6f2d92315d72d'],14,20,34,5185893,2,1,1,1,4435
92fe6ac2e5d08661f5474380b7e68af49cc6bb05,1,qianhao.zhou,2015-01-06 17:29:06+08:00,['c203146575ce3fd09deeefeb44d3e89dc658022c'],22,46,68,5185961,9,0.941176471,1,1,4435
151e3f6e7f9bd480270d6b6708f7c95903575eba,0,shaofengshi,2015-01-06 17:29:39+08:00,"['76eaef5534d9cf9499f3a396c33cd2df05b25c63', '71faab845323d3c3d857a3047ff1436e665f027b']",118,148,266,5186227,9,,,,4435
f73c90fbaaa117a61dfb04079553388d411bbdfe,0,qianhao.zhou,2015-01-06 17:35:20+08:00,"['92fe6ac2e5d08661f5474380b7e68af49cc6bb05', '151e3f6e7f9bd480270d6b6708f7c95903575eba']",646,695,1341,5187568,39,,,,4435
591de046c17b228e707b73aea95f8fa49e9b1d52,1,Li Yang,2015-01-06 18:13:20+08:00,['51a84011ac8bb8b58b5f1ded9fda644fc2159fd6'],39,66,105,5187673,4,0,1,1,4435
ef975d405adead1b5f4a48ed787104383d7acc61,0,Li Yang,2015-01-06 18:13:39+08:00,"['591de046c17b228e707b73aea95f8fa49e9b1d52', '151e3f6e7f9bd480270d6b6708f7c95903575eba']",118,148,266,5187939,9,,,,4435
253cb87ad3e3458bca96b548e359251619f987fb,0,Zhong Jian,2015-01-06 19:45:56+08:00,['84d4a2a672f0e6bca9cbd1615ae3eb54f85cdd6e'],39,28,67,5188006,6,0,0,0.8,4435
ec182a157c8b1b7eb18225e48ba93958bf0ae815,0,Zhong Jian,2015-01-06 19:50:37+08:00,"['84d4a2a672f0e6bca9cbd1615ae3eb54f85cdd6e', '253cb87ad3e3458bca96b548e359251619f987fb']",39,28,67,5188073,6,,,,4435
9d478450125a00e497bf12d808c0005875ca1e97,1,qianhao.zhou,2015-01-07 09:47:48+08:00,['f73c90fbaaa117a61dfb04079553388d411bbdfe'],63,117,180,5188253,8,1,0,0.625,4435
fc07cf836e4a7ea014e88677d18e0293a84833b4,1,qianhao.zhou,2015-01-07 10:41:01+08:00,['9d478450125a00e497bf12d808c0005875ca1e97'],50,29,79,5188332,3,0.05,0.05,0,4435
646fceaf538b2f792ad2fbe2cb0006b01a412e90,1,qianhao.zhou,2015-01-07 11:37:49+08:00,['fc07cf836e4a7ea014e88677d18e0293a84833b4'],32,32,64,5188396,3,0,0,,4435
ad9807f6a90bdc9a3b172dcc9506338783af0d12,1,qianhao.zhou,2015-01-07 11:52:10+08:00,['646fceaf538b2f792ad2fbe2cb0006b01a412e90'],93,50,143,5188539,4,0.87804878,1,0.243902439,4435
28e7af970a37c53e30df4ff35ce26bcaf0b58920,0,qianhao.zhou,2015-01-07 11:52:37+08:00,"['ad9807f6a90bdc9a3b172dcc9506338783af0d12', 'ef975d405adead1b5f4a48ed787104383d7acc61']",41,68,109,5188648,5,,,,4435
9af4113bbe4cae7126151e6aa3c4b6d953c42ef4,0,qianhao.zhou,2015-01-07 11:55:20+08:00,"['ef975d405adead1b5f4a48ed787104383d7acc61', '28e7af970a37c53e30df4ff35ce26bcaf0b58920']",436,3753,4189,5192837,62,,,,4435
502bd99a470522c0f3971a009c43625b0ff0b34b,1,cxiao,2015-01-07 13:29:52+08:00,['070a5352edb122596a7ed36035468afb8fac8403'],239,4438,4677,5197514,57,0.613951473,0.779896014,0.849220104,4483
9f5c92ee290a06b864781a4b13f89f89de1ebf15,0,cxiao,2015-01-07 13:41:11+08:00,['502bd99a470522c0f3971a009c43625b0ff0b34b'],3836,1,3837,5201351,48,0.411609499,0.202638522,0.168865435,4483
f34658d5d79b5c97c73286eb89e8be760ddc4930,1,shaofengshi,2015-01-07 14:21:52+08:00,['ef975d405adead1b5f4a48ed787104383d7acc61'],19,51,70,5201421,3,0,0.846153846,0,4483
47f67a9022fbe4b0c5eafe6f16b03fd66adb1bbb,0,cxiao,2015-01-07 14:43:02+08:00,['9f5c92ee290a06b864781a4b13f89f89de1ebf15'],1,3,4,5201425,2,1,1,1,4483
bc2bbc744fc6f29973f082fef855fcbdd82223f7,0,shaofengshi,2015-01-07 15:04:24+08:00,['ec182a157c8b1b7eb18225e48ba93958bf0ae815'],0,2,2,5201427,1,1,1,1,4483
f30641b0427e04eb5e40024433066436b40c0ffc,0,shaofengshi,2015-01-07 15:05:27+08:00,"['ec182a157c8b1b7eb18225e48ba93958bf0ae815', 'bc2bbc744fc6f29973f082fef855fcbdd82223f7']",0,2,2,5201429,1,,,,4483
c4ec97f3708b3baaa80639d4d91e621bbba1a8ae,0,shaofengshi,2015-01-07 15:55:52+08:00,['bc2bbc744fc6f29973f082fef855fcbdd82223f7'],2,1,3,5201432,1,0,0,0,4483
e890645c6453730118fcc50f1471f096a49a5621,0,shaofengshi,2015-01-07 15:57:49+08:00,"['f30641b0427e04eb5e40024433066436b40c0ffc', 'c4ec97f3708b3baaa80639d4d91e621bbba1a8ae']",2,1,3,5201435,1,,,,4483
ce226a64d52193fefe7af8ff03c7dcb2f09dfff6,1,qianhao.zhou,2015-01-07 16:02:26+08:00,['28e7af970a37c53e30df4ff35ce26bcaf0b58920'],85,296,381,5201816,9,0.566666667,0.726666667,0.973333333,4484
9d794b07592b5eb1f66f5f136f61fe0b0586caa5,0,cxiao,2015-01-07 16:43:59+08:00,['47f67a9022fbe4b0c5eafe6f16b03fd66adb1bbb'],12,6,18,5201834,2,0.428571429,0,0.428571429,4484
d1d031e4e7058b0ee6719ab93f8d88e2190493d0,0,qianhao.zhou,2015-01-07 17:04:26+08:00,['ce226a64d52193fefe7af8ff03c7dcb2f09dfff6'],10,17,27,5201861,4,1,1,1,4484
16b0646269d16920bc894992d00f46f24437e964,1,Zhong Jian,2015-01-07 17:20:48+08:00,['253cb87ad3e3458bca96b548e359251619f987fb'],4,27,31,5201892,2,0.928571429,1,1,4484
0a8677ac768d0294edd357320ffd253869de9550,0,qianhao.zhou,2015-01-07 17:49:04+08:00,['d1d031e4e7058b0ee6719ab93f8d88e2190493d0'],6,36,42,5201934,3,0.95,0.95,0.45,4484
d3be76bd4e617981756b4f16d5b6655f951fc9b2,0,qianhao.zhou,2015-01-07 18:06:13+08:00,['0a8677ac768d0294edd357320ffd253869de9550'],9,22,31,5201965,2,0,1,1,4484
af833793f11ee0d1e470506324152a303ccff673,0,qianhao.zhou,2015-01-07 18:19:18+08:00,"['9af4113bbe4cae7126151e6aa3c4b6d953c42ef4', 'd3be76bd4e617981756b4f16d5b6655f951fc9b2']",99,360,459,5202424,12,,,,4484
ddf2d48ff5f7ecb9e059c4ce80270449f83585f0,0,qianhao.zhou,2015-01-07 19:19:47+08:00,['d3be76bd4e617981756b4f16d5b6655f951fc9b2'],3,3,6,5202430,3,,,,4484
c25023d6f037919f48dc9f7b104b7093a376fbd3,0,qianhao.zhou,2015-01-07 19:20:41+08:00,"['af833793f11ee0d1e470506324152a303ccff673', 'ddf2d48ff5f7ecb9e059c4ce80270449f83585f0']",3,3,6,5202436,3,,,,4484
b0e5fbc0e1e3184a108dd5d81028d12dda1874f5,0,shaofengshi,2015-01-07 21:24:35+08:00,"['f34658d5d79b5c97c73286eb89e8be760ddc4930', 'c25023d6f037919f48dc9f7b104b7093a376fbd3']",442,4020,4462,5206898,63,,,,4484
4b631f92c0b12d0de1bf3dabe23978f9318e9aaf,0,lukehan,2015-01-07 22:42:00+08:00,['3fa1ea97b246b672ed9bfd7b6481505587bdc45d'],3,1665281,1665284,6872182,3655,0.423182549,0.693318409,0.716913097,8138
6926f19e11d5df5da97feb2be0f566dd553e61b2,1,Li Yang,2015-01-08 10:19:51+08:00,['9af4113bbe4cae7126151e6aa3c4b6d953c42ef4'],94,85,179,6872361,6,0.333333333,0,0.333333333,8138
a6fdf72db24a306aadedf9a1ba8ce4203aeaeb49,0,Li Yang,2015-01-08 10:21:07+08:00,"['6926f19e11d5df5da97feb2be0f566dd553e61b2', 'c25023d6f037919f48dc9f7b104b7093a376fbd3']",90,360,450,6872811,12,,,,8138
f1561a8b2cc2e2f3a46268261f05df7030032c4b,0,qianhao.zhou,2015-01-08 11:04:20+08:00,['c25023d6f037919f48dc9f7b104b7093a376fbd3'],1,4,5,6872816,2,0,0,1,8138
d8bad1b94e066e1fc04caf1516bb06443e404bb0,1,qianhao.zhou,2015-01-08 13:50:13+08:00,['f1561a8b2cc2e2f3a46268261f05df7030032c4b'],76,94,170,6872986,5,0,0,1,8138
ecdeea1e9fced1260f25b649119a4830c485041c,0,qianhao.zhou,2015-01-08 14:51:51+08:00,"['d8bad1b94e066e1fc04caf1516bb06443e404bb0', 'a6fdf72db24a306aadedf9a1ba8ce4203aeaeb49']",85,85,170,6873156,6,,,,8138
5f815e7e030ba994f02b7ca5cd0057db698fe58c,1,qianhao.zhou,2015-01-08 14:54:55+08:00,['ecdeea1e9fced1260f25b649119a4830c485041c'],1,1,2,6873158,1,,,,8138
a7b639a182fbab0cd208531f8469424231b45bee,0,qianhao.zhou,2015-01-08 14:55:33+08:00,"['a6fdf72db24a306aadedf9a1ba8ce4203aeaeb49', '5f815e7e030ba994f02b7ca5cd0057db698fe58c']",77,98,175,6873333,7,,,,8138
1cf04c4e2bd5ec74451c56313df6721e3a650430,0,qianhao.zhou,2015-01-08 15:56:22+08:00,['5f815e7e030ba994f02b7ca5cd0057db698fe58c'],768,91,859,6874192,5,0.486702128,0.114361702,0.103723404,8138
ddd01521f50c1e889da6e47d53379817cba337d4,0,qianhao.zhou,2015-01-08 16:26:52+08:00,['1cf04c4e2bd5ec74451c56313df6721e3a650430'],1,30,31,6874223,2,0.304347826,1,1,8138
431910191c6518d9e0f6fde4059085c52bf81afd,1,qianhao.zhou,2015-01-08 16:31:35+08:00,['ddd01521f50c1e889da6e47d53379817cba337d4'],555,21,576,6874799,7,0.581560284,0.35106383,0.195035461,8138
da1082156db44a930b0327a707623fc845da0f3d,0,qianhao.zhou,2015-01-08 17:24:44+08:00,['431910191c6518d9e0f6fde4059085c52bf81afd'],2722,78,2800,6877599,16,0.736127509,0.265053129,0.149350649,8138
9ecd239be7775db9279368b5340bf24d2bd9301d,1,qianhao.zhou,2015-01-08 18:04:50+08:00,['da1082156db44a930b0327a707623fc845da0f3d'],34,33,67,6877666,6,1,1,,8138
13c7cc68e54b93679d44b604ed4a535e5bd95c92,0,qianhao.zhou,2015-01-08 18:05:58+08:00,"['a7b639a182fbab0cd208531f8469424231b45bee', '9ecd239be7775db9279368b5340bf24d2bd9301d']",4080,253,4333,6881999,36,,,,8138
58507a2f4832c8c9e9c02f07ebce469b1b6035f3,0,qianhao.zhou,2015-01-08 20:02:51+08:00,['9ecd239be7775db9279368b5340bf24d2bd9301d'],1,0,1,6882000,1,,,,8138
5d893ec2d506ba5aa156a902a0e2a8bfce1bafee,0,qianhao.zhou,2015-01-08 20:07:51+08:00,"['13c7cc68e54b93679d44b604ed4a535e5bd95c92', '58507a2f4832c8c9e9c02f07ebce469b1b6035f3']",1,0,1,6882001,1,,,,8138
2d60b8c0d58d38ca0b72ad5f62267635d2b9caa7,1,qianhao.zhou,2015-01-08 20:29:01+08:00,['58507a2f4832c8c9e9c02f07ebce469b1b6035f3'],14,43,57,6882058,5,0.32,0.96,1,8138
e1c7e395d93cebbb07c8399023554fb1513c9909,0,qianhao.zhou,2015-01-08 20:31:11+08:00,"['5d893ec2d506ba5aa156a902a0e2a8bfce1bafee', '2d60b8c0d58d38ca0b72ad5f62267635d2b9caa7']",14,43,57,6882115,5,,,,8138
d17148415902c0541d2c6361a464e251bb23d1f2,0,qianhao.zhou,2015-01-09 10:10:51+08:00,['2d60b8c0d58d38ca0b72ad5f62267635d2b9caa7'],10,6,16,6882131,2,,,,8138
8be3148772111c716acef368698bbc730040f90c,1,honma,2015-01-09 11:25:48+08:00,['e1c7e395d93cebbb07c8399023554fb1513c9909'],12,12,24,6882155,6,,,,8138
5bde592504f7f73aa7441999668e931aba2383f4,0,honma,2015-01-09 11:25:48+08:00,['8be3148772111c716acef368698bbc730040f90c'],9,2,11,6882166,5,0,0,0,8138
fe174e5699185f5cd79f23c7ab148e72a2dfdcf4,1,honma,2015-01-09 11:27:34+08:00,['5bde592504f7f73aa7441999668e931aba2383f4'],200,219,419,6882585,20,1,1,0,8142
7d0e0ca10186e35802a37a58f9a953c0318e85ea,1,honma,2015-01-09 13:44:49+08:00,['fe174e5699185f5cd79f23c7ab148e72a2dfdcf4'],5,7,12,6882597,2,,,,8142
4924ead1100abcdf3122ddffc6e4c9ea8257c63c,0,honma,2015-01-09 14:19:32+08:00,['7d0e0ca10186e35802a37a58f9a953c0318e85ea'],5,3,8,6882605,1,,,,8142
16df422854bb080c22dcfd113f4bd79ad62ee3a3,1,cxiao,2015-01-09 17:14:32+08:00,['9d794b07592b5eb1f66f5f136f61fe0b0586caa5'],931,551,1482,6884087,10,1,0.234375,0.421875,8142
96a17abe04faf1a94632c05f54bbea370adbbd85,0,qianhao.zhou,2015-01-09 17:24:26+08:00,['d17148415902c0541d2c6361a464e251bb23d1f2'],39,152,191,6884278,4,1,0.985294118,0.941176471,8142
b7ee7da804e2d4744a0f8c8e288cc1fcbd51e968,0,qianhao.zhou,2015-01-09 17:26:13+08:00,"['96a17abe04faf1a94632c05f54bbea370adbbd85', '4924ead1100abcdf3122ddffc6e4c9ea8257c63c']",227,239,466,6884744,26,,,,8142
6fd43046382d0d445979b176abda8f17084d935c,0,qianhao.zhou,2015-01-09 17:27:18+08:00,['b7ee7da804e2d4744a0f8c8e288cc1fcbd51e968'],6,6,12,6884756,1,1,1,1,8142
52656475691ba0aaa0ff078056f379a7976fa189,0,qianhao.zhou,2015-01-09 17:28:26+08:00,"['4924ead1100abcdf3122ddffc6e4c9ea8257c63c', '6fd43046382d0d445979b176abda8f17084d935c']",42,151,193,6884949,5,,,,8142
bf8104c38054f14a423703360191c7519b6dfc70,0,Zhong Jian,2015-01-09 18:40:02+08:00,"['16b0646269d16920bc894992d00f46f24437e964', 'e890645c6453730118fcc50f1471f096a49a5621']",1,2,3,6884952,1,,,,8142
bf53aeddca51ad56ab068d5fc1f3c2fdf34c6ccf,0,Zhong Jian,2015-01-09 19:04:51+08:00,['bf8104c38054f14a423703360191c7519b6dfc70'],1,1,2,6884954,1,,,,8142
de4794f38f11db44f7e17d86c933848d63f35e0f,0,Zhong Jian,2015-01-09 20:10:33+08:00,['bf53aeddca51ad56ab068d5fc1f3c2fdf34c6ccf'],2,2,4,6884958,1,,,,8142
c1a76621d0a2c4d05d3ad6fbe2a335998f146864,0,Zhong Jian,2015-01-09 20:14:51+08:00,"['e890645c6453730118fcc50f1471f096a49a5621', 'de4794f38f11db44f7e17d86c933848d63f35e0f']",7,30,37,6884995,3,,,,8142
b7fbe8e798d88a553da640897986c417aaa62d8d,0,honma,2015-01-10 21:01:18+08:00,['52656475691ba0aaa0ff078056f379a7976fa189'],29,39,68,6885063,4,1,1,1,8142
91b70a6b4971185d63217e09e43bcd3b99ddf2de,0,shaofengshi,2015-01-12 09:23:05+08:00,['b0e5fbc0e1e3184a108dd5d81028d12dda1874f5'],41,71,112,6885175,3,0,1,1,8142
9a5b009fcf8446bdc95e1ab1633b9c0a40c72e43,0,shaofengshi,2015-01-12 09:23:29+08:00,"['91b70a6b4971185d63217e09e43bcd3b99ddf2de', 'b7fbe8e798d88a553da640897986c417aaa62d8d']",4445,798,5243,6890418,76,,,,8142
b16b08c98b9ab75998cefbe5a8172b9eafd5295b,0,luffy-xiao,2015-01-12 09:34:28+08:00,"['c1a76621d0a2c4d05d3ad6fbe2a335998f146864', '16df422854bb080c22dcfd113f4bd79ad62ee3a3']",602,1872,2474,6892892,26,,,,8142
781588a3845250df7000439a5dd3db06c726b7bf,0,qianhao.zhou,2015-01-12 09:46:04+08:00,['6fd43046382d0d445979b176abda8f17084d935c'],0,3,3,6892895,1,0,0,1,8142
96e242a6c371a087f8d9bcb418afcad97b4a2d33,0,qianhao.zhou,2015-01-12 09:51:13+08:00,['781588a3845250df7000439a5dd3db06c726b7bf'],2,0,2,6892897,1,1,0,0,8142
f34ba108644a7f68d1084d2c831fc0679139e571,0,cxiao,2015-01-12 11:02:20+08:00,['b16b08c98b9ab75998cefbe5a8172b9eafd5295b'],299,42,341,6893238,6,0.833333333,1,1,8142
2c8b78f83f8f840a91c04a20a05ffe649a19cb25,0,luffy-xiao,2015-01-12 11:10:00+08:00,"['b16b08c98b9ab75998cefbe5a8172b9eafd5295b', 'f34ba108644a7f68d1084d2c831fc0679139e571']",299,42,341,6893579,6,,,,8142
d94d7ab33bc70e8fce358c7aff41feb8736a4cc6,0,shaofengshi,2015-01-12 11:24:53+08:00,['9a5b009fcf8446bdc95e1ab1633b9c0a40c72e43'],1,2,3,6893582,1,1,1,1,8142
f439e90ad084b1d97fb625e30208d2dd05d94293,0,cxiao,2015-01-12 11:45:04+08:00,['f34ba108644a7f68d1084d2c831fc0679139e571'],6,9,15,6893597,2,,,,8142
8eb1b03f4d9bf0be953f2e909c310e7ffbb8a9c8,1,shaofengshi,2015-01-12 12:41:59+08:00,['d94d7ab33bc70e8fce358c7aff41feb8736a4cc6'],12,15,27,6893624,2,0.333333333,0.333333333,0.333333333,8142
e688061b01f4589e75d8634c4b679b1e11b3df11,0,luffy-xiao,2015-01-12 12:51:24+08:00,"['2c8b78f83f8f840a91c04a20a05ffe649a19cb25', 'f439e90ad084b1d97fb625e30208d2dd05d94293']",6,9,15,6893639,2,,,,8142
b9625c83079374577ec706372d965d9c709430c3,0,Li Yang,2015-01-12 13:05:15+08:00,['e890645c6453730118fcc50f1471f096a49a5621'],0,1,1,6893640,1,0,0,0,8142
f834781701f9c4d52dd3beb77cbc15be43715720,0,Li Yang,2015-01-12 13:05:39+08:00,"['b9625c83079374577ec706372d965d9c709430c3', 'e688061b01f4589e75d8634c4b679b1e11b3df11']",610,1649,2259,6895899,28,,,,8142
92ea82bb0269567189bdbc5328af34d68e3eb344,1,honma,2015-01-12 13:17:08+08:00,['b7fbe8e798d88a553da640897986c417aaa62d8d'],76,29,105,6896004,3,0,0,0,8142
ef1092a12e13be8aa6eb0ea57b93030e43462000,0,shaofengshi,2015-01-12 13:33:26+08:00,['8eb1b03f4d9bf0be953f2e909c310e7ffbb8a9c8'],2,3,5,6896009,3,0,1,1,8142
3ef346800cfe311d0759e9b19e0ee9922879c0d6,0,shaofengshi,2015-01-12 13:34:25+08:00,"['92ea82bb0269567189bdbc5328af34d68e3eb344', 'ef1092a12e13be8aa6eb0ea57b93030e43462000']",67,134,201,6896210,8,,,,8142
4ccf0740773c355c0b2507c856219c400dedfa9a,1,cxiao,2015-01-12 14:05:20+08:00,['f439e90ad084b1d97fb625e30208d2dd05d94293'],7,10,17,6896227,1,,,,8142
4e46be21368792cc9e8e2ac8286bb87b47ceea6e,0,luffy-xiao,2015-01-12 14:07:50+08:00,"['f834781701f9c4d52dd3beb77cbc15be43715720', '4ccf0740773c355c0b2507c856219c400dedfa9a']",7,10,17,6896244,1,,,,8142
ef82f4b004af08ebf41ac062a80f1d5600e89f02,0,qianhao.zhou,2015-01-12 14:54:17+08:00,['96e242a6c371a087f8d9bcb418afcad97b4a2d33'],422,171,593,6896837,49,0.282894737,0,0.052631579,8142
c9f2a07c70b9a821bf220ce707ddfb3baf7978a1,0,qianhao.zhou,2015-01-12 14:56:13+08:00,"['3ef346800cfe311d0759e9b19e0ee9922879c0d6', 'ef82f4b004af08ebf41ac062a80f1d5600e89f02']",424,174,598,6897435,50,,,,8142
64afd8759570a8add8f0138f63394ebbadb3302a,1,qianhao.zhou,2015-01-12 15:14:13+08:00,['ef82f4b004af08ebf41ac062a80f1d5600e89f02'],0,248,248,6897683,1,0.717105263,1,0.947368421,8143
40ed2871a817ebad2cedf0bd22f6249354fb2c08,0,qianhao.zhou,2015-01-12 15:16:15+08:00,"['c9f2a07c70b9a821bf220ce707ddfb3baf7978a1', '64afd8759570a8add8f0138f63394ebbadb3302a']",0,248,248,6897931,1,,,,8143
7256a4806b73bd1847975b9985a021873eb4c05a,1,cxiao,2015-01-12 15:28:18+08:00,['4ccf0740773c355c0b2507c856219c400dedfa9a'],13,11,24,6897955,3,0,0,0,8143
aeed2edeeb4838a259ed62aacaa3d77b63476bc7,0,luffy-xiao,2015-01-12 15:30:44+08:00,"['4e46be21368792cc9e8e2ac8286bb87b47ceea6e', '7256a4806b73bd1847975b9985a021873eb4c05a']",13,11,24,6897979,3,,,,8143
5d5c2cd66a5a70586234487eb8b2d60c4cc677b7,0,qianhao.zhou,2015-01-12 15:39:29+08:00,['64afd8759570a8add8f0138f63394ebbadb3302a'],1259,34,1293,6899272,28,0.533707865,0.31835206,0.170411985,8143
ef2efcb442c43643457e4a7da9b802341aef0e4b,0,qianhao.zhou,2015-01-12 15:53:45+08:00,"['5d5c2cd66a5a70586234487eb8b2d60c4cc677b7', '40ed2871a817ebad2cedf0bd22f6249354fb2c08']",170,200,370,6899642,14,,,,8143
9c21e6c7606b455cfa92f0a1680dff2229e0765c,1,Li Yang,2015-01-12 17:15:37+08:00,['f834781701f9c4d52dd3beb77cbc15be43715720'],3,5,8,6899650,1,,,,8143
d409e3788ea5eddbecba9b5a523256f515dc0091,0,Li Yang,2015-01-12 17:16:03+08:00,"['9c21e6c7606b455cfa92f0a1680dff2229e0765c', 'aeed2edeeb4838a259ed62aacaa3d77b63476bc7']",20,21,41,6899691,3,,,,8143
59d1d0e886adb3b920d4878ced0ccbf334f5e847,0,qianhao.zhou,2015-01-12 17:35:35+08:00,['ef2efcb442c43643457e4a7da9b802341aef0e4b'],2,24,26,6899717,1,0,1,1,8143
055856829f8dd62f35e0591b571c752b1f275dba,0,qianhao.zhou,2015-01-12 17:41:13+08:00,"['40ed2871a817ebad2cedf0bd22f6249354fb2c08', '59d1d0e886adb3b920d4878ced0ccbf334f5e847']",1261,58,1319,6901036,29,,,,8143
f22769c57cd4dbbb8de7c6bb57c4a6c3d971caf9,0,Li Yang,2015-01-12 18:06:12+08:00,['055856829f8dd62f35e0591b571c752b1f275dba'],8,6,14,6901050,2,,,,8143
61370f342ae57827754c127cbf8b53a503524f32,1,qianhao.zhou,2015-01-13 09:58:31+08:00,['f22769c57cd4dbbb8de7c6bb57c4a6c3d971caf9'],5,9,14,6901064,1,1,1,1,8143
3b1aaa0cbcc2b1b0e4e31aa5a739239f76a80321,0,qianhao.zhou,2015-01-13 10:01:26+08:00,"['f22769c57cd4dbbb8de7c6bb57c4a6c3d971caf9', '61370f342ae57827754c127cbf8b53a503524f32']",5,9,14,6901078,1,,,,8143
dc323632fbcbb8ea2a567714ab521bf759114cf2,0,honma,2015-01-13 10:07:14+08:00,['3b1aaa0cbcc2b1b0e4e31aa5a739239f76a80321'],631,610,1241,6902319,13,1,1,0.117647059,8143
c96190d7666416ce29f905dc1315729792735565,1,honma,2015-01-13 10:07:15+08:00,['dc323632fbcbb8ea2a567714ab521bf759114cf2'],103,65,168,6902487,14,1,1,1,8143
82ce7eebbd067d47d3bb5325a248ff0dd8845f01,0,honma,2015-01-13 10:07:15+08:00,['c96190d7666416ce29f905dc1315729792735565'],108,115,223,6902710,39,0,0,0,8143
209daecc454368cb8f5049ab8fc0a3323866b63d,1,honma,2015-01-13 10:07:15+08:00,['82ce7eebbd067d47d3bb5325a248ff0dd8845f01'],13,3,16,6902726,5,0.4,0.4,0.4,8143
8e78b59f7ab64538c38f6d3b98a177b5d9f20a3b,0,Li Yang,2015-01-13 13:24:11+08:00,['d409e3788ea5eddbecba9b5a523256f515dc0091'],0,0,0,6902726,1,,,,8143
40c5523c039a5f915e148569110ec5792da5788a,0,Li Yang,2015-01-13 13:49:15+08:00,['4b631f92c0b12d0de1bf3dabe23978f9318e9aaf'],0,1,1,6902727,1,,,,8143
d7ddbe0abdea740487ae7693269f165bbd4dc244,0,Li Yang,2015-01-13 13:49:44+08:00,['40c5523c039a5f915e148569110ec5792da5788a'],1,0,1,6902728,1,,,,8143
de626a7d3fa909b0cc2f8cd7a300677a58707876,1,qianhao.zhou,2015-01-13 14:59:15+08:00,['61370f342ae57827754c127cbf8b53a503524f32'],102,78,180,6902908,4,0,0,0.357142857,8143
3f21470b78e93c70b4b44c18a5c69d283f408bb4,0,honma,2015-01-13 15:33:50+08:00,['d7ddbe0abdea740487ae7693269f165bbd4dc244'],0,1,1,6902909,1,,,,8143
05a66da12ce1447cc8ed158446d116c47310e3a9,0,qianhao.zhou,2015-01-13 15:39:24+08:00,['de626a7d3fa909b0cc2f8cd7a300677a58707876'],47,3,50,6902959,3,0,0,0,8143
77f0ce152c85a33af19819810973f9873b843c7d,0,qianhao.zhou,2015-01-13 16:28:52+08:00,['05a66da12ce1447cc8ed158446d116c47310e3a9'],30,12,42,6903001,4,1,0,0.307692308,8143
c1aa4df7ec9573fa26c2a5ebf839f90cb4126233,0,qianhao.zhou,2015-01-13 16:29:15+08:00,"['77f0ce152c85a33af19819810973f9873b843c7d', '209daecc454368cb8f5049ab8fc0a3323866b63d']",849,787,1636,6904637,56,,,,8143
87b455e65ada8c7784d045796a204ed4bc1399d1,0,Li Yang,2015-01-13 18:14:22+08:00,['8e78b59f7ab64538c38f6d3b98a177b5d9f20a3b'],1,1,2,6904639,1,,,,8143
f3a3cd5107410f236f757d008276f9f93bd97031,0,honma,2015-01-13 20:05:13+08:00,['87b455e65ada8c7784d045796a204ed4bc1399d1'],0,1,1,6904640,2,,,,8144
81b2914919e856070708120eae01da598cd6bcd6,0,qianhao.zhou,2015-01-14 11:04:01+08:00,['c1aa4df7ec9573fa26c2a5ebf839f90cb4126233'],4,12,16,6904656,2,1,0,0,8144
5ec65be735ce0f0581859da326df50a1fcc79bb6,0,qianhao.zhou,2015-01-14 11:10:36+08:00,['81b2914919e856070708120eae01da598cd6bcd6'],0,3,3,6904659,1,0,1,1,8144
27a589c07701cf99592963f6e1a58436da5f2d27,0,qianhao.zhou,2015-01-14 11:12:32+08:00,"['209daecc454368cb8f5049ab8fc0a3323866b63d', '5ec65be735ce0f0581859da326df50a1fcc79bb6']",175,100,275,6904934,10,,,,8144
dd598471d5a7432203170f3930a77c5b44cae9ad,0,qianhao.zhou,2015-01-14 11:18:00+08:00,['5ec65be735ce0f0581859da326df50a1fcc79bb6'],2,0,2,6904936,1,,,,8144
6163264ffc94f9ea6024bd5302e9ed272d6f44dc,0,honma,2015-01-14 11:18:59+08:00,['209daecc454368cb8f5049ab8fc0a3323866b63d'],0,1,1,6904937,1,,,,8144
378300e0b89124a7c1051a91759b34ab9f84d6f1,0,hongbin ma,2015-01-14 11:25:54+08:00,"['27a589c07701cf99592963f6e1a58436da5f2d27', '6163264ffc94f9ea6024bd5302e9ed272d6f44dc']",0,1,1,6904938,1,,,,8144
a2d96c14623a8e8ec3ea3a2a6c77c530bfcf1423,0,qianhao.zhou,2015-01-14 11:44:53+08:00,"['378300e0b89124a7c1051a91759b34ab9f84d6f1', 'dd598471d5a7432203170f3930a77c5b44cae9ad']",2,0,2,6904940,1,,,,8144
704c8ad53b1fed2800fd165de96eff183e6458b2,0,honma,2015-01-14 14:21:34+08:00,['f5b334e08142204d0c43ac5fd62e97377aa7e3e1'],0,1,1,6904941,2,,,,8145
340a99b3df843ea84c6a4226745b95c7986b235d,1,shaofengshi,2015-01-14 14:34:40+08:00,['209daecc454368cb8f5049ab8fc0a3323866b63d'],267,253,520,6905461,7,1,1,1,8146
4800804d23ccd7ef7636976934a6b0b39f17877c,0,shaofengshi,2015-01-14 14:41:23+08:00,"['a2d96c14623a8e8ec3ea3a2a6c77c530bfcf1423', '340a99b3df843ea84c6a4226745b95c7986b235d']",267,253,520,6905981,7,,,,8146
3963ed8664afe71960ae5ed0c4d3faf7b7d84c4b,1,qianhao.zhou,2015-01-14 16:16:57+08:00,['4800804d23ccd7ef7636976934a6b0b39f17877c'],85,64,149,6906130,11,0.666666667,0,0,8146
33bcc0db5b7e52f350c3aa8254b6f1eb27dd92de,0,shaofengshi,2015-01-14 16:50:31+08:00,['4800804d23ccd7ef7636976934a6b0b39f17877c'],64,85,149,6906279,4,0.5,1,1,8146
948b967cdbc80b1399992f9066f147938e4241c8,0,shaofengshi,2015-01-14 17:03:02+08:00,"['4800804d23ccd7ef7636976934a6b0b39f17877c', '33bcc0db5b7e52f350c3aa8254b6f1eb27dd92de']",64,85,149,6906428,4,,,,8146
11e86ff1583505992634dd547f49ec39f5aa2243,0,shaofengshi,2015-01-14 17:28:37+08:00,['33bcc0db5b7e52f350c3aa8254b6f1eb27dd92de'],5,12,17,6906445,7,,,,8146
1ffb3b51f862631f1f3fe7b0e11fbf3aa6475bee,0,shaofengshi,2015-01-14 17:46:15+08:00,"['948b967cdbc80b1399992f9066f147938e4241c8', '11e86ff1583505992634dd547f49ec39f5aa2243']",5,12,17,6906462,7,,,,8146
9f84e90bc031f50381d781f118eea4e697941fe6,1,honma,2015-01-14 18:05:45+08:00,['1ffb3b51f862631f1f3fe7b0e11fbf3aa6475bee'],10,55,65,6906527,10,0.304347826,1,1,8147
ce2090135f69706a27b0d3eeb22844f6cb4fa3b3,0,honma,2015-01-14 18:05:45+08:00,['9f84e90bc031f50381d781f118eea4e697941fe6'],169,234,403,6906930,6,0,0.086956522,0.608695652,8147
4788fcd8ad4330a32834f48dde69dfe77cbb6773,0,honma,2015-01-14 18:05:45+08:00,['ce2090135f69706a27b0d3eeb22844f6cb4fa3b3'],53,57,110,6907040,6,0,0,1,8147
3bda345eec7f72030cb09cf0ef62e97fd8ca0599,0,honma,2015-01-14 18:05:45+08:00,['4788fcd8ad4330a32834f48dde69dfe77cbb6773'],8,7,15,6907055,3,1,1,1,8147
4f5bf6f9738fd84dec79f5139f1cb6648f511645,0,qianhao.zhou,2015-01-14 18:18:47+08:00,"['3bda345eec7f72030cb09cf0ef62e97fd8ca0599', '3963ed8664afe71960ae5ed0c4d3faf7b7d84c4b']",85,64,149,6907204,11,,,,8147
eccf656a1d6cb6040834b981be08f263bcbbde3f,0,Luke Han,2015-01-14 20:02:44+08:00,"['704c8ad53b1fed2800fd165de96eff183e6458b2', 'f3a3cd5107410f236f757d008276f9f93bd97031']",833,4616,5449,6912653,109,,,,8147
a60e165231f68aa4cc65cae561084cf4384af85f,0,Luke Han,2015-01-14 20:54:28+08:00,['eccf656a1d6cb6040834b981be08f263bcbbde3f'],11,11,22,6912675,11,,,,8147
f78eb4d4cdba0c4f53b2236074b2b290e1a8c125,1,qianhao.zhou,2015-01-14 21:05:58+08:00,['3963ed8664afe71960ae5ed0c4d3faf7b7d84c4b'],73,18,91,6912766,2,0.666666667,1,1,8147
6478c4868bde7e27c3a8273881c6b8c71a313d32,0,lukehan,2015-01-14 22:15:15+08:00,['3f21470b78e93c70b4b44c18a5c69d283f408bb4'],1665286,0,1665286,8578052,3655,0.576817451,0.306681591,0.283086903,8147
3726c8a48d6fef09d708586b7a8c4f7064832a3a,0,lukehan,2015-01-14 22:16:47+08:00,['6478c4868bde7e27c3a8273881c6b8c71a313d32'],0,2,2,8578054,1,,,,8148
9c31590f5b85c2a0321926ef20791987bdaa230f,0,honma,2015-01-15 09:53:37+08:00,['a60e165231f68aa4cc65cae561084cf4384af85f'],1,2,3,8578057,1,0,0,1,8148
4af9da6bc644cd909c45e76e9136fd0f4a0136ca,0,qianhao.zhou,2015-01-15 09:58:00+08:00,"['f78eb4d4cdba0c4f53b2236074b2b290e1a8c125', '4f5bf6f9738fd84dec79f5139f1cb6648f511645']",256,397,653,8578710,24,,,,8148
70d1e12a433104c7096416908c49236c207df057,0,qianhao.zhou,2015-01-15 10:08:07+08:00,"['4af9da6bc644cd909c45e76e9136fd0f4a0136ca', '9c31590f5b85c2a0321926ef20791987bdaa230f']",668,1706,2374,8581084,53,,,,8148
e0407ad5e519566f269c26f899f680a835dfe0f6,0,honma,2015-01-15 10:11:34+08:00,['9c31590f5b85c2a0321926ef20791987bdaa230f'],5,5,10,8581094,1,,,,8148
5e61ea712bfb74332f72ad5d535d1b15d576dae5,0,qianhao.zhou,2015-01-15 10:26:43+08:00,"['70d1e12a433104c7096416908c49236c207df057', 'e0407ad5e519566f269c26f899f680a835dfe0f6']",16,16,32,8581126,12,,,,8148
b4e00eefcf38849a21861352b92706f28097823e,0,qianhao.zhou,2015-01-15 10:29:19+08:00,"['4f5bf6f9738fd84dec79f5139f1cb6648f511645', '5e61ea712bfb74332f72ad5d535d1b15d576dae5']",747,1730,2477,8583603,56,,,,8148
9031114a1662196031d9951f96813511752b665c,0,qianhao.zhou,2015-01-15 11:00:36+08:00,['b4e00eefcf38849a21861352b92706f28097823e'],13,22,35,8583638,3,0.666666667,0.666666667,0.666666667,8148
536dae9318a172da225a20adb48b7fcabe1a173b,1,qianhao.zhou,2015-01-15 11:35:13+08:00,['9031114a1662196031d9951f96813511752b665c'],0,56,56,8583694,1,1,1,1,8149
e0a7cae53c4ecf866bc3e3fd677d0d46a553358f,0,qianhao.zhou,2015-01-15 11:36:07+08:00,"['b4e00eefcf38849a21861352b92706f28097823e', '536dae9318a172da225a20adb48b7fcabe1a173b']",13,78,91,8583785,4,,,,8149
255f1be35bf5287e2b4ddd7ee0c0e2144bad234b,1,qianhao.zhou,2015-01-15 14:23:59+08:00,['e0a7cae53c4ecf866bc3e3fd677d0d46a553358f'],8,7,15,8583800,3,0,,,8149
1b50af3eaffe248cedb15607a601a6f103c6808a,0,honma,2015-01-15 15:13:12+08:00,['e0407ad5e519566f269c26f899f680a835dfe0f6'],29,553,582,8584382,3,,,,8150
cea9c87c74b48b905a856ce506092abb7141f117,0,honma,2015-01-15 15:30:17+08:00,['1b50af3eaffe248cedb15607a601a6f103c6808a'],0,34,34,8584416,2,,,,8150
a3f839f00f64e0740ee6da1f38eaa8a7b25fbefc,0,honma,2015-01-15 15:35:17+08:00,['cea9c87c74b48b905a856ce506092abb7141f117'],0,7,7,8584423,1,,,,8150
f78dfd12b00a207e256d3f23b0472959cde8bacd,1,qianhao.zhou,2015-01-15 17:43:46+08:00,['255f1be35bf5287e2b4ddd7ee0c0e2144bad234b'],79,152,231,8584654,11,0.428571429,0.428571429,0.428571429,8151
1514d65c02193de55fc95bf6d68d261a362d063a,0,lukehan,2015-01-15 20:04:02+08:00,"['9c31590f5b85c2a0321926ef20791987bdaa230f', '3726c8a48d6fef09d708586b7a8c4f7064832a3a']",0,0,0,8584654,0,,,,8151
e402e6a06a5f44f546a8829abe0eedf85dc8c57c,0,lukehan,2015-01-15 21:52:32+08:00,['1514d65c02193de55fc95bf6d68d261a362d063a'],92,2,94,8584748,1,,,,8151
62bca0abf8acbf0c18aeb24b632f3ee7b951a89a,0,lukehan,2015-01-15 21:54:11+08:00,['e402e6a06a5f44f546a8829abe0eedf85dc8c57c'],0,94,94,8584842,1,,,,8152
e3bbbf1ed0ffcec635d8bf6028c7d2fe877292e6,0,Luke Han,2015-01-15 21:55:29+08:00,['62bca0abf8acbf0c18aeb24b632f3ee7b951a89a'],2,3,5,8584847,1,,,,8152
eb6d21e99baa58afd16fa7b88e97d84401dff426,0,Luke Han,2015-01-15 21:57:48+08:00,['e3bbbf1ed0ffcec635d8bf6028c7d2fe877292e6'],0,5,5,8584852,1,,,,8152
8a57e7cc929ada5813b7a69e21b2407fb79cf0f0,0,Li Yang,2015-01-16 12:16:09+08:00,['e0407ad5e519566f269c26f899f680a835dfe0f6'],1,6,7,8584859,2,0,0,1,8152
5ea053cb9cc7bc979ddc0d97725ba0126f1d961d,0,Li Yang,2015-01-16 12:16:30+08:00,"['8a57e7cc929ada5813b7a69e21b2407fb79cf0f0', 'a3f839f00f64e0740ee6da1f38eaa8a7b25fbefc']",29,594,623,8585482,3,,,,8152
c1aee65a024e14aa79a801b891e07f73836fff8e,0,Li Yang,2015-01-16 13:20:31+08:00,['5ea053cb9cc7bc979ddc0d97725ba0126f1d961d'],2,0,2,8585484,1,1,1,0,8152
0a636d2dc207cc03aa5978f537283ad824d85567,0,Li Yang,2015-01-16 13:58:41+08:00,['c1aee65a024e14aa79a801b891e07f73836fff8e'],5,7,12,8585496,2,1,1,1,8152
bc36c0acbf3fe1cb4ad9d76d53ec8d2509647311,1,shaofengshi,2015-01-16 15:20:57+08:00,['e0a7cae53c4ecf866bc3e3fd677d0d46a553358f'],245,866,1111,8586607,30,0.873076923,1,1,8161
97dc6cd92bb14af5c768ed08186ac1d51ff379d4,1,Zhong Jian,2015-01-16 01:39:33-08:00,['a3f839f00f64e0740ee6da1f38eaa8a7b25fbefc'],450,483,933,8587540,5,1,0.586206897,1,8162
7687c4ed036087299105fbd63fb63afa5723607d,0,Li Yang,2015-01-16 22:31:28+00:00,['bc36c0acbf3fe1cb4ad9d76d53ec8d2509647311'],22,0,22,8587562,4,,,,8162
b82a7eff3c5bbd10408851e8d8d5813a10cc1b27,0,Li Yang,2015-01-16 22:38:59+00:00,['0a636d2dc207cc03aa5978f537283ad824d85567'],5,6,11,8587573,1,,,,8162
d68e0e44013e99749b61d5eaa57099ed38176c1b,0,honma,2015-01-17 11:59:38+08:00,['0a636d2dc207cc03aa5978f537283ad824d85567'],2,0,2,8587575,1,,,,8162
66b36bd7bfac64e7824693164ea67301dbacf307,0,qianhao.zhou,2015-01-19 10:16:30+08:00,"['f78dfd12b00a207e256d3f23b0472959cde8bacd', '7687c4ed036087299105fbd63fb63afa5723607d']",245,844,1089,8588664,26,,,,8162
a152f787e17f1601248380ab0fe8420b9dd5f91a,1,qianhao.zhou,2015-01-19 10:32:14+08:00,['66b36bd7bfac64e7824693164ea67301dbacf307'],98,285,383,8589047,8,0.835616438,1,1,8165
8554e5685408cd1f480e039e007a997c45ba3581,0,Li Yang,2015-01-19 13:54:08+08:00,['b82a7eff3c5bbd10408851e8d8d5813a10cc1b27'],1,1,2,8589049,1,,,,8165
ad8c391c9552571c5850f0c0306220dfcd6398b2,0,Li Yang,2015-01-19 13:55:51+08:00,['8554e5685408cd1f480e039e007a997c45ba3581'],1,7,8,8589057,1,0,0,1,8165
ee0ec39ff5829ecc822199c77bc4cee72d2773bb,0,Li Yang,2015-01-19 13:56:15+08:00,"['ad8c391c9552571c5850f0c0306220dfcd6398b2', 'd68e0e44013e99749b61d5eaa57099ed38176c1b']",2,0,2,8589059,1,,,,8165
1e1a6394064a0e7ac1c06d1c5c2a403175d51cd8,0,shaofengshi,2015-01-19 15:14:32+08:00,['7687c4ed036087299105fbd63fb63afa5723607d'],123,88,211,8589270,8,1,1,1,8165
7dcdfdcb0efcc5fb2ec87a675bb5981d0b07c021,0,shaofengshi,2015-01-19 15:19:08+08:00,['7687c4ed036087299105fbd63fb63afa5723607d'],124,93,217,8589487,9,1,1,1,8165
8f168901ed82b82490ebb4b469c9e09b831feb21,0,shaofengshi,2015-01-19 15:20:09+08:00,"['7dcdfdcb0efcc5fb2ec87a675bb5981d0b07c021', '1e1a6394064a0e7ac1c06d1c5c2a403175d51cd8']",0,0,0,8589487,0,,,,8165
ea94f013358c50189778973a76acb2947b337fa0,0,Li Yang,2015-01-19 15:20:18+08:00,['ee0ec39ff5829ecc822199c77bc4cee72d2773bb'],1,1,2,8589489,1,,,,8165
53ee6ef0faa59375178216773032ded23da13806,0,qianhao.zhou,2015-01-19 15:38:31+08:00,"['a152f787e17f1601248380ab0fe8420b9dd5f91a', 'ea94f013358c50189778973a76acb2947b337fa0']",31,597,628,8590117,5,,,,8165
894a25aeaf62363c2b5fded74a2053b1915b0949,1,qianhao.zhou,2015-01-19 15:49:27+08:00,['53ee6ef0faa59375178216773032ded23da13806'],36,70,106,8590223,7,0,0.783783784,1,8165
6a3e5fdbc5dbb0c41104a774195377ecd4971cba,0,qianhao.zhou,2015-01-19 15:50:43+08:00,"['7687c4ed036087299105fbd63fb63afa5723607d', '894a25aeaf62363c2b5fded74a2053b1915b0949']",155,1014,1169,8591392,28,,,,8165
7b78d8eb6985ba7ecd6e6c64c87cc2340dbe3993,0,Zhong Jian,2015-01-18 23:57:40-08:00,"['ea94f013358c50189778973a76acb2947b337fa0', '97dc6cd92bb14af5c768ed08186ac1d51ff379d4']",450,483,933,8592325,5,,,,8165
95103fb7f0c5aec53b67a94f93bf6e3b5f5d8d96,0,Li Yang,2015-01-19 16:03:12+08:00,['7687c4ed036087299105fbd63fb63afa5723607d'],10,10,20,8592345,1,1,1,1,8165
ddddb374416f599946f2f6735dee092a7b86a2ad,0,honma,2015-01-19 16:04:39+08:00,['7b78d8eb6985ba7ecd6e6c64c87cc2340dbe3993'],12,12,24,8592369,1,,,,8165
2720f70625772c04a9f653bcb3db90334fad7590,1,honma,2015-01-19 16:04:39+08:00,['ddddb374416f599946f2f6735dee092a7b86a2ad'],86,162,248,8592617,33,0.525,1,1,8167
76434456fe8f20a5f9f1694b08ecf94770d6fa4a,1,Li Yang,2015-01-19 16:59:35+08:00,['95103fb7f0c5aec53b67a94f93bf6e3b5f5d8d96'],56,61,117,8592734,4,0,1,1,8167
90eb239212c35543aa30a345691f1c686f76602d,0,Li Yang,2015-01-19 17:22:52+08:00,['76434456fe8f20a5f9f1694b08ecf94770d6fa4a'],30,33,63,8592797,3,0,0.333333333,0,8167
1372dae94fbbb8b7f00abf4e7afb97df18e7d279,1,honma,2015-01-19 17:47:46+08:00,['2720f70625772c04a9f653bcb3db90334fad7590'],4657,27,4684,8597481,13,,,,8167
e65d607b7317e5eb4ca0e154a3358f38f1cf195a,0,honma,2015-01-19 18:21:05+08:00,['1372dae94fbbb8b7f00abf4e7afb97df18e7d279'],5,5,10,8597491,2,,,,8167
40cfb49499b28482594298726f9b97c0d3b75c6c,1,honma,2015-01-19 19:08:34+08:00,['e65d607b7317e5eb4ca0e154a3358f38f1cf195a'],1,1,2,8597493,1,,,,8167
e41c35611d642ed0ae20e7ac66b14e7ae165673e,0,honma,2015-01-19 20:31:56+08:00,['40cfb49499b28482594298726f9b97c0d3b75c6c'],8,8,16,8597509,2,,,,8167
65b655ad99e7cea068474db4a2281207db9da35b,1,shaofengshi,2015-01-19 21:07:04+08:00,['8f168901ed82b82490ebb4b469c9e09b831feb21'],5,3553,3558,8601067,35,0.546171171,0.628378378,0.972972973,8196
fd6dd43b571a953f4a91667e3458bcd18f9d4db6,0,honma,2015-01-19 21:33:55+08:00,['e41c35611d642ed0ae20e7ac66b14e7ae165673e'],27,20,47,8601114,1,,,,8196
b71a88419327c366dbbe11339de5c49bc55e4567,1,Zhong Jian,2015-01-19 06:37:13-08:00,['7687c4ed036087299105fbd63fb63afa5723607d'],77,107,184,8601298,7,1,0.64,1,8197
98af9115d01928cdda5f8baca78804a4749122fa,1,Li Yang,2015-01-20 10:18:22+08:00,['90eb239212c35543aa30a345691f1c686f76602d'],90,168,258,8601556,8,0.41025641,0.897435897,1,8198
e52692b3092edf5b8d200b8bc47c3c9e805f730c,0,Li Yang,2015-01-20 10:21:02+08:00,"['98af9115d01928cdda5f8baca78804a4749122fa', '6a3e5fdbc5dbb0c41104a774195377ecd4971cba']",156,1014,1170,8602726,28,,,,8198
ab2fc20c0faf0d8727ce1258d540f25bd4635fb0,0,Li Yang,2015-01-20 05:15:40+00:00,"['e52692b3092edf5b8d200b8bc47c3c9e805f730c', 'fd6dd43b571a953f4a91667e3458bcd18f9d4db6']",5290,800,6090,8608816,57,,,,8198
792c60932749348e9eaad4fd8049cae70a37ad85,1,honma,2015-01-20 15:31:17+08:00,['fd6dd43b571a953f4a91667e3458bcd18f9d4db6'],11,51,62,8608878,2,0,0,1,8198
4d2cc875fddc755e209b7861cb74e64e5c54337e,1,honma,2015-01-20 16:03:43+08:00,['792c60932749348e9eaad4fd8049cae70a37ad85'],26,12,38,8608916,3,1,1,0,8198
b5cf4ee57858fa085722264da5828e5dfc1cbb31,0,honma,2015-01-20 16:12:43+08:00,['4d2cc875fddc755e209b7861cb74e64e5c54337e'],1,1,2,8608918,1,,,,8198
58b7fda30661bfa8c3092a965cedb7a6f4f1fa1c,0,honma,2015-01-20 16:33:22+08:00,['b5cf4ee57858fa085722264da5828e5dfc1cbb31'],29,16,45,8608963,3,0,0,0,8198
bcad6ae2c6112e7cafa4d17244e4bfb311b86c8d,0,honma,2015-01-20 17:05:00+08:00,['58b7fda30661bfa8c3092a965cedb7a6f4f1fa1c'],30,14,44,8609007,2,,,,8198
811f6a87ed3391a5111a1ce021de2dec417f357b,1,qianhao.zhou,2015-01-20 17:34:31+08:00,['ab2fc20c0faf0d8727ce1258d540f25bd4635fb0'],46,184,230,8609237,7,0.085714286,1,0.904761905,8198
b5b268d9cd10f9f7be5f46c785abf57dbd3ac5a0,0,honma,2015-01-20 17:57:28+08:00,['bcad6ae2c6112e7cafa4d17244e4bfb311b86c8d'],4,4,8,8609245,2,,,,8198
5f63cb204d4085020537ed9feefebdf00bf8af63,1,shaofengshi,2015-01-20 19:12:13+08:00,['65b655ad99e7cea068474db4a2281207db9da35b'],69,773,842,8610087,16,0.5129683,0.76945245,0.945244957,8202
f5d2752163207a929ac8e9bf1264501a5e8ac8e3,1,shaofengshi,2015-01-20 19:15:05+08:00,['5f63cb204d4085020537ed9feefebdf00bf8af63'],69,123,192,8610279,1,0,0,1,8202
a84db25cbce00f1d8d099e62fa7ecea1fdaa3f2a,1,Li Yang,2015-01-20 19:15:42+08:00,['ab2fc20c0faf0d8727ce1258d540f25bd4635fb0'],70,2638,2708,8612987,26,0.317880795,0,0,8215
06fcb582c352f8f56af7ec4fb7462b78118e9f03,0,Li Yang,2015-01-20 19:16:18+08:00,"['a84db25cbce00f1d8d099e62fa7ecea1fdaa3f2a', '811f6a87ed3391a5111a1ce021de2dec417f357b']",46,184,230,8613217,7,,,,8215
17e43a8ce92eb95050ce7e084e86559fd0857065,0,shaofengshi,2015-01-20 19:32:41+08:00,"['f5d2752163207a929ac8e9bf1264501a5e8ac8e3', '06fcb582c352f8f56af7ec4fb7462b78118e9f03']",5708,4869,10577,8623794,113,,,,8215
cd2317bcac357c99a10f4e1d8abba2cccef4096f,0,SHAOFENG SHI,2015-01-20 19:33:17+08:00,"['06fcb582c352f8f56af7ec4fb7462b78118e9f03', '17e43a8ce92eb95050ce7e084e86559fd0857065']",162,4438,4600,8628394,56,,,,8215
9b153c019ee367ec34c618b5a5e657167112b826,1,shaofengshi,2015-01-20 20:16:22+08:00,['17e43a8ce92eb95050ce7e084e86559fd0857065'],58,55,113,8628507,8,1,1,0,8215
b6fe2f47532433dc07e2967a8e367b8a4a7d1479,0,shaofengshi,2015-01-20 20:17:34+08:00,"['9b153c019ee367ec34c618b5a5e657167112b826', 'cd2317bcac357c99a10f4e1d8abba2cccef4096f']",0,0,0,8628507,0,,,,8215
1f8ee7859b369e7cf331e8aa3e1b13147e3e0a72,0,SHAOFENG SHI,2015-01-20 20:18:43+08:00,"['cd2317bcac357c99a10f4e1d8abba2cccef4096f', 'b6fe2f47532433dc07e2967a8e367b8a4a7d1479']",58,55,113,8628620,8,,,,8215
642fdfe5afeb3f9479e5d854475becd701082914,1,qianhao.zhou,2015-01-20 21:07:32+08:00,['06fcb582c352f8f56af7ec4fb7462b78118e9f03'],114,132,246,8628866,3,1,1,0.2,8216
2bbf61f985e9e0a8363432be9d6c0638cdee92cd,0,qianhao.zhou,2015-01-20 21:07:43+08:00,"['642fdfe5afeb3f9479e5d854475becd701082914', '1f8ee7859b369e7cf331e8aa3e1b13147e3e0a72']",163,4436,4599,8633465,57,,,,8216
5e37a76472c46d0f572463766507507746e83aa6,1,Zhong Jian,2015-01-20 06:33:48-08:00,['b71a88419327c366dbbe11339de5c49bc55e4567'],14,54,68,8633533,11,0.25,1,0.928571429,8216
5ca47184691df0a372a0b0e68e8c09bbb830034f,0,lukehan,2015-01-20 23:35:34+08:00,['b5b268d9cd10f9f7be5f46c785abf57dbd3ac5a0'],0,31684,31684,8665217,113,0.968316832,0.82970297,0.906930693,8329
5efc267afbcbc257484949db0914920e606e5603,0,lukehan,2015-01-20 23:50:23+08:00,['5ca47184691df0a372a0b0e68e8c09bbb830034f'],3,11,14,8665231,1,,,,8329
9e32fba057aef703e145b3046410cd2b196779b4,1,"Shao Feng, Shi",2015-01-21 10:48:09+08:00,['2bbf61f985e9e0a8363432be9d6c0638cdee92cd'],2,41,43,8665274,4,1,1,1,8329
b1e625e424781fee02345f4c9f78800e2b650658,0,"Shao Feng, Shi",2015-01-21 11:54:50+08:00,"['9e32fba057aef703e145b3046410cd2b196779b4', '5efc267afbcbc257484949db0914920e606e5603']",86,31784,31870,8697144,120,,,,8329
fec16eb7b4df8832ba90ada5b02081294fccbdca,1,Li Yang,2015-01-21 14:29:17+08:00,['06fcb582c352f8f56af7ec4fb7462b78118e9f03'],3415,3415,6830,8703974,30,,,,8337
57a43feb352a3bfdb4144e8c2fb7bf1e60d6cf43,0,Li Yang,2015-01-21 14:36:00+08:00,['fec16eb7b4df8832ba90ada5b02081294fccbdca'],0,4,4,8703978,1,0,1,1,8337
6b4a34468ad937627a1bd25f350b77e4a781809f,0,Li Yang,2015-01-21 14:36:22+08:00,"['57a43feb352a3bfdb4144e8c2fb7bf1e60d6cf43', 'b1e625e424781fee02345f4c9f78800e2b650658']",365,36393,36758,8740736,181,,,,8337
a84bb59c7370aa7662d3c84eea04afa431856e23,0,Zhong Jian,2015-01-20 22:45:24-08:00,"['5e37a76472c46d0f572463766507507746e83aa6', '6b4a34468ad937627a1bd25f350b77e4a781809f']",6921,42108,49029,8789765,284,,,,8337
1c77f28588b648ab4aaf55c9a5540f0fd67b91db,1,Li Yang,2015-01-21 16:45:01+08:00,['6b4a34468ad937627a1bd25f350b77e4a781809f'],80,66,146,8789911,7,0,0,0,8337
98d44b4fb5d434518812294c2aeb6c92d7ee609f,0,Zhong Jian,2015-01-21 00:57:40-08:00,"['a84bb59c7370aa7662d3c84eea04afa431856e23', '1c77f28588b648ab4aaf55c9a5540f0fd67b91db']",80,66,146,8790057,7,,,,8337
8ca1d08735e2006f39f97e9e6ecaeaae4a7edf86,0,Li Yang,2015-01-21 17:05:52+08:00,['1c77f28588b648ab4aaf55c9a5540f0fd67b91db'],8,17,25,8790082,6,1,1,1,8337
7534a47c16a84d7c9f3651c7bfb943e13baaa48d,1,qianhao.zhou,2015-01-21 17:10:25+08:00,['6b4a34468ad937627a1bd25f350b77e4a781809f'],49,201,250,8790332,10,0.480314961,0.779527559,1,8337
58df5edcaf1796f57fe62f9bddabeb29461d4d98,0,qianhao.zhou,2015-01-21 17:10:36+08:00,"['7534a47c16a84d7c9f3651c7bfb943e13baaa48d', '1c77f28588b648ab4aaf55c9a5540f0fd67b91db']",80,66,146,8790478,7,,,,8337
0120ffc00031f31cc1992bbc43f074a2f1205767,0,qianhao.zhou,2015-01-21 17:41:40+08:00,['58df5edcaf1796f57fe62f9bddabeb29461d4d98'],4,4,8,8790486,4,,,,8337
db4e0abbbee489401cb37cf430913bbedb083bf3,1,Zhong Jian,2015-01-21 09:42:41-08:00,['98d44b4fb5d434518812294c2aeb6c92d7ee609f'],138,135,273,8790759,16,0,0,0,8337
bfa6e7aa3fc67d2e09ac9fa226d73385cdc2b0f7,1,Zhong Jian,2015-01-21 09:54:23-08:00,['db4e0abbbee489401cb37cf430913bbedb083bf3'],3,4,7,8790766,1,0,0,0,8337
1731d9ff8eff32868c80a8e5f633204e68007906,0,qianhao.zhou,2015-01-22 11:06:02+08:00,['0120ffc00031f31cc1992bbc43f074a2f1205767'],2,4,6,8790772,3,0,0,1,8337
c2de4caea238a7f127c2c929f32d4b0b489e4211,0,Li Yang,2015-01-22 11:07:43+08:00,['8ca1d08735e2006f39f97e9e6ecaeaae4a7edf86'],8,12,20,8790792,2,0.333333333,1,0.333333333,8337
c0db27fbbb8d4646668d4ed60502bc5101fb1dd9,0,Li Yang,2015-01-22 11:08:06+08:00,"['c2de4caea238a7f127c2c929f32d4b0b489e4211', '1731d9ff8eff32868c80a8e5f633204e68007906']",53,207,260,8791052,13,,,,8337
b0fb5c22c5026e9f57a64422e1dab8dee38b611a,0,qianhao.zhou,2015-01-22 11:51:27+08:00,['1731d9ff8eff32868c80a8e5f633204e68007906'],13,5,18,8791070,3,0,0,0,8337
9b0558877f873ce73931021f4238313fe7e8ea38,0,qianhao.zhou,2015-01-22 11:53:03+08:00,"['b0fb5c22c5026e9f57a64422e1dab8dee38b611a', 'c0db27fbbb8d4646668d4ed60502bc5101fb1dd9']",16,29,45,8791115,7,,,,8337
65bddf244de42f730cb864ee4fd986edee78da2d,0,"Shao Feng, Shi",2015-01-22 14:04:45+08:00,['1c77f28588b648ab4aaf55c9a5540f0fd67b91db'],8,37,45,8791160,5,0.944444444,0.944444444,1,8337
3d6315eed0f8b2ff99aad5ea92a3584790d00269,0,"Shao Feng, Shi",2015-01-22 14:05:11+08:00,"['65bddf244de42f730cb864ee4fd986edee78da2d', '9b0558877f873ce73931021f4238313fe7e8ea38']",70,229,299,8791459,20,,,,8337
6eb987414a69b039d84986f80a1d754595255edf,0,Li Yang,2015-01-22 14:32:16+08:00,['c0db27fbbb8d4646668d4ed60502bc5101fb1dd9'],8,11,19,8791478,4,0.5,1,1,8337
9dc10d8751f54a36f27748a70046c0c1647493c3,0,Li Yang,2015-01-22 14:32:38+08:00,"['6eb987414a69b039d84986f80a1d754595255edf', '3d6315eed0f8b2ff99aad5ea92a3584790d00269']",21,42,63,8791541,8,,,,8337
68a3626932c882f07695ff50df07cc4f649e83b7,0,Li Yang,2015-01-22 16:38:29+08:00,['5efc267afbcbc257484949db0914920e606e5603'],39,51,90,8791631,2,0.428571429,0,1,8337
5661f4227a7a66e7fe14e47fceda1ce0b2b1595a,0,Li Yang,2015-01-22 08:41:26+00:00,"['9dc10d8751f54a36f27748a70046c0c1647493c3', '68a3626932c882f07695ff50df07cc4f649e83b7']",41,53,94,8791725,2,,,,8337
7b85e5f0f2c11aa59af0a52ac4eb3063a8903c33,1,Li Yang,2015-01-22 16:44:56+08:00,['5661f4227a7a66e7fe14e47fceda1ce0b2b1595a'],80,19,99,8791824,6,1,0,0,8337
b6e78e93fe95d084b9a78f34e0b971b3e1db3b93,1,Li Yang,2015-01-22 17:24:44+08:00,['7b85e5f0f2c11aa59af0a52ac4eb3063a8903c33'],10,10,20,8791844,1,,,,8337
97c6ce285ed00cad125d5cc55f589ba29d3e513f,0,"Shao Feng, Shi",2015-01-22 17:31:50+08:00,['7b85e5f0f2c11aa59af0a52ac4eb3063a8903c33'],0,3,3,8791847,2,1,1,1,8337
1c117bf1a4eb2b3347290bceb0c063355f682eb6,0,honma,2015-01-22 17:33:54+08:00,['68a3626932c882f07695ff50df07cc4f649e83b7'],2,2,4,8791851,1,,,,8337
178fe13ba3c8091dbbc164b426ba891f47deee13,0,honma,2015-01-22 17:33:54+08:00,['1c117bf1a4eb2b3347290bceb0c063355f682eb6'],2,29,31,8791882,2,,,,8338
748e1451e86c3048ad5bd6475646e06d07cf0533,1,qianhao.zhou,2015-01-22 17:35:49+08:00,['9b0558877f873ce73931021f4238313fe7e8ea38'],45,226,271,8792153,4,0.190217391,0.190217391,0.891304348,8338
eea0f8d540cb477f61a04a63d4ec27a24a57fab9,0,qianhao.zhou,2015-01-22 17:36:20+08:00,"['748e1451e86c3048ad5bd6475646e06d07cf0533', '97c6ce285ed00cad125d5cc55f589ba29d3e513f']",137,123,260,8792413,19,,,,8338
a56a96a71925ecde36b58c5c3cddada8f5a15863,1,Li Yang,2015-01-22 17:40:21+08:00,['b6e78e93fe95d084b9a78f34e0b971b3e1db3b93'],113,65,178,8792591,8,0.666666667,1,0.666666667,8338
f9e7fe17489cffd7a56c533207aed5934c137a70,0,Li Yang,2015-01-22 17:40:44+08:00,"['a56a96a71925ecde36b58c5c3cddada8f5a15863', 'eea0f8d540cb477f61a04a63d4ec27a24a57fab9']",45,229,274,8792865,6,,,,8338
2b1d07604dc79fa710834f3052f5424ae9910a34,0,honma,2015-01-22 17:42:11+08:00,['178fe13ba3c8091dbbc164b426ba891f47deee13'],0,8,8,8792873,1,,,,8338
ac83b411567d4b26d79a03f28204ddc243e7df61,0,honma,2015-01-22 17:47:21+08:00,['2b1d07604dc79fa710834f3052f5424ae9910a34'],1,0,1,8792874,1,,,,8338
7cca8c3a3582216b60fc51f4057257d722ca1db9,0,honma,2015-01-22 17:54:33+08:00,['ac83b411567d4b26d79a03f28204ddc243e7df61'],15,12,27,8792901,1,,,,8338
d96d217ba9483f5ab878c92f1aa05cb28cdc7d15,0,"Shao Feng, Shi",2015-01-22 17:56:54+08:00,['97c6ce285ed00cad125d5cc55f589ba29d3e513f'],16,23,39,8792940,1,1,1,1,8338
0ba49ae9a31c763068666af4cdc1021f3708cc83,0,"Shao Feng, Shi",2015-01-22 17:57:04+08:00,"['d96d217ba9483f5ab878c92f1aa05cb28cdc7d15', 'f9e7fe17489cffd7a56c533207aed5934c137a70']",168,301,469,8793409,13,,,,8338
7755666dc56d3889f7bf2a4bb481b75f9e80bc51,0,Li Yang,2015-01-22 18:02:37+08:00,['7cca8c3a3582216b60fc51f4057257d722ca1db9'],59,1,60,8793469,1,1,0,0,8338
3b8ab08453578bdcd802fd52e043f4ddcafcb88a,0,honma,2015-01-22 18:17:56+08:00,['7755666dc56d3889f7bf2a4bb481b75f9e80bc51'],2,3,5,8793474,1,,,,8338
c5f0e60fc89d1336fa848527b02cb76ed323bdf2,0,honma,2015-01-22 21:51:16+08:00,['3b8ab08453578bdcd802fd52e043f4ddcafcb88a'],137,10,147,8793621,7,0,0,0,8338
3bff5cb5de14deeec268e8c705e9c9aa98ddc59a,0,honma,2015-01-22 22:07:45+08:00,['c5f0e60fc89d1336fa848527b02cb76ed323bdf2'],9,0,9,8793630,1,,,,8338
ab6d05f28f296544b38d0b12a41662c39f0303a2,1,Zhong Jian,2015-01-22 06:22:13-08:00,['bfa6e7aa3fc67d2e09ac9fa226d73385cdc2b0f7'],21,66,87,8793717,8,1,1,1,8338
b14aff763d3994606f055dd7bfc1d85abb1fb268,0,Zhong Jian,2015-01-22 06:25:03-08:00,"['ab6d05f28f296544b38d0b12a41662c39f0303a2', '0ba49ae9a31c763068666af4cdc1021f3708cc83']",388,671,1059,8794776,41,,,,8338
778bd0faad560730c8bfd1b481877319a807578d,0,Han,2015-01-23 10:56:31+08:00,['3bff5cb5de14deeec268e8c705e9c9aa98ddc59a'],613,27,640,8795416,6,,,,8338
9d8bad9331602293f3523470c7c5f83198175642,0,Han,2015-01-23 10:56:45+08:00,['778bd0faad560730c8bfd1b481877319a807578d'],0,1044,1044,8796460,12,,,,8350
a8a46649d17e063ae6d815362435b8a47a61faec,0,honma,2015-01-23 11:07:37+08:00,['3bff5cb5de14deeec268e8c705e9c9aa98ddc59a'],4,4,8,8796468,1,0,1,0,8350
2be1682a9b2559046c93f1ca504180dd3565ea31,0,Zhong Jian,2015-01-22 19:27:28-08:00,['a8a46649d17e063ae6d815362435b8a47a61faec'],4,2,6,8796474,3,,,,8350
64c5a42c525db91a521bd579503e56d0a925663a,0,honma,2015-01-23 13:15:42+08:00,['a8a46649d17e063ae6d815362435b8a47a61faec'],3,3,6,8796480,3,,,,8350
3e1340a7eb6823b8c8b9e35bda6d09c9cc89745a,0,honma,2015-01-23 13:44:03+08:00,"['0ba49ae9a31c763068666af4cdc1021f3708cc83', '64c5a42c525db91a521bd579503e56d0a925663a']",414,310,724,8797204,11,,,,8350
e7de90a858069420a1c0e7ba19cad466bbff156b,0,Zhong Jian,2015-01-22 21:54:22-08:00,['2be1682a9b2559046c93f1ca504180dd3565ea31'],23,0,23,8797227,1,0,0,0,8350
8b5f9fbe91d897adda2ad8a6a8b4e6b6aff97c7e,0,qianhao.zhou,2015-01-23 14:04:49+08:00,['eea0f8d540cb477f61a04a63d4ec27a24a57fab9'],0,4,4,8797231,2,1,1,1,8351
847216395aea294b6d86a5f28f7aaf99212b54fb,0,qianhao.zhou,2015-01-23 14:05:21+08:00,"['8b5f9fbe91d897adda2ad8a6a8b4e6b6aff97c7e', '3e1340a7eb6823b8c8b9e35bda6d09c9cc89745a']",553,408,961,8798192,20,,,,8351
e4504af1a0c0546eb22f2224b2922180948be8af,1,Li Yang,2015-01-23 14:13:32+08:00,['0ba49ae9a31c763068666af4cdc1021f3708cc83'],222,164,386,8798578,6,0.620689655,1,0.310344828,8351
63bcbf355c8d439c0bdbba253d2cdbf5175c8d58,1,"Shao Feng, Shi",2015-01-23 14:49:34+08:00,['0ba49ae9a31c763068666af4cdc1021f3708cc83'],2,2,4,8798582,2,,,,8351
6f2d3e196a16ee87a7907d91715a94831f83b18e,0,"Shao Feng, Shi",2015-01-23 14:49:45+08:00,"['63bcbf355c8d439c0bdbba253d2cdbf5175c8d58', '847216395aea294b6d86a5f28f7aaf99212b54fb']",414,314,728,8799310,13,,,,8351
ba2909d3d6b23673f5fe5a9a889d9907c4236b3d,0,qianhao.zhou,2015-01-23 15:34:52+08:00,['847216395aea294b6d86a5f28f7aaf99212b54fb'],0,37,37,8799347,1,,,,8352
ed84597904ef7cc8931bfa6e137e109090ad1062,0,qianhao.zhou,2015-01-23 15:35:11+08:00,"['ba2909d3d6b23673f5fe5a9a889d9907c4236b3d', '6f2d3e196a16ee87a7907d91715a94831f83b18e']",2,2,4,8799351,2,,,,8352
400f091674a41a0365c292e6bd97ec19b86268ab,1,Li Yang,2015-01-23 15:45:44+08:00,['e4504af1a0c0546eb22f2224b2922180948be8af'],30,30,60,8799411,14,1,0,1,8352
3456d047906b8d7f3c0b5a9d358a19872bbdeecc,0,Li Yang,2015-01-23 15:47:43+08:00,"['400f091674a41a0365c292e6bd97ec19b86268ab', 'ed84597904ef7cc8931bfa6e137e109090ad1062']",416,353,769,8800180,16,,,,8352
9cc2aa35ec25a0f9c366e7de02a6d087474ed8f4,0,Zhong Jian,2015-01-23 00:19:13-08:00,"['e7de90a858069420a1c0e7ba19cad466bbff156b', '64c5a42c525db91a521bd579503e56d0a925663a']",3,3,6,8800186,3,,,,8352
89ada554ab63ddf4e698a3f12b4f487db244884f,0,"Shao Feng, Shi",2015-01-23 16:19:55+08:00,['6f2d3e196a16ee87a7907d91715a94831f83b18e'],7,16,23,8800209,2,1,1,0.714285714,8352
1824aaf31f7635ce5aaedd73f64dd00077a25104,1,qianhao.zhou,2015-01-23 16:20:29+08:00,['ed84597904ef7cc8931bfa6e137e109090ad1062'],199,180,379,8800588,35,,,,8352
c9d1a17ed10d9b4ba4c52324619d825712ead19a,0,"Shao Feng, Shi",2015-01-23 16:20:53+08:00,"['89ada554ab63ddf4e698a3f12b4f487db244884f', '3456d047906b8d7f3c0b5a9d358a19872bbdeecc']",249,228,477,8801065,19,,,,8352
952a20eb58c67b63fe4591a6a9fad82f1f9e0797,0,qianhao.zhou,2015-01-23 16:21:34+08:00,"['1824aaf31f7635ce5aaedd73f64dd00077a25104', '3456d047906b8d7f3c0b5a9d358a19872bbdeecc']",244,185,429,8801494,18,,,,8352
aea19c96810bdce1b9048697645d0516a5be81a5,0,qianhao.zhou,2015-01-23 16:22:15+08:00,"['952a20eb58c67b63fe4591a6a9fad82f1f9e0797', 'c9d1a17ed10d9b4ba4c52324619d825712ead19a']",7,16,23,8801517,2,,,,8352
9fffc5ade03b8e1dac21c8e7c5fa51bbf2f0fdd2,0,Han,2015-01-23 16:34:50+08:00,"['9d8bad9331602293f3523470c7c5f83198175642', '64c5a42c525db91a521bd579503e56d0a925663a']",7,7,14,8801531,4,,,,8352
121e6371d6572241626dc6cf5c98e3b30d76f43f,1,qianhao.zhou,2015-01-23 17:00:56+08:00,['aea19c96810bdce1b9048697645d0516a5be81a5'],130,69,199,8801730,20,0,0,0,8352
e8dad2a54871a48046e9b418afcb8663ff0cefc0,0,qianhao.zhou,2015-01-23 18:19:55+08:00,['121e6371d6572241626dc6cf5c98e3b30d76f43f'],25,15,40,8801770,2,1,0.375,0,8352
8ac02fc22e250c00212cc71aae9e4d0bab7f5354,1,Li Yang,2015-01-23 18:32:15+08:00,['3456d047906b8d7f3c0b5a9d358a19872bbdeecc'],234,180,414,8802184,8,0.205882353,0.088235294,0,8352
0cef2763ad55a704395c9083940b103bd9a60d2b,0,Li Yang,2015-01-23 18:32:39+08:00,"['8ac02fc22e250c00212cc71aae9e4d0bab7f5354', 'e8dad2a54871a48046e9b418afcb8663ff0cefc0']",325,243,568,8802752,38,,,,8352
00bfccf47f987e7eb722cb72718baeec298d9e9b,0,Zhong Jian,2015-01-24 01:01:53-08:00,"['b14aff763d3994606f055dd7bfc1d85abb1fb268', '0cef2763ad55a704395c9083940b103bd9a60d2b']",1205,947,2152,8804904,65,,,,8352
b5152641147bee679c89f3cbe33677b00f4dff6f,1,Zhong Jian,2015-01-24 06:32:53-08:00,['00bfccf47f987e7eb722cb72718baeec298d9e9b'],42,37,79,8804983,15,1,1,1,8352
8c44efc1a39e8e26de794023921c0c8b1adb48f8,0,"Shao Feng, Shi",2015-01-24 22:53:12+08:00,['0cef2763ad55a704395c9083940b103bd9a60d2b'],1,4,5,8804988,2,1,1,1,8352
457575771eca9437c076640f8ffe43a8d5e7ca35,0,"Shao Feng, Shi",2015-01-25 18:57:32+08:00,['8c44efc1a39e8e26de794023921c0c8b1adb48f8'],1,1,2,8804990,1,,,,8352
b7ef6930f6a95d11a8708c87efe8345244e4ca4a,0,Zhong Jian,2015-01-25 06:08:42-08:00,"['b5152641147bee679c89f3cbe33677b00f4dff6f', '457575771eca9437c076640f8ffe43a8d5e7ca35']",2,5,7,8804997,3,,,,8352
5016bc80c8613385d52f2bef4c580e3832106c9d,0,"Shao Feng, Shi",2015-01-25 22:13:12+08:00,['457575771eca9437c076640f8ffe43a8d5e7ca35'],2,40,42,8805039,1,0,0.35483871,1,8352
cfe7306b3e0f54a4910e83bf98e45ad5593b05d5,1,Zhong Jian,2015-01-25 07:06:30-08:00,['b7ef6930f6a95d11a8708c87efe8345244e4ca4a'],30,16,46,8805085,5,0,1,0,8352
22cd3b5cc450cec97cb1438abef8765f807f505d,0,lukehan,2015-01-25 23:12:56+08:00,['9fffc5ade03b8e1dac21c8e7c5fa51bbf2f0fdd2'],208,90,298,8805383,15,,,,8352
f208a2adf8bfeb90c0944264999449b62b0dd639,0,Zhong Jian,2015-01-25 08:55:38-08:00,['cfe7306b3e0f54a4910e83bf98e45ad5593b05d5'],0,5,5,8805388,1,1,1,1,8352
dedca88a2dfeb01ba4fc654e1f615e4a62579a62,1,Zhong Jian,2015-01-25 18:19:05-08:00,['f208a2adf8bfeb90c0944264999449b62b0dd639'],1,1,2,8805390,1,,,,8352
1528897116aaa93fc5ad9c8b2b3597f76749e29d,0,Zhong Jian,2015-01-25 18:22:02-08:00,"['5016bc80c8613385d52f2bef4c580e3832106c9d', 'dedca88a2dfeb01ba4fc654e1f615e4a62579a62']",448,539,987,8806377,19,,,,8352
8b4714416f9de6680557f693c6a8cb5dc67e1a1e,0,qianhao.zhou,2015-01-26 10:29:08+08:00,['e8dad2a54871a48046e9b418afcb8663ff0cefc0'],1,28,29,8806406,2,1,1,1,8353
299f7b48cef665f22bba30f43cf59daede739b9b,1,Li Yang,2015-01-26 10:29:33+08:00,['0cef2763ad55a704395c9083940b103bd9a60d2b'],19,17,36,8806442,4,,,,8353
672b0a705ad44f1375a35fe08cf0617109374c3a,0,qianhao.zhou,2015-01-26 10:31:08+08:00,"['8b4714416f9de6680557f693c6a8cb5dc67e1a1e', '1528897116aaa93fc5ad9c8b2b3597f76749e29d']",686,764,1450,8807892,30,,,,8353
55bad0a00cae11e307a24b20dffc160e1603ce89,0,Li Yang,2015-01-26 10:32:51+08:00,"['299f7b48cef665f22bba30f43cf59daede739b9b', '672b0a705ad44f1375a35fe08cf0617109374c3a']",453,612,1065,8808957,25,,,,8353
8579128abeae14a0f10ec23bb394b094b2821b13,0,qianhao.zhou,2015-01-26 11:03:57+08:00,['672b0a705ad44f1375a35fe08cf0617109374c3a'],4,18,22,8808979,2,1,1,1,8353
0a61799a133603f4c3f1effefc07d0eaee5b60a0,0,qianhao.zhou,2015-01-26 11:04:12+08:00,"['8579128abeae14a0f10ec23bb394b094b2821b13', '55bad0a00cae11e307a24b20dffc160e1603ce89']",19,17,36,8809015,4,,,,8353
17a6d564d7bda03ccb3c59fd0b1e8e26781de791,0,Li Yang,2015-01-26 11:13:45+08:00,['55bad0a00cae11e307a24b20dffc160e1603ce89'],29,15,44,8809059,2,0,0,0,8353
0314539ac09aff629bde038210824ca9832f0b62,1,Zhong Jian,2015-01-25 19:20:49-08:00,['dedca88a2dfeb01ba4fc654e1f615e4a62579a62'],7,17,24,8809083,9,1,1,1,8353
9cfe6f89e8d2cc89efd47449068b895e051fc8a3,0,"Shao Feng, Shi",2015-01-26 11:21:10+08:00,['5016bc80c8613385d52f2bef4c580e3832106c9d'],4,11,15,8809098,1,0.5,1,1,8353
580f5a35f02bee5549b48c5663c669f50f9debfd,0,"Shao Feng, Shi",2015-01-26 11:21:26+08:00,"['9cfe6f89e8d2cc89efd47449068b895e051fc8a3', '0a61799a133603f4c3f1effefc07d0eaee5b60a0']",469,599,1068,8810166,26,,,,8353
81d66d67855b730ce522d7881cee1ea39319ddaa,0,Zhong Jian,2015-01-25 19:21:59-08:00,"['580f5a35f02bee5549b48c5663c669f50f9debfd', '0314539ac09aff629bde038210824ca9832f0b62']",7,17,24,8810190,9,,,,8353
79dcdbc9c0193be73e7c3ebf986f857210f2fe01,0,"Shao Feng, Shi",2015-01-26 13:25:49+08:00,['81d66d67855b730ce522d7881cee1ea39319ddaa'],2,0,2,8810192,1,1,0,0,8353
d09674ee9ac2f62ff808dc508393f9be83fc0cc2,1,qianhao.zhou,2015-01-26 14:47:57+08:00,['81d66d67855b730ce522d7881cee1ea39319ddaa'],2,3,5,8810197,1,0,0,1,8353
e15ad687234eccc9d640a1cc552fc470f49b50b1,0,qianhao.zhou,2015-01-26 14:48:14+08:00,"['d09674ee9ac2f62ff808dc508393f9be83fc0cc2', '79dcdbc9c0193be73e7c3ebf986f857210f2fe01']",2,0,2,8810199,1,,,,8353
ca765330472511dd8fd1106230699055c2bb5dfb,0,qianhao.zhou,2015-01-26 15:03:00+08:00,['e15ad687234eccc9d640a1cc552fc470f49b50b1'],3,3,6,8810205,3,,,,8353
18d0c980aa7543f027cd873b8a126ff5cf48031a,0,Zhong Jian,2015-01-25 23:16:06-08:00,"['9cc2aa35ec25a0f9c366e7de02a6d087474ed8f4', '22cd3b5cc450cec97cb1438abef8765f807f505d']",233,573,806,8811011,22,,,,8353
ba461902c023dd0811be8e8a84356c5ce51cd326,0,qianhao.zhou,2015-01-26 15:18:11+08:00,['ca765330472511dd8fd1106230699055c2bb5dfb'],33,1,34,8811045,3,0.740740741,0.740740741,0,8353
9c98e0cb3d3a34fbdbe31578862b6c59887daf38,1,qianhao.zhou,2015-01-26 15:25:19+08:00,['ba461902c023dd0811be8e8a84356c5ce51cd326'],2,2,4,8811049,2,,,,8353
df8a91ef70f6628c98a312500415c1795a7324b1,0,"Shao Feng, Shi",2015-01-26 15:55:14+08:00,['79dcdbc9c0193be73e7c3ebf986f857210f2fe01'],10,21,31,8811080,3,1,1,1,8353
03d6759f4a35372369209d6ead8608ccf4662d36,0,Li Yang,2015-01-26 15:57:01+08:00,"['17a6d564d7bda03ccb3c59fd0b1e8e26781de791', '9c98e0cb3d3a34fbdbe31578862b6c59887daf38']",57,55,112,8811192,22,,,,8353
a4115e79e3c9d59ad11acd31b64860b0defd0308,0,"Shao Feng, Shi",2015-01-26 16:04:05+08:00,"['df8a91ef70f6628c98a312500415c1795a7324b1', '9c98e0cb3d3a34fbdbe31578862b6c59887daf38']",40,9,49,8811241,9,,,,8353
2f0106e7012e9c195b118724ced36d54d62f31d3,1,Li Yang,2015-01-26 16:06:57+08:00,['03d6759f4a35372369209d6ead8608ccf4662d36'],116,218,334,8811575,4,1,1,0.28,8353
11992580138b839ca1e8b580b5ff5f3c57d32667,1,"Shao Feng, Shi",2015-01-26 16:16:46+08:00,['a4115e79e3c9d59ad11acd31b64860b0defd0308'],2,5,7,8811582,3,1,1,0.75,8353
d4ddabfcdf60a59ecaa865c7db55ba50f84a55fc,0,qianhao.zhou,2015-01-26 16:18:18+08:00,['9c98e0cb3d3a34fbdbe31578862b6c59887daf38'],18,0,18,8811600,1,1,0,0,8353
65294c5adcc8a1f442949ed718a6356f6fbe0440,0,qianhao.zhou,2015-01-26 16:18:33+08:00,"['d4ddabfcdf60a59ecaa865c7db55ba50f84a55fc', '11992580138b839ca1e8b580b5ff5f3c57d32667']",11,25,36,8811636,5,,,,8353
245f63f637831f22e0194b229451c41650eb8291,0,Zhong Jian,2015-01-26 00:36:31-08:00,['18d0c980aa7543f027cd873b8a126ff5cf48031a'],9,58,67,8811703,10,0.976190476,1,1,8354
fa900c65f248cdb8975a4ed075ff4a14d4f9517e,0,Zhong Jian,2015-01-26 18:22:29-08:00,"['22cd3b5cc450cec97cb1438abef8765f807f505d', '245f63f637831f22e0194b229451c41650eb8291']",17,41,58,8811761,11,,,,8354
b45f225bb3ddb96d3589baeefaa9adce32939d64,0,honma,2015-01-27 10:33:01+08:00,['65294c5adcc8a1f442949ed718a6356f6fbe0440'],2,2,4,8811765,1,,,,8354
36f802e75e6eea18f49a8947af2848a70e830acf,0,Zhong Jian,2015-01-26 18:40:00-08:00,['245f63f637831f22e0194b229451c41650eb8291'],4,1,5,8811770,2,0,0,0,8354
b038425a1b386fb4d7312ce1c99b72b2466c92be,0,Zhong Jian,2015-01-26 18:40:57-08:00,"['fa900c65f248cdb8975a4ed075ff4a14d4f9517e', '36f802e75e6eea18f49a8947af2848a70e830acf']",4,1,5,8811775,2,,,,8354
3c660bf1618a3ab9a84186613c270f7d0263687d,1,honma,2015-01-27 13:03:22+08:00,['b45f225bb3ddb96d3589baeefaa9adce32939d64'],60,74,134,8811909,7,1,1,1,8355
79895530ef338eaf8af2c1544ea0b714a2bde183,0,Li Yang,2015-01-27 13:45:46+08:00,['2f0106e7012e9c195b118724ced36d54d62f31d3'],9,7,16,8811925,2,,,,8355
ace63c9ad5ca1e4035661d3b669bb7e12d103711,0,Li Yang,2015-01-27 13:46:17+08:00,"['79895530ef338eaf8af2c1544ea0b714a2bde183', '3c660bf1618a3ab9a84186613c270f7d0263687d']",91,101,192,8812117,13,,,,8355
55442a44673cec2ae0112f3bf1b25096f6a82acc,0,qianhao.zhou,2015-01-27 14:18:01+08:00,['b038425a1b386fb4d7312ce1c99b72b2466c92be'],16,29,45,8812162,3,0.545454545,1,1,8355
2d20518e851e701e289526e533b3d6b7136aaf3f,0,honma,2015-01-27 14:33:44+08:00,['ace63c9ad5ca1e4035661d3b669bb7e12d103711'],3,8,11,8812173,5,0,0.5,1,8355
654a78a445151ae9bcf8d677a3716ef6f250c3c4,1,honma,2015-01-27 16:18:52+08:00,['2d20518e851e701e289526e533b3d6b7136aaf3f'],22,31,53,8812226,4,1,1,1,8355
0f427dc37da2457c0c612e91f5310be3116a30b0,1,Li Yang,2015-01-27 16:28:07+08:00,['ace63c9ad5ca1e4035661d3b669bb7e12d103711'],44,47,91,8812317,6,0.4,0.6,1,8355
f07b29e3dca1ae4d214632a762b8e85eb9a32acc,0,"Shao Feng, Shi",2015-01-27 17:29:12+08:00,['11992580138b839ca1e8b580b5ff5f3c57d32667'],47,120,167,8812484,3,0.212121212,0.121212121,0.787878788,8355
0b85f5b7ecd1996aa594ddfbabbfc56a9ed61f96,0,"Shao Feng, Shi",2015-01-27 17:30:36+08:00,"['f07b29e3dca1ae4d214632a762b8e85eb9a32acc', '654a78a445151ae9bcf8d677a3716ef6f250c3c4']",258,354,612,8813096,23,,,,8355
77e55a3653c685361921a48491c724ccfd95cc8a,0,Li Yang,2015-01-27 17:45:01+08:00,['0f427dc37da2457c0c612e91f5310be3116a30b0'],18,24,42,8813138,3,0.4,0.8,0.8,8355
60400b9261c9dd348a3e94c34035db3b3ad07a85,0,Li Yang,2015-01-27 17:45:21+08:00,"['77e55a3653c685361921a48491c724ccfd95cc8a', '0b85f5b7ecd1996aa594ddfbabbfc56a9ed61f96']",72,159,231,8813369,12,,,,8355
e924b4fcd57698a74af566a58236758f50886845,0,Li Yang,2015-01-27 18:19:37+08:00,['60400b9261c9dd348a3e94c34035db3b3ad07a85'],26,19,45,8813414,1,0,0,1,8355
111b58b495e0de07f6c742093fcc498bdad23207,1,qianhao.zhou,2015-01-27 18:37:01+08:00,['e924b4fcd57698a74af566a58236758f50886845'],96,87,183,8813597,24,1,0,0,8355
d17f9985f6b94df65f8f600cbb3739a5e772560b,0,Zhong Jian,2015-01-27 04:43:01-08:00,['111b58b495e0de07f6c742093fcc498bdad23207'],5,21,26,8813623,4,0.888888889,0.888888889,1,8355
80b0adaa7872d1fb62f53bbfabb4407af4cde67a,0,Zhong Jian,2015-01-27 04:44:38-08:00,"['111b58b495e0de07f6c742093fcc498bdad23207', 'd17f9985f6b94df65f8f600cbb3739a5e772560b']",5,21,26,8813649,4,,,,8355
e0c1e855a67831516037f71180a523f6c93b9a00,1,honma,2015-01-27 22:27:23+08:00,['80b0adaa7872d1fb62f53bbfabb4407af4cde67a'],30,15,45,8813694,10,0,0,0,8355
c162eabe706e1bda48178e2f42f27f3ea994a295,1,honma,2015-01-27 22:27:23+08:00,['e0c1e855a67831516037f71180a523f6c93b9a00'],17,59,76,8813770,5,0.740740741,0,0.888888889,8355
3ffc296458dc9e325e0e853ffabf74fb76b5cb77,0,"Shao Feng, Shi",2015-01-28 09:40:48+08:00,['0b85f5b7ecd1996aa594ddfbabbfc56a9ed61f96'],133,994,1127,8814897,19,0.692650334,0.728285078,0.977728285,8361
d75625c1e30cd0e480a1e72fd50fc492b11bca2e,0,Li Yang,2015-01-28 09:54:40+08:00,['c162eabe706e1bda48178e2f42f27f3ea994a295'],0,3,3,8814900,1,1,1,1,8361
d56a6de0dbc4d645e1a996a3cfb21a3c1c6d34de,0,"Shao Feng, Shi",2015-01-28 10:52:55+08:00,"['3ffc296458dc9e325e0e853ffabf74fb76b5cb77', 'c162eabe706e1bda48178e2f42f27f3ea994a295']",214,249,463,8815363,48,,,,8361
ddedfc6caa25b35225d5992c8dbd66dfce22a5e5,0,"Shao Feng, Shi",2015-01-28 10:53:04+08:00,"['d56a6de0dbc4d645e1a996a3cfb21a3c1c6d34de', 'd75625c1e30cd0e480a1e72fd50fc492b11bca2e']",0,3,3,8815366,1,,,,8361
bbb6cb37b5e1d7bf610eaf2e6618012ed165ab4c,1,Li Yang,2015-01-28 14:35:54+08:00,['d75625c1e30cd0e480a1e72fd50fc492b11bca2e'],147,106,253,8815619,4,1,1,1,8361
626028c203fc404b934dcabd644f873a9b3b0ffb,0,Li Yang,2015-01-28 14:36:21+08:00,"['bbb6cb37b5e1d7bf610eaf2e6618012ed165ab4c', 'ddedfc6caa25b35225d5992c8dbd66dfce22a5e5']",133,993,1126,8816745,19,,,,8361
f6c9c6db4e6fb55664a104d5db8e9f6375547097,0,Li Yang,2015-01-28 14:57:13+08:00,['626028c203fc404b934dcabd644f873a9b3b0ffb'],3,5,8,8816753,2,,,,8361
6cee570c03dd36e686bc8011cd60a815b6b93b43,1,"Shao Feng, Shi",2015-01-28 15:28:24+08:00,['ddedfc6caa25b35225d5992c8dbd66dfce22a5e5'],160,152,312,8817065,28,0.888888889,0,1,8361
d953931eaecdfeea860fa4a6793019ddc3b03c8e,0,Li Yang,2015-01-28 15:45:12+08:00,['f6c9c6db4e6fb55664a104d5db8e9f6375547097'],2,2,4,8817069,1,,,,8361
201e768cbfe85695f6f86fd712f779d3aa2242cc,1,Li Yang,2015-01-28 16:11:54+08:00,['d953931eaecdfeea860fa4a6793019ddc3b03c8e'],60,59,119,8817188,7,,,,8361
8dcdf761c27db4116c93bde85054756824927751,0,"Shao Feng, Shi",2015-01-28 16:17:24+08:00,['6cee570c03dd36e686bc8011cd60a815b6b93b43'],199,122,321,8817509,7,1,1,1,8361
de43130e23cb96a2753e9b9063f553ac971a1546,0,"Shao Feng, Shi",2015-01-28 16:21:44+08:00,"['8dcdf761c27db4116c93bde85054756824927751', '201e768cbfe85695f6f86fd712f779d3aa2242cc']",62,61,123,8817632,8,,,,8361
8a701ef4eee21904e5be400549c127e93e219862,1,Zhong Jian,2015-01-28 16:41:58+08:00,['d75625c1e30cd0e480a1e72fd50fc492b11bca2e'],165,260,425,8818057,26,1,0,0.333333333,8365
19ea71f0b1472655acf9028ac325b287f10dccd1,0,Zhong Jian,2015-01-28 16:46:34+08:00,"['de43130e23cb96a2753e9b9063f553ac971a1546', '8a701ef4eee21904e5be400549c127e93e219862']",165,260,425,8818482,26,,,,8365
08e11d9b61fc3a55b2801b9b308ef56b059f75bc,1,"Shao Feng, Shi",2015-01-28 17:03:08+08:00,['de43130e23cb96a2753e9b9063f553ac971a1546'],925,898,1823,8820305,8,,,,8365
1ac64fce270a9b851a5cf527ed9c441a67825274,0,"Shao Feng, Shi",2015-01-28 17:03:21+08:00,"['08e11d9b61fc3a55b2801b9b308ef56b059f75bc', '19ea71f0b1472655acf9028ac325b287f10dccd1']",165,260,425,8820730,26,,,,8365
18ed8f627328c4386f2b1eda94e2d72a1772da91,0,Li Yang,2015-01-28 17:14:19+08:00,['201e768cbfe85695f6f86fd712f779d3aa2242cc'],1,1,2,8820732,1,,,,8365
01f027c07decdca9566e65871197332b1a2cc6e6,0,Li Yang,2015-01-28 17:16:55+08:00,['18ed8f627328c4386f2b1eda94e2d72a1772da91'],4,6,10,8820742,1,1,1,,8365
71d45097caf45ba3d4da91fc8ad186edaf2109d2,0,Li Yang,2015-01-28 17:17:08+08:00,"['01f027c07decdca9566e65871197332b1a2cc6e6', '1ac64fce270a9b851a5cf527ed9c441a67825274']",1299,1321,2620,8823362,64,,,,8365
298a8444b2ec1fcbe3fd5a730bea206f65eacff5,0,"Shao Feng, Shi",2015-01-28 17:17:57+08:00,['1ac64fce270a9b851a5cf527ed9c441a67825274'],4,4,8,8823370,4,,,,8365
44fa89a2c009f7bf13ec0c6ea62a672c820585e0,0,"Shao Feng, Shi",2015-01-28 17:18:24+08:00,"['298a8444b2ec1fcbe3fd5a730bea206f65eacff5', '71d45097caf45ba3d4da91fc8ad186edaf2109d2']",5,7,12,8823382,2,,,,8365
4cae9a9d6dd808eb80162cc80480587d10f6dac0,1,Li Yang,2015-01-28 17:25:24+08:00,['71d45097caf45ba3d4da91fc8ad186edaf2109d2'],15,11,26,8823408,2,0,0,0,8365
da7a1cccb54c1f2094eb4b983cb99d76c90dd6f2,0,Li Yang,2015-01-28 17:25:46+08:00,"['4cae9a9d6dd808eb80162cc80480587d10f6dac0', '44fa89a2c009f7bf13ec0c6ea62a672c820585e0']",4,4,8,8823416,4,,,,8365
f56eae98e0fb72568b658a5712889c9495fc246e,1,Li Yang,2015-01-28 17:29:50+08:00,['da7a1cccb54c1f2094eb4b983cb99d76c90dd6f2'],31,31,62,8823478,11,,,,8365
d67a0e8ed52bc1dd20cb0d012f5cd38dbc7ee45b,0,Li Yang,2015-01-28 18:17:54+08:00,['f56eae98e0fb72568b658a5712889c9495fc246e'],19,0,19,8823497,1,,,,8365
67bbaa94b552e173d13c1a4e59840b7779281e66,1,Li Yang,2015-01-28 18:46:25+08:00,['d67a0e8ed52bc1dd20cb0d012f5cd38dbc7ee45b'],18,4,22,8823519,1,1,1,0,8365
1328d2ec3b4192e186dd4b322ffdab0709352a79,1,honma,2015-01-28 18:51:20+08:00,['67bbaa94b552e173d13c1a4e59840b7779281e66'],73,113,186,8823705,10,1,0.966666667,0.433333333,8367
c7fa788adc6e32acdd72a15e4daa75063a438332,0,honma,2015-01-28 18:51:20+08:00,['1328d2ec3b4192e186dd4b322ffdab0709352a79'],1,1,2,8823707,1,,,,8367
ef74631bea577476d57e0c84a4ace63086ce44eb,0,"Shao Feng, Shi",2015-01-29 10:50:10+08:00,['c7fa788adc6e32acdd72a15e4daa75063a438332'],19,12,31,8823738,4,0,0,0,8367
b8c9f0ee4657f65eb7243efe2a5cb72ea5db662e,0,"Shao Feng, Shi",2015-01-29 11:07:22+08:00,['ef74631bea577476d57e0c84a4ace63086ce44eb'],1,1,2,8823740,1,,,,8367
33183e2996be9f346521b07be51ea9caaa7020eb,0,qianhao.zhou,2015-01-29 12:25:07+08:00,['55442a44673cec2ae0112f3bf1b25096f6a82acc'],1,1,2,8823742,1,,,,8367
20054fdc2ad85c9fc25125f4700c1fba52434b6a,1,Li Yang,2015-01-29 13:38:21+08:00,['b8c9f0ee4657f65eb7243efe2a5cb72ea5db662e'],62,46,108,8823850,25,0,0,0,8367
f65b1736a79dd122d9ebbb3d93d3caed16eb1553,0,Li Yang,2015-01-29 13:42:44+08:00,['20054fdc2ad85c9fc25125f4700c1fba52434b6a'],12,2,14,8823864,1,1,1,0,8367
1c395c9b387ee82fa8f99ea6f5ce573be3f83c73,0,qianhao.zhou,2015-01-29 15:47:19+08:00,['ef74631bea577476d57e0c84a4ace63086ce44eb'],11,24,35,8823899,1,1,1,1,8367
87626e5defc5fd0bf35fe69440f8c0be50f1ea47,0,qianhao.zhou,2015-01-29 15:47:49+08:00,"['1c395c9b387ee82fa8f99ea6f5ce573be3f83c73', 'f65b1736a79dd122d9ebbb3d93d3caed16eb1553']",74,48,122,8824021,26,,,,8367
46899d72040ab8ae0d6669e9efa1455091bc73c4,1,qianhao.zhou,2015-01-29 17:09:34+08:00,['87626e5defc5fd0bf35fe69440f8c0be50f1ea47'],28,41,69,8824090,2,0,1,1,8367
8bd883c7c7ed9cb4a3822c5501b399680715f6bc,0,Li Yang,2015-01-29 17:30:14+08:00,['f65b1736a79dd122d9ebbb3d93d3caed16eb1553'],32,0,32,8824122,2,,,,8367
0caeda01298662e633a7e1ffecff55f237a5ec8d,0,Li Yang,2015-01-29 17:31:43+08:00,['8bd883c7c7ed9cb4a3822c5501b399680715f6bc'],25,26,51,8824173,8,,,,8367
2048ea847a8d660d0ca235c01951d405f5a48db1,0,Li Yang,2015-01-29 17:32:27+08:00,['0caeda01298662e633a7e1ffecff55f237a5ec8d'],3,0,3,8824176,1,,,,8367
9f731f2e0c1e2ecff440f4b078ec567d9f14e46c,0,Li Yang,2015-01-29 17:34:22+08:00,['2048ea847a8d660d0ca235c01951d405f5a48db1'],0,2,2,8824178,2,1,1,1,8367
1cf376b69466db3882405433452de488bc6958e8,1,Li Yang,2015-01-29 17:42:40+08:00,['9f731f2e0c1e2ecff440f4b078ec567d9f14e46c'],51,32,83,8824261,14,0,0,0,8367
1ef6146b38d8725e99cf60a19d53af112888625b,0,Li Yang,2015-01-29 17:43:27+08:00,['1cf376b69466db3882405433452de488bc6958e8'],14,6,20,8824281,1,,,,8367
0917be7395f890640fa5f0b6271a80dc6bc69173,0,Li Yang,2015-01-29 17:47:05+08:00,['1ef6146b38d8725e99cf60a19d53af112888625b'],11,5,16,8824297,4,0.5,0,0,8367
e1e49ee839998b735413caf87498f5d4c173e763,0,Li Yang,2015-01-29 17:47:53+08:00,['0917be7395f890640fa5f0b6271a80dc6bc69173'],7,5,12,8824309,1,,,,8367
d25eefce9942de2cd4e2c93302d01f79888d993f,0,Li Yang,2015-01-29 17:48:16+08:00,"['e1e49ee839998b735413caf87498f5d4c173e763', '46899d72040ab8ae0d6669e9efa1455091bc73c4']",33,59,92,8824401,2,,,,8367
584f68e3156e78707b47f235ba0e40648336730a,0,honma,2015-01-30 10:00:41+08:00,['d25eefce9942de2cd4e2c93302d01f79888d993f'],9,10,19,8824420,4,0,0,1,8367
19d15c5b5a6c74da7d3b29ff7323d1182646137d,0,honma,2015-01-30 10:08:55+08:00,"['eb6d21e99baa58afd16fa7b88e97d84401dff426', '33183e2996be9f346521b07be51ea9caaa7020eb']",5638,33598,39236,8863656,200,,,,8367
e005d2832d2de0a43efe49e338df046fbf991093,0,qianhao.zhou,2015-01-30 14:04:12+08:00,['584f68e3156e78707b47f235ba0e40648336730a'],7,13,20,8863676,3,1,1,1,8367
3e45678083fec302482efb1f880daade760f0a21,1,qianhao.zhou,2015-01-30 15:15:53+08:00,['e005d2832d2de0a43efe49e338df046fbf991093'],23,27,50,8863726,4,1,0,0,8367
99f717f25844f14e8ee2dd69d67a4ad0ded3b13b,1,Zhong Jian,2015-01-30 22:33:45+08:00,['584f68e3156e78707b47f235ba0e40648336730a'],306,557,863,8864589,27,0.527559055,0.62992126,0.496062992,8374
d0e70d5fd4fa6abc53dd6ba8979cae44168cc43d,0,Zhong Jian,2015-02-02 09:59:47+08:00,"['3e45678083fec302482efb1f880daade760f0a21', '99f717f25844f14e8ee2dd69d67a4ad0ded3b13b']",306,557,863,8865452,27,,,,8374
aa29aa7e064e210617dabdcdc65c36d5bd011c51,0,"Shao Feng, Shi",2015-02-02 10:21:48+08:00,['3e45678083fec302482efb1f880daade760f0a21'],3,126,129,8865581,4,0.591836735,1,1,8376
54988d9e6b1d7e781b9ea6bcca9b2e6b24fc99bd,0,"Shao Feng, Shi",2015-02-02 10:22:28+08:00,"['aa29aa7e064e210617dabdcdc65c36d5bd011c51', 'd0e70d5fd4fa6abc53dd6ba8979cae44168cc43d']",306,557,863,8866444,27,,,,8376
ba859f45eba72a0870bdea6f4bf5b23f6af4c58a,0,Zhong Jian,2015-02-02 10:25:03+08:00,['99f717f25844f14e8ee2dd69d67a4ad0ded3b13b'],6,6,12,8866456,3,,,,8376
00efb378e4b77dace951e04d06884ecef186138f,0,Zhong Jian,2015-02-02 10:25:59+08:00,"['54988d9e6b1d7e781b9ea6bcca9b2e6b24fc99bd', 'ba859f45eba72a0870bdea6f4bf5b23f6af4c58a']",6,6,12,8866468,3,,,,8376
98f6e58e235ab2aee4c97dcf9c8d901d77b3a24c,0,Li Yang,2015-02-02 03:13:06+00:00,['33183e2996be9f346521b07be51ea9caaa7020eb'],2,2,4,8866472,1,,,,8376
e3a80affbb4ea48af2f6d2fc616d57cb752c3f7e,0,Li Yang,2015-02-02 11:26:29+08:00,['00efb378e4b77dace951e04d06884ecef186138f'],2,2,4,8866476,1,,,,8376
b47173f1af470316897deb97abcb8c8bd1904dd5,1,Zhong Jian,2015-02-02 11:48:19+08:00,['ba859f45eba72a0870bdea6f4bf5b23f6af4c58a'],66,16,82,8866558,4,0.090909091,0,0.090909091,8376
fabec2e285a82ef28594c6b85076f650d5ae6856,0,Zhong Jian,2015-02-02 11:54:18+08:00,"['00efb378e4b77dace951e04d06884ecef186138f', 'b47173f1af470316897deb97abcb8c8bd1904dd5']",66,16,82,8866640,4,,,,8376
ebec0dd70b48f4c890b471150bd6290561465f8d,0,honma,2015-02-02 13:07:03+08:00,['fabec2e285a82ef28594c6b85076f650d5ae6856'],152,196,348,8866988,9,1,1,1,8377
5a7788d6847984ed10f414bd116b352dba66aabb,0,honma,2015-02-02 17:49:43+08:00,['ebec0dd70b48f4c890b471150bd6290561465f8d'],115,118,233,8867221,6,1,1,1,8377
de7b56abc39c9ccd672044a2ef8837a43c03a9a9,1,Li Yang,2015-02-02 18:35:26+08:00,['e3a80affbb4ea48af2f6d2fc616d57cb752c3f7e'],0,58,58,8867279,2,1,1,1,8379
50994cbae5d7bfa0b204ccd32cb3ac653022c027,0,Li Yang,2015-02-02 18:35:46+08:00,"['de7b56abc39c9ccd672044a2ef8837a43c03a9a9', '5a7788d6847984ed10f414bd116b352dba66aabb']",331,328,659,8867938,17,,,,8379
5946df4ed9f23babb881eeeca4f573490074258f,0,lukehan,2015-02-02 23:43:31+08:00,['98f6e58e235ab2aee4c97dcf9c8d901d77b3a24c'],0,223,223,8868161,3,,,,8382
2f9752e3c412697306f42ffe6dbd075333d9cb5d,0,lukehan,2015-02-02 23:44:15+08:00,['5946df4ed9f23babb881eeeca4f573490074258f'],120,60,180,8868341,15,,,,8382
9311c9267b5c0780e1f28dbd67ad40536240eb1f,0,lukehan,2015-02-02 23:46:33+08:00,['2f9752e3c412697306f42ffe6dbd075333d9cb5d'],0,0,0,8868341,3,,,,8382
e4352497c824e3b5275b4335e558b0f2ee48beac,1,honma,2015-02-03 10:28:10+08:00,['50994cbae5d7bfa0b204ccd32cb3ac653022c027'],1,67,68,8868409,2,1,1,1,8383
4737d571ce571d9c23c5c889850af25d5b18aaa7,0,Li Yang,2015-02-03 10:52:01+08:00,['50994cbae5d7bfa0b204ccd32cb3ac653022c027'],30,30,60,8868469,3,1,1,1,8384
aa573f2f0272942c1554cb45b5b1b1b507313576,0,Li Yang,2015-02-03 10:52:28+08:00,"['4737d571ce571d9c23c5c889850af25d5b18aaa7', 'e4352497c824e3b5275b4335e558b0f2ee48beac']",1,67,68,8868537,2,,,,8384
07c6f049fa626eb7cdb7164506a8e47e198c1a41,0,"Shao Feng, Shi",2015-02-03 11:45:58+08:00,['50994cbae5d7bfa0b204ccd32cb3ac653022c027'],130,123,253,8868790,3,1,1,1,8385
27c3dcf1c0650ced1a39311eb65e3d01da4baece,0,"Shao Feng, Shi",2015-02-03 11:46:09+08:00,"['07c6f049fa626eb7cdb7164506a8e47e198c1a41', 'aa573f2f0272942c1554cb45b5b1b1b507313576']",31,97,128,8868918,5,,,,8385
4ea83331fb3ac547ef665a4701694e2502e333c9,0,honma,2015-02-03 12:49:05+08:00,['27c3dcf1c0650ced1a39311eb65e3d01da4baece'],2,3,5,8868923,1,1,1,1,8385
5780937306ce7232345abba4098f45c605e2c07e,1,qianhao.zhou,2015-02-03 14:11:46+08:00,['4ea83331fb3ac547ef665a4701694e2502e333c9'],912,889,1801,8870724,408,,,,8386
9b62884a190d74628a2ad13b1f2931f067fafa43,1,Zhong Jian,2015-02-03 14:19:08+08:00,['b47173f1af470316897deb97abcb8c8bd1904dd5'],56,32,88,8870812,9,1,0,1,8387
fbf001667682ec0c12d38bc9eda3a231d1c418c6,0,Zhong Jian,2015-02-03 14:33:03+08:00,['9b62884a190d74628a2ad13b1f2931f067fafa43'],0,153,153,8870965,4,,,,8391
6c65df0ba2744f9de98b9a800263dd9bbe65909d,0,Zhong Jian,2015-02-03 14:34:24+08:00,['fbf001667682ec0c12d38bc9eda3a231d1c418c6'],153,0,153,8871118,4,,,,8391
a0e3ab1032a0e9686b618a6c00866e1e3980e2fd,0,Zhong Jian,2015-02-03 14:46:21+08:00,"['4ea83331fb3ac547ef665a4701694e2502e333c9', '6c65df0ba2744f9de98b9a800263dd9bbe65909d']",56,32,88,8871206,9,,,,8391
20c1b5002324a376029530a888f14760e4ca0470,0,qianhao.zhou,2015-02-03 15:17:43+08:00,"['a0e3ab1032a0e9686b618a6c00866e1e3980e2fd', '5780937306ce7232345abba4098f45c605e2c07e']",912,889,1801,8873007,408,,,,8391
15b406bcd34ca75ac2d3441322d82df75add0b92,1,qianhao.zhou,2015-02-03 15:26:37+08:00,['20c1b5002324a376029530a888f14760e4ca0470'],33,33,66,8873073,12,,,,8391
2616af47d2aaa130e3038b45edc642baf9b72030,1,qianhao.zhou,2015-02-03 15:29:01+08:00,['15b406bcd34ca75ac2d3441322d82df75add0b92'],311,306,617,8873690,76,,,,8391
b179ebe270c205e790cb01eb8a8a549fba97aeb7,1,honma,2015-02-03 15:31:35+08:00,['2616af47d2aaa130e3038b45edc642baf9b72030'],4,12,16,8873706,1,0,1,1,8391
d883cd3727b3a537b9fd2c1eceed376874e1cd22,0,"Shao Feng, Shi",2015-02-03 15:38:51+08:00,['9311c9267b5c0780e1f28dbd67ad40536240eb1f'],1097,2334,3431,8877137,13,0.5,1,1,8393
d2f9018d5cdda4d8b9bda0ff7627444fc9b9707b,1,qianhao.zhou,2015-02-03 17:19:57+08:00,['2616af47d2aaa130e3038b45edc642baf9b72030'],629,633,1262,8878399,249,,,,8393
c2eb0ce3d5446dca4cd53c6f5ef00f0cbb362457,1,qianhao.zhou,2015-02-03 17:24:06+08:00,['d2f9018d5cdda4d8b9bda0ff7627444fc9b9707b'],591,570,1161,8879560,198,,,,8393
307c9b6def443b38b0125d61cbad74c1a7b9df0d,0,qianhao.zhou,2015-02-03 17:24:23+08:00,"['c2eb0ce3d5446dca4cd53c6f5ef00f0cbb362457', 'b179ebe270c205e790cb01eb8a8a549fba97aeb7']",4,12,16,8879576,1,,,,8393
a2f4aa4ca84fd968ef8d9a0d047891399544e21c,1,qianhao.zhou,2015-02-03 17:30:53+08:00,['307c9b6def443b38b0125d61cbad74c1a7b9df0d'],600,606,1206,8880782,199,,,,8393
ab2127c44dfc7ef181728091893eda311a8ddd15,1,qianhao.zhou,2015-02-03 18:13:09+08:00,['a2f4aa4ca84fd968ef8d9a0d047891399544e21c'],155,149,304,8881086,54,,,,8393
34956b48fb39b74f72b3741b770e7556309f42a1,1,qianhao.zhou,2015-02-03 18:25:22+08:00,['ab2127c44dfc7ef181728091893eda311a8ddd15'],76,76,152,8881238,34,,,,8393
bd568da611b6fad3f27b2ecce368296c78e22321,1,Zhong Jian,2015-02-03 18:52:24+08:00,['6c65df0ba2744f9de98b9a800263dd9bbe65909d'],76,74,150,8881388,12,0,0.857142857,0,8393
f6b9ee95f971c9ca42da9c02a0f9cfa3e494bcc6,0,Zhong Jian,2015-02-03 18:55:18+08:00,"['bd568da611b6fad3f27b2ecce368296c78e22321', '34956b48fb39b74f72b3741b770e7556309f42a1']",3812,4073,7885,8889273,679,,,,8393
c36e30488d4e47382fefa215f0d79aef104fadf8,0,lukehan,2015-02-04 00:16:37+08:00,['d883cd3727b3a537b9fd2c1eceed376874e1cd22'],16557,3,16560,8905833,53,0.031683168,0.17029703,0.093069307,8393
3ffa800d808420c3bcb5c45d044b902144825b73,0,"Shao Feng, Shi",2015-02-04 09:55:30+08:00,['d883cd3727b3a537b9fd2c1eceed376874e1cd22'],2,14,16,8905849,1,1,1,1,8393
2c347c7d12c4a37fda19dcb0f4114656447fcdcd,0,"Shao Feng, Shi",2015-02-04 09:56:56+08:00,"['3ffa800d808420c3bcb5c45d044b902144825b73', 'c36e30488d4e47382fefa215f0d79aef104fadf8']",16557,3,16560,8922409,53,,,,8393
5c0e8ab8c17659b4c83a3c4268bb9e2e8e9befeb,0,"Shao Feng, Shi",2015-02-04 11:00:07+08:00,"['19d15c5b5a6c74da7d3b29ff7323d1182646137d', '2c347c7d12c4a37fda19dcb0f4114656447fcdcd']",17551,2409,19960,8942369,76,,,,8393
ddaa33f13241f5db270b53aaffc61e4bb64c07c7,0,rongcui,2015-02-04 11:36:17+08:00,['5c0e8ab8c17659b4c83a3c4268bb9e2e8e9befeb'],2,13,15,8942384,1,1,1,1,8393
a9ddf684e0f289a04a7bd666c1b55ffa3c53b2a7,0,rongcui,2015-02-04 11:45:06+08:00,['ddaa33f13241f5db270b53aaffc61e4bb64c07c7'],0,89,89,8942473,1,0,0,1,8394
438f92fce20beb4f1e8086121ce1070a9ccdb563,0,rongcui,2015-02-04 11:48:23+08:00,['a9ddf684e0f289a04a7bd666c1b55ffa3c53b2a7'],0,2,2,8942475,1,1,1,1,8394
610112efa8a15dce0de194d9b96f0482402cccdc,0,Zhong Jian,2015-02-04 13:48:50+08:00,"['34956b48fb39b74f72b3741b770e7556309f42a1', 'f6b9ee95f971c9ca42da9c02a0f9cfa3e494bcc6']",76,74,150,8942625,12,,,,8394
ec7c4b735fad21434ab87f0906a861b143e68c74,0,"Shao Feng, Shi",2015-02-04 14:43:57+08:00,['34956b48fb39b74f72b3741b770e7556309f42a1'],969,34,1003,8943628,10,0.496138996,0.092664093,0.185328185,8394
abb4ef9acc1fe685983bd2f6c52f0f53abb05b25,0,"Shao Feng, Shi",2015-02-04 14:44:11+08:00,"['ec7c4b735fad21434ab87f0906a861b143e68c74', '610112efa8a15dce0de194d9b96f0482402cccdc']",76,74,150,8943778,12,,,,8394
9099807b59f39acd6e1b3c52dde2acc4d3740a7f,0,"Shao Feng, Shi",2015-02-04 14:54:51+08:00,['abb4ef9acc1fe685983bd2f6c52f0f53abb05b25'],1,1,2,8943780,1,,,,8394
422f5c34023ebf94887ceeb8243c24f820ffe8a5,0,qianhao.zhou,2015-02-04 15:37:31+08:00,['34956b48fb39b74f72b3741b770e7556309f42a1'],271,156,427,8944207,10,,,,8399
fc97e8e1a3ef97217225c4a49ee53accf7821d43,0,qianhao.zhou,2015-02-04 15:37:40+08:00,"['422f5c34023ebf94887ceeb8243c24f820ffe8a5', '9099807b59f39acd6e1b3c52dde2acc4d3740a7f']",1046,109,1155,8945362,22,,,,8399
6f85f76ec7d0e905ebb65e8b97439df7f43f4970,0,qianhao.zhou,2015-02-04 15:59:20+08:00,['fc97e8e1a3ef97217225c4a49ee53accf7821d43'],0,257,257,8945619,4,,,,8403
61ed86b035f63071a74e142bd23ae519e41171c9,1,Zhong Jian,2015-02-04 16:22:21+08:00,['f6b9ee95f971c9ca42da9c02a0f9cfa3e494bcc6'],11,23,34,8945653,6,1,1,1,8403
8157184a551152558e6ee5eaebbda14314f419ec,0,Zhong Jian,2015-02-04 16:23:41+08:00,"['6f85f76ec7d0e905ebb65e8b97439df7f43f4970', '61ed86b035f63071a74e142bd23ae519e41171c9']",11,23,34,8945687,6,,,,8403
69717e02aa539eb17c3f6875dba9f1d00a04d3d6,0,qianhao.zhou,2015-02-04 17:06:03+08:00,['6f85f76ec7d0e905ebb65e8b97439df7f43f4970'],53,94,147,8945834,7,,,,8406
2d72b29bf1784032513d7434d693855213bfde52,0,qianhao.zhou,2015-02-04 17:06:29+08:00,"['69717e02aa539eb17c3f6875dba9f1d00a04d3d6', '8157184a551152558e6ee5eaebbda14314f419ec']",11,23,34,8945868,6,,,,8406
45b0a7d386e2952672961ca913e8f4dfef5bf0ea,1,Li Yang,2015-02-04 17:33:40+08:00,['34956b48fb39b74f72b3741b770e7556309f42a1'],1,373,374,8946242,2,0.335968379,0.743083004,0.66798419,8407
a59b00b0e2c6a858ba9e262650b24ef23c9718b7,0,qianhao.zhou,2015-02-04 17:33:57+08:00,['2d72b29bf1784032513d7434d693855213bfde52'],3,32,35,8946277,2,,,,8407
4c41bb4770678e1787ae96bff24a330e35bd7e43,0,Li Yang,2015-02-04 17:34:16+08:00,"['45b0a7d386e2952672961ca913e8f4dfef5bf0ea', 'a59b00b0e2c6a858ba9e262650b24ef23c9718b7']",1090,377,1467,8947744,39,,,,8407
8970c582a4a993d042349db511e1e82f5035bf67,0,Li Yang,2015-02-04 17:58:34+08:00,['4c41bb4770678e1787ae96bff24a330e35bd7e43'],436,859,1295,8949039,65,,,,8407
d83a9c514e0e7c19791179ce634def8417677113,0,shaofengshi,2015-02-04 18:02:14+08:00,['9099807b59f39acd6e1b3c52dde2acc4d3740a7f'],71,96,167,8949206,1,0,0,1,8407
10ff15006ce829db7a59cf9915c9a6424e8a1a28,0,shaofengshi,2015-02-04 18:02:33+08:00,"['d83a9c514e0e7c19791179ce634def8417677113', '8970c582a4a993d042349db511e1e82f5035bf67']",481,1500,1981,8951187,85,,,,8407
ed0d252925f31b97478e293fbb126b22d271c474,0,Li Yang,2015-02-04 18:10:43+08:00,['8970c582a4a993d042349db511e1e82f5035bf67'],3,225,228,8951415,13,,,,8407
4e31e7becf16e69ddd9ece107d9f394ad34c181e,0,Li Yang,2015-02-04 18:11:02+08:00,"['ed0d252925f31b97478e293fbb126b22d271c474', '10ff15006ce829db7a59cf9915c9a6424e8a1a28']",71,96,167,8951582,1,,,,8407
1d4d7017a29f76e2b9e7b3519ff61e718f27b64f,0,lukehan,2015-02-04 18:14:55+08:00,['2c347c7d12c4a37fda19dcb0f4114656447fcdcd'],40,38,78,8951660,5,,,,8407
4aad4b910a0b667af532965f603f3dca2e4b110b,0,Li Yang,2015-02-04 18:16:42+08:00,['4e31e7becf16e69ddd9ece107d9f394ad34c181e'],3752,7547,11299,8962959,571,,,,8407
ee3af95909499143d3292c4c841473d979870691,0,Li Yang,2015-02-04 18:18:59+08:00,['4aad4b910a0b667af532965f603f3dca2e4b110b'],23,0,23,8962982,1,,,,8407
6ba275250f210ad264b97d3b2b80b94f811366f8,0,qianhao.zhou,2015-02-04 18:25:02+08:00,['a59b00b0e2c6a858ba9e262650b24ef23c9718b7'],34,93,127,8963109,4,0.545454545,1,0,8409
75f863e52dd1ce03c44a4a57d86bf244cafd8d4c,0,qianhao.zhou,2015-02-04 18:25:32+08:00,"['6ba275250f210ad264b97d3b2b80b94f811366f8', '4aad4b910a0b667af532965f603f3dca2e4b110b']",4261,9098,13359,8976468,648,,,,8409
714277f0f569fbc81245716a002d7c02eef464f7,1,Zhong Jian,2015-02-04 22:39:44+08:00,['8157184a551152558e6ee5eaebbda14314f419ec'],72,80,152,8976620,18,0.636363636,0,1,8409
0c3ab0a0f01803607b6168189622aa01da99d06b,0,Zhong Jian,2015-02-04 22:41:03+08:00,"['4aad4b910a0b667af532965f603f3dca2e4b110b', '714277f0f569fbc81245716a002d7c02eef464f7']",72,80,152,8976772,18,,,,8409
b9c7633e6d22f7ccfc91d7f070ba2d322702a6e9,1,Zhong Jian,2015-02-04 23:20:34+08:00,['714277f0f569fbc81245716a002d7c02eef464f7'],12,34,46,8976818,6,0.6875,0.875,0.75,8409
c913a7e00ed18770e50c110a8870bb156c3bf5e0,0,Zhong Jian,2015-02-04 23:21:41+08:00,"['0c3ab0a0f01803607b6168189622aa01da99d06b', 'b9c7633e6d22f7ccfc91d7f070ba2d322702a6e9']",12,34,46,8976864,6,,,,8409
e069dbc2f94ae6b0b31f08767f92d78450ddd8f9,0,qianhao.zhou,2015-02-05 10:11:32+08:00,['75f863e52dd1ce03c44a4a57d86bf244cafd8d4c'],0,60,60,8976924,1,,,,8410
a62016310c3e44cb5df10ffdbca8d8431f09a6b0,0,qianhao.zhou,2015-02-05 10:16:00+08:00,['e069dbc2f94ae6b0b31f08767f92d78450ddd8f9'],7,9,16,8976940,1,,,,8410
d397817aa76ad7c7dedcd9960d21221e40184e68,0,shaofengshi,2015-02-05 10:27:21+08:00,['c913a7e00ed18770e50c110a8870bb156c3bf5e0'],159,121,280,8977220,7,0.549295775,0.309859155,0,8411
0e8038493c8d7c3799e05a61b7e8915f8c9b4ecc,1,Zhong Jian,2015-02-05 10:40:16+08:00,['b9c7633e6d22f7ccfc91d7f070ba2d322702a6e9'],6,6,12,8977232,2,,,,8411
14759d7790ddf29ca7da309aa9c9c3b4c95b206a,0,Zhong Jian,2015-02-05 10:41:19+08:00,"['d397817aa76ad7c7dedcd9960d21221e40184e68', '0e8038493c8d7c3799e05a61b7e8915f8c9b4ecc']",6,6,12,8977244,2,,,,8411
9b9a178b5f4c969f06a5e854f9e5f8ead6cab4af,0,honma,2015-02-05 10:42:47+08:00,['14759d7790ddf29ca7da309aa9c9c3b4c95b206a'],1,1,2,8977246,1,,,,8411
04de9261310b767e9545974888c9d803617ec80d,0,honma,2015-02-05 10:42:47+08:00,['9b9a178b5f4c969f06a5e854f9e5f8ead6cab4af'],2801,2,2803,8980049,11,0.345900658,0.246558947,0.083183722,8411
c5df564a7c2d31074a4922103924440325e35382,0,Li Yang,2015-02-05 05:50:17+00:00,"['ee3af95909499143d3292c4c841473d979870691', '04de9261310b767e9545974888c9d803617ec80d']",3048,241,3289,8983338,40,,,,8411
09e31b35ee719dbcc3999d9a8d761d9d61990587,1,Li Yang,2015-02-05 14:03:36+08:00,['c5df564a7c2d31074a4922103924440325e35382'],484,20,504,8983842,4,0.880368098,0.107361963,0.079754601,8411
319ad11600456db68a9cd0c162b0122801278cb9,0,qianhao.zhou,2015-02-05 14:47:56+08:00,['a62016310c3e44cb5df10ffdbca8d8431f09a6b0'],0,1839,1839,8985681,10,0.245283019,0.452830189,0.676549865,8420
eb9d822a2fc509a7ba6cd75f3af20b682d89cf61,0,qianhao.zhou,2015-02-05 14:49:06+08:00,['319ad11600456db68a9cd0c162b0122801278cb9'],1,1,2,8985683,1,,,,8420
487ef75e55e97bcbae47172d05e0bcdd0af989f9,1,shaofengshi,2015-02-05 15:05:23+08:00,['d397817aa76ad7c7dedcd9960d21221e40184e68'],69,73,142,8985825,5,0.5,1,1,8420
995111c23055cd5803e8c9396bca8b7812362476,0,shaofengshi,2015-02-05 15:05:56+08:00,"['487ef75e55e97bcbae47172d05e0bcdd0af989f9', '09e31b35ee719dbcc3999d9a8d761d9d61990587']",3315,29,3344,8989169,19,,,,8420
76d1e74a7ef22f3ad986834389c72b96e0b2c715,1,honma,2015-02-05 15:10:19+08:00,['995111c23055cd5803e8c9396bca8b7812362476'],100,101,201,8989370,24,0,0,0,8421
951cf319582853860a2eb9f3cdb8a928c2d24bb3,0,honma,2015-02-05 15:12:28+08:00,['76d1e74a7ef22f3ad986834389c72b96e0b2c715'],1,0,1,8989371,1,,,,8421
17f7ced348103bc94656af817a22ae8bb370c1c5,0,qianhao.zhou,2015-02-05 15:23:13+08:00,['eb9d822a2fc509a7ba6cd75f3af20b682d89cf61'],1841,12,1853,8991224,14,0.754716981,0.547169811,0.323450135,8422
9bcdfab34cbb6c695ce1daa57a8c916742fb96ce,0,qianhao.zhou,2015-02-05 15:42:14+08:00,['17f7ced348103bc94656af817a22ae8bb370c1c5'],16,25,41,8991265,3,,,,8422
e6040e4613a0060689e00ae45b1d99333cb5cf33,1,Zhong Jian,2015-02-05 15:43:08+08:00,['09e31b35ee719dbcc3999d9a8d761d9d61990587'],24,13,37,8991302,5,0.090909091,0.909090909,0,8422
542cfc56808feff45f46788953f5234935ae5554,0,Zhong Jian,2015-02-05 15:44:56+08:00,['e6040e4613a0060689e00ae45b1d99333cb5cf33'],2,0,2,8991304,1,0,0,1,8422
62fc01e557d5fd28177b187abae42a1a706f8dfb,0,Zhong Jian,2015-02-05 15:45:58+08:00,"['951cf319582853860a2eb9f3cdb8a928c2d24bb3', '542cfc56808feff45f46788953f5234935ae5554']",24,11,35,8991339,5,,,,8422
37b6a67f058537e4bd8401b0bcc64fc991825225,0,qianhao.zhou,2015-02-05 15:46:19+08:00,['9bcdfab34cbb6c695ce1daa57a8c916742fb96ce'],1,1,2,8991341,1,,,,8422
be7d1e107fb411bc4c61217d7ab34a382ad8fdc3,1,Li Yang,2015-02-05 15:51:22+08:00,['09e31b35ee719dbcc3999d9a8d761d9d61990587'],13,161,174,8991515,6,0.192771084,1,1,8423
9f5bffdd2833a45267fe71405b40a649d7a55232,0,Li Yang,2015-02-05 15:51:46+08:00,"['be7d1e107fb411bc4c61217d7ab34a382ad8fdc3', '62fc01e557d5fd28177b187abae42a1a706f8dfb']",192,183,375,8991890,33,,,,8423
35a4b32e955a1236e6f1e95366e206a6400ac835,1,qianhao.zhou,2015-02-05 16:57:56+08:00,['37b6a67f058537e4bd8401b0bcc64fc991825225'],47,80,127,8992017,6,1,1,0,8423
c83acc9eb7c1ac9ec4bd2eb18f34253d40d73437,1,honma,2015-02-05 17:00:50+08:00,['9f5bffdd2833a45267fe71405b40a649d7a55232'],39,27,66,8992083,4,,,,8423
7b1d93fefe1200c11bf5f9ac29de3960ce5d1664,0,honma,2015-02-05 17:00:50+08:00,['c83acc9eb7c1ac9ec4bd2eb18f34253d40d73437'],258,17,275,8992358,4,0,0,1,8423
8b5498ae7181cc5b57354b8179f496cecf07d79a,1,Zhong Jian,2015-02-05 17:09:22+08:00,['62fc01e557d5fd28177b187abae42a1a706f8dfb'],53,910,963,8993321,48,0,0,0.666666667,8423
76798b1f9c98d23b981cd08e531ab94cd2063acf,0,qianhao.zhou,2015-02-05 17:09:58+08:00,['35a4b32e955a1236e6f1e95366e206a6400ac835'],2,4,6,8993327,2,,,,8423
c6a03a51e462693991ce13b6919b102d18cc20f1,0,honma,2015-02-05 17:17:33+08:00,['7b1d93fefe1200c11bf5f9ac29de3960ce5d1664'],1,1,2,8993329,1,,,,8423
a42b6c7034cf7998898dd4d7b87b55ad9b582db6,1,Zhong Jian,2015-02-05 17:58:28+08:00,['8b5498ae7181cc5b57354b8179f496cecf07d79a'],1,668,669,8993998,38,,,,8423
4e6625de30e8394f7f33f74522e360a144aa7ec0,0,Zhong Jian,2015-02-05 18:01:33+08:00,"['c6a03a51e462693991ce13b6919b102d18cc20f1', 'a42b6c7034cf7998898dd4d7b87b55ad9b582db6']",54,1578,1632,8995630,85,,,,8423
7dc7d6b86898fc92420e94dcf1b48b0c5cfec1b3,1,qianhao.zhou,2015-02-05 18:17:47+08:00,['76798b1f9c98d23b981cd08e531ab94cd2063acf'],13,37,50,8995680,6,0.875,1,1,8423
8d49f06b33e03de0013a0bd4fb6b2f840075fe73,0,qianhao.zhou,2015-02-05 18:35:26+08:00,['7dc7d6b86898fc92420e94dcf1b48b0c5cfec1b3'],2,7,9,8995689,2,0,0,1,8423
006fe883a789ec0aa73d97352881ba9ea1f5c2b8,0,qianhao.zhou,2015-02-05 18:49:55+08:00,"['8d49f06b33e03de0013a0bd4fb6b2f840075fe73', '4e6625de30e8394f7f33f74522e360a144aa7ec0']",4119,2203,6322,9002011,144,,,,8423
9c1f7a743db5ccf6d44cb205690c22c9b9f9359d,0,honma,2015-02-05 19:15:18+08:00,['4e6625de30e8394f7f33f74522e360a144aa7ec0'],37721,0,37721,9039732,241,,,,8423
dda7d1f2148e7f0c43003d1472d1784c34384187,0,honma,2015-02-05 19:15:18+08:00,['9c1f7a743db5ccf6d44cb205690c22c9b9f9359d'],31,49,80,9039812,7,0,0.833333333,0.916666667,8423
cce01c33c95709470fa84b5585a358365d8629b5,1,Zhong Jian,2015-02-05 20:13:47+08:00,['a42b6c7034cf7998898dd4d7b87b55ad9b582db6'],23,19,42,9039854,6,1,0.111111111,1,8423
ac1e310d68efa00aaa34607285f41a4f0ca632ec,1,Zhong Jian,2015-02-05 20:48:19+08:00,['cce01c33c95709470fa84b5585a358365d8629b5'],35,127,162,9040016,12,0.869565217,0,1,8427
0deec944260eeabef4a2da7d6534add2a510ede1,0,Zhong Jian,2015-02-05 20:50:11+08:00,"['dda7d1f2148e7f0c43003d1472d1784c34384187', 'ac1e310d68efa00aaa34607285f41a4f0ca632ec']",58,146,204,9040220,17,,,,8427
979bc41e7353a581663eb46da370c672517b6d01,0,honma,2015-02-05 21:05:40+08:00,['0deec944260eeabef4a2da7d6534add2a510ede1'],5,9,14,9040234,3,0,0,1,8427
fab5760f54a48e93a2c81a760bfc8d7c15d55f87,0,honma,2015-02-05 21:05:41+08:00,['979bc41e7353a581663eb46da370c672517b6d01'],45,5,50,9040284,5,0.68,0,0,8427
e862c331a7d52cc12d8cb9aff2b3ec23c3682f6f,1,shaofengshi,2015-02-05 21:10:47+08:00,['951cf319582853860a2eb9f3cdb8a928c2d24bb3'],1,126,127,9040411,5,1,1,1,8428
22772216589008c34d73a0b09c747ccee7c5b3e4,1,Zhong Jian,2015-02-05 21:11:46+08:00,['ac1e310d68efa00aaa34607285f41a4f0ca632ec'],3,43,46,9040457,3,,,,8428
6f1f660b9d34a02e33b1bfd0e54ee39177bdae25,0,Zhong Jian,2015-02-05 21:15:49+08:00,"['fab5760f54a48e93a2c81a760bfc8d7c15d55f87', '22772216589008c34d73a0b09c747ccee7c5b3e4']",3,43,46,9040503,3,,,,8428
5284aacd045bdf97770b36a78b4cf0aaf500000f,0,shaofengshi,2015-02-05 21:17:53+08:00,"['e862c331a7d52cc12d8cb9aff2b3ec23c3682f6f', '6f1f660b9d34a02e33b1bfd0e54ee39177bdae25']",38214,2009,40223,9080726,349,,,,8428
12aa88ec0648e48dde92c17837aa8f22b3ce07fe,0,shaofengshi,2015-02-05 21:23:14+08:00,['5284aacd045bdf97770b36a78b4cf0aaf500000f'],9,9,18,9080744,3,,,,8428
40a33a979f58f905b66d788456a3c6a3f16886cb,0,shaofengshi,2015-02-05 21:26:06+08:00,['1d4d7017a29f76e2b9e7b3519ff61e718f27b64f'],4,4,8,9080752,1,,,,8428
40c5be88da5328b21472165d4cb774dca13b4867,0,shaofengshi,2015-02-05 21:27:24+08:00,"['5c0e8ab8c17659b4c83a3c4268bb9e2e8e9befeb', '40a33a979f58f905b66d788456a3c6a3f16886cb']",44,42,86,9080838,6,,,,8428
5ab25b6c3d7fe1faba2a8030787a0d3d14bbce32,0,shaofengshi,2015-02-06 09:38:26+08:00,['40a33a979f58f905b66d788456a3c6a3f16886cb'],8,10,18,9080856,1,1,1,1,8428
539f9338cabfc498a37b8b08c16f392d197c7056,0,honma,2015-02-06 10:31:56+08:00,['12aa88ec0648e48dde92c17837aa8f22b3ce07fe'],1,1,2,9080858,2,0,1,1,8428
b859c006c68491d94bb9e3d8cefd8246bf67e65b,0,honma,2015-02-06 10:37:47+08:00,['539f9338cabfc498a37b8b08c16f392d197c7056'],1,1,2,9080860,1,1,0,0,8428
657a729d3ab7f6651050d4286c56436781d6f910,0,qianhao.zhou,2015-02-06 11:07:29+08:00,['006fe883a789ec0aa73d97352881ba9ea1f5c2b8'],29,41,70,9080930,8,0,0,1,8428
7f950cee89e2710f9678dc2b5873bb52a80aa624,0,shaofengshi,2015-02-06 11:13:44+08:00,['12aa88ec0648e48dde92c17837aa8f22b3ce07fe'],161,1,162,9081092,2,0.74025974,0.207792208,0,8428
5d3aad3659fb9522443d8849db7d4837a802b461,0,shaofengshi,2015-02-06 11:14:14+08:00,"['7f950cee89e2710f9678dc2b5873bb52a80aa624', 'b859c006c68491d94bb9e3d8cefd8246bf67e65b']",2,2,4,9081096,2,,,,8428
71a3373c9329037709250433ea3d4e0a7e8013d8,0,lukehan,2015-02-06 11:28:04+08:00,['5ab25b6c3d7fe1faba2a8030787a0d3d14bbce32'],0,12,12,9081108,1,,,,8429
21aa87b37cd7f86afcbbcfee246b0b1c9f844599,0,lukehan,2015-02-06 11:29:58+08:00,"['40c5be88da5328b21472165d4cb774dca13b4867', '71a3373c9329037709250433ea3d4e0a7e8013d8']",8,22,30,9081138,2,,,,8429
f5785c58eb9eb8ff10f3c36a9d8f04bf6f5135e7,1,qianhao.zhou,2015-02-06 12:46:07+08:00,['657a729d3ab7f6651050d4286c56436781d6f910'],62,69,131,9081269,13,0,0,0,8430
256d2c54d0a23fc7440ea062cffef708fefcf059,0,qianhao.zhou,2015-02-06 13:03:31+08:00,['f5785c58eb9eb8ff10f3c36a9d8f04bf6f5135e7'],7,13,20,9081289,2,1,1,1,8430
2d3722c31af17f4917885fea422d0602f70e74b2,0,qianhao.zhou,2015-02-06 13:15:01+08:00,['256d2c54d0a23fc7440ea062cffef708fefcf059'],4,4,8,9081297,3,,,,8430
6409969bfd37699380ab64b27f6e701269ca27d9,0,Zhong Jian,2015-02-06 13:15:26+08:00,['12aa88ec0648e48dde92c17837aa8f22b3ce07fe'],955134,24,955158,10036455,2637,0.583367621,0.310199628,0.290666201,8430
e47fc7da4ff53db32f3757031171403bf666bd41,0,Zhong Jian,2015-02-06 13:20:43+08:00,"['5d3aad3659fb9522443d8849db7d4837a802b461', '6409969bfd37699380ab64b27f6e701269ca27d9']",955134,24,955158,10991613,2637,,,,8430
92c36932503532875af57838c7fa88849b0ccac7,0,lukehan,2015-02-06 13:27:07+08:00,['e47fc7da4ff53db32f3757031171403bf666bd41'],0,12,12,10991625,1,,,,8431
65fd52799146b6d1c7079ffaf1bf6b508bcea68c,0,honma,2015-02-06 13:53:55+08:00,['92c36932503532875af57838c7fa88849b0ccac7'],2,18,20,10991645,1,0.727272727,1,1,8431
76298c603f2abf16c363d8cea20a080ee0a55c6c,0,honma,2015-02-06 13:53:55+08:00,['65fd52799146b6d1c7079ffaf1bf6b508bcea68c'],87,132,219,10991864,4,1,1,1,8432
249c2d3ade8d3d32fcb6d529c30cab224e15e473,0,honma,2015-02-06 14:57:50+08:00,['76298c603f2abf16c363d8cea20a080ee0a55c6c'],1,13,14,10991878,2,1,1,1,8433
3e74d88835df3183d9a7e64b46627dff32855e3c,0,qianhao.zhou,2015-02-06 15:25:10+08:00,['2d3722c31af17f4917885fea422d0602f70e74b2'],10,20,30,10991908,3,,,,8434
6b6275f4544541886b561a5af8376bfea5a1112a,0,qianhao.zhou,2015-02-06 15:38:32+08:00,['3e74d88835df3183d9a7e64b46627dff32855e3c'],2,6,8,10991916,2,,,,8434
b623d64e3aa733c92855cb421cb6eb55861375fc,0,lukehan,2015-02-06 16:08:24+08:00,['71a3373c9329037709250433ea3d4e0a7e8013d8'],13,12,25,10991941,11,,,,8434
67549a4ce8637cde5612cb8898588b6b4625df1d,0,lukehan,2015-02-06 16:09:13+08:00,"['21aa87b37cd7f86afcbbcfee246b0b1c9f844599', 'b623d64e3aa733c92855cb421cb6eb55861375fc']",13,12,25,10991966,11,,,,8434
3322bba5f56f673a350c51dc42d8aafe4e8e6fc3,0,qianhao.zhou,2015-02-06 16:16:07+08:00,['6b6275f4544541886b561a5af8376bfea5a1112a'],4,22,26,10991992,4,0,0,1,8434
93677b36d92d26ebee902b55c88d7ff118a881b9,0,lukehan,2015-02-06 16:19:09+08:00,['67549a4ce8637cde5612cb8898588b6b4625df1d'],11,11,22,10992014,11,,,,8434
40c62470a2bca6975c05a20e90df0af352dc3d3d,0,lukehan,2015-02-06 16:25:51+08:00,['93677b36d92d26ebee902b55c88d7ff118a881b9'],11,11,22,10992036,11,,,,8434
f7acce05d55ed9e467ca6edb5f95f345f9a6a2b4,0,qianhao.zhou,2015-02-06 16:30:51+08:00,['3322bba5f56f673a350c51dc42d8aafe4e8e6fc3'],14,10,24,10992060,2,,,,8434
b9bac205ff3abf4ee1ce7414752098eff1be59a5,1,lukehan,2015-02-06 16:51:29+08:00,['249c2d3ade8d3d32fcb6d529c30cab224e15e473'],0,45,45,10992105,1,,,,8434
a4f66db91055355cc039d286c9a10e27357dd449,0,lukehan,2015-02-06 16:55:11+08:00,['b9bac205ff3abf4ee1ce7414752098eff1be59a5'],7,0,7,10992112,1,,,,8434
04be9bb39cb70677e242dc4a9151c96c22456472,0,qianhao.zhou,2015-02-06 17:16:33+08:00,['f7acce05d55ed9e467ca6edb5f95f345f9a6a2b4'],1,2,3,10992115,1,1,1,1,8434
4a17a8fa69cafb8c5d3e88a52124895fb1d6bc53,0,lukehan,2015-02-06 17:17:33+08:00,['a4f66db91055355cc039d286c9a10e27357dd449'],16196,4,16200,11008315,52,0.031683168,0.17029703,0.093069307,8435
eb402c2b70154e925ec2e001789893222bc404a4,1,shaofengshi,2015-02-06 17:18:10+08:00,['5d3aad3659fb9522443d8849db7d4837a802b461'],130,216,346,11008661,5,0.376811594,1,1,8436
9f5ce2f091d759f2cf63f2d522757d25bddb5d47,1,shaofengshi,2015-02-06 17:18:38+08:00,['eb402c2b70154e925ec2e001789893222bc404a4'],3,3,6,11008667,1,,,,8436
3715fd6b394cfbefe1e4f84ab19fa17eb4bbd9b2,0,shaofengshi,2015-02-06 17:18:54+08:00,"['9f5ce2f091d759f2cf63f2d522757d25bddb5d47', '4a17a8fa69cafb8c5d3e88a52124895fb1d6bc53']",971423,244,971667,11980334,2697,,,,8436
cd959799d774fe0822d7429012a115cee677dd1e,0,Zhong Jian,2015-02-06 17:50:55+08:00,['92c36932503532875af57838c7fa88849b0ccac7'],31,29,60,11980394,4,1,0,0.666666667,8436
1ae87c7843db3746f045dbf4cc3a1e86ced8045d,0,qianhao.zhou,2015-02-06 17:53:19+08:00,['04be9bb39cb70677e242dc4a9151c96c22456472'],0,1,1,11980395,1,,,,8436
46c8af4633051235668cacca01bd96233a75a55f,0,qianhao.zhou,2015-02-06 18:07:14+08:00,"['1ae87c7843db3746f045dbf4cc3a1e86ced8045d', '3715fd6b394cfbefe1e4f84ab19fa17eb4bbd9b2']",1009141,676,1009817,12990212,2967,,,,8436
9ca884b121e126b2d588ee08265d101c167e4113,0,qianhao.zhou,2015-02-06 18:14:36+08:00,['46c8af4633051235668cacca01bd96233a75a55f'],0,2,2,12990214,1,,,,8436
48e69901cf301e38c20aa422a286a505bbc57990,1,Zhong Jian,2015-02-06 18:31:42+08:00,['cd959799d774fe0822d7429012a115cee677dd1e'],2,4,6,12990220,3,1,1,1,8436
6548198aa98b0a2046516bdd904112238b57c6ea,0,honma,2015-02-06 19:56:49+08:00,['3715fd6b394cfbefe1e4f84ab19fa17eb4bbd9b2'],2,13,15,12990235,2,0.6,1,1,8436
a58b970eb815c271e751b2b61015487b57525a68,0,honma,2015-02-06 19:56:49+08:00,['6548198aa98b0a2046516bdd904112238b57c6ea'],13,51,64,12990299,4,0,1,1,8438
b206c9be24c091e3a6057c3f21b66768ab0b2de6,0,honma,2015-02-06 19:56:49+08:00,['a58b970eb815c271e751b2b61015487b57525a68'],21,89,110,12990409,3,0.5,0.078947368,1,8438
154a2be9afab80e2a4cad21fe7ddac797db4dd5e,0,honma,2015-02-06 22:49:00+08:00,['b206c9be24c091e3a6057c3f21b66768ab0b2de6'],4,2,6,12990415,1,,,,8438
531353706ce7045f25cdcdcd145c3a519a802df6,0,shaofengshi,2015-02-07 16:15:28+08:00,['154a2be9afab80e2a4cad21fe7ddac797db4dd5e'],10,10,20,12990435,2,,,,8438
ecbc226156e7d1685bb8762655b8ffb5067b11bf,0,honma,2015-02-07 16:22:18+08:00,['531353706ce7045f25cdcdcd145c3a519a802df6'],6,19,25,12990460,1,1,1,1,8438
3f35aabaabf8043b45274a043bb6c03e713053b9,0,shaofengshi,2015-02-07 22:33:41+08:00,['ecbc226156e7d1685bb8762655b8ffb5067b11bf'],1,0,1,12990461,1,,,,8438
96afd8a3ca72e9603f4ec910e677bda93def9fea,0,qianhao.zhou,2015-02-09 09:59:40+08:00,['9ca884b121e126b2d588ee08265d101c167e4113'],4,6,10,12990471,4,,,,8438
7171f49c11a9b2ea529412aa7a4e2b2beecb9968,0,qianhao.zhou,2015-02-09 10:06:38+08:00,['96afd8a3ca72e9603f4ec910e677bda93def9fea'],6,4,10,12990481,4,,,,8438
c4452f2d78a6121354ee8b70347d9df425ae38d3,0,shaofengshi,2015-02-09 10:31:39+08:00,['3f35aabaabf8043b45274a043bb6c03e713053b9'],0,0,0,12990481,1,,,,8438
c3d925210bf0ac5c9907ef01357c093de50d9c6e,0,shaofengshi,2015-02-09 10:33:58+08:00,['c4452f2d78a6121354ee8b70347d9df425ae38d3'],0,0,0,12990481,1,,,,8439
2e19c610c344e32896574812493d3db9af8fcf28,0,lukehan,2015-02-09 11:22:48+08:00,['c3d925210bf0ac5c9907ef01357c093de50d9c6e'],52,0,52,12990533,1,,,,8439
c08bde3bfbe7bdaa6494b02fc09277ec4999974c,0,shaofengshi,2015-02-09 11:26:50+08:00,['c3d925210bf0ac5c9907ef01357c093de50d9c6e'],21,87,108,12990641,3,0.205882353,1,1,8439
9dfe133a073bdd7934b83497fdb5dc39f77bd995,0,shaofengshi,2015-02-09 11:27:03+08:00,"['c08bde3bfbe7bdaa6494b02fc09277ec4999974c', '2e19c610c344e32896574812493d3db9af8fcf28']",52,0,52,12990693,1,,,,8439
1d326f6e1f3a36c5bc631bc3e93d3ae0a4bf2d6b,0,qianhao.zhou,2015-02-09 12:29:20+08:00,['7171f49c11a9b2ea529412aa7a4e2b2beecb9968'],0,2,2,12990695,1,,,,8439
d75ac6ef5d06372acdcf618435fecd4c878eefcc,0,qianhao.zhou,2015-02-09 12:45:44+08:00,['1d326f6e1f3a36c5bc631bc3e93d3ae0a4bf2d6b'],10,10,20,12990715,4,0,0,0,8439
768595084f1b613494eca023a46726764205e8b1,0,qianhao.zhou,2015-02-09 13:26:14+08:00,"['9dfe133a073bdd7934b83497fdb5dc39f77bd995', 'd75ac6ef5d06372acdcf618435fecd4c878eefcc']",175,680,855,12991570,34,,,,8439
f954ca2c1b44e198283c21dfecff1e2aa0c234fa,0,qianhao.zhou,2015-02-09 17:32:31+08:00,['768595084f1b613494eca023a46726764205e8b1'],9,9,18,12991588,2,,,,8439
19869cc4ef35e2d26c278646b6633b9c18de9519,0,lukehan,2015-02-09 17:48:17+08:00,['40c62470a2bca6975c05a20e90df0af352dc3d3d'],1,1,2,12991590,1,,,,8439
bdbd46cd386a10999d7a4bedc21db1e6e84a7ceb,0,Li Yang,2015-02-09 17:58:32+08:00,"['40c62470a2bca6975c05a20e90df0af352dc3d3d', '438f92fce20beb4f1e8086121ce1070a9ccdb563']",2,104,106,12991696,3,,,,8439
79b8d0b02a5f445a988d390487fc84d19ed02289,0,lukehan,2015-02-09 18:11:00+08:00,"['19869cc4ef35e2d26c278646b6633b9c18de9519', 'bdbd46cd386a10999d7a4bedc21db1e6e84a7ceb']",2,104,106,12991802,3,,,,8439
003da0fd3ac02cd165ea2f18aef6f69e9bc7cb47,1,shaofengshi,2015-02-09 18:14:36+08:00,['f954ca2c1b44e198283c21dfecff1e2aa0c234fa'],5,5,10,12991812,1,,,,8439
c9d6c0c5e6d0c7d1c10ee056b7387b7566a73b51,0,Li Yang,2015-02-09 18:57:18+08:00,['79b8d0b02a5f445a988d390487fc84d19ed02289'],103,59,162,12991974,3,0.5,0.5,0.125,8439
d8d6bbb98519056d23d6317e81d4d92b6f927955,0,qianhao.zhou,2015-02-09 19:05:33+08:00,['f954ca2c1b44e198283c21dfecff1e2aa0c234fa'],0,4,4,12991978,4,0,0.75,1,8439
50a8f87f3270b7929396b478b7fb7dc945953263,0,qianhao.zhou,2015-02-09 19:05:47+08:00,"['d8d6bbb98519056d23d6317e81d4d92b6f927955', '003da0fd3ac02cd165ea2f18aef6f69e9bc7cb47']",5,5,10,12991988,1,,,,8439
32d261b3fb5313f66cf2eb2879cf26ad8e11d53a,0,qianhao.zhou,2015-02-09 19:32:45+08:00,['50a8f87f3270b7929396b478b7fb7dc945953263'],2,2,4,12991992,1,,,,8439
8b802a1580457e296985a5bf2ebf5023ac01cbeb,0,honma,2015-02-10 12:03:09+08:00,['32d261b3fb5313f66cf2eb2879cf26ad8e11d53a'],199,279,478,12992470,20,0,0,0,8439
048112418e3d3edec63fe8d031398929dbdbea70,0,honma,2015-02-10 12:03:09+08:00,['8b802a1580457e296985a5bf2ebf5023ac01cbeb'],51,30,81,12992551,4,1,1,1,8439
f53d9a5a988d4e92389361dc8229feea06e5f7a9,0,qianhao.zhou,2015-02-10 12:30:05+08:00,['32d261b3fb5313f66cf2eb2879cf26ad8e11d53a'],5,16,21,12992572,4,0,0,1,8439
42e93bc9e3cbb55fa98e303e18f3020280eaf5e3,0,qianhao.zhou,2015-02-10 12:30:22+08:00,"['f53d9a5a988d4e92389361dc8229feea06e5f7a9', '048112418e3d3edec63fe8d031398929dbdbea70']",185,244,429,12993001,20,,,,8439
9dafadc6804eb7ee0bbae3b7ba4194c631d3199a,0,Li Yang,2015-02-10 06:47:18+00:00,"['1514d65c02193de55fc95bf6d68d261a362d063a', '3e45678083fec302482efb1f880daade760f0a21']",26283,108501,134784,13127785,1167,,,,8439
f88a1f3ba311aa8e4c805e569fc7a738efe7f75f,0,shaofengshi,2015-02-10 14:47:24+08:00,['42e93bc9e3cbb55fa98e303e18f3020280eaf5e3'],10,2,12,13127797,1,0,0,0,8439
706bd733cc9b0f06fd6a7d523166de95c98858df,0,honma,2015-02-10 16:11:46+08:00,['93677b36d92d26ebee902b55c88d7ff118a881b9'],1,1,2,13127799,1,,,,8439
2845a2581e3ff588c1b43efa59986e2750a45be0,0,Zhong Jian,2015-02-10 16:13:02+08:00,['48e69901cf301e38c20aa422a286a505bbc57990'],1,4,5,13127804,1,,,,8439
60ff3a2bcc4b3635121c3f93ef2451329ad3cdcd,0,Zhong Jian,2015-02-10 16:14:35+08:00,"['f88a1f3ba311aa8e4c805e569fc7a738efe7f75f', '2845a2581e3ff588c1b43efa59986e2750a45be0']",34,37,71,13127875,8,,,,8439
afc1e35da77b90809d32b177ecbde4f9325f34be,0,honma,2015-02-10 16:14:50+08:00,['60ff3a2bcc4b3635121c3f93ef2451329ad3cdcd'],4,4,8,13127883,3,,,,8439
216514973cc7aef8cf99bc0106defac2e334ed08,1,qianhao.zhou,2015-02-10 16:49:08+08:00,['42e93bc9e3cbb55fa98e303e18f3020280eaf5e3'],522,79,601,13128484,26,,,,8440
e25c71689d627b814a7cfafe4bebebb3a0fc8daa,0,qianhao.zhou,2015-02-10 16:51:14+08:00,"['216514973cc7aef8cf99bc0106defac2e334ed08', 'afc1e35da77b90809d32b177ecbde4f9325f34be']",44,39,83,13128567,9,,,,8440
5afd275cdda46ed095e007c6f1c9770a4e287106,0,qianhao.zhou,2015-02-10 16:53:23+08:00,['e25c71689d627b814a7cfafe4bebebb3a0fc8daa'],2,2,4,13128571,2,,,,8440
08f77193e20f10fbc8640d1dfff226705d61e4b5,0,qianhao.zhou,2015-02-10 17:01:44+08:00,['5afd275cdda46ed095e007c6f1c9770a4e287106'],1,1,2,13128573,2,,,,8440
04d69274d5d7c75bdd4f585452ad96539e20acc4,0,qianhao.zhou,2015-02-10 17:20:45+08:00,['08f77193e20f10fbc8640d1dfff226705d61e4b5'],3,13,16,13128589,1,,,,8440
ca78fe5109313fc12b28ba9d30e75fdc1e6ebc15,0,qianhao.zhou,2015-02-10 17:26:48+08:00,['04d69274d5d7c75bdd4f585452ad96539e20acc4'],1,2,3,13128592,1,,,,8440
f1341f78f4c0cfbfbc6abf417fe322d968372902,1,qianhao.zhou,2015-02-10 17:30:16+08:00,['ca78fe5109313fc12b28ba9d30e75fdc1e6ebc15'],1,155,156,13128748,6,,,,8445
d92e1145d13a19b4a993f48ac26fda9d4284aef9,0,qianhao.zhou,2015-02-10 17:35:21+08:00,['f1341f78f4c0cfbfbc6abf417fe322d968372902'],2,2,4,13128752,1,,,,8445
d9b4f4aa048230db5859c37669b88f22e6f0e14e,1,shaofengshi,2015-02-10 17:38:56+08:00,['f88a1f3ba311aa8e4c805e569fc7a738efe7f75f'],154,305,459,13129211,9,0.573529412,0.426470588,0.882352941,8447
cec2c583cfbc48072c226cbaf63271829aabebb6,0,shaofengshi,2015-02-10 17:39:21+08:00,"['d9b4f4aa048230db5859c37669b88f22e6f0e14e', 'd92e1145d13a19b4a993f48ac26fda9d4284aef9']",424,149,573,13129784,38,,,,8447
f3dd8b1ff5165ec7f18e0343273d0f93642cfef3,0,qianhao.zhou,2015-02-10 17:49:20+08:00,['d92e1145d13a19b4a993f48ac26fda9d4284aef9'],5,5,10,13129794,2,,,,8447
857c1d288ca3f950a8d67f36b3902a394f025bdf,0,qianhao.zhou,2015-02-10 17:49:58+08:00,"['f3dd8b1ff5165ec7f18e0343273d0f93642cfef3', 'cec2c583cfbc48072c226cbaf63271829aabebb6']",154,305,459,13130253,9,,,,8447
88ae67845faf877f93880a4b8223b8f2e4647edf,1,qianhao.zhou,2015-02-10 17:59:31+08:00,['857c1d288ca3f950a8d67f36b3902a394f025bdf'],4,4,8,13130261,2,,,,8447
0da79cd4bdc38b7de1debf899f05258929ecc489,1,Zhong Jian,2015-02-10 20:47:14+08:00,['88ae67845faf877f93880a4b8223b8f2e4647edf'],77,169,246,13130507,6,1,1,0.971428571,8449
8ee809d99fdafed0e15b505984d96eaed7351216,1,honma,2015-02-11 09:14:20+08:00,['afc1e35da77b90809d32b177ecbde4f9325f34be'],46,149,195,13130702,14,0.787234043,0.85106383,0.957446809,8450
0ecabae1ea83e8388f08a306d7f250d1ff117c31,0,Zhong Jian,2015-02-11 10:28:15+08:00,['0da79cd4bdc38b7de1debf899f05258929ecc489'],1,2,3,13130705,38,,,,8450
94b917f6e4250e727e2487f34b761919171ae561,0,Li Yang,2015-02-11 03:17:02+00:00,['c9d6c0c5e6d0c7d1c10ee056b7387b7566a73b51'],1,1,2,13130707,1,,,,8450
888716ace20b1e007cf56acb1ebcbe2f5c56f7dc,0,qianhao.zhou,2015-02-11 11:49:12+08:00,['88ae67845faf877f93880a4b8223b8f2e4647edf'],9,7,16,13130723,4,,,,8450
669dc0abf66440d21cb59b65a14826686bdafbf6,0,qianhao.zhou,2015-02-11 11:50:21+08:00,['888716ace20b1e007cf56acb1ebcbe2f5c56f7dc'],0,1,1,13130724,1,,,,8450
17f956be2d90386047e44b414e122e4741e9ffe7,0,honma,2015-02-11 13:59:49+08:00,['706bd733cc9b0f06fd6a7d523166de95c98858df'],27,8,35,13130759,3,0,0,0,8450
3e948db1ad1602533fdad45366274aaa6dbf02a2,0,honma,2015-02-11 14:10:47+08:00,['17f956be2d90386047e44b414e122e4741e9ffe7'],3,3,6,13130765,2,,,,8450
91f416fba64457af01b057ecaf039020ede2c02c,0,qianhao.zhou,2015-02-11 14:15:24+08:00,['669dc0abf66440d21cb59b65a14826686bdafbf6'],15,0,15,13130780,1,,,,8450
f9ccc852dbd8e0c40375eee1650b2f918cbae784,0,Li Yang,2015-02-11 14:56:48+08:00,['94b917f6e4250e727e2487f34b761919171ae561'],1,1,2,13130782,1,,,,8450
25bac026a8e563f1bef55d6beed38a972bf0fa42,0,qianhao.zhou,2015-02-11 15:39:15+08:00,['91f416fba64457af01b057ecaf039020ede2c02c'],3,11,14,13130796,2,,,,8450
83c9ebe155c4dbe2b431bc06222dd90fdc30159a,0,shaofengshi,2015-02-11 15:43:39+08:00,['88ae67845faf877f93880a4b8223b8f2e4647edf'],6,1,7,13130803,4,,,,8450
7983e40e9a98caefae27e616b13a2ea2cd748239,0,shaofengshi,2015-02-11 15:43:48+08:00,"['83c9ebe155c4dbe2b431bc06222dd90fdc30159a', '25bac026a8e563f1bef55d6beed38a972bf0fa42']",27,19,46,13130849,6,,,,8450
5e46e64a8402a5a44790e80e136161fecb3610ef,0,Li Yang,2015-02-11 15:45:01+08:00,['91f416fba64457af01b057ecaf039020ede2c02c'],13,3,16,13130865,1,,,,8450
4e94007e0d057e7d54e8d20b97ea736ae138b031,0,Li Yang,2015-02-11 15:45:21+08:00,"['5e46e64a8402a5a44790e80e136161fecb3610ef', '7983e40e9a98caefae27e616b13a2ea2cd748239']",9,12,21,13130886,6,,,,8450
67256a5d8b647f27eaa871819cdf7f1234c2619e,0,qianhao.zhou,2015-02-11 15:47:00+08:00,['25bac026a8e563f1bef55d6beed38a972bf0fa42'],3,9,12,13130898,1,,,,8450
94c9ac1ab7aa6f07f355f9bcc862f09c9a64df60,0,qianhao.zhou,2015-02-11 15:47:26+08:00,"['67256a5d8b647f27eaa871819cdf7f1234c2619e', '4e94007e0d057e7d54e8d20b97ea736ae138b031']",19,4,23,13130921,5,,,,8450
82955b99d1d07a338e6f39cfaccf63e575e96071,0,Li Yang,2015-02-11 15:49:35+08:00,['4e94007e0d057e7d54e8d20b97ea736ae138b031'],75,1,76,13130997,1,0.791666667,0.75,0,8450
05cf0a06ea637935864e95c6aa98ce0d46a70573,0,Li Yang,2015-02-11 15:50:03+08:00,"['82955b99d1d07a338e6f39cfaccf63e575e96071', '94c9ac1ab7aa6f07f355f9bcc862f09c9a64df60']",3,9,12,13131009,1,,,,8450
4dd0ac31aad1ef25559fcaa642662af103fdfd62,0,Li Yang,2015-02-11 15:50:36+08:00,['05cf0a06ea637935864e95c6aa98ce0d46a70573'],2,2,4,13131013,1,,,,8450
593f3d17756122efe7f057476ab5dd7e7ff401a1,0,Zhong Jian,2015-02-11 15:57:26+08:00,['1d4d7017a29f76e2b9e7b3519ff61e718f27b64f'],19,7,26,13131039,1,1,0.785714286,0.071428571,8450
f58908bc634b9aaf0c884b87690d026c646d71c1,0,shaofengshi,2015-02-11 15:58:16+08:00,['f9ccc852dbd8e0c40375eee1650b2f918cbae784'],1,1,2,13131041,1,,,,8450
2b68951a915d92c281bad9c08aebc18385252025,0,Zhong Jian,2015-02-11 15:58:30+08:00,"['f9ccc852dbd8e0c40375eee1650b2f918cbae784', '593f3d17756122efe7f057476ab5dd7e7ff401a1']",19,7,26,13131067,1,,,,8450
fd1f88c48237a4308a1b140431a2bfebaa8b8d42,0,shaofengshi,2015-02-11 16:01:03+08:00,"['f58908bc634b9aaf0c884b87690d026c646d71c1', '2b68951a915d92c281bad9c08aebc18385252025']",19,7,26,13131093,1,,,,8450
108bc23388a8bd360a9e3e3d522ed42435a39caa,0,shaofengshi,2015-02-11 16:03:42+08:00,['4dd0ac31aad1ef25559fcaa642662af103fdfd62'],1,1,2,13131095,1,,,,8450
d4a9e55ff3361d7de061966ebbb43d2d9538a4c6,0,shaofengshi,2015-02-11 16:09:20+08:00,['108bc23388a8bd360a9e3e3d522ed42435a39caa'],0,0,0,13131095,29,,,,8450
e2d642eb1ede12aa326b0fba27040964b5970ce8,0,Zhong Jian,2015-02-11 17:16:34+08:00,['593f3d17756122efe7f057476ab5dd7e7ff401a1'],0,1,1,13131096,1,,,,8450
a2186d78e6148376f92cd75ca5e46daad57744b6,0,Zhong Jian,2015-02-11 17:40:42+08:00,"['fd1f88c48237a4308a1b140431a2bfebaa8b8d42', 'e2d642eb1ede12aa326b0fba27040964b5970ce8']",0,1,1,13131097,1,,,,8450
9b9050f27fe7c22f08f7b9de0f3f79ae28aaba16,0,Zhong Jian,2015-02-11 19:18:56+08:00,"['0ecabae1ea83e8388f08a306d7f250d1ff117c31', 'd4a9e55ff3361d7de061966ebbb43d2d9538a4c6']",122,31,153,13131250,41,,,,8450
c75cddec413c8673fb794ab94054b50f46e83673,1,Zhong Jian,2015-02-11 19:53:55+08:00,['9b9050f27fe7c22f08f7b9de0f3f79ae28aaba16'],2,16,18,13131268,6,,,,8450
5dec70c00af6bd6e594a6fee7a6f0821cc94852d,0,Zhong Jian,2015-02-11 19:55:07+08:00,"['d4a9e55ff3361d7de061966ebbb43d2d9538a4c6', 'c75cddec413c8673fb794ab94054b50f46e83673']",80,187,267,13131535,50,,,,8450
695ca34f2b5729f27710aa61d2fc0faf4e911337,0,lukehan,2015-02-11 22:38:36+08:00,"['a2186d78e6148376f92cd75ca5e46daad57744b6', '3e948db1ad1602533fdad45366274aaa6dbf02a2']",31,12,43,13131578,5,,,,8450
f9d970f8d039f054ad60138585eb72ed21e03b02,0,lukehan,2015-02-11 23:04:21+08:00,['695ca34f2b5729f27710aa61d2fc0faf4e911337'],176,4,180,13131758,2,,,,8450
719065b371c21d80d448bb66f3f364bb1c122b9a,0,lukehan,2015-02-11 23:04:32+08:00,['f9d970f8d039f054ad60138585eb72ed21e03b02'],0,172,172,13131930,1,,,,8451
fb316713f9eacbf49e49b47f83f894a393019b0b,0,lukehan,2015-02-12 00:10:37+08:00,['719065b371c21d80d448bb66f3f364bb1c122b9a'],11,11,22,13131952,11,,,,8451
ad9dac5857b8ac75c8669c3410308977f52f4c03,0,qianhao.zhou,2015-02-12 10:35:46+08:00,['94c9ac1ab7aa6f07f355f9bcc862f09c9a64df60'],54,72,126,13132078,12,,,,8452
95573e157926bdc7830686d52da5631c207c0edd,0,qianhao.zhou,2015-02-12 10:35:55+08:00,"['ad9dac5857b8ac75c8669c3410308977f52f4c03', '5dec70c00af6bd6e594a6fee7a6f0821cc94852d']",158,191,349,13132427,81,,,,8452
7cdd98fe23f1782c5cdf8dc73be0620dae410325,1,honma,2015-02-12 10:36:37+08:00,['8ee809d99fdafed0e15b505984d96eaed7351216'],254,325,579,13133006,13,0.913043478,0.891304348,0.760869565,8452
fd7414cc143765041a06617faaa732a81f3f8bd8,0,honma,2015-02-12 10:59:59+08:00,"['7cdd98fe23f1782c5cdf8dc73be0620dae410325', '95573e157926bdc7830686d52da5631c207c0edd']",1094,1058,2152,13135158,119,,,,8452
98d1cd3e628ffd72a94a9dbd3b8802fbbd961e64,0,honma,2015-02-12 11:03:33+08:00,['fd7414cc143765041a06617faaa732a81f3f8bd8'],82,18,100,13135258,9,0.677419355,0.032258065,0,8452
2957e7e9c8ba48bb9e7d08e1e48c52ebf2fd8087,0,honma,2015-02-12 13:02:57+08:00,['98d1cd3e628ffd72a94a9dbd3b8802fbbd961e64'],7,8,15,13135273,1,0,0,1,8452
7394d1ab92742ba6a46d5c74c0ad25abd1ce085d,0,lukehan,2015-02-12 13:09:25+08:00,['2957e7e9c8ba48bb9e7d08e1e48c52ebf2fd8087'],116,448,564,13135837,15,,,,8459
990f5556a4d7ec342ce6e90b64432ebb129a6799,0,Li Yang,2015-02-12 13:20:11+08:00,['95573e157926bdc7830686d52da5631c207c0edd'],8,14,22,13135859,3,,,,8459
906b4ff4379daf9fc11809e4fb6b87912c7d5806,0,Li Yang,2015-02-12 13:20:33+08:00,"['990f5556a4d7ec342ce6e90b64432ebb129a6799', '7394d1ab92742ba6a46d5c74c0ad25abd1ce085d']",648,1148,1796,13137655,31,,,,8459
94264a82ccf5a7946c37da50855a36f1e15b90cd,0,Li Yang,2015-02-12 05:34:36+00:00,"['906b4ff4379daf9fc11809e4fb6b87912c7d5806', '9dafadc6804eb7ee0bbae3b7ba4194c631d3199a']",0,0,0,13137655,0,,,,8459
2badc88fb67a1d05947c51f9c575c356b22a1b46,0,shaofengshi,2015-02-12 14:25:38+08:00,['d4a9e55ff3361d7de061966ebbb43d2d9538a4c6'],16,9,25,13137680,1,1,1,0,8459
54f4e19826266d8ca7d26a075d4aa86c21e07bb6,0,shaofengshi,2015-02-12 14:25:55+08:00,"['2badc88fb67a1d05947c51f9c575c356b22a1b46', '906b4ff4379daf9fc11809e4fb6b87912c7d5806']",790,1421,2211,13139891,93,,,,8459
33d8c283d1f2c998e887f00e4ac2eef175c6fc1a,0,shaofengshi,2015-02-12 14:26:23+08:00,['54f4e19826266d8ca7d26a075d4aa86c21e07bb6'],0,0,0,13139891,29,,,,8459
7abbdb2025071b2fa14859ec1d196ed322420483,0,shaofengshi,2015-02-12 14:26:46+08:00,['33d8c283d1f2c998e887f00e4ac2eef175c6fc1a'],1,6,7,13139898,4,,,,8461
ace966f8ec9facc6ccdedebee404ea4fe5096d40,0,shaofengshi,2015-02-12 14:29:07+08:00,['7abbdb2025071b2fa14859ec1d196ed322420483'],2,1,3,13139901,2,,,,8461
97c0fbd314df7f8f4acd983b9bba48ce6eeab58a,0,lukehan,2015-02-12 15:40:15+08:00,['906b4ff4379daf9fc11809e4fb6b87912c7d5806'],651,699,1350,13141251,4,,,,8462
666c2d6d04f9012062df0ac3d1acb93da21b7af6,0,lukehan,2015-02-12 15:42:33+08:00,['97c0fbd314df7f8f4acd983b9bba48ce6eeab58a'],0,1,1,13141252,6,,,,8462
369c830462e4d9fabbf39f01bace85b8ec330d86,0,lukehan,2015-02-12 15:42:48+08:00,"['666c2d6d04f9012062df0ac3d1acb93da21b7af6', 'ace966f8ec9facc6ccdedebee404ea4fe5096d40']",16,13,29,13141281,33,,,,8462
23a361012ffb780ffe88e747de48fc7e74c68876,1,lukehan,2015-02-12 15:46:21+08:00,['369c830462e4d9fabbf39f01bace85b8ec330d86'],4,1,5,13141286,1,,,,8462
4177a4d0fad7512f6210d4ba4e065d067f9e4f18,0,lukehan,2015-02-12 15:50:02+08:00,['23a361012ffb780ffe88e747de48fc7e74c68876'],1,1,2,13141288,1,,,,8462
a4991f6c2ef0b75618036cdffddf99f03c393ac7,0,lukehan,2015-02-12 16:00:49+08:00,['4177a4d0fad7512f6210d4ba4e065d067f9e4f18'],141,1,142,13141430,3,,,,8462
4ec3d0c691db04e8204e85fbc1193da543d61558,0,qianhao.zhou,2015-02-12 16:56:16+08:00,['a4991f6c2ef0b75618036cdffddf99f03c393ac7'],2,2,4,13141434,1,,,,8462
d3bd9d7dcca2e39d66b9b2e45422c2caa13f4f74,1,honma,2015-02-12 17:39:23+08:00,['4ec3d0c691db04e8204e85fbc1193da543d61558'],48,97,145,13141579,14,0.787878788,0.787878788,1,8463
50fe818657a28ce5cb7ccb9e7a66b879c1a9c032,0,honma,2015-02-12 17:39:23+08:00,['d3bd9d7dcca2e39d66b9b2e45422c2caa13f4f74'],23,4,27,13141606,5,0,0,0,8464
bff95ab1be08faf6aafdb40331944d611619c048,1,honma,2015-02-12 18:31:22+08:00,['50fe818657a28ce5cb7ccb9e7a66b879c1a9c032'],57,35,92,13141698,4,0,0,0,8464
375e3a84aa525d75d96350efc748432358f41728,0,Li Yang,2015-02-13 09:03:21+08:00,['906b4ff4379daf9fc11809e4fb6b87912c7d5806'],20,18,38,13141736,5,,,,8464
37af13adcff4ee3b25ae3171be9e83793b75c505,0,Li Yang,2015-02-13 09:03:36+08:00,"['375e3a84aa525d75d96350efc748432358f41728', 'bff95ab1be08faf6aafdb40331944d611619c048']",931,842,1773,13143509,67,,,,8464
53de7164e43e446e14c22e4a940e448377e7c5a3,0,shaofengshi,2015-02-13 10:51:27+08:00,['bff95ab1be08faf6aafdb40331944d611619c048'],20,15,35,13143544,2,,,,8464
545f9ea5be205c9ee395a479272f377b0ea4344a,1,Li Yang,2015-02-13 11:14:21+08:00,['37af13adcff4ee3b25ae3171be9e83793b75c505'],5,28,33,13143577,2,1,1,1,8464
2bed1e2d614d42637f067386b5bd2ff718763140,0,Li Yang,2015-02-13 11:15:27+08:00,"['545f9ea5be205c9ee395a479272f377b0ea4344a', '53de7164e43e446e14c22e4a940e448377e7c5a3']",20,15,35,13143612,2,,,,8464
69093b05b23d6e3843f2a0cd54d25aff0036b2b5,0,qianhao.zhou,2015-02-13 11:49:12+08:00,['4ec3d0c691db04e8204e85fbc1193da543d61558'],2,21,23,13143635,1,,,,8464
76324e256fc27ef9d3b07b17d2688d986e69b226,0,qianhao.zhou,2015-02-13 11:49:28+08:00,"['69093b05b23d6e3843f2a0cd54d25aff0036b2b5', 'bff95ab1be08faf6aafdb40331944d611619c048']",121,129,250,13143885,21,,,,8464
68f88efc945f8abfa2588538be2f930b38ece459,0,Li Yang,2015-02-13 13:50:01+08:00,['2bed1e2d614d42637f067386b5bd2ff718763140'],3,6,9,13143894,1,0,0,1,8464
2b978b3e329603520829276e476eb9eac1b77f25,0,qianhao.zhou,2015-02-13 14:55:14+08:00,['76324e256fc27ef9d3b07b17d2688d986e69b226'],13,4,17,13143911,1,,,,8464
38159cb59ed764291a46bd98c6baa0a9d25f35aa,1,Li Yang,2015-02-13 14:59:31+08:00,['68f88efc945f8abfa2588538be2f930b38ece459'],107,56,163,13144074,13,1,0.783783784,0,8464
29f29b02978c9887a1f6a0a46ec9408094637157,0,qianhao.zhou,2015-02-13 15:04:55+08:00,['2b978b3e329603520829276e476eb9eac1b77f25'],4,4,8,13144082,1,,,,8464
b745be165268ddcb52a11a369290c094a1ad34d2,1,qianhao.zhou,2015-02-13 15:14:02+08:00,"['29f29b02978c9887a1f6a0a46ec9408094637157', '38159cb59ed764291a46bd98c6baa0a9d25f35aa']",150,117,267,13144349,21,,,,8464
10eb942e241df2c7acdf2ef00bc165caa79a9e74,1,shaofengshi,2015-02-13 15:35:03+08:00,['bff95ab1be08faf6aafdb40331944d611619c048'],27,427,454,13144803,15,0.774193548,1,1,8469
62856d2c766ddef28f02f8252d4afe9ae733bf3f,1,shaofengshi,2015-02-13 15:36:03+08:00,['10eb942e241df2c7acdf2ef00bc165caa79a9e74'],161,172,333,13145136,27,1,1,0,8469
4a5de3c5e60193a0048950800bc6e2e34c673efb,0,shaofengshi,2015-02-13 15:36:18+08:00,"['62856d2c766ddef28f02f8252d4afe9ae733bf3f', 'b745be165268ddcb52a11a369290c094a1ad34d2']",0,0,0,13145136,0,,,,8469
24821ded2274708163ba3d3b20d231e975653a1b,1,qianhao.zhou,2015-02-13 18:19:17+08:00,['b745be165268ddcb52a11a369290c094a1ad34d2'],13,31,44,13145180,2,0.1875,1,1,8469
9b72ee8a460d847d7c733f1c42245f9f3803125b,0,qianhao.zhou,2015-02-15 11:17:42+08:00,"['4a5de3c5e60193a0048950800bc6e2e34c673efb', '24821ded2274708163ba3d3b20d231e975653a1b']",13,31,44,13145224,2,,,,8469
4ddb0f2a11709a6441452de1cddb38b78743e64a,0,shaofengshi,2015-02-15 18:01:29+08:00,['b745be165268ddcb52a11a369290c094a1ad34d2'],5,7,12,13145236,5,1,0,1,8469
d72a71bb9364aba44139b5ed81958862ac21c31f,0,shaofengshi,2015-02-15 18:01:51+08:00,"['4ddb0f2a11709a6441452de1cddb38b78743e64a', '24821ded2274708163ba3d3b20d231e975653a1b']",13,31,44,13145280,2,,,,8469
c7297b20c47abab5168e5e83e5868ed2999b1e6d,1,shaofengshi,2015-02-15 20:45:20+08:00,['d72a71bb9364aba44139b5ed81958862ac21c31f'],1,8,9,13145289,2,1,1,1,8469
4a15a4f28534b4c4fb2af6c9ced8a9c1107d282f,0,shaofengshi,2015-02-15 21:33:48+08:00,"['9b72ee8a460d847d7c733f1c42245f9f3803125b', 'c7297b20c47abab5168e5e83e5868ed2999b1e6d']",6,15,21,13145310,6,,,,8469
4ac8bef2b22c6bd4e6a619182560d5aaf6387c63,0,shaofengshi,2015-02-16 16:37:32+08:00,['c7297b20c47abab5168e5e83e5868ed2999b1e6d'],0,7,7,13145317,1,,,,8469
f069e4f7ec900d804f3834b9314ed093b33a74c7,0,qianhao.zhou,2015-02-16 17:45:54+08:00,['9b72ee8a460d847d7c733f1c42245f9f3803125b'],0,989,989,13146306,14,0.511278195,0.804511278,0.812030075,8482
ff622052235b8b46dd144df9f260ec4cf8886a86,0,qianhao.zhou,2015-02-16 17:46:09+08:00,"['f069e4f7ec900d804f3834b9314ed093b33a74c7', '4a15a4f28534b4c4fb2af6c9ced8a9c1107d282f']",6,15,21,13146327,6,,,,8482
61c83a7d009df7a657acc300ad2e25cb73727ee3,0,qianhao.zhou,2015-02-16 17:46:31+08:00,"['ff622052235b8b46dd144df9f260ec4cf8886a86', '4ac8bef2b22c6bd4e6a619182560d5aaf6387c63']",0,7,7,13146334,1,,,,8482
e2e6d8bd9a493e5b91d791f321a2c907833107e1,0,qianhao.zhou,2015-02-17 13:59:40+08:00,['61c83a7d009df7a657acc300ad2e25cb73727ee3'],0,94,94,13146428,1,0.428571429,1,1,8483
158751c831b03f8095aaf86c51c7ccd58f72543f,0,Zhong Jian,2015-02-26 23:27:58+08:00,['4ac8bef2b22c6bd4e6a619182560d5aaf6387c63'],14,9,23,13146451,4,0,0,1,8483
f763d6de8071bf9b445fdf13a12017dc4fe7faa2,0,Zhong Jian,2015-02-26 23:36:50+08:00,"['4ac8bef2b22c6bd4e6a619182560d5aaf6387c63', '158751c831b03f8095aaf86c51c7ccd58f72543f']",14,9,23,13146474,4,,,,8483
b42ada703aa340af78ace1cff441bea0cd4d7729,0,Zhong Jian,2015-02-27 00:08:53+08:00,['158751c831b03f8095aaf86c51c7ccd58f72543f'],58,64,122,13146596,1,1,1,1,8483
985ffd2f255b92618bdec982d98691fbe0833e74,0,Zhong Jian,2015-02-27 00:10:13+08:00,"['f763d6de8071bf9b445fdf13a12017dc4fe7faa2', 'b42ada703aa340af78ace1cff441bea0cd4d7729']",58,64,122,13146718,1,,,,8483
9d57e975d94fab4ea8023c5ee5b712613d43e09d,1,Zhong Jian,2015-02-27 11:03:07+08:00,['b42ada703aa340af78ace1cff441bea0cd4d7729'],3,3,6,13146724,3,,,,8483
4c2dd47675ebfd3be278731a046f6c8242f4d1f5,0,Zhong Jian,2015-02-27 11:05:10+08:00,"['985ffd2f255b92618bdec982d98691fbe0833e74', '9d57e975d94fab4ea8023c5ee5b712613d43e09d']",3,3,6,13146730,3,,,,8483
f2a357592087d0eb43a2fee0a22fda8fe9ebd597,1,Li Yang,2015-02-27 13:22:22+08:00,['985ffd2f255b92618bdec982d98691fbe0833e74'],105,81,186,13146916,23,0,0,0,8483
6cae9769c04803c9d16ac3923bcb06498cb23cfd,0,Li Yang,2015-02-27 13:22:43+08:00,"['f2a357592087d0eb43a2fee0a22fda8fe9ebd597', '4c2dd47675ebfd3be278731a046f6c8242f4d1f5']",3,3,6,13146922,3,,,,8483
cf460c12482a31fb56ff02cd94b63875fe1a1567,1,Zhong Jian,2015-02-27 13:54:15+08:00,['9d57e975d94fab4ea8023c5ee5b712613d43e09d'],8,31,39,13146961,3,0.909090909,1,0.909090909,8483
dbed1077959a8ba3ad3cf671bc84cb3179822074,0,Li Yang,2015-02-27 06:13:19+00:00,"['e2e6d8bd9a493e5b91d791f321a2c907833107e1', '6cae9769c04803c9d16ac3923bcb06498cb23cfd']",180,157,337,13147298,31,,,,8483
47b4348a1608aefd20eb83773ffe29ba63e179a2,0,Li Yang,2015-02-27 06:24:36+00:00,"['6cae9769c04803c9d16ac3923bcb06498cb23cfd', '94264a82ccf5a7946c37da50855a36f1e15b90cd']",0,0,0,13147298,0,,,,8483
511c598e1e107f6c906ea944bc6a0469fcc1658d,0,shaofengshi,2015-02-27 14:24:59+08:00,['e2e6d8bd9a493e5b91d791f321a2c907833107e1'],4,135,139,13147437,3,0.492307692,1,0.938461538,8484
9d5fb549135c6fbeea25848f24fb6110e3187597,0,shaofengshi,2015-02-27 14:25:40+08:00,"['511c598e1e107f6c906ea944bc6a0469fcc1658d', 'dbed1077959a8ba3ad3cf671bc84cb3179822074']",180,157,337,13147774,31,,,,8484
568106f6cb499f25f2e2444b50d2a4380104059d,1,Zhong Jian,2015-02-27 16:49:20+08:00,['cf460c12482a31fb56ff02cd94b63875fe1a1567'],27,64,91,13147865,6,0,0,1,8484
2318d77d8634d7e7b141268eb6e9ea9769c8a295,0,Zhong Jian,2015-02-27 16:52:25+08:00,"['6cae9769c04803c9d16ac3923bcb06498cb23cfd', '568106f6cb499f25f2e2444b50d2a4380104059d']",22,82,104,13147969,6,,,,8484
20ebda6b91e11947b8f32dba46cfdbb4d7f682f1,0,Li Yang,2015-02-27 10:00:24+00:00,"['dbed1077959a8ba3ad3cf671bc84cb3179822074', '2318d77d8634d7e7b141268eb6e9ea9769c8a295']",22,82,104,13148073,6,,,,8484
eebbefc49f4eea14ca4eded9836b825f4bec1199,1,Zhong Jian,2015-02-27 18:28:06+08:00,['568106f6cb499f25f2e2444b50d2a4380104059d'],20,31,51,13148124,4,0.875,1,0.875,8484
9134e2fe2bf9098a3275a39d399b0d2a3ded3b95,0,Zhong Jian,2015-02-27 18:29:29+08:00,"['2318d77d8634d7e7b141268eb6e9ea9769c8a295', 'eebbefc49f4eea14ca4eded9836b825f4bec1199']",20,31,51,13148175,4,,,,8484
d6d7eebf2760a17b7d2583adcc641f2eea592fd8,0,shaofengshi,2015-02-28 09:41:13+08:00,['9d5fb549135c6fbeea25848f24fb6110e3187597'],18,30,48,13148223,3,1,1,1,8484
a4549cbde6801a87d5180070ffab47688443a1b3,0,shaofengshi,2015-02-28 09:41:26+08:00,"['d6d7eebf2760a17b7d2583adcc641f2eea592fd8', '20ebda6b91e11947b8f32dba46cfdbb4d7f682f1']",22,82,104,13148327,6,,,,8484
af60190d43713abc41188aec2fce40bf3c4d1594,0,Zhong Jian,2015-02-28 15:01:39+08:00,['9134e2fe2bf9098a3275a39d399b0d2a3ded3b95'],83,90,173,13148500,5,0.285714286,0.285714286,0,8484
4f19f7979bbca64a59f1289a29477eb6b69e7837,0,Zhong Jian,2015-02-28 15:39:30+08:00,['af60190d43713abc41188aec2fce40bf3c4d1594'],50,56,106,13148606,1,0.981481481,1,1,8484
1bb118cf34c8cc3c144dec24852a24764ab752ae,0,Zhong Jian,2015-02-28 17:40:18+08:00,['4f19f7979bbca64a59f1289a29477eb6b69e7837'],92,97,189,13148795,6,0.285714286,0,0.428571429,8484
3a59eefd7557091ddcc45fce696638b4919bbe85,0,Zhong Jian,2015-02-28 17:42:16+08:00,"['9134e2fe2bf9098a3275a39d399b0d2a3ded3b95', '1bb118cf34c8cc3c144dec24852a24764ab752ae']",173,191,364,13149159,10,,,,8484
5fae5ecd806e07ed2cac98683b2934d29b934a41,0,qianhao.zhou,2015-03-02 10:00:24+08:00,"['a4549cbde6801a87d5180070ffab47688443a1b3', '3a59eefd7557091ddcc45fce696638b4919bbe85']",193,222,415,13149574,14,,,,8484
d8b15a081288ab087abeef40f76cda8842c70dd0,0,qianhao.zhou,2015-03-02 11:41:56+08:00,['5fae5ecd806e07ed2cac98683b2934d29b934a41'],1,29,30,13149604,2,0,0.894736842,0.105263158,8484
dc0acadfef61d11240067b163b14accb658b37cf,0,Li Yang,2015-03-02 14:03:28+08:00,['3a59eefd7557091ddcc45fce696638b4919bbe85'],1,1,2,13149606,1,,,,8484
31cf12e5293dd9b342a60a64f21944cabdd4ffac,0,Li Yang,2015-03-02 06:04:03+00:00,"['d8b15a081288ab087abeef40f76cda8842c70dd0', 'dc0acadfef61d11240067b163b14accb658b37cf']",1,1,2,13149608,1,,,,8484
e3ec671b71c035fa5bd339aab37c7e9e3495d7c2,0,shaofengshi,2015-03-02 16:48:18+08:00,['a4549cbde6801a87d5180070ffab47688443a1b3'],32,60,92,13149700,9,0,0,1,8484
c2b90a9ddd4d2e9ed5c1cd067c3454352f8f71d7,0,Zhong Jian,2015-03-02 17:48:52+08:00,['1bb118cf34c8cc3c144dec24852a24764ab752ae'],2,6,8,13149708,2,0,1,1,8484
881a8c4c72a11dd0f73838939928faa58c4f0e2d,0,Zhong Jian,2015-03-02 17:49:45+08:00,"['dc0acadfef61d11240067b163b14accb658b37cf', 'c2b90a9ddd4d2e9ed5c1cd067c3454352f8f71d7']",2,6,8,13149716,2,,,,8484
fe767187ea46064914069743606770a67473c5cf,0,qianhao.zhou,2015-03-02 18:10:48+08:00,['d8b15a081288ab087abeef40f76cda8842c70dd0'],242,286,528,13150244,12,0.58,1,1,8487
9bc3f32c9600c5fbba94fff6f6539fe5f27fc973,0,qianhao.zhou,2015-03-03 10:14:32+08:00,"['fe767187ea46064914069743606770a67473c5cf', '31cf12e5293dd9b342a60a64f21944cabdd4ffac']",1,1,2,13150246,1,,,,8487
ec3f1dffa87740fb8086f20f6115bea3b049090d,0,qianhao.zhou,2015-03-03 11:09:58+08:00,['9bc3f32c9600c5fbba94fff6f6539fe5f27fc973'],0,1,1,13150247,1,0,1,1,8487
16fd3aa5dbd264a8936a28d6957e23fc946c2722,1,honma,2015-03-03 15:39:44+08:00,['31cf12e5293dd9b342a60a64f21944cabdd4ffac'],12,316,328,13150575,6,0.323943662,0.769953052,1,8488
5f35c41add087c45a2a86ea551620e6b5bf7bbf1,0,honma,2015-03-03 15:39:44+08:00,['16fd3aa5dbd264a8936a28d6957e23fc946c2722'],55,8,63,13150638,5,1,0,0,8488
538e181b2dc4a5e68c270f6798756fbcfc5004fb,0,honma,2015-03-03 15:39:45+08:00,['5f35c41add087c45a2a86ea551620e6b5bf7bbf1'],4,3,7,13150645,2,0.5,1,1,8488
5a7bae90a4acc9a9f6f4f3475bc12bf80ca799c6,0,qianhao.zhou,2015-03-03 16:06:58+08:00,['ec3f1dffa87740fb8086f20f6115bea3b049090d'],69,82,151,13150796,11,0,0,1,8488
87ed83131f255e074024e8f0de3a66bc843faef0,0,qianhao.zhou,2015-03-03 16:07:04+08:00,"['5a7bae90a4acc9a9f6f4f3475bc12bf80ca799c6', '538e181b2dc4a5e68c270f6798756fbcfc5004fb']",10,266,276,13151072,3,,,,8488
5a0252ff2da141016f0c79367e8d447a09b8c32a,1,Zhong Jian,2015-03-03 16:11:56+08:00,['881a8c4c72a11dd0f73838939928faa58c4f0e2d'],2,2,4,13151076,1,,,,8488
e90105cf238fdd0264f6f93624bb3ed81e096089,0,Zhong Jian,2015-03-03 16:13:02+08:00,"['881a8c4c72a11dd0f73838939928faa58c4f0e2d', '5a0252ff2da141016f0c79367e8d447a09b8c32a']",2,2,4,13151080,1,,,,8488
c49da3328a9aab6bfe6d7666196e71b36b9287ed,0,Li Yang,2015-03-03 10:02:40+00:00,"['e90105cf238fdd0264f6f93624bb3ed81e096089', '47b4348a1608aefd20eb83773ffe29ba63e179a2']",0,0,0,13151080,0,,,,8488
0546a5e7cd96e90791d80657013d1defd583f525,0,qianhao.zhou,2015-03-03 18:09:40+08:00,['87ed83131f255e074024e8f0de3a66bc843faef0'],6,98,104,13151184,4,1,1,1,8489
2d248ed2556aff7a2a838ed24af7d1d344e05c52,0,qianhao.zhou,2015-03-03 18:10:58+08:00,['c49da3328a9aab6bfe6d7666196e71b36b9287ed'],0,7,7,13151191,1,,,,8489
1ee6dc6b7bef1e491035c48a41e0ccd127634f28,0,Li Yang,2015-03-03 10:25:17+00:00,"['c49da3328a9aab6bfe6d7666196e71b36b9287ed', 'fb316713f9eacbf49e49b47f83f894a393019b0b']",0,0,0,13151191,0,,,,8489
1a880c9f3d1fbe91ae465250f24d6bee0bbf59c8,1,Zhong Jian,2015-03-03 18:55:16+08:00,['5a0252ff2da141016f0c79367e8d447a09b8c32a'],74,122,196,13151387,7,0.714285714,1,0.469387755,8489
1d9011e9f609b9e882d93e139410fa180c464107,0,Zhong Jian,2015-03-03 18:56:25+08:00,"['c49da3328a9aab6bfe6d7666196e71b36b9287ed', '1a880c9f3d1fbe91ae465250f24d6bee0bbf59c8']",74,122,196,13151583,7,,,,8489
765eedec70e3c00fb491a11364e69ba38dd72e8c,1,Zhong Jian,2015-03-04 20:11:55+08:00,['1d9011e9f609b9e882d93e139410fa180c464107'],8,18,26,13151609,5,1,1,0.833333333,8489
96648b6d4468d3b360609ed8fe5afb7d1494fa2c,0,Zhong Jian,2015-03-04 20:19:25+08:00,"['1d9011e9f609b9e882d93e139410fa180c464107', '765eedec70e3c00fb491a11364e69ba38dd72e8c']",8,18,26,13151635,5,,,,8489
3ccba5dc7c29a99bbddd6c54fdc74dbd10f5ae4b,1,shaofengshi,2015-03-04 21:27:05+08:00,['e3ec671b71c035fa5bd339aab37c7e9e3495d7c2'],255,367,622,13152257,28,0,0,0.985714286,8493
41f50eca1bbfecada45491177d5f015799f6555d,0,shaofengshi,2015-03-04 21:29:15+08:00,"['3ccba5dc7c29a99bbddd6c54fdc74dbd10f5ae4b', '0546a5e7cd96e90791d80657013d1defd583f525']",508,971,1479,13153736,36,,,,8493
65f27fe2a7b7e85642cd28df61c79ff095abf4b1,0,qianhao.zhou,2015-03-05 10:16:14+08:00,['96648b6d4468d3b360609ed8fe5afb7d1494fa2c'],0,9,9,13153745,1,,,,8493
2870f1fc69c6f87649178d43846456187eeb9c2d,0,qianhao.zhou,2015-03-05 10:18:17+08:00,"['41f50eca1bbfecada45491177d5f015799f6555d', '65f27fe2a7b7e85642cd28df61c79ff095abf4b1']",86,157,243,13153988,15,,,,8493
0b9545f1fa20414369d389bc74ee833a0d84956e,0,qianhao.zhou,2015-03-05 10:18:28+08:00,"['2870f1fc69c6f87649178d43846456187eeb9c2d', '2d248ed2556aff7a2a838ed24af7d1d344e05c52']",0,7,7,13153995,1,,,,8493
620a00b221943440dd2f5773989984e61ca961fa,0,Zhong Jian,2015-03-05 14:44:35+08:00,['765eedec70e3c00fb491a11364e69ba38dd72e8c'],14,11,25,13154020,3,,,,8493
2bbb0df3270830c0b7a93fad93dbfed5aadd8afe,1,Zhong Jian,2015-03-05 14:47:28+08:00,['620a00b221943440dd2f5773989984e61ca961fa'],1,1,2,13154022,1,,,,8493
aa91bc8945580e27cf137a48932084f4d5d6d7ad,0,Zhong Jian,2015-03-05 14:48:10+08:00,"['65f27fe2a7b7e85642cd28df61c79ff095abf4b1', '2bbb0df3270830c0b7a93fad93dbfed5aadd8afe']",14,11,25,13154047,3,,,,8493
eda6591199a6ea66bbaa2cdb58f5d9ad30561e83,1,honma,2015-03-05 14:52:17+08:00,['538e181b2dc4a5e68c270f6798756fbcfc5004fb'],188,292,480,13154527,15,0.66,0.7,0.74,8495
80141e069bd8d8ca6621cc4a0b64d46b55ba51f3,0,honma,2015-03-05 14:53:12+08:00,"['eda6591199a6ea66bbaa2cdb58f5d9ad30561e83', '0b9545f1fa20414369d389bc74ee833a0d84956e']",671,1039,1710,13156237,66,,,,8495
ace0fac9a6e59f8a98c3e2b6f71b4d24efbbd0be,1,shaofengshi,2015-03-05 18:00:12+08:00,['41f50eca1bbfecada45491177d5f015799f6555d'],227,359,586,13156823,59,1,0,0.375,8495
5dca7436ef1ccab479dc71a48a01f79f9cd74cca,0,shaofengshi,2015-03-05 18:00:57+08:00,"['ace0fac9a6e59f8a98c3e2b6f71b4d24efbbd0be', '0b9545f1fa20414369d389bc74ee833a0d84956e']",86,164,250,13157073,16,,,,8495
071a74f88cc4f950f5474988d4337a6a2e07a973,0,shaofengshi,2015-03-05 18:01:41+08:00,['5dca7436ef1ccab479dc71a48a01f79f9cd74cca'],30,0,30,13157103,1,0,0.714285714,0,8495
37757cea720a9ba22ea9e993ae57494ab0e37368,0,shaofengshi,2015-03-05 18:07:01+08:00,['071a74f88cc4f950f5474988d4337a6a2e07a973'],1,1,2,13157105,1,1,1,1,8495
c82088d77958cb8b49e59ebf1a1152f6a5122972,0,qianhao.zhou,2015-03-05 18:13:11+08:00,['80141e069bd8d8ca6621cc4a0b64d46b55ba51f3'],12,38,50,13157155,2,0,0.947368421,1,8495
ca0f9aac88b744221df77831fc7ef3e8956b23d6,0,qianhao.zhou,2015-03-05 18:16:49+08:00,['37757cea720a9ba22ea9e993ae57494ab0e37368'],0,2,2,13157157,1,,,,8495
ccc19f44c870e0ceb8c27025814a52c86f9d85a3,0,qianhao.zhou,2015-03-05 18:17:07+08:00,"['c82088d77958cb8b49e59ebf1a1152f6a5122972', 'ca0f9aac88b744221df77831fc7ef3e8956b23d6']",256,360,616,13157773,61,,,,8495
c27d0c50fc975d2c1500f5312955291949bb9269,1,Zhong Jian,2015-03-05 20:37:11+08:00,['2bbb0df3270830c0b7a93fad93dbfed5aadd8afe'],352,400,752,13158525,11,0,0,0.948717949,8495
35a7a85e6241da957c88f5b18df5f0034a448bda,0,Zhong Jian,2015-03-05 20:43:37+08:00,"['aa91bc8945580e27cf137a48932084f4d5d6d7ad', 'c27d0c50fc975d2c1500f5312955291949bb9269']",352,400,752,13159277,11,,,,8495
9067ab3962aa3b430f34b07757dcc6a6d2df58f5,0,shaofengshi,2015-03-05 22:27:26+08:00,['37757cea720a9ba22ea9e993ae57494ab0e37368'],1,1,2,13159279,1,,,,8495
09d443624b8d4b84bb6226b619bfe6e0c54dea35,0,shaofengshi,2015-03-05 22:27:38+08:00,"['9067ab3962aa3b430f34b07757dcc6a6d2df58f5', 'ca0f9aac88b744221df77831fc7ef3e8956b23d6']",0,2,2,13159281,1,,,,8495
abdeb5cf76fdda528ddab7798ea273ee9c3d59a7,0,qianhao.zhou,2015-03-06 10:27:49+08:00,['09d443624b8d4b84bb6226b619bfe6e0c54dea35'],0,1,1,13159282,1,,,,8495
9b0b0dddcfd09990267c2b12b7b3592b88b8d317,0,shaofengshi,2015-03-06 13:14:06+08:00,['09d443624b8d4b84bb6226b619bfe6e0c54dea35'],1,1,2,13159284,1,,,,8495
d58c8cea741c05a7ca58102e2dbb82260c948e8e,0,shaofengshi,2015-03-06 13:29:35+08:00,"['9b0b0dddcfd09990267c2b12b7b3592b88b8d317', 'abdeb5cf76fdda528ddab7798ea273ee9c3d59a7']",0,1,1,13159285,1,,,,8495
cb2467956b442c6ce23edc52ebea239dff0daa6f,1,qianhao.zhou,2015-03-06 14:09:08+08:00,['35a7a85e6241da957c88f5b18df5f0034a448bda'],76,76,152,13159437,3,,,,8496
17943e0c1e0957c44e0ff312fd909eb1e0723d23,0,qianhao.zhou,2015-03-06 14:22:36+08:00,['cb2467956b442c6ce23edc52ebea239dff0daa6f'],0,3,3,13159440,1,,,,8496
a70ec89f5068926596bf4e9c8f6b00776d72fab9,0,qianhao.zhou,2015-03-06 14:23:03+08:00,"['ccc19f44c870e0ceb8c27025814a52c86f9d85a3', '17943e0c1e0957c44e0ff312fd909eb1e0723d23']",442,490,932,13160372,16,,,,8496
5b46650e7bc3237848457ed08f6c2a1e8f5ed402,0,shaofengshi,2015-03-06 14:25:14+08:00,['d58c8cea741c05a7ca58102e2dbb82260c948e8e'],63,41,104,13160476,4,1,1,0,8496
107df5109decf67757460b126c9f2b5927e3c03e,0,lukehan,2015-03-06 14:55:01+08:00,['17943e0c1e0957c44e0ff312fd909eb1e0723d23'],6,13,19,13160495,1,,,,8496
fda9af720fba765aa88b38bb57e6f2d6c63b7135,0,lukehan,2015-03-06 14:55:31+08:00,"['1ee6dc6b7bef1e491035c48a41e0ccd127634f28', '107df5109decf67757460b126c9f2b5927e3c03e']",530,652,1182,13161677,26,,,,8496
182fcb80abd7a276e10a97a10240d46d595ef77d,0,qianhao.zhou,2015-03-06 14:56:55+08:00,['a70ec89f5068926596bf4e9c8f6b00776d72fab9'],94,48,142,13161819,4,1,0.558139535,0,8496
e972574a6b235ab5c7bc3f0442a157ac2cc07f86,0,Luke Han,2015-03-06 15:03:17+08:00,['fda9af720fba765aa88b38bb57e6f2d6c63b7135'],4,3,7,13161826,1,,,,8496
cb61d2aa5e3ef1de95931aa9fc603451f389b2ef,0,shaofengshi,2015-03-06 15:46:47+08:00,['5b46650e7bc3237848457ed08f6c2a1e8f5ed402'],19,18,37,13161863,2,,,,8496
9e8c7949c0ea045d48c73be4914976523dbf77d3,0,qianhao.zhou,2015-03-06 16:43:29+08:00,['182fcb80abd7a276e10a97a10240d46d595ef77d'],23,147,170,13162033,3,0.147368421,0.431578947,0.736842105,8496
660d30e8f0777a718de50207a809457acb0d3d99,1,shaofengshi,2015-03-06 16:47:50+08:00,['cb61d2aa5e3ef1de95931aa9fc603451f389b2ef'],9,152,161,13162194,5,1,1,1,8496
d6c367c94a491c900ebcc48f1e99310f9680ccf2,0,qianhao.zhou,2015-03-06 17:34:02+08:00,['9e8c7949c0ea045d48c73be4914976523dbf77d3'],15,12,27,13162221,5,,,,8496
16f2f955c79bfc47a1e69e176b64a050e466cae0,0,qianhao.zhou,2015-03-06 18:08:17+08:00,['d6c367c94a491c900ebcc48f1e99310f9680ccf2'],0,41,41,13162262,1,,,,8497
c2b319e615a097ee044b1309d0ca8c02d6295cab,0,qianhao.zhou,2015-03-06 18:08:33+08:00,"['16f2f955c79bfc47a1e69e176b64a050e466cae0', '660d30e8f0777a718de50207a809457acb0d3d99']",91,212,303,13162565,12,,,,8497
6fe1b9513d9df774160289931c8eff64f27ae865,1,Li Yang,2015-03-06 18:16:11+08:00,['0b9545f1fa20414369d389bc74ee833a0d84956e'],15,313,328,13162893,15,0.882352941,0.772058824,0.963235294,8505
5fe296a7453bbd809e77f6d36cd4d6bfac18c2aa,0,Li Yang,2015-03-06 18:16:34+08:00,"['6fe1b9513d9df774160289931c8eff64f27ae865', '660d30e8f0777a718de50207a809457acb0d3d99']",344,569,913,13163806,71,,,,8505
85e8be9818f1e5c467da06cebfe014ea383a1161,1,Zhong Jian,2015-03-06 18:20:21+08:00,['c27d0c50fc975d2c1500f5312955291949bb9269'],47,60,107,13163913,4,0.678571429,0.714285714,0.964285714,8505
68bd3e9a646f57a565894025c44ea67b600eaaa7,0,Zhong Jian,2015-03-06 18:21:17+08:00,"['e972574a6b235ab5c7bc3f0442a157ac2cc07f86', '85e8be9818f1e5c467da06cebfe014ea383a1161']",47,60,107,13164020,4,,,,8505
b1f36d81156e0478b0f1c0192fa5950f961d3fe5,1,Mustangore,2015-03-06 14:47:13+01:00,['e972574a6b235ab5c7bc3f0442a157ac2cc07f86'],2,4,6,13164026,1,0,0,1,8505
127c621bb3866060064ae6a0e6621490bc457166,0,Li Yang,2015-03-09 14:49:34+08:00,['5fe296a7453bbd809e77f6d36cd4d6bfac18c2aa'],6,23,29,13164055,4,,,,8506
6152c2804de2c19c151a645f2022cf5bcaecd84b,0,Li Yang,2015-03-09 15:04:52+08:00,['127c621bb3866060064ae6a0e6621490bc457166'],86,43,129,13164184,13,0,0,0,8507
a358a3cb2206ab57217581c11e9237d33b40f7a4,0,Zhong Jian,2015-03-09 16:26:58+08:00,['68bd3e9a646f57a565894025c44ea67b600eaaa7'],13,34,47,13164231,4,0.384615385,1,1,8507
415b56740b1b63c5e63ac0a583396388ea8a4389,0,Zhong Jian,2015-03-09 16:28:11+08:00,"['68bd3e9a646f57a565894025c44ea67b600eaaa7', 'a358a3cb2206ab57217581c11e9237d33b40f7a4']",13,34,47,13164278,4,,,,8507
dbcfa28aad492b90a763a9692b061ff5804892bb,0,Zhong Jian,2015-03-09 17:09:14+08:00,['a358a3cb2206ab57217581c11e9237d33b40f7a4'],2,3,5,13164283,2,,,,8507
49f6c2d5f23e40889c7c783424f344a55078df59,1,shaofengshi,2015-03-09 17:09:16+08:00,['68bd3e9a646f57a565894025c44ea67b600eaaa7'],4,9,13,13164296,1,0,0,0,8507
71e179d4fd00654565d70e3a2c43c2ef0e636a33,0,Zhong Jian,2015-03-09 17:10:09+08:00,"['415b56740b1b63c5e63ac0a583396388ea8a4389', 'dbcfa28aad492b90a763a9692b061ff5804892bb']",2,3,5,13164301,2,,,,8507
67a72c8771729592a7076a46fce0eb9b0f9a792e,0,shaofengshi,2015-03-09 17:10:31+08:00,"['49f6c2d5f23e40889c7c783424f344a55078df59', '71e179d4fd00654565d70e3a2c43c2ef0e636a33']",14,36,50,13164351,5,,,,8507
f630541927da6a0b33d22fc82cd15f69e067331d,0,shaofengshi,2015-03-09 17:33:37+08:00,['67a72c8771729592a7076a46fce0eb9b0f9a792e'],9,12,21,13164372,3,1,1,1,8507
c37ebad3baa012e516aa72b0cb15c17d1e12b2ab,1,Li Yang,2015-03-09 18:06:56+08:00,['6152c2804de2c19c151a645f2022cf5bcaecd84b'],217,304,521,13164893,25,0.5,1,0.727272727,8510
94e7a0fbcd8ac0ade7647546915bc2394418b2cf,0,Li Yang,2015-03-09 18:09:17+08:00,"['e972574a6b235ab5c7bc3f0442a157ac2cc07f86', 'b1f36d81156e0478b0f1c0192fa5950f961d3fe5']",2,4,6,13164899,1,,,,8510
0d91373b3e4885394ecaba877211fd1bccd59e3a,0,qianhao.zhou,2015-03-09 18:14:02+08:00,"['c2b319e615a097ee044b1309d0ca8c02d6295cab', '127c621bb3866060064ae6a0e6621490bc457166']",15,330,345,13165244,16,,,,8510
de7a09b1e853a60f21596cfd410b28d2588669d7,0,Li Yang,2015-03-09 11:22:43+01:00,"['f630541927da6a0b33d22fc82cd15f69e067331d', '94e7a0fbcd8ac0ade7647546915bc2394418b2cf']",2,4,6,13165250,1,,,,8510
ebc25bf048da85e8f3e36426f601b5778e705f18,1,Zhong Jian,2015-03-09 18:25:39+08:00,['dbcfa28aad492b90a763a9692b061ff5804892bb'],69,81,150,13165400,2,,,,8510
c5ce244f866d9e2b3d0e508a5ea807e5b64b7a2a,0,Li Yang,2015-03-09 11:25:57+01:00,"['c37ebad3baa012e516aa72b0cb15c17d1e12b2ab', 'de7a09b1e853a60f21596cfd410b28d2588669d7']",500,598,1098,13166498,26,,,,8510
523e10d610cffc0507e23d7e55ef7750bb0fdb48,1,qianhao.zhou,2015-03-09 18:51:33+08:00,['0d91373b3e4885394ecaba877211fd1bccd59e3a'],0,156,156,13166654,1,0.2,1,1,8511
87530b914d6b7b5c82ca6f31ea65761257876a84,0,Li Yang,2015-03-09 14:02:34+01:00,"['523e10d610cffc0507e23d7e55ef7750bb0fdb48', 'c5ce244f866d9e2b3d0e508a5ea807e5b64b7a2a']",380,473,853,13167507,44,,,,8511
c5098e22916e9fe0d03d98ce14d107c072227b53,0,Zhong Jian,2015-03-09 23:04:28+08:00,['ebc25bf048da85e8f3e36426f601b5778e705f18'],1,1,2,13167509,1,,,,8511
fc1ae6fec4a07a378df932db4f7448cc68f60932,0,lukehan,2015-03-09 17:25:21-07:00,['e972574a6b235ab5c7bc3f0442a157ac2cc07f86'],1,1,2,13167511,1,,,,8511
77072329adcb5364ca89500ec96ecec1c859ea24,0,lukehan,2015-03-09 17:25:28-07:00,"['fc1ae6fec4a07a378df932db4f7448cc68f60932', 'de7a09b1e853a60f21596cfd410b28d2588669d7']",76,121,197,13167708,13,,,,8511
2d9a8f9c14e90a51e08e8f435fca8c40bd865ef4,0,qianhao.zhou,2015-03-10 11:24:58+08:00,['de7a09b1e853a60f21596cfd410b28d2588669d7'],1,9,10,13167718,1,1,1,1,8511
c11350ab441b105eb10282f87bcde4790d38a3a6,0,qianhao.zhou,2015-03-10 11:26:49+08:00,"['87530b914d6b7b5c82ca6f31ea65761257876a84', '2d9a8f9c14e90a51e08e8f435fca8c40bd865ef4']",1,9,10,13167728,1,,,,8511
5c2012f98b9d86d95fe7332637cbf284fca84ea4,0,vipin kumar,2015-03-10 11:24:30+05:18,['94e7a0fbcd8ac0ade7647546915bc2394418b2cf'],2,3,5,13167733,1,,,,8511
1ad540150ace20e4497d223e9ce081cd0f7b7eec,0,qianhao.zhou,2015-03-10 14:12:58+08:00,"['94e7a0fbcd8ac0ade7647546915bc2394418b2cf', '5c2012f98b9d86d95fe7332637cbf284fca84ea4']",2,3,5,13167738,1,,,,8511
3f5933970c07d9992ecd8cc4e114a2b1ac3df920,0,Zhong Jian,2015-03-10 14:43:52+08:00,['c5098e22916e9fe0d03d98ce14d107c072227b53'],27,23,50,13167788,5,0.8,1,0.8,8511
54f897b78e6ce5bf4c6c79cebf3707c0dcda9a6a,0,Zhong Jian,2015-03-10 14:49:36+08:00,"['2d9a8f9c14e90a51e08e8f435fca8c40bd865ef4', '3f5933970c07d9992ecd8cc4e114a2b1ac3df920']",94,102,196,13167984,7,,,,8511
678a146eff02887b046bcc8bbb658bf0190cf67f,1,shaofengshi,2015-03-10 15:21:12+08:00,['f630541927da6a0b33d22fc82cd15f69e067331d'],0,2,2,13167986,2,0.5,1,1,8511
90a06200effc0fccc7af0c3ffe6bde3672310d63,0,Zhong Jian,2015-03-10 15:25:37+08:00,['3f5933970c07d9992ecd8cc4e114a2b1ac3df920'],0,2,2,13167988,2,1,1,1,8511
ca7b7b4984ec6902f1c4a744d5a5716a8e99e569,0,Zhong Jian,2015-03-10 15:27:18+08:00,"['54f897b78e6ce5bf4c6c79cebf3707c0dcda9a6a', '90a06200effc0fccc7af0c3ffe6bde3672310d63']",0,2,2,13167990,2,,,,8511
0a80daf7f36625f392fe9222c34c66a9501a558e,0,qianhao.zhou,2015-03-10 16:56:20+08:00,['c11350ab441b105eb10282f87bcde4790d38a3a6'],37,64,101,13168091,7,0.2,0,0.266666667,8511
851123c4ae927d254a28c23294f96587e299f6bf,0,Li Yang,2015-03-10 16:56:27+08:00,['c2b319e615a097ee044b1309d0ca8c02d6295cab'],4,4,8,13168099,1,,,,8511
43d26e44b9b8522c6cfde551206b183863e3c82f,0,qianhao.zhou,2015-03-10 16:56:33+08:00,"['0a80daf7f36625f392fe9222c34c66a9501a558e', 'ca7b7b4984ec6902f1c4a744d5a5716a8e99e569']",94,104,198,13168297,9,,,,8511
09e75232d91ffc7b67dee5cee65572c619b2cf2d,0,Li Yang,2015-03-10 16:56:56+08:00,"['851123c4ae927d254a28c23294f96587e299f6bf', '87530b914d6b7b5c82ca6f31ea65761257876a84']",395,959,1354,13169651,61,,,,8511
54a0ee7b8c7531661f3f258d953ac967a00056a9,0,Li Yang,2015-03-10 16:57:34+08:00,"['09e75232d91ffc7b67dee5cee65572c619b2cf2d', '43d26e44b9b8522c6cfde551206b183863e3c82f']",132,177,309,13169960,17,,,,8511
73df4b5f20a250da360717906518c390c6725524,0,Zhong Jian,2015-03-10 17:17:52+08:00,['90a06200effc0fccc7af0c3ffe6bde3672310d63'],11,2,13,13169973,4,0,0,0,8511
83f3ad94af4c0865950492ecb2f265e12b584eda,0,Zhong Jian,2015-03-10 17:18:54+08:00,"['ca7b7b4984ec6902f1c4a744d5a5716a8e99e569', '73df4b5f20a250da360717906518c390c6725524']",11,2,13,13169986,4,,,,8511
d3688232803a15a807ec130b171c57ed36edafb9,0,qianhao.zhou,2015-03-10 17:33:02+08:00,['43d26e44b9b8522c6cfde551206b183863e3c82f'],25,87,112,13170098,5,1,1,0.666666667,8512
22e1a2969703e151827c27d79bfa8bf11e6d738c,0,Zhong Jian,2015-03-10 18:20:16+08:00,"['c5ce244f866d9e2b3d0e508a5ea807e5b64b7a2a', '83f3ad94af4c0865950492ecb2f265e12b584eda']",106,115,221,13170319,14,,,,8512
6722aadfa828e3d39be6f44fd8e2ca5d8ad46ff8,0,Zhong Jian,2015-03-10 18:22:07+08:00,"['c5ce244f866d9e2b3d0e508a5ea807e5b64b7a2a', '22e1a2969703e151827c27d79bfa8bf11e6d738c']",106,115,221,13170540,14,,,,8512
3f626c99d15d4952a2341a8bed284c5931b6490e,0,qianhao.zhou,2015-03-10 18:25:33+08:00,['d3688232803a15a807ec130b171c57ed36edafb9'],50,56,106,13170646,8,1,1,,8512
7ae698d6f67883ae22f76180e53d4ae4ba002a71,0,qianhao.zhou,2015-03-10 18:25:41+08:00,"['3f626c99d15d4952a2341a8bed284c5931b6490e', '54a0ee7b8c7531661f3f258d953ac967a00056a9']",4,4,8,13170654,1,,,,8512
542455581fd38254f196b67b6407cd164b2b1d3c,0,lukehan,2015-03-10 09:47:08-07:00,"['77072329adcb5364ca89500ec96ecec1c859ea24', '83f3ad94af4c0865950492ecb2f265e12b584eda']",106,115,221,13170875,14,,,,8512
6fa41e2cd4144a1478694472deecebfb8b945451,0,lukehan,2015-03-10 09:51:32-07:00,['542455581fd38254f196b67b6407cd164b2b1d3c'],1,1,2,13170877,1,,,,8512
486be1193a273dbc4062f34c869ffebd4e5cdbe3,1,Li Yang,2015-03-11 10:40:51+08:00,['7ae698d6f67883ae22f76180e53d4ae4ba002a71'],71,122,193,13171070,19,1,1,1,8513
29d18430e0d7a47b457c134bfe8bf43e0059f705,1,shaofengshi,2015-03-11 11:21:26+08:00,['678a146eff02887b046bcc8bbb658bf0190cf67f'],20,44,64,13171134,1,0.923076923,1,1,8513
eeb880f45791960a43cbf4531a8d7d288af5504b,0,shaofengshi,2015-03-11 11:22:04+08:00,"['29d18430e0d7a47b457c134bfe8bf43e0059f705', '6fa41e2cd4144a1478694472deecebfb8b945451']",109,120,229,13171363,16,,,,8513
0b71f2f2457e0fd8b672e71797745745337554a1,0,shaofengshi,2015-03-11 11:32:07+08:00,['eeb880f45791960a43cbf4531a8d7d288af5504b'],0,1,1,13171364,1,1,1,1,8513
5c8c2335d5962d433f6460d4ed9e0ed7c319e9c0,0,shaofengshi,2015-03-11 14:02:33+08:00,"['6722aadfa828e3d39be6f44fd8e2ca5d8ad46ff8', '0b71f2f2457e0fd8b672e71797745745337554a1']",21,48,69,13171433,4,,,,8513
39b4a62c473793650dbebd1c55e5ff88bb57a1b0,1,qianhao.zhou,2015-03-11 15:40:59+08:00,['7ae698d6f67883ae22f76180e53d4ae4ba002a71'],61,100,161,13171594,8,0,0,0.760869565,8513
c5aa4c100c032812e7a9a6e9f9a9cff289d7d17e,0,qianhao.zhou,2015-03-11 15:41:08+08:00,"['39b4a62c473793650dbebd1c55e5ff88bb57a1b0', '486be1193a273dbc4062f34c869ffebd4e5cdbe3']",71,122,193,13171787,19,,,,8513
869454245a09f8b83eb5acc34a7e8dbfdf959f7a,0,qianhao.zhou,2015-03-11 16:50:40+08:00,['c5aa4c100c032812e7a9a6e9f9a9cff289d7d17e'],5,44,49,13171836,3,0.833333333,1,0.708333333,8513
703a3fa73473a6affd45c5061e09755acc2bf106,0,qianhao.zhou,2015-03-11 17:42:16+08:00,['869454245a09f8b83eb5acc34a7e8dbfdf959f7a'],5,6,11,13171847,1,,,,8513
3153ae13ccce8adb346b154b73a08908414f21ef,1,qianhao.zhou,2015-03-11 18:17:41+08:00,['703a3fa73473a6affd45c5061e09755acc2bf106'],9,56,65,13171912,2,1,1,1,8513
271e412560e683fb24aa35b62a0150b9fe127a59,0,qianhao.zhou,2015-03-11 18:19:46+08:00,"['3153ae13ccce8adb346b154b73a08908414f21ef', '5c8c2335d5962d433f6460d4ed9e0ed7c319e9c0']",32,50,82,13171994,8,,,,8513
45dd455bb009934869df08c227d3a67728a783bd,0,qianhao.zhou,2015-03-11 18:46:30+08:00,['271e412560e683fb24aa35b62a0150b9fe127a59'],6,3,9,13172003,1,,,,8513
87c9bbce70435553b83b66ec1d880300d79a9c24,0,honma,2015-03-11 15:30:52-07:00,['5c8c2335d5962d433f6460d4ed9e0ed7c319e9c0'],1,5,6,13172009,2,0,0.5,1,8513
963ce522a05848703baa11a610f8318a5243bda0,0,lukehan,2015-03-11 17:41:08-07:00,"['0b71f2f2457e0fd8b672e71797745745337554a1', '1ad540150ace20e4497d223e9ce081cd0f7b7eec']",2,3,5,13172014,1,,,,8513
239768ab2559bbda12f6d2956936013cea20ca7e,0,qianhao.zhou,2015-03-12 15:02:02+08:00,['45dd455bb009934869df08c227d3a67728a783bd'],7,21,28,13172042,4,0,0,1,8513
94a293c4b700951642fe58ca0436ba0d07fbdc2b,0,qianhao.zhou,2015-03-12 16:01:36+08:00,"['239768ab2559bbda12f6d2956936013cea20ca7e', '963ce522a05848703baa11a610f8318a5243bda0']",2,3,5,13172047,1,,,,8513
013fd3160605c0b387e4e1c8e66b9eef07dcd2f4,1,shaofengshi,2015-03-12 17:40:29+08:00,['0b71f2f2457e0fd8b672e71797745745337554a1'],5,11889,11894,13183941,16,,,,8525
ab811fc04673039f036165038d98ad802053ec2c,1,qianhao.zhou,2015-03-12 17:47:02+08:00,['94a293c4b700951642fe58ca0436ba0d07fbdc2b'],483,430,913,13184854,13,0.706382979,0.417021277,0.093617021,8526
d7009636a9c40e868402c9129aad7517ac985573,0,qianhao.zhou,2015-03-12 18:25:11+08:00,['ab811fc04673039f036165038d98ad802053ec2c'],4,24,28,13184882,3,0.823529412,0.823529412,0.823529412,8526
577709c4a3b5b9457617e43776fc4a65279eb186,0,qianhao.zhou,2015-03-12 18:50:45+08:00,['d7009636a9c40e868402c9129aad7517ac985573'],31,42,73,13184955,3,0.363636364,0.363636364,1,8526
ccd498eb3e5121af7b1a0c3929984e2780b87e1f,1,qianhao.zhou,2015-03-12 21:02:01+08:00,['577709c4a3b5b9457617e43776fc4a65279eb186'],71,103,174,13185129,10,0,0,1,8526
ab95645c5c3545cfd450a1f72105d44aff4f588a,1,honma,2015-03-12 16:36:40-07:00,['87c9bbce70435553b83b66ec1d880300d79a9c24'],2,4,6,13185135,1,,,,8526
017f320b0a0ac1b33f4bb457346c9e9543caf2bd,1,shaofengshi,2015-03-13 10:57:11+08:00,['013fd3160605c0b387e4e1c8e66b9eef07dcd2f4'],6,8,14,13185149,5,,,,8526
179349f25ffa3c47db1f9247c215a15fb9f6966c,0,shaofengshi,2015-03-13 10:57:30+08:00,['017f320b0a0ac1b33f4bb457346c9e9543caf2bd'],4,19,23,13185172,1,,,,8526
8062d880d4fc5ad6a536a70394330343966648eb,0,shaofengshi,2015-03-13 10:58:33+08:00,['179349f25ffa3c47db1f9247c215a15fb9f6966c'],1,1,2,13185174,1,,,,8526
ef81fb256f48f24c0f64232bc607c93d910c865c,0,qianhao.zhou,2015-03-13 13:02:53+08:00,['ccd498eb3e5121af7b1a0c3929984e2780b87e1f'],8,5,13,13185187,1,1,1,0,8526
3514f00d4ae8ca0e282f0cd2c178edb05c54cb7f,0,qianhao.zhou,2015-03-13 13:04:16+08:00,"['ef81fb256f48f24c0f64232bc607c93d910c865c', 'ab95645c5c3545cfd450a1f72105d44aff4f588a']",3,9,12,13185199,3,,,,8526
80dc7427fb723d7f6e9b763bded9e14d25135cbe,0,qianhao.zhou,2015-03-13 13:47:43+08:00,['3514f00d4ae8ca0e282f0cd2c178edb05c54cb7f'],17,95,112,13185311,3,0,0.949152542,1,8526
5432f0449dee5ae9b339d5a6fa0bda03a452ead1,0,qianhao.zhou,2015-03-13 13:51:45+08:00,['80dc7427fb723d7f6e9b763bded9e14d25135cbe'],12,8,20,13185331,3,1,1,0,8526
cdd1bfd4628c16aa95e26a6cbb7433f6eda69a8e,0,qianhao.zhou,2015-03-13 14:58:15+08:00,['5432f0449dee5ae9b339d5a6fa0bda03a452ead1'],5,2,7,13185338,1,,,,8526
8a075c272de08a551b9b62a80c65fad132f7e005,0,qianhao.zhou,2015-03-13 15:59:22+08:00,['cdd1bfd4628c16aa95e26a6cbb7433f6eda69a8e'],2,2,4,13185342,2,,,,8526
a8457e155e8af0c16c23f8a7cfa126cd2a2659f4,1,shaofengshi,2015-03-13 16:18:05+08:00,['8062d880d4fc5ad6a536a70394330343966648eb'],2,12,14,13185356,3,0,0,1,8526
fa5e99eceb22b2d3589f9413d9e65963993d6cf2,0,qianhao.zhou,2015-03-13 16:51:33+08:00,['8a075c272de08a551b9b62a80c65fad132f7e005'],58,77,135,13185491,4,0.6,1,0,8526
dcae86abd6e715db6958965f71275524f99c5d53,0,qianhao.zhou,2015-03-13 17:13:58+08:00,['fa5e99eceb22b2d3589f9413d9e65963993d6cf2'],6,28,34,13185525,2,0.1875,0.1875,1,8526
1f59164110fc5e8c55640edc55e304e257f23090,0,qianhao.zhou,2015-03-13 17:39:07+08:00,['dcae86abd6e715db6958965f71275524f99c5d53'],0,2,2,13185527,1,,,,8526
8dc6fa9ed07f88d3d89271d9e55246ef39159762,0,qianhao.zhou,2015-03-13 18:18:10+08:00,['1f59164110fc5e8c55640edc55e304e257f23090'],0,1,1,13185528,1,1,1,1,8526
692715d6ebfb129e9a8712b5160ff6c5672d4fb3,1,Li Yang,2015-03-13 18:41:55+08:00,['8dc6fa9ed07f88d3d89271d9e55246ef39159762'],215,1142,1357,13186885,43,0.595238095,0.838435374,0.880952381,8534
810c3262923e70727dbf9aece152ce8b97eabdb9,0,qianhao.zhou,2015-03-13 21:43:10+08:00,['8dc6fa9ed07f88d3d89271d9e55246ef39159762'],10,16,26,13186911,3,0,0.666666667,1,8534
4cfaf7c8174eade067d17369d7bc37c78c389856,0,qianhao.zhou,2015-03-13 21:45:55+08:00,"['810c3262923e70727dbf9aece152ce8b97eabdb9', '692715d6ebfb129e9a8712b5160ff6c5672d4fb3']",215,1142,1357,13188268,43,,,,8534
7e63ab0a8c7bd5f146159b4bf620cc8d3043a1b6,1,shaofengshi,2015-03-13 22:56:37+08:00,['a8457e155e8af0c16c23f8a7cfa126cd2a2659f4'],2,2,4,13188272,1,,,,8534
38761801486e92f9667ab86b899a477c9121f523,1,shaofengshi,2015-03-13 23:08:57+08:00,['7e63ab0a8c7bd5f146159b4bf620cc8d3043a1b6'],3,17,20,13188292,4,0.7,0.7,1,8534
72a747545119ec55e77f1b74340960dc6d848cfe,1,shaofengshi,2015-03-14 11:31:33+08:00,['38761801486e92f9667ab86b899a477c9121f523'],2,5,7,13188299,2,,,,8534
efc1f5310d34cb8727124eeabf544ed5d6a6454b,1,qianhao.zhou,2015-03-16 10:50:55+08:00,"['4cfaf7c8174eade067d17369d7bc37c78c389856', '72a747545119ec55e77f1b74340960dc6d848cfe']",16,11944,11960,13200259,24,,,,8534
7c852178455b554c5042182bc610b3f7c7c6e231,1,qianhao.zhou,2015-03-16 11:55:37+08:00,['efc1f5310d34cb8727124eeabf544ed5d6a6454b'],38,11,49,13200308,2,1,1,0,8534
0d4436616134c27c5d4c8e604a64c35b5f3bda6e,1,Li Yang,2015-03-16 12:32:46+08:00,['efc1f5310d34cb8727124eeabf544ed5d6a6454b'],1,5,6,13200314,1,1,0,0,8534
db8662cb8bba7019b29df0da56ba129bf11cf155,0,Li Yang,2015-03-16 12:33:04+08:00,"['0d4436616134c27c5d4c8e604a64c35b5f3bda6e', '7c852178455b554c5042182bc610b3f7c7c6e231']",38,11,49,13200363,2,,,,8534
05f5fb3f639a27f0f5d5764aaf50061052411593,1,Li Yang,2015-03-16 12:40:22+08:00,['db8662cb8bba7019b29df0da56ba129bf11cf155'],9,30,39,13200402,3,1,1,1,8534
f79f772e71fa6c7050f3e465049e162a42a0d1cc,0,Li Yang,2015-03-16 13:41:58+08:00,['72a747545119ec55e77f1b74340960dc6d848cfe'],7,38,45,13200447,2,0.05,1,1,8534
481ccc084e22a6c49395635f1e933371107281bb,0,qianhao.zhou,2015-03-16 14:17:17+08:00,['05f5fb3f639a27f0f5d5764aaf50061052411593'],2,2,4,13200451,1,,,,8534
f888fc3749e5dec096ea532991711104c7ad7849,1,qianhao.zhou,2015-03-16 14:20:28+08:00,['481ccc084e22a6c49395635f1e933371107281bb'],1,6,7,13200458,2,1,1,1,8534
69d0f45559fab825628f46ec2dc0d1d52e33bc8b,1,shaofengshi,2015-03-16 14:41:58+08:00,['efc1f5310d34cb8727124eeabf544ed5d6a6454b'],223,221,444,13200902,15,,,,8534
155f15a47211e096845ed5ca05158e0f2eb893b2,0,shaofengshi,2015-03-16 14:45:19+08:00,"['69d0f45559fab825628f46ec2dc0d1d52e33bc8b', 'f888fc3749e5dec096ea532991711104c7ad7849']",50,53,103,13201005,6,,,,8534
ca474cfb005e6f456b1df15d265d70256667b4db,0,qianhao.zhou,2015-03-16 15:14:43+08:00,['f888fc3749e5dec096ea532991711104c7ad7849'],1,1,2,13201007,1,,,,8534
187e78c3a5470214a6c88dee2d0c8b706e0d4b03,0,qianhao.zhou,2015-03-16 15:16:57+08:00,"['ca474cfb005e6f456b1df15d265d70256667b4db', '155f15a47211e096845ed5ca05158e0f2eb893b2']",223,221,444,13201451,15,,,,8534
2212e214769a441077bc61b7b2f5744537edee0b,1,qianhao.zhou,2015-03-16 15:48:28+08:00,['187e78c3a5470214a6c88dee2d0c8b706e0d4b03'],1,7,8,13201459,2,1,1,1,8534
58c2e1201880d7de52cc14544bb0f0244b603a3e,0,qianhao.zhou,2015-03-16 15:59:45+08:00,['2212e214769a441077bc61b7b2f5744537edee0b'],6,2,8,13201467,1,,,,8534
c9b070de4339121285ced9791e0a1ca332a2ab39,0,qianhao.zhou,2015-03-16 16:26:13+08:00,['58c2e1201880d7de52cc14544bb0f0244b603a3e'],2,0,2,13201469,1,0,0,0,8534
982808fdc22558f0c5705c69d8f62c087cb7e133,0,qianhao.zhou,2015-03-16 19:23:31+08:00,['c9b070de4339121285ced9791e0a1ca332a2ab39'],9,16,25,13201494,3,0.5,0.5,1,8534
5acef2e0c13b0e10fb6b3ebbf45d48aa3190377c,0,qianhao.zhou,2015-03-16 20:22:12+08:00,['982808fdc22558f0c5705c69d8f62c087cb7e133'],1,6,7,13201501,2,0.75,1,0.75,8534
098a7e6881366abad6c984b945c37c96647088dc,0,honma,2015-03-16 11:27:54-07:00,['f79f772e71fa6c7050f3e465049e162a42a0d1cc'],1,3,4,13201505,1,1,0,1,8534
fae4c1273a59323291c3380464583e37225cef52,0,lukehan,2015-03-16 12:30:14-07:00,"['963ce522a05848703baa11a610f8318a5243bda0', '098a7e6881366abad6c984b945c37c96647088dc']",24,11985,12009,13213514,27,,,,8534
010ee6774922451d49edc1fb2f5f1e21faff7ce3,0,lukehan,2015-03-16 12:32:06-07:00,['098a7e6881366abad6c984b945c37c96647088dc'],2,3,5,13213519,1,,,,8534
c6edef7b4d8f5c116323c4cc5ee65292bb299179,0,lukehan,2015-03-16 12:32:25-07:00,"['fae4c1273a59323291c3380464583e37225cef52', '010ee6774922451d49edc1fb2f5f1e21faff7ce3']",2,3,5,13213524,1,,,,8534
08f7966963bf7adb9fb6a8bbde985103523a561c,0,lukehan,2015-03-16 13:37:33-07:00,['010ee6774922451d49edc1fb2f5f1e21faff7ce3'],4,4,8,13213532,2,,,,8534
8bcebb9ccd538e9aba430386a702e0c70e79a07b,0,lukehan,2015-03-16 13:49:00-07:00,['08f7966963bf7adb9fb6a8bbde985103523a561c'],0,11,11,13213543,2,,,,8534
cd185bc44ea4c2ffe01ef2c98cb320a7e59cfb96,1,honma,2015-03-16 15:49:36-07:00,['5acef2e0c13b0e10fb6b3ebbf45d48aa3190377c'],10,299,309,13213852,7,0.5875,1,0.925,8538
149ba57598ef7a49cebca992b83d86e894219b06,0,honma,2015-03-16 16:38:18-07:00,['cd185bc44ea4c2ffe01ef2c98cb320a7e59cfb96'],24,38,62,13213914,4,1,1,1,8539
d9a7283b4175e76c75e27a79cf05217c3c12ebf2,1,shaofengshi,2015-03-17 11:15:04+08:00,['098a7e6881366abad6c984b945c37c96647088dc'],81,81,162,13214076,3,0.727272727,0.727272727,0,8539
545e482583edd51bae912c765ad08848e2d31541,1,shaofengshi,2015-03-17 13:54:06+08:00,['d9a7283b4175e76c75e27a79cf05217c3c12ebf2'],18,17,35,13214111,2,0,0,1,8539
89c464d1cfc7078263ceceda50e19d1495f914de,1,shaofengshi,2015-03-17 14:57:16+08:00,['545e482583edd51bae912c765ad08848e2d31541'],67,33,100,13214211,4,0,0.055555556,0,8539
88d9d93df14b810c91b9b6c0ccd48b6f4dbb5601,0,Li Yang,2015-03-17 15:54:48+08:00,['05f5fb3f639a27f0f5d5764aaf50061052411593'],0,384,384,13214595,2,,,,8541
bec1203d1d43680fb5ad41745f446edab3cb71d7,1,Li Yang,2015-03-17 15:55:32+08:00,['88d9d93df14b810c91b9b6c0ccd48b6f4dbb5601'],188,516,704,13215299,15,0.821862348,1,0.943319838,8542
1c92684ababe03b87d237687b703d34f6ff421a3,0,Li Yang,2015-03-17 08:55:52+01:00,"['bec1203d1d43680fb5ad41745f446edab3cb71d7', '149ba57598ef7a49cebca992b83d86e894219b06']",257,575,832,13216131,33,,,,8542
28f8ccfa5016ddb17c5caa0399388f2245d9c1d4,0,Li Yang,2015-03-17 16:09:01+08:00,['1c92684ababe03b87d237687b703d34f6ff421a3'],16,36,52,13216183,2,0,0,1,8542
67f24182b04b9a407aa59cb9a6758397ebb72f1d,0,qianhao.zhou,2015-03-17 16:20:52+08:00,['149ba57598ef7a49cebca992b83d86e894219b06'],65,147,212,13216395,9,0.266666667,1,0,8543
6fbfa5707cd46829af721865d6ecfc399b263343,0,qianhao.zhou,2015-03-17 16:21:01+08:00,"['67f24182b04b9a407aa59cb9a6758397ebb72f1d', '28f8ccfa5016ddb17c5caa0399388f2245d9c1d4']",188,920,1108,13217503,17,,,,8543
d4727300838e710d816d8d08e50c922eb42052ff,0,qianhao.zhou,2015-03-17 16:29:57+08:00,['6fbfa5707cd46829af721865d6ecfc399b263343'],19,27,46,13217549,1,1,1,0,8543
fc3b08991878549149bcc6a99b659e361149a6dc,0,shaofengshi,2015-03-17 16:47:16+08:00,['89c464d1cfc7078263ceceda50e19d1495f914de'],3,8,11,13217560,3,0,1,1,8543
7f2f61940f47c5d6cdb53e10a11f25cca4d348af,0,qianhao.zhou,2015-03-17 17:27:06+08:00,"['d4727300838e710d816d8d08e50c922eb42052ff', 'fc3b08991878549149bcc6a99b659e361149a6dc']",201,183,384,13217944,15,,,,8543
a131f388f9f5ebdfb3b0ca8e9ee2e1a74e792d26,1,Li Yang,2015-03-17 17:35:58+08:00,['28f8ccfa5016ddb17c5caa0399388f2245d9c1d4'],99,125,224,13218168,7,1,1,1,8543
4837d15d47101b500e9801a0ff3d3f6e4eaad8bd,0,Li Yang,2015-03-17 17:36:19+08:00,"['a131f388f9f5ebdfb3b0ca8e9ee2e1a74e792d26', '7f2f61940f47c5d6cdb53e10a11f25cca4d348af']",285,357,642,13218810,24,,,,8543
3999c2e39f905e803242814d706db64665427cc3,1,Li Yang,2015-03-17 17:50:33+08:00,['4837d15d47101b500e9801a0ff3d3f6e4eaad8bd'],16,19,35,13218845,3,1,1,1,8543
396a024b9b9f7153f613d64344fd346a5803220c,0,qianhao.zhou,2015-03-17 17:54:07+08:00,['7f2f61940f47c5d6cdb53e10a11f25cca4d348af'],5,9,14,13218859,2,,,,8543
9ac03369581d2615c894f1bffbf20b81ef0c4861,0,qianhao.zhou,2015-03-17 17:54:21+08:00,"['396a024b9b9f7153f613d64344fd346a5803220c', '3999c2e39f905e803242814d706db64665427cc3']",113,142,255,13219114,9,,,,8543
25fbdb4629dbfefa27ad62a8ee20b396368e1558,0,qianhao.zhou,2015-03-17 18:11:16+08:00,['9ac03369581d2615c894f1bffbf20b81ef0c4861'],10,9,19,13219133,1,,,,8543
c2758c4063ed318cb5aa888e78ec15e866dd636f,0,qianhao.zhou,2015-03-17 18:44:37+08:00,['25fbdb4629dbfefa27ad62a8ee20b396368e1558'],5,4,9,13219142,1,0,1,1,8543
004bb8c61c845bb2c800c6eaff3d3ce14c5f5fc7,0,shaofengshi,2015-03-18 11:34:06+08:00,['fc3b08991878549149bcc6a99b659e361149a6dc'],6,13,19,13219161,5,1,1,1,8543
87ec8cbfa70a6dfa8683530954344c5bbc53c8fd,0,shaofengshi,2015-03-18 11:34:06+08:00,['fc3b08991878549149bcc6a99b659e361149a6dc'],6,13,19,13219180,5,1,1,1,8543
8a7c5c36d73e696d71af6cb233a975d08e765e66,0,qianhao.zhou,2015-03-18 14:30:08+08:00,['c2758c4063ed318cb5aa888e78ec15e866dd636f'],131,22,153,13219333,4,0.445945946,0.716216216,0,8543
98d622769e1b07f32d0c0cfe2d7a2cc82badc0d6,0,qianhao.zhou,2015-03-18 15:49:45+08:00,['8a7c5c36d73e696d71af6cb233a975d08e765e66'],1,10,11,13219344,1,0,0,1,8543
e17678f9eb58a267a59cc163ef5e445fc021f040,0,qianhao.zhou,2015-03-18 16:00:10+08:00,['98d622769e1b07f32d0c0cfe2d7a2cc82badc0d6'],11,13,24,13219368,1,,,,8543
130a429421541dca20e3050cda502c1a82063903,0,qianhao.zhou,2015-03-18 16:08:34+08:00,['e17678f9eb58a267a59cc163ef5e445fc021f040'],27,31,58,13219426,2,,,,8543
b17a70aeb5405da8e6c73d0d814df25c962828cc,0,qianhao.zhou,2015-03-18 17:42:54+08:00,['130a429421541dca20e3050cda502c1a82063903'],3,17,20,13219446,2,0,0.5,0.5,8543
7423e49a1fd0de9612bdfc8c7b9cd64b6f237a98,0,Li Yang,2015-03-18 18:22:45+08:00,['3999c2e39f905e803242814d706db64665427cc3'],37,581,618,13220064,11,0.611731844,0.843575419,0.907821229,8547
e97b64f542c7853de941ffbadacfdaed75ce56d9,0,Li Yang,2015-03-18 18:23:06+08:00,"['7423e49a1fd0de9612bdfc8c7b9cd64b6f237a98', 'b17a70aeb5405da8e6c73d0d814df25c962828cc']",179,101,280,13220344,10,,,,8547
0335440b9cb800752a136e0d187c4c15d338d85c,0,qianhao.zhou,2015-03-18 18:54:00+08:00,['b17a70aeb5405da8e6c73d0d814df25c962828cc'],9,6,15,13220359,2,0.333333333,0.333333333,0,8547
da090b03aea815c5a1c543ff0c1f2f735ce2a72d,0,IT-DONG,2015-03-18 18:54:35+08:00,['004bb8c61c845bb2c800c6eaff3d3ce14c5f5fc7'],2,2,4,13220363,1,,,,8547
80f593f3bf8160e661e5d7cc442b774aed3be463,0,IT-DONG,2015-03-18 18:54:35+08:00,['87ec8cbfa70a6dfa8683530954344c5bbc53c8fd'],2,2,4,13220367,1,,,,8547
cd090ec85aa144886d09aeb917e40f8f8075d75e,0,qianhao.zhou,2015-03-18 18:54:37+08:00,"['0335440b9cb800752a136e0d187c4c15d338d85c', 'e97b64f542c7853de941ffbadacfdaed75ce56d9']",37,581,618,13220985,11,,,,8547
7df169cd54c9c924bca3ca34c0cd19c3b2989ffa,0,qianhao.zhou,2015-03-18 19:42:34+08:00,['cd090ec85aa144886d09aeb917e40f8f8075d75e'],3,3,6,13220991,3,,,,8547
848d23beaa272b394bcd5e101bb059f650d17f51,0,qianhao.zhou,2015-03-18 20:18:56+08:00,['7df169cd54c9c924bca3ca34c0cd19c3b2989ffa'],11,16,27,13221018,2,0,1,1,8547
5aeecaf521b9826db0c458354760483482147a0c,0,Li Yang,2015-03-19 16:48:38+08:00,['848d23beaa272b394bcd5e101bb059f650d17f51'],14,25,39,13221057,5,1,1,0.857142857,8547
6ab1b35444d1ea35a6728b47e3ce9604f6a09377,0,Zhong Jian,2015-03-19 17:43:53+08:00,['004bb8c61c845bb2c800c6eaff3d3ce14c5f5fc7'],1,1,2,13221059,1,,,,8547
d3bcb73f16c4a71c095cbc3c0df8ea1e92710fcb,0,Zhong Jian,2015-03-19 17:43:53+08:00,['87ec8cbfa70a6dfa8683530954344c5bbc53c8fd'],1,1,2,13221061,1,,,,8547
42ce02b30c3cf65535f3663a7393234cf2d7484a,0,Zhong Jian,2015-03-19 17:45:05+08:00,['ab95645c5c3545cfd450a1f72105d44aff4f588a'],1,1,2,13221063,1,,,,8547
ce19f659d6e8ba38823d9689dba3e8d29cbf8a04,1,shaofengshi,2015-03-19 18:13:45+08:00,['848d23beaa272b394bcd5e101bb059f650d17f51'],2,519,521,13221584,3,0.361867704,0.898832685,0.778210117,8549
b37cb056c394c46f5fea096ca2f50426006cdcd6,0,shaofengshi,2015-03-19 18:14:00+08:00,"['ce19f659d6e8ba38823d9689dba3e8d29cbf8a04', '5aeecaf521b9826db0c458354760483482147a0c']",14,25,39,13221623,5,,,,8549
c642fc4682bb5c1248deed73c7bd3f5c5b6cc220,1,Li Yang,2015-03-19 22:30:19+08:00,['6ab1b35444d1ea35a6728b47e3ce9604f6a09377'],5,14,19,13221642,2,0,0,0,8550
a836c9df9aec80c8c3c4fd2bb14274f4287485e2,1,Li Yang,2015-03-19 22:30:19+08:00,['d3bcb73f16c4a71c095cbc3c0df8ea1e92710fcb'],5,14,19,13221661,2,0,0,0,8551
8edd608ec15da33981a3a4f83c78f0250cd6b716,0,Li Yang,2015-03-19 15:31:19+01:00,"['c642fc4682bb5c1248deed73c7bd3f5c5b6cc220', 'c6edef7b4d8f5c116323c4cc5ee65292bb299179']",4,6,10,13221671,2,,,,8551
dec0cdcebebfd53b7468e4204d7c358540560824,0,Li Yang,2015-03-19 15:31:19+01:00,"['a836c9df9aec80c8c3c4fd2bb14274f4287485e2', 'c6edef7b4d8f5c116323c4cc5ee65292bb299179']",4,6,10,13221681,2,,,,8551
4081d093d34d42a588d8c8da6cd04858e1ce51ae,0,honma,2015-03-19 18:56:21-07:00,['c642fc4682bb5c1248deed73c7bd3f5c5b6cc220'],8,44,52,13221733,2,,,,8552
1a259fe1e4ad2c65333fa86170eaa6d74f087bc6,1,honma,2015-03-19 18:56:21-07:00,['a836c9df9aec80c8c3c4fd2bb14274f4287485e2'],8,44,52,13221785,2,,,,8553
16a2719f2de9de29640cdb1ebc71da2fdf7ee3c6,0,honma,2015-03-19 18:56:21-07:00,['4081d093d34d42a588d8c8da6cd04858e1ce51ae'],254,232,486,13222271,28,,,,8562
bad2dc8626f182faa1fa1300ce69f0b8b1335599,0,honma,2015-03-19 18:56:21-07:00,['1a259fe1e4ad2c65333fa86170eaa6d74f087bc6'],254,232,486,13222757,28,,,,8571
d8c8bb9e209450936d4f033de0aa2a02ffa9154d,0,honma,2015-03-19 19:04:45-07:00,['16a2719f2de9de29640cdb1ebc71da2fdf7ee3c6'],3,11,14,13222771,3,,,,8571
7ba69f29a1b417e6457e1403eb318f0a856ff7b8,0,honma,2015-03-19 19:04:45-07:00,['bad2dc8626f182faa1fa1300ce69f0b8b1335599'],3,11,14,13222785,3,,,,8571
c4b044450c23bffb46659fac73d0ec59140e7571,0,honma,2015-03-19 19:10:03-07:00,['d8c8bb9e209450936d4f033de0aa2a02ffa9154d'],5,14,19,13222804,3,,,,8571
af030c3088ca5ea1c0283e788a26623dcdccbf53,0,honma,2015-03-19 19:10:03-07:00,['7ba69f29a1b417e6457e1403eb318f0a856ff7b8'],5,14,19,13222823,3,,,,8571
187eb25fdcc8a2e667cfd90ae5c95aa9d69c1238,0,qianhao.zhou,2015-03-20 10:16:07+08:00,"['b37cb056c394c46f5fea096ca2f50426006cdcd6', '42ce02b30c3cf65535f3663a7393234cf2d7484a']",1,1,2,13222825,1,,,,8571
aa711723dd87af005e6cfce3e2ab793c0e253ff5,0,honma,2015-03-19 19:16:12-07:00,['c4b044450c23bffb46659fac73d0ec59140e7571'],1,3,4,13222829,1,,,,8571
4b897f3e913ea7efceec810330075cb6183c2ef9,0,honma,2015-03-19 19:16:12-07:00,['af030c3088ca5ea1c0283e788a26623dcdccbf53'],1,3,4,13222833,1,,,,8571
58e49b3f919763d6290be022b5235c7ac883cccb,0,honma,2015-03-19 19:20:55-07:00,['aa711723dd87af005e6cfce3e2ab793c0e253ff5'],1,1,2,13222835,1,,,,8571
e611f56dc28963d0cbecff9a075e763993be4b1f,0,honma,2015-03-19 19:20:55-07:00,['4b897f3e913ea7efceec810330075cb6183c2ef9'],1,1,2,13222837,1,,,,8571
6886d761d61b70b6213235b3db0b94ad1af5f4aa,0,qianhao.zhou,2015-03-20 10:21:03+08:00,"['187eb25fdcc8a2e667cfd90ae5c95aa9d69c1238', '4b897f3e913ea7efceec810330075cb6183c2ef9']",194,326,520,13223357,38,,,,8571
51c57222721d6cc79b0cfb3a8867261f977b2363,0,honma,2015-03-19 19:30:17-07:00,['58e49b3f919763d6290be022b5235c7ac883cccb'],3,6,9,13223366,1,,,,8571
e1bc75dac258f059504f228f898c394721bee6a6,0,honma,2015-03-19 19:30:17-07:00,['e611f56dc28963d0cbecff9a075e763993be4b1f'],3,6,9,13223375,1,,,,8571
0b91cc586b9a24a83ee0b2ba9b67a26fae8f2ae6,0,honma,2015-03-19 22:27:23-07:00,['51c57222721d6cc79b0cfb3a8867261f977b2363'],30,90,120,13223495,4,,,,8573
6fa187355d018d3fafe58a3c88ab1056ee320aa5,0,honma,2015-03-19 22:27:23-07:00,['e1bc75dac258f059504f228f898c394721bee6a6'],30,90,120,13223615,4,,,,8575
8a4a91fb1c5ea63021c16ed1617d3630e43ccdb4,0,honma,2015-03-19 23:07:09-07:00,['0b91cc586b9a24a83ee0b2ba9b67a26fae8f2ae6'],1,91,92,13223707,4,,,,8578
7281da56638744242167046ede5642a10c2c8d1d,0,honma,2015-03-19 23:07:09-07:00,['6fa187355d018d3fafe58a3c88ab1056ee320aa5'],1,91,92,13223799,4,,,,8581
61ef9bcd1ce0b14fe83c4c39b8685a0c57e626c9,0,honma,2015-03-19 23:23:11-07:00,['8a4a91fb1c5ea63021c16ed1617d3630e43ccdb4'],0,2244,2244,13226043,7,,,,8587
149174507b0722ac8dbf864b3a8e477b92d91e8e,0,honma,2015-03-19 23:23:11-07:00,['7281da56638744242167046ede5642a10c2c8d1d'],0,2244,2244,13228287,7,,,,8593
912590cfbef063025a895c232e1e9beeb92abf45,0,honma,2015-03-19 23:27:00-07:00,['61ef9bcd1ce0b14fe83c4c39b8685a0c57e626c9'],95,3,98,13228385,3,,,,8593
6897deb4e7ffe574a3f882c4a1ee357c41ba4d4a,0,honma,2015-03-19 23:27:00-07:00,['149174507b0722ac8dbf864b3a8e477b92d91e8e'],95,3,98,13228483,3,,,,8593
f6904cfe17afe9519fb6118a6176573eb2e0b41e,0,honma,2015-03-19 23:36:55-07:00,['912590cfbef063025a895c232e1e9beeb92abf45'],2,13,15,13228498,2,,,,8594
d22675b24cab44d95c15f406d1d2579c63c551d6,0,honma,2015-03-19 23:36:55-07:00,['6897deb4e7ffe574a3f882c4a1ee357c41ba4d4a'],2,13,15,13228513,2,,,,8595
b1c9d7bc3ca65e5f28def6653871d3d71a84bac1,0,honma,2015-03-19 23:38:56-07:00,['f6904cfe17afe9519fb6118a6176573eb2e0b41e'],1,2,3,13228516,1,,,,8595
f3f127e4f8de1bdbd7e820550c76d86a3e3717c8,0,honma,2015-03-19 23:38:56-07:00,['d22675b24cab44d95c15f406d1d2579c63c551d6'],1,2,3,13228519,1,,,,8595
1dd56a4d4d73b5ad6c9582ed9ffc8534163f54bc,0,honma,2015-03-19 23:53:26-07:00,['b1c9d7bc3ca65e5f28def6653871d3d71a84bac1'],1,1,2,13228521,1,,,,8595
fc21d357317bfb6bec212c75d336e633b387a579,0,honma,2015-03-19 23:53:26-07:00,['f3f127e4f8de1bdbd7e820550c76d86a3e3717c8'],1,1,2,13228523,1,,,,8595
3f062c16fce74ff6c022e3a41f06aedd954ba97a,0,honma,2015-03-19 23:55:15-07:00,['1dd56a4d4d73b5ad6c9582ed9ffc8534163f54bc'],2,2,4,13228527,2,,,,8595
d22baa553e33f58c9c6041bcb3e8e1f4b898665e,0,honma,2015-03-19 23:55:15-07:00,['fc21d357317bfb6bec212c75d336e633b387a579'],2,2,4,13228531,2,,,,8595
4a075e6a1baf7645c29173114391bb08a2e19c72,1,qianhao.zhou,2015-03-20 15:21:23+08:00,['6886d761d61b70b6213235b3db0b94ad1af5f4aa'],1,25,26,13228557,3,1,1,1,8595
884470472f7713e645db804bffd1d2db4b187868,0,qianhao.zhou,2015-03-20 15:21:49+08:00,['4a075e6a1baf7645c29173114391bb08a2e19c72'],1,3,4,13228561,1,0,0,1,8595
df951e7ef3060cfbf4d3501e9ce7558efb1bc203,0,Li Yang,2015-03-20 15:26:52+08:00,['6886d761d61b70b6213235b3db0b94ad1af5f4aa'],0,1,1,13228562,1,,,,8595
4b984e8d215589971b5fa5a11af44f9e5d0ec551,0,Li Yang,2015-03-20 15:31:37+08:00,['3f062c16fce74ff6c022e3a41f06aedd954ba97a'],1,1,2,13228564,1,,,,8595
5fad2d8a3da13ee90a164ea2bfa8db3156899e11,0,Li Yang,2015-03-20 15:31:37+08:00,['d22baa553e33f58c9c6041bcb3e8e1f4b898665e'],1,1,2,13228566,1,,,,8595
b6d697ff26cd99d8dfc84b77540ff7a969ac211a,0,Li Yang,2015-03-20 15:44:28+08:00,['3f062c16fce74ff6c022e3a41f06aedd954ba97a'],1,1,2,13228568,1,,,,8595
de2f3ae05823a1d3797cd45b4b8f024f3a4f8415,0,Li Yang,2015-03-20 15:44:28+08:00,['d22baa553e33f58c9c6041bcb3e8e1f4b898665e'],1,1,2,13228570,1,,,,8595
b75f7b98e671ac1f8e6b0b0b66f9ce7e575b358e,0,Li Yang,2015-03-20 15:45:37+08:00,"['b6d697ff26cd99d8dfc84b77540ff7a969ac211a', '4b984e8d215589971b5fa5a11af44f9e5d0ec551']",0,0,0,13228570,0,,,,8595
301cc74d9daeb7571800a63faf1701cccb9b412a,0,Li Yang,2015-03-20 15:45:37+08:00,"['de2f3ae05823a1d3797cd45b4b8f024f3a4f8415', '5fad2d8a3da13ee90a164ea2bfa8db3156899e11']",0,0,0,13228570,0,,,,8595
e0d835cdd0fff040a9c434e8376c48e89289ca52,0,Li Yang,2015-03-20 09:05:29+01:00,"['df951e7ef3060cfbf4d3501e9ce7558efb1bc203', '884470472f7713e645db804bffd1d2db4b187868']",2,28,30,13228600,4,,,,8595
c2085f0a513f3b4e248263b26cc6962473eaec4e,0,qianhao.zhou,2015-03-20 16:55:48+08:00,['884470472f7713e645db804bffd1d2db4b187868'],21,140,161,13228761,4,0.363636364,0,0.945454545,8596
72f448b259b3586e22512909d45cc3df5053bcc5,0,qianhao.zhou,2015-03-20 16:55:57+08:00,"['c2085f0a513f3b4e248263b26cc6962473eaec4e', 'e0d835cdd0fff040a9c434e8376c48e89289ca52']",0,1,1,13228762,1,,,,8596
28328b98d8f159919642023ea55d95c310707edb,0,shaofengshi,2015-03-20 18:13:50+08:00,['b37cb056c394c46f5fea096ca2f50426006cdcd6'],37,64,101,13228863,4,0.19047619,0,0.380952381,8596
a3a1dc82ff3a8073ec3877703112021455b84259,0,shaofengshi,2015-03-20 18:14:03+08:00,"['28328b98d8f159919642023ea55d95c310707edb', '72f448b259b3586e22512909d45cc3df5053bcc5']",218,496,714,13229577,48,,,,8596
bc57502f44e6f6c4c7a5e5ad139456b849a2da03,0,qianhao.zhou,2015-03-20 18:47:48+08:00,['72f448b259b3586e22512909d45cc3df5053bcc5'],1,2,3,13229580,1,0,1,0,8596
adbcb542987eeb31c6aaf097a8f51236f40c8f08,0,qianhao.zhou,2015-03-20 18:48:03+08:00,"['bc57502f44e6f6c4c7a5e5ad139456b849a2da03', 'a3a1dc82ff3a8073ec3877703112021455b84259']",37,64,101,13229681,4,,,,8596
00934313c6b67b515f1ce59acfcab847441a0996,0,honma,2015-03-20 09:50:26-07:00,"['adbcb542987eeb31c6aaf097a8f51236f40c8f08', '301cc74d9daeb7571800a63faf1701cccb9b412a']",129,2446,2575,13232256,18,,,,8596
4415aba0bb6426e9897c8681960f0a38f77b2506,0,honma,2015-03-21 10:32:12-07:00,['b75f7b98e671ac1f8e6b0b0b66f9ce7e575b358e'],0,3,3,13232259,1,,,,8596
d75f87287f531e3107c2fd218aecb4ef72818a21,0,honma,2015-03-21 10:32:12-07:00,['301cc74d9daeb7571800a63faf1701cccb9b412a'],0,3,3,13232262,1,,,,8596
00cf32c5db6118118a7e4352e4053db5f3484119,0,honma,2015-03-21 10:34:03-07:00,['4415aba0bb6426e9897c8681960f0a38f77b2506'],1,1,2,13232264,1,,,,8596
46899baaa39cdd50df61fec83234e45518bdaecd,0,honma,2015-03-21 10:34:03-07:00,['d75f87287f531e3107c2fd218aecb4ef72818a21'],1,1,2,13232266,1,,,,8596
9571f5fde144e01630b4d517e6b00ae093d175d6,0,shaofengshi,2015-03-23 10:20:36+08:00,['a3a1dc82ff3a8073ec3877703112021455b84259'],7,32,39,13232305,3,0,1,0.055555556,8596
7a05d0da7627adf0249abb90acbeb68800288756,0,shaofengshi,2015-03-23 10:20:53+08:00,"['9571f5fde144e01630b4d517e6b00ae093d175d6', '00934313c6b67b515f1ce59acfcab847441a0996']",130,2448,2578,13234883,19,,,,8596
9059340af10d5354f9830c4b28e4d14b24a74fe1,1,shaofengshi,2015-03-23 10:22:09+08:00,['00cf32c5db6118118a7e4352e4053db5f3484119'],1,1,2,13234885,1,,,,8596
0e857fa1846a747ba11f8f0752081ff33c92f49b,1,shaofengshi,2015-03-23 10:22:09+08:00,['46899baaa39cdd50df61fec83234e45518bdaecd'],1,1,2,13234887,1,,,,8596
63c36671c04f056f28799d83c2538c5643790886,1,shaofengshi,2015-03-23 10:30:47+08:00,['9059340af10d5354f9830c4b28e4d14b24a74fe1'],3,3,6,13234893,3,,,,8596
df903828c7e6fac495dec96871b78b4c7d03e73a,1,shaofengshi,2015-03-23 10:30:47+08:00,['0e857fa1846a747ba11f8f0752081ff33c92f49b'],3,3,6,13234899,3,,,,8596
34852eef1375f252b48efab6ab3de1ef4b576cf2,0,shaofengshi,2015-03-23 10:35:59+08:00,['63c36671c04f056f28799d83c2538c5643790886'],2,2,4,13234903,1,,,,8596
97a99a76b125c2b92dca1aa3cd79114c394be5bd,0,shaofengshi,2015-03-23 10:35:59+08:00,['df903828c7e6fac495dec96871b78b4c7d03e73a'],2,2,4,13234907,1,,,,8596
9b6848315783f9e8eb0781ebd463ae7c231d5859,1,Li Yang,2015-03-23 11:27:05+08:00,['e0d835cdd0fff040a9c434e8376c48e89289ca52'],381,200,581,13235488,8,0.14084507,0.14084507,0.049295775,8596
a9ad7090dc73962cc9fb407c7f7249cfe119d92e,0,Li Yang,2015-03-23 12:03:04+08:00,['34852eef1375f252b48efab6ab3de1ef4b576cf2'],0,4,4,13235492,1,,,,8596
6082e5d383afc8b7f333722dc8682affd1fe6343,0,Li Yang,2015-03-23 12:03:04+08:00,['97a99a76b125c2b92dca1aa3cd79114c394be5bd'],0,4,4,13235496,1,,,,8596
a8eedeaa45345f2dfcaf0cb79dd1c28f8554c252,0,Li Yang,2015-03-23 06:33:03+01:00,"['9b6848315783f9e8eb0781ebd463ae7c231d5859', '7a05d0da7627adf0249abb90acbeb68800288756']",190,2679,2869,13238365,29,,,,8596
1f746f299352b641218bb953092480a7510ca405,0,qianhao.zhou,2015-03-23 13:35:37+08:00,['adbcb542987eeb31c6aaf097a8f51236f40c8f08'],9,6,15,13238380,1,,,,8596
0cadff8a7f3db7b19fb6eca44192ab428115de2b,0,qianhao.zhou,2015-03-23 13:35:45+08:00,"['1f746f299352b641218bb953092480a7510ca405', '7a05d0da7627adf0249abb90acbeb68800288756']",136,2478,2614,13240994,21,,,,8596
b642deccb17617af718b508b7db69ca5e1b5bf22,0,honma,2015-03-23 16:46:45+08:00,['0cadff8a7f3db7b19fb6eca44192ab428115de2b'],8,10,18,13241012,3,,,,8596
5df8ac55a64815c5e9f68cd9c0c002f26dbef8ac,0,shaofengshi,2015-03-23 17:31:39+08:00,['7a05d0da7627adf0249abb90acbeb68800288756'],53,110,163,13241175,2,0.36,0.76,0.88,8597
8d567127cd84e59680671e5e8ff8e4cb6d336b5b,0,shaofengshi,2015-03-23 17:31:58+08:00,"['5df8ac55a64815c5e9f68cd9c0c002f26dbef8ac', 'b642deccb17617af718b508b7db69ca5e1b5bf22']",17,16,33,13241208,4,,,,8597
d5267102de10292fcabf4ae6291dba1ffdd27e23,0,shaofengshi,2015-03-23 17:54:29+08:00,['8d567127cd84e59680671e5e8ff8e4cb6d336b5b'],27,83,110,13241318,3,0,0.25,0.9375,8597
622eb41fb6411a3a2bd4a80a2a232b5c1b41caab,0,qianhao.zhou,2015-03-24 10:54:36+08:00,['0cadff8a7f3db7b19fb6eca44192ab428115de2b'],1,8,9,13241327,2,1,0,1,8597
d3bb75b7929a4e92f13a12c85d39f642e82fb9c1,0,qianhao.zhou,2015-03-24 10:54:50+08:00,"['622eb41fb6411a3a2bd4a80a2a232b5c1b41caab', '8d567127cd84e59680671e5e8ff8e4cb6d336b5b']",61,120,181,13241508,5,,,,8597
ac17f1d96a68be2320205e015be6296bd2c4e4ec,0,qianhao.zhou,2015-03-24 10:54:57+08:00,"['d3bb75b7929a4e92f13a12c85d39f642e82fb9c1', '6082e5d383afc8b7f333722dc8682affd1fe6343']",6,13,19,13241527,7,,,,8597
fef5c570adb90cec9ed767113b9ba91ac5fe7630,0,shaofengshi,2015-03-24 10:56:55+08:00,['d5267102de10292fcabf4ae6291dba1ffdd27e23'],10,3,13,13241540,2,,,,8597
2889853e55b1e1272a4889858f8d1717d642ee03,0,qianhao.zhou,2015-03-24 10:59:23+08:00,"['ac17f1d96a68be2320205e015be6296bd2c4e4ec', 'fef5c570adb90cec9ed767113b9ba91ac5fe7630']",36,85,121,13241661,3,,,,8597
f55ac404a6c2603071c3cd4ceafab2144df551e3,1,shaofengshi,2015-03-24 20:55:27+08:00,['fef5c570adb90cec9ed767113b9ba91ac5fe7630'],24,412,436,13242097,6,0.312138728,0.988439306,0.797687861,8599
77da29c09247c70d87bb5c69af0f64e46264166a,0,shaofengshi,2015-03-24 20:55:36+08:00,"['f55ac404a6c2603071c3cd4ceafab2144df551e3', '2889853e55b1e1272a4889858f8d1717d642ee03']",7,21,28,13242125,9,,,,8599
f367429788d6e78a527092eaaa235370c349a965,0,lukehan,2015-03-24 18:09:16-07:00,"['8bcebb9ccd538e9aba430386a702e0c70e79a07b', 'a9ad7090dc73962cc9fb407c7f7249cfe119d92e']",467,2810,3277,13245402,69,,,,8599
c70d18b1f7d1e90c4e041c7b371a4c8a48151be9,0,lukehan,2015-03-24 18:09:16-07:00,"['8bcebb9ccd538e9aba430386a702e0c70e79a07b', '6082e5d383afc8b7f333722dc8682affd1fe6343']",467,2810,3277,13248679,69,,,,8599
2dcdf6d1d76b9ca0e2187bad7d473c2d280b5409,0,lukehan,2015-03-24 18:14:58-07:00,"['c6edef7b4d8f5c116323c4cc5ee65292bb299179', 'f367429788d6e78a527092eaaa235370c349a965']",471,2825,3296,13251975,71,,,,8599
4ecd106c1fc265cbb379b09b0d5a355a14ea2d54,0,lukehan,2015-03-24 18:14:58-07:00,"['c6edef7b4d8f5c116323c4cc5ee65292bb299179', 'c70d18b1f7d1e90c4e041c7b371a4c8a48151be9']",471,2825,3296,13255271,71,,,,8599
63afc436725717698439552d892ec27d94eee0db,0,lukehan,2015-03-24 18:17:25-07:00,['f367429788d6e78a527092eaaa235370c349a965'],2,2,4,13255275,1,,,,8599
b8383dc1774e233bce2d51b875478fcf0362ae71,0,lukehan,2015-03-24 18:17:25-07:00,['c70d18b1f7d1e90c4e041c7b371a4c8a48151be9'],2,2,4,13255279,1,,,,8599
3569c4bd69fb5e3148b9df1b0bd1ea63d88f9aa6,0,lukehan,2015-03-24 18:19:09-07:00,"['2dcdf6d1d76b9ca0e2187bad7d473c2d280b5409', '8edd608ec15da33981a3a4f83c78f0250cd6b716']",0,0,0,13255279,0,,,,8599
ff4c07922ce122667e4c626e01682c5c5dcd23ca,0,lukehan,2015-03-24 18:19:09-07:00,"['4ecd106c1fc265cbb379b09b0d5a355a14ea2d54', 'dec0cdcebebfd53b7468e4204d7c358540560824']",0,0,0,13255279,0,,,,8599
9c936ae1c54b9e13e1342746b82a3c6423ca4e8a,0,lukehan,2015-03-24 18:19:17-07:00,"['3569c4bd69fb5e3148b9df1b0bd1ea63d88f9aa6', '63afc436725717698439552d892ec27d94eee0db']",2,2,4,13255283,1,,,,8599
618feec2804453335727a4b0597df8bf3d6d6128,0,lukehan,2015-03-24 18:19:17-07:00,"['ff4c07922ce122667e4c626e01682c5c5dcd23ca', 'b8383dc1774e233bce2d51b875478fcf0362ae71']",2,2,4,13255287,1,,,,8599
e54e9f04b160ea897b19274e1eeb691eda2bf0fe,1,Li Yang,2015-03-25 11:16:05+08:00,['a8eedeaa45345f2dfcaf0cb79dd1c28f8554c252'],51,190,241,13255528,9,0.621052632,0.631578947,1,8600
9a5b8bc7bb0521ced7537de08fff1019ebfe3419,0,Li Yang,2015-03-25 04:16:33+01:00,"['e54e9f04b160ea897b19274e1eeb691eda2bf0fe', '77da29c09247c70d87bb5c69af0f64e46264166a']",120,627,747,13256275,20,,,,8600
6add5483a1c18ec570a998904c2f7aec195079e8,0,qianhao.zhou,2015-03-25 11:34:21+08:00,['2889853e55b1e1272a4889858f8d1717d642ee03'],40,226,266,13256541,3,1,1,1,8602
e9324808772b390de64484249b653f79cc2d69af,0,qianhao.zhou,2015-03-25 11:34:37+08:00,"['6add5483a1c18ec570a998904c2f7aec195079e8', '9a5b8bc7bb0521ced7537de08fff1019ebfe3419']",456,802,1258,13257799,23,,,,8602
72115cc79e687dde02e22309bf5bafa4d9f6a710,0,shaofengshi,2015-03-25 15:44:15+08:00,['e9324808772b390de64484249b653f79cc2d69af'],200,76,276,13258075,6,1,0,0.013157895,8604
511d892704d368a606844d03ea7a5a674c71de90,0,shaofengshi,2015-03-25 15:45:08+08:00,['72115cc79e687dde02e22309bf5bafa4d9f6a710'],30,84,114,13258189,5,0,1,0.09375,8604
3fcf7890a5fc53f5473792d55d27b2896a264564,1,shaofengshi,2015-03-25 15:45:44+08:00,['511d892704d368a606844d03ea7a5a674c71de90'],25,156,181,13258370,3,0,0.597701149,0.83908046,8604
2e5918d53a00a3be6f22c81e8a713b64ff054d86,1,shaofengshi,2015-03-25 15:45:53+08:00,['3fcf7890a5fc53f5473792d55d27b2896a264564'],69,294,363,13258733,3,0,0.643478261,0.582608696,8604
ddc4ae735864266e158b7c96f76502fa8c35b812,0,qianhao.zhou,2015-03-25 16:12:47+08:00,['2e5918d53a00a3be6f22c81e8a713b64ff054d86'],59,75,134,13258867,9,1,1,1,8604
f72485051105609e06c4a6bfe04c2e063b02411c,0,qianhao.zhou,2015-03-25 16:30:12+08:00,['ddc4ae735864266e158b7c96f76502fa8c35b812'],16,2,18,13258885,1,0,0,0,8604
f4983454166d2d9e9a05c9166ea66fe003849d7c,0,qianhao.zhou,2015-03-25 17:54:30+08:00,['f72485051105609e06c4a6bfe04c2e063b02411c'],47,172,219,13259104,15,1,1,1,8607
65b5672ff245c6870c4e1cf41dffe173392a12bb,0,shaofengshi,2015-03-25 17:55:06+08:00,['2e5918d53a00a3be6f22c81e8a713b64ff054d86'],13,36,49,13259153,3,0,0,1,8607
fe2884465c3367f9dbb5937c528518b179588b76,0,shaofengshi,2015-03-25 17:55:28+08:00,"['65b5672ff245c6870c4e1cf41dffe173392a12bb', 'ddc4ae735864266e158b7c96f76502fa8c35b812']",59,75,134,13259287,9,,,,8607
c8903beeba4f337d4b8a3a7c280d5e58e150c704,0,IT-DONG,2015-03-25 18:42:09+08:00,['da090b03aea815c5a1c543ff0c1f2f735ce2a72d'],15,12,27,13259314,1,,,,8607
1b986b1120bcd3ce8d98d437274f8a4ff7f81180,0,IT-DONG,2015-03-25 18:42:09+08:00,['80f593f3bf8160e661e5d7cc442b774aed3be463'],15,12,27,13259341,1,,,,8607
e4327aab56b93cd460ec4488aece23035b782ec0,0,qianhao.zhou,2015-03-25 18:51:08+08:00,['f4983454166d2d9e9a05c9166ea66fe003849d7c'],1,147,148,13259489,4,1,1,0.772727273,8609
68743a361fcf8703cf66c64b0bfdcf40bd2b6a20,0,qianhao.zhou,2015-03-25 18:51:25+08:00,"['e4327aab56b93cd460ec4488aece23035b782ec0', 'fe2884465c3367f9dbb5937c528518b179588b76']",13,36,49,13259538,3,,,,8609
7b1d26573433f2bf67f9900a3ee2fbcac7fbaddb,0,qianhao.zhou,2015-03-26 10:15:45+08:00,"['63afc436725717698439552d892ec27d94eee0db', 'c8903beeba4f337d4b8a3a7c280d5e58e150c704']",17,14,31,13259569,2,,,,8609
2b0222e2cbf89d8ee0be0781ab70c31ece378dbf,0,qianhao.zhou,2015-03-26 10:15:45+08:00,"['b8383dc1774e233bce2d51b875478fcf0362ae71', '1b986b1120bcd3ce8d98d437274f8a4ff7f81180']",17,14,31,13259600,2,,,,8609
b4c4ff40983a2857827d677d6e7bfede172a65c3,1,shaofengshi,2015-03-26 11:30:51+08:00,['fe2884465c3367f9dbb5937c528518b179588b76'],4,25,29,13259629,2,1,1,1,8609
d0745d2c0f0c49ddc8c18f3cb27b74c138f2f2e6,1,honma,2015-03-26 15:17:32+08:00,['68743a361fcf8703cf66c64b0bfdcf40bd2b6a20'],139,216,355,13259984,4,0.666666667,1,1,8611
15ea499b4c50e1d0257ed1030d8e8e10cdd64a9f,0,honma,2015-03-26 16:03:30+08:00,['d0745d2c0f0c49ddc8c18f3cb27b74c138f2f2e6'],32,168,200,13260184,22,0.566666667,0.85,0.516666667,8612
958d3ac3d80de5543040257527a786e96d2ac0e4,0,honma,2015-03-26 16:09:33+08:00,['15ea499b4c50e1d0257ed1030d8e8e10cdd64a9f'],1,1,2,13260186,1,,,,8612
02e0684838175e7cabb9d2913c2401e3e0815b0d,0,qianhao.zhou,2015-03-26 16:21:41+08:00,['68743a361fcf8703cf66c64b0bfdcf40bd2b6a20'],9,18,27,13260213,6,1,1,1,8612
097302734f53a9d3e52d4abb84e4f3a80b8c0f0e,0,qianhao.zhou,2015-03-26 16:21:47+08:00,"['02e0684838175e7cabb9d2913c2401e3e0815b0d', '958d3ac3d80de5543040257527a786e96d2ac0e4']",170,383,553,13260766,25,,,,8612
8ba1ff52cd35b61aef01b7d2b7a99d21925391d3,0,qianhao.zhou,2015-03-26 17:49:39+08:00,['097302734f53a9d3e52d4abb84e4f3a80b8c0f0e'],38,210,248,13261014,8,0.277777778,1,0.981481481,8614
8e5ec3ebcd8a8b6be5bc52436d43ad965b402b6d,0,shaofengshi,2015-03-26 18:03:33+08:00,['b4c4ff40983a2857827d677d6e7bfede172a65c3'],10,55,65,13261079,3,1,1,0.714285714,8614
f920e6ec9253f0ac8995b417bc154287b0421df2,0,shaofengshi,2015-03-26 18:04:03+08:00,"['8e5ec3ebcd8a8b6be5bc52436d43ad965b402b6d', '8ba1ff52cd35b61aef01b7d2b7a99d21925391d3']",268,919,1187,13262266,51,,,,8614
e9551e600a61f0e56e94b9618441da3977c729a8,0,qianhao.zhou,2015-03-26 18:04:14+08:00,['8ba1ff52cd35b61aef01b7d2b7a99d21925391d3'],11,10,21,13262287,3,1,0,0,8614
bf0a3d5a5bc005defac2dcd12616ebf0eca69d85,0,qianhao.zhou,2015-03-26 18:04:29+08:00,"['e9551e600a61f0e56e94b9618441da3977c729a8', 'f920e6ec9253f0ac8995b417bc154287b0421df2']",14,80,94,13262381,5,,,,8614
bd72225691dbaf330f376fedcc2d91daecfdb278,1,qianhao.zhou,2015-03-26 19:38:38+08:00,['bf0a3d5a5bc005defac2dcd12616ebf0eca69d85'],49,98,147,13262528,4,0.925925926,1,1,8615
2792291e7b9426c3ca7f81926f0e07a601fa62a3,0,shaofengshi,2015-03-26 21:47:51+08:00,['f920e6ec9253f0ac8995b417bc154287b0421df2'],30,38,68,13262596,1,1,1,1,8615
46cd00a95f2826b3aabcdb75c7109de4972cc479,0,wangxiaoyu,2015-03-26 22:08:47+08:00,['9c936ae1c54b9e13e1342746b82a3c6423ca4e8a'],0,3,3,13262599,1,1,1,1,8615
3347dc167f0e256565039a695619744875ae1a96,0,wangxiaoyu,2015-03-26 22:08:47+08:00,['618feec2804453335727a4b0597df8bf3d6d6128'],0,3,3,13262602,1,1,1,1,8615
20e494fcf095360f113f2c26c4e7e0db0532e378,0,shaofengshi,2015-03-26 23:15:57+08:00,['2792291e7b9426c3ca7f81926f0e07a601fa62a3'],32,77,109,13262711,3,0,0,0.8,8615
f73624d3234d48e9ab7fe9d79e5520f560467613,0,shaofengshi,2015-03-26 23:16:06+08:00,"['20e494fcf095360f113f2c26c4e7e0db0532e378', 'bd72225691dbaf330f376fedcc2d91daecfdb278']",59,107,166,13262877,6,,,,8615
784b102bd7851dabf1b162d9dc9437997c93b9f5,0,shaofengshi,2015-03-26 23:32:56+08:00,['f73624d3234d48e9ab7fe9d79e5520f560467613'],11,10,21,13262898,3,,,,8615
2086cf39d199c50d5fa6ea7e1b4c20479a295288,0,shaofengshi,2015-03-27 00:01:59+08:00,['784b102bd7851dabf1b162d9dc9437997c93b9f5'],6,8,14,13262912,1,0,0,1,8615
68bd491e87f1d15c30a547a6501ad1689a715b49,0,qianhao.zhou,2015-03-27 10:05:20+08:00,['bd72225691dbaf330f376fedcc2d91daecfdb278'],59,88,147,13263059,6,0.181818182,0.727272727,0.363636364,8615
a2cb9d2559df20e89884d5202db2653732e741db,0,qianhao.zhou,2015-03-27 10:05:44+08:00,"['68bd491e87f1d15c30a547a6501ad1689a715b49', '2086cf39d199c50d5fa6ea7e1b4c20479a295288']",76,130,206,13263265,6,,,,8615
cefef05c5f46b26e515c73cc41d3360009bdc277,0,Li Yang,2015-03-27 10:35:19+08:00,['9a5b8bc7bb0521ced7537de08fff1019ebfe3419'],6,24,30,13263295,2,1,0.117647059,1,8615
5e9658b69169700b43ad15699fe516d262f672b2,0,Li Yang,2015-03-27 03:36:25+01:00,"['7b1d26573433f2bf67f9900a3ee2fbcac7fbaddb', '9c936ae1c54b9e13e1342746b82a3c6423ca4e8a']",1,2,3,13263298,1,,,,8615
ee5ecf0228c69aa9ece4b2784121a6d5be810ffb,0,Li Yang,2015-03-27 03:36:25+01:00,"['2b0222e2cbf89d8ee0be0781ab70c31ece378dbf', '618feec2804453335727a4b0597df8bf3d6d6128']",1,2,3,13263301,1,,,,8615
b65dc49f0803f71df5a96d0fda3c77217ccbe26c,1,Li Yang,2015-03-27 11:39:24+08:00,"['cefef05c5f46b26e515c73cc41d3360009bdc277', 'a2cb9d2559df20e89884d5202db2653732e741db']",693,2212,2905,13266206,74,,,,8615
4e6628b8cde04f28e17e60b38bcc56f8118d6fc9,1,qianhao.zhou,2015-03-27 11:57:27+08:00,['a2cb9d2559df20e89884d5202db2653732e741db'],28,45,73,13266279,5,1,1,1,8615
f3542b6517262f9ef2a1ca3413b19e67325d7d1b,0,qianhao.zhou,2015-03-27 11:58:26+08:00,"['4e6628b8cde04f28e17e60b38bcc56f8118d6fc9', 'b65dc49f0803f71df5a96d0fda3c77217ccbe26c']",59,237,296,13266575,7,,,,8615
a18304cd9e2f6b69e24ee0ab337f4df42dc5bc68,0,Li Yang,2015-03-27 11:58:31+08:00,['b65dc49f0803f71df5a96d0fda3c77217ccbe26c'],23,44,67,13266642,3,0.9,0.9,0,8615
dcf905e2bdae8f1adeb660faecf0f423b70ab22b,1,Li Yang,2015-03-27 13:25:47+08:00,['a18304cd9e2f6b69e24ee0ab337f4df42dc5bc68'],13,548,561,13267203,5,0.450777202,0.678756477,0.873056995,8617
a402972dc1620209bb94db68aab22a5e4446481e,0,Li Yang,2015-03-27 13:55:39+08:00,['dcf905e2bdae8f1adeb660faecf0f423b70ab22b'],1,11,12,13267215,1,1,1,1,8617
835819db11730ef6175127c74c3f3d1af4ca0195,0,qianhao.zhou,2015-03-27 13:57:35+08:00,"['f3542b6517262f9ef2a1ca3413b19e67325d7d1b', 'a402972dc1620209bb94db68aab22a5e4446481e']",37,603,640,13267855,9,,,,8617
8f285ae7df8c019be779ce1a3a105c9d0b1bdea6,0,Li Yang,2015-03-27 14:02:44+08:00,['a402972dc1620209bb94db68aab22a5e4446481e'],4,7,11,13267866,6,,,,8617
482ddf9ca5206cc3f7bf2b3c9295c18a3a18905e,0,qianhao.zhou,2015-03-27 14:06:32+08:00,"['835819db11730ef6175127c74c3f3d1af4ca0195', '8f285ae7df8c019be779ce1a3a105c9d0b1bdea6']",4,7,11,13267877,6,,,,8617
bedd4a2c73272a836120ca1a3dae09bf3859ba97,1,Li Yang,2015-03-27 14:37:49+08:00,['8f285ae7df8c019be779ce1a3a105c9d0b1bdea6'],93,138,231,13268108,11,1,1,1,8619
0eb0f737993acd1fede6a5a25bff21729ab1b3a7,0,honma,2015-03-27 15:16:20+08:00,['8f285ae7df8c019be779ce1a3a105c9d0b1bdea6'],34,177,211,13268319,10,0.625,1,0.953125,8621
2a14c7e00977503a348a336060828ebdd581b20c,0,honma,2015-03-27 15:16:20+08:00,['0eb0f737993acd1fede6a5a25bff21729ab1b3a7'],8,80,88,13268407,5,0.964285714,1,1,8623
68c7c0d6187c7d49e59bdea0e81bb4f6477a3aa5,0,honma,2015-03-27 15:16:20+08:00,['2a14c7e00977503a348a336060828ebdd581b20c'],4,18,22,13268429,3,1,1,1,8623
c409e6ee5542b847889e5e660ec7268c1e16d641,0,honma,2015-03-27 15:16:20+08:00,['68c7c0d6187c7d49e59bdea0e81bb4f6477a3aa5'],35,81,116,13268545,8,0.115384615,1,1,8623
8fdaea00e303daa12f529f586d5f11f8cd9709db,0,honma,2015-03-27 15:17:00+08:00,['c409e6ee5542b847889e5e660ec7268c1e16d641'],1,1,2,13268547,1,,,,8623
70565bbfd5a29dbb5833952f410f9f8506dc3c20,0,qianhao.zhou,2015-03-27 15:35:57+08:00,['482ddf9ca5206cc3f7bf2b3c9295c18a3a18905e'],14,15,29,13268576,3,1,0.8,1,8623
3988610ff67be0a4aaed4db4286e690529ad179d,0,qianhao.zhou,2015-03-27 15:36:01+08:00,"['70565bbfd5a29dbb5833952f410f9f8506dc3c20', '8fdaea00e303daa12f529f586d5f11f8cd9709db']",67,342,409,13268985,17,,,,8623
d578b5ae336927751ffd4bbdb0debf4bafb4236b,1,honma,2015-03-27 15:56:10+08:00,['8fdaea00e303daa12f529f586d5f11f8cd9709db'],85,199,284,13269269,8,0.234042553,0.234042553,0.234042553,8625
a71507c56fb084c4e6676def76758759ab98ad91,0,qianhao.zhou,2015-03-27 16:10:23+08:00,"['3988610ff67be0a4aaed4db4286e690529ad179d', 'd578b5ae336927751ffd4bbdb0debf4bafb4236b']",85,199,284,13269553,8,,,,8625
e79e2cd0d06e8b759c3f69bd159c66e07e098529,0,honma,2015-03-27 16:13:22+08:00,['d578b5ae336927751ffd4bbdb0debf4bafb4236b'],12,12,24,13269577,2,,,,8625
b808ba5936fd6c022fdf8c2193c113a1db4a6876,0,qianhao.zhou,2015-03-27 16:50:50+08:00,['a71507c56fb084c4e6676def76758759ab98ad91'],140,167,307,13269884,8,1,,1,8626
6aea6fd9f0fc873b1c8485187059966c76b75739,0,qianhao.zhou,2015-03-27 16:51:20+08:00,"['b808ba5936fd6c022fdf8c2193c113a1db4a6876', 'e79e2cd0d06e8b759c3f69bd159c66e07e098529']",12,12,24,13269908,2,,,,8626
4b34cb067a36c4b8f2885c98dec30e92d8e7af15,0,qianhao.zhou,2015-03-27 16:55:44+08:00,['6aea6fd9f0fc873b1c8485187059966c76b75739'],39,28,67,13269975,3,1,0,0,8626
7a8e8199ce3e2c2696e52b0579d363526b80c4c4,1,qianhao.zhou,2015-03-27 17:07:10+08:00,['4b34cb067a36c4b8f2885c98dec30e92d8e7af15'],0,26,26,13270001,1,,,,8626
eafd815758d6dc734596e24aba96d457ac5c1e54,0,honma,2015-03-27 18:06:19+08:00,['4b34cb067a36c4b8f2885c98dec30e92d8e7af15'],7,4,11,13270012,3,,,,8626
881bfb2e071d6b59de903184d47fff61b5e16fe2,0,qianhao.zhou,2015-03-27 18:18:21+08:00,['7a8e8199ce3e2c2696e52b0579d363526b80c4c4'],11,41,52,13270064,3,0,1,1,8626
8ddee636b2f430f5feb0ae6297833d2ae6586821,0,honma,2015-03-27 18:26:06+08:00,['eafd815758d6dc734596e24aba96d457ac5c1e54'],1,1,2,13270066,1,0,0,0,8626
0d3c0995dd9a647725c9d389412d119f8c348eba,1,Li Yang,2015-03-27 18:26:39+08:00,['bedd4a2c73272a836120ca1a3dae09bf3859ba97'],62,321,383,13270449,15,0.65,0.677777778,0.788888889,8627
ca16b1c9c5765b1a26f6f64accf26c6c5fa64707,0,qianhao.zhou,2015-03-27 18:27:03+08:00,"['881bfb2e071d6b59de903184d47fff61b5e16fe2', '8ddee636b2f430f5feb0ae6297833d2ae6586821']",13,10,23,13270472,4,,,,8627
cbb68f2d117a1a971a4ba228a985a3f298ad88ef,1,Li Yang,2015-03-27 21:03:13+08:00,['0d3c0995dd9a647725c9d389412d119f8c348eba'],12,45,57,13270529,4,1,1,0.625,8627
487022a22816e25263d617d76702583993638b2d,0,Li Yang,2015-03-27 14:07:40+01:00,"['cbb68f2d117a1a971a4ba228a985a3f298ad88ef', 'ca16b1c9c5765b1a26f6f64accf26c6c5fa64707']",286,765,1051,13271580,36,,,,8627
1659e37eb052bff66d83b41c0318d40e9c12ba5e,0,Li Yang,2015-03-28 01:02:51+01:00,['5e9658b69169700b43ad15699fe516d262f672b2'],24,19,43,13271623,1,,,,8627
8588376c9831266945533b41f0202389e8174035,0,Li Yang,2015-03-28 01:02:51+01:00,['ee5ecf0228c69aa9ece4b2784121a6d5be810ffb'],24,19,43,13271666,1,,,,8627
b29f1cce9d5ba3689623db156ba84feafe5333af,0,Li Yang,2015-03-28 01:11:41+01:00,['1659e37eb052bff66d83b41c0318d40e9c12ba5e'],1,1,2,13271668,1,,,,8627
ea73d3210320947041177e3aa9ba18d6f6631b24,0,Li Yang,2015-03-28 01:11:41+01:00,['8588376c9831266945533b41f0202389e8174035'],1,1,2,13271670,1,,,,8627
d777c5bea6e79617b71165aab3b783b9df98cba4,1,Li Yang,2015-03-28 09:09:13+01:00,['487022a22816e25263d617d76702583993638b2d'],2,44,46,13271716,1,1,1,1,8627
2bc466dcdf4bda3c6b280609d2ca7a288e73b509,1,Li Yang,2015-03-28 09:35:42+01:00,['d777c5bea6e79617b71165aab3b783b9df98cba4'],19,41,60,13271776,2,1,1,1,8627
085f760dc00d2b546b70fe96a97fb7fdeac3bac0,1,Li Yang,2015-03-29 23:48:09+01:00,['2bc466dcdf4bda3c6b280609d2ca7a288e73b509'],8,29,37,13271813,2,1,1,1,8627
37e19abc943cab88e0dcfce6c0df5c34e736f676,0,qianhao.zhou,2015-03-30 15:50:49+08:00,['085f760dc00d2b546b70fe96a97fb7fdeac3bac0'],3,10,13,13271826,1,0,1,1,8627
77134f938d4e82eb35fce50a74e7df3836189a1a,0,qianhao.zhou,2015-03-30 17:06:12+08:00,['37e19abc943cab88e0dcfce6c0df5c34e736f676'],14,23,37,13271863,1,0,1,1,8627
0303761363b6edf6c621b847b189741813d6276b,0,shaofengshi,2015-03-30 18:11:21+08:00,['085f760dc00d2b546b70fe96a97fb7fdeac3bac0'],9,14,23,13271886,2,1,1,1,8627
6ca82b980f1c1f2fe00528786e20255c0b9774ce,0,shaofengshi,2015-03-30 18:12:50+08:00,['0303761363b6edf6c621b847b189741813d6276b'],1,10,11,13271897,3,1,1,1,8627
cc9ce607c2ffb38c911cdc99f6c45ec9e6ab8f9a,0,qianhao.zhou,2015-03-30 18:53:44+08:00,['77134f938d4e82eb35fce50a74e7df3836189a1a'],1,6,7,13271904,2,0,1,1,8627
ef5215e107e4aa02782837071233be3182d79bfd,1,shaofengshi,2015-03-30 20:02:36+08:00,['6ca82b980f1c1f2fe00528786e20255c0b9774ce'],94,94,188,13272092,5,0.086956522,0,0,8627
43eeff18e8f612be8ba858bef188ad0ad10c912a,0,shaofengshi,2015-03-30 20:04:11+08:00,['ef5215e107e4aa02782837071233be3182d79bfd'],22,25,47,13272139,3,0,0.5,0.5,8627
3dea75401fa576016fb86724ab60c032b5a634c5,0,shaofengshi,2015-03-30 20:04:24+08:00,"['43eeff18e8f612be8ba858bef188ad0ad10c912a', '37e19abc943cab88e0dcfce6c0df5c34e736f676']",3,10,13,13272152,1,,,,8627
e1b4633c8fcbf3e34acc7646b743ef70649396f6,0,qianhao.zhou,2015-03-31 13:13:56+08:00,"['cc9ce607c2ffb38c911cdc99f6c45ec9e6ab8f9a', '3dea75401fa576016fb86724ab60c032b5a634c5']",126,143,269,13272421,13,,,,8627
deb2cd12e84d79d6ef97bd4d1a19e94e7f76770b,0,qianhao.zhou,2015-03-31 13:24:57+08:00,"['e1b4633c8fcbf3e34acc7646b743ef70649396f6', 'ea73d3210320947041177e3aa9ba18d6f6631b24']",48,52,100,13272521,6,,,,8627
db5e600a7e971556d5ed19aa4e5d11d1a8498312,0,Li Yang,2015-03-31 13:25:49+08:00,['085f760dc00d2b546b70fe96a97fb7fdeac3bac0'],45,132,177,13272698,8,0.175675676,1,0.945945946,8627
ee39957747c44e0c5666705fee33d29ccad58972,0,Li Yang,2015-03-31 06:26:10+01:00,"['db5e600a7e971556d5ed19aa4e5d11d1a8498312', 'deb2cd12e84d79d6ef97bd4d1a19e94e7f76770b']",192,234,426,13273124,23,,,,8627
ffe5f7b60ed9156ef79bbea6d0f00b3b5c713c0e,0,qianhao.zhou,2015-03-31 13:35:58+08:00,['deb2cd12e84d79d6ef97bd4d1a19e94e7f76770b'],11,6,17,13273141,3,1,0,0,8627
d9025cd1ed7f3abfd6c729ba3315245512cbd6c8,0,qianhao.zhou,2015-03-31 13:36:14+08:00,"['ffe5f7b60ed9156ef79bbea6d0f00b3b5c713c0e', 'ee39957747c44e0c5666705fee33d29ccad58972']",45,132,177,13273318,8,,,,8627
ba529b615a82e5bc8204abfe56a9d9a1558c9e51,1,qianhao.zhou,2015-03-31 14:16:53+08:00,['d9025cd1ed7f3abfd6c729ba3315245512cbd6c8'],6,16,22,13273340,3,1,1,1,8627
d78d43577fa49b88b0d133c38d545fa33be35936,1,qianhao.zhou,2015-03-31 14:29:52+08:00,['ba529b615a82e5bc8204abfe56a9d9a1558c9e51'],14,19,33,13273373,2,1,1,1,8627
3e0abe49bf80651965060cef4a3e5188011000df,0,qianhao.zhou,2015-03-31 15:01:15+08:00,['d78d43577fa49b88b0d133c38d545fa33be35936'],77,89,166,13273539,1,1,1,0.75,8627
3413255a2a21a30f3160b21bd5bae9d5d1de8f56,0,Li Yang,2015-03-31 15:38:45+08:00,['ee39957747c44e0c5666705fee33d29ccad58972'],33,34,67,13273606,29,1,1,1,8627
e89625701b8aee897da4a8b42a1cf272488b0095,0,shaofengshi,2015-03-31 17:09:49+08:00,['3dea75401fa576016fb86724ab60c032b5a634c5'],185,15,200,13273806,4,0.888888889,0,0.044444444,8629
490aa62b0578e9f65e696528792037eefe2c4ced,0,honma,2015-03-31 17:14:11+08:00,['3e0abe49bf80651965060cef4a3e5188011000df'],8,33,41,13273847,2,0.428571429,1,1,8629
f71ea2d2c01124698fa38c25a47e05ba6edfc20a,0,Li Yang,2015-03-31 17:19:09+08:00,['3413255a2a21a30f3160b21bd5bae9d5d1de8f56'],3,44,47,13273894,2,1,1,0.583333333,8630
bd243cfdef7c7dae27afb1b34d3c973127598f6a,0,Li Yang,2015-03-31 10:19:37+01:00,"['f71ea2d2c01124698fa38c25a47e05ba6edfc20a', '490aa62b0578e9f65e696528792037eefe2c4ced']",116,163,279,13274173,9,,,,8630
a2e8a53c914480ea6483739764079525f7c4e4bf,0,Li Yang,2015-03-31 10:21:27+01:00,['bd243cfdef7c7dae27afb1b34d3c973127598f6a'],1,5,6,13274179,1,1,1,1,8630
19148f0632a79195f362e5eafda44c3e820d7c1e,0,honma,2015-03-31 17:53:39+08:00,['bd243cfdef7c7dae27afb1b34d3c973127598f6a'],1,1,2,13274181,1,,,,8630
8b4fc886760f32f1f6167b4e14793d4ccfb40595,1,Li Yang,2015-03-31 18:06:48+08:00,['a2e8a53c914480ea6483739764079525f7c4e4bf'],1,6,7,13274188,1,1,1,1,8630
4be9d0bfb039371525ad05295480aafd123d1b56,0,Li Yang,2015-03-31 11:07:03+01:00,"['8b4fc886760f32f1f6167b4e14793d4ccfb40595', '19148f0632a79195f362e5eafda44c3e820d7c1e']",1,1,2,13274190,1,,,,8630
089b200e5123e1685de15eb95a67bee0d075658a,0,qianhao.zhou,2015-03-31 18:18:17+08:00,['3e0abe49bf80651965060cef4a3e5188011000df'],14,20,34,13274224,2,0,1,0.875,8630
9a24463ecca1da21c73741b7d462da06e99a52c2,0,qianhao.zhou,2015-03-31 18:19:20+08:00,"['089b200e5123e1685de15eb95a67bee0d075658a', '4be9d0bfb039371525ad05295480aafd123d1b56']",47,123,170,13274394,36,,,,8630
04669bb3d11aff0fade83955919453f197856d28,1,Li Yang,2015-04-01 11:28:23+08:00,['9a24463ecca1da21c73741b7d462da06e99a52c2'],49,89,138,13274532,3,0,1,0,8631
7476fced69d7eaba39efef91405c009b2c400a58,1,Li Yang,2015-04-01 13:12:26+08:00,['04669bb3d11aff0fade83955919453f197856d28'],13,20,33,13274565,3,0.4,1,0.4,8631
9c54f34f6d85b6037e7021f4c1756bb7780cad5e,0,shaofengshi,2015-04-01 13:15:25+08:00,['e89625701b8aee897da4a8b42a1cf272488b0095'],10,8,18,13274583,2,,1,1,8631
508b27e003cb5a0b1813ce9d137bd4453043bdfa,0,shaofengshi,2015-04-01 13:16:27+08:00,['9c54f34f6d85b6037e7021f4c1756bb7780cad5e'],78,89,167,13274750,2,,,,8631
33a05f908611849331751bf2394d989d862c4300,1,shaofengshi,2015-04-01 13:18:27+08:00,['508b27e003cb5a0b1813ce9d137bd4453043bdfa'],145,334,479,13275229,9,0,0.62295082,1,8631
ea4ce04d6af70d2d5401b6770e5538a950bffcf6,0,shaofengshi,2015-04-01 13:24:59+08:00,"['33a05f908611849331751bf2394d989d862c4300', '7476fced69d7eaba39efef91405c009b2c400a58']",322,748,1070,13276299,63,,,,8631
c724a51e50955918226134644b4e61737050eddf,0,lukehan,2015-04-01 13:54:28+08:00,['b29f1cce9d5ba3689623db156ba84feafe5333af'],80,77,157,13276456,3,1,0,0,8631
8a65548caace9cf18ead5fe37ddb52fd74a07d17,0,lukehan,2015-04-01 13:54:28+08:00,['ea73d3210320947041177e3aa9ba18d6f6631b24'],80,77,157,13276613,3,1,0,0,8631
fc1a9bbd17848b67959bd6e939612ccb3bc9eb58,1,wangxiaoyu,2015-04-01 14:48:55+08:00,['46cd00a95f2826b3aabcdb75c7109de4972cc479'],0,8,8,13276621,1,1,1,1,8631
650c879472f5e0c047af66d770d7862fa4075031,0,wangxiaoyu,2015-04-01 14:48:55+08:00,['3347dc167f0e256565039a695619744875ae1a96'],0,8,8,13276629,1,1,1,1,8631
ee60a5faa44a99b7c0c2d5b2299a92ffa28fcc55,0,shaofengshi,2015-04-01 15:17:05+08:00,['ea4ce04d6af70d2d5401b6770e5538a950bffcf6'],191,0,191,13276820,2,0.888888889,0,0.044444444,8631
c2ff1c7c04501decc233fe4c557ae3f85b2de1d6,0,Li Yang,2015-04-01 15:45:13+08:00,['7476fced69d7eaba39efef91405c009b2c400a58'],17,4,21,13276841,3,1,0,0.111111111,8631
e25b11d5c4844ac79aa3c6e2f295f0ffd7d2faea,0,qianhao.zhou,2015-04-01 15:57:18+08:00,['9a24463ecca1da21c73741b7d462da06e99a52c2'],3,3,6,13276847,2,,,,8631
f5ca9ba6932241d50f893ad7c989c782c685f5d8,0,qianhao.zhou,2015-04-01 15:57:27+08:00,"['e25b11d5c4844ac79aa3c6e2f295f0ffd7d2faea', 'ea4ce04d6af70d2d5401b6770e5538a950bffcf6']",280,525,805,13277652,18,,,,8631
4c2237f27534628ef26dec9b43260fe9483c6921,0,honma,2015-04-01 16:11:07+08:00,['f5ca9ba6932241d50f893ad7c989c782c685f5d8'],2,2,4,13277656,1,,0,,8631
2d671f11bedecee202908bbeb5feba5508b5cc33,0,honma,2015-04-01 16:11:07+08:00,['4c2237f27534628ef26dec9b43260fe9483c6921'],1,3,4,13277660,1,,,,8631
825edb2670c23e1bc1cecf5fe592cbef5833b362,0,wteo,2015-04-01 16:35:44+08:00,['b29f1cce9d5ba3689623db156ba84feafe5333af'],3,3,6,13277666,1,,,,8631
fea21c38a79117073d1a56e65ac5fc48d5bcbab2,0,wteo,2015-04-01 16:35:44+08:00,['ea73d3210320947041177e3aa9ba18d6f6631b24'],3,3,6,13277672,1,,,,8631
412aa0821f4c5344ef2ae6e267950abbd700ca81,1,shaofengshi,2015-04-01 17:41:19+08:00,['ee60a5faa44a99b7c0c2d5b2299a92ffa28fcc55'],148,203,351,13278023,3,0,0.422222222,0.466666667,8631
49ad410608e806a6ce0b5df33af249e12dde14fc,1,shaofengshi,2015-04-01 17:58:42+08:00,['412aa0821f4c5344ef2ae6e267950abbd700ca81'],20,30,50,13278073,3,1,1,1,8631
5143a82099db19f7b13667056b7d4118e4c4b47a,0,shaofengshi,2015-04-01 17:58:51+08:00,"['49ad410608e806a6ce0b5df33af249e12dde14fc', '2d671f11bedecee202908bbeb5feba5508b5cc33']",6,8,14,13278087,4,,,,8631
94c374755af8969bde0c4d378fefba9f87a9fc03,0,qianhao.zhou,2015-04-01 18:47:51+08:00,['2d671f11bedecee202908bbeb5feba5508b5cc33'],34,59,93,13278180,3,0,1,1,8631
094f9374a9663d445d6fae9c7a504cb8ecc895cb,0,qianhao.zhou,2015-04-01 18:47:58+08:00,"['94c374755af8969bde0c4d378fefba9f87a9fc03', '5143a82099db19f7b13667056b7d4118e4c4b47a']",342,216,558,13278738,7,,,,8631
d54bab3c845da3f3fe3834f5786cb2d527ff37b6,0,qianhao.zhou,2015-04-01 18:57:05+08:00,['094f9374a9663d445d6fae9c7a504cb8ecc895cb'],0,5,5,13278743,1,,,,8631
4d9fbe26ce6996ed5f1b80051c6ffbf5167b7c7a,0,qianhao.zhou,2015-04-01 19:15:26+08:00,['d54bab3c845da3f3fe3834f5786cb2d527ff37b6'],3,3,6,13278749,1,,,,8631
3c9d4dd50156a5800a8057d8fcf9a1e3269f6bc8,0,qianhao.zhou,2015-04-01 19:27:29+08:00,['4d9fbe26ce6996ed5f1b80051c6ffbf5167b7c7a'],5,14,19,13278768,2,0,1,0.666666667,8631
1463f75d3bead7d9f8cbc50ba299cb824f650820,0,qianhao.zhou,2015-04-01 19:54:35+08:00,['3c9d4dd50156a5800a8057d8fcf9a1e3269f6bc8'],1,1,2,13278770,1,,,,8631
2dd4564fa7c1039d38687d5182e0825cf7a83783,0,qianhao.zhou,2015-04-01 20:01:58+08:00,['1463f75d3bead7d9f8cbc50ba299cb824f650820'],2,2,4,13278774,1,,,,8631
ba35e49b92e189759da386cf0cdd80fdf65eb3e6,0,qianhao.zhou,2015-04-01 20:14:24+08:00,['2dd4564fa7c1039d38687d5182e0825cf7a83783'],1,0,1,13278775,1,1,1,0,8631
9251292095586b4066516d85eb860c0d293189aa,1,shaofengshi,2015-04-02 09:41:42+08:00,['ba35e49b92e189759da386cf0cdd80fdf65eb3e6'],178,86,264,13279039,30,0.862068966,0,0,8631
5c65e38df06decc206c73a2767228d2d127313b2,1,shaofengshi,2015-04-02 10:19:24+08:00,['9251292095586b4066516d85eb860c0d293189aa'],159,156,315,13279354,11,0.706896552,0,0,8631
ee783ea5798d9d7bce44d3e530470d7f68548d9e,0,qianhao.zhou,2015-04-02 11:31:09+08:00,['ba35e49b92e189759da386cf0cdd80fdf65eb3e6'],30,24,54,13279408,5,1,0,0,8631
506776c97d634b399ed0af0dc688413eb10b0407,0,qianhao.zhou,2015-04-02 11:33:38+08:00,"['ee783ea5798d9d7bce44d3e530470d7f68548d9e', '5c65e38df06decc206c73a2767228d2d127313b2']",337,242,579,13279987,37,,,,8631
81dd209a0ac1b9f142de07223879d867b623b725,1,shaofengshi,2015-04-02 12:53:18+08:00,['5c65e38df06decc206c73a2767228d2d127313b2'],32,31,63,13280050,4,1,1,0,8631
72859cdf84bc70efc02fd2f4b0b7bb68e991ad50,0,wangxiaoyu,2015-04-02 13:50:58+08:00,['7b1d26573433f2bf67f9900a3ee2fbcac7fbaddb'],1,8,9,13280059,1,1,1,1,8631
eb9901cf9b91d47039ddd1d25d1cf40999bc1762,0,wangxiaoyu,2015-04-02 13:50:58+08:00,['2b0222e2cbf89d8ee0be0781ab70c31ece378dbf'],1,8,9,13280068,1,1,1,1,8631
b9d88496dc28e15021fd24b6af4f102b04155811,0,qianhao.zhou,2015-04-02 14:43:45+08:00,"['506776c97d634b399ed0af0dc688413eb10b0407', '81dd209a0ac1b9f142de07223879d867b623b725']",32,31,63,13280131,4,,,,8631
2cd174f478c5ecdc34bb99a70a3dde0d55fb10bc,0,qianhao.zhou,2015-04-02 14:47:44+08:00,"['b9d88496dc28e15021fd24b6af4f102b04155811', 'd493583f58348b0b83385ef40f7234f52d26e195']",27,60,87,13280218,7,,,,8631
20cf059b0b79fea097853e45a83e90d8a06631e4,0,honma,2015-04-02 14:48:10+08:00,['81dd209a0ac1b9f142de07223879d867b623b725'],17,46,63,13280281,5,0,0,1,8631
acbec01bfea785f2bbe0669855017c4a5931e646,0,honma,2015-04-02 14:48:10+08:00,['20cf059b0b79fea097853e45a83e90d8a06631e4'],1,1,2,13280283,1,,,,8631
d493583f58348b0b83385ef40f7234f52d26e195,0,honma,2015-04-02 14:48:10+08:00,['acbec01bfea785f2bbe0669855017c4a5931e646'],9,13,22,13280305,1,1,1,1,8631
b92d63493c932b8f0306ecfd5c2575e2c2d425e1,0,shaofengshi,2015-04-02 15:36:15+08:00,['81dd209a0ac1b9f142de07223879d867b623b725'],12,0,12,13280317,1,,,,8631
f4cc42e19921f2963bb1b06349734e61607dfb31,0,shaofengshi,2015-04-02 15:36:35+08:00,['b92d63493c932b8f0306ecfd5c2575e2c2d425e1'],2,2,4,13280321,1,,,,8631
be342b9ab12dd24f15aef9c0d767df5c530c3c76,0,shaofengshi,2015-04-02 15:54:51+08:00,['f4cc42e19921f2963bb1b06349734e61607dfb31'],1,9,10,13280331,1,,,,8631
a35def40953546ffec685982c362219189498284,0,shaofengshi,2015-04-02 15:55:14+08:00,"['be342b9ab12dd24f15aef9c0d767df5c530c3c76', 'd493583f58348b0b83385ef40f7234f52d26e195']",26,59,85,13280416,6,,,,8631
92790bb297a43bf69945cf0af6a05d611460151d,0,shaofengshi,2015-04-02 15:57:06+08:00,['c724a51e50955918226134644b4e61737050eddf'],2,2,4,13280420,1,,,,8631
47adfb85b339dadc0e9abef09bb2f69d414e44e8,0,shaofengshi,2015-04-02 15:57:06+08:00,['8a65548caace9cf18ead5fe37ddb52fd74a07d17'],2,2,4,13280424,1,,,,8631
56e5e1b7b89c368873b6e334c827719936b9daca,0,shaofengshi,2015-04-02 15:59:30+08:00,['92790bb297a43bf69945cf0af6a05d611460151d'],1,1,2,13280426,1,,,,8631
6def3fb5e79e1706aca9b4a782f74d19664bdd2a,0,shaofengshi,2015-04-02 15:59:30+08:00,['47adfb85b339dadc0e9abef09bb2f69d414e44e8'],1,1,2,13280428,1,,,,8631
a7531454c6a4f202716b2cde4d4f2f376076088f,0,shaofengshi,2015-04-02 16:57:31+08:00,['56e5e1b7b89c368873b6e334c827719936b9daca'],1,6,7,13280435,1,1,1,1,8631
db30e1ccaf6325fbbb1f9432f04c9b0f7eca8e18,0,shaofengshi,2015-04-02 16:57:31+08:00,['6def3fb5e79e1706aca9b4a782f74d19664bdd2a'],1,6,7,13280442,1,1,1,1,8631
84886453e422d5711ccdee80d3029e23ea0a9b08,0,qianhao.zhou,2015-04-02 17:22:41+08:00,"['2cd174f478c5ecdc34bb99a70a3dde0d55fb10bc', 'a35def40953546ffec685982c362219189498284']",15,11,26,13280468,3,,,,8631
78dc5950e2bbd3515f50c32b648516e3d3d94ce3,1,Li Yang,2015-04-02 17:45:32+08:00,['c2ff1c7c04501decc233fe4c557ae3f85b2de1d6'],1,1,2,13280470,1,,,,8631
fb9534fa4b44030285a15b9f8e200e36138d13a8,1,Li Yang,2015-04-02 17:46:17+08:00,['78dc5950e2bbd3515f50c32b648516e3d3d94ce3'],55,681,736,13281206,19,0.459610028,0.771587744,0.685236769,8635
1b4c7ece700473c884472c61cdc82cd06b7fbfd9,0,Li Yang,2015-04-02 17:54:56+08:00,['c724a51e50955918226134644b4e61737050eddf'],10,0,10,13281216,1,0,0,0,8635
c9f56de5a560350d5376711f0ee78dabeaf98dfb,0,Li Yang,2015-04-02 17:54:56+08:00,['8a65548caace9cf18ead5fe37ddb52fd74a07d17'],10,0,10,13281226,1,0,0,0,8635
5bdeaa63f9bb02af6ac779268832ed28c076dad6,0,shaofengshi,2015-04-02 17:55:28+08:00,['a7531454c6a4f202716b2cde4d4f2f376076088f'],4,4,8,13281234,3,,,,8635
3aadd443f72e44940a0f1298528a73bf247954ef,0,shaofengshi,2015-04-02 17:55:28+08:00,['db30e1ccaf6325fbbb1f9432f04c9b0f7eca8e18'],4,4,8,13281242,3,,,,8635
b5cbce07061b2263a4e427e086789e1c97130476,0,shaofengshi,2015-04-02 17:55:55+08:00,"['5bdeaa63f9bb02af6ac779268832ed28c076dad6', '1b4c7ece700473c884472c61cdc82cd06b7fbfd9']",10,0,10,13281252,1,,,,8635
b81822ac64602fbba8a8ffb6c88aece97282bc36,0,shaofengshi,2015-04-02 17:55:55+08:00,"['3aadd443f72e44940a0f1298528a73bf247954ef', 'c9f56de5a560350d5376711f0ee78dabeaf98dfb']",10,0,10,13281262,1,,,,8635
84283f51de52c8cc35c13c6712019d9bb1adae38,0,shaofengshi,2015-04-02 18:07:04+08:00,['b5cbce07061b2263a4e427e086789e1c97130476'],2,2,4,13281266,1,,,,8635
bf944da55942348ed64759cc50e0e3f516a07509,0,shaofengshi,2015-04-02 18:07:04+08:00,['b81822ac64602fbba8a8ffb6c88aece97282bc36'],2,2,4,13281270,1,,,,8635
8f33b45c28f559b143e41ee10533a9dc2ac560aa,0,Li Yang,2015-04-02 11:08:56+01:00,"['fb9534fa4b44030285a15b9f8e200e36138d13a8', 'a35def40953546ffec685982c362219189498284']",845,890,1735,13283005,59,,,,8635
33c9dafd0c63af9e2fd4a809019e63868c01af07,0,Li Yang,2015-04-03 10:57:41+08:00,['8f33b45c28f559b143e41ee10533a9dc2ac560aa'],20,64,84,13283089,2,0.205882353,1,0.470588235,8635
2e73d925c7ff026793c9dc167b3b4319f98c108c,0,shaofengshi,2015-04-03 11:22:28+08:00,['84283f51de52c8cc35c13c6712019d9bb1adae38'],1,1,2,13283091,1,,,,8635
437921fcd5447d50f43213b16bc1097401530d69,1,shaofengshi,2015-04-03 11:22:28+08:00,['bf944da55942348ed64759cc50e0e3f516a07509'],1,1,2,13283093,1,,,,8635
f22eef345369a6b30ab41db3a6ebb4efdff83fde,0,qianhao.zhou,2015-04-03 11:24:19+08:00,['84886453e422d5711ccdee80d3029e23ea0a9b08'],0,2,2,13283095,1,,,,8635
09d10f57cfc06639a40a417b7decb5e67c6e3088,0,Li Yang,2015-04-03 04:24:35+01:00,['1b4c7ece700473c884472c61cdc82cd06b7fbfd9'],0,12,12,13283107,2,,,,8637
58db3c3c9e80e4424f774d961fe57944f037c955,0,Li Yang,2015-04-03 04:24:35+01:00,['c9f56de5a560350d5376711f0ee78dabeaf98dfb'],0,12,12,13283119,2,,,,8639
3319b9380ea9a0dfdd1bb5e3d17b089fc29fa6ad,0,Li Yang,2015-04-03 04:25:22+01:00,"['09d10f57cfc06639a40a417b7decb5e67c6e3088', '2e73d925c7ff026793c9dc167b3b4319f98c108c']",11,16,27,13283146,8,,,,8639
76f4c23cac4583f4149c35ca5a24eda59d5d87fc,0,Li Yang,2015-04-03 04:25:22+01:00,"['58db3c3c9e80e4424f774d961fe57944f037c955', '437921fcd5447d50f43213b16bc1097401530d69']",11,16,27,13283173,8,,,,8639
39d4ada316cb0f06652600539ebc940d90df1655,1,shaofengshi,2015-04-03 11:36:56+08:00,['84886453e422d5711ccdee80d3029e23ea0a9b08'],6,6,12,13283185,3,,,,8639
473f843d073bc5bb1750650b0e8686a39356d873,0,shaofengshi,2015-04-03 11:38:20+08:00,['2e73d925c7ff026793c9dc167b3b4319f98c108c'],1,1,2,13283187,1,,,,8639
c1076b397742f42efe1d9a42136e3b98bf3abcfe,0,shaofengshi,2015-04-03 11:38:20+08:00,['437921fcd5447d50f43213b16bc1097401530d69'],1,1,2,13283189,1,,,,8639
eca30d274183ae1fec430be174332527ff267475,0,Li Yang,2015-04-03 04:38:47+01:00,['3319b9380ea9a0dfdd1bb5e3d17b089fc29fa6ad'],0,0,0,13283189,1,,,,8639
b7c58b63d028c2cacb3e924fc46c4382bf685278,0,Li Yang,2015-04-03 04:38:47+01:00,['76f4c23cac4583f4149c35ca5a24eda59d5d87fc'],0,0,0,13283189,1,,,,8639
5146571fa5ddbb7db61919b99d3f648536fc7b53,0,Li Yang,2015-04-03 04:40:54+01:00,"['33c9dafd0c63af9e2fd4a809019e63868c01af07', 'f22eef345369a6b30ab41db3a6ebb4efdff83fde']",31,27,58,13283247,7,,,,8639
6382c208efc09660e1fccc863850cb31568ff0cd,0,honma,2015-04-03 11:43:26+08:00,['f22eef345369a6b30ab41db3a6ebb4efdff83fde'],34,43,77,13283324,4,1,1,0.2,8639
7171e85867a4a2b039c83cfc55e2cf29430ad82b,0,honma,2015-04-03 11:43:51+08:00,['6382c208efc09660e1fccc863850cb31568ff0cd'],86,86,172,13283496,1,,,,8639
722efe267f4c14e08411d67fa1dbb76ce3d65b0a,0,honma,2015-04-03 11:45:19+08:00,['7171e85867a4a2b039c83cfc55e2cf29430ad82b'],1,3,4,13283500,2,,,,8639
1c986daceb2b0b6c98f371c932370c9e37cc1b35,0,honma,2015-04-03 13:03:48+08:00,['722efe267f4c14e08411d67fa1dbb76ce3d65b0a'],206,112,318,13283818,4,0,0,0.342857143,8639
6e92a34f46eee2f0316672cbbeed4adf7631e261,0,honma,2015-04-03 13:17:59+08:00,['1c986daceb2b0b6c98f371c932370c9e37cc1b35'],89,0,89,13283907,1,0.613636364,0,0,8639
9438470b8dc9292b7463fe2381ec25d45f9ca929,0,Li Yang,2015-04-03 14:10:15+08:00,['5146571fa5ddbb7db61919b99d3f648536fc7b53'],16,18,34,13283941,1,,,,8639
2149eb7f364bd003891d0b37b9185b5e2a8fc27b,0,Li Yang,2015-04-03 14:10:33+08:00,"['9438470b8dc9292b7463fe2381ec25d45f9ca929', '6e92a34f46eee2f0316672cbbeed4adf7631e261']",416,244,660,13284601,12,,,,8639
dd85db452b0dd05afa0544fb246aac73bc94575c,0,qianhao.zhou,2015-04-03 15:44:38+08:00,['2149eb7f364bd003891d0b37b9185b5e2a8fc27b'],18,23,41,13284642,2,1,1,0.75,8639
843210e5ca38444651c1b7dd3e31523e38db7c84,1,shaofengshi,2015-04-03 15:51:22+08:00,['39d4ada316cb0f06652600539ebc940d90df1655'],5,11,16,13284658,3,0,0.333333333,1,8639
c9ce7104f3879af103c1d12e2e22c1b5a692cc0f,0,shaofengshi,2015-04-03 15:52:24+08:00,"['843210e5ca38444651c1b7dd3e31523e38db7c84', 'dd85db452b0dd05afa0544fb246aac73bc94575c']",521,1015,1536,13286194,37,,,,8639
03e784c5a905b903562611e5990847cc4fddd015,0,shaofengshi,2015-04-03 15:54:07+08:00,"['c9ce7104f3879af103c1d12e2e22c1b5a692cc0f', 'c1076b397742f42efe1d9a42136e3b98bf3abcfe']",101,93,194,13286388,12,,,,8639
2acb11209cfdc7fc327692d0d26c3925cfd56dce,0,shaofengshi,2015-04-03 15:54:39+08:00,"['473f843d073bc5bb1750650b0e8686a39356d873', 'eca30d274183ae1fec430be174332527ff267475']",0,12,12,13286400,2,,,,8639
c9ce7634e5ec41004773cc7e699a502ed4535bcc,0,shaofengshi,2015-04-03 15:54:39+08:00,"['c1076b397742f42efe1d9a42136e3b98bf3abcfe', 'b7c58b63d028c2cacb3e924fc46c4382bf685278']",0,12,12,13286412,2,,,,8639
efd533fc4e6f1812f09f39dd0211ba697fb88d1a,1,qianhao.zhou,2015-04-03 16:14:28+08:00,['dd85db452b0dd05afa0544fb246aac73bc94575c'],2,7,9,13286421,2,1,1,1,8639
0e6586cfd1b9209ba97e14ef6b19ac99677e8b21,0,qianhao.zhou,2015-04-03 16:14:53+08:00,"['efd533fc4e6f1812f09f39dd0211ba697fb88d1a', '03e784c5a905b903562611e5990847cc4fddd015']",112,110,222,13286643,18,,,,8639
e33dd5f20d9cb1273a2821c1129207303bf2d97f,0,Li Yang,2015-04-03 16:22:50+08:00,['2149eb7f364bd003891d0b37b9185b5e2a8fc27b'],1,17,18,13286661,1,0,1,1,8639
00d0bd2d8b95ac14b0114caae3ad03673a66b334,0,Li Yang,2015-04-03 09:23:13+01:00,"['e33dd5f20d9cb1273a2821c1129207303bf2d97f', '03e784c5a905b903562611e5990847cc4fddd015']",130,133,263,13286924,20,,,,8639
cf27ebef7eb25c341a16751f43013f989f45016e,0,qianhao.zhou,2015-04-03 16:35:29+08:00,"['0e6586cfd1b9209ba97e14ef6b19ac99677e8b21', '00d0bd2d8b95ac14b0114caae3ad03673a66b334']",1,17,18,13286942,1,,,,8639
4ba9b44145271b9ed54762c4c73bb9c4f257ce8b,0,Li Yang,2015-04-03 16:47:13+08:00,['cf27ebef7eb25c341a16751f43013f989f45016e'],2,2,4,13286946,1,,,,8639
8feae42c9b63e1fcbda93afd246b92870079a90b,0,shaofengshi,2015-04-03 17:36:24+08:00,['2acb11209cfdc7fc327692d0d26c3925cfd56dce'],1,1,2,13286948,1,,,,8639
10ac2b9fc3483afe91308df7669fd7606bd7c2bd,0,shaofengshi,2015-04-03 17:36:24+08:00,['c9ce7634e5ec41004773cc7e699a502ed4535bcc'],1,1,2,13286950,1,,,,8639
284443aec8594d614b1e3303af6246d2635dbae2,0,Zhong Jian,2015-04-03 17:56:47+08:00,['eca30d274183ae1fec430be174332527ff267475'],8,10,18,13286968,4,0,1,1,8639
904cffc90e3021fc320990ba2165cfa4649a754f,0,Zhong Jian,2015-04-03 17:56:47+08:00,['b7c58b63d028c2cacb3e924fc46c4382bf685278'],8,10,18,13286986,4,0,1,1,8639
bd8e7723c3fb9d1047d91ba4a38c216fd98fda48,0,Zhong Jian,2015-04-03 17:58:33+08:00,"['8feae42c9b63e1fcbda93afd246b92870079a90b', '284443aec8594d614b1e3303af6246d2635dbae2']",8,10,18,13287004,4,,,,8639
c3fb11cf2078473801d8e8fcb08611888b2f973b,0,Zhong Jian,2015-04-03 17:58:33+08:00,"['10ac2b9fc3483afe91308df7669fd7606bd7c2bd', '904cffc90e3021fc320990ba2165cfa4649a754f']",8,10,18,13287022,4,,,,8639
cd6778b2f17cc3050af1556b9968cf65e5bb9ec5,0,qianhao.zhou,2015-04-03 18:09:19+08:00,"['cf27ebef7eb25c341a16751f43013f989f45016e', 'c3fb11cf2078473801d8e8fcb08611888b2f973b']",9,23,32,13287054,7,,,,8639
837ddb260b58dea3f825a26eb84795edcacd3c3a,1,Li Yang,2015-04-03 18:16:01+08:00,['4ba9b44145271b9ed54762c4c73bb9c4f257ce8b'],10,90,100,13287154,10,1,1,1,8639
444b853c45d71bcb65e4b2358e7b2f8d02b25d57,0,Li Yang,2015-04-03 11:17:45+01:00,"['837ddb260b58dea3f825a26eb84795edcacd3c3a', 'cd6778b2f17cc3050af1556b9968cf65e5bb9ec5']",9,23,32,13287186,7,,,,8639
b505df2665d8ef5abac7286f98c0edb47ceb805b,0,Zhong Jian,2015-04-03 18:19:44+08:00,['284443aec8594d614b1e3303af6246d2635dbae2'],1,1,2,13287188,1,,,,8639
7996f96005f862acf46f29301b525e80d653a56d,0,Zhong Jian,2015-04-03 18:19:44+08:00,['904cffc90e3021fc320990ba2165cfa4649a754f'],1,1,2,13287190,1,,,,8639
2b7dffa9ee9fde8ad7d9de5ab616ce236813f71e,0,Zhong Jian,2015-04-03 18:20:50+08:00,"['bd8e7723c3fb9d1047d91ba4a38c216fd98fda48', 'b505df2665d8ef5abac7286f98c0edb47ceb805b']",1,1,2,13287192,1,,,,8639
66747c49fb90f5aef1aeb0bebac8aefd9928f3d1,0,Zhong Jian,2015-04-03 18:20:50+08:00,"['c3fb11cf2078473801d8e8fcb08611888b2f973b', '7996f96005f862acf46f29301b525e80d653a56d']",1,1,2,13287194,1,,,,8639
0799afa2c8be4503d874f573dd313f753e790965,0,honma,2015-04-03 18:21:44+08:00,['cf27ebef7eb25c341a16751f43013f989f45016e'],112,0,112,13287306,1,0,0,0,8639
20ba7d7e85e32a69b3b2415ca270375e81d27b48,0,honma,2015-04-03 18:22:09+08:00,['0799afa2c8be4503d874f573dd313f753e790965'],185,194,379,13287685,12,1,1,1,8639
4ab4e31ada15346a86287b3511ad12ed7d76b547,0,honma,2015-04-03 18:24:41+08:00,"['20ba7d7e85e32a69b3b2415ca270375e81d27b48', 'cd6778b2f17cc3050af1556b9968cf65e5bb9ec5']",9,23,32,13287717,7,,,,8639
e8708a7b7f4c8bd38ddb96c0a5db219748946aa9,0,honma,2015-04-03 18:30:20+08:00,['4ab4e31ada15346a86287b3511ad12ed7d76b547'],181,0,181,13287898,1,0.632075472,0.443396226,0.216981132,8639
e32f0bb69a36ca7e5c0018d0ca9edb2b2a5c2692,1,Li Yang,2015-04-03 21:01:44+08:00,['444b853c45d71bcb65e4b2358e7b2f8d02b25d57'],35,44,79,13287977,8,0.571428571,0.571428571,1,8639
884d3f0de61465f9f535f19edb7a467cf0e1de9b,0,Li Yang,2015-04-03 14:02:03+01:00,"['e32f0bb69a36ca7e5c0018d0ca9edb2b2a5c2692', 'e8708a7b7f4c8bd38ddb96c0a5db219748946aa9']",478,194,672,13288649,14,,,,8639
f42713526fc0966f1b538902388ba4094f0ea483,0,lukehan,2015-04-03 22:37:23+08:00,['2b7dffa9ee9fde8ad7d9de5ab616ce236813f71e'],2,2,4,13288653,1,,,,8639
e87eb2de3ce90372404aac8e08299cb8370e206f,0,lukehan,2015-04-03 22:37:23+08:00,['66747c49fb90f5aef1aeb0bebac8aefd9928f3d1'],2,2,4,13288657,1,,,,8639
8345fb4e83ff8febe1d1768bf84e2e473e959ddf,0,Li Yang,2015-04-03 23:57:11+01:00,"['f42713526fc0966f1b538902388ba4094f0ea483', '825edb2670c23e1bc1cecf5fe592cbef5833b362']",3,3,6,13288663,1,,,,8639
348a5126f20d95594e98fcfef9807faa2c8ca42e,0,Li Yang,2015-04-03 23:57:11+01:00,"['e87eb2de3ce90372404aac8e08299cb8370e206f', 'fea21c38a79117073d1a56e65ac5fc48d5bcbab2']",3,3,6,13288669,1,,,,8639
de6128bba013859dbcc9fb62fff18bb6cc06cc49,0,Li Yang,2015-04-04 07:05:08+08:00,"['f42713526fc0966f1b538902388ba4094f0ea483', '72859cdf84bc70efc02fd2f4b0b7bb68e991ad50']",1,8,9,13288678,1,,,,8639
27446bae68abd45d9dee3f3d489e51f1cae93ae9,0,Li Yang,2015-04-04 07:05:08+08:00,"['e87eb2de3ce90372404aac8e08299cb8370e206f', 'eb9901cf9b91d47039ddd1d25d1cf40999bc1762']",1,8,9,13288687,1,,,,8639
9414670d2751cddbb22ffc7cb94d8bc4538557a2,0,Li Yang,2015-04-04 07:06:40+08:00,"['f42713526fc0966f1b538902388ba4094f0ea483', 'fc1a9bbd17848b67959bd6e939612ccb3bc9eb58']",0,11,11,13288698,2,,,,8639
75667eedc7648c10dddbf3161ed9001bab07344e,0,Li Yang,2015-04-04 07:06:40+08:00,"['e87eb2de3ce90372404aac8e08299cb8370e206f', '650c879472f5e0c047af66d770d7862fa4075031']",0,11,11,13288709,2,,,,8639
162a4e56267a92b84f189b4ab3483606cd896f9a,0,Li Yang,2015-04-04 00:07:49+01:00,"['8345fb4e83ff8febe1d1768bf84e2e473e959ddf', 'de6128bba013859dbcc9fb62fff18bb6cc06cc49']",1,8,9,13288718,1,,,,8639
245dee70687b0b26455a26880a7fb909fdfead65,0,Li Yang,2015-04-04 00:07:49+01:00,"['348a5126f20d95594e98fcfef9807faa2c8ca42e', '27446bae68abd45d9dee3f3d489e51f1cae93ae9']",1,8,9,13288727,1,,,,8639
09dd67e5db7bb1bae58686574a00baa3fab38c41,0,Li Yang,2015-04-04 00:12:28+01:00,"['9414670d2751cddbb22ffc7cb94d8bc4538557a2', '162a4e56267a92b84f189b4ab3483606cd896f9a']",4,4,8,13288735,2,,,,8639
6e34f6ef6f0e879a55e3ddadad9a830888ea354b,0,Li Yang,2015-04-04 00:12:28+01:00,"['75667eedc7648c10dddbf3161ed9001bab07344e', '245dee70687b0b26455a26880a7fb909fdfead65']",4,4,8,13288743,2,,,,8639
94bfa1688a5975bc0d2100fa136293ae4a8d16dd,0,qianhao.zhou,2015-04-07 11:24:41+08:00,['884d3f0de61465f9f535f19edb7a467cf0e1de9b'],2,10,12,13288755,2,0,1,0,8639
1b2ccfeb19d642672c57f0a2741e94cbd4f13323,0,qianhao.zhou,2015-04-07 14:53:13+08:00,['94bfa1688a5975bc0d2100fa136293ae4a8d16dd'],35,81,116,13288871,8,1,1,0.7,8639
6296d565c51d4f837e79406cd1a427f577589b73,0,honma,2015-04-07 15:07:38+08:00,['884d3f0de61465f9f535f19edb7a467cf0e1de9b'],10,10,20,13288891,2,,,,8639
cdc0f6ea29e013360c34709aa91f23c5508c9122,0,honma,2015-04-07 15:07:58+08:00,"['6296d565c51d4f837e79406cd1a427f577589b73', '1b2ccfeb19d642672c57f0a2741e94cbd4f13323']",37,91,128,13289019,10,,,,8639
b7133d30161545bc8cf8abc3222093b362db8484,0,qianhao.zhou,2015-04-07 17:16:03+08:00,['1b2ccfeb19d642672c57f0a2741e94cbd4f13323'],78,115,193,13289212,7,0.413793103,1,0.344827586,8639
ba07e1302fce110e2769208a04618e85ee3e94c6,0,qianhao.zhou,2015-04-07 17:16:44+08:00,"['b7133d30161545bc8cf8abc3222093b362db8484', 'cdc0f6ea29e013360c34709aa91f23c5508c9122']",10,10,20,13289232,2,,,,8639
2d6ddaa202e175d7534337155447eb4163269610,0,honma,2015-04-07 18:02:23+08:00,['cdc0f6ea29e013360c34709aa91f23c5508c9122'],0,1,1,13289233,1,,,,8639
a7658173c00e78e935ec66c022a5699e5e8b9b92,0,honma,2015-04-07 18:02:49+08:00,['2d6ddaa202e175d7534337155447eb4163269610'],1,1,2,13289235,1,,,,8639
82966a5440c97c34f6bc2e7889f8d5eba64c9122,0,honma,2015-04-07 18:03:00+08:00,"['a7658173c00e78e935ec66c022a5699e5e8b9b92', 'ba07e1302fce110e2769208a04618e85ee3e94c6']",78,115,193,13289428,7,,,,8639
ca9bc38edc05d04b5590206805f94deb3013b8c2,0,shaofengshi,2015-04-07 18:17:52+08:00,['cdc0f6ea29e013360c34709aa91f23c5508c9122'],1,1,2,13289430,1,,,,8639
f689806719c547108bd406f91fb16fd0a396b78a,0,shaofengshi,2015-04-07 18:18:10+08:00,"['ca9bc38edc05d04b5590206805f94deb3013b8c2', '82966a5440c97c34f6bc2e7889f8d5eba64c9122']",79,117,196,13289626,9,,,,8639
abe7cc1d8d5d688ba2493844d1759589c31e58cf,0,shaofengshi,2015-04-07 18:20:10+08:00,['f689806719c547108bd406f91fb16fd0a396b78a'],1,1,2,13289628,1,,,,8639
d3dfc9ce5b7c4c9b648b8cad6f2bdb40978fad7c,1,honma,2015-04-08 13:11:17+08:00,['82966a5440c97c34f6bc2e7889f8d5eba64c9122'],1,1,2,13289630,1,,,,8639
59cd2d21b48bd8ff2e8b12786288ff8a924c7101,0,honma,2015-04-08 13:11:49+08:00,"['d3dfc9ce5b7c4c9b648b8cad6f2bdb40978fad7c', 'abe7cc1d8d5d688ba2493844d1759589c31e58cf']",2,2,4,13289634,2,,,,8639
bbc3be8503ab6e03e21911556fd8a9210bbe8bcd,0,honma,2015-04-08 13:36:42+08:00,['59cd2d21b48bd8ff2e8b12786288ff8a924c7101'],1,1,2,13289636,1,,,,8639
2ca743aee3d2a7e51c96076f6f4d3d3d1c165b4a,1,honma,2015-04-08 15:04:16+08:00,['bbc3be8503ab6e03e21911556fd8a9210bbe8bcd'],1,1,2,13289638,1,,,,8639
2bb0cc4b551268302fd02fe7fb119ff19a057c27,0,Li Yang,2015-04-08 15:23:38+08:00,['2ca743aee3d2a7e51c96076f6f4d3d3d1c165b4a'],6,36,42,13289680,3,0,0,1,8639
0d1e9d0828a9d4b273d322ae3c9d2badb2fd7b37,0,Li Yang,2015-04-08 15:55:12+08:00,['2bb0cc4b551268302fd02fe7fb119ff19a057c27'],5,5,10,13289690,1,,,0,8639
98b133b5ee93b0dd205ec8951f1e4ebf40cbee7f,0,honma,2015-04-08 22:34:02+08:00,['0d1e9d0828a9d4b273d322ae3c9d2badb2fd7b37'],2202,2758,4960,13294650,12,0.212814645,0.466819222,0.883295195,8641
1168e8ef7ca9c8f7f7e5cad4abd19ac475761811,0,honma,2015-04-09 10:22:50+08:00,['98b133b5ee93b0dd205ec8951f1e4ebf40cbee7f'],3,5,8,13294658,2,,,,8641
6e41b7ced7bbb4998dbf5d747f150439e369cec3,1,Li Yang,2015-04-09 11:10:05+08:00,['0d1e9d0828a9d4b273d322ae3c9d2badb2fd7b37'],141,332,473,13295131,9,0.402877698,0.474820144,0.956834532,8642
81faba09a8bd800707a25ed98e3919d95754ea90,0,Li Yang,2015-04-09 11:10:43+08:00,"['6e41b7ced7bbb4998dbf5d747f150439e369cec3', '1168e8ef7ca9c8f7f7e5cad4abd19ac475761811']",2202,2760,4962,13300093,12,,,,8642
50780fcf684e9af1338e11ef5ad9aa6181232b8e,0,honma,2015-04-09 16:33:46+08:00,['1168e8ef7ca9c8f7f7e5cad4abd19ac475761811'],63,101,164,13300257,9,0.5,0.846153846,1,8642
86a5f0c002c7844936d69fb9e6a87ae57adac105,0,honma,2015-04-09 16:36:32+08:00,"['50780fcf684e9af1338e11ef5ad9aa6181232b8e', '81faba09a8bd800707a25ed98e3919d95754ea90']",145,339,484,13300741,10,,,,8642
25a9f1a99c1ae82d6b1b808b9dbf1f197f9b0c1b,0,qianhao.zhou,2015-04-09 17:04:29+08:00,['86a5f0c002c7844936d69fb9e6a87ae57adac105'],167,183,350,13301091,5,1,1,0,8643
10beb02be2027880c019ba24dfef4c3bc3234ae1,0,honma,2015-04-10 10:09:31+08:00,['25a9f1a99c1ae82d6b1b808b9dbf1f197f9b0c1b'],23,21,44,13301135,1,0,0,0,8643
b2c58a6235bb21e41f2885e2891400183acaec10,0,honma,2015-04-10 11:15:04+08:00,['10beb02be2027880c019ba24dfef4c3bc3234ae1'],45,80,125,13301260,3,0,0.96,0,8643
c8d3620226e450755eb284d24498bcac05d69a30,0,qianhao.zhou,2015-04-10 14:02:13+08:00,['b2c58a6235bb21e41f2885e2891400183acaec10'],47,44,91,13301351,2,1,1,1,8643
0de19192eb96587611e85f9144b8bcb2eb984808,0,qianhao.zhou,2015-04-10 16:33:02+08:00,['c8d3620226e450755eb284d24498bcac05d69a30'],12,11,23,13301374,4,1,1,1,8643
c6a8fbf55d5a93bfaf6f388fb33e09d03ba8c60c,0,honma,2015-04-10 16:55:34+08:00,['0de19192eb96587611e85f9144b8bcb2eb984808'],0,8,8,13301382,1,0,1,0,8643
df8eea91dd8ebc03679f798aff69fc6f844b3ee9,1,honma,2015-04-10 16:55:34+08:00,['c6a8fbf55d5a93bfaf6f388fb33e09d03ba8c60c'],24,38,62,13301444,11,0,0.846153846,0.615384615,8643
f80a5bee5c86eee49b9fff286b3f20feaae49fbb,0,qianhao.zhou,2015-04-10 17:19:30+08:00,['df8eea91dd8ebc03679f798aff69fc6f844b3ee9'],4,4,8,13301452,1,,,,8643
11514bccc5ce18e8c0cc3252a58fd8d8d5b686c9,0,lukehan,2015-04-10 17:21:06+08:00,['09dd67e5db7bb1bae58686574a00baa3fab38c41'],1,1,2,13301454,1,,,,8643
d780cebbe18661e47e1ef1c54ab86ca155cdcd60,0,lukehan,2015-04-10 17:21:06+08:00,['6e34f6ef6f0e879a55e3ddadad9a830888ea354b'],1,1,2,13301456,1,,,,8643
3844e21b2fa7786172b652192e6bbe08b938a108,0,qianhao.zhou,2015-04-10 17:34:33+08:00,['09dd67e5db7bb1bae58686574a00baa3fab38c41'],4,4,8,13301464,1,,,,8643
9845103d4bff25f2c9fbcf7cfa5131deff5cf316,0,qianhao.zhou,2015-04-10 17:34:33+08:00,['6e34f6ef6f0e879a55e3ddadad9a830888ea354b'],4,4,8,13301472,1,,,,8643
e204695476f0ea623977beb2e6445eb930d7ec7b,0,lukehan,2015-04-10 17:42:16+08:00,"['11514bccc5ce18e8c0cc3252a58fd8d8d5b686c9', '3844e21b2fa7786172b652192e6bbe08b938a108']",4,4,8,13301480,1,,,,8643
bfa57334cd09c98d9f2f8dd13598a47ae2185d91,0,lukehan,2015-04-10 17:42:16+08:00,"['d780cebbe18661e47e1ef1c54ab86ca155cdcd60', '9845103d4bff25f2c9fbcf7cfa5131deff5cf316']",4,4,8,13301488,1,,,,8643
d0bbdec76106dea26c3d3b805c0277da45173962,0,qianhao.zhou,2015-04-13 10:46:26+08:00,['f80a5bee5c86eee49b9fff286b3f20feaae49fbb'],0,3,3,13301491,1,1,1,1,8643
fcb8b538649ca35f45dd745cb48ac8e47127a1c1,1,qianhao.zhou,2015-04-13 10:46:26+08:00,['d0bbdec76106dea26c3d3b805c0277da45173962'],0,8,8,13301499,1,1,1,1,8643
f376d2a0d9290a71dea2bebc2112f4fdc5c641b7,0,qianhao.zhou,2015-04-13 10:46:26+08:00,['fcb8b538649ca35f45dd745cb48ac8e47127a1c1'],3,3,6,13301505,1,,,,8643
898a5529d6bf8c59a1d342d446ad2c9dc3da40ab,0,qianhao.zhou,2015-04-13 10:49:44+08:00,['f376d2a0d9290a71dea2bebc2112f4fdc5c641b7'],1,1,2,13301507,1,,,,8643
7e4b97a4f40cd60a2cfe009ce2b452646ded5087,0,qianhao.zhou,2015-04-13 10:49:44+08:00,['898a5529d6bf8c59a1d342d446ad2c9dc3da40ab'],1,1,2,13301509,1,,,,8643
a2098d882583f4d91be440e64928de690ac39062,0,qianhao.zhou,2015-04-13 10:49:44+08:00,['7e4b97a4f40cd60a2cfe009ce2b452646ded5087'],2,2,4,13301513,1,,,,8643
27b41997d585470f9111bafb5649beeaa60aaf42,1,shaofengshi,2015-04-13 10:57:42+08:00,['a2098d882583f4d91be440e64928de690ac39062'],140,661,801,13302314,7,0.263843648,0.397394137,0.540716612,8646
9309a60217499e660304dfbda317349f545bd0af,1,shaofengshi,2015-04-13 10:57:42+08:00,['27b41997d585470f9111bafb5649beeaa60aaf42'],450,124,574,13302888,5,0.777777778,0.065656566,0.575757576,8646
fa4a407982134006c8883a3e7d39f970865b99f0,0,shaofengshi,2015-04-13 10:57:42+08:00,['9309a60217499e660304dfbda317349f545bd0af'],8,8,16,13302904,1,0,0,1,8646
ef51f794667746970c1c55980fc3bd66ae370f89,1,Li Yang,2015-04-13 15:28:29+08:00,['fa4a407982134006c8883a3e7d39f970865b99f0'],69,199,268,13303172,11,0.609195402,0.390804598,0.862068966,8646
f4b21a83b9a70cf1af2bd27cb95f0fe0b535b005,0,qianhao.zhou,2015-04-13 18:03:21+08:00,['ef51f794667746970c1c55980fc3bd66ae370f89'],21,110,131,13303303,8,0.333333333,0,0.527777778,8646
d6ab1eb50ea3abf90c3ab4786d5e61ed9e9b2549,0,qianhao.zhou,2015-04-13 20:46:12+08:00,['f4b21a83b9a70cf1af2bd27cb95f0fe0b535b005'],6,46,52,13303355,2,1,1,0,8646
b3c4132f8ce183383d06eaf8a5ac80da20208cb9,1,lukehan,2015-04-14 09:21:06+08:00,['bfa57334cd09c98d9f2f8dd13598a47ae2185d91'],0,70,70,13303425,1,,,,8646
ec84d065a94911874fbf527bf33ddc54fe8e60b6,0,lukehan,2015-04-14 09:21:06+08:00,['e204695476f0ea623977beb2e6445eb930d7ec7b'],0,70,70,13303495,1,,,,8646
87c98b800c65b060f14a96813237561f4b1aafe4,1,lukehan,2015-04-14 09:24:51+08:00,['b3c4132f8ce183383d06eaf8a5ac80da20208cb9'],12,7,19,13303514,1,,,,8646
8e739e67b5dcdc4727b469c975e927a9cc187fa1,0,lukehan,2015-04-14 09:24:51+08:00,['ec84d065a94911874fbf527bf33ddc54fe8e60b6'],12,7,19,13303533,1,,,,8646
bcdc3b0a50ed01903ee406bfc3c7517ca97cd996,0,qianhao.zhou,2015-04-14 10:42:04+08:00,['d6ab1eb50ea3abf90c3ab4786d5e61ed9e9b2549'],3,3,6,13303539,1,,,,8646
85c4d995e024cb758e03679084f470c802feeb25,0,shaofengshi,2015-04-14 12:32:33+08:00,['e204695476f0ea623977beb2e6445eb930d7ec7b'],1,1,2,13303541,1,,,,8646
024b4f13a95803460555b8c9c40416a6ed52ed29,0,shaofengshi,2015-04-14 12:32:33+08:00,['bfa57334cd09c98d9f2f8dd13598a47ae2185d91'],1,1,2,13303543,1,,,,8646
2f9a066a62f55cdfbaddc66cbfa2afd1557894c4,0,shaofengshi,2015-04-14 12:34:18+08:00,['85c4d995e024cb758e03679084f470c802feeb25'],1,1,2,13303545,1,,,,8646
52538c8843b5b3e30cbf9e41cc81310b62f29814,0,shaofengshi,2015-04-14 12:34:18+08:00,['024b4f13a95803460555b8c9c40416a6ed52ed29'],1,1,2,13303547,1,,,,8646
c56681b8bf25cd35dc0f36a76e307fddb530f406,1,Li Yang,2015-04-14 13:06:08+08:00,['bcdc3b0a50ed01903ee406bfc3c7517ca97cd996'],32,167,199,13303746,4,0.436363636,1,0.863636364,8646
b3e9aedd2ca50546b4814e4b6cb3a73a6a2bb70e,0,shaofengshi,2015-04-14 13:48:41+08:00,['2f9a066a62f55cdfbaddc66cbfa2afd1557894c4'],18,6,24,13303770,1,,,,8646
5fed6f4153c2d52ec6e5358a69c24a07c1711d76,0,shaofengshi,2015-04-14 13:48:41+08:00,['52538c8843b5b3e30cbf9e41cc81310b62f29814'],18,6,24,13303794,1,,,,8646
29c3bd9e096eb0db55809cb11140291c661d6a3c,1,shaofengshi,2015-04-14 13:51:42+08:00,['b3e9aedd2ca50546b4814e4b6cb3a73a6a2bb70e'],12,12,24,13303818,4,,,,8646
e077abe62204d0d2597f75a3db0a3f56ede6f3dd,1,shaofengshi,2015-04-14 13:51:42+08:00,['5fed6f4153c2d52ec6e5358a69c24a07c1711d76'],12,12,24,13303842,4,,,,8646
8833b064fa45ab306db27d267ccf2bf93ab2f1fe,0,lukehan,2015-04-14 14:23:56+08:00,['87c98b800c65b060f14a96813237561f4b1aafe4'],11,11,22,13303864,11,,,,8646
25b4329a0a50048d9a53fb5f74e0f357455649c5,0,lukehan,2015-04-14 14:23:56+08:00,['8e739e67b5dcdc4727b469c975e927a9cc187fa1'],11,11,22,13303886,11,,,,8646
3b67023c751cc4713f4f1ac60605b590c267bb4c,0,lukehan,2015-04-14 14:24:01+08:00,"['8833b064fa45ab306db27d267ccf2bf93ab2f1fe', 'e077abe62204d0d2597f75a3db0a3f56ede6f3dd']",32,20,52,13303938,7,,,,8646
2a99bee4b5faced1d6e87c2d2d975c4ce2d69e6b,0,lukehan,2015-04-14 14:24:01+08:00,"['25b4329a0a50048d9a53fb5f74e0f357455649c5', '29c3bd9e096eb0db55809cb11140291c661d6a3c']",32,20,52,13303990,7,,,,8646
05b51946bc05062f0a68ab083cc8276acc191a82,0,shaofengshi,2015-04-14 15:39:32+08:00,"['c56681b8bf25cd35dc0f36a76e307fddb530f406', 'e077abe62204d0d2597f75a3db0a3f56ede6f3dd']",32,20,52,13304042,7,,,,8646
d763bdf65f1376aea86038b42dc182e7de161323,0,qianhao.zhou,2015-04-14 15:54:17+08:00,['05b51946bc05062f0a68ab083cc8276acc191a82'],39,22,61,13304103,1,0,0,0,8646
e86c6e1dc818b6319d545cbd471d7b0bcbee8ec7,0,lukehan,2015-04-14 16:33:24+08:00,['2a99bee4b5faced1d6e87c2d2d975c4ce2d69e6b'],17,13,30,13304163,1,,,,8646
76bfe4c748c242aeb509fc85eeed5136b4c31ccb,0,shaofengshi,2015-04-15 16:25:56+08:00,"['d763bdf65f1376aea86038b42dc182e7de161323', '31cbf35dff44d4b3d740383105c38b28e9c3dfc5']",27,88,115,13304278,12,,,,8646
63753258b7f0a25ed00193967bc63186ac105df8,0,shaofengshi,2015-04-15 17:05:02+08:00,['76bfe4c748c242aeb509fc85eeed5136b4c31ccb'],1,1,2,13304280,1,,,,8646
3ac83a1deabf6c5ced080758beddbf799aa10287,0,Zhong Jian,2015-04-15 22:18:01+08:00,['e86c6e1dc818b6319d545cbd471d7b0bcbee8ec7'],2,2,4,13304284,1,,,,8646
c7b38aa029dd4544d828a84bb862e05c8789deef,0,Zhong Jian,2015-04-15 22:20:14+08:00,"['e86c6e1dc818b6319d545cbd471d7b0bcbee8ec7', '3ac83a1deabf6c5ced080758beddbf799aa10287']",2,2,4,13304288,1,,,,8646
a23e917aca704fe65ea6c99f3ce18fd45d6229db,1,honma,2015-04-16 16:33:10+08:00,['63753258b7f0a25ed00193967bc63186ac105df8'],322,44,366,13304654,22,0.369565217,0,0,8646
bbf2ca4aa960c0b6d0b66f8efff7b19246fbdd17,0,honma,2015-04-16 16:59:24+08:00,['a23e917aca704fe65ea6c99f3ce18fd45d6229db'],0,1,1,13304655,1,1,1,1,8646
f8adc1c572b7d85377e3f4991ba5cb3681b4a748,0,Zhong Jian,2015-04-16 18:01:14+08:00,['3ac83a1deabf6c5ced080758beddbf799aa10287'],1,5,6,13304661,2,0.75,1,0.75,8646
79182d7a8e5e75a3ff136c7fd700ccfeab6efaee,0,Zhong Jian,2015-04-16 18:03:18+08:00,"['c7b38aa029dd4544d828a84bb862e05c8789deef', 'f8adc1c572b7d85377e3f4991ba5cb3681b4a748']",1,5,6,13304667,2,,,,8646
378162d4a1e7a23862eeebac0474f17e72477e32,0,honma,2015-04-16 20:14:47+08:00,['bbf2ca4aa960c0b6d0b66f8efff7b19246fbdd17'],1,1,2,13304669,1,,,,8646
879f929092938f091a7dc91fb1ceaa4702f9afac,0,honma,2015-04-16 20:32:22+08:00,['378162d4a1e7a23862eeebac0474f17e72477e32'],8,4,12,13304681,1,1,1,1,8646
e37b3131b46b9f9fea45650cc0fe89eb391d4f61,1,shaofengshi,2015-04-20 10:42:15+08:00,['879f929092938f091a7dc91fb1ceaa4702f9afac'],101,117,218,13304899,4,1,1,0,8646
7c6c44ceca6b90e103a38221d9e7cb9bff7f3c77,1,shaofengshi,2015-04-20 10:42:15+08:00,['e37b3131b46b9f9fea45650cc0fe89eb391d4f61'],3,37,40,13304939,2,,,,8646
890ba5e1dd9a9d6ee094aa933c9944b42d266782,0,shaofengshi,2015-04-20 12:55:07+08:00,['79182d7a8e5e75a3ff136c7fd700ccfeab6efaee'],3,6,9,13304948,2,0,0,1,8646
7bb9b239c9ff83d831eb3488d813d97a2f77abf6,0,qianhao.zhou,2015-04-20 14:57:03+08:00,['7c6c44ceca6b90e103a38221d9e7cb9bff7f3c77'],1,0,1,13304949,1,,,,8646
d5d79284d78b27b89eefe0df2e5c2475b6d7e871,0,qianhao.zhou,2015-04-20 16:46:46+08:00,['7bb9b239c9ff83d831eb3488d813d97a2f77abf6'],110,132,242,13305191,9,1,1,1,8647
5398ab3e8d41cd72a3a966c61402a40852881a2a,0,shaofengshi,2015-04-21 13:04:57+08:00,['d5d79284d78b27b89eefe0df2e5c2475b6d7e871'],15,15,30,13305221,1,0,1,0,8647
f86516a82b9ff30d6e84f4c5373af863eda29bab,0,shaofengshi,2015-04-21 15:45:46+08:00,['890ba5e1dd9a9d6ee094aa933c9944b42d266782'],24,1,25,13305246,3,,,,8647
f12f61d2a6e02dd672e49b909271b796ba0a4fda,0,shaofengshi,2015-04-21 21:43:38+08:00,['f86516a82b9ff30d6e84f4c5373af863eda29bab'],4,8,12,13305258,2,1,1,1,8647
567c2b26420a6df903dbbc913ec975cd51c0d71c,0,qianhao.zhou,2015-04-22 12:28:18+08:00,['5398ab3e8d41cd72a3a966c61402a40852881a2a'],62,274,336,13305594,14,0.63,1,0.93,8648
21af4d161f64c5110cffecd4948be18ff9dd72f0,0,Li Yang,2015-04-22 14:55:43+08:00,['567c2b26420a6df903dbbc913ec975cd51c0d71c'],15,24,39,13305633,4,0.416666667,0,0.916666667,8648
b0a71564f062a93553c548c2a541eb02a038bbac,0,Li Yang,2015-04-22 15:28:26+08:00,['21af4d161f64c5110cffecd4948be18ff9dd72f0'],8,5,13,13305646,1,0.5,0.5,0,8648
2a670cda014cc1a4cb7c6ca41613f90253078fe4,0,honma,2015-04-22 16:44:51+08:00,['b0a71564f062a93553c548c2a541eb02a038bbac'],29,487,516,13306162,19,0.469387755,0.744897959,1,8655
5281d8eff389d3fd1115c9165f0b1c4b0ccc704e,0,honma,2015-04-22 16:44:51+08:00,['2a670cda014cc1a4cb7c6ca41613f90253078fe4'],263,168,431,13306593,7,1,0.706896552,0.965517241,8655
94d288a15f88c22b4c3376ae918ea24755aa3a4e,1,honma,2015-04-22 16:45:38+08:00,['5281d8eff389d3fd1115c9165f0b1c4b0ccc704e'],198,417,615,13307208,23,0.208,0.832,0.672,8660
87327c4a65db2176f0492c8d69c42ac11527edab,0,honma,2015-04-22 16:45:38+08:00,['94d288a15f88c22b4c3376ae918ea24755aa3a4e'],83,51,134,13307342,7,1,0.666666667,0.666666667,8660
54c550f68e4d11bc41bb89fb86d4675049a8fa77,0,honma,2015-04-22 16:45:38+08:00,['87327c4a65db2176f0492c8d69c42ac11527edab'],8,8,16,13307358,3,,,,8660
a7d16d895cdfc01fec5d9415dcd210f35966c202,0,honma,2015-04-22 16:46:02+08:00,['54c550f68e4d11bc41bb89fb86d4675049a8fa77'],56,204,260,13307618,15,0.632352941,0.602941176,1,8661
e51b981c516b40756983b928840eae2ad58a9a63,0,honma,2015-04-22 16:46:02+08:00,['a7d16d895cdfc01fec5d9415dcd210f35966c202'],46,255,301,13307919,10,0,0.560509554,1,8661
c17d28105724c69d650c7daf3d918214c91d4ba6,0,honma,2015-04-22 16:46:02+08:00,['e51b981c516b40756983b928840eae2ad58a9a63'],5,8,13,13307932,1,0,0,1,8661
d7e6ccf69fd816cc2c4f87ffa9926092f272ae6e,0,honma,2015-04-22 16:46:02+08:00,['c17d28105724c69d650c7daf3d918214c91d4ba6'],31,174,205,13308137,20,0.25,0,0.833333333,8669
36ac3394a7387ea8bd1694ddc0ed74795f3cf196,0,honma,2015-04-22 16:46:02+08:00,['d7e6ccf69fd816cc2c4f87ffa9926092f272ae6e'],49,328,377,13308514,13,0.045454545,0.738636364,0.903409091,8670
431d4ea47a69342ebee8e117b44c74663b2938a9,1,honma,2015-04-22 16:46:02+08:00,['36ac3394a7387ea8bd1694ddc0ed74795f3cf196'],162,213,375,13308889,16,1,1,0.904761905,8671
c11cfa44f7dfe500f1e11c61011fbe70b69fc23a,0,honma,2015-04-22 16:46:02+08:00,['431d4ea47a69342ebee8e117b44c74663b2938a9'],50,167,217,13309106,7,0,0.447368421,0.776315789,8671
5741313d4515ede96853a804eef102bdd0126a19,0,honma,2015-04-22 17:23:30+08:00,['c11cfa44f7dfe500f1e11c61011fbe70b69fc23a'],1,1,2,13309108,1,,,,8671
282eaea872d140f5726b7f3e0bc31b55bde55ab9,0,honma,2015-04-22 22:34:06+08:00,['5741313d4515ede96853a804eef102bdd0126a19'],1,3,4,13309112,3,0,0,1,8671
0700a4a49f8f6e07274032d50f12678b0fb9b887,1,qianhao.zhou,2015-04-23 11:24:33+08:00,['f12f61d2a6e02dd672e49b909271b796ba0a4fda'],152,1794,1946,13311058,104,,,,8671
a5d65b0944412cc656314850612d5356608558a5,0,honma,2015-04-23 15:26:55+08:00,['282eaea872d140f5726b7f3e0bc31b55bde55ab9'],1,1,2,13311060,1,,,,8671
3cca0347f50585e20718a96fbe24341b18717f9b,0,honma,2015-04-23 17:15:58+08:00,['a5d65b0944412cc656314850612d5356608558a5'],213,0,213,13311273,1,0.37,0,0.07,8671
aa201ab45aa9551a283a8058eac49cb3206d15c7,0,lukehan,2015-04-23 23:02:57+08:00,['0700a4a49f8f6e07274032d50f12678b0fb9b887'],1,1,2,13311275,1,,,,8671
9922005533682aff2160f1fa5d28139dc1dfab7f,0,lukehan,2015-04-23 23:05:17+08:00,['aa201ab45aa9551a283a8058eac49cb3206d15c7'],0,43,43,13311318,1,,,,8672
b0ae7417b7bc1ea189e11a68a2e906e17ff54acd,0,lukehan,2015-04-23 23:05:22+08:00,['9922005533682aff2160f1fa5d28139dc1dfab7f'],0,0,0,13311318,1,,,,8672
f02e2a7860a48dc2d05d02592ff73af0b08659f9,0,lukehan,2015-04-24 00:18:50+08:00,['b0ae7417b7bc1ea189e11a68a2e906e17ff54acd'],1,118,119,13311437,8,,,,8672
9370d16fdcac8853aba16390ee8f4509758d7325,0,qianhao.zhou,2015-04-24 12:32:36+08:00,['f02e2a7860a48dc2d05d02592ff73af0b08659f9'],325,3665,3990,13315427,205,0.585365854,0,0,8672
5d4be919e16fb1020b4cae53657fb9882d457748,0,Zhong Jian,2015-04-24 13:31:41+08:00,['9370d16fdcac8853aba16390ee8f4509758d7325'],183,207,390,13315817,2,0,0.173913043,0.826086957,8672
81d42ce2929671ad6ad67194fc372d8649683374,0,Zhong Jian,2015-04-24 13:31:45+08:00,['5d4be919e16fb1020b4cae53657fb9882d457748'],4475,4546,9021,13324838,54,0,1,0.850746269,8672
dd4e248ca1457455dcc1f52f2fa256ccd88a8db7,0,qianhao.zhou,2015-04-24 14:43:15+08:00,['81d42ce2929671ad6ad67194fc372d8649683374'],18,350,368,13325206,15,,,,8672
b1ff5f91e550cc25e79b1d03be59d8b83fd75727,1,Li Yang,2015-04-24 15:33:09+08:00,['3cca0347f50585e20718a96fbe24341b18717f9b'],466,415,881,13326087,21,0,0,0,8673
058d3b2b97e8c62a00cf68c9aea418a6c1087f5e,1,Li Yang,2015-04-24 15:33:13+08:00,['b1ff5f91e550cc25e79b1d03be59d8b83fd75727'],237,227,464,13326551,28,0.310344828,0.586206897,0,8674
423f51a6f1accf3cea68628015ec2011b12d345a,1,shaofengshi,2015-04-24 17:14:18+08:00,['058d3b2b97e8c62a00cf68c9aea418a6c1087f5e'],36,61,97,13326648,7,0.625,1,1,8674
31962bcdf6411f19f9699069fa31666d49f276fe,0,shaofengshi,2015-04-24 17:14:18+08:00,['423f51a6f1accf3cea68628015ec2011b12d345a'],6,8,14,13326662,2,0,1,0,8674
d575858731da03940221b366e532d4f97d9367a2,1,shaofengshi,2015-04-24 17:14:18+08:00,['31962bcdf6411f19f9699069fa31666d49f276fe'],46,69,115,13326777,8,0,0,0.368421053,8674
84e79b12fff6628e7b3aaa27bfb1fbb245ed7214,1,shaofengshi,2015-04-24 17:14:18+08:00,['d575858731da03940221b366e532d4f97d9367a2'],27,98,125,13326902,9,0.9,0.9,1,8676
123dbb58fce76ecf448967085eccd967340dec75,0,qianhao.zhou,2015-04-24 17:27:15+08:00,['dd4e248ca1457455dcc1f52f2fa256ccd88a8db7'],3418,3384,6802,13333704,201,,,,8676
d423ffd07fbb5d6de74fdd034414be1459e3d056,0,qianhao.zhou,2015-04-24 17:34:27+08:00,['84e79b12fff6628e7b3aaa27bfb1fbb245ed7214'],25,7,32,13333736,2,0,0,0,8676
50b273ed327967926ac54d909022890b9e320114,1,Li Yang,2015-04-26 12:38:17+08:00,['123dbb58fce76ecf448967085eccd967340dec75'],0,2,2,13333738,1,0,0,1,8676
70e6fb0eedef6dfed4a38da8fbd5237f4b7ad657,0,honma,2015-04-27 10:36:22+08:00,['50b273ed327967926ac54d909022890b9e320114'],38,60,98,13333836,9,1,1,1,8676
4a615a6dda199a1bf936e71bfe905ec44c054dbf,0,honma,2015-04-27 10:40:42+08:00,['70e6fb0eedef6dfed4a38da8fbd5237f4b7ad657'],0,9,9,13333845,1,,,,8676
ef64d4661c503135feaf81808940ae5cd183e515,1,lukehan,2015-04-27 10:50:27+08:00,['4a615a6dda199a1bf936e71bfe905ec44c054dbf'],0,10,10,13333855,1,,,,8676
35670f88a25c960fae53561eaaba3f2843e1c34a,1,lukehan,2015-04-27 10:50:27+08:00,['ef64d4661c503135feaf81808940ae5cd183e515'],68,8,76,13333931,2,,,,8676
18a784aaf0c72fd18bc9efd9b8d513a23dee12af,0,Li Yang,2015-04-27 17:57:44+08:00,['d423ffd07fbb5d6de74fdd034414be1459e3d056'],48,16,64,13333995,6,1,0,0,8676
f95aeaf399f67bec116fcd89f59a00b2ab355735,0,Li Yang,2015-04-27 18:14:55+08:00,['18a784aaf0c72fd18bc9efd9b8d513a23dee12af'],1,9,10,13334005,1,0,1,1,8676
a35a5cd998d13836d4e22b5732d0f2899697b203,0,qianhao.zhou,2015-04-27 18:21:32+08:00,['f95aeaf399f67bec116fcd89f59a00b2ab355735'],25,28,53,13334058,8,0,0,0,8676
d32fcf5e21aee2ba993905526f960af0c25a65e0,1,honma,2015-04-27 18:57:11+08:00,['a35a5cd998d13836d4e22b5732d0f2899697b203'],1,1,2,13334060,1,,,,8676
b0e2fff71dc259e9bb18a4b77f2caef3d60e57c0,0,honma,2015-04-27 18:57:11+08:00,['d32fcf5e21aee2ba993905526f960af0c25a65e0'],2,3,5,13334065,1,,,,8676
685dc9f2a78c1977d5d1ce2c958e8025b01bec88,0,honma,2015-04-27 18:57:11+08:00,['b0e2fff71dc259e9bb18a4b77f2caef3d60e57c0'],202,1145,1347,13335412,4,0.531446541,0.625786164,0.987421384,8676
fc9eeb6e8b5f0aca6864927062cc2c39af312054,0,honma,2015-04-27 18:57:11+08:00,['685dc9f2a78c1977d5d1ce2c958e8025b01bec88'],284,823,1107,13336519,6,0.707124011,0.81530343,0.963060686,8677
40b33565c6296e251c2f37242dd49d6e4a51cabe,0,honma,2015-04-27 18:57:11+08:00,['fc9eeb6e8b5f0aca6864927062cc2c39af312054'],11,10,21,13336540,1,1,1,1,8677
bdfed5657510dd51ee89b0158b2a69b8788f3417,0,honma,2015-04-27 19:18:27+08:00,['40b33565c6296e251c2f37242dd49d6e4a51cabe'],31,44,75,13336615,8,1,0.666666667,1,8677
e44af50ccbed2b7e83f1a0d4a87e93eac01b6460,0,qianhao.zhou,2015-04-27 19:30:36+08:00,['35670f88a25c960fae53561eaaba3f2843e1c34a'],128,69,197,13336812,8,,,,8677
20e9e6d784437db05bf9ef64e5944efa3405a5c8,0,honma,2015-04-28 10:24:32+08:00,['bdfed5657510dd51ee89b0158b2a69b8788f3417'],10,25,35,13336847,7,0.7,0.7,0.7,8677
4eb3e63f531baad1c8718401e293d3c81ea9d08e,0,honma,2015-04-28 11:20:51+08:00,['20e9e6d784437db05bf9ef64e5944efa3405a5c8'],4,0,4,13336851,2,,,,8677
ba4b02843b320ad7fcbcef8ba3ba4baf4f51a726,0,honma,2015-04-28 14:40:18+08:00,['4eb3e63f531baad1c8718401e293d3c81ea9d08e'],34,66,100,13336951,6,0.333333333,0.333333333,0.523809524,8677
9c107a953ac9e0cbe66a36cd7627862dd976c23d,0,honma,2015-04-28 14:49:24+08:00,['ba4b02843b320ad7fcbcef8ba3ba4baf4f51a726'],5,5,10,13336961,1,,,,8677
5a077831d7d8204c6c90f5e91d6d088bf70d9498,1,lukehan,2015-04-28 16:17:01+08:00,['e44af50ccbed2b7e83f1a0d4a87e93eac01b6460'],6,44,50,13337011,2,,,,8677
0b10ab39bc8ef1369b57566639c1cbee2b177aa5,0,lukehan,2015-04-28 16:18:04+08:00,['5a077831d7d8204c6c90f5e91d6d088bf70d9498'],0,18,18,13337029,1,,,,8677
09d64c7d673461fa92d48fa8436945f86e1236d0,1,Li Yang,2015-04-29 10:43:05+08:00,['0b10ab39bc8ef1369b57566639c1cbee2b177aa5'],16,22,38,13337067,4,1,0,0.111111111,8678
a16df5a1ab23a8a8747ed4f3816ad56f9600fb50,0,Li Yang,2015-04-29 11:13:57+08:00,['09d64c7d673461fa92d48fa8436945f86e1236d0'],1,1,2,13337069,1,,,,8678
3cb20cab4d0d7f4a088f4d9d7aeab4c492717054,0,Li Yang,2015-04-29 11:19:15+08:00,['a16df5a1ab23a8a8747ed4f3816ad56f9600fb50'],1,1,2,13337071,1,,,,8678
7ff280eb7543a85d46d5f2154a317ae90475f45f,0,honma,2015-04-29 14:01:33+08:00,['3cb20cab4d0d7f4a088f4d9d7aeab4c492717054'],6,14,20,13337091,4,0,0,0,8678
43e6ca232e146f8455073631f42268e85ad4dcb3,1,honma,2015-04-29 17:02:41+08:00,['9c107a953ac9e0cbe66a36cd7627862dd976c23d'],72,72,144,13337235,5,1,0,1,8678
2f93e46725a31c186692cb9bb81bd48bc377f8a5,0,honma,2015-04-30 15:50:01+08:00,['7ff280eb7543a85d46d5f2154a317ae90475f45f'],19,33,52,13337287,1,,,,8678
4188680b1c2fc700188de9a2d33b96f9470f560c,0,honma,2015-04-30 15:57:41+08:00,['43e6ca232e146f8455073631f42268e85ad4dcb3'],2,2,4,13337291,1,,,,8678
74521abac24bd82ce91385986e575ea0dc49dff9,1,honma,2015-05-04 13:28:53+08:00,['4188680b1c2fc700188de9a2d33b96f9470f560c'],12,93,105,13337396,4,0.694915254,1,1,8679
d902f2d1caa0a25790495c85e657d8ae23b4ebc6,1,honma,2015-05-04 15:55:44+08:00,['74521abac24bd82ce91385986e575ea0dc49dff9'],16,22,38,13337434,1,1,1,1,8679
b886034c8128a5a3ffcc9d867d72b894bb110f86,0,shaofengshi,2015-05-04 15:54:12+08:00,['d902f2d1caa0a25790495c85e657d8ae23b4ebc6'],12,21,33,13337467,1,1,1,1,8679
603699ceebd4a465d6d1b07466f66b1a7d8c6b39,1,honma,2015-05-04 17:37:21+08:00,['b886034c8128a5a3ffcc9d867d72b894bb110f86'],1,1,2,13337469,1,,,,8679
1bc1165b44c1fd34a98623fdc4ea286d2cf21ee0,0,honma,2015-05-04 18:12:28+08:00,['603699ceebd4a465d6d1b07466f66b1a7d8c6b39'],16,1,17,13337486,1,0,0,0,8679
a7adf9fb7656453bd318aa7aa6af640a74a8b029,0,honma,2015-05-04 18:23:03+08:00,['1bc1165b44c1fd34a98623fdc4ea286d2cf21ee0'],0,2,2,13337488,1,1,1,1,8679
cf5b5a6512ce7b14836b3a0c518e54956c3243da,0,honma,2015-05-05 10:09:32+08:00,['a7adf9fb7656453bd318aa7aa6af640a74a8b029'],1,6,7,13337495,1,1,1,1,8679
0d31e3d0ead6ab74a215f7a38e72c79704a18ee3,0,honma,2015-05-05 13:35:30+08:00,['cf5b5a6512ce7b14836b3a0c518e54956c3243da'],5,2,7,13337502,1,0,0,0,8679
2b3f0474ed052f0d7499cd68c84afc81f13ddb25,1,honma,2015-05-05 14:38:31+08:00,['0d31e3d0ead6ab74a215f7a38e72c79704a18ee3'],19,160,179,13337681,5,0.432835821,1,0.388059701,8682
4d5623a9387d30b678285e04693eaa14ff5d235c,1,honma,2015-05-05 14:38:58+08:00,['2b3f0474ed052f0d7499cd68c84afc81f13ddb25'],38,184,222,13337903,6,,,,8686
de930c0921820bd975a0baaab2fd8891bcc916cc,0,honma,2015-05-05 16:41:47+08:00,['4d5623a9387d30b678285e04693eaa14ff5d235c'],36,169,205,13338108,11,0.24,1,0.94,8689
c4300a236f018fc69c945f3056395b297094a14f,0,honma,2015-05-05 18:00:15+08:00,['de930c0921820bd975a0baaab2fd8891bcc916cc'],12,11,23,13338131,2,,,,8689
83cb58d42f43e6cfa25497eff6c9d998dbb2147a,0,shaofengshi,2015-05-06 10:11:09+08:00,['0d31e3d0ead6ab74a215f7a38e72c79704a18ee3'],38,30,68,13338199,9,1,1,1,8689
e84a835e167f43426f2e1acb37bda3a1e0761eaa,0,honma,2015-05-06 10:15:53+08:00,['c4300a236f018fc69c945f3056395b297094a14f'],9,7,16,13338215,1,0,0,0,8689
2650b8384cbc86e0f4b3a7f7c195922525c26e3e,0,honma,2015-05-06 10:16:48+08:00,['83cb58d42f43e6cfa25497eff6c9d998dbb2147a'],19,160,179,13338394,5,0.432835821,1,0.388059701,8692
bfdfd9e7c55ba53bc8bb2f7bb7a5101e87cb9e43,0,honma,2015-05-06 10:16:48+08:00,['2650b8384cbc86e0f4b3a7f7c195922525c26e3e'],38,184,222,13338616,6,,,,8696
d0fa65adaa746049f6a3cffbc6915e040a4bc98e,0,honma,2015-05-06 10:16:48+08:00,['bfdfd9e7c55ba53bc8bb2f7bb7a5101e87cb9e43'],36,169,205,13338821,11,0.24,1,0.94,8699
2dab51c842e0b87b03c32d623f5ec98bbc355bd2,0,honma,2015-05-06 10:16:48+08:00,['d0fa65adaa746049f6a3cffbc6915e040a4bc98e'],12,11,23,13338844,2,,,,8699
3eaaa78bccded74d6eb0366d3fa06fd2d34fdd27,0,honma,2015-05-06 10:16:48+08:00,['2dab51c842e0b87b03c32d623f5ec98bbc355bd2'],9,7,16,13338860,1,0,0,0,8699
91eac75d7825c5ba7f5f4550b79765d8da77f6ed,0,honma,2015-05-06 18:01:59+08:00,['3eaaa78bccded74d6eb0366d3fa06fd2d34fdd27'],2,5,7,13338867,1,0,0,1,8699
e02b53d7aa6f875867894599ee41a5f97e912cc1,0,honma,2015-05-07 15:04:48+08:00,"['e84a835e167f43426f2e1acb37bda3a1e0761eaa', '91eac75d7825c5ba7f5f4550b79765d8da77f6ed']",39,35,74,13338941,10,,,,8699
ca9d84546df4e49360d35ede865ac29c0d25eed3,1,honma,2015-05-07 15:04:48+08:00,['e02b53d7aa6f875867894599ee41a5f97e912cc1'],87,76,163,13339104,9,0.538461538,0.692307692,0.923076923,8699
ddbc93bbc20a1ea51f67377f247323f84231abce,1,honma,2015-05-07 15:04:48+08:00,['ca9d84546df4e49360d35ede865ac29c0d25eed3'],81,359,440,13339544,32,0.76433121,0.757961783,0.923566879,8703
cab709085d30dc3497955ed3a212efead5b740a3,0,honma,2015-05-07 15:51:45+08:00,['ddbc93bbc20a1ea51f67377f247323f84231abce'],1,2,3,13339547,1,0,0,1,8703
54953cfc00b91fee20dfa2d7fcfdc82c6f5abec2,0,honma,2015-05-07 15:52:57+08:00,['cab709085d30dc3497955ed3a212efead5b740a3'],10,23,33,13339580,2,,,,8704
0b722c2b25723173a75c068f12f5265e1c331a98,0,honma,2015-05-07 16:06:26+08:00,['54953cfc00b91fee20dfa2d7fcfdc82c6f5abec2'],6,8,14,13339594,2,,,,8704
231b4ae202e9267465ab65410f505b89f067db6d,1,shaofengshi,2015-05-07 17:25:56+08:00,['0b722c2b25723173a75c068f12f5265e1c331a98'],21,440,461,13340055,5,0.238095238,0.538095238,0.585714286,8706
4154b82f6d39bbe28100eef8403e8fe4907c30ff,1,shaofengshi,2015-05-07 17:27:31+08:00,['231b4ae202e9267465ab65410f505b89f067db6d'],94,2502,2596,13342651,82,0.636205396,0.696257615,0.554395126,8708
625cc2337675b61e58f7a57a700e7bb63f08cf07,0,shaofengshi,2015-05-07 17:30:58+08:00,['4154b82f6d39bbe28100eef8403e8fe4907c30ff'],1,1,2,13342653,1,,,,8708
7330715e6d40874827e747137884076ac49cc354,1,honma,2015-05-08 10:03:22+08:00,['625cc2337675b61e58f7a57a700e7bb63f08cf07'],3,11,14,13342667,2,0,0,1,8708
9b75f9e4a3b9252700822edaaa0805784da6027d,1,shaofengshi,2015-05-08 18:10:29+08:00,['2f93e46725a31c186692cb9bb81bd48bc377f8a5'],0,1,1,13342668,1,0,1,1,8708
e45f9f7873f9c55da9398a56f2af3db9f4734d8c,0,honma,2015-05-08 22:03:55+08:00,['7330715e6d40874827e747137884076ac49cc354'],11,0,11,13342679,1,0,0,0,8708
a87d8cf4e7f522b5e207a3de6db2d4406de3cb21,0,Li Yang,2015-05-12 09:55:12+08:00,['9b75f9e4a3b9252700822edaaa0805784da6027d'],16,12,28,13342707,1,,,,8708
c7e62112527b4b4d67e0e21a21c5dbd28ae6b8eb,1,shaofengshi,2015-05-12 10:26:43+08:00,['e45f9f7873f9c55da9398a56f2af3db9f4734d8c'],79,368,447,13343154,10,0.421052632,0.519736842,0.763157895,8709
76fce7ddb6a9a2a7b2f7ea0027ef3cab36747e53,1,qianhao.zhou,2015-05-12 13:59:54+08:00,['e45f9f7873f9c55da9398a56f2af3db9f4734d8c'],198,803,1001,13344155,29,0.802228412,0.877437326,0.955431755,8717
e74433f0aac11568c4edce095ab7cdae0a220d9d,0,qianhao.zhou,2015-05-12 14:01:31+08:00,"['c7e62112527b4b4d67e0e21a21c5dbd28ae6b8eb', '76fce7ddb6a9a2a7b2f7ea0027ef3cab36747e53']",198,803,1001,13345156,29,,,,8717
923bdaefa68ded2492a23836e5a690b1b32e61a3,1,shaofengshi,2015-05-12 14:10:35+08:00,['e74433f0aac11568c4edce095ab7cdae0a220d9d'],69,80,149,13345305,11,0.277777778,0.333333333,0.944444444,8717
fef4c9129a98e35cc6464d4ce39c80b20d188ded,1,shaofengshi,2015-05-12 14:10:35+08:00,['923bdaefa68ded2492a23836e5a690b1b32e61a3'],18,36,54,13345359,2,,,,8717
ff7388e5a1fbb23ac65d76a657d2306928454ac3,0,shaofengshi,2015-05-12 14:32:46+08:00,['a87d8cf4e7f522b5e207a3de6db2d4406de3cb21'],5,13,18,13345377,2,1,0.666666667,1,8717
7e8c9f1e0e41d87ba4cbf115baa3006792f0614f,1,honma,2015-05-12 15:20:57+08:00,['fef4c9129a98e35cc6464d4ce39c80b20d188ded'],152,156,308,13345685,16,1,1,1,8719
5d5b5761c9e2d862f195ffa6bf62a0affbeb8d9e,0,qianhao.zhou,2015-05-12 16:46:03+08:00,['76fce7ddb6a9a2a7b2f7ea0027ef3cab36747e53'],31,48,79,13345764,6,1,1,1,8719
d2f503923b42d28ea1487df99f8c4555e83f9893,0,qianhao.zhou,2015-05-12 16:47:16+08:00,"['7e8c9f1e0e41d87ba4cbf115baa3006792f0614f', '5d5b5761c9e2d862f195ffa6bf62a0affbeb8d9e']",31,48,79,13345843,6,,,,8719
84ff6a670ca71ef6ecfa2f70d7e6de50827c7c51,0,shaofengshi,2015-05-13 10:10:25+08:00,['d2f503923b42d28ea1487df99f8c4555e83f9893'],6,157,163,13346006,2,0.466666667,1,1,8720
a70aa753201109d1e3d54c686969e881dfe97f2f,0,qianhao.zhou,2015-05-13 12:22:56+08:00,['84ff6a670ca71ef6ecfa2f70d7e6de50827c7c51'],24,0,24,13346030,3,,,,8720
9fa98c60c8a83429d5aa0db895f953d426f464dc,1,shaofengshi,2015-05-13 13:05:35+08:00,['a70aa753201109d1e3d54c686969e881dfe97f2f'],27,127,154,13346184,4,0.405405405,1,0.945945946,8721
97b2886aef14710cf1cb1e9e13ae6f2dcf8f924a,0,qianhao.zhou,2015-05-13 16:36:46+08:00,['9fa98c60c8a83429d5aa0db895f953d426f464dc'],207,1,208,13346392,206,,,,8721
dfe2e69f9c522623678bbebe1ed718cb8cc8fa7f,0,shaofengshi,2015-05-14 10:32:59+08:00,['ff7388e5a1fbb23ac65d76a657d2306928454ac3'],1,2,3,13346395,1,,,,8721
e86f5bc47df0ceed98a556ad783c87639f06c9d2,0,shaofengshi,2015-05-14 15:24:14+08:00,['dfe2e69f9c522623678bbebe1ed718cb8cc8fa7f'],1,1,2,13346397,1,,,,8721
fc45704df13c356de1625dec7da7d2f623ade0fe,0,qianhao.zhou,2015-05-14 16:38:09+08:00,['97b2886aef14710cf1cb1e9e13ae6f2dcf8f924a'],5,67,72,13346469,2,1,1,1,8722
15cb969c5b6370df42997fb821f6395f4b9466d1,1,honma,2015-05-14 20:22:04+08:00,['fc45704df13c356de1625dec7da7d2f623ade0fe'],379,512,891,13347360,26,0.238095238,1,0.880952381,8726
b2b3e06ee465e53424e9442225e4fa0b87a288b3,1,honma,2015-05-14 20:22:04+08:00,['15cb969c5b6370df42997fb821f6395f4b9466d1'],132,476,608,13347968,14,0.335106383,0.781914894,0.984042553,8732
cf3ab92ded11160d735c6d0813aa55c0bbeef723,1,honma,2015-05-14 20:22:04+08:00,['b2b3e06ee465e53424e9442225e4fa0b87a288b3'],78,90,168,13348136,12,0,1,1,8732
f01c29b4db37021af896abfb4a1077ab25c14c70,1,honma,2015-05-14 20:22:04+08:00,['cf3ab92ded11160d735c6d0813aa55c0bbeef723'],37,47,84,13348220,4,0,1,1,8732
e0597d8eae68dc3382ba7b608f9334557e0680b2,0,honma,2015-05-14 20:22:04+08:00,['f01c29b4db37021af896abfb4a1077ab25c14c70'],53,9,62,13348282,3,0,1,1,8732
76534c6815e8748120a95ed6e76d3ed5cbd36038,0,shaofengshi,2015-05-15 10:37:14+08:00,['e0597d8eae68dc3382ba7b608f9334557e0680b2'],1,12,13,13348295,1,,,,8732
dfb8b57b9e4e5f92724092d6c35cf51dba232a58,1,honma,2015-05-15 11:14:04+08:00,['76534c6815e8748120a95ed6e76d3ed5cbd36038'],17,32,49,13348344,2,1,1,1,8732
955cd02a2d25f8b48c8d329e26e0041cd553e6a8,1,honma,2015-05-15 11:34:17+08:00,['dfb8b57b9e4e5f92724092d6c35cf51dba232a58'],2081,2618,4699,13353043,8,,,,8732
33600da1af4e538c080ae2cae12b93840b2cff6b,1,honma,2015-05-15 11:34:17+08:00,['955cd02a2d25f8b48c8d329e26e0041cd553e6a8'],3,35,38,13353081,5,0.75,1,1,8732
090542d92ee3f950f57c5cb92d002d0c9c5e7cec,1,honma,2015-05-15 11:35:49+08:00,['33600da1af4e538c080ae2cae12b93840b2cff6b'],133,420,553,13353634,8,1,1,0.811764706,8735
bc981fd84ccdb2cca98aae35f2497091fba0d991,1,honma,2015-05-15 11:35:49+08:00,['090542d92ee3f950f57c5cb92d002d0c9c5e7cec'],53,1848,1901,13355535,26,0.707401033,0.86746988,0.788296041,8750
017a7a581adc7f68e902d1d519cb8d0927e107ec,0,honma,2015-05-15 11:35:49+08:00,['bc981fd84ccdb2cca98aae35f2497091fba0d991'],74,372,446,13355981,13,0.75,1,0.853658537,8752
2ff8b5502fd43bc2ba64b8a0d15b5135edd8d78d,0,honma,2015-05-15 11:35:49+08:00,['017a7a581adc7f68e902d1d519cb8d0927e107ec'],2,52,54,13356035,2,,,,8752
fdf4a22f35609b1e9eb91eaaa3b4c3ca5a262c47,0,honma,2015-05-15 11:35:50+08:00,['2ff8b5502fd43bc2ba64b8a0d15b5135edd8d78d'],1,1,2,13356037,1,,,,8752
4391e8697e6d2cf6ae8401a0c3a9977c507c8ebd,1,honma,2015-05-15 11:35:50+08:00,['fdf4a22f35609b1e9eb91eaaa3b4c3ca5a262c47'],2,10,12,13356049,2,,,,8752
33a6e5fac3379c0c5008d130aaf042fb2505452e,1,honma,2015-05-15 11:36:27+08:00,['4391e8697e6d2cf6ae8401a0c3a9977c507c8ebd'],976,363,1339,13357388,20,0.322916667,0.375,0.192708333,8752
061987061df7d06ed8ce9ac1d0a2daada5723dfc,1,honma,2015-05-15 11:36:27+08:00,['33a6e5fac3379c0c5008d130aaf042fb2505452e'],23,38,61,13357449,10,0.5,0.916666667,0,8752
66d1b7d416ecb2592127598be090c3fdb70ba08c,1,honma,2015-05-15 11:36:51+08:00,['061987061df7d06ed8ce9ac1d0a2daada5723dfc'],131,338,469,13357918,17,0.096774194,0.64516129,0.032258065,8755
8584d66fb227f6e906168b5ca6a6aa1dae457de1,1,honma,2015-05-15 11:36:51+08:00,['66d1b7d416ecb2592127598be090c3fdb70ba08c'],172,302,474,13358392,23,0.290322581,0,0,8756
5aa3689b72fa4f0c596fea593892c0b1d980bb59,1,honma,2015-05-15 11:36:52+08:00,['8584d66fb227f6e906168b5ca6a6aa1dae457de1'],248,678,926,13359318,26,0.733333333,0.771666667,0.8,8757
7661165b76bc62562bb4f98b554e1e12617dd749,1,honma,2015-05-15 11:36:52+08:00,['5aa3689b72fa4f0c596fea593892c0b1d980bb59'],58,457,515,13359833,10,0.858823529,1,1,8757
5ce810d80715bf0f14cb8a6544b8e412d6bea724,0,honma,2015-05-15 11:36:52+08:00,['7661165b76bc62562bb4f98b554e1e12617dd749'],50,27,77,13359910,9,0.142857143,0,0.095238095,8757
7b63ebce6fc367bfa6e463e07f3fbdd31f40269b,1,honma,2015-05-15 11:36:52+08:00,['5ce810d80715bf0f14cb8a6544b8e412d6bea724'],34,93,127,13360037,13,1,0,0.923076923,8757
999572be90201818cfc298d66989c4a85d6c6da6,0,honma,2015-05-15 11:36:52+08:00,['7b63ebce6fc367bfa6e463e07f3fbdd31f40269b'],6,26,32,13360069,4,1,1,1,8757
b0d20c944a5a688f3334a90b9202582e8349747c,0,honma,2015-05-15 11:36:53+08:00,['999572be90201818cfc298d66989c4a85d6c6da6'],36,128,164,13360233,9,1,0.956521739,1,8757
4946953376d000f99812a24d8c45784d95d81ab2,1,honma,2015-05-15 11:36:53+08:00,['b0d20c944a5a688f3334a90b9202582e8349747c'],44,91,135,13360368,9,1,0.892857143,1,8757
083605c9a65a7ad86717467f4d4f8e479c67b401,0,honma,2015-05-15 11:36:53+08:00,['4946953376d000f99812a24d8c45784d95d81ab2'],240,75,315,13360683,6,0,1,0.8,8757
674fba79c4ced4cbed5469d2052a7269d75ffba7,1,honma,2015-05-15 11:36:53+08:00,['083605c9a65a7ad86717467f4d4f8e479c67b401'],65,185,250,13360933,12,0.568627451,0.647058824,0.950980392,8757
407a0e404e1fd2a1513c178bafe3557b7d053a4b,1,honma,2015-05-15 11:36:53+08:00,['674fba79c4ced4cbed5469d2052a7269d75ffba7'],531,718,1249,13362182,17,0.47715736,0.385786802,0.949238579,8757
e7b3f051ed77c5a062d52d782721876a2a4efab0,1,honma,2015-05-15 11:36:53+08:00,['407a0e404e1fd2a1513c178bafe3557b7d053a4b'],192,232,424,13362606,19,0.16,0,0.9,8757
cf2766c3e673549e6f8f3c746ff4c4d20b77c957,1,honma,2015-05-15 11:38:00+08:00,['e7b3f051ed77c5a062d52d782721876a2a4efab0'],134,233,367,13362973,20,0.444444444,0.574074074,1,8757
ec310185c454d8111a8b05ada50aac5c94715624,0,honma,2015-05-15 11:38:32+08:00,['cf2766c3e673549e6f8f3c746ff4c4d20b77c957'],27,36,63,13363036,8,1,,,8757
2b7c891297cf215e59c961697b02922e0e8df8a8,0,honma,2015-05-15 11:38:32+08:00,['ec310185c454d8111a8b05ada50aac5c94715624'],30,18,48,13363084,3,1,1,1,8757
c57f08e3fc0551a8cf5549b29dac6e5fa2a1cfa4,1,honma,2015-05-15 11:38:32+08:00,['2b7c891297cf215e59c961697b02922e0e8df8a8'],17,109,126,13363210,12,1,1,1,8757
c47a31b735932008ed53ea27ec907e8d838dead7,0,honma,2015-05-15 11:38:33+08:00,['c57f08e3fc0551a8cf5549b29dac6e5fa2a1cfa4'],4,4,8,13363218,2,0,0,0,8757
ef12babb98ec5b1fe82cf91d7b445387db46583a,1,honma,2015-05-15 11:38:33+08:00,['c47a31b735932008ed53ea27ec907e8d838dead7'],413,477,890,13364108,32,0.348837209,0.976744186,0.534883721,8758
83e846cabfa93c2f4f3419e0fc0310b08fd0adfd,0,honma,2015-05-15 11:39:11+08:00,['ef12babb98ec5b1fe82cf91d7b445387db46583a'],5,6,11,13364119,4,,,,8758
151b8dda38972a05ea63da7e7b528f63b4ad93a8,0,honma,2015-05-15 11:39:11+08:00,['83e846cabfa93c2f4f3419e0fc0310b08fd0adfd'],2,5,7,13364126,1,1,1,1,8758
9361feb329374d3077b423cb4ad62be608243ee5,1,honma,2015-05-15 11:39:12+08:00,['151b8dda38972a05ea63da7e7b528f63b4ad93a8'],32,14,46,13364172,7,,,,8758
4a20d20696b97fee5d7269669671d9d738cb479c,0,honma,2015-05-15 11:39:12+08:00,['9361feb329374d3077b423cb4ad62be608243ee5'],2,44,46,13364218,5,0,0,1,8761
cd14ff8bf222f7255758a13deb2003377ddfcd64,0,honma,2015-05-15 11:39:30+08:00,['4a20d20696b97fee5d7269669671d9d738cb479c'],1,241,242,13364460,8,1,1,1,8763
52e340b1e0b49f0c0b31806cd6fe0abf571d81a7,0,honma,2015-05-15 11:40:22+08:00,['cd14ff8bf222f7255758a13deb2003377ddfcd64'],98,98,196,13364656,1,,,,8763
ccb70190c2d6849e7261e8e0dc4ed7160ddb577d,0,honma,2015-05-15 11:40:22+08:00,"['dfb8b57b9e4e5f92724092d6c35cf51dba232a58', '52e340b1e0b49f0c0b31806cd6fe0abf571d81a7']",3517,7989,11506,13376162,109,,,,8763
26d40c9b61a495d0e23579ac34727138e01d02d7,1,honma,2015-05-15 14:50:09+08:00,['ccb70190c2d6849e7261e8e0dc4ed7160ddb577d'],17,17,34,13376196,1,,,,8763
8bb93071912ceae127f05713622714ee1e6dc881,1,Li Yang,2015-05-15 14:58:20+08:00,['26d40c9b61a495d0e23579ac34727138e01d02d7'],109,599,708,13376904,17,0.387205387,0.484848485,0.740740741,8765
1c0eec236b07b1796e7dc4e154ed6a222c217cbc,0,Li Yang,2015-05-15 15:16:17+08:00,['8bb93071912ceae127f05713622714ee1e6dc881'],8,45,53,13376957,3,1,0.952380952,1,8765
0bb3ab22c2013875156f385fe3bea86120ea4098,1,honma,2015-05-15 15:33:36+08:00,['1c0eec236b07b1796e7dc4e154ed6a222c217cbc'],11,22,33,13376990,1,0,1,1,8765
a676f89b14ae4d55f0a157aca04e8766471144ac,0,qianhao.zhou,2015-05-15 17:12:14+08:00,['0bb3ab22c2013875156f385fe3bea86120ea4098'],4,3,7,13376997,1,0,0,0,8765
c82f3139753fa507ea5259b10ee379d06f7bd0ff,0,qianhao.zhou,2015-05-18 19:19:03+08:00,['a676f89b14ae4d55f0a157aca04e8766471144ac'],1,4,5,13377002,1,1,1,1,8765
d110b2bea4b4b261c36284d3c5ce350452736c76,1,qianhao.zhou,2015-05-18 19:22:46+08:00,['c82f3139753fa507ea5259b10ee379d06f7bd0ff'],0,5,5,13377007,1,,,,8765
81a62fbb8110baa29a8b1f71a855f630a936abd8,0,shaofengshi,2015-05-18 22:07:56+08:00,['d110b2bea4b4b261c36284d3c5ce350452736c76'],39,53,92,13377099,3,0,0,0.052631579,8765
a65479e32b5b6c2d4353010c302f15cd9a7d66f7,1,shaofengshi,2015-05-19 10:54:31+08:00,['81a62fbb8110baa29a8b1f71a855f630a936abd8'],18,50,68,13377167,2,0,0,0,8765
f5f4e2d430edbe144f2a6c9f175f4ccf8d7fc0b9,0,lukehan,2015-05-19 18:09:58+08:00,['e86f5bc47df0ceed98a556ad783c87639f06c9d2'],3,7,10,13377177,1,,,,8765
07dae77fadef584ce00d95560cbf57099dc4e8d0,1,Li Yang,2015-05-20 08:22:53+08:00,['a65479e32b5b6c2d4353010c302f15cd9a7d66f7'],62,157,219,13377396,3,0.980769231,1,1,8766
ad1c3dbd99539232f83e8008021dced00621de10,1,shaofengshi,2015-05-20 20:29:08+08:00,['07dae77fadef584ce00d95560cbf57099dc4e8d0'],53,98,151,13377547,5,1,0.75,1,8767
8110df252deb68cd7fe95e84ce38b3af657732d2,0,lukehan,2015-05-20 20:40:11+08:00,['f5f4e2d430edbe144f2a6c9f175f4ccf8d7fc0b9'],358,0,358,13377905,5,,,,8767
3d9cfdf47498d5adc06bf6530c2fde6ce52d7157,0,lukehan,2015-05-20 20:42:19+08:00,['8110df252deb68cd7fe95e84ce38b3af657732d2'],0,226,226,13378131,4,,,,8771
70c79e5cf30737731c0d835eebe06fbc7beafb86,0,lukehan,2015-05-20 21:27:08+08:00,['3d9cfdf47498d5adc06bf6530c2fde6ce52d7157'],487,483,970,13379101,12,,,,8771
db78e0ee4b03b888133fa7fc1f5128ff1cdea5d8,0,lukehan,2015-05-20 22:00:53+08:00,['70c79e5cf30737731c0d835eebe06fbc7beafb86'],1,4,5,13379106,2,,,,8771
0af6e7c467ef930e6c2e34363d3cfca5f6471035,0,lukehan,2015-05-20 22:02:37+08:00,['db78e0ee4b03b888133fa7fc1f5128ff1cdea5d8'],0,5,5,13379111,2,,,,8771
2c4470c584cbe6d25143d90c6f3d7ae3c35c202f,0,Luke Han,2015-05-20 22:45:42+08:00,['0af6e7c467ef930e6c2e34363d3cfca5f6471035'],8,0,8,13379119,1,,,,8771
ff810de6461241229f413eccd6bc6b9b8b6819e5,0,Luke Han,2015-05-21 10:40:00+08:00,['2c4470c584cbe6d25143d90c6f3d7ae3c35c202f'],11,11,22,13379141,11,,,,8771
210ac3ebe287cbd2837e2067afe07f8b5cbc21a3,0,Luke Han,2015-05-21 10:58:11+08:00,['ff810de6461241229f413eccd6bc6b9b8b6819e5'],13,13,26,13379167,12,,,,8771
1ff3ba5c6c7eb3befc3209e3ac07924bfadcdcb2,0,Luke Han,2015-05-21 10:58:55+08:00,['210ac3ebe287cbd2837e2067afe07f8b5cbc21a3'],13,13,26,13379193,12,,,,8771
2210f222a6349e8dbf722c3aecfe38fcda633b72,0,Luke Han,2015-05-21 22:22:22+08:00,['1ff3ba5c6c7eb3befc3209e3ac07924bfadcdcb2'],11,11,22,13379215,11,,,,8771
ccd7084f9fdaf722d7ca7c3dabf40cd382c64ca3,0,Luke Han,2015-05-21 22:23:47+08:00,['2210f222a6349e8dbf722c3aecfe38fcda633b72'],1,1,2,13379217,1,,,,8771
3b3a302b1fdb14d5eba4618bf0610a50ebabdbe8,0,Luke Han,2015-05-21 22:26:39+08:00,['ccd7084f9fdaf722d7ca7c3dabf40cd382c64ca3'],13,13,26,13379243,12,,,,8771
994f1a3c68d5ed80e7cfbd1c0436d5bc4a699cf3,0,Luke Han,2015-05-21 22:27:49+08:00,['3b3a302b1fdb14d5eba4618bf0610a50ebabdbe8'],13,13,26,13379269,12,,,,8771
451823a6c4ee2e9d77da7eb4b031635d7eb3b074,0,Luke Han,2015-05-22 10:57:42+08:00,['994f1a3c68d5ed80e7cfbd1c0436d5bc4a699cf3'],0,73,73,13379342,1,,,,8772
25d3cfc358e0e7341214a88405eb813a42faf375,0,Zhong Jian,2015-05-22 11:11:28+08:00,['ad1c3dbd99539232f83e8008021dced00621de10'],485,1,486,13379828,3,0.214953271,0,0.112149533,8772
6ec49821f8fc6f1e3609e9d2ca3daf843075739a,0,Luke Han,2015-05-22 13:43:20+08:00,['451823a6c4ee2e9d77da7eb4b031635d7eb3b074'],0,33,33,13379861,1,,,,8773
404e04007b93bb3f05a477c93c58cf32cd41af5d,0,Zhong Jian,2015-05-22 14:24:02+08:00,['451823a6c4ee2e9d77da7eb4b031635d7eb3b074'],8,8,16,13379877,1,1,0,0,8773
f263db45976750a1bc571f720808e1c0e032812b,1,shaofengshi,2015-05-22 14:45:56+08:00,['25d3cfc358e0e7341214a88405eb813a42faf375'],16,136,152,13380029,8,0.094594595,0.445945946,1,8773
909b0f6f111e5aa805f93052f20fc25ea71cf739,0,Zhong Jian,2015-05-22 15:50:17+08:00,"['404e04007b93bb3f05a477c93c58cf32cd41af5d', '6ec49821f8fc6f1e3609e9d2ca3daf843075739a']",0,33,33,13380062,1,,,,8773
20c4482e0643df13b6fdf764ff585477c69650b8,0,Li Yang,2015-05-22 15:55:28+08:00,['909b0f6f111e5aa805f93052f20fc25ea71cf739'],0,2,2,13380064,1,,,,8773
cd9e1a7d728891130c69c6b765551ce3d304a7c7,0,Li Yang,2015-05-23 08:00:08+08:00,['f263db45976750a1bc571f720808e1c0e032812b'],1,24,25,13380089,4,0,0,1,8774
a17987ca19d660a1688a0ce19ba2729c21dd5f07,1,Li Yang,2015-05-23 12:20:38+08:00,['cd9e1a7d728891130c69c6b765551ce3d304a7c7'],0,557,557,13380646,3,0.391304348,1,0.826086957,8776
86361808b9c8e957f6ed8eebfe9b6cf783e20546,0,Li Yang,2015-05-24 07:22:07+08:00,['a17987ca19d660a1688a0ce19ba2729c21dd5f07'],54,43,97,13380743,9,0,0,1,8776
db33fec74669bbd38fc90f9cc6902eff09dc0b5e,0,shaofengshi,2015-05-25 10:35:00+08:00,['86361808b9c8e957f6ed8eebfe9b6cf783e20546'],38,22,60,13380803,2,1,1,0,8776
dff0f7a0102efdf763f1c20e97b8cb53cc401f37,1,shaofengshi,2015-05-25 17:13:34+08:00,['db33fec74669bbd38fc90f9cc6902eff09dc0b5e'],15,19,34,13380837,1,0,0,0,8776
8f45cf1856d03eff5132688aedf78b519eec2e0c,0,qianhao.zhou,2015-05-25 18:39:23+08:00,['dff0f7a0102efdf763f1c20e97b8cb53cc401f37'],84,403,487,13381324,7,0.669172932,0.458646617,0.69924812,8778
3a460fb3fb48f6f4cd1e0275b52803234c2171e2,0,Luke Han,2015-05-26 16:54:42+08:00,['994f1a3c68d5ed80e7cfbd1c0436d5bc4a699cf3'],12,12,24,13381348,12,,,,8778
dc9beb22bfaceb8b3ace110b2462adfcb6464e2d,0,Luke Han,2015-05-26 16:58:18+08:00,['3a460fb3fb48f6f4cd1e0275b52803234c2171e2'],13,13,26,13381374,12,,,,8778
8464b9f1b6e848d6ad0469ca99d2a4ab15fdd4bf,0,Luke Han,2015-05-26 17:01:41+08:00,['dc9beb22bfaceb8b3ace110b2462adfcb6464e2d'],13,13,26,13381400,12,,,,8778
174329f6f642f0d8e9ea599eb555c5e958b68fca,0,Zhong Jian,2015-05-26 18:32:56+08:00,['8f45cf1856d03eff5132688aedf78b519eec2e0c'],3,4,7,13381407,2,,,,8778
c1c76e8d04eeac847d154e94aa51c8e2b2d925cd,0,Luke Han,2015-05-26 19:30:18+08:00,['8464b9f1b6e848d6ad0469ca99d2a4ab15fdd4bf'],12,12,24,13381431,12,,,,8778
d957ae6294ae9aa4bc38977d97a6a3951c748732,1,Zhong Jian,2015-05-26 19:32:09+08:00,['174329f6f642f0d8e9ea599eb555c5e958b68fca'],49,39,88,13381519,9,0,0,0,8778
3105a5ecdc9f1b194f8a33523b83341f95755058,0,Luke Han,2015-05-26 19:44:06+08:00,['ccd7084f9fdaf722d7ca7c3dabf40cd382c64ca3'],7,7,14,13381533,2,,,,8778
9251fc4bfaa90dc4374467734c638acdcac67ee7,0,Luke Han,2015-05-26 19:45:29+08:00,['3105a5ecdc9f1b194f8a33523b83341f95755058'],10,0,10,13381543,1,,,,8778
f316c226e7bbd1def310cc4702e95fb157824c6e,0,Luke Han,2015-05-26 19:45:43+08:00,"['9251fc4bfaa90dc4374467734c638acdcac67ee7', 'c1c76e8d04eeac847d154e94aa51c8e2b2d925cd']",0,0,0,13381543,0,,,,8778
56d17108501304ac6452a4714d79a12c4c928777,0,Luke Han,2015-05-26 19:53:52+08:00,['f316c226e7bbd1def310cc4702e95fb157824c6e'],13,13,26,13381569,12,,,,8778
b2ffa3bd0791785e2d8c13fc3054de04f3e1701b,0,Luke Han,2015-05-26 19:57:32+08:00,['56d17108501304ac6452a4714d79a12c4c928777'],13,13,26,13381595,12,,,,8778
e912618f5b1ed599435fbd04caab838076a0a43b,1,honma,2015-05-26 23:11:52+08:00,['d957ae6294ae9aa4bc38977d97a6a3951c748732'],629,465,1094,13382689,27,0,0,0.016949153,8778
65046718da9f47233363b47e76661a76753f81d9,1,honma,2015-05-26 23:11:52+08:00,['e912618f5b1ed599435fbd04caab838076a0a43b'],168,1168,1336,13384025,18,0.519266055,0.605504587,0.834862385,8784
407f9c79f31cc2a7439bb64e796039b9623dc8be,0,honma,2015-05-26 23:11:52+08:00,['65046718da9f47233363b47e76661a76753f81d9'],86,5,91,13384116,2,0.837837838,0.837837838,0,8784
e5e96e63e6a9bcdf96bc04ec2fe2e444e7c42e88,0,honma,2015-05-26 23:11:52+08:00,['407f9c79f31cc2a7439bb64e796039b9623dc8be'],6,2,8,13384124,1,1,0,0,8784
e23b8362f9c58562d936d55f84621887f1fd0979,1,honma,2015-05-26 23:17:15+08:00,['e5e96e63e6a9bcdf96bc04ec2fe2e444e7c42e88'],97,87,184,13384308,26,0,0,0,8785
c98cb6ca36da8aa21dd9af7e4d99cad9f8cce75e,1,honma,2015-05-26 23:17:16+08:00,['e23b8362f9c58562d936d55f84621887f1fd0979'],8,13,21,13384329,4,1,1,1,8785
ed335573a8e6367e8b4ad37db309e59fad2e36a7,1,honma,2015-05-26 23:17:16+08:00,['c98cb6ca36da8aa21dd9af7e4d99cad9f8cce75e'],81,109,190,13384519,5,,,,8785
1ab8542375c0d1d26c84ec83c2ff6e17dbc40c93,0,honma,2015-05-26 23:20:40+08:00,['ed335573a8e6367e8b4ad37db309e59fad2e36a7'],0,159,159,13384678,2,1,1,0.928571429,8786
e1fc34f52eb249d2914e6b0db978669becabcc64,0,honma,2015-05-26 23:20:40+08:00,['1ab8542375c0d1d26c84ec83c2ff6e17dbc40c93'],1,0,1,13384679,1,,,,8786
75e4766914ffcb011a93cdfc47504949bfd3b811,1,honma,2015-05-26 23:21:27+08:00,['e1fc34f52eb249d2914e6b0db978669becabcc64'],172,14,186,13384865,5,0,0,0.071428571,8786
437e36ab9a619d5fbfe7b40a51cb17682fa19423,1,honma,2015-05-26 23:21:27+08:00,['75e4766914ffcb011a93cdfc47504949bfd3b811'],14,14,28,13384893,4,,,,8786
57faf86863b879e7fcd6e6cee0e81d6853a0c35a,0,honma,2015-05-26 23:21:27+08:00,['437e36ab9a619d5fbfe7b40a51cb17682fa19423'],0,1,1,13384894,1,,,,8787
396a6c70cfaa7da80f5951ac421af0467b7e59d6,1,honma,2015-05-26 23:21:27+08:00,['57faf86863b879e7fcd6e6cee0e81d6853a0c35a'],0,1,1,13384895,1,,,,8787
501faa2353fd0a88821a7ca1a24897a288751a68,0,honma,2015-05-26 23:21:27+08:00,['396a6c70cfaa7da80f5951ac421af0467b7e59d6'],17,14,31,13384926,1,,,,8787
486df6335b4c5f13445c124868d6c4002c0c3acd,0,honma,2015-05-26 23:21:27+08:00,['501faa2353fd0a88821a7ca1a24897a288751a68'],2,2,4,13384930,1,,,,8787
ec31ce8db8d0da746e1815a473ec77c59544b790,1,honma,2015-05-26 23:21:27+08:00,['486df6335b4c5f13445c124868d6c4002c0c3acd'],0,4,4,13384934,2,,,,8787
37e4c61a53b4b1ca2a88e5c4420517658269d25d,0,honma,2015-05-26 23:21:27+08:00,['ec31ce8db8d0da746e1815a473ec77c59544b790'],1478,1323,2801,13387735,9,,,,8787
9c9ef7e3e3260e7602a2364556df61d7ef42e1d4,0,honma,2015-05-26 23:21:27+08:00,['37e4c61a53b4b1ca2a88e5c4420517658269d25d'],0,2545,2545,13390280,13,,,,8800
b9fbbccdd7644b63ffb4c986be0296714e46d2d9,0,honma,2015-05-26 23:21:27+08:00,['9c9ef7e3e3260e7602a2364556df61d7ef42e1d4'],1,1,2,13390282,1,,,,8800
c97dc15cdf66750bcf9c460a4caad6f676930df0,0,honma,2015-05-26 23:21:27+08:00,['b9fbbccdd7644b63ffb4c986be0296714e46d2d9'],12,11,23,13390305,7,,,,8800
bdca923505c72c4189e5b5ea61ba85a54e558011,0,honma,2015-05-26 23:21:28+08:00,['c97dc15cdf66750bcf9c460a4caad6f676930df0'],2,0,2,13390307,1,,,,8800
5e6e29d67780d1ca39a4a042825d6ed68271bda9,1,honma,2015-05-26 23:21:28+08:00,['bdca923505c72c4189e5b5ea61ba85a54e558011'],241,295,536,13390843,20,0.285714286,1,1,8803
7b2361fac9efe1d08cbe70176d5d2e055c720875,0,honma,2015-05-26 23:21:28+08:00,['5e6e29d67780d1ca39a4a042825d6ed68271bda9'],5,4,9,13390852,1,,,,8803
5b54141b98f3967f47e79b35786514bd6abcb905,1,honma,2015-05-26 23:21:28+08:00,['7b2361fac9efe1d08cbe70176d5d2e055c720875'],1,8,9,13390861,1,,,,8803
cba41bc4317a2fc577532bbfa25893483a2eb3e1,0,honma,2015-05-26 23:21:28+08:00,['5b54141b98f3967f47e79b35786514bd6abcb905'],4,7,11,13390872,1,0,1,1,8803
439fdcdba152d4ed26f55e42cbd741408a209a04,0,honma,2015-05-26 23:25:24+08:00,['cba41bc4317a2fc577532bbfa25893483a2eb3e1'],0,3,3,13390875,2,,,,8803
12aad6154fb909ec60bf3a7a0218e9c889669d6a,0,honma,2015-05-26 23:56:41+08:00,['439fdcdba152d4ed26f55e42cbd741408a209a04'],285,84,369,13391244,6,0.350649351,0.935064935,0.519480519,8803
fa4193b467966493d98fbfd2f4af44b52728293c,1,honma,2015-05-27 11:02:57+08:00,['12aad6154fb909ec60bf3a7a0218e9c889669d6a'],3,3,6,13391250,1,,,,8803
c7b8aac5ba99f647211b9012b268935b6b188075,1,qianhao.zhou,2015-05-27 11:37:44+08:00,['fa4193b467966493d98fbfd2f4af44b52728293c'],84,285,369,13391619,6,0.649350649,0.064935065,0.480519481,8804
b0bdeddb4bda9a834f7e5cef8b60a9b97e358323,0,qianhao.zhou,2015-05-27 11:37:44+08:00,['c7b8aac5ba99f647211b9012b268935b6b188075'],1,1,2,13391621,1,,,,8804
fc3ecf3b8baa8a39987d38ed623d75a09c621036,1,shaofengshi,2015-05-27 12:07:56+08:00,['b0bdeddb4bda9a834f7e5cef8b60a9b97e358323'],1,481,482,13392103,2,0.783216783,1,0.885780886,8805
a0dfb8048a8eb9ab647a21ee42bfcff4103e35d2,0,shaofengshi,2015-05-27 12:07:56+08:00,['fc3ecf3b8baa8a39987d38ed623d75a09c621036'],3,6,9,13392112,2,0,0,1,8805
bc860ebd35e3b78b506e68a7dcbfd742443530bf,0,shaofengshi,2015-05-27 12:12:05+08:00,['a0dfb8048a8eb9ab647a21ee42bfcff4103e35d2'],24,0,24,13392136,2,,,,8805
751f601f21e2f155d0494e56f2f1e06c1accccdd,0,shaofengshi,2015-05-27 12:13:46+08:00,['bc860ebd35e3b78b506e68a7dcbfd742443530bf'],4,6,10,13392146,2,1,1,1,8805
6af47a8f017b562a2b1f86127ce5126dc8ed0685,0,shaofengshi,2015-05-27 12:14:58+08:00,['751f601f21e2f155d0494e56f2f1e06c1accccdd'],1,1,2,13392148,1,,,,8805
be10f0b004fcdf4f5e821b7b0b8ba28e2fedac68,0,shaofengshi,2015-05-27 12:14:58+08:00,['6af47a8f017b562a2b1f86127ce5126dc8ed0685'],0,43,43,13392191,1,,,,8806
056dcd339006b5e1618901c0c7d9a24ac145c7b8,0,shaofengshi,2015-05-27 12:15:02+08:00,['be10f0b004fcdf4f5e821b7b0b8ba28e2fedac68'],0,0,0,13392191,1,,,,8806
d99898413093bcf5e61bed7e062b929cfad638f8,1,shaofengshi,2015-05-27 12:17:01+08:00,['056dcd339006b5e1618901c0c7d9a24ac145c7b8'],3,126,129,13392320,7,,,,8806
938ca40fddc969b70ec30d60e018d58eafc00969,1,shaofengshi,2015-05-27 12:19:28+08:00,['d99898413093bcf5e61bed7e062b929cfad638f8'],278,3652,3930,13396250,204,0.585365854,0,0,8806
55730af5d8390238b654ffac2a81a782566549bb,1,shaofengshi,2015-05-27 12:20:29+08:00,['938ca40fddc969b70ec30d60e018d58eafc00969'],1611,1613,3224,13399474,30,0.833333333,1,0.666666667,8806
ab89a5e8bde433e98bd9cfa15d1493d3e8bde6d3,1,shaofengshi,2015-05-27 12:20:54+08:00,['55730af5d8390238b654ffac2a81a782566549bb'],18,332,350,13399824,14,,,,8806
3200a63fd330c8b38d4b329f44f77a2104613533,0,shaofengshi,2015-05-27 12:21:13+08:00,['ab89a5e8bde433e98bd9cfa15d1493d3e8bde6d3'],3420,3386,6806,13406630,201,,,,8806
a75ce16c45c5b39b17d9d4b72517e0f234855e8e,0,shaofengshi,2015-05-27 12:22:34+08:00,['3200a63fd330c8b38d4b329f44f77a2104613533'],0,2,2,13406632,1,0,0,1,8806
d8a3627c3020edd441cacc424472ec612b95417e,1,shaofengshi,2015-05-27 12:23:44+08:00,['a75ce16c45c5b39b17d9d4b72517e0f234855e8e'],35,40,75,13406707,6,1,0,1,8806
c74ed208f977f32037fdcffa96dcb5defe110820,0,shaofengshi,2015-05-27 12:23:44+08:00,['d8a3627c3020edd441cacc424472ec612b95417e'],0,9,9,13406716,1,,,,8806
7484dab03ecfaceabfb856dfe47141cb1f85115a,1,shaofengshi,2015-05-27 12:23:45+08:00,['c74ed208f977f32037fdcffa96dcb5defe110820'],0,10,10,13406726,1,,,,8806
18a650d51b99fe1459c904c660db689d1f455971,1,shaofengshi,2015-05-27 12:23:45+08:00,['7484dab03ecfaceabfb856dfe47141cb1f85115a'],68,8,76,13406802,2,,,,8806
542d8151bda490420a03170b673330d137f49037,0,shaofengshi,2015-05-27 12:23:45+08:00,['18a650d51b99fe1459c904c660db689d1f455971'],128,69,197,13406999,8,,,,8806
25f66e8d5b96db064444f83e3b1d7c1cefbf5c2f,1,shaofengshi,2015-05-27 12:24:07+08:00,['542d8151bda490420a03170b673330d137f49037'],1,31,32,13407031,1,,,,8806
3bdf991eca0c852daa7c9cba4f558ed79c9037c3,0,shaofengshi,2015-05-27 12:24:08+08:00,['25f66e8d5b96db064444f83e3b1d7c1cefbf5c2f'],0,18,18,13407049,1,,,,8806
4f7bf2c6d7210934e651e6ef35f01fa6c3a0219f,1,shaofengshi,2015-05-27 12:24:08+08:00,['3bdf991eca0c852daa7c9cba4f558ed79c9037c3'],0,22,22,13407071,2,,,,8807
8eeeac696e041ab653a06d272b35460a95743fc6,0,shaofengshi,2015-05-27 12:24:08+08:00,['4f7bf2c6d7210934e651e6ef35f01fa6c3a0219f'],1,1,2,13407073,1,,,,8807
ef56fb64a8f201b8aea396cf5035e554b795c8c6,0,shaofengshi,2015-05-27 12:24:08+08:00,['8eeeac696e041ab653a06d272b35460a95743fc6'],1,1,2,13407075,1,,,,8807
204dd727ec692b0bb48e5a5748d3315290744fed,0,shaofengshi,2015-05-27 12:24:08+08:00,['ef56fb64a8f201b8aea396cf5035e554b795c8c6'],6,14,20,13407095,4,0,0,0,8807
f3c4161a6319469c217066482c6377576371dd92,1,shaofengshi,2015-05-27 12:24:37+08:00,['204dd727ec692b0bb48e5a5748d3315290744fed'],17,25,42,13407137,1,,,,8807
fd5dfe78dc08388b020e05f0d63518b0816a76d0,1,shaofengshi,2015-05-27 12:24:37+08:00,['f3c4161a6319469c217066482c6377576371dd92'],0,1,1,13407138,1,0,1,1,8807
2453d4e937dc4ad1a5633cc8528cf306a77a5ff8,0,shaofengshi,2015-05-27 12:24:38+08:00,['fd5dfe78dc08388b020e05f0d63518b0816a76d0'],16,12,28,13407166,1,,,,8807
3f07867c7eeeed808b6669617011f4ad8aef5141,1,shaofengshi,2015-05-27 12:24:38+08:00,['2453d4e937dc4ad1a5633cc8528cf306a77a5ff8'],5,13,18,13407184,2,1,0.666666667,1,8807
4de54ec4c6be3f091f506612e9e728ac0b652155,0,shaofengshi,2015-05-27 12:24:38+08:00,['3f07867c7eeeed808b6669617011f4ad8aef5141'],1,2,3,13407187,1,,,,8807
aa4b1c99aa8fb5fa91e0021d0e4be28f5643b399,0,shaofengshi,2015-05-27 12:24:38+08:00,['4de54ec4c6be3f091f506612e9e728ac0b652155'],1,1,2,13407189,1,,,,8807
dbda6d109f520c34e173a6e1bb9ecc35d6f7aeeb,0,shaofengshi,2015-05-27 12:24:38+08:00,['aa4b1c99aa8fb5fa91e0021d0e4be28f5643b399'],3,7,10,13407199,1,,,,8807
a61f2afaadc68386e4ea59fbc5e9f5b0a4fe8351,0,shaofengshi,2015-05-27 12:25:28+08:00,['dbda6d109f520c34e173a6e1bb9ecc35d6f7aeeb'],0,226,226,13407425,4,,,,8811
ab3e8cf5fc389dada09a1beab344650094f3d669,0,shaofengshi,2015-05-27 12:26:14+08:00,['a61f2afaadc68386e4ea59fbc5e9f5b0a4fe8351'],488,485,973,13408398,12,,,,8811
a733082ac0dae1dc1762f787abe83570c96fc396,0,shaofengshi,2015-05-27 12:26:14+08:00,['ab3e8cf5fc389dada09a1beab344650094f3d669'],1,4,5,13408403,2,,,,8811
e2f8dda91e4d879f632dda4a477e43097287738d,0,shaofengshi,2015-05-27 12:26:14+08:00,['a733082ac0dae1dc1762f787abe83570c96fc396'],0,5,5,13408408,2,,,,8811
ab01d4a6b480cc4c3f63869c458d52f485b2abaa,0,shaofengshi,2015-05-27 12:26:14+08:00,['e2f8dda91e4d879f632dda4a477e43097287738d'],8,0,8,13408416,1,,,,8811
e1d4d33bb712ee0f0eacbff37ae7885896f4aae1,0,shaofengshi,2015-05-27 12:26:14+08:00,['ab01d4a6b480cc4c3f63869c458d52f485b2abaa'],9,9,18,13408434,9,,,,8811
14ecb357e685c15448350d90ef6febb2123fd266,0,shaofengshi,2015-05-27 12:26:14+08:00,['e1d4d33bb712ee0f0eacbff37ae7885896f4aae1'],13,13,26,13408460,12,,,,8811
d8c418d034edd97ac0be6082a21b69a6a94b6c27,0,shaofengshi,2015-05-27 12:26:15+08:00,['14ecb357e685c15448350d90ef6febb2123fd266'],13,13,26,13408486,12,,,,8811
c4cd04c4753a55b4d81d56728b901113aa50e3e2,0,shaofengshi,2015-05-27 12:26:15+08:00,['d8c418d034edd97ac0be6082a21b69a6a94b6c27'],11,11,22,13408508,11,,,,8811
5abc6acd8927ee1dd9fc9d9f19c857eaae20418a,0,shaofengshi,2015-05-27 12:26:15+08:00,['c4cd04c4753a55b4d81d56728b901113aa50e3e2'],1,1,2,13408510,1,,,,8811
26209c7395ce90f80a2b0ac912d8e57d7d02c42a,0,shaofengshi,2015-05-27 12:26:15+08:00,['5abc6acd8927ee1dd9fc9d9f19c857eaae20418a'],13,13,26,13408536,12,,,,8811
8125dc871fb8a898e5ca79175d9969ff410e1de8,0,shaofengshi,2015-05-27 12:26:15+08:00,['26209c7395ce90f80a2b0ac912d8e57d7d02c42a'],13,13,26,13408562,12,,,,8811
e2074440ea187d814e6e696f640971387a7fefba,0,shaofengshi,2015-05-27 12:26:15+08:00,['8125dc871fb8a898e5ca79175d9969ff410e1de8'],0,73,73,13408635,1,,,,8812
2387e739cfc4bc04ef3524e2eebe67d6b192b946,0,shaofengshi,2015-05-27 12:26:15+08:00,['e2074440ea187d814e6e696f640971387a7fefba'],0,33,33,13408668,1,,,,8813
59bfa48ee0cf262c00c81093b52cb0b7203dde46,0,shaofengshi,2015-05-27 12:26:38+08:00,['2387e739cfc4bc04ef3524e2eebe67d6b192b946'],0,2,2,13408670,1,,,,8813
25272c02b82c6b02d772995206692ec41264810c,0,shaofengshi,2015-05-27 12:33:54+08:00,['59bfa48ee0cf262c00c81093b52cb0b7203dde46'],158,161,319,13408989,2,0,0,0.071428571,8813
004c4817c11c3e582ebcf621d088a9c266e8da7d,1,shaofengshi,2015-05-27 15:01:22+08:00,['20c4482e0643df13b6fdf764ff585477c69650b8'],81,2483,2564,13411553,76,0.636205396,0.696257615,0.554395126,8815
6c3235895efbb31b41b9cedc8a66cc3dae9415c9,0,honma,2015-05-27 16:24:31+08:00,['25272c02b82c6b02d772995206692ec41264810c'],1,1,2,13411555,1,,,,8815
e8fe5a96450bcb9ef7409ac4b4dc78a65dad3cbd,0,Zhong Jian,2015-05-27 17:29:45+08:00,['6c3235895efbb31b41b9cedc8a66cc3dae9415c9'],226,192,418,13411973,22,0.571428571,0,0.571428571,8815
bf5b004e777c3cc7fb35f8adaf81ab9a4e085386,0,honma,2015-05-27 18:11:47+08:00,['e8fe5a96450bcb9ef7409ac4b4dc78a65dad3cbd'],17,12,29,13412002,1,1,1,1,8815
03e93e26723f662b5d3add1fa2160359f6dcb8bf,0,Luke Han,2015-05-27 18:51:01+08:00,['004c4817c11c3e582ebcf621d088a9c266e8da7d'],319,16,335,13412337,11,,,,8815
eccbe687f7a9c08bc605049810cdae5530a7bc1d,0,Luke Han,2015-05-27 18:51:02+08:00,['03e93e26723f662b5d3add1fa2160359f6dcb8bf'],0,4604,4604,13416941,131,,,,8946
b763017b5e228be372f84292df459a70d0450f4b,0,Li Yang,2015-05-27 18:57:25+08:00,['bf5b004e777c3cc7fb35f8adaf81ab9a4e085386'],123,55,178,13417119,4,0.347826087,1,0.956521739,8946
4e084ba5bbf4c5103c16848ef30f255d0b497092,0,honma,2015-05-27 19:35:17+08:00,['b763017b5e228be372f84292df459a70d0450f4b'],3,5,8,13417127,1,1,1,1,8946
e69867082ec28905bfd77c4674513e9d350f0a73,0,honma,2015-05-27 19:55:36+08:00,['4e084ba5bbf4c5103c16848ef30f255d0b497092'],1,1,2,13417129,1,,,,8946
fbbf443aaecef6d1e46b4e9bdb87b2fd5c7d1d23,0,Luke Han,2015-05-27 20:02:24+08:00,['eccbe687f7a9c08bc605049810cdae5530a7bc1d'],215,0,215,13417344,3,,,,8946
31d5c35fe7082e0b151e21563212898dc5f29d9a,0,Zhong Jian,2015-05-27 20:33:37+08:00,['e69867082ec28905bfd77c4674513e9d350f0a73'],2,2,4,13417348,1,,,,8946
83d9341be6d3fe7dffda69d96ae49d7a2c16ccab,0,shaofengshi,2015-05-27 21:01:06+08:00,['fbbf443aaecef6d1e46b4e9bdb87b2fd5c7d1d23'],1535,1263,2798,13420146,12,,,,8946
cf459019fe45d7f9beada54344919c2af9d504cc,0,Zhong Jian,2015-05-27 21:24:37+08:00,['31d5c35fe7082e0b151e21563212898dc5f29d9a'],481,0,481,13420627,1,0.220417633,0,0.118329466,8946
f49d25790963adbc6d34a1320f6779a0c6bf86d2,0,honma,2015-05-28 11:23:31+08:00,['cf459019fe45d7f9beada54344919c2af9d504cc'],74,212,286,13420913,9,,,,8946
099fb4eb9ff230b1181ae2ab7ffb0a5bf7636bb4,0,honma,2015-05-28 12:44:00+08:00,['f49d25790963adbc6d34a1320f6779a0c6bf86d2'],1,1,2,13420915,1,,,,8946
b5050f6ca84a43188d1776950c67d03c8fbb1be0,0,shaofengshi,2015-05-28 17:29:41+08:00,['83d9341be6d3fe7dffda69d96ae49d7a2c16ccab'],73,211,284,13421199,9,,,,8946
ce4bf024dbaa46a19eb73a2a486e33b1e945c681,1,Zhong Jian,2015-05-28 18:18:20+08:00,['099fb4eb9ff230b1181ae2ab7ffb0a5bf7636bb4'],1,1,2,13421201,1,,,,8946
2bcd3f275a493bf4e5f2b01763aa685067b5501c,0,Luke Han,2015-05-28 21:00:47+08:00,['b5050f6ca84a43188d1776950c67d03c8fbb1be0'],200,116,316,13421517,30,,,,8947
d6d6b6058a499df95c2d75eafcf45f5b30e9e3c0,1,Li Yang,2015-05-28 21:41:08+08:00,['ce4bf024dbaa46a19eb73a2a486e33b1e945c681'],59,960,1019,13422536,7,0.520134228,0.758389262,0.850671141,8951
436ec747bb7f76e9289116a7d9b7f04c4cdd8ea0,0,Luke Han,2015-05-29 10:26:42+08:00,['2bcd3f275a493bf4e5f2b01763aa685067b5501c'],3,12,15,13422551,2,,,,8951
6f5b3457b389a7b6749027f1e2bff3e896777aa1,0,Zhong Jian,2015-05-29 11:11:54+08:00,['d6d6b6058a499df95c2d75eafcf45f5b30e9e3c0'],103,1,104,13422655,3,0,0,0,8951
d2d88f79763f9ffd72e505fe114eb88626c991a3,1,shaofengshi,2015-05-29 11:33:05+08:00,['6f5b3457b389a7b6749027f1e2bff3e896777aa1'],14,51,65,13422720,4,0,0,1,8952
85c443c0488f3205e273229ed0f6d515d7c1006c,1,shaofengshi,2015-05-29 12:54:52+08:00,['b5050f6ca84a43188d1776950c67d03c8fbb1be0'],13,48,61,13422781,4,0,0,1,8953
0957e32af0b83de0fca8bde5810eb566192e7ed8,0,shaofengshi,2015-05-29 12:56:32+08:00,"['85c443c0488f3205e273229ed0f6d515d7c1006c', '436ec747bb7f76e9289116a7d9b7f04c4cdd8ea0']",201,126,327,13423108,31,,,,8953
4a2744e5d05977d6ab2c786f9ab41bdfc4085e61,1,honma,2015-05-29 15:44:25+08:00,['d2d88f79763f9ffd72e505fe114eb88626c991a3'],174,746,920,13424028,20,0.361930295,0.801608579,0.747989276,8956
8651381306dc98c073e63f508c75fb917dea8145,1,honma,2015-05-29 15:44:25+08:00,['4a2744e5d05977d6ab2c786f9ab41bdfc4085e61'],12,10,22,13424050,5,,,,8956
5ecae3f67b8c313ddf5e11e589d5c2dc46066041,0,honma,2015-05-29 15:44:25+08:00,['8651381306dc98c073e63f508c75fb917dea8145'],4,5,9,13424059,1,1,1,1,8956
de4367e82e3669ad08685b6dd33ad101447dbb6d,0,Zhong Jian,2015-05-29 16:25:24+08:00,['0957e32af0b83de0fca8bde5810eb566192e7ed8'],2,2,4,13424063,1,,,,8956
b81ff280350f6bb52c914ff1e785242e9edfc762,0,Li Yang,2015-05-29 17:57:26+08:00,['5ecae3f67b8c313ddf5e11e589d5c2dc46066041'],36,269,305,13424368,17,0.684563758,0.993288591,0.979865772,8957
3b814076f7d54102bee565c4707d78f293e7e8a8,1,Li Yang,2015-05-30 07:30:53+08:00,['b81ff280350f6bb52c914ff1e785242e9edfc762'],88,89,177,13424545,7,0,0,0,8957
0bbfd48f571d64c388ec1ddc0906fd5fcfee3908,1,Li Yang,2015-05-30 20:51:28+08:00,['3b814076f7d54102bee565c4707d78f293e7e8a8'],881,292,1173,13425718,13,0.805333333,0.706666667,0.458666667,8957
6ae05980e2f6ab95005ff920cff17eaa712a3f9c,0,Luke Han,2015-05-31 19:07:00+08:00,['b2ffa3bd0791785e2d8c13fc3054de04f3e1701b'],1,1,2,13425720,1,,,,8957
3d3cf17cf8f6a4934d0d88a51dd5e113fe27c85f,0,Luke Han,2015-05-31 19:08:10+08:00,['6ae05980e2f6ab95005ff920cff17eaa712a3f9c'],11,137,148,13425868,12,,,,8958
78bad6a2c36cb5e24ca79e898fca8c7ce45c2cfc,0,Luke Han,2015-05-31 19:09:20+08:00,['3d3cf17cf8f6a4934d0d88a51dd5e113fe27c85f'],0,0,0,13425868,1,,,,8958
d6cd5d4895997336e01f4b80cdaa70e3d43af164,0,Luke Han,2015-05-31 20:51:33+08:00,['78bad6a2c36cb5e24ca79e898fca8c7ce45c2cfc'],0,6,6,13425874,1,,,,8959
b8cc20fe28bfa5f85d0bf7f7f5cd3c17a7d94525,1,Li Yang,2015-05-31 21:54:52+08:00,['0bbfd48f571d64c388ec1ddc0906fd5fcfee3908'],218,343,561,13426435,11,0.15625,0.53125,0.989583333,8961
9b0ec50038b1b972e9d72dffaa93430a85c4dc8c,0,Luke Han,2015-05-31 23:13:41+08:00,['d6cd5d4895997336e01f4b80cdaa70e3d43af164'],52,206,258,13426693,2,,,,8961
61ebc1c13114480de7bb8551aee6a2c02b3042bd,0,Luke Han,2015-06-01 00:07:54+08:00,['9b0ec50038b1b972e9d72dffaa93430a85c4dc8c'],13,13,26,13426719,12,,,,8961
8307855d6dd9f200cde848ae3a514c1e76bb46fc,0,Luke Han,2015-06-01 00:11:00+08:00,['61ebc1c13114480de7bb8551aee6a2c02b3042bd'],13,13,26,13426745,12,,,,8961
43202e2bfb5f82dff47a0791f1e2e7c734b778e5,1,Li Yang,2015-06-01 11:28:34+08:00,['b8cc20fe28bfa5f85d0bf7f7f5cd3c17a7d94525'],0,739,739,13427484,2,0.342158859,0.631364562,0.759674134,8963
81fbc0942cdc1f7c6868158aec8f91615aecc9f9,0,shaofengshi,2015-06-01 13:30:57+08:00,['43202e2bfb5f82dff47a0791f1e2e7c734b778e5'],2,2,4,13427488,2,,,,8963
82b40966d7ac64c16dfb79701b17305b94024f1e,0,shaofengshi,2015-06-01 13:32:06+08:00,['81fbc0942cdc1f7c6868158aec8f91615aecc9f9'],0,2,2,13427490,1,,,,8963
ca463becf7df23db38e9d930bcd6922c9eaaec2e,1,shaofengshi,2015-06-01 13:32:06+08:00,['82b40966d7ac64c16dfb79701b17305b94024f1e'],16,141,157,13427647,6,0.93877551,1,0.612244898,8964
4c8a8856dbfabdccb066232bb8deea28079585b6,0,shaofengshi,2015-06-01 14:23:37+08:00,['ca463becf7df23db38e9d930bcd6922c9eaaec2e'],2,1,3,13427650,1,0,0,1,8964
0815bae5b4fda9cd567f1d59f519194be6d68040,0,Li Yang,2015-06-01 15:17:28+08:00,['4c8a8856dbfabdccb066232bb8deea28079585b6'],1,4,5,13427655,2,0,1,1,8964
416522423c1fecf577e0d1b69516dc17cf960fb7,1,Li Yang,2015-06-01 16:18:31+08:00,['0815bae5b4fda9cd567f1d59f519194be6d68040'],227,392,619,13428274,23,0.79245283,1,0.971698113,8965
c71021ec9281f546dc510fb54e16a680a41b7514,1,shaofengshi,2015-06-01 16:49:50+08:00,['416522423c1fecf577e0d1b69516dc17cf960fb7'],56,259,315,13428589,6,0.460674157,1,0.561797753,8967
c60b08ddda4897af84d8eb9e0a062d7d7fffba69,0,Li Yang,2015-06-01 17:05:57+08:00,['c71021ec9281f546dc510fb54e16a680a41b7514'],3,0,3,13428592,1,1,0,0,8967
35879a6a66272d8d567feef62a22280478cdbdbe,0,shaofengshi,2015-06-01 17:12:54+08:00,['de4367e82e3669ad08685b6dd33ad101447dbb6d'],2,2,4,13428596,2,,,,8967
a18ab6f53675145ea14c8b3efb01433f3f3d8a96,1,shaofengshi,2015-06-01 17:28:38+08:00,['c60b08ddda4897af84d8eb9e0a062d7d7fffba69'],2,3,5,13428601,2,,,,8967
6de3f4d6af56d15f2980a5d74a0012cd85eb4e92,1,honma,2015-06-01 17:33:49+08:00,['a18ab6f53675145ea14c8b3efb01433f3f3d8a96'],238,334,572,13429173,29,0.730769231,1,0,8971
6a4d54d556b64bd8de40c770834bda710028b633,0,honma,2015-06-01 19:29:36+08:00,['6de3f4d6af56d15f2980a5d74a0012cd85eb4e92'],1,5,6,13429179,1,0,1,1,8971
beb467b650d071d7f9e301cb9e6851fc2e7b5808,1,Li Yang,2015-06-01 21:19:18+08:00,['6a4d54d556b64bd8de40c770834bda710028b633'],38,226,264,13429443,11,1,1,1,8972
9014306fff4a75f5d72726bdc2271c17b06df840,0,qianhao.zhou,2015-06-02 00:54:58+08:00,['beb467b650d071d7f9e301cb9e6851fc2e7b5808'],11,11,22,13429465,2,,,,8972
f5c836c0c614ce699a80ef2a6528df4d74ba839a,1,Li Yang,2015-06-02 07:29:06+08:00,['9014306fff4a75f5d72726bdc2271c17b06df840'],86,548,634,13430099,8,0.6484375,0.8828125,0.94921875,8974
e19f4d5f279f92459ba9aa703020aa89541950cf,0,qianhao.zhou,2015-06-02 10:36:30+08:00,['f5c836c0c614ce699a80ef2a6528df4d74ba839a'],171,178,349,13430448,12,1,1,0,8978
d9d6dd38b16fde8388fde8f1d3702961c3576f51,1,Li Yang,2015-06-02 10:47:38+08:00,['e19f4d5f279f92459ba9aa703020aa89541950cf'],0,1,1,13430449,1,,,,8978
1bc978722b2436336957c44994db9bb4f2423e79,0,qianhao.zhou,2015-06-02 11:26:35+08:00,['d9d6dd38b16fde8388fde8f1d3702961c3576f51'],4,5,9,13430458,1,,,,8978
c0d5b63128e22aea4cb293f3cc0536d392136240,0,honma,2015-06-02 14:14:17+08:00,['1bc978722b2436336957c44994db9bb4f2423e79'],40,36,76,13430534,7,,,,8978
9b7ce3ad11ed3add596031bbe82874ea8675582c,0,honma,2015-06-02 14:18:34+08:00,['c0d5b63128e22aea4cb293f3cc0536d392136240'],7,59,66,13430600,3,0.325581395,0,0.976744186,8978
073d7e7d39606c677c6d71d5953d15066325f7fd,1,shaofengshi,2015-06-02 16:03:01+08:00,['9b7ce3ad11ed3add596031bbe82874ea8675582c'],104,154,258,13430858,5,0.166666667,0,0.833333333,8979
96bce78c58622b379d8d0bdc956d0db859184ff8,1,shaofengshi,2015-06-02 16:04:03+08:00,['073d7e7d39606c677c6d71d5953d15066325f7fd'],51,85,136,13430994,13,0,0,0,8979
e8ac84c28ece7fbc9cfce7112b18344409c71980,1,honma,2015-06-02 16:46:40+08:00,['96bce78c58622b379d8d0bdc956d0db859184ff8'],67,51,118,13431112,19,0.25,0.25,1,8979
25905114e9282b9ed8903720aea7e159f1ee685a,1,honma,2015-06-02 17:17:47+08:00,['e8ac84c28ece7fbc9cfce7112b18344409c71980'],1,12,13,13431125,2,0,0,1,8979
d5868ee164202310425b35f119bbde8beed2ec94,1,shaofengshi,2015-06-02 17:52:33+08:00,['25905114e9282b9ed8903720aea7e159f1ee685a'],11,10,21,13431146,4,0,,,8979
671774db80b71637911625c300f5d5a8495b7c33,0,Li Yang,2015-06-02 17:57:16+08:00,['d5868ee164202310425b35f119bbde8beed2ec94'],150845,139314,290159,13721305,3,,,,8979
12e483f49864e46e938343e74c4bdbb635f48537,0,Li Yang,2015-06-02 18:09:59+08:00,['35879a6a66272d8d567feef62a22280478cdbdbe'],150845,139314,290159,14011464,3,,,,8979
5b5981a8dc112ee80cf19cd886aa800f96465ed5,0,Luke Han,2015-06-02 18:12:20+08:00,['12e483f49864e46e938343e74c4bdbb635f48537'],0,0,0,14011464,2,,,,8979
db72eb319a778b331ec3e2f3c4a660748a30be75,0,Luke Han,2015-06-02 18:12:20+08:00,['5b5981a8dc112ee80cf19cd886aa800f96465ed5'],45,12,57,14011521,3,,,,8979
77141add1dc9c289dda79824d5b3cfddcd50d923,0,Luke Han,2015-06-02 18:12:21+08:00,['db72eb319a778b331ec3e2f3c4a660748a30be75'],28,994,1022,14012543,25,0.448275862,1,1,8994
4f47a88d8aff530344124dc13d6912a2a1bd4260,0,Luke Han,2015-06-02 18:15:40+08:00,['77141add1dc9c289dda79824d5b3cfddcd50d923'],12,12,24,14012567,12,,,,8994
e154abfe631f4cc85e79ee5ac887a953177285d3,0,Luke Han,2015-06-02 18:15:40+08:00,['4f47a88d8aff530344124dc13d6912a2a1bd4260'],13,13,26,14012593,12,,,,8994
0fd3492c4328d70f7bf464bcf327bed80512f1d3,0,Luke Han,2015-06-02 18:15:41+08:00,['e154abfe631f4cc85e79ee5ac887a953177285d3'],13,13,26,14012619,12,,,,8994
801f03c9ae65aef7d1c6238e01f9e8adaf450a32,0,Luke Han,2015-06-02 18:15:41+08:00,['0fd3492c4328d70f7bf464bcf327bed80512f1d3'],12,12,24,14012643,12,,,,8994
88a3f3b1a2851db0a2c43acaaef9c92c8803a09b,0,Luke Han,2015-06-02 18:15:41+08:00,['801f03c9ae65aef7d1c6238e01f9e8adaf450a32'],7,7,14,14012657,2,,,,8994
25755a4fa4274aa5f718f6d11095e0d37a7384dc,0,Luke Han,2015-06-02 18:15:41+08:00,['88a3f3b1a2851db0a2c43acaaef9c92c8803a09b'],10,0,10,14012667,1,,,,8994
ad81aa75b028b1c630221aa465e7cab8f2e67b12,0,Luke Han,2015-06-02 18:15:41+08:00,['25755a4fa4274aa5f718f6d11095e0d37a7384dc'],13,13,26,14012693,12,,,,8994
b67dea6d1a7900252d3a1a561fd8891eba05fe74,0,Luke Han,2015-06-02 18:15:41+08:00,['ad81aa75b028b1c630221aa465e7cab8f2e67b12'],13,13,26,14012719,12,,,,8994
9a4591301a564cb0cd503a4ec0a8cbf9cbfbba77,0,Luke Han,2015-06-02 18:15:41+08:00,['b67dea6d1a7900252d3a1a561fd8891eba05fe74'],1,1,2,14012721,1,,,,8994
b18b379f44a99e394ea30273e4d6f0f6cb35eab5,0,Luke Han,2015-06-02 18:15:41+08:00,['9a4591301a564cb0cd503a4ec0a8cbf9cbfbba77'],11,137,148,14012869,12,,,,8995
4adfe8c14fd41e43313eaa7048a8cef9c4b08903,0,Luke Han,2015-06-02 18:15:41+08:00,['b18b379f44a99e394ea30273e4d6f0f6cb35eab5'],0,0,0,14012869,1,,,,8995
30c6ca2721c863577c99d99e3925852821cd9ac6,0,Luke Han,2015-06-02 18:15:41+08:00,['4adfe8c14fd41e43313eaa7048a8cef9c4b08903'],0,6,6,14012875,1,,,,8996
c0b4ab0c70bcc39ee88a365c97648cd066da1b67,0,Luke Han,2015-06-02 18:15:41+08:00,['30c6ca2721c863577c99d99e3925852821cd9ac6'],52,206,258,14013133,2,,,,8996
9d6e691e622ee958083b1207a456fc5e122dbada,0,Luke Han,2015-06-02 18:15:41+08:00,['c0b4ab0c70bcc39ee88a365c97648cd066da1b67'],13,13,26,14013159,12,,,,8996
b814d044da003505ad5a5ed408c18d5ae0816f73,0,Luke Han,2015-06-02 18:15:41+08:00,['9d6e691e622ee958083b1207a456fc5e122dbada'],13,13,26,14013185,12,,,,8996
f1ad69f46ac8c01a174d1a7c11664b27f0eda32f,0,Luke Han,2015-06-02 18:15:41+08:00,['b814d044da003505ad5a5ed408c18d5ae0816f73'],21,29,50,14013235,1,,,,8996
13974f60af2a2b33233f96d069a8ffed4e713392,0,Luke Han,2015-06-02 18:15:42+08:00,['f1ad69f46ac8c01a174d1a7c11664b27f0eda32f'],80,87,167,14013402,12,,,,8996
a4fa1fc18e8eb0b98128ec1338095f7ea92c7f66,0,Luke Han,2015-06-02 18:15:42+08:00,['13974f60af2a2b33233f96d069a8ffed4e713392'],1,2,3,14013405,1,,,,8996
7309534de910a8701d44542937f7d3ef758f51e4,0,Luke Han,2015-06-02 18:15:42+08:00,['a4fa1fc18e8eb0b98128ec1338095f7ea92c7f66'],89,81,170,14013575,13,,,,8996
314b00ba1a613deca0100232db7a3fafdf1739e0,0,Luke Han,2015-06-02 18:15:42+08:00,['7309534de910a8701d44542937f7d3ef758f51e4'],18,17,35,14013610,13,,,,8996
3874576c456c431466e0ac06cbab26960f2f8f37,0,Luke Han,2015-06-02 18:25:12+08:00,"['314b00ba1a613deca0100232db7a3fafdf1739e0', '8307855d6dd9f200cde848ae3a514c1e76bb46fc']",2,8,10,14013620,2,,,,8996
c90e5cff2980b040c5c3f8fa947f876295328b24,0,Luke Han,2015-06-02 19:25:33+08:00,['3874576c456c431466e0ac06cbab26960f2f8f37'],0,19,19,14013639,2,,,,8996
622e775ad292adabd0b152101d8e6829035a2ae9,0,Luke Han,2015-06-02 19:33:01+08:00,['c90e5cff2980b040c5c3f8fa947f876295328b24'],0,3,3,14013642,1,,,,8996
9ff0bcea23599a5bd3cce751fa223538e212f560,0,Luke Han,2015-06-02 19:35:58+08:00,['622e775ad292adabd0b152101d8e6829035a2ae9'],1,1,2,14013644,1,,,,8996
7975a9e44777098cb9f0c6b70e4e027d323e968a,0,Luke Han,2015-06-02 19:38:56+08:00,['9ff0bcea23599a5bd3cce751fa223538e212f560'],1,1,2,14013646,1,,,,8996
54f54226629c8f619734d03373cfaaf7eda8e239,0,Luke Han,2015-06-02 19:46:56+08:00,['7975a9e44777098cb9f0c6b70e4e027d323e968a'],2,1,3,14013649,1,,,,8996
127d2c0a028b2fc2384dca88319ed58ee03b921f,0,Luke Han,2015-06-02 20:05:10+08:00,['54f54226629c8f619734d03373cfaaf7eda8e239'],4,1,5,14013654,3,,,,8996
c6ea7572f9253023a46fa730aa21976d10c6f3b8,0,Luke Han,2015-06-02 20:08:24+08:00,['127d2c0a028b2fc2384dca88319ed58ee03b921f'],1,1,2,14013656,2,,,,8996
f71ff2813332f50b6be881d6c4428db146eb8d5a,0,shaofengshi,2015-06-02 20:19:47+08:00,['671774db80b71637911625c300f5d5a8495b7c33'],5,38,43,14013699,3,1,1,1,8997
a6e24b91717bc2e4e01873e1ce062c67a7710115,0,Luke Han,2015-06-02 21:09:49+08:00,['c6ea7572f9253023a46fa730aa21976d10c6f3b8'],13,13,26,14013725,12,,,,8997
ae81f704c7fb286d0b7d335167fab885b1a98bf2,0,Luke Han,2015-06-02 21:10:33+08:00,['a6e24b91717bc2e4e01873e1ce062c67a7710115'],13,13,26,14013751,12,,,,8997
7471c509733d9e37a70d46f63ba70a467c49137f,0,shaofengshi,2015-06-02 22:17:00+08:00,['f71ff2813332f50b6be881d6c4428db146eb8d5a'],2,1,3,14013754,1,,,,8997
eb953298f3638008fffe8f8487084bab533609e6,0,honma,2015-06-02 22:25:55+08:00,['7471c509733d9e37a70d46f63ba70a467c49137f'],5,14,19,14013773,3,0,0.5,0.5,8997
bf89cf27acb9c6092d847d8cf7d6ccdd0cd8a6f6,1,honma,2015-06-02 22:25:55+08:00,['eb953298f3638008fffe8f8487084bab533609e6'],1,7,8,14013781,3,0,0.333333333,1,8997
9f3a877769ca72f420f721720a17277ff6d0f6e1,0,Li Yang,2015-06-03 09:46:52+08:00,['bf89cf27acb9c6092d847d8cf7d6ccdd0cd8a6f6'],74,210,284,14014065,11,0.747663551,0.514018692,0.990654206,8997
4471e2bec152f3c694ccbdb41c9de177d9caf6a3,1,shaofengshi,2015-06-03 10:46:24+08:00,['9f3a877769ca72f420f721720a17277ff6d0f6e1'],42,211,253,14014318,14,0.431372549,0.87254902,1,8998
e73b7fabac7acc4a0cf9eb4f64352a77e566440e,0,Li Yang,2015-06-03 13:57:14+08:00,['4471e2bec152f3c694ccbdb41c9de177d9caf6a3'],13,12,25,14014343,1,0,1,1,8998
3af8e1498077d64d681ba0d42d0defb153b50d73,0,Li Yang,2015-06-03 15:10:57+08:00,['e73b7fabac7acc4a0cf9eb4f64352a77e566440e'],2,6,8,14014351,1,0.5,1,1,8998
245a170870d06e09991e982ff7707994afb0e373,0,honma,2015-06-03 15:28:55+08:00,['3af8e1498077d64d681ba0d42d0defb153b50d73'],135,208,343,14014694,13,0.962962963,0,1,8999
3b64ec6969e111c972ca8584c1e0ac3070aa317e,0,honma,2015-06-03 17:07:30+08:00,['245a170870d06e09991e982ff7707994afb0e373'],12,10,22,14014716,9,,,,8999
3e01a9deba9f291aebc920ead11b684afdf2c486,0,honma,2015-06-03 17:33:50+08:00,['3b64ec6969e111c972ca8584c1e0ac3070aa317e'],4,4,8,14014724,3,,,,8999
90f33a3c6bd4a3395fd05250bf9f543d61dbb672,0,qianhao.zhou,2015-06-03 18:01:33+08:00,['3e01a9deba9f291aebc920ead11b684afdf2c486'],187,257,444,14015168,11,1,1,0.869565217,9001
da33c161961db8f7782a8eb0ae2934316042e9c9,0,Zhong Jian,2015-06-03 18:11:05+08:00,['90f33a3c6bd4a3395fd05250bf9f543d61dbb672'],2,9,11,14015179,1,1,0,1,9001
fd286c3e54b091ad13c5bec4fd7388183fd328aa,1,Zhong Jian,2015-06-03 18:13:47+08:00,['da33c161961db8f7782a8eb0ae2934316042e9c9'],85,91,176,14015355,2,1,1,1,9001
fcc544e8f79dc288ca4b9baa72271bb6334baf3d,1,shaofengshi,2015-06-04 10:19:49+08:00,['fd286c3e54b091ad13c5bec4fd7388183fd328aa'],3,3,6,14015361,1,,,,9001
de2ec3815098c009df17f20611ffcaf5ca9d0906,0,honma,2015-06-04 10:37:15+08:00,['fcc544e8f79dc288ca4b9baa72271bb6334baf3d'],19,31,50,14015411,3,1,0.833333333,1,9001
dbae8e8a97d148093830b85070b1b1a2da4bce99,0,qianhao.zhou,2015-06-04 10:40:07+08:00,['de2ec3815098c009df17f20611ffcaf5ca9d0906'],13,28,41,14015452,5,0.214285714,0.428571429,0.428571429,9001
3b32b6a745de7c52c25b12f3f14ef7cd71af9837,0,honma,2015-06-04 13:52:51+08:00,['dbae8e8a97d148093830b85070b1b1a2da4bce99'],23,34,57,14015509,5,0.375,1,1,9001
03ba46c32285d2c94153e3a30d05337031e55eee,1,Zhong Jian,2015-06-04 14:28:10+08:00,['3b32b6a745de7c52c25b12f3f14ef7cd71af9837'],0,2,2,14015511,1,,,,9001
96d7a1da9c89ef960968116c0fdc5682faf061d5,0,Li Yang,2015-06-04 15:04:08+08:00,['03ba46c32285d2c94153e3a30d05337031e55eee'],1,1,2,14015513,1,,,,9001
d219685e6a12cb686058ad3900f60f75c80ef3e3,0,Li Yang,2015-06-04 15:04:52+08:00,['96d7a1da9c89ef960968116c0fdc5682faf061d5'],1,1,2,14015515,1,,,,9001
0b1ed9e7bdaa842b602065ce2bd445d85e743e32,0,qianhao.zhou,2015-06-04 15:22:47+08:00,['d219685e6a12cb686058ad3900f60f75c80ef3e3'],5,5,10,14015525,5,,,,9001
1917b292fdee52d7379bbd96450255288ffefc1a,1,honma,2015-06-04 15:24:28+08:00,['0b1ed9e7bdaa842b602065ce2bd445d85e743e32'],8,12,20,14015545,3,0,0,0,9001
590864ec3e5ebffc8d928815b0b8f0806e251b50,0,qianhao.zhou,2015-06-04 15:54:43+08:00,['1917b292fdee52d7379bbd96450255288ffefc1a'],5,14,19,14015564,2,0,1,1,9001
80938ea6f548e10653d991fdcc55bb3f9ec0cd8e,0,Li Yang,2015-06-04 16:19:35+08:00,['314b00ba1a613deca0100232db7a3fafdf1739e0'],1,6,7,14015571,1,,,,9001
8d80bb610bbeb4c2035e52bef6891d152bdbdb00,0,honma,2015-06-04 17:20:12+08:00,['590864ec3e5ebffc8d928815b0b8f0806e251b50'],3,3,6,14015577,2,,,,9001
fe69b5257600fee0d2c231b7fa131fcbdc897591,0,Li Yang,2015-06-04 17:21:36+08:00,['80938ea6f548e10653d991fdcc55bb3f9ec0cd8e'],4,4,8,14015585,1,,,,9001
4c780c1dc61b16a3f9223fa9d329951d6a63411f,0,Li Yang,2015-06-04 17:21:40+08:00,['fe69b5257600fee0d2c231b7fa131fcbdc897591'],3,3,6,14015591,1,,,,9001
ef6ba56900800a42f54089b6df17f6792a0bbcde,0,Li Yang,2015-06-04 17:21:44+08:00,['4c780c1dc61b16a3f9223fa9d329951d6a63411f'],1,6,7,14015598,1,0,1,1,9001
d9b6054ac969c1362189b0e69eea3060485cc117,0,Li Yang,2015-06-04 17:21:48+08:00,['ef6ba56900800a42f54089b6df17f6792a0bbcde'],0,2,2,14015600,1,0,0,1,9001
2b3bbaaa0b77295ef8c2f32df46363eae3b6cfa6,1,Li Yang,2015-06-04 17:25:26+08:00,['8d80bb610bbeb4c2035e52bef6891d152bdbdb00'],4,4,8,14015608,1,,,,9001
94d1332b3b1a97dc1bc9b1d55576e7e8f5dd273e,0,Li Yang,2015-06-04 17:25:30+08:00,['2b3bbaaa0b77295ef8c2f32df46363eae3b6cfa6'],3,3,6,14015614,1,,,,9001
a6515e05cd86d533fe7abe4cedd629e930b47ff4,0,Li Yang,2015-06-04 17:25:34+08:00,['94d1332b3b1a97dc1bc9b1d55576e7e8f5dd273e'],1,6,7,14015621,1,0,1,1,9001
d0ec2e96538763b97aa3fc3a134451395be98a71,0,Li Yang,2015-06-04 17:25:38+08:00,['a6515e05cd86d533fe7abe4cedd629e930b47ff4'],0,2,2,14015623,1,0,0,1,9001
85c738964b24c2b1527ddbd5b6bd72a20529716c,0,honma,2015-06-04 18:25:14+08:00,['d0ec2e96538763b97aa3fc3a134451395be98a71'],17,19,36,14015659,3,0,0.5,0,9001
c1136de88d987cb8f1d438f89e23c709dd7e9bc2,0,honma,2015-06-04 20:38:03+08:00,['85c738964b24c2b1527ddbd5b6bd72a20529716c'],76,41,117,14015776,12,0,0,0,9001
f390422af0d1b1ac89da7642df22cdf7777e2469,0,honma,2015-06-05 10:35:50+08:00,['c1136de88d987cb8f1d438f89e23c709dd7e9bc2'],33,13,46,14015822,3,0,0,1,9001
1396f150caf14b415bfb7f00cee01d5edbde59a9,0,qianhao.zhou,2015-06-05 11:56:23+08:00,['f390422af0d1b1ac89da7642df22cdf7777e2469'],0,85,85,14015907,2,1,1,1,9001
3713e315bc8ab40312ac2d66519b7a1e7601163a,0,qianhao.zhou,2015-06-05 11:57:01+08:00,['1396f150caf14b415bfb7f00cee01d5edbde59a9'],17,69,86,14015993,6,0,0,0.76744186,9001
956c0abadcc9bb7625bbc19323a118fdbec76cab,0,qianhao.zhou,2015-06-05 12:32:15+08:00,['3713e315bc8ab40312ac2d66519b7a1e7601163a'],62,142,204,14016197,9,1,1,0.666666667,9004
5640f6422e608c9adff31953587df67150f29a6e,0,shaofengshi,2015-06-05 14:33:03+08:00,['314b00ba1a613deca0100232db7a3fafdf1739e0'],45,95,140,14016337,3,0.057142857,0.057142857,1,9004
bb24e61c63bbd2f0daf6889dba314866e7dcd0b4,1,Li Yang,2015-06-05 15:16:21+08:00,['956c0abadcc9bb7625bbc19323a118fdbec76cab'],92,194,286,14016623,1,1,1,1,9004
b4bb5d9f08ec710c9877dbd3e9e6554b506f3fe4,0,Li Yang,2015-06-05 17:25:04+08:00,['bb24e61c63bbd2f0daf6889dba314866e7dcd0b4'],9,3,12,14016635,1,,,,9004
850d48ff57f01ecae084ec3d263c96e3544e4290,1,Li Yang,2015-06-05 17:47:21+08:00,['b4bb5d9f08ec710c9877dbd3e9e6554b506f3fe4'],7,16,23,14016658,1,1,1,1,9004
a8aafb0d8720c5016c46f533f6c3871639d92b45,0,qianhao.zhou,2015-06-05 17:53:53+08:00,['850d48ff57f01ecae084ec3d263c96e3544e4290'],9,133,142,14016800,4,0.1875,0.1875,0.8125,9005
a3b05186800a848963a43c69f8f0679c35c19935,0,Li Yang,2015-06-06 20:52:20+08:00,['d9b6054ac969c1362189b0e69eea3060485cc117'],28,62,90,14016890,2,0.71875,1,1,9005
3b1b7ba0dfe58c65a67f4bef523373322242f365,0,Li Yang,2015-06-06 20:57:05+08:00,['a8aafb0d8720c5016c46f533f6c3871639d92b45'],15,41,56,14016946,2,0.958333333,1,1,9005
c3f1968a7a7fda45411a8d753b86ee98b9fc74cf,1,Li Yang,2015-06-06 21:34:43+08:00,['a3b05186800a848963a43c69f8f0679c35c19935'],0,17,17,14016963,1,0,0,1,9005
c96233863315be2219e654905fa35d3f2eaf6682,1,shaofengshi,2015-06-06 23:12:49+08:00,['3b1b7ba0dfe58c65a67f4bef523373322242f365'],16,34,50,14017013,2,0,0.125,1,9005
a9a77238a06e6bcc42330b08304f426d610c3aea,1,honma,2015-06-07 09:22:39+08:00,['f390422af0d1b1ac89da7642df22cdf7777e2469'],62,101,163,14017176,11,0.206896552,0.310344828,0.793103448,9005
ac714ed0bdf984412f993310d1ed7472693b7f9f,0,shaofengshi,2015-06-07 10:36:40+08:00,"['c96233863315be2219e654905fa35d3f2eaf6682', 'a9a77238a06e6bcc42330b08304f426d610c3aea']",62,101,163,14017339,11,,,,9005
c2fabb2da0c48e9f6a84ca30a7b1a7ea48751848,1,Li Yang,2015-06-07 16:35:34+08:00,['c3f1968a7a7fda45411a8d753b86ee98b9fc74cf'],135,209,344,14017683,9,0.72,1,0.76,9006
c9277adf3ea4e71e2e140a11ec19bb7b190bcc9f,1,Li Yang,2015-06-07 16:58:47+08:00,['ac714ed0bdf984412f993310d1ed7472693b7f9f'],54,86,140,14017823,3,0.3,1,0.4,9006
f7b45a70eefa3cf4cbe5351443a468e12829625a,0,shaofengshi,2015-06-08 11:25:07+08:00,['c9277adf3ea4e71e2e140a11ec19bb7b190bcc9f'],4,10,14,14017837,3,0,0.8,0.2,9006
118af3b1fcaf216137da653a9b8bd1a5715e810a,1,shaofengshi,2015-06-08 14:52:01+08:00,['f7b45a70eefa3cf4cbe5351443a468e12829625a'],22,168,190,14018027,5,0.269230769,0.91025641,0.230769231,9006
739a3a7d7b097f7200b9014e9ca1260a00a60ef8,0,shaofengshi,2015-06-08 14:56:47+08:00,"['5640f6422e608c9adff31953587df67150f29a6e', 'c2fabb2da0c48e9f6a84ca30a7b1a7ea48751848']",172,309,481,14018508,16,,,,9006
d1f2e52ec8934bb74a1dc22dc4e8d00ac19f74e4,0,honma,2015-06-08 17:01:53+08:00,['118af3b1fcaf216137da653a9b8bd1a5715e810a'],30,27,57,14018565,3,0,0,0,9006
9923c5a7b7d9e02940cbfe2f65b3026f7fb564c5,1,Li Yang,2015-06-08 17:56:35+08:00,['d1f2e52ec8934bb74a1dc22dc4e8d00ac19f74e4'],22,27,49,14018614,5,1,1,0.142857143,9006
57f349ce79169a390dd9b12cec2fccb72b3357b0,0,Li Yang,2015-06-08 17:59:52+08:00,['9923c5a7b7d9e02940cbfe2f65b3026f7fb564c5'],0,2,2,14018616,1,0,1,1,9006
873f2f4e2715464840b2a53a654acb806b939950,0,Zhong Jian,2015-06-08 18:43:43+08:00,['c2fabb2da0c48e9f6a84ca30a7b1a7ea48751848'],5,11,16,14018632,5,,,,9006
c8f8aac7b2d983567180c3981ffeb454648f2b17,1,qianhao.zhou,2015-06-08 19:33:13+08:00,['57f349ce79169a390dd9b12cec2fccb72b3357b0'],130,401,531,14019163,10,0.261363636,0.409090909,0.4375,9010
2abb4327470de214a6c7b27edec2730c2aefce02,0,Zhong Jian,2015-06-08 20:11:59+08:00,['c8f8aac7b2d983567180c3981ffeb454648f2b17'],2,2,4,14019167,2,,,,9010
9a1321fe742ed95e69c8df15fa858230d78b5155,1,Zhong Jian,2015-06-08 20:12:05+08:00,['2abb4327470de214a6c7b27edec2730c2aefce02'],14,14,28,14019195,3,,,,9010
18a8e15bda13d96eae01f13f4a44828adc6a4025,0,Zhong Jian,2015-06-08 20:18:27+08:00,['873f2f4e2715464840b2a53a654acb806b939950'],2,2,4,14019199,1,,,,9010
5a3a803dc769b04a5aa764eaa400e23f9b16a834,0,Luke Han,2015-06-08 10:12:23-07:00,"['18a8e15bda13d96eae01f13f4a44828adc6a4025', 'ae81f704c7fb286d0b7d335167fab885b1a98bf2']",15,39,54,14019253,16,,,,9010
e63b0362db6d2403d5b314f2bbc0c816ae86db2e,1,Li Yang,2015-06-09 10:41:45+08:00,['5a3a803dc769b04a5aa764eaa400e23f9b16a834'],183,183,366,14019619,1,,,,9010
e8185866cb7f55934875150556b573a37e8254f9,0,honma,2015-06-09 11:15:43+08:00,['9a1321fe742ed95e69c8df15fa858230d78b5155'],6,12,18,14019637,4,0.5,0.5,1,9010
fd26731baf555c4cb6f89a776c63bfbfe7b8cd1a,1,Li Yang,2015-06-09 12:46:49+08:00,['e8185866cb7f55934875150556b573a37e8254f9'],183,183,366,14020003,1,,,,9010
079acd65224f95ea7d65cc8a7244f0d17575d19f,0,Zhong Jian,2015-06-09 13:09:08+08:00,['e63b0362db6d2403d5b314f2bbc0c816ae86db2e'],120,31,151,14020154,8,1,0,1,9010
d078424cc14abca6e83c5705e97f4fddeff70488,1,shaofengshi,2015-06-09 14:19:36+08:00,['739a3a7d7b097f7200b9014e9ca1260a00a60ef8'],45,106,151,14020305,5,0.181818182,0,0.805194805,9010
dc1346dcb63e181501353f2573b0d2790613f698,0,shaofengshi,2015-06-09 14:20:35+08:00,"['d078424cc14abca6e83c5705e97f4fddeff70488', '079acd65224f95ea7d65cc8a7244f0d17575d19f']",323,264,587,14020892,30,,,,9010
ec14e92d76403b6603373048d0e0477b20937cba,1,honma,2015-06-09 15:00:35+08:00,['fd26731baf555c4cb6f89a776c63bfbfe7b8cd1a'],16,36,52,14020944,4,0.952380952,0.952380952,1,9010
36a1d684b7601cea9df3583da62ae3b69fc3c06e,1,qianhao.zhou,2015-06-09 15:41:51+08:00,['ec14e92d76403b6603373048d0e0477b20937cba'],15,65,80,14021024,2,0.039215686,1,0.019607843,9010
beae61a62044b92be546d0c94f8be8e5beaadcae,0,Li Yang,2015-06-09 16:21:15+08:00,['36a1d684b7601cea9df3583da62ae3b69fc3c06e'],3,2,5,14021029,1,1,1,0,9010
ff2ddc6d1ed4426c42590a39b0605fa9513e89be,0,shaofengshi,2015-06-09 17:31:38+08:00,['dc1346dcb63e181501353f2573b0d2790613f698'],7,30,37,14021066,3,0,1,0.538461538,9010
dfe847774c4f383fddea61cb26e746ae5055a5dd,0,Zhong Jian,2015-06-09 18:07:58+08:00,['ff2ddc6d1ed4426c42590a39b0605fa9513e89be'],16,17,33,14021099,3,,,,9010
ee877caacb0d3fe67340f3ec17676d3ffa96a935,0,Zhong Jian,2015-06-09 18:20:00+08:00,['dfe847774c4f383fddea61cb26e746ae5055a5dd'],8,0,8,14021107,1,,,,9010
b6b4503420415eff07c5e6230a3c9b89cb2fcb4b,1,honma,2015-06-09 19:08:03+08:00,['beae61a62044b92be546d0c94f8be8e5beaadcae'],13,33,46,14021153,6,0,0.882352941,0.941176471,9010
ce1cdf085df705cffd68c5a1a15b2e6a28a5fdb1,1,honma,2015-06-10 09:57:24+08:00,['b6b4503420415eff07c5e6230a3c9b89cb2fcb4b'],26,38,64,14021217,5,0,0,1,9010
00b81cf10a7d2c571fc88c5559c389c14c49d67d,1,Zhong Jian,2015-06-10 10:52:26+08:00,['ce1cdf085df705cffd68c5a1a15b2e6a28a5fdb1'],5,5,10,14021227,3,,,,9010
025b4f7e36d734388a980ba46d53d29c0f8679f7,0,qianhao.zhou,2015-06-10 15:33:17+08:00,['00b81cf10a7d2c571fc88c5559c389c14c49d67d'],37,76,113,14021340,7,1,1,1,9010
ab7b6899b9d3fbeb051882392515162ae7bc43da,0,shaofengshi,2015-06-10 16:21:13+08:00,['ee877caacb0d3fe67340f3ec17676d3ffa96a935'],4,35,39,14021379,3,0,0,1,9010
1b366ffac3ef047745c7e58439fb65de9d691f76,0,Zhong Jian,2015-06-10 20:32:51+08:00,['ab7b6899b9d3fbeb051882392515162ae7bc43da'],7,36,43,14021422,2,0.555555556,0,1,9010
b0943fca004ff39c99c9a2519dcc3d5b9cdfe9b2,0,qianhao.zhou,2015-06-11 09:44:01+08:00,['025b4f7e36d734388a980ba46d53d29c0f8679f7'],3,5,8,14021430,1,0,1,0,9010
d7753a91f3ca5444ff2925a78d291828092777dd,1,Li Yang,2015-06-11 10:50:42+08:00,['1b366ffac3ef047745c7e58439fb65de9d691f76'],1680,1741,3421,14024851,7,1,1,0.586956522,9010
3d98f264c9e164d5071553806ec284a934850a34,1,Zhong Jian,2015-06-11 10:54:32+08:00,['b0943fca004ff39c99c9a2519dcc3d5b9cdfe9b2'],0,23,23,14024874,1,0.555555556,0,1,9010
abe80fc7a08b11d786ea408581aba7a17e3180a4,0,Zhong Jian,2015-06-11 15:22:49+08:00,['ab7b6899b9d3fbeb051882392515162ae7bc43da'],7,36,43,14024917,2,0.555555556,0,1,9010
e326c62562551dea503c89521e862d48786f404d,0,Zhong Jian,2015-06-11 15:23:11+08:00,['abe80fc7a08b11d786ea408581aba7a17e3180a4'],1680,1741,3421,14028338,7,1,1,0.586956522,9010
244e1851c347e88fdbca91465de1ff8838cbbdf0,0,Zhong Jian,2015-06-11 15:23:15+08:00,['e326c62562551dea503c89521e862d48786f404d'],2,2,4,14028342,1,,,,9010
e3bec223283ca7bd9b0730379096667c56079e2e,1,Li Yang,2015-06-11 16:14:40+08:00,['244e1851c347e88fdbca91465de1ff8838cbbdf0'],19,13,32,14028374,2,1,1,1,9010
cb255534cec7e74741eb86e87bcf5e5b79cfa23f,0,Li Yang,2015-06-11 16:18:26+08:00,['3d98f264c9e164d5071553806ec284a934850a34'],17,11,28,14028402,2,1,1,1,9010
595f0b8f03bb78b42520a67f032c3ece42869615,0,shaofengshi,2015-06-11 16:47:12+08:00,['cb255534cec7e74741eb86e87bcf5e5b79cfa23f'],1,41,42,14028444,3,0,1,0,9010
880231fa786b738326b8c776f904c7a47ca58a96,0,Li Yang,2015-06-11 17:55:50+08:00,['e3bec223283ca7bd9b0730379096667c56079e2e'],4,152,156,14028600,2,0,0.164835165,0.384615385,9011
ecfdaf73aaf1866fe8c9154a50cd6b3b6a099609,1,Li Yang,2015-06-11 18:07:13+08:00,['880231fa786b738326b8c776f904c7a47ca58a96'],172,196,368,14028968,5,0.375,1,1,9012
9e4ae5177b015205ef16393417b6b69207042120,1,Li Yang,2015-06-11 18:23:45+08:00,['595f0b8f03bb78b42520a67f032c3ece42869615'],22,89,111,14029079,3,0,0,1,9012
d988a6b72338b31408a694b530c2469a65f117ee,0,Luke Han,2015-06-11 16:56:48-07:00,['ecfdaf73aaf1866fe8c9154a50cd6b3b6a099609'],5,114,119,14029198,1,,,,9012
514a5dca59b5426bb6a3e27931bac66e1ac08826,0,Luke Han,2015-06-11 17:00:40-07:00,['d988a6b72338b31408a694b530c2469a65f117ee'],9,9,18,14029216,1,,,,9012
4ba59843ebe64e05199f46ccb9c150ac53b6e604,0,Luke Han,2015-06-11 17:02:09-07:00,['514a5dca59b5426bb6a3e27931bac66e1ac08826'],2,4,6,14029222,1,,,,9012
552c76717ae67e7836b44f0c62f9a4ac55e86d31,1,Li Yang,2015-06-12 15:30:41+08:00,['9e4ae5177b015205ef16393417b6b69207042120'],1,9,10,14029232,1,1,1,1,9012
48a1e7d573f7d9cbce76c69a279324ca74edc421,0,Li Yang,2015-06-12 15:32:17+08:00,['4ba59843ebe64e05199f46ccb9c150ac53b6e604'],1,9,10,14029242,1,1,1,1,9012
856e26875482c40ff2ae46ad1e3a8ca53cc01f44,0,qianhao.zhou,2015-06-12 16:07:14+08:00,['552c76717ae67e7836b44f0c62f9a4ac55e86d31'],6,8,14,14029256,2,0,0,0,9012
9bcb55e6045aedca86b6076f8cd766b057e5d376,1,honma,2015-06-12 16:55:10+08:00,['856e26875482c40ff2ae46ad1e3a8ca53cc01f44'],16,199,215,14029471,9,,,,9015
41c17d17b7e922cb91c29684389ea8810a483fc5,1,honma,2015-06-12 16:55:10+08:00,['9bcb55e6045aedca86b6076f8cd766b057e5d376'],50,191,241,14029712,9,0.197530864,0.518518519,0.518518519,9017
2255398c8261ef928381ec728e7b99375d894910,0,honma,2015-06-12 16:55:10+08:00,['41c17d17b7e922cb91c29684389ea8810a483fc5'],148,25,173,14029885,3,1,1,0.424242424,9017
f77de31a37fa52ad55c94edfddfcbf2be97bd5a0,0,qianhao.zhou,2015-06-12 17:52:29+08:00,['2255398c8261ef928381ec728e7b99375d894910'],2,2,4,14029889,2,,,,9017
f8597d65591b566c428b32071ce7566291dfca12,0,Luke Han,2015-06-13 17:49:37-07:00,['48a1e7d573f7d9cbce76c69a279324ca74edc421'],53,172,225,14030114,4,,,,9020
78c9a689c64c991645bcb7f71cb2113756969c4f,0,Luke Han,2015-06-13 18:08:36-07:00,['f8597d65591b566c428b32071ce7566291dfca12'],4,4,8,14030122,3,,,,9020
0498e3cca4a75587ccbd69c903375de66e81a765,0,shaofengshi,2015-06-15 10:43:16+08:00,"['d7753a91f3ca5444ff2925a78d291828092777dd', '78c9a689c64c991645bcb7f71cb2113756969c4f']",104,508,612,14030734,12,,,,9020
c5bf3f1900b48e542d52c1d3784fd9024b54da5a,0,Zhong Jian,2015-06-15 12:31:13+08:00,['0498e3cca4a75587ccbd69c903375de66e81a765'],1,7,8,14030742,1,0.75,0.75,0,9020
a6ff91f520feb1b4cac6e49f86a3f53cb459a938,0,shaofengshi,2015-06-15 14:50:24+08:00,['c5bf3f1900b48e542d52c1d3784fd9024b54da5a'],5,39,44,14030786,2,1,1,0,9021
6a52bdf8ee6b2beb40361ebd54a7237092bb796e,1,Li Yang,2015-06-15 15:08:08+08:00,['f77de31a37fa52ad55c94edfddfcbf2be97bd5a0'],1647,1741,3388,14034174,6,0.945205479,0.98630137,0.739726027,9021
a0d71662fe90c59fd9b33705bf09ea896a42921f,0,Li Yang,2015-06-15 15:21:31+08:00,"['3b3a302b1fdb14d5eba4618bf0610a50ebabdbe8', '5a3a803dc769b04a5aa764eaa400e23f9b16a834']",0,0,0,14034174,0,,,,9021
e5e59ef91151b8ca33d280c10041b8b4f0c60ae3,1,qianhao.zhou,2015-06-15 17:44:25+08:00,['6a52bdf8ee6b2beb40361ebd54a7237092bb796e'],5,30,35,14034209,2,0,0,1,9021
3892c40970bc0f72e17e96e5dda785b312090fe2,0,qianhao.zhou,2015-06-15 21:00:14+08:00,['e5e59ef91151b8ca33d280c10041b8b4f0c60ae3'],0,1,1,14034210,1,0,1,0,9021
fcd6a7c7ef045d378a75710076fcdc5302e462e4,0,Li Yang,2015-06-16 10:27:44+08:00,['a6ff91f520feb1b4cac6e49f86a3f53cb459a938'],3,15,18,14034228,2,0,0,1,9021
fbec55ace7ba11d819079294304ad04d953f18b5,0,shaofengshi,2015-06-16 13:59:44+08:00,['fcd6a7c7ef045d378a75710076fcdc5302e462e4'],1,2,3,14034231,1,,,,9021
b05c4218d96c26e5c86aac729af7a8a65e32d416,0,shaofengshi,2015-06-16 14:01:04+08:00,['3892c40970bc0f72e17e96e5dda785b312090fe2'],1,2,3,14034234,1,,,,9021
0018c649ae5fa5c2dd5805ced96a8fcfc7ae9d21,0,qianhao.zhou,2015-06-16 15:53:18+08:00,['b05c4218d96c26e5c86aac729af7a8a65e32d416'],1,1,2,14034236,1,,,,9021
2e39511deefae2d02f3db796d72c12a63f772df4,0,qianhao.zhou,2015-06-16 16:07:40+08:00,['0018c649ae5fa5c2dd5805ced96a8fcfc7ae9d21'],2,11,13,14034249,2,,,,9022
56375b93cf1d33cb37049e67a3c0941b0e47d271,1,honma,2015-06-16 19:09:58+08:00,['3892c40970bc0f72e17e96e5dda785b312090fe2'],192,303,495,14034744,30,0.944444444,0,0,9034
537d1ae1e9279c7126ab51c5470260b511116895,0,honma,2015-06-16 19:11:10+08:00,"['56375b93cf1d33cb37049e67a3c0941b0e47d271', '2e39511deefae2d02f3db796d72c12a63f772df4']",3,13,16,14034760,3,,,,9034
9e5b30171fb2e068c30dd9ddc1e3e152aa9d0280,0,honma,2015-06-16 20:23:15+08:00,['537d1ae1e9279c7126ab51c5470260b511116895'],34,13,47,14034807,1,,,,9034
76a809ce3e672ded863b53f970d14c10f9f53a82,0,shaofengshi,2015-06-17 10:16:28+08:00,['fbec55ace7ba11d819079294304ad04d953f18b5'],3,12,15,14034822,2,0,0,1,9034
1814a494afac6b9439edb435b474258004c62c9d,0,shaofengshi,2015-06-17 10:20:22+08:00,['9e5b30171fb2e068c30dd9ddc1e3e152aa9d0280'],0,3,3,14034825,1,0,0,1,9034
24416d6f36c253fb153d648eeadacfae0a0c83d0,0,honma,2015-06-17 10:42:36+08:00,['1814a494afac6b9439edb435b474258004c62c9d'],15,28,43,14034868,1,0.888888889,0.888888889,0,9034
e48d88a216cfa254703c37d63dc7e04e01f51371,0,honma,2015-06-17 11:16:37+08:00,['24416d6f36c253fb153d648eeadacfae0a0c83d0'],8,21,29,14034897,3,1,1,1,9035
676de7e3bf1be7433871643ae967f042961b883d,1,Li Yang,2015-06-17 12:00:56+08:00,['76a809ce3e672ded863b53f970d14c10f9f53a82'],11,35,46,14034943,4,0.857142857,0.928571429,0.142857143,9035
9c59caf05b22e957c2a95dcf73723d45dd0c02c3,0,Li Yang,2015-06-17 14:46:27+08:00,['676de7e3bf1be7433871643ae967f042961b883d'],1,9,10,14034953,3,1,1,0.6,9035
3aaa9ba46fcdf9c138adcd66d47692728f6c7773,1,Li Yang,2015-06-17 14:48:47+08:00,['e48d88a216cfa254703c37d63dc7e04e01f51371'],1,5,6,14034959,1,1,0,0,9035
3d01d8da4dfc52b031d40517d3eeed09abfbfc82,0,Li Yang,2015-06-17 14:51:27+08:00,['9c59caf05b22e957c2a95dcf73723d45dd0c02c3'],2,7,9,14034968,1,1,0,0,9035
ee31cebcf5cd0bd04c363617cef92534fae761d5,0,honma,2015-06-17 16:00:04+08:00,['3aaa9ba46fcdf9c138adcd66d47692728f6c7773'],82,19,101,14035069,38,,,,9035
5ea332493abf02fa1d746cfa0da6011ce0276bf4,1,honma,2015-06-17 16:00:04+08:00,['ee31cebcf5cd0bd04c363617cef92534fae761d5'],18,22,40,14035109,4,0,0.333333333,0.333333333,9035
095a6bee0b4268d5437f25d7019ed87083652199,1,honma,2015-06-17 16:29:51+08:00,['5ea332493abf02fa1d746cfa0da6011ce0276bf4'],1,1,2,14035111,1,,,,9035
7b2b1b9dc30896f59afa575c742a95648b796917,0,Zhong Jian,2015-06-17 17:55:43+08:00,['095a6bee0b4268d5437f25d7019ed87083652199'],1,1,2,14035113,1,,,,9035
7e127a60852767ce00294e7af60ee4471acd351b,1,qianhao.zhou,2015-06-18 11:55:17+08:00,['7b2b1b9dc30896f59afa575c742a95648b796917'],90,254,344,14035457,10,0.579710145,0.833333333,0.586956522,9036
b1317dafbd7bbc20713a3625158eb4075c57cb7c,1,qianhao.zhou,2015-06-18 14:29:16+08:00,['3d01d8da4dfc52b031d40517d3eeed09abfbfc82'],106,248,354,14035811,9,0.427480916,0.824427481,0.549618321,9037
2c3ab20ddacecfd3479bd0d43dca3f898f1d1816,0,qianhao.zhou,2015-06-18 14:32:00+08:00,['b1317dafbd7bbc20713a3625158eb4075c57cb7c'],1,1,2,14035813,1,,,,9037
3cf6703394712289e2739eff3ca73ea9880544f4,0,qianhao.zhou,2015-06-18 14:36:32+08:00,['7e127a60852767ce00294e7af60ee4471acd351b'],3,3,6,14035819,2,,,,9037
a2dba85f8be34205e0bd8eee630d8f80f39e6e51,1,Li Yang,2015-06-18 15:12:48+08:00,['2c3ab20ddacecfd3479bd0d43dca3f898f1d1816'],11,7,18,14035837,3,1,0.5,0,9037
04fc9e8c177dd511d6087ca4973394c4fa619a3e,1,honma,2015-06-19 10:13:50+08:00,['a2dba85f8be34205e0bd8eee630d8f80f39e6e51'],96,107,203,14036040,3,,,,9037
09c3367f4f25dfea9e03b61dd4dc7d6fba917901,1,honma,2015-06-19 10:15:52+08:00,['3cf6703394712289e2739eff3ca73ea9880544f4'],4,16,20,14036060,3,,,,9037
6f78d62912fc243d5834d34d32d4a28c05f8a6e9,0,shaofengshi,2015-06-19 10:32:37+08:00,['04fc9e8c177dd511d6087ca4973394c4fa619a3e'],1,6,7,14036067,1,1,1,1,9037
0476f5f5e467bbae78e4dd660d710318f414704c,0,shaofengshi,2015-06-19 10:37:26+08:00,['09c3367f4f25dfea9e03b61dd4dc7d6fba917901'],1,6,7,14036074,1,1,1,1,9037
18f0540c3c53637d8752fb7fee014506c2001ae4,1,shaofengshi,2015-06-19 17:39:26+08:00,['6f78d62912fc243d5834d34d32d4a28c05f8a6e9'],12,18,30,14036104,2,0,1,1,9037
622d200a4c8317abc873361545fd49b6269329c9,0,shaofengshi,2015-06-19 17:58:50+08:00,['0476f5f5e467bbae78e4dd660d710318f414704c'],6,18,24,14036128,1,0,0,1,9037
9a372ea612f593f56e2bf3dc294dd43db1c87b14,1,Li Yang,2015-06-20 20:43:48+08:00,['622d200a4c8317abc873361545fd49b6269329c9'],62,385,447,14036575,7,0.443113772,0.646706587,1,9039
eb8eed4ff5a9e76e8b7914eddb0f037252460c11,1,Li Yang,2015-06-21 19:56:33+08:00,['9a372ea612f593f56e2bf3dc294dd43db1c87b14'],96,133,229,14036804,9,0.277777778,1,1,9039
2e920ab7dc8a10cb8c1f3fe82e291b6bf5b5f699,0,Li Yang,2015-06-22 08:52:50+08:00,['eb8eed4ff5a9e76e8b7914eddb0f037252460c11'],71,84,155,14036959,10,0,1,0.5,9040
741a8ef736c8518bb5bf51387185dc37acb2d4cb,1,Li Yang,2015-06-23 18:00:24+08:00,['2e920ab7dc8a10cb8c1f3fe82e291b6bf5b5f699'],76,436,512,14037471,10,0.661691542,0.985074627,0.850746269,9041
80918e76c62ddbf6564ea2ba14c34b83f0e40be1,1,shaofengshi,2015-06-23 19:11:17+08:00,['18f0540c3c53637d8752fb7fee014506c2001ae4'],8,34,42,14037513,4,0,0.333333333,0.333333333,9042
987b7a55ccafffe3760ce0748c3926ab9fc87a48,1,shaofengshi,2015-06-23 21:00:40+08:00,['80918e76c62ddbf6564ea2ba14c34b83f0e40be1'],11,23,34,14037547,2,0.25,0.25,0.25,9042
ac2d4c49cb38bb796120911bb7b50f5870bcff9a,1,shaofengshi,2015-06-24 09:35:07+08:00,['741a8ef736c8518bb5bf51387185dc37acb2d4cb'],8,34,42,14037589,4,0,0.333333333,0.333333333,9043
2e79bffd83554ffe1f8ddbcab0645de8e2d76ec8,1,shaofengshi,2015-06-24 09:43:22+08:00,['ac2d4c49cb38bb796120911bb7b50f5870bcff9a'],11,21,32,14037621,2,0.25,0.25,0.25,9043
6a919c293fd631970c3677498f3851708609c1bb,0,honma,2015-06-24 12:02:25+08:00,['987b7a55ccafffe3760ce0748c3926ab9fc87a48'],60,80,140,14037761,5,0.125,0.5,0,9044
65c530fbb75a86e3b214f1329013772fc5fb792a,0,honma,2015-06-24 14:10:49+08:00,['2e79bffd83554ffe1f8ddbcab0645de8e2d76ec8'],1,1,2,14037763,1,,,,9044
c68fd19344440d799516e7387d116850e1def82e,0,Li Yang,2015-06-24 16:15:13+08:00,['65c530fbb75a86e3b214f1329013772fc5fb792a'],16,14,30,14037793,1,0,0,0,9044
cb55a6c1f28ddf6f7c7ed5cd407af980e7e3641a,0,qianhao.zhou,2015-06-24 20:01:41+08:00,['c68fd19344440d799516e7387d116850e1def82e'],2,5,7,14037800,3,0,0,1,9044
78041ed29f59c9bc9b11267d8f5cc44e98f0425f,0,qianhao.zhou,2015-06-24 20:01:56+08:00,['cb55a6c1f28ddf6f7c7ed5cd407af980e7e3641a'],10,13,23,14037823,1,0,1,1,9044
7c036a4db8b57405fb3f2c59236391c8bad42796,1,honma,2015-06-24 21:16:52+08:00,['6a919c293fd631970c3677498f3851708609c1bb'],41,218,259,14038082,8,0.326086957,0.576086957,0.934782609,9046
c647d8b609dc6275ba3c033638578a38319a85e7,0,honma,2015-06-24 21:20:25+08:00,['7c036a4db8b57405fb3f2c59236391c8bad42796'],9,146,155,14038237,3,0.422222222,0.422222222,1,9047
1686914df7ef702e4a7f6074e829fb940c4f8c22,1,honma,2015-06-24 21:20:53+08:00,['c647d8b609dc6275ba3c033638578a38319a85e7'],59,60,119,14038356,1,0,0,1,9047
2d3ac8b581b057fbda036b308f28944595e03216,0,Li Yang,2015-06-25 07:40:10+08:00,['78041ed29f59c9bc9b11267d8f5cc44e98f0425f'],321,313,634,14038990,8,0,0,0.282608696,9048
04da90ac6e2b04d048c6494af2b17c6aabcdfd36,0,Li Yang,2015-06-25 07:46:54+08:00,['2d3ac8b581b057fbda036b308f28944595e03216'],2,2,4,14038994,1,,,,9048
9eae5d3a7fe684ed63dd051a562bbc0330d9d072,0,honma,2015-06-25 12:22:15+08:00,['1686914df7ef702e4a7f6074e829fb940c4f8c22'],128,166,294,14039288,9,1,1,0.740740741,9049
ce6a4485e9e5633bd5b4fe42b5f4f70cfc70430d,0,honma,2015-06-25 13:26:02+08:00,['9eae5d3a7fe684ed63dd051a562bbc0330d9d072'],3,5,8,14039296,1,0,0,0,9049
7378c1a443f011b15b8677812fa372bb7ccce726,0,qianhao.zhou,2015-06-25 13:36:44+08:00,['04da90ac6e2b04d048c6494af2b17c6aabcdfd36'],6,13,19,14039315,1,0,1,1,9049
652851b7f980eedb85a791ae0471ab7d6f00002b,0,Li Yang,2015-06-25 14:04:38+08:00,['ce6a4485e9e5633bd5b4fe42b5f4f70cfc70430d'],2,6,8,14039323,1,0.5,0.5,1,9049
605eec980689270448837a5caf0c13ea746e6b7e,0,Li Yang,2015-06-25 14:04:42+08:00,['652851b7f980eedb85a791ae0471ab7d6f00002b'],37,48,85,14039408,4,1,1,0.75,9049
173a605cc92cc34b93f8cc643ae033629afaf5e1,0,Li Yang,2015-06-25 14:29:49+08:00,['7378c1a443f011b15b8677812fa372bb7ccce726'],24,104,128,14039536,3,0.952380952,1,0.952380952,9050
e10aaa507813dd987ac8bdb624bbc2bf7e21282d,0,honma,2015-06-25 15:29:18+08:00,['173a605cc92cc34b93f8cc643ae033629afaf5e1'],83,67,150,14039686,9,1,1,1,9050
d7dbb4291239545fe32d48473e21506552543a23,0,honma,2015-06-25 15:45:00+08:00,['e10aaa507813dd987ac8bdb624bbc2bf7e21282d'],200,214,414,14040100,5,0.125,0.5,0,9051
d2409b53a08b655d92363f46113565a64e9a003c,1,honma,2015-06-25 15:50:16+08:00,['d7dbb4291239545fe32d48473e21506552543a23'],11,143,154,14040254,7,0.205128205,0.5,0.923076923,9052
0a9108a0909bbaa9fbb800032b270d6d5c00d9db,0,honma,2015-06-25 15:50:56+08:00,['d2409b53a08b655d92363f46113565a64e9a003c'],3,5,8,14040262,1,0,0,0,9052
99aedc5435845fe2ebda46c7c23b44b0aab70d45,0,honma,2015-06-25 15:55:25+08:00,['0a9108a0909bbaa9fbb800032b270d6d5c00d9db'],11,12,23,14040285,3,1,0,0,9052
f9a40f3fc1d5d0e47227d447fcc8aa4e010f8f15,0,honma,2015-06-25 16:03:54+08:00,['99aedc5435845fe2ebda46c7c23b44b0aab70d45'],7,10,17,14040302,5,0,0,0,9052
c497e6fb87c9e948c364de70e5642bd1e3325745,1,shaofengshi,2015-06-25 17:21:41+08:00,['605eec980689270448837a5caf0c13ea746e6b7e'],29,71,100,14040402,2,0.137931034,0,1,9052
74cf7fdda864e2c90fef3bc645e7b72e66b09ea0,0,shaofengshi,2015-06-27 09:15:18+08:00,['c497e6fb87c9e948c364de70e5642bd1e3325745'],1,1,2,14040404,1,,,,9052
d3d0a4676cc7937de6c5bdbf5a1a1ce06a6c754d,0,shaofengshi,2015-06-28 09:56:32+08:00,['74cf7fdda864e2c90fef3bc645e7b72e66b09ea0'],9,52,61,14040465,1,0,0,1,9052
39dec94323c350d6c1034fade7fa819b715b1c97,0,shaofengshi,2015-06-29 10:52:49+08:00,['d3d0a4676cc7937de6c5bdbf5a1a1ce06a6c754d'],4,4,8,14040473,1,,,,9052
253f70818451eef05845cdf96aa325ec39f306b5,1,shaofengshi,2015-06-29 13:52:58+08:00,['f9a40f3fc1d5d0e47227d447fcc8aa4e010f8f15'],8,14,22,14040495,1,0,0,1,9052
bd9111131a0bdca94c095a7c38e7c055d556cfd0,0,shaofengshi,2015-06-29 15:13:34+08:00,['39dec94323c350d6c1034fade7fa819b715b1c97'],46,71,117,14040612,1,0,0,1,9052
550db4400860b193251ba9afb17cece4fb5e735f,0,Li Yang,2015-06-29 17:15:59+08:00,['253f70818451eef05845cdf96aa325ec39f306b5'],13,45,58,14040670,3,0.709677419,0.709677419,0.870967742,9052
7bad83c6f6ca2bc30e6d50b95601637c2b6ec02d,0,shaofengshi,2015-06-29 19:04:56+08:00,['550db4400860b193251ba9afb17cece4fb5e735f'],14,17,31,14040701,7,1,0,1,9052
d24e5e3452d9d6bcf0257d739e815650f56834ed,0,shaofengshi,2015-06-29 19:11:54+08:00,['bd9111131a0bdca94c095a7c38e7c055d556cfd0'],3,3,6,14040707,1,1,1,0,9052
997207c381435fddad2672fc8095a05de613ff71,0,shaofengshi,2015-06-30 10:33:17+08:00,['7bad83c6f6ca2bc30e6d50b95601637c2b6ec02d'],41,109,150,14040857,1,0,0,1,9052
0b2829b7576a05494b2779dd3accc85a5224b19f,1,shaofengshi,2015-06-30 15:04:05+08:00,['997207c381435fddad2672fc8095a05de613ff71'],12,55,67,14040924,10,0.035714286,0.785714286,0.75,9052
05617b3282945812eee6219dcf0e29db1ce1591c,0,shaofengshi,2015-06-30 15:09:56+08:00,['d24e5e3452d9d6bcf0257d739e815650f56834ed'],2,4,6,14040930,1,0,0,1,9052
a1d2c03a5be6ab42337caf5e0aed923d5ed5a2a3,0,shaofengshi,2015-06-30 15:50:16+08:00,['0b2829b7576a05494b2779dd3accc85a5224b19f'],4,28,32,14040962,4,0,1,0.333333333,9052
414ceb5ce07616a557241c661ee09ae88045afd0,1,shaofengshi,2015-06-30 15:54:00+08:00,['a1d2c03a5be6ab42337caf5e0aed923d5ed5a2a3'],5,5,10,14040972,3,,,,9052
ed6a2862fd74b5dd2a12ff4d3445070608de2a73,0,shaofengshi,2015-06-30 18:22:46+08:00,['05617b3282945812eee6219dcf0e29db1ce1591c'],6,11,17,14040989,5,0,1,0,9052
6b53c2892b62a27b818f66fd7459ab649ab7765c,1,Li Yang,2015-06-30 18:27:38+08:00,['ed6a2862fd74b5dd2a12ff4d3445070608de2a73'],35,36,71,14041060,2,0,0,0,9052
924c91b8431665ede0d6b62b5676a5168c213976,1,Li Yang,2015-06-30 18:32:54+08:00,['414ceb5ce07616a557241c661ee09ae88045afd0'],37,38,75,14041135,2,0,0,0,9052
91ca4ce087ce61814df53f74a0395ce530f02bd7,0,shaofengshi,2015-07-01 13:39:06+08:00,['924c91b8431665ede0d6b62b5676a5168c213976'],2,2,4,14041139,1,,,,9052
53cf16ddbab4957c95387a05944bb08d9846130d,1,shaofengshi,2015-07-01 14:22:53+08:00,['6b53c2892b62a27b818f66fd7459ab649ab7765c'],13,57,70,14041209,3,1,1,0.708333333,9052
b7b26906c0bdb5e7db5efacb744fc40fb9c62aff,0,honma,2015-07-01 15:53:10+08:00,['53cf16ddbab4957c95387a05944bb08d9846130d'],0,37,37,14041246,1,,,,9053
4186424ad45f8db412d87f87d4247f440e895054,1,Li Yang,2015-07-01 15:55:30+08:00,['91ca4ce087ce61814df53f74a0395ce530f02bd7'],55,59,114,14041360,4,1,1,1,9053
c267b5a62c36b7a0d8826ade349dafc991bdbeeb,0,honma,2015-07-01 16:42:29+08:00,['4186424ad45f8db412d87f87d4247f440e895054'],52,337,389,14041749,12,0.341614907,0.49689441,0.894409938,9057
546582aaea811d10672c225cef52fd792e1408fd,1,honma,2015-07-01 16:42:29+08:00,['c267b5a62c36b7a0d8826ade349dafc991bdbeeb'],11,19,30,14041779,4,1,1,1,9057
5c805fefcbc1acaebcca611974bde6cda35c13de,1,honma,2015-07-01 16:42:29+08:00,['546582aaea811d10672c225cef52fd792e1408fd'],0,37,37,14041816,1,,,,9058
8478bff1c89a9c87614c783df3e99eaf5f4538f5,0,honma,2015-07-01 16:42:29+08:00,['5c805fefcbc1acaebcca611974bde6cda35c13de'],127,122,249,14042065,2,0.906666667,0.573333333,0.093333333,9058
a514be73f0bce1dd99f28c36211e350ab32dcb21,0,qianhao.zhou,2015-07-01 16:43:50+08:00,['8478bff1c89a9c87614c783df3e99eaf5f4538f5'],0,24,24,14042089,1,,,,9059
d7b86b92328e7ff4282ba22cf2ac5a194eeb0f98,1,qianhao.zhou,2015-07-01 16:43:50+08:00,['a514be73f0bce1dd99f28c36211e350ab32dcb21'],17,259,276,14042365,6,0.097902098,0.34965035,0.587412587,9061
c9f236b680aac4cef7165e16496b48a0f47c7793,1,honma,2015-07-02 15:38:23+08:00,['d7b86b92328e7ff4282ba22cf2ac5a194eeb0f98'],1,9,10,14042375,1,0,1,1,9061
f3ce30ef99c16e295d1f2ba4423b47d02ad40539,0,honma,2015-07-02 15:57:02+08:00,['c9f236b680aac4cef7165e16496b48a0f47c7793'],0,6,6,14042381,1,1,1,1,9061
295f18348a4eaa88df56747fea1afd692a805653,0,qianhao.zhou,2015-07-02 16:45:29+08:00,['f3ce30ef99c16e295d1f2ba4423b47d02ad40539'],11,30,41,14042422,4,0.461538462,0,1,9061
a8115cc3f689d5e203eba4b6a6c344ee02ae57a0,1,Zhong Jian,2015-07-02 19:51:40+08:00,['b7b26906c0bdb5e7db5efacb744fc40fb9c62aff'],2158,5391,7549,14049971,35,0.598540146,0.768248175,0.935218978,9078
400b5a3a7b360a99dc5d5a23805036bcae906b57,0,qianhao.zhou,2015-07-03 10:57:27+08:00,['295f18348a4eaa88df56747fea1afd692a805653'],5,14,19,14049990,2,0,0,0,9078
e330f783f5a8ced4ed535c4557865ba3520dfd5f,0,honma,2015-07-03 14:54:43+08:00,['400b5a3a7b360a99dc5d5a23805036bcae906b57'],3,3,6,14049996,2,,,,9078
82105da22a42edcdfb0af0373e4fa949ce6b4a60,0,honma,2015-07-03 14:56:19+08:00,['e330f783f5a8ced4ed535c4557865ba3520dfd5f'],61,128,189,14050185,7,0.415384615,0.707692308,0.938461538,9078
c0268d7b4c996424323fc1d0fe791243975b3252,1,honma,2015-07-03 14:56:19+08:00,['82105da22a42edcdfb0af0373e4fa949ce6b4a60'],30,23,53,14050238,5,1,1,1,9078
7e3d88a61ea235d6d80815eb3b4298ce411f7817,0,honma,2015-07-03 17:37:15+08:00,['c0268d7b4c996424323fc1d0fe791243975b3252'],33,31,64,14050302,1,1,0,1,9078
ca6d668cab7d54972d4aa876331db84eba6c7ffd,1,Zhong Jian,2015-07-03 17:42:50+08:00,['a8115cc3f689d5e203eba4b6a6c344ee02ae57a0'],1,39,40,14050342,2,0,0,0,9079
141509557343938cbad9472410d1e1babef9ce1c,0,honma,2015-07-03 21:24:21+08:00,['7e3d88a61ea235d6d80815eb3b4298ce411f7817'],13,26,39,14050381,3,0,1,0,9079
c42ce21a5e94e474d52d0d230586072fe46f4fb1,1,Li Yang,2015-07-04 06:33:36+08:00,['141509557343938cbad9472410d1e1babef9ce1c'],5600,4331,9931,14060312,73,0.479099678,0.448553055,0.276527331,9087
070ed9dd9274334371b171c23c37362aac28f488,1,Li Yang,2015-07-04 08:18:13+08:00,['c42ce21a5e94e474d52d0d230586072fe46f4fb1'],5,7,12,14060324,3,1,1,1,9087
d3d09684bbaab12e9655e9f983c09f6971d572c3,0,Li Yang,2015-07-04 12:46:10+08:00,['070ed9dd9274334371b171c23c37362aac28f488'],11,25,36,14060360,1,1,1,1,9087
5359ef1f8c4f7eaf120e60ca8e3b568b4bed7e97,0,Li Yang,2015-07-05 06:41:27+08:00,['d3d09684bbaab12e9655e9f983c09f6971d572c3'],1,1,2,14060362,1,0,0,0,9087
71e23ae03d6f1e1daaa5de3264a7dcad4d01f863,0,Li Yang,2015-07-05 07:30:18+08:00,['5359ef1f8c4f7eaf120e60ca8e3b568b4bed7e97'],2,4,6,14060368,2,0.333333333,0,1,9087
480de35fe3cbc9e1655499098651db9511b28dbc,0,Zhong Jian,2015-07-06 11:01:42+08:00,['71e23ae03d6f1e1daaa5de3264a7dcad4d01f863'],19,24,43,14060411,2,1,1,1,9087
9e97c9d50de001316456ac9e4fabfb341870edfa,0,Li Yang,2015-07-06 11:12:06+08:00,['ca6d668cab7d54972d4aa876331db84eba6c7ffd'],53,56,109,14060520,5,1,1,0,9087
729f432856734cb998260369177fc80d5c92bfc1,0,Li Yang,2015-07-06 11:17:56+08:00,['480de35fe3cbc9e1655499098651db9511b28dbc'],46,65,111,14060631,5,1,1,0,9087
56bb2a645125eb45bdb0b5628b50b32eb2ed98a4,0,Zhong Jian,2015-07-06 11:25:07+08:00,['9e97c9d50de001316456ac9e4fabfb341870edfa'],58,63,121,14060752,2,1,1,1,9087
fc8db25ea11c4fbe4e7a3bb82a4232c63a2a1311,1,honma,2015-07-06 11:28:04+08:00,['729f432856734cb998260369177fc80d5c92bfc1'],1,1,2,14060754,1,,,,9087
f6ff0e4bc472494174055ac7da12d1f5a4986ca3,0,Li Yang,2015-07-06 13:40:27+08:00,['fc8db25ea11c4fbe4e7a3bb82a4232c63a2a1311'],6,15,21,14060775,2,0.5,1,1,9087
b3c1ec6cedeb4abfb079c4f1278e9b8a69decdc9,1,Li Yang,2015-07-06 13:48:09+08:00,['56bb2a645125eb45bdb0b5628b50b32eb2ed98a4'],1569,1363,2932,14063707,50,0.528205128,0.420512821,0.482051282,9088
fd7a90c14f97751ade62455685cc5192b21e5fe7,1,Li Yang,2015-07-06 13:48:13+08:00,['b3c1ec6cedeb4abfb079c4f1278e9b8a69decdc9'],3565,2491,6056,14069763,35,0.471014493,0.483091787,0.171497585,9095
9b824516f5a5d7298247ce093c8b540f6a057f82,0,Li Yang,2015-07-06 13:50:16+08:00,['fd7a90c14f97751ade62455685cc5192b21e5fe7'],6,15,21,14069784,2,0.5,1,1,9095
87b75cc81fa68c254687d463b76e36c55a92d7d2,0,Li Yang,2015-07-06 14:01:50+08:00,['9b824516f5a5d7298247ce093c8b540f6a057f82'],1,1,2,14069786,1,,,,9095
f380a3e780f5c3fe4b8db524f841d1a06a2b2392,0,Li Yang,2015-07-06 14:02:41+08:00,['f6ff0e4bc472494174055ac7da12d1f5a4986ca3'],1,1,2,14069788,1,,,,9095
73dd7239d43267d739d40bac013d38dfacf82ab2,0,Zhong Jian,2015-07-06 15:16:02+08:00,['87b75cc81fa68c254687d463b76e36c55a92d7d2'],1,58,59,14069847,1,,,,9095
56c3bac8b6bdbbeb25b3a57ced6ff419393166a5,0,qianhao.zhou,2015-07-06 16:02:49+08:00,['f380a3e780f5c3fe4b8db524f841d1a06a2b2392'],16,66,82,14069929,5,1,1,1,9095
57ff6750809fe8b26e37a43c1156a60a253c6aba,1,shaofengshi,2015-07-06 16:19:17+08:00,['73dd7239d43267d739d40bac013d38dfacf82ab2'],117,979,1096,14071025,48,0.556626506,1,0.836144578,9107
6d998a9f62e958190700dfb9f89e6978914c1dc5,1,shaofengshi,2015-07-06 16:19:17+08:00,['57ff6750809fe8b26e37a43c1156a60a253c6aba'],167,207,374,14071399,19,0.216216216,0,1,9107
08948b97f384e315701b1f54b1e3943bb013fd25,0,shaofengshi,2015-07-06 16:19:17+08:00,['6d998a9f62e958190700dfb9f89e6978914c1dc5'],11,63,74,14071473,2,0,0.425,1,9107
f54aa940bbb761b2fe8997eb0e6ee710088b20b5,0,shaofengshi,2015-07-06 16:19:17+08:00,['08948b97f384e315701b1f54b1e3943bb013fd25'],4,23,27,14071500,2,1,1,1,9108
fa3bfd995639a500b0a442680717255c74916b5b,0,qianhao.zhou,2015-07-06 16:38:54+08:00,['56c3bac8b6bdbbeb25b3a57ced6ff419393166a5'],9,19,28,14071528,1,1,1,1,9108
8eafb268f692b5cd7f9b4d015f5baa1a7fa10156,0,shaofengshi,2015-07-06 17:48:51+08:00,['f54aa940bbb761b2fe8997eb0e6ee710088b20b5'],1,1,2,14071530,1,1,1,1,9108
42fc88ac583aeb0be66d763a527ceef96296649b,0,qianhao.zhou,2015-07-06 17:58:57+08:00,['fa3bfd995639a500b0a442680717255c74916b5b'],0,3,3,14071533,1,0,0,1,9108
142432c4ee55852e91913c8bd4c537ab3f11b84f,0,qianhao.zhou,2015-07-07 15:12:21+08:00,['56bb2a645125eb45bdb0b5628b50b32eb2ed98a4'],1,1,2,14071535,1,,,,9108
c711669aaa62f2d074c6940be99cb5496b4c7e62,1,Li Yang,2015-07-07 16:07:23+08:00,['8eafb268f692b5cd7f9b4d015f5baa1a7fa10156'],366,584,950,14072485,16,1,0.96031746,0.26984127,9108
628cb4f5834801dc57249eae782cf8ad91d68dd2,1,Li Yang,2015-07-07 16:29:26+08:00,['42fc88ac583aeb0be66d763a527ceef96296649b'],366,582,948,14073433,15,1,0.96031746,0.26984127,9108
c4092bb5a530a8ed2ae1d4c5b2391ae1a5d72b70,1,qianhao.zhou,2015-07-07 17:30:49+08:00,['c711669aaa62f2d074c6940be99cb5496b4c7e62'],17,21,38,14073471,9,1,1,1,9108
d852f0a29fc9934a9f28ec6a5aef5c0a2b19f919,1,qianhao.zhou,2015-07-07 17:47:29+08:00,['628cb4f5834801dc57249eae782cf8ad91d68dd2'],19,23,42,14073513,10,1,1,1,9108
6ea46ffe45ef66d39e4bd62bc27a69a5e960ec8c,0,honma,2015-07-07 20:12:47+08:00,['d852f0a29fc9934a9f28ec6a5aef5c0a2b19f919'],0,130,130,14073643,1,0.063492063,0.428571429,1,9109
6c69f2d1b2e4f06a42c3a14f485b88584f380222,0,Luke Han,2015-07-07 20:29:16+08:00,['56bb2a645125eb45bdb0b5628b50b32eb2ed98a4'],3,641,644,14074287,7,,,,9112
69c32eb4278f7735a84bb92c7e8bc8897d16fb05,0,Luke Han,2015-07-07 20:29:25+08:00,"['6c69f2d1b2e4f06a42c3a14f485b88584f380222', '142432c4ee55852e91913c8bd4c537ab3f11b84f']",1,1,2,14074289,1,,,,9112
e42eee69bab0b2f34d69b6e89138136e083fb395,1,shaofengshi,2015-07-08 10:20:48+08:00,['6ea46ffe45ef66d39e4bd62bc27a69a5e960ec8c'],107,110,217,14074506,2,0,0,1,9112
cc77a0f0799f9e2c131a96bbe81b52b06f3e829d,0,Li Yang,2015-07-08 11:16:20+08:00,['c4092bb5a530a8ed2ae1d4c5b2391ae1a5d72b70'],5,7,12,14074518,2,,,,9112
22b771501e0c2a895659fd313e9ff393cddd13fb,0,Li Yang,2015-07-08 13:37:18+08:00,['cc77a0f0799f9e2c131a96bbe81b52b06f3e829d'],1,1,2,14074520,1,,,,9112
62f94aa717067a44cd9ad3104264ec877d91e03c,0,Li Yang,2015-07-08 13:53:27+08:00,['e42eee69bab0b2f34d69b6e89138136e083fb395'],1,1,2,14074522,1,,,,9112
6f9a861ec4e35e6424a2d65cee339033662fffbe,1,qianhao.zhou,2015-07-08 16:23:40+08:00,['62f94aa717067a44cd9ad3104264ec877d91e03c'],13,28,41,14074563,5,,,,9113
f17119b871d2e58e625d4b1f3ededc6e8e824e36,1,shaofengshi,2015-07-08 17:50:28+08:00,['6f9a861ec4e35e6424a2d65cee339033662fffbe'],150,266,416,14074979,17,0.365853659,0.146341463,1,9114
eb86239c22bfb292ea854442848a8ee62be16d11,0,shaofengshi,2015-07-08 17:50:28+08:00,['f17119b871d2e58e625d4b1f3ededc6e8e824e36'],14,15,29,14075008,8,0,0,1,9114
ddac497a2cf62bccba8618829a03e3be1a030098,1,shaofengshi,2015-07-08 18:02:32+08:00,['eb86239c22bfb292ea854442848a8ee62be16d11'],5,25,30,14075038,5,0.176470588,1,1,9114
c7bb3640f83ae9f934311654715b0f3f52f8fea6,0,Li Yang,2015-07-08 18:11:51+08:00,['ddac497a2cf62bccba8618829a03e3be1a030098'],10,12,22,14075060,1,1,1,1,9114
460dd0264ede86f20ea96c3694041263d66c5712,1,Li Yang,2015-07-08 18:15:07+08:00,['c7bb3640f83ae9f934311654715b0f3f52f8fea6'],159,558,717,14075777,28,0.703703704,1,1,9127
5f0c6a6bc112ffcaa721be8e13a08117ae3d7105,1,honma,2015-07-09 13:18:11+08:00,['22b771501e0c2a895659fd313e9ff393cddd13fb'],17,12,29,14075806,1,0,0,1,9127
71b93be2a7728f33c32093c6c72b466c670a60c8,1,shaofengshi,2015-07-09 13:22:21+08:00,['460dd0264ede86f20ea96c3694041263d66c5712'],2,2,4,14075810,2,,,,9127
a3299889f6ccff6f46079fa5decc492356c5c83b,0,Luke Han,2015-07-09 16:53:14+08:00,['69c32eb4278f7735a84bb92c7e8bc8897d16fb05'],0,346,346,14076156,8,,,,9130
9634cee96398f64b8ebdf28de6cf5c8b7a1706d3,0,Luke Han,2015-07-09 20:37:04+08:00,['a3299889f6ccff6f46079fa5decc492356c5c83b'],115,182,297,14076453,33,,,,9130
73955ea03a8b3ba2334f400fc17359200c6acae6,0,Luke Han,2015-07-09 20:44:35+08:00,['9634cee96398f64b8ebdf28de6cf5c8b7a1706d3'],3,0,3,14076456,1,,,,9130
ba85eb1daa3f3bea835bd0757b7855dd20b568fa,0,Luke Han,2015-07-09 20:50:13+08:00,['73955ea03a8b3ba2334f400fc17359200c6acae6'],16,15,31,14076487,13,,,,9130
ae142dc878dd60635dbda89ced589f87b872ca01,0,Luke Han,2015-07-09 21:05:04+08:00,['ba85eb1daa3f3bea835bd0757b7855dd20b568fa'],14,14,28,14076515,13,,,,9130
80129ba12c6f9879863b80dee6219fa11e25519e,0,Luke Han,2015-07-10 10:25:45+08:00,['ae142dc878dd60635dbda89ced589f87b872ca01'],3,47,50,14076565,1,,,,9130
2ca45b1b05094546ab4edf2bf7628f954e866076,0,Luke Han,2015-07-10 14:29:00+08:00,['80129ba12c6f9879863b80dee6219fa11e25519e'],85,43,128,14076693,1,,,,9130
b0707b7334d97b57aeb3a6b6c12f18afe5a795a1,0,Luke Han,2015-07-10 14:35:18+08:00,['2ca45b1b05094546ab4edf2bf7628f954e866076'],83,13,96,14076789,2,,,,9130
10da13dc96b191780d37c21c8c8890b74f4acc73,0,Luke Han,2015-07-10 14:57:08+08:00,['b0707b7334d97b57aeb3a6b6c12f18afe5a795a1'],2,52,54,14076843,2,,,,9130
b532d7366971a29a05303e1acc87964595c732ba,1,Li Yang,2015-07-10 16:36:55+08:00,['71b93be2a7728f33c32093c6c72b466c670a60c8'],768,823,1591,14078434,26,1,1,1,9133
3508a037a60642db8aa781414355d0a5e4859d5b,0,Li Yang,2015-07-10 16:38:11+08:00,['b532d7366971a29a05303e1acc87964595c732ba'],23,7,30,14078464,4,1,0,0,9133
f775fede0a0d3e305ed6a066c37944d3c3b0b66e,0,Li Yang,2015-07-10 16:59:48+08:00,['3508a037a60642db8aa781414355d0a5e4859d5b'],29,21,50,14078514,6,0,0,0,9134
6f16140c50bb0cccd7dc06d83d76c60cfb7fe8a1,1,Li Yang,2015-07-13 13:33:48+08:00,['f775fede0a0d3e305ed6a066c37944d3c3b0b66e'],291,188,479,14078993,18,0.111111111,0.111111111,0,9134
a43074b71447aac799309e05f09a6ba93bb79ceb,0,Li Yang,2015-07-13 13:44:43+08:00,['5f0c6a6bc112ffcaa721be8e13a08117ae3d7105'],241,144,385,14079378,16,0.148148148,0.148148148,0.037037037,9134
21a5205ff65f2a2bb7aa780006498288c1a62938,0,qianhao.zhou,2015-07-13 14:54:39+08:00,['6f16140c50bb0cccd7dc06d83d76c60cfb7fe8a1'],1,1,2,14079380,1,,,,9134
cc86cf2d63d4c03c847a3e3f206539e63057103a,0,qianhao.zhou,2015-07-13 14:54:40+08:00,['21a5205ff65f2a2bb7aa780006498288c1a62938'],37,23,60,14079440,3,0.285714286,0.285714286,0,9134
86952c4678887ec96d259b72ff02651a9b684a3a,0,qianhao.zhou,2015-07-13 15:14:41+08:00,['a43074b71447aac799309e05f09a6ba93bb79ceb'],1,41,42,14079482,3,,,,9135
e63ae3cfd9b46abbd674cf3effcc96146ef0af70,0,Li Yang,2015-07-13 15:25:18+08:00,['86952c4678887ec96d259b72ff02651a9b684a3a'],99,64,163,14079645,5,0,0,0.466666667,9135
9d92afe01af9d3103105b7a3a7b96311c2dbebac,1,Li Yang,2015-07-13 15:37:00+08:00,['cc86cf2d63d4c03c847a3e3f206539e63057103a'],60,71,131,14079776,5,0,1,1,9135
14ad9141092c9bd652e78737744633dd4c024f3e,0,Luke Han,2015-07-13 16:25:19+08:00,['10da13dc96b191780d37c21c8c8890b74f4acc73'],193,48,241,14080017,3,,,,9135
25df02cea33ae3f9fc42ae09cf0d594adb8f2b1f,0,Luke Han,2015-07-13 17:04:04+08:00,"['e63ae3cfd9b46abbd674cf3effcc96146ef0af70', '14ad9141092c9bd652e78737744633dd4c024f3e']",591,1359,1950,14081967,62,,,,9135
4aed7b817fba2233b2f20ca797414ffac64ec754,0,Luke Han,2015-07-13 17:04:07+08:00,['25df02cea33ae3f9fc42ae09cf0d594adb8f2b1f'],15,67,82,14082049,4,,,,9135
9a54bdf1de7794a2fa2249ed359de15fe3efd114,0,shaofengshi,2015-07-13 17:49:50+08:00,['9d92afe01af9d3103105b7a3a7b96311c2dbebac'],0,1,1,14082050,1,,,,9135
8cf32cf0e32784efabd2a38ee4d97f178898a8a0,0,shaofengshi,2015-07-13 17:50:43+08:00,['e63ae3cfd9b46abbd674cf3effcc96146ef0af70'],0,1,1,14082051,1,,,,9135
08e6187777d8e89fbb87ba2dd64cfff7e33fa3ae,0,Luke Han,2015-07-13 18:35:17+08:00,['4aed7b817fba2233b2f20ca797414ffac64ec754'],86,147,233,14082284,12,,,,9135
aa768ea8e98e6a1f0259f59d84f63ce885d00786,0,Luke Han,2015-07-13 18:35:52+08:00,"['08e6187777d8e89fbb87ba2dd64cfff7e33fa3ae', '8cf32cf0e32784efabd2a38ee4d97f178898a8a0']",0,1,1,14082285,1,,,,9135
dfee5c4bc855a5aada69a7afae8a8b09d539f6ae,0,Luke Han,2015-07-13 18:58:45+08:00,['14ad9141092c9bd652e78737744633dd4c024f3e'],16,18,34,14082319,15,,,,9135
ef0de5ea0cca2db7ba92cb2eae88d62118f6d317,1,Zhong Jian,2015-07-13 19:03:08+08:00,['aa768ea8e98e6a1f0259f59d84f63ce885d00786'],4,5,9,14082328,2,1,1,1,9135
3da37f9fcded4c42dddc1ddf2292cbf27ecabb5c,0,Luke Han,2015-07-13 19:26:31+08:00,['dfee5c4bc855a5aada69a7afae8a8b09d539f6ae'],4,5,9,14082337,2,1,1,1,9135
51d9e853f54a7ef14070810efb8c21264e6ef119,0,Luke Han,2015-07-13 19:27:02+08:00,['3da37f9fcded4c42dddc1ddf2292cbf27ecabb5c'],154,4,158,14082495,3,,,,9135
c292c23ae8a0ecf414db36df637a1ea8afb1f5b8,0,Luke Han,2015-07-13 20:02:47+08:00,['51d9e853f54a7ef14070810efb8c21264e6ef119'],14,14,28,14082523,13,,,,9135
3b6b45a9bfd04a7d320cacce34da9ed6b352a4d4,0,Luke Han,2015-07-13 20:03:38+08:00,['c292c23ae8a0ecf414db36df637a1ea8afb1f5b8'],14,14,28,14082551,13,,,,9135
66fdb4b2f9cd22802d38475620310de7b6b4236c,0,Li Yang,2015-07-14 10:43:06+08:00,['ef0de5ea0cca2db7ba92cb2eae88d62118f6d317'],6,11,17,14082568,1,1,1,1,9135
758a639c0c2115502ce5c5fac67b3c4a0a8a3e7f,0,Li Yang,2015-07-14 10:48:28+08:00,['9a54bdf1de7794a2fa2249ed359de15fe3efd114'],6,11,17,14082585,1,1,1,1,9135
10c35cb4b5b68d6ab869286065c9289e3b91c127,0,Zhong Jian,2015-07-14 13:56:29+08:00,['66fdb4b2f9cd22802d38475620310de7b6b4236c'],2,3,5,14082590,3,0,1,0,9135
672457ba43bacc9a709ba0f3da0075636ee68dc0,0,shaofengshi,2015-07-14 16:35:16+08:00,['758a639c0c2115502ce5c5fac67b3c4a0a8a3e7f'],0,2,2,14082592,2,,,,9135
98a8e8cc030aa7198c21cb61d9afafec3a0c01d5,0,Luke Han,2015-07-15 13:05:06+08:00,['ef0de5ea0cca2db7ba92cb2eae88d62118f6d317'],24959,0,24959,14107551,244,0.03030303,0.162878788,0.089015152,9135
edf4a0f2e5ba3f7463e697b79e706c46ad5df1a1,0,Luke Han,2015-07-15 13:07:00+08:00,['98a8e8cc030aa7198c21cb61d9afafec3a0c01d5'],0,24066,24066,14131617,230,0.96969697,0.837121212,0.910984848,9365
0170d51ed54267175b90c598a30fe537a566ff14,0,Luke Han,2015-07-15 13:07:16+08:00,"['edf4a0f2e5ba3f7463e697b79e706c46ad5df1a1', '10c35cb4b5b68d6ab869286065c9289e3b91c127']",8,14,22,14131639,4,,,,9365
97fe0573510e80618141d18c7dfbc6423a00da0e,1,Li Yang,2015-07-15 14:33:11+08:00,['672457ba43bacc9a709ba0f3da0075636ee68dc0'],1133,862,1995,14133634,57,1,0.234375,0.625,9366
54592e5ccc12d1b5d08a60e26a1db26a5d95e65f,0,Luke Han,2015-07-15 14:43:30+08:00,"['0170d51ed54267175b90c598a30fe537a566ff14', '3b6b45a9bfd04a7d320cacce34da9ed6b352a4d4']",159,87,246,14133880,3,,,,9366
33f17daa8e81fb87346083109f3f692b2c05520c,0,shaofengshi,2015-07-15 14:56:28+08:00,['54592e5ccc12d1b5d08a60e26a1db26a5d95e65f'],93,26,119,14133999,5,,,,9366
db73eb5858ad355a860482c7b8557d3de4cf7573,0,shaofengshi,2015-07-15 15:30:26+08:00,['33f17daa8e81fb87346083109f3f692b2c05520c'],320,0,320,14134319,13,0.052631579,0.052631579,0.052631579,9366
91193115018fe9fbf9619b592044671d75cf4f33,1,shaofengshi,2015-07-15 15:40:01+08:00,['97fe0573510e80618141d18c7dfbc6423a00da0e'],75,27,102,14134421,4,,,,9366
a2ed53a37a55558b4cd9029f94c44b804b7dfa75,0,shaofengshi,2015-07-15 15:50:53+08:00,['91193115018fe9fbf9619b592044671d75cf4f33'],325,2,327,14134748,14,0.052631579,0.052631579,0.052631579,9366
0e9543bb098f71c52599d68a952d0f92ac0e08ce,0,shaofengshi,2015-07-15 17:31:22+08:00,['db73eb5858ad355a860482c7b8557d3de4cf7573'],2,12,14,14134762,1,1,1,1,9366
883a8e825549383176d9697a97b813b253f86c36,0,shaofengshi,2015-07-15 17:33:31+08:00,['a2ed53a37a55558b4cd9029f94c44b804b7dfa75'],2,12,14,14134776,1,1,1,1,9366
f716adba9a87ac34e69cf76307d8d3518d501fa2,1,honma,2015-07-15 17:42:15+08:00,['883a8e825549383176d9697a97b813b253f86c36'],0,29015,29015,14163791,87,0.161067069,0.302629923,0.304139927,9453
e32a0298f5a52647e4824cabc29c84b35bbf41b5,0,Luke Han,2015-07-15 18:01:42+08:00,['54592e5ccc12d1b5d08a60e26a1db26a5d95e65f'],2915,283,3198,14166989,52,,,,9454
c29ed946b20dbf5504ceffdc17d992a132b2276f,0,Luke Han,2015-07-15 18:02:14+08:00,['e32a0298f5a52647e4824cabc29c84b35bbf41b5'],0,517,517,14167506,7,,,,9461
6496cac2bf2be3dd79d051b043abb47a826418c8,0,Luke Han,2015-07-15 18:03:43+08:00,"['c29ed946b20dbf5504ceffdc17d992a132b2276f', '0e9543bb098f71c52599d68a952d0f92ac0e08ce']",414,37,451,14167957,18,,,,9461
71111da12bfe2bc7c2600633dd7f48a8f454fc9d,0,Luke Han,2015-07-15 20:13:59+08:00,['6496cac2bf2be3dd79d051b043abb47a826418c8'],33,32,65,14168022,7,,,,9461
fe8113303c6f4b46df2d1a7fd9f6c87c473c4c0a,0,Luke Han,2015-07-15 20:47:44+08:00,['71111da12bfe2bc7c2600633dd7f48a8f454fc9d'],75,11,86,14168108,9,,,,9461
2bd5fbb0b8928ff35385884418ec94f91555c284,1,Zhong Jian,2015-07-16 10:59:14+08:00,['fe8113303c6f4b46df2d1a7fd9f6c87c473c4c0a'],1,27,28,14168136,3,0.75,0.75,1,9461
b59b43b325f181c6aab45a70fba9935c54cd8f21,0,Luke Han,2015-07-16 13:49:17+08:00,['fe8113303c6f4b46df2d1a7fd9f6c87c473c4c0a'],2,2,4,14168140,2,,,,9461
aef72e5d7d8187d6b46ae026ed3f8e7422350ef2,0,Luke Han,2015-07-16 13:49:25+08:00,"['b59b43b325f181c6aab45a70fba9935c54cd8f21', '2bd5fbb0b8928ff35385884418ec94f91555c284']",1,27,28,14168168,3,,,,9461
54e7b4a4d71958c2ac71ed2a04d840155b2d40a8,0,shaofengshi,2015-07-16 15:11:59+08:00,['aef72e5d7d8187d6b46ae026ed3f8e7422350ef2'],68,0,68,14168236,1,0,0,0,9461
40f2c9d678329978e10c2a4a6812a0d63aa3a27e,1,qianhao.zhou,2015-07-16 15:49:40+08:00,['f716adba9a87ac34e69cf76307d8d3518d501fa2'],23,351,374,14168610,11,0.635036496,1,1,9467
05d062c11eade1d15eee57104aa1be2ada6c646e,0,Zhong Jian,2015-07-16 15:55:31+08:00,['54e7b4a4d71958c2ac71ed2a04d840155b2d40a8'],11,15,26,14168636,3,1,1,1,9467
1510061095284d4810b606af005e4d9d60b6e333,0,honma,2015-07-16 18:08:29+08:00,['40f2c9d678329978e10c2a4a6812a0d63aa3a27e'],8,19,27,14168663,8,,,,9472
7bca224aa8932c306894232e4a13e256a2ba028e,1,shaofengshi,2015-07-16 19:37:07+08:00,['1510061095284d4810b606af005e4d9d60b6e333'],24,72,96,14168759,4,0.432432432,1,1,9472
824f7e6e715867b7762a0ec9a5b4cc8c503e481e,0,honma,2015-07-16 20:06:19+08:00,['7bca224aa8932c306894232e4a13e256a2ba028e'],19,26,45,14168804,7,,,,9472
660c197dad040a400d13f3268bcd0d2ce31a53eb,0,honma,2015-07-16 21:45:43+08:00,['824f7e6e715867b7762a0ec9a5b4cc8c503e481e'],81,36,117,14168921,2,,,,9472
2928b7f95ae80280b1d9af20b4b8d6d9ff6673d8,0,qianhao.zhou,2015-07-17 14:58:50+08:00,['660c197dad040a400d13f3268bcd0d2ce31a53eb'],3,7,10,14168931,2,0,0,1,9472
86a9f9984dd05bdb40da7baf39cf9cfbf30436b5,0,qianhao.zhou,2015-07-17 17:23:24+08:00,['2928b7f95ae80280b1d9af20b4b8d6d9ff6673d8'],43,70,113,14169044,11,0,0,0,9473
e619be785fc76c963a6fe27fe58fe60783583265,1,Zhong Jian,2015-07-17 17:54:49+08:00,['86a9f9984dd05bdb40da7baf39cf9cfbf30436b5'],2,5,7,14169051,3,1,1,0.75,9473
97a91683ae9ee970a20b90bac24e983605f91e87,0,shaofengshi,2015-07-20 11:32:37+08:00,['05d062c11eade1d15eee57104aa1be2ada6c646e'],14,76,90,14169141,13,0.279069767,0.860465116,0.558139535,9473
a089343b485c830f0cd70d99c9e93c15d9f4bbde,0,Luke Han,2015-07-20 11:37:52+08:00,['05d062c11eade1d15eee57104aa1be2ada6c646e'],99,85,184,14169325,14,,,,9473
6ba7784e8cd645e363b5dc8feefada9bb1eedd86,0,Luke Han,2015-07-20 11:38:21+08:00,['a089343b485c830f0cd70d99c9e93c15d9f4bbde'],0,147,147,14169472,3,,,,9476
fbca7be39dcaec76ec004c52f36a221c1f18deda,0,Luke Han,2015-07-20 11:38:36+08:00,"['6ba7784e8cd645e363b5dc8feefada9bb1eedd86', '97a91683ae9ee970a20b90bac24e983605f91e87']",14,76,90,14169562,13,,,,9476
b5e13eb9c0be56cf2d4101c699da6fbc336e8ef0,0,shaofengshi,2015-07-20 12:41:24+08:00,['fbca7be39dcaec76ec004c52f36a221c1f18deda'],1,3,4,14169566,1,1,1,0,9476
0ccf5ef7585f14b2ece9ee98c720822fdd8bbe0a,0,shaofengshi,2015-07-20 12:41:24+08:00,['b5e13eb9c0be56cf2d4101c699da6fbc336e8ef0'],1,1,2,14169568,1,,,,9476
99aba210a36e56b7fccb3b3cf2efee8603ca1779,0,shaofengshi,2015-07-20 13:03:46+08:00,['0ccf5ef7585f14b2ece9ee98c720822fdd8bbe0a'],1,1,2,14169570,1,,,,9476
de59144c7aa09975d5ac71ef5626d072b1d0229c,0,honma,2015-07-20 13:14:54+08:00,['99aba210a36e56b7fccb3b3cf2efee8603ca1779'],52,18,70,14169640,4,,,,9476
70ced5c3a78508b3227f37308c78b52406e9718a,0,Luke Han,2015-07-20 13:17:59+08:00,['fbca7be39dcaec76ec004c52f36a221c1f18deda'],4,52,56,14169696,4,,,,9478
f2ad9a7fd7fe4e0acb64a25d9fb27057075276e4,0,Luke Han,2015-07-20 13:23:45+08:00,['70ced5c3a78508b3227f37308c78b52406e9718a'],1,2,3,14169699,2,,,,9478
39a9d740d55e50778dfd72010e03a63dca3c8002,0,Luke Han,2015-07-20 13:25:56+08:00,"['f2ad9a7fd7fe4e0acb64a25d9fb27057075276e4', 'de59144c7aa09975d5ac71ef5626d072b1d0229c']",55,23,78,14169777,6,,,,9478
6de389c82588c91cfeb722c6de18cbbf72ae3132,1,shaofengshi,2015-07-20 14:30:30+08:00,['39a9d740d55e50778dfd72010e03a63dca3c8002'],1,12,13,14169790,3,0.75,0.75,1,9478
572828ab7c8fb3281076c46b174908b582cb96ce,1,shaofengshi,2015-07-20 14:39:46+08:00,['e619be785fc76c963a6fe27fe58fe60783583265'],1,3,4,14169794,1,1,1,0,9478
0bb0f3c9047b03f9c7f6e3dc74846a03b250c672,1,shaofengshi,2015-07-20 14:47:28+08:00,['572828ab7c8fb3281076c46b174908b582cb96ce'],3,7,10,14169804,1,0.25,0.25,0,9478
56ecc20136fb8e1130d076b9311f62aa0199ae66,1,shaofengshi,2015-07-20 15:03:47+08:00,['0bb0f3c9047b03f9c7f6e3dc74846a03b250c672'],0,13,13,14169817,3,0.666666667,0.666666667,1,9478
16c9bfda1ee52d70f58bc28119b4da77c07d7519,0,shaofengshi,2015-07-20 17:37:27+08:00,['6de389c82588c91cfeb722c6de18cbbf72ae3132'],0,12,12,14169829,4,0.6,1,1,9478
1541adc70acf3f17093fcbfa1b5a74f6021fc269,0,Li Yang,2015-07-21 08:28:12+08:00,['56ecc20136fb8e1130d076b9311f62aa0199ae66'],0,24,24,14169853,2,,,,9478
e12e80c9fa388abb02549df72696ef67ee268306,1,Li Yang,2015-07-21 08:28:13+08:00,['1541adc70acf3f17093fcbfa1b5a74f6021fc269'],952,1637,2589,14172442,81,1,1,1,9487
6395fc5b74d1682be8dc9ed623a54fd44adfdff5,0,Zhong Jian,2015-07-21 10:35:42+08:00,['16c9bfda1ee52d70f58bc28119b4da77c07d7519'],1,7,8,14172450,4,1,1,0.333333333,9487
0981c3ccac372e5aead41e400f0c27a58a9b115a,0,Li Yang,2015-07-21 15:47:25+08:00,['e12e80c9fa388abb02549df72696ef67ee268306'],11,50,61,14172511,3,0,1,1,9487
4cfe3bc750c56f47a998e5fac79965c4c1da4898,0,Luke Han,2015-07-21 15:59:43+08:00,"['c292c23ae8a0ecf414db36df637a1ea8afb1f5b8', 'a0d71662fe90c59fd9b33705bf09ea896a42921f']",0,0,0,14172511,0,,,,9487
d809f37df4dde2f84eda195744d9d18c05bbab76,0,Luke Han,2015-07-21 16:17:56+08:00,['4cfe3bc750c56f47a998e5fac79965c4c1da4898'],25152,6,25158,14197669,246,0.03030303,0.162878788,0.089015152,9488
df95459f4af740f2fb9b8d5067a37cbf2d5e9975,0,Luke Han,2015-07-21 16:20:24+08:00,['0981c3ccac372e5aead41e400f0c27a58a9b115a'],19295,6,19301,14216970,111,0,0.172344689,0.094188377,9489
7cd023776443c539cdf782617d837af46a02f3cf,0,Luke Han,2015-07-21 16:42:31+08:00,['6395fc5b74d1682be8dc9ed623a54fd44adfdff5'],53,95,148,14217118,4,,,,9489
55f35949dff5566aaf87dd2e15de8681a3a0f6ab,0,Li Yang,2015-07-21 17:05:11+08:00,['df95459f4af740f2fb9b8d5067a37cbf2d5e9975'],218,0,218,14217336,2,0.545454545,0,0.090909091,9489
d894530509f362a5e3aea9582115e34b7d0c97a0,1,Li Yang,2015-07-22 12:12:32+08:00,['55f35949dff5566aaf87dd2e15de8681a3a0f6ab'],34,34,68,14217404,312,,,,9489
6a06cc24a9d9947eb671a635af6e632ea906d096,1,shaofengshi,2015-07-22 14:26:17+08:00,['d894530509f362a5e3aea9582115e34b7d0c97a0'],0,160,160,14217564,1,0.1625,0.375,1,9490
79d49d00a9c078d3da8be8012e57d3a97d79d316,1,Li Yang,2015-07-22 14:45:24+08:00,['6a06cc24a9d9947eb671a635af6e632ea906d096'],164,2270,2434,14219998,25,,,,9510
aaac013922d907cc35cbe21e9680d7f61bbc2961,1,shaofengshi,2015-07-22 14:56:52+08:00,['7cd023776443c539cdf782617d837af46a02f3cf'],6,179,185,14220183,2,0.164556962,0.379746835,1,9511
60fd704a8de1ff92b6efac411831433aaf287c00,0,shaofengshi,2015-07-22 15:42:04+08:00,['79d49d00a9c078d3da8be8012e57d3a97d79d316'],1,2,3,14220186,1,0,1,1,9511
ee611e0cebedb7435e47afe1a0ee9c0af84c0be2,0,shaofengshi,2015-07-22 16:34:34+08:00,['aaac013922d907cc35cbe21e9680d7f61bbc2961'],5,3,8,14220194,1,,,,9511
eb74e0953ff5e0d628a68ee49b28ee06317caaa6,0,qianhao.zhou,2015-07-22 17:43:21+08:00,['60fd704a8de1ff92b6efac411831433aaf287c00'],16,15,31,14220225,5,0.75,0.75,0,9511
1a0f3d39cbcd018ce3734948337f9d05ada76e03,0,qianhao.zhou,2015-07-22 17:43:21+08:00,['eb74e0953ff5e0d628a68ee49b28ee06317caaa6'],10,8,18,14220243,1,,,,9511
75da28ca1f768d6554e1ede11c5b8c19304b293c,1,Li Yang,2015-07-22 18:49:46+08:00,['1a0f3d39cbcd018ce3734948337f9d05ada76e03'],1675,755,2430,14222673,130,0.823232323,0.292929293,0.363636364,9512
245cc899c818937f2334e1678b875741c6170866,0,Li Yang,2015-07-22 21:17:54+08:00,['75da28ca1f768d6554e1ede11c5b8c19304b293c'],175,175,350,14223023,26,1,1,1,9514
87f16c38cc86448211e1de16b9b15944ba760d20,0,Li Yang,2015-07-22 21:35:03+08:00,['245cc899c818937f2334e1678b875741c6170866'],68,111,179,14223202,8,1,1,0,9515
730b90eb5d8ff7e8f167e61d53c9b9e48492ac96,1,Li Yang,2015-07-22 22:04:32+08:00,['87f16c38cc86448211e1de16b9b15944ba760d20'],182,123,305,14223507,23,0,1,0.5,9515
a80eba243ac3ebb4c1de47ce6fa4a813edcce146,1,Li Yang,2015-07-23 13:53:49+08:00,['730b90eb5d8ff7e8f167e61d53c9b9e48492ac96'],12,14,26,14223533,1,1,1,1,9515
5500cbba042975699a98b8ccb75ffb364ae5c199,0,Li Yang,2015-07-23 14:18:58+08:00,['a80eba243ac3ebb4c1de47ce6fa4a813edcce146'],10,62,72,14223605,2,1,1,1,9515
8b6d21133aab18b65ae571d9463089283b7dcbe1,0,Li Yang,2015-07-23 14:48:43+08:00,['5500cbba042975699a98b8ccb75ffb364ae5c199'],2,2,4,14223609,2,,,,9515
83b246ab2517a87c09b75371a718b5602ab3315e,0,Li Yang,2015-07-23 15:35:36+08:00,['8b6d21133aab18b65ae571d9463089283b7dcbe1'],21,22,43,14223652,4,,,,9515
f84f072547edfbd08ac93fd59e9b5a6697f05de5,0,shaofengshi,2015-07-23 19:55:48+08:00,['ee611e0cebedb7435e47afe1a0ee9c0af84c0be2'],9,16,25,14223677,3,,,,9515
9f4da05fb1c7124112c0a3930aa0405e2de59e03,1,Li Yang,2015-07-24 06:02:10+08:00,['83b246ab2517a87c09b75371a718b5602ab3315e'],1699,869,2568,14226245,260,0,0,0,9516
6abc7d804f1849d90c29c37d3eaf775e0d65fbec,0,Li Yang,2015-07-24 06:44:44+08:00,['9f4da05fb1c7124112c0a3930aa0405e2de59e03'],8,16,24,14226269,1,0.555555556,0.555555556,1,9516
ee96ac13bdbe7133e9b4e1d41ca08b3b2d6f7348,0,Li Yang,2015-07-24 07:17:38+08:00,['6abc7d804f1849d90c29c37d3eaf775e0d65fbec'],3,3,6,14226275,8,,,,9518
9cf375320ed5dbb3593e5044bbe353772e2b5cf1,1,Li Yang,2015-07-24 08:58:14+08:00,['ee96ac13bdbe7133e9b4e1d41ca08b3b2d6f7348'],40,21,61,14226336,6,1,1,1,9518
0d9aa17e15f9f16cd8132a6f9429ffaed36324b1,0,Li Yang,2015-07-24 10:24:53+08:00,['9cf375320ed5dbb3593e5044bbe353772e2b5cf1'],2,2,4,14226340,1,,,,9518
90368f6ca9abb0c81001cf0656438a87674d610f,1,shaofengshi,2015-07-24 21:19:40+08:00,['f84f072547edfbd08ac93fd59e9b5a6697f05de5'],4,226,230,14226570,4,0.537313433,0.589552239,0.940298507,9519
28f15c7d35b44a7478176f8b2327069ea953751c,0,shaofengshi,2015-07-27 11:16:45+08:00,['90368f6ca9abb0c81001cf0656438a87674d610f'],3,176,179,14226749,5,0.228346457,0.409448819,1,9519
9fa8ea7682f0712df379afc8f9d038c72d9f9ec7,0,honma,2015-07-27 12:49:22+08:00,['28f15c7d35b44a7478176f8b2327069ea953751c'],1,3,4,14226753,1,0,0,1,9519
7e228a65db5f2becdbb3fb10d4e0c64fd2882d49,0,honma,2015-07-27 12:49:22+08:00,['9fa8ea7682f0712df379afc8f9d038c72d9f9ec7'],44,139,183,14226936,6,0,1,1,9520
d95065f399e3b96561cc3b724da5bf0bd08d49b0,0,shaofengshi,2015-07-27 13:22:24+08:00,['7e228a65db5f2becdbb3fb10d4e0c64fd2882d49'],1,6,7,14226943,2,1,1,1,9520
5beffb2bddb2dad6adb032e1cc4bf30ebf69d022,0,shaofengshi,2015-07-27 13:22:24+08:00,['d95065f399e3b96561cc3b724da5bf0bd08d49b0'],3,3,6,14226949,3,1,1,,9520
8ff556e83f0b1ee9cdc96a5ad5700472bd52240d,0,shaofengshi,2015-07-27 13:36:34+08:00,['0d9aa17e15f9f16cd8132a6f9429ffaed36324b1'],5,4,9,14226958,3,1,1,,9520
a6b4490cc5c4e1d67fbaa0b281109ae7cf9db394,0,honma,2015-07-27 13:40:41+08:00,['5beffb2bddb2dad6adb032e1cc4bf30ebf69d022'],1,1,2,14226960,1,,,,9520
f1c3f484a0bfab4946504ef593b2adcba9e96c08,0,honma,2015-07-27 13:40:41+08:00,['a6b4490cc5c4e1d67fbaa0b281109ae7cf9db394'],2,6,8,14226968,1,0,1,1,9520
d8fcfeac84f4fce4217ec955d0cfbd7303332e4c,1,shaofengshi,2015-07-27 14:47:43+08:00,['8ff556e83f0b1ee9cdc96a5ad5700472bd52240d'],3,18,21,14226989,4,0.5,1,0.833333333,9520
cc1ca2d32b508a758bd85d3da58006d70eeb9104,0,shaofengshi,2015-07-27 15:06:36+08:00,['d8fcfeac84f4fce4217ec955d0cfbd7303332e4c'],8,10,18,14227007,1,0,0,1,9520
aad62c256ece98ee33cc9cdc9462f44b3a353ec9,1,shaofengshi,2015-07-27 15:11:10+08:00,['f1c3f484a0bfab4946504ef593b2adcba9e96c08'],11,15,26,14227033,2,0,1,1,9520
8a2e128c12460d63e581ceef182f9b287da623d6,0,shaofengshi,2015-07-27 15:11:10+08:00,['aad62c256ece98ee33cc9cdc9462f44b3a353ec9'],20,24,44,14227077,1,0,0,1,9520
ea7d8f6472b2407d4db2f3e81d1f3ada7ff91dc0,0,qianhao.zhou,2015-07-28 15:21:49+08:00,['8a2e128c12460d63e581ceef182f9b287da623d6'],9,21,30,14227107,3,0.833333333,1,1,9520
770f6e0412699a7b52fbcac68a1cc89ba8b8f2e9,0,honma,2015-07-29 13:23:59+08:00,['ea7d8f6472b2407d4db2f3e81d1f3ada7ff91dc0'],15,15,30,14227137,12,,,,9520
df63689f0b6772137846b0ec6447fd20aa8d964c,0,honma,2015-07-29 13:31:03+08:00,['770f6e0412699a7b52fbcac68a1cc89ba8b8f2e9'],1,9,10,14227147,1,,,,9520
9c4e3e3e12d7a52816d84932492d35298062cc11,0,shaofengshi,2015-07-29 13:58:26+08:00,['df63689f0b6772137846b0ec6447fd20aa8d964c'],8,10,18,14227165,1,0,0,1,9520
244f9fc6a554de3eaa5206f782513c11478ac7ee,0,shaofengshi,2015-07-29 14:56:58+08:00,['cc1ca2d32b508a758bd85d3da58006d70eeb9104'],0,2,2,14227167,1,0,0,1,9520
2b7898d08d284c0760080bb08002893b7075b594,0,shaofengshi,2015-07-29 15:36:15+08:00,['9c4e3e3e12d7a52816d84932492d35298062cc11'],1,22,23,14227190,5,0.45,0.85,1,9520
22ba4a92767681ec4f0fabaf774ac558ddc1986e,1,shaofengshi,2015-07-29 15:44:10+08:00,['244f9fc6a554de3eaa5206f782513c11478ac7ee'],0,31,31,14227221,8,0.3,1,1,9520
53a56720f065ddb11b4aeb73c5b9810d35e472dd,0,qianhao.zhou,2015-07-29 16:35:33+08:00,['22ba4a92767681ec4f0fabaf774ac558ddc1986e'],5,5,10,14227231,2,,,,9520
37fabd5dcdade25ba5e78cd4d55464d7f139286b,1,qianhao.zhou,2015-07-29 16:35:33+08:00,['53a56720f065ddb11b4aeb73c5b9810d35e472dd'],36,35,71,14227302,2,1,1,1,9520
225a1d0ab74fcd84941bce965ffff05ec34f14cf,0,Zhong Jian,2015-07-29 17:03:32+08:00,['2b7898d08d284c0760080bb08002893b7075b594'],3,47,50,14227352,9,0.777777778,0.888888889,0.888888889,9520
41da3a90ea50ae017e7a47fd26d85a9d2f0fcc14,0,shaofengshi,2015-07-29 17:27:05+08:00,['225a1d0ab74fcd84941bce965ffff05ec34f14cf'],2,20,22,14227374,2,0.5,0.5,1,9520
86fdca15e656140ad5d7f59929c0e343e9c74849,0,shaofengshi,2015-07-31 10:24:20+08:00,['37fabd5dcdade25ba5e78cd4d55464d7f139286b'],19,19,38,14227412,19,,,,9520
18607980786816089c5d91966c8dc1ef2d3fbcd7,0,shaofengshi,2015-07-31 15:12:40+08:00,['86fdca15e656140ad5d7f59929c0e343e9c74849'],3,16,19,14227431,3,0,0,0.2,9520
cc278ca993062a3330244e38c40b5fe2faa23531,1,Zhong Jian,2015-07-31 17:27:21+08:00,['18607980786816089c5d91966c8dc1ef2d3fbcd7'],312,1039,1351,14228782,33,0.811926606,1,0.834862385,9522
9f72e6728202d13d3a297db0355555a712ebfc89,1,qianhao.zhou,2015-07-31 17:45:12+08:00,['cc278ca993062a3330244e38c40b5fe2faa23531'],125,1895,2020,14230802,25,0.768939394,0.903409091,0.693181818,9544
f4252ad2995c1809b6c1def49bd6c91389bd9ec4,0,Zhong Jian,2015-07-31 18:10:58+08:00,['9f72e6728202d13d3a297db0355555a712ebfc89'],2,6,8,14230810,1,,,,9544
5519012ad9224eeda74a4acae26212dde976a606,1,honma,2015-08-03 14:45:27+08:00,['41da3a90ea50ae017e7a47fd26d85a9d2f0fcc14'],42,77,119,14230929,4,1,0,1,9544
e36270c4dea04ed3b750eec151c29a5d8c02713f,0,honma,2015-08-04 11:45:54+08:00,['5519012ad9224eeda74a4acae26212dde976a606'],5,13,18,14230947,2,0,1,1,9544
7dc745754029045b1057f455e01ba65db2032314,1,honma,2015-08-04 11:45:54+08:00,['e36270c4dea04ed3b750eec151c29a5d8c02713f'],9399,8785,18184,14249131,427,1,0.48850046,0.523459062,9547
1c261c76af55670b7b19753f8ce740e3ba713985,0,honma,2015-08-04 11:45:55+08:00,['7dc745754029045b1057f455e01ba65db2032314'],0,19,19,14249150,3,,,,9549
3d7a1811ee163eaa2a881e17fd6d5b38318cb2f5,0,Luke Han,2015-08-04 14:33:45+08:00,['1c261c76af55670b7b19753f8ce740e3ba713985'],138,126,264,14249414,6,,,,9550
361d9851337226d6e5225a4a9afdc8ae2075ccd5,0,Luke Han,2015-08-04 14:34:04+08:00,['3d7a1811ee163eaa2a881e17fd6d5b38318cb2f5'],0,18,18,14249432,1,,,,9551
e7bf7fbb2bb3e459e85f73287e9d1fe22e3b68a8,0,Luke Han,2015-08-04 19:32:35+08:00,['361d9851337226d6e5225a4a9afdc8ae2075ccd5'],55,172,227,14249659,15,,,,9555
4339e2ba56ff0c244e5d3dbf690ac92fc4f7950b,0,Luke Han,2015-08-04 20:17:02+08:00,['e7bf7fbb2bb3e459e85f73287e9d1fe22e3b68a8'],4,4,8,14249667,2,,,,9555
5dd0a1b6a0222001a6e1e16e973ddabfdd07044e,0,honma,2015-08-05 11:01:14+08:00,['4339e2ba56ff0c244e5d3dbf690ac92fc4f7950b'],5,12,17,14249684,4,0,1,1,9555
1c67f8de595e545a1df4626b037236020b5fda01,0,honma,2015-08-05 11:05:48+08:00,['f4252ad2995c1809b6c1def49bd6c91389bd9ec4'],14,13,27,14249711,13,,,,9555
9a6fa9c13957b01b8a3abbce4dfc55d549469b0e,0,honma,2015-08-05 11:06:59+08:00,['1c67f8de595e545a1df4626b037236020b5fda01'],11,107,118,14249829,4,0,1,1,9556
1b5ac7c2d84207d69c6824697845a26a58596127,1,honma,2015-08-05 14:42:15+08:00,['9a6fa9c13957b01b8a3abbce4dfc55d549469b0e'],169,187,356,14250185,7,0,0,0.814814815,9556
bbcc877383fe8032ea4e877df1886ae7a9377506,0,qianhao.zhou,2015-08-05 14:46:51+08:00,['5dd0a1b6a0222001a6e1e16e973ddabfdd07044e'],31,82,113,14250298,2,0,0.897435897,1,9556
e59580086d6b04b6f399cfc94bf75a15573836f6,1,qianhao.zhou,2015-08-05 14:48:19+08:00,['1b5ac7c2d84207d69c6824697845a26a58596127'],32,80,112,14250410,2,0,0.897435897,1,9556
eb34f62963dddcd8704ec9c7236910d083ab5e65,0,Zhong Jian,2015-08-05 15:02:23+08:00,['bbcc877383fe8032ea4e877df1886ae7a9377506'],1,1,2,14250412,1,,,,9556
e5a17982f6a320712bb6f6b90101850ef61eb73f,0,Zhong Jian,2015-08-05 15:06:17+08:00,['e59580086d6b04b6f399cfc94bf75a15573836f6'],1,1,2,14250414,1,,,,9556
bce79ed338a614fa8966a14dffb657bdda051d1f,0,qianhao.zhou,2015-08-05 17:15:57+08:00,['e5a17982f6a320712bb6f6b90101850ef61eb73f'],43,57,100,14250514,7,1,1,1,9556
f2951e2ae605a9d90b08af6ecf7b95529c2406da,0,qianhao.zhou,2015-08-06 10:56:03+08:00,['eb34f62963dddcd8704ec9c7236910d083ab5e65'],10,27,37,14250551,1,1,1,1,9556
fe68980c8467f180bd75b5ce08bdea688c2755bc,1,honma,2015-08-06 12:34:23+08:00,['f2951e2ae605a9d90b08af6ecf7b95529c2406da'],3,5,8,14250559,2,0,1,0,9556
12247c2b92d878e9817c733af029905c5a895f0d,0,honma,2015-08-06 12:41:25+08:00,['fe68980c8467f180bd75b5ce08bdea688c2755bc'],14,11,25,14250584,1,,,,9556
b234587bde15aede487e4991b5641ceca0c0b541,0,honma,2015-08-06 12:41:29+08:00,['12247c2b92d878e9817c733af029905c5a895f0d'],118,0,118,14250702,4,0.5,0,0,9556
60c9e5eef61fdf7eeeddb6fcf43eb3cf79509078,0,honma,2015-08-06 13:37:32+08:00,['b234587bde15aede487e4991b5641ceca0c0b541'],9,6,15,14250717,1,,,,9556
2483f35f540b8df4f9abf14673aafdd69c17cc8b,0,Zhong Jian,2015-08-06 13:40:18+08:00,['60c9e5eef61fdf7eeeddb6fcf43eb3cf79509078'],5,21,26,14250743,4,1,1,0.80952381,9556
ee15d5b183829a5f63672dd94e56cda77585e942,1,Zhong Jian,2015-08-06 13:45:09+08:00,['bce79ed338a614fa8966a14dffb657bdda051d1f'],747,817,1564,14252307,11,0.923076923,0.974358974,0.846153846,9556
9eeb84fb9b64ea449aaf9a951fa129caf0d79248,1,honma,2015-08-06 14:06:27+08:00,['2483f35f540b8df4f9abf14673aafdd69c17cc8b'],707,1026,1733,14254040,7,,,,9556
4b3bca005adf820ba261bb13b1e197967fcd5501,1,honma,2015-08-06 15:30:21+08:00,['9eeb84fb9b64ea449aaf9a951fa129caf0d79248'],114,5,119,14254159,3,0,0,0,9556
18241fa5dd9b17f56cbb77cd6c4b0bea579fb622,0,Zhong Jian,2015-08-06 15:35:08+08:00,['ee15d5b183829a5f63672dd94e56cda77585e942'],3,2,5,14254164,1,0,0,0,9556
32aa3396ce7d5c242576263a9cd9260863866a4a,0,Zhong Jian,2015-08-06 15:36:06+08:00,['4b3bca005adf820ba261bb13b1e197967fcd5501'],3,2,5,14254169,1,0,0,0,9556
0e5167bab3cb8344407a69de169968f6c8b63f64,0,Li Yang,2015-08-06 15:51:50+08:00,['32aa3396ce7d5c242576263a9cd9260863866a4a'],1,1,2,14254171,1,,,,9556
b27556919e43febf22f28e2730e325d9432db55f,0,Li Yang,2015-08-06 16:46:11+08:00,['18241fa5dd9b17f56cbb77cd6c4b0bea579fb622'],1,1,2,14254173,1,,,,9556
3460a47e4899d0768f89389b953d994c82e15ed5,1,honma,2015-08-06 17:19:14+08:00,['0e5167bab3cb8344407a69de169968f6c8b63f64'],1031,821,1852,14256025,10,1,1,1,9557
074634fea22b071b93ff3901a25f16b7a818d0a0,0,Zhong Jian,2015-08-07 15:54:44+08:00,['b27556919e43febf22f28e2730e325d9432db55f'],11,16,27,14256052,4,1,1,1,9557
35ae62305f577c82b31b21d1d73a759e0b97562d,1,Zhong Jian,2015-08-07 15:55:31+08:00,['3460a47e4899d0768f89389b953d994c82e15ed5'],1,19,20,14256072,5,1,1,1,9557
d7df33e8706872723b52e680556205e86a6d81af,0,Li Yang,2015-08-07 17:09:35+08:00,['35ae62305f577c82b31b21d1d73a759e0b97562d'],69,68,137,14256209,13,,,,9557
d55f6650c85750d81c5a1264ab6b6ee649f37436,1,honma,2015-08-10 09:51:41+08:00,['d7df33e8706872723b52e680556205e86a6d81af'],8,8,16,14256225,1,,,,9557
4d9a4884d7f48b1aab76c024c9c7d743afb93a61,1,shaofengshi,2015-08-10 11:22:03+08:00,['d55f6650c85750d81c5a1264ab6b6ee649f37436'],13,5,18,14256243,2,1,0,0,9557
eb6310650f515f9c92703922df82be8fa4962951,0,shaofengshi,2015-08-10 12:37:56+08:00,['4d9a4884d7f48b1aab76c024c9c7d743afb93a61'],80,45,125,14256368,4,0,1,0,9557
132121112564d794284a787496c92968e7806bc4,0,shaofengshi,2015-08-10 12:59:36+08:00,['eb6310650f515f9c92703922df82be8fa4962951'],1,1,2,14256370,1,,,,9557
02c820ef000338a1616d9b4688c513322a20385e,0,shaofengshi,2015-08-10 13:43:34+08:00,['132121112564d794284a787496c92968e7806bc4'],1,1,2,14256372,1,,,,9557
4b44ae3351209f7ab1dcefa6218ab5534c258c7c,0,Zhong Jian,2015-08-10 14:41:54+08:00,['02c820ef000338a1616d9b4688c513322a20385e'],7,7,14,14256386,1,,,,9557
eaef9407e15cf5e5cab57308fcfa7aa209889970,1,Zhong Jian,2015-08-10 14:43:41+08:00,['074634fea22b071b93ff3901a25f16b7a818d0a0'],9,9,18,14256404,1,,,,9557
17365ac321a399051b3f30bc6f23e1b90e7d8b60,0,Zhong Jian,2015-08-10 15:13:35+08:00,['4b44ae3351209f7ab1dcefa6218ab5534c258c7c'],1,1,2,14256406,1,,,,9557
63b7d2518c359da923cf0de1283b8d6adbc6aa2f,0,Zhong Jian,2015-08-10 15:14:58+08:00,['eaef9407e15cf5e5cab57308fcfa7aa209889970'],1,1,2,14256408,1,,,,9557
e670b99e678a498adbb0f668a21405ce8c6b490c,1,qianhao.zhou,2015-08-10 16:05:28+08:00,['63b7d2518c359da923cf0de1283b8d6adbc6aa2f'],371,1255,1626,14258034,32,0.445652174,0.706521739,0.797826087,9564
aa018b192c74d0fa07cd878d7975e00ce2ef2ef7,1,qianhao.zhou,2015-08-10 16:05:28+08:00,['e670b99e678a498adbb0f668a21405ce8c6b490c'],0,123,123,14258157,2,,,,9565
1dae09ee2cdb3145cc2711f20f00e68c10c12aa3,0,shaofengshi,2015-08-10 18:03:36+08:00,['17365ac321a399051b3f30bc6f23e1b90e7d8b60'],1,15,16,14258173,3,0.916666667,1,1,9565
32658b5dfb01e6f159a14d91ed01f181e28467cc,1,honma,2015-08-10 18:12:42+08:00,['aa018b192c74d0fa07cd878d7975e00ce2ef2ef7'],1162,1473,2635,14260808,15,0.5,1,1,9565
941decbe918686dbf4644ee2ee3baa391a5f9ea7,1,honma,2015-08-10 18:13:14+08:00,['32658b5dfb01e6f159a14d91ed01f181e28467cc'],36,80,116,14260924,19,0,0,0.40625,9565
d205806117a34940267910c4eaf1783005c78279,0,honma,2015-08-10 21:05:05+08:00,['17365ac321a399051b3f30bc6f23e1b90e7d8b60'],825,1030,1855,14262779,9,0,0,0,9565
c25f994036465b6ea6baceffebf0763ce59970f0,0,honma,2015-08-11 00:33:03+08:00,['d205806117a34940267910c4eaf1783005c78279'],26,58,84,14262863,19,0,0,0.16,9565
d024d9fb82a2cda689d3a930cd95bad12b741b01,0,qianhao.zhou,2015-08-11 11:49:30+08:00,['c25f994036465b6ea6baceffebf0763ce59970f0'],2,7,9,14262872,3,0,0,1,9565
5f008ec27538214945fc95e918a6441c8ab82dc1,0,shaofengshi,2015-08-11 12:36:53+08:00,"['1dae09ee2cdb3145cc2711f20f00e68c10c12aa3', 'd024d9fb82a2cda689d3a930cd95bad12b741b01']",853,1095,1948,14264820,31,,,,9565
6ed1e19563f7ce0d80bc5fed8f52bb94b5592995,0,shaofengshi,2015-08-11 12:54:06+08:00,['5f008ec27538214945fc95e918a6441c8ab82dc1'],3,1,4,14264824,1,1,0,0,9565
4fead6f5636a75c17c7c6ee33d0bbca1a3aafeb4,0,shaofengshi,2015-08-11 14:06:07+08:00,['941decbe918686dbf4644ee2ee3baa391a5f9ea7'],3,3,6,14264830,2,0,0,1,9565
806a160d475176d5ca671ce5d0e14bcd7d0d7159,0,honma,2015-08-11 14:16:58+08:00,['6ed1e19563f7ce0d80bc5fed8f52bb94b5592995'],60,37,97,14264927,10,1,1,0,9566
00f92413fb3b1cc68da58738f1d1bfa266950da5,0,honma,2015-08-11 14:49:20+08:00,['4fead6f5636a75c17c7c6ee33d0bbca1a3aafeb4'],28,17,45,14264972,13,1,0,1,9567
0f63cc4e8f7c4a42c7242d37717fa7b9dc1e2e56,0,qianhao.zhou,2015-08-11 15:01:49+08:00,['00f92413fb3b1cc68da58738f1d1bfa266950da5'],12,0,12,14264984,2,,,,9567
a6283234337fcee0f456207c5c83322a23d51100,1,qianhao.zhou,2015-08-11 15:01:49+08:00,['0f63cc4e8f7c4a42c7242d37717fa7b9dc1e2e56'],66,434,500,14265484,15,0.736842105,1,1,9572
7f504c8169e6f345cdf956c6c327d82351720ec8,0,honma,2015-08-11 15:49:49+08:00,['806a160d475176d5ca671ce5d0e14bcd7d0d7159'],1,1,2,14265486,1,,,,9572
1a9ec11bcecf0db1733ad0ab061f442df5b755f6,0,Li Yang,2015-08-11 17:46:02+08:00,['7f504c8169e6f345cdf956c6c327d82351720ec8'],193,206,399,14265885,1,0.2,0.7,1,9572
bdab62c5da024fdcbc4544d5a7d9289c08dad9e4,0,Li Yang,2015-08-12 08:55:42+08:00,['1a9ec11bcecf0db1733ad0ab061f442df5b755f6'],22,5,27,14265912,1,0.166666667,0.166666667,0,9572
fa8fae5dd76863d072127f2f60a658755b868edc,0,Li Yang,2015-08-12 08:56:52+08:00,['a6283234337fcee0f456207c5c83322a23d51100'],22,4,26,14265938,1,0.230769231,0.230769231,0,9572
f7598d8b2c954c9bcb25f97a5847eb62156b13f8,1,honma,2015-08-12 10:18:18+08:00,['fa8fae5dd76863d072127f2f60a658755b868edc'],32,30,62,14266000,2,1,0,0,9572
198d4626bb10627462c7f2f38a1e46c89bf1caa2,0,honma,2015-08-12 10:18:18+08:00,['f7598d8b2c954c9bcb25f97a5847eb62156b13f8'],1,1,2,14266002,4,,,,9573
0736733695fb0a54035a55f649aff6fb6d1c753a,0,honma,2015-08-12 10:18:18+08:00,['198d4626bb10627462c7f2f38a1e46c89bf1caa2'],48,40,88,14266090,2,,,,9573
d93567bb3fc62b0170962b762016de48c467dcde,0,honma,2015-08-12 10:23:43+08:00,['bdab62c5da024fdcbc4544d5a7d9289c08dad9e4'],206,190,396,14266486,1,0.785714286,0.428571429,0,9573
528d3a7bcc7e607e6fe8a7481259d8c8047f1fea,0,Li Yang,2015-08-12 10:32:07+08:00,['d93567bb3fc62b0170962b762016de48c467dcde'],540,540,1080,14267566,540,,,,9573
2cbf8930aa8f76dfdf3b25974019b0f0613780a9,0,Li Yang,2015-08-12 10:42:04+08:00,['528d3a7bcc7e607e6fe8a7481259d8c8047f1fea'],119,119,238,14267804,119,,,,9573
4b55d171dcc00f679c567ad9b38fb1e6eef2e286,0,Zhong Jian,2015-08-12 10:46:51+08:00,['2cbf8930aa8f76dfdf3b25974019b0f0613780a9'],6,19,25,14267829,1,0,0,1,9573
6db1300091818e8efcc7022f6f97c66cb8b46d42,1,Zhong Jian,2015-08-12 10:48:30+08:00,['0736733695fb0a54035a55f649aff6fb6d1c753a'],0,19,19,14267848,1,0,0,1,9573
b6d63ab9de87b81bfd383f0d08ee3e9e9c0255d4,0,Zhong Jian,2015-08-12 11:06:15+08:00,['4b55d171dcc00f679c567ad9b38fb1e6eef2e286'],15,45,60,14267908,2,0,0.8,1,9573
2b66eb6d8abc50e8efe45a0131424038cb423106,0,shaofengshi,2015-08-12 14:17:38+08:00,['6db1300091818e8efcc7022f6f97c66cb8b46d42'],1,6,7,14267915,2,0,1,0,9573
d44511caa7f06ecd6306883d1fac6417fd58a968,0,honma,2015-08-12 14:55:43+08:00,['2b66eb6d8abc50e8efe45a0131424038cb423106'],0,1,1,14267916,1,1,1,1,9573
b8de9c479085f579d2b1f0c6519964df0f589e6c,0,honma,2015-08-12 17:24:42+08:00,['d44511caa7f06ecd6306883d1fac6417fd58a968'],10,5,15,14267931,1,0,0,0,9573
f82d62911697d1010018ba1a8fe34b880af1f2de,0,Zhong Jian,2015-08-13 10:36:05+08:00,['b6d63ab9de87b81bfd383f0d08ee3e9e9c0255d4'],2,2,4,14267935,1,,,,9573
9c6e35fcaddb9b3ac7ce9520cf9fc9d69e0fe4c1,0,Zhong Jian,2015-08-13 10:38:32+08:00,['b8de9c479085f579d2b1f0c6519964df0f589e6c'],1,1,2,14267937,1,,,,9573
8bd2da49a1bd278775654cfe650cafe8efa15a33,0,Li Yang,2015-08-13 14:28:41+08:00,['f82d62911697d1010018ba1a8fe34b880af1f2de'],2,3,5,14267942,1,,,,9573
d49944427b11cb549a490072356daa4780597234,0,shaofengshi,2015-08-13 16:22:16+08:00,['8bd2da49a1bd278775654cfe650cafe8efa15a33'],0,13,13,14267955,1,1,1,1,9573
6a8f34ae14be30eb05ac7b2c9cb6738879499fb8,0,shaofengshi,2015-08-13 16:29:58+08:00,['9c6e35fcaddb9b3ac7ce9520cf9fc9d69e0fe4c1'],0,13,13,14267968,1,1,1,1,9573
8f0088ee605997a6439d89be579e556095c37a34,0,shaofengshi,2015-08-13 16:52:51+08:00,['d49944427b11cb549a490072356daa4780597234'],2,3,5,14267973,2,,,,9573
ab3232a1d8763e1dd3d14c2d94308a33f0c5d8fe,1,honma,2015-08-13 18:42:30+08:00,['6a8f34ae14be30eb05ac7b2c9cb6738879499fb8'],650,4049,4699,14272672,53,0.612106538,0.839225182,0.957384988,9587
b3952ed7842cb7077fb7bbb4dc40a1b81bf21420,0,honma,2015-08-13 19:36:54+08:00,['ab3232a1d8763e1dd3d14c2d94308a33f0c5d8fe'],21,1,22,14272694,2,0,0,0.125,9587
118387bd22501696541e7cf2a3b36835c59bb42b,1,honma,2015-08-13 19:42:59+08:00,['b3952ed7842cb7077fb7bbb4dc40a1b81bf21420'],15649,14793,30442,14303136,571,0.930417495,0.43074884,0.382372432,9587
898f0cc7513c87bd1b0dc71bcc26fdfd6947829c,0,honma,2015-08-14 10:52:08+08:00,['118387bd22501696541e7cf2a3b36835c59bb42b'],0,10,10,14303146,1,0,0,0,9587
f9b9ac71bbbd796dcb68c044663fa95d547eca6a,0,shaofengshi,2015-08-14 11:49:11+08:00,['8f0088ee605997a6439d89be579e556095c37a34'],9,18,27,14303173,1,0,0,1,9587
6b12e587093569a5bec5faafb264db500a58c0d4,0,shaofengshi,2015-08-14 13:33:19+08:00,['f9b9ac71bbbd796dcb68c044663fa95d547eca6a'],3,7,10,14303183,1,0,0,1,9587
55953192cdef3f8694e800a5bdae424a582085a9,0,Li Yang,2015-08-14 14:33:33+08:00,['6b12e587093569a5bec5faafb264db500a58c0d4'],1,1,2,14303185,1,,,,9587
18a4af5611c2ab1d1cb67549c3ab38f96a4f8aa4,0,shaofengshi,2015-08-14 15:36:31+08:00,['898f0cc7513c87bd1b0dc71bcc26fdfd6947829c'],2,2,4,14303189,1,,,,9587
ecac2d81748b79bb7e1124bc175f40ca958fa171,0,shaofengshi,2015-08-14 16:19:56+08:00,['55953192cdef3f8694e800a5bdae424a582085a9'],2,2,4,14303193,1,,,,9587
76e3c7bed6fb9c019f078f6303c8b6850ba5c720,0,honma,2015-08-14 17:53:39+08:00,['ecac2d81748b79bb7e1124bc175f40ca958fa171'],0,57,57,14303250,1,0.574468085,0.276595745,1,9587
dee3c9003352112a646e711dba9b5799f00f6162,0,Li Yang,2015-08-14 18:06:08+08:00,['76e3c7bed6fb9c019f078f6303c8b6850ba5c720'],0,68,68,14303318,4,,,,9591
db031b3ef17eefffb2ef461d628da809bf84b35e,0,Li Yang,2015-08-14 18:06:13+08:00,['dee3c9003352112a646e711dba9b5799f00f6162'],0,3,3,14303321,1,,,,9591
29a4172c96bd0889bd7832423d730ffe838b747b,0,Li Yang,2015-08-14 18:07:40+08:00,['18a4af5611c2ab1d1cb67549c3ab38f96a4f8aa4'],0,3,3,14303324,1,,,,9591
4dee83bdf1dbfda07f9e89e74a7bc40d4414d459,0,honma,2015-08-14 18:11:35+08:00,['29a4172c96bd0889bd7832423d730ffe838b747b'],0,57,57,14303381,1,0.574468085,0.276595745,1,9591
503d2b54a84f20a945e5bf86e0bdac77f976fa27,0,Zhong Jian,2015-08-14 18:47:54+08:00,['db031b3ef17eefffb2ef461d628da809bf84b35e'],3,12,15,14303396,2,0.9,1,0.9,9591
9daf43bb423e27baf4b2e7f4ab0b11d867d928f1,0,shaofengshi,2015-08-17 14:38:34+08:00,['503d2b54a84f20a945e5bf86e0bdac77f976fa27'],6,124,130,14303526,10,,,,9595
2fe622661da77d7bc1248521ee6d347791ecaba9,1,Zhong Jian,2015-08-17 15:22:33+08:00,['9daf43bb423e27baf4b2e7f4ab0b11d867d928f1'],2,8,10,14303536,3,0.833333333,1,0.833333333,9595
a4a4891f2aaa4e56a9ba805c727c3b068634f903,0,shaofengshi,2015-08-18 10:06:39+08:00,['2fe622661da77d7bc1248521ee6d347791ecaba9'],0,13,13,14303549,1,0,0,0,9595
c9e7dfdf778dd5bdd9ae03a3d8294724fe94893d,0,shaofengshi,2015-08-18 10:09:11+08:00,['4dee83bdf1dbfda07f9e89e74a7bc40d4414d459'],0,13,13,14303562,1,0,0,0,9595
ef71276cd54f89cb0128377fbc8823a9a51cb96c,1,qianhao.zhou,2015-08-18 18:15:58+08:00,['c9e7dfdf778dd5bdd9ae03a3d8294724fe94893d'],351,984,1335,14304897,25,0.070652174,0.339673913,0.45923913,9599
07d88947d7669e1ddc40561c35fe5caa92a73314,1,honma,2015-08-18 20:31:30+08:00,['ef71276cd54f89cb0128377fbc8823a9a51cb96c'],286,86,372,14305269,20,0.223529412,0.011764706,0,9599
43874d11df280ed2c38a20ca683ed7c46e7b3d7d,0,honma,2015-08-19 10:13:56+08:00,['07d88947d7669e1ddc40561c35fe5caa92a73314'],3,4,7,14305276,3,,,,9599
76e88cffafca79f84571081eeb7f049583700d1a,0,qianhao.zhou,2015-08-19 11:52:31+08:00,['43874d11df280ed2c38a20ca683ed7c46e7b3d7d'],1,1,2,14305278,1,,,,9599
bbf532a0f8c3f2f2e2bfeeb8aacfbb581336111c,0,honma,2015-08-19 13:14:32+08:00,['a4a4891f2aaa4e56a9ba805c727c3b068634f903'],272,84,356,14305634,16,0.24691358,0.012345679,0,9599
771909a5c034660c520fe2387715bd6447596bd7,0,honma,2015-08-19 13:16:37+08:00,['76e88cffafca79f84571081eeb7f049583700d1a'],2,3,5,14305639,1,,,,9599
6354f22f422bc99698f4c34da4a8a64b5934d9bd,1,Li Yang,2015-08-19 13:55:28+08:00,['771909a5c034660c520fe2387715bd6447596bd7'],13,35,48,14305687,9,1,1,1,9599
3d0957c2e6ef541d655596788563938021c824b0,0,qianhao.zhou,2015-08-19 15:57:25+08:00,['bbf532a0f8c3f2f2e2bfeeb8aacfbb581336111c'],1,6,7,14305694,1,,,,9599
cfe74fd52301b34588b9304486c2664d9f1107e8,0,honma,2015-08-19 16:36:24+08:00,['3d0957c2e6ef541d655596788563938021c824b0'],1,1,2,14305696,1,,,,9599
4980af532bd2321b04c7c5fb278c1cf37900342e,0,qianhao.zhou,2015-08-19 17:36:02+08:00,['cfe74fd52301b34588b9304486c2664d9f1107e8'],0,1,1,14305697,1,,,,9599
7819225a96835028e801e4fbde3b804559da5b46,0,Li Yang,2015-08-19 19:23:58+08:00,['6354f22f422bc99698f4c34da4a8a64b5934d9bd'],521,398,919,14306616,28,0,0,0.25862069,9601
23133f0fa9f97c49a2b86c37be5cb694a96d96bf,0,honma,2015-08-19 20:11:46+08:00,['4980af532bd2321b04c7c5fb278c1cf37900342e'],1,1,2,14306618,2,,,,9601
5b033373beb633488c15a8a0da6e324eed81a334,0,Li Yang,2015-08-20 14:24:51+08:00,['7819225a96835028e801e4fbde3b804559da5b46'],8,6,14,14306632,1,1,0.5,0,9601
97384ee826ce207775e1ccdfd302dc1fddafd342,0,Li Yang,2015-08-20 14:29:01+08:00,['23133f0fa9f97c49a2b86c37be5cb694a96d96bf'],6,4,10,14306642,1,1,0.5,0,9601
71c423c2f4aea359394b2638efcbd4a7f83f03b0,0,Luke Han,2015-08-20 15:56:21+08:00,['a4a4891f2aaa4e56a9ba805c727c3b068634f903'],18,18,36,14306678,15,,,,9601
654d019bcef43554408daa3241e04115d7d2653f,0,Luke Han,2015-08-20 15:57:21+08:00,"['71c423c2f4aea359394b2638efcbd4a7f83f03b0', '97384ee826ce207775e1ccdfd302dc1fddafd342']",281,97,378,14307056,22,,,,9601
9e8052407c6733e2c74470cb486ce0bc0ede0c87,0,Li Yang,2015-08-20 17:17:59+08:00,['97384ee826ce207775e1ccdfd302dc1fddafd342'],1,30,31,14307087,2,,,,9602
7c34656315f38f86d2140d4a7fc7201e8ea28081,0,shaofengshi,2015-08-20 17:31:46+08:00,['9e8052407c6733e2c74470cb486ce0bc0ede0c87'],15,18,33,14307120,2,0,1,1,9602
396e04211a840978f0034d21d606cfd22274d0a6,0,honma,2015-08-21 13:56:17+08:00,['7c34656315f38f86d2140d4a7fc7201e8ea28081'],0,12,12,14307132,3,,,,9603
3c2fd0021c03113ebcaef8c492e359bb28aea7fa,1,qianhao.zhou,2015-08-21 15:14:44+08:00,['5b033373beb633488c15a8a0da6e324eed81a334'],1,5,6,14307138,1,0.333333333,1,0.333333333,9603
ccd8d9cedf1f9f6c5030c83a0138f73e654f01e9,0,honma,2015-08-21 15:16:18+08:00,['396e04211a840978f0034d21d606cfd22274d0a6'],26,252,278,14307416,7,,,,9604
6ed7cc6b3bc1759ae3a791299b377cb6d1a1e69a,0,honma,2015-08-21 16:44:08+08:00,['ccd8d9cedf1f9f6c5030c83a0138f73e654f01e9'],1316,1316,2632,14310048,658,,,,9604
79bc05ab6f53666546667e109438df2c4b699e6d,0,Li Yang,2015-08-24 10:12:18+08:00,['3c2fd0021c03113ebcaef8c492e359bb28aea7fa'],1,1,2,14310050,1,,,,9604
5a22e9bd1954ccb37e728ed9490eb7affad107cd,0,Li Yang,2015-08-24 10:12:50+08:00,['6ed7cc6b3bc1759ae3a791299b377cb6d1a1e69a'],1,1,2,14310052,1,,,,9604
37a72ffe0361bfba9099bda72216973e69dcfd86,0,Zhong Jian,2015-08-24 15:05:37+08:00,['5a22e9bd1954ccb37e728ed9490eb7affad107cd'],1,1,2,14310054,1,,,,9604
5da9da09af9d072fb3d7c76f14fcdf8a50614100,0,Li Yang,2015-08-24 15:32:43+08:00,['37a72ffe0361bfba9099bda72216973e69dcfd86'],9,16,25,14310079,1,1,1,1,9604
039a127ae4b696fa9685bd283271595aa8f66f3f,0,Li Yang,2015-08-24 15:33:29+08:00,['5da9da09af9d072fb3d7c76f14fcdf8a50614100'],30,32,62,14310141,1,1,1,1,9604
da3a2231994b6fb4baed4f24b245802447d27275,0,Li Yang,2015-08-24 16:13:38+08:00,['79bc05ab6f53666546667e109438df2c4b699e6d'],9,16,25,14310166,1,1,1,1,9604
382b6f99ad7a39d0b52afd33a6c00f8f1df2089d,0,Li Yang,2015-08-24 16:15:26+08:00,['da3a2231994b6fb4baed4f24b245802447d27275'],2,6,8,14310174,1,0,1,1,9604
2ed39dc8c23922823b2f65ffbae1c9a38e7a4914,1,honma,2015-08-24 17:01:17+08:00,['382b6f99ad7a39d0b52afd33a6c00f8f1df2089d'],6834,6562,13396,14323570,157,0.048888889,0.671111111,0.911111111,9606
29b9fd10fa352bdea59a259c2813bc0cb58c4ae4,1,honma,2015-08-25 10:00:43+08:00,['2ed39dc8c23922823b2f65ffbae1c9a38e7a4914'],3,8,11,14323581,5,,,,9606
bec9eea6e3d8344ef61e55935415a9bb61dbdf32,0,Luke Han,2015-08-25 13:53:48+08:00,['654d019bcef43554408daa3241e04115d7d2653f'],1,1,2,14323583,1,,,,9606
62b1c88176a12f92f0b6ca678561bae31c7c5877,0,Zhong Jian,2015-08-25 14:02:44+08:00,['039a127ae4b696fa9685bd283271595aa8f66f3f'],6,4,10,14323593,1,,,,9606
f78835ca553102808ebc624e65e3cc19bd586984,0,honma,2015-08-25 15:03:57+08:00,['29b9fd10fa352bdea59a259c2813bc0cb58c4ae4'],4,4,8,14323601,1,,,,9606
d65107d56ebe949ad80b4eede7794407d139422f,0,Luke Han,2015-08-25 18:04:30+08:00,['bec9eea6e3d8344ef61e55935415a9bb61dbdf32'],14,14,28,14323629,13,,,,9606
b8378b8cc9c2336dc59017cef8c3aa25e5caa74c,0,Luke Han,2015-08-25 18:45:02+08:00,['d65107d56ebe949ad80b4eede7794407d139422f'],14,14,28,14323657,13,,,,9606
93525fea7488b0fe5b2c155db17c7e9e34d0facf,0,Luke Han,2015-08-25 20:59:15+08:00,['b8378b8cc9c2336dc59017cef8c3aa25e5caa74c'],3,58,61,14323718,2,,,,9606
47a797ba80f50e3e2a58a1dac3acd71be462ee98,0,honma,2015-08-26 12:29:37+08:00,['f78835ca553102808ebc624e65e3cc19bd586984'],0,2,2,14323720,1,,,,9606
a37a999cf773074de7b90dcaac886bd528231641,0,honma,2015-08-26 12:31:36+08:00,['62b1c88176a12f92f0b6ca678561bae31c7c5877'],0,2,2,14323722,1,,,,9606
140f62648c58cbdd4c32c26de92cc210947f18c5,0,honma,2015-08-26 15:19:50+08:00,['47a797ba80f50e3e2a58a1dac3acd71be462ee98'],37,3021,3058,14326780,13,0.607182941,0.831088664,0.838383838,9612
37b5e066c20222a38698b3561ba30d9fc3a6a45c,0,honma,2015-08-26 15:30:13+08:00,['a37a999cf773074de7b90dcaac886bd528231641'],19,28,47,14326827,4,0,0,0,9612
12d3cc2be1ae56a76e67e394275581a33fbcf741,1,Li Yang,2015-08-26 16:08:12+08:00,['140f62648c58cbdd4c32c26de92cc210947f18c5'],1,274,275,14327102,3,0.559748428,1,1,9614
f31c8f2fff5747bd07b714a3d9bbe233d64e2bef,0,honma,2015-08-26 17:08:35+08:00,['37b5e066c20222a38698b3561ba30d9fc3a6a45c'],199,44,243,14327345,5,0,0,0,9614
885e591168767e2b99f4a11a126d92b8e39d6914,0,honma,2015-08-26 17:19:44+08:00,['12d3cc2be1ae56a76e67e394275581a33fbcf741'],222,42,264,14327609,6,0,0,0,9614
384a7fa851edad7241f9c22995ec0f6c1ebc2570,0,honma,2015-08-26 18:02:39+08:00,['885e591168767e2b99f4a11a126d92b8e39d6914'],16,36,52,14327661,2,0,0,1,9614
6f857dd8221a980dc420fc0e48c7e948d615b3a6,0,honma,2015-08-26 18:29:03+08:00,['384a7fa851edad7241f9c22995ec0f6c1ebc2570'],6114,82,6196,14333857,59,,,,9614
ede3c2b03043f31fe3e20e98d56cf1fbd8476ef7,0,Luke Han,2015-08-27 08:52:52+08:00,['93525fea7488b0fe5b2c155db17c7e9e34d0facf'],1,1,2,14333859,1,,,,9614
e24c4374775fa79b58433707ebcef32868bb368b,0,Luke Han,2015-08-27 09:00:13+08:00,['ede3c2b03043f31fe3e20e98d56cf1fbd8476ef7'],13,13,26,14333885,13,,,,9614
f8a3320a85f6e26d85f3bffed73c0d38313c611c,0,Luke Han,2015-08-27 12:40:44+08:00,['e24c4374775fa79b58433707ebcef32868bb368b'],14,16,30,14333915,13,,,,9614
354a1c4c6b7151fdb695d954b34ffc13b8640084,0,honma,2015-08-27 14:34:06+08:00,['f31c8f2fff5747bd07b714a3d9bbe233d64e2bef'],1,3,4,14333919,1,,,,9614
b7be706146cf39af985154ce599db50bebb96c65,0,Luke Han,2015-08-27 15:48:03+08:00,['f8a3320a85f6e26d85f3bffed73c0d38313c611c'],14,14,28,14333947,13,,,,9614
060b993e3869d8231e7c72a1d347d9d9af1cd2e9,1,qianhao.zhou,2015-08-28 10:27:27+08:00,['6f857dd8221a980dc420fc0e48c7e948d615b3a6'],10,63,73,14334020,2,0.209302326,0.209302326,0.209302326,9614
f74c4066c537d1851dc390f7b61bc19eb00ed6d4,0,Li Yang,2015-08-28 10:52:45+08:00,['354a1c4c6b7151fdb695d954b34ffc13b8640084'],83,309,392,14334412,9,0.603603604,0.666666667,1,9616
c69fd4b4635901c4de951ea8aeb7185ef887be3b,0,shaofengshi,2015-08-28 11:02:10+08:00,['f74c4066c537d1851dc390f7b61bc19eb00ed6d4'],8,8,16,14334428,1,1,1,0,9616
3b779d6a0632585aff47a83ecdf3c76cffc61348,1,Li Yang,2015-08-28 11:12:20+08:00,['060b993e3869d8231e7c72a1d347d9d9af1cd2e9'],83,331,414,14334842,11,0.632,0.704,1,9618
dd53d7138fc27fce2bb16167fa5a81176915f78d,0,shaofengshi,2015-08-28 11:32:46+08:00,['c69fd4b4635901c4de951ea8aeb7185ef887be3b'],0,29,29,14334871,1,,,,9618
4632254541ce25dc1b3ca8c812d0ae8af3195f86,0,shaofengshi,2015-08-28 14:52:19+08:00,['dd53d7138fc27fce2bb16167fa5a81176915f78d'],1,1,2,14334873,1,,,,9618
32e4484aeb94add4e096842a1799c2d16cc61797,0,shaofengshi,2015-08-31 09:31:37+08:00,['4632254541ce25dc1b3ca8c812d0ae8af3195f86'],2,3,5,14334878,2,,,,9618
c4211cd754c288a2211fe14ba315b33649f31e37,1,shaofengshi,2015-08-31 09:34:26+08:00,['3b779d6a0632585aff47a83ecdf3c76cffc61348'],13,25,38,14334916,2,0.857142857,1,0.857142857,9618
1c0b39254079d49d5bdbddc1da289f2f5bc3ec3a,0,honma,2015-08-31 16:13:08+08:00,['32e4484aeb94add4e096842a1799c2d16cc61797'],1,1,2,14334918,1,,,,9618
c6baf42d757ab1423244864420eb181aa8971c9d,0,shaofengshi,2015-09-01 13:36:25+08:00,['1c0b39254079d49d5bdbddc1da289f2f5bc3ec3a'],16,6,22,14334940,3,,,,9618
1fe7239fdc2f1265de3073249e2516e9e0362932,0,honma,2015-09-01 14:14:03+08:00,['c4211cd754c288a2211fe14ba315b33649f31e37'],0,96,96,14335036,1,0,0,1,9619
cee985658c3d94a1b461b6ac8b692891b8d04527,0,honma,2015-09-01 14:14:03+08:00,['1fe7239fdc2f1265de3073249e2516e9e0362932'],3,3,6,14335042,1,,,,9619
77572d9834ecd12a2c4291d5418a61589e88c356,1,honma,2015-09-01 14:14:03+08:00,['cee985658c3d94a1b461b6ac8b692891b8d04527'],34,33,67,14335109,14,0.833333333,0,0.333333333,9619
ab0e3b4d77be07af5f418617df2b8e4c8fcf6e54,0,honma,2015-09-01 14:14:04+08:00,['77572d9834ecd12a2c4291d5418a61589e88c356'],7,24,31,14335140,4,0.545454545,0.545454545,1,9619
7a8866b315d30d1f171751bc16424f61ebffc703,1,Li Yang,2015-09-01 16:22:14+08:00,['ab0e3b4d77be07af5f418617df2b8e4c8fcf6e54'],289,986,1275,14336415,64,0.534759358,0.727272727,1,9627
337e5affe2443e80e54dfa8a97a1a19462e9b1e4,0,honma,2015-09-01 17:51:31+08:00,['7a8866b315d30d1f171751bc16424f61ebffc703'],0,51,51,14336466,4,,,,9631
1ebb41e8560edcc3a39582a159acb68fc4282f70,0,honma,2015-09-01 18:00:14+08:00,['c6baf42d757ab1423244864420eb181aa8971c9d'],3671,32,3703,14340169,42,,,,9631
899c7e5024bf68db2579d621ebb7003c8d63738e,0,honma,2015-09-01 21:21:38+08:00,['1ebb41e8560edcc3a39582a159acb68fc4282f70'],1,1,2,14340171,1,,,,9631
d02e31b877652a98f145161983de9edc43bddf55,0,shaofengshi,2015-09-02 09:24:03+08:00,['899c7e5024bf68db2579d621ebb7003c8d63738e'],27,198,225,14340396,13,1,1,1,9632
b53a6ce3d4d675362c5b9197f3bd7282e1f4a108,0,shaofengshi,2015-09-02 09:24:03+08:00,['d02e31b877652a98f145161983de9edc43bddf55'],2,9,11,14340407,2,,,,9632
635839508d127c37110deff519a4b5957dbdc4e0,0,shaofengshi,2015-09-02 09:51:54+08:00,['b53a6ce3d4d675362c5b9197f3bd7282e1f4a108'],85,228,313,14340720,6,0.636363636,1,1,9632
307cf126046b90a9d7809d5db95cfd11988bb340,0,honma,2015-09-02 10:31:43+08:00,['337e5affe2443e80e54dfa8a97a1a19462e9b1e4'],3,3,6,14340726,2,,,0,9632
63280d4b50e2ed63f25b1de37384fc05fb04d482,0,honma,2015-09-02 10:51:11+08:00,['307cf126046b90a9d7809d5db95cfd11988bb340'],1,1,2,14340728,1,,,,9632
53818168701fedf823c12c93ca5618b3770f47cf,0,honma,2015-09-02 10:52:39+08:00,['635839508d127c37110deff519a4b5957dbdc4e0'],1,1,2,14340730,1,,,,9632
f3be3419e869155c249fbbaf4b810ca0da538e4f,0,Li Yang,2015-09-02 15:32:38+08:00,['63280d4b50e2ed63f25b1de37384fc05fb04d482'],15,21,36,14340766,7,0.666666667,1,1,9632
ee3bc587a9b6023b4a446d2e992ecfbafd5358af,0,Zhong Jian,2015-09-02 16:01:35+08:00,['53818168701fedf823c12c93ca5618b3770f47cf'],9,63,72,14340838,7,0.085714286,0.085714286,1,9632
69106a990b57853bd20f511afa5df434e145b6d2,1,Li Yang,2015-09-02 16:11:49+08:00,['f3be3419e869155c249fbbaf4b810ca0da538e4f'],29,31,60,14340898,3,1,1,1,9632
eda2303b8decfcda8ae841a679c14499e9ff4cef,0,Zhong Jian,2015-09-02 16:16:46+08:00,['ee3bc587a9b6023b4a446d2e992ecfbafd5358af'],1,1,2,14340900,1,,,,9632
2fbd03285845857b6124866b0852da107d9ce6a6,0,honma,2015-09-02 17:07:51+08:00,['eda2303b8decfcda8ae841a679c14499e9ff4cef'],2,5,7,14340907,1,,,,9632
f5eb4f6df59937457dc1c41ed8ad85d4adcf85b0,0,Li Yang,2015-09-03 12:53:27+08:00,['2fbd03285845857b6124866b0852da107d9ce6a6'],39,32,71,14340978,1,,,,9632
cb54a5889ae5bdfa217699cf207989bb1b3784dc,0,Li Yang,2015-09-04 20:39:56+08:00,['f5eb4f6df59937457dc1c41ed8ad85d4adcf85b0'],0,42,42,14341020,2,1,1,1,9633
46d99c2dd271278df87d4288192665840a268e82,0,Li Yang,2015-09-04 20:43:06+08:00,['69106a990b57853bd20f511afa5df434e145b6d2'],0,42,42,14341062,2,1,1,1,9634
8bdb7fc2db3edc8f0de4ba8a601eeb0d14e718d5,0,qianhao.zhou,2015-09-04 21:46:20+08:00,['46d99c2dd271278df87d4288192665840a268e82'],1,1,2,14341064,1,,,,9634
cb0d865fd80ae1ccb1d2c88c3ecaf8823e09850a,0,qianhao.zhou,2015-09-04 22:04:36+08:00,['8bdb7fc2db3edc8f0de4ba8a601eeb0d14e718d5'],25,25,50,14341114,1,1,1,1,9634
1cec61b0c931b0b5955361df28b83533e73741a1,0,shaofengshi,2015-09-06 10:49:06+08:00,['cb54a5889ae5bdfa217699cf207989bb1b3784dc'],9,9,18,14341132,4,,,,9634
a4476dc752ea807b21b9f7be49fca3aa3e6a7de5,0,shaofengshi,2015-09-06 10:54:55+08:00,['cb0d865fd80ae1ccb1d2c88c3ecaf8823e09850a'],4,4,8,14341140,4,,,,9634
f6eb5bb4297493d214210caea1e1244588c35f44,0,shaofengshi,2015-09-06 14:23:32+08:00,['1cec61b0c931b0b5955361df28b83533e73741a1'],26,28,54,14341194,2,,,,9635
6b23867a09667978f92e75bd4ed2ff7a172dffb3,0,honma,2015-09-06 14:27:29+08:00,['f6eb5bb4297493d214210caea1e1244588c35f44'],3,10,13,14341207,1,,,,9635
9a50adf7b9602b8e647f8efd86f42ba081b439ee,0,Luke Han,2015-09-06 14:37:56+08:00,['b7be706146cf39af985154ce599db50bebb96c65'],1,30,31,14341238,2,,,,9636
cd22db688a02055bd83a5f9266d844e5c94ceda3,0,Luke Han,2015-09-06 14:37:56+08:00,['9a50adf7b9602b8e647f8efd86f42ba081b439ee'],15,18,33,14341271,2,0,1,1,9636
59149c670dc75b0620480f80d0203a9b34dfd38a,0,Luke Han,2015-09-06 14:37:56+08:00,['cd22db688a02055bd83a5f9266d844e5c94ceda3'],0,12,12,14341283,3,,,,9637
42931a6410dede71d7555fd0772ba7b74420332d,0,Luke Han,2015-09-06 14:37:56+08:00,['59149c670dc75b0620480f80d0203a9b34dfd38a'],26,252,278,14341561,7,,,,9638
4fb089c0ae5730518f813eb10e5e3552a3956e06,0,Luke Han,2015-09-06 14:37:57+08:00,['42931a6410dede71d7555fd0772ba7b74420332d'],1316,1316,2632,14344193,658,,,,9638
9955a3d78a39e794bc6f99e93132a5799435ca77,0,Luke Han,2015-09-06 14:37:57+08:00,['4fb089c0ae5730518f813eb10e5e3552a3956e06'],1,1,2,14344195,1,,,,9638
53f688c42323d7a6d00b484d23fe836a141dfb93,0,Luke Han,2015-09-06 14:37:57+08:00,['9955a3d78a39e794bc6f99e93132a5799435ca77'],9,16,25,14344220,1,1,1,1,9638
167c5c855afff7e9b99cadc86c232eecc0eb4583,0,Luke Han,2015-09-06 14:37:57+08:00,['53f688c42323d7a6d00b484d23fe836a141dfb93'],30,32,62,14344282,1,1,1,1,9638
1b206126ac8aae1c88d88a87cffe45bdb021861c,0,Luke Han,2015-09-06 14:37:58+08:00,['167c5c855afff7e9b99cadc86c232eecc0eb4583'],6,4,10,14344292,1,,,,9638
3ecb3b5db4d0b0c820bf9f132ba8feea3fb1a03f,0,Luke Han,2015-09-06 14:37:58+08:00,['1b206126ac8aae1c88d88a87cffe45bdb021861c'],0,2,2,14344294,1,,,,9638
967ad8376f8e77f81a7aa89bed64b2346b687a10,0,Luke Han,2015-09-06 14:37:58+08:00,['3ecb3b5db4d0b0c820bf9f132ba8feea3fb1a03f'],19,28,47,14344341,4,0,0,0,9638
20ccb1c2c84c7a149c437741055a806954d089bd,0,Luke Han,2015-09-06 14:37:58+08:00,['967ad8376f8e77f81a7aa89bed64b2346b687a10'],199,44,243,14344584,5,0,0,0,9638
603b16081c25cdde840b7e856fdafb09beda8327,0,Luke Han,2015-09-06 14:37:58+08:00,['20ccb1c2c84c7a149c437741055a806954d089bd'],1,3,4,14344588,1,,,,9638
6e3d2b0457e6b567622c96fefba9141d23a609e9,1,Luke Han,2015-09-06 14:37:58+08:00,['603b16081c25cdde840b7e856fdafb09beda8327'],83,309,392,14344980,9,0.603603604,0.666666667,1,9640
10120de74f02a7587224e393dea314f4d47bbc05,0,Luke Han,2015-09-06 14:37:58+08:00,['6e3d2b0457e6b567622c96fefba9141d23a609e9'],8,8,16,14344996,1,1,1,0,9640
74ceea9723e1b56f2b8be135109c29e7f6aa6e44,0,Luke Han,2015-09-06 14:37:58+08:00,['10120de74f02a7587224e393dea314f4d47bbc05'],0,29,29,14345025,1,,,,9640
7a5469e07f68aaa882a3d924b8f4d99cc2660cf7,0,Luke Han,2015-09-06 14:37:59+08:00,['74ceea9723e1b56f2b8be135109c29e7f6aa6e44'],1,1,2,14345027,1,,,,9640
8324c827e693c8a1cf79e562f753c7015d035c39,0,Luke Han,2015-09-06 14:37:59+08:00,['7a5469e07f68aaa882a3d924b8f4d99cc2660cf7'],2,3,5,14345032,2,,,,9640
babdffb6ccdcfc28c0f251c0ba458ca8cf3713a7,0,Luke Han,2015-09-06 14:37:59+08:00,['8324c827e693c8a1cf79e562f753c7015d035c39'],1,1,2,14345034,1,,,,9640
f347da479b69bcabbb0fd5316da932a8a827ea4b,0,Luke Han,2015-09-06 14:37:59+08:00,['babdffb6ccdcfc28c0f251c0ba458ca8cf3713a7'],16,6,22,14345056,3,,,,9640
1181183896e72127e867f306ddf3d7e6ca16adad,0,Luke Han,2015-09-06 14:37:59+08:00,['f347da479b69bcabbb0fd5316da932a8a827ea4b'],3671,32,3703,14348759,42,,,,9640
5e5b89a6dec1920863cb54500d3b81d4f57f3f65,0,Luke Han,2015-09-06 14:37:59+08:00,['1181183896e72127e867f306ddf3d7e6ca16adad'],1,1,2,14348761,1,,,,9640
12ba66da554b040c8cb6f04d5949d95e14cb5f36,1,Luke Han,2015-09-06 14:37:59+08:00,['5e5b89a6dec1920863cb54500d3b81d4f57f3f65'],27,198,225,14348986,13,1,1,1,9641
ca1107552df53dca40564ab3992f5abacb514413,0,Luke Han,2015-09-06 14:37:59+08:00,['12ba66da554b040c8cb6f04d5949d95e14cb5f36'],2,9,11,14348997,2,,,,9641
77143b3c03a9bfa651b8f904101ae5d32af946f7,1,Luke Han,2015-09-06 14:38:00+08:00,['ca1107552df53dca40564ab3992f5abacb514413'],85,228,313,14349310,6,0.636363636,1,1,9641
677463e2dcb644eee62959d749251964f6509f11,0,Luke Han,2015-09-06 14:38:00+08:00,['77143b3c03a9bfa651b8f904101ae5d32af946f7'],1,1,2,14349312,1,,,,9641
a5350e845ce7620f65bc014ef868655850c61758,1,Luke Han,2015-09-06 14:38:00+08:00,['677463e2dcb644eee62959d749251964f6509f11'],9,63,72,14349384,7,0.085714286,0.085714286,1,9641
f1c59484a173399873ae04f944a5a171b4877402,0,Luke Han,2015-09-06 14:38:00+08:00,['a5350e845ce7620f65bc014ef868655850c61758'],1,1,2,14349386,1,,,,9641
2d9a69ada8b0a1ad09248c30b50678ab47e713e8,0,Luke Han,2015-09-06 14:38:00+08:00,['f1c59484a173399873ae04f944a5a171b4877402'],2,5,7,14349393,1,,,,9641
9af098383fb4c212b67c86de960ee893c6ef1114,0,Luke Han,2015-09-06 14:38:00+08:00,['2d9a69ada8b0a1ad09248c30b50678ab47e713e8'],39,32,71,14349464,1,,,,9641
319362aacae2855b56fcede3674f46dbb32f5823,0,Luke Han,2015-09-06 14:38:00+08:00,['9af098383fb4c212b67c86de960ee893c6ef1114'],0,42,42,14349506,2,1,1,1,9642
a2707ea816eb13edcabcc8b7ea58b2ef47cbad47,0,Luke Han,2015-09-06 14:38:00+08:00,['319362aacae2855b56fcede3674f46dbb32f5823'],9,9,18,14349524,4,,,,9642
b06d2a5e8d0b639403220cd9960094010c109f75,0,honma,2015-09-06 14:38:45+08:00,['6b23867a09667978f92e75bd4ed2ff7a172dffb3'],2,2,4,14349528,2,,,,9642
a277b08e88e88c59c11b2d1df75746d327e375fb,0,Luke Han,2015-09-06 14:45:05+08:00,"['d809f37df4dde2f84eda195744d9d18c05bbab76', 'f8a3320a85f6e26d85f3bffed73c0d38313c611c']",16890,39531,56421,14405949,1013,,,,9642
63aa4de9d36a378f968350d611c534d54dd15963,0,Li Yang,2015-09-06 15:30:06+08:00,['b06d2a5e8d0b639403220cd9960094010c109f75'],67,32,99,14406048,2,0,1,1,9642
370b83f627fd005bf0f7cb897561fe819673b72d,0,honma,2015-09-06 15:31:39+08:00,['a4476dc752ea807b21b9f7be49fca3aa3e6a7de5'],0,197,197,14406245,2,0.149425287,0.563218391,0.931034483,9644
d4392a0b6135eeeeb57cbd828580bcbcff21eb53,1,Li Yang,2015-09-06 15:34:16+08:00,['370b83f627fd005bf0f7cb897561fe819673b72d'],6,3,9,14406254,1,,,,9644
790635212a2b5c307fc5fea508790fb4f3d56d58,0,Luke Han,2015-09-06 15:57:28+08:00,"['a2707ea816eb13edcabcc8b7ea58b2ef47cbad47', '63aa4de9d36a378f968350d611c534d54dd15963']",72,77,149,14406403,6,,,,9644
6cfb95d4d3edfc78ee6f3216b70d96dcf33d2b70,0,shaofengshi,2015-09-06 16:18:57+08:00,['790635212a2b5c307fc5fea508790fb4f3d56d58'],1,1,2,14406405,1,,,,9644
db8aa51dc2aa3e696d5a9f36f1b152dbb5be2180,1,Luke Han,2015-09-06 16:26:25+08:00,['d4392a0b6135eeeeb57cbd828580bcbcff21eb53'],146,500,646,14407051,30,,,,9649
09fc93d841221c5a1000af4659598063672e7ed2,1,shaofengshi,2015-09-06 17:16:51+08:00,['db8aa51dc2aa3e696d5a9f36f1b152dbb5be2180'],7,17,24,14407075,4,0,0,0.75,9649
9cdc6f12ce38897c3469e5e5a4b6df3851a7062c,1,qianhao.zhou,2015-09-06 19:57:04+08:00,['09fc93d841221c5a1000af4659598063672e7ed2'],4,19,23,14407098,1,0.8,1,1,9649
7fc45d24d0019f79fc0e8437256e3337c2edc85d,0,shaofengshi,2015-09-06 21:31:59+08:00,['9cdc6f12ce38897c3469e5e5a4b6df3851a7062c'],1,1,2,14407100,1,,,,9649
beb10fd4a9da2cf62b0667fe3ddef1acc1a03156,0,shaofengshi,2015-09-06 22:07:55+08:00,['6cfb95d4d3edfc78ee6f3216b70d96dcf33d2b70'],21,44,65,14407165,6,1,1,1,9649
ab8aa20f5eb82b55dec7d5d066557c8612ea3c5c,0,shaofengshi,2015-09-07 09:03:35+08:00,['beb10fd4a9da2cf62b0667fe3ddef1acc1a03156'],1,12,13,14407178,1,1,1,1,9649
4bea5fc267086f2d1e3b7a00d1e06ef0c60c63eb,0,shaofengshi,2015-09-07 10:02:13+08:00,['ab8aa20f5eb82b55dec7d5d066557c8612ea3c5c'],4,4,8,14407186,2,,,,9649
5ff290037cca5ead43f8874621a6de2475d8c00f,1,honma,2015-09-07 10:11:24+08:00,['7fc45d24d0019f79fc0e8437256e3337c2edc85d'],6,7,13,14407199,1,0,0,1,9649
21f5ac08dffc038236cea652b3bf2cf4284cec51,1,honma,2015-09-07 10:49:08+08:00,['5ff290037cca5ead43f8874621a6de2475d8c00f'],3,36,39,14407238,10,1,1,1,9651
4c4df179a44849c83fa4dae76ebad96bdb52a740,0,honma,2015-09-07 10:49:24+08:00,['4bea5fc267086f2d1e3b7a00d1e06ef0c60c63eb'],3,36,39,14407277,10,1,1,1,9653
87a54bee1ee48660a1a423834208eda753061184,0,shaofengshi,2015-09-07 13:48:06+08:00,['4c4df179a44849c83fa4dae76ebad96bdb52a740'],3,10,13,14407290,2,,,,9653
dafe4ebc475a8c7f3154d2fc6558ce33ed4c03d4,0,Li Yang,2015-09-07 13:59:04+08:00,['87a54bee1ee48660a1a423834208eda753061184'],7,11,18,14407308,1,,,,9653
8536310c48f85f32f82e28ef3b558539fa16e0a0,0,honma,2015-09-07 14:38:56+08:00,['21f5ac08dffc038236cea652b3bf2cf4284cec51'],4,5,9,14407317,1,1,1,1,9653
48db29c2e7270f50624afc4de3b86e52fc509820,0,Luke Han,2015-09-07 15:27:06+08:00,['dafe4ebc475a8c7f3154d2fc6558ce33ed4c03d4'],70,52,122,14407439,5,,,,9653
7250224d9633f35cee75e6e0a551541c27eb11ce,1,Luke Han,2015-09-07 16:07:51+08:00,['48db29c2e7270f50624afc4de3b86e52fc509820'],13,81,94,14407533,3,,,,9654
2f4a7a16c0484bf1773a9aebb699849e180c98ef,0,shaofengshi,2015-09-07 16:11:04+08:00,['8536310c48f85f32f82e28ef3b558539fa16e0a0'],20,20,40,14407573,4,,,,9654
acab4085a4837f147ce2b1c882aa37c25d1f1bfe,1,shaofengshi,2015-09-07 16:11:39+08:00,['7250224d9633f35cee75e6e0a551541c27eb11ce'],42,67,109,14407682,6,0,1,1,9654
50d31bcaf631974bf1556c5ecc7e479d7df6602f,0,Luke Han,2015-09-07 16:23:34+08:00,['7250224d9633f35cee75e6e0a551541c27eb11ce'],7,8,15,14407697,6,,,,9654
59ae69430a4337c77c5fe9942509599704a02f01,0,Luke Han,2015-09-07 16:23:55+08:00,"['50d31bcaf631974bf1556c5ecc7e479d7df6602f', 'acab4085a4837f147ce2b1c882aa37c25d1f1bfe']",42,67,109,14407806,6,,,,9654
f782de797172ad047eb2453e1dce7c6fda78225b,1,shaofengshi,2015-09-07 17:33:00+08:00,['59ae69430a4337c77c5fe9942509599704a02f01'],76,22,98,14407904,9,0,0,0,9654
7b40fba63e6205b3865ec05a48c587cd6f7cfdd6,1,Zhong Jian,2015-09-07 18:23:03+08:00,['2f4a7a16c0484bf1773a9aebb699849e180c98ef'],51,53,104,14408008,11,0.111111111,0,0,9654
2a381e603df4ba6642c6d7292563ad60f8b2eacd,1,honma,2015-09-07 19:05:49+08:00,['7b40fba63e6205b3865ec05a48c587cd6f7cfdd6'],87,77,164,14408172,21,,,,9654
81dd0f9adbdb0d716da7f0dccce3f3a0353fce23,0,shaofengshi,2015-09-07 21:23:25+08:00,['f782de797172ad047eb2453e1dce7c6fda78225b'],1,97,98,14408270,1,0,0,1,9654
6e993a8c374d0305ef206496f506fa7f0e8f834d,0,shaofengshi,2015-09-07 21:41:35+08:00,['81dd0f9adbdb0d716da7f0dccce3f3a0353fce23'],33,18,51,14408321,1,1,1,0,9654
39f051b71be2b83ffed907d522926276aa572834,1,shaofengshi,2015-09-07 21:42:35+08:00,['2a381e603df4ba6642c6d7292563ad60f8b2eacd'],1,97,98,14408419,1,0,0,1,9654
1603029bb2c4d9186206c97b2c866b299766aab7,1,shaofengshi,2015-09-07 21:49:03+08:00,['39f051b71be2b83ffed907d522926276aa572834'],35,20,55,14408474,1,1,1,0,9654
252c93209d95a9c1e1d4b066333cc57e2f3d08cf,0,Luke Han,2015-09-08 09:53:26+08:00,['6e993a8c374d0305ef206496f506fa7f0e8f834d'],9,11,20,14408494,3,,,,9654
876079188d0fea1bcc2a8871c5e8da03725fff80,0,shaofengshi,2015-09-08 13:54:42+08:00,['252c93209d95a9c1e1d4b066333cc57e2f3d08cf'],1,1,2,14408496,1,,,,9654
2cee641b44e81ef12099ad0c82b1e554889bccaf,0,shaofengshi,2015-09-08 13:55:34+08:00,['1603029bb2c4d9186206c97b2c866b299766aab7'],1,1,2,14408498,1,,,,9654
1ed767fab4d623262ec233c0466a84cac9a2d73b,0,shaofengshi,2015-09-09 09:50:14+08:00,['876079188d0fea1bcc2a8871c5e8da03725fff80'],6,3,9,14408507,2,0,0,1,9654
70d1125a54017b00d537710e041360355ada9b4a,0,shaofengshi,2015-09-09 09:50:29+08:00,['2cee641b44e81ef12099ad0c82b1e554889bccaf'],2,3,5,14408512,1,0,0,1,9654
b90fac1a1d09704b7c0d3a75983a2b65b10668a4,0,shaofengshi,2015-09-09 10:03:52+08:00,['70d1125a54017b00d537710e041360355ada9b4a'],3191,2,3193,14411705,13,0.458512931,0.371767241,0.037176724,9654
a6c338918e2cb76e9b3f4b3c212c8aff947f3a3b,0,shaofengshi,2015-09-09 10:14:01+08:00,['b90fac1a1d09704b7c0d3a75983a2b65b10668a4'],28,30,58,14411763,3,1,1,1,9654
449c771d18d1a795dcb8a20dd08da1d8042196b9,1,honma,2015-09-09 10:50:52+08:00,['a6c338918e2cb76e9b3f4b3c212c8aff947f3a3b'],16,47,63,14411826,5,0,0,0.958333333,9654
6d868f8ed46d91c35c662de4265f8c3117feeb7e,0,honma,2015-09-09 10:50:52+08:00,['449c771d18d1a795dcb8a20dd08da1d8042196b9'],0,327,327,14412153,2,0.262295082,0.508196721,0.93442623,9656
4af0f33248fc50c35092878c9c5d6738e51c73c2,1,honma,2015-09-09 10:50:52+08:00,['6d868f8ed46d91c35c662de4265f8c3117feeb7e'],21,35,56,14412209,3,0.5,0.5,1,9656
bb983e760e0981242175d177d8c55d40fa0c91fd,0,shaofengshi,2015-09-09 13:40:23+08:00,['1ed767fab4d623262ec233c0466a84cac9a2d73b'],41,44,85,14412294,1,1,1,1,9656
7beb3bf24806bf6ae2491b8c2ecc89aaf868460e,0,qianhao.zhou,2015-09-09 15:45:39+08:00,['bb983e760e0981242175d177d8c55d40fa0c91fd'],0,112,112,14412406,1,,,,9657
50aa5fe6279fbe8450db9c95d36d8750744be4b1,0,shaofengshi,2015-09-09 16:36:09+08:00,['7beb3bf24806bf6ae2491b8c2ecc89aaf868460e'],2,1,3,14412409,1,,,,9657
83827befae76e9b52791742b00505d3ec6801581,0,shaofengshi,2015-09-09 16:39:46+08:00,['4af0f33248fc50c35092878c9c5d6738e51c73c2'],2,1,3,14412412,1,,,,9657
12b888d2168e79dad0bbea09fc38fd566541915b,0,shaofengshi,2015-09-09 16:52:53+08:00,['50aa5fe6279fbe8450db9c95d36d8750744be4b1'],0,2,2,14412414,1,0,1,1,9657
0b42db158d1f953ef25c716b42602879c6f440f8,0,shaofengshi,2015-09-09 16:58:52+08:00,['83827befae76e9b52791742b00505d3ec6801581'],2,4,6,14412420,3,0,1,1,9657
ea581d7f5f0ef888923008f8ffccfaef46f49622,1,Zhong Jian,2015-09-10 18:11:23+08:00,['0b42db158d1f953ef25c716b42602879c6f440f8'],381,21,402,14412822,8,0.151612903,0,0.029032258,9657
122c9834353990fdf2599c919fb22fd9fac70879,0,Li Yang,2015-09-11 11:34:01+08:00,['ea581d7f5f0ef888923008f8ffccfaef46f49622'],255,167,422,14413244,19,0.80952381,0.285714286,0.317460317,9657
5e6eb87e1f3b6deac75bee5d303596f9853140a2,1,Li Yang,2015-09-11 11:34:04+08:00,['122c9834353990fdf2599c919fb22fd9fac70879'],8,297,305,14413549,4,0.450704225,1,0.661971831,9658
1837a96076da884d22090e5d2c742122d360e263,1,Li Yang,2015-09-11 11:34:07+08:00,['5e6eb87e1f3b6deac75bee5d303596f9853140a2'],103,230,333,14413882,6,0.275862069,0.344827586,0.873563218,9658
0caa8c31e072e98fcd58b4459ee5e6f3bba9c8eb,0,Zhong Jian,2015-09-11 14:40:18+08:00,['1837a96076da884d22090e5d2c742122d360e263'],253,1,254,14414136,8,0,0,0,9658
3cee6fba122a0cee8ffab51d60b3f963fa36e0b1,1,Li Yang,2015-09-11 15:33:14+08:00,['12b888d2168e79dad0bbea09fc38fd566541915b'],13,16,29,14414165,1,0,1,1,9658
b487a5546945db2b0677df4c4fd56de62921225e,1,Li Yang,2015-09-11 15:37:08+08:00,['0caa8c31e072e98fcd58b4459ee5e6f3bba9c8eb'],14,17,31,14414196,1,0,1,1,9658
102beaf489e3daea965fae6e71dc6ce3361c8751,0,honma,2015-09-11 16:16:26+08:00,['b487a5546945db2b0677df4c4fd56de62921225e'],11,119,130,14414326,6,0.018518519,0.018518519,1,9659
a5401e098a8185720f54f754a64d5fa09e0f51f3,0,honma,2015-09-11 18:44:03+08:00,['3cee6fba122a0cee8ffab51d60b3f963fa36e0b1'],12,33,45,14414371,1,0,0,1,9659
6fa33190590a2f6f25cb7f8ef00ad433cc1647f0,1,Li Yang,2015-09-14 10:56:23+08:00,['102beaf489e3daea965fae6e71dc6ce3361c8751'],4,10,14,14414385,1,0,1,1,9659
8878dae0339fd343099b93a54b45130fda07a7fd,1,Li Yang,2015-09-14 10:58:02+08:00,['a5401e098a8185720f54f754a64d5fa09e0f51f3'],4,10,14,14414399,1,0,1,1,9659
0f0c841e2935372609757b75358d36456092ab72,1,Zhong Jian,2015-09-15 10:47:59+08:00,['6fa33190590a2f6f25cb7f8ef00ad433cc1647f0'],13,114,127,14414526,6,0.421875,1,0.71875,9659
4d2cfb59cc218369304e1b9330ab3d6bc5998d05,0,Zhong Jian,2015-09-15 16:46:19+08:00,['8878dae0339fd343099b93a54b45130fda07a7fd'],64,167,231,14414757,11,0.345454545,1,0.6,9659
2f67b71f2511b968b97def970fd29a41bd831f34,0,Luke Han,2015-09-15 17:55:10+08:00,['4d2cfb59cc218369304e1b9330ab3d6bc5998d05'],86,91,177,14414934,1,,,,9659
2a743fffb26c548546df5c75db7522524fba6331,0,Luke Han,2015-09-15 17:55:10+08:00,['2f67b71f2511b968b97def970fd29a41bd831f34'],12,17,29,14414963,7,,,,9659
5f631fa8beed25a36f3b8b4aa2e3e905a517e0fd,0,honma,2015-09-15 20:38:22+08:00,['0f0c841e2935372609757b75358d36456092ab72'],1,3,4,14414967,1,,,,9659
1be633f0fe5fa285d4c13185c0f1dc48f047522b,0,honma,2015-09-15 20:38:57+08:00,['2a743fffb26c548546df5c75db7522524fba6331'],1,3,4,14414971,1,,,,9659
86ef55f39d55ea09717bf2b7bad7ea02324d2e57,0,shaofengshi,2015-09-16 10:48:33+08:00,['5f631fa8beed25a36f3b8b4aa2e3e905a517e0fd'],146,151,297,14415268,27,,,,9661
ee3152c2e435fbd839e82577d7fb43e163a10d86,1,Li Yang,2015-09-16 11:04:24+08:00,['86ef55f39d55ea09717bf2b7bad7ea02324d2e57'],710,50,760,14416028,38,0.70411985,0.27340824,0.142322097,9661
a4d0661db38b159d24b41dd96ef9c84736b74fa9,1,shaofengshi,2015-09-16 21:01:59+08:00,['1be633f0fe5fa285d4c13185c0f1dc48f047522b'],8,8,16,14416044,1,,,0,9661
4deda33f248d18d94a71f0923f12b6709f135207,1,shaofengshi,2015-09-16 21:02:26+08:00,['a4d0661db38b159d24b41dd96ef9c84736b74fa9'],27,58,85,14416129,2,0.115384615,1,0.884615385,9661
ff9e5159a4172ccd04b859abf19a52f3687dcd36,0,Zhong Jian,2015-09-17 10:50:18+08:00,['4deda33f248d18d94a71f0923f12b6709f135207'],0,6,6,14416135,2,,,,9661
b060f9862b1ef24c0d481bcb6e9d4c5b7a02316e,1,honma,2015-09-17 14:09:09+08:00,['ee3152c2e435fbd839e82577d7fb43e163a10d86'],57,71,128,14416263,4,0,1,0.625,9661
a6a8c02343fab9d21179bff02864c3cae6e5cf35,0,honma,2015-09-17 14:09:09+08:00,['b060f9862b1ef24c0d481bcb6e9d4c5b7a02316e'],3,4,7,14416270,2,0,1,0,9661
b0edb3b7aa47c891b7cdffc76762a6ef32055aa1,0,honma,2015-09-17 14:09:09+08:00,['a6a8c02343fab9d21179bff02864c3cae6e5cf35'],5,31,36,14416306,2,1,1,1,9661
2363e0cf37533abbaf44eb002d51a49181101903,1,honma,2015-09-17 14:09:09+08:00,['b0edb3b7aa47c891b7cdffc76762a6ef32055aa1'],24,7,31,14416337,1,1,1,0,9661
d6caf99d37b9ed3ad8ffef9823bd8757b4085dc0,1,Zhong Jian,2015-09-17 14:35:43+08:00,['2363e0cf37533abbaf44eb002d51a49181101903'],256,279,535,14416872,6,1,1,1,9661
156132660c47a533132f361861e0f484cfc0e8b4,1,qianhao.zhou,2015-09-18 11:24:45+08:00,['d6caf99d37b9ed3ad8ffef9823bd8757b4085dc0'],204,873,1077,14417949,28,0.377708978,0.907120743,0.764705882,9669
eb3e9506286a011776c9eb4b910ad5ad2bdf1702,0,Li Yang,2015-09-18 15:44:11+08:00,['ff9e5159a4172ccd04b859abf19a52f3687dcd36'],5,6,11,14417960,1,,,,9669
b1889667ccaf3fe33d220ed4c329683ae3b438e3,0,Li Yang,2015-09-18 17:52:49+08:00,['156132660c47a533132f361861e0f484cfc0e8b4'],4,12,16,14417976,1,1,1,1,9669
0a598fe5c06c8ca69367030059444f0443e26fca,0,Li Yang,2015-09-19 07:46:05+08:00,"['eb3e9506286a011776c9eb4b910ad5ad2bdf1702', 'a277b08e88e88c59c11b2d1df75746d327e375fb']",0,0,0,14417976,0,,,,9669
a82df663e52ccfb91df8cb9fd8806cd4a252e23b,1,Li Yang,2015-09-19 08:10:32+08:00,['b1889667ccaf3fe33d220ed4c329683ae3b438e3'],1571,404,1975,14419951,89,0.947368421,0,0.894736842,9670
619696c71dd0919c8c1c460d3cdfd3e72171dc59,0,Li Yang,2015-09-19 08:10:33+08:00,['a82df663e52ccfb91df8cb9fd8806cd4a252e23b'],3,3,6,14419957,3,,,,9670
e15e07d900128fa07abe5a16aac8a2d34ae5c121,0,Li Yang,2015-09-19 08:10:33+08:00,['619696c71dd0919c8c1c460d3cdfd3e72171dc59'],2,2,4,14419961,1,,,,9670
81f543de09e2fca5edf1d4eb00ec730f80624557,0,Li Yang,2015-09-19 08:10:34+08:00,['e15e07d900128fa07abe5a16aac8a2d34ae5c121'],1,1,2,14419963,1,,,,9670
9793e9ad659d46bcc3da1b4f33f26a18a214a6a8,0,shaofengshi,2015-09-21 09:18:06+08:00,['eb3e9506286a011776c9eb4b910ad5ad2bdf1702'],35,17,52,14420015,2,0.4,0,0.066666667,9670
063c64ce53ebb2ea65891ac7f02260dfe317b257,0,qianhao.zhou,2015-09-21 11:00:04+08:00,['81f543de09e2fca5edf1d4eb00ec730f80624557'],107,30,137,14420152,2,0.214285714,1,0.214285714,9670
35262bb72b56ffa755d2765affcf5d60eafb5dc3,0,Zhong Jian,2015-09-21 11:16:46+08:00,['9793e9ad659d46bcc3da1b4f33f26a18a214a6a8'],1,7,8,14420160,1,0,0,0,9670
d3848c141905549b0dff38fef617bf1781223048,0,Zhong Jian,2015-09-21 14:28:08+08:00,['35262bb72b56ffa755d2765affcf5d60eafb5dc3'],15,1,16,14420176,3,0.214285714,0,0.214285714,9670
8d16ed6012dfd619a28a0427824d93fdd07ef87f,0,shaofengshi,2015-09-21 17:21:03+08:00,['d3848c141905549b0dff38fef617bf1781223048'],10,13,23,14420199,5,0.571428571,1,1,9670
02fe41e05e7f635cc41a3b9fdc74efc7da713d09,0,Li Yang,2015-09-22 10:10:46+08:00,['8d16ed6012dfd619a28a0427824d93fdd07ef87f'],1,1,2,14420201,1,,,,9670
80f7db4dedf2a50f0c843de0ea4bf3e0d9fd3150,0,Li Yang,2015-09-22 10:13:34+08:00,['063c64ce53ebb2ea65891ac7f02260dfe317b257'],2,2,4,14420205,1,,,,9670
3cdc0be35e47bba231351c127cf03973d2ba44af,1,honma,2015-09-22 10:59:56+08:00,['80f7db4dedf2a50f0c843de0ea4bf3e0d9fd3150'],10,855,865,14421070,49,,,,9670
60224708cdd60af36f292c11ef585e957dc79ee5,1,shaofengshi,2015-09-22 11:17:10+08:00,['3cdc0be35e47bba231351c127cf03973d2ba44af'],9,64,73,14421143,11,0.846153846,0.846153846,1,9670
745cbb6c7c2d9825f51d04cda17879da136320af,1,shaofengshi,2015-09-22 11:19:53+08:00,['60224708cdd60af36f292c11ef585e957dc79ee5'],5,209,214,14421357,5,0.744186047,0.790697674,1,9671
e8957c61efcde48d9a99984aa402b29207fc2ef4,1,shaofengshi,2015-09-22 11:40:26+08:00,['745cbb6c7c2d9825f51d04cda17879da136320af'],31,17,48,14421405,2,0,0,0,9671
8991d37040b1058219f0b8cbc70ebd5c28d0d77a,1,Li Yang,2015-09-22 14:52:58+08:00,['02fe41e05e7f635cc41a3b9fdc74efc7da713d09'],2,29,31,14421436,2,0,0,0,9672
0dc525d373328a7b21cbd01cea18b5c2097a6f1f,1,Li Yang,2015-09-22 15:00:02+08:00,['e8957c61efcde48d9a99984aa402b29207fc2ef4'],2,29,31,14421467,2,0,0,0,9673
6ac9e4facefd26741cfb3d9cd6eb9cee50320e02,0,Li Yang,2015-09-22 16:29:59+08:00,['0dc525d373328a7b21cbd01cea18b5c2097a6f1f'],1,6,7,14421474,1,,,,9673
09fc5b865db0a22d6c95833091652419653b1ac8,0,Li Yang,2015-09-22 16:31:31+08:00,['8991d37040b1058219f0b8cbc70ebd5c28d0d77a'],1,6,7,14421481,1,,,,9673
05449319f70c404c4123baf1f3da2080e26c50b8,1,Zhong Jian,2015-09-23 16:37:11+08:00,['6ac9e4facefd26741cfb3d9cd6eb9cee50320e02'],182,570,752,14422233,13,0.53125,0.541666667,0.989583333,9674
2bcfcfa8a517191906e4722d72554ac389f54bf1,0,Luke Han,2015-09-23 19:05:20+08:00,['09fc5b865db0a22d6c95833091652419653b1ac8'],7,20,27,14422260,6,,,,9674
68a723f018d1b091cd5e2b1b7ed4d0ff63c4d2ba,0,Li Yang,2015-09-25 10:33:55+08:00,['2bcfcfa8a517191906e4722d72554ac389f54bf1'],1,18,19,14422279,2,,,,9674
6d2837417c1cfe370ed3aa7bf3547decdd3edb77,1,qianhao.zhou,2015-09-25 10:47:43+08:00,['05449319f70c404c4123baf1f3da2080e26c50b8'],4641,353,4994,14427273,69,0.534613441,0.306720566,0.172814553,9678
8c346a9876db58d55bb099629922d80ea4629ed4,0,Zhong Jian,2015-09-25 15:27:33+08:00,['68a723f018d1b091cd5e2b1b7ed4d0ff63c4d2ba'],11,11,22,14427295,5,,,,9678
620a2dbb3f6f185a3c551d190c900b73db40a2a7,0,qianhao.zhou,2015-09-25 17:29:30+08:00,['6d2837417c1cfe370ed3aa7bf3547decdd3edb77'],41,2,43,14427338,1,1,0.2,1,9678
4df57c8399e471ed719ae31f3b8e25f3053b9f31,0,qianhao.zhou,2015-09-25 17:29:36+08:00,['620a2dbb3f6f185a3c551d190c900b73db40a2a7'],1,0,1,14427339,1,,,,9678
91e9bce94cf753d8e18128799d79db8b8ead8afa,0,shaofengshi,2015-09-25 23:31:31+08:00,['8c346a9876db58d55bb099629922d80ea4629ed4'],14,29,43,14427382,2,0.363636364,0,0.909090909,9678
8bc590850b58ea1c0e5b7a7b5dd77b485c8eca82,0,shaofengshi,2015-09-25 23:31:31+08:00,['91e9bce94cf753d8e18128799d79db8b8ead8afa'],5,132,137,14427519,4,,,,9680
58e6c118e61a906a8486fa3bff572a50c9b6ecaa,0,Li Yang,2015-09-26 09:56:05+08:00,['8bc590850b58ea1c0e5b7a7b5dd77b485c8eca82'],6,24,30,14427549,2,0,0,1,9680
d2cb7a5bc4d497f52a59b330b961ecccedd72c63,0,Li Yang,2015-09-26 10:23:43+08:00,['4df57c8399e471ed719ae31f3b8e25f3053b9f31'],5,24,29,14427578,2,0,0,1,9680
291ba3a2a0dba8052ab20799e8fa7bc7b4bc3b6a,0,shaofengshi,2015-09-28 09:09:03+08:00,['58e6c118e61a906a8486fa3bff572a50c9b6ecaa'],24,32,56,14427634,1,,,,9680
817ec109f38bc990ce0cd610f4367476dbb0d7a5,0,shaofengshi,2015-09-28 15:30:52+08:00,['291ba3a2a0dba8052ab20799e8fa7bc7b4bc3b6a'],13,100,113,14427747,1,0,0.044776119,1,9680
3f08afece3c95a61bd34718e298c60dfa2264aa4,0,shaofengshi,2015-09-28 15:36:21+08:00,['817ec109f38bc990ce0cd610f4367476dbb0d7a5'],1,1,2,14427749,1,,,,9680
89b0ac7672dd7d12fdfb19c2a814d86f72d1dc98,1,Li Yang,2015-09-28 16:47:51+08:00,['3f08afece3c95a61bd34718e298c60dfa2264aa4'],0,19,19,14427768,1,,,,9680
589a9a650b765a8b0eaf1f4b4f09179869ae7230,0,Li Yang,2015-09-28 16:54:37+08:00,['d2cb7a5bc4d497f52a59b330b961ecccedd72c63'],0,23,23,14427791,1,,,,9680
8661ff644c4fa1508fd1c47804ee4f2f93f9978e,0,Li Yang,2015-09-28 17:35:24+08:00,['89b0ac7672dd7d12fdfb19c2a814d86f72d1dc98'],0,1,1,14427792,1,,,,9680
aea2c3573ef4d1a4fa8149238bfa963659ad74fc,1,shaofengshi,2015-09-29 08:56:33+08:00,['589a9a650b765a8b0eaf1f4b4f09179869ae7230'],0,1178,1178,14428970,9,0.623778502,0.899022801,0.975570033,9687
b06408cf1f115da38c8a5b635842d4b255541a9e,1,shaofengshi,2015-09-29 08:56:33+08:00,['aea2c3573ef4d1a4fa8149238bfa963659ad74fc'],401,519,920,14429890,5,1,1,0.830188679,9689
d16e0a8c143d12d560022a7c80eff4890e16ea95,0,shaofengshi,2015-09-29 08:56:33+08:00,['b06408cf1f115da38c8a5b635842d4b255541a9e'],59,226,285,14430175,10,0.75,0.985294118,1,9691
afa038ed86a5e10b51c85cf9cc1fc3350f615caf,1,shaofengshi,2015-09-29 08:56:33+08:00,['d16e0a8c143d12d560022a7c80eff4890e16ea95'],81,429,510,14430685,15,0.714285714,0.971428571,0.892857143,9693
690d4b0825a0e1f0741c821b58ea1cb2442255f5,0,shaofengshi,2015-09-29 08:56:33+08:00,['afa038ed86a5e10b51c85cf9cc1fc3350f615caf'],158,71,229,14430914,3,0.486842105,0,0,9694
8fb0dd2d04f6456a93d95cacac55decc0b28860d,0,shaofengshi,2015-09-29 08:56:34+08:00,['690d4b0825a0e1f0741c821b58ea1cb2442255f5'],9,52,61,14430975,6,1,1,1,9694
b328f71eac0dfafd32fe3c9638bf9ee0ebb83fd7,1,shaofengshi,2015-09-29 09:00:05+08:00,['8fb0dd2d04f6456a93d95cacac55decc0b28860d'],88,500,588,14431563,29,0.432692308,0.475961538,0.596153846,9698
824750bec53a753593e0afe9667f90202eda5306,0,shaofengshi,2015-09-29 09:01:02+08:00,['b328f71eac0dfafd32fe3c9638bf9ee0ebb83fd7'],6,5,11,14431574,2,1,1,1,9698
39c45e1a1afdd95f5eb07d7ca673abe863af6d02,0,shaofengshi,2015-09-29 09:01:02+08:00,['824750bec53a753593e0afe9667f90202eda5306'],3,6,9,14431583,2,,,,9698
779cc005d90b6ebd7b1baee331a191884046cfe4,0,shaofengshi,2015-09-29 09:01:23+08:00,['39c45e1a1afdd95f5eb07d7ca673abe863af6d02'],3,5,8,14431591,4,,,,9698
d79edfba1ceaac7b8e8a7f9f3b33f92085488223,0,shaofengshi,2015-09-29 09:01:23+08:00,['779cc005d90b6ebd7b1baee331a191884046cfe4'],0,6,6,14431597,6,,,,9698
7bc6014ed56dd7eff7823943c0fbd2fcf39d83cf,0,shaofengshi,2015-09-29 09:01:23+08:00,['d79edfba1ceaac7b8e8a7f9f3b33f92085488223'],0,2,2,14431599,1,,,,9698
44a2d08118d224be028f798d162467656d366bdb,0,shaofengshi,2015-09-29 09:01:53+08:00,['7bc6014ed56dd7eff7823943c0fbd2fcf39d83cf'],11,92,103,14431702,9,1,1,1,9699
a927ba9b300c339052c1050a92a5fefff9ef502a,1,shaofengshi,2015-09-29 09:01:53+08:00,['44a2d08118d224be028f798d162467656d366bdb'],2,3,5,14431707,1,0,0,1,9699
99fc611f1559cdb7668b64c41e06a6fac31fafc1,0,shaofengshi,2015-09-29 09:01:53+08:00,['a927ba9b300c339052c1050a92a5fefff9ef502a'],58,43,101,14431808,2,0.461538462,0,0,9699
5b042c59b06aa2304153cee39290162a5dffa762,1,shaofengshi,2015-09-29 09:01:53+08:00,['99fc611f1559cdb7668b64c41e06a6fac31fafc1'],11,31,42,14431850,10,0.84,1,1,9699
63965d3491f37525bfc560bc1c5b53623a1364ae,1,shaofengshi,2015-09-29 09:01:53+08:00,['5b042c59b06aa2304153cee39290162a5dffa762'],34,69,103,14431953,7,0.292682927,0,0.829268293,9699
ffe1438eae3754f9c6b9b8e49aebcf4389495127,0,shaofengshi,2015-09-29 09:01:53+08:00,['63965d3491f37525bfc560bc1c5b53623a1364ae'],1,1,2,14431955,1,,,,9699
048ac4dcb0a50657269eaf093639ff140213a24f,0,shaofengshi,2015-09-29 09:01:53+08:00,['ffe1438eae3754f9c6b9b8e49aebcf4389495127'],1,1,2,14431957,1,,,,9699
32b1e429f5cb21c48da5711475498afdf675fe68,0,shaofengshi,2015-09-29 09:02:21+08:00,['048ac4dcb0a50657269eaf093639ff140213a24f'],35,79,114,14432071,10,0,0,0,9699
97b4ea894e70efd39996ff6e2209f63678c0601e,0,shaofengshi,2015-09-29 09:02:21+08:00,['32b1e429f5cb21c48da5711475498afdf675fe68'],3,22,25,14432096,4,0.076923077,1,1,9699
f506935f127856edb674fc9a8f821d70a00e4d9b,0,shaofengshi,2015-09-29 09:02:21+08:00,['97b4ea894e70efd39996ff6e2209f63678c0601e'],6,34,40,14432136,2,1,1,1,9699
e2fe11d87a51cbeb31522a9360a08d667fd6a45a,0,shaofengshi,2015-09-29 09:02:21+08:00,['f506935f127856edb674fc9a8f821d70a00e4d9b'],5,2,7,14432143,1,,,,9699
9cb7771d1aed2e97cde03e22bf42955b8b70dea4,0,shaofengshi,2015-09-29 09:02:21+08:00,['e2fe11d87a51cbeb31522a9360a08d667fd6a45a'],5,14,19,14432162,1,0,0.666666667,0.666666667,9699
152bc1110579b179ef25b1b86e2bc6242f691276,0,shaofengshi,2015-09-29 09:02:48+08:00,['9cb7771d1aed2e97cde03e22bf42955b8b70dea4'],1,1,2,14432164,1,,,,9699
7e855317dd9b6081ca977741cf5da3eb8c1293cd,1,shaofengshi,2015-09-29 09:02:48+08:00,['152bc1110579b179ef25b1b86e2bc6242f691276'],53,198,251,14432415,7,1,1,1,9701
4d14de1c84cf4bd3095dea253746c3703d97b238,0,shaofengshi,2015-09-29 09:02:48+08:00,['7e855317dd9b6081ca977741cf5da3eb8c1293cd'],1,1,2,14432417,1,,,,9701
c8f7777d25c3e160adb7aeec6c9940dc11331f3b,0,shaofengshi,2015-09-29 09:18:46+08:00,['4d14de1c84cf4bd3095dea253746c3703d97b238'],87,0,87,14432504,1,0,0,0,9701
9099bbc3fe681419bb99bb8fe7272f37aa6f2963,0,shaofengshi,2015-09-29 09:27:52+08:00,['c8f7777d25c3e160adb7aeec6c9940dc11331f3b'],12,93,105,14432609,1,0,0,1,9701
56db4b5c6fcdcd638449d22fc3d4ca0a83f24d36,0,shaofengshi,2015-09-29 09:42:48+08:00,['8661ff644c4fa1508fd1c47804ee4f2f93f9978e'],0,1,1,14432610,1,,,,9701
e51d900d156bd126b8d186e0bc902e7745d830c2,1,shaofengshi,2015-09-29 11:19:49+08:00,['9099bbc3fe681419bb99bb8fe7272f37aa6f2963'],40,52,92,14432702,4,0,0,0,9701
25a04f9a5681df7f36952c416fdab85927d42d82,0,shaofengshi,2015-09-29 13:55:51+08:00,['56db4b5c6fcdcd638449d22fc3d4ca0a83f24d36'],3,5,8,14432710,1,1,1,0,9701
e160c63db14e0d8e0a47630683469e59c17f05f9,0,shaofengshi,2015-09-29 13:57:04+08:00,['e51d900d156bd126b8d186e0bc902e7745d830c2'],3,5,8,14432718,1,1,1,0,9701
d60a788d6803e68e1da70bf01ec4fdca53f666ee,0,Li Yang,2015-09-29 15:40:26+08:00,['25a04f9a5681df7f36952c416fdab85927d42d82'],137,330,467,14433185,4,0.77173913,0.77173913,0.891304348,9702
63c6ec3731d4a0e845f8f9cd659af757c9404a4f,0,Li Yang,2015-09-29 17:42:35+08:00,['d60a788d6803e68e1da70bf01ec4fdca53f666ee'],199,195,394,14433579,6,1,1,0,9703
e126be9b3d178f883970f7b611e7e00e623c573a,0,Li Yang,2015-09-30 14:55:05+08:00,['63c6ec3731d4a0e845f8f9cd659af757c9404a4f'],1662,100,1762,14435341,7,0.204892966,0.167176351,0.219164118,9703
71986e2acca2f09c02ad0eabb1927ec9b4338ce4,1,Li Yang,2015-09-30 15:06:46+08:00,['e160c63db14e0d8e0a47630683469e59c17f05f9'],215,116,331,14435672,5,0.802083333,0.84375,1,9703
38b2e0f1d7a67a3034bd05b66b6aa10d1dd1d063,0,shaofengshi,2015-09-30 15:33:32+08:00,['e126be9b3d178f883970f7b611e7e00e623c573a'],0,58,58,14435730,1,,,,9703
1ee09fdbcaa981f9fbee93f897cb572d6306de2f,0,shaofengshi,2015-09-30 15:33:32+08:00,['38b2e0f1d7a67a3034bd05b66b6aa10d1dd1d063'],187,0,187,14435917,11,,,,9703
d5600608e32e378fb02257a5d6e97f7a7f4a100e,1,Li Yang,2015-10-01 09:15:36+08:00,['71986e2acca2f09c02ad0eabb1927ec9b4338ce4'],1,2,3,14435920,1,0,1,1,9703
cabbec21133c0ac4b82368624e6dc1b9b8b0a3dc,1,Li Yang,2015-10-04 19:43:23+08:00,['1ee09fdbcaa981f9fbee93f897cb572d6306de2f'],91,7,98,14436018,8,0,1,1,9703
1c5e31782328d20be5117b85a67b02d356691c0e,0,Li Yang,2015-10-04 20:51:36+08:00,['cabbec21133c0ac4b82368624e6dc1b9b8b0a3dc'],10,6,16,14436034,4,,,,9703
a3a7a76879972e8ba0e4244404bf1e8ec1d348b9,0,Li Yang,2015-10-04 20:56:41+08:00,['1c5e31782328d20be5117b85a67b02d356691c0e'],0,46,46,14436080,1,1,1,1,9704
3a81733e9aa30c8d22ee6fa4463303ea15913a54,0,Li Yang,2015-10-04 21:57:37+08:00,['d5600608e32e378fb02257a5d6e97f7a7f4a100e'],43,98,141,14436221,8,0.928571429,1,1,9706
55306dfd84a2e6808050f964771c2a75cbcb8c04,0,Li Yang,2015-10-05 21:31:48+08:00,['a3a7a76879972e8ba0e4244404bf1e8ec1d348b9'],0,11,11,14436232,1,0,0,0,9706
18e43e0aca2b0c6a306f5cb2f0198d4a04215d50,1,Li Yang,2015-10-05 21:34:17+08:00,['3a81733e9aa30c8d22ee6fa4463303ea15913a54'],0,11,11,14436243,1,0,0,0,9706
b59a87b5d494b3e5d7faa17a0e608a7a18e81959,0,Li Yang,2015-10-06 15:20:25+08:00,['55306dfd84a2e6808050f964771c2a75cbcb8c04'],4,0,4,14436247,1,,,,9706
279430a861c431d9680bd09b2c6087c7711e5503,0,Li Yang,2015-10-06 18:54:59+08:00,['b59a87b5d494b3e5d7faa17a0e608a7a18e81959'],950,1014,1964,14438211,11,0,0.965517241,0.965517241,9706
81750e2e1b86ffd6275a05a528ef53fa064aed23,0,Li Yang,2015-10-07 09:27:43+08:00,['279430a861c431d9680bd09b2c6087c7711e5503'],3,10,13,14438224,2,1,1,1,9706
e2c688d5419d77658e03ad11e37a75dc771a9005,1,Li Yang,2015-10-07 09:31:11+08:00,['18e43e0aca2b0c6a306f5cb2f0198d4a04215d50'],5,7,12,14438236,2,1,1,,9706
5479484a3bc7d079056672b2594e514e99560a51,0,Li Yang,2015-10-07 09:34:02+08:00,['e2c688d5419d77658e03ad11e37a75dc771a9005'],0,2,2,14438238,1,,,,9706
3698acd8be16fbd3ad0b7e33ef47d57686d6159a,0,Li Yang,2015-10-07 21:54:08+08:00,['81750e2e1b86ffd6275a05a528ef53fa064aed23'],6,5,11,14438249,1,,,,9706
7e8f19e471b67ed701f298651555f2c7c8d3f7fb,0,lukehan,2015-10-07 23:53:58+08:00,['81750e2e1b86ffd6275a05a528ef53fa064aed23'],0,23,23,14438272,2,,,,9707
0f832eb5542f1d305a11156c9745c362598035d1,0,lukehan,2015-10-07 23:54:13+08:00,"['7e8f19e471b67ed701f298651555f2c7c8d3f7fb', '3698acd8be16fbd3ad0b7e33ef47d57686d6159a']",6,5,11,14438283,1,,,,9707
35b424e9c3c7083ccb83007d4b1845891a087f53,0,lukehan,2015-10-07 23:58:08+08:00,['0f832eb5542f1d305a11156c9745c362598035d1'],1,1,2,14438285,1,,,,9707
a097458ff57598de554efee29d4013b79c0f962b,0,lukehan,2015-10-08 00:25:35+08:00,['35b424e9c3c7083ccb83007d4b1845891a087f53'],4,3,7,14438292,2,,,,9707
fab7f635125988e127efcd195ccedd6f075b3ff3,0,shaofengshi,2015-10-08 10:35:33+08:00,['a097458ff57598de554efee29d4013b79c0f962b'],1,1,2,14438294,1,,,,9707
1fa4d5d078efed6d9617600933c0104f059ee692,0,shaofengshi,2015-10-08 10:43:51+08:00,['fab7f635125988e127efcd195ccedd6f075b3ff3'],14,26,40,14438334,1,,,,9707
d88063207d956d680ddb678525724d4443029981,0,honma,2015-10-08 11:51:00+08:00,['1fa4d5d078efed6d9617600933c0104f059ee692'],4,9,13,14438347,1,,,,9707
a4897035bf4799f553d803c40fd9ce12b6a33def,0,shaofengshi,2015-10-08 13:56:43+08:00,['d88063207d956d680ddb678525724d4443029981'],0,9,9,14438356,1,,,,9707
b24aa184a74519f2e05716aaad5a33eee6bd4deb,0,shaofengshi,2015-10-08 15:59:38+08:00,['a4897035bf4799f553d803c40fd9ce12b6a33def'],2,6,8,14438364,1,0,0,1,9707
6f28adc2d607261ca676602535b4132f1b51b9b5,0,shaofengshi,2015-10-08 16:30:48+08:00,['b24aa184a74519f2e05716aaad5a33eee6bd4deb'],1,1,2,14438366,1,,,,9707
742b18fc6bada17bc085afff61175daeadf8e2cc,1,shaofengshi,2015-10-08 16:47:32+08:00,['5479484a3bc7d079056672b2594e514e99560a51'],30,41,71,14438437,1,,,,9707
e540ffcde01ae5065d81deb4171c7c1ba0c50107,0,Luke Han,2015-10-08 19:33:37+08:00,['6f28adc2d607261ca676602535b4132f1b51b9b5'],0,1,1,14438438,1,,,,9707
d078c4c3b08f8516a9aa564aa04cbb6b140da74d,0,Luke Han,2015-10-08 19:36:04+08:00,['e540ffcde01ae5065d81deb4171c7c1ba0c50107'],3,14,17,14438455,5,,,,9707
e8f226f2e8127dabef79a36420dc8724d0852688,0,shaofengshi,2015-10-09 18:07:58+08:00,['6f28adc2d607261ca676602535b4132f1b51b9b5'],18,16,34,14438489,13,,,,9707
3f2dbb97c20790205a2880d146ceb79c7a18ab6a,0,Li Yang,2015-10-12 10:44:15+08:00,['742b18fc6bada17bc085afff61175daeadf8e2cc'],2,2,4,14438493,1,,,,9707
a7605a6377eba4e6efa949eb83ddb7dc5080c473,0,Li Yang,2015-10-12 10:51:16+08:00,['d078c4c3b08f8516a9aa564aa04cbb6b140da74d'],2,2,4,14438497,1,,,,9707
0ec13e48e998c94b792616a15cc7964762f0bdc2,0,shaofengshi,2015-10-12 13:18:22+08:00,['3f2dbb97c20790205a2880d146ceb79c7a18ab6a'],3,16,19,14438516,1,0,1,0,9707
6afcb70e86004e8548e6d514fb6a16f244b88fc9,0,Li Yang,2015-10-12 13:22:42+08:00,['0ec13e48e998c94b792616a15cc7964762f0bdc2'],13,11,24,14438540,2,0,1,0,9707
8e79577b04caad863c28003ee34f2b06b1ec5d05,0,Li Yang,2015-10-12 13:53:36+08:00,['6afcb70e86004e8548e6d514fb6a16f244b88fc9'],1,1,2,14438542,1,,,,9707
80a3e80ba4aa1080cb3130ed28e67654e4c78091,0,Zhong Jian,2015-10-12 16:34:21+08:00,['a7605a6377eba4e6efa949eb83ddb7dc5080c473'],1,1,2,14438544,1,,,,9707
98aa22c8ff1aafb78eedfc480986701f0b082efe,1,Li Yang,2015-10-13 09:35:06+08:00,['8e79577b04caad863c28003ee34f2b06b1ec5d05'],10,46,56,14438600,6,0.954545455,1,0.954545455,9707
accf6f4cd27f2b750937e247a7f14d8bbb7d8703,0,Li Yang,2015-10-13 14:06:40+08:00,['80a3e80ba4aa1080cb3130ed28e67654e4c78091'],15,17,32,14438632,2,1,1,1,9707
bfaa3da7751e6d0338a5a3c260f35559a3522b90,0,Zhong Jian,2015-10-13 14:17:42+08:00,['accf6f4cd27f2b750937e247a7f14d8bbb7d8703'],0,1,1,14438633,1,,,,9707
118860ce400454963e48c8383c827f22a6f3e7a9,0,Li Yang,2015-10-13 14:26:52+08:00,['bfaa3da7751e6d0338a5a3c260f35559a3522b90'],7,13,20,14438653,1,1,1,1,9707
4e4a92bdf88fafe64ea9491549c29da1c08c748d,1,Li Yang,2015-10-13 14:43:10+08:00,['98aa22c8ff1aafb78eedfc480986701f0b082efe'],23,46,69,14438722,2,0.705882353,0,0.941176471,9707
26760c79a4f7dc2dd8d1e976a82771152b315f1c,1,Li Yang,2015-10-13 16:55:13+08:00,['4e4a92bdf88fafe64ea9491549c29da1c08c748d'],1,9,10,14438732,1,1,1,1,9707
e23e90802dd46186b8cb266b9af4df6479da6328,0,shaofengshi,2015-10-13 16:55:22+08:00,['118860ce400454963e48c8383c827f22a6f3e7a9'],0,1,1,14438733,1,1,1,1,9707
39979d81bd013330c195937a78c37681797f69a2,1,Li Yang,2015-10-13 17:36:21+08:00,['26760c79a4f7dc2dd8d1e976a82771152b315f1c'],63,98,161,14438894,36,1,1,1,9707
ca428f831f9d73116e8798c8588d5e505bdd594f,0,shaofengshi,2015-10-14 11:29:11+08:00,['e23e90802dd46186b8cb266b9af4df6479da6328'],1,2,3,14438897,1,0,1,1,9707
c17221de6b2050ed81f1509e8b232b9cc1782e5d,0,qianhao.zhou,2015-10-15 11:14:56+08:00,['39979d81bd013330c195937a78c37681797f69a2'],2,4,6,14438903,3,0,1,0,9707
b6384edd46fab5e1805dcbcd1690d3bb037d98df,0,Li Yang,2015-10-16 15:37:55+08:00,['ca428f831f9d73116e8798c8588d5e505bdd594f'],4,71,75,14438978,2,0.519230769,0.519230769,1,9707
3252a3c9ca30521e0222e92313b61296214b1af4,0,Li Yang,2015-10-16 17:45:30+08:00,['c17221de6b2050ed81f1509e8b232b9cc1782e5d'],0,3,3,14438981,1,1,1,1,9707
ac9d47838262b83155bd3a0f37e132a0f09e9af7,0,Li Yang,2015-10-20 15:58:54+08:00,['3252a3c9ca30521e0222e92313b61296214b1af4'],3,69,72,14439053,2,0.529411765,0.529411765,1,9707
747c3300d086e41c3f2d83154645f6ef3b4e0de0,0,Li Yang,2015-10-20 16:27:40+08:00,['b6384edd46fab5e1805dcbcd1690d3bb037d98df'],2,64,66,14439119,2,0.05,0.05,1,9707
91a579fddad66f5b26c942317c35e2ad5ec141ca,0,Li Yang,2015-10-20 17:06:11+08:00,['ac9d47838262b83155bd3a0f37e132a0f09e9af7'],3,65,68,14439187,2,0.05,0.05,1,9707
4d8d7d426d7434821fc82efad21247b020542861,0,Li Yang,2015-10-20 17:58:24+08:00,['747c3300d086e41c3f2d83154645f6ef3b4e0de0'],2,42,44,14439231,3,0,0,1,9708
c2fd0d0479432a00ced41fb5abda7c31f1943ef7,1,Li Yang,2015-10-20 18:03:09+08:00,['91a579fddad66f5b26c942317c35e2ad5ec141ca'],6,46,52,14439283,3,0,0,1,9709
a8f494c8da97d30dc49f7fd893509fdb66d6c2a1,0,shaofengshi,2015-10-21 07:44:54+08:00,['4d8d7d426d7434821fc82efad21247b020542861'],0,8,8,14439291,1,,,,9709
4ead9832fddd8aa2c52cff0f25f15a15e626e05c,0,Luke Han,2015-10-21 10:08:12+08:00,['a8f494c8da97d30dc49f7fd893509fdb66d6c2a1'],0,64,64,14439355,11,,,,9719
574ffc6642f23fa6ae741a9e178e7b0990bb469b,0,qianhao.zhou,2015-10-21 14:47:20+08:00,['c2fd0d0479432a00ced41fb5abda7c31f1943ef7'],3,3,6,14439361,2,,,,9719
a7a8578ecd732a950491ba76c82ddfd6286c92e8,0,qianhao.zhou,2015-10-21 14:47:20+08:00,['574ffc6642f23fa6ae741a9e178e7b0990bb469b'],44,45,89,14439450,2,1,1,0,9719
6e9ea1dfc6f3c5cebd1351a0c97a5528fcd60ef2,0,Luke Han,2015-10-21 21:40:08+08:00,['4ead9832fddd8aa2c52cff0f25f15a15e626e05c'],13,41,54,14439504,2,,,,9719
ed819d0ef767a4ca857fd1c709c573705e197d2a,0,Luke Han,2015-10-21 21:46:18+08:00,['6e9ea1dfc6f3c5cebd1351a0c97a5528fcd60ef2'],4,11,15,14439519,2,,,,9719
251f7ed34a64c608746f2c9609cad124a860dab3,1,Zhong Jian,2015-10-22 18:05:59+08:00,['a7a8578ecd732a950491ba76c82ddfd6286c92e8'],1325,3452,4777,14444296,51,0.483539095,0.763374486,0.903292181,9733
9859231078b3c1c952f62e1f36a61e19af16fdbb,1,Zhong Jian,2015-10-22 18:06:02+08:00,['251f7ed34a64c608746f2c9609cad124a860dab3'],2,19,21,14444317,1,0.8125,1,0.8125,9733
021d31f211ecc81a527f7759bb7633f94754cda1,0,Zhong Jian,2015-10-22 18:29:23+08:00,['9859231078b3c1c952f62e1f36a61e19af16fdbb'],1,1,2,14444319,1,,,,9733
434da3c61c61d2f293d4392a3d266ce153637a25,0,Luke Han,2015-10-23 10:51:04+08:00,['ed819d0ef767a4ca857fd1c709c573705e197d2a'],0,12,12,14444331,1,,,,9733
723c323cfcf51c7a828ae85a5c59f3b989a8d4d0,0,Luke Han,2015-10-23 10:55:26+08:00,['434da3c61c61d2f293d4392a3d266ce153637a25'],1,7,8,14444339,1,,,,9733
efe9201ee4a7acbfa1c40ec450f49e0826fe9c62,0,Zhong Jian,2015-10-23 10:57:29+08:00,['723c323cfcf51c7a828ae85a5c59f3b989a8d4d0'],2,19,21,14444360,1,0.8,1,0.8,9733
21b6529f818404c8dbf126d23518480a292ff478,0,Zhong Jian,2015-10-23 11:36:22+08:00,['efe9201ee4a7acbfa1c40ec450f49e0826fe9c62'],2,3,5,14444365,1,,,,9733
c59b78f1eb04fff32727f6c1a2d5a0863b710e88,0,Zhong Jian,2015-10-23 11:37:00+08:00,['021d31f211ecc81a527f7759bb7633f94754cda1'],2,3,5,14444370,1,,,,9733
59253d1a5c23842a8e084ed97084d9159938db91,0,Zhong Jian,2015-10-23 15:23:31+08:00,['c59b78f1eb04fff32727f6c1a2d5a0863b710e88'],1,5,6,14444376,1,,,,9733
8e69f8b5e62a0d9cc7dc6814ac2b1e6f1a18431c,0,Li Yang,2015-10-23 15:51:35+08:00,['21b6529f818404c8dbf126d23518480a292ff478'],1,1,2,14444378,1,,,,9733
9def7e2c75aa77efc915d63014fc2f4905783ab7,1,Li Yang,2015-10-23 15:52:55+08:00,['59253d1a5c23842a8e084ed97084d9159938db91'],1,1,2,14444380,1,,,,9733
4a04f65829d3163768c1b92145f26478c2593bc1,1,Li Yang,2015-10-23 17:33:20+08:00,['8e69f8b5e62a0d9cc7dc6814ac2b1e6f1a18431c'],74,27,101,14444481,9,0.821428571,1,0,9733
8cc245a7c15eb023fef223b4d9df5775aaa18e96,1,Li Yang,2015-10-23 18:09:18+08:00,['9def7e2c75aa77efc915d63014fc2f4905783ab7'],142,88,230,14444711,15,0.764705882,1,0,9733
22d94a4f5f17b8f1decbddacb611c66ab5e3fac1,0,shaofengshi,2015-10-25 17:04:46+08:00,['4a04f65829d3163768c1b92145f26478c2593bc1'],11,12,23,14444734,1,,,,9733
7dee9720b3f817a77c5db4175641cef3e14b8b7e,0,honma,2015-10-25 21:15:21+08:00,['8cc245a7c15eb023fef223b4d9df5775aaa18e96'],4,14,18,14444752,1,,,,9733
7b46c3d403e028af4dfe8ffab3177b663ccf54a3,0,honma,2015-10-25 21:15:21+08:00,['7dee9720b3f817a77c5db4175641cef3e14b8b7e'],0,0,0,14444752,1,,,,9733
f0f019f511e293330cb55a96c9a726b354855d01,1,honma,2015-10-25 21:15:21+08:00,['7b46c3d403e028af4dfe8ffab3177b663ccf54a3'],812,2930,3742,14448494,96,0.475239617,0.728434505,0.884984026,9744
45dcdaf5d054f7880e059ea8c349aa65a0ab6d36,1,honma,2015-10-25 21:15:21+08:00,['f0f019f511e293330cb55a96c9a726b354855d01'],139,599,738,14449232,26,0.23628692,0.303797468,0.907172996,9747
f71826fca6d7174cc14f98a4b6725dac69fd5fb7,1,honma,2015-10-26 10:35:52+08:00,['45dcdaf5d054f7880e059ea8c349aa65a0ab6d36'],24,27,51,14449283,3,1,1,1,9747
ece8887e918326bd5b15ca73701e24ce87f757ac,0,honma,2015-10-26 10:36:07+08:00,['f71826fca6d7174cc14f98a4b6725dac69fd5fb7'],114,3,117,14449400,4,,,,9747
37d4795b5c7ee411b31a9547e7d73764ddfecce9,0,shaofengshi,2015-10-26 11:28:51+08:00,['22d94a4f5f17b8f1decbddacb611c66ab5e3fac1'],12,94,106,14449506,3,,,,9747
2cca1492e6ecd1bea9529861df79d2cce0282b0d,0,shaofengshi,2015-10-26 11:36:59+08:00,['37d4795b5c7ee411b31a9547e7d73764ddfecce9'],18,16,34,14449540,13,,,,9747
dd37ada65259c97973fef863e74281637f8db1d2,0,shaofengshi,2015-10-26 11:36:59+08:00,['2cca1492e6ecd1bea9529861df79d2cce0282b0d'],14,14,28,14449568,13,,,,9747
409afe411dac73fbaa1b0e218fe9a9d7695edf87,0,shaofengshi,2015-10-26 11:39:31+08:00,['dd37ada65259c97973fef863e74281637f8db1d2'],2,4,6,14449574,1,,,,9747
6a9d1a29f176781766f8f25c830ffbbdc9724502,0,shaofengshi,2015-10-26 11:39:31+08:00,['409afe411dac73fbaa1b0e218fe9a9d7695edf87'],12,64,76,14449650,1,,,,9747
0b17a38b9fcdfc91ef3591c8513001d3fede0032,1,shaofengshi,2015-10-26 13:30:16+08:00,['ece8887e918326bd5b15ca73701e24ce87f757ac'],261,153,414,14450064,16,0.754901961,0.323529412,0.156862745,9747
78a240982aed3f67b5d01e7ff4639c3010086a71,1,shaofengshi,2015-10-26 13:35:24+08:00,['0b17a38b9fcdfc91ef3591c8513001d3fede0032'],88,113,201,14450265,12,0,0,0.178571429,9747
3d62265709c6fcbd3dc000ae8250e89a29ac7dfd,0,shaofengshi,2015-10-26 17:04:53+08:00,['6a9d1a29f176781766f8f25c830ffbbdc9724502'],2,2,4,14450269,2,,,,9747
0c0f763be5382a762096b9ec8f9290f57c89de52,0,shaofengshi,2015-10-26 17:06:17+08:00,"['0a598fe5c06c8ca69367030059444f0443e26fca', 'e8f226f2e8127dabef79a36420dc8724d0852688']",3217,2117,5334,14455603,92,,,,9747
938139b161f58313855a2990e021a8af0041b076,0,shaofengshi,2015-10-26 17:21:56+08:00,['3d62265709c6fcbd3dc000ae8250e89a29ac7dfd'],0,1,1,14455604,1,,,,9747
73584d64a4c82f14f16da9247ea93e1c92f090de,1,honma,2015-10-26 17:35:10+08:00,['78a240982aed3f67b5d01e7ff4639c3010086a71'],10,71,81,14455685,9,0.666666667,0.966666667,0.7,9748
8e47a492b6afee95f4bf763739b679d4abdea1f9,1,honma,2015-10-27 11:45:06+08:00,['73584d64a4c82f14f16da9247ea93e1c92f090de'],71,228,299,14455984,14,0,0.172413793,0.49137931,9748
ba53238e4a561be2a0a6adf491f71a4af373bd5b,0,honma,2015-10-27 14:11:46+08:00,['8e47a492b6afee95f4bf763739b679d4abdea1f9'],3,2,5,14455989,2,1,0,1,9748
d25be74104f2002ea6dfa1bc8802adcb91c08d9e,0,honma,2015-10-27 14:24:01+08:00,['ba53238e4a561be2a0a6adf491f71a4af373bd5b'],0,0,0,14455989,2,,,,9748
0bdb316566f98b53ded1bd96272f6a0dc541449d,0,Li Yang,2015-10-27 14:28:45+08:00,['938139b161f58313855a2990e021a8af0041b076'],19,1,20,14456009,1,0,0,0,9748
0275bc4131414501fdeeb63c2004a69ae490fdd3,0,Li Yang,2015-10-27 14:31:13+08:00,['d25be74104f2002ea6dfa1bc8802adcb91c08d9e'],16,1,17,14456026,1,0,0,0,9748
888843dca3f702ef4ff5e36c38e8a857cc26531c,0,Li Yang,2015-10-27 15:29:00+08:00,['0275bc4131414501fdeeb63c2004a69ae490fdd3'],3,0,3,14456029,1,,,,9748
1c154d17ad18e76cac9035fdfb2c7a60fb6eae16,0,shaofengshi,2015-10-28 13:03:59+08:00,['0bdb316566f98b53ded1bd96272f6a0dc541449d'],8,10,18,14456047,3,,,,9748
a16354061ba6d5a2078c0f6fc520e10d83f923ae,0,honma,2015-10-28 14:44:13+08:00,['888843dca3f702ef4ff5e36c38e8a857cc26531c'],17,41,58,14456105,7,0,0,0,9748
40dc3d0812ae9c140f15a091bdc142d239428370,0,honma,2015-10-28 15:19:51+08:00,['a16354061ba6d5a2078c0f6fc520e10d83f923ae'],7,54,61,14456166,3,0.352941176,0.352941176,1,9748
0633584fceee45679a2e02f0e86b0912c4224342,1,honma,2015-10-28 15:20:23+08:00,['40dc3d0812ae9c140f15a091bdc142d239428370'],11,6,17,14456183,2,0,0,0,9748
0342520e514bbc49b2caf9e6c122f8c17e2632ee,0,honma,2015-10-28 15:21:04+08:00,['0633584fceee45679a2e02f0e86b0912c4224342'],0,0,0,14456183,2,,,,9748
aea99b27321847f82b54a3fab01578bd4b63a8e9,0,Li Yang,2015-10-28 15:51:52+08:00,['1c154d17ad18e76cac9035fdfb2c7a60fb6eae16'],13,74,87,14456270,5,1,0,0,9751
6350f31585900395c5a13d2ba24b73e9edcb273f,0,Li Yang,2015-10-28 16:10:46+08:00,['0342520e514bbc49b2caf9e6c122f8c17e2632ee'],14,74,88,14456358,5,1,0,0,9754
171f98df10a79dd417b1afe4da124ee1639a84c7,0,Li Yang,2015-10-28 17:57:58+08:00,['aea99b27321847f82b54a3fab01578bd4b63a8e9'],3,3,6,14456364,2,,,,9754
ddb2e5c8dcc3fea4a088efd743c0e2e34a112bca,0,Li Yang,2015-10-28 18:03:23+08:00,['6350f31585900395c5a13d2ba24b73e9edcb273f'],3,17,20,14456384,2,1,1,1,9754
c9938c54e754d0b22fce3358d773e81d1c5e0544,0,Li Yang,2015-10-28 18:04:05+08:00,['171f98df10a79dd417b1afe4da124ee1639a84c7'],4,17,21,14456405,2,1,1,1,9754
b06f12d6b4de127132722062ee975cbf08c6e9b3,0,qianhao.zhou,2015-10-29 11:30:06+08:00,['ddb2e5c8dcc3fea4a088efd743c0e2e34a112bca'],176,316,492,14456897,5,0.338709677,1,0.290322581,9756
c0d11946bf06d2277ecaba9ce2e3186bfb198b2e,0,Li Yang,2015-10-29 11:51:18+08:00,['b06f12d6b4de127132722062ee975cbf08c6e9b3'],1,3,4,14456901,2,1,1,1,9756
2fa7b62fca83e7b119528e6e14ce3baad748b599,0,Zhong Jian,2015-10-29 14:59:00+08:00,['c9938c54e754d0b22fce3358d773e81d1c5e0544'],0,0,0,14456901,1,,,,9756
08ccf6f17163c9727eb6630a11c571efdcabd9b4,0,Zhong Jian,2015-10-29 15:01:29+08:00,['2fa7b62fca83e7b119528e6e14ce3baad748b599'],0,5,5,14456906,1,0,0,1,9756
baed8ae05f12f4c177a0dc77882e8c4d7570bc87,0,Zhong Jian,2015-10-29 15:17:07+08:00,['c0d11946bf06d2277ecaba9ce2e3186bfb198b2e'],0,5,5,14456911,1,0,0,1,9756
8e44c8bc6fe92f53cae11320b8c567bddc1283cc,0,Zhong Jian,2015-10-29 15:19:02+08:00,['baed8ae05f12f4c177a0dc77882e8c4d7570bc87'],0,0,0,14456911,1,,,,9756
9fbf07fc41576379440ad29ef5616ae02c345c07,0,Zhong Jian,2015-10-29 17:04:10+08:00,['08ccf6f17163c9727eb6630a11c571efdcabd9b4'],2,25,27,14456938,3,0,1,1,9756
aa7b54c89c261b5173a9e4d0f8e970dddafcc2d4,0,Zhong Jian,2015-10-29 17:22:58+08:00,['8e44c8bc6fe92f53cae11320b8c567bddc1283cc'],2,26,28,14456966,3,0,1,1,9756
11c9c9ad3108c2740326334db41a9486e840a0f1,0,qianhao.zhou,2015-10-29 17:25:26+08:00,['aa7b54c89c261b5173a9e4d0f8e970dddafcc2d4'],2,2,4,14456970,1,,,,9756
74499e8ba38c025fd01e903602017541edb39dd8,1,shaofengshi,2015-10-29 17:26:22+08:00,['11c9c9ad3108c2740326334db41a9486e840a0f1'],15,203,218,14457188,5,0.377192982,0.00877193,0.631578947,9757
277e892ba2fa998ab9e779763794eafb7afd6241,0,shaofengshi,2015-10-29 17:26:22+08:00,['74499e8ba38c025fd01e903602017541edb39dd8'],1,8,9,14457197,3,0,0,0,9757
cab19a871bc6c83bd85f24bd88e7700f44ec3b93,0,shaofengshi,2015-10-29 17:26:22+08:00,['277e892ba2fa998ab9e779763794eafb7afd6241'],0,0,0,14457197,1,,,,9757
181f76f7833962050b9210db91933acc13534db9,0,Zhong Jian,2015-10-29 17:29:37+08:00,['cab19a871bc6c83bd85f24bd88e7700f44ec3b93'],1,1,2,14457199,1,,,,9757
6b126bf11765c22a03c02df47d162cce43695f03,0,Li Yang,2015-10-29 17:35:55+08:00,['9fbf07fc41576379440ad29ef5616ae02c345c07'],96,309,405,14457604,9,0.322580645,0.516129032,0.741935484,9761
d2cc1f43131f2c33bf87df249340727c78c66692,0,Li Yang,2015-10-29 17:35:59+08:00,['6b126bf11765c22a03c02df47d162cce43695f03'],22,17,39,14457643,5,1,1,1,9761
3c9e0813a0eadefcd501a10938c6212338315e82,0,Zhong Jian,2015-10-30 14:43:36+08:00,['181f76f7833962050b9210db91933acc13534db9'],2,1,3,14457646,1,,,,9761
c87fccdb56eb04fecebd9882ce4ac60a434005fa,0,Zhong Jian,2015-10-30 14:46:16+08:00,['d2cc1f43131f2c33bf87df249340727c78c66692'],2,1,3,14457649,1,,,,9761
9c996759e21000ceef0546a3a6db2c233abccdfb,0,qianhao.zhou,2015-11-02 10:39:05+08:00,['c87fccdb56eb04fecebd9882ce4ac60a434005fa'],1,9,10,14457659,1,0,0,1,9761
5fe30c70766b012f965b5d7f94217188e7587b25,0,qianhao.zhou,2015-11-02 10:42:03+08:00,['3c9e0813a0eadefcd501a10938c6212338315e82'],1,9,10,14457669,1,0,0,1,9761
69bdff40274db6ec780f34c5d36cac2b91873871,0,Li Yang,2015-11-02 11:29:21+08:00,['9c996759e21000ceef0546a3a6db2c233abccdfb'],14,26,40,14457709,3,1,0.8,1,9761
1f1060f1d72ed89a6a564cfea97d63da794d43c8,1,Li Yang,2015-11-02 12:53:50+08:00,['5fe30c70766b012f965b5d7f94217188e7587b25'],16,39,55,14457764,12,0.818181818,0.818181818,1,9761
b622b52c1d8737c73742cfbce65fce4374fc8f95,0,Li Yang,2015-11-02 14:21:36+08:00,['1f1060f1d72ed89a6a564cfea97d63da794d43c8'],14,3,17,14457781,3,,,,9761
29468faa70672d0f5fca4fe22e2faca4110583af,0,Zhong Jian,2015-11-02 14:30:57+08:00,['69bdff40274db6ec780f34c5d36cac2b91873871'],1,4,5,14457786,1,1,0,1,9761
0a097471f64e062f721b7ccd7d65c556c948e75e,0,Zhong Jian,2015-11-02 14:44:04+08:00,['b622b52c1d8737c73742cfbce65fce4374fc8f95'],1,4,5,14457791,1,0,0,0,9761
5cbff31b9e0a4518e4789adc57c859456e121d47,0,Li Yang,2015-11-02 15:11:15+08:00,['29468faa70672d0f5fca4fe22e2faca4110583af'],28,4,32,14457823,3,,,,9761
1dcea8a34be43e25f7d4f18c5c1d28b92738a139,0,Zhong Jian,2015-11-02 15:19:33+08:00,['0a097471f64e062f721b7ccd7d65c556c948e75e'],1,1,2,14457825,1,,,,9761
6530f01d7f28a7701e5cab103554960bd87e6891,0,Li Yang,2015-11-02 15:21:58+08:00,['5cbff31b9e0a4518e4789adc57c859456e121d47'],0,1,1,14457826,1,0,0,1,9761
28ea6b1e598d9ec52e03947247d8b790cd19a891,0,Li Yang,2015-11-02 15:23:15+08:00,['1dcea8a34be43e25f7d4f18c5c1d28b92738a139'],0,1,1,14457827,1,0,0,1,9761
f0b7598627fc14c362c1fa06f9c4e650da7d3d75,1,honma,2015-11-02 15:52:56+08:00,['28ea6b1e598d9ec52e03947247d8b790cd19a891'],21,17,38,14457865,7,,,,9763
a48461621ae23b5201917f02a6f14d3ec0aca30d,1,honma,2015-11-02 15:52:56+08:00,['f0b7598627fc14c362c1fa06f9c4e650da7d3d75'],197,489,686,14458551,16,0.329608939,0.240223464,0.737430168,9765
8ee23281f9312855cf2b70b946e7d920e04531fa,0,honma,2015-11-02 16:02:55+08:00,['a48461621ae23b5201917f02a6f14d3ec0aca30d'],0,4,4,14458555,1,,,,9765
21ba5ca89c7a9c5dfe237d2f694c83eb2da22fb5,0,Li Yang,2015-11-02 17:39:45+08:00,['6530f01d7f28a7701e5cab103554960bd87e6891'],5,18,23,14458578,1,0,1,1,9765
17b04214d3a6461844f729161a4afc8bb0664386,0,Li Yang,2015-11-02 17:41:03+08:00,['8ee23281f9312855cf2b70b946e7d920e04531fa'],0,112,112,14458690,1,0.418918919,1,0.878378378,9766
037a9ff9b4c6cb74f0a228d0d0d58542c40d5e67,0,honma,2015-11-02 18:52:58+08:00,['17b04214d3a6461844f729161a4afc8bb0664386'],5,6,11,14458701,4,0,0,1,9766
e6bac5f29cefe5b0c45a87872dfe48363988de07,0,Luke Han,2015-11-02 19:53:50+08:00,['21ba5ca89c7a9c5dfe237d2f694c83eb2da22fb5'],1,51,52,14458753,2,,,,9767
b7aa1ca0ffa73726f9d5b516830e98339c457f1d,0,honma,2015-11-03 11:34:43+08:00,['037a9ff9b4c6cb74f0a228d0d0d58542c40d5e67'],7,6,13,14458766,2,1,1,0,9767
b87db176411870a281c66f99e197fceb8cb93946,0,Li Yang,2015-11-03 14:55:54+08:00,['e6bac5f29cefe5b0c45a87872dfe48363988de07'],1,1,2,14458768,1,,,,9767
82ef4eab128b45f7f24e76ad2c3c2a6f2465e82b,0,honma,2015-11-03 15:37:02+08:00,['b7aa1ca0ffa73726f9d5b516830e98339c457f1d'],4,15,19,14458787,2,,,,9767
a3be461a2af6f0cd693e930c6047db1c4e087a2f,0,honma,2015-11-03 15:41:38+08:00,['b87db176411870a281c66f99e197fceb8cb93946'],3,14,17,14458804,1,,,,9767
0b1a201f0945a18f3834bbcc36e695df638e863f,0,Li Yang,2015-11-03 18:14:02+08:00,['a3be461a2af6f0cd693e930c6047db1c4e087a2f'],1,2,3,14458807,1,1,1,1,9767
e81017195d418d81d0f5047eaf8b4929ea70f8c0,0,honma,2015-11-04 10:10:12+08:00,['82ef4eab128b45f7f24e76ad2c3c2a6f2465e82b'],285,409,694,14459501,39,0,1,1,9767
f5a3ea779f453acc9bfa945bc361ea9a23aa3ab9,0,honma,2015-11-04 10:25:03+08:00,['e81017195d418d81d0f5047eaf8b4929ea70f8c0'],13,84,97,14459598,6,0.046153846,0.046153846,0,9767
363923696b7c43d0c9227cf50fa995b97fac22e9,0,Luke Han,2015-11-04 10:39:31+08:00,['e8f226f2e8127dabef79a36420dc8724d0852688'],38,16,54,14459652,18,,,,9767
3117031c658966ed305b601dd52bda413dfc88ee,0,Luke Han,2015-11-04 10:56:02+08:00,['363923696b7c43d0c9227cf50fa995b97fac22e9'],1,0,1,14459653,5,,,,9767
6e53b4bd70625c7a560bc51f782bc28d26ec23ac,0,Zhong Jian,2015-11-04 11:36:47+08:00,['3117031c658966ed305b601dd52bda413dfc88ee'],3,0,3,14459656,3,,,,9767
e6838248c954ab29568da28637cda479228c2233,0,shaofengshi,2015-11-04 14:34:47+08:00,['6e53b4bd70625c7a560bc51f782bc28d26ec23ac'],3,4,7,14459663,1,,,,9767
f519cb2035c779feefd50c17123c417ce6f82f86,0,Li Yang,2015-11-04 14:57:21+08:00,['e6838248c954ab29568da28637cda479228c2233'],9,144,153,14459816,9,,,,9767
fc1b185e0ae8fa806b27cc50edd643d1c74a639e,0,Li Yang,2015-11-04 15:00:31+08:00,['f5a3ea779f453acc9bfa945bc361ea9a23aa3ab9'],1,2,3,14459819,1,0,0,1,9767
df8299e6ad76e9f96a895715691546066c86b8fb,0,Li Yang,2015-11-04 15:00:35+08:00,['fc1b185e0ae8fa806b27cc50edd643d1c74a639e'],9,256,265,14460084,16,,,,9767
f2e8262eb531b72e3de228e53463c4ccf5379bb7,0,Luke Han,2015-11-04 15:12:47+08:00,['f519cb2035c779feefd50c17123c417ce6f82f86'],92,104,196,14460280,2,,,,9767
9c974824385d175c9ed63bd175123ea715a0d26a,0,shaofengshi,2015-11-04 15:58:26+08:00,['f2e8262eb531b72e3de228e53463c4ccf5379bb7'],1,6,7,14460287,1,,,,9767
9ff440d1f5d4273a19c8f6086f331f6fd35b4d9d,0,Li Yang,2015-11-04 16:24:05+08:00,['0b1a201f0945a18f3834bbcc36e695df638e863f'],2,2,4,14460291,1,,,,9767
9303d10240fe5f4b5eb318cbfdb8fb9c8b6bf556,1,Li Yang,2015-11-04 16:26:20+08:00,['df8299e6ad76e9f96a895715691546066c86b8fb'],2,2,4,14460295,1,,,,9767
d3864f2dc5d031a11f01161b0740c8557f1bef39,0,shaofengshi,2015-11-04 17:00:17+08:00,['9c974824385d175c9ed63bd175123ea715a0d26a'],27,1,28,14460323,2,,,,9767
0cbaee912ecbc456e27ca604ca7ccfec73594f91,0,shaofengshi,2015-11-04 17:52:37+08:00,['d3864f2dc5d031a11f01161b0740c8557f1bef39'],14,14,28,14460351,13,,,,9767
2721b00511f2685069680e5663a5d3662d5de2a4,0,shaofengshi,2015-11-04 20:28:56+08:00,['9303d10240fe5f4b5eb318cbfdb8fb9c8b6bf556'],18,61,79,14460430,8,0.741935484,0.774193548,0.35483871,9767
5a8a8f18bdf4891e10ab9598bc386417a304f374,0,shaofengshi,2015-11-04 20:32:08+08:00,['2721b00511f2685069680e5663a5d3662d5de2a4'],1,0,1,14460431,1,,,,9767
2fc9df07b02c9a111730b5310d1cebc620cd73c7,0,shaofengshi,2015-11-05 10:51:04+08:00,['9ff440d1f5d4273a19c8f6086f331f6fd35b4d9d'],6,18,24,14460455,3,,,,9767
c5446ecae9c4e99400b43299a3f077f300960898,0,shaofengshi,2015-11-05 11:16:21+08:00,['2fc9df07b02c9a111730b5310d1cebc620cd73c7'],25,3,28,14460483,5,,,,9767
9e487f0490d7df4b1ae85abb635b4cf8eaa621c0,0,shaofengshi,2015-11-05 11:16:21+08:00,['c5446ecae9c4e99400b43299a3f077f300960898'],1,0,1,14460484,4,,,,9767
100c5ac6672ceac6057be049877bf0cc0d0c857b,0,shaofengshi,2015-11-05 11:16:22+08:00,['9e487f0490d7df4b1ae85abb635b4cf8eaa621c0'],3,0,3,14460487,3,,,,9767
89e3930fc0f1e599d931b65aaa3e04d74fa6c4f5,0,shaofengshi,2015-11-05 11:16:22+08:00,['100c5ac6672ceac6057be049877bf0cc0d0c857b'],3,3,6,14460493,1,,,,9767
ca8f90930368bc41442bc7c6d4d248269f525f33,0,shaofengshi,2015-11-05 11:16:22+08:00,['89e3930fc0f1e599d931b65aaa3e04d74fa6c4f5'],9,144,153,14460646,9,,,,9767
ef96aaa4da339e12fa26e05a83dbea7f8f71d9c4,0,shaofengshi,2015-11-05 11:16:22+08:00,['ca8f90930368bc41442bc7c6d4d248269f525f33'],92,104,196,14460842,2,,,,9767
3cef3505684c1816dca5fb583b3b96be3e323da3,0,shaofengshi,2015-11-05 11:16:22+08:00,['ef96aaa4da339e12fa26e05a83dbea7f8f71d9c4'],1,6,7,14460849,1,,,,9767
760efe653b1ff111f36bf23e60adc036beda5939,0,shaofengshi,2015-11-05 11:33:55+08:00,['5a8a8f18bdf4891e10ab9598bc386417a304f374'],27,507,534,14461383,10,,,,9770
a3ea1a6c96126af851607c12beb4e21e9c434ae9,0,shaofengshi,2015-11-05 11:33:56+08:00,['760efe653b1ff111f36bf23e60adc036beda5939'],0,0,0,14461383,3,,,,9770
b28970008b69b730e5bea514586b49910285ebdd,1,shaofengshi,2015-11-05 11:54:26+08:00,['a3ea1a6c96126af851607c12beb4e21e9c434ae9'],5,9,14,14461397,3,,,,9770
be5ad9558998251219bf8ea33f5b80dcea7ba463,0,shaofengshi,2015-11-05 11:54:26+08:00,['b28970008b69b730e5bea514586b49910285ebdd'],3,4,7,14461404,1,,,,9770
02c2cf48c7c4e087d2eb5d4b07e90b0652f94823,1,shaofengshi,2015-11-05 13:21:19+08:00,['be5ad9558998251219bf8ea33f5b80dcea7ba463'],3,112,115,14461519,2,,,,9770
d997133ec2c6afb61714b8d8344371d5a0fe8ef1,0,shaofengshi,2015-11-05 13:21:19+08:00,['02c2cf48c7c4e087d2eb5d4b07e90b0652f94823'],0,6,6,14461525,1,,,,9770
1a936e257da15dd67391b0496e0d3e05d85663ea,0,shaofengshi,2015-11-05 13:25:10+08:00,"['0c0f763be5382a762096b9ec8f9290f57c89de52', '0cbaee912ecbc456e27ca604ca7ccfec73594f91']",174,275,449,14461974,34,,,,9770
36512643afe70eab1476a5eeb173c7208af7944b,0,Luke Han,2015-11-05 13:49:07+08:00,['3cef3505684c1816dca5fb583b3b96be3e323da3'],11,68,79,14462053,3,,,,9771
69d792fea0cac3d7a35750dfddaf0cf4320b5557,1,shaofengshi,2015-11-05 16:10:57+08:00,['d997133ec2c6afb61714b8d8344371d5a0fe8ef1'],1040,1533,2573,14464626,53,1,1,1,9775
fd62cfacfe2f7ebf6174963f8f257cd7034679e1,0,Luke Han,2015-11-05 17:27:17+08:00,['36512643afe70eab1476a5eeb173c7208af7944b'],9,24,33,14464659,3,,,,9775
0671b0e7f87bd168f3579339a8ed219794c54b41,1,Li Yang,2015-11-05 18:17:13+08:00,['69d792fea0cac3d7a35750dfddaf0cf4320b5557'],32,13,45,14464704,8,0.285714286,0,0,9775
f3c563b38151bcce3fc587ea3e5e394c386875b5,0,lukehan,2015-11-05 21:57:24+08:00,['36512643afe70eab1476a5eeb173c7208af7944b'],9,26,35,14464739,3,,,,9775
e5a44d9c3cb47990117568e712a092a4a28535d4,0,lukehan,2015-11-05 22:00:21+08:00,"['f3c563b38151bcce3fc587ea3e5e394c386875b5', 'fd62cfacfe2f7ebf6174963f8f257cd7034679e1']",0,0,0,14464739,0,,,,9775
7f85c0b52f9a33957fa41b5c92805d09b8986fd0,1,shaofengshi,2015-11-06 20:04:02+08:00,['0671b0e7f87bd168f3579339a8ed219794c54b41'],1044,213,1257,14465996,46,0.118918919,0,0.351351351,9775
d2cbc8f26df02147c4040655f0470d7bc271f90f,0,shaofengshi,2015-11-06 20:04:02+08:00,['7f85c0b52f9a33957fa41b5c92805d09b8986fd0'],17,5,22,14466018,5,0,0,0.714285714,9775
c0569baa169f26f911be05baeab568139bb45670,1,shaofengshi,2015-11-07 11:33:44+08:00,['d2cbc8f26df02147c4040655f0470d7bc271f90f'],0,2,2,14466020,1,0,0,1,9775
e14fbe1389105004e35df6870c4b9afc2cab1ae6,1,Li Yang,2015-11-09 10:41:59+08:00,['c0569baa169f26f911be05baeab568139bb45670'],234,236,470,14466490,13,0,0,0,9775
a933c22249a7117d1259638a836d81828cb97298,1,Li Yang,2015-11-09 11:15:12+08:00,['e14fbe1389105004e35df6870c4b9afc2cab1ae6'],107,105,212,14466702,19,0.16,0.96,1,9775
5f9d94490c6faf4ac2252ed5962740d0dd26c9e5,1,Li Yang,2015-11-09 11:53:43+08:00,['a933c22249a7117d1259638a836d81828cb97298'],23,85,108,14466810,4,0.823529412,1,0.941176471,9775
22817c48d3b8291c582a1fdcef607bb0f20cc998,0,Li Yang,2015-11-11 10:18:13+08:00,['e5a44d9c3cb47990117568e712a092a4a28535d4'],21,6,27,14466837,4,1,1,0,9775
11602a26310b4ba11dcb1b1d8e7a7c25377943b1,1,Li Yang,2015-11-11 10:29:47+08:00,['5f9d94490c6faf4ac2252ed5962740d0dd26c9e5'],102,286,388,14467225,14,0.76744186,0.88372093,0.860465116,9779
978df26c7e82bae536e436454e903244e831077c,0,Li Yang,2015-11-11 10:49:25+08:00,['22817c48d3b8291c582a1fdcef607bb0f20cc998'],4,17,21,14467246,2,1,1,0.909090909,9779
7bc4c3550dd6374acd46b14026f68e47c7432d75,1,Li Yang,2015-11-11 15:56:02+08:00,['11602a26310b4ba11dcb1b1d8e7a7c25377943b1'],3,11,14,14467260,1,1,1,1,9779
642d0a618d2a757c0e945c7b8512f6b108aac8b7,0,Li Yang,2015-11-12 14:43:58+08:00,['7bc4c3550dd6374acd46b14026f68e47c7432d75'],2,7,9,14467269,4,,,,9779
b780f75fd5501ea3d57c8518324a98fab98ccf83,0,Li Yang,2015-11-12 14:45:37+08:00,['642d0a618d2a757c0e945c7b8512f6b108aac8b7'],67,28,95,14467364,10,0.047619048,0.047619048,0.571428571,9779
a7e5f7aa4a3c0614758da7713c91a5a7db55dbc8,0,Li Yang,2015-11-12 15:17:09+08:00,['b780f75fd5501ea3d57c8518324a98fab98ccf83'],4,16,20,14467384,3,1,1,0.9,9779
870c587555a99eea646d6db585f5087ac32fbb24,0,shaofengshi,2015-11-12 16:36:22+08:00,['a7e5f7aa4a3c0614758da7713c91a5a7db55dbc8'],0,6,6,14467390,1,,,,9779
56e9a38c955d56860d2f367161ddf1a7254557dd,0,shaofengshi,2015-11-12 16:40:25+08:00,['978df26c7e82bae536e436454e903244e831077c'],0,6,6,14467396,1,,,,9779
6405c0f16fc66d2927161c6556237c369508f64e,0,shaofengshi,2015-11-12 17:12:42+08:00,['56e9a38c955d56860d2f367161ddf1a7254557dd'],2,3,5,14467401,2,,,,9779
0c733e952494de44f9512d8dceff08ca20400b88,0,shaofengshi,2015-11-12 17:15:57+08:00,['870c587555a99eea646d6db585f5087ac32fbb24'],0,1,1,14467402,1,,,,9779
4b0886cf75d23ca6c3513e9760a3c0b76ca5023b,0,shaofengshi,2015-11-12 17:30:03+08:00,['6405c0f16fc66d2927161c6556237c369508f64e'],9,9,18,14467420,3,,,,9779
54e4bff8aaf75a0a9b0f5089fdca1ba0dd8d0b93,0,Li Yang,2015-11-13 10:19:43+08:00,['4b0886cf75d23ca6c3513e9760a3c0b76ca5023b'],0,4,4,14467424,1,,,,9779
d08571644c7215ef9eff0462d3ccb29664c83c9c,0,shaofengshi,2015-11-13 11:26:50+08:00,['54e4bff8aaf75a0a9b0f5089fdca1ba0dd8d0b93'],0,17,17,14467441,1,,,,9779
5e3d695c6342078ee229951e27bbcd215b64a595,1,honma,2015-11-13 17:18:05+08:00,['0c733e952494de44f9512d8dceff08ca20400b88'],146,176,322,14467763,10,1,1,1,9779
8670773424fe7866b1453f0a911ef156bb4cc86b,0,honma,2015-11-13 17:50:30+08:00,['5e3d695c6342078ee229951e27bbcd215b64a595'],19,43,62,14467825,8,0,0.8,0.95,9779
f535477dd2c923b0486995a08893f45208b7e84b,1,honma,2015-11-16 10:27:54+08:00,['8670773424fe7866b1453f0a911ef156bb4cc86b'],701,1510,2211,14470036,58,0.760368664,0.502304147,0.822580645,9781
ebfab6b3b156f018d4c5b5bacd7c4fdc091c867f,1,honma,2015-11-16 10:28:24+08:00,['f535477dd2c923b0486995a08893f45208b7e84b'],43,86,129,14470165,4,0,1,0.833333333,9781
a91119bef4562c49b1ebea6484847dbdf23cfa70,0,honma,2015-11-16 10:28:25+08:00,['ebfab6b3b156f018d4c5b5bacd7c4fdc091c867f'],44,193,237,14470402,11,0.070707071,0.535353535,0.929292929,9781
1548f90fb7d5b86b7f89b0f36ccc7012f49b1840,0,honma,2015-11-16 11:11:40+08:00,['a91119bef4562c49b1ebea6484847dbdf23cfa70'],21,61,82,14470484,2,0,0,1,9781
546b90da74928ee14b549d029875ee13e2202872,0,honma,2015-11-16 11:19:54+08:00,['1548f90fb7d5b86b7f89b0f36ccc7012f49b1840'],7,11,18,14470502,3,0,1,1,9781
792b80aaab19f05db448bfe5292a113672d9c8b6,0,honma,2015-11-16 11:23:48+08:00,['546b90da74928ee14b549d029875ee13e2202872'],1,1,2,14470504,1,,,,9781
f14321b6e57368eb6f1bcde2b4ff17bc19324540,0,honma,2015-11-16 14:45:10+08:00,['792b80aaab19f05db448bfe5292a113672d9c8b6'],3,27,30,14470534,5,0,0.923076923,0.846153846,9781
b8bd4a7d15563bf5d7806322718e2ed36de8944f,0,honma,2015-11-16 16:05:20+08:00,['f14321b6e57368eb6f1bcde2b4ff17bc19324540'],5,16,21,14470555,1,1,1,1,9781
b286d06bfb91c022054e96b4105af97ade73f2dd,0,honma,2015-11-16 16:08:06+08:00,['b8bd4a7d15563bf5d7806322718e2ed36de8944f'],19,131,150,14470705,4,0.714285714,1,0.928571429,9782
b53f6f916f8878e1786a31da481512c30c0b9d73,0,shaofengshi,2015-11-16 16:29:16+08:00,['d08571644c7215ef9eff0462d3ccb29664c83c9c'],0,21,21,14470726,1,0.75,0.75,1,9782
8e97b9712a531d331773834366f60089787465ee,0,shaofengshi,2015-11-16 16:30:04+08:00,['b53f6f916f8878e1786a31da481512c30c0b9d73'],7,4,11,14470737,1,,,,9782
82539ae1973aff698a9721e3d4f73b1f3ca17b20,0,honma,2015-11-17 11:28:20+08:00,['b286d06bfb91c022054e96b4105af97ade73f2dd'],20,2,22,14470759,1,,,,9782
19fd36cf0da6263dbc56f888a67acedd77f0d919,1,Li Yang,2015-11-17 13:17:04+08:00,['8e97b9712a531d331773834366f60089787465ee'],91,82,173,14470932,14,0,0,0,9782
6e88ef31c9ce589f64f41681799f4c3a7620f3e4,0,honma,2015-11-17 13:29:27+08:00,['82539ae1973aff698a9721e3d4f73b1f3ca17b20'],0,1,1,14470933,1,0,1,1,9782
301987f1d5649645a5eb172c0b178ca8e1fc1681,1,Li Yang,2015-11-17 13:52:50+08:00,['6e88ef31c9ce589f64f41681799f4c3a7620f3e4'],82,99,181,14471114,14,0,0.777777778,0.888888889,9782
70586f4b01ec2201b539f37e1be0f911625edd4e,0,Li Yang,2015-11-17 13:54:19+08:00,['19fd36cf0da6263dbc56f888a67acedd77f0d919'],9,27,36,14471150,4,1,1,1,9782
157d40d6d32c47c7e20afaced3a383f0b9c2c5f9,0,honma,2015-11-17 15:01:24+08:00,['301987f1d5649645a5eb172c0b178ca8e1fc1681'],3,3,6,14471156,1,,,,9782
667b17a2cd643dbbde34f717fd93921c9d875f1b,1,Li Yang,2015-11-17 16:51:12+08:00,['70586f4b01ec2201b539f37e1be0f911625edd4e'],48,457,505,14471661,10,0.350230415,0.3640553,0.986175115,9787
79114d7d39c52b34adf28679c996b7fbf70a96cc,0,Li Yang,2015-11-17 17:47:13+08:00,['667b17a2cd643dbbde34f717fd93921c9d875f1b'],74,67,141,14471802,6,1,1,0,9787
2472fc86916db3c45ab9c730b0e8fe81144cbb6f,0,Li Yang,2015-11-18 10:19:41+08:00,['79114d7d39c52b34adf28679c996b7fbf70a96cc'],1,2,3,14471805,1,,,,9787
49590c99075d0fcfe2d355afd0375b360257d2e9,0,honma,2015-11-18 10:24:37+08:00,['157d40d6d32c47c7e20afaced3a383f0b9c2c5f9'],7,2,9,14471814,2,,,,9787
8e356b2ea865ace78226e95bd7e1cb7a9fd41fe8,0,Li Yang,2015-11-18 11:33:05+08:00,['2472fc86916db3c45ab9c730b0e8fe81144cbb6f'],2,2,4,14471818,1,,,,9787
14cbed110962806fe5a4bc47829fd70e0c0a675a,0,shaofengshi,2015-11-18 14:47:22+08:00,['8e356b2ea865ace78226e95bd7e1cb7a9fd41fe8'],17,43,60,14471878,5,0.222222222,0.222222222,1,9787
f748b2a9e916c7bf231e1ba0c7ab2cf003875cac,1,shaofengshi,2015-11-18 20:00:09+08:00,['14cbed110962806fe5a4bc47829fd70e0c0a675a'],0,8,8,14471886,2,0.666666667,1,1,9787
b23b622a697efc7dbef4c1ca8164ac288fbf8ccd,1,qianhao.zhou,2015-11-19 10:52:28+08:00,['49590c99075d0fcfe2d355afd0375b360257d2e9'],8,7,15,14471901,2,0,0,,9787
e1b0132be95aba6e8df873bedfb5f1d7853e1f76,0,shaofengshi,2015-11-19 14:11:05+08:00,['b23b622a697efc7dbef4c1ca8164ac288fbf8ccd'],7,4,11,14471912,1,,,,9787
8e242b41d43e304dbce289f98b647f5771049ad0,0,shaofengshi,2015-11-19 14:11:05+08:00,['e1b0132be95aba6e8df873bedfb5f1d7853e1f76'],0,8,8,14471920,1,,,,9787
b69918691d5def40550adbe3025659d23624c909,0,shaofengshi,2015-11-19 14:11:05+08:00,['8e242b41d43e304dbce289f98b647f5771049ad0'],57,1,58,14471978,2,,,,9787
186d0207b6344003168ae3f266ac2c8e90911fe5,0,shaofengshi,2015-11-19 15:55:37+08:00,['f748b2a9e916c7bf231e1ba0c7ab2cf003875cac'],172,20,192,14472170,8,1,0,0,9787
3ececec578bd5ba9ebdd67ab7a9183c5c805f5e0,0,shaofengshi,2015-11-19 21:38:38+08:00,['186d0207b6344003168ae3f266ac2c8e90911fe5'],9,4,13,14472183,2,1,1,1,9787
79f46a78b3ca79216a5cf999e6386a73f1b7ee29,1,shaofengshi,2015-11-23 10:22:15+08:00,['b69918691d5def40550adbe3025659d23624c909'],24,63,87,14472270,8,0,0,1,9787
1fb77c34e866d63f6f55c9beb5e5676e45d0151c,0,shaofengshi,2015-11-23 10:23:01+08:00,['3ececec578bd5ba9ebdd67ab7a9183c5c805f5e0'],4,10,14,14472284,9,,,,9787
7c80e4658def9e8ffb5de0e60aaaec777bff0318,0,shaofengshi,2015-11-23 10:28:51+08:00,['79f46a78b3ca79216a5cf999e6386a73f1b7ee29'],2,23,25,14472309,1,0.75,0.75,1,9787
128595d2cdf57f0a25b64ff0da451ab901243041,0,honma,2015-11-23 13:21:46+08:00,['1fb77c34e866d63f6f55c9beb5e5676e45d0151c'],3,3,6,14472315,1,,,,9787
f578b4f8a88505d16a464256b80c9e291bd534ad,0,honma,2015-11-23 13:41:17+08:00,['128595d2cdf57f0a25b64ff0da451ab901243041'],4,4,8,14472323,2,,,,9787
b12f66bc4ed7807f228e21b25257060cf1cb2460,0,Zhong Jian,2015-11-23 15:39:41+08:00,['7c80e4658def9e8ffb5de0e60aaaec777bff0318'],1,1,2,14472325,1,,,,9787
bf50a56b536cdf7c4c7bbde5aaa0d19436cb1276,0,shaofengshi,2015-11-23 15:50:08+08:00,['f578b4f8a88505d16a464256b80c9e291bd534ad'],1,1,2,14472327,1,,,,9787
9492bef5f3e60349f76d6c897a4f83c9e01354cc,0,shaofengshi,2015-11-23 15:50:48+08:00,['b12f66bc4ed7807f228e21b25257060cf1cb2460'],1,1,2,14472329,1,,,,9787
16400d5fa48e89e8275d70f0c71dcacc1dcd0b26,1,Li Yang,2015-11-23 17:23:50+08:00,['9492bef5f3e60349f76d6c897a4f83c9e01354cc'],724,369,1093,14473422,30,1,1,1,9787
eaaf061d218741b5389f5518a96d28435b98d24f,0,shaofengshi,2015-11-23 17:27:14+08:00,['bf50a56b536cdf7c4c7bbde5aaa0d19436cb1276'],15,43,58,14473480,1,0.115384615,0,0.884615385,9787
02fb4ca5fe4f00d021bc38f16aa000d36430c0e5,1,Li Yang,2015-11-24 10:28:51+08:00,['16400d5fa48e89e8275d70f0c71dcacc1dcd0b26'],120,139,259,14473739,5,1,1,1,9788
2f2b6082a3bddf96ac3bd6828000ae1e448a6206,0,Li Yang,2015-11-24 10:33:15+08:00,['eaaf061d218741b5389f5518a96d28435b98d24f'],123,142,265,14474004,5,1,1,1,9789
f58e80ee69ffa5c8df463bb4a8bccca8e9dc135e,0,shaofengshi,2015-11-24 10:39:51+08:00,['2f2b6082a3bddf96ac3bd6828000ae1e448a6206'],9,18,27,14474031,1,0,0,1,9789
b2e10533fae8f956bca9fa00bb4abc745ecd0bfa,0,Zhong,2015-11-24 13:38:42+08:00,['f58e80ee69ffa5c8df463bb4a8bccca8e9dc135e'],0,11,11,14474042,2,0.875,1,1,9789
74734147a4838008f10ec8fda0ddf28b265762d4,0,shaofengshi,2015-11-24 13:41:01+08:00,['b2e10533fae8f956bca9fa00bb4abc745ecd0bfa'],0,4,4,14474046,1,0,0,1,9789
10ff2894558dbc3eb2b9f428ef6f74fb14d1c0f4,0,shaofengshi,2015-11-24 13:41:01+08:00,['74734147a4838008f10ec8fda0ddf28b265762d4'],2,2,4,14474050,1,,,,9789
66d7d7b0e5cf5ae94ce0040499be94512b32729e,0,shaofengshi,2015-11-24 13:41:46+08:00,['02fb4ca5fe4f00d021bc38f16aa000d36430c0e5'],9,23,32,14474082,1,0,0,1,9789
0bb185c638b673381335977f988b237b3cc7dc07,1,shaofengshi,2015-11-24 13:41:46+08:00,['66d7d7b0e5cf5ae94ce0040499be94512b32729e'],19,48,67,14474149,1,0.115384615,0,0.884615385,9789
f483811e6e5d897ff3e236a691c0aff2ce303719,0,shaofengshi,2015-11-24 14:07:02+08:00,['0bb185c638b673381335977f988b237b3cc7dc07'],1014,5,1019,14475168,15,0.460815047,0.197492163,0,9789
bb50e8e920438b130da8ea7caddc49dc13aa1d60,1,Zhong,2015-11-24 14:25:51+08:00,['f483811e6e5d897ff3e236a691c0aff2ce303719'],0,11,11,14475179,2,0.875,1,1,9789
e713623a4594af9be5806e5c32b63742f50695a1,0,Luke Han,2015-11-24 15:53:52+08:00,['10ff2894558dbc3eb2b9f428ef6f74fb14d1c0f4'],2,2,4,14475183,1,,,,9789
c681c90ef8ddf8a78ef5255117293b645e83f92f,1,shaofengshi,2015-11-24 16:43:06+08:00,['bb50e8e920438b130da8ea7caddc49dc13aa1d60'],19,36,55,14475238,1,0,1,0,9789
9150a82a2a0d75b4fc1cf9faa40501677fde48aa,0,shaofengshi,2015-11-24 17:35:23+08:00,['c681c90ef8ddf8a78ef5255117293b645e83f92f'],11,5,16,14475254,1,1,1,1,9789
df169613cf79ece201a959a02cbc349e44d45be8,1,Zhong,2015-11-25 14:33:01+08:00,['9150a82a2a0d75b4fc1cf9faa40501677fde48aa'],3,3,6,14475260,2,,,,9789
050554f3f1bafa034cff576dea66a17c24f7b520,0,shaofengshi,2015-11-25 14:40:07+08:00,['e713623a4594af9be5806e5c32b63742f50695a1'],8,274,282,14475542,2,0.392045455,0.579545455,0.903409091,9790
4ab876cfea75a75d2d43d32bd5b1ae8a4156ef3c,0,shaofengshi,2015-11-25 14:40:07+08:00,['050554f3f1bafa034cff576dea66a17c24f7b520'],0,2,2,14475544,1,,,,9790
315b7f8bb7119de61ecf828acb3fa05f0ce995ca,0,shaofengshi,2015-11-25 14:40:07+08:00,['4ab876cfea75a75d2d43d32bd5b1ae8a4156ef3c'],8,39,47,14475591,1,0.1,0.1,0.966666667,9790
2ac2f783a745a747f318a2a111e2d2d986e6f0ac,0,shaofengshi,2015-11-25 14:46:58+08:00,['df169613cf79ece201a959a02cbc349e44d45be8'],0,2,2,14475593,1,,,,9790
5ac528d9ce837ad497d7e64d4c85c13811e75197,1,shaofengshi,2015-11-25 14:46:58+08:00,['2ac2f783a745a747f318a2a111e2d2d986e6f0ac'],2,36,38,14475631,1,0.1,0.1,0.966666667,9790
fc9fffcf2039c95db47f509aa82cb6b377da9151,0,Li Yang,2015-11-25 15:15:35+08:00,['315b7f8bb7119de61ecf828acb3fa05f0ce995ca'],33,94,127,14475758,9,1,1,1,9792
5d948e37c623a1cbd90e85fd13f837ca0828ddc7,0,Li Yang,2015-11-25 15:39:39+08:00,['fc9fffcf2039c95db47f509aa82cb6b377da9151'],4,4,8,14475766,2,,,,9792
c6fd7d67778560f7bbf90dc2c5d2d52b30f5f000,0,Li Yang,2015-11-25 15:42:19+08:00,['5ac528d9ce837ad497d7e64d4c85c13811e75197'],27,88,115,14475881,9,1,1,1,9794
37953a13c08aece393656ef4b9bc0eb5b211c24e,0,Li Yang,2015-11-25 15:47:13+08:00,['c6fd7d67778560f7bbf90dc2c5d2d52b30f5f000'],4,4,8,14475889,2,,,,9794
ccba62099cbb3a7ee801b6238dc4f6b4c22a9ac8,0,shaofengshi,2015-11-25 17:25:44+08:00,['5d948e37c623a1cbd90e85fd13f837ca0828ddc7'],56,31,87,14475976,4,0,0,0,9794
0da8862285a7e66dcca1a8e7e5ad47e8791d62f7,0,Zhong,2015-11-25 18:37:19+08:00,['37953a13c08aece393656ef4b9bc0eb5b211c24e'],15,3,18,14475994,1,,,,9794
f0f8abd52838b4ed1391114de22bbb7638bd61f9,0,shaofengshi,2015-11-26 11:27:56+08:00,['ccba62099cbb3a7ee801b6238dc4f6b4c22a9ac8'],9,10,19,14476013,3,0,0,1,9794
026b9b1221a06604ec17a331a9002c9dc677e257,0,Li Yang,2015-11-27 12:57:19+08:00,['0da8862285a7e66dcca1a8e7e5ad47e8791d62f7'],21,19,40,14476053,1,,,,9794
479d3b9ece294484189da8ebed9a44de6c694d99,0,Li Yang,2015-11-27 13:02:02+08:00,['f0f8abd52838b4ed1391114de22bbb7638bd61f9'],1,1,2,14476055,1,,,,9794
9872913125dc2bab540841ae7bc693a0dd5cb000,0,Zhong,2015-11-27 14:23:28+08:00,['026b9b1221a06604ec17a331a9002c9dc677e257'],4,10,14,14476069,1,1,1,1,9794
5ba2245054caa607c7dae281b37b9eebe5f0caf9,1,shaofengshi,2015-11-30 14:02:38+08:00,['9872913125dc2bab540841ae7bc693a0dd5cb000'],33,52,85,14476154,7,0,0,0,9794
3c2abfe35601a1c28f325c666bf7d339341de182,1,shaofengshi,2015-11-30 14:02:38+08:00,['5ba2245054caa607c7dae281b37b9eebe5f0caf9'],92,84,176,14476330,7,1,0.5,1,9794
a4c02a5410dfc0cfed4e249585385af722b588c8,0,shaofengshi,2015-11-30 14:08:27+08:00,['479d3b9ece294484189da8ebed9a44de6c694d99'],274,8,282,14476612,2,0.607954545,0.420454545,0.096590909,9794
683d860e6545b23dc9bca8a8984e77655a2d9c8d,0,shaofengshi,2015-12-01 12:48:54+08:00,['3c2abfe35601a1c28f325c666bf7d339341de182'],1,2,3,14476615,2,0,1,1,9794
b3784c5abe244a2b743aab2c8c02a6c9e07abf63,0,Li Yang,2015-12-02 11:09:21+08:00,['a4c02a5410dfc0cfed4e249585385af722b588c8'],2,5,7,14476622,5,1,1,1,9794
29b0a22b161c909cf2b930ca064dc671b1b0f815,0,Li Yang,2015-12-02 11:11:59+08:00,['b3784c5abe244a2b743aab2c8c02a6c9e07abf63'],3,11,14,14476636,2,0.375,1,0.375,9794
d2103278b6a3c13afb41c38f5e27d1740aeb0c0b,0,shaofengshi,2015-12-02 11:38:01+08:00,['683d860e6545b23dc9bca8a8984e77655a2d9c8d'],32,0,32,14476668,2,,,,9794
b0f0b13e8bc8bf8a601c3ab3c5b4f7bb5c04b50e,0,honma,2015-12-02 16:03:24+08:00,['29b0a22b161c909cf2b930ca064dc671b1b0f815'],126,121,247,14476915,29,,,,9794
372ad8c3009b518e8b35659800b7a21ac6d66d29,0,shaofengshi,2015-12-02 16:22:44+08:00,['d2103278b6a3c13afb41c38f5e27d1740aeb0c0b'],0,8,8,14476923,1,,,,9794
6546f15a190e6bb631dac90f8b0d81f483512c2a,0,shaofengshi,2015-12-03 10:37:25+08:00,['372ad8c3009b518e8b35659800b7a21ac6d66d29'],35,0,35,14476958,1,,,,9794
80fe9c81f97710c8de29e3fd533d7aed3145d03b,0,shaofengshi,2015-12-03 14:57:19+08:00,['b0f0b13e8bc8bf8a601c3ab3c5b4f7bb5c04b50e'],101,219,320,14477278,9,0,0.85,1,9794
c88f01fa883c97b1221a82da265f0064e5859ecf,0,honma,2015-12-03 17:49:32+08:00,['80fe9c81f97710c8de29e3fd533d7aed3145d03b'],4,5,9,14477287,1,,,,9794
fedb4e7a3fcfd20b9b74c52babb278dbce645da6,0,shaofengshi,2015-12-04 11:10:51+08:00,['c88f01fa883c97b1221a82da265f0064e5859ecf'],2,8,10,14477297,3,1,1,1,9794
793d4d18f87fc1640e0de67cbf25b707c4988a4d,0,shaofengshi,2015-12-04 14:04:36+08:00,['fedb4e7a3fcfd20b9b74c52babb278dbce645da6'],25,25,50,14477347,14,,,,9794
58ae69a989ae75a9974c20c1bc96a61d499283e7,0,shaofengshi,2015-12-04 16:15:42+08:00,['793d4d18f87fc1640e0de67cbf25b707c4988a4d'],5,5,10,14477357,1,,,,9794
12d9a5b4c213467e868e151b86125851f617f5f8,1,honma,2015-12-04 16:29:06+08:00,['6546f15a190e6bb631dac90f8b0d81f483512c2a'],4,121,125,14477482,3,0.28358209,0.567164179,1,9795
1fa447a52d378242005296fd168fe5743ba4aec5,0,honma,2015-12-04 16:29:06+08:00,['12d9a5b4c213467e868e151b86125851f617f5f8'],12,16,28,14477510,2,0.5,1,0,9795
a0386564f5c095f924cef56c33ccb42093d25b9f,1,honma,2015-12-04 16:29:06+08:00,['1fa447a52d378242005296fd168fe5743ba4aec5'],3,12,15,14477525,4,1,1,1,9795
892b40e30de8fb6bd7594b980649531315132148,0,honma,2015-12-04 16:29:07+08:00,['a0386564f5c095f924cef56c33ccb42093d25b9f'],0,9,9,14477534,1,,,,9795
ad1530881194e1f35237710cebd7b8d31b37528f,0,honma,2015-12-04 16:29:07+08:00,['892b40e30de8fb6bd7594b980649531315132148'],2,5,7,14477541,5,1,1,1,9795
97b779ca4448a7047ff5f26f1dd115642ac4dd85,1,honma,2015-12-04 16:29:07+08:00,['ad1530881194e1f35237710cebd7b8d31b37528f'],8,19,27,14477568,3,0.230769231,0.615384615,0.230769231,9795
430f8fd4d2235494a8719622c708e02b4d433f48,0,honma,2015-12-04 16:29:07+08:00,['97b779ca4448a7047ff5f26f1dd115642ac4dd85'],4,4,8,14477576,3,,,,9795
7aa8254ef72494d2711614eb5f090264e9fab7ac,0,honma,2015-12-04 16:29:07+08:00,['430f8fd4d2235494a8719622c708e02b4d433f48'],27,217,244,14477820,3,0.3125,0.321428571,1,9796
442fec1aecc57cd7dbb247b0f507f488ebc6073d,0,honma,2015-12-04 16:29:07+08:00,['7aa8254ef72494d2711614eb5f090264e9fab7ac'],0,4,4,14477824,1,1,1,1,9796
057ff9b9f1089a79a07419a77c91dfa93fcfa24f,0,honma,2015-12-04 16:29:07+08:00,['442fec1aecc57cd7dbb247b0f507f488ebc6073d'],3,5,8,14477832,1,1,1,1,9796
ed6f46ad831a71238763c31c7674063b64b9781d,0,honma,2015-12-04 17:02:02+08:00,['057ff9b9f1089a79a07419a77c91dfa93fcfa24f'],5,5,10,14477842,4,,,,9796
7a5de7b4e2ad1d594ce04f251d788b02b12cddb3,0,shaofengshi,2015-12-04 17:07:16+08:00,['58ae69a989ae75a9974c20c1bc96a61d499283e7'],2,0,2,14477844,1,1,1,0,9796
a10cf5f6de45dda5e1658c443bd212ace9b0f7f5,0,honma,2015-12-04 17:07:50+08:00,['ed6f46ad831a71238763c31c7674063b64b9781d'],5,4,9,14477853,3,,,,9796
95743bc8e7e1db9a72cb5fa99c058f874800c0f3,1,honma,2015-12-04 17:08:01+08:00,['a10cf5f6de45dda5e1658c443bd212ace9b0f7f5'],1874,3599,5473,14483326,74,0.558710668,0.586339217,1,9811
66df46e0329738ff8d0c3cd954e37f6a4846fad3,1,honma,2015-12-04 17:08:17+08:00,['95743bc8e7e1db9a72cb5fa99c058f874800c0f3'],1171,840,2011,14485337,5,,,,9811
b99335ba3d5d5d9a09fd7220b1599e1f461eff0a,1,shaofengshi,2015-12-04 17:18:47+08:00,['66df46e0329738ff8d0c3cd954e37f6a4846fad3'],5,5,10,14485347,1,,,,9811
2ba96a59f2769e01b05c6d782b263cb9aa7ef65e,0,jian,2015-12-04 18:04:31+08:00,['b99335ba3d5d5d9a09fd7220b1599e1f461eff0a'],2,6,8,14485355,1,0,1,1,9811
ab905de06e4180f7bc5798fc8c764e7757be5275,1,lukehan,2015-12-04 22:50:44+08:00,['7a5de7b4e2ad1d594ce04f251d788b02b12cddb3'],16,37,53,14485408,6,,,,9811
8f5c9aab7b76022db97408ee78cea537a17885f1,0,lukehan,2015-12-04 23:06:43+08:00,['ab905de06e4180f7bc5798fc8c764e7757be5275'],15,15,30,14485438,12,,,,9811
acf6e24bc12b862ddc2e698c99f4c43019f5fb4e,0,Li Yang,2015-12-05 06:48:41+08:00,['2ba96a59f2769e01b05c6d782b263cb9aa7ef65e'],1864,1969,3833,14489271,80,,,,9812
a2fb7a4003f7c995bc9fbdaafdcda6aaba44bede,1,Li Yang,2015-12-05 06:48:43+08:00,['acf6e24bc12b862ddc2e698c99f4c43019f5fb4e'],311,668,979,14490250,77,1,0.75257732,0.907216495,9820
03e0361cf53b0af8403412eecea0fd8c4d309464,1,Li Yang,2015-12-05 06:52:09+08:00,['a2fb7a4003f7c995bc9fbdaafdcda6aaba44bede'],710,794,1504,14491754,154,0.471698113,1,0,9826
0c8c6ea01bd44228e08783a22065d25522ad2551,0,Li Yang,2015-12-05 06:52:10+08:00,['03e0361cf53b0af8403412eecea0fd8c4d309464'],116,107,223,14491977,10,0.5,1,0,9826
8e6010ff7e69435f9115ff191307d7f074c58b7b,1,Li Yang,2015-12-05 06:52:10+08:00,['0c8c6ea01bd44228e08783a22065d25522ad2551'],498,466,964,14492941,21,1,1,1,9829
4da6016468520a4b7dec10a09102c8f79dad1fb1,1,Li Yang,2015-12-05 06:52:10+08:00,['8e6010ff7e69435f9115ff191307d7f074c58b7b'],55,86,141,14493082,16,1,1,1,9829
076676340822eb2df4dbe29fef746042ea6926b7,1,Li Yang,2015-12-05 06:52:11+08:00,['4da6016468520a4b7dec10a09102c8f79dad1fb1'],115,291,406,14493488,41,0.349514563,0.59223301,0.495145631,9829
e79a7e7f2545aa15271f2df17416e121f007b624,1,Li Yang,2015-12-05 06:55:39+08:00,['076676340822eb2df4dbe29fef746042ea6926b7'],977,473,1450,14494938,66,0.626556017,0.751037344,0.331950207,9830
b65458a6a256915ba129163cea03d8240894f05f,0,Li Yang,2015-12-05 06:55:39+08:00,['e79a7e7f2545aa15271f2df17416e121f007b624'],19,26,45,14494983,5,1,0,1,9830
6df478d10ada77fbaa4c8cf5ce6a0ef4d441799f,0,Li Yang,2015-12-05 07:08:46+08:00,['b65458a6a256915ba129163cea03d8240894f05f'],13,8,21,14495004,4,1,1,0.8,9830
ebbfaa42089f35b64edc09fa418af677d74465de,0,Li Yang,2015-12-05 07:23:52+08:00,['6df478d10ada77fbaa4c8cf5ce6a0ef4d441799f'],36,38,74,14495078,4,0,0,1,9830
41c0aed620b89e9a268c91c1e80666da0790d54a,0,Li Yang,2015-12-06 18:05:24+08:00,['ebbfaa42089f35b64edc09fa418af677d74465de'],17,69,86,14495164,11,0.888888889,0.259259259,0.888888889,9830
9a7f53ad892e0d46bb9d7210b739caa995a9dcbc,0,Li Yang,2015-12-06 20:10:04+08:00,['41c0aed620b89e9a268c91c1e80666da0790d54a'],37,30,67,14495231,5,0,1,0,9830
b8fb3460aba2d01160bc4484c51f3657e874f187,0,honma,2015-12-07 10:53:38+08:00,['9a7f53ad892e0d46bb9d7210b739caa995a9dcbc'],199,32,231,14495462,13,0.767676768,0.767676768,0,9830
fcd535b3c7761629628c57634e5aa36bd5fdf126,0,jian,2015-12-07 14:51:55+08:00,['b8fb3460aba2d01160bc4484c51f3657e874f187'],1,1,2,14495464,1,,,,9830
bcd24bb283d839cf8ba3ead207e16f7044e9b35b,1,Li Yang,2015-12-07 16:30:29+08:00,['fcd535b3c7761629628c57634e5aa36bd5fdf126'],33,29,62,14495526,14,1,1,0,9830
11b98ecdef9cf2a3b5bf0901b43adbb195607403,1,jian,2015-12-07 18:59:30+08:00,['bcd24bb283d839cf8ba3ead207e16f7044e9b35b'],6,6,12,14495538,6,,,,9830
bdfc6fde1f6a19f86c63cc4d632cf458e58cb83a,0,Li Yang,2015-12-08 10:43:03+08:00,['8f5c9aab7b76022db97408ee78cea537a17885f1'],4,29,33,14495571,4,0.944444444,0.944444444,1,9830
eee14f86cdd9a722b126e097d2f3530301fa98b4,0,jian,2015-12-08 11:03:05+08:00,['bdfc6fde1f6a19f86c63cc4d632cf458e58cb83a'],1,195,196,14495767,6,0.494949495,1,0.898989899,9831
edca6e0812a6a4c3700c5bb64708ec7c58eb3236,0,jian,2015-12-08 11:03:05+08:00,['eee14f86cdd9a722b126e097d2f3530301fa98b4'],3,3,6,14495773,2,,,,9831
297df749bee334bf171ad4dee678f6c4a48434e5,0,jian,2015-12-08 11:03:05+08:00,['edca6e0812a6a4c3700c5bb64708ec7c58eb3236'],20,33,53,14495826,4,1,1,1,9831
b920fe6d1bffcfda0f03d1627296feee357d4444,0,lidongsjtu,2015-12-08 12:33:07+08:00,['11b98ecdef9cf2a3b5bf0901b43adbb195607403'],0,308,308,14496134,18,,,,9831
e350b6da716dcf461157adfe4644fc4b02a3eb3b,0,jian,2015-12-08 15:12:55+08:00,['297df749bee334bf171ad4dee678f6c4a48434e5'],0,12,12,14496146,1,0.9,0.9,0.9,9831
2901938f77030d22648c6bc778ffe680b6924447,1,lidongsjtu,2015-12-08 15:24:23+08:00,['e350b6da716dcf461157adfe4644fc4b02a3eb3b'],8,3,11,14496157,1,,,,9831
12903bdc3b394c88e4102617640ec28c92079459,0,Li Yang,2015-12-08 16:36:38+08:00,['b920fe6d1bffcfda0f03d1627296feee357d4444'],60,209,269,14496426,13,0.103448276,0,0.603448276,9831
0d72e1e0143ee07ff78e4dc683b796fd2f6955f7,1,jian,2015-12-08 21:13:57+08:00,['12903bdc3b394c88e4102617640ec28c92079459'],103,229,332,14496758,5,0.123809524,0.123809524,1,9831
e7572a943ca0498a16f43ecb61498ab4e91c86fb,0,jian,2015-12-08 21:30:35+08:00,['0d72e1e0143ee07ff78e4dc683b796fd2f6955f7'],232,240,472,14497230,2,0.375,1,0.25,9831
39eaaecd29d5aea8f5d36ea65b631e8d005bb71e,0,jian,2015-12-08 21:44:28+08:00,['2901938f77030d22648c6bc778ffe680b6924447'],1,11,12,14497242,1,0,1,0.3,9831
1e9019bbc2adcc6270bd75f0a284068dec857de4,0,Xiaoyu Wang,2015-12-09 13:07:10+08:00,['39eaaecd29d5aea8f5d36ea65b631e8d005bb71e'],8,8,16,14497258,1,,,,9831
b9135cc0d181c3643500816806f104f5625e84b1,0,Li Yang,2015-12-09 15:03:21+08:00,['e7572a943ca0498a16f43ecb61498ab4e91c86fb'],5,4,9,14497267,2,,,0,9831
7f84d3dde1049984a9fd7b242bb64476be3647fc,0,Li Yang,2015-12-09 16:19:38+08:00,['b9135cc0d181c3643500816806f104f5625e84b1'],17,65,82,14497349,10,0.815789474,0.973684211,0.789473684,9831
3e71f53b95c4194bfb157f0dfd1dcac811f42472,0,Li Yang,2015-12-09 17:57:21+08:00,['1e9019bbc2adcc6270bd75f0a284068dec857de4'],6,7,13,14497362,1,,,,9831
7450c61ab29248604c14642dae2b684246c3edee,1,Li Yang,2015-12-09 18:01:46+08:00,['7f84d3dde1049984a9fd7b242bb64476be3647fc'],5,13,18,14497380,3,1,0,1,9831
91da83cd81d46753ae9ba0e5eccb08dfab738417,1,shaofengshi,2015-12-11 17:33:01+08:00,['7450c61ab29248604c14642dae2b684246c3edee'],95,586,681,14498061,12,0.5,1,1,9833
07eec5a5d3a475f5553812fe4b06d26c5a967cdd,1,honma,2015-12-11 18:16:02+08:00,['91da83cd81d46753ae9ba0e5eccb08dfab738417'],29,208,237,14498298,11,0,0.423913043,0.391304348,9835
3e618b53dc94496155f695ef2f0ccf51efac1cb7,1,shaofengshi,2015-12-14 10:47:57+08:00,['07eec5a5d3a475f5553812fe4b06d26c5a967cdd'],14,18,32,14498330,2,,,,9835
cd006be5aec23e93ace46b885f839c385b0e3ee4,0,jian,2015-12-14 14:21:36+08:00,['3e618b53dc94496155f695ef2f0ccf51efac1cb7'],3,4,7,14498337,1,,,,9835
9b8566f1c14d31a67d528b06257f87dd06ee09e1,0,jian,2015-12-14 14:51:21+08:00,['cd006be5aec23e93ace46b885f839c385b0e3ee4'],190,0,190,14498527,7,0,0,0,9835
e807340bb570a5b01a6ce786df07ab063c62dfaf,1,Li Yang,2015-12-14 15:39:50+08:00,['9b8566f1c14d31a67d528b06257f87dd06ee09e1'],34,55,89,14498616,4,0.733333333,1,1,9835
986708d8f9f9d116cbdae9fd05c41a1fff9471c7,0,shaofengshi,2015-12-14 18:25:20+08:00,['3e71f53b95c4194bfb157f0dfd1dcac811f42472'],0,36,36,14498652,2,,,,9835
27f906184ffeb5c3ad85513418443df96e6ba6d7,0,shaofengshi,2015-12-15 11:00:56+08:00,['e807340bb570a5b01a6ce786df07ab063c62dfaf'],4,19,23,14498675,2,0,1,1,9835
e7542e70c54ae222a3e5820dab62c03349dc1f2f,0,shaofengshi,2015-12-15 11:04:14+08:00,['986708d8f9f9d116cbdae9fd05c41a1fff9471c7'],48,97,145,14498820,8,,,,9835
0fc9be513ccc1d62f647b70d1b310d4013d1e0b0,0,shaofengshi,2015-12-15 13:50:03+08:00,['e7542e70c54ae222a3e5820dab62c03349dc1f2f'],13,13,26,14498846,13,,,,9835
b04034dfa3bd23334c9d60edaf4b4e14f67244af,0,honma,2015-12-15 18:56:38+08:00,['27f906184ffeb5c3ad85513418443df96e6ba6d7'],19,9,28,14498874,5,1,1,0.25,9835
8d13629198f0833257117e4a9c8ad2a436354ae9,1,honma,2015-12-15 18:56:38+08:00,['b04034dfa3bd23334c9d60edaf4b4e14f67244af'],7,318,325,14499199,13,0.356846473,0.917012448,0.497925311,9836
913f418d3be623c42f901930768d692af7cff66b,1,jian,2015-12-15 23:17:45+08:00,['8d13629198f0833257117e4a9c8ad2a436354ae9'],7,53,60,14499259,2,1,1,1,9836
0b0b52b96d01ba290d50f2cdd29422f83f9a1547,0,jian,2015-12-16 01:03:24+08:00,['913f418d3be623c42f901930768d692af7cff66b'],1,4,5,14499264,2,1,1,1,9836
a22d4251cc7bba791b15a9642f6236c9d4882ef9,0,honma,2015-12-16 18:06:28+08:00,['0b0b52b96d01ba290d50f2cdd29422f83f9a1547'],2,12,14,14499278,2,0,0,0,9836
7af2c3a2cfd1be1d5ad00efefa4c4ff70e052a99,0,honma,2015-12-17 11:31:55+08:00,['a22d4251cc7bba791b15a9642f6236c9d4882ef9'],11,49,60,14499338,10,0,0.222222222,1,9836
5e711e7c53438cd3aba4740b031a0088a24dcc87,0,honma,2015-12-17 13:06:56+08:00,['7af2c3a2cfd1be1d5ad00efefa4c4ff70e052a99'],0,1,1,14499339,1,0,1,1,9836
c8e6ee4d20b7d2572f06f356152162b5726d05ae,1,Li Yang,2015-12-17 16:22:23+08:00,['5e711e7c53438cd3aba4740b031a0088a24dcc87'],37,60,97,14499436,5,0.777777778,0.666666667,0.888888889,9836
4017822f0a5437c53ed20335ee2edd9b8b8d545b,1,Li Yang,2015-12-17 16:22:59+08:00,['c8e6ee4d20b7d2572f06f356152162b5726d05ae'],8,14,22,14499458,1,1,1,1,9836
97af27dd9b9c00328a4e46e2feb6302ea6461a28,0,Li Yang,2015-12-17 16:24:34+08:00,['4017822f0a5437c53ed20335ee2edd9b8b8d545b'],29,25,54,14499512,4,0.666666667,1,1,9836
35216a41d036d2031895b57e5d224f56029653f6,0,Li Yang,2015-12-17 16:25:11+08:00,['97af27dd9b9c00328a4e46e2feb6302ea6461a28'],2,3,5,14499517,1,1,1,0,9836
c06a4a597a51f459c4377a114c2057d6459c1d35,1,Li Yang,2015-12-17 16:29:03+08:00,['35216a41d036d2031895b57e5d224f56029653f6'],2,10,12,14499529,2,0,0,1,9836
65a02b412dee794fd3c1a3abd5844748edb38331,0,Li Yang,2015-12-17 22:14:56+08:00,['c06a4a597a51f459c4377a114c2057d6459c1d35'],1,0,1,14499530,1,0,0,0,9836
e7af4c78559d36a97403d81ed6e321440a70c185,1,Li Yang,2015-12-20 08:59:11+08:00,['65a02b412dee794fd3c1a3abd5844748edb38331'],45,132,177,14499707,3,0.473684211,0,1,9836
acd1410ed34a7c86e243714da573c34ddd4f8a03,0,Li Yang,2015-12-20 09:13:55+08:00,['e7af4c78559d36a97403d81ed6e321440a70c185'],1,1,2,14499709,1,,,,9836
dfc0a72094fbd8e10a4a42e37061230b0a4ba1a5,0,Li Yang,2015-12-21 14:02:28+08:00,['acd1410ed34a7c86e243714da573c34ddd4f8a03'],1,1,2,14499711,1,,,,9836
0b63a3c795af5695f87c9273abe40bb4984aa86a,1,Li Yang,2015-12-21 19:52:31+08:00,['dfc0a72094fbd8e10a4a42e37061230b0a4ba1a5'],1195,378,1573,14501284,13,0.721393035,0.320895522,0.266169154,9836
83c3052cde9f9f35a07bd168d4916a08061ddc53,0,honma,2015-12-22 16:11:12+08:00,['0b63a3c795af5695f87c9273abe40bb4984aa86a'],1,1,2,14501286,1,,,,9836
55df12b3dda125e20a29448075e2272b8ed70f18,1,lidongsjtu,2015-12-22 16:21:33+08:00,['83c3052cde9f9f35a07bd168d4916a08061ddc53'],35,23,58,14501344,5,,,,9836
68fcfd2448ec3db5fc21645c099bce7b2c35540b,0,shaofengshi,2015-12-22 16:43:33+08:00,"['1a936e257da15dd67391b0496e0d3e05d85663ea', '0fc9be513ccc1d62f647b70d1b310d4013d1e0b0']",1182,3052,4234,14505578,203,,,,9836
2b5345df77d3a8581e48962a6ccc3428c5774fe6,0,jian,2015-12-22 18:01:56+08:00,['55df12b3dda125e20a29448075e2272b8ed70f18'],2,35,37,14505615,2,0.448275862,1,0.965517241,9836
0af69e6814768e1ff50bcd1774d9c368313aa09d,1,Li Yang,2015-12-23 14:03:25+08:00,['2b5345df77d3a8581e48962a6ccc3428c5774fe6'],180,267,447,14506062,13,0.45,1,1,9837
abf108b432aaeb19e2eb9fbdd1769af705d1a54f,0,Li Yang,2015-12-23 15:13:57+08:00,['0af69e6814768e1ff50bcd1774d9c368313aa09d'],7,22,29,14506091,1,1,1,1,9837
9347bdc1b8dda5a25edd289d5c18c5922ff06a35,1,jian,2015-12-23 16:02:18+08:00,['abf108b432aaeb19e2eb9fbdd1769af705d1a54f'],5,1,6,14506097,1,1,1,1,9837
676dc781a4e8e49b52fcd1b98f74515e6838b441,1,Li Yang,2015-12-23 17:19:54+08:00,['9347bdc1b8dda5a25edd289d5c18c5922ff06a35'],566,558,1124,14507221,10,1,1,1,9839
ad8b5e6e018b314c489752685e7e724e578f4f3d,1,shaofengshi,2015-12-23 17:45:25+08:00,['676dc781a4e8e49b52fcd1b98f74515e6838b441'],17,55,72,14507293,2,0,1,1,9839
9b95f0ffb76b9b3993a81ead44ad86314af3b4da,0,shaofengshi,2015-12-24 11:14:41+08:00,['ad8b5e6e018b314c489752685e7e724e578f4f3d'],1,3,4,14507297,2,,,,9839
82717ae3a2bcc2572c194f0a085a1a49796d69d8,0,jian,2015-12-24 18:15:44+08:00,['9b95f0ffb76b9b3993a81ead44ad86314af3b4da'],2,46,48,14507345,3,0.538461538,0.538461538,0.948717949,9839
23cc6b4202ac4a33450f31e0aad1251f715b2860,1,Li Yang,2015-12-25 15:30:35+08:00,['82717ae3a2bcc2572c194f0a085a1a49796d69d8'],26,160,186,14507531,13,0.467391304,0.760869565,0.989130435,9839
e99d3e4a38a83a6476b6ca5866cbe46e25f61f71,1,Li Yang,2015-12-25 17:52:18+08:00,['23cc6b4202ac4a33450f31e0aad1251f715b2860'],11,6,17,14507548,3,,,,9839
3ea7075e8edbb6370636cc906a58dd2c95ab1c51,1,Li Yang,2015-12-25 18:12:38+08:00,['e99d3e4a38a83a6476b6ca5866cbe46e25f61f71'],8,7,15,14507563,5,,,,9839
d3925b7d85851ab462a157e97a3e72aeda406d24,0,Li Yang,2015-12-25 18:20:43+08:00,['3ea7075e8edbb6370636cc906a58dd2c95ab1c51'],1,4,5,14507568,1,,,,9839
e03de4391f14d51babeaf053b1d25cbdb325efdf,0,Li Yang,2015-12-25 20:50:26+08:00,['d3925b7d85851ab462a157e97a3e72aeda406d24'],51,50,101,14507669,1,1,0,0,9839
6ddb4459a4b8fa3345de9697f8dc40feb131d093,1,lidongsjtu,2015-12-27 11:05:11+08:00,['e03de4391f14d51babeaf053b1d25cbdb325efdf'],108,377,485,14508154,7,0.359375,0.817708333,1,9839
63cc8d008fb1b8301ae49979595460c4984bbf5f,1,lidongsjtu,2015-12-27 14:34:06+08:00,['6ddb4459a4b8fa3345de9697f8dc40feb131d093'],2,182,184,14508338,2,0.055045872,1,1,9840
9477725264edd934c7b50765f723d19fcd7ac465,0,lidongsjtu,2015-12-27 14:35:10+08:00,['63cc8d008fb1b8301ae49979595460c4984bbf5f'],1,1,2,14508340,1,,,,9840
834c5be4845ef79d13452d379168ecec1e440845,0,lidongsjtu,2015-12-27 15:12:36+08:00,['9477725264edd934c7b50765f723d19fcd7ac465'],1,1,2,14508342,1,,,,9840
0daa7ac68819e597cf531b2c604ff02398e22f0f,0,lidongsjtu,2015-12-27 23:59:00+08:00,['834c5be4845ef79d13452d379168ecec1e440845'],12,87,99,14508441,9,0.240740741,0.962962963,0.648148148,9840
3deb08ee456b1ec8a8bec94dfbaa7f8e93a3f05d,0,lidongsjtu,2015-12-28 10:13:44+08:00,['0daa7ac68819e597cf531b2c604ff02398e22f0f'],0,239,239,14508680,2,0.49137931,1,1,9841
242a3c5f73d2b6024f67bc7f7fcdd6e1cdd4774a,1,lidongsjtu,2015-12-28 10:42:10+08:00,['3deb08ee456b1ec8a8bec94dfbaa7f8e93a3f05d'],7,44,51,14508731,5,0.111111111,1,0.925925926,9841
78895d43783085fa491cc602692dd34f840dd9a8,1,shaofengshi,2015-12-28 11:40:05+08:00,['242a3c5f73d2b6024f67bc7f7fcdd6e1cdd4774a'],194,223,417,14509148,1,0.357142857,0,1,9841
3c9fd43b7e1d10a129afa208c5aae5534257b7d1,1,shaofengshi,2015-12-28 15:06:44+08:00,['78895d43783085fa491cc602692dd34f840dd9a8'],1,17,18,14509166,3,0.625,0,1,9841
dbf40957382cb46bdb44faaf17868dd75d40c943,0,honma,2015-12-29 09:49:44+08:00,['3c9fd43b7e1d10a129afa208c5aae5534257b7d1'],3,2,5,14509171,1,1,1,0,9841
dc34f8374512f2690dc8afebd6ee555b7d568362,0,Li Yang,2015-12-29 14:45:42+08:00,['dbf40957382cb46bdb44faaf17868dd75d40c943'],0,3,3,14509174,1,0,0,0,9841
7707abadd36aa9fa562478f40e11c37f7850524f,0,shaofengshi,2015-12-30 10:24:35+08:00,['dc34f8374512f2690dc8afebd6ee555b7d568362'],1,1,2,14509176,1,,,,9841
a1889ae64d5e233db19d5fc4fe5a89b534207b51,1,Li Yang,2015-12-30 16:42:37+08:00,['7707abadd36aa9fa562478f40e11c37f7850524f'],62,242,304,14509480,15,0.19047619,0.19047619,1,9843
b33ec60fe9c5da0a3e0afb269b88936f2e75636e,0,Li Yang,2015-12-30 16:55:00+08:00,['a1889ae64d5e233db19d5fc4fe5a89b534207b51'],30,11,41,14509521,4,0,0,0,9843
39f80aeb6aceb996103bedfdfefbac50f3253a22,1,shaofengshi,2015-12-30 17:49:38+08:00,['b33ec60fe9c5da0a3e0afb269b88936f2e75636e'],215,153,368,14509889,3,,,,9843
a1a8e4d34d5cc1323fc5c5abc95b8fa6e57b4777,0,Li Yang,2015-12-31 10:54:23+08:00,['39f80aeb6aceb996103bedfdfefbac50f3253a22'],5,7,12,14509901,1,,,,9843
f66cf2a678ef7b2042882f06795a365e512073ed,1,Li Yang,2015-12-31 11:47:27+08:00,['a1a8e4d34d5cc1323fc5c5abc95b8fa6e57b4777'],17,11,28,14509929,1,1,1,1,9843
5ec931f755166fec12314fabcc972bbb000c1b31,1,Li Yang,2015-12-31 16:30:37+08:00,['f66cf2a678ef7b2042882f06795a365e512073ed'],66,25,91,14510020,10,0,0,0,9843
3664458df1761a63f96aab365b3f068f5e6507ba,0,Li Yang,2015-12-31 17:19:27+08:00,['5ec931f755166fec12314fabcc972bbb000c1b31'],0,9,9,14510029,1,1,1,1,9843
a0e699436ebc07dc0b79897fa02ebe28c1d6ff5d,0,Li Yang,2015-12-31 18:39:03+08:00,['3664458df1761a63f96aab365b3f068f5e6507ba'],2,3,5,14510034,2,,,,9843
1cf6bc666f5738e462ba1fd6cfd5340dcb695213,1,Li Yang,2016-01-04 10:21:52+08:00,['a0e699436ebc07dc0b79897fa02ebe28c1d6ff5d'],2,3,5,14510039,1,0,0,0,9843
ee27b0b972c26e67859a312c3f23edf64205277d,0,Li Yang,2016-01-04 15:52:52+08:00,['1cf6bc666f5738e462ba1fd6cfd5340dcb695213'],0,6,6,14510045,1,,,,9843
2ec18964923fcbd8381673a17633b2fa706d5e48,1,shaofengshi,2016-01-04 17:33:00+08:00,['ee27b0b972c26e67859a312c3f23edf64205277d'],19,49,68,14510113,12,1,1,0.722222222,9843
626f4d476a8dc3558e8a3e37609c76f696d43f9b,0,shaofengshi,2016-01-04 17:33:32+08:00,['2ec18964923fcbd8381673a17633b2fa706d5e48'],0,0,0,14510113,0,,,,9843
6e565ed8efc23419720f47e5022c030b83b400c9,1,jian,2016-01-04 19:51:58+08:00,['626f4d476a8dc3558e8a3e37609c76f696d43f9b'],351,466,817,14510930,10,1,1,0,9843
8850b03f7d2dd96257f829bfd354af5afa854acb,1,honma,2016-01-04 21:39:54+08:00,['6e565ed8efc23419720f47e5022c030b83b400c9'],22,94,116,14511046,3,0.377358491,0.754716981,1,9843
7f22d34fa0e163f7aeb5dceb22b1ae2a16128376,1,honma,2016-01-04 21:39:54+08:00,['8850b03f7d2dd96257f829bfd354af5afa854acb'],271,702,973,14512019,35,0.074183976,0.445103858,1,9845
6eaf117718ce689f90bcf7aab48dbe8b97ddc144,1,jian,2016-01-05 00:50:45+08:00,['7f22d34fa0e163f7aeb5dceb22b1ae2a16128376'],21,53,74,14512093,6,1,1,,9845
f12bbb3bd416a3ab0c8bc97b5837f2f6d0341175,0,Li Yang,2016-01-05 10:58:10+08:00,['6eaf117718ce689f90bcf7aab48dbe8b97ddc144'],3,3,6,14512099,1,,,,9845
354d1d9287e00ba326b2051fcf870801ca3b9a25,1,shaofengshi,2016-01-05 11:12:10+08:00,['f12bbb3bd416a3ab0c8bc97b5837f2f6d0341175'],5,125,130,14512229,7,0.071428571,0.071428571,0.988095238,9845
137a78e209e2774d5577a2a3d8df3c55366168bd,0,Li Yang,2016-01-05 11:26:34+08:00,['354d1d9287e00ba326b2051fcf870801ca3b9a25'],0,73,73,14512302,4,,,,9845
c66343a549e43bcda40e16978407ddb8bc10ce35,1,lidongsjtu,2016-01-05 11:26:54+08:00,['137a78e209e2774d5577a2a3d8df3c55366168bd'],3,66,69,14512371,4,0.407407407,0.407407407,1,9846
80415ac96d54c547d912425489f549b8516681a3,0,lidongsjtu,2016-01-05 11:28:05+08:00,['c66343a549e43bcda40e16978407ddb8bc10ce35'],1,1,2,14512373,1,,,,9846
af03d0becd20f92a186be608cc9739638d00f1bc,1,shaofengshi,2016-01-05 14:34:37+08:00,['80415ac96d54c547d912425489f549b8516681a3'],2,6,8,14512381,1,,,,9846
bd52c89a052c56e71f36d06d40baaf24bb6213cb,1,jian,2016-01-05 15:16:14+08:00,['af03d0becd20f92a186be608cc9739638d00f1bc'],1,57,58,14512439,5,1,1,0.333333333,9847
eddeb3ec0339b07c6f7db184480aee08aefe3b12,0,jian,2016-01-05 15:48:00+08:00,['bd52c89a052c56e71f36d06d40baaf24bb6213cb'],12,2,14,14512453,1,1,1,1,9847
720a6146c8e2a0bd9a0cf1adf79d98cbde138c85,1,honma,2016-01-05 16:10:58+08:00,['eddeb3ec0339b07c6f7db184480aee08aefe3b12'],8,8,16,14512469,1,,,,9847
68c29a94bf3b8833000be69604b2b2bab1ef8136,0,honma,2016-01-05 16:11:29+08:00,['720a6146c8e2a0bd9a0cf1adf79d98cbde138c85'],5,5,10,14512479,1,1,1,0,9847
fa918a106c4b27dff748d689d0382cc5a05af884,0,Li Yang,2016-01-05 16:50:15+08:00,['68c29a94bf3b8833000be69604b2b2bab1ef8136'],19,6,25,14512504,1,0.8,1,0.1,9847
8b2917c5ca052fd930241a730c21df17191d50d0,0,Li Yang,2016-01-05 17:16:51+08:00,['fa918a106c4b27dff748d689d0382cc5a05af884'],7,4,11,14512515,1,1,0,0,9847
4edc828b75a172fdda41b6480ebb62cf09e029d6,1,lidongsjtu,2016-01-06 11:32:13+08:00,['8b2917c5ca052fd930241a730c21df17191d50d0'],8,307,315,14512830,8,0.48,0.685,0.6,9848
a39fb4e6eeefb47a8824e5c9c71056c45bbef589,0,shaofengshi,2016-01-06 14:30:41+08:00,['4edc828b75a172fdda41b6480ebb62cf09e029d6'],1,1,2,14512832,1,,,,9848
4c06bf4a6ee8d49aa8f9383a7d03d9d9ca7e0e4c,0,Li Yang,2016-01-07 11:32:54+08:00,['a39fb4e6eeefb47a8824e5c9c71056c45bbef589'],0,120,120,14512952,4,,,,9852
124d4b2716f8b30cad821744884e93cce5044851,1,jian,2016-01-07 17:00:23+08:00,['4c06bf4a6ee8d49aa8f9383a7d03d9d9ca7e0e4c'],173,167,340,14513292,11,0,0.222222222,0,9853
bc671a4abba3b61ad4052694fa6e1c8e537a0737,0,jian,2016-01-07 17:00:23+08:00,['124d4b2716f8b30cad821744884e93cce5044851'],3,11,14,14513306,2,,,,9853
81a4f7648d4d79200f1ca55dcaddbdd9d7afef7c,0,jian,2016-01-07 17:51:00+08:00,['bc671a4abba3b61ad4052694fa6e1c8e537a0737'],3,3,6,14513312,1,,,,9853
18d2a067ac7f674834f65fe2c019772595da1df7,1,jian,2016-01-07 18:50:53+08:00,['81a4f7648d4d79200f1ca55dcaddbdd9d7afef7c'],0,3,3,14513315,1,,,,9853
b2c410d62e509d31b097e7a7192a6b3cad24b80c,1,honma,2016-01-08 10:50:41+08:00,['18d2a067ac7f674834f65fe2c019772595da1df7'],2,26,28,14513343,6,1,1,1,9853
d03fe6259d4d711e3b9fb92650de63a79b2894ee,0,honma,2016-01-08 10:51:56+08:00,['b2c410d62e509d31b097e7a7192a6b3cad24b80c'],19,203,222,14513565,7,0.650793651,0.666666667,0.904761905,9853
8adc66b9eebc5d7d2491ec7cc13aaea3075f95a7,1,honma,2016-01-08 11:03:06+08:00,['d03fe6259d4d711e3b9fb92650de63a79b2894ee'],548,508,1056,14514621,22,0.902439024,0.731707317,0.951219512,9853
5992c1af06c06691ec7847501bd5abfa88a5eb84,1,lidongsjtu,2016-01-08 11:12:47+08:00,['8adc66b9eebc5d7d2491ec7cc13aaea3075f95a7'],6,874,880,14515501,15,0.2890625,0.32421875,0.888671875,9859
4fbfc89de21449f632c8629c4fec9df4d055e9fa,1,lidongsjtu,2016-01-08 11:40:51+08:00,['5992c1af06c06691ec7847501bd5abfa88a5eb84'],46,84,130,14515631,3,0.774193548,0.935483871,1,9859
9cd0f856418dfe182769c30d59535f82aee9398b,0,lidongsjtu,2016-01-08 11:40:56+08:00,['4fbfc89de21449f632c8629c4fec9df4d055e9fa'],3,0,3,14515634,1,,,,9859
cc0ed10637fc88d9d2019c41a55fd435ec241275,1,jian,2016-01-08 11:54:44+08:00,['9cd0f856418dfe182769c30d59535f82aee9398b'],105,18,123,14515757,6,0,0,1,9859
44efecba7f324f483846e52aa86e0a469e3c9eb5,0,jian,2016-01-08 16:54:49+08:00,['cc0ed10637fc88d9d2019c41a55fd435ec241275'],2,3,5,14515762,2,0,0,1,9859
b0654a699e31c90d2c8d83c632d5d8116917b92a,0,jian,2016-01-08 17:25:02+08:00,['44efecba7f324f483846e52aa86e0a469e3c9eb5'],0,3,3,14515765,1,,,,9859
56fce14130d6e6ea9c2e13184a7a1bae324cf7c2,0,lidongsjtu,2016-01-11 10:22:10+08:00,['b0654a699e31c90d2c8d83c632d5d8116917b92a'],7,7,14,14515779,2,,,,9859
fbfb65ea5a9b3e0f0c4fcbcb428a69f5c6bb2042,0,lidongsjtu,2016-01-11 10:23:52+08:00,['56fce14130d6e6ea9c2e13184a7a1bae324cf7c2'],17,41,58,14515837,3,,,,9859
a6ad62d1169db17c89cf9fd4f1e57f5cd3f0a9a9,0,shaofengshi,2016-01-12 17:28:34+08:00,['fbfb65ea5a9b3e0f0c4fcbcb428a69f5c6bb2042'],0,30,30,14515867,1,1,1,0.952380952,9859
acd6501d3d6b77f56fdee20231568409dece1088,1,jian,2016-01-12 18:43:02+08:00,['a6ad62d1169db17c89cf9fd4f1e57f5cd3f0a9a9'],117,55,172,14516039,2,1,1,1,9859
78e8c5d58f48b020783b690b4bde88f2b58cb12d,1,shaofengshi,2016-01-13 10:34:01+08:00,['acd6501d3d6b77f56fdee20231568409dece1088'],1,24,25,14516064,2,0.928571429,1,1,9859
3d760212f280955573789a173b7a56978d28b869,1,shaofengshi,2016-01-13 12:57:24+08:00,['78e8c5d58f48b020783b690b4bde88f2b58cb12d'],2,2,4,14516068,1,,,,9859
3a6ab9bbea32a7c09f070631fb4b123244d6a590,0,honma,2016-01-13 17:48:31+08:00,['3d760212f280955573789a173b7a56978d28b869'],2,8,10,14516078,2,1,1,1,9859
74ae5db734c87266f96de83da74a2fd85c998f4c,0,honma,2016-01-13 17:48:51+08:00,['3a6ab9bbea32a7c09f070631fb4b123244d6a590'],11,19,30,14516108,1,0,1,1,9859
58fbf75aaaf09922b8b2d395b864af46757846fc,0,honma,2016-01-13 17:49:27+08:00,['74ae5db734c87266f96de83da74a2fd85c998f4c'],16,38,54,14516162,5,0.428571429,0.714285714,0.285714286,9859
7f0c75dfe5eedb1c364ae2190490786c9aeed40d,0,honma,2016-01-13 17:49:33+08:00,['58fbf75aaaf09922b8b2d395b864af46757846fc'],7,5,12,14516174,2,0,0,1,9859
3c5f4e31ecbfbdfd49b8b3926a8c468050671f94,0,honma,2016-01-13 17:51:17+08:00,['7f0c75dfe5eedb1c364ae2190490786c9aeed40d'],3,58,61,14516235,3,0,0,1,9860
3ba7ae07ec99aee23d2c86bfdc3c529cf98bdd9d,0,honma,2016-01-13 17:52:57+08:00,['3c5f4e31ecbfbdfd49b8b3926a8c468050671f94'],14,51,65,14516300,3,0.096774194,0,1,9860
4757d1ad6f8f7a25d426a46ecf412e5859f64526,1,honma,2016-01-13 17:53:40+08:00,['3ba7ae07ec99aee23d2c86bfdc3c529cf98bdd9d'],453,416,869,14517169,8,1,0.56779661,0.025423729,9860
d9d45ade365d8ea11c96bf07bf5ecae7d5ecb690,0,honma,2016-01-13 17:54:04+08:00,['4757d1ad6f8f7a25d426a46ecf412e5859f64526'],1,2,3,14517172,1,,,,9860
98dec8e5bdaef1ce0e5513e253a6c0ce2789a3fa,0,honma,2016-01-13 17:54:04+08:00,['d9d45ade365d8ea11c96bf07bf5ecae7d5ecb690'],153,266,419,14517591,4,0.130177515,1,0.781065089,9860
be22c7d0737e08aa322132877c050187f63c39f1,1,lidongsjtu,2016-01-13 18:08:19+08:00,['98dec8e5bdaef1ce0e5513e253a6c0ce2789a3fa'],17,43,60,14517651,1,0.695652174,1,1,9860
e35b02ab39d967e05cc4d8eac4fc7d60e6fac724,0,jian,2016-01-13 19:58:42+08:00,['be22c7d0737e08aa322132877c050187f63c39f1'],1,1,2,14517653,1,,,,9860
d58225b6dbec86667549efb2296f4bc9aa63d7bd,1,jian,2016-01-13 19:58:42+08:00,['e35b02ab39d967e05cc4d8eac4fc7d60e6fac724'],0,3,3,14517656,1,0,1,1,9860
79677570fa91368333df324b48196f11431fb14b,1,jian,2016-01-13 20:33:10+08:00,['d58225b6dbec86667549efb2296f4bc9aa63d7bd'],1,1,2,14517658,1,,,,9860
9459a1f6938404676aaac12f99103e95f824319c,0,jian,2016-01-13 21:20:19+08:00,['79677570fa91368333df324b48196f11431fb14b'],4,13,17,14517675,2,,,,9860
fe2a7f5d7052466fa04f9dc4f7fdddb20c36007b,0,jian,2016-01-13 21:20:41+08:00,['9459a1f6938404676aaac12f99103e95f824319c'],0,1,1,14517676,1,,,,9860
ea70c63d37483d12e2dd6ac565b8dd65d857fecb,0,jian,2016-01-13 21:40:59+08:00,['fe2a7f5d7052466fa04f9dc4f7fdddb20c36007b'],1,1,2,14517678,1,,,,9860
3bec4581d2c43c02627d967cd5cf192bceef0903,0,honma,2016-01-14 10:38:00+08:00,['ea70c63d37483d12e2dd6ac565b8dd65d857fecb'],0,4,4,14517682,1,,,,9861
86f22b120f9ba70041070f9991cfb8a6da737bd4,0,honma,2016-01-14 10:48:05+08:00,['3bec4581d2c43c02627d967cd5cf192bceef0903'],11,18,29,14517711,1,0,0,1,9861
c209ac5cf23357d379f5af33f3d18cdb9ea3e339,1,jian,2016-01-14 11:01:41+08:00,['86f22b120f9ba70041070f9991cfb8a6da737bd4'],0,25,25,14517736,1,,,,9862
9d09eb3de7712599540dda3fcda4ed9917271948,0,lidongsjtu,2016-01-14 13:57:30+08:00,['c209ac5cf23357d379f5af33f3d18cdb9ea3e339'],0,16,16,14517752,1,,,,9862
579dba0f614756d313e07496efd7ffd2b78e8b6c,1,lidongsjtu,2016-01-14 13:57:43+08:00,['9d09eb3de7712599540dda3fcda4ed9917271948'],5,12,17,14517769,1,0,0,0,9862
dc7e16eb28a64c07fc816f7cadefbff194d9d620,0,jian,2016-01-14 14:03:41+08:00,['579dba0f614756d313e07496efd7ffd2b78e8b6c'],26,1,27,14517796,2,,,,9862
67bfe71613e94c23355dd14f003fd317f71f6c67,0,honma,2016-01-14 14:23:54+08:00,['dc7e16eb28a64c07fc816f7cadefbff194d9d620'],6,29,35,14517831,4,0.7,0.75,1,9862
e09ab0aa8a839a026c9e2477efa4bc977671a8f3,0,honma,2016-01-14 15:17:31+08:00,['67bfe71613e94c23355dd14f003fd317f71f6c67'],2,3,5,14517836,1,,,,9862
7757e4e88f9fc26f18e650b66bb4a506c2dc87ec,0,honma,2016-01-14 16:24:49+08:00,['e09ab0aa8a839a026c9e2477efa4bc977671a8f3'],1,1,2,14517838,1,,,,9862
25d8b02b3602cbce0f63b138b4f840ff06272bd0,0,honma,2016-01-14 17:41:10+08:00,['7757e4e88f9fc26f18e650b66bb4a506c2dc87ec'],1,0,1,14517839,1,1,0,0,9862
adcf11a7c056531dc7176da658a8308fcd311d6d,0,honma,2016-01-14 18:34:35+08:00,['25d8b02b3602cbce0f63b138b4f840ff06272bd0'],1,5,6,14517845,1,0,0,1,9862
5e17fb1d09ba2b9e44c791759d0985d10842c55c,0,honma,2016-01-14 18:34:44+08:00,['adcf11a7c056531dc7176da658a8308fcd311d6d'],1,1,2,14517847,1,1,1,0,9862
e7c29636715fe9b1be258d6cc010cf11cc87306f,0,jian,2016-01-15 18:52:18+08:00,['5e17fb1d09ba2b9e44c791759d0985d10842c55c'],3,1,4,14517851,1,0,0,0,9862
3ca65194dd38526569c1c717e305644463700f58,0,jian,2016-01-18 12:54:10+08:00,['e7c29636715fe9b1be258d6cc010cf11cc87306f'],1,1,2,14517853,1,,,,9862
57daab0890c4bff3411bc8a95f8a2c80390d5a3f,0,jian,2016-01-18 14:41:32+08:00,['3ca65194dd38526569c1c717e305644463700f58'],1,1,2,14517855,1,,,,9862
e707dbaf06cfea967adaf4cc911cb14326ed129d,0,jian,2016-01-18 15:03:46+08:00,['57daab0890c4bff3411bc8a95f8a2c80390d5a3f'],3,18,21,14517876,3,0.933333333,1,0.933333333,9862
4c29b640329f275988d82feb8790838bd9696fc1,0,jian,2016-01-18 17:19:13+08:00,['e707dbaf06cfea967adaf4cc911cb14326ed129d'],1,1,2,14517878,1,,,,9862
79df04e0dd6d4c12195f7c60201bbe4c51bdcc76,0,shaofengshi,2016-01-19 09:57:35+08:00,['4c29b640329f275988d82feb8790838bd9696fc1'],3,1,4,14517882,2,,,,9862
a7815dc49f2e54efd44730b11406248f5d4b7f99,0,shaofengshi,2016-01-19 09:57:44+08:00,['79df04e0dd6d4c12195f7c60201bbe4c51bdcc76'],4,4,8,14517890,2,,,,9862
c51b2e52dbbfe51c99be76a96f25d17a31a0403c,0,honma,2016-01-19 15:05:38+08:00,['a7815dc49f2e54efd44730b11406248f5d4b7f99'],9,22,31,14517921,1,0,0,1,9862
04ae0e805d839158655faa2f368b284ccef6fe50,0,honma,2016-01-19 15:05:53+08:00,['c51b2e52dbbfe51c99be76a96f25d17a31a0403c'],0,1,1,14517922,1,0,1,0,9862
adf2beb1c0927bfc639e208671a752ed2495eba9,0,honma,2016-01-19 15:10:41+08:00,['04ae0e805d839158655faa2f368b284ccef6fe50'],8,15,23,14517945,3,0,0.5,1,9862
b4a5c35aa7ce535a827931ca584b733b7b1ab036,0,lidongsjtu,2016-01-19 15:32:04+08:00,['adf2beb1c0927bfc639e208671a752ed2495eba9'],0,1,1,14517946,1,0,0,1,9862
5198582727279ec034e018638452e04d0e029078,1,lidongsjtu,2016-01-19 17:15:43+08:00,['b4a5c35aa7ce535a827931ca584b733b7b1ab036'],0,192,192,14518138,1,0.336206897,0.482758621,1,9863
c31deb2cf03a8bf3043694fcbc3d5de421a5a0da,1,lidongsjtu,2016-01-19 17:16:03+08:00,['5198582727279ec034e018638452e04d0e029078'],11,21,32,14518170,1,0.375,0.375,1,9863
2510fdd1c78ffd2510ca8788d58d7c0cf8570d14,0,lidongsjtu,2016-01-19 17:16:15+08:00,['c31deb2cf03a8bf3043694fcbc3d5de421a5a0da'],1,1,2,14518172,1,,,,9863
0eb4a7caa74ef1b5ac81534c08b8bdf9eb64d20a,0,lidongsjtu,2016-01-19 17:16:44+08:00,['2510fdd1c78ffd2510ca8788d58d7c0cf8570d14'],494,0,494,14518666,3,,,,9863
e74883b471344e37b118eec9d859153277296354,0,lidongsjtu,2016-01-19 17:17:00+08:00,['0eb4a7caa74ef1b5ac81534c08b8bdf9eb64d20a'],0,4,4,14518670,1,1,1,1,9863
b5cd225a7bbb6ac4e1f31bfa76ed14d27acaeb6e,0,lidongsjtu,2016-01-19 17:17:50+08:00,['e74883b471344e37b118eec9d859153277296354'],9,67,76,14518746,1,0,0.823529412,0,9863
14c762d1f93dc3debe546f6cc54a56589e175b44,1,jian,2016-01-19 21:40:17+08:00,['b5cd225a7bbb6ac4e1f31bfa76ed14d27acaeb6e'],49,98,147,14518893,8,,,,9863
2f41a7aa03657364c38ef6dbc010d82034e88acd,0,lidongsjtu,2016-01-20 15:33:55+08:00,['14c762d1f93dc3debe546f6cc54a56589e175b44'],0,1,1,14518894,1,0,1,1,9863
8e11f73b1fe68c5f4e566c6aa968b6c4e26c5acf,0,lidongsjtu,2016-01-20 15:34:13+08:00,['2f41a7aa03657364c38ef6dbc010d82034e88acd'],5,3,8,14518902,2,1,0.5,0.5,9863
85398ea6302b49155b60628f77476cd505833cb4,0,lidongsjtu,2016-01-20 15:34:20+08:00,['8e11f73b1fe68c5f4e566c6aa968b6c4e26c5acf'],1,1,2,14518904,1,,,,9863
c926cb3d4eeac558f9694c509a1342b26426c628,0,lidongsjtu,2016-01-20 15:45:45+08:00,['85398ea6302b49155b60628f77476cd505833cb4'],0,83,83,14518987,2,1,1,1,9864
c5dfb243e57c35e528162c679a9e43c731a4f63e,0,honma,2016-01-20 17:53:36+08:00,['c926cb3d4eeac558f9694c509a1342b26426c628'],4,62,66,14519053,4,0.9375,0.0625,0.125,9865
f990ed645ba66b13cdd23a3ea907f31f19479b23,0,lidongsjtu,2016-01-21 14:07:01+08:00,['c5dfb243e57c35e528162c679a9e43c731a4f63e'],3,2,5,14519058,1,,,,9865
325fd4b8e3b5c96ddb883d2471b5b6c87d644836,1,jian,2016-01-21 15:08:39+08:00,['f990ed645ba66b13cdd23a3ea907f31f19479b23'],51,32,83,14519141,7,1,1,0,9865
0a95ecb18c9be3e786fa265f23005b3e891147f4,1,jian,2016-01-22 01:20:39+08:00,['325fd4b8e3b5c96ddb883d2471b5b6c87d644836'],28,468,496,14519637,13,0.506024096,0.518072289,0.923694779,9867
e619ca000a5d458d42dc61596a71831a2c336459,0,shaofengshi,2016-01-22 11:16:46+08:00,['0a95ecb18c9be3e786fa265f23005b3e891147f4'],3,7,10,14519647,1,,,,9867
7a67ddd4ccbf312db2e1a3126a0888a70c393f80,0,Li Yang,2016-01-22 16:47:35+08:00,['e619ca000a5d458d42dc61596a71831a2c336459'],1,1,2,14519649,1,,,,9867
cc84b0521d4d51f18a89e8e05ba9857565b78143,1,Li Yang,2016-01-22 17:19:24+08:00,['7a67ddd4ccbf312db2e1a3126a0888a70c393f80'],5,8,13,14519662,1,1,1,1,9867
18692cc28e52cffb1df2d49e2fe61d7bceff2987,0,shaofengshi,2016-01-22 17:42:30+08:00,['cc84b0521d4d51f18a89e8e05ba9857565b78143'],3,8,11,14519673,1,0,1,1,9867
dea21fd8092cbeeb4561fa392922bbc92d37da9f,1,sunyerui,2016-01-22 21:44:03+08:00,['18692cc28e52cffb1df2d49e2fe61d7bceff2987'],10,947,957,14520630,26,0.8,0.996923077,0.966153846,9883
af8ae069ff40628fde44878d93330921785d4fda,0,Li Yang,2016-01-24 09:53:18+08:00,['dea21fd8092cbeeb4561fa392922bbc92d37da9f'],4,10,14,14520644,4,1,1,1,9883
a4e072bcc6ad528e721bfc5d62302eff719e1d07,1,shaofengshi,2016-01-25 09:49:39+08:00,['af8ae069ff40628fde44878d93330921785d4fda'],13,97,110,14520754,1,0.220338983,0.220338983,1,9883
d0f0e69fb7bafafe042849a0648e03fc03da5ece,0,shaofengshi,2016-01-25 12:19:27+08:00,['a4e072bcc6ad528e721bfc5d62302eff719e1d07'],1,1,2,14520756,1,,,,9883
33f684b5b4b1953296938fc1ba007ff6d8ea6439,0,shaofengshi,2016-01-25 17:13:41+08:00,['d0f0e69fb7bafafe042849a0648e03fc03da5ece'],33,101,134,14520890,3,0.619047619,1,0.738095238,9883
2ebb324f1070a17b63ac93ceb3c8a732a3882a59,0,shaofengshi,2016-01-25 17:20:55+08:00,['33f684b5b4b1953296938fc1ba007ff6d8ea6439'],8,22,30,14520920,1,0,0,1,9883
7ba00007554ede8ae2dd85e398faa8bf58eda810,0,shaofengshi,2016-01-25 21:37:50+08:00,['2ebb324f1070a17b63ac93ceb3c8a732a3882a59'],1,1,2,14520922,1,,,,9883
cd5ab97b4b1b5002695a48455f5b92971c0d57e0,1,shaofengshi,2016-01-26 08:09:14+08:00,['7ba00007554ede8ae2dd85e398faa8bf58eda810'],69,13,82,14521004,5,1,1,1,9883
b0f690b3ca2c8f0018f06b6c01cf04d1cde6ee19,0,lidongsjtu,2016-01-26 12:10:11+08:00,['cd5ab97b4b1b5002695a48455f5b92971c0d57e0'],5,70,75,14521079,2,1,1,1,9884
1b4399aa4fb58b628560d11644944ca7303f80b9,0,lidongsjtu,2016-01-26 12:10:34+08:00,['b0f690b3ca2c8f0018f06b6c01cf04d1cde6ee19'],7,13,20,14521099,1,1,1,1,9884
3213450d5d86d63d7837ab95690c027c7a2fc743,0,lidongsjtu,2016-01-26 12:10:41+08:00,['1b4399aa4fb58b628560d11644944ca7303f80b9'],0,2,2,14521101,1,0,0,0,9884
2a015f35a0d99319d2b9d2c4c7da3fbd62e4e34d,0,shaofengshi,2016-01-26 12:54:02+08:00,['3213450d5d86d63d7837ab95690c027c7a2fc743'],1,1,2,14521103,1,,,,9884
e76235c1d6bf532646b92885e9bf88cb34c89a5a,1,Zhong Jian,2016-01-26 14:47:55+08:00,['2a015f35a0d99319d2b9d2c4c7da3fbd62e4e34d'],165,342,507,14521610,14,0.102040816,0.231292517,0.986394558,9884
359f6748933995a950b877224095ba6e96cb09b8,0,shaofengshi,2016-01-26 16:03:44+08:00,['e76235c1d6bf532646b92885e9bf88cb34c89a5a'],1,1,2,14521612,1,,,,9884
cb0bf275b601437916fc26ce8eaa90b84dce5be8,0,honma,2016-01-26 21:40:48+08:00,['359f6748933995a950b877224095ba6e96cb09b8'],89,108,197,14521809,19,,,,9884
c437586ec9fc74632a2940caaf3694bcb44d8fa9,0,honma,2016-01-26 21:40:48+08:00,['cb0bf275b601437916fc26ce8eaa90b84dce5be8'],3,6,9,14521818,2,0,1,1,9884
dffe38d007156517a8039eb40eea425fa23cfdac,0,honma,2016-01-26 21:40:48+08:00,['c437586ec9fc74632a2940caaf3694bcb44d8fa9'],9,14,23,14521841,1,1,1,1,9884
a49af49db0f2145ef86244b51ec11f1a6f5d058e,1,honma,2016-01-26 21:40:49+08:00,['dffe38d007156517a8039eb40eea425fa23cfdac'],402,963,1365,14523206,286,0.127659574,0.393617021,0.531914894,9886
bbad1d791b0d764c1662ed13f89c4329f2800eed,0,sunyerui,2016-01-26 23:12:23+08:00,['a49af49db0f2145ef86244b51ec11f1a6f5d058e'],2,3,5,14523211,2,,,,9886
d287ae3d231ca33a2d2fac25fefd65ac18c68fd9,0,honma,2016-01-27 11:02:56+08:00,['bbad1d791b0d764c1662ed13f89c4329f2800eed'],2,1,3,14523214,2,,,,9886
d5b10fe073959435f11b80c32fc2a93d8d3eac1a,0,honma,2016-01-27 12:45:34+08:00,['d287ae3d231ca33a2d2fac25fefd65ac18c68fd9'],0,1,1,14523215,1,,,,9886
5c3849e6cdacd7691d8a86aa384dd9b7c94de665,1,Zhong Jian,2016-01-27 19:33:57+08:00,['d5b10fe073959435f11b80c32fc2a93d8d3eac1a'],2,2,4,14523219,1,,,,9886
35f24540562f6807d0d6ff71ccd0cdc37ed68f19,1,Zhong Jian,2016-01-27 19:33:57+08:00,['5c3849e6cdacd7691d8a86aa384dd9b7c94de665'],64,61,125,14523344,8,1,1,1,9886
22e9ac59558176ea031996bfa587f867005f60df,0,Zhong Jian,2016-01-27 19:40:44+08:00,['35f24540562f6807d0d6ff71ccd0cdc37ed68f19'],1,1,2,14523346,1,,,,9886
7d6defc51f365a7b2497cdb6c3e4cddfe237cebd,0,Zhong Jian,2016-01-27 19:56:51+08:00,['22e9ac59558176ea031996bfa587f867005f60df'],3,3,6,14523352,3,,,,9886
17d9ea13d510854f8eb82bbe36203c474bf83622,0,Zhong Jian,2016-01-27 20:25:05+08:00,['7d6defc51f365a7b2497cdb6c3e4cddfe237cebd'],1,1,2,14523354,1,,,,9886
0581a52d7136cc763dd8f19b0cff0c10ebbf8ff8,0,honma,2016-01-27 21:37:38+08:00,['17d9ea13d510854f8eb82bbe36203c474bf83622'],2,2,4,14523358,1,,,,9886
aef90a1630eec87e09cba3803684d12bcb43405e,0,honma,2016-01-27 21:37:38+08:00,['0581a52d7136cc763dd8f19b0cff0c10ebbf8ff8'],9,9,18,14523376,2,,,,9886
44d1c9a8f44e1910309909a80e061f85ac672708,0,honma,2016-01-27 21:53:32+08:00,['aef90a1630eec87e09cba3803684d12bcb43405e'],1,101,102,14523478,2,,,,9887
b44d02b7be27b6a7b2790e0e071e3d7d359cc58f,0,honma,2016-01-27 22:19:00+08:00,['44d1c9a8f44e1910309909a80e061f85ac672708'],66,52,118,14523596,45,,,,9887
6dc69420e1e2bb464900da71f1459a7fb94c499f,1,honma,2016-01-28 10:34:25+08:00,['b44d02b7be27b6a7b2790e0e071e3d7d359cc58f'],0,19,19,14523615,1,0,0,1,9887
273a163bea22da5747c9d3936769bb4c139c00c3,1,Zhong Jian,2016-01-28 20:13:41+08:00,['6dc69420e1e2bb464900da71f1459a7fb94c499f'],3,3,6,14523621,2,,,,9887
db2ebc0a0c438355f9015ae1285f9a85c2f480ef,0,shaofengshi,2016-01-29 10:50:47+08:00,['273a163bea22da5747c9d3936769bb4c139c00c3'],9,4,13,14523634,5,0,0,0,9887
a7540ef6460ff867646e46fb36b410b03453080b,1,sunyerui,2016-01-29 12:01:02+08:00,['db2ebc0a0c438355f9015ae1285f9a85c2f480ef'],1,43,44,14523678,4,0,0,1,9889
4ab027fa79d22c2c6c7569d1a8dc8ee465874ca9,1,Zhong Jian,2016-01-29 16:18:08+08:00,['a7540ef6460ff867646e46fb36b410b03453080b'],5,180,185,14523863,2,1,1,0.755555556,9889
c0ef0170f5653396bfd0121c23c73ba4d60364f3,1,Zhong Jian,2016-01-29 16:18:08+08:00,['4ab027fa79d22c2c6c7569d1a8dc8ee465874ca9'],18,98,116,14523979,4,1,1,0.607142857,9889
68fe1fc114e5eef1e4bb31f878e704be396ad777,0,shaofengshi,2016-01-29 17:48:15+08:00,['c0ef0170f5653396bfd0121c23c73ba4d60364f3'],4,4,8,14523987,1,,,,9889
4308ed84d27f0980da46c7e9cf183d998a0de526,1,shaofengshi,2016-01-31 16:47:59+08:00,['68fe1fc114e5eef1e4bb31f878e704be396ad777'],61,102,163,14524150,6,1,1,0.777777778,9890
f6fbfa5dc137982dacfbb67433b7cd7954b8a46d,0,shaofengshi,2016-01-31 17:04:36+08:00,['4308ed84d27f0980da46c7e9cf183d998a0de526'],0,2,2,14524152,1,,,,9890
6d8e0910844c4bacc35eeb911680f793ce282ee6,0,lidongsjtu,2016-02-01 11:10:55+08:00,['f6fbfa5dc137982dacfbb67433b7cd7954b8a46d'],0,4,4,14524156,2,0,0,0,9890
20673dacd52cf3b8b12e9822e7574d4b322b8b38,0,honma,2016-02-01 13:44:24+08:00,['6d8e0910844c4bacc35eeb911680f793ce282ee6'],1,1,2,14524158,1,,,,9890
f8175780da0a18828189484e5a2689615caa76fd,0,lidongsjtu,2016-02-01 15:29:46+08:00,['20673dacd52cf3b8b12e9822e7574d4b322b8b38'],109,255,364,14524522,7,0,0,0.391304348,9891
4334f97cb8674bea275f6cc904b9da1247dc7ee3,1,lidongsjtu,2016-02-01 17:18:24+08:00,['f8175780da0a18828189484e5a2689615caa76fd'],6959,8419,15378,14539900,42,0,0.244306418,0.334023464,9891
7118a5e5bed02c07041a7b68276d07aeffbe04d0,1,honma,2016-02-01 18:46:14+08:00,['4334f97cb8674bea275f6cc904b9da1247dc7ee3'],210,839,1049,14540949,23,0.478114478,0.589225589,0.831649832,9894
05f5a4f60ec84cc34df9930bfef7045a933fbc6d,0,honma,2016-02-01 22:14:41+08:00,['7118a5e5bed02c07041a7b68276d07aeffbe04d0'],5,5,10,14540959,3,,,,9894
04222b943b95569dbf09b7476f8ccd457702bc30,0,shaofengshi,2016-02-03 10:27:38+08:00,['05f5a4f60ec84cc34df9930bfef7045a933fbc6d'],1,8,9,14540968,2,0,1,1,9894
d11bb299b7ff92301f40b4d10e04b8553e653daa,1,honma,2016-02-03 14:34:12+08:00,['04222b943b95569dbf09b7476f8ccd457702bc30'],3,43,46,14541014,1,0.296296296,0.296296296,1,9894
6b7f5a588777691c96b09dc253a7e0e4687f8c16,1,honma,2016-02-04 10:06:47+08:00,['d11bb299b7ff92301f40b4d10e04b8553e653daa'],56,143,199,14541213,63,1,1,1,9895
8aa46f281e547a7445f43eb689e28d2f5e1e0ceb,0,shaofengshi,2016-02-05 16:00:52+08:00,['6b7f5a588777691c96b09dc253a7e0e4687f8c16'],1,4,5,14541218,1,1,1,1,9895
ba3ccf82d2f9411747cd9e2fb57b540a09a005d6,0,shaofengshi,2016-02-05 16:17:32+08:00,['8aa46f281e547a7445f43eb689e28d2f5e1e0ceb'],1,7,8,14541226,1,0,1,0,9895
4f7da438adf63474741ae868f1843020e54ef06d,1,shaofengshi,2016-02-05 16:40:07+08:00,['ba3ccf82d2f9411747cd9e2fb57b540a09a005d6'],14,22,36,14541262,1,0,1,0,9895
8eb9c5b9e23c7fdae160810f07bcc3646cce6f45,1,Li Yang,2016-02-09 09:11:56+08:00,['4f7da438adf63474741ae868f1843020e54ef06d'],56,636,692,14541954,38,,,,9895
82cb5ce1937bd52d587f8f0628d0d47ad317725b,1,Li Yang,2016-02-14 15:28:38+08:00,['8eb9c5b9e23c7fdae160810f07bcc3646cce6f45'],0,92,92,14542046,2,0.066666667,0.933333333,1,9896
5c1d0894791d5317a3c469a239aad5234c189629,1,Li Yang,2016-02-14 15:28:44+08:00,['82cb5ce1937bd52d587f8f0628d0d47ad317725b'],18,315,333,14542379,2,0.699115044,0.699115044,0.942477876,9896
3a9de806e725ece8727c248394f2d2ee3d3d52c1,0,Li Yang,2016-02-14 15:28:48+08:00,['5c1d0894791d5317a3c469a239aad5234c189629'],63,0,63,14542442,1,0.85,0,0,9896
2d4c5097d37982ca84ff9b9d641fa39c056f1d74,1,Li Yang,2016-02-14 15:59:46+08:00,['3a9de806e725ece8727c248394f2d2ee3d3d52c1'],50,46,96,14542538,6,1,0,0,9896
023866b0cc57632a8a90259a0c0073966875fdd3,0,Zhong Jian,2016-02-16 11:24:55+08:00,['2d4c5097d37982ca84ff9b9d641fa39c056f1d74'],3,8,11,14542549,1,0,0,1,9896
5c3bfb2185869450a16f1c7a9e97c5912f9e761e,0,Li Yang,2016-02-17 11:14:42+08:00,['023866b0cc57632a8a90259a0c0073966875fdd3'],2,49,51,14542600,2,0,1,1,9897
05571a284396cbf0cec2aa9fa5e08a0bd8303b0a,1,Zhong Jian,2016-02-17 16:11:45+08:00,['5c3bfb2185869450a16f1c7a9e97c5912f9e761e'],4,16,20,14542620,2,0,0,1,9897
c47e086c04ea265b7162a302f377a44bbd79a706,0,honma,2016-02-17 18:58:27+08:00,['05571a284396cbf0cec2aa9fa5e08a0bd8303b0a'],1,1,2,14542622,1,,,,9897
af684000e77de727434f31d6fa25899cd1638ab1,1,Zhong Jian,2016-02-17 19:16:02+08:00,['c47e086c04ea265b7162a302f377a44bbd79a706'],2,8,10,14542632,2,0.833333333,1,0.833333333,9897
8f166b93304fefeec7fc686d70eaa2efa18d1aa7,0,Zhong Jian,2016-02-18 14:42:04+08:00,['af684000e77de727434f31d6fa25899cd1638ab1'],6,23,29,14542661,1,,,,9897
3cfc45eb7c72b015bdc65721f8ecfebe6e44e216,0,Zhong Jian,2016-02-19 10:21:42+08:00,['8f166b93304fefeec7fc686d70eaa2efa18d1aa7'],3,3,6,14542667,1,,,,9897
cfe7bc0999d0c95d4e7f7db2a64f792da612c267,0,shaofengshi,2016-02-19 16:17:27+08:00,['3cfc45eb7c72b015bdc65721f8ecfebe6e44e216'],2,100,102,14542769,2,0,1,1,9898
5e8058052511a03563f9e658df839236683086d0,0,shaofengshi,2016-02-19 16:24:42+08:00,['cfe7bc0999d0c95d4e7f7db2a64f792da612c267'],3,9,12,14542781,2,0,1,1,9898
4d816857fd1bad0ad153d7f22087646492eb9d56,0,Zhong Jian,2016-02-19 18:31:46+08:00,['5e8058052511a03563f9e658df839236683086d0'],4,22,26,14542807,5,1,1,0,9898
33156ec51631855d6f08fcf7c245fedf813752d3,0,Zhong Jian,2016-02-19 18:57:04+08:00,['4d816857fd1bad0ad153d7f22087646492eb9d56'],15,3,18,14542825,2,0,0,1,9898
39326f8071935605b75bcc6092e3437e91aa4ba3,0,Zhong Jian,2016-02-19 19:01:00+08:00,['33156ec51631855d6f08fcf7c245fedf813752d3'],2,1,3,14542828,1,1,0,1,9898
b51314dcb0d16b41e490d2a1d9c97d46b33c2832,1,Zhong Jian,2016-02-22 16:45:06+08:00,['39326f8071935605b75bcc6092e3437e91aa4ba3'],20,3,23,14542851,1,,,,9898
cba1519dec63b315b9cbdff4e0760aaf88183608,1,Li Yang,2016-02-23 11:31:54+08:00,['b51314dcb0d16b41e490d2a1d9c97d46b33c2832'],14,130,144,14542995,3,1,1,0.909090909,9899
ff48e3704bdfff274b0ad25249749183cb87e1a6,0,Li Yang,2016-02-23 11:47:19+08:00,['cba1519dec63b315b9cbdff4e0760aaf88183608'],0,5,5,14543000,1,,,,9899
e78f4906f906f633da2005836ec6fa5c8e52490f,0,Zhong Jian,2016-02-23 14:48:52+08:00,['ff48e3704bdfff274b0ad25249749183cb87e1a6'],7,7,14,14543014,3,,,,9899
e5300645747d0d3decb261e7ee5fd1c0519b775b,0,Zhong Jian,2016-02-23 15:41:36+08:00,['e78f4906f906f633da2005836ec6fa5c8e52490f'],2,2,4,14543018,2,,,,9899
f2883eba94d7abc9e05e18086fae98e8f141a128,0,honma,2016-02-23 18:26:34+08:00,['e5300645747d0d3decb261e7ee5fd1c0519b775b'],2,8,10,14543028,2,1,1,1,9899
d003f1b2b396a127692f6a4c0ea8bdf6ac0b4d1a,0,honma,2016-02-23 18:26:35+08:00,['f2883eba94d7abc9e05e18086fae98e8f141a128'],2,1,3,14543031,1,1,1,1,9899
94ed632fe0a628f79df5e20dee7eba292031e183,1,honma,2016-02-23 18:26:35+08:00,['d003f1b2b396a127692f6a4c0ea8bdf6ac0b4d1a'],32,32,64,14543095,4,0,0,0.5,9899
799805e160e1047bcf5a6c68d026c2e60dfe8470,1,honma,2016-02-23 18:26:35+08:00,['94ed632fe0a628f79df5e20dee7eba292031e183'],124,209,333,14543428,8,1,1,0.4,9900
469bfe89c7222574c196e713f21f3a84da6ff56d,0,Zhong Jian,2016-02-23 19:13:39+08:00,['799805e160e1047bcf5a6c68d026c2e60dfe8470'],8,10,18,14543446,1,0,0,1,9900
80bb61e241002953f67bcb296fc828800776ef25,1,Zhong Jian,2016-02-23 20:02:36+08:00,['469bfe89c7222574c196e713f21f3a84da6ff56d'],23,58,81,14543527,1,0.115384615,0.153846154,1,9900
f5774128ed587cf4ac8deb3614746cb4b8ced547,1,Zhong Jian,2016-02-24 11:43:34+08:00,['80bb61e241002953f67bcb296fc828800776ef25'],2,1,3,14543530,1,1,1,0,9900
bd878d3084fcbcbf063b5f80f4f9a00a61aeedf8,0,Zhong Jian,2016-02-24 17:14:11+08:00,['f5774128ed587cf4ac8deb3614746cb4b8ced547'],63,70,133,14543663,3,0.142857143,1,0.571428571,9900
9328a015d07ab5e6c69fb3449e1e4b0baf19fb13,0,Zhong Jian,2016-02-24 17:52:44+08:00,['bd878d3084fcbcbf063b5f80f4f9a00a61aeedf8'],1,1,2,14543665,1,,,,9900
b442707ff3129f4a29d4c64104c2bcbf8bf33ec1,0,shaofengshi,2016-02-25 11:24:00+08:00,['9328a015d07ab5e6c69fb3449e1e4b0baf19fb13'],7,27,34,14543699,1,0,1,1,9900
82fcc4bf4cd8a2f75c2019abdb72d6e3a05d5c78,0,Zhong Jian,2016-02-25 14:31:02+08:00,['b442707ff3129f4a29d4c64104c2bcbf8bf33ec1'],2,1,3,14543702,1,0,0,0,9900
c7b06a216a0abc3a9b89f33ddaa589e1fec07e35,0,Zhong Jian,2016-02-25 15:57:15+08:00,['82fcc4bf4cd8a2f75c2019abdb72d6e3a05d5c78'],4,1,5,14543707,1,,,,9900
07fca12e020adfc034112948679fa322247053a9,0,Zhong Jian,2016-02-25 16:28:03+08:00,['c7b06a216a0abc3a9b89f33ddaa589e1fec07e35'],2,0,2,14543709,1,,,,9900
c8cab44c16ef51ab4e3962115798f0a97a59144f,1,Zhong Jian,2016-02-25 17:52:40+08:00,['07fca12e020adfc034112948679fa322247053a9'],1,1,2,14543711,1,,,,9900
566af684d9c6b490d8620fdf9e37367de3483c26,0,Zhong Jian,2016-02-25 18:14:15+08:00,['c8cab44c16ef51ab4e3962115798f0a97a59144f'],116,179,295,14544006,1,,,,9900
63aefcc417c9f580e6bf721ca82537c2a944a10b,0,Zhong Jian,2016-02-26 13:19:51+08:00,['566af684d9c6b490d8620fdf9e37367de3483c26'],2,6,8,14544014,2,0,0,1,9900
b6a017fd0c38b67a510c19f1a3ed1342b05399d7,0,Zhong Jian,2016-02-26 14:39:31+08:00,['63aefcc417c9f580e6bf721ca82537c2a944a10b'],14,16,30,14544044,2,0,0,1,9900
31cd12571c029d3cafa4d22246e2dcbfa4ff075c,1,shaofengshi,2016-02-26 16:18:50+08:00,['b6a017fd0c38b67a510c19f1a3ed1342b05399d7'],5,259,264,14544308,12,0.792349727,0.792349727,0.994535519,9901
6583f36440f9435d7ff50d982ef1595f9cc1f3be,0,honma,2016-02-26 17:54:37+08:00,['31cd12571c029d3cafa4d22246e2dcbfa4ff075c'],168,94,262,14544570,5,0.375,0,1,9901
5095552d831907695503907eadb9faa4d3ce47fe,1,honma,2016-02-26 17:54:37+08:00,['6583f36440f9435d7ff50d982ef1595f9cc1f3be'],37,21,58,14544628,14,0,0,0,9901
3cecf0b7a89e1064aec503fde3b76ddc2e80cf40,0,honma,2016-02-26 17:54:37+08:00,['5095552d831907695503907eadb9faa4d3ce47fe'],95,93,188,14544816,9,1,1,1,9901
a40e8b6bd51c3afdaecbc24ed9f7423ff3ab1b5b,1,honma,2016-02-26 17:54:37+08:00,['3cecf0b7a89e1064aec503fde3b76ddc2e80cf40'],110,147,257,14545073,18,0,1,0,9901
5d9112459cd84a9f457310f6cf99791d65dd9904,0,shaofengshi,2016-02-27 23:18:28+08:00,['a40e8b6bd51c3afdaecbc24ed9f7423ff3ab1b5b'],1,3,4,14545077,1,1,1,1,9901
d28be81d3b332b5e1cab51cdb22ca3381182fed1,1,sunyerui,2016-02-28 21:12:28+08:00,['5d9112459cd84a9f457310f6cf99791d65dd9904'],20,170,190,14545267,15,0.042105263,0.484210526,0.968421053,9901
c59a64211bbc9f2ebfd49b6e0f96cd213d0a6a1f,0,sunyerui,2016-02-28 21:36:17+08:00,['d28be81d3b332b5e1cab51cdb22ca3381182fed1'],2,1,3,14545270,1,,,,9901
56846b8c1453b520bc1e161375261b2981d2f250,0,sunyerui,2016-02-29 12:12:15+08:00,['c59a64211bbc9f2ebfd49b6e0f96cd213d0a6a1f'],2,2,4,14545274,2,,,,9901
6cc9951926aedfd1db4484a4539145a309fbb5e1,1,lidongsjtu,2016-02-29 19:26:56+08:00,['56846b8c1453b520bc1e161375261b2981d2f250'],40,351,391,14545665,10,0.466165414,0.443609023,1,9904
6fc5da2c1d613d1d635c1aa8fded8336f599fda7,0,lidongsjtu,2016-02-29 19:27:13+08:00,['6cc9951926aedfd1db4484a4539145a309fbb5e1'],3,21,24,14545689,1,,,,9904
adf4c18f6475fdf899818f642663d0db8f8fa14b,0,Hongbin Ma,2016-03-01 09:51:12+08:00,['6fc5da2c1d613d1d635c1aa8fded8336f599fda7'],1,1,2,14545691,1,,,,9904
98c610f34b5859a2d3752084d0ed8af458203673,0,Hongbin Ma,2016-03-01 13:38:02+08:00,['adf4c18f6475fdf899818f642663d0db8f8fa14b'],0,202,202,14545893,2,0.426229508,0.991803279,0.959016393,9905
b00cf0ccf0ad169680ed5f6bb1a4ca8918737a51,0,Hongbin Ma,2016-03-01 18:41:33+08:00,['98c610f34b5859a2d3752084d0ed8af458203673'],1,13,14,14545907,1,1,1,1,9905
273b30bdd5cd56e31785a89747eadb2a35a76e92,0,lidongsjtu,2016-03-01 19:13:24+08:00,['b00cf0ccf0ad169680ed5f6bb1a4ca8918737a51'],2,2,4,14545911,2,,,,9905
6456d239ebf1ec5fa92cc3a2256684ec9049deff,1,Jason,2016-03-02 15:18:55+08:00,['273b30bdd5cd56e31785a89747eadb2a35a76e92'],8,1509,1517,14547428,14,0.519848771,0.68241966,0.882797732,9907
a3e93d5f15a2f64ddaf62171ae6d995bc0361ccd,1,shaofengshi,2016-03-02 17:12:10+08:00,['6456d239ebf1ec5fa92cc3a2256684ec9049deff'],1,6,7,14547435,1,0,0,0,9907
1d2d64f579af8b283789d9938471ba0ef45794f6,0,lidongsjtu,2016-03-02 17:34:59+08:00,['a3e93d5f15a2f64ddaf62171ae6d995bc0361ccd'],864,0,864,14548299,1,,,,9907
61a3b992b52f8ce74cc19c85953ccd6462d6e494,0,Jason,2016-03-02 17:51:36+08:00,['1d2d64f579af8b283789d9938471ba0ef45794f6'],1,11,12,14548311,3,1,1,1,9907
3890c2cd96f7bf724ca86028e47a78f7b0b0d39d,0,Jason,2016-03-02 17:55:46+08:00,['61a3b992b52f8ce74cc19c85953ccd6462d6e494'],1,1,2,14548313,1,,,,9907
c746e944e7492aed0ef8b3ef91ea74085aae89e3,0,Hongbin Ma,2016-03-03 11:09:26+08:00,['3890c2cd96f7bf724ca86028e47a78f7b0b0d39d'],41,39,80,14548393,3,0,0,0.090909091,9907
6f6386d174c794301de744518f47d6fa10ed2205,0,Jason,2016-03-03 14:25:32+08:00,['c746e944e7492aed0ef8b3ef91ea74085aae89e3'],4,5,9,14548402,5,,,,9907
13a710dc77f04a0450af6a5a1595cbe6e70aed30,0,lidongsjtu,2016-03-03 23:26:55+08:00,['6f6386d174c794301de744518f47d6fa10ed2205'],1,1,2,14548404,1,,,,9907
f6c9058b519b8feb07c48bb2cb3c858791246c42,0,Jason,2016-03-04 10:58:24+08:00,['13a710dc77f04a0450af6a5a1595cbe6e70aed30'],1,1,2,14548406,1,,,,9907
39aba19620a668fd270cfa4730fb54cf3243d4d9,1,lidongsjtu,2016-03-04 14:02:28+08:00,['f6c9058b519b8feb07c48bb2cb3c858791246c42'],2,22,24,14548430,2,0,0,1,9907
d0df1f29b8c840f78f2400a19fbf184a47ab675e,1,Hongbin Ma,2016-03-04 16:01:04+08:00,['39aba19620a668fd270cfa4730fb54cf3243d4d9'],70,41,111,14548541,12,1,,1,9907
e805d7677f0532112fac0cebe731a5f9603338e6,0,Hongbin Ma,2016-03-04 16:01:04+08:00,['d0df1f29b8c840f78f2400a19fbf184a47ab675e'],9,44,53,14548594,4,0,1,1,9908
bc7c5e49082d471087aca962fdae0b0d7381263c,0,Jason,2016-03-04 17:59:12+08:00,['e805d7677f0532112fac0cebe731a5f9603338e6'],1,1,2,14548596,1,,,,9908
04d2f86bf05da7a98464b5823fed8ec3b37d73f6,0,Li Yang,2016-03-05 08:05:37+08:00,['bc7c5e49082d471087aca962fdae0b0d7381263c'],1,0,1,14548597,1,,,,9908
e87bb19fa2c88bc87ad61b60fb94b9fee241a0a6,0,Hongbin Ma,2016-03-08 10:31:12+08:00,['04d2f86bf05da7a98464b5823fed8ec3b37d73f6'],0,27,27,14548624,2,0,0,1,9908
af4fbf7a619cf87574e88e62aee9b0e283398cfc,1,shaofengshi,2016-03-08 12:13:16+08:00,['e87bb19fa2c88bc87ad61b60fb94b9fee241a0a6'],19,50,69,14548693,4,0,0,1,9908
918456b74fa65311aab6633edd41ed065f5bb400,1,shaofengshi,2016-03-08 12:14:18+08:00,['af4fbf7a619cf87574e88e62aee9b0e283398cfc'],2,2,4,14548697,1,,,,9908
43fd53da638bf0d4e3bf887544ae6adea81a6e49,0,shaofengshi,2016-03-08 12:15:11+08:00,['918456b74fa65311aab6633edd41ed065f5bb400'],18,11,29,14548726,2,0,0,0.666666667,9908
a88d7b3b16ce7a63ddec87917c2d7ab2103efcd7,1,shaofengshi,2016-03-08 12:19:36+08:00,['43fd53da638bf0d4e3bf887544ae6adea81a6e49'],80,254,334,14549060,11,0.567567568,0.621621622,0.918918919,9911
7cf5ff1c9627108307f5a2dd7237e84312442099,0,shaofengshi,2016-03-08 12:19:54+08:00,['a88d7b3b16ce7a63ddec87917c2d7ab2103efcd7'],22,26,48,14549108,1,1,1,1,9911
32ce381c2a616a73b12bb830f64f1d359ecce7c5,0,shaofengshi,2016-03-08 12:20:05+08:00,['7cf5ff1c9627108307f5a2dd7237e84312442099'],0,1,1,14549109,1,1,1,1,9911
e6fba94f2bf0ef99fc3708e420571185b4bad462,0,shaofengshi,2016-03-08 12:21:40+08:00,['32ce381c2a616a73b12bb830f64f1d359ecce7c5'],6,4,10,14549119,1,0,0,1,9911
b0b4224afcf2983fd870c304583fd4cdd1e9e7bf,0,shaofengshi,2016-03-08 12:21:56+08:00,['e6fba94f2bf0ef99fc3708e420571185b4bad462'],0,1,1,14549120,1,1,1,1,9911
359a0d0ff29a0af6e4d05bc461e3ac9195b16155,1,shaofengshi,2016-03-08 15:07:04+08:00,['b0b4224afcf2983fd870c304583fd4cdd1e9e7bf'],436,143,579,14549699,24,1,1,0,9912
4b54cc3a37c49aecea59732cd16e00585ab46e96,1,Li Yang,2016-03-08 15:54:05+08:00,['359a0d0ff29a0af6e4d05bc461e3ac9195b16155'],5091,4716,9807,14559506,26,0,0,0,9913
455bbc8093072d3c4b9a1f7a11a77a5bf9e567f3,1,lidongsjtu,2016-03-09 16:16:37+08:00,['4b54cc3a37c49aecea59732cd16e00585ab46e96'],2,2,4,14559510,1,,,,9913
cafddd37b85dd94c4eda1319637e464ae0e0409f,0,Hongbin Ma,2016-03-10 09:27:10+08:00,['455bbc8093072d3c4b9a1f7a11a77a5bf9e567f3'],1,6,7,14559517,1,1,1,1,9913
a31bc60e997f5df1ff65f451f239ec3bcdd625c6,0,Hongbin Ma,2016-03-10 14:21:57+08:00,['cafddd37b85dd94c4eda1319637e464ae0e0409f'],21,25,46,14559563,2,0.75,0.75,1,9913
0ba5881aac2dca22db02a0aafbf59e8ad3542cd7,0,Li Yang,2016-03-10 15:42:41+08:00,"['a31bc60e997f5df1ff65f451f239ec3bcdd625c6', '68fcfd2448ec3db5fc21645c099bce7b2c35540b']",0,0,0,14559563,0,,,,9913
441d6c64a78f82515434616629be5daa02148ec9,0,lidongsjtu,2016-03-10 18:58:37+08:00,['0ba5881aac2dca22db02a0aafbf59e8ad3542cd7'],3,12,15,14559578,1,0,0,1,9913
690d4420215955b544bdb294bdc66b5fefd2cc6d,0,Hongbin Ma,2016-03-10 19:47:02+08:00,['441d6c64a78f82515434616629be5daa02148ec9'],5,650,655,14560233,10,1,1,0,9922
0543dc950b42a49a00d2d72e8124dfa27806f1ed,0,Hongbin Ma,2016-03-10 19:47:02+08:00,['690d4420215955b544bdb294bdc66b5fefd2cc6d'],1,42,43,14560276,3,0.225806452,0.225806452,1,9922
12d54584b26b8ebae199e363f0508c07bfcdac57,0,Hongbin Ma,2016-03-10 20:00:45+08:00,['0543dc950b42a49a00d2d72e8124dfa27806f1ed'],72,66,138,14560414,66,,,,9922
2cad64598276bbe92f529c2d9b4e5876da18877a,1,Jason,2016-03-11 10:58:35+08:00,['12d54584b26b8ebae199e363f0508c07bfcdac57'],227,242,469,14560883,12,1,1,0,9923
bc211ff642f284813188ac1037c296581786769f,1,Jason,2016-03-11 10:58:35+08:00,['2cad64598276bbe92f529c2d9b4e5876da18877a'],196,343,539,14561422,17,0,0,1,9923
3e1557431b90e754e9a31372b85adf1e510af267,0,Hongbin Ma,2016-03-11 12:12:26+08:00,['bc211ff642f284813188ac1037c296581786769f'],0,12,12,14561434,2,,,,9923
674e3c07fade5071e748fec39d162a4aca815d3e,0,lidongsjtu,2016-03-11 12:45:44+08:00,['3e1557431b90e754e9a31372b85adf1e510af267'],3,1,4,14561438,1,,,,9923
9a7919e3e6fb5390305d601e5d8920a4910911bf,0,Li Yang,2016-03-11 13:49:22+08:00,['674e3c07fade5071e748fec39d162a4aca815d3e'],23,41,64,14561502,1,1,1,0.230769231,9923
2a5e3f3c4609b23fdb2ab8189f8d2368f1794acd,1,Hongbin Ma,2016-03-11 15:00:35+08:00,['9a7919e3e6fb5390305d601e5d8920a4910911bf'],670,483,1153,14562655,43,0.452941176,0.005882353,0.270588235,9924
6975dbcea6edbe934ae76ddf7e23a3698481edc2,1,Li Yang,2016-03-11 15:04:19+08:00,['2a5e3f3c4609b23fdb2ab8189f8d2368f1794acd'],15,31,46,14562701,3,0.227272727,1,1,9924
1e80997a7710406721adb610d0fab8f79831c8b6,0,Li Yang,2016-03-11 15:37:15+08:00,['6975dbcea6edbe934ae76ddf7e23a3698481edc2'],12,118,130,14562831,10,,,,9924
cce7111f773cd781c9671243f1b0a21f9243e6f7,0,Li Yang,2016-03-11 16:04:33+08:00,['1e80997a7710406721adb610d0fab8f79831c8b6'],158,522,680,14563511,30,,,,9924
b222c6098f6243b82459adff2b053066d5f0c293,0,lidongsjtu,2016-03-11 16:20:51+08:00,['cce7111f773cd781c9671243f1b0a21f9243e6f7'],1,1333,1334,14564845,74,,,,9924
46113397406b7fe7f46722635a9f5d863324f028,0,lidongsjtu,2016-03-11 16:26:38+08:00,['b222c6098f6243b82459adff2b053066d5f0c293'],0,414,414,14565259,23,,,,9924
a526a643710671a43dff2ed8a7308ab65bcd340f,0,Li Yang,2016-03-11 16:35:20+08:00,['46113397406b7fe7f46722635a9f5d863324f028'],0,54,54,14565313,3,,,,9924
01a1fb0cb9154f1847efdef27d6e31a7522c74cd,1,Jason,2016-03-11 18:36:00+08:00,['a526a643710671a43dff2ed8a7308ab65bcd340f'],20,103,123,14565436,6,0,0.864864865,0.567567568,9924
5333729b4c7392d71a2a7f3ca4add1023ca69277,0,Li Yang,2016-03-12 09:07:06+08:00,['01a1fb0cb9154f1847efdef27d6e31a7522c74cd'],2,2,4,14565440,1,,,,9924
6685a0ab76936a69de97f6f139030d4410a84aac,0,Li Yang,2016-03-12 11:01:12+08:00,['5333729b4c7392d71a2a7f3ca4add1023ca69277'],7,11,18,14565458,3,1,0,1,9924
6d3b0e1d10e8af9128966b5e0784efcc84258b60,0,lidongsjtu,2016-03-13 16:15:02+08:00,['6685a0ab76936a69de97f6f139030d4410a84aac'],28,28,56,14565514,4,,,,9924
f2aa50ecb28a606bdd25ea322443447c76c858a8,1,Li Yang,2016-03-14 16:42:33+08:00,['6d3b0e1d10e8af9128966b5e0784efcc84258b60'],624,772,1396,14566910,91,1,1,1,9928
8bf370c3aae2c802601963c13ee585686c9fa3c3,1,Jason,2016-03-14 16:47:23+08:00,['f2aa50ecb28a606bdd25ea322443447c76c858a8'],18,54,72,14566982,3,0.148148148,0.925925926,0.62962963,9928
e345de5517963e42669ce35e8774dd698e8f20f0,1,lidongsjtu,2016-03-14 18:59:01+08:00,['8bf370c3aae2c802601963c13ee585686c9fa3c3'],5,25,30,14567012,3,0.933333333,1,1,9928
4933033ab3755cfe04a06068aaf3e94fed7243a0,0,lidongsjtu,2016-03-14 19:41:45+08:00,['e345de5517963e42669ce35e8774dd698e8f20f0'],1,1,2,14567014,1,,,,9928
9e093b743d4da3cb2ddad29b1630341628b1c6a0,0,Li Yang,2016-03-15 18:03:20+08:00,['4933033ab3755cfe04a06068aaf3e94fed7243a0'],35,28,63,14567077,2,1,1,1,9928
732fda18fc7656eb7af138f6ba721e7c6c8c00e9,0,Li Yang,2016-03-15 18:20:29+08:00,['9e093b743d4da3cb2ddad29b1630341628b1c6a0'],5,6,11,14567088,1,1,1,1,9928
ca2504820a0c8758bc3508126a358d655a8dfbdf,1,Li Yang,2016-03-15 18:47:23+08:00,['732fda18fc7656eb7af138f6ba721e7c6c8c00e9'],7,20,27,14567115,2,1,1,1,9928
31fad2e705a0a2aabbf1e035a4bb894b3d622d74,0,Jason,2016-03-15 21:44:40+08:00,['ca2504820a0c8758bc3508126a358d655a8dfbdf'],10,14,24,14567139,2,,,,9928
61bc3e0543ae07848d5d814ac9af479489b31920,1,Li Yang,2016-03-16 17:22:34+08:00,['31fad2e705a0a2aabbf1e035a4bb894b3d622d74'],13,18,31,14567170,3,1,1,1,9928
41292a18ff4ee941dfa62ee74ac9201a7a450eac,1,lidongsjtu,2016-03-16 21:08:29+08:00,['61bc3e0543ae07848d5d814ac9af479489b31920'],7,94,101,14567271,4,0.19047619,1,1,9930
6992c7e626b0cd49442391635be12c93c1be2852,1,Hongbin Ma,2016-03-16 23:42:01+08:00,['41292a18ff4ee941dfa62ee74ac9201a7a450eac'],341,872,1213,14568484,30,0.572649573,0.606837607,0.752136752,9936
213fdcf27eba374006cb0d66a51c1260cde92c84,1,Hongbin Ma,2016-03-16 23:42:17+08:00,['6992c7e626b0cd49442391635be12c93c1be2852'],22,22,44,14568528,22,,,,9936
868ec25a9c06bca1018bcd5b793fd21ef3c62c1e,1,Hongbin Ma,2016-03-16 23:42:24+08:00,['213fdcf27eba374006cb0d66a51c1260cde92c84'],34,102,136,14568664,9,0.380952381,1,1,9936
4a12973498388cc348f279200b1a136f6b706f83,1,Hongbin Ma,2016-03-16 23:42:24+08:00,['868ec25a9c06bca1018bcd5b793fd21ef3c62c1e'],56,63,119,14568783,5,1,1,1,9936
d7aa5db7f0390ee32f832d0afe4653af159a1fae,0,Hongbin Ma,2016-03-17 10:10:02+08:00,['4a12973498388cc348f279200b1a136f6b706f83'],33,46,79,14568862,3,1,1,1,9936
8ab8a25b40dc26f80bfdb96d52c51036b2010c94,1,Hongbin Ma,2016-03-17 16:20:05+08:00,['d7aa5db7f0390ee32f832d0afe4653af159a1fae'],58,33,91,14568953,6,0,0,1,9936
a1fbd63449cf4772d146ef1b879d3f21bbf9d4b0,0,Li Yang,2016-03-17 18:51:19+08:00,['8ab8a25b40dc26f80bfdb96d52c51036b2010c94'],87,114,201,14569154,3,0,0,0.6875,9936
a99c4ee75c084ed68bd41a3e4c1e92934a59aa86,0,Hongbin Ma,2016-03-18 09:41:11+08:00,['a1fbd63449cf4772d146ef1b879d3f21bbf9d4b0'],2,1,3,14569157,2,,,,9936
3defd5d15909ff2af57f96141aeebf9f91bf0fbf,0,Jason,2016-03-18 11:42:54+08:00,['a99c4ee75c084ed68bd41a3e4c1e92934a59aa86'],2,4,6,14569163,2,1,1,1,9936
e4f17cc2857a50a65ace84e252e760f4bd0cbaf9,1,Li Yang,2016-03-20 15:16:49+08:00,['3defd5d15909ff2af57f96141aeebf9f91bf0fbf'],117,79,196,14569359,13,1,1,0,9936
9aa45fa432c9ed50c69a4e0319e6e9583e5210f8,0,Li Yang,2016-03-20 15:50:26+08:00,['e4f17cc2857a50a65ace84e252e760f4bd0cbaf9'],19,17,36,14569395,2,1,0,1,9936
c87cec3793b9803e855ec8c2b6eadc9409cdc0e1,1,Li Yang,2016-03-20 18:41:48+08:00,['9aa45fa432c9ed50c69a4e0319e6e9583e5210f8'],418,323,741,14570136,10,0.612903226,0,0,9937
5aff506bc4666a2bde236544aba4e313e66b286a,0,Li Yang,2016-03-20 20:13:08+08:00,['c87cec3793b9803e855ec8c2b6eadc9409cdc0e1'],33,35,68,14570204,1,,,,9937
7525a4863012822fac63f79058f41ad29329c323,1,wangxiaoyu,2016-03-20 20:31:58+08:00,['5aff506bc4666a2bde236544aba4e313e66b286a'],13,848,861,14571065,22,0.510028653,1,0.848137536,9948
91ec86f3abecd0a3772e2335971b4f3ab7fa6af1,1,shaofengshi,2016-03-21 17:34:51+08:00,['7525a4863012822fac63f79058f41ad29329c323'],11,11,22,14571087,2,,,,9948
3d98f68438b7edc83302875e9a362486089ff6dd,0,lidongsjtu,2016-03-22 10:06:41+08:00,['91ec86f3abecd0a3772e2335971b4f3ab7fa6af1'],2,8,10,14571097,1,,,,9948
410af0cb3bebc2b2c6ca47a1c40116009badd817,0,Li Yang,2016-03-22 10:26:40+08:00,['3d98f68438b7edc83302875e9a362486089ff6dd'],153,204,357,14571454,9,1,0.65625,0.78125,9948
5b456684569f3d20831499f4cfbeee967c867292,0,lidongsjtu,2016-03-22 15:03:11+08:00,['410af0cb3bebc2b2c6ca47a1c40116009badd817'],0,49,49,14571503,1,1,1,1,9949
e77bc2348c712499cb433c6ec53fe6de08b4606b,0,Li Yang,2016-03-22 15:16:31+08:00,['5b456684569f3d20831499f4cfbeee967c867292'],0,79,79,14571582,1,1,1,1,9950
940a8e4d48e80deb11ad336fe2b31c83afea2822,1,lidongsjtu,2016-03-22 15:30:41+08:00,['e77bc2348c712499cb433c6ec53fe6de08b4606b'],2,2,4,14571586,1,,,,9950
b826ebc9acb84275d9ca354c33676578ad4a0aa9,0,Li Yang,2016-03-22 15:42:12+08:00,['940a8e4d48e80deb11ad336fe2b31c83afea2822'],1,1,2,14571588,1,,,,9950
16c265795d5367a821a2b4b5cddea1fbe32f3036,0,Jason,2016-03-22 16:00:11+08:00,['b826ebc9acb84275d9ca354c33676578ad4a0aa9'],2,1,3,14571591,1,,,,9950
d723b8f05b87459410c36d16f4e19eaef0126909,1,lidongsjtu,2016-03-22 16:04:30+08:00,['16c265795d5367a821a2b4b5cddea1fbe32f3036'],3,28,31,14571622,3,1,1,1,9950
cd97dcabba2a96beb25d0c758107a2c580cfdafe,0,lidongsjtu,2016-03-23 13:34:50+08:00,['d723b8f05b87459410c36d16f4e19eaef0126909'],5,0,5,14571627,1,,,,9950
9b9cfe8f77c553147b0c76bfe2fecaed92260649,0,Li Yang,2016-03-23 16:53:24+08:00,['cd97dcabba2a96beb25d0c758107a2c580cfdafe'],1,2,3,14571630,1,0,1,1,9950
6d61055ffeb38f77c58e203dceeec58560550742,1,shaofengshi,2016-03-23 19:53:13+08:00,['9b9cfe8f77c553147b0c76bfe2fecaed92260649'],2,3,5,14571635,1,0,1,0,9950
870322003393485cbec5c46a423513cb7a282f62,1,lidongsjtu,2016-03-24 11:52:21+08:00,['6d61055ffeb38f77c58e203dceeec58560550742'],0,2,2,14571637,1,,,,9950
1a13952eadaee154bfb1920653bf741d12c1001a,0,Hongbin Ma,2016-03-24 14:45:02+08:00,['870322003393485cbec5c46a423513cb7a282f62'],1189,66,1255,14572892,23,0.533755274,0.156118143,0.223628692,9950
dfab0c14cf77c0c77687d66858e68500ae3776ab,0,Hongbin Ma,2016-03-24 14:45:02+08:00,['1a13952eadaee154bfb1920653bf741d12c1001a'],132,181,313,14573205,5,0.285714286,1,1,9950
4adea1677504e6dccdd7775d93df4625964f62e5,1,Hongbin Ma,2016-03-24 14:45:02+08:00,['dfab0c14cf77c0c77687d66858e68500ae3776ab'],289,1343,1632,14574837,46,0.52994012,0.865269461,0.820359281,9968
d2476f3010ea9ff6190c64c10f16c209b694c498,0,Hongbin Ma,2016-03-24 16:51:31+08:00,['4adea1677504e6dccdd7775d93df4625964f62e5'],18,27,45,14574882,3,,,,9968
1411f8906944f8714289638abf741975d1f1e7d7,0,lidongsjtu,2016-03-24 17:58:32+08:00,['d2476f3010ea9ff6190c64c10f16c209b694c498'],0,271,271,14575153,5,0.101265823,0.379746835,1,9973
db932df6052657e492b2f08ff7245f4135189321,0,lidongsjtu,2016-03-24 17:58:32+08:00,['1411f8906944f8714289638abf741975d1f1e7d7'],2,2,4,14575157,2,,,,9973
ea5df54711424c00209034b4266617dc13ff35e6,0,Li Yang,2016-03-24 18:02:44+08:00,['db932df6052657e492b2f08ff7245f4135189321'],20,36,56,14575213,2,0,1,1,9973
068694191855e0901874b517814b4585f3e94c6b,1,Jason,2016-03-26 01:53:10+08:00,['ea5df54711424c00209034b4266617dc13ff35e6'],6,98,104,14575317,5,1,1,1,9973
3b2ebd243cfe233ea7b1a80285f4c2110500bbe5,0,Jason,2016-03-26 02:07:21+08:00,['068694191855e0901874b517814b4585f3e94c6b'],0,271,271,14575588,3,1,1,1,9976
09da1e19027cffcdd8d676b5caa5d444389c11e3,1,Yang Li,2016-03-26 18:41:33+08:00,['3b2ebd243cfe233ea7b1a80285f4c2110500bbe5'],275,333,608,14576196,4,1,1,1,9977
23c54c17406af3b316276d2ba68ca38897303ae1,0,Yang Li,2016-03-27 09:26:48+08:00,['09da1e19027cffcdd8d676b5caa5d444389c11e3'],1,1,2,14576198,1,,,,9977
aaf494667c1fa0ea3321bf12d8ea055dbfac68e8,0,shaofengshi,2016-03-27 11:17:56+08:00,['23c54c17406af3b316276d2ba68ca38897303ae1'],3,3,6,14576204,2,,,,9977
5fd9485473d134377d62f9e947d38302c9edfba0,0,shaofengshi,2016-03-27 11:20:38+08:00,['aaf494667c1fa0ea3321bf12d8ea055dbfac68e8'],4,5,9,14576213,3,,0,1,9977
e53de30842e6c9f8837ed907a7eb70dbf0cbbe4c,1,Yang Li,2016-03-27 22:12:30+08:00,['5fd9485473d134377d62f9e947d38302c9edfba0'],19,63,82,14576295,2,0,0.291666667,0.958333333,9977
425d56bb5afccd99e666786f755cd4686a1706cc,0,Li Yang,2016-03-28 16:19:35+08:00,['e53de30842e6c9f8837ed907a7eb70dbf0cbbe4c'],2,21,23,14576318,2,1,1,1,9977
2e03c9c38a02635ce245ca8e6fe5157e7f1db618,1,shaofengshi,2016-03-28 17:57:54+08:00,['425d56bb5afccd99e666786f755cd4686a1706cc'],11,190,201,14576519,7,0.45,0.583333333,1,9978
82ae39aa21356390485ba292c790b800d536a329,0,Li Yang,2016-03-28 18:01:06+08:00,['2e03c9c38a02635ce245ca8e6fe5157e7f1db618'],0,172,172,14576691,2,0.987804878,1,0.670731707,9979
7c0c176b07e0098f32007b98b16a1c7948be3664,1,Li Yang,2016-03-28 18:03:30+08:00,['82ae39aa21356390485ba292c790b800d536a329'],0,129,129,14576820,1,0.34939759,1,1,9980
0e7658df006b01cdf9d056c6c13f375498bc17b8,1,Hongbin Ma,2016-03-29 15:03:24+08:00,['7c0c176b07e0098f32007b98b16a1c7948be3664'],14,45,59,14576879,8,0,0.565217391,1,9980
be30f4bef44a3169dfbbd246379c5517fbc866e6,0,Hongbin Ma,2016-03-29 16:58:39+08:00,['0e7658df006b01cdf9d056c6c13f375498bc17b8'],1,2,3,14576882,1,,,,9980
6e2afbb98d7670dc67ca7c6d38a3e199523da3ff,0,Li Yang,2016-03-29 18:35:03+08:00,['be30f4bef44a3169dfbbd246379c5517fbc866e6'],2,2,4,14576886,2,,,,9980
094510cf3aded8021e73de631e614ac735f1497e,0,Li Yang,2016-03-29 18:35:03+08:00,['6e2afbb98d7670dc67ca7c6d38a3e199523da3ff'],12,179,191,14577077,2,0.385964912,0.385964912,0.894736842,9980
9e31a190f49ab707bd74e6e03259b5ff4647bd81,0,lidongsjtu,2016-03-29 20:04:16+08:00,['094510cf3aded8021e73de631e614ac735f1497e'],23,26,49,14577126,1,0,0,1,9980
8de31563cc11f7babdb8c171f64224b63785ab8d,1,lidongsjtu,2016-03-29 20:04:16+08:00,['9e31a190f49ab707bd74e6e03259b5ff4647bd81'],0,294,294,14577420,2,0.622047244,0.748031496,1,9982
9bd421fe92d1c4be780485c482f5cbab66f3c2c2,1,Hongbin Ma,2016-03-30 11:04:47+08:00,['8de31563cc11f7babdb8c171f64224b63785ab8d'],24,22,46,14577466,7,,,,9982
28d90ec07d727f2953c5a19f2d612323786b4970,0,shaofengshi,2016-03-30 11:32:44+08:00,['9bd421fe92d1c4be780485c482f5cbab66f3c2c2'],6,4,10,14577476,3,,,,9982
ca269c99c2e84bfb2eca77821052689acbb9ac64,0,Li Yang,2016-03-30 13:16:47+08:00,['28d90ec07d727f2953c5a19f2d612323786b4970'],5,0,5,14577481,1,1,1,0,9982
f9c825775a06d61d0d168a8afc4bb5eea5becb04,0,Li Yang,2016-03-30 13:57:02+08:00,['ca269c99c2e84bfb2eca77821052689acbb9ac64'],4,2,6,14577487,1,0,0,0,9982
92d2a9c5aade00ef380ed56a87be73681a4027e1,1,lidongsjtu,2016-03-30 14:27:54+08:00,['f9c825775a06d61d0d168a8afc4bb5eea5becb04'],178,277,455,14577942,6,0.327272727,0.036363636,0.763636364,9984
030a16ada0f7284ae3e9dcf4f9a4f26ac6fe83c2,1,Jason,2016-03-30 16:05:00+08:00,['92d2a9c5aade00ef380ed56a87be73681a4027e1'],43,52,95,14578037,6,0,0,0.6875,9984
19ef6c374c03c2e17f9c71af4e2908439f8a0661,1,Li Yang,2016-03-30 16:59:20+08:00,['030a16ada0f7284ae3e9dcf4f9a4f26ac6fe83c2'],59,199,258,14578295,27,0.912280702,0.456140351,0.701754386,9985
cfb3c440c0f86f6987ec6e898f58b7fe5f292b95,0,lidongsjtu,2016-03-30 21:16:22+08:00,['19ef6c374c03c2e17f9c71af4e2908439f8a0661'],13,459,472,14578767,10,0.8,1,0.912820513,9990
c7d4449b8a61dbf7879a9034d4cddb44bf8103da,0,lidongsjtu,2016-03-30 21:59:11+08:00,['cfb3c440c0f86f6987ec6e898f58b7fe5f292b95'],13,19,32,14578799,4,0.75,1,1,9990
10203c1ce4c4d30a6d09756aa121ba2aa5e814f1,0,Hongbin Ma,2016-03-31 11:24:21+08:00,['c7d4449b8a61dbf7879a9034d4cddb44bf8103da'],2,6,8,14578807,2,1,1,1,9990
b121b2722a10d0b16357ce6dba94b39a493eba27,1,Li Yang,2016-03-31 11:52:59+08:00,['10203c1ce4c4d30a6d09756aa121ba2aa5e814f1'],1,28,29,14578836,3,1,1,1,9990
539decfe2ccaf6edb39673ce56e2ea4527c2ee56,1,lidongsjtu,2016-03-31 14:01:06+08:00,['b121b2722a10d0b16357ce6dba94b39a493eba27'],25,37,62,14578898,4,1,1,1,9990
261e4f411f5b2fae64b353bccc9215c2e6dc48e9,0,Hongbin Ma,2016-03-31 14:06:04+08:00,['539decfe2ccaf6edb39673ce56e2ea4527c2ee56'],13,13,26,14578924,3,1,0,0,9990
ee520d6980808dfd589401d638af26cbd52442b3,0,Hongbin Ma,2016-03-31 15:57:44+08:00,['261e4f411f5b2fae64b353bccc9215c2e6dc48e9'],3,5,8,14578932,3,,,,9990
828a71faeb37ff3db485130bbbe871a99a647cef,1,lidongsjtu,2016-03-31 16:22:30+08:00,['ee520d6980808dfd589401d638af26cbd52442b3'],0,128,128,14579060,9,1,1,1,9992
05033cbe4b30510070820ee4130516cdd94b185f,0,Jason,2016-03-31 17:01:28+08:00,['828a71faeb37ff3db485130bbbe871a99a647cef'],3,26,29,14579089,1,0,0,1,9992
099ffdd7a8874fe05ba5b65318e0c779905f4eac,0,shaofengshi,2016-03-31 18:56:01+08:00,['05033cbe4b30510070820ee4130516cdd94b185f'],3,3,6,14579095,1,,,,9992
9abd421b7627413d5e7e2fafe840497326da51d4,0,Hongbin Ma,2016-03-31 19:02:45+08:00,['099ffdd7a8874fe05ba5b65318e0c779905f4eac'],2,33,35,14579130,2,0.666666667,0.666666667,1,9992
51871d8706153bb49e2988529275f5c902d376c5,0,lidongsjtu,2016-03-31 21:17:55+08:00,['9abd421b7627413d5e7e2fafe840497326da51d4'],36,75,111,14579241,8,0,0,0,9992
c693dcfa9b66546c3ce6b9ed3cec20ab5dafc5d5,0,lidongsjtu,2016-04-01 09:59:48+08:00,['51871d8706153bb49e2988529275f5c902d376c5'],2,0,2,14579243,1,1,1,1,9992
220d17b05699ade8a084e3d7c4993451d69c6f8e,0,lidongsjtu,2016-04-01 11:08:02+08:00,['c693dcfa9b66546c3ce6b9ed3cec20ab5dafc5d5'],4,26,30,14579273,2,1,0.75,1,9992
a78cc9428a0f6a6a33ff95a5d8172e8812346b67,0,lidongsjtu,2016-04-01 11:36:49+08:00,['220d17b05699ade8a084e3d7c4993451d69c6f8e'],0,52,52,14579325,1,,,,9992
195f751041b7770f1c45497fe7728d968ebc3ad5,0,lidongsjtu,2016-04-01 13:36:27+08:00,['a78cc9428a0f6a6a33ff95a5d8172e8812346b67'],14,65,79,14579404,3,,,,9992
27f79174eaddc4c9192889e5025378dd4706620f,1,Hongbin Ma,2016-04-01 14:45:57+08:00,['195f751041b7770f1c45497fe7728d968ebc3ad5'],0,10,10,14579414,2,0,0,0,9992
5dd133f6d05b8e8c65c67d557966ebcdd88a6093,0,Hongbin Ma,2016-04-01 14:45:57+08:00,['27f79174eaddc4c9192889e5025378dd4706620f'],8,10,18,14579432,2,1,1,1,9992
9aeb76526f71a43ebfd9394c1eafb46398906208,0,Hongbin Ma,2016-04-01 14:45:57+08:00,['5dd133f6d05b8e8c65c67d557966ebcdd88a6093'],22,25,47,14579479,4,1,1,1,9992
c86de1a8e8e55b5dbd37bee55b3627ff959f9e91,0,Hongbin Ma,2016-04-01 14:48:53+08:00,['9aeb76526f71a43ebfd9394c1eafb46398906208'],2,3,5,14579484,1,,,,9992
0e662a350b88ad4b1194874af19f25590286a52a,1,Hongbin Ma,2016-04-01 15:47:50+08:00,['c86de1a8e8e55b5dbd37bee55b3627ff959f9e91'],47,58,105,14579589,5,0,0,1,9992
34c6ece41bef0f6aecc68450d285bc75d956d226,0,Li Yang,2016-04-01 17:28:19+08:00,['0e662a350b88ad4b1194874af19f25590286a52a'],4,3,7,14579596,2,,,,9992
fc14ef77a41b525ea708b0c415be55bc80dc6417,0,shaofengshi,2016-04-01 17:51:05+08:00,['34c6ece41bef0f6aecc68450d285bc75d956d226'],9,2,11,14579607,1,,,,9992
30aa60d6586292bd875e5a6150249bf9b0d6638a,0,lidongsjtu,2016-04-01 23:28:50+08:00,['fc14ef77a41b525ea708b0c415be55bc80dc6417'],12,87,99,14579706,6,0.649122807,0.701754386,0.912280702,9992
32aab3b9dc9e6af56402014de570c5c288baab89,0,Jason,2016-04-03 22:50:35+08:00,['30aa60d6586292bd875e5a6150249bf9b0d6638a'],3,1,4,14579710,2,,,,9992
6fbdf8704a78fe66a4094a41e1b0f3f8beae04df,0,lidongsjtu,2016-04-04 21:15:00+08:00,['32aab3b9dc9e6af56402014de570c5c288baab89'],2,13,15,14579725,2,,,,9992
6304e9474f441456d2f904fcbd6727cbb13eae66,1,shaofengshi,2016-04-05 11:43:02+08:00,['6fbdf8704a78fe66a4094a41e1b0f3f8beae04df'],12,23,35,14579760,3,0.375,0.375,1,9992
d1b0f9ca95c9bea3d5767cdffce86aaaa0207bc3,0,shaofengshi,2016-04-05 11:45:44+08:00,['6304e9474f441456d2f904fcbd6727cbb13eae66'],0,1,1,14579761,1,0,0,1,9992
77ebbc56b4e2e1914c983a21511b30dd06ed6855,0,lidongsjtu,2016-04-05 14:26:20+08:00,['d1b0f9ca95c9bea3d5767cdffce86aaaa0207bc3'],2,3,5,14579766,1,0,0,0,9992
166e8ea5d49d4f8b3d59bffe1ec86f9e57a3053b,0,lidongsjtu,2016-04-05 16:07:03+08:00,['77ebbc56b4e2e1914c983a21511b30dd06ed6855'],1,1,2,14579768,1,,,,9992
653743f34b3a0fe049ed5b9e48d5ad26114907eb,0,Hongbin Ma,2016-04-05 17:40:59+08:00,['166e8ea5d49d4f8b3d59bffe1ec86f9e57a3053b'],8,20,28,14579796,2,1,1,1,9992
d4e09b630c8acc36f84b750e2b1b4abc676f5137,0,lidongsjtu,2016-04-05 18:21:25+08:00,['653743f34b3a0fe049ed5b9e48d5ad26114907eb'],14,13,27,14579823,6,,,,9992
fb98f6435dc7aa341ffa1d16844b9ffc670b1d90,0,Li Yang,2016-04-05 18:38:18+08:00,['d4e09b630c8acc36f84b750e2b1b4abc676f5137'],3,3,6,14579829,2,,,,9992
6e6f48d928b0546cc9854505d68f07121ed457c6,0,shaofengshi,2016-04-06 09:28:15+08:00,['fb98f6435dc7aa341ffa1d16844b9ffc670b1d90'],0,4,4,14579833,2,0,0,1,9992
9a8153ae7947c155ace24f66e6e64a7bd4fe390b,0,lidongsjtu,2016-04-06 13:10:26+08:00,['6e6f48d928b0546cc9854505d68f07121ed457c6'],0,4,4,14579837,1,0,0,1,9992
be6e2065a853f71a2e898ac9cf3c4144ed6fb8fd,1,shaofengshi,2016-04-06 14:55:55+08:00,['9a8153ae7947c155ace24f66e6e64a7bd4fe390b'],42,50,92,14579929,8,0,,1,9992
b37c5bb293fe2025bf7e7b0c4901d13c02fc86eb,0,shaofengshi,2016-04-06 15:49:29+08:00,['be6e2065a853f71a2e898ac9cf3c4144ed6fb8fd'],5,32,37,14579966,1,0,0.458333333,0,9992
accbb5420bc0fc3a9768a69780f2d02977ab775e,0,lidongsjtu,2016-04-06 17:16:52+08:00,['b37c5bb293fe2025bf7e7b0c4901d13c02fc86eb'],2,2,4,14579970,1,,,,9992
633a1ccff880dfe89bbb1cc0ee170d6c79d60fb2,0,shaofengshi,2016-04-07 09:33:46+08:00,['accbb5420bc0fc3a9768a69780f2d02977ab775e'],2,2,4,14579974,1,,,,9992
e6e29bb7a1ae606f5d4e464d9c7014ab98d1a3c0,0,lidongsjtu,2016-04-07 10:10:36+08:00,['633a1ccff880dfe89bbb1cc0ee170d6c79d60fb2'],23,24,47,14580021,1,0,0,1,9992
c6412c4a751afd8f2077cf277f959fcd988f5fc1,0,shaofengshi,2016-04-07 13:30:39+08:00,['e6e29bb7a1ae606f5d4e464d9c7014ab98d1a3c0'],0,19,19,14580040,2,1,1,1,9992
b43174f092d96602bc6f982fdbccb68630d041a0,0,shaofengshi,2016-04-07 15:33:15+08:00,['c6412c4a751afd8f2077cf277f959fcd988f5fc1'],0,8,8,14580048,1,0,0,1,9992
7e59f81673669c9f9f8dd9e2e2323a7e407bb8e2,0,Li Yang,2016-04-07 16:20:39+08:00,['b43174f092d96602bc6f982fdbccb68630d041a0'],1,1,2,14580050,1,,,,9992
e7d01e0f326e067e1afd060ed0feec02a3a33ec8,0,Li Yang,2016-04-07 18:04:00+08:00,['7e59f81673669c9f9f8dd9e2e2323a7e407bb8e2'],0,1,1,14580051,1,1,1,1,9992
f23e8084f109cb043a5f5b709dd2d02b07667847,0,Jason,2016-04-07 22:31:08+08:00,['e7d01e0f326e067e1afd060ed0feec02a3a33ec8'],0,1,1,14580052,1,1,1,1,9992
d6cfffa3d3fba18bcf4c80a04e68539f7b5dde79,0,Hongbin Ma,2016-04-08 11:27:20+08:00,['f23e8084f109cb043a5f5b709dd2d02b07667847'],3,6,9,14580061,4,1,1,1,9992
8992b56692df4e663604134e9a6734fa69cfad31,0,Jason,2016-04-08 13:29:24+08:00,['d6cfffa3d3fba18bcf4c80a04e68539f7b5dde79'],3,0,3,14580064,1,0,0,0,9992
f6cde56f07786e86c2adf0f791c6a14b12da9870,0,Hongbin Ma,2016-04-08 14:25:27+08:00,['8992b56692df4e663604134e9a6734fa69cfad31'],9,4,13,14580077,1,1,1,0,9992
0b2123b4b9cd9fddf18a63a210166c34ffd1bd26,0,shaofengshi,2016-04-10 08:11:27+08:00,['f6cde56f07786e86c2adf0f791c6a14b12da9870'],4,14,18,14580095,4,0.714285714,1,1,9992
4d16e4d0e03777399de508aaf97fb417a62aca94,0,Hongbin Ma,2016-04-11 17:04:13+08:00,['0b2123b4b9cd9fddf18a63a210166c34ffd1bd26'],4,79,83,14580178,2,0.423076923,0,0.423076923,9993
737ba33b6be4e69ab6533c03e1bb3ba5aeb776a4,0,Hongbin Ma,2016-04-11 18:08:13+08:00,['4d16e4d0e03777399de508aaf97fb417a62aca94'],27,30,57,14580235,1,0,0,0,9993
9f3a4c8c7ce0a673630de17872cb27879e8573c2,0,lidongsjtu,2016-04-13 10:17:41+08:00,['737ba33b6be4e69ab6533c03e1bb3ba5aeb776a4'],60,41,101,14580336,21,,,,9993
16ff672b730951eb12086dcb7ba8fc9934a92e42,0,lidongsjtu,2016-04-13 10:17:41+08:00,['9f3a4c8c7ce0a673630de17872cb27879e8573c2'],22,22,44,14580380,21,,,,9993
8e10852aa4059671d890b3bb3220887dc510c6a9,0,shaofengshi,2016-04-13 11:03:06+08:00,['16ff672b730951eb12086dcb7ba8fc9934a92e42'],5,5,10,14580390,2,1,1,0,9993
ec2845af45bf9c44400bce68ce42dfe21adb850e,1,shaofengshi,2016-04-13 11:03:06+08:00,['8e10852aa4059671d890b3bb3220887dc510c6a9'],10,13,23,14580413,3,0,1,1,9993
aaf3b870c41cf356152e25335ecb089ee1a72223,1,Hongbin Ma,2016-04-13 11:10:14+08:00,['ec2845af45bf9c44400bce68ce42dfe21adb850e'],36,49,85,14580498,9,1,1,1,9993
b26b2489baddcfd148eaf8f17330878bbf349048,1,Hongbin Ma,2016-04-13 11:11:15+08:00,['aaf3b870c41cf356152e25335ecb089ee1a72223'],637,884,1521,14582019,43,0.776119403,0.597014925,0.694029851,9995
11be1e3826cdea8db8df8975ebdff5cf1d93444f,1,Hongbin Ma,2016-04-13 11:11:15+08:00,['b26b2489baddcfd148eaf8f17330878bbf349048'],52,463,515,14582534,5,0.303317536,0.336492891,0.890995261,9995
71d3f303058afa66608440ae3db91e32e921740c,0,Hongbin Ma,2016-04-13 11:11:15+08:00,['11be1e3826cdea8db8df8975ebdff5cf1d93444f'],33,47,80,14582614,4,1,1,1,9995
b2a386126e075ac6cc2d15d0c1a42d720abed06a,1,Hongbin Ma,2016-04-13 11:11:15+08:00,['71d3f303058afa66608440ae3db91e32e921740c'],8,15,23,14582637,1,0,0,1,9995
b6c893dbeefead2523fc686055736526d4f3ca3e,0,Hongbin Ma,2016-04-13 11:11:15+08:00,['b2a386126e075ac6cc2d15d0c1a42d720abed06a'],12,9,21,14582658,2,0,0,0,9995
59cb57ca6e1a545628d0057d5980c4fe7e789536,0,Hongbin Ma,2016-04-13 11:39:42+08:00,['b6c893dbeefead2523fc686055736526d4f3ca3e'],1,1,2,14582660,1,,,,9995
b109948e0601c3026afac60c566c84bfa5d2c5db,0,lidongsjtu,2016-04-13 15:54:27+08:00,['59cb57ca6e1a545628d0057d5980c4fe7e789536'],0,33,33,14582693,2,0.208333333,0.208333333,1,9995
1d4c7bb82059176aa8fb0f2805675f64ad603412,0,Hongbin Ma,2016-04-13 17:16:06+08:00,['b109948e0601c3026afac60c566c84bfa5d2c5db'],4,57,61,14582754,5,0,1,0.625,9996
96bd3c455ffb2fd37466bd4cfc0ce9a5866925d3,0,shaofengshi,2016-04-13 18:14:26+08:00,['1d4c7bb82059176aa8fb0f2805675f64ad603412'],10,41,51,14582805,3,1,1,1,9996
444302b2afe05940ec8fed43f437d8cd1ffbf62c,0,shaofengshi,2016-04-13 18:14:26+08:00,['96bd3c455ffb2fd37466bd4cfc0ce9a5866925d3'],1,1,2,14582807,1,,,,9996
5dfda003e665b3dd3ea65a1fb8fc0cadec77c2d5,0,Hongbin Ma,2016-04-14 12:06:57+08:00,['444302b2afe05940ec8fed43f437d8cd1ffbf62c'],31,76,107,14582914,6,1,1,1,9997
5042a30bcbc51a1061d2c09365c994dceb28d44e,0,Hongbin Ma,2016-04-14 12:17:31+08:00,['5dfda003e665b3dd3ea65a1fb8fc0cadec77c2d5'],5,7,12,14582926,2,1,1,1,9997
f3a33673fcc39e3673a1b1e712fb44fcf781d8f5,0,Hongbin Ma,2016-04-14 15:06:31+08:00,['5042a30bcbc51a1061d2c09365c994dceb28d44e'],8,12,20,14582946,1,0.5,1,0,9997
2174af259dbf53246bb366c1d605cf997b38c057,0,lidongsjtu,2016-04-14 16:18:09+08:00,['f3a33673fcc39e3673a1b1e712fb44fcf781d8f5'],12,22,34,14582980,2,1,1,1,9997
6dffd97a422589185b4e3c9c6fafafae9f9285d6,0,lidongsjtu,2016-04-14 16:18:26+08:00,['2174af259dbf53246bb366c1d605cf997b38c057'],1,37,38,14583018,3,0.653846154,0.653846154,1,9997
4a1bc1945c990e9e9752e19f63d27afd3f840941,1,lidongsjtu,2016-04-14 16:19:34+08:00,['6dffd97a422589185b4e3c9c6fafafae9f9285d6'],1,17,18,14583036,4,0,0,0.5,9997
71fccaedb2e9d5e288bef43e09050adb3b8757e7,0,Hongbin Ma,2016-04-14 16:39:44+08:00,['4a1bc1945c990e9e9752e19f63d27afd3f840941'],4,4,8,14583044,3,0,0,1,9997
9758c880d4ddd951e402a02e67170de6c55e0712,0,Hongbin Ma,2016-04-14 17:41:34+08:00,['71fccaedb2e9d5e288bef43e09050adb3b8757e7'],1,12,13,14583057,1,0,1,1,9997
9a913582b05fde8a0c192bbeb1686f8a90e32f37,0,Hongbin Ma,2016-04-14 18:00:50+08:00,['9758c880d4ddd951e402a02e67170de6c55e0712'],1,1,2,14583059,1,,,,9997
45759972a72ff7f9608525e3e9383dad8810edb0,0,shaofengshi,2016-04-14 20:21:52+08:00,['9a913582b05fde8a0c192bbeb1686f8a90e32f37'],1,5,6,14583065,1,0,0,0,9997
e564d45c7818ef239f507596d2e0bb84db25498a,1,Jason,2016-04-14 21:24:25+08:00,['45759972a72ff7f9608525e3e9383dad8810edb0'],14,553,567,14583632,13,0.632768362,0.576271186,0.81920904,9998
a607276fd8cb08a0ed1af66ca5c47716d15d939d,0,lidongsjtu,2016-04-15 11:17:36+08:00,['e564d45c7818ef239f507596d2e0bb84db25498a'],1,1,2,14583634,1,,,,9998
e8e95fa0433febb2936a5a775155ac05b337ff9e,0,Jason,2016-04-15 15:34:13+08:00,['a607276fd8cb08a0ed1af66ca5c47716d15d939d'],1,31,32,14583666,4,0.75,1,1,9998
1b54a40bd397064576ed075d7bb074f658ccb995,0,Hongbin Ma,2016-04-15 15:58:48+08:00,['e8e95fa0433febb2936a5a775155ac05b337ff9e'],1,8,9,14583675,1,0,0,0,9998
209068b943bf4a90efe4df618e1aaf5cbfe49cde,1,shaofengshi,2016-04-16 09:05:40+08:00,['1b54a40bd397064576ed075d7bb074f658ccb995'],50,140,190,14583865,7,0,1,0,9999
971efbfc02210188dbc4ca0ae780ac2cca3b123e,1,Hongbin Ma,2016-04-18 11:27:45+08:00,['1b54a40bd397064576ed075d7bb074f658ccb995'],2,2,4,14583869,2,,,,9999
89fb4870c34a9204a8f1200c8369f5fcdd194941,0,Jason,2016-04-18 12:21:16+08:00,['971efbfc02210188dbc4ca0ae780ac2cca3b123e'],27,18,45,14583914,3,0,0,0,9999
41014d6a5cc8d071738be97a97d28bf2c90e8621,1,Hongbin Ma,2016-04-18 13:56:40+08:00,['89fb4870c34a9204a8f1200c8369f5fcdd194941'],7,6,13,14583927,4,,,,9999
22e6969cb30f2146b23a9c81701b8a39dba15fd4,0,Hongbin Ma,2016-04-18 15:40:54+08:00,['41014d6a5cc8d071738be97a97d28bf2c90e8621'],7,28,35,14583962,4,0.764705882,0.764705882,0.941176471,9999
f0473fcafe37ecf5caaf977d105c5bb7c1654c56,0,Zhong,2016-04-18 17:11:11+08:00,['22e6969cb30f2146b23a9c81701b8a39dba15fd4'],2,1,3,14583965,1,,,,9999
78ff89470a9f774af3a6d9d189393a67f823d483,1,Hongbin Ma,2016-04-18 18:27:09+08:00,['f0473fcafe37ecf5caaf977d105c5bb7c1654c56'],2,2,4,14583969,2,,0,,9999
96167fc3ed249500aa1c6bad9f464a8464dd07a1,1,Hongbin Ma,2016-04-18 18:56:26+08:00,['78ff89470a9f774af3a6d9d189393a67f823d483'],4,6,10,14583979,4,1,0,0,9999
59477501cf6e82806309d50017ed121219e29b76,0,lidongsjtu,2016-04-18 21:47:23+08:00,['96167fc3ed249500aa1c6bad9f464a8464dd07a1'],1,1,2,14583981,1,,,,9999
205471998d551bf5bc1988e0da73f5490f0a622c,1,Hongbin Ma,2016-04-18 22:24:52+08:00,['59477501cf6e82806309d50017ed121219e29b76'],3,57,60,14584041,3,1,1,0.166666667,10000
0320d1f78f834bd941c7d531009a9434007254a6,1,Jason,2016-04-18 22:53:38+08:00,['205471998d551bf5bc1988e0da73f5490f0a622c'],25,166,191,14584232,4,0.947368421,1,0.342105263,10002
ef36d6cb49dc4d970f53af123419ea302c11c4f3,0,lidongsjtu,2016-04-18 23:21:29+08:00,['0320d1f78f834bd941c7d531009a9434007254a6'],1,0,1,14584233,1,,,,10002
8ee67a9cde465f806a8520009b50b73074564440,0,Hongbin Ma,2016-04-19 10:24:18+08:00,['ef36d6cb49dc4d970f53af123419ea302c11c4f3'],1,6,7,14584240,1,0,0,1,10002
01ae37d5dab5dcc837a1286344f7f7d85350d7c5,0,Hongbin Ma,2016-04-19 11:59:39+08:00,['8ee67a9cde465f806a8520009b50b73074564440'],158,255,413,14584653,3,0,1,0,10002
fbf2b3814a90ed8dfd39f5d39b48563cdaba155a,1,Jason,2016-04-19 22:26:07+08:00,['01ae37d5dab5dcc837a1286344f7f7d85350d7c5'],2,1929,1931,14586584,4,0.606412005,0.645293315,0.830832196,10003
39becdcd4a5678ab899ab85977ae0ffffc19e541,0,shaofengshi,2016-04-20 10:09:55+08:00,"['209068b943bf4a90efe4df618e1aaf5cbfe49cde', 'fbf2b3814a90ed8dfd39f5d39b48563cdaba155a']",235,2470,2705,14589289,26,,,,10003
dc1671ca509586d7fecb81e24fddab56d5380dae,0,shaofengshi,2016-04-20 10:11:16+08:00,['39becdcd4a5678ab899ab85977ae0ffffc19e541'],4,3,7,14589296,1,1,1,0,10003
3a0ba36f339920309cab7521efdc622eb702e026,0,lidongsjtu,2016-04-20 11:38:02+08:00,['dc1671ca509586d7fecb81e24fddab56d5380dae'],0,26,26,14589322,3,0,1,1,10003
155291fda3ec1c9d5ccf017861526e66c1ba364d,1,lidongsjtu,2016-04-20 16:28:58+08:00,['3a0ba36f339920309cab7521efdc622eb702e026'],22,333,355,14589677,12,0.868613139,1,1,10007
f759f61532fe6430c5531031bc12b22952c59f24,0,lidongsjtu,2016-04-20 16:39:15+08:00,['155291fda3ec1c9d5ccf017861526e66c1ba364d'],4,4,8,14589685,2,,,,10007
3af27d6882ebbc554021a8e9c9d3bd83e071dbbf,0,Hongbin Ma,2016-04-20 16:57:37+08:00,['f759f61532fe6430c5531031bc12b22952c59f24'],2,72,74,14589759,3,1,1,1,10009
19e9582fddd5bdabadb88e1a042b7874c11c38c6,0,Hongbin Ma,2016-04-20 17:15:43+08:00,['3af27d6882ebbc554021a8e9c9d3bd83e071dbbf'],2,2,4,14589763,1,,,,10009
e04d27a38fc07ffc817b5463834ebb8471e70d42,0,lidongsjtu,2016-04-20 18:49:49+08:00,['19e9582fddd5bdabadb88e1a042b7874c11c38c6'],1,0,1,14589764,1,,,,10009
70233918519190026f8ab3067c03ab8510a12163,0,lidongsjtu,2016-04-20 20:11:18+08:00,['e04d27a38fc07ffc817b5463834ebb8471e70d42'],0,12,12,14589776,4,1,1,1,10009
f76190fe9e2ab90e3bcb1d87f41efec22abc8a0e,1,Jason,2016-04-21 11:05:02+08:00,['70233918519190026f8ab3067c03ab8510a12163'],6,63,69,14589845,5,0.184210526,0.842105263,0.763157895,10009
618a6607348479e46dced04983c438d98366fd31,1,Hongbin Ma,2016-04-21 11:58:22+08:00,['f76190fe9e2ab90e3bcb1d87f41efec22abc8a0e'],130,124,254,14590099,3,1,0.375,0.1875,10009
bc46e29a696fe723618c01cdb8553acefb444f21,0,kyotoYaho,2016-04-21 12:52:54+08:00,['618a6607348479e46dced04983c438d98366fd31'],0,1,1,14590100,1,1,1,0,10009
9ca2b8e445ab5b78198fb3bfca5f5eed3f2a4123,1,lidongsjtu,2016-04-21 15:58:20+08:00,['bc46e29a696fe723618c01cdb8553acefb444f21'],3,237,240,14590340,4,0.301470588,0.661764706,1,10010
c40e2bf41c3939b68c3e40433012023ad9b9539f,0,lidongsjtu,2016-04-21 16:05:07+08:00,['9ca2b8e445ab5b78198fb3bfca5f5eed3f2a4123'],1,36,37,14590377,3,1,1,0,10010
37d63f41a8496f7ea93adaac798f7a09b95c8127,0,Hongbin Ma,2016-04-21 18:12:30+08:00,['c40e2bf41c3939b68c3e40433012023ad9b9539f'],14,32,46,14590423,2,0.066666667,0.066666667,0,10010
abe590a20e5f93d6eb5d598fe117195b1f4d7fbb,0,Hongbin Ma,2016-04-21 18:19:30+08:00,['37d63f41a8496f7ea93adaac798f7a09b95c8127'],6,8,14,14590437,3,0.4,0,0.4,10010
21e6b2bdbe9c1762642589a0d374aff0e225b43e,0,lidongsjtu,2016-04-21 18:45:53+08:00,['abe590a20e5f93d6eb5d598fe117195b1f4d7fbb'],9,39,48,14590485,2,0,0,1,10010
f4fc179d8c81823af8e9d0a0d75f553fd6b786d3,1,lidongsjtu,2016-04-22 15:49:05+08:00,['21e6b2bdbe9c1762642589a0d374aff0e225b43e'],1,1,2,14590487,1,,,,10010
8045e7d8112ae2479497cc13b1c28882bc24a786,0,lidongsjtu,2016-04-22 17:01:44+08:00,['f4fc179d8c81823af8e9d0a0d75f553fd6b786d3'],0,28,28,14590515,1,0,0,1,10010
4e169ecaf75714f5a5a937cedfd08b5c20a3fdf7,0,lidongsjtu,2016-04-23 22:44:28+08:00,['8045e7d8112ae2479497cc13b1c28882bc24a786'],1,5,6,14590521,1,0,1,1,10010
ff428cad1634eb8fcd2d982e21e0a51106c918a3,0,Yang Li,2016-04-24 09:53:08+08:00,['4e169ecaf75714f5a5a937cedfd08b5c20a3fdf7'],4,4,8,14590529,1,,,,10010
5209eaf25ebea23d32cdadbf6cf4efb4695adc34,0,Yang Li,2016-04-24 10:19:07+08:00,['ff428cad1634eb8fcd2d982e21e0a51106c918a3'],106,9,115,14590644,3,0.362068966,0.362068966,0.051724138,10010
35c5807686f4302ba554ee7668755885363b83c7,0,Yang Li,2016-04-24 20:49:09+08:00,['5209eaf25ebea23d32cdadbf6cf4efb4695adc34'],17,656,673,14591317,14,0.78313253,1,0.975903614,10015
e1c2b4f5376406ba643d4f5c5865fe3d9ff86d3c,0,lidongsjtu,2016-04-25 09:31:42+08:00,['35c5807686f4302ba554ee7668755885363b83c7'],1,1,2,14591319,1,,,,10015
85d9dff37f5363fa3a1be6ee64324b88610f0fc4,1,Hongbin Ma,2016-04-25 13:35:56+08:00,['e1c2b4f5376406ba643d4f5c5865fe3d9ff86d3c'],3,35,38,14591357,2,0.733333333,1,1,10015
7e38e67b9b8138961421dc9b31c0650cdfee9831,0,lidongsjtu,2016-04-25 15:26:34+08:00,['85d9dff37f5363fa3a1be6ee64324b88610f0fc4'],0,3,3,14591360,1,0,0,1,10015
d899a67963af14f80fc047a9253ac7736c1983f3,1,lidongsjtu,2016-04-25 15:26:40+08:00,['7e38e67b9b8138961421dc9b31c0650cdfee9831'],31,68,99,14591459,2,0.16,0.52,1,10015
d30bc8d542557a6fe92e041c4282c08032c89641,1,Hongbin Ma,2016-04-26 16:07:26+08:00,['d899a67963af14f80fc047a9253ac7736c1983f3'],1,2,3,14591462,1,,,,10015
aebdd66fec3739783d247e253e3f2782aac25a6b,0,Hongbin Ma,2016-04-26 16:07:26+08:00,['d30bc8d542557a6fe92e041c4282c08032c89641'],1,1,2,14591464,1,,,,10015
a2220073074d07d4cd52e5c66e8d83ef571ff500,0,Li Yang,2016-04-26 16:19:14+08:00,['aebdd66fec3739783d247e253e3f2782aac25a6b'],0,49,49,14591513,3,0.512195122,0.512195122,1,10015
e4ff6ef8af7893910240f62f4b811c1c8f8bc017,0,shaofengshi,2016-04-26 18:43:14+08:00,['a2220073074d07d4cd52e5c66e8d83ef571ff500'],8,13,21,14591534,7,0.75,1,1,10015
c96488da28e7375063f665f2b249452aaa77dbf8,0,shaofengshi,2016-04-26 19:10:22+08:00,['e4ff6ef8af7893910240f62f4b811c1c8f8bc017'],0,8,8,14591542,3,0.75,1,1,10015
d5ff2db320cd7bc59cee6c261edefa1b53162da5,0,Li Yang,2016-04-26 19:21:27+08:00,['c96488da28e7375063f665f2b249452aaa77dbf8'],4,32,36,14591578,1,0,0,1,10015
68183a49046aed328a18c8d1ea5d11a238224943,0,lidongsjtu,2016-04-26 20:41:12+08:00,['d5ff2db320cd7bc59cee6c261edefa1b53162da5'],1,1,2,14591580,1,,,,10015
2cd936608f8a96e7cf886a94283fe089a74b3a80,0,lidongsjtu,2016-04-26 20:53:49+08:00,['68183a49046aed328a18c8d1ea5d11a238224943'],20,12,32,14591612,1,1,1,0,10015
7ac73cb53e44f6dff3bbb2499ed44e67b267e55d,0,Yang Li,2016-04-26 22:56:48+08:00,['2cd936608f8a96e7cf886a94283fe089a74b3a80'],5,4,9,14591621,1,0,0,0,10015
e4da79aeff99f70dc41661ea339d06aa2f1b4e96,0,lidongsjtu,2016-04-26 23:18:29+08:00,['7ac73cb53e44f6dff3bbb2499ed44e67b267e55d'],1,1,2,14591623,1,,,,10015
76cbfede9c162e6d2725424f608144969c9a55b9,0,lidongsjtu,2016-04-26 23:18:59+08:00,['e4da79aeff99f70dc41661ea339d06aa2f1b4e96'],2,2,4,14591627,1,,,,10015
dd855a512f5d70e1734a4637e3dfee554a40aaf4,0,Yang Li,2016-04-27 07:05:35+08:00,['76cbfede9c162e6d2725424f608144969c9a55b9'],0,13,13,14591640,2,1,1,1,10015
34ac81fb00e0056877cfe6bf5220d1ea79bfe70e,1,shaofengshi,2016-04-27 14:33:12+08:00,['dd855a512f5d70e1734a4637e3dfee554a40aaf4'],5,23,28,14591668,2,0,1,1,10015
6ec5b3c599951f06c41e3428e49fea0624e7300f,1,Li Yang,2016-04-27 18:13:25+08:00,['34ac81fb00e0056877cfe6bf5220d1ea79bfe70e'],1,1,2,14591670,1,,,,10015
205d4d6e51e4559f0ca8ad8f419bf3354fa3c322,0,Yang Li,2016-04-28 10:04:25+08:00,['6ec5b3c599951f06c41e3428e49fea0624e7300f'],2,3,5,14591675,1,0,1,0,10015
cfbf43b8cdec59532964d45ffa763d8891973c84,0,Yang Li,2016-04-28 13:49:14+08:00,['205d4d6e51e4559f0ca8ad8f419bf3354fa3c322'],15,25,40,14591715,2,0.9,0.9,1,10015
866fdb437c66072cd94b48536250f9d6436711a8,0,Yang Li,2016-04-28 16:33:56+08:00,['cfbf43b8cdec59532964d45ffa763d8891973c84'],9,23,32,14591747,1,0.571428571,1,1,10015
8e7a76b9fc3b90ef60730dfab08d3e45b8a42675,1,shaofengshi,2016-04-28 18:36:05+08:00,['866fdb437c66072cd94b48536250f9d6436711a8'],79,140,219,14591966,13,0,0,0,10015
fb5e281f5096ac218a09e66e4381e36549f0f4cf,0,shaofengshi,2016-04-28 18:36:05+08:00,['8e7a76b9fc3b90ef60730dfab08d3e45b8a42675'],1,5,6,14591972,1,1,1,0,10015
bd54ef530cc7d1fe494c5711cfa485440bb228fc,0,shaofengshi,2016-04-28 18:36:05+08:00,['fb5e281f5096ac218a09e66e4381e36549f0f4cf'],6,9,15,14591987,3,1,1,0,10015
26a67349999288f671a1054908d5e889c0f0d408,0,shaofengshi,2016-04-28 18:36:05+08:00,['bd54ef530cc7d1fe494c5711cfa485440bb228fc'],4,5,9,14591996,2,0,1,1,10015
35bd66403a20e4f7083d35aa2f92dc4025d5c1b1,0,shaofengshi,2016-04-28 18:36:05+08:00,['26a67349999288f671a1054908d5e889c0f0d408'],0,4,4,14592000,1,0,0,0,10015
6a5c187bd962d38e6839353b20106584d8a04107,1,lidongsjtu,2016-04-28 18:54:18+08:00,['35bd66403a20e4f7083d35aa2f92dc4025d5c1b1'],44,101,145,14592145,10,0.24,0.92,0.4,10015
88c919489c53b3fe30072d77d070da576ab3e544,0,lidongsjtu,2016-04-28 18:54:18+08:00,['6a5c187bd962d38e6839353b20106584d8a04107'],1,1,2,14592147,1,,,,10015
b345cf60aa5410bcce93d80aa9910f41849d66e5,0,lidongsjtu,2016-04-28 23:47:46+08:00,['88c919489c53b3fe30072d77d070da576ab3e544'],3,3,6,14592153,1,,,,10015
3ba180a4e46bf1d799c16b56b83398b3d2e7b59f,0,shaofengshi,2016-04-29 09:52:10+08:00,['b345cf60aa5410bcce93d80aa9910f41849d66e5'],2,2,4,14592157,1,,,,10015
c80ccd010a9717b88c8d0e604e13e1e72e7783ba,1,shaofengshi,2016-04-29 12:04:55+08:00,['3ba180a4e46bf1d799c16b56b83398b3d2e7b59f'],22,164,186,14592343,7,0.643478261,0.956521739,0.886956522,10015
360b6f0aa111f999bf3b4aabd70b236ee6b93a79,1,shaofengshi,2016-04-29 12:08:12+08:00,['c80ccd010a9717b88c8d0e604e13e1e72e7783ba'],22,504,526,14592869,11,1,1,1,10016
834e7c8cb668257c03a68c5d281bd66106eb0ae7,0,shaofengshi,2016-04-29 12:08:32+08:00,['360b6f0aa111f999bf3b4aabd70b236ee6b93a79'],1,1,2,14592871,1,,,,10016
7e4a59eb3efaeeb6cfcbf9128a225e246175d072,0,shaofengshi,2016-04-29 12:08:43+08:00,['834e7c8cb668257c03a68c5d281bd66106eb0ae7'],1,0,1,14592872,1,0,0,0,10016
9284b47c3545469344c8985e7d499238ee7b8a32,1,shaofengshi,2016-04-29 12:08:51+08:00,['7e4a59eb3efaeeb6cfcbf9128a225e246175d072'],29,234,263,14593135,10,1,1,1,10018
44c6fc9b8f5b39d217466a2b7887730a82566712,0,Li Yang,2016-04-29 12:15:25+08:00,['9284b47c3545469344c8985e7d499238ee7b8a32'],254,291,545,14593680,3,1,0.708333333,0.791666667,10018
dc2e1c23affd4b609d2a8699965d025be5ddeb4c,0,shaofengshi,2016-04-29 13:49:14+08:00,['44c6fc9b8f5b39d217466a2b7887730a82566712'],61,0,61,14593741,1,,,,10018
c3cf042c44820bc416fa8d8fcb52f2a7d845b3c2,0,shaofengshi,2016-04-29 15:03:39+08:00,['dc2e1c23affd4b609d2a8699965d025be5ddeb4c'],3,20,23,14593764,3,,,,10018
0754a7953163399a842f4e07192a7885f1242b9b,1,lidongsjtu,2016-04-29 16:03:11+08:00,['c3cf042c44820bc416fa8d8fcb52f2a7d845b3c2'],0,1,1,14593765,1,1,1,0,10018
e1287f4f8f2c38131941fcb2082b46dd5f2ee50f,1,lidongsjtu,2016-04-29 16:03:11+08:00,['0754a7953163399a842f4e07192a7885f1242b9b'],248,474,722,14594487,9,0.807692308,1,0.634615385,10022
07e3c25fd11381dbbb999b4d5550863871d681ea,0,lidongsjtu,2016-04-29 16:03:11+08:00,['e1287f4f8f2c38131941fcb2082b46dd5f2ee50f'],1,1,2,14594489,1,,,,10022
78d0d223e281c6bbeaafd299b28d7d24de16e731,0,Li Yang,2016-04-29 17:10:56+08:00,['07e3c25fd11381dbbb999b4d5550863871d681ea'],1,1,2,14594491,1,,,,10022
1357847f5ba4981d94b0747fba33ca280c1e55e2,0,Li Yang,2016-04-29 17:13:27+08:00,['78d0d223e281c6bbeaafd299b28d7d24de16e731'],0,236,236,14594727,1,0.742647059,1,1,10023
8f584dd414e7168680d1990bc4fa1c9a34cd4712,0,Li Yang,2016-04-29 18:13:11+08:00,['1357847f5ba4981d94b0747fba33ca280c1e55e2'],0,2,2,14594729,1,0,0,1,10023
5da8ea857a8ed5d29add343a8951d151a1df713d,0,shaofengshi,2016-04-29 22:53:32+08:00,['8f584dd414e7168680d1990bc4fa1c9a34cd4712'],16,18,34,14594763,1,0,1,1,10023
2ab68ed352854ebd616099ea97eed050f71184eb,0,lidongsjtu,2016-04-29 22:59:30+08:00,['5da8ea857a8ed5d29add343a8951d151a1df713d'],2,2,4,14594767,2,,,,10023
96dc57bc7f96ed320ce461b3bb1bbea33b0b1737,0,lidongsjtu,2016-04-30 10:04:00+08:00,['2ab68ed352854ebd616099ea97eed050f71184eb'],4,5,9,14594776,1,1,1,1,10023
42bf1b5627002e268d8b848b8219a3776f41bc81,0,lidongsjtu,2016-04-30 10:11:01+08:00,['96dc57bc7f96ed320ce461b3bb1bbea33b0b1737'],2,2,4,14594780,2,0,1,1,10023
2fc5827f0e8c0f4c598bbf28f1ead962e80cdfcd,0,lidongsjtu,2016-04-30 12:28:15+08:00,['42bf1b5627002e268d8b848b8219a3776f41bc81'],3,8,11,14594791,1,0,1,1,10023
eb4cec69fb877f5b9f0b1de450eae296f22843ef,0,lidongsjtu,2016-04-30 14:35:08+08:00,['2fc5827f0e8c0f4c598bbf28f1ead962e80cdfcd'],1,1,2,14594793,1,,,,10023
79d1c6d5450c054b28eea19d486b069f3650c5f7,1,lidongsjtu,2016-04-30 14:42:20+08:00,['eb4cec69fb877f5b9f0b1de450eae296f22843ef'],43,139,182,14594975,7,0.555555556,1,0.644444444,10024
e47a64816d95e410bfacef9097737008bc19ebc7,0,lidongsjtu,2016-05-01 14:06:24+08:00,['79d1c6d5450c054b28eea19d486b069f3650c5f7'],4,16,20,14594995,3,1,1,1,10024
0308fa81146fd0b0e100da0e5005a845cba70958,0,lidongsjtu,2016-05-01 14:14:18+08:00,['e47a64816d95e410bfacef9097737008bc19ebc7'],44,41,85,14595080,7,1,1,0,10024
b7f03986f7f6fbf55b01c02637507f8cca0ef6b6,0,lidongsjtu,2016-05-01 14:14:18+08:00,['0308fa81146fd0b0e100da0e5005a845cba70958'],24,24,48,14595128,5,0.714285714,0.714285714,0,10024
f4bdd5b7c9c459609b9ca4ef1a3b21c493a0487c,0,lidongsjtu,2016-05-01 14:33:24+08:00,['b7f03986f7f6fbf55b01c02637507f8cca0ef6b6'],2,2,4,14595132,1,,,,10024
0ea4d369388c9dec1844a29edb1a3b6a94d54a4e,1,Yang Li,2016-05-01 19:21:09+08:00,['f4bdd5b7c9c459609b9ca4ef1a3b21c493a0487c'],824,561,1385,14596517,25,0.19047619,0,0,10026
5c3990ec5be4e4c7dd01420fc360eb729029994d,0,Yang Li,2016-05-01 19:32:59+08:00,['0ea4d369388c9dec1844a29edb1a3b6a94d54a4e'],6,0,6,14596523,1,,,,10026
dc1c2f66ec5fa9bdfd965ff023b26a357c9d1cd9,1,Yang Li,2016-05-01 19:38:34+08:00,['5c3990ec5be4e4c7dd01420fc360eb729029994d'],0,703,703,14597226,3,0.718274112,1,0.967005076,10029
c1ece6ab5390d83544bc83b5763f59de5a00c37a,0,Yang Li,2016-05-01 19:58:44+08:00,['dc1c2f66ec5fa9bdfd965ff023b26a357c9d1cd9'],18,40,58,14597284,2,1,1,1,10029
44ce1354ba1c0d7e895d39ee0b39a8f95c74654b,0,Yang Li,2016-05-01 20:32:56+08:00,['c1ece6ab5390d83544bc83b5763f59de5a00c37a'],1,8,9,14597293,2,1,1,1,10029
73edfb57d423e7aaf0eaab577e2e5668f4f9b95c,0,lidongsjtu,2016-05-02 07:26:45+08:00,['44ce1354ba1c0d7e895d39ee0b39a8f95c74654b'],0,28,28,14597321,1,,,,10030
cabd2f9cb9f4fd50c21bcfcaceb37c1fa122bb94,0,lidongsjtu,2016-05-03 16:56:29+08:00,['73edfb57d423e7aaf0eaab577e2e5668f4f9b95c'],1,5,6,14597327,1,1,1,1,10030
4f32927558ff6ebc1899241af87e93bd2747e242,0,lidongsjtu,2016-05-03 17:03:04+08:00,['cabd2f9cb9f4fd50c21bcfcaceb37c1fa122bb94'],1,1,2,14597329,1,,,,10030
de2f75458b3a5d76390173fdd9359eadbcb11764,0,lidongsjtu,2016-05-03 17:18:15+08:00,['4f32927558ff6ebc1899241af87e93bd2747e242'],0,7,7,14597336,1,1,1,1,10030
14be33f8f16d20bb18500934d56272a30face1b8,0,lidongsjtu,2016-05-03 17:30:06+08:00,['de2f75458b3a5d76390173fdd9359eadbcb11764'],0,2,2,14597338,1,1,1,1,10030
119d24bbd82ad9bb14da3f229b5aae214b916fba,1,shaofengshi,2016-05-03 19:11:15+08:00,['14be33f8f16d20bb18500934d56272a30face1b8'],1,8,9,14597347,2,1,1,1,10030
60848ce75b4200a2199c066cd6eb50ad0f8f7194,1,shaofengshi,2016-05-03 19:11:15+08:00,['119d24bbd82ad9bb14da3f229b5aae214b916fba'],5,5,10,14597357,2,,,,10030
576ec1b0bf7b311ed3823685919c6385e7ce0518,0,shaofengshi,2016-05-03 19:11:15+08:00,['60848ce75b4200a2199c066cd6eb50ad0f8f7194'],9,12,21,14597378,3,0,0,0,10030
2d1427525595987b057835a52b1fd059afb82a3c,0,shaofengshi,2016-05-03 19:11:15+08:00,['576ec1b0bf7b311ed3823685919c6385e7ce0518'],1,1,2,14597380,1,,,,10030
a1032bdf690e316900534c525a36d00031bf16c3,0,shaofengshi,2016-05-03 19:18:30+08:00,['2d1427525595987b057835a52b1fd059afb82a3c'],1,4,5,14597385,2,,,,10030
136a333d3300d1e3cc68faafd117045a816c69cd,1,Jason,2016-05-03 19:23:46+08:00,['a1032bdf690e316900534c525a36d00031bf16c3'],281,498,779,14598164,10,0.848101266,1,0.696202532,10034
f3f3133d1b01e79f7b0b132b2184a67972617395,1,shaofengshi,2016-05-04 09:32:23+08:00,['136a333d3300d1e3cc68faafd117045a816c69cd'],12,19,31,14598195,1,0,0,1,10034
30f7a1c5b7cb7e8839f4d0d9afe4a014baf13ba8,0,shaofengshi,2016-05-04 16:54:34+08:00,['f3f3133d1b01e79f7b0b132b2184a67972617395'],1,1,2,14598197,1,,,,10034
6dcac61c67a2bf0ddf42dc23fcc315e64bad830a,0,lidongsjtu,2016-05-04 18:45:51+08:00,['30f7a1c5b7cb7e8839f4d0d9afe4a014baf13ba8'],4,4,8,14598205,1,,,,10034
090998924bd089ea82ef17166b5f4851964093ed,0,lidongsjtu,2016-05-04 21:37:19+08:00,['6dcac61c67a2bf0ddf42dc23fcc315e64bad830a'],0,1,1,14598206,1,,,,10034
08bc6c4fba9828a82dd85b137a9a5773cdb543fd,0,lidongsjtu,2016-05-05 11:41:49+08:00,['090998924bd089ea82ef17166b5f4851964093ed'],3,14,17,14598223,1,0.8,1,1,10034
e767aa48f00a2625282c13ea04a3720341eda40b,0,lidongsjtu,2016-05-05 11:47:00+08:00,['08bc6c4fba9828a82dd85b137a9a5773cdb543fd'],9,9,18,14598241,7,,,,10034
d11055c5dd4fae00e147d565b777347dc26cee4e,0,lidongsjtu,2016-05-05 13:13:25+08:00,['e767aa48f00a2625282c13ea04a3720341eda40b'],8,18,26,14598267,1,0,0,1,10034
c1a19038d04b33d0d87b84c731c9cd44145d30c2,0,lidongsjtu,2016-05-05 14:49:07+08:00,['d11055c5dd4fae00e147d565b777347dc26cee4e'],4,3,7,14598274,2,,,,10034
99f766615ec7fdbc2bafc9805353565b2dd0b60b,0,Jason,2016-05-05 15:37:29+08:00,['c1a19038d04b33d0d87b84c731c9cd44145d30c2'],22,2,24,14598298,2,,,,10034
8d16bb3a444e673fa0527d19ca88bbf00331142b,1,lidongsjtu,2016-05-05 15:38:39+08:00,['99f766615ec7fdbc2bafc9805353565b2dd0b60b'],8,18,26,14598324,3,0,0.8,1,10034
bd62929c5fa82ad771c5b3f7801fedbcb8ceb521,0,lidongsjtu,2016-05-05 15:51:13+08:00,['8d16bb3a444e673fa0527d19ca88bbf00331142b'],19,11,30,14598354,1,0.357142857,0.357142857,0,10034
51c275f3e3f43c4d3e470944306e32291eca817d,1,Jason,2016-05-05 16:49:03+08:00,['bd62929c5fa82ad771c5b3f7801fedbcb8ceb521'],2,28,30,14598384,4,0,1,1,10034
7b2b9147db397b85ec45d17bb3787c9ff0f27a68,0,lidongsjtu,2016-05-05 18:39:51+08:00,['51c275f3e3f43c4d3e470944306e32291eca817d'],19,105,124,14598508,5,0.536585366,1,0.292682927,10035
80e5df2b1e71625f646e993938f424e9723ac4bb,0,lidongsjtu,2016-05-06 11:16:03+08:00,['7b2b9147db397b85ec45d17bb3787c9ff0f27a68'],1,1,2,14598510,1,,,,10035
ca118ba063decfa65ba11d109cbfe60c5901d2fb,1,Jason,2016-05-06 11:52:29+08:00,['80e5df2b1e71625f646e993938f424e9723ac4bb'],31,81,112,14598622,2,0.714285714,1,0.984126984,10035
824a33551ae19c43ab8ab4dc8c3546891ede9c93,1,Li Yang,2016-05-06 12:03:54+08:00,['ca118ba063decfa65ba11d109cbfe60c5901d2fb'],0,3,3,14598625,1,,,,10035
a930bd62ec831fde319edd8b50f093f52d9668ef,0,shaofengshi,2016-05-06 15:19:10+08:00,['824a33551ae19c43ab8ab4dc8c3546891ede9c93'],1,1,2,14598627,1,,,,10035
f17ba5c04ce121ceb0c98f985771ccf9587ee157,1,shaofengshi,2016-05-06 15:19:10+08:00,['a930bd62ec831fde319edd8b50f093f52d9668ef'],21,14,35,14598662,3,0.714285714,1,1,10035
eac98036ddf228daaa71bd41f00179fa493f2759,0,lidongsjtu,2016-05-06 17:09:31+08:00,['f17ba5c04ce121ceb0c98f985771ccf9587ee157'],5,175,180,14598842,4,0,0,1,10037
277e6d6285078a369c6a7fc388e899716a8eac65,0,lidongsjtu,2016-05-08 18:14:21+08:00,['eac98036ddf228daaa71bd41f00179fa493f2759'],29,27,56,14598898,6,1,1,1,10037
3e876ef6f4fa907ffd1885bfa3f096a980db0220,0,lidongsjtu,2016-05-09 11:15:47+08:00,['277e6d6285078a369c6a7fc388e899716a8eac65'],0,35,35,14598933,2,,,,10037
ecbff227a37c57a9321c85aa05e60741602f0ef0,0,lidongsjtu,2016-05-09 14:02:59+08:00,['3e876ef6f4fa907ffd1885bfa3f096a980db0220'],16,14,30,14598963,7,,,,10037
0c0bb078f3de11b0b2a0e4644b9134836727e59b,1,shaofengshi,2016-05-09 15:32:01+08:00,['ecbff227a37c57a9321c85aa05e60741602f0ef0'],4,6,10,14598973,1,1,0,1,10037
f65e7d1bd23d095bc6c60c5cd2eee4505ece0cfa,0,shaofengshi,2016-05-09 15:32:01+08:00,['0c0bb078f3de11b0b2a0e4644b9134836727e59b'],7,9,16,14598989,1,0,0,1,10037
548f5a433ccf8bd0406204cff8d968f172e7f5e1,1,lidongsjtu,2016-05-09 17:06:54+08:00,['f65e7d1bd23d095bc6c60c5cd2eee4505ece0cfa'],4,15,19,14599008,3,0,0,1,10037
86ee3556df82329fb7c4ba8826cfc2375df623f6,0,lidongsjtu,2016-05-09 17:39:22+08:00,['548f5a433ccf8bd0406204cff8d968f172e7f5e1'],1,1,2,14599010,1,,,,10037
94ab839f6cece4fff523274aeaf3b3dd6b3e461b,0,shaofengshi,2016-05-09 18:25:23+08:00,['86ee3556df82329fb7c4ba8826cfc2375df623f6'],5,5,10,14599020,3,,,,10037
656c645f3d2802178ccfdc092e31d7cb51aa496d,0,shaofengshi,2016-05-09 18:25:23+08:00,['94ab839f6cece4fff523274aeaf3b3dd6b3e461b'],0,9,9,14599029,1,0,0,1,10037
2fc706ca132dfad43b2f68c41757ddfbadc595b0,1,Hongbin Ma,2016-05-09 18:40:06+08:00,['656c645f3d2802178ccfdc092e31d7cb51aa496d'],95,213,308,14599337,10,0.8,1,0.857142857,10039
3542dd29147ed20a409c84212235dc6c3c5f0ad9,1,Jason,2016-05-09 18:41:49+08:00,['2fc706ca132dfad43b2f68c41757ddfbadc595b0'],78,55,133,14599470,8,1,0.5,0,10039
0870a6ab2215711dc3cf52c6718d097ecf336dd1,1,Jason,2016-05-09 18:41:49+08:00,['3542dd29147ed20a409c84212235dc6c3c5f0ad9'],7,39,46,14599516,2,0.136363636,0.136363636,1,10039
bdffa9fbe46b23765e2d71fa0a2ddf7ff55bd1d8,0,Hongbin Ma,2016-05-09 18:52:23+08:00,['0870a6ab2215711dc3cf52c6718d097ecf336dd1'],2,2,4,14599520,1,,,,10039
9e2572a30cfa74831eaab8c1504c6b7363ca1e17,0,Jason,2016-05-09 20:47:16+08:00,['bdffa9fbe46b23765e2d71fa0a2ddf7ff55bd1d8'],1,18,19,14599539,1,0,1,1,10039
ecc57ee6313408e7a41801b270d8567b44ab121b,0,Jason,2016-05-10 10:40:03+08:00,['9e2572a30cfa74831eaab8c1504c6b7363ca1e17'],0,10,10,14599549,2,0,1,1,10039
a943113f6141e5af9b58502094749ac821976e17,0,Jason,2016-05-10 14:32:43+08:00,['ecc57ee6313408e7a41801b270d8567b44ab121b'],3,3,6,14599555,1,,,,10039
d83a32888d59155928079d01da9505e94e142af4,0,Jason,2016-05-10 14:33:57+08:00,['a943113f6141e5af9b58502094749ac821976e17'],2,2,4,14599559,2,,,,10039
32bb2e41ee5995be92107fc9f669f68cd8d80844,0,Jason,2016-05-10 15:37:21+08:00,['d83a32888d59155928079d01da9505e94e142af4'],278,293,571,14600130,1,,,,10039
ba14da1ffe9a898145e87404a660e54951cc2164,0,Jason,2016-05-10 15:57:42+08:00,['32bb2e41ee5995be92107fc9f669f68cd8d80844'],8,2,10,14600140,1,,,,10039
2085686ace442d2c58fd0fb1962d662d32d7e5e5,0,Jason,2016-05-10 16:11:42+08:00,['ba14da1ffe9a898145e87404a660e54951cc2164'],0,5,5,14600145,1,1,1,1,10039
f4e171b06a699f40bf2db5ec6cdc937c38cf43b1,0,Hongbin Ma,2016-05-10 18:43:08+08:00,['2085686ace442d2c58fd0fb1962d662d32d7e5e5'],1,3,4,14600149,1,,,,10039
eab0321893a70071823b8f863cf53343d2d285e0,0,lidongsjtu,2016-05-10 18:52:11+08:00,['f4e171b06a699f40bf2db5ec6cdc937c38cf43b1'],0,2,2,14600151,1,,,,10039
24353d1b10d279d0c925afe6f03d479963fc934d,0,Jason,2016-05-11 15:04:33+08:00,['eab0321893a70071823b8f863cf53343d2d285e0'],2,5,7,14600158,4,,,,10039
4a0ae6c7baa4b5b4e4bb50ac8b6e01cc2f8accc4,1,Jason,2016-05-11 16:26:54+08:00,['24353d1b10d279d0c925afe6f03d479963fc934d'],72,2,74,14600232,6,0.357142857,0,0,10039
2dca5546c617550738f8e72c888486bbfceea3ef,0,Jason,2016-05-11 17:23:23+08:00,['4a0ae6c7baa4b5b4e4bb50ac8b6e01cc2f8accc4'],1,1,2,14600234,1,,,,10039
f6511331929f944a762815d4ace3ea60da4ea0f1,0,Jason,2016-05-11 17:30:32+08:00,['2dca5546c617550738f8e72c888486bbfceea3ef'],1,6,7,14600241,1,1,1,1,10039
c48bbd9257649cacf35f083c0e916681c9a91fcd,1,lidongsjtu,2016-05-12 14:40:34+08:00,['f6511331929f944a762815d4ace3ea60da4ea0f1'],55,69,124,14600365,7,0.708333333,0.708333333,1,10039
769eb81c78eaf89c93ffc3dd9d23b806a4a2832f,0,lidongsjtu,2016-05-12 15:18:26+08:00,['c48bbd9257649cacf35f083c0e916681c9a91fcd'],2,2,4,14600369,1,,,,10039
fbe16d6bc0f9ee524cc6bc508a2cc265966310d1,0,lidongsjtu,2016-05-12 18:10:30+08:00,['769eb81c78eaf89c93ffc3dd9d23b806a4a2832f'],0,2,2,14600371,1,,,,10039
7101f09a5d6e7d14efbf69c5e6e04c911599cae9,1,lidongsjtu,2016-05-12 21:14:42+08:00,['fbe16d6bc0f9ee524cc6bc508a2cc265966310d1'],0,22,22,14600393,2,0.833333333,0,1,10039
407fbd0d4600daa4a65f09628558fcea72863473,0,lidongsjtu,2016-05-12 21:27:08+08:00,['7101f09a5d6e7d14efbf69c5e6e04c911599cae9'],3,6,9,14600402,2,0,1,1,10039
58f3af3b33d7d581811e1854a4c14e4f2c6edaf8,0,Hongbin Ma,2016-05-13 13:54:10+08:00,['407fbd0d4600daa4a65f09628558fcea72863473'],1,27,28,14600430,3,1,1,1,10039
78e709b5a7826526fea992b2c09da0c55b75297b,0,Jason,2016-05-13 15:16:18+08:00,['58f3af3b33d7d581811e1854a4c14e4f2c6edaf8'],1,1,2,14600432,1,,,,10039
74fc2d9c57825770fa736e89e8119a17d53b63c0,1,lidongsjtu,2016-05-13 15:55:56+08:00,['78e709b5a7826526fea992b2c09da0c55b75297b'],2,13,15,14600447,1,0,0,0.555555556,10039
67b84d20eeaefec91d2dd6e7be93a1d82f172976,0,Hongbin Ma,2016-05-13 17:20:16+08:00,['74fc2d9c57825770fa736e89e8119a17d53b63c0'],6,6,12,14600459,1,1,1,0,10039
d26667bb2eb3b2a6043274c40872c9e89d4b4394,0,lidongsjtu,2016-05-13 17:43:44+08:00,['67b84d20eeaefec91d2dd6e7be93a1d82f172976'],2,2,4,14600463,2,,,,10039
aa98a909e3a7c897b48d822152e26d0124dff662,0,lidongsjtu,2016-05-13 20:37:44+08:00,['d26667bb2eb3b2a6043274c40872c9e89d4b4394'],1,2,3,14600466,1,,,,10039
708df134ba91bd49d5249bbe7c9b5aa9f71c12ec,0,lidongsjtu,2016-05-15 13:36:51+08:00,['aa98a909e3a7c897b48d822152e26d0124dff662'],2,2,4,14600470,1,,,,10039
19f5cf7d155aa2dc09b2c0c1887f5d57b4e8d0c8,1,Jason,2016-05-16 11:01:59+08:00,['708df134ba91bd49d5249bbe7c9b5aa9f71c12ec'],2,28087,28089,14628559,5,0.525349881,0.787958806,0.803340375,10040
f6be4839c07e4cd96b67601c57ab24a70e555da2,0,Jason,2016-05-16 15:26:34+08:00,['19f5cf7d155aa2dc09b2c0c1887f5d57b4e8d0c8'],1,1,2,14628561,1,,,,10040
e80b13ff1b3235b13b872675b8c2165a8b024d19,0,Hongbin Ma,2016-05-16 15:27:56+08:00,['f6be4839c07e4cd96b67601c57ab24a70e555da2'],2,8,10,14628571,2,0,1,1,10040
b7ae177f4c7f0e3add9b0ea612a6ac1c9d4d8730,0,kyotoYaho,2016-05-16 18:58:52+08:00,['e80b13ff1b3235b13b872675b8c2165a8b024d19'],9,73,82,14628653,2,0,0,1,10041
06e1ea2960c2d0dffc9245fa52a0e281d72c846c,0,kyotoYaho,2016-05-16 20:15:56+08:00,['b7ae177f4c7f0e3add9b0ea612a6ac1c9d4d8730'],2,22,24,14628677,1,0,0.3,0.3,10041
4a6aed92ea9ad1d155037dda756a19e55d50dec2,0,Hongbin Ma,2016-05-17 18:45:20+08:00,['06e1ea2960c2d0dffc9245fa52a0e281d72c846c'],5,9,14,14628691,2,1,1,1,10041
08276a3b3fcaa600d3869da749ef46a37bb90646,0,lidongsjtu,2016-05-18 10:22:44+08:00,['4a6aed92ea9ad1d155037dda756a19e55d50dec2'],4,29,33,14628724,2,1,1,1,10041
6c32fd6a2e72183e8d4f132da8ee771ef6cc33c9,1,shaofengshi,2016-05-18 10:28:15+08:00,['08276a3b3fcaa600d3869da749ef46a37bb90646'],7,105,112,14628836,4,1,0,0,10042
c6aad4e9636dbc52b3459268b45b433dc5f628ec,1,shaofengshi,2016-05-18 10:38:32+08:00,['6c32fd6a2e72183e8d4f132da8ee771ef6cc33c9'],29,243,272,14629108,5,0.876811594,1,0.869565217,10043
bdf5e47203132ae6c43654331f8ff5fe9fc6ccd9,0,shaofengshi,2016-05-18 10:38:32+08:00,['c6aad4e9636dbc52b3459268b45b433dc5f628ec'],22,1,23,14629131,1,,,,10043
185b34ff6e13d81a24a86893dbf85563ae3430a3,1,shaofengshi,2016-05-18 10:38:32+08:00,['bdf5e47203132ae6c43654331f8ff5fe9fc6ccd9'],156,187,343,14629474,6,0.769230769,1,0,10044
f0fe457e387235107921ee58f5a7e23a53938d02,1,Li Yang,2016-05-18 16:14:54+08:00,['185b34ff6e13d81a24a86893dbf85563ae3430a3'],152,227,379,14629853,5,0.939393939,0.939393939,1,10045
e7779f7e2abafa1aa9c51b23f05f5b12ec47fbcc,0,kyotoYaho,2016-05-18 20:59:39+08:00,['f0fe457e387235107921ee58f5a7e23a53938d02'],0,3,3,14629856,1,0,0,1,10045
92576ccae247bd541dd57cb70d1c99be48622be8,1,Jason,2016-05-19 11:12:27+08:00,['e7779f7e2abafa1aa9c51b23f05f5b12ec47fbcc'],289,396,685,14630541,12,0.387755102,0,0.408163265,10045
55f73e555dec1ffefe321d53512fbb6de92407be,0,Jason,2016-05-19 15:09:45+08:00,['92576ccae247bd541dd57cb70d1c99be48622be8'],29,13,42,14630583,7,,,,10045
c21dca5c78f4a325c2f0fe09474465f0de95e85d,0,lidongsjtu,2016-05-19 17:38:55+08:00,['55f73e555dec1ffefe321d53512fbb6de92407be'],7,1,8,14630591,1,,,,10045
c96f8274a40782d1b9b151edeb48a37d5149f88c,0,shaofengshi,2016-05-20 07:34:39+08:00,['c21dca5c78f4a325c2f0fe09474465f0de95e85d'],3,1,4,14630595,1,,,,10045
aa7558ab7b53f94b1b926035eba7c66cabbd5779,1,Li Yang,2016-05-20 12:37:39+08:00,['c96f8274a40782d1b9b151edeb48a37d5149f88c'],6,10,16,14630611,1,,,,10045
f31ad6e5bc5f4f7e90de04e6ad21f0ad11b45c52,0,Li Yang,2016-05-20 15:00:07+08:00,['aa7558ab7b53f94b1b926035eba7c66cabbd5779'],31,65,96,14630707,9,1,1,1,10045
8d178b91ffdedca077b27aef3e1170eced8433cd,0,Li Yang,2016-05-20 15:37:46+08:00,['f31ad6e5bc5f4f7e90de04e6ad21f0ad11b45c52'],10,0,10,14630717,2,0.333333333,0,0,10045
b6499b5c3a70478882f0895485068952f469862b,0,sunyerui,2016-05-22 01:17:13+08:00,['8d178b91ffdedca077b27aef3e1170eced8433cd'],1,2,3,14630720,1,1,1,1,10045
60a254fa10ad16570eb19c7297a0bb713a70a86d,0,Yang Li,2016-05-22 12:45:15+08:00,['b6499b5c3a70478882f0895485068952f469862b'],16,26,42,14630762,1,0,0,1,10045
3adecb0620489e511ecd7a9b49ae49498696056a,0,Yang Li,2016-05-22 13:15:09+08:00,['60a254fa10ad16570eb19c7297a0bb713a70a86d'],0,5,5,14630767,4,,,,10045
af5965ccb76342a35b1313a1f606108f6db66ef7,1,Yang Li,2016-05-22 14:14:43+08:00,['3adecb0620489e511ecd7a9b49ae49498696056a'],19,156,175,14630942,5,0.411764706,0.441176471,0.941176471,10045
d8898932aa338983d3ff9c460306bd59e99782e5,0,Yang Li,2016-05-22 15:21:35+08:00,['af5965ccb76342a35b1313a1f606108f6db66ef7'],35,61,96,14631038,12,0,0,1,10045
444013b4bae91a0c2a410f03e4497b1500b418be,0,Yang Li,2016-05-22 15:25:53+08:00,['d8898932aa338983d3ff9c460306bd59e99782e5'],6,5,11,14631049,2,1,1,0,10045
f2f3d6866dd165020d468d8a1c9248562c446bad,0,Yang Li,2016-05-22 19:13:41+08:00,['444013b4bae91a0c2a410f03e4497b1500b418be'],5,0,5,14631054,1,0,0,0,10045
d56abdea858930be1df9e1772e323fd9cda31289,0,Yang Li,2016-05-22 21:23:47+08:00,['f2f3d6866dd165020d468d8a1c9248562c446bad'],165,253,418,14631472,28,0.785714286,0.428571429,1,10046
5512147df6722f306580b3671bcaffb1c6ec6ef4,1,lidongsjtu,2016-05-22 21:53:11+08:00,['d56abdea858930be1df9e1772e323fd9cda31289'],1,2,3,14631475,1,,,,10046
dd0edffc7135b23da5a95de09b217cdf9ebabe30,0,Yang Li,2016-05-23 06:48:59+08:00,['5512147df6722f306580b3671bcaffb1c6ec6ef4'],2,2,4,14631479,2,,,,10046
422b362ee7fcb8411c6e2891083e03fd5a2f7a2e,1,lidongsjtu,2016-05-23 09:44:07+08:00,['dd0edffc7135b23da5a95de09b217cdf9ebabe30'],38,363,401,14631880,8,0.525714286,0.657142857,0.994285714,10046
dc08186d570e16b37d9ddaab80aba28801cdb3d0,0,Li Yang,2016-05-23 10:52:45+08:00,['422b362ee7fcb8411c6e2891083e03fd5a2f7a2e'],1,12,13,14631893,2,,,,10046
e5c176a6a18dfdd0623c63c156ba53d21f949450,0,Li Yang,2016-05-23 13:56:41+08:00,['dc08186d570e16b37d9ddaab80aba28801cdb3d0'],39,15,54,14631947,4,1,1,1,10046
f674d26e70413d2eacf378c8318ba91cb347d610,1,lidongsjtu,2016-05-23 16:31:45+08:00,['e5c176a6a18dfdd0623c63c156ba53d21f949450'],331,153,484,14632431,6,0.705882353,0.676470588,0,10046
674ec3a0790e074f9bc550a66dc1774da7e16339,1,Yang Li,2016-05-24 09:08:08+08:00,['f674d26e70413d2eacf378c8318ba91cb347d610'],209,433,642,14633073,75,0.526315789,0.305263158,0.915789474,10048
7eb40054b1ff83a82af6fdbfe1431806e8241f89,0,lidongsjtu,2016-05-24 10:40:20+08:00,['674ec3a0790e074f9bc550a66dc1774da7e16339'],2,2,4,14633077,1,,,,10048
e6dd811f4f338d3c6e370e37f221e66dc68db0c8,0,lidongsjtu,2016-05-24 10:52:29+08:00,['7eb40054b1ff83a82af6fdbfe1431806e8241f89'],42,123,165,14633242,10,1,1,1,10048
f079800a26ac1a6947da3b26d749f6523174464b,1,lidongsjtu,2016-05-24 11:50:17+08:00,['e6dd811f4f338d3c6e370e37f221e66dc68db0c8'],12,18,30,14633272,3,1,1,1,10048
1c6fb899bb80a8208c4e3d897edb2eada3f5b62b,0,lidongsjtu,2016-05-24 13:17:41+08:00,['f079800a26ac1a6947da3b26d749f6523174464b'],12,85,97,14633369,6,1,1,1,10048
7397bc57d86b7247b6af7044a4b5d1affde4dafb,1,lidongsjtu,2016-05-24 13:49:54+08:00,['1c6fb899bb80a8208c4e3d897edb2eada3f5b62b'],14,22,36,14633405,1,0,0.2,1,10048
eb58f4f4119e67f39052f0681674b1b3bc52e824,0,lidongsjtu,2016-05-24 13:56:34+08:00,['7397bc57d86b7247b6af7044a4b5d1affde4dafb'],2,15,17,14633422,1,1,1,1,10048
258e765d724eae02e5934fe53ed74522f40dabc5,1,shaofengshi,2016-05-24 14:15:03+08:00,['eb58f4f4119e67f39052f0681674b1b3bc52e824'],2,3,5,14633427,1,0,1,0,10048
1ce81910afe049dc2bc6f9072c96ca441e93297c,0,lidongsjtu,2016-05-24 16:45:23+08:00,['258e765d724eae02e5934fe53ed74522f40dabc5'],0,1,1,14633428,1,,,,10048
a19b3ae86016512294468337785eae6f7a0f80f5,0,Jason,2016-05-24 16:56:34+08:00,['1ce81910afe049dc2bc6f9072c96ca441e93297c'],5,3,8,14633436,1,1,0,1,10048
a5bf99a25b5aa1caf1b6d47cb7d2e67563ff29c0,0,Jason,2016-05-24 16:56:34+08:00,['a19b3ae86016512294468337785eae6f7a0f80f5'],0,7,7,14633443,1,,,,10048
9fb1451a5c1f3ec0dcc8a0070bb38022c30c1a1c,0,shaofengshi,2016-05-24 17:58:45+08:00,['a5bf99a25b5aa1caf1b6d47cb7d2e67563ff29c0'],5,43,48,14633491,5,0.173913043,1,0.434782609,10049
83f1d248af3d97cfb6062369c3611fadcf34f027,0,lidongsjtu,2016-05-24 23:02:36+08:00,['9fb1451a5c1f3ec0dcc8a0070bb38022c30c1a1c'],17,16,33,14633524,17,,,,10049
1ed8615394c0c6fe6f991e2a37d68343f90cafe8,1,shaofengshi,2016-05-25 14:12:32+08:00,['83f1d248af3d97cfb6062369c3611fadcf34f027'],62,245,307,14633831,16,0.702380952,1,1,10050
10c7f39fa4b45079bbcf17c51ed5d223bea8efd7,0,shaofengshi,2016-05-25 16:24:33+08:00,['1ed8615394c0c6fe6f991e2a37d68343f90cafe8'],48,4,52,14633883,4,1,1,1,10050
ffbe1eebb5a85201eda00927f45509ac7b4421f5,1,lidongsjtu,2016-05-25 21:38:08+08:00,['10c7f39fa4b45079bbcf17c51ed5d223bea8efd7'],1,1,2,14633885,1,,,,10050
873c8a83e7513756bbf834b7d8bdc49ffad929dd,1,Li Yang,2016-05-26 14:00:01+08:00,['ffbe1eebb5a85201eda00927f45509ac7b4421f5'],3,2,5,14633890,2,,,,10050
af028f012c7d765374f279d265595f75b53358f2,0,lidongsjtu,2016-05-26 16:25:14+08:00,['873c8a83e7513756bbf834b7d8bdc49ffad929dd'],2,7,9,14633899,1,,,,10050
3d1cc3d049f454e83f984b8367ac925ee4a948e2,0,lidongsjtu,2016-05-26 17:09:22+08:00,['af028f012c7d765374f279d265595f75b53358f2'],24,24,48,14633947,21,,,,10050
11b0a5c5d4c49d2fede2242a31396b6a599a580e,0,lidongsjtu,2016-05-26 17:09:33+08:00,['3d1cc3d049f454e83f984b8367ac925ee4a948e2'],22,22,44,14633991,21,,,,10050
61c9e36013dc3590e59ba65a18b0ebaa86ae83cd,0,lidongsjtu,2016-05-26 17:12:16+08:00,['11b0a5c5d4c49d2fede2242a31396b6a599a580e'],1,1,2,14633993,1,,,,10050
bced8874818013abe9b1ac917e95e9e26bf4500e,0,shaofengshi,2016-05-26 21:15:17+08:00,['61c9e36013dc3590e59ba65a18b0ebaa86ae83cd'],1,2,3,14633996,1,0,1,1,10050
c79c59f887f7e1c86b8b0ca762f6b9d068ffbc47,0,shaofengshi,2016-05-26 21:15:17+08:00,['bced8874818013abe9b1ac917e95e9e26bf4500e'],0,9,9,14634005,1,1,1,1,10050
86f7149fc809203b45d1b0cb74c2f00a45082ba2,1,Zhong,2016-05-26 22:08:58+08:00,['c79c59f887f7e1c86b8b0ca762f6b9d068ffbc47'],3,5,8,14634013,1,,,,10050
3bca0bfe4d5fe9f9080a6bc2e38d6fc8e3c2069b,0,lidongsjtu,2016-05-27 13:52:19+08:00,['86f7149fc809203b45d1b0cb74c2f00a45082ba2'],6,10,16,14634029,3,1,1,1,10050
6845a358c2b7d56ee453bcb8d769d0fcb9b609ea,0,lidongsjtu,2016-05-27 13:54:50+08:00,['3bca0bfe4d5fe9f9080a6bc2e38d6fc8e3c2069b'],4,15,19,14634048,2,0.666666667,0.666666667,0.666666667,10050
8c1d0ff74082ffdb76e3eb9b6fa4e8fbfe6801c3,1,Yang Li,2016-05-28 22:00:55+08:00,['6845a358c2b7d56ee453bcb8d769d0fcb9b609ea'],433,599,1032,14635080,16,0.5,0.307692308,1,10052
a6a0c9bced1142b7d1917587c553f5d957ef3f67,1,Yang Li,2016-05-29 12:00:31+08:00,['8c1d0ff74082ffdb76e3eb9b6fa4e8fbfe6801c3'],14,20,34,14635114,4,0,0,1,10052
3ab5a80fb6dc082c880a3c08948bbf823f4b42df,0,lidongsjtu,2016-05-30 17:54:02+08:00,['a6a0c9bced1142b7d1917587c553f5d957ef3f67'],4,12,16,14635130,4,0.5,0.5,0.666666667,10052
a0f029a0d69a3c2427aa5216c5fdae96a5c6c82e,1,lidongsjtu,2016-05-30 22:47:43+08:00,['3ab5a80fb6dc082c880a3c08948bbf823f4b42df'],0,4,4,14635134,2,1,1,1,10052
79a7b47d3c18b2c65ee217bf2da3cb7fe44e134f,0,Yang Li,2016-05-31 08:12:47+08:00,['a0f029a0d69a3c2427aa5216c5fdae96a5c6c82e'],21,44,65,14635199,6,1,1,1,10052
cf48410dd4eac9a94d69557e5c6c364a5bcd3035,1,shaofengshi,2016-05-31 10:38:00+08:00,['79a7b47d3c18b2c65ee217bf2da3cb7fe44e134f'],5,6,11,14635210,3,0.75,0.75,1,10052
164d683599163510fb5303fc71d59c35a65f0191,0,lidongsjtu,2016-05-31 14:13:27+08:00,['cf48410dd4eac9a94d69557e5c6c364a5bcd3035'],55,32,87,14635297,3,,,,10053
789d22fe8b3922f83b1915abbcf5f4f221d76184,0,Li Yang,2016-05-31 18:33:52+08:00,['164d683599163510fb5303fc71d59c35a65f0191'],1,1,2,14635299,1,,,,10053
1c0cd2bf71e56a127b3a789f28b386c2159b218a,0,Li Yang,2016-05-31 18:33:59+08:00,['789d22fe8b3922f83b1915abbcf5f4f221d76184'],0,8,8,14635307,1,1,1,1,10053
e02f0bed299b69dabed51809811134591f21248e,1,lidongsjtu,2016-05-31 21:02:17+08:00,['1c0cd2bf71e56a127b3a789f28b386c2159b218a'],17,168,185,14635492,3,0.23,0.4,0.92,10054
9d5fa320358610546caebb4933601833fbc08740,0,shaofengshi,2016-06-01 12:19:10+08:00,['e02f0bed299b69dabed51809811134591f21248e'],48,24,72,14635564,20,0.153846154,0,1,10054
03d7ca555743b27745837af81e631e17aa99a3ff,0,shaofengshi,2016-06-01 12:36:11+08:00,['9d5fa320358610546caebb4933601833fbc08740'],2,1,3,14635567,1,,,,10054
5ab4194493a547e79acba210342477d55c9539eb,0,lidongsjtu,2016-06-01 15:06:49+08:00,['03d7ca555743b27745837af81e631e17aa99a3ff'],1,1,2,14635569,1,,,,10054
669916eff7f56c3316f20d00072644d0b66b8da3,0,lidongsjtu,2016-06-01 15:12:38+08:00,['5ab4194493a547e79acba210342477d55c9539eb'],0,17,17,14635586,1,0.1,0.1,1,10054
d6bb49984b59e07b3944d622a560e0d026b80bb2,1,Li Yang,2016-06-01 15:34:52+08:00,['669916eff7f56c3316f20d00072644d0b66b8da3'],243,289,532,14636118,3,0.363636364,1,1,10054
b312200e7862bfc44a3574af1b8686715e5dbad8,0,lidongsjtu,2016-06-01 17:25:47+08:00,['d6bb49984b59e07b3944d622a560e0d026b80bb2'],0,16,16,14636134,1,0.833333333,1,0.916666667,10054
69157bb123e657bff5c2b4041060acef2245e2e6,0,Li Yang,2016-06-01 18:45:29+08:00,['b312200e7862bfc44a3574af1b8686715e5dbad8'],0,10,10,14636144,1,1,1,1,10054
2d6cd529dab65f06a067eba4bbea16fde19e1476,1,Li Yang,2016-06-02 16:46:46+08:00,['69157bb123e657bff5c2b4041060acef2245e2e6'],45,52,97,14636241,1,0,0,1,10054
18516c5e77719a933b2d6b7fd48b13727f491a19,0,lidongsjtu,2016-06-03 10:02:20+08:00,['2d6cd529dab65f06a067eba4bbea16fde19e1476'],4,12,16,14636257,2,1,1,1,10054
e50faa3233ddccc4b3ec81b83bed03c59ff885a4,1,Zhong,2016-06-03 20:01:59+08:00,['18516c5e77719a933b2d6b7fd48b13727f491a19'],0,27,27,14636284,3,0.545454545,0.545454545,0.545454545,10054
6f6dcf00ca8b721222fb5f07f5e5ded3ec45e687,1,shaofengshi,2016-06-04 20:34:13+08:00,['e50faa3233ddccc4b3ec81b83bed03c59ff885a4'],1,2,3,14636287,1,0,0,1,10054
4018e6671f6f4e23f4493286881fa47f302c6372,1,shaofengshi,2016-06-04 20:58:30+08:00,['6f6dcf00ca8b721222fb5f07f5e5ded3ec45e687'],36,16,52,14636339,3,0.777777778,1,0.666666667,10054
7d9737796374b1542467798d8ccf99eda17d5610,0,Yang Li,2016-06-05 08:24:37+08:00,['4018e6671f6f4e23f4493286881fa47f302c6372'],1,2,3,14636342,2,,,,10055
ff36ab7b579a1e754daa3070f354fd813f338214,1,Yang Li,2016-06-05 08:25:49+08:00,['7d9737796374b1542467798d8ccf99eda17d5610'],20,2066,2086,14638428,15,0.411186697,0.682539683,0.700680272,10061
59aaeb3057442dbf621aeefc634db1ae1060daff,0,Yang Li,2016-06-05 08:25:49+08:00,['ff36ab7b579a1e754daa3070f354fd813f338214'],4,48,52,14638480,3,0.56097561,0.219512195,1,10061
5198b877e7cbedd361756dd9cd5addbef46d1ed8,1,Yang Li,2016-06-05 08:25:49+08:00,['59aaeb3057442dbf621aeefc634db1ae1060daff'],441,508,949,14639429,10,0.103448276,0.103448276,0.862068966,10061
ba7254a34438e170709a640fa6c5194eb026e7cf,1,Yang Li,2016-06-05 09:11:30+08:00,['5198b877e7cbedd361756dd9cd5addbef46d1ed8'],142,64,206,14639635,8,,,,10061
b8258e43e45490eb272c0c96f5110b89e9d0b982,0,lidongsjtu,2016-06-06 11:05:20+08:00,['ba7254a34438e170709a640fa6c5194eb026e7cf'],5,7,12,14639647,2,0,0,1,10061
9ad34ec98e91f18a4dac23ab05356894cf4586c8,0,lidongsjtu,2016-06-06 15:57:59+08:00,['b8258e43e45490eb272c0c96f5110b89e9d0b982'],1,1,2,14639649,1,,,,10061
a490224eea84fd400320f8e29732c7371a5d0a73,0,shaofengshi,2016-06-06 18:28:56+08:00,['9ad34ec98e91f18a4dac23ab05356894cf4586c8'],5,18,23,14639672,2,1,1,1,10061
9113a4675430a0baffb8d133ba29465c5cd70b4a,1,shaofengshi,2016-06-06 18:28:56+08:00,['a490224eea84fd400320f8e29732c7371a5d0a73'],107,261,368,14640040,11,0.491071429,0,0.8125,10062
4668bd31e010bec16d0a61f85cb4824ad42c237e,1,shaofengshi,2016-06-06 18:28:56+08:00,['9113a4675430a0baffb8d133ba29465c5cd70b4a'],7,15,22,14640062,1,0,0,0.166666667,10062
c5db387863ca7fa05c5eecf1c44082c605845d03,0,Yang Li,2016-06-06 22:26:21+08:00,['4668bd31e010bec16d0a61f85cb4824ad42c237e'],0,1,1,14640063,1,,,,10062
e924fc439595b1b6629ab4884296596b429d8e97,0,Yang Li,2016-06-07 08:23:56+08:00,['c5db387863ca7fa05c5eecf1c44082c605845d03'],3,2,5,14640068,1,,,,10062
9f1029a76f053d2fc83a1623db125fce648662f6,0,Jason,2016-06-07 14:56:24+08:00,['e924fc439595b1b6629ab4884296596b429d8e97'],1,2,3,14640071,1,0,1,1,10062
d2e96bda0a5848815cf4430746276bc9e896bad7,0,shaofengshi,2016-06-07 15:09:29+08:00,['9f1029a76f053d2fc83a1623db125fce648662f6'],8,18,26,14640097,2,0,1,1,10062
5d5a09e36835c8ddcaa16651a3a0810bfa03576c,0,shaofengshi,2016-06-07 16:19:06+08:00,['d2e96bda0a5848815cf4430746276bc9e896bad7'],2,2,4,14640101,1,,,,10062
0c94968598f157fe16058d77f5198c40f6defc09,0,Yang Li,2016-06-07 21:02:09+08:00,['5d5a09e36835c8ddcaa16651a3a0810bfa03576c'],6,14,20,14640121,5,0.75,1,1,10062
4e52d2fcb92aa337a47546d2fb28b1c5acbb79dd,1,Yang Li,2016-06-07 21:35:06+08:00,['0c94968598f157fe16058d77f5198c40f6defc09'],2,35,37,14640158,2,0,0,1,10063
800fbd2181a106890c05015f5137aad55637c15f,0,Yang Li,2016-06-07 21:44:33+08:00,['4e52d2fcb92aa337a47546d2fb28b1c5acbb79dd'],3,4,7,14640165,2,,,,10063
6788ee6e1aa925334c79bb422a09ea7957363537,0,Li Yang,2016-06-08 11:40:53+08:00,['800fbd2181a106890c05015f5137aad55637c15f'],0,3,3,14640168,1,1,1,1,10063
4a202d16d433314d1fb5cd90eaa9d4222a20f411,0,shaofengshi,2016-06-08 16:23:38+08:00,['6788ee6e1aa925334c79bb422a09ea7957363537'],9,19,28,14640196,1,0,0,1,10063
e7740c852e5db40e2c37527de2e99d81e3beb928,0,shaofengshi,2016-06-08 16:39:17+08:00,['4a202d16d433314d1fb5cd90eaa9d4222a20f411'],10,10,20,14640216,2,,,,10063
38a76b6dbd4ae7fa1921e85a7efb1fe8f5766f82,0,gaodayue,2016-06-08 18:05:28+08:00,['e7740c852e5db40e2c37527de2e99d81e3beb928'],0,1,1,14640217,1,,,,10063
97950611f6eb3de85c285e9a69135d0ce8317eb7,0,sunyerui,2016-06-08 19:37:05+08:00,['38a76b6dbd4ae7fa1921e85a7efb1fe8f5766f82'],2,1,3,14640220,2,,,,10063
b044ed7703575e036e9b8c1d0516d022c19a57fc,1,gaodayue,2016-06-09 20:41:48+08:00,['97950611f6eb3de85c285e9a69135d0ce8317eb7'],44,44,88,14640308,11,1,0.166666667,0.333333333,10063
2d80bac7b51e7326b0645613a983274a85145535,0,lidongsjtu,2016-06-10 23:30:38+08:00,['b044ed7703575e036e9b8c1d0516d022c19a57fc'],14,35,49,14640357,2,0.857142857,0.857142857,1,10063
a8c3f6b5d5401a2f640323d6c044a4560134e61e,0,lidongsjtu,2016-06-11 10:25:33+08:00,['2d80bac7b51e7326b0645613a983274a85145535'],1,7,8,14640365,1,,,,10063
7719a486a9e365db473e975107fcb9f9e78d05c9,0,lidongsjtu,2016-06-11 10:31:08+08:00,['a8c3f6b5d5401a2f640323d6c044a4560134e61e'],1,117,118,14640483,1,,,,10063
536f94c0c198561e4ea71a5255fa4e77b7f1a2dc,0,shaofengshi,2016-06-12 11:41:43+08:00,['7719a486a9e365db473e975107fcb9f9e78d05c9'],1,0,1,14640484,1,,,,10063
0ddd907b127907b08179d329ad7267f4a446092f,0,shaofengshi,2016-06-12 12:32:14+08:00,['536f94c0c198561e4ea71a5255fa4e77b7f1a2dc'],0,4,4,14640488,1,1,0,1,10063
b376e242d52757aa04ab2ed7b0b9777311699139,1,shaofengshi,2016-06-12 12:40:45+08:00,['0ddd907b127907b08179d329ad7267f4a446092f'],6,13,19,14640507,2,0.5,0,0,10063
e824c0f7b056ff56d613356651ba81d3272d83a0,0,Jason,2016-06-13 10:28:47+08:00,['b376e242d52757aa04ab2ed7b0b9777311699139'],0,24,24,14640531,1,1,1,1,10063
139768fcb6a2ed984178484e7fbd10c87d4f491a,0,Jason,2016-06-13 10:30:37+08:00,['e824c0f7b056ff56d613356651ba81d3272d83a0'],6,0,6,14640537,1,,,,10063
baaa33d2ab9f024d1610be7f6c7335da3eea2d45,1,lidongsjtu,2016-06-13 10:39:35+08:00,['139768fcb6a2ed984178484e7fbd10c87d4f491a'],9,27,36,14640573,3,0.222222222,0.222222222,1,10063
fde16e693098e287cf18aa64a7d1bea11272d2e7,1,sunyerui,2016-06-13 16:39:41+08:00,['baaa33d2ab9f024d1610be7f6c7335da3eea2d45'],15,32,47,14640620,4,0.15,0.95,1,10063
9a3c96bfebd6eb62ad2375a31a1cea6369f5da10,0,Li Yang,2016-06-14 10:17:37+08:00,['fde16e693098e287cf18aa64a7d1bea11272d2e7'],5,24,29,14640649,3,1,1,1,10063
0a354125455e8bd34dfa934134543b851f4c09d2,0,Li Yang,2016-06-14 16:43:11+08:00,['9a3c96bfebd6eb62ad2375a31a1cea6369f5da10'],11,54,65,14640714,2,0.484848485,0,0.545454545,10063
5b4cbc4b61e444093b88fdb4ba3d3afeba7468d3,1,shaofengshi,2016-06-15 09:52:47+08:00,['0a354125455e8bd34dfa934134543b851f4c09d2'],77,112,189,14640903,5,1,1,0,10063
5fee547422821fccfc2c800f14cacf88bc22aa8a,1,Li Yang,2016-06-15 11:22:02+08:00,['5b4cbc4b61e444093b88fdb4ba3d3afeba7468d3'],57,60,117,14641020,21,1,1,1,10063
8c05e078dd69125a0e7fac8eb7960ee3456e9c26,0,shaofengshi,2016-06-15 16:01:24+08:00,['5fee547422821fccfc2c800f14cacf88bc22aa8a'],0,1,1,14641021,1,1,1,1,10063
c965250b426b3f14aeb945c54ae6291c115ee631,1,Li Yang,2016-06-15 16:15:54+08:00,['8c05e078dd69125a0e7fac8eb7960ee3456e9c26'],10,25,35,14641056,2,0,0,1,10063
cdcde050d18ae72408f91cf2d3dc894a5798d319,0,shaofengshi,2016-06-15 16:47:02+08:00,['c965250b426b3f14aeb945c54ae6291c115ee631'],6,1,7,14641063,1,1,0,0,10063
7a05309bf528851d94312199c20c1e9766f27408,0,sunyerui,2016-06-15 16:50:07+08:00,['cdcde050d18ae72408f91cf2d3dc894a5798d319'],2,3,5,14641068,2,,,,10063
a179136beabcad7a2cbb766d448d9acf88194245,0,Hongbin Ma,2016-06-16 13:45:47+08:00,['7a05309bf528851d94312199c20c1e9766f27408'],2,4,6,14641074,1,,,,10063
930f397d8e763e91de4741b3b5dc1096668f3fc6,1,shaofengshi,2016-06-16 13:56:21+08:00,['a179136beabcad7a2cbb766d448d9acf88194245'],28,448,476,14641550,9,1,1,1,10067
b70ad40769c014d1e3e2041cae77754cad8e043a,1,zkld123,2016-06-16 16:09:21+08:00,['930f397d8e763e91de4741b3b5dc1096668f3fc6'],1,2,3,14641553,1,,,,10067
baac10b037fc761690cc839e226f3f2c9ecc97a4,1,zkld123,2016-06-16 16:18:21+08:00,['b70ad40769c014d1e3e2041cae77754cad8e043a'],1,1,2,14641555,1,,,,10067
74ce81c629bc3f6e6e0487ad0a1353479eb4fb2e,0,Li Yang,2016-06-17 10:50:25+08:00,['baac10b037fc761690cc839e226f3f2c9ecc97a4'],7,4,11,14641566,2,1,1,1,10067
c919ca2c7b59e0a25a4485a345d278edca2f7a60,0,sunyerui,2016-06-17 14:03:12+08:00,['74ce81c629bc3f6e6e0487ad0a1353479eb4fb2e'],3,4,7,14641573,1,,,,10067
a3769ce6a08cd3b62a96884d92c75e6cf5bb789f,0,sunyerui,2016-06-17 14:03:37+08:00,['c919ca2c7b59e0a25a4485a345d278edca2f7a60'],1,1,2,14641575,1,,,,10067
ad9586454f76e703cadd08e1f1aa469499079210,0,shaofengshi,2016-06-17 15:35:57+08:00,['a3769ce6a08cd3b62a96884d92c75e6cf5bb789f'],17,7,24,14641599,5,0.461538462,0.230769231,0.538461538,10067
03f40ddd722fc8b2c30d5987c0014ed44e89f81d,0,shaofengshi,2016-06-17 16:33:05+08:00,['ad9586454f76e703cadd08e1f1aa469499079210'],1,12,13,14641612,2,0,0,1,10067
5f2db8cc1970f2945d9f4df5487b4ef162f958b9,0,shaofengshi,2016-06-17 16:33:24+08:00,['03f40ddd722fc8b2c30d5987c0014ed44e89f81d'],3,3,6,14641618,1,,,,10067
2008fb0584790fbf5c8d6bb75316426b32197164,0,shaofengshi,2016-06-17 16:42:36+08:00,['5f2db8cc1970f2945d9f4df5487b4ef162f958b9'],9,7,16,14641634,2,1,1,1,10067
67e9f8981d9ea9b88582d912574f2ea3bc7f9e2b,0,Li Yang,2016-06-17 17:15:41+08:00,['2008fb0584790fbf5c8d6bb75316426b32197164'],1,5,6,14641640,2,0,0,0,10067
1b1e3977053a6568c424533f20e90cd4d44715ee,0,Yang Li,2016-06-18 07:13:42+08:00,['67e9f8981d9ea9b88582d912574f2ea3bc7f9e2b'],6,5,11,14641651,2,1,1,1,10067
35f3e639cd4d50932a5dc548a5199928657b6b1d,1,Yang Li,2016-06-18 09:06:43+08:00,['1b1e3977053a6568c424533f20e90cd4d44715ee'],77,577,654,14642305,15,0.736842105,0.833333333,0.76754386,10072
5ee5a3daeef4f54a037ff65009bd66d65587327e,0,Yang Li,2016-06-18 09:06:44+08:00,['35f3e639cd4d50932a5dc548a5199928657b6b1d'],8,10,18,14642323,1,,,,10072
a82662bcd1b1fd8cb476e07e6b679d89a1337a96,0,Yang Li,2016-06-18 09:06:44+08:00,['5ee5a3daeef4f54a037ff65009bd66d65587327e'],3,9,12,14642335,1,1,1,1,10072
8a96b57f066ed58d55339d3b8e18bbf51c45ec34,1,Yang Li,2016-06-19 14:15:51+08:00,['a82662bcd1b1fd8cb476e07e6b679d89a1337a96'],184,157,341,14642676,16,0.666666667,0.523809524,1,10073
11e20adbdfc1ed2de34280d50b90176f59d1760a,0,Yang Li,2016-06-19 14:29:01+08:00,['8a96b57f066ed58d55339d3b8e18bbf51c45ec34'],1,2,3,14642679,1,,,,10073
762992d0ac981549f91587a73144e2d554662425,0,Hongbin Ma,2016-06-20 11:44:06+08:00,['11e20adbdfc1ed2de34280d50b90176f59d1760a'],6,6,12,14642691,3,,,,10073
76d60b66c59dfea78734e33fac9c5aa3535bff34,0,Zhong,2016-06-20 12:22:21+08:00,['762992d0ac981549f91587a73144e2d554662425'],8,31,39,14642730,1,0.684210526,0,0.842105263,10073
c4731de61faf3806cdba8a312d3ef66feaece14d,1,Zhong,2016-06-20 12:49:43+08:00,['76d60b66c59dfea78734e33fac9c5aa3535bff34'],11,41,52,14642782,1,0.85,0.85,1,10073
57727187ced348a5f87ea4b11f243cb170e196e1,0,lidongsjtu,2016-06-21 15:39:26+08:00,['c4731de61faf3806cdba8a312d3ef66feaece14d'],2,2,4,14642786,2,,,,10073
a80a0f7346247af607bb17f31845b1ecb0697330,1,Li Yang,2016-06-22 11:26:26+08:00,['57727187ced348a5f87ea4b11f243cb170e196e1'],9,20,29,14642815,1,0.375,0,1,10073
ce7fcdf37bcf6d1298b5cfe07b7ff148c195c59f,0,Li Yang,2016-06-22 11:29:02+08:00,['a80a0f7346247af607bb17f31845b1ecb0697330'],1,2,3,14642818,1,0,0,1,10073
ff1c81395259ba7e1d26a91bc9dbe47d18397f32,0,Li Yang,2016-06-22 11:47:02+08:00,['ce7fcdf37bcf6d1298b5cfe07b7ff148c195c59f'],2,5,7,14642825,1,1,1,1,10073
64b5f86fec6fce643cbd0f0f5a966ddc919dfbed,0,Hongbin Ma,2016-06-22 14:00:15+08:00,['ff1c81395259ba7e1d26a91bc9dbe47d18397f32'],69,91,160,14642985,7,1,0,0.166666667,10074
ea244504e5fa66ef14923f6665bbdbafcd8c28e2,0,Hongbin Ma,2016-06-22 14:00:15+08:00,['64b5f86fec6fce643cbd0f0f5a966ddc919dfbed'],70,22,92,14643077,5,0.590909091,1,0.181818182,10074
b361d8aaa2b1b5d0d86107bedb9f34397be000a5,0,Hongbin Ma,2016-06-22 14:00:15+08:00,['ea244504e5fa66ef14923f6665bbdbafcd8c28e2'],54,70,124,14643201,5,0,1,0.909090909,10074
5fd26125b08e080fcc2d4734b665d4a5994e43d4,0,lidongsjtu,2016-06-22 14:16:32+08:00,['b361d8aaa2b1b5d0d86107bedb9f34397be000a5'],0,24,24,14643225,1,0.923076923,0.923076923,1,10074
97bfd574796047b5a7e818f17620bae1f67e27f3,0,Hongbin Ma,2016-06-22 14:47:36+08:00,['5fd26125b08e080fcc2d4734b665d4a5994e43d4'],4,4,8,14643233,1,,,,10074
48e164924944a6f945a9d1e20828967146201695,0,Li Yang,2016-06-22 16:58:07+08:00,['97bfd574796047b5a7e818f17620bae1f67e27f3'],38,88,126,14643359,13,0.547619048,0.214285714,0.738095238,10074
edab8d03a21da4ef6637f0b74568da0286e6746c,0,Li Yang,2016-06-22 17:06:01+08:00,['48e164924944a6f945a9d1e20828967146201695'],2,2,4,14643363,1,,,,10074
bfee5ed44df0ec697e8ac0a50675881fd34de378,0,shaofengshi,2016-06-22 17:21:12+08:00,['edab8d03a21da4ef6637f0b74568da0286e6746c'],2,4,6,14643369,1,,,,10074
94567c150e94d0f6499bb26621869c83d117c5a4,1,Hongbin Ma,2016-06-22 17:52:03+08:00,['bfee5ed44df0ec697e8ac0a50675881fd34de378'],12,69,81,14643450,15,1,1,0,10074
9b8a9899b3147920964063a07a4da56d2cac3bf4,0,lidongsjtu,2016-06-22 18:42:00+08:00,['94567c150e94d0f6499bb26621869c83d117c5a4'],1,1,2,14643452,1,,,,10074
c736ee5fe8009c28f5e016d24c5f113940bc11cf,0,Hongbin Ma,2016-06-22 19:06:41+08:00,['9b8a9899b3147920964063a07a4da56d2cac3bf4'],5,43,48,14643500,1,0,1,0,10074
91d6798d47db0e4c3f20578d8d81f4390b082fdb,0,Hongbin Ma,2016-06-22 19:07:24+08:00,['c736ee5fe8009c28f5e016d24c5f113940bc11cf'],1,1,2,14643502,1,,,,10074
def979d9ce0507840e4bb35f5de935e303b58688,1,Yang Li,2016-06-22 21:10:52+08:00,['91d6798d47db0e4c3f20578d8d81f4390b082fdb'],28,61,89,14643591,2,1,1,1,10074
8d8ec0636cc1a66e1e3969dcd0b78a439ec420f4,0,Yang Li,2016-06-22 21:56:53+08:00,['def979d9ce0507840e4bb35f5de935e303b58688'],12,24,36,14643627,1,0,0,1,10074
b514ae16a1487537601f37427b84f864be4ad2f2,0,Li Yang,2016-06-23 12:00:50+08:00,['8d8ec0636cc1a66e1e3969dcd0b78a439ec420f4'],178,28,206,14643833,7,0.23880597,0,0,10074
1b0ece4a433ca3417d13a6d5fc7b5c1e503e341b,1,Hongbin Ma,2016-06-23 12:04:43+08:00,['b514ae16a1487537601f37427b84f864be4ad2f2'],45,147,192,14644025,15,0,0.615384615,1,10075
62ae3cb165126404b1ef95009ff1095fe39e2441,0,Hongbin Ma,2016-06-23 13:58:17+08:00,['1b0ece4a433ca3417d13a6d5fc7b5c1e503e341b'],1,1,2,14644027,1,,,,10075
4fd74fc6a7d7c9bcccab38b57da76f2b983cf5ef,1,Hongbin Ma,2016-06-23 16:37:09+08:00,['62ae3cb165126404b1ef95009ff1095fe39e2441'],360,399,759,14644786,6,1,1,1,10076
c7439a0a4281d1633437f268fdb5d44fbcd6cde1,1,Yang Li,2016-06-24 08:10:39+08:00,['4fd74fc6a7d7c9bcccab38b57da76f2b983cf5ef'],46,20,66,14644852,4,1,1,1,10076
842f590af8af2c95d08e7409ea719ef62b18807e,0,Hongbin Ma,2016-06-24 09:52:26+08:00,['c7439a0a4281d1633437f268fdb5d44fbcd6cde1'],14,17,31,14644883,1,0,0,0,10076
dd1fea3f5dadfa0b2ce74d6bfcef925174b19998,0,Li Yang,2016-06-24 10:55:42+08:00,['842f590af8af2c95d08e7409ea719ef62b18807e'],11,7,18,14644901,1,1,0,0,10076
4ffe818e2a0e0b933a7691dea4fbc416c2a5e368,0,shaofengshi,2016-06-24 13:26:54+08:00,['dd1fea3f5dadfa0b2ce74d6bfcef925174b19998'],0,6,6,14644907,1,,,,10076
25081d928ef081c343044af3587dc7e2830a4a46,0,shaofengshi,2016-06-24 15:17:33+08:00,['4ffe818e2a0e0b933a7691dea4fbc416c2a5e368'],1,55,56,14644963,3,,,,10077
1e63f670237e4fa3309f97e2cf9eae750cb3df60,0,Li Yang,2016-06-24 16:57:06+08:00,['25081d928ef081c343044af3587dc7e2830a4a46'],0,5,5,14644968,1,1,1,1,10077
f26f702a6e560347cb2489f468589be28c2834ad,1,Yang Li,2016-06-25 09:41:24+08:00,['1e63f670237e4fa3309f97e2cf9eae750cb3df60'],1,1,2,14644970,1,,,,10077
5d4982e247a2172d97d44c85309cef4b3dbfce09,1,Hongbin Ma,2016-06-25 19:10:05+08:00,['f26f702a6e560347cb2489f468589be28c2834ad'],15948,17193,33141,14678111,439,0.956382296,0.445798589,0.307889673,10096
81e3b2cd3d0ee4632b95d80d54aafd355b541726,1,Hongbin Ma,2016-06-25 20:18:23+08:00,['5d4982e247a2172d97d44c85309cef4b3dbfce09'],78,68,146,14678257,18,0.894736842,0.736842105,0.578947368,10096
ef226f60155cbbbc9783e59c9459d09ca6ecb167,0,Hongbin Ma,2016-06-25 21:19:29+08:00,['81e3b2cd3d0ee4632b95d80d54aafd355b541726'],5,4,9,14678266,3,1,1,0,10096
780d002fbac3b20a5d8194957ed9008d84d71ad1,1,Yang Li,2016-06-25 22:08:32+08:00,['ef226f60155cbbbc9783e59c9459d09ca6ecb167'],104,86,190,14678456,8,0.605263158,0.605263158,0,10096
af093f76e4e503d2c73303db8f8828248a67f371,1,Yang Li,2016-06-25 22:30:16+08:00,['780d002fbac3b20a5d8194957ed9008d84d71ad1'],44,175,219,14678675,27,0,1,1,10096
1a124e68faab349f34f5f47e5e144a8854172f41,1,Yang Li,2016-06-26 07:34:01+08:00,['af093f76e4e503d2c73303db8f8828248a67f371'],866,1396,2262,14680937,95,,,,10100
e9a36c6c5d47b67ab1a8b0bd3361a77001e06080,0,Yang Li,2016-06-26 07:56:51+08:00,['1a124e68faab349f34f5f47e5e144a8854172f41'],2,2,4,14680941,1,,,,10100
d5b3f7501be7a9ebd6a62091e129fec6f2696072,0,Yang Li,2016-06-26 10:14:17+08:00,['e9a36c6c5d47b67ab1a8b0bd3361a77001e06080'],46,47,93,14681034,23,0,0,0,10100
1015daedf108c1490673915ee37ca1c7d2d61562,0,Yang Li,2016-06-26 15:21:15+08:00,['d5b3f7501be7a9ebd6a62091e129fec6f2696072'],1,1,2,14681036,1,,,,10100
5bf6582f66bedb5d25baaa0d82ae193892b97e0c,1,Yang Li,2016-06-26 20:21:35+08:00,['1015daedf108c1490673915ee37ca1c7d2d61562'],1,15,16,14681052,2,0,0.5,1,10100
e5b97b0e8957e90e9563162d399f291c1dfaea6e,0,Yang Li,2016-06-26 21:51:09+08:00,['5bf6582f66bedb5d25baaa0d82ae193892b97e0c'],2,3,5,14681057,2,,,,10100
1044f1dbb1096689ff69601f2b631f37a9a59c3b,0,Li Yang,2016-06-27 08:44:46+08:00,['e5b97b0e8957e90e9563162d399f291c1dfaea6e'],1,1,2,14681059,1,,,,10100
7b46ed14cee13c2c47a7158e413ba742e9f4660c,0,Hongbin Ma,2016-06-27 09:55:52+08:00,['1044f1dbb1096689ff69601f2b631f37a9a59c3b'],5187,5596,10783,14691842,53,,,,10103
d384752f68acb1cb5e0b7666cde5304ddd6a3885,0,Hongbin Ma,2016-06-27 10:43:50+08:00,['7b46ed14cee13c2c47a7158e413ba742e9f4660c'],30,4,34,14691876,27,,,,10103
50c948ce5026b34eb90b73ad29d82ff66c918487,0,Hongbin Ma,2016-06-27 10:58:41+08:00,['d384752f68acb1cb5e0b7666cde5304ddd6a3885'],2,724,726,14692602,11,,,,10113
07c242e8df80e4706bb2d880e340e94bf297ba54,0,Hongbin Ma,2016-06-27 11:06:20+08:00,['50c948ce5026b34eb90b73ad29d82ff66c918487'],724,2,726,14693328,11,,,,10113
16d178998204301384b92aac313f7d486ac45186,0,Li Yang,2016-06-28 15:37:21+08:00,['07c242e8df80e4706bb2d880e340e94bf297ba54'],0,2,2,14693330,1,,,,10114
7043f144bbb20ce691ab0a436370c4ef169da662,1,Li Yang,2016-06-28 18:31:24+08:00,['16d178998204301384b92aac313f7d486ac45186'],197,211,408,14693738,2,1,1,1,10114
90a234e3d893edd1993aeb2ff89c346a41fd41e7,1,shaofengshi,2016-06-29 11:31:50+08:00,['7043f144bbb20ce691ab0a436370c4ef169da662'],8,5,13,14693751,2,,,,10114
b5bed249725fdc03a945b1fff2f209770c8f26dc,0,Li Yang,2016-06-30 10:34:51+08:00,['90a234e3d893edd1993aeb2ff89c346a41fd41e7'],19,25,44,14693795,2,0.285714286,1,1,10114
b075d25fab401d30f13dfcb17425ee72a07c004e,0,Li Yang,2016-06-30 10:43:39+08:00,['b5bed249725fdc03a945b1fff2f209770c8f26dc'],25,19,44,14693839,2,0.714285714,0,0,10114
83211221563df357bb78857fb9cde9db593841bf,0,lidongsjtu,2016-06-30 11:05:35+08:00,['b075d25fab401d30f13dfcb17425ee72a07c004e'],53,62,115,14693954,3,0,0,1,10114
07511d7bc665008db85c45a003486c01f3d9c8da,0,Hongbin Ma,2016-06-30 15:11:09+08:00,['83211221563df357bb78857fb9cde9db593841bf'],1,20,21,14693975,2,1,1,1,10114
bf9c18c7cf9b18686679941f6c6a07b0e8957b30,0,lidongsjtu,2016-07-01 10:15:50+08:00,['07511d7bc665008db85c45a003486c01f3d9c8da'],0,1,1,14693976,1,,,,10114
561cd0b98c050c66a3ef7e7d73df9670b48055c8,0,Li Yang,2016-07-01 18:31:49+08:00,['bf9c18c7cf9b18686679941f6c6a07b0e8957b30'],3,3,6,14693982,1,,,,10114
c7a8b389fbd94ba7f11d5a011ff25691c197c57b,1,lidongsjtu,2016-07-04 09:46:10+08:00,['561cd0b98c050c66a3ef7e7d73df9670b48055c8'],65,72,137,14694119,12,0.166666667,0.833333333,1,10114
bac0aa15321f7235c1cb517af2b7b3b5b86dd8a3,0,lidongsjtu,2016-07-04 16:39:43+08:00,['c7a8b389fbd94ba7f11d5a011ff25691c197c57b'],1,1,2,14694121,1,,,,10114
6f6d7790532668a5d30c2f5ad4e2c3062353ea87,1,Li Yang,2016-07-05 10:44:37+08:00,['bac0aa15321f7235c1cb517af2b7b3b5b86dd8a3'],0,15,15,14694136,1,0,0,1,10114
13ae6614f6ea98182dc048288fd05d3ec3be7803,0,Li Yang,2016-07-05 10:57:56+08:00,['6f6d7790532668a5d30c2f5ad4e2c3062353ea87'],5,6,11,14694147,1,0,0,1,10114
56071064f085e72373446bde00143b4e1de7e454,1,Li Yang,2016-07-05 16:43:40+08:00,['13ae6614f6ea98182dc048288fd05d3ec3be7803'],6,9,15,14694162,2,1,1,1,10114
ff1aec306b5ab1dbdc12accc3e5ca6bd0099778c,0,Li Yang,2016-07-05 16:50:49+08:00,['56071064f085e72373446bde00143b4e1de7e454'],2,1,3,14694165,1,,,,10114
1397bbb5d51f06a53f88fc9621bb688229bfba26,1,Li Yang,2016-07-05 16:59:06+08:00,['ff1aec306b5ab1dbdc12accc3e5ca6bd0099778c'],341,97,438,14694603,7,0,0.328358209,0.223880597,10114
acf1bc331ffe1d7655d6dbafcb8baadf4ad66fe8,1,Li Yang,2016-07-05 16:59:06+08:00,['1397bbb5d51f06a53f88fc9621bb688229bfba26'],2,2,4,14694607,1,,,,10114
4cd733a1465a5641229954afa5d8a6349cc6bb8a,0,Hongbin Ma,2016-07-06 18:03:19+08:00,['acf1bc331ffe1d7655d6dbafcb8baadf4ad66fe8'],0,10,10,14694617,1,0.875,1,1,10114
edfb37d08c94294801307c396b94df103b8706c8,1,Hongbin Ma,2016-07-07 15:31:56+08:00,['4cd733a1465a5641229954afa5d8a6349cc6bb8a'],18,35,53,14694670,3,0,1,1,10114
db5f89bae53c9fa84c96c5c4693a142a136ef1fe,0,Hongbin Ma,2016-07-07 17:06:40+08:00,['edfb37d08c94294801307c396b94df103b8706c8'],582,23,605,14695275,4,0.381107492,0.198697068,0.143322476,10114
cd5e603dd55a785a3c23e92b1c24c3e8200f342f,0,Hongbin Ma,2016-07-07 17:37:02+08:00,['db5f89bae53c9fa84c96c5c4693a142a136ef1fe'],6,6,12,14695287,4,,,,10114
2cc0b9c43f77624dfaa09b6410a818ac020fb475,1,Hongbin Ma,2016-07-08 15:14:37+08:00,['cd5e603dd55a785a3c23e92b1c24c3e8200f342f'],14351,11,14362,14709649,111,0.407292256,0.240814019,0.093697004,10114
43b4e4ac0a9359341112312057781c3765ea8cb7,0,Hongbin Ma,2016-07-08 15:38:10+08:00,['2cc0b9c43f77624dfaa09b6410a818ac020fb475'],9,5,14,14709663,1,0,0,0,10114
7dc8b06c0c90e2df64a10d27487f1ba8422a2908,0,Li Yang,2016-07-08 18:09:10+08:00,['43b4e4ac0a9359341112312057781c3765ea8cb7'],0,25,25,14709688,1,,,,10115
6b45c945af9948c17a971d530c0153b3564f1985,0,Li Yang,2016-07-08 18:13:55+08:00,['7dc8b06c0c90e2df64a10d27487f1ba8422a2908'],9,37,46,14709734,2,0.157894737,1,1,10115
d48b9aac1ecc03ab8945cc75384c0d295cc2c47d,0,Li Yang,2016-07-08 18:22:32+08:00,['6b45c945af9948c17a971d530c0153b3564f1985'],0,4,4,14709738,1,1,1,1,10115
f30862eb6a4b2b6c0a2a8c0dbf8e124bf5c6cb9f,1,shaofengshi,2016-07-09 15:20:30+08:00,['d48b9aac1ecc03ab8945cc75384c0d295cc2c47d'],128,51,179,14709917,6,0,0,0,10115
03f445307691d07b4222d6dea380457d968c0c70,1,Hongbin Ma,2016-07-10 14:24:33+08:00,['f30862eb6a4b2b6c0a2a8c0dbf8e124bf5c6cb9f'],2,2,4,14709921,1,,,,10115
c098c6b408d7c48695ff22e96b6d690220e3e441,0,lidongsjtu,2016-07-10 16:26:32+08:00,['03f445307691d07b4222d6dea380457d968c0c70'],0,26,26,14709947,2,0,0.041666667,1,10115
e3edf536c3cb81004a46d4d6545ddc6b6246833b,0,Jason,2016-07-10 20:32:04+08:00,['c098c6b408d7c48695ff22e96b6d690220e3e441'],4,11,15,14709962,3,0.5,0.5,0.5,10115
e89af6c2242f9b593d0ef8ba9e6bbb9b9e949922,0,Li Yang,2016-07-11 03:07:43+08:00,['e3edf536c3cb81004a46d4d6545ddc6b6246833b'],1,1,2,14709964,1,,,,10115
47feb29d681a68663a78c3a189337740a6775268,0,shaofengshi,2016-07-11 10:50:52+08:00,['e89af6c2242f9b593d0ef8ba9e6bbb9b9e949922'],3,3,6,14709970,1,,,,10115
41c372659e916cef0125246a58b8d18b7d51de37,0,shaofengshi,2016-07-11 10:51:06+08:00,['47feb29d681a68663a78c3a189337740a6775268'],1,1,2,14709972,1,,,,10115
ccc83cd1d2c27af0cf9dacd7fbb7f64ea1857b28,0,shaofengshi,2016-07-11 10:51:18+08:00,['41c372659e916cef0125246a58b8d18b7d51de37'],1,1,2,14709974,1,,,,10115
5bce12cd885c3b9130c64274db9057a130307951,0,shaofengshi,2016-07-11 10:51:36+08:00,['ccc83cd1d2c27af0cf9dacd7fbb7f64ea1857b28'],1,18,19,14709993,2,,,,10115
4528ff630415b2834c60d0b40713e6dbe2d80cff,0,shaofengshi,2016-07-11 10:51:53+08:00,['5bce12cd885c3b9130c64274db9057a130307951'],9,3,12,14710005,1,0,0,0,10115
9c578e70900a0292b7cb6d0f0b1719839b8c20bb,0,gaodayue,2016-07-11 10:58:06+08:00,['4528ff630415b2834c60d0b40713e6dbe2d80cff'],10,4,14,14710019,2,,,,10115
9595b160340a08398e0fe5de0ec5cbcf954e1ebb,0,Li Yang,2016-07-11 13:59:34+08:00,['9c578e70900a0292b7cb6d0f0b1719839b8c20bb'],60,12,72,14710091,7,,,,10115
80bb6f75d75990d5b9c381eb4fe89a42bbe8d971,0,shaofengshi,2016-07-11 14:33:21+08:00,['9595b160340a08398e0fe5de0ec5cbcf954e1ebb'],1,2,3,14710094,1,1,1,1,10115
23d73ef3bee464dec5abaf2188d86598f8493178,1,Hongbin Ma,2016-07-12 11:39:34+08:00,['80bb6f75d75990d5b9c381eb4fe89a42bbe8d971'],6,25,31,14710125,5,1,1,1,10115
ac347fd1e456bacd3f11ea92c47e4f33ea3d4b43,1,Hongbin Ma,2016-07-12 11:39:34+08:00,['23d73ef3bee464dec5abaf2188d86598f8493178'],1,1,2,14710127,1,,,,10115
47a7cbeb9c2879c7301fe7c9c94cfde0d6caf4a5,1,Hongbin Ma,2016-07-12 14:24:45+08:00,['ac347fd1e456bacd3f11ea92c47e4f33ea3d4b43'],1,9,10,14710137,1,0,0,1,10115
62ccd7a26ad2871f1547411263200c08c8520bd9,1,lidongsjtu,2016-07-12 15:03:47+08:00,['47a7cbeb9c2879c7301fe7c9c94cfde0d6caf4a5'],7,214,221,14710358,4,0.172932331,0.315789474,0.616541353,10116
92d57ec2e9379f399f3f7138cee6945694e6b6d6,1,Hongbin Ma,2016-07-12 16:05:14+08:00,['62ccd7a26ad2871f1547411263200c08c8520bd9'],34,32,66,14710424,11,0.333333333,0.333333333,1,10116
a1f4ef4336798591c9b4b060c204cda00d4d79de,0,Hongbin Ma,2016-07-12 16:08:24+08:00,['92d57ec2e9379f399f3f7138cee6945694e6b6d6'],0,3,3,14710427,1,0,0,1,10116
170d826bf2d27e625e1d4e1a9b00149098b16197,0,lidongsjtu,2016-07-12 18:06:26+08:00,['a1f4ef4336798591c9b4b060c204cda00d4d79de'],1,3,4,14710431,1,0,1,1,10116
95eb2ff7a648e686ec2658bde6849a91c7e5c222,0,lidongsjtu,2016-07-12 18:20:59+08:00,['170d826bf2d27e625e1d4e1a9b00149098b16197'],0,2,2,14710433,1,,,,10116
48180ec5f1d1315e952fd719ba0b640b2eab312a,0,Jason,2016-07-12 20:25:25+08:00,['95eb2ff7a648e686ec2658bde6849a91c7e5c222'],8,86,94,14710527,3,1,1,0.638297872,10116
e3b8be38c855ee1395fd4765462702215efe76bb,0,Jason,2016-07-12 20:25:25+08:00,['48180ec5f1d1315e952fd719ba0b640b2eab312a'],978,1923,2901,14713428,45,,,,10116
2b1f997e084b1f4153a3345971fe87a27380c3c0,0,Jason,2016-07-12 20:25:25+08:00,['e3b8be38c855ee1395fd4765462702215efe76bb'],58,165,223,14713651,3,0.486486486,0.594594595,0.891891892,10116
076419ea52b6f3ab1782484e4e10514fe9def0a7,0,Jason,2016-07-12 20:40:23+08:00,['2b1f997e084b1f4153a3345971fe87a27380c3c0'],2,2,4,14713655,1,,,,10116
49a0a41f0de9fbd8012373f2d2b7f70cf0cd9896,1,Hongbin Ma,2016-07-13 17:52:14+08:00,['076419ea52b6f3ab1782484e4e10514fe9def0a7'],29,33,62,14713717,3,1,1,1,10116
bb1cbda97ba9278e3ee77f1df593cc533b89dc75,0,Hongbin Ma,2016-07-14 14:49:03+08:00,['49a0a41f0de9fbd8012373f2d2b7f70cf0cd9896'],165,131,296,14714013,11,1,0,0,10116
ef740132f09cea11ea758a57f478750e3ce1025c,0,Hongbin Ma,2016-07-14 16:34:48+08:00,['bb1cbda97ba9278e3ee77f1df593cc533b89dc75'],2,2,4,14714017,1,,,,10116
86ddae64a1f3d46631d1c80ebc26499695b993e9,0,shaofengshi,2016-07-14 21:44:10+08:00,['ef740132f09cea11ea758a57f478750e3ce1025c'],0,6,6,14714023,1,1,1,1,10116
3299b0fa0a6ed0304bd284bc8188db0590070055,1,shaofengshi,2016-07-14 22:02:23+08:00,['86ddae64a1f3d46631d1c80ebc26499695b993e9'],0,2,2,14714025,1,0,0,1,10116
7e3727a731210a18eb55f349a1b508a6885278c5,0,Hongbin Ma,2016-07-15 11:20:11+08:00,['3299b0fa0a6ed0304bd284bc8188db0590070055'],4,19,23,14714048,2,0,0,0.533333333,10116
03f43fa7c4a01a3fff62fd6c1ce55d29d03eb4e1,0,lidongsjtu,2016-07-15 18:19:03+08:00,['7e3727a731210a18eb55f349a1b508a6885278c5'],2,3,5,14714053,1,1,1,1,10116
928baafa2350260ff598653f1149e74289a1aa77,0,shaofengshi,2016-07-18 18:50:28+08:00,['03f43fa7c4a01a3fff62fd6c1ce55d29d03eb4e1'],21,4,25,14714078,2,1,1,0.066666667,10116
30fb1e060b61a099d3cc4b018996fce2395f0c0a,0,shaofengshi,2016-07-18 18:50:36+08:00,['928baafa2350260ff598653f1149e74289a1aa77'],55,364,419,14714497,4,0.146788991,0.646788991,0.958715596,10117
5ea33f21776a2c546dbe835cf101e25c003ad55b,0,shaofengshi,2016-07-18 18:50:43+08:00,['30fb1e060b61a099d3cc4b018996fce2395f0c0a'],16,36,52,14714549,3,1,1,1,10117
0aea876f800476b5741a72179044376cac178510,1,Hongbin Ma,2016-07-18 19:13:43+08:00,['5ea33f21776a2c546dbe835cf101e25c003ad55b'],70,60,130,14714679,9,0,0,0,10117
a8dd0ec91de8455f2bf2252832b0cf822fc74e44,0,shaofengshi,2016-07-18 21:36:06+08:00,['0aea876f800476b5741a72179044376cac178510'],0,16,16,14714695,1,0.923076923,0.923076923,0.923076923,10117
19f9ef070bf47e0bc955ba7621a90ed4ef5b961c,0,Jason,2016-07-18 23:03:24+08:00,['a8dd0ec91de8455f2bf2252832b0cf822fc74e44'],181,60,241,14714936,4,0,0,0.5,10117
2f1ae8d45593bb940d6ba10af97fdea784f09f4d,1,shaofengshi,2016-07-19 10:43:21+08:00,['19f9ef070bf47e0bc955ba7621a90ed4ef5b961c'],0,18,18,14714954,2,,,,10117
faa95232701390457063d74f00a15b00267d16d9,0,shaofengshi,2016-07-19 10:43:29+08:00,['2f1ae8d45593bb940d6ba10af97fdea784f09f4d'],0,69,69,14715023,4,,,,10117
960bb953c62366696fc01e4352e4b228e2ea1571,0,shaofengshi,2016-07-19 11:03:12+08:00,['faa95232701390457063d74f00a15b00267d16d9'],2,2,4,14715027,1,,,,10117
5f70f3debbaab3a55fef68f0ecd3874b4bd7fede,0,Hongbin Ma,2016-07-19 13:59:24+08:00,['960bb953c62366696fc01e4352e4b228e2ea1571'],1,1,2,14715029,1,,,,10117
3dbb5016cd401be15dbcca1e22d04417cbae5d9f,1,Jason,2016-07-19 14:05:03+08:00,['5f70f3debbaab3a55fef68f0ecd3874b4bd7fede'],35,28,63,14715092,3,0.083333333,0,0,10117
f8745f35dfbbb577d78ee5527d550bd23c6fe58f,0,Hongbin Ma,2016-07-19 14:50:00+08:00,['3dbb5016cd401be15dbcca1e22d04417cbae5d9f'],6,20,26,14715118,2,,,,10117
1cd4ad8c10282a63ac2fc8258e9a5d09077bd460,0,Jason,2016-07-19 18:49:10+08:00,['f8745f35dfbbb577d78ee5527d550bd23c6fe58f'],1,1,2,14715120,1,,,,10117
819e660ee17361db92c20bfd28068a308334c7a7,0,Zhong,2016-07-20 10:48:21+08:00,['1cd4ad8c10282a63ac2fc8258e9a5d09077bd460'],2,15,17,14715137,1,1,1,1,10117
554874db3af85a9cf8dd1989525511d566dec2af,1,Hongbin Ma,2016-07-20 11:26:12+08:00,['819e660ee17361db92c20bfd28068a308334c7a7'],8,27,35,14715172,3,0.294117647,0.588235294,0.705882353,10117
1462371a59c9ff7eb3494076dcf3d7138edf62f8,0,Zhong,2016-07-20 14:20:10+08:00,['554874db3af85a9cf8dd1989525511d566dec2af'],1,1,2,14715174,1,,,,10117
07177caf7062ec3b631324924a35b6a02e1bde94,0,Zhong,2016-07-20 14:20:10+08:00,['1462371a59c9ff7eb3494076dcf3d7138edf62f8'],17,15,32,14715206,1,1,1,0,10117
44ee970ca27aa8685cbef492d6e9e500f042b6f0,0,Zhong,2016-07-20 14:20:10+08:00,['07177caf7062ec3b631324924a35b6a02e1bde94'],1,0,1,14715207,1,1,1,0,10117
696fb89aa2eb684408d1009218f80fe323dffd3b,0,Hongbin Ma,2016-07-20 17:19:34+08:00,['44ee970ca27aa8685cbef492d6e9e500f042b6f0'],7,45,52,14715259,4,0.3,0.3,1,10118
d7cf675541771000ff37f164070a686e61f7fa8f,0,shaofengshi,2016-07-21 14:43:32+08:00,['696fb89aa2eb684408d1009218f80fe323dffd3b'],10,12,22,14715281,1,0,0,1,10118
bacf9dc9199c5454500619de020bc78c56512216,1,shaofengshi,2016-07-21 15:34:22+08:00,['d7cf675541771000ff37f164070a686e61f7fa8f'],1,2,3,14715284,1,0,0,1,10118
1adb542288bfa55b072a68a02ba0896b9334bac2,0,Zhong,2016-07-21 16:01:44+08:00,['bacf9dc9199c5454500619de020bc78c56512216'],3,10,13,14715297,1,0,1,1,10118
36eec41221614ca89d50a3388db4fa7ab3bfc5a3,1,lidongsjtu,2016-07-22 09:12:42+08:00,['1adb542288bfa55b072a68a02ba0896b9334bac2'],1,5,6,14715303,2,0,0,1,10118
3bdafb1a118a03222c30c97d0af79f4a8c811930,1,shaofengshi,2016-07-22 10:35:50+08:00,['36eec41221614ca89d50a3388db4fa7ab3bfc5a3'],4,10,14,14715317,2,,,,10118
8615be974cfa99f54ceeb995ff2122dec0ded636,1,lidongsjtu,2016-07-22 11:01:07+08:00,['3bdafb1a118a03222c30c97d0af79f4a8c811930'],31,88,119,14715436,1,0,0,1,10118
c3925a63bbc27705d1d2f202cd445eeeb2e72e64,0,Li Yang,2016-07-22 15:10:21+08:00,['8615be974cfa99f54ceeb995ff2122dec0ded636'],34,191,225,14715661,2,,,,10118
8e3d8d4f8152119dbc326c356a19e341dc66c633,0,Li Yang,2016-07-22 15:11:07+08:00,['c3925a63bbc27705d1d2f202cd445eeeb2e72e64'],200,107,307,14715968,3,,,,10118
59a0586c9037cafc8112f43681766c78214210f0,1,Hongbin Ma,2016-07-22 15:39:54+08:00,['8e3d8d4f8152119dbc326c356a19e341dc66c633'],0,1,1,14715969,1,0,0,1,10118
2bab07db78e25b7eed7be45a3bce8954cbea4997,0,Hongbin Ma,2016-07-22 15:39:54+08:00,['59a0586c9037cafc8112f43681766c78214210f0'],5,5,10,14715979,3,,,,10118
0e901f1e77599d228e587b34b727220837c1b8e1,1,shaofengshi,2016-07-22 16:08:06+08:00,['2bab07db78e25b7eed7be45a3bce8954cbea4997'],14,31,45,14716024,5,1,1,1,10118
6eb646d8d1a372d65e235414d9c6d028245053eb,0,lidongsjtu,2016-07-22 17:48:49+08:00,['0e901f1e77599d228e587b34b727220837c1b8e1'],1,1,2,14716026,1,,,,10118
b20bc22a5c9bb2910ffb026436f96fe9e2fdf7e7,0,lidongsjtu,2016-07-22 18:05:31+08:00,['6eb646d8d1a372d65e235414d9c6d028245053eb'],2,2,4,14716030,2,,,,10118
408d0689612018d31c2273c62904f62259269d67,0,shaofengshi,2016-07-22 18:14:35+08:00,['b20bc22a5c9bb2910ffb026436f96fe9e2fdf7e7'],3,3,6,14716036,1,,,,10118
1adc2fdcf6d475c344ff44a35c553053e9782ab3,1,Yang Li,2016-07-23 06:48:05+08:00,['408d0689612018d31c2273c62904f62259269d67'],31,58,89,14716125,6,1,1,0.227272727,10118
67017e3eda9854d9640e7290a0ff039469f149c7,1,Yang Li,2016-07-23 08:18:34+08:00,['1adc2fdcf6d475c344ff44a35c553053e9782ab3'],65,126,191,14716316,1,0,0,0.942307692,10118
df455081f0b4da83b92447639eac47394e96af93,1,Yang Li,2016-07-23 08:43:39+08:00,['67017e3eda9854d9640e7290a0ff039469f149c7'],369,471,840,14717156,24,,,,10118
110968d3dbbb284fada623d933b9c79a7692d59c,1,Yang Li,2016-07-23 08:43:40+08:00,['df455081f0b4da83b92447639eac47394e96af93'],12,6,18,14717174,1,,,,10118
09323355021d4d887ba755ce236850dd87295b47,0,Yang Li,2016-07-24 16:58:44+08:00,['110968d3dbbb284fada623d933b9c79a7692d59c'],12,23,35,14717209,3,0.307692308,0.307692308,0.692307692,10118
0f81ed28368413216629195c5ec788d58c36b1aa,0,Yang Li,2016-07-24 17:09:35+08:00,['09323355021d4d887ba755ce236850dd87295b47'],3,15,18,14717227,2,,,,10118
22f09c18214df9239b4b546eb44ea164cf10334b,0,Hongbin Ma,2016-07-24 20:19:40+08:00,['0f81ed28368413216629195c5ec788d58c36b1aa'],1,1,2,14717229,1,,,,10118
57569a7dc3144a82873941e20c4139d008e9512d,0,Hongbin Ma,2016-07-24 20:19:40+08:00,['22f09c18214df9239b4b546eb44ea164cf10334b'],0,5,5,14717234,1,0,1,0,10118
8b572c38c419c11c63e4b29895c3bc29c74e9fdd,0,Hongbin Ma,2016-07-25 09:54:19+08:00,['57569a7dc3144a82873941e20c4139d008e9512d'],3,3,6,14717240,1,,,,10118
66f0332fde94585963dbcb62aa8f982d3eed93c4,0,lidongsjtu,2016-07-25 13:46:32+08:00,['8b572c38c419c11c63e4b29895c3bc29c74e9fdd'],3,15,18,14717258,2,0.75,0.75,1,10118
ff94893826a922addae03d7fdbc769ea024cffd8,0,Jason,2016-07-25 15:19:57+08:00,['66f0332fde94585963dbcb62aa8f982d3eed93c4'],1,1,2,14717260,1,,,,10118
4229a28b07315459306939d2f9f49d104d9a2bfb,0,Jason,2016-07-25 15:54:17+08:00,['ff94893826a922addae03d7fdbc769ea024cffd8'],0,2,2,14717262,1,0,1,1,10118
aac4e7e49faf7730621ac6397fbac8fb741fdc62,1,Yang Li,2016-07-26 07:45:58+08:00,['4229a28b07315459306939d2f9f49d104d9a2bfb'],15,21,36,14717298,7,,,,10118
49b37efd1c741d0d5900c4d500912f604df41260,1,Hongbin Ma,2016-07-26 13:19:45+08:00,['aac4e7e49faf7730621ac6397fbac8fb741fdc62'],60,79,139,14717437,9,1,1,1,10118
467226f409bf646cea1329e3638f8cfa28fee885,0,Hongbin Ma,2016-07-26 13:20:02+08:00,['49b37efd1c741d0d5900c4d500912f604df41260'],7,4,11,14717448,1,0,0,0,10118
260b62e1886b29fd9b881c5c447f8af502162268,1,Li Yang,2016-07-27 18:25:40+08:00,['467226f409bf646cea1329e3638f8cfa28fee885'],2,111,113,14717561,5,0,0.88,1,10119
fcf4ed04aa26b0ce48cd2987fb0b62b82dbe024a,0,Jason,2016-07-28 12:48:08+08:00,['260b62e1886b29fd9b881c5c447f8af502162268'],12,19,31,14717592,2,1,1,1,10119
cff597d69ccded49d82fc44aac47c7f828674894,0,shaofengshi,2016-07-28 15:10:37+08:00,['fcf4ed04aa26b0ce48cd2987fb0b62b82dbe024a'],21,21,42,14717634,21,,,,10119
62f838dd74b1902ae7ef842c48256fa2262600a4,0,shaofengshi,2016-07-28 15:24:08+08:00,['cff597d69ccded49d82fc44aac47c7f828674894'],1,1,2,14717636,1,,,,10119
5e4f173625a4e003b840632b99b48cab846fcfe8,0,shaofengshi,2016-07-29 11:55:47+08:00,['62f838dd74b1902ae7ef842c48256fa2262600a4'],2,15,17,14717653,2,0.333333333,0.333333333,1,10119
4cbb1c6161b37e7045433ff03bbffa49692fa1c0,0,Jason,2016-07-29 18:40:35+08:00,['5e4f173625a4e003b840632b99b48cab846fcfe8'],2,2,4,14717657,1,,,,10119
df8054a0f10aa68d18a3a35fb9f9bab385af32d9,1,Yang Li,2016-07-31 14:52:44+08:00,['4cbb1c6161b37e7045433ff03bbffa49692fa1c0'],38,52,90,14717747,23,,,,10119
71de3acb17f4c7a084e3e25ab25a6eeacecc1508,1,Yang Li,2016-07-31 20:02:22+08:00,['df8054a0f10aa68d18a3a35fb9f9bab385af32d9'],13,538,551,14718298,15,0.472906404,0.399014778,0.901477833,10129
6dad0f3eeee98fde7a592046525f668a39354845,0,Yang Li,2016-07-31 21:45:53+08:00,['71de3acb17f4c7a084e3e25ab25a6eeacecc1508'],17,13,30,14718328,6,1,1,0,10129
d94afcbbff2cf55aa96afd3bc0aa88221ea47717,0,Li Yang,2016-08-01 13:15:11+08:00,['6dad0f3eeee98fde7a592046525f668a39354845'],2,2,4,14718332,2,,,,10129
e63de677dba4f2b57d7bece62389a21eef310a32,0,Yang Li,2016-08-02 07:39:28+08:00,['d94afcbbff2cf55aa96afd3bc0aa88221ea47717'],1,470,471,14718803,16,0.988764045,1,0.898876404,10142
a769c286f0c00069ff7c54f04e9bb959f85d8df2,0,Yang Li,2016-08-02 08:49:16+08:00,['e63de677dba4f2b57d7bece62389a21eef310a32'],4,5,9,14718812,2,,,,10142
165dca8d87993c2922be7ae53db915cbfaddfda7,1,Hongbin Ma,2016-08-02 16:50:46+08:00,['a769c286f0c00069ff7c54f04e9bb959f85d8df2'],1,3,4,14718816,1,0,1,1,10142
4fd7eb97a4953286fd2e4c95842135f21a48d13d,1,Hongbin Ma,2016-08-02 16:51:07+08:00,['165dca8d87993c2922be7ae53db915cbfaddfda7'],4295,4455,8750,14727566,23,0.315789474,0.73993808,0.907120743,10142
8eb4a845e86863988eafc4446262ac179db55104,0,Jason,2016-08-03 10:32:28+08:00,['4fd7eb97a4953286fd2e4c95842135f21a48d13d'],2,0,2,14727568,1,0.5,0.5,0,10142
67cade98299afed04abe583effe1467290c44eb7,1,Jason,2016-08-04 13:40:28+08:00,['8eb4a845e86863988eafc4446262ac179db55104'],2,78,80,14727648,4,1,1,1,10143
0c67dfbca4fcd828b221fe171fd13a40540165f8,0,lidongsjtu,2016-08-04 15:55:28+08:00,['67cade98299afed04abe583effe1467290c44eb7'],1,1,2,14727650,1,0,0,0,10143
e885b750a2375d22d0831dcd4f861e91eb7d3e3b,1,lidongsjtu,2016-08-04 23:36:52+08:00,['0c67dfbca4fcd828b221fe171fd13a40540165f8'],8,6,14,14727664,2,,,,10143
5e83cd7344bd7cb3ddeed2bd76cfa4c0f3f02987,0,Jason,2016-08-05 13:55:06+08:00,['e885b750a2375d22d0831dcd4f861e91eb7d3e3b'],1,34,35,14727699,4,1,1,0.928571429,10143
59e5eeed3abae778f0e969540b2e2e1d7086bbd8,0,lidongsjtu,2016-08-05 14:29:08+08:00,['5e83cd7344bd7cb3ddeed2bd76cfa4c0f3f02987'],104,118,222,14727921,6,0.909090909,1,0.090909091,10143
cce90a0347cff25a2854a617781f225c80873389,0,Jason,2016-08-05 15:11:27+08:00,['59e5eeed3abae778f0e969540b2e2e1d7086bbd8'],2,4,6,14727927,2,,,,10143
0b09ff464a86cc4d7549ca089b8649b6fae7111d,0,lidongsjtu,2016-08-05 18:03:26+08:00,['cce90a0347cff25a2854a617781f225c80873389'],0,6,6,14727933,2,0.6,1,0.6,10143
3aab0201a7454c7dfab4fd443a5e942fad478883,0,shaofengshi,2016-08-08 10:01:20+08:00,['0b09ff464a86cc4d7549ca089b8649b6fae7111d'],2,4,6,14727939,2,,,,10143
2f166580c7710cd410a4dce818414d378102ce5d,0,shaofengshi,2016-08-08 11:03:00+08:00,['3aab0201a7454c7dfab4fd443a5e942fad478883'],3,2,5,14727944,1,1,0,0,10143
a0d8ab98874ceb1c1d69d6cb7bfc923077a30056,0,Yang Li,2016-08-09 07:47:26+08:00,['2f166580c7710cd410a4dce818414d378102ce5d'],12,2,14,14727958,5,0,0,0,10143
2146f2b00389e382637f0e3f620c0412ea24db3f,0,shaofengshi,2016-08-10 09:55:19+08:00,['a0d8ab98874ceb1c1d69d6cb7bfc923077a30056'],0,27,27,14727985,2,,,,10145
a2b693c7955b4e5c436f4f815cd5588da93f7e98,0,shaofengshi,2016-08-10 10:09:22+08:00,['2146f2b00389e382637f0e3f620c0412ea24db3f'],21,21,42,14728027,8,0.666666667,0.333333333,0.666666667,10145
acde339623d43fa9b441614bc64ca7960e9255fe,1,shaofengshi,2016-08-10 10:10:10+08:00,['a2b693c7955b4e5c436f4f815cd5588da93f7e98'],15,99,114,14728141,19,0.023809524,0.523809524,1,10146
23407e3ddeff9011151d871f1f4e51c0a987564c,0,shaofengshi,2016-08-10 10:23:55+08:00,['acde339623d43fa9b441614bc64ca7960e9255fe'],16,40,56,14728197,7,0.909090909,1,1,10146
76d8672ca77ee662bece45e1b2428d42d9beccc6,1,shaofengshi,2016-08-10 10:23:55+08:00,['23407e3ddeff9011151d871f1f4e51c0a987564c'],1,8,9,14728206,2,0,1,1,10146
a35dc3cb6b4e5f6a89001c146648200a15456443,1,shaofengshi,2016-08-10 10:31:42+08:00,['76d8672ca77ee662bece45e1b2428d42d9beccc6'],60,94,154,14728360,26,0.666666667,0.666666667,0.666666667,10146
c67891d26a5a937cc4850fc389ad395d1609b575,0,shaofengshi,2016-08-10 12:13:05+08:00,['a35dc3cb6b4e5f6a89001c146648200a15456443'],10,1,11,14728371,10,,,,10146
28e942306d545ff3b5f604e8225bacad650ad8ac,1,Hongbin Ma,2016-08-10 12:56:32+08:00,['c67891d26a5a937cc4850fc389ad395d1609b575'],447,1811,2258,14730629,42,0.346666667,0.676666667,0.716666667,10160
18cb49cdbbc8eb412187148c2c2aeeb52d1aa36e,0,shaofengshi,2016-08-10 15:06:40+08:00,['28e942306d545ff3b5f604e8225bacad650ad8ac'],1,1,2,14730631,1,,,,10160
a00f9d74d5ddabecd7c0b27fc0760d670f34fbcd,0,shaofengshi,2016-08-11 09:57:50+08:00,['18cb49cdbbc8eb412187148c2c2aeeb52d1aa36e'],1,10,11,14730642,2,,,,10160
a87bbadf985fecbe8c2b1740b89266e9faae4f35,0,shaofengshi,2016-08-11 10:44:48+08:00,['a00f9d74d5ddabecd7c0b27fc0760d670f34fbcd'],23,1,24,14730666,2,0,0,0,10160
8824c5175d9ed43237b37ebb3097a3a80fe8346b,0,Hongbin Ma,2016-08-11 14:06:52+08:00,['a87bbadf985fecbe8c2b1740b89266e9faae4f35'],2,4,6,14730672,1,,,,10160
8ecb7d455cc96a787b441da628a0c87301595aa9,0,lidongsjtu,2016-08-11 15:38:05+08:00,['8824c5175d9ed43237b37ebb3097a3a80fe8346b'],7,11,18,14730690,2,0,1,1,10160
47d2d15c6643c56e1fa6c65308d82ef1baf3b323,1,sunyerui,2016-08-13 12:56:26+08:00,['8ecb7d455cc96a787b441da628a0c87301595aa9'],10,161,171,14730861,2,0.988095238,1,0.916666667,10161
e82b62136783002b6c551d2ad53d5e7f91eadf21,0,sunyerui,2016-08-13 13:10:05+08:00,['47d2d15c6643c56e1fa6c65308d82ef1baf3b323'],1,1,2,14730863,1,,,,10161
bebe9dc567f752288462f11002387da11c1261b2,0,lidongsjtu,2016-08-14 10:25:20+08:00,['e82b62136783002b6c551d2ad53d5e7f91eadf21'],40,35,75,14730938,1,1,0,0,10161
548337500939ce125d5655fa5382b800d4614eab,0,Hongbin Ma,2016-08-15 13:51:15+08:00,['bebe9dc567f752288462f11002387da11c1261b2'],1,8,9,14730947,1,,,,10161
5860c497e718a82a2162742320e8c566a5c0c266,0,Hongbin Ma,2016-08-15 13:51:23+08:00,['548337500939ce125d5655fa5382b800d4614eab'],2,2,4,14730951,1,,,,10161
da53a7716ae42dc831f16411f04097ef743ef47c,1,Hongbin Ma,2016-08-16 18:13:18+08:00,['5860c497e718a82a2162742320e8c566a5c0c266'],57,16,73,14731024,6,0.8,1,0.8,10161
88b8850e7332ab1b50c69cc42e092f0152f7e21f,0,Li Yang,2016-08-17 12:26:31+08:00,['da53a7716ae42dc831f16411f04097ef743ef47c'],35,42,77,14731101,3,1,1,1,10161
83419cfbb91b6dc9aa808655881203d47c6d9b07,0,lidongsjtu,2016-08-17 13:08:41+08:00,['88b8850e7332ab1b50c69cc42e092f0152f7e21f'],4,4,8,14731109,1,,,,10161
d6745eafefc102f7a52742c0189c5b61c2a5e436,1,Li Yang,2016-08-17 14:07:51+08:00,['83419cfbb91b6dc9aa808655881203d47c6d9b07'],118,234,352,14731461,11,0.756756757,0.864864865,0.918918919,10164
224b07cd4134543ddc1f6fe37fca5b7ffe0cde79,0,Li Yang,2016-08-17 14:07:51+08:00,['d6745eafefc102f7a52742c0189c5b61c2a5e436'],45,48,93,14731554,5,1,1,1,10164
360c8ee03892ec40428bdee1a76f36dd618715b1,1,Hongbin Ma,2016-08-17 15:18:14+08:00,['224b07cd4134543ddc1f6fe37fca5b7ffe0cde79'],12,186,198,14731752,12,1,1,1,10168
0badf49fda295f4901d07dd0a670d3c7d6678de4,0,Hongbin Ma,2016-08-17 15:18:20+08:00,['360c8ee03892ec40428bdee1a76f36dd618715b1'],1,4,5,14731757,1,1,1,1,10168
69aaae2a31689bd65413f8f8a1a99dbb9325a879,1,Hongbin Ma,2016-08-17 18:30:42+08:00,['0badf49fda295f4901d07dd0a670d3c7d6678de4'],102,34,136,14731893,8,0,0,0,10168
322b44085372ed188f2c92f1c1a7675c126510bb,0,Hongbin Ma,2016-08-17 18:32:39+08:00,['69aaae2a31689bd65413f8f8a1a99dbb9325a879'],26,26,52,14731945,6,,,,10169
6c298fac2acd7d311e82002e0854e896037883c8,0,lidongsjtu,2016-08-17 22:16:28+08:00,['322b44085372ed188f2c92f1c1a7675c126510bb'],1,1,2,14731947,1,,,,10169
e8ed223099fba4ace11aea62d7116f7b7004073d,0,lidongsjtu,2016-08-17 22:30:36+08:00,['6c298fac2acd7d311e82002e0854e896037883c8'],2,13,15,14731962,1,0,0,1,10169
7f04a2bd8e1b8080a4410b85ad9d2113776b084a,0,Hongbin Ma,2016-08-18 09:42:09+08:00,['e8ed223099fba4ace11aea62d7116f7b7004073d'],44,0,44,14732006,2,0,0,0,10169
8f5442bff2f96399685cb86bc520d94e1b2de291,1,Hongbin Ma,2016-08-18 11:03:25+08:00,['7f04a2bd8e1b8080a4410b85ad9d2113776b084a'],1,11,12,14732018,2,,,,10169
2b929c20978d74e0416543e1b943920476f48a8b,0,Li Yang,2016-08-18 14:52:34+08:00,['8f5442bff2f96399685cb86bc520d94e1b2de291'],681,697,1378,14733396,4,1,1,1,10169
f77e032d0a1f8d3e0249dfa625b07c1aa1feafc9,1,lidongsjtu,2016-08-18 16:25:40+08:00,['2b929c20978d74e0416543e1b943920476f48a8b'],125,40,165,14733561,4,0.476190476,0,0.666666667,10169
9629fa8fb9adadef90258b2edb96e46e8f9f3ceb,0,lidongsjtu,2016-08-18 16:35:33+08:00,['f77e032d0a1f8d3e0249dfa625b07c1aa1feafc9'],6,3,9,14733570,2,0,1,1,10169
6c88139d4c91c86a916846d0ac0e4f5ce106f09a,0,Hongbin Ma,2016-08-18 23:09:32+08:00,['9629fa8fb9adadef90258b2edb96e46e8f9f3ceb'],1,4,5,14733575,1,0,1,0,10169
af2a82714d54a640c8e3941b4d79e9fb2bbe77a2,1,Yang Li,2016-08-19 07:14:41+08:00,['6c88139d4c91c86a916846d0ac0e4f5ce106f09a'],0,40,40,14733615,3,0.103448276,0.965517241,1,10169
56ec9d2d823c147432968c28cb223b3cb7fe6a53,0,Yang Li,2016-08-19 07:32:45+08:00,['af2a82714d54a640c8e3941b4d79e9fb2bbe77a2'],3,4,7,14733622,2,,,,10169
35de3fdc90ebab4373e2c2c288f6f70b75095133,0,Jason,2016-08-19 14:59:50+08:00,['56ec9d2d823c147432968c28cb223b3cb7fe6a53'],9,38,47,14733669,2,,,,10169
a4ad980c11761007142dd9ef5f70d5103021d598,1,Jason,2016-08-19 15:06:22+08:00,['35de3fdc90ebab4373e2c2c288f6f70b75095133'],1,22,23,14733692,2,0.954545455,1,0.954545455,10169
6b26a3100336c1affc172714d6003432438967e7,1,Hongbin Ma,2016-08-19 18:19:13+08:00,['a4ad980c11761007142dd9ef5f70d5103021d598'],38,443,481,14734173,15,0.328125,0.536458333,0.770833333,10174
ddb59106bfb1dc58117bc0a5a72d4ef946263644,1,lidongsjtu,2016-08-19 22:36:31+08:00,['6b26a3100336c1affc172714d6003432438967e7'],29,11,40,14734213,3,0,0,1,10174
889c544adf650963598381ce905aa8f86cb8ef86,1,Yang Li,2016-08-20 21:47:18+08:00,['ddb59106bfb1dc58117bc0a5a72d4ef946263644'],224,139,363,14734576,20,0.416666667,0.388888889,0.444444444,10174
c9f576eaf50d893434eade4b5fd6bb69446fc6b9,1,Yang Li,2016-08-21 10:44:34+08:00,['889c544adf650963598381ce905aa8f86cb8ef86'],4,4,8,14734584,1,,,,10174
45cc6f477dde9aa6d6f03c6b312460bf8707101d,0,Yang Li,2016-08-21 12:38:29+08:00,['c9f576eaf50d893434eade4b5fd6bb69446fc6b9'],18,1,19,14734603,1,0.5,0.5,0,10174
e80ddde7ce690ca4053ebd16e4af8482a4df72db,0,Yang Li,2016-08-21 16:49:13+08:00,['45cc6f477dde9aa6d6f03c6b312460bf8707101d'],2,3,5,14734608,1,,,,10174
0188a264cbc3637638055cea3fd5a898cb9b938d,1,Yang Li,2016-08-21 19:11:21+08:00,['e80ddde7ce690ca4053ebd16e4af8482a4df72db'],2,372,374,14734982,7,0.615384615,0.99408284,0.952662722,10177
1b34c38b2a9ff65950dbac8229af5749ad8403ed,0,Yang Li,2016-08-21 19:38:11+08:00,['0188a264cbc3637638055cea3fd5a898cb9b938d'],29,41,70,14735052,6,0.909090909,1,1,10177
29ba46beee3c9330c54a23265fdc183333f750d8,1,Yang Li,2016-08-22 08:37:12+08:00,['1b34c38b2a9ff65950dbac8229af5749ad8403ed'],110,310,420,14735472,29,0.802631579,1,0,10178
2ce1cde0ab18f1b3541498584543394123f91efb,0,Hongbin Ma,2016-08-22 10:35:09+08:00,['29ba46beee3c9330c54a23265fdc183333f750d8'],32,17,49,14735521,1,,,,10178
a863ae57f6e9f0762848d837df69c1913dfecc38,0,lidongsjtu,2016-08-22 11:21:11+08:00,['2ce1cde0ab18f1b3541498584543394123f91efb'],5,4,9,14735530,1,0,1,1,10178
f41f8c55614172134105441f864b0c8a1f55583e,1,lidongsjtu,2016-08-22 13:31:04+08:00,['a863ae57f6e9f0762848d837df69c1913dfecc38'],27,16,43,14735573,2,0,0,1,10178
4c897dd2e8b008c3baaa970d8a0f50d88137026b,1,lidongsjtu,2016-08-22 13:39:29+08:00,['f41f8c55614172134105441f864b0c8a1f55583e'],5,14,19,14735592,3,1,1,1,10178
03c6cf3dab0e3a40f663e083348cb3e4cdc59a49,0,Li Yang,2016-08-24 16:59:47+08:00,['4c897dd2e8b008c3baaa970d8a0f50d88137026b'],33,15,48,14735640,2,0.846153846,1,0,10178
5a77f5e72aeda51c2e2b2c2eea77e591eb998c19,0,lidongsjtu,2016-08-24 17:09:32+08:00,['03c6cf3dab0e3a40f663e083348cb3e4cdc59a49'],25,48,73,14735713,2,0,0,1,10178
579dfcff33997dc7d74ab33d0913f404413b5dea,0,lidongsjtu,2016-08-24 17:09:32+08:00,['5a77f5e72aeda51c2e2b2c2eea77e591eb998c19'],12,17,29,14735742,1,,,,10178
57a259a9d28484b3494fc62385a8d284c1052209,1,Li Yang,2016-08-25 12:01:46+08:00,['579dfcff33997dc7d74ab33d0913f404413b5dea'],7,27,34,14735776,2,0,0.466666667,1,10178
5ee76e8b5840e7f8c6da9a56e6f1f496f0821589,1,Hongbin Ma,2016-08-26 10:39:19+08:00,['57a259a9d28484b3494fc62385a8d284c1052209'],650,919,1569,14737345,31,0,0,1,10186
638880961ee745ccc107232f59d8c0055b6fc66b,0,Yang Li,2016-08-27 21:54:54+08:00,['5ee76e8b5840e7f8c6da9a56e6f1f496f0821589'],1,1,2,14737347,1,,,,10186
1ea79dda1a2d6202e4ca7bfc115f68090b06e9b6,1,Yang Li,2016-08-27 22:05:56+08:00,['638880961ee745ccc107232f59d8c0055b6fc66b'],2,40,42,14737389,1,0.264705882,0.264705882,1,10186
1d046421feb2c4845f4a833d6a2a7f3d07a5730b,0,Yang Li,2016-08-27 22:30:33+08:00,['1ea79dda1a2d6202e4ca7bfc115f68090b06e9b6'],42,31,73,14737462,2,1,1,0,10186
46be80550e4cbd3403756d615d170dc244c97976,0,Hongbin Ma,2016-08-28 14:19:07+08:00,['1d046421feb2c4845f4a833d6a2a7f3d07a5730b'],0,104,104,14737566,3,0.86440678,0.881355932,0.983050847,10187
ae9d747904d02f89a4d6616ca201243afbc075cc,1,Hongbin Ma,2016-08-28 23:19:06+08:00,['46be80550e4cbd3403756d615d170dc244c97976'],126,195,321,14737887,11,0,0.076923077,0.884615385,10188
7815224da90f81a752ceb3591370ebe39d2a45d1,0,Zhong,2016-08-29 09:35:50+08:00,['ae9d747904d02f89a4d6616ca201243afbc075cc'],4,16,20,14737907,2,1,1,1,10188
ab6b73be75542a8e3e18f52aa52001286a57334b,0,Zhong,2016-08-29 09:35:50+08:00,['7815224da90f81a752ceb3591370ebe39d2a45d1'],2,2,4,14737911,1,,,,10188
1f4675fc81c8e8bcad847b4cb405b9f302e3b6d4,1,Jason,2016-08-29 11:31:44+08:00,['ab6b73be75542a8e3e18f52aa52001286a57334b'],34,264,298,14738209,4,0.533834586,0.789473684,0.879699248,10188
f48f7faa0de5aa8bcee05e7b92e708670b5beb7c,0,Jason,2016-08-29 11:31:44+08:00,['1f4675fc81c8e8bcad847b4cb405b9f302e3b6d4'],1,5,6,14738215,1,,,,10188
cc9acbc2e30b5a2c4a2a0d4b6bb056bc716f1fbb,0,Hongbin Ma,2016-08-29 18:28:37+08:00,['f48f7faa0de5aa8bcee05e7b92e708670b5beb7c'],5,72,77,14738292,5,0.292682927,0,0.682926829,10188
fdad2d8d3ff34b069f646794226bcb73543a9474,0,Hongbin Ma,2016-08-30 11:05:26+08:00,['cc9acbc2e30b5a2c4a2a0d4b6bb056bc716f1fbb'],14,136,150,14738442,10,0.583333333,0,0.708333333,10191
27426aef28f57813db90c6713ea7fd21f0151cbe,1,Jason,2016-08-30 11:32:19+08:00,['fdad2d8d3ff34b069f646794226bcb73543a9474'],2,128,130,14738572,4,,,,10192
6c23313e9d14f8eabf165566ae0a8156b25a47e8,0,Hongbin Ma,2016-08-30 19:08:32+08:00,['27426aef28f57813db90c6713ea7fd21f0151cbe'],51,79,130,14738702,9,0,0,0,10193
42f286884598aac3e8d8a63c4462f6ead74bd8c2,0,shaofengshi,2016-08-30 20:43:32+08:00,['6c23313e9d14f8eabf165566ae0a8156b25a47e8'],1,1,2,14738704,1,,,,10193
c5fdacde4f8f8748259afcb6800b53f9838fda75,0,shaofengshi,2016-08-30 23:25:51+08:00,['42f286884598aac3e8d8a63c4462f6ead74bd8c2'],6,11,17,14738721,1,0,0,0,10193
9e0b8d8033dbe4e86d299adbd102cf52792cd5fe,0,Hongbin Ma,2016-08-31 11:47:42+08:00,['c5fdacde4f8f8748259afcb6800b53f9838fda75'],6,254,260,14738981,7,0.302816901,0.457746479,0.711267606,10195
a9ba1da138966cb3fd6c4bd6950fe4b48597cf8d,0,Hongbin Ma,2016-08-31 11:54:02+08:00,['9e0b8d8033dbe4e86d299adbd102cf52792cd5fe'],184,199,383,14739364,1,1,1,1,10195
a77fbc850178f9a730f2367add24ee1d71dc9046,0,shaofengshi,2016-08-31 13:25:28+08:00,['a9ba1da138966cb3fd6c4bd6950fe4b48597cf8d'],2,4,6,14739370,1,,,,10195
3cb0894c4ff329d985513775c172ee47ed05ac67,0,Hongbin Ma,2016-08-31 14:36:41+08:00,['a77fbc850178f9a730f2367add24ee1d71dc9046'],4,22,26,14739396,1,1,1,1,10195
e7d295669e023a4e28ac8ec3c6177f468371feb2,0,Jason,2016-08-31 14:39:00+08:00,['3cb0894c4ff329d985513775c172ee47ed05ac67'],4,14,18,14739414,2,1,1,1,10195
64005c67a4395d90b7732a069848f6aca0290934,0,Jason,2016-08-31 14:39:00+08:00,['e7d295669e023a4e28ac8ec3c6177f468371feb2'],12,12,24,14739438,2,0,0,0,10195
2ed2b381ba0ea67f01b3b33a0720770fa16223ee,0,Jason,2016-08-31 14:42:02+08:00,['64005c67a4395d90b7732a069848f6aca0290934'],2,0,2,14739440,1,,,,10195
eb991059fc48dee03278e729a4eeacebf92e6409,0,Hongbin Ma,2016-08-31 19:11:31+08:00,['2ed2b381ba0ea67f01b3b33a0720770fa16223ee'],813,968,1781,14741221,2,,,,10195
9702dff253e680b46b40a35359ed7cecb5b38665,0,Hongbin Ma,2016-08-31 19:17:43+08:00,['eb991059fc48dee03278e729a4eeacebf92e6409'],406,481,887,14742108,1,,,,10195
894c16f2c978667e2526c6a2a9e46c861e644ff8,0,Hongbin Ma,2016-08-31 20:12:45+08:00,['9702dff253e680b46b40a35359ed7cecb5b38665'],1459,1229,2688,14744796,7,,,,10195
bcd086c11d761a9c3a0cb54770b728689fc7e371,0,Hongbin Ma,2016-09-01 10:36:22+08:00,['894c16f2c978667e2526c6a2a9e46c861e644ff8'],0,2,2,14744798,1,,,,10195
96da2b6cd4aa38eca664ebea69f0adc992c58ccd,0,shaofengshi,2016-09-01 18:11:31+08:00,['bcd086c11d761a9c3a0cb54770b728689fc7e371'],5,6,11,14744809,1,0,0,1,10195
7d32ecb0d7ff52910c8c106dbd244b79c181c428,0,lidongsjtu,2016-09-01 19:15:11+08:00,['96da2b6cd4aa38eca664ebea69f0adc992c58ccd'],2,20,22,14744831,9,1,1,1,10195
cf102634137e2e72f980e51b9c997b8215dede07,0,lidongsjtu,2016-09-01 22:47:35+08:00,['7d32ecb0d7ff52910c8c106dbd244b79c181c428'],0,4,4,14744835,1,,,,10195
16de8ba2701881b08ab15f4c104726bcbd6fe596,0,Hongbin Ma,2016-09-01 23:38:15+08:00,['cf102634137e2e72f980e51b9c997b8215dede07'],76,0,76,14744911,1,0.923076923,0.923076923,0,10195
a20d709d27da9060d63ccb1c14902235a3aedec2,0,Li Yang,2016-09-02 15:49:48+08:00,['16de8ba2701881b08ab15f4c104726bcbd6fe596'],2,20,22,14744933,2,1,0.857142857,0.285714286,10195
111e984f9c3a47a8a90cc622ef368cf68b0f84fe,0,Li Yang,2016-09-02 16:11:14+08:00,['a20d709d27da9060d63ccb1c14902235a3aedec2'],0,3,3,14744936,1,1,1,1,10195
9e2970bc4a87d3848ba6677fd2d05c9ed86e15d9,1,shaofengshi,2016-09-02 19:42:22+08:00,['111e984f9c3a47a8a90cc622ef368cf68b0f84fe'],17,250,267,14745203,5,0.325842697,0.617977528,0.853932584,10195
7dae9778c1f360261b465e38db47e954cf226590,0,Jason,2016-09-02 19:57:40+08:00,['9e2970bc4a87d3848ba6677fd2d05c9ed86e15d9'],1,1,2,14745205,1,,,,10195
67bcec20fb6fee502a5267dfa583bd07ca5edc8b,1,Yang Li,2016-09-03 13:13:00+08:00,['7dae9778c1f360261b465e38db47e954cf226590'],90,121,211,14745416,4,0.163265306,0.224489796,0.959183673,10195
663820f1a267c9ff156ffbe018ac1d95a1ede7cc,1,Hongbin Ma,2016-09-04 21:10:51+08:00,['67bcec20fb6fee502a5267dfa583bd07ca5edc8b'],0,2,2,14745418,1,0,1,1,10195
99d0d7535ae307a3b34a8ffd23b5d2d50559eea5,0,Hongbin Ma,2016-09-04 21:15:48+08:00,['663820f1a267c9ff156ffbe018ac1d95a1ede7cc'],12,42,54,14745472,6,0,0,0,10195
a9c8f40ee7423180d60313047b329d0c91d0dfb9,0,Hongbin Ma,2016-09-05 11:09:59+08:00,['99d0d7535ae307a3b34a8ffd23b5d2d50559eea5'],1,1,2,14745474,1,,,,10195
7bc420b211f506c789a15d214b6730591a583ea0,1,Jason,2016-09-05 12:06:09+08:00,['a9c8f40ee7423180d60313047b329d0c91d0dfb9'],3,19,22,14745496,2,1,0,0,10195
08f7ddab1c63db4bcd4d8d461a8a21da0586512d,0,Jason,2016-09-06 11:04:30+08:00,['7bc420b211f506c789a15d214b6730591a583ea0'],1,1,2,14745498,1,,,,10195
6c35c8594c34e7401a5adb43f649b1ed62e18841,1,shaofengshi,2016-09-06 12:00:47+08:00,['08f7ddab1c63db4bcd4d8d461a8a21da0586512d'],20,40,60,14745558,3,1,1,1,10195
ae72c25705002f70df5996a4101acacbd6af7db6,0,shaofengshi,2016-09-06 12:00:54+08:00,['6c35c8594c34e7401a5adb43f649b1ed62e18841'],57,44,101,14745659,4,,,,10195
eb92f96fc598a2add7a80a49768cd4f2d4184c76,0,Li Yang,2016-09-07 11:30:48+08:00,['ae72c25705002f70df5996a4101acacbd6af7db6'],3,22,25,14745684,1,0,0.875,0.375,10195
4ede67e3f5a3bb1439d34263edb09c7ebf334675,1,Jason,2016-09-07 11:39:28+08:00,['eb92f96fc598a2add7a80a49768cd4f2d4184c76'],20,30,50,14745734,2,1,1,0.916666667,10195
f12a5e77e81d88a89aa700dd2dccba7f2e0814ae,0,Jason,2016-09-07 11:39:28+08:00,['4ede67e3f5a3bb1439d34263edb09c7ebf334675'],1,1,2,14745736,1,,,,10195
e3a1767f07dcb7365480d0fa495083d8bfdd0344,0,Jason,2016-09-07 15:48:50+08:00,['f12a5e77e81d88a89aa700dd2dccba7f2e0814ae'],6,29,35,14745771,2,0.217391304,0.913043478,0.913043478,10195
413bc9f2d6c73c3c4822ba3ce0ab9da405cd5b9c,0,Jason,2016-09-07 15:49:31+08:00,['e3a1767f07dcb7365480d0fa495083d8bfdd0344'],4,7,11,14745782,2,0,0,1,10195
97778788a0fea2bb4db4254264d42c58bdb8f7cc,0,Li Yang,2016-09-07 17:38:15+08:00,['413bc9f2d6c73c3c4822ba3ce0ab9da405cd5b9c'],0,5,5,14745787,1,0.666666667,1,1,10195
fc7281b21df6bf48b10999bb10e270207540bb18,0,shaofengshi,2016-09-08 07:58:56+08:00,['97778788a0fea2bb4db4254264d42c58bdb8f7cc'],20,7,27,14745814,4,,,,10195
ddeb7452a63279311b74fcfb5f7ed0252e3d54fd,1,Hongbin Ma,2016-09-08 10:15:08+08:00,['fc7281b21df6bf48b10999bb10e270207540bb18'],202,565,767,14746581,38,1,0,0.6,10208
01d033f76a058ca0cf7ef81728b7de6204115167,0,Hongbin Ma,2016-09-08 11:18:52+08:00,['ddeb7452a63279311b74fcfb5f7ed0252e3d54fd'],1,19,20,14746601,2,0,0,0,10209
d6801695240f5191716aec4cbd336470281fb20f,0,Li Yang,2016-09-08 17:02:28+08:00,['01d033f76a058ca0cf7ef81728b7de6204115167'],6,6,12,14746613,5,,,,10209
ded3b58583e76ab1234ac48459c264196c98f04b,1,Jason,2016-09-08 17:47:26+08:00,['d6801695240f5191716aec4cbd336470281fb20f'],3,3,6,14746619,1,,,,10209
be7751bc021063f89e5955e5f1c50d66bedc5b91,0,Jason,2016-09-08 17:51:28+08:00,['ded3b58583e76ab1234ac48459c264196c98f04b'],2,2,4,14746623,2,,,,10209
bf26114866d9b4f8dcb5e13c48acdbf6c8e308e9,0,lidongsjtu,2016-09-09 12:37:05+08:00,['be7751bc021063f89e5955e5f1c50d66bedc5b91'],0,45,45,14746668,2,1,1,1,10210
e87c816dd7099290220ca09361f9ca04c36a317e,0,Jason,2016-09-09 15:52:48+08:00,['bf26114866d9b4f8dcb5e13c48acdbf6c8e308e9'],8,2,10,14746678,1,1,0,0,10210
e38557b4d1cd1d42fe042e5500020cbfaba2d80b,1,Hongbin Ma,2016-09-09 16:42:33+08:00,['e87c816dd7099290220ca09361f9ca04c36a317e'],129,264,393,14747071,21,0,0.829268293,0.853658537,10212
a2c875d8a2d06f23dd6467bbcc459bff82918295,0,Hongbin Ma,2016-09-09 17:47:29+08:00,['e38557b4d1cd1d42fe042e5500020cbfaba2d80b'],684,306,990,14748061,13,0.475,0.645,0,10212
618cf28c96d6b267d13ff737d2b3c550fc67e176,0,Hongbin Ma,2016-09-09 18:57:01+08:00,['a2c875d8a2d06f23dd6467bbcc459bff82918295'],1043,1423,2466,14750527,8,0,0,1,10212
466cf1afb19ee1acb4f99ff72ac61e7689617957,0,Hongbin Ma,2016-09-09 22:27:17+08:00,['618cf28c96d6b267d13ff737d2b3c550fc67e176'],32,21,53,14750580,1,1,0,0,10212
942406bda3ec7405a6d2be27ba11bb38b5f88298,0,Hongbin Ma,2016-09-09 23:01:00+08:00,['466cf1afb19ee1acb4f99ff72ac61e7689617957'],4,18,22,14750602,1,0,1,1,10212
a05f11146c9edd4ba18618f38fd13c9b7e4806ce,0,Hongbin Ma,2016-09-09 23:45:17+08:00,['942406bda3ec7405a6d2be27ba11bb38b5f88298'],6,0,6,14750608,2,,,,10212
d7a3fdf57acb6fbabf94669aaca869e47d89aa13,1,Hongbin Ma,2016-09-10 14:42:46+08:00,['a05f11146c9edd4ba18618f38fd13c9b7e4806ce'],1418,1048,2466,14753074,8,,,,10212
d7cbf6732a9571007de61dd492ed4d7559cbf9ac,0,lidongsjtu,2016-09-10 16:09:19+08:00,['d7a3fdf57acb6fbabf94669aaca869e47d89aa13'],0,2,2,14753076,1,0,1,1,10212
233a699f3b6f7a6c64ecf43fb80108b56db61f5f,1,shaofengshi,2016-09-10 17:59:46+08:00,['d7cbf6732a9571007de61dd492ed4d7559cbf9ac'],37,234,271,14753347,10,0.708333333,1,0.923611111,10212
56136ede7c8b9abac5ddd7b7785b3f63c59b74db,0,shaofengshi,2016-09-10 17:59:59+08:00,['233a699f3b6f7a6c64ecf43fb80108b56db61f5f'],18,19,37,14753384,1,0,,,10212
3450c0f984933d40cc60a604813a310accdfaded,0,shaofengshi,2016-09-10 18:00:08+08:00,['56136ede7c8b9abac5ddd7b7785b3f63c59b74db'],3,3,6,14753390,1,,,,10212
5e95abdec6da71a609cea80fa6569328b0c1e6cf,0,Hongbin Ma,2016-09-10 19:26:42+08:00,['3450c0f984933d40cc60a604813a310accdfaded'],0,5,5,14753395,1,0,1,1,10212
b941f115d5dae06397605c73cb630fbc31c9a5ab,0,shaofengshi,2016-09-11 10:13:28+08:00,['5e95abdec6da71a609cea80fa6569328b0c1e6cf'],0,35,35,14753430,2,,,,10212
c5c85017c135f03ac72ebbc9d1bb51f796eb0551,0,shaofengshi,2016-09-11 10:13:28+08:00,['b941f115d5dae06397605c73cb630fbc31c9a5ab'],1,108,109,14753539,6,,,,10212
c59d63de6fc404456bd59f4ca5d36e48fb251637,1,shaofengshi,2016-09-11 10:13:28+08:00,['c5c85017c135f03ac72ebbc9d1bb51f796eb0551'],204,11,215,14753754,4,,,,10212
0954176adb50df25d0995a7fbeb68e64ee7aed79,1,shaofengshi,2016-09-12 11:23:19+08:00,['c59d63de6fc404456bd59f4ca5d36e48fb251637'],34,129,163,14753917,2,0.846153846,1,0.858974359,10212
aef7869c953dec1caaf4b0e426b77c0a9a8938b1,0,shaofengshi,2016-09-12 11:36:52+08:00,['0954176adb50df25d0995a7fbeb68e64ee7aed79'],11,11,22,14753939,2,,,,10212
6db4b1723c47762280128ec7c08a160fdc9a69d7,0,Li Yang,2016-09-12 15:28:58+08:00,['aef7869c953dec1caaf4b0e426b77c0a9a8938b1'],190,192,382,14754321,3,0,0,0,10212
a201c5b0f8e7706ef2cf7cbf9b6d43d3a6bc4a57,0,Hongbin Ma,2016-09-12 23:53:48+08:00,['6db4b1723c47762280128ec7c08a160fdc9a69d7'],16,45,61,14754382,6,0.529411765,1,1,10212
4e8ed97d12c53c19d09f736be3baaa9112dcf413,1,Hongbin Ma,2016-09-12 23:53:48+08:00,['a201c5b0f8e7706ef2cf7cbf9b6d43d3a6bc4a57'],161,265,426,14754808,21,1,0.974358974,0.948717949,10215
6ed643bfaa0f571aa2ab538c0d011c293174c987,0,Hongbin Ma,2016-09-13 09:41:07+08:00,['4e8ed97d12c53c19d09f736be3baaa9112dcf413'],1,1,2,14754810,1,,,,10215
3c4537dc8f15ccd8b0f1102ed67b3f5a21ec29d6,1,Hongbin Ma,2016-09-13 11:29:17+08:00,['6ed643bfaa0f571aa2ab538c0d011c293174c987'],8,44,52,14754862,5,1,1,1,10216
0362c2bb8ea8c9f0178fbe4eb08113eaf94cd01b,0,Hongbin Ma,2016-09-13 14:10:30+08:00,['3c4537dc8f15ccd8b0f1102ed67b3f5a21ec29d6'],26,10,36,14754898,4,0,1,0,10216
5dc5ac85fc2ac0671ff2e60c6538ea5448b67c83,0,Li Yang,2016-09-13 15:16:47+08:00,['0362c2bb8ea8c9f0178fbe4eb08113eaf94cd01b'],2,6,8,14754906,1,0,0,1,10216
973ecc74943613e32e5a9145bff3cad4fe48e01f,0,Li Yang,2016-09-13 17:22:24+08:00,['5dc5ac85fc2ac0671ff2e60c6538ea5448b67c83'],0,3,3,14754909,1,,,,10217
c8326d729b0fc3fe9e3b72e5c89b9a69e607be93,0,Li Yang,2016-09-13 17:42:33+00:00,['973ecc74943613e32e5a9145bff3cad4fe48e01f'],27,0,27,14754936,2,,,,10217
ad5844babe7473f5116c69bb9d137fc690a8a277,0,Li Yang,2016-09-13 18:18:03+08:00,['c8326d729b0fc3fe9e3b72e5c89b9a69e607be93'],1,1,2,14754938,1,,,,10217
dfa304850f780ce9a546a8f60447ce3febb1c23d,0,lidongsjtu,2016-09-13 22:47:23+08:00,['ad5844babe7473f5116c69bb9d137fc690a8a277'],0,19,19,14754957,2,,,,10218
823d98af75dbc8d31af2269aff9045e96900bb43,0,lidongsjtu,2016-09-13 23:04:40+08:00,['dfa304850f780ce9a546a8f60447ce3febb1c23d'],0,18,18,14754975,1,,,,10218
617734be4d9259b511c84abfa23870c4a235c816,0,lidongsjtu,2016-09-13 23:45:24+08:00,['823d98af75dbc8d31af2269aff9045e96900bb43'],7,6,13,14754988,1,,,,10218
c48baba9fe7e9a5fe374aa83c38987b1931f5766,0,gaodayue,2016-09-14 10:55:22+08:00,['617734be4d9259b511c84abfa23870c4a235c816'],0,2,2,14754990,1,0,0,1,10218
17569f6c32a373f599ef7689f9506b5af5ed68bd,1,gaodayue,2016-09-14 15:02:33+08:00,['c48baba9fe7e9a5fe374aa83c38987b1931f5766'],200,353,553,14755543,15,0.412371134,1,0.762886598,10219
81c7323b633df88eedac8b319fc57f9b62b01a4a,1,shaofengshi,2016-09-14 16:34:36+08:00,['17569f6c32a373f599ef7689f9506b5af5ed68bd'],317,2105,2422,14757965,44,0.465367965,0.654761905,0.882034632,10234
42dafc15db40731582d6257c618eff29643930a8,0,shaofengshi,2016-09-14 16:34:36+08:00,['81c7323b633df88eedac8b319fc57f9b62b01a4a'],17,36,53,14758018,5,0,1,0.357142857,10234
4e060e7bc89f757a138dfa5beba2a43209e91371,0,shaofengshi,2016-09-14 16:34:36+08:00,['42dafc15db40731582d6257c618eff29643930a8'],8,10,18,14758036,3,,,,10234
1b1b2e37fdcba7ad67f0fa3f2369aa65431f13bc,0,shaofengshi,2016-09-14 16:34:36+08:00,['4e060e7bc89f757a138dfa5beba2a43209e91371'],27,53,80,14758116,4,0,0.476190476,1,10234
1108d9eeccecbccffea0b3f9049151672196c91a,0,shaofengshi,2016-09-14 16:34:36+08:00,['1b1b2e37fdcba7ad67f0fa3f2369aa65431f13bc'],10,41,51,14758167,2,0,0,1,10234
ffdc5d21d5f46daaf25a0dfed9b3afeef78fc62c,0,shaofengshi,2016-09-14 16:34:36+08:00,['1108d9eeccecbccffea0b3f9049151672196c91a'],27,0,27,14758194,2,,,,10234
aa30880578078369a5844e04a7d7ce736661e902,0,shaofengshi,2016-09-14 16:34:36+08:00,['ffdc5d21d5f46daaf25a0dfed9b3afeef78fc62c'],0,27,27,14758221,2,,,,10236
aff2df5987e98ee9fd64d4803a8a2dea90013e40,0,shaofengshi,2016-09-14 16:34:36+08:00,['aa30880578078369a5844e04a7d7ce736661e902'],11,68,79,14758300,6,1,1,1,10237
3e081b3fbec4fc8a6cc4ddf8795d2fd581ae04f4,0,shaofengshi,2016-09-14 16:34:36+08:00,['aff2df5987e98ee9fd64d4803a8a2dea90013e40'],49,320,369,14758669,12,0.398734177,0.474683544,0.955696203,10238
ab7585a1c98352ed8991753f700c02c3b00f88f4,1,Yang Li,2016-09-16 21:13:09+08:00,['3e081b3fbec4fc8a6cc4ddf8795d2fd581ae04f4'],22,22,44,14758713,22,,,,10238
04d6f2a26186b48545d54fc3f537d147091192ae,0,shaofengshi,2016-09-16 21:43:24+08:00,['ab7585a1c98352ed8991753f700c02c3b00f88f4'],22,22,44,14758757,22,,,,10238
023b5cb1dfdacfa9adcc2586b4aaeb3886f61098,0,shaofengshi,2016-09-16 22:53:10+08:00,['04d6f2a26186b48545d54fc3f537d147091192ae'],0,10,10,14758767,4,0,1,1,10238
aa256fd74d485c432e261552b0d155da2250fab6,0,Hongbin Ma,2016-09-18 11:23:21+08:00,['023b5cb1dfdacfa9adcc2586b4aaeb3886f61098'],1,1,2,14758769,1,1,0,0,10238
7955b093de5bc04547ae2ca9ed12a78670c38e81,1,Hongbin Ma,2016-09-18 11:23:26+08:00,['aa256fd74d485c432e261552b0d155da2250fab6'],2,197,199,14758968,12,0.661290323,0.661290323,1,10244
6707cfa40f262a5de165b7e23db27d33a415e8c8,0,Hongbin Ma,2016-09-18 15:20:43+08:00,['7955b093de5bc04547ae2ca9ed12a78670c38e81'],15,14,29,14758997,1,0,1,1,10244
6bd239f322f60eb23b6bd60be6cb5200036daa38,1,Hongbin Ma,2016-09-18 18:21:17+08:00,['6707cfa40f262a5de165b7e23db27d33a415e8c8'],1,393,394,14759391,4,0.913978495,1,0.725806452,10246
805b938d5c88238a2279b67b0ddb8b705b782637,0,Hongbin Ma,2016-09-19 10:58:30+08:00,['6bd239f322f60eb23b6bd60be6cb5200036daa38'],4,3,7,14759398,1,0,0,0,10246
9ebc741d871ce5cb679d440b8e6adf9ac9cb6692,0,Li Yang,2016-09-19 15:54:36+08:00,['805b938d5c88238a2279b67b0ddb8b705b782637'],2,2,4,14759402,2,,,,10246
c9dcb07c72d0fef99ce8f630936b819c2db73408,1,Hongbin Ma,2016-09-19 22:13:13+08:00,['9ebc741d871ce5cb679d440b8e6adf9ac9cb6692'],2,4,6,14759408,1,0,1,1,10246
a08dd2e03900b321617647d1dbf1c4ee8b4b18c2,0,shaofengshi,2016-09-19 22:16:06+08:00,['c9dcb07c72d0fef99ce8f630936b819c2db73408'],150,12,162,14759570,3,0.235294118,0.164705882,0.164705882,10246
a8a1b6e037767b75a3184f4b5db6f384f622a89e,0,shaofengshi,2016-09-19 22:16:06+08:00,['a08dd2e03900b321617647d1dbf1c4ee8b4b18c2'],7,0,7,14759577,1,1,0,0,10246
e17b11bd861a1ce7ecfda37997e0011f7e180fd2,1,shaofengshi,2016-09-19 22:58:12+08:00,['a8a1b6e037767b75a3184f4b5db6f384f622a89e'],0,7,7,14759584,1,0,1,1,10246
20ac92a325ef4e92839c18b5e9c8e2bfcaf56c37,0,Li Yang,2016-09-20 08:38:49+08:00,['e17b11bd861a1ce7ecfda37997e0011f7e180fd2'],1,1,2,14759586,1,,,,10246
a6cd40940248a99803d1596a32b62767646e39ac,1,Hongbin Ma,2016-09-20 11:43:08+08:00,['20ac92a325ef4e92839c18b5e9c8e2bfcaf56c37'],102,1015,1117,14760703,11,0.453183521,0.816479401,1,10251
8e9c4550bb562b497442b17eec6485ae96e848d8,0,Hongbin Ma,2016-09-20 11:43:08+08:00,['a6cd40940248a99803d1596a32b62767646e39ac'],12,150,162,14760865,3,0.764705882,0.835294118,0.835294118,10251
e604f6527d60b767f8a46a576765cfd205b1efc5,0,Hongbin Ma,2016-09-20 11:43:08+08:00,['8e9c4550bb562b497442b17eec6485ae96e848d8'],9,0,9,14760874,4,1,0,0,10251
96d5f0e0e639fe4e4fc169f687004d9d9361999b,0,Hongbin Ma,2016-09-20 11:43:08+08:00,['e604f6527d60b767f8a46a576765cfd205b1efc5'],320,49,369,14761243,12,0.601265823,0.525316456,0.044303797,10251
3ae2549ba89e3a2c8ed94a2089678227cf78312d,0,Hongbin Ma,2016-09-20 11:43:08+08:00,['96d5f0e0e639fe4e4fc169f687004d9d9361999b'],68,11,79,14761322,6,0,0,0,10251
d1e979b4995597ae2ac3fbeb88ba1902d7296782,0,Hongbin Ma,2016-09-20 11:43:08+08:00,['3ae2549ba89e3a2c8ed94a2089678227cf78312d'],27,0,27,14761349,2,,,,10251
bec25b4638835301a102141e56e12cd38d09139f,0,Hongbin Ma,2016-09-20 11:43:08+08:00,['d1e979b4995597ae2ac3fbeb88ba1902d7296782'],0,27,27,14761376,2,,,,10253
da5ba276b972f8b3c0d220252e74ac2ff73298fc,0,Hongbin Ma,2016-09-20 11:43:08+08:00,['bec25b4638835301a102141e56e12cd38d09139f'],41,10,51,14761427,2,1,1,0,10253
355e58ba4209ddf945663228688d550bf654c387,0,Hongbin Ma,2016-09-20 11:43:08+08:00,['da5ba276b972f8b3c0d220252e74ac2ff73298fc'],53,27,80,14761507,4,1,0.523809524,0,10253
dee8f2d073d225a3b8189c66170fd310c1a8d221,0,Hongbin Ma,2016-09-20 11:43:08+08:00,['355e58ba4209ddf945663228688d550bf654c387'],10,8,18,14761525,3,,,,10253
1f4880479cd3132786062723ba70312440de4805,0,Hongbin Ma,2016-09-20 11:43:08+08:00,['dee8f2d073d225a3b8189c66170fd310c1a8d221'],36,17,53,14761578,5,1,0,0.642857143,10253
506cd783132023a06f1669ad248b74bf9d96d0e1,0,Hongbin Ma,2016-09-20 11:43:08+08:00,['1f4880479cd3132786062723ba70312440de4805'],2100,313,2413,14763991,44,0.535791757,0.345986985,0.118221258,10253
a768b65d608cb6c1d0dbb7bcadf4adbd97a7b1f6,0,Li Yang,2016-09-20 18:30:14+08:00,['506cd783132023a06f1669ad248b74bf9d96d0e1'],35,30,65,14764056,4,0.4,1,0.3,10253
5a049a58de91d84dda67d7d422786c38f75f4e8e,0,Li Yang,2016-09-20 18:40:28+08:00,['a768b65d608cb6c1d0dbb7bcadf4adbd97a7b1f6'],8,0,8,14764064,1,1,0,0,10253
7d716dff10326e8f906bdcb8d70c67fde18881d5,1,Yang Li,2016-09-20 21:07:39+08:00,['5a049a58de91d84dda67d7d422786c38f75f4e8e'],30,35,65,14764129,4,0.6,0,0.7,10253
472e6d547f2f04b8d6f92b9affa173a9685d3d2d,1,Hongbin Ma,2016-09-20 21:17:12+08:00,['7d716dff10326e8f906bdcb8d70c67fde18881d5'],2,25,27,14764156,2,1,1,1,10254
dbc02b75b09e07dbeee7bd417a29e5e9a01a0adf,0,Hongbin Ma,2016-09-20 21:17:12+08:00,['472e6d547f2f04b8d6f92b9affa173a9685d3d2d'],3,21,24,14764180,1,0,0,1,10254
f62541ed4794adacaca508da5a4997dea82bd385,0,Hongbin Ma,2016-09-20 21:17:12+08:00,['dbc02b75b09e07dbeee7bd417a29e5e9a01a0adf'],0,29,29,14764209,1,1,1,1,10255
f0d2be3c93cde5e658178c896be1671d1aca5685,1,Yang Li,2016-09-21 06:41:51+08:00,['f62541ed4794adacaca508da5a4997dea82bd385'],2,7,9,14764218,1,0,0,0,10255
8babee8d09f48d8ed60c70f16258402822ea81bf,1,Yang Li,2016-09-21 06:53:10+08:00,['f0d2be3c93cde5e658178c896be1671d1aca5685'],111,113,224,14764442,6,,,,10255
c1fc72386f72b9a86c547e612c6be8093dba4b68,0,Yang Li,2016-09-21 07:16:44+08:00,['8babee8d09f48d8ed60c70f16258402822ea81bf'],3,7,10,14764452,3,1,1,1,10255
45cc681326bbd701fd8740c6425354f362f1d87e,0,Jason,2016-09-21 14:20:48+08:00,['c1fc72386f72b9a86c547e612c6be8093dba4b68'],3,49,52,14764504,4,0,0.307692308,0.974358974,10255
69cb49dbad6b27e9ca7662fa8dfaf29ad90cc98a,0,Jason,2016-09-21 14:27:27+08:00,['45cc681326bbd701fd8740c6425354f362f1d87e'],2,2,4,14764508,1,,,,10255
32a9c67068edfa0778ab5e19fc8376813e1bbc90,0,Jason,2016-09-21 15:25:08+08:00,['69cb49dbad6b27e9ca7662fa8dfaf29ad90cc98a'],1,1,2,14764510,1,,,,10255
2359a75e3ca9d1a9c5f06331ab02edce1385b66d,0,Hongbin Ma,2016-09-22 10:45:15+08:00,['32a9c67068edfa0778ab5e19fc8376813e1bbc90'],2,3,5,14764515,3,0,0,1,10255
c2ff8c5135e72cafeae09f20e654d247f9335d5c,0,lidongsjtu,2016-09-22 12:54:03+08:00,['2359a75e3ca9d1a9c5f06331ab02edce1385b66d'],5,5,10,14764525,2,,,,10255
4c9b67fa449d9b43cfd1cdf6fc19710bb368005f,0,Jason,2016-09-22 18:17:43+08:00,['c2ff8c5135e72cafeae09f20e654d247f9335d5c'],1,1,2,14764527,1,,,,10255
fa5c9cb7851afff028f5a2d39d12fbbb32bd40e8,0,Hongbin Ma,2016-09-22 18:50:35+08:00,['4c9b67fa449d9b43cfd1cdf6fc19710bb368005f'],85,89,174,14764701,24,1,1,0,10255
858fad676bb42366c26f4033fcc208675cb4bf72,1,Li Yang,2016-09-23 17:44:23+08:00,['fa5c9cb7851afff028f5a2d39d12fbbb32bd40e8'],9,48,57,14764758,1,0.448275862,0.448275862,1,10255
72005ea5b7e945268028b88e5fc8f197d7608861,1,Yang Li,2016-09-23 22:15:58+08:00,['858fad676bb42366c26f4033fcc208675cb4bf72'],359,535,894,14765652,19,1,1,0,10255
65afee78287186557975e57aca3843689195e1a0,0,Yang Li,2016-09-23 23:47:24+08:00,['72005ea5b7e945268028b88e5fc8f197d7608861'],0,1,1,14765653,1,,,,10255
b6cdc0d1b20683feb7255a71dfa8d5b98c4e636e,1,Yang Li,2016-09-24 01:31:22+08:00,['65afee78287186557975e57aca3843689195e1a0'],58,52,110,14765763,4,1,0,0.5,10255
f2732ec85f750441a1386115daafc6e2bb91647f,1,shaofengshi,2016-09-24 09:09:36+08:00,['b6cdc0d1b20683feb7255a71dfa8d5b98c4e636e'],1,2,3,14765766,1,,,,10255
5aeedd5c7d11a282cc253e13247218bb2a0e3bf3,0,Yang Li,2016-09-24 10:38:38+08:00,['f2732ec85f750441a1386115daafc6e2bb91647f'],2,3,5,14765771,1,,,,10255
5658283de1dd653881eacd8442ae6f3122600581,0,lidongsjtu,2016-09-24 10:42:46+08:00,['5aeedd5c7d11a282cc253e13247218bb2a0e3bf3'],0,1,1,14765772,1,0,1,0,10255
818188d484f2a848c84d3b1f79865e04e74dcd22,0,lidongsjtu,2016-09-24 10:42:46+08:00,['5658283de1dd653881eacd8442ae6f3122600581'],1,1,2,14765774,1,,,,10255
a346db5108b55acb667539a5269d1b1864ea3084,0,lidongsjtu,2016-09-24 10:42:46+08:00,['818188d484f2a848c84d3b1f79865e04e74dcd22'],2,9,11,14765785,1,0,1,1,10255
afa350f0018fce4d34692fb0a1616829e11977ae,0,lidongsjtu,2016-09-24 10:42:46+08:00,['a346db5108b55acb667539a5269d1b1864ea3084'],6,5,11,14765796,1,0,0,0,10255
bf127a9167c506025616031374a91c57eb1355ed,0,Yang Li,2016-09-24 14:29:56+08:00,['afa350f0018fce4d34692fb0a1616829e11977ae'],18,39,57,14765853,7,0.8125,1,0.75,10255
e10f2b922006a002ea9cb58ff11a4ecd9aa749c9,1,Yang Li,2016-09-25 13:54:51+08:00,['bf127a9167c506025616031374a91c57eb1355ed'],54,65,119,14765972,1,1,0,0,10255
a25131eca336c0698a75c85c64dc000c8b91cc74,0,shaofengshi,2016-09-25 15:38:21+08:00,['e10f2b922006a002ea9cb58ff11a4ecd9aa749c9'],8,2,10,14765982,1,,,,10255
61a3e7ef1b9998fb2414170b2978d62d84b8a6c1,0,shaofengshi,2016-09-25 15:40:03+08:00,['a25131eca336c0698a75c85c64dc000c8b91cc74'],12,5,17,14765999,7,,,,10255
b95e9671042240761ec8667d8ba0ae80227869e2,0,shaofengshi,2016-09-25 17:07:48+08:00,['61a3e7ef1b9998fb2414170b2978d62d84b8a6c1'],1,1,2,14766001,1,,,,10255
0861bfb0312d344267eaf5772ed1b3011f778301,0,shaofengshi,2016-09-26 11:55:31+08:00,['b95e9671042240761ec8667d8ba0ae80227869e2'],1,2,3,14766004,1,,,,10255
e05cb60061a43987f7648d3d04921b5a01bb5ac9,1,Yang Li,2016-09-26 19:45:19+08:00,['0861bfb0312d344267eaf5772ed1b3011f778301'],10,6,16,14766020,3,0.25,0,0,10255
2993e7bdd8875e6b2f8893d7852bb67d226f6c9e,0,Yang Li,2016-09-26 19:51:04+08:00,['e05cb60061a43987f7648d3d04921b5a01bb5ac9'],13,13,26,14766046,3,,,,10255
0def97cce3e31db675be9aaedcfc0b8293d7f35a,0,Yang Li,2016-09-26 19:51:11+08:00,['2993e7bdd8875e6b2f8893d7852bb67d226f6c9e'],17,17,34,14766080,4,,,,10255
abc6a744783731b9d1b33166a98c6fcdda5fddb8,0,Yang Li,2016-09-26 19:58:21+08:00,['0def97cce3e31db675be9aaedcfc0b8293d7f35a'],1,1,2,14766082,1,,,,10255
8596af11e9f46b7be82009f446b8adcca0d4e499,1,Yang Li,2016-09-26 21:45:37+08:00,['abc6a744783731b9d1b33166a98c6fcdda5fddb8'],1337,567,1904,14767986,47,,,,10255
05afca7a8346370a2f507c4b477b46cbe4e258f7,0,Yang Li,2016-09-27 06:46:18+08:00,['8596af11e9f46b7be82009f446b8adcca0d4e499'],3,3,6,14767992,2,,,,10255
afd3e61eedea2ce175e3fb2844b6118aabe25a6f,0,Yang Li,2016-09-27 08:38:42+08:00,['05afca7a8346370a2f507c4b477b46cbe4e258f7'],0,19,19,14768011,1,,,,10256
a00d1e37483a5f15bf8f469fb1ed23bba1aa0011,0,shaofengshi,2016-09-27 09:55:03+08:00,['afd3e61eedea2ce175e3fb2844b6118aabe25a6f'],1,1,2,14768013,2,,,,10256
8431af45528abb2d39a69b5e762712983573e5a6,1,shaofengshi,2016-09-27 10:17:40+08:00,['a00d1e37483a5f15bf8f469fb1ed23bba1aa0011'],85,1989,2074,14770087,39,0.464208243,0.654013015,0.881778742,10271
f89e35f6309c9bec43cc16e68fb35b7490aecc38,1,shaofengshi,2016-09-27 10:17:40+08:00,['8431af45528abb2d39a69b5e762712983573e5a6'],17,36,53,14770140,5,0,1,0.357142857,10271
c738f0f265737dd5849f9342fd694e3cef3344b8,0,shaofengshi,2016-09-27 10:17:40+08:00,['f89e35f6309c9bec43cc16e68fb35b7490aecc38'],8,10,18,14770158,3,,,,10271
ae3d7e4314bb5d5441d74224967c96a1f05f1b30,1,shaofengshi,2016-09-27 10:17:40+08:00,['c738f0f265737dd5849f9342fd694e3cef3344b8'],27,53,80,14770238,4,0,0.476190476,1,10271
25f8ffc0ee16b1702723d5530b22084a608fed9a,0,shaofengshi,2016-09-27 10:17:40+08:00,['ae3d7e4314bb5d5441d74224967c96a1f05f1b30'],10,41,51,14770289,2,0,0,1,10271
8136380f0aa6b0594b2882952e36077c6e474a3c,0,shaofengshi,2016-09-27 10:17:40+08:00,['25f8ffc0ee16b1702723d5530b22084a608fed9a'],27,0,27,14770316,2,,,,10271
de2f4e2a395af57a42aba43f7233bd1bbdd0f6d0,0,shaofengshi,2016-09-27 10:17:40+08:00,['8136380f0aa6b0594b2882952e36077c6e474a3c'],0,27,27,14770343,2,,,,10273
f0de02392f4808e08432417cb00f2ab5fa829055,0,shaofengshi,2016-09-27 10:17:40+08:00,['de2f4e2a395af57a42aba43f7233bd1bbdd0f6d0'],11,68,79,14770422,6,1,1,1,10274
b1a0f4dc93bd17a36a6c4573cf56fb9d285e4bed,1,shaofengshi,2016-09-27 10:17:40+08:00,['f0de02392f4808e08432417cb00f2ab5fa829055'],49,320,369,14770791,12,0.398734177,0.474683544,0.955696203,10275
8cbffb40477611aa9c06bc5c22787aef83bc28d3,0,shaofengshi,2016-09-27 10:17:40+08:00,['b1a0f4dc93bd17a36a6c4573cf56fb9d285e4bed'],0,9,9,14770800,4,0,1,1,10275
be18158dcc5ce739c272b9345d3b2296c3936ee3,0,shaofengshi,2016-09-27 10:17:40+08:00,['8cbffb40477611aa9c06bc5c22787aef83bc28d3'],150,12,162,14770962,3,0.235294118,0.164705882,0.164705882,10275
ab5563a8ec060fba48ec8f43244bed6f887b0e83,1,shaofengshi,2016-09-27 10:17:40+08:00,['be18158dcc5ce739c272b9345d3b2296c3936ee3'],50,117,167,14771129,13,0.063829787,0.191489362,0.553191489,10275
859230d787f9c218f56e56308897b68fb23d8dc4,1,shaofengshi,2016-09-27 10:17:40+08:00,['ab5563a8ec060fba48ec8f43244bed6f887b0e83'],188,116,304,14771433,7,0.125,0,0,10275
d366dc1118aeb342a2ace251bc6dfac976f00e14,1,Li Yang,2016-09-28 11:51:50+08:00,['859230d787f9c218f56e56308897b68fb23d8dc4'],5,20,25,14771458,2,1,0.066666667,1,10275
31b80905ec3645ecf2c0e8bb5c02bdc451974648,0,Li Yang,2016-09-28 13:37:26+08:00,['d366dc1118aeb342a2ace251bc6dfac976f00e14'],72,123,195,14771653,13,1,1,0.483870968,10276
01d5670e0ea7f1e3fe5cbb6e9decb293f8815d8f,0,Li Yang,2016-09-28 14:53:26+08:00,['31b80905ec3645ecf2c0e8bb5c02bdc451974648'],18,23,41,14771694,1,0,0,1,10276
e500726184b318da2d1f503cd1b159cfe7242347,1,shaofengshi,2016-09-28 17:00:46+08:00,['01d5670e0ea7f1e3fe5cbb6e9decb293f8815d8f'],17,222,239,14771933,9,0.424657534,0.356164384,1,10279
0fd4ad587e3710324eaf58266b64f202eeabfa7e,0,shaofengshi,2016-09-28 17:51:36+08:00,['e500726184b318da2d1f503cd1b159cfe7242347'],1,1,2,14771935,1,,,,10279
51b5b31bbce3aac1d3a3c0de7746334961d5ffcd,0,shaofengshi,2016-09-28 17:51:49+08:00,['0fd4ad587e3710324eaf58266b64f202eeabfa7e'],120,33,153,14772088,5,0.4,0.933333333,0,10279
1e049817856ede06c7c8736ad1d608765f301a21,1,lidongsjtu,2016-09-29 15:34:25+08:00,['51b5b31bbce3aac1d3a3c0de7746334961d5ffcd'],4,9,13,14772101,2,0,1,1,10279
dfb4176531046e212649dce89aebb8d091fc5689,0,shaofengshi,2016-09-30 11:02:09+08:00,['1e049817856ede06c7c8736ad1d608765f301a21'],3,1,4,14772105,1,,,,10279
3a6b1f2d1cd1a42837353e52e3fa219c0d5a314b,0,shaofengshi,2016-09-30 14:04:12+08:00,['dfb4176531046e212649dce89aebb8d091fc5689'],1,10,11,14772116,1,1,1,1,10279
92fc0e53845a30a320467e3657a90343d2002e8c,0,Yang Li,2016-09-30 21:48:35+08:00,['3a6b1f2d1cd1a42837353e52e3fa219c0d5a314b'],25,24,49,14772165,2,0,0,0,10279
e22039d1344f6bb768df62f73737066a7f10838a,0,Yang Li,2016-09-30 22:05:59+08:00,['92fc0e53845a30a320467e3657a90343d2002e8c'],173,118,291,14772456,11,1,1,0,10279
937cc546d1dc34832217f1b806f3e91aa486caa4,0,Yang Li,2016-10-04 15:45:45+08:00,['e22039d1344f6bb768df62f73737066a7f10838a'],11,35,46,14772502,2,,,,10279
792d4ee3fd3f12b63a34a47bb90ed7b87449f15a,0,Yang Li,2016-10-04 16:55:46+08:00,['937cc546d1dc34832217f1b806f3e91aa486caa4'],43,45,88,14772590,1,,,,10279
aa51ce0c3382d330ba5418b49eb669c964315f96,0,shaofengshi,2016-10-06 14:44:05+08:00,['792d4ee3fd3f12b63a34a47bb90ed7b87449f15a'],83,133,216,14772806,11,1,1,0.818181818,10279
334c2e09ba443b8fdcb7d4bfe08ab8fbc0ac3fbe,1,shaofengshi,2016-10-06 14:44:05+08:00,['aa51ce0c3382d330ba5418b49eb669c964315f96'],35,145,180,14772986,3,0.043478261,0.507246377,1,10279
95ebc851274953023ba092a249c1ddbbee5cd845,0,shaofengshi,2016-10-06 14:44:05+08:00,['334c2e09ba443b8fdcb7d4bfe08ab8fbc0ac3fbe'],16,5,21,14773007,3,0.666666667,0.666666667,0,10279
cd9de01c690193efede9114a6a31d1a964b0a29f,1,Yang Li,2016-10-06 17:03:13+08:00,['95ebc851274953023ba092a249c1ddbbee5cd845'],2,4,6,14773013,1,,,,10279
483e63654dbff10a789644f9b8e8039466ae393c,0,Yang Li,2016-10-07 12:40:12+08:00,['cd9de01c690193efede9114a6a31d1a964b0a29f'],0,2,2,14773015,1,0,0,1,10279
4fae26781af999c7274c176d4bf6e87e28bb9bfe,1,lidongsjtu,2016-10-07 18:22:39+08:00,['483e63654dbff10a789644f9b8e8039466ae393c'],23,34,57,14773072,1,0,1,0.785714286,10279
4c636b8a3a4df90d27f72391605b5500800a95a4,0,shaofengshi,2016-10-08 11:15:49+08:00,['4fae26781af999c7274c176d4bf6e87e28bb9bfe'],2,5,7,14773079,1,0,0,1,10279
e850593d4b32ac486021f2ba6853725ba891fef7,0,Li Yang,2016-10-08 14:47:03+08:00,['4c636b8a3a4df90d27f72391605b5500800a95a4'],1,2,3,14773082,1,1,1,1,10279
88cf5acb42170a2a1b1a5f744cfd964f0ef92159,1,shaofengshi,2016-10-09 08:47:38+08:00,['e850593d4b32ac486021f2ba6853725ba891fef7'],240,352,592,14773674,16,0.112149533,0.112149533,0.53271028,10279
c46b58b32b485efdd8060f37c2841834a54194bf,0,shaofengshi,2016-10-09 08:47:38+08:00,['88cf5acb42170a2a1b1a5f744cfd964f0ef92159'],14,259,273,14773947,4,0.979591837,1,0.908163265,10281
9d42d430f10261cb6b0df21f0c678fedde53b428,0,lidongsjtu,2016-10-09 12:52:29+08:00,['c46b58b32b485efdd8060f37c2841834a54194bf'],3,3,6,14773953,1,,,,10281
bc3cd889a18ff7f93a04af2f0ad5e9a60edbf161,1,lidongsjtu,2016-10-09 18:12:54+08:00,['9d42d430f10261cb6b0df21f0c678fedde53b428'],0,2,2,14773955,1,0,1,1,10281
14c680c9444b4a2e1a64baad4ca81498e9c27e47,0,shaofengshi,2016-10-09 19:06:17+08:00,['bc3cd889a18ff7f93a04af2f0ad5e9a60edbf161'],1,10,11,14773966,1,0,0,1,10281
71f3735073d3e29c0620c1e680d41dd495ff5ec0,0,Jason,2016-10-09 19:36:34+08:00,['14c680c9444b4a2e1a64baad4ca81498e9c27e47'],3,3,6,14773972,2,,,,10281
cb2b12b3b619ac86efbb9c7ca708418882683daf,1,shaofengshi,2016-10-10 13:30:27+08:00,['71f3735073d3e29c0620c1e680d41dd495ff5ec0'],1,293,294,14774266,4,0.993150685,1,1,10283
5aee022612c6fa40c41e8c00063714b79b6d5237,1,shaofengshi,2016-10-10 13:32:44+08:00,['cb2b12b3b619ac86efbb9c7ca708418882683daf'],2981,18,2999,14777265,45,0.671694765,0.463176575,0.306122449,10283
c67fa740d364d372c7a6424fd160570cc7e890c4,0,shaofengshi,2016-10-10 13:32:44+08:00,['5aee022612c6fa40c41e8c00063714b79b6d5237'],106,13,119,14777384,7,0,0,0,10283
ed643e6b20e31a4c3a45d72dc8e5ff1287584764,0,shaofengshi,2016-10-10 13:32:44+08:00,['c67fa740d364d372c7a6424fd160570cc7e890c4'],86,1,87,14777471,4,0,0,0,10283
7847f51cac4d8fe2be494ed20bc3616a17ad8757,0,shaofengshi,2016-10-10 15:19:09+08:00,['ed643e6b20e31a4c3a45d72dc8e5ff1287584764'],9,8,17,14777488,2,1,0,0,10283
e23f761e7b516e77018f398af6cacab675dbf761,0,Li Yang,2016-10-10 15:33:15+08:00,['7847f51cac4d8fe2be494ed20bc3616a17ad8757'],4,31,35,14777523,1,0.789473684,0.789473684,1,10283
94a9f381548ff6ecfb253e189a3319252f18d16c,0,gaodayue,2016-10-10 16:27:01+08:00,['e23f761e7b516e77018f398af6cacab675dbf761'],3,1,4,14777527,1,0,0,0,10283
dc969cd5cf7c37b1e0df6b8b6c620b9b9817754d,0,shaofengshi,2016-10-10 17:54:08+08:00,['94a9f381548ff6ecfb253e189a3319252f18d16c'],1,3,4,14777531,1,1,1,1,10283
726b0ec93f9f3b1b5da3520be385d6a2047d32c6,1,shaofengshi,2016-10-10 17:55:43+08:00,['dc969cd5cf7c37b1e0df6b8b6c620b9b9817754d'],2,3,5,14777536,1,0,0,1,10283
0c7e2688e80822cfbdad901cef909884bfa79ee8,0,Li Yang,2016-10-10 18:02:04+08:00,['726b0ec93f9f3b1b5da3520be385d6a2047d32c6'],10004,10030,20034,14797570,5,,,,10283
fad9e818fe965e15dd086bb2c33d63784b347e44,0,shaofengshi,2016-10-11 17:10:32+08:00,['0c7e2688e80822cfbdad901cef909884bfa79ee8'],0,2,2,14797572,1,0,1,1,10283
4be729e0f7616b24cb289ead635b882abc515e1b,0,shaofengshi,2016-10-11 17:21:08+08:00,['fad9e818fe965e15dd086bb2c33d63784b347e44'],5,1,6,14797578,1,1,0,0,10283
ff8510313526134e504651b2d7879c1db8a8388f,0,lidongsjtu,2016-10-11 17:28:13+08:00,['4be729e0f7616b24cb289ead635b882abc515e1b'],2,2,4,14797582,2,,,,10283
460536c001575bd09e9f059062efe0d1049d6b31,1,gaodayue,2016-10-11 20:36:11+08:00,['ff8510313526134e504651b2d7879c1db8a8388f'],147,292,439,14798021,5,0,1,1,10284
58afe0103098dd0845cb50a0751e3305a973f834,1,shaofengshi,2016-10-12 09:25:24+08:00,['460536c001575bd09e9f059062efe0d1049d6b31'],24,46,70,14798091,5,0.875,0.875,0.875,10284
8fbfc580c1b89e3e0065027eb22f8e3e5b7e0c67,1,lidongsjtu,2016-10-12 16:32:44+08:00,['58afe0103098dd0845cb50a0751e3305a973f834'],1,2,3,14798094,1,,,,10284
96935fe99996cd02efe0b8d11d25f2f67a83ad17,0,lidongsjtu,2016-10-12 17:29:00+08:00,['8fbfc580c1b89e3e0065027eb22f8e3e5b7e0c67'],0,42,42,14798136,3,,,,10287
36cf99ef77486c1361a31f3e1f748bb277eca217,0,gaodayue,2016-10-13 16:56:35+08:00,['96935fe99996cd02efe0b8d11d25f2f67a83ad17'],36,21,57,14798193,2,0.826086957,0.826086957,0,10287
5974fc0870be17a8801c55c7496093d42dbb7c4f,0,gaodayue,2016-10-13 17:16:02+08:00,['36cf99ef77486c1361a31f3e1f748bb277eca217'],16,16,32,14798225,8,,,,10287
e6698c8f054ce925adb041a85c21af8e886aa768,0,Li Yang,2016-10-13 18:55:59+08:00,['5974fc0870be17a8801c55c7496093d42dbb7c4f'],1,12,13,14798238,2,0,0,0,10287
bebbc78476c6b41b50fc0492134a5418d522533e,1,shaofengshi,2016-10-14 11:46:01+08:00,['e6698c8f054ce925adb041a85c21af8e886aa768'],16,16,32,14798270,8,,,,10287
021ccfd0984bd41e2f2286ebec83efb551899575,0,Yang Li,2016-10-15 15:59:38+08:00,['bebbc78476c6b41b50fc0492134a5418d522533e'],7,9,16,14798286,2,,,,10287
61a08d429a2c7419751b312e41bcee82048716e2,1,Yang Li,2016-10-16 07:59:33+08:00,['021ccfd0984bd41e2f2286ebec83efb551899575'],4,1,5,14798291,2,0,0,0,10287
b4c970adf18362daade77e936693dac08c0639e1,0,Yang Li,2016-10-16 08:10:05+08:00,['61a08d429a2c7419751b312e41bcee82048716e2'],3,195,198,14798489,8,0.427083333,0.802083333,0.8125,10289
0018a212470bfe1e8edd3603d383da80f2ffd322,1,Yang Li,2016-10-16 23:44:49+08:00,['b4c970adf18362daade77e936693dac08c0639e1'],119,187,306,14798795,18,0.71875,0.40625,0.9375,10289
81403c1b879f23760d91e2fc0864ece17da00d00,0,Yang Li,2016-10-17 05:54:45+08:00,['0018a212470bfe1e8edd3603d383da80f2ffd322'],6,8,14,14798809,1,1,1,1,10289
70c85a7a1279ed0246dbc3c61cc47275cd1b31c5,0,Jason,2016-10-17 11:20:01+08:00,['81403c1b879f23760d91e2fc0864ece17da00d00'],0,2,2,14798811,1,,,,10289
c3bfd770af93db7e7c295846898851c4bdc458c5,0,shaofengshi,2016-10-17 12:23:11+08:00,['70c85a7a1279ed0246dbc3c61cc47275cd1b31c5'],0,5,5,14798816,1,0,0,0,10289
ef44b7f6873b2e5ac55243818877474cdc0376d8,0,Jason,2016-10-17 13:20:16+08:00,['c3bfd770af93db7e7c295846898851c4bdc458c5'],0,20,20,14798836,3,0.823529412,0.823529412,1,10289
44cf9fba5900252fb3b4364d4bd129d83212d51c,0,Li Yang,2016-10-17 13:33:08+08:00,['ef44b7f6873b2e5ac55243818877474cdc0376d8'],141,134,275,14799111,4,,,,10289
ef0c9e5c64d5fbb1aebc415755b8f2b9ff8d1a83,1,Li Yang,2016-10-17 13:39:06+08:00,['44cf9fba5900252fb3b4364d4bd129d83212d51c'],1,2,3,14799114,2,,,,10289
3924672be05305a9374b4ba757500d89af8e125c,1,shaofengshi,2016-10-17 13:51:53+08:00,['ef0c9e5c64d5fbb1aebc415755b8f2b9ff8d1a83'],20,35,55,14799169,1,0,0,0,10289
5429006a5976a52a08ef39976dfedfeb164629ea,0,Li Yang,2016-10-17 16:45:31+08:00,['3924672be05305a9374b4ba757500d89af8e125c'],11,11,22,14799191,3,,,,10289
c92f79ad39e562ed32fff1a55eb979f0593ed6e3,0,shaofengshi,2016-10-17 17:53:56+08:00,['5429006a5976a52a08ef39976dfedfeb164629ea'],12,108,120,14799311,9,0.517241379,0.948275862,1,10289
ac356f014d52c4b13ad72e9d6a537e50e9ace5fb,0,shaofengshi,2016-10-17 18:25:26+08:00,['c92f79ad39e562ed32fff1a55eb979f0593ed6e3'],3,21,24,14799335,1,0,0.764705882,0.235294118,10289
cc2b59faf1a12e76e6af83ba3a19fbe27ba54cc3,0,shaofengshi,2016-10-17 18:25:26+08:00,['ac356f014d52c4b13ad72e9d6a537e50e9ace5fb'],1,0,1,14799336,1,,,,10289
07e81fd0b744e782d84383e327b1923cfc178d42,0,shaofengshi,2016-10-17 22:07:57+08:00,['cc2b59faf1a12e76e6af83ba3a19fbe27ba54cc3'],16,30,46,14799382,2,1,1,1,10289
c13ab1c324bf6a56e75365e0e1ab5ecd48fd048a,0,shaofengshi,2016-10-18 10:43:13+08:00,['07e81fd0b744e782d84383e327b1923cfc178d42'],12,2,14,14799396,2,0,0,0,10289
03118bd445e7cfba14b75751fb9f478fe650b88a,0,Li Yang,2016-10-18 12:37:13+08:00,['c13ab1c324bf6a56e75365e0e1ab5ecd48fd048a'],1,1,2,14799398,1,,,,10289
c84892f527a6a16904d3cb801748e35248b4d90a,0,shaofengshi,2016-10-18 15:17:01+08:00,['03118bd445e7cfba14b75751fb9f478fe650b88a'],0,1,1,14799399,1,,,,10289
d28835f69b088d8b08ed0d1bb6514116e280fd13,0,Li Yang,2016-10-18 16:29:43+08:00,['c84892f527a6a16904d3cb801748e35248b4d90a'],183,12,195,14799594,6,0.836363636,0.836363636,1,10289
4473d71011cc0e652eccf4f80269828caa5d3c73,1,Yang Li,2016-10-19 07:30:13+08:00,['d28835f69b088d8b08ed0d1bb6514116e280fd13'],13,16,29,14799623,1,0,0,0,10289
aa1550c9ecfb1c047c107fa51187a51e958ab189,0,Yang Li,2016-10-19 08:19:35+08:00,['4473d71011cc0e652eccf4f80269828caa5d3c73'],20,24,44,14799667,1,0,0,1,10289
6cafc422bc0ca2fa19a4516bcb4388719c99184c,0,Yang Li,2016-10-19 08:30:49+08:00,['aa1550c9ecfb1c047c107fa51187a51e958ab189'],10,3,13,14799680,1,1,1,1,10289
db09f5f9cae5a3d3ff731221cbb1c026da4f4e41,1,gaodayue,2016-10-19 08:36:53+08:00,['6cafc422bc0ca2fa19a4516bcb4388719c99184c'],28,420,448,14800128,10,0.682291667,0.78125,0.994791667,10292
047a23652f36012b5da03bb4c1cd57d079085717,0,Li Yang,2016-10-19 13:26:57+08:00,['db09f5f9cae5a3d3ff731221cbb1c026da4f4e41'],4,3,7,14800135,3,,,,10292
100487fc209542b4aa226e0435d22b09cf9750c5,0,Li Yang,2016-10-19 16:46:37+08:00,['047a23652f36012b5da03bb4c1cd57d079085717'],0,4,4,14800139,1,0,0,1,10292
c49eb9446514ba77b946ce83be59c2bd272ba3f7,0,lidongsjtu,2016-10-19 21:27:47+08:00,['100487fc209542b4aa226e0435d22b09cf9750c5'],0,5,5,14800144,1,0,1,1,10292
554771272038aa3eec44e01e7c4e2f95ebcfe16b,0,lidongsjtu,2016-10-19 22:01:58+08:00,['c49eb9446514ba77b946ce83be59c2bd272ba3f7'],0,3,3,14800147,2,,,,10292
1ceaf9eebe2be35071e526e90d14ac59196268d1,1,Jason,2016-10-20 11:20:15+08:00,['554771272038aa3eec44e01e7c4e2f95ebcfe16b'],18,194,212,14800359,6,0.942528736,1,0.942528736,10292
37ad942155df2e266410e878e880e9bc59fec848,0,Jason,2016-10-20 13:19:38+08:00,['1ceaf9eebe2be35071e526e90d14ac59196268d1'],1,1,2,14800361,1,,,,10292
b4329a66a4d368c653cd95e9a859305e6a77fc33,1,Jason,2016-10-20 14:12:14+08:00,['37ad942155df2e266410e878e880e9bc59fec848'],33,57,90,14800451,1,0.84,1,1,10292
111e79275ecf4393d427a17f7f6654d74e2ec1a9,0,shaofengshi,2016-10-20 14:27:52+08:00,['b4329a66a4d368c653cd95e9a859305e6a77fc33'],0,1,1,14800452,1,0,1,1,10292
0deabb6504dd901b97585a7c25aea7643c80a6f7,1,shaofengshi,2016-10-20 14:27:52+08:00,['111e79275ecf4393d427a17f7f6654d74e2ec1a9'],160,99,259,14800711,5,1,1,0,10292
501c12a3002f2d116a328fdad229f4b16e5bde75,0,shaofengshi,2016-10-20 14:27:52+08:00,['0deabb6504dd901b97585a7c25aea7643c80a6f7'],28,44,72,14800783,3,1,1,0.333333333,10292
30a4162dd7af4158c90b6965a5bcf14119fae2e1,0,shaofengshi,2016-10-20 14:27:52+08:00,['501c12a3002f2d116a328fdad229f4b16e5bde75'],19,12,31,14800814,2,0,0,0,10292
ac1d7d66e919f52fd2575c54311979d0c412ef5c,0,shaofengshi,2016-10-20 14:33:23+08:00,['30a4162dd7af4158c90b6965a5bcf14119fae2e1'],5,1,6,14800820,1,0,0,0,10292
6366215aef53514d070b9e54abd3716c5abc3615,1,Li Yang,2016-10-20 15:10:25+08:00,['ac1d7d66e919f52fd2575c54311979d0c412ef5c'],145,274,419,14801239,7,0.368421053,0.894736842,1,10294
d1bc6e3de05a184ba34b641fec9439f2772767b9,0,Jason,2016-10-20 15:31:39+08:00,['6366215aef53514d070b9e54abd3716c5abc3615'],30,26,56,14801295,4,0,1,0,10294
24f26dbd6cb5b950cf5f3139caacc984ae67f909,1,shaofengshi,2016-10-20 16:00:31+08:00,['d1bc6e3de05a184ba34b641fec9439f2772767b9'],203,8,211,14801506,5,0,0,0,10294
eef157c7d0cb59021802782fb32b111edd552bd9,0,Jason,2016-10-20 16:43:27+08:00,['24f26dbd6cb5b950cf5f3139caacc984ae67f909'],3,8,11,14801517,2,0,0,1,10294
b7e8065c0b44eb45ec11fd3b498fd72652782b84,1,Li Yang,2016-10-20 16:43:51+08:00,['eef157c7d0cb59021802782fb32b111edd552bd9'],9,46,55,14801572,1,0.944444444,0.944444444,0.611111111,10294
c7a48dd93f7733b6ddf267e8b8f56ed7153a280c,1,Li Yang,2016-10-20 16:43:51+08:00,['b7e8065c0b44eb45ec11fd3b498fd72652782b84'],6,22,28,14801600,1,0.25,0.25,0.25,10294
9cc953273aa5f90281bd688d0a02092e144c4141,0,Li Yang,2016-10-20 16:43:51+08:00,['c7a48dd93f7733b6ddf267e8b8f56ed7153a280c'],380,383,763,14802363,1,0.75,0.75,0,10294
b9fdab7f85831499f77ae2787ee9aa8a49eb2e46,1,Li Yang,2016-10-20 17:23:27+08:00,['9cc953273aa5f90281bd688d0a02092e144c4141'],15,11,26,14802389,3,1,0,0,10294
44f9ba56671e634916c6b7ba5759c1f09cbb9afc,0,shaofengshi,2016-10-20 17:30:38+08:00,['b9fdab7f85831499f77ae2787ee9aa8a49eb2e46'],10,0,10,14802399,1,0.111111111,0,0.111111111,10294
7403665cba8f8faa4985f8993dc61f9dbe06b459,0,Jason,2016-10-20 17:51:47+08:00,['44f9ba56671e634916c6b7ba5759c1f09cbb9afc'],0,8,8,14802407,1,0,0,1,10294
0060304e3461cba8faad8036890501527f70b590,0,Li Yang,2016-10-20 18:06:52+08:00,['7403665cba8f8faa4985f8993dc61f9dbe06b459'],2,1,3,14802410,1,,,,10294
5e26fd5ccc13d6eb2c6d1505cf8b7763cdf1b663,0,Jason,2016-10-20 18:13:15+08:00,['0060304e3461cba8faad8036890501527f70b590'],22,10,32,14802442,2,0,0,0,10294
bec4a888cbacf1db1dca81a50919c935b7cb1d96,0,gaodayue,2016-10-20 18:32:52+08:00,['5e26fd5ccc13d6eb2c6d1505cf8b7763cdf1b663'],1,1,2,14802444,1,,,,10294
0eab5e0ad61f66601685b18ceca1ce7833ee1287,1,shaofengshi,2016-10-20 19:08:42+08:00,['bec4a888cbacf1db1dca81a50919c935b7cb1d96'],2,3,5,14802449,1,0,0,1,10294
4f76e16c491b0d50a61bd68c9d0fd54ee4f87e4a,1,shaofengshi,2016-10-21 10:37:24+08:00,['0eab5e0ad61f66601685b18ceca1ce7833ee1287'],1,43,44,14802493,2,0.8,0,1,10294
5aa0ae318ea740eefbacbcd5bfc963b3ca2aace9,1,shaofengshi,2016-10-21 11:48:59+08:00,['4f76e16c491b0d50a61bd68c9d0fd54ee4f87e4a'],0,10,10,14802503,2,0.857142857,0.857142857,1,10294
325803d2ff47f8b2b7e9e326cc7d1781fa9877d5,1,shaofengshi,2016-10-21 14:28:49+08:00,['5aa0ae318ea740eefbacbcd5bfc963b3ca2aace9'],26,16,42,14802545,2,0,0,0,10294
2d49c88d1326bd31a22e0d3bd4a3042adcf81994,1,shaofengshi,2016-10-21 14:53:37+08:00,['325803d2ff47f8b2b7e9e326cc7d1781fa9877d5'],36,39,75,14802620,2,,,,10294
338412454cf61399ee78befe1cb30bca0ecc6346,0,Jason,2016-10-21 16:31:29+08:00,['2d49c88d1326bd31a22e0d3bd4a3042adcf81994'],1,9,10,14802630,3,,,,10294
5156ccd470fe56fa8d57671a2b6262dae3fcef96,1,Li Yang,2016-10-21 18:21:21+08:00,['338412454cf61399ee78befe1cb30bca0ecc6346'],10088,10736,20824,14823454,19,0.911764706,1,0.911764706,10299
3142c74cb22ea2b80ba36de462da69197020e1b3,1,shaofengshi,2016-10-21 18:32:52+08:00,['5156ccd470fe56fa8d57671a2b6262dae3fcef96'],60,60,120,14823574,4,0,0,0.2,10299
e119cc9bd1df5cc7895e319fe2c965ed0e0f3a88,1,Yang Li,2016-10-22 13:17:28+08:00,['3142c74cb22ea2b80ba36de462da69197020e1b3'],220,112,332,14823906,14,0.465116279,0.046511628,0.930232558,10299
cde08cdda69aa00e991b2a3260f2bcb3ad9160c2,1,Yang Li,2016-10-22 20:47:26+08:00,['e119cc9bd1df5cc7895e319fe2c965ed0e0f3a88'],210,159,369,14824275,22,0,0.113636364,0.5,10299
1c278f36899b589ba145268262d64bf65a471194,0,Yang Li,2016-10-23 07:29:08+08:00,['cde08cdda69aa00e991b2a3260f2bcb3ad9160c2'],2650,2684,5334,14829609,5,1,1,1,10299
eed5a5db59405752e3ea383158b9093a88cb721c,0,Yang Li,2016-10-23 08:04:43+08:00,['1c278f36899b589ba145268262d64bf65a471194'],2,2,4,14829613,1,,,,10299
06841bfcdf1833b5bf7e3945d93969e17888f43a,1,Yang Li,2016-10-24 08:24:02+08:00,['eed5a5db59405752e3ea383158b9093a88cb721c'],50,142,192,14829805,17,0.618421053,0.881578947,0.921052632,10299
2651640b71a7426fd34b428bcb48a49c3f097ad0,0,Li Yang,2016-10-24 13:26:47+08:00,['06841bfcdf1833b5bf7e3945d93969e17888f43a'],2,2,4,14829809,1,,,,10299
5a4486851523117e2944e57cd805d8c2d087078c,0,Jason,2016-10-24 14:46:24+08:00,['2651640b71a7426fd34b428bcb48a49c3f097ad0'],148,158,306,14830115,2,0.953846154,1,0.953846154,10299
2814f612a4530434cca3f958878dfa761bb95aa5,0,Jason,2016-10-24 14:54:53+08:00,['5a4486851523117e2944e57cd805d8c2d087078c'],0,8,8,14830123,2,,,,10299
89b8e14b79824c118cf248ed2be4987845909718,0,Li Yang,2016-10-24 15:39:33+08:00,['2814f612a4530434cca3f958878dfa761bb95aa5'],13,14,27,14830150,2,1,1,1,10299
5c23699533f3d5c32cb34371a5d6c8da661bcd71,0,Jason,2016-10-24 15:42:10+08:00,['89b8e14b79824c118cf248ed2be4987845909718'],0,5,5,14830155,1,,,,10299
b32ab335b8c30fd2c5bfbe0dc0a9701dc75f8328,0,lidongsjtu,2016-10-25 09:50:46+08:00,['5c23699533f3d5c32cb34371a5d6c8da661bcd71'],2,2,4,14830159,1,,,,10299
eb3943792e9730c07da3b56961f8d23b991b75db,0,shaofengshi,2016-10-25 11:54:50+08:00,['b32ab335b8c30fd2c5bfbe0dc0a9701dc75f8328'],15,97,112,14830271,4,0.225806452,0.096774194,0.838709677,10300
85717fe33712fe1b0f6d78e371aa9194ce5f1d4a,0,Jason,2016-10-25 20:19:55+08:00,['eb3943792e9730c07da3b56961f8d23b991b75db'],6,22,28,14830299,2,0,0,0.846153846,10300
92c823bb68c1280ae1ae48d325fa1c678a4c7812,0,Jason,2016-10-25 20:20:25+08:00,['85717fe33712fe1b0f6d78e371aa9194ce5f1d4a'],89,64,153,14830452,1,,,,10300
6350e31f4267f456706f8964c4875af90c170f99,0,Jason,2016-10-25 21:00:01+08:00,['92c823bb68c1280ae1ae48d325fa1c678a4c7812'],16,4,20,14830472,2,,,,10300
151ec3bd13c290ef250df10cef36ee94f77abaaa,0,Jason,2016-10-25 21:53:07+08:00,['6350e31f4267f456706f8964c4875af90c170f99'],2,2,4,14830476,1,,,,10300
5cdd22523a68faa4879092d4b2510ea461609f6e,1,Li Yang,2016-10-26 11:06:42+08:00,['151ec3bd13c290ef250df10cef36ee94f77abaaa'],142,351,493,14830969,16,0.456,0.432,0.696,10301
577052bd2246ec1feb02771f11ca2642a8076c4b,0,Jason,2016-10-26 19:13:45+08:00,['5cdd22523a68faa4879092d4b2510ea461609f6e'],1,1,2,14830971,1,,,,10301
69213e9991a1a69b26803852193a78628246b127,0,gaodayue,2016-10-26 21:39:11+08:00,['577052bd2246ec1feb02771f11ca2642a8076c4b'],2,5,7,14830978,1,,,,10301
ea3d02ff16fe96b0865b81d60063adbab3e462d2,1,Yang Li,2016-10-27 08:15:44+08:00,['69213e9991a1a69b26803852193a78628246b127'],74,146,220,14831198,11,0.612244898,1,1,10301
e2a932e7439d0034b26b99897d7c293cadb1b8e3,1,Hongbin Ma,2016-10-27 08:30:13+08:00,['ea3d02ff16fe96b0865b81d60063adbab3e462d2'],235,667,902,14832100,13,0.502487562,0.497512438,0.930348259,10308
ca6837d004c0da31c95027b48db589238179f1ed,0,Hongbin Ma,2016-10-27 08:30:13+08:00,['e2a932e7439d0034b26b99897d7c293cadb1b8e3'],9,12,21,14832121,4,0.5,0.5,0,10308
615e21d7fb0dae651ab643949ef5078bef7b12ea,0,Hongbin Ma,2016-10-27 08:30:13+08:00,['ca6837d004c0da31c95027b48db589238179f1ed'],44,36,80,14832201,4,0,0.2,0.2,10308
1429da5f650852402d1494785368e9175f13c379,1,Hongbin Ma,2016-10-27 08:30:13+08:00,['615e21d7fb0dae651ab643949ef5078bef7b12ea'],163,63,226,14832427,5,0.183673469,0.183673469,0,10308
46284bdca211d59f4a3274f5579dc8fe8a48cc6e,0,Hongbin Ma,2016-10-27 08:30:13+08:00,['1429da5f650852402d1494785368e9175f13c379'],13,39,52,14832479,5,0,0,1,10310
324e4239c308ba5b14a46eb3187dad3186489f92,0,Hongbin Ma,2016-10-27 08:30:13+08:00,['46284bdca211d59f4a3274f5579dc8fe8a48cc6e'],20,25,45,14832524,2,0.75,0.75,1,10310
c804dc8d77bb0402d6cd391e582a47f323edbb21,0,Hongbin Ma,2016-10-27 08:30:13+08:00,['324e4239c308ba5b14a46eb3187dad3186489f92'],17,4,21,14832545,2,0.444444444,0.444444444,0,10310
7a793e5c33f1f7bffd5a53d64ec92065abd5856a,0,shaofengshi,2016-10-27 09:10:16+08:00,['c804dc8d77bb0402d6cd391e582a47f323edbb21'],14,22,36,14832581,2,0,1,1,10310
efa945e56b1d07648c3f0507831b769d0a018e7e,0,shaofengshi,2016-10-27 09:10:23+08:00,['7a793e5c33f1f7bffd5a53d64ec92065abd5856a'],5,36,41,14832622,2,0.965517241,1,1,10310
3047b53d6fed4ae9a9f455223afc9dfefb758534,0,shaofengshi,2016-10-27 09:10:31+08:00,['efa945e56b1d07648c3f0507831b769d0a018e7e'],3,0,3,14832625,1,,,,10310
71963cbeb332a4a035d83dc18a2b090b87c15d42,0,shaofengshi,2016-10-27 10:48:10+08:00,['3047b53d6fed4ae9a9f455223afc9dfefb758534'],58,61,119,14832744,1,0,1,1,10310
4b3047a767aa7a696bf663cab96c11894a1f901e,0,lidongsjtu,2016-10-27 11:15:51+08:00,['71963cbeb332a4a035d83dc18a2b090b87c15d42'],2,0,2,14832746,1,1,0,0,10310
5c1c24a9f7cc5635e0fde5eb89be595f6a07ea25,0,gaodayue,2016-10-27 12:16:36+08:00,['4b3047a767aa7a696bf663cab96c11894a1f901e'],161,4,165,14832911,4,0.303571429,0,0,10310
a43729bc75b431bbabee49e89a4e60c60cbf6baa,0,Li Yang,2016-10-27 14:34:40+08:00,['5c1c24a9f7cc5635e0fde5eb89be595f6a07ea25'],18,0,18,14832929,2,0.230769231,0,0.230769231,10310
468fe9ffc3d1b6c6813481803dd59673f78718f1,0,Li Yang,2016-10-27 15:01:51+08:00,['a43729bc75b431bbabee49e89a4e60c60cbf6baa'],12,1,13,14832942,3,0,0,0,10310
49260dd0cb1c129d40b51c359197402441b87256,0,Hongbin Ma,2016-10-27 15:22:57+08:00,['468fe9ffc3d1b6c6813481803dd59673f78718f1'],1,1,2,14832944,1,,,,10310
3b9be19634c8f295a9c7468bcdaf8ab2aad73fcb,0,Li Yang,2016-10-27 17:09:22+08:00,['49260dd0cb1c129d40b51c359197402441b87256'],8,4,12,14832956,2,1,1,,10310
d06a425e3b30b52ae895954a9faa034da1ad0e04,0,Li Yang,2016-10-27 18:03:22+08:00,['3b9be19634c8f295a9c7468bcdaf8ab2aad73fcb'],32,46,78,14833034,3,1,1,1,10310
59228300fd5f60f415e5430859c111ab39715b55,0,lidongsjtu,2016-10-28 14:07:46+08:00,['d06a425e3b30b52ae895954a9faa034da1ad0e04'],1,1,2,14833036,1,,,,10310
a0cfaa1bcba920b98b663f19e4df8142019d5965,1,Li Yang,2016-10-28 14:52:05+08:00,['59228300fd5f60f415e5430859c111ab39715b55'],17,45,62,14833098,7,0.333333333,0,0.944444444,10310
8314e744f40a4042f4652502c621cc30591b7fd1,1,shaofengshi,2016-10-28 21:57:19+08:00,['a0cfaa1bcba920b98b663f19e4df8142019d5965'],20,22,42,14833140,2,1,1,1,10310
c5af44353d5904ddb8e9107a160872164f0e5f4d,0,shaofengshi,2016-10-28 22:17:34+08:00,['8314e744f40a4042f4652502c621cc30591b7fd1'],1,8,9,14833149,1,0,0,1,10310
650f57c88c1cad890c5ca8b7679d7d94e8279080,0,Li Yang,2016-10-29 06:48:22+08:00,['c5af44353d5904ddb8e9107a160872164f0e5f4d'],8,1,9,14833158,1,1,1,0,10310
635b3b97662515b7b9e4c58d6996c28c12fcfb28,0,Li Yang,2016-10-30 15:45:17+08:00,['650f57c88c1cad890c5ca8b7679d7d94e8279080'],22,11,33,14833191,1,0,0,0,10310
7749e1e61954dd59e448270dee520746ec8604ce,0,Yang Li,2016-10-30 19:45:41+08:00,['635b3b97662515b7b9e4c58d6996c28c12fcfb28'],0,352,352,14833543,2,0.255,0.2,0.595,10311
f2a062575eb4e0f705d532641b210c84ff0a829d,0,gaodayue,2016-10-30 22:31:50+08:00,['7749e1e61954dd59e448270dee520746ec8604ce'],61,60,121,14833664,7,1,1,0,10311
dd61f58a9892d7eb863b9e3e1c381d378e1014fa,0,Hongbin Ma,2016-10-31 12:45:16+08:00,['f2a062575eb4e0f705d532641b210c84ff0a829d'],1,2,3,14833667,1,,,,10311
9fd38bb7ad19c0feb6f7a8066718db15e77f2a3b,0,Jason,2016-10-31 14:56:10+08:00,['dd61f58a9892d7eb863b9e3e1c381d378e1014fa'],1,1,2,14833669,1,,,,10311
02f8550d8eec6d25a39cead51b7cdecfaebbec4e,0,Jason,2016-10-31 16:56:50+08:00,['9fd38bb7ad19c0feb6f7a8066718db15e77f2a3b'],236,703,939,14834608,1,0.523809524,0.604010025,0.932330827,10311
ca976f31910de0e4b69533028dfc259e6f6d6f78,0,Hongbin Ma,2016-10-31 17:07:52+08:00,['02f8550d8eec6d25a39cead51b7cdecfaebbec4e'],9,10,19,14834627,2,1,1,1,10311
81c6bd9f770b06e28a869b5f04eb7192bbb42949,0,Jason,2016-10-31 17:08:56+08:00,['ca976f31910de0e4b69533028dfc259e6f6d6f78'],36,100,136,14834763,2,0.621621622,1,0.986486486,10311
b720b8dc90f21ac642d24dc386b6cb0b7509ebd2,0,Jason,2016-10-31 17:08:56+08:00,['81c6bd9f770b06e28a869b5f04eb7192bbb42949'],5,5,10,14834773,1,,,,10311
275f23ccfab85d6484b0c6e282cffb85fddd826a,1,Jason,2016-11-01 16:51:51+08:00,['b720b8dc90f21ac642d24dc386b6cb0b7509ebd2'],48,82,130,14834903,2,1,1,1,10311
cd9423fb5b6e88f7451d0684f7d9598b7e06c381,0,gaodayue,2016-11-01 17:25:00+08:00,['275f23ccfab85d6484b0c6e282cffb85fddd826a'],92,26,118,14835021,2,0,0,0,10311
4ca3cfea6aec6e1302c48072085bf1e473f6383b,1,Jason,2016-11-01 17:35:52+08:00,['cd9423fb5b6e88f7451d0684f7d9598b7e06c381'],3,9,12,14835033,2,,,,10311
a2884f13c22c0efe9a702b585af6c5404ef7d001,0,Jason,2016-11-01 19:15:48+08:00,['4ca3cfea6aec6e1302c48072085bf1e473f6383b'],2,5,7,14835040,2,,,,10311
7d5c294406cc192a86f610f3cb56fbc2a8f5b978,1,lidongsjtu,2016-11-01 22:50:25+08:00,['a2884f13c22c0efe9a702b585af6c5404ef7d001'],47,81,128,14835168,3,0.961538462,0.961538462,1,10311
0a0a794242ed8e9ad9d89a89c97941876a490efd,0,Li Yang,2016-11-02 12:04:23+08:00,['7d5c294406cc192a86f610f3cb56fbc2a8f5b978'],11,14,25,14835193,1,0,0,1,10311
067282c4404c09d2e234d0a3f9883d851ab0f5ab,1,shaofengshi,2016-11-02 13:41:12+08:00,['0a0a794242ed8e9ad9d89a89c97941876a490efd'],6,13,19,14835212,1,0,0,1,10311
2bf5697da031dba21d2fb863018512fd89147402,0,shaofengshi,2016-11-02 13:41:12+08:00,['067282c4404c09d2e234d0a3f9883d851ab0f5ab'],1,1,2,14835214,1,,,,10311
dd1474be38cd33c1b2be349f85f340d0c629d074,1,shaofengshi,2016-11-02 16:04:44+08:00,['2bf5697da031dba21d2fb863018512fd89147402'],341,483,824,14836038,21,1,1,1,10312
cdd633c9ce224d0efc60aaffb3fac2162b86ebdd,0,shaofengshi,2016-11-02 16:05:04+08:00,['dd1474be38cd33c1b2be349f85f340d0c629d074'],1,1,2,14836040,1,,,,10312
56e600ffa984e89a78907a63708a3a7c0fa10fd7,0,shaofengshi,2016-11-02 16:05:11+08:00,['cdd633c9ce224d0efc60aaffb3fac2162b86ebdd'],2,1,3,14836043,1,0,0,0,10312
effb57edb32a4c8599a742c0f30b37ae6f1c45c4,0,shaofengshi,2016-11-02 16:26:36+08:00,['56e600ffa984e89a78907a63708a3a7c0fa10fd7'],4,4,8,14836051,1,,,,10312
5ffc5fa0aa67fa4caf30a58d1b08f64eaba5d3f7,0,shaofengshi,2016-11-02 16:56:00+08:00,['effb57edb32a4c8599a742c0f30b37ae6f1c45c4'],0,3,3,14836054,1,0,0,1,10312
f8d3f143079719b43a5758d24368ab518238dccc,0,shaofengshi,2016-11-02 18:27:57+08:00,['5ffc5fa0aa67fa4caf30a58d1b08f64eaba5d3f7'],70,1,71,14836125,6,0.129032258,0.129032258,0,10312
e8d1e345b9ca6715f28451dc00c356224e4864c2,0,Yang Li,2016-11-02 22:04:42+08:00,['f8d3f143079719b43a5758d24368ab518238dccc'],4,24,28,14836153,1,0,1,1,10312
f930472338a7cd6a5e07c7b6a7082e590fe06464,0,Hongbin Ma,2016-11-03 10:38:02+08:00,['e8d1e345b9ca6715f28451dc00c356224e4864c2'],1,1,2,14836155,1,,,,10312
d9c118bccab391b0f4155e6663e00b29074d5835,0,shaofengshi,2016-11-03 13:26:21+08:00,['f930472338a7cd6a5e07c7b6a7082e590fe06464'],1,1,2,14836157,1,,,,10312
99eb6488227b795b63349851fabce302d7697082,0,Hongbin Ma,2016-11-03 13:34:12+08:00,['d9c118bccab391b0f4155e6663e00b29074d5835'],2,2,4,14836161,1,,0,,10312
2dffc1dc47f480f374a119f02f95d8e5da84d486,0,Hongbin Ma,2016-11-03 13:34:12+08:00,['99eb6488227b795b63349851fabce302d7697082'],1,9,10,14836171,1,0,0,1,10312
7358a78a482a9de6a255ad8334fc0eeac9213be3,1,Hongbin Ma,2016-11-03 13:34:12+08:00,['2dffc1dc47f480f374a119f02f95d8e5da84d486'],5,1632,1637,14837808,18,0.274291498,0.431174089,0.836032389,10317
cad3def9e21fcfc07767e3a1b72f5b1bf8cae3de,1,Hongbin Ma,2016-11-03 13:34:12+08:00,['7358a78a482a9de6a255ad8334fc0eeac9213be3'],23,25,48,14837856,2,1,1,0,10317
2c8d7759e8662eb2a9e103a7b25948156e630e2a,1,Hongbin Ma,2016-11-03 13:34:12+08:00,['cad3def9e21fcfc07767e3a1b72f5b1bf8cae3de'],12,49,61,14837917,1,0.148148148,0.148148148,1,10317
e3e9ad3a2b347eee71aa6b243a2561e6f94fd370,0,Hongbin Ma,2016-11-03 13:34:12+08:00,['2c8d7759e8662eb2a9e103a7b25948156e630e2a'],1,1,2,14837919,1,,,,10317
f9adf10d2574bb244e1cbd18bf0f5185e044213b,0,Hongbin Ma,2016-11-03 13:34:12+08:00,['e3e9ad3a2b347eee71aa6b243a2561e6f94fd370'],3,11,14,14837933,2,0,0.2,0.8,10317
93e30208d4cf96e460948bc9df5050e43240e89b,1,shaofengshi,2016-11-03 13:40:16+08:00,['f9adf10d2574bb244e1cbd18bf0f5185e044213b'],15,12,27,14837960,1,,,,10317
b80762cd1dcc410179ab366391588486e1028ffa,0,Li Yang,2016-11-03 13:51:42+08:00,['93e30208d4cf96e460948bc9df5050e43240e89b'],0,62,62,14838022,1,0.260869565,1,1,10318
03f385795fd11daaef637cd9be837158cebc2c9c,1,Hongbin Ma,2016-11-03 14:11:44+08:00,['b80762cd1dcc410179ab366391588486e1028ffa'],14,7,21,14838043,3,1,1,0,10318
50059e388ea59c42fb9eeea2d1d92927114bcdbd,0,Li Yang,2016-11-03 14:15:03+08:00,['03f385795fd11daaef637cd9be837158cebc2c9c'],1,1,2,14838045,1,,,,10318
5da63c233fdee07b11d8e1e7886b50eba0b56f31,1,Li Yang,2016-11-03 16:42:51+08:00,['50059e388ea59c42fb9eeea2d1d92927114bcdbd'],0,5,5,14838050,1,0,1,1,10318
1395955386bb505dd4ddcb5158823552ddc699e4,0,Li Yang,2016-11-03 17:22:21+08:00,['5da63c233fdee07b11d8e1e7886b50eba0b56f31'],2,6,8,14838058,2,1,1,1,10318
235b123d09c629b685cbaf029f205bbeab887d6f,0,Li Yang,2016-11-03 18:23:01+08:00,['1395955386bb505dd4ddcb5158823552ddc699e4'],2,8,10,14838068,2,0,1,0,10318
c587b2ed3a968262a794e893f6af8fc109b02730,0,shaofengshi,2016-11-04 13:33:19+08:00,['235b123d09c629b685cbaf029f205bbeab887d6f'],5,13,18,14838086,3,0,0,1,10318
38ab2e0bdd41406657af7a948c17257d7f50d85a,0,shaofengshi,2016-11-04 14:12:20+08:00,['c587b2ed3a968262a794e893f6af8fc109b02730'],16,7,23,14838109,1,0,0,0,10318
0759ca2216a0bc439f5e7442074280df04c32522,0,shaofengshi,2016-11-04 14:29:35+08:00,['38ab2e0bdd41406657af7a948c17257d7f50d85a'],12,26,38,14838147,1,0,1,1,10318
37a98b78bc0f4192a2d0c128972369224bfda371,1,shaofengshi,2016-11-04 14:32:27+08:00,['0759ca2216a0bc439f5e7442074280df04c32522'],5,26,31,14838178,1,0.0625,0.0625,0.25,10318
4bc3490b409856a4c2ae04e2dd80bc26b5943461,0,Li Yang,2016-11-04 16:26:25+08:00,['37a98b78bc0f4192a2d0c128972369224bfda371'],48,13,61,14838239,2,0,0,0,10318
927219888307386ffd0f41bb305bddacf97533ae,0,Li Yang,2016-11-04 16:37:24+08:00,['4bc3490b409856a4c2ae04e2dd80bc26b5943461'],1,0,1,14838240,1,,,,10318
91609671882b8c639c36326ad4d506167065e576,1,Yang Li,2016-11-05 12:14:57+08:00,['927219888307386ffd0f41bb305bddacf97533ae'],77,94,171,14838411,11,,,,10319
b162e6c4eab0e373116c3d0597e19feb72de8349,0,shaofengshi,2016-11-06 15:32:22+08:00,['91609671882b8c639c36326ad4d506167065e576'],2,4,6,14838417,1,0,0,1,10319
13eeb685b71d2d2f0ed3f59c2ccde0a4ff3e8f25,0,Yang Li,2016-11-06 15:51:13+08:00,['b162e6c4eab0e373116c3d0597e19feb72de8349'],3,12,15,14838432,1,1,1,1,10319
44efded289d5489530d4d0424d8fa90740054781,1,Yang Li,2016-11-06 21:47:02+08:00,['13eeb685b71d2d2f0ed3f59c2ccde0a4ff3e8f25'],219,156,375,14838807,14,0.645833333,0.375,1,10319
840a20870783381c6673e0b4685c04cb30c31a9d,0,Jason,2016-11-07 11:17:24+08:00,['44efded289d5489530d4d0424d8fa90740054781'],2,2,4,14838811,1,,,,10319
4a1b22c7230514a031c7aed938fb7751856ef3a2,0,lidongsjtu,2016-11-07 11:40:51+08:00,['840a20870783381c6673e0b4685c04cb30c31a9d'],7,3,10,14838821,1,0,0,0,10319
eae6d2e28a18244fce09156a29f30a26559a6ef2,1,Jason,2016-11-07 14:09:11+08:00,['4a1b22c7230514a031c7aed938fb7751856ef3a2'],34,35,69,14838890,6,,,,10319
cadc85adac160bedb39536598a3108f9c0ad6537,0,Jason,2016-11-07 14:09:11+08:00,['eae6d2e28a18244fce09156a29f30a26559a6ef2'],0,1,1,14838891,1,,,,10319
a9fe953dfafae5f0aefd080d9e6c3d6a54c89fc5,1,shaofengshi,2016-11-07 14:26:37+08:00,['cadc85adac160bedb39536598a3108f9c0ad6537'],73,78,151,14839042,13,1,0.25,0.5,10319
04ac1c492ecb4dea02c3f952e3cce7bfca2b4b8d,0,Hongbin Ma,2016-11-07 14:51:39+08:00,['a9fe953dfafae5f0aefd080d9e6c3d6a54c89fc5'],5,9,14,14839056,2,1,1,1,10319
a0c4bfba39859bca5049326f227f4e6137ab106c,0,Hongbin Ma,2016-11-07 14:51:49+08:00,['04ac1c492ecb4dea02c3f952e3cce7bfca2b4b8d'],0,10,10,14839066,1,0,0,1,10319
b8acf14f5e963e48024cd479b64dcf9f1be4d2e0,1,Hongbin Ma,2016-11-07 15:01:15+08:00,['a0c4bfba39859bca5049326f227f4e6137ab106c'],9,32,41,14839107,7,0.846153846,1,0.769230769,10319
76a53da74536f4b3414bd7f5ef3950b9b489b3e8,1,shaofengshi,2016-11-07 18:21:08+08:00,['b8acf14f5e963e48024cd479b64dcf9f1be4d2e0'],115,18,133,14839240,6,0.833333333,0,0.277777778,10319
0efc45da0f87d0fd22963a296c40d6806bc48bba,0,Jason,2016-11-07 18:52:17+08:00,['76a53da74536f4b3414bd7f5ef3950b9b489b3e8'],4,39,43,14839283,4,0.487179487,1,0.974358974,10319
7211d92158c72979719df68659863ff985eafaa4,0,Yang Li,2016-11-07 20:13:47+08:00,['0efc45da0f87d0fd22963a296c40d6806bc48bba'],3,19,22,14839305,2,,,,10319
dc1866a8f21956acea6d489e37a731e87faf4502,0,lidongsjtu,2016-11-07 23:59:55+08:00,['7211d92158c72979719df68659863ff985eafaa4'],41,40,81,14839386,1,,,,10319
408f9d43d309eedf19361f0a701213214e436cdd,0,shaofengshi,2016-11-08 14:26:53+08:00,['dc1866a8f21956acea6d489e37a731e87faf4502'],3,7,10,14839396,1,0,1,1,10319
637581fb7f9b1ae1a3abde93795755aaceea4ecf,0,Hongbin Ma,2016-11-08 14:50:15+08:00,['408f9d43d309eedf19361f0a701213214e436cdd'],1,122,123,14839519,8,1,1,1,10323
9615b4ea6f817606c93df73dcafdcb151f4e8632,0,Li Yang,2016-11-08 17:02:38+08:00,['637581fb7f9b1ae1a3abde93795755aaceea4ecf'],50,53,103,14839622,20,0.8,0.8,1,10323
d5d2b9c28d625da54f7cbb72459382f73f5d8f9e,1,shaofengshi,2016-11-08 17:11:50+08:00,['9615b4ea6f817606c93df73dcafdcb151f4e8632'],44,92,136,14839758,4,0.135135135,0.135135135,1,10323
47de9611be71e3adeebe5da5041b37db5de9fa28,0,Li Yang,2016-11-08 18:56:33+08:00,['d5d2b9c28d625da54f7cbb72459382f73f5d8f9e'],107,137,244,14840002,8,0,0.3125,1,10323
74214030272ffef275ccf0359b583b3278aec468,1,shaofengshi,2016-11-08 21:29:22+08:00,['47de9611be71e3adeebe5da5041b37db5de9fa28'],26,170,196,14840198,9,0.147058824,0,0.745098039,10323
dd496a6945ba20192c2fa2bda845c055357ab44a,0,shaofengshi,2016-11-08 21:29:22+08:00,['74214030272ffef275ccf0359b583b3278aec468'],65,61,126,14840324,2,0,0,0,10323
4d9a92319ae6f0f778328f06d153cc6a7c9c93a8,1,shaofengshi,2016-11-08 21:29:22+08:00,['dd496a6945ba20192c2fa2bda845c055357ab44a'],23,12,35,14840359,1,1,1,0,10323
e7a20a063a3f007aa2a0ed5f39c616880ba46118,1,shaofengshi,2016-11-08 21:29:22+08:00,['4d9a92319ae6f0f778328f06d153cc6a7c9c93a8'],30,18,48,14840407,2,1,1,0.583333333,10323
0c6aa760e81a30b7df08c9c2015af9f03c253567,1,Yang Li,2016-11-08 23:13:57+08:00,['e7a20a063a3f007aa2a0ed5f39c616880ba46118'],17,15,32,14840439,2,0,0,0,10323
82c2e5dba0d4783714c2e55c7407f3170f2e94c0,0,Yang Li,2016-11-08 23:16:06+08:00,['0c6aa760e81a30b7df08c9c2015af9f03c253567'],1,1,2,14840441,1,,,,10323
ddec049a6b7cd9596a59aa8e2d4c500770bbddd3,0,Yang Li,2016-11-08 23:23:11+08:00,['82c2e5dba0d4783714c2e55c7407f3170f2e94c0'],5,0,5,14840446,2,,,,10323
5858448321113a33fcbbcc8167a0448f4a44abb1,1,Yang Li,2016-11-09 06:31:44+08:00,['ddec049a6b7cd9596a59aa8e2d4c500770bbddd3'],0,2742,2742,14843188,15,0.362391034,0.773972603,0.851183064,10338
4f66783e1e4a765080e26e19cc0fe53a78ca599a,1,Yang Li,2016-11-09 06:32:01+08:00,['5858448321113a33fcbbcc8167a0448f4a44abb1'],62,1182,1244,14844432,13,0.434782609,0.772173913,0.965217391,10346
85c4ded4cc6882d661d79cfbe8bec0f7d7015ba9,0,Yang Li,2016-11-09 06:32:02+08:00,['4f66783e1e4a765080e26e19cc0fe53a78ca599a'],27,7,34,14844466,4,,,,10346
b1e81d4e261a5e9367390e63f8148468fac9e001,0,Yang Li,2016-11-09 06:32:02+08:00,['85c4ded4cc6882d661d79cfbe8bec0f7d7015ba9'],107,115,222,14844688,9,0,1,1,10346
c8efa548307e6acec92740d2049b885b8b98190f,0,Yang Li,2016-11-09 06:34:04+08:00,['b1e81d4e261a5e9367390e63f8148468fac9e001'],2,11,13,14844701,2,1,1,1,10346
309593b4089a1868a92b7a8c339d2fc63911bfe7,0,shaofengshi,2016-11-09 13:38:30+08:00,['c8efa548307e6acec92740d2049b885b8b98190f'],11,44,55,14844756,3,0.142857143,0.142857143,1,10346
862aaabe6990fff7bfbfedbe72b13e1ffa370ba6,1,Li Yang,2016-11-09 16:59:24+08:00,['309593b4089a1868a92b7a8c339d2fc63911bfe7'],170,227,397,14845153,23,0.55,1,0.15,10346
5ea095a3251a6588331a26d57ae3bdee4eb61fbb,0,shaofengshi,2016-11-10 10:48:45+08:00,['862aaabe6990fff7bfbfedbe72b13e1ffa370ba6'],2,6,8,14845161,1,1,1,1,10346
6b068e36e2a1fb7b18bddcea2d73ee93c387ab99,1,Li Yang,2016-11-10 10:50:36+08:00,['5ea095a3251a6588331a26d57ae3bdee4eb61fbb'],12,8,20,14845181,4,0,0,1,10346
eea4271b34b0b5e288f9c310584c1b9d9b7b6b90,0,Li Yang,2016-11-10 13:38:34+08:00,['6b068e36e2a1fb7b18bddcea2d73ee93c387ab99'],13,1,14,14845195,4,,,,10346
6af36a5ae8fbcb82ffe45d3e7a21d0c030084051,0,shaofengshi,2016-11-10 14:42:34+08:00,['eea4271b34b0b5e288f9c310584c1b9d9b7b6b90'],0,35,35,14845230,2,,,,10346
0aca5d5b7921833f9fb97b8342166868f65b681b,0,shaofengshi,2016-11-10 14:47:36+08:00,['6af36a5ae8fbcb82ffe45d3e7a21d0c030084051'],22,22,44,14845274,22,,,,10346
8f93945a3ec2283659ddcd36d380ba2b5d9200ce,0,Li Yang,2016-11-10 18:27:32+08:00,['0aca5d5b7921833f9fb97b8342166868f65b681b'],1,1,2,14845276,1,,,,10346
9f21d2a4bc381f75411d37484f4f6119590607f9,1,zhongjian,2016-11-10 18:55:20+08:00,['8f93945a3ec2283659ddcd36d380ba2b5d9200ce'],27,42,69,14845345,2,0.6,0.9,0.9,10346
14d65c2c176263739e8fd4e0d1dd0db03c4217b3,0,Li Yang,2016-11-11 11:10:19+08:00,['9f21d2a4bc381f75411d37484f4f6119590607f9'],34,31,65,14845410,1,1,1,0,10346
e6948012549b2bbc65895e8832ea2df58b14627c,0,Hongbin Ma,2016-11-11 11:51:43+08:00,['14d65c2c176263739e8fd4e0d1dd0db03c4217b3'],4,8,12,14845422,1,0.8,1,1,10346
4faf058761e87ac0cd8dc5386b9b39da2b52c898,0,Li Yang,2016-11-11 16:09:39+08:00,['e6948012549b2bbc65895e8832ea2df58b14627c'],2,1,3,14845425,1,0,0,1,10346
0fb0a75bde38c7ec88d100049e08af92b205fb38,0,shaofengshi,2016-11-11 16:12:55+08:00,['4faf058761e87ac0cd8dc5386b9b39da2b52c898'],0,1,1,14845426,1,1,1,1,10346
a6e8c35da8e2c6d944dce4c7d261a541c312b7f6,1,Hongbin Ma,2016-11-11 16:55:57+08:00,['0fb0a75bde38c7ec88d100049e08af92b205fb38'],18,40,58,14845484,1,0,0,0,10346
8e22aae3a710d0b0a04b25b2b13814308bf3802f,0,zhongjian,2016-11-11 19:40:22+08:00,['a6e8c35da8e2c6d944dce4c7d261a541c312b7f6'],1,1,2,14845486,1,,,,10346
371e3f4b32a7e3e04be7c3fff9811f2d3619984b,0,Yang Li,2016-11-11 22:53:33+08:00,['8e22aae3a710d0b0a04b25b2b13814308bf3802f'],10,13,23,14845509,4,1,1,0,10346
cbd4dcc6ddf62b8caaaf753fb38c24c6727d9f92,0,Yang Li,2016-11-12 09:24:07+08:00,['371e3f4b32a7e3e04be7c3fff9811f2d3619984b'],2,2,4,14845513,2,,,,10346
a1847b90dd4bc40e97d3df8cee7241c6d15e8e45,0,Yang Li,2016-11-13 13:14:35+08:00,['cbd4dcc6ddf62b8caaaf753fb38c24c6727d9f92'],13,0,13,14845526,2,0,0,0,10346
b7600f87c061e4979e9fdde046a0e8606ffba331,0,Hongbin Ma,2016-11-13 17:02:21+08:00,['a1847b90dd4bc40e97d3df8cee7241c6d15e8e45'],3,3,6,14845532,2,,,,10346
f1042bf012d292c98e0d0506c10dfa0f1b2f6b7d,0,Yang Li,2016-11-13 19:14:03+08:00,['b7600f87c061e4979e9fdde046a0e8606ffba331'],3,3,6,14845538,3,,,,10346
b6d8e8849751b12706669069c83a4bedddfc9be0,0,Hongbin Ma,2016-11-13 22:56:50+08:00,['f1042bf012d292c98e0d0506c10dfa0f1b2f6b7d'],2,2,4,14845542,1,,,,10346
38dfbb3ef31ca0490647aacf0666dce0f119835b,0,Hongbin Ma,2016-11-14 13:54:12+08:00,['b6d8e8849751b12706669069c83a4bedddfc9be0'],1,1,2,14845544,1,,,,10346
07d892124231d1ad413f73b7e6a2da0428157107,0,zhongjian,2016-11-14 17:48:12+08:00,['38dfbb3ef31ca0490647aacf0666dce0f119835b'],18,14,32,14845576,2,1,0,0,10346
8ed3fbc353965da9df7f18f53e84f0515200708e,0,Hongbin Ma,2016-11-14 18:27:25+08:00,['07d892124231d1ad413f73b7e6a2da0428157107'],0,11,11,14845587,1,,,,10346
8822e78af041dbcd00f89c5e3ef65a712d394d76,0,Hongbin Ma,2016-11-14 18:27:25+08:00,['8ed3fbc353965da9df7f18f53e84f0515200708e'],1,4,5,14845592,1,0,0,1,10346
13e1e75f86b685fc5c30879f13efbd4a2c71edf0,0,gaodayue,2016-11-14 21:17:44+08:00,['8822e78af041dbcd00f89c5e3ef65a712d394d76'],80,18,98,14845690,2,0.387755102,1,0.714285714,10346
2a101f663ef3c25942a53a35d9e070afdbf97732,0,Hongbin Ma,2016-11-14 22:46:25+08:00,['13e1e75f86b685fc5c30879f13efbd4a2c71edf0'],1,2,3,14845693,1,,,,10346
c471165a49666fa7d66c860590e41229d4a9e37b,0,Li Yang,2016-11-15 13:34:34+08:00,['2a101f663ef3c25942a53a35d9e070afdbf97732'],1,0,1,14845694,1,,,,10346
22826adc35c24215c36154c3edc3f9a9981d326a,0,Li Yang,2016-11-15 15:15:42+08:00,['c471165a49666fa7d66c860590e41229d4a9e37b'],0,7,7,14845701,3,,,,10346
1c57bd40e9bd5e4ce248fdf23ad96a9fa97bde55,1,Li Yang,2016-11-15 17:18:05+08:00,['22826adc35c24215c36154c3edc3f9a9981d326a'],19,42,61,14845762,3,0.941176471,0.941176471,1,10346
2c2970feb58609e470d15be79534cce3ba9add88,0,Li Yang,2016-11-15 17:38:50+08:00,['1c57bd40e9bd5e4ce248fdf23ad96a9fa97bde55'],0,4,4,14845766,2,,,,10346
e68b257968a03809e114f6871394c4b55b05562f,0,Hongbin Ma,2016-11-15 21:06:25+08:00,['2c2970feb58609e470d15be79534cce3ba9add88'],5,13,18,14845784,2,0.5,0.5,0.5,10346
ab6e083517a16bece87db34d9f7f22a5df0662ee,0,Hongbin Ma,2016-11-15 21:33:45+08:00,['e68b257968a03809e114f6871394c4b55b05562f'],86,129,215,14845999,3,0,1,1,10346
acacb67db4aec8de1a8759579341d5d60fee04c7,0,Yang Li,2016-11-16 08:32:52+08:00,['ab6e083517a16bece87db34d9f7f22a5df0662ee'],7,155,162,14846161,6,0.717948718,1,1,10348
dd9c2c9f504e462f71ed93cf317ef4a46bf6237f,0,Hongbin Ma,2016-11-16 10:17:39+08:00,['acacb67db4aec8de1a8759579341d5d60fee04c7'],2,2,4,14846165,1,,,,10348
546ea249892742a4f004ad545cb14daa38f20b0a,0,Li Yang,2016-11-16 10:33:51+08:00,['dd9c2c9f504e462f71ed93cf317ef4a46bf6237f'],0,316,316,14846481,1,0.891566265,0.891566265,0.963855422,10349
d1c0b58598c26a7b4ce3c52717fd723839d4cf95,0,Li Yang,2016-11-16 10:33:57+08:00,['546ea249892742a4f004ad545cb14daa38f20b0a'],5,2,7,14846488,1,1,1,1,10349
40dca95711e5e9c35df0b4ff30f4a87069f3d286,1,Li Yang,2016-11-16 10:53:43+08:00,['d1c0b58598c26a7b4ce3c52717fd723839d4cf95'],158,120,278,14846766,8,1,0,0.2,10349
6b35e5e33e7d8c0f9c60a411819f5ac356e94f63,0,Li Yang,2016-11-16 10:53:48+08:00,['40dca95711e5e9c35df0b4ff30f4a87069f3d286'],1,25,26,14846792,1,1,1,1,10349
73ec4a4c20f8d8cf372a15d2100c7bfd919b4ba5,1,Li Yang,2016-11-16 11:07:31+08:00,['6b35e5e33e7d8c0f9c60a411819f5ac356e94f63'],91,69,160,14846952,4,0,0,0,10349
9410b015bfac9543106927afda323a375658b0fc,0,Li Yang,2016-11-16 11:25:02+08:00,['73ec4a4c20f8d8cf372a15d2100c7bfd919b4ba5'],22,19,41,14846993,4,1,0,0,10349
734a4f98b912a6f45957c3435b4f5be0cf54f4e8,1,Li Yang,2016-11-16 18:03:59+08:00,['9410b015bfac9543106927afda323a375658b0fc'],155,1174,1329,14848322,26,0.222664016,0.510934394,0.723658052,10351
350547e6ec6634008a4d07d771822f81acc2bcbe,1,Li Yang,2016-11-16 18:46:49+08:00,['734a4f98b912a6f45957c3435b4f5be0cf54f4e8'],387,54,441,14848763,15,0,0,1,10351
21a1c5c09e8e40adb4b11aed11ff2878fef18134,1,Yang Li,2016-11-17 07:57:31+08:00,['350547e6ec6634008a4d07d771822f81acc2bcbe'],137,90,227,14848990,2,1,0,1,10351
caf7040fc745ccca2525300979fce7785d6f0969,1,Hongbin Ma,2016-11-17 10:56:36+08:00,['21a1c5c09e8e40adb4b11aed11ff2878fef18134'],34,202,236,14849226,7,0.384615385,0.705128205,0.743589744,10353
4fcaa8ac3fdeb7709ba53b531393ab88a71ecdd5,0,Hongbin Ma,2016-11-17 10:56:36+08:00,['caf7040fc745ccca2525300979fce7785d6f0969'],13,247,260,14849486,5,0.830357143,0.839285714,1,10354
3b1850eae6ff9ec2ea5cd2d03fb1fa4e05aaafed,1,Li Yang,2016-11-17 11:26:45+08:00,['4fcaa8ac3fdeb7709ba53b531393ab88a71ecdd5'],20,82,102,14849588,2,0.230769231,0.230769231,0.942307692,10354
f3d19f6da20fa415eac641b8daf6081b3eaaf9d4,0,Hongbin Ma,2016-11-17 11:28:06+08:00,['3b1850eae6ff9ec2ea5cd2d03fb1fa4e05aaafed'],1,842,843,14850431,5,1,1,1,10357
00ba74327a0322e1ce62d3c1cf7953ab21ae9407,0,Hongbin Ma,2016-11-17 11:28:06+08:00,['f3d19f6da20fa415eac641b8daf6081b3eaaf9d4'],5,421,426,14850857,5,1,1,1,10358
0a0c5547d4f7d87696822b322a9a78112ec26c40,1,Li Yang,2016-11-17 11:34:54+08:00,['00ba74327a0322e1ce62d3c1cf7953ab21ae9407'],476,180,656,14851513,7,0.532544379,0.526627219,0.307692308,10358
28276e940955578ecda46c28543004e9cad877c9,0,Li Yang,2016-11-17 16:39:11+08:00,['0a0c5547d4f7d87696822b322a9a78112ec26c40'],2,6,8,14851521,1,0,1,1,10358
9cf480bc64b3790765a75f5312187df318aadc40,0,Hongbin Ma,2016-11-17 16:47:03+08:00,['28276e940955578ecda46c28543004e9cad877c9'],0,6,6,14851527,1,1,1,1,10358
297730dc97e705f2c8526dcdc7718cee900e40e9,1,Li Yang,2016-11-17 17:36:40+08:00,['9cf480bc64b3790765a75f5312187df318aadc40'],7,52,59,14851586,7,1,1,1,10358
971b10905e23a1b2b97d2aa19de93d38d4f527f4,0,Yang Li,2016-11-18 08:00:58+08:00,['297730dc97e705f2c8526dcdc7718cee900e40e9'],1,1,2,14851588,1,,,,10358
99079fb432ae72ca87a027642b88a594020246ce,0,Li Yang,2016-11-18 09:51:50+08:00,['971b10905e23a1b2b97d2aa19de93d38d4f527f4'],7,14,21,14851609,1,1,1,1,10358
3797ade1eb7516ae317e03e4fb9d490f5c883177,1,Li Yang,2016-11-18 15:10:29+08:00,['99079fb432ae72ca87a027642b88a594020246ce'],110,84,194,14851803,15,1,1,0.304347826,10358
c8d4136b01a1b3d5816c9db9d9e3bad0ef575a3c,0,lidongsjtu,2016-11-18 15:20:34+08:00,['3797ade1eb7516ae317e03e4fb9d490f5c883177'],2,2,4,14851807,2,,,,10358
d4a18c113131dc316d78ad98e1eaf1fb18af95c7,0,Yang Li,2016-11-19 15:04:10+08:00,['c8d4136b01a1b3d5816c9db9d9e3bad0ef575a3c'],15,52,67,14851874,4,0,1,0.967741935,10358
a6e3ccd7b22b19e03b5e3af568148816fe4a563a,0,Yang Li,2016-11-19 16:07:10+08:00,['d4a18c113131dc316d78ad98e1eaf1fb18af95c7'],253,122,375,14852249,29,0.206896552,0,0.206896552,10358
2b2eb3405fce57307496ba809e3da25c0bd9849d,1,Yang Li,2016-11-19 20:01:57+08:00,['a6e3ccd7b22b19e03b5e3af568148816fe4a563a'],3,27,30,14852279,2,1,1,1,10358
634aeaa9486171bb816a738794f136c0d1936c92,0,Yang Li,2016-11-19 20:09:29+08:00,['2b2eb3405fce57307496ba809e3da25c0bd9849d'],5,0,5,14852284,1,0,0,0,10358
1d4f57af7cf0ab89a1e1acd10bb4d1aaec1012cf,1,Yang Li,2016-11-20 07:48:48+08:00,['634aeaa9486171bb816a738794f136c0d1936c92'],89,56,145,14852429,7,0,0,0,10358
cfa3d0d431c1e396356b5c9d79092a0203664769,1,Yang Li,2016-11-20 20:43:50+08:00,['1d4f57af7cf0ab89a1e1acd10bb4d1aaec1012cf'],371,466,837,14853266,45,1,1,1,10359
09ac74c8ca548cbc7efc9089f26f91455bac5dc4,1,lidongsjtu,2016-11-21 10:18:35+08:00,['cfa3d0d431c1e396356b5c9d79092a0203664769'],7,5,12,14853278,1,1,1,0,10359
a179f5e830716947c81dae7540081dd8b38695c8,0,Li Yang,2016-11-21 11:40:45+08:00,['09ac74c8ca548cbc7efc9089f26f91455bac5dc4'],4,2,6,14853284,2,,,,10359
3ab966b650debb83eb219c9ed8d357d141466776,1,Hongbin Ma,2016-11-21 13:37:58+08:00,['a179f5e830716947c81dae7540081dd8b38695c8'],4,15,19,14853303,2,0,0,1,10359
4b525d074d82bccb89b0dad0cfa75f198ad3c4f0,0,Hongbin Ma,2016-11-21 13:37:58+08:00,['3ab966b650debb83eb219c9ed8d357d141466776'],15,24,39,14853342,3,0,0.142857143,1,10359
d38d2e9550a0a296ab7edbbbbb0155cfa39fc21f,0,Hongbin Ma,2016-11-21 13:37:59+08:00,['4b525d074d82bccb89b0dad0cfa75f198ad3c4f0'],16,23,39,14853381,3,0.714285714,0.714285714,1,10359
a0ab87cc7431bc43075914796f22d59aad719dac,0,Li Yang,2016-11-21 15:49:28+08:00,['d38d2e9550a0a296ab7edbbbbb0155cfa39fc21f'],4,4,8,14853389,2,,,,10359
5270d05fa79ed95a46beecedf18a9a515741e25a,0,Li Yang,2016-11-21 17:10:55+08:00,['a0ab87cc7431bc43075914796f22d59aad719dac'],11,16,27,14853416,2,0,0,1,10359
e6d22ba2f737fecb3032a330d98fcf8e4aa4148a,1,lidongsjtu,2016-11-22 09:07:41+08:00,['5270d05fa79ed95a46beecedf18a9a515741e25a'],1,7,8,14853424,1,0,0,1,10359
d5b414ae161eae4d37dbd015cb8311d3108b954f,0,Li Yang,2016-11-22 11:36:13+08:00,['e6d22ba2f737fecb3032a330d98fcf8e4aa4148a'],0,3,3,14853427,1,,,,10359
51830456f63403d37c9be00f75fc1cc5cdfbd6be,0,Li Yang,2016-11-22 11:40:15+08:00,['d5b414ae161eae4d37dbd015cb8311d3108b954f'],2,10,12,14853439,1,1,1,1,10359
58991331d276e127695893c2041bce37934c836f,0,Hongbin Ma,2016-11-22 13:42:57+08:00,['51830456f63403d37c9be00f75fc1cc5cdfbd6be'],17,20,37,14853476,2,1,0,1,10359
12221a327f7e70c1aa0401c6f9b30d761d1b58b4,0,Hongbin Ma,2016-11-22 13:59:56+08:00,['58991331d276e127695893c2041bce37934c836f'],111,191,302,14853778,5,1,1,1,10359
8132cab31fc084cf6b83ab29884e6821d86bf249,0,Hongbin Ma,2016-11-22 14:00:12+08:00,['12221a327f7e70c1aa0401c6f9b30d761d1b58b4'],35,70,105,14853883,3,0.434782609,0,0.826086957,10359
1c730b91b3c0847873dbbf74106647b663be1942,0,Hongbin Ma,2016-11-22 15:32:31+08:00,['8132cab31fc084cf6b83ab29884e6821d86bf249'],234,11,245,14854128,5,0.203703704,0.166666667,0,10359
a058049c8824db19c0a7bb724fc7ed3b920ff2d6,0,Hongbin Ma,2016-11-22 16:50:34+08:00,['1c730b91b3c0847873dbbf74106647b663be1942'],2,2,4,14854132,1,,,,10359
bce9ab822492772c7c2b42421941421dfb27f9f7,0,Hongbin Ma,2016-11-22 17:14:04+08:00,['a058049c8824db19c0a7bb724fc7ed3b920ff2d6'],1,1,2,14854134,1,,,,10359
79cb59cfda2caa9b4a623d2e425c6b3d99ea50db,0,Li Yang,2016-11-22 18:36:32+08:00,['bce9ab822492772c7c2b42421941421dfb27f9f7'],9,186,195,14854329,2,0,0,0,10359
2b7fe6106d5363d9993dfd7b7f27c49319ed7d44,1,Li Yang,2016-11-22 18:39:35+08:00,['79cb59cfda2caa9b4a623d2e425c6b3d99ea50db'],870,31046,31916,14886245,52,0.90625,0.645833333,1,10381
c8dfa13e633517bbfde7125ce286429f643e5af6,0,shaofengshi,2016-11-22 21:43:54+08:00,['2b7fe6106d5363d9993dfd7b7f27c49319ed7d44'],1,1,2,14886247,1,,0,,10381
657aa31b29b1b22d96c7ef121276ffa60ba9ea5d,0,shaofengshi,2016-11-22 22:41:11+08:00,['c8dfa13e633517bbfde7125ce286429f643e5af6'],3,3,6,14886253,1,,,,10381
747337ae405b7f21aa711a66e2f58bf6547f8f67,0,shaofengshi,2016-11-22 22:42:16+08:00,['657aa31b29b1b22d96c7ef121276ffa60ba9ea5d'],0,9,9,14886262,1,,,,10381
53b5a2752bfb282445572e2dbabe6cee93cf404c,1,Yang Li,2016-11-23 08:23:22+08:00,['747337ae405b7f21aa711a66e2f58bf6547f8f67'],224,291,515,14886777,4,0,0.142857143,1,10382
1ec1ffccd787036cbc89d0a549adcbb0469cb1ec,1,Hongbin Ma,2016-11-23 11:46:35+08:00,['53b5a2752bfb282445572e2dbabe6cee93cf404c'],7,8,15,14886792,3,,,0,10382
826f23f14f60ba068b8594ba312c14e66c4807f2,1,Li Yang,2016-11-23 17:08:29+08:00,['1ec1ffccd787036cbc89d0a549adcbb0469cb1ec'],6858,6869,13727,14900519,91,0.888888889,0.888888889,1,10382
2cca348c608aa8674572ee6bee53fbf48e40e4df,1,Li Yang,2016-11-23 17:08:29+08:00,['826f23f14f60ba068b8594ba312c14e66c4807f2'],187,193,380,14900899,13,0.764705882,0,1,10382
3e4e82f06e1e6f7343d87259d912db3abc8c5a96,0,lidongsjtu,2016-11-23 17:13:35+08:00,['2cca348c608aa8674572ee6bee53fbf48e40e4df'],4,6,10,14900909,2,0,0,1,10382
b8e764d434ab12b9fb7b902ac8dea0d6b792dec5,0,Hongbin Ma,2016-11-23 18:14:45+08:00,['3e4e82f06e1e6f7343d87259d912db3abc8c5a96'],36,43,79,14900988,7,0,0,0,10383
83adb8eb8700d388aa042d833e7fea9746282624,0,Hongbin Ma,2016-11-23 18:14:45+08:00,['b8e764d434ab12b9fb7b902ac8dea0d6b792dec5'],0,1,1,14900989,1,,,,10383
53b5a6d8e2fa854cbf09ea66fc39bdfbd961950f,0,Yang Li,2016-11-23 22:28:38+08:00,['83adb8eb8700d388aa042d833e7fea9746282624'],9,3,12,14901001,2,1,0,1,10383
798f03ed2eaaddaee5930ff074a022655fec51ff,1,shaofengshi,2016-11-24 09:11:33+08:00,['53b5a6d8e2fa854cbf09ea66fc39bdfbd961950f'],10,122,132,14901133,15,0.842105263,0.421052632,0.986842105,10383
873f903f3d95afa2cec5e1d6d3027f1b62f3ec54,1,Li Yang,2016-11-24 13:00:42+08:00,['798f03ed2eaaddaee5930ff074a022655fec51ff'],68,141,209,14901342,6,0.319148936,1,1,10383
af3e4fece65b7f7add39bb016ba03e0e7774ab3e,0,shaofengshi,2016-11-24 13:38:25+08:00,['873f903f3d95afa2cec5e1d6d3027f1b62f3ec54'],2,4,6,14901348,1,,,,10383
827205f17b61d1e1ac9d6af580e04583c1079003,0,Li Yang,2016-11-24 15:18:19+08:00,['af3e4fece65b7f7add39bb016ba03e0e7774ab3e'],480,193,673,14902021,19,0.102564103,0.085470085,0.239316239,10383
e1d5b29385a5c044fe7f60d27d59baf82499b3de,0,shaofengshi,2016-11-24 18:14:27+08:00,['827205f17b61d1e1ac9d6af580e04583c1079003'],3,48,51,14902072,6,1,1,1,10383
6afcb2690c0d7eefd50e103e298aff80286776a4,0,Yang Li,2016-11-24 21:55:19+08:00,['e1d5b29385a5c044fe7f60d27d59baf82499b3de'],1,1,2,14902074,1,,,,10383
8530ebd692b3362f7fb9eb07160c8c069d467fc4,0,Hongbin Ma,2016-11-25 09:58:10+08:00,['6afcb2690c0d7eefd50e103e298aff80286776a4'],15,4,19,14902093,2,1,1,0,10383
89875fae78556d4d5f5099accb70d6572faeb3d4,1,Li Yang,2016-11-25 14:49:58+08:00,['8530ebd692b3362f7fb9eb07160c8c069d467fc4'],367,411,778,14902871,1,,,,10383
d367bf56df8cf6581cc3dbdae57b5ed167be47f7,1,Li Yang,2016-11-25 15:05:19+08:00,['89875fae78556d4d5f5099accb70d6572faeb3d4'],2,9,11,14902882,3,1,1,1,10383
ddc003c860cd4566e4995aa160f89a8d4b93934f,0,shaofengshi,2016-11-25 18:08:36+08:00,['d367bf56df8cf6581cc3dbdae57b5ed167be47f7'],0,1,1,14902883,1,,,,10383
25f0819fab211749ac81dff4bbd4812e2be637ed,0,Yang Li,2016-11-26 13:02:16+08:00,['ddc003c860cd4566e4995aa160f89a8d4b93934f'],27,2,29,14902912,3,0,0,0,10383
ff2d79c4e032ef243e584730738e5ba2d12ed5c0,1,Yang Li,2016-11-26 13:02:17+08:00,['25f0819fab211749ac81dff4bbd4812e2be637ed'],50,93,143,14903055,7,1,1,0,10383
5edffa51df0cfd6c34682a0c999aac2a114592d2,1,Yang Li,2016-11-26 13:02:22+08:00,['ff2d79c4e032ef243e584730738e5ba2d12ed5c0'],23,182,205,14903260,17,0.511363636,0.681818182,0.920454545,10384
99f1dd9d2460566748db2167e69a6a8a7689271d,0,lidongsjtu,2016-11-28 08:46:35+08:00,['5edffa51df0cfd6c34682a0c999aac2a114592d2'],121,12,133,14903393,9,0.754716981,0.716981132,0,10384
3f10b3a534166f43118caf0564ad521a9fb2632f,0,lidongsjtu,2016-11-28 09:02:36+08:00,['99f1dd9d2460566748db2167e69a6a8a7689271d'],1,1,2,14903395,1,,,,10384
be7b5d1012e4ba0f8696ccbf9c0507706c07ad22,1,Li Yang,2016-11-28 16:23:38+08:00,['3f10b3a534166f43118caf0564ad521a9fb2632f'],2,23,25,14903420,2,0.411764706,0.411764706,1,10384
a2ecf18de8ceb73f6b2748cd3e1d7b43ac1ca8ac,0,Li Yang,2016-11-28 16:28:56+08:00,['be7b5d1012e4ba0f8696ccbf9c0507706c07ad22'],12,2,14,14903434,1,1,1,0,10384
b1448e5789ce65d5b94ed246df01fa4c269515b2,0,lidongsjtu,2016-11-28 23:37:41+08:00,['a2ecf18de8ceb73f6b2748cd3e1d7b43ac1ca8ac'],1,45,46,14903480,2,1,1,1,10385
c3d62e9c5e6c39771bec1bbe2660130ff2033ef3,0,lidongsjtu,2016-11-28 23:48:46+08:00,['b1448e5789ce65d5b94ed246df01fa4c269515b2'],2,2,4,14903484,1,,,,10385
a1a2a4a643d013471079ac0d353bbf179fd0d85c,0,Yang Li,2016-11-29 07:25:25+08:00,['c3d62e9c5e6c39771bec1bbe2660130ff2033ef3'],10090,20246,30336,14933820,20,1,0,,10387
bda8787d1a5c9bbe7d94798091763e1004a1eb61,1,Yang Li,2016-11-29 07:25:29+08:00,['a1a2a4a643d013471079ac0d353bbf179fd0d85c'],221,1293,1514,14935334,18,1,1,0.613861386,10396
8506e4d4f75fbbda518997cac97e3333229fa5a0,0,lidongsjtu,2016-11-29 18:24:07+08:00,['bda8787d1a5c9bbe7d94798091763e1004a1eb61'],2,10,12,14935346,1,,,,10396
3186d176113596c71a47d98a927564cefff3b123,0,lidongsjtu,2016-11-29 19:11:50+08:00,['8506e4d4f75fbbda518997cac97e3333229fa5a0'],10,2,12,14935358,1,,,,10396
875a5931ad8cad79cdec1e80ab9388ded9446091,0,Hongbin Ma,2016-11-30 13:48:29+08:00,['3186d176113596c71a47d98a927564cefff3b123'],5,36,41,14935399,3,1,0.976190476,0.976190476,10396
b1b90adbe896e808776caf49ad7172979cf860df,0,Hongbin Ma,2016-11-30 13:49:16+08:00,['875a5931ad8cad79cdec1e80ab9388ded9446091'],1,27,28,14935427,1,1,1,1,10396
1af08e4b8875d33bfc5dd124fed72d6042456c32,1,Li Yang,2016-11-30 15:31:58+08:00,['b1b90adbe896e808776caf49ad7172979cf860df'],60,547,607,14936034,13,0.44015444,0.536679537,0.845559846,10400
30cb1ac678b063ac164acd27591e8a1d0becafa0,1,Yang Li,2016-11-30 21:00:17+08:00,['1af08e4b8875d33bfc5dd124fed72d6042456c32'],427,231,658,14936692,13,0.834862385,0.458715596,0.853211009,10400
93bf0d0214fe446d794b61e02fb18ff8097611d1,0,Hongbin Ma,2016-12-01 11:40:25+08:00,['30cb1ac678b063ac164acd27591e8a1d0becafa0'],8,35,43,14936735,3,1,1,1,10400
28ba1eaeac8fd29ff3872f6d14604813a89b3a6e,0,Hongbin Ma,2016-12-01 11:46:00+08:00,['93bf0d0214fe446d794b61e02fb18ff8097611d1'],5,13,18,14936753,2,0,1,1,10400
58224921d896e4479f5d034d43c044aacaf14200,0,Hongbin Ma,2016-12-01 18:15:46+08:00,['28ba1eaeac8fd29ff3872f6d14604813a89b3a6e'],36,33,69,14936822,7,1,0,1,10400
1a5295bad21fc18766bb3c7ba6eee59678d42185,0,Hongbin Ma,2016-12-01 18:17:35+08:00,['58224921d896e4479f5d034d43c044aacaf14200'],7,7,14,14936836,3,,,,10400
9fc8f5e207b5111fffaec3335efe0c8947353cfa,0,Li Yang,2016-12-02 11:39:34+08:00,['1a5295bad21fc18766bb3c7ba6eee59678d42185'],1,10,11,14936847,1,0,1,1,10400
3091f06a68e0b97b35639cbb65acbf532c114ca4,0,Li Yang,2016-12-02 13:21:54+08:00,['9fc8f5e207b5111fffaec3335efe0c8947353cfa'],0,31,31,14936878,1,,,,10401
e562aafee10c8bbd125937503d42b958c1843aad,1,Hongbin Ma,2016-12-02 13:33:18+08:00,['3091f06a68e0b97b35639cbb65acbf532c114ca4'],7,56,63,14936941,7,0.730769231,0.769230769,0,10401
4a0ee7989d5f8272592b980fce3f5716ca40d4c1,1,gaodayue,2016-12-02 13:33:59+08:00,['e562aafee10c8bbd125937503d42b958c1843aad'],1283,1737,3020,14939961,29,0.560344828,0.833333333,0.718390805,10402
3ca53954415c62c2a91473c6d7bf831504b5e9db,1,Li Yang,2016-12-02 17:26:07+08:00,['4a0ee7989d5f8272592b980fce3f5716ca40d4c1'],111,176,287,14940248,7,1,1,1,10403
0eebd7d8ab10b6b2b4823d6a23eaa774ac36989e,0,Li Yang,2016-12-02 17:26:13+08:00,['3ca53954415c62c2a91473c6d7bf831504b5e9db'],19,14,33,14940281,3,0,0,0,10403
0fd1ed6f14758bb38f1abf7a7ed9e24ed818f50f,0,Li Yang,2016-12-02 18:32:24+08:00,['0eebd7d8ab10b6b2b4823d6a23eaa774ac36989e'],0,58,58,14940339,6,0.058823529,0.058823529,1,10404
eb686a9428d930a60ec87883a2c253fb07f80a72,0,Li Yang,2016-12-02 18:34:29+08:00,['0fd1ed6f14758bb38f1abf7a7ed9e24ed818f50f'],0,4,4,14940343,1,0.5,1,1,10404
fe9efa86cd34da31ec41dc176140ee4ee2f49fed,0,Hongbin Ma,2016-12-04 21:26:18+08:00,['eb686a9428d930a60ec87883a2c253fb07f80a72'],1,11,12,14940355,1,0.777777778,0.777777778,1,10404
a03eec88f3b4e60d1f1d6bd2fd5922a97aec23f5,1,Hongbin Ma,2016-12-04 21:28:17+08:00,['fe9efa86cd34da31ec41dc176140ee4ee2f49fed'],4,30,34,14940389,1,1,1,1,10404
00a4c5064bfe894bb8c106a214277d4d1d0f3c70,0,Hongbin Ma,2016-12-04 21:41:07+08:00,['a03eec88f3b4e60d1f1d6bd2fd5922a97aec23f5'],1,1,2,14940391,1,,,,10404
9556152622599a87610f16ae8f06185e24ec02d6,0,Hongbin Ma,2016-12-05 10:58:31+08:00,['00a4c5064bfe894bb8c106a214277d4d1d0f3c70'],0,4,4,14940395,1,1,1,1,10404
8f3239bf9ea4f1abd8d2c814967d425d4da68a45,1,Hongbin Ma,2016-12-05 13:43:03+08:00,['9556152622599a87610f16ae8f06185e24ec02d6'],41,53,94,14940489,3,1,1,0,10404
af429e5cbbda2a64159b25bc5ce4ad70f2f1a1f2,0,Hongbin Ma,2016-12-05 15:05:35+08:00,['8f3239bf9ea4f1abd8d2c814967d425d4da68a45'],2,71,73,14940562,5,,,,10408
59a30f66d47cc1838e6852405699fd7957bfac29,1,shaofengshi,2016-12-05 17:42:34+08:00,['af429e5cbbda2a64159b25bc5ce4ad70f2f1a1f2'],34,13,47,14940609,1,1,1,0,10408
0a441c3fa30aee0a06cfc6301f7fbfa412103179,1,Yang Li,2016-12-05 20:20:30+08:00,['59a30f66d47cc1838e6852405699fd7957bfac29'],169,221,390,14940999,4,1,0.787878788,0,10408
fc1e11aa8a2d20add72e382396787d9cb09771da,0,Yang Li,2016-12-05 21:20:21+08:00,['0a441c3fa30aee0a06cfc6301f7fbfa412103179'],11,7,18,14941017,4,0,0,1,10408
9968c2257c2a8605637a93830d1d95db94185dce,0,Li Yang,2016-12-06 11:10:26+08:00,['fc1e11aa8a2d20add72e382396787d9cb09771da'],33,10,43,14941060,5,0,1,0,10408
d2aaf2705a9035be9dbef8205fc9a1358b4316c2,0,Hongbin Ma,2016-12-06 13:50:28+08:00,['9968c2257c2a8605637a93830d1d95db94185dce'],10000,10000,20000,14961060,1,,,,10408
76999735f4157b6064eb099b59a7c79fbc9b6007,1,Hongbin Ma,2016-12-06 13:50:28+08:00,['d2aaf2705a9035be9dbef8205fc9a1358b4316c2'],55,138,193,14961253,5,0.289473684,0.973684211,0.973684211,10409
b5c058801b916ddc6e00085d652ad6a0497ce7d9,1,Li Yang,2016-12-06 16:46:40+08:00,['76999735f4157b6064eb099b59a7c79fbc9b6007'],11,20,31,14961284,4,1,1,1,10409
a53eafaa30d5bb8bf5b52404bb6bbc1dcd9673e8,0,Li Yang,2016-12-06 18:39:03+08:00,['b5c058801b916ddc6e00085d652ad6a0497ce7d9'],1,1,2,14961286,1,,,,10409
ea13af4d8aa6a5b25fc328ee1adaf2b454eddea0,0,Billy Liu,2016-12-07 09:01:52+08:00,['a53eafaa30d5bb8bf5b52404bb6bbc1dcd9673e8'],4,4,8,14961294,1,,,,10409
1e787165edee713a59db8627e70f79edabfd7d9d,0,Billy Liu,2016-12-07 09:42:58+08:00,['ea13af4d8aa6a5b25fc328ee1adaf2b454eddea0'],3,31,34,14961328,4,0,0,1,10409
081ed0d505e5638b1294c59e57ed651a0f9dffa1,0,lidongsjtu,2016-12-07 11:10:49+08:00,['1e787165edee713a59db8627e70f79edabfd7d9d'],0,0,0,14961328,1,,,,10409
967ef18062048e199cd0dd351ba82618a10b08e5,1,Li Yang,2016-12-07 17:53:35+08:00,['081ed0d505e5638b1294c59e57ed651a0f9dffa1'],56,64,120,14961448,8,1,1,1,10409
227bbf4152074c0621bf2b1047102d416d4dd3eb,1,Li Yang,2016-12-07 17:53:36+08:00,['967ef18062048e199cd0dd351ba82618a10b08e5'],9,28,37,14961485,2,0,0,1,10409
64d9b8b89f84cc31f9931e5a6cdf89bdfa13925a,1,Li Yang,2016-12-07 17:53:37+08:00,['227bbf4152074c0621bf2b1047102d416d4dd3eb'],81,59,140,14961625,7,0.7,0,0,10409
79e48011bd3f4696a916f0bfee244ec28355f3b3,0,Li Yang,2016-12-07 17:53:38+08:00,['64d9b8b89f84cc31f9931e5a6cdf89bdfa13925a'],18,30,48,14961673,3,1,1,0.428571429,10409
92e4d464069745f0c58cc0559e054efa470960c1,1,Li Yang,2016-12-07 17:53:39+08:00,['79e48011bd3f4696a916f0bfee244ec28355f3b3'],33,41,74,14961747,9,0,0,1,10409
365caaebd841917f161dab37b0af7c055626194c,1,Li Yang,2016-12-07 17:53:46+08:00,['92e4d464069745f0c58cc0559e054efa470960c1'],10,21,31,14961778,6,,,,10409
b1fd4679fa80e8e971d553a42baf20198afb9eac,0,Billy Liu,2016-12-07 18:29:07+08:00,['365caaebd841917f161dab37b0af7c055626194c'],0,33,33,14961811,1,1,1,1,10409
350fad8f248988596c05b080b3c5a68b77b790a1,1,Li Yang,2016-12-08 09:47:27+08:00,['b1fd4679fa80e8e971d553a42baf20198afb9eac'],41,66,107,14961918,6,0,0,0,10410
21bcd2f6b7d56e639aba18f3f376875922c9cd68,0,lidongsjtu,2016-12-08 10:40:55+08:00,['350fad8f248988596c05b080b3c5a68b77b790a1'],10000,10000,20000,14981918,1,,,,10410
545201f6c0c2e4da9b3dcabac0f606e2ef880d19,0,Li Yang,2016-12-08 10:54:58+08:00,['21bcd2f6b7d56e639aba18f3f376875922c9cd68'],6149,0,6149,14988067,24,0.471440997,0.261815019,0.218614091,10410
c0c56f4b6b05bb108a4952a56af992b237c1bbe6,0,Li Yang,2016-12-08 11:09:31+08:00,['545201f6c0c2e4da9b3dcabac0f606e2ef880d19'],1,7,8,14988075,1,0,0,1,10410
4c39fcb0eaab053d43554ac6add377343d585065,1,Li Yang,2016-12-08 11:14:31+08:00,['c0c56f4b6b05bb108a4952a56af992b237c1bbe6'],4,3,7,14988082,1,1,1,0,10410
8b64620631200a724117dec97e3c69c19d9cf22c,0,Li Yang,2016-12-08 14:48:11+08:00,['4c39fcb0eaab053d43554ac6add377343d585065'],6,0,6,14988088,1,1,1,0,10410
af8940d5b38087f71edfe4d3eb4bb32af1177bab,0,Li Yang,2016-12-08 15:06:04+08:00,['8b64620631200a724117dec97e3c69c19d9cf22c'],4,3,7,14988095,1,0,0,0,10410
c0b87039eb45ee94c6ecab71e27d14ee81bac8e2,0,Hongbin Ma,2016-12-08 16:04:09+08:00,['af8940d5b38087f71edfe4d3eb4bb32af1177bab'],5,7,12,14988107,3,1,1,1,10410
c94d2182904b0f1174eaba2504ce242b7d509168,0,Li Yang,2016-12-08 16:57:38+08:00,['c0b87039eb45ee94c6ecab71e27d14ee81bac8e2'],5,11,16,14988123,1,0,0.4,1,10410
6599a068cdd34efda37bb3297a14639b28f1bd8c,0,Li Yang,2016-12-08 18:09:58+08:00,['c94d2182904b0f1174eaba2504ce242b7d509168'],0,0,0,14988123,1,,,,10410
763b14086ad7334a995f494ded14654a154f81a7,0,Billy Liu,2016-12-08 18:40:20+08:00,['6599a068cdd34efda37bb3297a14639b28f1bd8c'],1,3,4,14988127,1,0,1,1,10410
2814ce774c5bfc88f012beac7de9f46692f4aadd,0,lidongsjtu,2016-12-08 18:42:54+08:00,['763b14086ad7334a995f494ded14654a154f81a7'],1,1,2,14988129,1,,,,10410
ea60803e20ac17489f513bf6af29b183829db020,1,Yang Li,2016-12-08 21:09:11+08:00,['2814ce774c5bfc88f012beac7de9f46692f4aadd'],57,255,312,14988441,11,0.747368421,0.463157895,0.715789474,10411
c31c8490b05d5f9618464f431cc3d923b012e9b8,0,Yang Li,2016-12-08 21:23:18+08:00,['ea60803e20ac17489f513bf6af29b183829db020'],3,3,6,14988447,2,,,,10411
940d84f237652a35f5d7debb05115ee13a938aa5,0,Yang Li,2016-12-09 06:51:48+08:00,['c31c8490b05d5f9618464f431cc3d923b012e9b8'],35,21,56,14988503,4,0.583333333,1,0,10411
7ae06634e1b4b48af342a7218214f1aeb50b32c7,0,Yang Li,2016-12-09 06:57:40+08:00,['940d84f237652a35f5d7debb05115ee13a938aa5'],2,2,4,14988507,1,,,,10411
01060b574cb6186f040dac398e2eb2a90b052d42,0,Yang Li,2016-12-09 12:11:08+08:00,['7ae06634e1b4b48af342a7218214f1aeb50b32c7'],1,2,3,14988510,1,0,0,0,10411
9021c085e541457d3676c287a9be347a8d093037,0,Billy Liu,2016-12-09 14:31:52+08:00,['01060b574cb6186f040dac398e2eb2a90b052d42'],4,16,20,14988530,1,1,1,1,10411
9e8d13482a9ecaa4bfd08d7077a04f34cea19286,0,Billy Liu,2016-12-09 15:23:12+08:00,['9021c085e541457d3676c287a9be347a8d093037'],7,6,13,14988543,1,,,,10411
a006c98244ec21fbbbba71ed4b63d56059278e1d,0,gaodayue,2016-12-09 19:33:35+08:00,['9e8d13482a9ecaa4bfd08d7077a04f34cea19286'],6,12,18,14988561,1,1,1,1,10411
19a613958701b5a15210bc3e680e6d82c2d6d02e,0,gaodayue,2016-12-09 22:48:52+08:00,['a006c98244ec21fbbbba71ed4b63d56059278e1d'],12,6,18,14988579,1,0,0,0,10411
fbb7ed921a8b63c3b62cb85bf64fb79ba650431d,1,gaodayue,2016-12-09 22:49:28+08:00,['19a613958701b5a15210bc3e680e6d82c2d6d02e'],6,12,18,14988597,1,1,1,1,10411
77d5d7d627dcbb0ed66461a46834711106a055e1,1,lidongsjtu,2016-12-10 20:36:15+08:00,['fbb7ed921a8b63c3b62cb85bf64fb79ba650431d'],10,95,105,14988702,4,0.451612903,1,1,10412
6957fd767056864fc8e3898f2c2fc28ffbd51d03,1,shaofengshi,2016-12-11 15:04:45+08:00,['77d5d7d627dcbb0ed66461a46834711106a055e1'],0,4,4,14988706,1,1,1,0,10412
5d6bfbaa46dfd4b0ea899a7aa05bbc357732edc0,0,Li Yang,2016-12-11 20:04:08+08:00,['6957fd767056864fc8e3898f2c2fc28ffbd51d03'],27,16,43,14988749,2,0,0,0,10412
65c58990802c644ea35005c301ba2951a9b7e6a5,0,shaofengshi,2016-12-12 10:55:32+08:00,['5d6bfbaa46dfd4b0ea899a7aa05bbc357732edc0'],14,2,16,14988765,3,0.111111111,0,0.111111111,10412
8265c3b0e567e0c9ffd9d4bcb04d7ef2bbfecdbd,1,shaofengshi,2016-12-12 11:31:06+08:00,['65c58990802c644ea35005c301ba2951a9b7e6a5'],7,7,14,14988779,2,0,0,1,10412
4408579d4b3e9f33364d738b569e5f81d6fcb5c9,0,shaofengshi,2016-12-12 11:37:25+08:00,['8265c3b0e567e0c9ffd9d4bcb04d7ef2bbfecdbd'],2,2,4,14988783,1,,,,10412
8ffb0e7103d63d2c0f5d093f3afde1a0490eb8a0,0,shaofengshi,2016-12-12 14:19:55+08:00,['4408579d4b3e9f33364d738b569e5f81d6fcb5c9'],21,20,41,14988824,2,1,1,1,10412
a4ddbbdde876d0690dd65ea8549e8d40cfb5fdd1,1,shaofengshi,2016-12-12 14:34:19+08:00,['8ffb0e7103d63d2c0f5d093f3afde1a0490eb8a0'],1,1,2,14988826,1,,,,10412
d11d019c98e11bf058381752d605f842a8eb30b1,0,shaofengshi,2016-12-12 16:22:15+08:00,['a4ddbbdde876d0690dd65ea8549e8d40cfb5fdd1'],0,13,13,14988839,2,0,0,1,10412
e393338124302f60ff6e85e5fdc2e8cb806696f5,0,Billy Liu,2016-12-13 08:03:22+08:00,['d11d019c98e11bf058381752d605f842a8eb30b1'],1,1,2,14988841,1,,,,10412
05f35f0e41269f21c228bbf638a927d3bdf93887,0,lidongsjtu,2016-12-13 10:38:34+08:00,['e393338124302f60ff6e85e5fdc2e8cb806696f5'],1,1,2,14988843,1,,,,10412
5303651316ee6911e312130624534315267ef99a,0,lidongsjtu,2016-12-13 13:05:51+08:00,['05f35f0e41269f21c228bbf638a927d3bdf93887'],2,2,4,14988847,4,1,,,10412
f05404d5576b52c70cf26eb1bccde1c27cd3852f,0,Li Yang,2016-12-14 11:07:42+08:00,['5303651316ee6911e312130624534315267ef99a'],148,1376,1524,14990371,32,0.462799496,0.815889029,0.967213115,10419
e6e330a8bd47f1d2dd5fd6f68b510c3cf0be0287,1,Li Yang,2016-12-14 15:29:56+08:00,['f05404d5576b52c70cf26eb1bccde1c27cd3852f'],319,348,667,14991038,31,0.696969697,1,1,10419
654144f47ff647bc4b7eac9793d2fa5f88dec372,1,Yang Li,2016-12-14 21:18:21+08:00,['e6e330a8bd47f1d2dd5fd6f68b510c3cf0be0287'],4,91,95,14991133,5,0.316666667,0.316666667,0.983333333,10419
8d0b504bfc69738b4b0ccc1611f6765b76c47884,0,Li Yang,2016-12-15 14:48:42+08:00,['654144f47ff647bc4b7eac9793d2fa5f88dec372'],0,5,5,14991138,1,1,1,1,10419
520b05f744b13ad4cbd37372ae70272099ea48a1,0,Li Yang,2016-12-15 18:57:36+08:00,['8d0b504bfc69738b4b0ccc1611f6765b76c47884'],8,3,11,14991149,1,,,,10419
91cf788cebd66ffa8b56e37586fa3207c09f2d2e,0,Li Yang,2016-12-15 18:57:36+08:00,['520b05f744b13ad4cbd37372ae70272099ea48a1'],1,1,2,14991151,1,,,,10419
d5b8c7f27820196400f43cdcd88b94206b581484,0,Li Yang,2016-12-15 18:57:36+08:00,['91cf788cebd66ffa8b56e37586fa3207c09f2d2e'],363,585,948,14992099,13,0.904761905,1,0.801587302,10421
36a42d86f84e0b0ba69b44e809e68fcee5437d65,0,Li Yang,2016-12-15 18:57:36+08:00,['d5b8c7f27820196400f43cdcd88b94206b581484'],71,26,97,14992196,5,0.090909091,0,0,10421
076fbcfb616cee4b4696cae20178ad6dc8365b3c,0,Li Yang,2016-12-15 18:57:36+08:00,['36a42d86f84e0b0ba69b44e809e68fcee5437d65'],3,9,12,14992208,1,0,0,1,10421
a9230473e3c3bad774f930ad90f4479dcbe34fa0,0,Li Yang,2016-12-15 18:57:36+08:00,['076fbcfb616cee4b4696cae20178ad6dc8365b3c'],124,104,228,14992436,8,0.805555556,0,1,10421
e7cc152e69ce98cba7fd3be5251d334314f25828,0,Li Yang,2016-12-15 18:57:36+08:00,['a9230473e3c3bad774f930ad90f4479dcbe34fa0'],1,1,2,14992438,1,,,,10421
f55cc5c446e8878d059019561894cc70bd0ab89b,0,Li Yang,2016-12-15 18:57:36+08:00,['e7cc152e69ce98cba7fd3be5251d334314f25828'],63,119,182,14992620,5,0.24,0.26,0.98,10421
1c2c43cb88d2abc5a1ea1cbf18cbede02fe8c4f5,0,Li Yang,2016-12-15 18:57:36+08:00,['f55cc5c446e8878d059019561894cc70bd0ab89b'],48,63,111,14992731,6,1,0.952380952,1,10421
3003d9fba7c0b20a74785cbc431f9e708e775418,1,Yang Li,2016-12-16 07:57:33+08:00,['1c2c43cb88d2abc5a1ea1cbf18cbede02fe8c4f5'],7,6,13,14992744,1,1,1,0,10421
911bdd00afb9176af594fe97cbc0a639f376da2d,0,Li Yang,2016-12-16 11:18:15+08:00,['3003d9fba7c0b20a74785cbc431f9e708e775418'],158,107,265,14993009,6,0.386363636,0,0.75,10421
f2377db9ff2687098c0bd8a805449547b7dcd436,0,Li Yang,2016-12-16 15:53:30+08:00,['911bdd00afb9176af594fe97cbc0a639f376da2d'],5,9,14,14993023,3,,,,10421
d79d9374cd8411518ee8eafc7640910826f6838c,0,Li Yang,2016-12-16 17:45:16+08:00,['f2377db9ff2687098c0bd8a805449547b7dcd436'],3,18,21,14993044,5,0.615384615,0.615384615,0.846153846,10421
e14f4e1e837ecb02c4f49788567c0ed16d6347da,0,Yang Li,2016-12-18 08:17:34+08:00,['d79d9374cd8411518ee8eafc7640910826f6838c'],1,1,2,14993046,1,,,,10421
d1175d2c414853f4d223601a2db096f7f963ce72,1,Yang Li,2016-12-18 17:23:18+08:00,['e14f4e1e837ecb02c4f49788567c0ed16d6347da'],1383,953,2336,14995382,19,1,1,1,10426
1d53ce9a0183ec369a681dec29b412f77f681f3e,0,Li Yang,2016-12-19 11:50:14+08:00,['d1175d2c414853f4d223601a2db096f7f963ce72'],3,3,6,14995388,3,,,,10426
7446c56b1aca87fce9868c9e1f0674299b05c405,0,lidongsjtu,2016-12-19 12:57:14+08:00,['1d53ce9a0183ec369a681dec29b412f77f681f3e'],0,26,26,14995414,1,1,0.315789474,1,10426
5fd3c56408050b1bb2a939bbb7b2105b4806aef8,1,zhongjian,2016-12-19 13:54:36+08:00,['7446c56b1aca87fce9868c9e1f0674299b05c405'],2,3,5,14995419,1,1,1,1,10426
699a88eba6833449defa166cc3397a96ff765961,1,zhongjian,2016-12-19 13:57:22+08:00,['5fd3c56408050b1bb2a939bbb7b2105b4806aef8'],1,1,2,14995421,1,,,,10426
6f9bd4a9998cff24c97bce0e6d86282f48fef388,1,Hongbin Ma,2016-12-19 14:16:00+08:00,['699a88eba6833449defa166cc3397a96ff765961'],77,60,137,14995558,16,1,0,0.058823529,10426
4ae4333c82243c21d253008c9f5146f1e18f6e84,1,Hongbin Ma,2016-12-19 14:16:08+08:00,['6f9bd4a9998cff24c97bce0e6d86282f48fef388'],0,1890,1890,14997448,5,0.148648649,0.321144674,0.584260731,10431
6f563df4afa46af61ffcbbc3ad599098b737d07a,0,Li Yang,2016-12-19 16:03:22+08:00,['4ae4333c82243c21d253008c9f5146f1e18f6e84'],2480,1498,3978,15001426,28,0,0,0,10432
878107e35bf4ac3a7963f22ac00a805eea9c323f,0,zhongjian,2016-12-19 16:29:42+08:00,['6f563df4afa46af61ffcbbc3ad599098b737d07a'],154,100,254,15001680,13,0.526315789,0.315789474,0.263157895,10432
f50c0c87373e4abacd7106d527df4b885f0a88ea,0,Hongbin Ma,2016-12-19 17:52:41+08:00,['878107e35bf4ac3a7963f22ac00a805eea9c323f'],12,60,72,15001752,6,1,1,1,10432
64a0a5943c034ea6f9cdc6d179d8be9da64fe5ac,1,zhongjian,2016-12-20 15:12:54+08:00,['f50c0c87373e4abacd7106d527df4b885f0a88ea'],263,215,478,15002230,7,0,0,0,10432
c72e2320238edeb2e7279dc4dc152493837e8843,0,zhongjian,2016-12-20 15:43:12+08:00,['64a0a5943c034ea6f9cdc6d179d8be9da64fe5ac'],0,8,8,15002238,1,,,,10432
83ea85174eb1bd379c2183fc2c9ff465a8c6267d,0,Billy Liu,2016-12-20 21:01:08+08:00,['c72e2320238edeb2e7279dc4dc152493837e8843'],1,3,4,15002242,1,,,,10432
8cb8f279bdaa13e5f75e7f675a5bd998ce5aac87,0,Billy Liu,2016-12-21 09:48:12+08:00,['83ea85174eb1bd379c2183fc2c9ff465a8c6267d'],1,55,56,15002298,2,0,0.404761905,0.595238095,10432
9dbc24bf320ff761ae83028f868feb4a4424f083,0,Billy Liu,2016-12-21 17:44:53+08:00,['8cb8f279bdaa13e5f75e7f675a5bd998ce5aac87'],98,344,442,15002740,16,0.545454545,0.97979798,1,10437
f0fbffd58a37aa9de22b887e385502b7baf670ea,1,Li Yang,2016-12-22 10:38:15+08:00,['9dbc24bf320ff761ae83028f868feb4a4424f083'],287,1124,1411,15004151,53,1,0,0.05,10444
c3bb878fa87f17d4002080e2f2cb5849677f9c8b,1,Li Yang,2016-12-22 11:14:03+08:00,['f0fbffd58a37aa9de22b887e385502b7baf670ea'],532,653,1185,15005336,4,1,1,0.876923077,10444
a39d0786008d2a65fdb19440949477673516b69c,0,Li Yang,2016-12-22 13:45:30+08:00,['c3bb878fa87f17d4002080e2f2cb5849677f9c8b'],54,301,355,15005691,8,0.145251397,0.558659218,0.955307263,10445
78a59179825012daa94a117babbf0c3aea15ec89,0,Li Yang,2016-12-22 14:31:07+08:00,['a39d0786008d2a65fdb19440949477673516b69c'],52,48,100,15005791,6,0.285714286,0.714285714,1,10445
642981746b0db15a66a854fdd45876bf685667b5,0,Billy Liu,2016-12-22 15:02:01+08:00,['78a59179825012daa94a117babbf0c3aea15ec89'],29,48,77,15005868,9,0.916666667,0.916666667,1,10445
d337ab1fd9aa6d2b063aa0c4a9bdc369ea0eef7b,0,Billy Liu,2016-12-22 15:07:52+08:00,['642981746b0db15a66a854fdd45876bf685667b5'],62,17,79,15005947,5,0,0,0,10445
440394de1ac0a8ebbc64f117f9442052508cce81,0,Li Yang,2016-12-22 15:24:40+08:00,['d337ab1fd9aa6d2b063aa0c4a9bdc369ea0eef7b'],2,3,5,15005952,1,0,0,1,10445
0d46e4a270749475a1154db94391970748fa3a8e,0,Li Yang,2016-12-22 16:07:58+08:00,['440394de1ac0a8ebbc64f117f9442052508cce81'],412,114,526,15006478,32,1,1,1,10447
4d1676a66889283647b7c63022505234fa9d328c,1,Billy Liu,2016-12-22 18:55:51+08:00,['0d46e4a270749475a1154db94391970748fa3a8e'],21,417,438,15006916,5,0.974358974,1,0.974358974,10448
120df2d55f2e5aec742be646046a6654bcf5492b,0,Li Yang,2016-12-23 08:17:49+08:00,['4d1676a66889283647b7c63022505234fa9d328c'],1,3,4,15006920,2,,,,10448
4496928e31abd002636d7695f0bf118210dae6eb,0,zhongjian,2016-12-23 20:48:27+08:00,['120df2d55f2e5aec742be646046a6654bcf5492b'],1,0,1,15006921,1,,,,10448
488283d3de1a385a4a6ed03ebd2e412cb9f2f7d7,0,zhongjian,2016-12-23 21:35:45+08:00,['4496928e31abd002636d7695f0bf118210dae6eb'],7,7,14,15006935,4,1,1,1,10448
73a40296e33921a000cb97faa3321dd53b8dbf41,0,Billy Liu,2016-12-23 23:49:20+08:00,['488283d3de1a385a4a6ed03ebd2e412cb9f2f7d7'],24,35,59,15006994,1,0,0,1,10448
30d3763f8256a9e88ae9620499021e99771b3351,0,Yang Li,2016-12-24 14:46:38+08:00,['73a40296e33921a000cb97faa3321dd53b8dbf41'],10,35,45,15007039,2,1,1,0.277777778,10448
c6c6719730e05c66c14407cfd7926a0a54a6009a,1,Yang Li,2016-12-24 14:46:39+08:00,['30d3763f8256a9e88ae9620499021e99771b3351'],1250,1035,2285,15009324,28,0,0.916666667,1,10449
73fbbb90e7cb0618bd27e146c89463cfcfb97e4b,0,Yang Li,2016-12-24 16:47:17+08:00,['c6c6719730e05c66c14407cfd7926a0a54a6009a'],2,123,125,15009449,8,0.428571429,1,1,10455
ed8b1683a35488ffb8dd222c7bbe0fa84600aa5d,0,Yang Li,2016-12-26 07:25:54+08:00,['73fbbb90e7cb0618bd27e146c89463cfcfb97e4b'],7,12,19,15009468,3,0.5,0,0,10455
0453d3daada2e32f79954dfd12ac9f19062e825c,1,Li Yang,2016-12-26 15:26:25+08:00,['ed8b1683a35488ffb8dd222c7bbe0fa84600aa5d'],23,32,55,15009523,7,1,1,0.9,10456
4f466a07bfb5438a1c573699f0b01cd206b0423a,0,Li Yang,2016-12-26 15:59:03+08:00,['0453d3daada2e32f79954dfd12ac9f19062e825c'],2,2,4,15009527,2,,,,10456
a78b6509f8727a53e26c57b2e5a14adc0ff88b73,1,Yang Li,2016-12-26 21:14:01+08:00,['4f466a07bfb5438a1c573699f0b01cd206b0423a'],5,63,68,15009595,2,0.451612903,0.451612903,1,10456
f9a8402d57755a9c3c3132ff676cf3c7492775c9,0,Billy Liu,2016-12-27 00:02:35+08:00,['a78b6509f8727a53e26c57b2e5a14adc0ff88b73'],4,32,36,15009631,1,1,1,1,10456
74c2d6bcf0ea96939c63c3432961d666c77e609c,0,Yang Li,2016-12-27 07:02:32+08:00,['f9a8402d57755a9c3c3132ff676cf3c7492775c9'],2,3,5,15009636,1,0,1,1,10456
00de44116126bd585f906c25606579a1ce2961f3,0,Li Yang,2016-12-27 18:38:16+08:00,['74c2d6bcf0ea96939c63c3432961d666c77e609c'],1,0,1,15009637,1,0,0,0,10456
fa4a5ee269eea66eee5b8ab8278305dfe0144c92,0,Hongbin Ma,2016-12-27 22:15:44+08:00,['00de44116126bd585f906c25606579a1ce2961f3'],10,87,97,15009734,7,0.866666667,0.866666667,0.933333333,10458
182c565df6b2134ef1302c88988ed27b60fefa42,1,Hongbin Ma,2016-12-27 22:15:44+08:00,['fa4a5ee269eea66eee5b8ab8278305dfe0144c92'],29,93,122,15009856,5,0.476190476,0.952380952,1,10459
2436140ef093c8d5b061124a5dbc2f5a1c3e9f3f,0,Hongbin Ma,2016-12-27 22:15:44+08:00,['182c565df6b2134ef1302c88988ed27b60fefa42'],6,44,50,15009906,2,0.888888889,0.888888889,0.111111111,10460
53b6c8c18033f92feadd2295456fa4f31011b5bb,0,Hongbin Ma,2016-12-27 22:15:44+08:00,['2436140ef093c8d5b061124a5dbc2f5a1c3e9f3f'],1,1,2,15009908,1,,,,10460
596ab51b4b98ae0923a134ede56c0ceb2f23bb66,0,Hongbin Ma,2016-12-27 22:17:30+08:00,['53b6c8c18033f92feadd2295456fa4f31011b5bb'],11,22,33,15009941,1,0,0,1,10460
bfe8b1a35c6b2c2f377eeb72295622ecb4d71284,0,Hongbin Ma,2016-12-27 22:17:33+08:00,['596ab51b4b98ae0923a134ede56c0ceb2f23bb66'],0,32,32,15009973,2,1,1,1,10460
1563eb945d0f3c68874934beca18579c96acc100,1,Hongbin Ma,2016-12-27 22:17:33+08:00,['bfe8b1a35c6b2c2f377eeb72295622ecb4d71284'],0,11,11,15009984,2,0.875,0.875,1,10460
3e0edc842ec4f6f7d9ef04dfa26afce101d2fd6e,1,Billy Liu,2016-12-28 01:16:58+08:00,['1563eb945d0f3c68874934beca18579c96acc100'],883,872,1755,15011739,45,1,1,1,10460
84ec908b57cff0d3167cc35a9e4ea6d4b7bf94ce,0,Billy Liu,2016-12-28 08:42:33+08:00,['3e0edc842ec4f6f7d9ef04dfa26afce101d2fd6e'],2,0,2,15011741,2,,,,10460
cccf3a9c1a8dd0c7ac326c958aafab050a3886cb,0,Li Yang,2016-12-28 09:45:18+08:00,['84ec908b57cff0d3167cc35a9e4ea6d4b7bf94ce'],2,5,7,15011748,1,1,1,1,10460
9898a07b1451c29b25fb295b22ed62015073df93,0,Hongbin Ma,2016-12-28 10:21:28+08:00,['cccf3a9c1a8dd0c7ac326c958aafab050a3886cb'],1,2,3,15011751,1,0,0,1,10460
7aabe4cb1d1480f99b4724b20598ba216f44586a,0,gaodayue,2016-12-28 12:20:51+08:00,['9898a07b1451c29b25fb295b22ed62015073df93'],2,2,4,15011755,1,,,,10460
8747e24da5053cc8bda8ec27b48c01bd97b7c63b,0,zhongjian,2016-12-28 14:55:50+08:00,['7aabe4cb1d1480f99b4724b20598ba216f44586a'],0,4,4,15011759,1,,,,10460
94acbc7130bb9084af9b5ac6def2527c5d238b15,0,zhongjian,2016-12-28 15:09:17+08:00,['8747e24da5053cc8bda8ec27b48c01bd97b7c63b'],1,1,2,15011761,1,,,,10460
bc1a49ec57987cf52d2596ac4d7a439b7596eb0d,0,zhongjian,2016-12-28 15:15:36+08:00,['94acbc7130bb9084af9b5ac6def2527c5d238b15'],68,20,88,15011849,6,0,0,0,10460
76e321b2d95955959fe3fac030195bbd321f9659,0,zhongjian,2016-12-28 15:22:02+08:00,['bc1a49ec57987cf52d2596ac4d7a439b7596eb0d'],4,4,8,15011857,2,,,,10460
73a7c25dfeb28764658af3e73065aa04cc1b92cd,0,zhongjian,2016-12-28 16:31:30+08:00,['76e321b2d95955959fe3fac030195bbd321f9659'],3,14,17,15011874,2,0,0,1,10460
fd745c8804848a60ac96eff1bd9b30bbe38bdafc,0,Billy Liu,2016-12-28 22:00:25+08:00,['73a7c25dfeb28764658af3e73065aa04cc1b92cd'],2,5,7,15011881,1,0,0,0,10460
08eda7b714a30c665bdd777c296d15c7650c9ea9,0,Billy Liu,2016-12-28 22:01:39+08:00,['fd745c8804848a60ac96eff1bd9b30bbe38bdafc'],4,7,11,15011892,1,0,0,1,10460
fdecf0937802a2d17418595e6c0543c9668ac8a4,1,lidongsjtu,2016-12-28 22:45:57+08:00,['08eda7b714a30c665bdd777c296d15c7650c9ea9'],4,102,106,15011998,3,0.5,1,1,10461
1a190ecfcaad88e2551c5aff3bd4938719ba46a6,0,Yang Li,2016-12-29 07:31:17+08:00,['fdecf0937802a2d17418595e6c0543c9668ac8a4'],14,91,105,15012103,4,0.240740741,0.592592593,0.592592593,10461
687d5fd150b6019e71db0f600307bbd4f7c749f9,1,shaofengshi,2016-12-29 13:23:14+08:00,['1a190ecfcaad88e2551c5aff3bd4938719ba46a6'],1,1,2,15012105,1,,,,10461
13c34079daa0e102b817d15ccfe2d70b8b364c34,1,Li Yang,2016-12-29 13:38:19+08:00,['687d5fd150b6019e71db0f600307bbd4f7c749f9'],69,108,177,15012282,9,0.75,1,1,10462
8cd416a3b18c43a63a8437a8a35728d2ba25076e,0,Li Yang,2016-12-29 17:03:23+08:00,['13c34079daa0e102b817d15ccfe2d70b8b364c34'],22,22,44,15012326,22,,,,10462
64c3c61898d10f05c4350609517b2096c4171167,0,Li Yang,2016-12-29 18:26:59+08:00,['8cd416a3b18c43a63a8437a8a35728d2ba25076e'],1,2,3,15012329,1,,,,10462
6ea03b8638d72853959aba0666aea18f1ba97391,1,gaodayue,2016-12-29 18:39:13+08:00,['64c3c61898d10f05c4350609517b2096c4171167'],33,48,81,15012410,8,1,1,0.818181818,10462
e2e2a81c1f1d7e3f9af5c81bb4f1ad14d2d1b859,1,Billy Liu,2016-12-29 18:48:38+08:00,['6ea03b8638d72853959aba0666aea18f1ba97391'],334,391,725,15013135,8,0,1,0.066666667,10463
020cf5f00ebeb3514493652629e408906ac1786e,0,Hongbin Ma,2016-12-29 18:51:50+08:00,['e2e2a81c1f1d7e3f9af5c81bb4f1ad14d2d1b859'],10,12,22,15013157,5,0,1,0,10463
75c8d13c708e66c995cdea494f8656b72636a4d6,0,lidongsjtu,2016-12-29 22:57:54+08:00,['020cf5f00ebeb3514493652629e408906ac1786e'],2,2,4,15013161,2,,,,10463
5cbef32fcd51bffe31f92a985bb5d02405fb7b7c,0,Yang Li,2016-12-30 06:57:42+08:00,['75c8d13c708e66c995cdea494f8656b72636a4d6'],5,5,10,15013171,1,,,,10463
a9ee6d33eca53f67d9d4dd1da52b6fbfe98cb510,0,Yang Li,2016-12-30 07:07:53+08:00,['5cbef32fcd51bffe31f92a985bb5d02405fb7b7c'],1,13,14,15013185,2,1,1,1,10463
32d724440657fd97462d4d10f9a5d91ba0d5a6da,1,Billy Liu,2016-12-30 11:06:30+08:00,['a9ee6d33eca53f67d9d4dd1da52b6fbfe98cb510'],10,11,21,15013206,1,,,,10463
6e4637c98814d8a3e8164dc366950bf8eb9ca716,1,Li Yang,2016-12-30 15:17:44+08:00,['32d724440657fd97462d4d10f9a5d91ba0d5a6da'],25,49,74,15013280,4,1,1,1,10464
9d3573a661d98c6a56716edc80e667b4050c54da,0,Billy Liu,2016-12-30 15:55:48+08:00,['6e4637c98814d8a3e8164dc366950bf8eb9ca716'],0,1,1,15013281,1,0,0,1,10464
fdcb9b81d49d81a66cd290837d0dd89f0a308018,0,lidongsjtu,2016-12-30 16:02:34+08:00,['9d3573a661d98c6a56716edc80e667b4050c54da'],4,2,6,15013287,1,,,,10464
e7e29f1fee854f64f18bb898033f09e32996f16a,1,Billy Liu,2016-12-30 19:00:11+08:00,['fdcb9b81d49d81a66cd290837d0dd89f0a308018'],6,6,12,15013299,2,,,,10464
b052d6f22930c45bd34f1d7a2fd493cbf4330791,0,Billy Liu,2017-01-03 11:15:06+08:00,['e7e29f1fee854f64f18bb898033f09e32996f16a'],84,28,112,15013411,7,0.128205128,0,0,10464
0b49eff2ceda02c0b2ba74245583b5184bb65955,1,Billy Liu,2017-01-03 12:42:22+08:00,['b052d6f22930c45bd34f1d7a2fd493cbf4330791'],1,5,6,15013417,1,1,1,1,10464
d7196d20ed7a70d11192d6f36eb802ee21f5539a,1,Billy Liu,2017-01-03 12:53:01+08:00,['e7e29f1fee854f64f18bb898033f09e32996f16a'],18,816,834,15014251,13,0.546052632,0.546052632,0.888157895,10472
53b0f57c3263379aebe7d907e3964a8f2ef5d2d2,0,Billy Liu,2017-01-03 13:37:03+08:00,"['d7196d20ed7a70d11192d6f36eb802ee21f5539a', '0b49eff2ceda02c0b2ba74245583b5184bb65955']",85,33,118,15014369,8,,,,10472
d7971d9bd7351a4a2c60f3852d85fb335b4adb17,0,Billy Liu,2017-01-03 13:43:02+08:00,['53b0f57c3263379aebe7d907e3964a8f2ef5d2d2'],1,0,1,15014370,1,,,,10472
1d6a36bf66085e0bed79876379b21677ec55788f,1,Li Yang,2017-01-03 15:43:24+08:00,['d7971d9bd7351a4a2c60f3852d85fb335b4adb17'],259,325,584,15014954,13,1,1,0,10474
e62d87826f0b4fc5ab3b4fdbed85d2c2ffe188be,1,Billy Liu,2017-01-03 18:28:55+08:00,['1d6a36bf66085e0bed79876379b21677ec55788f'],0,309,309,15015263,4,0.388535032,0.751592357,0.636942675,10477
487f2d99dfe76566c5ff366e316bc531a694050c,0,Li Yang,2017-01-04 13:43:48+08:00,['e62d87826f0b4fc5ab3b4fdbed85d2c2ffe188be'],13,20,33,15015296,2,1,1,0.666666667,10477
5be4bbab639049b596d77f1a16fc676fda484e03,0,lidongsjtu,2017-01-04 14:25:02+08:00,['487f2d99dfe76566c5ff366e316bc531a694050c'],98,2,100,15015396,1,,,,10477
89e4b53daaeadda3945bc796a09ee9e8dd90de9c,0,zhongjian,2017-01-05 11:26:30+08:00,['5be4bbab639049b596d77f1a16fc676fda484e03'],1,3,4,15015400,1,0,0,0,10477
7e71df9479ebc82b39211945a83f3147ddb70592,1,zhongjian,2017-01-05 11:27:13+08:00,['89e4b53daaeadda3945bc796a09ee9e8dd90de9c'],3,8,11,15015411,1,1,1,1,10477
e6a84c56961063f4ba83919ec1f689e9f37d1719,0,Hongbin Ma,2017-01-05 11:57:40+08:00,['7e71df9479ebc82b39211945a83f3147ddb70592'],2,2,4,15015415,1,,,,10477
e043d5fad8ccf420b1c0e744ee87a237cd7babd7,0,shaofengshi,2017-01-05 12:01:36+08:00,['e6a84c56961063f4ba83919ec1f689e9f37d1719'],7,9,16,15015431,3,1,1,1,10477
809b78309d0b85058aad43e6b863271dfebd1255,0,shaofengshi,2017-01-05 12:01:36+08:00,['e043d5fad8ccf420b1c0e744ee87a237cd7babd7'],36,30,66,15015497,3,0.2,0,1,10477
9c985742584a6bf15053d5482d13e1e01f76894d,0,shaofengshi,2017-01-05 12:19:42+08:00,['809b78309d0b85058aad43e6b863271dfebd1255'],7,8,15,15015512,3,,,,10477
4b5257a1dc4b1cf90804e5273f27944de30b8fbf,0,shaofengshi,2017-01-05 13:49:08+08:00,['9c985742584a6bf15053d5482d13e1e01f76894d'],16,19,35,15015547,2,1,1,1,10477
df5faf37cd3186376c28018a5a5a7e42bcea1db9,0,shaofengshi,2017-01-05 15:14:37+08:00,['4b5257a1dc4b1cf90804e5273f27944de30b8fbf'],4,3,7,15015554,3,1,0,0,10477
b736175f417f48fe07d01c0e2c99e040c3242d6f,0,Billy Liu,2017-01-05 15:51:01+08:00,['df5faf37cd3186376c28018a5a5a7e42bcea1db9'],8,4,12,15015566,3,1,0,1,10477
5683954bafec3fb02cc2ccda56387dacceb6b593,0,shaofengshi,2017-01-05 16:32:28+08:00,['b736175f417f48fe07d01c0e2c99e040c3242d6f'],1,1,2,15015568,1,,,,10477
c64f55b2e34089d10c8a55301b62f96aa597d8f1,1,Billy Liu,2017-01-05 17:41:06+08:00,['5683954bafec3fb02cc2ccda56387dacceb6b593'],169,137,306,15015874,59,1,0,0.75,10477
980b03b1abb8af82a9bceeb497847fe17c19c3e3,0,Billy Liu,2017-01-05 17:45:20+08:00,['c64f55b2e34089d10c8a55301b62f96aa597d8f1'],2,100,102,15015976,2,1,1,1,10478
503d232dc1875d504959a3e00da2eb62a7b7d599,1,shaofengshi,2017-01-05 18:09:45+08:00,['980b03b1abb8af82a9bceeb497847fe17c19c3e3'],18,71,89,15016065,4,0,0,1,10478
399f0c45108115c627cbf5f452ec33ff94167247,1,Yang Li,2017-01-06 06:45:37+08:00,['503d232dc1875d504959a3e00da2eb62a7b7d599'],44,87,131,15016196,24,1,1,1,10478
f5734861863c506510ed23bc1b3891d566b7219d,0,Billy Liu,2017-01-06 09:15:38+08:00,['399f0c45108115c627cbf5f452ec33ff94167247'],2,0,2,15016198,2,,,,10478
f267ba9dcb3db317d07eb367ddff668e03291519,0,Billy Liu,2017-01-06 10:42:48+08:00,['f5734861863c506510ed23bc1b3891d566b7219d'],68,82,150,15016348,6,,,,10478
49de556f00ff8fd854654daf1bc7e1d26c1fb879,0,zhongjian,2017-01-06 12:29:35+08:00,['f267ba9dcb3db317d07eb367ddff668e03291519'],3,39,42,15016390,2,0.045454545,1,0.954545455,10478
40ede31bf538efb60c879914a6387f1eb107c5f1,0,Billy Liu,2017-01-06 15:04:10+08:00,['49de556f00ff8fd854654daf1bc7e1d26c1fb879'],0,4,4,15016394,1,,,,10478
fbacb71ed7aa982b04dc4556c253a9bcfee576fa,0,lidongsjtu,2017-01-06 15:53:52+08:00,['40ede31bf538efb60c879914a6387f1eb107c5f1'],8,8,16,15016410,4,,,,10478
1b85f710d91c7f7f5a81790d665a1ac617c7a591,0,Li Yang,2017-01-06 16:28:20+08:00,['fbacb71ed7aa982b04dc4556c253a9bcfee576fa'],0,8,8,15016418,1,0,1,1,10478
1087f7ad49f324b6ee9c1d48b4b6b0489236fe9c,0,Billy Liu,2017-01-06 16:43:04+08:00,['1b85f710d91c7f7f5a81790d665a1ac617c7a591'],1,1,2,15016420,1,,,,10478
7509beeeaaf1d4a50bb82fd83dff5516276b9b9e,1,Yang Li,2017-01-07 09:35:00+08:00,['1087f7ad49f324b6ee9c1d48b4b6b0489236fe9c'],1,2,3,15016423,2,,,,10478
122b15a2a5fb7385e64839edfb9cbdaec5fde841,0,Yang Li,2017-01-07 09:38:06+08:00,['7509beeeaaf1d4a50bb82fd83dff5516276b9b9e'],1,2,3,15016426,1,1,1,1,10478
5a18af04ca40aaa6509cdf7c39b71b17dc5eb4a3,0,shaofengshi,2017-01-07 10:18:20+08:00,['122b15a2a5fb7385e64839edfb9cbdaec5fde841'],6,2,8,15016434,1,0,0,0,10478
746e3801faec58f0e10e619f0697ffbe37c08c63,0,Yang Li,2017-01-07 19:04:52+08:00,['5a18af04ca40aaa6509cdf7c39b71b17dc5eb4a3'],93,18,111,15016545,1,0.6,0,0.145454545,10478
aa574462aad0620fe10343613dc4c8d761c0d6a0,0,Yang Li,2017-01-07 19:08:15+08:00,['746e3801faec58f0e10e619f0697ffbe37c08c63'],16,37,53,15016598,1,0,1,1,10478
731a53a51a32fb1314b4e1282f158e3b7ed819a5,0,Yang Li,2017-01-07 19:08:37+08:00,['aa574462aad0620fe10343613dc4c8d761c0d6a0'],52,70,122,15016720,3,0,1,1,10478
56daf6d592ae454b3bca97c4a7a948781485befa,0,Yang Li,2017-01-07 19:30:27+08:00,['731a53a51a32fb1314b4e1282f158e3b7ed819a5'],4,6,10,15016730,1,1,1,1,10478
e46d699e05100db084db354d7efb3786575d5c54,0,Billy Liu,2017-01-08 12:14:05+08:00,['56daf6d592ae454b3bca97c4a7a948781485befa'],1,1,2,15016732,1,,,,10478
68ff75de260e6e93197103c0fd06009cf73c8e21,1,Billy Liu,2017-01-09 00:29:57+08:00,['e46d699e05100db084db354d7efb3786575d5c54'],16,31,47,15016779,1,,,,10478
6f8cdeb55cb4b41a63871aed2b3f61c7eddd107d,1,Li Yang,2017-01-09 14:41:05+08:00,['68ff75de260e6e93197103c0fd06009cf73c8e21'],5,9,14,15016793,1,0,0,1,10478
75625ae512b3d6cc080053e4e8871f3fff816ef0,1,Billy Liu,2017-01-09 15:02:13+08:00,['6f8cdeb55cb4b41a63871aed2b3f61c7eddd107d'],87,92,179,15016972,20,,,,10478
b7d87bb4e6c4de484d910e9af04965392da518e5,1,shaofengshi,2017-01-09 16:58:11+08:00,['75625ae512b3d6cc080053e4e8871f3fff816ef0'],721,1715,2436,15019408,129,0.458646617,0.635338346,0.830827068,10485
e864cd3b1c06700b1a1054d1f520eaabedc25d82,1,shaofengshi,2017-01-09 16:58:11+08:00,['b7d87bb4e6c4de484d910e9af04965392da518e5'],25,200,225,15019633,12,1,1,1,10488
b9a69efaea27d915ae44f75db436b6c9b6b7a4ec,0,shaofengshi,2017-01-09 16:58:11+08:00,['e864cd3b1c06700b1a1054d1f520eaabedc25d82'],1,3,4,15019637,1,0,1,1,10488
2cf52b49ed9a1158cb2ec0ded6d907f90ee024fe,0,shaofengshi,2017-01-09 16:58:11+08:00,['b9a69efaea27d915ae44f75db436b6c9b6b7a4ec'],3,3,6,15019643,1,,,,10488
66bca9a676fda02aa88cc25bad2e545f779f6dde,0,shaofengshi,2017-01-09 16:58:11+08:00,['2cf52b49ed9a1158cb2ec0ded6d907f90ee024fe'],23,9,32,15019675,7,0.142857143,0,0.071428571,10488
ee74a74e4d17a45b3832912381220af39e71f3d5,1,shaofengshi,2017-01-09 16:58:11+08:00,['66bca9a676fda02aa88cc25bad2e545f779f6dde'],19,55,74,15019749,8,0.133333333,0,0.966666667,10488
00c8f31e6d235d38bb7919fa4ee5b12e53d840f6,0,shaofengshi,2017-01-10 09:40:44+08:00,['ee74a74e4d17a45b3832912381220af39e71f3d5'],75,65,140,15019889,9,0,0,0.071428571,10489
3a36c66a1c2bbb372b0a3f3243f181332d7ed882,1,Li Yang,2017-01-10 11:44:17+08:00,['00c8f31e6d235d38bb7919fa4ee5b12e53d840f6'],30,161,191,15020080,10,0.3,1,1,10490
b0aadb12d1e25005445eda0d912c63a941ad929a,0,gaodayue,2017-01-10 11:52:04+08:00,['3a36c66a1c2bbb372b0a3f3243f181332d7ed882'],53,26,79,15020159,6,0,0,0.55,10490
07e5e5a75f4f692a53ac48c64c3cb44b84022c88,0,Li Yang,2017-01-10 15:45:05+08:00,['b0aadb12d1e25005445eda0d912c63a941ad929a'],1,1,2,15020161,1,,,,10490
c84b46bd5b72006f140f7aad147ba0185c7eecbb,0,Billy Liu,2017-01-10 20:48:43+08:00,['07e5e5a75f4f692a53ac48c64c3cb44b84022c88'],1,1,2,15020163,1,,,,10490
521dfffae15d0c85885ec816a4fc40907bfb7645,1,Billy Liu,2017-01-10 20:53:57+08:00,['c84b46bd5b72006f140f7aad147ba0185c7eecbb'],0,7,7,15020170,1,,,,10490
78d7086e51c9311ab25b17f05206766d8a279afa,0,Li Yang,2017-01-11 09:40:55+08:00,['521dfffae15d0c85885ec816a4fc40907bfb7645'],1,1,2,15020172,1,,,,10490
5f6450d6e77f9f62c3670c20ec4d8aef18bfd2fb,0,Li Yang,2017-01-11 12:39:24+08:00,['78d7086e51c9311ab25b17f05206766d8a279afa'],56,152,208,15020380,3,0.640625,0.46875,0.359375,10490
be11dc629460ef4620300e1508c548037540f961,1,Li Yang,2017-01-11 13:04:36+08:00,['5f6450d6e77f9f62c3670c20ec4d8aef18bfd2fb'],15,15,30,15020410,4,,,,10490
c9ab289c09bf95b97d67315f5d7e0b9d634aa48b,0,Yang Li,2017-01-11 21:11:47+08:00,['be11dc629460ef4620300e1508c548037540f961'],1,1,2,15020412,1,,,,10490
060309991f56988e097666346c5c13be7d3ba043,0,Yang Li,2017-01-11 21:35:50+08:00,['c9ab289c09bf95b97d67315f5d7e0b9d634aa48b'],1,0,1,15020413,1,0,0,1,10490
b0a406ff3c43d0cf6f8aa0b632e324d933440439,0,Yang Li,2017-01-12 08:08:29+08:00,['060309991f56988e097666346c5c13be7d3ba043'],0,8,8,15020421,1,0,0,1,10490
c6108a78eeca8e4b906aeba4f94e28addd974676,0,Li Yang,2017-01-12 16:01:17+08:00,['b0a406ff3c43d0cf6f8aa0b632e324d933440439'],4,86,90,15020511,5,0.617647059,0.058823529,1,10491
a11a31da0323c35686d982de6f02ea507573f753,0,Li Yang,2017-01-12 16:21:49+08:00,['c6108a78eeca8e4b906aeba4f94e28addd974676'],1,1,2,15020513,1,,,,10491
0f36b9b37097b95c16dd62cbe32781e5af8911dc,0,kangkaisen,2017-01-12 17:42:54+08:00,['a11a31da0323c35686d982de6f02ea507573f753'],2,4,6,15020519,2,,,,10491
362acd9ac215da2403af1d682d66a8dd097ffabe,0,lidongsjtu,2017-01-13 11:13:48+08:00,['0f36b9b37097b95c16dd62cbe32781e5af8911dc'],4,8,12,15020531,1,1,1,1,10491
4b977215186281908a8c29741128242146a2b934,0,gaodayue,2017-01-13 19:20:46+08:00,['362acd9ac215da2403af1d682d66a8dd097ffabe'],101,60,161,15020692,3,0.642857143,0,0,10491
d19533c45414315b3ec29428edfd7c1df6d33604,1,gaodayue,2017-01-13 22:32:05+08:00,['4b977215186281908a8c29741128242146a2b934'],350,457,807,15021499,15,0,0,0,10494
20c329423f75df63bcc3d6dac7883fe12288f668,0,lidongsjtu,2017-01-14 16:19:59+08:00,['d19533c45414315b3ec29428edfd7c1df6d33604'],68,15,83,15021582,3,,,,10494
4b00ec26de1e1cc9bf9b2e55a1b162d123114df8,0,kangkaisen,2017-01-14 19:00:09+08:00,['20c329423f75df63bcc3d6dac7883fe12288f668'],3,11,14,15021596,1,1,1,1,10494
eb18ac59fa74b3f2f1f0163f7728739a1027a233,1,kangkaisen,2017-01-14 19:07:59+08:00,['4b00ec26de1e1cc9bf9b2e55a1b162d123114df8'],7,14,21,15021617,2,0,1,1,10494
8d374f84368194d78208ea3b7683a697e8ec4314,0,kangkaisen,2017-01-14 19:14:42+08:00,['eb18ac59fa74b3f2f1f0163f7728739a1027a233'],3,6,9,15021626,4,1,1,1,10494
e79a55d94c6c45c315f991b8a8e6f606a6b2c25e,0,kangkaisen,2017-01-14 19:31:55+08:00,['8d374f84368194d78208ea3b7683a697e8ec4314'],1,1,2,15021628,1,,,,10494
61d43028241b8043609bf9e36bd7c35d558c4da2,0,shaofengshi,2017-01-15 22:14:16+08:00,['e79a55d94c6c45c315f991b8a8e6f606a6b2c25e'],1,14,15,15021643,1,,,,10494
4bc31de965ae67717bc4e05e0c7e91c957297999,0,Billy Liu,2017-01-16 13:49:39+08:00,['61d43028241b8043609bf9e36bd7c35d558c4da2'],0,1,1,15021644,1,,,,10494
4625b059ba5f55e1b938483297c18884aa17f6da,0,shaofengshi,2017-01-16 17:18:05+08:00,['4bc31de965ae67717bc4e05e0c7e91c957297999'],4,4,8,15021652,1,,,,10494
95d4412194fb6fc08c99600d162826d9350a7a80,1,lidongsjtu,2017-01-16 17:25:28+08:00,['4625b059ba5f55e1b938483297c18884aa17f6da'],10,755,765,15022417,19,0.672661871,0.996402878,0.956834532,10506
e20e2b2e82de5318edaf123b11d72267b7ef1ea1,0,lidongsjtu,2017-01-16 22:39:58+08:00,['95d4412194fb6fc08c99600d162826d9350a7a80'],1,1,2,15022419,1,,,,10506
e769bfa004e9d548c5a042f02765cc093ce70ec1,1,Li Yang,2017-01-17 10:54:22+08:00,['e20e2b2e82de5318edaf123b11d72267b7ef1ea1'],259,92,351,15022770,25,0.060150376,0.030075188,0.631578947,10506
576d2dd352b11f428db1d6308e35350a2fca122e,1,Li Yang,2017-01-17 11:06:26+08:00,['e769bfa004e9d548c5a042f02765cc093ce70ec1'],81,43,124,15022894,12,0.5,0.166666667,0.333333333,10506
f18267043df55c2e8a6a378e126a4fafa302f3c8,0,Billy Liu,2017-01-17 13:38:39+08:00,['576d2dd352b11f428db1d6308e35350a2fca122e'],1,6,7,15022901,1,1,0,1,10506
e894465007f422d619ddeab2acd87e38fa093fd9,0,gaodayue,2017-01-17 18:39:01+08:00,['f18267043df55c2e8a6a378e126a4fafa302f3c8'],16,15,31,15022932,5,0,,,10506
837bd8200b250f38fcfb2d221764d5aca0c66403,0,kangkaisen,2017-01-18 16:14:24+08:00,['e894465007f422d619ddeab2acd87e38fa093fd9'],60,58,118,15023050,4,0.19047619,0.80952381,0.142857143,10506
6e30376752d95bafa4a1773d39c2f798f75c35a7,1,shaofengshi,2017-01-18 16:28:05+08:00,['837bd8200b250f38fcfb2d221764d5aca0c66403'],20,57,77,15023127,1,1,1,1,10506
131a3f3f0ca3fbcc8000188b9973c27406bd9a90,0,shaofengshi,2017-01-18 16:28:05+08:00,['6e30376752d95bafa4a1773d39c2f798f75c35a7'],0,11,11,15023138,1,,,,10506
51c657108d4dae221a1d4d090ba68a1d0948e8f7,0,Billy Liu,2017-01-18 17:15:11+08:00,['131a3f3f0ca3fbcc8000188b9973c27406bd9a90'],19,17,36,15023174,4,1,0,0,10506
d52bb8bc05bd530362fe0970b8e8a85f8b2289bc,1,Li Yang,2017-01-18 22:46:24+08:00,['51c657108d4dae221a1d4d090ba68a1d0948e8f7'],8,10,18,15023192,2,1,0,0,10506
eddb695ba13de282ada123f358aff723cb414316,1,Yang Li,2017-01-19 08:56:22+08:00,['d52bb8bc05bd530362fe0970b8e8a85f8b2289bc'],70,71,141,15023333,51,0.5,0,0,10506
61833d952daa3ed7e3938f6e310caca5a52a4974,0,Yang Li,2017-01-19 12:42:44+08:00,['eddb695ba13de282ada123f358aff723cb414316'],3,0,3,15023336,1,0,0,0,10506
dfb5fac9f0d9c13f1128206b73e683b515fe3d72,1,Billy Liu,2017-01-19 14:54:20+08:00,['61833d952daa3ed7e3938f6e310caca5a52a4974'],1571,2430,4001,15027337,8,0,0.420803783,0.488179669,10506
38c3e7bf691ecdfd0f8d42fcc97065a0596be018,0,gaodayue,2017-01-19 15:43:14+08:00,['61833d952daa3ed7e3938f6e310caca5a52a4974'],136,225,361,15027698,14,1,1,1,10507
b49c9e3951c29a21e71f179ee77e2295fbc52ba9,0,shaofengshi,2017-01-19 17:37:42+08:00,['38c3e7bf691ecdfd0f8d42fcc97065a0596be018'],3,7,10,15027708,2,0,0,1,10507
21969753cc66efa22bc9fc933af46346e9846631,0,shaofengshi,2017-01-19 17:37:42+08:00,['b49c9e3951c29a21e71f179ee77e2295fbc52ba9'],2,17,19,15027727,4,0.545454545,1,1,10507
1e4ae540bf194c7e67bb622c2eb0cd0ff1a6657c,0,shaofengshi,2017-01-19 17:44:19+08:00,['21969753cc66efa22bc9fc933af46346e9846631'],1,1,2,15027729,1,,,,10507
85a1eb399d8dcd099d4607aa802faa5ccdf4d2bf,0,Billy Liu,2017-01-20 08:13:11+08:00,['1e4ae540bf194c7e67bb622c2eb0cd0ff1a6657c'],16,33,49,15027778,13,1,1,1,10507
d34f2d3e2bf691c55077a9a76a89217ae915bbdd,0,Billy Liu,2017-01-20 15:42:37+08:00,['dfb5fac9f0d9c13f1128206b73e683b515fe3d72'],28,23,51,15027829,1,1,1,0,10507
a853a7c4b6b7d42cc3ffd066b618f5ea72ca0d9f,0,zhongjian,2017-01-20 16:21:11+08:00,['85a1eb399d8dcd099d4607aa802faa5ccdf4d2bf'],137,111,248,15028077,5,0.64,0.04,0.04,10507
8331d8d0ad37d24bdbfa90d1032bcdd063aa0a59,0,zhongjian,2017-01-20 17:25:28+08:00,['a853a7c4b6b7d42cc3ffd066b618f5ea72ca0d9f'],59,194,253,15028330,5,1,0.843137255,0.921568627,10507
c2229c9c7f83fe5a28e564c37ada5794a67ee3d8,0,lidongsjtu,2017-01-21 19:52:42+08:00,['8331d8d0ad37d24bdbfa90d1032bcdd063aa0a59'],56,22,78,15028408,3,0,0,0.25,10507
7de8aa1203a72bad105ed692f7100535939b03af,0,kangkaisen,2017-01-21 23:19:50+08:00,['c2229c9c7f83fe5a28e564c37ada5794a67ee3d8'],187,175,362,15028770,8,0.813953488,0.790697674,0.674418605,10507
7576a09f29b75f2eb80a1b5ca9c65fe5c81b1144,1,shaofengshi,2017-01-22 11:38:17+08:00,['7de8aa1203a72bad105ed692f7100535939b03af'],175,187,362,15029132,8,0.186046512,0.209302326,0.325581395,10507
d264339b1c16c195ffafc2217b793d81bdbd6434,0,gaodayue,2017-01-22 14:02:09+08:00,['7576a09f29b75f2eb80a1b5ca9c65fe5c81b1144'],1,3,4,15029136,1,1,1,1,10507
2c4591a609c8d8141c880722a3b8b282b785133e,0,Billy Liu,2017-01-22 17:43:16+08:00,"['d264339b1c16c195ffafc2217b793d81bdbd6434', 'd34f2d3e2bf691c55077a9a76a89217ae915bbdd']",1494,2348,3842,15032978,8,,,,10507
6aaf6676b5e904260f16d1222bfe99013a095963,0,Hongbin Ma,2017-01-23 11:31:38+08:00,['2c4591a609c8d8141c880722a3b8b282b785133e'],4,12,16,15032994,2,0.375,1,0.375,10507
28673a8126ec2ecff8c125c0ecf887ce2565362c,0,lidongsjtu,2017-01-23 11:32:46+08:00,['6aaf6676b5e904260f16d1222bfe99013a095963'],34,40,74,15033068,3,0.647058824,0,1,10507
b56bc622086495f7d0047d01af57efc919b2ecce,0,lidongsjtu,2017-01-23 11:32:46+08:00,['28673a8126ec2ecff8c125c0ecf887ce2565362c'],3,5,8,15033076,2,0,0,1,10507
68e87f08255caf33dd7946f43b3393372a73c68b,1,Hongbin Ma,2017-01-23 11:54:54+08:00,['b56bc622086495f7d0047d01af57efc919b2ecce'],0,5,5,15033081,1,,,,10507
169c3de6456f394d049e9550d65a98f6aa0a316f,1,lidongsjtu,2017-01-23 13:01:20+08:00,['68e87f08255caf33dd7946f43b3393372a73c68b'],437,366,803,15033884,39,0.581395349,0,0.186046512,10507
eb73da7a0b27540af54fec23b561b390405620c5,1,lidongsjtu,2017-01-23 13:03:29+08:00,['169c3de6456f394d049e9550d65a98f6aa0a316f'],20,145,165,15034049,6,1,1,1,10507
87d103948fdf8951941c9a7fd11213dd569f8aa5,0,lidongsjtu,2017-01-23 13:18:24+08:00,['eb73da7a0b27540af54fec23b561b390405620c5'],150,380,530,15034579,11,,,,10507
db85d6679c5e1c067cfe2f1c58de0efb88044203,1,Hongbin Ma,2017-01-23 16:14:33+08:00,['87d103948fdf8951941c9a7fd11213dd569f8aa5'],1,1,2,15034581,1,,,,10507
d23bf930da0b542d0e6981917e6bde055839577a,1,shaofengshi,2017-01-23 16:23:56+08:00,['db85d6679c5e1c067cfe2f1c58de0efb88044203'],1,409,410,15034991,7,0.714953271,0.897196262,0.780373832,10511
d3276e2e909d3001724ee8fda1304ae8b7f08c63,0,shaofengshi,2017-01-23 16:23:56+08:00,['d23bf930da0b542d0e6981917e6bde055839577a'],175,471,646,15035637,10,0.450980392,0.758169935,0.901960784,10514
4c33e38f3e6c33438ef3bb830875b8ed74ffac5b,1,shaofengshi,2017-01-23 16:23:56+08:00,['d3276e2e909d3001724ee8fda1304ae8b7f08c63'],16,23,39,15035676,5,0,1,1,10514
f6dda4fecd5a882a17379987445a5aa0a347ff63,1,shaofengshi,2017-01-23 16:23:56+08:00,['4c33e38f3e6c33438ef3bb830875b8ed74ffac5b'],187,175,362,15036038,8,0.813953488,0.790697674,0.674418605,10514
e217ae84e1bd163658176093de208fcdf3bdf43c,1,shaofengshi,2017-01-23 16:23:56+08:00,['f6dda4fecd5a882a17379987445a5aa0a347ff63'],9,31,40,15036078,8,0,0.636363636,0.454545455,10514
971bf80009c446a873ddc0927151eb1e68d36e27,1,shaofengshi,2017-01-23 16:23:56+08:00,['e217ae84e1bd163658176093de208fcdf3bdf43c'],2,7,9,15036087,1,0,1,1,10514
b6d247c2c1412d7eb1024048ae7aad0ba5d1ea82,1,shaofengshi,2017-01-24 13:43:04+08:00,['971bf80009c446a873ddc0927151eb1e68d36e27'],9,9,18,15036105,9,,,,10514
571b7914f763e05160fb7598bbc2bfbe54d8c7cf,0,Hongbin Ma,2017-01-24 15:29:10+08:00,['b6d247c2c1412d7eb1024048ae7aad0ba5d1ea82'],7,7,14,15036119,5,,,,10514
a86569a5c0b49f5a607f642a70af7a826fda3edf,1,shaofengshi,2017-01-24 15:59:38+08:00,['571b7914f763e05160fb7598bbc2bfbe54d8c7cf'],5,15,20,15036139,1,0,1,1,10514
5629341122abe18d9576f71a0ea99ac83c327c21,0,Hongbin Ma,2017-01-25 11:19:13+08:00,['a86569a5c0b49f5a607f642a70af7a826fda3edf'],10,13,23,15036162,1,1,1,1,10514
a2a59c4303a29de308beb7b5c8300f78023313dd,0,Hongbin Ma,2017-01-25 14:21:37+08:00,['5629341122abe18d9576f71a0ea99ac83c327c21'],4,5,9,15036171,2,,,,10514
5eae37ef18ca51027c6bb2cfd3410fefc7982f2a,1,shaofengshi,2017-01-26 09:55:48+08:00,['a2a59c4303a29de308beb7b5c8300f78023313dd'],57,97,154,15036325,9,1,1,1,10514
e6a9382b8d357e5bb13be2f678ebabb8bad75dc7,0,shaofengshi,2017-01-26 09:56:54+08:00,['5eae37ef18ca51027c6bb2cfd3410fefc7982f2a'],3,6,9,15036334,2,0,0,1,10514
c3fff6d19d355e78461fa7f32d02feabc5bf63c8,0,shaofengshi,2017-01-26 10:53:19+08:00,['e6a9382b8d357e5bb13be2f678ebabb8bad75dc7'],13,18,31,15036365,3,,,,10514
0582512ea06bcd1c662903ff69012ba1cc7cc33c,0,Li Yang,2017-01-26 11:49:56+08:00,['c3fff6d19d355e78461fa7f32d02feabc5bf63c8'],9,27,36,15036401,2,1,1,1,10514
546f88f38ca017773c17ccaf2cf4812b0c7c4666,0,Yang Li,2017-01-31 08:11:41+08:00,['0582512ea06bcd1c662903ff69012ba1cc7cc33c'],18,15,33,15036434,5,1,1,0.666666667,10514
a058bfb8b0490fe36b7fe4da026028411ed208a5,1,Li Yang,2017-02-03 13:43:56+08:00,['546f88f38ca017773c17ccaf2cf4812b0c7c4666'],10,26,36,15036470,1,0,0,1,10514
7611338b5f022d216f5c9564a13c161374751adf,0,Li Yang,2017-02-04 11:03:25+08:00,['a058bfb8b0490fe36b7fe4da026028411ed208a5'],1844,0,1844,15038314,3,0.851351351,0.678855326,0.415739269,10514
2b60ac6a42741ca70d63e6680a0fbe9aeed7d46e,0,Billy Liu,2017-02-04 11:42:02+08:00,['a058bfb8b0490fe36b7fe4da026028411ed208a5'],15,16,31,15038345,4,0,1,1,10514
9a3bd71c8e5ce9dc13e38560efc556dc862819a1,0,Billy Liu,2017-02-04 11:42:02+08:00,['2b60ac6a42741ca70d63e6680a0fbe9aeed7d46e'],3,353,356,15038701,3,1,1,0.941176471,10516
56c7aa505706f9aa878b4d3804cdf3f357a7931f,0,Billy Liu,2017-02-04 13:46:59+08:00,['7611338b5f022d216f5c9564a13c161374751adf'],1,25,26,15038727,1,0.222222222,0,1,10516
855301dc7fc83ece4f03dd981f3184bb46a97105,0,Li Yang,2017-02-04 16:12:42+08:00,['56c7aa505706f9aa878b4d3804cdf3f357a7931f'],8,90,98,15038825,5,0.066666667,0.416666667,1,10516
5da53936502136c0d56236e148da2751aa1462c9,1,shaofengshi,2017-02-04 19:37:59+08:00,['855301dc7fc83ece4f03dd981f3184bb46a97105'],201,355,556,15039381,17,0.518518519,0.925925926,0.555555556,10517
24fa338e608030e3762ce5a17340fcf1d82029b1,0,shaofengshi,2017-02-04 19:37:59+08:00,['5da53936502136c0d56236e148da2751aa1462c9'],1,29,30,15039411,2,0.142857143,0.142857143,0.142857143,10517
56a3e6c8d0c39271ea95d83bbe0f3f8c7db8b41b,1,shaofengshi,2017-02-04 19:37:59+08:00,['24fa338e608030e3762ce5a17340fcf1d82029b1'],0,2,2,15039413,1,,,,10517
6f0bc1c3edd75f0b180afeeb68e09cf01298d4d8,0,shaofengshi,2017-02-04 19:37:59+08:00,['56a3e6c8d0c39271ea95d83bbe0f3f8c7db8b41b'],8,13,21,15039434,1,0,1,1,10517
5d83c80fbc0d6c3db434368cc8c29d786eebcd94,0,shaofengshi,2017-02-04 21:37:05+08:00,['6f0bc1c3edd75f0b180afeeb68e09cf01298d4d8'],33,97,130,15039564,14,0.739130435,1,0.913043478,10517
663a6f939f2fed83f096daf8a3a55ed3f785e5a0,0,shaofengshi,2017-02-05 09:57:34+08:00,['5d83c80fbc0d6c3db434368cc8c29d786eebcd94'],4,10,14,15039578,2,0,0,1,10517
9cd6c7075839e41a0f2ff71334343613ce503cd3,0,shaofengshi,2017-02-05 11:31:13+08:00,['663a6f939f2fed83f096daf8a3a55ed3f785e5a0'],3,1,4,15039582,1,,,,10517
19252848e27423edeb6f3ebed6dea453db1904e9,0,lidongsjtu,2017-02-06 13:48:38+08:00,['9cd6c7075839e41a0f2ff71334343613ce503cd3'],18,21,39,15039621,1,,,,10517
4047e8dc5bf8aad7c8db79abb5ef2c3be15cd622,0,Billy Liu,2017-02-06 14:37:46+08:00,"['19252848e27423edeb6f3ebed6dea453db1904e9', '9a3bd71c8e5ce9dc13e38560efc556dc862819a1']",18,369,387,15040008,6,,,,10517
ef0fc86876db488bf65353ec50e5f29411835b82,0,Hongbin Ma,2017-02-06 15:46:26+08:00,['4047e8dc5bf8aad7c8db79abb5ef2c3be15cd622'],0,4,4,15040012,1,1,1,1,10517
1f444681d30ed5f31997c2182cce0f388fef0347,1,lidongsjtu,2017-02-06 17:06:55+08:00,['ef0fc86876db488bf65353ec50e5f29411835b82'],0,3,3,15040015,1,0,0,1,10517
7a6dd1ca3a35bb2a0223b7df0762f922c341d0af,0,zhongjian,2017-02-06 18:54:47+08:00,['1f444681d30ed5f31997c2182cce0f388fef0347'],78,57,135,15040150,5,1,1,1,10517
8581f1d203cee9fe3d834d6beb9f6bf7717f921a,0,zhongjian,2017-02-07 17:08:24+08:00,['7a6dd1ca3a35bb2a0223b7df0762f922c341d0af'],2,2,4,15040154,1,,,,10517
6d11dd1d27a74fe50cd4fa58d2acf26f728f82e7,0,zhongjian,2017-02-07 17:08:45+08:00,['8581f1d203cee9fe3d834d6beb9f6bf7717f921a'],1,11,12,15040166,1,1,1,1,10517
b32cc9545a76657570c4a3353469ded43892c772,1,kangkaisen,2017-02-07 17:20:30+08:00,['6d11dd1d27a74fe50cd4fa58d2acf26f728f82e7'],0,10,10,15040176,1,0.5,0,1,10517
f62465cc5a5fe0f90142c0606c0c75e8c721bf0e,1,lidongsjtu,2017-02-07 17:31:14+08:00,['b32cc9545a76657570c4a3353469ded43892c772'],2,3,5,15040181,1,,,,10517
eee9ecbcb031862ed316f630933bb320cf93a9d1,0,lidongsjtu,2017-02-07 17:37:21+08:00,['f62465cc5a5fe0f90142c0606c0c75e8c721bf0e'],1,1,2,15040183,1,,,,10517
7b860adb0a23b53d6e2e40337f4317a3a2b067ba,0,kangkaisen,2017-02-07 17:40:39+08:00,['eee9ecbcb031862ed316f630933bb320cf93a9d1'],5,12,17,15040200,1,0,1,1,10517
39afa5197e197d5143843a3bb62c528749b03418,0,kangkaisen,2017-02-07 19:57:29+08:00,['7b860adb0a23b53d6e2e40337f4317a3a2b067ba'],32,191,223,15040423,9,0.98630137,1,0.98630137,10519
0dcce15f7fc01f6d8c388661025e5dab99ef05ad,0,Hongbin Ma,2017-02-08 15:18:10+08:00,['39afa5197e197d5143843a3bb62c528749b03418'],1,1,2,15040425,1,,,,10519
8263752a499158342e0588fda851a4006e8b1669,0,kangkaisen,2017-02-08 15:51:30+08:00,['0dcce15f7fc01f6d8c388661025e5dab99ef05ad'],2,32,34,15040459,7,0.944444444,1,0.944444444,10519
d135bdb0eed6118245a606fb0bca996420dee70f,0,lidongsjtu,2017-02-08 18:54:06+08:00,['8263752a499158342e0588fda851a4006e8b1669'],4,13,17,15040476,2,0,1,1,10519
df3ecd324a6442fee52f146d930cc5f84dafd945,0,Yang Li,2017-02-08 20:42:02+08:00,['d135bdb0eed6118245a606fb0bca996420dee70f'],8,4,12,15040488,1,,,,10519
570ab42a9b7597ce85b17202b67cd0ea5403cba4,0,kangkaisen,2017-02-08 21:38:00+08:00,['df3ecd324a6442fee52f146d930cc5f84dafd945'],1,2,3,15040491,1,,,,10519
722efb82357e0ebcf7853a813272bd960044dd52,0,Hongbin Ma,2017-02-08 21:41:57+08:00,['570ab42a9b7597ce85b17202b67cd0ea5403cba4'],0,127,127,15040618,2,1,1,1,10521
7742b31d85e4256556c52d3bf0b485ef20151508,1,Hongbin Ma,2017-02-09 10:47:21+08:00,['722efb82357e0ebcf7853a813272bd960044dd52'],7,62,69,15040687,2,1,1,0.75,10522
1e9f0908b9942113bbd251dc5eeba71973cc77e1,0,kangkaisen,2017-02-09 15:54:01+08:00,['7742b31d85e4256556c52d3bf0b485ef20151508'],3,43,46,15040733,3,0.736842105,0.842105263,1,10522
abf53322527148eaa49020bc2a327a210308e62d,0,lidongsjtu,2017-02-09 16:17:49+08:00,['1e9f0908b9942113bbd251dc5eeba71973cc77e1'],0,1,1,15040734,1,1,1,0,10522
f456961986e5c6ab94080a0fa74fa86c1a33c273,0,Hongbin Ma,2017-02-09 17:35:05+08:00,['abf53322527148eaa49020bc2a327a210308e62d'],1,8,9,15040743,1,1,1,0,10522
7fa25e0fafe25686450587407f2ed6f1e71cf4d3,0,Li Yang,2017-02-09 18:28:53+08:00,['f456961986e5c6ab94080a0fa74fa86c1a33c273'],4,31,35,15040778,1,1,1,1,10522
3ee49467ce686d11afcecbc636bb5213b0927427,0,kangkaisen,2017-02-09 20:28:17+08:00,['7fa25e0fafe25686450587407f2ed6f1e71cf4d3'],2,18,20,15040798,2,0.444444444,0.444444444,1,10522
f2e8b690f186abe5048dee8a6b0339c2a28c0594,0,lidongsjtu,2017-02-09 22:05:11+08:00,['3ee49467ce686d11afcecbc636bb5213b0927427'],71,124,195,15040993,9,1,1,1,10523
41332f3ed430b095efe5edefc831f0ec27f4b2ee,0,Hongbin Ma,2017-02-10 12:35:14+08:00,['f2e8b690f186abe5048dee8a6b0339c2a28c0594'],57,79,136,15041129,5,0,0,0,10524
ecf6a69fece7cbda3a9bd8d678c928224ce677aa,1,gaodayue,2017-02-10 12:43:34+08:00,['41332f3ed430b095efe5edefc831f0ec27f4b2ee'],49,162,211,15041340,10,0.46875,0.53125,1,10524
e09338b34c0b07a7167096e45bf9185aa0d0cbd5,0,gaodayue,2017-02-10 15:39:11+08:00,['ecf6a69fece7cbda3a9bd8d678c928224ce677aa'],103,254,357,15041697,13,0.858823529,1,1,10524
edf6cef15753eae8675e9f2f4cf4ba5c7fb4e513,0,kangkaisen,2017-02-10 17:36:51+08:00,['e09338b34c0b07a7167096e45bf9185aa0d0cbd5'],1,1,2,15041699,1,,,,10524
09a086688a664585c57b715046a9869b75351a52,0,gaodayue,2017-02-10 18:07:58+08:00,['edf6cef15753eae8675e9f2f4cf4ba5c7fb4e513'],191,186,377,15042076,19,0,0,1,10524
3c49c9e0c261ad0893c8911cc0f19804afea5516,1,lidongsjtu,2017-02-10 20:59:55+08:00,['09a086688a664585c57b715046a9869b75351a52'],64,96,160,15042236,10,1,1,1,10524
cd4e116ac3391d4da975a29c21a0c69f053463a6,0,Yang Li,2017-02-10 21:41:50+08:00,['3c49c9e0c261ad0893c8911cc0f19804afea5516'],9,9,18,15042254,1,,,,10524
707b05598a1b65e0c1b85c2dffd57f7cf2ac8dfb,0,lidongsjtu,2017-02-12 09:11:24+08:00,['cd4e116ac3391d4da975a29c21a0c69f053463a6'],0,1,1,15042255,1,0,1,1,10524
43c0566728092d537201d751d3e8f6e3c0d5f051,0,gaodayue,2017-02-12 09:34:49+08:00,['707b05598a1b65e0c1b85c2dffd57f7cf2ac8dfb'],266,1289,1555,15043810,19,0.608759124,0.776642336,0.983941606,10524
405dee26d7fe463d15bf5f1d7690359c9e83f678,0,Li Yang,2017-02-13 10:20:54+08:00,['43c0566728092d537201d751d3e8f6e3c0d5f051'],16,44,60,15043870,6,0.227272727,0.954545455,0.954545455,10524
c93ea9c9cb70c285e9b5ce69be3b7b435220ad91,0,shaofengshi,2017-02-13 18:54:10+08:00,['405dee26d7fe463d15bf5f1d7690359c9e83f678'],5,16,21,15043891,2,1,1,1,10524
ab657d1f77a0a5edd0e6b12f496b5c2d86c74849,1,shaofengshi,2017-02-14 16:45:16+08:00,['c93ea9c9cb70c285e9b5ce69be3b7b435220ad91'],5,70,75,15043966,7,0.166666667,0.166666667,1,10524
e2ff7842ef9e89f5c0e1ca955f0d0b20db7699f8,1,Hongbin Ma,2017-02-14 17:33:00+08:00,['ab657d1f77a0a5edd0e6b12f496b5c2d86c74849'],5,7,12,15043978,2,1,1,1,10524
69f898482499d530dddeb35b3327f65a50899dd5,1,kangkaisen,2017-02-14 17:43:14+08:00,['e2ff7842ef9e89f5c0e1ca955f0d0b20db7699f8'],1,39,40,15044018,1,0.129032258,0.129032258,1,10524
a5326fcb5a670970ee20b08486a77ec02dcf5c66,0,kangkaisen,2017-02-14 17:50:26+08:00,['69f898482499d530dddeb35b3327f65a50899dd5'],6,10,16,15044034,1,0,0,0,10524
c3021156dba2e7a6c685e3d8240b8dff3a3c4814,1,shaofengshi,2017-02-14 17:56:22+08:00,['a5326fcb5a670970ee20b08486a77ec02dcf5c66'],2,5,7,15044041,3,,,,10524
29bff866405f385f99f57013ad186818f32ae8d1,0,shaofengshi,2017-02-14 17:56:22+08:00,['c3021156dba2e7a6c685e3d8240b8dff3a3c4814'],26,30,56,15044097,3,,,,10524
11617a9ecd5161290612deda46eff6937f109ace,0,shaofengshi,2017-02-14 18:09:46+08:00,['29bff866405f385f99f57013ad186818f32ae8d1'],1,1,2,15044099,1,,,,10524
eb472a335856e4e7952edc7e34323f97c6453c5a,0,lidongsjtu,2017-02-14 19:50:32+08:00,['11617a9ecd5161290612deda46eff6937f109ace'],15,21,36,15044135,2,0.6,0.6,1,10524
f474ac5c1a34170922e485f53e91b3f224c16386,0,Hongbin Ma,2017-02-15 09:32:18+08:00,['eb472a335856e4e7952edc7e34323f97c6453c5a'],10,10,20,15044155,5,,,,10524
545d14552da0e069fcbffced6c51fa19db0cba3f,0,shaofengshi,2017-02-15 13:14:23+08:00,['f474ac5c1a34170922e485f53e91b3f224c16386'],14,24,38,15044193,5,1,1,1,10524
09377224ce2e26fdd1d00b952d8f5bca7654bd07,0,shaofengshi,2017-02-15 13:36:17+08:00,['545d14552da0e069fcbffced6c51fa19db0cba3f'],19,22,41,15044234,6,,,,10524
c880db0d7af2271c49f1465c1de229d7d52444ea,0,Hongbin Ma,2017-02-15 23:02:34+08:00,['09377224ce2e26fdd1d00b952d8f5bca7654bd07'],131,280,411,15044645,10,0.611940299,0.776119403,1,10525
a71193796f218ba1754240334d8cfce34ddde6ff,1,shaofengshi,2017-02-16 11:07:52+08:00,['c880db0d7af2271c49f1465c1de229d7d52444ea'],2,311,313,15044958,3,0.821052632,1,0.894736842,10526
61784b44b4ac4d3fa9ad6d3d7f9f84771cc0ab79,0,Hongbin Ma,2017-02-16 15:46:10+08:00,['a71193796f218ba1754240334d8cfce34ddde6ff'],5,5,10,15044968,1,1,1,0,10526
b8a96dbf4df3ffa267c6cbdcadce9a1ea62b18bf,0,Hongbin Ma,2017-02-16 16:27:10+08:00,['61784b44b4ac4d3fa9ad6d3d7f9f84771cc0ab79'],39,61,100,15045068,5,0.076923077,1,0.615384615,10526
8c0c44b887e2caa21b097c2334f8d21c42462e80,1,shaofengshi,2017-02-16 16:37:12+08:00,['b8a96dbf4df3ffa267c6cbdcadce9a1ea62b18bf'],0,1,1,15045069,1,0,0,1,10526
e95c07156b983052955b3bead8afa99eaa250408,0,Li Yang,2017-02-16 17:35:28+08:00,['8c0c44b887e2caa21b097c2334f8d21c42462e80'],7,6,13,15045082,2,0,0,1,10526
a60f893ff0c6d8f1e34ef9bbdd3cab7cc875aa99,1,Billy Liu,2017-02-16 17:36:49+08:00,['e95c07156b983052955b3bead8afa99eaa250408'],30,41,71,15045153,11,0,1,1,10526
4d08be56184eaebd2d8cff9597ce9a15f02fe9cc,0,lidongsjtu,2017-02-17 23:21:08+08:00,['a60f893ff0c6d8f1e34ef9bbdd3cab7cc875aa99'],5,9,14,15045167,1,1,1,1,10526
a7126f00cce821710384153df8cca2867d363f15,1,Billy Liu,2017-02-19 00:49:29+08:00,['4d08be56184eaebd2d8cff9597ce9a15f02fe9cc'],8,14,22,15045189,3,,,,10526
4f940010894a3ee7c284ded15e1d7ef6cc16e966,1,Billy Liu,2017-02-19 00:52:30+08:00,['a7126f00cce821710384153df8cca2867d363f15'],898,847,1745,15046934,52,0,0,0.268907563,10529
385d8011a97fdb66cf921933881d3f3e690d75f6,0,Billy Liu,2017-02-19 11:41:58+08:00,['4f940010894a3ee7c284ded15e1d7ef6cc16e966'],0,5,5,15046939,1,,,,10529
92533c7771f676634a37710a1a0fa4ce68ec162a,1,Li Yang,2017-02-20 14:03:59+08:00,['385d8011a97fdb66cf921933881d3f3e690d75f6'],3,3,6,15046945,3,,,,10529
bbcb0ed52c121bc68bea835e0fa0be7d9397b986,0,shaofengshi,2017-02-20 14:23:17+08:00,['92533c7771f676634a37710a1a0fa4ce68ec162a'],4,4,8,15046953,2,,,,10529
42d09a79848f2becf57deab8742b896d017791b3,1,shaofengshi,2017-02-20 15:20:31+08:00,['bbcb0ed52c121bc68bea835e0fa0be7d9397b986'],12,19,31,15046984,2,0.4,0.4,1,10529
bf8134010a927b35b942957080466bce7ccac6c9,0,shaofengshi,2017-02-20 15:30:59+08:00,['42d09a79848f2becf57deab8742b896d017791b3'],6,8,14,15046998,3,0,0,1,10529
c52b6981f9404a03dfa988eec67fa2dd23b99d94,1,Li Yang,2017-02-20 17:00:34+08:00,['bf8134010a927b35b942957080466bce7ccac6c9'],23,26,49,15047047,2,,,,10529
d7ecd6e2f1a87bf82d3cf6645eab013b873dde8d,1,Li Yang,2017-02-20 17:21:21+08:00,['c52b6981f9404a03dfa988eec67fa2dd23b99d94'],21,22,43,15047090,2,0,1,1,10529
ed413ee34a6f0301b57133ef7b4d45d58fc9f534,0,Hongbin Ma,2017-02-20 18:29:35+08:00,['d7ecd6e2f1a87bf82d3cf6645eab013b873dde8d'],80,112,192,15047282,5,0.175,1,0.75,10529
e05d8f3d87e2e7d0acf3bf47daa4e4bbd2d8d75f,0,Billy Liu,2017-02-20 22:26:35+08:00,['ed413ee34a6f0301b57133ef7b4d45d58fc9f534'],5,3,8,15047290,2,,,,10529
5d2e6c10c40c725c8e068242da5f719a71505099,0,shaofengshi,2017-02-20 23:12:01+08:00,['e05d8f3d87e2e7d0acf3bf47daa4e4bbd2d8d75f'],2,4,6,15047296,1,,,,10529
65acd70ed4ff1a6f16a1ede95c1c9b85dc2f5578,0,Li Yang,2017-02-21 10:04:02+08:00,['5d2e6c10c40c725c8e068242da5f719a71505099'],1,60,61,15047357,2,1,1,1,10529
4dce0cf0806c29522aa2380296fa38e373028008,0,Li Yang,2017-02-21 10:10:21+08:00,['65acd70ed4ff1a6f16a1ede95c1c9b85dc2f5578'],219,232,451,15047808,6,0,0,0,10530
e77a848e343f2e1f9a9382e336a48c85de25212a,0,Li Yang,2017-02-21 10:25:52+08:00,['4dce0cf0806c29522aa2380296fa38e373028008'],4,5,9,15047817,1,,,,10530
f2feae22a6cb5940213d040b96181b89bc51c46c,1,Li Yang,2017-02-21 15:10:58+08:00,['e77a848e343f2e1f9a9382e336a48c85de25212a'],24,33,57,15047874,2,1,1,1,10530
a0dba2962e70449fc8dad8cc770361581f00ad0d,0,Li Yang,2017-02-21 15:40:10+08:00,['f2feae22a6cb5940213d040b96181b89bc51c46c'],3,16,19,15047893,1,1,1,1,10530
36f716f3afd5ccca6639e58ec767b60773dd96a3,1,Li Yang,2017-02-21 16:01:56+08:00,['a0dba2962e70449fc8dad8cc770361581f00ad0d'],0,4,4,15047897,1,,,,10530
7ce3a153cdb63b874e68b29518cd6bb0836a9d57,0,Li Yang,2017-02-21 17:29:13+08:00,['36f716f3afd5ccca6639e58ec767b60773dd96a3'],19,79,98,15047995,7,0,1,1,10534
78a082f4ca9f587617152ef6b2935cb55c4618e0,0,Li Yang,2017-02-21 17:32:18+08:00,['7ce3a153cdb63b874e68b29518cd6bb0836a9d57'],11,19,30,15048025,4,1,1,0.615384615,10534
4c6fd2cc5911a5221ba03b230cff65a706f9f9aa,1,Li Yang,2017-02-21 18:18:00+08:00,['78a082f4ca9f587617152ef6b2935cb55c4618e0'],6,25,31,15048056,1,0.571428571,1,1,10534
661f016bbf8eae6d3ed8efb8ab1672ac212c62b4,1,Hongbin Ma,2017-02-21 18:44:29+08:00,['4c6fd2cc5911a5221ba03b230cff65a706f9f9aa'],30,46,76,15048132,2,1,1,1,10534
4bdb62cb3697e15d005a1a5383edf21f2a3ff567,0,Hongbin Ma,2017-02-21 20:58:31+08:00,['661f016bbf8eae6d3ed8efb8ab1672ac212c62b4'],183,210,393,15048525,29,0.625,1,1,10535
4c512f00fc38efa6a211327c3cb32dee4b788007,0,Hongbin Ma,2017-02-22 11:44:50+08:00,['4bdb62cb3697e15d005a1a5383edf21f2a3ff567'],4,4,8,15048533,1,,,,10535
859605fb35dcfb318a562691cb0ba7a0563db0f1,0,Billy Liu,2017-02-22 16:53:43+08:00,['4c512f00fc38efa6a211327c3cb32dee4b788007'],46,22,68,15048601,4,0.76,1,0,10535
6f35b62bd81d793340b944804a4f78e5d8ff7dbe,0,Billy Liu,2017-02-22 17:02:55+08:00,['859605fb35dcfb318a562691cb0ba7a0563db0f1'],1,0,1,15048602,1,1,0,0,10535
82f68035ceee222905e8daf443dd99585fbc4428,0,Hongbin Ma,2017-02-22 20:49:04+08:00,['6f35b62bd81d793340b944804a4f78e5d8ff7dbe'],8,9,17,15048619,2,1,0,0,10535
77df9dc190c16a3b00c325b245c346722e65eaeb,0,Li Yang,2017-02-23 11:32:13+08:00,['82f68035ceee222905e8daf443dd99585fbc4428'],3,5,8,15048627,1,0,0,0,10535
37aab3c69ef78633367718a5fd85caa398820f2f,0,Li Yang,2017-02-23 11:32:29+08:00,['77df9dc190c16a3b00c325b245c346722e65eaeb'],6,2,8,15048635,1,0,0,0,10535
4332b3d42b631747707231ca47079c230bc628dc,0,Hongbin Ma,2017-02-23 14:04:12+08:00,['37aab3c69ef78633367718a5fd85caa398820f2f'],28,0,28,15048663,1,,,,10535
730f5d7ca296ad82e8bb89568dff3d010c9ad9c8,0,Hongbin Ma,2017-02-23 14:04:12+08:00,['4332b3d42b631747707231ca47079c230bc628dc'],18,18,36,15048699,1,1,1,0,10535
6cf9749e23ef784eebc4a0604632eaf1c9efc301,1,Hongbin Ma,2017-02-23 14:04:12+08:00,['730f5d7ca296ad82e8bb89568dff3d010c9ad9c8'],66,110,176,15048875,7,0,0,0,10535
5ed2a07cb92003e4fc24cc1597abacb0050bbbab,0,root,2017-02-23 12:30:50+00:00,['6cf9749e23ef784eebc4a0604632eaf1c9efc301'],25,23,48,15048923,1,,,,10535
32cce58da28929a1ff9076a1afa35cce93460b87,0,root,2017-02-23 12:30:50+00:00,['5ed2a07cb92003e4fc24cc1597abacb0050bbbab'],19,8,27,15048950,2,0,0,0,10535
2c43860240b1c80cef1f14d0baaba989a49aa79d,1,Hongbin Ma,2017-02-24 15:07:08+08:00,['32cce58da28929a1ff9076a1afa35cce93460b87'],34,112,146,15049096,9,0.4,0.4,0,10536
20787d97d7ebb0fd66da7543bf154ccb940137bb,0,Hongbin Ma,2017-02-24 15:07:08+08:00,['2c43860240b1c80cef1f14d0baaba989a49aa79d'],1,1,2,15049098,1,,,,10536
cdfde7cb1ecb583af56dfb2f1255f819b1d93131,0,shaofengshi,2017-02-24 15:40:04+08:00,['20787d97d7ebb0fd66da7543bf154ccb940137bb'],26,0,26,15049124,2,,,,10536
d59b8ae7704ddb0cd40ef1458055e19d2eee3819,0,Li Yang,2017-02-24 16:16:01+08:00,['cdfde7cb1ecb583af56dfb2f1255f819b1d93131'],6,6,12,15049136,1,,,,10536
9ff78bce72a56b63dc9e1c8f0b4cd59d0c01b011,0,Li Yang,2017-02-24 16:20:33+08:00,['d59b8ae7704ddb0cd40ef1458055e19d2eee3819'],12,11,23,15049159,3,,,,10536
cc1bac9f452fddcfd316a23c4d21bfb7e4261ff0,1,Li Yang,2017-02-24 17:20:02+08:00,['9ff78bce72a56b63dc9e1c8f0b4cd59d0c01b011'],1,6,7,15049166,2,,,,10536
6adb73d3a286ca008e09cd1384cb4a183bc115ae,1,Hongbin Ma,2017-02-24 17:22:54+08:00,['cc1bac9f452fddcfd316a23c4d21bfb7e4261ff0'],33,49,82,15049248,2,0.666666667,0.666666667,0.916666667,10536
693c6faf2f38d19816c8e0c9e0a48c6caaaf18cd,0,Li Yang,2017-02-24 18:46:44+08:00,['6adb73d3a286ca008e09cd1384cb4a183bc115ae'],42,58,100,15049348,17,,,,10536
bb2789156668f699d0c5f85bb578d5d0997fbde1,1,Hongbin Ma,2017-02-24 19:49:02+08:00,['693c6faf2f38d19816c8e0c9e0a48c6caaaf18cd'],5,19,24,15049372,2,,,,10536
d6fc052e79bf669fd603ec3218b780c75208e292,0,Hongbin Ma,2017-02-25 16:36:43+08:00,['bb2789156668f699d0c5f85bb578d5d0997fbde1'],0,1,1,15049373,1,0,0,1,10536
29b3f6d422f0d4c86678b574864e8823892e3924,1,Hongbin Ma,2017-02-25 16:36:45+08:00,['d6fc052e79bf669fd603ec3218b780c75208e292'],0,200,200,15049573,4,0.622222222,1,1,10540
e875e87042c7b78dbf452c4ec158743c1be6769e,1,Hongbin Ma,2017-02-28 11:04:52+08:00,['29b3f6d422f0d4c86678b574864e8823892e3924'],0,41,41,15049614,1,0.344827586,0.896551724,1,10540
cda4df4106551f17311fde737d349af91790b3da,0,Hongbin Ma,2017-02-28 18:18:36+08:00,['e875e87042c7b78dbf452c4ec158743c1be6769e'],5,13,18,15049632,2,0.666666667,1,1,10540
a8001226b2a07cd553e680b7e14de9bf8c9981f3,1,gaodayue,2017-02-28 20:03:55+08:00,['cda4df4106551f17311fde737d349af91790b3da'],8,8,16,15049648,1,0,0,0,10540
aed28ec4b315f760ce902794b8041c1239c467a3,1,Yang Li,2017-02-28 21:30:48+08:00,['a8001226b2a07cd553e680b7e14de9bf8c9981f3'],1,11,12,15049660,1,0,0,0,10540
7d571635fdcd74b97e1345465cc0535283a21f95,0,Hongbin Ma,2017-03-01 10:21:54+08:00,['aed28ec4b315f760ce902794b8041c1239c467a3'],1,1,2,15049662,1,,,,10540
6c1f53ec9cdce3730b4c7262538dba698ddb5628,0,Hongbin Ma,2017-03-01 13:53:36+08:00,['7d571635fdcd74b97e1345465cc0535283a21f95'],13,25,38,15049700,1,0,0,1,10540
4d2fa3ce3eb65315cf9ec3769ddcb180004aa45f,0,Hongbin Ma,2017-03-01 14:07:18+08:00,['6c1f53ec9cdce3730b4c7262538dba698ddb5628'],1,1,2,15049702,1,,,,10540
29dc1dd095ed70044f8f6a00e1ecfe8e0d1b0757,0,Li Yang,2017-03-04 17:09:39+08:00,['4d2fa3ce3eb65315cf9ec3769ddcb180004aa45f'],1,6,7,15049709,1,0,0,1,10540
20ab0d65a2f7a47ff666baddbdf1d58b51356a63,1,shaofengshi,2017-03-05 20:51:44+08:00,['29dc1dd095ed70044f8f6a00e1ecfe8e0d1b0757'],0,26,26,15049735,2,,,,10541
dd7507a5923a07baff99f72f88a86f74839f56eb,0,shaofengshi,2017-03-05 20:53:26+08:00,['20ab0d65a2f7a47ff666baddbdf1d58b51356a63'],2,0,2,15049737,1,,,,10541
3fc6843736f877712cd24ed8cafba4554b5e4d31,0,Hongbin Ma,2017-03-05 22:44:20+08:00,['dd7507a5923a07baff99f72f88a86f74839f56eb'],30,50,80,15049817,5,1,1,1,10541
ac35cd39a59cca817d9890181d9a3fb8aca23124,0,Hongbin Ma,2017-03-06 09:35:11+08:00,['3fc6843736f877712cd24ed8cafba4554b5e4d31'],7,1,8,15049825,2,0,0,0,10541
4d1f169cd883319491c72a68b6ca8428fb217cfa,0,shaofengshi,2017-03-06 11:49:06+08:00,['ac35cd39a59cca817d9890181d9a3fb8aca23124'],0,6,6,15049831,1,0,0,1,10541
0e632fe75519966ef96313a51636736b1cc22bc5,0,shaofengshi,2017-03-06 18:14:45+08:00,['4d1f169cd883319491c72a68b6ca8428fb217cfa'],19,34,53,15049884,1,1,1,1,10541
cde40f3f220e2cdde618c2500c05bdce9daf586b,0,lidongsjtu,2017-03-06 21:55:27+08:00,['0e632fe75519966ef96313a51636736b1cc22bc5'],6,5,11,15049895,1,,,,10541
a21ffc839d46248f219cf81c0412b416059f6fa8,0,Hongbin Ma,2017-03-07 16:59:20+08:00,['cde40f3f220e2cdde618c2500c05bdce9daf586b'],11,18,29,15049924,2,1,1,1,10541
67d30a023e75a76dd5d5e146d42f50f6fa749a2f,0,lidongsjtu,2017-03-07 20:36:26+08:00,['a21ffc839d46248f219cf81c0412b416059f6fa8'],6,6,12,15049936,1,,,,10541
f1154c55ebcc87280dc8d126e36587bc913dacc4,1,shaofengshi,2017-03-08 11:23:29+08:00,['67d30a023e75a76dd5d5e146d42f50f6fa749a2f'],1,9,10,15049946,1,0,1,1,10541
4f7885c13727c9f6975c111a57138e75ca16de7a,0,Hongbin Ma,2017-03-08 15:01:37+08:00,['f1154c55ebcc87280dc8d126e36587bc913dacc4'],3,3,6,15049952,2,,,,10541
01abb00e45047c06d72d47d1eead136d2fa87d3d,0,Hongbin Ma,2017-03-08 16:53:09+08:00,['4f7885c13727c9f6975c111a57138e75ca16de7a'],69,87,156,15050108,10,1,1,0,10541
2dfffde267c91312fa9ff7644ecba46e3570e005,0,Hongbin Ma,2017-03-08 17:56:54+08:00,['01abb00e45047c06d72d47d1eead136d2fa87d3d'],11,10,21,15050129,5,0,0,1,10541
182ed009400629dee1bd7ad0121224cacfd07668,0,Li Yang,2017-03-09 18:03:26+08:00,['2dfffde267c91312fa9ff7644ecba46e3570e005'],16,22,38,15050167,4,1,1,1,10541
7eb9969e1ce54cc919ad47f2589d85da44090d18,0,Hongbin Ma,2017-03-09 21:19:30+08:00,['182ed009400629dee1bd7ad0121224cacfd07668'],3,21,24,15050191,1,0.411764706,0.411764706,0.411764706,10541
181890e542783e66078ad707f37dcb273abae596,0,Hongbin Ma,2017-03-09 21:19:30+08:00,['7eb9969e1ce54cc919ad47f2589d85da44090d18'],8,7,15,15050206,2,1,1,0,10541
70dda40448bbd5622788dbfea591bf54aa4cdc8a,1,lidongsjtu,2017-03-10 14:16:48+08:00,['181890e542783e66078ad707f37dcb273abae596'],1,2,3,15050209,2,,,,10541
c5f3b2286987d12c31310e9c9670d469606e9d4c,0,Hongbin Ma,2017-03-10 17:17:02+08:00,['70dda40448bbd5622788dbfea591bf54aa4cdc8a'],51,88,139,15050348,7,1,1,0.333333333,10541
8edf234ce571593145970e4d6cc18934cf761348,0,Hongbin Ma,2017-03-10 17:17:11+08:00,['c5f3b2286987d12c31310e9c9670d469606e9d4c'],3,2,5,15050353,1,,,,10541
0301da01b3669d92ad4bd07facfc8f79b7b0e0eb,0,Hongbin Ma,2017-03-11 17:06:22+08:00,['8edf234ce571593145970e4d6cc18934cf761348'],3,51,54,15050407,3,0.324324324,0.324324324,1,10541
82b223641047a215a0b212f4c3d77e21d1a5203c,0,Hongbin Ma,2017-03-11 17:49:23+08:00,['0301da01b3669d92ad4bd07facfc8f79b7b0e0eb'],35,17,52,15050459,2,0.466666667,1,0,10541
791a010061ad216fd8bb4b5f31f1a1be5a43a141,0,Hongbin Ma,2017-03-11 17:55:16+08:00,['82b223641047a215a0b212f4c3d77e21d1a5203c'],2,2,4,15050463,2,,,,10541
5d012b9fa0ca6b3f98aa80f1ae9418be90d32bca,0,shaofengshi,2017-03-11 20:42:15+08:00,['791a010061ad216fd8bb4b5f31f1a1be5a43a141'],19,26,45,15050508,1,0,0.2,0,10541
f38d871a72e1e24331e092fd51664fcb8fd47e22,0,shaofengshi,2017-03-11 22:08:28+08:00,['5d012b9fa0ca6b3f98aa80f1ae9418be90d32bca'],0,17,17,15050525,1,0,0,1,10541
0cb5032ee8da30a91f5ef8914138852daead558d,0,Hongbin Ma,2017-03-11 22:09:55+08:00,['f38d871a72e1e24331e092fd51664fcb8fd47e22'],27,44,71,15050596,4,1,1,1,10541
181b6c5c16fc0506a475993f3735a4b7e73a07c1,0,shaofengshi,2017-03-11 22:12:55+08:00,['0cb5032ee8da30a91f5ef8914138852daead558d'],2,3,5,15050601,1,,,,10541
77fe58136e0a00a64f9149e3d79532d92eeb77aa,1,Hongbin Ma,2017-03-12 10:50:24+08:00,['181b6c5c16fc0506a475993f3735a4b7e73a07c1'],90,139,229,15050830,6,0.821428571,1,1,10541
530549cf92c0f20d3247da563ca40ad4962c8ba4,0,shaofengshi,2017-03-12 11:13:23+08:00,['77fe58136e0a00a64f9149e3d79532d92eeb77aa'],3,12,15,15050845,1,0,0,1,10541
f0eca24140b2a48e43b287bafe08f37e138e2df0,0,shaofengshi,2017-03-12 12:54:18+08:00,['530549cf92c0f20d3247da563ca40ad4962c8ba4'],8,9,17,15050862,1,,,,10541
47b7c800ecdfe14d10426d64eae6b47e11f2a328,1,shaofengshi,2017-03-12 14:13:04+08:00,['f0eca24140b2a48e43b287bafe08f37e138e2df0'],121,153,274,15051136,7,1,1,1,10542
f36b1341b7905e68b99afc77c8009ba156c0bca4,0,shaofengshi,2017-03-12 15:15:13+08:00,['47b7c800ecdfe14d10426d64eae6b47e11f2a328'],3,5,8,15051144,1,0,0,1,10542
7976b5fc714f5e73734b3037c05fc2601ea17662,0,Hongbin Ma,2017-03-12 17:18:37+08:00,['f36b1341b7905e68b99afc77c8009ba156c0bca4'],436,53,489,15051633,8,0.034090909,0,0.056818182,10542
3a3e96786b5bbea046d0a6fe9eef1c3f8cb13521,0,Hongbin Ma,2017-03-13 09:13:16+08:00,['7976b5fc714f5e73734b3037c05fc2601ea17662'],72,5,77,15051710,5,0,0,0,10542
9d8bf2b340738289d0a3d23664868ae3f5b40cd1,0,Hongbin Ma,2017-03-13 18:57:01+08:00,['3a3e96786b5bbea046d0a6fe9eef1c3f8cb13521'],10,10,20,15051730,7,,,,10542
08bc3386ef904f2fc2bb9482ac9ac514dfcf17f0,1,lidongsjtu,2017-03-13 18:58:02+08:00,['9d8bf2b340738289d0a3d23664868ae3f5b40cd1'],2,2,4,15051734,1,0,0,1,10542
06e4027b305c2b848c9977d25912f8482a15d75d,0,Hongbin Ma,2017-03-13 21:35:18+08:00,['08bc3386ef904f2fc2bb9482ac9ac514dfcf17f0'],5,10,15,15051749,3,,,,10542
b53f2b6d0bed3e426fbb3ba184cb8fe44018c286,0,Li Yang,2017-03-14 13:40:53+08:00,['06e4027b305c2b848c9977d25912f8482a15d75d'],1,11,12,15051761,1,1,1,1,10542
3ce48199164424734696497ddd3eef90efff9563,1,Hongbin Ma,2017-03-14 14:21:27+08:00,['b53f2b6d0bed3e426fbb3ba184cb8fe44018c286'],2,3,5,15051766,1,,,,10542
872036241c6f8255a07e0f160ba54c9473bf0501,0,Hongbin Ma,2017-03-14 16:43:35+08:00,['3ce48199164424734696497ddd3eef90efff9563'],11,18,29,15051795,2,0.5,0.5,0,10542
e7510c270642178ca208389dbfaf856c20f9a17d,1,Hongbin Ma,2017-03-14 19:30:33+08:00,['872036241c6f8255a07e0f160ba54c9473bf0501'],16,29,45,15051840,1,1,1,1,10542
d4768c12e423e96679e4d7db73c697f0378c0a94,1,lidongsjtu,2017-03-14 23:05:24+08:00,['e7510c270642178ca208389dbfaf856c20f9a17d'],30,86,116,15051956,4,0.372093023,0.372093023,1,10542
7bc8aafd124309d3ebfa4aca89701bd20cd0d589,0,lidongsjtu,2017-03-15 00:24:21+08:00,['d4768c12e423e96679e4d7db73c697f0378c0a94'],2,11,13,15051969,1,1,1,1,10542
242b331746f6e9b56da5d5b1ed13b15cbbeff342,0,Hongbin Ma,2017-03-15 13:53:35+08:00,['7bc8aafd124309d3ebfa4aca89701bd20cd0d589'],2,3,5,15051974,3,,,,10542
f8528637c17d0aa5260df13c0340c314a60c89c1,1,Hongbin Ma,2017-03-15 14:39:58+08:00,['242b331746f6e9b56da5d5b1ed13b15cbbeff342'],83,46,129,15052103,4,0,0,1,10542
e4ed2322b7ff37a14a0d741766304f46ea58ba69,1,Hongbin Ma,2017-03-15 14:40:18+08:00,['f8528637c17d0aa5260df13c0340c314a60c89c1'],1,100,101,15052204,2,,,,10543
5155994e1a84e47d9ce8d90d3787a28910673b66,0,lidongsjtu,2017-03-15 14:51:55+08:00,['e4ed2322b7ff37a14a0d741766304f46ea58ba69'],65,149,214,15052418,3,0,0.041666667,0,10543
3e6992da3b844d4642985f732c3269e354fed88c,0,Hongbin Ma,2017-03-15 18:35:50+08:00,['5155994e1a84e47d9ce8d90d3787a28910673b66'],38,39,77,15052495,1,0,0,1,10543
32034fc1d0cb96156da8c4b49c35f2631a59079b,0,shaofengshi,2017-03-15 20:17:19+08:00,['3e6992da3b844d4642985f732c3269e354fed88c'],7,0,7,15052502,2,,,,10543
dde297e48a6886f662cd153c6f834f7e26560522,0,shaofengshi,2017-03-15 22:25:51+08:00,['32034fc1d0cb96156da8c4b49c35f2631a59079b'],4,0,4,15052506,1,1,0,0,10543
8be842e9b845477541c2569ae1c2484e9d627214,0,lidongsjtu,2017-03-16 09:44:54+08:00,['dde297e48a6886f662cd153c6f834f7e26560522'],3,2,5,15052511,1,0,0,0,10543
2ab9bf2d88aae2e8fa6189e8e375e140e9dbb4b5,0,Billy Liu,2017-03-15 21:03:47-07:00,['8be842e9b845477541c2569ae1c2484e9d627214'],2,2,4,15052515,1,,,,10543
6c800d6e825c36ebe677b19efd7f02a7e3b9509b,0,lidongsjtu,2017-03-16 17:22:31+08:00,['2ab9bf2d88aae2e8fa6189e8e375e140e9dbb4b5'],16,35,51,15052566,1,0,0.777777778,0.888888889,10543
40249fee78a8a078d461ea66009111082732d27b,0,Hongbin Ma,2017-03-17 12:53:11+08:00,['6c800d6e825c36ebe677b19efd7f02a7e3b9509b'],5,11,16,15052582,2,,,,10543
14b96a86dc4cf6da78f2137838ca9827848f52be,1,Hongbin Ma,2017-03-17 19:55:27+08:00,['40249fee78a8a078d461ea66009111082732d27b'],19,52,71,15052653,2,0,0,1,10543
8b70fa5210c7c2f95086dd2311d373277161d4ed,1,Hongbin Ma,2017-03-17 23:28:15+08:00,['14b96a86dc4cf6da78f2137838ca9827848f52be'],15,16,31,15052684,2,,,,10543
19c87e7a80b95a16a930feb6d0281555cd1232b5,0,Hongbin Ma,2017-03-17 23:39:22+08:00,['8b70fa5210c7c2f95086dd2311d373277161d4ed'],7,6,13,15052697,1,,,,10543
0860048484639aa07f745726a58c8544a911e5f6,0,Hongbin Ma,2017-03-18 17:29:20+08:00,['19c87e7a80b95a16a930feb6d0281555cd1232b5'],40,45,85,15052782,2,1,1,1,10543
98664f0decb0591ccc44692193145a1187201dfd,0,Li Yang,2017-03-19 06:52:39+08:00,['0860048484639aa07f745726a58c8544a911e5f6'],1,1,2,15052784,1,,,,10543
3ae6f9c9120360cdc9fc238a2a9208fa9813aea6,0,shaofengshi,2017-03-19 09:47:47+08:00,['98664f0decb0591ccc44692193145a1187201dfd'],5,6,11,15052795,2,,,,10543
c82603a7f4a0f8b1128cfe057a12b922cd1282f8,1,Hongbin Ma,2017-03-20 19:54:38+08:00,['3ae6f9c9120360cdc9fc238a2a9208fa9813aea6'],3,2,5,15052800,1,,,,10543
f72a3f6d35c028ebb5c68ee6bd11b97750fbf194,1,Hongbin Ma,2017-03-20 20:08:43+08:00,['c82603a7f4a0f8b1128cfe057a12b922cd1282f8'],2,1,3,15052803,1,,,,10543
88a1c71dde855c693b230f67b92c4cd067d43b2b,0,Hongbin Ma,2017-03-27 15:20:40+08:00,['f72a3f6d35c028ebb5c68ee6bd11b97750fbf194'],51,304,355,15053158,7,0.657142857,0.535714286,1,10545
636282db889973fe29269b43e417414effb68b76,1,Hongbin Ma,2017-03-27 15:36:07+08:00,['f72a3f6d35c028ebb5c68ee6bd11b97750fbf194'],51,250,301,15053459,5,0.657142857,0.535714286,1,10545
b1cc0dd643ebd55776a3f22b61ce33e2abf29d48,0,Hongbin Ma,2017-03-27 15:39:03+08:00,"['636282db889973fe29269b43e417414effb68b76', '88a1c71dde855c693b230f67b92c4cd067d43b2b']",0,54,54,15053513,2,,,,10545
9e03c718f86725e7b5d0b96950d8372b7bb77428,1,Dong Li,2017-03-27 15:50:53+08:00,['b1cc0dd643ebd55776a3f22b61ce33e2abf29d48'],101,136,237,15053750,3,,,,10546
997d4298e506b75b93e75d8410f8ab2471975a03,0,Roger Shi,2017-03-28 16:02:45+08:00,['9e03c718f86725e7b5d0b96950d8372b7bb77428'],0,0,0,15053750,1,,,,10546
598b32efa21ebd87e76ac5798b30f472c6e29de2,0,Dong Li,2017-03-29 10:47:10+08:00,['997d4298e506b75b93e75d8410f8ab2471975a03'],4,2,6,15053756,2,,,,10546
4c21821471cb261cfecdf8289c5f8284af817b3e,0,Hongbin Ma,2017-03-29 11:01:24+08:00,['b1cc0dd643ebd55776a3f22b61ce33e2abf29d48'],43,341,384,15054140,3,0.673469388,0.918367347,0.852040816,10547
a776ef6747638ab757c9a5298b500dd18756f5b5,0,Li Yang,2017-03-29 11:57:24+08:00,['4c21821471cb261cfecdf8289c5f8284af817b3e'],1,1,2,15054142,1,,,,10547
9147d3edef5f650a3fce479da7968f39f9c63e84,0,lidongsjtu,2017-03-29 19:40:10+08:00,['598b32efa21ebd87e76ac5798b30f472c6e29de2'],1,1,2,15054144,1,,,,10547
c6b4592fca047d1fc4094a0812774ddd2d8917f9,0,Yang Li,2017-03-29 21:02:16+08:00,['a776ef6747638ab757c9a5298b500dd18756f5b5'],6,13,19,15054163,2,0,0,1,10547
fa3ee3ffbbb11ac3d4dc79dbb719f56a7e913857,0,Yang Li,2017-03-29 21:02:23+08:00,['c6b4592fca047d1fc4094a0812774ddd2d8917f9'],4,9,13,15054176,1,0,0,1,10547
0fa572482f209d25cca6968812d293c08d077210,0,Hongbin Ma,2017-03-31 16:39:35+08:00,['fa3ee3ffbbb11ac3d4dc79dbb719f56a7e913857'],210,704,914,15055090,26,0.615720524,0.92139738,0.633187773,10551
782a97482ca1e92cf24e04badd8ee48c9b829f46,0,Hongbin Ma,2017-03-31 16:39:35+08:00,['0fa572482f209d25cca6968812d293c08d077210'],136,108,244,15055334,7,0,0.214285714,0,10552
85a341b9513f36857e1ba06ab0000cc2d4dfe400,0,Hongbin Ma,2017-03-31 16:45:02+08:00,['9147d3edef5f650a3fce479da7968f39f9c63e84'],51,89,140,15055474,1,0.28,1,0.88,10552
19d5b3dee38a40c0a344b5f340c4806514290cc3,0,Hongbin Ma,2017-03-31 16:51:03+08:00,['85a341b9513f36857e1ba06ab0000cc2d4dfe400'],1020,1133,2153,15057627,5,0,0.642105263,0.663157895,10552
f6ee76c85a86971e71f998b2dd096b035bc7613c,1,Hongbin Ma,2017-03-31 18:12:22+08:00,['19d5b3dee38a40c0a344b5f340c4806514290cc3'],14,44,58,15057685,5,0.571428571,0.571428571,0.428571429,10552
d4cce762addda1c819939e767220864dad551503,0,hongbin ma,2017-03-31 18:34:37+08:00,['f6ee76c85a86971e71f998b2dd096b035bc7613c'],32,130,162,15057847,2,0.872340426,1,0.765957447,10553
1e8b6a5e7b1350930c68e750fb1ce75c27428082,0,lidongsjtu,2017-03-31 19:03:54+08:00,['782a97482ca1e92cf24e04badd8ee48c9b829f46'],12,56,68,15057915,2,0,1,1,10553
ee5397bc6207c9cdf57cdce93bcda6bcac58a5a9,0,Hongbin Ma,2017-03-31 20:00:59+08:00,"['d4cce762addda1c819939e767220864dad551503', '782a97482ca1e92cf24e04badd8ee48c9b829f46']",254,1047,1301,15059216,33,,,,10553
9250d9baa6940bf7aa0a76a0025b852a356e2f03,0,Hongbin Ma,2017-03-31 20:22:16+08:00,"['ee5397bc6207c9cdf57cdce93bcda6bcac58a5a9', '1e8b6a5e7b1350930c68e750fb1ce75c27428082']",12,56,68,15059284,2,,,,10553
d216e223b0d1ef67aaa93aa820a11f04ac69cb2e,0,lidongsjtu,2017-03-31 22:57:52+08:00,['9250d9baa6940bf7aa0a76a0025b852a356e2f03'],2,12,14,15059298,2,1,1,0.857142857,10553
4ddcc699ec807aea73cf4c158550678803f48eef,0,Yang Li,2017-04-02 08:56:34+08:00,['9250d9baa6940bf7aa0a76a0025b852a356e2f03'],2,42,44,15059342,3,0,0,1,10554
c85a0e73192ea65d5bf12d116a0f791261365753,0,Yang Li,2017-04-02 09:15:10+08:00,['4ddcc699ec807aea73cf4c158550678803f48eef'],1,30,31,15059373,2,,,,10555
20578319e11e504c2ba647a0593dd6eae2d4624b,1,Yang Li,2017-04-03 16:19:46+08:00,['c85a0e73192ea65d5bf12d116a0f791261365753'],11,33,44,15059417,3,1,1,1,10556
7af5529ef566434b34131a6b77c0f32e738bb318,1,Yang Li,2017-04-03 22:35:21+08:00,['20578319e11e504c2ba647a0593dd6eae2d4624b'],67,44,111,15059528,6,1,1,0,10556
551f5ed2e7922f63e260b5adf1e04c8a86a77298,0,lidongsjtu,2017-04-04 10:55:37+08:00,['7af5529ef566434b34131a6b77c0f32e738bb318'],0,4,4,15059532,1,,,,10556
7cb88f5f971535cdd43292c624c3a3f08faadcdf,0,Yang Li,2017-04-04 16:56:12+08:00,['551f5ed2e7922f63e260b5adf1e04c8a86a77298'],0,2,2,15059534,1,1,1,1,10556
38fe432d914d0bde8a0ddda50a6867ea42b5ccbf,0,Roger Shi,2017-04-05 00:20:55-05:00,['d216e223b0d1ef67aaa93aa820a11f04ac69cb2e'],1,30,31,15059565,3,0,1,1,10556
6f9bce27545ef185a64c24aff67790150fb469b9,0,gaodayue,2017-04-05 13:56:03+08:00,['7cb88f5f971535cdd43292c624c3a3f08faadcdf'],10,12,22,15059587,1,0,1,1,10556
266a62a5ab6b0b39b08b79d3f3d4d1948e111247,0,Dong Li,2017-04-05 14:46:12+08:00,['38fe432d914d0bde8a0ddda50a6867ea42b5ccbf'],20,85,105,15059692,2,0.829268293,1,1,10556
88e66f3ea642816c91c964836aa468c758ec65d9,0,Roger Shi,2017-04-05 18:36:16+08:00,['266a62a5ab6b0b39b08b79d3f3d4d1948e111247'],5,0,5,15059697,1,,,,10556
023fa2387f9685efc64cc21a0fcc7b2e4457d9e7,0,chenzhx,2017-04-06 15:34:14+08:00,['88e66f3ea642816c91c964836aa468c758ec65d9'],3,3,6,15059703,1,,,,10556
75630b8d90a900550a55f4a931eedee4b9eb3d21,0,chenzhx,2017-04-06 15:42:52+08:00,['023fa2387f9685efc64cc21a0fcc7b2e4457d9e7'],10,11,21,15059724,1,0,,,10556
4ae40bd7a59217adef7fe68f952b006191908551,0,Li Yang,2017-04-06 15:46:43+08:00,['6f9bce27545ef185a64c24aff67790150fb469b9'],0,0,0,15059724,1,,,,10556
7129ea650e757d6c50a81823760c45734688cfd2,0,gaodayue,2017-04-06 20:38:03+08:00,['4ae40bd7a59217adef7fe68f952b006191908551'],4,4,8,15059732,2,,,,10556
93cc5ab6a454ecf99a492fa1eb4161a13bf91247,0,gaodayue,2017-04-07 12:11:34+08:00,['7129ea650e757d6c50a81823760c45734688cfd2'],1,1,2,15059734,1,,,,10556
2e87fb41fe36aff015950bad3a88e7ac525debd6,1,gaodayue,2017-04-07 19:10:38+08:00,['93cc5ab6a454ecf99a492fa1eb4161a13bf91247'],75,58,133,15059867,4,0,0,0,10556
6b4f70d257e1eb363a7b792cde8f6f59821094a6,0,Roger Shi,2017-04-09 21:26:09+08:00,['75630b8d90a900550a55f4a931eedee4b9eb3d21'],18,0,18,15059885,1,0.071428571,0.071428571,0,10556
b641032bfe2d79ae162c88ac7faf082250ca3a73,0,lidongsjtu,2017-04-09 23:54:44+08:00,['2e87fb41fe36aff015950bad3a88e7ac525debd6'],7,8,15,15059900,1,,,,10556
c80d4324962a5152380fbdb6b65980331ed9c1ab,1,Li Yang,2017-04-10 17:20:30+08:00,['b641032bfe2d79ae162c88ac7faf082250ca3a73'],2,5,7,15059907,1,1,1,1,10556
c17b3eb36bd89abe0d6b479b223047b68f933cc7,0,Li Yang,2017-04-10 18:20:01+08:00,['c80d4324962a5152380fbdb6b65980331ed9c1ab'],0,1,1,15059908,1,1,1,1,10556
177079d10c1dfd4decadd743eafdfc36a712e470,1,Hongbin Ma,2017-04-10 21:22:09+08:00,['c17b3eb36bd89abe0d6b479b223047b68f933cc7'],1,108,109,15060017,3,0.327272727,0.454545455,0.981818182,10557
6e248e85fbf35440f7e59b5383c99ad3f80079b7,0,lidongsjtu,2017-04-10 21:50:32+08:00,['177079d10c1dfd4decadd743eafdfc36a712e470'],15,61,76,15060093,5,1,1,0,10559
86645af9ddec2289b330bebb3593c673e8ab2ff6,1,lidongsjtu,2017-04-11 10:46:22+08:00,['6e248e85fbf35440f7e59b5383c99ad3f80079b7'],4,5,9,15060102,2,1,,1,10559
9532bf2b089b0b77b7ca49ec73f9304fcbe36666,0,lidongsjtu,2017-04-11 11:13:25+08:00,['86645af9ddec2289b330bebb3593c673e8ab2ff6'],6,0,6,15060108,1,1,0,0,10559
bd3b84402a8f75f02d7f5427d3261ee7c880a5d0,1,lidongsjtu,2017-04-11 12:45:52+08:00,['9532bf2b089b0b77b7ca49ec73f9304fcbe36666'],4,13,17,15060125,2,0.142857143,0.142857143,1,10559
794ef4d4375d03f490b0d1c5da7b5ce1a9dac75e,1,Hongbin Ma,2017-04-11 13:49:17+08:00,['bd3b84402a8f75f02d7f5427d3261ee7c880a5d0'],18,16,34,15060159,3,0,1,1,10559
a36288142f30cad931881107872adb4ba0a574a3,0,Hongbin Ma,2017-04-11 13:55:11+08:00,['794ef4d4375d03f490b0d1c5da7b5ce1a9dac75e'],3,3,6,15060165,2,0,0,0,10559
f44f828928aaecac3e7dafee69d9443b043b0d4f,0,Hongbin Ma,2017-04-11 14:54:21+08:00,['6b4f70d257e1eb363a7b792cde8f6f59821094a6'],1,1,2,15060167,1,,,,10559
e9ec116c247072603a5405ddba425fd349ba670b,1,Hongbin Ma,2017-04-11 17:12:46+08:00,"['f44f828928aaecac3e7dafee69d9443b043b0d4f', 'a36288142f30cad931881107872adb4ba0a574a3']",186,403,589,15060756,31,,,,10559
037dd474980b2e33ee80674d4a5de2434a033e85,0,Dong Li,2017-04-11 19:00:34+08:00,['e9ec116c247072603a5405ddba425fd349ba670b'],39,45,84,15060840,12,1,1,0,10559
abb73ff560fcc0819ef7c1e252da00ef6f0256be,0,lidongsjtu,2017-04-11 23:19:46+08:00,['037dd474980b2e33ee80674d4a5de2434a033e85'],4,4,8,15060848,4,,,,10559
1caf19ab5f7f309899f93b9f6c426db11a6ff19a,0,Li Yang,2017-04-12 10:39:55+08:00,['e9ec116c247072603a5405ddba425fd349ba670b'],11,13,24,15060872,1,,,,10559
d69cc2780d6849ff04d36e24882b932b22f6cc67,0,liyang-gmt8,2017-04-12 11:51:31+08:00,['abb73ff560fcc0819ef7c1e252da00ef6f0256be'],1,50,51,15060923,1,,,,10559
8733ddab7b710ce6807ba06a4fc000679453e379,0,nichunen,2017-04-12 14:44:45+08:00,['d69cc2780d6849ff04d36e24882b932b22f6cc67'],1,1,2,15060925,1,,,,10559
821f59be351f1f91a3e6bd0ef3a71e451504f9fe,1,shaofengshi,2017-04-13 19:34:22+08:00,['1caf19ab5f7f309899f93b9f6c426db11a6ff19a'],1,5,6,15060931,1,0,0,1,10559
675c0d82a0e568cf6b7a4d36ae12fc8966d5d705,0,lidongsjtu,2017-04-13 20:04:42+08:00,['8733ddab7b710ce6807ba06a4fc000679453e379'],10,50,60,15060991,2,1,0.461538462,1,10559
75d50ae97a5ee877acace8cb0e8b4557013b3702,0,shaofengshi,2017-04-14 10:33:20+08:00,['821f59be351f1f91a3e6bd0ef3a71e451504f9fe'],8,26,34,15061025,2,1,1,0.857142857,10559
7d6329b0dda3bccf04437f803326edc72d27c2db,0,Billy Liu,2017-04-14 11:37:47+08:00,['75d50ae97a5ee877acace8cb0e8b4557013b3702'],2,7,9,15061034,1,,,,10559
47e8be5d55b4210c84e5f5d20a19bdb3eb8e8c6f,0,shaofengshi,2017-04-18 10:39:42+08:00,['7d6329b0dda3bccf04437f803326edc72d27c2db'],5,8,13,15061047,1,0,0,1,10559
bb1517bb56cd9230836ab2df807680e960aa943a,0,hongbin ma,2017-04-18 15:20:00+08:00,['675c0d82a0e568cf6b7a4d36ae12fc8966d5d705'],4,50,54,15061101,1,0,0,0.875,10559
a1ad1eb2d8f1e0fe4f4a5cdc2fd93f35ea82b2d4,0,xiefan46,2017-04-18 15:30:59+08:00,['bb1517bb56cd9230836ab2df807680e960aa943a'],1,2,3,15061104,1,0,0,1,10559
913170468742bd5b307e48f89ab7d221b19ef6b6,0,Yang Li,2017-04-18 20:43:20+08:00,['47e8be5d55b4210c84e5f5d20a19bdb3eb8e8c6f'],429,95,524,15061628,6,0.451612903,0.532258065,0.612903226,10559
410898f64632fe882fcd82072ed15f6d28e3e0aa,1,Hongbin Ma,2017-04-19 11:02:27+08:00,['a1ad1eb2d8f1e0fe4f4a5cdc2fd93f35ea82b2d4'],16,49,65,15061693,1,,,,10559
6d6e862f15568a5cd40f3bf10f02645641e17d07,1,hongbin ma,2017-04-19 12:34:16+08:00,['410898f64632fe882fcd82072ed15f6d28e3e0aa'],1,12,13,15061706,1,0,0,1,10559
3c70b8b96176c58b784cda48afee8f560ace848f,1,Hongbin Ma,2017-04-19 19:21:44+08:00,['6d6e862f15568a5cd40f3bf10f02645641e17d07'],13,49,62,15061768,7,0,1,1,10559
9b36e268d17fae688620faeaf6fabf9e660c04b2,1,kangkaisen,2017-04-20 20:01:24+08:00,['913170468742bd5b307e48f89ab7d221b19ef6b6'],2236,2318,4554,15066322,26,0.739130435,0.554347826,0.516304348,10568
e3fe6b7bd13efc27c57ee771d059f24217d0ee52,0,Li Yang,2017-04-21 12:06:30+08:00,['9b36e268d17fae688620faeaf6fabf9e660c04b2'],1,1,2,15066324,1,,,,10568
f9791172ef44714bd84adb027fb5849fc3aecb3f,0,shaofengshi,2017-04-21 16:50:58+08:00,['e3fe6b7bd13efc27c57ee771d059f24217d0ee52'],0,2,2,15066326,1,0,0,1,10568
139aa1886145c9210a1a752d1036766cfa00b73f,0,kangkaisen,2017-04-21 17:19:35+08:00,['f9791172ef44714bd84adb027fb5849fc3aecb3f'],2,3,5,15066331,1,,,,10568
a8626030668cb92abf7e4219041ca2df54779adf,0,lidongsjtu,2017-04-21 17:26:08+08:00,['3c70b8b96176c58b784cda48afee8f560ace848f'],0,1,1,15066332,1,0,1,1,10568
8c9484242ac8f575a80abdcb110a7691bc1951e9,1,Li Yang,2017-04-22 10:30:34+08:00,['139aa1886145c9210a1a752d1036766cfa00b73f'],2,52,54,15066386,4,,,,10568
f1c0d7d4e931b063f0b1563d5e24b03944506d04,0,Li Yang,2017-04-22 14:48:18+08:00,['8c9484242ac8f575a80abdcb110a7691bc1951e9'],23,23,46,15066432,23,,,,10568
3152264c15f07cc64210ccbe052780fd6fefc006,0,Li Yang,2017-04-24 11:42:20+08:00,['f1c0d7d4e931b063f0b1563d5e24b03944506d04'],0,5,5,15066437,1,,,,10568
07cf142820ed2033d9af4278c8f4166c1815bd0d,1,shaofengshi,2017-04-24 18:15:26+08:00,['3152264c15f07cc64210ccbe052780fd6fefc006'],0,37,37,15066474,3,0,0,1,10568
c43f96d21a2e4309949619be5dfede4a3d82c1a2,0,Li Yang,2017-04-25 14:52:20+08:00,['07cf142820ed2033d9af4278c8f4166c1815bd0d'],0,1,1,15066475,1,0,1,1,10568
0762c4ddbc27be4f471882394e580d94bc836fb5,0,liyang-gmt8,2017-04-25 16:13:53+08:00,['a8626030668cb92abf7e4219041ca2df54779adf'],8,46,54,15066529,3,0.208333333,1,1,10568
a0b537b8ce5a2f5d8340e06f2a49b525fcef4572,1,Hongbin Ma,2017-04-25 18:20:06+08:00,['0762c4ddbc27be4f471882394e580d94bc836fb5'],487,598,1085,15067614,1,,,,10568
2d11fbcea1fcecfc9efd395e24d10696046f4a12,0,Yang Li,2017-04-25 20:19:35+08:00,['c43f96d21a2e4309949619be5dfede4a3d82c1a2'],21,51,72,15067686,6,0.952380952,0.952380952,0.952380952,10568
8fa827716eb66a40e2561433d58f13a4605e3796,0,nichunen,2017-04-26 17:57:54+08:00,['a0b537b8ce5a2f5d8340e06f2a49b525fcef4572'],4,9,13,15067699,1,1,1,1,10568
85b4b2c7c0dc7d2052cd92cc50ac3b6b94f88668,0,kangkaisen,2017-04-26 18:35:17+08:00,['2d11fbcea1fcecfc9efd395e24d10696046f4a12'],50,134,184,15067883,3,0.47826087,1,1,10569
6cd1b3640aecd42ac5860c1c40e94c75cfdfbf59,0,lidongsjtu,2017-04-26 18:41:41+08:00,['8fa827716eb66a40e2561433d58f13a4605e3796'],1,10,11,15067894,2,1,1,1,10569
29265aff2956fd125062e1aa431c4821f70e922d,0,Hongbin Ma,2017-04-26 22:04:37+08:00,['6cd1b3640aecd42ac5860c1c40e94c75cfdfbf59'],34,29,63,15067957,1,,,,10569
043dd5cd551735c5f9d8036a987eab579c4ee7b3,0,lidongsjtu,2017-04-27 11:43:19+08:00,['85b4b2c7c0dc7d2052cd92cc50ac3b6b94f88668'],1,12,13,15067970,2,0,0,0.875,10569
ff3e095ac7a575c6e192f3baf72df10da4ff1fee,0,Hongbin Ma,2017-04-27 17:26:32+08:00,"['29265aff2956fd125062e1aa431c4821f70e922d', '043dd5cd551735c5f9d8036a987eab579c4ee7b3']",2788,2790,5578,15073548,81,,,,10569
60350c4af1368062db47412c3cda80a8fd266784,1,lidongsjtu,2017-04-28 10:51:19+08:00,['ff3e095ac7a575c6e192f3baf72df10da4ff1fee'],6,48,54,15073602,4,0.290322581,0.290322581,1,10569
95c6d4fa3dcdca737185a9e84dbb98f13ca5dd8f,1,Hongbin Ma,2017-04-28 11:33:26+08:00,['ff3e095ac7a575c6e192f3baf72df10da4ff1fee'],406,1501,1907,15075509,15,0.391549296,0.698591549,0.935211268,10574
61fbebd4711bdaa183ea19d0a3cedd2b4ffb36bd,1,Hongbin Ma,2017-04-28 11:33:55+08:00,['95c6d4fa3dcdca737185a9e84dbb98f13ca5dd8f'],684,1401,2085,15077594,23,0.598930481,0.689839572,0.823529412,10580
7a5a3643b238e28e59015d488638307fbd46390d,1,Hongbin Ma,2017-04-28 11:34:10+08:00,['61fbebd4711bdaa183ea19d0a3cedd2b4ffb36bd'],358,337,695,15078289,24,0.111111111,0.777777778,0.777777778,10581
5450d06a09bf604836757f060daea480ea6ee27e,0,Hongbin Ma,2017-04-28 11:34:17+08:00,['7a5a3643b238e28e59015d488638307fbd46390d'],72,13,85,15078374,3,1,1,0.779569892,10581
02a3d14ffc7ef26f0f0b9c90bccebeacdeb01edc,0,Hongbin Ma,2017-04-28 11:44:50+08:00,"['60350c4af1368062db47412c3cda80a8fd266784', '5450d06a09bf604836757f060daea480ea6ee27e']",1107,2842,3949,15082323,42,,,,10581
d609809939d8221ec37b8056abad359a58154f4b,0,Hongbin Ma,2017-04-28 13:26:57+08:00,['02a3d14ffc7ef26f0f0b9c90bccebeacdeb01edc'],87,87,174,15082497,3,,,,10581
4c18526cff0c8437f3724fb32833636050bb7fe1,0,hongbin ma,2017-04-28 18:09:53+08:00,['d609809939d8221ec37b8056abad359a58154f4b'],112,164,276,15082773,5,1,1,1,10583
ea5fcff8397026de315324bf1797b62944591908,1,nichunen,2017-04-28 18:41:52+08:00,['4c18526cff0c8437f3724fb32833636050bb7fe1'],42,173,215,15082988,8,0.428571429,1,1,10585
c40843771224c756cd4972c9f1d0bf9520a03e3e,0,Yang Li,2017-04-29 07:23:27+08:00,['02a3d14ffc7ef26f0f0b9c90bccebeacdeb01edc'],2,2,4,15082992,1,,,,10585
299b584151f75f475c61a88bd15167dbbd744386,0,Cheng Wang,2017-04-29 20:34:08+08:00,['ea5fcff8397026de315324bf1797b62944591908'],6,11,17,15083009,2,1,1,1,10585
0b51f7bec9d6f721d8e6a092f23b2f1d445f7a18,0,hongbin ma,2017-05-01 11:35:07+08:00,['299b584151f75f475c61a88bd15167dbbd744386'],49,205,254,15083263,6,0.178571429,0,1,10589
7926ecd91a3fe984e5b6e9402c6b6efbc9dc6d83,0,Hongbin Ma,2017-05-01 17:40:37+08:00,['c40843771224c756cd4972c9f1d0bf9520a03e3e'],3,1065,1068,15084331,15,0.414168937,0.959128065,0.550408719,10602
8d647bd15d414d9e1cc5f8a8fd7198ce01fc97e3,0,Hongbin Ma,2017-05-01 17:45:48+08:00,['7926ecd91a3fe984e5b6e9402c6b6efbc9dc6d83'],1,0,1,15084332,1,,,,10602
d7d468acb3982813304f87e8f3acc7952261aa9e,0,Hongbin Ma,2017-05-01 20:26:34+08:00,['8d647bd15d414d9e1cc5f8a8fd7198ce01fc97e3'],8,58,66,15084398,7,1,1,1,10604
2b6a91f14e791347f19bb1a7811c691fb1b6afb0,1,hongbin ma,2017-05-02 13:33:47+08:00,['0b51f7bec9d6f721d8e6a092f23b2f1d445f7a18'],295,199,494,15084892,8,0,0.125,0,10607
4c58b9837bfff6493051a7f0a4a68132e59b9ef2,0,Dong Li,2017-05-03 11:40:19+08:00,['2b6a91f14e791347f19bb1a7811c691fb1b6afb0'],1,1,2,15084894,1,,,,10607
0e0c970aadb17d9abec7166a3ab87b0c5a783d65,0,Dong Li,2017-05-03 13:51:55+08:00,['4c58b9837bfff6493051a7f0a4a68132e59b9ef2'],5,5,10,15084904,5,,,,10607
32b8f2c7fe7e4179dec9ce1ccafac917dbe2eb27,1,hongbin ma,2017-05-03 20:00:29+08:00,['0e0c970aadb17d9abec7166a3ab87b0c5a783d65'],18,10,28,15084932,8,1,0,0.142857143,10607
8a4b6b9611a25c8e0f8bf2ec99244a250d9dd91b,0,Dong Li,2017-05-04 17:00:22+08:00,['32b8f2c7fe7e4179dec9ce1ccafac917dbe2eb27'],1,1,2,15084934,1,,,,10607
ca106b824f50613385c98f8276bcbfaa04cb6cde,1,hongbin ma,2017-05-04 22:32:55+08:00,['8a4b6b9611a25c8e0f8bf2ec99244a250d9dd91b'],1,66,67,15085001,6,0.98,1,0.98,10607
783bb4eecdcd9d455d61009eef27f2508f14d8c8,0,Hongbin Ma,2017-05-05 09:24:42+08:00,['d7d468acb3982813304f87e8f3acc7952261aa9e'],3,8,11,15085012,1,0,1,1,10607
5e6ed11efd9a6a607fd1c8abf01f2c0d829c5e62,0,hongbin ma,2017-05-05 10:31:54+08:00,['ca106b824f50613385c98f8276bcbfaa04cb6cde'],44,256,300,15085312,5,1,1,0.5375,10609
9a0598e31592b204f92e9f30843103b5552a9883,0,hongbin ma,2017-05-05 10:42:44+08:00,['5e6ed11efd9a6a607fd1c8abf01f2c0d829c5e62'],2,0,2,15085314,1,,,,10609
0396923651cda8428b3022febcf013ff6d0457cf,1,hongbin ma,2017-05-05 20:56:52+08:00,['9a0598e31592b204f92e9f30843103b5552a9883'],3,3,6,15085320,1,,,,10609
7df407da0cff32feaba4570698fdddcd86c4c48f,1,Yang Li,2017-05-07 14:51:53+08:00,['783bb4eecdcd9d455d61009eef27f2508f14d8c8'],483,700,1183,15086503,13,0.26,0.62,0.97,10611
d738544eeb03235ed2cf9e2f4509c1d09d98db8a,0,Yang Li,2017-05-07 14:52:14+08:00,['7df407da0cff32feaba4570698fdddcd86c4c48f'],4,51,55,15086558,2,0.290322581,1,1,10611
263a1e8889ba223883ba42178debeee0bd02c240,0,Yang Li,2017-05-07 15:56:43+08:00,['d738544eeb03235ed2cf9e2f4509c1d09d98db8a'],11,38,49,15086607,5,0.8125,0.9375,0.3125,10611
41c7a4d9417eb75dad5f0da4e5a07a14e8f7e056,0,Yang Li,2017-05-07 20:36:24+08:00,['263a1e8889ba223883ba42178debeee0bd02c240'],8,8,16,15086623,2,,,,10611
8b277d5e492d8d54e6fd1f38eef7cf8d174f2b00,1,liyang-gmt8,2017-05-07 21:22:28+08:00,['0396923651cda8428b3022febcf013ff6d0457cf'],143,51,194,15086817,14,0,0,0,10611
1ba9af70a5e8c49dfa3ecbc1e3222cbd46b06cbe,0,Dong Li,2017-05-08 15:25:53+08:00,['8b277d5e492d8d54e6fd1f38eef7cf8d174f2b00'],1,54,55,15086872,2,0,1,0.906976744,10611
d6fdda2c24ac89ec72ff9663a36993f42a70960b,0,liyang-gmt8,2017-05-08 16:01:48+08:00,['1ba9af70a5e8c49dfa3ecbc1e3222cbd46b06cbe'],3,3,6,15086878,1,1,1,1,10611
9a812d5fc917ddcdb736cd1c91fdfe9c933e603a,1,liyang-gmt8,2017-05-08 16:01:48+08:00,['d6fdda2c24ac89ec72ff9663a36993f42a70960b'],1011,1894,2905,15089783,39,0.581967213,0.840163934,0.819672131,10619
42f7e7dad7f34f9d0849c72f1a20c3e2d4475b99,0,Yang Li,2017-05-09 07:06:03+08:00,['41c7a4d9417eb75dad5f0da4e5a07a14e8f7e056'],2,3,5,15089788,1,1,1,1,10619
901b10cee549a9c1e8d2df711a8c8d83789d7717,0,Billy Liu,2017-05-09 13:47:32+08:00,['42f7e7dad7f34f9d0849c72f1a20c3e2d4475b99'],7,34,41,15089829,1,,,,10619
529b1be2f9f0f1c7bfb2798928b8c6c60cb581ea,0,Dong Li,2017-05-09 20:30:21+08:00,['9a812d5fc917ddcdb736cd1c91fdfe9c933e603a'],0,86,86,15089915,2,0,0,1,10620
9dc6553d29eb3f106823026f45dc878347a2a108,0,Dong Li,2017-05-09 20:30:21+08:00,['529b1be2f9f0f1c7bfb2798928b8c6c60cb581ea'],4,144,148,15090063,7,0.428571429,0.428571429,1,10624
c3d81832f796ab281526d3ac1cd97b11eb986a92,0,liyang-gmt8,2017-05-10 09:41:40+08:00,['9dc6553d29eb3f106823026f45dc878347a2a108'],0,37,37,15090100,2,0,0,1,10625
f277b2d586d4b306d15a2fc7de83b1dfb38d628e,0,liyang-gmt8,2017-05-10 14:16:18+08:00,['c3d81832f796ab281526d3ac1cd97b11eb986a92'],12,142,154,15090254,8,0.0625,0.0625,1,10631
1264ff39b740f9515653d30e0712739bc717d438,0,kangkaisen,2017-05-10 20:03:40+08:00,['901b10cee549a9c1e8d2df711a8c8d83789d7717'],1,1,2,15090256,1,,,,10631
b3310dcdc0f9ac99006eb4d1a0910de9c43f22fd,0,kangkaisen,2017-05-11 10:13:58+08:00,['1264ff39b740f9515653d30e0712739bc717d438'],3,11,14,15090270,1,0.5,0.5,1,10631
d449c40d58b8af10ebc638be4aadb80e09787a9d,0,Billy Liu,2017-05-11 13:34:24+08:00,['b3310dcdc0f9ac99006eb4d1a0910de9c43f22fd'],12,23,35,15090305,2,,,,10631
a059064df85d26014150709273cb2535805adadf,0,liyang-gmt8,2017-05-11 16:27:38+08:00,['f277b2d586d4b306d15a2fc7de83b1dfb38d628e'],1,1,2,15090307,1,,,,10631
c6428efae6d0c5c53823666e1bc72ea0bdd9f4e7,0,Billy Liu,2017-05-11 21:51:30+08:00,['d449c40d58b8af10ebc638be4aadb80e09787a9d'],0,1,1,15090308,1,1,1,1,10631
397642009ed6056d7ee5ee66f51f7f67026933d4,0,Billy Liu,2017-05-11 23:45:45+08:00,['c6428efae6d0c5c53823666e1bc72ea0bdd9f4e7'],2,2,4,15090312,1,,,,10631
949237ddca0ab24bf8121ccc002d802df678761c,0,Dong Li,2017-05-12 12:46:35+08:00,['a059064df85d26014150709273cb2535805adadf'],1,1,2,15090314,1,,,,10631
b08d278e5ed688457758eee43aff4f479fd0fb72,0,Dong Li,2017-05-12 12:46:35+08:00,['949237ddca0ab24bf8121ccc002d802df678761c'],177,0,177,15090491,2,,,,10631
b3ba338eaf889d42e02870007c1876eb32c884ee,1,Hongbin Ma,2017-05-12 13:00:43+08:00,['397642009ed6056d7ee5ee66f51f7f67026933d4'],12,177,189,15090680,3,0.765432099,0.592592593,1,10632
7c0038db4aab12c6fbd8f249b104a473e1d5a61c,0,Dong Li,2017-05-12 13:12:08+08:00,['b08d278e5ed688457758eee43aff4f479fd0fb72'],1,1,2,15090682,1,,,,10632
edc4d4cc558473476b18d48f232635e44640c27a,1,hongbin ma,2017-05-12 14:55:14+08:00,['7c0038db4aab12c6fbd8f249b104a473e1d5a61c'],107,134,241,15090923,12,0,0,0.466666667,10632
320e56a532cf6d4968430c8111d239961a07c7f8,1,kangkaisen,2017-05-12 16:47:39+08:00,['b3ba338eaf889d42e02870007c1876eb32c884ee'],3,13,16,15090939,1,0,1,0,10632
fd671d165aa59c734b2f273ffae6d1017dc61153,1,Yang Li,2017-05-14 13:35:29+08:00,['320e56a532cf6d4968430c8111d239961a07c7f8'],34,32,66,15091005,1,1,1,1,10632
c8524efe7c49db6a3225ef0caa7bf900f55c2ae3,0,Yang Li,2017-05-14 16:42:34+08:00,['fd671d165aa59c734b2f273ffae6d1017dc61153'],1,2,3,15091008,1,,,,10632
e6a8a00b89dbdf922405f8586b43d1c9b99cff90,1,Yang Li,2017-05-14 19:45:48+08:00,['c8524efe7c49db6a3225ef0caa7bf900f55c2ae3'],1,20,21,15091029,1,0.230769231,0.230769231,0.230769231,10632
1c80c29b22d9c00de1eb2e9a09c21377714248b7,0,Yang Li,2017-05-14 20:14:29+08:00,['e6a8a00b89dbdf922405f8586b43d1c9b99cff90'],27,27,54,15091083,1,0,0,0,10632
1c3ed36f7dcf2152b17966bb69dd3211ce4e8aba,0,kangkaisen,2017-05-15 16:02:01+08:00,['1c80c29b22d9c00de1eb2e9a09c21377714248b7'],2,9,11,15091094,2,0.6,0.6,1,10632
858d947518b308c1a33b832ea8ef49144285c02e,0,kangkaisen,2017-05-16 09:48:22+08:00,['1c3ed36f7dcf2152b17966bb69dd3211ce4e8aba'],9,2,11,15091105,2,0.4,0.4,0,10632
a38b02df0387541684aa1689e044927af650f1c7,0,liyang-gmt8,2017-05-16 14:03:50+08:00,['edc4d4cc558473476b18d48f232635e44640c27a'],128,207,335,15091440,10,0.896551724,0.965517241,0.24137931,10632
c9dc7cc78c5eed40f4c5a438423b857a145f17b1,0,Roger Shi,2017-05-16 20:59:12+08:00,['a38b02df0387541684aa1689e044927af650f1c7'],1,27,28,15091468,2,1,0,1,10633
a34db26f0bd594b55fd4df29b66f15579bb3c8ff,0,Billy Liu,2017-05-17 16:23:12+08:00,['858d947518b308c1a33b832ea8ef49144285c02e'],10,10,20,15091488,1,,,0,10633
ea5cabac95b3d27aa60d6b16263904142e3d2daa,0,Roger Shi,2017-05-17 19:40:34+08:00,['c9dc7cc78c5eed40f4c5a438423b857a145f17b1'],2,145,147,15091635,2,0.539215686,1,0.921568627,10633
5f52cea4f7ffbb0fa885df650803156cd1daa5d2,0,Roger Shi,2017-05-18 11:02:49+08:00,['ea5cabac95b3d27aa60d6b16263904142e3d2daa'],0,6,6,15091641,1,0,0,1,10633
0061900bb5bd34c8f0cc1c6e955d34bf34ca48e2,0,liyang-gmt8,2017-05-18 15:27:36+08:00,['5f52cea4f7ffbb0fa885df650803156cd1daa5d2'],4,6,10,15091651,1,,,,10633
7c152c515ce6cebe380c4e1b7c16d109192308db,1,liyang-gmt8,2017-05-18 15:27:36+08:00,['0061900bb5bd34c8f0cc1c6e955d34bf34ca48e2'],53,57,110,15091761,6,1,0,1,10633
2dfc5bb36a00245b95deeebb5bb3bca9c353c934,1,nichunen,2017-05-19 13:52:53+08:00,['7c152c515ce6cebe380c4e1b7c16d109192308db'],185,461,646,15092407,28,0.590909091,0.603896104,0.967532468,10635
87fedf75e5bbf61a33cf1b31720ad9ac55de6287,0,Billy Liu,2017-05-19 16:44:28+08:00,['a34db26f0bd594b55fd4df29b66f15579bb3c8ff'],2,5,7,15092414,1,1,1,1,10635
8ce972fd6475e923af2a5e525d8ddb698d0dbadf,0,liyang-gmt8,2017-05-19 17:25:55+08:00,['2dfc5bb36a00245b95deeebb5bb3bca9c353c934'],1,5,6,15092420,1,1,1,1,10635
f36372bc657b1edb312b36a071b077cde184eab8,0,Hongbin Ma,2017-05-19 17:55:26+08:00,"['8ce972fd6475e923af2a5e525d8ddb698d0dbadf', '87fedf75e5bbf61a33cf1b31720ad9ac55de6287']",604,2252,2856,15095276,53,,,,10635
be32f75883c21bf32545d1b06158ad7cf36d676b,0,Yang Li,2017-05-19 22:02:38+08:00,['f36372bc657b1edb312b36a071b077cde184eab8'],4,13,17,15095293,2,1,1,1,10635
d21c8170b7bbc8f750aadab5c68d229dee6d252f,1,hongbin ma,2017-05-19 22:48:41+08:00,['f36372bc657b1edb312b36a071b077cde184eab8'],11,19,30,15095323,1,1,1,1,10635
0bdd1c21981cef4d9e6edafd63b9c5a0fb2a6725,0,Yang Li,2017-05-20 09:38:51+08:00,['be32f75883c21bf32545d1b06158ad7cf36d676b'],4,15,19,15095342,4,0.666666667,0.833333333,1,10636
fd3bfedb50f488d6679b9a01bc17e214622b8838,0,Yang Li,2017-05-20 14:00:06+08:00,['0bdd1c21981cef4d9e6edafd63b9c5a0fb2a6725'],2,2,4,15095346,1,,,,10636
1b864f04e3fbf50c08978c2f8533ead4ca9784c6,0,hongbin ma,2017-05-20 14:19:07+08:00,['d21c8170b7bbc8f750aadab5c68d229dee6d252f'],6,17,23,15095369,4,0.666666667,0.833333333,1,10637
429dfbdc93371e8df2095e35298425ccab8ac7de,0,Roger Shi,2017-05-20 21:35:36+08:00,['1b864f04e3fbf50c08978c2f8533ead4ca9784c6'],67,32,99,15095468,4,0.826086957,0,0,10637
73a78dbee84808de42925ca5a0b8e16761840233,1,liyang-gmt8,2017-05-21 09:18:59+08:00,['429dfbdc93371e8df2095e35298425ccab8ac7de'],436,6748,7184,15102652,101,0.43464837,0.558490566,0.72109777,10668
ce09d6c7f027cdc55c10fb96ea21a70c4002f244,0,shaofengshi,2017-05-22 11:25:13+08:00,['fd3bfedb50f488d6679b9a01bc17e214622b8838'],13,7,20,15102672,1,0.2,0.2,0,10668
f9b6db6a582747f58e91d22de76ff7549172f460,0,shaofengshi,2017-05-22 16:52:47+08:00,['ce09d6c7f027cdc55c10fb96ea21a70c4002f244'],1,1,2,15102674,1,,,,10668
ce6e3ede2f670bf037a55234630b85098265075a,0,Billy Liu,2017-05-23 09:43:07+08:00,['f9b6db6a582747f58e91d22de76ff7549172f460'],3,13,16,15102690,1,1,1,1,10668
11a0b57acd434cff426e860a0b4c645b496522f6,0,鎴?2017-05-23 11:30:25+08:00,['73a78dbee84808de42925ca5a0b8e16761840233'],2,2,4,15102694,1,,,,10668,
8cd807f778eeafbb54effb0dd1c7ab552e68c730,0,鎴?2017-05-23 11:30:25+08:00,['11a0b57acd434cff426e860a0b4c645b496522f6'],1,2,3,15102697,1,,,,10668,
4766c789d8298b477edad7a9e86ebaec603f1b52,0,鎴?2017-05-23 11:30:25+08:00,['8cd807f778eeafbb54effb0dd1c7ab552e68c730'],1,1,2,15102699,1,,,,10668,
0a0edfefb96689ba06bb89a657d7c65711894ebb,1,hongbin ma,2017-05-23 17:30:18+08:00,['4766c789d8298b477edad7a9e86ebaec603f1b52'],396,491,887,15103586,49,0,0,1,10670
2471d5e56219d7c51342953ae37eb77370ae1e58,0,liyang-gmt8,2017-05-23 18:21:27+08:00,['0a0edfefb96689ba06bb89a657d7c65711894ebb'],419,319,738,15104324,10,0.344086022,1,0.021505376,10670
81ed30110186e2c13511a3fc50f6098645412aab,0,Hongbin Ma,2017-05-23 19:31:36+08:00,"['2471d5e56219d7c51342953ae37eb77370ae1e58', 'ce6e3ede2f670bf037a55234630b85098265075a']",21,26,47,15104371,9,,,,10670
83fb144f2c3df127a2b893f96a05507b8de01e7f,0,hongbin ma,2017-05-23 19:46:02+08:00,['81ed30110186e2c13511a3fc50f6098645412aab'],5,7,12,15104383,1,0,0,1,10670
9fef04d9a98e11454d00247d8cd2f4d501ba66a2,0,Billy Liu,2017-05-23 20:02:21+08:00,['81ed30110186e2c13511a3fc50f6098645412aab'],6,12,18,15104401,1,0,0,1,10670
e1bc72e36d83a42d364e6d9b0ee893fbc018d498,0,hongbin ma,2017-05-23 20:18:17+08:00,['83fb144f2c3df127a2b893f96a05507b8de01e7f'],107,370,477,15104878,19,0.756756757,0.331081081,0.709459459,10670
0e44a195b5b2a0074896ffae0636b82a1d7c1355,0,hongbin ma,2017-05-23 20:18:17+08:00,['e1bc72e36d83a42d364e6d9b0ee893fbc018d498'],1,1,2,15104880,1,,,,10670
ed0430bc0649ac5b4de7a6c3df0f65b8121d12cd,0,hongbin ma,2017-05-23 20:18:17+08:00,['0e44a195b5b2a0074896ffae0636b82a1d7c1355'],2,1,3,15104883,1,1,0,0,10670
34a65baec0d47de0d91aa8a98b8e1a70db7b6d65,0,Hongbin Ma,2017-05-23 20:22:54+08:00,"['ed0430bc0649ac5b4de7a6c3df0f65b8121d12cd', '9fef04d9a98e11454d00247d8cd2f4d501ba66a2']",6,12,18,15104901,1,,,,10670
ada37a9109678abf347d3600b3a19888d6f64056,0,Hongbin Ma,2017-05-23 20:24:46+08:00,['34a65baec0d47de0d91aa8a98b8e1a70db7b6d65'],23,72,95,15104996,5,1,0,1,10672
f870c6c4d64e4aa2ae5f3495534d97e04466b843,1,Hongbin Ma,2017-05-23 20:30:03+08:00,['ada37a9109678abf347d3600b3a19888d6f64056'],70,96,166,15105162,7,0.32,1,1,10672
2c549895dab065491faef3a46cf0b710791ef2af,0,Hongbin Ma,2017-05-23 20:30:06+08:00,['f870c6c4d64e4aa2ae5f3495534d97e04466b843'],56,203,259,15105421,12,1,0.827160494,1,10673
79c75015e49b2216f6e8ca9ec0cedbff72737821,0,Hongbin Ma,2017-05-23 20:30:06+08:00,['2c549895dab065491faef3a46cf0b710791ef2af'],1,102,103,15105524,4,0.523809524,0.238095238,0.976190476,10676
92b640437ca09ba75fc7bce6407cf722f4f4dd8b,0,Hongbin Ma,2017-05-23 20:34:28+08:00,"['34a65baec0d47de0d91aa8a98b8e1a70db7b6d65', '79c75015e49b2216f6e8ca9ec0cedbff72737821']",149,470,619,15106143,25,,,,10676
5d2934b7e6331e5fef2c18c92d7338932b087b3f,0,hongbin ma,2017-05-23 21:27:41+08:00,['92b640437ca09ba75fc7bce6407cf722f4f4dd8b'],1,31,32,15106175,2,1,1,1,10677
fdacf5d3fac8740ab031f35d6317571f11a87c23,0,hongbin ma,2017-05-24 10:52:57+08:00,['5d2934b7e6331e5fef2c18c92d7338932b087b3f'],3,3,6,15106181,3,,,,10677
5c254475c63c68eb238d7ba44eb8ed0de5fc471e,0,hongbin ma,2017-05-24 12:37:44+08:00,['fdacf5d3fac8740ab031f35d6317571f11a87c23'],22,14,36,15106217,8,1,0.166666667,0.666666667,10677
6d9bbddc044ec00118855ad50ca3434d5a71fdd3,0,hongbin ma,2017-05-24 15:53:19+08:00,['5c254475c63c68eb238d7ba44eb8ed0de5fc471e'],2,0,2,15106219,1,1,0,0,10677
7544c9b74c4e0c726c4a8e3ebfba1013a69d5a7e,0,hongbin ma,2017-05-24 16:35:18+08:00,['6d9bbddc044ec00118855ad50ca3434d5a71fdd3'],2,17,19,15106238,1,0,0,1,10677
6914f3f409372dc1fd11cd140984aa67d31e5ac4,0,Billy Liu,2017-05-25 10:37:03+08:00,['fdacf5d3fac8740ab031f35d6317571f11a87c23'],0,2,2,15106240,1,,,,10677
7894fc0381c986d6f8351b4969735c7ddea9f74e,1,hongbin ma,2017-05-25 13:30:46+08:00,['7544c9b74c4e0c726c4a8e3ebfba1013a69d5a7e'],25,522,547,15106787,22,0.644859813,0.836448598,0.714953271,10682
c4a6eaf4a2a9fc591607aaaced6cba7f7215b9bb,0,hongbin ma,2017-05-25 13:30:46+08:00,['7894fc0381c986d6f8351b4969735c7ddea9f74e'],1,5,6,15106793,1,0,0,1,10682
e92f3443682e07e99d63f2926cb34b60c1d31cbb,0,liyang-gmt8,2017-05-25 14:43:16+08:00,['c4a6eaf4a2a9fc591607aaaced6cba7f7215b9bb'],0,12,12,15106805,1,1,1,1,10682
a1ccf02e297c3b655b707880aa27c9049f4b1b8b,1,Dong Li,2017-05-25 19:28:54+08:00,['e92f3443682e07e99d63f2926cb34b60c1d31cbb'],529,2236,2765,15109570,23,0.573643411,0.899224806,0.821705426,10689
a8061752aed6941bfd443f6456cab6f4dc660d95,1,hongbin ma,2017-05-25 21:42:37+08:00,['a1ccf02e297c3b655b707880aa27c9049f4b1b8b'],2,70,72,15109642,2,0.610169492,0.220338983,0.610169492,10689
e0f30d100b7afc73326538d4d8a57b973f57013b,0,Dong Li,2017-05-25 22:24:04+08:00,['a8061752aed6941bfd443f6456cab6f4dc660d95'],3,16,19,15109661,2,1,1,0.3,10689
fc0b99729c5cc88e7883bc3fffb7aeb035c96316,1,liyang-gmt8,2017-05-26 06:20:19+08:00,['e0f30d100b7afc73326538d4d8a57b973f57013b'],274,197,471,15110132,13,1,0.94,0,10689
9d4bdaed36220b57576f044467459e12c976002a,1,liyang-gmt8,2017-05-26 10:09:00+08:00,['fc0b99729c5cc88e7883bc3fffb7aeb035c96316'],1868,863,2731,15112863,22,0.795591182,0.659318637,0.224448898,10689
f02558d00ad3d45726aa5704d28f3ff3eff237c5,0,liyang-gmt8,2017-05-26 15:13:24+08:00,['9d4bdaed36220b57576f044467459e12c976002a'],17,26,43,15112906,2,1,1,1,10689
54980f992d528eaf81252451311c490631fd68b7,0,liyang-gmt8,2017-05-26 15:55:07+08:00,['f02558d00ad3d45726aa5704d28f3ff3eff237c5'],1,1,2,15112908,1,,,,10689
dcaacc491cce0839598af66ceea664a1164e12ea,0,liyang-gmt8,2017-05-26 16:14:47+08:00,['54980f992d528eaf81252451311c490631fd68b7'],19,19,38,15112946,19,,,,10689
2a74bf0a677fbd1b83f7fc3f764cfd72db599e34,0,Roger Shi,2017-05-26 18:14:55+08:00,['dcaacc491cce0839598af66ceea664a1164e12ea'],8,6,14,15112960,3,1,1,1,10689
a4814bd651f8373a0137013a17e38dd60a6c1644,0,Roger Shi,2017-05-26 18:14:55+08:00,['2a74bf0a677fbd1b83f7fc3f764cfd72db599e34'],1,1,2,15112962,1,,,,10689
53a83420c10775771779bce2e0cce972111b4834,0,SHAOFENG SHI,2017-05-26 18:29:42+08:00,['a4814bd651f8373a0137013a17e38dd60a6c1644'],0,1,1,15112963,1,0,1,1,10689
12e7d15a0f87312cc03b0a248479be846641a469,0,liyang-gmt8,2017-05-26 18:39:03+08:00,['53a83420c10775771779bce2e0cce972111b4834'],72,46,118,15113081,10,0.066666667,0.066666667,0,10689
f95596040f0d156c549114b1765d0b3d1a156f14,1,hongbin ma,2017-05-26 19:30:45+08:00,['12e7d15a0f87312cc03b0a248479be846641a469'],11078,13766,24844,15137925,694,0,0.816408877,0.736381977,10689
195858461c19d654faf3036df44d4d1f9889654a,1,Roger Shi,2017-05-26 20:41:41+08:00,['f95596040f0d156c549114b1765d0b3d1a156f14'],13764,11076,24840,15162765,694,1,0.183591123,0.263618023,10689
8edff35a2229d2541c1d7549bc00bd08e4a59205,0,hongbin ma,2017-05-27 11:24:39+08:00,['195858461c19d654faf3036df44d4d1f9889654a'],1,1,2,15162767,1,,,,10689
eafbe7325e3ce96e7bcedb4f14f6266d16c6cf3c,1,Roger Shi,2017-05-27 15:24:35+08:00,['8edff35a2229d2541c1d7549bc00bd08e4a59205'],11,25,36,15162803,1,0,0.928571429,0.571428571,10689
3fbf90aed1bd78c1f44f9fd1f37fc34ffa704762,0,hongbin ma,2017-05-27 16:20:07+08:00,['eafbe7325e3ce96e7bcedb4f14f6266d16c6cf3c'],10,24,34,15162837,2,1,1,0,10689
87d5d8db276b590c86c473db5997414285b2d689,0,hongbin ma,2017-05-27 16:20:07+08:00,['3fbf90aed1bd78c1f44f9fd1f37fc34ffa704762'],20,18,38,15162875,2,0,0,1,10689
6bfc6d286de0d8d2fcec43cf655fee7030b18d84,0,hongbin ma,2017-05-27 16:41:52+08:00,['87d5d8db276b590c86c473db5997414285b2d689'],1,2,3,15162878,1,,,,10689
e3a79c8276123bb9fa3a9de9bfc653a81607d392,1,hongbin ma,2017-05-27 17:08:06+08:00,['6bfc6d286de0d8d2fcec43cf655fee7030b18d84'],18,39,57,15162935,3,0,1,1,10689
c341a627de025dc4aa4c20a03c4337f685b476c1,0,鎴?2017-05-27 18:36:33+08:00,['e3a79c8276123bb9fa3a9de9bfc653a81607d392'],3,6,9,15162944,1,0,0,0,10689,
b6b0dc7c846aa56aec9913931fcf7152067fd3c6,1,鎴?2017-05-27 20:20:06+08:00,['c341a627de025dc4aa4c20a03c4337f685b476c1'],2,5,7,15162951,1,0,0,1,10689,
9fafd27e7d2e7f1af9267921d9a6579528b17762,1,Roger Shi,2017-05-27 20:30:38+08:00,['b6b0dc7c846aa56aec9913931fcf7152067fd3c6'],9,16,25,15162976,2,,,,10689
6ce9983f70fb497a50b660289cd11a8714cc731e,1,Roger Shi,2017-05-27 21:11:03+08:00,['9fafd27e7d2e7f1af9267921d9a6579528b17762'],15,297,312,15163288,6,0.462585034,0.414965986,0.911564626,10692
ce97f814f7bfa003011e5176ab891a11558ad009,1,Roger Shi,2017-05-27 21:11:03+08:00,['6ce9983f70fb497a50b660289cd11a8714cc731e'],6,17,23,15163311,1,1,1,0.777777778,10692
dd3715329416bac41e6017157ba2a6bd343ab22a,0,Roger Shi,2017-05-27 21:11:03+08:00,['ce97f814f7bfa003011e5176ab891a11558ad009'],1,1,2,15163313,1,,,,10692
f3b4085fd217af869717160fce7053d9dfd16412,0,Roger Shi,2017-05-27 21:11:03+08:00,['dd3715329416bac41e6017157ba2a6bd343ab22a'],1,1,2,15163315,1,,,,10692
1008bd2cd6ca8d1412b6c68bcfa4cb438abf23ec,0,hongbin ma,2017-05-27 22:25:23+08:00,['f3b4085fd217af869717160fce7053d9dfd16412'],8,8,16,15163331,1,,,,10692
99f08a97a70b207a16a05671f5f611e3f31623b4,1,liyang-gmt8,2017-05-27 22:39:07+08:00,['1008bd2cd6ca8d1412b6c68bcfa4cb438abf23ec'],597,840,1437,15164768,19,0.976958525,1,1,10692
96e8c7f79a099703ff6cf670b90e63ef2b34bae1,0,Dong Li,2017-05-29 00:17:08+08:00,['99f08a97a70b207a16a05671f5f611e3f31623b4'],2,3,5,15164773,1,,,,10692
cfff185c4b7809449d816f137dcb042f9e30067c,0,Dong Li,2017-05-29 00:24:38+08:00,['96e8c7f79a099703ff6cf670b90e63ef2b34bae1'],1,1,2,15164775,1,,,,10692
c1e2143d06dfe7af714e60c0e5daa85b937ca59b,0,hongbin ma,2017-05-29 13:30:38+08:00,['cfff185c4b7809449d816f137dcb042f9e30067c'],4,10,14,15164789,3,,,,10692
052382345a1bd0da6d4ae589e88a11f33b7f9a72,0,hongbin ma,2017-05-30 11:40:16+08:00,['c1e2143d06dfe7af714e60c0e5daa85b937ca59b'],1,16,17,15164806,1,,,,10692
afaa95a099d69105198b73fbf92622975dbf766c,1,nichunen,2017-05-30 13:20:11+08:00,['052382345a1bd0da6d4ae589e88a11f33b7f9a72'],1052,473,1525,15166331,23,0.700617284,0.339506173,0.108024691,10695
361ac0068661ad5627bc590b5174eb2b57c6ea60,0,Dong Li,2017-05-30 14:04:27+08:00,['afaa95a099d69105198b73fbf92622975dbf766c'],4,13,17,15166348,1,1,1,1,10695
2cde33606980d30b169bd11ed6a0dfd5a93af5ff,0,鎴?2017-05-30 14:54:30+08:00,['361ac0068661ad5627bc590b5174eb2b57c6ea60'],11,16,27,15166375,1,1,1,1,10695,
508fc232183bf769d4aa81f19746faeb77aae761,0,hongbin ma,2017-05-30 23:24:16+08:00,['2cde33606980d30b169bd11ed6a0dfd5a93af5ff'],1,1,2,15166377,1,,,,10695
7c381487069d2bcf3adb07b38dc0b0803d13a8b4,1,hongbin ma,2017-05-30 23:47:23+08:00,['508fc232183bf769d4aa81f19746faeb77aae761'],33,296,329,15166706,9,0.142011834,0.680473373,0.857988166,10696
84408d5f0b9d353e87d1f716eecdfc3f5183542d,0,Roger Shi,2017-05-31 17:14:55+08:00,['7c381487069d2bcf3adb07b38dc0b0803d13a8b4'],4,4,8,15166714,3,,,,10696
38308bc4c0383517ace73ad213a9f265ae74756b,0,hongbin ma,2017-06-01 13:11:34+08:00,['84408d5f0b9d353e87d1f716eecdfc3f5183542d'],1,3,4,15166718,1,0,0,0,10696
0c85fb721739490b0ec8f011598b9f9fd5e95bef,0,hongbin ma,2017-06-01 14:34:07+08:00,['38308bc4c0383517ace73ad213a9f265ae74756b'],2,21,23,15166741,2,0.3,0.3,1,10696
de193bcd1c4ef37b0d06a8c11557a64f68fa90ee,1,hongbin ma,2017-06-01 21:37:09+08:00,['0c85fb721739490b0ec8f011598b9f9fd5e95bef'],20,18,38,15166779,4,0.5,0,0,10696
53aafa97e150d8ac9dd4dfc54d6b55b12a70240c,1,Billy Liu,2017-06-02 09:23:57+08:00,['6914f3f409372dc1fd11cd140984aa67d31e5ac4'],8,47,55,15166834,5,0.2,1,0.6,10696
944d3aa1155d299ffe69e194f316cf29777120c8,0,hongbin ma,2017-06-02 14:31:21+08:00,['de193bcd1c4ef37b0d06a8c11557a64f68fa90ee'],2,1,3,15166837,1,,,,10696
58a63073620d16c4bc1aeb0a44db6caadccd3d17,0,liyang-gmt8,2017-06-02 21:25:23+08:00,['944d3aa1155d299ffe69e194f316cf29777120c8'],106,107,213,15167050,9,0,0,0,10696
0a95de0049e5bc2c0707618266141116e6f9a139,1,liyang-gmt8,2017-06-03 21:35:01+08:00,['58a63073620d16c4bc1aeb0a44db6caadccd3d17'],19,11,30,15167080,19,1,1,0,10696
21a17688d351c533a6032f8d314ff41efc00f51d,0,liyang-gmt8,2017-06-03 21:35:01+08:00,['0a95de0049e5bc2c0707618266141116e6f9a139'],1,1,2,15167082,1,,,,10696
216ae0337bcb57ec75fc3f694ec8c13e137572a5,0,liyang-gmt8,2017-06-04 09:12:32+08:00,['21a17688d351c533a6032f8d314ff41efc00f51d'],5,6,11,15167093,1,0,0,1,10696
f6cdd629817d18b60d6885753eb9681cfa4b57f2,0,nichunen,2017-06-04 18:01:03+08:00,['216ae0337bcb57ec75fc3f694ec8c13e137572a5'],101,70,171,15167264,14,0.548387097,1,0.548387097,10696
b6b71e86b87982d0c986999122e4d8eb96187f3d,0,liyang-gmt8,2017-06-04 21:56:06+08:00,['f6cdd629817d18b60d6885753eb9681cfa4b57f2'],0,10,10,15167274,1,,,,10696
25a536734fc46ad71cceae24289733e90d214793,1,liyang-gmt8,2017-06-05 13:16:15+08:00,['b6b71e86b87982d0c986999122e4d8eb96187f3d'],77,121,198,15167472,3,0,0.214285714,0.404761905,10696
c38def7b53dae81f9fde0520b1fb270804dde728,0,Hongbin Ma,2017-06-05 13:22:06+08:00,"['25a536734fc46ad71cceae24289733e90d214793', '53aafa97e150d8ac9dd4dfc54d6b55b12a70240c']",8,49,57,15167529,6,,,,10696
bcb29fc9637b3eee452b3f747caaba7f4088eefe,0,Dong Li,2017-06-05 13:36:34+08:00,['25a536734fc46ad71cceae24289733e90d214793'],0,3,3,15167532,1,,,,10696
2998e11747ad960979355f15c80b3880de7b4111,0,Dong Li,2017-06-05 13:36:34+08:00,['bcb29fc9637b3eee452b3f747caaba7f4088eefe'],4,0,4,15167536,2,,,,10696
c2b2cead62aa75807075762a529868d6632ddc66,0,Hongbin Ma,2017-06-05 14:31:54+08:00,"['2998e11747ad960979355f15c80b3880de7b4111', 'c38def7b53dae81f9fde0520b1fb270804dde728']",8,49,57,15167593,6,,,,10696
791f388db8b92c35c9696718985d0a58190b952b,0,hongbin ma,2017-06-05 20:07:16+08:00,['c2b2cead62aa75807075762a529868d6632ddc66'],1,1,2,15167595,1,,,,10696
a27e484d281758df84c3473edcaea9a2bab1f760,0,luguosheng1314,2017-06-06 13:31:45+08:00,['791f388db8b92c35c9696718985d0a58190b952b'],0,7,7,15167602,2,0.75,0.75,0.75,10696
c7f32b83a1c114014a30d295117dcba1b1dc7e81,1,Li Yang,2017-06-06 16:36:43+08:00,['c2b2cead62aa75807075762a529868d6632ddc66'],28,1133,1161,15168763,21,0.525925926,0.864814815,0.787037037,10705
5e1c9be45fefbfd3ff890e51cdf78c50b0ed8106,1,Li Yang,2017-06-06 16:36:50+08:00,['c7f32b83a1c114014a30d295117dcba1b1dc7e81'],330,384,714,15169477,28,1,0,1,10706
472370158fe5f1ab0f6973b9002b86794dc574ed,0,Roger Shi,2017-06-06 17:44:17+08:00,['a27e484d281758df84c3473edcaea9a2bab1f760'],7,19,26,15169503,1,1,1,1,10706
9ad0ba3ddb391695eddaadca438dc4dfdda60d5f,0,hongbin ma,2017-06-06 18:33:08+08:00,['472370158fe5f1ab0f6973b9002b86794dc574ed'],2,2,4,15169507,1,,,,10706
04e60d05e688bff2a0532b6ebd20169908eeeee5,0,Roger Shi,2017-06-06 20:29:08+08:00,['9ad0ba3ddb391695eddaadca438dc4dfdda60d5f'],1,6,7,15169514,2,1,1,1,10706
2d57a645b0e5d4d2ce3307d4d1e1ddc634e2afa3,0,nichunen,2017-06-06 21:07:22+08:00,['04e60d05e688bff2a0532b6ebd20169908eeeee5'],2,2,4,15169518,1,,,,10706
3c9cdc07f484d4729620f5ea02836aab4416d542,0,hongbin ma,2017-06-07 11:53:37+08:00,['2d57a645b0e5d4d2ce3307d4d1e1ddc634e2afa3'],48,27,75,15169593,7,0,0,0,10706
e836ade6144e8ea30b6822b91af6357389333dd5,1,hongbin ma,2017-06-07 12:55:15+08:00,['3c9cdc07f484d4729620f5ea02836aab4416d542'],273,354,627,15170220,8,0.833333333,0,1,10707
898f545f520f91b8bec7a237fb378e3e65117978,0,hongbin ma,2017-06-07 16:19:27+08:00,['e836ade6144e8ea30b6822b91af6357389333dd5'],3,45,48,15170268,3,1,1,1,10708
c22d8599ad6fd212c66ca682ecdec5e3f6cca2e2,0,luguosheng1314,2017-06-07 18:42:54+08:00,['898f545f520f91b8bec7a237fb378e3e65117978'],2,2,4,15170272,1,,,,10708
e633c7924a9c6ae4f9cccc3e6a8c9872890a58a4,0,luguosheng1314,2017-06-07 19:18:34+08:00,['c22d8599ad6fd212c66ca682ecdec5e3f6cca2e2'],2,2,4,15170276,1,,,,10708
1c4a939e72a923c1378561827086aa79b6fd4b64,0,Billy Liu,2017-06-07 20:56:45+08:00,['5e1c9be45fefbfd3ff890e51cdf78c50b0ed8106'],0,9,9,15170285,1,1,1,1,10708
988783f6450bdec92b14e0e905096c97615bb7e3,0,liyang-gmt8,2017-06-08 09:42:30+08:00,['e633c7924a9c6ae4f9cccc3e6a8c9872890a58a4'],1,8,9,15170294,1,,,,10708
3204281f028113e870f7859bbc98b9d531d64e4f,0,liyang-gmt8,2017-06-08 15:42:08+08:00,['988783f6450bdec92b14e0e905096c97615bb7e3'],21,6,27,15170321,1,,,,10708
07f0c99f90fa028c254a7e2d91e3f286faff4536,1,Billy Liu,2017-06-08 19:13:57+08:00,['1c4a939e72a923c1378561827086aa79b6fd4b64'],5,5,10,15170331,1,,,,10708
7072bd028c6ea4adb819f6534926478dd48b5db7,1,Roger Shi,2017-06-08 21:00:35+08:00,['3204281f028113e870f7859bbc98b9d531d64e4f'],15,35,50,15170381,4,0.058823529,0.294117647,0.882352941,10708
bbeafabab44875a27513281ae639233e47693dda,1,hongbin ma,2017-06-08 21:10:55+08:00,['7072bd028c6ea4adb819f6534926478dd48b5db7'],3,5,8,15170389,2,0,0,0,10708
f77caf7d7f2407132cf05a26d69adf4d44ac07a8,0,nichunen,2017-06-09 13:50:36+08:00,['bbeafabab44875a27513281ae639233e47693dda'],0,5,5,15170394,1,0,0,1,10708
6ab083497851b392908b3f4dcf4208154bcaf03a,0,hongbin ma,2017-06-09 17:25:05+08:00,['f77caf7d7f2407132cf05a26d69adf4d44ac07a8'],0,0,0,15170394,1,,,,10708
f9957f1be3c2cb307974e3e9bd9592f1a1ee651f,0,kangkaisen,2017-06-09 17:31:22+08:00,['07f0c99f90fa028c254a7e2d91e3f286faff4536'],3,6,9,15170403,1,0,0,1,10708
f65e8cb5ef56c71d1b9c76a8b1f8b3162fa80959,1,kangkaisen,2017-06-09 17:41:46+08:00,['f9957f1be3c2cb307974e3e9bd9592f1a1ee651f'],4,3,7,15170410,1,,,,10708
6c2b8341c02474f9838adb079bf8dcc37ebb3848,0,kangkaisen,2017-06-09 17:51:37+08:00,['f65e8cb5ef56c71d1b9c76a8b1f8b3162fa80959'],6,9,15,15170425,1,1,1,1,10708
c9ee26bce8aa546e0adafdd520f05ece793196c4,0,kangkaisen,2017-06-09 18:21:43+08:00,['6c2b8341c02474f9838adb079bf8dcc37ebb3848'],1,1,2,15170427,1,,,,10708
e49af5ffacd51ad1ce9ea227c4a2df73b5722b65,0,Yifan Zhang,2017-06-09 18:35:53+08:00,['6ab083497851b392908b3f4dcf4208154bcaf03a'],1,2,3,15170430,1,,,,10708
c912949b037d590b2c3084ef0ad993d1bd8f0a30,1,kangkaisen,2017-06-09 18:52:15+08:00,['c9ee26bce8aa546e0adafdd520f05ece793196c4'],5,58,63,15170493,5,0,1,1,10709
c14e16e73a186641456b43b487c11462c3befee8,0,hongbin ma,2017-06-09 20:33:14+08:00,['e49af5ffacd51ad1ce9ea227c4a2df73b5722b65'],1,1,2,15170495,1,,,,10709
4bcf96c32170bd0d08073d90fc677d408f0fa074,0,liyang-gmt8,2017-06-09 23:07:38+08:00,['c14e16e73a186641456b43b487c11462c3befee8'],16,12,28,15170523,1,,,,10709
4ac77e527831a18937a17ca9b51b3a7d28af127f,0,Roger Shi,2017-06-09 23:47:08+08:00,['4bcf96c32170bd0d08073d90fc677d408f0fa074'],160,465,625,15171148,8,1,1,1,10712
2db2697fb98bbc6949df16897a0f95ba9333b483,1,hongbin ma,2017-06-11 12:49:16+08:00,['4ac77e527831a18937a17ca9b51b3a7d28af127f'],20,17,37,15171185,5,0,1,0.166666667,10712
3d61e2336325043c66110a6c7368e0e3342ed2fc,0,hongbin ma,2017-06-11 13:56:26+08:00,['2db2697fb98bbc6949df16897a0f95ba9333b483'],1,1,2,15171187,1,,,,10712
a509186f6c1d54776edf34dc961ea50ff37e1c8d,0,鎴?2017-06-11 14:03:01+08:00,['3d61e2336325043c66110a6c7368e0e3342ed2fc'],1,4,5,15171192,1,,,,10712,
3bb93c32d073c10cf9a045e32a25715524324421,0,liyang-gmt8,2017-06-11 14:09:32+08:00,['a509186f6c1d54776edf34dc961ea50ff37e1c8d'],3,4,7,15171199,1,1,1,0,10712
55d26ad17a571216c124bedfb321ecc7ee2f7ade,0,Roger Shi,2017-06-11 15:26:59+08:00,['3bb93c32d073c10cf9a045e32a25715524324421'],279,174,453,15171652,10,1,1,1,10712
1c5cdd89418c5eb67cfc31fca5e3eb4516a23b19,1,Roger Shi,2017-06-11 17:38:55+08:00,['55d26ad17a571216c124bedfb321ecc7ee2f7ade'],6,21,27,15171679,2,1,1,1,10712
02011a63cdde04afbad44ea39d7d9e7c325bee30,0,liyang-gmt8,2017-06-11 18:09:16+08:00,['1c5cdd89418c5eb67cfc31fca5e3eb4516a23b19'],84,46,130,15171809,3,0.612903226,0.612903226,0,10712
5466cea0d61560db6a691bb62f7a3a3f43ad20f4,0,luguosheng1314,2017-06-11 22:13:54+08:00,['02011a63cdde04afbad44ea39d7d9e7c325bee30'],0,1,1,15171810,1,1,1,1,10712
d7cbe1c0d4486a4354ed83b21ea7927c965e57a0,0,liyang-gmt8,2017-06-12 15:12:02+08:00,['5466cea0d61560db6a691bb62f7a3a3f43ad20f4'],6,8,14,15171824,2,1,0,0,10712
0d5e6a6391e6a2eef3c3ce0630b9481792594fec,0,Hongbin Ma,2017-06-12 17:02:31+08:00,['d7cbe1c0d4486a4354ed83b21ea7927c965e57a0'],1,9,10,15171834,2,,,,10712
450246a9d78992655ccad8fa2216ba12afeaec4b,0,Hongbin Ma,2017-06-13 09:37:25+08:00,['0d5e6a6391e6a2eef3c3ce0630b9481792594fec'],36,37,73,15171907,12,1,0,0,10712
0ed5910e8c2a5e37d9a88662bc3ed3261c3017f7,0,Hongbin Ma,2017-06-13 10:19:14+08:00,['450246a9d78992655ccad8fa2216ba12afeaec4b'],43,74,117,15172024,6,0,1,1,10712
5a5c0112e24c44a8c728fb3b1a7234f7700c2ee7,1,Hongbin Ma,2017-06-13 15:12:54+08:00,['0ed5910e8c2a5e37d9a88662bc3ed3261c3017f7'],0,1,1,15172025,1,0,1,1,10712
5fc7a17dad053e8e65d223668393e6eba5bdfae0,0,liyang-gmt8,2017-06-13 15:48:29+08:00,['5a5c0112e24c44a8c728fb3b1a7234f7700c2ee7'],6,14,20,15172045,2,1,1,1,10712
9f99e4004708d6761262d2f87075f66c49b013ab,0,liyang-gmt8,2017-06-13 17:47:02+08:00,['5fc7a17dad053e8e65d223668393e6eba5bdfae0'],11,11,22,15172067,2,,,,10712
4e7751fd81531ef90540a0a3c1e12df3acc620b2,0,liyang-gmt8,2017-06-13 19:16:15+08:00,['9f99e4004708d6761262d2f87075f66c49b013ab'],32,34,66,15172133,1,0,0,1,10712
fa2508f38b703dcd33914847ac27f6593dd43a24,1,Roger Shi,2017-06-13 20:32:09+08:00,['4e7751fd81531ef90540a0a3c1e12df3acc620b2'],99,133,232,15172365,1,0,0.703703704,0.111111111,10712
6f1e48d5ffb764b5d6499fc8dc5fb7aa242bc7ea,0,liyang-gmt8,2017-06-14 10:51:36+08:00,['fa2508f38b703dcd33914847ac27f6593dd43a24'],1,1,2,15172367,1,,,,10712
fa6d1b30d4c2ad60d93a4b069e1cec612537afb9,0,Dong Li,2017-06-14 20:25:41+08:00,['6f1e48d5ffb764b5d6499fc8dc5fb7aa242bc7ea'],36,40,76,15172443,2,,,,10712
b172e0c15802d2e2e085b74f62011f13f55a225a,0,Hongbin Ma,2017-06-14 21:10:24+08:00,['fa6d1b30d4c2ad60d93a4b069e1cec612537afb9'],4,66,70,15172513,4,0.928571429,0.535714286,1,10712
3dbdbf544be012b47d4735a3f5aae0254e97b153,0,luguosheng1314,2017-06-15 12:22:28+08:00,['b172e0c15802d2e2e085b74f62011f13f55a225a'],3,3,6,15172519,1,,0,,10712
27dfdbc65fa68609a8c9fd26c75067d1df4b6753,0,Dong Li,2017-06-15 16:49:07+08:00,['3dbdbf544be012b47d4735a3f5aae0254e97b153'],67,32,99,15172618,3,0,0,0.705882353,10712
1b5837305e9343a3624b50ec460cb88f883236ce,0,Dong Li,2017-06-15 17:43:44+08:00,['27dfdbc65fa68609a8c9fd26c75067d1df4b6753'],4,10,14,15172632,2,0.166666667,0,0.5,10712
56e9fb9e9fa45e9bfb93dd1f4fd0a1027b539c7a,1,liyang-gmt8,2017-06-15 18:18:45+08:00,['1b5837305e9343a3624b50ec460cb88f883236ce'],34,1623,1657,15174289,4,0.290622098,0.551532033,0.413184773,10714
f32165ef3c89ed6a6004a63d28f7227e6cd6d1e6,1,Hongbin Ma,2017-06-15 21:16:29+08:00,['56e9fb9e9fa45e9bfb93dd1f4fd0a1027b539c7a'],17,21,38,15174327,8,0,0,0,10714
51f22e284467f23c8aeeed8ea79e5133ddd1141e,0,Hongbin Ma,2017-06-15 21:17:54+08:00,['f32165ef3c89ed6a6004a63d28f7227e6cd6d1e6'],40,57,97,15174424,5,0,0,0,10714
d659bade9283ecbf99e31285e620e880ef6a06b1,0,liyang-gmt8,2017-06-16 10:11:21+08:00,['51f22e284467f23c8aeeed8ea79e5133ddd1141e'],42,133,175,15174599,5,0.677419355,1,1,10715
1c3329a89894b0825b07d58b7dcbafd983ebc036,0,luguosheng1314,2017-06-16 16:11:45+08:00,['d659bade9283ecbf99e31285e620e880ef6a06b1'],9,18,27,15174626,1,0,0.555555556,0.666666667,10715
15b7a030e6814cf7c4481f09fb92c654dd952b29,0,kangkaisen,2017-06-16 17:54:47+08:00,['c912949b037d590b2c3084ef0ad993d1bd8f0a30'],1,1,2,15174628,1,,,,10715
6182589362b0675db28fa494a0664efd4942e6c3,1,Hongbin Ma,2017-06-16 18:08:41+08:00,['1c3329a89894b0825b07d58b7dcbafd983ebc036'],25,58,83,15174711,4,0.304347826,0.347826087,0,10715
81d26370c8365faf1de2c74cfb2af7869d786a1a,0,Roger Shi,2017-06-16 21:24:14+08:00,['6182589362b0675db28fa494a0664efd4942e6c3'],4,6,10,15174721,1,1,1,0,10715
70ad90c2d5ee643b2febde1857a55c150eb3d9cf,1,鎴?2017-06-16 21:26:56+08:00,['81d26370c8365faf1de2c74cfb2af7869d786a1a'],24,99,123,15174844,2,0.303030303,0.333333333,1,10715,
0ab915dad029440bf8b9c6091958f99d7cadd241,0,Hongbin Ma,2017-06-17 15:47:29+08:00,['70ad90c2d5ee643b2febde1857a55c150eb3d9cf'],6,44,50,15174894,3,0.260869565,1,1,10715
ea06950ae7078ad5c20d334cb14b075868f763b1,0,Hongbin Ma,2017-06-19 13:19:29+08:00,['0ab915dad029440bf8b9c6091958f99d7cadd241'],2,9,11,15174905,1,0,0,1,10715
66dc5418ce9860103a67398256ee11a7e428d4a0,1,Hongbin Ma,2017-06-19 13:23:47+08:00,['ea06950ae7078ad5c20d334cb14b075868f763b1'],9,31,40,15174945,1,0.947368421,0.947368421,1,10715
3beef268dd06fb3f275b4accc92836b44d99b175,0,Hongbin Ma,2017-06-19 13:30:35+08:00,['66dc5418ce9860103a67398256ee11a7e428d4a0'],45,4,49,15174994,3,1,0,0,10715
d67bf453aa791f90edd89f1f7a40e8ce6a399312,0,Luwei-Chen,2017-06-19 15:38:01+08:00,['3beef268dd06fb3f275b4accc92836b44d99b175'],1,1,2,15174996,1,,,,10715
361b58d6dc5fc1add839952ecf1c687662577bc8,1,Ni Chunen,2017-06-19 16:39:05+08:00,['d67bf453aa791f90edd89f1f7a40e8ce6a399312'],13,21,34,15175030,3,0.166666667,1,0.5,10715
4d2a548accba5aa70ad7c2bcc405882a44fe9aae,0,Roger Shi,2017-06-19 18:56:33+08:00,['361b58d6dc5fc1add839952ecf1c687662577bc8'],7,7,14,15175044,1,,,,10715
5a4e465dd8b8fda640db74e595491a2b2dd3c9db,1,Roger Shi,2017-06-20 15:01:11+08:00,['4d2a548accba5aa70ad7c2bcc405882a44fe9aae'],8,14,22,15175066,1,0.333333333,0.333333333,0.5,10715
247f3cd266c77480ac0f8d329e8e7adb617b5de0,1,Roger Shi,2017-06-20 15:28:30+08:00,['5a4e465dd8b8fda640db74e595491a2b2dd3c9db'],45,53,98,15175164,7,1,1,1,10715
73bd0339fea74944e465921ed4283215b01e2c67,1,Hongbin Ma,2017-06-20 17:16:03+08:00,['247f3cd266c77480ac0f8d329e8e7adb617b5de0'],1,16,17,15175181,3,0.571428571,0,1,10715
73faf9917a788a7875691c019501f623e91c8107,0,Roger Shi,2017-06-20 17:58:52+08:00,['73bd0339fea74944e465921ed4283215b01e2c67'],11,9,20,15175201,1,1,1,1,10715
7661ad79b40e9defcd02019f9b55ce0299459dd2,0,Hongbin Ma,2017-06-20 19:14:02+08:00,['73faf9917a788a7875691c019501f623e91c8107'],0,2,2,15175203,1,,,,10715
1e386948ad7381c86891233193a95837b3a47c8b,0,Dong Li,2017-06-20 21:16:21+08:00,['7661ad79b40e9defcd02019f9b55ce0299459dd2'],1,3,4,15175207,1,,,,10715
bf8716919aaf6bf3880b12fc347aa04d98c6dc83,0,Billy(Yiming) Liu,2017-06-21 12:53:52+08:00,['1e386948ad7381c86891233193a95837b3a47c8b'],26,40,66,15175273,2,0.142857143,0.142857143,1,10715
cfac81bffc22e1fb320c9fd6efe8c4e4ffd219a5,1,Hongbin Ma,2017-06-21 16:27:16+08:00,['bf8716919aaf6bf3880b12fc347aa04d98c6dc83'],68,21,89,15175362,3,0,0,0,10715
5749aed4e23c0deecf23bc3971ccadafd861d600,0,Billy Liu,2017-06-21 21:46:01+08:00,['15b7a030e6814cf7c4481f09fb92c654dd952b29'],17,55,72,15175434,3,1,1,0.833333333,10715
57c1d5e03f5cf07ccfb02f7711375c4aa72dd7a6,0,Roger Shi,2017-06-22 17:59:14+08:00,['cfac81bffc22e1fb320c9fd6efe8c4e4ffd219a5'],0,5,5,15175439,2,,,,10715
071f3b92caccf56ed70c15147da32a9ef2538bff,1,Hongbin Ma,2017-06-22 18:05:21+08:00,['57c1d5e03f5cf07ccfb02f7711375c4aa72dd7a6'],13,31,44,15175483,2,1,1,0,10715
cf2f27a3a8ffc41d5d909ff2b4fd38887305fe9d,1,Hongbin Ma,2017-06-22 18:26:32+08:00,['071f3b92caccf56ed70c15147da32a9ef2538bff'],276,318,594,15176077,12,0.958333333,0.791666667,0.8125,10716
401bb0a466cc3618d6801937d076f05b818d31f4,0,Dong Li,2017-06-22 18:31:21+08:00,['cf2f27a3a8ffc41d5d909ff2b4fd38887305fe9d'],2,2,4,15176081,1,,,,10716
0eeceeff43ff64bcd4baa1bc214e1288d7716f9e,0,Hongbin Ma,2017-06-22 20:56:24+08:00,['401bb0a466cc3618d6801937d076f05b818d31f4'],6,26,32,15176113,2,0.909090909,0.909090909,1,10716
3f9d158a13186306b666898ea607768094805559,0,Hongbin Ma,2017-06-22 20:56:24+08:00,['0eeceeff43ff64bcd4baa1bc214e1288d7716f9e'],1,1,2,15176115,1,,,,10716
2d1a47d1be28e47a143c42b2a885c10725228b91,1,Billy Liu,2017-06-22 22:00:43+08:00,['5749aed4e23c0deecf23bc3971ccadafd861d600'],4,8,12,15176127,1,1,1,1,10716
c6ade2f0385f69bd1be90fd57de5e31cffde5f16,1,Hongbin Ma,2017-06-23 19:14:31+08:00,['3f9d158a13186306b666898ea607768094805559'],6,8,14,15176141,3,0,0,0,10716
e6f58d1b8129d3ff024e6cfc1462dccbb65a27d8,0,Hongbin Ma,2017-06-23 19:14:31+08:00,['c6ade2f0385f69bd1be90fd57de5e31cffde5f16'],15,2,17,15176158,2,0.5,0.5,0,10716
22d8faeacdd43d65550e23ce9b8d2bbbb0fd6f96,0,Hongbin Ma,2017-06-23 19:29:08+08:00,['e6f58d1b8129d3ff024e6cfc1462dccbb65a27d8'],0,2,2,15176160,1,0,0,1,10716
3280172b737f85479eb3432fa12c267b477674fd,1,liyang-gmt8,2017-06-23 20:26:46+08:00,['22d8faeacdd43d65550e23ce9b8d2bbbb0fd6f96'],96,111,207,15176367,6,0.857142857,0.857142857,0,10716
ba7bfd6131f3bb296dacbec3066340ffdce5765b,0,Hongbin Ma,2017-06-23 21:26:05+08:00,['3280172b737f85479eb3432fa12c267b477674fd'],2,2,4,15176371,1,,,,10716
81ff9a488cd94e54d605c74f66a8613010e967fa,0,Hongbin Ma,2017-06-23 21:31:32+08:00,['ba7bfd6131f3bb296dacbec3066340ffdce5765b'],30,0,30,15176401,1,0,0,0,10716
0f8c21ba350afee829a5e847d234705d8b2ef559,0,Dong Li,2017-06-25 17:17:49+08:00,['81ff9a488cd94e54d605c74f66a8613010e967fa'],2,6,8,15176409,1,1,1,1,10716
ac725cbd90976652970d7ce41029e7b9d8cc1852,1,Hongbin Ma,2017-06-26 17:24:29+08:00,['0f8c21ba350afee829a5e847d234705d8b2ef559'],2,6,8,15176417,2,0.25,1,1,10716
f79fa389cc4530950a26a2280811c5929d8956e2,0,Hongbin Ma,2017-06-26 20:23:10+08:00,['ac725cbd90976652970d7ce41029e7b9d8cc1852'],5,5,10,15176427,4,,,,10716
6f8a91c0dde0cf09efe3ff5e99533baed50f85c1,0,Hongbin Ma,2017-06-26 20:23:10+08:00,['f79fa389cc4530950a26a2280811c5929d8956e2'],1,7,8,15176435,1,1,1,1,10716
2b07f2915bd052dd8fcee9b896eaedffa6f25b4b,0,shaofengshi,2017-06-27 10:10:34+08:00,['2d1a47d1be28e47a143c42b2a885c10725228b91'],1,1,2,15176437,1,,,,10716
450845c6377c131db801f9eca9c4e062fd67fc0e,1,Hongbin Ma,2017-06-27 11:18:03+08:00,['6f8a91c0dde0cf09efe3ff5e99533baed50f85c1'],34,62,96,15176533,5,1,1,0.85,10716
4f20ba32a8e93c05957d6da8e71b71920828a4f3,0,Hongbin Ma,2017-06-27 18:28:14+08:00,['450845c6377c131db801f9eca9c4e062fd67fc0e'],0,57,57,15176590,11,1,1,1,10716
05631b588c0b49bb156e85dcaf3dca27e79b700c,0,Hongbin Ma,2017-06-27 18:29:11+08:00,['4f20ba32a8e93c05957d6da8e71b71920828a4f3'],23,520,543,15177133,8,0.426380368,0.690184049,1,10718
1acd066cc0e5dc40e9547f25be7fcc992a1dd941,0,GitHub,2017-06-27 19:03:20+08:00,['05631b588c0b49bb156e85dcaf3dca27e79b700c'],3,0,3,15177136,1,,,,10718
a9b0b6ed3de04dbc2395e44dd6f7241c466a3d8b,0,shaofengshi,2017-06-27 19:17:59+08:00,['2b07f2915bd052dd8fcee9b896eaedffa6f25b4b'],0,1,1,15177137,1,0,1,1,10718
3f3cb39e1cfa56231d9a6ede5c8becd5a0c6c6af,0,chenzhx,2017-06-27 21:46:30+08:00,['a9b0b6ed3de04dbc2395e44dd6f7241c466a3d8b'],1,1,2,15177139,1,,,,10718
2bc90f9331bcdc2e64b43cb5025640f95ec4efe1,0,chenzhx,2017-06-28 09:10:33+08:00,['3f3cb39e1cfa56231d9a6ede5c8becd5a0c6c6af'],15,37,52,15177191,3,0.307692308,1,0.653846154,10718
b2fc2c220ba66482447a7631f90363382bcaa422,1,Billy(Yiming) Liu,2017-06-28 11:23:51+08:00,['1acd066cc0e5dc40e9547f25be7fcc992a1dd941'],1,23,24,15177215,2,1,1,1,10718
a0b7e74c16718bb7bab3eb093d6953c393f3444a,0,Hongbin Ma,2017-06-28 14:04:24+08:00,['b2fc2c220ba66482447a7631f90363382bcaa422'],12,31,43,15177258,1,0.3125,0.3125,1,10718
2f084601b938d6051c0fe02a9fc075be549547f0,0,shaofengshi,2017-06-29 10:39:58+08:00,['2bc90f9331bcdc2e64b43cb5025640f95ec4efe1'],2,12,14,15177272,2,1,1,1,10718
69532cd5ff3dc7da9a4670795f1230faa489c389,0,Hongbin Ma,2017-06-29 13:43:13+08:00,"['a0b7e74c16718bb7bab3eb093d6953c393f3444a', '2f084601b938d6051c0fe02a9fc075be549547f0']",198,1499,1697,15178969,50,,,,10718
d61f867ff9fa170e155310edeb03db6059433f2f,0,Hongbin Ma,2017-06-29 13:51:45+08:00,['69532cd5ff3dc7da9a4670795f1230faa489c389'],146,379,525,15179494,11,0.763636364,1,0.881818182,10720
56a0fa5f1d1bebde0297612ee9a4af0354ce672e,0,Hongbin Ma,2017-06-29 13:51:45+08:00,['d61f867ff9fa170e155310edeb03db6059433f2f'],3,0,3,15179497,1,,,,10720
86032971f766a893a28fce9017227999f5defe2d,0,Hongbin Ma,2017-06-29 13:51:45+08:00,['56a0fa5f1d1bebde0297612ee9a4af0354ce672e'],15,46,61,15179558,3,0,0,1,10722
2f7aa456640885dfde622966a6d487579a117931,1,Hongbin Ma,2017-06-29 13:51:45+08:00,['86032971f766a893a28fce9017227999f5defe2d'],23,22,45,15179603,1,1,0,0,10722
d851c51d2c5b41d3d118ff0d5115b37c13dcc1f3,0,shaofengshi,2017-06-29 14:16:10+08:00,['69532cd5ff3dc7da9a4670795f1230faa489c389'],1,1,2,15179605,1,,,,10722
c8acbc620b2e52fd9d2ba3fc6fc478a6418b0f97,0,Hongbin Ma,2017-06-29 14:50:21+08:00,['2f7aa456640885dfde622966a6d487579a117931'],7,13,20,15179625,1,0,1,1,10722
8e1a7d514519bedfbadccd3ba252ca240b56137f,0,鎴?2017-06-29 16:08:04+08:00,['c8acbc620b2e52fd9d2ba3fc6fc478a6418b0f97'],2,4,6,15179631,1,1,1,1,10722,
c490e6cf7c01e0e1443fa93fac681300f96680d6,0,liyang-gmt8,2017-06-29 16:36:57+08:00,['8e1a7d514519bedfbadccd3ba252ca240b56137f'],35,131,166,15179797,4,0.683333333,0.533333333,0.5,10722
7f79083722b634df8f4f814c6a59e0472dbcbe74,0,liyang-gmt8,2017-06-29 16:36:57+08:00,['c490e6cf7c01e0e1443fa93fac681300f96680d6'],2,2,4,15179801,2,,,,10722
8ca0d3217453929d0ac0c3078d9e78e769f852b0,0,liyang-gmt8,2017-06-29 18:05:01+08:00,['7f79083722b634df8f4f814c6a59e0472dbcbe74'],0,16,16,15179817,1,1,1,0,10722
052d6096779d5826ba24517b0b4cc9a45b78bf4a,0,liyang-gmt8,2017-06-29 18:24:43+08:00,['8ca0d3217453929d0ac0c3078d9e78e769f852b0'],1,5,6,15179823,1,1,1,1,10722
a8627e8a9f264cc138124f3825d490463fa58480,0,chenzhx,2017-06-29 19:16:02+08:00,['d851c51d2c5b41d3d118ff0d5115b37c13dcc1f3'],7,10,17,15179840,2,1,1,1,10722
804a1aa3809e67d8e701f147bee794eec19d57e2,0,kangkaisen,2017-06-29 21:03:20+08:00,['a8627e8a9f264cc138124f3825d490463fa58480'],1,6,7,15179847,1,0,0,1,10722
547722d6a35344a5675d6d6ce9b885d8fdc58fc7,0,kangkaisen,2017-06-29 21:13:06+08:00,['804a1aa3809e67d8e701f147bee794eec19d57e2'],1,1,2,15179849,1,,,,10722
772a95f3a0aaafca5260140c461edb053990cfe8,0,kangkaisen,2017-06-29 21:17:45+08:00,['547722d6a35344a5675d6d6ce9b885d8fdc58fc7'],0,2,2,15179851,1,0,0.5,1,10722
a1e055a6b448f7e797ea29bc97e84325b3056638,0,kangkaisen,2017-06-29 21:20:22+08:00,['772a95f3a0aaafca5260140c461edb053990cfe8'],5,2,7,15179858,1,0.5,0.5,0.5,10722
1eb32c3e62d92142b4f7330ac10edd606c870307,0,kangkaisen,2017-06-29 21:23:43+08:00,['a1e055a6b448f7e797ea29bc97e84325b3056638'],4,0,4,15179862,1,1,1,1,10722
40054dd4b263a44bfacf809d614fb9a9d5cce77e,0,Hongbin Ma,2017-06-29 21:33:04+08:00,['052d6096779d5826ba24517b0b4cc9a45b78bf4a'],5,0,5,15179867,1,0,0,0,10722
5eca7f6b59454df4681deb17f361d4708a2affca,1,liyang-gmt8,2017-06-29 23:11:00+08:00,['40054dd4b263a44bfacf809d614fb9a9d5cce77e'],1,1,2,15179869,1,,0,,10722
e7f9dab77f087ce1701974abaae1b8f541448de4,1,liyang-gmt8,2017-06-29 23:11:00+08:00,['5eca7f6b59454df4681deb17f361d4708a2affca'],0,10,10,15179879,2,0.888888889,1,1,10722
2546e00cf2f80b0f8abba9ec3cfe9a0fbce5cb4f,0,liyang-gmt8,2017-06-30 09:42:07+08:00,['e7f9dab77f087ce1701974abaae1b8f541448de4'],0,43,43,15179922,1,0,0.025,0.975,10722
f52eb0c5c667b655d9a20f6226af2a3f5cbe0f4e,0,Hongbin Ma,2017-06-30 13:46:14+08:00,['2546e00cf2f80b0f8abba9ec3cfe9a0fbce5cb4f'],23,24,47,15179969,4,,,,10722
5fb4f3500d12e3ad160b2235667de6131907af57,0,liyang-gmt8,2017-06-30 14:31:24+08:00,['f52eb0c5c667b655d9a20f6226af2a3f5cbe0f4e'],0,1,1,15179970,1,1,1,1,10722
cf1ba9566c2b8ae8aa0f69dc8c27293bee156ab5,1,Hongbin Ma,2017-06-30 16:00:37+08:00,['5fb4f3500d12e3ad160b2235667de6131907af57'],170,116,286,15180256,11,0.742857143,0,0.285714286,10722
6228f886ecf697a41fd658b6eb46dde149cd0e2a,0,liyang-gmt8,2017-06-30 18:20:45+08:00,['cf1ba9566c2b8ae8aa0f69dc8c27293bee156ab5'],10,41,51,15180307,2,0.518518519,0.518518519,1,10722
40e4d627227f584d6212ef588eb3fd658bf159dc,0,Billy Liu,2017-06-30 18:40:10+08:00,['1eb32c3e62d92142b4f7330ac10edd606c870307'],1,1,2,15180309,1,,,,10722
03702f1ecd3a79228468bb7ec6ae25ad369fd65c,0,liyang-gmt8,2017-06-30 19:21:45+08:00,['6228f886ecf697a41fd658b6eb46dde149cd0e2a'],2,1,3,15180312,1,0,0,0,10722
dc232d114c5ad8c50ebed60cf238a0f5b21802a8,0,Hongbin Ma,2017-06-30 19:57:28+08:00,['03702f1ecd3a79228468bb7ec6ae25ad369fd65c'],23,79,102,15180414,1,,,,10722
3ae8ca7cd3796583787e0657edec31b8bdb30ce1,0,liyang-gmt8,2017-06-30 20:29:11+08:00,['dc232d114c5ad8c50ebed60cf238a0f5b21802a8'],31,0,31,15180445,1,0.481481481,0.481481481,0,10722
d91f522904424f59d817bbcde10c47cc68f04d9d,0,Hongbin Ma,2017-06-30 20:57:18+08:00,['3ae8ca7cd3796583787e0657edec31b8bdb30ce1'],18,79,97,15180542,9,0.80952381,1,0.619047619,10722
7002dd864a3f43a2e97a022d1d348773609f446d,1,liyang-gmt8,2017-06-30 21:18:10+08:00,['d91f522904424f59d817bbcde10c47cc68f04d9d'],129,193,322,15180864,14,0.061538462,0.107692308,0.353846154,10722
4f4382df90ddd04a963dda36bcc1093c4b5d77b4,1,liyang-gmt8,2017-06-30 23:45:52+08:00,['7002dd864a3f43a2e97a022d1d348773609f446d'],4,2,6,15180870,2,,,,10722
82b578a561de76e93dcd0b56473bbd229e1292b9,0,Roger Shi,2017-07-01 12:30:52+08:00,['4f4382df90ddd04a963dda36bcc1093c4b5d77b4'],1,1,2,15180872,1,,,,10722
44961356c1f63fd3d91fb2ded3362219e578c279,0,Hongbin Ma,2017-07-03 16:07:49+08:00,"['82b578a561de76e93dcd0b56473bbd229e1292b9', '40e4d627227f584d6212ef588eb3fd658bf159dc']",19,22,41,15180913,7,,,,10722
eab590a03a82a71da3be3b3177d470f2f14c3338,0,Dong Li,2017-07-04 15:20:12+08:00,['44961356c1f63fd3d91fb2ded3362219e578c279'],7,10,17,15180930,2,1,1,1,10722
46d144a027a75d9cab71581da2ec9ad4f674c477,0,chenzhx,2017-07-04 18:14:08+08:00,['44961356c1f63fd3d91fb2ded3362219e578c279'],20,2,22,15180952,7,,,,10722
f74803bb27edb301dce6e93b9eb6a2db32ffd9b6,0,liyang-gmt8,2017-07-04 20:50:02+08:00,['eab590a03a82a71da3be3b3177d470f2f14c3338'],7,12,19,15180971,1,0,0,1,10722
4b66751d4fc9cc77c6bd8f22a899900c66fd31df,0,chenzhx,2017-07-04 21:56:33+08:00,['46d144a027a75d9cab71581da2ec9ad4f674c477'],2,2,4,15180975,2,,,,10722
b0cc68b767098f1b9d7dc714e3129ae1efdfb321,0,chenzhx,2017-07-04 22:01:42+08:00,['4b66751d4fc9cc77c6bd8f22a899900c66fd31df'],12,8,20,15180995,4,0.75,0,0,10722
926a17ae3a4646eeda0cb19abcbb7fe182b174e4,0,chenzhx,2017-07-05 14:14:24+08:00,['b0cc68b767098f1b9d7dc714e3129ae1efdfb321'],1,1,2,15180997,1,,,,10722
ad47dc00e672e8e967d8605d2c8d607ce28225d5,0,Li Yang,2017-07-05 17:02:56+08:00,['926a17ae3a4646eeda0cb19abcbb7fe182b174e4'],0,243,243,15181240,4,1,1,0.871559633,10724
0180aa9dc5545b438358bbf445e67ddae3c5035c,1,Hongbin Ma,2017-07-06 10:21:11+08:00,['f74803bb27edb301dce6e93b9eb6a2db32ffd9b6'],9,10,19,15181259,2,0,0,0,10724
05565236c4523ef5a13619c2b712d224c6b990d5,1,liyang-gmt8,2017-07-06 16:38:37+08:00,['0180aa9dc5545b438358bbf445e67ddae3c5035c'],1,16,17,15181276,1,0,1,1,10724
f8d3c0eed2f04604abcb9e7972634755ac673e2d,0,Li Yang,2017-07-06 17:18:11+08:00,['ad47dc00e672e8e967d8605d2c8d607ce28225d5'],58,40,98,15181374,2,0,0,0.538461538,10724
d509542fca8f5b6e3af6383bb34f6bf33dcf2467,0,Li Yang,2017-07-06 17:37:55+08:00,['f8d3c0eed2f04604abcb9e7972634755ac673e2d'],0,16,16,15181390,1,,,,10724
d2545076062219971f19cb086b334f0a2440a70b,0,kangkaisen,2017-07-07 17:03:42+08:00,['d509542fca8f5b6e3af6383bb34f6bf33dcf2467'],0,10,10,15181400,2,0.875,1,1,10724
f55045c872d25a28578fec729807743a030616a9,1,Hongbin Ma,2017-07-12 10:35:09+08:00,['05565236c4523ef5a13619c2b712d224c6b990d5'],183,252,435,15181835,42,0.032258065,0.903225806,0,10724
1a3527cc29183d29b3b736063127ad373491421b,0,chenzhx,2017-07-12 21:11:30+08:00,['d2545076062219971f19cb086b334f0a2440a70b'],3,3,6,15181841,2,,,,10724
933a5f61492787a1b73efbdf5113ebbf3ce52eb0,1,chenzhx,2017-07-13 11:31:54+08:00,['1a3527cc29183d29b3b736063127ad373491421b'],20,46,66,15181907,4,0,0,1,10724
f65a1dbf3eb1585b4e27104e75e8af1462b3dbc6,0,Roger Shi,2017-07-13 15:36:20+08:00,['f55045c872d25a28578fec729807743a030616a9'],1,27,28,15181935,2,,1,,10725
96154633475ede1ee83cc0a5c9a5b5a62f329fa5,0,chenzhx,2017-07-13 16:10:14+08:00,['933a5f61492787a1b73efbdf5113ebbf3ce52eb0'],18,44,62,15181997,2,0.173913043,0.173913043,1,10725
a9c9715d08dd5fda47054e74bd4d31f0239ba721,0,Li Yang,2017-07-14 16:21:00+08:00,['96154633475ede1ee83cc0a5c9a5b5a62f329fa5'],0,6,6,15182003,2,,,,10726
0dc2cd4665efd32d2f782e53382f86e5dadb720a,0,kangkaisen,2017-07-16 20:00:06+08:00,['a9c9715d08dd5fda47054e74bd4d31f0239ba721'],2,9,11,15182014,1,0,0,0,10726
0e675cf2cbaa9f2bc9a520aaef82443641efb8ca,1,kangkaisen,2017-07-16 20:05:08+08:00,['0dc2cd4665efd32d2f782e53382f86e5dadb720a'],1,6,7,15182021,1,0,0,0,10726
dcd12b0ea561987f30f348b33c2746b605fc5c71,1,Li Yang,2017-07-17 09:51:42+08:00,['0e675cf2cbaa9f2bc9a520aaef82443641efb8ca'],0,37,37,15182058,2,0.869565217,0.869565217,0.869565217,10726
f1247abe9597f112665f44434d668fe55a444a1e,0,Li Yang,2017-07-17 10:12:52+08:00,['dcd12b0ea561987f30f348b33c2746b605fc5c71'],1,6,7,15182065,1,,,,10726
04d3ed5cea32b928bd43a64d1e6f58e983a8d162,0,Hongbin Ma,2017-07-18 14:37:58+08:00,['f65a1dbf3eb1585b4e27104e75e8af1462b3dbc6'],2,4,6,15182071,2,1,1,1,10726
ebc660ddf75b2fda642ec96c55e9e170e36c0fa4,0,chenzhx,2017-07-18 21:26:58+08:00,['04d3ed5cea32b928bd43a64d1e6f58e983a8d162'],1,2,3,15182074,1,0,0,1,10726
6ce341dbdfd02f06fbc9c0013e2638e4a5954879,0,chenzhx,2017-07-19 13:49:17+08:00,['ebc660ddf75b2fda642ec96c55e9e170e36c0fa4'],5,9,14,15182088,4,1,1,1,10726
7145b6d21f983238ab44ffc252756393c4198c82,0,Li Yang,2017-07-19 16:05:50+08:00,['f1247abe9597f112665f44434d668fe55a444a1e'],0,2,2,15182090,1,,,,10726
d48e5eb6905a1bd7e4263e8efef8e451088d326f,0,Dong Li,2017-07-19 21:40:16+08:00,['6ce341dbdfd02f06fbc9c0013e2638e4a5954879'],7,14,21,15182111,1,1,1,1,10726
d44ceb4fac39247710580f63f9be9d325bb12a0b,0,Hongbin Ma,2017-07-20 13:16:21+08:00,['d48e5eb6905a1bd7e4263e8efef8e451088d326f'],1,10,11,15182122,1,0,0,0,10726
1f7980625092a34b157df2cbea21f766a88e8037,0,GitHub,2017-07-21 01:14:00-05:00,['d44ceb4fac39247710580f63f9be9d325bb12a0b'],7,68,75,15182197,4,0.12962963,0.481481481,0.462962963,10726
84ba5615898de99e154d0e13912a82815a0cf02f,0,shaofengshi,2017-07-21 14:16:46+08:00,['7145b6d21f983238ab44ffc252756393c4198c82'],2,54,56,15182253,1,0,1,0.457142857,10726
02e768774784f61e6a55f26daa2e917bb368ef84,0,Hongbin Ma,2017-07-21 14:21:05+08:00,['1f7980625092a34b157df2cbea21f766a88e8037'],2,5,7,15182260,3,0,1,1,10726
eb4ab9cf051c9adb02b78b48e5f93f63806f592f,0,Hongbin Ma,2017-07-21 14:21:05+08:00,['02e768774784f61e6a55f26daa2e917bb368ef84'],3,5,8,15182268,1,1,1,1,10726
fcfce2b64a4c93d87f2d9816fcf9949e4894b998,1,Hongbin Ma,2017-07-21 14:21:05+08:00,['eb4ab9cf051c9adb02b78b48e5f93f63806f592f'],36,61,97,15182365,13,,,,10726
945e4fd46c3eaa3fc92610e3910e2e726697c25b,0,shaofengshi,2017-07-21 14:30:43+08:00,['84ba5615898de99e154d0e13912a82815a0cf02f'],7583,0,7583,15189948,58,,,,10726
65eaaf79fb344bdefc093bd085730a76f56a2395,0,shaofengshi,2017-07-21 14:55:49+08:00,['945e4fd46c3eaa3fc92610e3910e2e726697c25b'],0,0,0,15189948,1,,,,10726
fa7399e7df56b71eb89273bc2bbd9e282f4ac440,0,Hongbin Ma,2017-07-21 16:12:22+08:00,['fcfce2b64a4c93d87f2d9816fcf9949e4894b998'],2,19,21,15189969,2,0,0.4,0.4,10726
c87f87be2599305043e3f97aacba79f9ba4d6787,1,Hongbin Ma,2017-07-21 16:12:22+08:00,['fa7399e7df56b71eb89273bc2bbd9e282f4ac440'],148,224,372,15190341,14,0,0.519230769,0.903846154,10726
9a08beb4f2df04d35a65b7aa76bd08eafb1f1da1,0,Hongbin Ma,2017-07-21 16:12:22+08:00,['c87f87be2599305043e3f97aacba79f9ba4d6787'],2,1,3,15190344,1,,,,10726
61ff3c310c5406a1133ccb287bb6989bd10a5efd,0,shaofengshi,2017-07-22 21:40:45+08:00,['65eaaf79fb344bdefc093bd085730a76f56a2395'],4,7,11,15190355,2,0,0.5,0.5,10726
6ca141a9f2e6cd5bc67fc37ec0fba61b1fc2d49c,0,shaofengshi,2017-07-22 21:55:07+08:00,['61ff3c310c5406a1133ccb287bb6989bd10a5efd'],9,8,17,15190372,1,1,0,1,10726
c0c96bba0ca83b610c266a6ffdedb5728acce820,0,shaofengshi,2017-07-22 22:07:10+08:00,['6ca141a9f2e6cd5bc67fc37ec0fba61b1fc2d49c'],5,7,12,15190384,1,1,1,1,10726
fd4a009d4d0239ed7d20ae872c8725bb5422992c,1,chenzhx,2017-07-22 22:24:23+08:00,['c0c96bba0ca83b610c266a6ffdedb5728acce820'],5,59,64,15190448,3,0.960784314,1,1,10726
2182c07b1ef01bb37d168572600a2f4fe7d39da3,0,shaofengshi,2017-07-23 13:42:15+08:00,['fd4a009d4d0239ed7d20ae872c8725bb5422992c'],7,6,13,15190461,3,0,0,0,10726
f70c18f0b8d5be87f13f1ec65a83b208e6b4367f,0,shaofengshi,2017-07-23 13:42:15+08:00,['2182c07b1ef01bb37d168572600a2f4fe7d39da3'],1,10,11,15190472,1,,,,10726
849fe3c4e3197ccca57778042aa5de9e96cf8cb8,0,kangkaisen,2017-07-23 18:22:15+08:00,['f70c18f0b8d5be87f13f1ec65a83b208e6b4367f'],9,2,11,15190483,1,1,1,1,10726
51b1e092e79e96cbc3d42b98e5d48acd73ec0ae0,0,YIMINGXU,2017-07-24 11:11:05+08:00,['9a08beb4f2df04d35a65b7aa76bd08eafb1f1da1'],2,2,4,15190487,1,,,,10726
38eaa8b85f0ad58dbc68cf4e9d09a17c5c1766e4,0,GitHub,2017-07-23 22:17:03-05:00,['51b1e092e79e96cbc3d42b98e5d48acd73ec0ae0'],12,27,39,15190526,5,1,1,0,10726
14483e0f39ba491439eff3b1e7decce64822a922,0,Hongbin Ma,2017-07-24 17:55:31+08:00,['38eaa8b85f0ad58dbc68cf4e9d09a17c5c1766e4'],11,57,68,15190594,6,1,1,1,10727
dcdbcfb6d7d2cf74eac36a471452cc48166540f7,0,Roger Shi,2017-07-24 18:55:28+08:00,['14483e0f39ba491439eff3b1e7decce64822a922'],3,3,6,15190600,1,,,,10727
ac7f61bdd590f9e2ed2dd21ff1b8c9c5d8bbd93f,0,Hongbin Ma,2017-07-24 21:16:12+08:00,['dcdbcfb6d7d2cf74eac36a471452cc48166540f7'],0,4,4,15190604,1,0,0.75,0,10727
6519b18faa388ed017567cfb33aa094fcee70e8b,0,Billy Liu,2017-07-24 21:25:01+08:00,['849fe3c4e3197ccca57778042aa5de9e96cf8cb8'],0,1,1,15190605,1,1,1,1,10727
9706e30551ed47165ade083e5820d49e6cfa35be,1,Billy Liu,2017-07-24 21:34:03+08:00,['6519b18faa388ed017567cfb33aa094fcee70e8b'],14,11,25,15190630,2,1,0,0,10727
68efbc2d1bfdb1ce53794fd4263f41b287ff5baf,0,Hongbin Ma,2017-07-24 21:44:23+08:00,['ac7f61bdd590f9e2ed2dd21ff1b8c9c5d8bbd93f'],7,24,31,15190661,2,1,1,1,10727
51c6fce10e35f2543e745d6136a1b380e39deef1,1,Hongbin Ma,2017-07-25 11:56:33+08:00,['68efbc2d1bfdb1ce53794fd4263f41b287ff5baf'],6,18,24,15190685,3,0,0,0.727272727,10727
03046dac062b62e41fed3512a084f6235c2a8728,0,YIMINGXU,2017-07-25 13:57:43+08:00,['51c6fce10e35f2543e745d6136a1b380e39deef1'],0,6,6,15190691,1,1,1,1,10727
1b2ceb280f4f7b6e52b7204f730835ea77273be6,0,Roger Shi,2017-07-25 15:32:54+08:00,['03046dac062b62e41fed3512a084f6235c2a8728'],3,9,12,15190703,1,0,1,0,10727
0fd4cc6586e17c47fa1523a87dd58b4834376416,0,Roger Shi,2017-07-25 16:46:55+08:00,['1b2ceb280f4f7b6e52b7204f730835ea77273be6'],0,1,1,15190704,1,0,0,1,10727
818a63c89e4dc195badbe3327c4ae3ad1f4882f7,0,鎴?2017-07-25 18:31:34+08:00,['0fd4cc6586e17c47fa1523a87dd58b4834376416'],1,1,2,15190706,1,,,,10727,
8f47d7d88f8bc25b2dc0b14fb56e234b95f3c6b5,0,luguosheng1314,2017-07-25 18:45:10+08:00,['818a63c89e4dc195badbe3327c4ae3ad1f4882f7'],2,2,4,15190710,2,,,,10727
384007f777186713f9f51bbc8844f1fa458f0d73,0,lidongsjtu,2017-07-25 22:23:06+08:00,['9706e30551ed47165ade083e5820d49e6cfa35be'],0,7583,7583,15198293,58,,,,10785
f8dfdf379099acaa2f40d9abb33b96ce97c6edc5,0,shaofengshi,2017-07-26 09:25:04+08:00,['384007f777186713f9f51bbc8844f1fa458f0d73'],1,1,2,15198295,1,,,,10785
a65d3995bed3faab41ee174f4f16e2df7614761c,0,shaofengshi,2017-07-26 09:25:13+08:00,['f8dfdf379099acaa2f40d9abb33b96ce97c6edc5'],1,1,2,15198297,1,,,,10785
01a62a600c61869ba38565ff95797f6632ab111b,1,Hongbin Ma,2017-07-26 12:22:14+08:00,['8f47d7d88f8bc25b2dc0b14fb56e234b95f3c6b5'],0,6,6,15198303,1,,,,10785
c5129a0749e80bf604ab70a9975bd31ad2cb8d0c,0,GitHub,2017-07-27 10:38:44+08:00,['01a62a600c61869ba38565ff95797f6632ab111b'],10,11,21,15198324,1,1,1,1,10785
5fb195cecbfe34dce041a929a30b99e5585697ef,0,Roger Shi,2017-07-27 13:21:17+08:00,['c5129a0749e80bf604ab70a9975bd31ad2cb8d0c'],1,1,2,15198326,1,,,,10785
6f53bdc54c560d7ebfd129d7962452d65058e4c7,0,shaofengshi,2017-07-27 14:36:31+08:00,['a65d3995bed3faab41ee174f4f16e2df7614761c'],1,1,2,15198328,1,,,,10785
c2feb81e5812116775a256b369da9fe0b5b3afaa,0,Hongbin Ma,2017-07-27 18:47:44+08:00,['5fb195cecbfe34dce041a929a30b99e5585697ef'],1,1,2,15198330,1,,,,10785
c08965f92906bdd6f38efdbe92cbdace570681c7,1,kangkaisen,2017-07-27 20:46:48+08:00,['6f53bdc54c560d7ebfd129d7962452d65058e4c7'],111,188,299,15198629,7,1,0,0.973684211,10786
03bea8d94c2d4e948c45905cdc174fde73648cd8,0,kangkaisen,2017-07-27 20:50:10+08:00,['c08965f92906bdd6f38efdbe92cbdace570681c7'],1,4,5,15198634,2,0,1,1,10786
511de715f9894cfe5f66af4ce9ead7c2331b68fb,0,shaofengshi,2017-07-27 21:53:53+08:00,['03bea8d94c2d4e948c45905cdc174fde73648cd8'],8,9,17,15198651,1,,,,10786
4530c166cafab630caa17e2e9c2fa3bb3935360c,1,Roger Shi,2017-07-28 15:19:45+08:00,['c2feb81e5812116775a256b369da9fe0b5b3afaa'],2,15,17,15198668,2,0.5,0.5,1,10786
b910d8a7791722bac1b4d2ca97edfb0400c8f794,1,GitHub,2017-07-28 03:30:16-05:00,['4530c166cafab630caa17e2e9c2fa3bb3935360c'],101,304,405,15199073,7,0.256756757,0.97972973,0.97972973,10787
a536e7a164e11f39f14311af3ed753e79e1d8d2a,0,chenzhx,2017-07-30 18:06:52+08:00,['511de715f9894cfe5f66af4ce9ead7c2331b68fb'],2,2,4,15199077,1,,,,10787
d2982dc17bdd81ac12cb80d88f4689ef37be6d7f,0,chenzhx,2017-07-30 18:07:24+08:00,['a536e7a164e11f39f14311af3ed753e79e1d8d2a'],10,13,23,15199100,2,0,0,1,10787
b36a5e5b03e781fcf043dd0166d891b8a9458f73,0,YIMINGXU,2017-07-31 02:15:06-05:00,['b910d8a7791722bac1b4d2ca97edfb0400c8f794'],1,1,2,15199102,1,,,,10787
09235b63394255bf02f0556953201a8f3c5ba3e3,1,Hongbin Ma,2017-07-31 15:21:50+08:00,['b36a5e5b03e781fcf043dd0166d891b8a9458f73'],1,1,2,15199104,1,,,,10787
02eea9afea30eb08af6c0a9a050572a70f60ce16,1,Hongbin Ma,2017-07-31 17:24:39+08:00,['09235b63394255bf02f0556953201a8f3c5ba3e3'],13,48,61,15199165,3,0.730769231,0.115384615,1,10787
5021e89a65842d92b75ed0f224fe2276e132a21e,0,YIMINGXU,2017-07-31 05:22:43-05:00,['02eea9afea30eb08af6c0a9a050572a70f60ce16'],3,3,6,15199171,1,,,,10787
a093f1dde752b333ef9d725bc96d8c88fa78b088,0,GitHub,2017-07-31 06:58:38-05:00,['5021e89a65842d92b75ed0f224fe2276e132a21e'],2,2,4,15199175,1,,,,10787
33d8926eb1a3a8a87214c0e7c53af02ca99b1be3,0,Hongbin Ma,2017-07-31 22:01:21+08:00,['a093f1dde752b333ef9d725bc96d8c88fa78b088'],2,8,10,15199185,1,0,1,1,10787
29d3dc37e576b9d927dae6aad3446dcdfd14c565,0,Hongbin Ma,2017-08-01 10:21:45+08:00,['d2982dc17bdd81ac12cb80d88f4689ef37be6d7f'],54,2,56,15199241,1,1,0,0.542857143,10787
631fe416cb60223c5f96325fda40abbea24cff3b,0,Hongbin Ma,2017-08-01 10:40:27+08:00,['33d8926eb1a3a8a87214c0e7c53af02ca99b1be3'],18,18,36,15199277,1,0,0,0,10787
6a570a13862751a1a390a3d3c3d8fa3f2f57f43e,1,chenzhx,2017-08-02 00:06:22+08:00,['29d3dc37e576b9d927dae6aad3446dcdfd14c565'],1,2,3,15199280,1,,,,10787
5d3cf61c85199a49d51bb2f4de2042b1f848e40d,0,Zhong,2017-08-02 14:09:36+08:00,['6a570a13862751a1a390a3d3c3d8fa3f2f57f43e'],10,8,18,15199298,1,,,0,10787
5a53564976856dac32f71983d547b6f5682ee441,0,GitHub,2017-08-02 04:26:43-05:00,['631fe416cb60223c5f96325fda40abbea24cff3b'],5,19,24,15199322,1,0.636363636,0.636363636,0.636363636,10787
928313e08a134ed204a88a07496bd8047cc3d405,1,Hongbin Ma,2017-08-02 18:09:42+08:00,['5a53564976856dac32f71983d547b6f5682ee441'],6246,6434,12680,15212002,6,0.028571429,0,0.871428571,10787
ffebb83d20f9e4f73e19510ec77e6610526f562a,0,Roger Shi,2017-08-03 16:48:56+08:00,['928313e08a134ed204a88a07496bd8047cc3d405'],1,1,2,15212004,1,,,,10787
be75b04541c1d2334ded448451c03b10fbd1f8fd,0,Dong Li,2017-08-04 18:54:05+08:00,['ffebb83d20f9e4f73e19510ec77e6610526f562a'],6,11,17,15212021,2,1,1,1,10787
296c797a37ee4e5f12ed284c8704376d08c43628,0,shaofengshi,2017-08-05 10:40:39+00:00,['5d3cf61c85199a49d51bb2f4de2042b1f848e40d'],1,1,2,15212023,1,,,,10787
b63ea43566433ee0c861f4ad9ac8ca2cd133c798,0,shaofengshi,2017-08-05 11:46:02+00:00,['296c797a37ee4e5f12ed284c8704376d08c43628'],1,1,2,15212025,1,,,,10787
5c3b40be166d837d15df677ee23b9a56f974b799,0,Hongbin Ma,2017-08-07 17:27:38+08:00,['be75b04541c1d2334ded448451c03b10fbd1f8fd'],2,370,372,15212397,8,,,,10794
239f01651b7b70b59d58086ad7b83b35777f2693,1,liyang-gmt8,2017-08-07 18:31:56+08:00,['5c3b40be166d837d15df677ee23b9a56f974b799'],118,205,323,15212720,5,0.388059701,0.865671642,0.805970149,10794
bd73b548eb08df83958881b972e8aa99f64422cd,0,Hongbin Ma,2017-08-07 20:15:45+08:00,['239f01651b7b70b59d58086ad7b83b35777f2693'],737,1,738,15213458,12,0.539156627,0.352409639,0,10794
4f16f1cdc61f9bd01edad27151abff1bf4aa3596,0,shaofengshi,2017-08-07 22:34:00+08:00,['b63ea43566433ee0c861f4ad9ac8ca2cd133c798'],0,97,97,15213555,4,,,,10798
714b225122bd6686ef6e1c1d7075bc662b5a6eb2,0,shaofengshi,2017-08-07 22:34:09+08:00,['4f16f1cdc61f9bd01edad27151abff1bf4aa3596'],2,2,4,15213559,1,,,,10798
659eeaedd571c837df3beae44456dadde3036c3d,0,kangkaisen,2017-08-09 19:59:58+08:00,['714b225122bd6686ef6e1c1d7075bc662b5a6eb2'],5,35,40,15213599,3,0,0,0,10799
8ab351b6e29faa4477cb4d184dd4080cc71c9792,0,Hongbin Ma,2017-08-10 14:23:43+08:00,['bd73b548eb08df83958881b972e8aa99f64422cd'],2,4,6,15213605,1,,,,10799
841f168f3773e8114305937ed569f8638ef01a03,0,Hongbin Ma,2017-08-10 14:24:27+08:00,['8ab351b6e29faa4477cb4d184dd4080cc71c9792'],1,1,2,15213607,1,,,,10799
f894d23b3b448770db1f587f68d7a426fa98aa8d,0,Hongbin Ma,2017-08-10 14:24:44+08:00,['841f168f3773e8114305937ed569f8638ef01a03'],1,1,2,15213609,1,,,,10799
7d475840570a26b71ae33689ae73686566c2af5f,1,liyang-gmt8,2017-08-10 16:38:55+08:00,['f894d23b3b448770db1f587f68d7a426fa98aa8d'],323,357,680,15214289,16,0.80952381,0.80952381,0.80952381,10800
8cb52b215b8c5cb4f05ceda06addde58c3395f86,0,SHAOFENG SHI,2017-08-10 19:02:07+08:00,['7d475840570a26b71ae33689ae73686566c2af5f'],85,48,133,15214422,1,1,1,0,10800
d384e8750b4063351e3e5f6cf3e9eec542eaa266,0,Hongbin Ma,2017-08-11 10:24:06+08:00,['8cb52b215b8c5cb4f05ceda06addde58c3395f86'],0,2,2,15214424,2,1,1,0.5,10800
929f229daf8d43baafe4eba0365d6326918e7d48,0,YIMINGXU,2017-08-10 22:02:32-05:00,['d384e8750b4063351e3e5f6cf3e9eec542eaa266'],3,3,6,15214430,1,,,,10800
982d36df68f65c99e5fdcb16277a8a55342c8686,0,Dong Li,2017-08-11 11:05:38+08:00,['929f229daf8d43baafe4eba0365d6326918e7d48'],1,1,2,15214432,1,,,,10800
5d2a14b03714af1ab462d219a5ed0118628da3f3,0,liyang-gmt8,2017-08-11 12:26:12+08:00,['982d36df68f65c99e5fdcb16277a8a55342c8686'],11,4,15,15214447,2,0.5,0.5,0.5,10800
2f6c54b92aff46567c3a51db383498ac1c635d13,1,Hongbin Ma,2017-08-11 16:21:36+08:00,['5d2a14b03714af1ab462d219a5ed0118628da3f3'],22,19,41,15214488,5,0,0,0,10800
0153263d3bbacfebd306d53f4de67f48fed0bcd0,0,Dong Li,2017-08-11 16:44:22+08:00,['2f6c54b92aff46567c3a51db383498ac1c635d13'],2,44,46,15214534,2,1,1,1,10801
617281de3e1c32471eec81bc05c24f0e2055b339,0,shaofengshi,2017-08-13 14:52:14+08:00,['659eeaedd571c837df3beae44456dadde3036c3d'],0,1,1,15214535,1,,,,10801
4b2865389e0691b8a3474dd14f6f6390540c86d7,0,shaofengshi,2017-08-13 19:24:19+08:00,['617281de3e1c32471eec81bc05c24f0e2055b339'],0,62,62,15214597,1,1,1,1,10802
5008866f41efd13ce5abaf8cc19c09919fe698dd,0,Roger Shi,2017-08-13 22:39:54+08:00,['0153263d3bbacfebd306d53f4de67f48fed0bcd0'],0,2,2,15214599,1,0,0,1,10802
c8bab3df33edd5dc146a02f94caccd0d810b68bd,0,Roger Shi,2017-08-14 09:35:09+08:00,['5008866f41efd13ce5abaf8cc19c09919fe698dd'],193,187,380,15214979,7,0,0.85,1,10802
2eca43c40723cce0f12a56a1299894bbf5803d03,0,GitHub,2017-08-14 05:05:31-05:00,['c8bab3df33edd5dc146a02f94caccd0d810b68bd'],11,23,34,15215013,3,0,0,1,10802
c487fe4990473afa11d30a2e16ceb133e3f25b6d,1,luguosheng1314,2017-08-16 12:05:20+08:00,['2eca43c40723cce0f12a56a1299894bbf5803d03'],64,63,127,15215140,1,,,,10802
fa7eb692b33218fba463f7839c00663bd83892f3,0,Hongbin Ma,2017-08-16 14:13:36+08:00,['c487fe4990473afa11d30a2e16ceb133e3f25b6d'],1,1,2,15215142,1,,,,10802
7a9f74c8a0f70480f40c6e88e0aeb71824fd7884,1,Hongbin Ma,2017-08-16 16:04:09+08:00,['fa7eb692b33218fba463f7839c00663bd83892f3'],277,440,717,15215859,26,0.6328125,1,0.9375,10803
9a0c20e3646dbb9fff2afacd2402243df7882f42,0,chenzhx,2017-08-17 17:00:20+08:00,['4b2865389e0691b8a3474dd14f6f6390540c86d7'],6,3,9,15215868,1,1,1,0,10803
0558d8045cb985a61e6abb5ee88df8faccc92f12,0,shaofengshi,2017-08-17 22:02:35+08:00,['9a0c20e3646dbb9fff2afacd2402243df7882f42'],22,22,44,15215912,22,,,,10803
bb3b2fd6a23b002b2911003d6128df8bcf96242d,0,shaofengshi,2017-08-17 22:03:20+08:00,['0558d8045cb985a61e6abb5ee88df8faccc92f12'],1,1,2,15215914,1,,,,10803
ef148601da606a241e8233e25881bb3cc57f5e79,0,shaofengshi,2017-08-18 15:27:44+08:00,['bb3b2fd6a23b002b2911003d6128df8bcf96242d'],84,47,131,15216045,1,0.833333333,1,0,10803
72a4f0f8c0b8b4ad440bf1f0b5ce35e687edd858,0,Dong Li,2017-08-18 16:24:43+08:00,['7a9f74c8a0f70480f40c6e88e0aeb71824fd7884'],2,2,4,15216049,2,,,,10803
5b942267fc26175199b4b26229e54def6728ce87,0,kangkaisen,2017-08-19 13:30:36+08:00,['ef148601da606a241e8233e25881bb3cc57f5e79'],38,292,330,15216379,16,0.461077844,0.149700599,0.77245509,10803
6ec099b31b448189930187612aa5be782f910d51,1,Roger Shi,2017-08-19 21:09:59+08:00,['72a4f0f8c0b8b4ad440bf1f0b5ce35e687edd858'],7,41,48,15216427,1,0.95,1,0.35,10803
c4f125c4750ef8d0c754d7a00c2ad100c6999cf6,1,Roger Shi,2017-08-20 14:06:28+08:00,['6ec099b31b448189930187612aa5be782f910d51'],0,13,13,15216440,2,0.375,0.375,0.375,10803
bdb3a5fde7635ab3601abdaf6c2e2653ccd5ac60,0,Li Yang,2017-08-20 17:24:35+08:00,['5b942267fc26175199b4b26229e54def6728ce87'],11,2,13,15216453,1,0,0,0,10803
8073957873e114a2a1152f73e4942be66730761e,0,Li Yang,2017-08-20 17:30:48+08:00,['bdb3a5fde7635ab3601abdaf6c2e2653ccd5ac60'],24,81,105,15216558,3,1,1,0,10803
15d6063cf982ce3f0299631962f6582cec246460,0,chenzhx,2017-08-21 13:35:51+08:00,['8073957873e114a2a1152f73e4942be66730761e'],1,1,2,15216560,1,,,,10803
1c8de93c33cdcb4b032409d0fea37885014b3cab,0,Yifan Zhang,2017-08-21 13:48:25+08:00,['c4f125c4750ef8d0c754d7a00c2ad100c6999cf6'],293,292,585,15217145,2,,,,10803
8906d133f430254ed4a8c1f6f7b989b0c4ca2c09,0,GitHub,2017-08-21 02:08:08-05:00,['1c8de93c33cdcb4b032409d0fea37885014b3cab'],2,8,10,15217155,1,0,1,0,10803
aed840f9343e3e62a711517900c357a091e75619,1,Hongbin Ma,2017-08-21 22:55:59+08:00,['8906d133f430254ed4a8c1f6f7b989b0c4ca2c09'],433,861,1294,15218449,45,0.243654822,0.710659898,0.258883249,10805
6e28a020309796289d892a704f6a7f62cc7512c9,0,Hongbin Ma,2017-08-21 22:55:59+08:00,['aed840f9343e3e62a711517900c357a091e75619'],312,150,462,15218911,10,0.948148148,0.288888889,0.022222222,10805
788c731337cf76aab14ac388fa06782943cdf711,0,Hongbin Ma,2017-08-21 22:55:59+08:00,['6e28a020309796289d892a704f6a7f62cc7512c9'],2,20,22,15218933,4,0,0,1,10807
909628ff6d128639eb813d616fe7281295378619,0,Hongbin Ma,2017-08-21 22:55:59+08:00,['788c731337cf76aab14ac388fa06782943cdf711'],3,8,11,15218944,1,0,0,1,10807
aaf94169873b0622300ebebb1f5d3bc707a507c2,0,Billy Liu,2017-08-22 11:23:41+08:00,['15d6063cf982ce3f0299631962f6582cec246460'],70,136,206,15219150,5,1,1,0,10809
46cd8813902881912aaed9969151092b48f49d57,0,Hongbin Ma,2017-08-22 11:41:31+08:00,['909628ff6d128639eb813d616fe7281295378619'],3,53,56,15219206,2,,,,10809
a3d42f11924c734b40a7b61fbf6f2f8bac3caa88,1,Hongbin Ma,2017-08-22 16:00:14+08:00,['46cd8813902881912aaed9969151092b48f49d57'],11,54,65,15219271,2,1,1,1,10809
68ae79a61c03763c0e21f27fcb79b52db849d306,0,Hongbin Ma,2017-08-22 16:00:14+08:00,['a3d42f11924c734b40a7b61fbf6f2f8bac3caa88'],9,41,50,15219321,2,0.111111111,1,1,10809
a637d2a0cea88d85a372bc449269a50a1502471f,1,鎴?2017-08-22 16:46:53+08:00,['68ae79a61c03763c0e21f27fcb79b52db849d306'],2,4,6,15219327,2,0.25,0.25,1,10809,
891caabd7563b230855d251f4896fdfa9c09d0cd,0,Hongbin Ma,2017-08-22 17:27:57+08:00,['aaf94169873b0622300ebebb1f5d3bc707a507c2'],19,0,19,15219346,1,,,,10809
f26b1abf7cc3052dae937713f2ebec083e185ae2,0,Hongbin Ma,2017-08-22 17:39:02+08:00,['a637d2a0cea88d85a372bc449269a50a1502471f'],1,2,3,15219349,1,0,0,1,10809
d85f6ab0130e3c1962c9dc770e06f178d3d85c32,1,Roger Shi,2017-08-22 17:55:53+08:00,['f26b1abf7cc3052dae937713f2ebec083e185ae2'],8,66,74,15219423,10,0,0,0.55,10809
4316cfdbe21cbab5764c2bcb6a45010bef434bf3,1,shaofengshi,2017-08-22 20:52:45+08:00,['891caabd7563b230855d251f4896fdfa9c09d0cd'],11,15,26,15219449,7,,,,10809
8e078847a42b4f7853a2c1a75afa405c09c4ea7b,1,Hongbin Ma,2017-08-23 13:49:23+08:00,['d85f6ab0130e3c1962c9dc770e06f178d3d85c32'],2,1957,1959,15221408,26,0.570332481,0.823529412,0.891304348,10830
cd9a515286eb7ba0553339cfb98d86ea10377a90,0,Hongbin Ma,2017-08-24 10:30:24+08:00,['8e078847a42b4f7853a2c1a75afa405c09c4ea7b'],1,1,2,15221410,1,,,,10830
d873ca13aa67a90a99b66d99659ca571a3ab977f,0,Hongbin Ma,2017-08-24 11:27:44+08:00,['cd9a515286eb7ba0553339cfb98d86ea10377a90'],38,179,217,15221627,2,0.408695652,1,1,10830
d059c05e7a064c6c6bc861fb3e399985ed968177,0,Roger Shi,2017-08-24 15:46:12+08:00,['d873ca13aa67a90a99b66d99659ca571a3ab977f'],1,1,2,15221629,1,,,,10830
1fff42146aa539b599802f9b19de28dc87d05fad,0,Roger Shi,2017-08-25 17:36:24+08:00,['d059c05e7a064c6c6bc861fb3e399985ed968177'],60,42,102,15221731,3,,,,10830
ff4f634fe5ad5f96b1506a2ab368eb701f62c5dc,1,鎴?2017-08-26 00:19:08+08:00,['1fff42146aa539b599802f9b19de28dc87d05fad'],15,26,41,15221772,1,0.454545455,0.636363636,0.909090909,10830,
a1c234a9afbc5a30306f4275127649f980ab75bd,1,Hongbin Ma,2017-08-27 15:08:18+08:00,['4316cfdbe21cbab5764c2bcb6a45010bef434bf3'],178,267,445,15222217,7,0.431372549,1,0.803921569,10830
e2e0102c4bac289c1e0d61226794030fd93cb145,1,GitHub,2017-08-27 18:51:50+08:00,['ff4f634fe5ad5f96b1506a2ab368eb701f62c5dc'],2,53,55,15222272,2,0,1,1,10831
28a07ebd3983c325c64c0642e7dedbf32c284f39,0,GitHub,2017-08-27 18:55:03+08:00,['e2e0102c4bac289c1e0d61226794030fd93cb145'],9,28,37,15222309,4,0,0,0,10831
3200d6a148d4368801e415f6ae969bbab7c7345e,1,Hongbin Ma,2017-08-28 10:42:57+08:00,['28a07ebd3983c325c64c0642e7dedbf32c284f39'],2,11,13,15222322,1,0.142857143,0.142857143,1,10831
fad75c93f42d252dd1ee2ec7b03df716c15fb2f4,0,Hongbin Ma,2017-08-28 12:25:12+08:00,['3200d6a148d4368801e415f6ae969bbab7c7345e'],4,9,13,15222335,1,0,0.75,0.25,10831
b778f33af3718fd1bf5f705b81104f424803fe78,0,Hongbin Ma,2017-08-28 13:50:36+08:00,['fad75c93f42d252dd1ee2ec7b03df716c15fb2f4'],82,86,168,15222503,15,0.375,1,1,10831
727920b4d3642aaa3657d90b7f3dce7dcdd68fe2,1,Hongbin Ma,2017-08-28 14:41:26+08:00,['a1c234a9afbc5a30306f4275127649f980ab75bd'],19,24,43,15222546,1,1,1,0,10831
74c904e4eedc224b07c9b6463ab0b63faddd4a21,0,Hongbin Ma,2017-08-28 15:25:27+08:00,['b778f33af3718fd1bf5f705b81104f424803fe78'],7,135,142,15222688,3,0.304347826,1,1,10832
480592d49b8479d4cbba74e889eb5e256d9b2ef8,0,Roger Shi,2017-08-28 15:47:38+08:00,['74c904e4eedc224b07c9b6463ab0b63faddd4a21'],2,2,4,15222692,2,,,,10832
dbecb9b84bc90049acb3ef314128ac71f3516731,1,SHAOFENG SHI,2017-08-28 16:02:43+08:00,['480592d49b8479d4cbba74e889eb5e256d9b2ef8'],26,172,198,15222890,8,0.081818182,0.645454545,0.890909091,10832
81e9f573fae2af9511ac6004f69101598fc7a71a,0,Hongbin Ma,2017-08-29 10:36:10+08:00,['dbecb9b84bc90049acb3ef314128ac71f3516731'],135,7,142,15223032,3,0.695652174,0,0,10832
487a854bfece7b9fc72b0118a40d51100eca8463,1,Hongbin Ma,2017-08-29 10:36:10+08:00,['81e9f573fae2af9511ac6004f69101598fc7a71a'],28,9,37,15223069,4,1,1,1,10832
28ac7d9aeeeb8818207a363231b1354652f9aa8d,0,Hongbin Ma,2017-08-29 17:40:33+08:00,['487a854bfece7b9fc72b0118a40d51100eca8463'],11,11,22,15223091,4,,,,10832
87f1732b0a26191122788baaa2fc9d97c96210da,0,Roger Shi,2017-08-30 16:02:26+08:00,['28ac7d9aeeeb8818207a363231b1354652f9aa8d'],0,54,54,15223145,1,0,0.058823529,0.941176471,10832
1eb3617cf1cf50da16d5f86b4f922b3e8925de4b,0,Roger Shi,2017-08-30 16:02:26+08:00,['87f1732b0a26191122788baaa2fc9d97c96210da'],1,27,28,15223173,3,1,1,1,10833
47822891332aef146ae3c2b5e3adc98c23024770,1,鎴?2017-08-30 17:40:03+08:00,['1eb3617cf1cf50da16d5f86b4f922b3e8925de4b'],46,459,505,15223678,7,0.345070423,0.894366197,0.950704225,10836,
d62cb58bde55766dbe87bbad29953dd1243c2014,0,Roger Shi,2017-08-30 18:13:52+08:00,['47822891332aef146ae3c2b5e3adc98c23024770'],2,60,62,15223740,4,0.727272727,0.727272727,0.681818182,10836
a4aeb77890577e46300bc702c1117bf542081cc9,0,Roger Shi,2017-08-30 18:13:52+08:00,['d62cb58bde55766dbe87bbad29953dd1243c2014'],13,6,19,15223759,1,1,1,0,10836
068baf6b3ec13fe6e68e9a41593dcd139b4a8597,0,Roger Shi,2017-08-31 10:37:32+08:00,['a4aeb77890577e46300bc702c1117bf542081cc9'],141,145,286,15224045,10,1,0.375,0.8125,10837
b50030da4cd64d424a82e9d2b752c00917e8e681,1,Hongbin Ma,2017-08-31 21:33:14+08:00,"['068baf6b3ec13fe6e68e9a41593dcd139b4a8597', '727920b4d3642aaa3657d90b7f3dce7dcdd68fe2']",576,1692,2268,15226313,111,,,,10837
32d346b4cd619a38461a27115fbef2bd44f28372,0,Hongbin Ma,2017-08-31 22:41:20+08:00,['b50030da4cd64d424a82e9d2b752c00917e8e681'],6,13,19,15226332,1,0,0,1,10837
363f858b890ea04c87ee7b081fc74805766e0b93,0,Hongbin Ma,2017-08-31 22:43:36+08:00,['32d346b4cd619a38461a27115fbef2bd44f28372'],60,2,62,15226394,4,0.272727273,0.272727273,0.318181818,10837
7f47b51a3ebe0ccd0283fa79995bfb02f4c3919e,1,鎴?2017-09-01 14:43:21+08:00,['363f858b890ea04c87ee7b081fc74805766e0b93'],5,6,11,15226405,3,,,,10837,
7a47e9479f7a8c53d284d3bd95cf11b145cf9c36,0,Billy Liu,2017-09-01 17:37:31+08:00,['363f858b890ea04c87ee7b081fc74805766e0b93'],0,2,2,15226407,1,0,0,1,10837
4b3a44b92442e9be056baa953e2543078ea0ec20,1,Hongbin Ma,2017-09-01 17:51:08+08:00,['7f47b51a3ebe0ccd0283fa79995bfb02f4c3919e'],172,128,300,15226707,19,0.358974359,0,0,10837
a54f016aff86e93652e7df0a401c270ca6795d13,0,Hongbin Ma,2017-09-01 17:53:18+08:00,['4b3a44b92442e9be056baa953e2543078ea0ec20'],0,4,4,15226711,1,1,1,1,10837
1004a853225503e00f48a27949d7e09109e937db,0,Billy Liu,2017-09-01 18:10:00+08:00,['7a47e9479f7a8c53d284d3bd95cf11b145cf9c36'],5,6,11,15226722,1,0,0,1,10837
75fbdcffb0366cb555783a229d1a514d010abd87,1,Hongbin Ma,2017-09-02 18:47:28+08:00,['a54f016aff86e93652e7df0a401c270ca6795d13'],653,965,1618,15228340,48,0.961538462,1,1,10840
34596d3553a7694738f48b10d38384c12cb535a3,0,Li Yang,2017-09-03 09:22:34+08:00,"['75fbdcffb0366cb555783a229d1a514d010abd87', '1004a853225503e00f48a27949d7e09109e937db']",32,12,44,15228384,5,,,,10840
78543d6e970cfb9dc85bcc48775681afcdb1c0e9,0,kangkaisen,2017-09-03 17:53:37+08:00,['34596d3553a7694738f48b10d38384c12cb535a3'],1,1,2,15228386,1,,,,10840
ae311b10e29f64c519140e4c02d903987981733a,1,Li Yang,2017-09-03 17:57:25+08:00,['78543d6e970cfb9dc85bcc48775681afcdb1c0e9'],1,5,6,15228392,1,0,1,0,10840
3f11a59bd6104231596a0db612c08630cfa96bb5,1,Roger Shi,2017-09-03 18:10:12+08:00,['34596d3553a7694738f48b10d38384c12cb535a3'],10,106,116,15228508,8,0.95,0.95,1,10844
2e4474e46cb563096635d0b749ee023e0fcb66d0,0,Li Yang,2017-09-03 18:38:15+08:00,['ae311b10e29f64c519140e4c02d903987981733a'],54,90,144,15228652,1,0,1,0.931034483,10844
1da269d5912aed83eebb93a2e4429fd025321386,0,Li Yang,2017-09-03 19:51:04+08:00,['2e4474e46cb563096635d0b749ee023e0fcb66d0'],52,54,106,15228758,1,,,,10844
14058bda896f7670c333ca14f614e7cdab0ce62c,0,Li Yang,2017-09-03 20:15:58+08:00,['1da269d5912aed83eebb93a2e4429fd025321386'],4,2,6,15228764,1,0,0,0,10844
520f6279c560f457c1b7fe1173532959fcee5c6c,0,Li Yang,2017-09-03 20:46:58+08:00,['14058bda896f7670c333ca14f614e7cdab0ce62c'],2,8,10,15228774,4,1,1,1,10844
adb04cda694e6f9d534ab32adb57ed97f080ced0,1,Roger Shi,2017-09-03 22:27:39+08:00,['3f11a59bd6104231596a0db612c08630cfa96bb5'],0,14,14,15228788,2,1,1,1,10844
ea10b6c4d8449a1d4b4ad40e24b760b4cc291708,0,liyang-gmt8,2017-09-04 17:26:22+08:00,['adb04cda694e6f9d534ab32adb57ed97f080ced0'],0,26,26,15228814,1,,,,10845
af4b5a552fe540c0e77389a6c1ecaa23dabb5375,0,Roger Shi,2017-09-04 18:43:30+08:00,['ea10b6c4d8449a1d4b4ad40e24b760b4cc291708'],8,8,16,15228830,2,,,,10845
b1b3c22f060e5399808290984f0a9911dea55331,0,GitHub,2017-09-05 09:43:09+08:00,['af4b5a552fe540c0e77389a6c1ecaa23dabb5375'],0,0,0,15228830,21,,,,10845
26c03fe26b665adcf31cefb574f7c389a4daa0a5,1,Hongbin Ma,2017-09-05 10:29:20+08:00,['b1b3c22f060e5399808290984f0a9911dea55331'],156,399,555,15229385,13,0.488549618,0.595419847,0.702290076,10847
ecf4819eb39b8d22ea82c70d6679200c0b2602bb,1,Hongbin Ma,2017-09-05 16:58:30+08:00,['26c03fe26b665adcf31cefb574f7c389a4daa0a5'],41,121,162,15229547,6,0.264705882,0.911764706,0.382352941,10848
2d939a59fdf385bb20b4724e8a6f87879e26bdd7,1,Roger Shi,2017-09-05 21:14:02+08:00,['ecf4819eb39b8d22ea82c70d6679200c0b2602bb'],77,108,185,15229732,6,0.111111111,0,1,10848
a5a8def893644ca2b0bcdd8e34ef251d3c028455,1,Hongbin Ma,2017-09-06 10:49:28+08:00,['2d939a59fdf385bb20b4724e8a6f87879e26bdd7'],4,1121,1125,15230857,22,0.829457364,1,0.848837209,10860
01f1756b847d53000f5578547239ce4f23e5e8e3,0,Hongbin Ma,2017-09-06 10:53:07+08:00,['a5a8def893644ca2b0bcdd8e34ef251d3c028455'],13,13,26,15230883,3,,,,10860
309c872abf2344f820504fef574bbd41278d2d0c,1,Hongbin Ma,2017-09-06 10:55:54+08:00,['01f1756b847d53000f5578547239ce4f23e5e8e3'],14,76,90,15230973,7,0.647058824,0.647058824,0.705882353,10860
c297f466ed2fbf850a4b44e68cee51f04b7c2545,0,Hongbin Ma,2017-09-06 10:57:36+08:00,['309c872abf2344f820504fef574bbd41278d2d0c'],59,48,107,15231080,12,0,0,0,10860
ac77008ee81d4dcc2956b1a2cfd6eaa7ae9fc5d9,0,Li Yang,2017-09-06 11:27:56+08:00,['520f6279c560f457c1b7fe1173532959fcee5c6c'],184,43,227,15231307,11,0.357894737,0.157894737,0.431578947,10860
c0e0b8f670311ee5abf400ac1cb8182054de4c7d,0,Hongbin Ma,2017-09-06 12:01:03+08:00,['c297f466ed2fbf850a4b44e68cee51f04b7c2545'],3,4,7,15231314,4,,,,10860
565fe9a71e93d41c26c03cbba454af33235ea2dc,1,Roger Shi,2017-09-06 12:59:48+08:00,['c0e0b8f670311ee5abf400ac1cb8182054de4c7d'],25,88,113,15231427,2,1,1,1,10860
b1559c669c3594b33f9e4aeff415d780a0a170ca,1,liyang-gmt8,2017-09-06 13:26:23+08:00,['565fe9a71e93d41c26c03cbba454af33235ea2dc'],30,90,120,15231547,5,0,0.79245283,0.622641509,10860
7bdce5e873179c5612415ee66b8470e2fd041737,0,Li Yang,2017-09-06 14:23:44+08:00,['ac77008ee81d4dcc2956b1a2cfd6eaa7ae9fc5d9'],8,8,16,15231563,1,1,1,1,10860
8edc901dec945776c7989c414a4eee746a5f741a,0,Dong Li,2017-09-06 19:30:15+08:00,['b1559c669c3594b33f9e4aeff415d780a0a170ca'],0,1,1,15231564,1,0,1,0,10860
9230663940177f0d4ef87d24ebeb67f0ee1a50e6,0,Roger Shi,2017-09-07 13:32:42+08:00,['8edc901dec945776c7989c414a4eee746a5f741a'],3269,3,3272,15234836,19,0.46624305,0.277998411,0.281175536,10860
55c6ee780a5cabc1618fc5f078c776f73123059b,0,鎴?2017-09-07 17:27:50+08:00,['9230663940177f0d4ef87d24ebeb67f0ee1a50e6'],31,99,130,15234966,23,0.172413793,0.931034483,0.896551724,10860,
aa9e73e4f726c8466f95864f3a88357c3deaa795,0,Hongbin Ma,2017-09-07 20:03:20+08:00,['55c6ee780a5cabc1618fc5f078c776f73123059b'],68,26,94,15235060,5,0.576923077,0.653846154,0.576923077,10860
25d2fd9a77a1f2a2afadd97b9ca0725032e9f5c9,0,Hongbin Ma,2017-09-07 20:03:20+08:00,['aa9e73e4f726c8466f95864f3a88357c3deaa795'],19,43,62,15235122,4,0.933333333,1,1,10860
fae56af2166ac21b5737542ca4c9ad1fb5b7622b,1,Roger Shi,2017-09-07 21:13:38+08:00,['25d2fd9a77a1f2a2afadd97b9ca0725032e9f5c9'],1,969,970,15236092,5,0.785714286,0.785714286,1,10861
5d8adbf0def0a2c034d7a1547e736c8044889fd9,0,Roger Shi,2017-09-08 10:05:44+08:00,['fae56af2166ac21b5737542ca4c9ad1fb5b7622b'],5,5,10,15236102,1,,,,10861
263791d2bed483a1a496450ee33d8a1c73ec0a98,0,Jiatao Tao,2017-09-08 15:16:43+08:00,['5d8adbf0def0a2c034d7a1547e736c8044889fd9'],1,1,2,15236104,1,,,,10861
604b3e0da007f6f0a29579188c3857a205a8edc0,0,Hongbin Ma,2017-09-08 17:59:52+08:00,['263791d2bed483a1a496450ee33d8a1c73ec0a98'],4,3,7,15236111,4,,,,10861
4c1c0aa0bf6c06f090a67403812bd913c1f2f862,0,GitHub,2017-09-08 19:22:13+08:00,['604b3e0da007f6f0a29579188c3857a205a8edc0'],0,67,67,15236178,2,0,0,1,10861
7da2cf8a1818ab78c3df679c95b44a332c4d4bd0,0,shaofengshi,2017-09-08 22:36:48+08:00,['7bdce5e873179c5612415ee66b8470e2fd041737'],2,34,36,15236214,3,0.391304348,0.391304348,1,10861
a0ca77da876c0c472b403ed70a81d92fba1717ed,0,shaofengshi,2017-09-09 16:35:50+08:00,['7da2cf8a1818ab78c3df679c95b44a332c4d4bd0'],2,2,4,15236218,1,,,,10861
57f665d63aabc8b8cf886cf7562ca92effebd176,0,Billy Liu,2017-09-09 21:22:55+08:00,['a0ca77da876c0c472b403ed70a81d92fba1717ed'],2,1,3,15236221,1,,,,10861
142d1d0c161dfa7c0358e9f014baf7cc2b66c64b,0,Billy Liu,2017-09-09 21:36:07+08:00,['57f665d63aabc8b8cf886cf7562ca92effebd176'],1,0,1,15236222,1,,,,10861
e9efa71a0604e520a952dd399092c72a69c78c0a,0,shaofengshi,2017-09-09 22:27:27+08:00,['142d1d0c161dfa7c0358e9f014baf7cc2b66c64b'],2,2,4,15236226,1,,,,10861
084a6fb0bcd3d57737d18e097c8699a1c929d3f9,0,shaofengshi,2017-09-09 22:27:27+08:00,['e9efa71a0604e520a952dd399092c72a69c78c0a'],34,2,36,15236262,3,0.608695652,0.608695652,0,10861
465c5070dcc27c6d42c2590cf0685ab154b40e7b,1,Li Yang,2017-09-10 07:47:20+08:00,['084a6fb0bcd3d57737d18e097c8699a1c929d3f9'],293,738,1031,15237293,42,0.781362007,0.870967742,0.88172043,10862
0eded0ad38a4a4b59f23e6cd5749fdb04b7c627f,1,Li Yang,2017-09-10 07:47:20+08:00,['465c5070dcc27c6d42c2590cf0685ab154b40e7b'],3,333,336,15237629,4,0.639810427,0.886255924,1,10864
b3b7a4e7e04831924ff1f6d844956ca5df9dcab1,0,Li Yang,2017-09-10 07:47:20+08:00,['0eded0ad38a4a4b59f23e6cd5749fdb04b7c627f'],109,67,176,15237805,12,0.925925926,0.888888889,0,10864
b9e1108e369909845ef917b985b70f8b76bd69f8,1,Li Yang,2017-09-10 09:46:53+08:00,"['4c1c0aa0bf6c06f090a67403812bd913c1f2f862', 'b3b7a4e7e04831924ff1f6d844956ca5df9dcab1']",623,1246,1869,15239674,64,,,,10864
d65376b5808daaf192fabe775df2b63889e29fe2,1,Li Yang,2017-09-10 13:03:23+08:00,['b9e1108e369909845ef917b985b70f8b76bd69f8'],2,2,4,15239678,1,,,,10864
ffcbdb7f4288fa6011f018163bdce9602415cf10,0,Li Yang,2017-09-10 18:55:54+08:00,['d65376b5808daaf192fabe775df2b63889e29fe2'],2,11,13,15239691,5,0,1,1,10864
bfe9c52f1617416497da30f9df3670e6ad009d0e,0,liyang-gmt8,2017-09-10 19:03:20+08:00,['d65376b5808daaf192fabe775df2b63889e29fe2'],4,6,10,15239701,8,0,0,1,10864
241a4ae08f097cc2e78573f58cf792e76908900b,1,Li Yang,2017-09-10 19:08:17+08:00,['ffcbdb7f4288fa6011f018163bdce9602415cf10'],1,29,30,15239731,3,0.6,1,0.6,10864
80a2e7abc80e0ac9a5f5af4fa85faa03e597056c,1,Li Yang,2017-09-10 19:12:43+08:00,['241a4ae08f097cc2e78573f58cf792e76908900b'],14,10,24,15239755,3,,,,10864
22c86acef1829d17dc0fab23ef4dbb9a16c2ede5,0,鎴?2017-09-10 19:18:01+08:00,['bfe9c52f1617416497da30f9df3670e6ad009d0e'],6,18,24,15239779,4,,,,10864,
32d9d23e4c5aac7dfc6d871d7d7f846641d3443a,0,Billy Liu,2017-09-10 21:13:03+08:00,['80a2e7abc80e0ac9a5f5af4fa85faa03e597056c'],6,13,19,15239798,1,1,1,1,10864
ecc01458c4ad361aaf863505884d51474a8fec9d,0,shaofengshi,2017-09-11 11:09:29+08:00,['32d9d23e4c5aac7dfc6d871d7d7f846641d3443a'],2,38,40,15239838,4,0,0.461538462,1,10864
9b7b52648a3a1ce87ff91413dc4b781e53600c1b,0,shaofengshi,2017-09-11 13:12:10+08:00,['ecc01458c4ad361aaf863505884d51474a8fec9d'],2,2,4,15239842,2,,,,10864
71297d883a2201f264106d9adb87a4e604462a49,0,liyang-gmt8,2017-09-11 14:53:56+08:00,['22c86acef1829d17dc0fab23ef4dbb9a16c2ede5'],1,0,1,15239843,1,0,0,0,10864
b029b64b60352a547b0bb1adaa5e86c9fb035054,0,liyang-gmt8,2017-09-11 15:30:08+08:00,['71297d883a2201f264106d9adb87a4e604462a49'],1,1,2,15239845,1,,,,10864
2a47f44518030dae8039ad43b9304d98f0b7ce38,0,Hongbin Ma,2017-09-11 19:10:21+08:00,['b029b64b60352a547b0bb1adaa5e86c9fb035054'],3,3,6,15239851,2,,,,10864
08d64ccc52bd51714c6b914fc155948588cdf030,0,Dong Li,2017-09-12 13:15:43+08:00,['2a47f44518030dae8039ad43b9304d98f0b7ce38'],1,6,7,15239858,2,0,1,1,10864
2dbbd51f69579a7105d5541a08d103ef0976e0ef,1,Hongbin Ma,2017-09-14 10:58:16+08:00,['08d64ccc52bd51714c6b914fc155948588cdf030'],22,32,54,15239912,1,0.428571429,0.428571429,0,10864
584553437f707593d009b1c4d54378d19a36b737,1,Roger Shi,2017-09-14 15:23:17+08:00,['2dbbd51f69579a7105d5541a08d103ef0976e0ef'],57,4,61,15239973,2,0.093023256,0.093023256,0,10864
b3d908986e8c7e545eac9749ee6c8291be415b5a,0,Li Yang,2017-09-15 11:09:29+08:00,['9b7b52648a3a1ce87ff91413dc4b781e53600c1b'],1,1,2,15239975,1,,,,10864
a30c8d27b3a7b7de8d9c7daa1289c03ea1685ddc,0,Hongbin Ma,2017-09-15 11:12:42+08:00,['584553437f707593d009b1c4d54378d19a36b737'],8,8,16,15239991,1,1,0,0,10864
06138f51b19a9b23b2fbb1665e5bae5f31e8f2b1,1,Hongbin Ma,2017-09-15 11:24:54+08:00,['a30c8d27b3a7b7de8d9c7daa1289c03ea1685ddc'],105,578,683,15240674,18,0.682926829,1,1,10869
35b9d9ae9692f2a0fcb4d56e7e47ecafa5f45663,1,Roger Shi,2017-09-15 14:35:56+08:00,['06138f51b19a9b23b2fbb1665e5bae5f31e8f2b1'],26,36,62,15240736,2,1,1,0,10869
5d2f9cfa3a926d23c45f721d233bddd52be0a269,0,Ni Chunen,2017-09-15 14:38:48+08:00,['35b9d9ae9692f2a0fcb4d56e7e47ecafa5f45663'],9,66,75,15240811,2,0,0,1,10869
38dae180038ab3bd1b9d80326c8c171ef9c36b07,0,Roger Shi,2017-09-15 15:09:25+08:00,['5d2f9cfa3a926d23c45f721d233bddd52be0a269'],240,80,320,15241131,17,0,0.085470085,0.102564103,10869
46c3e25fba32bc0ff772a9811f53d8c0dcac5e83,1,liyang-gmt8,2017-09-15 15:13:15+08:00,['38dae180038ab3bd1b9d80326c8c171ef9c36b07'],26,58,84,15241215,5,0.724137931,0.689655172,0.75862069,10869
44a37be7c27cdefd66d1b1917b4df3d805dc2b49,0,Li Yang,2017-09-15 15:30:08+08:00,['b3d908986e8c7e545eac9749ee6c8291be415b5a'],1,1,2,15241217,1,,,,10869
e3e361d2e98783bed8a8652974f150acb5dc1acb,0,Li Yang,2017-09-15 15:30:26+08:00,['44a37be7c27cdefd66d1b1917b4df3d805dc2b49'],11,2,13,15241230,5,1,0,0,10869
108e93c604d89b83d40986ebf50d1024412ab8e4,1,Li Yang,2017-09-15 22:41:24+08:00,['e3e361d2e98783bed8a8652974f150acb5dc1acb'],12,323,335,15241565,13,0.623188406,0.623188406,0.797101449,10872
87ccbc3a6edfa9282c4f801d80f66089d7375c4a,0,Li Yang,2017-09-16 08:11:27+08:00,['108e93c604d89b83d40986ebf50d1024412ab8e4'],0,1,1,15241566,1,1,1,1,10872
a3b339d2665ca9e2fb58990a3bbdffc0f200a469,0,liyang-gmt8,2017-09-16 10:10:16+08:00,['46c3e25fba32bc0ff772a9811f53d8c0dcac5e83'],6,3,9,15241575,2,0,0,0,10872
6d47976a435e42084d9f09853598acd84825c687,0,SHAOFENG SHI,2017-09-16 10:32:41+08:00,['a3b339d2665ca9e2fb58990a3bbdffc0f200a469'],0,1,1,15241576,1,1,1,1,10872
b97e16ad8ad561e2f1ca8fe60fe7ad8c577401d8,1,Dong Li,2017-09-16 15:30:30+08:00,['6d47976a435e42084d9f09853598acd84825c687'],82,534,616,15242192,19,0.625806452,0.706451613,0.970967742,10873
fd4a178cdf5f7c81463938f6909fafb41f54fe9c,0,Dong Li,2017-09-16 20:42:31+08:00,['b97e16ad8ad561e2f1ca8fe60fe7ad8c577401d8'],3,2,5,15242197,1,,,,10873
d04819d7436171f2570d16ddbec541a1686b68c1,0,shengping.liao,2017-09-16 22:14:51+08:00,['fd4a178cdf5f7c81463938f6909fafb41f54fe9c'],4,4,8,15242205,1,,,,10873
c9a855f271d592262b6e9ede0262ae160fcc42cd,0,Li Yang,2017-09-17 16:21:33+08:00,['87ccbc3a6edfa9282c4f801d80f66089d7375c4a'],4,25,29,15242234,5,1,1,1,10873
876811f2312981b99344cd700e1300a0462ec124,0,Li Yang,2017-09-17 16:28:19+08:00,['c9a855f271d592262b6e9ede0262ae160fcc42cd'],27,26,53,15242287,8,0.444444444,0.555555556,1,10873
4237d7296e1076f8c333a9591e4ce3d62c704892,0,Zhixiong Chen,2017-09-17 17:56:42+08:00,['d04819d7436171f2570d16ddbec541a1686b68c1'],1,2,3,15242290,1,1,1,1,10873
7640c946c7d9fbb5dac49c939b993030e5f90063,1,YIMINGXU,2017-09-17 08:29:20-05:00,['4237d7296e1076f8c333a9591e4ce3d62c704892'],93,75,168,15242458,12,0.4,0,0.8,10873
191014568967d9517549ecc76f1d5ecc2f5ff011,0,Li Yang,2017-09-17 21:34:38+08:00,['876811f2312981b99344cd700e1300a0462ec124'],4,6,10,15242468,2,0,1,1,10873
21a256075b9be3c3f91ab7126a419eeae866d967,1,Li Yang,2017-09-17 21:34:38+08:00,['191014568967d9517549ecc76f1d5ecc2f5ff011'],14,68,82,15242550,3,0.294117647,0.911764706,0.382352941,10873
e4624779bcf8e3a68b53c77700c9ff695559c76a,0,Li Yang,2017-09-17 21:34:38+08:00,['21a256075b9be3c3f91ab7126a419eeae866d967'],27,45,72,15242622,3,1,1,0,10873
cfe5c447c1daad3d139a7c6d678e603d5683e8d8,0,Dong Li,2017-09-18 01:00:55+08:00,['7640c946c7d9fbb5dac49c939b993030e5f90063'],0,5,5,15242627,1,0,0,1,10873
ec2603ea46fbdb0e778d0257fa23e56fbe5aa762,1,Li Yang,2017-09-18 06:37:57+08:00,['e4624779bcf8e3a68b53c77700c9ff695559c76a'],15,30,45,15242672,2,0,1,0,10873
bf0e2e16a88844488783a496b31f3e7dfff54b2c,0,Li Yang,2017-09-18 09:41:19+08:00,"['cfe5c447c1daad3d139a7c6d678e603d5683e8d8', 'ec2603ea46fbdb0e778d0257fa23e56fbe5aa762']",84,715,799,15243471,38,,,,10873
b4ad6f084cad7e0aca8d50301d991e7802c0cdcf,0,Dong Li,2017-09-18 15:19:16+08:00,['bf0e2e16a88844488783a496b31f3e7dfff54b2c'],10,0,10,15243481,1,0,0,0,10873
3177d79ca5cd8533164319acda8676684a6d307e,1,liyang-gmt8,2017-09-18 16:17:01+08:00,['b4ad6f084cad7e0aca8d50301d991e7802c0cdcf'],11,10,21,15243502,6,,,,10873
0d55c3118aeea323fc7d33b05e46288628ab4ab3,0,Roger Shi,2017-09-18 19:02:01+08:00,['3177d79ca5cd8533164319acda8676684a6d307e'],0,9,9,15243511,3,,,,10873
58ca04efc1b10b38bd996513a41233f5a31c0180,1,liyang-gmt8,2017-09-18 21:26:44+08:00,['0d55c3118aeea323fc7d33b05e46288628ab4ab3'],5,20,25,15243536,2,0,1,0.666666667,10873
ea92edf2cc23952292b18fb4b44a1b3dc32dd08a,0,Hongbin Ma,2017-09-18 21:34:47+08:00,['58ca04efc1b10b38bd996513a41233f5a31c0180'],5,7,12,15243548,3,1,1,0,10873
8f3f459e35728b9238c36e868164be123b102d69,0,Hongbin Ma,2017-09-19 21:21:12+08:00,['ea92edf2cc23952292b18fb4b44a1b3dc32dd08a'],11,11,22,15243570,3,,,,10873
13293bad2ce503a35339a5c4ec5bc532684efb48,1,liyang-gmt8,2017-09-19 22:03:56+08:00,['8f3f459e35728b9238c36e868164be123b102d69'],13,13,26,15243596,4,,,,10873
7f8f039fe210d7f01066655bda1f7a924b7e6abf,1,鎴?2017-09-20 14:00:01+08:00,['13293bad2ce503a35339a5c4ec5bc532684efb48'],16,23,39,15243635,1,0.285714286,0.714285714,0.571428571,10873,
a7fd3b1541177a71bf3dded8b193b8bf1eda992f,0,Dong Li,2017-09-20 16:05:15+08:00,['7f8f039fe210d7f01066655bda1f7a924b7e6abf'],2,146,148,15243783,4,0.268292683,0.182926829,1,10874
9af6a3f0cd2788b9df412c10c1ac237ff8b6d0ef,0,Jiatao Tao,2017-09-20 16:46:10+08:00,['a7fd3b1541177a71bf3dded8b193b8bf1eda992f'],9,22,31,15243814,2,1,1,1,10874
af8d8855572dc28b16317f5864a9c7aca989001e,0,Li Yang,2017-09-20 21:27:47+08:00,['bf0e2e16a88844488783a496b31f3e7dfff54b2c'],1,1,2,15243816,1,,,,10874
7c9125f94129771bb2a509cffbb679ad738fe03e,0,Hongbin Ma,2017-09-20 21:46:47+08:00,['9af6a3f0cd2788b9df412c10c1ac237ff8b6d0ef'],2,3,5,15243821,1,,,,10874
ff14042f5f318b1cc7881b06a4613c1de4439d2d,0,lidongsjtu,2017-09-21 13:28:25+08:00,['af8d8855572dc28b16317f5864a9c7aca989001e'],10,11,21,15243842,1,,,,10874
f5ebc3252fd1aa08d33da99db3a4d528d94c8690,0,Dong Li,2017-09-21 15:25:57+08:00,['7c9125f94129771bb2a509cffbb679ad738fe03e'],11,12,23,15243865,1,,,,10874
940aef6c67230db86eae767f7797c5dab1df07e7,0,Roger Shi,2017-09-21 16:23:07+08:00,['f5ebc3252fd1aa08d33da99db3a4d528d94c8690'],6,9,15,15243880,3,1,1,1,10874
555617cb07362dbe80e53fdfc317d641acc25e19,0,Hongbin Ma,2017-09-21 17:57:08+08:00,['940aef6c67230db86eae767f7797c5dab1df07e7'],1,16,17,15243897,4,1,1,1,10874
56bb972047f83f6f154347f57ed50082098af10c,0,SHAOFENG SHI,2017-09-21 20:38:42+08:00,['555617cb07362dbe80e53fdfc317d641acc25e19'],1,5,6,15243903,1,,,,10874
28d1e352e59f741b7efbce7a2cb78d293916d072,0,liyang-gmt8,2017-09-22 22:11:37+08:00,['56bb972047f83f6f154347f57ed50082098af10c'],1,12,13,15243916,2,1,1,1,10874
a09cc4bc80327a201013192494421642dd0ebf08,1,liyang-gmt8,2017-09-23 07:10:51+08:00,['28d1e352e59f741b7efbce7a2cb78d293916d072'],4,4,8,15243924,1,,,,10874
ae430ed8745ea36679113f27d745f6cca7898ac0,0,Li Yang,2017-09-23 08:30:17+08:00,['ff14042f5f318b1cc7881b06a4613c1de4439d2d'],4,5,9,15243933,1,0,0,0,10874
5c1a3d10fcdc15c2dc17dd3eae9668524195748b,0,Li Yang,2017-09-23 11:53:03+08:00,['ae430ed8745ea36679113f27d745f6cca7898ac0'],1,1,2,15243935,1,,,,10874
b15164ac23280ebad4e1ef92c637e070ea47b016,0,Hongbin Ma,2017-09-23 14:04:28+08:00,['a09cc4bc80327a201013192494421642dd0ebf08'],3,11,14,15243949,4,0,0,1,10875
713e9f74bd5ae69def13edae14f26c57fbeee44c,1,Li Yang,2017-09-23 14:05:30+08:00,['5c1a3d10fcdc15c2dc17dd3eae9668524195748b'],2,3,5,15243954,1,,,,10875
228b34aa10f3f89f9024bc2368cbe11a59894d28,0,Li Yang,2017-09-23 15:12:09+08:00,['713e9f74bd5ae69def13edae14f26c57fbeee44c'],35,41,76,15244030,3,0,0,1,10875
7530edb507b7f174e39413c24ed594d587c4fe99,1,Li Yang,2017-09-23 16:28:58+08:00,['228b34aa10f3f89f9024bc2368cbe11a59894d28'],58,162,220,15244250,13,0,1,0.424242424,10876
2551d489ba774a1d6b67fd52b29b372557ab05ee,0,Li Yang,2017-09-23 16:42:49+08:00,['7530edb507b7f174e39413c24ed594d587c4fe99'],9,6,15,15244265,1,0,0,0,10876
2edee491577d1507d3e251fcb33b5f43c21749d3,0,Li Yang,2017-09-23 16:55:07+08:00,['2551d489ba774a1d6b67fd52b29b372557ab05ee'],0,2,2,15244267,1,0,1,1,10876
e2029dd9a6de405d5ab32f05f0a92e9f228abef3,1,Li Yang,2017-09-23 18:16:48+08:00,['2edee491577d1507d3e251fcb33b5f43c21749d3'],2,5643,5645,15249912,13,0.424916574,0.760845384,0.836484983,10888
01fe425f1f4998d213fb89197781f1933821d0b2,0,Li Yang,2017-09-23 18:16:48+08:00,['e2029dd9a6de405d5ab32f05f0a92e9f228abef3'],0,228,228,15250140,2,0.24137931,0.24137931,0.974137931,10890
7b6606ad7ff6e89595c3db791a80607fe816c423,1,Li Yang,2017-09-23 18:16:48+08:00,['01fe425f1f4998d213fb89197781f1933821d0b2'],0,1780,1780,15251920,21,0.708414873,0.8962818,0.945205479,10911
f0bc691ecff2a8f92a3a43e49c5c7b1b676d6d10,1,Li Yang,2017-09-23 18:16:48+08:00,['7b6606ad7ff6e89595c3db791a80607fe816c423'],124,880,1004,15252924,16,0.364361702,0.329787234,0.542553191,10917
e21fe2acb46d4786ff9b694e66195798e31ab501,1,Li Yang,2017-09-23 19:29:25+08:00,['f0bc691ecff2a8f92a3a43e49c5c7b1b676d6d10'],60,48,108,15253032,7,1,1,0,10917
658353ad57ebb30e6e6a740769a85472354212d9,1,Li Yang,2017-09-23 20:18:07+08:00,['e21fe2acb46d4786ff9b694e66195798e31ab501'],80,75,155,15253187,15,1,0.086956522,0.043478261,10917
452f468533de169f6fe5aa24717367281350376d,0,Li Yang,2017-09-23 21:45:52+08:00,"['b15164ac23280ebad4e1ef92c637e070ea47b016', '658353ad57ebb30e6e6a740769a85472354212d9']",245,8717,8962,15262149,80,,,,10917
0a8bdc27a75827c9c24f29c056a0a48ea383b2e0,1,Li Yang,2017-09-24 07:08:14+08:00,['452f468533de169f6fe5aa24717367281350376d'],3,2,5,15262154,2,,,,10917
f11f184b0aca368e3859a90efcab0e9a9df43948,0,Li Yang,2017-09-24 07:47:40+08:00,['0a8bdc27a75827c9c24f29c056a0a48ea383b2e0'],6,4,10,15262164,5,,,,10917
2e845c21343e4143bfa5a3d6bb54842808c57275,1,Jiatao Tao,2017-09-24 17:47:04+08:00,['0a8bdc27a75827c9c24f29c056a0a48ea383b2e0'],2,46,48,15262212,5,0.25,0.805555556,0.777777778,10917
036d70fd0996ded0119c7c58369701eedac93a13,1,Jiatao Tao,2017-09-24 18:32:15+08:00,['2e845c21343e4143bfa5a3d6bb54842808c57275'],28,45,73,15262285,9,1,1,0.571428571,10917
8e6c60fb4d2457123ce403a7463f782233930ee1,1,Li Yang,2017-09-25 09:34:19+08:00,['036d70fd0996ded0119c7c58369701eedac93a13'],0,7,7,15262292,1,0,1,1,10917
aae24e351540930f09c681e6532df048f37f195d,1,Shaofeng Shi,2017-09-26 13:19:22+08:00,['8e6c60fb4d2457123ce403a7463f782233930ee1'],214,103,317,15262609,4,0.346153846,0,0.25,10918
14eeb3398db9e055c5a70ae55708ec2929a0b6b3,0,Li Yang,2017-09-26 18:14:24+08:00,['aae24e351540930f09c681e6532df048f37f195d'],2,734,736,15263345,2,0.244274809,0.666666667,0.82697201,10919
b425bb990854918e3dd20f4cf605e360b4d71df7,1,Jiatao Tao,2017-09-26 19:52:52+08:00,['14eeb3398db9e055c5a70ae55708ec2929a0b6b3'],0,40,40,15263385,4,1,1,1,10919
22631a62232c9696ce2532af60c623694468fef0,0,Jiatao Tao,2017-09-26 20:48:10+08:00,['b425bb990854918e3dd20f4cf605e360b4d71df7'],5,4,9,15263394,2,,,,10919
c9a55c9fde8f8bfaafaf1277311c28cf06131ceb,1,Li Yang,2017-09-26 20:51:26+08:00,['22631a62232c9696ce2532af60c623694468fef0'],734,2,736,15264130,2,0.755725191,0.333333333,0.17302799,10919
617de5c3389a728f53f8d044ff9a0edde47709cc,1,Li Yang,2017-09-26 21:06:12+08:00,['c9a55c9fde8f8bfaafaf1277311c28cf06131ceb'],2,729,731,15264861,2,0.246786632,0.673521851,0.825192802,10920
6dbb8402e7379c7e59fdf7ce39630a1739b4169d,0,YIMINGXU,2017-09-27 03:10:02-05:00,['617de5c3389a728f53f8d044ff9a0edde47709cc'],6,11,17,15264878,2,1,0,1,10920
3b74cea8e610c021240983d68e2ba3e1326e64f0,0,鎴?2017-09-28 11:08:38+08:00,['6dbb8402e7379c7e59fdf7ce39630a1739b4169d'],0,306,306,15265184,17,,,,10920,
2ee76384d9d2b9e432424c7439f056b9ba11b12f,0,Li Yang,2017-09-28 16:38:39+08:00,['3b74cea8e610c021240983d68e2ba3e1326e64f0'],54,172,226,15265410,4,0.745454545,0.927272727,0.854545455,10921
01c02be6930ac777d4c7320ccdd2d37b26744809,0,Shaofeng Shi,2017-09-29 09:45:43+08:00,['2ee76384d9d2b9e432424c7439f056b9ba11b12f'],9,9,18,15265428,2,,,,10921
c865ad5712cc5225ee664c9b25b4226517779ca0,0,Ni Chunen,2017-09-29 04:42:46-05:00,['01c02be6930ac777d4c7320ccdd2d37b26744809'],1,1,2,15265430,1,,,,10921
ef7d29083e45714722875bf6ce20bccd88a547d2,0,Li Yang,2017-09-29 18:28:44+08:00,"['c865ad5712cc5225ee664c9b25b4226517779ca0', 'f11f184b0aca368e3859a90efcab0e9a9df43948']",4,4,8,15265438,5,,,,10921
bd7cb9c9570f3d3cb0ceeb8f4c6be81853eb59bd,0,Li Yang,2017-09-29 19:37:44+08:00,['ef7d29083e45714722875bf6ce20bccd88a547d2'],0,3,3,15265441,1,0,0,1,10921
2415fd9e65b7bf483c375eda7d074c6804edb60e,0,Li Yang,2017-09-30 16:11:29+08:00,['bd7cb9c9570f3d3cb0ceeb8f4c6be81853eb59bd'],2,4,6,15265447,1,0,0,1,10921
d5bfcf5a9e3cfe2546b73db9690d092d651082fe,0,Li Yang,2017-09-30 17:02:57+08:00,['2415fd9e65b7bf483c375eda7d074c6804edb60e'],1,1,2,15265449,1,,,,10921
1f6e04c80d721ce11e415f92e9df1c4694d56bde,0,Li Yang,2017-10-01 09:11:10+08:00,['d5bfcf5a9e3cfe2546b73db9690d092d651082fe'],1,1,2,15265451,1,,,,10921
83d0ef3c854627d7c09250e0ecc625cf97b79ed4,0,Li Yang,2017-10-08 14:34:24+08:00,['ef7d29083e45714722875bf6ce20bccd88a547d2'],1,1,2,15265453,1,,,,10921
26a426bde36adaceaaa3ff5d883bc1f9c5ef526d,0,Li Yang,2017-10-08 16:50:20+08:00,['83d0ef3c854627d7c09250e0ecc625cf97b79ed4'],3,3,6,15265459,3,,,,10921
4b2f4866ccf50d930b4684c7ad24cf67a3fe458b,1,Li Yang,2017-10-08 16:52:38+08:00,['26a426bde36adaceaaa3ff5d883bc1f9c5ef526d'],2,5,7,15265466,2,1,1,1,10921
7a2510d44d8aeaa4bac653d6acec084260c54488,1,Li Yang,2017-10-08 16:53:11+08:00,['4b2f4866ccf50d930b4684c7ad24cf67a3fe458b'],0,1,1,15265467,1,0,1,0,10921
f45d8133b28f0063f1d73087f6dd65b34cf372cf,1,Li Yang,2017-10-08 18:31:56+08:00,['1f6e04c80d721ce11e415f92e9df1c4694d56bde'],1420,761,2181,15267648,102,0.730569948,0.170984456,0.015544041,10923
92959476bdd3e4775428a24f15fbc41f4ec2efd7,0,Li Yang,2017-10-08 18:31:56+08:00,['f45d8133b28f0063f1d73087f6dd65b34cf372cf'],31,39,70,15267718,7,1,1,0,10923
dbc513eef80d6e7c43f6f14fb69586c6b8897f3a,1,Li Yang,2017-10-08 18:31:56+08:00,['92959476bdd3e4775428a24f15fbc41f4ec2efd7'],25,24,49,15267767,23,,,,10923
a118cae1c9e0289c50ea42f4d21e93b0d6a0fc11,1,Li Yang,2017-10-08 18:38:50+08:00,['7a2510d44d8aeaa4bac653d6acec084260c54488'],1,16,17,15267784,2,0.714285714,1,0.714285714,10923
0297d9abfd47fc5fb6b360d7678fc7cfac4172a4,0,Li Yang,2017-10-08 18:44:31+08:00,['a118cae1c9e0289c50ea42f4d21e93b0d6a0fc11'],20,19,39,15267823,2,0.5,0,0.5,10923
b86a7346a1fcc3d5cf0215e83eb5279f1c4872a4,1,Li Yang,2017-10-08 18:48:58+08:00,['0297d9abfd47fc5fb6b360d7678fc7cfac4172a4'],13,42,55,15267878,2,0,0,1,10923
c04be637d2991afb3a97eac59c333e4ce28f5a43,1,Li Yang,2017-10-08 19:19:06+08:00,['b86a7346a1fcc3d5cf0215e83eb5279f1c4872a4'],50,41,91,15267969,2,0.8,0.8,0,10923
2ca82411c33271261ce7d2df1d2de953b391e05b,0,Li Yang,2017-10-08 21:13:09+08:00,"['dbc513eef80d6e7c43f6f14fb69586c6b8897f3a', 'c04be637d2991afb3a97eac59c333e4ce28f5a43']",57,95,152,15268121,11,,,,10923
da35e392d372927daa9fe069b375923f625d8ca0,0,lidongsjtu,2017-10-09 17:01:07+08:00,['2ca82411c33271261ce7d2df1d2de953b391e05b'],4,4,8,15268129,1,,,,10923
0f00b9393e38bc8bbed05033bc7e48e24f3d6123,0,shaofengshi,2017-10-10 18:45:42+08:00,['da35e392d372927daa9fe069b375923f625d8ca0'],1,1,2,15268131,1,,,,10923
4cc32eca0e6e3ae8e3c2861a6a5e4dc774c896d9,1,Billy Liu,2017-10-11 10:45:21+08:00,['0f00b9393e38bc8bbed05033bc7e48e24f3d6123'],3,3,6,15268137,2,,,,10923
071dbade190065ec59d67b59447c15a58dec6910,1,Yifan Zhang,2017-10-11 03:25:30-05:00,['2ca82411c33271261ce7d2df1d2de953b391e05b'],77,99,176,15268313,3,0,0,0,10924
5933a8abf917042c4712fb681549020c18039eed,0,Yifan Zhang,2017-10-11 03:25:30-05:00,['071dbade190065ec59d67b59447c15a58dec6910'],1,3,4,15268317,2,,,,10924
6e4c5af68edf6d369e6c6739ec31e954111c6812,0,Zhong,2017-10-12 00:50:21+08:00,['4cc32eca0e6e3ae8e3c2861a6a5e4dc774c896d9'],3,23,26,15268343,2,0,0,1,10924
c1c336d65abfe127b3b763ec9b910e1684aa7916,0,lidongsjtu,2017-10-12 18:05:14+08:00,['6e4c5af68edf6d369e6c6739ec31e954111c6812'],26,26,52,15268395,4,,,,10924
8891b1c84ad1fe84199c9c796c0ce57408607435,0,shaofengshi,2017-10-12 21:50:52+08:00,['c1c336d65abfe127b3b763ec9b910e1684aa7916'],1,230,231,15268626,4,0.555555556,1,1,10926
4a565b536afd8fee8377751127d40154444784b7,0,Hongbin Ma,2017-10-16 19:13:03+08:00,['5933a8abf917042c4712fb681549020c18039eed'],0,4,4,15268630,1,0,0,0,10926
dcd36fa2a7bb1a9051a9b22aca02e418c2d171b4,0,Li Yang,2017-10-17 15:34:27+08:00,['4a565b536afd8fee8377751127d40154444784b7'],26,62,88,15268718,4,0.6,0.04,0.72,10926
e89695166e97e941e87ee9ebb68ca20b4c02bc0f,0,GitHub,2017-10-17 03:58:05-05:00,['dcd36fa2a7bb1a9051a9b22aca02e418c2d171b4'],1,1,2,15268720,1,,,,10926
521f4fcd1c0107f6919e3975ab29ef61e0ccf0b2,0,Zhixiong Chen,2017-10-17 04:25:13-05:00,['e89695166e97e941e87ee9ebb68ca20b4c02bc0f'],26,30,56,15268776,8,0,0,1,10926
7269a3eadb830c758e94e9b7b52bf620d6e6655d,0,GitHub,2017-10-17 09:17:59-05:00,['521f4fcd1c0107f6919e3975ab29ef61e0ccf0b2'],0,2,2,15268778,1,,,,10926
c536978b897036686ca9dba465ef53b01965f670,0,GitHub,2017-10-17 09:54:27-05:00,['7269a3eadb830c758e94e9b7b52bf620d6e6655d'],5,3,8,15268786,1,1,1,0,10926
3efa9b4fe17623af1d42ba09b389dabef73d789e,0,shaofengshi,2017-10-18 09:14:40+08:00,['8891b1c84ad1fe84199c9c796c0ce57408607435'],4,3,7,15268793,3,1,0,0,10926
fe9141b50bc070ccc57682f7ba86b49291c55e1a,0,Zhixiong Chen,2017-10-18 01:33:02-05:00,['c536978b897036686ca9dba465ef53b01965f670'],30,30,60,15268853,10,,,,10926
6df6a32e0e0ef0251df28ee65748ff40bdc80646,0,Ni Chunen,2017-10-18 08:26:48-05:00,['fe9141b50bc070ccc57682f7ba86b49291c55e1a'],2,3,5,15268858,1,0,0,0,10926
9f0b3a5d3bd1b8f1bd08320e5ef815d59df43b32,0,Li Yang,2017-10-19 09:11:46+08:00,['6df6a32e0e0ef0251df28ee65748ff40bdc80646'],5,55,60,15268918,10,0.848484848,1,1,10926
a30a66ab28c05ae886c376a51daa332893c5ef1d,0,Li Yang,2017-10-19 09:12:59+08:00,['9f0b3a5d3bd1b8f1bd08320e5ef815d59df43b32'],1,3,4,15268922,2,,,,10927
3016ab94d6a6860c6b6d4685bca42c121b35c41c,0,Zhixiong Chen,2017-10-19 02:59:14-05:00,['a30a66ab28c05ae886c376a51daa332893c5ef1d'],3,13,16,15268938,2,1,1,1,10927
27ba8c75518757fb6503c64915c204cb99e9d089,0,luguosheng1314,2017-10-19 17:34:31+08:00,['3efa9b4fe17623af1d42ba09b389dabef73d789e'],0,5,5,15268943,1,1,1,1,10927
37e03a43e8ce78fec9a6b18e9c7c4863e153d987,0,lidongsjtu,2017-10-19 21:25:25+08:00,['27ba8c75518757fb6503c64915c204cb99e9d089'],0,1,1,15268944,1,1,1,1,10927
8e0605c91ccb70ea1fc6cab14402dcfc776a8d02,1,Dong Li,2017-10-19 10:12:08-05:00,['3016ab94d6a6860c6b6d4685bca42c121b35c41c'],1,1,2,15268946,1,,,,10927
b53e54f31f88993e998f7b6656d7874ec5f62ead,0,lidongsjtu,2017-10-19 23:33:53+08:00,['37e03a43e8ce78fec9a6b18e9c7c4863e153d987'],1,1,2,15268948,1,,,,10927
2b32aa4ca91ccdb4a885c4c509ae173bea5658d5,1,Li Yang,2017-10-20 07:05:39+08:00,['b53e54f31f88993e998f7b6656d7874ec5f62ead'],3,2490,2493,15271441,31,0.731804586,0.848454636,0.940179462,10956
c844903cdd8b649e41f25d7db6b81fa6a966e1f3,1,GitHub,2017-10-19 21:28:16-05:00,['8e0605c91ccb70ea1fc6cab14402dcfc776a8d02'],41,202,243,15271684,11,0.642857143,1,1,10957
52951adfc7d3f61bfd05a259ac3b87e1bd26d40d,0,Ni Chunen,2017-10-19 22:26:30-05:00,['c844903cdd8b649e41f25d7db6b81fa6a966e1f3'],4,4,8,15271692,1,,,,10957
d0ff774448fd4dc72d258ac79192a5419d96d65e,0,Li Yang,2017-10-21 14:39:48+08:00,['2b32aa4ca91ccdb4a885c4c509ae173bea5658d5'],4,36,40,15271732,2,0,1,1,10957
096034772b52422a948023c62179a60be9ab86b0,0,Li Yang,2017-10-21 17:00:10+08:00,['52951adfc7d3f61bfd05a259ac3b87e1bd26d40d'],1,1,2,15271734,1,,,,10957
874e825907dab66f4a6637236585eeace8e38576,0,Li Yang,2017-10-21 17:00:21+08:00,['096034772b52422a948023c62179a60be9ab86b0'],4,3,7,15271741,3,1,0,0,10957
05bd7959053ac9bc98dee70ce568a0ad7a85c843,0,Li Yang,2017-10-21 17:01:02+08:00,['874e825907dab66f4a6637236585eeace8e38576'],3,23,26,15271767,2,0,0,1,10957
3941b4da36b255c8d44ce3dcea75ecef11577155,1,shaofengshi,2017-10-21 22:17:42+08:00,['d0ff774448fd4dc72d258ac79192a5419d96d65e'],57,611,668,15272435,22,0.681102362,0.901574803,0.767716535,10961
48f3fb1953a413acfdd405539a7cfd211a5e85de,0,kangkaisen,2017-10-22 13:47:25+08:00,['3941b4da36b255c8d44ce3dcea75ecef11577155'],69,1,70,15272505,2,0,0,0,10961
460de4edeee3866a25e8056d2630d38e58a37d8e,0,Li Yang,2017-10-22 14:48:22+08:00,['05bd7959053ac9bc98dee70ce568a0ad7a85c843'],1,1,2,15272507,1,,,,10961
21316802d0c71b1c7e2910d983bd88e8182631b0,0,Roger Shi,2017-10-22 19:54:18+08:00,['460de4edeee3866a25e8056d2630d38e58a37d8e'],378,26,404,15272911,7,0.25,0.23125,0.0375,10961
7936560a1b48e82e94a875755bd938a76a0991b2,1,Li Yang,2017-10-22 20:20:52+08:00,['21316802d0c71b1c7e2910d983bd88e8182631b0'],165,227,392,15273303,18,0.380952381,1,0,10962
09cc2edc4bf56bff986aeb00d431ef79c59d03e2,0,shaofengshi,2017-10-23 17:16:27+08:00,['48f3fb1953a413acfdd405539a7cfd211a5e85de'],2,11,13,15273316,5,0,1,1,10962
f3d3585ed6360657574ac5b89535b18e41ac3efa,0,shaofengshi,2017-10-23 17:16:27+08:00,['09cc2edc4bf56bff986aeb00d431ef79c59d03e2'],1,1,2,15273318,1,,,,10962
dbf59e5cd06ad7bb45f22d89478bba7f19618608,0,shaofengshi,2017-10-23 17:16:27+08:00,['f3d3585ed6360657574ac5b89535b18e41ac3efa'],1,3,4,15273322,1,0,0,1,10962
febbf26230dec27eebe0d6568e2820ab26596b57,0,shaofengshi,2017-10-23 17:16:27+08:00,['dbf59e5cd06ad7bb45f22d89478bba7f19618608'],1,13,14,15273336,2,0,1,1,10962
4f214cdef54c593f5a4d29cdc924f4e79a7e53db,0,Zhixiong Chen,2017-10-24 02:35:54-05:00,['7936560a1b48e82e94a875755bd938a76a0991b2'],16,20,36,15273372,4,0,1,0,10962
7e1680eda08de6851e9cea301c39cbeca761d10d,1,shaofengshi,2017-10-24 16:46:21+08:00,['febbf26230dec27eebe0d6568e2820ab26596b57'],2,146,148,15273520,6,0.090909091,0.984848485,0.984848485,10962
17d6b1ff92423b5bfd3e6b0ec0c1c28604bf767b,0,Ni Chunen,2017-10-24 06:12:41-05:00,['4f214cdef54c593f5a4d29cdc924f4e79a7e53db'],2,44,46,15273566,3,0,1,1,10963
a8c05572eb5e1decc9de39965cd2369fa92bd79a,0,Hongbin Ma,2017-10-24 21:40:29+08:00,['17d6b1ff92423b5bfd3e6b0ec0c1c28604bf767b'],29,71,100,15273666,1,0.428571429,1,0.742857143,10963
dc441d700eee8921b632d762c8b20ff061b0d935,0,Ni Chunen,2017-10-24 08:40:51-05:00,['a8c05572eb5e1decc9de39965cd2369fa92bd79a'],0,8,8,15273674,1,,,,10963
5144a8a14721bdf68f74744c8fa9683ec469fe13,0,Li Yang,2017-10-24 22:41:15+08:00,['dc441d700eee8921b632d762c8b20ff061b0d935'],0,22,22,15273696,1,1,1,1,10963
db712c47a1842c532b7c55a56a7bb3e6a044556e,0,Li Yang,2017-10-25 09:07:48+08:00,['5144a8a14721bdf68f74744c8fa9683ec469fe13'],5,23,28,15273724,1,1,0.9,1,10963
b040c37751ecb50561d6040cd788adae0df704b3,0,luguosheng1314,2017-10-25 10:45:56+08:00,['7e1680eda08de6851e9cea301c39cbeca761d10d'],1,1,2,15273726,1,,,,10963
25850bc5e12e25cfc76437f42d6e866dcfe25550,0,YIMINGXU,2017-10-24 21:55:53-05:00,['db712c47a1842c532b7c55a56a7bb3e6a044556e'],1,1,2,15273728,1,,,,10963
b179cd18f6be7f8ba97a04988a22204c1e9fb9ef,0,YIMINGXU,2017-10-24 21:55:53-05:00,['25850bc5e12e25cfc76437f42d6e866dcfe25550'],0,27,27,15273755,1,,,,10964
28a9ab50beef55df1d5528886e664313a0c3a15a,1,Hongbin Ma,2017-10-25 14:09:54+08:00,['b179cd18f6be7f8ba97a04988a22204c1e9fb9ef'],10,129,139,15273894,4,0.326923077,0.980769231,0.673076923,10965
b486fbd8afef588563a28ca7b46eb1f8b13b558b,0,luguosheng1314,2017-10-25 04:31:08-05:00,['28a9ab50beef55df1d5528886e664313a0c3a15a'],2,7,9,15273903,1,1,1,0.75,10965
9308814acef8e5be97fb8c2ef3d77c46ed058dce,0,Yifan Zhang,2017-10-25 18:54:13+08:00,['b486fbd8afef588563a28ca7b46eb1f8b13b558b'],5,5,10,15273913,1,,,,10965
ce92e5385446cf4ee9bfbb04ce4d22add9c91a56,0,Li Yang,2017-10-25 20:04:37+08:00,['9308814acef8e5be97fb8c2ef3d77c46ed058dce'],1,1,2,15273915,1,,,,10965
761acfd9e56311cbd0542275c539c6729c1ddc3d,0,Li Yang,2017-10-25 22:19:04+08:00,['ce92e5385446cf4ee9bfbb04ce4d22add9c91a56'],1,1,2,15273917,1,,,,10965
e112bd7e9212120e979373166d9a854a478d075e,0,Li Yang,2017-10-25 22:19:04+08:00,['761acfd9e56311cbd0542275c539c6729c1ddc3d'],0,49,49,15273966,3,0.928571429,0.928571429,0.928571429,10966
187d9380b081862e61f238e7f8fc9c3d332c66ac,0,Li Yang,2017-10-26 10:23:12+08:00,['e112bd7e9212120e979373166d9a854a478d075e'],35,33,68,15274034,4,0,0,1,10966
f1510177e958ed5a570821834b841aa75a02bc18,0,Li Yang,2017-10-26 13:08:22+08:00,['187d9380b081862e61f238e7f8fc9c3d332c66ac'],3,6,9,15274043,2,0,0,0,10966
3ea100a1a5cab59fe9c99a04f13f879ef097f0e0,0,Ni Chunen,2017-10-26 07:42:19-05:00,['f1510177e958ed5a570821834b841aa75a02bc18'],0,7,7,15274050,1,1,1,1,10966
d8af4518d80aca1cb3e58c4eff2ca0563bb02edc,1,lidongsjtu,2017-10-27 21:58:08+08:00,['b040c37751ecb50561d6040cd788adae0df704b3'],1,753,754,15274804,13,0.739263804,0.877300613,0.739263804,10974
4e3b515c39bda273cec67e2b3ada663544753deb,1,lidongsjtu,2017-10-27 21:58:08+08:00,['d8af4518d80aca1cb3e58c4eff2ca0563bb02edc'],91,542,633,15275437,15,0.670103093,0.611683849,0.621993127,10974
ff0d0edc4f71a112dac347656a6c5bdc786975a9,1,lidongsjtu,2017-10-27 21:58:08+08:00,['4e3b515c39bda273cec67e2b3ada663544753deb'],55,413,468,15275905,30,0.786585366,0.81097561,0.670731707,10979
ec897aaeff90708b7f87b180a807fe766faf05c2,1,lidongsjtu,2017-10-27 21:58:08+08:00,['ff0d0edc4f71a112dac347656a6c5bdc786975a9'],588,771,1359,15277264,24,0.81547619,1,0.892857143,10984
2411470d1e8cb3f7e08d31627c7e3e66d95ba3f9,1,lidongsjtu,2017-10-27 21:58:17+08:00,['ec897aaeff90708b7f87b180a807fe766faf05c2'],76,63,139,15277403,25,0,0,0,10984
206789289af0c75569af505c732a3d0b8fed1cd5,0,Li Yang,2017-10-29 07:53:04+08:00,['2411470d1e8cb3f7e08d31627c7e3e66d95ba3f9'],2,0,2,15277405,1,0,0,0,10984
c1f5ed88c9f24220a1b75891b7801a7d69dbfd69,0,Li Yang,2017-10-29 08:24:39+08:00,['206789289af0c75569af505c732a3d0b8fed1cd5'],15,74,89,15277494,10,1,1,1,10985
0b5f799e9e9061a1f9194ebab988a17f2ac269e2,0,lidongsjtu,2017-10-29 16:01:18+08:00,['c1f5ed88c9f24220a1b75891b7801a7d69dbfd69'],1,1,2,15277496,1,,,,10985
29b91289673bf45e9378390225e16e9037657044,0,Li Yang,2017-10-29 18:45:03+08:00,['0b5f799e9e9061a1f9194ebab988a17f2ac269e2'],1,1,2,15277498,1,,,,10985
794e294e920c97bfcfd936ad3a79495177c773fe,0,Dong Li,2017-10-30 10:04:18+08:00,['3ea100a1a5cab59fe9c99a04f13f879ef097f0e0'],1,1,2,15277500,1,,,,10985
fe2e21e5bef7833a680059221e046e72d38082a2,0,Li Yang,2017-10-30 16:19:55+08:00,['794e294e920c97bfcfd936ad3a79495177c773fe'],15,70,85,15277585,4,0.933333333,0.933333333,1,10986
cb7de00c57c2552dfa16ab9aaa83687f98c4acf6,0,Li Yang,2017-10-31 18:29:24+08:00,['fe2e21e5bef7833a680059221e046e72d38082a2'],25,41,66,15277651,3,0.384615385,0.923076923,0.384615385,10986
9ff94437e69c6fd4b7edc3aecd3489792ce3819e,0,Yifan Zhang,2017-11-01 17:18:44+08:00,['cb7de00c57c2552dfa16ab9aaa83687f98c4acf6'],212,0,212,15277863,2,0.677165354,0.488188976,0.086614173,10986
10c550e574f7b198bc9bbcbcc6fd34b98cc92a09,0,Li Yang,2017-11-01 21:34:04+08:00,['9ff94437e69c6fd4b7edc3aecd3489792ce3819e'],9,11,20,15277883,6,,,,10986
1c142eb6af5be2d3cdb99d0a107257e3f80dc32d,0,Li Yang,2017-11-02 15:37:20+08:00,['10c550e574f7b198bc9bbcbcc6fd34b98cc92a09'],33,39,72,15277955,1,0,0,1,10986
3dad49c8479990bc64189b798c9a2bc7b36056b3,1,Li Yang,2017-11-02 15:47:03+08:00,['1c142eb6af5be2d3cdb99d0a107257e3f80dc32d'],392,77,469,15278424,9,0.343373494,0.102409639,0.301204819,10987
aff8d8e91559fdfbc867857e47eb67bce1bc5f1d,1,Li Yang,2017-11-02 15:47:03+08:00,['3dad49c8479990bc64189b798c9a2bc7b36056b3'],3,7,10,15278434,1,0,0,1,10987
a0c9795fb4dcedbe3f85e13b8aac160dbbe7de7c,1,lidongsjtu,2017-11-02 17:36:02+08:00,['29b91289673bf45e9378390225e16e9037657044'],5,2007,2012,15280446,20,0.513210568,0.772618094,0.786228983,10999
e1479a7875863a4add97f8edbd1a7297a22413ef,0,lidongsjtu,2017-11-02 17:36:02+08:00,['a0c9795fb4dcedbe3f85e13b8aac160dbbe7de7c'],0,138,138,15280584,1,0.723076923,1,0.615384615,11000
5c8e4d8a2b6e2315e932458ef9c1c77152567970,0,lidongsjtu,2017-11-02 17:36:02+08:00,['e1479a7875863a4add97f8edbd1a7297a22413ef'],18,128,146,15280730,6,0.235294118,0.5,0.941176471,11000
31b16c333e62ac5074c2a715905e2ee3f91b2a2f,0,lidongsjtu,2017-11-02 17:36:02+08:00,['5c8e4d8a2b6e2315e932458ef9c1c77152567970'],12,57,69,15280799,1,0,1,1,11000
3e2489ae7fe700db02f38d038008aab3cdabcb4d,0,GitHub,2017-11-02 05:23:36-05:00,['aff8d8e91559fdfbc867857e47eb67bce1bc5f1d'],3,2,5,15280804,1,,,,11000
11d8f87afbe8c1f3bc61fe18261624e13cdf8a1a,1,lidongsjtu,2017-11-03 13:44:17+08:00,['31b16c333e62ac5074c2a715905e2ee3f91b2a2f'],3,3,6,15280810,1,,,,11000
988857b436366d31d82e0cbd20f34453feea4211,0,Shaofeng Shi,2017-11-03 14:10:06+08:00,['3e2489ae7fe700db02f38d038008aab3cdabcb4d'],1,0,1,15280811,1,1,1,1,11000
3e21f104d2c3d9df896d550e22d907526aa6d5ea,0,lidongsjtu,2017-11-03 15:35:11+08:00,['11d8f87afbe8c1f3bc61fe18261624e13cdf8a1a'],1,1,2,15280813,1,,,,11000
c744a6cce8b42d31d541182e2c5709d9a8e10c72,0,Dong Li,2017-11-03 15:44:20+08:00,['988857b436366d31d82e0cbd20f34453feea4211'],33,59,92,15280905,8,0.846153846,0.846153846,1,11000
95268596bd4d315f2d2908a5a9e521f1ea5d0c0d,0,Li Yang,2017-11-03 17:22:24+08:00,['3e21f104d2c3d9df896d550e22d907526aa6d5ea'],52,116,168,15281073,4,0.604651163,0.976744186,0.976744186,11000
188124f36fe99cc0d2df5541c08a9040661d1deb,0,Li Yang,2017-11-03 18:01:02+08:00,['95268596bd4d315f2d2908a5a9e521f1ea5d0c0d'],15,0,15,15281088,1,,,,11000
e6bb40ae203d270fa35b964dbe5eb020f9c2ee5b,0,lidongsjtu,2017-11-03 22:54:25+08:00,['188124f36fe99cc0d2df5541c08a9040661d1deb'],2,3,5,15281093,1,,0,,11000
16f7ade4439a5916a1db017ab2d8bcf51cfba567,0,lidongsjtu,2017-11-03 22:55:17+08:00,['e6bb40ae203d270fa35b964dbe5eb020f9c2ee5b'],0,3,3,15281096,2,0,0.333333333,0.666666667,11000
1d0c4d4fddfc0d858b2173b0c37c8dc5f6b3d0bc,0,lidongsjtu,2017-11-03 22:58:32+08:00,['16f7ade4439a5916a1db017ab2d8bcf51cfba567'],3,11,14,15281110,1,1,1,1,11000
632c20b16fec2530e466ab4728e7cda133b61586,1,shaofengshi,2017-11-04 18:14:35+08:00,['1d0c4d4fddfc0d858b2173b0c37c8dc5f6b3d0bc'],10,10,20,15281130,2,,,,11000
9dc1fdda10fe997adc3bb2881946461813d02248,0,shaofengshi,2017-11-04 19:46:28+08:00,['632c20b16fec2530e466ab4728e7cda133b61586'],2,2,4,15281134,1,,,,11000
ca5b3b76feb3ba70381d09827eb0fafe6bf79dd1,0,shaofengshi,2017-11-04 19:54:12+08:00,['9dc1fdda10fe997adc3bb2881946461813d02248'],3,3,6,15281140,1,,,,11000
82fc92f216ba1ffe848007a4d64ea43882232795,0,shaofengshi,2017-11-04 19:59:17+08:00,['ca5b3b76feb3ba70381d09827eb0fafe6bf79dd1'],14,1,15,15281155,4,1,0,0.166666667,11000
b3552c977a91af2824c7fcfe1c446b280e2940a8,0,shaofengshi,2017-11-05 15:07:36+08:00,['82fc92f216ba1ffe848007a4d64ea43882232795'],0,488,488,15281643,3,0.81443299,1,0.886597938,11003
4917c658104af65abe48c2caffd0ceb532c5b3c4,1,shaofengshi,2017-11-05 19:10:26+08:00,['b3552c977a91af2824c7fcfe1c446b280e2940a8'],4,36,40,15281683,1,1,1,1,11003
c987b30fab06fa7b0a89cfc468db63bf2fe411cf,0,shaofengshi,2017-11-05 19:26:24+08:00,['4917c658104af65abe48c2caffd0ceb532c5b3c4'],1280,0,1280,15282963,12,0.753144654,0.322327044,0.48427673,11003
c56c741a9266f5ad37e938666fc43240dcc67c22,0,Shaofeng Shi,2017-11-06 15:06:04+08:00,['c744a6cce8b42d31d541182e2c5709d9a8e10c72'],2827,3,2830,15285793,19,0.39231279,0.320079523,0.039761431,11003
8511bb361d99d639a26b89de0af401dc10228d5a,0,Shaofeng Shi,2017-11-06 15:06:04+08:00,['c56c741a9266f5ad37e938666fc43240dcc67c22'],234,82,316,15286109,10,0.575,0.9375,0.025,11003
fb1d9e57912abe43c66495e16e6a13e0fa8eb3dd,0,Yifan Zhang,2017-11-07 17:08:55+08:00,['8511bb361d99d639a26b89de0af401dc10228d5a'],0,19,19,15286128,1,0,0,0,11003
3f3c42b3b6fbf393f63676eb439219007707aeff,0,Billy Liu,2017-11-07 21:47:02+08:00,['c987b30fab06fa7b0a89cfc468db63bf2fe411cf'],0,5,5,15286133,1,0,1,1,11003
480ed59f67e5a6643b971eee6c911cfc702a617d,0,Roger Shi,2017-11-09 15:46:12+08:00,['fb1d9e57912abe43c66495e16e6a13e0fa8eb3dd'],0,90,90,15286223,3,0.564516129,0.596774194,0.983870968,11003
5e2c783e12fc3a50088b7730bafafe941dc61b65,0,Ni Chunen,2017-11-10 02:37:28-06:00,['480ed59f67e5a6643b971eee6c911cfc702a617d'],8,13,21,15286244,3,1,1,1,11003
c00d7904300335877fa2a3a9795032ffac202af8,0,Ni Chunen,2017-11-10 02:37:28-06:00,['5e2c783e12fc3a50088b7730bafafe941dc61b65'],18,50,68,15286312,6,0.956521739,0.956521739,1,11003
293aa4bbdee98cc27f39507384cc23578802b482,0,Billy(Yiming) Liu,2017-11-10 03:08:27-06:00,['c00d7904300335877fa2a3a9795032ffac202af8'],3,0,3,15286315,1,,,,11003
9f15903e2b1b20332d6740bedb0641ba7dc41511,0,Billy(Yiming) Liu,2017-11-10 03:08:27-06:00,['293aa4bbdee98cc27f39507384cc23578802b482'],361,0,361,15286676,3,0.828828829,0.828828829,0.027027027,11003
091aeaa33bd7f9a59efe06dba21745116ebb0b46,0,lidongsjtu,2017-11-12 20:28:41+08:00,['3f3c42b3b6fbf393f63676eb439219007707aeff'],17,29,46,15286722,2,0,1,1,11003
685ac1598cf3e05ad9c9610f517fd9d19b6d3343,0,鎴?2017-11-12 11:04:42-06:00,['9f15903e2b1b20332d6740bedb0641ba7dc41511'],50,18,68,15286790,6,0.043478261,0.043478261,0,11003,
f26406d412a305ec13f7c3fe3a44b0d1d6b6fc7f,0,鎴?2017-11-12 11:04:42-06:00,['685ac1598cf3e05ad9c9610f517fd9d19b6d3343'],13,8,21,15286811,3,0,0,0,11003,
00595b1c92bbbdb4455d838fb66aee0d4194d033,1,Hongbin Ma,2017-11-13 16:01:39+08:00,['f26406d412a305ec13f7c3fe3a44b0d1d6b6fc7f'],194,219,413,15287224,28,0,0.65,1,11003
08b3a21ebd1a9b1dd295b831767235a0305ae373,0,Li Yang,2017-11-13 17:06:20+08:00,['00595b1c92bbbdb4455d838fb66aee0d4194d033'],33,95,128,15287352,4,0.609756098,1,1,11003
8527ede03d2626df2dd1d894ce28c572ea10acda,0,Zhong,2017-11-13 17:55:48+08:00,['091aeaa33bd7f9a59efe06dba21745116ebb0b46'],1,2,3,15287355,1,,,,11003
c7a0a03e6592925970fd00dda94a2dcb5d677906,0,Roger Shi,2017-11-13 19:44:58+08:00,['08b3a21ebd1a9b1dd295b831767235a0305ae373'],2,61,63,15287418,2,0.791666667,0.791666667,1,11004
d1d6085cafb45dc2f30cbbfe7468641a240140f3,1,GitHub,2017-11-13 22:55:33+08:00,['c7a0a03e6592925970fd00dda94a2dcb5d677906'],0,121,121,15287539,2,0,0.745454545,0.745454545,11005
37a1705016524ff2afd60681192883c322bc9fb0,1,Li Yang,2017-11-14 10:43:20+08:00,['d1d6085cafb45dc2f30cbbfe7468641a240140f3'],3,24,27,15287566,4,0.428571429,0.428571429,0.428571429,11005
27dfcc8ae8af749dab01b340d681e32f97ecc3a7,1,Dong Li,2017-11-14 10:45:50+08:00,['37a1705016524ff2afd60681192883c322bc9fb0'],1,26,27,15287593,4,0,0,0,11006
2d3079690d19bd585c2fc6d49c9cef98b174d6f8,0,Ni Chunen,2017-11-14 00:18:26-06:00,['27dfcc8ae8af749dab01b340d681e32f97ecc3a7'],14,21,35,15287628,3,0.833333333,0.833333333,1,11006
5ad1c581257a1dcd5d25fe0babcfb249213f58f1,0,Ni Chunen,2017-11-14 00:18:26-06:00,['2d3079690d19bd585c2fc6d49c9cef98b174d6f8'],11,42,53,15287681,3,1,1,1,11006
c62fdd3e06ef43eb8bc3a06032907937956784fa,0,鎴?2017-11-14 01:13:51-06:00,['5ad1c581257a1dcd5d25fe0babcfb249213f58f1'],40,38,78,15287759,1,0,1,1,11006,
3a1868d9a9bff3f315a10c84f5aa07650cf1ad07,0,Li Yang,2017-11-14 15:44:58+08:00,['c62fdd3e06ef43eb8bc3a06032907937956784fa'],11,13,24,15287783,1,0,1,1,11006
3f63d8e4e86d5acaced76627552ccbc6806f9529,1,Jiatao Tao,2017-11-14 02:10:16-06:00,['3a1868d9a9bff3f315a10c84f5aa07650cf1ad07'],302,695,997,15288780,21,0.7,1,0.721052632,11010
4078c96eca5864b0397a9f402de52341a3fcff4c,0,Jiatao Tao,2017-11-14 02:10:16-06:00,['3f63d8e4e86d5acaced76627552ccbc6806f9529'],22,6,28,15288808,4,0,0,0,11010
c2f54af6b7e8f8261eb2bb716a0818eaa4dc8c78,1,Jiatao Tao,2017-11-14 02:10:16-06:00,['4078c96eca5864b0397a9f402de52341a3fcff4c'],251,676,927,15289735,19,0.841463415,0.853658537,0.829268293,11016
598c6737ed64558bcb9185f31e06b11f44cab42e,0,Li Yang,2017-11-14 18:31:12+08:00,['c2f54af6b7e8f8261eb2bb716a0818eaa4dc8c78'],23,85,108,15289843,7,0.363636364,0.840909091,0.772727273,11016
6b2de10c9480311d364a611f5946434c6acf34f3,0,Li Yang,2017-11-14 18:31:12+08:00,['598c6737ed64558bcb9185f31e06b11f44cab42e'],0,3,3,15289846,1,0,1,1,11016
a952c836f1543e09ff908e78e32c13a8d137e466,0,Li Yang,2017-11-14 18:31:12+08:00,['6b2de10c9480311d364a611f5946434c6acf34f3'],24,38,62,15289908,5,0.9,0.9,0,11016
263affc69ca57bf6f14ee9c76e9f04fbf337ed15,0,鎴?2017-11-15 04:09:27-06:00,['a952c836f1543e09ff908e78e32c13a8d137e466'],1,14,15,15289923,1,1,1,1,11016,
745aa2c455d7c49da2365e4e61ce4c5cf96d8f7b,0,GitHub,2017-11-15 05:21:13-06:00,['263affc69ca57bf6f14ee9c76e9f04fbf337ed15'],4,9,13,15289936,2,0,0,0,11016
00c3dca0f798ef81f1b7c08a2afa9d7e05ca466e,0,Jiatao Tao,2017-11-15 07:44:02-06:00,['745aa2c455d7c49da2365e4e61ce4c5cf96d8f7b'],11,22,33,15289969,2,0,1,0.444444444,11016
08769e5eeb61979bbc89964657765d797c839dc7,1,Jiatao Tao,2017-11-15 07:44:43-06:00,['00c3dca0f798ef81f1b7c08a2afa9d7e05ca466e'],73,230,303,15290272,8,0.314814815,1,1,11019
15341d644ddb9d61972340f09d8851937863854e,1,Hongbin Ma,2017-11-15 23:51:57+08:00,['08769e5eeb61979bbc89964657765d797c839dc7'],44,208,252,15290524,11,0.377358491,0.773584906,0.886792453,11020
2df2bcb67c1f130ae81ca1742176a8effd0b7732,0,lidongsjtu,2017-11-16 13:34:36+08:00,['8527ede03d2626df2dd1d894ce28c572ea10acda'],0,2,2,15290526,1,1,1,1,11020
5a190d57f1eb186a1fa1b83647542286d47d543a,0,Yifan Zhang,2017-11-16 18:42:18+08:00,['15341d644ddb9d61972340f09d8851937863854e'],2,98,100,15290626,2,0.079545455,0.261363636,1,11020
eb4f1918faec80d9d8fbdfb7acfca167223c2d59,1,Hongbin Ma,2017-11-16 22:17:08+08:00,['5a190d57f1eb186a1fa1b83647542286d47d543a'],293,1356,1649,15292275,65,0.781094527,0.907960199,0.838308458,11035
6da4777e41556b8e87698b922ab1a6555ebf3f7a,0,chenzhx,2017-11-17 11:30:05+08:00,['2df2bcb67c1f130ae81ca1742176a8effd0b7732'],0,1,1,15292276,1,,,,11035
3d83f164a705357ed5cf9540c0fa212fa732b8ef,0,Li Yang,2017-11-17 13:03:36+08:00,['6da4777e41556b8e87698b922ab1a6555ebf3f7a'],1,8,9,15292285,1,0,1,1,11035
948553b9b8c65c720ccb986739988e216cfd26fc,0,chenzhx,2017-11-17 14:24:54+08:00,['3d83f164a705357ed5cf9540c0fa212fa732b8ef'],0,10,10,15292295,1,1,1,1,11035
2f6d8ec0674947d34f84ae41d175e7f9742f8420,0,shaofengshi,2017-11-17 14:28:44+08:00,['948553b9b8c65c720ccb986739988e216cfd26fc'],6,12,18,15292313,1,1,1,1,11035
683f4510a97b8e4215e147816ad7c9471d956719,1,shaofengshi,2017-11-17 14:45:29+08:00,['2f6d8ec0674947d34f84ae41d175e7f9742f8420'],23,123,146,15292459,6,0.525,1,0.625,11036
77b367e40a70a8b1b3cab7f914cb415e86208d27,0,Billy Liu,2017-11-17 14:51:41+08:00,['683f4510a97b8e4215e147816ad7c9471d956719'],0,42,42,15292501,1,,,,11036
cc08dd3f0fc155ea2bd7b6e8070018c416c9c7f9,0,Yifan Zhang,2017-11-17 16:16:06+08:00,['eb4f1918faec80d9d8fbdfb7acfca167223c2d59'],0,1,1,15292502,1,0,1,1,11036
84dd4b6f8d2398367c2c036d09b9be8bc9d56189,0,Cheng Wang,2017-11-19 13:25:08+08:00,['77b367e40a70a8b1b3cab7f914cb415e86208d27'],42,0,42,15292544,1,,,,11036
ce15042c3d4df0d570db12b879829ad547dccc21,0,Ni Chunen,2017-11-19 21:24:31+08:00,['cc08dd3f0fc155ea2bd7b6e8070018c416c9c7f9'],4,3,7,15292551,1,,,,11036
f00fd73d6834fbb24a65de7ce8b035092dc0eb28,0,Hongbin Ma,2017-11-20 12:38:42+08:00,['ce15042c3d4df0d570db12b879829ad547dccc21'],2,4,6,15292557,1,0,0,1,11036
8d662b263b27120603b893451d20f164caab612d,0,Hongbin Ma,2017-11-20 12:38:42+08:00,['f00fd73d6834fbb24a65de7ce8b035092dc0eb28'],1,8,9,15292566,1,0,1,1,11036
e4b1d7e0be3d657963e8ada357c150c2e703883f,0,chenzhx,2017-11-20 15:42:47+08:00,['84dd4b6f8d2398367c2c036d09b9be8bc9d56189'],1,1,2,15292568,1,,,,11036
577d0c62fbc7798e26c57bc57cadda3ae1e00649,0,Jiatao Tao,2017-11-21 03:33:09-06:00,['8d662b263b27120603b893451d20f164caab612d'],1,1,2,15292570,1,,,,11036
3a5ed25d57646f895de1793c16ea8bbcd0515770,0,Jiatao Tao,2017-11-21 08:11:15-06:00,['577d0c62fbc7798e26c57bc57cadda3ae1e00649'],6,46,52,15292622,2,0.194444444,1,1,11036
4eaea69b084e011a3f07692c5f087c048fd6ae03,0,鎴?2017-11-21 20:13:14-06:00,['3a5ed25d57646f895de1793c16ea8bbcd0515770'],19,14,33,15292655,1,0,0,1,11036,
2f7df1f52da99798df878eb1ca0a51a9929ed3f5,1,Hongbin Ma,2017-11-22 11:49:58+08:00,['4eaea69b084e011a3f07692c5f087c048fd6ae03'],148,387,535,15293190,18,0.177777778,0.711111111,1,11038
2b9470c38243c4678fb5d975664c82e7a9a87805,0,shaofengshi,2017-11-22 13:58:11+08:00,['e4b1d7e0be3d657963e8ada357c150c2e703883f'],0,8,8,15293198,1,0,0,1,11038
b02e7bd24cc724e03023706eac6389bfe71ebb3e,0,shaofengshi,2017-11-22 13:58:11+08:00,['2b9470c38243c4678fb5d975664c82e7a9a87805'],2,7,9,15293207,1,0,1,1,11038
0be3ae31b58777fd7d3ece6769ed772b9a6e99cb,0,shaofengshi,2017-11-22 14:35:30+08:00,['b02e7bd24cc724e03023706eac6389bfe71ebb3e'],19,0,19,15293226,1,0,0,0,11038
a53648f6c91d4941b1ba5379d582936f7d4e6ecc,0,shaofengshi,2017-11-22 15:20:31+08:00,['0be3ae31b58777fd7d3ece6769ed772b9a6e99cb'],1,1,2,15293228,1,,,,11038
1c8eb04d3774dd4ec29c1c40e0fcd465e7c37455,0,Li Yang,2017-11-22 19:03:52+08:00,['2f7df1f52da99798df878eb1ca0a51a9929ed3f5'],160,270,430,15293658,3,0.04040404,1,0.797979798,11038
79bab7a82a00f0dc4595ba2c40030372cd92f2c5,0,Li Yang,2017-11-22 19:03:52+08:00,['1c8eb04d3774dd4ec29c1c40e0fcd465e7c37455'],2,14,16,15293674,1,0.8,0.8,1,11038
07b7f82fb763ed9644c9784ecce6cfcb33e3f03a,0,shaofengshi,2017-11-23 11:26:55+08:00,['a53648f6c91d4941b1ba5379d582936f7d4e6ecc'],1,1,2,15293676,1,,,,11038
704f99b6f15cb392680f0ab7dc5fee5f67ef13a2,0,chenzhx,2017-11-23 15:53:12+08:00,['07b7f82fb763ed9644c9784ecce6cfcb33e3f03a'],1,1,2,15293678,1,,,,11038
f48208c143d6b26f778b3e6cb29ce57ac98aa1a3,0,chenzhx,2017-11-23 15:57:33+08:00,['704f99b6f15cb392680f0ab7dc5fee5f67ef13a2'],0,9,9,15293687,1,1,1,1,11038
3536e5219dffe310dcc9610212d3633c64efeb35,0,chenzhx,2017-11-23 19:26:59+08:00,['f48208c143d6b26f778b3e6cb29ce57ac98aa1a3'],2,2,4,15293691,1,,,,11038
d837e18ebb8503ef5346a2602a908492868c0e3e,0,chenzhx,2017-11-23 20:36:56+08:00,['3536e5219dffe310dcc9610212d3633c64efeb35'],9,0,9,15293700,1,0,0,0,11038
f47197b2fb6c315d7a2e07644aa417322a40417b,0,YIMINGXU,2017-11-23 23:47:17+08:00,['79bab7a82a00f0dc4595ba2c40030372cd92f2c5'],2,2,4,15293704,1,,,,11038
04e957216e439c6af39f2835cb322a8de4f1152f,0,Hongbin Ma,2017-11-25 19:25:22+08:00,['f47197b2fb6c315d7a2e07644aa417322a40417b'],1,1,2,15293706,1,,,,11038
421e94e4d915e994fb524654a60ae440fa445937,1,Dong Li,2017-11-25 20:58:22+08:00,['04e957216e439c6af39f2835cb322a8de4f1152f'],2,2,4,15293710,1,,,,11038
3f77a9f5889876acacf6e6a6bf268ba2c5328977,0,Hongbin Ma,2017-11-25 21:47:32+08:00,['421e94e4d915e994fb524654a60ae440fa445937'],29,45,74,15293784,1,0.058823529,0.058823529,0.411764706,11038
cac1f8bb48239fe5a49ca720575915f3507a4010,1,Li Yang,2017-11-26 13:03:47+08:00,['d837e18ebb8503ef5346a2602a908492868c0e3e'],278,1258,1536,15295320,21,0.623582766,0.684807256,0.968253968,11050
695971a2a27837bbf10f3fb0c4079ce11333951d,1,Li Yang,2017-11-26 13:04:27+08:00,['cac1f8bb48239fe5a49ca720575915f3507a4010'],14,16,30,15295350,6,1,1,0.5,11050
b40d0e06f8dddf0916a40eb01a49417d4b65826b,1,Li Yang,2017-11-26 14:16:04+08:00,['695971a2a27837bbf10f3fb0c4079ce11333951d'],1,44,45,15295395,1,0,0,1,11050
d375d93f390a3531ed13576620ba79e343fdb295,0,Hongbin Ma,2017-11-26 17:28:23+08:00,['3f77a9f5889876acacf6e6a6bf268ba2c5328977'],0,55,55,15295450,1,1,1,1,11051
d9e1d8cd9602936251628c72c63626e5a4f8cbf9,0,Li Yang,2017-11-26 18:43:30+08:00,['b40d0e06f8dddf0916a40eb01a49417d4b65826b'],1,4,5,15295455,1,,,,11051
7e16e8fa54215a75c3277cbe9c0d382fc8d9c932,0,Hongbin Ma,2017-11-27 09:35:20+08:00,['d375d93f390a3531ed13576620ba79e343fdb295'],1,2,3,15295458,1,,,,11051
418fb4f9246fa7a1d49da274b03284b3ffeb8aa8,0,chenzhx,2017-11-27 14:41:12+08:00,['d9e1d8cd9602936251628c72c63626e5a4f8cbf9'],1,5,6,15295464,2,,,,11051
92d13a0e6a725a25414ebdcc7bfcdc845dd10145,0,chenzhx,2017-11-27 14:45:10+08:00,['418fb4f9246fa7a1d49da274b03284b3ffeb8aa8'],2,2,4,15295468,1,,,,11051
8d64bcff3985e94cfe23810e1a7b991c152619bf,0,chenzhx,2017-11-27 14:46:30+08:00,['92d13a0e6a725a25414ebdcc7bfcdc845dd10145'],2,2,4,15295472,2,,,,11051
eedc73c1da80d3d0af77139e3bc2a1c4804d4797,0,YIMINGXU,2017-11-27 20:49:55+08:00,['7e16e8fa54215a75c3277cbe9c0d382fc8d9c932'],1,9,10,15295482,2,1,1,1,11051
fbd83ce4cfe782bad432730d5a93f1ced6c13ca2,1,Roger Shi,2017-11-28 13:49:17+08:00,['eedc73c1da80d3d0af77139e3bc2a1c4804d4797'],34,94,128,15295610,2,0.590909091,0.590909091,1,11052
924c6672d042bb6f77ab18cc425cda64ba731b35,0,GitHub,2017-11-28 02:45:51-06:00,['fbd83ce4cfe782bad432730d5a93f1ced6c13ca2'],4,18,22,15295632,1,0.857142857,1,0.857142857,11052
ed47869372a17bb002c9423e9a653ca381f42e96,0,shaofengshi,2017-11-29 08:13:11+08:00,['8d64bcff3985e94cfe23810e1a7b991c152619bf'],2,2,4,15295636,1,,,,11052
87bf2a143e5dc8a0880bfbbfea306ef7446cdc97,0,shaofengshi,2017-11-29 09:41:29+08:00,['ed47869372a17bb002c9423e9a653ca381f42e96'],0,2,2,15295638,1,1,1,1,11052
1b665cb8824b891deb2107ff0ee68f2e785afe6a,0,shaofengshi,2017-11-29 14:11:34+08:00,['87bf2a143e5dc8a0880bfbbfea306ef7446cdc97'],36,70,106,15295744,8,0.619047619,0.80952381,0.80952381,11052
4de64cd33224f0c83bfb55f7cbd5e30bf7ef4dcc,0,chenzhx,2017-11-29 14:59:38+08:00,['1b665cb8824b891deb2107ff0ee68f2e785afe6a'],0,11,11,15295755,2,1,0.909090909,1,11052
c46302eda0db7930f68258dc8eee7b2f4e3fe197,0,Yifan Zhang,2017-11-29 15:02:27+08:00,['924c6672d042bb6f77ab18cc425cda64ba731b35'],3,4,7,15295762,1,0,0,1,11052
3d8b34393d43d33835cb89bda888e5844c2965cd,0,Roger Shi,2017-11-30 14:54:19+08:00,['c46302eda0db7930f68258dc8eee7b2f4e3fe197'],1,19,20,15295782,1,0,0,0,11052
b3b07b12263ac526fa5b0d602e4545794817bde0,0,Roger Shi,2017-11-30 14:54:19+08:00,['3d8b34393d43d33835cb89bda888e5844c2965cd'],0,317,317,15296099,1,0.456896552,0.456896552,0.137931034,11053
82ca1b1a677c8fb4a116e1d56ec3540a22c237ab,0,Roger Shi,2017-11-30 14:54:19+08:00,['b3b07b12263ac526fa5b0d602e4545794817bde0'],0,1336,1336,15297435,1,0.378063011,0.49008168,0.68378063,11054
81ba38bd5ad29fd72c5406134198a30bb949fe3f,0,shaofengshi,2017-12-01 08:48:19+08:00,['4de64cd33224f0c83bfb55f7cbd5e30bf7ef4dcc'],41,3,44,15297479,1,,,,11054
a94b4796a6c4732af7b138e46f844d89bcdac8d9,0,Li Yang,2017-12-01 14:37:41+08:00,['81ba38bd5ad29fd72c5406134198a30bb949fe3f'],2,61,63,15297542,2,0.260869565,1,1,11055
bdf0f69c96e4cf21289168c49b778c741e06ae83,1,Zhong,2017-12-02 23:21:43+08:00,['a94b4796a6c4732af7b138e46f844d89bcdac8d9'],294,813,1107,15298649,19,0.686915888,0.920560748,0.448598131,11062
4cfffc29a6a826183e3d09fa59f3d3dc945ad1c5,1,Zhong,2017-12-02 23:21:43+08:00,['bdf0f69c96e4cf21289168c49b778c741e06ae83'],16,298,314,15298963,5,0.252380952,0.633333333,0.423809524,11063
99fbd755e167cfe0b4ef137dac66f28020d50415,1,Zhong,2017-12-02 23:21:43+08:00,['4cfffc29a6a826183e3d09fa59f3d3dc945ad1c5'],161,2893,3054,15302017,64,0.377344877,0.859307359,0.803751804,11082
0f13305dd42705aa0344e61fb843a1412d2b1dc7,1,Zhong,2017-12-02 23:21:43+08:00,['99fbd755e167cfe0b4ef137dac66f28020d50415'],24,22,46,15302063,8,0,0,0,11082
42f8e073d7f381af7e50660099cfdd6200066363,0,Zhong,2017-12-02 23:21:43+08:00,['0f13305dd42705aa0344e61fb843a1412d2b1dc7'],0,30,30,15302093,1,0.2,0.84,0.84,11082
df0c0e996be0f90b678d6fec450ed130b915d83a,0,Zhong,2017-12-02 23:21:43+08:00,['42f8e073d7f381af7e50660099cfdd6200066363'],121,119,240,15302333,9,0,0,1,11083
35774a14118618ec8a355a325ba343f0b291a197,0,Zhong,2017-12-02 23:21:44+08:00,['df0c0e996be0f90b678d6fec450ed130b915d83a'],31,77,108,15302441,11,1,0,1,11083
4e8e2f755c28e746acbbfa9cd6cfa3e53d3593ee,0,Zhong,2017-12-02 23:21:44+08:00,['35774a14118618ec8a355a325ba343f0b291a197'],0,10,10,15302451,1,0,1,1,11083
c27455fa3b26837d1f0777814b0ae2ac3b8a231f,1,Zhong,2017-12-02 23:43:43+08:00,['4e8e2f755c28e746acbbfa9cd6cfa3e53d3593ee'],254,251,505,15302956,9,0,0,1,11084
6236bfd1a9de325816241394d2b11249b469825c,1,Zhong,2017-12-02 23:43:43+08:00,['c27455fa3b26837d1f0777814b0ae2ac3b8a231f'],4,1309,1313,15304269,18,0.659090909,0.828787879,0.701515152,11090
75f6b0054e78c6abb5a1723161b04fbd9acac4a8,1,Zhong,2017-12-02 23:43:43+08:00,['6236bfd1a9de325816241394d2b11249b469825c'],5,399,404,15304673,5,0.339694656,0.786259542,0.667938931,11091
9d60da5033b8a579ee87868406f70dfc8fce51a6,0,Zhong,2017-12-02 23:43:43+08:00,['75f6b0054e78c6abb5a1723161b04fbd9acac4a8'],8,49,57,15304730,4,0.709677419,0.967741935,0.806451613,11091
eaf0537b8c3247aacd3d4840c82b0116dead1489,0,Zhong,2017-12-02 23:43:43+08:00,['9d60da5033b8a579ee87868406f70dfc8fce51a6'],18,63,81,15304811,5,0.107142857,0.821428571,1,11091
7a54e58bfa19092e3756b00c701e01441dd00fda,0,Zhong,2017-12-02 23:43:43+08:00,['eaf0537b8c3247aacd3d4840c82b0116dead1489'],4,171,175,15304986,7,0.403669725,0.128440367,1,11091
659c3861633f094634c9f7902d10341e9e698906,1,Zhong,2017-12-02 23:43:43+08:00,['7a54e58bfa19092e3756b00c701e01441dd00fda'],5,413,418,15305404,7,0.56993007,0.916083916,0.937062937,11091
8aef23a8b553fd5c923466ff64e4885f9d161e48,1,Zhong,2017-12-02 23:43:44+08:00,['659c3861633f094634c9f7902d10341e9e698906'],2,136,138,15305542,4,0.890909091,0.890909091,1,11091
84779827ad56673848c0e2f6b589a406dac1bce2,0,Zhong,2017-12-03 00:55:36+08:00,['8aef23a8b553fd5c923466ff64e4885f9d161e48'],27,156,183,15305725,3,0,0,1,11092
e53257d1fad0edc43cc625b4e3bc63723e403f4e,1,Li Yang,2017-12-03 13:06:10+08:00,['84779827ad56673848c0e2f6b589a406dac1bce2'],0,15,15,15305740,1,0,0.2,1,11092
c5d1fd07f5cb16978b1cc626edf556c0a2be4dcf,0,Li Yang,2017-12-03 13:11:03+08:00,['e53257d1fad0edc43cc625b4e3bc63723e403f4e'],12,27,39,15305779,1,0.5,0.5,0.5,11092
a184c51de9571f3092c1d225967e5cd3199f60db,0,Li Yang,2017-12-03 13:18:18+08:00,['c5d1fd07f5cb16978b1cc626edf556c0a2be4dcf'],14,14,28,15305807,4,,,,11092
f5e22801704b31820f08ca1cae74ab685ec42ec0,0,Li Yang,2017-12-03 14:22:17+08:00,['a184c51de9571f3092c1d225967e5cd3199f60db'],3,7,10,15305817,1,0,0,1,11092
43d02f4730f17bde981582d5a94591ca9f2c1f22,0,Li Yang,2017-12-03 14:40:14+08:00,['f5e22801704b31820f08ca1cae74ab685ec42ec0'],2,6,8,15305825,1,0,0,1,11092
2ed4dc226c8780d13d59b308fdab3577f81df381,0,Roger Shi,2017-12-04 09:46:48+08:00,['82ca1b1a677c8fb4a116e1d56ec3540a22c237ab'],15,172,187,15306012,8,0.345132743,0.707964602,0.663716814,11092
d103e639db0530cb21d3f98584fe2552ddfe8b59,0,Zhong,2017-12-05 00:37:27+08:00,['43d02f4730f17bde981582d5a94591ca9f2c1f22'],156,27,183,15306195,3,1,1,0,11092
5a6e6d7e38342691a057345a9d51c4375df8dc8f,0,Zhong,2017-12-05 00:38:22+08:00,['d103e639db0530cb21d3f98584fe2552ddfe8b59'],42,164,206,15306401,6,0,0,0.833333333,11093
a101229fbaf34860656a7eaf073868ba209029d0,1,Roger Shi,2017-12-05 10:03:38+08:00,['2ed4dc226c8780d13d59b308fdab3577f81df381'],1,13,14,15306415,2,1,1,1,11093
ed319575e6da35998e427e9803f69df2b450b872,0,kangkaisen,2017-12-05 10:35:24+08:00,['5a6e6d7e38342691a057345a9d51c4375df8dc8f'],1,31,32,15306447,2,0.962962963,0.62962963,1,11093
ca1e0b81aed27d5c8f279d76c58c35e51bdb1c31,0,Hongbin Ma,2017-12-04 21:11:58-08:00,['a101229fbaf34860656a7eaf073868ba209029d0'],1,0,1,15306448,1,,,,11093
6474e22fe09012d9c22e20685a55de6b43d181a4,0,shaofengshi,2017-12-05 16:15:28+08:00,['ed319575e6da35998e427e9803f69df2b450b872'],13,20,33,15306481,4,0,0,1,11093
f3ae1c42d21be10affb0e3feb81056b85c1849cf,0,chenzhx,2017-12-05 17:54:49+08:00,['6474e22fe09012d9c22e20685a55de6b43d181a4'],3,27,30,15306511,4,0.857142857,0.857142857,1,11093
577acc5a7c10291d4d5458d9afa620c823822061,0,chenzhx,2017-12-05 17:56:47+08:00,['f3ae1c42d21be10affb0e3feb81056b85c1849cf'],12,12,24,15306535,1,0,,0,11093
1654cc7b0cab219f4771e2dc17c08f3326b94653,0,Hongbin Ma,2017-12-05 02:35:59-08:00,['ca1e0b81aed27d5c8f279d76c58c35e51bdb1c31'],3,8,11,15306546,1,1,1,1,11093
849faec7d63b59af58eadc331f00c96343f18cc8,0,Li Yang,2017-12-05 07:31:03-06:00,['1654cc7b0cab219f4771e2dc17c08f3326b94653'],7,21,28,15306574,4,1,1,1,11093
5c435cd3554e926f176143633a09a27554905788,0,shaofengshi,2017-12-06 09:08:13+08:00,['577acc5a7c10291d4d5458d9afa620c823822061'],16,11,27,15306601,5,0,0,0,11093
14dd92e00fa1548889bf6e6bba8010f8a6a8cfcf,1,shaofengshi,2017-12-06 09:08:33+08:00,['5c435cd3554e926f176143633a09a27554905788'],1,1,2,15306603,1,,,,11093
7536c9ceaa863d9e7c0e8600bbeb4fa3ebb5a587,1,Li Yang,2017-12-05 21:52:10-06:00,['849faec7d63b59af58eadc331f00c96343f18cc8'],1,614,615,15307218,10,0.51026393,0.753665689,0.950146628,11099
2051197c91445a9156754261fe35d28e0d0c52e6,1,Li Yang,2017-12-06 01:37:30-06:00,['7536c9ceaa863d9e7c0e8600bbeb4fa3ebb5a587'],3,7,10,15307228,1,0,0,1,11099
9265e150d80519d3e4f532c5f106e6718543daba,1,kangkaisen,2017-12-06 20:09:44+08:00,['14dd92e00fa1548889bf6e6bba8010f8a6a8cfcf'],2,36,38,15307266,2,0,0,0,11100
c6cfa69841f96f6d3f411e375fbe1779e819cd84,1,shaofengshi,2017-12-07 13:25:27+08:00,['9265e150d80519d3e4f532c5f106e6718543daba'],15,76,91,15307357,3,0.863636364,0.954545455,0.636363636,11101
d0c015b8219e7d23e4446d4efd4a53c161afd9a4,0,chenzhx,2017-12-08 18:37:47+08:00,['c6cfa69841f96f6d3f411e375fbe1779e819cd84'],2,17,19,15307376,4,0,0.923076923,1,11101
6b39397859494492a9e9cfe1cc5b2ea83369fbde,0,shaofengshi,2017-12-08 18:57:29+08:00,['d0c015b8219e7d23e4446d4efd4a53c161afd9a4'],2,5,7,15307383,4,,,,11101
24f7e626e39a93d14aaf6a9783853176790a9f84,0,shaofengshi,2017-12-08 18:57:29+08:00,['6b39397859494492a9e9cfe1cc5b2ea83369fbde'],2,14,16,15307399,1,0,0,1,11101
e0d8dda58819786076d028d4ba0a571dddb8afe9,0,shaofengshi,2017-12-08 18:57:29+08:00,['24f7e626e39a93d14aaf6a9783853176790a9f84'],2,7,9,15307408,2,1,1,1,11101
b8f2292641ae6d00b207196f6294de36e2a17bd6,1,shaofengshi,2017-12-08 18:57:29+08:00,['e0d8dda58819786076d028d4ba0a571dddb8afe9'],1,4,5,15307413,1,0,1,1,11101
7e6aa347186560ff35b2ac2e2f75860a9ac70cc7,1,shaofengshi,2017-12-08 18:57:29+08:00,['b8f2292641ae6d00b207196f6294de36e2a17bd6'],2,45,47,15307460,7,0.961538462,0.961538462,1,11101
2762f5cdeae08f0346dc713b21bbf9a198b03d09,1,鎴?2017-12-08 19:13:58+08:00,['2051197c91445a9156754261fe35d28e0d0c52e6'],58,153,211,15307671,5,0.113207547,0.132075472,1,11101,
d173c7ef58e8614593707ec8830893488b31e987,0,鎴?2017-12-08 19:55:46+08:00,['2762f5cdeae08f0346dc713b21bbf9a198b03d09'],0,108,108,15307779,1,0.188679245,1,1,11102,
9df8572d787e03577c515b5818f5f11814b321f9,1,shaofengshi,2017-12-09 21:58:59+08:00,['7e6aa347186560ff35b2ac2e2f75860a9ac70cc7'],11,27,38,15307817,3,1,1,1,11102
fab517b951fdcc7cd2f74f38f3f2e6991bcfada0,1,shaofengshi,2017-12-09 22:34:57+08:00,['9df8572d787e03577c515b5818f5f11814b321f9'],4,4,8,15307825,2,,,,11102
3ebd15d522ee12103badd0547d9316a2e3314137,0,Yifan Zhang,2017-12-10 22:25:14+08:00,['d173c7ef58e8614593707ec8830893488b31e987'],2,12,14,15307839,2,1,1,1,11102
221caaab80a910639c9df3a3d8934de558e76635,1,Ni Chunen,2017-12-11 09:15:35+08:00,['3ebd15d522ee12103badd0547d9316a2e3314137'],8,20,28,15307867,1,0,0,1,11102
bace2d20b515ef0d458b2579d1923a7fa19d12a8,0,Roger Shi,2017-12-11 09:42:38+08:00,['221caaab80a910639c9df3a3d8934de558e76635'],21,22,43,15307910,5,1,,,11102
17838a19afb3891d6de7b5ac28dd61757a9e00f0,0,lidongsjtu,2017-12-11 09:46:09+08:00,['fab517b951fdcc7cd2f74f38f3f2e6991bcfada0'],1,2,3,15307913,1,,,,11102
ccf44c3223343ef353404ed4f2fcda46cf8e6766,0,chenzhx,2017-12-11 10:09:11+08:00,['17838a19afb3891d6de7b5ac28dd61757a9e00f0'],0,3,3,15307916,1,,,,11102
b8d7987090d96a763569a20a3f1665a3a612b565,1,Dong Li,2017-12-11 10:16:35+08:00,['bace2d20b515ef0d458b2579d1923a7fa19d12a8'],1082,686,1768,15309684,52,1,0.06175772,0.066508314,11106
f2f487fe2dc868119562303cb8b9a0b630f704cf,1,Dong Li,2017-12-11 10:16:35+08:00,['b8d7987090d96a763569a20a3f1665a3a612b565'],1675,1746,3421,15313105,32,0.590909091,1,0,11107
15dd1c12bc9b64981e14a6dbe2a28cd987acb588,0,Li Yang,2017-12-11 02:56:17-06:00,['f2f487fe2dc868119562303cb8b9a0b630f704cf'],1,1,2,15313107,1,,,,11107
da703bc11fdff6916e6acd9ef75f2e31473fcd45,0,chenzhx,2017-12-11 18:59:51+08:00,['ccf44c3223343ef353404ed4f2fcda46cf8e6766'],1,6,7,15313114,1,1,1,1,11107
af15062543b93c8146ae75bbb90f971e86a6bf96,0,Ni Chunen,2017-12-12 12:57:18+08:00,['15dd1c12bc9b64981e14a6dbe2a28cd987acb588'],0,5,5,15313119,1,0,1,1,11107
4629d8483914e29f4bb50cfcc6ba09b064187a38,1,Zhixiong Chen,2017-12-12 15:37:31+08:00,['af15062543b93c8146ae75bbb90f971e86a6bf96'],20,94,114,15313233,8,1,1,1,11107
029880f23098bf4f54430b6006dbb3f6b99adc9b,1,shaofengshi,2017-12-12 21:58:13+08:00,['da703bc11fdff6916e6acd9ef75f2e31473fcd45'],3,3,6,15313239,1,,,,11107
1e35990184815c3ed0f655542d8c9af118560dae,1,Ni Chunen,2017-12-12 22:43:24+08:00,['4629d8483914e29f4bb50cfcc6ba09b064187a38'],1,77,78,15313317,4,0.820512821,0.820512821,1,11108
05610dee7990d819a615efe57e8f9782948ee36f,0,Roger Shi,2017-12-13 14:16:02+08:00,['1e35990184815c3ed0f655542d8c9af118560dae'],16,5,21,15313338,2,0,0,0,11108
cb7f567f43ea0b1466772c61fa5855f406cce661,0,lidongsjtu,2017-12-13 14:23:17+08:00,['029880f23098bf4f54430b6006dbb3f6b99adc9b'],10,43,53,15313391,2,0.2,0.233333333,0.933333333,11108
fd59b513c7118e8c4e273ee2ed8b1be467490cc7,0,lidongsjtu,2017-12-13 15:48:17+08:00,['cb7f567f43ea0b1466772c61fa5855f406cce661'],72,215,287,15313678,2,0.451327434,0.663716814,0.884955752,11108
79374047d3bcd8468bee9ac56f68f4f191edad7b,0,lidongsjtu,2017-12-13 16:44:44+08:00,['fd59b513c7118e8c4e273ee2ed8b1be467490cc7'],17,19,36,15313714,2,0,0,0.6,11108
c09426515918b53495811ec0de6b3a21cb49f383,1,Hongbin Ma,2017-12-13 17:23:48+08:00,['05610dee7990d819a615efe57e8f9782948ee36f'],5,28,33,15313747,2,0,0.904761905,0.904761905,11108
39c80ca16fea0a1353f86002e2ee28ee8a3442a0,0,shaofengshi,2017-12-13 18:01:14+08:00,['79374047d3bcd8468bee9ac56f68f4f191edad7b'],2,33,35,15313782,2,0,0,0.782608696,11108
80b7edf419b8717c800009bc48872b20043cbe85,0,shaofengshi,2017-12-14 11:26:35+08:00,['39c80ca16fea0a1353f86002e2ee28ee8a3442a0'],12,12,24,15313806,7,,,,11108
b5a02430b5e0fb9a5e9651c4482d170769de9158,0,chenzhx,2017-12-14 11:35:49+08:00,['80b7edf419b8717c800009bc48872b20043cbe85'],1,3,4,15313810,1,,,,11108
a79035a63c6928eee6d556bd15bc8e5c50880ae8,1,Li Yang,2017-12-14 14:58:00+08:00,['b5a02430b5e0fb9a5e9651c4482d170769de9158'],8,19,27,15313837,1,0,0.714285714,0.714285714,11108
ad3dd3f63d399640142bd2c97669080bc3e37560,0,Li Yang,2017-12-14 14:58:17+08:00,['a79035a63c6928eee6d556bd15bc8e5c50880ae8'],0,13,13,15313850,2,0.375,0,0.375,11108
280f6738b765aa32dbcdc50951777a8d30e6b489,0,Li Yang,2017-12-14 14:58:21+08:00,['ad3dd3f63d399640142bd2c97669080bc3e37560'],0,9,9,15313859,2,0.5,0.5,0.5,11108
03e6b8c5d622125aca36128c6a7942f711951768,1,Hongbin Ma,2017-12-14 16:53:10+08:00,['c09426515918b53495811ec0de6b3a21cb49f383'],435,528,963,15314822,21,0.186915888,0.327102804,0.925233645,11109
9ff03c8cf647256fa0c3ba3b7adc1947fe73cfe7,0,Hongbin Ma,2017-12-14 16:53:10+08:00,['03e6b8c5d622125aca36128c6a7942f711951768'],1,1,2,15314824,1,,,,11109
3a3d11a319024fb7eccf26eb63f7c41891d66080,0,Jiatao Tao,2017-12-14 18:00:18+08:00,['9ff03c8cf647256fa0c3ba3b7adc1947fe73cfe7'],34,16,50,15314874,4,0,0,0,11109
f15da9e6ca64232ecb6153396b4bb2656c36fbc8,0,Jiatao Tao,2017-12-14 19:07:28+08:00,['3a3d11a319024fb7eccf26eb63f7c41891d66080'],1,43,44,15314918,1,0.472222222,0.472222222,0.527777778,11109
9c8565465a7bc2d9b227900e3a6cf841e919d49e,1,Jiatao Tao,2017-12-14 19:08:11+08:00,['f15da9e6ca64232ecb6153396b4bb2656c36fbc8'],5,7,12,15314930,1,0,1,1,11109
d7ebaec5162d8714ba8c2b86249d4b83cef5fdbe,0,Jiatao Tao,2017-12-14 19:51:54+08:00,['9c8565465a7bc2d9b227900e3a6cf841e919d49e'],27,0,27,15314957,4,0,0,0,11109
60431f46494aaa1297d8da87bbf49bc78312fcb4,1,kangkaisen,2017-12-15 15:29:25+08:00,['280f6738b765aa32dbcdc50951777a8d30e6b489'],1,7,8,15314965,1,0,1,0,11109
f0e5e376d6466891873514f76c7b34c73c0ea28f,1,kangkaisen,2017-12-15 20:29:04+08:00,['60431f46494aaa1297d8da87bbf49bc78312fcb4'],0,23,23,15314988,1,,,,11110
04c76e0c5143461d8cedbbb0b5e89e198247cb00,0,lidongsjtu,2017-12-17 17:18:35+08:00,['f0e5e376d6466891873514f76c7b34c73c0ea28f'],44,56,100,15315088,2,0,0.5,1,11110
0af27cdf981a95c0ccadf6223afbdfc357f5e61d,0,chenzhx,2017-12-17 19:23:20+08:00,['04c76e0c5143461d8cedbbb0b5e89e198247cb00'],4,29,33,15315121,3,0.56,1,0.68,11110
39949c38dc675fdad65b45c8a709ed879f29f949,0,chenzhx,2017-12-17 19:39:50+08:00,['0af27cdf981a95c0ccadf6223afbdfc357f5e61d'],9,46,55,15315176,2,0.962962963,1,0.962962963,11110
26e191a52e56a35deab9753138502e02c5d9dc23,0,Hongbin Ma,2017-12-18 14:36:50+08:00,['d7ebaec5162d8714ba8c2b86249d4b83cef5fdbe'],2,2,4,15315180,1,,,,11110
c051fb815f4f86eb098a3db9fd2428a56cb428cd,0,chenzhx,2017-12-19 11:12:05+08:00,['39949c38dc675fdad65b45c8a709ed879f29f949'],1,1,2,15315182,1,,,,11110
9f603d3188bd20070ea10cbe5fc0eecc28703633,0,Hongbin Ma,2017-12-20 10:09:10+08:00,['26e191a52e56a35deab9753138502e02c5d9dc23'],32,53,85,15315267,4,0.833333333,0,0.916666667,11110
a8f35cf26df452857dc4d7e1bc2a5d279bf7b13e,0,shaofengshi,2017-12-20 18:16:03+08:00,['c051fb815f4f86eb098a3db9fd2428a56cb428cd'],2,26,28,15315295,3,0.181818182,1,0.272727273,11110
377ec491c66e36a217012547fa5ea9b00ae361cc,0,lidongsjtu,2017-12-20 23:20:11+08:00,['a8f35cf26df452857dc4d7e1bc2a5d279bf7b13e'],32,215,247,15315542,6,0.118881119,0.272727273,0.594405594,11110
5425debae98f6397bf05f5459416a57d8feb14da,0,lidongsjtu,2017-12-20 23:20:11+08:00,['377ec491c66e36a217012547fa5ea9b00ae361cc'],19,111,130,15315672,5,0.761904762,0,0.476190476,11111
fba9d1d3dbe7d4dffbf8e0b87bf58b70baa7ffa6,0,lidongsjtu,2017-12-20 23:20:11+08:00,['5425debae98f6397bf05f5459416a57d8feb14da'],22,27,49,15315721,5,0,0,0,11111
ebafc766e613adf755675c574a76b1a4f8658346,0,lidongsjtu,2017-12-20 23:20:11+08:00,['fba9d1d3dbe7d4dffbf8e0b87bf58b70baa7ffa6'],49,42,91,15315812,2,1,1,0.333333333,11111
e7a32458c9f8b82345c029200db2658298a12815,0,lidongsjtu,2017-12-20 23:20:11+08:00,['ebafc766e613adf755675c574a76b1a4f8658346'],9,10,19,15315831,4,,,,11111
f6b2d7042c27a8e5eba2842bf478fb85ef3cf874,0,lidongsjtu,2017-12-20 23:20:11+08:00,['e7a32458c9f8b82345c029200db2658298a12815'],8,131,139,15315970,6,0.406779661,0.677966102,1,11112
1fbd51bf1f1038ad5c5151868e1cb259335dc396,0,lidongsjtu,2017-12-20 23:20:11+08:00,['f6b2d7042c27a8e5eba2842bf478fb85ef3cf874'],0,69,69,15316039,1,0,0,1,11113
7aef88aeeb8d4ab40c6aca4b403e187ab7c3a171,0,lidongsjtu,2017-12-20 23:20:11+08:00,['1fbd51bf1f1038ad5c5151868e1cb259335dc396'],72,76,148,15316187,4,0.75,0,1,11113
8690fd2d671ca7fa49576cc84eda41c3f24e539f,0,lidongsjtu,2017-12-20 23:20:11+08:00,['7aef88aeeb8d4ab40c6aca4b403e187ab7c3a171'],22,25,47,15316234,3,0,0,1,11113
cc701662b1a97939b595bf04156bbf6033e85fc2,0,lidongsjtu,2017-12-20 23:20:11+08:00,['8690fd2d671ca7fa49576cc84eda41c3f24e539f'],11,15,26,15316260,2,0,0,1,11113
7ca66d436ff5ec97dd80741dbaa9d73812743648,1,lidongsjtu,2017-12-20 23:21:17+08:00,['cc701662b1a97939b595bf04156bbf6033e85fc2'],11,55,66,15316326,1,0.105263158,0.763157895,0.868421053,11113
58005727ea7f0f9a35a83c737b1a6b9c6b342f6f,0,lidongsjtu,2017-12-20 23:27:33+08:00,['7ca66d436ff5ec97dd80741dbaa9d73812743648'],1,4,5,15316331,1,1,1,1,11113
c9bcc5b88475adef6cbd74f149128702997c776b,0,lidongsjtu,2017-12-20 23:29:05+08:00,['58005727ea7f0f9a35a83c737b1a6b9c6b342f6f'],1,1,2,15316333,1,,,,11113
07142889d4423b3211be625eceb8fd093fd34a22,1,lidongsjtu,2017-12-20 23:30:25+08:00,['c9bcc5b88475adef6cbd74f149128702997c776b'],8,5,13,15316346,2,0,0,0,11113
b55f4967067f0ecc056d58c9ba081e496f0d2b9e,1,lidongsjtu,2017-12-21 00:01:55+08:00,['07142889d4423b3211be625eceb8fd093fd34a22'],19,10,29,15316375,3,0.25,0.25,0.25,11113
2309618b98561531ed31f9faf175efc5269aa172,0,lidongsjtu,2017-12-21 00:02:08+08:00,['b55f4967067f0ecc056d58c9ba081e496f0d2b9e'],7,10,17,15316392,1,0,1,1,11113
f37fbce17f6e25775877290ba1f0de076c62f32f,1,Hongbin Ma,2017-12-21 11:06:34+08:00,['9f603d3188bd20070ea10cbe5fc0eecc28703633'],16,12,28,15316420,4,0,0,0,11113
ca42b92b6d86eb6cb3eb22a212e77f2155b19890,0,Li Yang,2017-12-20 21:45:01-06:00,['f37fbce17f6e25775877290ba1f0de076c62f32f'],0,4,4,15316424,1,1,1,1,11113
7e213b0132e4c53a396755f75750ac7e48e084c4,0,lidongsjtu,2017-12-21 15:06:32+08:00,['2309618b98561531ed31f9faf175efc5269aa172'],5,27,32,15316456,2,0,1,1,11113
006a5aab091bddf47d5a1cff19081b2245cd2a31,1,lidongsjtu,2017-12-21 23:12:18+08:00,['7e213b0132e4c53a396755f75750ac7e48e084c4'],19,120,139,15316595,16,1,0.735849057,1,11114
e787d7cd1b13d87ec68373893ede8c1ea534c58b,1,Li Yang,2017-12-21 23:06:06-06:00,['ca42b92b6d86eb6cb3eb22a212e77f2155b19890'],274,1252,1526,15318121,23,0.61784897,0.679633867,0.967963387,11126
fa482cc703484b8dad63c6acb41aff78dcec605a,0,chenzhx,2017-12-22 16:33:22+08:00,['006a5aab091bddf47d5a1cff19081b2245cd2a31'],3,20,23,15318144,3,1,1,1,11126
d4b63d3dee734811a1ea084971dfea2de0dd8f3d,1,chenzhx,2017-12-22 16:34:38+08:00,['fa482cc703484b8dad63c6acb41aff78dcec605a'],2,2,4,15318148,1,,,,11126
018605d646923ac91fea4583f3c9339516991d7f,0,chenzhx,2017-12-22 16:53:28+08:00,['d4b63d3dee734811a1ea084971dfea2de0dd8f3d'],2,2,4,15318152,2,,,,11126
bcda327f734d4833d3baff11709376c14da779bf,0,Hongbin Ma,2017-12-22 18:11:43+08:00,['e787d7cd1b13d87ec68373893ede8c1ea534c58b'],4,55,59,15318211,9,0.323529412,0.088235294,0.764705882,11126
1d1627a9a49b31c0ff96f6c9bc313587e52601c7,0,kangkaisen,2017-12-22 18:43:00+08:00,['018605d646923ac91fea4583f3c9339516991d7f'],2,4,6,15318217,1,0,0,1,11126
acc9d0c834bf48ede6c57e2cc7aee73b76531fa2,1,鎴?2017-12-23 22:22:21+08:00,['bcda327f734d4833d3baff11709376c14da779bf'],8,66,74,15318291,6,0.666666667,0.692307692,1,11126,
17ce7d760edd5db29c6e49ee7543daf74291ec7a,0,Ni Chunen,2017-12-25 18:38:45+08:00,['acc9d0c834bf48ede6c57e2cc7aee73b76531fa2'],1,1,2,15318293,1,,,,11126
5f2eff68d80ea6264d7590e14c052114c3cd6b74,0,lidongsjtu,2017-12-26 14:02:35+08:00,['1d1627a9a49b31c0ff96f6c9bc313587e52601c7'],3,5,8,15318301,4,0.5,1,0.5,11126
19c4eb79576c102cb1475d7a96ff13db14496712,1,Jiatao Tao,2017-12-26 19:44:40+08:00,['17ce7d760edd5db29c6e49ee7543daf74291ec7a'],15,121,136,15318437,6,0.090909091,1,1,11128
5aa8033525c9223d305b233928e29ee32193715a,1,Hongbin Ma,2017-12-27 15:05:12+08:00,['19c4eb79576c102cb1475d7a96ff13db14496712'],25,75,100,15318537,2,0.857142857,1,1,11129
c6e45a76dac1f9428308622558fe3608e11b66df,0,Sheng Zhang,2017-12-27 16:59:51+08:00,['5aa8033525c9223d305b233928e29ee32193715a'],1,37,38,15318575,2,0,1,1,11129
63de91df546c28c4aa745f61619eeb8797eb7b44,1,Dong Li,2017-12-27 18:58:35+08:00,['c6e45a76dac1f9428308622558fe3608e11b66df'],5,24,29,15318604,2,1,1,0,11129
6c31ca9235a84df588806bc51b108d921db18e1e,1,Hongbin Ma,2017-12-27 20:05:54+08:00,['63de91df546c28c4aa745f61619eeb8797eb7b44'],17,38,55,15318659,4,1,1,1,11129
d86c2a087514fd9fc3c192ba0f9668855d9c7aa1,1,Hongbin Ma,2017-12-27 20:05:54+08:00,['6c31ca9235a84df588806bc51b108d921db18e1e'],31,160,191,15318850,13,0.833333333,1,1,11133
3b200a78fc8149376ae1e70404b8afc8bb67ce91,0,Hongbin Ma,2017-12-27 20:05:54+08:00,['d86c2a087514fd9fc3c192ba0f9668855d9c7aa1'],26,17,43,15318893,3,1,0.125,0,11133
f2722eb7d147735c79102e9e4bb35bf7b38d8534,0,Hongbin Ma,2017-12-27 20:05:54+08:00,['3b200a78fc8149376ae1e70404b8afc8bb67ce91'],44,160,204,15319097,5,0.553571429,0.839285714,0.946428571,11134
826788a35b717159381e53adb3c5da16eeac360d,0,Hongbin Ma,2017-12-28 10:34:43+08:00,['f2722eb7d147735c79102e9e4bb35bf7b38d8534'],6,10,16,15319113,1,0.571428571,0.571428571,1,11134
b8ddd820383881fedd6ea617874887e0b0b32734,1,Hongbin Ma,2017-12-28 17:37:18+08:00,['826788a35b717159381e53adb3c5da16eeac360d'],139,121,260,15319373,16,0,1,0.5,11134
4eb6cd41b31401542091cab7a8aa6f5b38ca8524,1,Hongbin Ma,2017-12-28 18:53:55+08:00,['b8ddd820383881fedd6ea617874887e0b0b32734'],0,1,1,15319374,1,0,1,0,11134
a6d1ab02234bcc021faed77fac17d74d3c1c7e30,1,Li Yang,2017-12-28 21:34:52-06:00,['4eb6cd41b31401542091cab7a8aa6f5b38ca8524'],12,102,114,15319488,4,0.446428571,0.928571429,1,11135
7889cec6794a6dda7ba6151feb5e9f9b2378cb7e,1,Li Yang,2017-12-28 22:05:18-06:00,['a6d1ab02234bcc021faed77fac17d74d3c1c7e30'],9,42,51,15319539,3,0.76,0.76,0.68,11135
4d50b26972bb7bbaff852172990e0f189f987673,1,Li Yang,2017-12-31 19:57:05+08:00,"['7889cec6794a6dda7ba6151feb5e9f9b2378cb7e', '5f2eff68d80ea6264d7590e14c052114c3cd6b74']",3026,17686,20712,15340251,381,,,,11135
6f4dbc1210ad77578f37fcb21a9acd6024571765,1,Li Yang,2018-01-01 07:35:11+08:00,['4d50b26972bb7bbaff852172990e0f189f987673'],12,12,24,15340275,2,,,,11135
edc4397aa1f168a75a612639376bff89d6424310,0,Li Yang,2018-01-01 07:57:10+08:00,['6f4dbc1210ad77578f37fcb21a9acd6024571765'],0,3,3,15340278,1,,,,11135
3ec60100454bd2ff841a77581c32bdb3d9b7074e,0,lidongsjtu,2018-01-01 21:26:12+08:00,['edc4397aa1f168a75a612639376bff89d6424310'],1,1,2,15340280,1,,,,11135
3e9bc5bd2e818d9e855ac2b917c8942800e0788e,0,shaofengshi,2018-01-03 13:38:09+08:00,['3ec60100454bd2ff841a77581c32bdb3d9b7074e'],18,20,38,15340318,1,,,,11135
fb706854ab7e0b03ad85ec85c83902bb83b36ae2,1,shaofengshi,2018-01-03 18:06:09+08:00,['3e9bc5bd2e818d9e855ac2b917c8942800e0788e'],17,2,19,15340337,3,0.111111111,0,0,11135
7f3fdbe11d09a866c2e69776a84eb1c3a8d9d4ff,0,shaofengshi,2018-01-04 11:25:16+08:00,['fb706854ab7e0b03ad85ec85c83902bb83b36ae2'],4,2,6,15340343,1,,,,11135
e44f95e632bb11dad6c2df16f8e0398b09e3e8c3,0,shaofengshi,2018-01-04 11:25:35+08:00,['7f3fdbe11d09a866c2e69776a84eb1c3a8d9d4ff'],0,4,4,15340347,1,0,0,1,11135
f86d0678df40d204cc2a0826e5f7e87180a20128,0,chenzhx,2018-01-06 16:37:49+08:00,['e44f95e632bb11dad6c2df16f8e0398b09e3e8c3'],1,1,2,15340349,1,,,,11135
2ba22a9ce67b44db62897422e338b29522be67b7,1,chenzhx,2018-01-06 17:17:19+08:00,['f86d0678df40d204cc2a0826e5f7e87180a20128'],11,16,27,15340376,2,1,0,1,11135
18ac702ade9e630d9baafc0b8c21920d1e44b05e,1,chenzhx,2018-01-06 17:43:58+08:00,['2ba22a9ce67b44db62897422e338b29522be67b7'],17,26,43,15340419,2,0.941176471,1,1,11135
2ee18bc8246d519d3de4910d4ac816a1fda0c8cc,0,lidongsjtu,2018-01-08 13:52:15+08:00,['18ac702ade9e630d9baafc0b8c21920d1e44b05e'],0,1,1,15340420,1,,,,11135
393115712af3cd46faa2664e4bdc1431a3b2f135,0,chenzhx,2018-01-08 14:02:11+08:00,['2ee18bc8246d519d3de4910d4ac816a1fda0c8cc'],4,1,5,15340425,2,,0,,11135
91c76dd2d28c6d198bafdb84db04190a7e796159,1,chenzhx,2018-01-08 14:02:11+08:00,['393115712af3cd46faa2664e4bdc1431a3b2f135'],1,19,20,15340445,1,0.421052632,0.421052632,1,11135
18673d096d57df217bdaf4c9f93759dbf122d68f,0,lidongsjtu,2018-01-09 20:03:16+08:00,['91c76dd2d28c6d198bafdb84db04190a7e796159'],3,9,12,15340457,3,1,1,1,11135
0162d8886ebe2b9fde98c995509754df26f19722,0,shaofengshi,2018-01-11 11:21:22+08:00,['18673d096d57df217bdaf4c9f93759dbf122d68f'],1,1,2,15340459,1,,,,11135
1388b73be3ccae9e7aa6cdd07f41dd7ebbff1fa8,0,chenzhx,2018-01-16 14:49:53+08:00,['0162d8886ebe2b9fde98c995509754df26f19722'],0,327,327,15340786,5,0.732876712,1,0.760273973,11138
89fffc23b9067f7161df597b26602be0593c67f8,0,chenzhx,2018-01-16 18:08:26+08:00,['1388b73be3ccae9e7aa6cdd07f41dd7ebbff1fa8'],9,9,18,15340804,5,,,,11138
a6189a6069589a05db5a99bd2bc48242e67cc34d,0,shaofengshi,2018-01-17 17:05:50+08:00,['89fffc23b9067f7161df597b26602be0593c67f8'],1,1,2,15340806,1,,,,11138
c3d17452a841892d426275fb7ee2f8857ae61914,1,shaofengshi,2018-01-17 18:25:20+08:00,['a6189a6069589a05db5a99bd2bc48242e67cc34d'],1,3,4,15340810,1,0,0,0,11138
27ccf441c64ca28a0dfe86ced6ea8b56b88b02df,0,Cheng Wang,2018-01-18 17:40:02+08:00,['c3d17452a841892d426275fb7ee2f8857ae61914'],7,22,29,15340839,2,0.214285714,0,0.928571429,11138
54266f88c6e33d29f40f34092f54df98b1e8ec68,0,lidongsjtu,2018-01-21 20:01:34+08:00,['27ccf441c64ca28a0dfe86ced6ea8b56b88b02df'],40,223,263,15341102,12,0.761363636,1,0.420454545,11139
fcac5fcddd2d7ba56495217a337c617a4dff9026,1,lidongsjtu,2018-01-21 20:01:34+08:00,['54266f88c6e33d29f40f34092f54df98b1e8ec68'],118,224,342,15341444,6,0.329113924,0.379746835,0,11139
e1d8b71bbd02d04405ab138a8a91d9dc064cb676,0,lidongsjtu,2018-01-21 20:01:34+08:00,['fcac5fcddd2d7ba56495217a337c617a4dff9026'],98,81,179,15341623,16,0,0.111111111,1,11139
ab420496eccdfd157045f47a00add7b6f2f2a272,0,lidongsjtu,2018-01-21 20:06:50+08:00,['e1d8b71bbd02d04405ab138a8a91d9dc064cb676'],2,1,3,15341626,1,0,0,0,11139
f988401d4821e0765105248baad90fd4e28e8fa2,0,lidongsjtu,2018-01-21 21:27:28+08:00,['ab420496eccdfd157045f47a00add7b6f2f2a272'],0,19,19,15341645,3,0.6,0.6,0.6,11139
6acb3aba1310424f9048f5eccfa2bdb42731308a,1,Billy Liu,2018-01-24 10:31:08+08:00,['f988401d4821e0765105248baad90fd4e28e8fa2'],0,1,1,15341646,1,1,1,1,11139
52479bee2136683d824d95db857d0d3024753bb5,0,Billy Liu,2018-01-24 13:24:17+08:00,['6acb3aba1310424f9048f5eccfa2bdb42731308a'],1,1,2,15341648,1,,,,11139
0ddef025c6ec51e3758d07f103fe9655335a9d31,0,chenzhx,2018-01-24 14:20:06+08:00,['52479bee2136683d824d95db857d0d3024753bb5'],10,8,18,15341666,4,0.5,0.5,0.5,11139
8547011aa060d88161fa09bf48a5378184485d0b,0,Billy Liu,2018-01-24 14:32:54+08:00,['0ddef025c6ec51e3758d07f103fe9655335a9d31'],7,3,10,15341676,4,,,,11139
6791327d5a444d0acb2099b3396c30df03ef9396,0,chenzhx,2018-01-24 14:44:53+08:00,['8547011aa060d88161fa09bf48a5378184485d0b'],1,1,2,15341678,1,,,,11139
4f1f8a595eade778bb2c2eb4fb88504a7af003d3,0,chenzhx,2018-01-24 14:44:53+08:00,['6791327d5a444d0acb2099b3396c30df03ef9396'],3,5,8,15341686,1,1,1,1,11139
5dbc083e89a3874ad597ab385078f4a2414d9b49,0,chenzhx,2018-01-24 14:44:53+08:00,['4f1f8a595eade778bb2c2eb4fb88504a7af003d3'],0,9,9,15341695,1,1,1,1,11139
b88c6223aab7d98fb10450f5b55493f5f7268593,0,Billy Liu,2018-01-24 15:00:50+08:00,['5dbc083e89a3874ad597ab385078f4a2414d9b49'],10,13,23,15341718,1,1,,,11139
cd8beb1c0e14b250a1e5c6e647db214e1c3f0b2e,0,Billy Liu,2018-01-24 15:22:33+08:00,['b88c6223aab7d98fb10450f5b55493f5f7268593'],5,4,9,15341727,1,1,1,0,11139
4044c820d42f5b87138a1489010b0874942ef610,0,Billy Liu,2018-01-24 15:28:04+08:00,['cd8beb1c0e14b250a1e5c6e647db214e1c3f0b2e'],0,5,5,15341732,1,0,1,1,11139
47bec8595c8d64abb58f911d96e6bf0d20b76eeb,1,Billy Liu,2018-01-24 17:44:21+08:00,['4044c820d42f5b87138a1489010b0874942ef610'],3,4,7,15341739,2,,,,11139
8191b8ed39c32d8cfa30eaa596c03552db736a70,0,Billy Liu,2018-01-24 18:18:37+08:00,['47bec8595c8d64abb58f911d96e6bf0d20b76eeb'],1,9,10,15341749,1,1,1,1,11139
ff2d2727e6f8eb1ac0f4f840f1c98dd69ba60165,0,Billy Liu,2018-01-24 18:38:19+08:00,['8191b8ed39c32d8cfa30eaa596c03552db736a70'],2,1,3,15341752,2,1,0,0,11139
6346deb9fb718144cc25880e5217e2bbe5645c09,0,Billy Liu,2018-01-25 10:34:47+08:00,['ff2d2727e6f8eb1ac0f4f840f1c98dd69ba60165'],12,62,74,15341826,9,1,1,1,11140
e03c76a4098d08e606ecb819340b153effb38b6e,1,Billy Liu,2018-01-25 10:47:24+08:00,['6346deb9fb718144cc25880e5217e2bbe5645c09'],46,21,67,15341893,10,,,,11140
d7aab19d3c918fcce062e1b4b7d2475bbbcb090c,0,lidongsjtu,2018-01-25 16:39:32+08:00,['e03c76a4098d08e606ecb819340b153effb38b6e'],10,15,25,15341918,1,1,1,0,11140
c49e26393cbde59110f217939cf3165bb3984a53,0,chenzhx,2018-01-25 17:19:26+08:00,['d7aab19d3c918fcce062e1b4b7d2475bbbcb090c'],8,14,22,15341940,1,,,,11140
b66f3da5ca24522dbb39cf4bae368d63bc2ff2e9,0,chenzhx,2018-01-25 17:19:26+08:00,['c49e26393cbde59110f217939cf3165bb3984a53'],8,1,9,15341949,1,,,,11140
b4d5a142ac82873d599b0a0c798e0d9755de0f6c,1,lidongsjtu,2018-01-25 21:25:07+08:00,['b66f3da5ca24522dbb39cf4bae368d63bc2ff2e9'],42,77,119,15342068,8,0.928571429,0.928571429,1,11141
b6320da48a66dba06e49ee69d0a7e71ab3fef087,0,chenzhx,2018-01-26 14:37:01+08:00,['b4d5a142ac82873d599b0a0c798e0d9755de0f6c'],10,54,64,15342132,5,0.885714286,1,0.885714286,11141
b361844ce16ec01d4c78290a450ff705d0c84911,1,Billy Liu,2018-01-26 14:44:38+08:00,['b6320da48a66dba06e49ee69d0a7e71ab3fef087'],8,8,16,15342148,1,,,,11141
34cbd18133362fa63207a2aa7a234cc3e82c5531,0,lidongsjtu,2018-01-26 16:14:31+08:00,['b361844ce16ec01d4c78290a450ff705d0c84911'],0,1,1,15342149,1,,,,11141
a41a7e7d3a97197a16360ab41e94d9ee5c77ebc6,1,kangkaisen,2018-01-26 17:28:54+08:00,['34cbd18133362fa63207a2aa7a234cc3e82c5531'],5,117,122,15342271,7,0.636363636,0.681818182,0.977272727,11141
d30d2a30538701dc314be81e7e020e1f47f7ce78,0,Billy Liu,2018-01-26 17:40:17+08:00,['a41a7e7d3a97197a16360ab41e94d9ee5c77ebc6'],5,12,17,15342288,2,,,,11141
25bb46e0cea270cae2c5b042a5766880fc2eea02,1,Li Yang,2018-01-26 22:54:58+08:00,['d30d2a30538701dc314be81e7e020e1f47f7ce78'],41,125,166,15342454,4,0,1,1,11141
ebc53b6b72dcade8f0c9f88f36f3aa43a43ae8f8,0,Li Yang,2018-01-26 22:54:58+08:00,['25bb46e0cea270cae2c5b042a5766880fc2eea02'],3,21,24,15342478,1,0,1,1,11141
26bee6625e7a09373a9b2c39db57af0c1a5a8460,1,Li Yang,2018-01-26 22:54:58+08:00,['ebc53b6b72dcade8f0c9f88f36f3aa43a43ae8f8'],45,43,88,15342566,5,0,1,1,11141
f73219c07f5f0d5e01d801aeb274af9cf886f261,0,Li Yang,2018-01-26 22:54:58+08:00,['26bee6625e7a09373a9b2c39db57af0c1a5a8460'],2,10,12,15342578,1,1,1,1,11141
a4acb4d53ef74f8e59f46f550143c599c546ff30,0,Li Yang,2018-01-26 22:54:58+08:00,['f73219c07f5f0d5e01d801aeb274af9cf886f261'],413,59,472,15343050,5,0,0,0.116666667,11142
2ef3d4906937ad1b00bc344f8cfcbb8900ce0998,0,Li Yang,2018-01-26 22:54:58+08:00,['a4acb4d53ef74f8e59f46f550143c599c546ff30'],1,79,80,15343130,2,0.176470588,1,1,11143
8e8d71b99a340831512f7ca34cbc0098a190f1f6,0,Li Yang,2018-01-26 22:54:58+08:00,['2ef3d4906937ad1b00bc344f8cfcbb8900ce0998'],3,15,18,15343148,2,1,1,1,11143
cc130e925622bd962674b4125d9b93f62ebb12bf,1,Li Yang,2018-01-26 22:54:58+08:00,['8e8d71b99a340831512f7ca34cbc0098a190f1f6'],2,2,4,15343152,2,,,,11143
67f7197b849249df65d79bf3ec3ca090c0bb50a9,0,Li Yang,2018-01-26 22:54:58+08:00,['cc130e925622bd962674b4125d9b93f62ebb12bf'],1,19,20,15343172,2,1,1,1,11143
5bf5099e15cf732f4b77773061743558fb4508ef,0,Li Yang,2018-01-26 22:54:58+08:00,['67f7197b849249df65d79bf3ec3ca090c0bb50a9'],1,1,2,15343174,1,,,,11143
87a0058d9188d4e1140470e0df260548ade097a1,1,Li Yang,2018-01-26 22:54:58+08:00,['5bf5099e15cf732f4b77773061743558fb4508ef'],2,3,5,15343179,1,,,,11143
1f33dd93123dd59795a16193a3b5064419f4b532,1,Li Yang,2018-01-26 22:54:58+08:00,['87a0058d9188d4e1140470e0df260548ade097a1'],35,144,179,15343358,10,0.705882353,1,0.843137255,11144
c2b69155215f72a5f78bf65995390431ff424c1e,0,Li Yang,2018-01-26 22:54:58+08:00,['1f33dd93123dd59795a16193a3b5064419f4b532'],0,134,134,15343492,3,0.451219512,0.451219512,1,11145
48bccac0fd1966c89111e7e640ac4641d2eedccf,0,Li Yang,2018-01-26 22:54:58+08:00,['c2b69155215f72a5f78bf65995390431ff424c1e'],1,4,5,15343497,1,0,1,1,11145
0fce61c805f1822de6a2cc540bd96dfe46f23eb9,0,Li Yang,2018-01-26 22:54:58+08:00,['48bccac0fd1966c89111e7e640ac4641d2eedccf'],1,1,2,15343499,1,,,,11145
baf7133dabd8f1e53f5235b61da2bc5da334d870,1,Li Yang,2018-01-26 22:54:58+08:00,['0fce61c805f1822de6a2cc540bd96dfe46f23eb9'],35,151,186,15343685,6,0.734375,1,0.890625,11145
9dfd8b9c8a5ad4b185f9855b7ef167087f06d2a1,0,Li Yang,2018-01-26 22:54:58+08:00,['baf7133dabd8f1e53f5235b61da2bc5da334d870'],9,29,38,15343723,1,0,1,1,11145
adf645e319b5f49708bd6a540a0a980a7339885d,1,Li Yang,2018-01-26 22:54:58+08:00,['9dfd8b9c8a5ad4b185f9855b7ef167087f06d2a1'],12,23,35,15343758,1,0,1,1,11145
95e3d077cb69b2e8086b4646c173e0098f44f265,0,Li Yang,2018-01-26 22:54:58+08:00,['adf645e319b5f49708bd6a540a0a980a7339885d'],1,70,71,15343829,2,1,1,1,11146
d2203f430f4f9dcf0bd681b7657f31906a32a5bc,0,Li Yang,2018-01-26 22:54:58+08:00,['95e3d077cb69b2e8086b4646c173e0098f44f265'],42,1,43,15343872,4,1,0.1,0.45,11146
60caf619a2daaf06d8b783861990b5a3bd082d81,0,Li Yang,2018-01-26 22:54:58+08:00,['d2203f430f4f9dcf0bd681b7657f31906a32a5bc'],1,1,2,15343874,1,1,1,0,11146
7d5fb855064e2b81cd3b154cdeeafec4e64f63c9,1,Li Yang,2018-01-26 22:54:58+08:00,['60caf619a2daaf06d8b783861990b5a3bd082d81'],14,19,33,15343907,2,1,1,1,11146
0ae39b5bb1cb05d3660ffb94c125cd8e85b91902,1,Li Yang,2018-01-26 22:54:58+08:00,['7d5fb855064e2b81cd3b154cdeeafec4e64f63c9'],0,16,16,15343923,1,0.923076923,0.923076923,1,11146
0988c846823ca65a46eb6ab9b3dcee443da57872,0,Li Yang,2018-01-26 22:54:58+08:00,['0ae39b5bb1cb05d3660ffb94c125cd8e85b91902'],0,10,10,15343933,1,1,1,1,11146
55365b68dfa021f5c14acbd79e2417f55b294473,0,Li Yang,2018-01-26 22:54:58+08:00,['0988c846823ca65a46eb6ab9b3dcee443da57872'],4,74,78,15344011,2,0.325,0.675,0.7,11147
a31bce69dfef5ee8070e8b642cdcfbcfde404a60,0,Li Yang,2018-01-26 22:54:58+08:00,['55365b68dfa021f5c14acbd79e2417f55b294473'],16,12,28,15344039,1,0,0,0,11147
195fdef501ee03f5e31fdae81d282f3e0cf1ee0f,0,Li Yang,2018-01-26 22:54:58+08:00,['a31bce69dfef5ee8070e8b642cdcfbcfde404a60'],0,2,2,15344041,1,0,1,1,11147
35979ff0875d06cb4b1cc4b151efe6af37d1318d,1,Li Yang,2018-01-26 22:54:58+08:00,['195fdef501ee03f5e31fdae81d282f3e0cf1ee0f'],58,115,173,15344214,4,0,1,1,11148
16236ef30cde20e474740fdee693ce26dbd88155,0,Li Yang,2018-01-26 22:54:58+08:00,['35979ff0875d06cb4b1cc4b151efe6af37d1318d'],14,21,35,15344249,2,0.5,1,0.5,11148
59d5064673282ba36783e0796523ad83c2dc5e8c,0,Li Yang,2018-01-26 22:54:58+08:00,['16236ef30cde20e474740fdee693ce26dbd88155'],41,47,88,15344337,5,0,0,0,11148
543124dab1ec1e6f23ea8cc63c97abc89a1eae0d,0,Li Yang,2018-01-26 22:54:58+08:00,['59d5064673282ba36783e0796523ad83c2dc5e8c'],0,89,89,15344426,2,1,1,1,11149
ce1775a5ab0e775bce6685e7801f114a4aff9b9b,0,Li Yang,2018-01-26 22:54:58+08:00,['543124dab1ec1e6f23ea8cc63c97abc89a1eae0d'],4,10,14,15344440,3,0.833333333,1,1,11149
73554fa71cd4bb519b19dab3c9e4a19e19d33d1e,0,Li Yang,2018-01-26 22:54:58+08:00,['ce1775a5ab0e775bce6685e7801f114a4aff9b9b'],4,27,31,15344471,2,0.058823529,1,1,11149
8e2744925034eb8715a59beaaf89d507beb65288,0,Li Yang,2018-01-26 22:54:58+08:00,['73554fa71cd4bb519b19dab3c9e4a19e19d33d1e'],4,6,10,15344481,1,0,1,1,11149
7dc1875831d225d9968e587599ee274d8d1a93f8,1,lidongsjtu,2018-01-26 23:09:01+08:00,['8e2744925034eb8715a59beaaf89d507beb65288'],0,1283,1283,15345764,8,1,1,1,11155
c96e1b1947ca8764066ff4390ea1f9e4aa0f6c40,1,lidongsjtu,2018-01-28 15:57:30+08:00,['7dc1875831d225d9968e587599ee274d8d1a93f8'],114,202,316,15346080,9,0.379310345,0,1,11157
74e3f614d6a9cc2807865b8fb210836880b8da85,0,lidongsjtu,2018-01-28 19:42:26+08:00,['c96e1b1947ca8764066ff4390ea1f9e4aa0f6c40'],205,182,387,15346467,13,0.066666667,1,1,11159
9198cfe8f1439246eff6abff38b3869453325aca,0,lidongsjtu,2018-01-28 19:43:00+08:00,['74e3f614d6a9cc2807865b8fb210836880b8da85'],4,4,8,15346475,2,,,,11159
5eedd135d27da96c2242079fd9e188fce0518f90,0,lidongsjtu,2018-01-28 19:55:07+08:00,['9198cfe8f1439246eff6abff38b3869453325aca'],8,20,28,15346503,1,0.272727273,0.909090909,0.727272727,11159
0f63fa617ffc9604e61ba024f8dcf8acb30a54a2,0,Zhong,2018-01-30 11:24:41+08:00,['5eedd135d27da96c2242079fd9e188fce0518f90'],2,4,6,15346509,2,,,,11159
4c31b1d4a582522a7a2109bed470d4f65a145c44,0,chenzhx,2018-01-30 16:59:42+08:00,['0f63fa617ffc9604e61ba024f8dcf8acb30a54a2'],1,2,3,15346512,2,0,1,1,11159
b07a05666d5474a9089fcd38219ffa204809ba10,1,lidongsjtu,2018-01-30 17:23:32+08:00,['4c31b1d4a582522a7a2109bed470d4f65a145c44'],30,28,58,15346570,2,0,,,11159
fee5730258a5082999bcf8d3141aa4cb179b693c,0,lidongsjtu,2018-01-30 17:28:58+08:00,['b07a05666d5474a9089fcd38219ffa204809ba10'],5,5,10,15346580,1,,,,11159
c704f7cda79921c5a22645492a52c94734847541,0,lidongsjtu,2018-01-30 19:10:51+08:00,['fee5730258a5082999bcf8d3141aa4cb179b693c'],33,87,120,15346700,2,0.163265306,0,0.591836735,11159
6a2ee80c9ec19be1d7e72ed8b587fbc48a195867,0,lidongsjtu,2018-01-30 21:45:18+08:00,['c704f7cda79921c5a22645492a52c94734847541'],25,49,74,15346774,6,0.666666667,1,0.8,11159
ff8bece2114dc6c2a401b0b774ad14d530fd8c65,0,Billy Liu,2018-01-31 11:45:31+08:00,['6a2ee80c9ec19be1d7e72ed8b587fbc48a195867'],1,11,12,15346786,1,,,,11159
490891e39ca3176f67058a3f7cd4b15fe3941b99,1,Billy Liu,2018-01-31 17:23:27+08:00,['ff8bece2114dc6c2a401b0b774ad14d530fd8c65'],63,124,187,15346973,8,,,,11159
c771833434523aecef2e6f33d9055a92a2c6f7cb,0,shaofengshi,2018-02-01 09:43:13+08:00,['490891e39ca3176f67058a3f7cd4b15fe3941b99'],3,17,20,15346993,1,,,,11159
f797c84044f52f9c351ad680bc3a8a3482781121,0,Li Yang,2018-02-04 08:44:22+08:00,['c771833434523aecef2e6f33d9055a92a2c6f7cb'],110,102,212,15347205,6,1,1,0.431818182,11161
da14ee94bcc5b91fabf99954b88819cc513effea,0,Li Yang,2018-02-04 08:44:45+08:00,['f797c84044f52f9c351ad680bc3a8a3482781121'],11,15,26,15347231,1,0,0,1,11161
4ade239fd0ba027fda70b2e61f2a510ee31fbaea,0,Li Yang,2018-02-04 08:45:09+08:00,['da14ee94bcc5b91fabf99954b88819cc513effea'],0,1,1,15347232,1,0,0,0,11161
04b3220739713a7d157e6a286fabea5a5036fad4,0,Li Yang,2018-02-04 08:45:40+08:00,['4ade239fd0ba027fda70b2e61f2a510ee31fbaea'],6,9,15,15347247,2,1,1,0.666666667,11161
76dc049717632eaf1f4c80e58ce61fa6081ae24f,0,Li Yang,2018-02-04 09:43:53+08:00,['04b3220739713a7d157e6a286fabea5a5036fad4'],3,3,6,15347253,1,,,,11161
a2af43d409fb6493b43b7cb525d0e8884e2d5828,0,shaofengshi,2018-02-04 21:08:13+08:00,['76dc049717632eaf1f4c80e58ce61fa6081ae24f'],2,4,6,15347259,1,0,0,1,11161
4a29d92e8cb5e92dc97ac18181417893c0d79d9b,0,Billy Liu,2018-02-04 22:31:31+08:00,['a2af43d409fb6493b43b7cb525d0e8884e2d5828'],13,57,70,15347329,1,0.1875,0.875,1,11161
61f36a270aa218fb3b221f695b74f86e6b433d8d,0,Zhong,2018-02-05 14:50:00+08:00,['4a29d92e8cb5e92dc97ac18181417893c0d79d9b'],38,42,80,15347409,2,0.5,0.5,1,11161
148f5c6ca7a2296cb011cc1e710830cea1fd1ac3,1,chenzhx,2018-02-05 16:20:43+08:00,['61f36a270aa218fb3b221f695b74f86e6b433d8d'],30,17,47,15347456,3,1,1,1,11161
d4c8fbcc58c5b237be5bfa7f1cc06400976f8551,0,chenzhx,2018-02-05 17:04:03+08:00,['148f5c6ca7a2296cb011cc1e710830cea1fd1ac3'],1,1,2,15347458,1,,,,11161
d31a009887f7d8b849abb560812318533836e5f8,1,Billy Liu,2018-02-05 22:16:07+08:00,['d4c8fbcc58c5b237be5bfa7f1cc06400976f8551'],4,13,17,15347475,1,1,1,1,11161
5bc5e659dc6513e560ca14f4de696af2f79fac67,0,Billy Liu,2018-02-05 22:55:36+08:00,['d31a009887f7d8b849abb560812318533836e5f8'],27,11,38,15347513,3,0,0,0,11161
ff6f6c73ab7752cdf4ba6009a0ac09b94b5c738b,0,chenzhx,2018-02-06 15:14:23+08:00,['5bc5e659dc6513e560ca14f4de696af2f79fac67'],17,2,19,15347532,2,0.142857143,0,0,11161
ebfce48f36740c1533764d9a83b8f45aef412999,0,chenzhx,2018-02-06 15:20:06+08:00,['ff6f6c73ab7752cdf4ba6009a0ac09b94b5c738b'],3,3,6,15347538,1,,,,11161
eac03cdcd97e2b5c16280c7c356afd5525b9fc67,0,shaofengshi,2018-02-06 20:45:42+08:00,['ebfce48f36740c1533764d9a83b8f45aef412999'],1,9,10,15347548,1,1,1,1,11161
c686b8436369df1fa951a42f179caa72984e1597,0,chenzhx,2018-02-07 10:27:33+08:00,['eac03cdcd97e2b5c16280c7c356afd5525b9fc67'],37,42,79,15347627,3,1,1,1,11161
0432487ed867b5355765c37b872f8480c2e00535,0,chenzhx,2018-02-07 12:59:42+08:00,['c686b8436369df1fa951a42f179caa72984e1597'],1,2,3,15347630,1,0,1,1,11161
9347f0b4fc236b68b956cec5eed6592e50eaaea0,0,Billy Liu,2018-02-07 13:34:12+08:00,['0432487ed867b5355765c37b872f8480c2e00535'],0,59,59,15347689,1,,,,11161
0bc0677714f262095f8099581f1ec15a783142b5,1,Billy Liu,2018-02-08 13:55:27+08:00,['9347f0b4fc236b68b956cec5eed6592e50eaaea0'],1,1,2,15347691,1,,,,11161
56ec6af45c2a6f407e04f03eb08d986fb9770278,0,chenzhx,2018-02-08 14:24:28+08:00,['0bc0677714f262095f8099581f1ec15a783142b5'],11,11,22,15347713,2,,,,11161
ce76ed9df42844be04eb5bca2651fa5ba34477d8,0,chenzhx,2018-02-08 14:25:20+08:00,['56ec6af45c2a6f407e04f03eb08d986fb9770278'],1,1,2,15347715,1,,,,11161
6a558d88271f3975cd71c6d3e61c1a7f658ed367,0,chenzhx,2018-02-08 15:17:11+08:00,['ce76ed9df42844be04eb5bca2651fa5ba34477d8'],2,14,16,15347731,1,0.019230769,1,1,11161
d06b72e3e9d868dee475f4b1add3e50131683c98,0,Billy Liu,2018-02-08 15:47:01+08:00,['6a558d88271f3975cd71c6d3e61c1a7f658ed367'],2,2,4,15347735,2,,,,11161
bc040a9ddbd3f94d7a865eb192eeb94dcccd8f26,0,shaofengshi,2018-02-08 16:04:56+08:00,['d06b72e3e9d868dee475f4b1add3e50131683c98'],2,4,6,15347741,2,,,,11161
8826e1dedf33b7a6df7ea0615b5ec66736807419,1,Billy Liu,2018-02-08 17:14:59+08:00,['bc040a9ddbd3f94d7a865eb192eeb94dcccd8f26'],2,11,13,15347754,3,1,1,1,11161
46d4f97c27c39f6eacc32f974bc17ba6860f50df,0,Billy Liu,2018-02-09 09:12:07+08:00,['8826e1dedf33b7a6df7ea0615b5ec66736807419'],4,14,18,15347772,1,,,,11161
5075f590d843e808186f9d859e0c09ab1877fb0b,1,shaofengshi,2018-02-09 09:53:48+08:00,['46d4f97c27c39f6eacc32f974bc17ba6860f50df'],18,79,97,15347869,5,0.622222222,1,0.911111111,11161
01bd0d41475962e4f63e09c17c0bb1cd319384db,1,shaofengshi,2018-02-09 09:57:35+08:00,['5075f590d843e808186f9d859e0c09ab1877fb0b'],4,7,11,15347880,1,0,0,0,11161
50435e1143430f3f5c601c1eab22e9fe37c7bf98,0,shaofengshi,2018-02-09 09:59:01+08:00,['01bd0d41475962e4f63e09c17c0bb1cd319384db'],0,1,1,15347881,1,0,1,1,11161
0655dbc383790f61ef9b04cd23b6b6ebf5f2ff6e,1,Billy Liu,2018-02-09 10:51:17+08:00,['50435e1143430f3f5c601c1eab22e9fe37c7bf98'],15,34,49,15347930,1,0,0,1,11161
0550cc3a061dac2714763d153afdd3228e448b66,0,chenzhx,2018-02-09 11:29:16+08:00,['0655dbc383790f61ef9b04cd23b6b6ebf5f2ff6e'],5,17,22,15347952,3,1,1,1,11161
d4f9d564bc643c5fd4375f2eb5d5ad15caa31269,0,lidongsjtu,2018-02-09 13:55:27+08:00,['0550cc3a061dac2714763d153afdd3228e448b66'],5,11,16,15347968,1,0,0.4,0.6,11161
139c303d4519e6c6700465f6477a3c3b0db2dbae,1,chenzhx,2018-02-09 14:42:49+08:00,['d4f9d564bc643c5fd4375f2eb5d5ad15caa31269'],3,156,159,15348127,4,1,1,1,11162
65c2315d4e5396b50294c9bbe03f3a0307c92904,1,Billy Liu,2018-02-09 21:19:09+08:00,['139c303d4519e6c6700465f6477a3c3b0db2dbae'],12,168,180,15348307,10,0.431818182,1,0.363636364,11163
5cecbce26301a40bd436132efe1bc611ed86779a,0,Billy Liu,2018-02-09 21:19:52+08:00,['65c2315d4e5396b50294c9bbe03f3a0307c92904'],6,5,11,15348318,4,,,,11163
509906641dc819ecc03bb1050bcdc33e1236e6cf,0,Billy Liu,2018-02-09 21:20:03+08:00,['5cecbce26301a40bd436132efe1bc611ed86779a'],1,53,54,15348372,1,0,1,1,11163
da0e6b04a67e9dbe6adc7ed35bcdb25dae247eb2,0,Billy Liu,2018-02-09 21:32:44+08:00,['509906641dc819ecc03bb1050bcdc33e1236e6cf'],1,1,2,15348374,1,,,,11163
c86f30f88a0713dabee8f9ca5dd99be9b063214f,1,Billy Liu,2018-02-09 21:37:52+08:00,['da0e6b04a67e9dbe6adc7ed35bcdb25dae247eb2'],72,75,147,15348521,5,1,1,1,11163
82f76db0a6fe8c71c93526e935e25e7a85535586,0,Zhong,2018-02-10 10:57:22+08:00,['c86f30f88a0713dabee8f9ca5dd99be9b063214f'],0,30,30,15348551,15,,,,11163
3fa11b2cffa4e9159b4a5f911dfb1eb1b7c08005,0,Billy Liu,2018-02-10 22:24:00+08:00,['82f76db0a6fe8c71c93526e935e25e7a85535586'],8,2,10,15348561,1,1,1,0,11163
2fd676b36ec9e0f853d59db31ee62cd90a647641,0,peng.jianhua,2018-02-12 00:22:50+08:00,['3fa11b2cffa4e9159b4a5f911dfb1eb1b7c08005'],0,8,8,15348569,1,1,1,1,11163
17435fa6a93214300ec8e8e5e42019db1b774144,1,lidongsjtu,2018-02-12 09:52:09+08:00,['2fd676b36ec9e0f853d59db31ee62cd90a647641'],3,19,22,15348591,1,0,1,0,11163
24c489a4a17e186ee73f9285bc082f517243126e,0,lidongsjtu,2018-02-12 09:52:18+08:00,['17435fa6a93214300ec8e8e5e42019db1b774144'],20,145,165,15348756,1,0,0,1,11163
f1e9f1882113df6bc053905a5f31e0346384f0cd,1,lidongsjtu,2018-02-12 09:57:13+08:00,['24c489a4a17e186ee73f9285bc082f517243126e'],2,7,9,15348765,2,0,1,1,11163
714aee04e1ee8964c0e5309fed3bbf711b995f13,0,peng.jianhua,2018-02-12 14:12:37+08:00,['f1e9f1882113df6bc053905a5f31e0346384f0cd'],7,0,7,15348772,1,0,0,0,11163
e59c33e1994c04f2adde06894fe68320a01557c0,0,Billy Liu,2018-02-12 16:21:16+08:00,['714aee04e1ee8964c0e5309fed3bbf711b995f13'],3,3,6,15348778,3,,,,11163
99d68c8b66d47f5b6d24d5df272faca1f8bc52dd,0,lidongsjtu,2018-02-13 13:11:20+08:00,['e59c33e1994c04f2adde06894fe68320a01557c0'],1,1,2,15348780,1,,,,11163
c234f8f24527cf0be831fc59af2e487d6f2b20c0,0,Billy Liu,2018-02-13 17:48:05+08:00,['99d68c8b66d47f5b6d24d5df272faca1f8bc52dd'],0,1,1,15348781,1,,,,11163
519f486b8589e08e44be7e5a6708535b391c98a5,1,Billy Liu,2018-02-15 18:31:23+08:00,['c234f8f24527cf0be831fc59af2e487d6f2b20c0'],9,15,24,15348805,2,,,,11163
3be7af98a0f8017858f197ee7e8e8fe525be3c0f,0,GitHub,2018-02-15 19:19:14+08:00,"['c234f8f24527cf0be831fc59af2e487d6f2b20c0', '519f486b8589e08e44be7e5a6708535b391c98a5']",9,15,24,15348829,2,,,,11163
21ef4d6e4bb62eb3f5209b14daaa8ab404d0f4c5,1,Billy Liu,2018-02-20 20:30:13+08:00,['3be7af98a0f8017858f197ee7e8e8fe525be3c0f'],3,3,6,15348835,1,,,,11163
74dff9fa36ea937e947a0cc5a96f373d7c2f372d,1,Jiatao Tao,2018-02-23 19:00:13+08:00,['21ef4d6e4bb62eb3f5209b14daaa8ab404d0f4c5'],94,37,131,15348966,3,0,0.481481481,0,11163
66ea154ecee74a18066e9b6ea706e7232fb19bf5,0,GitHub,2018-02-23 23:23:32+08:00,"['21ef4d6e4bb62eb3f5209b14daaa8ab404d0f4c5', '74dff9fa36ea937e947a0cc5a96f373d7c2f372d']",94,37,131,15349097,3,,,,11163
23641a2ee31bed105575671d565b006f3ca257c4,0,liapan,2018-02-24 14:22:28+08:00,['66ea154ecee74a18066e9b6ea706e7232fb19bf5'],17,19,36,15349133,1,1,1,1,11163
865e377b6803caa2e2b2aeab2e5bb77f6470c3e6,0,GitHub,2018-02-24 16:42:10+08:00,"['66ea154ecee74a18066e9b6ea706e7232fb19bf5', '23641a2ee31bed105575671d565b006f3ca257c4']",17,19,36,15349169,1,,,,11163
045b22df330ff5425bdc0538564a2fbd653733e5,1,Billy Liu,2018-02-28 22:52:12+08:00,['865e377b6803caa2e2b2aeab2e5bb77f6470c3e6'],3,3,6,15349175,2,,,,11163
2b38b3b59dcf5de154dc0815f44b90b611c2b29e,0,Billy Liu,2018-02-28 22:59:52+08:00,['045b22df330ff5425bdc0538564a2fbd653733e5'],0,1,1,15349176,1,,,,11163
76934db8fcddabf437f490e77c8f06c9a4a3db86,1,Billy Liu,2018-02-28 23:47:11+08:00,['2b38b3b59dcf5de154dc0815f44b90b611c2b29e'],34,50,84,15349260,4,0.428571429,0,1,11163
31cc006284c1a496a8284db0b4eee7cf12a630e9,0,chenzhx,2018-03-01 10:14:16+08:00,['76934db8fcddabf437f490e77c8f06c9a4a3db86'],1,14,15,15349275,4,0.4,1,0.8,11163
6afe7130a06c0264c9578c6f70e315819490cacb,0,GitHub,2018-03-01 10:29:23+08:00,"['76934db8fcddabf437f490e77c8f06c9a4a3db86', '31cc006284c1a496a8284db0b4eee7cf12a630e9']",1,14,15,15349290,4,,,,11163
39ef73ccade23fe3c0e95ea1e29b5090d9b16e76,0,Zhixiong Chen,2018-03-02 16:59:17+08:00,['6afe7130a06c0264c9578c6f70e315819490cacb'],4,16,20,15349310,2,0.666666667,0.75,1,11163
c5e46bbf93e6ba6092cab3bd364f19680d23ac30,1,Li Yang,2018-03-03 09:25:26+08:00,['39ef73ccade23fe3c0e95ea1e29b5090d9b16e76'],18,52,70,15349380,4,0,0,1,11163
d63160d2df0ea7db7f919d10a5f94c3f05bb6653,0,Li Yang,2018-03-03 09:27:10+08:00,['c5e46bbf93e6ba6092cab3bd364f19680d23ac30'],5,39,44,15349424,3,0,1,0.47826087,11163
4823d8b0f5b344f4b94b82bd7c8bc1d5bc7bc07a,0,Li Yang,2018-03-03 10:13:17+08:00,['d63160d2df0ea7db7f919d10a5f94c3f05bb6653'],10,105,115,15349539,3,0.782608696,1,1,11164
24d319eddc58a4ab5a612c11b7a824582afb3b92,0,Li Yang,2018-03-03 10:15:07+08:00,['4823d8b0f5b344f4b94b82bd7c8bc1d5bc7bc07a'],1,1,2,15349541,1,,,,11164
4b2ead2c5d3b9f465a166416477972741a016b5c,0,Yang Li,2018-03-03 10:29:25+08:00,['24d319eddc58a4ab5a612c11b7a824582afb3b92'],2,6,8,15349549,3,0,1,1,11164
c6829f133f593ce8ee327baf8b797be781b73e27,0,Li Yang,2018-03-03 12:08:02+08:00,['4b2ead2c5d3b9f465a166416477972741a016b5c'],12,12,24,15349573,1,,,,11164
a040c9a7f419fa1599d35f3becea3f4d67cfcef3,0,Yang Li,2018-03-03 12:26:20+08:00,['c6829f133f593ce8ee327baf8b797be781b73e27'],33,42,75,15349648,1,1,0,1,11164
31af5c27870dfefb2d1c626a35a4202606faed84,0,Yang Li,2018-03-03 12:29:38+08:00,['a040c9a7f419fa1599d35f3becea3f4d67cfcef3'],1,1,2,15349650,1,,,,11164
0efcf9c9e66879bbee633d9799aa529aefcde543,1,Yang Li,2018-03-03 12:32:11+08:00,['31af5c27870dfefb2d1c626a35a4202606faed84'],5,16,21,15349671,1,0,1,1,11164
451b7bae796e47358900678ac18dce24a2e6d8df,1,Yang Li,2018-03-03 12:33:36+08:00,['0efcf9c9e66879bbee633d9799aa529aefcde543'],6,80,86,15349757,6,0.107142857,0,0.75,11165
a05a4d0058976f7a940fdf840643ab7c820ff6e4,0,Yang Li,2018-03-03 12:35:01+08:00,['451b7bae796e47358900678ac18dce24a2e6d8df'],51,1968,2019,15351776,26,0.568627451,0.509803922,1,11189
8e55ba90096613012097807acedfc0e42dc3407d,0,Billy Liu,2018-03-04 13:12:03+08:00,['a05a4d0058976f7a940fdf840643ab7c820ff6e4'],1,1,2,15351778,1,,,,11189
81129cf25a4bd9d191a68cda9d0e69384a930e3a,1,Billy Liu,2018-03-04 13:12:09+08:00,['8e55ba90096613012097807acedfc0e42dc3407d'],95,62,157,15351935,26,,,,11189
1d4b2d3ff4cd2c0b8457b4f1ce02f96c69daf616,1,Billy Liu,2018-03-04 13:12:15+08:00,['81129cf25a4bd9d191a68cda9d0e69384a930e3a'],28,28,56,15351991,26,,,,11189
eae0c95ccb95f5a5a040127ac5ee4d3ff414ba13,0,Billy Liu,2018-03-04 13:12:22+08:00,['1d4b2d3ff4cd2c0b8457b4f1ce02f96c69daf616'],1,1,2,15351993,1,,,,11189
1e7825bd8b69ad7517298175d2d5bb0fde578fca,0,Billy Liu,2018-03-04 13:21:37+08:00,['eae0c95ccb95f5a5a040127ac5ee4d3ff414ba13'],1,1,2,15351995,1,,,,11189
62bfc5f70e9553f0c95fe160dbf63f8d20ec3d52,1,Billy(Yiming) Liu,2018-03-06 09:53:16-08:00,['1e7825bd8b69ad7517298175d2d5bb0fde578fca'],498,1189,1687,15353682,16,0.932075472,1,1,11195
4de8bfc92814410155fa42b9a030bb86986e9652,1,Billy(Yiming) Liu,2018-03-06 09:53:16-08:00,['62bfc5f70e9553f0c95fe160dbf63f8d20ec3d52'],66,161,227,15353909,10,1,1,0.850746269,11195
94a197849e9fb46b52e898adb01cd81a7bc12d78,0,Billy(Yiming) Liu,2018-03-06 09:53:16-08:00,['4de8bfc92814410155fa42b9a030bb86986e9652'],126,74,200,15354109,3,0.775,0.775,0,11195
5807cdf70f8e8215566fcb20ae3b900f20f8ed27,0,Billy(Yiming) Liu,2018-03-06 09:53:16-08:00,['94a197849e9fb46b52e898adb01cd81a7bc12d78'],8,23,31,15354140,4,1,1,0,11195
7c9892b2f8163d63536d4b5e76759186584c3d60,1,Billy(Yiming) Liu,2018-03-06 09:53:16-08:00,['5807cdf70f8e8215566fcb20ae3b900f20f8ed27'],65,217,282,15354422,6,0.725806452,1,0.85483871,11197
fde86c2d67bdc08b057ab31698a7b01986518b34,0,Billy(Yiming) Liu,2018-03-06 09:53:16-08:00,['7c9892b2f8163d63536d4b5e76759186584c3d60'],3,106,109,15354531,5,0.534246575,1,0.794520548,11197
56e73333dc6f4b7e074826070c806209d0bdab79,0,Billy(Yiming) Liu,2018-03-06 09:53:16-08:00,['fde86c2d67bdc08b057ab31698a7b01986518b34'],36,134,170,15354701,2,0.45,1,1,11198
9ab6b52c1a40a69e6793a76e3fc2f53d18d1b57e,0,Yang Li,2018-03-11 14:21:27+08:00,['56e73333dc6f4b7e074826070c806209d0bdab79'],26,544,570,15355271,11,0.701923077,1,0.509615385,11206
24d2d6590d1e31edb5f5b7da11c51c477f9d2dcf,0,Yang Li,2018-03-11 14:22:25+08:00,['9ab6b52c1a40a69e6793a76e3fc2f53d18d1b57e'],1,15,16,15355287,1,0.5,0.5,0,11206
c2ef3c62a96ca52ef673335f621232d6d664c24a,0,Yang Li,2018-03-11 14:22:51+08:00,['24d2d6590d1e31edb5f5b7da11c51c477f9d2dcf'],1,4,5,15355292,1,1,1,0,11206
06f497eb603134a6b0ddbfd88739ccaddab007fb,0,Li Yang,2018-03-11 14:24:28+08:00,['c2ef3c62a96ca52ef673335f621232d6d664c24a'],10,21,31,15355323,1,0,0,1,11206
f26969cca2157fe4001714676d8ff5c11e59cf8b,0,Jiatao Tao,2018-03-12 20:20:13+08:00,['06f497eb603134a6b0ddbfd88739ccaddab007fb'],2,3,5,15355328,2,,,,11206
ac0573840929eb888cf7b55a545d8c4a19cbc89c,0,GitHub,2018-03-12 20:27:45+08:00,"['06f497eb603134a6b0ddbfd88739ccaddab007fb', 'f26969cca2157fe4001714676d8ff5c11e59cf8b']",2,3,5,15355333,2,,,,11206
a74cb8a8258d46e2021aacd63c3a6d131b09ede1,1,Billy(Yiming) Liu,2018-03-12 17:22:10-07:00,['ac0573840929eb888cf7b55a545d8c4a19cbc89c'],11,70,81,15355414,2,0,0.86440678,0.86440678,11206
ef89806e67145f771aedbb60585e2db05d42076e,0,Billy(Yiming) Liu,2018-03-12 17:26:13-07:00,['a74cb8a8258d46e2021aacd63c3a6d131b09ede1'],1,1,2,15355416,1,,,,11206
cb3913b681a1230130376215cfa30477eb3692f0,0,Billy Liu,2018-03-13 15:15:54-07:00,['ef89806e67145f771aedbb60585e2db05d42076e'],0,7,7,15355423,1,,,,11206
537ae8afd1c60d374980c099e5c5fead2c215684,0,Billy Liu,2018-03-13 15:18:29-07:00,['cb3913b681a1230130376215cfa30477eb3692f0'],0,0,0,15355423,1,,,,11207
cf6d76d2dd5c96d3979481fe4d7ca69bbb626b30,0,Billy(Yiming) Liu,2018-03-14 14:10:48-07:00,['537ae8afd1c60d374980c099e5c5fead2c215684'],1,1,2,15355425,1,,,,11207
0b4e35b817d908280fd399722dfbb69a3162c6b6,1,Li Yang,2018-03-17 08:22:37+08:00,['cf6d76d2dd5c96d3979481fe4d7ca69bbb626b30'],39,64,103,15355528,3,1,1,1,11208
6ba2fcaafc3c849851eed1e790318d1bc015fd7f,1,Li Yang,2018-03-17 08:27:44+08:00,['0b4e35b817d908280fd399722dfbb69a3162c6b6'],2,45,47,15355575,3,0.344827586,1,1,11208
09689e24855a6c4ed57f0f55c226f4929fc180e7,0,Li Yang,2018-03-17 17:50:34+08:00,['6ba2fcaafc3c849851eed1e790318d1bc015fd7f'],3,3,6,15355581,1,,,,11208
8a9ed59213bb2f2d06ef99e836d7b21e37413112,0,Li Yang,2018-03-17 17:50:40+08:00,['09689e24855a6c4ed57f0f55c226f4929fc180e7'],24,72,96,15355677,6,1,1,1,11209
4e0bb70f72e6fcc11bacd7d8ede996ede5449560,1,Li Yang,2018-03-17 17:50:41+08:00,['8a9ed59213bb2f2d06ef99e836d7b21e37413112'],7,95,102,15355779,6,0.75,0.916666667,1,11210
6122f0675d05e10ade86c45a0dc64dfb20e728f3,0,Li Yang,2018-03-17 17:50:41+08:00,['4e0bb70f72e6fcc11bacd7d8ede996ede5449560'],4,333,337,15356116,10,0.957142857,0.514285714,0.728571429,11217
b81d7a2df289029768edd6532e63eae251f28b41,1,Li Yang,2018-03-17 22:26:53+08:00,['6122f0675d05e10ade86c45a0dc64dfb20e728f3'],7,122,129,15356245,9,0.434210526,0.460526316,0.276315789,11219
4bcd8a14d3fcce385057275fcae10520abe2ead2,0,GitHub,2018-03-18 17:23:50+08:00,"['cf6d76d2dd5c96d3979481fe4d7ca69bbb626b30', 'b81d7a2df289029768edd6532e63eae251f28b41']",83,731,814,15357059,31,,,,11219
e7343f8459fd7d85ba40076f17146c2cf9cd758e,0,Dong Li,2018-03-19 11:14:36+08:00,['4bcd8a14d3fcce385057275fcae10520abe2ead2'],2,0,2,15357061,2,0,0,0,11219
ec8186e52a152b033c00ed6befa7fa9edaae31a5,0,shaofengshi,2018-03-21 09:59:12+08:00,['e7343f8459fd7d85ba40076f17146c2cf9cd758e'],1,1,2,15357063,1,,,,11219
3282fafb77c43729a241f99a50f010350db0f95d,1,shaofengshi,2018-03-21 10:23:29+08:00,['ec8186e52a152b033c00ed6befa7fa9edaae31a5'],1,6,7,15357070,1,,,,11219
0029d8a77a4588e613f766f3218595cf33e1fb2e,0,shaofengshi,2018-03-21 11:16:53+08:00,['3282fafb77c43729a241f99a50f010350db0f95d'],129,7,136,15357206,5,0.7,0,0,11219
6cc59cfb3c766f5dda77517be8a2bcf21c065c30,0,shaofengshi,2018-03-21 11:30:01+08:00,['0029d8a77a4588e613f766f3218595cf33e1fb2e'],0,2,2,15357208,1,,,,11219
236e6f557e3fdfa0a3b07cc86c710c02220f0c80,0,shaofengshi,2018-03-21 14:02:43+08:00,['6cc59cfb3c766f5dda77517be8a2bcf21c065c30'],7,5,12,15357220,2,,,,11219
24042e2209d85b0c8de98a86d9a573aff182d9c9,0,shaofengshi,2018-03-21 18:32:08+08:00,['236e6f557e3fdfa0a3b07cc86c710c02220f0c80'],58,132,190,15357410,5,0.068965517,0.431034483,0.517241379,11219
cfb21d7c97d72c9c4dfc1079b7d147ef8363b2f4,0,Zhixiong Chen,2018-03-23 10:02:32+08:00,['24042e2209d85b0c8de98a86d9a573aff182d9c9'],1,1,2,15357412,1,,,,11219
a7a0baa319c8f609be0142e7098141f518b972fb,1,Dong Li,2018-03-23 16:15:15+08:00,['cfb21d7c97d72c9c4dfc1079b7d147ef8363b2f4'],3,17,20,15357432,1,0.777777778,1,1,11219
03316e2ebf5efed203ef16e2cd27b7541d3ff09d,1,kyotoYaho,2018-03-26 22:26:29+08:00,['a7a0baa319c8f609be0142e7098141f518b972fb'],1609,447,2056,15359488,31,0.267267267,0.186186186,0.021021021,11220
8350de4493ac792a62878a1aebf6588b3119e4bb,0,Billy(Yiming) Liu,2018-03-27 16:14:28+08:00,['03316e2ebf5efed203ef16e2cd27b7541d3ff09d'],4,47,51,15359539,3,1,1,1,11221
565a442dc388b67578b5099810de0b5925867d60,0,Zhong,2018-03-27 17:22:36+08:00,['8350de4493ac792a62878a1aebf6588b3119e4bb'],10,5,15,15359554,1,0,0,0,11221
aff6f4257313472bdeed2c391e01f68934905f13,0,Shaofeng Shi,2018-04-04 12:12:07+08:00,['565a442dc388b67578b5099810de0b5925867d60'],1,17,18,15359572,1,1,1,1,11221
2e4912892ffdf36a173c2dd09d5af48d4a9eab4f,0,Shaofeng Shi,2018-04-04 12:12:07+08:00,['aff6f4257313472bdeed2c391e01f68934905f13'],1,1,2,15359574,1,,,,11221
a6bfc9d019b7df4d96d46db2b8e010323fe4fddf,1,Shaofeng Shi,2018-04-04 12:12:07+08:00,['2e4912892ffdf36a173c2dd09d5af48d4a9eab4f'],22,26,48,15359622,10,0.666666667,1,0,11221
febabc400944ab71f4bb3106394b37b1be21f49d,0,Shaofeng Shi,2018-04-04 12:12:07+08:00,['a6bfc9d019b7df4d96d46db2b8e010323fe4fddf'],0,12,12,15359634,1,1,1,1,11221
cfe84a18f3f54d405ceb394ed3b40bd4b09a692b,1,Shaofeng Shi,2018-04-04 12:12:07+08:00,['febabc400944ab71f4bb3106394b37b1be21f49d'],49,115,164,15359798,3,0.615384615,0.615384615,1,11222
417c4b646eb28c3f5dd51378e5cac1546e65c7ff,0,Shaofeng Shi,2018-04-04 12:12:07+08:00,['cfe84a18f3f54d405ceb394ed3b40bd4b09a692b'],19,50,69,15359867,4,1,1,1,11223
343d63d19d281905c2900b250c11d5375d68503d,1,Shaofeng Shi,2018-04-04 12:12:07+08:00,['417c4b646eb28c3f5dd51378e5cac1546e65c7ff'],8,11,19,15359886,5,,,,11223
37d3cd9987e4fdd43e569ccb38be37ba1d2a3d4e,0,Shaofeng Shi,2018-04-04 12:12:07+08:00,['343d63d19d281905c2900b250c11d5375d68503d'],0,34,34,15359920,1,1,1,1,11224
709e5640bc1f59bbb7753951fde5f22ac941aee4,1,Shaofeng Shi,2018-04-04 12:12:07+08:00,['37d3cd9987e4fdd43e569ccb38be37ba1d2a3d4e'],169,401,570,15360490,29,0.575539568,0.884892086,0.985611511,11226
5552164ba09eba989b9ddccdf3f1e4f83ed0b799,0,Shaofeng Shi,2018-04-04 12:12:07+08:00,['709e5640bc1f59bbb7753951fde5f22ac941aee4'],9,9,18,15360508,2,,,,11226
be3588b7f177d6621a09fefe3ad458499ceac97d,0,shaofengshi,2018-04-04 23:26:48+08:00,['5552164ba09eba989b9ddccdf3f1e4f83ed0b799'],0,2,2,15360510,1,0,1,1,11226
1e884f248602efa80cff0009dad73b94098363ff,0,shaofengshi,2018-04-04 23:33:24+08:00,['be3588b7f177d6621a09fefe3ad458499ceac97d'],2,0,2,15360512,1,1,0,0,11226
2cda6c39f7cbd82eba0aa9518526472deea7c479,1,lidongsjtu,2018-04-09 13:10:04+08:00,['1e884f248602efa80cff0009dad73b94098363ff'],2,2,4,15360516,1,,,,11226
7540cbd29ade23771c97c0837a5cf650a822b052,0,Billy(Yiming) Liu,2018-04-16 00:01:37+08:00,['2cda6c39f7cbd82eba0aa9518526472deea7c479'],80,115,195,15360711,2,,,,11226
5ab78cb8d59620189ccd18508939d00a36ee3baa,0,GitHub,2018-04-23 15:11:10+08:00,['7540cbd29ade23771c97c0837a5cf650a822b052'],10,21,31,15360742,5,0.583333333,1,0.666666667,11226
6fb75b68c222b99c39d6be905ce9b6e42b286d3d,0,Shaofeng Shi,2018-04-24 11:49:19+08:00,['5ab78cb8d59620189ccd18508939d00a36ee3baa'],0,46,46,15360788,2,,,,11227
9509989800170c49379b5442297e886df9df63ee,0,Shaofeng Shi,2018-04-24 11:49:19+08:00,['6fb75b68c222b99c39d6be905ce9b6e42b286d3d'],28,58,86,15360874,11,,,,11227
9d88e47214b036b34dac38b12d549823cafdbefc,0,Shaofeng Shi,2018-04-24 11:49:19+08:00,['9509989800170c49379b5442297e886df9df63ee'],5,4,9,15360883,2,1,1,0,11227
71397fd39709ebdb61b20309c22ef1ae8e3c2af4,1,Shaofeng Shi,2018-04-24 11:49:19+08:00,['9d88e47214b036b34dac38b12d549823cafdbefc'],318,481,799,15361682,34,0.853333333,1,0.84,11228
a9dcad1a859158ffeecceff614ed864695788a0d,1,Shaofeng Shi,2018-04-24 11:49:19+08:00,['71397fd39709ebdb61b20309c22ef1ae8e3c2af4'],70,103,173,15361855,7,0.5,1,1,11228
143cfdc317c4faa2289cdd84bfb3685cc17dc426,0,Shaofeng Shi,2018-04-24 11:49:19+08:00,['a9dcad1a859158ffeecceff614ed864695788a0d'],1,5,6,15361861,2,1,1,1,11228
b1c8944471558afe63d61b6578c494decbae53cc,0,Shaofeng Shi,2018-04-24 11:49:19+08:00,['143cfdc317c4faa2289cdd84bfb3685cc17dc426'],10,33,43,15361904,2,1,1,0.411764706,11228
7e8d5a573640d9b90a415ea860a4e0558ee865de,0,shaofengshi,2018-04-26 09:01:10+08:00,['b1c8944471558afe63d61b6578c494decbae53cc'],69,0,69,15361973,1,1,0,0,11228
b9bcc92b87514a0d26c8ba9662db0735d9d3a3d5,1,shaofengshi,2018-05-04 17:25:46+08:00,['7e8d5a573640d9b90a415ea860a4e0558ee865de'],8,7,15,15361988,1,1,0,0,11228
7217d7f9d28bdd7de56090189fbd5246a18cbf32,0,shaofengshi,2018-05-08 17:29:00+08:00,['b9bcc92b87514a0d26c8ba9662db0735d9d3a3d5'],1191,7,1198,15363186,15,0.475103734,0.143153527,0.049792531,11228
2ca5b982d5c65dcfa7f158c81f7f24d24b2c2ea8,0,shaofengshi,2018-05-11 10:39:55+08:00,['7217d7f9d28bdd7de56090189fbd5246a18cbf32'],19,52,71,15363257,3,0,0.909090909,0.818181818,11228
f2382eaf81ad5778587ae40afc483dc5cb6e8c14,1,shaofengshi,2018-05-11 19:09:30+08:00,['2ca5b982d5c65dcfa7f158c81f7f24d24b2c2ea8'],24,24,48,15363305,6,0,0,0.333333333,11228
56117606d1518da9740c0f241639866fb0f8c0fb,0,shaofengshi,2018-05-12 15:25:19+08:00,['f2382eaf81ad5778587ae40afc483dc5cb6e8c14'],15,14,29,15363334,4,1,0,1,11228
026db17fa184471c00057a6c80ccbca046c588b3,0,shaofengshi,2018-05-24 11:32:52+08:00,['56117606d1518da9740c0f241639866fb0f8c0fb'],0,46,46,15363380,1,0.8,0.8,1,11228
877cab0ca3089cfcccfa2bebcf211322a63e2a57,0,shaofengshi,2018-05-25 15:52:46+08:00,['026db17fa184471c00057a6c80ccbca046c588b3'],1,1,2,15363382,1,,,,11228
e20e2443d61a92beb85f481be241032fd674ac57,1,Dong Li,2018-05-27 08:24:37+08:00,['877cab0ca3089cfcccfa2bebcf211322a63e2a57'],1,1,2,15363384,1,,,,11228
faf7064c2161109eb43b2566960ea58b8556a67b,1,Dong Li,2018-05-27 08:24:37+08:00,['e20e2443d61a92beb85f481be241032fd674ac57'],17,24,41,15363425,1,0,0,1,11228
36810892442d51a1d073817714e0b0ace9963a56,1,Dong Li,2018-05-27 08:24:37+08:00,['faf7064c2161109eb43b2566960ea58b8556a67b'],27,93,120,15363545,7,0.896551724,0.896551724,1,11229
6820f8dad553b6b9d2a4b129732330a665db1965,0,Shaofeng Shi,2018-05-27 19:22:12+08:00,['36810892442d51a1d073817714e0b0ace9963a56'],5,12,17,15363562,1,0,0,1,11229
bbb71a83ddb4f8307e468d8562da4275043e8dd8,1,Shaofeng Shi,2018-05-27 19:22:12+08:00,['6820f8dad553b6b9d2a4b129732330a665db1965'],7,35,42,15363604,6,0.863636364,0.363636364,1,11229
1a1c8a9369113cef82b8a9d4d183f0339ad20828,1,Shaofeng Shi,2018-05-27 19:22:12+08:00,['bbb71a83ddb4f8307e468d8562da4275043e8dd8'],30,126,156,15363760,3,0,0.911392405,0.924050633,11229
c02783135a954ceb44fc765a5c3cc186e3e4c1be,0,Shaofeng Shi,2018-05-27 19:22:12+08:00,['1a1c8a9369113cef82b8a9d4d183f0339ad20828'],0,11,11,15363771,2,0.090909091,1,0.909090909,11229
0efcdca5d8537fd18531850a0505ba7cd4cd9632,0,Shaofeng Shi,2018-05-27 19:22:12+08:00,['c02783135a954ceb44fc765a5c3cc186e3e4c1be'],11,12,23,15363794,1,1,1,,11229
e08c10667ebc1f85cfd2cfe51e06af8051a1dd0c,1,Shaofeng Shi,2018-05-27 19:22:12+08:00,['0efcdca5d8537fd18531850a0505ba7cd4cd9632'],8,8,16,15363810,3,,,,11229
398401fbce0cdaad6db81142cba3a7cec84f7051,0,Shaofeng Shi,2018-05-27 19:22:12+08:00,['e08c10667ebc1f85cfd2cfe51e06af8051a1dd0c'],5,29,34,15363844,4,0.526315789,0,1,11229
2b1e9f4b965a47dde999eca073bdbf49eecdb63d,0,Shaofeng Shi,2018-05-27 19:22:12+08:00,['398401fbce0cdaad6db81142cba3a7cec84f7051'],0,9,9,15363853,2,0,1,1,11229
999f1f0089baf41bf4e3b546abe0af6384ab1b25,1,Shaofeng Shi,2018-05-29 10:34:18+08:00,['2b1e9f4b965a47dde999eca073bdbf49eecdb63d'],1,1,2,15363855,1,,,,11229
4c67905d3cd82a0330a5ff212bd53187636623d0,1,Shaofeng Shi,2018-05-29 10:54:19+08:00,['999f1f0089baf41bf4e3b546abe0af6384ab1b25'],1,11,12,15363867,1,,,,11229
d1c68f6cf4f6f0f788be65d43964d49e488271e0,0,Shaofeng Shi,2018-05-30 18:25:56+08:00,['4c67905d3cd82a0330a5ff212bd53187636623d0'],1,1,2,15363869,1,,,,11229
8325ae9abd278d3ce6eae2551403bf41ba9be35a,0,Billy(Yiming) Liu,2018-05-30 23:45:46+08:00,['d1c68f6cf4f6f0f788be65d43964d49e488271e0'],137,0,137,15364006,1,0.860759494,0.607594937,0.860759494,11229
f0f588f31f26d0f35c789ec79212f2df0cfa6e42,1,Shaofeng Shi,2018-06-01 13:42:56+08:00,['8325ae9abd278d3ce6eae2551403bf41ba9be35a'],5,457,462,15364468,13,0.753424658,0.835616438,0.872146119,11230
179eddbdb858626b537d19112cc39630098e5245,0,Shaofeng Shi,2018-06-01 13:42:56+08:00,['f0f588f31f26d0f35c789ec79212f2df0cfa6e42'],3,536,539,15365007,8,0.882352941,1,0.955017301,11233
777f8fa5d3b1f24f59354909de1ca3d28d5bc137,1,Shaofeng Shi,2018-06-01 13:42:56+08:00,['179eddbdb858626b537d19112cc39630098e5245'],56,2147,2203,15367210,39,0.520418848,0.87434555,0.696335079,11252
5a96f8b46ce73684a19a781a7aa0ce6a587900c7,1,Shaofeng Shi,2018-06-01 13:42:56+08:00,['777f8fa5d3b1f24f59354909de1ca3d28d5bc137'],60,1224,1284,15368494,19,0.519623234,0.923076923,0.894819466,11259
b7d2cb796ca3e3c9bc25837026a9a8966f3e1cad,1,Shaofeng Shi,2018-06-01 13:42:56+08:00,['5a96f8b46ce73684a19a781a7aa0ce6a587900c7'],0,876,876,15369370,12,0.592074592,0.937062937,0.818181818,11267
71d416adaab0c9c4f7b4b99cdb6ce43625a5c58c,0,Shaofeng Shi,2018-06-01 13:42:56+08:00,['b7d2cb796ca3e3c9bc25837026a9a8966f3e1cad'],0,3,3,15369373,1,0,0,1,11267
20c66d803d2ce0634078d790b441799a7af29991,1,Shaofeng Shi,2018-06-01 13:42:56+08:00,['71d416adaab0c9c4f7b4b99cdb6ce43625a5c58c'],9,21,30,15369403,3,0,1,0.5,11267
18316ec54a7b154de3ad3132b4e834efcc0d8d14,0,Shaofeng Shi,2018-06-01 13:42:56+08:00,['20c66d803d2ce0634078d790b441799a7af29991'],5,10,15,15369418,4,0,1,0.5,11267
c7d5ea2e255d30f6b9103037c48df746385dd3ce,1,Shaofeng Shi,2018-06-01 13:46:11+08:00,['18316ec54a7b154de3ad3132b4e834efcc0d8d14'],1,1,2,15369420,1,,,,11267
e0f29e29164d44581c133314ac01c419e4277c35,1,shaofengshi,2018-06-01 14:57:10+08:00,['c7d5ea2e255d30f6b9103037c48df746385dd3ce'],40,26,66,15369486,4,0.076923077,0,0.076923077,11267
8205fac0eb9c7c986e7690166793c5cc08742cd6,0,shaofengshi,2018-06-01 14:57:10+08:00,['e0f29e29164d44581c133314ac01c419e4277c35'],2,1,3,15369489,1,,,,11267
e3dcafb097d04f50f22994dc722d8bc0736dccbb,0,Shaofeng Shi,2018-06-04 09:15:39+08:00,['8205fac0eb9c7c986e7690166793c5cc08742cd6'],6,59,65,15369554,4,0.36,0.36,1,11267
2a8d9943fc271d40ab7cfe221b2eaac45b8a7468,1,shaofengshi,2018-06-05 09:44:26+08:00,['e3dcafb097d04f50f22994dc722d8bc0736dccbb'],51,200,251,15369805,13,0.836363636,0,0.963636364,11269
0fdf55abb2c709e04bf327d15299d695dce7b219,0,shaofengshi,2018-06-05 14:44:32+08:00,['2a8d9943fc271d40ab7cfe221b2eaac45b8a7468'],10,43,53,15369858,2,0.04,0.12,0.92,11269
e5accc575cc78f25f54d3125b0796a933526e79b,0,chenzhx,2018-06-06 14:58:14+08:00,['0fdf55abb2c709e04bf327d15299d695dce7b219'],1,1,2,15369860,1,,,,11269
f85d561293cd2cfd36a1674978c719c86cbbee9b,1,shaofengshi,2018-06-06 23:05:18+08:00,['e5accc575cc78f25f54d3125b0796a933526e79b'],108,296,404,15370264,17,0.404958678,0.950413223,1,11269
995a7198e6d78f0b21bac108a368306ca8cc48fa,0,shaofengshi,2018-06-06 23:05:18+08:00,['f85d561293cd2cfd36a1674978c719c86cbbee9b'],1,5,6,15370270,2,1,1,1,11269
372d1bb08a11cea918ea10ec9a7de79a050267e0,1,Shaofeng Shi,2018-06-07 09:24:00+08:00,['995a7198e6d78f0b21bac108a368306ca8cc48fa'],74,24,98,15370368,2,0.901960784,0,0.392156863,11269
9fa82a4e9fddbfa24bdf73b49d081f53ca8191bd,0,Shaofeng Shi,2018-06-10 10:43:08+08:00,['372d1bb08a11cea918ea10ec9a7de79a050267e0'],1,4,5,15370373,1,,,,11269
93247fa7f23ac427e8b6a581b0f902366bb9804f,1,Shaofeng Shi,2018-06-10 14:24:48+08:00,['9fa82a4e9fddbfa24bdf73b49d081f53ca8191bd'],1,1,2,15370375,1,,,,11269
38b47c7fce7159c62a59865db0edaa2554238d44,1,shaofengshi,2018-06-10 15:02:21+08:00,['93247fa7f23ac427e8b6a581b0f902366bb9804f'],1,1,2,15370377,1,,,,11269
ff122ebdde3a2486bede103c589e0aa4149e1658,0,Shaofeng Shi,2018-06-10 15:08:34+08:00,['38b47c7fce7159c62a59865db0edaa2554238d44'],2,2,4,15370381,1,,,,11269
de17b6ea0f53a4a4819ada47b81589b405e9e9e5,1,shaofengshi,2018-06-10 22:04:06+08:00,['ff122ebdde3a2486bede103c589e0aa4149e1658'],0,6,6,15370387,1,,,,11269
f6b1dfb5ef3239ea252b1498bf4c51235361bbcd,1,shaofengshi,2018-06-11 13:27:52+08:00,['de17b6ea0f53a4a4819ada47b81589b405e9e9e5'],10,15,25,15370412,9,1,1,1,11269
2b531d9831ca359ecf0f0a7ae384967c184e5507,0,chenzhx,2018-06-11 16:22:12+08:00,['f6b1dfb5ef3239ea252b1498bf4c51235361bbcd'],1,1,2,15370414,1,,,,11269
fd7cc177f78e4b037d57e7a28b749c747485040e,0,Shaofeng Shi,2018-06-12 09:34:38+08:00,['2b531d9831ca359ecf0f0a7ae384967c184e5507'],0,9,9,15370423,1,1,1,1,11269
c8de73d85b607eebb13a484b3796cbf28167430d,1,Shaofeng Shi,2018-06-12 22:44:24+08:00,['fd7cc177f78e4b037d57e7a28b749c747485040e'],9,6,15,15370438,2,0.333333333,0,0,11269
ec927e3f5ebfac4be04e54d0194556f71478a4f5,0,Shaofeng Shi,2018-06-14 17:28:19+08:00,['c8de73d85b607eebb13a484b3796cbf28167430d'],6,32,38,15370476,4,0.130434783,1,0.956521739,11269
e3388f987d122121e5c7ed7fd399029a35840377,1,Shaofeng Shi,2018-06-14 17:28:19+08:00,['ec927e3f5ebfac4be04e54d0194556f71478a4f5'],496,3087,3583,15374059,49,0.517498138,0.676842889,0.956068503,11289
f0c7e0f083baccf4a938073c23a0e3371ef66dfd,1,Shaofeng Shi,2018-06-14 17:28:19+08:00,['e3388f987d122121e5c7ed7fd399029a35840377'],0,437,437,15374496,7,0.130434783,1,1,11294
1c9b6792dfc5714e936bc098d7b634bc8aa94f98,0,Shaofeng Shi,2018-06-14 17:28:19+08:00,['f0c7e0f083baccf4a938073c23a0e3371ef66dfd'],4,96,100,15374596,4,0.28358209,0.28358209,0.865671642,11294
189f7ae318ee0b7c4ccaf62c08dc2aec1a2e0e2c,0,Shaofeng Shi,2018-06-14 17:28:19+08:00,['1c9b6792dfc5714e936bc098d7b634bc8aa94f98'],0,26,26,15374622,1,,,,11295
d3adc52e5e6ecf3518d0445e9180557e70b2731f,1,Shaofeng Shi,2018-06-14 17:28:19+08:00,['189f7ae318ee0b7c4ccaf62c08dc2aec1a2e0e2c'],39,227,266,15374888,14,0,0.476635514,0.672897196,11296
0d4d1ef246eac65278ea50ebf0c1b2f2746f7681,0,Shaofeng Shi,2018-06-14 17:28:19+08:00,['d3adc52e5e6ecf3518d0445e9180557e70b2731f'],0,80,80,15374968,2,,,,11298
ed1882f561b54e57cb6cfa1425180bb74c4a05ab,1,Shaofeng Shi,2018-06-14 17:28:19+08:00,['0d4d1ef246eac65278ea50ebf0c1b2f2746f7681'],10,33,43,15375011,5,0.5,0.5,1,11298
e47f2cf10abea422cf2d359aa0187b8a0649c85b,0,Shaofeng Shi,2018-06-14 17:28:19+08:00,['ed1882f561b54e57cb6cfa1425180bb74c4a05ab'],10,11,21,15375032,3,0,0,0,11298
a9557a6ccd32e89985330398bca4e73a054fa5a6,0,Shaofeng Shi,2018-06-14 17:28:19+08:00,['e47f2cf10abea422cf2d359aa0187b8a0649c85b'],47,52,99,15375131,5,0,0.5,0.25,11298
4c22115737992d6a06e69a1fd165f81491187768,0,shaofengshi,2018-06-14 17:29:10+08:00,['a9557a6ccd32e89985330398bca4e73a054fa5a6'],1,33,34,15375165,1,,,,11298
52bceb8d488cb4aafb5d6c3bd5519c2767db905c,0,shaofengshi,2018-06-14 21:41:28+08:00,['4c22115737992d6a06e69a1fd165f81491187768'],59,6,65,15375230,4,0.64,0.64,0,11298
6d8892de258c5596fab12020247feef959c95e41,0,shaofengshi,2018-06-14 23:19:50+08:00,['52bceb8d488cb4aafb5d6c3bd5519c2767db905c'],3,5,8,15375238,2,0,0.5,1,11298
1da7e28d5d1519e88bd59385227082ff286f835a,0,shaofengshi,2018-06-17 09:58:53+08:00,['6d8892de258c5596fab12020247feef959c95e41'],1,1,2,15375240,1,,,,11298
44ac227717303ae97b4f6a2bbb53ebc2fd928e64,0,Billy(Yiming) Liu,2018-06-20 10:33:37+08:00,['1da7e28d5d1519e88bd59385227082ff286f835a'],0,6,6,15375246,1,,,,11298
fbd36de020d87f0ff54d66a4951612dcf42440dd,0,Shaofeng Shi,2018-06-20 10:56:57+08:00,['44ac227717303ae97b4f6a2bbb53ebc2fd928e64'],0,13,13,15375259,2,0.333333333,0.333333333,0.333333333,11298
01df768ac5f38cbeaff1f3a6245c26a8863d5709,0,Shaofeng Shi,2018-06-20 10:56:57+08:00,['fbd36de020d87f0ff54d66a4951612dcf42440dd'],11,2,13,15375272,2,1,1,1,11298
0f6273e3ad0003082ed2585f1bc0339262a18350,0,shaofengshi,2018-06-20 16:50:56+08:00,['01df768ac5f38cbeaff1f3a6245c26a8863d5709'],362,27,389,15375661,8,0.571428571,0.257142857,0.028571429,11298
d680a4aa9162fdcf0e845bde7b6952aeeac81410,0,Billy(Yiming) Liu,2018-06-20 16:54:45+08:00,['0f6273e3ad0003082ed2585f1bc0339262a18350'],2,6,8,15375669,1,0,0,0,11298
40a593541055cde65b16fc551345171b22456ab1,0,Shaofeng Shi,2018-06-20 17:31:49+08:00,['d680a4aa9162fdcf0e845bde7b6952aeeac81410'],5,5,10,15375679,1,,,,11298
ef28440a8270076393f3c695cad7b8fd66c5a9f6,0,Shaofeng Shi,2018-06-20 19:32:42+08:00,['40a593541055cde65b16fc551345171b22456ab1'],4,27,31,15375710,2,0,1,1,11298
4f2992d72ed6126fe276b305d17bd042c51d0e6a,0,Shaofeng Shi,2018-06-20 19:32:42+08:00,['ef28440a8270076393f3c695cad7b8fd66c5a9f6'],1,1,2,15375712,1,,,,11298
dbaf37ecbe44906f7a18b767ef23182e0562b44a,0,Shaofeng Shi,2018-06-20 19:36:14+08:00,['4f2992d72ed6126fe276b305d17bd042c51d0e6a'],1,1,2,15375714,1,,,,11298
a602afdaa914e02abd04d939a470bc3e5d6532a6,0,Zhong,2018-06-23 13:09:21+08:00,['dbaf37ecbe44906f7a18b767ef23182e0562b44a'],1,5,6,15375720,2,1,1,1,11298
eddab3791b3322e8f8c42d5254e03c4f334897af,1,Zhong,2018-06-24 07:21:14+08:00,['a602afdaa914e02abd04d939a470bc3e5d6532a6'],279,401,680,15376400,7,1,1,0,11302
c5fd42aa3b925b8e83743532234ef2351f2cd4ee,0,Zhong,2018-06-24 07:21:14+08:00,['eddab3791b3322e8f8c42d5254e03c4f334897af'],91,8,99,15376499,4,0.695652174,0,0,11302
cedbdc580ca6f0fb1bad9a39bfa1d930c40958b8,0,shaofengshi,2018-06-24 19:47:39+08:00,['c5fd42aa3b925b8e83743532234ef2351f2cd4ee'],26,26,52,15376551,26,,,,11302
5a089adcae55a5fb5333f4e8f527ae05cca3e0d7,1,shaofengshi,2018-06-25 09:41:01+08:00,['cedbdc580ca6f0fb1bad9a39bfa1d930c40958b8'],26,26,52,15376603,26,,,,11302
a0595c07ebfcade52f10e9ac134fa3e330fc57da,0,kangkaisen,2018-06-25 15:07:18+08:00,['5a089adcae55a5fb5333f4e8f527ae05cca3e0d7'],0,59,59,15376662,1,,,,11302
959ba2d53ab1922615dc75df325475d51b410f80,0,Shaofeng Shi,2018-06-27 15:46:57+08:00,['a0595c07ebfcade52f10e9ac134fa3e330fc57da'],9,13,22,15376684,2,1,1,1,11302
2c08e7f1bd6d341a19d9ae9e2b9ab2afaefed4de,0,shaofengshi,2018-07-01 22:06:51+08:00,['959ba2d53ab1922615dc75df325475d51b410f80'],0,5,5,15376689,2,0.75,0.75,0.75,11302
7c1d9026a00e9da0845c2fad13a5dd0fcd851939,0,chenzhx,2018-07-02 10:43:57+08:00,['2c08e7f1bd6d341a19d9ae9e2b9ab2afaefed4de'],1,1,2,15376691,1,,,,11302
40dd2be1d2456029a2308abe2c94353bbe75dca9,0,Zhixiong Chen,2018-07-04 14:20:21+08:00,['7c1d9026a00e9da0845c2fad13a5dd0fcd851939'],15,4,19,15376710,1,0,0,0,11302
54cd2c793bb5487cefc6def073a902ae73e5c5d4,1,shaofengshi,2018-07-05 11:18:12+08:00,['40dd2be1d2456029a2308abe2c94353bbe75dca9'],808,2372,3180,15379890,45,0.458984375,0.80078125,0.708984375,11319
bec6e5965a7a547d8dd346023e93a6e287c8a9db,0,shaofengshi,2018-07-06 15:21:52+08:00,['54cd2c793bb5487cefc6def073a902ae73e5c5d4'],4,4,8,15379898,1,,,,11319
59354acced7fdb35e0325fb7a8ea2e8c862f658c,0,shaofengshi,2018-07-06 18:09:10+08:00,['bec6e5965a7a547d8dd346023e93a6e287c8a9db'],10,2,12,15379910,1,1,0,0,11319
1845ee0ce3b8f775e05443fed1b4d3e860ae7503,0,shaofengshi,2018-07-08 08:28:00+08:00,['59354acced7fdb35e0325fb7a8ea2e8c862f658c'],4,6,10,15379920,2,1,1,1,11319
fdbe369d1187dae8c7157ef90234e6855c9eee60,0,shaofengshi,2018-07-08 08:28:00+08:00,['1845ee0ce3b8f775e05443fed1b4d3e860ae7503'],7,1,8,15379928,1,0,0,0,11319
f487d803a0505bb11dfadce90aee12d8d20042f5,0,shaofengshi,2018-07-08 08:28:00+08:00,['fdbe369d1187dae8c7157ef90234e6855c9eee60'],4,54,58,15379986,5,1,1,1,11320
05baf2123fd0b0fcfee613e1fe18c93722c8ed9b,1,shaofengshi,2018-07-08 16:58:48+08:00,['f487d803a0505bb11dfadce90aee12d8d20042f5'],1082,1669,2751,15382737,42,0,1,0.976470588,11328
d1ed1072728ca0bd12b83a04e2308784b2e045a6,0,shaofengshi,2018-07-08 16:58:48+08:00,['05baf2123fd0b0fcfee613e1fe18c93722c8ed9b'],30,185,215,15382952,5,0.643678161,0.91954023,0.781609195,11329
31073af0285bb43cdee5ec844ef455d98e193c86,0,shaofengshi,2018-07-08 16:58:48+08:00,['d1ed1072728ca0bd12b83a04e2308784b2e045a6'],0,31,31,15382983,2,1,1,1,11330
01c37717043c9c038482afb2cd07d1188aad77c7,0,chenzhx,2018-07-09 16:39:27+08:00,['31073af0285bb43cdee5ec844ef455d98e193c86'],2,2,4,15382987,1,,,,11330
ee7f2f435c4b82ac6b3867d4d6505de0de43c24f,1,shaofengshi,2018-07-10 16:00:05+08:00,['01c37717043c9c038482afb2cd07d1188aad77c7'],3,25,28,15383015,2,0.266666667,0.266666667,1,11330
22f2d6e79e0bba5f2101f1d1c42922cd36c001b4,0,shaofengshi,2018-07-10 16:00:05+08:00,['ee7f2f435c4b82ac6b3867d4d6505de0de43c24f'],71,38,109,15383124,2,1,1,0,11330
a565fdae47a818ff0062de4ac6cbdde733cd6bf5,0,shaofengshi,2018-07-10 17:29:20+08:00,['22f2d6e79e0bba5f2101f1d1c42922cd36c001b4'],10,16,26,15383150,4,0.8,0.8,1,11330
4bda69ebbe5f25cfa9f94310efcdbb734df486b3,1,shaofengshi,2018-07-13 09:55:08+08:00,['a565fdae47a818ff0062de4ac6cbdde733cd6bf5'],293,731,1024,15384174,20,0.350877193,0.916666667,1,11332
d5affd97fd95b6e915b97502eb5639153a3d6365,0,shaofengshi,2018-07-16 22:32:52+08:00,['4bda69ebbe5f25cfa9f94310efcdbb734df486b3'],0,3,3,15384177,1,0,1,1,11332
8a9a333a053634d4885087979826fbe016f13bbd,1,shaofengshi,2018-07-17 14:07:08+08:00,['d5affd97fd95b6e915b97502eb5639153a3d6365'],2,7,9,15384186,1,0,0,1,11332
85c389589edbd66848f5ef61e0001d93fe976fc7,0,Shaofeng Shi,2018-07-18 22:23:07+08:00,['8a9a333a053634d4885087979826fbe016f13bbd'],7,83,90,15384276,2,1,1,1,11333
4b5fe6de6278f54751ed9a58c336b133895b05c9,0,Shaofeng Shi,2018-07-19 15:18:00+08:00,['85c389589edbd66848f5ef61e0001d93fe976fc7'],32,155,187,15384463,4,0.902439024,0.756097561,1,11333
7f2aa5ad3cbdac59763b7539f1d31bf099d51cb5,1,Shaofeng Shi,2018-07-19 15:18:00+08:00,['4b5fe6de6278f54751ed9a58c336b133895b05c9'],7,31,38,15384501,2,0.444444444,0.444444444,1,11333
27eb8cd2b8be7cfbb4345f3bef782587248cce18,1,Shaofeng Shi,2018-07-19 15:39:05+08:00,['7f2aa5ad3cbdac59763b7539f1d31bf099d51cb5'],1,830,831,15385332,3,0.349177331,0.574040219,0.301645338,11334
95d2a5befaa596b2d502026d53a791fa31d20bbe,1,Shaofeng Shi,2018-07-19 15:45:56+08:00,['27eb8cd2b8be7cfbb4345f3bef782587248cce18'],22,45,67,15385399,5,0,1,1,11334
11642df257d514b68d23a1f85f093b8816b10967,0,Shaofeng Shi,2018-07-19 16:43:37+08:00,['95d2a5befaa596b2d502026d53a791fa31d20bbe'],1,1,2,15385401,1,,,,11334
c9d9b2ed3e2f1c0fe9bf6c94ad87ed2a80758a18,1,shaofengshi,2018-07-21 08:26:41+08:00,['11642df257d514b68d23a1f85f093b8816b10967'],67,110,177,15385578,4,0,0,1,11334
f27a92b648b891ac682c5527cfb4cd0266a33863,1,Shaofeng Shi,2018-07-26 09:44:34+08:00,['c9d9b2ed3e2f1c0fe9bf6c94ad87ed2a80758a18'],5,66,71,15385649,4,0.041666667,0.166666667,0.520833333,11334
036e26caafef60610d4c0ab7833b19319251c7f5,0,Shaofeng Shi,2018-07-26 09:45:31+08:00,['f27a92b648b891ac682c5527cfb4cd0266a33863'],12,16,28,15385677,4,1,1,1,11334
9bc8d120f9fa874c4c075f2479a45a1ea0a53fbc,1,shaofengshi,2018-07-26 10:39:02+08:00,['036e26caafef60610d4c0ab7833b19319251c7f5'],68,261,329,15386006,4,0.178807947,0,1,11334
312eaae7d469ed90984fc32f11d9b772e5f5bb89,1,shaofengshi,2018-07-26 10:48:25+08:00,['9bc8d120f9fa874c4c075f2479a45a1ea0a53fbc'],158,208,366,15386372,18,1,1,0.727272727,11334
b1032ebb600777477c8cdda270cc88757ac7aaeb,0,shaofengshi,2018-07-26 18:15:30+08:00,['312eaae7d469ed90984fc32f11d9b772e5f5bb89'],4,4,8,15386380,2,,,,11334
88a242f514a9ea9ae44f5b22a213dcd3a0aefb0b,1,Shaofeng Shi,2018-07-26 18:57:55+08:00,['b1032ebb600777477c8cdda270cc88757ac7aaeb'],43,129,172,15386552,5,1,0.947368421,1,11335
f5e28fb60ef42551deb58e81b08499e725afdf74,1,Shaofeng Shi,2018-07-26 18:58:22+08:00,['88a242f514a9ea9ae44f5b22a213dcd3a0aefb0b'],45,1076,1121,15387673,19,0.825358852,1,0.85645933,11347
1cd00269a63f51a011f93effe6fc982d3e614459,1,Shaofeng Shi,2018-07-27 09:48:14+08:00,['f5e28fb60ef42551deb58e81b08499e725afdf74'],28,99,127,15387800,8,0.68,0.74,0.36,11347
03f7f6712ed8b6f93470603a5b40f7725ae5f213,0,Emiya0306,2018-07-30 10:22:35+08:00,['1cd00269a63f51a011f93effe6fc982d3e614459'],69,97,166,15387966,15,1,1,1,11348
25b300c1f654561e561565ebf35c4e0e93ae0a04,0,GitHub,2018-07-30 11:51:25+08:00,"['1cd00269a63f51a011f93effe6fc982d3e614459', '03f7f6712ed8b6f93470603a5b40f7725ae5f213']",69,97,166,15388132,15,,,,11348
de693a75a64982c20ee6a6f3858c7eb0adbd926b,1,Shaofeng Shi,2018-08-01 17:07:22+08:00,['25b300c1f654561e561565ebf35c4e0e93ae0a04'],1,25,26,15388158,1,,,,11348
44926b777f81d34d4e9da25e900f352be313dd58,1,shaofengshi,2018-08-02 09:19:27+08:00,['de693a75a64982c20ee6a6f3858c7eb0adbd926b'],30,21,51,15388209,7,0,0,0,11348
2b9aedc74d28028b712ba44f73e76d81d5d3ff20,0,shaofengshi,2018-08-02 10:05:01+08:00,['44926b777f81d34d4e9da25e900f352be313dd58'],0,5,5,15388214,1,,,,11348
bccfb7f0010b29054b0d301da818c406ab5ff601,0,Shaofeng Shi,2018-08-02 11:38:38+08:00,['2b9aedc74d28028b712ba44f73e76d81d5d3ff20'],0,117,117,15388331,5,0.510638298,1,1,11349
9fec0c403a4f1e470fc66d7af55060632073553d,1,shaofengshi,2018-08-02 13:51:03+08:00,['bccfb7f0010b29054b0d301da818c406ab5ff601'],102,115,217,15388548,7,1,0.259259259,0.111111111,11350
23ff19d4e4c095742f4efc6ae5472000193f5c14,1,Shaofeng Shi,2018-08-06 12:44:40+08:00,['9fec0c403a4f1e470fc66d7af55060632073553d'],2,62,64,15388612,2,0.260869565,1,1,11351
95f35fc4e60a2085d8e2e6272e1579eed3a76913,0,Shaofeng Shi,2018-08-06 16:56:59+08:00,['23ff19d4e4c095742f4efc6ae5472000193f5c14'],13,2813,2826,15391438,27,0.856254319,0.897028334,0.838286109,11371
122b4d0cf0d0917438eb1c05e9d132e068bb481b,0,Shaofeng Shi,2018-08-06 16:58:24+08:00,['95f35fc4e60a2085d8e2e6272e1579eed3a76913'],0,8,8,15391446,1,0,1,1,11371
4d61c30ebd52c555632933ccdc928f85cc806cfd,0,Shaofeng Shi,2018-08-06 17:55:27+08:00,['122b4d0cf0d0917438eb1c05e9d132e068bb481b'],1,1,2,15391448,1,,,,11371
b938a1c53e5b5e894b9ca0cd6c6b3b757bdeca6a,0,shaofengshi,2018-08-06 18:55:13+08:00,['4d61c30ebd52c555632933ccdc928f85cc806cfd'],7,56,63,15391511,4,0.833333333,0.833333333,1,11372
e7bacd35ea771db6ebaa2dad8d3a8994f76a78d3,0,shaofengshi,2018-08-07 17:43:39+08:00,['b938a1c53e5b5e894b9ca0cd6c6b3b757bdeca6a'],2,6,8,15391519,2,,,,11372
050f1c189bf328e72ac690ee7cf4316747102f6a,0,Shaofeng Shi,2018-08-07 21:44:43+08:00,['e7bacd35ea771db6ebaa2dad8d3a8994f76a78d3'],18,35,53,15391572,5,1,1,1,11372
9a92f4922ad17e40c1914f34db659aaad3c98605,1,Shaofeng Shi,2018-08-07 21:52:42+08:00,['050f1c189bf328e72ac690ee7cf4316747102f6a'],6,740,746,15392318,9,0.259668508,0.593922652,0.616022099,11376
74ac1cd1d2aa45028f38ccac47a5920343756313,1,Shaofeng Shi,2018-08-07 21:52:42+08:00,['9a92f4922ad17e40c1914f34db659aaad3c98605'],15,338,353,15392671,3,0.204819277,0.5,0.84939759,11377
6adf1b396c2ca72daf55a94f28092cbd8909626e,0,Shaofeng Shi,2018-08-07 23:05:53+08:00,['74ac1cd1d2aa45028f38ccac47a5920343756313'],0,2,2,15392673,1,,,,11377
7e0cbad33598dbcd821aebec66e5339d9e0fe7fb,1,Shaofeng Shi,2018-08-09 20:53:33+08:00,['6adf1b396c2ca72daf55a94f28092cbd8909626e'],0,21,21,15392694,2,,,,11377
3fe29d081fffd5b700a3dec2345462cd4e753037,1,Shaofeng Shi,2018-08-10 09:46:17+08:00,['7e0cbad33598dbcd821aebec66e5339d9e0fe7fb'],60,32,92,15392786,3,1,0,0,11377
ddfed27655ed433ba241f72e7d9177920b0bca18,0,Shaofeng Shi,2018-08-12 21:38:05+08:00,['3fe29d081fffd5b700a3dec2345462cd4e753037'],1,1,2,15392788,1,,,,11377
367fdfbac44e7a3ce37873ae66457f7b1de68951,1,Shaofeng Shi,2018-08-14 17:38:53+08:00,['ddfed27655ed433ba241f72e7d9177920b0bca18'],65,267,332,15393120,7,0.676470588,0.860294118,0.970588235,11377
0b5d25566cf24441e8371a782a8ac74dfa1dca72,1,Shaofeng Shi,2018-08-14 17:42:46+08:00,['367fdfbac44e7a3ce37873ae66457f7b1de68951'],173,736,909,15394029,7,0.158018868,0.438679245,0.419811321,11378
648379867850f4dba6187efe6fd22e2b57d5580e,1,Shaofeng Shi,2018-08-14 17:48:38+08:00,['0b5d25566cf24441e8371a782a8ac74dfa1dca72'],90,155,245,15394274,36,1,1,1,11380
d2d2ac72d3c3582c3d8cfae4707fd0969b98e228,0,Billy(Yiming) Liu,2018-08-17 14:55:50+08:00,['648379867850f4dba6187efe6fd22e2b57d5580e'],4,4,8,15394282,1,,,,11380
b4f21550a773965eb93c639d1c5437661cb5b36f,0,Billy(Yiming) Liu,2018-08-17 17:56:44+08:00,['d2d2ac72d3c3582c3d8cfae4707fd0969b98e228'],0,8,8,15394290,1,,,,11380
2eba8e2142e674bef3ff2ddacb2729902cc81d0a,1,Shaofeng Shi,2018-08-20 16:01:53+08:00,['b4f21550a773965eb93c639d1c5437661cb5b36f'],8,4,12,15394302,1,1,1,0,11380
55d8adae2ecab463d3198dce5d59f93276d6bd59,0,shaofengshi,2018-08-20 16:07:28+08:00,['2eba8e2142e674bef3ff2ddacb2729902cc81d0a'],1,1,2,15394304,1,0,1,1,11380
76c9c960be542c919301c72b34c7ae5ce6f1ec1c,1,shaofengshi,2018-08-20 18:47:05+08:00,['55d8adae2ecab463d3198dce5d59f93276d6bd59'],40,97,137,15394441,7,0.255319149,0.765957447,0.659574468,11380
c9337cb4a5e6c4f04c10b7fde1d5e3f6a8ffa25b,0,shaofengshi,2018-08-20 18:48:13+08:00,['76c9c960be542c919301c72b34c7ae5ce6f1ec1c'],0,92,92,15394533,3,0.338983051,1,0.627118644,11380
c9d7f5ec2ff8834f0f1b24610485bb819741206f,1,shaofengshi,2018-08-20 18:48:13+08:00,['c9337cb4a5e6c4f04c10b7fde1d5e3f6a8ffa25b'],36,276,312,15394845,10,0.704081633,1,0.836734694,11384
2372b96ad3ab483591e68d184ad0ecc37507b78a,0,Shaofeng Shi,2018-08-21 18:49:15+08:00,['c9d7f5ec2ff8834f0f1b24610485bb819741206f'],4,4,8,15394853,1,,,,11384
64dfa7b9f7ef95a3edd8548d46a21ea9e71facc7,1,Shaofeng Shi,2018-08-22 16:41:57+08:00,['2372b96ad3ab483591e68d184ad0ecc37507b78a'],0,6,6,15394859,1,0,0,1,11384
024a60d683d5761a1dc1bea357bfe80d030ba560,1,Shaofeng Shi,2018-08-24 09:23:58+08:00,['64dfa7b9f7ef95a3edd8548d46a21ea9e71facc7'],2,42,44,15394903,2,0.133333333,0.8,1,11384
e8e20529f42e6c9865d13664e31a9f0422e17086,0,shaofengshi,2018-08-24 15:27:50+08:00,['024a60d683d5761a1dc1bea357bfe80d030ba560'],17,24,41,15394944,2,0.5,0.5,1,11384
a334ee4ff1f6609ab15bd7d4744206750e77ec21,1,Shaofeng Shi,2018-08-24 17:48:16+08:00,['e8e20529f42e6c9865d13664e31a9f0422e17086'],46,1123,1169,15396113,9,0.277966102,0.811864407,0.83220339,11386
637f45d8444c7b52713780c1701d33d6656fffc0,1,shaofengshi,2018-08-25 07:57:30+08:00,['a334ee4ff1f6609ab15bd7d4744206750e77ec21'],17,699,716,15396829,22,0.433774834,0.798013245,0.831125828,11392
80c60ee3142a1de56fc70b1d1a2f1cf57442fd21,0,shaofengshi,2018-08-25 07:57:30+08:00,['637f45d8444c7b52713780c1701d33d6656fffc0'],19,29,48,15396877,4,0,0,1,11392
8ecaba51a97e13458d2dd1a94dee656dcd75e20d,1,shaofengshi,2018-08-26 20:27:29+08:00,['80c60ee3142a1de56fc70b1d1a2f1cf57442fd21'],11,85,96,15396973,2,1,1,1,11393
32c65936891cd23b330e6f9cf84310c72aa6f206,1,Shaofeng Shi,2018-08-27 14:02:28+08:00,['8ecaba51a97e13458d2dd1a94dee656dcd75e20d'],1,1,2,15396975,1,,,,11393
c5424ce065ccbeb39bb0b9aea1c214a32fb082e8,1,Shaofeng Shi,2018-08-28 10:30:27+08:00,['32c65936891cd23b330e6f9cf84310c72aa6f206'],6,88,94,15397069,8,0.666666667,0.8,0.844444444,11393
5a2b76c874dde642ad04d0734f14ea944d334184,0,Shaofeng Shi,2018-08-28 11:08:36+08:00,['c5424ce065ccbeb39bb0b9aea1c214a32fb082e8'],24,21,45,15397114,3,1,1,,11393
d26d32189a1d3ed3a41867238004128dde03537e,0,shaofengshi,2018-08-28 11:47:51+08:00,['5a2b76c874dde642ad04d0734f14ea944d334184'],0,1,1,15397115,1,,,,11393
88db74a2c056dd734755447f2382218d7f5a6ec8,0,shaofengshi,2018-08-28 11:48:47+08:00,['d26d32189a1d3ed3a41867238004128dde03537e'],0,77,77,15397192,5,0,1,1,11395
d5aebf376ed537fe5253d7b3761a4585a7ccffb0,0,Shaofeng Shi,2018-08-28 22:20:45+08:00,['88db74a2c056dd734755447f2382218d7f5a6ec8'],6,49,55,15397247,5,0,1,0.615384615,11395
877cb8aa43b057caf0b6aeef99a3b2d4c5580d89,0,Shaofeng Shi,2018-08-28 22:20:45+08:00,['d5aebf376ed537fe5253d7b3761a4585a7ccffb0'],15,29,44,15397291,2,0.625,0.625,1,11395
2f6eff685cab5ea4ada42abff6e6f70f2e8ba997,1,Shaofeng Shi,2018-08-28 22:20:45+08:00,['877cb8aa43b057caf0b6aeef99a3b2d4c5580d89'],79,32,111,15397402,3,0.921052632,0,0.5,11395
3de7c4ffb72fc2230730069e1f0eca48b5c9a66b,0,Shaofeng Shi,2018-08-28 22:22:41+08:00,['2f6eff685cab5ea4ada42abff6e6f70f2e8ba997'],2,38,40,15397442,7,0.6,0.666666667,0.933333333,11395
2889e36160e4610af982400db4ef6c2a61acf5bd,1,shaofengshi,2018-08-29 14:52:11+08:00,['3de7c4ffb72fc2230730069e1f0eca48b5c9a66b'],45,44,89,15397531,2,0,1,1,11395
c8972772af60d0a6736acb063ff6c4b775790b4a,1,shaofengshi,2018-08-30 11:42:23+08:00,['2889e36160e4610af982400db4ef6c2a61acf5bd'],208,225,433,15397964,4,0.28,0.68,0.92,11395
f1d2ee46493fb9dd37ca8f8e2e6a8b5f5ad494ab,0,shaofengshi,2018-08-30 21:41:58+08:00,['c8972772af60d0a6736acb063ff6c4b775790b4a'],0,0,0,15397964,1,,,,11395
91db31cc38786570160ff07625ad853b15515d67,1,Shaofeng Shi,2018-09-02 10:25:54+08:00,['f1d2ee46493fb9dd37ca8f8e2e6a8b5f5ad494ab'],2868,3448,6316,15404280,201,0,0.725631769,0.59566787,11396
a0fdac4d68c0097e1d4c25e90e2e876aa23577db,0,Emiya0306,2018-09-03 13:52:40+08:00,['91db31cc38786570160ff07625ad853b15515d67'],0,6,6,15404286,1,0,1,1,11396
119053b91336437e8765804bee797d463e6fd6b1,0,GitHub,2018-09-03 14:03:46+08:00,"['91db31cc38786570160ff07625ad853b15515d67', 'a0fdac4d68c0097e1d4c25e90e2e876aa23577db']",0,6,6,15404292,1,,,,11396
6d2738e23fd858b417cc8a599e51ebbf9d2678eb,0,shaofengshi,2018-09-03 16:30:00+08:00,['119053b91336437e8765804bee797d463e6fd6b1'],1,12,13,15404305,2,0.909090909,0.909090909,1,11396
8a266f2eaca285741c975ca18b34fcc3b1ba317b,1,shaofengshi,2018-09-03 17:55:09+08:00,['6d2738e23fd858b417cc8a599e51ebbf9d2678eb'],0,1882,1882,15406187,17,0.489233419,0.765719208,0.80620155,11406
101758d121cf7d192cbcfdb066deee5fb984de5d,1,shaofengshi,2018-09-03 18:00:19+08:00,['8a266f2eaca285741c975ca18b34fcc3b1ba317b'],212,152,364,15406551,6,0.902439024,0.926829268,0,11406
94afb6b9ca1beb26ca3d5a8238a0a9a499e61813,0,shaofengshi,2018-09-04 09:14:20+08:00,['101758d121cf7d192cbcfdb066deee5fb984de5d'],8,8,16,15406567,2,,,,11406
e7e8e62f7dc1e39ce7484777accca5f55472f6d3,0,Shaofeng Shi,2018-09-04 17:30:56+08:00,['94afb6b9ca1beb26ca3d5a8238a0a9a499e61813'],1,1,2,15406569,1,,,,11406
fff673fc3e3d8c22be0f52e4693de3f1c8850eed,0,shaofengshi,2018-09-04 18:30:19+08:00,['e7e8e62f7dc1e39ce7484777accca5f55472f6d3'],0,19,19,15406588,1,0.928571429,0.928571429,1,11406
6d00ed556c192fe498df4e265bce6ef4bb969e0b,0,shaofengshi,2018-09-06 08:25:37+08:00,['fff673fc3e3d8c22be0f52e4693de3f1c8850eed'],1,1,2,15406590,1,,,,11406
85801fa7a61f41a633477b8f5b602b3fcf296f07,0,Zhong,2018-09-07 14:35:29+08:00,['6d00ed556c192fe498df4e265bce6ef4bb969e0b'],0,58,58,15406648,1,,,,11406
5fb5b0cb580dfbbf8fffbdb30e9c44c7a45906c2,0,shaofengshi,2018-09-09 20:20:27+08:00,['85801fa7a61f41a633477b8f5b602b3fcf296f07'],1,1,2,15406650,1,,,,11406
7a7714175a9d479678abb70740977c46e8507247,0,Shaofeng Shi,2018-09-10 09:58:25+08:00,['5fb5b0cb580dfbbf8fffbdb30e9c44c7a45906c2'],0,14,14,15406664,1,0,0,1,11406
37a4966db41c775dfc48cdd4a4a244f03a18a96c,0,Shaofeng Shi,2018-09-10 16:51:36+08:00,['7a7714175a9d479678abb70740977c46e8507247'],1,1,2,15406666,1,,,,11406
d164225e91fa59aa1dd06d2ddf64e6acc1035a3f,0,Shaofeng Shi,2018-09-10 16:51:36+08:00,['37a4966db41c775dfc48cdd4a4a244f03a18a96c'],2,5,7,15406673,1,0,1,1,11406
5faddf6eb5ba7e8bb682e1ee6fded4a7e89a2d92,0,Shaofeng Shi,2018-09-10 16:51:36+08:00,['d164225e91fa59aa1dd06d2ddf64e6acc1035a3f'],4,0,4,15406677,1,1,1,0,11406
bffaa8a26a2d93b3aa62326484bc31a8717a7c0b,0,Shaofeng Shi,2018-09-10 16:51:36+08:00,['5faddf6eb5ba7e8bb682e1ee6fded4a7e89a2d92'],10,68,78,15406755,2,0.96,0.96,1,11406
165378bb13a374fad80830ab9a5c56a45420aa7c,0,shaofengshi,2018-09-11 11:04:10+08:00,['bffaa8a26a2d93b3aa62326484bc31a8717a7c0b'],2,11,13,15406768,2,0.375,0,0.75,11406
da5037ea1e5bd056f7c4f6811ce7b858f0dee00b,0,Shaofeng Shi,2018-09-11 15:54:53+08:00,['165378bb13a374fad80830ab9a5c56a45420aa7c'],3,3,6,15406774,2,,,,11406
64e46720cf0c2cb7da1a2cb69859bc2d3c134f2d,1,Shaofeng Shi,2018-09-11 18:05:26+08:00,['da5037ea1e5bd056f7c4f6811ce7b858f0dee00b'],13,15,28,15406802,1,0,0,1,11406
91fb3c1c0d719e2883e5328352af6395abc054db,0,Shaofeng Shi,2018-09-11 18:05:38+08:00,['64e46720cf0c2cb7da1a2cb69859bc2d3c134f2d'],1,14,15,15406817,2,0,0.75,1,11406
7cba77993e3372ce8764a9a2e8bcd5bb2e6a18cf,0,shaofengshi,2018-09-11 22:33:31+08:00,['91fb3c1c0d719e2883e5328352af6395abc054db'],1,1,2,15406819,1,,,,11406
9e5856ae15eecd08658026963641f3a586a17d96,0,shaofengshi,2018-09-11 22:34:06+08:00,['7cba77993e3372ce8764a9a2e8bcd5bb2e6a18cf'],4,9,13,15406832,1,0,0,1,11406
0f7d3f8a7c19712b65269bdc4af8f9c485faa326,0,shaofengshi,2018-09-11 22:34:06+08:00,['9e5856ae15eecd08658026963641f3a586a17d96'],1,1,2,15406834,1,,,,11406
3f7b42acd1ef2b99f054cc958b310d1cd7b6784c,0,shaofengshi,2018-09-12 09:59:36+08:00,['0f7d3f8a7c19712b65269bdc4af8f9c485faa326'],3,9,12,15406846,1,0,1,1,11406
375acdedf88a298bfcd2d2dddbf6f8551f42e427,1,Shaofeng Shi,2018-09-12 18:27:11+08:00,['3f7b42acd1ef2b99f054cc958b310d1cd7b6784c'],7,8,15,15406861,1,0,1,1,11406
d9972eef5e31c0d323f13b8b53a9842bb60b75a6,0,shaofengshi,2018-09-13 21:25:50+08:00,['375acdedf88a298bfcd2d2dddbf6f8551f42e427'],36,13,49,15406910,3,,,,11406
0c1ef1d4f94bcadf21be1971532ede788045e984,0,shaofengshi,2018-09-13 21:58:15+08:00,['d9972eef5e31c0d323f13b8b53a9842bb60b75a6'],1,1,2,15406912,1,,,,11406
501a8049735608705c075ade4e305317ed19ee41,0,shaofengshi,2018-09-13 22:02:04+08:00,['0c1ef1d4f94bcadf21be1971532ede788045e984'],26,26,52,15406964,26,,,,11406
535c9ed00f0a72c3e6c379e505985e519de7e8ce,0,guosheng lu,2018-09-17 17:49:16+08:00,['501a8049735608705c075ade4e305317ed19ee41'],2,1,3,15406967,1,,,,11406
2b2a203008451da69f9b30998be65e6062010691,0,guosheng lu,2018-09-18 09:58:12+08:00,['535c9ed00f0a72c3e6c379e505985e519de7e8ce'],4,6,10,15406977,2,0,1,0,11406
51fa4d059a7c90f448af58fa261396647e1e1bb6,0,guosheng lu,2018-09-18 18:16:10+08:00,['2b2a203008451da69f9b30998be65e6062010691'],4,107,111,15407088,4,1,1,0.64,11407
bb904b8f6fbfe61728fd199bd1fb8ce579f66209,1,shaofengshi,2018-09-19 09:36:38+08:00,['51fa4d059a7c90f448af58fa261396647e1e1bb6'],1,2,3,15407091,1,,,,11407
5413975a94ea41ba17cd5e02359038d7a7affb45,0,Shaofeng Shi,2018-09-19 09:44:42+08:00,['bb904b8f6fbfe61728fd199bd1fb8ce579f66209'],2,4,6,15407097,2,1,1,1,11407
6dcd79566e3a8a65650dfde3a3962bf51d52c4b6,0,Shaofeng Shi,2018-09-19 09:45:27+08:00,['5413975a94ea41ba17cd5e02359038d7a7affb45'],1,6,7,15407104,1,0,0,1,11407
aee4b57ece21ad1bd5f33efd23feb79542235d91,0,guosheng lu,2018-09-19 11:24:34+08:00,['6dcd79566e3a8a65650dfde3a3962bf51d52c4b6'],1,3,4,15407108,1,1,1,1,11407
dd9909ca02bf0375b588849a5fd87aad3a201fcb,0,Shaofeng Shi,2018-09-19 13:28:47+08:00,['aee4b57ece21ad1bd5f33efd23feb79542235d91'],3,9,12,15407120,3,0.8,1,1,11407
82e1c01af3dee09c0c6a417210ff5dfa47571575,0,Shaofeng Shi,2018-09-21 11:26:03+08:00,['dd9909ca02bf0375b588849a5fd87aad3a201fcb'],0,3,3,15407123,1,,,,11407
e093fac0aa98712560cb4438956730c849098953,0,Shaofeng Shi,2018-09-21 11:26:50+08:00,['82e1c01af3dee09c0c6a417210ff5dfa47571575'],1,1,2,15407125,1,,,,11407
cf171da0ef30fec80b21cd1cb2247d0c0bd91716,1,Shaofeng Shi,2018-09-21 17:21:28+08:00,['e093fac0aa98712560cb4438956730c849098953'],49,110,159,15407284,32,0.8,0.9,0.04,11407
715f819f7f8013578cbe392c7f3e2ace1bf97b38,0,Shaofeng Shi,2018-09-21 17:47:38+08:00,['cf171da0ef30fec80b21cd1cb2247d0c0bd91716'],35,1258,1293,15408577,17,0.522012579,1,0.943396226,11415
754da80a130827f22aa2bde96aba551ad6f2d5ac,0,shaofengshi,2018-09-24 14:46:02+08:00,['715f819f7f8013578cbe392c7f3e2ace1bf97b38'],9,3,12,15408589,2,1,1,0,11415
f37be33cedba7fa4f6970d2c3082578e70a6b1a0,0,Shaofeng Shi,2018-09-24 15:11:59+08:00,['754da80a130827f22aa2bde96aba551ad6f2d5ac'],0,3,3,15408592,1,0.333333333,1,1,11415
98833e041e05667948038538d6a2551094d419fb,1,Shaofeng Shi,2018-09-24 20:10:09+08:00,['f37be33cedba7fa4f6970d2c3082578e70a6b1a0'],1,23,24,15408616,1,0,0,0,11415
d8c2a282930adb0d93e827ed014fbe7ceda69c09,0,Shaofeng Shi,2018-09-25 08:23:39+08:00,['98833e041e05667948038538d6a2551094d419fb'],2,1,3,15408619,1,,,,11415
fc9444fd81cfebe96e0019ea0ca83c533db2951b,0,Shaofeng Shi,2018-09-25 11:43:53+08:00,['d8c2a282930adb0d93e827ed014fbe7ceda69c09'],21,9,30,15408649,5,0,0,0,11415
34fd447c2f8b1852c530168e344d24f6efce4a3c,1,Shaofeng Shi,2018-09-25 16:47:48+08:00,['fc9444fd81cfebe96e0019ea0ca83c533db2951b'],6,6,12,15408661,4,,,,11415
043a3156c17f9c2dbd76125ab8e957d29c1dffed,0,Shaofeng Shi,2018-09-26 18:55:13+08:00,['34fd447c2f8b1852c530168e344d24f6efce4a3c'],1,4,5,15408666,1,0,0,0,11415
c8610e21f4aaaa158ac400485bdab21ab59dc586,0,Shaofeng Shi,2018-09-26 19:28:12+08:00,['043a3156c17f9c2dbd76125ab8e957d29c1dffed'],4,4,8,15408674,1,,,,11415
cd8c3759342c38d602b5715c18f7f1f220e6611b,1,Shaofeng Shi,2018-09-26 19:30:49+08:00,['c8610e21f4aaaa158ac400485bdab21ab59dc586'],1,1,2,15408676,1,,,,11415
95f399e98957992e9a13fa1e71ee319e3018f246,1,shaofengshi,2018-09-26 21:32:30+08:00,['cd8c3759342c38d602b5715c18f7f1f220e6611b'],384,81,465,15409141,7,0.738916256,0.384236453,0.133004926,11415
82cf3096e5cac09eb25c217629f4e440266d3b86,0,Shaofeng Shi,2018-09-27 13:43:45+08:00,['95f399e98957992e9a13fa1e71ee319e3018f246'],1,5,6,15409147,1,1,1,1,11415
dcd2a63ca7dee0dc028124b95fcc132c2c91b99c,0,Shaofeng Shi,2018-09-27 13:43:45+08:00,['82cf3096e5cac09eb25c217629f4e440266d3b86'],1,1,2,15409149,1,,,,11415
23e4ffa795baede6a772091fe823d5d4bf3048ee,0,Billy(Yiming) Liu,2018-09-27 21:14:58+08:00,['dcd2a63ca7dee0dc028124b95fcc132c2c91b99c'],67,59,126,15409275,6,0.888888889,0.888888889,0,11415
de396e3bb019243a4dfe51e11c77db6381de4357,1,Billy(Yiming) Liu,2018-09-27 21:17:13+08:00,['23e4ffa795baede6a772091fe823d5d4bf3048ee'],1,106,107,15409382,27,1,1,1,11415
08c451fb901eb252797be945f31dd113da79d983,0,Billy(Yiming) Liu,2018-09-27 21:17:46+08:00,['de396e3bb019243a4dfe51e11c77db6381de4357'],3,3,6,15409388,3,,,,11415
24efe159dce75255462b1792363937587bdf56fa,1,Shaofeng Shi,2018-09-27 22:45:00+08:00,['08c451fb901eb252797be945f31dd113da79d983'],40,34,74,15409462,4,1,0.142857143,0,11415
615b21c984489a191a3bab6cce3091607c8b1f6e,1,Shaofeng Shi,2018-09-27 22:48:16+08:00,['24efe159dce75255462b1792363937587bdf56fa'],0,151,151,15409613,3,,,,11417
9ae03f6d79d3f7b36f3600208d07d1d5c6856320,0,Shaofeng Shi,2018-09-27 22:54:15+08:00,['615b21c984489a191a3bab6cce3091607c8b1f6e'],1,6,7,15409620,1,0,0,0,11417
8e7d2a90fa8488e6720130c511d139296939b32d,1,Shaofeng Shi,2018-09-28 14:17:35+08:00,['9ae03f6d79d3f7b36f3600208d07d1d5c6856320'],59,59,118,15409738,19,,,,11417
c3e02c3f0c464008dc45c559888c4149b0457376,0,Shaofeng Shi,2018-09-28 17:45:18+08:00,['8e7d2a90fa8488e6720130c511d139296939b32d'],77,83,160,15409898,4,0,0,0.142857143,11417
65ab55e920a611c12a331f084599bbca6e3381bc,0,shaofengshi,2018-09-28 19:23:23+08:00,['c3e02c3f0c464008dc45c559888c4149b0457376'],285,0,285,15410183,3,0.7890625,0,0,11417
910b79e81f415eb9db4fcb414792132ade71df74,0,Shaofeng Shi,2018-09-29 10:47:27+08:00,['65ab55e920a611c12a331f084599bbca6e3381bc'],3,4,7,15410190,1,1,1,1,11417
10587a65fe0552179a5c8a6e1151686ce1c8a135,0,guosheng lu,2018-09-29 11:34:32+08:00,['910b79e81f415eb9db4fcb414792132ade71df74'],38,222,260,15410450,2,1,1,1,11417
796fede6740dd90e624a3d79791625176b504b0a,0,Shaofeng Shi,2018-09-29 17:27:41+08:00,['10587a65fe0552179a5c8a6e1151686ce1c8a135'],73,66,139,15410589,6,1,1,0,11417
bd8961c884cdc8ec5a9903a1d5a317bb626a2dff,0,Shaofeng Shi,2018-09-29 18:43:27+08:00,['796fede6740dd90e624a3d79791625176b504b0a'],26,63,89,15410678,10,0,0,0,11417
f42e937a2e968f94d8484f7bdafa7a86903eaa58,0,Shaofeng Shi,2018-09-30 08:22:02+08:00,['bd8961c884cdc8ec5a9903a1d5a317bb626a2dff'],0,65,65,15410743,2,,,,11417
aefaf9cccef7a21d96912ac55cf622d452d4d05c,0,Shaofeng Shi,2018-09-30 11:07:27+08:00,['f42e937a2e968f94d8484f7bdafa7a86903eaa58'],1,1,2,15410745,1,,,,11417
8db033097833be5118655a6d88a5b96e862055ae,0,Shaofeng Shi,2018-09-30 11:07:27+08:00,['aefaf9cccef7a21d96912ac55cf622d452d4d05c'],12,12,24,15410769,2,1,1,0,11417
3342d08ef8f4684cac6fe0bfc7484fbba6aa8fb9,0,Shaofeng Shi,2018-09-30 11:42:10+08:00,['8db033097833be5118655a6d88a5b96e862055ae'],0,26,26,15410795,2,1,1,1,11417
974bf6f3a971d256e2a93a11942a87143e61db21,0,Shaofeng Shi,2018-09-30 11:45:06+08:00,['3342d08ef8f4684cac6fe0bfc7484fbba6aa8fb9'],6,9,15,15410810,1,0,1,1,11417
55a085cffa14a0e24b2f8d716d3e4925faf3c40d,0,shaofengshi,2018-09-30 13:30:03+08:00,['974bf6f3a971d256e2a93a11942a87143e61db21'],4,4,8,15410818,1,,,,11417
8e98b8b8807929cb7bbdf8f52bbb98383c254a33,0,shaofengshi,2018-09-30 13:30:03+08:00,['55a085cffa14a0e24b2f8d716d3e4925faf3c40d'],8,1036,1044,15411862,6,0.371268657,0.861940299,0.843283582,11420
f859e4363f4fea381ee65538f76c37882750a531,1,Shaofeng Shi,2018-09-30 17:41:34+08:00,['8e98b8b8807929cb7bbdf8f52bbb98383c254a33'],253,259,512,15412374,4,0,0.714285714,1,11420
eb01b69ca958827e1e5b55078efd70f510f599da,1,Shaofeng Shi,2018-10-06 22:58:39+08:00,['f859e4363f4fea381ee65538f76c37882750a531'],3,98,101,15412475,5,0.289473684,1,0.868421053,11422
4f114d0257e3f13932f0909306abdfc6988466bd,0,Shaofeng Shi,2018-10-07 22:36:01+08:00,['eb01b69ca958827e1e5b55078efd70f510f599da'],7,7,14,15412489,3,,,,11422
25f094b19cd73f435911d838243cc3e808f8ec01,0,Shaofeng Shi,2018-10-07 22:36:33+08:00,['4f114d0257e3f13932f0909306abdfc6988466bd'],37,0,37,15412526,2,,,,11422
09c56680b178e4bb1b7200679e87fdeeae298e2e,0,Zhong,2018-10-08 10:10:19+08:00,['25f094b19cd73f435911d838243cc3e808f8ec01'],1,1,2,15412528,1,,,,11422
46c9f55b98fa9ea1230f62137fb53264e8980343,1,Shaofeng Shi,2018-10-09 09:49:01+08:00,['09c56680b178e4bb1b7200679e87fdeeae298e2e'],48,35,83,15412611,9,1,0,0.4,11422
ee93848cd7e5c0cbadb0d3701a7c92172b3546f2,1,Shaofeng Shi,2018-10-09 09:53:59+08:00,['46c9f55b98fa9ea1230f62137fb53264e8980343'],50,53,103,15412714,2,0,0.666666667,1,11422
72c2361a943afe251f7453133d8b5842afe57d5c,0,Shaofeng Shi,2018-10-09 10:17:40+08:00,['ee93848cd7e5c0cbadb0d3701a7c92172b3546f2'],126,86,212,15412926,1,,,,11422
2a90044c18e50e8c6fb3f60b3fd8e878e6b93ced,0,shaofengshi,2018-10-10 16:35:26+08:00,['72c2361a943afe251f7453133d8b5842afe57d5c'],0,5,5,15412931,1,,,,11422
d2a2864968f451938881d55073518851d60a6bd1,0,Shaofeng Shi,2018-10-10 19:00:25+08:00,['2a90044c18e50e8c6fb3f60b3fd8e878e6b93ced'],3,6,9,15412940,3,0,1,1,11422
97e95207bb14db2399f85e22c0d001d95a4ff187,0,Shaofeng Shi,2018-10-11 17:25:56+08:00,['d2a2864968f451938881d55073518851d60a6bd1'],43,63,106,15413046,4,0,0.666666667,0.5,11422
e2c1e7e7ef58ba7282f8b87de033567181546178,0,shaofengshi,2018-10-11 18:00:39+08:00,['97e95207bb14db2399f85e22c0d001d95a4ff187'],1,5,6,15413052,1,1,1,1,11422
85813226ae0d99d562cb3030157115e4aeadd7fd,0,Shaofeng Shi,2018-10-12 09:12:13+08:00,['e2c1e7e7ef58ba7282f8b87de033567181546178'],42,183,225,15413277,6,0.344827586,0.977011494,1,11422
562e88dfc5661485f80dbf2f1403b6384d3b49db,0,Shaofeng Shi,2018-10-12 09:56:40+08:00,['85813226ae0d99d562cb3030157115e4aeadd7fd'],6,14,20,15413297,1,0,1,0,11422
99cbaaa9938cc7c64c311b54dae6b3ce003c658e,0,shaofengshi,2018-10-12 11:24:21+08:00,['562e88dfc5661485f80dbf2f1403b6384d3b49db'],23,2,25,15413322,2,0,0,0,11422
fdafecc23a34e1b245dbe409cfd2fc1984717c55,0,shaofengshi,2018-10-12 11:35:11+08:00,['99cbaaa9938cc7c64c311b54dae6b3ce003c658e'],394,0,394,15413716,3,,,,11422
ec101142ad01b28b2a6156715f5e2cc6bb042fe3,0,shaofengshi,2018-10-14 10:55:11+08:00,['fdafecc23a34e1b245dbe409cfd2fc1984717c55'],0,3,3,15413719,1,0,1,1,11422
ae9c24a5782841e5079fad44d2c807b07ae72f33,0,Shaofeng Shi,2018-10-14 20:37:58+08:00,['ec101142ad01b28b2a6156715f5e2cc6bb042fe3'],86,99,185,15413904,3,0.142857143,0.142857143,0.571428571,11422
50f175892a558d40d645501745c9ab7d060fa0f6,0,Shaofeng Shi,2018-10-14 20:40:57+08:00,['ae9c24a5782841e5079fad44d2c807b07ae72f33'],20,13,33,15413937,7,0,0,0,11422
52307bab46db6240169492f240a8b69bde5110d8,0,Shaofeng Shi,2018-10-15 08:48:10+08:00,['50f175892a558d40d645501745c9ab7d060fa0f6'],16,60,76,15414013,5,1,1,1,11422
5f6007ff2b5aead4781c876fa3203dd67188d90b,0,shaofengshi,2018-10-15 09:24:43+08:00,['52307bab46db6240169492f240a8b69bde5110d8'],22,21,43,15414056,4,1,0,0,11422
fb0ea363ebdc6a7e44ff37b609af273e0dd3e842,0,Shaofeng Shi,2018-10-17 15:10:13+08:00,['5f6007ff2b5aead4781c876fa3203dd67188d90b'],1,5,6,15414062,2,1,1,1,11422
2ab720d7f5cfae7d734d33d02a3b8969fc52486b,0,shaofengshi,2018-10-18 10:55:48+08:00,['fb0ea363ebdc6a7e44ff37b609af273e0dd3e842'],60,16,76,15414138,5,0,0,0,11422
5a6ff1d54f004e2e8c1bcaa09e64bebc036df8ef,0,Shaofeng Shi,2018-10-18 22:19:20+08:00,['2ab720d7f5cfae7d734d33d02a3b8969fc52486b'],0,5,5,15414143,1,0,1,1,11422
30c484c33c2ddc728e4bc522dc00c97f7999c4b8,1,Shaofeng Shi,2018-10-19 10:20:26+08:00,['5a6ff1d54f004e2e8c1bcaa09e64bebc036df8ef'],101,205,306,15414449,8,0.775,0.35,1,11424
4e9737803d59ac18b1c27aa1cb902f69fd47c135,0,Shaofeng Shi,2018-10-19 18:11:57+08:00,['30c484c33c2ddc728e4bc522dc00c97f7999c4b8'],5,14,19,15414468,2,0.625,1,1,11424
c87856da8551b035a084c3e51aafe123f6845e6e,0,shaofengshi,2018-10-19 18:14:19+08:00,['4e9737803d59ac18b1c27aa1cb902f69fd47c135'],2,2,4,15414472,1,,,,11424
e9ccd0711d46b5db1d2b48b89f2d1be67f949632,1,shaofengshi,2018-10-21 22:49:38+08:00,['c87856da8551b035a084c3e51aafe123f6845e6e'],143,132,275,15414747,3,0.583333333,0,0,11425
a0dd4f7a57c9acd8ae77a9ccb714bf987765d360,0,Shaofeng Shi,2018-10-22 22:59:21+08:00,['e9ccd0711d46b5db1d2b48b89f2d1be67f949632'],1,26,27,15414774,2,1,1,1,11425
bef5dabd6015a87e62a9ecb3e35140b372e21f21,1,Shaofeng Shi,2018-10-22 23:01:16+08:00,['a0dd4f7a57c9acd8ae77a9ccb714bf987765d360'],2,2,4,15414778,2,,,,11425
c5394b432f59e3552ff51b2e20c27ec38838184c,1,shaofengshi,2018-10-23 09:56:21+08:00,['bef5dabd6015a87e62a9ecb3e35140b372e21f21'],84,104,188,15414966,2,1,1,1,11425
a0c662c7656751e21c006611268ff8eb252f0811,0,shaofengshi,2018-10-23 10:39:45+08:00,['c5394b432f59e3552ff51b2e20c27ec38838184c'],2,6,8,15414974,1,0,0,1,11425
8b51d4a0cd8c33ded5bb380885a731c381da710d,0,Shaofeng Shi,2018-10-23 21:27:07+08:00,['a0c662c7656751e21c006611268ff8eb252f0811'],18,114,132,15415106,5,0.882352941,0.882352941,0.882352941,11425
494933e08307d741a99417c6c43a9d1b833d77f4,0,Shaofeng Shi,2018-10-24 14:30:31+08:00,['8b51d4a0cd8c33ded5bb380885a731c381da710d'],4,126,130,15415236,6,0.384615385,1,0.692307692,11429
9c3165a1e10a830b48463a23aa26419986b5abfa,1,Shaofeng Shi,2018-10-24 14:47:36+08:00,['494933e08307d741a99417c6c43a9d1b833d77f4'],3,51,54,15415290,2,0,1,1,11429
21bc42d90a0fb392115b4eda75a11cf092f5c7e6,0,guosheng lu,2018-10-24 18:45:26+08:00,['9c3165a1e10a830b48463a23aa26419986b5abfa'],6,8,14,15415304,1,,,,11429
2fd01c3f888c14cf484dbcb26bcb365d95cdca15,0,shaofengshi,2018-10-25 13:55:50+08:00,['21bc42d90a0fb392115b4eda75a11cf092f5c7e6'],1,1,2,15415306,1,,,,11429
baae2c8627da0f2ba92320e4348d244209fad83a,1,Shaofeng Shi,2018-10-25 14:04:31+08:00,['2fd01c3f888c14cf484dbcb26bcb365d95cdca15'],1,8,9,15415315,1,1,1,1,11429
0f0346be2dfbb753ccfb9db698c5f46d6544a190,1,Shaofeng Shi,2018-10-25 14:05:45+08:00,['baae2c8627da0f2ba92320e4348d244209fad83a'],44,81,125,15415440,6,1,0,1,11430
e9e427a73ef08314f983a2f3dfb37ecb37c752be,0,Shaofeng Shi,2018-10-25 14:06:50+08:00,['0f0346be2dfbb753ccfb9db698c5f46d6544a190'],50,52,102,15415542,5,1,1,1,11430
9e777440d0e08b8dd7ff64a349cb52d7d653a675,0,Shaofeng Shi,2018-10-26 21:38:38+08:00,['e9e427a73ef08314f983a2f3dfb37ecb37c752be'],1,1,2,15415544,1,,,,11430
4817ae0c23b40004f41030398c0e6e1178c825f0,1,shaofengshi,2018-10-29 11:33:01+08:00,['9e777440d0e08b8dd7ff64a349cb52d7d653a675'],11,38,49,15415593,1,1,1,0.16,11430
26e71a762b08445ad173fe42fc84c204ff33fe49,0,Shaofeng Shi,2018-10-29 14:27:15+08:00,['4817ae0c23b40004f41030398c0e6e1178c825f0'],3,23,26,15415619,5,0,0.333333333,1,11430
3bcbaa88b97cf868ddf8f51a54b015ef3b7cc068,1,Shaofeng Shi,2018-10-29 15:20:57+08:00,['26e71a762b08445ad173fe42fc84c204ff33fe49'],23,20,43,15415662,2,0,0.6,0,11430
f12088637347385ba1d81eb345c39d2276c2bbe3,0,Shaofeng Shi,2018-10-29 19:27:47+08:00,['3bcbaa88b97cf868ddf8f51a54b015ef3b7cc068'],39,545,584,15416246,12,0.709543568,0.514522822,0.709543568,11436
1fcf9679e14978b9d0fa36a500797991be34e63e,0,Shaofeng Shi,2018-10-29 19:27:47+08:00,['f12088637347385ba1d81eb345c39d2276c2bbe3'],6,18,24,15416270,3,0.75,0,0.833333333,11436
7e1cdeda85dc293efe8bd408444d7bbef8401be6,0,Shaofeng Shi,2018-10-29 19:27:47+08:00,['1fcf9679e14978b9d0fa36a500797991be34e63e'],4,116,120,15416390,3,0.283333333,0.566666667,0.4,11437
95afdb44e52be0d1e24c2487745906dbd35da8fc,0,Shaofeng Shi,2018-10-29 19:27:47+08:00,['7e1cdeda85dc293efe8bd408444d7bbef8401be6'],0,318,318,15416708,4,0.488372093,1,0.945736434,11441
6b5f961724e4b7964dbc1b268a200095d0fbe30d,1,Shaofeng Shi,2018-10-29 19:27:47+08:00,['95afdb44e52be0d1e24c2487745906dbd35da8fc'],38,26,64,15416772,2,0.818181818,0.818181818,0,11441
b9aab0105cbf00a3581409a357be3816d0cd89a6,1,Shaofeng Shi,2018-10-29 19:27:47+08:00,['6b5f961724e4b7964dbc1b268a200095d0fbe30d'],0,59,59,15416831,3,0.348837209,0.348837209,1,11441
cd952ffd23e27b8468db03c38758d552a00c7486,0,Shaofeng Shi,2018-10-29 19:27:47+08:00,['b9aab0105cbf00a3581409a357be3816d0cd89a6'],0,2463,2463,15419294,17,0.573905863,0.729149463,0.876135425,11456
73d0fd43af2ad4fa3ae7830341a0e7d96a349ee5,0,Shaofeng Shi,2018-10-29 19:27:47+08:00,['cd952ffd23e27b8468db03c38758d552a00c7486'],5,27,32,15419326,2,1,1,1,11456
2f04803e2c860922a5f33469403f667bce004cc3,0,Shaofeng Shi,2018-10-29 19:27:47+08:00,['73d0fd43af2ad4fa3ae7830341a0e7d96a349ee5'],0,373,373,15419699,5,0.254098361,1,1,11461
7b58b161a1d3264e744e3e78b0cffbde5e830e67,1,Shaofeng Shi,2018-10-29 19:27:47+08:00,['2f04803e2c860922a5f33469403f667bce004cc3'],7,526,533,15420232,9,0.47266881,0.675241158,0.768488746,11464
78b17f5a70fb2e5d66e9cce4def79e5adb377878,0,Shaofeng Shi,2018-10-29 19:27:47+08:00,['7b58b161a1d3264e744e3e78b0cffbde5e830e67'],29,25,54,15420286,1,1,0.571428571,0.571428571,11464
de86ed61271e1cddb98ddfb29639f757823f0b2a,0,Shaofeng Shi,2018-10-29 19:27:47+08:00,['78b17f5a70fb2e5d66e9cce4def79e5adb377878'],1,7,8,15420294,2,0,0,1,11464
43c7207524f8507e1a47552d71186e6c8d7254c6,1,shaofengshi,2018-10-30 13:48:25+08:00,['de86ed61271e1cddb98ddfb29639f757823f0b2a'],7,9,16,15420310,2,0,1,1,11464
4f3fd2bc19e0f4f48ce52029d15213c3cdffb687,0,Shaofeng Shi,2018-10-30 14:00:05+08:00,['43c7207524f8507e1a47552d71186e6c8d7254c6'],4,9,13,15420323,1,0,1,0,11464
fa6fdbda5c76cb9558ae0a818b3f68b7eb9b6bbb,0,shaofengshi,2018-11-01 09:04:44+08:00,['4f3fd2bc19e0f4f48ce52029d15213c3cdffb687'],2,2,4,15420327,1,,,,11464
3fabbe6d2b1199bedb7b74083feabc6586a6d644,0,shaofengshi,2018-11-01 15:37:00+08:00,['fa6fdbda5c76cb9558ae0a818b3f68b7eb9b6bbb'],1,1,2,15420329,1,,,,11464
65441434e0aff410050009b4538ef3bf9e7af93f,0,Shaofeng Shi,2018-11-01 18:28:15+08:00,['3fabbe6d2b1199bedb7b74083feabc6586a6d644'],2,5,7,15420336,2,0,1,1,11464
2793a94331d85a35ca7144a4584dd6ac0e4fb901,0,shaofengshi,2018-11-01 21:47:51+08:00,['65441434e0aff410050009b4538ef3bf9e7af93f'],1,1,2,15420338,1,,,,11464
37fdf651e5d0d986a177e17e302871400beb0c97,0,shaofengshi,2018-11-02 12:07:47+08:00,['2793a94331d85a35ca7144a4584dd6ac0e4fb901'],1,1,2,15420340,1,,,,11464
caf109ea016c0bcbbef8f15c26b620003f253955,0,shaofengshi,2018-11-02 17:31:52+08:00,['37fdf651e5d0d986a177e17e302871400beb0c97'],7,8,15,15420355,1,,,,11464
a0e703986a5d965b3db8ee5be16dc3a26738c9eb,0,Zhong,2018-11-06 14:47:37+08:00,['caf109ea016c0bcbbef8f15c26b620003f253955'],1,1,2,15420357,1,,,,11464
90854f4619d4a92b9551140d82a48516515a4b80,0,shaofengshi,2018-11-07 08:38:05+08:00,['a0e703986a5d965b3db8ee5be16dc3a26738c9eb'],3,3,6,15420363,3,,,,11464
c1542015776bb6bb86225791c4da3caf37d908a8,0,Shaofeng Shi,2018-11-07 13:46:31+08:00,['90854f4619d4a92b9551140d82a48516515a4b80'],1,4,5,15420368,1,1,1,1,11464
c549db5749e1e01095a315ae805e753283bf802b,0,Shaofeng Shi,2018-11-08 16:57:27+08:00,['c1542015776bb6bb86225791c4da3caf37d908a8'],1,1,2,15420370,1,,,,11464
8e1fd97321d8c64adb328511bbd53e6d529571ab,0,shaofengshi,2018-11-10 09:57:25+08:00,['c549db5749e1e01095a315ae805e753283bf802b'],2,16,18,15420388,3,0,0.75,1,11464
91a1b31080767e9590ef5af3d9d9861390d9c097,0,shaofengshi,2018-11-10 22:18:53+08:00,['8e1fd97321d8c64adb328511bbd53e6d529571ab'],35,56,91,15420479,1,1,1,1,11464
f0b26c42bad84d6ee2cb367557d256e057d9287c,0,Shaofeng Shi,2018-11-12 08:59:20+08:00,['91a1b31080767e9590ef5af3d9d9861390d9c097'],2,2,4,15420483,1,,,,11464
889dc503c6b538e60d180055b9b39b84d15d9ba0,0,Shaofeng Shi,2018-11-15 20:21:37+08:00,['f0b26c42bad84d6ee2cb367557d256e057d9287c'],8,110,118,15420601,3,0.768115942,1,1,11464
ff730dbdfe76ee18a2b059a76f3cdbe8222dacad,1,shaofengshi,2018-11-15 20:31:39+08:00,['889dc503c6b538e60d180055b9b39b84d15d9ba0'],437,24030,24467,15445068,95,0.543527631,0.785011355,0.918622256,11522
634498649f20ce61fcabe0b46fe515bb6ca96af0,0,shaofengshi,2018-11-15 20:56:17+08:00,['ff730dbdfe76ee18a2b059a76f3cdbe8222dacad'],12593,64,12657,15457725,27,0.616265298,0.454270299,0.350309251,11522
45fb6a2661a9ae92a5766ace97d8a6a51f188f7c,0,shaofengshi,2018-11-20 09:36:37+08:00,['634498649f20ce61fcabe0b46fe515bb6ca96af0'],1,7,8,15457733,2,1,0,1,11522
c9d5d0deac6ce587761f3359cdcfe161cb991ec5,0,shaofengshi,2018-11-20 10:48:33+08:00,['45fb6a2661a9ae92a5766ace97d8a6a51f188f7c'],1,1,2,15457735,1,,,,11522
dca3ee7e12e238f6c0baf25388c5a63d3298758f,0,Shaofeng Shi,2018-11-20 10:53:01+08:00,['c9d5d0deac6ce587761f3359cdcfe161cb991ec5'],6,9,15,15457750,4,,,,11522
cede58b5325bdb8b17dd8f0f1d59f8e0ded52ceb,1,Shaofeng Shi,2018-11-20 16:15:55+08:00,['dca3ee7e12e238f6c0baf25388c5a63d3298758f'],14,21,35,15457785,12,0,0,1,11522
4e0340737fc39364c23c6b7d6d5f604a8e2eca7f,0,shaofengshi,2018-11-20 18:01:31+08:00,['cede58b5325bdb8b17dd8f0f1d59f8e0ded52ceb'],1,1,2,15457787,1,,,,11522
5aea3d40646ed578f5a35fde290ebab560790785,0,Shaofeng Shi,2018-11-20 21:45:44+08:00,['4e0340737fc39364c23c6b7d6d5f604a8e2eca7f'],1,34,35,15457822,2,,,,11523
7105e5ef1403a571922efe1661cc3d62680d560a,0,Shaofeng Shi,2018-11-21 08:20:27+08:00,['5aea3d40646ed578f5a35fde290ebab560790785'],2,3,5,15457827,1,,,,11523
78a5f349e8f744edeed8072b0dc82ce7d21e052f,0,Shaofeng Shi,2018-11-21 12:16:35+08:00,['7105e5ef1403a571922efe1661cc3d62680d560a'],0,1,1,15457828,1,0,0,0,11523
98cb504470c85718abd1616e78d36851c21f2fd0,0,Shaofeng Shi,2018-11-21 17:52:50+08:00,['78a5f349e8f744edeed8072b0dc82ce7d21e052f'],7,11,18,15457846,2,1,1,1,11523
ac7a86a62a68301a195599e12cc8d7ddeeb73abd,1,shaofengshi,2018-11-26 18:35:40+08:00,['98cb504470c85718abd1616e78d36851c21f2fd0'],84,166,250,15458096,17,1,0.555555556,1,11525
920ac2f069cddf4d07bcc93b123811ce8fc41bc2,0,Shaofeng Shi,2018-11-26 18:44:42+08:00,['ac7a86a62a68301a195599e12cc8d7ddeeb73abd'],56,140,196,15458292,26,0.857142857,0.904761905,0.761904762,11526
b046585fc8936799fa5480857e94f9dc4b4e35f0,0,Shaofeng Shi,2018-11-26 18:44:42+08:00,['920ac2f069cddf4d07bcc93b123811ce8fc41bc2'],2,1,3,15458295,1,,,,11526
733d5742bb58acc6cf70ccb1909acccbc5668ce4,0,Shaofeng Shi,2018-11-26 18:47:22+08:00,['b046585fc8936799fa5480857e94f9dc4b4e35f0'],6,47,53,15458348,1,,,,11526
70f15d7b5a580f85cf604ca7d689a292cf031def,0,Shaofeng Shi,2018-11-26 21:25:22+08:00,['733d5742bb58acc6cf70ccb1909acccbc5668ce4'],7,4,11,15458359,2,1,0,0,11526
c4e58dcd039547004c374871be2626411f1e8abb,0,shaofengshi,2018-11-27 13:40:12+08:00,['70f15d7b5a580f85cf604ca7d689a292cf031def'],1,2,3,15458362,1,,,,11526
2d8e0fcd2c31a14a49fde061f4c8c97fddd64f7c,0,shaofengshi,2018-11-27 13:40:20+08:00,['c4e58dcd039547004c374871be2626411f1e8abb'],140,56,196,15458558,26,0.142857143,0.095238095,0.238095238,11526
4e6a69b7fa819918b33a5f1a5d25308ae316df97,0,Shaofeng Shi,2018-11-27 22:16:20+08:00,['2d8e0fcd2c31a14a49fde061f4c8c97fddd64f7c'],16,21,37,15458595,1,0,0.2,0,11526
7bcc6987e5bbcfd57f320aa19c4fba67ed02aaea,1,Shaofeng Shi,2018-11-27 22:43:45+08:00,['4e6a69b7fa819918b33a5f1a5d25308ae316df97'],401,124,525,15459120,14,0.50862069,0.086206897,0.275862069,11526
97ee98bfbd93510b578db93998f2ab488199ef40,1,Shaofeng Shi,2018-11-28 08:49:42+08:00,['7bcc6987e5bbcfd57f320aa19c4fba67ed02aaea'],55,138,193,15459313,25,0.857142857,0.904761905,0.761904762,11527
4158d7b3b56cbeb3c10ec5c091c23334131616a5,1,Shaofeng Shi,2018-11-28 15:20:30+08:00,['97ee98bfbd93510b578db93998f2ab488199ef40'],165,921,1086,15460399,22,0.249508841,0.884086444,0.774066798,11529
be5df4a8bb6939c0c62c6135c4312fe3ad56775d,0,Shaofeng Shi,2018-11-28 19:19:34+08:00,['4158d7b3b56cbeb3c10ec5c091c23334131616a5'],4,1,5,15460404,2,1,0,0,11529
7f672b074a068d20779d33889f1cb63b0da172a7,1,guosheng lu,2018-12-05 13:47:53+08:00,['be5df4a8bb6939c0c62c6135c4312fe3ad56775d'],4,4,8,15460412,1,,,,11529
b8ad201e7797c909cb2069ec664e51452f85654e,0,shaofengshi,2018-12-06 17:15:56+08:00,['7f672b074a068d20779d33889f1cb63b0da172a7'],12,37,49,15460461,3,0.764705882,1,1,11529
2979f4092ee338ad1bbdaeaca5639d99466268d8,0,Shaofeng Shi,2018-12-06 18:27:19+08:00,['b8ad201e7797c909cb2069ec664e51452f85654e'],1,0,1,15460462,1,,,,11529
39878baa405385e850820838f86fcfe56a10b0ca,1,Shaofeng Shi,2018-12-08 17:31:17+08:00,['2979f4092ee338ad1bbdaeaca5639d99466268d8'],22,27,49,15460511,6,1,1,1,11529
b169d2d32be48c27d93d2af6a0a52ebe0143dd65,1,Shaofeng Shi,2018-12-09 20:44:21+08:00,['39878baa405385e850820838f86fcfe56a10b0ca'],18,94,112,15460623,7,0.644067797,0.644067797,1,11529
2de2b9fced1ba27b1688b803e119160aa45950fc,0,Shaofeng Shi,2018-12-10 11:07:45+08:00,['b169d2d32be48c27d93d2af6a0a52ebe0143dd65'],1,24,25,15460648,1,,,,11529
684f21c9282af6491e36b96ee97c2c1953439e77,1,Shaofeng Shi,2018-12-10 17:19:53+08:00,['2de2b9fced1ba27b1688b803e119160aa45950fc'],1588,2529,4117,15464765,59,0.606326889,0.616871705,0.467486819,11534
4e171c8b0fbcd7a6ffaa24e62a12dd7a070ccd49,0,Shaofeng Shi,2018-12-10 21:54:19+08:00,['684f21c9282af6491e36b96ee97c2c1953439e77'],24,11,35,15464800,3,0.466666667,0.466666667,0,11534
497cdf0c3bf0bee3bcc1c9d9ff21b0a00448f42e,0,Shaofeng Shi,2018-12-10 21:54:19+08:00,['4e171c8b0fbcd7a6ffaa24e62a12dd7a070ccd49'],1,1,2,15464802,1,,,,11534
0d9fbbee85c6a5415639cd59ba5ddacbd5056537,1,Shaofeng Shi,2018-12-11 13:50:24+08:00,['497cdf0c3bf0bee3bcc1c9d9ff21b0a00448f42e'],4,21,25,15464827,5,0,0.222222222,0.333333333,11534
195640eb0499a449a02b412af7e247cdcde47cec,1,Shaofeng Shi,2018-12-11 16:18:57+08:00,['0d9fbbee85c6a5415639cd59ba5ddacbd5056537'],677,777,1454,15466281,20,1,,1,11539
cddb493884e624c12c3452bad4de7482fc37de8d,1,Shaofeng Shi,2018-12-11 16:18:57+08:00,['195640eb0499a449a02b412af7e247cdcde47cec'],27,60,87,15466368,2,1,1,1,11539
0b31a911302c0754ae6da5745d127dcaa336a467,1,Shaofeng Shi,2018-12-12 08:59:57+08:00,['cddb493884e624c12c3452bad4de7482fc37de8d'],74,69,143,15466511,9,1,0,0,11539
2e5505c0fc866ee671e74552d01853ee0d8f904f,0,shaofengshi,2018-12-12 09:40:57+08:00,['0b31a911302c0754ae6da5745d127dcaa336a467'],1,3,4,15466515,1,1,1,1,11539
23732b207d90a2a5ad9068e07c3b5176bceb0406,0,Shaofeng Shi,2018-12-12 10:10:15+08:00,['2e5505c0fc866ee671e74552d01853ee0d8f904f'],60,51,111,15466626,5,1,0.444444444,0.222222222,11539
ba0fbf9b42034dbc72e916ba3fc59bcaac906f0d,0,Shaofeng Shi,2018-12-12 10:51:29+08:00,['23732b207d90a2a5ad9068e07c3b5176bceb0406'],19,27,46,15466672,2,0,1,1,11539
bef9e5c13b48f150145327a2648a5cbbd0d425c2,0,Shaofeng Shi,2018-12-12 18:55:34+08:00,['ba0fbf9b42034dbc72e916ba3fc59bcaac906f0d'],65,1196,1261,15467933,19,0.4390625,0.778125,0.76875,11546
fab6955b9d31837d8bdb723c043ecd5c30eb2625,0,Shaofeng Shi,2018-12-13 09:25:28+08:00,['bef9e5c13b48f150145327a2648a5cbbd0d425c2'],24,21,45,15467978,5,0,0,1,11546
ab51ea9aad035d08450da2abdccca2441c37092e,1,Shaofeng Shi,2018-12-14 09:43:02+08:00,['fab6955b9d31837d8bdb723c043ecd5c30eb2625'],0,37,37,15468015,2,,,,11547
1358e801990b1059ddbc4133381a74a77d66105b,0,shaofengshi,2018-12-14 11:31:59+08:00,['ab51ea9aad035d08450da2abdccca2441c37092e'],1,1,2,15468017,1,,,,11547
f031005e4bd61dc6340c221d9fcbc16fa2024777,0,shaofengshi,2018-12-14 11:32:40+08:00,['1358e801990b1059ddbc4133381a74a77d66105b'],1,1,2,15468019,1,,,,11547
6590abfddc72ae3ac3ca0ecaf6d90bd389f3979d,1,shaofengshi,2018-12-14 14:37:22+08:00,['f031005e4bd61dc6340c221d9fcbc16fa2024777'],1,38,39,15468058,5,0,1,1,11548
62830469424c3f2dcb79f35d1f66e1698768428f,0,Shaofeng Shi,2018-12-15 21:19:25+08:00,['6590abfddc72ae3ac3ca0ecaf6d90bd389f3979d'],39,31,70,15468128,6,0.4,0.5,0.5,11548
32a31506ce609eeabe3c88544a2bcf742a5c5599,0,Shaofeng Shi,2018-12-15 21:21:01+08:00,['62830469424c3f2dcb79f35d1f66e1698768428f'],17,15,32,15468160,3,,,,11548
fb54f38cdad26b776b6f5116cacfbc8470e19142,0,Shaofeng Shi,2018-12-15 21:22:36+08:00,['32a31506ce609eeabe3c88544a2bcf742a5c5599'],23,70,93,15468253,5,0.078947368,0.868421053,1,11548
9fb5b4657edcb58d370bd64e5b011172188c4c37,0,Shaofeng Shi,2018-12-16 14:27:51+08:00,['fb54f38cdad26b776b6f5116cacfbc8470e19142'],1,2,3,15468256,1,1,1,1,11548
dd0943a74bdba838a21342a21f32e8be0012fa13,0,Shaofeng Shi,2018-12-16 14:29:20+08:00,['9fb5b4657edcb58d370bd64e5b011172188c4c37'],0,5,5,15468261,1,0,1,1,11548
13d183ab4e5deef11ffc7148eb408278c0a97a5f,0,Shaofeng Shi,2018-12-17 14:46:34+08:00,['dd0943a74bdba838a21342a21f32e8be0012fa13'],0,28,28,15468289,1,0,0,1,11548
45f6f99ebef4a0d64afc2341e5c786201cad0500,0,shaofengshi,2018-12-17 16:03:32+08:00,['13d183ab4e5deef11ffc7148eb408278c0a97a5f'],1,1,2,15468291,1,,,,11548
adb83bbe9751205f5695501fa92038b1bd4d18b0,0,Zhong,2018-12-18 15:17:20+08:00,['45f6f99ebef4a0d64afc2341e5c786201cad0500'],44,5,49,15468340,3,0.379310345,0,0,11548
d4ad0fa0f11fa5f5b40e77a3631a6b03b3ac7a12,0,Shaofeng Shi,2018-12-18 21:48:42+08:00,['45f6f99ebef4a0d64afc2341e5c786201cad0500'],3,3,6,15468346,2,1,1,1,11548
af77cfa28b5f2b47b57dce71b00f69115275748c,0,kyotoYaho,2018-12-19 11:48:57+08:00,['d4ad0fa0f11fa5f5b40e77a3631a6b03b3ac7a12'],6,7,13,15468359,1,0,0,1,11548
9b205feffe7e6cc3576fabf62a59c07f86880dd2,0,GitHub,2018-12-19 14:02:58+08:00,"['af77cfa28b5f2b47b57dce71b00f69115275748c', 'adb83bbe9751205f5695501fa92038b1bd4d18b0']",44,5,49,15468408,3,,,,11548
91efa0cff4c23246dd4e9c8eee87b7aeee54837e,0,kyotoYaho,2018-12-19 14:49:32+08:00,['9b205feffe7e6cc3576fabf62a59c07f86880dd2'],4,581,585,15468993,3,0.276536313,0.765363128,0.958100559,11549
6f760efb41deab05a3ac4499851ed98e59a74a7b,0,Shaofeng Shi,2018-12-22 22:04:29+08:00,['91efa0cff4c23246dd4e9c8eee87b7aeee54837e'],1,2,3,15468996,1,,,,11549
b31385f8e53d49ad68b5030769c1611a8a64ae9c,1,Shaofeng Shi,2018-12-22 22:04:29+08:00,['6f760efb41deab05a3ac4499851ed98e59a74a7b'],3,31,34,15469030,5,0,1,1,11549
9bf0063a486150b1fc742393dd7dabe7bcfecdb2,0,Shaofeng Shi,2018-12-23 09:57:38+08:00,['b31385f8e53d49ad68b5030769c1611a8a64ae9c'],2,2,4,15469034,2,,,,11549
95b812fb95e8a69ab35ada11a341959ac15c145a,0,Shaofeng Shi,2018-12-24 11:15:50+08:00,['9bf0063a486150b1fc742393dd7dabe7bcfecdb2'],11,48,59,15469093,3,0.769230769,0.769230769,1,11549
5982bb79bacc5e0728df52a6e602239e1d2c6b26,0,Shaofeng Shi,2018-12-24 17:00:10+08:00,['95b812fb95e8a69ab35ada11a341959ac15c145a'],44,97,141,15469234,3,0,0,1,11549
3b9c5a55139ca85e60e45bb5c748f480178a93d5,0,Shaofeng Shi,2018-12-24 17:05:23+08:00,['5982bb79bacc5e0728df52a6e602239e1d2c6b26'],18,20,38,15469272,3,1,1,1,11549
0c60c6b9cad6ffefd716fd2a3e41a3b9b45788b5,0,Shaofeng Shi,2018-12-24 17:22:04+08:00,['3b9c5a55139ca85e60e45bb5c748f480178a93d5'],17,57,74,15469346,1,0,0,1,11549
0c92d1cbbb22ffa222b7f3e476e5441bac50f756,0,shaofengshi,2018-12-24 22:50:36+08:00,['0c60c6b9cad6ffefd716fd2a3e41a3b9b45788b5'],2,4,6,15469352,1,,,,11549
8cfe32cf4f61d218439e57e134ccc3413aa98f89,0,kyotoYaho,2018-12-25 09:28:57+08:00,['0c92d1cbbb22ffa222b7f3e476e5441bac50f756'],81,78,159,15469511,2,1,0,0,11549
4db6a37c7220c122cedb9fac1a2c735f10e27226,0,kyotoYaho,2018-12-25 09:28:57+08:00,['8cfe32cf4f61d218439e57e134ccc3413aa98f89'],68,73,141,15469652,4,1,1,0,11549
4850dacece8a2e90f4333b50e2e8304635a730a2,1,kyotoYaho,2018-12-25 09:28:57+08:00,['4db6a37c7220c122cedb9fac1a2c735f10e27226'],166,495,661,15470313,10,0.088235294,0.676470588,0.93697479,11549
1af62e46516b7b9a31d3de5a1a7867f9cb51799b,0,Shaofeng Shi,2018-12-25 10:16:43+08:00,['4850dacece8a2e90f4333b50e2e8304635a730a2'],1,0,1,15470314,1,,,,11549
338a8f1e699dcdc297f48a9a0ecfb99d2b1c947b,0,Shaofeng Shi,2018-12-26 10:18:41+08:00,['1af62e46516b7b9a31d3de5a1a7867f9cb51799b'],31,32,63,15470377,1,,,,11549
72f53331fb1974fbb8366e0f13c565d1d4c7a181,0,shaofengshi,2018-12-26 12:12:33+08:00,['338a8f1e699dcdc297f48a9a0ecfb99d2b1c947b'],1,1,2,15470379,1,,,,11549
5976c692b0e344d2dac63790b6f03bff9d1740bc,0,Shaofeng Shi,2018-12-26 13:49:42+08:00,['72f53331fb1974fbb8366e0f13c565d1d4c7a181'],0,4,4,15470383,1,0,0,1,11549
7539ac4d5fa613ab705bc3368e78355db0ae5a8e,1,Shaofeng Shi,2018-12-26 13:49:42+08:00,['5976c692b0e344d2dac63790b6f03bff9d1740bc'],2,16,18,15470401,5,0.545454545,0.545454545,1,11549
eadb2a80dac7d2f83114162e09dc6a9f225f961e,0,shaofengshi,2018-12-26 14:03:14+08:00,['7539ac4d5fa613ab705bc3368e78355db0ae5a8e'],1,0,1,15470402,1,1,0,1,11549
e1ba10ab4f0bfbea3abd1aed1860c81762aca91a,1,Shaofeng Shi,2018-12-26 14:49:28+08:00,['eadb2a80dac7d2f83114162e09dc6a9f225f961e'],16,11,27,15470429,2,1,0.166666667,0,11549
e3896af23471672ae0b1b4a5aa2053eda3079175,0,Shaofeng Shi,2018-12-26 14:49:57+08:00,['e1ba10ab4f0bfbea3abd1aed1860c81762aca91a'],3,37,40,15470469,3,0,0.2,1,11549
49e835a3b317ee79ecd4ed1ebbb25409e0ce6718,0,Shaofeng Shi,2018-12-27 10:09:24+08:00,['e3896af23471672ae0b1b4a5aa2053eda3079175'],4,14,18,15470487,1,0.333333333,0.333333333,0.333333333,11549
a20f04fb17ccb58162471868e5adf3594fb41c77,0,Shaofeng Shi,2018-12-27 16:10:33+08:00,['49e835a3b317ee79ecd4ed1ebbb25409e0ce6718'],2,47,49,15470536,1,0,0,1,11549
cc00df69e2459686d71c7852bcbc94fd14213555,0,kyotoYaho,2018-12-28 11:43:45+08:00,['a20f04fb17ccb58162471868e5adf3594fb41c77'],0,7,7,15470543,1,,,,11549
bfe1364297df1d192fb70905d3ace19f67380a79,0,Shaofeng Shi,2018-12-29 09:01:52+08:00,['cc00df69e2459686d71c7852bcbc94fd14213555'],8,13,21,15470564,1,0,0,1,11549
33edddf29be4c8ed9529b1477da474a090f7811b,0,Shaofeng Shi,2018-12-31 11:45:26+08:00,['bfe1364297df1d192fb70905d3ace19f67380a79'],1,218,219,15470783,3,0.384615385,1,1,11550
250f1a1941432059e86207fbf483f183d5b3ed9a,1,Shaofeng Shi,2019-01-03 15:04:52+08:00,['33edddf29be4c8ed9529b1477da474a090f7811b'],3,6,9,15470792,1,0,0,1,11550
b780759c6641f0dfbd57f91d4f3d568b8dbb46f6,0,kyotoYaho,2019-01-07 09:48:59+08:00,['250f1a1941432059e86207fbf483f183d5b3ed9a'],9,13,22,15470814,1,0,1,1,11550
d5bfbb1293ab549a3182ddda761ad5023f98d175,1,Shaofeng Shi,2019-01-07 10:19:33+08:00,['b780759c6641f0dfbd57f91d4f3d568b8dbb46f6'],10,51,61,15470875,6,0.928571429,0,0.928571429,11551
108765e3080366e32a336475eb1e149ba3da4585,0,kyotoYaho,2019-01-07 10:27:21+08:00,['d5bfbb1293ab549a3182ddda761ad5023f98d175'],3,7,10,15470885,1,1,1,1,11551
0e83b2dbc37cebe68d14e73e68602fa3dc80f439,0,shaofengshi,2019-01-07 10:34:24+08:00,['108765e3080366e32a336475eb1e149ba3da4585'],1,1,2,15470887,1,,,,11551
1f369678c78c80c7a4cb1fb2a3e5902cb6171126,0,kyotoYaho,2019-01-07 10:50:11+08:00,['0e83b2dbc37cebe68d14e73e68602fa3dc80f439'],1,2,3,15470890,1,,,,11551
5c9c3dfb8dbd665d864a036f9cbbc845edc2c172,0,kyotoYaho,2019-01-07 15:39:42+08:00,['1f369678c78c80c7a4cb1fb2a3e5902cb6171126'],7,7,14,15470904,1,,,,11551
601deae4e72203c3309023848d70cd95941029c2,0,kyotoYaho,2019-01-07 20:44:08+08:00,['5c9c3dfb8dbd665d864a036f9cbbc845edc2c172'],1,4,5,15470909,1,0,0,1,11551
fe8014e4643642668b57b1bf77465569f125734f,0,Shaofeng Shi,2019-01-11 22:46:23+08:00,['601deae4e72203c3309023848d70cd95941029c2'],0,2,2,15470911,1,0,1,1,11551
4c88f1863de9133ca3405d74cebf0e0a1479a6c9,0,Shaofeng Shi,2019-01-17 13:57:06+08:00,['fe8014e4643642668b57b1bf77465569f125734f'],0,2,2,15470913,1,0,0,1,11551
3825a3d7fb0b503b819631caa6920eec3231852c,0,Shaofeng Shi,2019-01-17 14:17:31+08:00,['4c88f1863de9133ca3405d74cebf0e0a1479a6c9'],34,42,76,15470989,3,1,1,1,11551
e7783777df4256d391f1d37a3d015bdd2398be2b,0,Shaofeng Shi,2019-01-17 14:17:31+08:00,['3825a3d7fb0b503b819631caa6920eec3231852c'],7,6,13,15471002,1,,,,11551
1cf232289a663304f770421c7f909314064baeb5,0,Shaofeng Shi,2019-01-17 15:21:16+08:00,['e7783777df4256d391f1d37a3d015bdd2398be2b'],0,12,12,15471014,1,0,0,1,11551
4a025fe11db7dd2ea31bf7028eb368ebd2d72553,1,Shaofeng Shi,2019-01-21 10:48:17+08:00,['1cf232289a663304f770421c7f909314064baeb5'],1,2,3,15471017,1,1,1,1,11551
e413a812690ceaff07f093514b328eee8baeb40d,0,Shaofeng Shi,2019-01-21 21:22:51+08:00,['4a025fe11db7dd2ea31bf7028eb368ebd2d72553'],2,5,7,15471024,2,0,0,1,11551
b4dace4db8304a53082265e614384132316801bb,0,Shaofeng Shi,2019-01-22 10:21:03+08:00,['e413a812690ceaff07f093514b328eee8baeb40d'],0,6,6,15471030,1,,,,11551
a96e6428a4eee5519542978b891291b0602bdd92,0,guosheng lu,2019-01-22 10:51:25+08:00,['b4dace4db8304a53082265e614384132316801bb'],2,2,4,15471034,1,,,,11551
168fa86ebe8bbd09642f894da0312ebc623f1ada,1,Shaofeng Shi,2019-01-23 11:59:24+08:00,['a96e6428a4eee5519542978b891291b0602bdd92'],5,39,44,15471078,9,0.608695652,0.956521739,1,11551
d3235e7b1fa4d95b56d79ebee00dcfee67af53b4,0,Shaofeng Shi,2019-01-24 15:46:41+08:00,['168fa86ebe8bbd09642f894da0312ebc623f1ada'],18,14,32,15471110,3,,,,11551
c44832c15ca282da02ee55e9c784f0193cbe2233,1,Shaofeng Shi,2019-01-26 20:35:59+08:00,['d3235e7b1fa4d95b56d79ebee00dcfee67af53b4'],1,1,2,15471112,1,,,,11551
b99beb640f67bb2957ce770bf3bc2be2398d8c63,0,Shaofeng Shi,2019-01-27 15:31:49+08:00,['c44832c15ca282da02ee55e9c784f0193cbe2233'],1,1,2,15471114,1,,,,11551
d678fe715c9be8a9d821bf54cca435ce406670fd,0,shaofengshi,2019-01-28 08:08:00+08:00,['b99beb640f67bb2957ce770bf3bc2be2398d8c63'],1,1,2,15471116,1,,,,11551
2cea735c48f1f708ebb863d3d7a48f5c9ce6703c,0,Shaofeng Shi,2019-01-28 09:40:50+08:00,['d678fe715c9be8a9d821bf54cca435ce406670fd'],1,1,2,15471118,1,,,,11551
7437af838c5fe1fc9eb2055cc5e9f81e5dc4aab5,0,kyotoYaho,2019-01-28 12:06:09+08:00,['2cea735c48f1f708ebb863d3d7a48f5c9ce6703c'],1,0,1,15471119,1,1,0,1,11551
33ef4a92b094935db029d3478cf6d491cf51efea,0,shaofengshi,2019-01-28 20:31:35+08:00,['7437af838c5fe1fc9eb2055cc5e9f81e5dc4aab5'],1,1,2,15471121,1,,,,11551
b1f1b7bdf04a00fd9fd96e35e700f4ee7aeb455e,0,kyotoYaho,2019-01-30 16:38:41+08:00,['33ef4a92b094935db029d3478cf6d491cf51efea'],32,132,164,15471285,2,0.854166667,0.854166667,1,11552
bcf1b5237bf25116cbcb393bb8e12f42c8306600,0,Shaofeng Shi,2019-01-30 21:19:54+08:00,['b1f1b7bdf04a00fd9fd96e35e700f4ee7aeb455e'],1,7,8,15471293,1,,,,11552
24f1987d71df1c51f9e1fca5885a2bfa4fca501d,0,Shaofeng Shi,2019-01-30 21:23:00+08:00,['bcf1b5237bf25116cbcb393bb8e12f42c8306600'],6,92,98,15471391,3,0.40625,0.9375,0.6875,11552
4fb7eeec2f16896d85f63eeef903b22fe99ddbdf,0,Shaofeng Shi,2019-02-11 12:37:44+08:00,['24f1987d71df1c51f9e1fca5885a2bfa4fca501d'],2,7,9,15471400,2,0.8,0.8,1,11552
5e9d53311637efcb04fc8529f6682d17a6f08968,0,Shaofeng Shi,2019-02-11 13:53:36+08:00,['4fb7eeec2f16896d85f63eeef903b22fe99ddbdf'],8,9,17,15471417,2,,,,11552
7e9a8e1ae601f9302425e52b22a97810b6a86d76,0,Shaofeng Shi,2019-02-12 05:10:17+08:00,['5e9d53311637efcb04fc8529f6682d17a6f08968'],4,8,12,15471429,3,0.25,0,1,11552
2b759f9cfab369bcfbb4410730c55735412f6bfa,0,Shaofeng Shi,2019-02-14 02:39:47+08:00,['7e9a8e1ae601f9302425e52b22a97810b6a86d76'],2,21,23,15471452,2,0.928571429,0.928571429,1,11552
0d43ae933937a9c25f81fca16de6c7b627e45371,0,Shaofeng Shi,2019-02-14 02:43:43+08:00,['2b759f9cfab369bcfbb4410730c55735412f6bfa'],36,33,69,15471521,7,1,0,0,11552
96d72ca74d5b19173aef11df51d1e9f50eac557a,0,Shaofeng Shi,2019-02-14 02:44:03+08:00,['0d43ae933937a9c25f81fca16de6c7b627e45371'],1,1,2,15471523,1,,,,11552
73ae41cebb8fd086a40810303e6482fcc49ec7aa,0,Shaofeng Shi,2019-02-14 08:19:21+08:00,['96d72ca74d5b19173aef11df51d1e9f50eac557a'],72,95,167,15471690,2,0.65,0.65,1,11552
03714e0ba90cf90eb5fb1ff98d227b26afeb4e33,0,shaofengshi,2019-02-18 19:14:28+08:00,['73ae41cebb8fd086a40810303e6482fcc49ec7aa'],3,3,6,15471696,1,,,,11552
d362acb644745b5fa59e74faa00d9fe16e7e16de,1,shaofengshi,2019-02-19 14:41:18+08:00,['03714e0ba90cf90eb5fb1ff98d227b26afeb4e33'],96,182,278,15471974,4,1,1,1,11553
6eee27359252979c855b45a3699222aaa54ac344,0,shaofengshi,2019-02-19 22:29:50+08:00,['d362acb644745b5fa59e74faa00d9fe16e7e16de'],27,27,54,15472028,27,,,,11553
0b92dd41b458ef43c4f37223905e063534143264,0,Shaofeng Shi,2019-02-21 16:15:54+08:00,['6eee27359252979c855b45a3699222aaa54ac344'],6,17,23,15472051,1,,,,11553
0b0ceeee4267570526a08ade9f991146857f6fd8,1,Shaofeng Shi,2019-02-22 18:18:21+08:00,['0b92dd41b458ef43c4f37223905e063534143264'],4,5,9,15472060,1,0,0,1,11553
9d125e1e83fd498a817d7c1b8919c8f96a404814,0,Shaofeng Shi,2019-02-22 22:52:54+08:00,['0b0ceeee4267570526a08ade9f991146857f6fd8'],2,2,4,15472064,1,,,,11553
500f1025326a16d71deb1c96075336d03316306e,0,Shaofeng Shi,2019-02-24 11:44:49+08:00,['9d125e1e83fd498a817d7c1b8919c8f96a404814'],2,4,6,15472070,1,0,1,1,11553
fb34122243372cb229b43eee29ca59f933d0ada3,1,Shaofeng Shi,2019-02-25 22:13:33+08:00,['500f1025326a16d71deb1c96075336d03316306e'],3,40,43,15472113,2,0,0.25,1,11553
8e717518642b36bea5b35a45d7f1995c0f662c73,0,shaofengshi,2019-02-25 22:27:36+08:00,['fb34122243372cb229b43eee29ca59f933d0ada3'],5,10,15,15472128,1,0,0,1,11553
bab003c57a68c5e242ca02b1281cdf19ce29d34e,0,Shaofeng Shi,2019-02-26 22:37:51+08:00,['8e717518642b36bea5b35a45d7f1995c0f662c73'],34,486,520,15472648,18,0.714285714,0.727272727,0.077922078,11562
bfb30d92d068f8d067212ad23aa80dc403e7a6f7,0,Shaofeng Shi,2019-02-26 22:37:51+08:00,['bab003c57a68c5e242ca02b1281cdf19ce29d34e'],0,2,2,15472650,1,0,0.5,0.5,11562
c152807ab200cbfd2253df94a8a371b8ecccad98,1,Shaofeng Shi,2019-02-27 08:27:16+08:00,['bfb30d92d068f8d067212ad23aa80dc403e7a6f7'],2,2,4,15472654,1,,,,11562
e5c7c0de0a93a89b97d9427f95e3bbf6bada61dc,0,Shaofeng Shi,2019-02-27 08:28:56+08:00,['c152807ab200cbfd2253df94a8a371b8ecccad98'],0,2,2,15472656,1,0,1,1,11562
6bc2aaeb7032aa89feed91316a2179263c4c4c35,0,Shaofeng Shi,2019-02-28 21:59:20+08:00,['e5c7c0de0a93a89b97d9427f95e3bbf6bada61dc'],15,23,38,15472694,1,0,0,1,11562
68bffc14a8770fa7e1cf5dbad2c027eb027f7be2,1,Shaofeng Shi,2019-03-01 18:45:24+08:00,['6bc2aaeb7032aa89feed91316a2179263c4c4c35'],4,25,29,15472723,1,0,0,1,11562
5cd0909451c588b92226550e9e150895810b3968,1,Shaofeng Shi,2019-03-04 16:54:35+08:00,['68bffc14a8770fa7e1cf5dbad2c027eb027f7be2'],2,43,45,15472768,2,1,1,0.75,11563
30ef767648df47ec9c57e190e84ee21cedda278f,0,Shaofeng Shi,2019-03-04 18:46:09+08:00,['5cd0909451c588b92226550e9e150895810b3968'],12,622,634,15473402,10,0.483271375,1,0.977695167,11568
2688b825026e9886a8b2dc39c14a8a4fc0933c1f,0,Shaofeng Shi,2019-03-04 18:46:09+08:00,['30ef767648df47ec9c57e190e84ee21cedda278f'],11,205,216,15473618,4,0.492424242,1,0.984848485,11569
a5e08425b607c9e406eee147d489729d4fa3af06,0,Shaofeng Shi,2019-03-04 18:46:09+08:00,['2688b825026e9886a8b2dc39c14a8a4fc0933c1f'],0,3,3,15473621,2,,,,11569
662a7f95104b3e8c31026cef65192127a2ab2e15,0,Shaofeng Shi,2019-03-04 18:56:20+08:00,['a5e08425b607c9e406eee147d489729d4fa3af06'],11,1172,1183,15474804,16,0.39516129,0.6,0.964516129,11579
f968e31140e6b5e68ef3c8124192987752c32a03,1,Shaofeng Shi,2019-03-04 19:37:09+08:00,['662a7f95104b3e8c31026cef65192127a2ab2e15'],14,66,80,15474884,7,0.5,0.15625,0.625,11579
636f93a0a3fb412b352e1518f1658b7c94368a0d,0,shaofengshi,2019-03-04 19:45:49+08:00,['f968e31140e6b5e68ef3c8124192987752c32a03'],27,493,520,15475404,24,0.921161826,1,0.975103734,11582
7519629d04c3b46c6f97acaaf7eddb5b8ceabe1e,0,shaofengshi,2019-03-04 19:57:39+08:00,['636f93a0a3fb412b352e1518f1658b7c94368a0d'],28,136,164,15475568,3,0.494117647,1,0.341176471,11582
d00aced068a0eb274c7d3e04a2c3cdeaec6d2c68,0,Shaofeng Shi,2019-03-05 10:27:17+08:00,['7519629d04c3b46c6f97acaaf7eddb5b8ceabe1e'],8,82,90,15475658,2,0.40625,1,1,11583
69c2c17ee6777c16d6444fdd58da00e0e482d1f8,0,Shaofeng Shi,2019-03-05 10:27:17+08:00,['d00aced068a0eb274c7d3e04a2c3cdeaec6d2c68'],2,5,7,15475665,2,,,,11583
0234301b68a3dab8952be2be4f51cb5c66043c48,1,guosheng lu,2019-03-06 10:31:33+08:00,['69c2c17ee6777c16d6444fdd58da00e0e482d1f8'],2,4,6,15475671,1,1,1,1,11583
c0b9e5142eb185c092143b7aa05af0d51f1b2cfd,0,shaofengshi,2019-03-06 14:35:56+08:00,['0234301b68a3dab8952be2be4f51cb5c66043c48'],0,9,9,15475680,1,0,1,1,11583
d240e0d3ea939483d0d07a638c47aae610958c1f,0,Shaofeng Shi,2019-03-08 16:12:09+08:00,['c0b9e5142eb185c092143b7aa05af0d51f1b2cfd'],4,76,80,15475760,3,,,,11584
fb52a1df65e72d78f90eaf8b50cb0bc3c51c6a4a,0,Shaofeng Shi,2019-03-08 18:17:39+08:00,['d240e0d3ea939483d0d07a638c47aae610958c1f'],85,91,176,15475936,2,0,1,1,11584
a1ade72de515daa1eb99c8e041291d3724181745,0,Shaofeng Shi,2019-03-13 08:26:20+08:00,['fb52a1df65e72d78f90eaf8b50cb0bc3c51c6a4a'],1,0,1,15475937,1,,,,11584
92e9299b77bff3d924d8cafa73970544b97c6d00,0,shaofengshi,2019-03-13 09:49:43+08:00,['a1ade72de515daa1eb99c8e041291d3724181745'],13,14,27,15475964,6,,,,11584
a6aa9c812aa7cf93d97fcd8eb554a8c289d1f20d,1,Shaofeng Shi,2019-03-13 17:32:09+08:00,['92e9299b77bff3d924d8cafa73970544b97c6d00'],284,287,571,15476535,15,1,0,1,11585
6a80d36ac8ae3f7caf5ce630434cefa94366f0db,0,Shaofeng Shi,2019-03-13 18:03:05+08:00,['a6aa9c812aa7cf93d97fcd8eb554a8c289d1f20d'],13,36,49,15476584,1,0.684210526,1,1,11585
699d650b076d6309f1087ee3c95705c253616075,0,Shaofeng Shi,2019-03-13 18:03:05+08:00,['6a80d36ac8ae3f7caf5ce630434cefa94366f0db'],19,38,57,15476641,1,0.25,1,1,11585
fe43a3eba2716a8a534bb7916fbc425b22849157,0,shaofengshi,2019-03-13 23:04:12+08:00,['699d650b076d6309f1087ee3c95705c253616075'],0,1,1,15476642,1,,,,11585
d23d2bddab3263d39059492b91f71d8091198057,0,shaofengshi,2019-03-14 13:54:27+08:00,['fe43a3eba2716a8a534bb7916fbc425b22849157'],7,15,22,15476664,2,0.6,0.6,1,11585
6b9a3d27c3e29bd698a8a39d3dd945fbb61657da,0,shaofengshi,2019-03-15 18:03:42+08:00,['d23d2bddab3263d39059492b91f71d8091198057'],0,5,5,15476669,1,,,,11585
7b88a99b4b77f1bb732d38a06d8b71cfe4b904df,0,Shaofeng Shi,2019-03-15 18:04:15+08:00,['6b9a3d27c3e29bd698a8a39d3dd945fbb61657da'],4,54,58,15476727,3,,,,11585
756d582cfc33f7c028edd02e22531b43a133a47e,0,shaofengshi,2019-03-15 22:13:01+08:00,['7b88a99b4b77f1bb732d38a06d8b71cfe4b904df'],31,47,78,15476805,1,,,,11585
0121af2ee5530e450373495fad41968338b86a8c,0,shaofengshi,2019-03-16 08:14:23+08:00,['756d582cfc33f7c028edd02e22531b43a133a47e'],1,1,2,15476807,1,,,,11585
4706fe8b2f6b5075ecedd8cf43368aca2f68588c,0,shaofengshi,2019-03-17 08:25:18+08:00,['0121af2ee5530e450373495fad41968338b86a8c'],1,0,1,15476808,1,,,,11585
90879fbd0904c5f77836e0418fabbec38a4e0fa2,1,Shaofeng Shi,2019-03-18 11:13:44+08:00,['4706fe8b2f6b5075ecedd8cf43368aca2f68588c'],4,4,8,15476816,2,,,,11585
aa61c1a062d8cb336c67df7803a09b52f139b643,0,Shaofeng Shi,2019-03-18 11:55:33+08:00,['90879fbd0904c5f77836e0418fabbec38a4e0fa2'],0,26,26,15476842,1,,,,11586
e16d2cfae1615fa18306ff378487627858afe8fa,0,Shaofeng Shi,2019-03-18 12:07:54+08:00,['aa61c1a062d8cb336c67df7803a09b52f139b643'],1,4,5,15476847,2,,,,11586
9f7ec94c9dee4f0f0946318bff52a8e186c0da87,0,Shaofeng Shi,2019-03-18 13:37:44+08:00,['e16d2cfae1615fa18306ff378487627858afe8fa'],0,13,13,15476860,1,0.8,1,1,11586
0431554ecf2779d5d48cbb549881a3895e375cad,0,Shaofeng Shi,2019-03-18 13:50:28+08:00,['9f7ec94c9dee4f0f0946318bff52a8e186c0da87'],2,1,3,15476863,1,,,,11586
9c8d30b09b224dc173acd99ff4c62f51b2492e97,0,Shaofeng Shi,2019-03-18 16:50:09+08:00,['0431554ecf2779d5d48cbb549881a3895e375cad'],3,1,4,15476867,1,1,0,1,11586
62d5b0336b65013522e258499f640416f7e5ca82,1,Shaofeng Shi,2019-03-18 16:57:13+08:00,['9c8d30b09b224dc173acd99ff4c62f51b2492e97'],44,208,252,15477119,7,0.4625,0.95,1,11587
980b9674d984ee27c30b30bb63710554d7b54dcc,0,Shaofeng Shi,2019-03-19 22:52:52+08:00,['62d5b0336b65013522e258499f640416f7e5ca82'],4,10,14,15477133,1,0,0,1,11587
4fa40bde2a5669b27c4e3b79bac749c0a8bb9e2b,0,Shaofeng Shi,2019-03-19 22:52:52+08:00,['980b9674d984ee27c30b30bb63710554d7b54dcc'],0,1,1,15477134,1,0,0,1,11587
24d08d2527dad4d8089e3c248cd3fc08b713a658,0,Shaofeng Shi,2019-03-19 22:55:05+08:00,['4fa40bde2a5669b27c4e3b79bac749c0a8bb9e2b'],3,14,17,15477151,1,0.3,0.3,1,11587
4abe7123ad32fb19af74f99721c1140b3e077fdd,0,Shaofeng Shi,2019-03-19 22:55:05+08:00,['24d08d2527dad4d8089e3c248cd3fc08b713a658'],1,1,2,15477153,1,,,,11587
14d0a37cbc93c1fd05d6b815011cbe6b8923503c,0,Shaofeng Shi,2019-03-21 10:48:00+08:00,['4abe7123ad32fb19af74f99721c1140b3e077fdd'],1,1,2,15477155,1,,,,11587
d9b028b24a0ad9ca09d4d4f1f6ee4de1e59ccd6a,0,Shaofeng Shi,2019-03-21 14:17:57+08:00,['14d0a37cbc93c1fd05d6b815011cbe6b8923503c'],2,6,8,15477163,1,,,,11587
6ee0212af9d5b50096850c9cb76031b7cdd67402,0,Shaofeng Shi,2019-03-22 14:10:26+08:00,['d9b028b24a0ad9ca09d4d4f1f6ee4de1e59ccd6a'],3,2,5,15477168,1,1,1,1,11587
c05ae0ce08a37dd9075b9c4f7ad3da9b90cc658f,1,shaofengshi,2019-03-24 19:30:13+08:00,['6ee0212af9d5b50096850c9cb76031b7cdd67402'],325,3039,3364,15480532,32,0.647017045,0.865056818,0.857244318,11597
09435994d3020446facba9e803e96fae6d6879e1,1,shaofengshi,2019-03-24 19:33:25+08:00,['c05ae0ce08a37dd9075b9c4f7ad3da9b90cc658f'],20,29831,29851,15510383,268,0.551959227,0.767407996,0.836775218,11834
dd4ea5bb104ba6dc5f6bd60fe5f2f10799d45e11,1,shaofengshi,2019-03-24 19:33:25+08:00,['09435994d3020446facba9e803e96fae6d6879e1'],0,1698,1698,15512081,10,0.479532164,0.657894737,0.886939571,11844
363749ed00793fd1766d9fa87c31627f06966717,1,shaofengshi,2019-03-24 19:33:25+08:00,['dd4ea5bb104ba6dc5f6bd60fe5f2f10799d45e11'],1,1917,1918,15513999,23,0.381114903,0.739476678,0.8407281,11863
6da979581476e80db1524dff919d3d9c55d7448b,0,shaofengshi,2019-03-24 19:33:25+08:00,['363749ed00793fd1766d9fa87c31627f06966717'],1,1,2,15514001,1,,,,11863
4a1a4debb2d8eca6b49e4a38e67119619215dc76,0,shaofengshi,2019-03-24 19:33:25+08:00,['6da979581476e80db1524dff919d3d9c55d7448b'],37,92,129,15514130,10,0.333333333,0.833333333,0.5,11863
4e370b284e9fc1a67d9c64c0a40f66b5754c9940,0,shaofengshi,2019-03-24 19:33:25+08:00,['4a1a4debb2d8eca6b49e4a38e67119619215dc76'],2,3,5,15514135,1,,,,11863
b253b2c9c56ba07e0d1119570ea674c8d2f6133e,0,shaofengshi,2019-03-24 19:33:25+08:00,['4e370b284e9fc1a67d9c64c0a40f66b5754c9940'],4,4,8,15514143,1,,,,11863
1516d8c7dceba4de0a603c6442d6da32ba667f5c,0,shaofengshi,2019-03-24 19:33:25+08:00,['b253b2c9c56ba07e0d1119570ea674c8d2f6133e'],1,1,2,15514145,1,,,,11863
63268a02006ba2afafc4ede1c981512e3d5ca365,0,shaofengshi,2019-03-24 19:33:25+08:00,['1516d8c7dceba4de0a603c6442d6da32ba667f5c'],0,5,5,15514150,1,,,,11863
13b761226f407cb057e69b7d7635f62bc1048f4e,0,shaofengshi,2019-03-24 19:33:25+08:00,['63268a02006ba2afafc4ede1c981512e3d5ca365'],69,561,630,15514780,5,0.478599222,0.758754864,0.704280156,11865
b7a52af09c26f3d39394deca01738487ebaae4a3,0,shaofengshi,2019-03-24 19:33:25+08:00,['13b761226f407cb057e69b7d7635f62bc1048f4e'],8,56,64,15514844,1,0.081081081,0.081081081,1,11865
2cbb8cd9cbd5170aa7e0799f712e19ae6e95c20a,0,shaofengshi,2019-03-24 19:33:25+08:00,['b7a52af09c26f3d39394deca01738487ebaae4a3'],4,15,19,15514863,1,0,0,1,11865
bf446aa8a760dfde9e8f71be32411a14093a594d,0,shaofengshi,2019-03-24 19:33:25+08:00,['2cbb8cd9cbd5170aa7e0799f712e19ae6e95c20a'],6,12,18,15514881,1,,,,11865
0669cee27d5c3625dbc91b84539955df7d84ea39,0,shaofengshi,2019-03-24 19:33:25+08:00,['bf446aa8a760dfde9e8f71be32411a14093a594d'],24,15,39,15514920,3,0,0,0,11865
6cd70612db367406dff2ce9fcd12db5b1e4946ee,0,shaofengshi,2019-03-24 19:33:25+08:00,['0669cee27d5c3625dbc91b84539955df7d84ea39'],0,7,7,15514927,2,0.833333333,1,1,11865
14be024ffb6a01158561df3adee582897a385aac,0,shaofengshi,2019-03-24 19:37:40+08:00,['6cd70612db367406dff2ce9fcd12db5b1e4946ee'],37,11266,11303,15526230,36,0.491408935,0.900343643,0.910652921,11885
ad9b49b4d2feff226ee0fb9dfde9b943c9f86702,0,shaofengshi,2019-03-24 19:37:40+08:00,['14be024ffb6a01158561df3adee582897a385aac'],0,3,3,15526233,1,,,,11885
9a363c15867389f4bd1ab590ca1e336db32c09db,0,shaofengshi,2019-03-24 19:37:40+08:00,['ad9b49b4d2feff226ee0fb9dfde9b943c9f86702'],21,71,92,15526325,9,0,0.435897436,1,11885
e70a6f71fabd1abdf5e3739b7dd37d2f83b562da,0,shaofengshi,2019-03-24 19:37:40+08:00,['9a363c15867389f4bd1ab590ca1e336db32c09db'],65,152,217,15526542,8,0.46875,0.96875,0.96875,11885
a774221cd8fb309516d880f3919ffc74b699aa08,0,shaofengshi,2019-03-26 09:46:31+08:00,['e70a6f71fabd1abdf5e3739b7dd37d2f83b562da'],6,5,11,15526553,2,1,1,0,11885
80fbff41fd28657801e80516b3cf414dcbcf1719,0,shaofengshi,2019-03-26 09:46:32+08:00,['a774221cd8fb309516d880f3919ffc74b699aa08'],45,46,91,15526644,12,1,0,0.4,11885
c137bc80a8bdf49f41a5214541ca42e5ff4cc6ef,0,Shaofeng Shi,2019-03-26 22:14:09+08:00,['80fbff41fd28657801e80516b3cf414dcbcf1719'],106,59,165,15526809,12,0,0,0,11886
4ddd4f4fcd631af54c94d1cee0e4a29435f8da24,0,Shaofeng Shi,2019-03-27 10:22:19+08:00,['c137bc80a8bdf49f41a5214541ca42e5ff4cc6ef'],0,1,1,15526810,1,0,1,1,11886
ed344280513116d9eaf1d86182e8146e92e1bb5c,0,Shaofeng Shi,2019-03-27 10:22:49+08:00,['4ddd4f4fcd631af54c94d1cee0e4a29435f8da24'],1,1,2,15526812,1,,,,11886
eabb4234a95e10e81c7dfc1e3b107411917b5f5a,0,Shaofeng Shi,2019-03-27 10:23:22+08:00,['ed344280513116d9eaf1d86182e8146e92e1bb5c'],1,1,2,15526814,1,,,,11886
a04dba4d99bb1679f457bed1865a08d07eabe969,0,Shaofeng Shi,2019-03-27 10:27:11+08:00,['eabb4234a95e10e81c7dfc1e3b107411917b5f5a'],7,8,15,15526829,1,,,,11886
0b7bda84d2984b4e873cf0af331dca37bc0bfcc6,0,Shaofeng Shi,2019-03-27 11:23:07+08:00,['a04dba4d99bb1679f457bed1865a08d07eabe969'],2,2,4,15526833,1,,,,11886
59378efca9b4ebb865bc90709e292d3e7b412ebe,0,Shaofeng Shi,2019-03-27 14:57:16+08:00,['0b7bda84d2984b4e873cf0af331dca37bc0bfcc6'],1,3,4,15526837,1,0,0,0,11886
dceb144f150b4c73486f3868a99ed23fb6c38272,0,guosheng lu,2019-03-28 11:53:58+08:00,['59378efca9b4ebb865bc90709e292d3e7b412ebe'],1,1,2,15526839,1,,,,11886
a834f0898aa436d603fe27b08e46b833f7de0a79,0,guosheng lu,2019-03-28 11:53:58+08:00,['dceb144f150b4c73486f3868a99ed23fb6c38272'],1,5,6,15526845,1,1,1,1,11886
865cec3597df1c2041e3abc681626dd68aba335a,0,guosheng lu,2019-03-28 11:53:58+08:00,['a834f0898aa436d603fe27b08e46b833f7de0a79'],2,0,2,15526847,1,,,,11886
f0daeaf9071dd8ef51d0d9136ef0af90b4cdec2b,0,guosheng lu,2019-03-28 12:04:16+08:00,['865cec3597df1c2041e3abc681626dd68aba335a'],16,16,32,15526879,1,,,,11886
9ab6c2f12bbddd5b402a373f37afca3c8ec9aafe,0,Shaofeng Shi,2019-03-28 22:00:48+08:00,['f0daeaf9071dd8ef51d0d9136ef0af90b4cdec2b'],18,21,39,15526918,1,0,1,0.5,11886
a5a2eda5851afd0248a3bf89361818a6f44555f3,0,Shaofeng Shi,2019-03-29 17:51:48+08:00,['9ab6c2f12bbddd5b402a373f37afca3c8ec9aafe'],1,6,7,15526925,2,0,0,1,11886
c0bb353b92682d6f08f359d458df59bd7ccd9b66,0,Shaofeng Shi,2019-03-29 17:52:36+08:00,['a5a2eda5851afd0248a3bf89361818a6f44555f3'],3,3,6,15526931,2,,,,11886
b6a509e3744077934e2ed817ea21364a44a9ff9c,0,Shaofeng Shi,2019-03-29 17:52:36+08:00,['c0bb353b92682d6f08f359d458df59bd7ccd9b66'],3,30,33,15526964,1,1,1,1,11886
aac8e400f031304ca479ccf93db11ee172ef14d4,1,Shaofeng Shi,2019-03-29 17:52:36+08:00,['b6a509e3744077934e2ed817ea21364a44a9ff9c'],7,29,36,15527000,1,1,1,1,11886
504ab5da9535071d7dc9b9d8d5ac8a5b1b737d3b,0,Shaofeng Shi,2019-03-29 21:21:58+08:00,['aac8e400f031304ca479ccf93db11ee172ef14d4'],0,2,2,15527002,1,0,0,0,11886
3a38a17ca66b9a9ed3f8e30ca52f4c36bf29752e,1,Shaofeng Shi,2019-03-29 23:13:26+08:00,['504ab5da9535071d7dc9b9d8d5ac8a5b1b737d3b'],61,98,159,15527161,4,0.088235294,0.235294118,1,11886
4ec4051dd1e1a33995f19a397b8b8d4af96af1c9,0,Shaofeng Shi,2019-03-29 23:13:26+08:00,['3a38a17ca66b9a9ed3f8e30ca52f4c36bf29752e'],11,1,12,15527173,1,1,1,0,11886
610d0f3e826d0e551af1b3b59d7374f1872024b1,0,Shaofeng Shi,2019-03-29 23:13:26+08:00,['4ec4051dd1e1a33995f19a397b8b8d4af96af1c9'],55,65,120,15527293,1,1,0,0,11886
07b4b913c342e205d09c3f6050921a401bc15d3d,0,Shaofeng Shi,2019-03-30 09:18:20+08:00,['610d0f3e826d0e551af1b3b59d7374f1872024b1'],33,149,182,15527475,3,0.636363636,0.672727273,0.8,11888
a9eaf3658eae48abd7401d4d6adee04aadd3275a,0,Shaofeng Shi,2019-03-31 17:46:55+08:00,['07b4b913c342e205d09c3f6050921a401bc15d3d'],60,239,299,15527774,33,0.315789474,0,0.192982456,11890
22159b506555fb654302a682893cbbfb5428c535,0,Shaofeng Shi,2019-03-31 17:46:55+08:00,['a9eaf3658eae48abd7401d4d6adee04aadd3275a'],28,30,58,15527832,4,0.6,0.6,0,11890
925a4c6552f9dcf78fda3da00fcb8f3ba90c9228,0,Jiatao Tao,2019-03-31 19:39:24+08:00,['22159b506555fb654302a682893cbbfb5428c535'],2,2,4,15527836,1,,,,11890
2311b05d0320aa67ebda154e329b632fdb5c0b52,0,GitHub,2019-03-31 20:12:18+08:00,"['22159b506555fb654302a682893cbbfb5428c535', '925a4c6552f9dcf78fda3da00fcb8f3ba90c9228']",2,2,4,15527840,1,,,,11890
ae503d9eb31b8c803f5f5d09b4f327e74abf5a79,0,Shaofeng Shi,2019-04-01 08:11:51+08:00,['2311b05d0320aa67ebda154e329b632fdb5c0b52'],1,9,10,15527850,1,1,1,1,11890
fea18cc6534ccc80821748a0f4cd6a1a9289dfb2,0,Shaofeng Shi,2019-04-03 09:28:20+08:00,['ae503d9eb31b8c803f5f5d09b4f327e74abf5a79'],2,10001,10003,15537853,2,,,,11890
7a1f90d598b0254b94f36fa0e381c66274aced83,0,Shaofeng Shi,2019-04-03 09:32:00+08:00,['fea18cc6534ccc80821748a0f4cd6a1a9289dfb2'],3,4,7,15537860,1,,,,11890
f63699d0c002b6c9bcfcc88387ea9a178427c459,0,Ni Chunen,2019-04-08 11:29:03+08:00,['7a1f90d598b0254b94f36fa0e381c66274aced83'],3,1,4,15537864,1,,,,11890
80ac894f36bd26780564c04a2eae43a7146a50af,0,Ni Chunen,2019-04-08 16:13:04+08:00,['f63699d0c002b6c9bcfcc88387ea9a178427c459'],1,6,7,15537871,1,1,1,1,11890
480d80b672d6c91429e56542f24681edf84f309f,1,Ni Chunen,2019-04-08 18:20:03+08:00,['80ac894f36bd26780564c04a2eae43a7146a50af'],4,771,775,15538646,14,0.208409506,0.510054845,0.729433272,11892
5d04f2febbfa50346da56e3be7b2211a0b5d8071,0,Ni Chunen,2019-04-08 18:20:03+08:00,['480d80b672d6c91429e56542f24681edf84f309f'],182,164,346,15538992,7,0.133333333,1,0.133333333,11892
e9dfaf9a5465ff3f6f3bfa3460ca8b2adb8c6617,0,Ni Chunen,2019-04-08 18:20:03+08:00,['5d04f2febbfa50346da56e3be7b2211a0b5d8071'],66,54,120,15539112,6,1,0,1,11892
578217e9e5d6c05863ed5370ae6aeaa063079ae5,0,Shaofeng Shi,2019-04-09 17:16:26+08:00,['e9dfaf9a5465ff3f6f3bfa3460ca8b2adb8c6617'],33,55,88,15539200,7,,,,11892
49cb81505d71fa3eef12524d2760e877dd1fdbdd,0,Shaofeng Shi,2019-04-09 17:27:19+08:00,['578217e9e5d6c05863ed5370ae6aeaa063079ae5'],52,25,77,15539277,10,0,0,0,11892
053b4f61b976ee05af98f41b42514017be373871,0,Ni Chunen,2019-04-10 14:49:39+08:00,['49cb81505d71fa3eef12524d2760e877dd1fdbdd'],1,2,3,15539280,1,,,,11892
7ac5a8449621c191b9e1bcdeaa61a31e144e24a3,0,Ni Chunen,2019-04-10 15:38:48+08:00,['053b4f61b976ee05af98f41b42514017be373871'],56,131,187,15539467,18,0.840909091,0.954545455,0.409090909,11892
aee4596495ee946c22d2b1a050f2a8301d22f49c,1,Ni Chunen,2019-04-10 16:16:19+08:00,['7ac5a8449621c191b9e1bcdeaa61a31e144e24a3'],11,245,256,15539723,8,0.468085106,0.989361702,0.914893617,11894
82ced2ce0df0341cd68447c183af6b778c4b3b77,1,Ni Chunen,2019-04-10 16:16:19+08:00,['aee4596495ee946c22d2b1a050f2a8301d22f49c'],1,15,16,15539739,3,0.818181818,1,1,11894
41b130ded73cbc3c0b55adadf23f2fd4f6de1336,1,Ni Chunen,2019-04-10 16:16:19+08:00,['82ced2ce0df0341cd68447c183af6b778c4b3b77'],7,195,202,15539941,10,0.962264151,1,0.754716981,11898
5316e190acd85f52205b0849a0d8689004900c1b,0,Ni Chunen,2019-04-10 20:35:15+08:00,['41b130ded73cbc3c0b55adadf23f2fd4f6de1336'],107,293,400,15540341,11,1,1,0.533333333,11901
ddc51f3307616a33536c76ff61023b7634e3d289,0,Shaofeng Shi,2019-04-11 09:24:20+08:00,['5316e190acd85f52205b0849a0d8689004900c1b'],2,25,27,15540368,7,0.5,0.916666667,1,11901
e1f62fa59eacee8736b935bbff5ae10f5e4e437b,0,Ni Chunen,2019-04-11 16:33:03+08:00,['ddc51f3307616a33536c76ff61023b7634e3d289'],6,20,26,15540394,3,1,1,1,11901
7deb2048a8477fdd27735fd128f28968bea7fb8e,0,Ni Chunen,2019-04-11 18:30:14+08:00,['e1f62fa59eacee8736b935bbff5ae10f5e4e437b'],1,26,27,15540421,2,0.736842105,0.736842105,0.736842105,11901
8f5f8302f19fbc72a2800bdb7191956ed54ad870,0,luguosheng1314,2019-04-12 13:35:00+08:00,['7deb2048a8477fdd27735fd128f28968bea7fb8e'],77,57,134,15540555,1,1,1,0,11901
ed266aa98d8524a344469b1e1ead8bfd462702d8,0,Ni Chunen,2019-04-12 15:53:38+08:00,['8f5f8302f19fbc72a2800bdb7191956ed54ad870'],1,10,11,15540566,3,1,1,1,11901
e13f101cb52c75a5ebf581f490b7a603d0ba4289,0,Ni Chunen,2019-04-12 21:53:06+08:00,['ed266aa98d8524a344469b1e1ead8bfd462702d8'],31,184,215,15540781,4,0.346456693,0.984251969,0.952755906,11901
cb9641875b8b9783f06f5c1169231d36d75ae76f,0,Ni Chunen,2019-04-12 22:16:16+08:00,['e13f101cb52c75a5ebf581f490b7a603d0ba4289'],1,6,7,15540788,1,1,1,1,11901
595c4e2112afeaea8c2881626959e37bbed50c84,0,Ni Chunen,2019-04-16 10:50:09+08:00,['cb9641875b8b9783f06f5c1169231d36d75ae76f'],1,12,13,15540801,2,0,0.272727273,1,11901
6d5d2cdcc8426ee0f4975fa3a8fd3c9c076af2cf,0,allenma,2019-04-18 11:44:36+08:00,['595c4e2112afeaea8c2881626959e37bbed50c84'],4,14,18,15540819,1,0.454545455,1,1,11901
e7b76b702c2fb56bfb847078b0593574b870578f,1,allenma,2019-04-18 11:44:36+08:00,['6d5d2cdcc8426ee0f4975fa3a8fd3c9c076af2cf'],10,288,298,15541117,4,0.525179856,0.582733813,1,11903
f0cfdf537e1b5a57cf15fc1204e9294367fb7e5f,0,allenma,2019-04-18 11:49:27+08:00,['e7b76b702c2fb56bfb847078b0593574b870578f'],1,22,23,15541140,1,0,0,1,11903
426a22711d6e25d2b7a4c1c3c6cea4e642b7f248,1,Ni Chunen,2019-04-18 21:35:45+08:00,['f0cfdf537e1b5a57cf15fc1204e9294367fb7e5f'],70,98,168,15541308,9,0.964285714,1,1,11903
261de78b8adbb7ce96a34afccd322de144a70fc7,0,Ni Chunen,2019-04-22 23:09:23+08:00,['426a22711d6e25d2b7a4c1c3c6cea4e642b7f248'],2,11,13,15541321,2,1,1,1,11903
cfabb816a54855b321d9c1ac2acdb76bb7d2652a,1,Ni Chunen,2019-04-23 10:34:27+08:00,['261de78b8adbb7ce96a34afccd322de144a70fc7'],37,55,92,15541413,2,,,,11903
cf2de6968b0e46365a65c8c121f0552b71e22cdf,0,Ni Chunen,2019-04-24 13:26:48+08:00,['cfabb816a54855b321d9c1ac2acdb76bb7d2652a'],5,27,32,15541445,3,0,0,1,11903
c42aafd0bd58935b5ac5836103f05e5208e84ef2,0,Ni Chunen,2019-04-25 15:16:50+08:00,['cf2de6968b0e46365a65c8c121f0552b71e22cdf'],0,17,17,15541462,1,0,0,0,11903
4b11e1d04e495ec6fd9484dd73c4d001644b431a,0,Ni Chunen,2019-04-26 22:09:59+08:00,['c42aafd0bd58935b5ac5836103f05e5208e84ef2'],2,2,4,15541466,2,,,,11903
c04694bf9a7e70e7f63870157884fdcde030f88a,0,Ni Chunen,2019-04-26 22:10:58+08:00,['4b11e1d04e495ec6fd9484dd73c4d001644b431a'],1,3,4,15541470,1,,,,11903
956ecde679285a8bac7289779b091e2e7f4d1b04,0,Ni Chunen,2019-04-29 21:10:39+08:00,['c04694bf9a7e70e7f63870157884fdcde030f88a'],1,1,2,15541472,1,,,,11903
245cf97f5b74a29fe6562efd79a6a2765f462ec8,0,Ni Chunen,2019-05-01 10:48:34+08:00,['956ecde679285a8bac7289779b091e2e7f4d1b04'],2,14,16,15541488,3,,,,11904
2076e394240c8a093606046df8b2ad6c3400fd80,0,Ni Chunen,2019-05-03 23:06:34+08:00,['245cf97f5b74a29fe6562efd79a6a2765f462ec8'],8,169,177,15541665,2,1,1,1,11904
962629a2743f4798b4bec68badaca33e3e7bfbc7,0,Ni Chunen,2019-05-05 17:25:47+08:00,['2076e394240c8a093606046df8b2ad6c3400fd80'],3,3,6,15541671,1,,,,11904
aab2b90197cb58408ee808da3f83045248784a86,1,Ni Chunen,2019-05-05 19:30:04+08:00,['962629a2743f4798b4bec68badaca33e3e7bfbc7'],0,16,16,15541687,1,0,0,1,11904
1be5d6a0c1bc2396f127d8bf38e12e0a11a141e7,0,Ni Chunen,2019-05-07 17:09:27+08:00,['aab2b90197cb58408ee808da3f83045248784a86'],8,8,16,15541703,2,,,,11904
5098f206ec86fee7d5e68c782e9e3aa803113fc3,0,Ni Chunen,2019-05-07 20:49:15+08:00,['1be5d6a0c1bc2396f127d8bf38e12e0a11a141e7'],2,23,25,15541728,4,0.368421053,0.368421053,0.789473684,11904
ab124ac9ffd988c9e1ec4b0d9513db49724b70a1,0,Ni Chunen,2019-05-07 20:49:15+08:00,['5098f206ec86fee7d5e68c782e9e3aa803113fc3'],24,55,79,15541807,3,0,0,0.633333333,11904
a0ed26d1a733912db49775e4d5cf405a3e0bb3ae,0,Ni Chunen,2019-05-08 09:53:07+08:00,['ab124ac9ffd988c9e1ec4b0d9513db49724b70a1'],0,15,15,15541822,1,0.769230769,0.769230769,1,11904
7bfa5d136fdb8cdba5cc714213e3ef4fa4f1ed62,0,Ni Chunen,2019-05-08 09:53:07+08:00,['a0ed26d1a733912db49775e4d5cf405a3e0bb3ae'],3,9,12,15541834,3,0.666666667,0.666666667,1,11904
8957a03006059b815eb57a905b71f51da7661479,0,Ni Chunen,2019-05-08 09:53:07+08:00,['7bfa5d136fdb8cdba5cc714213e3ef4fa4f1ed62'],0,35,35,15541869,1,,,,11905
3f0ca847e09532ff07d4258f92e30fec331e672c,1,Ni Chunen,2019-05-09 22:23:19+08:00,['8957a03006059b815eb57a905b71f51da7661479'],3,13,16,15541885,2,0.75,0.75,1,11905
d16bdd3a546ce7c37602471e1fdac1a3ad4e8be9,0,Ni Chunen,2019-05-11 23:07:12+08:00,['3f0ca847e09532ff07d4258f92e30fec331e672c'],1,1,2,15541887,1,,,,11905
c39b238fb2f4999f5484a7d2fa0b55245db5534c,0,Ni Chunen,2019-05-12 16:48:06+08:00,['d16bdd3a546ce7c37602471e1fdac1a3ad4e8be9'],28,569,597,15542484,9,1,1,1,11911
20fa8b1530e0d09f4393242db282dff43b930b00,0,Ni Chunen,2019-05-14 11:34:59+08:00,['c39b238fb2f4999f5484a7d2fa0b55245db5534c'],0,102,102,15542586,2,1,1,1,11913
6efcd791842bf485e47971877f259a562e5563f5,0,Ni Chunen,2019-05-15 14:17:58+08:00,['20fa8b1530e0d09f4393242db282dff43b930b00'],0,1,1,15542587,1,0,0,1,11913
bb44678f11a830c13d1550d8510e303132cf176f,1,Ni Chunen,2019-05-15 21:39:00+08:00,['6efcd791842bf485e47971877f259a562e5563f5'],238,959,1197,15543784,18,0.373848987,0.701657459,0.839779006,11914
ee95242edff6f07b8a175049f975f062526fde25,0,Ni Chunen,2019-05-16 10:06:10+08:00,['bb44678f11a830c13d1550d8510e303132cf176f'],22,15,37,15543821,8,0.25,1,0.125,11914
e09d9d7b37a688b5bebd8f93aea41d1eaf3bcfec,1,allenma,2019-05-17 18:18:59+08:00,['ee95242edff6f07b8a175049f975f062526fde25'],3,207,210,15544031,6,0.53125,0.78125,1,11917
876d420812a09270455bfbb78204010c81cab612,0,allenma,2019-05-17 18:18:59+08:00,['e09d9d7b37a688b5bebd8f93aea41d1eaf3bcfec'],3,21,24,15544055,2,0,1,0.666666667,11917
79a2fc26af25a8c6c5bbd5200e714ad95bcfdf4f,0,Ni Chunen,2019-05-19 13:58:41+08:00,['876d420812a09270455bfbb78204010c81cab612'],36,240,276,15544331,4,1,1,1,11918
b48de90d046bfbef30917149e9c3426c6a7365cc,0,Ni Chunen,2019-05-21 10:18:57+08:00,['79a2fc26af25a8c6c5bbd5200e714ad95bcfdf4f'],5,153,158,15544489,4,0.425925926,1,1,11920
4e7b242b3009f1f194d2e66dae9b368330b89a7b,0,Ni Chunen,2019-05-23 09:49:46+08:00,['b48de90d046bfbef30917149e9c3426c6a7365cc'],1,1,2,15544491,1,,,,11920
f15b1f8a7ce05416dc1df2ee8a2ab629d1c00873,0,Ni Chunen,2019-05-23 14:58:01+08:00,['4e7b242b3009f1f194d2e66dae9b368330b89a7b'],62,81,143,15544634,5,1,0.454545455,0,11920
47431ba0da7c3cce533f4d9dcd600654f33e0c90,0,Ni Chunen,2019-05-23 14:58:01+08:00,['f15b1f8a7ce05416dc1df2ee8a2ab629d1c00873'],19,26,45,15544679,3,0,1,0.4,11920
b08935205a7aa1a00b6c09ef4625f45eacf9b013,0,Ni Chunen,2019-05-30 15:50:42+08:00,['47431ba0da7c3cce533f4d9dcd600654f33e0c90'],3,22,25,15544704,2,1,1,1,11920
475df34fc27969414936e59a5ee2efd23cf2bcbe,1,Ni Chunen,2019-05-30 17:33:53+08:00,['b08935205a7aa1a00b6c09ef4625f45eacf9b013'],2,107,109,15544813,11,0.894736842,0.894736842,0.881578947,11920
670c2a98a82a699481eceddb685168104d5b185c,0,Ni Chunen,2019-05-30 18:34:31+08:00,['475df34fc27969414936e59a5ee2efd23cf2bcbe'],12,22,34,15544847,1,0,1,1,11920
cfce8bb628e0e4ade4e03ba9d544096859760907,0,Ni Chunen,2019-05-31 18:18:19+08:00,['670c2a98a82a699481eceddb685168104d5b185c'],3,19,22,15544869,4,1,1,1,11920
21045e85ff83674b735bc8d9a7640668d8f385c1,0,Ni Chunen,2019-05-31 22:20:18+08:00,['cfce8bb628e0e4ade4e03ba9d544096859760907'],21,21,42,15544911,15,,,,11920
d533d186494e9e5ec23f8e6576d2a15004aed7a3,0,Ni Chunen,2019-05-31 22:20:18+08:00,['21045e85ff83674b735bc8d9a7640668d8f385c1'],1,1,2,15544913,1,,,,11920
581299bcb4d81540537d784fe0a468fecfd9c84e,1,Ni Chunen,2019-05-31 22:35:00+08:00,['d533d186494e9e5ec23f8e6576d2a15004aed7a3'],23,18,41,15544954,14,0,0,0,11920
e3ed8b29a78f69ca629303ac517a669df7ae86ca,0,Ni Chunen,2019-05-31 23:00:48+08:00,['581299bcb4d81540537d784fe0a468fecfd9c84e'],30,24,54,15545008,1,0,0,1,11920
354f6ded8506fa53b4a78a8614da1e1c2bf1fef2,0,Ni Chunen,2019-06-03 18:26:50+08:00,['e3ed8b29a78f69ca629303ac517a669df7ae86ca'],29,29,58,15545066,5,,,,11920
c3a71101286ba994dec85aa515236b28c98b9e94,0,Ni Chunen,2019-06-04 13:40:45+08:00,['354f6ded8506fa53b4a78a8614da1e1c2bf1fef2'],5,17,22,15545088,3,0.272727273,0.272727273,0.272727273,11920
745842bccf038432ee0b112269de7cb29585a59a,0,Ni Chunen,2019-06-05 18:45:13+08:00,['c3a71101286ba994dec85aa515236b28c98b9e94'],1,0,1,15545089,1,1,0,0,11920
3ec378ce745ee273b47ad9ecee4eeb917b470ca4,0,Ni Chunen,2019-06-06 11:25:13+08:00,['745842bccf038432ee0b112269de7cb29585a59a'],24,30,54,15545143,2,0.5,0.5,0.5,11920
1fb000e45fb299ff40b9af6d197028dfee29a90b,1,Ni Chunen,2019-06-09 21:37:19+08:00,['3ec378ce745ee273b47ad9ecee4eeb917b470ca4'],8,402,410,15545553,10,0.582978723,0.744680851,1,11922
8efa5583f4026291789e5df090202bbc06b9bad7,0,Ni Chunen,2019-06-10 14:07:10+08:00,['1fb000e45fb299ff40b9af6d197028dfee29a90b'],1,8,9,15545562,1,0,0,1,11922
f38d5046a20d4f9830a10ecc01faf15868375955,0,Ni Chunen,2019-06-11 15:45:10+08:00,['8efa5583f4026291789e5df090202bbc06b9bad7'],2,8,10,15545572,1,1,1,1,11922
89aa466197fcc2105af05775e779eb771fbd607e,0,Ni Chunen,2019-06-11 17:19:36+08:00,['f38d5046a20d4f9830a10ecc01faf15868375955'],0,3,3,15545575,1,1,0,1,11922
30ff09f350dbeada44baa4ae8735f08ac0b3268c,0,Ni Chunen,2019-06-12 10:47:32+08:00,['89aa466197fcc2105af05775e779eb771fbd607e'],1,2,3,15545578,1,,,,11922
b0ae00315e1fe3d9301581387668fde3ec0efd6f,1,Shaofeng Shi,2019-06-13 10:27:41+08:00,['30ff09f350dbeada44baa4ae8735f08ac0b3268c'],0,50,50,15545628,2,0.9,0.9,1,11923
f19f16aad334fd65f9946dd51d369497a15cb9e4,0,Shaofeng Shi,2019-06-13 10:27:41+08:00,['b0ae00315e1fe3d9301581387668fde3ec0efd6f'],4,3,7,15545635,1,,,,11923
a74dc055a163e6adb0269e0924fbc78e8f997db2,0,Ni Chunen,2019-06-13 11:08:49+08:00,['f19f16aad334fd65f9946dd51d369497a15cb9e4'],2,8,10,15545645,2,0,1,1,11923
698084a69446a16fd5d91eb86c1ac135e562819f,0,Ni Chunen,2019-06-13 15:20:07+08:00,['a74dc055a163e6adb0269e0924fbc78e8f997db2'],0,6,6,15545651,1,,,,11923
b38fbcaf943a33a80e7400e21da60116266a5d62,0,guosheng lu,2019-06-13 19:56:10+08:00,['698084a69446a16fd5d91eb86c1ac135e562819f'],6,10,16,15545667,3,1,0,1,11923
2cfead0b3c7772366e233c6bc61942ca38c68642,0,Ni Chunen,2019-06-17 20:29:51+08:00,['b38fbcaf943a33a80e7400e21da60116266a5d62'],3,56,59,15545726,3,0,1,0.771428571,11923
7fe98c9c6082444a29451f7a2dce8274e9794ef9,0,Ni Chunen,2019-06-18 18:50:35+08:00,['2cfead0b3c7772366e233c6bc61942ca38c68642'],1,2,3,15545729,1,,,,11923
807a5712efc0752da47e5962bab1fdfdb3482dca,0,Ni Chunen,2019-06-19 19:48:28+08:00,['7fe98c9c6082444a29451f7a2dce8274e9794ef9'],6,28,34,15545763,6,,,,11923
c3fd390910305c2d1c3dea2421c6f61cc8fb9861,0,Ni Chunen,2019-06-19 19:57:44+08:00,['807a5712efc0752da47e5962bab1fdfdb3482dca'],0,17,17,15545780,1,0.75,0,1,11923
c3a17283a63a31ad4268b63800a59959bd70d245,0,Ni Chunen,2019-06-19 20:02:28+08:00,['c3fd390910305c2d1c3dea2421c6f61cc8fb9861'],7,43,50,15545830,6,0.08,0.84,1,11923
5b1d0a5c839f1929966c0062993f346c3f6a3ed3,0,Ni Chunen,2019-06-19 20:03:20+08:00,['c3a17283a63a31ad4268b63800a59959bd70d245'],1,1,2,15545832,1,,,,11923
5f5895dd07748cbf4bbc0ac31b907a8798457600,0,Ni Chunen,2019-06-19 20:55:28+08:00,['5b1d0a5c839f1929966c0062993f346c3f6a3ed3'],0,46,46,15545878,3,1,1,1,11925
970899011211b285b78cfc3a63ac5025436ddb59,0,Ni Chunen,2019-06-20 09:49:43+08:00,['5f5895dd07748cbf4bbc0ac31b907a8798457600'],3,34,37,15545915,2,,,,11925
37a1a802375e0dcaa4179317eceb88afdcc58a40,0,guosheng lu,2019-06-24 10:14:15+08:00,['970899011211b285b78cfc3a63ac5025436ddb59'],0,4,4,15545919,1,1,1,1,11925
6fb7ff0a1ae2b19a47a559cfaade6258c8a10034,0,guosheng lu,2019-06-24 10:14:15+08:00,['37a1a802375e0dcaa4179317eceb88afdcc58a40'],9,7,16,15545935,1,0,0,0,11925
760aefddf80f5ba32eb4448355713e4e22b7412d,0,Ni Chunen,2019-06-24 11:11:08+08:00,['6fb7ff0a1ae2b19a47a559cfaade6258c8a10034'],16,204,220,15546155,4,0.215686275,0.862745098,0.901960784,11926
9a72b9efe88de98cf6f3abc47b7fee235db2b10a,0,Ni Chunen,2019-06-24 13:32:15+08:00,['760aefddf80f5ba32eb4448355713e4e22b7412d'],35,36,71,15546226,4,0,0,0,11926
55f714007b21b8b7e197dd99d0f081b77fb4efce,0,Ni Chunen,2019-06-26 15:51:56+08:00,['9a72b9efe88de98cf6f3abc47b7fee235db2b10a'],10,9,19,15546245,2,,,,11926
916e51d3a932c02d66df0de0fa88d3c4774e8319,0,shaofengshi,2019-06-28 14:37:14+08:00,['55f714007b21b8b7e197dd99d0f081b77fb4efce'],1,1,2,15546247,1,,,,11926
6f12aaf5c62bfb10e2b3acf28520e259fce1a7a2,1,Ni Chunen,2019-06-30 15:43:57+08:00,['916e51d3a932c02d66df0de0fa88d3c4774e8319'],100,533,633,15546880,19,0.262975779,0.467128028,0.307958478,11927
8712a872048025d082f1f3e565f39d0f563b785f,1,Ni Chunen,2019-07-01 18:47:05+08:00,['6f12aaf5c62bfb10e2b3acf28520e259fce1a7a2'],29,725,754,15547634,9,0.403645833,0.921875,0.947916667,11934
7b1927c709546c8982d234f5ffa1c199fb9d46c5,0,Ni Chunen,2019-07-03 09:57:40+08:00,['8712a872048025d082f1f3e565f39d0f563b785f'],9,13,22,15547656,1,1,1,1,11934
c17dc296edca4705cb482369a3b93fc7f01f14c0,0,Ni Chunen,2019-07-04 15:03:19+08:00,['7b1927c709546c8982d234f5ffa1c199fb9d46c5'],0,16,16,15547672,1,,,,11934
96ba0c66889e0caa29f52c3d740536ef81d8dc5c,1,Ni Chunen,2019-07-04 19:55:35+08:00,['c17dc296edca4705cb482369a3b93fc7f01f14c0'],725,29,754,15548426,9,0.596354167,0.078125,0.052083333,11934
9331a94b2a95c00a59c0783f0be1555f13a7059f,0,Ni Chunen,2019-07-07 20:27:43+08:00,['96ba0c66889e0caa29f52c3d740536ef81d8dc5c'],41,32,73,15548499,1,1,1,0,11934
afe4e8802fb92c963088608cdb4f9bda435b7a38,0,Ni Chunen,2019-07-08 21:16:12+08:00,['9331a94b2a95c00a59c0783f0be1555f13a7059f'],1,1,2,15548501,1,,,,11934
8d5f4a46829df0b2c1c0d51d798daefdf67a08d6,0,Ni Chunen,2019-07-09 20:24:04+08:00,['afe4e8802fb92c963088608cdb4f9bda435b7a38'],1,1,2,15548503,1,,,,11934
47cb8de4a7baf7982c9a1cc26ba9c4ce68e527ff,1,Ni Chunen,2019-07-11 23:49:14+08:00,['8d5f4a46829df0b2c1c0d51d798daefdf67a08d6'],2,603,605,15549108,3,0.157894737,1,1,11935
f17664c168315035bec878066275054a6b4576d9,0,Ni Chunen,2019-07-11 23:49:14+08:00,['47cb8de4a7baf7982c9a1cc26ba9c4ce68e527ff'],8,11,19,15549127,2,1,1,1,11935
46d3f09ff777fdafc69ed43f169b5cbf17fa4569,1,Ni Chunen,2019-07-12 06:52:15+08:00,['f17664c168315035bec878066275054a6b4576d9'],30,113,143,15549270,4,0.079365079,0.380952381,0.523809524,11935
66e2325ca572ce96475073b2b09b391ecc09b23e,1,Ni Chunen,2019-07-12 06:52:15+08:00,['46d3f09ff777fdafc69ed43f169b5cbf17fa4569'],74,90,164,15549434,4,0.235294118,0.647058824,0.470588235,11935
7466b7913a9623d6f54fae3c8b8806f9a03b2d56,0,Ni Chunen,2019-07-14 17:49:32+08:00,['66e2325ca572ce96475073b2b09b391ecc09b23e'],1,6,7,15549441,1,0,1,1,11935
decaf230cba5468525bbd525724028c0a55e4d03,0,Ni Chunen,2019-07-14 18:04:56+08:00,['7466b7913a9623d6f54fae3c8b8806f9a03b2d56'],1,1,2,15549443,1,,,,11935
e7f548c85358bb3ad9a3aed697a4311c92bb364c,0,Ni Chunen,2019-07-14 18:19:10+08:00,['decaf230cba5468525bbd525724028c0a55e4d03'],7,54,61,15549504,4,0,0.923076923,1,11936
e5e253f9377f31104d811fe315a1e82d44bfbd62,0,Ni Chunen,2019-07-14 19:03:24+08:00,['e7f548c85358bb3ad9a3aed697a4311c92bb364c'],59,180,239,15549743,6,0.626666667,0.386666667,1,11936
58f990c90762b27ca397fd050324f291398e4f53,0,guosheng lu,2019-07-14 19:07:04+08:00,['e5e253f9377f31104d811fe315a1e82d44bfbd62'],1,30,31,15549774,2,0.964285714,1,0.964285714,11936
34a717233784b8c34c6cf193e96ab8a5fe8b0856,0,Ni Chunen,2019-07-16 10:06:25+08:00,['58f990c90762b27ca397fd050324f291398e4f53'],0,5,5,15549779,1,,,,11936
82b088bd4f69aa4e233c79ba8f305a3dd2301fff,0,Ni Chunen,2019-07-16 11:41:28+08:00,['34a717233784b8c34c6cf193e96ab8a5fe8b0856'],2,2,4,15549783,2,,,,11936
db184be59f99b8dae7fab5f1aa857ed00d937135,0,Ni Chunen,2019-07-16 14:52:31+08:00,['82b088bd4f69aa4e233c79ba8f305a3dd2301fff'],51,74,125,15549908,3,0.315789474,0.315789474,0,11936
8b3a2685369ce24366c2caca2039c3a450723c58,0,Ni Chunen,2019-07-18 14:46:46+08:00,['db184be59f99b8dae7fab5f1aa857ed00d937135'],1,6,7,15549915,2,0,0,1,11936
d659542ed28e6dcb12a9e6944214258f4eefc178,0,Ni Chunen,2019-07-18 17:51:40+08:00,['8b3a2685369ce24366c2caca2039c3a450723c58'],5,35,40,15549955,2,0.75,0.75,0,11936
0b38be9a62984025e0196278e0e517c96df99e43,0,allenma,2019-07-19 15:23:55+08:00,['d659542ed28e6dcb12a9e6944214258f4eefc178'],27,114,141,15550096,6,0.163934426,0.459016393,1,11936
4d654188e2e3a09fec14898f3c49257eb7c07885,0,Ni Chunen,2019-07-22 14:27:38+08:00,['0b38be9a62984025e0196278e0e517c96df99e43'],74,208,282,15550378,24,1,1,1,11936
e4d3d12911ce95da2c0d95e3d39c947e6e90a7d8,0,Shaofeng Shi,2019-07-22 22:29:13+08:00,['4d654188e2e3a09fec14898f3c49257eb7c07885'],2,2,4,15550382,1,,,,11936
536049e827d78c25e09e26fc212f9a4539eecf65,0,Ni Chunen,2019-07-25 18:40:24+08:00,['e4d3d12911ce95da2c0d95e3d39c947e6e90a7d8'],1,1,2,15550384,1,,,,11936
92baa2f6e8265d4d05a0865b7360ac9ff467eedd,0,Ni Chunen,2019-07-25 22:50:10+08:00,['536049e827d78c25e09e26fc212f9a4539eecf65'],13,49,62,15550446,2,1,0.428571429,0.428571429,11936
1f026a6535ba00f8a60a7c6df9036ec827f08c72,1,Ni Chunen,2019-07-26 17:25:46+08:00,['92baa2f6e8265d4d05a0865b7360ac9ff467eedd'],3,3,6,15550452,1,,,,11936
1d56aeef9a20105859f29d28e7acc48d168356ff,0,Ni Chunen,2019-07-28 15:40:07+08:00,['1f026a6535ba00f8a60a7c6df9036ec827f08c72'],33,730,763,15551215,10,0.403645833,0.921875,0.947916667,11943
d2970d821149428e103277b7dd968cee28863da6,0,Shaofeng Shi,2019-07-29 08:57:31+08:00,['1d56aeef9a20105859f29d28e7acc48d168356ff'],1,1,2,15551217,1,,,,11943
774b93bb28a83237123e2a7c10aad209792ee562,0,Ni Chunen,2019-07-29 12:52:25+08:00,['d2970d821149428e103277b7dd968cee28863da6'],55,31,86,15551303,4,0.5,0.5,0.5,11943
32044d9522b881ae1b4723667695c9c01ea342aa,0,Ni Chunen,2019-07-29 13:28:51+08:00,['774b93bb28a83237123e2a7c10aad209792ee562'],4,5,9,15551312,1,0,0,0,11943
ed2092616211e3306d35aeaa0296e6d41b55b273,0,Ni Chunen,2019-07-29 15:51:24+08:00,['32044d9522b881ae1b4723667695c9c01ea342aa'],6,9,15,15551327,2,0,0,1,11943
47a744141045bde0455fa0708fda1cfda4ea8177,1,Ni Chunen,2019-07-30 15:34:11+08:00,['ed2092616211e3306d35aeaa0296e6d41b55b273'],22,30,52,15551379,1,1,0.153846154,1,11943
09fd0f62d4cc3a8a9c592daf22786ccfffbbd5c3,0,Ni Chunen,2019-07-30 17:20:46+08:00,['47a744141045bde0455fa0708fda1cfda4ea8177'],1,1,2,15551381,1,,,,11943
38737f164f53cb8863113956ae76a6dce3b58339,0,Ni Chunen,2019-07-30 20:31:10+08:00,['09fd0f62d4cc3a8a9c592daf22786ccfffbbd5c3'],2,79,81,15551462,2,,,,11944
6f92f2a802b901ef9db0590a7140562336d43a4a,0,Ni Chunen,2019-07-31 17:24:22+08:00,['38737f164f53cb8863113956ae76a6dce3b58339'],65,166,231,15551693,3,0.373626374,0.208791209,0.912087912,11944
6a9161a9d1dff1743ff991ce86ff3ccee97882b7,1,Ni Chunen,2019-07-31 19:28:59+08:00,['6f92f2a802b901ef9db0590a7140562336d43a4a'],1,22,23,15551716,2,1,1,0.2,11944
ed03f1e1c3e83ea4e97673c07677719b24ef096a,1,Ni Chunen,2019-07-31 19:39:39+08:00,['6a9161a9d1dff1743ff991ce86ff3ccee97882b7'],9,51,60,15551776,3,0,0,1,11944
ae32c5724faa4110bde737e8b6e6070dc1423f45,0,Ni Chunen,2019-07-31 20:14:51+08:00,['ed03f1e1c3e83ea4e97673c07677719b24ef096a'],3,1,4,15551780,1,1,0,0,11944
7b3576124bd4a155d8b86f66f6b1ac612570f97d,0,Ni Chunen,2019-08-01 21:37:13+08:00,['ae32c5724faa4110bde737e8b6e6070dc1423f45'],3,4,7,15551787,1,1,1,1,11944
d73838b29336c960e27e2232b9c1440d264f7f13,0,Ni Chunen,2019-08-02 18:22:50+08:00,['7b3576124bd4a155d8b86f66f6b1ac612570f97d'],2,1,3,15551790,1,,,,11944
d449335d68f01270aa0b6a8093ca12daff4b74bd,1,guosheng lu,2019-08-02 20:30:30+08:00,['d73838b29336c960e27e2232b9c1440d264f7f13'],11,18,29,15551819,2,0.8,0.9,1,11944
c39ba7f403c91af3b8e799e498d10b2280db330d,0,Ni Chunen,2019-08-02 20:32:23+08:00,['d449335d68f01270aa0b6a8093ca12daff4b74bd'],4,3,7,15551826,1,0,0,0,11944
d2c3cd342777320185604969d5977bbb75d3058c,0,Ni Chunen,2019-08-05 20:15:39+08:00,['c39ba7f403c91af3b8e799e498d10b2280db330d'],1,5,6,15551832,1,0,0,1,11944
cb7de1d27ccedfd475eeef4d6bebe74bf1edeab8,0,Ni Chunen,2019-08-06 15:15:15+08:00,['d2c3cd342777320185604969d5977bbb75d3058c'],0,1,1,15551833,1,,,,11944
40cab4f164fbeaeba441cefb246437eb9cb02c94,0,Ni Chunen,2019-08-06 17:15:59+08:00,['cb7de1d27ccedfd475eeef4d6bebe74bf1edeab8'],3,7,10,15551843,1,1,1,1,11944
03a2be03de4dc294a4366e7e6e7da4ba6f7f22f0,0,Ni Chunen,2019-08-06 20:56:50+08:00,['40cab4f164fbeaeba441cefb246437eb9cb02c94'],14,339,353,15552196,8,0.401197605,0.850299401,0.958083832,11946
ec4bfa1664d20dfbfd305c03a9b6dd4da7f4f6cc,0,Ni Chunen,2019-08-06 20:56:50+08:00,['03a2be03de4dc294a4366e7e6e7da4ba6f7f22f0'],0,2,2,15552198,2,,,,11946
6668b0d095dc0f6753e41d8dbe352c0547717c3a,1,Ni Chunen,2019-08-09 23:01:05+08:00,['ec4bfa1664d20dfbfd305c03a9b6dd4da7f4f6cc'],11,122,133,15552331,3,0,0,0.617283951,11946
afe076a22b1876bbe551b1f7edb5f9fc68296c1e,1,Ni Chunen,2019-08-11 20:35:07+08:00,['6668b0d095dc0f6753e41d8dbe352c0547717c3a'],57,58,115,15552446,3,1,1,0.5,11946
abc0ab80a04f1bab95f93901f1b802aecaf72382,0,guosheng lu,2019-08-11 20:50:52+08:00,['afe076a22b1876bbe551b1f7edb5f9fc68296c1e'],81,153,234,15552680,7,0,0.794871795,0.487179487,11947
724b36de8c15b417d2332a5699cafbe5f0c9b160,0,Ni Chunen,2019-08-13 16:11:58+08:00,['abc0ab80a04f1bab95f93901f1b802aecaf72382'],1,1,2,15552682,1,0,0,1,11947
465173758773f947339a6568f5546afbb25551d0,1,Ni Chunen,2019-08-15 11:08:20+08:00,['724b36de8c15b417d2332a5699cafbe5f0c9b160'],104,2027,2131,15554813,36,0.673984632,0.82546652,0.839736553,11961
5a53486a256ca550148075a7598a59f670dc2374,0,Ni Chunen,2019-08-15 11:09:27+08:00,['465173758773f947339a6568f5546afbb25551d0'],9,0,9,15554822,2,0,0,0,11961
99bbabd93fadf05fee1381d105ebb5d368b7a6b6,0,Ni Chunen,2019-08-15 11:09:58+08:00,['5a53486a256ca550148075a7598a59f670dc2374'],4,0,4,15554826,1,0,0,0,11961
57fb3c9f97994c5c55c7edfc9555fa0eb0c90b94,0,Ni Chunen,2019-08-15 11:10:38+08:00,['99bbabd93fadf05fee1381d105ebb5d368b7a6b6'],13,0,13,15554839,2,,,,11961
194272986e6dec96a78f1228d27e0208a68a268b,1,Ni Chunen,2019-08-15 16:47:58+08:00,['57fb3c9f97994c5c55c7edfc9555fa0eb0c90b94'],3,47,50,15554889,3,0,1,1,11962
dfb848844f9e6c9e9984f99a347d4e70f44c4249,0,Ni Chunen,2019-08-16 13:43:39+08:00,['194272986e6dec96a78f1228d27e0208a68a268b'],4,57,61,15554950,2,0,0.230769231,0.487179487,11962
73c1a85fe5e3ee2a70592ca98f899b9f41dfc207,0,Ni Chunen,2019-08-16 15:13:59+08:00,['dfb848844f9e6c9e9984f99a347d4e70f44c4249'],2,37,39,15554989,3,1,1,1,11963
2def3a4cf526151e07bcb3c97b48ace21b91d25d,0,Ni Chunen,2019-08-22 08:34:48+08:00,['73c1a85fe5e3ee2a70592ca98f899b9f41dfc207'],45,82,127,15555116,8,0,0,1,11963
b78c08895f822ca54a6fe227d4f3321be7b4bdad,0,Ni Chunen,2019-08-26 21:02:55+08:00,['2def3a4cf526151e07bcb3c97b48ace21b91d25d'],7,27,34,15555150,3,0,0.875,0.375,11963
20a93e75a59fa1bda8547e1c0267d35716862d2d,0,Ni Chunen,2019-08-26 21:15:28+08:00,['b78c08895f822ca54a6fe227d4f3321be7b4bdad'],12,24,36,15555186,9,0.666666667,0.666666667,1,11963
d6bff664fdd58db2cc7f0966c9b52ecc1a89bb8d,0,Ni Chunen,2019-08-27 09:40:30+08:00,['20a93e75a59fa1bda8547e1c0267d35716862d2d'],6,21,27,15555213,1,0,0,0.933333333,11963
191d4beda9172877b5807be0dc30b49b8457b373,0,Ni Chunen,2019-08-27 15:10:11+08:00,['d6bff664fdd58db2cc7f0966c9b52ecc1a89bb8d'],4,4,8,15555221,2,,,,11963
7b460d10c1e229508eedf87223fc97191bcf904b,0,Ni Chunen,2019-08-27 18:21:30+08:00,['191d4beda9172877b5807be0dc30b49b8457b373'],34,3,37,15555258,2,,,,11963
54c1acf8d9a0f5a47e16484a690516977f79073f,0,Ni Chunen,2019-08-27 18:23:56+08:00,['7b460d10c1e229508eedf87223fc97191bcf904b'],9,66,75,15555333,5,1,1,0.4,11963
6e1d48ebb86089b185b10fdbc5eea40cf4df0ea7,1,Ni Chunen,2019-08-27 18:24:43+08:00,['54c1acf8d9a0f5a47e16484a690516977f79073f'],0,460,460,15555793,12,,,,11975
60b01bafd712cfa92fd0f19586b51a9ffc743d54,0,Ni Chunen,2019-08-29 20:49:42+08:00,['6e1d48ebb86089b185b10fdbc5eea40cf4df0ea7'],0,10,10,15555803,1,0,0,1,11975
452e7c80c2be9d4c0de2e8f6d3ecca849b280e2f,0,Ni Chunen,2019-08-29 20:58:20+08:00,['60b01bafd712cfa92fd0f19586b51a9ffc743d54'],53,121,174,15555977,1,,,,11975
ebff43a81eeac79429138d2be1ab7a9a0d5f41f3,0,Ni Chunen,2019-08-29 22:08:06+08:00,['452e7c80c2be9d4c0de2e8f6d3ecca849b280e2f'],16,40,56,15556033,10,0,0.25,1,11975
1b9894e60140a10f9f2bb06b694437a8e4b9793d,1,Ni Chunen,2019-08-29 22:14:18+08:00,['ebff43a81eeac79429138d2be1ab7a9a0d5f41f3'],66,9,75,15556108,5,0,0,0.6,11975
dee88f9aa572525cef80ee2cc37ca67ad2dd8f00,0,Ni Chunen,2019-08-29 23:04:43+08:00,['1b9894e60140a10f9f2bb06b694437a8e4b9793d'],20,180,200,15556308,5,1,1,1,11976
de23e721859e45e1db50353d2af53c8267402862,0,Ni Chunen,2019-08-30 19:17:08+08:00,['dee88f9aa572525cef80ee2cc37ca67ad2dd8f00'],0,1,1,15556309,1,0,1,1,11976
dae765fb83cae9f72377ac2c8376a8c748451d7b,0,Ni Chunen,2019-09-03 20:53:53+08:00,['de23e721859e45e1db50353d2af53c8267402862'],3,0,3,15556312,1,,,,11976
f29638632fb4269c00bcb165759f287d8c50bccc,0,Ni Chunen,2019-09-03 21:11:45+08:00,['dae765fb83cae9f72377ac2c8376a8c748451d7b'],3,63,66,15556378,5,1,1,0.470588235,11976
42ba57f7f396f616c8b7f622ac96c2f2f7721482,1,Ni Chunen,2019-09-03 21:24:30+08:00,['f29638632fb4269c00bcb165759f287d8c50bccc'],11,3,14,15556392,1,0,0,0,11976
800d1c59d0e7c2915be320e83d3bd5efb6afc268,0,shaofengshi,2019-09-05 11:12:49+08:00,['42ba57f7f396f616c8b7f622ac96c2f2f7721482'],1,1,2,15556394,1,,,,11976
cdb6c655490cad7737d5a5d3e39be2d715b7d8b4,0,Ni Chunen,2019-09-06 17:29:11+08:00,['800d1c59d0e7c2915be320e83d3bd5efb6afc268'],1,1,2,15556396,1,,,,11976
893a75a8b1accec37fd15a2d055ee58243fa56c4,0,Ni Chunen,2019-09-09 21:27:07+08:00,['cdb6c655490cad7737d5a5d3e39be2d715b7d8b4'],1,18,19,15556415,3,0.461538462,0.461538462,0.769230769,11976
7e117e27764dc94cd627b0bd3dc4f4bbbf7f4a3e,0,Ni Chunen,2019-09-09 21:41:25+08:00,['893a75a8b1accec37fd15a2d055ee58243fa56c4'],71,51,122,15556537,3,0,0,0.421052632,11976
f62adcdebff121cac28685cdfb850bcc27df643d,0,Ni Chunen,2019-09-10 15:09:30+08:00,['7e117e27764dc94cd627b0bd3dc4f4bbbf7f4a3e'],0,9,9,15556546,1,,,,11976
ff828f6d6a3675b87702b87bab31778dd5576c8c,0,Ni Chunen,2019-09-10 15:09:30+08:00,['f62adcdebff121cac28685cdfb850bcc27df643d'],0,84,84,15556630,5,,,,11976
a8e87c8fe29aa342df3f6c15428345ff60105ec0,1,Ni Chunen,2019-09-10 16:04:52+08:00,['ff828f6d6a3675b87702b87bab31778dd5576c8c'],15,18,33,15556663,1,0,0,1,11976
ce0e336ffe4433feee4b0582bfec5f8afc686caf,0,Ni Chunen,2019-09-10 21:02:46+08:00,['a8e87c8fe29aa342df3f6c15428345ff60105ec0'],6,18,24,15556687,2,0.916666667,0,1,11976
154d5d5f36fc194fdb81a94936ddf88fdb0cd290,0,Ni Chunen,2019-09-10 21:32:27+08:00,['ce0e336ffe4433feee4b0582bfec5f8afc686caf'],2,2,4,15556691,1,,,,11976
08075e0d0dee9106546c2c1112699a57a3d25c62,0,Ni Chunen,2019-09-10 21:42:31+08:00,['154d5d5f36fc194fdb81a94936ddf88fdb0cd290'],2,15,17,15556708,1,1,1,1,11976
014b11095cf3d89f8274efbf09652ef3661e8a05,0,Ni Chunen,2019-09-11 10:46:53+08:00,['08075e0d0dee9106546c2c1112699a57a3d25c62'],0,4,4,15556712,1,,,,11976
12655bff44d8f3831bb129fa8c3b948ba1578fc3,0,Ni Chunen,2019-09-11 11:34:37+08:00,['014b11095cf3d89f8274efbf09652ef3661e8a05'],2,17,19,15556731,1,0,1,1,11976
661f5ac4cb938ad881bef4705348c72e8cf4e8ca,0,Ni Chunen,2019-09-11 14:35:32+08:00,['12655bff44d8f3831bb129fa8c3b948ba1578fc3'],3,33,36,15556767,2,0,0.166666667,0,11977
1a2f779a074c1d03703eebbb7506d171ef26ce56,0,Ni Chunen,2019-09-11 22:02:52+08:00,['661f5ac4cb938ad881bef4705348c72e8cf4e8ca'],70,553,623,15557390,21,0.505119454,0.846416382,0.894197952,11980
d2907d8f017c316376d5ad5e0206b49c4dba0118,1,Ni Chunen,2019-09-12 15:04:39+08:00,['1a2f779a074c1d03703eebbb7506d171ef26ce56'],2,192,194,15557584,3,0.76744186,0.988372093,0.988372093,11982
1b71a6259411ac0d69ff460f5ee3c789498873a5,1,Ni Chunen,2019-09-12 15:04:39+08:00,['d2907d8f017c316376d5ad5e0206b49c4dba0118'],26,27,53,15557637,4,,,,11982
ca76625bc3b783ced7168e9ff7bd588ade2592ab,0,Ni Chunen,2019-09-12 19:50:59+08:00,['1b71a6259411ac0d69ff460f5ee3c789498873a5'],3,35,38,15557675,3,1,1,1,11982
a2aca12ff3f8114be9c215ccee5e2ad74fe05f9d,0,Ni Chunen,2019-09-12 19:50:59+08:00,['ca76625bc3b783ced7168e9ff7bd588ade2592ab'],16,12,28,15557703,2,,,,11982
23846794fef1d6c4eae523869da7c4d2617b540c,0,Ni Chunen,2019-09-17 17:00:52+08:00,['a2aca12ff3f8114be9c215ccee5e2ad74fe05f9d'],2,33,35,15557738,2,0,1,1,11982
199bc17e572652b8a8ec8c4f0c6aab1a2359c1ef,0,guosheng lu,2019-09-17 17:34:08+08:00,['23846794fef1d6c4eae523869da7c4d2617b540c'],12,130,142,15557880,9,0.509615385,0.528846154,0.798076923,11982
5867d6b687f9c667d40b7b3e6437eea14e86835e,0,Ni Chunen,2019-09-19 18:23:02+08:00,['199bc17e572652b8a8ec8c4f0c6aab1a2359c1ef'],9,16,25,15557905,4,0.666666667,1,0.666666667,11982
ac27da78c9e94d773367ba6a5c7ec80c2df60a80,0,Ni Chunen,2019-09-19 22:09:06+08:00,['5867d6b687f9c667d40b7b3e6437eea14e86835e'],5,5,10,15557915,4,,,,11982
2091f1ebf1ca84c0f7d5f582336f2d9b8ddbd471,1,Ni Chunen,2019-09-20 15:07:31+08:00,['ac27da78c9e94d773367ba6a5c7ec80c2df60a80'],1,1,2,15557917,1,,,,11982
0dc8f2c29628d1eb1a975481d23f56fdeb3e0544,0,Ni Chunen,2019-09-21 10:29:42+08:00,['2091f1ebf1ca84c0f7d5f582336f2d9b8ddbd471'],553,70,623,15558540,21,0.494880546,0.153583618,0.105802048,11982
566ded888733dec7aba241944675169c4ef869d3,0,Ni Chunen,2019-09-21 15:05:33+08:00,['0dc8f2c29628d1eb1a975481d23f56fdeb3e0544'],5,6,11,15558551,1,,,,11982
9ae2bd17489e87efacd7b177735c9ddc8e03e09f,0,Ni Chunen,2019-09-23 23:14:37+08:00,['566ded888733dec7aba241944675169c4ef869d3'],16,20,36,15558587,1,0,0,0,11982
19706b2e2aeac0e65ec467c55a8b90bb5b43ff51,0,Ni Chunen,2019-09-23 23:46:34+08:00,['9ae2bd17489e87efacd7b177735c9ddc8e03e09f'],37,29,66,15558653,2,0,0,0,11982
92273d469511d32c5291f8b856ed0f4fba98b5e6,1,Ni Chunen,2019-09-24 13:50:36+08:00,['19706b2e2aeac0e65ec467c55a8b90bb5b43ff51'],381,620,1001,15559654,16,0.379032258,0.258064516,0.935483871,11983
4f3d8e70124349b121e920b93a0683303014ef11,0,Ni Chunen,2019-09-24 13:50:36+08:00,['92273d469511d32c5291f8b856ed0f4fba98b5e6'],5,748,753,15560407,11,0.283854167,0.776041667,0.8046875,11987
a6fc3e7e22bf335f868ad3533aae65b602a9ea94,0,Ni Chunen,2019-09-24 13:50:36+08:00,['4f3d8e70124349b121e920b93a0683303014ef11'],75,203,278,15560685,16,0.538461538,0.153846154,0.615384615,11987
e8ad658fcd43c650a7545c0d6946fdcd114460dc,0,Ni Chunen,2019-09-24 13:50:36+08:00,['a6fc3e7e22bf335f868ad3533aae65b602a9ea94'],25,2645,2670,15563355,25,0.319482289,0.615122616,0.705040872,11999
80384da925e7b284eea461d21754ebc2d7695c66,0,Ni Chunen,2019-09-24 13:50:36+08:00,['e8ad658fcd43c650a7545c0d6946fdcd114460dc'],167,18,185,15563540,6,0.292307692,0.553846154,0,11999
75c90df928d921808201b172f14c42cc91eeae02,0,Ni Chunen,2019-09-24 17:46:44+08:00,['80384da925e7b284eea461d21754ebc2d7695c66'],5,3,8,15563548,2,0,0,0,11999
78db7998198cc6b51cddb79f773500a650789818,0,Shaofeng Shi,2019-09-29 19:23:24+08:00,['75c90df928d921808201b172f14c42cc91eeae02'],1,13,14,15563562,1,1,1,1,11999
1e64c23c49043a426889274aacf26652d9d96d0a,0,Ni Chunen,2019-09-30 11:51:10+08:00,['78db7998198cc6b51cddb79f773500a650789818'],5,3,8,15563570,1,,,,11999
1b88e90b82cf8cd9658491a2ca31ad25920d655a,0,Xiaoxiang Yu,2020-06-15 18:58:11+08:00,['1e64c23c49043a426889274aacf26652d9d96d0a'],4,4,8,15563578,2,,,,11999
4b9e6dcf31f82eb0a5760d470192599336a53b86,0,Xiaoxiang Yu,2020-06-15 18:58:11+08:00,['1b88e90b82cf8cd9658491a2ca31ad25920d655a'],11,32,43,15563621,3,0.733333333,1,1,11999
d3a334ddf7ce06dc15d5b17da38bf7f12935b440,0,Xiaoxiang Yu,2020-06-15 18:58:11+08:00,['4b9e6dcf31f82eb0a5760d470192599336a53b86'],4,9,13,15563634,1,0,0,0,11999
3779b11badf7828fb61fe04fbf905c3ce490ea02,1,Xiaoxiang Yu,2020-06-15 18:58:11+08:00,['d3a334ddf7ce06dc15d5b17da38bf7f12935b440'],2,3,5,15563639,1,0,1,0,11999
4a00f802447c9355280748a342a540dcda3dcfd0,0,Xiaoxiang Yu,2020-06-15 18:58:11+08:00,['3779b11badf7828fb61fe04fbf905c3ce490ea02'],10,29,39,15563678,2,,,,11999
5d52d3b19fa332270719f2d66253e57b1d036fac,0,Xiaoxiang Yu,2020-06-15 18:58:11+08:00,['4a00f802447c9355280748a342a540dcda3dcfd0'],2,2,4,15563682,1,,0,,11999
16ed55754fee83a3e0028e5e33e93fb89ec6dec3,0,Xiaoxiang Yu,2020-06-15 18:58:11+08:00,['5d52d3b19fa332270719f2d66253e57b1d036fac'],1,1,2,15563684,1,,,,11999
3bce8659b502b796d69e56807db2e00720304b38,0,Xiaoxiang Yu,2020-06-15 18:58:11+08:00,['16ed55754fee83a3e0028e5e33e93fb89ec6dec3'],1,80,81,15563765,3,0,0.080645161,0.85483871,11999
5e1636ca74500dec2362c18ae150a6bc0218b253,0,Xiaoxiang Yu,2020-06-15 18:58:11+08:00,['3bce8659b502b796d69e56807db2e00720304b38'],80,1,81,15563846,3,1,0.919354839,0.14516129,11999
42ebbd0ef2d305c4328d50de137696b134e4d664,0,Xiaoxiang Yu,2020-06-15 18:58:11+08:00,['5e1636ca74500dec2362c18ae150a6bc0218b253'],98,184,282,15564128,5,0.029850746,0.71641791,0.895522388,11999
f6a19fadab5a293027d89a51cc8715512652cee3,0,Xiaoxiang Yu,2020-06-15 18:58:11+08:00,['42ebbd0ef2d305c4328d50de137696b134e4d664'],1,21,22,15564150,3,0,1,1,11999
a393abea81f7f7fb8091738fd84160173048416f,1,Xiaoxiang Yu,2020-06-15 18:58:11+08:00,['f6a19fadab5a293027d89a51cc8715512652cee3'],10,7,17,15564167,3,1,0.333333333,1,11999
3a47d375804e068c4f8ee8d863cf93857d39626d,0,Xiaoxiang Yu,2020-06-15 18:58:11+08:00,['a393abea81f7f7fb8091738fd84160173048416f'],9,61,70,15564237,5,1,1,0.947368421,12000
bc79afdc630329cb92f37dd21a39c7466a6df465,0,Xiaoxiang Yu,2020-06-15 18:58:11+08:00,['3a47d375804e068c4f8ee8d863cf93857d39626d'],1,2,3,15564240,1,,,,12000
818b7b0776e0380d1246fc044de49833945fadbe,0,Xiaoxiang Yu,2020-06-15 18:58:11+08:00,['bc79afdc630329cb92f37dd21a39c7466a6df465'],6,38,44,15564284,2,0,0,1,12001
eaf9e3c3a7ffd3e9255960531a79f75e15317852,0,Xiaoxiang Yu,2020-06-15 18:58:11+08:00,['818b7b0776e0380d1246fc044de49833945fadbe'],3,7,10,15564294,1,0,0,1,12001
8f3ce86a5b93bcc514ba938ae8d45798a85b9ffb,0,Xiaoxiang Yu,2020-06-15 18:58:11+08:00,['eaf9e3c3a7ffd3e9255960531a79f75e15317852'],25,195,220,15564514,12,0.666666667,1,0.913580247,12002
c25639ac5f989f33cb20ecf6baa5288408b26405,0,Xiaoxiang Yu,2020-06-15 18:58:11+08:00,['8f3ce86a5b93bcc514ba938ae8d45798a85b9ffb'],1,1,2,15564516,1,,,,12002
c8b6b61d66f01af18bfd6e4c92d2b6ed58fdcfe1,1,Xiaoxiang Yu,2020-06-15 18:58:11+08:00,['c25639ac5f989f33cb20ecf6baa5288408b26405'],17,19,36,15564552,4,,,,12002
95541aa8c8bb31232daf6dfbfaa5637e0ac77b5f,0,Xiaoxiang Yu,2020-06-15 18:58:11+08:00,['c8b6b61d66f01af18bfd6e4c92d2b6ed58fdcfe1'],1,1,2,15564554,1,,,,12002
631fd258da2b2331d37261ee54a9afc847d06e73,1,Xiaoxiang Yu,2020-06-15 18:58:11+08:00,['95541aa8c8bb31232daf6dfbfaa5637e0ac77b5f'],2,3,5,15564559,1,,,,12002
bbfb7fd4d209662bb62f75f0165ef3d78d541087,1,Xiaoxiang Yu,2020-06-15 18:58:11+08:00,['631fd258da2b2331d37261ee54a9afc847d06e73'],9,9,18,15564577,3,,,,12002
bab187a37759d84a4cf37582add9f85746ce0041,0,Xiaoxiang Yu,2020-06-15 18:58:11+08:00,['bbfb7fd4d209662bb62f75f0165ef3d78d541087'],1,1,2,15564579,1,,,,12002
170dd575d7e6345392ca6488c8dec75169d7c727,0,Xiaoxiang Yu,2020-06-15 18:58:11+08:00,['bab187a37759d84a4cf37582add9f85746ce0041'],2,43,45,15564624,1,0,0.153846154,1,12002
b49de47db07d8c02a597803cc354225de0220aef,0,Xiaoxiang Yu,2020-06-15 18:58:11+08:00,['170dd575d7e6345392ca6488c8dec75169d7c727'],28,1,29,15564653,1,1,1,0,12002
b8962223ca65e98191d59c2a8891213d0446535c,0,Xiaoxiang Yu,2020-06-15 18:58:11+08:00,['b49de47db07d8c02a597803cc354225de0220aef'],1,1,2,15564655,1,,,,12002
a80f3fb234589e0310da1dd2629d0c1b8d0cfa6a,1,Xiaoxiang Yu,2020-06-15 18:58:11+08:00,['b8962223ca65e98191d59c2a8891213d0446535c'],0,2834,2834,15567489,28,0.611438183,0.90412111,0.983179142,12030
f5c7cec43765afe5920a1003d5173fb3d70de3b5,1,Xiaoxiang Yu,2020-06-15 18:58:11+08:00,['a80f3fb234589e0310da1dd2629d0c1b8d0cfa6a'],0,5140,5140,15572629,35,0.3393276,0.780297107,0.853401095,12065
06911b29203763fe1ceeca59d207364b34a9aac0,1,Xiaoxiang Yu,2020-06-15 18:58:11+08:00,['f5c7cec43765afe5920a1003d5173fb3d70de3b5'],0,1970,1970,15574599,9,0.380835381,0.728910729,0.655200655,12074
e978e0447080a985346a56d8d30ce1038dde4ebf,1,Xiaoxiang Yu,2020-06-15 18:58:11+08:00,['06911b29203763fe1ceeca59d207364b34a9aac0'],0,3219,3219,15577818,34,0.482855143,0.750174948,0.66689993,12108
5a316f763da06ba61c7ee7f52207cd566284551f,0,Xiaoxiang Yu,2020-06-15 18:58:11+08:00,['e978e0447080a985346a56d8d30ce1038dde4ebf'],0,4659,4659,15582477,38,0.633596392,0.852311161,0.882750846,12146
48fdb2720cb4d7e19e6f6bf949af4b6daa035ca4,0,Xiaoxiang Yu,2020-06-15 18:58:11+08:00,['5a316f763da06ba61c7ee7f52207cd566284551f'],0,525,525,15583002,8,0.650485437,1,0.951456311,12154
aa6d9fad57211182f3bd65509b2ab42a7b3aab97,0,Xiaoxiang Yu,2020-06-15 18:58:11+08:00,['48fdb2720cb4d7e19e6f6bf949af4b6daa035ca4'],0,746,746,15583748,5,0.530364372,0.789473684,0.712550607,12159
fbba33d1bd1959d8e4fc64299d37a1c72fd2e452,0,Xiaoxiang Yu,2020-06-15 18:58:11+08:00,['aa6d9fad57211182f3bd65509b2ab42a7b3aab97'],0,375,375,15584123,4,0.756756757,1,1,12163
7de06ce1cbaa592b5598231b6a9239abb88d15b6,0,Xiaoxiang Yu,2020-06-15 18:58:11+08:00,['fbba33d1bd1959d8e4fc64299d37a1c72fd2e452'],0,159462,159462,15743585,330,1,1,1,12493
0a4910f3f24d6a78982680d4c2efe79598a49445,0,Xiaoxiang Yu,2020-06-15 18:58:11+08:00,['7de06ce1cbaa592b5598231b6a9239abb88d15b6'],0,856,856,15744441,10,0.74122807,0.907894737,1,12503
81adb346cd201f1cb76b1dae0552d27d978ce4f2,0,Xiaoxiang Yu,2020-06-15 18:58:11+08:00,['0a4910f3f24d6a78982680d4c2efe79598a49445'],0,883,883,15745324,7,0.658536585,0.875338753,0.720867209,12510
631064055f5769b122dd8c0e0e0936c6c3e431c7,0,Xiaoxiang Yu,2020-06-15 18:58:11+08:00,['81adb346cd201f1cb76b1dae0552d27d978ce4f2'],0,947,947,15746271,8,0.655384615,0.827692308,1,12518
0ecf45deed347f91ad42a3a1e022255060ce12e7,0,Xiaoxiang Yu,2020-06-15 18:58:11+08:00,['631064055f5769b122dd8c0e0e0936c6c3e431c7'],158456,1244,159700,15905971,333,0.321475626,0.984189723,0.911725955,12527
b26770f5ad81ab2bd7324a929a21a2c6bcf44458,0,Xiaoxiang Yu,2020-06-15 18:58:11+08:00,['0ecf45deed347f91ad42a3a1e022255060ce12e7'],60,288,348,15906319,207,1,1,0,12532
847a11b1d8ac8141c9dc3a3b860a5f7c2eaa63d3,0,Xiaoxiang Yu,2020-06-15 18:58:11+08:00,['b26770f5ad81ab2bd7324a929a21a2c6bcf44458'],2,8,10,15906329,1,,,,12532
880a684d28d7ff9465d0dfed96638d6b76d22e85,0,Xiaoxiang Yu,2020-06-15 18:58:11+08:00,['847a11b1d8ac8141c9dc3a3b860a5f7c2eaa63d3'],1,70,71,15906400,5,1,1,0.863636364,12533
8e79222b7d50e348286b7f845b54d991aa4ac2f4,0,Xiaoxiang Yu,2020-06-15 18:58:11+08:00,['880a684d28d7ff9465d0dfed96638d6b76d22e85'],14,154,168,15906568,7,1,1,1,12536
cf0dffb7358fab50b8914781051ac3364ce4ed01,0,Xiaoxiang Yu,2020-06-15 18:58:11+08:00,['8e79222b7d50e348286b7f845b54d991aa4ac2f4'],18,607,625,15907193,8,1,0.955645161,0.971774194,12539
48cea01c85483003b47ee450dd48bcad1aa579bc,0,Xiaoxiang Yu,2020-06-15 18:58:11+08:00,['cf0dffb7358fab50b8914781051ac3364ce4ed01'],74,98,172,15907365,6,1,1,1,12540
e7d71bdcc68587366dfcc4120147b89f2b2770b5,1,Xiaoxiang Yu,2020-06-15 18:58:11+08:00,['48cea01c85483003b47ee450dd48bcad1aa579bc'],20,40,60,15907425,8,1,1,1,12540
7035b1f3ae81798a96ee658de0f16b3afb7ab6bc,0,Xiaoxiang Yu,2020-06-15 18:58:11+08:00,['e7d71bdcc68587366dfcc4120147b89f2b2770b5'],0,149059,149059,16056484,117,,,,12657
bf504cbac2806ee9084fed9d20b49f6dc935ef49,0,Xiaoxiang Yu,2020-06-15 18:58:11+08:00,['7035b1f3ae81798a96ee658de0f16b3afb7ab6bc'],16,553,569,16057053,5,0.778501629,0.794788274,1,12658
9f123a8a84b71faaf26f55f1fd55d41bb14a38db,0,Xiaoxiang Yu,2020-06-15 18:58:11+08:00,['bf504cbac2806ee9084fed9d20b49f6dc935ef49'],0,90,90,16057143,3,1,1,1,12660
dba46edf4595f1e194b05ff8571a13cd07bb0705,0,Xiaoxiang Yu,2020-06-15 18:58:11+08:00,['9f123a8a84b71faaf26f55f1fd55d41bb14a38db'],225,202,427,16057570,10,0.421875,0.53125,0.15625,12661
646b71eb39365e2f1542882a02ba0086913c48c2,0,Xiaoxiang Yu,2020-06-15 18:58:11+08:00,['dba46edf4595f1e194b05ff8571a13cd07bb0705'],74,78,152,16057722,6,0,0,0,12662
237539d5bb22561692ac9dec9ee33e4c2b76e5ea,0,Xiaoxiang Yu,2020-06-15 18:58:11+08:00,['646b71eb39365e2f1542882a02ba0086913c48c2'],25,0,25,16057747,1,,,,12662
998b6a330c854595969af996e1403b72a5d9cc35,0,Xiaoxiang Yu,2020-06-15 18:58:11+08:00,['237539d5bb22561692ac9dec9ee33e4c2b76e5ea'],76,41,117,16057864,4,,,,12662
074ed80fe39994a81a34d2af03ea1124a9dd51f0,0,Xiaoxiang Yu,2020-06-15 18:58:11+08:00,['998b6a330c854595969af996e1403b72a5d9cc35'],39,424,463,16058327,8,1,1,0.944134078,12665
a3ecc66752eab41154506cb2cb08f8f0b274dc6f,0,Xiaoxiang Yu,2020-06-15 18:58:11+08:00,['074ed80fe39994a81a34d2af03ea1124a9dd51f0'],48,91,139,16058466,6,1,1,1,12665
6bd9439a8a3a59a9f81ceced254f2b3eec11da82,0,Xiaoxiang Yu,2020-06-15 18:58:11+08:00,['a3ecc66752eab41154506cb2cb08f8f0b274dc6f'],40,605,645,16059111,10,1,1,1,12668
bc94039d34b29f6f69decfc54d62de2547108c19,0,Xiaoxiang Yu,2020-06-15 18:58:11+08:00,['6bd9439a8a3a59a9f81ceced254f2b3eec11da82'],130,176,306,16059417,12,1,1,1,12669
9f996d5a620760f74e182922e7f018f2cb594d11,0,Xiaoxiang Yu,2020-06-15 18:58:11+08:00,['bc94039d34b29f6f69decfc54d62de2547108c19'],17,6,23,16059440,2,0,0,0,12669
82b4f82db1e2a063b7ffa23dfe0f18254226da78,0,Xiaoxiang Yu,2020-06-15 18:58:11+08:00,['9f996d5a620760f74e182922e7f018f2cb594d11'],22,18,40,16059480,1,,,,12669
9f5e8560ce741ba4c4df2dcfbffe79f8e72509bb,0,Xiaoxiang Yu,2020-06-15 18:58:11+08:00,['82b4f82db1e2a063b7ffa23dfe0f18254226da78'],189,319,508,16059988,8,0,1,0.5,12670
40b11d6122908740b07de1e74189b752b91be575,1,Xiaoxiang Yu,2020-06-15 18:58:11+08:00,['9f5e8560ce741ba4c4df2dcfbffe79f8e72509bb'],50,229,279,16060267,16,1,1,1,12671
a86aff3b9033b29305f3daade48f6529b7ff39ac,0,Xiaoxiang Yu,2020-06-15 18:58:11+08:00,['40b11d6122908740b07de1e74189b752b91be575'],188,425,613,16060880,18,1,1,0.972727273,12673
c4d3aa2676c79a0e084e5c1f864f29c677d72ec7,0,Xiaoxiang Yu,2020-06-15 18:58:11+08:00,['a86aff3b9033b29305f3daade48f6529b7ff39ac'],232,277,509,16061389,14,1,0.95890411,0.136986301,12674
7595c4c9cb4fc3b330da2775eff853f2e5108788,0,Xiaoxiang Yu,2020-06-15 18:58:11+08:00,['c4d3aa2676c79a0e084e5c1f864f29c677d72ec7'],76,421,497,16061886,20,1,1,0.92920354,12677
b66175fa47db4b8123e141db571993064a318205,0,Xiaoxiang Yu,2020-06-15 18:58:11+08:00,['7595c4c9cb4fc3b330da2775eff853f2e5108788'],69,210,279,16062165,14,0.201219512,0.591463415,0.87804878,12677
dbc14c4a0ab5f81f2d8e7f6c1fbc6067e88cb9cd,0,Xiaoxiang Yu,2020-06-15 18:58:11+08:00,['b66175fa47db4b8123e141db571993064a318205'],70,424,494,16062659,12,0.613924051,1,1,12681
8e17b1ae152df143dd5ce5cea065abf7f69cafb2,0,Xiaoxiang Yu,2020-06-15 18:58:11+08:00,['dbc14c4a0ab5f81f2d8e7f6c1fbc6067e88cb9cd'],29,584,613,16063272,10,0.199556541,0.243902439,0.689578714,12683
453f6dd2ab5178997fc991b3a2113bbe4fa49ff2,0,Xiaoxiang Yu,2020-06-15 18:58:11+08:00,['8e17b1ae152df143dd5ce5cea065abf7f69cafb2'],3301,2460,5761,16069033,176,1,1,1,12683
f14180c0fa1906297f159ede6e8820dc9c5d42ed,0,Xiaoxiang Yu,2020-06-15 18:58:11+08:00,['453f6dd2ab5178997fc991b3a2113bbe4fa49ff2'],8,7,15,16069048,3,0,0,0,12683
c7e60c501c830f6b82e011c2bdd949caab71e431,0,Xiaoxiang Yu,2020-06-15 18:58:11+08:00,['f14180c0fa1906297f159ede6e8820dc9c5d42ed'],570,4299,4869,16073917,77,0.445783133,0.93373494,0.987951807,12738
e29b8f604a30927472c49a06e4b8b9eaf5c54dc7,0,Xiaoxiang Yu,2020-06-15 18:58:11+08:00,['c7e60c501c830f6b82e011c2bdd949caab71e431'],220,378,598,16074515,15,1,1,1,12739
337aa6301378857bea0e517f443e2539a1f486b3,1,Xiaoxiang Yu,2020-06-15 18:58:11+08:00,['e29b8f604a30927472c49a06e4b8b9eaf5c54dc7'],11594,9909,21503,16096018,212,1,0,0,12801
f00a57740f3fa1f9abc454589fbe905dcc86e48d,0,Xiaoxiang Yu,2020-06-15 18:58:11+08:00,['337aa6301378857bea0e517f443e2539a1f486b3'],66,501,567,16096585,5,0.365269461,0.838323353,0.700598802,12804
bbd539d1ab5af47168b6250fc387e137517fcd08,0,Xiaoxiang Yu,2020-06-15 18:58:11+08:00,['f00a57740f3fa1f9abc454589fbe905dcc86e48d'],310,205,515,16097100,16,0.487179487,0.282051282,1,12806
afb581de74dcf2a5e0f4d2e0005fa3111e5290f2,0,Xiaoxiang Yu,2020-06-15 18:58:11+08:00,['bbd539d1ab5af47168b6250fc387e137517fcd08'],231,129,360,16097460,13,0.238095238,0.333333333,0,12807
3a61c7581dde3f6634ff894ade03db3f99fde370,0,Xiaoxiang Yu,2020-06-15 18:58:11+08:00,['afb581de74dcf2a5e0f4d2e0005fa3111e5290f2'],534,279,813,16098273,14,0.62295082,0,0.12295082,12812
da6eef3bc1d88caa8b77dd8575f5ec8b90726d77,1,Xiaoxiang Yu,2020-06-15 18:58:11+08:00,['3a61c7581dde3f6634ff894ade03db3f99fde370'],154,154,308,16098581,2,1,1,1,12812
af411854b429aaaa71d47c23b3121c882ca69f7c,0,Xiaoxiang Yu,2020-06-15 18:58:11+08:00,['da6eef3bc1d88caa8b77dd8575f5ec8b90726d77'],6,5,11,16098592,1,,,,12812
904651dc54643c678119b13bc5ac87183502a642,1,Xiaoxiang Yu,2020-06-15 18:58:11+08:00,['af411854b429aaaa71d47c23b3121c882ca69f7c'],11505,2738,14243,16112835,102,0.247644408,0.190290864,0.068414584,12816
6d397b7b9578deb63d5b13af8c6a12591d0b32a0,0,Xiaoxiang Yu,2020-06-15 18:58:11+08:00,['904651dc54643c678119b13bc5ac87183502a642'],171,235,406,16113241,9,0.4,1,1,12816
a0fc18d136bd111c25edcaf05ec340582dc54270,0,Xiaoxiang Yu,2020-06-15 18:58:11+08:00,['6d397b7b9578deb63d5b13af8c6a12591d0b32a0'],496,0,496,16113737,4,0.871980676,0.823671498,0.31884058,12816
c8c1f6174c95d638c929ae5202829aeebe2c5411,1,Xiaoxiang Yu,2020-06-15 18:58:11+08:00,['a0fc18d136bd111c25edcaf05ec340582dc54270'],40,295,335,16114072,9,0.594936709,1,0.974683544,12817
8a058e7f69d14653e881037638f2a3d9248581c2,1,Xiaoxiang Yu,2020-06-15 18:58:11+08:00,['c8c1f6174c95d638c929ae5202829aeebe2c5411'],98,28,126,16114198,7,0.886363636,0,0,12817
81821be7bebccfab2496d2ed0df8ec45bb825fbb,1,Xiaoxiang Yu,2020-06-15 18:58:11+08:00,['8a058e7f69d14653e881037638f2a3d9248581c2'],146396,46909,193305,16307503,850,1,1,1,13530
13d754f002de43971778bb9870c0f679eb2afb74,0,Xiaoxiang Yu,2020-06-15 18:58:11+08:00,['81821be7bebccfab2496d2ed0df8ec45bb825fbb'],1436,35,1471,16308974,7,0,0,0,13530
9c91a14dea2b0b90e29042c62143e4fc824e8dbc,0,Xiaoxiang Yu,2020-06-15 18:58:11+08:00,['13d754f002de43971778bb9870c0f679eb2afb74'],1,9,10,16308984,1,1,1,1,13530
8a5ea1fe537a6f0557d08b21e8df1cec60ce4da3,0,Xiaoxiang Yu,2020-06-15 18:58:11+08:00,['9c91a14dea2b0b90e29042c62143e4fc824e8dbc'],20,65,85,16309069,8,1,1,1,13531
8b3047fc91e1a7ea69f3465d8a362b5823743fc6,0,Xiaoxiang Yu,2020-06-15 18:58:11+08:00,['8a5ea1fe537a6f0557d08b21e8df1cec60ce4da3'],9251,14,9265,16318334,534,1,1,1,13531
dbbb5ec08a3002a434cdb54074c335c81ae08fd0,1,Xiaoxiang Yu,2020-06-15 18:58:11+08:00,['8b3047fc91e1a7ea69f3465d8a362b5823743fc6'],980,111,1091,16319425,22,0.127329193,0.121118012,0,13532
81e345d01fea78c4690d346fb0537f1cc967519c,1,Xiaoxiang Yu,2020-06-15 18:58:11+08:00,['dbbb5ec08a3002a434cdb54074c335c81ae08fd0'],80,159,239,16319664,8,0.808510638,0.808510638,0.382978723,13533
a23f8f77192846368d6eb7bddc1a292fcf10b1d2,1,Xiaoxiang Yu,2020-06-15 18:58:11+08:00,['81e345d01fea78c4690d346fb0537f1cc967519c'],2,311,313,16319977,3,0.592857143,0.5,0.8,13534
ead5deaeb9c21ba6d9b2fa966e0944e436919b15,0,Xiaoxiang Yu,2020-06-15 18:58:11+08:00,['a23f8f77192846368d6eb7bddc1a292fcf10b1d2'],4,12,16,16319993,3,1,1,1,13534
bcd26941fbd9ddeed078695f90534e80698241db,0,Xiaoxiang Yu,2020-06-15 18:58:11+08:00,['ead5deaeb9c21ba6d9b2fa966e0944e436919b15'],10,322,332,16320325,7,0.194312796,0.526066351,0.639810427,13535
0a1f4ac051fecb5923c65090a7bf7474d7f06ef2,0,Xiaoxiang Yu,2020-06-15 18:58:11+08:00,['bcd26941fbd9ddeed078695f90534e80698241db'],50,117,167,16320492,14,0.807692308,0,0.807692308,13536
6ddd16aa84f67bfec1d2505d59f30b2d01339da3,1,Xiaoxiang Yu,2020-06-15 18:58:11+08:00,['0a1f4ac051fecb5923c65090a7bf7474d7f06ef2'],30,48,78,16320570,10,0.764705882,0.941176471,1,13536
83416ed0902acc1de038dc807d896272e3ac7d5e,1,Xiaoxiang Yu,2020-06-15 18:58:11+08:00,['6ddd16aa84f67bfec1d2505d59f30b2d01339da3'],250,34,284,16320854,9,0.183673469,0,0.142857143,13537
33bdceaa234191cef68dd579b08d812da8e73e5d,0,Xiaoxiang Yu,2020-06-15 18:58:11+08:00,['83416ed0902acc1de038dc807d896272e3ac7d5e'],70,53,123,16320977,26,1,1,1,13537
8f35de108e7db3028840c583e3cb746b737ce24f,0,Xiaoxiang Yu,2020-06-15 18:58:11+08:00,['33bdceaa234191cef68dd579b08d812da8e73e5d'],0,469,469,16321446,7,0.645348837,0.744186047,1,13544
ec659ee47c9de30aecb73208164f65cb0fb1ada2,1,Xiaoxiang Yu,2020-06-15 18:58:11+08:00,['8f35de108e7db3028840c583e3cb746b737ce24f'],826,623,1449,16322895,31,0.117647059,0.843137255,0.970588235,13548
a293b5d94b5ad0a16190fdf6c3c51959b5d33496,0,Xiaoxiang Yu,2020-06-15 18:58:11+08:00,['ec659ee47c9de30aecb73208164f65cb0fb1ada2'],24,44,68,16322963,6,1,1,1,13548
2b0d32cc75c2c58d6367a1ee61d57f136f7de98a,1,Xiaoxiang Yu,2020-06-15 18:58:11+08:00,['a293b5d94b5ad0a16190fdf6c3c51959b5d33496'],5,13,18,16322981,2,0,1,0,13548
a2ac245fa5ab94bca450049386a73dac8eff4bbd,0,Xiaoxiang Yu,2020-06-15 18:58:11+08:00,['2b0d32cc75c2c58d6367a1ee61d57f136f7de98a'],1,1,2,16322983,1,,,,13548
2086b2e734a2804b000ebbf8d41595b74fa115fb,0,Xiaoxiang Yu,2020-06-15 18:58:11+08:00,['a2ac245fa5ab94bca450049386a73dac8eff4bbd'],373,329,702,16323685,29,0.5,0,0,13549
f57cf3780954446343ddde38f33dc1e4b7176fd5,0,Xiaoxiang Yu,2020-06-15 18:58:11+08:00,['2086b2e734a2804b000ebbf8d41595b74fa115fb'],0,91,91,16323776,1,0.212121212,1,1,13550
f9985010409cbe7337cdc78470b4185ffe1cdf37,0,Xiaoxiang Yu,2020-06-15 18:58:11+08:00,['f57cf3780954446343ddde38f33dc1e4b7176fd5'],0,488,488,16324264,4,0.421800948,0.763033175,0.843601896,13554
ad2418d867cba070e8505f9f692f990bf301d04a,1,Xiaoxiang Yu,2020-06-15 18:58:11+08:00,['f9985010409cbe7337cdc78470b4185ffe1cdf37'],0,598,598,16324862,5,0.36900369,1,0.328413284,13559
30f78f7ae7145ebbaf461164a039aa0d998e475f,1,Xiaoxiang Yu,2020-06-15 18:58:11+08:00,['ad2418d867cba070e8505f9f692f990bf301d04a'],763,497,1260,16326122,22,1,0.3828125,0.9375,13561
17042030c4507f5d83e4c379940256d7a62fe328,0,Xiaoxiang Yu,2020-06-15 18:58:11+08:00,['30f78f7ae7145ebbaf461164a039aa0d998e475f'],1,1,2,16326124,1,,,,13561
a89cd0310722fcf69fee943d0ed7e9ed826c7351,0,Xiaoxiang Yu,2020-06-15 18:58:11+08:00,['17042030c4507f5d83e4c379940256d7a62fe328'],97,66,163,16326287,7,0,0,1,13561
f1e2e9d84c491093e0b1dbbfb0c86dc6d9fce769,0,Xiaoxiang Yu,2020-06-15 18:58:11+08:00,['a89cd0310722fcf69fee943d0ed7e9ed826c7351'],34,45,79,16326366,3,0,1,0,13561
72feb2726300a9dbcc2cb131573455cbdb9b9a5b,0,Xiaoxiang Yu,2020-06-15 18:58:11+08:00,['f1e2e9d84c491093e0b1dbbfb0c86dc6d9fce769'],1,2,3,16326369,1,,,,13561
87201a2813892a8c8ad581b1665aa7e04d17e734,0,Xiaoxiang Yu,2020-06-15 18:58:11+08:00,['72feb2726300a9dbcc2cb131573455cbdb9b9a5b'],19,23,42,16326411,3,,,,13561
45e78d0f19736aa7aa92090439c2b618b64e7841,0,Xiaoxiang Yu,2020-06-15 18:58:11+08:00,['87201a2813892a8c8ad581b1665aa7e04d17e734'],236,16,252,16326663,7,0.5,1,0.75,13561
06a92a1aecc2076b9a5570e0b922a0ac2463c617,1,Xiaoxiang Yu,2020-06-15 18:58:11+08:00,['45e78d0f19736aa7aa92090439c2b618b64e7841'],307,278,585,16327248,89,,,,13562
167c277ae7d09432764a93b8284cfdad92f8dcf0,0,Xiaoxiang Yu,2020-06-15 18:58:11+08:00,['06a92a1aecc2076b9a5570e0b922a0ac2463c617'],17,28,45,16327293,4,1,1,1,13562
4eee5877b53ddefab06f782e77bc894cefdf9de7,0,Xiaoxiang Yu,2020-06-15 18:58:11+08:00,['167c277ae7d09432764a93b8284cfdad92f8dcf0'],3,11,14,16327307,3,,,,13562
ad2886338f7487de3a41dada2db722fd8f90ebd8,0,Xiaoxiang Yu,2020-06-15 18:58:11+08:00,['4eee5877b53ddefab06f782e77bc894cefdf9de7'],4,4,8,16327315,2,,,,13562
8e89f931f41ef08ceea5a610b6b10b9a1f4b7ae2,0,Xiaoxiang Yu,2020-06-15 18:58:11+08:00,['ad2886338f7487de3a41dada2db722fd8f90ebd8'],0,945,945,16328260,13,0.828746177,1,0.93883792,13575
2bc169dde4c713608e886f8bb8de37b096378e0b,1,Xiaoxiang Yu,2020-06-15 18:58:11+08:00,['8e89f931f41ef08ceea5a610b6b10b9a1f4b7ae2'],1,1972,1973,16330233,12,0.414838036,0.841170324,0.833855799,13586
27bd9d814cb1f90c520ae300f735a57c3235be22,1,Xiaoxiang Yu,2020-06-15 18:58:11+08:00,['2bc169dde4c713608e886f8bb8de37b096378e0b'],27,1171,1198,16331431,13,0.600790514,0.693675889,0.709486166,13596
1e4481f458c5014e2ae18a7fbd50ba651224a7a5,1,Xiaoxiang Yu,2020-06-15 18:58:11+08:00,['27bd9d814cb1f90c520ae300f735a57c3235be22'],0,814,814,16332245,3,0.186206897,0.186206897,0.487931034,13598
1b2bb248c48d41c359c71a3d260f4d3acd63960c,1,Xiaoxiang Yu,2020-06-15 18:58:11+08:00,['1e4481f458c5014e2ae18a7fbd50ba651224a7a5'],304,2434,2738,16334983,54,0.235004916,0.335299902,0.819075713,13621
da2ad5e28e2da32a069cb020e5c0e931013a96e0,0,Xiaoxiang Yu,2020-06-15 18:58:11+08:00,['1b2bb248c48d41c359c71a3d260f4d3acd63960c'],24,56,80,16335063,4,0.714285714,0.714285714,1,13621
5315466087fe9be34650a0cf8cacadfbca41ae19,1,Xiaoxiang Yu,2020-06-15 18:58:11+08:00,['da2ad5e28e2da32a069cb020e5c0e931013a96e0'],12,2669,2681,16337744,19,0.495804196,0.853146853,0.71048951,13633
dc5896a4522e1af0ab499b5dbc16273107108f71,1,Xiaoxiang Yu,2020-06-15 18:58:11+08:00,['5315466087fe9be34650a0cf8cacadfbca41ae19'],126,88,214,16337958,15,0,0,0,13633
fe378f91e32adb833e44740b1822dde566937da7,1,Xiaoxiang Yu,2020-06-15 18:58:11+08:00,['dc5896a4522e1af0ab499b5dbc16273107108f71'],212,313,525,16338483,23,1,0.043478261,1,13636
82574edb833ec55b2ae18c6662f5429c51d3716e,0,Xiaoxiang Yu,2020-06-15 18:58:11+08:00,['fe378f91e32adb833e44740b1822dde566937da7'],74,63,137,16338620,15,0.538461538,0.461538462,0,13636
e21f0c393ac0dd28055f9ba6ae4323746bee4433,0,Xiaoxiang Yu,2020-06-15 18:58:11+08:00,['82574edb833ec55b2ae18c6662f5429c51d3716e'],2,2,4,16338624,2,,,,13636
a838f4c766b09ffc753bd55173635b25e61169f3,1,Xiaoxiang Yu,2020-06-15 18:58:11+08:00,['e21f0c393ac0dd28055f9ba6ae4323746bee4433'],271,210,481,16339105,13,0,0.5,0.5,13636
2f5d3f6a28c50c9e96864cc291f2350570ea3886,0,Xiaoxiang Yu,2020-06-15 18:58:11+08:00,['a838f4c766b09ffc753bd55173635b25e61169f3'],1,1,2,16339107,1,,,,13636
6bb802e5f156e41f76d0374c8bc9dd41662863b0,0,Xiaoxiang Yu,2020-06-15 18:58:11+08:00,['2f5d3f6a28c50c9e96864cc291f2350570ea3886'],2,8,10,16339117,2,,,,13636
61c348b3720569c939b74589189bf0f7059fbd6f,0,Xiaoxiang Yu,2020-06-15 18:58:11+08:00,['6bb802e5f156e41f76d0374c8bc9dd41662863b0'],147,77,224,16339341,6,1,0,0.041666667,13636
c7a4db69b5491c35295cf0f9d0ceed8ddb69b79d,0,Xiaoxiang Yu,2020-06-15 18:58:11+08:00,['61c348b3720569c939b74589189bf0f7059fbd6f'],40,60,100,16339441,20,0,0.476190476,0.761904762,13636
73f19ba42986ab5f3bc08cb9fdc8db20253c5082,0,Xiaoxiang Yu,2020-06-15 18:58:11+08:00,['c7a4db69b5491c35295cf0f9d0ceed8ddb69b79d'],20,39,59,16339500,7,0,0.052631579,1,13636
15b6717b66426648c2fe7e259c92d42dbe959309,0,Xiaoxiang Yu,2020-06-15 18:58:11+08:00,['73f19ba42986ab5f3bc08cb9fdc8db20253c5082'],59,38,97,16339597,7,0,1,1,13636
f0d12a738106ce32e709686de9b7e0bab120baad,0,Xiaoxiang Yu,2020-06-15 18:58:11+08:00,['15b6717b66426648c2fe7e259c92d42dbe959309'],24,99,123,16339720,9,0.074074074,0.111111111,0.814814815,13636
7c2ffc3c2f207245771b5cdf71829eae411d2ae0,1,Xiaoxiang Yu,2020-06-15 18:58:11+08:00,['f0d12a738106ce32e709686de9b7e0bab120baad'],56,82,138,16339858,8,0.285714286,0.476190476,0.80952381,13636
4329c80edef1de1f6b226687458c9fa385a0125e,1,Xiaoxiang Yu,2020-06-15 18:58:11+08:00,['7c2ffc3c2f207245771b5cdf71829eae411d2ae0'],163,524,687,16340545,9,0.196374622,0.634441088,0.332326284,13638
eebb4ccbe9df8a9abf3e21ce41e634c721560804,0,Xiaoxiang Yu,2020-06-15 18:58:11+08:00,['4329c80edef1de1f6b226687458c9fa385a0125e'],0,1,1,16340546,1,1,1,1,13638
2be4329f5268242adbcac4b01a2c2432119679fb,0,Xiaoxiang Yu,2020-06-15 18:58:11+08:00,['eebb4ccbe9df8a9abf3e21ce41e634c721560804'],1,589,590,16341136,8,0.518272425,0.88372093,0.77076412,13644
733f63275692f5563f624f65383793dc6b121ecc,0,Xiaoxiang Yu,2020-06-15 18:58:11+08:00,['2be4329f5268242adbcac4b01a2c2432119679fb'],53,196,249,16341385,12,0.014084507,0,0.521126761,13644
4ec017578b16128bebb0eae9031935b41af1d215,1,Xiaoxiang Yu,2020-06-15 18:58:11+08:00,['733f63275692f5563f624f65383793dc6b121ecc'],2,7,9,16341394,2,0,1,0,13644
c4a47d7cc542aaf6074c48077c3dc36de50da707,0,Xiaoxiang Yu,2020-06-15 18:58:11+08:00,['4ec017578b16128bebb0eae9031935b41af1d215'],4,9,13,16341407,2,1,1,1,13644
5c55895b400409b28615dc61991e03ac1ae3766a,0,Xiaoxiang Yu,2020-06-15 18:58:11+08:00,['c4a47d7cc542aaf6074c48077c3dc36de50da707'],985,715,1700,16343107,53,1,0,0,13644
73aa89addb8952d503ea5c8228bf4f099b354f57,1,Xiaoxiang Yu,2020-06-15 18:58:11+08:00,['5c55895b400409b28615dc61991e03ac1ae3766a'],55,519,574,16343681,20,0.524271845,0.776699029,0.517799353,13645
91cbc07959e9784cb9cb333cf5273443144c151f,1,Xiaoxiang Yu,2020-06-15 18:58:11+08:00,['73aa89addb8952d503ea5c8228bf4f099b354f57'],51,20,71,16343752,4,0,1,1,13645
aca4b805a29eedb63ec7c7b183409983c1cc880b,0,Xiaoxiang Yu,2020-06-15 18:58:11+08:00,['91cbc07959e9784cb9cb333cf5273443144c151f'],3382,0,3382,16347134,54,,,,13645
0cf976c9a3795ec1c4e11e1eee3a84614b7bb4f5,1,Xiaoxiang Yu,2020-06-15 18:58:11+08:00,['aca4b805a29eedb63ec7c7b183409983c1cc880b'],14,373,387,16347521,3,0.399038462,1,0.908653846,13646
62a0beff4242af8f10deb37aa18d1b5a9f2e6761,0,Xiaoxiang Yu,2020-06-15 18:58:11+08:00,['0cf976c9a3795ec1c4e11e1eee3a84614b7bb4f5'],114,147,261,16347782,6,1,1,1,13646
99af9f79e6b11a40d0770339d97b462ff7dd4785,0,Xiaoxiang Yu,2020-06-15 18:58:11+08:00,['62a0beff4242af8f10deb37aa18d1b5a9f2e6761'],1,1,2,16347784,1,,,,13646
7372bfcd1cc10a8f7dadb6be1565650b0b591f8b,1,Xiaoxiang Yu,2020-06-15 18:58:11+08:00,['99af9f79e6b11a40d0770339d97b462ff7dd4785'],46,48,94,16347878,15,1,1,0,13646
2f815b0d92d4d6eefde2c3452cf870eb81116a4a,0,Xiaoxiang Yu,2020-06-15 18:58:11+08:00,['7372bfcd1cc10a8f7dadb6be1565650b0b591f8b'],168,171,339,16348217,21,0.291139241,0.291139241,0,13646
c2464a3b18d19ff3444b79ea64970b89e6a20670,0,Xiaoxiang Yu,2020-06-15 18:58:11+08:00,['2f815b0d92d4d6eefde2c3452cf870eb81116a4a'],85,5,90,16348307,2,,,,13646
5838569c3b1d46b7099641cd66e837d0171ba304,0,Xiaoxiang Yu,2020-06-15 18:58:11+08:00,['c2464a3b18d19ff3444b79ea64970b89e6a20670'],25,52,77,16348384,3,,,,13646
488f408e8dbc01d3818a2a5895d339e36545dab5,0,Xiaoxiang Yu,2020-06-15 18:58:11+08:00,['5838569c3b1d46b7099641cd66e837d0171ba304'],113,165,278,16348662,8,,,,13646
bcea991cd9714d94bea45dc4030516b6eb74cef5,0,Xiaoxiang Yu,2020-06-15 18:58:11+08:00,['488f408e8dbc01d3818a2a5895d339e36545dab5'],0,3,3,16348665,1,0,1,1,13646
40a13eb319d3406d83c29ffc02d8c22c3e0c59be,0,Xiaoxiang Yu,2020-06-15 18:58:11+08:00,['bcea991cd9714d94bea45dc4030516b6eb74cef5'],0,5,5,16348670,1,,,,13646
4674d00fb03b39daa1eb7c2652e03396c5e6df20,1,Xiaoxiang Yu,2020-06-15 18:58:11+08:00,['40a13eb319d3406d83c29ffc02d8c22c3e0c59be'],1,1,2,16348672,1,,,,13646
c350b6a5d89d9899967d2ad87fedad57b54b9ac4,0,Xiaoxiang Yu,2020-06-15 18:58:11+08:00,['4674d00fb03b39daa1eb7c2652e03396c5e6df20'],37,119,156,16348828,3,0,0.080645161,0.85483871,13646
714876e277484cdbb57027132deb89c669fa2164,0,Xiaoxiang Yu,2020-06-15 18:58:11+08:00,['c350b6a5d89d9899967d2ad87fedad57b54b9ac4'],2,19,21,16348849,1,0.714285714,1,1,13646
014f03c642d1ded37ea0a930f62d84d52f7e8285,0,Xiaoxiang Yu,2020-06-15 18:58:11+08:00,['714876e277484cdbb57027132deb89c669fa2164'],1,1,2,16348851,1,,,,13646
ac688922760a696ccc5cba225b0a76a59ff451d5,0,Xiaoxiang Yu,2020-06-15 18:58:11+08:00,['014f03c642d1ded37ea0a930f62d84d52f7e8285'],1,30,31,16348882,2,1,1,1,13646
27984e7bd35027a10a62bf877c6121962d0ca66b,0,Xiaoxiang Yu,2020-06-15 18:58:11+08:00,['ac688922760a696ccc5cba225b0a76a59ff451d5'],4,4,8,16348890,2,,,,13646
55bc6da633ee7d82c26fc1b51d0420e3e681660e,0,Xiaoxiang Yu,2020-06-15 18:58:11+08:00,['27984e7bd35027a10a62bf877c6121962d0ca66b'],0,22,22,16348912,1,0.75,0.75,1,13646
fe7a56f60ffc7160ccaa06643a2380a975813b50,0,Xiaoxiang Yu,2020-06-15 18:58:11+08:00,['55bc6da633ee7d82c26fc1b51d0420e3e681660e'],1,1,2,16348914,1,,,,13646
ca867dc56233aacbd07608f098eed9a1bfe51067,0,Xiaoxiang Yu,2020-06-15 18:58:11+08:00,['fe7a56f60ffc7160ccaa06643a2380a975813b50'],2,2,4,16348918,1,,,,13646
11ce0ce5b7e36982197cf7850f03cbe4f795b9ff,0,Xiaoxiang Yu,2020-06-15 18:58:11+08:00,['ca867dc56233aacbd07608f098eed9a1bfe51067'],2,43,45,16348963,3,0.972222222,1,0.972222222,13646
b010f3b9bfb1fdbaef3711dc08ae89fe81b6c864,0,Xiaoxiang Yu,2020-06-15 18:58:11+08:00,['11ce0ce5b7e36982197cf7850f03cbe4f795b9ff'],4,31,35,16348998,4,0.88,1,0.96,13646
6b6d4c10b35b1f46c9deaa73ac02c54a9c4c9108,0,Xiaoxiang Yu,2020-06-15 18:58:11+08:00,['b010f3b9bfb1fdbaef3711dc08ae89fe81b6c864'],1,7,8,16349006,1,,,,13646
0a3505499ac9d1f9a31a12ebc9acdc4b2969aac1,0,Xiaoxiang Yu,2020-06-15 18:58:11+08:00,['6b6d4c10b35b1f46c9deaa73ac02c54a9c4c9108'],5,110,115,16349121,4,,,,13647
6c77ca9f7e1e27933a47d6c2aea64dd607e6a760,0,Xiaoxiang Yu,2020-06-15 18:58:11+08:00,['0a3505499ac9d1f9a31a12ebc9acdc4b2969aac1'],0,37,37,16349158,3,0.214285714,0.214285714,1,13647
c6624182ba716158c443b18c7eae3dc3c9d06d13,0,Xiaoxiang Yu,2020-06-15 18:58:11+08:00,['6c77ca9f7e1e27933a47d6c2aea64dd607e6a760'],0,68,68,16349226,6,0.319148936,0.936170213,1,13647
b52003000a4fb399dcb619b63052ebbdc7d59b75,0,Xiaoxiang Yu,2020-06-15 18:58:11+08:00,['c6624182ba716158c443b18c7eae3dc3c9d06d13'],1,34,35,16349261,3,0.96969697,1,0.96969697,13647
57313de793a5951f10ce6862ba258736f438b52e,0,Xiaoxiang Yu,2020-06-15 18:58:11+08:00,['b52003000a4fb399dcb619b63052ebbdc7d59b75'],15,21,36,16349297,3,0,0,1,13647
a8efa10a3755a9b62f17e873176a646fe303c000,1,Xiaoxiang Yu,2020-06-15 18:58:11+08:00,['57313de793a5951f10ce6862ba258736f438b52e'],25,22,47,16349344,11,1,1,1,13647
2aa437e9b1e964fdd945bb814b8d6df38cc4d8bf,0,Xiaoxiang Yu,2020-06-15 18:58:11+08:00,['a8efa10a3755a9b62f17e873176a646fe303c000'],8,14,22,16349366,1,0,0,1,13647
c4d55b6501104f76923c4ea3f11fd95e52f6e92d,0,Xiaoxiang Yu,2020-06-15 18:58:11+08:00,['2aa437e9b1e964fdd945bb814b8d6df38cc4d8bf'],1,6,7,16349373,1,0,0,1,13647
0cb852a27f926772db334d8c5888fe8078e4beb0,0,Xiaoxiang Yu,2020-06-15 18:58:11+08:00,['c4d55b6501104f76923c4ea3f11fd95e52f6e92d'],1,1,2,16349375,1,,,,13647
52f873764ff5d1f0cc7ece526fcbc671cd982c69,0,Xiaoxiang Yu,2020-06-15 18:58:11+08:00,['0cb852a27f926772db334d8c5888fe8078e4beb0'],0,1,1,16349376,1,,,,13647
d200edd34f07420176843bba90f2de4c63edc28c,0,Xiaoxiang Yu,2020-06-15 18:58:11+08:00,['52f873764ff5d1f0cc7ece526fcbc671cd982c69'],1,1,2,16349378,1,,,,13647
a5a07660afc1eac76177e40d37006e4dad07a61d,0,Xiaoxiang Yu,2020-06-15 18:58:11+08:00,['d200edd34f07420176843bba90f2de4c63edc28c'],1,576,577,16349955,7,0.257879656,0.730659026,0.730659026,13648
3b0d01dd6d6fda4e492abf49a87b051bff657893,0,Xiaoxiang Yu,2020-06-15 18:58:11+08:00,['a5a07660afc1eac76177e40d37006e4dad07a61d'],2,2,4,16349959,2,,,,13648
e51e514c83f7e631b66c93c06ce7303cfc779888,0,Xiaoxiang Yu,2020-06-15 18:58:11+08:00,['3b0d01dd6d6fda4e492abf49a87b051bff657893'],15,19,34,16349993,1,0.333333333,1,0.333333333,13648
98304b49d8e5794635aaafacab50fc03ab90e3a2,0,Xiaoxiang Yu,2020-06-15 18:58:11+08:00,['e51e514c83f7e631b66c93c06ce7303cfc779888'],0,4,4,16349997,1,0,0,0,13648
067f013e7d43768af7b17055c3b1117368c4d611,0,Xiaoxiang Yu,2020-06-15 18:58:11+08:00,['98304b49d8e5794635aaafacab50fc03ab90e3a2'],0,12,12,16350009,1,0,0,1,13648
c25f721c50b3ee7699307de54e7f707acecee7ca,0,Xiaoxiang Yu,2020-06-15 18:58:11+08:00,['067f013e7d43768af7b17055c3b1117368c4d611'],37,95,132,16350141,5,0,1,0.75,13648
985b83b60cb9284699c97fa2d8636dbdae9088ec,0,Xiaoxiang Yu,2020-06-15 18:58:11+08:00,['c25f721c50b3ee7699307de54e7f707acecee7ca'],14,91,105,16350246,4,0,0.090909091,1,13648
8e11e4a43941f29bc5caaf77074625b9d87f050b,0,Xiaoxiang Yu,2020-06-15 18:58:11+08:00,['985b83b60cb9284699c97fa2d8636dbdae9088ec'],3,6,9,16350255,1,0,0,0,13648
1d7ed609e401fc55bed0fedb7e000e04113b1626,0,Xiaoxiang Yu,2020-06-15 18:58:11+08:00,['8e11e4a43941f29bc5caaf77074625b9d87f050b'],18,17,35,16350290,1,1,0,1,13648
a2b323a023e3816c290cde29ad84dfe00d28ed41,0,Xiaoxiang Yu,2020-06-15 18:58:11+08:00,['1d7ed609e401fc55bed0fedb7e000e04113b1626'],12,427,439,16350729,8,0.418300654,0.552287582,0.934640523,13649
fda0e10f5ee7f58785b923805f48dd02bd6ae6c6,0,Xiaoxiang Yu,2020-06-15 18:58:11+08:00,['a2b323a023e3816c290cde29ad84dfe00d28ed41'],134,525,659,16351388,29,0,0.641509434,0.485849057,13649
e7c36bd87078bf54b85850e1a128478b5505966b,0,Xiaoxiang Yu,2020-06-15 18:58:11+08:00,['fda0e10f5ee7f58785b923805f48dd02bd6ae6c6'],1,0,1,16351389,1,0,0,0,13649
1b75f2df48e856a49dc710c9d1973035e97918a5,0,Xiaoxiang Yu,2020-06-15 18:58:11+08:00,['e7c36bd87078bf54b85850e1a128478b5505966b'],1,5,6,16351395,2,0.75,0.75,1,13649
5bbb4c0ca5b124be08692a8bf0b386e723497337,0,Xiaoxiang Yu,2020-06-15 18:58:11+08:00,['1b75f2df48e856a49dc710c9d1973035e97918a5'],4,3,7,16351402,2,,,,13649
7e1ee4b42f759792ccb2b00631ec1e2f52d54e79,0,Xiaoxiang Yu,2020-06-15 18:58:11+08:00,['5bbb4c0ca5b124be08692a8bf0b386e723497337'],2,2,4,16351406,1,,,,13649
a8b6a2cabf6b2df365293011b9e80edd12df8784,0,Xiaoxiang Yu,2020-06-15 18:58:11+08:00,['7e1ee4b42f759792ccb2b00631ec1e2f52d54e79'],2,11,13,16351419,1,,,,13649
5196f75bffb6a5cbd3097eb1efda39fa5be515df,0,Xiaoxiang Yu,2020-06-15 18:58:11+08:00,['a8b6a2cabf6b2df365293011b9e80edd12df8784'],34,241,275,16351694,3,0.014388489,0.935251799,1,13650
ac960cbac3f597e6df07ba34b38dbd0b57587756,0,Xiaoxiang Yu,2020-06-15 18:58:11+08:00,['5196f75bffb6a5cbd3097eb1efda39fa5be515df'],3,30,33,16351727,2,0,0.909090909,0.909090909,13650
2aead276615a2af70307bd2cc5d78825642794fb,0,Xiaoxiang Yu,2020-06-15 18:58:11+08:00,['ac960cbac3f597e6df07ba34b38dbd0b57587756'],15,17,32,16351759,1,0,0,1,13650
faff746c2345b9f718933314f1a47aae85aed947,0,Xiaoxiang Yu,2020-06-15 18:58:11+08:00,['2aead276615a2af70307bd2cc5d78825642794fb'],0,7,7,16351766,1,0,1,1,13650
8d1f02bbed5023b4249b38037fb1019d86743105,0,Xiaoxiang Yu,2020-06-15 18:58:11+08:00,['faff746c2345b9f718933314f1a47aae85aed947'],6,57,63,16351829,1,0.46875,1,0.46875,13650
067729f49142266a37a01315051f63c1603f0741,0,Xiaoxiang Yu,2020-06-15 18:58:11+08:00,['8d1f02bbed5023b4249b38037fb1019d86743105'],0,61,61,16351890,1,0.25,1,1,13651
37d7f463bcfb1600417775b406dd3513be4e0ac6,0,Xiaoxiang Yu,2020-06-15 18:58:11+08:00,['067729f49142266a37a01315051f63c1603f0741'],6,82,88,16351978,2,0.857142857,1,1,13651
60fae8ca936b4424bf35b028233f71b2bece8979,0,Xiaoxiang Yu,2020-06-15 18:58:11+08:00,['37d7f463bcfb1600417775b406dd3513be4e0ac6'],5,8,13,16351991,4,,,1,13651
2f464c3e83a50f8c8222cf1075fdf0a2fd34ba47,0,Xiaoxiang Yu,2020-06-15 18:58:11+08:00,['60fae8ca936b4424bf35b028233f71b2bece8979'],2,10,12,16352003,1,0,0,1,13651
afe8eacfd60b8c936b526ce7ae8a2836c52a2884,1,Xiaoxiang Yu,2020-06-15 18:58:11+08:00,['2f464c3e83a50f8c8222cf1075fdf0a2fd34ba47'],18,119,137,16352140,5,0.636363636,0.295454545,0.727272727,13652
3367caab0676cbcc0c0b38748c4bfc8e1eba1894,0,Xiaoxiang Yu,2020-06-15 18:58:11+08:00,['afe8eacfd60b8c936b526ce7ae8a2836c52a2884'],2,35,37,16352177,3,,,,13652
c5cf048395ccd7f3be7a067ebddb53bc131130b5,0,Xiaoxiang Yu,2020-06-15 18:58:11+08:00,['3367caab0676cbcc0c0b38748c4bfc8e1eba1894'],3,6,9,16352186,1,,,,13652
9c465fe75cb15cedcffd051e70d49e667a3d4eba,0,Xiaoxiang Yu,2020-06-15 18:58:11+08:00,['c5cf048395ccd7f3be7a067ebddb53bc131130b5'],10,17,27,16352213,1,0,0,1,13652
2728e4771a8e4b9d5075d9430e1489ff227f96fe,0,Xiaoxiang Yu,2020-06-15 18:58:11+08:00,['9c465fe75cb15cedcffd051e70d49e667a3d4eba'],1,1,2,16352215,1,,,,13652
5c06ea2fb1aca265e9ed3899614c4062db1324fa,0,Xiaoxiang Yu,2020-06-15 18:58:11+08:00,['2728e4771a8e4b9d5075d9430e1489ff227f96fe'],1,7,8,16352223,1,1,1,1,13652
558ab4e691daabf15735fcf77b43523b44b24321,0,Xiaoxiang Yu,2020-06-15 18:58:11+08:00,['5c06ea2fb1aca265e9ed3899614c4062db1324fa'],2,2,4,16352227,1,,,,13652
ff6b5abe201115390d0395ec1057af4ee9b73f8a,0,Xiaoxiang Yu,2020-06-15 18:58:11+08:00,['558ab4e691daabf15735fcf77b43523b44b24321'],20,20,40,16352267,19,,,,13652
5056f44a95f7a4b33139a182cdbbd4ffd435735d,0,Xiaoxiang Yu,2020-06-15 18:58:11+08:00,['ff6b5abe201115390d0395ec1057af4ee9b73f8a'],11,16,27,16352294,2,1,1,1,13652
c18586280a3ef368bbeaeb7add1907098111dce3,0,Xiaoxiang Yu,2020-06-15 18:58:11+08:00,['5056f44a95f7a4b33139a182cdbbd4ffd435735d'],0,141,141,16352435,6,1,1,0.872340426,13654
7054d0562c5b835a4739c27a3273352bee0f4b22,0,Xiaoxiang Yu,2020-06-15 18:58:11+08:00,['c18586280a3ef368bbeaeb7add1907098111dce3'],2,2,4,16352439,1,,,,13654
8350653e28a822a9af960166f76c8ebd6d750b10,0,Xiaoxiang Yu,2020-06-15 18:58:11+08:00,['7054d0562c5b835a4739c27a3273352bee0f4b22'],0,1,1,16352440,1,1,1,1,13654
eb9f62fb96e3eb462175f4e71b51045194c463cc,0,Xiaoxiang Yu,2020-06-15 18:58:11+08:00,['8350653e28a822a9af960166f76c8ebd6d750b10'],8,7,15,16352455,1,,,,13654
3eafc56d58808afb556a4ab1aea6882f246f561a,1,Xiaoxiang Yu,2020-06-15 18:58:11+08:00,['eb9f62fb96e3eb462175f4e71b51045194c463cc'],5,46,51,16352506,2,0,0.833333333,0.833333333,13654
821589f63b525c26c711866b60cc8aa90879fe7e,0,Xiaoxiang Yu,2020-06-15 18:58:11+08:00,['3eafc56d58808afb556a4ab1aea6882f246f561a'],16,312,328,16352834,11,0.69047619,0.984126984,0.952380952,13657
83217fd2d699ee22e24412f46741fa75663750c8,0,Xiaoxiang Yu,2020-06-15 18:58:11+08:00,['821589f63b525c26c711866b60cc8aa90879fe7e'],183,203,386,16353220,26,1,1,0,13657
8d3c7f32abf7b45210050e799fbe9b1138d0b8aa,0,Xiaoxiang Yu,2020-06-15 18:58:11+08:00,['83217fd2d699ee22e24412f46741fa75663750c8'],0,343,343,16353563,4,,,,13660
bb3f186fac3fa7969e690551721bd4cf179d417d,0,Xiaoxiang Yu,2020-06-15 18:58:11+08:00,['8d3c7f32abf7b45210050e799fbe9b1138d0b8aa'],1,22,23,16353586,4,,,,13660
c053e90e71505815b3fbc6c8603e4c02b0e624cc,1,Xiaoxiang Yu,2020-06-15 18:58:11+08:00,['bb3f186fac3fa7969e690551721bd4cf179d417d'],0,634,634,16354220,3,0.50728863,0.810495627,0.655976676,13662
a9bcef8e01c31cb056b3068e08b9dc7290973d26,0,Xiaoxiang Yu,2020-06-15 18:58:11+08:00,['c053e90e71505815b3fbc6c8603e4c02b0e624cc'],0,638,638,16354858,4,0.343085106,0.449468085,0.920212766,13665
d866ba9dbc516e936fb0a3e36c068b8e74f0b78e,0,Xiaoxiang Yu,2020-06-15 18:58:11+08:00,['a9bcef8e01c31cb056b3068e08b9dc7290973d26'],0,54,54,16354912,2,,,,13666
34b5cbe95687b3da2ac1bbf756f81a47e3815feb,0,Xiaoxiang Yu,2020-06-15 18:58:11+08:00,['d866ba9dbc516e936fb0a3e36c068b8e74f0b78e'],1,1,2,16354914,1,,,,13666
31f8be641c53f6c2b7b586200a0571fd0d07e7ac,1,Xiaoxiang Yu,2020-06-15 18:58:11+08:00,['34b5cbe95687b3da2ac1bbf756f81a47e3815feb'],0,309,309,16355223,1,0.402597403,0.402597403,0.915584416,13667
e4143b29c9b08c4d54274c8c382db93e4285c941,0,Xiaoxiang Yu,2020-06-15 18:58:11+08:00,['31f8be641c53f6c2b7b586200a0571fd0d07e7ac'],0,15,15,16355238,2,,,,13667
96ba199e69e46e57127d624ea51cba7cc80213e8,0,Xiaoxiang Yu,2020-06-15 18:58:11+08:00,['e4143b29c9b08c4d54274c8c382db93e4285c941'],0,48,48,16355286,1,0,1,1,13668
9f3d62347b01828a9e777842e65bbd45e085f1cd,0,Xiaoxiang Yu,2020-06-15 18:58:11+08:00,['96ba199e69e46e57127d624ea51cba7cc80213e8'],0,202,202,16355488,2,0.302325581,1,0.558139535,13670
fd31bad6a15c263d470f55ff8fe5620107ca8e5f,0,Xiaoxiang Yu,2020-06-15 18:58:11+08:00,['9f3d62347b01828a9e777842e65bbd45e085f1cd'],0,99,99,16355587,3,1,1,1,13671
cf0ef3ea67b9c4f4bd8cb55e9f00fd247e7d0061,0,Xiaoxiang Yu,2020-06-15 18:58:11+08:00,['fd31bad6a15c263d470f55ff8fe5620107ca8e5f'],0,106,106,16355693,3,0.12195122,1,1,13672
35bf9c631393892baf863370b24eecb5f1e0e936,0,Xiaoxiang Yu,2020-06-15 18:58:11+08:00,['cf0ef3ea67b9c4f4bd8cb55e9f00fd247e7d0061'],25,320,345,16356038,3,0.267605634,0.5,0.929577465,13673
468c1bd441d67f5428f8095803e91203c1b5fb92,0,Xiaoxiang Yu,2020-06-15 18:58:11+08:00,['35bf9c631393892baf863370b24eecb5f1e0e936'],1,8,9,16356047,1,,,,13673
c58a22d754c9c688093c7ec174bcf2d0a3879239,0,Xiaoxiang Yu,2020-06-15 18:58:11+08:00,['468c1bd441d67f5428f8095803e91203c1b5fb92'],1,12,13,16356060,1,,,,13673
ab92818e3e06d1b6eee34f55a7c734d32d12e65f,0,Xiaoxiang Yu,2020-06-15 18:58:11+08:00,['c58a22d754c9c688093c7ec174bcf2d0a3879239'],0,126,126,16356186,1,0.073529412,0.073529412,1,13674
1fbd6eb1365080408c496fa617c396fe0837e740,1,Xiaoxiang Yu,2020-06-15 18:58:11+08:00,['ab92818e3e06d1b6eee34f55a7c734d32d12e65f'],7,5,12,16356198,4,1,0,1,13674
7576ebfc786a2011ebf88113511884530b3d30d5,0,Xiaoxiang Yu,2020-06-15 18:58:11+08:00,['1fbd6eb1365080408c496fa617c396fe0837e740'],6,7,13,16356211,1,,,,13674
81555e5bf3029b7b6e04cba0f5c65f957a98ae29,0,Xiaoxiang Yu,2020-06-15 18:58:11+08:00,['7576ebfc786a2011ebf88113511884530b3d30d5'],0,65,65,16356276,3,0.826086957,0.826086957,0.173913043,13675
e51da66da35ecec281447a3faea63d33cc26eca9,0,Xiaoxiang Yu,2020-06-15 18:58:11+08:00,['81555e5bf3029b7b6e04cba0f5c65f957a98ae29'],39,59,98,16356374,7,0,0,1,13675
c2875ee22f391653e6316d4fbefce7b4355d60fe,0,Xiaoxiang Yu,2020-06-15 18:58:11+08:00,['e51da66da35ecec281447a3faea63d33cc26eca9'],39,26,65,16356439,5,0.166666667,0.75,0,13675
ec6524076cfd20f520e39e8bfa17cde28a7c8789,0,Xiaoxiang Yu,2020-06-15 18:58:11+08:00,['c2875ee22f391653e6316d4fbefce7b4355d60fe'],1,4,5,16356444,1,0,1,0,13675
e0f470d7b6f12a8c94bbcefb4b8778662a969059,1,Xiaoxiang Yu,2020-06-15 18:58:11+08:00,['ec6524076cfd20f520e39e8bfa17cde28a7c8789'],8,6,14,16356458,1,1,1,0,13675
1fcafdecd3e67e9885944f085d2440516ab0b591,0,Xiaoxiang Yu,2020-06-15 18:58:11+08:00,['e0f470d7b6f12a8c94bbcefb4b8778662a969059'],5,86,91,16356549,1,1,1,0.826923077,13675
a5cbe95bf90f4d01a80f266c3cf7695c14a39d6c,1,Xiaoxiang Yu,2020-06-15 18:58:11+08:00,['1fcafdecd3e67e9885944f085d2440516ab0b591'],4,111,115,16356664,1,0.476923077,1,0.815384615,13675
6d4a075ceab0b688f98d9319581d13bbec02530c,0,Xiaoxiang Yu,2020-06-15 18:58:11+08:00,['a5cbe95bf90f4d01a80f266c3cf7695c14a39d6c'],1,8,9,16356673,4,,,,13675
5c362f2745e4285d9060682c74fc3ea752a48094,0,Xiaoxiang Yu,2020-06-15 18:58:11+08:00,['6d4a075ceab0b688f98d9319581d13bbec02530c'],1,1,2,16356675,1,,,,13675
2ff1822de17bb8beac8f766df5ed9e8235319200,0,Xiaoxiang Yu,2020-06-15 18:58:11+08:00,['5c362f2745e4285d9060682c74fc3ea752a48094'],32,35,67,16356742,4,,,,13675
3288e477394a5f951156d88b5c07c522dd08f846,0,Xiaoxiang Yu,2020-06-15 18:58:11+08:00,['2ff1822de17bb8beac8f766df5ed9e8235319200'],7,7,14,16356756,3,,,0,13675
466bb6c348a6138f8e19007f2ad0657c37614062,0,Xiaoxiang Yu,2020-06-15 18:58:11+08:00,['3288e477394a5f951156d88b5c07c522dd08f846'],2,10,12,16356768,2,0,0,1,13675
feb0baea938c7a0f2e59a0894a70d4fb673b0850,0,Xiaoxiang Yu,2020-06-15 18:58:11+08:00,['466bb6c348a6138f8e19007f2ad0657c37614062'],2,26,28,16356796,2,0,0,1,13675
402f03335cdc13ef8eb7023557e7d075478e933f,0,Xiaoxiang Yu,2020-06-15 18:58:11+08:00,['feb0baea938c7a0f2e59a0894a70d4fb673b0850'],20,27,47,16356843,1,0,0,1,13675
6f69cacab0932d5f4360f464da3212f175ebf3f0,1,Xiaoxiang Yu,2020-06-15 18:58:11+08:00,['402f03335cdc13ef8eb7023557e7d075478e933f'],6,120,126,16356969,8,0.482758621,0,1,13676
3d1d0bcd928b94ce851e1a320d029410a99e583d,1,Xiaoxiang Yu,2020-06-15 18:58:11+08:00,['6f69cacab0932d5f4360f464da3212f175ebf3f0'],10,697,707,16357676,14,0.980582524,0.844660194,0.922330097,13680
49f49dcd0dbb452de807de2569703fe512324847,0,Xiaoxiang Yu,2020-06-15 18:58:11+08:00,['3d1d0bcd928b94ce851e1a320d029410a99e583d'],0,5,5,16357681,1,1,1,1,13680
4c2174a5aea54c9679944e2e678207eb71b58dd8,0,Xiaoxiang Yu,2020-06-15 18:58:11+08:00,['49f49dcd0dbb452de807de2569703fe512324847'],2,0,2,16357683,1,,,,13680
795be05352cc6f612a91a5d52fc940d07590cdbf,0,Xiaoxiang Yu,2020-06-15 18:58:11+08:00,['4c2174a5aea54c9679944e2e678207eb71b58dd8'],4,27,31,16357714,7,0.333333333,0.466666667,0.933333333,13680
c49e7d98be48591bd97af1a22b2c8d48c0d5807b,0,Xiaoxiang Yu,2020-06-15 18:58:11+08:00,['795be05352cc6f612a91a5d52fc940d07590cdbf'],2,15,17,16357731,4,0.666666667,1,1,13680
2fa2acc433c6d508f9a73e30377b21774ef287fc,0,Xiaoxiang Yu,2020-06-15 18:58:11+08:00,['c49e7d98be48591bd97af1a22b2c8d48c0d5807b'],121,124,245,16357976,1,0,0,1,13680
ead858d32fd36b71448cdd74975911669fb7de0e,0,Xiaoxiang Yu,2020-06-15 18:58:11+08:00,['2fa2acc433c6d508f9a73e30377b21774ef287fc'],1,25,26,16358002,4,0.6875,0.8125,1,13680
357ec589786b304c19ad02889f4f3ab31c5ee1ae,0,Xiaoxiang Yu,2020-06-15 18:58:11+08:00,['ead858d32fd36b71448cdd74975911669fb7de0e'],7,13,20,16358022,2,1,0.8,1,13680
02d591d8ba735b78a9bd370c2c213866b30bce2e,0,Xiaoxiang Yu,2020-06-15 18:58:11+08:00,['357ec589786b304c19ad02889f4f3ab31c5ee1ae'],5,3,8,16358030,1,1,1,0,13680
2687e0924cdbdaaa8567c63a5c1772e884cb7fc9,0,Xiaoxiang Yu,2020-06-15 18:58:11+08:00,['02d591d8ba735b78a9bd370c2c213866b30bce2e'],7,16,23,16358053,1,0,0,0,13680
fb854239da6de72839d359cf2878b9bd9c5b711d,1,Xiaoxiang Yu,2020-06-15 18:58:11+08:00,['2687e0924cdbdaaa8567c63a5c1772e884cb7fc9'],3,388,391,16358444,7,0.291079812,0.666666667,0.971830986,13681
393c1f385e3603418d43e57d72f1d603b76f2c9b,1,Xiaoxiang Yu,2020-06-15 18:58:11+08:00,['fb854239da6de72839d359cf2878b9bd9c5b711d'],6,254,260,16358704,7,0.266666667,0.725,0.691666667,13683
4d0d25705b678bdfc713081ea07af901a02b0ab1,1,Xiaoxiang Yu,2020-06-15 18:58:11+08:00,['393c1f385e3603418d43e57d72f1d603b76f2c9b'],100,241,341,16359045,7,0.724137931,1,0.712643678,13684
4904fb74a55923087bc8a3ed17e9753eef777d76,0,Xiaoxiang Yu,2020-06-15 18:58:11+08:00,['4d0d25705b678bdfc713081ea07af901a02b0ab1'],4,7,11,16359056,2,1,1,0,13684
e35f7f01ebc055f33941037229695d73e7c2d2d3,0,Xiaoxiang Yu,2020-06-15 18:58:11+08:00,['4904fb74a55923087bc8a3ed17e9753eef777d76'],12,19,31,16359087,2,0,0,1,13684
f68a2ff91aa223a591e48d2982235d700b09d5a2,0,Xiaoxiang Yu,2020-06-15 18:58:11+08:00,['e35f7f01ebc055f33941037229695d73e7c2d2d3'],58,81,139,16359226,3,0,0.260869565,0.47826087,13684
fe074ee6a86725ceeb8b05fcf83149270ac2cdd0,0,Xiaoxiang Yu,2020-06-15 18:58:11+08:00,['f68a2ff91aa223a591e48d2982235d700b09d5a2'],0,11,11,16359237,3,,,,13684
042a1081894709a95b2416670798e86e8f246770,0,Xiaoxiang Yu,2020-06-15 18:58:11+08:00,['fe074ee6a86725ceeb8b05fcf83149270ac2cdd0'],19,23,42,16359279,3,1,1,1,13684
082a5b40bab2c27787a8297efec9013dc25b94fb,0,Xiaoxiang Yu,2020-06-15 18:58:11+08:00,['042a1081894709a95b2416670798e86e8f246770'],1,1,2,16359281,1,,,,13684
0312041ea6f8d963475b8d41f7dc6f414fe66bef,0,Xiaoxiang Yu,2020-06-15 18:58:11+08:00,['082a5b40bab2c27787a8297efec9013dc25b94fb'],1,15,16,16359297,2,0.909090909,1,0.909090909,13684
fc80358109b69a24e23314f650b0faa6a418c24c,0,Xiaoxiang Yu,2020-06-15 18:58:11+08:00,['0312041ea6f8d963475b8d41f7dc6f414fe66bef'],0,5,5,16359302,1,0,1,1,13684
c686d5992d573969ce77c153a32d371fa9ba151f,0,Xiaoxiang Yu,2020-06-15 18:58:11+08:00,['fc80358109b69a24e23314f650b0faa6a418c24c'],17,33,50,16359352,1,0.666666667,0.666666667,1,13684
df027d2e71384b34b55864573212c7a2f7ba5665,0,Xiaoxiang Yu,2020-06-15 18:58:11+08:00,['c686d5992d573969ce77c153a32d371fa9ba151f'],2,12,14,16359366,2,0,0.666666667,0,13684
c66b8b17fcc0b5d502d4a401cdccdd503c0f3c51,0,Xiaoxiang Yu,2020-06-15 18:58:11+08:00,['df027d2e71384b34b55864573212c7a2f7ba5665'],1,1,2,16359368,1,,,,13684
bfacd994805cf571588493e7d2b16eae22e703d3,0,Xiaoxiang Yu,2020-06-15 18:58:11+08:00,['c66b8b17fcc0b5d502d4a401cdccdd503c0f3c51'],8,10,18,16359386,2,1,1,1,13684
9c01dd3eb5058cca1f64a4c92287f5b30e789e26,0,Xiaoxiang Yu,2020-06-15 18:58:11+08:00,['bfacd994805cf571588493e7d2b16eae22e703d3'],0,17,17,16359403,1,1,1,1,13684
9def975f818d84482f43ef6e49b5f04c8e74e99d,0,Xiaoxiang Yu,2020-06-15 18:58:11+08:00,['9c01dd3eb5058cca1f64a4c92287f5b30e789e26'],48,58,106,16359509,3,0,0,0,13684
51520230ed442f77d04ac0fc830d6721d81a1db0,0,Xiaoxiang Yu,2020-06-15 18:58:11+08:00,['9def975f818d84482f43ef6e49b5f04c8e74e99d'],39,99,138,16359647,6,1,1,1,13685
d8057b35b656f004384ca760a1d384dd7435af9f,0,Xiaoxiang Yu,2020-06-15 18:58:11+08:00,['51520230ed442f77d04ac0fc830d6721d81a1db0'],2,3,5,16359652,1,,,,13685
1636fa4435aa5e1f4d7c29dbf36f29ebe20a42c1,0,Xiaoxiang Yu,2020-06-15 18:58:11+08:00,['d8057b35b656f004384ca760a1d384dd7435af9f'],35,337,372,16360024,7,1,1,1,13685
de0cfbb637ec988074c74b782f99799176d691c6,0,Xiaoxiang Yu,2020-06-15 18:58:11+08:00,['1636fa4435aa5e1f4d7c29dbf36f29ebe20a42c1'],82,90,172,16360196,4,0.2,0.8,0.4,13685
184de90e7a25525b1fc92dbb839a85efafa88a18,0,Xiaoxiang Yu,2020-06-15 18:58:11+08:00,['de0cfbb637ec988074c74b782f99799176d691c6'],14,8,22,16360218,5,,,,13685
c73ac33115be29f61cfcf0830e4ab9c82466c538,0,Xiaoxiang Yu,2020-06-15 18:58:11+08:00,['184de90e7a25525b1fc92dbb839a85efafa88a18'],1,1,2,16360220,1,,,,13685
e879008bf6b50ff42736451a941ca240ecd631ff,1,Xiaoxiang Yu,2020-06-15 18:58:11+08:00,['c73ac33115be29f61cfcf0830e4ab9c82466c538'],31,53,84,16360304,1,0,0.875,0.875,13685
5167dfc66f5bb0ed93c897ececf7698df9c492ae,0,Xiaoxiang Yu,2020-06-15 18:58:11+08:00,['e879008bf6b50ff42736451a941ca240ecd631ff'],0,1,1,16360305,1,1,1,1,13685
38141f6cd78a1400655e9390bf3860da7853a251,0,Xiaoxiang Yu,2020-06-15 18:58:11+08:00,['5167dfc66f5bb0ed93c897ececf7698df9c492ae'],11,13,24,16360329,1,0,1,1,13685
f51de1b9cc4f8d7c532a44fe93947442a6c8185a,0,Xiaoxiang Yu,2020-06-15 18:58:11+08:00,['38141f6cd78a1400655e9390bf3860da7853a251'],1,2,3,16360332,1,,,,13685
8d6a6d89997e51a3a3ff21561b242e55cc75f530,0,Xiaoxiang Yu,2020-06-15 18:58:11+08:00,['f51de1b9cc4f8d7c532a44fe93947442a6c8185a'],2,2,4,16360336,1,,,,13685
0c347e7eeb4e693161677228493b0c8021d04db2,0,Xiaoxiang Yu,2020-06-15 18:58:11+08:00,['8d6a6d89997e51a3a3ff21561b242e55cc75f530'],2,2,4,16360340,2,,,,13685
e7346213287b0d88e173dc414b7211fa2490fcde,0,Xiaoxiang Yu,2020-06-15 18:58:11+08:00,['0c347e7eeb4e693161677228493b0c8021d04db2'],1,1,2,16360342,1,,,,13685
a0b0aa6d0f80f23313b7f0e3a7725b8827aa3e05,0,Xiaoxiang Yu,2020-06-15 18:58:11+08:00,['e7346213287b0d88e173dc414b7211fa2490fcde'],10,0,10,16360352,1,0.5,0,0,13685
f64019095e4985da1709303a7363ac6d3f658e08,0,Xiaoxiang Yu,2020-06-15 18:58:11+08:00,['a0b0aa6d0f80f23313b7f0e3a7725b8827aa3e05'],7,14,21,16360373,3,0.5,0.5,0.5,13685
5a10f20dcd725a55fa1761a0488cbeeacd7b14bc,0,Xiaoxiang Yu,2020-06-15 18:58:11+08:00,['f64019095e4985da1709303a7363ac6d3f658e08'],37,54,91,16360464,2,1,1,1,13685
4275c5233ecb10f5f5a8b85f25bc1b01aaf24c93,1,Xiaoxiang Yu,2020-06-15 18:58:11+08:00,['5a10f20dcd725a55fa1761a0488cbeeacd7b14bc'],5,14,19,16360483,1,0,1,1,13685
0660cede84dba10566f348606dfc8d0d9e04cd76,1,Xiaoxiang Yu,2020-06-15 18:58:11+08:00,['4275c5233ecb10f5f5a8b85f25bc1b01aaf24c93'],4,51,55,16360538,2,0,1,1,13685
898719414382054dc9f25965b441af79a0b5ee41,0,Xiaoxiang Yu,2020-06-15 18:58:11+08:00,['0660cede84dba10566f348606dfc8d0d9e04cd76'],2,2,4,16360542,1,,,,13685
6e42b173d25b54ab147ecd84df964277bb4a94ef,0,Xiaoxiang Yu,2020-06-15 18:58:11+08:00,['898719414382054dc9f25965b441af79a0b5ee41'],0,1,1,16360543,1,1,1,1,13685
78adff4e0f3b009b83df532dd75211bc992719dc,0,Xiaoxiang Yu,2020-06-15 18:58:11+08:00,['6e42b173d25b54ab147ecd84df964277bb4a94ef'],1,6,7,16360550,1,1,1,1,13685
1ff3ce8d0e29ca1d9d1ebc17ab21ee6ab548041e,0,Xiaoxiang Yu,2020-06-15 18:58:11+08:00,['78adff4e0f3b009b83df532dd75211bc992719dc'],120,147,267,16360817,2,0,0.15,1,13685
f2a59e447e10c3b3c70af29b01ceba7fba3b99c6,0,Xiaoxiang Yu,2020-06-15 18:58:11+08:00,['1ff3ce8d0e29ca1d9d1ebc17ab21ee6ab548041e'],0,1,1,16360818,1,1,1,1,13685
8c6a74b704baab15612a417adf7461a58a5dd6d1,0,Xiaoxiang Yu,2020-06-15 18:58:11+08:00,['f2a59e447e10c3b3c70af29b01ceba7fba3b99c6'],0,171,171,16360989,4,0.511627907,1,1,13688
6bef250be12d43d5f07d3b9d17585464e21885aa,0,Xiaoxiang Yu,2020-06-15 18:58:11+08:00,['8c6a74b704baab15612a417adf7461a58a5dd6d1'],1,5,6,16360995,2,0,1,1,13688
590177a853fbd357756a1004c016fd2c7765de4c,0,Xiaoxiang Yu,2020-06-15 18:58:11+08:00,['6bef250be12d43d5f07d3b9d17585464e21885aa'],49,121,170,16361165,7,0.240740741,0.203703704,0.833333333,13688
7d0abb126e528b4b795fde1b9c10325308fb455c,0,Xiaoxiang Yu,2020-06-15 18:58:11+08:00,['590177a853fbd357756a1004c016fd2c7765de4c'],33,33,66,16361231,33,,,,13688
ce000fda5bc550b83241489818a2ce9dd657470e,0,Xiaoxiang Yu,2020-06-15 18:58:11+08:00,['7d0abb126e528b4b795fde1b9c10325308fb455c'],9,42,51,16361282,2,0,1,1,13688
b1be18c6ba421183df4e6aaa44ff7c95ad7c25d1,0,Xiaoxiang Yu,2020-06-15 18:58:11+08:00,['ce000fda5bc550b83241489818a2ce9dd657470e'],0,6,6,16361288,1,0,1,1,13688
fe6100979ec9b1dd36923ad8a2a0c11f909cea0b,0,Xiaoxiang Yu,2020-06-15 18:58:11+08:00,['b1be18c6ba421183df4e6aaa44ff7c95ad7c25d1'],121,49,170,16361458,7,0.759259259,0.796296296,0.166666667,13688
8f4b2ba3e465cd3f8800b05d3cc3c68dbba4144d,0,Xiaoxiang Yu,2020-06-15 18:58:11+08:00,['fe6100979ec9b1dd36923ad8a2a0c11f909cea0b'],6,6,12,16361470,3,,,,13688
4374519d555d58eadd95a29da02b2a8d0b84505e,0,Xiaoxiang Yu,2020-06-15 18:58:11+08:00,['8f4b2ba3e465cd3f8800b05d3cc3c68dbba4144d'],13,10,23,16361493,4,1,1,,13688
e113cad3726510abc6b4da56a8c7f848477d13bd,0,Xiaoxiang Yu,2020-06-15 18:58:11+08:00,['4374519d555d58eadd95a29da02b2a8d0b84505e'],38,78,116,16361609,4,0,0.516129032,0.032258065,13688
158636d972f63de75b63ee5fd7da094406170804,0,Xiaoxiang Yu,2020-06-15 18:58:11+08:00,['e113cad3726510abc6b4da56a8c7f848477d13bd'],23,45,68,16361677,3,0,0,0.777777778,13688
5882cb944a90a14a1f9a6d61a939020b19d9140a,0,Xiaoxiang Yu,2020-06-15 18:58:11+08:00,['158636d972f63de75b63ee5fd7da094406170804'],16,17,33,16361710,1,0,,,13688
cce90456d987337ad1847e542df8a132a15a61ab,0,Xiaoxiang Yu,2020-06-15 18:58:11+08:00,['5882cb944a90a14a1f9a6d61a939020b19d9140a'],4,5,9,16361719,2,1,1,1,13688
73aa4f92ac15dddc9eada04aab411a8c517bad77,0,Xiaoxiang Yu,2020-06-15 18:58:11+08:00,['cce90456d987337ad1847e542df8a132a15a61ab'],0,1,1,16361720,1,,,,13688
cb7c654b65e8b4db571fb94e17bcdbb155a84f4f,0,Xiaoxiang Yu,2020-06-15 18:58:11+08:00,['73aa4f92ac15dddc9eada04aab411a8c517bad77'],2,10,12,16361732,1,1,1,1,13688
5f72032b28e1472d2cb4110bd2d45da8f4e5d8ad,0,Xiaoxiang Yu,2020-06-15 18:58:11+08:00,['cb7c654b65e8b4db571fb94e17bcdbb155a84f4f'],83,96,179,16361911,4,1,1,1,13688
3dac03425c8005c1eb4d9650cd6c8e595933cf4b,0,Xiaoxiang Yu,2020-06-15 18:58:11+08:00,['5f72032b28e1472d2cb4110bd2d45da8f4e5d8ad'],7,27,34,16361945,2,0.85,0.85,1,13688
4b87fd10a2b6556321a011246db555eafcb2afe2,0,Xiaoxiang Yu,2020-06-15 18:58:11+08:00,['3dac03425c8005c1eb4d9650cd6c8e595933cf4b'],14,14,28,16361973,1,0.5,0.5,0,13688
309ae5e085478709cc4b81b28fee25a9b0ace39b,0,Xiaoxiang Yu,2020-06-15 18:58:11+08:00,['4b87fd10a2b6556321a011246db555eafcb2afe2'],0,1,1,16361974,1,0,0,1,13688
64856effd7219f33764d82771deb7177958698c4,0,Xiaoxiang Yu,2020-06-15 18:58:11+08:00,['309ae5e085478709cc4b81b28fee25a9b0ace39b'],0,2,2,16361976,1,0,0,0,13688
f2a33a59f50232a37dbc9fbe08a8f396ef2e99d4,1,Xiaoxiang Yu,2020-06-15 18:58:11+08:00,['64856effd7219f33764d82771deb7177958698c4'],0,17,17,16361993,2,0.428571429,0.428571429,1,13688
fc971a933f28361702627d4699a165b983cceddb,0,Xiaoxiang Yu,2020-06-15 18:58:11+08:00,['f2a33a59f50232a37dbc9fbe08a8f396ef2e99d4'],2,42,44,16362037,3,0.962962963,1,1,13688
5b111ed6e796fb9149dcc07f20feaed75ddb38a7,0,Xiaoxiang Yu,2020-06-15 18:58:11+08:00,['fc971a933f28361702627d4699a165b983cceddb'],0,1,1,16362038,1,1,1,1,13688
2f6e7aeba7c2a5aad3b57aa0965215dee11096f0,0,Xiaoxiang Yu,2020-06-15 18:58:11+08:00,['5b111ed6e796fb9149dcc07f20feaed75ddb38a7'],0,22,22,16362060,1,0,0,1,13688
521f1fc04002271da4e6c1f32630d8d7308912c7,0,Xiaoxiang Yu,2020-06-15 18:58:11+08:00,['2f6e7aeba7c2a5aad3b57aa0965215dee11096f0'],0,19,19,16362079,1,1,1,1,13688
a599814641584fa060453b4c865a1a2c1f5666ec,0,Xiaoxiang Yu,2020-06-15 18:58:11+08:00,['521f1fc04002271da4e6c1f32630d8d7308912c7'],42,63,105,16362184,1,0,0,1,13688
64f916929a9dd4cb2881d3da56a3bec78af32049,0,Xiaoxiang Yu,2020-06-15 18:58:11+08:00,['a599814641584fa060453b4c865a1a2c1f5666ec'],1,12,13,16362197,3,0,0,1,13688
1d46e2a3db2acc3c43360427ce7d1799dd8a8f4a,0,Xiaoxiang Yu,2020-06-15 18:58:11+08:00,['64f916929a9dd4cb2881d3da56a3bec78af32049'],63,42,105,16362302,1,1,1,0,13688
560c26509face3ace693d4cc5e845461c74fbd37,0,Xiaoxiang Yu,2020-06-15 18:58:11+08:00,['1d46e2a3db2acc3c43360427ce7d1799dd8a8f4a'],0,1,1,16362303,1,0,0,1,13688
73aee330ea5918da321cbed2e80d1512ef5e8873,0,Xiaoxiang Yu,2020-06-15 18:58:11+08:00,['560c26509face3ace693d4cc5e845461c74fbd37'],2,3,5,16362308,2,1,0,0,13688
0e00841cc2fc0361fc5e5504502ac5fe953fd4cf,0,Xiaoxiang Yu,2020-06-15 18:58:11+08:00,['73aee330ea5918da321cbed2e80d1512ef5e8873'],1,1,2,16362310,1,,,,13688
85fbaa3819e54bec4646c114c42b6842156ab68f,0,Xiaoxiang Yu,2020-06-15 18:58:11+08:00,['0e00841cc2fc0361fc5e5504502ac5fe953fd4cf'],1,1,2,16362312,1,,,,13688
962fefa0726b1366eb6b26acbaefb1d7f20d6c11,0,Xiaoxiang Yu,2020-06-15 18:58:11+08:00,['85fbaa3819e54bec4646c114c42b6842156ab68f'],1,199,200,16362512,7,0.357142857,0.542857143,0.714285714,13688
fbcb9e86a34e2344645c7861018975a869f045f4,0,Xiaoxiang Yu,2020-06-15 18:58:11+08:00,['962fefa0726b1366eb6b26acbaefb1d7f20d6c11'],52,243,295,16362807,9,0.403508772,0.403508772,0.438596491,13692
09305d1bc5d4ccd08c998222c14dd8792ec8fbbe,0,Xiaoxiang Yu,2020-06-15 18:58:11+08:00,['fbcb9e86a34e2344645c7861018975a869f045f4'],4,18,22,16362829,2,0,0,1,13692
87f7ee206a744420354b68dcdd6e2456c67e8f81,0,Xiaoxiang Yu,2020-06-15 18:58:11+08:00,['09305d1bc5d4ccd08c998222c14dd8792ec8fbbe'],2,2,4,16362833,2,,,,13692
18bab976f3a513aae6fa3df734607f416eae5738,0,Xiaoxiang Yu,2020-06-15 18:58:11+08:00,['87f7ee206a744420354b68dcdd6e2456c67e8f81'],84,119,203,16363036,18,0.529411765,0.676470588,0.647058824,13692
775a003042af94af59a510f420d62958938460df,0,Xiaoxiang Yu,2020-06-15 18:58:11+08:00,['18bab976f3a513aae6fa3df734607f416eae5738'],5,1,6,16363042,2,,,,13692
e1da3aa357748b5d8822271408e4cd8bdb073a1f,0,Xiaoxiang Yu,2020-06-15 18:58:11+08:00,['775a003042af94af59a510f420d62958938460df'],3,4,7,16363049,1,1,1,1,13692
c9760365c2dbd66d4e87eb5ce856cbdba070ed42,0,Xiaoxiang Yu,2020-06-15 18:58:11+08:00,['e1da3aa357748b5d8822271408e4cd8bdb073a1f'],18,27,45,16363094,7,1,1,0.333333333,13692
25cd62a66e7d8d6cacbf600cacb32ce316f62fbb,0,Xiaoxiang Yu,2020-06-15 18:58:11+08:00,['c9760365c2dbd66d4e87eb5ce856cbdba070ed42'],0,4,4,16363098,1,1,1,1,13692
fd56bbfcf2e30db1f88b5b68ebb74d41b10b06e9,0,Xiaoxiang Yu,2020-06-15 18:58:11+08:00,['25cd62a66e7d8d6cacbf600cacb32ce316f62fbb'],13,278,291,16363389,8,0.320895522,0.432835821,0.708955224,13693
db81a67067d06b354b29d554b2378fb2a9a6b28e,0,Xiaoxiang Yu,2020-06-15 18:58:11+08:00,['fd56bbfcf2e30db1f88b5b68ebb74d41b10b06e9'],7,0,7,16363396,1,0,0,0,13693
57825ef384718e32ea6ab4853880b6ce7a537d24,0,Xiaoxiang Yu,2020-06-15 18:58:11+08:00,['db81a67067d06b354b29d554b2378fb2a9a6b28e'],0,6,6,16363402,1,1,1,1,13693
bda32a81c8798ccecd99e453026b472438d8a1a9,0,Xiaoxiang Yu,2020-06-15 18:58:11+08:00,['57825ef384718e32ea6ab4853880b6ce7a537d24'],16,57,73,16363475,2,0.733333333,0,1,13693
683fcf3b055cd27c10a1fe302e64a8a8438ef678,0,Xiaoxiang Yu,2020-06-15 18:58:11+08:00,['bda32a81c8798ccecd99e453026b472438d8a1a9'],1,1,2,16363477,1,,,,13693
b181e18455602ac54e95bf1f0bb25b549d00281b,0,Xiaoxiang Yu,2020-06-15 18:58:11+08:00,['683fcf3b055cd27c10a1fe302e64a8a8438ef678'],37,49,86,16363563,3,0,1,0.8,13693
f979bc7c48d45826443983c89da7f43a3566dde4,0,Xiaoxiang Yu,2020-06-15 18:58:11+08:00,['b181e18455602ac54e95bf1f0bb25b549d00281b'],1,1,2,16363565,1,,,,13693
ad0e17ec91185c5f610c4ef1dab815f478d05ba7,0,Xiaoxiang Yu,2020-06-15 18:58:11+08:00,['f979bc7c48d45826443983c89da7f43a3566dde4'],2,3,5,16363570,1,,,,13693
974654b30b0a2088cde78362966808865549198c,0,Xiaoxiang Yu,2020-06-15 18:58:11+08:00,['ad0e17ec91185c5f610c4ef1dab815f478d05ba7'],3,3,6,16363576,2,,,,13693
9df1c526989934ffbf24115a4b1c8cef1dffe00a,0,Xiaoxiang Yu,2020-06-15 18:58:11+08:00,['974654b30b0a2088cde78362966808865549198c'],2,10,12,16363588,2,0.428571429,1,1,13693
59ae0bdf3222a8c3d6943e9c2b9df38946e9682b,0,Xiaoxiang Yu,2020-06-15 18:58:11+08:00,['9df1c526989934ffbf24115a4b1c8cef1dffe00a'],294,505,799,16364387,34,0.50862069,0.870689655,0.646551724,13695
9b355b162496e1bd24245e576f8a6d49c8fee48a,0,Xiaoxiang Yu,2020-06-15 18:58:11+08:00,['59ae0bdf3222a8c3d6943e9c2b9df38946e9682b'],4,13,17,16364404,3,0,0,1,13695
f322f83177053ad471883de93545b57f3002583e,0,Xiaoxiang Yu,2020-06-15 18:58:11+08:00,['9b355b162496e1bd24245e576f8a6d49c8fee48a'],4,25,29,16364433,3,,,,13695
0849ddb91eb3009f887a9674ef4fb93303da3166,0,Xiaoxiang Yu,2020-06-15 18:58:11+08:00,['f322f83177053ad471883de93545b57f3002583e'],256,322,578,16365011,8,,,,13698
fa369dae7fe908bf4228648ddff6771f83b8d1f4,0,Xiaoxiang Yu,2020-06-15 18:58:11+08:00,['0849ddb91eb3009f887a9674ef4fb93303da3166'],2,12,14,16365025,1,0,0,1,13698
5c331e10f6e9f284833b2745cb0a397232d9daa1,0,Xiaoxiang Yu,2020-06-15 18:58:11+08:00,['fa369dae7fe908bf4228648ddff6771f83b8d1f4'],4,33,37,16365062,3,1,1,1,13699
9709da42deb30a95e692b3b82b875fac7747d1aa,0,Xiaoxiang Yu,2020-06-15 18:58:11+08:00,['5c331e10f6e9f284833b2745cb0a397232d9daa1'],1,3,4,16365066,1,0,1,1,13699
4cc49ae9672b048ca53b70a9ca9253668a795b44,0,Xiaoxiang Yu,2020-06-15 18:58:11+08:00,['9709da42deb30a95e692b3b82b875fac7747d1aa'],7,6,13,16365079,2,,,,13699
a88a9ef54610f94a853dc1b976c5637c5bf9e81f,0,Xiaoxiang Yu,2020-06-15 18:58:11+08:00,['4cc49ae9672b048ca53b70a9ca9253668a795b44'],9,159,168,16365247,5,,,,13701
b9be241d68f3c74defd10d3b7b409a970a2ca66f,0,Xiaoxiang Yu,2020-06-15 18:58:11+08:00,['a88a9ef54610f94a853dc1b976c5637c5bf9e81f'],24,54,78,16365325,1,1,1,1,13701
f7a10dabd60e953c1caab3d35397c496f55d408b,0,Xiaoxiang Yu,2020-06-15 18:58:11+08:00,['b9be241d68f3c74defd10d3b7b409a970a2ca66f'],0,6,6,16365331,1,,,,13701
cb25fd76e6bbf3588b6ae9f90b0efe7db1bae4cb,0,Xiaoxiang Yu,2020-06-15 18:58:11+08:00,['f7a10dabd60e953c1caab3d35397c496f55d408b'],1,1,2,16365333,1,,,,13701
0c520d9842d42d11ce4d63a17452b7ee6202afd3,0,Xiaoxiang Yu,2020-06-15 18:58:11+08:00,['cb25fd76e6bbf3588b6ae9f90b0efe7db1bae4cb'],0,1,1,16365334,1,,,,13701
dc2b4f313ba81ca56a84db3f4116ccb96262aad5,0,Xiaoxiang Yu,2020-06-15 18:58:11+08:00,['0c520d9842d42d11ce4d63a17452b7ee6202afd3'],12,13,25,16365359,1,,,,13701
82249d70359e6288b22894d28e762ce029d3ca1a,0,Xiaoxiang Yu,2020-06-15 18:58:11+08:00,['dc2b4f313ba81ca56a84db3f4116ccb96262aad5'],3,34,37,16365396,3,0.884615385,0.923076923,0.423076923,13701
4cae8c5909801bd05439e5d7f72160246f4f1a3d,1,Xiaoxiang Yu,2020-06-15 18:58:11+08:00,['82249d70359e6288b22894d28e762ce029d3ca1a'],7,33,40,16365436,1,,,,13701
6dfd0bba8e9d448f36f786c5d8595646b7dfc949,0,Xiaoxiang Yu,2020-06-15 18:58:11+08:00,['4cae8c5909801bd05439e5d7f72160246f4f1a3d'],24,26,50,16365486,3,0,1,1,13701
c1f973dd68f8f1d9be8c1dee87cc5206f61321ea,0,Xiaoxiang Yu,2020-06-15 18:58:11+08:00,['6dfd0bba8e9d448f36f786c5d8595646b7dfc949'],2,1,3,16365489,1,,,,13701
9689b32960dd68b217a167bb41ebc35fe5229fe1,0,Xiaoxiang Yu,2020-06-15 18:58:11+08:00,['c1f973dd68f8f1d9be8c1dee87cc5206f61321ea'],0,28,28,16365517,1,,,,13702
6898d55c7b8e34ddc60760694ce2d89b6b66ed80,1,Xiaoxiang Yu,2020-06-15 18:58:11+08:00,['9689b32960dd68b217a167bb41ebc35fe5229fe1'],5,82,87,16365604,3,0.807692308,1,1,13703
f16c85d5d5078840bb6a7d4ba596108f22b91dff,0,Xiaoxiang Yu,2020-06-15 18:58:11+08:00,['6898d55c7b8e34ddc60760694ce2d89b6b66ed80'],0,71,71,16365675,2,0.347826087,1,1,13703
96013db6b7be088c0462b91cae7e7a76a6fcb3af,1,Xiaoxiang Yu,2020-06-15 18:58:11+08:00,['f16c85d5d5078840bb6a7d4ba596108f22b91dff'],8,3,11,16365686,1,1,0,0,13703
a9cde2ed60306dadc7c45d31ed0f73fe8661b425,0,Xiaoxiang Yu,2020-06-15 18:58:11+08:00,['96013db6b7be088c0462b91cae7e7a76a6fcb3af'],2,2,4,16365690,1,0,1,1,13703
4f85224387596210cbce6af298f1313457f59a7a,0,Xiaoxiang Yu,2020-06-15 18:58:11+08:00,['a9cde2ed60306dadc7c45d31ed0f73fe8661b425'],10,16,26,16365716,1,0,0,0,13703
10923341afa953afad80d4c2206ac224ce5fafeb,1,Xiaoxiang Yu,2020-06-15 18:58:11+08:00,['4f85224387596210cbce6af298f1313457f59a7a'],179,645,824,16366540,23,0.330508475,0.576271186,1,13706
63a6763c98e3b58859e0b9858731895349fb06e9,0,Xiaoxiang Yu,2020-06-15 18:58:11+08:00,['10923341afa953afad80d4c2206ac224ce5fafeb'],1,1,2,16366542,1,,,,13706
060ef0630c0ffcd8751637f5a0c8081bacd16df4,0,Xiaoxiang Yu,2020-06-15 18:58:11+08:00,['63a6763c98e3b58859e0b9858731895349fb06e9'],3,5,8,16366550,1,0,0,0,13706
fd0c42ee426e33231dde7240b28149bab24c4dda,0,Xiaoxiang Yu,2020-06-15 18:58:11+08:00,['060ef0630c0ffcd8751637f5a0c8081bacd16df4'],0,1,1,16366551,1,,,,13706
f1402266f6e84b4c7b73d685ed6b85d608f514bf,0,Xiaoxiang Yu,2020-06-15 18:58:11+08:00,['fd0c42ee426e33231dde7240b28149bab24c4dda'],52,56,108,16366659,43,,,,13706
fd10a0963ef1bd5b17af2911f4062fea9e2ac908,0,Xiaoxiang Yu,2020-06-15 18:58:11+08:00,['f1402266f6e84b4c7b73d685ed6b85d608f514bf'],1,1,2,16366661,1,,,,13706
952407cbf604bbab85742cad7e65e05863cef006,0,Xiaoxiang Yu,2020-06-15 18:58:11+08:00,['fd10a0963ef1bd5b17af2911f4062fea9e2ac908'],4,4,8,16366669,1,,,,13706
ec6e7deb88862cf14304e950d8f08eb3081e1caf,0,Xiaoxiang Yu,2020-06-15 18:58:11+08:00,['952407cbf604bbab85742cad7e65e05863cef006'],0,4,4,16366673,1,,,,13706
4d5a234b372e3d6d3d98f6453c9684b8b6aca9e6,0,Xiaoxiang Yu,2020-06-15 18:58:11+08:00,['ec6e7deb88862cf14304e950d8f08eb3081e1caf'],2,2,4,16366677,1,,,,13706
c59d172e5ee37961bc51175be89ff8a3964f0533,1,Xiaoxiang Yu,2020-06-15 18:58:11+08:00,['4d5a234b372e3d6d3d98f6453c9684b8b6aca9e6'],1,1,2,16366679,1,,,,13706
80e88ae6bf00426010d18a2ed9102604673f3971,0,Xiaoxiang Yu,2020-06-15 18:58:11+08:00,['c59d172e5ee37961bc51175be89ff8a3964f0533'],1,1,2,16366681,1,,,,13706
1048f44f16ae14789f24229a40a2c761d8976789,1,Xiaoxiang Yu,2020-06-15 18:58:11+08:00,['80e88ae6bf00426010d18a2ed9102604673f3971'],354,437,791,16367472,12,0.058823529,0.485294118,0.852941176,13706
c3a83a9e491f5e9675b059fd46d449d63d2013a4,0,Xiaoxiang Yu,2020-06-15 18:58:11+08:00,['1048f44f16ae14789f24229a40a2c761d8976789'],19460,841,20301,16387773,217,0,0,1,13711
49509bd2420646d151b74bbca2bd8ca31a3becc1,1,Xiaoxiang Yu,2020-06-15 18:58:11+08:00,['c3a83a9e491f5e9675b059fd46d449d63d2013a4'],78,178,256,16388029,24,0,0,0.2,13714
ef68fceb2e5249a852ef2aed3905c26a6c7c92da,0,Xiaoxiang Yu,2020-06-15 18:58:11+08:00,['49509bd2420646d151b74bbca2bd8ca31a3becc1'],0,18,18,16388047,2,,,,13714
fc7fc280f9699f5faa1bc4525d7b3f4b0cb7b973,0,Xiaoxiang Yu,2020-06-15 18:58:11+08:00,['ef68fceb2e5249a852ef2aed3905c26a6c7c92da'],2,163,165,16388212,10,,,,13714
a12d96cb3c2824a58c6b4845c795001ce3de1cd8,0,Xiaoxiang Yu,2020-06-15 18:58:11+08:00,['fc7fc280f9699f5faa1bc4525d7b3f4b0cb7b973'],0,24,24,16388236,1,,,,13715
a61d213c2a2dfad2b698691b8c939765abd882e3,0,Xiaoxiang Yu,2020-06-15 18:58:11+08:00,['a12d96cb3c2824a58c6b4845c795001ce3de1cd8'],0,1270,1270,16389506,5,0.356652949,1,0.969821674,13720
005358016c9487bdbffc521d8c7c5ded258fbdf5,0,Xiaoxiang Yu,2020-06-15 18:58:11+08:00,['a61d213c2a2dfad2b698691b8c939765abd882e3'],0,229,229,16389735,5,1,1,1,13725
99df0b1e94f2ca81836cc747b0ea92a1e5c6bf4f,0,Xiaoxiang Yu,2020-06-15 18:58:11+08:00,['005358016c9487bdbffc521d8c7c5ded258fbdf5'],0,746,746,16390481,5,0.530364372,0.789473684,0.712550607,13730
5354f553bb0875d8f5df153376055f56503443ec,0,Xiaoxiang Yu,2020-06-15 18:58:11+08:00,['99df0b1e94f2ca81836cc747b0ea92a1e5c6bf4f'],0,375,375,16390856,4,0.756756757,1,1,13734
4321c2e2c963e97f2204a31d875dfd348ff8028a,0,Xiaoxiang Yu,2020-06-15 18:58:11+08:00,['5354f553bb0875d8f5df153376055f56503443ec'],0,598,598,16391454,5,0.723472669,0.961414791,0.784565916,13739
0c6df266e66773dc8f789bf458a5825ad8555c89,1,Xiaoxiang Yu,2020-06-15 18:58:11+08:00,['4321c2e2c963e97f2204a31d875dfd348ff8028a'],2770,1967,4737,16396191,49,0.66536965,0.08690013,0.230869001,13750
713b7d50fd3ae0e118fb1db1e59b6638f01a6f3e,0,Xiaoxiang Yu,2020-06-15 18:58:11+08:00,['0c6df266e66773dc8f789bf458a5825ad8555c89'],2,17,19,16396210,1,,,,13750
f341806616ec8ef03bb730dc17c7721942a9c951,0,Xiaoxiang Yu,2020-06-15 18:58:11+08:00,['713b7d50fd3ae0e118fb1db1e59b6638f01a6f3e'],18,14,32,16396242,1,,,,13750
99e96339b8888f2470d451b89de1e7e938ca9d2f,0,Xiaoxiang Yu,2020-06-15 18:58:11+08:00,['f341806616ec8ef03bb730dc17c7721942a9c951'],2,2,4,16396246,1,,,,13750
0e88d9f64dff2f5bc1fd73601522232a81107274,0,Xiaoxiang Yu,2020-06-15 18:58:11+08:00,['99e96339b8888f2470d451b89de1e7e938ca9d2f'],70,73,143,16396389,16,0,,,13750
6396252dbb57fce4783ee7707b2556dffe8d0b8b,1,Xiaoxiang Yu,2020-06-15 18:58:11+08:00,['0e88d9f64dff2f5bc1fd73601522232a81107274'],0,1050,1050,16397439,9,0.581081081,0.681467181,1,13757
bf9d2d1dcf877232c237a77427c28fc7e00060b6,1,Xiaoxiang Yu,2020-06-15 18:58:11+08:00,['6396252dbb57fce4783ee7707b2556dffe8d0b8b'],109,113,222,16397661,11,1,1,0,13757
ed42c3f4371dade74bcc90b4ce6422a12403a3c7,1,Xiaoxiang Yu,2020-06-15 18:58:11+08:00,['bf9d2d1dcf877232c237a77427c28fc7e00060b6'],46,76,122,16397783,21,0.388888889,0,0.833333333,13757
cd22a0a93ba9b3314f664fbebfad9d7aacacf8e6,0,Xiaoxiang Yu,2020-06-15 18:58:11+08:00,['ed42c3f4371dade74bcc90b4ce6422a12403a3c7'],19,2,21,16397804,2,,,,13757
7e78f2b50322f76c30fe80ccefee8d4066aae688,1,Xiaoxiang Yu,2020-06-15 18:58:11+08:00,['cd22a0a93ba9b3314f664fbebfad9d7aacacf8e6'],165,8,173,16397977,9,0,0,0,13757
958f73a3c84d22b686fa8b1983f1e0dc6a942b89,0,Xiaoxiang Yu,2020-06-15 18:58:11+08:00,['7e78f2b50322f76c30fe80ccefee8d4066aae688'],1,0,1,16397978,1,1,0,0,13757
a1fca740bff284df186b0beb84d0507d9a3ecbe8,0,Xiaoxiang Yu,2020-06-15 18:58:11+08:00,['958f73a3c84d22b686fa8b1983f1e0dc6a942b89'],3,6,9,16397987,1,,,,13757
36337aefd6018e75b0eedc90e620fb2648f8c45e,1,Xiaoxiang Yu,2020-06-15 18:58:11+08:00,['a1fca740bff284df186b0beb84d0507d9a3ecbe8'],5,31,36,16398023,2,0,1,1,13757
73fe07d5aca6a0f4cfdf0aeae31652fd7de8a883,0,Xiaoxiang Yu,2020-06-15 18:58:11+08:00,['36337aefd6018e75b0eedc90e620fb2648f8c45e'],224,60,284,16398307,7,0.848837209,0,0,13757
aebc7fac0abab5be889b6a2b03cb996edc0a691e,0,Xiaoxiang Yu,2020-06-15 18:58:11+08:00,['73fe07d5aca6a0f4cfdf0aeae31652fd7de8a883'],41,55,96,16398403,5,0.75,0.75,1,13757
34ac41191b4fda1140417f2c2f8ed23c41eaa7f6,1,Xiaoxiang Yu,2020-06-15 18:58:11+08:00,['aebc7fac0abab5be889b6a2b03cb996edc0a691e'],0,1,1,16398404,1,0,0,1,13757
b0385e2cedf2536b41643c9ce34260f5ac357c72,0,Xiaoxiang Yu,2020-06-15 18:58:11+08:00,['34ac41191b4fda1140417f2c2f8ed23c41eaa7f6'],11,15,26,16398430,7,0.166666667,0.333333333,0,13757
90391f5dd0165dd700128c69a8f6870da1c5b731,0,Xiaoxiang Yu,2020-06-15 18:58:11+08:00,['b0385e2cedf2536b41643c9ce34260f5ac357c72'],118,4,122,16398552,2,0.4,0,0.177777778,13757
48310a58dfa2bf9bff3c7e1b8c0ba758ea3a805e,0,Xiaoxiang Yu,2020-06-15 18:58:11+08:00,['90391f5dd0165dd700128c69a8f6870da1c5b731'],6,8,14,16398566,1,,,,13757
8a425b2b133a2cbc336d65ba19594d04fe276a59,0,Xiaoxiang Yu,2020-06-15 18:58:11+08:00,['48310a58dfa2bf9bff3c7e1b8c0ba758ea3a805e'],37,27,64,16398630,2,1,0.5,0.5,13757
0d06367bfb6e8cca631de69344c95f3afe4b9764,1,Xiaoxiang Yu,2020-06-15 18:58:11+08:00,['8a425b2b133a2cbc336d65ba19594d04fe276a59'],32,66,98,16398728,3,0.529411765,1,0,13758
db6650e74dd3717e5260e52a5e72274c3e00b063,1,Xiaoxiang Yu,2020-06-15 18:58:11+08:00,['0d06367bfb6e8cca631de69344c95f3afe4b9764'],1,2,3,16398731,2,0,0,1,13758
e81191e0cbd55958bd4e28ef44cefcc0a4ae64b0,0,Xiaoxiang Yu,2020-06-15 18:58:11+08:00,['db6650e74dd3717e5260e52a5e72274c3e00b063'],59,53,112,16398843,6,1,1,1,13758
243ec8ee740666070d7781a09609bef60713b82b,0,Xiaoxiang Yu,2020-06-15 18:58:11+08:00,['e81191e0cbd55958bd4e28ef44cefcc0a4ae64b0'],7,6,13,16398856,3,,,,13758
54e51a3b2a56ca7578bb553fc61f316a57bc9c26,0,Xiaoxiang Yu,2020-06-15 18:58:11+08:00,['243ec8ee740666070d7781a09609bef60713b82b'],24,24,48,16398904,2,0,1,1,13758
734a0033b19253c249ac53717b231ec85f6f2690,1,Xiaoxiang Yu,2020-06-15 18:58:11+08:00,['54e51a3b2a56ca7578bb553fc61f316a57bc9c26'],42,35,77,16398981,1,0.4,0,0.6,13758
073300f16e54d1fa058d2f2c08837092aa9a8f29,0,Xiaoxiang Yu,2020-06-15 18:58:11+08:00,['734a0033b19253c249ac53717b231ec85f6f2690'],24,40,64,16399045,2,,,,13758
2ed1d08465f8176def975a8aa1869f361763ac26,1,Xiaoxiang Yu,2020-06-15 18:58:11+08:00,['073300f16e54d1fa058d2f2c08837092aa9a8f29'],25,55,80,16399125,8,0.826086957,0.869565217,0.913043478,13758
334097e8840b45e09a097fe2205eb1ace1e071d1,0,Xiaoxiang Yu,2020-06-15 18:58:11+08:00,['2ed1d08465f8176def975a8aa1869f361763ac26'],1,6,7,16399132,1,1,1,1,13758
bdb52b3205d8281af7f96e8808bc6bb216559ae8,1,Xiaoxiang Yu,2020-06-15 18:58:11+08:00,['334097e8840b45e09a097fe2205eb1ace1e071d1'],184,16198,16382,16415514,31,0.146341463,1,0.914634146,13776
4054206a29e0f6dba419724fc30eb0eb519b1c2f,0,Xiaoxiang Yu,2020-06-15 18:58:11+08:00,['bdb52b3205d8281af7f96e8808bc6bb216559ae8'],62,197,259,16415773,18,0.71875,0.609375,0,13778
ec8a1376c716498e3136bf7e715510fef201444d,0,Xiaoxiang Yu,2020-06-15 18:58:11+08:00,['4054206a29e0f6dba419724fc30eb0eb519b1c2f'],10,2,12,16415785,1,,,,13778
95e46db70586fb6754f9fd5564140042e1941f25,0,Xiaoxiang Yu,2020-07-05 15:21:41+08:00,['ec8a1376c716498e3136bf7e715510fef201444d'],1,1,2,16415787,1,,,,13778
0e2d15f6ed2fdcaee7355a841845c18db5b9d7da,0,xxyu,2020-07-10 18:38:39+08:00,['95e46db70586fb6754f9fd5564140042e1941f25'],0,2,2,16415789,2,,,,13778
c23ab54ac858e68ade579da3e70fed37d2cc7365,0,xxyu,2020-07-10 18:41:15+08:00,['0e2d15f6ed2fdcaee7355a841845c18db5b9d7da'],22,22,44,16415833,9,,,,13778
ecb1a7365423881b7e4c44aa4ee2ce6a77d71f37,1,xxyu,2020-07-15 11:08:00+08:00,['c23ab54ac858e68ade579da3e70fed37d2cc7365'],56,37283,37339,16453172,36,0.5,0.5,1,13801
27a29d01e83f69b4e021bab67f19fd23ab2d3099,0,xxyu,2020-07-15 11:14:12+08:00,['ecb1a7365423881b7e4c44aa4ee2ce6a77d71f37'],11,52,63,16453235,6,1,1,1,13802
60ffdaa564cc602e2ea60d0e036f84e7ba1fd7ba,0,xxyu,2020-07-20 17:01:58+08:00,['27a29d01e83f69b4e021bab67f19fd23ab2d3099'],503,100,603,16453838,2,0.635738832,0.463917526,0.240549828,13802
95b1af050a708dbd16710e530a8df10335eb09fd,0,xxyu,2020-07-20 17:01:58+08:00,['60ffdaa564cc602e2ea60d0e036f84e7ba1fd7ba'],284,155,439,16454277,5,,,,13802
a8de6d49135c4efc9afd68ffd3f7c306a1367dee,1,xxyu,2020-07-28 09:34:26+08:00,['95b1af050a708dbd16710e530a8df10335eb09fd'],48,37944,37992,16492269,73,0.446018564,0.65925745,0.739863214,13872
db1eba82b3c6a538f9b12f814e77f410157e3a83,0,xxyu,2020-07-28 09:34:26+08:00,['a8de6d49135c4efc9afd68ffd3f7c306a1367dee'],328,260,588,16492857,25,,,,13872
db866b7d0a9e6a1911a367e393c9c1f9018fa71f,0,xxyu,2020-07-28 09:34:26+08:00,['db1eba82b3c6a538f9b12f814e77f410157e3a83'],2142,4,2146,16495003,19,0.372013652,0.040102389,0.098976109,13872
82045c24a4b1cc3c4e541ec66acbf8009878d41f,0,xxyu,2020-07-28 09:34:26+08:00,['db866b7d0a9e6a1911a367e393c9c1f9018fa71f'],3097,2337,5434,16500437,42,0.557888422,0.303539292,0.179364127,13875
4bfaf99118af5e5c4f9ac6f595912e6811fe6cb9,1,xxyu,2020-07-28 09:44:18+08:00,['82045c24a4b1cc3c4e541ec66acbf8009878d41f'],5,6,11,16500448,6,0,1,0,13875
5764e4797c90b3c9225c5c5c8c1d4fea27fe59a4,1,xxyu,2020-07-29 13:52:54+08:00,['4bfaf99118af5e5c4f9ac6f595912e6811fe6cb9'],175,153,328,16500776,51,0.333333333,0.25,0.083333333,13875
dc1a80f2c1ad11fbd821014ae7975bb11c6db1d1,0,xxyu,2020-07-31 11:26:51+08:00,['5764e4797c90b3c9225c5c5c8c1d4fea27fe59a4'],14,8,22,16500798,2,,,,13875
3d14e97233f8d4074e34690b1a89b1d63c76fd68,0,xxyu,2020-08-11 21:10:46+08:00,['dc1a80f2c1ad11fbd821014ae7975bb11c6db1d1'],0,32,32,16500830,3,1,1,1,13876
a2e9bfa52fe13c7a0b22cd8fd24f1b00ab4a934c,1,xxyu,2020-08-11 21:16:56+08:00,['3d14e97233f8d4074e34690b1a89b1d63c76fd68'],11,35,46,16500876,7,0.857142857,0.857142857,1,13876
15305eaf86fb8925f559e3b3d0efda05f4a022f8,0,xxyu,2020-08-12 22:03:24+08:00,['a2e9bfa52fe13c7a0b22cd8fd24f1b00ab4a934c'],61,62,123,16500999,15,0,0.5,0,13876
8e6c90accf7e852c90158f7439a6d3bc48c5732b,0,xxyu,2020-08-12 22:03:24+08:00,['15305eaf86fb8925f559e3b3d0efda05f4a022f8'],2,2,4,16501003,1,,,,13876
47dd4a23d7b83b68a6e75c2aed0552efe41f893d,0,xxyu,2020-08-12 22:03:24+08:00,['8e6c90accf7e852c90158f7439a6d3bc48c5732b'],2,2,4,16501007,3,0,,,13876
1b4e4c245e620f1c2ccfc1267c5f7bd9a382aa83,1,xxyu,2020-08-14 11:23:32+08:00,['47dd4a23d7b83b68a6e75c2aed0552efe41f893d'],592,26,618,16501625,6,0.496527778,0.40625,0,13876
c9370ea32e794c34c7ce98e72fea775486241ef1,0,xxyu,2020-08-24 02:34:25+08:00,['1b4e4c245e620f1c2ccfc1267c5f7bd9a382aa83'],10058,10075,20133,16521758,5,,,,13876
14b575083a06aaaa44a722a966cdd93f8d7c1e46,1,xxyu,2020-08-24 02:34:25+08:00,['c9370ea32e794c34c7ce98e72fea775486241ef1'],20,27,47,16521805,3,1,1,0,13876
35308f71158719d203abc4858dcdc87fe586e18e,0,xxyu,2020-08-24 02:34:25+08:00,['14b575083a06aaaa44a722a966cdd93f8d7c1e46'],381,345,726,16522531,3,,,,13876
656d9f3c923b18610aa93a9975a5eb6a9f2d8ec8,0,xxyu,2020-08-24 02:34:25+08:00,['35308f71158719d203abc4858dcdc87fe586e18e'],190,165,355,16522886,25,1,1,0,13876
ccdff322431e90eef8807f3fd3eb9870b726d73c,0,xxyu,2020-08-25 13:50:05+08:00,['656d9f3c923b18610aa93a9975a5eb6a9f2d8ec8'],1,8,9,16522895,1,0,0,0,13876
3f0b2a8eaa14e42a36df314b16263b1e90efc44d,0,xxyu,2020-08-27 14:08:27+08:00,['ccdff322431e90eef8807f3fd3eb9870b726d73c'],5,103,108,16523003,9,0.666666667,0.666666667,0.944444444,13876
65ad98410810d47c7bbd2b4f5bcd2e0a877bd014,1,xxyu,2020-08-27 15:10:38+08:00,['3f0b2a8eaa14e42a36df314b16263b1e90efc44d'],9,85,94,16523097,6,0.679245283,0.679245283,0.886792453,13876
d43aca4a4672e1b823456c964eaa499ffde27e1a,0,xxyu,2020-08-27 15:10:38+08:00,['65ad98410810d47c7bbd2b4f5bcd2e0a877bd014'],5,5,10,16523107,5,,,,13876
7a336fab3eb9c5bb931eba031f9249f334fad066,1,xxyu,2020-08-27 15:37:06+08:00,['d43aca4a4672e1b823456c964eaa499ffde27e1a'],55,29,84,16523191,13,0,0,0,13876
56cf4e6ee59358a2dd2a325d4e086b04049e9ad4,1,xxyu,2020-08-27 15:37:06+08:00,['7a336fab3eb9c5bb931eba031f9249f334fad066'],38,40,78,16523269,7,0,1,0,13876
cfdcb9f1efecd39ad709db7257cac6bc90a98bbd,1,xxyu,2020-08-27 15:37:06+08:00,['56cf4e6ee59358a2dd2a325d4e086b04049e9ad4'],15,88,103,16523372,6,0.235294118,0.549019608,0.568627451,13876
ff338de3d3fcd30508b8973bc740d0daf5da597d,0,xxyu,2020-08-27 15:37:06+08:00,['cfdcb9f1efecd39ad709db7257cac6bc90a98bbd'],2,23,25,16523397,1,0,0,0,13876
621868cb04d03df9683bb4c2508afc92f23058ad,0,xxyu,2020-08-27 15:37:06+08:00,['ff338de3d3fcd30508b8973bc740d0daf5da597d'],10,3,13,16523410,4,,,,13876
2d998f181dbeec0a5efb42e2bf94329897e8e150,0,xxyu,2020-08-27 15:37:06+08:00,['621868cb04d03df9683bb4c2508afc92f23058ad'],9,74,83,16523493,6,1,1,1,13877
ea267e240a9584cbefccd935d14f702c1f58c291,0,xxyu,2020-08-27 15:37:06+08:00,['2d998f181dbeec0a5efb42e2bf94329897e8e150'],2,21,23,16523516,1,,,,13877
2d6d8b55ff384d6ce393e1111feecd35987600d0,0,xxyu,2020-08-27 15:37:06+08:00,['ea267e240a9584cbefccd935d14f702c1f58c291'],24,24,48,16523564,4,0,0,1,13877
698af2ca3401f64c4d296be88a1a14621d03d0c6,0,xxyu,2020-08-27 19:09:38+08:00,['2d6d8b55ff384d6ce393e1111feecd35987600d0'],1,3,4,16523568,1,0,0,1,13877
07fd1b4566ff5a84e15d32f5584b21e0861c8109,0,xxyu,2020-08-28 10:39:59+08:00,['698af2ca3401f64c4d296be88a1a14621d03d0c6'],84,7,91,16523659,2,,,,13877
1b63cec0b57f1d5367abd37dd4364f78cf741c42,1,xxyu,2020-08-31 10:35:04+08:00,['07fd1b4566ff5a84e15d32f5584b21e0861c8109'],13,23,36,16523695,6,0.416666667,0.75,0,13877
e573ed3d4d87687885df474fdbcaff0c54c9e79d,0,xxyu,2020-08-31 11:06:54+08:00,['1b63cec0b57f1d5367abd37dd4364f78cf741c42'],2,10,12,16523707,3,0.8,1,0.8,13877
f48a0321b314e63516ac1a0774d68b3836ba5978,0,xxyu,2020-09-01 17:52:52+08:00,['e573ed3d4d87687885df474fdbcaff0c54c9e79d'],49,54,103,16523810,9,0,0,1,13877
5eb9b37cf4164f4cf94076aa84fd47f346ae4b17,0,xxyu,2020-09-01 17:52:52+08:00,['f48a0321b314e63516ac1a0774d68b3836ba5978'],0,2,2,16523812,1,0,0,1,13877
24fabdc69201cdb114c18a541ddf2995735a7f09,0,xxyu,2020-09-01 22:02:27+08:00,['5eb9b37cf4164f4cf94076aa84fd47f346ae4b17'],3,3,6,16523818,3,,,,13877
e62ca6ebd19e336d009a36bf435ad2beb99f6080,0,xxyu,2020-09-02 09:54:11+08:00,['24fabdc69201cdb114c18a541ddf2995735a7f09'],1,2,3,16523821,1,,,,13877
be0aedd6a2a1cf23e4ff50597a264857d2dff22b,0,xxyu,2020-09-02 11:07:13+08:00,['e62ca6ebd19e336d009a36bf435ad2beb99f6080'],7,100,107,16523928,4,0,0,1,13878
762e7c8379e9aec6162afec73437c7df6f8d6eef,1,xxyu,2020-09-03 17:18:18+08:00,['be0aedd6a2a1cf23e4ff50597a264857d2dff22b'],6,10,16,16523944,5,0.333333333,1,0,13878
582969ded2ab5c89bdc28e86b1514e6aa1b794b2,0,xxyu,2020-09-03 18:33:25+08:00,['762e7c8379e9aec6162afec73437c7df6f8d6eef'],6,16,22,16523966,1,0,0,0,13878
11475536e42bc742757599a1a53738de5e4485dd,1,xxyu,2020-09-03 23:41:16+08:00,['582969ded2ab5c89bdc28e86b1514e6aa1b794b2'],143,32,175,16524141,13,1,1,1,13878
0da41e20a652794d9328c819977754ec8c4f9941,0,xxyu,2020-09-04 09:59:49+08:00,['11475536e42bc742757599a1a53738de5e4485dd'],10,16,26,16524167,1,0,1,0,13878
276f906a35ce9f868b444b0a95c4d57648e07b23,0,xxyu,2020-09-04 10:24:46+08:00,['0da41e20a652794d9328c819977754ec8c4f9941'],19,16,35,16524202,4,0,0,0,13878
63f8c841918041be05508bf9fef5300e0d54a764,1,xxyu,2020-09-04 11:16:20+08:00,['276f906a35ce9f868b444b0a95c4d57648e07b23'],3,13,16,16524218,2,1,1,1,13878
3405ab2609da1fe8e95c5e0fb9603d429c3e81b6,1,xxyu,2020-09-04 15:03:44+08:00,['63f8c841918041be05508bf9fef5300e0d54a764'],175,31,206,16524424,2,,,,13878
524e2da496b86e22590cf8e46ab7766a819b1e25,0,XiaoxiangYu,2020-09-06 23:24:07+08:00,['3405ab2609da1fe8e95c5e0fb9603d429c3e81b6'],9,133,142,16524566,10,1,1,1,13879
53b62a9bd11c6d5b2e3be9ca099f57309238241f,0,XiaoxiangYu,2020-09-07 11:55:03+08:00,['524e2da496b86e22590cf8e46ab7766a819b1e25'],8,15,23,16524589,7,,,,13879
bc94f4978bc3009a5ad7853c2c6f86c8f2f1c39d,0,XiaoxiangYu,2020-09-08 18:19:49+08:00,['53b62a9bd11c6d5b2e3be9ca099f57309238241f'],8,25,33,16524622,2,,,,13879
a285f9a5b84affc36c5466ce5a1b2fcdb4348b37,0,nichunen,2020-09-08 12:52:30+00:00,['bc94f4978bc3009a5ad7853c2c6f86c8f2f1c39d'],76,55,131,16524753,29,,,,13879
f7c4ede01c6b9b46c1b007d94500038789a94fc6,0,nichunen,2020-09-08 12:52:49+00:00,['a285f9a5b84affc36c5466ce5a1b2fcdb4348b37'],40,40,80,16524833,29,,,,13879
02e9eb6792ae9624704bc4edb44091beab352d3c,0,xxyu,2020-09-10 14:25:20+08:00,['f7c4ede01c6b9b46c1b007d94500038789a94fc6'],1,3,4,16524837,1,,,,13879
bb4130d5455f5bc462ad4d6703da47ec1546e4fc,1,xxyu,2020-09-10 18:33:39+08:00,['02e9eb6792ae9624704bc4edb44091beab352d3c'],10,25,35,16524872,8,0.25,0.25,1,13879
4b396ab86152a7f72aecb65e69f87441394d7373,0,xxyu,2020-09-10 18:58:34+08:00,['bb4130d5455f5bc462ad4d6703da47ec1546e4fc'],56,107,163,16525035,7,0.5,0.5,1,13879
f19f3286a5a0122c313faa2bf3c5248aae4c726f,0,xxyu,2020-09-16 20:57:44+08:00,['4b396ab86152a7f72aecb65e69f87441394d7373'],3,402,405,16525440,3,0.568548387,0.725806452,0.951612903,13881
e6565f87fdeaa9e6bb8e2a5951ff7f3046997b96,0,xxyu,2020-09-16 21:03:05+08:00,['f19f3286a5a0122c313faa2bf3c5248aae4c726f'],159,760,919,16526359,13,,,,13886
beabeaa2ec9b81c06a60d5ca62e639de0b660358,0,xxyu,2020-09-17 16:18:34+08:00,['e6565f87fdeaa9e6bb8e2a5951ff7f3046997b96'],15,95,110,16526469,2,0,0.411764706,1,13886
d9a2631b585fef3a079cc1153c0395b319f5eedd,0,xxyu,2020-09-17 16:21:54+08:00,['beabeaa2ec9b81c06a60d5ca62e639de0b660358'],10062,10105,20167,16546636,5,,,,13886
70b1afa65149ba94741c45907dc2ec8dc091cd98,0,xxyu,2020-09-20 15:29:08+08:00,['d9a2631b585fef3a079cc1153c0395b319f5eedd'],3,7,10,16546646,2,0,1,0,13886
cd03d6d41b6cec6756de1247fc9ae74dfe122685,0,xxyu,2020-09-21 17:14:51+08:00,['70b1afa65149ba94741c45907dc2ec8dc091cd98'],2,18,20,16546666,1,0.090909091,0.090909091,0.363636364,13886
64fb5150559d245ffc73070775f2c76882ef8bad,0,xxyu,2020-09-23 10:53:15+08:00,['cd03d6d41b6cec6756de1247fc9ae74dfe122685'],7,10,17,16546683,2,,,,13886
54408d4ff376841be81a043f4992bab89127cca5,1,xxyu,2020-09-24 14:09:25+08:00,['64fb5150559d245ffc73070775f2c76882ef8bad'],5,14,19,16546702,4,0.333333333,0.333333333,1,13886
23d06772a46451d45475db8f31c88154e70fbaaf,0,xxyu,2020-09-24 14:11:26+08:00,['54408d4ff376841be81a043f4992bab89127cca5'],10,1,11,16546713,1,1,0,0,13886
5c58e2549736df679cb1e8d5b0e933a984298099,0,xxyu,2020-09-24 14:14:25+08:00,['23d06772a46451d45475db8f31c88154e70fbaaf'],7,7,14,16546727,4,,,,13886
b3415685d5de9abbf47ee12a5fcdcca4a56accdc,1,xxyu,2020-09-25 14:57:07+08:00,['5c58e2549736df679cb1e8d5b0e933a984298099'],248,215,463,16547190,9,0,0,1,13887
e1fd472d00eea438d26c26f032e819db56e33486,0,xxyu,2020-09-27 12:47:55+08:00,['b3415685d5de9abbf47ee12a5fcdcca4a56accdc'],1465,1761,3226,16550416,647,0.108108108,0,0.540540541,13891
67a1c7c6c28e1e22f6d4e7c3b20dbbb9b80a52fe,0,xxyu,2020-09-29 09:46:00+08:00,['e1fd472d00eea438d26c26f032e819db56e33486'],1,3,4,16550420,2,0,0,1,13891
1faff2b74f60a108759799b954e9a20333734aac,0,xxyu,2020-09-29 09:50:43+08:00,['67a1c7c6c28e1e22f6d4e7c3b20dbbb9b80a52fe'],11,20,31,16550451,2,0,0.777777778,0.777777778,13891
ea7a8b454fd884fd504b17ec8dabcade89e76b0f,0,xxyu,2020-10-07 15:03:21+08:00,['1faff2b74f60a108759799b954e9a20333734aac'],1,25,26,16550477,2,0.8,0.8,1,13891
9b2a12bc334edf4f8756a1a758c941a4571efa78,0,xxyu,2020-10-10 17:34:34+08:00,['ea7a8b454fd884fd504b17ec8dabcade89e76b0f'],78,701,779,16551256,298,0.399253731,0.51119403,0.548507463,13892
3683c243534d2c9bf9dfda2a5f10016b18a9ff6c,0,xxyu,2020-10-19 17:30:01+08:00,['9b2a12bc334edf4f8756a1a758c941a4571efa78'],0,35,35,16551291,1,,,,13892
d4cd28d108c8f16aa1546434a9f311002d2d8010,0,xxyu,2020-10-20 15:09:01+08:00,['3683c243534d2c9bf9dfda2a5f10016b18a9ff6c'],29,145,174,16551465,5,0,0.2,1,13895
b49b26f2a681a45076487b503700ec4271b06585,0,xxyu,2020-10-21 11:25:36+08:00,['d4cd28d108c8f16aa1546434a9f311002d2d8010'],484,647,1131,16552596,300,0.5,0.5625,0.28125,13895
be783f07342c420ddab3a3450a97802c6ee2d243,1,xxyu,2020-10-22 10:36:19+08:00,['b49b26f2a681a45076487b503700ec4271b06585'],0,60,60,16552656,3,0,1,1,13895
1fe3e2c80622af6806ff43435a456d48d17ef45f,0,xxyu,2020-10-23 11:28:01+08:00,['be783f07342c420ddab3a3450a97802c6ee2d243'],35,55,90,16552746,24,0,1,0,13895
602c46166384d018966312b8a57184458f9ffc0c,0,xxyu,2020-10-23 14:10:07+08:00,['1fe3e2c80622af6806ff43435a456d48d17ef45f'],7,11,18,16552764,2,0,1,1,13895
92727d6c411f1848a0f829e39a22e7388b8e5c43,0,xxyu,2020-10-23 17:20:04+08:00,['602c46166384d018966312b8a57184458f9ffc0c'],2,19,21,16552785,2,,,,13895
b5a133d2c0a3c3f732d228490ba0bbcda4c41856,0,xxyu,2020-10-28 14:22:22+08:00,['92727d6c411f1848a0f829e39a22e7388b8e5c43'],1,32,33,16552818,1,0,1,1,13895
1d43e0a4ac81648f89666365e06e2519ae53271b,0,xxyu,2020-10-29 11:30:30+08:00,['b5a133d2c0a3c3f732d228490ba0bbcda4c41856'],0,273,273,16553091,5,0.484375,0.484375,1,13897
69ac9cea322d5430ac0756caab730ceb19449e7e,0,xxyu,2020-11-08 16:12:46+08:00,['1d43e0a4ac81648f89666365e06e2519ae53271b'],96,3497,3593,16556684,101,,,,13987
c23238811aa66cf972555db8cd6ee16006d5f4af,0,xxyu,2020-11-08 16:12:46+08:00,['69ac9cea322d5430ac0756caab730ceb19449e7e'],327,791,1118,16557802,21,,,,13996
823059d077a6d439b932ef99173671d177b3aa87,0,xxyu,2020-11-08 16:12:46+08:00,['c23238811aa66cf972555db8cd6ee16006d5f4af'],5,63,68,16557870,2,,,,13996
8a96a4b6986dd89d15fe6c6b5813f511a0e47a31,0,xxyu,2020-11-08 16:12:46+08:00,['823059d077a6d439b932ef99173671d177b3aa87'],2,8,10,16557880,1,0,0,1,13996
e6f579ef05cf60eaad77662431b9d120a7d77133,0,xxyu,2020-11-08 16:12:46+08:00,['8a96a4b6986dd89d15fe6c6b5813f511a0e47a31'],0,3669,3669,16561549,24,0.737513284,0.807651435,0.304994687,14020
4dd747adc05c4868c01d0544e3424ca1d486c2e0,0,xxyu,2020-11-08 16:12:46+08:00,['e6f579ef05cf60eaad77662431b9d120a7d77133'],0,373,373,16561922,5,,,,14025
768a6d662350d4d18a9e2ced4490df439104f537,0,xxyu,2020-11-08 16:12:46+08:00,['4dd747adc05c4868c01d0544e3424ca1d486c2e0'],365,608,973,16562895,41,,,,14029
9679252db3dbe36746e80d449791e9c53c47b15d,0,xxyu,2020-11-08 16:12:46+08:00,['768a6d662350d4d18a9e2ced4490df439104f537'],149,169,318,16563213,9,,,,14030
5f16a065ace55d884532cf7d5ad867d94804a39c,0,xxyu,2020-11-08 16:12:46+08:00,['9679252db3dbe36746e80d449791e9c53c47b15d'],3,15,18,16563231,7,,,,14030
49715c038bde459f1b842fc3f9ddf97a90b0976d,0,xxyu,2020-11-08 16:12:46+08:00,['5f16a065ace55d884532cf7d5ad867d94804a39c'],235,251,486,16563717,27,0,0,0.5,14033
dc073f44bac77d9649977d62f5af0f4d33b4a4cf,0,xxyu,2020-11-08 16:12:46+08:00,['49715c038bde459f1b842fc3f9ddf97a90b0976d'],6,41,47,16563764,1,,,,14033
97cebbdca78911d505b63ad16ea5df825c951612,0,xxyu,2020-11-08 16:12:46+08:00,['dc073f44bac77d9649977d62f5af0f4d33b4a4cf'],712,126,838,16564602,13,0.7,0,0.25,14037
15866d18133ff29a70db01027f7ab4fd0ced0b70,0,xxyu,2020-11-08 16:12:46+08:00,['97cebbdca78911d505b63ad16ea5df825c951612'],25,42,67,16564669,11,0.473684211,0.473684211,0.315789474,14037
2db2800639f79f15d3c00774facfb31de2764e67,0,xxyu,2020-11-08 16:44:44+08:00,['15866d18133ff29a70db01027f7ab4fd0ced0b70'],47,104,151,16564820,1,,,,14037
270b3326dcb0a6f0f7342323cb214bb1a9ece032,0,xxyu,2020-11-09 10:13:15+08:00,['2db2800639f79f15d3c00774facfb31de2764e67'],3,11,14,16564834,1,0.4,0.4,1,14037
0894c0d3754ea0cb591d7b50d26f9b8b5c4f1aa5,0,xxyu,2020-11-10 09:46:57+08:00,['270b3326dcb0a6f0f7342323cb214bb1a9ece032'],15,16,31,16564865,1,,,,14037
b6893dd16f6f097f19e24e692bed1ac2bdf7f886,0,xxyu,2020-11-17 16:27:21+08:00,['0894c0d3754ea0cb591d7b50d26f9b8b5c4f1aa5'],16,24,40,16564905,6,0.285714286,1,1,14037
a3ac3feff315dd6b30403096dfbc812ad808f418,0,xxyu,2020-11-17 16:45:04+08:00,['b6893dd16f6f097f19e24e692bed1ac2bdf7f886'],18,413,431,16565336,27,,,,14037
0b4df4cf67b27c6f9a7a9e5c9006ddf528acc09b,0,xxyu,2020-11-18 14:01:43+08:00,['a3ac3feff315dd6b30403096dfbc812ad808f418'],5,10,15,16565351,1,0,0,1,14037
8da4b26c2cb3e9d46100ca64fe5bb4fcdfaf56ac,0,xxyu,2020-11-23 20:50:12+08:00,['0b4df4cf67b27c6f9a7a9e5c9006ddf528acc09b'],1,1,2,16565353,1,,,,14037
c7e08d60e4a96d1e343bcf43f757624c16cdfff2,0,Xiaoxiang Yu,2020-11-26 18:43:29+08:00,['8da4b26c2cb3e9d46100ca64fe5bb4fcdfaf56ac'],433,7987,8420,16573773,427,0.571428571,0.571428571,0.714285714,14457
2dca9ef9a52cf1adb12684e0ba576b91e96b3792,1,Xiaoxiang Yu,2020-11-27 15:22:32+08:00,['c7e08d60e4a96d1e343bcf43f757624c16cdfff2'],142,1044,1186,16574959,20,0.61452514,0.664804469,0.823091248,14461
c0b27873f7ff6cfcaa4d404214c41288bd81a4f4,0,Xiaoxiang Yu,2020-11-27 15:22:32+08:00,['2dca9ef9a52cf1adb12684e0ba576b91e96b3792'],2,298,300,16575259,6,0.738562092,0.869281046,1,14463
86aae4dc1cd6f364c36e9f47db84b20956b2b911,0,Xiaoxiang Yu,2020-11-27 15:22:32+08:00,['c0b27873f7ff6cfcaa4d404214c41288bd81a4f4'],85,110,195,16575454,10,0.047619048,0.095238095,0,14463
c4d3168268f189aaec4e7406d08dcc10fffb2888,0,Xiaoxiang Yu,2020-11-27 15:22:32+08:00,['86aae4dc1cd6f364c36e9f47db84b20956b2b911'],3,12,15,16575469,3,1,1,0.8,14463
9a4df78f291cd7e34a30cbbdd9ec43124e6cd46f,1,Xiaoxiang Yu,2020-11-27 15:22:32+08:00,['c4d3168268f189aaec4e7406d08dcc10fffb2888'],60,53,113,16575582,7,0.285714286,1,1,14463
51ff5ec9c6959bd5238c579573494bc4b07c2095,1,Xiaoxiang Yu,2020-11-27 15:22:32+08:00,['9a4df78f291cd7e34a30cbbdd9ec43124e6cd46f'],17,198,215,16575797,8,0.454545455,1,0.848484848,14464
d46fc4a602dc3d12c5b1bab5e143cfc65fcba32f,0,Xiaoxiang Yu,2020-11-30 20:17:44+08:00,['51ff5ec9c6959bd5238c579573494bc4b07c2095'],1409,21302,22711,16598508,263,0.613793103,0.620689655,0.524137931,14537
cd449eab1c6f49a27bc97ecfff8e1b29af92aead,0,Xiaoxiang Yu,2020-12-04 19:36:55+08:00,['d46fc4a602dc3d12c5b1bab5e143cfc65fcba32f'],281,168,449,16598957,3,0.641975309,0.37037037,0,14537
9e69f668ebeacbb08d3db5d8682df656fbc8d7af,0,Xiaoxiang Yu,2020-12-08 19:13:01+08:00,['cd449eab1c6f49a27bc97ecfff8e1b29af92aead'],44,43,87,16599044,14,,,,14542
29b003c48a19418d596aff128f4c7cdc5b099b41,0,Xiaoxiang Yu,2020-12-08 19:13:01+08:00,['9e69f668ebeacbb08d3db5d8682df656fbc8d7af'],3,3,6,16599050,2,,,,14542
7182101021353196fa2ea919050b3e96f68a85fd,0,Xiaoxiang Yu,2020-12-08 19:13:01+08:00,['29b003c48a19418d596aff128f4c7cdc5b099b41'],3,3,6,16599056,3,,,,14542
959edebdb262afd63308ba32031abcf889670245,0,Xiaoxiang Yu,2020-12-09 10:40:34+08:00,['7182101021353196fa2ea919050b3e96f68a85fd'],134,328,462,16599518,17,0.890410959,1,0.917808219,14545
bd5bc7a118ee3cebe68937780102d13a54972a6d,0,Xiaoxiang Yu,2020-12-16 10:54:35+08:00,['959edebdb262afd63308ba32031abcf889670245'],101,140,241,16599759,30,0.4375,0,0,14545
64e93654cdc4ed56bed790fe3a86e57ab78ca02c,0,Xiaoxiang Yu,2020-12-16 13:46:39+08:00,['bd5bc7a118ee3cebe68937780102d13a54972a6d'],18,201,219,16599978,12,0,0.555555556,1,14552
df425556757d0654800d96aa0b11728e8adcc4a6,0,Xiaoxiang Yu,2020-12-17 16:52:36+08:00,['64e93654cdc4ed56bed790fe3a86e57ab78ca02c'],95,339,434,16600412,60,0.125,0.160714286,0.946428571,14591
fb94ec44cee704f79e6a1796a44b4d5c04f9699d,1,Xiaoxiang Yu,2020-12-17 17:25:28+08:00,['df425556757d0654800d96aa0b11728e8adcc4a6'],1,19,20,16600432,2,0.058823529,1,1,14591
6279025a017a26b76100106a789a694a112fca62,0,Xiaoxiang Yu,2020-12-18 11:35:44+08:00,['fb94ec44cee704f79e6a1796a44b4d5c04f9699d'],70,43,113,16600545,6,,,,14592
b0cd9fab3717144b77d8928a1ba6312ca3b178ee,0,Xiaoxiang Yu,2020-12-18 16:17:50+08:00,['6279025a017a26b76100106a789a694a112fca62'],160,36,196,16600741,18,,,,14592
49dcdd270a0a014123e4ba1b586c49e6dd508540,1,Xiaoxiang Yu,2020-12-18 16:57:19+08:00,['b0cd9fab3717144b77d8928a1ba6312ca3b178ee'],116,62,178,16600919,7,,,,14592
9b0cc69e58029209242b210e23782b0cdb244ee9,1,Xiaoxiang Yu,2020-12-23 17:02:35+08:00,['49dcdd270a0a014123e4ba1b586c49e6dd508540'],2,92,94,16601013,3,0.578947368,1,1,14593
39086e3a279cd92447c9f919147edec6db058685,0,Xiaoxiang Yu,2020-12-23 17:03:30+08:00,['9b0cc69e58029209242b210e23782b0cdb244ee9'],15,9,24,16601037,3,0,0,1,14593
32f8d66cc368a157fb27acf41e8dac8bf73375f1,0,Xiaoxiang Yu,2020-12-30 11:42:05+08:00,['39086e3a279cd92447c9f919147edec6db058685'],1,24,25,16601062,2,1,1,1,14593
a6f78cd53b951acf3ec966fa537dae3f2b82fd1e,0,Xiaoxiang Yu,2021-01-04 14:04:51+08:00,['32f8d66cc368a157fb27acf41e8dac8bf73375f1'],30,234,264,16601326,11,0.092783505,0.979381443,0.680412371,14594
3d6db494526094c6f7f1134e9fe576d7e0c66307,1,Xiaoxiang Yu,2021-01-04 14:04:51+08:00,['a6f78cd53b951acf3ec966fa537dae3f2b82fd1e'],63,138,201,16601527,10,0,0,0.980769231,14594
9e33d93b2dc668c1309a1f4c1afb8f8f5a946c29,1,Xiaoxiang Yu,2021-01-04 14:04:51+08:00,['3d6db494526094c6f7f1134e9fe576d7e0c66307'],42,86,128,16601655,6,0,0,0,14594
d8e5db8457bf5bbd1ae05b9360c5ae48038b57fb,0,Xiaoxiang Yu,2021-01-04 14:04:51+08:00,['9e33d93b2dc668c1309a1f4c1afb8f8f5a946c29'],25,80,105,16601760,10,0.612903226,0.870967742,0.935483871,14594
2e9597a099dd24ce54ad8d8b564dc3cfdf2618c9,0,Xiaoxiang Yu,2021-01-04 14:04:51+08:00,['d8e5db8457bf5bbd1ae05b9360c5ae48038b57fb'],9,9,18,16601778,3,,,,14594
af8c8fee7c98d7fb4b3ccd594ed0e8b200ff3e64,0,Xiaoxiang Yu,2021-01-04 14:04:51+08:00,['2e9597a099dd24ce54ad8d8b564dc3cfdf2618c9'],25,23,48,16601826,5,0,0,0,14594
6f4e3562d9061bee4ef3288f35e9e53133a9e9cd,0,GitHub,2021-01-04 22:50:13+08:00,['af8c8fee7c98d7fb4b3ccd594ed0e8b200ff3e64'],1,147,148,16601974,3,,,,14595
44402d3c39cecff9a71dea2edc85bae72b8ab224,0,GitHub,2021-01-05 18:31:16+08:00,['6f4e3562d9061bee4ef3288f35e9e53133a9e9cd'],0,14,14,16601988,1,0,0,1,14595
b08c1be22eb51796fb58c3694e86e60f948337f6,0,GitHub,2021-01-06 09:52:17+08:00,['44402d3c39cecff9a71dea2edc85bae72b8ab224'],5,6,11,16601999,1,,,,14595
124dd054923b9e41f37c725494ff1cadac496eee,0,Xiaoxiang Yu,2021-01-08 10:18:30+08:00,['b08c1be22eb51796fb58c3694e86e60f948337f6'],21,23,44,16602043,5,1,1,0,14595
2ad58c712ea1cb8ca7a3494eb30a7d1a69f212a2,0,Xiaoxiang Yu,2021-01-14 19:18:43+08:00,['124dd054923b9e41f37c725494ff1cadac496eee'],16,25,41,16602084,2,0.333333333,1,0.333333333,14595
af3a1b55ae1bbfb157ce9ec63a73651865c4c94a,0,Xiaoxiang Yu,2021-01-17 23:17:35+08:00,['2ad58c712ea1cb8ca7a3494eb30a7d1a69f212a2'],379,1450,1829,16603913,19,0.605504587,1,0.79204893,14600
ad7b47245c959ea3e57efe1c8f5a737d0b1653ed,1,Xiaoxiang Yu,2021-01-17 23:17:35+08:00,['af3a1b55ae1bbfb157ce9ec63a73651865c4c94a'],68,363,431,16604344,13,0.085106383,0.957446809,0.991489362,14600
7431240a7a8d868cbceba25cfb5b0d66c428cb66,0,Xiaoxiang Yu,2021-01-17 23:17:35+08:00,['ad7b47245c959ea3e57efe1c8f5a737d0b1653ed'],0,1,1,16604345,1,1,1,1,14600
3400338d7870c843e5ab2490c6767aa37e8092e4,0,Xiaoxiang Yu,2021-01-17 23:17:35+08:00,['7431240a7a8d868cbceba25cfb5b0d66c428cb66'],17,77,94,16604439,2,0,0.295454545,0.727272727,14600
6f48ce8322e6e46df107564c7788e25bcd3abde0,0,Xiaoxiang Yu,2021-01-17 23:17:35+08:00,['3400338d7870c843e5ab2490c6767aa37e8092e4'],4,30,34,16604473,2,0.866666667,1,0.533333333,14600
5b3859c9d6871cd001a39ece43c856275215e01b,0,Xiaoxiang Yu,2021-01-17 23:17:35+08:00,['6f48ce8322e6e46df107564c7788e25bcd3abde0'],10,13,23,16604496,3,,,,14600
dc5f2951f1c0791d62afcd0c741e2e08d8cc958c,1,Xiaoxiang Yu,2021-01-17 23:17:35+08:00,['5b3859c9d6871cd001a39ece43c856275215e01b'],101,180,281,16604777,9,0.372881356,0.745762712,1,14600
e719f7b562f87cb0ecaaca34a4c53c2fe91cecc0,0,Xiaoxiang Yu,2021-01-18 15:46:04+08:00,['dc5f2951f1c0791d62afcd0c741e2e08d8cc958c'],4,15,19,16604796,2,0,0,1,14600
588e08b465115a39810819102074c80161e6c790,0,Xiaoxiang Yu,2021-01-19 11:40:42+08:00,['e719f7b562f87cb0ecaaca34a4c53c2fe91cecc0'],6,6,12,16604808,3,,,,14600
3aa72f3fdc1265aa2a819e5a475f4419d8efcc71,1,Xiaoxiang Yu,2021-01-19 15:19:47+08:00,['588e08b465115a39810819102074c80161e6c790'],13,69,82,16604890,5,0.340909091,0.295454545,0.886363636,14600
76492b5b0eea24aba0665a5b9b76476abe547c40,0,Xiaoxiang Yu,2021-01-21 15:18:00+08:00,['3aa72f3fdc1265aa2a819e5a475f4419d8efcc71'],1,10,11,16604901,1,,,,14600
d7d20645d797aa43ee41456d61a0a96bfd42d378,0,Xiaoxiang Yu,2021-01-22 20:06:52+08:00,['76492b5b0eea24aba0665a5b9b76476abe547c40'],20,34,54,16604955,2,0,1,1,14600
5650a4e98d1ca02f1a1163c74d8756835a75c443,0,Xiaoxiang Yu,2021-01-26 10:31:04+08:00,['d7d20645d797aa43ee41456d61a0a96bfd42d378'],1,7,8,16604963,2,0,0,1,14600
20842e4f730da60da0d8279bf6b681f2b3139a3c,0,XiaoxiangYu,2021-02-03 17:17:33+08:00,['5650a4e98d1ca02f1a1163c74d8756835a75c443'],7,65,72,16605035,3,,,,14600
546381392c55136310f591969e5a3f3db6074988,0,nichunen,2021-02-03 12:08:58+00:00,['20842e4f730da60da0d8279bf6b681f2b3139a3c'],35,35,70,16605105,29,,,,14600
2bcdb62d957637f5401effaecc8fb6fc6b1c29a8,0,nichunen,2021-02-03 12:09:16+00:00,['546381392c55136310f591969e5a3f3db6074988'],35,35,70,16605175,29,,,,14600
cef085efbf1f5d5a8a6d5604d9f497cdb95ad04b,0,Xiaoxiang Yu,2021-02-07 10:22:53+08:00,['2bcdb62d957637f5401effaecc8fb6fc6b1c29a8'],2,2,4,16605179,1,,,,14600
23d908208b0fa3ca8fe30ecdf9579ba83aed0abd,0,Xiaoxiang Yu,2021-02-07 17:21:21+08:00,['cef085efbf1f5d5a8a6d5604d9f497cdb95ad04b'],129,234,363,16605542,4,0.027777778,1,1,14600
b171aaccacbee0d41ab1465138677b431e691d81,0,Xiaoxiang Yu,2021-02-07 17:43:59+08:00,['23d908208b0fa3ca8fe30ecdf9579ba83aed0abd'],2,3,5,16605547,1,,,,14600
a4a8480a05449b7ab19c7eace096dc3e39697dcb,0,Xiaoxiang Yu,2021-02-07 17:56:47+08:00,['b171aaccacbee0d41ab1465138677b431e691d81'],17,9,26,16605573,4,1,0,0,14600
0cf9e3d5951e880f04033efa599059237deba766,0,Xiaoxiang Yu,2021-02-07 17:57:10+08:00,['a4a8480a05449b7ab19c7eace096dc3e39697dcb'],4,1,5,16605578,1,,,,14600
69814e01a28210c95f2d296f6a5ed4402a8ae1e4,0,Xiaoxiang Yu,2021-02-07 18:02:02+08:00,['0cf9e3d5951e880f04033efa599059237deba766'],4,4,8,16605586,3,,,,14600
0f94e8165427eeb0cbae516f9516d4742f7a1205,0,Xiaoxiang Yu,2021-02-07 21:48:12+08:00,['69814e01a28210c95f2d296f6a5ed4402a8ae1e4'],9,1487,1496,16607082,20,0.257281553,0.966019417,0.800970874,14612
591c0e61e5cdd74b2bce2d36d5b3995130673559,0,Xiaoxiang Yu,2021-02-07 22:09:46+08:00,['0f94e8165427eeb0cbae516f9516d4742f7a1205'],18,16,34,16607116,2,1,1,0,14612
8f8bab94ed46ad81b45c3522125d7ab020f0e66f,0,Xiaoxiang Yu,2021-02-07 22:09:46+08:00,['591c0e61e5cdd74b2bce2d36d5b3995130673559'],1,1,2,16607118,1,,,,14612
b9cd81a0b1710913af469b04d44f3451d6a87f0c,0,Xiaoxiang Yu,2021-02-07 22:23:51+08:00,['8f8bab94ed46ad81b45c3522125d7ab020f0e66f'],54,62,116,16607234,3,0,1,1,14612
b428f1e1ab6a48101bec03e515d135c57af32878,1,Xiaoxiang Yu,2021-02-07 23:21:46+08:00,['b9cd81a0b1710913af469b04d44f3451d6a87f0c'],18,50,68,16607302,3,0.526315789,0,1,14612
5125ef614fd3269646bc66ffc0931e8b4a756a88,0,Xiaoxiang Yu,2021-02-20 14:27:30+08:00,['b428f1e1ab6a48101bec03e515d135c57af32878'],0,96,96,16607398,1,,,,14613
8a21389f685dfbbcd9c9254e578d7e8dcf70f078,0,Xiaoxiang Yu,2021-02-22 14:44:42+08:00,['5125ef614fd3269646bc66ffc0931e8b4a756a88'],275,298,573,16607971,16,0,1,0,14615
e1f7157dd5dd52b8f6e3e76d7dc873fe9e973f67,1,Xiaoxiang Yu,2021-02-25 20:26:19+08:00,['8a21389f685dfbbcd9c9254e578d7e8dcf70f078'],10,1236,1246,16609217,11,,,,14622
88ad6ec31b1d5ba0308bebd96d9c65d93935d3d8,0,Xiaoxiang Yu,2021-03-01 14:43:47+08:00,['e1f7157dd5dd52b8f6e3e76d7dc873fe9e973f67'],13,53,66,16609283,3,0.03125,1,1,14622
01036afd898e313a7d3b31f326dc780fd47f8fd0,0,Xiaoxiang Yu,2021-03-01 14:44:13+08:00,['88ad6ec31b1d5ba0308bebd96d9c65d93935d3d8'],2,74,76,16609359,9,0,1,1,14627
41ebf457858a76e4ab005b2f37f9b8fdb1d303ae,0,Xiaoxiang Yu,2021-03-05 14:34:29+08:00,['01036afd898e313a7d3b31f326dc780fd47f8fd0'],1,6,7,16609366,1,0,0,1,14627
399d25b23c112eaaa090b24ecbc332449dd1a4c1,0,Xiaoxiang Yu,2021-03-05 14:54:27+08:00,['41ebf457858a76e4ab005b2f37f9b8fdb1d303ae'],2,2,4,16609370,1,,,,14627
de95ab977e700178efd70705ead4edaca272d41f,0,Xiaoxiang Yu,2021-03-05 14:54:27+08:00,['399d25b23c112eaaa090b24ecbc332449dd1a4c1'],13,328,341,16609711,10,1,1,1,14634
a8cecf3d6786ceabb8138d4b54fa2edfc3526ebe,0,Xiaoxiang Yu,2021-03-11 16:01:01+08:00,['de95ab977e700178efd70705ead4edaca272d41f'],25,269,294,16610005,6,0,1,1,14636
bb54a2ab56ac3ab47b3cc77ed0f4fedd5ba857af,0,Xiaoxiang Yu,2021-03-24 16:49:49+08:00,['a8cecf3d6786ceabb8138d4b54fa2edfc3526ebe'],19,30,49,16610054,5,1,0,0.666666667,14636
04e216994b9c03e2f1eee44eab3427ab6b46d619,1,Xiaoxiang Yu,2021-03-24 16:53:57+08:00,['bb54a2ab56ac3ab47b3cc77ed0f4fedd5ba857af'],33,113,146,16610200,7,0,,0,14636
1d5f176fc3c940309dd9fd91f68b2bcd14f37975,1,Xiaoxiang Yu,2021-03-24 16:53:57+08:00,['04e216994b9c03e2f1eee44eab3427ab6b46d619'],5,43,48,16610248,4,0.151515152,1,0.181818182,14636
c3765cdaba3da961f99e68da4e6681dd72ebb768,0,Xiaoxiang Yu,2021-03-24 17:01:24+08:00,['1d5f176fc3c940309dd9fd91f68b2bcd14f37975'],1,7,8,16610256,2,0,0,0,14636
d7ca7a5918f28ec7bf8de187014451c5709456e4,0,Zhichao Zhang,2021-03-30 15:51:29+08:00,['c3765cdaba3da961f99e68da4e6681dd72ebb768'],15,12,27,16610283,2,,,0,14636
ee82816dd1bd8fd5eaaa51ea41794736f51ba20a,0,Xiaoxiang Yu,2021-04-07 17:19:51+08:00,['d7ca7a5918f28ec7bf8de187014451c5709456e4'],24,10243,10267,16620550,67,0.339901478,0.615763547,1,14691
d554c762838ddac4bf5e38d294e049788e6b8423,0,Zhichao Zhang,2021-04-09 16:02:16+08:00,['ee82816dd1bd8fd5eaaa51ea41794736f51ba20a'],4,89,93,16620643,4,0.446428571,0.303571429,0.875,14691
dfd012f45b9740ae0598041d7f1326e3a58c0da7,0,Zhichao Zhang,2021-04-09 18:31:32+08:00,['d554c762838ddac4bf5e38d294e049788e6b8423'],13,53,66,16620709,4,0.368421053,1,0.947368421,14691
6153889ce1b1fad2c409364e77ec471166654551,0,Xiaoxiang Yu,2021-04-12 11:21:31+08:00,['dfd012f45b9740ae0598041d7f1326e3a58c0da7'],19,108,127,16620836,7,0.852941176,0,1,14692
e6ca98d9e047efee4e6505e55f5aca573c9c0052,0,Xiaoxiang Yu,2021-04-21 10:38:20+08:00,['6153889ce1b1fad2c409364e77ec471166654551'],77,197,274,16621110,1,0,0.493150685,0.684931507,14692
279fbf34b71d00ef71ac8a931e03a50e6f8a078b,0,Xiaoxiang Yu,2021-04-21 19:55:31+08:00,['e6ca98d9e047efee4e6505e55f5aca573c9c0052'],2,9,11,16621121,3,0,1,1,14692
d16e7f053116cf659a3998affba233320d3d1dca,1,Zhichao Zhang,2021-04-26 00:45:56+08:00,['279fbf34b71d00ef71ac8a931e03a50e6f8a078b'],3,74,77,16621198,6,0,0,1,14697
6d87071158cb9256552c880c0c29bc995eb2cb54,0,Xiaoxiang Yu,2021-05-08 12:11:00+08:00,['d16e7f053116cf659a3998affba233320d3d1dca'],5,150,155,16621353,4,0.518987342,0.784810127,0.898734177,14698
f5ec8f3dd1a70c5e1125966e144d492248030de4,0,Xiaoxiang Yu,2021-05-08 12:11:00+08:00,['6d87071158cb9256552c880c0c29bc995eb2cb54'],16,37,53,16621406,3,0,1,0,14698
ee1be8c5f69ce87804913bdeabba7c1189e6358a,0,GitHub,2021-05-25 10:27:00+08:00,['f5ec8f3dd1a70c5e1125966e144d492248030de4'],9,19,28,16621434,2,,,,14698
0dc4c06641966e4fb2975f1ff738de65ff5d846c,1,Xiaoxiang Yu,2021-05-27 11:04:42+08:00,['ee1be8c5f69ce87804913bdeabba7c1189e6358a'],95,1560,1655,16623089,30,0.357239513,0.802435724,0.736129905,14708
082df34f2d304d1e6237c09047cf2c008c5e7df0,0,Xiaoxiang Yu,2021-05-27 11:04:42+08:00,['0dc4c06641966e4fb2975f1ff738de65ff5d846c'],0,99,99,16623188,2,0.192307692,0.192307692,1,14709
2edeaea625ce5a1e8bfbc73a72fbafccbfb420ff,0,Xiaoxiang Yu,2021-05-31 08:09:00+08:00,['082df34f2d304d1e6237c09047cf2c008c5e7df0'],9,176,185,16623373,7,0,0.021978022,0.901098901,14710
c94374569a5534a92ab305898698a3943c89c7ef,0,Yaqian Zhang,2021-06-07 15:38:48+08:00,['2edeaea625ce5a1e8bfbc73a72fbafccbfb420ff'],1,2,3,16623376,2,,,,14710
23ecb279f3df849c7c99c304ca63d427a28ee393,0,Xiaoxiang Yu,2021-06-22 11:06:43+08:00,['c94374569a5534a92ab305898698a3943c89c7ef'],2,2,4,16623380,2,,,,14710
5d552fe61e4a05b5f061805807f866ce53f4c03a,1,Yaqian Zhang,2021-06-22 19:39:53+08:00,['23ecb279f3df849c7c99c304ca63d427a28ee393'],13,28,41,16623421,3,0,1,0.846153846,14710
ba3348039f2e39f4262d80792a7aa2fbc14604aa,0,Yaqian Zhang,2021-06-22 19:39:53+08:00,['5d552fe61e4a05b5f061805807f866ce53f4c03a'],1,2,3,16623424,1,,,,14710
25080df65fae347edc28ebf73167fae7689aa561,0,Yaqian Zhang,2021-06-22 19:39:53+08:00,['ba3348039f2e39f4262d80792a7aa2fbc14604aa'],2,4,6,16623430,1,0,0,0,14710
cc5a56d63a13cdc33882619a04e0b112e78f9407,0,GitHub,2021-06-24 22:37:52+08:00,['25080df65fae347edc28ebf73167fae7689aa561'],47,90,137,16623567,10,0,0,0,14710
ed241cd753efd40720d205d90e0ea54c46b0f9ee,1,GitHub,2021-06-26 23:32:49+08:00,['cc5a56d63a13cdc33882619a04e0b112e78f9407'],242,1431,1673,16625240,65,0.501240695,0.610421836,0.928039702,14719
a6d4372639dce414829eb31d16dd51368c452b2a,0,Xiaoxiang Yu,2021-06-27 15:52:06+08:00,['ed241cd753efd40720d205d90e0ea54c46b0f9ee'],1,5,6,16625246,1,0,0,1,14719
401e9b49d160cda23f9d7015d0c94a64296be6c3,0,Xiaoxiang Yu,2021-06-27 15:52:06+08:00,['a6d4372639dce414829eb31d16dd51368c452b2a'],22,2,24,16625270,1,0,0,0,14719
f0c479686f7f3584198f5ce4b485aaf4775e599e,0,Xiaoxiang Yu,2021-06-27 15:52:06+08:00,['401e9b49d160cda23f9d7015d0c94a64296be6c3'],1,32,33,16625303,2,0.142857143,1,1,14719
1e43119b58ab4cdad4484ae58a795fc27b68ec8e,0,Xiaoxiang Yu,2021-06-27 15:52:06+08:00,['f0c479686f7f3584198f5ce4b485aaf4775e599e'],6,66,72,16625375,1,,,,14719
a33666183192aa36886b139c5eb3cffa6c3e1c7e,0,Xiaoxiang Yu,2021-06-27 15:52:06+08:00,['1e43119b58ab4cdad4484ae58a795fc27b68ec8e'],14,39,53,16625428,3,0.222222222,1,1,14719
53d4d2ba9129d6e9297cf00c9d10db0590344ba3,0,Xiaoxiang Yu,2021-06-27 15:52:06+08:00,['a33666183192aa36886b139c5eb3cffa6c3e1c7e'],4,0,4,16625432,1,0.25,0,0.25,14719
e42cc235153f7e8302dabd3207beb945b510d628,0,Xiaoxiang Yu,2021-06-27 15:52:06+08:00,['53d4d2ba9129d6e9297cf00c9d10db0590344ba3'],0,12,12,16625444,2,1,1,1,14719
4846b3849db5fcc121a79625ae2b3a159fb3e1b6,0,Xiaoxiang Yu,2021-06-27 15:52:06+08:00,['e42cc235153f7e8302dabd3207beb945b510d628'],1,1,2,16625446,1,,,,14719
adb8407544a77495bb36a3bea5a19d1cccfb1f81,0,Xiaoxiang Yu,2021-06-27 15:52:06+08:00,['4846b3849db5fcc121a79625ae2b3a159fb3e1b6'],0,2,2,16625448,1,0,0,1,14719
5c71764b7f3cba60cc707f8e0086ebae04edf840,0,Xiaoxiang Yu,2021-06-27 15:52:06+08:00,['adb8407544a77495bb36a3bea5a19d1cccfb1f81'],13,13,26,16625474,1,,,,14719
2d4010953f6c9c57ecbdccf9a3d5d20879986003,0,Xiaoxiang Yu,2021-06-27 15:52:06+08:00,['5c71764b7f3cba60cc707f8e0086ebae04edf840'],5,14,19,16625493,2,0,1,1,14719
13fd437297101c70fc21669f0fbadcbc1926fa0d,0,Xiaoxiang Yu,2021-06-27 15:52:06+08:00,['2d4010953f6c9c57ecbdccf9a3d5d20879986003'],1,1,2,16625495,1,,,,14719
57687830f6455d9e15a5801994213b663b93849c,0,Xiaoxiang Yu,2021-06-27 15:52:06+08:00,['13fd437297101c70fc21669f0fbadcbc1926fa0d'],0,23,23,16625518,1,,,,14719
f7f9d7899e2e9c3a4e22fbeb9e3a037035047fde,0,Xiaoxiang Yu,2021-06-27 15:52:06+08:00,['57687830f6455d9e15a5801994213b663b93849c'],1,5,6,16625524,2,,,,14719
4c4caf114421cb407450e02f1e5fb12dff15a6f4,0,Xiaoxiang Yu,2021-06-27 15:52:06+08:00,['f7f9d7899e2e9c3a4e22fbeb9e3a037035047fde'],8,8,16,16625540,2,,,,14719
fcbbc258926ce8ccbe5f334ad5e52f72949fe2f9,0,Xiaoxiang Yu,2021-06-27 15:52:06+08:00,['4c4caf114421cb407450e02f1e5fb12dff15a6f4'],0,24,24,16625564,1,0.055555556,1,1,14719
9d671222709827ccc3d8f1052625f357c788dc85,0,Xiaoxiang Yu,2021-06-27 15:52:06+08:00,['fcbbc258926ce8ccbe5f334ad5e52f72949fe2f9'],2,444,446,16626010,8,0.625615764,1,1,14724
fed858c976bb0477878d702cc495f9ca028da5d7,0,Xiaoxiang Yu,2021-06-27 15:52:06+08:00,['9d671222709827ccc3d8f1052625f357c788dc85'],5,31,36,16626046,2,0.833333333,0.833333333,1,14724
ba86987e32e572610faf0f690ae9601bd774d55a,0,Xiaoxiang Yu,2021-06-27 15:52:06+08:00,['fed858c976bb0477878d702cc495f9ca028da5d7'],3,4,7,16626053,1,1,1,1,14724
2bd7355ea14c04ffdd262b94b1bc7d9e5f326488,0,Xiaoxiang Yu,2021-06-27 15:52:06+08:00,['ba86987e32e572610faf0f690ae9601bd774d55a'],451,667,1118,16627171,34,0.214285714,0.464285714,0.720238095,14726
f5b0829b724e7847d8f8b0987dcec54d63b26182,0,Xiaoxiang Yu,2021-06-27 15:52:06+08:00,['2bd7355ea14c04ffdd262b94b1bc7d9e5f326488'],0,13,13,16627184,1,,,,14726
1948031acb899cf30e7f4c27fb5f5a2c65371e9e,0,Xiaoxiang Yu,2021-06-27 15:52:06+08:00,['f5b0829b724e7847d8f8b0987dcec54d63b26182'],1,8,9,16627193,2,0.6,0.6,1,14726
b3b963bbe4d91330455cf129e40a25e965c13e5d,0,Xiaoxiang Yu,2021-06-27 15:52:06+08:00,['1948031acb899cf30e7f4c27fb5f5a2c65371e9e'],44,42,86,16627279,7,0,0.5,0,14726
8c56af13fc998e6e4846b8d370a9bb82fd88527c,0,Xiaoxiang Yu,2021-06-27 15:52:06+08:00,['b3b963bbe4d91330455cf129e40a25e965c13e5d'],1,24,25,16627304,2,1,1,1,14726
47585640987fcc05babcc02b6455ee882b580c02,0,Xiaoxiang Yu,2021-06-27 15:52:06+08:00,['8c56af13fc998e6e4846b8d370a9bb82fd88527c'],0,641,641,16627945,1,0.574074074,0.651234568,0.922839506,14727
66840a964ce54cfb06c3b231762d863f136fcd80,0,Xiaoxiang Yu,2021-06-27 15:52:06+08:00,['47585640987fcc05babcc02b6455ee882b580c02'],1,29,30,16627975,3,1,1,1,14727
540e861102fa4cacd5ef257b742b2385ed3d42f9,0,Xiaoxiang Yu,2021-06-27 15:52:06+08:00,['66840a964ce54cfb06c3b231762d863f136fcd80'],4,14,18,16627993,1,1,1,1,14727
ec0e538534df66bb05f05ecb70c7a99049b60f44,0,Xiaoxiang Yu,2021-06-27 15:52:06+08:00,['540e861102fa4cacd5ef257b742b2385ed3d42f9'],10,0,10,16628003,1,0,0,0,14727
261f0cb735b0f48eb5a769aaf3412fc3f6e59af9,0,Xiaoxiang Yu,2021-06-27 15:52:06+08:00,['ec0e538534df66bb05f05ecb70c7a99049b60f44'],1,279,280,16628283,7,0.538461538,0.723076923,0.907692308,14731
dd8436eb7cf1eac6491b619d7716cb96bbeeae27,0,Xiaoxiang Yu,2021-06-27 15:52:06+08:00,['261f0cb735b0f48eb5a769aaf3412fc3f6e59af9'],1,1,2,16628285,1,,,,14731
6c7b63726c356f65d7d81fb780acbe5ef85cb03f,1,Xiaoxiang Yu,2021-06-27 15:52:06+08:00,['dd8436eb7cf1eac6491b619d7716cb96bbeeae27'],6,39,45,16628330,6,1,1,1,14731
b99ac75e2f2c3285a28918e2d00bb4a401e1f155,0,Xiaoxiang Yu,2021-06-27 15:52:06+08:00,['6c7b63726c356f65d7d81fb780acbe5ef85cb03f'],1,1,2,16628332,1,,,,14731
277202a04e4cad4a1473301fb0299bab2270bc91,0,Xiaoxiang Yu,2021-06-27 15:52:06+08:00,['b99ac75e2f2c3285a28918e2d00bb4a401e1f155'],2,2,4,16628336,1,,,,14731
fdd45a616de42bd50c8b5c4d71a29a660d310167,0,Xiaoxiang Yu,2021-06-27 15:52:06+08:00,['277202a04e4cad4a1473301fb0299bab2270bc91'],8,32,40,16628376,2,1,1,1,14731
b996b7b8c3d4c6c81193962edda6540a94a3bd4f,0,Xiaoxiang Yu,2021-06-27 15:52:06+08:00,['fdd45a616de42bd50c8b5c4d71a29a660d310167'],7,362,369,16628745,6,0.334677419,0.282258065,0.790322581,14732
9fa49f324a898d484cc10cb9426b12cd5c9b9ec9,0,Xiaoxiang Yu,2021-06-27 15:52:06+08:00,['b996b7b8c3d4c6c81193962edda6540a94a3bd4f'],3,10,13,16628758,1,0,0.333333333,1,14732
245ed3030a8d7339c84b279d327cbe45e9dfc370,0,Xiaoxiang Yu,2021-06-27 15:52:06+08:00,['9fa49f324a898d484cc10cb9426b12cd5c9b9ec9'],19,2405,2424,16631182,25,0.39223301,0.53592233,1,14744
10d901d6ec7bb80d898491cae6dde550d1bddc2d,1,Xiaoxiang Yu,2021-06-27 15:52:06+08:00,['245ed3030a8d7339c84b279d327cbe45e9dfc370'],129,146,275,16631457,13,1,0,0,14745
eb678cd18b50f817b4d88fd2c1d31aea675c1728,0,Xiaoxiang Yu,2021-06-27 15:52:06+08:00,['10d901d6ec7bb80d898491cae6dde550d1bddc2d'],0,20,20,16631477,20,,,,14745
52c48f97f18d168d9817cc6fa454e93ddb5a473b,0,Xiaoxiang Yu,2021-06-27 15:52:06+08:00,['eb678cd18b50f817b4d88fd2c1d31aea675c1728'],1,48,49,16631526,2,0,0,0.5,14745
3f54272f94c8718d0c6417d4e26c1729ba40bd9d,0,Xiaoxiang Yu,2021-06-27 15:52:06+08:00,['52c48f97f18d168d9817cc6fa454e93ddb5a473b'],0,6,6,16631532,1,,,,14745
ee0f48b09de0652eb942bdee66116e14a5cc5aa7,0,Xiaoxiang Yu,2021-06-27 15:52:06+08:00,['3f54272f94c8718d0c6417d4e26c1729ba40bd9d'],4,68,72,16631604,3,1,1,1,14746
7cf7a20e918d5aa53b40614c2fae1b18db8dd2fd,0,Xiaoxiang Yu,2021-06-27 15:52:06+08:00,['ee0f48b09de0652eb942bdee66116e14a5cc5aa7'],1,42,43,16631647,1,,,,14746
fc6508ff3b44410661c1824c73fc248954d7073b,0,Xiaoxiang Yu,2021-06-27 15:52:06+08:00,['7cf7a20e918d5aa53b40614c2fae1b18db8dd2fd'],1,9,10,16631657,1,0,1,1,14746
6dc7948f45f7e6b03a0c8c646083891ea14cf1f2,0,Xiaoxiang Yu,2021-06-27 15:52:06+08:00,['fc6508ff3b44410661c1824c73fc248954d7073b'],1,1,2,16631659,1,,,,14746
9f8eec31953d18696d4abb83cd2cfb9a22f5e2a7,1,Xiaoxiang Yu,2021-06-27 15:52:06+08:00,['6dc7948f45f7e6b03a0c8c646083891ea14cf1f2'],1,1,2,16631661,1,,,,14746
e769f1cc19a03fba9d3792c5f1d302457c4038a3,0,Xiaoxiang Yu,2021-06-27 15:52:06+08:00,['9f8eec31953d18696d4abb83cd2cfb9a22f5e2a7'],1,1,2,16631663,1,,,,14746
9e9a91a183fa045160765bc89052fb721c4307a9,0,Xiaoxiang Yu,2021-06-27 15:52:06+08:00,['e769f1cc19a03fba9d3792c5f1d302457c4038a3'],0,3,3,16631666,1,,,,14746
367fa70b6582123bd10f919813fdf543c87e19d9,0,Xiaoxiang Yu,2021-06-27 15:52:06+08:00,['9e9a91a183fa045160765bc89052fb721c4307a9'],0,25,25,16631691,2,1,1,1,14746
329affee0c84044389a674314897816c26208676,0,Xiaoxiang Yu,2021-06-27 15:52:06+08:00,['367fa70b6582123bd10f919813fdf543c87e19d9'],0,3,3,16631694,1,0,0,0,14746
1402d96b39a09c6ed9c04f4a9ca2fbd18ee4c401,0,Xiaoxiang Yu,2021-06-27 15:52:06+08:00,['329affee0c84044389a674314897816c26208676'],0,3,3,16631697,1,1,1,1,14746
093399f82ca872d217b3f941742847e84302eded,0,Xiaoxiang Yu,2021-06-27 15:52:06+08:00,['1402d96b39a09c6ed9c04f4a9ca2fbd18ee4c401'],10,60,70,16631767,6,1,1,1,14746
fbcfa3cf1c4f3fe77b622574025a0a23ad169e62,0,Xiaoxiang Yu,2021-06-27 15:52:06+08:00,['093399f82ca872d217b3f941742847e84302eded'],0,2,2,16631769,1,,,,14746
38569190b3cbc1432b9f97fc0146a99143e39c50,0,Xiaoxiang Yu,2021-06-27 15:52:06+08:00,['fbcfa3cf1c4f3fe77b622574025a0a23ad169e62'],10,334,344,16632113,15,0.412935323,0.646766169,0.980099502,14746
666cce471a4bb8077c29bb9d7c03a15888e25a4b,0,Xiaoxiang Yu,2021-06-27 15:52:06+08:00,['38569190b3cbc1432b9f97fc0146a99143e39c50'],17,11,28,16632141,2,0.142857143,0,0,14746
a055639a733ff8912c63032af5a4a4ca761f6f72,0,Xiaoxiang Yu,2021-06-27 15:52:06+08:00,['666cce471a4bb8077c29bb9d7c03a15888e25a4b'],5,5,10,16632151,2,,,,14746
61497c97f980b9ff4b6673ed6e2b8859a4cfae56,0,Xiaoxiang Yu,2021-06-27 15:52:06+08:00,['a055639a733ff8912c63032af5a4a4ca761f6f72'],2,2,4,16632155,2,1,1,1,14746
19dd0b8406dc6370f6df6e5cc76b0c854785a787,0,Xiaoxiang Yu,2021-06-27 15:52:06+08:00,['61497c97f980b9ff4b6673ed6e2b8859a4cfae56'],0,9,9,16632164,1,0.5,0.5,1,14746
05a7bed1655a342915fc591013314f052090d7af,0,Xiaoxiang Yu,2021-06-27 15:52:06+08:00,['19dd0b8406dc6370f6df6e5cc76b0c854785a787'],7,88,95,16632259,2,0.761904762,1,0.746031746,14746
cf782f6f2c311d5e6acbb5dc86dcbff8acfcbe94,0,Xiaoxiang Yu,2021-06-27 15:52:06+08:00,['05a7bed1655a342915fc591013314f052090d7af'],0,6,6,16632265,1,0,0,1,14746
7b07d714f61ff641fe64d33622d341bf0eb2a356,0,Xiaoxiang Yu,2021-06-27 15:52:06+08:00,['cf782f6f2c311d5e6acbb5dc86dcbff8acfcbe94'],0,1,1,16632266,1,0,0,0,14746
e2635c1763d25fdd9d7fb629670a1fce59edad1e,0,Xiaoxiang Yu,2021-06-27 15:52:06+08:00,['7b07d714f61ff641fe64d33622d341bf0eb2a356'],29,55,84,16632350,3,0.65,1,0.9,14746
eff7d420875977a2d8dc9738bd3dc4c1f608b589,0,Xiaoxiang Yu,2021-06-27 15:52:06+08:00,['e2635c1763d25fdd9d7fb629670a1fce59edad1e'],0,2,2,16632352,2,,,,14746
7abab14aad868e092f0479a600aa6002c04985f3,0,Xiaoxiang Yu,2021-06-27 15:52:06+08:00,['eff7d420875977a2d8dc9738bd3dc4c1f608b589'],59,186,245,16632597,3,0.833333333,1,0.833333333,14746
e78d38ece43f4f41a34588bd922326a932d5c96a,0,Xiaoxiang Yu,2021-06-27 15:52:06+08:00,['7abab14aad868e092f0479a600aa6002c04985f3'],224,236,460,16633057,32,0.5,1,1,14746
9a880c47b4c6dc6db47a6ea8c8cb0635f6ff3a82,0,Xiaoxiang Yu,2021-06-27 15:52:06+08:00,['e78d38ece43f4f41a34588bd922326a932d5c96a'],1,3,4,16633061,1,0,0,1,14746
1ca9d9bd2521c1b1156be8c0882d446d1801b42b,0,Xiaoxiang Yu,2021-06-27 15:52:06+08:00,['9a880c47b4c6dc6db47a6ea8c8cb0635f6ff3a82'],1,3,4,16633065,1,0,0,1,14746
b9a1950c04a24916fc1507fcd7614502cd5ee02a,0,Xiaoxiang Yu,2021-06-27 15:52:06+08:00,['1ca9d9bd2521c1b1156be8c0882d446d1801b42b'],475,183,658,16633723,5,1,1,1,14746
8a8f574e7c56f4a0131f8b0f938e58dc98238a72,0,Xiaoxiang Yu,2021-06-27 15:52:06+08:00,['b9a1950c04a24916fc1507fcd7614502cd5ee02a'],2,4,6,16633729,2,,,,14746
5cffdfb3fa92c159f57730f02b89785d15839f43,0,Xiaoxiang Yu,2021-06-27 15:52:06+08:00,['8a8f574e7c56f4a0131f8b0f938e58dc98238a72'],7,48,55,16633784,2,1,1,1,14746
7294e6dd4d7b546f1bc480e7c074c3518cbcd97c,0,Xiaoxiang Yu,2021-06-27 15:52:06+08:00,['5cffdfb3fa92c159f57730f02b89785d15839f43'],1,1,2,16633786,1,,,,14746
f82397d941a318d0dddf475ebf4b171de859b2ae,0,Xiaoxiang Yu,2021-06-27 15:52:06+08:00,['7294e6dd4d7b546f1bc480e7c074c3518cbcd97c'],3,3,6,16633792,2,,,,14746
760636cc854da9790e993d43d7e41c7b0e34c58c,0,Xiaoxiang Yu,2021-06-27 15:52:06+08:00,['f82397d941a318d0dddf475ebf4b171de859b2ae'],1,1,2,16633794,1,,,,14746
faf9c3dc891ac13a917771e3561298ac05efe720,0,Xiaoxiang Yu,2021-06-27 15:52:06+08:00,['760636cc854da9790e993d43d7e41c7b0e34c58c'],3,160,163,16633957,3,0.174242424,0.901515152,1,14746
800cb647b205f0d97917e00bdee991e29b0ba3c6,0,Xiaoxiang Yu,2021-06-27 15:52:06+08:00,['faf9c3dc891ac13a917771e3561298ac05efe720'],2,2,4,16633961,1,,,,14746
156db2afaa06dcfd7990e9d828cc9db0e6344ec9,0,Xiaoxiang Yu,2021-06-27 15:52:06+08:00,['800cb647b205f0d97917e00bdee991e29b0ba3c6'],1,1,2,16633963,1,,,,14746
f4d1a9b2a857709a0a00fbb585315d97ce92bc29,0,Xiaoxiang Yu,2021-06-27 15:52:06+08:00,['156db2afaa06dcfd7990e9d828cc9db0e6344ec9'],0,1,1,16633964,1,,,,14746
229a960ce8543a4f825403ce022ee8291a5a8d8a,0,Xiaoxiang Yu,2021-06-27 15:52:06+08:00,['f4d1a9b2a857709a0a00fbb585315d97ce92bc29'],3,3,6,16633970,1,,,,14746
586fb9c74e87c5bfafa9b397bb11dc506ef4aba9,0,Xiaoxiang Yu,2021-06-27 15:52:06+08:00,['229a960ce8543a4f825403ce022ee8291a5a8d8a'],1,1,2,16633972,1,,,,14746
cae7ce5ff0b32f0ff402e1e37419a82afeb12120,0,Xiaoxiang Yu,2021-06-27 15:52:06+08:00,['586fb9c74e87c5bfafa9b397bb11dc506ef4aba9'],10,316,326,16634298,4,0.368983957,0.556149733,0.807486631,14748
61754a4f05c7d9899dfa4a822e22b1567c798987,0,Xiaoxiang Yu,2021-06-27 15:52:06+08:00,['cae7ce5ff0b32f0ff402e1e37419a82afeb12120'],3,8,11,16634309,1,,,,14748
a0ed13d6e57843477579060f21b0d3cb14098abe,0,Xiaoxiang Yu,2021-06-27 15:52:06+08:00,['61754a4f05c7d9899dfa4a822e22b1567c798987'],1,4,5,16634314,1,0.666666667,0.666666667,0.666666667,14748
3f20bb3cafe5f086d611521ce2df34274b57a5bc,0,Xiaoxiang Yu,2021-06-27 15:52:06+08:00,['a0ed13d6e57843477579060f21b0d3cb14098abe'],68,117,185,16634499,2,,,,14748
b10dd933954076d74caf762157b5971bc76854db,0,Xiaoxiang Yu,2021-06-27 15:52:06+08:00,['3f20bb3cafe5f086d611521ce2df34274b57a5bc'],1,6,7,16634506,2,1,1,1,14748
e2ad2996dcaaf7420ed25eec746bb0da3617168e,0,Xiaoxiang Yu,2021-06-27 15:52:06+08:00,['b10dd933954076d74caf762157b5971bc76854db'],0,4,4,16634510,1,1,1,1,14748
3e73e421322e9e42f669c4a2a7510de3755b3558,0,Xiaoxiang Yu,2021-06-27 15:52:06+08:00,['e2ad2996dcaaf7420ed25eec746bb0da3617168e'],6,14,20,16634530,3,1,1,1,14748
2f07fd133027bd7f02b710baa766fb5f6116a88e,0,Xiaoxiang Yu,2021-06-27 15:52:06+08:00,['3e73e421322e9e42f669c4a2a7510de3755b3558'],0,55,55,16634585,3,0.5,1,1,14748
310593370b99b7ec86c652709dc9fec125f30b87,0,Xiaoxiang Yu,2021-06-27 15:52:06+08:00,['2f07fd133027bd7f02b710baa766fb5f6116a88e'],8,46,54,16634639,2,0,0,1,14748
4c523b13b90477f143fcc20178736a7a2367ebf0,0,Xiaoxiang Yu,2021-06-27 15:52:06+08:00,['310593370b99b7ec86c652709dc9fec125f30b87'],1,1,2,16634641,1,,,,14748
25db0b67e09f56fc646cbaaa8e05d0370275a539,0,Xiaoxiang Yu,2021-06-27 15:52:06+08:00,['4c523b13b90477f143fcc20178736a7a2367ebf0'],10,8,18,16634659,2,,,,14748
21df0af823359e5288dd880a49996d941ad1a25c,0,Xiaoxiang Yu,2021-06-27 15:52:06+08:00,['25db0b67e09f56fc646cbaaa8e05d0370275a539'],2,3,5,16634664,1,0,0,1,14748
50eb7be759a3532b39b67fe0f7963f33e97fbe83,0,Xiaoxiang Yu,2021-06-27 15:52:06+08:00,['21df0af823359e5288dd880a49996d941ad1a25c'],0,12,12,16634676,1,0,1,1,14748
6621a2aaa750540054fe6951dcfacf5fbaabb166,0,Xiaoxiang Yu,2021-06-27 15:52:06+08:00,['50eb7be759a3532b39b67fe0f7963f33e97fbe83'],4,148,152,16634828,4,0.864197531,0.864197531,0.913580247,14749
f478294a6dad7523b6496dabd3c91a0d507da866,0,Xiaoxiang Yu,2021-06-27 15:52:06+08:00,['6621a2aaa750540054fe6951dcfacf5fbaabb166'],153,16,169,16634997,7,0,0,0,14749
ec962036bd84cff9934ca28ba5d859683f0307d6,0,Xiaoxiang Yu,2021-06-27 15:52:06+08:00,['f478294a6dad7523b6496dabd3c91a0d507da866'],2,17,19,16635016,2,1,1,1,14749
f5fbe9e0c64935ae3284c8e877c1834f0a3d3663,0,Xiaoxiang Yu,2021-06-27 15:52:06+08:00,['ec962036bd84cff9934ca28ba5d859683f0307d6'],667,451,1118,16636134,34,0.785714286,0.535714286,0.279761905,14750
68dd4073bf120dcb9ec47b8e7a6932c14be36f36,0,Xiaoxiang Yu,2021-06-27 15:52:06+08:00,['f5fbe9e0c64935ae3284c8e877c1834f0a3d3663'],1,2,3,16636137,1,,,,14750
7fa1b9d8d1651198d23c177f4aa1b41fbb1536ca,0,Xiaoxiang Yu,2021-06-27 15:52:06+08:00,['68dd4073bf120dcb9ec47b8e7a6932c14be36f36'],1,1,2,16636139,1,,,,14750
914b97f5cf2347030525140038d060178b93f955,0,GitHub,2021-06-27 21:34:55+08:00,['7fa1b9d8d1651198d23c177f4aa1b41fbb1536ca'],18,186,204,16636343,11,0.056074766,0.682242991,0.91588785,14750
e9291e3b232cb628bbfa8dc9fc21fbab1d491a19,0,Xiaoxiang Yu,2021-07-05 20:59:03+08:00,['914b97f5cf2347030525140038d060178b93f955'],2668,1709,4377,16640720,38,0.583280153,0.255902999,0.273771538,14750
dc499be71bdfa03e5fe10c9f46fbce51f7c1defd,0,Xiaoxiang Yu,2021-07-06 13:43:32+08:00,['e9291e3b232cb628bbfa8dc9fc21fbab1d491a19'],1714,2673,4387,16645107,38,0.416719847,0.744097001,0.726228462,14753
2e7a4ea307764ca08ac2d2840c7147ab1c9290cc,1,Xiaoxiang Yu,2021-07-09 13:48:43+08:00,['dc499be71bdfa03e5fe10c9f46fbce51f7c1defd'],0,5,5,16645112,2,1,1,1,14753
b2016f915db454e64b7018047b3df5c707d7946c,0,Xiaoxiang Yu,2021-07-12 13:47:50+08:00,['2e7a4ea307764ca08ac2d2840c7147ab1c9290cc'],8,582,590,16645702,11,0.341666667,0.733333333,0.716666667,14759
c51b481e1c6006142c4b04d8957cbd3daa0e8f6b,0,Xiaoxiang Yu,2021-07-13 10:48:56+08:00,['b2016f915db454e64b7018047b3df5c707d7946c'],1,10,11,16645713,4,,,,14759
4100e5007624ae29b8e5e97319261064896ea699,0,GitHub,2021-07-16 18:16:13+08:00,['c51b481e1c6006142c4b04d8957cbd3daa0e8f6b'],1,4,5,16645718,1,0,0,1,14759
a9ad60ae86b35f52302160bb50b47a2bc6c87bec,0,Xiaoxiang Yu,2021-07-19 17:52:45+08:00,['4100e5007624ae29b8e5e97319261064896ea699'],1,7,8,16645726,1,0,0,0,14759
133bfb8020ebc50fe712f0745e961c5dea51f072,0,GitHub,2021-07-26 11:05:42+08:00,['a9ad60ae86b35f52302160bb50b47a2bc6c87bec'],2,20,22,16645748,2,,,,14760
c2f261b09c17db9b7e9ee21117c5c7d783811fab,0,Xiaoxiang Yu,2021-07-27 10:08:48+08:00,['133bfb8020ebc50fe712f0745e961c5dea51f072'],7,25,32,16645780,4,0.647058824,0.705882353,1,14760
27d9ee032751aee36a1f4b6d6e615f41ac94eed2,0,Xiaoxiang Yu,2021-07-27 10:09:24+08:00,['c2f261b09c17db9b7e9ee21117c5c7d783811fab'],1,74,75,16645855,4,0.75,0.75,1,14762
9f7e5316effee916605cb883f9accfa46b849071,0,GitHub,2021-07-27 17:18:04+08:00,['27d9ee032751aee36a1f4b6d6e615f41ac94eed2'],24,55,79,16645934,10,0,0,,14762
f1436a3ea2610a2f41b7b0b89f2db87dd9999909,0,Xiaoxiang Yu,2021-07-29 19:33:10+08:00,['9f7e5316effee916605cb883f9accfa46b849071'],1,15,16,16645950,1,0,1,1,14762
6007f8577aaa52b45fb3ad56034a641c90bf4414,0,GitHub,2021-08-02 20:05:56+08:00,['f1436a3ea2610a2f41b7b0b89f2db87dd9999909'],1797,562,2359,16648309,40,0.664375716,0.357388316,0.422680412,14762
33c068fd66a028a174a15acb28bbca8394903f28,0,GitHub,2021-08-07 13:20:55+08:00,['6007f8577aaa52b45fb3ad56034a641c90bf4414'],13,12,25,16648334,5,0,0,0,14762
5312bac727e5d64bfa7be999de0d2bddc273a3b8,0,Xiaoxiang Yu,2021-08-09 11:27:06+08:00,['33c068fd66a028a174a15acb28bbca8394903f28'],167,119,286,16648620,11,0.535714286,0,0.821428571,14762
b207ca1666213807177a4a6ae711efecb4ac9cbc,0,Xiaoxiang Yu,2021-08-10 13:38:13+08:00,['5312bac727e5d64bfa7be999de0d2bddc273a3b8'],7,1,8,16648628,2,0,0,0,14762
6416ea0f426ccfa60bed707693bccc0e7676eac2,0,Xiaoxiang Yu,2021-08-11 09:52:36+08:00,['b207ca1666213807177a4a6ae711efecb4ac9cbc'],4,4,8,16648636,1,,,,14762
95888c867c40a58866a99ae3738a5d0e58eb3b30,0,GitHub,2021-08-11 09:52:51+08:00,['6416ea0f426ccfa60bed707693bccc0e7676eac2'],3,1,4,16648640,1,1,0,1,14762
e0de52432f3d9e253ac3a581f9f8e389e67afc86,0,GitHub,2021-08-11 09:53:06+08:00,['95888c867c40a58866a99ae3738a5d0e58eb3b30'],1,7,8,16648648,1,0.857142857,1,1,14762
45a7889eccf8acf7bc14890a7b930a12adebd463,0,GitHub,2021-08-11 09:53:15+08:00,['e0de52432f3d9e253ac3a581f9f8e389e67afc86'],6,8,14,16648662,2,0,1,0.5,14762
1dd5aa71406443b4e58e6eb87c40cc09204841a4,0,Xiaoxiang Yu,2021-08-11 11:03:13+08:00,['45a7889eccf8acf7bc14890a7b930a12adebd463'],0,9,9,16648671,1,,,,14762
7370489ed53c044841955d9481a6fe00035aa697,0,Zhichao Zhang,2021-08-11 15:31:03+08:00,['1dd5aa71406443b4e58e6eb87c40cc09204841a4'],3,4,7,16648678,1,,,,14762
a6ac84e37b959efef3dbe7324268f50fba5b7ecc,0,Zhichao Zhang,2021-08-11 15:31:03+08:00,['7370489ed53c044841955d9481a6fe00035aa697'],1,1,2,16648680,1,,,,14762
3a0aadf785d3ff6fd1e3393f79d830527c1cbeec,0,Zhichao Zhang,2021-08-11 23:20:48+08:00,['a6ac84e37b959efef3dbe7324268f50fba5b7ecc'],0,1,1,16648681,1,0,0,1,14762
d34f08594db97d0f175144f0190e782e11f2b9b5,0,Xiaoxiang Yu,2021-08-12 10:00:52+08:00,['3a0aadf785d3ff6fd1e3393f79d830527c1cbeec'],548,4,552,16649233,3,0.417857143,0.342857143,0.1,14762
23365b6cae8939e6bbefb328d1c80d4236afda34,0,Zhichao Zhang,2021-08-12 19:55:30+08:00,['d34f08594db97d0f175144f0190e782e11f2b9b5'],3,6,9,16649242,1,0,0,1,14762
9797e4c339d041c344a25a0b92c3763bd5b0e184,1,GitHub,2021-08-16 08:40:58+08:00,['23365b6cae8939e6bbefb328d1c80d4236afda34'],244,711,955,16650197,30,1,0,1,14776
94b109f363629a8829e9a90ac6f8853c6fd961b0,0,Xiaoxiang Yu,2021-08-17 21:45:48+08:00,['9797e4c339d041c344a25a0b92c3763bd5b0e184'],3,40,43,16650240,3,0.290322581,0,0.870967742,14776
a7b7edba90e8810bad3b9a76cbf64241da8de4b5,0,GitHub,2021-08-18 12:52:13+08:00,['94b109f363629a8829e9a90ac6f8853c6fd961b0'],67,134,201,16650441,8,0.052631579,0.105263158,0.894736842,14776
a7623eb811389449560fb7e0c295bbf69ee40e08,0,Xiaoxiang Yu,2021-09-02 10:13:28+08:00,['a7b7edba90e8810bad3b9a76cbf64241da8de4b5'],28,28,56,16650497,3,,,,14776
57f6a272c96af7d5ee8cb2e035376fe452c57c35,0,Xiaoxiang Yu,2021-09-02 14:06:35+08:00,['a7623eb811389449560fb7e0c295bbf69ee40e08'],32,35,67,16650564,6,,,,14776
b4c857eda293a9a71e4f3e0841e62ef49cbe66c0,0,Xiaoxiang Yu,2021-09-08 16:31:54+08:00,['57f6a272c96af7d5ee8cb2e035376fe452c57c35'],0,23,23,16650587,1,,,,14776
bf02b8c2d33bfd27cc29d4ce8fd5faff92be9c77,0,Xiaoxiang Yu,2021-09-09 21:50:42+08:00,['b4c857eda293a9a71e4f3e0841e62ef49cbe66c0'],20,98,118,16650705,7,0.780487805,0.780487805,0.609756098,14777
77526b253ad12e1c6f93520244a187f161e1638a,0,Xiaoxiang Yu,2021-09-18 13:50:35+08:00,['bf02b8c2d33bfd27cc29d4ce8fd5faff92be9c77'],3,29,32,16650737,3,0.72,0.84,1,14777
93671dfb0a2d3d21025e1dbf1e872daf0e217cc5,0,Xiaoxiang Yu,2021-09-18 13:56:04+08:00,['77526b253ad12e1c6f93520244a187f161e1638a'],1,7,8,16650745,1,1,1,1,14777
df6dd4726a90fdabb4dc4e04daacbee8f206b782,0,Xiaoxiang Yu,2021-09-18 15:10:21+08:00,['93671dfb0a2d3d21025e1dbf1e872daf0e217cc5'],9,15,24,16650769,4,0,1,1,14777
5187affe180fc88a8422cc193097d1ef9614ce89,1,Xiaoxiang Yu,2021-11-01 11:57:32+08:00,['df6dd4726a90fdabb4dc4e04daacbee8f206b782'],1371,437,1808,16652577,19,0.538461538,0.366863905,0.023668639,14780
e9e12a5edcfc9cbb25ab334ec160f9a6f2c656eb,0,Xiaoxiang Yu,2021-11-04 11:50:08+08:00,['5187affe180fc88a8422cc193097d1ef9614ce89'],1,1,2,16652579,1,,,,14780
d9a5c70136c29b77f981058c7166492ce53ea2a4,0,Xiaoxiang Yu,2021-11-04 16:15:40+08:00,['e9e12a5edcfc9cbb25ab334ec160f9a6f2c656eb'],4,513,517,16653096,12,0.564202335,0.79766537,0.766536965,14785
01cc8f00316e5334b500596785eeef0ed21af2d5,0,Xiaoxiang Yu,2021-11-05 10:47:56+08:00,['d9a5c70136c29b77f981058c7166492ce53ea2a4'],4,11,15,16653111,2,,,,14785
529bb281d11133176f10bb37d12a343bee713b7c,0,Xiaoxiang Yu,2021-11-05 10:47:56+08:00,['01cc8f00316e5334b500596785eeef0ed21af2d5'],2,2,4,16653115,1,,,,14785
929014c70467eb7f90a72e2906826bed6c462201,0,Xiaoxiang Yu,2021-11-05 10:47:56+08:00,['529bb281d11133176f10bb37d12a343bee713b7c'],16,24,40,16653155,1,,,,14785
12aeea918df9a0065cd1f507a67dbf271de45336,0,GitHub,2021-11-08 15:17:57+08:00,['929014c70467eb7f90a72e2906826bed6c462201'],6,32,38,16653193,3,0,0,1,14786
63a106813db149893e9a2ecae762698b23322ae8,0,Xiaoxiang Yu,2021-11-09 09:49:45+08:00,['12aeea918df9a0065cd1f507a67dbf271de45336'],2,2,4,16653197,1,,,,14786
07a749068939bdbaf633b8cb3fd0bd4803ff1906,0,Xiaoxiang Yu,2021-11-10 13:57:12+08:00,['63a106813db149893e9a2ecae762698b23322ae8'],7,16,23,16653220,4,0.166666667,0.166666667,1,14786
c99b98270bb9cab357fd7cc45df83b3678dca870,0,Xiaoxiang Yu,2021-11-10 13:59:46+08:00,['07a749068939bdbaf633b8cb3fd0bd4803ff1906'],1,1,2,16653222,1,,,,14786
8ed6d5d69a4b589d183bb679f511f8230daa09bf,0,Xiaoxiang Yu,2021-11-11 10:52:02+08:00,['c99b98270bb9cab357fd7cc45df83b3678dca870'],6,26,32,16653254,2,0.235294118,1,1,14786
1f63a3bd05c1a79102cfa3a13e61aadd6e423aea,0,Xiaoxiang Yu,2021-11-15 17:44:55+08:00,['8ed6d5d69a4b589d183bb679f511f8230daa09bf'],8,18,26,16653280,5,0,0,1,14786
93b82957e855b9e2545b7722dd1379e218f495cb,0,Xiaoxiang Yu,2021-11-15 17:45:50+08:00,['1f63a3bd05c1a79102cfa3a13e61aadd6e423aea'],3,2,5,16653285,1,,,,14786
6847d860056e9479b32d1cea8395cb689539203e,0,Xiaoxiang Yu,2021-11-17 14:15:10+08:00,['93b82957e855b9e2545b7722dd1379e218f495cb'],2,6,8,16653293,1,,,,14786
b7b77a3ee75219d152250a7592203e08db1f1c5b,0,Xiaoxiang Yu,2021-11-18 17:39:20+08:00,['6847d860056e9479b32d1cea8395cb689539203e'],4,9,13,16653306,1,0.25,0,1,14786
0db286ec3e5ae59d7b0311701d94bd0878a7668c,0,GitHub,2021-11-19 15:05:03+08:00,['b7b77a3ee75219d152250a7592203e08db1f1c5b'],1,1,2,16653308,1,,,,14786
cdc21bca775fd50ecb07bae05fa1ea56eac18882,0,GitHub,2021-11-19 20:38:53+08:00,['0db286ec3e5ae59d7b0311701d94bd0878a7668c'],1,5,6,16653314,1,0,0,1,14786
72c76651d573635fb74c66f79bebb81d52c2a1be,0,XiaoxiangYu,2021-12-07 10:58:19+08:00,['cdc21bca775fd50ecb07bae05fa1ea56eac18882'],5,2,7,16653321,1,1,1,0,14786
f4daf14dde99b934c92ce2c832509f24342bc845,0,XiaoxiangYu,2021-12-23 19:34:28+08:00,['72c76651d573635fb74c66f79bebb81d52c2a1be'],6,23,29,16653350,5,1,1,1,14786
c757d158d33837888f9b2f25746f347041ea3bf5,0,XiaoxiangYu,2022-01-05 11:49:36+08:00,['f4daf14dde99b934c92ce2c832509f24342bc845'],2,2,4,16653354,1,,,,14786
64d81cb72b1ff478544909b4bf3d0ff414988bb4,0,XiaoxiangYu,2022-01-05 11:49:36+08:00,['c757d158d33837888f9b2f25746f347041ea3bf5'],38,36,74,16653428,27,,,,14786
5fa5a0b06483735b988684f31086ab2990670e86,0,XiaoxiangYu,2022-01-05 11:49:36+08:00,['64d81cb72b1ff478544909b4bf3d0ff414988bb4'],33,33,66,16653494,27,,,,14786
a56732e8bdc55a45c9bffff015bd6a19f6832196,0,XiaoxiangYu,2022-01-19 16:09:57+08:00,['5fa5a0b06483735b988684f31086ab2990670e86'],1,28,29,16653523,2,,,,14787
a261311a3150210f6d957726d6bf3749b78321b8,0,XiaoxiangYu,2022-01-19 16:10:21+08:00,['a56732e8bdc55a45c9bffff015bd6a19f6832196'],2,2,4,16653527,1,,,,14787
ad36cf7a0d58ffa2de83db9a2bfc0c2c1110dab1,0,XiaoxiangYu,2022-01-19 16:10:21+08:00,['a261311a3150210f6d957726d6bf3749b78321b8'],1,1,2,16653529,1,,,,14787
dc3fd9ab25ecd03ec53f8855f5366db8de542ce5,0,XiaoxiangYu,2022-01-19 16:11:09+08:00,['ad36cf7a0d58ffa2de83db9a2bfc0c2c1110dab1'],139,110,249,16653778,5,0.142857143,0,0,14788
8365e66d81cd3f804a36571bed1892aa45360094,0,XiaoxiangYu,2022-01-19 16:11:09+08:00,['dc3fd9ab25ecd03ec53f8855f5366db8de542ce5'],0,18,18,16653796,1,,,,14788
9f8a07f0d07ad7cb6980e539ede9661e58718b20,0,XiaoxiangYu,2022-02-09 11:35:39+08:00,['8365e66d81cd3f804a36571bed1892aa45360094'],1,1,2,16653798,1,,,,14788
737f79edc0ef73ab780355f2a54f5898e5809ab3,0,XiaoxiangYu,2022-02-11 16:15:56+08:00,['9f8a07f0d07ad7cb6980e539ede9661e58718b20'],61,128,189,16653987,8,0.689655172,0.689655172,0.586206897,14789
121a8a1d9fadf988a45029caf39c6249a95d5ba9,0,XiaoxiangYu,2022-02-25 09:50:20+08:00,['737f79edc0ef73ab780355f2a54f5898e5809ab3'],1,1,2,16653989,1,,,,14789
0be292d8d9c53fd948258be3bd8a084b00bb3364,0,XiaoxiangYu,2022-03-07 10:48:29+08:00,['121a8a1d9fadf988a45029caf39c6249a95d5ba9'],0,190,190,16654179,9,0.574626866,0.574626866,0.597014925,14789
273fae822e4ce7e7c7434c4d1fccadb5bb9db719,0,XiaoxiangYu,2022-03-09 10:19:01+08:00,['0be292d8d9c53fd948258be3bd8a084b00bb3364'],19,399,418,16654597,11,0.27184466,0.86407767,0.616504854,14792
c29b8f5b5ffa4d33ea2120a4efe261a6fbab1b01,0,XiaoxiangYu,2022-03-09 10:22:39+08:00,['273fae822e4ce7e7c7434c4d1fccadb5bb9db719'],2,5,7,16654604,1,0,0,0,14792
d56d72f736db5ea52bcc9a672dd20dc6ee4aaaae,0,XiaoxiangYu,2022-03-10 13:52:50+08:00,['c29b8f5b5ffa4d33ea2120a4efe261a6fbab1b01'],4,10,14,16654618,1,0,0,1,14792
0fa41762ec0fc69c0b8029fc8a81b273388bbf1d,0,GitHub,2022-04-06 17:23:57+08:00,['d56d72f736db5ea52bcc9a672dd20dc6ee4aaaae'],5,5,10,16654628,1,,,,14792
fa8e0fccefdaab37e93ff83e1f7d19f3af19f47d,0,GitHub,2022-04-29 10:31:51+08:00,['0fa41762ec0fc69c0b8029fc8a81b273388bbf1d'],12,37,49,16654677,4,0.166666667,0.833333333,1,14792
a6941e35bda6a4d819b966c0c040b0931c84630f,0,XiaoxiangYu,2022-04-29 10:33:01+08:00,['fa8e0fccefdaab37e93ff83e1f7d19f3af19f47d'],16,54,70,16654747,6,0.230769231,0.884615385,1,14792
7f9171d36aab78ba1550dbbd8bcd072afeac85e4,0,GitHub,2022-05-05 15:44:55+08:00,['a6941e35bda6a4d819b966c0c040b0931c84630f'],241,1453,1694,16656441,50,0.397037037,0.748148148,0.712592593,14798
c9a3140729da6d28ddb8359b035567d2c4d1eca3,0,XiaoxiangYu,2022-05-05 15:46:17+08:00,['7f9171d36aab78ba1550dbbd8bcd072afeac85e4'],7,206,213,16656654,6,0.097744361,0.097744361,1,14799
83f8a3d450323eb6774999f9b1a61c85b7c4bea8,0,XiaoxiangYu,2022-05-13 16:31:40+08:00,['c9a3140729da6d28ddb8359b035567d2c4d1eca3'],1,1,2,16656656,1,,,,14799
626c971cb10ab79c8f60603370bedf7aac63c3f7,0,Shaofeng Shi,2022-05-15 10:11:06+08:00,['83f8a3d450323eb6774999f9b1a61c85b7c4bea8'],796931,13,796944,17453600,1396,0.539946898,0.286797007,0.166175879,14799
15825b3b59932a2cd79b571e796588e69e02476a,0,Shaofeng Shi,2022-05-15 10:20:34+08:00,['626c971cb10ab79c8f60603370bedf7aac63c3f7'],3,3,6,17453606,1,,,,14799
f6f3ae5808659346011a5e19ab3c09a951eed895,0,Shaofeng Shi,2022-05-15 12:09:17+08:00,['15825b3b59932a2cd79b571e796588e69e02476a'],6,1,7,17453613,1,,,,14799
68d08488f1e1e586523be85d79edac43c8bcf3c5,0,Shaofeng Shi,2022-05-15 17:07:45+08:00,['f6f3ae5808659346011a5e19ab3c09a951eed895'],1,1,2,17453615,1,,,,14799
6fa14239c49c800f69369321eafdc4ef9727ba33,0,XiaoxiangYu,2022-05-16 09:38:24+08:00,['68d08488f1e1e586523be85d79edac43c8bcf3c5'],1,11,12,17453627,2,0.428571429,1,1,14799
e33e17e63e0fa273196c5a422c97112ef123383a,0,XiaoxiangYu,2022-05-16 09:38:56+08:00,['6fa14239c49c800f69369321eafdc4ef9727ba33'],8,8,16,17453643,2,,,,14799
39ee0b8a6a84dcf27404c838ead379b0342f7b65,0,XiaoxiangYu,2022-05-16 11:12:54+08:00,['e33e17e63e0fa273196c5a422c97112ef123383a'],10,68,78,17453721,9,0.783783784,0.27027027,0.864864865,14799
165b7a1dc4552ea8a467e2cbbb1593ddcb2b8739,0,XiaoxiangYu,2022-05-25 10:01:34+08:00,['39ee0b8a6a84dcf27404c838ead379b0342f7b65'],0,1,1,17453722,1,,,,14799
8cde6ddae6ad8df022b90f0309eecd9f2c999687,0,GitHub,2022-06-10 18:35:18+08:00,['165b7a1dc4552ea8a467e2cbbb1593ddcb2b8739'],2,2,4,17453726,1,,,,14799
d9f112cd78490106694a6ab1bc15f51c7e5832d7,0,XiaoxiangYu,2022-06-16 09:35:01+08:00,['8cde6ddae6ad8df022b90f0309eecd9f2c999687'],11,28,39,17453765,2,0.625,0.625,0.875,14799
8a44cac482bbf09843a26cf0663e0480954fbec6,0,GitHub,2022-06-16 10:02:20+08:00,['d9f112cd78490106694a6ab1bc15f51c7e5832d7'],2,9,11,17453776,3,0.8,0,0.2,14799
92b77fdaa819844519b2baa019472bed0edc3819,0,XiaoxiangYu,2022-06-16 10:02:44+08:00,['8a44cac482bbf09843a26cf0663e0480954fbec6'],1,10,11,17453787,3,0,1,0,14799
afa3bbaa44ed901b83c2ccf86222548a3cf72311,0,XiaoxiangYu,2022-06-16 10:58:01+08:00,['92b77fdaa819844519b2baa019472bed0edc3819'],4,7,11,17453798,1,,,,14799
444ae0604e8290cf18b5defddfdd6d79006f7501,0,GitHub,2022-06-16 10:58:50+08:00,['afa3bbaa44ed901b83c2ccf86222548a3cf72311'],134,246,380,17454178,19,0.676470588,0.294117647,0.705882353,14799
fd4a472e348589ea9c6e0c46edcc4b1a06b0ee38,0,GitHub,2022-06-16 11:03:48+08:00,['444ae0604e8290cf18b5defddfdd6d79006f7501'],19,23,42,17454220,3,0,0,1,14799
9706a9dd76486ea4c4fd4fa86abe1f53602edb28,0,XiaoxiangYu,2022-06-21 17:36:23+08:00,['fd4a472e348589ea9c6e0c46edcc4b1a06b0ee38'],22,2230,2252,17456472,30,0.545714286,0.793333333,0.74952381,14820
f2cdedb47416de04c4f3f3594e64fa9ce46be33d,0,XiaoxiangYu,2022-06-21 17:36:23+08:00,['9706a9dd76486ea4c4fd4fa86abe1f53602edb28'],3,4,7,17456479,2,,,,14820
857aaeaf3c6dba0ad2587761f917ddcc62844932,0,GitHub,2022-06-21 17:50:36+08:00,['f2cdedb47416de04c4f3f3594e64fa9ce46be33d'],10,99,109,17456588,7,0.095238095,1,1,14822
cf93a9b226b30537cc0a909f4e9d2a001bb01da1,0,GitHub,2022-06-23 10:43:08+08:00,['857aaeaf3c6dba0ad2587761f917ddcc62844932'],1,1,2,17456590,1,,,,14822
66e83b46a0868742e9ead9838f01efdccc74e378,0,GitHub,2022-06-23 10:45:58+08:00,['cf93a9b226b30537cc0a909f4e9d2a001bb01da1'],0,12,12,17456602,1,,,,14822
