sha,is_bug,committer_name,commit_time,parents,all_del,all_add,all_change_lines,all_lines,files_change_nums,dmm_unit_size,dmm_unit_complexity,dmm_unit_interfacing,file_nums
e6eaf50b5bf0bca7f435d61b3e8f54022c7cc238,0,Grant Ingersoll,2008-01-15 03:13:56+00:00,[],0,0,0,0,0,,,,0
22345c718b950fb69e8ad518136fc657038ed810,0,Otis Gospodnetic,2008-01-15 16:43:39+00:00,['e6eaf50b5bf0bca7f435d61b3e8f54022c7cc238'],0,0,0,0,1,,,,1
24c4bd048f94735a3bb6a70692247b7bd779ba92,0,Grant Ingersoll,2008-02-02 04:35:52+00:00,['22345c718b950fb69e8ad518136fc657038ed810'],0,1174,1174,1174,17,,,,17
f599de26606ac2d798df6c3643329ddc1385412d,0,Grant Ingersoll,2008-02-11 02:38:57+00:00,['24c4bd048f94735a3bb6a70692247b7bd779ba92'],100,0,100,1274,3,,,,18
884c4a8675649ed4094e8f3ebf23ff7acdbb020a,0,Grant Ingersoll,2008-02-11 02:49:47+00:00,['f599de26606ac2d798df6c3643329ddc1385412d'],16,86,102,1376,1,,,,18
f494c00b6fb8db10824a444ce7715d875eb4c216,0,Grant Ingersoll,2008-02-11 02:50:34+00:00,['884c4a8675649ed4094e8f3ebf23ff7acdbb020a'],0,0,0,1376,0,,,,18
1c0d31d54050dce298524a5197acab5552694a14,1,Grant Ingersoll,2008-02-20 04:27:57+00:00,['f494c00b6fb8db10824a444ce7715d875eb4c216'],2,1921,1923,3299,16,0.423925668,0.93728223,0.806039489,33
b7c044dc0c472a8a747541889e0cc450585e1d92,0,Grant Ingersoll,2008-02-24 22:00:10+00:00,['1c0d31d54050dce298524a5197acab5552694a14'],4,11,15,3314,6,,,,33
4e3e255cd97f083679a14a46b27e35b3908c6310,0,Grant Ingersoll,2008-02-24 22:38:19+00:00,['b7c044dc0c472a8a747541889e0cc450585e1d92'],0,0,0,3314,2,,,,34
5339db364918df7a20fd4345558facc5f71dda91,1,Grant Ingersoll,2008-03-01 03:33:13+00:00,['4e3e255cd97f083679a14a46b27e35b3908c6310'],318,1592,1910,5224,21,0.43883792,0.686544343,0.727828746,42
07f5feeeabf881ada27c476fa919941345814a2b,0,Dawid Weiss,2008-03-06 09:24:07+00:00,['5339db364918df7a20fd4345558facc5f71dda91'],0,0,0,5224,0,,,,42
6dd23719d845436af4759fe8669154ff8074e1a3,0,Dawid Weiss,2008-03-09 11:10:51+00:00,['07f5feeeabf881ada27c476fa919941345814a2b'],7,7,14,5238,7,,,,42
6dbd767dac486c6c8d435eb8dda2cf55cfe90bc0,1,Dawid Weiss,2008-03-09 11:13:52+00:00,['6dd23719d845436af4759fe8669154ff8074e1a3'],17,60,77,5315,2,1,1,1,43
b028bd35924aa5843e4913852c63b11e683cb27f,0,Dawid Weiss,2008-03-09 11:42:16+00:00,['6dbd767dac486c6c8d435eb8dda2cf55cfe90bc0'],1,9,10,5325,2,1,1,1,43
e2539dae3971d51614c892db31b5ed423ac3c2c3,1,Dawid Weiss,2008-03-09 11:58:00+00:00,['b028bd35924aa5843e4913852c63b11e683cb27f'],11,19,30,5355,3,1,1,1,43
0cbf4863ba03502dedc0d6f77360224356f461ae,1,Dawid Weiss,2008-03-14 14:28:54+00:00,['e2539dae3971d51614c892db31b5ed423ac3c2c3'],59,29,88,5443,8,0.482758621,0.034482759,0.137931034,43
ad706e4c3be562349486f55db5ef4b9f1bfb9c03,0,Dawid Weiss,2008-03-14 14:30:58+00:00,['0cbf4863ba03502dedc0d6f77360224356f461ae'],2,0,2,5445,2,,,,43
ceb992ee1784703338c2c51273fc3e25a07939fa,1,Grant Ingersoll,2008-03-16 21:24:48+00:00,['ad706e4c3be562349486f55db5ef4b9f1bfb9c03'],0,6099,6099,11544,26,0.990046838,0.980386417,0.989168618,69
73ce7a109aaa05a1ccb3816f1953301d22334bd2,0,Karl-Johan Wettin,2008-04-04 17:34:14+00:00,['ceb992ee1784703338c2c51273fc3e25a07939fa'],3,3,6,11550,2,,,,69
9c76557b8c373fad8bb5c8bc91411c27abe4f0f0,1,Karl-Johan Wettin,2008-04-11 14:00:29+00:00,['73ce7a109aaa05a1ccb3816f1953301d22334bd2'],1767,506,2273,13823,6,0,0,0,70
d085b9410dd196cb65976fd984d3ca5c40063434,1,Karl-Johan Wettin,2008-04-11 14:15:51+00:00,['9c76557b8c373fad8bb5c8bc91411c27abe4f0f0'],0,63,63,13886,3,0.282051282,0.282051282,1,70
67534ed15fe28fe74751642509f5d6bbc38a353d,0,Karl-Johan Wettin,2008-04-11 15:08:07+00:00,['d085b9410dd196cb65976fd984d3ca5c40063434'],1,2,3,13889,1,,,,70
5b40e01dd203d3e84bb27c6ab649e82ead952120,1,Karl-Johan Wettin,2008-04-12 16:44:14+00:00,['67534ed15fe28fe74751642509f5d6bbc38a353d'],1,110,111,14000,5,1,1,1,70
dcf942cdd1c868009629cd587bb6e87ba907311d,1,Karl-Johan Wettin,2008-04-14 07:11:04+00:00,['5b40e01dd203d3e84bb27c6ab649e82ead952120'],11,30,41,14041,1,1,1,1,70
a77e64d71ed71cbe74a7c243379b1144d6bd9acd,1,Jeff Eastman,2008-04-15 01:16:52+00:00,['dcf942cdd1c868009629cd587bb6e87ba907311d'],6,1358,1364,15405,12,0.469622332,0.712643678,0.706075534,78
6011291b44c05112381cde6ce68f2e4e76fe45d3,0,Karl-Johan Wettin,2008-04-16 23:31:24+00:00,['a77e64d71ed71cbe74a7c243379b1144d6bd9acd'],2,17,19,15424,1,,,,78
dab28f8483ef5079b24af337fc76a1fb66cdbb26,1,Karl-Johan Wettin,2008-04-16 23:39:12+00:00,['6011291b44c05112381cde6ce68f2e4e76fe45d3'],5,5,10,15434,2,,,,78
e82af530b0dc26f4cdc1ce178319b4a79a7bad4a,1,Karl-Johan Wettin,2008-04-17 00:43:19+00:00,['dab28f8483ef5079b24af337fc76a1fb66cdbb26'],2,54,56,15490,2,0.4,1,1,78
3f683ad8318cae4c7a4297a663761a85077811f8,0,Karl-Johan Wettin,2008-04-17 00:47:42+00:00,['e82af530b0dc26f4cdc1ce178319b4a79a7bad4a'],0,243,243,15733,4,0.772277228,1,1,82
9a1a44b69de5adc9ed40b182bab45a9ba65917a8,0,Karl-Johan Wettin,2008-04-17 00:59:51+00:00,['3f683ad8318cae4c7a4297a663761a85077811f8'],2,2,4,15737,1,,,,82
e3d68a056778871f98a8ba4f6c9dacf1391cb6a4,0,Karl-Johan Wettin,2008-04-17 03:07:40+00:00,['9a1a44b69de5adc9ed40b182bab45a9ba65917a8'],1,1,2,15739,1,,,,82
e63dd05d6d37e241bd55346aaef5ddf6e2d9bb1f,0,Karl-Johan Wettin,2008-04-17 15:08:56+00:00,['e3d68a056778871f98a8ba4f6c9dacf1391cb6a4'],7,3,10,15749,2,0,0,0,82
0a7717fc02e4064b6b10275d9eafeccdcbf2e33d,1,Jeff Eastman,2008-04-18 19:28:49+00:00,['e63dd05d6d37e241bd55346aaef5ddf6e2d9bb1f'],25,542,567,16316,2,1,1,1,83
1b2e4e35ed2b2dce279160ea7b4541182b026ca8,1,Karl-Johan Wettin,2008-04-18 19:46:55+00:00,['0a7717fc02e4064b6b10275d9eafeccdcbf2e33d'],2,466,468,16784,12,0.559701493,1,1,93
a8a33322bbbbeb10209faefb4aeb4161528b689d,1,Jeff Eastman,2008-04-19 00:10:38+00:00,['1b2e4e35ed2b2dce279160ea7b4541182b026ca8'],294,315,609,17393,17,0,0,1,93
c1095f4ccc9422669a97403090c20a70ae36b18a,1,Sean R. Owen,2008-04-19 00:49:44+00:00,['a8a33322bbbbeb10209faefb4aeb4161528b689d'],72,77,149,17542,24,1,1,1,93
6a401e9da696494e2e3a2d8cce82dba326d9e8d7,1,Grant Ingersoll,2008-04-20 15:18:52+00:00,['c1095f4ccc9422669a97403090c20a70ae36b18a'],0,23,23,17565,1,1,1,1,93
3f526642caa2177107a632a131d6a9e8e5e23f0b,0,Karl-Johan Wettin,2008-04-20 19:24:58+00:00,['6a401e9da696494e2e3a2d8cce82dba326d9e8d7'],0,0,0,17565,87,,,,93
119a39d4f35126ffd2921175e6a96367ef5adc46,1,Jeff Eastman,2008-04-21 17:29:14+00:00,['3f526642caa2177107a632a131d6a9e8e5e23f0b'],180,393,573,18138,12,0.98245614,0.98245614,1,93
6f320d75de13a19542613c35f96ade30369a80aa,1,Karl-Johan Wettin,2008-04-23 13:18:42+00:00,['119a39d4f35126ffd2921175e6a96367ef5adc46'],0,267,267,18405,2,,,,95
06b7c8c8b9b0f9d882737a0c4f218f62194e45f4,0,Karl-Johan Wettin,2008-04-23 13:45:55+00:00,['6f320d75de13a19542613c35f96ade30369a80aa'],3,3,6,18411,1,,,,95
72116a08a73d0642401bbdad1f728109296c2665,0,Karl-Johan Wettin,2008-04-23 13:49:40+00:00,['06b7c8c8b9b0f9d882737a0c4f218f62194e45f4'],1,1,2,18413,1,,,,95
f115e352d16593675f37fa060315843d454170a1,1,Karl-Johan Wettin,2008-04-23 17:35:16+00:00,['72116a08a73d0642401bbdad1f728109296c2665'],234,167,401,18814,12,0,0,1,95
d907cbfd82e3c95f5c4871b8e36190582d2f2ea1,0,Karl-Johan Wettin,2008-04-23 17:50:10+00:00,['f115e352d16593675f37fa060315843d454170a1'],22,647,669,19483,14,0.862204724,1,0.803149606,105
70123b4fe00f19b99c098f012b77439ffe5d8356,0,Karl-Johan Wettin,2008-04-23 19:26:42+00:00,['d907cbfd82e3c95f5c4871b8e36190582d2f2ea1'],2,2,4,19487,1,,,,105
bca581ef8a39e41b7ddba8322dc05f9d40d6e3cf,1,Jeff Eastman,2008-04-23 21:38:24+00:00,['70123b4fe00f19b99c098f012b77439ffe5d8356'],526,463,989,20476,18,0,0.022727273,0,105
76f705e887659466f275f912fd3babd78d75e53c,0,Jeff Eastman,2008-04-23 22:07:15+00:00,['bca581ef8a39e41b7ddba8322dc05f9d40d6e3cf'],4,3,7,20483,2,0,0,1,105
3e44d3c5eff7f22005619ef1c96932b67544200a,0,Grant Ingersoll,2008-04-26 21:40:13+00:00,['76f705e887659466f275f912fd3babd78d75e53c'],0,0,0,20483,1,,,,105
8ea53775a2b4c7ade8118ec4889c83950cd805ab,0,Jeff Eastman,2008-05-02 01:18:21+00:00,['3e44d3c5eff7f22005619ef1c96932b67544200a'],98,105,203,20686,6,0,0,0,105
9aaf641bb0eb632f8c07ceff2adf2e75537c40e2,1,Sean R. Owen,2008-05-09 21:35:12+00:00,['8ea53775a2b4c7ade8118ec4889c83950cd805ab'],0,16058,16058,36744,152,0.531722934,0.769644936,0.822759022,256
9b5c85f314d2fda7ff5c30e43990de5ba3ba8758,0,Sean R. Owen,2008-05-10 19:25:45+00:00,['9aaf641bb0eb632f8c07ceff2adf2e75537c40e2'],311,7,318,37062,5,0.5546875,0,0,256
fd82a6ef176606e8dff5619456a4ac0f12147204,0,Sean R. Owen,2008-05-12 06:50:38+00:00,['9b5c85f314d2fda7ff5c30e43990de5ba3ba8758'],0,0,0,37062,4,,,,257
d0667bef27c50163b39e85228dcbd896b05d95a6,0,Sean R. Owen,2008-05-12 11:19:28+00:00,['fd82a6ef176606e8dff5619456a4ac0f12147204'],2,2,4,37066,2,,,,257
0e8966c8756c287d8ae68bbcec954b9d43ca1a96,0,Sean R. Owen,2008-05-12 11:20:50+00:00,['d0667bef27c50163b39e85228dcbd896b05d95a6'],7,1,8,37074,1,,,,257
229e553847f291a9d30f5fcaf53e16dc9e263841,0,Sean R. Owen,2008-05-12 11:31:11+00:00,['0e8966c8756c287d8ae68bbcec954b9d43ca1a96'],30,0,30,37104,12,,,,257
470d92172684c0fb0818ab6f51cbedafa4388c54,0,Sean R. Owen,2008-05-12 11:38:23+00:00,['229e553847f291a9d30f5fcaf53e16dc9e263841'],19,9,28,37132,2,,,,257
73a8c821a3f2841dcd2dceeec8cbb07ff1d48007,0,Sean R. Owen,2008-05-12 11:42:25+00:00,['470d92172684c0fb0818ab6f51cbedafa4388c54'],2,1,3,37135,1,,,,257
b5d812fc2b488aae2ae6c8eeef8f17a713be124a,0,Sean R. Owen,2008-05-13 00:24:23+00:00,['73a8c821a3f2841dcd2dceeec8cbb07ff1d48007'],0,338,338,37473,4,0.3359375,0.7890625,0.6796875,261
8f47e46fb0beb28f910cdf0d83dc4e9327ffa1b2,1,Sean R. Owen,2008-05-13 01:37:41+00:00,['b5d812fc2b488aae2ae6c8eeef8f17a713be124a'],43,92,135,37608,1,0,1,0.1,261
85740d1aaa22638acbec3b9b61260cf4e3d5c5ff,1,Sean R. Owen,2008-05-14 00:31:24+00:00,['8f47e46fb0beb28f910cdf0d83dc4e9327ffa1b2'],285,209,494,38102,28,1,1,0.333333333,264
1ebc724f8ca2d058440c7f1b5fed3231808e9f76,0,Sean R. Owen,2008-05-14 01:57:10+00:00,['85740d1aaa22638acbec3b9b61260cf4e3d5c5ff'],0,1239,1239,39341,7,,,,271
bb4fa3ab1b48e21fa39724eb63e6d59dd353e8e7,0,Sean R. Owen,2008-05-14 23:05:10+00:00,['1ebc724f8ca2d058440c7f1b5fed3231808e9f76'],29,23,52,39393,5,,,,271
5cf566bb6d8329811e1fc4435c155312ce17ebd9,0,Sean R. Owen,2008-05-14 23:08:31+00:00,['bb4fa3ab1b48e21fa39724eb63e6d59dd353e8e7'],0,327,327,39720,2,,,,273
09ea2054ef4fb8624edcb60ec5ba469314f03a2d,1,Sean R. Owen,2008-05-17 19:47:50+00:00,['5cf566bb6d8329811e1fc4435c155312ce17ebd9'],8,25,33,39753,2,0,0.636363636,0.363636364,273
318435c056a91da39c05ab1aec9fb165fb0cadda,0,Sean R. Owen,2008-05-18 23:36:04+00:00,['09ea2054ef4fb8624edcb60ec5ba469314f03a2d'],3,3,6,39759,1,,,,273
d72f4c43d2fb349d5ad630769eb5527ee32e019c,0,Sean R. Owen,2008-05-25 03:30:32+00:00,['318435c056a91da39c05ab1aec9fb165fb0cadda'],2,1,3,39762,1,1,0,1,273
ef3df78081536699055a9e3eb1a7b11b94af8a28,0,Sean R. Owen,2008-05-25 20:01:22+00:00,['d72f4c43d2fb349d5ad630769eb5527ee32e019c'],2,2,4,39766,6,,,,275
4395e08efe0aad331d9d15c062af5ae667fcdc74,1,Sean R. Owen,2008-05-25 23:15:15+00:00,['ef3df78081536699055a9e3eb1a7b11b94af8a28'],11,517,528,40294,9,0.659217877,1,0.770949721,283
0a099d9f84a1249cf2d92af418d34145c4250184,0,Sean R. Owen,2008-05-26 04:56:50+00:00,['4395e08efe0aad331d9d15c062af5ae667fcdc74'],14,22,36,40330,5,,,,283
9bc5b4066c95154ba5bce43559c2078a054f9cf9,1,Jeff Eastman,2008-05-27 00:18:37+00:00,['0a099d9f84a1249cf2d92af418d34145c4250184'],11,78,89,40419,3,0.428571429,1,0.428571429,284
27a00869158170f1dbe1e11393b0d1f7a402bc06,0,Jeff Eastman,2008-05-27 01:47:46+00:00,['9bc5b4066c95154ba5bce43559c2078a054f9cf9'],9,1,10,40429,2,1,0,1,284
6628dae4670fbc1057a0847a7bae0612818d3605,0,Sean R. Owen,2008-05-27 15:22:09+00:00,['27a00869158170f1dbe1e11393b0d1f7a402bc06'],67,1,68,40497,3,0,0,0,284
744654be9738f4bb5a0cf8f5bfdd7b6ea550b2db,0,Sean R. Owen,2008-05-30 19:29:22+00:00,['6628dae4670fbc1057a0847a7bae0612818d3605'],0,10,10,40507,1,,,,284
10803d67d9f83d083015104fa35883aa6957c26d,1,Sean R. Owen,2008-05-30 22:06:08+00:00,['744654be9738f4bb5a0cf8f5bfdd7b6ea550b2db'],321,876,1197,41704,7,0.689873418,0.689873418,0.965189873,289
8bfbc180d2a6f3e607c7b47b30af6de559465d61,0,Sean R. Owen,2008-05-30 22:07:43+00:00,['10803d67d9f83d083015104fa35883aa6957c26d'],13,47,60,41764,5,,,,290
c6700b32b3c1385bbc2b89f165c43da0523fc985,0,Sean R. Owen,2008-05-30 22:08:13+00:00,['8bfbc180d2a6f3e607c7b47b30af6de559465d61'],38,0,38,41802,1,,,,290
5893f0267a0d2132411ca8b36386e3d5c27b73d8,0,Sean R. Owen,2008-05-31 00:18:27+00:00,['c6700b32b3c1385bbc2b89f165c43da0523fc985'],10,117,127,41929,4,1,1,1,292
ea3a862acc037bd044686e22d75fca0be3965ce5,0,Sean R. Owen,2008-05-31 18:18:53+00:00,['5893f0267a0d2132411ca8b36386e3d5c27b73d8'],14,8,22,41951,5,,,,292
60b11d8e2591d052bbf426d11183aa66bad7ba17,0,Sean R. Owen,2008-05-31 23:13:29+00:00,['ea3a862acc037bd044686e22d75fca0be3965ce5'],13,98,111,42062,7,0.384615385,0.553846154,0.538461538,292
58c82cc39e01cf6f20631f59c3c11f9662f96329,0,Sean R. Owen,2008-06-02 13:15:33+00:00,['60b11d8e2591d052bbf426d11183aa66bad7ba17'],1,1,2,42064,1,,,,292
8a77a4a373a6582651885a29dd6cf5b3124378b9,0,Sean R. Owen,2008-06-03 22:59:28+00:00,['58c82cc39e01cf6f20631f59c3c11f9662f96329'],0,138,138,42202,3,0.573770492,1,0.885245902,294
749c27aec1a3e1732158f9fc8372a934aafba8de,1,Sean R. Owen,2008-06-15 16:17:43+00:00,['8a77a4a373a6582651885a29dd6cf5b3124378b9'],24,151,175,42377,6,1,1,1,295
819e958ad37dfe6eb28d0542eb903698e1cb24b7,0,Sean R. Owen,2008-06-15 16:19:30+00:00,['749c27aec1a3e1732158f9fc8372a934aafba8de'],130,0,130,42507,1,0,0,0,295
c9d1f45936d39fd308cc53084aadacf3098fe962,0,Sean R. Owen,2008-06-15 18:20:12+00:00,['819e958ad37dfe6eb28d0542eb903698e1cb24b7'],47,50,97,42604,15,0,0,1,295
c176ef271797ac8aa6d49b8b24660333e075f56f,0,Sean R. Owen,2008-06-15 20:03:19+00:00,['c9d1f45936d39fd308cc53084aadacf3098fe962'],54,49,103,42707,8,1,0,0,295
1b4f0190db9a9b4ccbd30037b0412993de98fee4,1,Jeff Eastman,2008-06-16 15:49:43+00:00,['c176ef271797ac8aa6d49b8b24660333e075f56f'],0,790,790,43497,13,0.383458647,1,0.563909774,308
567ee55e95b3b52c514dfbe4698ae247ab1c6369,0,Grant Ingersoll,2008-06-26 00:59:57+00:00,['1b4f0190db9a9b4ccbd30037b0412993de98fee4'],0,7,7,43504,1,,,,308
0bf53b4a321d713dc3925f41867aeecd29aec6fc,1,Sean R. Owen,2008-07-04 14:25:17+00:00,['567ee55e95b3b52c514dfbe4698ae247ab1c6369'],6,12,18,43522,1,,,,308
955dea6fef5f60cbe72be2dbaa5e5a5a3b7c8bd5,0,Sean R. Owen,2008-07-10 02:46:36+00:00,['0bf53b4a321d713dc3925f41867aeecd29aec6fc'],2,7,9,43531,1,1,1,1,308
88cbd2dd8e00a7b6135bc097c9ff9bc93abea2d0,0,Grant Ingersoll,2008-07-12 02:29:59+00:00,['955dea6fef5f60cbe72be2dbaa5e5a5a3b7c8bd5'],0,0,0,43531,1,,,,309
6e4c3344f57ead5599c1df9c4a7bd83e5c1afc1c,0,Grant Ingersoll,2008-07-12 02:44:59+00:00,['88cbd2dd8e00a7b6135bc097c9ff9bc93abea2d0'],0,0,0,43531,1,,,,310
3bf6d5b3fd8e42755623c44ab37032a0af09d7dd,0,Grant Ingersoll,2008-07-12 11:53:08+00:00,['6e4c3344f57ead5599c1df9c4a7bd83e5c1afc1c'],0,0,0,43531,1,,,,310
7068665e363baa1db98af1aecd884f6b2058a9fd,0,Sean R. Owen,2008-07-17 19:17:21+00:00,['3bf6d5b3fd8e42755623c44ab37032a0af09d7dd'],0,29,29,43560,5,0,0.965517241,1,310
411fe8d0c8d9c5da18976b715c6e2dd8a7df9c1e,0,Sean R. Owen,2008-07-19 17:16:57+00:00,['7068665e363baa1db98af1aecd884f6b2058a9fd'],36,149,185,43745,4,1,1,1,312
b1a8b8d2a963b406daaa2e92314beeef031f6975,1,Sean R. Owen,2008-07-21 20:47:05+00:00,['411fe8d0c8d9c5da18976b715c6e2dd8a7df9c1e'],104,104,208,43953,30,0,1,1,312
281b5f0981c1ee4ffac6bff64b8a9011e18c2034,1,Grant Ingersoll,2008-07-31 10:33:45+00:00,['b1a8b8d2a963b406daaa2e92314beeef031f6975'],2,7549,7551,51504,75,0.590706871,0.918437963,0.831932773,386
caab90d8458654e3fd65a686e9d3df8795b69be8,0,Sean R. Owen,2008-08-02 00:46:24+00:00,['281b5f0981c1ee4ffac6bff64b8a9011e18c2034'],1,1,2,51506,1,,,,386
15881963e7298b0a33d32050cfe1b3d26850a525,0,Sean R. Owen,2008-08-02 00:55:20+00:00,['caab90d8458654e3fd65a686e9d3df8795b69be8'],5,5,10,51516,6,,,,387
946101731f238c7c43f9a6ba16daf9c8aaa893f4,0,Sean R. Owen,2008-08-02 02:49:15+00:00,['15881963e7298b0a33d32050cfe1b3d26850a525'],28,52,80,51596,7,,,,388
009e1a3373e43fe0d5d49995eb1dbac997fe4cb6,0,Sean R. Owen,2008-08-02 03:56:26+00:00,['946101731f238c7c43f9a6ba16daf9c8aaa893f4'],39,63,102,51698,22,0.826086957,1,1,388
e1e9427458bf81a71708320d24f6d093ea87e22f,0,Grant Ingersoll,2008-08-02 10:39:14+00:00,['009e1a3373e43fe0d5d49995eb1dbac997fe4cb6'],0,0,0,51698,1,,,,388
96d1ae1b687e59ce61ad357d5c0c6450d766e205,0,Grant Ingersoll,2008-08-02 10:40:41+00:00,['e1e9427458bf81a71708320d24f6d093ea87e22f'],15,3,18,51716,1,0,0,0,388
3f427d93598a1dae64ad7a27b6dbc52a28824dad,1,Karl-Johan Wettin,2008-08-07 01:25:41+00:00,['96d1ae1b687e59ce61ad357d5c0c6450d766e205'],2,112,114,51830,2,,,,388
c8c86edb76a575582e8c12cc8e1108ea6f9f1b61,0,Sean R. Owen,2008-08-07 03:23:39+00:00,['3f427d93598a1dae64ad7a27b6dbc52a28824dad'],42,88,130,51960,10,0,1,1,389
8df25cda76ecfbb37d66ccd4dd685c44667d53e6,0,Sean R. Owen,2008-08-07 21:39:09+00:00,['c8c86edb76a575582e8c12cc8e1108ea6f9f1b61'],2,2,4,51964,1,,,,389
8486e67feac5d2a4a45daf2c3fe394e8a08be1bd,0,Sean R. Owen,2008-08-08 01:34:56+00:00,['8df25cda76ecfbb37d66ccd4dd685c44667d53e6'],29,13,42,52006,9,0,0,0,389
b488bb55cb6ebbb2e27ed117b22f8003db69f853,0,Sean R. Owen,2008-08-08 03:36:55+00:00,['8486e67feac5d2a4a45daf2c3fe394e8a08be1bd'],0,142,142,52148,2,1,1,1,391
b78388a3d57656f0b02e02a33dd82f99fe369915,0,Sean R. Owen,2008-08-08 03:52:02+00:00,['b488bb55cb6ebbb2e27ed117b22f8003db69f853'],91,124,215,52363,3,1,1,1,392
170ea9d5e05a2800f3dcb39f1e988defd9868d69,0,Sean R. Owen,2008-08-08 04:42:39+00:00,['b78388a3d57656f0b02e02a33dd82f99fe369915'],6,12,18,52381,3,1,1,1,392
6e32a623e13b518e820a20266e3a26576d82abb6,1,Sean R. Owen,2008-08-09 21:55:03+00:00,['170ea9d5e05a2800f3dcb39f1e988defd9868d69'],327,520,847,53228,53,1,0,0,395
045b0811b96e92d55bdcae24b6361bf4e315bd18,1,Sean R. Owen,2008-08-11 22:04:54+00:00,['6e32a623e13b518e820a20266e3a26576d82abb6'],192,213,405,53633,11,1,1,0,395
6ced2664e9f3a3c3df8c480c4931d8968c512fd4,1,Sean R. Owen,2008-08-11 23:51:49+00:00,['045b0811b96e92d55bdcae24b6361bf4e315bd18'],39,43,82,53715,3,0,1,0,395
c056eed3392f60811d5b607404d1202fc2195086,0,Sean R. Owen,2008-08-12 01:47:40+00:00,['6ced2664e9f3a3c3df8c480c4931d8968c512fd4'],2,4,6,53721,1,,,,395
4bd55ffe9efc9e05ee4aad90ef935b6e7203adbb,1,Sean R. Owen,2008-08-12 21:42:55+00:00,['c056eed3392f60811d5b607404d1202fc2195086'],3,61,64,53785,3,1,1,1,396
5dced8933f8b8b3d90a92f1154aac464375f3295,0,Sean R. Owen,2008-08-12 23:09:56+00:00,['4bd55ffe9efc9e05ee4aad90ef935b6e7203adbb'],1,1,2,53787,1,,,,396
09028b1d443f8cefca6a99b293d9f70ab6776681,0,Sean R. Owen,2008-08-14 01:36:19+00:00,['5dced8933f8b8b3d90a92f1154aac464375f3295'],5,9,14,53801,2,,,,396
62716daff85ebbd6ef0c7e1b5ce2bba1ac366a55,1,Sean R. Owen,2008-08-14 02:29:48+00:00,['09028b1d443f8cefca6a99b293d9f70ab6776681'],160,149,309,54110,28,1,0,0.310344828,396
80161e65042a6444f521a2deb54106826385babc,0,Karl-Johan Wettin,2008-08-14 19:17:43+00:00,['62716daff85ebbd6ef0c7e1b5ce2bba1ac366a55'],72,564,636,54746,61,,,,400
20813530ba7f3e480fd0a9e91af253ec4f401fa4,0,Grant Ingersoll,2008-08-15 12:55:43+00:00,['80161e65042a6444f521a2deb54106826385babc'],0,0,0,54746,0,,,,400
eefade2b45b388565f1e9ee7071614dc39ed958d,0,Grant Ingersoll,2008-08-15 13:28:34+00:00,['20813530ba7f3e480fd0a9e91af253ec4f401fa4'],5,17,22,54768,2,,,,400
9cfa8b6994c1e76293243fa9374431821fa7c586,0,Grant Ingersoll,2008-08-15 13:55:50+00:00,['eefade2b45b388565f1e9ee7071614dc39ed958d'],0,1,1,54769,1,,,,400
fbd81f33745ff6719c9542cf66fbb4f448d4dcff,1,Grant Ingersoll,2008-08-15 14:09:36+00:00,['9cfa8b6994c1e76293243fa9374431821fa7c586'],129,1407,1536,56305,22,0.551785714,0.9125,0.75,411
7fe72ce60bc3800a00dad94e814afd298415bd32,0,Grant Ingersoll,2008-08-15 14:12:16+00:00,['fbd81f33745ff6719c9542cf66fbb4f448d4dcff'],0,0,0,56305,18,,,,411
41b029f6f01c3ae3ce21b255a69dfb68f8f6ab68,0,Grant Ingersoll,2008-08-15 14:13:17+00:00,['7fe72ce60bc3800a00dad94e814afd298415bd32'],0,0,0,56305,0,,,,411
41edba44cfcd942f3cf548b43e2f41f5b6cca0b3,0,Grant Ingersoll,2008-08-15 14:13:58+00:00,['41b029f6f01c3ae3ce21b255a69dfb68f8f6ab68'],0,0,0,56305,18,,,,411
3d5559af3d62686ff531b4242d28e4e1955aeb2a,0,Grant Ingersoll,2008-08-15 14:23:46+00:00,['41edba44cfcd942f3cf548b43e2f41f5b6cca0b3'],0,0,0,56305,0,,,,411
ec52bcc2447139198630e985ad94a2c8b97a4e5e,0,Grant Ingersoll,2008-08-15 14:25:45+00:00,['3d5559af3d62686ff531b4242d28e4e1955aeb2a'],4,2,6,56311,1,,,,411
d1248ed479e9d5e53d00b081fc3ca124ebce72e1,0,Grant Ingersoll,2008-08-15 14:26:32+00:00,['ec52bcc2447139198630e985ad94a2c8b97a4e5e'],0,0,0,56311,0,,,,411
05bf7931e495432ad906d312784485485d0be328,0,Grant Ingersoll,2008-08-15 15:02:52+00:00,['d1248ed479e9d5e53d00b081fc3ca124ebce72e1'],0,0,0,56311,1,,,,412
ebc579530ed01e74115788d28f135f952b33074d,1,Grant Ingersoll,2008-08-15 19:27:43+00:00,['05bf7931e495432ad906d312784485485d0be328'],0,6,6,56317,1,,,,412
1ebec96319d73d39d5c2e7cb4ff2c8eacf1cfc47,0,Grant Ingersoll,2008-08-18 13:11:12+00:00,['ebc579530ed01e74115788d28f135f952b33074d'],20,630,650,56967,6,0,1,1,414
42592067e2ccc7d998d7dca4cc85fa257b8165db,0,Karl-Johan Wettin,2008-08-19 09:41:31+00:00,['1ebec96319d73d39d5c2e7cb4ff2c8eacf1cfc47'],23,37,60,57027,6,,,,414
d8bafd5791e0e796788e63500bdfb32fda1fddb4,0,Grant Ingersoll,2008-08-19 12:53:38+00:00,['42592067e2ccc7d998d7dca4cc85fa257b8165db'],0,5,5,57032,1,,,,414
0391850affd7975616f57601c4250764d831a42b,1,Grant Ingersoll,2008-08-19 12:55:45+00:00,['d8bafd5791e0e796788e63500bdfb32fda1fddb4'],2,5952,5954,62986,57,0.311539976,0.766443482,0.667979519,470
ba295b0497f1c8c32a1ee475580b3db769b00f37,0,Grant Ingersoll,2008-08-20 13:36:07+00:00,['0391850affd7975616f57601c4250764d831a42b'],0,0,0,62986,2,,,,472
93e06fa3d5173b9fb57ee7b70105654afcc46ac5,0,Sean R. Owen,2008-08-21 05:16:06+00:00,['ba295b0497f1c8c32a1ee475580b3db769b00f37'],9,37,46,63032,5,0.466666667,0,0,472
b5a9a0a5c6cb6ece7b4648c8c2a9dd663386eb47,0,Sean R. Owen,2008-08-21 10:09:05+00:00,['93e06fa3d5173b9fb57ee7b70105654afcc46ac5'],1,1,2,63034,1,,,,472
0d23c9c2ece0a4af7314d22435e07b5426493fbe,1,Karl-Johan Wettin,2008-08-21 11:37:16+00:00,['b5a9a0a5c6cb6ece7b4648c8c2a9dd663386eb47'],2,25,27,63061,8,,,,472
141e4c3d68a0045fe854d9c1ed73e184de2da87b,0,Karl-Johan Wettin,2008-08-21 11:47:48+00:00,['0d23c9c2ece0a4af7314d22435e07b5426493fbe'],1,1,2,63063,1,,,,472
4a8639d8bb0218796d7fa0b433a323c5827f4579,0,Karl-Johan Wettin,2008-08-21 14:23:50+00:00,['141e4c3d68a0045fe854d9c1ed73e184de2da87b'],11,22,33,63096,5,1,1,1,472
4dc6a6cde1340b6f0fa17ba70687778bbe0efd5d,0,Karl-Johan Wettin,2008-08-21 15:34:01+00:00,['4a8639d8bb0218796d7fa0b433a323c5827f4579'],9,11,20,63116,2,,,,472
b4cfbe1e180e58e8cd3471c1a3372d93aa811b2e,1,Grant Ingersoll,2008-08-22 17:05:39+00:00,['4dc6a6cde1340b6f0fa17ba70687778bbe0efd5d'],3,1542,1545,64661,9,0.297530864,0.650617284,0.692592593,480
b0be89b6215112a68f26ff15d554fb0e4b3bf0db,1,Sean R. Owen,2008-08-23 15:21:22+00:00,['b4cfbe1e180e58e8cd3471c1a3372d93aa811b2e'],142,155,297,64958,53,0,0,0,480
dd952bb373e4f3fb0217fcb64e9f1e5566c9cd9a,0,Sean R. Owen,2008-08-23 16:22:14+00:00,['b0be89b6215112a68f26ff15d554fb0e4b3bf0db'],4,8,12,64970,2,0,0,0,480
7f6626cd2056bdbfdf16be06dc1aaa251b39995a,1,Sean R. Owen,2008-08-23 16:48:28+00:00,['dd952bb373e4f3fb0217fcb64e9f1e5566c9cd9a'],834,662,1496,66466,135,0.583333333,0,0.111111111,480
78ef8aaa0036cdd02b43214a6c4ffea74323b8e5,1,Sean R. Owen,2008-08-24 16:10:42+00:00,['7f6626cd2056bdbfdf16be06dc1aaa251b39995a'],837,830,1667,68133,56,0.164383562,0.602739726,0.712328767,480
6502d605ff60847d91fc1bd7d6dd488d31d1a37f,1,Karl-Johan Wettin,2008-08-25 12:29:35+00:00,['78ef8aaa0036cdd02b43214a6c4ffea74323b8e5'],0,128,128,68261,2,0.12195122,0.12195122,1,482
932b53a2347a1d766c0c215f8d917b9ecab94179,1,Sean R. Owen,2008-08-25 15:59:35+00:00,['6502d605ff60847d91fc1bd7d6dd488d31d1a37f'],271,273,544,68805,24,1,0.631578947,0.157894737,482
9ec6989af5e5c35865fa14313455e78da0e21485,0,Sean R. Owen,2008-08-26 22:46:17+00:00,['932b53a2347a1d766c0c215f8d917b9ecab94179'],0,8,8,68813,1,0,0,0,482
8d109ec4f36dec47accfeeef38c991ddd10d0d5b,0,Sean R. Owen,2008-08-27 01:05:04+00:00,['9ec6989af5e5c35865fa14313455e78da0e21485'],1,2,3,68816,1,0,0,0,482
1eccbcfea0f7490afe1d255d4a89d04cbbfdf985,0,Sean R. Owen,2008-08-31 16:25:09+00:00,['8d109ec4f36dec47accfeeef38c991ddd10d0d5b'],177,210,387,69203,53,0.7,0,1,486
b9432ed47a962b787344661d40d77e9255cb700c,0,Sean R. Owen,2008-09-02 16:20:30+00:00,['1eccbcfea0f7490afe1d255d4a89d04cbbfdf985'],5,30,35,69238,2,1,1,1,486
8434e44d949b4f63be75d44e944ca35e873b25cd,0,Sean R. Owen,2008-09-02 16:22:47+00:00,['b9432ed47a962b787344661d40d77e9255cb700c'],433,435,868,70106,37,,,,486
955a439fea493cbe13b453b9b3ffc1436b3d2fbe,0,Grant Ingersoll,2008-09-11 15:56:52+00:00,['8434e44d949b4f63be75d44e944ca35e873b25cd'],0,52,52,70158,1,,,,487
062041e4ea1914ce70a2c5da5ef3d9b28f870484,0,Sean R. Owen,2008-09-12 15:06:38+00:00,['955a439fea493cbe13b453b9b3ffc1436b3d2fbe'],4,28,32,70190,2,0.625,0.625,0.625,487
8413b05759ae5bf88e36d6505a129d99d8f9a3f5,1,Grant Ingersoll,2008-09-17 13:49:34+00:00,['062041e4ea1914ce70a2c5da5ef3d9b28f870484'],0,52,52,70242,1,,,,488
c439ed00a2ccc73881ae16e96f4e408028a81a7d,0,Grant Ingersoll,2008-09-17 13:49:49+00:00,['8413b05759ae5bf88e36d6505a129d99d8f9a3f5'],52,0,52,70294,1,,,,488
3709bc58ce71b0cee169e8351484938a1e48ca3e,1,Karl-Johan Wettin,2008-09-17 13:56:35+00:00,['c439ed00a2ccc73881ae16e96f4e408028a81a7d'],0,36,36,70330,1,,,,488
71e2414dbb03fc550e18a52c2be00a4d3cef2746,0,Grant Ingersoll,2008-09-17 13:58:07+00:00,['3709bc58ce71b0cee169e8351484938a1e48ca3e'],1,17,18,70348,2,,,,488
1b4c0e28185c33afc8f7b3c47ceb72a1f3f3a7ab,0,Karl-Johan Wettin,2008-09-21 15:08:13+00:00,['71e2414dbb03fc550e18a52c2be00a4d3cef2746'],4,4,8,70356,1,,,,488
be69161283070aad24ceb880e08ca3deb2b1a42d,0,Karl-Johan Wettin,2008-09-21 15:08:38+00:00,['1b4c0e28185c33afc8f7b3c47ceb72a1f3f3a7ab'],6,6,12,70368,4,,,,488
d1be9cf613a7425747a00479a6b02fde82c5cc42,0,Karl-Johan Wettin,2008-09-21 17:05:54+00:00,['be69161283070aad24ceb880e08ca3deb2b1a42d'],0,13,13,70381,1,,,,488
0c74b63312a2d5a08d15b57bed67dd971944b99a,1,Karl-Johan Wettin,2008-09-21 17:08:18+00:00,['d1be9cf613a7425747a00479a6b02fde82c5cc42'],0,23,23,70404,2,,,,488
8da1d8c44da8b107fc3ac755240b4fd9c44cd63a,0,Karl-Johan Wettin,2008-09-21 17:10:41+00:00,['0c74b63312a2d5a08d15b57bed67dd971944b99a'],4,95,99,70503,2,,,,488
6a88bd3115b874d85bcc4935ef9f085f4c820e1a,0,Karl-Johan Wettin,2008-09-21 21:31:40+00:00,['8da1d8c44da8b107fc3ac755240b4fd9c44cd63a'],0,12,12,70515,1,,,,488
ab28b8b85b416ad71335738d6f24925f16584a39,0,Grant Ingersoll,2008-09-22 12:27:16+00:00,['6a88bd3115b874d85bcc4935ef9f085f4c820e1a'],1,18,19,70534,1,,,,488
0f305a6b60cbb9e3431c4d599cf0cf7c651bf36d,0,Grant Ingersoll,2008-09-22 12:31:26+00:00,['ab28b8b85b416ad71335738d6f24925f16584a39'],0,100,100,70634,6,,,,488
e6f91abe5d815670ad52e217bfb81f3189c37a37,1,Karl-Johan Wettin,2008-09-24 16:48:48+00:00,['0f305a6b60cbb9e3431c4d599cf0cf7c651bf36d'],4,4,8,70642,4,,,,488
dd5d3579a8b7d2028789cf05c6c9848a66cc8d78,1,Karl-Johan Wettin,2008-09-25 13:13:34+00:00,['e6f91abe5d815670ad52e217bfb81f3189c37a37'],5,5,10,70652,3,,,,488
8d77cdedd886597a10d34b9a0ef81adaf33c8987,0,Karl-Johan Wettin,2008-09-25 14:57:09+00:00,['dd5d3579a8b7d2028789cf05c6c9848a66cc8d78'],1,18,19,70671,1,,,,488
33c3ef13054ce941121ec2bdf197fdf7ebc2e563,0,Grant Ingersoll,2008-09-26 13:57:23+00:00,['8d77cdedd886597a10d34b9a0ef81adaf33c8987'],333,256,589,71260,1,,,,488
6ce282a93accb0477bfda24f69deb09184545ea0,0,Otis Gospodnetic,2008-09-29 17:48:11+00:00,['33c3ef13054ce941121ec2bdf197fdf7ebc2e563'],3,3,6,71266,1,,,,488
e8262b15f341a16146165688db009f85dfd98c15,0,Grant Ingersoll,2008-09-29 19:02:36+00:00,['6ce282a93accb0477bfda24f69deb09184545ea0'],0,1,1,71267,1,,,,488
4de1814943a6364089ec2a489bb08d0719f5b5bb,0,Otis Gospodnetic,2008-10-03 19:44:17+00:00,['e8262b15f341a16146165688db009f85dfd98c15'],3,3,6,71273,2,,,,488
c4ef7efac75a45371151b27079c89e091906e394,0,Sean R. Owen,2008-10-11 15:35:10+00:00,['4de1814943a6364089ec2a489bb08d0719f5b5bb'],2,5,7,71280,1,,,,488
a5e5d5dbb16d0fa9cf323c45c33c8b2f6d3602b3,1,Sean R. Owen,2008-10-14 11:07:46+00:00,['c4ef7efac75a45371151b27079c89e091906e394'],149,180,329,71609,37,0.285714286,0.071428571,1,488
faad04042fb21e4c0bd1fe316a45e5491f9bfda7,0,Grant Ingersoll,2008-10-16 18:02:27+00:00,['a5e5d5dbb16d0fa9cf323c45c33c8b2f6d3602b3'],1,1,2,71611,1,,,,488
4643ae503c4b0024b80e8fa880e1fb944c405d95,0,Grant Ingersoll,2008-10-16 18:05:52+00:00,['faad04042fb21e4c0bd1fe316a45e5491f9bfda7'],1,1,2,71613,1,,,,488
b0232339c0d79baab652ef79eff986cc4204c25f,0,Grant Ingersoll,2008-10-16 18:06:18+00:00,['4643ae503c4b0024b80e8fa880e1fb944c405d95'],1,1,2,71615,1,,,,488
34821786940919c3e12ea641a53f1506a12aeac3,0,Grant Ingersoll,2008-10-16 18:17:16+00:00,['b0232339c0d79baab652ef79eff986cc4204c25f'],1,1,2,71617,1,,,,488
82a1d6305783b6f54d80f8954b9b682e477f00f4,0,Grant Ingersoll,2008-10-16 18:17:38+00:00,['34821786940919c3e12ea641a53f1506a12aeac3'],1,1,2,71619,1,,,,488
5c8f78f9b586d497a52c6b67616d7de5d26e2c4b,0,Grant Ingersoll,2008-10-16 20:56:57+00:00,['82a1d6305783b6f54d80f8954b9b682e477f00f4'],353,228,581,72200,4,,,,489
9d1dea51f2152ed3267f6293631a9a9bbf0171b9,0,Grant Ingersoll,2008-10-16 21:06:36+00:00,['5c8f78f9b586d497a52c6b67616d7de5d26e2c4b'],0,3,3,72203,1,,,,489
e84d6d27b1de1d5675f81cb2a150c59272338bdc,0,Grant Ingersoll,2008-10-16 21:10:52+00:00,['9d1dea51f2152ed3267f6293631a9a9bbf0171b9'],0,3,3,72206,1,,,,489
66d0c178ab6bed84626f29522136314378c915f8,0,Grant Ingersoll,2008-10-16 22:31:17+00:00,['e84d6d27b1de1d5675f81cb2a150c59272338bdc'],28,167,195,72401,7,,,,493
2eefb042eecda11982b5da6f0da2e218f5f94290,0,Grant Ingersoll,2008-10-16 22:39:04+00:00,['66d0c178ab6bed84626f29522136314378c915f8'],2,7,9,72410,1,,,,493
6a1cb5dc3731c3f4e53d391469c1d32af2217c03,0,Grant Ingersoll,2008-10-17 00:50:27+00:00,['2eefb042eecda11982b5da6f0da2e218f5f94290'],95,132,227,72637,5,0,0,1,493
8a84dcd0fb569d1259b88485c5a05a2655bb2e51,0,Grant Ingersoll,2008-10-17 01:06:38+00:00,['6a1cb5dc3731c3f4e53d391469c1d32af2217c03'],1,1,2,72639,1,,,,493
42d0bd0dc2dd67ba3bb415b8d9a1562905ea67ae,0,Jeff Eastman,2008-10-17 17:16:55+00:00,['8a84dcd0fb569d1259b88485c5a05a2655bb2e51'],1,1,2,72641,1,,,,493
26034ec5a19caab64c0621c9bdd5b6e5b08b0440,1,Grant Ingersoll,2008-10-17 17:45:45+00:00,['42d0bd0dc2dd67ba3bb415b8d9a1562905ea67ae'],157,252,409,73050,9,0,0.621621622,1,493
d38260349531d2bd0a9846885cc1fb3248696611,1,Jeff Eastman,2008-10-17 18:44:18+00:00,['26034ec5a19caab64c0621c9bdd5b6e5b08b0440'],5,100,105,73155,7,1,1,1,494
732f03088ef215d8c86e3663ff05eea6545612f6,0,Grant Ingersoll,2008-10-17 19:20:09+00:00,['d38260349531d2bd0a9846885cc1fb3248696611'],3,6,9,73164,4,,,,494
35c3a29a4ea357fa6d567c7d5baa11e35ae8d2aa,0,Grant Ingersoll,2008-10-17 19:25:03+00:00,['732f03088ef215d8c86e3663ff05eea6545612f6'],3,3,6,73170,1,,,,494
e9c586d3d5aea6fe98c26dcac5cd895877f2a002,0,Grant Ingersoll,2008-10-17 19:51:57+00:00,['35c3a29a4ea357fa6d567c7d5baa11e35ae8d2aa'],1,1,2,73172,1,,,,494
4f6b3b0c2cf019c57fd856a008a11b0fa2ba2ce0,0,Grant Ingersoll,2008-10-17 19:58:26+00:00,['e9c586d3d5aea6fe98c26dcac5cd895877f2a002'],1,1,2,73174,1,,,,494
42dde4eef7c4f7b7cfb8aec24621feabb54fae5f,0,Grant Ingersoll,2008-10-17 20:32:39+00:00,['4f6b3b0c2cf019c57fd856a008a11b0fa2ba2ce0'],1,1,2,73176,2,,,,494
358c5749d0a6fc38e9442187b78403367895478c,1,Sean R. Owen,2008-10-20 10:04:21+00:00,['42dde4eef7c4f7b7cfb8aec24621feabb54fae5f'],838,1056,1894,75070,193,0,1,0.333333333,494
45e0c3e4c3190bc3c708b853641d82f0e3e9db3c,1,Sean R. Owen,2008-10-24 11:47:42+00:00,['358c5749d0a6fc38e9442187b78403367895478c'],1815,744,2559,77629,120,0.915662651,0.56626506,0.21686747,494
4d90718c3aea5c15291e56b0d7eb35f0db6f0717,0,Sean R. Owen,2008-10-24 16:01:39+00:00,['45e0c3e4c3190bc3c708b853641d82f0e3e9db3c'],1,30,31,77660,1,,,,494
990d76131a4e9adbdc06b3edf62322b6d14cfbd3,0,Sean R. Owen,2008-10-28 10:35:51+00:00,['4d90718c3aea5c15291e56b0d7eb35f0db6f0717'],5,10,15,77675,1,0.2,1,0,494
bd220119527065ff0e60b45c8468662b8d01dbdd,0,Sean R. Owen,2008-10-28 10:41:38+00:00,['990d76131a4e9adbdc06b3edf62322b6d14cfbd3'],53,33,86,77761,11,1,0.714285714,0.523809524,494
ed9696caacf8364aa1636c06539f284678fd34b6,0,Grant Ingersoll,2008-10-31 15:10:28+00:00,['bd220119527065ff0e60b45c8468662b8d01dbdd'],0,229,229,77990,1,,,,495
260b2bd6c371961dc61d5655427e46ebce725d2f,0,Grant Ingersoll,2008-10-31 16:01:35+00:00,['ed9696caacf8364aa1636c06539f284678fd34b6'],1,1,2,77992,1,,,,495
d925b9eb30c06b112c70881987c1ceaff0214599,0,Grant Ingersoll,2008-10-31 17:27:58+00:00,['260b2bd6c371961dc61d5655427e46ebce725d2f'],1,19,20,78012,1,,,,495
6c76f3c12a26774bee72723bc60a5188e8127e38,0,Grant Ingersoll,2008-10-31 17:28:48+00:00,['d925b9eb30c06b112c70881987c1ceaff0214599'],2,3,5,78017,1,,,,495
1adf75e1ce294190b3164ea119b65e6e0f5a56c4,0,Grant Ingersoll,2008-10-31 17:30:12+00:00,['6c76f3c12a26774bee72723bc60a5188e8127e38'],1,9,10,78027,2,,,,495
7bb88f895e1ee2fab9732bf976c24be3759c07ff,1,Sean R. Owen,2008-10-31 19:02:53+00:00,['1adf75e1ce294190b3164ea119b65e6e0f5a56c4'],17,36,53,78080,2,0.75,0.875,0,495
67375589969cb4ecbdcd1c2fd9b93d138442f1b1,0,Grant Ingersoll,2008-10-31 20:07:04+00:00,['7bb88f895e1ee2fab9732bf976c24be3759c07ff'],1,1,2,78082,1,,,,495
5b821555191722d104e949c6abd95e3d1bd2fe98,0,Grant Ingersoll,2008-10-31 20:35:42+00:00,['67375589969cb4ecbdcd1c2fd9b93d138442f1b1'],2,2,4,78086,1,,,,495
9a2b9647c4b4d6e36689afa39a08f7e4a301fb92,0,Grant Ingersoll,2008-10-31 21:28:46+00:00,['5b821555191722d104e949c6abd95e3d1bd2fe98'],21,21,42,78128,8,,,,495
d86e6c006b15ad19cef7f4c28b58375a4863f504,0,Grant Ingersoll,2008-11-01 17:37:59+00:00,['9a2b9647c4b4d6e36689afa39a08f7e4a301fb92'],2,2,4,78132,1,,,,495
f0b0dc456797aa46f16aca9a328ca26eadc9fc55,0,Grant Ingersoll,2008-11-01 18:18:51+00:00,['d86e6c006b15ad19cef7f4c28b58375a4863f504'],2,2,4,78136,1,,,,495
7b8b1743155f24068eb2028e87ae9e447f6070cb,0,Grant Ingersoll,2008-11-01 18:41:34+00:00,['f0b0dc456797aa46f16aca9a328ca26eadc9fc55'],1,1,2,78138,1,,,,495
307994c2d364e009c1432e7c34ba971131fc6ece,0,Grant Ingersoll,2008-11-01 20:34:57+00:00,['7b8b1743155f24068eb2028e87ae9e447f6070cb'],11,20,31,78169,1,0,0,0,495
5eee7e0d8b7fa4eb45e81481ee375f5db0ea6504,0,Grant Ingersoll,2008-11-01 20:37:46+00:00,['307994c2d364e009c1432e7c34ba971131fc6ece'],2,2,4,78173,1,,,,495
f6d6b2937e756fd2a965b4505024dd67611d6309,0,Sean R. Owen,2008-11-02 10:24:18+00:00,['5eee7e0d8b7fa4eb45e81481ee375f5db0ea6504'],2,7,9,78182,1,1,1,1,495
9d22ce7dcdd1c9db352d51933fee01d800432d76,1,Sean R. Owen,2008-11-02 15:18:47+00:00,['f6d6b2937e756fd2a965b4505024dd67611d6309'],62,63,125,78307,2,,,,495
6e77677ebca428d346457af3b3b94ce4aa21324d,0,Grant Ingersoll,2008-11-03 03:39:22+00:00,['9d22ce7dcdd1c9db352d51933fee01d800432d76'],1,1,2,78309,1,,,,495
79d0bc2514cebea0260c56536adb6989c01591ac,0,Sean R. Owen,2008-11-03 09:42:36+00:00,['6e77677ebca428d346457af3b3b94ce4aa21324d'],94,94,188,78497,22,,,,495
9fb0bd9c87d40a344a56cc6238799ff7d12799bf,1,Sean R. Owen,2008-11-04 16:11:01+00:00,['79d0bc2514cebea0260c56536adb6989c01591ac'],29,484,513,79010,12,0.821782178,1,1,497
3bf78f84933d0f906feabb5ac68cbee4c4e857f4,0,Otis Gospodnetic,2008-11-06 18:55:05+00:00,['9fb0bd9c87d40a344a56cc6238799ff7d12799bf'],1,5,6,79016,1,,,,497
863470a46d9cac8305e52aae0f9c941797fb7af0,0,Otis Gospodnetic,2008-11-06 18:57:15+00:00,['3bf78f84933d0f906feabb5ac68cbee4c4e857f4'],1,1,2,79018,1,,,,497
e851a248537271fdbb3c11f6957656cf564dad7e,1,Sean R. Owen,2008-11-07 11:01:09+00:00,['863470a46d9cac8305e52aae0f9c941797fb7af0'],64,42,106,79124,11,0.217391304,0.217391304,1,497
558c33f6796e7159ac09ef559228fb2821709a7b,1,Grant Ingersoll,2008-11-07 23:39:26+00:00,['e851a248537271fdbb3c11f6957656cf564dad7e'],79,124,203,79327,11,0.105263158,1,0.894736842,498
d6235d015a5cb7b3d21d93324b807c9e0182743b,1,Sean R. Owen,2008-11-08 14:39:41+00:00,['558c33f6796e7159ac09ef559228fb2821709a7b'],398,367,765,80092,29,0.763636364,0.763636364,0.309090909,499
d690c83fbcaf894e5ffbeb1a0b65cc212d25e8a5,0,Sean R. Owen,2008-11-09 17:11:00+00:00,['d6235d015a5cb7b3d21d93324b807c9e0182743b'],11,12,23,80115,4,0,0,1,499
b88e34a1607db5bedf8a3b189bbca791243a4a18,0,Sean R. Owen,2008-11-12 10:52:25+00:00,['d690c83fbcaf894e5ffbeb1a0b65cc212d25e8a5'],4,9,13,80128,1,,,,499
6d805f8c861e682a7c8d9317b48a6bf1ba788a06,0,Sean R. Owen,2008-11-12 12:43:18+00:00,['b88e34a1607db5bedf8a3b189bbca791243a4a18'],59,76,135,80263,4,0,0,0.428571429,499
112a5dbabe07c225b8299295cb1958e223b7acfa,0,Otis Gospodnetic,2008-11-12 15:14:34+00:00,['6d805f8c861e682a7c8d9317b48a6bf1ba788a06'],1,1,2,80265,1,,,,499
9cac2f30be2dcf954fd3cc14e2905aec722d10ee,0,Sean R. Owen,2008-11-13 14:22:51+00:00,['112a5dbabe07c225b8299295cb1958e223b7acfa'],6,6,12,80277,7,,,,501
ff9f2f12802e1394e42934e434a28d3946a3908c,1,Grant Ingersoll,2008-11-30 04:04:54+00:00,['9cac2f30be2dcf954fd3cc14e2905aec722d10ee'],175,386,561,80838,9,0,0,0.680851064,502
1e67bf5c6abea58341d4ee3a899c6bb7cacf48ae,0,Sean R. Owen,2008-12-03 18:00:50+00:00,['ff9f2f12802e1394e42934e434a28d3946a3908c'],25,85,110,80948,3,0.163265306,1,0.163265306,502
f09228b2be7fc67484220fbc260996846b38942e,0,Sean R. Owen,2008-12-03 18:04:59+00:00,['1e67bf5c6abea58341d4ee3a899c6bb7cacf48ae'],2,2,4,80952,1,,,,502
ed38552e1bf451dd65e14117f276ae02bda35811,0,Sean R. Owen,2008-12-03 18:06:54+00:00,['f09228b2be7fc67484220fbc260996846b38942e'],2,2,4,80956,1,,,,502
58d7a84ad21b12a3ac5c710e6b9dec17fc1df0ba,1,Sean R. Owen,2008-12-23 23:32:31+00:00,['ed38552e1bf451dd65e14117f276ae02bda35811'],559,1115,1674,82630,234,0.702380952,1,0.964285714,502
8d3a9d4dc4105b6a99d4318265910c89ba4ea930,0,Sean R. Owen,2008-12-30 15:37:00+00:00,['58d7a84ad21b12a3ac5c710e6b9dec17fc1df0ba'],0,132,132,82762,2,1,1,1,504
b174f6b6ed178a1c7a67340ac00084a4b33b4479,1,Sean R. Owen,2009-01-04 05:05:24+00:00,['8d3a9d4dc4105b6a99d4318265910c89ba4ea930'],19,512,531,83293,10,0.497674419,0.776744186,0.823255814,510
884ab10a1bcab7161eff764f8116039b4b521b96,0,Sean R. Owen,2009-01-04 20:04:03+00:00,['b174f6b6ed178a1c7a67340ac00084a4b33b4479'],17,108,125,83418,6,0.533333333,0.222222222,0.955555556,511
64daaa4b3badd6e6db8fbbfd50d0033cf0728656,0,Sean R. Owen,2009-01-07 00:29:58+00:00,['884ab10a1bcab7161eff764f8116039b4b521b96'],0,270,270,83688,6,0.723684211,1,0.631578947,517
81d77f722c82617626f94b9a51bc59bb2f37890f,0,Sean R. Owen,2009-01-07 16:33:26+00:00,['64daaa4b3badd6e6db8fbbfd50d0033cf0728656'],5,4,9,83697,1,1,0,1,517
03795b0397655d29be4a54bf91432450ccb6de6f,0,Sean R. Owen,2009-01-10 00:18:14+00:00,['81d77f722c82617626f94b9a51bc59bb2f37890f'],2,858,860,84557,7,0.700483092,0.830917874,0.707729469,522
b9b837c4ee8f408710dbbfdf35806489d8385dde,0,Sean R. Owen,2009-01-10 17:09:52+00:00,['03795b0397655d29be4a54bf91432450ccb6de6f'],13,4,17,84574,7,1,0.2,0,522
5e56d973e947c216d0a5dd06b0af1c5fdfba8ad5,0,Sean R. Owen,2009-01-10 18:15:42+00:00,['b9b837c4ee8f408710dbbfdf35806489d8385dde'],66,57,123,84697,18,1,0,0.833333333,522
8a854b4c9bcce43bd87edb6b3574d2f27633a933,0,Otis Gospodnetic,2009-01-13 20:32:29+00:00,['5e56d973e947c216d0a5dd06b0af1c5fdfba8ad5'],2,2,4,84701,1,,,,522
0dece127488fd13393770e7c78b62a6903bdffad,0,Sean R. Owen,2009-01-15 00:49:38+00:00,['8a854b4c9bcce43bd87edb6b3574d2f27633a933'],0,271,271,84972,2,0.583333333,0.704545455,0.977272727,524
ac34e851136dfc17efc55aa6af1917dbd4129cd2,0,Sean R. Owen,2009-01-15 07:50:12+00:00,['0dece127488fd13393770e7c78b62a6903bdffad'],4,5,9,84981,1,,,,524
28d8b152e15f74699ad2ddc7b7e856d1f5b78ccf,0,Sean R. Owen,2009-01-15 21:20:49+00:00,['ac34e851136dfc17efc55aa6af1917dbd4129cd2'],5,270,275,85256,4,0.619402985,0.753731343,0.97761194,526
0d5586e22938d4bc5de5746ead2dc9575945b3c6,0,Sean R. Owen,2009-01-17 15:15:17+00:00,['28d8b152e15f74699ad2ddc7b7e856d1f5b78ccf'],12,169,181,85437,5,1,1,0.794117647,529
fb482d02254f88cc431670ab5060808eab908395,0,Sean R. Owen,2009-01-17 15:24:43+00:00,['0d5586e22938d4bc5de5746ead2dc9575945b3c6'],2,21,23,85460,3,1,1,1,529
7b5d4b5de8ec9589f9f0f56bf532fce008f3501e,0,Sean R. Owen,2009-01-18 20:49:13+00:00,['fb482d02254f88cc431670ab5060808eab908395'],11,43,54,85514,2,0,0,0.538461538,529
8681219a2b1f6db69bf0b67e9d574f6ac4cca767,0,Sean R. Owen,2009-01-20 22:24:40+00:00,['7b5d4b5de8ec9589f9f0f56bf532fce008f3501e'],71,55,126,85640,4,1,1,0,529
04b5a4d6491acb0c0101d3bf4cc2eadaadf4eecc,0,Sean R. Owen,2009-01-20 22:33:11+00:00,['8681219a2b1f6db69bf0b67e9d574f6ac4cca767'],119,8,127,85767,2,1,1,1,529
d36507b279bb903e3d3bbef9ae48479eb5e93dd3,0,Sean R. Owen,2009-01-22 20:28:12+00:00,['04b5a4d6491acb0c0101d3bf4cc2eadaadf4eecc'],26,87,113,85880,13,1,1,1,531
7cba6c80eb3aaa44c144aabf011929780fe59615,0,Sean R. Owen,2009-01-23 14:44:30+00:00,['d36507b279bb903e3d3bbef9ae48479eb5e93dd3'],104,28,132,86012,25,,,,531
8b50e89805d7c041e510041aad992dd0d6bf895a,0,Sean R. Owen,2009-01-23 14:50:04+00:00,['7cba6c80eb3aaa44c144aabf011929780fe59615'],2,2,4,86016,1,,,,531
794c3aea496ccf2b6a48467d0fce7d9c97608f11,1,Otis Gospodnetic,2009-01-29 19:38:03+00:00,['8b50e89805d7c041e510041aad992dd0d6bf895a'],4,29,33,86049,1,1,1,0.153846154,531
18a586b5285ff95a7eed7e6b07ca60c7b2df91ce,0,Otis Gospodnetic,2009-01-29 19:41:47+00:00,['794c3aea496ccf2b6a48467d0fce7d9c97608f11'],1,1,2,86051,1,,,,531
a13f48fbe092c07261db975c525777522410c6a9,0,Sean R. Owen,2009-01-30 15:53:26+00:00,['18a586b5285ff95a7eed7e6b07ca60c7b2df91ce'],40,26,66,86117,1,0,0,0,531
a036bf518f7eeff363cb35b45208a2b2415ef195,0,Sean R. Owen,2009-01-31 14:22:24+00:00,['a13f48fbe092c07261db975c525777522410c6a9'],616,20,636,86753,11,,,,533
25217da1dbdba7e722db741aa11f98e86e41784d,0,Sean R. Owen,2009-02-01 23:44:11+00:00,['a036bf518f7eeff363cb35b45208a2b2415ef195'],31,76,107,86860,4,0.62962963,0.592592593,0.62962963,533
328088678b7f90080150e37d774b6f42e49f7ab9,0,Sean R. Owen,2009-02-01 23:59:53+00:00,['25217da1dbdba7e722db741aa11f98e86e41784d'],2,5,7,86867,1,0,0,1,533
23f5202b6e8a5d0468fcc95277d166f38b64aeec,0,Grant Ingersoll,2009-02-02 16:53:11+00:00,['328088678b7f90080150e37d774b6f42e49f7ab9'],1,25,26,86893,1,1,1,1,533
7b3ba4655a6a4edca43e1fd09c43ee43ce4f3ba4,0,Grant Ingersoll,2009-02-02 16:53:28+00:00,['23f5202b6e8a5d0468fcc95277d166f38b64aeec'],10,0,10,86903,1,,,,533
ded3f0f3560b623900fd99571eaf1026a2f5691f,0,Grant Ingersoll,2009-02-02 17:00:14+00:00,['7b3ba4655a6a4edca43e1fd09c43ee43ce4f3ba4'],17,17,34,86937,7,,,,533
660fc70aa2280d217d5bd2b823c9d4d3dfddcd80,0,Sean R. Owen,2009-02-02 19:07:57+00:00,['ded3f0f3560b623900fd99571eaf1026a2f5691f'],15,19,34,86971,3,0,1,1,533
120401405cc2154416a1785c282cf58e4b225fad,0,Sean R. Owen,2009-02-02 19:19:36+00:00,['660fc70aa2280d217d5bd2b823c9d4d3dfddcd80'],7,1,8,86979,1,0,0,0,533
e3f80a1ee2c6aa94be0eb183856bf1c1271a67e3,0,Grant Ingersoll,2009-02-03 14:28:01+00:00,['120401405cc2154416a1785c282cf58e4b225fad'],1868,6,1874,88853,37,,,,533
dabdc0e22ce8673ca0998d6e2e8285c184ea7339,0,Grant Ingersoll,2009-02-03 15:08:45+00:00,['e3f80a1ee2c6aa94be0eb183856bf1c1271a67e3'],124,49,173,89026,2,,,,534
5b6ed8bb3cbea2fd42043602e23993a19b991f4f,0,Grant Ingersoll,2009-02-03 16:02:29+00:00,['dabdc0e22ce8673ca0998d6e2e8285c184ea7339'],5,164,169,89195,4,,,,535
a1fee6f5ae81cf932d8a262576df7aad6d3c30de,1,Grant Ingersoll,2009-02-04 15:40:19+00:00,['5b6ed8bb3cbea2fd42043602e23993a19b991f4f'],23,231,254,89449,9,,,,537
08cce661f1efe70b3fd3dcc77c90aa61f77c54cb,1,Grant Ingersoll,2009-02-04 15:49:31+00:00,['a1fee6f5ae81cf932d8a262576df7aad6d3c30de'],17,50,67,89516,3,,,,537
7868e51d7b5d59ff93d7d93c60adc53d6bb04960,0,Sean R. Owen,2009-02-04 19:56:43+00:00,['08cce661f1efe70b3fd3dcc77c90aa61f77c54cb'],22,45,67,89583,5,0.272727273,1,1,537
5a06f0bf44bc8007c07da38276964a00dc66769f,0,Grant Ingersoll,2009-02-05 14:01:27+00:00,['7868e51d7b5d59ff93d7d93c60adc53d6bb04960'],13,59,72,89655,5,,,,538
3a4a00138bae2aaa272da85aed75c2ed1aa28058,1,Grant Ingersoll,2009-02-05 14:20:54+00:00,['5a06f0bf44bc8007c07da38276964a00dc66769f'],127,148,275,89930,5,,,,539
a2e0e7a8d282bc326c9a47df388418f06a4dd86e,0,Grant Ingersoll,2009-02-05 14:27:58+00:00,['3a4a00138bae2aaa272da85aed75c2ed1aa28058'],5,5,10,89940,5,,,,539
5a5dacc97c182fffd130131f12e0f3d757ea4f8c,0,Grant Ingersoll,2009-02-05 14:39:09+00:00,['a2e0e7a8d282bc326c9a47df388418f06a4dd86e'],5,5,10,89950,5,,,,539
1abd480c37550893ee1384e6b72af1f289d60540,0,Grant Ingersoll,2009-02-05 14:41:46+00:00,['5a5dacc97c182fffd130131f12e0f3d757ea4f8c'],0,4,4,89954,4,,,,539
c4ca4a1c53e9373777b2d1521d10408bcbe188c6,1,Grant Ingersoll,2009-02-05 14:43:37+00:00,['1abd480c37550893ee1384e6b72af1f289d60540'],5,8,13,89967,5,,,,539
c80f45bdf74250ae6a2ec083bae4d1019c7f5b25,1,Grant Ingersoll,2009-02-05 14:47:47+00:00,['c4ca4a1c53e9373777b2d1521d10408bcbe188c6'],4,4,8,89975,3,,,,539
72e1ecc63bdbffb58c3a1f7cbdcd2a8875763930,1,Grant Ingersoll,2009-02-05 15:12:42+00:00,['c80f45bdf74250ae6a2ec083bae4d1019c7f5b25'],0,9,9,89984,1,,,,539
86b32a28d6a6dd72c8772b56a4b489dac09df168,0,Grant Ingersoll,2009-02-05 15:14:52+00:00,['72e1ecc63bdbffb58c3a1f7cbdcd2a8875763930'],0,0,0,89984,0,,,,539
2ee03cbd73a9b873dc9d9e0100d3f85262a33b9e,0,Grant Ingersoll,2009-02-05 15:19:14+00:00,['86b32a28d6a6dd72c8772b56a4b489dac09df168'],32,45,77,90061,4,,,,539
70822ea7f2e24e4057ab3b6204e058a8dd50d050,1,Grant Ingersoll,2009-02-05 15:24:32+00:00,['2ee03cbd73a9b873dc9d9e0100d3f85262a33b9e'],0,1,1,90062,1,,,,539
6f11be6a14df540f920ca6745d60c4133bcba9b1,0,Grant Ingersoll,2009-02-05 15:26:57+00:00,['70822ea7f2e24e4057ab3b6204e058a8dd50d050'],4,4,8,90070,4,,,,539
aa02bd62dce16e5e04b7d4d515f9c6cf7cbce7cc,0,Grant Ingersoll,2009-02-05 15:30:54+00:00,['6f11be6a14df540f920ca6745d60c4133bcba9b1'],4,4,8,90078,4,,,,539
cf1e1c4ff7302859505a3e88378a6fed582dbbf4,0,Grant Ingersoll,2009-02-05 15:32:38+00:00,['aa02bd62dce16e5e04b7d4d515f9c6cf7cbce7cc'],4,4,8,90086,4,,,,539
c07818cb139749e02c496142d92bf350f891554b,1,Grant Ingersoll,2009-02-05 15:33:26+00:00,['cf1e1c4ff7302859505a3e88378a6fed582dbbf4'],1,1,2,90088,1,,,,539
ad4c424428f6c1445a3b213a06098db3e6d496fb,0,Grant Ingersoll,2009-02-05 15:38:39+00:00,['c07818cb139749e02c496142d92bf350f891554b'],12,12,24,90112,4,,,,539
f96d230a533ee0e180e102dccfdf0b7562488c54,0,Grant Ingersoll,2009-02-05 15:39:26+00:00,['ad4c424428f6c1445a3b213a06098db3e6d496fb'],12,12,24,90136,4,,,,539
57abddab07391f5b1ca3d1e9756c8ec606f4323b,0,Grant Ingersoll,2009-02-05 17:01:42+00:00,['f96d230a533ee0e180e102dccfdf0b7562488c54'],4,4,8,90144,4,,,,539
a36d715eecf8815e085a2fb68fe0e4a37b398ff4,1,Grant Ingersoll,2009-02-05 17:04:00+00:00,['57abddab07391f5b1ca3d1e9756c8ec606f4323b'],2,69,71,90215,1,,,,539
b07c0c1b57901f0edb61295c191233944377b0ce,0,Grant Ingersoll,2009-02-05 18:35:27+00:00,['a36d715eecf8815e085a2fb68fe0e4a37b398ff4'],12,12,24,90239,4,,,,539
564bea5cb2e47b83d5255b8abb8617dcea67cbf9,0,Grant Ingersoll,2009-02-05 18:45:18+00:00,['b07c0c1b57901f0edb61295c191233944377b0ce'],4,4,8,90247,4,,,,539
8da586e7205ac0e7315ffcdeabdd59a2a961cd79,0,Grant Ingersoll,2009-02-05 18:50:06+00:00,['564bea5cb2e47b83d5255b8abb8617dcea67cbf9'],4,4,8,90255,4,,,,539
0c849066e2529852feb38bf1bd9315bc94544c25,0,Grant Ingersoll,2009-02-05 18:50:25+00:00,['8da586e7205ac0e7315ffcdeabdd59a2a961cd79'],4,4,8,90263,4,,,,539
c98a2ebd27ddca0002f10fb12c1b74ffd2e9a07f,0,Sean R. Owen,2009-02-05 19:32:08+00:00,['0c849066e2529852feb38bf1bd9315bc94544c25'],11,20,31,90294,5,0,0.5,1,539
676ecce8cec2a4f11957709dc29c36ad7a3f8ed8,1,Grant Ingersoll,2009-02-06 01:27:34+00:00,['c98a2ebd27ddca0002f10fb12c1b74ffd2e9a07f'],98,137,235,90529,5,,,,539
c4205ca16a4dcdd9d909441b190afc6c08264f9c,0,Grant Ingersoll,2009-02-06 14:11:01+00:00,['676ecce8cec2a4f11957709dc29c36ad7a3f8ed8'],1,1,2,90531,1,,,,539
e2bce86c9dad65e2765b054aa91c44b995407645,0,Grant Ingersoll,2009-02-06 15:00:19+00:00,['c4205ca16a4dcdd9d909441b190afc6c08264f9c'],4,4,8,90539,4,,,,539
a90eaa479bf352d85f17a13a9abe9959544bc257,0,Grant Ingersoll,2009-02-06 15:00:32+00:00,['e2bce86c9dad65e2765b054aa91c44b995407645'],4,4,8,90547,4,,,,539
a20f6b066ad624a5a1761a6318e65ef00a658460,0,Grant Ingersoll,2009-02-06 16:37:54+00:00,['a90eaa479bf352d85f17a13a9abe9959544bc257'],4,4,8,90555,4,,,,539
5d2d68e70992e56d00f47fb849e97328a33eded7,0,Grant Ingersoll,2009-02-06 16:39:11+00:00,['a20f6b066ad624a5a1761a6318e65ef00a658460'],0,1,1,90556,1,,,,539
992c3818296104d36a4fe406397112f20a26d2c9,0,Grant Ingersoll,2009-02-06 16:44:07+00:00,['5d2d68e70992e56d00f47fb849e97328a33eded7'],4,4,8,90564,4,,,,539
ffee8afb89e5a1fc636cf4dc611223548570bdef,0,Grant Ingersoll,2009-02-06 16:45:01+00:00,['992c3818296104d36a4fe406397112f20a26d2c9'],4,4,8,90572,4,,,,539
97e829f2de3d6a1a8f10486c37a9239667313db9,0,Grant Ingersoll,2009-02-06 17:08:16+00:00,['ffee8afb89e5a1fc636cf4dc611223548570bdef'],4,4,8,90580,4,,,,539
69340abee57c256c85e011fd219696d17f21e861,1,Grant Ingersoll,2009-02-06 17:21:56+00:00,['97e829f2de3d6a1a8f10486c37a9239667313db9'],139,147,286,90866,2,,,,539
0f7f5c86d09ab5ff777978d9cf210c5edded10bc,0,Grant Ingersoll,2009-02-06 17:27:59+00:00,['69340abee57c256c85e011fd219696d17f21e861'],12,11,23,90889,4,,,,539
a89f8b394cbed53e9906caf82ea9c7fd37592559,0,Grant Ingersoll,2009-02-06 17:28:14+00:00,['0f7f5c86d09ab5ff777978d9cf210c5edded10bc'],4,4,8,90897,4,,,,539
2ab553ad129b368fcff5ccba2222b867788b3c65,0,Grant Ingersoll,2009-02-06 20:39:49+00:00,['a89f8b394cbed53e9906caf82ea9c7fd37592559'],7,55,62,90959,4,,,,539
a4076014395b661c29346f495211fa6ea8655f80,1,Grant Ingersoll,2009-02-06 20:43:29+00:00,['2ab553ad129b368fcff5ccba2222b867788b3c65'],3,3,6,90965,2,,,,539
0c0adfa897d39f2a6b562caed239b242c2c1e78e,0,Grant Ingersoll,2009-02-06 20:56:38+00:00,['a4076014395b661c29346f495211fa6ea8655f80'],1,1,2,90967,1,,,,539
a82c0db21096f3ef4518f7108441701946ec98e6,0,Grant Ingersoll,2009-02-06 20:57:25+00:00,['0c0adfa897d39f2a6b562caed239b242c2c1e78e'],1,1,2,90969,1,,,,539
de571bca0d4df2705913c174317449ea85480200,0,Grant Ingersoll,2009-02-06 20:58:49+00:00,['a82c0db21096f3ef4518f7108441701946ec98e6'],1,1,2,90971,1,,,,539
319aa26f879515ae83be5b136df16a96e115cc9f,0,Grant Ingersoll,2009-02-06 21:03:53+00:00,['de571bca0d4df2705913c174317449ea85480200'],4,4,8,90979,4,,,,539
1318fd1e5a9815c10780723e93517cee84c7486b,0,Grant Ingersoll,2009-02-06 21:04:31+00:00,['319aa26f879515ae83be5b136df16a96e115cc9f'],4,4,8,90987,4,,,,539
042538088fecf9671e3f5f35908ab67fd929134a,1,Grant Ingersoll,2009-02-07 21:01:01+00:00,['1318fd1e5a9815c10780723e93517cee84c7486b'],4,113,117,91104,5,,,,540
683309b451a7d01201173f59522a39f5af1ed883,0,Grant Ingersoll,2009-02-07 21:07:43+00:00,['042538088fecf9671e3f5f35908ab67fd929134a'],4,4,8,91112,4,,,,540
74fb261bf996507a8369bec88c9b4b0834bcafec,0,Grant Ingersoll,2009-02-07 21:08:01+00:00,['683309b451a7d01201173f59522a39f5af1ed883'],4,4,8,91120,4,,,,540
ec698213281e7115fefaf96ad17e03369504ed29,1,Grant Ingersoll,2009-02-09 14:13:27+00:00,['74fb261bf996507a8369bec88c9b4b0834bcafec'],22,151,173,91293,5,,,,540
c8c90e5c6cd15de45aecefbc599454661c4102c2,0,Grant Ingersoll,2009-02-09 14:17:16+00:00,['ec698213281e7115fefaf96ad17e03369504ed29'],4,4,8,91301,4,,,,540
3b12cc843279ab77df0fb208228ff6fca86f2f44,0,Grant Ingersoll,2009-02-09 14:28:59+00:00,['c8c90e5c6cd15de45aecefbc599454661c4102c2'],12,15,27,91328,4,,,,540
6799343ac3b8e5ac81c05d1b1f576e9324a26900,0,Grant Ingersoll,2009-02-09 14:29:14+00:00,['3b12cc843279ab77df0fb208228ff6fca86f2f44'],8,8,16,91344,4,,,,540
6c291d849a46379ed0857095aaff6ab95f03e097,0,Isabel Drost,2009-02-20 21:27:39+00:00,['6799343ac3b8e5ac81c05d1b1f576e9324a26900'],7,9,16,91360,1,,,,540
d4c83316ec0f54f3a1fb5d0ebee56fcb94f5dba9,0,Isabel Drost,2009-02-20 21:50:29+00:00,['6c291d849a46379ed0857095aaff6ab95f03e097'],2,1,3,91363,1,,,,540
8604a31b33e343931e1eebbd0e0d4e66c58d70c3,0,Sean R. Owen,2009-02-23 20:36:31+00:00,['d4c83316ec0f54f3a1fb5d0ebee56fcb94f5dba9'],16,17,33,91396,3,,,,540
42820b6da47cd8f66c8f395bc709e16c8c29e385,0,Sean R. Owen,2009-02-25 17:57:36+00:00,['8604a31b33e343931e1eebbd0e0d4e66c58d70c3'],35,87,122,91518,3,0.789473684,0.842105263,1,541
31387558ce02efbad13209af7943eca90a258df7,0,Sean R. Owen,2009-02-26 15:44:20+00:00,['42820b6da47cd8f66c8f395bc709e16c8c29e385'],3,3,6,91524,1,,,,541
445f7d17512a44169df70d8ecbb55f6318c70e79,0,Sean R. Owen,2009-02-26 15:47:58+00:00,['31387558ce02efbad13209af7943eca90a258df7'],10,8,18,91542,4,1,1,0,541
a034755f6872c1f353c903a96dcc00de523664ad,0,Sean R. Owen,2009-02-27 23:29:58+00:00,['445f7d17512a44169df70d8ecbb55f6318c70e79'],91,59,150,91692,16,0.6,0.371428571,0.142857143,541
821c7d9e8907553b7c846f3816c3df47ae5b04d7,0,Sean R. Owen,2009-02-27 23:31:54+00:00,['a034755f6872c1f353c903a96dcc00de523664ad'],7,4,11,91703,1,0,0,0,541
2d3c57475c4c190d215850b57c6462c7905c3118,0,Sean R. Owen,2009-02-27 23:35:54+00:00,['821c7d9e8907553b7c846f3816c3df47ae5b04d7'],50,56,106,91809,9,1,1,1,541
1a7bf903713bbf50e0dfc3f2dbf8c8aca4e594bb,0,Grant Ingersoll,2009-02-28 12:23:30+00:00,['2d3c57475c4c190d215850b57c6462c7905c3118'],4,4,8,91817,4,,,,541
40b08ad9f7c061522a9666df989f9b3838689fa8,0,Grant Ingersoll,2009-02-28 12:31:17+00:00,['1a7bf903713bbf50e0dfc3f2dbf8c8aca4e594bb'],8,8,16,91833,4,,,,541
14a3feacbb0238220641aaf596fe8feae8f95348,0,Grant Ingersoll,2009-02-28 12:31:31+00:00,['40b08ad9f7c061522a9666df989f9b3838689fa8'],8,8,16,91849,4,,,,541
51b9d94e8b396da5b79beda55fdbe043ebf071c7,0,Sean R. Owen,2009-03-07 10:58:54+00:00,['14a3feacbb0238220641aaf596fe8feae8f95348'],1,1,2,91851,1,,,,541
43a5c740d434d2901eaf0b24c4b1045a26e46405,0,Sean R. Owen,2009-03-08 10:22:52+00:00,['51b9d94e8b396da5b79beda55fdbe043ebf071c7'],4,44,48,91899,3,1,1,1,541
d91ba0d7e848f4792bb78b05d5ce2ac5be95a462,1,Sean R. Owen,2009-03-08 17:52:18+00:00,['43a5c740d434d2901eaf0b24c4b1045a26e46405'],345,407,752,92651,46,1,1,1,541
4c3897952879450e18840bef4959368b92674a64,0,Sean R. Owen,2009-03-08 18:00:23+00:00,['d91ba0d7e848f4792bb78b05d5ce2ac5be95a462'],12,1,13,92664,1,1,1,1,541
1bc8b432472632fdd4b76d4a8240161ee39b9bbf,0,Sean R. Owen,2009-03-13 00:36:44+00:00,['4c3897952879450e18840bef4959368b92674a64'],2,2,4,92668,4,,,,542
db1b3ebe10055325b5c7ee9b6f55ba0cdfcb73bb,0,Sean R. Owen,2009-03-13 00:41:34+00:00,['1bc8b432472632fdd4b76d4a8240161ee39b9bbf'],1,1,2,92670,1,,,,542
cce7bb3123423464b87d86e131f5b2baf6b535ad,0,Sean R. Owen,2009-03-13 01:05:57+00:00,['db1b3ebe10055325b5c7ee9b6f55ba0cdfcb73bb'],1,1,2,92672,1,,,,542
4e16b527cfce42c54e27db78bcf82da11dc7d025,0,Sean R. Owen,2009-03-13 01:08:10+00:00,['cce7bb3123423464b87d86e131f5b2baf6b535ad'],58,51,109,92781,7,,,,542
3c8a038ed7b6571d66984e7cf5756ab4816a313e,0,Grant Ingersoll,2009-03-15 20:00:20+00:00,['4e16b527cfce42c54e27db78bcf82da11dc7d025'],4,22,26,92807,2,,,,542
2106581be160d557eb3fb3849b5dca26714d86a4,0,Grant Ingersoll,2009-03-15 20:08:58+00:00,['3c8a038ed7b6571d66984e7cf5756ab4816a313e'],4,4,8,92815,4,,,,542
ce91768b58508f308b9415e1600a3753c8d76219,1,Jeff Eastman,2009-03-16 00:17:07+00:00,['2106581be160d557eb3fb3849b5dca26714d86a4'],2,3660,3662,96477,36,0.689095128,0.978538283,0.796403712,575
16cd249c8d8695dd9c65ad25d341569c788d2b78,0,Jeff Eastman,2009-03-16 01:15:02+00:00,['ce91768b58508f308b9415e1600a3753c8d76219'],0,10,10,96487,1,,,,575
c247fa9357edf68c4d9932f1dc4110eace208483,1,Grant Ingersoll,2009-03-18 11:07:16+00:00,['16cd249c8d8695dd9c65ad25d341569c788d2b78'],252,489,741,97228,10,0.213675214,0.35042735,0.555555556,577
e2e966abc4ade5da8ebf44ff29fb830591aa9793,1,Grant Ingersoll,2009-03-18 11:22:10+00:00,['c247fa9357edf68c4d9932f1dc4110eace208483'],40,13,53,97281,4,,,,577
fd33ae90dee21a7c665aafa66fdedcb7f8afe43b,1,Grant Ingersoll,2009-03-18 12:04:41+00:00,['e2e966abc4ade5da8ebf44ff29fb830591aa9793'],4,99,103,97384,2,,,,577
e6645fa8d9896b9742853bc794e40ccba1ea0693,0,Grant Ingersoll,2009-03-18 13:12:59+00:00,['fd33ae90dee21a7c665aafa66fdedcb7f8afe43b'],8,8,16,97400,4,,,,577
b25dd6b61bbda943f2f6658a728253b2a8e9d36b,0,Grant Ingersoll,2009-03-18 13:13:54+00:00,['e6645fa8d9896b9742853bc794e40ccba1ea0693'],8,8,16,97416,4,,,,577
bfa970fc025da7a23eb61d72b0cc7be4c8851318,0,Jeff Eastman,2009-03-18 17:14:49+00:00,['b25dd6b61bbda943f2f6658a728253b2a8e9d36b'],0,28,28,97444,1,,,,578
b2a36644582be4918493f1821fd9593b1f92995a,0,Grant Ingersoll,2009-03-19 12:26:30+00:00,['bfa970fc025da7a23eb61d72b0cc7be4c8851318'],78,48,126,97570,4,1,1,0.961538462,578
92d065769acf37ea1c278815947ca5a63adfd69c,0,Grant Ingersoll,2009-03-19 14:00:11+00:00,['b2a36644582be4918493f1821fd9593b1f92995a'],94,4,98,97668,5,,,,578
9cb904515a81533b67de16c9f88278a5e1983edf,0,Grant Ingersoll,2009-03-19 14:22:21+00:00,['92d065769acf37ea1c278815947ca5a63adfd69c'],8,8,16,97684,4,,,,578
0b2b622be761b28fe085c7fc0792e2806e2b1cf1,0,Grant Ingersoll,2009-03-19 14:23:10+00:00,['9cb904515a81533b67de16c9f88278a5e1983edf'],8,8,16,97700,4,,,,578
95368a7d4286d236a302cfb2ce203afb2adf3479,1,Sean R. Owen,2009-03-19 15:17:07+00:00,['0b2b622be761b28fe085c7fc0792e2806e2b1cf1'],186,127,313,98013,29,0.071428571,0,0.285714286,578
ef577dcf532aaddf1735f3aa1b9bd58c3d3dfb05,1,Jeff Eastman,2009-03-19 19:21:44+00:00,['95368a7d4286d236a302cfb2ce203afb2adf3479'],8,305,313,98326,9,0.613138686,1,0.781021898,582
29bfe1d4c99617d4f60e9366d0a48bbe720df24b,0,Grant Ingersoll,2009-03-19 20:21:12+00:00,['ef577dcf532aaddf1735f3aa1b9bd58c3d3dfb05'],4,4,8,98334,4,,,,582
e8f874256a9a239080add01c197fd3a28dc94853,0,Grant Ingersoll,2009-03-19 20:31:56+00:00,['29bfe1d4c99617d4f60e9366d0a48bbe720df24b'],8,8,16,98350,4,,,,582
258b538f1db04b5a0656455cf4ff3fd18a2833c6,0,Grant Ingersoll,2009-03-19 20:32:40+00:00,['e8f874256a9a239080add01c197fd3a28dc94853'],8,8,16,98366,4,,,,582
e6ee6da3b9b4d0b8cdaa1b0e083a11a0cfafd782,0,Sean R. Owen,2009-03-20 08:34:30+00:00,['258b538f1db04b5a0656455cf4ff3fd18a2833c6'],12,12,24,98390,6,,,,582
a5f14365c6c451c6e042f1e8d9052babe3b9289d,0,Grant Ingersoll,2009-03-25 16:13:20+00:00,['e6ee6da3b9b4d0b8cdaa1b0e083a11a0cfafd782'],4,15,19,98409,1,,,,582
f68cbda6a26fa6ac988d6b21e185c3f32a22d89d,0,Grant Ingersoll,2009-03-26 12:34:13+00:00,['a5f14365c6c451c6e042f1e8d9052babe3b9289d'],4,4,8,98417,4,,,,582
a3228d9f4a43f7a15a68d5b96d36579fa719097f,0,Grant Ingersoll,2009-03-26 14:25:24+00:00,['f68cbda6a26fa6ac988d6b21e185c3f32a22d89d'],8,8,16,98433,4,,,,582
4f0f8e077f67bbc1c33c82d873a6b262ad6785f8,0,Grant Ingersoll,2009-03-26 14:28:05+00:00,['a3228d9f4a43f7a15a68d5b96d36579fa719097f'],8,8,16,98449,4,,,,582
3ecf83f6af209815c876494c4b60049e0e96a550,0,Sean R. Owen,2009-04-06 22:20:40+00:00,['4f0f8e077f67bbc1c33c82d873a6b262ad6785f8'],1,1,2,98451,1,,,,582
897e904b75a26ab9578cca5b0c9824121846c028,0,Sean R. Owen,2009-04-07 06:20:43+00:00,['3ecf83f6af209815c876494c4b60049e0e96a550'],0,0,0,98451,0,,,,582
f89f04389ca317f9d6c3975b6b0d59d965873662,1,Sean R. Owen,2009-04-10 14:36:20+00:00,['897e904b75a26ab9578cca5b0c9824121846c028'],0,6,6,98457,1,,,,582
5f6b134ab8e79204fef6b05f741bb3ab577b54eb,0,Sean R. Owen,2009-04-12 06:58:16+00:00,['f89f04389ca317f9d6c3975b6b0d59d965873662'],11,12,23,98480,10,,,,582
6b1176dc2e26a7c64fdfd72c7708bfdb97eccc84,0,Sean R. Owen,2009-04-12 14:44:31+00:00,['5f6b134ab8e79204fef6b05f741bb3ab577b54eb'],6,738,744,99224,7,0.348484848,0.475757576,0.678787879,588
9d613083770a7f28920b6ed65be862c2f7318f24,1,Jeff Eastman,2009-04-13 17:01:19+00:00,['6b1176dc2e26a7c64fdfd72c7708bfdb97eccc84'],36,390,426,99650,8,0.38125,0.75,0.5,591
0d94cc31bd242cd284a66ed94e0bcc77a0b3eed6,0,Sean R. Owen,2009-04-14 21:32:56+00:00,['9d613083770a7f28920b6ed65be862c2f7318f24'],0,266,266,99916,2,0.457831325,0.78313253,0.885542169,592
7f4aade6993e832fd6dcb3a079365014661f5fbe,0,Otis Gospodnetic,2009-04-14 21:52:09+00:00,['0d94cc31bd242cd284a66ed94e0bcc77a0b3eed6'],1,1,2,99918,1,,,,592
55f131e571bdb0128ef22e08054b504e665dc869,0,Otis Gospodnetic,2009-04-14 22:03:03+00:00,['7f4aade6993e832fd6dcb3a079365014661f5fbe'],16,17,33,99951,1,0,0,0,592
806e42d710befde918c11f5742a7dbd568c782e0,0,Sean R. Owen,2009-04-15 04:10:02+00:00,['55f131e571bdb0128ef22e08054b504e665dc869'],3,2,5,99956,1,,,,592
21ec19b3a86bc6ade4a3433fa22de5573f0ac864,0,Sean R. Owen,2009-04-15 11:30:32+00:00,['806e42d710befde918c11f5742a7dbd568c782e0'],1,12,13,99969,1,1,1,1,592
b12b3493cceace6f5d04e7d7e801f00a572cae1a,0,Sean R. Owen,2009-04-15 11:37:49+00:00,['21ec19b3a86bc6ade4a3433fa22de5573f0ac864'],8,19,27,99996,7,0.444444444,1,0.888888889,592
14a5d584243d39f70d3590d699c01956d4a5627c,0,Otis Gospodnetic,2009-04-15 13:40:50+00:00,['b12b3493cceace6f5d04e7d7e801f00a572cae1a'],27,1,28,100024,1,0,0,0,592
92385547a6c26ae57e7a8818c113769584baa20d,0,Otis Gospodnetic,2009-04-15 13:41:55+00:00,['14a5d584243d39f70d3590d699c01956d4a5627c'],0,1,1,100025,1,0,1,1,592
c84f4a16e16a0cdad1d42c0bd01c17192eeb4643,1,Jeff Eastman,2009-04-15 15:09:57+00:00,['92385547a6c26ae57e7a8818c113769584baa20d'],3,2,5,100030,2,,,,592
4df33688b9aa49c1b19a4a7a551ec72e40a49b82,0,Otis Gospodnetic,2009-04-15 15:33:09+00:00,['c84f4a16e16a0cdad1d42c0bd01c17192eeb4643'],4,8,12,100042,2,0.25,0,0.75,592
d2aad3a9b0060d387eb97450f06d25f781320b77,0,Otis Gospodnetic,2009-04-15 15:34:46+00:00,['4df33688b9aa49c1b19a4a7a551ec72e40a49b82'],1,14,15,100057,1,1,1,1,592
c7626983d918ee0fe1b6c4adf7142475cf5102c6,1,Jeff Eastman,2009-04-15 22:38:44+00:00,['d2aad3a9b0060d387eb97450f06d25f781320b77'],11,350,361,100418,5,0.402234637,0.782122905,0.675977654,594
ff8a5ffa2c97528dcada15b6a4de94eaa90129bb,0,Jeff Eastman,2009-04-15 23:07:24+00:00,['c7626983d918ee0fe1b6c4adf7142475cf5102c6'],4,2,6,100424,1,0,0,0,594
bd96a63b8f64a44a1d18c5ffffc36a75af628dac,0,Sean R. Owen,2009-04-16 09:11:46+00:00,['ff8a5ffa2c97528dcada15b6a4de94eaa90129bb'],10,14,24,100448,1,1,1,1,594
ab30512333c848befd5c1c8064e190ebb919c0c6,0,Sean R. Owen,2009-04-16 09:22:18+00:00,['bd96a63b8f64a44a1d18c5ffffc36a75af628dac'],1,3,4,100452,2,1,1,1,594
c4115cefe758a88503f8a9b4243b621cb288fb6b,0,Sean R. Owen,2009-04-16 17:54:47+00:00,['ab30512333c848befd5c1c8064e190ebb919c0c6'],4,17,21,100473,1,,,,594
96bd5a3b13d939a82ba1aaaf2607378129bef3b4,1,Jeff Eastman,2009-04-16 21:32:11+00:00,['c4115cefe758a88503f8a9b4243b621cb288fb6b'],49,54,103,100576,42,0,0.5,0.5,594
fe501e2b9f2942f1e0751e37f99d8de58d58a2b2,0,Sean R. Owen,2009-04-21 10:39:50+00:00,['96bd5a3b13d939a82ba1aaaf2607378129bef3b4'],390,20,410,100986,5,0.1875,0,0.051136364,594
2bbffd59d897e443a8b9a99d7d97bf9a1310792e,0,Sean R. Owen,2009-04-21 10:44:32+00:00,['fe501e2b9f2942f1e0751e37f99d8de58d58a2b2'],26,117,143,101129,7,0.6,0.96,0.94,594
d23cf1a126732a659c16673b7c82c64a5f4f793a,0,Sean R. Owen,2009-04-23 07:45:01+00:00,['2bbffd59d897e443a8b9a99d7d97bf9a1310792e'],2,8,10,101139,1,0,1,1,594
1b9c5349ee77a32f1b269aef883e7718dc07c1aa,0,Sean R. Owen,2009-04-30 22:09:22+00:00,['d23cf1a126732a659c16673b7c82c64a5f4f793a'],2,14,16,101155,2,0.375,0.375,1,594
369c86fb2bb00026ca8f5feee272c61786776a5f,0,Sean R. Owen,2009-05-01 07:32:27+00:00,['1b9c5349ee77a32f1b269aef883e7718dc07c1aa'],11,140,151,101306,5,0.958333333,1,1,596
43b810ea022387cd97b8fc07d68bf00fadd1b08b,0,Sean R. Owen,2009-05-01 17:38:13+00:00,['369c86fb2bb00026ca8f5feee272c61786776a5f'],53,46,99,101405,3,1,1,0,596
61bfdee84c3d32af3f389279da56d6a60e3cebdd,0,Otis Gospodnetic,2009-05-04 22:25:50+00:00,['43b810ea022387cd97b8fc07d68bf00fadd1b08b'],5,1,6,101411,1,1,1,0,596
cdf74895119d5429cd30d5757a2c06e5ccb3ecef,0,Sean R. Owen,2009-05-05 11:43:05+00:00,['61bfdee84c3d32af3f389279da56d6a60e3cebdd'],3,1,4,101415,1,1,1,1,596
40ee01bc95f337c5f7eec4ceb423c4c40f14f4f8,0,Sean R. Owen,2009-05-05 11:49:41+00:00,['cdf74895119d5429cd30d5757a2c06e5ccb3ecef'],6,11,17,101432,2,0,0,1,596
86a3ccf8cf660e4f9b8669c068474862f6006ee5,0,Sean R. Owen,2009-05-10 19:13:37+00:00,['40ee01bc95f337c5f7eec4ceb423c4c40f14f4f8'],11,17,28,101460,2,1,1,1,596
906d2ecc0749d34fecb393d033ae5a0a9bcb7237,0,Sean R. Owen,2009-05-12 06:25:02+00:00,['86a3ccf8cf660e4f9b8669c068474862f6006ee5'],21,12,33,101493,3,0.6,0.6,0.6,596
4c0f0e04f6d0b10c52c7dc4e9651ce591d1e386e,0,Jeff Eastman,2009-05-13 20:42:22+00:00,['906d2ecc0749d34fecb393d033ae5a0a9bcb7237'],0,147,147,101640,2,0.610169492,1,1,598
18e90285f9b79c1ccbcee9fa9493fa4c99188da3,1,Jeff Eastman,2009-05-13 22:30:23+00:00,['4c0f0e04f6d0b10c52c7dc4e9651ce591d1e386e'],18,120,138,101778,3,0.107526882,0.967741935,1,598
c433d1cd0b58e986466bd26af8ae7c145578ac7e,1,Sean R. Owen,2009-05-14 15:28:05+00:00,['18e90285f9b79c1ccbcee9fa9493fa4c99188da3'],4,7,11,101789,1,1,1,1,598
a3d6c426d8c1aacec2321a393dc4bd1794b9952a,0,Sean R. Owen,2009-05-15 18:55:34+00:00,['c433d1cd0b58e986466bd26af8ae7c145578ac7e'],1,4,5,101794,1,1,1,1,598
1605504a8dd31e03f048ae33c491daebfc08770b,0,Sean R. Owen,2009-05-28 11:03:10+00:00,['a3d6c426d8c1aacec2321a393dc4bd1794b9952a'],0,3,3,101797,1,0,1,0,598
766cd3d7e3e19a83075fc95a75eb3e747d0e701f,0,Sean R. Owen,2009-05-28 12:28:00+00:00,['1605504a8dd31e03f048ae33c491daebfc08770b'],3,4,7,101804,1,,,,598
b1bb1c7524f67fc699bd14e4618b5447c2cca2fb,1,Jeff Eastman,2009-05-29 23:07:50+00:00,['766cd3d7e3e19a83075fc95a75eb3e747d0e701f'],23,11,34,101838,4,1,1,0,598
e9a5145d2277ad1f365870d60dfb081ce08fa986,0,Sean R. Owen,2009-05-30 07:19:28+00:00,['b1bb1c7524f67fc699bd14e4618b5447c2cca2fb'],30,18,48,101886,24,,,,598
c24581008b0681c5577519e136329c94323684a4,1,Sean R. Owen,2009-05-31 17:13:08+00:00,['e9a5145d2277ad1f365870d60dfb081ce08fa986'],59,59,118,102004,26,,,,598
05ccf2c38c5eed0460b2cd45cb20f4439aa655d6,0,Sean R. Owen,2009-05-31 18:05:43+00:00,['c24581008b0681c5577519e136329c94323684a4'],1,1,2,102006,1,,,,598
ffc036cdb90d3e03ce6d2a7c6c83af75903cf17d,0,Sean R. Owen,2009-06-01 18:53:00+00:00,['05ccf2c38c5eed0460b2cd45cb20f4439aa655d6'],19,20,39,102045,1,0,0,1,598
9551dbdfcf8d0cb1988e976672f0e9600b855e42,0,Sean R. Owen,2009-06-01 20:26:48+00:00,['ffc036cdb90d3e03ce6d2a7c6c83af75903cf17d'],1,1,2,102047,1,,,,598
7f6829635ebadb2041835e8f96db71da6b954121,0,Sean R. Owen,2009-06-01 21:36:56+00:00,['9551dbdfcf8d0cb1988e976672f0e9600b855e42'],0,1,1,102048,1,,,,598
cbe629418a70ca2ad9736e40a4ff92c1a7eb3d32,0,Grant Ingersoll,2009-06-04 18:01:38+00:00,['7f6829635ebadb2041835e8f96db71da6b954121'],0,2,2,102050,1,,,,598
de25169a4b6ca09cab875713bc3fb2eb60b55b1b,0,Sean R. Owen,2009-06-05 14:35:19+00:00,['cbe629418a70ca2ad9736e40a4ff92c1a7eb3d32'],6,6,12,102062,3,,,,598
34c357ffb0499fad4613b8500e9a2f10ac6fde7f,0,Sean R. Owen,2009-06-08 17:26:17+00:00,['de25169a4b6ca09cab875713bc3fb2eb60b55b1b'],18,113,131,102193,2,0.930232558,1,1,599
cc1ac9178d30a86c89336ef7ea46f9ecdf276d5c,1,Grant Ingersoll,2009-06-09 14:31:19+00:00,['34c357ffb0499fad4613b8500e9a2f10ac6fde7f'],11,165,176,102369,4,0.298969072,0.711340206,1,599
429c226a71f91343b36b45eba6bfb4e3d4798e98,0,Grant Ingersoll,2009-06-09 19:46:14+00:00,['cc1ac9178d30a86c89336ef7ea46f9ecdf276d5c'],2,13,15,102384,1,0,0,1,599
9fdf7c789bad91ff6772301b6eb3494b17f7f539,0,Sean R. Owen,2009-06-10 16:53:39+00:00,['429c226a71f91343b36b45eba6bfb4e3d4798e98'],1,1,2,102386,1,,,,599
6ecc0a0f69df52ec26604a2dc1bfc3b5f6da88a0,0,Jeff Eastman,2009-06-11 00:02:16+00:00,['9fdf7c789bad91ff6772301b6eb3494b17f7f539'],1,1,2,102388,1,,,,599
1437684155d8506541a756d8d6f62e0051c5bcde,1,Jeff Eastman,2009-06-11 03:45:26+00:00,['6ecc0a0f69df52ec26604a2dc1bfc3b5f6da88a0'],78,21,99,102487,4,0.565217391,0,0.565217391,599
52b70867964d2867ba135e5955463ad5b731128d,1,Sean R. Owen,2009-06-12 21:34:25+00:00,['1437684155d8506541a756d8d6f62e0051c5bcde'],36,26,62,102549,8,0.714285714,0.428571429,0.428571429,599
0df97e3106743bbdc8ae913b3027e7c0360e0c0f,1,Grant Ingersoll,2009-06-13 12:33:07+00:00,['52b70867964d2867ba135e5955463ad5b731128d'],9,147,156,102705,6,0.461538462,0.865384615,1,599
af7140eeaeab155f580f66cae6d756e8060ac0e3,0,Jeff Eastman,2009-06-13 21:47:49+00:00,['0df97e3106743bbdc8ae913b3027e7c0360e0c0f'],1,2,3,102708,1,,,,599
efd2643a0ed67e540aa54097846c47610a6bb96c,0,Grant Ingersoll,2009-06-15 01:32:13+00:00,['af7140eeaeab155f580f66cae6d756e8060ac0e3'],24,92,116,102824,10,0,1,0,600
e80a99dc680f9cb6fe528cdd96a0f139b3b403ef,0,Jeff Eastman,2009-06-15 17:25:08+00:00,['efd2643a0ed67e540aa54097846c47610a6bb96c'],1,1,2,102826,1,,,,600
cfbf06228de52ca2f12d16238b2c2ce46a97d9ce,1,Grant Ingersoll,2009-06-16 13:12:35+00:00,['e80a99dc680f9cb6fe528cdd96a0f139b3b403ef'],14,23,37,102863,1,0,1,1,600
ca7f6d9a13535e619394ec04588e143f602a8b8d,1,Jeff Eastman,2009-06-16 13:28:14+00:00,['cfbf06228de52ca2f12d16238b2c2ce46a97d9ce'],565,752,1317,104180,39,0.212765957,0.957446809,0.382978723,602
3e7c67bd6121919ca4d19f746b07d6575ff413c3,0,Jeff Eastman,2009-06-16 13:33:13+00:00,['ca7f6d9a13535e619394ec04588e143f602a8b8d'],8,19,27,104207,2,0,1,1,602
50629d68e03c26080cbe1800f6f7a07f39b3489a,0,Jeff Eastman,2009-06-16 14:06:51+00:00,['3e7c67bd6121919ca4d19f746b07d6575ff413c3'],0,44,44,104251,3,1,1,0.6,602
9b10f7f6d5f8b6419dc633e1efefdea0bacb1d48,1,Grant Ingersoll,2009-06-16 19:17:08+00:00,['50629d68e03c26080cbe1800f6f7a07f39b3489a'],8,11,19,104270,2,,,,602
3aced6c72cf44d71d209c55c90abd19302f8815a,1,Grant Ingersoll,2009-06-16 20:44:12+00:00,['9b10f7f6d5f8b6419dc633e1efefdea0bacb1d48'],9,156,165,104435,5,0.243589744,0.551282051,1,602
1a0efb0e5d31d700fd909e6bba92042b803428f6,0,Grant Ingersoll,2009-06-16 22:29:39+00:00,['3aced6c72cf44d71d209c55c90abd19302f8815a'],0,4,4,104439,1,,,,602
b01005ae9a393cacd9393b45f0082038426f6175,1,Sean R. Owen,2009-06-17 10:11:38+00:00,['1a0efb0e5d31d700fd909e6bba92042b803428f6'],4,6,10,104449,2,,,,602
032fff5eb2d8d7245acdc2773c459ea1acc06bd1,0,Sean R. Owen,2009-06-17 10:25:43+00:00,['b01005ae9a393cacd9393b45f0082038426f6175'],15,0,15,104464,3,,,,602
db362c22307a9cdb51bdb81fe7db6e380a7b12bc,1,Grant Ingersoll,2009-06-17 14:22:08+00:00,['032fff5eb2d8d7245acdc2773c459ea1acc06bd1'],55,1035,1090,105554,16,0.380782918,0.451957295,0.804270463,614
f0c89957e530d2429c8fce291c5eba0569680d08,1,Jeff Eastman,2009-06-17 15:08:29+00:00,['db362c22307a9cdb51bdb81fe7db6e380a7b12bc'],33,268,301,105855,4,0.478991597,1,0.781512605,614
bfba4bc22fdaa570c27e6ef8328ac157cc1ccaa3,0,Sean R. Owen,2009-06-17 17:54:26+00:00,['f0c89957e530d2429c8fce291c5eba0569680d08'],1,9,10,105865,1,0,0,0,614
206cee03ceea35d36720aacefd411eda5172dc32,0,Grant Ingersoll,2009-06-17 21:59:51+00:00,['bfba4bc22fdaa570c27e6ef8328ac157cc1ccaa3'],9,14,23,105888,2,1,1,0,614
98a79f4765cb4a905c38872a617df17a90195f5e,0,Grant Ingersoll,2009-06-17 22:16:56+00:00,['206cee03ceea35d36720aacefd411eda5172dc32'],2,52,54,105942,2,0.176470588,0.176470588,0.823529412,615
26cb05dd177009b4c41a50ec8427ca4d62e20890,0,Grant Ingersoll,2009-06-18 00:33:13+00:00,['98a79f4765cb4a905c38872a617df17a90195f5e'],1,3,4,105946,1,0,0,1,615
4319ae37d5e973f71b60789107f452e58c4d9ea5,0,Grant Ingersoll,2009-06-18 12:53:06+00:00,['26cb05dd177009b4c41a50ec8427ca4d62e20890'],1,2,3,105949,1,1,1,0,615
0d2afee5251d2116c7a4872a1b810562c5b15f1f,0,Grant Ingersoll,2009-06-18 22:31:35+00:00,['4319ae37d5e973f71b60789107f452e58c4d9ea5'],0,1,1,105950,1,,,,615
c5f77f735ec22905339dd731d1b935c743b800ba,0,Jeff Eastman,2009-06-18 22:36:57+00:00,['0d2afee5251d2116c7a4872a1b810562c5b15f1f'],10,10,20,105970,5,,,,615
40aa3e89f5ef0e82844c602615f5c54184574b9d,1,Sean R. Owen,2009-06-19 04:50:40+00:00,['c5f77f735ec22905339dd731d1b935c743b800ba'],484,655,1139,107109,40,0.485981308,0.644859813,0.953271028,617
c4efb9f45815bf28b3286f4e7593767e88753f35,0,Sean R. Owen,2009-06-19 11:09:36+00:00,['40aa3e89f5ef0e82844c602615f5c54184574b9d'],1,26,27,107136,2,0.736842105,0.736842105,0.736842105,617
8eb6d1df1e4420365a63dd6bb2d28c4fcd1b5cb5,0,Jeff Eastman,2009-06-19 16:36:33+00:00,['c4efb9f45815bf28b3286f4e7593767e88753f35'],99,28,127,107263,11,0,0,0,617
3172bd1bb1bf533b614e0311c3e5375205cc6037,1,Jeff Eastman,2009-06-19 21:45:46+00:00,['8eb6d1df1e4420365a63dd6bb2d28c4fcd1b5cb5'],149,413,562,107825,12,0.452631579,0.989473684,1,617
b80b5bbf6d354a1f522c25def3ca2139364ee075,1,Jeff Eastman,2009-06-20 00:48:21+00:00,['3172bd1bb1bf533b614e0311c3e5375205cc6037'],230,122,352,108177,9,0,0,0.45,617
fdd56b559e99ad77cdbe39e9926d4515e0ee9565,0,Grant Ingersoll,2009-06-21 00:43:36+00:00,['b80b5bbf6d354a1f522c25def3ca2139364ee075'],1,2,3,108180,1,1,1,1,617
85de9d46518d60d657cc4acfe0fc44f41412b0ae,0,Jeff Eastman,2009-06-22 16:35:48+00:00,['fdd56b559e99ad77cdbe39e9926d4515e0ee9565'],4,16,20,108200,2,,,,617
781d81bf74b066208e45eadfd40e48757a9ed2cd,0,Jeff Eastman,2009-06-22 17:26:23+00:00,['85de9d46518d60d657cc4acfe0fc44f41412b0ae'],2,11,13,108213,1,0,1,1,617
0ddd8cc06d6c110869b517e0b922fc98df5ae0eb,0,Sean R. Owen,2009-06-22 17:51:43+00:00,['781d81bf74b066208e45eadfd40e48757a9ed2cd'],1,1,2,108215,1,,,,617
075ea19c17260ac3e7bff82792a604b690259c5a,1,Grant Ingersoll,2009-06-23 18:23:18+00:00,['0ddd8cc06d6c110869b517e0b922fc98df5ae0eb'],712,1277,1989,110204,42,1,0.838709677,0.935483871,626
4d2a7f4b34661faac4b5316f556c749dd1b061e0,0,Grant Ingersoll,2009-06-23 19:31:46+00:00,['075ea19c17260ac3e7bff82792a604b690259c5a'],103,0,103,110307,2,0,0,0.307692308,626
917cca0f238b6c33fbe7527a17cb619ae4451858,0,Jeff Eastman,2009-06-23 19:37:04+00:00,['4d2a7f4b34661faac4b5316f556c749dd1b061e0'],183,123,306,110613,7,0.388888889,0.416666667,0.305555556,626
69e6ced726f5e516f85e6bcd9620acf474b794e2,0,Grant Ingersoll,2009-06-24 04:14:34+00:00,['917cca0f238b6c33fbe7527a17cb619ae4451858'],102,125,227,110840,1,0,0,0.153846154,626
17d937ade65d164b0151186e2feedc2bd9d07c23,0,Grant Ingersoll,2009-06-24 12:25:11+00:00,['69e6ced726f5e516f85e6bcd9620acf474b794e2'],3,3,6,110846,1,,,,626
63e11c0028e5338410f21dd0458d59751a2d4b4d,1,Grant Ingersoll,2009-06-24 13:23:54+00:00,['17d937ade65d164b0151186e2feedc2bd9d07c23'],5,140,145,110991,4,0.6,1,1,628
3db6c9e31c5858600f673699a5c8fcf1d0ec513c,0,Grant Ingersoll,2009-06-24 13:58:20+00:00,['63e11c0028e5338410f21dd0458d59751a2d4b4d'],1,111,112,111103,3,0.547169811,0.981132075,1,630
83402dc91a76de4e80ad5f86607ed71d29c1f1e1,0,Grant Ingersoll,2009-06-24 14:14:50+00:00,['3db6c9e31c5858600f673699a5c8fcf1d0ec513c'],0,99,99,111202,1,0.094339623,0.094339623,1,631
b19a51e05eb5cea29cb7cd84a67612192cebdb92,0,Grant Ingersoll,2009-06-24 15:37:20+00:00,['83402dc91a76de4e80ad5f86607ed71d29c1f1e1'],1,2,3,111205,2,0,0,1,631
be42fe00ae95b3d750f1f95f451db445d4a47f6e,1,Jeff Eastman,2009-06-24 16:25:03+00:00,['b19a51e05eb5cea29cb7cd84a67612192cebdb92'],360,232,592,111797,12,0.769230769,0.596153846,1,631
2afb63115c63adfb7206e3f2abdf33da2dfce147,0,Grant Ingersoll,2009-06-24 18:22:12+00:00,['be42fe00ae95b3d750f1f95f451db445d4a47f6e'],1,5,6,111803,1,,,,631
93798790e3ad53ab13ebdcda28eaac5089eafbf3,0,Grant Ingersoll,2009-06-24 18:23:39+00:00,['2afb63115c63adfb7206e3f2abdf33da2dfce147'],8,9,17,111820,1,,,,631
abcb7f5bea440c59ae9d3e194d5323d847d62101,1,Jeff Eastman,2009-06-24 18:41:37+00:00,['93798790e3ad53ab13ebdcda28eaac5089eafbf3'],255,292,547,112367,12,0,1,1,631
1145c455a5316c04cdbc18917bb4b0c461af64ec,0,Grant Ingersoll,2009-06-24 21:10:13+00:00,['abcb7f5bea440c59ae9d3e194d5323d847d62101'],4,4,8,112375,1,,,,631
11a21dcf5e2968829930cc0810f72e77dd423bba,1,Grant Ingersoll,2009-06-24 21:26:25+00:00,['1145c455a5316c04cdbc18917bb4b0c461af64ec'],283,861,1144,113519,25,0.453287197,0.750865052,0.961937716,633
2ce1755e34b739bbe754805aa146206b1809d2d3,0,Grant Ingersoll,2009-06-25 13:14:47+00:00,['11a21dcf5e2968829930cc0810f72e77dd423bba'],4,17,21,113540,1,0,0,1,633
cfa2ed7a9d27753e39248bb1ce8c0be35bba628d,0,Jeff Eastman,2009-06-25 16:43:29+00:00,['2ce1755e34b739bbe754805aa146206b1809d2d3'],7,10,17,113557,1,,,,633
8fdd78ccbb513df5aa4399a90039cf2e7bbce8d6,0,Jeff Eastman,2009-06-25 18:15:50+00:00,['cfa2ed7a9d27753e39248bb1ce8c0be35bba628d'],53,38,91,113648,8,1,1,1,633
298eee07f074a7a56f3232ba73bd7a450c1c6338,1,Grant Ingersoll,2009-06-25 20:46:42+00:00,['8fdd78ccbb513df5aa4399a90039cf2e7bbce8d6'],69,296,365,114013,14,1,1,0.788135593,634
ef99043f9b20dbd10c44c25f3d1721284f8d49ff,0,Grant Ingersoll,2009-06-25 21:40:37+00:00,['298eee07f074a7a56f3232ba73bd7a450c1c6338'],2,2,4,114017,1,,,,634
cbc4347fa5fc2fc5690705ab969cc035aff9957e,0,Grant Ingersoll,2009-06-25 21:42:17+00:00,['ef99043f9b20dbd10c44c25f3d1721284f8d49ff'],1,1,2,114019,1,,,,634
43585266cc110b0023d69945ed84980e8f024a48,0,Grant Ingersoll,2009-06-25 22:24:28+00:00,['cbc4347fa5fc2fc5690705ab969cc035aff9957e'],1,0,1,114020,1,0,0,0,634
fad901ea214d6138061cfaebca7582255ed8f8b9,0,Grant Ingersoll,2009-06-25 22:27:35+00:00,['43585266cc110b0023d69945ed84980e8f024a48'],1,1,2,114022,1,,,,634
e74ae9b4119f6807a79a2b937849ec4b2460fb08,0,Jeff Eastman,2009-06-25 22:31:10+00:00,['fad901ea214d6138061cfaebca7582255ed8f8b9'],14,20,34,114056,1,0,1,0.5,634
3ae4c54bfe46ac08b2a9f132de6b58c1b9b330ab,0,Grant Ingersoll,2009-06-26 11:15:55+00:00,['e74ae9b4119f6807a79a2b937849ec4b2460fb08'],1,1,2,114058,1,,,,634
e9ecfe16e2689554c63224cde26c3b8bae74c242,0,Grant Ingersoll,2009-06-26 14:58:01+00:00,['3ae4c54bfe46ac08b2a9f132de6b58c1b9b330ab'],0,19,19,114077,1,1,1,1,635
d87b7a37608fa8ceb51bbbea96d59d642d37db70,0,Grant Ingersoll,2009-06-26 15:27:11+00:00,['e9ecfe16e2689554c63224cde26c3b8bae74c242'],7,4,11,114088,1,0,0,0,635
addeb36841bb43a80c53fc748e29fb0a1e6fa021,0,Grant Ingersoll,2009-06-26 15:42:37+00:00,['d87b7a37608fa8ceb51bbbea96d59d642d37db70'],2,12,14,114102,1,0,0,1,635
ad88a2fef2c3e26176cbe18755e7928ccfe12ad9,1,Grant Ingersoll,2009-06-26 20:25:07+00:00,['addeb36841bb43a80c53fc748e29fb0a1e6fa021'],106,200,306,114408,5,0,0,0.632183908,636
a7fc9bf00e408e57a22507198cc0e509392d1107,0,Grant Ingersoll,2009-06-26 20:26:45+00:00,['ad88a2fef2c3e26176cbe18755e7928ccfe12ad9'],0,3,3,114411,1,0,0,0,636
9d0b2199b44347c8a5fce00fdface750da9810a2,0,Grant Ingersoll,2009-06-26 20:39:46+00:00,['a7fc9bf00e408e57a22507198cc0e509392d1107'],2,2,4,114415,1,,,,636
7c2ec2012c961e4fa82d48cf7e3814d854790f19,0,Jeff Eastman,2009-06-26 23:45:30+00:00,['9d0b2199b44347c8a5fce00fdface750da9810a2'],1,1,2,114417,1,,,,636
75e76eb0289bf752de84ed1eca27fe3341fc9df4,0,Grant Ingersoll,2009-06-27 01:58:21+00:00,['7c2ec2012c961e4fa82d48cf7e3814d854790f19'],56,68,124,114541,4,0,0.2,0.8,636
5ba24cb62939b35f5336ad3aa24119c0a74313f2,0,Grant Ingersoll,2009-06-27 02:22:31+00:00,['75e76eb0289bf752de84ed1eca27fe3341fc9df4'],29,248,277,114818,4,0,1,1,636
d2d9d85abcc2f26449cff850c1e8a52de5f5fca5,0,Grant Ingersoll,2009-06-27 02:57:18+00:00,['5ba24cb62939b35f5336ad3aa24119c0a74313f2'],1,3,4,114822,1,0,0,0,636
d6db69f2b5a86113538cae86099820726faedb69,0,Grant Ingersoll,2009-06-27 03:00:08+00:00,['d2d9d85abcc2f26449cff850c1e8a52de5f5fca5'],1,3,4,114826,1,0,0,1,636
76c06269d745e27247c410f357d9e43598c3eb5b,0,Grant Ingersoll,2009-06-27 11:03:16+00:00,['d6db69f2b5a86113538cae86099820726faedb69'],7,14,21,114847,1,0,0,1,636
09b74e67d69a00b9a488aa9c608bfe954fa7c888,0,Grant Ingersoll,2009-06-27 11:22:41+00:00,['76c06269d745e27247c410f357d9e43598c3eb5b'],0,5,5,114852,1,0,1,0,636
40cf7d3b9c0f67fa274b3a3a650d4c7fc6a5cc71,1,Grant Ingersoll,2009-06-27 11:26:10+00:00,['09b74e67d69a00b9a488aa9c608bfe954fa7c888'],0,112,112,114964,1,0.076923077,0.076923077,1,637
4fb3040df537e536f87b84402e105bfe027c23f8,0,Grant Ingersoll,2009-06-29 19:54:00+00:00,['40cf7d3b9c0f67fa274b3a3a650d4c7fc6a5cc71'],2,2,4,114968,1,,,,637
c7d3f6da3c4fcedd001a6587c8194cac356aff46,0,Jeff Eastman,2009-06-29 21:20:18+00:00,['4fb3040df537e536f87b84402e105bfe027c23f8'],2,2,4,114972,2,,,,637
9acbff2a8c8b09ca713a562a738d6849c0268abf,1,Grant Ingersoll,2009-06-30 17:39:24+00:00,['c7d3f6da3c4fcedd001a6587c8194cac356aff46'],115,257,372,115344,6,0,0,1,638
089d1329cff0a8412470b897cdc6bcd09f7a9793,1,Grant Ingersoll,2009-07-01 15:50:45+00:00,['9acbff2a8c8b09ca713a562a738d6849c0268abf'],9,11,20,115364,10,,,,640
25166b2453e4b588460b509e461191056416cc68,1,Sean R. Owen,2009-07-03 13:42:52+00:00,['089d1329cff0a8412470b897cdc6bcd09f7a9793'],176,220,396,115760,34,0.826086957,0.130434783,0.086956522,640
f55276b6465b5c91c7b5c2b7bc201be2eb937bf1,1,Sean R. Owen,2009-07-03 18:30:46+00:00,['25166b2453e4b588460b509e461191056416cc68'],102,353,455,116215,21,0,0,0,640
83637d70dd569b4cdf7d32616728ec9b7a5b8760,1,Sean R. Owen,2009-07-06 18:36:45+00:00,['f55276b6465b5c91c7b5c2b7bc201be2eb937bf1'],72,84,156,116371,11,1,1,1,640
d023be63369a9bf9bce6426442ea1d6c92428142,1,Sean R. Owen,2009-07-06 18:46:57+00:00,['83637d70dd569b4cdf7d32616728ec9b7a5b8760'],33,31,64,116435,10,1,0.166666667,0.166666667,640
f08dae3d162d0861183d60098134b49055cae168,0,Sean R. Owen,2009-07-07 08:22:37+00:00,['d023be63369a9bf9bce6426442ea1d6c92428142'],0,17,17,116452,2,1,1,1,640
8535e20f0675c7b605fa6789194beb10577d364e,1,Sean R. Owen,2009-07-07 16:45:25+00:00,['f08dae3d162d0861183d60098134b49055cae168'],3,456,459,116911,4,0.193548387,0.641129032,0.584677419,642
e02a166a1b61abb857832ee19bdc996333a38515,0,Sean R. Owen,2009-07-08 13:26:42+00:00,['8535e20f0675c7b605fa6789194beb10577d364e'],43,59,102,117013,4,0,1,0.863636364,642
39bfe7c3eda44bbeb3434c0365efec608814690f,1,Sean R. Owen,2009-07-08 13:28:14+00:00,['e02a166a1b61abb857832ee19bdc996333a38515'],32,144,176,117189,3,0.568627451,0.568627451,1,643
00a6c61392fff55edc17ad3339931563730a1410,0,Sean R. Owen,2009-07-09 11:03:35+00:00,['39bfe7c3eda44bbeb3434c0365efec608814690f'],13,23,36,117225,3,0.857142857,1,0.857142857,643
aa1bf8f5be6428b33936202f4995647b71ce0876,0,Sean R. Owen,2009-07-09 12:58:02+00:00,['00a6c61392fff55edc17ad3339931563730a1410'],16,132,148,117373,6,0.095890411,0.095890411,1,644
20bb0d9afc78dcfeccef2c88e901ae76a89c5ec6,0,Sean R. Owen,2009-07-09 16:46:16+00:00,['aa1bf8f5be6428b33936202f4995647b71ce0876'],12,62,74,117447,4,0.487804878,0.951219512,0.902439024,644
a9ec40f287e1d189a0b935c622eb5d98c152e259,0,Sean R. Owen,2009-07-09 17:16:54+00:00,['20bb0d9afc78dcfeccef2c88e901ae76a89c5ec6'],1,19,20,117467,1,0.875,1,0.875,644
b25ad9d2dadf961fb79ac37a2d4f26a9135ee3ce,1,Sean R. Owen,2009-07-10 09:35:19+00:00,['a9ec40f287e1d189a0b935c622eb5d98c152e259'],4923,4462,9385,126852,322,0.545794393,0.865420561,0.921495327,645
15ff4830d7430b12c54b81a3556f7dc9a402c5a3,0,Sean R. Owen,2009-07-10 10:19:59+00:00,['b25ad9d2dadf961fb79ac37a2d4f26a9135ee3ce'],55,16,71,126923,1,0,0,0,645
57db294a83b2097c7ce8a87c2ae18aadbb8e04a5,0,Sean R. Owen,2009-07-10 12:40:39+00:00,['15ff4830d7430b12c54b81a3556f7dc9a402c5a3'],20,5,25,126948,3,0.125,0.125,0.25,645
68640a4d9ce7f8716e7e99e7cf3da9df0ff6fa30,0,Sean R. Owen,2009-07-10 15:56:58+00:00,['57db294a83b2097c7ce8a87c2ae18aadbb8e04a5'],21,46,67,127015,4,0.428571429,1,0.714285714,645
810a5d2b30d4dd7de448802a945ba91a773e1207,0,Sean R. Owen,2009-07-13 08:55:24+00:00,['68640a4d9ce7f8716e7e99e7cf3da9df0ff6fa30'],10,8,18,127033,4,1,0,1,645
1c1e2785caafb4c22a641ec110c63ad4c9f8fd01,1,Sean R. Owen,2009-07-13 09:44:44+00:00,['810a5d2b30d4dd7de448802a945ba91a773e1207'],60,358,418,127451,6,0.508928571,1,0.616071429,648
3581c4ffdf2a98da970d959d6c32be825704e131,0,Sean R. Owen,2009-07-13 10:00:04+00:00,['1c1e2785caafb4c22a641ec110c63ad4c9f8fd01'],2,14,16,127467,2,0,1,1,648
3e3f96792d0c01ea1b8378d4e00197614259d79e,0,Sean R. Owen,2009-07-13 10:16:02+00:00,['3581c4ffdf2a98da970d959d6c32be825704e131'],4,18,22,127489,2,1,0,0,648
7df0ef08b59770f0ca81bd411a8d9532a2b1121a,0,Jeff Eastman,2009-07-13 16:38:52+00:00,['3e3f96792d0c01ea1b8378d4e00197614259d79e'],97,105,202,127691,1,0,0,0.9,648
31e36443aa0f58a27dc6c2ad1f99e7bf6aeaaa7f,0,Grant Ingersoll,2009-07-13 19:36:28+00:00,['7df0ef08b59770f0ca81bd411a8d9532a2b1121a'],4,4,8,127699,2,,,,648
d228006ff98143babe4a49bd1a8a8af8d7ebbad8,0,Sean R. Owen,2009-07-14 09:59:21+00:00,['31e36443aa0f58a27dc6c2ad1f99e7bf6aeaaa7f'],4,4,8,127707,1,,,,648
e290c8e9edfa6126dd0a2a62dbd14c4412df82bb,0,Jeff Eastman,2009-07-14 16:57:36+00:00,['d228006ff98143babe4a49bd1a8a8af8d7ebbad8'],2,4,6,127713,1,0,0,0,648
2d97d9387b83998ef24738c14174b4babb925bb1,0,Sean R. Owen,2009-07-15 19:53:38+00:00,['e290c8e9edfa6126dd0a2a62dbd14c4412df82bb'],170,180,350,128063,8,1,0.75,1,649
dfdd58a01a4ceb935eefaa8a9c75ee34feeebb4e,0,Grant Ingersoll,2009-07-15 22:07:35+00:00,['2d97d9387b83998ef24738c14174b4babb925bb1'],3,2,5,128068,1,1,0,1,649
7cb1bd97d34439b21408c36586ca577ba6b0a7cc,1,Grant Ingersoll,2009-07-16 14:33:59+00:00,['dfdd58a01a4ceb935eefaa8a9c75ee34feeebb4e'],245,1255,1500,129568,15,,,,658
112116128251bea5face03c720949613064ffe4c,0,Sean R. Owen,2009-07-17 12:51:08+00:00,['7cb1bd97d34439b21408c36586ca577ba6b0a7cc'],34,80,114,129682,9,0.595744681,0.042553191,0.574468085,658
3f0e5bbbf11a0b2c16c5199a8f68825cba18e476,0,Grant Ingersoll,2009-07-17 14:36:21+00:00,['112116128251bea5face03c720949613064ffe4c'],126,141,267,129949,6,0,0,0.851851852,659
cc1b29280664b1210a00c34a5c3a6eb99cb6486f,0,Sean R. Owen,2009-07-20 11:07:30+00:00,['3f0e5bbbf11a0b2c16c5199a8f68825cba18e476'],1,1,2,129951,1,,,,659
90366ccdd83d0020546dffbee852176611a3964d,0,Sean R. Owen,2009-07-20 16:35:52+00:00,['cc1b29280664b1210a00c34a5c3a6eb99cb6486f'],1,161,162,130113,2,0.679487179,0.935897436,0.884615385,660
b747675a040732515bd361b1b21da2909f42a071,0,Grant Ingersoll,2009-07-21 00:52:57+00:00,['90366ccdd83d0020546dffbee852176611a3964d'],1,1,2,130115,1,,,,660
9fff6c35b5942f3e592ee77e5b2c26d189add4cc,0,Sean R. Owen,2009-07-22 11:14:13+00:00,['b747675a040732515bd361b1b21da2909f42a071'],10,16,26,130141,2,0,0.25,1,660
fec65570175a4e6b04d26bad702fefedf01696e3,0,Grant Ingersoll,2009-07-22 16:13:17+00:00,['9fff6c35b5942f3e592ee77e5b2c26d189add4cc'],14,29,43,130184,1,0,0,1,660
57139241cd217b6e910ffefd5743e8103086262c,1,Grant Ingersoll,2009-07-22 17:28:58+00:00,['fec65570175a4e6b04d26bad702fefedf01696e3'],92,181,273,130457,9,0,0,0.50877193,661
7a96c08b5612a49109523d25680261ad1cf2c7cf,1,Grant Ingersoll,2009-07-22 22:40:55+00:00,['57139241cd217b6e910ffefd5743e8103086262c'],9,27,36,130493,2,0.153846154,0.153846154,1,661
794d025c7b14d798bb747528ad943f287c5e54fe,0,Grant Ingersoll,2009-07-23 20:44:29+00:00,['7a96c08b5612a49109523d25680261ad1cf2c7cf'],3,2,5,130498,1,,,,661
0a949d84fff3d1592b27676e04ca6bb889c0920a,1,Sean R. Owen,2009-07-24 14:32:05+00:00,['794d025c7b14d798bb747528ad943f287c5e54fe'],1704,987,2691,133189,102,0.610062893,0.283018868,0.411949686,661
4d1b7231f462d8d4a7a61566c081e6b3bae53217,0,Grant Ingersoll,2009-07-27 01:27:26+00:00,['0a949d84fff3d1592b27676e04ca6bb889c0920a'],1,1,2,133191,1,,,,661
a29296c7e31e9e994447737303ab31b9cddb2a96,0,Grant Ingersoll,2009-07-29 01:01:24+00:00,['4d1b7231f462d8d4a7a61566c081e6b3bae53217'],26,88,114,133305,3,0,0.487179487,1,662
9768420548fdcd149e5e663f37207a5b6024712d,0,Sean R. Owen,2009-07-30 09:07:22+00:00,['a29296c7e31e9e994447737303ab31b9cddb2a96'],3,1,4,133309,1,1,0,1,662
02ba74191839b5d8cdaee35dddb9213358d4a572,0,Sean R. Owen,2009-07-30 09:11:45+00:00,['9768420548fdcd149e5e663f37207a5b6024712d'],15,19,34,133343,1,0,1,0,662
bf710b538bd7ec4aae06a242de331205610adba3,0,Grant Ingersoll,2009-08-01 14:38:58+00:00,['02ba74191839b5d8cdaee35dddb9213358d4a572'],9,8,17,133360,1,,,,662
ee4a2614f4644ff8571ae32de59908d37428e5fe,1,Grant Ingersoll,2009-08-02 14:19:55+00:00,['bf710b538bd7ec4aae06a242de331205610adba3'],10,930,940,134300,9,0.354022989,0.657471264,0.942528736,668
3bad4df1265c82d201923e9c9ff5860e273e9ceb,1,Grant Ingersoll,2009-08-02 14:38:42+00:00,['ee4a2614f4644ff8571ae32de59908d37428e5fe'],37,54,91,134391,5,0.25,0,1,668
20faad6330614d077d5a567aa7b6ebdd6bad5d60,1,Grant Ingersoll,2009-08-03 13:11:49+00:00,['3bad4df1265c82d201923e9c9ff5860e273e9ceb'],54,141,195,134586,6,0.25862069,1,0.689655172,668
d86c96740b02cb7651991984d6a3b4d80f7fbb2b,1,Sean R. Owen,2009-08-04 00:06:46+00:00,['20faad6330614d077d5a567aa7b6ebdd6bad5d60'],3629,3313,6942,141528,142,0.933333333,1,0.6,674
d7b9ef38320b6b2e44e287fff4c4ad9f3cd31fc9,0,Grant Ingersoll,2009-08-06 14:55:41+00:00,['d86c96740b02cb7651991984d6a3b4d80f7fbb2b'],48,165,213,141741,1,0.045977011,0.022988506,0.620689655,674
65be0f0afce788f735f44588e37cb4ee54fc8bb1,0,Otis Gospodnetic,2009-08-07 18:36:05+00:00,['d7b9ef38320b6b2e44e287fff4c4ad9f3cd31fc9'],0,15,15,141756,2,1,1,1,674
9e9182dca02ec2b83f25c07f5d834ea7ab818534,1,Grant Ingersoll,2009-08-08 01:42:06+00:00,['65be0f0afce788f735f44588e37cb4ee54fc8bb1'],22,15,37,141793,4,0,0,0,674
31a30f043a69164157fb255d82fe498042baead1,0,Grant Ingersoll,2009-08-08 17:53:58+00:00,['9e9182dca02ec2b83f25c07f5d834ea7ab818534'],3,5,8,141801,2,,,,674
4a28bda3481b8ba3140c0602eb5f2d5b3bc7031a,1,Grant Ingersoll,2009-08-09 02:36:01+00:00,['31a30f043a69164157fb255d82fe498042baead1'],6,4,10,141811,3,0,0,0,674
f5062921d65ae46431c4595d56f27b44058d2f41,1,Grant Ingersoll,2009-08-09 11:08:34+00:00,['4a28bda3481b8ba3140c0602eb5f2d5b3bc7031a'],8,26,34,141845,2,1,1,1,674
ead7576445a6d8629f3ceb8d90f92ac67387e034,1,Grant Ingersoll,2009-08-10 00:35:48+00:00,['f5062921d65ae46431c4595d56f27b44058d2f41'],2,3,5,141850,1,0,0,1,674
a66f1a87253050d54ff081efb59fa32a1fa489fd,1,Sean R. Owen,2009-08-11 12:04:35+00:00,['ead7576445a6d8629f3ceb8d90f92ac67387e034'],1983,2763,4746,146596,141,0.946759259,0.731481481,1,680
accdbdbd5c33500cce48d3c72707d5f8ff9ce837,0,Sean R. Owen,2009-08-11 14:58:55+00:00,['a66f1a87253050d54ff081efb59fa32a1fa489fd'],12,13,25,146621,2,,,,680
995c003e124bf6351606f444a7f533806063aa02,1,Grant Ingersoll,2009-08-17 13:33:18+00:00,['accdbdbd5c33500cce48d3c72707d5f8ff9ce837'],0,1570,1570,148191,14,0.308321965,0.660300136,0.669849932,692
00dee57638092d89b37d447da7b662bce5f3fef7,0,Sean R. Owen,2009-08-17 16:52:31+00:00,['995c003e124bf6351606f444a7f533806063aa02'],14,320,334,148525,6,0.747126437,1,0.827586207,697
66764adcf988176006f4ced03bf83bda5d80b1f9,0,Sean R. Owen,2009-08-17 16:55:10+00:00,['00dee57638092d89b37d447da7b662bce5f3fef7'],4,27,31,148556,8,1,1,1,697
f499b17bd7e496a4185e5bcbec20c18de39b7997,0,Sean R. Owen,2009-08-17 16:58:57+00:00,['66764adcf988176006f4ced03bf83bda5d80b1f9'],2,7,9,148565,1,0,0,1,697
1a6d9c63efb4ca396073c33318220ae109d70b42,0,Sean R. Owen,2009-08-18 13:08:08+00:00,['f499b17bd7e496a4185e5bcbec20c18de39b7997'],4,5,9,148574,1,0,0,1,697
1d1145c6918885f0306a0310592668bb6d1382df,0,Sean R. Owen,2009-08-18 19:28:33+00:00,['1a6d9c63efb4ca396073c33318220ae109d70b42'],4,19,23,148597,1,0,0,1,697
f3e63ce6ae465f9e34345e0c729ce2a087b082ed,0,Sean R. Owen,2009-08-19 11:07:25+00:00,['1d1145c6918885f0306a0310592668bb6d1382df'],32,78,110,148707,19,1,1,1,697
af8c8b5384b52bedee814a0f9b21deed07a18bfe,0,Sean R. Owen,2009-08-19 13:20:21+00:00,['f3e63ce6ae465f9e34345e0c729ce2a087b082ed'],1,2,3,148710,1,0,0,1,697
481b440d929971309f96a0043c1c294e08c99b9b,0,Sean R. Owen,2009-08-19 16:07:23+00:00,['af8c8b5384b52bedee814a0f9b21deed07a18bfe'],90,14,104,148814,4,0.796875,0.75,0,697
90d12eb7eba53eceae1263b798ec3658a0ae2058,0,Sean R. Owen,2009-08-20 10:52:28+00:00,['481b440d929971309f96a0043c1c294e08c99b9b'],3,13,16,148830,3,0,0,0.8,697
b3ad106ae67ef13482f641351f8d190790d62347,0,Sean R. Owen,2009-08-20 10:53:45+00:00,['90d12eb7eba53eceae1263b798ec3658a0ae2058'],29,37,66,148896,4,0.285714286,1,1,697
94e8d0da0f416ff8c199862b8d349245d03ae8dc,0,Sean R. Owen,2009-08-20 15:50:55+00:00,['b3ad106ae67ef13482f641351f8d190790d62347'],4,22,26,148922,4,0.916666667,0.916666667,1,697
553291ba1fffd4bf0c9de8d7624577e4c174b7d6,0,Sean R. Owen,2009-08-20 16:16:58+00:00,['94e8d0da0f416ff8c199862b8d349245d03ae8dc'],2,10,12,148934,1,1,1,1,697
172ffcdad38045580e8859c4daacefad230cf186,1,Sean R. Owen,2009-08-20 22:57:27+00:00,['553291ba1fffd4bf0c9de8d7624577e4c174b7d6'],90,84,174,149108,14,1,1,1,697
7a387ddb1c4196b25554f7fadd56a69749d79867,0,Sean R. Owen,2009-08-21 13:29:47+00:00,['172ffcdad38045580e8859c4daacefad230cf186'],1,1,2,149110,1,,,,697
88b40a5aa99131f16b40761d460712f7746fbe60,0,Sean R. Owen,2009-08-24 17:35:01+00:00,['7a387ddb1c4196b25554f7fadd56a69749d79867'],19,28,47,149157,1,1,0,1,697
758cc1bb5abdfb11484d0f3397886a4e7ef80d5c,1,Sean R. Owen,2009-08-24 20:16:37+00:00,['88b40a5aa99131f16b40761d460712f7746fbe60'],510,532,1042,150199,85,1,1,0,697
98c32ab4a436eeb0ddf90d8d3ce88a23aec720e7,0,Sean R. Owen,2009-08-25 10:52:51+00:00,['758cc1bb5abdfb11484d0f3397886a4e7ef80d5c'],1,8,9,150208,1,0,1,1,697
26ac2a57ba86b53851dc14d24503d112bda07b5b,0,Sean R. Owen,2009-08-25 10:53:26+00:00,['98c32ab4a436eeb0ddf90d8d3ce88a23aec720e7'],13,22,35,150243,6,,,,697
00fd47486821e36b4b356e785a5350349e9158c2,0,Sean R. Owen,2009-08-25 11:04:05+00:00,['26ac2a57ba86b53851dc14d24503d112bda07b5b'],5,6,11,150254,1,1,1,1,697
49697cc46f876b06feaa538b2165890b00dcbf5d,0,Sean R. Owen,2009-08-27 12:58:52+00:00,['00fd47486821e36b4b356e785a5350349e9158c2'],1,288,289,150543,3,0.547297297,0.885135135,0.952702703,699
fbe90e6ff946a96674284d1effc2178dd299090a,0,Sean R. Owen,2009-08-27 15:28:33+00:00,['49697cc46f876b06feaa538b2165890b00dcbf5d'],1,5,6,150549,1,,,,699
9125a01281b9e90412e362da9758f6b361eabb91,1,Robin Anil,2009-08-28 08:17:13+00:00,['fbe90e6ff946a96674284d1effc2178dd299090a'],1452,2935,4387,154936,65,0.507503411,0.759890859,0.361527967,722
7587515d345eb0d9f0aaa96a6a70465d4c2df9e4,0,Sean R. Owen,2009-08-28 09:07:33+00:00,['9125a01281b9e90412e362da9758f6b361eabb91'],24,62,86,155022,3,1,1,0.75,722
5fc2f1b8690b247e0b8f451caec0ba1dc13d4132,0,Sean R. Owen,2009-08-28 12:21:33+00:00,['7587515d345eb0d9f0aaa96a6a70465d4c2df9e4'],0,20,20,155042,2,0,0,1,722
67fafe27cc285fe0cf17a147224a059d6271a886,1,Sean R. Owen,2009-08-28 14:36:46+00:00,['5fc2f1b8690b247e0b8f451caec0ba1dc13d4132'],30,26,56,155098,2,1,1,0,722
2835555933a8bbaa78b85589471b8040bdcd981a,1,Grant Ingersoll,2009-09-01 19:22:10+00:00,['67fafe27cc285fe0cf17a147224a059d6271a886'],20,94,114,155212,5,0.209677419,0.887096774,1,722
af5885061e0760ade8b973485502c4f447704fac,1,Sean R. Owen,2009-09-06 17:57:28+00:00,['2835555933a8bbaa78b85589471b8040bdcd981a'],65,155,220,155432,25,1,0.333333333,0.111111111,722
6f08ad76e861bc6711e9861e2f4cb94b9434d95c,0,Sean R. Owen,2009-09-07 17:19:10+00:00,['af5885061e0760ade8b973485502c4f447704fac'],4,10,14,155446,1,0,1,1,722
da03b2302af2f51253685da4030a59f5144a2ba4,1,Sean R. Owen,2009-09-07 22:03:18+00:00,['6f08ad76e861bc6711e9861e2f4cb94b9434d95c'],262,201,463,155909,68,0.678571429,0.75,0,722
5df646ece7ffe0cdb922a04eb8485aa1d7340fa3,0,Sean R. Owen,2009-09-07 22:06:38+00:00,['da03b2302af2f51253685da4030a59f5144a2ba4'],2,2,4,155913,2,,,,722
a4664320567a2627bd3c1f23faca84729a5962a5,1,Sean R. Owen,2009-09-08 12:41:28+00:00,['5df646ece7ffe0cdb922a04eb8485aa1d7340fa3'],84,70,154,156067,12,1,0,0.230769231,722
543213bfe62095487237be3bc07535fadabb971f,1,Sean R. Owen,2009-09-09 10:53:02+00:00,['a4664320567a2627bd3c1f23faca84729a5962a5'],24,152,176,156243,7,0.571428571,1,0.714285714,724
095f4356f145696ef9d887357dbee09aca28ce6b,1,Grant Ingersoll,2009-09-09 13:28:31+00:00,['543213bfe62095487237be3bc07535fadabb971f'],4,4,8,156251,4,,,,724
90fe0a203290e1ceded177d7b354e68e9637fc2a,0,Grant Ingersoll,2009-09-09 13:33:41+00:00,['095f4356f145696ef9d887357dbee09aca28ce6b'],21,38,59,156310,9,1,1,1,724
9416447d0aeb84b2c4c08833d2914c377fe26700,1,Sean R. Owen,2009-09-09 15:41:31+00:00,['90fe0a203290e1ceded177d7b354e68e9637fc2a'],294,214,508,156818,36,0.732142857,0.25,0.089285714,724
e6f27f1171b408932a5915eaf2925ea57402c60d,0,Grant Ingersoll,2009-09-12 19:53:03+00:00,['9416447d0aeb84b2c4c08833d2914c377fe26700'],34,15,49,156867,2,,,,724
5ca50f3b8975b84425a4b4fb90d5fe272dedfb93,0,Grant Ingersoll,2009-09-12 20:37:13+00:00,['e6f27f1171b408932a5915eaf2925ea57402c60d'],1,1,2,156869,1,,,,724
217b964e9b54c0ed18c24d423ee4472e38ee034d,0,Isabel Drost,2009-09-14 06:40:13+00:00,['5ca50f3b8975b84425a4b4fb90d5fe272dedfb93'],2,2,4,156873,1,,,,724
4b6a029226adaed6549439553f8983bd5bbd34b6,0,Sean R. Owen,2009-09-15 09:49:50+00:00,['217b964e9b54c0ed18c24d423ee4472e38ee034d'],1,4,5,156878,1,,,,724
18d1a48178dee6d930c29e444c5352b6e9a548f2,0,Isabel Drost,2009-09-18 08:18:44+00:00,['4b6a029226adaed6549439553f8983bd5bbd34b6'],25,90,115,156993,1,0,1,1,724
4020e68ad11893642913dcdf44cf824970d867bc,0,Isabel Drost,2009-09-18 09:02:09+00:00,['18d1a48178dee6d930c29e444c5352b6e9a548f2'],7,67,74,157067,1,0,1,1,724
89607ffb61c19068b1f06ea4804ebfed835acc92,1,Sean R. Owen,2009-09-18 09:21:18+00:00,['4020e68ad11893642913dcdf44cf824970d867bc'],156,175,331,157398,90,0,0,0,724
42f986b32a3b8b65e79bcbfe345903a5708f538b,0,Isabel Drost,2009-09-18 09:24:23+00:00,['89607ffb61c19068b1f06ea4804ebfed835acc92'],9,69,78,157476,1,0,1,1,724
b11989c85e8afe871e0c2b595968f2e319f44cde,0,Isabel Drost,2009-09-18 09:41:24+00:00,['42f986b32a3b8b65e79bcbfe345903a5708f538b'],1,1,2,157478,1,,,,724
0a26e036d0337a22bbc2eb6050dd54d3ab033ae0,0,Sean R. Owen,2009-09-18 10:01:12+00:00,['b11989c85e8afe871e0c2b595968f2e319f44cde'],41,36,77,157555,8,1,0.666666667,0,724
b530d4dc9204d42beb2197055db461b22a48d80c,1,Isabel Drost,2009-09-18 11:37:10+00:00,['0a26e036d0337a22bbc2eb6050dd54d3ab033ae0'],16,20,36,157591,1,0,1,1,724
4dd7df6be7d1f459b58885f7041e4cc073b2d975,0,Isabel Drost,2009-09-18 12:12:47+00:00,['b530d4dc9204d42beb2197055db461b22a48d80c'],75,243,318,157909,6,0.466019417,1,1,725
72929a6e3250829fc7e0d27798a057ed05a2ec40,0,Sean R. Owen,2009-09-21 17:54:51+00:00,['4dd7df6be7d1f459b58885f7041e4cc073b2d975'],4,3,7,157916,2,,,,725
286addc849ba11b5333d8a04d37e085f96734116,0,Sean R. Owen,2009-09-23 13:48:29+00:00,['72929a6e3250829fc7e0d27798a057ed05a2ec40'],4,0,4,157920,1,,,,725
1ad8a29cabe4947cea06e4d96de5d7e3c145046e,0,Sean R. Owen,2009-09-23 17:21:17+00:00,['286addc849ba11b5333d8a04d37e085f96734116'],93,78,171,158091,2,,,,725
d9d3e15732f2a6e2ad499e412ea3739e9cf31844,1,Sean R. Owen,2009-09-25 22:11:52+00:00,['1ad8a29cabe4947cea06e4d96de5d7e3c145046e'],340,342,682,158773,19,0,0,1,730
cc453b494aab9adad6c0039a9ddb432a23aba86a,0,Sean R. Owen,2009-09-25 22:55:41+00:00,['d9d3e15732f2a6e2ad499e412ea3739e9cf31844'],22,16,38,158811,9,1,1,0,730
7d4e73d039940b73571ec8d9cb347b169a0aee95,0,Sean R. Owen,2009-09-26 16:15:02+00:00,['cc453b494aab9adad6c0039a9ddb432a23aba86a'],1,1,2,158813,1,,,,730
8c37a844c7dc2f67c7dc88ea42604efe324aa8be,1,Abdel Hakim Deneche,2009-09-27 18:20:42+00:00,['7d4e73d039940b73571ec8d9cb347b169a0aee95'],0,5294,5294,164107,44,0.599905527,0.81483231,0.794992915,774
a8f9f8875ecb1fc61738cbd35357b1daf6bfc15b,1,Abdel Hakim Deneche,2009-09-29 04:56:25+00:00,['8c37a844c7dc2f67c7dc88ea42604efe324aa8be'],0,2518,2518,166625,17,0.674321503,0.925887265,0.879958246,791
287b72b3d6358a24cb725627461aa06c1fa3f0ff,1,Abdel Hakim Deneche,2009-09-30 05:29:22+00:00,['a8f9f8875ecb1fc61738cbd35357b1daf6bfc15b'],0,5576,5576,172201,32,0.315129812,0.908236347,0.691136974,823
8547de7acdd06df851a3445f59279ad30543822c,1,Sean R. Owen,2009-10-03 12:46:06+00:00,['287b72b3d6358a24cb725627461aa06c1fa3f0ff'],595,656,1251,173452,83,1,1,1,824
5820585d1fbef5cf715236ef62a988bdcf49dc39,0,Isabel Drost,2009-10-03 18:23:05+00:00,['8547de7acdd06df851a3445f59279ad30543822c'],109,204,313,173765,12,0,0.2,0,826
e89736f921bd11ff0128f1d58c516b3ca312ab9e,0,Isabel Drost,2009-10-04 11:40:26+00:00,['5820585d1fbef5cf715236ef62a988bdcf49dc39'],1,1,2,173767,1,,,,826
c4072b06d611145eb6a60b674e9df0db59bc3c7f,0,Sean R. Owen,2009-10-05 10:13:50+00:00,['e89736f921bd11ff0128f1d58c516b3ca312ab9e'],2,3,5,173772,1,0,0,1,826
acafdc0f0fe155b3063e65fca4f935304822b437,1,Sean R. Owen,2009-10-05 10:35:25+00:00,['c4072b06d611145eb6a60b674e9df0db59bc3c7f'],221,195,416,174188,54,0.863636364,1,0.045454545,826
abe21371c50c697196798d1b3cb0c2f71375aa9e,0,Abdel Hakim Deneche,2009-10-06 05:27:13+00:00,['acafdc0f0fe155b3063e65fca4f935304822b437'],2,2,4,174192,1,,,,826
a2d1b8050942e0213828d2bc7f1e782cbe51128b,0,Isabel Drost,2009-10-09 10:28:19+00:00,['abe21371c50c697196798d1b3cb0c2f71375aa9e'],21,159,180,174372,4,0,1,1,826
8a86b759b428f0f111a589814812088f23409521,0,Isabel Drost,2009-10-09 13:16:41+00:00,['a2d1b8050942e0213828d2bc7f1e782cbe51128b'],15,38,53,174425,5,0,0.923076923,1,826
1970d8829a0290533db5d03c75c40e5c84c0d269,0,Isabel Drost,2009-10-09 13:19:57+00:00,['8a86b759b428f0f111a589814812088f23409521'],0,60,60,174485,1,0,1,1,827
254af094d6a7dc7fcc63a0bf4a991bd8894aa60d,1,Sean R. Owen,2009-10-09 16:48:09+00:00,['1970d8829a0290533db5d03c75c40e5c84c0d269'],183,167,350,174835,51,1,1,0.307692308,827
efcd32d0cc235897f4cf180f7743c7064b443a5f,0,Abdel Hakim Deneche,2009-10-10 04:55:42+00:00,['254af094d6a7dc7fcc63a0bf4a991bd8894aa60d'],1,1,2,174837,1,,,,827
c7ed48699d97618399044cea050ecb4405469194,1,Abdel Hakim Deneche,2009-10-10 07:52:33+00:00,['efcd32d0cc235897f4cf180f7743c7064b443a5f'],46,148,194,175031,2,0,0,1,827
e75b077728353cc75dfcea5d5105dae876f9b1c0,0,Sean R. Owen,2009-10-10 18:12:36+00:00,['c7ed48699d97618399044cea050ecb4405469194'],4,4,8,175039,2,,,,827
d50182061f416656b763abcda8fb0a2e01a22bda,0,Sean R. Owen,2009-10-10 18:17:30+00:00,['e75b077728353cc75dfcea5d5105dae876f9b1c0'],1110,741,1851,176890,36,0.716216216,0,1,829
9a23b72c87ae9b41aa99f3a9e177026ed585d29b,0,Abdel Hakim Deneche,2009-10-11 07:02:20+00:00,['d50182061f416656b763abcda8fb0a2e01a22bda'],54,101,155,177045,1,0,0,0,829
c145861f0e9e7585366bf6ba062251b7cfd603bc,0,Sean R. Owen,2009-10-12 11:57:41+00:00,['9a23b72c87ae9b41aa99f3a9e177026ed585d29b'],3,0,3,177048,1,1,1,1,829
3af7201cb7478913993507db6cf85e41bc94f05c,0,Grant Ingersoll,2009-10-14 12:58:38+00:00,['c145861f0e9e7585366bf6ba062251b7cfd603bc'],68,61,129,177177,4,1,0,1,829
0b8a660387cee5bb573892efeeec2c31ff3cbfbb,1,Isabel Drost,2009-10-15 15:27:40+00:00,['3af7201cb7478913993507db6cf85e41bc94f05c'],129,455,584,177761,17,0,1,0.988636364,829
11e92a3c2fba0ba9fe1ac3a8b61020a4f04567e1,0,Isabel Drost,2009-10-15 15:35:18+00:00,['0b8a660387cee5bb573892efeeec2c31ff3cbfbb'],8,8,16,177777,2,,,,829
d6b8130f2ccdb7a656a03ac066b942cbe99d1fbe,1,Sean R. Owen,2009-10-16 15:12:38+00:00,['11e92a3c2fba0ba9fe1ac3a8b61020a4f04567e1'],0,36,36,177813,1,,,,829
4139a9a8358fbe9cba42362d2e1d0614339ea652,0,Sean R. Owen,2009-10-16 15:18:37+00:00,['d6b8130f2ccdb7a656a03ac066b942cbe99d1fbe'],17,13,30,177843,6,1,0.2,0,829
1dc91b27b74f6a625632a6da9fde57996a5bc9ac,0,Sean R. Owen,2009-10-16 15:20:04+00:00,['4139a9a8358fbe9cba42362d2e1d0614339ea652'],12,25,37,177880,2,0,0.083333333,0.083333333,829
e18ba10ebe5af534d8a65f3532faed958e3b3203,0,Sean R. Owen,2009-10-16 18:19:55+00:00,['1dc91b27b74f6a625632a6da9fde57996a5bc9ac'],30,51,81,177961,1,,,,829
1429d48ecf37c5e8427cd8872a2ef20dd82a157f,0,Sean R. Owen,2009-10-16 18:23:59+00:00,['e18ba10ebe5af534d8a65f3532faed958e3b3203'],0,14,14,177975,1,,,,829
de680d0396ec6900ed8bf9d9a6cb75007016dbaa,0,Sean R. Owen,2009-10-16 19:19:40+00:00,['1429d48ecf37c5e8427cd8872a2ef20dd82a157f'],3,11,14,177989,1,1,1,1,829
90ba2a1ce84581b03b04678bcc0019a87b6f4bf0,0,Abdel Hakim Deneche,2009-10-17 08:02:23+00:00,['de680d0396ec6900ed8bf9d9a6cb75007016dbaa'],1,2,3,177992,1,,,,829
d0ef5126194fbe80054cfa3833730f13c206b1f1,1,Sean R. Owen,2009-10-17 09:42:31+00:00,['90ba2a1ce84581b03b04678bcc0019a87b6f4bf0'],182,165,347,178339,40,0,1,0,829
1c87313a36d374fb4bba754b7d9ba42dce25d6f4,0,Abdel Hakim Deneche,2009-10-18 05:21:45+00:00,['d0ef5126194fbe80054cfa3833730f13c206b1f1'],7,0,7,178346,3,1,0.5,0.5,829
0bff77cf53372dcdcf680881ec972cf8313a0704,0,Sean R. Owen,2009-10-18 21:57:42+00:00,['1c87313a36d374fb4bba754b7d9ba42dce25d6f4'],1,1,2,178348,1,,,,829
288156fb37e851730047230ab8a040193981b17a,1,Robin Anil,2009-10-18 22:19:56+00:00,['0bff77cf53372dcdcf680881ec972cf8313a0704'],0,3632,3632,181980,28,0.403856454,0.638993037,0.724692019,857
7cd7e7e53537de8947446722943101816f9c12fd,0,Robin Anil,2009-10-18 22:28:59+00:00,['288156fb37e851730047230ab8a040193981b17a'],0,4,4,181984,4,,,,857
cad7b5ad6baf9fbbc51e7ee32cec3c4b87dfd269,0,Robin Anil,2009-10-19 00:03:55+00:00,['7cd7e7e53537de8947446722943101816f9c12fd'],43,54,97,182081,3,0.125,0,0.125,857
5651a1c97fe9dbbbbffd00a0764182ddae56cd73,0,Robin Anil,2009-10-19 00:05:02+00:00,['cad7b5ad6baf9fbbc51e7ee32cec3c4b87dfd269'],5,5,10,182091,3,,,,857
7f8418365775dbfac768e5cf2371b00bd9976581,1,Isabel Drost,2009-10-19 19:01:57+00:00,['5651a1c97fe9dbbbbffd00a0764182ddae56cd73'],1294,299,1593,183684,15,,,,857
f3a3d400fe8d049a4dced93bcfbb0598028c802e,0,Robin Anil,2009-10-19 22:26:27+00:00,['7f8418365775dbfac768e5cf2371b00bd9976581'],132,224,356,184040,8,0,0,0.973333333,857
914a86d5d5966bee469f9d7dfd70f86d8c8d6f34,0,Isabel Drost,2009-10-20 05:53:18+00:00,['f3a3d400fe8d049a4dced93bcfbb0598028c802e'],0,1025,1025,185065,7,,,,864
fe5698ba95b792237353670155207db2434d5996,1,Robin Anil,2009-10-20 11:32:36+00:00,['914a86d5d5966bee469f9d7dfd70f86d8c8d6f34'],695,690,1385,186450,17,1,1,1,864
937e64ecdc9255b52f8d177cd15f369c48c2fab2,0,Sean R. Owen,2009-10-20 12:19:19+00:00,['fe5698ba95b792237353670155207db2434d5996'],15,69,84,186534,1,0,1,0.8,864
d951f3ea72af3675c1c757ae15a7d6fef285aa53,0,Robin Anil,2009-10-20 13:44:21+00:00,['937e64ecdc9255b52f8d177cd15f369c48c2fab2'],5,5,10,186544,1,0,0,0,864
b5bbe2ed4004d7145c5db2934137e080915a33be,1,Sean R. Owen,2009-10-20 14:04:55+00:00,['d951f3ea72af3675c1c757ae15a7d6fef285aa53'],451,440,891,187435,83,0.214285714,1,0.5,864
f483d0e0f5f3fd6f1de748dcf244c867b9f69291,1,Sean R. Owen,2009-10-20 14:43:22+00:00,['b5bbe2ed4004d7145c5db2934137e080915a33be'],295,281,576,188011,8,,,,864
1073c721d41fe36c355765753e8ab4280cc1ab41,0,Sean R. Owen,2009-10-20 14:52:45+00:00,['f483d0e0f5f3fd6f1de748dcf244c867b9f69291'],11,11,22,188033,6,,,,864
f92849f8334724e0e619bbaeeec724c07c5f2973,0,Sean R. Owen,2009-10-21 18:20:22+00:00,['1073c721d41fe36c355765753e8ab4280cc1ab41'],7,6,13,188046,3,1,1,1,864
c4d5b16c52110491e8e690cc963a8d6c186be301,0,Sean R. Owen,2009-10-22 00:00:51+00:00,['f92849f8334724e0e619bbaeeec724c07c5f2973'],44,38,82,188128,6,,,,864
7bacea948155a19cdcf1eed989cacc4a97e30c6f,0,Sean R. Owen,2009-10-22 00:04:53+00:00,['c4d5b16c52110491e8e690cc963a8d6c186be301'],38,44,82,188210,6,,,,864
48eb62267e5952ced1d2c54602eb683f529cedca,0,Sean R. Owen,2009-10-22 00:11:37+00:00,['7bacea948155a19cdcf1eed989cacc4a97e30c6f'],44,38,82,188292,6,,,,864
4c4d94e8c43b68981b5434d011309d5c2c7a7393,0,Sean R. Owen,2009-10-22 01:04:33+00:00,['48eb62267e5952ced1d2c54602eb683f529cedca'],38,44,82,188374,6,,,,864
5ed200f6e138050f04943c400f512694064f6ea5,0,Sean R. Owen,2009-10-22 17:33:51+00:00,['4c4d94e8c43b68981b5434d011309d5c2c7a7393'],44,38,82,188456,6,,,,864
d82296bf4c7085761652105ee4b42a333cf561d1,0,Sean R. Owen,2009-10-22 18:22:12+00:00,['5ed200f6e138050f04943c400f512694064f6ea5'],38,44,82,188538,6,,,,864
40b1c16e26349e722c818ba6151823e6e1eaafdb,0,Robin Anil,2009-10-23 04:41:23+00:00,['d82296bf4c7085761652105ee4b42a333cf561d1'],2,4,6,188544,1,0,0,0,864
d8e70442b4e3d9d1de331ee309a156be561a419a,0,Grant Ingersoll,2009-10-23 20:44:48+00:00,['40b1c16e26349e722c818ba6151823e6e1eaafdb'],1,1,2,188546,1,,,,864
a03bb1167293d98a0a0048d5e9c1545b3b82d48d,0,Grant Ingersoll,2009-10-23 20:48:46+00:00,['d8e70442b4e3d9d1de331ee309a156be561a419a'],5,6,11,188557,1,,,,864
ef9062cff748a220351fb9ea7f49853d136382ba,0,Grant Ingersoll,2009-10-23 20:49:00+00:00,['a03bb1167293d98a0a0048d5e9c1545b3b82d48d'],6,5,11,188568,1,,,,864
3d8f73e6af09d93a5430494263783f6ade06a1cc,0,Grant Ingersoll,2009-10-23 20:51:07+00:00,['ef9062cff748a220351fb9ea7f49853d136382ba'],0,1,1,188569,1,,,,864
a829d8ca3acc0f96b7dc61bbbe67371b098e6117,1,Grant Ingersoll,2009-10-23 21:09:44+00:00,['3d8f73e6af09d93a5430494263783f6ade06a1cc'],16,16,32,188601,2,,,,864
8c3742cbd84d7cc8a78ac039c32eb87cfa2c3b6e,0,Grant Ingersoll,2009-10-24 10:55:54+00:00,['a829d8ca3acc0f96b7dc61bbbe67371b098e6117'],6,3,9,188610,1,,,,864
37cb1bea8aca0dc09dadc1a3ccb680c44fa6a872,0,Sean R. Owen,2009-10-24 17:49:24+00:00,['8c3742cbd84d7cc8a78ac039c32eb87cfa2c3b6e'],44,38,82,188692,6,,,,864
93d60a05297c364410307d0c5b934e77140d49c0,0,Sean R. Owen,2009-10-24 17:57:15+00:00,['37cb1bea8aca0dc09dadc1a3ccb680c44fa6a872'],38,44,82,188774,6,,,,864
ea615061e8605aacc2cb787d4f7c8ff272a255a8,0,Sean R. Owen,2009-10-24 18:03:20+00:00,['93d60a05297c364410307d0c5b934e77140d49c0'],44,38,82,188856,6,,,,864
0d511716a299e8cbd21429616f01d5a4f2c88ca4,0,Sean R. Owen,2009-10-24 18:26:17+00:00,['ea615061e8605aacc2cb787d4f7c8ff272a255a8'],38,44,82,188938,6,,,,864
64c19ef74360a4ebb91a58811dfd1fdcaf1a0fb3,0,Sean R. Owen,2009-10-26 02:17:05+00:00,['0d511716a299e8cbd21429616f01d5a4f2c88ca4'],0,6,6,188944,1,1,1,1,864
70bfd52f198895485b9910d6123d64eb52dd1aa0,0,Sean R. Owen,2009-10-26 03:19:20+00:00,['64c19ef74360a4ebb91a58811dfd1fdcaf1a0fb3'],66,130,196,189140,5,1,1,1,867
f1bb02fc00fa605c0c4a119536a72c70fe6df79d,0,Sean R. Owen,2009-10-26 03:55:29+00:00,['70bfd52f198895485b9910d6123d64eb52dd1aa0'],2,2,4,189144,2,,,,867
b6f37a5cf89037a4aa6c0fa9f635aeb75f2e2340,0,Grant Ingersoll,2009-10-26 16:34:28+00:00,['f1bb02fc00fa605c0c4a119536a72c70fe6df79d'],44,38,82,189226,6,,,,867
79694a950f85f2f3b169e1c039a52b12fab3abc6,0,Grant Ingersoll,2009-10-26 16:38:02+00:00,['b6f37a5cf89037a4aa6c0fa9f635aeb75f2e2340'],38,44,82,189308,6,,,,867
8d369480bad4813d97932484b6c63d61bee4519c,0,Grant Ingersoll,2009-10-26 17:52:35+00:00,['79694a950f85f2f3b169e1c039a52b12fab3abc6'],44,38,82,189390,6,,,,867
98946e8022476c8e83e4f4aa474fefc80e0b551a,0,Grant Ingersoll,2009-10-26 20:02:34+00:00,['8d369480bad4813d97932484b6c63d61bee4519c'],38,44,82,189472,6,,,,867
6d5ffcd250d6ff7f552aaf999f435dff07227d46,0,Grant Ingersoll,2009-10-26 20:10:58+00:00,['98946e8022476c8e83e4f4aa474fefc80e0b551a'],2,2,4,189476,1,,,,867
e01672cacfa361300316a3b8bd7ef497f33a958f,0,Grant Ingersoll,2009-10-26 20:49:17+00:00,['6d5ffcd250d6ff7f552aaf999f435dff07227d46'],53,47,100,189576,6,,,,867
bef33c44c6165c5c96c6cbae7e8d6f14bc088609,0,Grant Ingersoll,2009-10-26 20:49:54+00:00,['e01672cacfa361300316a3b8bd7ef497f33a958f'],47,53,100,189676,6,,,,867
ffee40634d9e2b2fa04e3d797cfceeb2985640a9,0,Grant Ingersoll,2009-10-26 20:50:28+00:00,['bef33c44c6165c5c96c6cbae7e8d6f14bc088609'],1,1,2,189678,1,,,,867
e5202fa398606c92c3b05dc540ed2ebc4dec6f88,0,Grant Ingersoll,2009-10-26 21:00:09+00:00,['ffee40634d9e2b2fa04e3d797cfceeb2985640a9'],53,47,100,189778,6,,,,867
37e61f4344b03aab294bc7e5dfb4bbe4de8b9ba0,0,Grant Ingersoll,2009-10-26 21:00:21+00:00,['e5202fa398606c92c3b05dc540ed2ebc4dec6f88'],28,28,56,189834,6,,,,867
0336ea5f348d5f0d76223962d4f85f19dd61e594,0,Grant Ingersoll,2009-10-27 12:17:27+00:00,['37e61f4344b03aab294bc7e5dfb4bbe4de8b9ba0'],30,36,66,189900,6,,,,867
ac9d92936130f8162cf224e21b3e4a8748be6fe2,0,Grant Ingersoll,2009-10-27 12:30:58+00:00,['0336ea5f348d5f0d76223962d4f85f19dd61e594'],1,1,2,189902,1,,,,867
8763f92b9fc0ed1cba20b94a194b21d3bf5d27d2,0,Grant Ingersoll,2009-10-27 14:29:23+00:00,['ac9d92936130f8162cf224e21b3e4a8748be6fe2'],1,1,2,189904,1,,,,867
f9f7a6c62c4fc0e2439a930a2f77b3453852cbc9,0,Grant Ingersoll,2009-10-27 14:38:49+00:00,['8763f92b9fc0ed1cba20b94a194b21d3bf5d27d2'],53,47,100,190004,6,,,,867
94ef0871ae6f70d8304f82f1fd17d00a818363f4,0,Grant Ingersoll,2009-10-27 14:39:06+00:00,['f9f7a6c62c4fc0e2439a930a2f77b3453852cbc9'],28,28,56,190060,6,,,,867
7bcfb13f086d6764f980e95c4cdb7a60de607c10,0,Sean R. Owen,2009-10-29 19:22:01+00:00,['94ef0871ae6f70d8304f82f1fd17d00a818363f4'],0,3,3,190063,1,0,0,1,867
0c785b2787ef089f88ffdea1823a78924df23b38,0,Sean R. Owen,2009-11-01 19:28:40+00:00,['7bcfb13f086d6764f980e95c4cdb7a60de607c10'],1,1,2,190065,1,,,,867
7f0d7748f209281a6446b85e90b55e3f2345bed6,1,Sean R. Owen,2009-11-01 19:35:12+00:00,['0c785b2787ef089f88ffdea1823a78924df23b38'],51,147,198,190263,28,0.291666667,0,0.625,867
21388ac0b782811a4dcfcafaf3b1aaf470b6ad66,1,Grant Ingersoll,2009-11-03 13:46:42+00:00,['7f0d7748f209281a6446b85e90b55e3f2345bed6'],30,53,83,190346,1,,,,867
a9d47369e106eed077f342f638fdb5e50a2a57ab,0,Grant Ingersoll,2009-11-03 14:09:55+00:00,['21388ac0b782811a4dcfcafaf3b1aaf470b6ad66'],11,11,22,190368,6,,,,867
09ddad525bfa22ab2dfe6800a56867042ad46832,0,Grant Ingersoll,2009-11-03 14:15:29+00:00,['a9d47369e106eed077f342f638fdb5e50a2a57ab'],10,10,20,190388,1,,,,867
a20fc52a0062d4f8cbb8760f494f26b3296ea5cf,0,Grant Ingersoll,2009-11-03 14:37:13+00:00,['09ddad525bfa22ab2dfe6800a56867042ad46832'],28,28,56,190444,6,,,,867
def063ca691d74a599e7e790662a8097ab8613e0,0,Grant Ingersoll,2009-11-03 14:37:31+00:00,['a20fc52a0062d4f8cbb8760f494f26b3296ea5cf'],28,28,56,190500,6,,,,867
6ebe4f4b82e23a8544e348ba1fe75255a3f011f3,1,Sean R. Owen,2009-11-04 12:06:37+00:00,['def063ca691d74a599e7e790662a8097ab8613e0'],139,310,449,190949,37,1,1,1,867
b19c3b95d36279476da846a738f592c027705413,1,Sean R. Owen,2009-11-04 12:08:38+00:00,['6ebe4f4b82e23a8544e348ba1fe75255a3f011f3'],60,227,287,191236,8,1,1,0.651162791,867
220c529f8db7552b2d1ee16163d686dd9fe8883d,0,Sean R. Owen,2009-11-04 12:33:59+00:00,['b19c3b95d36279476da846a738f592c027705413'],4,22,26,191262,1,0,0,1,867
91ca078c6e1f0f2aaea449db505c8cbc87ab8541,0,Sean R. Owen,2009-11-04 12:48:46+00:00,['220c529f8db7552b2d1ee16163d686dd9fe8883d'],2,5,7,191269,1,0,0,0,867
8be8b5e820eedc76b6a3bfc0ab218f429a1c5489,1,Sean R. Owen,2009-11-05 20:48:18+00:00,['91ca078c6e1f0f2aaea449db505c8cbc87ab8541'],1,1,2,191271,1,,,,867
ae78fc3ded0f6bea3e98218fdf94b6435f81ce1d,0,Sean R. Owen,2009-11-05 20:50:17+00:00,['8be8b5e820eedc76b6a3bfc0ab218f429a1c5489'],9,10,19,191290,2,1,1,0,867
d28be5211dad13db16dbdc5654f3b14b7d5f91bc,0,Sean R. Owen,2009-11-05 20:54:14+00:00,['ae78fc3ded0f6bea3e98218fdf94b6435f81ce1d'],18,10,28,191318,13,,,,879
b646b177737ffb8a2cd05ff67b4d49affa14f9f9,1,Isabel Drost,2009-11-05 21:42:28+00:00,['d28be5211dad13db16dbdc5654f3b14b7d5f91bc'],0,36,36,191354,1,,,,879
24d6e96f23b29894d4e3441049a2f2f8a307d499,0,Sean R. Owen,2009-11-07 13:27:55+00:00,['b646b177737ffb8a2cd05ff67b4d49affa14f9f9'],6,68,74,191428,4,0.92,0.92,1,879
db58aa5f495596e9ecf9459d163e39e39b803806,0,Sean R. Owen,2009-11-07 15:59:45+00:00,['24d6e96f23b29894d4e3441049a2f2f8a307d499'],0,1,1,191429,1,1,1,1,879
7d214cd60fd56476b4c52192673ad926c54e1ae0,0,Sean R. Owen,2009-11-08 13:14:11+00:00,['db58aa5f495596e9ecf9459d163e39e39b803806'],79,128,207,191636,8,1,1,0.666666667,879
faccaf27eee8c9f393cdcbc1d9bc6ca8cbb22e64,0,Sean R. Owen,2009-11-08 13:28:52+00:00,['7d214cd60fd56476b4c52192673ad926c54e1ae0'],10,33,43,191679,1,1,1,0.166666667,879
df73dbca9bea7c5be04e1d6f1ba5a6cb02dbff37,0,Abdel Hakim Deneche,2009-11-09 04:30:46+00:00,['faccaf27eee8c9f393cdcbc1d9bc6ca8cbb22e64'],0,112,112,191791,23,0.986486486,1,1,879
2e2c4aa8aa1f542d50e440f5518dc733808aa95c,1,Sean R. Owen,2009-11-09 14:16:37+00:00,['df73dbca9bea7c5be04e1d6f1ba5a6cb02dbff37'],4,6,10,191801,3,1,1,1,879
12abbc0fee5ba28c6c622b7f618dba9ff75b2fa7,0,Sean R. Owen,2009-11-09 14:41:00+00:00,['2e2c4aa8aa1f542d50e440f5518dc733808aa95c'],9,5,14,191815,3,0,0,0,879
fc74924ecccd7cccb19f4f68961e1be55f22c41e,1,Sean R. Owen,2009-11-09 15:00:48+00:00,['12abbc0fee5ba28c6c622b7f618dba9ff75b2fa7'],295,424,719,192534,70,0.98019802,0.98019802,0.99009901,879
db394ce9527db1a043c998e67eeb53ac35687cb8,0,Grant Ingersoll,2009-11-09 15:02:17+00:00,['fc74924ecccd7cccb19f4f68961e1be55f22c41e'],11,11,22,192556,6,,,,879
90e6dcf339b8bf27903c79fa41b4abcdef9df6af,0,Grant Ingersoll,2009-11-09 16:42:15+00:00,['db394ce9527db1a043c998e67eeb53ac35687cb8'],0,128,128,192684,1,,,,879
5f157b2e398c94d1b89f520e5d1e16a8a728e1fb,0,Grant Ingersoll,2009-11-09 16:58:13+00:00,['90e6dcf339b8bf27903c79fa41b4abcdef9df6af'],8,8,16,192700,1,,,,879
8678ef0fae80b6ed9d75488653057c63199e9c18,0,Sean R. Owen,2009-11-09 16:58:48+00:00,['5f157b2e398c94d1b89f520e5d1e16a8a728e1fb'],1,1,2,192702,1,,,,879
95503705da3ea00c99cb71088687599d0d4189d3,0,Grant Ingersoll,2009-11-09 18:36:13+00:00,['8678ef0fae80b6ed9d75488653057c63199e9c18'],131,1,132,192834,1,,,,879
bb48e9d64982993e4b85d96a16b67f6631367969,0,Grant Ingersoll,2009-11-09 20:57:13+00:00,['95503705da3ea00c99cb71088687599d0d4189d3'],1,131,132,192966,1,,,,879
0d662e03f16bc5fcd1955c4d76f538c00456240d,0,Grant Ingersoll,2009-11-10 16:24:17+00:00,['bb48e9d64982993e4b85d96a16b67f6631367969'],133,0,133,193099,1,,,,879
00ee52c04c833f2893aefc63bd734d9489454915,0,Grant Ingersoll,2009-11-10 16:27:42+00:00,['0d662e03f16bc5fcd1955c4d76f538c00456240d'],1,113,114,193213,1,,,,879
f6f2db83fea8cbb39a52c1cca782ed5842981eef,0,Grant Ingersoll,2009-11-10 16:28:11+00:00,['00ee52c04c833f2893aefc63bd734d9489454915'],7,7,14,193227,1,,,,879
e1e410a02de825a00ce2d174133988106cae1cc2,0,Grant Ingersoll,2009-11-10 16:44:38+00:00,['f6f2db83fea8cbb39a52c1cca782ed5842981eef'],30,29,59,193286,6,,,,879
37aff7c88b0647c5b51bc52f5deea7f63c812202,0,Grant Ingersoll,2009-11-10 16:44:58+00:00,['e1e410a02de825a00ce2d174133988106cae1cc2'],28,28,56,193342,6,,,,879
2d5a87a73a0b1b57b73c18aea76f082265c000e4,0,Grant Ingersoll,2009-11-10 17:46:11+00:00,['37aff7c88b0647c5b51bc52f5deea7f63c812202'],12,13,25,193367,6,,,,879
13aaad6b0671a5599aba98eace7f3ebe81c7a695,0,Grant Ingersoll,2009-11-10 17:46:45+00:00,['2d5a87a73a0b1b57b73c18aea76f082265c000e4'],3,3,6,193373,3,,,,879
a5d11b9b60499ab6229ba3ae68dedab6f527fb18,0,Grant Ingersoll,2009-11-10 18:10:04+00:00,['13aaad6b0671a5599aba98eace7f3ebe81c7a695'],30,29,59,193432,6,,,,879
252a83d0991a8dbcb7490658ba450ed230077ba2,0,Grant Ingersoll,2009-11-10 18:10:19+00:00,['a5d11b9b60499ab6229ba3ae68dedab6f527fb18'],28,28,56,193488,6,,,,879
7a44135725ad69ead8896c0d7bd7f2f1f059c112,0,Grant Ingersoll,2009-11-10 20:37:37+00:00,['252a83d0991a8dbcb7490658ba450ed230077ba2'],12,13,25,193513,6,,,,879
4eb4e7593c1eb6deaa23cb5e8d762efbc98ad4a0,0,Grant Ingersoll,2009-11-10 21:13:23+00:00,['7a44135725ad69ead8896c0d7bd7f2f1f059c112'],1,134,135,193648,2,,,,879
32d1134d09b73a573518d00af1a55a18db864722,0,Grant Ingersoll,2009-11-10 21:23:29+00:00,['4eb4e7593c1eb6deaa23cb5e8d762efbc98ad4a0'],30,29,59,193707,6,,,,879
9d2b6511351e6e7c2b94703269a0638d03905ab6,0,Grant Ingersoll,2009-11-10 21:30:46+00:00,['32d1134d09b73a573518d00af1a55a18db864722'],29,30,59,193766,6,,,,879
76eac2cddcfbdea532f63abd4898156e0246a164,0,Grant Ingersoll,2009-11-10 21:44:00+00:00,['9d2b6511351e6e7c2b94703269a0638d03905ab6'],30,29,59,193825,6,,,,879
01ee1f8bb59e9e2e910b3eea3107814f7f07384d,0,Grant Ingersoll,2009-11-10 21:44:36+00:00,['76eac2cddcfbdea532f63abd4898156e0246a164'],28,28,56,193881,6,,,,879
4928fe3b0c94e331712ab9a19ccb0d9389481820,0,Grant Ingersoll,2009-11-11 03:05:18+00:00,['01ee1f8bb59e9e2e910b3eea3107814f7f07384d'],12,13,25,193906,6,,,,879
1b8aaccf3338124f07b8644dc8e4fbdf261e8da2,0,Grant Ingersoll,2009-11-11 03:07:20+00:00,['4928fe3b0c94e331712ab9a19ccb0d9389481820'],6,23,29,193935,2,,,,879
9e9bcdc13fbff9b821f199f24d4f8050e0e2bde8,0,Grant Ingersoll,2009-11-11 03:17:48+00:00,['1b8aaccf3338124f07b8644dc8e4fbdf261e8da2'],36,34,70,194005,6,,,,879
29830dea0f477f50390563d4480dac517323c2ba,0,Grant Ingersoll,2009-11-11 03:18:29+00:00,['9e9bcdc13fbff9b821f199f24d4f8050e0e2bde8'],28,28,56,194061,6,,,,879
7e632b7aad89e40ea1c007e40baac094560d7d04,0,Grant Ingersoll,2009-11-11 12:50:21+00:00,['29830dea0f477f50390563d4480dac517323c2ba'],17,19,36,194097,6,,,,879
3db0fde074e290415873abeed4445c60b24a6acd,0,Grant Ingersoll,2009-11-11 12:51:45+00:00,['7e632b7aad89e40ea1c007e40baac094560d7d04'],12,15,27,194124,1,,,,879
b68ed1a23061177dd3bcbcf871ec71aef0829616,0,Grant Ingersoll,2009-11-11 13:01:16+00:00,['3db0fde074e290415873abeed4445c60b24a6acd'],36,34,70,194194,6,,,,879
f5dbb8525d5d7e6012b6dea9662c5bfe649f539d,0,Grant Ingersoll,2009-11-11 13:07:24+00:00,['b68ed1a23061177dd3bcbcf871ec71aef0829616'],34,36,70,194264,6,,,,879
07f6b703fe11088e57de3f43a0203dd3327097ca,0,Grant Ingersoll,2009-11-11 13:18:06+00:00,['f5dbb8525d5d7e6012b6dea9662c5bfe649f539d'],36,34,70,194334,6,,,,879
5934fc00ebef4f475d7b58d6153703cff7d4cbe7,0,Grant Ingersoll,2009-11-11 13:18:20+00:00,['07f6b703fe11088e57de3f43a0203dd3327097ca'],28,28,56,194390,6,,,,879
9b4c1693d9ecfd00a59d83a8952dd5ce04959396,0,Grant Ingersoll,2009-11-11 14:00:01+00:00,['5934fc00ebef4f475d7b58d6153703cff7d4cbe7'],17,19,36,194426,6,,,,879
1a7841f59ba0a37212a134c6b2f3274dcbc6c454,0,Grant Ingersoll,2009-11-11 14:03:49+00:00,['9b4c1693d9ecfd00a59d83a8952dd5ce04959396'],196,16,212,194638,2,,,,879
fccd9b79234d1042eab21dca76c90ef731c46a86,0,Grant Ingersoll,2009-11-11 14:13:52+00:00,['1a7841f59ba0a37212a134c6b2f3274dcbc6c454'],36,34,70,194708,6,,,,879
dafcde0f4ff3b5feffc9ed41019b3a34895af6ee,0,Grant Ingersoll,2009-11-11 14:14:05+00:00,['fccd9b79234d1042eab21dca76c90ef731c46a86'],28,28,56,194764,6,,,,879
10535a2cffa99d956cca1a9be5d29b5ddd96fefd,0,Grant Ingersoll,2009-11-11 15:38:03+00:00,['dafcde0f4ff3b5feffc9ed41019b3a34895af6ee'],17,19,36,194800,6,,,,879
4cbe27e143b15104261d7f98c8380ca5a0b695e8,0,Grant Ingersoll,2009-11-11 15:38:33+00:00,['10535a2cffa99d956cca1a9be5d29b5ddd96fefd'],7,7,14,194814,1,,,,879
1a676633f7331818cbc748ac16a4415a1a815ee4,0,Grant Ingersoll,2009-11-11 16:07:26+00:00,['4cbe27e143b15104261d7f98c8380ca5a0b695e8'],36,34,70,194884,6,,,,879
645ebf318a461256183ed68daea0a0745f8fd1c3,0,Grant Ingersoll,2009-11-11 16:07:44+00:00,['1a676633f7331818cbc748ac16a4415a1a815ee4'],28,28,56,194940,6,,,,879
acb473baaacf11fd22d0b4ca346d3cc138ab0269,0,Grant Ingersoll,2009-11-11 17:44:34+00:00,['645ebf318a461256183ed68daea0a0745f8fd1c3'],17,19,36,194976,6,,,,879
8f6fa7291a1ea74926c36b199e051da176c9b180,0,Grant Ingersoll,2009-11-11 17:47:13+00:00,['acb473baaacf11fd22d0b4ca346d3cc138ab0269'],7,7,14,194990,1,,,,879
160068d2f6e7308c956c02f804ca52a0a1af7575,0,Grant Ingersoll,2009-11-11 17:57:05+00:00,['8f6fa7291a1ea74926c36b199e051da176c9b180'],36,34,70,195060,6,,,,879
6faea8b79042ef00327445a62327af1a367fb356,0,Grant Ingersoll,2009-11-11 17:57:18+00:00,['160068d2f6e7308c956c02f804ca52a0a1af7575'],28,28,56,195116,6,,,,879
a5f9b42aeaaa022a59a3405e7362f21101deb74b,0,Grant Ingersoll,2009-11-11 23:16:08+00:00,['6faea8b79042ef00327445a62327af1a367fb356'],17,19,36,195152,6,,,,879
df651b191283d1e171b3359a0ae86078e1eec23f,1,Grant Ingersoll,2009-11-11 23:22:43+00:00,['a5f9b42aeaaa022a59a3405e7362f21101deb74b'],1879,24,1903,197055,35,,,,879
ff7ab7ce3d274f200e8cc664ebf9b0b2e8c59b77,0,Grant Ingersoll,2009-11-12 03:14:58+00:00,['df651b191283d1e171b3359a0ae86078e1eec23f'],1062,1,1063,198118,10,,,,879
edf852edb6e025c98268a147f324cd7c06ec5f94,0,Grant Ingersoll,2009-11-12 04:04:21+00:00,['ff7ab7ce3d274f200e8cc664ebf9b0b2e8c59b77'],34,32,66,198184,6,,,,879
6be329fae9a57d23f64a74dde6e9f4ff99be8c9a,0,Grant Ingersoll,2009-11-12 04:04:44+00:00,['edf852edb6e025c98268a147f324cd7c06ec5f94'],28,28,56,198240,6,,,,879
a1ef3043709a8ab2d919de7656465fdcec1c84b3,0,Grant Ingersoll,2009-11-12 14:05:52+00:00,['6be329fae9a57d23f64a74dde6e9f4ff99be8c9a'],15,17,32,198272,6,,,,879
11082155ed7f2967e11c43b38369fdf698eeb9a8,0,Grant Ingersoll,2009-11-12 14:32:30+00:00,['a1ef3043709a8ab2d919de7656465fdcec1c84b3'],0,17,17,198289,1,,,,879
561d4e9470dab6b732f35c8063c7514328a7d490,0,Grant Ingersoll,2009-11-12 19:17:07+00:00,['11082155ed7f2967e11c43b38369fdf698eeb9a8'],34,32,66,198355,6,,,,879
244a2cf65e54dcf7da4b640e05ac9b06feeedeac,1,Grant Ingersoll,2009-11-12 19:17:20+00:00,['561d4e9470dab6b732f35c8063c7514328a7d490'],28,28,56,198411,6,,,,879
0f8c789d7ba8340101eb874c60e45234565b66a7,0,Sean R. Owen,2009-11-12 20:13:56+00:00,['244a2cf65e54dcf7da4b640e05ac9b06feeedeac'],1,1,2,198413,1,,,,879
6df2469ecf22eba781b1deb7951b6df80962a61d,1,Sean R. Owen,2009-11-16 11:21:01+00:00,['0f8c789d7ba8340101eb874c60e45234565b66a7'],7,208,215,198628,13,,,,879
10c5652a498ed5f98b8e01036159cbc57373c95b,0,Sean R. Owen,2009-11-17 12:46:18+00:00,['6df2469ecf22eba781b1deb7951b6df80962a61d'],38,66,104,198732,2,0.95,1,1,879
e24c20fca7a7e1683c384c52d6d1e4bae21e0266,0,Sean R. Owen,2009-11-18 12:15:21+00:00,['10c5652a498ed5f98b8e01036159cbc57373c95b'],145,0,145,198877,1,,,,879
7d5c17f7e91b2df7112369d69827ae1327ea7278,1,Sean R. Owen,2009-11-22 06:51:11+00:00,['e24c20fca7a7e1683c384c52d6d1e4bae21e0266'],63,132,195,199072,28,1,1,1,880
b119249f379db1045cfaf738ac920d319851e4bc,1,Grant Ingersoll,2009-11-22 16:13:10+00:00,['7d5c17f7e91b2df7112369d69827ae1327ea7278'],9,150,159,199231,5,0.707692308,1,1,881
e4cbc9ad12450f293d9fc48d587b5f90baff49a3,0,Sean R. Owen,2009-11-22 17:56:38+00:00,['b119249f379db1045cfaf738ac920d319851e4bc'],0,117,117,199348,1,0.5625,1,0.833333333,882
5a2b3aef94fac986134da5bb01fa7a30e8ec2341,1,Sean R. Owen,2009-11-22 18:01:53+00:00,['e4cbc9ad12450f293d9fc48d587b5f90baff49a3'],76,51,127,199475,26,0.666666667,0,0,882
4ce88a0181451d3c6ed5558032edf124e66f38e7,0,Sean R. Owen,2009-11-23 12:20:39+00:00,['5a2b3aef94fac986134da5bb01fa7a30e8ec2341'],1,16,17,199492,1,0,1,1,882
7550a10b3725cf97dcfb9206499e854473520510,1,Grant Ingersoll,2009-11-23 15:14:26+00:00,['4ce88a0181451d3c6ed5558032edf124e66f38e7'],0,84663,84663,284155,314,0.528650212,0.615239761,0.722240904,1193
bd5593f8d027fff0c8d0e4d879d35c9876dd649f,1,Grant Ingersoll,2009-11-23 15:39:36+00:00,['7550a10b3725cf97dcfb9206499e854473520510'],9,34,43,284198,39,,,,1193
f49424ede69e469aed8f9822e76c22142ef73852,1,Grant Ingersoll,2009-11-23 16:34:55+00:00,['bd5593f8d027fff0c8d0e4d879d35c9876dd649f'],1301,1391,2692,286890,227,0.407407407,1,1,1193
a857ed5cba52fc4430271297de41cf321966e2ea,0,Sean R. Owen,2009-11-25 01:15:56+00:00,['f49424ede69e469aed8f9822e76c22142ef73852'],22,33,55,286945,11,,,,1193
05078f9c7ccb401c7c265bce51c881584d95f379,0,Sean R. Owen,2009-11-25 01:41:50+00:00,['a857ed5cba52fc4430271297de41cf321966e2ea'],2,10,12,286957,1,0,1,1,1193
7a9ecf45a7ea742cab56c2bd87f29e096fb8bb9f,0,Sean R. Owen,2009-11-25 03:31:47+00:00,['05078f9c7ccb401c7c265bce51c881584d95f379'],8682,8594,17276,304233,66,,,,1193
fcbc54a719bdc7446d0150bbc69383e7aca25d52,0,Sean R. Owen,2009-11-25 03:35:59+00:00,['7a9ecf45a7ea742cab56c2bd87f29e096fb8bb9f'],10716,10650,21366,325599,79,,,,1193
eb2e0a8d196e9cb40719b32d8c0cfb1fa607c935,0,Sean R. Owen,2009-11-25 03:41:28+00:00,['fcbc54a719bdc7446d0150bbc69383e7aca25d52'],14870,14844,29714,355313,86,,,,1193
a597bcae1aeee70090f7b163e4f926f19342e17b,0,Sean R. Owen,2009-11-25 12:53:33+00:00,['eb2e0a8d196e9cb40719b32d8c0cfb1fa607c935'],29,0,29,355342,2,,,,1193
7926fcb8893243e21c4e5add781d953a18454e23,1,Sean R. Owen,2009-11-25 15:26:52+00:00,['a597bcae1aeee70090f7b163e4f926f19342e17b'],66992,72138,139130,494472,285,0.086775294,0.493558166,0.621068587,1193
e50fbd587f11650518aa304f595b20e410e8cb5a,1,Sean R. Owen,2009-11-26 20:09:51+00:00,['7926fcb8893243e21c4e5add781d953a18454e23'],1895,130,2025,496497,48,0.457300275,0.247933884,0.130853994,1193
a90e57e6faa40a74edacf8ab078174e8641c06b9,1,Sean R. Owen,2009-11-26 20:14:06+00:00,['e50fbd587f11650518aa304f595b20e410e8cb5a'],495,152,647,497144,31,0.938461538,0.430769231,0.235897436,1193
eba097da79dfc33502becdbd84a8070666ae0bd4,1,Sean R. Owen,2009-11-26 20:21:47+00:00,['a90e57e6faa40a74edacf8ab078174e8641c06b9'],8216,160,8376,505520,76,0.748903509,0.270285088,0.338815789,1193
496ccd066f5e8fe5e41acc0a658ece18d0089bd9,0,Sean R. Owen,2009-11-26 23:06:24+00:00,['eba097da79dfc33502becdbd84a8070666ae0bd4'],1,1,2,505522,1,,,,1193
2f0cdab7cedc393342998f67d02ba20be33e43a4,1,Sean R. Owen,2009-11-28 07:51:16+00:00,['496ccd066f5e8fe5e41acc0a658ece18d0089bd9'],67,65,132,505654,19,1,0,1,1193
7627de6a15c3e7bd9b674dca521e6d99ac6392ed,1,Sean R. Owen,2009-11-29 11:19:58+00:00,['2f0cdab7cedc393342998f67d02ba20be33e43a4'],3671,1386,5057,510711,178,0.715662651,0.210441767,0.115662651,1193
86b25164d41a708e6bd852172e19f46ef762861b,0,Sean R. Owen,2009-11-30 11:13:58+00:00,['7627de6a15c3e7bd9b674dca521e6d99ac6392ed'],13,1,14,510725,2,0,0,0,1193
a28cf138b3c6ff0f4ad5bd4d2f363f3b67241d8b,1,Sean R. Owen,2009-12-01 15:02:25+00:00,['86b25164d41a708e6bd852172e19f46ef762861b'],108,152,260,510985,10,0,1,0,1193
638c387fad9091c5f754a207eeda937326a3586c,0,Sean R. Owen,2009-12-02 12:01:49+00:00,['a28cf138b3c6ff0f4ad5bd4d2f363f3b67241d8b'],70,49,119,511104,7,0,1,0.666666667,1193
0b59227b2034892e65e208ae223feef365cf27d3,1,Sean R. Owen,2009-12-03 12:54:00+00:00,['638c387fad9091c5f754a207eeda937326a3586c'],16,345,361,511465,5,0.187214612,0.561643836,0.639269406,1194
bccccbcbee9a924187b8305270257bac4a1e04e9,1,Sean R. Owen,2009-12-04 15:59:18+00:00,['0b59227b2034892e65e208ae223feef365cf27d3'],191,398,589,512054,16,0.571428571,1,0,1199
db6d401455f769fccc6d83b188206151ffa0f465,0,Sean R. Owen,2009-12-04 19:15:31+00:00,['bccccbcbee9a924187b8305270257bac4a1e04e9'],252,221,473,512527,5,1,0,1,1200
c9fe2f958a8d905fc39931944d80b3b48bcff6b7,0,Sean R. Owen,2009-12-05 09:25:05+00:00,['db6d401455f769fccc6d83b188206151ffa0f465'],5,63,68,512595,3,0,1,1,1200
56c4f4cde61be04df5e4b978e3b4ff3d2391fed1,0,Sean R. Owen,2009-12-05 09:29:24+00:00,['c9fe2f958a8d905fc39931944d80b3b48bcff6b7'],0,58,58,512653,1,1,1,1,1201
f80b6ccfe48b6b25122cb42637adf48e987acbd0,0,Sean R. Owen,2009-12-05 09:39:07+00:00,['56c4f4cde61be04df5e4b978e3b4ff3d2391fed1'],0,10,10,512663,1,0,0,1,1201
c076e7bf93da590a04be560f4af4293cb4522a21,0,Sean R. Owen,2009-12-05 11:48:52+00:00,['f80b6ccfe48b6b25122cb42637adf48e987acbd0'],16,22,38,512701,5,0,1,1,1201
757f2a75886aadfa351fb5b0981752c0c40f9ebd,1,Sean R. Owen,2009-12-06 13:05:18+00:00,['c076e7bf93da590a04be560f4af4293cb4522a21'],39,211,250,512951,10,0.410958904,1,0.589041096,1203
0302c0602914b4c10232d7d9c4b0e782b0a0f330,0,Sean R. Owen,2009-12-06 17:02:08+00:00,['757f2a75886aadfa351fb5b0981752c0c40f9ebd'],90,80,170,513121,19,0.25,0,0,1203
29d428a442ed968320f6fb4bac85e7ec7eb85778,0,Sean R. Owen,2009-12-06 18:06:46+00:00,['0302c0602914b4c10232d7d9c4b0e782b0a0f330'],44,40,84,513205,8,1,0,1,1203
b80c48bf44f08e3cb2b841c930a29cd9fa46e4e2,0,Sean R. Owen,2009-12-06 20:00:21+00:00,['29d428a442ed968320f6fb4bac85e7ec7eb85778'],34,44,78,513283,3,0,1,0.5,1203
4a888f0ffca6e97571f36ab423099f074a3bd86f,0,David Leo Wright Hall,2009-12-07 06:03:40+00:00,['b80c48bf44f08e3cb2b841c930a29cd9fa46e4e2'],3,3,6,513289,1,0,1,0,1203
cb030aa49c7bd866727ff471615f7a697fa1065f,0,Sean R. Owen,2009-12-07 07:34:06+00:00,['4a888f0ffca6e97571f36ab423099f074a3bd86f'],4,17,21,513310,3,0.555555556,1,1,1203
0f07461185a608a9121a385346c46f0133d1f96a,1,Sean R. Owen,2009-12-07 20:24:07+00:00,['cb030aa49c7bd866727ff471615f7a697fa1065f'],47,137,184,513494,8,0.666666667,0.404761905,0.571428571,1204
c054f041527a82d35958c118fc8487fc40a78032,0,Sean R. Owen,2009-12-07 20:47:29+00:00,['0f07461185a608a9121a385346c46f0133d1f96a'],0,9,9,513503,3,0,1,1,1204
a240c224a1f54f8319bd1449d2b257929930fed4,0,Sean R. Owen,2009-12-08 12:20:09+00:00,['c054f041527a82d35958c118fc8487fc40a78032'],8,34,42,513545,4,0,0,0,1204
26bca69231fa8be2b3e4dc4d1bd1e085196ad7a3,0,Sean R. Owen,2009-12-09 18:48:08+00:00,['a240c224a1f54f8319bd1449d2b257929930fed4'],7,1,8,513553,2,0,0,0,1204
a73bdd42ab31a989e041f0ffe057b8bd3cfacacf,1,Isabel Drost,2009-12-10 09:34:48+00:00,['26bca69231fa8be2b3e4dc4d1bd1e085196ad7a3'],903,550,1453,515006,34,0.241610738,0,0.771812081,1204
d1801d2a4585ed7e8c4a41d172b3543d5bf081a8,1,Isabel Drost,2009-12-10 11:01:28+00:00,['a73bdd42ab31a989e041f0ffe057b8bd3cfacacf'],0,828,828,515834,11,0.457142857,0.885714286,0.631428571,1215
5a58194a49120e6c39bd7a8a762102eeeda68a86,0,Sean R. Owen,2009-12-10 19:03:20+00:00,['d1801d2a4585ed7e8c4a41d172b3543d5bf081a8'],17,541,558,516392,20,0.753488372,1,1,1223
3db2d4cda8c6047539fa1aceea145b15d69d6446,1,Sean R. Owen,2009-12-11 12:48:40+00:00,['5a58194a49120e6c39bd7a8a762102eeeda68a86'],0,6,6,516398,2,1,1,1,1223
c1887540c284479da56777c5e5449f533306aa71,1,Sean R. Owen,2009-12-11 19:04:23+00:00,['3db2d4cda8c6047539fa1aceea145b15d69d6446'],112,212,324,516722,9,0.818181818,0.954545455,0.409090909,1224
d224470bba06177cc4839cab1fc7a7ccabdea7f2,0,Sean R. Owen,2009-12-11 19:13:19+00:00,['c1887540c284479da56777c5e5449f533306aa71'],1,1,2,516724,1,,,,1224
9167d2dd14f694e8bec6c2a11f774a4d74517d4c,0,Sean R. Owen,2009-12-11 19:14:19+00:00,['d224470bba06177cc4839cab1fc7a7ccabdea7f2'],12,2,14,516738,1,0.571428571,0,0,1224
5ce2e7d052931ef99affd50af7bd2bd6108f92e7,1,Sean R. Owen,2009-12-11 19:22:16+00:00,['9167d2dd14f694e8bec6c2a11f774a4d74517d4c'],0,97,97,516835,1,1,1,1,1225
2ea6173a34ed75afddb655cfc04fa97ec4a52cdb,0,Sean R. Owen,2009-12-11 20:38:08+00:00,['5ce2e7d052931ef99affd50af7bd2bd6108f92e7'],1,1,2,516837,1,,,,1225
9a7e7927fda2bcf0a9176a2a9333e5baa4c93d40,0,Sean R. Owen,2009-12-11 21:26:03+00:00,['2ea6173a34ed75afddb655cfc04fa97ec4a52cdb'],1,1,2,516839,1,,,,1225
baa0d69142727c3d778f4f800901b17095ab9b5d,0,Sean R. Owen,2009-12-12 11:32:44+00:00,['9a7e7927fda2bcf0a9176a2a9333e5baa4c93d40'],2,2,4,516843,1,,,,1225
a502b40a1d1fcdf0a702439bc16079891fa73568,0,Sean R. Owen,2009-12-12 22:48:57+00:00,['baa0d69142727c3d778f4f800901b17095ab9b5d'],2,5,7,516850,1,1,1,1,1225
b349fe9539e99038fad395c282b60b9d6af86e35,1,Sean R. Owen,2009-12-12 22:50:02+00:00,['a502b40a1d1fcdf0a702439bc16079891fa73568'],10,60,70,516920,3,0.138888889,0,0.5,1225
885812f604ea95399efe5f595b6958c116f2455f,0,Sean R. Owen,2009-12-13 09:52:59+00:00,['b349fe9539e99038fad395c282b60b9d6af86e35'],5,1,6,516926,1,0,0,0,1225
7b04b10076761beceb95dd7e51e2a73079fe5aa0,0,Sean R. Owen,2009-12-13 10:01:46+00:00,['885812f604ea95399efe5f595b6958c116f2455f'],32,81,113,517039,5,0.189189189,0.918918919,0.378378378,1225
c40fd0785ee56f231436610eed56c9913738b4e5,0,Sean R. Owen,2009-12-13 11:00:45+00:00,['7b04b10076761beceb95dd7e51e2a73079fe5aa0'],107,150,257,517296,43,1,1,0,1225
5a0ee2da1b697bcdf69d8df7782b846cceba947a,1,Sean R. Owen,2009-12-13 11:05:10+00:00,['c40fd0785ee56f231436610eed56c9913738b4e5'],3,29,32,517328,3,0,0,0.833333333,1225
13f56eacac037a5ec679211d9715ad4d51532b0a,0,Sean R. Owen,2009-12-13 11:20:02+00:00,['5a0ee2da1b697bcdf69d8df7782b846cceba947a'],3,7,10,517338,2,0.25,1,0.75,1225
fad1e48c8bffa45f2877aa4727b461c546c95991,0,Sean R. Owen,2009-12-13 19:11:57+00:00,['13f56eacac037a5ec679211d9715ad4d51532b0a'],1,1,2,517340,1,,,,1225
2563b6ee1742674a54344f6a9610e88be15121c9,1,Abdel Hakim Deneche,2009-12-13 19:52:27+00:00,['fad1e48c8bffa45f2877aa4727b461c546c95991'],7,648,655,517995,6,0.33447099,0.829351536,0.784982935,1228
7404f7085219149fa84ece099764b73680a8d97d,0,Abdel Hakim Deneche,2009-12-13 20:10:12+00:00,['2563b6ee1742674a54344f6a9610e88be15121c9'],0,5,5,518000,1,0,0,1,1228
7369cd51b31a9601c434af773ebab458e0b3463d,0,Sean R. Owen,2009-12-15 10:36:20+00:00,['7404f7085219149fa84ece099764b73680a8d97d'],27,51,78,518078,5,0,0,0,1229
aecf48587ee77971a9651220a665f9e8a81f8eb0,0,Sean R. Owen,2009-12-15 11:24:06+00:00,['7369cd51b31a9601c434af773ebab458e0b3463d'],1,1,2,518080,1,,,,1229
2bc819ef3974ed538774b506ad974ab869a36d22,0,Sean R. Owen,2009-12-15 17:39:18+00:00,['aecf48587ee77971a9651220a665f9e8a81f8eb0'],277,349,626,518706,44,0,0.45,0.65,1229
97033e3b1964ad1da319f72fe8874333dc487245,0,Isabel Drost,2009-12-17 11:19:48+00:00,['2bc819ef3974ed538774b506ad974ab869a36d22'],105,260,365,519071,7,,,,1232
3955f7b2c44b15b335ca41ad57045e4457ae641c,0,Isabel Drost,2009-12-17 11:39:12+00:00,['97033e3b1964ad1da319f72fe8874333dc487245'],2,0,2,519073,2,,,,1232
3957076bec1e80b22750a79c3de15012bea69bc9,0,Isabel Drost,2009-12-17 14:30:19+00:00,['3955f7b2c44b15b335ca41ad57045e4457ae641c'],2,2,4,519077,1,,,,1232
8ea0c13a5cc6aae0465606db7308d6620a30249c,0,Isabel Drost,2009-12-17 14:51:45+00:00,['3957076bec1e80b22750a79c3de15012bea69bc9'],2,2,4,519081,1,,,,1232
89653f9f373aae95cf04c32b4ba343bfacce5c2c,0,Isabel Drost,2009-12-17 14:56:38+00:00,['8ea0c13a5cc6aae0465606db7308d6620a30249c'],2,2,4,519085,1,,,,1232
a435efb1a63b8530bdf120ba9965f33fda9db92f,1,Grant Ingersoll,2009-12-17 23:22:16+00:00,['89653f9f373aae95cf04c32b4ba343bfacce5c2c'],4452,2281,6733,525818,426,,,,1234
7360fad39479220dcb1618321fa6aac34885740b,1,Jacob Alexander Mannix,2009-12-20 22:55:31+00:00,['a435efb1a63b8530bdf120ba9965f33fda9db92f'],0,156,156,525974,1,,,,1234
8f767d8514a57b50eee8966b4c610ca8afdea711,0,Abdel Hakim Deneche,2009-12-22 09:08:44+00:00,['7360fad39479220dcb1618321fa6aac34885740b'],7,6,13,525987,1,1,0,1,1234
07515446dd3ef8fe5f98e4fe3e5a430c4c5bfb23,0,Sean R. Owen,2009-12-22 13:32:26+00:00,['8f767d8514a57b50eee8966b4c610ca8afdea711'],147,0,147,526134,15,0,0,0,1234
fdd8ca2a2afc84395abaaaeeea16515b58e52f5c,1,Sean R. Owen,2009-12-22 14:56:19+00:00,['07515446dd3ef8fe5f98e4fe3e5a430c4c5bfb23'],111,263,374,526508,6,0.166666667,0.166666667,1,1236
e73641946409e00a6680fb079b3a70904647e0e1,0,Sean R. Owen,2009-12-22 17:13:36+00:00,['fdd8ca2a2afc84395abaaaeeea16515b58e52f5c'],8,27,35,526543,2,,,,1236
10c79a3d1ba65f6b99a330e36c110bbf2f2f1b98,0,Sean R. Owen,2009-12-22 21:05:06+00:00,['e73641946409e00a6680fb079b3a70904647e0e1'],10,100,110,526653,4,,,,1236
c86ef1458a615f5598ee6807f545fca92f9c1deb,0,Sean R. Owen,2009-12-23 11:41:51+00:00,['10c79a3d1ba65f6b99a330e36c110bbf2f2f1b98'],5,4,9,526662,1,,,,1236
49bb59b3654d4e4803f966bd162d20f0f5d720ff,0,Sean R. Owen,2009-12-23 12:05:30+00:00,['c86ef1458a615f5598ee6807f545fca92f9c1deb'],0,1,1,526663,1,,,,1236
c00a70c1f63ee46c9680bd9253096f241dc2a6f5,0,Sean R. Owen,2009-12-23 19:51:09+00:00,['49bb59b3654d4e4803f966bd162d20f0f5d720ff'],0,1133,1133,527796,6,0.486486486,0.95777027,0.474662162,1242
c2976b2b77cc7aaa7a32ecd182598bbdb1ee231c,0,Sean R. Owen,2009-12-24 11:58:35+00:00,['c00a70c1f63ee46c9680bd9253096f241dc2a6f5'],0,119,119,527915,2,,,,1244
f3c16c2dca2431ec1ef5fc99808241501f11c801,0,Robin Anil,2009-12-26 22:56:22+00:00,['c2976b2b77cc7aaa7a32ecd182598bbdb1ee231c'],1,1,2,527917,1,,,,1244
a51dd9e2e16a6286aa894a9f5be23f5c046b60e3,1,Robin Anil,2009-12-28 21:30:05+00:00,['f3c16c2dca2431ec1ef5fc99808241501f11c801'],12377,1846,14223,542140,61,0.298958333,0.265885417,0.300520833,1248
b5b5d40367d6236e415058bcc6f4dc53003541b0,0,Grant Ingersoll,2009-12-29 13:54:43+00:00,['a51dd9e2e16a6286aa894a9f5be23f5c046b60e3'],2084,2051,4135,546275,1,0,0.164222874,0.205278592,1248
73e17cfc4e178c81e47b689426aaa87aebac2985,1,Grant Ingersoll,2009-12-30 17:27:11+00:00,['b5b5d40367d6236e415058bcc6f4dc53003541b0'],78,579,657,546932,2,0.32885906,0.389261745,0.855704698,1249
2d857d59170a947427e7c353c8e57dff5492b927,1,Grant Ingersoll,2009-12-31 15:46:04+00:00,['73e17cfc4e178c81e47b689426aaa87aebac2985'],3,6,9,546941,1,0,0,1,1249
f4596a6a9a6ec9839b99c747d00e16c26ef814bd,0,Grant Ingersoll,2009-12-31 15:54:47+00:00,['2d857d59170a947427e7c353c8e57dff5492b927'],1,3,4,546945,1,,,,1249
ae92fd670708da5dfab8068e4c766c4dba668cf3,0,Grant Ingersoll,2009-12-31 16:39:50+00:00,['f4596a6a9a6ec9839b99c747d00e16c26ef814bd'],2,3,5,546950,1,0,0,1,1249
f9d039d562a49d766b899fa989ffa27ec4057691,0,Sean R. Owen,2010-01-02 15:49:09+00:00,['ae92fd670708da5dfab8068e4c766c4dba668cf3'],1,0,1,546951,1,,,,1249
85d756f00159d92e570a3412fc0e195377998683,0,Grant Ingersoll,2010-01-02 22:01:21+00:00,['f9d039d562a49d766b899fa989ffa27ec4057691'],1,3,4,546955,1,0,1,0,1249
d106e8479867fef1d315e66c7e63fdc1ecbc2be0,0,Grant Ingersoll,2010-01-02 22:45:49+00:00,['85d756f00159d92e570a3412fc0e195377998683'],37,124,161,547116,2,0.222222222,0.814814815,1,1250
4931ade7dc8ce32f02d33a876a8737175dcd1b92,0,Grant Ingersoll,2010-01-02 22:59:40+00:00,['d106e8479867fef1d315e66c7e63fdc1ecbc2be0'],4,18,22,547138,1,0,0,1,1250
bc440feeeef9ffe7e85ef432981db1f2e8e1fedf,0,Sean R. Owen,2010-01-03 16:10:08+00:00,['4931ade7dc8ce32f02d33a876a8737175dcd1b92'],2,3,5,547143,1,1,1,1,1250
f17cc37c0a07a873811424a47f84c95e2555a5ed,0,Grant Ingersoll,2010-01-03 17:13:04+00:00,['bc440feeeef9ffe7e85ef432981db1f2e8e1fedf'],2,3,5,547148,1,0,1,1,1250
c21e773c0c8c3b6aa46415fb8a7bcbef6c4885f3,1,Grant Ingersoll,2010-01-05 14:12:09+00:00,['f17cc37c0a07a873811424a47f84c95e2555a5ed'],25,139,164,547312,3,1,1,1,1252
cebf8bfe53fddd78e80ae24b38e468a16f576c2a,1,Sean R. Owen,2010-01-05 19:46:26+00:00,['c21e773c0c8c3b6aa46415fb8a7bcbef6c4885f3'],1171,477,1648,548960,15,0.553191489,0.103723404,0.055851064,1253
2f85f29f82b9b44509ff76de96321ace572dbb7c,1,Robin Anil,2010-01-06 02:46:22+00:00,['cebf8bfe53fddd78e80ae24b38e468a16f576c2a'],1894,2248,4142,553102,55,0,0.619047619,0.446428571,1253
b35b030a3d817675e6c5d0d445608b51ec8072c2,1,Robin Anil,2010-01-07 16:45:37+00:00,['2f85f29f82b9b44509ff76de96321ace572dbb7c'],713,2050,2763,555865,34,0.371385084,0.811263318,0.891933029,1265
b597523c39fdc4844f7623c1b2a7ea086179e7e2,1,Sean R. Owen,2010-01-07 18:02:41+00:00,['b35b030a3d817675e6c5d0d445608b51ec8072c2'],84,37,121,555986,5,,,,1265
65ea79f03dc80e2c55906e1544118b4ec1c3d1a5,1,Robin Anil,2010-01-08 08:23:22+00:00,['b597523c39fdc4844f7623c1b2a7ea086179e7e2'],0,133,133,556119,2,0.296875,0.546875,0.546875,1267
d63012f869c355b014b4fd9bb0866621e89b3baf,1,Abdel Hakim Deneche,2010-01-09 10:02:49+00:00,['65ea79f03dc80e2c55906e1544118b4ec1c3d1a5'],12,61,73,556192,4,1,0.235294118,0.235294118,1267
2308cccf783b15fe2a0f9eca94f43e3cb0e271ea,1,Sean R. Owen,2010-01-09 12:53:25+00:00,['d63012f869c355b014b4fd9bb0866621e89b3baf'],101,95,196,556388,27,1,0,0.076923077,1267
cfe7f01fbccc1e6aee4ccdc5ae2b435f1a6efff9,1,Sean R. Owen,2010-01-10 08:21:30+00:00,['2308cccf783b15fe2a0f9eca94f43e3cb0e271ea'],13,24,37,556425,6,,,,1267
2b19ed54115a1d6184eab860e5af24712fd14a0d,0,Isabel Drost,2010-01-10 11:15:04+00:00,['cfe7f01fbccc1e6aee4ccdc5ae2b435f1a6efff9'],0,575,575,557000,9,0.583732057,0.866028708,0.736842105,1276
0a06799a12b30425e7c4df86cd0030785d78988c,0,Grant Ingersoll,2010-01-10 16:28:01+00:00,['2b19ed54115a1d6184eab860e5af24712fd14a0d'],25,25,50,557050,1,,,,1276
fb1f1c257f924be1fb4a444dc42b5c94c8f1ab9d,0,Grant Ingersoll,2010-01-10 16:33:33+00:00,['0a06799a12b30425e7c4df86cd0030785d78988c'],1,2,3,557053,1,0,0,1,1276
250ed3d84da6edebf2257d8020f1230a416ab66e,0,Grant Ingersoll,2010-01-10 17:48:13+00:00,['fb1f1c257f924be1fb4a444dc42b5c94c8f1ab9d'],50,50,100,557153,1,,,,1276
41f1c0445cdee15b437b94742c8dbdaa7b5ecdea,0,Isabel Drost,2010-01-10 18:15:39+00:00,['250ed3d84da6edebf2257d8020f1230a416ab66e'],23,0,23,557176,1,0,0,1,1276
166b331defd0203bbf63569918dc1b777dac6ac5,1,Sean R. Owen,2010-01-10 20:30:25+00:00,['41f1c0445cdee15b437b94742c8dbdaa7b5ecdea'],0,990,990,558166,2,,,,1278
0ac661821f43a4a08a684d8b4af773c2da0ee6d7,0,Robin Anil,2010-01-11 18:32:02+00:00,['166b331defd0203bbf63569918dc1b777dac6ac5'],1763,0,1763,559929,3,0.513613861,0.228960396,0.126237624,1278
48989a4e0740ef1a25c40e37b7716e0b505a9aea,1,Sean R. Owen,2010-01-13 01:11:59+00:00,['0ac661821f43a4a08a684d8b4af773c2da0ee6d7'],0,1586,1586,561515,10,0.218790219,0.885456885,0.594594595,1288
67fbb78b3ea4845b54050d9c5eac487b6df0bb8b,0,Robin Anil,2010-01-13 05:40:24+00:00,['48989a4e0740ef1a25c40e37b7716e0b505a9aea'],1,0,1,561516,1,1,1,1,1288
135a84023a208a1c9de9bcb79da6b5ae8c3381e8,1,Jacob Alexander Mannix,2010-01-13 08:01:34+00:00,['67fbb78b3ea4845b54050d9c5eac487b6df0bb8b'],912,707,1619,563135,78,0.319526627,0,0.035502959,1288
251a4768a8f7b4480ece8f477ec4c0b8bfe4fcbe,0,Jacob Alexander Mannix,2010-01-13 08:12:18+00:00,['135a84023a208a1c9de9bcb79da6b5ae8c3381e8'],68,0,68,563203,1,0.793103448,0,0,1288
eeaafa6217c9d763b7cc2bbd578aa040f7ed432a,1,Jacob Alexander Mannix,2010-01-13 08:13:10+00:00,['251a4768a8f7b4480ece8f477ec4c0b8bfe4fcbe'],0,477,477,563680,7,0.493055556,1,0.864583333,1295
a9cf7d817aa327399ecd3f08d6174248c3807bf5,1,Benson Margulies,2010-01-14 00:12:34+00:00,['eeaafa6217c9d763b7cc2bbd578aa040f7ed432a'],1310,630,1940,565620,13,0.540948276,0.181034483,0.109913793,1296
66f844a404bea947abf27fbabe28643253fe8aad,1,Abdel Hakim Deneche,2010-01-14 10:56:25+00:00,['a9cf7d817aa327399ecd3f08d6174248c3807bf5'],38,138,176,565796,3,0,0,0.672727273,1296
6214879061a9dd71cf9ff6027c712edcb4c45874,1,Isabel Drost,2010-01-14 10:58:40+00:00,['66f844a404bea947abf27fbabe28643253fe8aad'],2,30,32,565828,2,1,1,0.5,1296
b3f68574c107dffea09362cabc84e4432778f60d,1,Sean R. Owen,2010-01-14 17:54:30+00:00,['6214879061a9dd71cf9ff6027c712edcb4c45874'],680,1507,2187,568015,62,0.530973451,0.969026549,0.902654867,1300
7fd0c4110ee2f415041367bfde1bcf0fb5388412,0,Sean R. Owen,2010-01-14 17:55:37+00:00,['b3f68574c107dffea09362cabc84e4432778f60d'],2,13,15,568030,1,1,1,1,1300
b19e36aaac7648c3e1a932f4ad7330317301e5ae,0,Sean R. Owen,2010-01-15 00:39:32+00:00,['7fd0c4110ee2f415041367bfde1bcf0fb5388412'],2,14,16,568046,1,0,0,0,1300
c3b4adadcd40e11b037bf8670411147d1b9edbc1,1,Benson Margulies,2010-01-15 12:30:58+00:00,['b19e36aaac7648c3e1a932f4ad7330317301e5ae'],2,1535,1537,569583,5,,,,1304
6adea873190067b9c3fae521fc2b68a2316ced97,1,Benson Margulies,2010-01-16 13:32:45+00:00,['c3b4adadcd40e11b037bf8670411147d1b9edbc1'],0,49,49,569632,1,,,,1305
824dc51f90da44ce6d71cab7e4012d351bbf562a,0,Benson Margulies,2010-01-16 17:30:05+00:00,['6adea873190067b9c3fae521fc2b68a2316ced97'],49,0,49,569681,1,,,,1305
7ea6efce2294c55869d4b0441158cb5c35a855c1,1,Benson Margulies,2010-01-16 17:51:18+00:00,['824dc51f90da44ce6d71cab7e4012d351bbf562a'],35,658,693,570374,10,,,,1307
44127950c4c50cd2e73050856373bb33f66b4b17,0,Robin Anil,2010-01-16 23:10:31+00:00,['7ea6efce2294c55869d4b0441158cb5c35a855c1'],128,202,330,570704,8,0,1,0.35,1308
0935b073a7d2d2c02dccbd621369ac2960f9c091,1,Benson Margulies,2010-01-17 12:47:32+00:00,['44127950c4c50cd2e73050856373bb33f66b4b17'],0,177,177,570881,1,,,,1309
434cdff2176906edf5d6bfd8c66980b423fa0c47,1,Sean R. Owen,2010-01-17 19:41:24+00:00,['0935b073a7d2d2c02dccbd621369ac2960f9c091'],543,356,899,571780,97,0.029126214,0,0,1310
d7351ccd19765f564a4155937024c83a99e3d23b,1,Benson Margulies,2010-01-18 00:13:13+00:00,['434cdff2176906edf5d6bfd8c66980b423fa0c47'],148,1836,1984,573764,8,0.449830891,0.878241263,0.931228861,1315
7a61938f2c90c0876f6d0075adf316b246c76424,0,Benson Margulies,2010-01-18 00:26:45+00:00,['d7351ccd19765f564a4155937024c83a99e3d23b'],304,240,544,574308,8,0,0,0,1315
6a253e35677ae3872fbf2064db5367016025fd48,0,Sean R. Owen,2010-01-18 01:26:12+00:00,['7a61938f2c90c0876f6d0075adf316b246c76424'],2,2,4,574312,1,,,,1315
d911fcefc434638513808e298fb7562705e21b2a,1,Sean R. Owen,2010-01-18 01:28:36+00:00,['6a253e35677ae3872fbf2064db5367016025fd48'],148,138,286,574598,43,0,0,0,1315
d673a78f9ac7423a5868f42f57bc827f6124737a,0,Sean R. Owen,2010-01-18 01:43:14+00:00,['d911fcefc434638513808e298fb7562705e21b2a'],6,0,6,574604,1,0,0,0,1315
20dd0a1bcc17d08089ef132114034345796b5925,0,Benson Margulies,2010-01-18 02:55:03+00:00,['d673a78f9ac7423a5868f42f57bc827f6124737a'],1029,479,1508,576112,19,0.403954802,0.361581921,0.107344633,1315
0308bb821691c00d8cbbf4dce01e489745463a41,1,Jeff Eastman,2010-01-18 03:17:10+00:00,['20dd0a1bcc17d08089ef132114034345796b5925'],666,504,1170,577282,18,1,0,0.788990826,1316
1d47c52246dce73f900bb91de3dacee23cb54712,0,Jeff Eastman,2010-01-18 03:19:13+00:00,['0308bb821691c00d8cbbf4dce01e489745463a41'],104,0,104,577386,2,0,0,0.59375,1316
4233591fad46d89f01068fddf77a013d538792b9,0,Sean R. Owen,2010-01-18 08:46:54+00:00,['1d47c52246dce73f900bb91de3dacee23cb54712'],1,1,2,577388,1,,,,1316
14a584464a1da38cb5e40e3be1106922b52e2052,0,Sean R. Owen,2010-01-18 09:47:05+00:00,['4233591fad46d89f01068fddf77a013d538792b9'],6,9,15,577403,4,0,0,1,1316
a7e552ae4a386dc6c6331a2b907ac6f1a1747e0a,0,Sean R. Owen,2010-01-18 11:02:47+00:00,['14a584464a1da38cb5e40e3be1106922b52e2052'],4,9,13,577416,1,0.5,1,1,1316
27632def50fc555e351c7c9d2efa3fcdf8c87337,0,Benson Margulies,2010-01-18 15:02:17+00:00,['a7e552ae4a386dc6c6331a2b907ac6f1a1747e0a'],7171,0,7171,584587,24,0.359618718,0.255632582,0.272963605,1316
a47e23ebbd96de785fd1397931ad231c291ae948,1,Benson Margulies,2010-01-18 15:36:59+00:00,['27632def50fc555e351c7c9d2efa3fcdf8c87337'],3,91,94,584681,6,,,,1316
435c42923b389bb434484c6d68c7951c98c323a6,1,Jeff Eastman,2010-01-18 19:23:25+00:00,['a47e23ebbd96de785fd1397931ad231c291ae948'],40,66,106,584787,13,0,1,1,1316
1b91a877acbd48141da6b1ec0f55039d0b9e7988,0,Jeff Eastman,2010-01-19 00:11:42+00:00,['435c42923b389bb434484c6d68c7951c98c323a6'],6,201,207,584994,3,0.474226804,0.649484536,0.845360825,1318
66174ac4f0ca1882d1c6ba2538ea32de859c25e8,0,Jeff Eastman,2010-01-20 17:03:02+00:00,['1b91a877acbd48141da6b1ec0f55039d0b9e7988'],148,260,408,585402,5,0,0.824561404,1,1320
93443ba1fb1718ddf5cd82751e14fd6732a3b896,0,Jeff Eastman,2010-01-20 17:37:37+00:00,['66174ac4f0ca1882d1c6ba2538ea32de859c25e8'],2,16,18,585420,1,,,,1320
2badc2d4df05a8f4409a23ab3e48f770ccab6941,0,Jeff Eastman,2010-01-21 01:26:49+00:00,['93443ba1fb1718ddf5cd82751e14fd6732a3b896'],38,104,142,585562,1,0.745454545,0.6,0.6,1320
ecb08e8dd4c79d51ea8a7fcf065ce2a5f978fd5a,0,Jacob Alexander Mannix,2010-01-21 06:55:03+00:00,['2badc2d4df05a8f4409a23ab3e48f770ccab6941'],20,1485,1505,587067,17,0.528571429,0.617460317,0.626984127,1332
e98c2ec601e4ec241847c9ad6a7c73c648d53348,0,Jacob Alexander Mannix,2010-01-21 07:14:48+00:00,['ecb08e8dd4c79d51ea8a7fcf065ce2a5f978fd5a'],1485,20,1505,588572,17,0.471428571,0.382539683,0.373015873,1332
504c1677cb19a97c6a9f15526cd509bb75ab7366,1,Jacob Alexander Mannix,2010-01-21 13:12:40+00:00,['e98c2ec601e4ec241847c9ad6a7c73c648d53348'],20,149,169,588741,5,0.56,1,0.906666667,1332
993e608eb65378b6536b9469f13996d6fbd0a492,1,Jacob Alexander Mannix,2010-01-21 13:15:54+00:00,['504c1677cb19a97c6a9f15526cd509bb75ab7366'],1,1,2,588743,1,,,,1332
a258fa20ca77654baeb205864d697606cea2e267,0,Jacob Alexander Mannix,2010-01-21 13:21:49+00:00,['993e608eb65378b6536b9469f13996d6fbd0a492'],1,1,2,588745,1,,,,1332
08f8923c1a4ebd9b13f93e34a22af6fd0ccc6363,1,Jacob Alexander Mannix,2010-01-21 13:31:31+00:00,['a258fa20ca77654baeb205864d697606cea2e267'],2,5,7,588752,1,1,1,1,1332
a01238bb99c948dcaeec536b546f7af4c6a37d0b,0,Jacob Alexander Mannix,2010-01-21 13:36:10+00:00,['08f8923c1a4ebd9b13f93e34a22af6fd0ccc6363'],0,20,20,588772,1,0,0,1,1332
0821d4271ff44e18ac504a9e8859b8fe9ecbd73b,1,Jacob Alexander Mannix,2010-01-21 13:39:23+00:00,['a01238bb99c948dcaeec536b546f7af4c6a37d0b'],0,14,14,588786,1,1,1,1,1332
ab2d63e79fc379beb751bba13159842de6b771ad,0,Jacob Alexander Mannix,2010-01-21 14:13:26+00:00,['0821d4271ff44e18ac504a9e8859b8fe9ecbd73b'],1,1,2,588788,1,,,,1332
ba1198e91f793d7a527bc3520586cb7ffa7ff781,1,Jacob Alexander Mannix,2010-01-21 14:14:45+00:00,['ab2d63e79fc379beb751bba13159842de6b771ad'],15,33,48,588836,1,1,1,0.071428571,1332
506d84d80dbcd4eb703ec6fb0370fad06fc9d13f,1,Jacob Alexander Mannix,2010-01-21 14:20:01+00:00,['ba1198e91f793d7a527bc3520586cb7ffa7ff781'],0,1330,1330,590166,12,0.524324324,0.565765766,0.589189189,1344
6e3509bb26e2bbc7a5b3b2a78cf4ba0dfe1e921b,0,Isabel Drost,2010-01-21 17:36:20+00:00,['506d84d80dbcd4eb703ec6fb0370fad06fc9d13f'],31,24,55,590221,3,1,0,1,1344
ea6519794d19f11cd2540b6e46f56f765cec74c8,1,Sean R. Owen,2010-01-21 19:51:44+00:00,['6e3509bb26e2bbc7a5b3b2a78cf4ba0dfe1e921b'],1067,643,1710,591931,158,1,0.291666667,0.541666667,1344
885e4d7bbc76963566b6d9580e6864524f3822dc,0,Sean R. Owen,2010-01-21 21:50:47+00:00,['ea6519794d19f11cd2540b6e46f56f765cec74c8'],15,25,40,591971,2,0,0,1,1344
089dbf2633a6427852354881f75acecd8aa7cb54,0,Jacob Alexander Mannix,2010-01-21 22:50:36+00:00,['885e4d7bbc76963566b6d9580e6864524f3822dc'],1,2,3,591974,1,,,,1344
b78c9af0fb7e57b05b7cd003a72e95a013f57b74,0,Sean R. Owen,2010-01-21 22:54:45+00:00,['089dbf2633a6427852354881f75acecd8aa7cb54'],12,14,26,592000,2,0,0,1,1344
e3fd6a4d1459d7a4893945d8cdf405d97d5a4663,0,Sean R. Owen,2010-01-22 04:41:24+00:00,['b78c9af0fb7e57b05b7cd003a72e95a013f57b74'],2,14,16,592016,1,0,0,1,1344
c184e663bfb63164ff8217f5fbdf2c0d220ab206,0,Sean R. Owen,2010-01-22 14:38:53+00:00,['e3fd6a4d1459d7a4893945d8cdf405d97d5a4663'],11,40,51,592067,1,0,0,1,1344
af5cf6c3ed0224ca611adbd9ab20485f8cf1633d,0,Sean R. Owen,2010-01-22 14:41:16+00:00,['c184e663bfb63164ff8217f5fbdf2c0d220ab206'],0,6,6,592073,1,,,,1344
f518dba33d7c6116a5e65be9160fc48f61b989a4,0,Sean R. Owen,2010-01-22 14:43:49+00:00,['af5cf6c3ed0224ca611adbd9ab20485f8cf1633d'],2,15,17,592090,1,0,0,1,1344
96e6ed2248fdcdbfa263dfd55af7ee0785b2264e,0,Sean R. Owen,2010-01-22 14:47:03+00:00,['f518dba33d7c6116a5e65be9160fc48f61b989a4'],9,87,96,592186,2,1,1,0.891891892,1345
e244bcaa2ff6ddf4aced9f7645abaa88400a197a,1,Sean R. Owen,2010-01-22 20:35:21+00:00,['96e6ed2248fdcdbfa263dfd55af7ee0785b2264e'],14,82,96,592282,3,1,1,1,1345
39945ad3a0c48c20b1c8d01235178329bdc04488,0,Sean R. Owen,2010-01-24 17:53:46+00:00,['e244bcaa2ff6ddf4aced9f7645abaa88400a197a'],4,6,10,592292,1,,,,1345
18bf66395622980fc4796a0506aa12af484ed7f4,1,Sean R. Owen,2010-01-24 18:13:41+00:00,['39945ad3a0c48c20b1c8d01235178329bdc04488'],48,34,82,592374,26,1,0.833333333,0.833333333,1345
a576dc786efa69f44e396bd61b59fd412e5806d3,0,Sean R. Owen,2010-01-25 21:43:23+00:00,['18bf66395622980fc4796a0506aa12af484ed7f4'],6,341,347,592721,2,0.033557047,1,1,1346
5a677d48c6ae50254ef8d72e4b9900f84e84efbe,1,Sean R. Owen,2010-01-26 03:55:27+00:00,['a576dc786efa69f44e396bd61b59fd412e5806d3'],214,179,393,593114,47,0,1,0,1346
81702b74f959aa0699f55c2745e52ed53bf354db,0,Sean R. Owen,2010-01-26 21:47:49+00:00,['5a677d48c6ae50254ef8d72e4b9900f84e84efbe'],2,2,4,593118,1,,,,1346
e4e6d107ae7bebc26f333ddafc11edcf20cb39f2,0,Sean R. Owen,2010-01-27 22:32:03+00:00,['81702b74f959aa0699f55c2745e52ed53bf354db'],12,66,78,593196,2,0,0.85,1,1346
4f91f4458bef5854c6af5a051c0ef788c0e0f774,1,Jacob Alexander Mannix,2010-01-28 06:11:42+00:00,['e4e6d107ae7bebc26f333ddafc11edcf20cb39f2'],655,801,1456,594652,70,0.376811594,1,0.949275362,1348
fdc5ca5a41df2b95e71c2575decd84be2bcc1c77,0,Jacob Alexander Mannix,2010-01-28 06:23:34+00:00,['4f91f4458bef5854c6af5a051c0ef788c0e0f774'],9,5,14,594666,2,0,0,0.75,1348
ed761b730105d83a0393265dabaf46dd7dafe9c3,0,Jacob Alexander Mannix,2010-01-28 07:51:31+00:00,['fdc5ca5a41df2b95e71c2575decd84be2bcc1c77'],1,2,3,594669,1,0,0,1,1348
b162d9e28f2afab911cdac589b36b4931c1cca04,1,Jacob Alexander Mannix,2010-01-28 07:52:53+00:00,['ed761b730105d83a0393265dabaf46dd7dafe9c3'],47,79,126,594795,5,,,,1348
7f224686b57e45c5d0bb5aa63166513ef7d61c76,0,Sean R. Owen,2010-01-30 15:15:36+00:00,['b162d9e28f2afab911cdac589b36b4931c1cca04'],1,10,11,594806,3,0,1,1,1348
c1ee809929102246c80d39ee1fcb886c475afc89,0,Robin Anil,2010-01-31 18:10:33+00:00,['7f224686b57e45c5d0bb5aa63166513ef7d61c76'],1,1,2,594808,1,,,,1348
bba929eb403b1de6edb2e6c45bb053bb31069e38,0,Robin Anil,2010-02-01 10:08:29+00:00,['c1ee809929102246c80d39ee1fcb886c475afc89'],9,15,24,594832,1,0,1,1,1348
9c457637ab87bdcd31441d8c7618a0862a820f9d,0,Robin Anil,2010-02-01 19:34:31+00:00,['bba929eb403b1de6edb2e6c45bb053bb31069e38'],0,1,1,594833,1,,,,1348
bf717650b7d3abbbf65ce31423e8e019fa0ebc94,1,Jacob Alexander Mannix,2010-02-02 05:59:27+00:00,['9c457637ab87bdcd31441d8c7618a0862a820f9d'],0,107,107,594940,2,,,,1350
31007bced7d8f424dd69e406938f1eea617cd9f0,1,Jacob Alexander Mannix,2010-02-03 08:05:57+00:00,['bf717650b7d3abbbf65ce31423e8e019fa0ebc94'],0,14,14,594954,3,1,1,1,1350
f89fd9a53ba114de0582c9a2e1b3667137273633,0,Robin Anil,2010-02-03 21:36:51+00:00,['31007bced7d8f424dd69e406938f1eea617cd9f0'],19,34,53,595007,1,0,0,0,1350
9a8c2331b4056bf204ec6fd6787449c6df42c5c9,0,Sean R. Owen,2010-02-04 15:07:39+00:00,['f89fd9a53ba114de0582c9a2e1b3667137273633'],15,14,29,595036,5,,,,1350
251f0e920403f47e83764e6d6cb7816f91985afb,1,Robin Anil,2010-02-05 09:27:04+00:00,['9a8c2331b4056bf204ec6fd6787449c6df42c5c9'],312,1100,1412,596448,17,0.175159236,0.242038217,0.398089172,1356
1be812e19977fe5410bd39ea2a1561006c4e260f,1,Robin Anil,2010-02-05 11:00:25+00:00,['251f0e920403f47e83764e6d6cb7816f91985afb'],953,1237,2190,598638,32,0,0.582089552,0.313432836,1356
2e38f55bff6e5b5080d57ab37ad79255cdb47346,0,Sean R. Owen,2010-02-05 17:12:39+00:00,['1be812e19977fe5410bd39ea2a1561006c4e260f'],10,66,76,598714,6,,,,1358
f401530f6f32160d1d5f46b9f6642777ccf63265,1,Robin Anil,2010-02-05 17:59:14+00:00,['2e38f55bff6e5b5080d57ab37ad79255cdb47346'],6,6,12,598726,2,,,,1358
ecf6999d99cfd771105ee362700590fba6ab340c,0,Sean R. Owen,2010-02-05 18:24:37+00:00,['f401530f6f32160d1d5f46b9f6642777ccf63265'],54,218,272,598998,4,0,0,1,1358
753f43e4ccfa6b719edca9c52cfdd333087b2613,1,Robin Anil,2010-02-06 11:50:37+00:00,['ecf6999d99cfd771105ee362700590fba6ab340c'],147,98,245,599243,4,,,,1358
838ad263b117205bde49096cd376e6f323be89d6,0,Robin Anil,2010-02-06 13:56:31+00:00,['753f43e4ccfa6b719edca9c52cfdd333087b2613'],2,8,10,599253,2,0,1,0,1358
98aeb713ff6ecc06c4c1cfa50f5b387e03c675df,0,Robin Anil,2010-02-07 12:08:26+00:00,['838ad263b117205bde49096cd376e6f323be89d6'],13,99,112,599365,5,0.515151515,1,0.606060606,1359
54aef6529b95851faa34e5bfb236a101a326ffab,0,Robin Anil,2010-02-07 16:43:38+00:00,['98aeb713ff6ecc06c4c1cfa50f5b387e03c675df'],1,1,2,599367,1,,,,1359
7eac96d5dd658a7168d0548747fbd205d3c918ca,0,Robin Anil,2010-02-07 18:55:29+00:00,['54aef6529b95851faa34e5bfb236a101a326ffab'],24,24,48,599415,2,1,0,0,1359
595157bc194375fbc2f72a4279bfb9bc3ea34ef5,1,Robin Anil,2010-02-07 19:49:16+00:00,['7eac96d5dd658a7168d0548747fbd205d3c918ca'],202,356,558,599973,3,0,0.165217391,0.808695652,1359
fa9b2b1b24568176255b9406ac17ef0708d9dd42,1,Benson Margulies,2010-02-08 02:03:12+00:00,['595157bc194375fbc2f72a4279bfb9bc3ea34ef5'],14,19275,19289,619262,90,0.440207331,0.58663458,0.580895964,1448
b879eb29ca15ef44c7be85685a5b399d113b5d32,1,Benson Margulies,2010-02-08 02:17:57+00:00,['fa9b2b1b24568176255b9406ac17ef0708d9dd42'],0,132,132,619394,1,,,,1449
ebf9a4d9c26c182c26d5fdb3ea4b1f12ed19a7bb,1,Benson Margulies,2010-02-08 02:57:57+00:00,['b879eb29ca15ef44c7be85685a5b399d113b5d32'],12027,15,12042,631436,68,0.55097534,0.408722856,0.422340817,1449
56079f0ddc932eb8f62839da7a5245d1f953af11,0,Robin Anil,2010-02-08 11:59:39+00:00,['ebf9a4d9c26c182c26d5fdb3ea4b1f12ed19a7bb'],4,6,10,631446,1,,,,1449
1b028058317526221b1124612c7dd468b77030f7,0,Robin Anil,2010-02-08 12:40:00+00:00,['56079f0ddc932eb8f62839da7a5245d1f953af11'],48,0,48,631494,4,,,,1449
b38e82489b33d4999113a09ff1964581565fea2c,1,Robin Anil,2010-02-08 12:51:51+00:00,['1b028058317526221b1124612c7dd468b77030f7'],48,50,98,631592,10,0.125,1,0.125,1449
00777adafbab69e23488a867ecf61c65d1fadb34,0,Robin Anil,2010-02-08 15:06:09+00:00,['b38e82489b33d4999113a09ff1964581565fea2c'],2,8,10,631602,2,,,,1449
520918395bcc10bdcdbe05e25708b353ffe21716,0,Jeff Eastman,2010-02-08 23:11:51+00:00,['00777adafbab69e23488a867ecf61c65d1fadb34'],30,24,54,631656,3,0,0,0,1449
290e76ff0b67306dfa21062aad3a1c8b20e0b843,1,Sean R. Owen,2010-02-09 01:17:44+00:00,['520918395bcc10bdcdbe05e25708b353ffe21716'],464,130,594,632250,46,0.586666667,0.14,0.086666667,1449
e4ad6b16f3fa2cebf7c2c0baf36c346fb7599f17,0,Robin Anil,2010-02-09 04:08:55+00:00,['290e76ff0b67306dfa21062aad3a1c8b20e0b843'],25,0,25,632275,2,,,,1449
a276c6ddc72ce12b8a78b9a50f80e36a4e1267fc,1,Robin Anil,2010-02-09 05:49:18+00:00,['e4ad6b16f3fa2cebf7c2c0baf36c346fb7599f17'],0,1483,1483,633758,12,0.256454389,0.705679862,0.722891566,1460
1db8ad4c4f0426fbb7973384cff41df6844abd56,0,Sean R. Owen,2010-02-09 09:27:53+00:00,['a276c6ddc72ce12b8a78b9a50f80e36a4e1267fc'],0,5,5,633763,1,,,,1460
8555d67ad27df9bf664eaaa87f6dd704d9fbaaff,0,Robin Anil,2010-02-09 12:44:33+00:00,['1db8ad4c4f0426fbb7973384cff41df6844abd56'],1,0,1,633764,3,,,,1460
6980b95dce04af3545fb3b75c11836b0988bb98a,0,Robin Anil,2010-02-09 13:45:48+00:00,['8555d67ad27df9bf664eaaa87f6dd704d9fbaaff'],9,9,18,633782,6,,,,1460
382b4470c54285194dc9a722f88dcaf2cc2528a3,1,Robin Anil,2010-02-09 14:11:50+00:00,['6980b95dce04af3545fb3b75c11836b0988bb98a'],81,138,219,634001,6,0.075,0.275,0.3,1460
611c3a7753cdacef3f168a8dddd4786226445bfa,1,Jeff Eastman,2010-02-09 21:30:17+00:00,['382b4470c54285194dc9a722f88dcaf2cc2528a3'],66,703,769,634770,13,1,0.908571429,0.84,1464
2c005ed09a80889b83bbcf09972804a6c4278302,0,Jeff Eastman,2010-02-09 21:44:06+00:00,['611c3a7753cdacef3f168a8dddd4786226445bfa'],2,2,4,634774,2,,,,1464
2e77bf8c7fcacf9ad7252b2b9e0d8a758fc60d32,1,Sean R. Owen,2010-02-10 00:03:16+00:00,['2c005ed09a80889b83bbcf09972804a6c4278302'],166,151,317,635091,50,0.166666667,0.5,0,1464
ed6770439adef1c609f40907acc69081c9d658e8,0,Robin Anil,2010-02-10 06:54:08+00:00,['2e77bf8c7fcacf9ad7252b2b9e0d8a758fc60d32'],1,3,4,635095,1,,,,1464
1769809395eb3383f97dd3f696290abfdbfd8208,0,Robin Anil,2010-02-10 12:08:44+00:00,['ed6770439adef1c609f40907acc69081c9d658e8'],611,5,616,635711,4,0.540462428,0.462427746,0.751445087,1464
1c2d22d06acbd0a975311b36ceb8bd24bf28d952,0,Robin Anil,2010-02-10 22:45:34+00:00,['1769809395eb3383f97dd3f696290abfdbfd8208'],401,597,998,636709,15,0.176100629,0,0.547169811,1464
1186b5a77f952c90e763b098a2704923d1df246b,0,Sean R. Owen,2010-02-10 23:21:36+00:00,['1c2d22d06acbd0a975311b36ceb8bd24bf28d952'],1,1,2,636711,1,,,,1464
951224a86989e4c75b92d6ff21607a50caa8e433,1,Robin Anil,2010-02-11 04:34:04+00:00,['1186b5a77f952c90e763b098a2704923d1df246b'],3,76,79,636790,1,0,0,1,1464
5e41ea67c5a2233a3f085ad2ee494c06d27236be,0,Robin Anil,2010-02-11 04:35:24+00:00,['951224a86989e4c75b92d6ff21607a50caa8e433'],0,0,0,636790,1,,,,1464
a54904160693310346489178b15c8d4eacc2d9e7,0,Robin Anil,2010-02-11 06:01:19+00:00,['5e41ea67c5a2233a3f085ad2ee494c06d27236be'],57,369,426,637216,9,0.106796117,0.718446602,0.737864078,1466
fd7975f809dd543c633db145e1fde3377f867f46,0,Robin Anil,2010-02-11 07:12:48+00:00,['a54904160693310346489178b15c8d4eacc2d9e7'],186,216,402,637618,3,0,0,0,1466
87f1d33718c3fd0e75d46d6fa22999b711863be7,1,Robin Anil,2010-02-11 14:58:59+00:00,['fd7975f809dd543c633db145e1fde3377f867f46'],33,38,71,637689,1,1,1,1,1466
4bd4d8d09b54981ef7b20d44d43f789e27f7ede8,1,Robin Anil,2010-02-11 16:32:44+00:00,['87f1d33718c3fd0e75d46d6fa22999b711863be7'],290,351,641,638330,9,0.028571429,0,0.371428571,1466
da1b0acfa7ecf1027af50f622733607726bee0c0,1,Grant Ingersoll,2010-02-11 19:43:00+00:00,['4bd4d8d09b54981ef7b20d44d43f789e27f7ede8'],0,209,209,638539,3,,,,1467
3a39b0bb82c65e74bec2b88dbbd5d3df9132d6d2,0,Robin Anil,2010-02-12 12:42:42+00:00,['da1b0acfa7ecf1027af50f622733607726bee0c0'],119,158,277,638816,1,0,0.078947368,1,1467
49c9b9903a554830bbe8c2aacf9597d3248a37b0,1,Sean R. Owen,2010-02-12 13:04:16+00:00,['3a39b0bb82c65e74bec2b88dbbd5d3df9132d6d2'],133,127,260,639076,32,0,1,0,1467
ed8a04fb29dd9aeadc15a5e6d89a0ae505a7c6fd,0,Sean R. Owen,2010-02-12 13:37:54+00:00,['49c9b9903a554830bbe8c2aacf9597d3248a37b0'],11,9,20,639096,5,,,,1467
f41017d00d89068b960a1fac82eae7297c1fa6a9,0,Robin Anil,2010-02-12 14:44:19+00:00,['ed8a04fb29dd9aeadc15a5e6d89a0ae505a7c6fd'],4,5,9,639105,1,,,,1467
95cc48a65eac18a3c4a91d3be9461dbe55b3880d,0,Sean R. Owen,2010-02-12 15:38:06+00:00,['f41017d00d89068b960a1fac82eae7297c1fa6a9'],7,9,16,639121,1,,,,1467
933e150126a6935bccb45da403e21c990fa0cd46,0,Robin Anil,2010-02-12 20:23:55+00:00,['95cc48a65eac18a3c4a91d3be9461dbe55b3880d'],11,15,26,639147,3,0,0.75,0.75,1467
bbbebdac003341dae4cb23c1443a2c70eb06359b,1,Jacob Alexander Mannix,2010-02-12 21:21:23+00:00,['933e150126a6935bccb45da403e21c990fa0cd46'],29,75,104,639251,7,0.055555556,0.416666667,0.111111111,1467
9d4b21512ae6213d1381d2686b5a69ae9a6c590d,1,Robin Anil,2010-02-12 21:24:08+00:00,['bbbebdac003341dae4cb23c1443a2c70eb06359b'],2,12,14,639265,1,0,0,1,1467
e26711c75d1c82d968686fa9eec84ca3822805d6,0,Grant Ingersoll,2010-02-12 23:23:29+00:00,['9d4b21512ae6213d1381d2686b5a69ae9a6c590d'],7,8,15,639280,1,,,,1467
a6d8cd609dd774c37a3637fb57a7bacca8ddb57c,0,Robin Anil,2010-02-13 02:17:01+00:00,['e26711c75d1c82d968686fa9eec84ca3822805d6'],79,94,173,639453,1,0.1,0,0.8,1467
ab794986d5a4ad30b5a99c69b4c7bdc625b9d83e,0,Robin Anil,2010-02-13 09:24:06+00:00,['a6d8cd609dd774c37a3637fb57a7bacca8ddb57c'],1,2,3,639456,1,0,0,1,1467
9ebf9127b3a16ce6c6e58b4e2b0e62e2a931f3f3,1,Grant Ingersoll,2010-02-13 17:36:33+00:00,['ab794986d5a4ad30b5a99c69b4c7bdc625b9d83e'],23,39,62,639518,1,0,1,1,1467
905bee382ef7039f278df955fdb89db4af23f625,0,Grant Ingersoll,2010-02-13 17:39:34+00:00,['9ebf9127b3a16ce6c6e58b4e2b0e62e2a931f3f3'],5,5,10,639528,1,,,,1467
2939520a476e10369e035f61f0bc251aefac18a1,0,Grant Ingersoll,2010-02-13 17:46:37+00:00,['905bee382ef7039f278df955fdb89db4af23f625'],2,5,7,639535,2,,,,1467
233d93d401d813ae7e5de852fe7a2b7cce14e305,1,Robin Anil,2010-02-13 17:55:56+00:00,['2939520a476e10369e035f61f0bc251aefac18a1'],1852,1687,3539,643074,58,1,0.882352941,0.235294118,1467
833d96f4b96739118941c0a890d07c65807d35bc,0,Grant Ingersoll,2010-02-13 17:57:42+00:00,['233d93d401d813ae7e5de852fe7a2b7cce14e305'],1,1,2,643076,1,,,,1467
42ae840390ea2453e6ee53ff466cf631bbf2edb7,1,Robin Anil,2010-02-13 19:07:36+00:00,['833d96f4b96739118941c0a890d07c65807d35bc'],3603,3513,7116,650192,101,0,0.296703297,0,1467
d581a9e5a482283a0019bb5667dec4594c124b3b,0,Robin Anil,2010-02-13 19:12:14+00:00,['42ae840390ea2453e6ee53ff466cf631bbf2edb7'],24,32,56,650248,5,0,0,1,1467
b82d989933132c9807007147b1ef7239f00d6eb0,1,Robin Anil,2010-02-13 19:57:04+00:00,['d581a9e5a482283a0019bb5667dec4594c124b3b'],2214,1947,4161,654409,119,0.69348659,0.429118774,0.314176245,1467
ad11134046ff704007aab4f3d0ebb912b833edd3,1,Robin Anil,2010-02-13 20:27:25+00:00,['b82d989933132c9807007147b1ef7239f00d6eb0'],2135,2285,4420,658829,59,0,0.115384615,0.615384615,1467
67b36047481fd9dcf85fbbd5ec15bc39c5f8c6b0,0,Robin Anil,2010-02-13 20:33:13+00:00,['ad11134046ff704007aab4f3d0ebb912b833edd3'],135,147,282,659111,6,0.285714286,0,0.285714286,1467
1b4e01f075d3e7d7148898c0d4127b590bc0458c,1,Robin Anil,2010-02-13 20:54:05+00:00,['67b36047481fd9dcf85fbbd5ec15bc39c5f8c6b0'],5024,5809,10833,669944,155,1,0.061643836,0.445205479,1467
53de8dcfa25980a395af03309cfed029798efb99,1,Robin Anil,2010-02-13 21:07:53+00:00,['1b4e01f075d3e7d7148898c0d4127b590bc0458c'],2360,2657,5017,674961,69,0,0.947368421,0,1467
f254e9c08c8b6ffe832a5da389243974fe62f452,0,Robin Anil,2010-02-13 21:22:29+00:00,['53de8dcfa25980a395af03309cfed029798efb99'],6,6,12,674973,1,,,,1467
f64d9c4ec850d6f17c0165d0a8e81b39dfa5ec0b,0,Robin Anil,2010-02-13 21:45:41+00:00,['f254e9c08c8b6ffe832a5da389243974fe62f452'],1,1,2,674975,1,,,,1467
04f2a221f69bd4beeaadc3a4963ba2bf82ffaf19,1,Jacob Alexander Mannix,2010-02-13 23:40:15+00:00,['f64d9c4ec850d6f17c0165d0a8e81b39dfa5ec0b'],1,5,6,674981,1,1,1,1,1467
87e3a11f35eff0e0969c247345bb15b022425e0c,0,Jacob Alexander Mannix,2010-02-13 23:41:19+00:00,['04f2a221f69bd4beeaadc3a4963ba2bf82ffaf19'],1,1,2,674983,1,,,,1467
119d7bdf856443b9afacfed076d16b429c7ab1ee,1,Jacob Alexander Mannix,2010-02-13 23:58:59+00:00,['87e3a11f35eff0e0969c247345bb15b022425e0c'],15,31,46,675029,2,0,0,0.666666667,1467
35b33a489c92e291225f35a4f0505e1fc2946d01,0,Robin Anil,2010-02-14 00:19:31+00:00,['119d7bdf856443b9afacfed076d16b429c7ab1ee'],8,13,21,675050,4,0,1,0,1467
380e609abdb94c83f81c5f12298d71b67cc196cd,0,Robin Anil,2010-02-14 20:23:42+00:00,['35b33a489c92e291225f35a4f0505e1fc2946d01'],52,74,126,675176,1,0.461538462,0.461538462,1,1467
8aacfc32f6fdd74dae8011305a0e8d3f299f350f,0,Grant Ingersoll,2010-02-14 22:10:08+00:00,['380e609abdb94c83f81c5f12298d71b67cc196cd'],0,13,13,675189,1,,,,1467
51c9f4c819a79fbf599e6bc10e418cdcac1b8936,0,Grant Ingersoll,2010-02-14 22:11:17+00:00,['8aacfc32f6fdd74dae8011305a0e8d3f299f350f'],0,3,3,675192,1,,,,1467
a29b210b067688a03fcbebd69c91342e59355f0f,1,Jacob Alexander Mannix,2010-02-14 22:18:51+00:00,['51c9f4c819a79fbf599e6bc10e418cdcac1b8936'],1,36,37,675229,2,,,,1467
297bef58c48087d8ee321cf457f155cfd1b5a260,1,Robin Anil,2010-02-15 18:17:54+00:00,['a29b210b067688a03fcbebd69c91342e59355f0f'],1187,1227,2414,677643,200,1,0.625,0,1467
e4d6877dd99b667c6fda57a6f5b914a3e03912cb,1,Robin Anil,2010-02-15 18:27:31+00:00,['297bef58c48087d8ee321cf457f155cfd1b5a260'],5,285,290,677933,3,0.189655172,0.189655172,0.913793103,1469
d2ef57c1fe2213ada9433960dbc4e21bface75d8,0,Sean R. Owen,2010-02-16 10:06:12+00:00,['e4d6877dd99b667c6fda57a6f5b914a3e03912cb'],74,166,240,678173,15,0.442307692,0.75,0.961538462,1469
210fac329f44feaf54944b97a0848a9b8827b45c,1,Sean R. Owen,2010-02-16 10:41:38+00:00,['d2ef57c1fe2213ada9433960dbc4e21bface75d8'],461,458,919,679092,143,0.5,0.5,0,1469
a0a39da35a85bbccd5764f99fd5a4944f3b5a974,0,Sean R. Owen,2010-02-16 15:55:07+00:00,['210fac329f44feaf54944b97a0848a9b8827b45c'],3,3,6,679098,1,,,,1469
2dc63b9dc2eda7825b92653a6f3b0ef80075da65,0,Sean R. Owen,2010-02-16 15:56:52+00:00,['a0a39da35a85bbccd5764f99fd5a4944f3b5a974'],12,13,25,679123,6,0.333333333,0,0.333333333,1469
46e266a9bbe91e9003b1b67cef4f33d9b1411ba7,1,Robin Anil,2010-02-17 09:19:01+00:00,['2dc63b9dc2eda7825b92653a6f3b0ef80075da65'],4,305,309,679432,2,0.038834951,0.116504854,0.898058252,1470
8b39361586ee71eb53125ba38b0dd498e2b8a7e2,0,Sean R. Owen,2010-02-17 10:53:00+00:00,['46e266a9bbe91e9003b1b67cef4f33d9b1411ba7'],5,6,11,679443,1,1,1,1,1470
1c3cf6d7eb6da71e35b5aa38970400479395fe03,1,Robin Anil,2010-02-17 11:37:34+00:00,['8b39361586ee71eb53125ba38b0dd498e2b8a7e2'],23,104,127,679570,1,0,0.333333333,0.621212121,1470
18736b68f4de63ebf6b5716d198c9600ccf76dbd,0,Robin Anil,2010-02-17 11:38:17+00:00,['1c3cf6d7eb6da71e35b5aa38970400479395fe03'],1,1,2,679572,1,,,,1470
f33ffab2f139011af961672c5f3ea9248be3e1ab,1,Sean R. Owen,2010-02-17 11:45:34+00:00,['18736b68f4de63ebf6b5716d198c9600ccf76dbd'],39,58,97,679669,1,0,0,1,1470
6a0a2bdaaa7a1e300a1bacdc7775c758df4858d2,0,Sean R. Owen,2010-02-17 12:52:25+00:00,['f33ffab2f139011af961672c5f3ea9248be3e1ab'],10,17,27,679696,2,0,1,0,1470
6958a7fe17994d1435246ea1bf232fcf33dd241a,1,Robin Anil,2010-02-18 15:12:14+00:00,['6a0a2bdaaa7a1e300a1bacdc7775c758df4858d2'],8,22,30,679726,2,0,0,1,1470
9bcb6affd525cb9a971091e5d33c5bc549629d73,0,Robin Anil,2010-02-18 15:14:44+00:00,['6958a7fe17994d1435246ea1bf232fcf33dd241a'],9,12,21,679747,1,0,0,1,1470
2b5810e51c0241f5ba3abe0a38ccd8ced0751af0,0,Jacob Alexander Mannix,2010-02-18 23:12:30+00:00,['9bcb6affd525cb9a971091e5d33c5bc549629d73'],1,2,3,679750,1,0,0,0,1470
1b4185175a2dbb08603c0b9e4a258dd3830c80b1,0,Jacob Alexander Mannix,2010-02-18 23:17:06+00:00,['2b5810e51c0241f5ba3abe0a38ccd8ced0751af0'],12,8,20,679770,1,1,0,0,1470
be17264524e2379bd960c25741336820b1bd3cbb,1,Sean R. Owen,2010-02-19 13:45:18+00:00,['1b4185175a2dbb08603c0b9e4a258dd3830c80b1'],22,1014,1036,680806,17,0.902173913,1,1,1483
dad5997b7e8a04eab9183288e5e8ac948916615c,1,Jacob Alexander Mannix,2010-02-20 05:55:37+00:00,['be17264524e2379bd960c25741336820b1bd3cbb'],4,108,112,680918,2,0.261904762,1,1,1483
5a32a902bad5b56bd39193bc7dfd2b86ef11e769,1,Jacob Alexander Mannix,2010-02-20 15:45:47+00:00,['dad5997b7e8a04eab9183288e5e8ac948916615c'],43,1063,1106,682024,20,0.490401396,0.945898778,0.719022688,1491
0083108dea189e391496e21571c3cbce225a8755,1,Andrew L. Farris,2010-02-20 18:47:22+00:00,['5a32a902bad5b56bd39193bc7dfd2b86ef11e769'],533,299,832,682856,11,1,1,0.016949153,1491
18d25de94848b039e9e5e759b63d2e22b5362682,0,Robin Anil,2010-02-20 18:54:33+00:00,['0083108dea189e391496e21571c3cbce225a8755'],1,1,2,682858,1,,,,1491
44b4ed70b77bdae5b6ec336a57371038d77ef87c,1,Sean R. Owen,2010-02-22 13:54:47+00:00,['18d25de94848b039e9e5e759b63d2e22b5362682'],229,216,445,683303,42,0,0,0.777777778,1491
3305f4fff3e2a0e45ab7c4b9a7750fd624ca45a2,1,Robin Anil,2010-02-22 14:38:48+00:00,['44b4ed70b77bdae5b6ec336a57371038d77ef87c'],28,18,46,683349,4,1,0,0.5,1491
ca5d17cb9a63eea4d4d975856cbf763e2e074a01,0,Sean R. Owen,2010-02-22 15:58:42+00:00,['3305f4fff3e2a0e45ab7c4b9a7750fd624ca45a2'],2,1,3,683352,1,,,,1491
8c68b31cf5d346d001cffef9cf28b4b819c06e90,1,Robin Anil,2010-02-22 17:01:56+00:00,['ca5d17cb9a63eea4d4d975856cbf763e2e074a01'],116,394,510,683862,8,0,0,0.850806452,1491
05f0c82f93f41122cfb14aec7f8cb8a3d05cc71d,0,Robin Anil,2010-02-22 18:26:17+00:00,['8c68b31cf5d346d001cffef9cf28b4b819c06e90'],14,16,30,683892,2,,,,1491
ef044f501e5629fe0ac46f29b82ee4cc65b35c5b,0,Robin Anil,2010-02-22 18:42:55+00:00,['05f0c82f93f41122cfb14aec7f8cb8a3d05cc71d'],1,1,2,683894,1,,,,1491
9a9f6eb7574babe36103c4f743c14f0ba2d18fa4,0,Robin Anil,2010-02-22 19:03:43+00:00,['ef044f501e5629fe0ac46f29b82ee4cc65b35c5b'],2,2,4,683898,1,,,,1491
43a96876a6ba242db43090fec3bbdad1ba6e5bef,0,Robin Anil,2010-02-22 19:28:32+00:00,['9a9f6eb7574babe36103c4f743c14f0ba2d18fa4'],2,3,5,683903,1,,,,1491
5b965dfcfd697faa04175f312da8bf516d5e5f0f,0,Robin Anil,2010-02-22 19:38:39+00:00,['43a96876a6ba242db43090fec3bbdad1ba6e5bef'],2,2,4,683907,1,,,,1491
4c6ba6ffe40ad41812149d1f8a1210e68532789d,0,Robin Anil,2010-02-22 21:14:06+00:00,['5b965dfcfd697faa04175f312da8bf516d5e5f0f'],2,2,4,683911,1,,,,1491
d7b0b37570f64dd7ddbafbd51b72648a31afe95b,1,Jacob Alexander Mannix,2010-02-22 21:22:39+00:00,['4c6ba6ffe40ad41812149d1f8a1210e68532789d'],7,118,125,684036,1,0,0,1,1491
2152f095f4088e9996114b9f8a9acd76234a7e9e,0,Andrew L. Farris,2010-02-23 02:41:22+00:00,['d7b0b37570f64dd7ddbafbd51b72648a31afe95b'],0,0,0,684036,0,,,,1491
0f033b2774fca4146484c8e134f2c3ad612e88f6,0,Sean R. Owen,2010-02-23 10:57:44+00:00,['2152f095f4088e9996114b9f8a9acd76234a7e9e'],136,100,236,684272,61,,,,1491
9e64aa69ec78bfe8a32422a561de13595c57ddaf,0,Jacob Alexander Mannix,2010-02-23 17:12:19+00:00,['0f033b2774fca4146484c8e134f2c3ad612e88f6'],6,0,6,684278,1,1,0,0,1491
c0a999bc4859f6c2c19f70d932cdec5fbf9156b9,0,Jacob Alexander Mannix,2010-02-24 02:57:42+00:00,['9e64aa69ec78bfe8a32422a561de13595c57ddaf'],2,1,3,684281,1,0,0,0,1491
07b148e26df4cc712749673344de1be4009b906f,0,Jacob Alexander Mannix,2010-02-24 19:24:13+00:00,['c0a999bc4859f6c2c19f70d932cdec5fbf9156b9'],0,0,0,684281,0,,,,1491
452f13bd8a3a7adee0792067d4af8484c2d4bad9,1,Robin Anil,2010-02-25 03:41:07+00:00,['07b148e26df4cc712749673344de1be4009b906f'],1,24,25,684306,3,0,1,1,1491
8abc960f2830891bf43a706d1dc19ab60626a382,1,Robin Anil,2010-03-01 05:42:35+00:00,['452f13bd8a3a7adee0792067d4af8484c2d4bad9'],1290,1277,2567,686873,28,1,1,1,1492
5d4cee37074351dae6fa9f7ec2b3357127cc8143,1,Robin Anil,2010-03-01 16:37:26+00:00,['8abc960f2830891bf43a706d1dc19ab60626a382'],48,31,79,686952,2,0.8,0.8,0.15,1492
eb92397738d7c4fee90e82506c21baa151822a26,1,Robin Anil,2010-03-01 16:51:37+00:00,['5d4cee37074351dae6fa9f7ec2b3357127cc8143'],67,84,151,687103,1,1,1,1,1492
0f2cc3a60771f81e7f5f02ae70eb3b300874d627,0,Robin Anil,2010-03-01 21:50:25+00:00,['eb92397738d7c4fee90e82506c21baa151822a26'],14,13,27,687130,2,0,1,1,1492
073255d3fe33ee0bc365d595129cf612585283e5,0,Robin Anil,2010-03-02 10:00:36+00:00,['0f2cc3a60771f81e7f5f02ae70eb3b300874d627'],2,14,16,687146,1,1,1,1,1492
43982ceb748327b4dcc2854e62478f59de720b6a,1,Sean R. Owen,2010-03-02 13:19:23+00:00,['073255d3fe33ee0bc365d595129cf612585283e5'],37,43,80,687226,1,1,0.888888889,0.888888889,1492
8ccc7fda37c8b75066a545e52e6b92b30cfcb929,1,Jacob Alexander Mannix,2010-03-02 18:08:32+00:00,['43982ceb748327b4dcc2854e62478f59de720b6a'],83,304,387,687613,20,0.230769231,0.230769231,0.931623932,1510
e689607f5502b1ecb524417edd68cfe38cf4793a,0,Jacob Alexander Mannix,2010-03-02 18:12:49+00:00,['8ccc7fda37c8b75066a545e52e6b92b30cfcb929'],33,94,127,687740,2,,,,1510
36e0f3726c61835290885b19e667923e39bfb1bc,0,Andrew L. Farris,2010-03-03 01:32:39+00:00,['e689607f5502b1ecb524417edd68cfe38cf4793a'],3,2,5,687745,1,,,,1510
b697110ddacea6ac31362195a6bb3e03447c5a08,0,Andrew L. Farris,2010-03-03 01:36:17+00:00,['36e0f3726c61835290885b19e667923e39bfb1bc'],0,0,0,687745,1,,,,1510
cf27d49d261cc7fd72e6666868110e305c6dc16b,0,Andrew L. Farris,2010-03-03 01:51:21+00:00,['b697110ddacea6ac31362195a6bb3e03447c5a08'],7,7,14,687759,1,,,,1510
e0ade2e91745dd3175b2779bb1de57f18d3e58e3,1,Robin Anil,2010-03-03 13:36:02+00:00,['cf27d49d261cc7fd72e6666868110e305c6dc16b'],32,61,93,687852,5,1,1,1,1510
1115e3b4e438702cfb75c81aa3a420e9d2524e8c,1,Robin Anil,2010-03-03 14:43:30+00:00,['e0ade2e91745dd3175b2779bb1de57f18d3e58e3'],7,9,16,687868,1,1,1,1,1510
5854423a402d08048242f39d90fe2a8647a9773d,1,Robin Anil,2010-03-04 05:40:03+00:00,['1115e3b4e438702cfb75c81aa3a420e9d2524e8c'],210,423,633,688501,8,0.893203883,1,1,1512
e6569c6f9e11e2f4cdf2e12c44d1d4e6bc7b1b6e,0,Robin Anil,2010-03-04 06:09:56+00:00,['5854423a402d08048242f39d90fe2a8647a9773d'],2,3,5,688506,1,,,,1512
6d454c927086e60257f325923a42e44a6f62cdb8,0,Sean R. Owen,2010-03-04 12:39:14+00:00,['e6569c6f9e11e2f4cdf2e12c44d1d4e6bc7b1b6e'],2,2,4,688510,1,,,,1512
b469a98d8d29ac9762eae46ece6dfef0dcc7bc20,1,Sean R. Owen,2010-03-04 15:57:40+00:00,['6d454c927086e60257f325923a42e44a6f62cdb8'],185,710,895,689405,45,,,,1512
064567e18b9a72f421a605fec6f39c86e65591f9,1,Andrew L. Farris,2010-03-05 05:13:35+00:00,['b469a98d8d29ac9762eae46ece6dfef0dcc7bc20'],0,47,47,689452,1,,,,1512
40d13893127859367b9be568af7a2e444f3114eb,0,Sean R. Owen,2010-03-05 12:23:32+00:00,['064567e18b9a72f421a605fec6f39c86e65591f9'],53,108,161,689613,2,1,1,0.375,1512
25a1880085f73a8885cf637bed35199c9d39cef8,1,Sean R. Owen,2010-03-05 17:01:35+00:00,['40d13893127859367b9be568af7a2e444f3114eb'],235,162,397,690010,48,1,0.545454545,0,1512
a8ba0591a6cc12a354c6705eabc0388c151730f8,1,Jacob Alexander Mannix,2010-03-05 18:48:31+00:00,['25a1880085f73a8885cf637bed35199c9d39cef8'],0,6,6,690016,1,1,1,1,1512
cb6f86a80e2d3a060301e880a5a20b0a917b0e88,0,Jacob Alexander Mannix,2010-03-05 18:51:28+00:00,['a8ba0591a6cc12a354c6705eabc0388c151730f8'],3,3,6,690022,3,,,,1512
36e4fc18e027beffdb85e65a2b0e1f34e9c7e4e1,0,Jacob Alexander Mannix,2010-03-05 18:54:21+00:00,['cb6f86a80e2d3a060301e880a5a20b0a917b0e88'],6,4,10,690032,2,1,0,0,1512
fb4bb1a95a4c5dc8ffac34a0c33828eabc5db538,1,Jacob Alexander Mannix,2010-03-06 04:58:34+00:00,['36e4fc18e027beffdb85e65a2b0e1f34e9c7e4e1'],0,70,70,690102,3,0.073170732,1,1,1514
3edb1a7ef4c6a2a9e7b7bb8cca1d5cf132a6c5a9,1,Jacob Alexander Mannix,2010-03-06 04:59:57+00:00,['fb4bb1a95a4c5dc8ffac34a0c33828eabc5db538'],19,49,68,690170,4,0.291666667,0.958333333,0.458333333,1514
235b944133bc4c44ff168bd8659d62ba652a47f1,1,Jacob Alexander Mannix,2010-03-06 05:08:36+00:00,['3edb1a7ef4c6a2a9e7b7bb8cca1d5cf132a6c5a9'],20,642,662,690832,5,0.452784504,0.900726392,0.503631961,1517
c035a02d11ade06996f21f4d6f6231e324336ebb,0,Jacob Alexander Mannix,2010-03-06 05:10:54+00:00,['235b944133bc4c44ff168bd8659d62ba652a47f1'],58,52,110,690942,5,0,0,1,1518
e7ae8b7326f3a3dd8d0efd20ffcf533e5493b895,1,Andrew L. Farris,2010-03-06 16:38:03+00:00,['c035a02d11ade06996f21f4d6f6231e324336ebb'],116,709,825,691767,14,0.492063492,0.761904762,0.777777778,1524
2798555d67cac9fc3628e38a20b24b7740a07f99,0,Sean R. Owen,2010-03-09 23:48:05+00:00,['e7ae8b7326f3a3dd8d0efd20ffcf533e5493b895'],74,73,147,691914,2,1,1,0,1524
cd19bd1d31acdd27b7a8de9c81d484c00999b93d,0,Sean R. Owen,2010-03-09 23:49:41+00:00,['2798555d67cac9fc3628e38a20b24b7740a07f99'],1,1,2,691916,1,,,,1524
bf9b8e8ba7645f60fe6e4e89522e56f033bff0d9,0,Sean R. Owen,2010-03-10 10:26:18+00:00,['cd19bd1d31acdd27b7a8de9c81d484c00999b93d'],7,11,18,691934,4,,,,1524
f71908acc53c4988e85f03eed0556090fa11e62e,0,Sean R. Owen,2010-03-10 13:51:28+00:00,['bf9b8e8ba7645f60fe6e4e89522e56f033bff0d9'],5,5,10,691944,1,,,,1524
5dfbb0c5283fd2a9596e5c30e6fa49f4a5caf786,1,Sean R. Owen,2010-03-10 20:00:23+00:00,['f71908acc53c4988e85f03eed0556090fa11e62e'],9,238,247,692191,7,0.609375,0.515625,0.890625,1528
12deb551775a682db0ea7cb687886d75cc31cb8b,0,Andrew L. Farris,2010-03-11 02:12:08+00:00,['5dfbb0c5283fd2a9596e5c30e6fa49f4a5caf786'],1,11,12,692203,1,,,,1528
74ab3098c996d3499e299a7adb55e81ed60a4a32,1,Sean R. Owen,2010-03-11 09:26:39+00:00,['12deb551775a682db0ea7cb687886d75cc31cb8b'],122,139,261,692464,23,0.083333333,0.333333333,0,1528
5220c6f2a8b5dd0204d5c2263534eafb477fef1a,1,Robin Anil,2010-03-11 10:22:34+00:00,['74ab3098c996d3499e299a7adb55e81ed60a4a32'],23,23,46,692510,3,0,0.4,1,1528
8e8c6e27a7cab08500df85a336033d82b5083ba8,0,Sean R. Owen,2010-03-11 15:01:58+00:00,['5220c6f2a8b5dd0204d5c2263534eafb477fef1a'],3,3,6,692516,1,,,,1528
e7f3d3e20113b337b976b43e1e28bc719749975f,1,Benson Margulies,2010-03-11 22:08:57+00:00,['8e8c6e27a7cab08500df85a336033d82b5083ba8'],0,65,65,692581,1,,,,1528
e87e186a8af217058b57d81060fb8fb802911fda,1,Benson Margulies,2010-03-11 22:49:07+00:00,['e7f3d3e20113b337b976b43e1e28bc719749975f'],2,36,38,692619,4,,,,1528
a58444269456415255c83f2a13020a4c21671cf8,0,Benson Margulies,2010-03-12 00:17:11+00:00,['e87e186a8af217058b57d81060fb8fb802911fda'],18,32,50,692669,2,,,,1528
d8f384e5971a6f67f952ee008a9a75eaff71c4c1,0,Benson Margulies,2010-03-12 00:24:58+00:00,['a58444269456415255c83f2a13020a4c21671cf8'],47,43,90,692759,9,,,,1528
c57cb54f95f58df6c7cb45144a529f414eb66b15,1,Benson Margulies,2010-03-12 00:25:11+00:00,['d8f384e5971a6f67f952ee008a9a75eaff71c4c1'],40,40,80,692839,9,,,,1528
1a7b47aca1fdc8ce360bb96a44f6f91af33ae801,1,Abdel Hakim Deneche,2010-03-13 10:54:14+00:00,['c57cb54f95f58df6c7cb45144a529f414eb66b15'],24,267,291,693130,6,0.194915254,0.313559322,1,1529
12d0d2bee2f78680ff685415d0c1f5e4a13537ba,1,Abdel Hakim Deneche,2010-03-13 16:25:13+00:00,['1a7b47aca1fdc8ce360bb96a44f6f91af33ae801'],7,47,54,693184,1,0,0.407407407,1,1529
a1c2a058867a3fb1ae9cf0591471227f0219050d,0,Abdel Hakim Deneche,2010-03-13 17:38:05+00:00,['12d0d2bee2f78680ff685415d0c1f5e4a13537ba'],3,9,12,693196,1,0,0,1,1529
d9d9948419868e9929f25132cc830936f2e2e34b,0,Benson Margulies,2010-03-18 02:01:10+00:00,['a1c2a058867a3fb1ae9cf0591471227f0219050d'],5,0,5,693201,1,,,,1529
3dca4b59148654d617ad580a2ba7641a95d9d1a1,1,Sean R. Owen,2010-03-18 12:15:45+00:00,['d9d9948419868e9929f25132cc830936f2e2e34b'],68,360,428,693629,20,0.4625,0.8625,0.8375,1531
6872e91043f803099453c1f21345ef08d969f7f0,0,Sean R. Owen,2010-03-18 18:15:16+00:00,['3dca4b59148654d617ad580a2ba7641a95d9d1a1'],59,58,117,693746,7,1,1,1,1531
0b499309aa7072f7e007e1413d26a2f5b19df6d5,1,Benson Margulies,2010-03-19 01:30:34+00:00,['6872e91043f803099453c1f21345ef08d969f7f0'],36,350,386,694132,6,,,,1536
4226bec4d17550cb3358175b3a23059153ad700c,0,Benson Margulies,2010-03-19 01:31:25+00:00,['0b499309aa7072f7e007e1413d26a2f5b19df6d5'],235,0,235,694367,4,,,,1536
1b16a94949af5564cd35a530b06ded5f6234fc28,1,Benson Margulies,2010-03-19 01:44:48+00:00,['4226bec4d17550cb3358175b3a23059153ad700c'],700,649,1349,695716,10,,,,1536
c0b74781eb165ff410e953d844da9c00dabac235,1,Benson Margulies,2010-03-22 13:22:40+00:00,['1b16a94949af5564cd35a530b06ded5f6234fc28'],16,1579,1595,697311,18,,,,1553
16e39847c982df48ee710dac8c620767192039c7,0,Andrew L. Farris,2010-03-23 01:52:26+00:00,['c0b74781eb165ff410e953d844da9c00dabac235'],0,0,0,697311,0,,,,1553
6eb3e85b64716c36fbba472a4e0a9b2cfd62fba1,0,Sean R. Owen,2010-03-23 18:17:47+00:00,['16e39847c982df48ee710dac8c620767192039c7'],1,1,2,697313,1,,,,1553
d9d24d35952292a9fb4761676192ea7fa4a8fdc9,1,Benson Margulies,2010-03-24 12:23:18+00:00,['6eb3e85b64716c36fbba472a4e0a9b2cfd62fba1'],65,596,661,697974,5,,,,1557
cd81660d4f5bdf536ababe20da0ed63272172be4,0,Benson Margulies,2010-03-24 12:23:41+00:00,['d9d24d35952292a9fb4761676192ea7fa4a8fdc9'],503,0,503,698477,3,,,,1557
bd7d5540bf900f6d5e23e78ded0dea4a1171ad26,0,Benson Margulies,2010-03-24 12:40:20+00:00,['cd81660d4f5bdf536ababe20da0ed63272172be4'],26,31,57,698534,2,0,1,1,1557
95b26428b0deb9e58991cc5efbf26b5275799706,0,Sean R. Owen,2010-03-26 20:26:33+00:00,['bd7d5540bf900f6d5e23e78ded0dea4a1171ad26'],1,1,2,698536,1,,,,1557
ad32b57995762e36a26edb4ab43ef10d3df841a8,1,Abdel Hakim Deneche,2010-03-27 06:34:42+00:00,['95b26428b0deb9e58991cc5efbf26b5275799706'],17,52,69,698605,1,0.375,0.375,0,1557
382f209783e3be32a6341fb6a8689b8843868fe8,0,Sean R. Owen,2010-03-27 15:09:47+00:00,['ad32b57995762e36a26edb4ab43ef10d3df841a8'],0,68,68,698673,4,0.466666667,1,1,1557
37d97270e61ca93c0aa694789535bc893c2adf85,0,Sean R. Owen,2010-03-29 10:34:59+00:00,['382f209783e3be32a6341fb6a8689b8843868fe8'],37,32,69,698742,15,0,1,1,1557
5ec20d543d1ed8668396f4c57a152579ea997795,0,Sean R. Owen,2010-03-29 10:59:47+00:00,['37d97270e61ca93c0aa694789535bc893c2adf85'],60,172,232,698974,4,0.76,1,0.6,1559
53d3cc8acccf0fea554d0a197f09207b22c1adec,0,Sean R. Owen,2010-03-29 11:07:46+00:00,['5ec20d543d1ed8668396f4c57a152579ea997795'],1,1,2,698976,1,,,,1559
2ebfee75b9e21e8819fe8782fe978dc3ad3b0539,0,Sean R. Owen,2010-03-30 10:18:05+00:00,['53d3cc8acccf0fea554d0a197f09207b22c1adec'],1,3,4,698980,1,0,1,1,1559
bad696f525d524170087a01dadcdee0ff829d411,0,Sean R. Owen,2010-03-30 17:03:56+00:00,['2ebfee75b9e21e8819fe8782fe978dc3ad3b0539'],2,6,8,698988,1,0,1,1,1559
2bdf8e34206d8937c066bd6388d504cdc6ee8cef,1,Sean R. Owen,2010-03-31 11:01:38+00:00,['bad696f525d524170087a01dadcdee0ff829d411'],4,7,11,698999,3,1,1,1,1559
b3a9c4f08c44f842f5efd0e2039682021889b4a3,0,Sean R. Owen,2010-03-31 11:09:55+00:00,['2bdf8e34206d8937c066bd6388d504cdc6ee8cef'],1,9,10,699009,1,0,1,0.25,1559
b1376583d1bd4ec255080c4a92279a264dcbfb4b,0,Sean R. Owen,2010-03-31 11:47:55+00:00,['b3a9c4f08c44f842f5efd0e2039682021889b4a3'],48,26,74,699083,5,0.625,0,0.3125,1559
f618163c42a65c18c30faf6f9cbb4801ce0da3d0,1,Sean R. Owen,2010-04-01 11:05:27+00:00,['b1376583d1bd4ec255080c4a92279a264dcbfb4b'],58,121,179,699262,9,0,1,0.333333333,1559
56a7423020a6f258afefbca5fb5cdbcbd2768ae1,0,Sean R. Owen,2010-04-01 11:11:44+00:00,['f618163c42a65c18c30faf6f9cbb4801ce0da3d0'],101,128,229,699491,2,0,1,1,1559
34c48fe4f5c540153feb70c18aaf8e745e85cf00,0,Sean R. Owen,2010-04-01 14:25:28+00:00,['56a7423020a6f258afefbca5fb5cdbcbd2768ae1'],14,13,27,699518,4,0,0,0,1559
a92b4ed0d24262b40beaa1c66d4fa0c4cd13d19e,0,Sean R. Owen,2010-04-01 14:37:51+00:00,['34c48fe4f5c540153feb70c18aaf8e745e85cf00'],479,0,479,699997,9,0.524590164,0.524590164,0.098360656,1559
477a95f84dac37242156a9a46c2a3e7088143916,0,Sean R. Owen,2010-04-01 17:37:25+00:00,['a92b4ed0d24262b40beaa1c66d4fa0c4cd13d19e'],13,13,26,700023,10,,,,1559
3c36df26cc04affc269bb081740f81c1acd83950,0,Sean R. Owen,2010-04-02 09:12:19+00:00,['477a95f84dac37242156a9a46c2a3e7088143916'],8,21,29,700052,3,,,,1559
03b916413c94c7e97e4176a278341b7b634ea554,0,Sean R. Owen,2010-04-02 10:11:31+00:00,['3c36df26cc04affc269bb081740f81c1acd83950'],8,6,14,700066,1,1,0,0,1559
ba43564e2f1b7bdddbd49bbba9a838b206c56860,1,Sean R. Owen,2010-04-02 10:21:31+00:00,['03b916413c94c7e97e4176a278341b7b634ea554'],2,3,5,700071,1,,,,1559
100fc63108740d576f3fd68687955f1a422f45c2,0,Sean R. Owen,2010-04-02 18:54:15+00:00,['ba43564e2f1b7bdddbd49bbba9a838b206c56860'],26,129,155,700226,6,0.604166667,0.791666667,0.708333333,1560
3e150062d1511229a6fff47b1705498f036244d4,1,Sean R. Owen,2010-04-02 19:25:38+00:00,['100fc63108740d576f3fd68687955f1a422f45c2'],0,12,12,700238,1,1,1,1,1560
c9c9b5be0b3e24f31ba0ff950bd2746e4b65050b,0,Jeff Eastman,2010-04-02 21:52:20+00:00,['3e150062d1511229a6fff47b1705498f036244d4'],41,63,104,700342,2,1,1,0,1560
9de8cc75b731823945df61201cf80b6387badfb6,0,Sean R. Owen,2010-04-03 12:36:36+00:00,['c9c9b5be0b3e24f31ba0ff950bd2746e4b65050b'],22,0,22,700364,2,1,0,0,1560
5cef385e23a72350880c0d72d8f4cb2b9de5c20d,1,Abdel Hakim Deneche,2010-04-03 19:09:28+00:00,['9de8cc75b731823945df61201cf80b6387badfb6'],22,315,337,700701,3,0.5,1,0.823076923,1561
306b4d04e304bb63b6a50cc17af229a3865a5ec6,0,Sean R. Owen,2010-04-05 05:21:27+00:00,['5cef385e23a72350880c0d72d8f4cb2b9de5c20d'],237,22,259,700960,12,1,1,0.176923077,1561
775626f0a292f7d67313d271a1f50abb05967a67,1,Sean R. Owen,2010-04-05 05:51:48+00:00,['306b4d04e304bb63b6a50cc17af229a3865a5ec6'],5,63,68,701028,3,0,0,0.5,1561
4d434adfdc9c8742ce73ceee66c55b26920be4ad,1,Sean R. Owen,2010-04-05 05:59:17+00:00,['775626f0a292f7d67313d271a1f50abb05967a67'],4,1305,1309,702337,16,0.644578313,0.891566265,0.759036145,1575
60b60918451bcb914c44f5148bd38478e9fe86d2,0,Sean R. Owen,2010-04-05 06:07:18+00:00,['4d434adfdc9c8742ce73ceee66c55b26920be4ad'],15,3,18,702355,3,0,0,0,1575
dd8ed02c858a2195d89268addc225636426c7698,0,Sean R. Owen,2010-04-05 06:26:00+00:00,['60b60918451bcb914c44f5148bd38478e9fe86d2'],307,145,452,702807,18,0.033333333,0.45,0,1575
a16ed788407400b1863dc5c9d9b707293a4ff133,1,Sean R. Owen,2010-04-05 06:47:09+00:00,['dd8ed02c858a2195d89268addc225636426c7698'],93,89,182,702989,13,0,0,0.333333333,1575
1ac13fa7f87f6c81816b53f29d048df48a55bd25,0,Sean R. Owen,2010-04-05 16:05:41+00:00,['a16ed788407400b1863dc5c9d9b707293a4ff133'],392,311,703,703692,18,0,1,1,1577
69f7b592116354a30de7db4fb9f979deafdfef4c,0,Sean R. Owen,2010-04-06 11:12:22+00:00,['1ac13fa7f87f6c81816b53f29d048df48a55bd25'],2,5,7,703699,1,0,0,1,1577
992f6b80321467d5114ff752b5aa31820a2d0d66,0,Sean R. Owen,2010-04-06 12:44:13+00:00,['69f7b592116354a30de7db4fb9f979deafdfef4c'],2,1,3,703702,1,1,1,0,1577
b148f217bbf19bf1f0d0d3d8536023d0c310aba1,0,Sean R. Owen,2010-04-06 17:09:46+00:00,['992f6b80321467d5114ff752b5aa31820a2d0d66'],11,23,34,703736,10,,,,1577
b7c7c42f726945eb4069887e50e1801171c6f4b3,0,Sean R. Owen,2010-04-06 17:38:45+00:00,['b148f217bbf19bf1f0d0d3d8536023d0c310aba1'],6,1,7,703743,1,1,0,0,1577
34bf3badcffa171524cd343e81827134076b8911,0,Benson Margulies,2010-04-06 23:08:22+00:00,['b7c7c42f726945eb4069887e50e1801171c6f4b3'],7,25,32,703775,1,,,,1577
7d41e5e404de9a5a8f85602be142b36c7d4fcae8,0,Benson Margulies,2010-04-06 23:10:48+00:00,['34bf3badcffa171524cd343e81827134076b8911'],1,2,3,703778,1,,,,1577
10b09ef1c72a2c5527387b2c3ef89119750c437b,0,Benson Margulies,2010-04-06 23:12:50+00:00,['7d41e5e404de9a5a8f85602be142b36c7d4fcae8'],1,1,2,703780,1,,,,1577
71293910aea8e5ab3264c7f9b66180a5b67e75de,0,Benson Margulies,2010-04-06 23:15:04+00:00,['10b09ef1c72a2c5527387b2c3ef89119750c437b'],0,13,13,703793,1,,,,1577
3bb27ad15a39f576711fe6d7f8233616b19f7650,0,Benson Margulies,2010-04-06 23:23:51+00:00,['71293910aea8e5ab3264c7f9b66180a5b67e75de'],1,7,8,703801,1,,,,1577
9c61d6438182ca633bc69abd696b4ba43a0bd87b,0,Benson Margulies,2010-04-07 00:59:25+00:00,['3bb27ad15a39f576711fe6d7f8233616b19f7650'],3,4,7,703808,1,,,,1577
c61b83c037090a238609a790f6b62fd6f2d8cb14,0,Benson Margulies,2010-04-07 01:00:47+00:00,['9c61d6438182ca633bc69abd696b4ba43a0bd87b'],4,3,7,703815,1,,,,1577
6cda6440aa16aeb4ccd66f58d2240158597c122a,0,Benson Margulies,2010-04-07 01:01:34+00:00,['c61b83c037090a238609a790f6b62fd6f2d8cb14'],2,2,4,703819,1,,,,1577
d5c160bdcda99c85eec5b72f61a560cd50cfd707,0,Benson Margulies,2010-04-07 01:02:00+00:00,['6cda6440aa16aeb4ccd66f58d2240158597c122a'],3,4,7,703826,1,,,,1577
6f12cb313e15eed63e5c5cb26c8c18ac726323ae,0,Benson Margulies,2010-04-07 01:02:10+00:00,['d5c160bdcda99c85eec5b72f61a560cd50cfd707'],4,4,8,703834,1,,,,1577
8b8b85aa0ae824b1a04e80076ae612ef27a5f1bf,0,Sean R. Owen,2010-04-07 11:56:25+00:00,['6f12cb313e15eed63e5c5cb26c8c18ac726323ae'],47,73,120,703954,6,0,0,0,1578
22e5cce8c07082a3b1ef039bdd445edf5c508632,0,Sean R. Owen,2010-04-07 12:08:35+00:00,['8b8b85aa0ae824b1a04e80076ae612ef27a5f1bf'],20,24,44,703998,4,1,1,1,1578
ca33bc32551eb20d6480cfb544092f5acd5b33cd,0,Sean R. Owen,2010-04-07 14:16:03+00:00,['22e5cce8c07082a3b1ef039bdd445edf5c508632'],1,1,2,704000,1,,,,1578
892fb11ea0ae7ef0bea23dd782410aacd59ba8f8,0,Sean R. Owen,2010-04-07 14:42:50+00:00,['ca33bc32551eb20d6480cfb544092f5acd5b33cd'],2,2,4,704004,1,,,,1578
9891a79717e0463f5df8802789a7ef42bcc755e1,0,Sean R. Owen,2010-04-07 16:19:27+00:00,['892fb11ea0ae7ef0bea23dd782410aacd59ba8f8'],5,7,12,704016,1,0,0,0,1578
3a70a1066390b3e10c75799d915630f29a3e4126,1,Jeff Eastman,2010-04-08 00:08:00+00:00,['9891a79717e0463f5df8802789a7ef42bcc755e1'],96,362,458,704474,10,0.614678899,1,1,1579
c6ad3c2984b79faa707a80cfab14c5b81c7e30ba,0,Jeff Eastman,2010-04-08 00:16:18+00:00,['3a70a1066390b3e10c75799d915630f29a3e4126'],0,0,0,704474,1,,,,1579
994f73fdba06abfe7adde577d6d111fa4433356f,0,Jeff Eastman,2010-04-08 02:12:45+00:00,['c6ad3c2984b79faa707a80cfab14c5b81c7e30ba'],1,1,2,704476,1,,,,1579
bc97f11b88e1465788cad6f9f629fcba4521557f,0,Sean R. Owen,2010-04-08 18:05:34+00:00,['994f73fdba06abfe7adde577d6d111fa4433356f'],2,5,7,704483,1,0,0,0,1579
279c2bcc8015aaa1d192e01274d5066b496a39ac,0,Benson Margulies,2010-04-08 19:49:20+00:00,['bc97f11b88e1465788cad6f9f629fcba4521557f'],3,1,4,704487,2,,,,1579
3f973d6460fc0ec239d13b6ebfb1f7054f359fe2,0,Benson Margulies,2010-04-12 00:40:32+00:00,['279c2bcc8015aaa1d192e01274d5066b496a39ac'],11,31,42,704529,4,,,,1579
20f2c1ec0d90d14b02f1f8c15e32667c496b8b31,0,Benson Margulies,2010-04-12 00:48:58+00:00,['3f973d6460fc0ec239d13b6ebfb1f7054f359fe2'],2,269,271,704800,5,,,,1583
6111d5ca30fbc93fa16c2198b5926777fd088921,0,Benson Margulies,2010-04-12 00:50:34+00:00,['20f2c1ec0d90d14b02f1f8c15e32667c496b8b31'],0,5,5,704805,1,,,,1584
edcbd3d58bae9c908c735eb91e19c8dfca9539a4,0,Benson Margulies,2010-04-12 01:05:10+00:00,['6111d5ca30fbc93fa16c2198b5926777fd088921'],4,4,8,704813,1,,,,1584
d2ab9478b80c36337b749754685a2137e35fef9d,0,Benson Margulies,2010-04-12 01:05:19+00:00,['edcbd3d58bae9c908c735eb91e19c8dfca9539a4'],4,4,8,704821,1,,,,1584
b447d1cb8d116f68326f91947393b15262742005,0,Benson Margulies,2010-04-12 01:16:29+00:00,['d2ab9478b80c36337b749754685a2137e35fef9d'],16,3,19,704840,1,,,,1584
40561f911879f3d914738ecb296d62258cb8a5fc,0,Benson Margulies,2010-04-12 01:18:57+00:00,['b447d1cb8d116f68326f91947393b15262742005'],4,4,8,704848,1,,,,1584
8438f10d3f8dd639850890ed994f86953a2d907d,0,Benson Margulies,2010-04-12 01:19:06+00:00,['40561f911879f3d914738ecb296d62258cb8a5fc'],4,4,8,704856,1,,,,1584
005bb1e9b189f4a276e2d87ce1d255de3317a0f5,0,Benson Margulies,2010-04-12 01:43:30+00:00,['8438f10d3f8dd639850890ed994f86953a2d907d'],126,202,328,705184,1,,,,1584
fb33e5adacee649660af6862ec06a755e17ed814,0,Benson Margulies,2010-04-12 01:44:31+00:00,['005bb1e9b189f4a276e2d87ce1d255de3317a0f5'],4,4,8,705192,1,,,,1584
0db81653d8bb6c4775464c951ba6ce85ddbe9100,0,Benson Margulies,2010-04-12 01:44:40+00:00,['fb33e5adacee649660af6862ec06a755e17ed814'],4,4,8,705200,1,,,,1584
68a241f6dab3971c7c00b114307b2ffe5d3f97e3,0,Sean R. Owen,2010-04-12 09:13:05+00:00,['0db81653d8bb6c4775464c951ba6ce85ddbe9100'],7,5,12,705212,3,,,,1584
2f55c85f23c6ef8829db225740f9d5f935cf500a,0,Sean R. Owen,2010-04-16 09:15:24+00:00,['68a241f6dab3971c7c00b114307b2ffe5d3f97e3'],3,9,12,705224,2,0,1,0,1584
ae491e0cf2bde89565221b3490caba772987282b,0,Andrew L. Farris,2010-04-16 13:35:55+00:00,['2f55c85f23c6ef8829db225740f9d5f935cf500a'],0,0,0,705224,0,,,,1584
6bed65ae0c31d50c5c7d58ac237cb6e9815ca253,0,Andrew L. Farris,2010-04-17 17:53:39+00:00,['ae491e0cf2bde89565221b3490caba772987282b'],0,0,0,705224,0,,,,1584
ff3da8cd8522a90122b3ba833991e6f5d32717a6,1,Sean R. Owen,2010-04-19 12:24:54+00:00,['6bed65ae0c31d50c5c7d58ac237cb6e9815ca253'],156,173,329,705553,45,0,1,0.45,1584
d1e33585986d4f199d06e4469fc204151c3cc091,0,Benson Margulies,2010-04-19 21:10:56+00:00,['ff3da8cd8522a90122b3ba833991e6f5d32717a6'],4,2,6,705559,1,,,,1584
5244107f93fd1339c3d8d3861e3028165f44eb55,0,Sean R. Owen,2010-04-20 11:37:01+00:00,['d1e33585986d4f199d06e4469fc204151c3cc091'],3,6,9,705568,1,1,1,1,1584
b4d9cc8be1c7440bbfba8473ec1dd7feaf207daa,1,Sean R. Owen,2010-04-21 07:41:55+00:00,['5244107f93fd1339c3d8d3861e3028165f44eb55'],1614,1415,3029,708597,51,0.502242152,0.497757848,0.085201794,1589
44ce35b3e71e795862f2ba6719fed45b2ab3e9bd,1,Sean R. Owen,2010-04-21 07:48:15+00:00,['b4d9cc8be1c7440bbfba8473ec1dd7feaf207daa'],125,121,246,708843,12,0,1,0,1589
9a47bc15ce60ac09df8a0470493fcb175258e9e8,1,Jeff Eastman,2010-04-21 20:35:22+00:00,['44ce35b3e71e795862f2ba6719fed45b2ab3e9bd'],502,1380,1882,710725,44,0.578666667,0.994666667,0.648,1596
e6494ad3461266e9f7a86b1f37214a610698f621,0,Benson Margulies,2010-04-22 11:41:07+00:00,['9a47bc15ce60ac09df8a0470493fcb175258e9e8'],1,1,2,710727,1,,,,1596
fb7be38a0a27d5f0dfac48cbe150f1f479d1dc11,0,Jeff Eastman,2010-04-22 20:47:39+00:00,['e6494ad3461266e9f7a86b1f37214a610698f621'],121,147,268,710995,24,1,0.923076923,0.923076923,1596
680648282c980320eeb204db428a4b01e8cde68c,1,Sean R. Owen,2010-04-23 09:34:57+00:00,['fb7be38a0a27d5f0dfac48cbe150f1f479d1dc11'],313,799,1112,712107,20,0.632978723,1,0.521276596,1604
b58c9e3473a4368e5a6dc5ac58dace0ca71feef0,0,Sean R. Owen,2010-04-26 14:49:37+00:00,['680648282c980320eeb204db428a4b01e8cde68c'],27,16,43,712150,2,0,0,0.888888889,1604
6dd87dbab4623a4fa35f52c13ec979c791044e38,0,Sean R. Owen,2010-04-27 08:24:56+00:00,['b58c9e3473a4368e5a6dc5ac58dace0ca71feef0'],23,2,25,712175,2,1,1,0.2,1604
e9aaf30b941e696f7c0c5bf3c0b89007c4b02914,1,Sean R. Owen,2010-04-28 04:35:41+00:00,['6dd87dbab4623a4fa35f52c13ec979c791044e38'],572,168,740,712915,16,0,0,0.046511628,1604
a496859f3623a36697175888f30e4af1a8e80b3b,1,Sean R. Owen,2010-04-28 04:37:19+00:00,['e9aaf30b941e696f7c0c5bf3c0b89007c4b02914'],1432,406,1838,714753,23,0.517321016,0,0.799076212,1606
722355d56edd370827d15e7cfd974f76668256e3,1,Jeff Eastman,2010-04-28 17:37:12+00:00,['a496859f3623a36697175888f30e4af1a8e80b3b'],351,709,1060,715813,17,0.266949153,0.610169492,0.830508475,1607
28f38a05b24156652183f01ff9bcac5510291629,0,Sean R. Owen,2010-04-28 20:15:09+00:00,['722355d56edd370827d15e7cfd974f76668256e3'],35,99,134,715947,4,0.625,0.6875,0,1608
38a66416e9a1153f11c4e09f46c6377a387036a1,0,Jeff Eastman,2010-04-28 23:27:54+00:00,['28f38a05b24156652183f01ff9bcac5510291629'],6,6,12,715959,2,,,,1608
08a9bba83172802d3192c3a61be9705369c2fc0a,0,Jeff Eastman,2010-04-29 00:45:29+00:00,['38a66416e9a1153f11c4e09f46c6377a387036a1'],37,38,75,716034,1,,,,1608
cba4ea758c612ebe9b4b056e82c89bb9de6091b4,0,Sean R. Owen,2010-04-29 08:32:44+00:00,['08a9bba83172802d3192c3a61be9705369c2fc0a'],3,3,6,716040,3,,,,1608
2cea87aae8731be7b061c4030810b4032c491b2c,1,Jeff Eastman,2010-04-29 16:16:10+00:00,['cba4ea758c612ebe9b4b056e82c89bb9de6091b4'],213,202,415,716455,21,0,0,1,1608
124f28161b4e08867f5f7db3458675882da21ea2,1,Sean R. Owen,2010-04-29 22:35:52+00:00,['2cea87aae8731be7b061c4030810b4032c491b2c'],16,29,45,716500,2,1,1,0.363636364,1608
1ad2373fc111098b95ea9d2717f9380628aed007,1,Jeff Eastman,2010-04-29 23:22:18+00:00,['124f28161b4e08867f5f7db3458675882da21ea2'],216,210,426,716926,12,1,0,1,1608
2951ca4f74fcb3636baf57d5b3599f3aa1bdea61,0,Jeff Eastman,2010-04-30 20:16:56+00:00,['1ad2373fc111098b95ea9d2717f9380628aed007'],1147,686,1833,718759,27,1,0,0.288617886,1608
3aec9dc08ec9aa779de2c7058079f1c67021cb70,1,Jeff Eastman,2010-04-30 22:52:11+00:00,['2951ca4f74fcb3636baf57d5b3599f3aa1bdea61'],395,275,670,719429,12,0.726027397,0.150684932,0.479452055,1608
5f29b068fe0956341b1232d11fda196b78fbead6,1,Robin Anil,2010-05-02 16:05:16+00:00,['3aec9dc08ec9aa779de2c7058079f1c67021cb70'],3,113,116,719545,1,0,0,1,1608
d8dbba553d3e79d5407310b11323db84a5866fb4,0,Jeff Eastman,2010-05-03 21:15:42+00:00,['5f29b068fe0956341b1232d11fda196b78fbead6'],106,0,106,719651,2,0.296296296,0,0.37037037,1608
4091520729308f48c95c0213dcc16942db593b03,0,Sean R. Owen,2010-05-04 18:31:22+00:00,['d8dbba553d3e79d5407310b11323db84a5866fb4'],11,23,34,719685,1,0,0,1,1608
16937e1fd3cbf15109ecc68a34e36b95df0a8d94,1,Sean R. Owen,2010-05-06 11:43:01+00:00,['4091520729308f48c95c0213dcc16942db593b03'],1054,762,1816,721501,94,1,0.77734375,0.46875,1609
2ea96a14bc5fc6a76f7d1db4cf9e70c4505f398c,0,Sean R. Owen,2010-05-06 12:55:04+00:00,['16937e1fd3cbf15109ecc68a34e36b95df0a8d94'],3,7,10,721511,1,0,1,1,1609
cdb8e6d9c9e049ff9b16ee93e745d20f59ec3b00,0,Sean R. Owen,2010-05-06 17:55:15+00:00,['2ea96a14bc5fc6a76f7d1db4cf9e70c4505f398c'],122,542,664,722175,14,0.73964497,0.99408284,0.662721893,1614
ae7e1a0040667767163631d012f24e986435f3fb,0,Sean R. Owen,2010-05-06 20:04:55+00:00,['cdb8e6d9c9e049ff9b16ee93e745d20f59ec3b00'],2,1,3,722178,1,,,,1614
60c12f9e0fbe40e9dce58a6fa5e7c6c98d402957,1,Sean R. Owen,2010-05-07 12:25:11+00:00,['ae7e1a0040667767163631d012f24e986435f3fb'],195,161,356,722534,10,1,0.516129032,0.129032258,1614
f4c378aa4211427ba0c1b3f7b2b861d4404b5b40,0,Sean R. Owen,2010-05-07 17:12:27+00:00,['60c12f9e0fbe40e9dce58a6fa5e7c6c98d402957'],124,94,218,722752,21,0.636363636,0.727272727,0,1614
355a5171cfc251b15fb6491851b52223a59fbbfb,1,Sean R. Owen,2010-05-07 20:21:49+00:00,['f4c378aa4211427ba0c1b3f7b2b861d4404b5b40'],46,71,117,722869,13,0.111111111,0.777777778,0.666666667,1614
d9e9db0c32f9c89612af72095617cfcdbfaadc0b,1,Sean R. Owen,2010-05-07 21:56:37+00:00,['355a5171cfc251b15fb6491851b52223a59fbbfb'],6,6,12,722881,1,,,,1614
059bc651196ac77a1b97ee95d001530365ba0df9,0,Sean R. Owen,2010-05-08 07:20:03+00:00,['d9e9db0c32f9c89612af72095617cfcdbfaadc0b'],3,10,13,722894,1,1,1,1,1614
6d867a23552fd97d01263900069dd7b0cf0d3d56,0,Sean R. Owen,2010-05-08 07:22:32+00:00,['059bc651196ac77a1b97ee95d001530365ba0df9'],0,27,27,722921,4,,,,1614
f8516295afd8734badef7ffc1cf3049067d415a3,1,Sean R. Owen,2010-05-08 09:06:23+00:00,['6d867a23552fd97d01263900069dd7b0cf0d3d56'],8,39,47,722968,1,0.333333333,0.333333333,1,1614
115bfeaa4004f065dcc531171c0d5ff810f8032e,0,Sean R. Owen,2010-05-09 08:44:29+00:00,['f8516295afd8734badef7ffc1cf3049067d415a3'],133,157,290,723258,29,0.5,0,0.5625,1614
ae7df11dd9aaeccefcf0987a5bda711a89bcd972,1,Sean R. Owen,2010-05-09 13:36:38+00:00,['115bfeaa4004f065dcc531171c0d5ff810f8032e'],56,905,961,724219,21,0.737704918,0.895081967,0.567213115,1627
d13e2acaa45de3408231e8252820c30e958f4bab,0,Jeff Eastman,2010-05-10 14:55:19+00:00,['ae7df11dd9aaeccefcf0987a5bda711a89bcd972'],26,9,35,724254,1,,,,1627
01bdb8e60f696819e4298b3e45c0685b6e530580,0,Jeff Eastman,2010-05-10 15:09:59+00:00,['d13e2acaa45de3408231e8252820c30e958f4bab'],4,4,8,724262,1,,,,1627
ba3c70cde5315abc5c33926bfec4bbc7cea7a79b,0,Sean R. Owen,2010-05-10 21:08:10+00:00,['01bdb8e60f696819e4298b3e45c0685b6e530580'],1,1,2,724264,1,,,,1627
e55e36da81c26e625ba64463d79f10a125182c8f,0,Andrew L. Farris,2010-05-11 02:40:14+00:00,['ba3c70cde5315abc5c33926bfec4bbc7cea7a79b'],13,43,56,724320,9,1,1,1,1628
b4297270718a3f4dd3cbbafd3aca03b910016d95,0,Sean R. Owen,2010-05-11 07:50:13+00:00,['e55e36da81c26e625ba64463d79f10a125182c8f'],73,111,184,724504,3,0,0.730769231,0.423076923,1628
babecbcc62a453961c7d4f305c3b8605b75ac09b,1,Sean R. Owen,2010-05-11 13:01:42+00:00,['b4297270718a3f4dd3cbbafd3aca03b910016d95'],27,69,96,724600,7,0,0.837837838,0.864864865,1628
8b63e8fcf692af00384be5ae1aa646f105da2746,0,Sean R. Owen,2010-05-11 14:35:04+00:00,['babecbcc62a453961c7d4f305c3b8605b75ac09b'],5,4,9,724609,1,,,,1628
01ce805e5c923e4bfd04f5e7c41c7728d5848aab,1,Sean R. Owen,2010-05-11 19:22:23+00:00,['8b63e8fcf692af00384be5ae1aa646f105da2746'],20,423,443,725052,3,0.493775934,0.77593361,1,1630
c8f60cd566688992b044c4b97390543b9451e4bb,0,Joe Schaefer,2010-05-12 16:07:37+00:00,['01ce805e5c923e4bfd04f5e7c41c7728d5848aab'],0,0,0,725052,0,,,,1630
3d4bfb1e08e36491cfb04a54742131709988a659,0,Jeff Eastman,2010-05-12 19:08:08+00:00,['c8f60cd566688992b044c4b97390543b9451e4bb'],126,116,242,725294,7,1,0,1,1630
06bc65709052fa88eebb07032cf3db0b2765f1d5,0,Benson Margulies,2010-05-12 21:41:21+00:00,['3d4bfb1e08e36491cfb04a54742131709988a659'],19470,0,19470,744764,78,0.574410163,0.420689655,0.429038113,1630
ac6f7580a59d9a44ac8f919ffd75d1c98621aef3,0,Andrew L. Farris,2010-05-15 02:29:30+00:00,['06bc65709052fa88eebb07032cf3db0b2765f1d5'],8,9,17,744781,1,0,0,0,1630
e068ce739ad5857e15a6e65d22a1664e3ed79392,1,Jeff Eastman,2010-05-18 01:08:20+00:00,['ac6f7580a59d9a44ac8f919ffd75d1c98621aef3'],457,406,863,745644,19,1,1,0.189473684,1632
4097e10dcf621bcc12c69d209006a2add83fcd81,1,Jeff Eastman,2010-05-18 17:24:16+00:00,['e068ce739ad5857e15a6e65d22a1664e3ed79392'],152,136,288,745932,6,1,1,0.433333333,1632
53369972e5337bf1a2dd23cd700fac87d125b37c,0,Jeff Eastman,2010-05-18 21:11:59+00:00,['4097e10dcf621bcc12c69d209006a2add83fcd81'],0,10,10,745942,2,,,,1633
ed5ef48601e132b973a90168b3cdce5aac9eab0e,0,Jeff Eastman,2010-05-18 21:53:52+00:00,['53369972e5337bf1a2dd23cd700fac87d125b37c'],3,9,12,745954,2,,,,1633
5b8274eb5f268798416d234e5105ba83a1675c80,0,Jeff Eastman,2010-05-19 15:25:25+00:00,['ed5ef48601e132b973a90168b3cdce5aac9eab0e'],8,2,10,745964,2,1,1,0,1633
5dde0ca5287cf6003a2948b5940119edda932012,1,Andrew L. Farris,2010-05-20 02:12:43+00:00,['5b8274eb5f268798416d234e5105ba83a1675c80'],21,20,41,746005,1,,,,1633
530cfbfa496e29e3d939ede323fa4def2fe766d5,1,Sean R. Owen,2010-05-22 16:52:05+00:00,['5dde0ca5287cf6003a2948b5940119edda932012'],2,53,55,746060,4,,,,1633
96d5647f79c723715fc1f276346a56b487268a81,1,Jeff Eastman,2010-05-23 15:22:28+00:00,['530cfbfa496e29e3d939ede323fa4def2fe766d5'],34,46,80,746140,10,0,0.666666667,0,1633
71ec577800d2700b46cbb7482577deb074e137e7,1,Jeff Eastman,2010-05-23 20:17:10+00:00,['96d5647f79c723715fc1f276346a56b487268a81'],1,1,2,746142,1,,,,1633
a7c50b83956774709a02ce56b023e60a73c04571,0,Jeff Eastman,2010-05-23 22:30:05+00:00,['71ec577800d2700b46cbb7482577deb074e137e7'],1,9,10,746152,1,0,1,0,1633
48332a4260d85693d84c07105e7dbefe835bff47,1,Sean R. Owen,2010-05-24 22:44:51+00:00,['a7c50b83956774709a02ce56b023e60a73c04571'],604,759,1363,747515,43,1,1,1,1638
1e7d5eec0f736d703a73228aecf3db50b9b3720e,0,Robin Anil,2010-05-25 20:46:21+00:00,['48332a4260d85693d84c07105e7dbefe835bff47'],1,26,27,747542,2,,,,1639
4228fa47002df629b540b872daf0c03a88fb244e,0,Robin Anil,2010-05-25 21:26:14+00:00,['1e7d5eec0f736d703a73228aecf3db50b9b3720e'],1,1,2,747544,1,,,,1639
00dc9346a4cbb936e0a6a564d5cd556e931cf4da,0,Robin Anil,2010-05-26 00:21:38+00:00,['4228fa47002df629b540b872daf0c03a88fb244e'],2,5,7,747551,1,0,1,1,1639
2e49d08ca4c49eda82eb68cf04563707e80d7476,0,Robin Anil,2010-05-26 01:56:51+00:00,['00dc9346a4cbb936e0a6a564d5cd556e931cf4da'],1,1,2,747553,1,,,,1639
7e14bc6d22fe6bf2916615b1f0722931711d68eb,0,Robin Anil,2010-05-26 02:02:28+00:00,['2e49d08ca4c49eda82eb68cf04563707e80d7476'],1,1,2,747555,1,,,,1639
0357f87ef42f892640f3c020980b34d5424f7ce8,1,Robin Anil,2010-05-26 05:35:22+00:00,['7e14bc6d22fe6bf2916615b1f0722931711d68eb'],41,21,62,747617,4,,,,1639
de75a29fc4849dd5a700410aaa40674eaa724575,0,Sean R. Owen,2010-05-26 07:10:50+00:00,['0357f87ef42f892640f3c020980b34d5424f7ce8'],152,0,152,747769,1,0.260869565,0,0,1639
db9e80cf4be0694f76477736d02e6cf5b5290637,0,Jeff Eastman,2010-05-26 16:36:08+00:00,['de75a29fc4849dd5a700410aaa40674eaa724575'],5,7,12,747781,6,0,0.833333333,1,1639
0d4077c53a79a61bea50dc0bc139887fdfe672d8,0,Robin Anil,2010-05-26 17:27:00+00:00,['db9e80cf4be0694f76477736d02e6cf5b5290637'],1,0,1,747782,1,,,,1639
95ab66ffc698968dfc7e8910e37d138f5ea2f243,1,Sean R. Owen,2010-05-26 18:59:02+00:00,['0d4077c53a79a61bea50dc0bc139887fdfe672d8'],786,629,1415,749197,42,0,0,1,1639
c92666f3a7c0ea647fb94606f45ce9b108440a44,1,Sean R. Owen,2010-05-26 19:15:39+00:00,['95ab66ffc698968dfc7e8910e37d138f5ea2f243'],24,227,251,749448,3,0,1,1,1640
4d270caf64e8aa53684ce637ac89824dc6efe6f4,0,Sean R. Owen,2010-05-26 20:35:44+00:00,['c92666f3a7c0ea647fb94606f45ce9b108440a44'],1,1,2,749450,1,,,,1640
c8fecd2f3dbbc092a8f61510ddc0204f05d9603c,0,Grant Ingersoll,2010-05-27 13:40:40+00:00,['4d270caf64e8aa53684ce637ac89824dc6efe6f4'],21,24,45,749495,1,,,,1640
e970c0bf3293730da363416e9251930a8bae88eb,0,Grant Ingersoll,2010-05-27 14:12:08+00:00,['c8fecd2f3dbbc092a8f61510ddc0204f05d9603c'],0,0,0,749495,1,,,,1640
891782dbb4005f0e158d1f155918c71cc14a0ec4,0,Grant Ingersoll,2010-05-27 15:36:52+00:00,['e970c0bf3293730da363416e9251930a8bae88eb'],3,5,8,749503,1,,,,1640
4ef4dc725dea6f8a9f1b3f72f3e82cd8254354ce,1,Sean R. Owen,2010-05-27 18:02:20+00:00,['891782dbb4005f0e158d1f155918c71cc14a0ec4'],511,441,952,750455,132,1,1,0.210526316,1640
0e1fcf6cf220576c1ed87dca7663087815a76a21,0,Sean R. Owen,2010-05-28 15:44:27+00:00,['4ef4dc725dea6f8a9f1b3f72f3e82cd8254354ce'],10,10,20,750475,5,,,,1640
48eac3d6ba656554da5274431505f60f1f796531,0,Grant Ingersoll,2010-05-28 18:39:34+00:00,['0e1fcf6cf220576c1ed87dca7663087815a76a21'],1,6,7,750482,1,1,1,0,1640
f824f90d5eb76383e5e38227958bc1b0388259ed,1,Sean R. Owen,2010-05-28 20:03:36+00:00,['48eac3d6ba656554da5274431505f60f1f796531'],1215,1387,2602,753084,184,0.135746606,0.914027149,0.20361991,1640
aa861a5018495d48ddd16f95b4e715747db06fe4,0,Andrew L. Farris,2010-05-31 02:04:01+00:00,['f824f90d5eb76383e5e38227958bc1b0388259ed'],4,4,8,753092,2,,,,1640
3a1cc8a7de554d108f0fa5c61fcb9eeb43308d8d,0,Sean R. Owen,2010-05-31 13:48:33+00:00,['aa861a5018495d48ddd16f95b4e715747db06fe4'],16,13,29,753121,2,,,,1640
7d55afa1222190ce01b893c3355e355e51b6840d,0,Sean R. Owen,2010-05-31 14:37:38+00:00,['3a1cc8a7de554d108f0fa5c61fcb9eeb43308d8d'],10,6,16,753137,1,1,0,0.2,1640
641a6993653e3f920724761ae504bd4428c9a06d,1,Sean R. Owen,2010-06-01 12:55:49+00:00,['7d55afa1222190ce01b893c3355e355e51b6840d'],18,51,69,753206,4,0.238095238,0.333333333,1,1640
625ea72a7aea8e20f8f82665567a7b4d12672e4b,1,Ted Dunning,2010-06-02 05:52:23+00:00,['641a6993653e3f920724761ae504bd4428c9a06d'],555,763,1318,754524,20,0.157894737,1,1,1641
bf9e2556131bc8a4d00462691f716920121af9c8,1,Sean R. Owen,2010-06-02 12:36:10+00:00,['625ea72a7aea8e20f8f82665567a7b4d12672e4b'],49,200,249,754773,16,0.574257426,1,0.683168317,1641
ad2817beb235f8f24b7e73feac2ad717346bcd6f,1,Sean R. Owen,2010-06-02 12:37:36+00:00,['bf9e2556131bc8a4d00462691f716920121af9c8'],565,516,1081,755854,66,1,1,0.2,1641
db1208973c21061f2af548ec3407ff11656d9e37,0,Andrew L. Farris,2010-06-03 12:55:20+00:00,['ad2817beb235f8f24b7e73feac2ad717346bcd6f'],0,9,9,755863,6,0,0.75,1,1641
2eb0fdea836e077efb5350d41edef797903b2ed2,0,Sean R. Owen,2010-06-03 21:00:15+00:00,['db1208973c21061f2af548ec3407ff11656d9e37'],1,13,14,755877,1,,,,1641
69e9aa7bede6877cd792793c72c6a9b6b240eb20,1,Ted Dunning,2010-06-05 07:04:22+00:00,['2eb0fdea836e077efb5350d41edef797903b2ed2'],23,20,43,755920,5,0,0,0,1641
9d5bf2d5e6bcfb4cea7eb259fbe73ca740584e31,0,Sean R. Owen,2010-06-07 15:30:20+00:00,['69e9aa7bede6877cd792793c72c6a9b6b240eb20'],0,2,2,755922,1,1,1,1,1641
5ce11fb7735a24894cc07e0c8545e98f29b90e11,1,Andrew L. Farris,2010-06-08 02:20:01+00:00,['9d5bf2d5e6bcfb4cea7eb259fbe73ca740584e31'],305,416,721,756643,14,1,0.515151515,0,1641
3a445f7fdedb0b025d1a311b22ed63e1fd1345be,1,Sean R. Owen,2010-06-08 11:41:33+00:00,['5ce11fb7735a24894cc07e0c8545e98f29b90e11'],66,33,99,756742,2,0,1,0,1641
db4c0c4a57f87671bdaccf9756cf97bf7378d209,1,Jeff Eastman,2010-06-08 18:07:59+00:00,['3a445f7fdedb0b025d1a311b22ed63e1fd1345be'],274,367,641,757383,22,1,0,1,1644
611e74f8207eec4f84f77cb9357c1b261c054885,1,Sean R. Owen,2010-06-08 21:55:36+00:00,['db4c0c4a57f87671bdaccf9756cf97bf7378d209'],11,13,24,757407,1,,,,1644
b5707dda706b8e4be4c941f4bdc9fa06e7489116,1,Jeff Eastman,2010-06-09 01:06:51+00:00,['611e74f8207eec4f84f77cb9357c1b261c054885'],329,312,641,758048,11,0.214285714,0.214285714,1,1644
7c1f5dfc55524542aebbd9958793f36585f7380f,0,Sean R. Owen,2010-06-09 17:00:59+00:00,['b5707dda706b8e4be4c941f4bdc9fa06e7489116'],103,138,241,758289,2,0.857142857,0.857142857,0,1644
69ee3e552f9319f5fb6a8475ab55e80534146d8e,1,Jeff Eastman,2010-06-09 21:18:37+00:00,['7c1f5dfc55524542aebbd9958793f36585f7380f'],291,266,557,758846,10,0.918918919,0,1,1644
964db4a8ae51fb0d896dcd03836c6056ff317898,1,Jeff Eastman,2010-06-10 22:25:49+00:00,['69ee3e552f9319f5fb6a8475ab55e80534146d8e'],258,258,516,759362,7,0.933333333,0,1,1644
88c5af99ce20151ca2a8f4fb476db9db0f8a1708,1,Jacob Alexander Mannix,2010-06-10 22:34:27+00:00,['964db4a8ae51fb0d896dcd03836c6056ff317898'],3,22,25,759387,4,0.833333333,1,0,1645
fae0f2d40cbbf027c303bb130fc8b48596946890,1,Jeff Eastman,2010-06-10 23:28:12+00:00,['88c5af99ce20151ca2a8f4fb476db9db0f8a1708'],426,239,665,760052,12,1,0.060606061,0.444444444,1645
0497f91ce4e03a7855d500cfad0dccddd2f61d21,1,Sean R. Owen,2010-06-11 11:07:05+00:00,['fae0f2d40cbbf027c303bb130fc8b48596946890'],106,74,180,760232,13,1,0.2,0,1645
8fba6529a1a4beafe6e43bd8300f7a1594c5c14f,1,Sean R. Owen,2010-06-11 11:17:09+00:00,['0497f91ce4e03a7855d500cfad0dccddd2f61d21'],21,29,50,760282,2,0.6,0.6,1,1645
d99b6780a5c58ee7fd4c54b2a1caa763f76c28e1,0,Sean R. Owen,2010-06-11 11:34:10+00:00,['8fba6529a1a4beafe6e43bd8300f7a1594c5c14f'],26,360,386,760668,4,1,1,1,1647
32f5f0940dabce67113be97b15a87cbb52e5ce5c,1,Ted Dunning,2010-06-11 21:14:23+00:00,['d99b6780a5c58ee7fd4c54b2a1caa763f76c28e1'],0,13,13,760681,1,1,1,1,1647
daa77420b2c5a83be1fca5d584c414e189f2a446,0,Sean R. Owen,2010-06-13 15:33:56+00:00,['32f5f0940dabce67113be97b15a87cbb52e5ce5c'],5,5,10,760691,1,1,1,0,1647
71850f26e96311afcf9d1029a62ac47d07cdf0d8,1,Sean R. Owen,2010-06-16 10:00:55+00:00,['daa77420b2c5a83be1fca5d584c414e189f2a446'],3712,168,3880,764571,40,0.536727273,0.132363636,0.28,1649
6cb5b69946c6ed51c53051656d78f2736aa7d8db,1,Jeff Eastman,2010-06-16 15:10:58+00:00,['71850f26e96311afcf9d1029a62ac47d07cdf0d8'],718,1028,1746,766317,24,0.65625,0,0.953125,1651
a604dad3013fbce19c3f0ea63f8bbb27d945cf4f,0,Sean R. Owen,2010-06-16 18:37:15+00:00,['6cb5b69946c6ed51c53051656d78f2736aa7d8db'],0,12,12,766329,1,1,1,0,1651
7455cab2a8cc433836f800c25d0bc3628f87fccd,0,Jeff Eastman,2010-06-16 20:43:35+00:00,['a604dad3013fbce19c3f0ea63f8bbb27d945cf4f'],47,97,144,766473,6,0,1,0.714285714,1652
6be26c7f4a04d63be6d8831ca8501ed954970042,0,Sean R. Owen,2010-06-16 21:38:34+00:00,['7455cab2a8cc433836f800c25d0bc3628f87fccd'],6,4,10,766483,1,0,0,1,1652
6ce1a40c38c7ed565093913fc64dad27af19cccd,1,Sean R. Owen,2010-06-17 06:24:28+00:00,['6be26c7f4a04d63be6d8831ca8501ed954970042'],8,577,585,767068,7,0.582706767,0.864661654,0.890977444,1657
88652b9b2188d9df14c434663128d5b077617bba,0,Sean R. Owen,2010-06-21 06:37:04+00:00,['6ce1a40c38c7ed565093913fc64dad27af19cccd'],2,5,7,767075,2,,,,1657
2462a10ee707940b10a7fc602ffa2dfa958d0d7c,0,Sean R. Owen,2010-06-22 06:45:54+00:00,['88652b9b2188d9df14c434663128d5b077617bba'],11,15,26,767101,1,0,0,1,1657
dcf2924e4f645dfc6048c48b3cdb973ee10474b4,0,Sean R. Owen,2010-06-22 16:48:54+00:00,['2462a10ee707940b10a7fc602ffa2dfa958d0d7c'],10,293,303,767404,13,0.440366972,0.440366972,1,1658
f77d59d3d850cd43be4b5257378bd9cda747c767,0,Sean R. Owen,2010-06-22 17:16:24+00:00,['dcf2924e4f645dfc6048c48b3cdb973ee10474b4'],30,45,75,767479,3,1,1,0,1658
639f2dee3e127c737f3e47c821b6238bcec9fd34,1,Sean R. Owen,2010-06-28 09:41:09+00:00,['f77d59d3d850cd43be4b5257378bd9cda747c767'],1750,2370,4120,771599,49,0.576,1,0.56,1675
5d0f8fbc99042d55bd39bb5222769d51d2609565,0,Sean R. Owen,2010-06-28 19:37:20+00:00,['639f2dee3e127c737f3e47c821b6238bcec9fd34'],1,2,3,771602,1,0,0,0,1675
f63257710f2caeb697f47522abe70b67296d4b2d,0,Sean R. Owen,2010-06-29 08:09:12+00:00,['5d0f8fbc99042d55bd39bb5222769d51d2609565'],9,57,66,771668,2,0,0.513513514,1,1675
74735db0c1b9f01eb7fc39376e9de26278b3d5b6,0,Robin Anil,2010-06-30 05:12:38+00:00,['f63257710f2caeb697f47522abe70b67296d4b2d'],1,1,2,771670,1,,,,1675
1ec084c1bff93440ce33bd1460260b36373399a9,1,Grant Ingersoll,2010-06-30 19:02:56+00:00,['74735db0c1b9f01eb7fc39376e9de26278b3d5b6'],5,18,23,771693,2,0.3,1,0.8,1675
95e5e49d678e9c9f90fb3877746bc2e93e293d57,0,Grant Ingersoll,2010-07-01 12:52:37+00:00,['1ec084c1bff93440ce33bd1460260b36373399a9'],1,8,9,771702,1,0,0,1,1675
45cebc427d31070ef01e9d660da10dea81f40604,1,Sean R. Owen,2010-07-01 21:08:24+00:00,['95e5e49d678e9c9f90fb3877746bc2e93e293d57'],596,329,925,772627,95,0,0.095238095,0,1675
7097e25f0f864e6e708243191e2d5b78203ecbab,1,Andrew L. Farris,2010-07-02 02:43:48+00:00,['45cebc427d31070ef01e9d660da10dea81f40604'],1,2,3,772630,1,,,,1675
c40f860ad3b3526e882c84b7fa18e1752ae24ddc,1,Sean R. Owen,2010-07-05 12:01:26+00:00,['7097e25f0f864e6e708243191e2d5b78203ecbab'],9,43,52,772682,2,0,0,0.875,1675
59ce155dfe66a8611de87fdd0b035bbad40a130c,1,Grant Ingersoll,2010-07-05 14:19:22+00:00,['c40f860ad3b3526e882c84b7fa18e1752ae24ddc'],0,5,5,772687,1,0,0,1,1675
ecc4cc76e84a3ea80b28cbeba58e05f6e637bdab,0,Grant Ingersoll,2010-07-05 19:08:47+00:00,['59ce155dfe66a8611de87fdd0b035bbad40a130c'],4,17,21,772708,2,0,1,1,1675
5698bdd64e0c2107924d15f930497f7766682d19,0,Grant Ingersoll,2010-07-05 21:34:09+00:00,['ecc4cc76e84a3ea80b28cbeba58e05f6e637bdab'],1,1,2,772710,1,,,,1675
508f7815fb67a6520bf4e4d7781d98a4b05dbc66,1,Grant Ingersoll,2010-07-05 21:47:03+00:00,['5698bdd64e0c2107924d15f930497f7766682d19'],45,61,106,772816,1,0.058823529,0.058823529,1,1675
0acff21d032d4e12545b84cf2d0aa92b16500fb9,0,Ted Dunning,2010-07-06 16:59:23+00:00,['508f7815fb67a6520bf4e4d7781d98a4b05dbc66'],0,1,1,772817,1,0,1,0,1675
a7f82c97696625a5f0add0d2b22540141987ef29,1,Jeff Eastman,2010-07-07 18:46:19+00:00,['0acff21d032d4e12545b84cf2d0aa92b16500fb9'],1006,998,2004,774821,32,0.523809524,0,1,1676
44dbc4f2acb9c5ae6fc7ae481c18bddf187dc19e,0,Jeff Eastman,2010-07-07 21:58:16+00:00,['a7f82c97696625a5f0add0d2b22540141987ef29'],0,0,0,774821,2,,,,1676
97f9beb0ee587d0fa9843c3d1d79cfc5f5ad5f2b,1,Jeff Eastman,2010-07-07 23:21:00+00:00,['44dbc4f2acb9c5ae6fc7ae481c18bddf187dc19e'],243,289,532,775353,9,0,0.550561798,1,1676
d701a675ff403aeca46f1268c7d12414ae49da92,1,Andrew L. Farris,2010-07-07 23:39:44+00:00,['97f9beb0ee587d0fa9843c3d1d79cfc5f5ad5f2b'],91,103,194,775547,5,1,1,0,1676
cb4a14acebd7a8d0f5fb5b14b5abea4db218a47c,0,Andrew L. Farris,2010-07-07 23:41:46+00:00,['d701a675ff403aeca46f1268c7d12414ae49da92'],12,303,315,775862,2,0,0.943005181,0.989637306,1677
644abbf6daecf009704964ac85c1bfa79f96331a,1,Andrew L. Farris,2010-07-08 00:04:49+00:00,['cb4a14acebd7a8d0f5fb5b14b5abea4db218a47c'],1,3,4,775866,1,0,1,0,1677
4f0ddbda9efb1b3e9dfbea9f2103cebd828e685d,1,Jeff Eastman,2010-07-08 00:58:10+00:00,['644abbf6daecf009704964ac85c1bfa79f96331a'],56,41,97,775963,14,0,0,1,1677
1a03fe87d166440650ab32cd60a2a407c42d5b8f,1,Andrew L. Farris,2010-07-08 12:43:17+00:00,['4f0ddbda9efb1b3e9dfbea9f2103cebd828e685d'],4,34,38,776001,1,,,,1677
d3226b811fc8ce6b00fc6594e383df79251ba0eb,0,Robin Anil,2010-07-08 12:57:30+00:00,['1a03fe87d166440650ab32cd60a2a407c42d5b8f'],1,1,2,776003,1,,,,1677
bedb0216ed3e4d50b247a3228d06bc4a57df0e8b,0,Jeff Eastman,2010-07-08 18:56:58+00:00,['d3226b811fc8ce6b00fc6594e383df79251ba0eb'],64,57,121,776124,4,0,0,0,1677
93a672ca0d1d7e0cb1cf53fcba9999c167830f50,1,Sean R. Owen,2010-07-08 19:19:53+00:00,['bedb0216ed3e4d50b247a3228d06bc4a57df0e8b'],481,1293,1774,777898,21,0.397727273,0.679545455,0.938636364,1681
e7566a06a3d86782336eaeed7004630731b690a9,0,Jeff Eastman,2010-07-09 17:14:20+00:00,['93a672ca0d1d7e0cb1cf53fcba9999c167830f50'],140,149,289,778187,12,1,1,1,1681
571a6e9a0117726b5d15f83d7bcd46ff0cc580a9,0,Jeff Eastman,2010-07-10 01:25:32+00:00,['e7566a06a3d86782336eaeed7004630731b690a9'],683,254,937,779124,14,0.336734694,0,0,1683
c81292ec7522e829c85fed1df5ae17e4849d18f1,0,Jeff Eastman,2010-07-10 02:32:38+00:00,['571a6e9a0117726b5d15f83d7bcd46ff0cc580a9'],6,51,57,779181,10,1,1,1,1683
6fa7225686f34c8f77e843e115e2bda08f70996b,0,Ted Dunning,2010-07-11 01:02:50+00:00,['c81292ec7522e829c85fed1df5ae17e4849d18f1'],2,8,10,779191,1,0,0,1,1683
f798e278b2589dea5f79c43d653beb65dfe88913,1,Ted Dunning,2010-07-11 06:47:54+00:00,['6fa7225686f34c8f77e843e115e2bda08f70996b'],16,145,161,779352,4,0.217391304,0.75,1,1683
1084b172cadd9f83860c8e9682af5a3703939cac,0,Sean R. Owen,2010-07-11 22:55:18+00:00,['f798e278b2589dea5f79c43d653beb65dfe88913'],5,5,10,779362,2,,,,1683
4799a594388ac2fd70c417b736f0f8542ee32409,0,Sean R. Owen,2010-07-12 11:54:39+00:00,['1084b172cadd9f83860c8e9682af5a3703939cac'],28,75,103,779465,5,0,0,1,1684
0971a5397dd848f5ca34e9e65e6addefd2b7fd3f,0,Andrew L. Farris,2010-07-13 02:35:03+00:00,['4799a594388ac2fd70c417b736f0f8542ee32409'],12,12,24,779489,1,,,,1684
2b4f74cd17260e67093e77047814160634a53392,1,Jeff Eastman,2010-07-13 19:47:30+00:00,['0971a5397dd848f5ca34e9e65e6addefd2b7fd3f'],9,18,27,779516,7,0,1,0.111111111,1684
ab87ea2805946b5e3c5d380b10b57bf7d11e84bd,0,Sean R. Owen,2010-07-15 10:14:04+00:00,['2b4f74cd17260e67093e77047814160634a53392'],5,21,26,779542,2,0.3,0,1,1684
0ffe1b1fd3da1ba87b1c4957907ee5d3a3e2fbda,0,Sean R. Owen,2010-07-15 11:17:48+00:00,['ab87ea2805946b5e3c5d380b10b57bf7d11e84bd'],1,0,1,779543,1,,,,1684
a14c9cb094b7b5745ecd82110fc759c6466d41c0,1,Jeff Eastman,2010-07-15 17:53:51+00:00,['0ffe1b1fd3da1ba87b1c4957907ee5d3a3e2fbda'],1127,1470,2597,782140,21,0.017699115,1,0,1685
808ea0425edd408293700054706052ecb6865985,1,Jeff Eastman,2010-07-15 19:03:20+00:00,['a14c9cb094b7b5745ecd82110fc759c6466d41c0'],24,40,64,782204,5,1,1,1,1685
4a734131d3b064b1821a3bb25c0346e0bc30d145,0,Jeff Eastman,2010-07-16 01:31:39+00:00,['808ea0425edd408293700054706052ecb6865985'],35,18,53,782257,4,1,0,0,1685
a3f65c88044dd3d8bbb94e84cf32ca44562d2469,0,Sean R. Owen,2010-07-17 21:17:45+00:00,['4a734131d3b064b1821a3bb25c0346e0bc30d145'],35,294,329,782586,8,0.66,1,1,1688
a69d7b38727078309a3d630def4ee2f87337a19e,1,Jeff Eastman,2010-07-19 19:06:14+00:00,['a3f65c88044dd3d8bbb94e84cf32ca44562d2469'],532,466,998,783584,22,1,1,0,1688
cfdebc84619d3df3cf52bca79dab98269d4e8899,1,Ted Dunning,2010-07-21 22:37:51+00:00,['a69d7b38727078309a3d630def4ee2f87337a19e'],157,342,499,784083,7,0.5,0.224137931,0.706896552,1689
5a5a0c48342577696ba72d84ae41bb3d640d187f,1,Ted Dunning,2010-07-22 00:59:03+00:00,['cfdebc84619d3df3cf52bca79dab98269d4e8899'],0,292,292,784375,2,0.511764706,0.858823529,0.970588235,1691
f7dd64cedc905f6941bdb3bd794140d070d6d893,1,Jeff Eastman,2010-07-22 01:28:42+00:00,['5a5a0c48342577696ba72d84ae41bb3d640d187f'],589,1398,1987,786362,23,0.207459207,1,0.184149184,1691
f41456bf87a9852ad18a3a97d1494fe3336f31c5,0,Ted Dunning,2010-07-22 16:09:02+00:00,['f7dd64cedc905f6941bdb3bd794140d070d6d893'],10,11,21,786383,1,1,0,0,1691
d01c26a4b7e2845668bc0873aa9f95137cdd5c95,1,Jeff Eastman,2010-07-22 19:25:20+00:00,['f41456bf87a9852ad18a3a97d1494fe3336f31c5'],243,1228,1471,787854,15,0.2,0.881538462,0.324615385,1691
a69d070e85313ea33c91fe9eed72e9e23bba6822,1,Andrew L. Farris,2010-07-23 13:09:00+00:00,['d01c26a4b7e2845668bc0873aa9f95137cdd5c95'],0,1267,1267,789121,5,0.3025,0.38875,0.9775,1696
5a06fc07904e6770abc315e7640d284598f18307,0,Andrew L. Farris,2010-07-23 20:40:51+00:00,['a69d070e85313ea33c91fe9eed72e9e23bba6822'],3,15,18,789139,8,0.1,1,0.2,1696
f7a66839cbf2b2531699d326a855a4d84564a233,0,Andrew L. Farris,2010-07-23 20:50:04+00:00,['5a06fc07904e6770abc315e7640d284598f18307'],0,1,1,789140,1,0,1,0,1696
b64eb1cc7459f94a0140304e658e6faf97191b7f,0,Andrew L. Farris,2010-07-23 23:42:42+00:00,['f7a66839cbf2b2531699d326a855a4d84564a233'],0,5,5,789145,4,0.5,1,0,1696
b7ef42cb0afc1ecc8ca280e10c6d84be4e1d42f3,0,Andrew L. Farris,2010-07-23 23:51:19+00:00,['b64eb1cc7459f94a0140304e658e6faf97191b7f'],0,1,1,789146,1,0,0,1,1696
b3ba49c381d8fb155b887d4eb89c828b8c0bd722,1,Jeff Eastman,2010-07-24 03:39:30+00:00,['b7ef42cb0afc1ecc8ca280e10c6d84be4e1d42f3'],1197,972,2169,791315,49,0,0,0,1699
5a986a3cf882927eb65f59066161989c97ab5f36,0,Ted Dunning,2010-07-24 03:59:08+00:00,['b3ba49c381d8fb155b887d4eb89c828b8c0bd722'],1,10,11,791326,3,0,0,1,1700
91456bb2aab251b8512b41b48726fe0550d25cfa,1,Ted Dunning,2010-07-24 23:38:28+00:00,['5a986a3cf882927eb65f59066161989c97ab5f36'],420,5526,5946,797272,56,0.417910448,0.775186567,0.890391791,1752
f4c8f73fce2f184612db3a837a180c9c2689b889,1,Ted Dunning,2010-07-24 23:54:26+00:00,['91456bb2aab251b8512b41b48726fe0550d25cfa'],5528,422,5950,803222,56,0.582089552,0.224813433,0.109608209,1752
1d47b6f7b71812bba4ef8dd2ba09410dade0d063,1,Ted Dunning,2010-07-27 06:39:08+00:00,['f4c8f73fce2f184612db3a837a180c9c2689b889'],175,1406,1581,804803,11,0.118811881,0.851485149,1,1756
622a9045889e73beaaad1d23d7e7dc63fefe7780,1,Sean R. Owen,2010-07-31 14:15:10+00:00,['1d47b6f7b71812bba4ef8dd2ba09410dade0d063'],24,453,477,805280,12,0.357723577,1,0.772357724,1763
5eb9b167bdaf83b2199e42e0b30576c6160629ec,0,Sean R. Owen,2010-07-31 14:26:54+00:00,['622a9045889e73beaaad1d23d7e7dc63fefe7780'],1,6,7,805287,1,,,,1763
c09306664f27c222f21c1528bb65848cc676dcd3,1,Ted Dunning,2010-08-03 00:12:23+00:00,['5eb9b167bdaf83b2199e42e0b30576c6160629ec'],68,259,327,805614,7,0.657407407,1,1,1763
a6f25769c57d27be81ff030704fdff22071790f3,1,Ted Dunning,2010-08-03 03:30:46+00:00,['c09306664f27c222f21c1528bb65848cc676dcd3'],0,253,253,805867,3,0.836734694,1,0.806122449,1766
5deeadd52fd9d781619c96fe1d93df666f2a8109,1,Jacob Alexander Mannix,2010-08-06 00:12:18+00:00,['a6f25769c57d27be81ff030704fdff22071790f3'],2,21,23,805890,1,0,1,1,1766
4b8c14bdb7c5efe3f97aedb485233d6669da5a97,0,Jacob Alexander Mannix,2010-08-06 01:02:00+00:00,['5deeadd52fd9d781619c96fe1d93df666f2a8109'],1,1,2,805892,1,,,,1766
f30de5ca80829958171b3102f678ed831eaa46fe,1,Andrew L. Farris,2010-08-09 02:33:24+00:00,['4b8c14bdb7c5efe3f97aedb485233d6669da5a97'],12,527,539,806431,13,0.38,0.512,0.648,1770
3fb713293baa218477bda020daa9f867f70dd4fb,0,Andrew L. Farris,2010-08-10 13:11:06+00:00,['f30de5ca80829958171b3102f678ed831eaa46fe'],106,97,203,806634,5,1,1,0,1770
25d94c3e7ff7c37b5ec65f476c331ce92f39988b,0,Andrew L. Farris,2010-08-10 16:41:41+00:00,['3fb713293baa218477bda020daa9f867f70dd4fb'],0,1,1,806635,1,,,,1770
d9b6358bb1f0730038e3683552b2d3812cbd22ec,1,Sean R. Owen,2010-08-10 17:00:13+00:00,['25d94c3e7ff7c37b5ec65f476c331ce92f39988b'],438,224,662,807297,45,0,0,0,1770
2dbcb6df9e0ee6db81ba82e35fa2e2de6763e405,1,Sean R. Owen,2010-08-10 17:16:24+00:00,['d9b6358bb1f0730038e3683552b2d3812cbd22ec'],5,4,9,807306,2,,,,1770
0a8908e73d282173a713fd2d1f81e80fe0edfc05,0,Sean R. Owen,2010-08-10 17:22:11+00:00,['2dbcb6df9e0ee6db81ba82e35fa2e2de6763e405'],29,12,41,807347,1,1,1,0,1770
d07a964f1fbe4923ab2cec1775eab85a9f3437ce,0,Andrew L. Farris,2010-08-11 00:55:34+00:00,['0a8908e73d282173a713fd2d1f81e80fe0edfc05'],6,8,14,807361,3,0,1,1,1770
0ead4c80b56f9f96c8f3f07b2dc95f2eeef98a55,1,Andrew L. Farris,2010-08-11 02:33:29+00:00,['d07a964f1fbe4923ab2cec1775eab85a9f3437ce'],8,14,22,807383,3,,,,1770
aa84f9b8135fce4dc0131c01e6e04f86a496114c,1,Ted Dunning,2010-08-12 02:51:28+00:00,['0ead4c80b56f9f96c8f3f07b2dc95f2eeef98a55'],5,38,43,807426,2,0.230769231,1,0.884615385,1770
2b14be2eb134d16be0cf20704af38122a3f68232,1,Ted Dunning,2010-08-12 22:36:36+00:00,['aa84f9b8135fce4dc0131c01e6e04f86a496114c'],3,418,421,807847,4,0.221238938,0.85840708,0.946902655,1772
29af4d71dcaa2d95a492d5676fb6dc7a75e4fac5,1,Ted Dunning,2010-08-13 03:03:42+00:00,['2b14be2eb134d16be0cf20704af38122a3f68232'],219,191,410,808257,14,1,1,0,1772
8a4161be2d63acc80cacf990aadface9134a84f0,1,Sean R. Owen,2010-08-13 03:39:46+00:00,['29af4d71dcaa2d95a492d5676fb6dc7a75e4fac5'],13,28,41,808298,3,0.875,0.875,0.5,1772
f5f286e074aafb513ae51bf8a06cb0398cc739e9,0,Jacob Alexander Mannix,2010-08-13 05:02:58+00:00,['8a4161be2d63acc80cacf990aadface9134a84f0'],2,2,4,808302,2,,,,1772
f85173cbdefb26974165b4f229006d4b35e2f739,0,Jacob Alexander Mannix,2010-08-13 05:12:33+00:00,['f5f286e074aafb513ae51bf8a06cb0398cc739e9'],1,1,2,808304,1,,,,1772
024261a3f609d4d40f090369d80fd1cda3d5ef9e,1,Sean R. Owen,2010-08-13 18:19:16+00:00,['f85173cbdefb26974165b4f229006d4b35e2f739'],661,455,1116,809420,84,1,0.902439024,0,1772
bfa4da7277221d064cb00ba3af370171fef72caa,1,Sean R. Owen,2010-08-13 18:20:53+00:00,['024261a3f609d4d40f090369d80fd1cda3d5ef9e'],7,94,101,809521,6,0.322033898,0.898305085,0.949152542,1772
6de4710d460494ed9d4ab20766f93c609373844c,1,Sean R. Owen,2010-08-13 18:25:04+00:00,['bfa4da7277221d064cb00ba3af370171fef72caa'],241,494,735,810256,14,0.346666667,1,0.206666667,1772
dda346445586dc52ea4a7f2888d2c09da7f05e5b,0,Sean R. Owen,2010-08-13 19:32:41+00:00,['6de4710d460494ed9d4ab20766f93c609373844c'],7,9,16,810272,1,0,1,0,1772
b0d9fb594cc3619a4644709e91baf95d569c229d,0,Sean R. Owen,2010-08-13 19:32:53+00:00,['dda346445586dc52ea4a7f2888d2c09da7f05e5b'],11,2,13,810285,2,0,0,1,1772
a492d4a7c60712e003f25752d84e7ed4a8eb4cc4,0,Sean R. Owen,2010-08-14 00:13:23+00:00,['b0d9fb594cc3619a4644709e91baf95d569c229d'],21,21,42,810327,7,,,,1772
d9a3043b0459271e7bebee3ad9a0033e537acfe6,1,Andrew L. Farris,2010-08-14 00:30:47+00:00,['a492d4a7c60712e003f25752d84e7ed4a8eb4cc4'],0,837,837,811164,2,0.405034325,0.542334096,0.961098398,1774
aec18185d718dc04d4c5e53ddb3cc3e5825db386,1,Sean R. Owen,2010-08-14 19:09:09+00:00,['d9a3043b0459271e7bebee3ad9a0033e537acfe6'],454,364,818,811982,61,0.353333333,0.346666667,0.3,1774
719772b4d8ce5d160f12048f2f2c0382ae63d078,1,Ted Dunning,2010-08-14 21:19:02+00:00,['aec18185d718dc04d4c5e53ddb3cc3e5825db386'],499,479,978,812960,2,0.333333333,0.142857143,0,1774
e67810fed1958e7dd966539bdbcc9c3c6fa72bfe,0,Sebastian Schelter,2010-08-14 23:54:57+00:00,['719772b4d8ce5d160f12048f2f2c0382ae63d078'],1,1,2,812962,1,,,,1774
611d287e8da9e5023a0bea99a66b50734a6d6027,1,Ted Dunning,2010-08-15 07:02:46+00:00,['e67810fed1958e7dd966539bdbcc9c3c6fa72bfe'],127,130,257,813219,1,,,,1774
bb9ed914abc456aba8fc14af5ab03edcc017fb9b,0,Ted Dunning,2010-08-15 07:02:48+00:00,['611d287e8da9e5023a0bea99a66b50734a6d6027'],82,79,161,813380,1,1,1,0,1774
803b893527b56f5dcbe4316a3e51daf05f08de50,0,Sean R. Owen,2010-08-16 00:32:20+00:00,['bb9ed914abc456aba8fc14af5ab03edcc017fb9b'],0,10,10,813390,1,1,1,1,1774
555f1f636b608d7d72ad79ad91f56f29d3c6dc43,1,Ted Dunning,2010-08-16 14:13:47+00:00,['803b893527b56f5dcbe4316a3e51daf05f08de50'],368,319,687,814077,1,1,1,0,1774
dca7cbbd88b5f53ae435b6a32653898221150af5,0,Ted Dunning,2010-08-16 14:13:50+00:00,['555f1f636b608d7d72ad79ad91f56f29d3c6dc43'],145,130,275,814352,1,1,1,0,1774
078cde25dd55be6a57476ed438bb21d4f64dbfcf,1,Ted Dunning,2010-08-16 14:13:52+00:00,['dca7cbbd88b5f53ae435b6a32653898221150af5'],68,66,134,814486,1,1,1,0,1774
4c96b79ae7196ba48c36c8ae59018f061b91e9ee,0,Ted Dunning,2010-08-16 14:13:55+00:00,['078cde25dd55be6a57476ed438bb21d4f64dbfcf'],0,210,210,814696,2,0.653061224,1,1,1776
0c98400219fa906e1daf9e49fc35fc8d080df1e3,0,Sebastian Schelter,2010-08-16 15:19:12+00:00,['4c96b79ae7196ba48c36c8ae59018f061b91e9ee'],1,1,2,814698,1,,,,1776
bd927c9fa965fcdca99cc0f525b3f3e439fbbe66,1,Ted Dunning,2010-08-16 16:56:46+00:00,['0c98400219fa906e1daf9e49fc35fc8d080df1e3'],0,2839,2839,817537,30,0.539949537,0.86038688,0.864592094,1806
4f16e3cbfee813278904f38b50011b4ea4f90bc4,0,Ted Dunning,2010-08-16 16:56:48+00:00,['bd927c9fa965fcdca99cc0f525b3f3e439fbbe66'],0,745,745,818282,2,,,,1808
d17537375235e0124eeb5ce7de5d3818c39113a3,0,Ted Dunning,2010-08-16 20:26:59+00:00,['4f16e3cbfee813278904f38b50011b4ea4f90bc4'],1,8,9,818291,2,0.5,1,1,1808
b1dd03663c549c191d2aa61b80f0af5e5978d542,0,Ted Dunning,2010-08-17 16:22:05+00:00,['d17537375235e0124eeb5ce7de5d3818c39113a3'],142,210,352,818643,25,0.6,0.6,1,1809
a179dc4d2e98b819e992d36ae6bf2b6563d705af,0,Ted Dunning,2010-08-17 16:22:09+00:00,['b1dd03663c549c191d2aa61b80f0af5e5978d542'],6,50,56,818699,4,1,1,0.965517241,1809
79eb25360468283e525e6730a6f52b31008dd29f,0,Ted Dunning,2010-08-17 16:22:10+00:00,['a179dc4d2e98b819e992d36ae6bf2b6563d705af'],0,8,8,818707,1,,,,1809
515bac41819e209190a53c8f6b1de1db25dee575,1,Sean R. Owen,2010-08-17 17:34:14+00:00,['79eb25360468283e525e6730a6f52b31008dd29f'],4022,1315,5337,824044,169,0.698852772,0.709369025,0.111854685,1809
4a711cfb5c37680a6d606aec658fed1381b6180f,0,Jeff Eastman,2010-08-17 20:16:35+00:00,['515bac41819e209190a53c8f6b1de1db25dee575'],132,0,132,824176,1,0,0,0,1809
11b9d84cf2b148c97420ca0ca899cb1cec2ed354,1,Jeff Eastman,2010-08-17 21:25:25+00:00,['4a711cfb5c37680a6d606aec658fed1381b6180f'],35,33,68,824244,6,1,0,1,1809
fedfd0cbb41f0e28cf59d10e4178bbd273be4ef8,0,Ted Dunning,2010-08-17 22:42:20+00:00,['11b9d84cf2b148c97420ca0ca899cb1cec2ed354'],0,5,5,824249,2,1,1,1,1809
f13030431a0c1ab2a9ce434a932a96104108000e,1,Sebastian Schelter,2010-08-18 06:09:38+00:00,['fedfd0cbb41f0e28cf59d10e4178bbd273be4ef8'],320,314,634,824883,11,0,0,0.142857143,1812
f443e7f5dc9263766ae2202334437e5ef82a7d4a,0,Sebastian Schelter,2010-08-18 07:10:28+00:00,['f13030431a0c1ab2a9ce434a932a96104108000e'],8,14,22,824905,2,0,0,1,1812
70fa8025a59acb5fb90fb6c0195a8b94e11cf8a1,1,Sean R. Owen,2010-08-18 08:53:53+00:00,['f443e7f5dc9263766ae2202334437e5ef82a7d4a'],209,251,460,825365,22,0.538461538,0.807692308,1,1812
13c4f5083258b848dbd74ff38b44f8f67ccd24a1,1,Andrew L. Farris,2010-08-18 13:19:19+00:00,['70fa8025a59acb5fb90fb6c0195a8b94e11cf8a1'],4,11,15,825380,1,,,,1812
81f2e6b500fa68a3c944d19a7bdde025159f98e5,0,Ted Dunning,2010-08-18 13:34:37+00:00,['13c4f5083258b848dbd74ff38b44f8f67ccd24a1'],3,6,9,825389,4,1,1,1,1812
75613c4e6646dbaa810abd434b42b082a8306d90,0,Ted Dunning,2010-08-18 17:26:36+00:00,['81f2e6b500fa68a3c944d19a7bdde025159f98e5'],1,0,1,825390,1,,,,1812
721d1fe2b238870b85745ee5fbc0601f152f763b,0,Ted Dunning,2010-08-18 17:26:38+00:00,['75613c4e6646dbaa810abd434b42b082a8306d90'],0,7,7,825397,1,,,,1812
292bb9dcc3cc8d4a6b0f311c6d0afb7232d4b9c8,1,Ted Dunning,2010-08-18 17:26:42+00:00,['721d1fe2b238870b85745ee5fbc0601f152f763b'],0,463,463,825860,6,0.656716418,0.786069652,0.71641791,1818
adcc8ada4e2f4d028f53c3dc8210ecdede323a27,0,Ted Dunning,2010-08-18 17:26:44+00:00,['292bb9dcc3cc8d4a6b0f311c6d0afb7232d4b9c8'],0,5,5,825865,2,,,,1818
4af55522253a9f5d0b25923b4f72ab3e13fbb88b,0,Ted Dunning,2010-08-18 17:26:46+00:00,['adcc8ada4e2f4d028f53c3dc8210ecdede323a27'],2,2,4,825869,1,,,,1818
4b66c38229fcb479a44bc67bd38d51f0dddef2ee,0,Ted Dunning,2010-08-18 17:26:49+00:00,['4af55522253a9f5d0b25923b4f72ab3e13fbb88b'],2,2,4,825873,1,,,,1818
2d40bd6ebeca444f414775e4456275ad5e11044e,0,Ted Dunning,2010-08-18 21:21:39+00:00,['4b66c38229fcb479a44bc67bd38d51f0dddef2ee'],2,0,2,825875,1,,,,1818
03424784c070b28b3e6ec3fcc1fab1163d1decf3,1,Jeff Eastman,2010-08-18 21:47:30+00:00,['2d40bd6ebeca444f414775e4456275ad5e11044e'],584,738,1322,827197,50,0,0.863636364,0.068181818,1821
3bc895ff8672f6f3d00f34a5a66385fad3f7d96a,0,Ted Dunning,2010-08-19 07:26:22+00:00,['03424784c070b28b3e6ec3fcc1fab1163d1decf3'],3,12,15,827212,2,0.75,1,1,1821
a351fdf2624f25acbdbde1c338551e5f74458e31,1,Ted Dunning,2010-08-19 07:26:25+00:00,['3bc895ff8672f6f3d00f34a5a66385fad3f7d96a'],15,61,76,827288,4,1,1,1,1822
115fec691bb1c36047ea24e79bce5befb449c78d,1,Ted Dunning,2010-08-19 07:26:28+00:00,['a351fdf2624f25acbdbde1c338551e5f74458e31'],5,117,122,827410,2,0.287671233,0.616438356,0.890410959,1823
4b25f31b1c616ca86438e0690c5f411c852f2156,1,Ted Dunning,2010-08-19 07:26:33+00:00,['115fec691bb1c36047ea24e79bce5befb449c78d'],176,555,731,828141,13,0.417085427,0.613065327,0.879396985,1826
ae086da2e70abb2c89d17f9bd9f8d5343b9cbaaa,0,Ted Dunning,2010-08-19 08:22:26+00:00,['4b25f31b1c616ca86438e0690c5f411c852f2156'],1,1,2,828143,1,,,,1826
ec393c0090f12d8ddc93b3934efe0a5dbd754281,0,Ted Dunning,2010-08-19 14:49:48+00:00,['ae086da2e70abb2c89d17f9bd9f8d5343b9cbaaa'],2,6,8,828151,1,0.5,1,1,1826
090e1886c7468c87796f92b4a6d021218e8dcd6d,0,Ted Dunning,2010-08-19 16:15:05+00:00,['ec393c0090f12d8ddc93b3934efe0a5dbd754281'],1,1,2,828153,1,,,,1826
fed7d6133df15b27c2d210a784f4a0cbea7c9dda,1,Jeff Eastman,2010-08-19 17:32:49+00:00,['090e1886c7468c87796f92b4a6d021218e8dcd6d'],426,636,1062,829215,40,0.888888889,1,1,1829
c7435d3f96caaa1cdd857d608cbc44d50a44193b,1,Ted Dunning,2010-08-20 03:22:06+00:00,['fed7d6133df15b27c2d210a784f4a0cbea7c9dda'],0,82,82,829297,1,1,1,0.230769231,1830
407cfd34e013919fc5bf975fd20c1b29f18b9416,1,Ted Dunning,2010-08-20 03:23:19+00:00,['c7435d3f96caaa1cdd857d608cbc44d50a44193b'],53,70,123,829420,2,1,1,0.5,1830
d3ace90fb457097c769ba996cb845395ff628d01,1,Ted Dunning,2010-08-20 03:23:22+00:00,['407cfd34e013919fc5bf975fd20c1b29f18b9416'],7,36,43,829463,2,1,1,0.933333333,1830
489a1c27f13e384b973499498902605d60ee280a,0,Ted Dunning,2010-08-20 03:23:25+00:00,['d3ace90fb457097c769ba996cb845395ff628d01'],1,1,2,829465,1,,,,1830
555cc737089c6d6be5d390a0928464d28bee4cef,1,Jeff Eastman,2010-08-20 21:56:16+00:00,['489a1c27f13e384b973499498902605d60ee280a'],396,689,1085,830550,25,1,1,0.939849624,1834
b9469ab3e6d65575357c68cddc4e0ca889b51ccf,1,Jeff Eastman,2010-08-21 02:21:57+00:00,['555cc737089c6d6be5d390a0928464d28bee4cef'],80,70,150,830700,7,1,1,0.5,1834
e2fa1e0b2f8736072c879c6bde722125d759d91a,0,Sean R. Owen,2010-08-22 22:25:11+00:00,['b9469ab3e6d65575357c68cddc4e0ca889b51ccf'],0,2,2,830702,1,1,1,1,1834
f13833ee202321d2121f2f26cd27e7f3289046f1,0,Andrew L. Farris,2010-08-23 14:09:59+00:00,['e2fa1e0b2f8736072c879c6bde722125d759d91a'],8,12,20,830722,1,1,1,0,1834
20fbf4d2216b0c0dc8abd4ae7df4e4cacb3e2c25,1,Grant Ingersoll,2010-08-27 17:55:11+00:00,['f13833ee202321d2121f2f26cd27e7f3289046f1'],2,1,3,830725,1,1,1,0,1834
34d576e43ada185f877e118663ca28cffb0991ba,0,Ted Dunning,2010-08-27 20:17:33+00:00,['20fbf4d2216b0c0dc8abd4ae7df4e4cacb3e2c25'],0,10,10,830735,4,,,,1837
7aa6232663fa2ad6d4b2ec536bed27097b3e1c6b,1,Ted Dunning,2010-08-29 04:12:10+00:00,['34d576e43ada185f877e118663ca28cffb0991ba'],0,1154,1154,831889,8,0.417422868,0.693284936,0.916515426,1845
d84e4c0afad28a72a4d5505b8d3dc12e0454bab0,1,Ted Dunning,2010-08-29 05:15:21+00:00,['7aa6232663fa2ad6d4b2ec536bed27097b3e1c6b'],10,11,21,831910,3,0.5,0.5,0.5,1845
52bbdd2d32ee2440f7884b95a10a85ee5c9172ac,0,Grant Ingersoll,2010-08-29 11:53:37+00:00,['d84e4c0afad28a72a4d5505b8d3dc12e0454bab0'],9,9,18,831928,1,1,,1,1845
6fca24e9cfd2baef20e2c6fb3b15cc331e458056,1,Sean R. Owen,2010-08-30 18:39:35+00:00,['52bbdd2d32ee2440f7884b95a10a85ee5c9172ac'],36,56,92,832020,7,0,0,0.25,1845
c1a418840ba418ac6691d398ab7f3f65752f6f3f,1,Sean R. Owen,2010-08-30 18:41:46+00:00,['6fca24e9cfd2baef20e2c6fb3b15cc331e458056'],450,497,947,832967,52,0,0.848484848,0.090909091,1845
5528154cb7636e474428d77639b8286ccf29ca33,1,Ted Dunning,2010-08-30 19:34:00+00:00,['c1a418840ba418ac6691d398ab7f3f65752f6f3f'],10,17,27,832994,1,1,1,0,1845
d457f73f1b2fd165c574213523b0e323ee54795a,1,Ted Dunning,2010-08-30 19:34:03+00:00,['5528154cb7636e474428d77639b8286ccf29ca33'],19,75,94,833088,2,0,1,1,1846
669b7ed603312b6bfafa3c7372f7c8c378f06f15,1,Ted Dunning,2010-08-30 19:34:06+00:00,['d457f73f1b2fd165c574213523b0e323ee54795a'],3,6,9,833097,1,1,1,0,1846
c96fa1426e231d48b8e45cc84a862920f9173784,1,Ted Dunning,2010-08-30 19:34:10+00:00,['669b7ed603312b6bfafa3c7372f7c8c378f06f15'],52,157,209,833306,9,0.75,1,0.34375,1846
7c6f529b41ad78f6a37107372a7331644cf2aedf,1,Ted Dunning,2010-08-30 19:34:13+00:00,['c96fa1426e231d48b8e45cc84a862920f9173784'],38,57,95,833401,6,1,1,0.857142857,1846
f02c4bc7ed3b8dbff4864949b3370abf54f34428,1,Ted Dunning,2010-08-30 19:34:16+00:00,['7c6f529b41ad78f6a37107372a7331644cf2aedf'],54,64,118,833519,8,0,0,1,1846
cce95dafcb40da1d0163a1ca1e01f8630cf3343d,0,Ted Dunning,2010-08-30 20:45:23+00:00,['f02c4bc7ed3b8dbff4864949b3370abf54f34428'],5,5,10,833529,2,,,,1846
a8b77cbd6b9676ed3ec21957e4c901654e54bd02,1,Ted Dunning,2010-08-30 20:50:57+00:00,['cce95dafcb40da1d0163a1ca1e01f8630cf3343d'],3,5,8,833537,1,,,,1846
913d44d9a87032b24b33b29d443ff0d26ab4adf0,1,Ted Dunning,2010-09-01 00:23:41+00:00,['a8b77cbd6b9676ed3ec21957e4c901654e54bd02'],50,280,330,833867,7,1,1,1,1846
a704e1731bd11c63cc4de416073a97b54ccb9fa2,1,Ted Dunning,2010-09-01 00:57:47+00:00,['913d44d9a87032b24b33b29d443ff0d26ab4adf0'],0,565,565,834432,3,0.668639053,1,0.464497041,1848
1bc1c14590ba8cac8eb7d2f92a46f5f400e04f73,1,Ted Dunning,2010-09-02 04:32:51+00:00,['a704e1731bd11c63cc4de416073a97b54ccb9fa2'],26,126,152,834584,2,1,1,0.731707317,1849
0bff67012bf4fcb83a5c47d1cc07a953d512a9f3,1,Ted Dunning,2010-09-02 04:33:02+00:00,['1bc1c14590ba8cac8eb7d2f92a46f5f400e04f73'],56,245,301,834885,7,0.367088608,0.367088608,0.278481013,1851
f747b5132626acbb320b5a384485693d522e3d2b,0,Ted Dunning,2010-09-02 04:33:08+00:00,['0bff67012bf4fcb83a5c47d1cc07a953d512a9f3'],1,1,2,834887,1,,,,1851
22726e80d48f13e5f46ba3a0f9576e407bb7c466,1,Ted Dunning,2010-09-02 04:33:38+00:00,['f747b5132626acbb320b5a384485693d522e3d2b'],313,305,618,835505,42,0.017857143,0.017857143,0.017857143,1851
018a14c838427581ad2126e601c470ead811b984,1,Ted Dunning,2010-09-02 04:33:50+00:00,['22726e80d48f13e5f46ba3a0f9576e407bb7c466'],12,40,52,835557,9,1,1,1,1851
d32f30aa0ca389f31b48067381061636e27cb5ea,0,Ted Dunning,2010-09-02 04:33:56+00:00,['018a14c838427581ad2126e601c470ead811b984'],2,1,3,835560,1,,,,1851
1ead75a2ca54aae059619e9b0c033533fdda4ef2,0,Ted Dunning,2010-09-02 04:34:02+00:00,['d32f30aa0ca389f31b48067381061636e27cb5ea'],2,1,3,835563,1,,,,1851
c0c8d9f64563d092506407f49addff96846a04cb,1,Sean R. Owen,2010-09-02 12:28:03+00:00,['1ead75a2ca54aae059619e9b0c033533fdda4ef2'],11694,465,12159,847722,83,0.58408947,0.454948301,0.383414222,1851
ff79ff48c3a7228dc7ea89f917b2e9db87048728,1,Sean R. Owen,2010-09-03 12:28:34+00:00,['c0c8d9f64563d092506407f49addff96846a04cb'],2246,2781,5027,852749,222,0.217391304,0.046035806,0,1853
ed18cb307e2df855efc1d6c5ffcb03251f94bfc9,0,Andrew L. Farris,2010-09-03 15:28:06+00:00,['ff79ff48c3a7228dc7ea89f917b2e9db87048728'],2,11,13,852762,2,,,,1853
9b2c7aa28ed4e3afe1e8b74ce3f8266dc7927915,1,Jeff Eastman,2010-09-03 15:36:46+00:00,['ed18cb307e2df855efc1d6c5ffcb03251f94bfc9'],1,111,112,852874,2,0,1,1,1853
f84ab255d5014c9f477c1197e5a9cb35d522c79f,0,Sean R. Owen,2010-09-03 18:52:58+00:00,['9b2c7aa28ed4e3afe1e8b74ce3f8266dc7927915'],1,12,13,852887,1,1,1,1,1853
2b8d5e455e14cf7722846acbe89221a6cbdb166d,0,Sean R. Owen,2010-09-04 17:56:30+00:00,['f84ab255d5014c9f477c1197e5a9cb35d522c79f'],16,50,66,852953,7,1,1,1,1853
b840d2f12b7cc46c891ecbb85a7e9ca8b69f5774,1,Ted Dunning,2010-09-04 18:03:29+00:00,['2b8d5e455e14cf7722846acbe89221a6cbdb166d'],1,12,13,852966,1,1,1,1,1853
c62fe141e409d107a2d2b3cbed6840117763c780,1,Ted Dunning,2010-09-04 20:40:59+00:00,['b840d2f12b7cc46c891ecbb85a7e9ca8b69f5774'],19,24,43,853009,5,1,1,1,1853
235098da699bf57e013183f30447f9c0c89058e0,1,Ted Dunning,2010-09-04 22:10:21+00:00,['c62fe141e409d107a2d2b3cbed6840117763c780'],5,5,10,853019,4,,,,1853
10afd75e2db4339c3185f09cabd19887fa91e4fc,0,Sean R. Owen,2010-09-05 08:52:17+00:00,['235098da699bf57e013183f30447f9c0c89058e0'],14,8,22,853041,1,1,1,0,1853
705828f78799f586d5539b87307d7dc4031ffef1,1,Sean R. Owen,2010-09-05 10:00:33+00:00,['10afd75e2db4339c3185f09cabd19887fa91e4fc'],14,12,26,853067,1,0,0,0,1853
75845af558f3ae0607336a17ff491265e0315aec,0,Andrew L. Farris,2010-09-06 01:16:38+00:00,['705828f78799f586d5539b87307d7dc4031ffef1'],91,113,204,853271,1,0,0,1,1853
7e75b29b73839c8164a4584918226c0855fa78a1,0,Andrew L. Farris,2010-09-06 01:18:18+00:00,['75845af558f3ae0607336a17ff491265e0315aec'],1,1,2,853273,1,,,,1853
170284d12c82dc305df9414d839d5d8434387021,0,Benson Margulies,2010-09-06 11:58:24+00:00,['7e75b29b73839c8164a4584918226c0855fa78a1'],3,3,6,853279,3,,,,1853
75a2a7068dcaeb14568d52f3554babb3b0289ebf,0,Benson Margulies,2010-09-06 12:04:38+00:00,['170284d12c82dc305df9414d839d5d8434387021'],246,0,246,853525,7,,,,1853
8a99d7561228883cfddcda43428053cd78611b11,1,Sean R. Owen,2010-09-07 13:54:21+00:00,['75a2a7068dcaeb14568d52f3554babb3b0289ebf'],875,864,1739,855264,99,0.034482759,1,0,1853
f1ca6dee7fd0ce189b250eaf01b475847c19ffda,0,Benson Margulies,2010-09-08 01:24:18+00:00,['8a99d7561228883cfddcda43428053cd78611b11'],4,4,8,855272,1,,,,1853
5352ea2dbe1b21da0873c4ccf34b92e1840dd4d7,1,Sebastian Schelter,2010-09-08 05:43:10+00:00,['f1ca6dee7fd0ce189b250eaf01b475847c19ffda'],11,264,275,855547,4,0.31496063,0.606299213,0.850393701,1855
758dc915161008d81183cf7b42a0e50985f517ba,0,Ted Dunning,2010-09-08 18:02:13+00:00,['5352ea2dbe1b21da0873c4ccf34b92e1840dd4d7'],2,167,169,855716,3,0.057692308,0.403846154,1,1857
d61aa504fbc7dafef58048b007d30cb081592b7d,0,Ted Dunning,2010-09-08 18:02:15+00:00,['758dc915161008d81183cf7b42a0e50985f517ba'],2,2,4,855720,1,,,,1857
6c34155d2c5f2eb4188a772215bd8f080d75e870,1,Ted Dunning,2010-09-08 18:02:18+00:00,['d61aa504fbc7dafef58048b007d30cb081592b7d'],0,196,196,855916,1,0.786666667,1,0.946666667,1858
b60177d7e2ef6a15a23ab301d4c2ff6516baf963,0,Ted Dunning,2010-09-08 18:02:20+00:00,['6c34155d2c5f2eb4188a772215bd8f080d75e870'],6,33,39,855955,1,1,1,1,1858
2ce6410a48f54137afe140cca6b5b4007593cc4f,0,Ted Dunning,2010-09-08 18:02:22+00:00,['b60177d7e2ef6a15a23ab301d4c2ff6516baf963'],1,4,5,855960,2,0,0.5,1,1858
451dc8c2b9b5b348b32a64161ab111d6aa2909d2,0,Ted Dunning,2010-09-08 18:02:25+00:00,['2ce6410a48f54137afe140cca6b5b4007593cc4f'],1,4,5,855965,1,,,,1858
2c6fc0bbebb249dd1954b428b2c1a5238f57f050,0,Ted Dunning,2010-09-08 18:49:57+00:00,['451dc8c2b9b5b348b32a64161ab111d6aa2909d2'],2,4,6,855971,1,0,1,0,1858
93ddcf8bc21ca37bc76b8bf5857a602b0bc9c0c0,0,Ted Dunning,2010-09-08 18:49:59+00:00,['2c6fc0bbebb249dd1954b428b2c1a5238f57f050'],4,15,19,855990,1,0,0,1,1858
ee62ea239c82953f563b8163b0271d6ad0233278,0,Ted Dunning,2010-09-08 18:50:03+00:00,['93ddcf8bc21ca37bc76b8bf5857a602b0bc9c0c0'],32,21,53,856043,2,0,0,1,1858
7be2356a7b44ff6a67ffa158525b41addd02a626,1,Ted Dunning,2010-09-08 19:48:24+00:00,['ee62ea239c82953f563b8163b0271d6ad0233278'],69,63,132,856175,8,0,0,0,1858
1d54c24c1a139e9a2fd4d206a136201a1e106865,0,Ted Dunning,2010-09-08 20:54:30+00:00,['7be2356a7b44ff6a67ffa158525b41addd02a626'],2,0,2,856177,1,,,,1858
96b7f9b53dd85ff206c89011c917961b61964b77,0,Ted Dunning,2010-09-08 21:10:10+00:00,['1d54c24c1a139e9a2fd4d206a136201a1e106865'],2,4,6,856183,1,1,0,0,1858
3686970f586cff8a52e9ab73650540b2ee57e80f,0,Ted Dunning,2010-09-09 00:36:16+00:00,['96b7f9b53dd85ff206c89011c917961b61964b77'],0,2,2,856185,1,,,,1858
5ce59923464550a51f4dd8f7cea50cfaba228844,1,Sean R. Owen,2010-09-09 23:57:51+00:00,['3686970f586cff8a52e9ab73650540b2ee57e80f'],867,384,1251,857436,36,0.845901639,0.521311475,0.426229508,1858
88848aef092c49122f58e1ae898cb21db61ed8a7,0,Ted Dunning,2010-09-11 00:30:32+00:00,['5ce59923464550a51f4dd8f7cea50cfaba228844'],3,69,72,857508,2,0.322580645,0.935483871,1,1859
894b64695337ed467a5c7038f2b89f1e11b709f0,0,Ted Dunning,2010-09-11 05:42:51+00:00,['88848aef092c49122f58e1ae898cb21db61ed8a7'],2,12,14,857522,1,,,,1859
a1dd99275fd93488e01439fa2a1c7d75d8d5b15d,1,Grant Ingersoll,2010-09-12 11:39:54+00:00,['894b64695337ed467a5c7038f2b89f1e11b709f0'],1,18,19,857541,2,1,1,1,1859
2ca68e8b9e154e03f6f081f1ef726760e3905b63,1,Jeff Eastman,2010-09-12 18:58:52+00:00,['a1dd99275fd93488e01439fa2a1c7d75d8d5b15d'],41,37,78,857619,16,0,0,0,1859
dd2619f81b656b741a13f3d627044d3a4356fb8d,0,Jeff Eastman,2010-09-13 16:48:23+00:00,['2ca68e8b9e154e03f6f081f1ef726760e3905b63'],48,95,143,857762,2,0.75,1,0,1859
64301883acca71df44f307f5c281639839c62818,1,Sean R. Owen,2010-09-14 01:05:30+00:00,['dd2619f81b656b741a13f3d627044d3a4356fb8d'],845,400,1245,859007,69,0.640167364,0.476987448,0.225941423,1859
6510938993147374125229bf833dc676a5aeae84,1,Jeff Eastman,2010-09-14 17:35:51+00:00,['64301883acca71df44f307f5c281639839c62818'],85,273,358,859365,4,0,1,0.828571429,1860
1e923edde6f7bf16d5ab177377cbf38afccaebe8,0,Ted Dunning,2010-09-15 06:18:04+00:00,['6510938993147374125229bf833dc676a5aeae84'],7,120,127,859492,5,1,1,1,1861
04a4b3d4236b3e083c5778f833a01fc3cc130803,0,Ted Dunning,2010-09-15 06:19:40+00:00,['1e923edde6f7bf16d5ab177377cbf38afccaebe8'],34,74,108,859600,1,0.055555556,1,0.055555556,1861
0ada0cb8bd89217d4c995b566627df47db8b1486,0,Ted Dunning,2010-09-15 06:33:15+00:00,['04a4b3d4236b3e083c5778f833a01fc3cc130803'],1,1,2,859602,1,,,,1861
e763bdfd3cb5077c9359536966b9b1925ae4772f,0,Ted Dunning,2010-09-15 06:33:18+00:00,['0ada0cb8bd89217d4c995b566627df47db8b1486'],14,0,14,859616,1,1,0,1,1861
af1c02cce14cad4ad8f390e1f21272be06af8cc7,0,Ted Dunning,2010-09-15 22:16:47+00:00,['e763bdfd3cb5077c9359536966b9b1925ae4772f'],4,17,21,859637,1,0,1,1,1861
8f6bd9e072c960958f09200221888570c4ec7c2c,0,Sean R. Owen,2010-09-16 08:13:16+00:00,['af1c02cce14cad4ad8f390e1f21272be06af8cc7'],4,4,8,859645,1,1,1,1,1861
878d80f99e8d9c2c43828a1fec476026a628e766,0,Sean R. Owen,2010-09-16 08:22:17+00:00,['8f6bd9e072c960958f09200221888570c4ec7c2c'],18,31,49,859694,1,1,1,0.2,1861
6680267723a56fab773f61834ba99a84fb707d0e,0,Sean R. Owen,2010-09-16 10:00:20+00:00,['878d80f99e8d9c2c43828a1fec476026a628e766'],1,2,3,859697,1,,,,1861
7865230994fb76084e7d5db80b840c5bd308f589,0,Sean R. Owen,2010-09-17 07:39:12+00:00,['6680267723a56fab773f61834ba99a84fb707d0e'],21,21,42,859739,2,0,0,1,1861
fbf804bb0c294c9d06869a30c7baa1ebd5a77cad,1,Ted Dunning,2010-09-17 18:41:18+00:00,['7865230994fb76084e7d5db80b840c5bd308f589'],87,345,432,860171,16,0.857142857,1,0.446428571,1864
fa5ca4a8fca3e8aa83478763470a585b19bcf4fb,0,Ted Dunning,2010-09-17 18:41:21+00:00,['fbf804bb0c294c9d06869a30c7baa1ebd5a77cad'],9,35,44,860215,1,1,1,1,1864
0687a7a26061e0965882ca694dfec1ef583d225b,0,Ted Dunning,2010-09-17 18:41:24+00:00,['fa5ca4a8fca3e8aa83478763470a585b19bcf4fb'],1,0,1,860216,1,,,,1864
ffc9d6a3fec99aedea4d710d23d56fdcaa59635f,0,Ted Dunning,2010-09-17 18:41:26+00:00,['0687a7a26061e0965882ca694dfec1ef583d225b'],10,3,13,860229,1,0,0,0,1864
013d0eb78b795ced6f6b4efe63c36f5df5a35e2a,1,Ted Dunning,2010-09-17 18:41:29+00:00,['ffc9d6a3fec99aedea4d710d23d56fdcaa59635f'],13,89,102,860331,1,1,1,1,1864
8b9a6bf7d767b0933d6ebbde594f1f88b351e281,0,Ted Dunning,2010-09-17 19:51:44+00:00,['013d0eb78b795ced6f6b4efe63c36f5df5a35e2a'],2,2,4,860335,1,,,,1864
a5994378c57bb9a6ecc7c67810ed898a94cd47dc,0,Ted Dunning,2010-09-17 19:51:46+00:00,['8b9a6bf7d767b0933d6ebbde594f1f88b351e281'],1,2,3,860338,1,,,,1864
b5d873b2fc1df325fefe8bd4651660d6ed322426,0,Ted Dunning,2010-09-17 19:51:49+00:00,['a5994378c57bb9a6ecc7c67810ed898a94cd47dc'],1,5,6,860344,2,1,1,1,1864
8a51eb432fbf8f7080ceec249f54ebca39c33a2b,0,Ted Dunning,2010-09-17 19:51:52+00:00,['b5d873b2fc1df325fefe8bd4651660d6ed322426'],0,5,5,860349,1,0,1,1,1864
7a57c515e4a42967d8cee6b72b82fad6ef5125d3,0,Ted Dunning,2010-09-17 19:51:54+00:00,['8a51eb432fbf8f7080ceec249f54ebca39c33a2b'],1,2,3,860352,1,0,1,1,1864
7ab7df7b40bbe936c9d095f50320f73292dd09f7,0,Ted Dunning,2010-09-17 19:51:57+00:00,['7a57c515e4a42967d8cee6b72b82fad6ef5125d3'],3,3,6,860358,1,,,,1864
e81fe138735d132b61a647a693bf16eaa83deeb0,0,Ted Dunning,2010-09-17 21:32:49+00:00,['7ab7df7b40bbe936c9d095f50320f73292dd09f7'],19,25,44,860402,2,1,1,1,1864
d24b3031e677324494409f114ed662f292d04cb1,0,Ted Dunning,2010-09-17 21:32:52+00:00,['e81fe138735d132b61a647a693bf16eaa83deeb0'],3,2,5,860407,2,,,,1864
66e63a120beeb61dea873e698a488ee44fb4a317,0,Ted Dunning,2010-09-17 21:32:55+00:00,['d24b3031e677324494409f114ed662f292d04cb1'],9,23,32,860439,3,1,1,1,1864
2b9294068a004b97dccfeb41c16a4c76e09f6afd,0,Sean R. Owen,2010-09-18 10:27:23+00:00,['66e63a120beeb61dea873e698a488ee44fb4a317'],1,37,38,860477,1,0.823529412,0.823529412,0.911764706,1864
bf7cb962c6aff6c6b1f8bc3190245949604ad519,0,Ted Dunning,2010-09-19 06:51:56+00:00,['2b9294068a004b97dccfeb41c16a4c76e09f6afd'],14,45,59,860536,3,0.666666667,1,0.466666667,1864
41acc3f8ba9fae40948dfb7687dad80bea36a607,0,Ted Dunning,2010-09-19 20:28:18+00:00,['bf7cb962c6aff6c6b1f8bc3190245949604ad519'],0,14,14,860550,1,,,,1864
42b989b0104ff75d10a89ebe69bc8822778b611c,1,Ted Dunning,2010-09-20 04:11:44+00:00,['41acc3f8ba9fae40948dfb7687dad80bea36a607'],1,14,15,860565,2,0,1,1,1864
20a43c49986dd721eb23d4fbc6efb633b50b8011,0,Ted Dunning,2010-09-20 04:24:24+00:00,['42b989b0104ff75d10a89ebe69bc8822778b611c'],1,1,2,860567,1,,,,1864
68de812e21943b3a2cc34ce23e6cac65cb1c7605,0,Ted Dunning,2010-09-20 04:24:27+00:00,['20a43c49986dd721eb23d4fbc6efb633b50b8011'],1,1,2,860569,1,,,,1864
e236ae93e6c025ef3d8de7f0fb6668d7337efba4,0,Jeff Eastman,2010-09-20 20:59:39+00:00,['68de812e21943b3a2cc34ce23e6cac65cb1c7605'],1,30,31,860600,2,,,,1864
6ab620d9f672b43fcb08ab0a20447bcb495d2f52,1,Ted Dunning,2010-09-20 22:26:05+00:00,['e236ae93e6c025ef3d8de7f0fb6668d7337efba4'],1,1,2,860602,1,,,,1864
b553e02f3bcda293d761b1f76009bc48caa3a0f3,1,Ted Dunning,2010-09-20 22:26:07+00:00,['6ab620d9f672b43fcb08ab0a20447bcb495d2f52'],1,23,24,860626,1,0.727272727,0.727272727,1,1864
a87bed8d606a707f401371558467bd54feaa0c26,0,Ted Dunning,2010-09-20 22:26:10+00:00,['b553e02f3bcda293d761b1f76009bc48caa3a0f3'],4,18,22,860648,2,0.75,1,0.75,1864
8b6f5d72d89ed19d94cb01da1a6161451780ca98,1,Ted Dunning,2010-09-20 22:26:12+00:00,['a87bed8d606a707f401371558467bd54feaa0c26'],0,276,276,860924,1,0.142857143,0.299319728,0.585034014,1865
23e751fc5d60385c85f1a7d410f493c43e8c9c6f,0,Ted Dunning,2010-09-22 04:22:54+00:00,['8b6f5d72d89ed19d94cb01da1a6161451780ca98'],37,73,110,861034,2,0,1,1,1865
51e2486689dc8427ed8291a6faddd5a8c755a43e,0,Ted Dunning,2010-09-22 04:28:08+00:00,['23e751fc5d60385c85f1a7d410f493c43e8c9c6f'],0,18,18,861052,1,0,0,1,1865
ef7b7682a4ae4465fc9472f0921dd96d715ee32d,0,Ted Dunning,2010-09-22 04:32:22+00:00,['51e2486689dc8427ed8291a6faddd5a8c755a43e'],0,5,5,861057,1,1,1,1,1865
9cfe290fe0781002a8011111cd2b644f3e796c33,0,Ted Dunning,2010-09-22 04:32:26+00:00,['ef7b7682a4ae4465fc9472f0921dd96d715ee32d'],6,14,20,861077,2,0.6,0.6,1,1865
9a5b4611d14559b1c8738cf65f5694dbebde594f,0,Ted Dunning,2010-09-22 04:32:28+00:00,['9cfe290fe0781002a8011111cd2b644f3e796c33'],1,2,3,861080,1,0,1,0,1865
24a75dbf158c935ba74245adb15add4caf6c923c,0,Ted Dunning,2010-09-22 04:32:30+00:00,['9a5b4611d14559b1c8738cf65f5694dbebde594f'],5,14,19,861099,1,0,0.4,0.6,1865
3181b4bb3f2eab7e5bb3e5a7db2bfa61642f4d15,0,Andrew L. Farris,2010-09-22 13:04:59+00:00,['24a75dbf158c935ba74245adb15add4caf6c923c'],0,0,0,861099,1,,,,1865
8267c5b6f67a263028672e5a7ac2849b0479d9eb,1,Jeff Eastman,2010-09-22 15:05:09+00:00,['3181b4bb3f2eab7e5bb3e5a7db2bfa61642f4d15'],34,83,117,861216,3,0.441860465,0.325581395,1,1865
d4b792442e4be3da8acd009f90c55b761437906e,1,Ted Dunning,2010-09-22 17:28:20+00:00,['8267c5b6f67a263028672e5a7ac2849b0479d9eb'],0,90,90,861306,2,0.139534884,0.976744186,1,1866
86306e5d6cad056c6f64b29d16d5ba655bffb9a7,0,Ted Dunning,2010-09-22 18:19:00+00:00,['d4b792442e4be3da8acd009f90c55b761437906e'],4,10,14,861320,2,1,1,1,1866
6a4a189231a75ba32ad63cb67609a949f703934e,0,Ted Dunning,2010-09-22 20:28:13+00:00,['86306e5d6cad056c6f64b29d16d5ba655bffb9a7'],5,10,15,861335,3,1,1,1,1866
e6b4e352c4d9ce41908a5c67d325fb430b2fd44e,1,Ted Dunning,2010-09-23 00:12:09+00:00,['6a4a189231a75ba32ad63cb67609a949f703934e'],161,355,516,861851,10,0.5,0.525,0.6625,1868
b50007094b3b817e9a5119af83c93d73093321b1,1,Ted Dunning,2010-09-23 00:12:13+00:00,['e6b4e352c4d9ce41908a5c67d325fb430b2fd44e'],2,46,48,861899,2,0.730769231,1,0.269230769,1868
48840c1fe40e8f66ecc0b23a2ed51e4f162b1915,1,Jeff Eastman,2010-09-23 03:03:21+00:00,['b50007094b3b817e9a5119af83c93d73093321b1'],849,714,1563,863462,20,1,0.275862069,0.873563218,1868
001b04d44c193533a24b868159bab20e3379692a,0,Jeff Eastman,2010-09-23 20:02:40+00:00,['48840c1fe40e8f66ecc0b23a2ed51e4f162b1915'],27,37,64,863526,5,0,1,0.428571429,1868
5606a0d2b3bbf8996fa6e9e36aa1ab5f60199a77,0,Jeff Eastman,2010-09-23 20:16:43+00:00,['001b04d44c193533a24b868159bab20e3379692a'],3,0,3,863529,1,1,0,1,1868
763db667457934e7b465ec661d0acb9a97133335,1,Ted Dunning,2010-09-24 00:26:44+00:00,['5606a0d2b3bbf8996fa6e9e36aa1ab5f60199a77'],11,38,49,863578,3,1,1,0,1868
c93818ef801be7bc45e3ded82e13919cafa0643d,1,Ted Dunning,2010-09-24 00:26:47+00:00,['763db667457934e7b465ec661d0acb9a97133335'],18,11,29,863607,1,1,0,1,1868
3fc2024c83a1575a8c28b82d5ec918044b86f20a,0,Sean R. Owen,2010-09-24 06:39:39+00:00,['c93818ef801be7bc45e3ded82e13919cafa0643d'],5,2,7,863614,1,1,0,0,1868
27d33a2f42fcb583e78699a1659644e83ca93188,0,Isabel Drost,2010-09-24 11:17:13+00:00,['3fc2024c83a1575a8c28b82d5ec918044b86f20a'],0,2794,2794,866408,13,0.319290466,0.546193644,0.580192166,1880
20276b4ade92758323e1b798bbf2bbd134c0ee2d,0,Sean R. Owen,2010-09-24 11:49:18+00:00,['27d33a2f42fcb583e78699a1659644e83ca93188'],0,10,10,866418,2,,,,1881
61b5385aa74f5dc813129599bcf7e50f5a234169,1,Sean R. Owen,2010-09-24 12:32:23+00:00,['20276b4ade92758323e1b798bbf2bbd134c0ee2d'],0,3,3,866421,1,1,1,1,1881
ad53dbea31ecfb9b0c3bb02b3e3470a4c5d5c586,0,Sean R. Owen,2010-09-24 16:46:30+00:00,['61b5385aa74f5dc813129599bcf7e50f5a234169'],1,5,6,866427,1,0,1,1,1881
31d93a8ac65fb0878391d88aa2166762a28ebbf4,0,Sean R. Owen,2010-09-24 16:47:37+00:00,['ad53dbea31ecfb9b0c3bb02b3e3470a4c5d5c586'],1,4,5,866432,1,0,0,1,1881
1259c968fc6f0f222b5d385c44fd8104608b10d4,1,Sean R. Owen,2010-09-24 16:48:08+00:00,['31d93a8ac65fb0878391d88aa2166762a28ebbf4'],12,71,83,866515,2,0.023255814,1,1,1881
c8270dc4e72930ae4f1e993fbcfe44ddaf61e3b8,1,Jeff Eastman,2010-09-24 18:31:56+00:00,['1259c968fc6f0f222b5d385c44fd8104608b10d4'],222,834,1056,867571,8,0.325062035,0.992555831,0.947890819,1883
f900e2a6e1a5a60a76757c5a61a9024a6545bcd6,1,Jeff Eastman,2010-09-24 18:33:55+00:00,['c8270dc4e72930ae4f1e993fbcfe44ddaf61e3b8'],209,171,380,867951,9,1,0,0,1883
c4a0cb9426b7792d4365f0e419917cf85d6e5b63,1,Jeff Eastman,2010-09-24 19:18:46+00:00,['f900e2a6e1a5a60a76757c5a61a9024a6545bcd6'],194,141,335,868286,7,1,0.095238095,0,1883
69ad72b64c90836a20eb600fc8acf1a00743f427,1,Jeff Eastman,2010-09-25 02:39:05+00:00,['c4a0cb9426b7792d4365f0e419917cf85d6e5b63'],17,19,36,868322,1,0,0,1,1883
22d7d31c58adfc711986028ed0e03a07f740483f,1,Andrew L. Farris,2010-09-25 03:27:57+00:00,['69ad72b64c90836a20eb600fc8acf1a00743f427'],70,319,389,868711,10,0.235772358,0.853658537,0.601626016,1885
d53cf4a1ae2c94132ebb247a872e391d74389cf4,1,Sean R. Owen,2010-09-25 09:51:42+00:00,['22d7d31c58adfc711986028ed0e03a07f740483f'],463,525,988,869699,45,0,0.319444444,0.541666667,1885
d41b3609f226d921a53b69ce834a5c0a8eb1409e,1,Jeff Eastman,2010-09-25 16:33:05+00:00,['d53cf4a1ae2c94132ebb247a872e391d74389cf4'],93,88,181,869880,3,1,0,0,1885
07d3d5fe6f4c9b250c6c03a826b1cfe7d2b5f8ac,0,Sean R. Owen,2010-09-25 18:59:51+00:00,['d41b3609f226d921a53b69ce834a5c0a8eb1409e'],255,204,459,870339,12,0.518072289,0.843373494,0.024096386,1887
2ede1c0d067dca290150c3a9be28b62743dc9130,1,Sean R. Owen,2010-09-26 10:18:19+00:00,['07d3d5fe6f4c9b250c6c03a826b1cfe7d2b5f8ac'],26,38,64,870403,3,0,0,1,1887
b0695e95e7d66fd569d0cb80ec1ac9b80c20d21a,1,Sean R. Owen,2010-09-26 11:54:34+00:00,['2ede1c0d067dca290150c3a9be28b62743dc9130'],6,121,127,870530,2,0.771428571,1,1,1888
3f1450a35e058c5353004affd12f3ddd7e7327e8,1,Sean R. Owen,2010-09-26 14:31:53+00:00,['b0695e95e7d66fd569d0cb80ec1ac9b80c20d21a'],215,223,438,870968,46,1,1,0.555555556,1888
c69893b5c99758e176525dc03c9ea724a397173a,0,Sean R. Owen,2010-09-26 16:23:25+00:00,['3f1450a35e058c5353004affd12f3ddd7e7327e8'],15,24,39,871007,2,0,1,1,1888
1619a3f3fb5692ac36805e18a617870989cf85ce,1,Sean R. Owen,2010-09-26 20:57:24+00:00,['c69893b5c99758e176525dc03c9ea724a397173a'],12,12,24,871031,6,,,,1888
f4597a2eb0eafe379f200ace797e92fc96c73786,0,Sean R. Owen,2010-09-26 21:49:06+00:00,['1619a3f3fb5692ac36805e18a617870989cf85ce'],1,1,2,871033,1,,,,1888
61ae2e77f725bbc71c2ed9899f8b91fd6f422242,1,Sean R. Owen,2010-09-27 09:28:27+00:00,['f4597a2eb0eafe379f200ace797e92fc96c73786'],180,221,401,871434,30,0,0.790697674,0.395348837,1888
981b4431e6ad7f4194687ae8b758d2b1a164c101,0,Jeff Eastman,2010-09-27 14:57:09+00:00,['61ae2e77f725bbc71c2ed9899f8b91fd6f422242'],1,1,2,871436,1,,,,1888
597db6a05e4e2464d26b19109d6a4ee43cc5c363,0,Ted Dunning,2010-09-28 00:11:51+00:00,['981b4431e6ad7f4194687ae8b758d2b1a164c101'],20,118,138,871574,3,0.630769231,0.953846154,0.923076923,1888
f029d24a28c10915b49474e6b6d47809f446e5a4,0,Ted Dunning,2010-09-28 06:20:16+00:00,['597db6a05e4e2464d26b19109d6a4ee43cc5c363'],14,29,43,871617,1,0,0,0.909090909,1888
b801629db0fa2a64946917561844ba38137f04c6,0,Ted Dunning,2010-09-28 06:20:19+00:00,['f029d24a28c10915b49474e6b6d47809f446e5a4'],4,1,5,871622,2,,,,1888
57f0c7d567fedc0828bb72cda774a1c8ace1e2a7,0,Sean R. Owen,2010-09-28 15:05:24+00:00,['b801629db0fa2a64946917561844ba38137f04c6'],0,122,122,871744,1,0.413333333,1,1,1889
1ce47b660e9d4605f36e8ac41681c0991a65d78f,1,Jeff Eastman,2010-09-28 18:09:04+00:00,['57f0c7d567fedc0828bb72cda774a1c8ace1e2a7'],43,165,208,871952,4,0.086956522,0.510869565,0.293478261,1889
1bb9546ee479ee23138ccb29d5a452ade4199a07,1,Jeff Eastman,2010-09-28 22:08:19+00:00,['1ce47b660e9d4605f36e8ac41681c0991a65d78f'],86,141,227,872179,2,0,1,1,1889
3c9538a43c1c02567f6018cf3bafbeadb49b7b65,1,Jeff Eastman,2010-09-29 16:27:04+00:00,['1bb9546ee479ee23138ccb29d5a452ade4199a07'],222,691,913,873092,16,1,1,0.778947368,1893
d0dc3886420effe3c0913aa865cae4499bc15465,0,Ted Dunning,2010-09-29 16:41:17+00:00,['3c9538a43c1c02567f6018cf3bafbeadb49b7b65'],9,12,21,873113,3,0,1,0,1893
ebc739324e931b150a73dc53f60e43105378c2ed,1,Jeff Eastman,2010-09-29 16:47:02+00:00,['d0dc3886420effe3c0913aa865cae4499bc15465'],32,11,43,873156,1,0,1,1,1893
76059d43401ddeb8df1fb8e6e5677adcd3378b4f,0,Jeff Eastman,2010-09-29 17:11:59+00:00,['ebc739324e931b150a73dc53f60e43105378c2ed'],3,3,6,873162,2,1,1,1,1893
237bcbdcd40b27c1bae2d191d8b7c60bd20da72e,0,Jeff Eastman,2010-09-29 17:47:17+00:00,['76059d43401ddeb8df1fb8e6e5677adcd3378b4f'],20,17,37,873199,5,0.5,0,0,1893
28a69a00105a7f1001d4ff3f803eedbbcb8a6c2c,1,Jeff Eastman,2010-09-29 20:27:46+00:00,['237bcbdcd40b27c1bae2d191d8b7c60bd20da72e'],47,52,99,873298,5,0,0.5,0,1893
58b5f28efe24232e833d116249bde23217f4f840,1,Ted Dunning,2010-09-29 21:52:20+00:00,['28a69a00105a7f1001d4ff3f803eedbbcb8a6c2c'],135,171,306,873604,7,0.083333333,0,0.125,1894
72583eb53f987abd605fce2de9d1cf8f1ac00cc7,0,Jeff Eastman,2010-09-30 14:05:38+00:00,['58b5f28efe24232e833d116249bde23217f4f840'],8,21,29,873633,9,,,,1894
48d069f4559da3870ee1e3b36df757b29b781885,1,Jeff Eastman,2010-09-30 18:00:23+00:00,['72583eb53f987abd605fce2de9d1cf8f1ac00cc7'],23,2973,2996,876629,27,0.291288566,0.796733212,0.614337568,1918
77c59bcdf244253cf376bac1ba7d430e46a75dd4,0,Jeff Eastman,2010-09-30 19:20:28+00:00,['48d069f4559da3870ee1e3b36df757b29b781885'],1,1,2,876631,1,,,,1918
cf76c3f875b935b68db345ccefc1636224487905,0,Jeff Eastman,2010-09-30 23:07:46+00:00,['77c59bcdf244253cf376bac1ba7d430e46a75dd4'],71,132,203,876834,2,0,1,0,1918
71ecd11a54369ad8d98ec7a297899983b24ed7d8,1,Jeff Eastman,2010-10-01 02:10:06+00:00,['cf76c3f875b935b68db345ccefc1636224487905'],2,1,3,876837,1,1,0,0,1918
9608f224f5f86cf786584c9c9524b30adf14dc07,1,Sean R. Owen,2010-10-01 07:40:53+00:00,['71ecd11a54369ad8d98ec7a297899983b24ed7d8'],0,1121,1121,877958,9,0.352253756,0.757929883,0.721202003,1927
049e7dc6cae23f7992aee48ec1f85d0cc133a20c,1,Sean R. Owen,2010-10-01 11:00:16+00:00,['9608f224f5f86cf786584c9c9524b30adf14dc07'],560,694,1254,879212,107,1,1,0,1927
833c65998e3cf6ac33cc7068f3d689eb99e10566,0,Andrew L. Farris,2010-10-02 00:40:46+00:00,['049e7dc6cae23f7992aee48ec1f85d0cc133a20c'],63,96,159,879371,2,0.529411765,0.470588235,0.529411765,1927
abb9151ccecf844fd9976158f68e2dfe89fe2f9d,1,Andrew L. Farris,2010-10-02 01:03:51+00:00,['833c65998e3cf6ac33cc7068f3d689eb99e10566'],2,7,9,879380,1,0,1,1,1927
21d08d20a72f22cd2a26cd66fb983bfb9ea37d70,0,Ted Dunning,2010-10-02 08:18:35+00:00,['abb9151ccecf844fd9976158f68e2dfe89fe2f9d'],26,191,217,879597,5,1,1,0.43902439,1930
4b8c8d4ae0b18e25683342d41a4950388c8bd091,1,Robin Anil,2010-10-02 20:10:51+00:00,['21d08d20a72f22cd2a26cd66fb983bfb9ea37d70'],31,173,204,879801,10,0.296703297,0.197802198,0.89010989,1930
52f677a87a11a5d84389ad34955082776b1dcf7d,0,Sean R. Owen,2010-10-03 10:21:43+00:00,['4b8c8d4ae0b18e25683342d41a4950388c8bd091'],27,33,60,879861,1,0,0,1,1930
10d666390968cba134b31b78d6c3c99b0b6164cd,0,Robin Anil,2010-10-03 18:43:20+00:00,['52f677a87a11a5d84389ad34955082776b1dcf7d'],93,90,183,880044,41,,,,1930
69ba194af61508da5e286b5690d171e01ab1635e,1,Sean R. Owen,2010-10-03 20:53:07+00:00,['10d666390968cba134b31b78d6c3c99b0b6164cd'],1173,820,1993,882037,128,0.714285714,0.957983193,0.31512605,1930
fff59db8997f9d0afe8216fe382c9c03fc3fb2e7,0,Andrew L. Farris,2010-10-04 03:42:30+00:00,['69ba194af61508da5e286b5690d171e01ab1635e'],2,2,4,882041,1,,,,1930
6c9a0234c234250eab869c59e27bfdcf167723ea,1,Andrew L. Farris,2010-10-04 03:44:15+00:00,['fff59db8997f9d0afe8216fe382c9c03fc3fb2e7'],116,102,218,882259,6,,,,1932
5a6f2711f2b1ca6be3726731cec10157357625a1,0,Andrew L. Farris,2010-10-04 19:55:04+00:00,['6c9a0234c234250eab869c59e27bfdcf167723ea'],0,16,16,882275,1,,,,1932
bb6c61679795d2ebc5483e706a076f4f10583225,1,Robin Anil,2010-10-04 22:49:02+00:00,['5a6f2711f2b1ca6be3726731cec10157357625a1'],67,82,149,882424,6,0,0,0,1932
5a7067b89828b28feeb5df964edca3d02746a15f,1,Robin Anil,2010-10-04 22:56:06+00:00,['bb6c61679795d2ebc5483e706a076f4f10583225'],25,25,50,882474,22,,,,1932
af0434f0518d9bbf53d0e22581d4591d05c9f590,0,Robin Anil,2010-10-04 22:58:48+00:00,['5a7067b89828b28feeb5df964edca3d02746a15f'],6,6,12,882486,1,,,,1932
4c864912764782e54f33c0c511d4955c62e3453d,0,Sebastian Schelter,2010-10-05 08:44:33+00:00,['af0434f0518d9bbf53d0e22581d4591d05c9f590'],1,1,2,882488,1,,,,1932
d2c0b5ee8d401bdab705f859e07697c3e26e3901,0,Jeff Eastman,2010-10-05 19:22:49+00:00,['4c864912764782e54f33c0c511d4955c62e3453d'],1,1,2,882490,1,,,,1932
515a414a4ee0bc872621fd0af360d7669e6806a1,1,Robin Anil,2010-10-06 21:38:41+00:00,['d2c0b5ee8d401bdab705f859e07697c3e26e3901'],0,1509,1509,883999,16,0.478021978,0.771978022,0.671703297,1948
1ab159a766ee7c0219c0bd9a5b3ee914c280fdff,0,Sean R. Owen,2010-10-08 06:17:06+00:00,['515a414a4ee0bc872621fd0af360d7669e6806a1'],9,6,15,884014,1,1,0,0,1948
4a31f91b01b79b741611a300262e2eeb2fd12378,0,Sean R. Owen,2010-10-08 13:00:29+00:00,['1ab159a766ee7c0219c0bd9a5b3ee914c280fdff'],1,2,3,884017,1,,,,1948
f50b9a69bb2f072d0dced7c747cbf8f9a408f25c,0,Jeff Eastman,2010-10-08 19:01:34+00:00,['4a31f91b01b79b741611a300262e2eeb2fd12378'],102,104,206,884223,7,1,0,0,1948
9b6984319d93ecf5e0ea3f1b827055ad20005a8b,0,Robin Anil,2010-10-08 20:07:06+00:00,['f50b9a69bb2f072d0dced7c747cbf8f9a408f25c'],4,6,10,884233,4,1,1,0.666666667,1948
595fd5ae02b98a6637f55f9b0850e995f3e34544,0,Sebastian Schelter,2010-10-10 09:10:18+00:00,['9b6984319d93ecf5e0ea3f1b827055ad20005a8b'],24,46,70,884303,3,,,,1948
f201912ac6e4f36fd6d286fc12e905f2cc4cc822,0,Sean R. Owen,2010-10-10 09:56:49+00:00,['595fd5ae02b98a6637f55f9b0850e995f3e34544'],3,5,8,884311,2,0,0,1,1948
e20c007f190de6acdae723b192290b60aeb10fb4,0,Sean R. Owen,2010-10-10 23:16:48+00:00,['f201912ac6e4f36fd6d286fc12e905f2cc4cc822'],1,1,2,884313,1,,,,1948
903575e1bbd5f13d6674b872b96a3fe5dd28ba44,1,Jeff Eastman,2010-10-11 01:03:06+00:00,['e20c007f190de6acdae723b192290b60aeb10fb4'],32,108,140,884453,5,0.222222222,1,0.722222222,1949
48a678cc7ee0ce43532e916e51a4c30d121e2162,0,Jeff Eastman,2010-10-11 14:31:07+00:00,['903575e1bbd5f13d6674b872b96a3fe5dd28ba44'],2,2,4,884457,1,,,,1949
16d172e920ea94ca73aa5aeaae47067cdec52be1,0,Jeff Eastman,2010-10-12 13:50:26+00:00,['48a678cc7ee0ce43532e916e51a4c30d121e2162'],1,1,2,884459,1,,,,1949
d4997623f55762409880a2a94bfb211c998d64d0,1,Andrew L. Farris,2010-10-13 01:55:00+00:00,['16d172e920ea94ca73aa5aeaae47067cdec52be1'],11,12,23,884482,1,,,,1949
fa4822bf80aeb21a5a8099e9396d661e6d3d89f7,0,Andrew L. Farris,2010-10-13 12:49:05+00:00,['d4997623f55762409880a2a94bfb211c998d64d0'],1,1,2,884484,1,,,,1949
de4e1df4da6345ae766c86da63871490cd113cfb,0,Andrew L. Farris,2010-10-13 14:16:52+00:00,['fa4822bf80aeb21a5a8099e9396d661e6d3d89f7'],1,1,2,884486,1,,,,1949
319fd82531c3bc5b8b0751fdf83b8d1d68dc4114,1,Ted Dunning,2010-10-15 03:45:37+00:00,['de4e1df4da6345ae766c86da63871490cd113cfb'],20,92,112,884598,4,1,0.75862069,0.482758621,1949
38c0cb46cc4f0cf551325fec5def4de1e187bd33,0,Ted Dunning,2010-10-15 03:45:40+00:00,['319fd82531c3bc5b8b0751fdf83b8d1d68dc4114'],3,3,6,884604,1,,,,1949
8ce9787b69ef4cba6409502b71496acd4ee838d6,1,Grant Ingersoll,2010-10-15 18:23:57+00:00,['38c0cb46cc4f0cf551325fec5def4de1e187bd33'],1,35,36,884640,3,0,0,1,1949
94089d639ecd312a3bb340dc06e06cb46160c753,1,Andrew L. Farris,2010-10-15 21:56:22+00:00,['8ce9787b69ef4cba6409502b71496acd4ee838d6'],1,1,2,884642,1,,,,1949
4560cd81722872c9bbcafb63c56178954a9ce0b7,0,Sebastian Schelter,2010-10-16 12:33:19+00:00,['94089d639ecd312a3bb340dc06e06cb46160c753'],1,2,3,884645,1,,,,1949
be0683b90b3a316d7082261821dc4f8e5095e25e,0,Sebastian Schelter,2010-10-16 12:41:27+00:00,['4560cd81722872c9bbcafb63c56178954a9ce0b7'],1,1,2,884647,1,,,,1949
fbf5509aa30f7f569608aac8e5635bde8338b645,1,Jeff Eastman,2010-10-16 14:57:28+00:00,['be0683b90b3a316d7082261821dc4f8e5095e25e'],1,1,2,884649,1,,,,1949
d6cd587272e8870530cdc57f58ed7d0a7ba2b212,1,Sebastian Schelter,2010-10-16 17:09:56+00:00,['fbf5509aa30f7f569608aac8e5635bde8338b645'],4,35,39,884688,5,,,,1952
efb835bd259eae59ce91307ff328f12b84dbac9e,0,Jeff Eastman,2010-10-16 17:47:54+00:00,['d6cd587272e8870530cdc57f58ed7d0a7ba2b212'],2,2,4,884692,1,,,,1952
4bb80404696edb20723ab8b770a3b82a6ac66abc,0,Jeff Eastman,2010-10-16 21:58:18+00:00,['efb835bd259eae59ce91307ff328f12b84dbac9e'],1,2,3,884695,1,0,0,1,1952
88193f062d488f8d9a2bf046961affc8cea0104b,0,Jeff Eastman,2010-10-16 23:58:08+00:00,['4bb80404696edb20723ab8b770a3b82a6ac66abc'],1,2,3,884698,1,,,,1952
42f7417ab4bc5ec9914b044dae2c35cbc29f4330,0,Ted Dunning,2010-10-17 07:55:07+00:00,['88193f062d488f8d9a2bf046961affc8cea0104b'],6,7,13,884711,1,,,,1952
38a69607daa70d532dfa915c01f7d70fd84be00b,1,Ted Dunning,2010-10-17 07:55:10+00:00,['42f7417ab4bc5ec9914b044dae2c35cbc29f4330'],17,35,52,884763,3,0,1,0.133333333,1952
9b7802a753deb776492d1370a821fc50829ae6f6,1,Ted Dunning,2010-10-17 07:55:14+00:00,['38a69607daa70d532dfa915c01f7d70fd84be00b'],0,315,315,885078,2,0.662650602,1,0.909638554,1954
d94fda18195a8f78202e473d5ac174fed1a73b46,0,Abdel Hakim Deneche,2010-10-17 11:00:23+00:00,['9b7802a753deb776492d1370a821fc50829ae6f6'],0,0,0,885078,0,,,,1954
b0cb378466ddeb172eff9b44ad65badc122431bb,0,Jeff Eastman,2010-10-17 21:26:54+00:00,['d94fda18195a8f78202e473d5ac174fed1a73b46'],21,16,37,885115,9,,,,1954
cab04b8bc6859662717cacdef5f48899788341f8,0,Robin Anil,2010-10-18 16:58:32+00:00,['b0cb378466ddeb172eff9b44ad65badc122431bb'],1,1,2,885117,1,,,,1954
59143ea6e416eb0555eed568571f0398967285dd,0,Sean R. Owen,2010-10-20 20:48:58+00:00,['cab04b8bc6859662717cacdef5f48899788341f8'],1,1,2,885119,1,,,,1954
0e3e6c509f2b1b7807d7918bb09bce886cfa1940,0,Sean R. Owen,2010-10-20 20:52:02+00:00,['59143ea6e416eb0555eed568571f0398967285dd'],4,4,8,885127,1,,,,1954
60314413d24ab8e34130ae565dd2e17fc44f7f8a,0,Sean R. Owen,2010-10-21 13:38:15+00:00,['0e3e6c509f2b1b7807d7918bb09bce886cfa1940'],49,49,98,885225,9,,,,1954
868e831312979b00db2ef70f4d2956ff1244c380,0,Sean R. Owen,2010-10-21 13:38:57+00:00,['60314413d24ab8e34130ae565dd2e17fc44f7f8a'],47,41,88,885313,9,,,,1954
4dee1c3c540f091905a62c6d25d7961fc7785e2e,1,Benson Margulies,2010-10-23 17:24:38+00:00,['868e831312979b00db2ef70f4d2956ff1244c380'],0,238,238,885551,1,,,,1954
b5e646be274b11c4a8cd0f4092995907236fdded,1,Andrew L. Farris,2010-10-24 02:37:28+00:00,['4dee1c3c540f091905a62c6d25d7961fc7785e2e'],8,3,11,885562,1,,,,1954
e1136b9f97ad5dabf3c0251a06487d0e84eebb74,1,Benson Margulies,2010-10-25 00:24:45+00:00,['b5e646be274b11c4a8cd0f4092995907236fdded'],48,91,139,885701,8,,,,1954
270ab0b0a7b3dfab91ea51e70324baffee98e7db,0,Benson Margulies,2010-10-25 00:28:18+00:00,['e1136b9f97ad5dabf3c0251a06487d0e84eebb74'],17,17,34,885735,9,,,,1954
e149a1afd6c74b265cb64c3558adeb501716f336,0,Benson Margulies,2010-10-25 00:41:22+00:00,['270ab0b0a7b3dfab91ea51e70324baffee98e7db'],41,41,82,885817,9,,,,1954
89c5404ac5f1ab7a7aaea10c9701d1e829a6346a,0,Benson Margulies,2010-10-25 00:41:39+00:00,['e149a1afd6c74b265cb64c3558adeb501716f336'],41,41,82,885899,9,,,,1954
834433b4982990a8eea5dc16c87e9f4cb1df2953,0,Benson Margulies,2010-10-26 00:14:10+00:00,['89c5404ac5f1ab7a7aaea10c9701d1e829a6346a'],17,17,34,885933,9,,,,1954
a9e5c04062e77579f3bba7fd902266bb3b34f00e,0,Benson Margulies,2010-10-26 00:28:10+00:00,['834433b4982990a8eea5dc16c87e9f4cb1df2953'],5,2,7,885940,1,,,,1954
fe5c88e8885d63f9cf5794a6c2ef279ac452b37d,0,Benson Margulies,2010-10-26 00:47:43+00:00,['a9e5c04062e77579f3bba7fd902266bb3b34f00e'],0,6,6,885946,1,,,,1954
01b48600034873ccabcdfc7a9ccbc0ca9a10d100,0,Benson Margulies,2010-10-26 01:13:13+00:00,['fe5c88e8885d63f9cf5794a6c2ef279ac452b37d'],41,41,82,886028,9,,,,1954
24472b1ab9f2db976c153ef140757a57c14f1978,0,Benson Margulies,2010-10-26 01:13:30+00:00,['01b48600034873ccabcdfc7a9ccbc0ca9a10d100'],41,41,82,886110,9,,,,1954
a5c0e6ba0b76f475e6604f4114ef883dfbee879f,0,Benson Margulies,2010-10-26 11:45:53+00:00,['24472b1ab9f2db976c153ef140757a57c14f1978'],17,17,34,886144,9,,,,1954
47a4094224730dee474efb03a6f45c0c605b6fbe,0,Benson Margulies,2010-10-26 11:48:51+00:00,['a5c0e6ba0b76f475e6604f4114ef883dfbee879f'],0,1,1,886145,1,,,,1954
df53a47dda7543542384286f98b3fc36bea22ed9,1,Andrew L. Farris,2010-10-26 19:36:31+00:00,['47a4094224730dee474efb03a6f45c0c605b6fbe'],0,19,19,886164,2,,,,1954
767b996c1e222e2c5790fe7a9ddc4bf30e86b75b,1,Benson Margulies,2010-10-27 12:15:41+00:00,['df53a47dda7543542384286f98b3fc36bea22ed9'],1,1,2,886166,1,,,,1954
9ba70fa29876a94d2fc55c746fcb7c7ba2f8154e,0,Benson Margulies,2010-10-27 12:32:24+00:00,['767b996c1e222e2c5790fe7a9ddc4bf30e86b75b'],36,36,72,886238,8,,,,1954
410d9e199e224480e5fc46df16bf2aa3e807708e,0,Benson Margulies,2010-10-27 12:32:37+00:00,['9ba70fa29876a94d2fc55c746fcb7c7ba2f8154e'],36,36,72,886310,8,,,,1954
6e53a4d652acc3e7ffc8a1978bac8090217af68d,0,Benson Margulies,2010-10-27 19:18:46+00:00,['410d9e199e224480e5fc46df16bf2aa3e807708e'],15,15,30,886340,8,,,,1954
1626b4cbe0991c15147fd8796ac0b41111642ae1,1,Benson Margulies,2010-10-27 19:41:06+00:00,['6e53a4d652acc3e7ffc8a1978bac8090217af68d'],24,23,47,886387,1,,,,1954
b4aa90e336466d3d48f2a36cd3d58d25a3f35e58,0,Benson Margulies,2010-10-28 14:20:05+00:00,['1626b4cbe0991c15147fd8796ac0b41111642ae1'],0,3,3,886390,1,,,,1954
ea1c577e65d7c9d5000aa3ec3d5a2f445f43e807,0,Benson Margulies,2010-10-28 14:24:18+00:00,['b4aa90e336466d3d48f2a36cd3d58d25a3f35e58'],41,41,82,886472,9,,,,1954
03eb0c2a1b804363b1fa430b6dfd8336f66c602e,0,Benson Margulies,2010-10-28 14:25:09+00:00,['ea1c577e65d7c9d5000aa3ec3d5a2f445f43e807'],39,36,75,886547,8,,,,1954
e5f5a3bd82dcfccc0e0a8646392840db642ce65d,0,Benson Margulies,2010-10-28 14:26:52+00:00,['03eb0c2a1b804363b1fa430b6dfd8336f66c602e'],0,1,1,886548,1,,,,1954
f4f40ac9d6ab2c1f055cd7e44111297448a21ec7,0,Benson Margulies,2010-10-28 14:28:49+00:00,['e5f5a3bd82dcfccc0e0a8646392840db642ce65d'],4,4,8,886556,1,,,,1954
e66a7bd0ed9d7a6186f1ba7feca5de817d7a58b7,0,Benson Margulies,2010-10-28 14:32:37+00:00,['f4f40ac9d6ab2c1f055cd7e44111297448a21ec7'],13,11,24,886580,7,,,,1954
58f38346052516cc11eae436ee027d4a09d6f8b4,0,Benson Margulies,2010-10-28 14:34:11+00:00,['e66a7bd0ed9d7a6186f1ba7feca5de817d7a58b7'],0,3,3,886583,1,,,,1954
02bd351e922fe054c0b723c44fae8b0a9455135f,0,Benson Margulies,2010-10-28 14:38:12+00:00,['58f38346052516cc11eae436ee027d4a09d6f8b4'],40,40,80,886663,9,,,,1954
8622138425f4ebb0a1c2a03a81b31e27faf7cc9a,0,Benson Margulies,2010-10-28 14:40:18+00:00,['02bd351e922fe054c0b723c44fae8b0a9455135f'],41,41,82,886745,9,,,,1954
6073bb29dfca8d40bdd65cbb833ff8ff2795af82,1,Sean R. Owen,2010-10-31 20:30:02+00:00,['8622138425f4ebb0a1c2a03a81b31e27faf7cc9a'],32,19,51,886796,1,0,0,0,1954
ad1416331ecd86960610cc6774caa5e1bcf109bb,0,Sean R. Owen,2010-10-31 20:36:48+00:00,['6073bb29dfca8d40bdd65cbb833ff8ff2795af82'],31,75,106,886902,3,1,1,1,1954
6cc884c4c6fbf0921424d4f895556d5d8957a337,0,Abdel Hakim Deneche,2010-11-01 16:43:36+00:00,['ad1416331ecd86960610cc6774caa5e1bcf109bb'],11,108,119,887021,3,0.5,0.5,0.970588235,1955
bb54d455599d0ccd320673380e6186bed67e8f6a,1,Ted Dunning,2010-11-05 03:20:13+00:00,['6cc884c4c6fbf0921424d4f895556d5d8957a337'],16,309,325,887346,4,0.433962264,0.65408805,0.993710692,1957
86b3d6161c14fb63724323a1ee6802308bc6751d,0,Ted Dunning,2010-11-05 03:20:20+00:00,['bb54d455599d0ccd320673380e6186bed67e8f6a'],3,14,17,887363,1,0,0,1,1957
697a8d7493be7f6f7d2dc670ce66a1a3db641900,0,Ted Dunning,2010-11-05 03:20:32+00:00,['86b3d6161c14fb63724323a1ee6802308bc6751d'],2,101,103,887466,5,0.269230769,1,1,1958
5ea5a26a5da1fcd4436ff2cfa4d634602114269e,0,Ted Dunning,2010-11-05 03:20:40+00:00,['697a8d7493be7f6f7d2dc670ce66a1a3db641900'],1,1,2,887468,1,,,,1958
9e7dbb0a8a8127331f8c3342ad3be4b56ca0ba16,0,Sean R. Owen,2010-11-07 09:37:39+00:00,['5ea5a26a5da1fcd4436ff2cfa4d634602114269e'],8,31,39,887507,3,0,1,1,1958
c242e523dcb20dc9585580bfc5d8b459217160fd,1,Benson Margulies,2010-11-08 12:49:57+00:00,['9e7dbb0a8a8127331f8c3342ad3be4b56ca0ba16'],104,121,225,887732,3,,,,1958
d77c389712f1ae0d4cc082faf55699d052e52d0a,0,Sean R. Owen,2010-11-08 19:59:37+00:00,['c242e523dcb20dc9585580bfc5d8b459217160fd'],896,927,1823,889555,9,,,,1958
939ac30b4b482bb3ae24dcf73c730dd1f9021615,1,Sean R. Owen,2010-11-09 13:19:26+00:00,['d77c389712f1ae0d4cc082faf55699d052e52d0a'],241,279,520,890075,68,0,0.619047619,0.404761905,1958
8974838b108b09e45ad9d738d54b6bc6f12e0346,0,Sean R. Owen,2010-11-09 14:01:57+00:00,['939ac30b4b482bb3ae24dcf73c730dd1f9021615'],10,454,464,890539,6,0.27607362,1,0.27607362,1960
1f5c571a14f012acb0c2ba5d44f01f4b91b68ae4,0,Sean R. Owen,2010-11-16 22:07:25+00:00,['8974838b108b09e45ad9d738d54b6bc6f12e0346'],12,15,27,890566,1,0,0,1,1960
5d90b588af177e3b468ec6b8e84dca981773858d,0,Sean R. Owen,2010-11-16 22:08:46+00:00,['1f5c571a14f012acb0c2ba5d44f01f4b91b68ae4'],0,63,63,890629,1,1,1,1,1961
7cf21394342f2c491605204b2c23c4c8ec6ea4da,0,Grant Ingersoll,2010-11-17 15:20:36+00:00,['5d90b588af177e3b468ec6b8e84dca981773858d'],1,9,10,890639,2,1,1,1,1961
a59f6f8c5144f9d94b183c16ecfb72ebbf9491d8,1,Grant Ingersoll,2010-11-18 14:23:20+00:00,['7cf21394342f2c491605204b2c23c4c8ec6ea4da'],1,24,25,890664,2,0,1,1,1961
54085a14150ff205860af7400628981475a7e52d,0,Grant Ingersoll,2010-11-19 14:20:25+00:00,['a59f6f8c5144f9d94b183c16ecfb72ebbf9491d8'],0,3,3,890667,1,,,,1961
a2bb4115d2d234e90ec3be9192f8b57d5a580213,0,Grant Ingersoll,2010-11-19 14:21:19+00:00,['54085a14150ff205860af7400628981475a7e52d'],0,2,2,890669,1,,,,1961
15c61ee24bcd381f3d34650f61a95dbe59c1a417,0,Grant Ingersoll,2010-11-19 14:49:33+00:00,['a2bb4115d2d234e90ec3be9192f8b57d5a580213'],0,2,2,890671,1,,,,1961
706ffc2e9b66b7856c37cd7cefefe90c22cdf56a,0,Grant Ingersoll,2010-11-19 16:49:00+00:00,['15c61ee24bcd381f3d34650f61a95dbe59c1a417'],1,1,2,890673,1,,,,1961
ae8259169fc77e5a04c38935e2ae2a9561f77de4,0,Sebastian Schelter,2010-11-20 18:13:09+00:00,['706ffc2e9b66b7856c37cd7cefefe90c22cdf56a'],1,1,2,890675,1,,,,1961
1c761e024dcf32ec25c6296b6c52f51d87773742,0,Jeff Eastman,2010-11-20 19:19:23+00:00,['ae8259169fc77e5a04c38935e2ae2a9561f77de4'],3,1,4,890679,1,0,0,0,1961
58fd277b2a697fe09cc092c0f180576de15f0aa3,1,Sean R. Owen,2010-11-24 21:11:01+00:00,['1c761e024dcf32ec25c6296b6c52f51d87773742'],197,223,420,891099,57,1,0,0,1961
07d604f2c4fdcd67dd0463e5867d01abaf420090,0,Sebastian Schelter,2010-11-26 21:21:14+00:00,['58fd277b2a697fe09cc092c0f180576de15f0aa3'],22,26,48,891147,2,1,1,1,1961
58d9bf0fdb63bfc40f13a651814e46024544b502,1,Sebastian Schelter,2010-11-26 22:20:48+00:00,['07d604f2c4fdcd67dd0463e5867d01abaf420090'],0,54,54,891201,1,0,1,1,1962
bade960ad6b0b51335cab2ffef9702ef9affe46b,0,Sean R. Owen,2010-11-27 11:17:52+00:00,['58d9bf0fdb63bfc40f13a651814e46024544b502'],0,207,207,891408,2,1,1,0.963855422,1964
5e4edb71a094cbf969f5629915c2ed3b8716b6ec,0,Sean R. Owen,2010-11-27 11:18:24+00:00,['bade960ad6b0b51335cab2ffef9702ef9affe46b'],0,7,7,891415,1,1,1,1,1964
e767bb623ab4c841918ce6590f09b534f3d1ba0b,0,Sebastian Schelter,2010-11-28 09:33:43+00:00,['5e4edb71a094cbf969f5629915c2ed3b8716b6ec'],1,1,2,891417,1,,,,1964
a12e609eb50890998d0ecc48e57916d7fdb92ed6,0,Sebastian Schelter,2010-11-28 09:35:52+00:00,['e767bb623ab4c841918ce6590f09b534f3d1ba0b'],1,1,2,891419,1,,,,1964
e92c694e8d2cca1dcaaddb36f0200f27d21e28df,0,Sebastian Schelter,2010-11-28 09:47:37+00:00,['a12e609eb50890998d0ecc48e57916d7fdb92ed6'],0,0,0,891419,1,,,,1965
9bd4f80752eeb7f4a5853499229b29a6fb24ee32,0,Sean R. Owen,2010-11-28 19:57:00+00:00,['e92c694e8d2cca1dcaaddb36f0200f27d21e28df'],18,167,185,891604,8,0,1,0.858823529,1966
49aca6b9fe5c1c4ee8005cd8e1370b9d1817dec5,0,Sebastian Schelter,2010-12-05 19:40:08+00:00,['9bd4f80752eeb7f4a5853499229b29a6fb24ee32'],7,95,102,891706,3,0.930232558,0.534883721,0.604651163,1966
cf12948b2c48dab276264c3a3667bc2088bfc677,0,Sean R. Owen,2010-12-06 23:25:10+00:00,['49aca6b9fe5c1c4ee8005cd8e1370b9d1817dec5'],2,17,19,891725,4,1,1,0.375,1966
c31a625a813efe311f4c345f364db91db365daae,0,Ted Dunning,2010-12-12 22:40:16+00:00,['cf12948b2c48dab276264c3a3667bc2088bfc677'],4,25,29,891754,2,0,1,1,1966
614fc76a6c650a617662f06450b52c2de30d35f0,1,Isabel Drost,2010-12-16 09:31:06+00:00,['c31a625a813efe311f4c345f364db91db365daae'],4,24,28,891782,1,0,0,0.466666667,1966
f77c2559b8fefc40c06a7090d20af00afd1e41a0,1,Sean R. Owen,2010-12-16 14:20:00+00:00,['614fc76a6c650a617662f06450b52c2de30d35f0'],78,82,160,891942,4,0,1,0,1966
bbb43bda144803b5c8a306324aaee7a1a27d7822,1,Sean R. Owen,2010-12-21 09:17:39+00:00,['f77c2559b8fefc40c06a7090d20af00afd1e41a0'],34,35,69,892011,17,0.666666667,0.333333333,0.333333333,1966
d8a7b9163f7176aa7185319b6917eae1c87e8383,0,Sean R. Owen,2010-12-21 10:27:50+00:00,['bbb43bda144803b5c8a306324aaee7a1a27d7822'],1,2,3,892014,1,,,,1966
04a0324f309e8a30aa1d0a1f11489d9a4c93cfb8,1,Sean R. Owen,2010-12-22 11:06:55+00:00,['d8a7b9163f7176aa7185319b6917eae1c87e8383'],90,77,167,892181,25,0.333333333,1,0.333333333,1966
d7a490a9fd59b47679e6d3d0248f4e79d639e1ff,1,Sean R. Owen,2010-12-22 14:29:00+00:00,['04a0324f309e8a30aa1d0a1f11489d9a4c93cfb8'],39,44,83,892264,4,0.75,1,0.5,1966
02f8694d044b85938a56f48444743f367987ad37,1,Ted Dunning,2010-12-30 02:30:03+00:00,['d7a490a9fd59b47679e6d3d0248f4e79d639e1ff'],251,870,1121,893385,26,0.490765172,0.981530343,0.868073879,1967
c1471da87a12878970eea447df9eb8bb32f2491a,1,Jeff Eastman,2010-12-30 05:52:45+00:00,['02f8694d044b85938a56f48444743f367987ad37'],2,3,5,893390,1,0,0,1,1967
0ac86361e072ce60b5294f73f2825fca8b313752,1,Sebastian Schelter,2011-01-02 10:34:27+00:00,['c1471da87a12878970eea447df9eb8bb32f2491a'],48,120,168,893558,8,1,1,1,1969
7892be34c11990b514b3e24237b04b5116efc2d3,1,Sebastian Schelter,2011-01-03 09:18:46+00:00,['0ac86361e072ce60b5294f73f2825fca8b313752'],260,919,1179,894737,11,0.693950178,0.864768683,0.932384342,1978
d29a980d71402b3e9b7e3f408cc19a59a6037689,0,Jeff Eastman,2011-01-04 00:02:06+00:00,['7892be34c11990b514b3e24237b04b5116efc2d3'],59,67,126,894863,1,1,0.75,0.75,1978
50a76b61a210c1b409d01c0b2b02a03856da940d,0,Sean R. Owen,2011-01-04 22:55:05+00:00,['d29a980d71402b3e9b7e3f408cc19a59a6037689'],1,8,9,894872,1,1,1,1,1978
85ec3a32bfd7b337c8cd45aecac7494c429c462f,1,Sean R. Owen,2011-01-08 13:49:07+00:00,['50a76b61a210c1b409d01c0b2b02a03856da940d'],10161,444,10605,905477,119,0.598092643,0.492279746,0.287238874,1978
5bde30b43928038e36386f77e39acb63b9005b2b,0,Sean R. Owen,2011-01-08 23:40:08+00:00,['85ec3a32bfd7b337c8cd45aecac7494c429c462f'],0,432,432,905909,1,0.313664596,0.630434783,0.319875776,1979
5a5765179fb8e97990f6a5b04bc018b7a9cee389,0,Sean R. Owen,2011-01-10 17:30:20+00:00,['5bde30b43928038e36386f77e39acb63b9005b2b'],31,60,91,906000,3,0,0.888888889,0.944444444,1979
0c4bba06474f7d7b4d5e93ced45ea665b296fa75,0,Sean R. Owen,2011-01-10 22:27:00+00:00,['5a5765179fb8e97990f6a5b04bc018b7a9cee389'],1,3,4,906004,1,,,,1979
1bed5fbdb46dc89a86e9b9d05dabde47517c3461,0,Sean R. Owen,2011-01-11 11:44:47+00:00,['0c4bba06474f7d7b4d5e93ced45ea665b296fa75'],0,12,12,906016,2,0.9,0.9,0.9,1979
c0f3d944047ad6c32a129b02a28822e34cc781a4,1,Sean R. Owen,2011-01-11 20:24:05+00:00,['1bed5fbdb46dc89a86e9b9d05dabde47517c3461'],68,105,173,906189,25,1,1,1,1979
6bc7b7f3452fd717ced096e87e75fa7adaf16d36,0,Sebastian Schelter,2011-01-14 09:00:04+00:00,['c0f3d944047ad6c32a129b02a28822e34cc781a4'],12,21,33,906222,1,0,0,1,1979
234b35200c18e8a143a8f4005fc3ccfe66a48e30,0,Sean R. Owen,2011-01-15 16:28:49+00:00,['6bc7b7f3452fd717ced096e87e75fa7adaf16d36'],77,382,459,906681,7,0.18220339,0.546610169,0.360169492,1979
237ace3aa6113adcfa4e8a8049157da4818611f4,1,Sean R. Owen,2011-01-15 16:36:30+00:00,['234b35200c18e8a143a8f4005fc3ccfe66a48e30'],58,24,82,906763,3,0,0,0,1979
af8ebde30992f66d7978a8f5278f9e895d39451a,1,Sean R. Owen,2011-01-15 16:43:19+00:00,['237ace3aa6113adcfa4e8a8049157da4818611f4'],4,61,65,906828,1,0,1,0.176470588,1979
cfec62fa98be0545c3a01c8fd34b2744385e1786,0,Sean R. Owen,2011-01-16 23:39:07+00:00,['af8ebde30992f66d7978a8f5278f9e895d39451a'],3,3,6,906834,1,,,,1979
da457338777808ee9c5b09d893f6bc76c79b6906,0,Sean R. Owen,2011-01-17 00:09:28+00:00,['cfec62fa98be0545c3a01c8fd34b2744385e1786'],3,1,4,906838,1,0,0,0,1979
1eb917262f980798586c3cb9c54152dbb59485f9,0,Ted Dunning,2011-01-17 01:01:42+00:00,['da457338777808ee9c5b09d893f6bc76c79b6906'],3,1,4,906842,1,0,0,0,1979
711ab6074b5e4ccf8092e9204abe640901ea0411,1,Ted Dunning,2011-01-17 01:02:52+00:00,['1eb917262f980798586c3cb9c54152dbb59485f9'],6,199,205,907047,2,0.245283019,0.462264151,0.669811321,1979
ebaa95d2ab70eab6a9587afabe554e4fe7b84426,1,Ted Dunning,2011-01-17 03:01:26+00:00,['711ab6074b5e4ccf8092e9204abe640901ea0411'],30,114,144,907191,3,0.261904762,1,0.619047619,1979
5baba6ec444157370bc9c999d3b8f374d9d7aea1,0,Ted Dunning,2011-01-17 05:46:05+00:00,['ebaa95d2ab70eab6a9587afabe554e4fe7b84426'],3,3,6,907197,1,,,,1979
76da194b25659aab6bc5ac1ae0787376132c950e,1,Sean R. Owen,2011-01-17 10:24:53+00:00,['5baba6ec444157370bc9c999d3b8f374d9d7aea1'],22,18,40,907237,1,0.5,0,0,1979
41b0a8bc33964f7a1e5e186fd125cc53f1de2b52,1,Sean R. Owen,2011-01-17 11:39:25+00:00,['76da194b25659aab6bc5ac1ae0787376132c950e'],18,27,45,907282,1,0,1,1,1979
347aaedee6f7ec1e7f7f115d08d060f1d436d1e1,1,Jeff Eastman,2011-01-17 17:04:43+00:00,['41b0a8bc33964f7a1e5e186fd125cc53f1de2b52'],1,1,2,907284,1,,,,1979
0d4cb371d24fe83f3d52f5ea60269938c4d0ab70,1,Sean R. Owen,2011-01-18 00:41:30+00:00,['347aaedee6f7ec1e7f7f115d08d060f1d436d1e1'],5,36,41,907325,2,1,1,1,1980
b588af39baa033efac8eba809cc899d71b5a9280,0,Sean R. Owen,2011-01-18 16:28:08+00:00,['0d4cb371d24fe83f3d52f5ea60269938c4d0ab70'],67,141,208,907533,5,0.612903226,1,1,1980
de48f9f96207215bf0f7962d04d2a88da2717a14,0,Sean R. Owen,2011-01-18 16:28:43+00:00,['b588af39baa033efac8eba809cc899d71b5a9280'],7,13,20,907553,2,0,1,0.666666667,1980
f9406683539f5a3ecefa132ae7cb7c83e700d94f,0,Sean R. Owen,2011-01-19 00:49:10+00:00,['de48f9f96207215bf0f7962d04d2a88da2717a14'],18,17,35,907588,2,0.6,1,1,1980
ca920b35069f7433cc67353415de2b3780da15d1,0,Sean R. Owen,2011-01-19 07:37:32+00:00,['f9406683539f5a3ecefa132ae7cb7c83e700d94f'],3,3,6,907594,1,,,,1980
e8b1acf8dc45ba764d6cd91c8b5e5d0a714faa1c,1,Sean R. Owen,2011-01-20 23:36:57+00:00,['ca920b35069f7433cc67353415de2b3780da15d1'],134,239,373,907967,2,0.363636364,1,0,1981
a9234ce16d6ba605747fc641302ce68aba303495,0,Sean R. Owen,2011-01-21 19:58:21+00:00,['e8b1acf8dc45ba764d6cd91c8b5e5d0a714faa1c'],14,27,41,908008,1,0,0,1,1981
ba6e77f733659cec32d39c1f63cdeb69f3ee6ff6,1,Andrew L. Farris,2011-01-22 15:08:23+00:00,['a9234ce16d6ba605747fc641302ce68aba303495'],28,234,262,908270,3,,,,1983
495f736df90968b6f03ae2b050cd05ea8602fd5f,0,Ted Dunning,2011-01-24 06:44:33+00:00,['ba6e77f733659cec32d39c1f63cdeb69f3ee6ff6'],9,44,53,908323,2,1,1,1,1984
d2915a0b38562de5b27f06e7a6ec5f6c35c9c06f,1,Sean R. Owen,2011-01-24 21:42:41+00:00,['495f736df90968b6f03ae2b050cd05ea8602fd5f'],35,56,91,908414,8,0.176470588,0.647058824,0,1984
f3723040d134b5a8d2739f1d7c9ffb6245679e79,1,Ted Dunning,2011-01-25 00:30:41+00:00,['d2915a0b38562de5b27f06e7a6ec5f6c35c9c06f'],1538,4,1542,909956,11,0.783055199,0.716302953,0.0436457,1984
d9ccec463c7f9ffc3c99f1e2e4eeaeee4bbb11bf,1,Sean R. Owen,2011-01-25 15:31:02+00:00,['f3723040d134b5a8d2739f1d7c9ffb6245679e79'],0,26,26,909982,5,,,,1984
ad8b61d809b5fd15dea9ef031d14ec8055ab9a03,0,Sean R. Owen,2011-01-26 23:21:41+00:00,['d9ccec463c7f9ffc3c99f1e2e4eeaeee4bbb11bf'],86,161,247,910229,18,0,0.754716981,0.867924528,1984
b1d63885954bff8d804fce8ccdeef88b20a59ecd,0,Sean R. Owen,2011-01-27 11:14:51+00:00,['ad8b61d809b5fd15dea9ef031d14ec8055ab9a03'],7,24,31,910260,2,0,1,0.8,1984
977cc3995690858f7714fb587947ce9231dca06b,0,Sebastian Schelter,2011-01-28 14:23:38+00:00,['b1d63885954bff8d804fce8ccdeef88b20a59ecd'],11,13,24,910284,2,,,,1984
8bf7ac422adcbc74d6d8ebd87edc39caf4eac879,1,Ted Dunning,2011-01-29 05:57:24+00:00,['977cc3995690858f7714fb587947ce9231dca06b'],10,10,20,910304,1,,,,1984
0b78318b2fbc0a8c6503cb4bca6cda581c8876a9,0,Sebastian Schelter,2011-01-30 14:59:51+00:00,['8bf7ac422adcbc74d6d8ebd87edc39caf4eac879'],1,1,2,910306,1,,,,1984
e04d6f329b74538370cf2656d532aee41fb9527c,1,Ted Dunning,2011-01-31 03:40:51+00:00,['0b78318b2fbc0a8c6503cb4bca6cda581c8876a9'],19,24,43,910349,2,1,1,0,1984
84d667d8aec89664a2fe69532f30de3e0e44835a,0,Ted Dunning,2011-01-31 03:40:54+00:00,['e04d6f329b74538370cf2656d532aee41fb9527c'],4,4,8,910357,1,,,,1984
3a0509f60a1cf5fb6dbd35911e51d2dad6214b68,0,Jeff Eastman,2011-01-31 17:40:15+00:00,['84d667d8aec89664a2fe69532f30de3e0e44835a'],1,1,2,910359,1,,,,1984
75f8f0eb54fb2dcf3d6e2d3160b47a1089cdee80,0,Grant Ingersoll,2011-02-01 14:37:46+00:00,['3a0509f60a1cf5fb6dbd35911e51d2dad6214b68'],0,7,7,910366,1,,,,1984
9703584d0d86d8576bb02738fa31736d8bf3d8a6,1,Sean R. Owen,2011-02-03 12:51:06+00:00,['75f8f0eb54fb2dcf3d6e2d3160b47a1089cdee80'],81,95,176,910542,6,0,1,1,1984
672b6f9cf5e46175c78b277d8c07ac88de7308d8,0,Abdel Hakim Deneche,2011-02-04 08:50:02+00:00,['9703584d0d86d8576bb02738fa31736d8bf3d8a6'],4,4,8,910550,1,0,0,0,1984
306b285816c6d200e29ddc94bd13ade411978249,0,Abdel Hakim Deneche,2011-02-04 08:56:26+00:00,['672b6f9cf5e46175c78b277d8c07ac88de7308d8'],10,2,12,910562,1,0,0,0,1984
3c7136379aa22f900c7111175479be3c1d60b95b,0,Sean R. Owen,2011-02-04 17:48:46+00:00,['306b285816c6d200e29ddc94bd13ade411978249'],0,293,293,910855,4,0.421052632,1,0.947368421,1988
8efcdac10686a5776a920a9d3cc3e184f847f147,0,Sebastian Schelter,2011-02-04 18:49:59+00:00,['3c7136379aa22f900c7111175479be3c1d60b95b'],3,30,33,910888,2,0,1,0.777777778,1988
a06f96c8a011bd2c9c0e572e3d965dc6f9325bd4,0,Sean R. Owen,2011-02-05 18:05:43+00:00,['8efcdac10686a5776a920a9d3cc3e184f847f147'],9,9,18,910906,2,,,,1988
3a1adb7b5b84f5ea4ce2aee7ca99e55b459266d0,1,Sean R. Owen,2011-02-05 19:06:34+00:00,['a06f96c8a011bd2c9c0e572e3d965dc6f9325bd4'],204,259,463,911369,30,0.339622642,0.566037736,0.981132075,1988
7d656ca9ad1f5fab7d66fac8b3b11776135704c2,0,Sebastian Schelter,2011-02-12 00:38:01+00:00,['3a1adb7b5b84f5ea4ce2aee7ca99e55b459266d0'],0,0,0,911369,2,,,,1988
5a2a2562e8231d1c7e159023bb658d3f675612df,1,Sean R. Owen,2011-02-14 08:47:39+00:00,['7d656ca9ad1f5fab7d66fac8b3b11776135704c2'],150,12,162,911531,44,,,,1988
37d9cca5df12c5d6104038179f20e6d34aa58a74,0,Sebastian Schelter,2011-02-14 19:40:15+00:00,['5a2a2562e8231d1c7e159023bb658d3f675612df'],62,129,191,911722,2,0.188679245,0.490566038,1,1988
75d18373ebd5ebf291ffcd58f2d51fc1ca2fe358,1,Sebastian Schelter,2011-02-14 23:23:57+00:00,['37d9cca5df12c5d6104038179f20e6d34aa58a74'],4,4,8,911730,1,,,,1988
0b04779565a30f0e1e6debb6c2ce846fb1df1447,0,Sean R. Owen,2011-02-15 07:57:39+00:00,['75d18373ebd5ebf291ffcd58f2d51fc1ca2fe358'],8,8,16,911746,1,,,,1988
4ee6a1fbc4ffcf701582d75e5509f407ea371a8f,0,Sebastian Schelter,2011-02-16 19:28:29+00:00,['0b04779565a30f0e1e6debb6c2ce846fb1df1447'],9,51,60,911806,2,0.21875,1,0.75,1988
c181b9f5f0d9b8933f1b3bce9efd9ecabaa6a362,0,Sebastian Schelter,2011-02-20 16:52:09+00:00,['4ee6a1fbc4ffcf701582d75e5509f407ea371a8f'],5,7,12,911818,4,,,,1988
d2fe1ac3708c6aecf61858692f5b0f61789e3464,0,Sean R. Owen,2011-02-21 06:45:28+00:00,['c181b9f5f0d9b8933f1b3bce9efd9ecabaa6a362'],0,0,0,911818,0,,,,1988
d61a0ee216389fcac1d3e56f531aa4cc8f597c59,1,Sean R. Owen,2011-02-21 06:47:02+00:00,['d2fe1ac3708c6aecf61858692f5b0f61789e3464'],617,568,1185,913003,104,0,1,0.529411765,1989
aadc0984ea019fcc79867386406d0c3bf1037ac7,1,Sean R. Owen,2011-02-22 21:17:35+00:00,['d61a0ee216389fcac1d3e56f531aa4cc8f597c59'],57,14,71,913074,2,0.266666667,0,1,1989
43c059c7dec4d67a7cebac94356d7ee068c9e00c,0,Sean R. Owen,2011-02-24 18:07:56+00:00,['aadc0984ea019fcc79867386406d0c3bf1037ac7'],2,9,11,913085,1,1,1,1,1989
530253de47fb45ec813f45109bb1036ff3f87cb7,1,Sean R. Owen,2011-02-26 11:52:57+00:00,['43c059c7dec4d67a7cebac94356d7ee068c9e00c'],0,44,44,913129,1,,,,1990
14bfc076eaa8a8af2484c95b0c8945f836256587,0,Dmitriy Lyubimov,2011-02-28 02:49:36+00:00,['530253de47fb45ec813f45109bb1036ff3f87cb7'],0,2,2,913131,1,,,,1990
7a9e99ec4ac53d32d598b63412ee470fc8a03c2e,1,Sean R. Owen,2011-03-03 18:17:50+00:00,['14bfc076eaa8a8af2484c95b0c8945f836256587'],54,943,997,914128,21,0.483240223,0.589385475,0.837988827,1999
151de0d737501af5dcfee8a21bc7d18ff6edddc8,1,Dmitriy Lyubimov,2011-03-07 06:34:12+00:00,['7a9e99ec4ac53d32d598b63412ee470fc8a03c2e'],3,3613,3616,917744,21,0.369369369,0.70213964,0.567567568,2016
13bd3085ad83d08efe45ab4cb20f296ee9f8c7a5,0,Dmitriy Lyubimov,2011-03-07 07:09:58+00:00,['151de0d737501af5dcfee8a21bc7d18ff6edddc8'],27,30,57,917801,1,1,1,1,2016
75ea223e804ad6936976ef9ffd7947f45a690c75,1,Sean R. Owen,2011-03-07 08:36:36+00:00,['13bd3085ad83d08efe45ab4cb20f296ee9f8c7a5'],60,125,185,917986,4,0,0.416666667,0.333333333,2016
f696d3635f390a514bd708ffa762486850f55ed1,1,Sean R. Owen,2011-03-08 01:51:50+00:00,['75ea223e804ad6936976ef9ffd7947f45a690c75'],25,407,432,918418,36,0.494845361,0.948453608,0.969072165,2016
2f4ac68921f348abbebbb9e6434c9531972539a8,1,Sean R. Owen,2011-03-08 08:57:52+00:00,['f696d3635f390a514bd708ffa762486850f55ed1'],58,108,166,918584,2,0.166666667,0.166666667,0.233333333,2017
3bfdd3a08ea71973c5f475ceec147079b8430890,0,Sean R. Owen,2011-03-09 14:41:01+00:00,['2f4ac68921f348abbebbb9e6434c9531972539a8'],6,10,16,918600,1,0,1,0,2017
07bfa59e5a3a359136e0c565564dfe769f3f84db,1,Robin Anil,2011-03-13 19:07:17+00:00,['3bfdd3a08ea71973c5f475ceec147079b8430890'],0,70,70,918670,1,0,1,1,2017
d25dd2069df700169753952a2dec44879a5178c2,1,Sean R. Owen,2011-03-18 17:54:11+00:00,['07bfa59e5a3a359136e0c565564dfe769f3f84db'],97,614,711,919381,13,0.495238095,0.6,0.957142857,2024
17988ce5e65cf9668c68e2704620c82d5bd84817,0,Sean R. Owen,2011-03-20 15:27:02+00:00,['d25dd2069df700169753952a2dec44879a5178c2'],13,166,179,919560,7,0.327868852,0,1,2026
f5bb6b7eadaf63e07a79e5c13a1cbbe59576538d,0,Sean R. Owen,2011-03-20 15:53:32+00:00,['17988ce5e65cf9668c68e2704620c82d5bd84817'],18,338,356,919916,14,0.165829146,0.56281407,0.899497487,2026
c4550a1812cbb5a8f6db8250c604635527bfd538,1,Sean R. Owen,2011-03-20 20:51:33+00:00,['f5bb6b7eadaf63e07a79e5c13a1cbbe59576538d'],15,31,46,919962,4,1,1,0.666666667,2026
9ceb0970e01ca74cd0ea2bf030d60291cd603d52,0,Sean R. Owen,2011-03-22 08:48:57+00:00,['c4550a1812cbb5a8f6db8250c604635527bfd538'],3,2,5,919967,1,0,0,1,2026
a25bab20fbd704726013b64d93a965763ffb04ad,0,Sean R. Owen,2011-03-22 10:21:56+00:00,['9ceb0970e01ca74cd0ea2bf030d60291cd603d52'],8,7,15,919982,6,,,,2026
c4597cb82df23157764baed7f8944f713316e75f,1,Sean R. Owen,2011-03-22 16:15:36+00:00,['a25bab20fbd704726013b64d93a965763ffb04ad'],3,172,175,920157,3,0.273809524,1,1,2028
baa399cd2361dd4c6b5ca5a0357f9b18376d35af,1,Robin Anil,2011-03-22 16:15:41+00:00,['c4597cb82df23157764baed7f8944f713316e75f'],0,94883,94883,1015040,5,0,0.279661017,1,2032
58fb7c5df98097318453db2cb7e7b413a4749719,0,Sebastian Schelter,2011-03-22 19:18:10+00:00,['baa399cd2361dd4c6b5ca5a0357f9b18376d35af'],7,3,10,1015050,1,1,0,0,2032
6aa2bdbd288919f6ac2c97feae8a066b921c0150,0,Sebastian Schelter,2011-03-22 21:48:22+00:00,['58fb7c5df98097318453db2cb7e7b413a4749719'],34,126,160,1015210,6,0.714285714,0.714285714,0.971428571,2033
466f319cead11e9733dbfd0d25a343627e102aad,1,Isabel Drost,2011-03-23 13:32:26+00:00,['6aa2bdbd288919f6ac2c97feae8a066b921c0150'],132,392,524,1015734,6,0.778846154,1,0.759615385,2037
af775ba7dd35ba27f836de39a2610c1c1e82afde,1,Sebastian Schelter,2011-03-23 22:33:57+00:00,['466f319cead11e9733dbfd0d25a343627e102aad'],0,1479,1479,1017213,16,0.545331529,0.771312585,0.818673884,2052
763433cd756da7fda62e1fe6ee60a52f2c8d5221,1,Ted Dunning,2011-03-24 23:39:32+00:00,['af775ba7dd35ba27f836de39a2610c1c1e82afde'],0,130,130,1017343,2,0.590909091,1,1,2054
bdacb9a41ec7c5acc53b606ff63d2e2bea47dc5a,0,Grant Ingersoll,2011-03-25 13:44:17+00:00,['763433cd756da7fda62e1fe6ee60a52f2c8d5221'],0,16,16,1017359,1,,,,2054
747dfa4eda826821c2df5c99cd1d587ccb4011b4,1,Grant Ingersoll,2011-03-25 14:28:12+00:00,['bdacb9a41ec7c5acc53b606ff63d2e2bea47dc5a'],24,406,430,1017789,10,0.51875,0.84375,0.8375,2058
c36923f525ef9be0f6e11e71bc892c52734b7b99,1,Grant Ingersoll,2011-03-25 14:39:25+00:00,['747dfa4eda826821c2df5c99cd1d587ccb4011b4'],0,741,741,1018530,4,0.37694704,0.769470405,0.943925234,2062
f29a874f803f76c090c55db9ef02a85113773964,0,Sean R. Owen,2011-03-27 14:03:20+00:00,['c36923f525ef9be0f6e11e71bc892c52734b7b99'],278,17,295,1018825,8,0,0,0.018691589,2062
dec61dee27807815b9308b75213f067a53c81f32,1,Dmitriy Lyubimov,2011-03-29 04:02:26+00:00,['f29a874f803f76c090c55db9ef02a85113773964'],63,150,213,1019038,4,,,,2062
b0ac9f5178fe52ed4b7e82feb610ffcb1417da48,1,Dmitriy Lyubimov,2011-03-29 04:36:33+00:00,['dec61dee27807815b9308b75213f067a53c81f32'],8,23,31,1019069,2,0,0.083333333,0.083333333,2062
39386b2bbfb0b6f0e0d360d262be714f86337009,0,Sean R. Owen,2011-03-30 15:50:20+00:00,['b0ac9f5178fe52ed4b7e82feb610ffcb1417da48'],645,25,670,1019739,17,0.681440443,0.432132964,0.27700831,2062
00e3d8f9f8141d438edc817b64c8bc4ee667245b,0,Sebastian Schelter,2011-03-30 19:36:37+00:00,['39386b2bbfb0b6f0e0d360d262be714f86337009'],3,3,6,1019745,2,,,,2062
a13b4b7fae76062d7db63aebbde750fce6daed70,1,Sean R. Owen,2011-03-31 09:25:25+00:00,['00e3d8f9f8141d438edc817b64c8bc4ee667245b'],3333,3071,6404,1026149,182,1,0.894736842,0.485964912,2076
a116dc7085f78ae025a7d13c0ff078a1c71f3f4e,1,Sean R. Owen,2011-03-31 09:28:44+00:00,['a13b4b7fae76062d7db63aebbde750fce6daed70'],1,149,150,1026299,3,1,1,0.685185185,2078
be09d7347223baab6bc217502661e4caa69de3a4,1,Sean R. Owen,2011-03-31 10:40:07+00:00,['a116dc7085f78ae025a7d13c0ff078a1c71f3f4e'],18,194,212,1026511,5,0.537931034,1,0.579310345,2078
2feae277d324ec985d93624a4f34f66813e53007,1,Sean R. Owen,2011-03-31 19:00:25+00:00,['be09d7347223baab6bc217502661e4caa69de3a4'],10,105,115,1026626,1,0,0.040540541,0.959459459,2078
62b237759d5f37a0b1400655248ff4c7428e3d3e,0,Sean R. Owen,2011-03-31 21:38:45+00:00,['2feae277d324ec985d93624a4f34f66813e53007'],3,3,6,1026632,2,,,,2078
b16c26072da5828e6b9a05a882da838463a8f2a6,1,Sean R. Owen,2011-04-02 09:26:16+00:00,['62b237759d5f37a0b1400655248ff4c7428e3d3e'],248,263,511,1027143,48,0,0.777777778,0.944444444,2078
d023fad1ab0f9443a4d67f8924a42907d1616940,1,Sean R. Owen,2011-04-02 10:14:00+00:00,['b16c26072da5828e6b9a05a882da838463a8f2a6'],116,196,312,1027455,4,0.435897436,0.205128205,0.743589744,2079
e23728debd770f4710d9455c5bb6117b3d864ff9,1,Sebastian Schelter,2011-04-02 16:38:38+00:00,['d023fad1ab0f9443a4d67f8924a42907d1616940'],117,753,870,1028325,38,0.681528662,1,0.719745223,2084
2d2e58631ae92e4e989f3114c3e37a033c003983,0,Sean R. Owen,2011-04-03 20:40:38+00:00,['e23728debd770f4710d9455c5bb6117b3d864ff9'],281,2,283,1028608,4,0.72,0.346666667,0.08,2084
281156e2c3a5a768f5fe70db3dd1e6bcd9edf152,0,Sean R. Owen,2011-04-04 07:12:14+00:00,['2d2e58631ae92e4e989f3114c3e37a033c003983'],53,14,67,1028675,3,0,0,0,2084
3d4e6f287302a1d1e6371688829a2c007f971592,1,Jacob Alexander Mannix,2011-04-05 00:20:27+00:00,['281156e2c3a5a768f5fe70db3dd1e6bcd9edf152'],89,230,319,1028994,13,0.286956522,1,0.782608696,2084
4b30ce3d047911e9f6a9924a2ad6ea625f2c99b8,1,Dmitriy Lyubimov,2011-04-05 02:49:08+00:00,['3d4e6f287302a1d1e6371688829a2c007f971592'],61,81,142,1029136,7,,,,2084
0681eb11afbe12e512e0c475ef3e76018500c6a9,1,Sean R. Owen,2011-04-05 10:21:32+00:00,['4b30ce3d047911e9f6a9924a2ad6ea625f2c99b8'],26,37,63,1029199,12,0.090909091,0,0,2084
35032b8b4e08e8873ac02d96cb2a63f5b19daae3,1,Sean R. Owen,2011-04-05 21:13:49+00:00,['0681eb11afbe12e512e0c475ef3e76018500c6a9'],2012,459,2471,1031670,62,0.336828309,0,0.688073394,2085
375e080d1f9b53631b55a40cdb88850d859677f9,0,Abdel Hakim Deneche,2011-04-05 21:27:33+00:00,['35032b8b4e08e8873ac02d96cb2a63f5b19daae3'],0,2,2,1031672,1,1,1,1,2085
75d76fdf94a30adbf43c0ab97261891abe7e8db8,0,Sean R. Owen,2011-04-06 11:20:37+00:00,['375e080d1f9b53631b55a40cdb88850d859677f9'],46,0,46,1031718,2,,,,2085
05a29c3f08b8f938e98c00703588db145d09f6f4,1,Grant Ingersoll,2011-04-06 21:25:41+00:00,['75d76fdf94a30adbf43c0ab97261891abe7e8db8'],0,197,197,1031915,1,,,,2086
4641c87ebc5e8cd9d2764b6a17445d6ce7dc3997,1,Sean R. Owen,2011-04-06 22:02:48+00:00,['05a29c3f08b8f938e98c00703588db145d09f6f4'],134,39,173,1032088,9,0.948051948,0.311688312,0.142857143,2086
208aa074f35c0c0143f9ad00b7f0056299b80eba,1,Sean R. Owen,2011-04-07 08:31:12+00:00,['4641c87ebc5e8cd9d2764b6a17445d6ce7dc3997'],130,134,264,1032352,40,1,1,0.176470588,2086
ad17b0d1f00bea5f1932ce3d8f2170120e29d4f2,0,Sean R. Owen,2011-04-07 14:39:14+00:00,['208aa074f35c0c0143f9ad00b7f0056299b80eba'],219,208,427,1032779,9,0.965517241,0,0,2088
c8e77d84ea952b1e0d17164e8aa0ddd5fbed039f,0,Benson Margulies,2011-04-07 20:14:46+00:00,['ad17b0d1f00bea5f1932ce3d8f2170120e29d4f2'],0,4,4,1032783,1,,,,2088
abff05e2a13cb88d4d4628062d2bbf02df058b08,0,Benson Margulies,2011-04-07 20:14:52+00:00,['c8e77d84ea952b1e0d17164e8aa0ddd5fbed039f'],94,22,116,1032899,9,,,,2088
c439f53c74d6c8589ced4c89c1a312bbf70d8d62,0,Sebastian Schelter,2011-04-07 21:10:28+00:00,['abff05e2a13cb88d4d4628062d2bbf02df058b08'],13,731,744,1033643,7,0.564102564,0.675213675,0.643874644,2094
105be3e11b0bc426879dd3ea1f9bcb30adbfdd4f,0,Benson Margulies,2011-04-08 11:48:07+00:00,['c439f53c74d6c8589ced4c89c1a312bbf70d8d62'],2,4,6,1033649,1,,,,2094
6063d3f5927847c6200793beb798a7d30df5b811,0,Benson Margulies,2011-04-08 15:47:42+00:00,['105be3e11b0bc426879dd3ea1f9bcb30adbfdd4f'],19,0,19,1033668,1,,,,2094
554f434158d7adffdb8d41b88166a5d15ddee724,0,Jeff Eastman,2011-04-10 16:51:56+00:00,['6063d3f5927847c6200793beb798a7d30df5b811'],0,1,1,1033669,1,0,1,0,2094
328a543e60954f3e7c83a58af55d15d76804991d,0,Jeff Eastman,2011-04-10 18:10:50+00:00,['554f434158d7adffdb8d41b88166a5d15ddee724'],2,26,28,1033697,4,0.454545455,1,0.545454545,2094
80366ee59bc003a5cf18910340bd3d2a08d87de5,1,Sean R. Owen,2011-04-10 18:30:05+00:00,['328a543e60954f3e7c83a58af55d15d76804991d'],2285,1026,3311,1037008,99,0.15826087,0,0.060869565,2096
9af07ed974ec639518d6980448ab892c6c120908,1,Jeff Eastman,2011-04-10 20:00:13+00:00,['80366ee59bc003a5cf18910340bd3d2a08d87de5'],650,1044,1694,1038702,11,0.345360825,0.845360825,0.881443299,2096
ce284d8f2cd8e9ad9901c8ee9f8e277e2dc17858,1,Jacob Alexander Mannix,2011-04-12 05:05:06+00:00,['9af07ed974ec639518d6980448ab892c6c120908'],6,93,99,1038801,2,0,1,0.983333333,2096
fb7dd583e70de55c491b5582ea843faa0e89dfdb,0,Sean R. Owen,2011-04-12 08:06:39+00:00,['ce284d8f2cd8e9ad9901c8ee9f8e277e2dc17858'],433,16,449,1039250,10,0.235632184,0,0,2096
bd5d2f30a93f7accbf019c34e88ed47cfea0fa64,1,Sebastian Schelter,2011-04-12 09:40:58+00:00,['fb7dd583e70de55c491b5582ea843faa0e89dfdb'],0,547,547,1039797,4,0.18699187,1,0.849593496,2100
f3a9cc138cf2e4e64436d24eda06d32d335aff85,1,Sean R. Owen,2011-04-12 18:55:25+00:00,['bd5d2f30a93f7accbf019c34e88ed47cfea0fa64'],318,351,669,1040466,51,1,0.287234043,0.106382979,2101
11afe576b256b9b44229348cddfadaddbb359f0f,0,Sean R. Owen,2011-04-12 18:58:13+00:00,['f3a9cc138cf2e4e64436d24eda06d32d335aff85'],19,66,85,1040551,4,1,0.466666667,1,2101
471cb81754b3f377abd077efd57f9ae9e1978f68,0,Sean R. Owen,2011-04-12 20:16:02+00:00,['11afe576b256b9b44229348cddfadaddbb359f0f'],0,8,8,1040559,1,1,1,1,2101
f147e17328f402f6a6580878a3a772ed298f2dae,0,Sean R. Owen,2011-04-14 11:13:36+00:00,['471cb81754b3f377abd077efd57f9ae9e1978f68'],1,1,2,1040561,1,,,,2101
82f941298bad7760b61485d029590efd6994b43d,1,Sean R. Owen,2011-04-15 09:48:07+00:00,['f147e17328f402f6a6580878a3a772ed298f2dae'],50,37,87,1040648,3,0,0,0.333333333,2101
d8ac693133622ba28da15d54bf0d5400697242dc,0,Sean R. Owen,2011-04-15 10:24:21+00:00,['82f941298bad7760b61485d029590efd6994b43d'],14,26,40,1040688,3,0,1,1,2101
4e75f777e8ecebf0fc36cdebc5b62e1ca9d68413,0,Sean R. Owen,2011-04-15 13:33:04+00:00,['d8ac693133622ba28da15d54bf0d5400697242dc'],8,8,16,1040704,5,,,,2101
84f17ae48ddeaf6de637d839e4625aa32484fd00,0,Sebastian Schelter,2011-04-17 10:09:42+00:00,['4e75f777e8ecebf0fc36cdebc5b62e1ca9d68413'],6,387,393,1041097,6,0.389937107,0.805031447,0.899371069,2105
bd368539913733904e9ca74c19c726258f2c3bbe,0,Sean R. Owen,2011-04-17 15:09:46+00:00,['84f17ae48ddeaf6de637d839e4625aa32484fd00'],121,125,246,1041343,1,0,1,0,2105
3218e951e55dea4d2cb984be697f39bb70e82a36,1,Sean R. Owen,2011-04-17 15:30:15+00:00,['bd368539913733904e9ca74c19c726258f2c3bbe'],743,836,1579,1042922,102,0,0.933333333,0.438095238,2105
172bb3bd8c83c45ba50a255621ddade9c8e8d1af,0,Jeff Eastman,2011-04-18 04:19:01+00:00,['3218e951e55dea4d2cb984be697f39bb70e82a36'],147,578,725,1043647,24,0.271186441,0.774011299,0.768361582,2110
8049eff6dd48dc2621219c51e1eef97dd62165c8,0,Jeff Eastman,2011-04-18 04:20:36+00:00,['172bb3bd8c83c45ba50a255621ddade9c8e8d1af'],0,254,254,1043901,1,0.905555556,1,1,2111
ff31f377268456d212763b9c60d9205acd3ab1ba,0,Sean R. Owen,2011-04-18 21:32:30+00:00,['8049eff6dd48dc2621219c51e1eef97dd62165c8'],1,1,2,1043903,1,,,,2111
c03322867930e5a9a40f19035eaf4d3cd26dafe2,0,Sean R. Owen,2011-04-18 21:42:12+00:00,['ff31f377268456d212763b9c60d9205acd3ab1ba'],15,13,28,1043931,1,,,,2111
6ad3e135004f695f0a795cadf09d39f4a1b74bbb,1,Sean R. Owen,2011-04-18 21:45:27+00:00,['c03322867930e5a9a40f19035eaf4d3cd26dafe2'],1,6,7,1043938,1,0,0,1,2111
a581a13a5f3dc5688e231392dad652af1bcd6376,1,Sean R. Owen,2011-04-19 07:07:14+00:00,['6ad3e135004f695f0a795cadf09d39f4a1b74bbb'],1,23,24,1043962,1,0,0.733333333,0.266666667,2111
b479bd27035f0222df7176816afde0b14cfe4418,1,Dmitriy Lyubimov,2011-04-19 14:32:17+00:00,['a581a13a5f3dc5688e231392dad652af1bcd6376'],63,240,303,1044265,6,0.492753623,1,1,2112
3e276bb4a8855734fa440845e75c9376b7a5cdcb,0,Dmitriy Lyubimov,2011-04-19 15:34:19+00:00,['b479bd27035f0222df7176816afde0b14cfe4418'],3,1,4,1044269,1,1,0,0,2112
afc8abbd70f2a3c5df25ef06d4b7e52572eee280,0,Sean R. Owen,2011-04-20 16:57:14+00:00,['3e276bb4a8855734fa440845e75c9376b7a5cdcb'],1,2,3,1044272,1,0,1,1,2112
933e22a2afa9bfe6a38f1f33d6adb0cee6cc38aa,0,Jeff Eastman,2011-04-22 04:34:06+00:00,['afc8abbd70f2a3c5df25ef06d4b7e52572eee280'],151,277,428,1044700,16,0.215384615,1,0.892307692,2113
a3b93795bb530d9be3f7b3c2dfac8e89a6a980e2,1,Ted Dunning,2011-04-22 04:58:14+00:00,['933e22a2afa9bfe6a38f1f33d6adb0cee6cc38aa'],11,97,108,1044808,3,0.106060606,0.075757576,0.696969697,2113
0e23821df0e1b0e17d1ed7b196ed5185f6d2db33,0,Dmitriy Lyubimov,2011-04-22 05:18:33+00:00,['a3b93795bb530d9be3f7b3c2dfac8e89a6a980e2'],10,53,63,1044871,1,0,1,0.4375,2113
3ffddc56c4d954ae8c03fb41f8cf8290467266b0,0,Ted Dunning,2011-04-22 06:13:36+00:00,['0e23821df0e1b0e17d1ed7b196ed5185f6d2db33'],0,68,68,1044939,2,1,1,1,2115
9c5a1f8e7a296438291a55ca58441045d1e75b0d,1,Jeff Eastman,2011-04-22 16:55:03+00:00,['3ffddc56c4d954ae8c03fb41f8cf8290467266b0'],15,25,40,1044979,1,0.6,1,1,2115
a4fc290a53eb512487388ff87d52569aa8adacc7,0,Ted Dunning,2011-04-22 18:34:41+00:00,['9c5a1f8e7a296438291a55ca58441045d1e75b0d'],1,6,7,1044986,1,0,0,1,2115
691bf8e65a6fe348019acc637a648b1976ceef99,0,Ted Dunning,2011-04-22 18:34:44+00:00,['a4fc290a53eb512487388ff87d52569aa8adacc7'],9,0,9,1044995,1,0.444444444,0,0,2115
57472918a320e2c4b2c011a875ecc5ad8591a620,1,Sean R. Owen,2011-04-23 08:44:22+00:00,['691bf8e65a6fe348019acc637a648b1976ceef99'],6,9,15,1045010,1,,,,2115
15712a6eda44b04cb52e61ac04a779848f9485c1,0,Sean R. Owen,2011-04-23 15:53:32+00:00,['57472918a320e2c4b2c011a875ecc5ad8591a620'],44,92,136,1045146,11,0.285714286,0.714285714,0,2115
642d48ff0be783668753fbc0e06a32a6f03aea09,0,Sean R. Owen,2011-04-24 08:07:42+00:00,['15712a6eda44b04cb52e61ac04a779848f9485c1'],3,3,6,1045152,2,,,,2115
ece4db69918406abb86c65cd422d3f9edf71be24,1,Sean R. Owen,2011-04-25 11:36:59+00:00,['642d48ff0be783668753fbc0e06a32a6f03aea09'],1175,19,1194,1046346,16,0.05203252,0,0.030894309,2115
8205dae408407f764e8f7bdfaa66feae7c94b32c,0,Benson Margulies,2011-04-28 23:54:43+00:00,['ece4db69918406abb86c65cd422d3f9edf71be24'],5,0,5,1046351,1,,,,2115
0e3f35da37442d6dd451d355290aafb651805995,1,Benson Margulies,2011-04-28 23:54:49+00:00,['8205dae408407f764e8f7bdfaa66feae7c94b32c'],0,5,5,1046356,1,,,,2115
fcd0f0ed5659e4946289e8f34f38f06d9333614c,0,Benson Margulies,2011-04-29 12:02:05+00:00,['0e3f35da37442d6dd451d355290aafb651805995'],44,26,70,1046426,9,,,,2115
3cf3f3056efc271af60e83107212115eeae52f68,0,Benson Margulies,2011-04-29 12:02:14+00:00,['fcd0f0ed5659e4946289e8f34f38f06d9333614c'],13,13,26,1046452,9,,,,2115
f879fca57d41cb16830f8ad5a5202e38536238ad,0,Benson Margulies,2011-04-29 12:34:57+00:00,['3cf3f3056efc271af60e83107212115eeae52f68'],13,31,44,1046496,9,,,,2115
1d21076b4a67367f912de6762b4b4723b76cc4c4,0,Benson Margulies,2011-04-29 12:37:13+00:00,['f879fca57d41cb16830f8ad5a5202e38536238ad'],2,2,4,1046500,1,,,,2115
d78e18637e66d1e5d25a036653a2ecaa92363fb5,1,Benson Margulies,2011-04-29 12:53:30+00:00,['1d21076b4a67367f912de6762b4b4723b76cc4c4'],44,26,70,1046570,9,,,,2115
dafeaaa6406c0f2b1ac6d5ca61ebc20ae114fcc1,0,Benson Margulies,2011-04-29 12:53:38+00:00,['d78e18637e66d1e5d25a036653a2ecaa92363fb5'],13,13,26,1046596,9,,,,2115
a6f66312ac183a70a84c8867dc6c967d215cdfaa,1,Jacob Alexander Mannix,2011-04-30 04:35:18+00:00,['dafeaaa6406c0f2b1ac6d5ca61ebc20ae114fcc1'],14,63,77,1046673,5,0,1,0.965517241,2115
5d14fc9bbf18cf7ef645f4a397aef18410f02c70,0,Jacob Alexander Mannix,2011-04-30 05:23:58+00:00,['a6f66312ac183a70a84c8867dc6c967d215cdfaa'],7,6,13,1046686,2,1,1,0.5,2115
39fe22402990d06f23a39cec18e74887ea5eb262,1,Sean R. Owen,2011-05-02 18:14:18+00:00,['5d14fc9bbf18cf7ef645f4a397aef18410f02c70'],2594,1023,3617,1050303,231,0.453333333,0.006666667,0,2131
9ae4c2622ef2554bcce37353e48e511c16bf5df9,0,Sean R. Owen,2011-05-02 19:14:09+00:00,['39fe22402990d06f23a39cec18e74887ea5eb262'],2,6,8,1050311,2,1,1,1,2131
8f2373a4af29e51bba97def52f29ba56fce3f06b,0,Sean R. Owen,2011-05-02 21:33:26+00:00,['9ae4c2622ef2554bcce37353e48e511c16bf5df9'],4,3,7,1050318,1,,,,2131
8aecd6c6692856f92dc83119b2d2a0ebba36a0f6,0,Sean R. Owen,2011-05-04 21:13:14+00:00,['8f2373a4af29e51bba97def52f29ba56fce3f06b'],1,1,2,1050320,1,,,,2131
a4778a48c6f21ab6a65189c737530c5e41ec75c8,1,Grant Ingersoll,2011-05-05 17:55:22+00:00,['8aecd6c6692856f92dc83119b2d2a0ebba36a0f6'],161,161,322,1050642,16,0,0,0,2132
bb62dab20ac28605492d778e1642e6e4bc50f6ab,0,Grant Ingersoll,2011-05-05 19:42:27+00:00,['a4778a48c6f21ab6a65189c737530c5e41ec75c8'],1,1,2,1050644,1,,,,2132
522ee0b5dbf30156745e9d66abb70149c4ec4cfb,1,Jacob Alexander Mannix,2011-05-06 04:19:53+00:00,['bb62dab20ac28605492d778e1642e6e4bc50f6ab'],239,814,1053,1051697,14,0.577922078,0.614718615,0.863636364,2134
f3609730fc992b310afe36f0fd08e4183bd53188,1,Jacob Alexander Mannix,2011-05-07 00:18:51+00:00,['522ee0b5dbf30156745e9d66abb70149c4ec4cfb'],97,389,486,1052183,8,0.14479638,0.538461538,0.266968326,2135
4dd8881bff84519df3b90d8da3d4d53dea1f4b9b,1,Jeff Eastman,2011-05-09 01:49:20+00:00,['f3609730fc992b310afe36f0fd08e4183bd53188'],110,307,417,1052600,6,0.668965517,1,0,2135
a6bdcbba056612ad4057e68c405527992e8a958b,1,Sean R. Owen,2011-05-10 11:30:14+00:00,['4dd8881bff84519df3b90d8da3d4d53dea1f4b9b'],169,166,335,1052935,10,1,0,0,2135
ec7c14065938798598bbb514fc5228156d8ae533,0,Sean R. Owen,2011-05-15 16:27:08+00:00,['a6bdcbba056612ad4057e68c405527992e8a958b'],24,7,31,1052966,2,,,,2135
77fa3161a89df6a2bb8688b1c4a5f1b97a474adf,0,Sean R. Owen,2011-05-17 11:09:06+00:00,['ec7c14065938798598bbb514fc5228156d8ae533'],2,4,6,1052972,1,1,1,1,2135
b50c396cbafc60bdaf98de9d2f3d409d4e75d376,0,Benson Margulies,2011-05-17 16:42:54+00:00,['77fa3161a89df6a2bb8688b1c4a5f1b97a474adf'],6,11,17,1052989,1,,,,2135
804b46e093f9c0104a00f16f9a5305c8d7732125,1,Sean R. Owen,2011-05-17 22:01:41+00:00,['b50c396cbafc60bdaf98de9d2f3d409d4e75d376'],53,55,108,1053097,1,,,,2135
a14fd1c1e44f7e330809887a1e2f6e1b69f1137b,0,Sean R. Owen,2011-05-17 22:49:16+00:00,['804b46e093f9c0104a00f16f9a5305c8d7732125'],13,13,26,1053123,9,,,,2135
99b0f5429c482ba1af411d1a6c0e24567346143c,0,Sean R. Owen,2011-05-17 23:06:52+00:00,['a14fd1c1e44f7e330809887a1e2f6e1b69f1137b'],13,13,26,1053149,9,,,,2135
4cb42512b71cc1d410c0b438d4b0ca80864daa5e,0,Sean R. Owen,2011-05-18 10:40:43+00:00,['99b0f5429c482ba1af411d1a6c0e24567346143c'],10,10,20,1053169,9,,,,2135
7ecf707b3e27fd665d74419957dade54755b57b4,0,Sean R. Owen,2011-05-18 11:14:57+00:00,['4cb42512b71cc1d410c0b438d4b0ca80864daa5e'],13,13,26,1053195,9,,,,2135
cbb1ad8c8a205ee543c6874aeaf7773d33f41fd2,0,Sean R. Owen,2011-05-18 11:16:28+00:00,['7ecf707b3e27fd665d74419957dade54755b57b4'],13,13,26,1053221,9,,,,2135
1bbc6a96210a8edbcc396268cd5d924dffdcb109,0,Sean R. Owen,2011-05-18 11:51:51+00:00,['cbb1ad8c8a205ee543c6874aeaf7773d33f41fd2'],13,13,26,1053247,9,,,,2135
1deba16f7d1309e0981b3400ad96f46d77e08dbe,0,Sean R. Owen,2011-05-18 11:52:18+00:00,['1bbc6a96210a8edbcc396268cd5d924dffdcb109'],13,13,26,1053273,9,,,,2135
737249b0db7fafd150ac56ddc2bc1b465b12abb7,0,Grant Ingersoll,2011-05-20 20:08:51+00:00,['1deba16f7d1309e0981b3400ad96f46d77e08dbe'],1,2,3,1053276,1,,,,2135
4510a3ce147f6947231ac19f384fe554a8a8f52b,0,Grant Ingersoll,2011-05-20 20:34:14+00:00,['737249b0db7fafd150ac56ddc2bc1b465b12abb7'],0,0,0,1053276,0,,,,2135
fa42f721cdc0b0a5115ab38256378729b5760317,0,Grant Ingersoll,2011-05-20 20:35:04+00:00,['4510a3ce147f6947231ac19f384fe554a8a8f52b'],0,0,0,1053276,0,,,,2135
cef6f88628be1d93ac1cc307464d8329204710c9,0,Grant Ingersoll,2011-05-20 20:35:57+00:00,['fa42f721cdc0b0a5115ab38256378729b5760317'],0,0,0,1053276,0,,,,2135
fb171d41f9e36856285a0e8bde7c683a2c899a4f,0,Grant Ingersoll,2011-05-21 10:47:19+00:00,['cef6f88628be1d93ac1cc307464d8329204710c9'],8,14,22,1053298,1,0,1,1,2135
fc0ecc2dfc137f0aa6c000064144ff98f447db25,1,Andrew L. Farris,2011-05-23 12:27:00+00:00,['fb171d41f9e36856285a0e8bde7c683a2c899a4f'],41,72,113,1053411,1,,,,2135
691ed8e5eda676ec39dcb3ba12a956f50245ba65,0,Sean R. Owen,2011-05-23 17:20:38+00:00,['fc0ecc2dfc137f0aa6c000064144ff98f447db25'],10,10,20,1053431,9,,,,2135
b1f46d50240b2601e401939404bdbc7197572006,0,Sean R. Owen,2011-05-23 17:41:14+00:00,['691ed8e5eda676ec39dcb3ba12a956f50245ba65'],13,13,26,1053457,9,,,,2135
175b269dc6bd5243f3d6529132fbcc24af584da0,0,Sean R. Owen,2011-05-23 17:41:31+00:00,['b1f46d50240b2601e401939404bdbc7197572006'],13,13,26,1053483,9,,,,2135
c02e98f2eeff25bce854133dbbe9de8579bbc634,0,Jeff Eastman,2011-05-25 21:32:52+00:00,['175b269dc6bd5243f3d6529132fbcc24af584da0'],5,5,10,1053493,5,,,,2135
55439df8c2b595c9cbe3f452d330dcd77e982ea4,1,Sean R. Owen,2011-05-28 08:58:58+00:00,['c02e98f2eeff25bce854133dbbe9de8579bbc634'],162,133,295,1053788,7,,,,2135
a500c977d047d0955bf5dd830f558241c918e3c2,0,Sean R. Owen,2011-05-28 09:03:44+00:00,['55439df8c2b595c9cbe3f452d330dcd77e982ea4'],10,10,20,1053808,9,,,,2135
93b66b11b89965957970fce64e2d6cb12dbbc966,0,Sean R. Owen,2011-05-28 09:25:40+00:00,['a500c977d047d0955bf5dd830f558241c918e3c2'],13,13,26,1053834,9,,,,2135
bebbd10e4276bd01256b75bbac262d5305264b2a,0,Sean R. Owen,2011-05-28 10:14:19+00:00,['93b66b11b89965957970fce64e2d6cb12dbbc966'],13,13,26,1053860,9,,,,2135
1292145799e70890d4898353e4f5279d0484c5b7,0,Sean R. Owen,2011-05-28 11:45:06+00:00,['bebbd10e4276bd01256b75bbac262d5305264b2a'],13,13,26,1053886,9,,,,2135
5d64fbce6cd194a90e26ca35f90f61c88e75135b,0,Sean R. Owen,2011-05-28 11:45:21+00:00,['1292145799e70890d4898353e4f5279d0484c5b7'],13,13,26,1053912,9,,,,2135
ac28cf4841459c785e4beee061cc350ce97c9838,1,Sean R. Owen,2011-06-01 16:35:44+00:00,['5d64fbce6cd194a90e26ca35f90f61c88e75135b'],2,3,5,1053917,2,0,0,0,2135
a26d3b136f0c8b24904f062bfbc1d2b14448eac1,0,Sean R. Owen,2011-06-01 16:36:31+00:00,['ac28cf4841459c785e4beee061cc350ce97c9838'],14,14,28,1053945,5,0,1,0,2135
e37620bc847b7942384016749d43077c6a250caa,1,Sean R. Owen,2011-06-01 16:38:32+00:00,['a26d3b136f0c8b24904f062bfbc1d2b14448eac1'],0,50,50,1053995,1,,,,2136
96d93d4325208fa4fe253d294e52e983dd798beb,0,Sean R. Owen,2011-06-01 16:38:45+00:00,['e37620bc847b7942384016749d43077c6a250caa'],14,16,30,1054025,5,,,,2136
efa6a1770ec807050c269c580bb08a6a7a5b481d,0,Sean R. Owen,2011-06-01 23:04:43+00:00,['96d93d4325208fa4fe253d294e52e983dd798beb'],44,11,55,1054080,3,,,,2136
740db0320ad8fc1af0f3a79953aa74f175bd6fd7,0,Sean R. Owen,2011-06-02 08:09:14+00:00,['efa6a1770ec807050c269c580bb08a6a7a5b481d'],12,1,13,1054093,2,,,,2136
96024a77ce7b2d271e4c84e185912189ec53bd4e,1,Sebastian Schelter,2011-06-02 09:07:49+00:00,['740db0320ad8fc1af0f3a79953aa74f175bd6fd7'],254,529,783,1054876,42,1,1,1,2141
fad58fee36a45d473c6f919c9476f9f17e9c471c,1,Sean R. Owen,2011-06-02 13:11:46+00:00,['96024a77ce7b2d271e4c84e185912189ec53bd4e'],87,161,248,1055124,2,0.853658537,1,1,2141
6d38de26f5ac36fb07c2c3640d722f03620e23c5,0,Sean R. Owen,2011-06-02 13:34:33+00:00,['fad58fee36a45d473c6f919c9476f9f17e9c471c'],214,0,214,1055338,1,0.898989899,0,0.070707071,2141
0793ce4513a5f3f8b64da9d4d3ed6355edec46d5,0,Sean R. Owen,2011-06-02 16:33:06+00:00,['6d38de26f5ac36fb07c2c3640d722f03620e23c5'],74,57,131,1055469,3,,,,2141
304d6b3456cb983c441624f430186f47e1da5062,0,Sean R. Owen,2011-06-02 17:05:37+00:00,['0793ce4513a5f3f8b64da9d4d3ed6355edec46d5'],15,3,18,1055487,2,,,,2141
50fd693770212294b1c14eb9ec10324c7d99a303,1,Sean R. Owen,2011-06-04 07:16:33+00:00,['304d6b3456cb983c441624f430186f47e1da5062'],208,41,249,1055736,97,,,,2141
466f8fe8672a32afd5174d29fef56e3c66f22dc1,1,Sean R. Owen,2011-06-04 07:19:30+00:00,['50fd693770212294b1c14eb9ec10324c7d99a303'],0,6,6,1055742,1,1,1,1,2141
e2620d31bab2ef08518d0fa0963de6ee87f6506e,1,Sean R. Owen,2011-06-04 08:16:21+00:00,['466f8fe8672a32afd5174d29fef56e3c66f22dc1'],0,874,874,1056616,3,0.235421166,0.580993521,0.667386609,2142
c3fe242df3a9bd14a12014671cac30aad7c39dfe,0,Sean R. Owen,2011-06-04 08:22:33+00:00,['e2620d31bab2ef08518d0fa0963de6ee87f6506e'],1,30,31,1056647,6,1,1,1,2142
5c9f8fb6e5c8330540c0c424d7fe122daa608c79,0,Sean R. Owen,2011-06-04 08:28:20+00:00,['c3fe242df3a9bd14a12014671cac30aad7c39dfe'],3,0,3,1056650,1,0,0,0,2142
d608a88d95b4a7bfd5f32a24f0c0a5d5cf6f25cf,1,Sebastian Schelter,2011-06-04 08:42:57+00:00,['5c9f8fb6e5c8330540c0c424d7fe122daa608c79'],827,1136,1963,1058613,111,0.051948052,0.701298701,0.627705628,2142
e7b1934536bb9dc014a744406a7122e088f2a435,0,Sean R. Owen,2011-06-04 10:48:52+00:00,['d608a88d95b4a7bfd5f32a24f0c0a5d5cf6f25cf'],4,21,25,1058638,2,0,1,1,2142
f5e773225fffa34ee6f1040c283fd81ef54b557e,1,Sean R. Owen,2011-06-04 11:04:48+00:00,['e7b1934536bb9dc014a744406a7122e088f2a435'],20,26,46,1058684,5,0.5,1,0,2142
623be86e5837ae0f5f9f84d9409eda4550c2308d,0,Sean R. Owen,2011-06-04 11:14:14+00:00,['f5e773225fffa34ee6f1040c283fd81ef54b557e'],0,218,218,1058902,2,1,0.86746988,0.879518072,2144
4ef41c7748e23e3dfc3c90d52092b92dcb088653,1,Sean R. Owen,2011-06-04 15:47:07+00:00,['623be86e5837ae0f5f9f84d9409eda4550c2308d'],18,22,40,1058942,10,,,,2144
96117d39eed51f10ee1300917f80abc32908d373,1,Sean R. Owen,2011-06-04 16:03:49+00:00,['4ef41c7748e23e3dfc3c90d52092b92dcb088653'],181,167,348,1059290,53,0,0,0,2144
4f85c156b15fa44ed1e7d3b62e0b5e0ac25058a2,1,Sean R. Owen,2011-06-04 16:14:43+00:00,['96117d39eed51f10ee1300917f80abc32908d373'],1,1,2,1059292,1,,,,2144
9d93d27e94fe0a4753a35d27c9acd1429c1f45f8,0,Sean R. Owen,2011-06-04 16:31:50+00:00,['4f85c156b15fa44ed1e7d3b62e0b5e0ac25058a2'],0,2,2,1059294,1,0,0,0,2144
d3ccbe045f29d260ad27bf364047b59b939b1805,1,Sean R. Owen,2011-06-04 17:43:31+00:00,['9d93d27e94fe0a4753a35d27c9acd1429c1f45f8'],40,48,88,1059382,8,0.833333333,1,0.666666667,2144
1f672cb7befb8f6bf553fde8c87c7e6238c2ddd7,0,Sean R. Owen,2011-06-04 19:37:27+00:00,['d3ccbe045f29d260ad27bf364047b59b939b1805'],131,403,534,1059916,4,0.752293578,1,0.71559633,2147
b4c54009ee19014149b18941b4341297ccdab562,1,Sean R. Owen,2011-06-04 19:47:37+00:00,['1f672cb7befb8f6bf553fde8c87c7e6238c2ddd7'],0,461,461,1060377,3,0.408730159,0.793650794,0.674603175,2149
0de31cb5d92f79abdf1f82b4b0a0847b5f8e757f,1,Jeff Eastman,2011-06-04 23:40:28+00:00,['b4c54009ee19014149b18941b4341297ccdab562'],906,1368,2274,1062651,14,0,0.788104089,1,2152
e4e7947ccb3b5260732ce044b7d0334b7547bef3,0,Sean R. Owen,2011-06-05 09:25:21+00:00,['0de31cb5d92f79abdf1f82b4b0a0847b5f8e757f'],10,43,53,1062704,2,,,,2152
793a170399de40ec7da6bffa15e8aeb9368fbead,0,Sean R. Owen,2011-06-05 16:03:53+00:00,['e4e7947ccb3b5260732ce044b7d0334b7547bef3'],2,5,7,1062711,1,0,1,1,2152
4ac06616432df2d08ba924d278c6c739dc3437c2,0,Sean R. Owen,2011-06-05 16:04:16+00:00,['793a170399de40ec7da6bffa15e8aeb9368fbead'],58,41,99,1062810,1,0,0,0,2152
194986dc255b7486444a15867be9c736945b0dd8,0,Sean R. Owen,2011-06-05 16:40:07+00:00,['4ac06616432df2d08ba924d278c6c739dc3437c2'],80,0,80,1062890,1,0,0,0.321428571,2152
055f4abec06d90e7fcc1c707768480a6902db877,0,Sean R. Owen,2011-06-05 18:59:38+00:00,['194986dc255b7486444a15867be9c736945b0dd8'],62,41,103,1062993,23,,,,2152
3f3cc8a2fff90017c16a26209556238b73cfeb0b,1,Sean R. Owen,2011-06-06 10:00:29+00:00,['055f4abec06d90e7fcc1c707768480a6902db877'],230,119,349,1063342,18,1,0,0,2152
5681bb0f11e29897635456c43603605169010ecf,0,Sean R. Owen,2011-06-06 10:15:29+00:00,['3f3cc8a2fff90017c16a26209556238b73cfeb0b'],609,71,680,1064022,18,,,,2152
6634dc9a3f6e9962457d4aa7843689d7ab218bc7,0,Sean R. Owen,2011-06-07 07:41:10+00:00,['5681bb0f11e29897635456c43603605169010ecf'],25,25,50,1064072,2,,,,2152
74f849b10c4d76281f31741a9cef48ceddcde123,1,Sebastian Schelter,2011-06-10 21:58:14+00:00,['6634dc9a3f6e9962457d4aa7843689d7ab218bc7'],1047,914,1961,1066033,268,1,0.752941176,0.776470588,2153
346c98c319c0fd978f8a0959d85452848e0e0bda,0,Sebastian Schelter,2011-06-10 22:16:26+00:00,['74f849b10c4d76281f31741a9cef48ceddcde123'],27,46,73,1066106,22,1,1,0,2154
fd730ff6025009ed25a50dc74f7bae2283ce5fd0,0,Sebastian Schelter,2011-06-10 22:56:55+00:00,['346c98c319c0fd978f8a0959d85452848e0e0bda'],3,3,6,1066112,1,,,,2154
38616e010567870d39b9fd5ef7211ef348fdb29b,0,Sebastian Schelter,2011-06-13 10:00:49+00:00,['fd730ff6025009ed25a50dc74f7bae2283ce5fd0'],10,20,30,1066142,5,0.75,1,0.75,2154
d497b6871e219622bff3a6d5b503b6d203e1861d,0,Sebastian Schelter,2011-06-14 06:53:12+00:00,['38616e010567870d39b9fd5ef7211ef348fdb29b'],1,4,5,1066147,1,1,1,1,2154
95743219fd99d1bed8241b9206293af6fa8fe7b2,0,Sean R. Owen,2011-06-15 20:42:47+00:00,['d497b6871e219622bff3a6d5b503b6d203e1861d'],1,2,3,1066150,1,0,0,0,2154
507af7a6975bb795b7e3d60f67a7e75e4e247352,0,Sean R. Owen,2011-06-16 09:47:02+00:00,['95743219fd99d1bed8241b9206293af6fa8fe7b2'],146,498,644,1066794,4,0.353982301,1,0.221238938,2156
70fb5a121258d375005b5c3c3d96786c363f708a,0,Sean R. Owen,2011-06-19 14:50:28+00:00,['507af7a6975bb795b7e3d60f67a7e75e4e247352'],6,8,14,1066808,2,0,0,1,2156
b51662be15e5fbce55e4c323c54fc064c0a65a50,1,Sean R. Owen,2011-06-19 15:19:53+00:00,['70fb5a121258d375005b5c3c3d96786c363f708a'],2,5,7,1066815,1,,,,2156
a8df4a23aa6eaefea26d72a822b4710da991ea94,0,Sebastian Schelter,2011-06-19 21:19:24+00:00,['b51662be15e5fbce55e4c323c54fc064c0a65a50'],11,1534,1545,1068360,19,0.750724638,0.962318841,0.847826087,2173
a8fb97ebd61ff4a67fa32e063e0779bdc2d46396,1,Sebastian Schelter,2011-06-19 21:54:08+00:00,['a8df4a23aa6eaefea26d72a822b4710da991ea94'],360,26,386,1068746,11,0.13740458,0.229007634,0.198473282,2173
fe9baebb217b04ca5764d5dc0eb927240c25f8e8,0,Sebastian Schelter,2011-06-19 22:07:55+00:00,['a8fb97ebd61ff4a67fa32e063e0779bdc2d46396'],0,0,0,1068746,4,,,,2173
b79bc621ce888770c67e6e1facb8880976e2c5ec,0,Sebastian Schelter,2011-06-19 22:09:03+00:00,['fe9baebb217b04ca5764d5dc0eb927240c25f8e8'],1,0,1,1068747,1,,,,2173
b4f8b6b0a85ce825ba29a83539dbfc1f5b761d43,0,Sebastian Schelter,2011-06-22 07:58:47+00:00,['b79bc621ce888770c67e6e1facb8880976e2c5ec'],0,231,231,1068978,3,0.227848101,1,0.810126582,2176
f9af45c30cbdac92f95e62b06d53334beef1b4e2,1,Sean R. Owen,2011-06-22 17:05:51+00:00,['b4f8b6b0a85ce825ba29a83539dbfc1f5b761d43'],62,57,119,1069097,16,0.4,0.4,0.4,2176
ce3ca5ec278fc55b79491e3e3805957707e16b5d,1,Sean R. Owen,2011-06-22 22:29:35+00:00,['f9af45c30cbdac92f95e62b06d53334beef1b4e2'],118,134,252,1069349,6,0.263157895,0.947368421,0.526315789,2176
a2c5df682f143a82fb726c1a556cfca35f0b1b47,0,Sebastian Schelter,2011-06-23 12:26:46+00:00,['ce3ca5ec278fc55b79491e3e3805957707e16b5d'],2,351,353,1069702,4,0.380116959,1,0.754385965,2178
9101588c917614dc5ff9c589a7bb935042236d0b,1,Sean R. Owen,2011-06-23 21:05:11+00:00,['a2c5df682f143a82fb726c1a556cfca35f0b1b47'],23,49,72,1069774,13,0,1,1,2178
d4d72203893ecada27dce2594b290f00462ca3cf,0,Sebastian Schelter,2011-06-24 12:39:52+00:00,['9101588c917614dc5ff9c589a7bb935042236d0b'],42,6,48,1069822,2,0,0,1,2178
cb143232cecdeb309609edca7d073da8855bf0c2,0,Sean R. Owen,2011-06-26 08:09:25+00:00,['d4d72203893ecada27dce2594b290f00462ca3cf'],33,120,153,1069975,4,1,1,0.730769231,2180
b185cd5b34e9bddf5f7deac7c6af2032a1b37eb4,1,Sean R. Owen,2011-06-27 10:54:47+00:00,['cb143232cecdeb309609edca7d073da8855bf0c2'],10,28,38,1070013,2,1,1,1,2180
3d44c1ee288700b0a5ffd8aaf2f734cf4315de99,1,Sean R. Owen,2011-06-27 12:42:21+00:00,['b185cd5b34e9bddf5f7deac7c6af2032a1b37eb4'],432,202,634,1070647,49,0.398058252,0.038834951,0.417475728,2180
a8689591e32c8c27d74f3b0caad34e42eea1af70,1,Sean R. Owen,2011-06-27 16:09:10+00:00,['3d44c1ee288700b0a5ffd8aaf2f734cf4315de99'],43,37,80,1070727,3,1,0,0,2180
d0dbdfb7bb33326e6157cc69c0292a40dee1d10a,1,Sean R. Owen,2011-06-27 18:46:46+00:00,['a8689591e32c8c27d74f3b0caad34e42eea1af70'],19,480,499,1071226,7,0.116071429,0.321428571,1,2184
5626e10584e3c29614aea84985f2d07daf9ce899,0,Sean R. Owen,2011-06-27 20:27:43+00:00,['d0dbdfb7bb33326e6157cc69c0292a40dee1d10a'],10,27,37,1071263,1,0,0,1,2184
c3dfffa3f5b9d7cc060289aeaf4e980d5e1d6e42,1,Sean R. Owen,2011-06-28 07:14:02+00:00,['5626e10584e3c29614aea84985f2d07daf9ce899'],1,1,2,1071265,1,,,,2184
e4cf2c733d38e11277c933701e7cb496e419cb14,0,Sean R. Owen,2011-06-30 13:54:29+00:00,['c3dfffa3f5b9d7cc060289aeaf4e980d5e1d6e42'],0,5,5,1071270,1,1,1,1,2184
e3fb0c4f3162fda964b6ad8658fb09702bc279d2,1,Sebastian Schelter,2011-07-04 06:49:17+00:00,['e4cf2c733d38e11277c933701e7cb496e419cb14'],797,1033,1830,1073100,27,1,1,1,2195
a5ec598b63138a5243e4a5895b53614d12de3400,0,Sebastian Schelter,2011-07-04 06:52:27+00:00,['e3fb0c4f3162fda964b6ad8658fb09702bc279d2'],0,0,0,1073100,1,,,,2195
91ff58708329ef6112e218458a7a36746fa91cdf,0,Sebastian Schelter,2011-07-04 08:21:55+00:00,['a5ec598b63138a5243e4a5895b53614d12de3400'],1,1,2,1073102,1,,,,2195
e43db6158f5cb97b2c67081144cece74153ab79f,0,Sebastian Schelter,2011-07-04 13:59:13+00:00,['91ff58708329ef6112e218458a7a36746fa91cdf'],51,43,94,1073196,6,1,0,0,2195
e4dfc93f53c1fa923803e0dac96274f0351bcd6d,1,Sean R. Owen,2011-07-04 22:01:20+00:00,['e43db6158f5cb97b2c67081144cece74153ab79f'],68,80,148,1073344,14,0.954545455,1,1,2195
82fb4016fa0c002a8753dc6f72b010da7122939d,1,Sean R. Owen,2011-07-05 07:18:31+00:00,['e4dfc93f53c1fa923803e0dac96274f0351bcd6d'],16,17,33,1073377,6,,,,2195
b04eb0ed363ea438b498325bf0799f3fcc21dcd7,0,Sean R. Owen,2011-07-05 07:58:32+00:00,['82fb4016fa0c002a8753dc6f72b010da7122939d'],12,12,24,1073401,3,,,,2195
b722041e31c83db3935256bec94ed4c8120e7f1a,1,Sean R. Owen,2011-07-05 13:54:39+00:00,['b04eb0ed363ea438b498325bf0799f3fcc21dcd7'],0,1179,1179,1074580,18,0.692537313,1,0.719402985,2213
183fa8faea7b4011ab93025a2696aa1a380f1bf5,0,Sean R. Owen,2011-07-06 19:03:45+00:00,['b722041e31c83db3935256bec94ed4c8120e7f1a'],2,2,4,1074584,1,,,,2213
a515335bbe063f612c9c09b1e0360cc5848ad396,1,Sean R. Owen,2011-07-06 20:17:58+00:00,['183fa8faea7b4011ab93025a2696aa1a380f1bf5'],74,1190,1264,1075848,11,0.261410788,0.699861687,0.964038728,2217
23722bcc7103b2253c1216aed934fa78271d3c64,0,Sean R. Owen,2011-07-08 07:40:25+00:00,['a515335bbe063f612c9c09b1e0360cc5848ad396'],40,44,84,1075932,14,0.2,0.4,1,2217
69e3a649a0580f0c02536fdb9a6a79a82821475f,1,Sebastian Schelter,2011-07-11 15:48:16+00:00,['23722bcc7103b2253c1216aed934fa78271d3c64'],2,618,620,1076552,7,0.544444444,1,0.796296296,2222
856f9dfc4804fde5aaccd125e82cd3bb596a3380,0,Sean R. Owen,2011-07-12 22:15:36+00:00,['69e3a649a0580f0c02536fdb9a6a79a82821475f'],310,0,310,1076862,2,0.413580247,0,0.018518519,2222
ccafd1a85c81a7fda05582f7149fda5d67c653ba,0,Sean R. Owen,2011-07-14 16:25:10+00:00,['856f9dfc4804fde5aaccd125e82cd3bb596a3380'],1,1,2,1076864,1,,,,2222
7c72dc4fe3d80a30d6daa9dc8b20973a176580b4,0,Grant Ingersoll,2011-07-14 18:18:49+00:00,['ccafd1a85c81a7fda05582f7149fda5d67c653ba'],28,53,81,1076945,5,0,0.153846154,0.846153846,2222
f580dbfeaab498faad78ac0314089d511caf9b28,0,Grant Ingersoll,2011-07-14 20:16:25+00:00,['7c72dc4fe3d80a30d6daa9dc8b20973a176580b4'],0,97,97,1077042,1,1,1,0.916666667,2223
63ccd5ab86f1b53b0ac780c678c7567a1471d95e,0,Grant Ingersoll,2011-07-15 11:30:14+00:00,['f580dbfeaab498faad78ac0314089d511caf9b28'],27,35,62,1077104,1,0,0,1,2223
d10f7096b9decc15cad55f4d7fd46b4feb7bb88c,0,Grant Ingersoll,2011-07-15 11:33:29+00:00,['63ccd5ab86f1b53b0ac780c678c7567a1471d95e'],0,1,1,1077105,1,,,,2223
136942055bacc2a3d1db40f8654ec96391937080,1,Grant Ingersoll,2011-07-15 13:05:06+00:00,['d10f7096b9decc15cad55f4d7fd46b4feb7bb88c'],5,26,31,1077136,2,0.277777778,0.277777778,1,2223
efa490c12b86034a26c9534dd6c9459550da2e5e,1,Grant Ingersoll,2011-07-15 17:31:25+00:00,['136942055bacc2a3d1db40f8654ec96391937080'],0,388,388,1077524,3,0.157635468,0.640394089,0.802955665,2226
e55ec3c0157b794e9d9058b974db50b19c8843e0,1,Grant Ingersoll,2011-07-15 21:07:48+00:00,['efa490c12b86034a26c9534dd6c9459550da2e5e'],89,328,417,1077941,5,0.017699115,0.849557522,0.778761062,2228
d54c89bbfba59792741d052b7ea94cd2e93ae1d8,1,Sean R. Owen,2011-07-16 14:19:51+00:00,['e55ec3c0157b794e9d9058b974db50b19c8843e0'],36,55,91,1078032,4,0.555555556,0.555555556,0.111111111,2228
68f00b01edd76acb20a8bb0fbb1e43070c1bfab4,0,Sean R. Owen,2011-07-17 11:52:21+00:00,['d54c89bbfba59792741d052b7ea94cd2e93ae1d8'],79,112,191,1078223,11,1,1,1,2228
b59e46855e589f31a5a6e831a90beeed34e03c89,1,Sean R. Owen,2011-07-17 15:06:01+00:00,['68f00b01edd76acb20a8bb0fbb1e43070c1bfab4'],243,182,425,1078648,25,0,1,0,2228
42fab8a4b13e8bbc3c675741d846eebd44900149,1,Sean R. Owen,2011-07-21 11:07:10+00:00,['b59e46855e589f31a5a6e831a90beeed34e03c89'],4,7,11,1078659,1,0,1,1,2228
032d3ac2a35c77b5eb29e76a3cbbde6d85cc1707,1,Jeff Eastman,2011-07-21 21:13:02+00:00,['42fab8a4b13e8bbc3c675741d846eebd44900149'],199,328,527,1079186,7,0.010526316,0.936842105,0.968421053,2228
7da117daf6873ce275cf9b6bba58e45ecc33733b,1,Sean R. Owen,2011-07-23 14:51:51+00:00,['032d3ac2a35c77b5eb29e76a3cbbde6d85cc1707'],3,12,15,1079201,1,0,1,1,2228
3e720bc9cbafc163018f92695c374ca004cc13f7,1,Sean R. Owen,2011-07-23 15:28:40+00:00,['7da117daf6873ce275cf9b6bba58e45ecc33733b'],10,2,12,1079213,1,,,,2228
ce3ac7947f5425437f449ee57205c124391cbded,0,Sean R. Owen,2011-07-25 13:40:21+00:00,['3e720bc9cbafc163018f92695c374ca004cc13f7'],0,480,480,1079693,3,0.639004149,1,0.825726141,2229
3894b57af0239b00c82284d9d268acefa81c0461,0,Sean R. Owen,2011-07-25 13:41:00+00:00,['ce3ac7947f5425437f449ee57205c124391cbded'],5,1,6,1079699,2,1,1,0,2229
62fdbb9e6323c4688fdbcc240a26beaa7c7d9736,0,Sean R. Owen,2011-07-25 20:08:59+00:00,['3894b57af0239b00c82284d9d268acefa81c0461'],1,1,2,1079701,1,,,,2229
a36831c085d42aedc28553106fa52082fe0adf32,0,Sean R. Owen,2011-07-26 13:45:56+00:00,['62fdbb9e6323c4688fdbcc240a26beaa7c7d9736'],2,2,4,1079705,1,,,,2229
7cd73f5662f19c4b2f007d6c6ebe51d51d97158b,0,Sean R. Owen,2011-08-03 13:15:29+00:00,['a36831c085d42aedc28553106fa52082fe0adf32'],2,4,6,1079711,1,,,,2229
ac6bab2209fd5cd203a29dd8be19c1097305e841,0,Sean R. Owen,2011-08-06 07:31:50+00:00,['7cd73f5662f19c4b2f007d6c6ebe51d51d97158b'],3,12,15,1079726,1,0,1,1,2229
bbe149d4a79b85222f4a88cabb487dd99e0affb2,0,Grant Ingersoll,2011-08-09 13:10:01+00:00,['ac6bab2209fd5cd203a29dd8be19c1097305e841'],0,1257,1257,1080983,14,,,,2243
3088f5893b228dbbcccf0a8bfad7f2d06c6153c6,0,Sean R. Owen,2011-08-16 12:24:26+00:00,['bbe149d4a79b85222f4a88cabb487dd99e0affb2'],0,3,3,1080986,1,0,0,0,2243
df391cadef65a655268873822bb32fdb8be93951,0,Sean R. Owen,2011-08-16 12:27:40+00:00,['3088f5893b228dbbcccf0a8bfad7f2d06c6153c6'],0,5,5,1080991,1,1,1,1,2243
e10506d9cba0e4676a901836f0931ee0c7846c8e,0,Sean R. Owen,2011-08-17 09:30:09+00:00,['df391cadef65a655268873822bb32fdb8be93951'],6,4,10,1081001,1,0,1,0,2243
ec1110272a81664a92cdd3d7916551a2565e3b43,0,Sean R. Owen,2011-08-17 09:31:51+00:00,['e10506d9cba0e4676a901836f0931ee0c7846c8e'],0,3,3,1081004,1,0,0,1,2243
5f76b2ae7567970adac579e34168cb18561aa847,0,Sean R. Owen,2011-08-17 11:03:27+00:00,['ec1110272a81664a92cdd3d7916551a2565e3b43'],4,4,8,1081012,1,,,,2243
48612cb8a4081a4c70e78fb84a255a59041f021e,0,Sean R. Owen,2011-08-17 15:08:36+00:00,['5f76b2ae7567970adac579e34168cb18561aa847'],2,18,20,1081032,2,0,0,1,2243
cc8070905f4a9556fdd54cb7e9cf9ecc2c898d95,0,Sean R. Owen,2011-08-21 21:44:14+00:00,['48612cb8a4081a4c70e78fb84a255a59041f021e'],4,13,17,1081049,1,1,1,0,2243
3a16b20f8ea42778d4203e789329c178f51432a6,1,Ted Dunning,2011-08-22 03:28:15+00:00,['cc8070905f4a9556fdd54cb7e9cf9ecc2c898d95'],13,17,30,1081079,5,,,,2243
318a0e8861b658726e4a4dba114a84e7a26a41c6,1,Sebastian Schelter,2011-08-23 09:13:03+00:00,['3a16b20f8ea42778d4203e789329c178f51432a6'],37,47,84,1081163,1,1,1,1,2243
c864d1f3ddce6ed42bc0b6871398462b77e9d58b,0,Grant Ingersoll,2011-08-24 12:30:25+00:00,['318a0e8861b658726e4a4dba114a84e7a26a41c6'],108,17,125,1081288,1,,,,2243
05abdd6a1e0bd90ed1c13d055ac228dfc8a59969,1,Sean R. Owen,2011-08-26 16:12:17+00:00,['c864d1f3ddce6ed42bc0b6871398462b77e9d58b'],125,211,336,1081624,7,0.670886076,1,0.924050633,2245
0b12c1c7c783aa74c37cc568686d3a126a3fb479,0,Sean R. Owen,2011-08-26 20:24:50+00:00,['05abdd6a1e0bd90ed1c13d055ac228dfc8a59969'],22,0,22,1081646,1,,,,2245
12659e1be565572466d20780a0f91c6b791cc7ea,0,Sean R. Owen,2011-08-31 21:42:35+00:00,['0b12c1c7c783aa74c37cc568686d3a126a3fb479'],4,47,51,1081697,2,0.444444444,0.444444444,0.444444444,2245
b7b518c5a85841b8019de3cd0b99804abfd6508b,1,Ted Dunning,2011-09-01 11:28:06+00:00,['12659e1be565572466d20780a0f91c6b791cc7ea'],0,10,10,1081707,2,1,1,1,2245
21779d890a7c11002493849f62760e73287b5c9e,1,Ted Dunning,2011-09-01 11:28:14+00:00,['b7b518c5a85841b8019de3cd0b99804abfd6508b'],0,863,863,1082570,6,0.760416667,1,0.90625,2251
1593176db998dc5c62017c61c4d5c8f86de24cd3,1,Ted Dunning,2011-09-01 11:28:19+00:00,['21779d890a7c11002493849f62760e73287b5c9e'],2,2,4,1082574,1,,,,2251
9bdd41d9bdc60ad1f6d48671b1a341c33f02b8a7,0,Ted Dunning,2011-09-01 11:28:24+00:00,['1593176db998dc5c62017c61c4d5c8f86de24cd3'],1,1,2,1082576,1,,,,2251
5212d25bd0b371bd2fab261d8bcf722b3eb0b50e,0,Ted Dunning,2011-09-01 11:28:29+00:00,['9bdd41d9bdc60ad1f6d48671b1a341c33f02b8a7'],15,28,43,1082619,2,,,,2251
528ffcd080419a6fd5edcaa49490bb5c2260a1aa,1,Ted Dunning,2011-09-01 11:28:59+00:00,['5212d25bd0b371bd2fab261d8bcf722b3eb0b50e'],304,193,497,1083116,50,0.101265823,0,0,2251
15a7014e889513e9c4e6470a227b97dfc90559d5,1,Ted Dunning,2011-09-01 11:29:08+00:00,['528ffcd080419a6fd5edcaa49490bb5c2260a1aa'],39,40,79,1083195,4,0,0,0,2251
95f836bfb22663dee1ee109512fb202b7932ecbd,1,Ted Dunning,2011-09-01 11:29:29+00:00,['15a7014e889513e9c4e6470a227b97dfc90559d5'],543,593,1136,1084331,33,0.195652174,0.108695652,0,2252
b35c86bf5ee4b773e7cfb5a57de449fa4a828660,1,Ted Dunning,2011-09-02 00:13:20+00:00,['95f836bfb22663dee1ee109512fb202b7932ecbd'],0,4,4,1084335,1,1,1,1,2252
33414e645ee7135176fd2dd66af19b90f0df8716,1,Ted Dunning,2011-09-02 03:05:32+00:00,['b35c86bf5ee4b773e7cfb5a57de449fa4a828660'],26,108,134,1084469,5,0.909090909,0.454545455,1,2253
ffc7fabb57ecb08220e53ceaafc6ac8b4d665860,1,Dmitriy Lyubimov,2011-09-03 06:42:25+00:00,['33414e645ee7135176fd2dd66af19b90f0df8716'],576,2524,3100,1087569,23,0.311264822,0.727272727,0.657114625,2262
80cfd1c4a99eaa250d52655daed9dd856f139e1e,0,Grant Ingersoll,2011-09-08 12:04:39+00:00,['ffc7fabb57ecb08220e53ceaafc6ac8b4d665860'],1,28,29,1087598,2,0.75,0.75,0.25,2262
020e3bede9efc69833fb01402bc97870420bf85a,1,Grant Ingersoll,2011-09-08 18:18:45+00:00,['80cfd1c4a99eaa250d52655daed9dd856f139e1e'],1,1,2,1087600,1,,,,2262
845cbcdd860ee1aa8817259b9b6a5415a5196275,1,Sebastian Schelter,2011-09-09 07:45:16+00:00,['020e3bede9efc69833fb01402bc97870420bf85a'],2526,1645,4171,1091771,59,0.274074074,0.503703704,0.211111111,2274
4e64e04a1c742f9499710e5877218b79cb5194ba,0,Sebastian Schelter,2011-09-09 07:55:32+00:00,['845cbcdd860ee1aa8817259b9b6a5415a5196275'],10,10,20,1091791,7,,,,2274
b70621d756f234598f69deb9bef1c029ad770938,0,Sebastian Schelter,2011-09-09 11:49:49+00:00,['4e64e04a1c742f9499710e5877218b79cb5194ba'],161,118,279,1092070,6,0,0,1,2274
3a38fb9d8c58bb5be7e2a9899788085812441b8e,0,Grant Ingersoll,2011-09-09 20:06:49+00:00,['b70621d756f234598f69deb9bef1c029ad770938'],1,6,7,1092077,1,0,0,0,2274
798b6a5cc23fa33ac166b8993361e674b3620124,0,Grant Ingersoll,2011-09-09 20:21:48+00:00,['3a38fb9d8c58bb5be7e2a9899788085812441b8e'],1,1,2,1092079,1,,,,2274
89720ce9c41fa68367826b482832cec7570579bc,0,Sean R. Owen,2011-09-12 14:57:45+00:00,['798b6a5cc23fa33ac166b8993361e674b3620124'],5,7,12,1092091,1,0.5,1,1,2274
7fa228fcaa75178c75c819436abd6e4c1dd55a1a,0,Sean R. Owen,2011-09-13 07:48:46+00:00,['89720ce9c41fa68367826b482832cec7570579bc'],3,0,3,1092094,1,0,0,0,2274
b58213b267ed7efaf9c148df68cf953d423a973a,1,Sean R. Owen,2011-09-13 07:53:44+00:00,['7fa228fcaa75178c75c819436abd6e4c1dd55a1a'],2,2,4,1092098,1,,,,2274
250edf36cd6bc9c3cb3e6332b42ae451a9251f48,0,Sean R. Owen,2011-09-13 09:01:13+00:00,['b58213b267ed7efaf9c148df68cf953d423a973a'],1,1,2,1092100,1,,,,2274
c3496d1b4a5a3012d546e73079a07a137788a5c6,1,Sebastian Schelter,2011-09-14 09:18:46+00:00,['250edf36cd6bc9c3cb3e6332b42ae451a9251f48'],653,1141,1794,1093894,33,0.735751295,1,0.803108808,2281
adab9e7a3f8267410330c1e9f43d6606fdcb8c07,0,Sean R. Owen,2011-09-14 09:21:30+00:00,['c3496d1b4a5a3012d546e73079a07a137788a5c6'],2,46,48,1093942,3,1,1,0,2282
4a8d35ee89f9ead3854fd2c79af7b299b57cf2d4,1,Sean R. Owen,2011-09-14 09:21:50+00:00,['adab9e7a3f8267410330c1e9f43d6606fdcb8c07'],3,2,5,1093947,1,1,0,0,2282
434b9936259ff00ac6772cbd0970e7dd1e24e24f,0,Sean R. Owen,2011-09-14 14:00:25+00:00,['4a8d35ee89f9ead3854fd2c79af7b299b57cf2d4'],1,2,3,1093950,1,1,1,1,2282
e498621f5a46872ffd60bf757b96a616e73ffffc,1,Sean R. Owen,2011-09-14 16:12:53+00:00,['434b9936259ff00ac6772cbd0970e7dd1e24e24f'],65,86,151,1094101,4,,,,2282
5a76e5354e70ee63b7b3b92862155ced2ae7030c,1,Sean R. Owen,2011-09-15 18:16:21+00:00,['e498621f5a46872ffd60bf757b96a616e73ffffc'],8,11,19,1094120,1,1,1,1,2282
149941141dcc05cd92c154139ad04c2d4529bc2a,1,Sean R. Owen,2011-09-15 19:50:07+00:00,['5a76e5354e70ee63b7b3b92862155ced2ae7030c'],346,536,882,1095002,111,0,0.615384615,0.653846154,2282
0d4e2bc1901f7ee67254dc562695ff8a6e2e3b87,0,Sean R. Owen,2011-09-16 15:47:19+00:00,['149941141dcc05cd92c154139ad04c2d4529bc2a'],31,22,53,1095055,1,,,,2282
7773abc1f63d878327ffcfb306081eb051e1f647,0,Sean R. Owen,2011-09-16 18:26:32+00:00,['0d4e2bc1901f7ee67254dc562695ff8a6e2e3b87'],3,0,3,1095058,1,,,,2282
307a198b9cf7262d06fda40045980a7155a69ca7,0,Sean R. Owen,2011-09-17 07:03:57+00:00,['7773abc1f63d878327ffcfb306081eb051e1f647'],3,5,8,1095066,2,0,0,0,2282
6d94195a79b36e1ec0968a28a93c6c0e3462f13f,0,Sean R. Owen,2011-09-18 13:32:19+00:00,['307a198b9cf7262d06fda40045980a7155a69ca7'],1,2,3,1095069,1,,,,2282
1dd5ff1cc735f41369df6208dd55fe38670f4b1f,0,Sebastian Schelter,2011-09-19 17:04:06+00:00,['6d94195a79b36e1ec0968a28a93c6c0e3462f13f'],0,2,2,1095071,1,0,0,1,2282
765834c377d7283cc4243dc91d682dc2aab98040,0,Sean R. Owen,2011-09-20 06:47:58+00:00,['1dd5ff1cc735f41369df6208dd55fe38670f4b1f'],1,18,19,1095090,6,0.5,1,0.666666667,2282
7be37c082b016c9477955e14462ac4c335f50d2b,0,Dmitriy Lyubimov,2011-09-21 18:54:38+00:00,['765834c377d7283cc4243dc91d682dc2aab98040'],2,7,9,1095099,2,1,1,1,2282
a8be9be983ec747145ca34aa094dd4594c8ab6b7,0,Dmitriy Lyubimov,2011-09-22 23:46:22+00:00,['7be37c082b016c9477955e14462ac4c335f50d2b'],8,7,15,1095114,2,0,1,1,2282
db304a20982e8665a365226b7e007867444cab6d,1,Sean R. Owen,2011-09-23 09:00:29+00:00,['a8be9be983ec747145ca34aa094dd4594c8ab6b7'],1,8,9,1095123,1,,,,2282
b8a553b5a1e7e58dc27a47d4860b7f8106a566d7,0,Dmitriy Lyubimov,2011-09-24 00:26:56+00:00,['db304a20982e8665a365226b7e007867444cab6d'],1,1,2,1095125,1,,,,2282
c06c89ae80b6279ffe78156ddc650e329bcb6441,1,Sebastian Schelter,2011-09-27 13:35:08+00:00,['b8a553b5a1e7e58dc27a47d4860b7f8106a566d7'],1,3,4,1095129,1,1,1,1,2282
f4009bfed0f76c9674bccfa06bdff8cd65a41c36,1,Sean R. Owen,2011-09-27 16:16:18+00:00,['c06c89ae80b6279ffe78156ddc650e329bcb6441'],0,2,2,1095131,2,,,,2282
bd654ca4fa9311d3a4b9db83642cbb11318c7c1e,1,Jeff Eastman,2011-09-27 20:34:47+00:00,['f4009bfed0f76c9674bccfa06bdff8cd65a41c36'],129,208,337,1095468,8,0.829268293,0,1,2282
7c0da9029832e3e1f2e5313cdd7e42cbff541e04,1,Sean R. Owen,2011-09-28 19:37:45+00:00,['bd654ca4fa9311d3a4b9db83642cbb11318c7c1e'],216,53,269,1095737,5,0.370786517,0,0.595505618,2282
4cad7a0d9da8f4626a15f895db1e2e27ef68e2dd,0,Sebastian Schelter,2011-09-29 09:24:47+00:00,['7c0da9029832e3e1f2e5313cdd7e42cbff541e04'],17,21,38,1095775,9,1,1,0.2,2282
ff23ffd05bc364ca91e84a9390a53673775c8299,1,Sean R. Owen,2011-09-30 11:44:00+00:00,['4cad7a0d9da8f4626a15f895db1e2e27ef68e2dd'],7,27,34,1095809,2,0,1,1,2282
b0ccf74e0596e678c5d13cb065b3169d206edb36,1,Sean R. Owen,2011-09-30 19:20:47+00:00,['ff23ffd05bc364ca91e84a9390a53673775c8299'],22,122,144,1095953,10,0.6,0.92,0.6,2283
971a56d1d6ea40cbc1505594baeb0685c63cb659,1,Sean R. Owen,2011-10-01 12:16:57+00:00,['b0ccf74e0596e678c5d13cb065b3169d206edb36'],30,34,64,1096017,21,0,0,0,2283
790e703706c7f0e9776bf40c76b1810fd565d669,1,Sean R. Owen,2011-10-01 13:30:24+00:00,['971a56d1d6ea40cbc1505594baeb0685c63cb659'],131,36,167,1096184,5,0.636363636,0.636363636,0,2283
437d9189078a12efee99d52e51b5018e1786c7ca,0,Sean R. Owen,2011-10-02 07:03:17+00:00,['790e703706c7f0e9776bf40c76b1810fd565d669'],25,342,367,1096551,6,0.737777778,1,0.973333333,2284
94f64e6128ae3ba6bf3a76987b43e48e738141f7,1,Sean R. Owen,2011-10-03 07:51:03+00:00,['437d9189078a12efee99d52e51b5018e1786c7ca'],4,305,309,1096860,5,0.415,0.49,0.94,2286
aa4cabef42a30a3e8965e7519dde93fc977256a6,0,Ted Dunning,2011-10-06 18:18:19+00:00,['94f64e6128ae3ba6bf3a76987b43e48e738141f7'],1,11,12,1096872,2,,,,2286
e3f0b7ddf09cdd53d5dc4fdc5785cf852dc52cb5,0,Ted Dunning,2011-10-06 18:20:56+00:00,['aa4cabef42a30a3e8965e7519dde93fc977256a6'],5,15,20,1096892,1,,,,2286
f76674786c4b7a31bfa5e8743a15056220c919c5,0,Ted Dunning,2011-10-06 18:28:12+00:00,['e3f0b7ddf09cdd53d5dc4fdc5785cf852dc52cb5'],1,1,2,1096894,1,,,,2286
07513b859baff21f3ff5a4ad309e4bdaa8fe25c8,0,Grant Ingersoll,2011-10-06 18:32:13+00:00,['f76674786c4b7a31bfa5e8743a15056220c919c5'],0,4,4,1096898,1,,,,2286
7809d0489a2b342f718ef62317f04ae03c1e8399,0,Grant Ingersoll,2011-10-06 18:32:18+00:00,['07513b859baff21f3ff5a4ad309e4bdaa8fe25c8'],0,4,4,1096902,1,,,,2286
ea9726767b108495f49448bdd6be05297f10fce5,0,Grant Ingersoll,2011-10-06 18:38:17+00:00,['7809d0489a2b342f718ef62317f04ae03c1e8399'],8,0,8,1096910,1,,,,2286
29a7f38810270fa45a17bdf2418c896c1594d43c,1,Grant Ingersoll,2011-10-07 14:02:20+00:00,['ea9726767b108495f49448bdd6be05297f10fce5'],597,3491,4088,1100998,49,0.288159772,0.54636234,0.704707561,2311
819cc97c0b37cb4855a6f40b9a9fedbe8b4375b4,0,Abdel Hakim Deneche,2011-10-09 04:40:44+00:00,['29a7f38810270fa45a17bdf2418c896c1594d43c'],13,18,31,1101029,4,0,1,0,2311
8ca83b1fd2fb101f21e5af7d471ba334420e84cd,0,Abdel Hakim Deneche,2011-10-09 17:55:19+00:00,['819cc97c0b37cb4855a6f40b9a9fedbe8b4375b4'],16,22,38,1101067,1,0,0.6,1,2311
8193b05cccacabbcbd2a90fa5730ac7086261a2e,0,Grant Ingersoll,2011-10-09 19:22:55+00:00,['8ca83b1fd2fb101f21e5af7d471ba334420e84cd'],1,1,2,1101069,1,,,,2311
5c5a93d7795a802f6baf7ac2793a6734ed79e640,0,Grant Ingersoll,2011-10-10 15:58:11+00:00,['8193b05cccacabbcbd2a90fa5730ac7086261a2e'],1,1,2,1101071,1,,,,2311
c70f4c1990c94bc42c4630f4bcb91dec68912d2c,0,Grant Ingersoll,2011-10-10 16:36:35+00:00,['5c5a93d7795a802f6baf7ac2793a6734ed79e640'],1,1,2,1101073,1,,,,2311
ac83cf3753a1948364de2d1639aa8aeb2c5c76dc,1,Abdel Hakim Deneche,2011-10-11 04:52:36+00:00,['c70f4c1990c94bc42c4630f4bcb91dec68912d2c'],2221,52,2273,1103346,27,0.675368899,0.188422247,0.371169126,2311
3b9f63579a691838d8e8eec7af33f6f255f4dbdf,1,Grant Ingersoll,2011-10-14 14:58:05+00:00,['ac83cf3753a1948364de2d1639aa8aeb2c5c76dc'],11,37,48,1103394,5,0.133333333,0.133333333,0.866666667,2311
5e191d93a23eb403d7bdee731d51be352957a6d9,0,Sean R. Owen,2011-10-15 10:12:37+00:00,['3b9f63579a691838d8e8eec7af33f6f255f4dbdf'],1,8,9,1103403,1,0,0,1,2311
4194a28a7fd44438f0277c55deff67509bb9fcc4,1,Sean R. Owen,2011-10-15 14:08:33+00:00,['5e191d93a23eb403d7bdee731d51be352957a6d9'],591,744,1335,1104738,131,1,1,1,2311
763c94cac94ada5120cee0cd76fae21ebbff0a14,1,Sean R. Owen,2011-10-15 15:35:50+00:00,['4194a28a7fd44438f0277c55deff67509bb9fcc4'],134,83,217,1104955,20,1,0.85,0.016666667,2311
f56404ad6131bd06e10b57064a1795bedce39ee0,0,Sean R. Owen,2011-10-17 21:05:49+00:00,['763c94cac94ada5120cee0cd76fae21ebbff0a14'],1,1,2,1104957,1,,,,2311
189ac5985d1e01e6c24fdab1bd4dd607003ccbd1,0,Sean R. Owen,2011-10-18 09:35:36+00:00,['f56404ad6131bd06e10b57064a1795bedce39ee0'],1,4,5,1104962,1,0,1,1,2311
8b71fc0e7b98e5f885ef1d9b7b403b3caa586210,0,Jeff Eastman,2011-10-18 16:12:46+00:00,['189ac5985d1e01e6c24fdab1bd4dd607003ccbd1'],2,3,5,1104967,3,,,,2311
4199e60a704c5f3b615ca3e04a02ae57f9242384,0,Jeff Eastman,2011-10-19 16:28:52+00:00,['8b71fc0e7b98e5f885ef1d9b7b403b3caa586210'],1,32,33,1105000,1,,,,2311
45a3cc11f74c55367151878f702cda504d9794e1,0,Jeff Eastman,2011-10-19 20:23:50+00:00,['4199e60a704c5f3b615ca3e04a02ae57f9242384'],6,14,20,1105020,2,1,1,1,2311
08734219ddb27516e4cefcf79f213d66e86dd046,0,Jeff Eastman,2011-10-19 22:28:22+00:00,['45a3cc11f74c55367151878f702cda504d9794e1'],10,11,21,1105041,3,,,,2311
31f5a5f46c56ff29796302014b71ae2f11c4ad71,0,Sean R. Owen,2011-10-20 10:24:02+00:00,['08734219ddb27516e4cefcf79f213d66e86dd046'],4,15,19,1105060,1,,,,2311
f5ac4584c8600b8c02bf6d632ea9471436137816,0,Sean R. Owen,2011-10-20 10:25:21+00:00,['31f5a5f46c56ff29796302014b71ae2f11c4ad71'],1,9,10,1105070,1,,,,2311
4bfa8ebab936c8f524394bda3fcb738a7a1f5858,0,Jeff Eastman,2011-10-20 15:57:10+00:00,['f5ac4584c8600b8c02bf6d632ea9471436137816'],1,1,2,1105072,1,,,,2311
dbf9bd37c7917dbfe4c594d6ea46179386d13141,0,Sean R. Owen,2011-10-21 09:22:38+00:00,['4bfa8ebab936c8f524394bda3fcb738a7a1f5858'],18,27,45,1105117,4,,,,2311
93c7800834e57506bcfb5372a50764ff846cbb1c,1,Sean R. Owen,2011-10-22 11:46:26+00:00,['dbf9bd37c7917dbfe4c594d6ea46179386d13141'],48,55,103,1105220,1,0,0.8,1,2311
e107bfa88bca9b7a39e440b59382ab0396b4f368,1,Abdel Hakim Deneche,2011-10-23 19:26:19+00:00,['93c7800834e57506bcfb5372a50764ff846cbb1c'],195,163,358,1105578,24,0,0,0,2311
760aec883d24d08f633ba4d2c5525372290c6fc6,0,Sean R. Owen,2011-10-24 07:29:36+00:00,['e107bfa88bca9b7a39e440b59382ab0396b4f368'],1,8,9,1105587,1,0,1,1,2311
083eb988e4bd6426e6aedc5b60d11a199300c715,0,Abdel Hakim Deneche,2011-10-24 19:39:40+00:00,['760aec883d24d08f633ba4d2c5525372290c6fc6'],41,25,66,1105653,11,0.2,0.2,0.2,2311
5fc5b6505fe3b8aab755eb8225f73ba6a73b45ef,1,Jacob Alexander Mannix,2011-10-25 01:59:58+00:00,['083eb988e4bd6426e6aedc5b60d11a199300c715'],0,1436,1436,1107089,9,0.392022008,0.675378267,0.870701513,2320
5a5c3247ea619f3b83204ff3120f2532b1023e29,0,Grant Ingersoll,2011-10-26 17:04:16+00:00,['5fc5b6505fe3b8aab755eb8225f73ba6a73b45ef'],4,4,8,1107097,1,,,,2320
ac89aa3c0417e92e0e970141fee14e3d2113ee18,0,Grant Ingersoll,2011-10-31 16:19:46+00:00,['5a5c3247ea619f3b83204ff3120f2532b1023e29'],2,42,44,1107141,2,0.2,1,0.833333333,2320
202d376d2845c7bc05f78f5f4683b2123b9545d8,0,Grant Ingersoll,2011-11-01 15:07:11+00:00,['ac89aa3c0417e92e0e970141fee14e3d2113ee18'],2,6,8,1107149,1,,,,2320
95736dde4a5285f53dcfdae41dbcb9e00996d417,1,Grant Ingersoll,2011-11-01 18:59:35+00:00,['202d376d2845c7bc05f78f5f4683b2123b9545d8'],203,392,595,1107744,5,0.194444444,1,1,2323
f533aefdc3562f578f16a6dd27bbe6a08a77d130,0,Grant Ingersoll,2011-11-01 19:00:13+00:00,['95736dde4a5285f53dcfdae41dbcb9e00996d417'],10,21,31,1107775,2,,,,2323
6c86257f784d8e142039d5d8ff3da260c739b662,0,Grant Ingersoll,2011-11-02 01:11:00+00:00,['f533aefdc3562f578f16a6dd27bbe6a08a77d130'],3,34,37,1107812,4,0.666666667,1,0.708333333,2323
fb65e8a329848d63886074e541395093a7a39eec,0,Grant Ingersoll,2011-11-02 03:27:03+00:00,['6c86257f784d8e142039d5d8ff3da260c739b662'],4,4,8,1107820,2,,,,2323
230b8c5bc9afa9055db49b09692ac8dd076ea37f,0,Grant Ingersoll,2011-11-02 04:07:31+00:00,['fb65e8a329848d63886074e541395093a7a39eec'],1,10,11,1107831,1,,,,2323
6fc9667f092addd03c9e5a98b5eabb6561e1c395,1,Sean R. Owen,2011-11-02 08:38:31+00:00,['230b8c5bc9afa9055db49b09692ac8dd076ea37f'],1,17,18,1107849,2,1,1,1,2323
215570df00da2a682f2109d85c5eab12b78b485e,0,Sebastian Schelter,2011-11-02 09:31:30+00:00,['6fc9667f092addd03c9e5a98b5eabb6561e1c395'],1,2,3,1107852,1,1,1,0,2323
b2866979dfb1d9fc7bcf72905ccb29d5011612eb,0,Grant Ingersoll,2011-11-02 13:32:19+00:00,['215570df00da2a682f2109d85c5eab12b78b485e'],8,9,17,1107869,1,,,,2323
52ce4129a013933836b4bc6ba1bde282810f1959,1,Grant Ingersoll,2011-11-02 13:45:18+00:00,['b2866979dfb1d9fc7bcf72905ccb29d5011612eb'],230,230,460,1108329,64,,,,2323
eecf9dbb97e691fada0c9f81f4a99e1949fce0cc,0,Grant Ingersoll,2011-11-02 13:48:15+00:00,['52ce4129a013933836b4bc6ba1bde282810f1959'],3,2,5,1108334,1,1,1,1,2323
dff4ef1a7c9420a664c441f49aa39652213a213c,0,Grant Ingersoll,2011-11-02 13:48:49+00:00,['eecf9dbb97e691fada0c9f81f4a99e1949fce0cc'],0,1,1,1108335,1,,,,2323
3a50c882374e89a285707600d1f9a17dfec5b327,1,Grant Ingersoll,2011-11-02 14:57:44+00:00,['dff4ef1a7c9420a664c441f49aa39652213a213c'],5,113,118,1108453,4,0.245283019,0.905660377,0.339622642,2324
de69de1d385b4c64d1d710c869f79315944e45f5,0,Grant Ingersoll,2011-11-02 15:30:40+00:00,['3a50c882374e89a285707600d1f9a17dfec5b327'],7,21,28,1108481,2,0,1,1,2324
12379ec7bfc25014ce2bb46888e9617899e67cc5,0,Grant Ingersoll,2011-11-02 16:02:03+00:00,['de69de1d385b4c64d1d710c869f79315944e45f5'],6,3,9,1108490,3,0,0,0,2324
b2e119a79c3a8ce26de523982e9a0b168fc88bc7,1,Grant Ingersoll,2011-11-02 17:19:09+00:00,['12379ec7bfc25014ce2bb46888e9617899e67cc5'],0,32,32,1108522,1,0,1,1,2325
7ad6f1375acf47e7fdbcd812802081c11bb2645f,0,Grant Ingersoll,2011-11-02 21:16:52+00:00,['b2e119a79c3a8ce26de523982e9a0b168fc88bc7'],1,2,3,1108525,1,1,1,1,2325
e0ec7c1be9cf1141123b00841c9502e85f5ae426,1,Sean R. Owen,2011-11-02 21:50:15+00:00,['7ad6f1375acf47e7fdbcd812802081c11bb2645f'],639,8581,9220,1117745,167,0.613243762,0.897952655,0.785668586,2386
90d175e5a930b0081332ea1d2f079815fe846112,0,Grant Ingersoll,2011-11-03 00:39:52+00:00,['e0ec7c1be9cf1141123b00841c9502e85f5ae426'],48,47,95,1117840,1,0,0,1,2386
bee7405746e85665cabb64201d6bb3547f633189,0,Grant Ingersoll,2011-11-03 04:01:49+00:00,['90d175e5a930b0081332ea1d2f079815fe846112'],5,46,51,1117891,3,0,0.068965517,1,2386
d491f69bc2a6e2d0d369d84c03b46338fe886b42,0,Grant Ingersoll,2011-11-03 12:16:03+00:00,['bee7405746e85665cabb64201d6bb3547f633189'],8080,0,8080,1125971,61,0.438429506,0.176680547,0.199881023,2386
3988abddbc7abbf4c36b759cd88240fc8f553d2b,1,Grant Ingersoll,2011-11-03 12:23:56+00:00,['d491f69bc2a6e2d0d369d84c03b46338fe886b42'],13,10,23,1125994,5,0.666666667,0,0.333333333,2386
807ad49c4b3fa4a4f558283cd4fa2d7d3cd9117d,0,Grant Ingersoll,2011-11-03 12:57:02+00:00,['3988abddbc7abbf4c36b759cd88240fc8f553d2b'],16,15,31,1126025,1,,,,2386
e410e34ddc9066e0a1b22f199c54b662fe9494e9,0,Grant Ingersoll,2011-11-03 18:20:59+00:00,['807ad49c4b3fa4a4f558283cd4fa2d7d3cd9117d'],13,13,26,1126051,1,,,,2386
509b443752e5099b7080abca9344f4ca98df55f4,0,Grant Ingersoll,2011-11-03 19:52:07+00:00,['e410e34ddc9066e0a1b22f199c54b662fe9494e9'],62,64,126,1126177,1,,,,2386
1b0d9ee637273bdd884c544b3694e4a6a073b7dc,0,Grant Ingersoll,2011-11-03 21:04:21+00:00,['509b443752e5099b7080abca9344f4ca98df55f4'],18,10,28,1126205,1,0,0,0,2386
3ba87c8695c8c8b00a7ebc5fdb916e62c541ad7c,0,Grant Ingersoll,2011-11-03 23:02:00+00:00,['1b0d9ee637273bdd884c544b3694e4a6a073b7dc'],20,23,43,1126248,1,,,,2386
b4e428cfe2f47566ffffd62824dfbdfdd4e0918e,0,Grant Ingersoll,2011-11-04 02:32:39+00:00,['3ba87c8695c8c8b00a7ebc5fdb916e62c541ad7c'],7,8,15,1126263,1,,,,2386
81d64c0977a896c40e582d80724501bfd9c694dc,1,Sebastian Schelter,2011-11-04 08:55:26+00:00,['b4e428cfe2f47566ffffd62824dfbdfdd4e0918e'],1470,618,2088,1128351,26,0.484496124,0.160852713,0.110465116,2392
ca18680aa892900773be3440a58f2cd63aaf7b44,1,Sean R. Owen,2011-11-04 11:20:03+00:00,['81d64c0977a896c40e582d80724501bfd9c694dc'],76,593,669,1129020,7,0.629508197,0.829508197,0.691803279,2393
8ad8d96cb41120e5278ade09437d91f5120291e0,0,Grant Ingersoll,2011-11-04 14:19:44+00:00,['ca18680aa892900773be3440a58f2cd63aaf7b44'],3,4,7,1129027,1,,,,2393
8bee08594605e6ddb4bb8d3a658463f534533950,0,Grant Ingersoll,2011-11-04 21:56:39+00:00,['8ad8d96cb41120e5278ade09437d91f5120291e0'],2,8,10,1129037,2,,,,2393
f23eb85caa05801f978f54799abfffc0047a385a,0,Sean R. Owen,2011-11-04 23:49:38+00:00,['8bee08594605e6ddb4bb8d3a658463f534533950'],0,149,149,1129186,1,0.635294118,0.635294118,0.423529412,2394
fd0d1951e1b6737f249b27070966c917ca4309c5,0,Sean R. Owen,2011-11-04 23:50:12+00:00,['f23eb85caa05801f978f54799abfffc0047a385a'],231,0,231,1129417,2,0.714285714,0.472527473,0.472527473,2394
faa82ce3719898058da06a1d7b0948bf326968eb,1,Grant Ingersoll,2011-11-05 00:21:17+00:00,['fd0d1951e1b6737f249b27070966c917ca4309c5'],128,700,828,1130245,13,0.606382979,0.680851064,0.542553191,2400
4688b73ba9d99e0dc77367a62f5d7e4b36c8cc72,1,Grant Ingersoll,2011-11-05 04:10:05+00:00,['faa82ce3719898058da06a1d7b0948bf326968eb'],146,104,250,1130495,1,1,1,0,2400
070cf44cb72d3034e4098db6fd8a22d17de28260,1,Grant Ingersoll,2011-11-05 14:17:52+00:00,['4688b73ba9d99e0dc77367a62f5d7e4b36c8cc72'],26,35,61,1130556,1,,,,2400
f1a7de436bb6098e8c51991f00f84802b17b6527,0,Grant Ingersoll,2011-11-05 16:23:46+00:00,['070cf44cb72d3034e4098db6fd8a22d17de28260'],8,11,19,1130575,1,,,,2400
2e4d30660950bea4610036917d108079c0bcb887,1,Grant Ingersoll,2011-11-05 17:11:57+00:00,['f1a7de436bb6098e8c51991f00f84802b17b6527'],15,752,767,1131342,17,0.3728223,0.728222997,0.853658537,2413
baa3a8c60a51a8d41ab20ebf04f3cc86636a0be7,1,Sean R. Owen,2011-11-06 09:44:54+00:00,['2e4d30660950bea4610036917d108079c0bcb887'],156,182,338,1131680,5,0,1,0.214285714,2413
2736bc5c58f71c2fa863ff64bf61b3960c122b86,1,Sean R. Owen,2011-11-07 08:44:59+00:00,['baa3a8c60a51a8d41ab20ebf04f3cc86636a0be7'],56,78,134,1131814,10,0,0,0.636363636,2413
1dc03a53897010623429fd5b63b4af8f7368db22,0,Sean R. Owen,2011-11-07 22:03:29+00:00,['2736bc5c58f71c2fa863ff64bf61b3960c122b86'],1,1,2,1131816,1,,,,2413
3631151aa02e5df237b4f20be673d6fc5d299cef,1,Sebastian Schelter,2011-11-08 10:13:22+00:00,['1dc03a53897010623429fd5b63b4af8f7368db22'],74,340,414,1132230,6,0.5,1,0.883116883,2414
d317c1cbd78b0d0b06464010f52a057f29eff554,1,Sebastian Schelter,2011-11-10 15:09:01+00:00,['3631151aa02e5df237b4f20be673d6fc5d299cef'],5,233,238,1132468,5,0,0,1,2416
cdafd91b26b2049b69717085074dc4ee6fb61a30,0,Grant Ingersoll,2011-11-11 05:39:57+00:00,['d317c1cbd78b0d0b06464010f52a057f29eff554'],6,6,12,1132480,1,,,,2416
467fe17a305c5347fdd9c5c0ac7823043a9ac3d9,1,Grant Ingersoll,2011-11-11 23:15:29+00:00,['cdafd91b26b2049b69717085074dc4ee6fb61a30'],0,6,6,1132486,1,,,,2416
8771d8921483ba202cd44f58b33f770f489c0f1c,0,Grant Ingersoll,2011-11-12 05:20:44+00:00,['467fe17a305c5347fdd9c5c0ac7823043a9ac3d9'],4,4,8,1132494,1,,,,2416
efb7b638eb4329ba86a8bdfb6a1b73b5d1ebeb14,1,Grant Ingersoll,2011-11-12 08:15:20+00:00,['8771d8921483ba202cd44f58b33f770f489c0f1c'],1,161,162,1132656,2,0.431372549,1,1,2417
8a2c0f3e24424e533b253b7110615c2ce75b043e,1,Grant Ingersoll,2011-11-12 08:19:18+00:00,['efb7b638eb4329ba86a8bdfb6a1b73b5d1ebeb14'],128,476,604,1133260,6,0.076335878,0.564885496,0.625954198,2421
4b2c5d37e9c6fb4636d3c931da168b6e143c88d8,0,Sean R. Owen,2011-11-12 11:42:09+00:00,['8a2c0f3e24424e533b253b7110615c2ce75b043e'],3,16,19,1133279,3,0,1,1,2421
9f6eb59b2669888d4dd65b6d512701add7ebb9b5,0,Sean R. Owen,2011-11-12 11:49:12+00:00,['4b2c5d37e9c6fb4636d3c931da168b6e143c88d8'],21,19,40,1133319,1,,,,2421
c8143391050e7137a405691c59e3848e3086ff3b,0,Grant Ingersoll,2011-11-12 16:19:38+00:00,['9f6eb59b2669888d4dd65b6d512701add7ebb9b5'],0,41,41,1133360,1,0,1,1,2422
d2dd88487f4bcc1972f25d71e74afd4940b7398b,0,Grant Ingersoll,2011-11-12 23:07:58+00:00,['c8143391050e7137a405691c59e3848e3086ff3b'],9,23,32,1133392,2,0,0,1,2422
1ead5ae9809a2048c27a6af02dd59e12fce03f87,0,Grant Ingersoll,2011-11-12 23:35:42+00:00,['d2dd88487f4bcc1972f25d71e74afd4940b7398b'],6,22,28,1133420,3,0,0,1,2422
128e3bed08b5b34d82f1154d101863fc57d30e04,0,Grant Ingersoll,2011-11-13 05:17:40+00:00,['1ead5ae9809a2048c27a6af02dd59e12fce03f87'],3,2,5,1133425,1,1,0,0,2422
08e65f66279f03caaa46f789f20d17d1db36c78f,1,Sebastian Schelter,2011-11-13 17:00:36+00:00,['128e3bed08b5b34d82f1154d101863fc57d30e04'],2691,483,3174,1136599,38,0.248987854,0.026315789,0.203441296,2425
5ee07e316a372e81bae135153c1157c2ef276562,0,Sebastian Schelter,2011-11-13 17:03:29+00:00,['08e65f66279f03caaa46f789f20d17d1db36c78f'],4,92,96,1136695,3,0,1,1,2426
aad970c9d687fe802709380583b76cf9bf1d19d9,0,Sebastian Schelter,2011-11-13 17:09:45+00:00,['5ee07e316a372e81bae135153c1157c2ef276562'],185,0,185,1136880,2,0,0,0,2426
d8629d6c29daf985e5b0c4c8aa179355a90be9b2,0,Sebastian Schelter,2011-11-13 17:13:32+00:00,['aad970c9d687fe802709380583b76cf9bf1d19d9'],1,2,3,1136883,1,1,1,1,2426
2f7f0dc0cfd8c31e4cfa54f397866b66c6dc2d21,1,Sean R. Owen,2011-11-14 21:26:53+00:00,['d8629d6c29daf985e5b0c4c8aa179355a90be9b2'],4,22,26,1136909,3,0.266666667,0.933333333,1,2426
bea695ddeee7f54b7128bc916442385bb02f0a5e,0,Sean R. Owen,2011-11-15 08:49:13+00:00,['2f7f0dc0cfd8c31e4cfa54f397866b66c6dc2d21'],5,43,48,1136957,2,0.176470588,0.735294118,0.176470588,2426
330250d36b0308c6b49975cf0f9065466e07aef9,0,Sean R. Owen,2011-11-16 18:01:04+00:00,['bea695ddeee7f54b7128bc916442385bb02f0a5e'],2,2,4,1136961,2,,,,2426
2bccb1d2f845cb2ef385acebfde0773a21bdc925,0,Jacob Alexander Mannix,2011-11-17 07:58:04+00:00,['330250d36b0308c6b49975cf0f9065466e07aef9'],4,5,9,1136970,1,,,,2426
eecce949023711e3ed55833ca84e1a0d3887f301,0,Isabel Drost,2011-11-18 19:06:36+00:00,['2bccb1d2f845cb2ef385acebfde0773a21bdc925'],6,20,26,1136996,1,,,,2426
d98241a04d24dd46eb549a493f835abe6c68a4e9,1,Grant Ingersoll,2011-11-21 22:35:15+00:00,['eecce949023711e3ed55833ca84e1a0d3887f301'],366,473,839,1137835,7,,,,2430
4fbab15638e53ce494796260f6c291bb2926ad19,0,Sean R. Owen,2011-11-22 06:48:38+00:00,['d98241a04d24dd46eb549a493f835abe6c68a4e9'],88,214,302,1138137,7,0,1,0,2433
05cf6342b2699ecba05a44abfc5e47e680a425fe,0,Grant Ingersoll,2011-11-23 02:47:28+00:00,['4fbab15638e53ce494796260f6c291bb2926ad19'],6,55,61,1138198,4,0.818181818,0.818181818,0.318181818,2434
1eb8e4f612e251b02c6921d59f6e23a7a5ab5189,1,Grant Ingersoll,2011-11-23 14:25:26+00:00,['05cf6342b2699ecba05a44abfc5e47e680a425fe'],6,23,29,1138227,2,0,0,1,2434
6b4c192d420cb9bb8596eeefcb2c280d3eed0b15,0,Sean R. Owen,2011-11-23 17:17:56+00:00,['1eb8e4f612e251b02c6921d59f6e23a7a5ab5189'],0,6,6,1138233,1,,,,2434
846ef86fa1e40ccdec01445c5c29703107d564d3,0,Sean R. Owen,2011-11-25 16:37:42+00:00,['6b4c192d420cb9bb8596eeefcb2c280d3eed0b15'],25,25,50,1138283,1,,,,2434
5389d76eed9ce58aefd9b08e0827ce48ca6fea39,0,Grant Ingersoll,2011-11-25 21:29:47+00:00,['846ef86fa1e40ccdec01445c5c29703107d564d3'],9,22,31,1138314,4,1,1,0,2434
d04071c12abc80df189041eb168ac007f8cd7f99,1,Grant Ingersoll,2011-11-27 12:35:27+00:00,['5389d76eed9ce58aefd9b08e0827ce48ca6fea39'],1,1,2,1138316,1,,,,2434
69febd5a32829837e8267ad3d804154f8f3d03b7,0,Grant Ingersoll,2011-11-27 12:46:26+00:00,['d04071c12abc80df189041eb168ac007f8cd7f99'],1,0,1,1138317,1,,,,2434
a2346aebab853c08f6076e6cac573a3499d48b27,0,Grant Ingersoll,2011-11-27 16:54:39+00:00,['69febd5a32829837e8267ad3d804154f8f3d03b7'],3,3,6,1138323,1,,,,2434
2c1c3ad1057f9e36227549064fa555a37d307a7a,0,Grant Ingersoll,2011-11-27 21:52:38+00:00,['a2346aebab853c08f6076e6cac573a3499d48b27'],1,1,2,1138325,1,,,,2434
4bb34a8b88cf399b58b0ff279613b7c1473c8fbd,1,Grant Ingersoll,2011-11-28 00:46:20+00:00,['2c1c3ad1057f9e36227549064fa555a37d307a7a'],6,12,18,1138343,1,,,,2434
e75074d1349574cc6c19579aadf826d831866995,0,Sean R. Owen,2011-11-28 10:45:08+00:00,['4bb34a8b88cf399b58b0ff279613b7c1473c8fbd'],4,4,8,1138351,2,,,,2434
220e11992cc33c088c360be948c0ee5aa365e4f3,0,Sean R. Owen,2011-11-28 10:46:25+00:00,['e75074d1349574cc6c19579aadf826d831866995'],2,2,4,1138355,1,,,,2434
1c9c61798fc66195dbd015df2244f90c92a1094a,0,Sean R. Owen,2011-11-28 12:23:05+00:00,['220e11992cc33c088c360be948c0ee5aa365e4f3'],1,7,8,1138363,1,0,1,1,2434
4c2d7deb2fe77db40b5f01ac3de09bf1283ac77c,1,Sean R. Owen,2011-11-28 18:54:29+00:00,['1c9c61798fc66195dbd015df2244f90c92a1094a'],2,2,4,1138367,1,,,,2434
38b644235d854331d59f27d3461ead8c72334508,1,Grant Ingersoll,2011-11-29 04:26:42+00:00,['4c2d7deb2fe77db40b5f01ac3de09bf1283ac77c'],95,94,189,1138556,1,1,1,1,2434
2ead329cb23df8561510b4e3ca191cc77a6605cf,1,Sean R. Owen,2011-11-29 10:55:42+00:00,['38b644235d854331d59f27d3461ead8c72334508'],31,115,146,1138702,1,0,0,0,2434
408e57bb224d5fbf276eba7ca5056e681623d219,0,Grant Ingersoll,2011-11-29 13:10:13+00:00,['2ead329cb23df8561510b4e3ca191cc77a6605cf'],8,10,18,1138720,1,0,0,1,2434
c9d49ee0b1b63f4503cbb3457a6c96c67e3df799,0,Grant Ingersoll,2011-11-29 16:35:19+00:00,['408e57bb224d5fbf276eba7ca5056e681623d219'],9,4,13,1138733,6,,,,2434
c1d2cd13539c1e4c58cb013da6c63ed362720386,0,Sean R. Owen,2011-12-02 00:12:13+00:00,['c9d49ee0b1b63f4503cbb3457a6c96c67e3df799'],37,170,207,1138940,15,1,1,1,2435
3292d07fa38bd482a27eb757f3cfad5fd4e2ba1d,0,Grant Ingersoll,2011-12-02 13:39:00+00:00,['c1d2cd13539c1e4c58cb013da6c63ed362720386'],4,4,8,1138948,3,,,,2435
cf4cfaa245fecd522d678e207f1861ae99774f80,0,Grant Ingersoll,2011-12-02 13:51:19+00:00,['3292d07fa38bd482a27eb757f3cfad5fd4e2ba1d'],1,1,2,1138950,1,,,,2435
7bfa45c6e870935af96622d96d622be242bb4c96,0,Sean R. Owen,2011-12-02 16:48:19+00:00,['cf4cfaa245fecd522d678e207f1861ae99774f80'],7,14,21,1138971,3,0.571428571,0.571428571,1,2435
131eb4a1f8d2865e62c97779ac59dedc365d2988,1,Jacob Alexander Mannix,2011-12-03 00:18:46+00:00,['7bfa45c6e870935af96622d96d622be242bb4c96'],71,3071,3142,1142113,25,0.403575298,0.699891658,0.660346696,2451
e5ad03222a60e7fc11f43fc04d600b26b6cc5678,0,Jacob Alexander Mannix,2011-12-03 05:50:44+00:00,['131eb4a1f8d2865e62c97779ac59dedc365d2988'],2,5,7,1142120,2,,,,2451
07f8c0afbcdda2839164919857406066e2cdfe12,0,Sebastian Schelter,2011-12-04 07:35:52+00:00,['e5ad03222a60e7fc11f43fc04d600b26b6cc5678'],1,2,3,1142123,1,,,,2451
4fbfbc694a956c6e4923af27fbd42eb26467bb9f,1,Sean R. Owen,2011-12-05 12:33:12+00:00,['07f8c0afbcdda2839164919857406066e2cdfe12'],698,826,1524,1143647,110,1,0.375,0.7,2451
2e2ef2cadb6d5c047e3f45356d689e8977a99dcc,0,Sean R. Owen,2011-12-05 17:54:39+00:00,['4fbfbc694a956c6e4923af27fbd42eb26467bb9f'],1,33,34,1143681,3,1,1,0.888888889,2451
ce91968a54263986f45f74dac55f8987ec6941ed,0,Sean R. Owen,2011-12-05 20:13:43+00:00,['2e2ef2cadb6d5c047e3f45356d689e8977a99dcc'],1,2,3,1143684,1,,,,2451
2b5dabe1817fff5db738dce15446d2693d1084b7,1,Grant Ingersoll,2011-12-06 15:07:31+00:00,['ce91968a54263986f45f74dac55f8987ec6941ed'],55,109,164,1143848,6,,,,2451
d8e91f904e3306651743e1ad2a2c48e4f3745248,1,Grant Ingersoll,2011-12-06 16:17:04+00:00,['2b5dabe1817fff5db738dce15446d2693d1084b7'],83,1086,1169,1145017,17,0.410752688,0.916129032,0.488172043,2459
f81face912ea2d911cba2514b13e9ae022dc5458,0,Sean R. Owen,2011-12-06 21:11:26+00:00,['d8e91f904e3306651743e1ad2a2c48e4f3745248'],225,23,248,1145265,4,0.329113924,0,0.075949367,2459
4be0a0821ae7e3a4b61ce42d5c31ddc5395392de,0,Sean R. Owen,2011-12-07 10:24:47+00:00,['f81face912ea2d911cba2514b13e9ae022dc5458'],35,71,106,1145371,2,0.1,0.133333333,0.533333333,2459
c586b3e013fa57feebea59b6e1cf4aab615b9b04,0,Sean R. Owen,2011-12-07 13:49:29+00:00,['4be0a0821ae7e3a4b61ce42d5c31ddc5395392de'],11,46,57,1145428,1,1,1,1,2459
9d448811aa05a14758390f1c4f19f67b4f267559,1,Jeff Eastman,2011-12-07 23:58:36+00:00,['c586b3e013fa57feebea59b6e1cf4aab615b9b04'],16,1132,1148,1146576,18,0.812182741,1,0.842639594,2470
bcde5878421f8721402c1f435658af737f5b4eda,1,Grant Ingersoll,2011-12-08 10:41:58+00:00,['9d448811aa05a14758390f1c4f19f67b4f267559'],11,31,42,1146618,1,,,,2470
8150e795c22e43ab7cbb5f265684bcaccc4f2cb6,1,Grant Ingersoll,2011-12-08 11:11:39+00:00,['bcde5878421f8721402c1f435658af737f5b4eda'],4,13,17,1146635,1,0,0,1,2470
96ea50161aa164271e335061f7730844865b8c62,0,Grant Ingersoll,2011-12-08 13:27:37+00:00,['8150e795c22e43ab7cbb5f265684bcaccc4f2cb6'],7,10,17,1146652,1,0,1,1,2470
05f9475a731cbbd00ef871263436410e7998b1de,0,Sean R. Owen,2011-12-09 10:09:04+00:00,['96ea50161aa164271e335061f7730844865b8c62'],3,3,6,1146658,2,,,,2470
f22d03cb408c1cc05304f9c1633620f0dff49b67,0,Jeff Eastman,2011-12-09 17:35:56+00:00,['05f9475a731cbbd00ef871263436410e7998b1de'],11,0,11,1146669,1,,,,2470
e9cc3238826c6c248b6ba69eceba6807ac9defeb,1,Abdel Hakim Deneche,2011-12-11 17:53:50+00:00,['f22d03cb408c1cc05304f9c1633620f0dff49b67'],443,1216,1659,1148328,42,0,0,0.883870968,2473
d6aba1afc80cbeb3c6945c69b6e5ee13d4699496,1,Abdel Hakim Deneche,2011-12-12 14:52:57+00:00,['e9cc3238826c6c248b6ba69eceba6807ac9defeb'],474,474,948,1149276,37,0.833333333,1,0.833333333,2473
3a14a77f222e7a276d3719eb9af005926bd61e39,0,Sebastian Schelter,2011-12-12 16:08:36+00:00,['d6aba1afc80cbeb3c6945c69b6e5ee13d4699496'],12,87,99,1149375,2,0,1,0.890909091,2473
319649691808de0aab899cf11820691f3944abc6,0,Grant Ingersoll,2011-12-13 13:25:30+00:00,['3a14a77f222e7a276d3719eb9af005926bd61e39'],4,2,6,1149381,1,,,,2473
5a2250c6e82880eb68b6f0a3953403c476486dfe,1,Dmitriy Lyubimov,2011-12-13 18:36:05+00:00,['319649691808de0aab899cf11820691f3944abc6'],442,826,1268,1150649,20,0.147783251,0.39408867,0.694581281,2474
7942746edc830e88cd4ee8f55ea1a2b54d0169ea,1,Sean R. Owen,2011-12-13 21:08:56+00:00,['5a2250c6e82880eb68b6f0a3953403c476486dfe'],3,31,34,1150683,3,0.294117647,0,0.176470588,2474
5214b1d7a44e3f82d7011fadbfc748520c8c07de,0,Dmitriy Lyubimov,2011-12-18 05:01:32+00:00,['7942746edc830e88cd4ee8f55ea1a2b54d0169ea'],58,185,243,1150926,7,0,0,0.728395062,2474
ebeade909b952e203f30416486ee45b7848d1741,0,Dmitriy Lyubimov,2011-12-19 05:33:26+00:00,['5214b1d7a44e3f82d7011fadbfc748520c8c07de'],185,58,243,1151169,7,1,1,0.271604938,2474
8bac9143bda95a13b992e074a090df24be91019f,1,Dmitriy Lyubimov,2011-12-21 04:08:04+00:00,['ebeade909b952e203f30416486ee45b7848d1741'],127,441,568,1151737,9,0.146496815,0,0.433121019,2474
c590f1b006f6c186ea1e98e9aaea27df66f83f98,0,Jeff Eastman,2011-12-22 20:18:34+00:00,['8bac9143bda95a13b992e074a090df24be91019f'],9,26,35,1151772,2,1,1,1,2474
4432e3194bc54dcbfe8fd7267c01bddd26762e3a,0,Jeff Eastman,2011-12-22 20:43:26+00:00,['c590f1b006f6c186ea1e98e9aaea27df66f83f98'],6,4,10,1151782,1,0,0,0,2474
faf0b6e325b52e0f25f7e8b657981441ac6f8608,1,Ted Dunning,2011-12-22 23:51:27+00:00,['4432e3194bc54dcbfe8fd7267c01bddd26762e3a'],0,350,350,1152132,2,0.299107143,0.71875,1,2476
86352e3decdf7b1caffdbb03e11cbb3c640db8fe,1,Ted Dunning,2011-12-22 23:51:31+00:00,['faf0b6e325b52e0f25f7e8b657981441ac6f8608'],0,17,17,1152149,1,1,1,1,2476
c898d272120b6d63a8b81175fad2f1e72a711310,1,Ted Dunning,2011-12-22 23:51:41+00:00,['86352e3decdf7b1caffdbb03e11cbb3c640db8fe'],0,554,554,1152703,6,0.506726457,0.816143498,0.542600897,2480
f5cce9b0b12dbfaae57dd753e8ffe2729d300dc4,1,Ted Dunning,2011-12-22 23:51:50+00:00,['c898d272120b6d63a8b81175fad2f1e72a711310'],26,36,62,1152765,3,0,1,1,2480
11763fb82ee9f90de3a8114333a9ecf405add48b,0,Ted Dunning,2011-12-22 23:51:56+00:00,['f5cce9b0b12dbfaae57dd753e8ffe2729d300dc4'],11,25,36,1152801,2,0.363636364,0.363636364,0.272727273,2480
60fae60a240bfc3880717f96ee884cdccaa1c5d4,0,Jeff Eastman,2011-12-23 01:01:58+00:00,['11763fb82ee9f90de3a8114333a9ecf405add48b'],13,33,46,1152847,1,1,1,1,2480
7ad345d3331db7a38ef100d2512f3145232ceedd,0,Abdel Hakim Deneche,2011-12-23 07:29:36+00:00,['60fae60a240bfc3880717f96ee884cdccaa1c5d4'],48,86,134,1152981,2,0.125,0,1,2480
6290deb496f0974fc9a776463b810a3bb5fd947a,0,Abdel Hakim Deneche,2011-12-23 07:30:28+00:00,['7ad345d3331db7a38ef100d2512f3145232ceedd'],0,78,78,1153059,1,0,1,1,2481
4eac2cb442d62f12e532621cbcd666a0237635f4,0,Sean R. Owen,2011-12-23 14:10:57+00:00,['6290deb496f0974fc9a776463b810a3bb5fd947a'],2,2,4,1153063,1,,,,2481
dc637e81642ddf1171bfaa171c15c28bc0594565,1,Jeff Eastman,2011-12-26 14:21:26+00:00,['4eac2cb442d62f12e532621cbcd666a0237635f4'],118,372,490,1153553,13,0.451327434,1,0.353982301,2483
8642b98ebd1de6e1b2286ef80d44adf959b34140,1,Abdel Hakim Deneche,2011-12-26 16:24:37+00:00,['dc637e81642ddf1171bfaa171c15c28bc0594565'],0,514,514,1154067,3,0.254681648,0.651685393,0.460674157,2486
564c3e13a9eaf84fc76335b4a415937a747c974f,1,Sean R. Owen,2011-12-28 04:58:11+00:00,['8642b98ebd1de6e1b2286ef80d44adf959b34140'],644,516,1160,1155227,60,1,0,0.346153846,2487
15925a5bb0bed57dde21c071997d79c411068162,0,Sean R. Owen,2011-12-29 03:19:48+00:00,['564c3e13a9eaf84fc76335b4a415937a747c974f'],52,13,65,1155292,9,,,,2487
eae542027e78732bff9a553e238683dcca08f94c,0,Sean R. Owen,2011-12-29 03:20:56+00:00,['15925a5bb0bed57dde21c071997d79c411068162'],19,8,27,1155319,1,0,0,0,2487
78545ff1d97693d51a718eb2992c104b025ab79c,1,Jeff Eastman,2011-12-29 17:20:48+00:00,['eae542027e78732bff9a553e238683dcca08f94c'],26,109,135,1155454,6,0.53125,1,0.75,2487
71bf817489d4f23b85d1d2ee048093e8353a3f12,0,Sean R. Owen,2011-12-29 20:55:49+00:00,['78545ff1d97693d51a718eb2992c104b025ab79c'],50,166,216,1155670,3,1,1,0.384615385,2489
1540cecb889e1204a7fef826e92e30f60486af5c,0,Sean R. Owen,2011-12-30 00:03:12+00:00,['71bf817489d4f23b85d1d2ee048093e8353a3f12'],21,8,29,1155699,1,0,0,0,2489
8bc64151162118158ebc4b362be7d0f9709a065c,0,Ted Dunning,2011-12-30 18:24:00+00:00,['1540cecb889e1204a7fef826e92e30f60486af5c'],0,45,45,1155744,3,1,1,1,2491
e6a308bebe5ee5b4c45fed6c08cc7aa83bce85f6,1,Grant Ingersoll,2012-01-02 17:14:53+00:00,['8bc64151162118158ebc4b362be7d0f9709a065c'],150,671,821,1156565,7,0.25,0.667857143,0.717857143,2492
822a5e17c3c1e07c711821b3c19c7641b19c55a5,1,Sean R. Owen,2012-01-04 14:47:11+00:00,['e6a308bebe5ee5b4c45fed6c08cc7aa83bce85f6'],73,36,109,1156674,7,1,1,0.193548387,2492
69f324d9ed6a70e4eb7f6190b2e1751ce9dfca10,1,Grant Ingersoll,2012-01-08 15:54:31+00:00,['822a5e17c3c1e07c711821b3c19c7641b19c55a5'],24,151,175,1156849,8,0.388888889,0.694444444,0.930555556,2492
b7b432c7f958b3feed1fd181f9bda08aa6c1865d,1,Grant Ingersoll,2012-01-08 20:37:59+00:00,['69f324d9ed6a70e4eb7f6190b2e1751ce9dfca10'],29,218,247,1157096,7,0.115107914,0.215827338,0.381294964,2492
051cbcf86e5dd61a198803256781c058120938d0,1,Sean R. Owen,2012-01-09 05:27:28+00:00,['b7b432c7f958b3feed1fd181f9bda08aa6c1865d'],123,140,263,1157359,30,0.8,1,1,2492
bc9aa53c3fa0409c98801bbc2a58af6d48dd4c94,0,Grant Ingersoll,2012-01-12 20:54:44+00:00,['051cbcf86e5dd61a198803256781c058120938d0'],1,7,8,1157367,2,0,1,1,2492
f57e759a33a9edbcb7bfb4424a04f4889250706f,1,Grant Ingersoll,2012-01-13 13:48:50+00:00,['bc9aa53c3fa0409c98801bbc2a58af6d48dd4c94'],0,378,378,1157745,1,0.40952381,1,0.871428571,2493
33592c1a38c48efd2b9cbb042a31f94236e0b89b,1,Robin Anil,2012-01-15 16:12:14+00:00,['f57e759a33a9edbcb7bfb4424a04f4889250706f'],402,3179,3581,1161326,27,0.12386511,0.416990921,0.762645914,2505
3be3d239e82b2f977778f3d7163c642980e34474,0,Ted Dunning,2012-01-16 00:01:38+00:00,['33592c1a38c48efd2b9cbb042a31f94236e0b89b'],68,111,179,1161505,2,0,0.777777778,1,2505
5995c32d6ea481dd5dbf494c8f92af8463386816,1,Sean R. Owen,2012-01-27 16:25:26+00:00,['3be3d239e82b2f977778f3d7163c642980e34474'],0,59,59,1161564,1,,,,2505
f9a9f39b05ba380e56901b78234a801b86c6e719,0,Grant Ingersoll,2012-01-27 21:41:31+00:00,['5995c32d6ea481dd5dbf494c8f92af8463386816'],1,2,3,1161567,1,,,,2505
356bfd15aeee5e14010f0af8436f261e12f1f907,1,Grant Ingersoll,2012-01-28 15:23:58+00:00,['f9a9f39b05ba380e56901b78234a801b86c6e719'],9,52,61,1161628,2,0,0.162162162,0.837837838,2505
1ce7d01775bd547c570fafa808111e4456a185f2,0,Grant Ingersoll,2012-01-28 15:24:03+00:00,['356bfd15aeee5e14010f0af8436f261e12f1f907'],0,2,2,1161630,1,,,,2505
3d22cb24b2822b6740b555455625431340663bed,0,Shannon Quinn,2012-02-01 01:59:54+00:00,['1ce7d01775bd547c570fafa808111e4456a185f2'],11,11,22,1161652,7,,,,2505
d29dd6cd3a32ddbb22d2fabaec3b42078b217c51,0,Shannon Quinn,2012-02-01 02:00:06+00:00,['3d22cb24b2822b6740b555455625431340663bed'],11,11,22,1161674,7,,,,2505
d5af57b38606e96772bcd0344d489b37c8419077,0,Shannon Quinn,2012-02-01 02:54:49+00:00,['d29dd6cd3a32ddbb22d2fabaec3b42078b217c51'],8,8,16,1161690,7,,,,2505
deb1c161ccec42d78f692932e5bef19331695954,0,Shannon Quinn,2012-02-01 12:35:23+00:00,['d5af57b38606e96772bcd0344d489b37c8419077'],11,11,22,1161712,7,,,,2505
63e58164dac143488300b9ce9bf3038a27a81623,0,Shannon Quinn,2012-02-01 12:35:34+00:00,['deb1c161ccec42d78f692932e5bef19331695954'],11,11,22,1161734,7,,,,2505
118c25493d2073057b0617a9efb8aa42d52da97d,0,Sean R. Owen,2012-02-07 18:45:58+00:00,['63e58164dac143488300b9ce9bf3038a27a81623'],51,41,92,1161826,2,1,1,0,2505
d2b08cdb1d6864bf5bb5228b6fd0a592d9dc19f2,0,Sean R. Owen,2012-02-07 20:18:45+00:00,['118c25493d2073057b0617a9efb8aa42d52da97d'],8,12,20,1161846,1,,,,2505
e881d555d40fbbe03ab25051c283715fce537fb5,0,Sean R. Owen,2012-02-07 20:20:18+00:00,['d2b08cdb1d6864bf5bb5228b6fd0a592d9dc19f2'],0,1,1,1161847,1,,,,2505
b5c65a5441eed37d532bdcd007957ed7c2e80db0,0,Sean R. Owen,2012-02-07 20:25:04+00:00,['e881d555d40fbbe03ab25051c283715fce537fb5'],5,17,22,1161869,1,0.428571429,1,0.428571429,2505
da7c5b68f0777b70ed305df3f8adb0ad107dfe76,0,Sean R. Owen,2012-02-07 20:52:51+00:00,['b5c65a5441eed37d532bdcd007957ed7c2e80db0'],2,2,4,1161873,2,,,,2505
1de8cec0ace0a8026f8c7b4e9fd8961d7496b2ca,1,Sean R. Owen,2012-02-07 21:52:02+00:00,['da7c5b68f0777b70ed305df3f8adb0ad107dfe76'],88,86,174,1162047,44,0,0.555555556,0,2505
3f2d65a4708c3d457cbdd9c4974afb90c2f2abbf,0,Sean R. Owen,2012-02-07 21:52:56+00:00,['1de8cec0ace0a8026f8c7b4e9fd8961d7496b2ca'],20,24,44,1162091,1,0,0,1,2505
7c2b66444177812e26572e6d66a70e29a2855fa9,1,Sean R. Owen,2012-02-08 17:18:47+00:00,['3f2d65a4708c3d457cbdd9c4974afb90c2f2abbf'],86,264,350,1162441,46,0,0,0.642045455,2505
c94a7d005e938476736f96e652be2b536fa61e5f,0,Sean R. Owen,2012-02-08 17:20:09+00:00,['7c2b66444177812e26572e6d66a70e29a2855fa9'],1,4,5,1162446,1,0,1,1,2505
22dc9fe1e12db6e672e00fc885fae24309938423,0,Sean R. Owen,2012-02-09 13:57:13+00:00,['c94a7d005e938476736f96e652be2b536fa61e5f'],115,114,229,1162675,1,0,1,0.714285714,2505
522dfbb7699cecc24babcad3394935cfb21f3a15,0,Sean R. Owen,2012-02-09 14:06:02+00:00,['22dc9fe1e12db6e672e00fc885fae24309938423'],1,1,2,1162677,1,1,0,0,2505
2343aee681db7e70e5b7568dc809eaf39e820889,0,Sean R. Owen,2012-02-09 14:08:58+00:00,['522dfbb7699cecc24babcad3394935cfb21f3a15'],0,3,3,1162680,1,0,0,1,2505
b9a9f9415a02bd2bb2aa5ca6aa1d4aead4290f89,0,Jeff Eastman,2012-02-10 03:12:46+00:00,['2343aee681db7e70e5b7568dc809eaf39e820889'],2,2,4,1162684,2,,,,2505
2153bb95b1dcd1ada274c99bdf1a5a049f7aa3f8,1,Jeff Eastman,2012-02-12 18:44:23+00:00,['b9a9f9415a02bd2bb2aa5ca6aa1d4aead4290f89'],253,253,506,1163190,5,0,0,1,2506
529b114bde729951ffe22bd3845dbe19dfdd45df,0,Jeff Eastman,2012-02-12 19:03:59+00:00,['2153bb95b1dcd1ada274c99bdf1a5a049f7aa3f8'],81,101,182,1163372,5,,,,2506
a28cf1dc0d4191ccd4b4798a2cdb27348a3d96dd,0,Jeff Eastman,2012-02-12 20:54:26+00:00,['529b114bde729951ffe22bd3845dbe19dfdd45df'],4,161,165,1163537,7,0.950819672,1,0.950819672,2507
1ac30a4af120f511c04461f5fbef6984d4cfa806,1,Jeff Eastman,2012-02-13 01:03:17+00:00,['a28cf1dc0d4191ccd4b4798a2cdb27348a3d96dd'],627,599,1226,1164763,35,0.810344828,0,0.137931034,2507
f4fbdbbc5040f0f5802a093fa7662b2e9bd95c16,0,Jeff Eastman,2012-02-13 01:05:46+00:00,['1ac30a4af120f511c04461f5fbef6984d4cfa806'],38,38,76,1164839,7,,,,2507
6db7f6287a5720ea3dca07c1c89da4568bb4e84e,1,Grant Ingersoll,2012-02-13 15:14:18+00:00,['f4fbdbbc5040f0f5802a093fa7662b2e9bd95c16'],446,577,1023,1165862,30,0.223880597,0,0.776119403,2507
03a94924b8c788f1b3e97114fa4d5b1167157bae,1,Grant Ingersoll,2012-02-13 15:14:42+00:00,['6db7f6287a5720ea3dca07c1c89da4568bb4e84e'],62,69,131,1165993,15,0.571428571,0.571428571,0,2507
6a3f566d3d7661d6a78e92996d0d58f45d12eda6,1,Jeff Eastman,2012-02-14 19:47:43+00:00,['03a94924b8c788f1b3e97114fa4d5b1167157bae'],12,632,644,1166637,7,0.655913978,1,0.774193548,2511
8843678330bf7f80c8ef11344fdeb2b25d37a71c,0,Grant Ingersoll,2012-02-15 15:54:54+00:00,['6a3f566d3d7661d6a78e92996d0d58f45d12eda6'],4,10,14,1166651,2,,,,2511
dd2b1986a41c8d4423bba93064c47739be1f96b5,1,Sean R. Owen,2012-02-17 15:34:17+00:00,['8843678330bf7f80c8ef11344fdeb2b25d37a71c'],1,662,663,1167314,3,0.634969325,0.828220859,0.981595092,2513
175701cb6261ef2f5eab9878d92ba10baec32496,1,Dmitriy Lyubimov,2012-02-22 21:57:27+00:00,['dd2b1986a41c8d4423bba93064c47739be1f96b5'],1008,1599,2607,1169921,20,0.280851064,1,0.693617021,2516
76e80dceb487cc9105b3e993bc9fadd65701fbb8,1,Jeff Eastman,2012-02-22 22:45:59+00:00,['175701cb6261ef2f5eab9878d92ba10baec32496'],203,469,672,1170593,16,1,1,1,2518
457db943e6833e90db1d800fc7ed51f59d479e58,0,Jeff Eastman,2012-02-23 02:48:03+00:00,['76e80dceb487cc9105b3e993bc9fadd65701fbb8'],255,258,513,1171106,6,1,0,0.666666667,2518
8d102ea2cea0e43c91e867362ec842fbc286fb26,1,Jeff Eastman,2012-02-25 22:40:26+00:00,['457db943e6833e90db1d800fc7ed51f59d479e58'],56,87,143,1171249,41,,,,2518
8953d93be40143d0ff51481231ce087564086eff,0,Jeff Eastman,2012-02-25 22:42:14+00:00,['8d102ea2cea0e43c91e867362ec842fbc286fb26'],18,18,36,1171285,16,,,,2518
98f66f4f1c2e2b994613177fe05fa130a09423aa,1,pranjan,2012-02-26 17:02:20+00:00,['8953d93be40143d0ff51481231ce087564086eff'],64,138,202,1171487,2,0.828571429,1,0.357142857,2518
1371326369e3ca9b019251a19a1e91a97dcb5411,1,pranjan,2012-02-28 04:00:09+00:00,['98f66f4f1c2e2b994613177fe05fa130a09423aa'],47,125,172,1171659,4,0.379310345,1,0.413793103,2518
1627c7d181b83855271d88fcff520f02e5ebf7e2,0,tcp,2012-03-01 00:24:07+00:00,['1371326369e3ca9b019251a19a1e91a97dcb5411'],2,15,17,1171676,1,0,0,1,2518
61bfaaa9a96f3f4512d0bce375b1219b6b3de91e,0,tcp,2012-03-01 06:01:06+00:00,['1627c7d181b83855271d88fcff520f02e5ebf7e2'],112,0,112,1171788,15,0.9375,0.8625,0,2518
eeaf4a83a056a5dd5fddf5d3ca0745e2be1155ba,0,Sean R. Owen,2012-03-02 12:09:11+00:00,['61bfaaa9a96f3f4512d0bce375b1219b6b3de91e'],1,1,2,1171790,1,,,,2518
63f3118f8aa2e21bb030d209e706f03046ed9a1e,0,tcp,2012-03-02 19:46:17+00:00,['eeaf4a83a056a5dd5fddf5d3ca0745e2be1155ba'],33,21,54,1171844,6,1,0.333333333,1,2518
cff65e7cb900ddb5bdf6a88b304020f086da7ee8,0,tcp,2012-03-05 23:57:43+00:00,['63f3118f8aa2e21bb030d209e706f03046ed9a1e'],123,84,207,1172051,12,1,1,0,2518
a93745846d1fb5b41af5f1e33810cefb9f0806f7,0,pranjan,2012-03-08 14:24:18+00:00,['cff65e7cb900ddb5bdf6a88b304020f086da7ee8'],297,17,314,1172365,4,0.801075269,0.102150538,0.397849462,2518
d364748c74d1dda33c413cc7f3f3f86943d77696,0,pranjan,2012-03-08 14:31:39+00:00,['a93745846d1fb5b41af5f1e33810cefb9f0806f7'],3,3,6,1172371,1,,,,2518
3eba6f26486dcb9e2ec03702b60a38de399e738f,1,Jeff Eastman,2012-03-08 22:27:28+00:00,['d364748c74d1dda33c413cc7f3f3f86943d77696'],242,287,529,1172900,18,0,0,0.541666667,2519
f99a18f07f743bdde96cc08140715b6bc3312abf,1,pranjan,2012-03-10 14:00:52+00:00,['3eba6f26486dcb9e2ec03702b60a38de399e738f'],41,123,164,1173064,13,0,0.916666667,1,2519
90987ff6c7efd130938266d8beb8fed7c61cdc6b,1,tcp,2012-03-12 18:25:45+00:00,['f99a18f07f743bdde96cc08140715b6bc3312abf'],354,478,832,1173896,15,0.02,0.27,0.5,2519
26a6b243d0eb79680521536746687801efdc6628,1,tcp,2012-03-13 15:38:33+00:00,['90987ff6c7efd130938266d8beb8fed7c61cdc6b'],1,3,4,1173900,1,1,1,1,2519
ba81a9322c8006217df919e89e212e7723cbb9a2,1,pranjan,2012-03-16 17:10:29+00:00,['26a6b243d0eb79680521536746687801efdc6628'],549,175,724,1174624,16,0.432432432,0,1,2519
dfbcfb18efe7f9371bb754dfcc12917f191e88b7,1,pranjan,2012-03-16 21:07:22+00:00,['ba81a9322c8006217df919e89e212e7723cbb9a2'],10,14,24,1174648,2,0,0.75,1,2519
2cfaf19221b07b57b0b42d9e843a2e464c0ead21,1,pranjan,2012-03-17 07:34:31+00:00,['dfbcfb18efe7f9371bb754dfcc12917f191e88b7'],30,53,83,1174731,9,0,0.25,0.75,2519
73ff886ec2fdb7598d69a930f1308ed5321e6ce5,0,pranjan,2012-03-18 09:09:57+00:00,['2cfaf19221b07b57b0b42d9e843a2e464c0ead21'],3,3,6,1174737,1,,,,2519
68826d977fb5bd94cd93382019c149030e696360,0,pranjan,2012-03-21 05:01:32+00:00,['73ff886ec2fdb7598d69a930f1308ed5321e6ce5'],6,8,14,1174751,1,1,1,1,2519
51f58b8b5a066d0afabc850c19fae21b9f24ca95,1,pranjan,2012-03-23 17:09:35+00:00,['68826d977fb5bd94cd93382019c149030e696360'],217,333,550,1175301,35,0,0.4,0.413333333,2519
bf2df6e86e2ed7efdd631adc8d347ff409a411a4,1,pranjan,2012-03-31 13:28:31+00:00,['51f58b8b5a066d0afabc850c19fae21b9f24ca95'],77,46,123,1175424,1,0.935483871,0,0.612903226,2519
fd355fe7b249b552160eba3ce72aee3a09ee08e8,1,pranjan,2012-03-31 17:30:10+00:00,['bf2df6e86e2ed7efdd631adc8d347ff409a411a4'],293,30,323,1175747,6,0.960893855,0.541899441,0.374301676,2519
1b7d47acd8392ca5ac632a8ff6d331ac27301160,1,pranjan,2012-04-01 05:51:44+00:00,['fd355fe7b249b552160eba3ce72aee3a09ee08e8'],1839,68,1907,1177654,14,0.712163417,0.439182916,0.493036212,2519
d6b1b5f518b55c045258e36bfbeeaeaf079eb456,0,Sean R. Owen,2012-04-06 12:41:15+00:00,['1b7d47acd8392ca5ac632a8ff6d331ac27301160'],1,1,2,1177656,1,,,,2519
eccd384b0ed93fe51ba4d52b70f6a701c4bad50a,1,Sean R. Owen,2012-04-06 14:44:05+00:00,['d6b1b5f518b55c045258e36bfbeeaeaf079eb456'],2,3,5,1177661,1,0,0,1,2519
4df72fbac47d88ce3d66bf9a67f7e88276500a1a,0,Sean R. Owen,2012-04-06 14:44:27+00:00,['eccd384b0ed93fe51ba4d52b70f6a701c4bad50a'],47,70,117,1177778,3,1,1,0,2519
9ebd317942cdfd90395785a3cad7b2f571f9bf63,0,pranjan,2012-04-10 19:00:41+00:00,['4df72fbac47d88ce3d66bf9a67f7e88276500a1a'],11,20,31,1177809,2,0,1,0,2519
3f1b344c77fec2124ca7eb32748f4da7fa32f9ff,0,Jeff Eastman,2012-04-18 17:12:02+00:00,['9ebd317942cdfd90395785a3cad7b2f571f9bf63'],228,826,1054,1178863,1,,,,2519
6b390e785eacbd91dd53ca71a10fafd410c93e93,0,Jeff Eastman,2012-04-18 17:12:44+00:00,['3f1b344c77fec2124ca7eb32748f4da7fa32f9ff'],13,10,23,1178886,1,,,,2519
9d08db8b658fef04eadf3eae6669d9b45269640b,0,Sean R. Owen,2012-04-25 16:48:07+00:00,['6b390e785eacbd91dd53ca71a10fafd410c93e93'],1,3,4,1178890,1,0,1,0,2519
e1b128959e1109a067399cc5670d75393f858ecc,0,Sebastian Schelter,2012-04-27 15:31:58+00:00,['9d08db8b658fef04eadf3eae6669d9b45269640b'],0,395,395,1179285,1,0.503759398,0.954887218,0.898496241,2520
21cdb526fae3897af5fb74f5d1af2b2af5ca3be2,0,Sean R. Owen,2012-05-02 07:28:23+00:00,['e1b128959e1109a067399cc5670d75393f858ecc'],0,9,9,1179294,1,1,1,1,2520
137423f4e5f0d822cd44615125a87f836429923c,1,tcp,2012-05-02 18:55:47+00:00,['21cdb526fae3897af5fb74f5d1af2b2af5ca3be2'],13,22,35,1179329,2,,,,2520
9c7a9e7488555d27bd7f6a0bebb4021671b1842f,1,Ted Dunning,2012-05-03 22:36:49+00:00,['137423f4e5f0d822cd44615125a87f836429923c'],1025,1010,2035,1181364,5,0.828571429,0.585714286,0,2522
2fd2aed8702c9bd4490978f9c0eee2f27ba66958,1,Ted Dunning,2012-05-05 23:01:29+00:00,['9c7a9e7488555d27bd7f6a0bebb4021671b1842f'],3,18,21,1181385,2,1,1,1,2522
f514c8294e6a61d8b1a345738d3870919f888e78,1,Ted Dunning,2012-05-06 07:53:50+00:00,['2fd2aed8702c9bd4490978f9c0eee2f27ba66958'],30,34,64,1181449,1,0.5,0.5,0.5,2522
298eef9ddff628a9ce6b4d2c77644f7166cec9cd,0,Sebastian Schelter,2012-05-07 14:16:37+00:00,['f514c8294e6a61d8b1a345738d3870919f888e78'],0,11,11,1181460,1,0,0,1,2522
3bf7a1c54816fb5c055d897389ba0c37a66404ed,1,Sebastian Schelter,2012-05-08 20:07:05+00:00,['298eef9ddff628a9ce6b4d2c77644f7166cec9cd'],2,68,70,1181530,3,0.857142857,0.857142857,1,2522
f60ceca58810052e30842d25305941c1bb9c9dc1,0,Sebastian Schelter,2012-05-08 20:16:30+00:00,['3bf7a1c54816fb5c055d897389ba0c37a66404ed'],4,0,4,1181534,2,,,,2522
590ffede5cf8cac72c6c278b09a270bf99c13c25,1,Jeff Eastman,2012-05-09 22:02:50+00:00,['f60ceca58810052e30842d25305941c1bb9c9dc1'],1727,408,2135,1183669,29,0.528104575,0,0.436601307,2522
4aa9091ce6f5e06b4a9c21af682ab82579d203b2,0,Sean R. Owen,2012-05-10 19:43:48+00:00,['590ffede5cf8cac72c6c278b09a270bf99c13c25'],2,2,4,1183673,1,,,,2522
d994ab807a6a08965be959d17b9ae3157fb75971,0,Sebastian Schelter,2012-05-10 21:19:44+00:00,['4aa9091ce6f5e06b4a9c21af682ab82579d203b2'],915,0,915,1184588,7,0.841584158,0.128712871,0.113861386,2522
b06077a7217548e3c3a7c5748dc03bf9e52015b6,0,Sebastian Schelter,2012-05-11 08:58:55+00:00,['d994ab807a6a08965be959d17b9ae3157fb75971'],6543,5,6548,1191136,66,0.769121309,0.395588758,0.390252579,2522
9bbc7a0c10f43a77e0b7459f1c15c4ce7addc184,0,Sebastian Schelter,2012-05-11 11:13:24+00:00,['b06077a7217548e3c3a7c5748dc03bf9e52015b6'],6,10,16,1191152,5,0.5,1,0.75,2522
0a80b544349320c89b495fc2f78588297359d929,0,Sebastian Schelter,2012-05-12 21:50:01+00:00,['9bbc7a0c10f43a77e0b7459f1c15c4ce7addc184'],6901,13,6914,1198066,66,0.43234714,0.084418146,0.198816568,2522
26cee84a0b90ce98b7b9a540018c3ba017289595,0,Sebastian Schelter,2012-05-12 21:52:48+00:00,['0a80b544349320c89b495fc2f78588297359d929'],0,0,0,1198066,0,,,,2522
5257bc9d294a28c83e6b50e70d1ef2026976e43f,0,Robin Anil,2012-05-13 18:36:21+00:00,['26cee84a0b90ce98b7b9a540018c3ba017289595'],33,39,72,1198138,4,,,,2522
9a15cb8d2e13b44f88b45428c37bbd6bb14eabcc,1,Robin Anil,2012-05-13 21:55:26+00:00,['5257bc9d294a28c83e6b50e70d1ef2026976e43f'],0,1111,1111,1199249,7,0.155844156,0.519480519,0.756957328,2529
39b8c2d006a2df6c1e919d883a4d220148908cec,1,Robin Anil,2012-05-13 22:12:08+00:00,['9a15cb8d2e13b44f88b45428c37bbd6bb14eabcc'],6,14,20,1199269,4,,,,2529
8dd6dba6dfac61d8e74859827cdfd564bdb0b27a,0,Robin Anil,2012-05-13 22:27:32+00:00,['39b8c2d006a2df6c1e919d883a4d220148908cec'],70,1,71,1199340,5,,,,2529
1526c5b9e465aaae38b90eae7e208cf41e5bd2b4,0,Robin Anil,2012-05-13 22:55:08+00:00,['8dd6dba6dfac61d8e74859827cdfd564bdb0b27a'],143,342,485,1199825,9,0,1,1,2531
e64dd36ec79d1c22a6161078f5363cfb5f89ff91,0,tcp,2012-05-15 01:58:58+00:00,['1526c5b9e465aaae38b90eae7e208cf41e5bd2b4'],420,420,840,1200665,87,,,,2531
44459bda14b550d8929728294bc9af412aa41852,1,tcp,2012-05-15 03:47:39+00:00,['e64dd36ec79d1c22a6161078f5363cfb5f89ff91'],558,554,1112,1201777,42,,,,2531
d8d721acc0b4616b688bbe56b5fe5ae96dda407d,1,Robin Anil,2012-05-15 16:08:52+00:00,['44459bda14b550d8929728294bc9af412aa41852'],377,246,623,1202400,18,1,0,0,2531
0d7555556bcc4a9a5aef16340e09df54bd1e8658,0,Sean R. Owen,2012-05-16 10:36:30+00:00,['d8d721acc0b4616b688bbe56b5fe5ae96dda407d'],2,2,4,1202404,1,,,,2531
35fa73f05fa65905e4b9e26f8fdbea51d2e945f4,1,Ted Dunning,2012-05-16 11:29:08+00:00,['0d7555556bcc4a9a5aef16340e09df54bd1e8658'],6692,7399,14091,1216495,55,0,0.118508655,0,2554
8fa659d3db512a0f0db1af065d9445f093c8ec85,0,Ted Dunning,2012-05-16 22:37:52+00:00,['35fa73f05fa65905e4b9e26f8fdbea51d2e945f4'],13,1,14,1216509,2,,,,2554
d63c631e347e63afc8a19c88f912e0b094b3b7af,0,Sean R. Owen,2012-05-22 09:09:56+00:00,['8fa659d3db512a0f0db1af065d9445f093c8ec85'],3,15,18,1216527,2,0.9,1,1,2554
ff886ecec5048a030708c5b3a99b2a4401e8b8d2,0,Jeff Eastman,2012-05-23 14:33:04+00:00,['d63c631e347e63afc8a19c88f912e0b094b3b7af'],1,1,2,1216529,1,,,,2554
3f09bcd423a4216f6a7e6ee8ff478028864530d6,0,Jeff Eastman,2012-05-23 18:07:50+00:00,['ff886ecec5048a030708c5b3a99b2a4401e8b8d2'],33,15,48,1216577,1,1,1,0,2554
bd7f364c9ad10bdec910aff5c8bb7865e45c3676,1,Grant Ingersoll,2012-05-31 16:04:06+00:00,['3f09bcd423a4216f6a7e6ee8ff478028864530d6'],0,18,18,1216595,1,1,1,1,2554
50b4637a387f54729144bb38699df672aa76e8f1,1,Jeff Eastman,2012-06-01 14:48:23+00:00,['bd7f364c9ad10bdec910aff5c8bb7865e45c3676'],175,117,292,1216887,1,1,0,0.172413793,2554
73c5336bc755373b6edc51d41abd2b6453b3da11,1,Jeff Eastman,2012-06-01 16:22:10+00:00,['50b4637a387f54729144bb38699df672aa76e8f1'],159,96,255,1217142,1,1,0,0.169491525,2554
2e681c461c685c23e13ad7ada0eba5a9136c29a2,0,Jeff Eastman,2012-06-01 20:13:51+00:00,['73c5336bc755373b6edc51d41abd2b6453b3da11'],18,32,50,1217192,3,0.75,0.75,0,2554
e69bcbd022f59e1ec0fb6cec5fea0a742c761cf3,0,Jeff Eastman,2012-06-01 22:19:54+00:00,['2e681c461c685c23e13ad7ada0eba5a9136c29a2'],114,81,195,1217387,3,0.885714286,0,0.628571429,2554
03fca8714727e38b8efa2ea8e5320c170e11bfcf,0,Grant Ingersoll,2012-06-03 17:33:41+00:00,['e69bcbd022f59e1ec0fb6cec5fea0a742c761cf3'],1,1,2,1217389,1,,,,2554
a344c6be5962fae2f762b6a487065fbd06673e25,1,Robin Anil,2012-06-03 18:34:59+00:00,['03fca8714727e38b8efa2ea8e5320c170e11bfcf'],9,9,18,1217407,9,0,0,0,2554
bb10835b8e092fbf709ccd8c55edbd078cbd5491,0,Sebastian Schelter,2012-06-03 18:39:43+00:00,['a344c6be5962fae2f762b6a487065fbd06673e25'],1526,41,1567,1218974,14,0.74153074,0.184441656,0.469259724,2554
cd02e8bd4ed8d7425eedfe37f42fa23a605f6dbd,0,Robin Anil,2012-06-03 20:32:43+00:00,['bb10835b8e092fbf709ccd8c55edbd078cbd5491'],1,12,13,1218987,2,0.3,0.3,1,2554
1bdf3ab8af012cb3248384073f99c1dc69f7e97f,1,Robin Anil,2012-06-04 00:04:20+00:00,['cd02e8bd4ed8d7425eedfe37f42fa23a605f6dbd'],14,64,78,1219065,7,,,,2554
9a0617dd700bc428746d9ac447f6dacfea0074dd,0,Robin Anil,2012-06-04 00:15:59+00:00,['1bdf3ab8af012cb3248384073f99c1dc69f7e97f'],3,5,8,1219073,1,,,,2554
2ab5e922cf165b77a8304d9c86feb16a32baa9ac,1,Robin Anil,2012-06-04 01:39:29+00:00,['9a0617dd700bc428746d9ac447f6dacfea0074dd'],11,18,29,1219102,2,,,,2554
d94eb39fa85641da388646a5d9e8d340910f7b8d,1,Robin Anil,2012-06-04 03:42:31+00:00,['2ab5e922cf165b77a8304d9c86feb16a32baa9ac'],53,76,129,1219231,11,1,1,0,2554
cfd85f859c73b3c7899a9337bd4aeab5e1281eb7,0,Sebastian Schelter,2012-06-04 14:20:49+00:00,['d94eb39fa85641da388646a5d9e8d340910f7b8d'],1,1,2,1219233,1,,,,2554
69ea83dade036e74d5d0c40e3f060ba3ac4ad9bd,1,Robin Anil,2012-06-04 15:54:18+00:00,['cfd85f859c73b3c7899a9337bd4aeab5e1281eb7'],8,5,13,1219246,2,,,,2554
b758f8d8f3c9d7db89add438eff1a5f599cf826d,1,Robin Anil,2012-06-04 16:40:20+00:00,['69ea83dade036e74d5d0c40e3f060ba3ac4ad9bd'],3,4,7,1219253,1,,,,2554
79b654d49d19ef3463152864e0485b9f500e8ed4,1,Sebastian Schelter,2012-06-05 04:30:42+00:00,['b758f8d8f3c9d7db89add438eff1a5f599cf826d'],19,21,40,1219293,1,,,,2554
3beecc0e8e48909ab17f70022adf7ee878bbe696,1,Robin Anil,2012-06-05 12:11:21+00:00,['79b654d49d19ef3463152864e0485b9f500e8ed4'],25,16,41,1219334,7,0,0,0,2554
f4d9a5b22e7fac290b74717a1f78c908f211d0c4,0,Robin Anil,2012-06-05 12:50:23+00:00,['3beecc0e8e48909ab17f70022adf7ee878bbe696'],6,1,7,1219341,2,,,,2554
5b94d3fbb16d73a0e88dfd7ab04b79ff33bbba24,0,Sean R. Owen,2012-06-05 19:22:15+00:00,['f4d9a5b22e7fac290b74717a1f78c908f211d0c4'],12,32,44,1219385,1,0,0,0,2554
36e198142d8e876b622f0563c8176066185b8ecf,0,Sean R. Owen,2012-06-05 19:24:50+00:00,['5b94d3fbb16d73a0e88dfd7ab04b79ff33bbba24'],686,0,686,1220071,6,0.327645051,0.109215017,0.040955631,2554
6d0a451f7068cfacd9384d6e50908b4c01dad7e3,1,Robin Anil,2012-06-06 13:28:26+00:00,['36e198142d8e876b622f0563c8176066185b8ecf'],4,13,17,1220088,2,,,,2554
7c8c27eeb83e065740a49b4551c01d7100b90344,0,Robin Anil,2012-06-06 14:32:48+00:00,['6d0a451f7068cfacd9384d6e50908b4c01dad7e3'],28,5,33,1220121,2,,,,2554
d521b72eec4964d547922e357ad77f2b4fc1f06e,1,Jeff Eastman,2012-06-06 16:55:14+00:00,['7c8c27eeb83e065740a49b4551c01d7100b90344'],12,27,39,1220160,2,0.111111111,1,1,2554
d0b12880eb7e7dc965e5cb174f8311a2de4a54f1,1,pranjan,2012-06-06 16:56:14+00:00,['d521b72eec4964d547922e357ad77f2b4fc1f06e'],0,58,58,1220218,1,,,,2554
f467a7b4e23c950e1f60a10eb122bce170c44aec,0,Jeff Eastman,2012-06-06 17:24:47+00:00,['d0b12880eb7e7dc965e5cb174f8311a2de4a54f1'],0,10,10,1220228,1,0,1,0.5,2554
eec57e4ff74eff067b2ac4093a93c008b5287af9,0,Robin Anil,2012-06-07 03:14:37+00:00,['f467a7b4e23c950e1f60a10eb122bce170c44aec'],1,1,2,1220230,1,,,,2554
9e154d923ee0f8801edac9e8a9df6f6f824958a0,1,Robin Anil,2012-06-07 04:50:16+00:00,['eec57e4ff74eff067b2ac4093a93c008b5287af9'],1,1,2,1220232,1,,,,2554
86b1196bb540df26fcb03ae5c03904779924face,1,Robin Anil,2012-06-08 13:55:57+00:00,['9e154d923ee0f8801edac9e8a9df6f6f824958a0'],147,161,308,1220540,3,0.166666667,0.5,1,2554
ee910dfbfbeee2bcff9afd83f0bdcf4c9356e08b,0,pranjan,2012-06-08 16:15:01+00:00,['86b1196bb540df26fcb03ae5c03904779924face'],14,12,26,1220566,7,,,,2554
1f59d8ea289ffb8290e39f5b3fe2fec42e0a2591,0,Robin Anil,2012-06-08 16:22:57+00:00,['ee910dfbfbeee2bcff9afd83f0bdcf4c9356e08b'],1,0,1,1220567,1,,,,2554
caacd5c28d435d5ed45617ad3fc18623d3e2a318,0,pranjan,2012-06-08 16:25:53+00:00,['1f59d8ea289ffb8290e39f5b3fe2fec42e0a2591'],12,14,26,1220593,7,,,,2554
abb4fe4c8c949fc310f086f4397fe0645d67ba29,0,pranjan,2012-06-08 17:29:54+00:00,['caacd5c28d435d5ed45617ad3fc18623d3e2a318'],14,12,26,1220619,7,,,,2554
159174ebfbeede79b9bcef3e1c3ade5aac24d6c1,0,pranjan,2012-06-08 17:30:45+00:00,['abb4fe4c8c949fc310f086f4397fe0645d67ba29'],11,11,22,1220641,7,,,,2554
a320da91873e98640378fd0afbf811d820526087,0,pranjan,2012-06-08 18:30:24+00:00,['159174ebfbeede79b9bcef3e1c3ade5aac24d6c1'],9,11,20,1220661,7,,,,2554
f692f7d69577ce6bb2e7e045c0ce9c3d72c76dd8,0,pranjan,2012-06-08 20:01:07+00:00,['a320da91873e98640378fd0afbf811d820526087'],14,12,26,1220687,7,,,,2554
256c7a70a19243c6304c972a8a0c81463d798a56,0,pranjan,2012-06-08 20:02:04+00:00,['f692f7d69577ce6bb2e7e045c0ce9c3d72c76dd8'],11,11,22,1220709,7,,,,2554
cb7e6cd5b4581c26a93edaa71fba54b35f11e79d,0,pranjan,2012-06-08 20:42:03+00:00,['256c7a70a19243c6304c972a8a0c81463d798a56'],9,11,20,1220729,7,,,,2554
b8c11c6c9ce4777ace544427ef9685ce9c56864d,1,pranjan,2012-06-08 20:52:25+00:00,['cb7e6cd5b4581c26a93edaa71fba54b35f11e79d'],14,12,26,1220755,7,,,,2554
0596971048899c0243370e20104d12d24675a39f,0,pranjan,2012-06-08 20:53:18+00:00,['b8c11c6c9ce4777ace544427ef9685ce9c56864d'],11,11,22,1220777,7,,,,2554
9d083f17b6a4fa099dac6783c5de500539ccaa85,1,Jeff Eastman,2012-06-09 19:54:34+00:00,['0596971048899c0243370e20104d12d24675a39f'],18,16,34,1220811,1,0,0,1,2554
44bf39a9f02ac39589f4cdf542117336da43b03d,0,Jeff Eastman,2012-06-09 20:03:10+00:00,['9d083f17b6a4fa099dac6783c5de500539ccaa85'],7,8,15,1220826,1,0,0,1,2554
214b3292a9975c7a1bf635e99e84c00290c47c47,1,Jeff Eastman,2012-06-09 20:07:16+00:00,['44bf39a9f02ac39589f4cdf542117336da43b03d'],3,3,6,1220832,2,,,,2554
90cd33ae5be980c60ffd7b37b108c238f4397e98,0,Jeff Eastman,2012-06-09 20:54:35+00:00,['214b3292a9975c7a1bf635e99e84c00290c47c47'],17,19,36,1220868,3,0.5,0,0.5,2554
87eed5bd06efdac96fa99883d37985e2dae1779f,0,Jeff Eastman,2012-06-09 21:11:51+00:00,['90cd33ae5be980c60ffd7b37b108c238f4397e98'],2,2,4,1220872,1,,,,2554
a4740550cbfe6d1ceac08c011f095ade423800fc,1,Robin Anil,2012-06-09 22:54:02+00:00,['87eed5bd06efdac96fa99883d37985e2dae1779f'],8,8,16,1220888,1,,,,2554
e5cbfb226d808dc51ebe419524c494171c42e34a,0,Andrew L. Farris,2012-06-11 02:13:22+00:00,['a4740550cbfe6d1ceac08c011f095ade423800fc'],8,0,8,1220896,1,,,,2554
a99ce3c8370e029bd5df4b6d2a7bbe9e2f01a607,1,Jeff Eastman,2012-06-11 21:13:13+00:00,['e5cbfb226d808dc51ebe419524c494171c42e34a'],233,151,384,1221280,8,1,0,0.854545455,2554
25c5e7aae291e5463178ec5a6d76e29a8859bc39,0,pranjan,2012-06-12 06:35:24+00:00,['a99ce3c8370e029bd5df4b6d2a7bbe9e2f01a607'],8,8,16,1221296,7,,,,2554
1ac5f1af46bfd48b29d97f3663d0328f6d890b5d,0,pranjan,2012-06-12 07:48:54+00:00,['25c5e7aae291e5463178ec5a6d76e29a8859bc39'],11,11,22,1221318,7,,,,2554
4c112817b845cdae6a1967a0680d5f7aa4c3b75e,0,pranjan,2012-06-12 07:49:51+00:00,['1ac5f1af46bfd48b29d97f3663d0328f6d890b5d'],11,11,22,1221340,7,,,,2554
010f8ebf35a322604d6497e175a1fe20924a991d,0,pranjan,2012-06-12 08:13:13+00:00,['4c112817b845cdae6a1967a0680d5f7aa4c3b75e'],8,8,16,1221356,7,,,,2554
9be3b158c5341d4cca33ada6ce1155e7ca5b25f3,0,pranjan,2012-06-12 08:29:20+00:00,['010f8ebf35a322604d6497e175a1fe20924a991d'],11,11,22,1221378,7,,,,2554
c4bd519bb4daacd73d6a856ed8588d98a39363e3,0,pranjan,2012-06-12 08:30:13+00:00,['9be3b158c5341d4cca33ada6ce1155e7ca5b25f3'],11,11,22,1221400,7,,,,2554
229aeff334882293c915b27e40a4864878a644b9,1,Sean R. Owen,2012-06-20 12:07:50+00:00,['c4bd519bb4daacd73d6a856ed8588d98a39363e3'],2125,1976,4101,1225501,222,0.52173913,1,0.565217391,2554
0f5531490c8c05de53788acf1a527d461b0484f7,1,Sebastian Schelter,2012-06-22 08:19:10+00:00,['229aeff334882293c915b27e40a4864878a644b9'],6,16,22,1225523,1,0,1,1,2554
c6df97ba6352e56bb1d5a431c1eafb64366ed634,1,Sean R. Owen,2012-06-22 09:38:37+00:00,['0f5531490c8c05de53788acf1a527d461b0484f7'],19,4,23,1225546,2,0,0,0,2554
b285e2d2b39b64b7f5e4c43a919ffad398af0b29,1,Sebastian Schelter,2012-06-22 10:42:56+00:00,['c6df97ba6352e56bb1d5a431c1eafb64366ed634'],1,56,57,1225603,2,1,1,1,2555
1608f61a2092a021a28b37b1d06fbaedf8049a5a,1,Sean R. Owen,2012-06-22 10:42:57+00:00,['b285e2d2b39b64b7f5e4c43a919ffad398af0b29'],47,413,460,1226063,9,0.094017094,0.854700855,0.927350427,2557
2cd3ea39e3dc70f1ffcffae92cb0901894bed63b,0,Sean R. Owen,2012-06-22 10:47:18+00:00,['1608f61a2092a021a28b37b1d06fbaedf8049a5a'],1,1,2,1226065,1,,,,2557
c9a79471aa9b1c9ff8ce5f8695357e6dab91cd5b,1,Sean R. Owen,2012-06-22 11:58:13+00:00,['2cd3ea39e3dc70f1ffcffae92cb0901894bed63b'],18,40,58,1226123,3,0.6,0.6,1,2557
35e02588b398447ac1b70077ce529c55e53a2108,0,Sebastian Schelter,2012-06-29 19:21:09+00:00,['c9a79471aa9b1c9ff8ce5f8695357e6dab91cd5b'],1,3,4,1226127,1,0,1,1,2557
7d90a581ef2c1a6059ff06403c98069211b89cee,0,Sebastian Schelter,2012-06-29 21:51:42+00:00,['35e02588b398447ac1b70077ce529c55e53a2108'],5,6,11,1226138,2,,,,2557
a793d3a64edc544ffe5edcf3f7c164814c4f9a22,0,Sean R. Owen,2012-07-04 07:48:55+00:00,['7d90a581ef2c1a6059ff06403c98069211b89cee'],1,1,2,1226140,1,,,,2557
09ab62452c81d0423e957bc9e8ac9acb10651ac7,0,Sean R. Owen,2012-07-04 07:52:34+00:00,['a793d3a64edc544ffe5edcf3f7c164814c4f9a22'],1,1,2,1226142,1,,,,2557
0a0551eb06149e2919707237f678e4e9953c836e,1,Sean R. Owen,2012-07-10 14:49:26+00:00,['09ab62452c81d0423e957bc9e8ac9acb10651ac7'],41,103,144,1226286,7,,,,2557
c395a3b7e68748f88068e8c86ed81d71f77a650a,0,Sebastian Schelter,2012-07-10 15:16:47+00:00,['0a0551eb06149e2919707237f678e4e9953c836e'],17,26,43,1226329,4,0,0,0,2557
49a8268ded2d0b9da8866b7aa3676d7acbeae061,0,Sean R. Owen,2012-07-11 19:22:35+00:00,['c395a3b7e68748f88068e8c86ed81d71f77a650a'],2,1,3,1226332,1,,,,2557
f543a10d285c7cf97b5d845a938ec24e6feae88b,0,Sean R. Owen,2012-07-14 18:59:15+00:00,['49a8268ded2d0b9da8866b7aa3676d7acbeae061'],0,61,61,1226393,2,0.5,1,1,2557
1029bc039fa6b13e000efe9dbdff7800e04be2fc,1,Ted Dunning,2012-07-14 20:09:35+00:00,['f543a10d285c7cf97b5d845a938ec24e6feae88b'],5,14,19,1226412,2,1,1,1,2557
c4b3169a8de7716d9a2d48ddd0902eee3248dd2d,0,Sean R. Owen,2012-07-18 20:55:24+00:00,['1029bc039fa6b13e000efe9dbdff7800e04be2fc'],1,1,2,1226414,1,,,,2557
39a3539b81ad86b488f408eb5441e3328981a07f,1,Jacob Alexander Mannix,2012-07-29 03:50:07+00:00,['c4b3169a8de7716d9a2d48ddd0902eee3248dd2d'],2,2,4,1226418,1,,,,2557
22b0c3d3ca7fb07f5abf34aab6ad3449d5b69c7b,1,Jeff Eastman,2012-08-09 15:16:51+00:00,['39a3539b81ad86b488f408eb5441e3328981a07f'],285,385,670,1227088,5,0.340909091,1,1,2558
4300ff31500eab95d54fc6fff2eb5441b4585825,0,Jacob Alexander Mannix,2012-08-09 18:27:49+00:00,['22b0c3d3ca7fb07f5abf34aab6ad3449d5b69c7b'],7,25,32,1227120,1,0,0,1,2558
c831d30bee3604202f24bf7ba8ec31925a740304,0,Jeff Eastman,2012-08-09 18:57:37+00:00,['4300ff31500eab95d54fc6fff2eb5441b4585825'],159,0,159,1227279,3,0,0,0.126436782,2558
74f9303eeaaf278c507bbabc306c6341af5fc03a,1,Sebastian Schelter,2012-08-13 09:07:29+00:00,['c831d30bee3604202f24bf7ba8ec31925a740304'],16,155,171,1227450,2,0.441860465,0.860465116,0.720930233,2558
62eeeae391554793dac788c062588deb89ba7ed4,1,Sebastian Schelter,2012-08-13 23:06:07+00:00,['74f9303eeaaf278c507bbabc306c6341af5fc03a'],2,14,16,1227466,5,0.4,1,0.4,2558
ba4bd06db2d753d75b00613ade842f5c90f543e1,0,Jeff Eastman,2012-08-19 20:01:15+00:00,['62eeeae391554793dac788c062588deb89ba7ed4'],41,0,41,1227507,1,0,0,0,2558
e73d67ff0b96170fb61a66779a34142f6463d199,0,Sebastian Schelter,2012-08-26 07:59:12+00:00,['ba4bd06db2d753d75b00613ade842f5c90f543e1'],1,1,2,1227509,1,,,,2558
b293384f8641db47ce9103f492f5115fe15867f4,0,Sebastian Schelter,2012-08-29 12:23:14+00:00,['e73d67ff0b96170fb61a66779a34142f6463d199'],2,11,13,1227522,1,1,1,0,2558
0e291d4e8ad48763447c2cf3826b331392864a41,0,Sebastian Schelter,2012-08-29 18:26:21+00:00,['b293384f8641db47ce9103f492f5115fe15867f4'],0,24,24,1227546,1,1,1,1,2558
7dc7e095943c1e916da88b3f5d58e8b99d3d187a,1,Ted Dunning,2012-09-01 14:03:22+00:00,['0e291d4e8ad48763447c2cf3826b331392864a41'],1,10,11,1227557,3,0,0,1,2558
0fe5282a038e5e5c960912fb32569cd77c77bd75,0,Ted Dunning,2012-09-01 22:31:01+00:00,['7dc7e095943c1e916da88b3f5d58e8b99d3d187a'],1,24,25,1227582,1,0,1,1,2558
a07bfc3abfca6b81b4de537d921828e8728a3a77,1,Ted Dunning,2012-09-04 02:18:44+00:00,['0fe5282a038e5e5c960912fb32569cd77c77bd75'],0,2560,2560,1230142,26,0.599156118,0.770464135,0.93164557,2584
0b8db82fb99bdd664a1aabed17dc338e8bc3ebc6,0,Ted Dunning,2012-09-04 02:18:48+00:00,['a07bfc3abfca6b81b4de537d921828e8728a3a77'],150,149,299,1230441,4,,,,2584
3d4e6e2e0e2e2a1f8f73f7d83305ce738c5fb477,1,Ted Dunning,2012-09-04 02:18:51+00:00,['0b8db82fb99bdd664a1aabed17dc338e8bc3ebc6'],33,148,181,1230622,4,0.171428571,1,1,2585
0e847ae12d1bc62c9f8bdd16aa3a7ba942c622ac,0,Ted Dunning,2012-09-04 02:18:54+00:00,['3d4e6e2e0e2e2a1f8f73f7d83305ce738c5fb477'],179,179,358,1230980,1,,,,2585
aebdfaf6f87a8b89449ba0eb5020a60ee92ab22a,1,Ted Dunning,2012-09-04 02:18:58+00:00,['0e847ae12d1bc62c9f8bdd16aa3a7ba942c622ac'],47,252,299,1231279,6,0.018518519,0.953703704,0.962962963,2587
be028c7a1ba0e9af8c4a761ad9d89075efbad814,1,Ted Dunning,2012-09-04 02:19:00+00:00,['aebdfaf6f87a8b89449ba0eb5020a60ee92ab22a'],0,38,38,1231317,1,0.407407407,1,1,2587
ba3d406896bcb927bf9c5e05b4563d90444833c8,1,Ted Dunning,2012-09-04 02:31:49+00:00,['be028c7a1ba0e9af8c4a761ad9d89075efbad814'],0,1168,1168,1232485,1,,,,2588
5fc1b502dfd649c4c4112252309ef68f453c397a,1,Ted Dunning,2012-09-06 22:14:51+00:00,['ba3d406896bcb927bf9c5e05b4563d90444833c8'],0,484,484,1232969,1,0.458937198,0.888888889,0.917874396,2589
500d981c93dddbb5b9e28cdce02e47c120372273,0,Ted Dunning,2012-09-06 22:17:21+00:00,['5fc1b502dfd649c4c4112252309ef68f453c397a'],1,1,2,1232971,1,,,,2589
fab8d87d14361db02e37ea756e9b1640b2f74ba0,0,Sean R. Owen,2012-09-17 17:26:19+00:00,['500d981c93dddbb5b9e28cdce02e47c120372273'],1,8,9,1232980,1,0,0,1,2589
e9787eff04cfcfd6192b2412b7053efdc7f120bd,0,Sean R. Owen,2012-09-21 10:16:00+00:00,['fab8d87d14361db02e37ea756e9b1640b2f74ba0'],1,3,4,1232984,1,0,0,0,2589
478cad97b77c6bee4c9a53685a8d7a41b5d99f3c,1,Dmitriy Lyubimov,2012-09-28 00:20:13+00:00,['e9787eff04cfcfd6192b2412b7053efdc7f120bd'],34,200,234,1233218,5,0.066115702,0.338842975,0.933884298,2589
2424717bdb4309d9d6f84c264feecee09b8c52ef,1,Jeff Eastman,2012-09-29 05:05:34+00:00,['478cad97b77c6bee4c9a53685a8d7a41b5d99f3c'],10,13,23,1233241,3,1,1,1,2589
a8f16b8bf83b1bb049f5bd7a83c2d4e0c8b04925,0,Sebastian Schelter,2012-09-30 20:02:00+00:00,['2424717bdb4309d9d6f84c264feecee09b8c52ef'],0,199,199,1233440,1,0.565891473,0.76744186,0.465116279,2590
a89b08167ae581eb2907f19224ab265856cef8e9,0,Sebastian Schelter,2012-09-30 21:23:01+00:00,['a8f16b8bf83b1bb049f5bd7a83c2d4e0c8b04925'],54,51,105,1233545,1,0,0,1,2590
7a01e245feaa8eb1f9cf6f2d7897b7153f829a1d,1,Sean R. Owen,2012-10-03 21:51:38+00:00,['a89b08167ae581eb2907f19224ab265856cef8e9'],0,512,512,1234057,2,0.359735974,0.887788779,0.930693069,2591
8b6a26a153cd87720b6f323da1317ea6177a998f,1,Sean R. Owen,2012-10-05 10:49:31+00:00,['7a01e245feaa8eb1f9cf6f2d7897b7153f829a1d'],207,230,437,1234494,38,0,0.833333333,0.916666667,2591
0bce4cd90a7b8fca3da894e4abff30edd78b1804,0,pranjan,2012-10-08 08:58:09+00:00,['8b6a26a153cd87720b6f323da1317ea6177a998f'],1,1,2,1234496,1,,,,2591
0ab9b15356197e7387714484da9c1cd39a555c84,1,pranjan,2012-10-08 10:35:35+00:00,['0bce4cd90a7b8fca3da894e4abff30edd78b1804'],7,4,11,1234507,1,0.5,0,0.5,2591
1e3f7aedc67c6c7c7e55afc282447387c7952f91,1,Ted Dunning,2012-10-11 01:17:10+00:00,['0ab9b15356197e7387714484da9c1cd39a555c84'],607,819,1426,1235933,17,0.351724138,0.489655172,1,2591
f181ccef73aa77493f846fc27ca34bb58590ddcf,1,Ted Dunning,2012-10-11 05:05:59+00:00,['1e3f7aedc67c6c7c7e55afc282447387c7952f91'],4,4,8,1235941,3,,,,2591
1b50c196538a1cc9223f67ac4e41927790b98638,1,Ted Dunning,2012-10-11 06:23:44+00:00,['f181ccef73aa77493f846fc27ca34bb58590ddcf'],7,63,70,1236011,2,0.145833333,1,1,2591
f8125269795412cdc1b8602adfb24ea2754a368c,1,Ted Dunning,2012-10-11 06:23:47+00:00,['1b50c196538a1cc9223f67ac4e41927790b98638'],4,4,8,1236019,4,,,,2591
308d034c4fb0ca62239c1dd63335ebc981f8e981,1,Ted Dunning,2012-10-11 08:45:00+00:00,['f8125269795412cdc1b8602adfb24ea2754a368c'],32,16,48,1236067,4,0,0,0,2591
c4714d8fe38a5d44d8cdd2385942bdb773e83754,1,Dmitriy Lyubimov,2012-10-11 19:30:42+00:00,['308d034c4fb0ca62239c1dd63335ebc981f8e981'],19,21,40,1236107,1,0,0,1,2591
ca9b6d0c814bffc8551debcf2317a60c0ab58df3,1,Ted Dunning,2012-10-11 22:42:38+00:00,['c4714d8fe38a5d44d8cdd2385942bdb773e83754'],1,209,210,1236317,8,1,1,1,2593
03e68753602be563af8d19c9e62659ecc9cca67f,1,Dmitriy Lyubimov,2012-10-11 23:20:07+00:00,['ca9b6d0c814bffc8551debcf2317a60c0ab58df3'],16,36,52,1236369,4,0,0,1,2593
b20785fc9d11868bc1c9551ce1db71ef795f9b8e,0,Sean R. Owen,2012-10-12 09:11:02+00:00,['03e68753602be563af8d19c9e62659ecc9cca67f'],1,149,150,1236519,2,0.147368421,1,1,2594
5a76df996586396ac28c54474668b207c9274900,0,Sean R. Owen,2012-10-12 09:38:51+00:00,['b20785fc9d11868bc1c9551ce1db71ef795f9b8e'],1,7,8,1236527,1,0,1,1,2594
570202f378e10e4027758e816b82f1e24b64b78e,0,Sean R. Owen,2012-10-26 15:49:47+00:00,['5a76df996586396ac28c54474668b207c9274900'],1,3,4,1236531,1,,,,2594
48daaac77adfa6fc2e3eb4d6ddc0f757e28b6b14,0,Sean R. Owen,2012-10-26 15:52:02+00:00,['570202f378e10e4027758e816b82f1e24b64b78e'],1,1,2,1236533,1,,,,2594
d688be00c27311031db14a7644a248f9e4cb1881,1,Sean R. Owen,2012-10-29 09:42:55+00:00,['48daaac77adfa6fc2e3eb4d6ddc0f757e28b6b14'],67,51,118,1236651,4,,,,2594
9e1ffa407672020df5485c1373a7adcc2d03c1d1,0,Sebastian Schelter,2012-10-29 20:50:45+00:00,['d688be00c27311031db14a7644a248f9e4cb1881'],0,224,224,1236875,1,0.530769231,1,0.730769231,2595
d51e8b7358ae605e0770f6cf8ba8323503964585,1,Sebastian Schelter,2012-10-29 21:05:33+00:00,['9e1ffa407672020df5485c1373a7adcc2d03c1d1'],0,186,186,1237061,1,0.14953271,0.308411215,0.579439252,2596
6413ec447742fbb8a86030a7ce9cccdcc9e32ef2,0,pranjan,2012-11-01 13:02:03+00:00,['d51e8b7358ae605e0770f6cf8ba8323503964585'],0,1,1,1237062,1,0,0,1,2596
c98080785a6ffd1b60a3b86862be86b61c9b8dee,0,Sean R. Owen,2012-11-12 15:26:31+00:00,['6413ec447742fbb8a86030a7ce9cccdcc9e32ef2'],0,1,1,1237063,1,0,0,0,2596
e7011776a60d81073f21306158f3e9ed8cfc1582,1,Ted Dunning,2012-11-15 08:19:26+00:00,['c98080785a6ffd1b60a3b86862be86b61c9b8dee'],9,231,240,1237303,2,0,0,1,2597
acda70bccad1a506f13053e216a22c9ecfc5997c,1,Ted Dunning,2012-11-15 08:19:30+00:00,['e7011776a60d81073f21306158f3e9ed8cfc1582'],52,58,110,1237413,4,0,1,1,2597
df130cb98c8d8f4accddbcd793a11677b6e2aa36,1,Ted Dunning,2012-11-15 08:19:35+00:00,['acda70bccad1a506f13053e216a22c9ecfc5997c'],46,75,121,1237534,1,0,1,1,2597
a2375a39c11c09fcd10bbdfee7d5cffda64e2baa,1,Ted Dunning,2012-11-15 08:21:41+00:00,['df130cb98c8d8f4accddbcd793a11677b6e2aa36'],3,19,22,1237556,2,1,1,1,2597
0600c3786af720f261f51f916ae6624dd2193c7b,0,Sean R. Owen,2012-11-15 19:19:16+00:00,['a2375a39c11c09fcd10bbdfee7d5cffda64e2baa'],0,93,93,1237649,1,1,1,1,2597
5c13640d05309e1a4b7fb99142546cd9bb89ee4e,1,Sean R. Owen,2012-11-16 18:06:01+00:00,['0600c3786af720f261f51f916ae6624dd2193c7b'],31,60,91,1237740,3,1,1,1,2598
6529d6340eae2123297d0857d9fbb81f3e8c8176,0,Sean R. Owen,2012-11-18 12:01:18+00:00,['5c13640d05309e1a4b7fb99142546cd9bb89ee4e'],57,75,132,1237872,3,1,0,1,2598
606139dff68790be49816f8857fb22f5edb17020,0,Grant Ingersoll,2012-11-18 14:20:13+00:00,['6529d6340eae2123297d0857d9fbb81f3e8c8176'],0,12,12,1237884,1,,,,2598
4884cc4f94b93fb461e2416a89c2cf5207d9213e,0,Sean R. Owen,2012-11-27 18:16:21+00:00,['606139dff68790be49816f8857fb22f5edb17020'],34,38,72,1237956,2,0,1,1,2598
04c337423690a1ba25f9eb1f602dd4caeb472aaf,0,Sean R. Owen,2012-11-28 09:53:56+00:00,['4884cc4f94b93fb461e2416a89c2cf5207d9213e'],35,74,109,1238065,4,0.466666667,1,1,2598
0c1cb71aa95e4ec789159bf80174fe5ee00c2fb9,0,Sean R. Owen,2012-12-03 20:13:29+00:00,['04c337423690a1ba25f9eb1f602dd4caeb472aaf'],14,12,26,1238091,2,1,1,1,2598
f96f852a9c77b72c2a521fa89801b202df41624a,0,Sebastian Schelter,2012-12-07 08:58:08+00:00,['0c1cb71aa95e4ec789159bf80174fe5ee00c2fb9'],0,12,12,1238103,12,,,,2598
e527616c988f96e3cf60fac7c1229769a8f12935,1,Ted Dunning,2012-12-15 00:35:13+00:00,['f96f852a9c77b72c2a521fa89801b202df41624a'],18,59,77,1238180,1,0,0,1,2598
dde8b34fdbfb0634a51824ed45ae419eff313212,0,Ted Dunning,2012-12-15 02:12:34+00:00,['e527616c988f96e3cf60fac7c1229769a8f12935'],1,1,2,1238182,1,,,,2598
127d4503c4408f44695ca0e67302e7f67ecdd417,1,Sean R. Owen,2013-01-02 13:55:23+00:00,['dde8b34fdbfb0634a51824ed45ae419eff313212'],127,109,236,1238418,11,0.363636364,0.454545455,0,2598
2deba3678e74cf3a59dcc670e9116e50795d590e,1,Sean R. Owen,2013-01-02 21:51:52+00:00,['127d4503c4408f44695ca0e67302e7f67ecdd417'],449,228,677,1239095,30,0.303030303,0.045454545,0,2598
7dac77913f714143ea76e1c130a2af55ac2374c1,0,Ted Dunning,2013-01-09 23:17:47+00:00,['2deba3678e74cf3a59dcc670e9116e50795d590e'],2,5,7,1239102,1,,,,2598
63546f99df425b9601511925e785fec619bce110,1,Ted Dunning,2013-01-11 00:59:50+00:00,['7dac77913f714143ea76e1c130a2af55ac2374c1'],13,5,18,1239120,4,0,0,0,2598
ac0abc69d9bcbab4e7e3c2b8afddfeb2fbb2fbe6,1,Ted Dunning,2013-01-11 02:11:19+00:00,['63546f99df425b9601511925e785fec619bce110'],1,23,24,1239144,2,1,1,1,2598
441c8b32dddb80bbdb7844016c9bfda2eabe577d,0,Ted Dunning,2013-01-11 23:43:56+00:00,['ac0abc69d9bcbab4e7e3c2b8afddfeb2fbb2fbe6'],14,1,15,1239159,1,1,1,0,2598
69653557a82d62ce18ac2b2f3292ee422ed939f8,0,Sebastian Schelter,2013-01-17 19:02:22+00:00,['441c8b32dddb80bbdb7844016c9bfda2eabe577d'],0,7,7,1239166,1,0,1,1,2598
034f21a11b57b65945d017d1c6d74c3589a1f469,0,Sebastian Schelter,2013-01-17 23:13:30+00:00,['69653557a82d62ce18ac2b2f3292ee422ed939f8'],6,4,10,1239176,1,0,0,0,2598
b90e8466bc9a4042a648f7f73173e58e012ee8d5,0,Sebastian Schelter,2013-01-18 07:45:06+00:00,['034f21a11b57b65945d017d1c6d74c3589a1f469'],1,1,2,1239178,1,,,,2598
2b8b2a7d5b9cc726e436e28ad6ff8a5555a36a50,0,Sebastian Schelter,2013-01-18 07:55:55+00:00,['b90e8466bc9a4042a648f7f73173e58e012ee8d5'],0,1,1,1239179,1,0,0,1,2598
44f8d0adc2c4b3d7b4b5ce6b2eefedada51e6b9a,0,Sebastian Schelter,2013-01-18 10:57:36+00:00,['2b8b2a7d5b9cc726e436e28ad6ff8a5555a36a50'],7,49,56,1239235,3,0.272727273,0.242424242,1,2598
f4d8201a5f6090d5cb76bd3fddc1ee4f325a911c,0,Sean R. Owen,2013-01-22 11:41:33+00:00,['44f8d0adc2c4b3d7b4b5ce6b2eefedada51e6b9a'],1,5,6,1239241,1,0,1,1,2598
c81abd5dd6d7efe5970e7cf19edc55e3286eac67,0,Sean R. Owen,2013-01-22 18:39:26+00:00,['f4d8201a5f6090d5cb76bd3fddc1ee4f325a911c'],15,15,30,1239271,1,,,,2598
8396a27bb2881b59c4aa9bb49427f0e7c27ae095,1,Sean R. Owen,2013-01-26 17:29:09+00:00,['c81abd5dd6d7efe5970e7cf19edc55e3286eac67'],191,159,350,1239621,53,1,0.157894737,0.210526316,2598
6a4942cd0fb2dfce2766ce070341242ea8cb9086,1,Grant Ingersoll,2013-01-30 10:27:17+00:00,['8396a27bb2881b59c4aa9bb49427f0e7c27ae095'],408,611,1019,1240640,40,0.234042553,1,0.776595745,2600
f862e2b821ffc202008cb5359350194368d5ac35,0,Jacob Alexander Mannix,2013-01-31 14:53:14+00:00,['6a4942cd0fb2dfce2766ce070341242ea8cb9086'],1,15,16,1240656,2,0,1,1,2600
0c99a40783c5f7e66f5759fd1d04be245c4783f2,0,Jacob Alexander Mannix,2013-01-31 16:27:17+00:00,['f862e2b821ffc202008cb5359350194368d5ac35'],2,0,2,1240658,1,0,0,0,2600
fc6c6f3777bb05cd5e2bbebf2565bcaadcd2bd74,0,Grant Ingersoll,2013-02-01 11:25:23+00:00,['0c99a40783c5f7e66f5759fd1d04be245c4783f2'],39,26,65,1240723,12,0,0,0,2600
ace4c35cbe87ed4e485e68173dc97b9a50700a69,1,Ted Dunning,2013-02-04 23:12:41+00:00,['fc6c6f3777bb05cd5e2bbebf2565bcaadcd2bd74'],154,574,728,1241451,4,0.26122449,0.828571429,0.951020408,2602
86d269b3104c940ed8ff0d065332e0af347ac523,1,Ted Dunning,2013-02-04 23:51:58+00:00,['ace4c35cbe87ed4e485e68173dc97b9a50700a69'],38,102,140,1241591,4,0,1,0,2603
0afb32c6d15435f37711655b3099569ee4673774,1,Ted Dunning,2013-02-05 18:38:39+00:00,['86d269b3104c940ed8ff0d065332e0af347ac523'],1,1,2,1241593,1,,,,2603
e200147652165bb457f4b14de4ce96e96f98866d,1,Sebastian Schelter,2013-03-06 12:22:01+00:00,['0afb32c6d15435f37711655b3099569ee4673774'],23,77,100,1241693,7,0.8125,0,0.5,2603
87a2503b48a4638a82f9b7473e9165600d04cfdc,0,Sebastian Schelter,2013-03-06 12:49:33+00:00,['e200147652165bb457f4b14de4ce96e96f98866d'],1,1,2,1241695,1,,,,2603
c3154b86dce55f8ca318c35f97751d3aeee415aa,0,Sebastian Schelter,2013-03-07 10:10:00+00:00,['87a2503b48a4638a82f9b7473e9165600d04cfdc'],25,101,126,1241821,5,0.862068966,0.862068966,0.862068966,2604
49bf055acf29dcc1aa69bd37e97b5dfe3015e7ba,0,Sebastian Schelter,2013-03-07 10:30:36+00:00,['c3154b86dce55f8ca318c35f97751d3aeee415aa'],2,0,2,1241823,1,,,,2604
8a8e10dec709e9869ab8fe411c7fc07c7a7b265c,1,Sebastian Schelter,2013-03-08 13:53:26+00:00,['49bf055acf29dcc1aa69bd37e97b5dfe3015e7ba'],55,179,234,1242057,5,1,1,1,2606
1d3131815cb929a7f1e580bce825c29a6848b41c,1,Sebastian Schelter,2013-03-11 09:48:16+00:00,['8a8e10dec709e9869ab8fe411c7fc07c7a7b265c'],33,26,59,1242116,1,1,1,0,2606
9dba3cc0501f096ef2e569829d9f18e275334907,1,Sebastian Schelter,2013-03-11 11:04:58+00:00,['1d3131815cb929a7f1e580bce825c29a6848b41c'],48,113,161,1242277,3,0.292682927,0.853658537,0.682926829,2606
bfd82145bfc1d94b7dfabae2bc04737929c41747,1,Sebastian Schelter,2013-03-11 12:02:26+00:00,['9dba3cc0501f096ef2e569829d9f18e275334907'],10,38,48,1242325,2,1,1,1,2607
a1e5c7bfc0e48f289e7de4f062a901d625f3e00c,0,Sebastian Schelter,2013-03-11 12:18:11+00:00,['bfd82145bfc1d94b7dfabae2bc04737929c41747'],3,19,22,1242347,2,0.428571429,1,1,2607
1250c232a8ae93c76b28b0fa8b5267362e692d1b,0,Sebastian Schelter,2013-03-11 12:35:30+00:00,['a1e5c7bfc0e48f289e7de4f062a901d625f3e00c'],0,1,1,1242348,1,0,1,0,2607
dbaadb1c8c720a41296fb8a3e215c38aa53ed5ca,0,Sebastian Schelter,2013-03-11 15:07:05+00:00,['1250c232a8ae93c76b28b0fa8b5267362e692d1b'],0,1,1,1242349,1,,,,2607
750a1a0243456b25f259dd55cd71c4a827875ab4,0,Sebastian Schelter,2013-03-11 15:27:54+00:00,['dbaadb1c8c720a41296fb8a3e215c38aa53ed5ca'],3,6,9,1242358,1,0,0,0,2607
6a8de49a78333bbafddc9877685065d911604942,0,Sebastian Schelter,2013-03-11 15:43:39+00:00,['750a1a0243456b25f259dd55cd71c4a827875ab4'],1,1,2,1242360,1,,,,2607
f2eccdccf8066a8d140949afbaf7162e898140a3,0,Sean R. Owen,2013-03-11 16:18:11+00:00,['6a8de49a78333bbafddc9877685065d911604942'],5,2,7,1242367,1,,,,2607
e7a90d186e1940ce817413eff04a6946db0238d1,0,Sebastian Schelter,2013-03-11 16:55:09+00:00,['f2eccdccf8066a8d140949afbaf7162e898140a3'],1,6,7,1242374,1,1,1,1,2607
7b10d65ade075c00a5930437542aa87692c42c15,1,Sebastian Schelter,2013-03-11 17:51:29+00:00,['e7a90d186e1940ce817413eff04a6946db0238d1'],4,108,112,1242486,5,0.37704918,0.786885246,1,2608
25b51464a991fa26f566e9c4d79be8a332a81181,0,Shannon Quinn,2013-03-11 19:06:58+00:00,['7b10d65ade075c00a5930437542aa87692c42c15'],131,186,317,1242803,2,0,1,0.192307692,2608
f2dc2fd6602fcec6d812aeec0eb36f4b2c3a6ff6,0,Shannon Quinn,2013-03-11 19:15:28+00:00,['25b51464a991fa26f566e9c4d79be8a332a81181'],13,2,15,1242818,1,,,,2608
733f4b64b700e80d2f5649306b1daf5ab13d6351,0,Shannon Quinn,2013-03-11 22:22:12+00:00,['f2dc2fd6602fcec6d812aeec0eb36f4b2c3a6ff6'],10,38,48,1242866,1,0.482758621,1,0.413793103,2608
8511167483774c09fd6620b749991b5493b2213d,0,Sebastian Schelter,2013-03-12 06:43:03+00:00,['733f4b64b700e80d2f5649306b1daf5ab13d6351'],9,16,25,1242891,1,0,0,0,2608
418f643b2ace74ce0cadc0e5e2d7808cd65674e3,0,Sebastian Schelter,2013-03-12 07:21:32+00:00,['8511167483774c09fd6620b749991b5493b2213d'],66,138,204,1243095,2,,,,2608
a3baa242603d82f1cc34aec3d08562f76b9ecb03,0,Sebastian Schelter,2013-03-12 18:54:52+00:00,['418f643b2ace74ce0cadc0e5e2d7808cd65674e3'],1,1,2,1243097,1,,,,2608
95cf05f1aacee2195e802b515deb2af0a6b8606f,0,Shannon Quinn,2013-03-12 19:03:55+00:00,['a3baa242603d82f1cc34aec3d08562f76b9ecb03'],9,17,26,1243123,1,0,1,0.666666667,2608
7071580d31460d854b5f1d7148c37c0c8c42c3f7,0,Sebastian Schelter,2013-03-12 19:06:49+00:00,['95cf05f1aacee2195e802b515deb2af0a6b8606f'],2,4,6,1243129,1,,,,2608
553252f9dd3b744006a1fe755f9ab1785ab47e62,0,Sebastian Schelter,2013-03-12 19:46:02+00:00,['7071580d31460d854b5f1d7148c37c0c8c42c3f7'],5,5,10,1243139,1,,,,2608
dce96b20c9b2f5341f37d36cf22130fb8cd2d995,0,Sebastian Schelter,2013-03-12 21:52:10+00:00,['553252f9dd3b744006a1fe755f9ab1785ab47e62'],5,0,5,1243144,1,0,0,0,2608
10c535c16ea567a2105a6cbcbeb2af3321028417,1,Sean R. Owen,2013-03-12 23:10:14+00:00,['dce96b20c9b2f5341f37d36cf22130fb8cd2d995'],637,561,1198,1244342,52,0.928104575,0.013071895,0,2610
d5b6b74306fac6cbcab2498e0e14b3c53b4f7a23,0,Sean R. Owen,2013-03-12 23:14:30+00:00,['10c535c16ea567a2105a6cbcbeb2af3321028417'],81,165,246,1244588,2,0,0,1,2611
21a9c51552b0f7ef94882effa90b072de3ff6a54,0,Sebastian Schelter,2013-03-13 08:16:01+00:00,['d5b6b74306fac6cbcab2498e0e14b3c53b4f7a23'],14,27,41,1244629,1,0,1,1,2611
e5cc83df010f7857b3b18284ab5fa963eb3e78c5,1,Sebastian Schelter,2013-03-14 21:21:18+00:00,['21a9c51552b0f7ef94882effa90b072de3ff6a54'],26,85,111,1244740,4,0.56097561,1,0.536585366,2611
c5edfe9ac7f34203ed2f26ab266e5331bc3efa8e,1,Sebastian Schelter,2013-03-16 07:24:45+00:00,['e5cc83df010f7857b3b18284ab5fa963eb3e78c5'],6,5,11,1244751,2,1,1,1,2611
63c81f15995fa6dfcd1c11cdd97c9b0d791ee13a,1,Sebastian Schelter,2013-03-16 11:52:14+00:00,['c5edfe9ac7f34203ed2f26ab266e5331bc3efa8e'],108,460,568,1245319,15,0.676767677,0.535353535,0.454545455,2617
1e898e791b0df150485a715542793623e01e860d,1,Sebastian Schelter,2013-03-20 11:15:09+00:00,['63c81f15995fa6dfcd1c11cdd97c9b0d791ee13a'],11,536,547,1245866,8,0.520618557,1,0.757731959,2623
f9baeba30c31ad6f9d2f9b7172589d7c45998c25,0,Sebastian Schelter,2013-03-20 11:29:01+00:00,['1e898e791b0df150485a715542793623e01e860d'],8,11,19,1245885,2,,,,2623
50349a6053bdc71cae1ab6ccab3ec281b22456dc,0,Sebastian Schelter,2013-03-20 11:32:12+00:00,['f9baeba30c31ad6f9d2f9b7172589d7c45998c25'],1,2,3,1245888,1,,,,2623
70eecdb341e017a308813712471539f831144d6a,0,Sebastian Schelter,2013-03-20 14:48:29+00:00,['50349a6053bdc71cae1ab6ccab3ec281b22456dc'],1,1,2,1245890,1,,,,2623
10740e3b38433f9e0be0f3edba605cbfd50f8972,1,Benson Margulies,2013-03-21 13:58:39+00:00,['70eecdb341e017a308813712471539f831144d6a'],101,165,266,1246156,3,1,1,0.666666667,2624
df39ce464b8383c05f70d46e11e6adfb2adc1ded,0,Sebastian Schelter,2013-03-21 15:44:17+00:00,['10740e3b38433f9e0be0f3edba605cbfd50f8972'],248,152,400,1246556,8,0.142857143,1,0.657142857,2625
5d667589f9f7d775448389c69bf6c6776ef54269,1,Sebastian Schelter,2013-03-21 17:37:50+00:00,['df39ce464b8383c05f70d46e11e6adfb2adc1ded'],243,44,287,1246843,28,0.012345679,0.012345679,0.012345679,2625
210b26585d87b7096286b162b733b18f18d9c785,1,Sebastian Schelter,2013-03-23 11:38:59+00:00,['5d667589f9f7d775448389c69bf6c6776ef54269'],237,237,474,1247317,89,0.018181818,0.490909091,0.072727273,2625
402e296c5efe03d91a8ca8e962705bc79b2b6f23,1,Ted Dunning,2013-03-24 12:14:24+00:00,['210b26585d87b7096286b162b733b18f18d9c785'],101,6,107,1247424,74,1,1,0,2625
4841efbcd36c2d7bd160fe673824578f3adc5a23,1,Sebastian Schelter,2013-03-24 20:05:50+00:00,['402e296c5efe03d91a8ca8e962705bc79b2b6f23'],644,680,1324,1248748,137,0,0.566666667,0.7,2625
d95bddae46e6b9210a4c4b89d71202e7881a08db,0,Sebastian Schelter,2013-03-25 08:16:22+00:00,['4841efbcd36c2d7bd160fe673824578f3adc5a23'],343,240,583,1249331,18,0,0,0,2628
3c22856e8f2163301aa0ea870622c142427b4b40,1,Sebastian Schelter,2013-03-25 09:50:22+00:00,['d95bddae46e6b9210a4c4b89d71202e7881a08db'],181,241,422,1249753,59,0,0.333333333,0.8,2628
de76182341022df3819c1cf29ca0593ecbf34917,0,Sebastian Schelter,2013-03-25 11:27:36+00:00,['3c22856e8f2163301aa0ea870622c142427b4b40'],421,24,445,1250198,22,0.283018868,0.283018868,0.106918239,2628
67e09b3ee3ada13ae709c18d010f56bfa4555d74,1,Ted Dunning,2013-03-25 22:09:13+00:00,['de76182341022df3819c1cf29ca0593ecbf34917'],0,16,16,1250214,2,0,0,0,2628
1036a80ac81a092574a84b129e936dea37af5907,0,Ted Dunning,2013-03-25 23:16:16+00:00,['67e09b3ee3ada13ae709c18d010f56bfa4555d74'],2,2,4,1250218,2,,,,2628
6d16230d5548b1acd9762dee1f76b98f2727e2a2,1,Sebastian Schelter,2013-03-26 13:24:40+00:00,['1036a80ac81a092574a84b129e936dea37af5907'],1621,1537,3158,1253376,160,0.333333333,0,1,2628
d1ba46ece920edad9fd87f6306436c3e949c577a,0,Sebastian Schelter,2013-03-27 06:11:25+00:00,['6d16230d5548b1acd9762dee1f76b98f2727e2a2'],0,5,5,1253381,1,,,,2629
5f8070b989f5f6f87fc41053ad91d640dbe8712f,0,Ted Dunning,2013-03-31 05:38:47+00:00,['d1ba46ece920edad9fd87f6306436c3e949c577a'],1,1,2,1253383,1,,,,2629
e8b1f807ac6ac4dafb3b307769f6af4067f535c0,0,Ted Dunning,2013-03-31 08:27:11+00:00,['5f8070b989f5f6f87fc41053ad91d640dbe8712f'],1,2,3,1253386,1,,,,2629
2359f98e7af58e46f2b1b4a87bd5a690ce859fc8,0,Sebastian Schelter,2013-03-31 09:55:23+00:00,['e8b1f807ac6ac4dafb3b307769f6af4067f535c0'],0,2,2,1253388,1,,,,2629
bdb1c48561578dc496d05c263b28b68d0c97e2d2,1,Sebastian Schelter,2013-04-01 09:18:12+00:00,['2359f98e7af58e46f2b1b4a87bd5a690ce859fc8'],660,646,1306,1254694,48,1,1,1,2631
4d1f06290348faa37ce17d2739b94e47923375d0,0,Sean R. Owen,2013-04-02 09:36:40+00:00,['bdb1c48561578dc496d05c263b28b68d0c97e2d2'],1,1,2,1254696,1,,,,2631
17270d846a337f4b8e5cfa2b19175aa8f07c58c7,1,Jacob Alexander Mannix,2013-04-05 20:42:12+00:00,['4d1f06290348faa37ce17d2739b94e47923375d0'],11,14,25,1254721,4,,,,2631
46ed1c07f3606df8e3d47ca3531c07b03911659d,1,Sean R. Owen,2013-04-07 11:33:31+00:00,['17270d846a337f4b8e5cfa2b19175aa8f07c58c7'],91,30,121,1254842,3,0,0,0,2631
67a531e942f10611477f9ffd4424f957d41cbb7c,1,smarthi,2013-04-07 17:00:23+00:00,['46ed1c07f3606df8e3d47ca3531c07b03911659d'],38,39,77,1254919,34,,,,2631
c79dde5a9b847c58b888d0745fd4fa86af781f90,1,Sebastian Schelter,2013-04-09 05:27:18+00:00,['67a531e942f10611477f9ffd4424f957d41cbb7c'],17,9,26,1254945,2,0,0,0,2631
8ba23091ee0eafe5f303058621cb7b86758b1629,0,Sebastian Schelter,2013-04-09 05:28:53+00:00,['c79dde5a9b847c58b888d0745fd4fa86af781f90'],0,38,38,1254983,1,1,1,1,2632
2eaae3646498b74c37ce53604b6129f1697092f3,0,Sebastian Schelter,2013-04-09 05:29:42+00:00,['8ba23091ee0eafe5f303058621cb7b86758b1629'],0,2,2,1254985,1,,,,2632
c36dc719028351db110d0acaf1fe65b846c5c258,0,smarthi,2013-04-09 16:37:44+00:00,['2eaae3646498b74c37ce53604b6129f1697092f3'],21,23,44,1255029,13,,,,2632
be945338d4cb09ecd3e165f6b322cf132fc027c0,1,Robin Anil,2013-04-15 20:20:43+00:00,['c36dc719028351db110d0acaf1fe65b846c5c258'],262,673,935,1255964,20,0.375478927,0.716475096,0.957854406,2632
be8e8a05152595c3b31e81cb2b3fcf54d951f4d3,1,Robin Anil,2013-04-15 20:28:53+00:00,['be945338d4cb09ecd3e165f6b322cf132fc027c0'],3,3,6,1255970,3,,,,2632
abd58a8fcd8edf1a6925229864efe0e13cd0bbfb,0,Robin Anil,2013-04-15 20:31:02+00:00,['be8e8a05152595c3b31e81cb2b3fcf54d951f4d3'],1,1,2,1255972,1,,,,2632
812d0ba2ae098ad86fa66c92f30eb264be78debb,0,Robin Anil,2013-04-18 19:06:27+00:00,['abd58a8fcd8edf1a6925229864efe0e13cd0bbfb'],646,1163,1809,1257781,11,0.579365079,1,0.988095238,2641
0a0fddf469f3f58f74c12dc2fe47ba8d8141c161,1,Robin Anil,2013-04-18 19:39:21+00:00,['812d0ba2ae098ad86fa66c92f30eb264be78debb'],99,184,283,1258064,14,1,1,0.595238095,2641
3cadef96006421dc7f169bf10de2d0ed4b78bebc,0,Robin Anil,2013-04-20 17:14:16+00:00,['0a0fddf469f3f58f74c12dc2fe47ba8d8141c161'],21,58,79,1258143,4,0.259259259,1,1,2641
1519d015d3b1cb112788e94e7de5ac2466229026,0,Robin Anil,2013-04-20 17:56:49+00:00,['3cadef96006421dc7f169bf10de2d0ed4b78bebc'],1,24,25,1258168,1,0,0.952380952,1,2641
a95412337722e1cfecf23f8fa29ead6438f55daa,0,Robin Anil,2013-04-20 18:05:59+00:00,['1519d015d3b1cb112788e94e7de5ac2466229026'],0,3,3,1258171,1,0,1,1,2641
fc209b78248d6ee12189763df5e8a22118f06e3b,1,Jacob Alexander Mannix,2013-04-26 17:30:39+00:00,['a95412337722e1cfecf23f8fa29ead6438f55daa'],1,4,5,1258176,1,1,1,1,2641
c9684aae817642fba89483a1d96893e21710011d,0,Robin Anil,2013-04-29 22:50:47+00:00,['fc209b78248d6ee12189763df5e8a22118f06e3b'],14,16,30,1258206,1,0,1,1,2641
87faa135f14d66f052ed89a5e987d0ccb54c2a1a,0,Robin Anil,2013-04-30 02:29:56+00:00,['c9684aae817642fba89483a1d96893e21710011d'],14,20,34,1258240,1,0.333333333,0.666666667,1,2641
802464db19ab8ea041ba35f26335ba376d61c51d,1,dfilimon,2013-05-03 11:07:01+00:00,['87faa135f14d66f052ed89a5e987d0ccb54c2a1a'],10,46,56,1258296,2,0.961538462,1,1,2641
e5ee197bb70a5d0458f45dc93a1f4c8366690109,1,dfilimon,2013-05-03 11:24:46+00:00,['802464db19ab8ea041ba35f26335ba376d61c51d'],5,8,13,1258309,3,0,1,1,2641
c233f90323d2aa6413035c694154c67faf4848c2,1,dfilimon,2013-05-03 15:21:47+00:00,['e5ee197bb70a5d0458f45dc93a1f4c8366690109'],7,10,17,1258326,1,1,1,1,2641
f95d551355130df5fd3d147caa6f978ca98c1de4,1,dfilimon,2013-05-03 16:04:13+00:00,['c233f90323d2aa6413035c694154c67faf4848c2'],47,1128,1175,1259501,14,0.157790927,0.970414201,0.960552268,2642
a23d87a0b20b54ffb3a1a64f92e4296c13c45453,1,dfilimon,2013-05-03 16:26:50+00:00,['f95d551355130df5fd3d147caa6f978ca98c1de4'],15,115,130,1259631,2,0.051282051,0.064102564,1,2642
a8d3dbd11adf6bb1255cc8c949ef004a78bddee2,1,dfilimon,2013-05-03 20:29:52+00:00,['a23d87a0b20b54ffb3a1a64f92e4296c13c45453'],614,2462,3076,1262707,29,0.799149841,0.882040383,0.233793836,2648
8649ac2655c4b6dbd0a6065e3a42cea6d6e741b5,1,dfilimon,2013-05-05 12:23:17+00:00,['a8d3dbd11adf6bb1255cc8c949ef004a78bddee2'],1,1467,1468,1264175,11,0.409859155,0.726760563,0.925352113,2657
7b7cfef8a9288fb901505fff1b8f9c7e6374d869,0,Sebastian Schelter,2013-05-07 05:45:16+00:00,['8649ac2655c4b6dbd0a6065e3a42cea6d6e741b5'],0,16,16,1264191,1,,,,2657
97f6db225444438e51cbd132b572168ecd8a01e8,0,Sebastian Schelter,2013-05-07 08:04:26+00:00,['7b7cfef8a9288fb901505fff1b8f9c7e6374d869'],27,164,191,1264382,6,0.444444444,0.416666667,0.625,2657
2d3fed22c5b5aa7200b74b581c8e574dab8afc7b,0,Sebastian Schelter,2013-05-07 08:05:31+00:00,['97f6db225444438e51cbd132b572168ecd8a01e8'],8,10,18,1264400,1,,,,2657
fd242548372aba9051f7676ac56b8c8e5e0317ec,1,dfilimon,2013-05-10 09:20:31+00:00,['2d3fed22c5b5aa7200b74b581c8e574dab8afc7b'],0,1518,1518,1265918,7,0.224340176,0.571847507,0.750733138,2663
d54c59b406def0d478e2c005e49fcfaa803f6b2d,1,smarthi,2013-05-12 05:25:54+00:00,['fd242548372aba9051f7676ac56b8c8e5e0317ec'],5,94,99,1266017,11,,,,2663
672364de57c8ba570fd6944e1ee29d319339f792,1,smarthi,2013-05-12 13:50:58+00:00,['d54c59b406def0d478e2c005e49fcfaa803f6b2d'],2,4,6,1266023,2,,,,2663
69ce85fa6e2f6e1ba3a430057c6f790db60b596e,1,smarthi,2013-05-12 14:11:51+00:00,['672364de57c8ba570fd6944e1ee29d319339f792'],40,2,42,1266065,5,,,,2663
b7ebff7fd747e8986dc41839a1b194c742eb1c78,0,smarthi,2013-05-13 13:31:00+00:00,['69ce85fa6e2f6e1ba3a430057c6f790db60b596e'],2,4,6,1266071,2,,,,2663
1d6dc496f13d049caf6b2b5fab50cc9a3561bffd,1,dfilimon,2013-05-15 15:35:12+00:00,['b7ebff7fd747e8986dc41839a1b194c742eb1c78'],0,1177,1177,1267248,10,0.381125227,0.827586207,0.731397459,2670
ec9035c60d8133286de3a7a123d299e25d2a1991,1,dfilimon,2013-05-17 09:04:12+00:00,['1d6dc496f13d049caf6b2b5fab50cc9a3561bffd'],0,535,535,1267783,9,0.562264151,0.739622642,0.867924528,2673
4edc814197dcae1c4c085b326aba5c4ba5c73600,1,dfilimon,2013-05-17 12:49:52+00:00,['ec9035c60d8133286de3a7a123d299e25d2a1991'],3,35,38,1267821,3,0.65,0.65,1,2673
5b29d0367ff99d215d30a45355f9257df36f24d8,1,dfilimon,2013-05-17 13:44:32+00:00,['4edc814197dcae1c4c085b326aba5c4ba5c73600'],3,2,5,1267826,2,1,0,0,2673
a400cb8acb5ad65c28ac646a1b1208451e0b0c50,1,smarthi,2013-05-20 06:04:47+00:00,['5b29d0367ff99d215d30a45355f9257df36f24d8'],0,16,16,1267842,3,1,1,1,2673
cb80ec66ec9e2b4acbc94182a3c64c9c429ae043,1,dfilimon,2013-05-20 14:58:18+00:00,['a400cb8acb5ad65c28ac646a1b1208451e0b0c50'],3,2,5,1267847,2,0,0,0,2673
9899396f574ec686b4cd12e9d786ef98a7414775,1,dfilimon,2013-05-21 08:38:48+00:00,['cb80ec66ec9e2b4acbc94182a3c64c9c429ae043'],41,26,67,1267914,2,0.2,0.2,0,2673
bc5ca9400f45de703aa82ff051c238f75fdcc3a2,1,dfilimon,2013-05-21 10:52:25+00:00,['9899396f574ec686b4cd12e9d786ef98a7414775'],4,10,14,1267928,2,0,0,1,2673
bad258a7ad3d5240538e2dc6566a35f62fe04f40,1,Sean R. Owen,2013-05-22 16:37:44+00:00,['bc5ca9400f45de703aa82ff051c238f75fdcc3a2'],17,17,34,1267962,3,0,0,0,2673
dc62944247cc3dbc212aad50fd9d7243ce3fd446,1,Jacob Alexander Mannix,2013-05-24 17:11:20+00:00,['bad258a7ad3d5240538e2dc6566a35f62fe04f40'],556,308,864,1268826,84,1,0.183574879,0.468599034,2673
a6f16219a25291db451a3ff20d0a604089c5991b,0,smarthi,2013-05-26 03:26:12+00:00,['dc62944247cc3dbc212aad50fd9d7243ce3fd446'],10,19,29,1268855,2,0,0,1,2673
754fd18bd52d198518ce0ac3882581427593ece1,1,smarthi,2013-05-27 07:03:34+00:00,['a6f16219a25291db451a3ff20d0a604089c5991b'],0,3,3,1268858,2,,,,2673
cfc31552094358301ab5d31d932620d599d29723,1,smarthi,2013-05-29 05:47:05+00:00,['754fd18bd52d198518ce0ac3882581427593ece1'],1,29,30,1268888,4,0.875,1,1,2673
b04eba0733e756fb367109613e61cd18a3a62d81,1,smarthi,2013-05-29 10:26:06+00:00,['cfc31552094358301ab5d31d932620d599d29723'],21,52,73,1268961,7,0.909090909,0.909090909,1,2673
096d686486fb30a2dbce9c4e33ecc9875a2c0fa8,0,smarthi,2013-05-29 10:34:05+00:00,['b04eba0733e756fb367109613e61cd18a3a62d81'],2,0,2,1268963,1,,,,2673
aeb8c72aec0ad5be73d94eb21ad4b90517e7b00b,0,smarthi,2013-05-29 20:59:04+00:00,['096d686486fb30a2dbce9c4e33ecc9875a2c0fa8'],0,14,14,1268977,1,1,1,1,2673
8c539d2b051ce7f9ac6a9b13256708935b6ad44a,0,smarthi,2013-05-30 20:54:06+00:00,['aeb8c72aec0ad5be73d94eb21ad4b90517e7b00b'],7,11,18,1268995,2,0,1,1,2673
d40bf86a1084c778b6125db83f125cfd596036ab,0,Sebastian Schelter,2013-06-01 16:08:26+00:00,['8c539d2b051ce7f9ac6a9b13256708935b6ad44a'],3,5,8,1269003,2,,,,2673
dca3aab6fc8bb26513e226eb77600322d5b0e9e8,0,Robin Anil,2013-06-01 17:54:31+00:00,['d40bf86a1084c778b6125db83f125cfd596036ab'],9,8,17,1269020,1,1,0,1,2673
67d149037c651cbe2a341e2548bde70fb5fdb4dc,0,smarthi,2013-06-01 18:20:43+00:00,['dca3aab6fc8bb26513e226eb77600322d5b0e9e8'],14,31,45,1269065,3,0.785714286,1,1,2673
ed9e993d7eb23de48c2d7133d760b1fb085d5f08,0,Robin Anil,2013-06-01 19:48:51+00:00,['67d149037c651cbe2a341e2548bde70fb5fdb4dc'],0,2,2,1269067,1,1,1,1,2673
740a9c958330d665987808a6f04813c217322c55,0,Robin Anil,2013-06-01 20:44:20+00:00,['ed9e993d7eb23de48c2d7133d760b1fb085d5f08'],13,119,132,1269199,3,0.56,1,0.933333333,2673
f5b2ef2651945b120c301bbcaea773f75ef3c3fe,1,Robin Anil,2013-06-01 21:28:35+00:00,['740a9c958330d665987808a6f04813c217322c55'],0,346,346,1269545,3,0.112068966,0.112068966,0.978448276,2674
dda8a7814ef8ccbaf5056e76663d81dc946cd48f,0,Grant Ingersoll,2013-06-01 21:43:12+00:00,['f5b2ef2651945b120c301bbcaea773f75ef3c3fe'],3,7,10,1269555,3,1,1,0,2674
4ce12cc008e64d4c301123c13c8ce1fe007497a0,0,Isabel Drost,2013-06-01 22:13:24+00:00,['dda8a7814ef8ccbaf5056e76663d81dc946cd48f'],30,68,98,1269653,10,0.863636364,1,0.636363636,2674
e3ec9d80c23269e3160494575dfa283459da5e02,1,Isabel Drost,2013-06-01 22:24:03+00:00,['4ce12cc008e64d4c301123c13c8ce1fe007497a0'],148,183,331,1269984,40,0.958333333,1,1,2674
ab0c8f3dac1e88724fe5bb01a4141b9db98f8168,0,Isabel Drost,2013-06-01 23:12:45+00:00,['e3ec9d80c23269e3160494575dfa283459da5e02'],1,3,4,1269988,1,,,,2674
da4f5c94abdc1adc6a95a38ca645a07832888a22,0,Sebastian Schelter,2013-06-02 09:16:27+00:00,['ab0c8f3dac1e88724fe5bb01a4141b9db98f8168'],13,4,17,1270005,2,,,,2674
0c43ada4a6d5690538a326148ff643647ddde44d,0,Robin Anil,2013-06-02 13:49:51+00:00,['da4f5c94abdc1adc6a95a38ca645a07832888a22'],4,6,10,1270015,1,,,,2674
092f374530822d6cbd2d4bcea5d5902b8a673f1a,1,Robin Anil,2013-06-02 14:04:22+00:00,['0c43ada4a6d5690538a326148ff643647ddde44d'],11,11,22,1270037,2,0.5,0.5,0,2674
d1e5295b786f159731c348671d63520ffaf7167c,1,Robin Anil,2013-06-02 14:57:18+00:00,['092f374530822d6cbd2d4bcea5d5902b8a673f1a'],16,26,42,1270079,3,0.142857143,0.285714286,0.857142857,2674
6657591cb459b058643f2d31c7ee96df1d01fc95,1,Grant Ingersoll,2013-06-02 17:21:46+00:00,['d1e5295b786f159731c348671d63520ffaf7167c'],18,23,41,1270120,2,,,,2674
8dc2719a33efaa35492e3147b987583e7ffa5a3f,0,Grant Ingersoll,2013-06-02 17:42:31+00:00,['6657591cb459b058643f2d31c7ee96df1d01fc95'],2,7,9,1270129,1,,,,2674
f2ad4e16e7778d6652d3383d402e7819d7629dd6,0,Grant Ingersoll,2013-06-02 18:16:42+00:00,['8dc2719a33efaa35492e3147b987583e7ffa5a3f'],4,15,19,1270148,1,,,,2674
454557b65eaf7deca7bf5e35a644ce57f2a44ab3,1,Grant Ingersoll,2013-06-02 18:51:49+00:00,['f2ad4e16e7778d6652d3383d402e7819d7629dd6'],3,4,7,1270155,1,0,1,1,2674
a3306645e446d00237e41d722e0ee74f89dcec84,1,dfilimon,2013-06-02 18:56:27+00:00,['454557b65eaf7deca7bf5e35a644ce57f2a44ab3'],5,56,61,1270216,4,0,0.928571429,0.392857143,2674
ee8e393ee7a4f245861b1648966ca05adef5096f,0,Sebastian Schelter,2013-06-02 19:36:47+00:00,['a3306645e446d00237e41d722e0ee74f89dcec84'],7,55,62,1270278,3,0.636363636,1,1,2675
f09ea540f2e8fc0d87d110018194745c030fb482,1,dfilimon,2013-06-02 19:48:43+00:00,['ee8e393ee7a4f245861b1648966ca05adef5096f'],2,3,5,1270283,2,0,0,0,2675
6d87badaaf89bdf2e76ea87aed0b1c549576ace8,1,Robin Anil,2013-06-03 14:18:29+00:00,['f09ea540f2e8fc0d87d110018194745c030fb482'],1,10,11,1270294,2,1,1,1,2675
77cbd83e5504480667a57d06354421e2ed29cd65,1,Sean R. Owen,2013-06-04 00:18:24+00:00,['6d87badaaf89bdf2e76ea87aed0b1c549576ace8'],5,5,10,1270304,2,,,,2675
89a2ba02042fa9aa4eced6801bbd566a25e3c392,0,smarthi,2013-06-04 03:40:34+00:00,['77cbd83e5504480667a57d06354421e2ed29cd65'],96,119,215,1270519,5,1,0,1,2675
26e532fd792ed08203c94ef02c480708a9e92d33,1,Robin Anil,2013-06-04 14:24:04+00:00,['89a2ba02042fa9aa4eced6801bbd566a25e3c392'],62,82,144,1270663,2,0.5,0.5,0.5,2675
fa5336eba62537b237df358338bc723c1398a7ea,1,Robin Anil,2013-06-04 14:59:41+00:00,['26e532fd792ed08203c94ef02c480708a9e92d33'],5,2,7,1270670,1,,,,2675
9ced02fb64732b1b664c01bacdd54fc28760d631,1,smarthi,2013-06-04 22:47:22+00:00,['fa5336eba62537b237df358338bc723c1398a7ea'],0,8,8,1270678,1,,,,2675
4ca6b866a4b2cdacec85be5f1828594a1ef76754,1,Sean R. Owen,2013-06-05 05:20:34+00:00,['9ced02fb64732b1b664c01bacdd54fc28760d631'],257,266,523,1271201,97,1,1,1,2675
2282122dcd1e27747f44da7ba08e5c63a6627b0c,1,Grant Ingersoll,2013-06-05 10:39:15+00:00,['4ca6b866a4b2cdacec85be5f1828594a1ef76754'],95,140,235,1271436,3,1,0.807692308,0.730769231,2675
5c200426dd8f29d0b073caea4b85b1f49223117f,0,Sean R. Owen,2013-06-05 11:58:32+00:00,['2282122dcd1e27747f44da7ba08e5c63a6627b0c'],1,3,4,1271440,1,,,,2675
10093c97f3dc09660f839da83aabfc97e20fef93,0,Robin Anil,2013-06-06 01:57:01+00:00,['5c200426dd8f29d0b073caea4b85b1f49223117f'],1,1,2,1271442,1,,,,2675
554bcb9a2d7dfe1bc7c4ef2e2e9a562437c62082,1,Grant Ingersoll,2013-06-06 15:51:06+00:00,['10093c97f3dc09660f839da83aabfc97e20fef93'],2,2053,2055,1273497,21,0.62710084,0.839285714,0.902310924,2693
cbab3380c963f42f261ee63d10d1659344f19e3b,1,smarthi,2013-06-06 21:47:15+00:00,['554bcb9a2d7dfe1bc7c4ef2e2e9a562437c62082'],1,8,9,1273506,1,,,,2693
42b4d33be64a2d00d2a1665697d6d2d0efee19fe,1,Grant Ingersoll,2013-06-06 21:57:50+00:00,['cbab3380c963f42f261ee63d10d1659344f19e3b'],353,379,732,1274238,17,0,1,0.75,2693
6e333b9dab6f2be809a73b31f492cf8bb3269b99,1,Grant Ingersoll,2013-06-07 03:42:09+00:00,['42b4d33be64a2d00d2a1665697d6d2d0efee19fe'],0,42,42,1274280,1,1,1,0.333333333,2694
e48eb4cb394c8dfe5ed395dd77d769792c1eaa43,0,Grant Ingersoll,2013-06-07 04:11:31+00:00,['6e333b9dab6f2be809a73b31f492cf8bb3269b99'],20,20,40,1274320,11,,,,2694
b5c8c04927b8b59e64e065ff5e1422d27c2d8f71,1,Grant Ingersoll,2013-06-07 04:20:08+00:00,['e48eb4cb394c8dfe5ed395dd77d769792c1eaa43'],0,151,151,1274471,4,1,1,0.85,2698
4a6453cdefac463d15c02371b0042c0b3be7e556,0,Grant Ingersoll,2013-06-07 06:26:01+00:00,['b5c8c04927b8b59e64e065ff5e1422d27c2d8f71'],44,77,121,1274592,11,0,0,1,2698
54a66572dfce70f67851b672da0662d7b1916442,1,smarthi,2013-06-07 08:42:25+00:00,['4a6453cdefac463d15c02371b0042c0b3be7e556'],31,202,233,1274825,21,0,0,0,2698
72c68828a0018a736caa596dd7fa1f92e19d7335,1,Grant Ingersoll,2013-06-07 19:33:29+00:00,['54a66572dfce70f67851b672da0662d7b1916442'],14,19,33,1274858,3,0,1,1,2698
e66f94b8ea6e4a3feac3aa0d92a50b593d17c647,1,Grant Ingersoll,2013-06-07 19:34:00+00:00,['72c68828a0018a736caa596dd7fa1f92e19d7335'],2,17,19,1274877,2,1,1,1,2698
bbd2b7ea35a36804a2f813cebfdd66061adaabcc,1,Sebastian Schelter,2013-06-08 07:28:24+00:00,['e66f94b8ea6e4a3feac3aa0d92a50b593d17c647'],69,322,391,1275268,11,0.189873418,0.841772152,1,2698
dd56a290f592281f80f0146139a2c954b98aa352,1,Sebastian Schelter,2013-06-08 08:44:43+00:00,['bbd2b7ea35a36804a2f813cebfdd66061adaabcc'],15,195,210,1275478,4,0.231707317,0.134146341,1,2699
01b6488536a3102b20e5e4d109afff3d02c77684,0,Grant Ingersoll,2013-06-08 12:01:19+00:00,['dd56a290f592281f80f0146139a2c954b98aa352'],5,10,15,1275493,2,0,1,0,2699
81419837bb4a88540e126f20009419c644236f09,0,smarthi,2013-06-08 16:27:34+00:00,['01b6488536a3102b20e5e4d109afff3d02c77684'],2,29,31,1275524,1,,,,2699
e6370c079379b5640dadb7e8f3a62068bfeac432,0,smarthi,2013-06-08 16:37:23+00:00,['81419837bb4a88540e126f20009419c644236f09'],3,3,6,1275530,1,,,,2699
6b7f601ad34d484b7c63a7711d7964c0beaf132c,1,Sebastian Schelter,2013-06-09 10:59:47+00:00,['e6370c079379b5640dadb7e8f3a62068bfeac432'],171,206,377,1275907,8,0,0,0.846153846,2699
d0bed6dbb08a76ff018e0b248e2be60bccf2431c,1,Sebastian Schelter,2013-06-09 11:53:13+00:00,['6b7f601ad34d484b7c63a7711d7964c0beaf132c'],161,395,556,1276463,14,0.71875,0.953125,0.6875,2710
06ce99241a610b15a556104e8f5ccf75ffd6cfb0,0,Grant Ingersoll,2013-06-09 12:17:28+00:00,['d0bed6dbb08a76ff018e0b248e2be60bccf2431c'],0,14,14,1276477,2,,,,2710
bbf536942a6044048b6f909dfe346268f5370df9,1,Grant Ingersoll,2013-06-09 12:17:45+00:00,['06ce99241a610b15a556104e8f5ccf75ffd6cfb0'],273,375,648,1277125,10,0.191780822,0.150684932,0.589041096,2710
8bd9487ae9ed9e8e136e95d1ac7fb839895242d6,0,Grant Ingersoll,2013-06-09 12:19:54+00:00,['bbf536942a6044048b6f909dfe346268f5370df9'],1,5,6,1277131,1,,,,2710
31cb292293bd539e29458896e78bad5d72b2b895,1,Grant Ingersoll,2013-06-09 13:32:39+00:00,['8bd9487ae9ed9e8e136e95d1ac7fb839895242d6'],209,243,452,1277583,124,0,0,1,2710
035cd73153fa6ca2c5e521a7c16193986ba1639f,0,Grant Ingersoll,2013-06-09 14:34:19+00:00,['31cb292293bd539e29458896e78bad5d72b2b895'],1,62,63,1277646,2,0.306122449,1,1,2710
87d4b2e03012ca44f5c0f6629b0546785d9058ee,1,dfilimon,2013-06-09 18:50:03+00:00,['035cd73153fa6ca2c5e521a7c16193986ba1639f'],363,363,726,1278372,94,,,,2710
7678af4d27230234c07767c40fb9ff2bf3e8e203,0,Sebastian Schelter,2013-06-09 20:20:43+00:00,['87d4b2e03012ca44f5c0f6629b0546785d9058ee'],206,89,295,1278667,6,0.169014085,0,0.014084507,2710
f58960dca071c6c0d4ab46e3bb19b428ce8f0734,0,Grant Ingersoll,2013-06-09 20:50:53+00:00,['7678af4d27230234c07767c40fb9ff2bf3e8e203'],4,9,13,1278680,2,0,0,1,2710
25d59aa146c7edc802832cbcd5ef076ba4d92bd2,0,Grant Ingersoll,2013-06-09 20:51:18+00:00,['f58960dca071c6c0d4ab46e3bb19b428ce8f0734'],14,36,50,1278730,8,0,0,0.913043478,2710
6d9179e1497f89a3fb1703c31918f9cdf46b60a2,1,Sebastian Schelter,2013-06-09 21:43:55+00:00,['25d59aa146c7edc802832cbcd5ef076ba4d92bd2'],146,84,230,1278960,19,1,1,0.028169014,2710
17f63629727bc2b67fb6d0ac1b0df0f15eb6c257,0,Sebastian Schelter,2013-06-09 22:06:58+00:00,['6d9179e1497f89a3fb1703c31918f9cdf46b60a2'],0,129,129,1279089,128,,,,2710
b5d68c5a09af34dc79f54f81a32a36302885f127,1,smarthi,2013-06-09 22:20:38+00:00,['17f63629727bc2b67fb6d0ac1b0df0f15eb6c257'],0,326,326,1279415,5,0.210526316,0.45112782,0.69924812,2713
3aa430961e0bd0cd3de24c7f600eb210749ab11e,0,smarthi,2013-06-10 02:29:57+00:00,['b5d68c5a09af34dc79f54f81a32a36302885f127'],1,1,2,1279417,1,,,,2713
4da4468986b9dd2b4837ac1fa6796681a4c37392,0,smarthi,2013-06-10 02:40:26+00:00,['3aa430961e0bd0cd3de24c7f600eb210749ab11e'],3,3,6,1279423,1,,,,2713
1c16298cd7c72738519f8e5018ba16210a0f2f5b,0,Jacob Alexander Mannix,2013-06-11 05:44:01+00:00,['4da4468986b9dd2b4837ac1fa6796681a4c37392'],0,1,1,1279424,1,0,1,0,2713
fab9d376a2b17d4487a75250bdf1c96908cfadf6,1,dfilimon,2013-06-12 14:26:38+00:00,['1c16298cd7c72738519f8e5018ba16210a0f2f5b'],0,460,460,1279884,5,0.191919192,0.393939394,0.872053872,2716
58cc1ae19757e09389196dff605359be72f797fe,1,Sebastian Schelter,2013-06-12 20:44:19+00:00,['fab9d376a2b17d4487a75250bdf1c96908cfadf6'],501,522,1023,1280907,115,0,0,0,2716
8b194c80a6645b9dc7f0851fb33e224b553a6a37,1,Sebastian Schelter,2013-06-12 20:57:00+00:00,['58cc1ae19757e09389196dff605359be72f797fe'],31,31,62,1280969,23,,,,2716
bf555a67db57bd27e28728cef1eeb078d592d03f,0,smarthi,2013-06-12 21:26:22+00:00,['8b194c80a6645b9dc7f0851fb33e224b553a6a37'],4,16,20,1280989,4,,,,2716
2c2b52d9173be7b1b3284554a590fa04fa6a3d14,0,smarthi,2013-06-12 22:12:46+00:00,['bf555a67db57bd27e28728cef1eeb078d592d03f'],1,2,3,1280992,1,,,,2716
33af892642740f01291ea88ed30bebe2626270d6,1,Robin Anil,2013-06-13 04:13:30+00:00,['2c2b52d9173be7b1b3284554a590fa04fa6a3d14'],3,1,4,1280996,1,1,0,0,2716
727ddf6a52b5341d79f364ef6a4fed9772b67fbf,0,Sebastian Schelter,2013-06-13 19:52:12+00:00,['33af892642740f01291ea88ed30bebe2626270d6'],0,2,2,1280998,2,,,,2716
11321f7cccac0e32c90d0fecb132351aca69a1bc,0,Sebastian Schelter,2013-06-13 20:10:44+00:00,['727ddf6a52b5341d79f364ef6a4fed9772b67fbf'],0,6,6,1281004,6,,,,2716
4cd0064939fb84bf343e3cff9401f37d8870df9f,1,smarthi,2013-06-15 04:40:02+00:00,['11321f7cccac0e32c90d0fecb132351aca69a1bc'],1,66,67,1281071,3,0.027027027,1,1,2716
8460c0cbcf029beaa64f082e73d2a45f0b05f342,1,smarthi,2013-06-15 13:25:35+00:00,['4cd0064939fb84bf343e3cff9401f37d8870df9f'],11,23,34,1281105,1,0,1,1,2716
6b6b8a0211bb1cf6ba201e05e687ac8c1f97666f,1,dfilimon,2013-06-16 16:21:09+00:00,['8460c0cbcf029beaa64f082e73d2a45f0b05f342'],49,94,143,1281248,8,0.5,1,1,2716
eb78d61e6f74fd1ae3102729667d605ee2b63ee9,0,dfilimon,2013-06-16 17:04:08+00:00,['6b6b8a0211bb1cf6ba201e05e687ac8c1f97666f'],6,8,14,1281262,2,,,,2716
7f431a0494c6ab1c7f3ded7f45f3b3890c38ef28,1,dfilimon,2013-06-16 18:03:05+00:00,['eb78d61e6f74fd1ae3102729667d605ee2b63ee9'],6,10,16,1281278,2,1,1,1,2716
16e1e41ef34631e96d911b4a2081da6525204e5a,0,smarthi,2013-06-16 19:12:51+00:00,['7f431a0494c6ab1c7f3ded7f45f3b3890c38ef28'],0,17,17,1281295,1,,,,2716
4aed7cce0f7ff2c34348ac8d101e706838199598,1,Sebastian Schelter,2013-06-17 05:59:13+00:00,['16e1e41ef34631e96d911b4a2081da6525204e5a'],102,89,191,1281486,6,1,0,0.933333333,2716
9152a13729be2c43f6d275c5cc7f2c845777e14b,1,Sebastian Schelter,2013-06-17 07:08:02+00:00,['4aed7cce0f7ff2c34348ac8d101e706838199598'],58,100,158,1281644,16,1,1,0,2716
157bca3ba477b0f1480958b11f9d8950e7c841aa,1,Robin Anil,2013-06-18 03:45:48+00:00,['9152a13729be2c43f6d275c5cc7f2c845777e14b'],16,77,93,1281737,1,0,1,0.956521739,2716
335a993715963616980d746f9d80d28f0c22fabe,1,Sean R. Owen,2013-06-22 14:20:36+00:00,['157bca3ba477b0f1480958b11f9d8950e7c841aa'],91,98,189,1281926,46,0,0,0,2716
d711ac12007394a990e0dbc7c5cb8426a20eacdd,1,smarthi,2013-06-23 18:15:56+00:00,['335a993715963616980d746f9d80d28f0c22fabe'],218,1168,1386,1283312,11,0.168738899,0.648312611,0.552397869,2720
f656195b54f0ebddbd4c1aa65c8db22ce30a0f49,0,smarthi,2013-06-24 04:49:10+00:00,['d711ac12007394a990e0dbc7c5cb8426a20eacdd'],1,0,1,1283313,1,,,,2720
22533ae66540ba3d86167b20f859095fd640f995,1,smarthi,2013-06-24 05:35:27+00:00,['f656195b54f0ebddbd4c1aa65c8db22ce30a0f49'],67,70,137,1283450,8,1,0,0,2720
53fe357aba3194ae1cf3a28e056e948a629d640f,0,smarthi,2013-06-24 15:04:47+00:00,['22533ae66540ba3d86167b20f859095fd640f995'],2,2,4,1283454,2,,,,2720
d49d4c8a2d8f19c84f5f7b5543d2aa427390f0c6,0,smarthi,2013-06-24 16:54:31+00:00,['53fe357aba3194ae1cf3a28e056e948a629d640f'],7,2,9,1283463,3,1,0,0,2720
7ee9154fa43f2550ce64bb81f3e2bcbaec04feda,0,Sebastian Schelter,2013-06-25 12:00:57+00:00,['d49d4c8a2d8f19c84f5f7b5543d2aa427390f0c6'],1,3,4,1283467,2,,,,2720
13aa5273ea661af61f19096067ec1fefa97a790e,0,smarthi,2013-06-25 16:40:50+00:00,['7ee9154fa43f2550ce64bb81f3e2bcbaec04feda'],0,2,2,1283469,1,,,,2720
3ea5a17fb5218699ae361c52a67318480d1d12be,1,smarthi,2013-06-25 18:57:25+00:00,['13aa5273ea661af61f19096067ec1fefa97a790e'],18,16,34,1283503,4,0,0,0,2720
c533e9376d40736c1cd95f4ed58b4c28ed3da697,0,smarthi,2013-06-25 18:57:50+00:00,['3ea5a17fb5218699ae361c52a67318480d1d12be'],0,2,2,1283505,1,,,,2720
656537eb4a62a5d4afe0f35597883105aa05b490,0,sslavic,2013-06-26 00:10:58+00:00,['c533e9376d40736c1cd95f4ed58b4c28ed3da697'],0,0,0,1283505,0,,,,2720
b44256efca249c6b3b7b16dc3106db1c82e068a1,0,sslavic,2013-06-26 00:35:37+00:00,['656537eb4a62a5d4afe0f35597883105aa05b490'],1,1,2,1283507,1,,,,2720
74078b68af6456a19db6ae8f7c49f52adffeae2d,1,smarthi,2013-06-26 13:34:45+00:00,['b44256efca249c6b3b7b16dc3106db1c82e068a1'],211,206,417,1283924,6,0.823529412,0.882352941,0.117647059,2720
efe408bafef6edd3076d35ea85117a032d136879,0,smarthi,2013-06-26 13:35:11+00:00,['74078b68af6456a19db6ae8f7c49f52adffeae2d'],28,28,56,1283980,1,1,1,0,2720
b35e54fb71bfcbd5563d06eea5145fab5ec9ad1d,1,Robin Anil,2013-06-27 22:32:02+00:00,['efe408bafef6edd3076d35ea85117a032d136879'],156,422,578,1284558,4,0.359550562,0,0.651685393,2722
99a5ce8c56a168084a5f4f0ae26ae1032bcefa79,0,smarthi,2013-06-28 00:10:00+00:00,['b35e54fb71bfcbd5563d06eea5145fab5ec9ad1d'],9,3,12,1284570,3,1,1,1,2722
cb9a9eab9ff7dacd3efc7df149f2d1db6ba6dbeb,0,smarthi,2013-06-28 01:33:54+00:00,['99a5ce8c56a168084a5f4f0ae26ae1032bcefa79'],30,23,53,1284623,2,1,1,0.142857143,2722
9d7d6151ccc387fde6bbe092d2cedffafcc7c77e,0,smarthi,2013-06-28 03:58:28+00:00,['cb9a9eab9ff7dacd3efc7df149f2d1db6ba6dbeb'],1,1,2,1284625,1,,,,2722
eae8c6c84b8a6481d1c16feb9c6627ef6dc03ee0,0,smarthi,2013-06-28 04:02:04+00:00,['9d7d6151ccc387fde6bbe092d2cedffafcc7c77e'],0,2,2,1284627,1,,,,2722
4a8ffdc594c84eefcdd03d087403f231e37fffea,0,sslavic,2013-07-05 19:00:36+00:00,['eae8c6c84b8a6481d1c16feb9c6627ef6dc03ee0'],1,0,1,1284628,1,,,,2722
3173c6a2ffd19df9a732a0dbb976293fe25ed457,0,sslavic,2013-07-05 19:01:56+00:00,['4a8ffdc594c84eefcdd03d087403f231e37fffea'],1,0,1,1284629,1,,,,2722
2880d6a27b31dd52f175222a8da02395f4e00552,0,sslavic,2013-07-05 19:08:47+00:00,['3173c6a2ffd19df9a732a0dbb976293fe25ed457'],26,26,52,1284681,1,,,,2722
5febdc5554ad0479ae8a9125b887fe192452116e,0,sslavic,2013-07-05 19:46:10+00:00,['2880d6a27b31dd52f175222a8da02395f4e00552'],16,16,32,1284713,1,,,,2722
371bef607ac191a6f90ef366a42d912325f7f0f5,0,sslavic,2013-07-05 20:02:11+00:00,['5febdc5554ad0479ae8a9125b887fe192452116e'],12,8,20,1284733,1,,,,2722
f9c7de41950c5ed764831207acf96be2ecc3f8c1,0,sslavic,2013-07-05 20:10:26+00:00,['371bef607ac191a6f90ef366a42d912325f7f0f5'],1,0,1,1284734,1,,,,2722
2f9697f89c61f77e8474f647812f11aed46c46dc,0,sslavic,2013-07-05 20:16:53+00:00,['f9c7de41950c5ed764831207acf96be2ecc3f8c1'],0,1,1,1284735,1,,,,2722
a362bb5876ede0c14352297cee46dd763b3dc555,0,sslavic,2013-07-05 20:30:46+00:00,['2f9697f89c61f77e8474f647812f11aed46c46dc'],8,4,12,1284747,1,,,,2722
54025dfac4d3edfc28dc63b9d58bcb1924edb817,0,sslavic,2013-07-05 20:32:42+00:00,['a362bb5876ede0c14352297cee46dd763b3dc555'],6,6,12,1284759,1,,,,2722
47576b7da37c68bd32e9e9144ee5b6220da20570,0,sslavic,2013-07-05 20:53:20+00:00,['54025dfac4d3edfc28dc63b9d58bcb1924edb817'],3,4,7,1284766,1,,,,2722
cd13dfd89072713c491edd0b61e9461f04396f32,1,sslavic,2013-07-05 23:00:04+00:00,['47576b7da37c68bd32e9e9144ee5b6220da20570'],243,281,524,1285290,4,,,,2722
f7feb2328f49af2f136d3af6c969fc5fc8d916d4,0,sslavic,2013-07-05 23:03:18+00:00,['cd13dfd89072713c491edd0b61e9461f04396f32'],7,8,15,1285305,1,,,,2722
ff32b1adca4dcf123924c1b538ee83cda21f8fdd,0,sslavic,2013-07-05 23:09:10+00:00,['f7feb2328f49af2f136d3af6c969fc5fc8d916d4'],8,4,12,1285317,1,,,,2722
4e71b72cc609ee245a8da19d85e68810221b4c55,0,sslavic,2013-07-05 23:12:04+00:00,['ff32b1adca4dcf123924c1b538ee83cda21f8fdd'],0,6,6,1285323,1,,,,2722
bf1e899d328df636b8bd3ef5f726ff955b2626a6,0,sslavic,2013-07-06 06:45:42+00:00,['4e71b72cc609ee245a8da19d85e68810221b4c55'],0,13,13,1285336,1,,,,2722
8e68ee590688fef4ac214906f191ded0ff827f57,0,sslavic,2013-07-06 07:00:20+00:00,['bf1e899d328df636b8bd3ef5f726ff955b2626a6'],12,12,24,1285360,1,,,,2722
60a602d00536dbd3c828261c8f21d24e9eda0689,0,sslavic,2013-07-06 07:30:00+00:00,['8e68ee590688fef4ac214906f191ded0ff827f57'],1,1,2,1285362,1,,,,2722
0c9478ece1a4161c8c0ef0a75ad42cec5c560e2c,0,smarthi,2013-07-06 18:53:37+00:00,['60a602d00536dbd3c828261c8f21d24e9eda0689'],2,0,2,1285364,1,,,,2722
097ec69706778c041aa3d9d949b7cf003b2bebf6,0,sslavic,2013-07-07 16:34:02+00:00,['0c9478ece1a4161c8c0ef0a75ad42cec5c560e2c'],0,1,1,1285365,1,,,,2722
81f7dfa09091102911e1707082a30b9962a60034,1,Sebastian Schelter,2013-07-07 23:51:07+00:00,['097ec69706778c041aa3d9d949b7cf003b2bebf6'],0,694,694,1286059,3,0.289672544,0.904282116,0.881612091,2724
27a4d3f97549e222b07edcd9f2e5bac099bebbbe,0,Grant Ingersoll,2013-07-08 01:55:39+00:00,['81f7dfa09091102911e1707082a30b9962a60034'],12,18,30,1286089,7,,,,2724
060e6cf4091a4bcc7e9d30d12211d74eb02d45b6,0,Grant Ingersoll,2013-07-08 01:55:50+00:00,['27a4d3f97549e222b07edcd9f2e5bac099bebbbe'],17,10,27,1286116,7,,,,2724
eb465f42c91eaedb50030ae19c24315c621b8833,0,sslavic,2013-07-08 19:30:01+00:00,['060e6cf4091a4bcc7e9d30d12211d74eb02d45b6'],3,5,8,1286124,3,,,,2724
7619995a0ab5a5faf95c7c61dd66bb3180721c37,0,sslavic,2013-07-09 07:03:04+00:00,['eb465f42c91eaedb50030ae19c24315c621b8833'],5,3,8,1286132,3,,,,2724
f43adfea425fe2a34f4c845df6fe7dbea5f68261,1,Dmitriy Lyubimov,2013-07-25 23:09:58+00:00,['7619995a0ab5a5faf95c7c61dd66bb3180721c37'],54,163,217,1286349,11,0.698113208,1,0.849056604,2726
bc8eafdd518b121fc79377b67537f7b0b08d38c7,1,Dmitriy Lyubimov,2013-07-25 23:31:43+00:00,['f43adfea425fe2a34f4c845df6fe7dbea5f68261'],175,86,261,1286610,6,0.272727273,0.272727273,0,2726
5b56a529b9ed4e17b68283aeb1f139fa5869a4a6,0,sslavic,2013-07-26 17:22:20+00:00,['bc8eafdd518b121fc79377b67537f7b0b08d38c7'],3,5,8,1286618,3,,,,2726
9676d7a5a55b1efc6ad64ce6e93c94e2e3cc38de,0,sslavic,2013-07-26 17:43:26+00:00,['5b56a529b9ed4e17b68283aeb1f139fa5869a4a6'],0,3,3,1286621,2,,,,2726
00d3d83ced62377a356a478bfe115c6430f4b2b3,0,Sean R. Owen,2013-07-26 18:59:46+00:00,['9676d7a5a55b1efc6ad64ce6e93c94e2e3cc38de'],0,1,1,1286622,1,0,0,1,2726
9e9ffd32f64e02ddb1a114e7df21108fba2f873e,0,smarthi,2013-07-26 19:19:16+00:00,['00d3d83ced62377a356a478bfe115c6430f4b2b3'],1,3,4,1286626,1,,,,2726
824b430f40bfb770c0782471f7c1cc86322808e7,0,smarthi,2013-07-26 20:12:19+00:00,['9e9ffd32f64e02ddb1a114e7df21108fba2f873e'],5,6,11,1286637,3,,,,2726
e21ebcb20115462c7d8d6b513769f11b22f631b6,0,smarthi,2013-07-26 20:12:48+00:00,['824b430f40bfb770c0782471f7c1cc86322808e7'],0,2,2,1286639,1,,,,2726
771b3138b033eb28315c9a9d7f94fe6f124e856f,0,sslavic,2013-07-26 20:29:58+00:00,['e21ebcb20115462c7d8d6b513769f11b22f631b6'],0,28,28,1286667,2,,,,2726
dc88c8d37bd735280f01b7ec24934f3c7f8cc67d,0,sslavic,2013-07-26 21:33:23+00:00,['771b3138b033eb28315c9a9d7f94fe6f124e856f'],0,3,3,1286670,1,,,,2726
9dbb1a04e29b222f4dd9bbad8ab21a42e36e7e75,1,sslavic,2013-07-26 23:03:39+00:00,['dc88c8d37bd735280f01b7ec24934f3c7f8cc67d'],2,4,6,1286676,3,,,,2726
c3e0b8c5bee2314e3c4799f7fac411f6f38a3f70,1,smarthi,2013-07-27 05:07:51+00:00,['9dbb1a04e29b222f4dd9bbad8ab21a42e36e7e75'],11,40,51,1286727,3,1,1,1,2726
125d2e386b7fc07e1b34c3d79670767f6c129fb1,0,smarthi,2013-07-29 04:15:02+00:00,['c3e0b8c5bee2314e3c4799f7fac411f6f38a3f70'],36,122,158,1286885,3,0.4,0.4,1,2727
1e8951f6a806b4d2fb1b317b84db9be95d3050f6,0,Sebastian Schelter,2013-07-29 07:03:02+00:00,['125d2e386b7fc07e1b34c3d79670767f6c129fb1'],57,57,114,1286999,3,1,1,0.285714286,2727
b60c9090cf6823b04b8608b4b21b003e3d5367d6,0,Sebastian Schelter,2013-07-29 07:39:53+00:00,['1e8951f6a806b4d2fb1b317b84db9be95d3050f6'],23846,59,23905,1310904,220,0.647018739,0.280664395,0.273168654,2727
7d4faa844189899eaccf69aa58c86dcf437e1a56,0,Sebastian Schelter,2013-07-29 07:45:57+00:00,['b60c9090cf6823b04b8608b4b21b003e3d5367d6'],0,0,0,1310904,0,,,,2727
7820b672466e2c6ba55b8c8d6c12ebe0eafb287f,0,smarthi,2013-07-29 23:36:53+00:00,['7d4faa844189899eaccf69aa58c86dcf437e1a56'],11,2,13,1310917,1,,,,2727
e90d90134e9b2d32ab61a6ab31a05f84d0b816d7,1,Sebastian Schelter,2013-07-30 05:15:22+00:00,['7820b672466e2c6ba55b8c8d6c12ebe0eafb287f'],91,172,263,1311180,11,0.074074074,0.555555556,1,2727
ed2321df8ada6e1c1d219186da99301073846810,0,Sebastian Schelter,2013-07-30 13:59:45+00:00,['e90d90134e9b2d32ab61a6ab31a05f84d0b816d7'],0,38,38,1311218,1,1,1,0,2728
0116ebdc0d12b4ff941dc13568e99503f1878b35,0,Sebastian Schelter,2013-07-31 05:08:41+00:00,['ed2321df8ada6e1c1d219186da99301073846810'],38,0,38,1311256,4,,,,2728
cd829a2c43a6866179abe58ce12a4133b932c65c,1,Dmitriy Lyubimov,2013-07-31 05:41:29+00:00,['0116ebdc0d12b4ff941dc13568e99503f1878b35'],1,111,112,1311368,3,0.555555556,1,1,2730
f494f8f34cf589fe6dff8d48f5a5886452297727,1,Dmitriy Lyubimov,2013-07-31 05:55:10+00:00,['cd829a2c43a6866179abe58ce12a4133b932c65c'],3,28,31,1311399,2,1,1,1,2730
8269b08176ec734c875141656b05a7b99c88c465,1,Sean R. Owen,2013-07-31 06:58:26+00:00,['f494f8f34cf589fe6dff8d48f5a5886452297727'],27,16,43,1311442,5,,,,2730
3241531314b2e388f84ccce2f1b3c6b0311a2323,0,smarthi,2013-08-01 16:34:44+00:00,['8269b08176ec734c875141656b05a7b99c88c465'],22,2,24,1311466,1,,,,2730
0833411f3286b20ce1d6c936d16ab43cfa711aee,1,smarthi,2013-08-01 21:46:53+00:00,['3241531314b2e388f84ccce2f1b3c6b0311a2323'],36,72,108,1311574,8,1,1,1,2730
faefa0c2a634afbe59e65a3e3e504efa6a9b02d1,0,smarthi,2013-08-01 21:47:48+00:00,['0833411f3286b20ce1d6c936d16ab43cfa711aee'],1,3,4,1311578,1,,,,2730
a1e815eced1a1455c3462dd9ae860570d0262c68,0,Sean R. Owen,2013-08-05 13:53:54+00:00,['faefa0c2a634afbe59e65a3e3e504efa6a9b02d1'],1,1,2,1311580,1,,,,2730
b717cfc0d9720607517e0380eb6cb8e8ee13bde4,0,Dmitriy Lyubimov,2013-08-08 06:05:32+00:00,['a1e815eced1a1455c3462dd9ae860570d0262c68'],283,401,684,1312264,9,0,0.532608696,0.402173913,2731
841b783a043a5b122d5eb72d9b8c3195e6331001,1,sslavic,2013-08-13 20:08:16+00:00,['b717cfc0d9720607517e0380eb6cb8e8ee13bde4'],2,4,6,1312270,2,,,,2731
b89d1c35301bd6032a388b429c7e699d615dd6ac,0,sslavic,2013-08-13 21:46:24+00:00,['841b783a043a5b122d5eb72d9b8c3195e6331001'],1,1,2,1312272,1,,,,2731
e70534f7a4ec2b54ec768ac7ab901471c449283f,0,sslavic,2013-08-18 16:31:06+00:00,['b89d1c35301bd6032a388b429c7e699d615dd6ac'],0,17,17,1312289,1,,,,2731
f868a68b7eb416a6eab16c1bc5111a9304abda78,0,Sebastian Schelter,2013-08-27 04:34:12+00:00,['e70534f7a4ec2b54ec768ac7ab901471c449283f'],1,3,4,1312293,1,,,,2731
5741b1e318b22e438ca1eeb91925bc4baee70b64,0,sslavic,2013-08-27 11:43:34+00:00,['f868a68b7eb416a6eab16c1bc5111a9304abda78'],1,1,2,1312295,1,,,,2731
fcc3260b5a1e83ef05302f2eb6b7d4fd40fad1ef,1,sslavic,2013-08-27 21:16:15+00:00,['5741b1e318b22e438ca1eeb91925bc4baee70b64'],2,20,22,1312317,1,0,1,1,2731
31f58654d63d42bbda1d7e912b6f95efb6120627,1,sslavic,2013-08-28 19:35:36+00:00,['fcc3260b5a1e83ef05302f2eb6b7d4fd40fad1ef'],39,74,113,1312430,3,1,1,0,2731
09127f56c636ee637eb1f07d0eba3440b6712f10,0,sslavic,2013-08-30 09:21:22+00:00,['31f58654d63d42bbda1d7e912b6f95efb6120627'],1,1,2,1312432,1,,,,2731
6cd9cc6a8d1e532428172d8c54f492780cbf5b7a,0,sslavic,2013-08-30 10:11:36+00:00,['09127f56c636ee637eb1f07d0eba3440b6712f10'],3,0,3,1312435,1,,,,2731
c8f9f08756d150c5a46f445a17304919b9e41f95,0,sslavic,2013-08-30 10:12:39+00:00,['6cd9cc6a8d1e532428172d8c54f492780cbf5b7a'],1,1,2,1312437,1,,,,2731
c029e29adc9db2f7a2471358b2b5a061093cfb02,0,sslavic,2013-08-30 12:34:20+00:00,['c8f9f08756d150c5a46f445a17304919b9e41f95'],1,0,1,1312438,1,,,,2731
ff27b1223d4d5453fd2906adcf72b9a747680e10,0,sslavic,2013-08-30 15:38:37+00:00,['c029e29adc9db2f7a2471358b2b5a061093cfb02'],2,2,4,1312442,1,,,,2731
b381afd170e9cc4163736bfa71ddae77701a0816,0,sslavic,2013-08-30 23:16:35+00:00,['ff27b1223d4d5453fd2906adcf72b9a747680e10'],45,29,74,1312516,17,,,,2731
3828ebf93ec969d4a7f819383025bfb91ad9a741,0,sslavic,2013-09-07 18:42:14+00:00,['b381afd170e9cc4163736bfa71ddae77701a0816'],3,3,6,1312522,1,,,,2731
de46e0eae6d0ea4a38224707e901ecd295446493,0,sslavic,2013-09-07 19:04:27+00:00,['3828ebf93ec969d4a7f819383025bfb91ad9a741'],1,1,2,1312524,1,,,,2731
6b4f770852690e1d34fe43e0db37628137d6c82d,0,sslavic,2013-09-07 20:19:47+00:00,['de46e0eae6d0ea4a38224707e901ecd295446493'],1,1,2,1312526,1,,,,2731
ae0d0d872fed2966ef12a5cf71ac9f5960f5828c,0,sslavic,2013-09-10 19:59:43+00:00,['6b4f770852690e1d34fe43e0db37628137d6c82d'],1,1,2,1312528,1,,,,2731
2a2bf0b031c4469027045b22ec4f31aa3de55a4b,1,sslavic,2013-09-12 22:47:47+00:00,['ae0d0d872fed2966ef12a5cf71ac9f5960f5828c'],3,3,6,1312534,1,,,,2731
2d5c5a18b7dd46479303dbacc73f6352f595f0b1,0,sslavic,2013-09-13 18:06:27+00:00,['2a2bf0b031c4469027045b22ec4f31aa3de55a4b'],1,1,2,1312536,1,,,,2731
34795fc34ca1a67262c0c8a8e76002b370c74ef1,0,sslavic,2013-09-13 18:51:17+00:00,['2d5c5a18b7dd46479303dbacc73f6352f595f0b1'],1,1,2,1312538,1,,,,2731
c91c0a525b17efd583e2db9587ed1636f4a8d6b8,0,sslavic,2013-09-13 18:52:33+00:00,['34795fc34ca1a67262c0c8a8e76002b370c74ef1'],1,1,2,1312540,1,,,,2731
411a86eb6e47ca9ac5c33af87d59e2380475a4db,0,sslavic,2013-09-13 18:53:29+00:00,['c91c0a525b17efd583e2db9587ed1636f4a8d6b8'],1,1,2,1312542,1,,,,2731
131c84c923edbb949e2066761c88e8ea79763e99,0,sslavic,2013-09-13 18:59:24+00:00,['411a86eb6e47ca9ac5c33af87d59e2380475a4db'],44,43,87,1312629,19,,,,2731
ca3300f23f47bc44b20a0ae55815ad003756463e,0,sslavic,2013-09-14 00:51:06+00:00,['131c84c923edbb949e2066761c88e8ea79763e99'],1,1,2,1312631,1,,,,2731
82bbf156a58baa2b45a3f76ff6c886ee3fdf395b,0,Sebastian Schelter,2013-09-17 05:43:04+00:00,['ca3300f23f47bc44b20a0ae55815ad003756463e'],6,13,19,1312650,1,1,1,1,2731
bf1d130e3e221512b764f7a321ba608dd7efbcb2,0,Sebastian Schelter,2013-09-17 05:48:03+00:00,['82bbf156a58baa2b45a3f76ff6c886ee3fdf395b'],3,2,5,1312655,1,0,0,0,2731
00566b139ec2bf0355864b333a8331b6fac1add9,1,sslavic,2013-09-17 14:35:02+00:00,['bf1d130e3e221512b764f7a321ba608dd7efbcb2'],0,5,5,1312660,3,,,,2731
9abf7557ca81150d98dec2ac44543ef39af4f31c,0,sslavic,2013-09-17 16:21:30+00:00,['00566b139ec2bf0355864b333a8331b6fac1add9'],5,45,50,1312710,4,0.636363636,0.636363636,1,2731
b3d25547b6232ece8e77ee034b1248aaff52f108,0,sslavic,2013-09-17 18:47:23+00:00,['9abf7557ca81150d98dec2ac44543ef39af4f31c'],0,3,3,1312713,1,1,1,1,2731
ce272b232d75d13b3812ad1f06a65b8ff8156cc7,0,sslavic,2013-09-18 12:44:18+00:00,['b3d25547b6232ece8e77ee034b1248aaff52f108'],4,0,4,1312717,1,,,,2731
3231e8b074c810b013e301d3c060ed03e86706ce,0,sslavic,2013-09-19 22:12:29+00:00,['ce272b232d75d13b3812ad1f06a65b8ff8156cc7'],1,1,2,1312719,1,,,,2731
d45c030478b733f37f32c6cc770ddfe4ce8b1c2b,0,sslavic,2013-09-20 02:36:11+00:00,['3231e8b074c810b013e301d3c060ed03e86706ce'],1,1,2,1312721,1,,,,2731
7923646ecb3359aa81d905ac2ad98ecf6f71a605,1,Sean R. Owen,2013-09-20 10:52:42+00:00,['d45c030478b733f37f32c6cc770ddfe4ce8b1c2b'],35,18,53,1312774,2,,,,2731
1cdd0956f8e82c9ffea5058b3b017bfe3fde55cc,1,Sean R. Owen,2013-09-21 08:28:25+00:00,['7923646ecb3359aa81d905ac2ad98ecf6f71a605'],8,638,646,1313420,39,,,,2731
f7d1c10588df3e31be6b88f18752b443d5102261,1,Sean R. Owen,2013-09-21 09:17:59+00:00,['1cdd0956f8e82c9ffea5058b3b017bfe3fde55cc'],2,2,4,1313424,2,,,,2731
13a20a5a3ab25cbdcd7129866f612136fc7f73a0,0,sslavic,2013-09-22 21:28:55+00:00,['f7d1c10588df3e31be6b88f18752b443d5102261'],1,1,2,1313426,1,,,,2731
4fc5ff5924ecf1ec07c9727b0b1825185ad0e19e,0,sslavic,2013-09-22 21:44:47+00:00,['13a20a5a3ab25cbdcd7129866f612136fc7f73a0'],4,4,8,1313434,1,,,,2731
a5bc1b248b3bceee85278bb06348a165a2f300b8,0,sslavic,2013-09-22 22:34:51+00:00,['4fc5ff5924ecf1ec07c9727b0b1825185ad0e19e'],1,1,2,1313436,1,,,,2731
b2d204fcac71a6e76cfb249b27c25f0f5d961451,0,sslavic,2013-09-22 23:07:23+00:00,['a5bc1b248b3bceee85278bb06348a165a2f300b8'],1,1,2,1313438,1,,,,2731
2f22cc7a8e4a80b37fedb4b7b7f39b561da90845,0,sslavic,2013-09-22 23:08:43+00:00,['b2d204fcac71a6e76cfb249b27c25f0f5d961451'],1,1,2,1313440,1,,,,2731
f7ddce5bedabc1a5dd548f47a64306e5b9fd63b6,0,sslavic,2013-09-22 23:09:54+00:00,['2f22cc7a8e4a80b37fedb4b7b7f39b561da90845'],1,1,2,1313442,1,,,,2731
cbae1e8b5de643277439ebe67a6d15288514057e,0,sslavic,2013-09-24 03:03:01+00:00,['f7ddce5bedabc1a5dd548f47a64306e5b9fd63b6'],11,13,24,1313466,1,,,,2731
5592426ee15d7b81dcc3d8213704be47fe113227,1,Sean R. Owen,2013-09-24 12:05:33+00:00,['cbae1e8b5de643277439ebe67a6d15288514057e'],3,35,38,1313504,2,1,1,1,2731
a2afabff4602fc08d0b67876e0daacab36d156da,0,sslavic,2013-09-24 23:04:07+00:00,['5592426ee15d7b81dcc3d8213704be47fe113227'],0,5,5,1313509,1,,,,2731
5a5acf0697de2bf4d44e3f28e8cba69210855a67,0,Sean R. Owen,2013-10-03 07:01:10+00:00,['a2afabff4602fc08d0b67876e0daacab36d156da'],1,16,17,1313526,1,1,1,1,2731
e0a4f02fe67abe9d836984366433f58b48d3e5ae,0,sslavic,2013-10-06 17:23:40+00:00,['5a5acf0697de2bf4d44e3f28e8cba69210855a67'],1,1,2,1313528,1,,,,2731
9d58fc8500a3a48a806ae2ebdb41d9d64dc22572,0,sslavic,2013-10-06 17:28:51+00:00,['e0a4f02fe67abe9d836984366433f58b48d3e5ae'],1,0,1,1313529,1,,,,2731
e8f1e701d25144d81cd0195a9f5fbc9458dd6f9a,0,sslavic,2013-10-06 17:55:16+00:00,['9d58fc8500a3a48a806ae2ebdb41d9d64dc22572'],0,0,0,1313529,0,,,,2731
3032e7b893d56adc630134652c2377ab65920ee0,1,Dmitriy Lyubimov,2013-10-07 20:17:47+00:00,['e8f1e701d25144d81cd0195a9f5fbc9458dd6f9a'],14,439,453,1313982,6,1,1,0.782352941,2735
7f7ff5e8ba17c6c8d625c33b8f05e606fc9f71e3,0,sslavic,2013-10-07 22:07:02+00:00,['3032e7b893d56adc630134652c2377ab65920ee0'],8,8,16,1313998,1,,,,2735
1a38c2339ab6749dfcc6810d94e1793beb82f6ef,0,sslavic,2013-10-27 14:33:11+00:00,['7f7ff5e8ba17c6c8d625c33b8f05e606fc9f71e3'],1,1,2,1314000,1,,,,2735
921e2015ef96bc9655c9d821e051d6c0d2e99045,1,sslavic,2013-10-27 22:42:41+00:00,['1a38c2339ab6749dfcc6810d94e1793beb82f6ef'],72,81,153,1314153,41,0.75,1,1,2735
e56c7ff17a2385076e8a05f36d9a63adf4f078ec,1,sslavic,2013-11-03 17:48:57+00:00,['921e2015ef96bc9655c9d821e051d6c0d2e99045'],1,210,211,1314364,4,0.447916667,1,0.635416667,2736
5c9a671d5f511bc01eae6f950023583f3be90182,0,smarthi,2013-11-03 19:20:18+00:00,['e56c7ff17a2385076e8a05f36d9a63adf4f078ec'],4,4,8,1314372,1,,,,2736
abbf629a5d31dc5151bb3c394284f4773c816560,1,smarthi,2013-11-03 19:30:34+00:00,['5c9a671d5f511bc01eae6f950023583f3be90182'],9,8,17,1314389,2,,,,2736
e8cd2306709625bd0f2ed3e4e768f510a4343b96,0,sslavic,2013-11-03 20:10:51+00:00,['abbf629a5d31dc5151bb3c394284f4773c816560'],3,11,14,1314403,3,0,1,1,2736
072f1ae98e47b54aa751499832f60961ebe9677a,0,Sebastian Schelter,2013-11-07 14:59:14+00:00,['e8cd2306709625bd0f2ed3e4e768f510a4343b96'],1,2,3,1314406,1,,,,2736
9e6098a25b1968d239502651d634f92836eed1bb,0,Sebastian Schelter,2013-11-08 13:31:54+00:00,['072f1ae98e47b54aa751499832f60961ebe9677a'],1,7,8,1314414,1,0,0,1,2736
02ecad17bac6be42eb946fcc029d10dda283b57c,1,Dmitriy Lyubimov,2013-11-12 00:50:47+00:00,['9e6098a25b1968d239502651d634f92836eed1bb'],0,1697,1697,1316111,20,0.907936508,1,0.650793651,2755
91095865ff06c3b77efcb3d9514df10f70f95912,0,smarthi,2013-11-15 14:48:18+00:00,['02ecad17bac6be42eb946fcc029d10dda283b57c'],3,33,36,1316147,3,0.928571429,1,0.928571429,2755
3cc95f4fc8e167417e12def3948b13bd7e1f57f6,1,smarthi,2013-11-16 19:09:35+00:00,['91095865ff06c3b77efcb3d9514df10f70f95912'],27,83,110,1316257,9,0.741935484,1,1,2755
f739dca9e8d666e52d7388ad53dae1293d934ae5,1,smarthi,2013-11-16 21:56:39+00:00,['3cc95f4fc8e167417e12def3948b13bd7e1f57f6'],0,40,40,1316297,1,1,1,1,2756
770b5af25e1fbeaf5b273f1c74433dacddd0104a,1,smarthi,2013-11-17 05:14:56+00:00,['f739dca9e8d666e52d7388ad53dae1293d934ae5'],4,12,16,1316313,1,0,0,1,2756
e1bb0027ba261e3822d379914ab3ab4bcf7b8aeb,1,smarthi,2013-11-17 05:45:04+00:00,['770b5af25e1fbeaf5b273f1c74433dacddd0104a'],1,70,71,1316384,3,0.173076923,1,1,2756
0c1b4a1e07fa6be269615c08a3813af04a71d46e,0,smarthi,2013-11-18 07:50:29+00:00,['e1bb0027ba261e3822d379914ab3ab4bcf7b8aeb'],4,16,20,1316404,2,1,1,1,2756
40907b1f5cbf02a6eb64cce11e1fcaa27f6c4f18,1,smarthi,2013-11-18 17:54:35+00:00,['0c1b4a1e07fa6be269615c08a3813af04a71d46e'],12,28,40,1316444,2,0,0,1,2756
17ab609eac44fd5f539f10604c664a2cbfee98fe,0,smarthi,2013-11-18 19:24:29+00:00,['40907b1f5cbf02a6eb64cce11e1fcaa27f6c4f18'],25,2,27,1316471,2,,,,2756
f75ea67e61cfbd25c2bf1dc094ae6c739831bb43,0,Sebastian Schelter,2013-11-20 21:52:53+00:00,['17ab609eac44fd5f539f10604c664a2cbfee98fe'],3,2,5,1316476,1,1,1,1,2756
f1c99aa6a03880f80f483d24ac46a0d097a130b5,0,smarthi,2013-11-21 23:29:09+00:00,['f75ea67e61cfbd25c2bf1dc094ae6c739831bb43'],1,1,2,1316478,1,,,,2756
209714387177f289273d64d48ed6141b9d5aa1e2,0,smarthi,2013-11-21 23:30:22+00:00,['f1c99aa6a03880f80f483d24ac46a0d097a130b5'],3,1,4,1316482,1,,,,2756
682feb495ad2a18716afc11eff5d9138984e5b8d,1,smarthi,2013-11-22 00:15:46+00:00,['209714387177f289273d64d48ed6141b9d5aa1e2'],1,1,2,1316484,1,,,,2756
2e7c3198e4d9e5e3fce876da83c3ef0d2ce6423a,1,smarthi,2013-11-22 02:34:22+00:00,['682feb495ad2a18716afc11eff5d9138984e5b8d'],1,1,2,1316486,1,,,,2756
d72ba280d8ed202f60872e3b2cc9d167c7b6699d,0,smarthi,2013-11-22 03:38:02+00:00,['2e7c3198e4d9e5e3fce876da83c3ef0d2ce6423a'],0,2,2,1316488,1,,,,2756
cd167f96b31eec1c4e7affc0f188d06c753cd39c,1,smarthi,2013-11-22 20:56:08+00:00,['d72ba280d8ed202f60872e3b2cc9d167c7b6699d'],134,127,261,1316749,37,0,1,0,2756
018ec691f0f734aca79ba7353d6e8a2b731054e3,1,smarthi,2013-11-24 06:12:56+00:00,['cd167f96b31eec1c4e7affc0f188d06c753cd39c'],0,1527,1527,1318276,5,0.36770428,0.524319066,0.854085603,2760
b96e7ba8fab03745257d5feb6ab97247d6abcee8,0,smarthi,2013-11-24 06:17:24+00:00,['018ec691f0f734aca79ba7353d6e8a2b731054e3'],1,2,3,1318279,1,1,1,1,2760
cf8fec97f253a2e60db4d853231311320f612422,0,smarthi,2013-11-24 06:30:41+00:00,['b96e7ba8fab03745257d5feb6ab97247d6abcee8'],2,4,6,1318285,1,0,1,1,2760
b4e41ba3e745dabf6024a4a6f3f44c22a01cf1b7,0,smarthi,2013-11-24 07:02:17+00:00,['cf8fec97f253a2e60db4d853231311320f612422'],133,214,347,1318632,4,0.162790698,0.348837209,1,2760
ba4e9d9c999177f6a5fa85cc6461a982a34059a7,1,Dmitriy Lyubimov,2013-11-25 20:47:16+00:00,['b4e41ba3e745dabf6024a4a6f3f44c22a01cf1b7'],24,24,48,1318680,18,,,,2760
9c167fc0c2face25e6e8b90f0c065f9bf681b21f,0,sslavic,2013-11-26 23:53:34+00:00,['ba4e9d9c999177f6a5fa85cc6461a982a34059a7'],0,0,0,1318680,0,,,,2760
8e0495d48a7ba1eec21fa4e0d0afc2efa3ef8073,0,sslavic,2013-11-27 00:18:33+00:00,['9c167fc0c2face25e6e8b90f0c065f9bf681b21f'],0,0,0,1318680,0,,,,2760
beb2ff38a86224f7855f526dbbdaee3727db779e,1,smarthi,2013-11-27 23:27:11+00:00,['8e0495d48a7ba1eec21fa4e0d0afc2efa3ef8073'],2,20,22,1318702,1,,,,2760
fbf614367dafbe3229054d81b2c3817c50e94519,0,smarthi,2013-11-28 01:08:51+00:00,['beb2ff38a86224f7855f526dbbdaee3727db779e'],0,2,2,1318704,1,,,,2760
211edf2178cd44d027ab1ec9def58d0895725c88,1,smarthi,2013-11-28 05:44:44+00:00,['fbf614367dafbe3229054d81b2c3817c50e94519'],34,60,94,1318798,4,0.2,1,1,2760
6d8fbe246b46a1a935767bb4d2c8be7e27ec15a3,0,smarthi,2013-11-28 14:46:54+00:00,['211edf2178cd44d027ab1ec9def58d0895725c88'],2,44,46,1318844,3,1,1,1,2761
f2eb7e1b759bada8130cfc00b1d72d8f3b83febb,1,smarthi,2013-11-29 19:06:13+00:00,['6d8fbe246b46a1a935767bb4d2c8be7e27ec15a3'],52,83,135,1318979,3,1,1,1,2761
7016ff63856c8deffcf11b8f932b845e04160147,0,smarthi,2013-11-29 19:54:00+00:00,['f2eb7e1b759bada8130cfc00b1d72d8f3b83febb'],2,2,4,1318983,2,,,,2761
84326249883a55eb502c114a3149c52cf4297425,0,smarthi,2013-11-29 20:03:07+00:00,['7016ff63856c8deffcf11b8f932b845e04160147'],0,2,2,1318985,1,,,,2761
25efc4357261656d5edcbe0e2ae3852d5ebe6100,1,sslavic,2013-11-30 17:29:50+00:00,['84326249883a55eb502c114a3149c52cf4297425'],2,32,34,1319019,5,1,1,1,2761
62766057cc02d6550f854f13d77dc0a6629a7ac7,0,smarthi,2013-11-30 18:41:31+00:00,['25efc4357261656d5edcbe0e2ae3852d5ebe6100'],1,3,4,1319023,1,,,,2761
09b4ef12001f21f55089baf36a8a4281641cdd27,0,smarthi,2013-12-01 12:16:43+00:00,['62766057cc02d6550f854f13d77dc0a6629a7ac7'],19,26,45,1319068,1,0,0,1,2761
37201275a452d3f906eac6e10e5e6cd740b5ec0a,0,smarthi,2013-12-01 12:19:00+00:00,['09b4ef12001f21f55089baf36a8a4281641cdd27'],2,4,6,1319074,1,,,,2761
c88c240fc6bb33a8206ede54d4bb81c25e67066c,1,smarthi,2013-12-01 17:42:03+00:00,['37201275a452d3f906eac6e10e5e6cd740b5ec0a'],68,124,192,1319266,33,0,0.964285714,1,2761
343bd9b3a4935cad9c178b34639f1060938ef33a,1,smarthi,2013-12-01 17:43:43+00:00,['c88c240fc6bb33a8206ede54d4bb81c25e67066c'],1,12,13,1319279,2,,,,2761
fcaf1f5e6998ca1363a30582926488ef736148e3,1,smarthi,2013-12-01 17:48:41+00:00,['343bd9b3a4935cad9c178b34639f1060938ef33a'],9,14,23,1319302,2,,,,2761
802233b7a22a09a81a1bc9e6f1d68d7c5814da46,1,smarthi,2013-12-01 23:35:30+00:00,['fcaf1f5e6998ca1363a30582926488ef736148e3'],1,19,20,1319322,3,,,,2761
1e1175531c9c27f5f60e9e3ae06db387dfa79c3c,0,frankscholten,2013-12-02 18:39:21+00:00,['802233b7a22a09a81a1bc9e6f1d68d7c5814da46'],1,0,1,1319323,1,,,,2761
69178eb38fbb9cad0e32ff2cf36304f183dfb62c,0,smarthi,2013-12-03 03:43:21+00:00,['1e1175531c9c27f5f60e9e3ae06db387dfa79c3c'],1,0,1,1319324,1,,,,2761
fa2e343dd464293d7ff74d33f2997a079111c95a,0,sslavic,2013-12-03 16:49:40+00:00,['69178eb38fbb9cad0e32ff2cf36304f183dfb62c'],46,0,46,1319370,3,,,,2761
edd0725252f00c7ed89c8718967a9edc20916d55,0,sslavic,2013-12-03 16:51:51+00:00,['fa2e343dd464293d7ff74d33f2997a079111c95a'],5,0,5,1319375,1,,,,2761
7a5ffcb875367369a4270e3ed638daed60fc0b4d,0,sslavic,2013-12-03 19:31:47+00:00,['edd0725252f00c7ed89c8718967a9edc20916d55'],0,30,30,1319405,2,,,,2761
44200432b98a9e889858c818ffa4e8beaeb2c52a,0,smarthi,2013-12-04 00:36:57+00:00,['7a5ffcb875367369a4270e3ed638daed60fc0b4d'],0,4,4,1319409,2,0,0,1,2761
9ecac13b6221f4cce0326aee2dcff1b90e5896e8,0,smarthi,2013-12-04 05:10:33+00:00,['44200432b98a9e889858c818ffa4e8beaeb2c52a'],1,1,2,1319411,1,,,,2761
d0976522fc36999bbd1df82bdcbbb2c174539c09,0,smarthi,2013-12-04 06:13:54+00:00,['9ecac13b6221f4cce0326aee2dcff1b90e5896e8'],2,6,8,1319419,1,,,,2761
59dbea77e73ca8ea49d7ed346c1e6b7e06f89930,0,smarthi,2013-12-04 19:24:41+00:00,['d0976522fc36999bbd1df82bdcbbb2c174539c09'],47,0,47,1319466,1,,,,2761
58546105b5680bae0993fd9167fb97b1b65e2ae0,1,smarthi,2013-12-04 19:36:18+00:00,['59dbea77e73ca8ea49d7ed346c1e6b7e06f89930'],1,1,2,1319468,1,,,,2761
a851ddc46955ae1fb35c621edbaed4daae7bdbd8,1,smarthi,2013-12-04 20:05:22+00:00,['58546105b5680bae0993fd9167fb97b1b65e2ae0'],14,30,44,1319512,3,0.157894737,1,1,2761
3186b37fb0e8a711bf07029db45fe9fc940f0079,1,smarthi,2013-12-04 21:03:22+00:00,['a851ddc46955ae1fb35c621edbaed4daae7bdbd8'],116,62,178,1319690,4,1,1,0,2761
82534918c3cdebf610c8c49c4c4ad3112703eb64,1,smarthi,2013-12-08 18:16:10+00:00,['3186b37fb0e8a711bf07029db45fe9fc940f0079'],90,84,174,1319864,11,1,1,0,2761
c20d04cde96a1c09fa9819c870d22acb8918d906,1,smarthi,2013-12-08 18:18:08+00:00,['82534918c3cdebf610c8c49c4c4ad3112703eb64'],5,9,14,1319878,1,1,1,0,2761
95c68de3eb275c9333bd067b1ed1cf00e7fcb40a,0,smarthi,2013-12-08 23:35:02+00:00,['c20d04cde96a1c09fa9819c870d22acb8918d906'],1,68,69,1319947,3,0,1,1,2761
055fbeda80e0f9227aa67d5c3ef87785a1cf1a88,1,smarthi,2013-12-09 00:32:02+00:00,['95c68de3eb275c9333bd067b1ed1cf00e7fcb40a'],1,1,2,1319949,1,,,,2761
24c4921f1a3c305656229bea2ee8f21521f2a9b8,0,smarthi,2013-12-15 07:47:13+00:00,['055fbeda80e0f9227aa67d5c3ef87785a1cf1a88'],19,19,38,1319987,2,1,1,0,2761
06205a6cd43d9d2fac4b59184e03d52725fde536,1,smarthi,2013-12-15 09:25:29+00:00,['24c4921f1a3c305656229bea2ee8f21521f2a9b8'],1,4,5,1319992,2,,,,2761
44cc7b3e9102a05aa5c963a8d0a2aba241553b6d,1,smarthi,2013-12-15 12:56:19+00:00,['06205a6cd43d9d2fac4b59184e03d52725fde536'],17,40,57,1320049,3,0,1,1,2761
59cd40a4b32eec1d5eb4539781b4e59e6486787c,1,smarthi,2013-12-15 13:17:22+00:00,['44cc7b3e9102a05aa5c963a8d0a2aba241553b6d'],0,3,3,1320052,2,,,,2761
304fb0f05af390ae3e34778f42aeedf84de270f8,0,smarthi,2013-12-15 18:29:36+00:00,['59cd40a4b32eec1d5eb4539781b4e59e6486787c'],44,92,136,1320188,6,0,0,1,2761
05e5398c029ef8a470ba1b3fe53e3e74fe636f26,0,smarthi,2013-12-15 18:30:43+00:00,['304fb0f05af390ae3e34778f42aeedf84de270f8'],0,2,2,1320190,1,,,,2761
c371b4e399d3ca1ceaf76b4200a6db5657ad7513,1,smarthi,2013-12-17 19:05:41+00:00,['05e5398c029ef8a470ba1b3fe53e3e74fe636f26'],19,10,29,1320219,1,0.888888889,1,0,2761
80e4928bc2a2ff168ad9cd2bab60c8896b6dd38d,0,smarthi,2013-12-18 04:11:47+00:00,['c371b4e399d3ca1ceaf76b4200a6db5657ad7513'],9,10,19,1320238,3,,,,2761
2e5449f24d06c2e9f1006ae82c86b883d4cdf7ef,1,frankscholten,2013-12-18 13:20:42+00:00,['80e4928bc2a2ff168ad9cd2bab60c8896b6dd38d'],50,71,121,1320359,30,0.8,1,1,2761
d520c597df9caf412ee59cff8d44a1dbd255038c,0,smarthi,2013-12-18 13:53:22+00:00,['2e5449f24d06c2e9f1006ae82c86b883d4cdf7ef'],0,2,2,1320361,1,,,,2761
6413575104c174922ccbaa4a63f3e815c8bb90f5,1,smarthi,2013-12-19 19:29:02+00:00,['d520c597df9caf412ee59cff8d44a1dbd255038c'],0,1413,1413,1321774,6,0.380403458,0.691642651,0.796829971,2766
e62e64a1032b74e18e4dd4c1f9ee54826ca8e5ca,1,smarthi,2013-12-20 08:44:25+00:00,['6413575104c174922ccbaa4a63f3e815c8bb90f5'],1,19,20,1321794,2,,,,2766
c87196e4e24a758d652b5ba36e26701c35726654,0,smarthi,2013-12-20 17:18:47+00:00,['e62e64a1032b74e18e4dd4c1f9ee54826ca8e5ca'],38,148,186,1321980,6,0.206896552,0,0.706896552,2767
2e5e8a573b2074526104847b26707d131f6c35ba,0,smarthi,2013-12-21 06:18:10+00:00,['c87196e4e24a758d652b5ba36e26701c35726654'],2,2,4,1321984,1,,,,2767
2b054b6bfd4c9d6a53d0a4a3d0a5b72c455d4d56,0,smarthi,2013-12-21 17:29:52+00:00,['2e5e8a573b2074526104847b26707d131f6c35ba'],2,3,5,1321989,1,,,,2767
16e952d6cbaecda90cd16de87cb51da384a6ca22,0,smarthi,2013-12-21 18:26:55+00:00,['2b054b6bfd4c9d6a53d0a4a3d0a5b72c455d4d56'],14,12,26,1322015,1,1,0,0,2767
6a8cfcde4d862689b0b2db3a48328de4884f2776,0,smarthi,2013-12-23 19:20:30+00:00,['16e952d6cbaecda90cd16de87cb51da384a6ca22'],11,12,23,1322038,3,1,1,0,2767
ede812b2b7c6519cd2a4eebfca0538a65b7d7a8d,0,smarthi,2013-12-30 10:55:05+00:00,['6a8cfcde4d862689b0b2db3a48328de4884f2776'],3,7,10,1322048,3,,,,2767
d15537b19c6b6d221c20567dcaefddeb39eed7f5,1,Ted Dunning,2014-01-02 06:41:51+00:00,['ede812b2b7c6519cd2a4eebfca0538a65b7d7a8d'],6,168,174,1322222,3,0.115384615,0.884615385,1,2768
f6c9f3d475b23da31c6af20b597dc6b313dfecc4,0,smarthi,2014-01-02 06:47:25+00:00,['d15537b19c6b6d221c20567dcaefddeb39eed7f5'],0,2,2,1322224,1,,,,2768
0b0f254897e5e98fdb683083d6bc52b847f80178,0,smarthi,2014-01-07 20:36:28+00:00,['f6c9f3d475b23da31c6af20b597dc6b313dfecc4'],2,6,8,1322232,1,,,,2768
b0dc01b24aae9e583dd873541ab9f3eafe0b7d9a,0,smarthi,2014-01-09 17:01:54+00:00,['0b0f254897e5e98fdb683083d6bc52b847f80178'],1,3,4,1322236,2,,,,2768
7bb6320b1fbd446ec416afed1f322f4ab04dcc5a,0,smarthi,2014-01-09 18:09:01+00:00,['b0dc01b24aae9e583dd873541ab9f3eafe0b7d9a'],0,4,4,1322240,1,,,,2768
1c06e9db4fb2623af8953fe14ddf2a8002e4c015,0,smarthi,2014-01-09 21:34:43+00:00,['7bb6320b1fbd446ec416afed1f322f4ab04dcc5a'],55,35,90,1322330,2,1,1,1,2768
dcc8b38f31b3ee59b7da55b82a5c63038e43edad,1,smarthi,2014-01-10 23:08:20+00:00,['1c06e9db4fb2623af8953fe14ddf2a8002e4c015'],1,59,60,1322390,1,,,,2768
d32fa5f95e4e351b36423b77bb32367a546ad0ca,1,smarthi,2014-01-10 23:48:57+00:00,['dcc8b38f31b3ee59b7da55b82a5c63038e43edad'],13,18,31,1322421,8,,,,2768
8fd8964def87d065b2e648a26f996247e5f5db1f,0,smarthi,2014-01-10 23:49:01+00:00,['d32fa5f95e4e351b36423b77bb32367a546ad0ca'],17,11,28,1322449,8,,,,2768
dfa1ded57519a1f790f268e6b5c7a4e157a5f4b6,0,smarthi,2014-01-15 17:16:28+00:00,['8fd8964def87d065b2e648a26f996247e5f5db1f'],7,7,14,1322463,7,,,,2768
0fbb722b80251907a7842ee84e7e2e368dbeb4eb,0,smarthi,2014-01-15 17:30:14+00:00,['dfa1ded57519a1f790f268e6b5c7a4e157a5f4b6'],1,3,4,1322467,2,,,,2768
26a338e3f01717afaa11a6fd2aaf764bb21bd2c9,0,smarthi,2014-01-15 19:19:53+00:00,['0fbb722b80251907a7842ee84e7e2e368dbeb4eb'],8,7,15,1322482,8,,,,2768
4aaf42a07dfe1990420ab6f28b18b5476421a443,0,smarthi,2014-01-15 19:21:51+00:00,['26a338e3f01717afaa11a6fd2aaf764bb21bd2c9'],0,1,1,1322483,1,,,,2768
82d51ea3287b5a34931bbfe36f4c39b95a00d858,0,smarthi,2014-01-15 19:34:55+00:00,['4aaf42a07dfe1990420ab6f28b18b5476421a443'],1,1,2,1322485,1,,,,2768
b49a45a152050f92c140bea73b47043ff545cff3,0,smarthi,2014-01-15 19:59:03+00:00,['82d51ea3287b5a34931bbfe36f4c39b95a00d858'],5,5,10,1322495,5,,,,2768
377131e745ef87fbf1c18f269e13301f48471d23,0,smarthi,2014-01-15 19:59:43+00:00,['b49a45a152050f92c140bea73b47043ff545cff3'],1,1,2,1322497,1,,,,2768
e9fbbc0459389f1ccccb304043ec85acef6e70e7,0,smarthi,2014-01-15 20:12:43+00:00,['377131e745ef87fbf1c18f269e13301f48471d23'],1,1,2,1322499,1,,,,2768
1fbd7b7bd7c509073e0ea4af63a997694e742d55,0,smarthi,2014-01-15 23:21:44+00:00,['e9fbbc0459389f1ccccb304043ec85acef6e70e7'],2,2,4,1322503,1,,,,2768
f88d7dc297f7b72127105605cf46ecc6334620e5,0,Sebastian Schelter,2014-01-16 07:45:55+00:00,['1fbd7b7bd7c509073e0ea4af63a997694e742d55'],4,1,5,1322508,3,,,,2768
89c7f4c4a29a153945d68ad085896a627328ce37,0,smarthi,2014-01-16 12:56:06+00:00,['f88d7dc297f7b72127105605cf46ecc6334620e5'],0,2,2,1322510,1,,,,2768
770bcbadeaab566bf0c831a84d96491fc0e08139,0,smarthi,2014-01-16 13:20:59+00:00,['89c7f4c4a29a153945d68ad085896a627328ce37'],11,17,28,1322538,8,,,,2768
31354daeb589b4af9e6a0b5795a500c2d012ae3d,0,smarthi,2014-01-16 13:21:04+00:00,['770bcbadeaab566bf0c831a84d96491fc0e08139'],17,11,28,1322566,8,,,,2768
dbe5d501b911f66770791e96640c0578226f956b,0,smarthi,2014-01-16 13:54:22+00:00,['31354daeb589b4af9e6a0b5795a500c2d012ae3d'],7,7,14,1322580,7,,,,2768
750043ebe07efce9ae9a5d159655ab3e3089c9a2,0,smarthi,2014-01-16 14:12:44+00:00,['dbe5d501b911f66770791e96640c0578226f956b'],1,1,2,1322582,1,,,,2768
02faa512a7a7b9b04ab8dcc70d2e9770894b2d46,0,smarthi,2014-01-16 14:21:26+00:00,['750043ebe07efce9ae9a5d159655ab3e3089c9a2'],2,2,4,1322586,1,,,,2768
23adfe36515e771433712d23eb900681c421e63c,0,smarthi,2014-01-16 14:30:03+00:00,['02faa512a7a7b9b04ab8dcc70d2e9770894b2d46'],11,17,28,1322614,8,,,,2768
4eb085d55237404ae61a17a8712e6b64de239a41,0,smarthi,2014-01-16 14:30:09+00:00,['23adfe36515e771433712d23eb900681c421e63c'],17,11,28,1322642,8,,,,2768
a096f35cae260d68f63ced51634c920ca4cbfc92,0,smarthi,2014-01-21 19:33:32+00:00,['4eb085d55237404ae61a17a8712e6b64de239a41'],8,8,16,1322658,8,,,,2768
5a41f8fb35fdec453f5874a143f854101bc9785e,0,Sebastian Schelter,2014-01-21 20:57:06+00:00,['a096f35cae260d68f63ced51634c920ca4cbfc92'],326,1,327,1322985,4,,,,2768
4f368b8efd9e040a3b982321fe2eb207b49b48b1,0,Sebastian Schelter,2014-01-21 21:02:01+00:00,['5a41f8fb35fdec453f5874a143f854101bc9785e'],9,3,12,1322997,2,,,,2768
67f146c86e4961a693becc49f270b1850d90ab19,1,Sebastian Schelter,2014-01-21 21:33:28+00:00,['4f368b8efd9e040a3b982321fe2eb207b49b48b1'],13,64,77,1323074,3,0.526315789,0.526315789,0.368421053,2768
78996cb6b215662402dcdaa29fc1454ce84c52f6,0,smarthi,2014-01-22 05:05:01+00:00,['67f146c86e4961a693becc49f270b1850d90ab19'],0,0,0,1323074,0,,,,2768
700224140ffb5cda4517f2d32261612b3d29bace,0,smarthi,2014-01-22 06:01:24+00:00,['78996cb6b215662402dcdaa29fc1454ce84c52f6'],1,7499,7500,1330574,52,0.25929574,0.593449889,0.749076582,2819
7b9c6c5cab87bc86267e398b067a9c9e506833b6,0,smarthi,2014-01-22 09:11:56+00:00,['700224140ffb5cda4517f2d32261612b3d29bace'],1,3,4,1330578,2,,,,2819
81838f2d8f77cee2e6869aa8372f51401d8759a4,0,smarthi,2014-01-22 22:08:48+00:00,['7b9c6c5cab87bc86267e398b067a9c9e506833b6'],11,17,28,1330606,8,,,,2819
a46d104d37a1b8125fc35b80d2890e4b8c646f10,0,smarthi,2014-01-22 22:08:53+00:00,['81838f2d8f77cee2e6869aa8372f51401d8759a4'],17,11,28,1330634,8,,,,2819
2396246c13ac844d6a9b7d9d02c7fcd779d11804,1,Ted Dunning,2014-01-24 02:27:54+00:00,['a46d104d37a1b8125fc35b80d2890e4b8c646f10'],28,6,34,1330668,1,1,0,0,2819
bef1e8e81b69c968afaebd747efe07a956e2211d,1,Ted Dunning,2014-01-24 02:27:57+00:00,['2396246c13ac844d6a9b7d9d02c7fcd779d11804'],2,23,25,1330693,2,1,1,1,2819
b29f6631d993c0f5fd8f067bc85c34f3a8d7740d,0,smarthi,2014-01-26 03:22:57+00:00,['bef1e8e81b69c968afaebd747efe07a956e2211d'],8,8,16,1330709,8,,,,2819
18b2c440c8a7e4c389f6d548f696e81cedf21056,0,smarthi,2014-01-26 03:29:42+00:00,['b29f6631d993c0f5fd8f067bc85c34f3a8d7740d'],0,2,2,1330711,1,,,,2819
e93f05d642aa759cbc0a69c9e275d39167e34f8f,1,smarthi,2014-01-26 03:50:55+00:00,['18b2c440c8a7e4c389f6d548f696e81cedf21056'],17,55,72,1330783,4,0,0,0.214285714,2819
6b1be46477855d652fef9a18b7eec86e50b9cf6f,1,smarthi,2014-01-26 08:06:40+00:00,['e93f05d642aa759cbc0a69c9e275d39167e34f8f'],10,1,11,1330794,1,,,,2819
3b4f783171afb64be082f442171ee48ef60cf180,0,sslavic,2014-01-26 23:43:43+00:00,['6b1be46477855d652fef9a18b7eec86e50b9cf6f'],1,0,1,1330795,1,,,,2819
632a45d5ad962bb03ef2e571d5f91cd191b5fc73,0,sslavic,2014-01-27 00:45:18+00:00,['3b4f783171afb64be082f442171ee48ef60cf180'],3,3,6,1330801,1,,,,2819
d1c79edf5596437dd5980fffee26c0da5f1da432,1,sslavic,2014-01-27 01:10:15+00:00,['632a45d5ad962bb03ef2e571d5f91cd191b5fc73'],5,46,51,1330852,4,,,,2819
29c3f055950ed8fc038c9cbf8cee67a07f6dc2ef,0,sslavic,2014-01-27 01:43:14+00:00,['d1c79edf5596437dd5980fffee26c0da5f1da432'],2,2,4,1330856,1,,,,2819
08da3686124f67a529bfc8b00a829b7dc72a9a4e,0,smarthi,2014-01-27 05:25:19+00:00,['29c3f055950ed8fc038c9cbf8cee67a07f6dc2ef'],0,4,4,1330860,2,,,,2819
0080be59ee880a3007a612f43fe6fdca86556aa6,1,smarthi,2014-01-27 08:29:58+00:00,['08da3686124f67a529bfc8b00a829b7dc72a9a4e'],1,1,2,1330862,1,,,,2819
ab6216f1e57a95454e39233f406ffbd7c7fe7cfb,0,smarthi,2014-01-28 05:55:25+00:00,['0080be59ee880a3007a612f43fe6fdca86556aa6'],11,12,23,1330885,3,0,0,0,2819
4d4efb0cb3ce1ba12009179b38a848460cb076a8,0,smarthi,2014-01-28 06:55:14+00:00,['ab6216f1e57a95454e39233f406ffbd7c7fe7cfb'],4,16,20,1330905,2,1,1,0,2819
84059288d0fc2b645c449e04fb030872137091eb,0,smarthi,2014-01-28 08:07:34+00:00,['4d4efb0cb3ce1ba12009179b38a848460cb076a8'],94,72,166,1331071,12,1,0,0.916666667,2819
a2339d02b15c2e56b74ededc143e74f2606b880d,0,smarthi,2014-01-28 18:40:37+00:00,['84059288d0fc2b645c449e04fb030872137091eb'],2,4,6,1331077,2,,,,2819
8552cff1d923d91c479bf0ce40fdc96543655529,0,smarthi,2014-01-28 22:46:31+00:00,['a2339d02b15c2e56b74ededc143e74f2606b880d'],8,17,25,1331102,1,1,1,1,2819
9a7458f2bb5b882d239c5751b6c4945dafc7e2fa,0,smarthi,2014-01-28 23:01:32+00:00,['8552cff1d923d91c479bf0ce40fdc96543655529'],1,1,2,1331104,1,,,,2819
fab3d2f6ae5aa92cdbefcf3ba5e110e7a71fd991,0,smarthi,2014-01-28 23:46:18+00:00,['9a7458f2bb5b882d239c5751b6c4945dafc7e2fa'],14,0,14,1331118,1,,,,2819
d74edf431d3a5678d51d4fd89b415c67ea9a76d6,0,smarthi,2014-01-28 23:54:46+00:00,['fab3d2f6ae5aa92cdbefcf3ba5e110e7a71fd991'],1,1,2,1331120,1,,,,2819
fdded755a7ba0ccd467aa52e9c4e0d524ded5219,0,smarthi,2014-01-29 00:32:06+00:00,['d74edf431d3a5678d51d4fd89b415c67ea9a76d6'],11,17,28,1331148,8,,,,2819
28de0d8e7e31c3f5c38dc8bfe4e0df71ce2437b8,0,smarthi,2014-01-29 00:32:11+00:00,['fdded755a7ba0ccd467aa52e9c4e0d524ded5219'],17,11,28,1331176,8,,,,2819
6130da0bbdb7e382615c499dc8e1b1c68f9812d1,1,frankscholten,2014-02-02 16:26:48+00:00,['28de0d8e7e31c3f5c38dc8bfe4e0df71ce2437b8'],0,1,1,1331177,1,,,,2819
256fe2714e949798a1aeae1329de0b6d5fc7c8ff,1,smarthi,2014-02-02 16:57:59+00:00,['6130da0bbdb7e382615c499dc8e1b1c68f9812d1'],1,3,4,1331181,1,,,,2819
29ff0a8b71de50e333b5bc9701c67baaa684e7a5,1,frankscholten,2014-02-02 17:42:30+00:00,['256fe2714e949798a1aeae1329de0b6d5fc7c8ff'],1,1,2,1331183,1,,,,2819
a0ce86226101a06dacb82d08bc2156736862c6c2,1,smarthi,2014-02-03 06:45:00+00:00,['29ff0a8b71de50e333b5bc9701c67baaa684e7a5'],1,2,3,1331186,1,,,,2819
3e9cd90fa55c6300d60b36d1d02bc9f632625412,1,Sebastian Schelter,2014-02-11 14:56:37+00:00,['a0ce86226101a06dacb82d08bc2156736862c6c2'],4,44,48,1331234,3,1,1,1,2819
678525a86e75741ee6426efdd8b163b6004efee7,0,smarthi,2014-02-12 17:33:08+00:00,['3e9cd90fa55c6300d60b36d1d02bc9f632625412'],1,9,10,1331244,2,,,,2819
4e1b7a6ebf54a444e01ffa613fe44a1f11f06e31,0,smarthi,2014-02-16 05:58:15+00:00,['678525a86e75741ee6426efdd8b163b6004efee7'],8,26,34,1331278,3,0,1,1,2819
f322cbc13a5f2914d8429850673612cddc23b08a,0,smarthi,2014-02-16 06:52:47+00:00,['4e1b7a6ebf54a444e01ffa613fe44a1f11f06e31'],3,2,5,1331283,1,1,0,0,2819
5e25fddbaedf0a9ca2daa54021570b03d1a74251,0,smarthi,2014-02-19 20:14:33+00:00,['f322cbc13a5f2914d8429850673612cddc23b08a'],178,326,504,1331787,6,,,,2819
adbf34c1c54625e9bea9e8d6b5f6d9e21298847e,0,smarthi,2014-02-20 00:59:56+00:00,['5e25fddbaedf0a9ca2daa54021570b03d1a74251'],326,178,504,1332291,6,,,,2819
d257e955295583f5de4775159f9c3488ceb9248d,0,gcapan,2014-02-25 09:52:58+00:00,['adbf34c1c54625e9bea9e8d6b5f6d9e21298847e'],144,211,355,1332646,3,,,,2819
8128b9bae0814e7d82c42b25f76154036efbe383,0,gcapan,2014-02-25 13:03:04+00:00,['d257e955295583f5de4775159f9c3488ceb9248d'],0,2,2,1332648,1,,,,2819
d4e58278d0f406049d156c730cda6683c3529f93,1,Sean R. Owen,2014-02-25 14:15:06+00:00,['8128b9bae0814e7d82c42b25f76154036efbe383'],235,239,474,1333122,5,0,0.875,0.5,2819
dde5e3f7cf414b0d6eb88f5f3e337d1bcc55b4ae,1,smarthi,2014-02-28 08:49:57+00:00,['d4e58278d0f406049d156c730cda6683c3529f93'],1,132,133,1333255,4,,,,2821
f6fd0ce109f425fd56237b92a21dec09cd0388f0,1,Sebastian Schelter,2014-03-03 21:55:08+00:00,['dde5e3f7cf414b0d6eb88f5f3e337d1bcc55b4ae'],21,56,77,1333332,4,0.047619048,0,0.952380952,2821
7dbe24a0d35518d330173c82bb437bfbd011fcc4,0,frankscholten,2014-03-05 20:03:18+00:00,['f6fd0ce109f425fd56237b92a21dec09cd0388f0'],1,1,2,1333334,1,,,,2821
7120506af5e5eb97235b69a42795c9309e6c0404,0,frankscholten,2014-03-05 20:04:15+00:00,['7dbe24a0d35518d330173c82bb437bfbd011fcc4'],3,4,7,1333341,3,,,,2821
cb901b410349875178345e378e51c6749c245ca1,0,frankscholten,2014-03-05 20:25:30+00:00,['7120506af5e5eb97235b69a42795c9309e6c0404'],56,0,56,1333397,2,0,0,0,2821
0dc7b5cdebe24b9dd309d0c08a2049245d30d0a3,0,frankscholten,2014-03-05 21:51:32+00:00,['cb901b410349875178345e378e51c6749c245ca1'],51,41,92,1333489,4,0.333333333,0,1,2821
ee41571393261942e86191b4f0200680def23885,0,frankscholten,2014-03-05 21:55:09+00:00,['0dc7b5cdebe24b9dd309d0c08a2049245d30d0a3'],1,1,2,1333491,1,,,,2821
235b6cad6eff26bc6251a76f17308961c3997096,0,Sebastian Schelter,2014-03-05 23:25:49+00:00,['ee41571393261942e86191b4f0200680def23885'],1,4,5,1333496,2,,,,2821
13b793cccf3662c7f5289bc383dccbede0e12aed,1,Dmitriy Lyubimov,2014-03-07 05:00:41+00:00,['235b6cad6eff26bc6251a76f17308961c3997096'],16,3795,3811,1337307,59,0.545679012,0.767901235,0.785185185,2871
dce39e6255de28e7c5b9ab534635ec50c80c26da,0,Sebastian Schelter,2014-03-09 16:19:33+00:00,['13b793cccf3662c7f5289bc383dccbede0e12aed'],0,2,2,1337309,1,,,,2871
38bcfb522c7b6a33f55d9d7472b5610754714f53,0,smarthi,2014-03-09 17:49:19+00:00,['dce39e6255de28e7c5b9ab534635ec50c80c26da'],2,4,6,1337315,1,,,,2871
31fed42cb8afee148da17eeeb0a2e858ac9af142,0,smarthi,2014-03-09 17:51:08+00:00,['38bcfb522c7b6a33f55d9d7472b5610754714f53'],0,2,2,1337317,1,,,,2871
62b94a582e9c2c52b6ba512304dd36df9897da6a,1,Sebastian Schelter,2014-03-11 18:32:02+00:00,['31fed42cb8afee148da17eeeb0a2e858ac9af142'],9,84,93,1337410,4,0.480769231,0.942307692,1,2871
2ace5ccff9ee43ab8c23665cf7d713afc3ab9331,0,Sebastian Schelter,2014-03-12 06:19:49+00:00,['62b94a582e9c2c52b6ba512304dd36df9897da6a'],6,20,26,1337436,2,1,1,0,2871
2a6b55e1cde25285623af1dd925b3d0b669585aa,0,Sebastian Schelter,2014-03-12 07:18:01+00:00,['2ace5ccff9ee43ab8c23665cf7d713afc3ab9331'],0,2,2,1337438,1,,,,2871
dc3638afacc5b7c9e0f4e3aec775daa064a71a88,0,Sebastian Schelter,2014-03-13 12:06:35+00:00,['2a6b55e1cde25285623af1dd925b3d0b669585aa'],0,2,2,1337440,1,,,,2871
4e532ba536e0af2c5edd3fbe2584c52545afcf96,0,frankscholten,2014-03-13 19:26:19+00:00,['dc3638afacc5b7c9e0f4e3aec775daa064a71a88'],0,10,10,1337450,1,,,,2871
f95fda217838bae7d40eb7be62cb20b35db64a0d,1,smarthi,2014-03-16 23:21:37+00:00,['4e532ba536e0af2c5edd3fbe2584c52545afcf96'],1679,59,1738,1339188,8,0.642040457,0.479331574,0.136323659,2871
744d7e373498b5dc83655304c5e0bfe66b8c6585,0,akm,2014-03-17 02:52:36+00:00,['f95fda217838bae7d40eb7be62cb20b35db64a0d'],22,9,31,1339219,2,,,,2871
f53cfe112513cd4ff37d2d5dbefa6c95973bafde,1,Dmitriy Lyubimov,2014-03-17 19:25:23+00:00,['744d7e373498b5dc83655304c5e0bfe66b8c6585'],133,1025,1158,1340377,40,0.595959596,1,0.565656566,2877
f85becc6809858818e074b881f49c5f7f91ac62e,0,Sebastian Schelter,2014-03-17 20:12:07+00:00,['f53cfe112513cd4ff37d2d5dbefa6c95973bafde'],4,2,6,1340383,2,,,,2877
d3db3eea1e667b144eaf40e8d506ce088a306534,0,Dmitriy Lyubimov,2014-03-17 23:36:59+00:00,['f85becc6809858818e074b881f49c5f7f91ac62e'],28,33,61,1340444,2,,,,2877
52d824f3ea1f1de9e371b3d7db89ae1c7f688ae2,0,smarthi,2014-03-18 00:12:16+00:00,['d3db3eea1e667b144eaf40e8d506ce088a306534'],3,6,9,1340453,2,1,1,1,2877
048b6899f4cbe1226981fd030cf6890510754406,1,Dmitriy Lyubimov,2014-03-20 08:53:50+00:00,['52d824f3ea1f1de9e371b3d7db89ae1c7f688ae2'],48,123,171,1340624,10,0.138888889,0.916666667,0.916666667,2877
f4a9c597f3e254a4a19e663ef2ee47a78a3048bd,1,Dmitriy Lyubimov,2014-03-20 09:32:35+00:00,['048b6899f4cbe1226981fd030cf6890510754406'],7,1,8,1340632,1,,,,2877
82ceb2ab34bb3a88bbd92b01892019700cf67b80,0,smarthi,2014-03-20 22:15:07+00:00,['f4a9c597f3e254a4a19e663ef2ee47a78a3048bd'],1,1,2,1340634,1,,,,2877
f689fadc747825d0ffa6d77350cd31e4fe74dd53,1,akm,2014-03-22 03:09:57+00:00,['82ceb2ab34bb3a88bbd92b01892019700cf67b80'],4,145,149,1340783,6,,,,2879
abea22627dc67d6dedd513c9000b64e5728aca5e,0,smarthi,2014-03-22 03:39:37+00:00,['f689fadc747825d0ffa6d77350cd31e4fe74dd53'],0,0,0,1340783,1,,,,2879
2b4fa028bb8621e04b84f411e14b2345877ca73b,0,smarthi,2014-03-23 05:58:41+00:00,['abea22627dc67d6dedd513c9000b64e5728aca5e'],1,5,6,1340789,1,,,,2879
101a9a60f200aef4401fc748adbfef3af8bdd080,0,Dmitriy Lyubimov,2014-03-24 19:35:38+00:00,['2b4fa028bb8621e04b84f411e14b2345877ca73b'],2,2,4,1340793,2,,,,2879
d0261e801739c6bb767176a4d643ab065e4d9996,0,Dmitriy Lyubimov,2014-03-26 19:20:07+00:00,['101a9a60f200aef4401fc748adbfef3af8bdd080'],2,2,4,1340797,1,,,,2879
2b8bfc2453b9b061d23b710241b041c4571c182c,1,Dmitriy Lyubimov,2014-03-26 19:35:01+00:00,['d0261e801739c6bb767176a4d643ab065e4d9996'],18,18,36,1340833,7,,,,2879
2ab6e297ef4f7a4d2d480152424d2670d10395d0,0,Dmitriy Lyubimov,2014-03-26 19:38:48+00:00,['2b8bfc2453b9b061d23b710241b041c4571c182c'],1,1,2,1340835,1,,,,2879
ebffa7a88cf46103a144baefdd7027b31f4df432,0,smarthi,2014-03-26 20:03:05+00:00,['2ab6e297ef4f7a4d2d480152424d2670d10395d0'],0,2,2,1340837,1,,,,2879
e58f704e276f6dd736a16a2db74a8fe6a80db1c4,0,smarthi,2014-03-26 20:06:26+00:00,['ebffa7a88cf46103a144baefdd7027b31f4df432'],1,3,4,1340841,2,,,,2879
ebec1e32185bdcc10f48972f791487fe376d4c7b,0,akm,2014-03-27 02:51:57+00:00,['e58f704e276f6dd736a16a2db74a8fe6a80db1c4'],1,5,6,1340847,2,0,0.5,0.5,2879
056dc18c4dfc6e52026dc88a09a6aeb451f003d0,0,Ted Dunning,2014-03-27 17:32:04+00:00,['ebec1e32185bdcc10f48972f791487fe376d4c7b'],2,2,4,1340851,1,,,,2879
d8ceebe302ccaafa877d092e5d125e4bdb59b966,0,Ted Dunning,2014-03-27 17:34:35+00:00,['056dc18c4dfc6e52026dc88a09a6aeb451f003d0'],1,1,2,1340853,1,,,,2879
5b3171d81667a2ef9431c05e1e4ef56982490bd4,1,akm,2014-03-28 15:18:49+00:00,['d8ceebe302ccaafa877d092e5d125e4bdb59b966'],0,2,2,1340855,1,,,,2879
2e2114f312fbf4d3856c0c4fcdec3ca81de72f07,0,Sebastian Schelter,2014-03-30 18:36:24+00:00,['5b3171d81667a2ef9431c05e1e4ef56982490bd4'],2,0,2,1340857,1,,,,2879
4080fe4ce74a7adef18330d4dc49667e5219c2b8,0,Sebastian Schelter,2014-04-05 09:10:10+00:00,['2e2114f312fbf4d3856c0c4fcdec3ca81de72f07'],0,2,2,1340859,1,,,,2879
c1086aa319a1b0fdbe8412cf88c8d67c55cee492,0,Sebastian Schelter,2014-04-05 09:53:07+00:00,['4080fe4ce74a7adef18330d4dc49667e5219c2b8'],7,3,10,1340869,2,0,0,0,2879
76d3f74d071a1a3e6b7228edf9b76bf8e448b0cf,0,Sebastian Schelter,2014-04-05 11:23:08+00:00,['c1086aa319a1b0fdbe8412cf88c8d67c55cee492'],44,366,410,1341279,6,0.783950617,0.697530864,0.839506173,2881
5477173c071f3e70493cf36bd85de741998eb17b,0,akm,2014-04-09 18:23:07+00:00,['76d3f74d071a1a3e6b7228edf9b76bf8e448b0cf'],162,8,170,1341449,1,,,,2881
0fe6a49d76c237bd831a27f8526c62cf1c7f5cc8,1,Sebastian Schelter,2014-04-12 11:53:39+00:00,['5477173c071f3e70493cf36bd85de741998eb17b'],101,222,323,1341772,7,0.157894737,0.389473684,1,2881
d51639d615a0a19575f45188642c6b7a946bb44d,0,akm,2014-04-13 04:25:53+00:00,['0fe6a49d76c237bd831a27f8526c62cf1c7f5cc8'],4,42,46,1341818,2,,,,2882
4538d8f33f01ad7a4541cf2b8bc265049363c644,0,akm,2014-04-13 04:34:13+00:00,['d51639d615a0a19575f45188642c6b7a946bb44d'],1,1,2,1341820,1,,,,2882
ff3b13e5a7d19678260220e18da291a5bd6c311c,0,Sebastian Schelter,2014-04-13 14:31:16+00:00,['4538d8f33f01ad7a4541cf2b8bc265049363c644'],0,2,2,1341822,1,,,,2882
e431289d450baba0f73811335959834b11362a72,0,akm,2014-04-13 19:37:57+00:00,['ff3b13e5a7d19678260220e18da291a5bd6c311c'],1,3,4,1341826,1,,,,2882
deafc5cc6db3a6c10d21d13a2fa99b6db4e11b83,0,smarthi,2014-04-15 01:50:23+00:00,['e431289d450baba0f73811335959834b11362a72'],1,3,4,1341830,1,,,,2882
678957e64fb937be688c471622877103edb8592a,0,smarthi,2014-04-15 02:35:14+00:00,['deafc5cc6db3a6c10d21d13a2fa99b6db4e11b83'],32,39,71,1341901,2,0,1,1,2882
fa2972607a4ba589a4db42cfafd5293b350f671a,0,smarthi,2014-04-15 02:57:34+00:00,['678957e64fb937be688c471622877103edb8592a'],33,47,80,1341981,10,0,0,1,2882
28a9e82edfe31cce0300f8ff7be4dd96262ef0a9,0,smarthi,2014-04-15 03:10:16+00:00,['fa2972607a4ba589a4db42cfafd5293b350f671a'],4,4,8,1341989,1,,,,2882
0be8a407b1ada018e2f35e93dc7561f1683fe6e2,0,Sebastian Schelter,2014-04-15 04:36:47+00:00,['28a9e82edfe31cce0300f8ff7be4dd96262ef0a9'],0,2,2,1341991,1,,,,2882
94b08db7c444d5a00929e8a52e4359cc029bf237,0,Sebastian Schelter,2014-04-15 05:22:31+00:00,['0be8a407b1ada018e2f35e93dc7561f1683fe6e2'],26,16,42,1342033,4,,,,2882
28fe00310d0f74a8e5c2350dc7c17bdbcb388fa1,0,smarthi,2014-04-15 09:19:30+00:00,['94b08db7c444d5a00929e8a52e4359cc029bf237'],1,2,3,1342036,1,,,,2882
6ed413c9b194a02ccce770922c99a1e9edd41a30,0,Sebastian Schelter,2014-04-18 09:40:23+00:00,['28fe00310d0f74a8e5c2350dc7c17bdbcb388fa1'],0,2,2,1342038,1,,,,2882
0c7c65e673848f856aefb22336af8605120c5ae7,0,Sebastian Schelter,2014-04-18 11:13:29+00:00,['6ed413c9b194a02ccce770922c99a1e9edd41a30'],15,117,132,1342170,8,0.164179104,0,0.925373134,2882
d6a08331597861de59819b0f5b10e68c6dd57113,0,Sebastian Schelter,2014-04-18 11:23:17+00:00,['0c7c65e673848f856aefb22336af8605120c5ae7'],5,11,16,1342186,10,,,,2882
497ac820ac0652031ae62b1ddef3e85f30972072,0,Sebastian Schelter,2014-04-18 11:37:37+00:00,['d6a08331597861de59819b0f5b10e68c6dd57113'],0,1,1,1342187,1,,,,2882
37f28bd6472cd1700ffc16015096a53749e0a09b,0,Sebastian Schelter,2014-04-18 13:08:48+00:00,['497ac820ac0652031ae62b1ddef3e85f30972072'],0,82,82,1342269,3,0.088235294,1,1,2883
7afd9f4cf51c6ebde450d57ad756d7fd7e13b326,0,Sebastian Schelter,2014-04-18 18:38:15+00:00,['37f28bd6472cd1700ffc16015096a53749e0a09b'],301,183,484,1342753,5,0.4375,0,0.857142857,2883
9f036af1028a8456ef50102222765efabad69f01,0,Sebastian Schelter,2014-04-18 21:03:08+00:00,['7afd9f4cf51c6ebde450d57ad756d7fd7e13b326'],66,34,100,1342853,5,0.8,0,0.5,2883
657803cdb7e8361bf02208ee435d8fbf900b2903,0,smarthi,2014-04-18 21:15:37+00:00,['9f036af1028a8456ef50102222765efabad69f01'],7,7,14,1342867,1,1,1,1,2883
fb6408bd207a2a3053aadf1a189dff2310204b27,1,smarthi,2014-04-18 21:39:59+00:00,['657803cdb7e8361bf02208ee435d8fbf900b2903'],7,7,14,1342881,1,0,0,0,2883
69eb75e334907b230edf6d2c7ef12b79c5216de2,1,smarthi,2014-04-18 21:49:01+00:00,['fb6408bd207a2a3053aadf1a189dff2310204b27'],5,5,10,1342891,1,,,,2883
1a9d87432110ab40723e3e21691a2f8d66a776bf,0,smarthi,2014-04-18 22:26:50+00:00,['69eb75e334907b230edf6d2c7ef12b79c5216de2'],5,5,10,1342901,1,,,,2883
1a42d852daa75cf9b6a78013544647be2ec2a8e3,0,frankscholten,2014-04-19 12:36:33+00:00,['1a9d87432110ab40723e3e21691a2f8d66a776bf'],23,25,48,1342949,820,,,,2883
a64100d443edabe608668d4cac9f9fa0221d03af,0,frankscholten,2014-04-19 12:49:39+00:00,['1a42d852daa75cf9b6a78013544647be2ec2a8e3'],0,45438,45438,1388387,5,0.097826087,0.336956522,1,2887
f789bd0de54514e614334b7766f07d4ab5d21129,0,Sebastian Schelter,2014-04-19 14:29:20+00:00,['a64100d443edabe608668d4cac9f9fa0221d03af'],32,34,66,1388453,2,0,0.333333333,1,2887
5f070b4312060a04e857386fbaea9a189a5a3727,0,Sebastian Schelter,2014-04-19 14:31:03+00:00,['f789bd0de54514e614334b7766f07d4ab5d21129'],4,9,13,1388466,2,1,1,0,2887
9a46c29d010c36c090a14aca84d488079eb19247,0,Sebastian Schelter,2014-04-20 05:53:13+00:00,['5f070b4312060a04e857386fbaea9a189a5a3727'],0,1,1,1388467,1,,,,2887
b0036a958479599ed15b9f29752d47c33e31b613,0,Sebastian Schelter,2014-04-20 13:20:25+00:00,['9a46c29d010c36c090a14aca84d488079eb19247'],0,2,2,1388469,1,,,,2887
9a5bab5ef9328ec5e527f8dcfe08439d11971058,0,Sebastian Schelter,2014-04-22 06:36:03+00:00,['b0036a958479599ed15b9f29752d47c33e31b613'],205,174,379,1388848,15,0,0.125,1,2887
bae0d6e11bc4ac19beebba85b1670dcb4be3e3df,1,Dmitriy Lyubimov,2014-04-22 18:39:30+00:00,['9a5bab5ef9328ec5e527f8dcfe08439d11971058'],132,490,622,1389470,13,0.396551724,0.827586207,0.913793103,2891
6731710c30ae09092b058935b416d42b9ce77b11,0,Sebastian Schelter,2014-04-25 14:58:31+00:00,['bae0d6e11bc4ac19beebba85b1670dcb4be3e3df'],0,140,140,1389610,2,,,,2892
b962375718a597b3177217c74f2305f480f3230c,0,akm,2014-04-25 15:19:57+00:00,['6731710c30ae09092b058935b416d42b9ce77b11'],0,2,2,1389612,1,,,,2892
92fbb7149134b685891965fb5cc5982505d1457e,0,Sebastian Schelter,2014-04-27 09:21:01+00:00,['b962375718a597b3177217c74f2305f480f3230c'],48,2,50,1389662,15,,,,2892
19383c24e23ba6a0721e832702255f99610e4ae9,0,smarthi,2014-04-27 09:40:05+00:00,['92fbb7149134b685891965fb5cc5982505d1457e'],0,2,2,1389664,1,,,,2892
c383f0b6308d5d11e297eb64be1eb0fc875bea23,0,smarthi,2014-04-27 09:55:01+00:00,['19383c24e23ba6a0721e832702255f99610e4ae9'],0,6,6,1389670,1,,,,2892
3a284f5eb89cf09b61b73cf6ff2711741bbacc7a,1,Sebastian Schelter,2014-04-28 15:46:53+00:00,['c383f0b6308d5d11e297eb64be1eb0fc875bea23'],15,84,99,1389769,9,0,0.941176471,1,2892
1fb3f6aeed780f0362d63bed0b52a44efcb320bb,1,frankscholten,2014-04-28 20:14:19+00:00,['3a284f5eb89cf09b61b73cf6ff2711741bbacc7a'],30,90,120,1389889,10,0.75,1,1,2893
1570b44019662548936df3d3ac282d6753046f55,0,Sebastian Schelter,2014-04-28 21:29:35+00:00,['1fb3f6aeed780f0362d63bed0b52a44efcb320bb'],0,402,402,1390291,1,,,,2894
1132b48a540150a251d0d18471c010813e929cb4,0,Sebastian Schelter,2014-04-28 21:31:06+00:00,['1570b44019662548936df3d3ac282d6753046f55'],1,1,2,1390293,1,,,,2894
25c9cee1ac3f2d4c3d2c839ddad2caf386b07770,1,Sebastian Schelter,2014-04-29 19:52:08+00:00,['1132b48a540150a251d0d18471c010813e929cb4'],0,23,23,1390316,2,0,1,1,2894
a47466fbc31df0335b37de2f4d190ea1c9b22fa9,0,Sebastian Schelter,2014-05-01 07:39:13+00:00,['25c9cee1ac3f2d4c3d2c839ddad2caf386b07770'],89,2,91,1390407,2,,,,2894
524fc62e706bc71230860ff52688b2a15f01949b,0,Sebastian Schelter,2014-05-01 16:56:51+00:00,['a47466fbc31df0335b37de2f4d190ea1c9b22fa9'],7122,3,7125,1397532,47,0.738150141,0.415577761,0.246733282,2894
c43287f816aeea6d3aef21046d420a7c0c37e57b,1,Dmitriy Lyubimov,2014-05-02 18:44:28+00:00,['524fc62e706bc71230860ff52688b2a15f01949b'],2,4,6,1397538,2,,,,2894
d141c8e887904122a2b3cb4bf94851e7401d807d,0,Sebastian Schelter,2014-05-06 05:01:51+00:00,['c43287f816aeea6d3aef21046d420a7c0c37e57b'],66,277,343,1397881,28,0.592,0.96,0,2894
58e6581424438243c5bf670b26d505a9d8175f98,0,Sebastian Schelter,2014-05-06 21:07:36+00:00,['d141c8e887904122a2b3cb4bf94851e7401d807d'],0,2,2,1397883,1,,,,2894
575f8c2bd491122e777523bde284eeb6def74796,1,Sebastian Schelter,2014-05-06 23:11:19+00:00,['58e6581424438243c5bf670b26d505a9d8175f98'],1,94,95,1397978,3,1,1,1,2894
29e3f2820746f53ceaab2c173c6e48434d59d2c6,1,Dmitriy Lyubimov,2014-05-07 01:28:34+00:00,['575f8c2bd491122e777523bde284eeb6def74796'],17,48,65,1398043,9,1,0,1,2895
464e8de1f0854e0d84e2b3a4a1320be128f720c9,0,Sebastian Schelter,2014-05-18 11:38:37+00:00,['29e3f2820746f53ceaab2c173c6e48434d59d2c6'],8,11,19,1398062,2,,,,2895
d3c09ba44bdaba2fe63a3bf8badd2ea4b9f567b8,1,Sebastian Schelter,2014-05-18 14:33:55+00:00,['464e8de1f0854e0d84e2b3a4a1320be128f720c9'],27,176,203,1398265,5,0,1,0,2897
4f668dba945e2d61d62d37276a1d4a03f3b14276,0,Sebastian Schelter,2014-05-18 16:51:28+00:00,['d3c09ba44bdaba2fe63a3bf8badd2ea4b9f567b8'],20,72,92,1398357,4,1,1,0.857142857,2898
5b0b559cb9985a10f3a206f4dc557d817bd0d085,0,Sebastian Schelter,2014-05-18 17:35:16+00:00,['4f668dba945e2d61d62d37276a1d4a03f3b14276'],30,89,119,1398476,7,0.2,1,1,2899
c1adfe003ce0f50ecf5b429fcbc38277e3b426a1,0,Sebastian Schelter,2014-05-18 21:03:02+00:00,['5b0b559cb9985a10f3a206f4dc557d817bd0d085'],195,1805,2000,1400476,10,0.070731707,0.692682927,0.997560976,2904
6634aaaf2222de25f855a70963c03f39410ba90a,0,sslavic,2014-05-18 21:08:16+00:00,['c1adfe003ce0f50ecf5b429fcbc38277e3b426a1'],0,0,0,1400476,0,,,,2904
bf40156eacda79253142c96ebb856cb68f0d3ca0,1,sslavic,2014-05-18 22:24:26+00:00,['6634aaaf2222de25f855a70963c03f39410ba90a'],7,23,30,1400506,3,,,,2904
6bda4d73ff5d2b3b4ad4288fb22cde44a2898fe3,0,Dmitriy Lyubimov,2014-05-22 10:45:08-07:00,['bf40156eacda79253142c96ebb856cb68f0d3ca0'],138,0,138,1400644,1,,,,2904
360613f1d6c6b4694d2ac5a229950010ff4eab04,0,Andrew Musselman,2014-05-22 11:18:31-07:00,['6bda4d73ff5d2b3b4ad4288fb22cde44a2898fe3'],30,30,60,1400704,1,,,,2904
d850a091d3240f7863c92380fc01624c27f783c4,0,gcapan,2014-05-22 22:43:43+03:00,['360613f1d6c6b4694d2ac5a229950010ff4eab04'],3,1,4,1400708,1,,,,2904
299fe6cc217f3d62057a55140a44ada0ce6ea145,0,ssc,2014-05-23 18:39:18+02:00,['d850a091d3240f7863c92380fc01624c27f783c4'],33,157,190,1400898,4,0.94,1,1,2904
84a4bce9e4a4964d396a4ada3da35df4d842a9fe,1,ssc,2014-05-24 17:17:20+02:00,['299fe6cc217f3d62057a55140a44ada0ce6ea145'],8,96,104,1401002,3,0.870967742,1,0.129032258,2905
b59276e9271d4b865331cd192d7a19871847fbb8,0,ssc,2014-05-24 18:02:47+02:00,['84a4bce9e4a4964d396a4ada3da35df4d842a9fe'],25,49,74,1401076,3,,,,2906
aa0f0f461f6b9ca0186a7e054ec61eee76f396f7,0,ssc,2014-05-24 18:08:35+02:00,['b59276e9271d4b865331cd192d7a19871847fbb8'],1,3,4,1401080,2,,,,2906
cb6abe1f9b54e35be1b3189422b91d395f732031,0,ssc,2014-05-25 13:50:35+02:00,['aa0f0f461f6b9ca0186a7e054ec61eee76f396f7'],0,2,2,1401082,1,,,,2906
e8d2617d36d54371701707531756135147aed1b7,0,ssc,2014-05-25 17:00:01+02:00,['cb6abe1f9b54e35be1b3189422b91d395f732031'],0,2,2,1401084,1,,,,2906
0be2ea46aa3a700e9e863d0c5f75f256ff56641b,0,Suneel Marthi,2014-05-26 06:56:27-04:00,['e8d2617d36d54371701707531756135147aed1b7'],2,11,13,1401097,1,1,1,0.5,2906
5a1c2ccba645ee38bbc3a7c251a470a42194f41e,0,Suneel Marthi,2014-05-26 08:17:29-04:00,['0be2ea46aa3a700e9e863d0c5f75f256ff56641b'],0,2,2,1401099,1,,,,2906
8714a0f722663ea5cb16c14c5b8a01e57574cd93,1,Dmitriy Lyubimov,2014-05-27 12:13:29-07:00,['5a1c2ccba645ee38bbc3a7c251a470a42194f41e'],720,1083,1803,1402902,68,0.476190476,0.476190476,0.857142857,2915
7423629056bf709be07d0c7bb7d42e0e250f3ad9,0,Dmitriy Lyubimov,2014-05-27 12:32:22-07:00,['8714a0f722663ea5cb16c14c5b8a01e57574cd93'],0,0,0,1402902,0,,,,2915
d5c94bdde1ca02bf84fe6a2c5fb28bce5c07309e,0,Dmitriy Lyubimov,2014-05-27 14:20:58-07:00,['7423629056bf709be07d0c7bb7d42e0e250f3ad9'],0,8,8,1402910,1,,,,2915
e0751eaaca4bb06adcf80108d85ad0dc6cc67074,1,Andrew Musselman,2014-05-30 15:35:18-07:00,['d5c94bdde1ca02bf84fe6a2c5fb28bce5c07309e'],62,147,209,1403119,7,0.27027027,0.891891892,1,2915
9d6be1cd3b0a1f6a846e985ece0365b0ba218cdf,0,Andrew Musselman,2014-05-30 20:09:11-07:00,['e0751eaaca4bb06adcf80108d85ad0dc6cc67074'],2,0,2,1403121,1,,,,2915
1d1134ee941c6a06804fdb5fef536e3ed95ed36e,0,Andrew Musselman,2014-05-31 10:24:21-07:00,['9d6be1cd3b0a1f6a846e985ece0365b0ba218cdf'],0,2,2,1403123,1,,,,2915
88bddb08ab014df9d1d14b75fc96f6a8380b4545,0,Andrew Musselman,2014-05-31 15:24:11-07:00,['1d1134ee941c6a06804fdb5fef536e3ed95ed36e'],123,33,156,1403279,7,0,0.074074074,0,2915
127bd01344532f2f666335b80450279bb96c45eb,0,Andrew Musselman,2014-05-31 20:16:05-07:00,['88bddb08ab014df9d1d14b75fc96f6a8380b4545'],1,1,2,1403281,1,,,,2915
656878ea69adf7663015156b55ad5c9ea3ec7e4f,0,Dmitriy Lyubimov,2014-06-04 14:03:43-07:00,['127bd01344532f2f666335b80450279bb96c45eb'],887,320,1207,1404488,28,1,0,0.925925926,2915
26d3db6ba1f12870af996ef9eaea17dfc4a8b8fb,1,Dmitriy Lyubimov,2014-06-04 14:27:37-07:00,['656878ea69adf7663015156b55ad5c9ea3ec7e4f'],320,887,1207,1405695,28,0,1,0.074074074,2920
9cf90546dfa8bf11c99089a12d70b0272e7da211,1,Dmitriy Lyubimov,2014-06-04 14:29:34-07:00,['26d3db6ba1f12870af996ef9eaea17dfc4a8b8fb'],264,757,1021,1406716,31,0.7,0.7,1,2923
dd78ed9479559cd222f24fa0be57655cf2e3075b,1,Ted Dunning,2014-06-06 19:19:03-07:00,['9cf90546dfa8bf11c99089a12d70b0272e7da211'],5,244,249,1406965,2,0.358381503,1,1,2923
0f4f5dec7f3a7de7161d1fabf3e02418099f4446,1,Ted Dunning,2014-06-06 19:20:35-07:00,['dd78ed9479559cd222f24fa0be57655cf2e3075b'],0,43,43,1407008,1,0,0,1,2923
5083f58359dd103ac6d8e72a50c53bb20a5df14e,1,Ted Dunning,2014-06-06 19:21:47-07:00,['0f4f5dec7f3a7de7161d1fabf3e02418099f4446'],0,127,127,1407135,1,0,0,1,2923
63b765abb305cca6d726f54549a92018754a6348,1,Ted Dunning,2014-06-06 22:08:35-07:00,['5083f58359dd103ac6d8e72a50c53bb20a5df14e'],14,21,35,1407170,1,0.25,0.25,1,2923
cc9a70ebbdaceb8d5c2fcecd1a8cd9bee67e323e,0,pferrel,2014-06-07 13:36:12-07:00,['63b765abb305cca6d726f54549a92018754a6348'],0,1,1,1407171,1,,,,2923
99fd9ba4f9673b2b2d30c2b403aaa294503cc2a2,1,Ted Dunning,2014-06-07 15:09:10-07:00,['63b765abb305cca6d726f54549a92018754a6348'],6,7,13,1407184,2,,,,2923
a12135b94002367046ef6edc977527d586026689,0,pferrel,2014-06-08 08:25:36-07:00,"['cc9a70ebbdaceb8d5c2fcecd1a8cd9bee67e323e', '99fd9ba4f9673b2b2d30c2b403aaa294503cc2a2']",6,7,13,1407197,2,,,,2923
0844e69d6cbdc7bbfd54ba01dc9c829764eaeb6d,1,Ted Dunning,2014-06-08 18:24:48-07:00,['99fd9ba4f9673b2b2d30c2b403aaa294503cc2a2'],48,127,175,1407372,12,0.173333333,0.173333333,1,2923
8bcaa77340ac377a20237af4efbe891dc5a4790d,1,Ted Dunning,2014-06-08 20:57:37-07:00,['0844e69d6cbdc7bbfd54ba01dc9c829764eaeb6d'],34,43,77,1407449,6,0,0,1,2923
fcb436d2a7ed399dd8006b3254e655634000f4a1,1,Ted Dunning,2014-06-08 21:18:09-07:00,['8bcaa77340ac377a20237af4efbe891dc5a4790d'],2,2,4,1407453,1,,,,2923
d319b325066620a82d079379564188912e8b0b92,0,pferrel,2014-06-09 07:01:15-07:00,"['a12135b94002367046ef6edc977527d586026689', 'fcb436d2a7ed399dd8006b3254e655634000f4a1']",83,171,254,1407707,18,,,,2923
11046fb5273b559298111b201470d80cd6af43d9,1,Dmitriy Lyubimov,2014-06-09 12:17:00-07:00,['fcb436d2a7ed399dd8006b3254e655634000f4a1'],1,4,5,1407712,1,,,,2923
907781bb856b47cb7b180484c6d4b9f55a6df038,1,Dmitriy Lyubimov,2014-06-10 10:48:55-07:00,['11046fb5273b559298111b201470d80cd6af43d9'],0,27,27,1407739,3,1,1,1,2923
8c529ccff23d419c4cb5191b0435de40d6a9831c,1,Dmitriy Lyubimov,2014-06-10 11:30:55-07:00,['907781bb856b47cb7b180484c6d4b9f55a6df038'],1,43,44,1407783,3,,,,2923
b044a07797a8fef23d10f10126615c9b7db659bb,0,Dmitriy Lyubimov,2014-06-10 11:46:32-07:00,['8c529ccff23d419c4cb5191b0435de40d6a9831c'],0,7,7,1407790,1,1,1,1,2923
fd7a0bf969e19f069dc97c7d908f9c120c58acdd,0,pferrel,2014-06-11 19:17:59-07:00,"['d319b325066620a82d079379564188912e8b0b92', 'b044a07797a8fef23d10f10126615c9b7db659bb']",2,81,83,1407873,7,,,,2923
a8e09cd3aa1c9d6fdda2eaf84f86a06a33963658,1,ssc,2014-06-12 19:03:19+02:00,['b044a07797a8fef23d10f10126615c9b7db659bb'],20,59,79,1407952,3,1,1,0,2923
b77caec6f1c2b9bb48a619a7680c5a5e351579f8,0,pferrel,2014-06-12 11:33:55-07:00,"['fd7a0bf969e19f069dc97c7d908f9c120c58acdd', 'a8e09cd3aa1c9d6fdda2eaf84f86a06a33963658']",20,59,79,1408031,3,,,,2923
c1ca30872c622e513e49fc1bb111bc4b8a527d3b,1,pferrel,2014-06-12 17:45:09-07:00,['b77caec6f1c2b9bb48a619a7680c5a5e351579f8'],11,477,488,1408519,11,0.163461538,0.644230769,0.336538462,2925
c20eee89c6cc669494cf7edbb80255a83e194a15,1,pferrel,2014-06-14 09:24:30-07:00,['c1ca30872c622e513e49fc1bb111bc4b8a527d3b'],13,36,49,1408568,6,1,1,1,2925
6fbf3663b55def1f75fa3bed4690bf9562146921,1,Ted Dunning,2014-06-14 10:47:52-07:00,['c20eee89c6cc669494cf7edbb80255a83e194a15'],5,4,9,1408577,1,0,0,0,2925
45d88031c8e782a624eaf6cefea9700600805647,1,ssc,2014-06-18 22:31:34+02:00,['6fbf3663b55def1f75fa3bed4690bf9562146921'],5,80,85,1408662,6,1,1,1,2925
3dd18344a47fb86b5127bcf3e051a2eb4e7ca996,1,Dmitriy Lyubimov,2014-06-18 14:33:07-07:00,['45d88031c8e782a624eaf6cefea9700600805647'],38,198,236,1408898,11,1,1,0,2927
37b85253981770b455bd9936cef23de460662483,0,Gokhan Capan,2014-07-01 00:41:09+03:00,['3dd18344a47fb86b5127bcf3e051a2eb4e7ca996'],22,2,24,1408922,2,,,,2927
2b65475c3ab682ebd47cffdc6b502698799cd2c8,1,pferrel,2014-07-03 15:56:37-07:00,['37b85253981770b455bd9936cef23de460662483'],92,1454,1546,1410468,17,0.139442231,0.334661355,0.613545817,2937
638ac8c7f783d30f5a52c62ca50c28cabde454f8,0,pferrel,2014-07-04 09:01:22-07:00,['2b65475c3ab682ebd47cffdc6b502698799cd2c8'],5,5,10,1410478,1,,,,2937
32badb1d360ddf514e6b253f2dea9ae7e5df078a,0,pferrel,2014-07-04 11:23:20-07:00,['2b65475c3ab682ebd47cffdc6b502698799cd2c8'],10,21,31,1410509,3,0,0,0,2937
8b2bec7f5e3a0d3500e38bbecbc3db6d08e7435c,0,pferrel,2014-07-04 13:32:07-07:00,"['32badb1d360ddf514e6b253f2dea9ae7e5df078a', '638ac8c7f783d30f5a52c62ca50c28cabde454f8']",5,5,10,1410519,1,,,,2937
24cb5576f720737b73906ebb15be486d540ac629,1,pferrel,2014-07-05 13:36:24-07:00,['8b2bec7f5e3a0d3500e38bbecbc3db6d08e7435c'],48,51,99,1410618,3,1,1,1,2937
9bfb767323833586873272af4db446f68f357f1f,1,pferrel,2014-07-07 08:42:49-07:00,['24cb5576f720737b73906ebb15be486d540ac629'],9,125,134,1410752,4,0,0,0.5,2937
63cebf76e9c7746a1851841e37f5873704e086e8,1,Dmitriy Lyubimov,2014-07-07 12:34:12-07:00,['9bfb767323833586873272af4db446f68f357f1f'],26,237,263,1411015,7,1,1,1,2939
e4ba7887fc6dbf17c3d73f8d4aa1045eeb48d53e,1,Dmitriy Lyubimov,2014-07-07 13:15:30-07:00,['63cebf76e9c7746a1851841e37f5873704e086e8'],26,71,97,1411112,10,0.833333333,0.833333333,0.833333333,2939
25a6fc0967357e6ba4aafcaf11bf3f7faec752fd,1,Dmitriy Lyubimov,2014-07-14 13:18:33-07:00,['e4ba7887fc6dbf17c3d73f8d4aa1045eeb48d53e'],643,811,1454,1412566,17,,,,2944
272b1615311c551def0a686a75cc64591b01007e,1,Dmitriy Lyubimov,2014-07-16 15:51:27-07:00,['25a6fc0967357e6ba4aafcaf11bf3f7faec752fd'],5,8,13,1412579,4,,,,2944
dec441fb895c96d1e756619d15d75bba00b10fa3,1,Dmitriy Lyubimov,2014-07-21 14:58:10-07:00,['272b1615311c551def0a686a75cc64591b01007e'],31,33,64,1412643,3,,,,2944
c9d978a460203736732af546f8b88120795c5d33,1,Dmitriy Lyubimov,2014-07-21 16:06:20-07:00,['dec441fb895c96d1e756619d15d75bba00b10fa3'],1,64,65,1412708,2,0,0,1,2944
ccaec1b267d768e890695dd36c49a34d621e1e73,0,wobu,2014-07-25 13:01:10+02:00,['c9d978a460203736732af546f8b88120795c5d33'],11,65,76,1412784,2,0,0.916666667,0.722222222,2944
377dcace16fe4fd77baaab91ad575e9da5c49ac0,1,Dmitriy Lyubimov,2014-07-28 10:25:05-07:00,['c9d978a460203736732af546f8b88120795c5d33'],24,250,274,1413058,16,0,0,1,2944
2715ed201b7e6d583ee40e6d262a29a400fd16fb,0,Dmitriy Lyubimov,2014-07-28 13:36:18-07:00,['377dcace16fe4fd77baaab91ad575e9da5c49ac0'],0,0,0,1413058,0,,,,2944
846307d5b03ef7df6d3c890f2a291b4c11581e80,1,Dmitriy Lyubimov,2014-07-29 13:17:15-07:00,['2715ed201b7e6d583ee40e6d262a29a400fd16fb'],0,135,135,1413193,7,1,1,1,2946
e7f247d8ee25cf59ca0d58dc426edfee62e3613f,1,Dmitriy Lyubimov,2014-07-30 13:17:42-07:00,['846307d5b03ef7df6d3c890f2a291b4c11581e80'],2,2,4,1413197,2,,,,2946
56a2305ed14a3f4706b10c394a27d3429c2103b4,1,Dmitriy Lyubimov,2014-07-31 13:28:17-07:00,['e7f247d8ee25cf59ca0d58dc426edfee62e3613f'],40,32,72,1413269,6,,,,2946
66f164057e322d2e63ea02c35c9e30c3969e80b1,1,Dmitriy Lyubimov,2014-07-31 18:06:27-07:00,['56a2305ed14a3f4706b10c394a27d3429c2103b4'],43,50,93,1413362,6,,,,2946
e5bc885fdb4492a6d54232cea6c7e8e0abd4080d,0,Dmitriy Lyubimov,2014-08-04 16:39:29-07:00,['66f164057e322d2e63ea02c35c9e30c3969e80b1'],9,10,19,1413381,1,,,,2946
7a50a291b4598e9809f9acf609b92175ce7f953b,1,Dmitriy Lyubimov,2014-08-06 12:33:03-07:00,['e5bc885fdb4492a6d54232cea6c7e8e0abd4080d'],2,14,16,1413397,3,,,,2946
00c0149b95d3621ed5991578ac534ba5fdf5ac02,1,Dmitriy Lyubimov,2014-08-06 13:27:34-07:00,['7a50a291b4598e9809f9acf609b92175ce7f953b'],18,10,28,1413425,4,,,,2946
a80974037853c5227f9e5ef1c384a1fca134746e,1,pferrel,2014-08-06 16:28:37-07:00,['00c0149b95d3621ed5991578ac534ba5fdf5ac02'],311,901,1212,1414637,12,1,1,0,2946
ee6359f621b508ab7f21df0316941e68c75eb3e5,1,Dmitriy Lyubimov,2014-08-08 11:52:10-07:00,['a80974037853c5227f9e5ef1c384a1fca134746e'],582,464,1046,1415683,14,1,1,1,2946
b447f3fd07eafa36440dc4347e8514a15501e3c2,1,pferrel,2014-08-13 08:27:48-07:00,['ee6359f621b508ab7f21df0316941e68c75eb3e5'],26,54,80,1415763,3,1,1,1,2946
a70f48537524bdaa92178bf539bf84aad501c80d,0,pferrel,2014-08-14 09:45:19-07:00,['b447f3fd07eafa36440dc4347e8514a15501e3c2'],3,3,6,1415769,1,,,,2946
a6c8346ddb82390e2f5b5bd8c5968c436264e8a6,1,Dmitriy Lyubimov,2014-08-14 19:30:44-07:00,['a70f48537524bdaa92178bf539bf84aad501c80d'],61,116,177,1415946,4,0,1,1,2947
4bac5c295b3b820a6e7f25e4dcf5a843b7d1983e,1,Dmitriy Lyubimov,2014-08-15 11:56:45-07:00,['a6c8346ddb82390e2f5b5bd8c5968c436264e8a6'],1,1,2,1415948,1,,,,2947
25c9ed0ebeb34a3ef43a48fa47ea0340a049aac0,1,Dmitriy Lyubimov,2014-08-15 12:08:33-07:00,['4bac5c295b3b820a6e7f25e4dcf5a843b7d1983e'],0,58,58,1416006,3,1,1,1,2947
8d6ac39fc08d11d84a0c37bf81d8af5d6d7fe234,0,Dmitriy Lyubimov,2014-08-15 15:26:07-07:00,['25c9ed0ebeb34a3ef43a48fa47ea0340a049aac0'],0,2,2,1416008,1,,,,2947
445c1e3f743e687e874353b054c98253475d3413,1,Dmitriy Lyubimov,2014-08-15 15:36:39-07:00,['8d6ac39fc08d11d84a0c37bf81d8af5d6d7fe234'],0,1,1,1416009,1,,,,2947
c6ee8cbcdb6ae205624b908bc16ae462515c98e6,0,Dmitriy Lyubimov,2014-08-15 16:31:10-07:00,['445c1e3f743e687e874353b054c98253475d3413'],21,0,21,1416030,1,,,,2947
85a098a364d467616394cd76d186d44f5f49a227,1,Dmitriy Lyubimov,2014-08-15 18:25:43-07:00,['c6ee8cbcdb6ae205624b908bc16ae462515c98e6'],6,29,35,1416065,5,1,1,1,2948
656225c67fb5cc5d232ac77a4201ecd2f1136805,1,Dmitriy Lyubimov,2014-08-21 15:28:52-07:00,['85a098a364d467616394cd76d186d44f5f49a227'],11,19,30,1416095,5,0,0,0,2948
336f0e7dba88253838397dc2c579d5a6a472870f,1,Dmitriy Lyubimov,2014-08-22 12:12:59-07:00,['656225c67fb5cc5d232ac77a4201ecd2f1136805'],1,130,131,1416226,11,1,1,1,2950
74c10743dfaa3d00b7cea1b89a0432173187866c,1,Dmitriy Lyubimov,2014-08-25 22:16:29-07:00,['336f0e7dba88253838397dc2c579d5a6a472870f'],3,6,9,1416235,2,,,,2950
f870a630291bd9d623b32c21f087ba19e69eb1fc,1,Andrew Palumbo,2014-08-27 12:14:37-04:00,['74c10743dfaa3d00b7cea1b89a0432173187866c'],0,2879,2879,1419114,40,0.255091104,0.548767417,0.734190782,2987
c96498680df551f2cbd2a4735d9408044a0c7bc3,1,Andrew Palumbo,2014-08-27 15:42:37-04:00,['f870a630291bd9d623b32c21f087ba19e69eb1fc'],51,36,87,1419201,15,,,,2987
91f15ecfe5d26de36d8e9bcd6cf109b307882a32,1,Sean Owen,2014-08-28 17:38:08+01:00,['c96498680df551f2cbd2a4735d9408044a0c7bc3'],55,138,193,1419394,10,0,1,1,2989
149c98592fe447c98dfb5afc67b5809725cc3056,1,pferrel,2014-08-28 10:45:13-07:00,['91f15ecfe5d26de36d8e9bcd6cf109b307882a32'],576,1075,1651,1421045,20,0.333333333,0.63030303,0.503030303,2991
03a5bb61ed56daccd207d7a255956e21612cf995,0,Andrew Palumbo,2014-08-28 16:03:39-04:00,['149c98592fe447c98dfb5afc67b5809725cc3056'],28,28,56,1421101,13,,,,2991
6dd0c92ddb9dad2627e9ca5e28118865d6fba159,0,Andrew Palumbo,2014-08-28 20:12:22-04:00,['03a5bb61ed56daccd207d7a255956e21612cf995'],10,59,69,1421170,3,0.027777778,0,0.805555556,2991
d9e26c64d620d723c94386e1a5ef9e70588c31a3,0,Sean Owen,2014-08-29 06:19:37+01:00,['6dd0c92ddb9dad2627e9ca5e28118865d6fba159'],0,2,2,1421172,1,,,,2991
e24c4afb699c2930d372c701fe2de874a2a2f6c0,1,pferrel,2014-09-04 09:55:17-07:00,['d9e26c64d620d723c94386e1a5ef9e70588c31a3'],54,54,108,1421280,5,,,,2991
2d1b0bf632724ceb091035582274201269cfe3e3,1,Andrew Palumbo,2014-09-05 16:44:21-04:00,['e24c4afb699c2930d372c701fe2de874a2a2f6c0'],313,650,963,1422243,22,0,0.888888889,0.888888889,2991
034afd61126660b6f44b232fdf3e1dd9d1a79708,1,Andrew Palumbo,2014-09-27 10:18:30-04:00,['2d1b0bf632724ceb091035582274201269cfe3e3'],48,196,244,1422487,15,1,1,1,2994
3c88f50432dc8dd70ab7eb03e1bbf419f3f7ab81,1,Dmitriy Lyubimov,2014-09-27 10:57:24-07:00,['034afd61126660b6f44b232fdf3e1dd9d1a79708'],196,48,244,1422731,15,0,0,0,2994
c34e8a84c39b7bd2175cdbcb8583d487548a34b4,1,Andrew Palumbo,2014-10-09 16:16:14-04:00,['3c88f50432dc8dd70ab7eb03e1bbf419f3f7ab81'],48,198,246,1422977,15,1,1,1,2997
61c9e1a92975de5891f082068fb708dc30cfafa1,1,Andrew Palumbo,2014-10-10 16:43:36-04:00,['c34e8a84c39b7bd2175cdbcb8583d487548a34b4'],4,158,162,1423139,6,0.447368421,1,1,3000
4e6577d140c203eae0b634764971bf2444438f41,0,Andrew Palumbo,2014-10-10 19:45:32-04:00,['61c9e1a92975de5891f082068fb708dc30cfafa1'],3,0,3,1423142,1,1,0,0,3000
666d314fb8d9f466a5496a143d73d55036aea619,1,pferrel,2014-10-14 14:45:32-07:00,['4e6577d140c203eae0b634764971bf2444438f41'],304,535,839,1423981,23,0.85,0.76,0.14,3003
6651a328679742ce6c14ce8a4e6ab0bc0a05f7e9,0,pferrel,2014-10-16 10:32:28-07:00,['666d314fb8d9f466a5496a143d73d55036aea619'],0,1,1,1423982,1,,,,3003
c1a10d9b5a62036cbfc93a775a3817f69a85bf6e,1,pferrel,2014-10-29 10:26:57-07:00,['6651a328679742ce6c14ce8a4e6ab0bc0a05f7e9'],5,26,31,1424013,3,,,,3003
f1095d8c30d33e0e86e691f797d13c6f7bc11c4c,1,Gokhan,2014-11-05 23:09:45+02:00,['c1a10d9b5a62036cbfc93a775a3817f69a85bf6e'],256,136,392,1424405,6,,,,3003
379863d8f9dff8c0a42c341c68044c9c52b597e0,1,Suneel Marthi,2014-11-09 12:45:39-05:00,['f1095d8c30d33e0e86e691f797d13c6f7bc11c4c'],2,4,6,1424411,2,,,,3003
6530e8144f9638932092d65bbdc72faf0fc840cd,0,Suneel Marthi,2014-11-19 02:51:13-05:00,['379863d8f9dff8c0a42c341c68044c9c52b597e0'],1,1,2,1424413,1,,,,3003
ae1808be0e76c15544e75ec54aae3fc720f65364,1,pferrel,2014-12-11 16:26:57-08:00,['6530e8144f9638932092d65bbdc72faf0fc840cd'],57,74,131,1424544,7,0,1,1,3004
310534319ae8df4cd95c3ff044afb6afdaee2605,1,Andrew Palumbo,2014-12-19 16:58:05-05:00,['ae1808be0e76c15544e75ec54aae3fc720f65364'],34,2636,2670,1427214,19,0.586324786,0.958974359,0.905982906,3016
0f037cb03e77c09627c36962600e4fb00c4013c8,1,Andrew Palumbo,2014-12-19 17:43:24-05:00,['310534319ae8df4cd95c3ff044afb6afdaee2605'],7,1,8,1427222,2,1,0,0,3016
d0f64205a116853aa471dd1361a635167da15fcc,1,pferrel,2014-12-27 15:43:41-08:00,['0f037cb03e77c09627c36962600e4fb00c4013c8'],93,61,154,1427376,8,0.222222222,1,0,3016
c3936fd3820fe4fb6cdd1cba7944f016dc0d5e13,1,Andrew Palumbo,2015-01-01 22:32:13-05:00,['0f037cb03e77c09627c36962600e4fb00c4013c8'],6,5,11,1427387,2,0,0,1,3016
1ca1ef32483f35014cdd96596c454cafe83c34f3,0,Andrew Palumbo,2015-01-26 19:39:27-05:00,['c3936fd3820fe4fb6cdd1cba7944f016dc0d5e13'],0,0,0,1427387,0,,,,3016
e005b28b263ce5eeab6f105ead660a3fe89cb756,0,pferrel,2015-02-12 10:22:38-08:00,"['d0f64205a116853aa471dd1361a635167da15fcc', '1ca1ef32483f35014cdd96596c454cafe83c34f3']",6,5,11,1427398,2,,,,3016
0c672bbcd95b8f757d7faccc09d980c62576f41c,0,Dmitriy Lyubimov,2015-02-20 11:51:43-08:00,['1ca1ef32483f35014cdd96596c454cafe83c34f3'],14,17,31,1427429,7,1,1,1,3016
901ef03b4c7f7da96452fbd08018b32ef2341fe0,0,Dmitriy Lyubimov,2015-02-20 11:55:59-08:00,['0c672bbcd95b8f757d7faccc09d980c62576f41c'],0,0,0,1427429,0,,,,3016
463989272b4219716ca692cb4f9b757076d5c690,0,pferrel,2015-02-21 08:45:39-08:00,"['e005b28b263ce5eeab6f105ead660a3fe89cb756', '901ef03b4c7f7da96452fbd08018b32ef2341fe0']",12,15,27,1427456,7,,,,3016
fde08a9a57af94511fddc501dcff09fbd7825d48,1,Dmitriy Lyubimov,2015-02-24 11:51:58-08:00,['901ef03b4c7f7da96452fbd08018b32ef2341fe0'],17,14,31,1427487,7,0,0,0,3016
43bea68f363143d87f567eedff147460db5bd146,0,pferrel,2015-03-02 13:29:10-08:00,"['463989272b4219716ca692cb4f9b757076d5c690', 'fde08a9a57af94511fddc501dcff09fbd7825d48']",15,12,27,1427514,7,,,,3016
15ee1951d1ba8d8ee7d24e2510af187fd984c8cf,1,pferrel,2015-03-02 13:38:05-08:00,['43bea68f363143d87f567eedff147460db5bd146'],482,587,1069,1428583,24,0.525974026,0.688311688,1,3016
b0ee8e2657a900315140d21205416338cc955864,0,pferrel,2015-03-04 13:52:04-08:00,['15ee1951d1ba8d8ee7d24e2510af187fd984c8cf'],1,3,4,1428587,1,,,,3016
d5ea1f1be4d8ee6e3ceb7863322921c331a6c0a2,1,Andrew Palumbo,2015-03-09 20:15:00-04:00,['b0ee8e2657a900315140d21205416338cc955864'],0,321,321,1428908,3,0.607843137,1,0.294117647,3019
9b169e7e710f1a4883a15b652ad8ece86a88960f,1,Andrew Palumbo,2015-03-13 18:47:31-04:00,['d5ea1f1be4d8ee6e3ceb7863322921c331a6c0a2'],7,7,14,1428922,2,,,,3019
ec8a5a006385c0ecf25f1d982ace83bb3c41e052,0,Suneel Marthi,2015-03-24 23:31:09-04:00,['9b169e7e710f1a4883a15b652ad8ece86a88960f'],2,4,6,1428928,2,,,,3019
87c15bea46081baab98db9a0dbd480c5dac5ceb4,1,Suneel Marthi,2015-03-25 02:43:44-04:00,['ec8a5a006385c0ecf25f1d982ace83bb3c41e052'],433,324,757,1429685,132,1,0.821782178,0.277227723,3019
7476e35535b062e5ce883dfb1125001c2cf58a16,0,Suneel Marthi,2015-03-25 03:14:35-04:00,['87c15bea46081baab98db9a0dbd480c5dac5ceb4'],1,3,4,1429689,1,,,,3019
4d3a3863552e23c4aaafd82545222b0e6a3cd1fd,0,Suneel Marthi,2015-03-25 03:39:35-04:00,['7476e35535b062e5ce883dfb1125001c2cf58a16'],1,1,2,1429691,1,,,,3019
47790146ab93f742eb987f751e40645dfd530b37,1,Stevo Slavic,2015-03-26 09:32:06+01:00,['4d3a3863552e23c4aaafd82545222b0e6a3cd1fd'],17,19,36,1429727,2,,,,3019
c7241d5875a933a0b58cab0ceecb8962625040b7,1,Stevo Slavic,2015-03-26 11:36:53+01:00,['47790146ab93f742eb987f751e40645dfd530b37'],32,30,62,1429789,6,1,0,0.3,3019
b58df10f4c822ae989bb436734880940e9063fde,1,Stevo Slavic,2015-03-26 12:34:34+01:00,['c7241d5875a933a0b58cab0ceecb8962625040b7'],2,21,23,1429812,1,,,,3019
9f4abbd96bc03ec5b76ed6a67a661904051cea50,0,Stevo Slavic,2015-03-26 13:39:56+01:00,['b58df10f4c822ae989bb436734880940e9063fde'],0,5,5,1429817,1,,,,3019
f5f54a1560c708913c30d460bec361eb71ab0bd7,0,Stevo Slavic,2015-03-26 17:11:41+01:00,['9f4abbd96bc03ec5b76ed6a67a661904051cea50'],25,24,49,1429866,17,,,,3019
eeca175c3a838a8aaa821cbbcd8d0376bd17939d,0,Suneel Marthi,2015-03-28 19:50:17-04:00,['f5f54a1560c708913c30d460bec361eb71ab0bd7'],19,29,48,1429914,2,0,1,1,3019
4de8c58624556983a6745a8841c50fb2a380e0b5,0,Suneel Marthi,2015-03-28 20:57:07-04:00,['eeca175c3a838a8aaa821cbbcd8d0376bd17939d'],1,0,1,1429915,1,,,,3019
af0db6ed86dc50ac428d3b60b828f585aed7ca9c,0,Andrew Musselman,2015-03-28 22:16:48-07:00,['4de8c58624556983a6745a8841c50fb2a380e0b5'],4,5,9,1429924,1,,,,3019
cc361cb7b6588601b63ce23b5e6a984d997e8453,0,Suneel Marthi,2015-03-29 01:48:03-04:00,['af0db6ed86dc50ac428d3b60b828f585aed7ca9c'],1,1,2,1429926,1,,,,3019
6cf991c60ac73dbd32b26d8ea0b773ac07d16193,1,Stevo Slavic,2015-03-29 22:17:25+02:00,['cc361cb7b6588601b63ce23b5e6a984d997e8453'],370,158,528,1430454,7,,,,3019
205896fde04baa774f77703c5867f09b20895e6b,0,Stevo Slavic,2015-03-29 22:41:40+02:00,['6cf991c60ac73dbd32b26d8ea0b773ac07d16193'],0,5,5,1430459,1,,,,3019
089275713f5f49499d939569fd9929f2f50ce1f3,0,Stevo Slavic,2015-03-29 23:11:40+02:00,['205896fde04baa774f77703c5867f09b20895e6b'],2,14,16,1430475,2,,,,3019
e5dca85992d32133c54f2f9dca668abce2eb923f,0,Andrew Palumbo,2015-03-29 20:10:43-04:00,['089275713f5f49499d939569fd9929f2f50ce1f3'],3,3,6,1430481,2,,,,3019
4b1c133325da0119e693b69811a54a16cd77aa55,0,Suneel Marthi,2015-03-30 02:29:00-04:00,['e5dca85992d32133c54f2f9dca668abce2eb923f'],98,51,149,1430630,4,0.892857143,1,0.607142857,3019
1f17d23f6095e67a2f8d188f4817e286cf916e98,0,Andrew Musselman,2015-03-30 08:46:53-07:00,"['4b1c133325da0119e693b69811a54a16cd77aa55', 'ccaec1b267d768e890695dd36c49a34d621e1e73']",11,65,76,1430706,2,,,,3019
91c1626df337900051ead7019f70bd15fe93f6a7,0,Andrew Musselman,2015-03-30 09:33:35-07:00,['1f17d23f6095e67a2f8d188f4817e286cf916e98'],0,2,2,1430708,1,,,,3019
d5d8de1857d60b7b53b9baf0af6e7aea26bbde19,1,Andrew Palumbo,2015-03-30 16:21:25-04:00,['91c1626df337900051ead7019f70bd15fe93f6a7'],10,53,63,1430771,2,,,,3019
edec611f07d4e7a352a3332af271207652caab02,1,Andrew Palumbo,2015-03-30 16:32:24-04:00,['d5d8de1857d60b7b53b9baf0af6e7aea26bbde19'],0,3,3,1430774,2,,,,3019
5624a96c6da94ad1c95077dbbdab71409d85770c,0,Suneel Marthi,2015-03-30 23:00:50-04:00,['edec611f07d4e7a352a3332af271207652caab02'],11,7,18,1430792,3,1,0.75,1,3019
57429b176a94514acce5f6985a1299fccb8d115f,0,Suneel Marthi,2015-03-30 23:50:57-04:00,['5624a96c6da94ad1c95077dbbdab71409d85770c'],1,3,4,1430796,2,,,,3019
c0f44b79ff735d8e9e95af46bbd6afcdb97cfe65,0,Andrew Musselman,2015-03-31 14:22:52-07:00,['edec611f07d4e7a352a3332af271207652caab02'],0,15,15,1430811,1,,,,3020
312c714329135573bf83db00db58d8c8b84133e1,0,Andrew Musselman,2015-03-31 14:23:36-07:00,"['c0f44b79ff735d8e9e95af46bbd6afcdb97cfe65', '57429b176a94514acce5f6985a1299fccb8d115f']",12,10,22,1430833,4,,,,3020
0853c069f87e7e93a74edd79487c51b945187c73,0,Andrew Musselman,2015-03-31 14:52:55-07:00,['312c714329135573bf83db00db58d8c8b84133e1'],0,2,2,1430835,1,,,,3020
b988c493b562ceeaa5f82027f108c67d06c1fc19,1,pferrel,2015-04-01 11:06:30-07:00,['0853c069f87e7e93a74edd79487c51b945187c73'],197,841,1038,1431873,793,0.445901639,0.91147541,1,3024
34800682e119975183b3f24c20366acf692d128d,0,pferrel,2015-04-01 11:24:44-07:00,['b988c493b562ceeaa5f82027f108c67d06c1fc19'],0,8,8,1431881,2,,,,3024
3eb9fdf923e60c9df4a87b7f691d9a468692beb8,1,Andrew Palumbo,2015-04-01 17:13:16-04:00,['34800682e119975183b3f24c20366acf692d128d'],3,5,8,1431889,2,,,,3024
441460e77cd38acc684cb2351dad5f0e6156c1f0,0,Andrew Palumbo,2015-04-01 17:21:47-04:00,['3eb9fdf923e60c9df4a87b7f691d9a468692beb8'],1,200,201,1432090,2,,,,3025
adb0955f549dfa8f427ddb8273dd2f9d1f23a6c2,1,Stevo Slavic,2015-04-01 23:44:52+02:00,['441460e77cd38acc684cb2351dad5f0e6156c1f0'],154,28,182,1432272,3,,,,3025
6604f1d9f636bf331ac70077be557e75d3b035d9,0,Stevo Slavic,2015-04-02 00:15:24+02:00,['adb0955f549dfa8f427ddb8273dd2f9d1f23a6c2'],5,5,10,1432282,1,,,,3025
a4f24dda8f30745e1989da7f0e1cb6baaf82cc80,0,Stevo Slavic,2015-04-02 03:25:29+02:00,['6604f1d9f636bf331ac70077be557e75d3b035d9'],28,51,79,1432361,4,,,,3025
5e07c8646f46ce55400094c3ab817a87fbf3d5b5,0,Stevo Slavic,2015-04-02 04:17:56+02:00,['a4f24dda8f30745e1989da7f0e1cb6baaf82cc80'],0,3,3,1432364,1,,,,3025
260753fdb9cc2b17a3e4dbf373e79c3de4887654,1,Andrew Palumbo,2015-04-02 16:43:51-04:00,['5e07c8646f46ce55400094c3ab817a87fbf3d5b5'],16,27,43,1432407,7,0,1,1,3025
5197ac9e8393763dd4ed58f5f1e9f167e75d3078,0,Andrew Palumbo,2015-04-03 12:43:04-04:00,['260753fdb9cc2b17a3e4dbf373e79c3de4887654'],3,92,95,1432502,6,0.136363636,1,1,3027
16aeaba993556767c95a4cd59540f1d3b6992772,1,Andrew Palumbo,2015-04-03 13:53:16-04:00,['5197ac9e8393763dd4ed58f5f1e9f167e75d3078'],1,7,8,1432510,5,,,,3027
3aefb18d73e2df241f38a06d69b001f1669c1d8e,1,Andrew Musselman,2015-04-03 16:16:31-07:00,['16aeaba993556767c95a4cd59540f1d3b6992772'],4,6,10,1432520,2,,,,3027
6874995394596eb192c37a066dd750d87e602c0a,0,Andrew Musselman,2015-04-03 16:24:58-07:00,['3aefb18d73e2df241f38a06d69b001f1669c1d8e'],0,0,0,1432520,0,,,,3027
896a6ed07b3be65c8a59bfa7a2dff11bbdd2f909,0,Andrew Palumbo,2015-04-03 21:52:26-04:00,['6874995394596eb192c37a066dd750d87e602c0a'],0,0,0,1432520,0,,,,3027
2b5584bbcfa95094421b637786e1885a716f07f6,0,Andrew Palumbo,2015-04-03 21:55:00-04:00,['896a6ed07b3be65c8a59bfa7a2dff11bbdd2f909'],0,0,0,1432520,0,,,,3027
736721e0eb655c0af8c836475a6f7cc9c36a80fe,0,Andrew Palumbo,2015-04-03 21:56:56-04:00,['2b5584bbcfa95094421b637786e1885a716f07f6'],0,0,0,1432520,0,,,,3027
d1583664215742083099465c51e877fcb8369e46,0,Suneel Marthi,2015-04-03 22:04:06-04:00,['736721e0eb655c0af8c836475a6f7cc9c36a80fe'],0,0,0,1432520,0,,,,3027
1748916497e805f7fce21b9aee70e31760b50a27,0,Suneel Marthi,2015-04-03 23:56:49-04:00,['d1583664215742083099465c51e877fcb8369e46'],12,12,24,1432544,12,,,,3027
94f5464b3f42be3164061030d352ffcfc78be711,0,Suneel Marthi,2015-04-04 00:23:08-04:00,['1748916497e805f7fce21b9aee70e31760b50a27'],3,2,5,1432549,2,,,,3027
2ff34a0ed3a1d35d5fdeef6cdc1f576931104b8a,0,Suneel Marthi,2015-04-04 00:58:39-04:00,['94f5464b3f42be3164061030d352ffcfc78be711'],1,1,2,1432551,1,,,,3027
d19ee0d47a2ba44a7ff0f60998e0e0c42c4224a6,0,Suneel Marthi,2015-04-04 13:19:39-04:00,['2ff34a0ed3a1d35d5fdeef6cdc1f576931104b8a'],0,2,2,1432553,1,,,,3027
eb77ce6e6dd546d9389fd105e47c4883bd943879,0,Suneel Marthi,2015-04-04 13:21:27-04:00,['d19ee0d47a2ba44a7ff0f60998e0e0c42c4224a6'],0,2,2,1432555,1,,,,3027
1bcda32146713144eac4889c3065c448417c36f6,1,Andrew Palumbo,2015-04-04 15:47:25-04:00,['eb77ce6e6dd546d9389fd105e47c4883bd943879'],41,32,73,1432628,3,0.666666667,0,0,3027
88520fb1b54953967f4d7e299cfd772f4357c768,0,Andrew Palumbo,2015-04-04 18:59:05-04:00,['1bcda32146713144eac4889c3065c448417c36f6'],20,12,32,1432660,5,0.285714286,0.285714286,0,3027
4ef9d31ff253aeed9795379d440f8f1439651acc,1,Suneel Marthi,2015-04-05 11:53:34-04:00,['88520fb1b54953967f4d7e299cfd772f4357c768'],491,362,853,1433513,53,1,0.415384615,0.107692308,3027
3a476e44f73f02ec986bee373c7632c109f2bc69,0,Suneel Marthi,2015-04-05 12:05:34-04:00,['4ef9d31ff253aeed9795379d440f8f1439651acc'],0,0,0,1433513,0,,,,3027
d8e0568e7ff45e5fcbccf4a5aaa2df6059c4aade,0,Suneel Marthi,2015-04-05 12:14:21-04:00,['3a476e44f73f02ec986bee373c7632c109f2bc69'],47,49,96,1433609,2,,,,3027
cd366d17e1d9b4c001b0ffa08864e1ad5d21034d,1,Suneel Marthi,2015-04-05 12:34:47-04:00,['d8e0568e7ff45e5fcbccf4a5aaa2df6059c4aade'],16,34,50,1433659,3,1,0,1,3027
9b6b2361ec0a4eacfb3700d123e02ccb6291f796,0,Suneel Marthi,2015-04-05 13:08:14-04:00,['cd366d17e1d9b4c001b0ffa08864e1ad5d21034d'],14,16,30,1433689,2,0,1,0,3027
1be5a00c809fe0c7d26fcad24536428b5f0b564e,1,Andrew Palumbo,2015-04-05 13:58:02-04:00,['9b6b2361ec0a4eacfb3700d123e02ccb6291f796'],66,304,370,1434059,8,0,1,1,3027
355418e32e737fe66b18e81759461cceaff5392c,0,Suneel Marthi,2015-04-05 14:25:10-04:00,['1be5a00c809fe0c7d26fcad24536428b5f0b564e'],2,0,2,1434061,1,,,,3027
53e5adac2f24da4ff9f3276c73e89c2b14e03916,0,Andrew Palumbo,2015-04-05 15:06:14-04:00,['355418e32e737fe66b18e81759461cceaff5392c'],6,25,31,1434092,8,,,,3027
85f9ece660407fe68ad61560ebd723a57ec761e6,1,Suneel Marthi,2015-04-05 22:24:06-04:00,['53e5adac2f24da4ff9f3276c73e89c2b14e03916'],1487,1055,2542,1436634,172,1,0.218518519,0.248148148,3027
8a1978a753192a82f602f3d791ed9946cc7bcf08,1,Suneel Marthi,2015-04-05 22:29:43-04:00,['85f9ece660407fe68ad61560ebd723a57ec761e6'],2,2,4,1436638,2,,,,3027
30fe6cc83f83578c922d8c01742ae7a6939280e8,1,Andrew Palumbo,2015-04-05 23:23:29-04:00,['8a1978a753192a82f602f3d791ed9946cc7bcf08'],8,51,59,1436697,5,0,1,1,3027
ebb39fe4ae917188b7a1ac235fd8d04e30c92cba,1,Andrew Palumbo,2015-04-05 23:49:23-04:00,['30fe6cc83f83578c922d8c01742ae7a6939280e8'],1,1,2,1436699,1,,,,3027
97a920f72c6655a615522272b752e6d0cbc1d429,1,pferrel,2015-04-05 21:37:27-07:00,['ebb39fe4ae917188b7a1ac235fd8d04e30c92cba'],9,100,109,1436808,6,0,1,1,3030
d67a1d034fca4b70299c4bbc1ed77e38c7d00841,0,Andrew Palumbo,2015-04-06 01:08:53-04:00,['97a920f72c6655a615522272b752e6d0cbc1d429'],0,4,4,1436812,1,,,,3030
4cff54295d9e494eaff46a190b73bcb8d491f7e5,0,Suneel Marthi,2015-04-06 01:35:22-04:00,['d67a1d034fca4b70299c4bbc1ed77e38c7d00841'],478,108,586,1437398,27,0.338308458,0.144278607,0.218905473,3030
44a9849c075f42f5d1029d604a64a72b7415a0b4,0,pferrel,2015-04-06 08:09:22-07:00,['4cff54295d9e494eaff46a190b73bcb8d491f7e5'],3,3,6,1437404,1,,,,3030
c70d708f2c11ff9fd5974d0c124a9f56790df428,0,Andrew Musselman,2015-04-06 08:22:45-07:00,['44a9849c075f42f5d1029d604a64a72b7415a0b4'],0,0,0,1437404,0,,,,3030
db624ef35c8174e9bd5a9f63f9e2957e8bd594b8,0,Andrew Musselman,2015-04-06 09:22:52-07:00,['c70d708f2c11ff9fd5974d0c124a9f56790df428'],108,478,586,1437990,27,0.661691542,0.855721393,0.781094527,3031
a551b15e2b88b32e12860f8c01e59a8999700d14,1,Andrew Musselman,2015-04-06 11:10:37-07:00,['c70d708f2c11ff9fd5974d0c124a9f56790df428'],108,478,586,1438576,27,0.661691542,0.855721393,0.781094527,3032
92bdcf8e0f74cf8e4da858156602e658bfbe0c70,0,Andrew Musselman,2015-04-06 11:11:26-07:00,"['a551b15e2b88b32e12860f8c01e59a8999700d14', 'db624ef35c8174e9bd5a9f63f9e2957e8bd594b8']",0,0,0,1438576,0,,,,3032
670a7d219e4eab8c7735083d52cefa13e81197fb,0,Suneel Marthi,2015-04-06 22:25:12-04:00,['a551b15e2b88b32e12860f8c01e59a8999700d14'],448,75,523,1439099,23,0.342857143,0.123809524,0.195238095,3032
f63ee5fdde0f35ecd5a851c9122f5195befc9348,0,Andrew Musselman,2015-04-06 20:38:48-07:00,"['92bdcf8e0f74cf8e4da858156602e658bfbe0c70', '670a7d219e4eab8c7735083d52cefa13e81197fb']",448,75,523,1439622,23,,,,3032
33263f68c8157a63734f445669f34c326edec2d3,0,Suneel Marthi,2015-04-07 00:27:22-04:00,['670a7d219e4eab8c7735083d52cefa13e81197fb'],0,0,0,1439622,0,,,,3032
2b6c17fa0b067299eccc1365512465edcbf5f155,0,Suneel Marthi,2015-04-07 00:51:17-04:00,['33263f68c8157a63734f445669f34c326edec2d3'],0,0,0,1439622,0,,,,3032
c203c97b498a0add45ed0f213e76dddb20e33652,0,Suneel Marthi,2015-04-07 00:52:34-04:00,['2b6c17fa0b067299eccc1365512465edcbf5f155'],0,0,0,1439622,0,,,,3032
f66ce94a9f809f910eae65347a7d25f6e6fd4241,0,pferrel,2015-04-07 12:53:23-07:00,['c203c97b498a0add45ed0f213e76dddb20e33652'],6,32,38,1439660,1,,,,3032
5e41bc096444fb4d04a88e47200e4d50c406621d,0,Suneel Marthi,2015-04-07 19:39:36-04:00,['f66ce94a9f809f910eae65347a7d25f6e6fd4241'],0,0,0,1439660,0,,,,3032
27ff9df077fd498edcb5e92946be0d5041f755dd,0,Andrew Musselman,2015-04-07 16:45:19-07:00,"['f63ee5fdde0f35ecd5a851c9122f5195befc9348', '5e41bc096444fb4d04a88e47200e4d50c406621d']",6,32,38,1439698,1,,,,3032
daad3a4ce618cbd05be468c4ce6e451618f3a028,1,Andrew Musselman,2015-04-07 16:56:10-07:00,['27ff9df077fd498edcb5e92946be0d5041f755dd'],88,147,235,1439933,10,,,,3033
37b82124faf98dda5ef9f350f64477570a3bc804,0,Andrew Musselman,2015-04-07 19:31:24-07:00,['daad3a4ce618cbd05be468c4ce6e451618f3a028'],0,8,8,1439941,1,,,,3033
be5a05d126e5bf275c4bd1766962493f1c8ac342,1,Suneel Marthi,2015-04-08 00:49:17-04:00,['37b82124faf98dda5ef9f350f64477570a3bc804'],0,10,10,1439951,1,1,1,1,3033
628b1302f273accf53b2d91e6f7ac90e20c4102f,0,Suneel Marthi,2015-04-08 01:39:11-04:00,['be5a05d126e5bf275c4bd1766962493f1c8ac342'],0,2,2,1439953,1,,,,3033
c58d65d78ff349968fe9b8d8e758659fcfc001c5,0,Andrew Palumbo,2015-04-08 09:25:29-04:00,['628b1302f273accf53b2d91e6f7ac90e20c4102f'],1,1,2,1439955,1,,,,3033
77ed7bb54982d2a81e085c0689a95d4902b03960,0,Andrew Palumbo,2015-04-08 10:11:06-04:00,['c58d65d78ff349968fe9b8d8e758659fcfc001c5'],1,1,2,1439957,1,,,,3033
b5c63caf99934b1a602e64e0906a2c97b033b025,0,Andrew Musselman,2015-04-08 07:41:45-07:00,['77ed7bb54982d2a81e085c0689a95d4902b03960'],1,283,284,1440241,3,,,,3035
864ba1aea23ece6491acff38adab0cd1b0d29354,1,Andrew Musselman,2015-04-08 10:21:39-07:00,['b5c63caf99934b1a602e64e0906a2c97b033b025'],75,448,523,1440764,23,0.657142857,0.876190476,0.804761905,3036
4325123cc97770e242e10061478834bf5474ccf8,0,Andrew Palumbo,2015-04-08 14:19:51-04:00,['864ba1aea23ece6491acff38adab0cd1b0d29354'],1,1,2,1440766,2,,,,3036
3ecf5f825ca0255cdedaf085326c602e3b404b5e,0,Andrew Palumbo,2015-04-08 14:46:17-04:00,['4325123cc97770e242e10061478834bf5474ccf8'],10,0,10,1440776,1,,,,3036
c7867d52248ffe0fc4aac073dbb03dbc214d0fae,0,Suneel Marthi,2015-04-09 00:47:51-04:00,['3ecf5f825ca0255cdedaf085326c602e3b404b5e'],0,0,0,1440776,0,,,,3036
f7921f4fb50030f2a84913b080e335a2d7eb30a5,0,pferrel,2015-04-09 10:38:26-07:00,['c7867d52248ffe0fc4aac073dbb03dbc214d0fae'],4,18,22,1440798,1,,,,3036
ac021efa45e4706ceb309f6cb578c1d6910daea2,0,Stevo Slavic,2015-04-09 21:44:14+02:00,['f7921f4fb50030f2a84913b080e335a2d7eb30a5'],1,1,2,1440800,1,,,,3036
cb9be1dae4352c2cfacf9b4732e8065c062a9230,1,Suneel Marthi,2015-04-09 17:21:29-04:00,['ac021efa45e4706ceb309f6cb578c1d6910daea2'],19,20,39,1440839,12,,,,3036
f208b8a4a899fbf5ca8646cddf8960f8d5ee3c88,0,Suneel Marthi,2015-04-09 17:21:45-04:00,['cb9be1dae4352c2cfacf9b4732e8065c062a9230'],17,13,30,1440869,12,,,,3036
94cb88cad4ef7f0d06895ed8e85db3fcaf1c8656,0,Suneel Marthi,2015-04-10 00:51:09-04:00,['f208b8a4a899fbf5ca8646cddf8960f8d5ee3c88'],11,11,22,1440891,11,,,,3036
50357a4f48a8307bd1b84858dda5765f70940b94,0,Andrew Palumbo,2015-04-10 01:21:29-04:00,['f208b8a4a899fbf5ca8646cddf8960f8d5ee3c88'],2,243,245,1441136,4,,,,3039
8f46ac3e7d664219e8a3cf1e7a2cbf833aec7f47,1,Suneel Marthi,2015-04-10 01:23:58-04:00,['94cb88cad4ef7f0d06895ed8e85db3fcaf1c8656'],0,16,16,1441152,1,,,,3039
b7dc3a53af3250123f8ef82e3f259657991dfaa9,0,Andrew Palumbo,2015-04-10 01:23:00-04:00,"['50357a4f48a8307bd1b84858dda5765f70940b94', '8f46ac3e7d664219e8a3cf1e7a2cbf833aec7f47']",11,27,38,1441190,11,,,,3039
fa758ce77db00b3518a680516fe07afb58a3979e,0,Suneel Marthi,2015-04-10 01:36:50-04:00,['b7dc3a53af3250123f8ef82e3f259657991dfaa9'],1,1,2,1441192,1,,,,3039
dc6bf103f583bf8ab78f73aa5b6183042aa73022,0,Suneel Marthi,2015-04-10 01:46:38-04:00,['fa758ce77db00b3518a680516fe07afb58a3979e'],13,17,30,1441222,12,,,,3039
05fea2a13d0291917ed9605d563c899bc2ce04a9,0,Suneel Marthi,2015-04-10 01:46:54-04:00,['dc6bf103f583bf8ab78f73aa5b6183042aa73022'],17,13,30,1441252,12,,,,3039
5fdd30c3cd448fe23affcf0466d5761f146573e0,0,Suneel Marthi,2015-04-10 02:12:34-04:00,['05fea2a13d0291917ed9605d563c899bc2ce04a9'],12,12,24,1441276,12,,,,3039
fb9a7c3d0ed9b4c348d2945766e8546f560eacdd,1,Stevo Slavic,2015-04-10 18:08:58+02:00,['5fdd30c3cd448fe23affcf0466d5761f146573e0'],12,202,214,1441490,8,,,,3039
f96a86130094ba0813a1b1037481ca021f7ec17e,0,Andrew Palumbo,2015-04-10 17:00:34-04:00,['fb9a7c3d0ed9b4c348d2945766e8546f560eacdd'],4,4,8,1441498,4,,,,3039
fb30375e40062ff9b85357857d0e09dc38da25fc,1,Stevo Slavic,2015-04-11 01:11:52+02:00,['fb9a7c3d0ed9b4c348d2945766e8546f560eacdd'],8,8,16,1441514,5,,,,3039
ec0f0163d472fdaeee99088fcbb3e0b967655bec,0,Andrew Musselman,2015-04-10 16:24:57-07:00,"['f96a86130094ba0813a1b1037481ca021f7ec17e', 'fb30375e40062ff9b85357857d0e09dc38da25fc']",8,8,16,1441530,5,,,,3039
8439846c99c2c81dde6a03eb40105ea908555943,0,Andrew Palumbo,2015-04-10 20:07:58-04:00,['fb30375e40062ff9b85357857d0e09dc38da25fc'],4,4,8,1441538,4,,,,3039
832b08c40752b58a98e1a89891a1e0ff54094910,0,Suneel Marthi,2015-04-10 20:50:30-04:00,['8439846c99c2c81dde6a03eb40105ea908555943'],13,17,30,1441568,12,,,,3039
d8661ff23ce941ee601eaf206a7f3818df62bb73,0,Suneel Marthi,2015-04-10 20:50:45-04:00,['832b08c40752b58a98e1a89891a1e0ff54094910'],17,13,30,1441598,12,,,,3039
dfb444682350572379fea26535e44b12e6df5d68,0,Andrew Musselman,2015-04-11 07:21:08-07:00,"['ec0f0163d472fdaeee99088fcbb3e0b967655bec', 'd8661ff23ce941ee601eaf206a7f3818df62bb73']",12,12,24,1441622,12,,,,3039
62bff72905aa040c27eb5d021a245acd3d87d89d,0,Suneel Marthi,2015-04-11 20:35:53-04:00,['d8661ff23ce941ee601eaf206a7f3818df62bb73'],1,1,2,1441624,1,,,,3039
9cb1756c6672ba7ae2cbf0ae31b66c30bb03e898,0,Stevo Slavic,2015-04-12 23:33:30+02:00,['62bff72905aa040c27eb5d021a245acd3d87d89d'],1,1,2,1441626,1,,,,3039
4a02b701e246590a09ac1428b0fed717187815a6,0,Stevo Slavic,2015-04-13 00:04:08+02:00,['9cb1756c6672ba7ae2cbf0ae31b66c30bb03e898'],1,1,2,1441628,1,,,,3039
f758919621902a4f6622e9dc8b70f2db0c74679e,0,Stevo Slavic,2015-04-13 00:17:59+02:00,['4a02b701e246590a09ac1428b0fed717187815a6'],14,14,28,1441656,10,,,,3039
f635f6a7665bd25f61f0b2d02e8d0c55683ddd85,0,Stevo Slavic,2015-04-13 00:20:56+02:00,['f758919621902a4f6622e9dc8b70f2db0c74679e'],279,0,279,1441935,1,,,,3039
ad6885bebc7f75765e45906cfc058d7caa675d64,0,Andrew Musselman,2015-04-13 09:11:04-07:00,"['dfb444682350572379fea26535e44b12e6df5d68', 'f635f6a7665bd25f61f0b2d02e8d0c55683ddd85']",296,17,313,1442248,14,,,,3039
63e82ea2705b15f3de3e98936ca7581278f6353e,1,Stevo Slavic,2015-04-14 08:09:57+02:00,['f635f6a7665bd25f61f0b2d02e8d0c55683ddd85'],3,7,10,1442258,2,,,,3039
f7b69fabf1253b5e735e269c9410459d91816cdd,0,Stevo Slavic,2015-04-14 08:28:15+02:00,['63e82ea2705b15f3de3e98936ca7581278f6353e'],20,19,39,1442297,87,,,,3039
ef6d93a34035c848335af57289c2c0acb58a2e4a,1,Stevo Slavic,2015-04-14 23:34:28+02:00,['f7b69fabf1253b5e735e269c9410459d91816cdd'],19,20,39,1442336,87,,,,3039
3e392104be322217b37502670f75e7adbd68e093,0,Suneel Marthi,2015-04-14 20:43:58-04:00,['ef6d93a34035c848335af57289c2c0acb58a2e4a'],1,1,2,1442338,1,,,,3039
435dd49eb2ff7f02461987e4e69dcbddecf9da9a,0,Andrew Palumbo,2015-04-17 16:04:43-04:00,['3e392104be322217b37502670f75e7adbd68e093'],1,1,2,1442340,1,,,,3039
8be44ab3bb5e92c664203d0974bbfc2379496281,1,Andrew Palumbo,2015-04-21 00:29:54-04:00,['435dd49eb2ff7f02461987e4e69dcbddecf9da9a'],0,7,7,1442347,2,1,1,1,3039
6a3f93e6f695d12f63ef48c5e33f0d24658bd596,1,Andrew Palumbo,2015-04-21 23:11:50-04:00,['8be44ab3bb5e92c664203d0974bbfc2379496281'],11,53,64,1442411,3,0,0,1,3039
a3f78bde9bf87d3d37931f878015b490761e75ce,0,Suneel Marthi,2015-04-22 23:04:56-04:00,['6a3f93e6f695d12f63ef48c5e33f0d24658bd596'],57,61,118,1442529,2,0.333333333,0.333333333,1,3039
ec43b57605a6c2b8a7d1c7912246915f192e5582,0,Suneel Marthi,2015-04-23 08:24:22-04:00,['a3f78bde9bf87d3d37931f878015b490761e75ce'],1,1,2,1442531,1,,,,3039
1f9188d0789640a6514e1120bf4b44061a886165,1,Andrew Palumbo,2015-04-24 19:33:41-04:00,['ec43b57605a6c2b8a7d1c7912246915f192e5582'],1,5,6,1442537,2,0,0,1,3039
9abb526120810661fdc6495438107408cc4dd16d,1,Stevo Slavic,2015-04-26 14:49:54+02:00,['1f9188d0789640a6514e1120bf4b44061a886165'],2,4,6,1442543,2,,,,3039
244295a743554ecd2a7b5154788336735e47d694,0,Andrew Palumbo,2015-05-07 15:09:45-04:00,['9abb526120810661fdc6495438107408cc4dd16d'],13,63,76,1442619,5,,,,3040
3d78096bdb61b4ba20336f3fc51d42a5af77cc3c,1,pferrel,2015-05-20 11:16:15-07:00,['9abb526120810661fdc6495438107408cc4dd16d'],191,493,684,1443303,32,0.244444444,0.377777778,1,3042
72865b431fcfbca8148301cd02fe91c31ae497bd,0,pferrel,2015-05-20 11:53:37-07:00,"['3d78096bdb61b4ba20336f3fc51d42a5af77cc3c', '244295a743554ecd2a7b5154788336735e47d694']",0,0,0,1443303,0,,,,3042
fb54de3ff2c270d2387b3764445de1a1a02dda58,0,Stevo Slavic,2015-05-26 23:33:24+02:00,['72865b431fcfbca8148301cd02fe91c31ae497bd'],14,18,32,1443335,13,,,,3042
0b564c71e1a7d555efb5c9696275ecc69a0df026,1,Anand Avati,2015-06-22 19:49:34-07:00,['fb54de3ff2c270d2387b3764445de1a1a02dda58'],643,4251,4894,1448229,107,0.606122449,0.71122449,0.67244898,3056
bbf4e5a34e9dcdd802b353b01eeabf5794aa2942,0,Anand Avati,2015-06-22 19:59:32-07:00,['0b564c71e1a7d555efb5c9696275ecc69a0df026'],0,12,12,1448241,1,1,1,1,3056
2c143fcc06f0e9cac2e8d62bc1adfde26058b1b8,0,Anand Avati,2015-06-23 17:55:49-07:00,['bbf4e5a34e9dcdd802b353b01eeabf5794aa2942'],0,91,91,1448332,2,0,0,0,3057
856a681092b7f9c6977102ce2b83a86adc1d7387,0,Anand Avati,2015-06-23 21:17:40-07:00,['2c143fcc06f0e9cac2e8d62bc1adfde26058b1b8'],2,2,4,1448336,1,,,,3057
5d02c708a37f547258e40bd687898bae9e6fc13e,0,Anand Avati,2015-06-24 11:06:21-07:00,['856a681092b7f9c6977102ce2b83a86adc1d7387'],0,56,56,1448392,2,1,1,0,3058
5924e160823905f2e6c711cdd367c78109bf3d0e,0,Anand Avati,2015-06-24 11:06:35-07:00,['5d02c708a37f547258e40bd687898bae9e6fc13e'],1,33,34,1448426,2,0,1,0,3058
c0463c0e4508a1abe254a9f8cbc7dfa3c2a3798a,1,Dmitriy Lyubimov,2015-07-01 16:05:11-07:00,['5924e160823905f2e6c711cdd367c78109bf3d0e'],32,315,347,1448773,7,0.76119403,1,1,3058
05a97bb4e2ce57cb62262526360f28b2939aca1c,0,Dmitriy Lyubimov,2015-07-01 16:13:05-07:00,['c0463c0e4508a1abe254a9f8cbc7dfa3c2a3798a'],0,10,10,1448783,1,,,,3058
bbb90c21de046d7368c985570f7bab325485f327,1,Andrew Palumbo,2015-07-10 14:27:37-04:00,['05a97bb4e2ce57cb62262526360f28b2939aca1c'],53,127,180,1448963,6,0,0,1,3058
c943c37e0cc9695700774031c43d4421ba210c3b,1,pferrel,2015-07-18 17:17:04-07:00,['bbb90c21de046d7368c985570f7bab325485f327'],25,41,66,1449029,7,0.142857143,0.428571429,0,3058
a5a5b5144fd5b68e0ec14ffedd8c0a8b3a1b044f,1,smarthi,2015-07-31 15:41:20-04:00,['c943c37e0cc9695700774031c43d4421ba210c3b'],0,8,8,1449037,2,,,,3058
7587f40cfeb36a713f7618e496aac203567c3c72,1,smarthi,2015-07-31 15:45:09-04:00,['a5a5b5144fd5b68e0ec14ffedd8c0a8b3a1b044f'],39,42,81,1449118,3,0,1,0,3058
e75a36c569e86c272781653cf863796a2ae51f8c,0,smarthi,2015-07-31 17:00:05-04:00,['7587f40cfeb36a713f7618e496aac203567c3c72'],0,2,2,1449120,1,,,,3058
95bb303200ed1dac7bb097ded3d10199556e90c2,0,smarthi,2015-07-31 17:00:56-04:00,['e75a36c569e86c272781653cf863796a2ae51f8c'],0,2,2,1449122,1,,,,3058
3930aafb3100f860e60f9cf48ec122f54eaabf2e,0,Andrew Palumbo,2015-08-02 17:26:29-04:00,['95bb303200ed1dac7bb097ded3d10199556e90c2'],0,7,7,1449129,3,,,,3058
0b3b4911b52c779ca1749673ab65c97c6014e0ab,0,smarthi,2015-08-02 17:56:15-04:00,['3930aafb3100f860e60f9cf48ec122f54eaabf2e'],7,22,29,1449158,22,,,,3058
4e19a530e15189a7c6ee6342e566f6d1e32aff03,0,smarthi,2015-08-02 18:31:32-04:00,['0b3b4911b52c779ca1749673ab65c97c6014e0ab'],2,6,8,1449166,6,,,,3058
a04e2c3662084adea7dedeb1b023c37ee28fd6d4,0,smarthi,2015-08-02 19:01:34-04:00,['4e19a530e15189a7c6ee6342e566f6d1e32aff03'],0,0,0,1449166,0,,,,3058
d11a2d7a012931794bfae34a2a6b85f60c956ba3,0,smarthi,2015-08-02 19:19:25-04:00,['a04e2c3662084adea7dedeb1b023c37ee28fd6d4'],13,17,30,1449196,12,,,,3058
3c8c8e216bf9c86f88a1c4990fa8118a55194c13,0,smarthi,2015-08-02 19:19:41-04:00,['d11a2d7a012931794bfae34a2a6b85f60c956ba3'],17,13,30,1449226,12,,,,3058
77a780ab4edb46c46772ce9582da746712f36d03,0,smarthi,2015-08-03 01:15:29-04:00,['3c8c8e216bf9c86f88a1c4990fa8118a55194c13'],12,12,24,1449250,12,,,,3058
bdad547ca0d96d457f714527faecd0ba0b9e8df1,1,smarthi,2015-08-03 01:30:50-04:00,['77a780ab4edb46c46772ce9582da746712f36d03'],1,1,2,1449252,1,,,,3058
2ddda854d41d251fee40e6e51046d0f086161ce6,0,smarthi,2015-08-03 02:01:55-04:00,['bdad547ca0d96d457f714527faecd0ba0b9e8df1'],13,17,30,1449282,12,,,,3058
9885c64d04c84bb5c808cfcf43d7c5b8e0561f6c,0,smarthi,2015-08-03 02:02:16-04:00,['2ddda854d41d251fee40e6e51046d0f086161ce6'],17,13,30,1449312,12,,,,3058
0fecda4a30fdbb8e51124924e6b48fdda39910d2,0,smarthi,2015-08-05 00:35:37-04:00,['9885c64d04c84bb5c808cfcf43d7c5b8e0561f6c'],12,12,24,1449336,12,,,,3058
dbd9f75c8c4153c823501b20be3a1fbb80aaafe8,0,smarthi,2015-08-05 12:49:18-04:00,['0fecda4a30fdbb8e51124924e6b48fdda39910d2'],13,17,30,1449366,12,,,,3058
3d6285b7ab0ba56a5f79342b002eb8160447f8b3,0,smarthi,2015-08-05 12:49:38-04:00,['dbd9f75c8c4153c823501b20be3a1fbb80aaafe8'],17,13,30,1449396,12,,,,3058
00c670b04a5918f2e986d2d417c2cb7693f34536,0,smarthi,2015-08-05 13:10:42-04:00,['3d6285b7ab0ba56a5f79342b002eb8160447f8b3'],12,12,24,1449420,12,,,,3058
d98e33f6ce9cd7f03614311c0e990833d8aa90d4,1,Andrew Musselman,2015-08-05 11:13:16-07:00,['00c670b04a5918f2e986d2d417c2cb7693f34536'],0,58,58,1449478,1,,,,3058
31114b4e314f8ea15cc4a0170db0aae8eb0ebb39,1,Andrew Musselman,2015-08-05 17:47:15-07:00,['d98e33f6ce9cd7f03614311c0e990833d8aa90d4'],33,74,107,1449585,3,,,,3058
1b3f34534980d2b5e664e2d355cc81c465249084,0,Andrew Musselman,2015-08-05 19:34:26-07:00,['31114b4e314f8ea15cc4a0170db0aae8eb0ebb39'],13,17,30,1449615,12,,,,3058
7b55d387f54bc7ca85081aac4d9bf47472867d47,0,Andrew Musselman,2015-08-05 19:35:22-07:00,['1b3f34534980d2b5e664e2d355cc81c465249084'],17,13,30,1449645,12,,,,3058
459e9acba620fa59540cf755cb927f7a0843631b,0,Andrew Musselman,2015-08-05 19:40:18-07:00,['7b55d387f54bc7ca85081aac4d9bf47472867d47'],12,12,24,1449669,12,,,,3058
b3a44a4ab274266a0a0808f8c401e80059db48ac,0,smarthi,2015-08-06 00:31:35-04:00,['459e9acba620fa59540cf755cb927f7a0843631b'],13,17,30,1449699,12,,,,3058
261aa47c5c120c3961465d6d84e11a78a9bf983d,0,smarthi,2015-08-06 00:31:51-04:00,['b3a44a4ab274266a0a0808f8c401e80059db48ac'],17,13,30,1449729,12,,,,3058
20be890bcce6c852def5855dd7d8bc69b249fe8f,1,smarthi,2015-08-08 14:06:11-04:00,['261aa47c5c120c3961465d6d84e11a78a9bf983d'],2,4,6,1449735,1,,,,3058
002943be77e9da8e7d6c0d41e55fffe8bf4ea817,0,smarthi,2015-08-08 14:18:49-04:00,['20be890bcce6c852def5855dd7d8bc69b249fe8f'],2996,2,2998,1452733,11,0.737569061,0.303867403,0.130755064,3058
785668906b5e69db6c9352ffba961b49bda450d2,0,smarthi,2015-08-08 14:35:41-04:00,['002943be77e9da8e7d6c0d41e55fffe8bf4ea817'],1,53,54,1452787,3,1,1,1,3059
d177b0a4852df8c2172c7f218131a9d250c5a1dd,0,smarthi,2015-08-08 14:59:29-04:00,['785668906b5e69db6c9352ffba961b49bda450d2'],9,29,38,1452825,2,0.9,1,1,3059
1cfa8eab6b2aaa8e01e7ac162926ed3fbc6fe44d,0,Andrew Musselman,2015-08-21 15:17:46-07:00,"['d177b0a4852df8c2172c7f218131a9d250c5a1dd', 'ad6885bebc7f75765e45906cfc058d7caa675d64']",0,0,0,1452825,0,,,,3059
77be783e845dec2f7bf0f90cc693a86bb9ab001a,0,smarthi,2015-09-08 19:25:56-04:00,['d177b0a4852df8c2172c7f218131a9d250c5a1dd'],1,1,2,1452827,1,,,,3059
9d14053c80a1244bdf7157ab02748a492ae9868a,0,smarthi,2015-09-08 19:36:59-04:00,['77be783e845dec2f7bf0f90cc693a86bb9ab001a'],0,2,2,1452829,1,,,,3059
bb4c4bcaf452d67b75b3c8d7c500cca6aeb31036,0,Alexey Grigorev,2015-09-25 17:41:36+02:00,['9d14053c80a1244bdf7157ab02748a492ae9868a'],2,341,343,1453172,6,1,1,0.510204082,3063
98d4ff0312e6228c7f34d6030a493d2aec794e03,1,Alexey Grigorev,2015-09-25 17:41:37+02:00,['bb4c4bcaf452d67b75b3c8d7c500cca6aeb31036'],46,599,645,1453817,12,1,1,1,3070
f836481b823a1aaaa70d9ab87c030f60c459de0d,1,Alexey Grigorev,2015-09-25 17:41:39+02:00,['98d4ff0312e6228c7f34d6030a493d2aec794e03'],49,285,334,1454151,7,1,1,0.555555556,3073
92f48afbb6da34e58ce738eef44f2dec80a60bf1,0,Alexey Grigorev,2015-09-25 17:41:40+02:00,['f836481b823a1aaaa70d9ab87c030f60c459de0d'],4,285,289,1454440,6,1,0.108108108,0.594594595,3075
a5f0f755fac4a39475b91da8c5977899faa5df77,0,Alexey Grigorev,2015-09-25 17:41:42+02:00,['92f48afbb6da34e58ce738eef44f2dec80a60bf1'],30,194,224,1454664,8,0.076923077,0.076923077,0.076923077,3078
de7a75fb3e8bdc2c4768c024a041bb9f11949760,0,Alexey Grigorev,2015-09-25 17:41:43+02:00,['a5f0f755fac4a39475b91da8c5977899faa5df77'],5,74,79,1454743,4,1,1,1,3079
522f3d516cefd44272cdbf5b4b4f52574200dd6c,1,Alexey Grigorev,2015-09-25 17:41:44+02:00,['de7a75fb3e8bdc2c4768c024a041bb9f11949760'],1,70,71,1454814,4,1,1,1,3080
df1db7cc775ed5e10c6416e033e25e430ffdd171,1,Alexey Grigorev,2015-09-25 17:41:45+02:00,['522f3d516cefd44272cdbf5b4b4f52574200dd6c'],20,62,82,1454896,2,1,1,1,3080
de732d4bc7fae9d4719ecba54decd14376551344,0,Alexey Grigorev,2015-09-25 17:41:46+02:00,['df1db7cc775ed5e10c6416e033e25e430ffdd171'],18,5,23,1454919,1,0,0,1,3080
b3bda195ad72cdbab0c31a80acc409a8a415d11e,0,Alexey Grigorev,2015-09-25 17:41:47+02:00,['de732d4bc7fae9d4719ecba54decd14376551344'],0,1,1,1454920,1,,,,3080
1806ca809beb2312c62e83b3dbab314b90172118,0,Alexey Grigorev,2015-09-25 17:41:48+02:00,['b3bda195ad72cdbab0c31a80acc409a8a415d11e'],29,38,67,1454987,5,,,,3081
0e7b0b4623ff802323027a5e6cd4568e60b2a793,1,Alexey Grigorev,2015-09-25 17:41:49+02:00,['1806ca809beb2312c62e83b3dbab314b90172118'],99,511,610,1455597,11,0.751515152,0.884848485,0.824242424,3087
58f79489129c73b9a4bd7cd5a503cfaf723ccaef,0,Alexey Grigorev,2015-09-25 17:41:50+02:00,['0e7b0b4623ff802323027a5e6cd4568e60b2a793'],672,1097,1769,1457366,26,,,,3087
08ad113f732adfe844cb5fb68ab5897f75aa2456,1,Alexey Grigorev,2015-09-25 17:41:51+02:00,['58f79489129c73b9a4bd7cd5a503cfaf723ccaef'],754,878,1632,1458998,11,1,1,1,3089
8de8b798f0ffa374c2b18e00b8130ac0a0d8e918,0,Alexey Grigorev,2015-09-25 17:41:53+02:00,['08ad113f732adfe844cb5fb68ab5897f75aa2456'],14,45,59,1459057,4,,,,3089
f66477fc53581796035e1dfef06d57e12719f1c5,0,Alexey Grigorev,2015-09-25 17:41:54+02:00,['8de8b798f0ffa374c2b18e00b8130ac0a0d8e918'],5,39,44,1459101,1,1,1,1,3089
851eebcb648752f1a3bff08191d19ce3d6f66ab5,0,Alexey Grigorev,2015-09-25 17:41:55+02:00,['f66477fc53581796035e1dfef06d57e12719f1c5'],146,168,314,1459415,12,,,,3089
be815fb25f4c008bf3809bb444e3d8562dea96fa,0,Alexey Grigorev,2015-09-25 17:41:56+02:00,['851eebcb648752f1a3bff08191d19ce3d6f66ab5'],18,14,32,1459447,1,1,1,0,3089
4bafc76276ff3d6a3eb1687d4d1c3f834671a482,0,Alexey Grigorev,2015-09-25 17:41:57+02:00,['be815fb25f4c008bf3809bb444e3d8562dea96fa'],1,1,2,1459449,1,,,,3089
ceb1f050cfaf50548bcad83f661d0ad01fe96122,1,Alexey Grigorev,2015-09-25 17:41:58+02:00,['4bafc76276ff3d6a3eb1687d4d1c3f834671a482'],5,81,86,1459535,9,,,,3093
9d48487cf2a7060193b305c152b8ce191f7d15be,1,Alexey Grigorev,2015-09-25 17:42:50+02:00,['ceb1f050cfaf50548bcad83f661d0ad01fe96122'],19,95,114,1459649,4,1,1,1,3094
f26245b8f06d2c05a818f47c9162df6f4d7f7b67,0,Alexey Grigorev,2015-09-25 17:43:41+02:00,['9d48487cf2a7060193b305c152b8ce191f7d15be'],5,89,94,1459743,4,0.19047619,1,0.19047619,3094
2a4e9690c82fa341741f52fa7ccb64cab8ea66df,0,Alexey Grigorev,2015-09-25 17:44:21+02:00,['f26245b8f06d2c05a818f47c9162df6f4d7f7b67'],5,11,16,1459759,2,,,,3094
fcc6cf17a7820de9d0edd6bbca023086c84913ee,0,Alexey Grigorev,2015-09-25 17:44:49+02:00,['2a4e9690c82fa341741f52fa7ccb64cab8ea66df'],1,15,16,1459775,2,,,,3094
d13f48849ad5658cc03acea57f7c5d9d14bad137,1,Alexey Grigorev,2015-09-25 17:45:53+02:00,['fcc6cf17a7820de9d0edd6bbca023086c84913ee'],45,95,140,1459915,2,1,1,0,3095
35426a96b98bb74538466318c5347d2f90415e97,0,Alexey Grigorev,2015-09-25 17:46:20+02:00,['d13f48849ad5658cc03acea57f7c5d9d14bad137'],3,30,33,1459948,2,1,1,1,3095
3112f3c67abbf0368cb5729c8561201e65dc674b,0,Alexey Grigorev,2015-09-25 17:46:31+02:00,['35426a96b98bb74538466318c5347d2f90415e97'],7,2,9,1459957,1,,,,3095
19708f46a41d0bc437f904a383876858a3fef35d,0,Alexey Grigorev,2015-09-25 17:47:05+02:00,['3112f3c67abbf0368cb5729c8561201e65dc674b'],52,112,164,1460121,10,1,1,1,3095
137b3b840eff74f0833d5678a55af2dde4a316a7,0,Alexey Grigorev,2015-09-25 17:47:46+02:00,['19708f46a41d0bc437f904a383876858a3fef35d'],17,21,38,1460159,2,0,0,0,3095
78c9ac2ea3b14cdf20d38fbc3f7bbee1b059d610,1,Alexey Grigorev,2015-09-25 17:48:16+02:00,['137b3b840eff74f0833d5678a55af2dde4a316a7'],29,147,176,1460335,4,0.763157895,1,0.855263158,3095
c72698aca16368c4f16d5181fbdd3db6314c04e3,0,Alexey Grigorev,2015-10-06 09:54:48+02:00,['78c9ac2ea3b14cdf20d38fbc3f7bbee1b059d610'],21,0,21,1460356,1,,,,3095
0df6e08f27c76c6eeb4a714e0087722bef166970,0,Dmitriy Lyubimov,2015-10-19 23:26:43-07:00,['c72698aca16368c4f16d5181fbdd3db6314c04e3'],29,16,45,1460401,10,,,,3095
7039f4c5f1fb86edc02e56f8a159a1a8bd4c51db,0,smarthi,2015-10-22 14:04:57-04:00,['c72698aca16368c4f16d5181fbdd3db6314c04e3'],17,16,33,1460434,13,,,,3095
f5a4a976288a3ec10942f1b28ea793bacac33955,1,smarthi,2015-10-23 18:23:43-04:00,['7039f4c5f1fb86edc02e56f8a159a1a8bd4c51db'],31,31,62,1460496,7,,,,3095
9f6f62acfaa501f183bdfd29c42de815db24201d,0,Dmitriy Lyubimov,2015-10-24 14:07:07-07:00,"['0df6e08f27c76c6eeb4a714e0087722bef166970', 'f5a4a976288a3ec10942f1b28ea793bacac33955']",48,47,95,1460591,19,,,,3095
edc0c69ac5456c13d74ab1d5c656d6a3ee17f246,0,Dmitriy Lyubimov,2015-10-24 14:18:59-07:00,['9d14053c80a1244bdf7157ab02748a492ae9868a'],2,2,4,1460595,2,,,,3095
9831771b868e254413d0c52c6fc1ad1e1c664d04,0,Dmitriy Lyubimov,2015-10-24 14:29:07-07:00,"['9f6f62acfaa501f183bdfd29c42de815db24201d', 'edc0c69ac5456c13d74ab1d5c656d6a3ee17f246']",0,0,0,1460595,0,,,,3095
9e9ec79d6ceac7928e78be1dcf48c421c851b4bb,1,Dmitriy Lyubimov,2015-10-24 20:26:56-07:00,['9831771b868e254413d0c52c6fc1ad1e1c664d04'],49,49,98,1460693,16,,,,3095
41dcb4253af7fdccee81b2f2acf22e6a904c2b9d,0,smarthi,2015-10-24 23:38:15-04:00,['9e9ec79d6ceac7928e78be1dcf48c421c851b4bb'],51,52,103,1460796,15,,,,3095
1d9b6322e4db2cfd0b681e27591fe81206a915f5,0,smarthi,2015-10-24 23:43:53-04:00,['41dcb4253af7fdccee81b2f2acf22e6a904c2b9d'],0,1,1,1460797,1,,,,3095
e943b0a0df28b20cf93aba8778a02eb68fead6c4,0,smarthi,2015-10-24 23:51:15-04:00,['1d9b6322e4db2cfd0b681e27591fe81206a915f5'],13,6,19,1460816,2,0,0,0,3095
7552c55e2c0705ebc5fd43cbb2026b4dbf46f1ec,0,smarthi,2015-10-25 00:29:47-04:00,['edc0c69ac5456c13d74ab1d5c656d6a3ee17f246'],4,7,11,1460827,1,,,,3095
37dccb87ea86ca54e56409df62474be8fe56761c,0,smarthi,2015-10-25 00:41:44-04:00,['7552c55e2c0705ebc5fd43cbb2026b4dbf46f1ec'],1,3,4,1460831,1,,,,3095
0753d422ba74aa20079075215c01684bbdce7d43,0,smarthi,2015-10-25 00:45:06-04:00,['37dccb87ea86ca54e56409df62474be8fe56761c'],0,0,0,1460831,0,,,,3095
d53f0a5d78000045bb12e90e3a6808cc2c369450,0,smarthi,2015-10-25 09:57:46-04:00,['e943b0a0df28b20cf93aba8778a02eb68fead6c4'],4,7,11,1460842,1,,,,3095
0c6351fa5459920ccfd752f54f8fd41176b0afe8,0,smarthi,2015-10-25 09:57:46-04:00,['d53f0a5d78000045bb12e90e3a6808cc2c369450'],1,3,4,1460846,1,,,,3095
dc890d99a26f64dd04f0458e0d1dc58299483095,0,smarthi,2015-10-25 14:01:22-04:00,['0753d422ba74aa20079075215c01684bbdce7d43'],8,215,223,1461069,2,,,,3095
1d42df192fb7f941da4ca9ed4aa5c667bfa79e93,0,smarthi,2015-10-25 19:37:42-04:00,['dc890d99a26f64dd04f0458e0d1dc58299483095'],0,0,0,1461069,0,,,,3095
38d0808523800a4369b18251e58b04d61771baf5,1,smarthi,2015-10-26 20:59:42-07:00,['0c6351fa5459920ccfd752f54f8fd41176b0afe8'],50,116,166,1461235,7,0,1,1,3096
854a2893c9b30fea78f9f93d59848f0eb62b175b,0,smarthi,2015-10-27 00:19:46-04:00,['38d0808523800a4369b18251e58b04d61771baf5'],2,0,2,1461237,1,,,,3096
509c966f1b0f8fcd9a63cac1bc16f089b0b615df,1,smarthi,2015-10-27 01:33:15-04:00,['1d42df192fb7f941da4ca9ed4aa5c667bfa79e93'],8,154,162,1461399,7,0.183098592,0.183098592,0.943661972,3096
5a6d140599024cd8a6bb2a4b2187376fbad40a7d,1,smarthi,2015-10-27 01:37:25-04:00,['854a2893c9b30fea78f9f93d59848f0eb62b175b'],8,154,162,1461561,7,0.183098592,0.183098592,0.943661972,3096
708cc4f2b6c16ca76005d0a06b4dc8e3f0bacd3a,0,smarthi,2015-11-03 20:15:07-05:00,['509c966f1b0f8fcd9a63cac1bc16f089b0b615df'],320,0,320,1461881,4,0.809160305,0.564885496,0.320610687,3096
82e78a8c9a1beee637ad381baf3ff9d4bb4297cc,0,smarthi,2015-11-03 20:30:37-05:00,['708cc4f2b6c16ca76005d0a06b4dc8e3f0bacd3a'],2519,0,2519,1464400,21,0.450680272,0.150510204,0.097789116,3096
e0b8b90e91c2ea72e2562d504ad16051cf759787,1,smarthi,2015-11-04 22:27:36-05:00,['82e78a8c9a1beee637ad381baf3ff9d4bb4297cc'],4,318,322,1464722,6,,,,3099
c113a8c9314a7f21ffb282d043565006a9d5c9c7,0,smarthi,2015-11-04 22:50:50-05:00,['e0b8b90e91c2ea72e2562d504ad16051cf759787'],1,1,2,1464724,1,,,,3099
126c165ca09cf3b0f85f6a83fb080e8283c1fed0,1,smarthi,2015-11-05 18:15:51-05:00,['c113a8c9314a7f21ffb282d043565006a9d5c9c7'],9,6,15,1464739,3,,,,3099
347c2f2ec61f6a83e06c00c19d069acaf3a938b7,0,Andrew Palumbo,2015-11-05 22:22:18-05:00,['126c165ca09cf3b0f85f6a83fb080e8283c1fed0'],18,51,69,1464808,2,,,,3100
48bfb64f1b57844d37a693f5aaafd10699b355df,0,smarthi,2015-11-05 23:43:52-05:00,['347c2f2ec61f6a83e06c00c19d069acaf3a938b7'],0,0,0,1464808,0,,,,3100
1ffa3a4609f58f9144a69422b202ae53cd8ef6c9,0,smarthi,2015-11-06 00:15:09-05:00,['48bfb64f1b57844d37a693f5aaafd10699b355df'],942,63,1005,1465813,70,0.931603774,0.634433962,0.202830189,3100
ebdd44fc8ce6c0275dd76570814ce9e549706bcc,0,smarthi,2015-11-06 00:56:31-05:00,['1ffa3a4609f58f9144a69422b202ae53cd8ef6c9'],13,17,30,1465843,12,,,,3100
6f9a8125f5aa54ab6f58da0640b982a2dae41170,0,smarthi,2015-11-06 00:59:20-05:00,['ebdd44fc8ce6c0275dd76570814ce9e549706bcc'],17,13,30,1465873,12,,,,3100
0c4b464335f4d663471f289a0794efcc651c519d,0,smarthi,2015-11-06 01:12:10-05:00,['6f9a8125f5aa54ab6f58da0640b982a2dae41170'],13,17,30,1465903,12,,,,3100
884f2d317f2e2a4e1321a5febddc8499e7715209,0,smarthi,2015-11-06 01:13:24-05:00,['0c4b464335f4d663471f289a0794efcc651c519d'],17,13,30,1465933,12,,,,3100
390faac19c957f60e44c6daf40ee9534c13dd5a4,0,smarthi,2015-11-06 01:26:53-05:00,['884f2d317f2e2a4e1321a5febddc8499e7715209'],13,17,30,1465963,12,,,,3100
0db570698ddc749a02062a5818f5ef313a49bbf2,0,smarthi,2015-11-06 01:27:10-05:00,['390faac19c957f60e44c6daf40ee9534c13dd5a4'],17,13,30,1465993,12,,,,3100
6785ba1a0c28fd530464144ac2731f2b977af1f1,0,smarthi,2015-11-06 11:40:15-05:00,['0db570698ddc749a02062a5818f5ef313a49bbf2'],12,12,24,1466017,12,,,,3100
242c1e23b457d2fa99e1a8e8eabcc2b39c86d723,0,Andrew Palumbo,2015-11-06 12:45:50-05:00,['6785ba1a0c28fd530464144ac2731f2b977af1f1'],1,1,2,1466019,1,,,,3100
afeff1e39a74de08d6a25cbdb80d2b08e5b345b5,0,smarthi,2015-11-06 12:55:17-05:00,['242c1e23b457d2fa99e1a8e8eabcc2b39c86d723'],3,0,3,1466022,1,,,,3100
a6d6bf503b528d2180f85224c7df9a84925cd633,0,smarthi,2015-11-06 14:12:43-05:00,['afeff1e39a74de08d6a25cbdb80d2b08e5b345b5'],13,17,30,1466052,12,,,,3100
115ae609aca1737007b2b44f8a3d8eafc53d0271,0,smarthi,2015-11-06 14:12:59-05:00,['a6d6bf503b528d2180f85224c7df9a84925cd633'],17,13,30,1466082,12,,,,3100
cc710b0d4e699f1683b042020b2cd9d5b682a466,1,smarthi,2015-11-06 17:48:26-05:00,['5a6d140599024cd8a6bb2a4b2187376fbad40a7d'],7,13,20,1466102,2,0,1,1,3100
c2b077f0a22ffbf1ca6c74d694bfadda06d6db44,1,smarthi,2015-11-07 21:01:55-05:00,['115ae609aca1737007b2b44f8a3d8eafc53d0271'],17,13,30,1466132,4,,,,3100
bf1cdd428c02552cb27c87de89c63a896d1cb0e6,0,smarthi,2015-11-07 23:39:58-05:00,['cc710b0d4e699f1683b042020b2cd9d5b682a466'],14,10,24,1466156,3,,,,3100
ec10963a436fea7d5775482fb22acb16bb970f1d,1,smarthi,2015-11-07 23:53:58-05:00,['c2b077f0a22ffbf1ca6c74d694bfadda06d6db44'],7,13,20,1466176,2,0,1,1,3100
3e5491535695048d0f7ada9bd741cf76379eb643,1,smarthi,2015-11-09 23:13:28-05:00,['bf1cdd428c02552cb27c87de89c63a896d1cb0e6'],7,5,12,1466188,4,0,0,0,3100
54f51de82cd8281c1ea27a9b9b8d8703191da504,0,smarthi,2015-11-09 23:21:04-05:00,['3e5491535695048d0f7ada9bd741cf76379eb643'],0,0,0,1466188,0,,,,3100
e2ab67f2629a6c49c4d8e911274b409c2b57101c,1,smarthi,2015-11-10 19:51:20-05:00,['54f51de82cd8281c1ea27a9b9b8d8703191da504'],167,129,296,1466484,18,0,0,0.028571429,3100
67c78209b68955a9bef219e3b1ed69c92e8e68a4,0,smarthi,2015-11-12 01:10:54-05:00,['ec10963a436fea7d5775482fb22acb16bb970f1d'],0,17,17,1466501,1,,,,3100
af015ece73400d7a215bc109835800ec1b480f0e,0,smarthi,2015-11-12 01:15:20-05:00,['e2ab67f2629a6c49c4d8e911274b409c2b57101c'],0,17,17,1466518,1,,,,3100
99d8ce24b3ae3e4ea413bee2e09da72ff3faf723,0,smarthi,2015-11-16 21:52:39-05:00,['67c78209b68955a9bef219e3b1ed69c92e8e68a4'],2,2,4,1466522,1,,,,3100
89e19c75e80fd9523af5eb208cc13674db7a847f,0,Albert Chu,2015-11-19 13:45:45-08:00,['99d8ce24b3ae3e4ea413bee2e09da72ff3faf723'],7,32,39,1466561,6,,,,3100
599101083ab7d31600b8c93b2efd8cea4c0a30bf,0,Albert Chu,2015-11-19 13:46:05-08:00,['89e19c75e80fd9523af5eb208cc13674db7a847f'],3,3,6,1466567,3,,,,3100
57317a51a8da516d6e25000eae7db8b4102cbda3,0,Andrew Musselman,2016-01-15 19:22:41-08:00,['99d8ce24b3ae3e4ea413bee2e09da72ff3faf723'],4,4,8,1466575,1,,,,3100
6919fd9febe1585d15e78e51aabcad8fa29235f3,0,Andrew Palumbo,2016-03-07 23:35:37-05:00,['57317a51a8da516d6e25000eae7db8b4102cbda3'],274,460,734,1467309,54,0.888888889,0.888888889,1,3100
e3935bbad97eeb55cbe9f2cd60b8a7ec969a6c62,0,smarthi,2016-03-08 00:15:50-05:00,['af015ece73400d7a215bc109835800ec1b480f0e'],2,2,4,1467313,1,,,,3100
f66e022c631c134e8b7e138e25d8fd94011d1b4c,0,smarthi,2016-03-08 00:18:49-05:00,['e3935bbad97eeb55cbe9f2cd60b8a7ec969a6c62'],1,9,10,1467323,1,,,,3100
97a3f2e022bd2c5fbefb4b53d670b3f313a39cc9,1,smarthi,2016-03-08 00:21:03-05:00,['f66e022c631c134e8b7e138e25d8fd94011d1b4c'],295,473,768,1468091,53,0.888888889,0.888888889,1,3100
fcd6b9e01aea5f92fd947c0964ef7884314f33db,0,Andrew Palumbo,2016-03-08 00:44:48-05:00,['6919fd9febe1585d15e78e51aabcad8fa29235f3'],460,274,734,1468825,54,0.111111111,0.111111111,0,3100
e8b9c8003b15143a7dd64af074be8b06c9eb35a2,1,Andrew Palumbo,2016-03-08 11:34:56-05:00,['fcd6b9e01aea5f92fd947c0964ef7884314f33db'],274,460,734,1469559,54,0.888888889,0.888888889,1,3100
f6224fcf7e3dc2cfdf086c553e6b7f3e872263aa,1,smarthi,2016-03-08 11:38:37-05:00,['e8b9c8003b15143a7dd64af074be8b06c9eb35a2'],41,29,70,1469629,14,,,,3100
2b023cf88e09efc301e9d970fd834cb05d96287c,1,Andrew Palumbo,2016-03-08 15:18:45-05:00,['e8b9c8003b15143a7dd64af074be8b06c9eb35a2'],1,1,2,1469631,1,,,,3100
a3cdff6d6f5a10457bb7c17a3f976f9b67c39b6a,0,Andrew Palumbo,2016-03-08 15:19:41-05:00,"['2b023cf88e09efc301e9d970fd834cb05d96287c', 'f6224fcf7e3dc2cfdf086c553e6b7f3e872263aa']",41,29,70,1469701,14,,,,3100
284651dc05c0c57ba094ba738a20db6cbe3bbcd7,1,smarthi,2016-03-08 15:32:57-05:00,['a3cdff6d6f5a10457bb7c17a3f976f9b67c39b6a'],86,91,177,1469878,5,0,0,0,3100
b21381b92ef9a0e92d8360273a1dcbf368f2a9a1,1,smarthi,2016-03-08 18:02:42-05:00,['284651dc05c0c57ba094ba738a20db6cbe3bbcd7'],1,6,7,1469885,1,1,1,1,3100
5926df8f1130106ff6ff525a3d670f6fff567f0b,1,smarthi,2016-03-08 21:45:11-05:00,['b21381b92ef9a0e92d8360273a1dcbf368f2a9a1'],29,29,58,1469943,1,1,0.5,0,3100
85e543c9af73b1fa560c11124361772e7cf59e9e,1,smarthi,2016-03-08 22:54:05-05:00,['5926df8f1130106ff6ff525a3d670f6fff567f0b'],0,1,1,1469944,1,,,,3100
a4bba8261f848ea7833bd5723a515ee3bd10989c,1,Andrew Palumbo,2016-03-08 22:55:36-05:00,['85e543c9af73b1fa560c11124361772e7cf59e9e'],30,48,78,1470022,7,1,1,1,3100
d9b376e37e2b9613baf6fb774f6cb9d3b88560b8,0,Andrew Palumbo,2016-03-08 23:05:03-05:00,['a4bba8261f848ea7833bd5723a515ee3bd10989c'],1,1,2,1470024,1,,,,3100
c401eb9ae18e67b3d504e0db7aace47e194e53d5,0,smarthi,2016-03-09 17:58:39-05:00,['97a3f2e022bd2c5fbefb4b53d670b3f313a39cc9'],41,29,70,1470094,14,,,,3100
05f1b8ff0486e648a29eccaff00c48a0b1fc3f03,0,smarthi,2016-03-09 18:05:07-05:00,['c401eb9ae18e67b3d504e0db7aace47e194e53d5'],3,4,7,1470101,1,,,,3100
6ca09989dbd32f319372444595265faa2d5606ea,1,smarthi,2016-03-09 18:10:26-05:00,['05f1b8ff0486e648a29eccaff00c48a0b1fc3f03'],86,96,182,1470283,5,0,1,1,3100
c238b3fd80cae020bae4cb8be1838e6104a22d43,0,smarthi,2016-03-09 18:11:21-05:00,['6ca09989dbd32f319372444595265faa2d5606ea'],29,29,58,1470341,1,1,0.5,0,3100
f1018ed184f741a78cce3ba887442e8786662b54,0,smarthi,2016-03-09 18:11:58-05:00,['c238b3fd80cae020bae4cb8be1838e6104a22d43'],0,1,1,1470342,1,,,,3100
46071e6f3eb9ed53895222a54657326c83c62a53,1,smarthi,2016-03-09 18:16:58-05:00,['f1018ed184f741a78cce3ba887442e8786662b54'],51,71,122,1470464,7,1,1,1,3100
73649fa84493c11c82ac6f568b344776b4ab81a9,0,smarthi,2016-03-09 18:18:20-05:00,['46071e6f3eb9ed53895222a54657326c83c62a53'],1,1,2,1470466,1,,,,3100
d6cd142d4e977567f46a47beb0541e67d6485ddc,1,smarthi,2016-03-09 19:55:04-05:00,['d9b376e37e2b9613baf6fb774f6cb9d3b88560b8'],160,106,266,1470732,34,,,,3100
a168d238d13fabfe11afe6870b38e09534dc65d6,1,smarthi,2016-03-09 19:59:44-05:00,['73649fa84493c11c82ac6f568b344776b4ab81a9'],164,110,274,1471006,34,,,,3100
928599a2dea15fcf187bd5fd0d166cfa20aa715f,0,smarthi,2016-03-11 16:44:36-05:00,['d6cd142d4e977567f46a47beb0541e67d6485ddc'],13,17,30,1471036,12,,,,3100
abdfa2e57aac4c68ad2307bd718b14263a9d68e1,0,smarthi,2016-03-11 16:44:55-05:00,['928599a2dea15fcf187bd5fd0d166cfa20aa715f'],17,13,30,1471066,12,,,,3100
92a2f6c8ffa02478e7cc8a4b79ff270bf4d08c8a,1,smarthi,2016-03-12 22:20:29-05:00,['a168d238d13fabfe11afe6870b38e09534dc65d6'],27,28,55,1471121,8,,,,3100
5d56be7f31592c73a3363ec6f582fece5ff27be4,1,Andrew Palumbo,2016-03-15 12:21:15-04:00,['abdfa2e57aac4c68ad2307bd718b14263a9d68e1'],10,2,12,1471133,2,,,,3100
401c8e8b4a40accc0d41fe8f3c4ee55dfba0040d,0,Andrew Palumbo,2016-03-15 12:44:52-04:00,['5d56be7f31592c73a3363ec6f582fece5ff27be4'],2,2,4,1471137,1,,,,3100
7d71ad00a5a3f3e8f2b176194259e9f2044484ac,0,Andrew Palumbo,2016-03-15 12:59:20-04:00,['401c8e8b4a40accc0d41fe8f3c4ee55dfba0040d'],3,0,3,1471140,1,0,0,0,3100
072289a46c9bd4b7297a17b621f7da30b94df1a7,1,smarthi,2016-03-15 13:57:35-04:00,['92a2f6c8ffa02478e7cc8a4b79ff270bf4d08c8a'],578,940,1518,1472658,49,0,0.404761905,0.396825397,3102
cd4e3cec34aac50a6110839be47f9a1be5550e23,0,smarthi,2016-03-15 14:24:04-04:00,['072289a46c9bd4b7297a17b621f7da30b94df1a7'],1,6,7,1472665,1,1,1,1,3102
e75c5f6064b162e1f0469ea3e86997d1e37f9057,0,Andrew Palumbo,2016-03-15 14:48:43-04:00,['cd4e3cec34aac50a6110839be47f9a1be5550e23'],1,3,4,1472669,1,,,,3102
93ebed620ae7d7da1a6ac2dbe944a8fd517de1c0,0,smarthi,2016-03-15 15:04:21-04:00,['e75c5f6064b162e1f0469ea3e86997d1e37f9057'],42,71,113,1472782,2,1,1,0,3102
b692cbfcc56871c85ea1c483e8d78eed21b514b8,0,Andrew Palumbo,2016-03-15 15:40:30-04:00,['93ebed620ae7d7da1a6ac2dbe944a8fd517de1c0'],13,7,20,1472802,1,,,,3102
eda8a38e40d3aa938ea525183ff484957f2c8597,1,Andrew Palumbo,2016-03-15 15:52:43-04:00,['b692cbfcc56871c85ea1c483e8d78eed21b514b8'],0,7,7,1472809,1,,,,3102
fd0112dcf3ac8219b169aa03bed1de3e3333c1a8,0,smarthi,2016-03-15 16:26:24-04:00,['eda8a38e40d3aa938ea525183ff484957f2c8597'],1,1,2,1472811,1,,,,3102
f2aef44cd592904a1baba5e798b3b0d84c089930,0,Andrew Palumbo,2016-03-15 16:34:12-04:00,['fd0112dcf3ac8219b169aa03bed1de3e3333c1a8'],3,0,3,1472814,1,0,0,0,3102
1e6c547e0814393413ed5c67ba149294e1229d49,1,Andrew Palumbo,2016-03-15 16:34:50-04:00,['f2aef44cd592904a1baba5e798b3b0d84c089930'],2,2,4,1472818,1,,,,3102
b52036cc9e35dcd6031ebd9e4fc8a63856b3f34f,0,Andrew Palumbo,2016-03-15 16:35:15-04:00,['1e6c547e0814393413ed5c67ba149294e1229d49'],10,2,12,1472830,2,,,,3102
d9deb68ff1d744d7994a60181f302f714543dff5,0,smarthi,2016-03-15 17:32:29-04:00,['b52036cc9e35dcd6031ebd9e4fc8a63856b3f34f'],20,20,40,1472870,4,,,,3102
ff51ab448b07c5b218d1a08ed5c1194ad5b24179,1,Andrew Palumbo,2016-03-15 18:19:49-04:00,['7d71ad00a5a3f3e8f2b176194259e9f2044484ac'],6,112,118,1472988,5,1,1,0.64516129,3102
812ae398c257b6e2ec87bcc8ef986d50c28e6025,1,Andrew Palumbo,2016-03-15 18:21:22-04:00,['d9deb68ff1d744d7994a60181f302f714543dff5'],6,112,118,1473106,5,1,1,0.64516129,3102
7b862781cfcd854335600f2ad85ad577817ba43e,0,smarthi,2016-03-17 13:46:45-04:00,['812ae398c257b6e2ec87bcc8ef986d50c28e6025'],3,3,6,1473112,2,,,,3102
2e8790d5c6e0f337abe55906e052d7236f046207,0,Andrew Palumbo,2016-03-17 18:33:10-04:00,['7b862781cfcd854335600f2ad85ad577817ba43e'],3,6,9,1473121,2,1,1,1,3102
23267a0bef064f3351fd879274724bcb02333c4a,1,Andrew Musselman,2016-03-17 18:00:01-07:00,['ff51ab448b07c5b218d1a08ed5c1194ad5b24179'],4,4,8,1473129,1,,,,3102
da65cbe2b745da98a39ef51723154ef4a450e832,0,Andrew Musselman,2016-03-17 18:04:04-07:00,['2e8790d5c6e0f337abe55906e052d7236f046207'],4,4,8,1473137,1,,,,3102
67f00930a8412be39de2c7b2abc9936f634f13d6,0,Andrew Musselman,2016-03-17 18:34:41-07:00,"['23267a0bef064f3351fd879274724bcb02333c4a', '599101083ab7d31600b8c93b2efd8cea4c0a30bf']",10,35,45,1473182,6,,,,3102
b25a70a1bc6b9f8cb6c89947e0eaba5588463652,0,Andrew Musselman,2016-03-19 14:46:48-07:00,['67f00930a8412be39de2c7b2abc9936f634f13d6'],1,4,5,1473187,1,,,,3102
1c1abbf3d946c6a8082f089b3f49900450553578,0,Andrew Musselman,2016-03-19 20:06:42-07:00,['da65cbe2b745da98a39ef51723154ef4a450e832'],10,35,45,1473232,6,,,,3102
c00b96ecc909fe6bcd4dce5e365a7fcea8a2bfdf,0,Andrew Musselman,2016-03-19 20:10:50-07:00,['1c1abbf3d946c6a8082f089b3f49900450553578'],1,4,5,1473237,1,,,,3102
d1d6fc0a4bcab5fe51aa1775074571174b671b3a,0,Andrew Musselman,2016-03-19 20:14:51-07:00,['c00b96ecc909fe6bcd4dce5e365a7fcea8a2bfdf'],1,1,2,1473239,1,,,,3102
f4f42ae4c4c7555659edcc43669fec82f9537219,1,Andrew Palumbo,2016-03-21 22:22:09-04:00,['d1d6fc0a4bcab5fe51aa1775074571174b671b3a'],43,23,66,1473305,3,1,1,1,3102
9bf5292fd7ae8bacf027378d4b692f4e70aa46e2,1,smarthi,2016-03-21 22:59:11-04:00,['f4f42ae4c4c7555659edcc43669fec82f9537219'],6,8,14,1473319,2,1,1,1,3102
e06fb119dc3a719651fd48f0d2aa3ee8adee9a1b,0,Andrew Palumbo,2016-03-22 00:13:34-04:00,['9bf5292fd7ae8bacf027378d4b692f4e70aa46e2'],0,3,3,1473322,1,,,,3102
202b94f840286d4d0970f0427122697ba27fc1fb,0,Andrew Palumbo,2016-03-22 19:14:57-04:00,['e06fb119dc3a719651fd48f0d2aa3ee8adee9a1b'],8,51,59,1473381,3,1,1,1,3102
e3c8db502b5e7cf926c2628f413bd5aaa69b2765,0,smarthi,2016-03-25 04:03:05-04:00,['202b94f840286d4d0970f0427122697ba27fc1fb'],64,41,105,1473486,7,,,,3102
a1cf7cf56e036ce12d616f8aea0af1e9dcdf2cb6,0,Andrew Palumbo,2016-03-25 16:56:20-04:00,['e3c8db502b5e7cf926c2628f413bd5aaa69b2765'],4,2,6,1473492,1,,,,3102
9c5ee59214a454f7ae25c762bf04bb30bd7982c8,0,Andrew Palumbo,2016-03-25 18:10:18-04:00,['a1cf7cf56e036ce12d616f8aea0af1e9dcdf2cb6'],10,26,36,1473528,2,1,1,1,3102
ad4c32ce871df686267df1f1dbff76a883b8d3fc,0,Andrew Palumbo,2016-03-25 18:31:51-04:00,['9c5ee59214a454f7ae25c762bf04bb30bd7982c8'],1,5,6,1473534,1,1,1,1,3102
ad22252ca2ab39e22d4df7cc22464af2c6179830,0,Andrew Palumbo,2016-03-25 19:05:39-04:00,['ad4c32ce871df686267df1f1dbff76a883b8d3fc'],3,6,9,1473543,1,,,,3102
100d343e4b6e66b1a7c581455cd1faab7bbdb538,0,Andrew Palumbo,2016-03-25 20:29:47-04:00,['ad22252ca2ab39e22d4df7cc22464af2c6179830'],5,17,22,1473565,1,1,1,1,3102
b96918bba9855fba5cefc11e1c4153b9419509cb,0,Andrew Palumbo,2016-03-25 20:33:22-04:00,['100d343e4b6e66b1a7c581455cd1faab7bbdb538'],2,3,5,1473570,1,,,,3102
b45f982581b2a2bed75b771672b4f2d66ef32840,0,Andrew Palumbo,2016-03-26 17:38:50-04:00,['b96918bba9855fba5cefc11e1c4153b9419509cb'],2,8,10,1473580,2,1,1,1,3102
a77f1c13de58d462eed7ff224ec333b22ac22bf3,0,Andrew Palumbo,2016-03-26 23:22:44-04:00,['e3c8db502b5e7cf926c2628f413bd5aaa69b2765'],9,41,50,1473630,2,0,1,1,3102
f0ee522c69a1f47f0d4da263e9f1669404155b5e,0,Andrew Palumbo,2016-03-26 23:28:52-04:00,"['b45f982581b2a2bed75b771672b4f2d66ef32840', 'a77f1c13de58d462eed7ff224ec333b22ac22bf3']",9,41,50,1473680,2,,,,3102
e420485e0b82908919985a892f85c7d6dff9d24b,0,Andrew Palumbo,2016-03-26 23:49:14-04:00,['f0ee522c69a1f47f0d4da263e9f1669404155b5e'],5,11,16,1473696,2,,,,3102
48a8a8208322ed690d5356a4e0cac7667b080bab,0,Andrew Palumbo,2016-03-27 15:16:36-04:00,['e420485e0b82908919985a892f85c7d6dff9d24b'],7,14,21,1473717,1,0,0,0,3102
f9111ac27334659b2fb55849319dcd8e113b3c25,0,Andrew Palumbo,2016-03-27 16:06:11-04:00,['48a8a8208322ed690d5356a4e0cac7667b080bab'],112,27,139,1473856,4,0.633333333,0,0,3102
b67398f933d50d3e4f00ebd7ccd57f17b96604c7,0,Andrew Palumbo,2016-03-27 16:23:41-04:00,['f9111ac27334659b2fb55849319dcd8e113b3c25'],27,112,139,1473995,4,0.366666667,1,1,3102
99c32f2d9008e1a48c52183c638792bdbd4766f4,1,smarthi,2016-03-27 19:21:45-04:00,['b67398f933d50d3e4f00ebd7ccd57f17b96604c7'],4,3,7,1474002,3,,,,3102
f0e22e28c8da53a0c26233afd4d363dcc035ee7d,1,smarthi,2016-03-28 17:17:48-04:00,['99c32f2d9008e1a48c52183c638792bdbd4766f4'],13,28,41,1474043,4,0,0,0,3102
5863bbf1587cabef68f470fc8cd4812a2c1f8f79,1,smarthi,2016-03-29 19:26:03-04:00,['f0e22e28c8da53a0c26233afd4d363dcc035ee7d'],0,51,51,1474094,1,1,1,1,3103
c75f3e2de00ffb2014d765e904a3c754169039c7,0,smarthi,2016-04-03 12:27:04-04:00,['5863bbf1587cabef68f470fc8cd4812a2c1f8f79'],8,2,10,1474104,1,,,,3103
c1d79ff4c2e38325736f09a8a35eb7ba2625509d,1,smarthi,2016-04-06 02:35:29-04:00,['c75f3e2de00ffb2014d765e904a3c754169039c7'],32,117,149,1474253,6,1,1,1,3103
209b9460050695cdf42cb75dfcff5482792c342d,0,smarthi,2016-04-06 20:52:52-04:00,['c1d79ff4c2e38325736f09a8a35eb7ba2625509d'],2,2,4,1474257,1,,,,3103
2861732da34a87c48f7da77576ca2a75837a54e4,0,smarthi,2016-04-06 21:18:59-04:00,['209b9460050695cdf42cb75dfcff5482792c342d'],67,0,67,1474324,1,,,,3103
4fc65d4e26957cfef68eb30e0bf712758e21a5a1,0,Andrew Palumbo,2016-04-08 04:03:10-04:00,['2861732da34a87c48f7da77576ca2a75837a54e4'],92,146,238,1474562,2,,,,3103
a2101110e9a932ac547c025c7267ffa88ecbe271,1,smarthi,2016-04-08 04:27:31-04:00,['4fc65d4e26957cfef68eb30e0bf712758e21a5a1'],7,25,32,1474594,4,,,,3103
c9c89627b29156525d1cae714629c59bd011ba53,0,smarthi,2016-04-08 19:38:51-04:00,['a2101110e9a932ac547c025c7267ffa88ecbe271'],3,3,6,1474600,1,,,,3103
1aae3321b554adaf18f6c56abe1d7e4835c13cab,0,Andrew Musselman,2016-04-08 17:04:35-07:00,['a2101110e9a932ac547c025c7267ffa88ecbe271'],0,4,4,1474604,1,,,,3103
2edb274d56a257dabf9d7f559e71d5b22ff021f0,0,Andrew Musselman,2016-04-08 17:04:59-07:00,"['1aae3321b554adaf18f6c56abe1d7e4835c13cab', 'c9c89627b29156525d1cae714629c59bd011ba53']",3,3,6,1474610,1,,,,3103
eccbc4e1eefb89d198633f4138870e1a64eacfea,0,Andrew Musselman,2016-04-08 17:08:16-07:00,['b25a70a1bc6b9f8cb6c89947e0eaba5588463652'],0,5,5,1474615,1,,,,3103
00a09dc7243bddf89d5dd22888397c94f4b7ca77,0,Andrew Musselman,2016-04-08 17:10:01-07:00,['2edb274d56a257dabf9d7f559e71d5b22ff021f0'],22,56,78,1474693,2,,,,3104
7c275f06e618624ac5bdc269b19d328a6c2b6983,0,smarthi,2016-04-08 20:24:04-04:00,['00a09dc7243bddf89d5dd22888397c94f4b7ca77'],3,67,70,1474763,2,,,,3105
430310dbf7870e263ea0340df9b226655ce82a72,1,smarthi,2016-04-09 23:04:53-04:00,['7c275f06e618624ac5bdc269b19d328a6c2b6983'],16,133,149,1474912,3,1,1,1,3105
681d30e54f1f90a75733990056f864ab6c7c9cc6,0,smarthi,2016-04-10 01:34:34-04:00,['430310dbf7870e263ea0340df9b226655ce82a72'],51,21,72,1474984,15,,,,3105
4856d5fdf8010127e2e7951a0045b8cc2cae9ce3,1,smarthi,2016-04-10 14:44:09-04:00,['681d30e54f1f90a75733990056f864ab6c7c9cc6'],3,3,6,1474990,2,,,,3105
472438bc83a51bcc08518e44daff4ec5f3bf81e9,0,Andrew Palumbo,2016-04-10 19:11:31-04:00,['681d30e54f1f90a75733990056f864ab6c7c9cc6'],303,221,524,1475514,3,0,1,1,3106
71609ad61ce02feeaa641c0cedb75e707d6c9b7d,0,Andrew Palumbo,2016-04-10 19:13:10-04:00,"['472438bc83a51bcc08518e44daff4ec5f3bf81e9', '4856d5fdf8010127e2e7951a0045b8cc2cae9ce3']",3,3,6,1475520,2,,,,3106
0987e9949879ff1e595f39eeb08cf5aa505ad2b4,0,Andrew Palumbo,2016-04-10 20:05:12-04:00,['71609ad61ce02feeaa641c0cedb75e707d6c9b7d'],0,45374,45374,1520894,6,,,,3112
abfc756373ba8277b72477cd9a2c4ac4e6fdf833,0,smarthi,2016-04-10 20:26:08-04:00,['0987e9949879ff1e595f39eeb08cf5aa505ad2b4'],16,19,35,1520929,13,,,,3112
837448483c0eb18fee62176e22b9053b0670a3bb,0,smarthi,2016-04-10 20:26:23-04:00,['abfc756373ba8277b72477cd9a2c4ac4e6fdf833'],18,14,32,1520961,13,,,,3112
6fc0100827268d1dcac473980d79707683914880,0,smarthi,2016-04-10 20:50:24-04:00,['837448483c0eb18fee62176e22b9053b0670a3bb'],13,13,26,1520987,13,,,,3112
6667bb0adf206ef5cc86520c8e211b8553ed98b3,0,Andrew Palumbo,2016-04-10 21:17:44-04:00,['6fc0100827268d1dcac473980d79707683914880'],3,3,6,1520993,1,,,,3112
1f5fc5243053b933a65b8277bc9743cd8e94b5a7,1,smarthi,2016-04-10 21:40:13-04:00,['6667bb0adf206ef5cc86520c8e211b8553ed98b3'],1,22,23,1521016,3,,,,3112
4e7d106a6b958fa11f849262a4359e937c4bb882,0,smarthi,2016-04-10 22:07:07-04:00,['1f5fc5243053b933a65b8277bc9743cd8e94b5a7'],14,18,32,1521048,13,,,,3112
612380e1d38c3920a66611dc0d614d9e50472671,0,smarthi,2016-04-10 22:07:23-04:00,['4e7d106a6b958fa11f849262a4359e937c4bb882'],18,14,32,1521080,13,,,,3112
c5659b5fe841afc8df70c39645db268cc2c85c30,0,smarthi,2016-04-11 01:24:32-04:00,['612380e1d38c3920a66611dc0d614d9e50472671'],13,13,26,1521106,13,,,,3112
165460e4b6f2f2febc85c56db765a2f91028d31b,0,Andrew Palumbo,2016-04-11 03:31:03-04:00,"['eccbc4e1eefb89d198633f4138870e1a64eacfea', '6667bb0adf206ef5cc86520c8e211b8553ed98b3']",164,49543,49707,1570813,97,,,,3112
f115633fd4de83afd1be1cc8ced61580cc426604,0,smarthi,2016-04-11 04:08:31-04:00,"['eccbc4e1eefb89d198633f4138870e1a64eacfea', 'c5659b5fe841afc8df70c39645db268cc2c85c30']",177,49566,49743,1620556,100,,,,3112
eabf90d73e7aa664eb4f9f8b3166f748e547b506,0,smarthi,2016-04-11 04:35:53-04:00,['f115633fd4de83afd1be1cc8ced61580cc426604'],0,7,7,1620563,1,,,,3112
fcdeef6d70042c5433e70f827df11fe79dd274f4,0,Andrew Palumbo,2016-04-11 04:43:52-04:00,"['165460e4b6f2f2febc85c56db765a2f91028d31b', 'f115633fd4de83afd1be1cc8ced61580cc426604']",17,35,52,1620615,8,,,,3112
4a917824f7b8366fcb19b222f80fd210c37707ec,0,Andrew Palumbo,2016-04-11 04:44:06-04:00,"['fcdeef6d70042c5433e70f827df11fe79dd274f4', 'eabf90d73e7aa664eb4f9f8b3166f748e547b506']",0,7,7,1620622,1,,,,3112
b725255ad6414fc89b6a7276c86995fa7183f14c,0,Andrew Palumbo,2016-04-11 04:52:41-04:00,['4a917824f7b8366fcb19b222f80fd210c37707ec'],7,0,7,1620629,1,,,,3112
94b4fa1433c7a5e1950fb3f66cdba3c649445df8,0,Andrew Palumbo,2016-04-11 05:57:57-04:00,['b725255ad6414fc89b6a7276c86995fa7183f14c'],0,8,8,1620637,2,,,,3112
e7086e7021803148a6cd00aee6b4cd785e1e2fba,0,smarthi,2016-04-11 07:29:05-04:00,['94b4fa1433c7a5e1950fb3f66cdba3c649445df8'],2,0,2,1620639,2,,,,3112
75c382f2129544a26d35889df7c15ab9d5ee9104,0,smarthi,2016-04-11 08:20:42-04:00,['e7086e7021803148a6cd00aee6b4cd785e1e2fba'],14,18,32,1620671,13,,,,3112
cefd0d3d3c62b756f4ebc90bf828e635d674cada,0,smarthi,2016-04-11 08:20:59-04:00,['75c382f2129544a26d35889df7c15ab9d5ee9104'],18,14,32,1620703,13,,,,3112
0db81f693c510f456ec99ff1bf339f817b448ed2,0,smarthi,2016-04-13 17:23:53-04:00,['cefd0d3d3c62b756f4ebc90bf828e635d674cada'],2,2,4,1620707,1,,,,3112
f344f642b2f195e2e83ffe84eacfd8e7851bd2cc,0,smarthi,2016-04-14 17:38:13-04:00,['0db81f693c510f456ec99ff1bf339f817b448ed2'],2,2,4,1620711,1,,,,3112
2985b7cc463035cf991b5fa94cb6c9abd1592466,1,smarthi,2016-04-17 20:49:06-04:00,['f344f642b2f195e2e83ffe84eacfd8e7851bd2cc'],20,9,29,1620740,3,,,,3112
f26698dc7d8ce928229e39d152da35ac25e226e3,1,smarthi,2016-04-19 16:10:47-04:00,['2985b7cc463035cf991b5fa94cb6c9abd1592466'],0,36,36,1620776,2,,,,3113
8e605339896ae8e295f4e4029c92e5fddc96d427,0,smarthi,2016-04-19 16:36:11-04:00,['f26698dc7d8ce928229e39d152da35ac25e226e3'],2,6,8,1620784,1,,,,3113
91df36918221dcf6f553c8d51c4dbf4d14180fee,0,smarthi,2016-04-19 17:01:36-04:00,['8e605339896ae8e295f4e4029c92e5fddc96d427'],1,1,2,1620786,1,,,,3113
9c064b32b01af5192587b4da2d0ad259b4335e83,0,smarthi,2016-04-19 17:18:08-04:00,['91df36918221dcf6f553c8d51c4dbf4d14180fee'],1,1,2,1620788,1,,,,3113
9fcebb0efcea1f04e4c1cf4a40f12e907a79e80a,0,Andrew Palumbo,2016-04-19 19:07:45-04:00,['9c064b32b01af5192587b4da2d0ad259b4335e83'],1,2,3,1620791,1,,,,3113
3fe00616bf3c41befbd3dd70427451891bac742b,0,Andrew Palumbo,2016-04-19 19:17:21-04:00,['9fcebb0efcea1f04e4c1cf4a40f12e907a79e80a'],1,1,2,1620793,1,,,,3113
48f05d6c0cc7790810225e138239b4b8418c2979,0,Andrew Palumbo,2016-04-19 19:27:23-04:00,['3fe00616bf3c41befbd3dd70427451891bac742b'],3,3,6,1620799,1,,,,3113
df1f064a08ffeef1f413c807d97664d3e6de8118,0,Andrew Palumbo,2016-04-19 20:20:11-04:00,['48f05d6c0cc7790810225e138239b4b8418c2979'],6,48,54,1620853,2,,,,3114
79539f1269dfb3e654a89e77d598908481073471,0,Andrew Palumbo,2016-04-19 20:57:42-04:00,['df1f064a08ffeef1f413c807d97664d3e6de8118'],50,7,57,1620910,3,,,,3114
ea12bb60e2ae509f9ba5f98c5688eda2a8ff4813,0,Andrew Palumbo,2016-04-20 00:32:50-04:00,['79539f1269dfb3e654a89e77d598908481073471'],3,43,46,1620956,2,,,,3115
a8379ad36898b971f4f3f8ddc6bf01b6de67f64d,0,Andrew Palumbo,2016-04-20 00:36:41-04:00,['ea12bb60e2ae509f9ba5f98c5688eda2a8ff4813'],1,1,2,1620958,1,,,,3115
53e1c8db96a60ddd1f28516778ec6e2230ad437e,0,Andrew Palumbo,2016-04-20 00:39:25-04:00,['a8379ad36898b971f4f3f8ddc6bf01b6de67f64d'],1,1,2,1620960,1,,,,3115
e75b1e0dd8e1ab764dc469b683307fe9b91eed6e,0,Andrew Palumbo,2016-04-20 00:44:27-04:00,['53e1c8db96a60ddd1f28516778ec6e2230ad437e'],0,2,2,1620962,1,,,,3115
ce54875d14cd7ca18753dfdf954389b4dccc606e,0,Andrew Palumbo,2016-04-20 00:48:33-04:00,['e75b1e0dd8e1ab764dc469b683307fe9b91eed6e'],3,2,5,1620967,1,,,,3115
f7476a4b7c19947aecc61d56dc2783d19a06292a,1,Andrew Palumbo,2016-04-20 01:58:35-04:00,['ce54875d14cd7ca18753dfdf954389b4dccc606e'],4,26,30,1620997,2,,,,3115
af73bd743c7020dd4ae3fde8f0aa803d54147d84,1,Andrew Palumbo,2016-04-20 02:04:35-04:00,['f7476a4b7c19947aecc61d56dc2783d19a06292a'],24,24,48,1621045,2,,,,3115
536abe76b9a15f7e6482a82adf963b41905148fa,1,Andrew Palumbo,2016-04-20 02:31:38-04:00,['af73bd743c7020dd4ae3fde8f0aa803d54147d84'],2,2,4,1621049,1,,,,3115
c14a4d705272c0b5c22b1f88f4cbd286266e5dfe,0,Andrew Palumbo,2016-04-20 13:21:29-04:00,['536abe76b9a15f7e6482a82adf963b41905148fa'],5,10,15,1621064,2,,,,3115
bedcc3fbec6fcd3b7dcca83569040a2fb6cb851e,0,smarthi,2016-04-20 19:58:12-04:00,['c14a4d705272c0b5c22b1f88f4cbd286266e5dfe'],1,1,2,1621066,1,,,,3115
add081015e9b7c9c4a3a47f084a21680f7c2be7d,1,Andrew Palumbo,2016-04-22 16:33:55-04:00,['bedcc3fbec6fcd3b7dcca83569040a2fb6cb851e'],4,23,27,1621093,2,0,1,1,3115
0c39c29998c8b6f93174bf7458f1b4732405c3e4,0,smarthi,2016-04-23 10:17:40-04:00,['add081015e9b7c9c4a3a47f084a21680f7c2be7d'],28,5,33,1621126,2,0,0,0,3115
383493d6c2d4f7b011030c3f00324f11042f381f,0,Marku,2016-04-26 17:55:01+08:00,['0c39c29998c8b6f93174bf7458f1b4732405c3e4'],4,10,14,1621140,1,,,,3115
d7a87936ef386476db88db323d19345b1064eae2,0,Andrew Palumbo,2016-04-27 18:54:28-04:00,['383493d6c2d4f7b011030c3f00324f11042f381f'],10,4,14,1621154,1,,,,3115
9df093c98c985dce06841e31b40de4f7b9233069,0,Andrew Palumbo,2016-04-27 19:02:46-04:00,['d7a87936ef386476db88db323d19345b1064eae2'],4,10,14,1621168,1,,,,3115
4105063d87178c93fd216c8eaeac85b83f506e73,0,Andrew Palumbo,2016-04-29 18:00:52-04:00,['9df093c98c985dce06841e31b40de4f7b9233069'],1,365,366,1621534,10,0,0,1,3119
1127661fd96cac6d7584ba50b717bc67bda4aa43,0,smarthi,2016-04-30 21:16:37-04:00,['4105063d87178c93fd216c8eaeac85b83f506e73'],16,14,30,1621564,1,0,0,0,3119
0d6c4e02409a6f8da776d00dc661fd178a7630b2,1,Andrew Palumbo,2016-05-01 17:46:12-04:00,['1127661fd96cac6d7584ba50b717bc67bda4aa43'],14,16,30,1621594,1,1,1,1,3119
b0cede1e2725c16b039c18c4eb0ee4aa324d7389,1,Andrew Palumbo,2016-05-01 17:51:34-04:00,['0d6c4e02409a6f8da776d00dc661fd178a7630b2'],97,631,728,1622322,11,1,1,1,3126
aa327719837e3996e0018c0d1d221e9561d47152,1,smarthi,2016-05-01 18:33:03-04:00,['b0cede1e2725c16b039c18c4eb0ee4aa324d7389'],49,33,82,1622404,7,0,0,0,3126
616b87c07e3889609f10f08423c0e8992f8d6a43,1,Andrew Palumbo,2016-05-01 20:14:17-04:00,['aa327719837e3996e0018c0d1d221e9561d47152'],4,28,32,1622436,1,,,,3126
4c85d6a48bcdd5c161f50f85ec1e7d278d1dbae0,1,smarthi,2016-05-02 18:50:48-04:00,['616b87c07e3889609f10f08423c0e8992f8d6a43'],1,9,10,1622446,1,,,,3126
6ac833bdc78713effd3f94b97117a5f6cd6ffb7e,0,smarthi,2016-05-02 19:21:24-04:00,['4c85d6a48bcdd5c161f50f85ec1e7d278d1dbae0'],23,24,47,1622493,4,,,,3126
6ab5a8d6456dfc52d7a951ae71618a6417516a07,0,smarthi,2016-05-02 23:06:00-04:00,['6ac833bdc78713effd3f94b97117a5f6cd6ffb7e'],8,19,27,1622520,1,,,,3126
79a70dff924d30e634672e58ecc6cfac3265f82e,1,smarthi,2016-05-12 04:46:00-07:00,['6ab5a8d6456dfc52d7a951ae71618a6417516a07'],7,7,14,1622534,3,,,,3126
8554714235ace8f44c6ac81f6edfe1343bacee4c,0,Andrew Palumbo,2016-05-18 13:52:09-04:00,['79a70dff924d30e634672e58ecc6cfac3265f82e'],8,16,24,1622558,4,,,,3126
92ef9e599e64e2aad1e04f5e866a922af4ac71ce,0,smarthi,2016-05-18 17:44:01-04:00,['8554714235ace8f44c6ac81f6edfe1343bacee4c'],14,18,32,1622590,13,,,,3126
d38edb1cd4f0d4eed2e61b22f20f4a405e2cb13f,0,smarthi,2016-05-18 17:44:18-04:00,['92ef9e599e64e2aad1e04f5e866a922af4ac71ce'],18,14,32,1622622,13,,,,3126
bd1f7bdabceeaaaffd3e7d9c372d40b3b714afc8,1,smarthi,2016-05-21 20:05:41-04:00,['d38edb1cd4f0d4eed2e61b22f20f4a405e2cb13f'],22,84,106,1622728,3,0,0,0,3127
1f3566d358d94a6e6a868cd74a83a553facea355,0,Andrew Palumbo,2016-05-26 19:53:59-04:00,['bd1f7bdabceeaaaffd3e7d9c372d40b3b714afc8'],2,12,14,1622742,1,,,,3127
8f4ee88fb40710d983ea3fb6ad008317f6c00936,1,smarthi,2016-05-29 13:06:59-04:00,['1f3566d358d94a6e6a868cd74a83a553facea355'],0,36,36,1622778,1,,,,3127
0381deb707d206a7ad9c09381306a55ba143f648,1,smarthi,2016-05-29 23:49:08-04:00,['8f4ee88fb40710d983ea3fb6ad008317f6c00936'],2,2,4,1622782,2,,,,3127
1fca0743aa7ba9642a1cadfefb149fcba15770ac,0,Andrew Palumbo,2016-06-01 00:22:25-04:00,['0381deb707d206a7ad9c09381306a55ba143f648'],914,0,914,1623696,12,0,0,0,3127
f7c1f8026296bae1eab9768564a871ea1dd6583b,0,Andrew Palumbo,2016-06-08 17:39:19-04:00,['1fca0743aa7ba9642a1cadfefb149fcba15770ac'],0,120789,120789,1744485,292,0.241574888,0.534150587,0.398238454,3415
7ae549fa8e93bace810bf1c41df7cf45a72dcaa2,0,Andrew Palumbo,2016-06-10 12:50:59-04:00,['f7c1f8026296bae1eab9768564a871ea1dd6583b'],120789,0,120789,1865274,292,0.758425112,0.465849413,0.601761546,3415
2831ae40364b9b4eb74807198dce1a4be005e5e3,0,Andrew Palumbo,2016-06-10 13:26:55-04:00,['7ae549fa8e93bace810bf1c41df7cf45a72dcaa2'],6,0,6,1865280,1,,,,3415
acd515542f16eb6a570bd0796cf56256fd4df7f9,0,smarthi,2016-06-10 16:46:16-04:00,['2831ae40364b9b4eb74807198dce1a4be005e5e3'],14,18,32,1865312,13,,,,3415
c4c39880d96b218e960258bf11488dd021ccb996,0,smarthi,2016-06-10 16:46:34-04:00,['acd515542f16eb6a570bd0796cf56256fd4df7f9'],18,14,32,1865344,13,,,,3415
9810ba3148cfbbacdae7d92a14d9debcf1b73759,0,smarthi,2016-06-10 19:23:01-04:00,['c4c39880d96b218e960258bf11488dd021ccb996'],13,13,26,1865370,13,,,,3415
34ecba4c109b9590eea048eca09c790d298f30ce,0,smarthi,2016-06-10 19:26:55-04:00,['9810ba3148cfbbacdae7d92a14d9debcf1b73759'],1,1,2,1865372,1,,,,3415
a799cc460c93f21fe7f9a3f725f6e3cb40080300,0,smarthi,2016-06-10 19:44:39-04:00,['34ecba4c109b9590eea048eca09c790d298f30ce'],14,18,32,1865404,13,,,,3415
d2ee18a7352b2b88812ec32873f11f5c02742892,0,smarthi,2016-06-10 19:44:55-04:00,['a799cc460c93f21fe7f9a3f725f6e3cb40080300'],18,14,32,1865436,13,,,,3415
cc151e654aa2b0b9d2f9d054d48f39b7d44e6c3c,0,smarthi,2016-06-10 19:46:29-04:00,['d2ee18a7352b2b88812ec32873f11f5c02742892'],13,13,26,1865462,13,,,,3415
38f5c58a20b534102e355ed696d5703ac1832db2,0,smarthi,2016-06-10 19:56:54-04:00,['cc151e654aa2b0b9d2f9d054d48f39b7d44e6c3c'],14,18,32,1865494,13,,,,3415
de9aab2c63142b12448dc6512a598d6d8bca1cdf,0,smarthi,2016-06-10 19:58:31-04:00,['38f5c58a20b534102e355ed696d5703ac1832db2'],18,14,32,1865526,13,,,,3415
0b88c1fe977b40dcc10b7e81330cb7bf8d7bba2e,0,smarthi,2016-06-10 20:05:16-04:00,['de9aab2c63142b12448dc6512a598d6d8bca1cdf'],14,18,32,1865558,13,,,,3415
e19f0a5c094a25e221adba54f4628943a0dd551a,0,smarthi,2016-06-10 20:06:11-04:00,['0b88c1fe977b40dcc10b7e81330cb7bf8d7bba2e'],18,14,32,1865590,13,,,,3415
9c901d74e2444e59eeae2d2a975959d8804bd8fd,0,smarthi,2016-06-10 20:11:49-04:00,['e19f0a5c094a25e221adba54f4628943a0dd551a'],14,18,32,1865622,13,,,,3415
131f922bd3ec45ab3dc11111bcf54f6e87d6e3a6,0,smarthi,2016-06-10 20:18:21-04:00,['9c901d74e2444e59eeae2d2a975959d8804bd8fd'],18,14,32,1865654,13,,,,3415
c756eb54536499799472eabe8641404bc232d8e6,0,smarthi,2016-06-10 20:25:15-04:00,['131f922bd3ec45ab3dc11111bcf54f6e87d6e3a6'],14,18,32,1865686,13,,,,3415
b635e05c031876e24c951b7c711ab517a6708774,0,smarthi,2016-06-10 20:25:31-04:00,['c756eb54536499799472eabe8641404bc232d8e6'],18,14,32,1865718,13,,,,3415
5ffae27612ce148783e8c8c511700e7c0edf2590,0,smarthi,2016-06-10 20:28:19-04:00,['b635e05c031876e24c951b7c711ab517a6708774'],13,13,26,1865744,13,,,,3415
ebf883edbf9bdcd65d1091e773dd0b544c5ab83b,0,smarthi,2016-06-10 20:35:02-04:00,['5ffae27612ce148783e8c8c511700e7c0edf2590'],14,18,32,1865776,13,,,,3415
96cbc068fc5c434fab148246b94a5552d3f9a7b9,0,smarthi,2016-06-10 20:35:18-04:00,['ebf883edbf9bdcd65d1091e773dd0b544c5ab83b'],18,14,32,1865808,13,,,,3415
0955d82f35ac54f4427e73e33a01dad455efeb76,0,smarthi,2016-06-10 22:51:59-04:00,['96cbc068fc5c434fab148246b94a5552d3f9a7b9'],13,13,26,1865834,13,,,,3415
a12ff86ca2997945666f09605d9f9af3098aa904,0,smarthi,2016-06-10 23:01:51-04:00,['0955d82f35ac54f4427e73e33a01dad455efeb76'],14,18,32,1865866,13,,,,3415
3324055a677e9ef238e37c11049216180f96f546,0,smarthi,2016-06-10 23:02:08-04:00,['a12ff86ca2997945666f09605d9f9af3098aa904'],18,14,32,1865898,13,,,,3415
5f5e12493d01862e9b8c964f8412abcd10b5c370,0,smarthi,2016-06-10 23:03:54-04:00,['3324055a677e9ef238e37c11049216180f96f546'],13,13,26,1865924,13,,,,3415
fbc1c450b4cf759e7220f083e27c6cfb26020ab2,0,smarthi,2016-06-10 23:14:08-04:00,['5f5e12493d01862e9b8c964f8412abcd10b5c370'],14,18,32,1865956,13,,,,3415
ed4c9392044f09ebc87e87df31136558d377f5a4,0,smarthi,2016-06-10 23:14:24-04:00,['fbc1c450b4cf759e7220f083e27c6cfb26020ab2'],18,14,32,1865988,13,,,,3415
cab542cc7eb6618ae6ec9e0d140d621af95d9102,0,smarthi,2016-06-10 23:26:31-04:00,['ed4c9392044f09ebc87e87df31136558d377f5a4'],14,18,32,1866020,13,,,,3415
e8e6a6a7b4d0e015b6e120a34ef1ded964d59bd5,0,smarthi,2016-06-10 23:26:47-04:00,['cab542cc7eb6618ae6ec9e0d140d621af95d9102'],18,14,32,1866052,13,,,,3415
dbefde439b37f3bf9729db1754019f2de34a6205,0,smarthi,2016-06-10 23:27:28-04:00,['e8e6a6a7b4d0e015b6e120a34ef1ded964d59bd5'],13,13,26,1866078,13,,,,3415
73a006da344c8b7811c55d5cc5abd7b1d85a8de4,0,smarthi,2016-06-10 23:36:27-04:00,['dbefde439b37f3bf9729db1754019f2de34a6205'],14,18,32,1866110,13,,,,3415
41506c889a75edcc5f4669328d566406af77d619,0,smarthi,2016-06-10 23:36:43-04:00,['73a006da344c8b7811c55d5cc5abd7b1d85a8de4'],18,14,32,1866142,13,,,,3415
4160fe62fbcc6d2ec4649773f84309097c0ba6d2,0,smarthi,2016-06-10 23:38:46-04:00,['41506c889a75edcc5f4669328d566406af77d619'],13,13,26,1866168,13,,,,3415
8b581727461af9f30e820d7a437aa0ee2c91898c,0,smarthi,2016-06-10 23:44:21-04:00,['4160fe62fbcc6d2ec4649773f84309097c0ba6d2'],14,18,32,1866200,13,,,,3415
0e79265c54d355ce12743022c9c610aa64445cae,0,smarthi,2016-06-10 23:44:37-04:00,['8b581727461af9f30e820d7a437aa0ee2c91898c'],18,14,32,1866232,13,,,,3415
a414673a0f435d8ad7885bf19a9b0bc7a018fea6,0,smarthi,2016-06-11 00:08:05-04:00,['0e79265c54d355ce12743022c9c610aa64445cae'],13,13,26,1866258,13,,,,3415
f22a48358f82a14ba40724f30e486fc74fac0188,0,smarthi,2016-06-11 00:45:09-04:00,['a414673a0f435d8ad7885bf19a9b0bc7a018fea6'],14,18,32,1866290,13,,,,3415
124f1eaa5e8a82fd1b2084e10dcd5d7a5a4e6a1a,0,smarthi,2016-06-11 00:46:11-04:00,['f22a48358f82a14ba40724f30e486fc74fac0188'],18,14,32,1866322,13,,,,3415
6576b95c02602f0526eedfde05504b0b748409d4,0,smarthi,2016-06-11 01:02:02-04:00,['124f1eaa5e8a82fd1b2084e10dcd5d7a5a4e6a1a'],14,18,32,1866354,13,,,,3415
abe1933390fbec6b9c2273373a5683fa688a739b,0,smarthi,2016-06-11 01:02:19-04:00,['6576b95c02602f0526eedfde05504b0b748409d4'],18,14,32,1866386,13,,,,3415
2f8586bf0b56ca3be63376b89fe9ee0abd664bc7,0,smarthi,2016-06-11 01:03:24-04:00,['abe1933390fbec6b9c2273373a5683fa688a739b'],13,13,26,1866412,13,,,,3415
d53000f755920887add869f29f2b80eb311a58e6,0,smarthi,2016-06-11 01:27:58-04:00,['2f8586bf0b56ca3be63376b89fe9ee0abd664bc7'],14,18,32,1866444,13,,,,3415
700e691940b39cca6b1a475646e6471046c96712,0,smarthi,2016-06-11 01:28:14-04:00,['d53000f755920887add869f29f2b80eb311a58e6'],18,14,32,1866476,13,,,,3415
6a1d871807ea198a5df68f20c7337f6bae5d76f7,0,smarthi,2016-06-11 02:52:21-04:00,['700e691940b39cca6b1a475646e6471046c96712'],14,18,32,1866508,13,,,,3415
6654308f5beb7e22b123a5080d301543435dee7a,0,smarthi,2016-06-11 02:53:36-04:00,['6a1d871807ea198a5df68f20c7337f6bae5d76f7'],18,14,32,1866540,13,,,,3415
5ca7632212eabc01d174519eca0ddf89a54ae2b9,0,smarthi,2016-06-11 11:03:29-04:00,['6654308f5beb7e22b123a5080d301543435dee7a'],14,18,32,1866572,13,,,,3415
05476170196d20841578017de8511882f6522c7d,0,smarthi,2016-06-11 11:03:50-04:00,['5ca7632212eabc01d174519eca0ddf89a54ae2b9'],18,14,32,1866604,13,,,,3415
d5a1ea4129206783c6eb83db370497c513931ecc,0,smarthi,2016-06-11 11:14:02-04:00,['05476170196d20841578017de8511882f6522c7d'],13,13,26,1866630,13,,,,3415
c082ad6629a786bd72e800ab89d6189a1037a4c7,0,smarthi,2016-06-11 13:35:48-04:00,['d5a1ea4129206783c6eb83db370497c513931ecc'],14,18,32,1866662,13,,,,3415
a3f75765dad462ebc3115f777857e25da4fe3225,0,smarthi,2016-06-11 13:36:08-04:00,['c082ad6629a786bd72e800ab89d6189a1037a4c7'],18,14,32,1866694,13,,,,3415
fdc4d9adf39f84bcf1bfcda402cb22a8f1096d26,0,smarthi,2016-06-11 13:45:03-04:00,['a3f75765dad462ebc3115f777857e25da4fe3225'],13,13,26,1866720,13,,,,3415
7d3cdcdcf948aa1f59986e540b608f6a4ef7182e,0,smarthi,2016-06-11 15:17:40-04:00,['fdc4d9adf39f84bcf1bfcda402cb22a8f1096d26'],14,18,32,1866752,13,,,,3415
9de72fb018bb138d962b5fdd5e6e487b74c0fead,0,smarthi,2016-06-11 15:22:40-04:00,['7d3cdcdcf948aa1f59986e540b608f6a4ef7182e'],13,13,26,1866778,13,,,,3415
d30b725042a8d19f75216aab2a9a7e1c95b6b95e,0,smarthi,2016-06-11 15:23:04-04:00,['9de72fb018bb138d962b5fdd5e6e487b74c0fead'],5,1,6,1866784,2,,,,3415
99779be8c465c48bbcf4dc18f7bfce51179390e2,0,smarthi,2016-06-11 15:32:52-04:00,['d30b725042a8d19f75216aab2a9a7e1c95b6b95e'],14,18,32,1866816,13,,,,3415
0a05af48bf9dd7b33a18aff5ef96e013720b27b9,0,smarthi,2016-06-11 15:33:07-04:00,['99779be8c465c48bbcf4dc18f7bfce51179390e2'],18,14,32,1866848,13,,,,3415
151676d658f2b855ce740f80ccf5e64de8d4e2f1,0,smarthi,2016-06-11 15:58:14-04:00,['0a05af48bf9dd7b33a18aff5ef96e013720b27b9'],13,13,26,1866874,13,,,,3415
4aae8df897d16eba9e7a309a5d2369cd099bc01d,0,smarthi,2016-06-11 16:08:29-04:00,['151676d658f2b855ce740f80ccf5e64de8d4e2f1'],14,18,32,1866906,13,,,,3415
56b9dfbded0918e166bfce3503c8c2441849ac3b,0,smarthi,2016-06-11 16:08:44-04:00,['4aae8df897d16eba9e7a309a5d2369cd099bc01d'],18,14,32,1866938,13,,,,3415
5a4ac4c30526e78e6cc9a5392f8903563a67dc7a,0,smarthi,2016-06-11 16:27:05-04:00,['56b9dfbded0918e166bfce3503c8c2441849ac3b'],13,13,26,1866964,13,,,,3415
b2d995b2b36f6f7af060a2996e9310995973e41d,0,smarthi,2016-06-11 18:29:43-04:00,['5a4ac4c30526e78e6cc9a5392f8903563a67dc7a'],14,18,32,1866996,13,,,,3415
93264ada89d6217651e7f86221e5fe218a346421,0,smarthi,2016-06-11 18:30:26-04:00,['b2d995b2b36f6f7af060a2996e9310995973e41d'],18,14,32,1867028,13,,,,3415
cc669ecd1af30fce77cf3dc00b56a1dec879dda8,0,smarthi,2016-06-11 18:44:41-04:00,['93264ada89d6217651e7f86221e5fe218a346421'],14,18,32,1867060,13,,,,3415
9fcb25d16a8b7d2dfd7e9f50e0d21f40e14c7f28,0,smarthi,2016-06-11 18:45:24-04:00,['cc669ecd1af30fce77cf3dc00b56a1dec879dda8'],18,14,32,1867092,13,,,,3415
45f022981b5d7d9a40d0862dc1ebdae6fdef4456,0,smarthi,2016-06-11 18:51:20-04:00,['9fcb25d16a8b7d2dfd7e9f50e0d21f40e14c7f28'],14,18,32,1867124,13,,,,3415
a5513d893f21a0e5a32d509e5ce5e6725705e06f,0,smarthi,2016-06-11 18:51:35-04:00,['45f022981b5d7d9a40d0862dc1ebdae6fdef4456'],18,14,32,1867156,13,,,,3415
fe8e39acb1335e2caf24748424aa85c4085c57af,0,smarthi,2016-06-11 18:59:15-04:00,['a5513d893f21a0e5a32d509e5ce5e6725705e06f'],12,12,24,1867180,12,,,,3415
f81a909d0f5fdb10e7100b808e01ef4bf2096394,0,smarthi,2016-06-11 18:59:39-04:00,['fe8e39acb1335e2caf24748424aa85c4085c57af'],1,1,2,1867182,1,,,,3415
5c7491544eb69f60d4800a7a1544d0f725439197,0,smarthi,2016-06-11 19:10:49-04:00,['f81a909d0f5fdb10e7100b808e01ef4bf2096394'],14,18,32,1867214,13,,,,3415
2803873c35b0ddc9c92c86d295edee60f52d8af1,0,smarthi,2016-06-11 19:11:05-04:00,['5c7491544eb69f60d4800a7a1544d0f725439197'],18,14,32,1867246,13,,,,3415
1141a8d3cb47f6c1e3f4a44d9397e2aba7ab43a1,0,smarthi,2016-06-11 19:16:05-04:00,['2803873c35b0ddc9c92c86d295edee60f52d8af1'],13,13,26,1867272,13,,,,3415
ae5fc27584e478da52d16f85ef7d634a3726aec5,0,smarthi,2016-06-11 21:19:09-04:00,['1141a8d3cb47f6c1e3f4a44d9397e2aba7ab43a1'],14,18,32,1867304,13,,,,3415
b50582f2ac39b4f2f2e09670428448466f6257fb,0,smarthi,2016-06-11 21:19:26-04:00,['ae5fc27584e478da52d16f85ef7d634a3726aec5'],18,14,32,1867336,13,,,,3415
fc0697224e6f9e120b7ef237b6e8fe447c39b22d,0,smarthi,2016-06-11 21:31:14-04:00,['b50582f2ac39b4f2f2e09670428448466f6257fb'],13,13,26,1867362,13,,,,3415
cbdac4f0b38e4afe87a9307cd0dd2a8fb0b1d3da,0,smarthi,2016-06-12 01:33:02-04:00,['fc0697224e6f9e120b7ef237b6e8fe447c39b22d'],14,18,32,1867394,13,,,,3415
8028859c46a7f65503ea5bb0682957d69355d83f,0,smarthi,2016-06-12 01:33:19-04:00,['cbdac4f0b38e4afe87a9307cd0dd2a8fb0b1d3da'],18,14,32,1867426,13,,,,3415
a7212d8a417b9d549cd5b5a7be13bc8831d5e9e0,0,smarthi,2016-06-12 01:38:55-04:00,['8028859c46a7f65503ea5bb0682957d69355d83f'],13,13,26,1867452,13,,,,3415
26bd91275eff3aefb5200025409750aa0f250e59,0,smarthi,2016-06-12 14:48:10-04:00,['a7212d8a417b9d549cd5b5a7be13bc8831d5e9e0'],14,18,32,1867484,13,,,,3415
627900ac8d5ac7f17361bfa4dafcdef0682664ea,0,smarthi,2016-06-12 14:48:26-04:00,['26bd91275eff3aefb5200025409750aa0f250e59'],18,14,32,1867516,13,,,,3415
1a2b69384c9c3401b51c0127ff6d063518290d76,0,smarthi,2016-06-12 15:04:28-04:00,['627900ac8d5ac7f17361bfa4dafcdef0682664ea'],13,13,26,1867542,13,,,,3415
b8ce2493d365dd72a426ebba48310995fe22468c,0,smarthi,2016-06-13 10:29:57-04:00,['1a2b69384c9c3401b51c0127ff6d063518290d76'],14,18,32,1867574,13,,,,3415
cfe52f2fa178e0ac4bbb7b761551af88fd658ed0,0,smarthi,2016-06-13 10:30:24-04:00,['b8ce2493d365dd72a426ebba48310995fe22468c'],18,14,32,1867606,13,,,,3415
d9940489d2f849d36af396d603f6170ab560e505,1,Andrew Palumbo,2016-06-15 20:00:26-04:00,['cfe52f2fa178e0ac4bbb7b761551af88fd658ed0'],17,123,140,1867746,7,0,0,1,3415
727e5be85c0326d9c009d9cdc361fe47ffa201ad,1,Andrew Palumbo,2016-06-24 17:25:23-04:00,['d9940489d2f849d36af396d603f6170ab560e505'],15,15,30,1867776,4,,,,3415
45ee3cf097f35735d49b6861c7b9fe04a3d7b562,0,smarthi,2016-08-05 18:12:05-04:00,['727e5be85c0326d9c009d9cdc361fe47ffa201ad'],0,1,1,1867777,1,,,,3415
0ecb6685c2bb8fd2e8857967954d616a59cc2389,0,smarthi,2016-08-08 20:40:30-04:00,['45ee3cf097f35735d49b6861c7b9fe04a3d7b562'],4,5,9,1867786,2,,,,3415
33c1eab1133d8f286fb3fd18a105789e7ebee44a,0,smarthi,2016-08-11 00:53:48-04:00,['0ecb6685c2bb8fd2e8857967954d616a59cc2389'],4,4,8,1867794,2,,,,3415
4d0cd66a6269eb02fceaabdb11d70fd38d433474,0,smarthi,2016-08-11 01:42:30-04:00,['33c1eab1133d8f286fb3fd18a105789e7ebee44a'],82,67,149,1867943,18,0,0,0,3415
476972d2e3c4b297ac66e711c121ce80fc621d50,0,smarthi,2016-08-12 13:10:01-04:00,['4d0cd66a6269eb02fceaabdb11d70fd38d433474'],0,33,33,1867976,1,,,,3415
eb70eb820cbccb5d82750cd2f6541444bbb2e0dd,0,smarthi,2016-08-12 14:40:30-04:00,['476972d2e3c4b297ac66e711c121ce80fc621d50'],3,3,6,1867982,1,,,,3415
b391c76502a5294284fe761de86f952fd91434a5,0,Andrew Musselman,2016-08-16 22:47:14-06:00,"['1cfa8eab6b2aaa8e01e7ac162926ed3fbc6fe44d', 'eb70eb820cbccb5d82750cd2f6541444bbb2e0dd']",4850,51879,56729,1924711,306,,,,3415
f4a71d084958f2e1865efc8ac8115cd51e1e57d9,1,Andrew Palumbo,2016-08-27 12:21:51-04:00,['eb70eb820cbccb5d82750cd2f6541444bbb2e0dd'],16,12,28,1924739,1,,,,3415
a5e820c95c4f420d8f44dfc827fb2128c9f0750d,0,smarthi,2016-09-06 20:59:53-04:00,['f4a71d084958f2e1865efc8ac8115cd51e1e57d9'],4,0,4,1924743,1,,,,3415
c5934c2f73cc0b07ca686f76330e085893283390,0,smarthi,2016-09-06 21:03:54-04:00,['a5e820c95c4f420d8f44dfc827fb2128c9f0750d'],0,0,0,1924743,0,,,,3415
e73fdb8694e80e1e95a1213097434749726fd8af,1,smarthi,2016-09-07 00:32:50-04:00,['c5934c2f73cc0b07ca686f76330e085893283390'],38,34,72,1924815,13,0.5,1,0,3415
2f6399f3fd36f5074c2f4892407ed9d4f889fa07,0,smarthi,2016-09-08 10:55:04-04:00,['e73fdb8694e80e1e95a1213097434749726fd8af'],4,4,8,1924823,4,,,,3415
25d0ac866edd4ff496950835746fce2519d379bf,0,Andrew Musselman,2016-09-09 20:17:27-07:00,['2f6399f3fd36f5074c2f4892407ed9d4f889fa07'],0,0,0,1924823,0,,,,3415
edaddde9422a142ce07570b74278b42effd1853c,0,Andrew Musselman,2016-09-09 20:30:34-07:00,"['25d0ac866edd4ff496950835746fce2519d379bf', 'b391c76502a5294284fe761de86f952fd91434a5']",0,0,0,1924823,0,,,,3415
3351b75b3fbae173a2919c8c61268707ed193ec8,0,Andrew Musselman,2016-09-13 12:12:46-07:00,['edaddde9422a142ce07570b74278b42effd1853c'],0,0,0,1924823,0,,,,3415
b5fe4aab22e7867ae057a6cdb1610cfa17555311,1,pferrel,2016-09-13 13:02:14-07:00,['3351b75b3fbae173a2919c8c61268707ed193ec8'],672,272,944,1925767,3,0,0.843137255,0.725490196,3415
220c47493d30c0928e116af9210ab1786068ab13,1,pferrel,2016-10-01 14:02:50-07:00,['b5fe4aab22e7867ae057a6cdb1610cfa17555311'],13,87,100,1925867,2,0,0,1,3415
e87567af05884506a37e8751df0fa7f41a9d94d0,0,smarthi,2016-10-06 21:22:02-04:00,['b5fe4aab22e7867ae057a6cdb1610cfa17555311'],0,17,17,1925884,1,,,,3415
02ff22f0bbf35c3c25094433cf66261985b3ce4d,1,smarthi,2016-10-09 20:23:49-04:00,['e87567af05884506a37e8751df0fa7f41a9d94d0'],156,155,311,1926195,63,0,0,0,3415
b5c28791a001af4c4da4f3cd31979f58173cf0ec,1,smarthi,2016-10-09 20:25:38-04:00,['02ff22f0bbf35c3c25094433cf66261985b3ce4d'],152,210,362,1926557,26,,,,3415
20fdf9b9fb25dcae9e8b83242d777c373605576f,0,smarthi,2016-10-10 12:03:42-04:00,['b5c28791a001af4c4da4f3cd31979f58173cf0ec'],2,2,4,1926561,1,,,,3415
c9ee7282d0c695a6eb76dda9590a5386309c758a,0,pferrel,2016-10-10 18:24:21-07:00,"['220c47493d30c0928e116af9210ab1786068ab13', '20fdf9b9fb25dcae9e8b83242d777c373605576f']",310,384,694,1927255,89,,,,3415
1f5e36f249aabc68495ec15f64f5ed6754d9f1e2,1,pferrel,2016-10-11 08:10:31-07:00,['c9ee7282d0c695a6eb76dda9590a5386309c758a'],34,50,84,1927339,15,,,,3415
292b718a633efae5ff1b47772b9dd7bf9f1ca6da,1,smarthi,2016-10-13 22:38:09-04:00,['1f5e36f249aabc68495ec15f64f5ed6754d9f1e2'],28,109,137,1927476,8,0,1,1,3415
a511d6f45e88a133c16469fefb8087fa2dab7d94,0,pferrel,2016-10-21 12:37:50-07:00,['292b718a633efae5ff1b47772b9dd7bf9f1ca6da'],2,2,4,1927480,1,1,1,1,3415
00a2883ec69b0807a5486c61dfcc7ef27f35ddc6,1,pferrel,2016-10-28 12:25:34-07:00,['a511d6f45e88a133c16469fefb8087fa2dab7d94'],2,5,7,1927487,2,,0,0,3415
8c614a1661f58b42e84acf2b65de9e11703db7c2,0,smarthi,2016-12-26 01:53:39-05:00,['00a2883ec69b0807a5486c61dfcc7ef27f35ddc6'],2,2,4,1927491,1,,,,3415
8a0a074898c345b73b17a058301acb01352db12b,1,smarthi,2016-12-27 12:47:14-05:00,['8c614a1661f58b42e84acf2b65de9e11703db7c2'],3,3,6,1927497,2,,,,3415
1e081287671b186915148bedc05aae4384230c8f,0,smarthi,2017-01-07 10:47:58-05:00,['8a0a074898c345b73b17a058301acb01352db12b'],21,0,21,1927518,1,,,,3415
b3b72cb658ed6ad59a092eb554b06898163a1375,1,rawkintrevo,2017-01-13 13:52:35-06:00,['1e081287671b186915148bedc05aae4384230c8f'],1,130,131,1927649,3,1,1,0,3415
3e2d63c10b66a2e24ae65a575a7c2215f72e61cb,0,rawkintrevo,2017-01-13 14:05:40-06:00,['b3b72cb658ed6ad59a092eb554b06898163a1375'],0,0,0,1927649,0,,,,3415
b289f4657fb8fe16f60f806ef2b2dee86f666e74,0,smarthi,2017-01-16 16:47:55-05:00,['3e2d63c10b66a2e24ae65a575a7c2215f72e61cb'],37,62,99,1927748,8,1,1,1,3415
8e0e8b5572e0d24c1930ed60fec6d02693b41575,1,Andrew Palumbo,2017-01-16 14:48:44-08:00,['3e2d63c10b66a2e24ae65a575a7c2215f72e61cb'],37,63,100,1927848,9,0.9375,1,0.9375,3415
19182a81dcb76a3b7df55aad1d8d1086e2df7c0f,0,Andrew Palumbo,2017-01-16 14:51:24-08:00,"['8e0e8b5572e0d24c1930ed60fec6d02693b41575', 'b289f4657fb8fe16f60f806ef2b2dee86f666e74']",0,0,0,1927848,0,,,,3415
84e90ed23327355f92abeb4aede8f3a9ee5b5867,1,rawkintrevo,2017-01-16 21:17:57-06:00,['19182a81dcb76a3b7df55aad1d8d1086e2df7c0f'],0,88,88,1927936,2,1,1,1,3417
034790cce40fcee2b7a875c482345d35f7c0fa8d,1,Andrew Palumbo,2017-01-25 20:23:28-08:00,['84e90ed23327355f92abeb4aede8f3a9ee5b5867'],1065,7428,8493,1936429,75,0.365803815,0.658719346,0.651226158,3469
f8596b8668ca5104a28efd54d0ceaab51a619c89,0,Andrew Palumbo,2017-01-29 11:35:00-08:00,['034790cce40fcee2b7a875c482345d35f7c0fa8d'],2,2,4,1936433,1,,,,3469
9a31923eae3727d9d91bd2c2ed8df12a616a577e,1,rawkintrevo,2017-01-31 21:23:10-06:00,['f8596b8668ca5104a28efd54d0ceaab51a619c89'],0,1448,1448,1937881,29,0.615384615,1,1,3497
b67034e22b04124c3ec449ef5e6f3cb0b7224e0b,0,rawkintrevo,2017-01-31 21:28:41-06:00,['9a31923eae3727d9d91bd2c2ed8df12a616a577e'],0,1,1,1937882,1,,,,3497
991583abf6534a0a7118bfea3af60bf3170397d3,1,Andrew Palumbo,2017-02-02 14:11:46-08:00,['b67034e22b04124c3ec449ef5e6f3cb0b7224e0b'],9,9,18,1937900,1,0,0.666666667,0.333333333,3497
fa89753707d3ad8eba4f4328e164b832d4f699b6,0,Andrew Palumbo,2017-02-02 14:22:07-08:00,['991583abf6534a0a7118bfea3af60bf3170397d3'],0,0,0,1937900,0,,,,3497
22c5e86480c124c95b2a4698e23a0d98cd7a474b,1,Andrew Palumbo,2017-02-02 17:32:57-08:00,['fa89753707d3ad8eba4f4328e164b832d4f699b6'],2,7,9,1937909,1,,,,3497
fa9aeacccc11e50a166d290521030305d51fa787,1,rawkintrevo,2017-02-06 21:56:19-06:00,['22c5e86480c124c95b2a4698e23a0d98cd7a474b'],9,14,23,1937932,1,,,,3497
771339c82c36929d5b331215fbe792626de373af,1,rawkintrevo,2017-02-06 21:59:21-06:00,['fa9aeacccc11e50a166d290521030305d51fa787'],9,13,22,1937954,1,,,,3497
7a3617b33eb397b0d2f44e3a1456f266196c1282,1,rawkintrevo,2017-02-06 22:01:06-06:00,['771339c82c36929d5b331215fbe792626de373af'],2,4,6,1937960,1,,,,3497
f4631528b6d017d974ed46d191651e1f7edbe6a7,1,rawkintrevo,2017-02-06 22:03:29-06:00,['7a3617b33eb397b0d2f44e3a1456f266196c1282'],3,2,5,1937965,1,1,0,0,3497
60bb751926524b62be52f9b4c9d1c70d735a0afc,1,rawkintrevo,2017-02-06 22:05:21-06:00,['f4631528b6d017d974ed46d191651e1f7edbe6a7'],3,5,8,1937973,1,,,,3497
a70a8733c6db0e5dcf02384f8dd474469c42e7c5,1,rawkintrevo,2017-02-20 07:38:33-06:00,['60bb751926524b62be52f9b4c9d1c70d735a0afc'],4,46,50,1938023,2,,,,3497
52aceaf68cc198f6d5c3fb77ac16e21abce6e6dc,1,rawkintrevo,2017-02-24 07:33:36-06:00,['a70a8733c6db0e5dcf02384f8dd474469c42e7c5'],0,28,28,1938051,1,,,,3497
5afdc68e0a25e9f66a0d707a7f76d46d9603b614,1,rawkintrevo,2017-02-24 07:35:13-06:00,['52aceaf68cc198f6d5c3fb77ac16e21abce6e6dc'],477,15,492,1938543,8,0.822916667,0.333333333,0,3497
ba37a8aa20d0969d2db5d810ecd6d68f7ea57978,1,rawkintrevo,2017-02-24 07:37:06-06:00,['5afdc68e0a25e9f66a0d707a7f76d46d9603b614'],0,22,22,1938565,1,,,,3497
a2cbd15709e8f5789711d171afc5206fa6ec63ed,0,Andrew Musselman,2017-02-24 14:27:05-08:00,['ba37a8aa20d0969d2db5d810ecd6d68f7ea57978'],2,0,2,1938567,2,,,,3497
67f3a65cf6b68a2c6ac34130ab16d1a118006f45,1,Andrew Palumbo,2017-02-25 16:11:40-08:00,['a2cbd15709e8f5789711d171afc5206fa6ec63ed'],1024,1024,2048,1940615,3,1,1,1,3497
189dfe577236c009c3f66b611728395108c69801,0,Andrew Palumbo,2017-02-25 17:46:57-08:00,['67f3a65cf6b68a2c6ac34130ab16d1a118006f45'],0,0,0,1940615,0,,,,3497
bd0579d4c69e4c38955e82f12d7fcef5e537fdb5,0,Andrew Palumbo,2017-02-25 18:14:42-08:00,['189dfe577236c009c3f66b611728395108c69801'],0,0,0,1940615,0,,,,3497
d36db1d2d775d9b6ade59a451d4746f39b1a354a,1,Andrew Musselman,2017-02-25 22:01:02-08:00,['bd0579d4c69e4c38955e82f12d7fcef5e537fdb5'],53,52,105,1940720,1,,,,3497
1eacd7f9d6e34b681e8f789ce83b06a45dc92d55,0,Andrew Palumbo,2017-02-25 23:16:11-08:00,['d36db1d2d775d9b6ade59a451d4746f39b1a354a'],0,56,56,1940776,1,,,,3497
0f4b3d97cfc651a4bc052515b260648cd0093ac2,0,Andrew Palumbo,2017-02-26 13:36:24-08:00,['1eacd7f9d6e34b681e8f789ce83b06a45dc92d55'],31,48,79,1940855,3,,,,3497
b8f9d26db736268ec1b268cebaec1bed2e860523,0,Andrew Musselman,2017-02-26 14:46:08-08:00,['0f4b3d97cfc651a4bc052515b260648cd0093ac2'],1,1,2,1940857,1,,,,3497
51b1ab99a86311078aa205f32ad178acdb824fc9,0,Andrew Palumbo,2017-02-26 18:17:57-08:00,['b8f9d26db736268ec1b268cebaec1bed2e860523'],3,3,6,1940863,3,,,,3497
4d1464ef4d7a1d278c828d29a906e8f431a2fcb5,0,Andrew Palumbo,2017-02-26 19:05:40-08:00,['51b1ab99a86311078aa205f32ad178acdb824fc9'],0,27,27,1940890,1,,,,3497
eb278dc3d3789e3e945af77d48551aecc15ab33b,0,Andrew Palumbo,2017-02-26 20:26:46-08:00,['4d1464ef4d7a1d278c828d29a906e8f431a2fcb5'],29,2,31,1940921,2,,,,3497
d848625df7144ef14dd90300adcf253f08aa28e4,1,rawkintrevo,2017-02-26 22:55:35-06:00,['eb278dc3d3789e3e945af77d48551aecc15ab33b'],35,199,234,1941155,5,0.8,1,1,3497
4e0106ae5edafbef7b1411d66bc5f9e9bf44045a,1,rawkintrevo,2017-02-26 22:56:54-06:00,['d848625df7144ef14dd90300adcf253f08aa28e4'],1,1,2,1941157,1,,,,3497
5bccac1193a071d9406283969ff395990a8495c5,1,rawkintrevo,2017-02-26 23:01:11-06:00,['4e0106ae5edafbef7b1411d66bc5f9e9bf44045a'],0,58,58,1941215,1,,,,3497
7883ebc26ea40e62d8c73797e15a4ba801ae6348,0,Andrew Musselman,2017-02-27 14:57:28-08:00,['5bccac1193a071d9406283969ff395990a8495c5'],3,3,6,1941221,2,,,,3497
9ed9b4af4153fd3fed42d928c505d05335b29b92,1,Andrew Musselman,2017-02-27 15:15:43-08:00,['7883ebc26ea40e62d8c73797e15a4ba801ae6348'],103,89,192,1941413,5,,,,3497
c842ddf556f6efe12942d2f44778091b2567d145,0,Andrew Musselman,2017-02-27 15:19:06-08:00,['9ed9b4af4153fd3fed42d928c505d05335b29b92'],2,2,4,1941417,1,,,,3497
3f2e1512f597ae416c265284d6b7817e9adfad5c,0,Andrew Musselman,2017-02-28 14:45:34-08:00,['c842ddf556f6efe12942d2f44778091b2567d145'],12,16,28,1941445,11,,,,3497
aa95461e567f9981a6b886856d49b46acd366e9c,0,Andrew Musselman,2017-02-28 14:46:10-08:00,['3f2e1512f597ae416c265284d6b7817e9adfad5c'],16,12,28,1941473,11,,,,3497
58244008986b7ab35c1bd5c87bd6065c2e61bdec,0,Andrew Musselman,2017-02-28 14:58:09-08:00,['aa95461e567f9981a6b886856d49b46acd366e9c'],11,11,22,1941495,11,,,,3497
a89500f33ff35f08f9d15e73eccf6ae0e1c69f81,0,Andrew Musselman,2017-02-28 16:32:44-08:00,['58244008986b7ab35c1bd5c87bd6065c2e61bdec'],12,16,28,1941523,11,,,,3497
e1cdfa75448b501c49c46767f866fc8e263c2030,0,Andrew Musselman,2017-02-28 16:35:13-08:00,['a89500f33ff35f08f9d15e73eccf6ae0e1c69f81'],16,12,28,1941551,11,,,,3497
565af6c11ca7b97b3a0b317c09cd964978ec8b6e,0,Andrew Musselman,2017-02-28 16:45:42-08:00,['e1cdfa75448b501c49c46767f866fc8e263c2030'],12,16,28,1941579,11,,,,3497
8bc43395cff7a0060eaf33f6b282a673b4e35051,0,Andrew Musselman,2017-02-28 16:47:20-08:00,['565af6c11ca7b97b3a0b317c09cd964978ec8b6e'],16,12,28,1941607,11,,,,3497
3a8a64b6a9e8159855d1f4fcfc681cae00489a17,0,Andrew Musselman,2017-02-28 16:48:14-08:00,['8bc43395cff7a0060eaf33f6b282a673b4e35051'],11,11,22,1941629,11,,,,3497
dc7b6f493df093aa30e418224950c467d02725ab,0,Andrew Musselman,2017-02-28 21:47:11-08:00,['3a8a64b6a9e8159855d1f4fcfc681cae00489a17'],12,16,28,1941657,11,,,,3497
7d0e6225cbc8a6f186af40a94098fbf91e9f81df,0,Andrew Musselman,2017-02-28 21:47:57-08:00,['dc7b6f493df093aa30e418224950c467d02725ab'],16,12,28,1941685,11,,,,3497
a8ff16f2788f584b806721a479edb16ea9810897,0,Andrew Musselman,2017-02-28 22:10:55-08:00,['7d0e6225cbc8a6f186af40a94098fbf91e9f81df'],11,11,22,1941707,11,,,,3497
f4f3bfa31ddcd9cffdccd5bc7c60cb22d41ba48e,0,Andrew Musselman,2017-02-28 22:29:16-08:00,['a8ff16f2788f584b806721a479edb16ea9810897'],11,11,22,1941729,11,,,,3497
67e0ccf7a0841481a8b3dcb3b814a356dbccce0b,0,Andrew Musselman,2017-02-28 22:37:11-08:00,['f4f3bfa31ddcd9cffdccd5bc7c60cb22d41ba48e'],12,16,28,1941757,11,,,,3497
74d2f886116ed5284e67751a62598fd9dc3ba6b7,0,Andrew Musselman,2017-02-28 22:37:58-08:00,['67e0ccf7a0841481a8b3dcb3b814a356dbccce0b'],16,12,28,1941785,11,,,,3497
857c96d2cd5a120791f5303ad0fdf45f48d2d5dc,1,Andrew Musselman,2017-03-01 21:16:28-08:00,['74d2f886116ed5284e67751a62598fd9dc3ba6b7'],16,14,30,1941815,13,,,,3497
a6b007b65d7d90fac2f88ba857551d2c5872277b,0,Andrew Musselman,2017-03-01 21:23:23-08:00,['857c96d2cd5a120791f5303ad0fdf45f48d2d5dc'],12,16,28,1941843,11,,,,3497
08248ada165e8c3ebc96e4917129486490eb05f2,0,Andrew Musselman,2017-03-01 21:23:52-08:00,['a6b007b65d7d90fac2f88ba857551d2c5872277b'],16,12,28,1941871,11,,,,3497
ca24f0c44931aaf6ea57ef97384e12e39ccc561d,1,rawkintrevo,2017-03-05 23:24:24-06:00,['08248ada165e8c3ebc96e4917129486490eb05f2'],5,141,146,1942017,9,,,,3497
e42e26c5d93e42cb340d744325af219f3d4354f9,0,Andrew Musselman,2017-03-08 21:15:31-08:00,['ca24f0c44931aaf6ea57ef97384e12e39ccc561d'],11,11,22,1942039,11,,,,3497
d9bc8c5241252fc7a9b8415d38e4896eb8db8bc7,0,Andrew Musselman,2017-03-08 21:27:27-08:00,['e42e26c5d93e42cb340d744325af219f3d4354f9'],0,2,2,1942041,1,,,,3497
b32b6d9731481f00ea3b96e3129b9bc96e34eff5,1,Andrew Palumbo,2017-03-09 08:34:29-08:00,['d9bc8c5241252fc7a9b8415d38e4896eb8db8bc7'],26,26,52,1942093,1,,,,3497
f8f8f127231781bca0b981c26e2387bfad3958c2,0,pferrel,2017-03-09 11:45:38-08:00,['b32b6d9731481f00ea3b96e3129b9bc96e34eff5'],1,2,3,1942096,1,1,0,1,3497
2418038df19060c6efffff5f93909210ea68e699,0,Andrew Musselman,2017-03-11 21:39:45-08:00,['f8f8f127231781bca0b981c26e2387bfad3958c2'],19,23,42,1942138,11,,,,3497
07c56f2a9ea1deb98885198d80cd6359d6b4e5a5,0,Andrew Musselman,2017-03-11 21:40:23-08:00,['2418038df19060c6efffff5f93909210ea68e699'],16,12,28,1942166,11,,,,3497
66bfc6dcf84701eda4f4bbfd326cf1325f44dc2b,0,Andrew Musselman,2017-03-12 22:20:32-07:00,['07c56f2a9ea1deb98885198d80cd6359d6b4e5a5'],10,10,20,1942186,10,,,,3497
d18fcead78568f18615e2c1e43d50b41ef444df1,0,Andrew Musselman,2017-03-14 20:32:47-07:00,['66bfc6dcf84701eda4f4bbfd326cf1325f44dc2b'],12,16,28,1942214,11,,,,3497
6b5ae4d443465cd720e86d51b1bd2d377c0c4929,0,Andrew Musselman,2017-03-14 20:33:35-07:00,['d18fcead78568f18615e2c1e43d50b41ef444df1'],16,12,28,1942242,11,,,,3497
1f3156309f797fe7021383e534ffe5c2a94079f8,0,Andrew Musselman,2017-03-16 09:52:18-07:00,['6b5ae4d443465cd720e86d51b1bd2d377c0c4929'],11,11,22,1942264,11,,,,3497
049619464145feb44805877cea337a4d84179083,0,Andrew Palumbo,2017-03-17 17:44:38-07:00,['1f3156309f797fe7021383e534ffe5c2a94079f8'],0,43,43,1942307,2,,,,3497
9eb68e5319ad6f7692779e566206a159f98be8b9,1,Andrew Palumbo,2017-03-19 14:33:04-07:00,['049619464145feb44805877cea337a4d84179083'],12,196,208,1942515,1,,,,3497
0ba81db1234e7603fa0ae4a9fd0fb0881a0b523c,0,Andrew Musselman,2017-03-20 22:48:47-07:00,['049619464145feb44805877cea337a4d84179083'],12,16,28,1942543,11,,,,3497
d337d994263b9c268e8131b14dda989d0dd211b8,0,Andrew Musselman,2017-03-20 22:49:23-07:00,['0ba81db1234e7603fa0ae4a9fd0fb0881a0b523c'],16,12,28,1942571,11,,,,3497
2367fde821d5f6b052038322a60b0146ac3b3a08,0,Andrew Musselman,2017-03-21 08:29:27-07:00,['d337d994263b9c268e8131b14dda989d0dd211b8'],11,11,22,1942593,11,,,,3497
1199e51179bf858ccc3c809b332a0cc9cd950adb,0,Andrew Musselman,2017-03-21 08:34:21-07:00,"['9eb68e5319ad6f7692779e566206a159f98be8b9', '2367fde821d5f6b052038322a60b0146ac3b3a08']",0,0,0,1942593,0,,,,3497
d7cdbb009015475c91f8ada27b9834c1473bc91b,0,Andrew Musselman,2017-03-21 08:48:11-07:00,['1199e51179bf858ccc3c809b332a0cc9cd950adb'],16,11,27,1942620,1,,,,3497
bb781665d9055121a8fc33257a47f5cbad4ed538,0,Andrew Musselman,2017-03-21 08:56:28-07:00,['d7cdbb009015475c91f8ada27b9834c1473bc91b'],12,16,28,1942648,11,,,,3497
7a7930e856d0119b3650a34e7007cdfc96bb35a0,0,Andrew Musselman,2017-03-21 09:05:38-07:00,['bb781665d9055121a8fc33257a47f5cbad4ed538'],16,12,28,1942676,11,,,,3497
717b1939a8e9d5d66a8746d03a178f4987e8399b,0,Andrew Musselman,2017-03-27 08:32:32-07:00,['7a7930e856d0119b3650a34e7007cdfc96bb35a0'],11,11,22,1942698,11,,,,3497
28c1d20e21dcb97235a0c4dd5a0e22bf1783f6cc,0,Andrew Musselman,2017-03-27 09:51:04-07:00,['717b1939a8e9d5d66a8746d03a178f4987e8399b'],8,11,19,1942717,1,,,,3497
3b36ba28288ab08900fad23bfdf8a55057f63658,0,Andrew Musselman,2017-03-27 09:52:51-07:00,['28c1d20e21dcb97235a0c4dd5a0e22bf1783f6cc'],1,1,2,1942719,1,,,,3497
c0f58903b7aa29442814e1f7080858bb6ab9e96e,0,Andrew Musselman,2017-03-27 10:17:03-07:00,['3b36ba28288ab08900fad23bfdf8a55057f63658'],12,16,28,1942747,11,,,,3497
999851e2a805e4c706dba8718c00e0458e2446d2,0,Andrew Musselman,2017-03-27 10:17:29-07:00,['c0f58903b7aa29442814e1f7080858bb6ab9e96e'],16,12,28,1942775,11,,,,3497
700c270ea554ef33e31a74874199a1be13ee4ae0,0,Andrew Musselman,2017-03-27 21:24:27-07:00,['999851e2a805e4c706dba8718c00e0458e2446d2'],11,11,22,1942797,11,,,,3497
7b71b3160e105e7cd7ceac8b50028b5c2a945689,0,Andrew Musselman,2017-03-27 21:30:41-07:00,['700c270ea554ef33e31a74874199a1be13ee4ae0'],12,16,28,1942825,11,,,,3497
75b8cbba3e1364d9d1d8af3c91e5dd8bc00a005e,0,Andrew Musselman,2017-03-27 21:31:09-07:00,['7b71b3160e105e7cd7ceac8b50028b5c2a945689'],16,12,28,1942853,11,,,,3497
683990bfdeabb4ce6e0de00844d598204bc30cd8,0,Andrew Musselman,2017-03-27 22:03:51-07:00,['75b8cbba3e1364d9d1d8af3c91e5dd8bc00a005e'],11,11,22,1942875,11,,,,3497
267b34edd472b0329e0d5e8a9122d799779bdb08,0,Andrew Musselman,2017-03-28 13:36:50-07:00,['683990bfdeabb4ce6e0de00844d598204bc30cd8'],2,2,4,1942879,1,,,,3497
aa63105983037819b70fabc84fa576cc8c761634,0,Andrew Musselman,2017-03-28 13:39:40-07:00,['267b34edd472b0329e0d5e8a9122d799779bdb08'],12,16,28,1942907,11,,,,3497
2d41ae3daddd77265c86a231d4f9a2ddadab4b5c,0,Andrew Musselman,2017-03-28 13:40:03-07:00,['aa63105983037819b70fabc84fa576cc8c761634'],16,12,28,1942935,11,,,,3497
6b2e312599c2ae285d682dced977eb82db9c2d4c,0,Andrew Musselman,2017-03-28 21:44:21-07:00,['2d41ae3daddd77265c86a231d4f9a2ddadab4b5c'],10,10,20,1942955,10,,,,3497
b77f89f5da98142eb021e0c5ab3fbdccd5a8bcb9,0,Andrew Musselman,2017-03-28 21:45:45-07:00,['6b2e312599c2ae285d682dced977eb82db9c2d4c'],1,1,2,1942957,1,,,,3497
3d0c271df2713f125a435f30f399a6865f87636b,0,Andrew Palumbo,2017-04-01 19:54:51-07:00,['b77f89f5da98142eb021e0c5ab3fbdccd5a8bcb9'],2,2,4,1942961,1,,,,3497
c408c74ba0e96e738dfe1ab62190014030c88ebd,0,Andrew Musselman,2017-04-10 15:38:59-07:00,['3d0c271df2713f125a435f30f399a6865f87636b'],18,20,38,1942999,13,,,,3497
e2d0e14a3490904d74ab2dbac16ee955c3bc09d4,0,Andrew Musselman,2017-04-10 15:39:27-07:00,['c408c74ba0e96e738dfe1ab62190014030c88ebd'],18,14,32,1943031,13,,,,3497
a69fa9d4d7e442975882bec6ead383474c4ef003,1,Andrew Musselman,2017-04-14 11:17:16-07:00,['e2d0e14a3490904d74ab2dbac16ee955c3bc09d4'],13,37,50,1943081,14,,,,3497
54ba6c706d36d0e0c100dce05804486efb8a5cc0,0,Andrew Musselman,2017-04-14 11:28:25-07:00,['a69fa9d4d7e442975882bec6ead383474c4ef003'],2,0,2,1943083,1,,,,3497
059226746276a263f85d5c81d8173123ce81d45d,1,Andrew Musselman,2017-04-14 11:37:39-07:00,['54ba6c706d36d0e0c100dce05804486efb8a5cc0'],0,1,1,1943084,1,,,,3497
2333d08acc1fe476775b4ffa471cf6a1a8a10a43,0,Andrew Musselman,2017-04-14 12:02:16-07:00,['059226746276a263f85d5c81d8173123ce81d45d'],14,18,32,1943116,13,,,,3497
13019f7e4e0a192ffd9dae430fa83a9d6cff84c7,0,Andrew Musselman,2017-04-14 12:02:46-07:00,['2333d08acc1fe476775b4ffa471cf6a1a8a10a43'],18,14,32,1943148,13,,,,3497
84d43790f97988d034b33c55f76ce966949c3168,0,smarthi,2017-04-14 15:07:46-04:00,['13019f7e4e0a192ffd9dae430fa83a9d6cff84c7'],0,24,24,1943172,1,,,,3497
98ca93ed31ea9d84f925ef89886ecd52584da6c7,1,Andrew Musselman,2017-04-14 21:17:12-07:00,['13019f7e4e0a192ffd9dae430fa83a9d6cff84c7'],13,14,27,1943199,13,,,,3497
eef02000ad748d5a28f418c2da5fcff877de542f,0,Andrew Musselman,2017-04-14 21:17:20-07:00,"['98ca93ed31ea9d84f925ef89886ecd52584da6c7', '84d43790f97988d034b33c55f76ce966949c3168']",0,24,24,1943223,1,,,,3497
31b611f6f4a773e944fabf827d9ff747bc9624dc,0,Andrew Musselman,2017-04-14 21:20:33-07:00,['eef02000ad748d5a28f418c2da5fcff877de542f'],24,0,24,1943247,1,,,,3497
cca62c5a600703b99a6291440193dd233103d4e4,0,Andrew Musselman,2017-04-14 22:09:39-07:00,['31b611f6f4a773e944fabf827d9ff747bc9624dc'],14,18,32,1943279,13,,,,3497
2e5093ea269b2d0e6a57e16db24f261bbf39b1ce,0,Andrew Musselman,2017-04-14 22:10:13-07:00,['cca62c5a600703b99a6291440193dd233103d4e4'],18,14,32,1943311,13,,,,3497
724b9070cbde160d237f58a5a178125f00dcfc84,0,dustinvanstee,2017-04-20 23:02:27-04:00,"['b77f89f5da98142eb021e0c5ab3fbdccd5a8bcb9', '2e5093ea269b2d0e6a57e16db24f261bbf39b1ce']",19,41,60,1943371,15,,,,3497
54ef150e8f31ce2292ea02902674d86c9c35ffd7,0,dustinvanstee,2017-04-20 23:12:05-04:00,['724b9070cbde160d237f58a5a178125f00dcfc84'],0,25569,25569,1968940,273,0.694741967,0.741480039,0.928432327,3770
98be68ac7fde5d22b502a8cab98069e13f363abb,0,rawkintrevo,2017-04-21 16:57:03-05:00,['2e5093ea269b2d0e6a57e16db24f261bbf39b1ce'],1,7,8,1968948,1,,,,3770
eae79da4c2642a195a63462f8781e56600c1295e,1,rawkintrevo,2017-04-21 17:09:27-05:00,['98be68ac7fde5d22b502a8cab98069e13f363abb'],54,67,121,1969069,2,,,,3770
4d059f85f7341130193a74d18a951fe3110f884b,0,rawkintrevo,2017-04-21 23:16:08-05:00,['eae79da4c2642a195a63462f8781e56600c1295e'],11,31,42,1969111,3,,,,3770
db5a1d5ce5a6e4a3999cf2b943e29e9b64bbed5d,0,Andrew Musselman,2017-04-22 10:46:01-07:00,['5bccac1193a071d9406283969ff395990a8495c5'],0,1,1,1969112,1,,,,3770
f2f8cba4279b86b3a902fcac27e6f5db1d1e49ba,0,Andrew Musselman,2017-04-22 10:48:32-07:00,"['db5a1d5ce5a6e4a3999cf2b943e29e9b64bbed5d', '4d059f85f7341130193a74d18a951fe3110f884b']",231,640,871,1969983,28,,,,3770
a5c7cec9fbe24112c71cef5bc428b342a4a78ac3,0,Andrew Musselman,2017-04-22 10:49:59-07:00,"['54ef150e8f31ce2292ea02902674d86c9c35ffd7', 'f2f8cba4279b86b3a902fcac27e6f5db1d1e49ba']",57,97,154,1970137,5,,,,3770
e16bcc3d152eb6cf9f512f75bbf5e009b00fe992,0,Andrew Musselman,2017-04-22 10:53:15-07:00,['a5c7cec9fbe24112c71cef5bc428b342a4a78ac3'],1,1,2,1970139,1,,,,3770
c397ef7f7b104a56980d928466022ad2b59ac297,0,Andrew Musselman,2017-04-22 10:57:48-07:00,['f2f8cba4279b86b3a902fcac27e6f5db1d1e49ba'],0,1,1,1970140,1,,,,3770
2a8139dcfb3ad523aeaced225c162ceabde7dcff,0,Andrew Musselman,2017-04-22 10:58:28-07:00,"['e16bcc3d152eb6cf9f512f75bbf5e009b00fe992', 'c397ef7f7b104a56980d928466022ad2b59ac297']",0,1,1,1970141,1,,,,3770
08e02602e947ff945b9bd73ab5f0b45863df3e53,1,rawkintrevo,2017-04-22 13:58:17-05:00,['c397ef7f7b104a56980d928466022ad2b59ac297'],2,42,44,1970185,4,,,,3770
a60c79e7a2f32aa3e3c78d184e4219360f24869e,0,rawkintrevo,2017-04-23 12:06:02-05:00,['2a8139dcfb3ad523aeaced225c162ceabde7dcff'],8659,1411,10070,1980255,144,,,,3805
bcdad32ac3d250d7c42195d9bfa5e48fcbd4fe1f,0,rawkintrevo,2017-04-23 12:32:25-05:00,['a60c79e7a2f32aa3e3c78d184e4219360f24869e'],3,13,16,1980271,2,,,,3805
4c05501b6c10074149b93500beae9fa5f0d421ca,0,rawkintrevo,2017-04-24 19:32:14-05:00,['bcdad32ac3d250d7c42195d9bfa5e48fcbd4fe1f'],3,48,51,1980322,1,,,,3805
64108c94d9918f031bb17b78403db3866eaf5dc6,0,rawkintrevo,2017-04-24 23:16:00-05:00,['4c05501b6c10074149b93500beae9fa5f0d421ca'],91,8814,8905,1989227,105,1,0.889570552,0.975460123,3840
8f879548a3e310b960b6b555bd8def40cf60130f,0,rawkintrevo,2017-04-25 07:06:35-05:00,['bcdad32ac3d250d7c42195d9bfa5e48fcbd4fe1f'],93,8861,8954,1998181,105,1,0.889570552,0.975460123,3875
660036ebba42b739162ec4456ca4da4cea64af2a,0,rawkintrevo,2017-04-25 09:17:00-05:00,['64108c94d9918f031bb17b78403db3866eaf5dc6'],2246,220,2466,2000647,56,,,,3876
cd830b69bbc31addbf2375d92fcd70ce09c6543e,0,rawkintrevo,2017-04-25 09:36:08-05:00,['660036ebba42b739162ec4456ca4da4cea64af2a'],19,41,60,2000707,9,,,,3877
0b2d3a15f0adfd5b847dce8e6e33c82797a1f906,0,rawkintrevo,2017-04-25 09:46:06-05:00,['cd830b69bbc31addbf2375d92fcd70ce09c6543e'],6,45,51,2000758,6,,,,3881
a98bd9db539416484c89cf49d7433179d5bc9a43,0,rawkintrevo,2017-04-25 09:55:28-05:00,['0b2d3a15f0adfd5b847dce8e6e33c82797a1f906'],31,32,63,2000821,10,,,,3881
c89e3126c4d85fcdfcdee657b87fd48b6671ba38,0,rawkintrevo,2017-04-25 10:27:39-05:00,['a98bd9db539416484c89cf49d7433179d5bc9a43'],12,9,21,2000842,2,,,,3881
3958af3df16fd7d8546a8d7eaba2e3c692644f70,0,rawkintrevo,2017-04-25 10:37:46-05:00,"['c89e3126c4d85fcdfcdee657b87fd48b6671ba38', '8f879548a3e310b960b6b555bd8def40cf60130f']",0,2068,2068,2002910,14,,,,3881
00ef278cd05d11120faf6305b773564b9b0ef671,0,rawkintrevo,2017-04-25 10:38:50-05:00,['8f879548a3e310b960b6b555bd8def40cf60130f'],232,333,565,2003475,49,,,,3887
7fcf655aa45d49a549a537f4449d2431883ce5b6,0,Trevor,2017-04-25 21:50:21-05:00,['00ef278cd05d11120faf6305b773564b9b0ef671'],2584,471,3055,2006530,70,,,,3890
506212ba1b991b8681b35b73abe89537643158c4,0,Trevor,2017-04-25 22:00:23-05:00,"['7fcf655aa45d49a549a537f4449d2431883ce5b6', '3958af3df16fd7d8546a8d7eaba2e3c692644f70']",0,199,199,2006729,5,,,,3890
e2549b78cd17ecdaeaec5ca67bad2474a7cb2d60,0,Trevor,2017-04-27 11:44:41-05:00,['506212ba1b991b8681b35b73abe89537643158c4'],355,15981,16336,2023065,181,1,0.89556962,0.974683544,4008
ae8e3bbe62acb5473ea59e78e15982ad465b9334,1,rawkintrevo,2017-04-27 22:54:09-05:00,['08e02602e947ff945b9bd73ab5f0b45863df3e53'],5,112,117,2023182,7,,,,4008
a04a32fd12430d3460690ef057e98ecf628bc198,0,rawkintrevo,2017-04-28 18:55:23-05:00,['e2549b78cd17ecdaeaec5ca67bad2474a7cb2d60'],0,1,1,2023183,1,,,,4009
ac56b5512356ed4a2c590808ee0f68bb512afa10,0,rawkintrevo,2017-04-28 23:56:13-05:00,['a04a32fd12430d3460690ef057e98ecf628bc198'],13926,35888,49814,2072997,169,0.763414634,0.769296987,0.907173601,4062
0e718ec99681319487c2b7eade17bb58beb1ff3d,1,rawkintrevo,2017-04-29 00:07:39-05:00,['ac56b5512356ed4a2c590808ee0f68bb512afa10'],1,159714,159715,2232712,627,0.75761786,0.762354353,0.903059775,4688
3a724debcff6c26765a77300d79b28b32b7e3398,0,Trevor,2017-04-29 14:14:29-05:00,['0e718ec99681319487c2b7eade17bb58beb1ff3d'],24345,849,25194,2257906,52,0.231179027,0.227954577,0.091265947,4695
9c0314528b4fec247ec92654bfcc1471a880e578,1,Trevor,2017-04-29 18:24:40-05:00,['3a724debcff6c26765a77300d79b28b32b7e3398'],1,17212,17213,2275119,104,,,,4798
c81fc8b72b2fa36469b839423fddab13feba869d,0,Trevor,2017-04-29 22:23:56-05:00,['9c0314528b4fec247ec92654bfcc1471a880e578'],30,8733,8763,2283882,67,,,,4826
9759e024ee93bbcbef142ab15b92e71207096798,0,Trevor,2017-04-30 22:31:59-05:00,['c81fc8b72b2fa36469b839423fddab13feba869d'],65,320,385,2284267,56,1,1,1,4840
2346425bdb4c11133bda8759f106c7637007d702,0,Trevor,2017-05-01 10:43:53-05:00,['9759e024ee93bbcbef142ab15b92e71207096798'],36,37,73,2284340,6,,,,4841
747d94b1da72c7e3b909087b8f04e03d760df346,0,Trevor,2017-05-01 12:03:23-05:00,['2346425bdb4c11133bda8759f106c7637007d702'],1,139,140,2284480,4,,,,4842
b582dc5291512ace348540491db8671d7d41c0a2,0,rawkintrevo,2017-05-01 14:30:46-05:00,['747d94b1da72c7e3b909087b8f04e03d760df346'],288,286,574,2285054,19,,,,4849
516e3fb9ab340a2e641770e32d6511c8c7b365b6,0,rawkintrevo,2017-05-01 16:29:39-05:00,['b582dc5291512ace348540491db8671d7d41c0a2'],28,3697,3725,2288779,36,,,,4883
c8bdf2efc66d9dbba07d0c50d8369fb721581149,0,rawkintrevo,2017-05-03 00:07:22-05:00,['516e3fb9ab340a2e641770e32d6511c8c7b365b6'],1,16,17,2288796,9,,,,4888
0b38f5167297b3654f1f5fa5e79ce6e8d086ae53,0,rawkintrevo,2017-05-03 00:08:20-05:00,['c8bdf2efc66d9dbba07d0c50d8369fb721581149'],51,488,539,2289335,15,,,,4891
6f135ee6deeb8f70f33bde17c2353dd2db9dedb1,0,rawkintrevo,2017-05-03 00:36:14-05:00,['0b38f5167297b3654f1f5fa5e79ce6e8d086ae53'],2,446,448,2289783,6,,,,4892
bd360a2b34432f01cfa53bb7854c5f49854b73ca,0,rawkintrevo,2017-05-03 11:20:51-05:00,['6f135ee6deeb8f70f33bde17c2353dd2db9dedb1'],11,19,30,2289813,11,,,,4892
38cc9e2706e07612cac9b400aac19001253e2fee,0,rawkintrevo,2017-05-03 13:03:21-05:00,['ae8e3bbe62acb5473ea59e78e15982ad465b9334'],0,28,28,2289841,1,,,,4893
a84294211d9f426e7bc8709f6f876ce23b21ba6d,0,rawkintrevo,2017-05-03 13:22:58-05:00,['bd360a2b34432f01cfa53bb7854c5f49854b73ca'],141,133,274,2290115,52,,,,4894
6e5359d59ac02f9df18176ce465de6afe7b2078f,0,rawkintrevo,2017-05-03 13:26:23-05:00,['a84294211d9f426e7bc8709f6f876ce23b21ba6d'],57,57,114,2290229,57,,,,4894
fc433408f4f2c9b6065598fa27fe7f9e1a3533a0,0,rawkintrevo,2017-05-03 18:09:40-05:00,['6e5359d59ac02f9df18176ce465de6afe7b2078f'],6,161,167,2290396,2,,,,4894
c4feca039d93cfa10c074d732511ec3dfa86b69e,0,rawkintrevo,2017-05-04 12:36:21-05:00,['fc433408f4f2c9b6065598fa27fe7f9e1a3533a0'],19,104,123,2290519,3,,,,4894
3c53a6dcfb0cc8e25d7da4b62e8ed056a7629b98,0,rawkintrevo,2017-05-04 20:13:50-05:00,['c4feca039d93cfa10c074d732511ec3dfa86b69e'],37834,10438,48272,2338791,273,,,,4894
f463a5c4cc832932663afe5331cc5ad379abc599,0,rawkintrevo,2017-05-04 20:17:55-05:00,['3c53a6dcfb0cc8e25d7da4b62e8ed056a7629b98'],1,5,6,2338797,1,,,,4894
9c69c28af0494875d7e9417b82a11b79a063c146,0,rawkintrevo,2017-05-04 20:38:11-05:00,"['f463a5c4cc832932663afe5331cc5ad379abc599', '08e02602e947ff945b9bd73ab5f0b45863df3e53']",2,42,44,2338841,4,,,,4894
a8a719efaedd453059241b15fbbd99a9e9ceb4c8,0,Andrew Musselman,2017-05-04 20:56:39-07:00,"['38cc9e2706e07612cac9b400aac19001253e2fee', '9c69c28af0494875d7e9417b82a11b79a063c146']",1,202812,202813,2541654,994,,,,4894
a2b60567ac55f38f942f9fabd3981c1f8b784723,0,Andrew Musselman,2017-05-05 08:29:04-07:00,['a8a719efaedd453059241b15fbbd99a9e9ceb4c8'],3,0,3,2541657,1,,,,4894
f71020f41107fd4ac621c9814313e5e2cd0b014b,0,rawkintrevo,2017-05-07 18:01:02-05:00,['a2b60567ac55f38f942f9fabd3981c1f8b784723'],15,8,23,2541680,2,,,,4894
d5072a082bf702d5a6f275dd058f7fefa5cb2a5d,0,rawkintrevo,2017-05-07 18:14:50-05:00,['f71020f41107fd4ac621c9814313e5e2cd0b014b'],0,694,694,2542374,9,,,,4901
be2ad1c75b756ca7a797596ab70356308360a509,0,rawkintrevo,2017-05-07 18:32:08-05:00,['d5072a082bf702d5a6f275dd058f7fefa5cb2a5d'],0,30,30,2542404,1,,,,4901
b45178e2832cc30bace75ec29be8dfaa943444c2,0,rawkintrevo,2017-05-07 18:37:47-05:00,['be2ad1c75b756ca7a797596ab70356308360a509'],30,1,31,2542435,1,,,,4901
534c2f8d9a5788db0d671d9623109791dcd579c8,0,rawkintrevo,2017-05-13 02:59:13-05:00,['b45178e2832cc30bace75ec29be8dfaa943444c2'],71,104,175,2542610,4,,,,4901
7c0babd79bf352c98d46a4d7dab38d11ef9b6669,0,rawkintrevo,2017-05-13 03:00:37-05:00,['534c2f8d9a5788db0d671d9623109791dcd579c8'],105601,168,105769,2648379,390,0.243825951,0.237161897,0.094766758,4903
cf5a33d565f6602f6624bc4d34c62c048379140f,1,rawkintrevo,2017-05-20 22:19:32-05:00,['7c0babd79bf352c98d46a4d7dab38d11ef9b6669'],18,166,184,2648563,5,,,,4903
2f2ca3c987745c51fcaa10d056dbd9d6503a9fd6,0,rawkintrevo,2017-05-20 22:32:51-05:00,['cf5a33d565f6602f6624bc4d34c62c048379140f'],0,0,0,2648563,0,,,,4903
9b4eabb9cfc27eb4f8d062b33114e32a590dc791,0,rawkintrevo,2017-05-20 22:34:33-05:00,['2f2ca3c987745c51fcaa10d056dbd9d6503a9fd6'],0,0,0,2648563,0,,,,4903
c29496cb11372baddbb76acdee51530347525645,1,rawkintrevo,2017-05-20 22:36:02-05:00,['9b4eabb9cfc27eb4f8d062b33114e32a590dc791'],2,604,606,2649169,15,1,1,1,4916
31833fa6827729155934be77bdde7c546ebd47f3,0,rawkintrevo,2017-05-20 22:44:04-05:00,['c29496cb11372baddbb76acdee51530347525645'],4,4,8,2649177,1,,,,4916
e74c478d223c9f2ec90478dd2236c1b886bc5050,0,dustinvanstee,2017-06-23 11:47:08-04:00,['31833fa6827729155934be77bdde7c546ebd47f3'],4,4,8,2649185,2,,,,4916
c17bee3c2705495b638d81ae2ad374bf7494c3f3,0,rawkintrevo,2017-06-26 16:39:14-05:00,['e74c478d223c9f2ec90478dd2236c1b886bc5050'],41,127,168,2649353,9,1,1,0.363636364,4916
48d6ca51738f9560aced6e15e1201025243a0d90,0,rawkintrevo,2017-06-26 16:41:58-05:00,['c17bee3c2705495b638d81ae2ad374bf7494c3f3'],1,3,4,2649357,2,,,,4916
a799ead59aa77cab0596f72bbe40872b59367e35,1,rawkintrevo,2017-06-26 16:49:09-05:00,['48d6ca51738f9560aced6e15e1201025243a0d90'],8,24,32,2649389,2,,,,4916
36c15d8a633f6836b35578e9915c96f4ca71ac55,0,Andrew Palumbo,2017-06-27 15:01:30-07:00,['a799ead59aa77cab0596f72bbe40872b59367e35'],3,32,35,2649424,2,,,,4916
fed8c472084b976965b59cdc3129d20e7fde7735,0,rawkintrevo,2017-06-28 21:48:31-05:00,['36c15d8a633f6836b35578e9915c96f4ca71ac55'],0,0,0,2649424,0,,,,4916
5a3b4f509cfca5ab7ce5fe85a4fd006e89e460c8,0,rawkintrevo,2017-06-28 22:18:15-05:00,['fed8c472084b976965b59cdc3129d20e7fde7735'],2,2,4,2649428,1,,,,4916
b41e140cc01a58a233eb91e632ed5e1780607406,0,rawkintrevo,2017-06-29 08:37:18-05:00,['5a3b4f509cfca5ab7ce5fe85a4fd006e89e460c8'],9,37,46,2649474,2,,,,4916
182ef0229842054ba1bbad4352791d493546ade1,0,rawkintrevo,2017-06-29 08:39:57-05:00,['b41e140cc01a58a233eb91e632ed5e1780607406'],0,0,0,2649474,0,,,,4916
2be27b3784412beb907374026cd5e5c787a55eec,0,Andrew Musselman,2017-07-06 17:11:33-07:00,['182ef0229842054ba1bbad4352791d493546ade1'],123,56,179,2649653,1,,,,4916
6081793d063381c3e6c7ef121ee66660ec789ce6,0,rawkintrevo,2017-07-06 23:17:10-05:00,['2be27b3784412beb907374026cd5e5c787a55eec'],14,18,32,2649685,13,,,,4916
3f8d181ca519982c95e7d2f83f8d0701748406f2,0,rawkintrevo,2017-07-06 23:17:48-05:00,['6081793d063381c3e6c7ef121ee66660ec789ce6'],18,14,32,2649717,13,,,,4916
d3fb367b31cfe7932e2c1c5607838158b8df0e73,0,rawkintrevo,2017-07-06 23:28:16-05:00,['3f8d181ca519982c95e7d2f83f8d0701748406f2'],13,13,26,2649743,13,,,,4916
f04fa9afe83ce9e147909c9956b62f05f6257aba,0,rawkintrevo,2017-07-06 23:33:46-05:00,['d3fb367b31cfe7932e2c1c5607838158b8df0e73'],14,18,32,2649775,13,,,,4916
d264c1b6a3dd5451ff002f86bd241098a4b6f5f6,0,rawkintrevo,2017-07-06 23:36:36-05:00,['f04fa9afe83ce9e147909c9956b62f05f6257aba'],18,14,32,2649807,13,,,,4916
c806504cd9b85705659a27c12116b9ef04a22dad,0,rawkintrevo,2017-07-06 23:42:30-05:00,['d264c1b6a3dd5451ff002f86bd241098a4b6f5f6'],14,18,32,2649839,13,,,,4916
ef5820f22f6a3e7acfdcde278bc28e8c8f0c41d1,0,rawkintrevo,2017-07-06 23:42:56-05:00,['c806504cd9b85705659a27c12116b9ef04a22dad'],18,14,32,2649871,13,,,,4916
74766e309cb371059ce73fe2f7a585d6757662a4,1,rawkintrevo,2017-07-11 08:58:24-05:00,['2be27b3784412beb907374026cd5e5c787a55eec'],1,20,21,2649892,3,,,,4916
d043db4035f641b92be392bdb09320e896a93c0a,0,vanstee,2017-07-20 14:28:51-04:00,['74766e309cb371059ce73fe2f7a585d6757662a4'],10,44,54,2649946,3,,,,4917
9595d30ad1db5d77920d887c8676082c1375bce5,0,vanstee,2017-07-20 14:55:11-04:00,['d043db4035f641b92be392bdb09320e896a93c0a'],6,45,51,2649997,5,,,,4918
8c14b309cb4319cb304b68328bc646a3ec48f55d,1,rawkintrevo,2017-07-24 15:33:08-05:00,['9595d30ad1db5d77920d887c8676082c1375bce5'],17,582,599,2650596,7,,,,4921
47a9362255fed1e1f8a21c1bf93549b308987d52,0,rawkintrevo,2017-07-24 15:38:35-05:00,"['ef5820f22f6a3e7acfdcde278bc28e8c8f0c41d1', '8c14b309cb4319cb304b68328bc646a3ec48f55d']",34,691,725,2651321,15,,,,4921
4149843c13c8eb5c54deaad3fd77a22968c5f966,0,rawkintrevo,2017-07-24 16:44:30-05:00,['47a9362255fed1e1f8a21c1bf93549b308987d52'],12,16,28,2651349,11,,,,4921
e3530b24132b39ee7ada7d5ec9a9edf388984fb1,0,rawkintrevo,2017-07-24 16:48:20-05:00,['4149843c13c8eb5c54deaad3fd77a22968c5f966'],16,12,28,2651377,11,,,,4921
72dfcee8c15594c7d3cc9daee13de0752451a48b,0,rawkintrevo,2017-07-25 16:57:06-05:00,['e3530b24132b39ee7ada7d5ec9a9edf388984fb1'],80,710,790,2652167,17,,,,4930
9a4f9d36298259274dac94665eda7ce9e482cdbd,0,rawkintrevo,2017-07-27 11:45:39-05:00,['72dfcee8c15594c7d3cc9daee13de0752451a48b'],588,5949,6537,2658704,95,0.395469256,0.677669903,0.637540453,4974
b3c6708bab882e2637a854b1a00ec21dbe268b2d,0,rawkintrevo,2017-07-27 11:51:24-05:00,['9a4f9d36298259274dac94665eda7ce9e482cdbd'],1,1,2,2658706,1,,,,4974
9f83099af8c9e788da00cdb422f9e97ac8492961,0,rawkintrevo,2017-07-27 12:05:33-05:00,['b3c6708bab882e2637a854b1a00ec21dbe268b2d'],1,1,2,2658708,1,,,,4974
89484d8791bbeba6ccd42271de67d76541529100,0,rawkintrevo,2017-07-27 23:56:33-05:00,['9f83099af8c9e788da00cdb422f9e97ac8492961'],41,226,267,2658975,14,,,,4976
ecf642f7de1fd56435282e7db6734e6abe359d7b,0,rawkintrevo,2017-07-30 21:59:35-05:00,['89484d8791bbeba6ccd42271de67d76541529100'],1,1,2,2658977,1,,,,4976
e2dde2272fe5956faaf1da2b34bc9119d7f33a5d,0,rawkintrevo,2017-07-31 18:50:05-05:00,['ecf642f7de1fd56435282e7db6734e6abe359d7b'],1,21,22,2658999,3,,,,4976
50f605a0d5c484a5b0d4028fb09d15aba57a290a,0,rawkintrevo,2017-07-31 19:48:33-05:00,['e2dde2272fe5956faaf1da2b34bc9119d7f33a5d'],0,4,4,2659003,1,,,,4976
0f82e09527150753901ea0deeb2fcec8d45de781,0,rawkintrevo,2017-08-01 08:49:23-05:00,['50f605a0d5c484a5b0d4028fb09d15aba57a290a'],21,21,42,2659045,20,,,,4976
2670242f0d065bf2deb521f337d7a2d8b705b0b2,0,rawkintrevo,2017-08-01 09:27:37-05:00,['0f82e09527150753901ea0deeb2fcec8d45de781'],1,1,2,2659047,1,,,,4976
cbdec6e059a07f2f33a3e67a5f3ce1febf963651,0,rawkintrevo,2017-08-01 09:49:02-05:00,['2670242f0d065bf2deb521f337d7a2d8b705b0b2'],2,1,3,2659050,1,,,,4976
aedb0243715058c5e32a7026b7350e221b3fc788,0,Trevor Grant,2017-08-01 11:54:30-05:00,['cbdec6e059a07f2f33a3e67a5f3ce1febf963651'],4,2,6,2659056,1,,,,4976
d108041d92faa0327339e478305222022b858329,0,Trevor Grant,2017-08-01 18:55:48-05:00,['aedb0243715058c5e32a7026b7350e221b3fc788'],10,23,33,2659089,4,,,,4976
e56378cf7191fefa56eab6c17266a956d01f709e,1,Andrew Palumbo,2017-09-05 11:34:29-07:00,['e3530b24132b39ee7ada7d5ec9a9edf388984fb1'],15,15,30,2659119,13,,,,4976
b99e71c32c9fece5acf4485e7f3073d50240336a,0,Trevor a.k.a @rawkintrevo,2017-09-21 13:17:12-05:00,['e56378cf7191fefa56eab6c17266a956d01f709e'],1,0,1,2659120,1,,,,4976
be254cdf3d7d24826e52a0f3db66902e485fad43,0,Trevor a.k.a @rawkintrevo,2017-09-21 13:17:54-05:00,['b99e71c32c9fece5acf4485e7f3073d50240336a'],0,0,0,2659120,0,,,,4976
fe4cb1a0919eebd8262ad8f0ff142a53de9eba42,1,Andrew Palumbo,2017-09-30 11:52:55-07:00,['be254cdf3d7d24826e52a0f3db66902e485fad43'],1,1,2,2659122,1,,,,4976
d9b32f308804859b382e855d5a323a62ba7153e1,1,Trevor a.k.a @rawkintrevo,2017-11-17 17:04:24-06:00,['fe4cb1a0919eebd8262ad8f0ff142a53de9eba42'],49,342,391,2659513,12,,,,4977
800a9ed6d7e015aa82b9eb7624bb441b71a8f397,1,pferrel,2017-11-18 12:34:07-08:00,['d9b32f308804859b382e855d5a323a62ba7153e1'],0,53,53,2659566,1,0,0,1,4977
6188fa578acdfb275119a4f85ba128fc0506b4f8,0,Trevor a.k.a @rawkintrevo,2017-11-28 15:02:41-06:00,['800a9ed6d7e015aa82b9eb7624bb441b71a8f397'],1,1,2,2659568,1,,,,4977
a128b768e62a229be845855ecee235240efec8f7,0,Trevor a.k.a @rawkintrevo,2017-11-28 15:08:51-06:00,['6188fa578acdfb275119a4f85ba128fc0506b4f8'],0,0,0,2659568,0,,,,4977
1d198100aa02005e8e5e0319ca2a08113bf58468,0,Trevor a.k.a @rawkintrevo,2017-11-28 15:09:08-06:00,['a128b768e62a229be845855ecee235240efec8f7'],0,0,0,2659568,0,,,,4977
defbbd20f78c7b9e0bcc3a81d3d79d76be32cf23,0,Trevor a.k.a @rawkintrevo,2017-11-28 15:37:29-06:00,['1d198100aa02005e8e5e0319ca2a08113bf58468'],2,31,33,2659601,1,1,1,1,4977
5f3133c337ca89893b0accb2e7edae9a4e756166,0,Trevor a.k.a @rawkintrevo,2017-11-29 11:01:38-06:00,['defbbd20f78c7b9e0bcc3a81d3d79d76be32cf23'],0,39,39,2659640,1,,,,4978
54f01bce24a946b2f93f6606f6c970e62c3c57ee,0,Trevor a.k.a @rawkintrevo,2017-11-29 12:06:28-06:00,['5f3133c337ca89893b0accb2e7edae9a4e756166'],0,0,0,2659640,0,,,,4978
b213213a302caa91fc4b5a64247a4a1862244b38,0,Trevor a.k.a @rawkintrevo,2017-11-29 12:25:54-06:00,['54f01bce24a946b2f93f6606f6c970e62c3c57ee'],0,0,0,2659640,1,,,,4978
e591012439c04e98d669ef9732fde865a9ef76fa,0,Trevor a.k.a @rawkintrevo,2017-11-29 13:14:54-06:00,['b213213a302caa91fc4b5a64247a4a1862244b38'],3,4,7,2659647,1,,,,4978
fe77fc19fc0c4d0c05c55a30a473acc71e30f1de,0,Trevor a.k.a @rawkintrevo,2017-11-29 13:25:14-06:00,['e591012439c04e98d669ef9732fde865a9ef76fa'],28,164,192,2659839,2,,,,4978
d5014fc543343b08a0c876c2b76d09f86092e86c,0,Trevor a.k.a @rawkintrevo,2017-11-29 13:29:38-06:00,['fe77fc19fc0c4d0c05c55a30a473acc71e30f1de'],0,0,0,2659839,1,,,,4978
bb33d9a5a09a8b77c0853c41cd85228cecc40675,0,Trevor a.k.a @rawkintrevo,2017-11-29 13:35:09-06:00,['d5014fc543343b08a0c876c2b76d09f86092e86c'],0,0,0,2659839,1,,,,4978
2872a3082549731314e4426774978da86698aa3a,0,Trevor a.k.a @rawkintrevo,2017-11-29 13:37:28-06:00,['bb33d9a5a09a8b77c0853c41cd85228cecc40675'],0,0,0,2659839,1,,,,4978
f0a246a341cdf66e1ff727a469ed268c00b7ebfe,0,Trevor a.k.a @rawkintrevo,2017-11-29 13:38:26-06:00,['2872a3082549731314e4426774978da86698aa3a'],4,1,5,2659844,1,,,,4978
2613883f2f6af05e69cdcc5945a456480747566e,0,Trevor a.k.a @rawkintrevo,2017-11-29 14:28:48-06:00,['f0a246a341cdf66e1ff727a469ed268c00b7ebfe'],12,6,18,2659862,4,,,,4978
c80e00f894779b9c937eea280b3b7c39d07ed610,0,Trevor a.k.a @rawkintrevo,2017-11-29 14:53:23-06:00,['2613883f2f6af05e69cdcc5945a456480747566e'],8,8,16,2659878,1,,,,4978
52154565410a7ebb9f9cdfe13ad9f039c1f8abb7,0,Trevor a.k.a @rawkintrevo,2017-11-29 15:22:36-06:00,['c80e00f894779b9c937eea280b3b7c39d07ed610'],0,0,0,2659878,0,,,,4978
2483037dc65fd69a508759f241e62709ea780af3,0,Trevor a.k.a @rawkintrevo,2017-11-29 15:35:27-06:00,['52154565410a7ebb9f9cdfe13ad9f039c1f8abb7'],0,0,0,2659878,0,,,,4978
697eae12c513f15e97a18b8a4e143fdc53064b7f,0,Trevor a.k.a @rawkintrevo,2017-11-29 15:46:42-06:00,['2483037dc65fd69a508759f241e62709ea780af3'],2511,22,2533,2662411,40,0,0,0,4978
1e6584d78e8dc83c04fd1c29a8b01d7e63b6005d,0,Trevor a.k.a @rawkintrevo,2017-11-29 18:01:09-06:00,['697eae12c513f15e97a18b8a4e143fdc53064b7f'],4,0,4,2662415,1,,,,4978
9fe4aadc731ffecf3996992b51b8044c880b0e94,0,Trevor a.k.a @rawkintrevo,2017-11-29 18:11:53-06:00,['1e6584d78e8dc83c04fd1c29a8b01d7e63b6005d'],17,3,20,2662435,2,,,,4978
8a7bd9156880f3f12509c64cda62ac389cbb4f7d,0,Trevor a.k.a @rawkintrevo,2017-11-29 18:22:33-06:00,['9fe4aadc731ffecf3996992b51b8044c880b0e94'],34,29,63,2662498,1,,,,4978
4f2108c576daaa3198671568eaa619266e787b1a,0,Trevor a.k.a @rawkintrevo,2017-11-29 18:28:24-06:00,['8a7bd9156880f3f12509c64cda62ac389cbb4f7d'],1,1,2,2662500,1,,,,4978
ec5eb314fa4c9c30282c78ee1d1e033148674015,0,Trevor a.k.a @rawkintrevo,2017-12-02 00:08:10-06:00,['4f2108c576daaa3198671568eaa619266e787b1a'],480,37989,38469,2700969,867,0.493477861,0.538122359,0.704207239,5278
9beddd3108ae453091a21a881c6693016f5f2012,1,Trevor a.k.a @rawkintrevo,2017-12-04 20:53:19-06:00,['ec5eb314fa4c9c30282c78ee1d1e033148674015'],81674,556,82230,2783199,784,0.241471345,0.235745135,0.094045713,5281
03918713563bf6aac55299d7239c4e042795faf0,0,Trevor a.k.a @rawkintrevo,2017-12-05 22:17:31-06:00,['9beddd3108ae453091a21a881c6693016f5f2012'],0,28,28,2783227,1,,,,5282
fc36bef157dc47d9572c4cfd460067e1916910a0,0,Trevor a.k.a @rawkintrevo,2017-12-05 22:35:26-06:00,['03918713563bf6aac55299d7239c4e042795faf0'],7,4,11,2783238,1,,,,5282
5a07b51b4f85ea54ee234bd8e2bc320f49f8968c,0,Trevor a.k.a @rawkintrevo,2017-12-05 23:16:20-06:00,['fc36bef157dc47d9572c4cfd460067e1916910a0'],594,490,1084,2784322,214,,,,5282
9a2055e7b7bd1788b0b7523367772650ffdb6b53,0,Andrew Musselman,2017-12-05 22:44:12-08:00,['5a07b51b4f85ea54ee234bd8e2bc320f49f8968c'],5,6,11,2784333,2,,,,5282
ca8b4935c4014397ee4ffc7cd7964dce0979cdf6,0,Trevor a.k.a @rawkintrevo,2017-12-07 13:23:08-06:00,['4f2108c576daaa3198671568eaa619266e787b1a'],2,2,4,2784337,1,,,,5282
df08a37c4112cbe1161f5c20f985e9c1c9abff42,0,Andrew Musselman,2017-12-17 19:45:23-08:00,"['d108041d92faa0327339e478305222022b858329', 'ca8b4935c4014397ee4ffc7cd7964dce0979cdf6']",2548,626,3174,2787511,63,,,,5282
2f55adeffebef2fdd1295deb1c44489d33b0b495,0,Andrew Musselman,2017-12-17 21:16:46-08:00,['df08a37c4112cbe1161f5c20f985e9c1c9abff42'],6736,477,7213,2794724,107,0.604530744,0.322330097,0.362459547,5282
b887ab3653590c854f2b118162114f1133b9534d,0,Andrew Musselman,2017-12-20 20:50:58-08:00,"['9a2055e7b7bd1788b0b7523367772650ffdb6b53', '2f55adeffebef2fdd1295deb1c44489d33b0b495']",2,2,4,2794728,1,,,,5282
1c528a194ebad97f24934685e7bfd9872ebe3019,0,Trevor a.k.a @rawkintrevo,2017-12-21 17:57:04-06:00,['b887ab3653590c854f2b118162114f1133b9534d'],60,78,138,2794866,10,,,,5284
6141be782e271748c9839de1e2b837eabb25033c,0,Trevor a.k.a @rawkintrevo,2017-12-21 18:40:59-06:00,['1c528a194ebad97f24934685e7bfd9872ebe3019'],2,2,4,2794870,1,,,,5284
b9895898d799ae913ad2b37e10b4ae75467b5e37,0,Trevor a.k.a @rawkintrevo,2017-12-21 18:47:13-06:00,['6141be782e271748c9839de1e2b837eabb25033c'],0,0,0,2794870,0,,,,5284
4c1d12e39801ca7e2fa1170190d77e150ff11d66,0,Trevor a.k.a @rawkintrevo,2017-12-21 19:42:45-06:00,['b9895898d799ae913ad2b37e10b4ae75467b5e37'],3,3,6,2794876,3,,,,5284
d53d444374c874a89abd87042a4bdd6a57915258,0,Trevor a.k.a @rawkintrevo,2017-12-21 20:51:23-06:00,['4c1d12e39801ca7e2fa1170190d77e150ff11d66'],19,34,53,2794929,5,,,,5285
36da4cf3d4982e246191a3ec7eac2495a25f8a86,0,Trevor a.k.a @rawkintrevo,2017-12-21 21:24:39-06:00,['d53d444374c874a89abd87042a4bdd6a57915258'],15,18,33,2794962,5,,,,5285
5c51c60180b05f5ea70ef7b86daf62c7e250ef08,0,Trevor a.k.a @rawkintrevo,2017-12-21 21:36:05-06:00,['36da4cf3d4982e246191a3ec7eac2495a25f8a86'],9,7,16,2794978,3,,,,5285
71ce4bf599f7abe8508724d124fa4554153055c6,0,Trevor a.k.a @rawkintrevo,2017-12-21 21:49:36-06:00,['5c51c60180b05f5ea70ef7b86daf62c7e250ef08'],4,14,18,2794996,6,,,,5285
84f389140c3781ace210ad9fc977f0d464666644,0,Trevor a.k.a @rawkintrevo,2017-12-21 21:52:30-06:00,['71ce4bf599f7abe8508724d124fa4554153055c6'],1,1,2,2794998,1,,,,5285
7dff35bc3c61c3e0b95e8e59406742be15203a69,0,Trevor a.k.a @rawkintrevo,2017-12-21 22:03:02-06:00,['84f389140c3781ace210ad9fc977f0d464666644'],2,2,4,2795002,2,,,,5285
33d1a6e699c688191fe079bfa427f89dbbe532e4,1,Trevor a.k.a @rawkintrevo,2018-05-31 11:41:16-05:00,['7dff35bc3c61c3e0b95e8e59406742be15203a69'],901,64031,64932,2859934,472,0.547085435,0.75165098,0.828818054,5665
5eda9e1fdd390a94fe7740ff196b5de155d9e3d6,1,Trevor a.k.a @rawkintrevo,2018-06-02 11:02:13-05:00,['33d1a6e699c688191fe079bfa427f89dbbe532e4'],99,3038,3137,2863071,850,0.601950355,0.703900709,0.757092199,5692
65c8aae283540df0a9ba68bbacb15e09d757a526,1,Trevor a.k.a @rawkintrevo,2018-06-03 09:57:20-05:00,['5eda9e1fdd390a94fe7740ff196b5de155d9e3d6'],1,16,17,2863088,2,,,,5692
4f18f402a289de7fb41f067c411bd059d3b0138d,1,Trevor a.k.a @rawkintrevo,2018-06-03 11:23:42-05:00,['65c8aae283540df0a9ba68bbacb15e09d757a526'],74,559,633,2863721,40,,,,5692
020a187523266dad14da2dc36ca87d7cc186de82,1,Trevor a.k.a @rawkintrevo,2018-06-04 11:34:19-05:00,['4f18f402a289de7fb41f067c411bd059d3b0138d'],60,1011,1071,2864792,17,0.320241692,0.851963746,0.963746224,5697
3ee84f9c1dec2c559050e371362aeaf8f02ebbba,1,Trevor a.k.a @rawkintrevo,2018-06-05 08:25:57-05:00,['020a187523266dad14da2dc36ca87d7cc186de82'],0,24,24,2864816,2,,,,5697
5ca36a458dbafee65244514fc0b46f4672ddfc49,0,Trevor a.k.a @rawkintrevo,2018-06-05 08:41:47-05:00,['3ee84f9c1dec2c559050e371362aeaf8f02ebbba'],15,15,30,2864846,13,,,,5697
a39ccda97cb02b2c9445ad2dd68e203d511f32bc,0,Trevor a.k.a @rawkintrevo,2018-06-05 08:42:55-05:00,['5ca36a458dbafee65244514fc0b46f4672ddfc49'],14,14,28,2864874,13,,,,5697
505f08553970471edfeb251f2f54396e4793704e,1,Trevor a.k.a @rawkintrevo,2018-06-05 08:50:06-05:00,['a39ccda97cb02b2c9445ad2dd68e203d511f32bc'],14,14,28,2864902,13,,,,5697
2d53a5c6b08c1fb16bef048443f718c1bad39c10,0,Trevor a.k.a @rawkintrevo,2018-06-05 08:50:45-05:00,['505f08553970471edfeb251f2f54396e4793704e'],1,3,4,2864906,2,,,,5697
ed37c220cbd86b11dde67e6290151ac13f227772,0,Trevor a.k.a @rawkintrevo,2018-06-05 09:15:33-05:00,['2d53a5c6b08c1fb16bef048443f718c1bad39c10'],5,16,21,2864927,1,,,,5697
c23a9f696f33994b8f733aa09ce4540f9e0bc4a4,1,Trevor a.k.a @rawkintrevo,2018-06-05 09:16:21-05:00,['ed37c220cbd86b11dde67e6290151ac13f227772'],11,11,22,2864949,11,,,,5697
7b9eea4673e8325f49d184ed5275afacfd851026,1,Trevor a.k.a @rawkintrevo,2018-06-05 09:24:15-05:00,['c23a9f696f33994b8f733aa09ce4540f9e0bc4a4'],0,3,3,2864952,1,,,,5697
9f9b518b79f6950879f8141500ebc12149caa442,0,Trevor a.k.a @rawkintrevo,2018-06-05 10:09:08-05:00,['7b9eea4673e8325f49d184ed5275afacfd851026'],13,15,28,2864980,14,,,,5697
5aacd5bede9fbf78fc1347cc85a42a498408b1ce,0,Trevor a.k.a @rawkintrevo,2018-06-05 10:16:24-05:00,['9f9b518b79f6950879f8141500ebc12149caa442'],12,12,24,2865004,11,,,,5697
03432eaa383ad10a95b1c7d3d1db590ffa0678b7,0,Trevor a.k.a @rawkintrevo,2018-06-05 10:17:11-05:00,['5aacd5bede9fbf78fc1347cc85a42a498408b1ce'],12,12,24,2865028,11,,,,5697
6867631269e1de85b3965473219c01b3d9f1aee9,1,Trevor a.k.a @rawkintrevo,2018-06-05 10:24:56-05:00,['03432eaa383ad10a95b1c7d3d1db590ffa0678b7'],12,12,24,2865052,11,,,,5697
f7719650ddccb313c68483eb7dd1cd855b425014,1,Trevor a.k.a @rawkintrevo,2018-06-05 10:29:16-05:00,['6867631269e1de85b3965473219c01b3d9f1aee9'],11,13,24,2865076,12,,,,5697
f8e728ab7724d02a800b31fa4007fb9725c417d1,0,Trevor a.k.a @rawkintrevo,2018-06-05 10:36:40-05:00,['f7719650ddccb313c68483eb7dd1cd855b425014'],11,11,22,2865098,11,,,,5697
01aec6b39e8a5cc72675be5b2641ddca4f38adab,0,Trevor a.k.a @rawkintrevo,2018-06-05 10:40:11-05:00,['f8e728ab7724d02a800b31fa4007fb9725c417d1'],11,11,22,2865120,11,,,,5697
8d407a161f15f194a4af2452a3cbe12947971f67,1,Trevor a.k.a @rawkintrevo,2018-06-05 10:41:29-05:00,['01aec6b39e8a5cc72675be5b2641ddca4f38adab'],1,9,10,2865130,1,,,,5697
9e2f710041445b63b87a3ae021354721e55d91ff,0,Trevor a.k.a @rawkintrevo,2018-06-05 10:48:48-05:00,['8d407a161f15f194a4af2452a3cbe12947971f67'],12,12,24,2865154,11,,,,5697
d076ab6bee986a26b336459c449afe2af0547dae,1,Trevor a.k.a @rawkintrevo,2018-06-05 10:49:11-05:00,['9e2f710041445b63b87a3ae021354721e55d91ff'],12,12,24,2865178,11,,,,5697
5acdd99d30eb79b6d7996e82099a2ecd7e50fa34,0,Trevor a.k.a @rawkintrevo,2018-06-05 11:12:06-05:00,['d076ab6bee986a26b336459c449afe2af0547dae'],13,13,26,2865204,13,,,,5697
98d345cbca531ab8906a447b3c949d9871462cf1,0,Trevor a.k.a @rawkintrevo,2018-06-05 11:38:37-05:00,['5acdd99d30eb79b6d7996e82099a2ecd7e50fa34'],12,6,18,2865222,1,,,,5697
c317393277c56ed789246b17fabbcea18679ba9a,1,Trevor a.k.a @rawkintrevo,2018-06-06 09:36:18-05:00,['98d345cbca531ab8906a447b3c949d9871462cf1'],69,137,206,2865428,6,,,,5697
ff658853dc7d6a588b60957119c4183a8e00bd9b,0,Trevor a.k.a @rawkintrevo,2018-06-06 09:58:45-05:00,['c317393277c56ed789246b17fabbcea18679ba9a'],3,4,7,2865435,3,,,,5697
0fca1c0f6f2e9f45905171ac80550e33e72c477e,0,Trevor a.k.a @rawkintrevo,2018-06-06 10:11:38-05:00,['ff658853dc7d6a588b60957119c4183a8e00bd9b'],0,3,3,2865438,1,,,,5697
abcc6456756b45f2ed14ff6c8ffecf893d679cc7,1,Trevor a.k.a @rawkintrevo,2018-06-18 10:25:41-05:00,['0fca1c0f6f2e9f45905171ac80550e33e72c477e'],42,126,168,2865606,5,,,,5697
edb29e5f2e7b4acf288cf106b7a58d0b3b80c965,0,Trevor a.k.a @rawkintrevo,2018-06-18 10:36:37-05:00,['7dff35bc3c61c3e0b95e8e59406742be15203a69'],16,15,31,2865637,1,,,,5697
6990bd5adca7a83308301cec0fa5fb27849d47dc,0,Trevor a.k.a @rawkintrevo,2018-06-18 10:40:22-05:00,['edb29e5f2e7b4acf288cf106b7a58d0b3b80c965'],1,1,2,2865639,1,,,,5697
209d09e12c33b04cc0dd35c267e5be2017ace755,0,Trevor a.k.a @rawkintrevo,2018-06-18 10:42:10-05:00,['6990bd5adca7a83308301cec0fa5fb27849d47dc'],2,2,4,2865643,1,,,,5697
d4def830db4570ca06b65e67decaa7dcfa64f7b8,0,Trevor a.k.a @rawkintrevo,2018-06-18 10:43:18-05:00,['209d09e12c33b04cc0dd35c267e5be2017ace755'],0,0,0,2865643,0,,,,5697
574ccc990673afdd34cb47f2b50f4379c5823212,0,Trevor a.k.a @rawkintrevo,2018-06-18 14:46:11-05:00,['d4def830db4570ca06b65e67decaa7dcfa64f7b8'],0,28,28,2865671,1,,,,5698
eff8b1fd6a5c871331345d40bc1c9061b7ea2a40,0,Trevor a.k.a @rawkintrevo,2018-06-19 10:42:22-05:00,['abcc6456756b45f2ed14ff6c8ffecf893d679cc7'],81,37,118,2865789,4,,,,5698
aa57e2f171ee8836f2645c1cdd087faf2ee1f934,0,Trevor a.k.a @rawkintrevo,2018-06-20 09:23:35-05:00,['eff8b1fd6a5c871331345d40bc1c9061b7ea2a40'],69,85,154,2865943,3,,,,5698
5a1d85f59f3503102298b410a0b81c2acb458a76,0,pferrel,2018-06-26 12:08:00-07:00,['574ccc990673afdd34cb47f2b50f4379c5823212'],3,11,14,2865957,1,,,,5698
0a51eb0f5bf3e70575b8b5527de23d05650d8bdd,0,pferrel,2018-06-26 13:01:23-07:00,['5a1d85f59f3503102298b410a0b81c2acb458a76'],92,86,178,2866135,1,,,,5698
eec16428d2d9ce1158867b8ebf6f68e194058ec0,0,pferrel,2018-06-26 16:53:48-07:00,['0a51eb0f5bf3e70575b8b5527de23d05650d8bdd'],201,259,460,2866595,8,,,,5698
a6db60ddd0a02d1f16bd4b95ac1d243a4d3c7102,0,pferrel,2018-06-26 17:02:44-07:00,['eec16428d2d9ce1158867b8ebf6f68e194058ec0'],14,23,37,2866632,6,,,,5698
62297da7ea5dc72e73e6d2c749ac73664c283c15,0,pferrel,2018-06-26 17:08:31-07:00,['a6db60ddd0a02d1f16bd4b95ac1d243a4d3c7102'],21,1,22,2866654,1,,,,5698
02f75f997bbc01083a345287072e821bfe4f1558,1,Trevor a.k.a @rawkintrevo,2018-06-27 08:13:16-05:00,['aa57e2f171ee8836f2645c1cdd087faf2ee1f934'],271,1753,2024,2868678,134,1,1,1,5705
0908c521a5c35a2cd107404334db7a89accbb523,0,Trevor a.k.a @rawkintrevo,2018-06-27 09:28:21-05:00,['02f75f997bbc01083a345287072e821bfe4f1558'],6,0,6,2868684,1,,,,5705
e0573de33887e9d0909f1a5c34313680916b5aee,1,Trevor a.k.a @rawkintrevo,2018-06-27 09:51:06-05:00,['0908c521a5c35a2cd107404334db7a89accbb523'],78063,1,78064,2946748,639,0.489866891,0.281968262,0.21841148,5705
410ed16af1fc587999868dd4990cebfa7d14633e,1,Trevor a.k.a @rawkintrevo,2018-06-28 09:38:33-05:00,['e0573de33887e9d0909f1a5c34313680916b5aee'],334,373,707,2947455,922,,,,5706
49ad8cb457079301a87b02e71ba1273c62585bed,0,Trevor a.k.a @rawkintrevo,2018-06-29 11:10:13-05:00,['410ed16af1fc587999868dd4990cebfa7d14633e'],27852,8199,36051,2983506,178,0.458731995,0.351067185,0.201661234,5720
7b0b27b903c415e13ad7de7ea379553cddcafa79,0,Jimmy Casey,2018-07-29 21:08:46+00:00,['62297da7ea5dc72e73e6d2c749ac73664c283c15'],1,1,2,2983508,1,,,,5720
545648f6a8f69139757f0328e924c6b16a839441,0,Trevor a.k.a @rawkintrevo,2018-09-08 18:34:43-05:00,['49ad8cb457079301a87b02e71ba1273c62585bed'],0,32350,32350,3015858,154,0.487143224,0.635124711,0.733929031,5874
0bf221ee9f24adfc9054db059be2899ffdbadc0f,0,Trevor a.k.a @rawkintrevo,2018-09-10 13:28:37-05:00,['545648f6a8f69139757f0328e924c6b16a839441'],4,5,9,3015867,1,,,,5874
a29bbd794849e8ad7c179135f199135978c6ad97,0,Trevor a.k.a @rawkintrevo,2018-09-28 11:49:01-05:00,['0bf221ee9f24adfc9054db059be2899ffdbadc0f'],1,1,2,3015869,1,,,,5874
025efffcf1c733bb8fcc83266dcfe56bbfbe961f,0,GitHub,2019-01-11 11:32:23-08:00,"['a29bbd794849e8ad7c179135f199135978c6ad97', '62297da7ea5dc72e73e6d2c749ac73664c283c15']",322,398,720,3016589,12,,,,5874
758cfada62556d679c445416dff9d9fb2a3c4e59,0,GitHub,2019-01-11 11:35:33-08:00,"['62297da7ea5dc72e73e6d2c749ac73664c283c15', '025efffcf1c733bb8fcc83266dcfe56bbfbe961f']",3116,6961,10077,3026666,1700,,,,5874
70f8c9024fedf94ce6902e94dfaad7990f1b2542,0,Andrew Musselman,2019-01-11 11:40:01-08:00,['758cfada62556d679c445416dff9d9fb2a3c4e59'],16,16,32,3026698,1,,,,5874
b4ddcd082589b3a452b5ffc5824e2befd01b4994,0,Andrew Musselman,2019-01-11 11:51:51-08:00,['70f8c9024fedf94ce6902e94dfaad7990f1b2542'],4,4,8,3026706,1,,,,5874
a615067cab51de15d1f8d09a666527792081ad07,0,GitHub,2019-01-11 18:46:57-06:00,['b4ddcd082589b3a452b5ffc5824e2befd01b4994'],0,1,1,3026707,1,,,,5874
264974ddad5f97e6a6f9348982505d6ae5f064c8,0,GitHub,2019-01-12 08:55:45-06:00,['a615067cab51de15d1f8d09a666527792081ad07'],4,9,13,3026720,1,,,,5874
5122dbe38fee2ee6e3ac617c8b447f38fcfca9a0,0,GitHub,2019-01-12 09:04:05-06:00,['264974ddad5f97e6a6f9348982505d6ae5f064c8'],2,2,4,3026724,1,,,,5874
6c1f8a11b4ba45cbd6f3074925e7a4f0d7e07ceb,0,GitHub,2019-01-12 09:09:11-06:00,['5122dbe38fee2ee6e3ac617c8b447f38fcfca9a0'],1,2,3,3026727,1,,,,5874
aa26f695a6ef1923b710ddf8b7c48aafef618796,0,GitHub,2019-01-12 09:09:53-06:00,['6c1f8a11b4ba45cbd6f3074925e7a4f0d7e07ceb'],1,1,2,3026729,1,,,,5874
af6066f4b0fd2e932dd2352ac58da880a053e4d3,0,GitHub,2019-01-12 09:18:11-06:00,['aa26f695a6ef1923b710ddf8b7c48aafef618796'],1,1,2,3026731,1,,,,5874
d5f84c94fbf6a63971b55e0051fcf81d1be3f120,0,Andrew Musselman,2019-01-13 20:44:45-08:00,['b4ddcd082589b3a452b5ffc5824e2befd01b4994'],7,7,14,3026745,7,,,,5874
1e265c982937ee227921335bc6342cafb7dcd512,0,Andrew Musselman,2019-01-13 20:48:27-08:00,['d5f84c94fbf6a63971b55e0051fcf81d1be3f120'],7,7,14,3026759,7,,,,5874
70120d398df0f1f8f1e88972efe37f2cb938c394,0,Andrew Musselman,2019-01-13 20:49:10-08:00,"['1e265c982937ee227921335bc6342cafb7dcd512', 'af6066f4b0fd2e932dd2352ac58da880a053e4d3']",6,13,19,3026778,2,,,,5874
5aed83e35b54bba7cfd012e72b907f82eacbbbaf,0,Andrew Musselman,2019-01-13 20:55:08-08:00,['70120d398df0f1f8f1e88972efe37f2cb938c394'],7,7,14,3026792,7,,,,5874
fdea0d79a8e8c2e96e5a3ceb2011093827961476,0,Andrew Musselman,2019-01-13 20:56:21-08:00,['5aed83e35b54bba7cfd012e72b907f82eacbbbaf'],7,7,14,3026806,7,,,,5874
f537d80609736e0a5f88ec514d289173b29ae8b5,0,Andrew Musselman,2019-01-13 21:04:16-08:00,['fdea0d79a8e8c2e96e5a3ceb2011093827961476'],7,7,14,3026820,7,,,,5874
bb3cb83ca4419d830b69be923d1327d78d17b4e0,0,Andrew Musselman,2019-01-13 21:05:02-08:00,['f537d80609736e0a5f88ec514d289173b29ae8b5'],7,7,14,3026834,7,,,,5874
981147db7ede56d94f38c99a429320cf76ca5bdd,0,Andrew Musselman,2019-01-13 21:08:16-08:00,['bb3cb83ca4419d830b69be923d1327d78d17b4e0'],2,2,4,3026838,1,,,,5874
5d8b94ecbe0e0be50bcf8e8aa1746c447bb3b497,0,Andrew Musselman,2019-01-13 21:13:53-08:00,['981147db7ede56d94f38c99a429320cf76ca5bdd'],7,7,14,3026852,7,,,,5874
e72eb918b75716e4aa5cdfaba594699943a8aaa4,0,Andrew Musselman,2019-01-13 21:16:00-08:00,['5d8b94ecbe0e0be50bcf8e8aa1746c447bb3b497'],7,7,14,3026866,7,,,,5874
0064cde029f1681dd4d81a7ff893a54f24e381d1,0,Andrew Musselman,2019-01-13 21:18:40-08:00,['e72eb918b75716e4aa5cdfaba594699943a8aaa4'],7,7,14,3026880,7,,,,5874
878310443e47816d7e75d3ea424d00480186a584,0,Andrew Musselman,2019-01-13 21:26:44-08:00,['0064cde029f1681dd4d81a7ff893a54f24e381d1'],7,7,14,3026894,7,,,,5874
d885cf02b51507e6fb98045bb63ec81d67814b22,0,Andrew Musselman,2019-01-13 21:27:07-08:00,['878310443e47816d7e75d3ea424d00480186a584'],7,7,14,3026908,7,,,,5874
3543c9dd49931dfc8fbb7347148d765729e418aa,0,Andrew Musselman,2019-01-13 21:33:32-08:00,['d885cf02b51507e6fb98045bb63ec81d67814b22'],7,7,14,3026922,7,,,,5874
be1ec41ae35d2f08b0af5221398755091f34751a,0,Andrew Musselman,2019-01-13 21:33:52-08:00,['3543c9dd49931dfc8fbb7347148d765729e418aa'],7,7,14,3026936,7,,,,5874
02cde581157ab3a21dbc17f1533d362aa2b88db5,0,Andrew Musselman,2019-01-13 21:37:52-08:00,['be1ec41ae35d2f08b0af5221398755091f34751a'],7,7,14,3026950,7,,,,5874
33ee492fd61ed983d07beae0ba17c275e9940b3f,0,Andrew Musselman,2019-01-13 21:44:39-08:00,['02cde581157ab3a21dbc17f1533d362aa2b88db5'],7,7,14,3026964,7,,,,5874
2878b98765a7fcc10d7f2c05bcf10eb9bb6b026f,0,Andrew Musselman,2019-01-13 21:44:59-08:00,['33ee492fd61ed983d07beae0ba17c275e9940b3f'],7,7,14,3026978,7,,,,5874
3d8aa9f084066c12114527e7620586ad21d8945b,0,Andrew Musselman,2019-01-18 10:13:55-08:00,['2878b98765a7fcc10d7f2c05bcf10eb9bb6b026f'],10,10,20,3026998,7,,,,5874
3d54d12b150ffca7e2d5fa50781d4f27140b953d,0,Trevor a.k.a @rawkintrevo,2019-01-18 12:50:18-06:00,['3d8aa9f084066c12114527e7620586ad21d8945b'],1,173,174,3027172,3,,,,5876
a901c2659031461395781ad6767bae859a01f13b,0,GitHub,2019-01-18 12:57:19-06:00,"['3d8aa9f084066c12114527e7620586ad21d8945b', '7b0b27b903c415e13ad7de7ea379553cddcafa79']",1,1,2,3027174,1,,,,5876
a194c35b7b4cc9967dd55f2f004fdc14bc7a7467,0,GitHub,2019-01-18 12:59:00-06:00,"['a901c2659031461395781ad6767bae859a01f13b', '3d54d12b150ffca7e2d5fa50781d4f27140b953d']",1,173,174,3027348,3,,,,5876
58b6cd361c9aa954876f7f1b96180cc63aa27eeb,0,Trevor a.k.a @rawkintrevo,2019-01-18 15:56:38-06:00,['3d54d12b150ffca7e2d5fa50781d4f27140b953d'],22,84,106,3027454,4,,,,5876
eb90d8805ac6a4526b857a8a2a58113b42d3ef53,0,GitHub,2019-01-18 15:57:58-06:00,"['a194c35b7b4cc9967dd55f2f004fdc14bc7a7467', '58b6cd361c9aa954876f7f1b96180cc63aa27eeb']",22,84,106,3027560,4,,,,5876
42bb10c89777daf5e1e8ae443da50c5a54fde98b,0,Andrew Musselman,2019-01-18 15:49:25-08:00,['eb90d8805ac6a4526b857a8a2a58113b42d3ef53'],7,7,14,3027574,7,,,,5876
b7a99b44553faa9147b4813342bb78ba1c5e11d3,0,Andrew Musselman,2019-01-18 16:00:58-08:00,['42bb10c89777daf5e1e8ae443da50c5a54fde98b'],662,0,662,3028236,1,,,,5876
357f674d8db2c8d9fd2824726ded4784206dd3b0,0,Trevor a.k.a @rawkintrevo,2019-02-15 12:49:10-06:00,['b7a99b44553faa9147b4813342bb78ba1c5e11d3'],348,93,441,3028677,1,,,,5876
0e97d216288cb529948d3a95b54985a8993d8530,0,Trevor a.k.a @rawkintrevo,2019-02-22 12:10:33-06:00,['357f674d8db2c8d9fd2824726ded4784206dd3b0'],30,8,38,3028715,4,,,,5876
fdbed4e45b0a97cae5fc5899e1b628ff48202e2f,0,Trevor a.k.a @rawkintrevo,2019-02-22 12:16:36-06:00,['0e97d216288cb529948d3a95b54985a8993d8530'],6,6,12,3028727,6,,,,5876
51e59419ef6db8d4d3a8685375d9ce49bc140ef4,0,Trevor a.k.a @rawkintrevo,2019-02-22 12:16:56-06:00,['fdbed4e45b0a97cae5fc5899e1b628ff48202e2f'],6,6,12,3028739,6,,,,5876
f7fe2c250f1e06c165692734e034a7c048cbb774,0,Trevor a.k.a @rawkintrevo,2019-02-28 13:24:15-06:00,['51e59419ef6db8d4d3a8685375d9ce49bc140ef4'],25,25,50,3028789,1,,,,5876
0db4ff4542a1147edc0c9926b5cb38ee3b717d1f,0,Andrew Musselman,2019-03-01 09:04:59-08:00,['f7fe2c250f1e06c165692734e034a7c048cbb774'],7,7,14,3028803,6,,,,5876
fae32653c70a2ef311f97aabe71be8349324c792,0,Andrew Musselman,2019-03-01 09:05:22-08:00,['0db4ff4542a1147edc0c9926b5cb38ee3b717d1f'],7,7,14,3028817,6,,,,5876
c51f2d8258ec0537c12e915b7220e8c49c67669f,0,Andrew Musselman,2019-03-01 09:45:05-08:00,['fae32653c70a2ef311f97aabe71be8349324c792'],4,4,8,3028825,4,,,,5876
0542e4034f55b113e40ffc3c80d4c05ab6622077,0,Andrew Musselman,2019-03-01 09:46:53-08:00,['c51f2d8258ec0537c12e915b7220e8c49c67669f'],2,2,4,3028829,2,,,,5876
7ccda509fc328f394a744315738e0d0cac4681eb,0,Andrew Musselman,2019-03-01 09:51:43-08:00,['0542e4034f55b113e40ffc3c80d4c05ab6622077'],6,6,12,3028841,6,,,,5876
c6afcf033c340493143031b91dc706ac2e7ea122,0,Andrew Musselman,2019-03-01 09:52:44-08:00,['7ccda509fc328f394a744315738e0d0cac4681eb'],6,6,12,3028853,6,,,,5876
bfa829c146aeef367ac8d45124561307d73a9069,0,Andrew Musselman,2019-03-01 09:58:09-08:00,['c6afcf033c340493143031b91dc706ac2e7ea122'],6,6,12,3028865,6,,,,5876
63c4eda7a481d0f9296e3cdae23ba22d86514a79,0,Andrew Musselman,2019-03-01 09:58:33-08:00,['bfa829c146aeef367ac8d45124561307d73a9069'],6,6,12,3028877,6,,,,5876
a42847b801842748c0da03ed13f7ded0879acef9,0,Andrew Musselman,2019-03-01 14:22:39-08:00,['63c4eda7a481d0f9296e3cdae23ba22d86514a79'],24,13,37,3028914,1,,,,5876
a206853e76fd1f2e10c2112da3bb2e7b1ad2001a,0,GitHub,2019-03-01 14:25:00-08:00,"['63c4eda7a481d0f9296e3cdae23ba22d86514a79', 'a42847b801842748c0da03ed13f7ded0879acef9']",24,13,37,3028951,1,,,,5876
3af776fca6bff7d0075c90cc2bf5560cb5a64b72,0,Andrew Musselman,2019-03-05 20:13:44-08:00,['a206853e76fd1f2e10c2112da3bb2e7b1ad2001a'],1,1,2,3028953,1,,,,5876
ee9c8f2e7539d251eff517a3dfdba7f1c2d3092d,0,Andrew Musselman,2019-03-07 08:26:43-08:00,['3af776fca6bff7d0075c90cc2bf5560cb5a64b72'],2,2,4,3028957,2,,,,5876
48d76dbb8bb3455a7aba5ceceab0a0304bd53cbb,0,Andrew Musselman,2019-03-10 11:17:43-07:00,['ee9c8f2e7539d251eff517a3dfdba7f1c2d3092d'],2,8,10,3028967,1,,,,5876
b0cf1694e60f643e352182ea03744c34e96dbac4,0,Andrew Musselman,2019-03-10 11:30:39-07:00,['48d76dbb8bb3455a7aba5ceceab0a0304bd53cbb'],6,7,13,3028980,1,,,,5876
14864c91f68228e3aa8b038292c27aa3234b1967,0,GitHub,2019-03-25 10:18:38-04:00,['b0cf1694e60f643e352182ea03744c34e96dbac4'],2,2,4,3028984,1,,,,5876
5350e6bc139f92a7eb5d14728a2bfa0b585ac685,0,GitHub,2019-03-25 07:50:56-07:00,"['b0cf1694e60f643e352182ea03744c34e96dbac4', '14864c91f68228e3aa8b038292c27aa3234b1967']",2,2,4,3028988,1,,,,5876
53ae6bd3c2e407c04c23effd7d0442ed78a6bb55,0,Andrew Musselman,2019-04-18 14:14:09-07:00,['5350e6bc139f92a7eb5d14728a2bfa0b585ac685'],15,20,35,3029023,1,,,,5876
9b0ce1f3d74529c7965be52b11688ade497d497e,0,Andrew Musselman,2019-04-18 15:05:35-07:00,['53ae6bd3c2e407c04c23effd7d0442ed78a6bb55'],1,0,1,3029024,1,,,,5876
847d35957e8f99564497fbe8a8a92bb9dd68754c,0,Andrew Musselman,2019-04-18 15:53:49-07:00,['9b0ce1f3d74529c7965be52b11688ade497d497e'],2,2,4,3029028,1,,,,5876
5ca4b6a70b9066c5b9b5b79bb0544bd61f071f67,0,GitHub,2019-04-30 20:34:27-07:00,['847d35957e8f99564497fbe8a8a92bb9dd68754c'],3,8,11,3029039,1,,,,5876
6ef04ceefdeee70e32bb0a8d66bea2f485331cca,0,Andrew Palumbo,2019-05-09 14:35:39-07:00,['5ca4b6a70b9066c5b9b5b79bb0544bd61f071f67'],5,5,10,3029049,4,,,,5876
f52fd5ce0c0bf0fd98501297088b6deebe4c88e8,1,Andrew Palumbo,2019-05-09 14:50:27-07:00,['6ef04ceefdeee70e32bb0a8d66bea2f485331cca'],101,142,243,3029292,26,,,,5876
35d0b1fa535977887598a018ec996a54acb4cda5,0,Andrew Palumbo,2019-05-09 15:12:55-07:00,['5ca4b6a70b9066c5b9b5b79bb0544bd61f071f67'],3,3,6,3029298,2,,,,5876
046b97df55db6564d83898ee2ea0574daedd4dfb,0,Andrew Palumbo,2019-05-09 15:17:24-07:00,['f52fd5ce0c0bf0fd98501297088b6deebe4c88e8'],3,2,5,3029303,2,,,,5876
985dd202da49dc463c0ea021181642a45832ca71,0,Andrew Palumbo,2019-05-09 15:19:36-07:00,"['046b97df55db6564d83898ee2ea0574daedd4dfb', '35d0b1fa535977887598a018ec996a54acb4cda5']",3,3,6,3029309,2,,,,5876
00694e08edbc79a88fe1743acea010c1dde876d8,0,Andrew Palumbo,2019-05-09 15:21:17-07:00,['985dd202da49dc463c0ea021181642a45832ca71'],17,25,42,3029351,2,,,,5876
d507a08ef6479b9503d356be3f4c11421973c1c5,0,Andrew Palumbo,2019-05-09 15:30:03-07:00,['00694e08edbc79a88fe1743acea010c1dde876d8'],12,12,24,3029375,7,,,,5876
fc9d7d8c85e2f25aa9fd9246785bd98199261ec1,0,Andrew Palumbo,2019-05-09 15:30:26-07:00,['d507a08ef6479b9503d356be3f4c11421973c1c5'],12,12,24,3029399,7,,,,5876
e9a54ba104183b94b78ea316768333e5fc14ce18,0,Andrew Palumbo,2019-05-09 15:53:25-07:00,['fc9d7d8c85e2f25aa9fd9246785bd98199261ec1'],15,15,30,3029429,14,,,,5876
2274f7d824747912c58d98879889654b44606bf1,0,Andrew Palumbo,2019-05-09 15:59:11-07:00,['e9a54ba104183b94b78ea316768333e5fc14ce18'],1,1,2,3029431,1,,,,5876
9493b980df6b6bc2454ee3c816705ce552fc9f41,0,Andrew Palumbo,2019-05-09 16:44:28-07:00,['2274f7d824747912c58d98879889654b44606bf1'],11,10,21,3029452,7,,,,5876
7fb14fba8b32a8515c8c287e1e65b6ca71174dd6,0,Andrew Musselman,2019-05-09 17:05:59-07:00,['9493b980df6b6bc2454ee3c816705ce552fc9f41'],26,25,51,3029503,19,,,,5876
e0676091ed9bda0c5539ea76d813c0cacf87c035,0,Andrew Musselman,2019-05-09 17:11:35-07:00,['7fb14fba8b32a8515c8c287e1e65b6ca71174dd6'],3,3,6,3029509,1,,,,5876
8e5d4b42e3440ce7909d739d62d5bf61c49e9181,0,Andrew Musselman,2019-05-09 17:17:31-07:00,['e0676091ed9bda0c5539ea76d813c0cacf87c035'],9,9,18,3029527,7,,,,5876
60c5fd7338a1bb9b90b10dc1725521e4aabda9b1,0,Andrew Musselman,2019-05-09 17:17:52-07:00,['8e5d4b42e3440ce7909d739d62d5bf61c49e9181'],9,9,18,3029545,7,,,,5876
2b452235dcc667dcdeccb7a22b9e9481bc36c84e,0,Andrew Musselman,2019-05-09 17:41:59-07:00,['60c5fd7338a1bb9b90b10dc1725521e4aabda9b1'],7,7,14,3029559,7,,,,5876
290c995078072f598e2600ac56d2d1518f9b0d1f,0,Andrew Palumbo,2019-05-09 18:11:51-07:00,['60c5fd7338a1bb9b90b10dc1725521e4aabda9b1'],5,5,10,3029569,1,,,,5876
708b95ff215e01493b7d7d224df01affd832778b,0,Andrew Musselman,2019-05-09 18:48:41-07:00,"['2b452235dcc667dcdeccb7a22b9e9481bc36c84e', '290c995078072f598e2600ac56d2d1518f9b0d1f']",5,5,10,3029579,1,,,,5876
a3865591ca17711e1482d4dccffe0c795ec9381d,0,Andrew Palumbo,2019-05-09 19:24:53-07:00,['290c995078072f598e2600ac56d2d1518f9b0d1f'],7,7,14,3029593,7,,,,5876
a2de6541e35f7f2caa9e8994f47b060affa393e9,0,Andrew Musselman,2019-05-09 20:21:15-07:00,"['708b95ff215e01493b7d7d224df01affd832778b', 'a3865591ca17711e1482d4dccffe0c795ec9381d']",0,0,0,3029593,0,,,,5876
625b4bef8de18491222a87cdc285d01d9ebb1135,0,Andrew Musselman,2019-05-09 20:45:52-07:00,['a2de6541e35f7f2caa9e8994f47b060affa393e9'],7,23,30,3029623,1,,,,5876
e9d6aa21be72bf56afd556bd6d65655def27d801,0,Andrew Musselman,2019-05-09 21:24:57-07:00,['625b4bef8de18491222a87cdc285d01d9ebb1135'],1,1,2,3029625,1,,,,5876
c9914c394e2180de3f78fb181ffed3abc5c58177,0,Andrew Musselman,2019-05-09 21:37:51-07:00,['e9d6aa21be72bf56afd556bd6d65655def27d801'],2,2,4,3029629,1,,,,5876
de6ad662ff375aa4a0bedc30a662dd6d4c8c800d,0,Andrew Musselman,2019-05-09 21:54:59-07:00,['c9914c394e2180de3f78fb181ffed3abc5c58177'],9,3,12,3029641,1,,,,5876
7c7aca770e1cb612c542b553f94bc7b406176e30,0,Andrew Musselman,2019-05-09 22:06:25-07:00,['de6ad662ff375aa4a0bedc30a662dd6d4c8c800d'],35,17,52,3029693,1,,,,5876
bcb93cf94d04a4e4484d052f4df4d9e28b2a9988,0,Andrew Musselman,2019-05-09 22:25:32-07:00,['7c7aca770e1cb612c542b553f94bc7b406176e30'],18,37,55,3029748,1,,,,5876
550ba50925bfa78b4ca9782099bb2bc39c4352a5,0,Andrew Musselman,2019-05-09 22:46:32-07:00,['bcb93cf94d04a4e4484d052f4df4d9e28b2a9988'],7,7,14,3029762,2,,,,5876
faba9daf18298ab18692c8b915974598efe2e67e,0,Andrew Musselman,2019-05-09 23:12:21-07:00,['550ba50925bfa78b4ca9782099bb2bc39c4352a5'],19,3,22,3029784,3,,,,5876
d84b96486f7c1cfb4e31eeab788719bf82ba5e7c,0,Andrew Palumbo,2019-05-16 17:03:54-07:00,['faba9daf18298ab18692c8b915974598efe2e67e'],5,4,9,3029793,2,,,,5876
395e8c715897b88f183d9364f3e0808c86398f32,0,Andrew Palumbo,2019-05-16 19:54:28-07:00,['d84b96486f7c1cfb4e31eeab788719bf82ba5e7c'],7,29,36,3029829,7,,,,5876
1882239aaad460a5ab71007b136281ee828fd5ee,0,Andrew Palumbo,2019-05-17 15:10:39-07:00,['395e8c715897b88f183d9364f3e0808c86398f32'],17,18,35,3029864,1,,,,5876
54eee3b84d4f21300f359fe298305b23924b7edf,0,Andrew Palumbo,2019-05-17 19:48:04-07:00,['1882239aaad460a5ab71007b136281ee828fd5ee'],10,24,34,3029898,8,,,,5876
045e132f0e4d3bea31652fda61c721d2da212c01,0,Andrew Palumbo,2019-05-17 19:49:24-07:00,['54eee3b84d4f21300f359fe298305b23924b7edf'],6,1,7,3029905,1,,,,5876
fbcdf6a4c5a4df8dd6ab5f8a88d8d76914626f89,0,Andrew Palumbo,2019-05-20 12:51:18-07:00,['045e132f0e4d3bea31652fda61c721d2da212c01'],2,2,4,3029909,1,,,,5876
c4c7a6f29399157dacc616c0cb138696ef022906,0,Andrew Palumbo,2019-05-21 16:09:16-07:00,['fbcdf6a4c5a4df8dd6ab5f8a88d8d76914626f89'],55,4,59,3029968,2,,,,5876
8338ccf1aa91c14d3aa41bb24cc727b824d6ff6e,0,Andrew Palumbo,2019-05-23 15:47:17-07:00,['c4c7a6f29399157dacc616c0cb138696ef022906'],40,46,86,3030054,15,,,,5876
6b02826d5ccbba4c1d1ff45e2f148b7529973d12,0,Andrew Palumbo,2019-05-23 15:50:50-07:00,['8338ccf1aa91c14d3aa41bb24cc727b824d6ff6e'],14,14,28,3030082,14,,,,5876
c7b92eed76c44b2a2bc3555e8229976455c60511,0,Andrew Palumbo,2019-05-23 16:05:01-07:00,['6b02826d5ccbba4c1d1ff45e2f148b7529973d12'],3,21,24,3030106,2,,,,5876
2ea278e8efc21a645138276b66eef65c6d1cca56,0,Andrew Palumbo,2019-05-23 21:51:28-07:00,['c7b92eed76c44b2a2bc3555e8229976455c60511'],6,6,12,3030118,3,,,,5876
a8301c72ae2b60f4a9500ea52283da173a47f5d4,0,Andrew Palumbo,2019-05-30 15:20:59-07:00,['2ea278e8efc21a645138276b66eef65c6d1cca56'],5,8,13,3030131,1,,,,5876
b3e6bf842532c5223a254c42e308348c258b064e,0,Andrew Palumbo,2019-05-30 15:27:59-07:00,['a8301c72ae2b60f4a9500ea52283da173a47f5d4'],5,0,5,3030136,1,,,,5876
4c4a3fa2d0b07ee8c8f67f32c8bd7a289e6b4b9c,0,Andrew Musselman,2019-05-30 15:52:25-07:00,['b3e6bf842532c5223a254c42e308348c258b064e'],1,1,2,3030138,1,,,,5876
587c713dcc244a7a6c2582f02929636178aed4a0,0,Andrew Palumbo,2019-05-30 16:37:42-07:00,['b3e6bf842532c5223a254c42e308348c258b064e'],2,2,4,3030142,2,,,,5876
369c430696fc8f1f493990ed3d9a0870b7b5a7f8,0,Andrew Palumbo,2019-05-30 16:41:21-07:00,"['587c713dcc244a7a6c2582f02929636178aed4a0', '4c4a3fa2d0b07ee8c8f67f32c8bd7a289e6b4b9c']",1,1,2,3030144,1,,,,5876
2a374a6b41e241627d3c2e247da7ee251df62805,0,Andrew Palumbo,2019-05-30 17:02:14-07:00,['369c430696fc8f1f493990ed3d9a0870b7b5a7f8'],1,1,2,3030146,1,,,,5876
d8f96273f70d3f5c23df9437fdcc8d078bdaf168,0,Andrew Palumbo,2019-05-30 20:24:37-07:00,['2a374a6b41e241627d3c2e247da7ee251df62805'],0,156,156,3030302,2,,,,5878
db22e978e39c0a7dc0e5111971bd5159ac9f7aa3,0,Andrew Palumbo,2019-06-01 18:04:48-07:00,['d8f96273f70d3f5c23df9437fdcc8d078bdaf168'],29,67,96,3030398,9,,,,5878
01b7be917efe4a689fefe97ef187bb997c49f2ce,0,Andrew Palumbo,2019-06-01 20:21:15-07:00,['db22e978e39c0a7dc0e5111971bd5159ac9f7aa3'],10,8,18,3030416,1,,,,5878
3a06eef433c1f522099720503a1ffd0a9b2f6ac7,0,Andrew Palumbo,2019-06-01 21:13:59-07:00,['01b7be917efe4a689fefe97ef187bb997c49f2ce'],9,6,15,3030431,4,,,,5878
8ae70946109a014df05351f41fd2989fd90ad278,0,Andrew Palumbo,2019-06-03 20:42:05-07:00,['3a06eef433c1f522099720503a1ffd0a9b2f6ac7'],12,1337,1349,3031780,14,,,,5887
c1066bad1a7e62c1c9f17cffb71f42669ea2c5b1,0,Andrew Palumbo,2019-06-07 18:30:15-07:00,['8ae70946109a014df05351f41fd2989fd90ad278'],33,44,77,3031857,4,,,,5887
38d69005acbbba0cb62124d268d4ea53ec7a0b7b,0,Andrew Palumbo,2019-06-07 18:34:14-07:00,['c1066bad1a7e62c1c9f17cffb71f42669ea2c5b1'],8,10,18,3031875,1,,,,5887
687ac4b0a676783bfec06a9ab013e29bd23353c0,0,Andrew Palumbo,2019-06-07 18:51:47-07:00,['38d69005acbbba0cb62124d268d4ea53ec7a0b7b'],77,25,102,3031977,9,,,,5887
1a5cbff0d9ae521eac61d7e409abc31473a4714b,0,Andrew Palumbo,2019-06-07 19:01:53-07:00,['687ac4b0a676783bfec06a9ab013e29bd23353c0'],2,2,4,3031981,2,,,,5887
3b9bc03faca7fec8635598aa0d4765bdefc4ebcd,0,Andrew Palumbo,2019-06-07 23:57:26-07:00,['1a5cbff0d9ae521eac61d7e409abc31473a4714b'],49,67,116,3032097,8,,,,5887
0dd9c755b271e0c4164589c2314b395bbf5cb4c5,0,Andrew Palumbo,2019-06-08 01:06:16-07:00,['3b9bc03faca7fec8635598aa0d4765bdefc4ebcd'],1,23,24,3032121,1,,,,5887
a406fc716d06e3635f44231c1679ac8b4bf7ebe4,0,Andrew Palumbo,2019-06-08 10:18:25-07:00,['0dd9c755b271e0c4164589c2314b395bbf5cb4c5'],72,52,124,3032245,3,,,,5887
fa1a0e6ea7634e9241387e8ecce576fbcf30a975,0,Andrew Palumbo,2019-06-08 10:22:19-07:00,['a406fc716d06e3635f44231c1679ac8b4bf7ebe4'],63,1,64,3032309,4,,,,5887
7b5726efe0799ea88488fea235c34e3bd5951cc8,0,Andrew Palumbo,2019-06-08 10:28:33-07:00,['fa1a0e6ea7634e9241387e8ecce576fbcf30a975'],0,6,6,3032315,1,,,,5887
d93fa8a09f1481b361b2382f64ea81237cdc33ac,0,Andrew Palumbo,2019-06-08 10:57:59-07:00,['7b5726efe0799ea88488fea235c34e3bd5951cc8'],63,61,124,3032439,7,,,,5887
a3ea1cabc4deefb564160b9c91a535d9ee7b65e2,0,Andrew Palumbo,2019-06-08 11:05:19-07:00,['d93fa8a09f1481b361b2382f64ea81237cdc33ac'],4,4,8,3032447,1,,,,5887
839ba1a4e9ff7ec49673b8a0de6cd52d2d44e1ac,0,Andrew Palumbo,2019-06-08 11:18:26-07:00,['a3ea1cabc4deefb564160b9c91a535d9ee7b65e2'],6,8,14,3032461,2,,,,5887
f80db6309fd7b891aeeeaf8210ac0ad88f44f35d,0,Andrew Palumbo,2019-06-08 11:23:32-07:00,['839ba1a4e9ff7ec49673b8a0de6cd52d2d44e1ac'],3,3,6,3032467,1,,,,5887
80b18835e9e1b0348f494199d07df06d1bceca9b,0,Andrew Palumbo,2019-06-08 13:09:20-07:00,['f80db6309fd7b891aeeeaf8210ac0ad88f44f35d'],17,148,165,3032632,11,,,,5888
f6c75a810e54084f7e5367267cc4514a77c526aa,0,Andrew Palumbo,2019-06-08 13:14:56-07:00,['80b18835e9e1b0348f494199d07df06d1bceca9b'],4,0,4,3032636,2,,,,5888
f708a56044a119636c9f52dba77ae5f7cf010d7a,0,Andrew Palumbo,2019-06-08 19:56:07-07:00,['f6c75a810e54084f7e5367267cc4514a77c526aa'],20,141,161,3032797,7,,,,5888
9829ccf5e7fac5689c69c8d2c12e143186977281,0,Andrew Palumbo,2019-06-08 21:17:54-07:00,['f708a56044a119636c9f52dba77ae5f7cf010d7a'],64,25,89,3032886,5,,,,5888
33fa57a52d0441db47cae78fcbbc61ac53e8469f,0,Andrew Palumbo,2019-06-08 21:31:06-07:00,['9829ccf5e7fac5689c69c8d2c12e143186977281'],2,2,4,3032890,1,,,,5888
0a038d5a8765fdbdbc1c0f8389941cee9bcdab38,0,Andrew Palumbo,2019-06-08 21:39:03-07:00,['33fa57a52d0441db47cae78fcbbc61ac53e8469f'],168,219,387,3033277,3,,,,5889
c564ad6cb04d477a9c52cd89b5d2bb4dff0779a5,0,Andrew Palumbo,2019-06-08 22:39:17-07:00,['0a038d5a8765fdbdbc1c0f8389941cee9bcdab38'],4,6,10,3033287,2,,,,5889
0adc9e783f365cd8eea5366186d45ca8f3d2b61e,0,Andrew Palumbo,2019-06-08 22:50:46-07:00,['c564ad6cb04d477a9c52cd89b5d2bb4dff0779a5'],9,9,18,3033305,9,,,,5889
647ce0712d9cef15311b7469a629571b3f69e8ef,1,Andrew Palumbo,2019-06-08 23:14:13-07:00,['0adc9e783f365cd8eea5366186d45ca8f3d2b61e'],1242,158,1400,3034705,22,,,,5889
11ee0f280ad882a0907c0b6aee6f4d5e944ee5cf,0,Andrew Palumbo,2019-06-08 23:29:07-07:00,['647ce0712d9cef15311b7469a629571b3f69e8ef'],1,1,2,3034707,1,,,,5889
070e7ed17a9006e56704dae51ca0c4ccb6298ab5,0,Andrew Palumbo,2019-06-08 23:31:35-07:00,['11ee0f280ad882a0907c0b6aee6f4d5e944ee5cf'],3,3,6,3034713,3,,,,5889
5dd5313fd8cd28698a9211a8079d6360cc583a2e,0,Andrew Palumbo,2019-06-08 23:35:56-07:00,['070e7ed17a9006e56704dae51ca0c4ccb6298ab5'],8,0,8,3034721,1,,,,5889
5ce3f9fdc494741fb7a32c28af0e9d98e2b3e8c8,0,Andrew Palumbo,2019-06-09 13:37:36-07:00,['5dd5313fd8cd28698a9211a8079d6360cc583a2e'],2,2,4,3034725,1,,,,5889
ac87bdc8456f0a67fc808b76d78bdb2df865e468,0,Andrew Palumbo,2019-06-09 13:43:27-07:00,['5ce3f9fdc494741fb7a32c28af0e9d98e2b3e8c8'],2,2,4,3034729,1,,,,5889
3559fc5ab69bef85534a27e2c7fbf278106272ca,0,Andrew Palumbo,2019-06-19 17:23:28-07:00,['ac87bdc8456f0a67fc808b76d78bdb2df865e468'],54,153,207,3034936,3,,,,5889
0ed68978d45bc7659bb8f962b76773f71042934e,0,Andrew Palumbo,2019-06-19 17:26:46-07:00,['3559fc5ab69bef85534a27e2c7fbf278106272ca'],15,14,29,3034965,1,,,,5889
a66568c584a41705dd10d7bc00714a8e45138a5b,0,Andrew Palumbo,2019-06-19 17:31:50-07:00,['0ed68978d45bc7659bb8f962b76773f71042934e'],4,0,4,3034969,2,,,,5889
0abfb934ce3c33b6db7558919bb8f2575cebe5c2,0,Andrew Palumbo,2019-06-19 23:36:13-07:00,['a66568c584a41705dd10d7bc00714a8e45138a5b'],176,141,317,3035286,3,,,,5889
af0411cd96552b5bfcf8d1d1f52d170ca9007286,0,Andrew Palumbo,2019-06-20 01:24:51-07:00,['0abfb934ce3c33b6db7558919bb8f2575cebe5c2'],38,36,74,3035360,10,,,,5889
b268bde8a3f693ac94b5f3857c28b3197194a476,0,Andrew Palumbo,2019-06-20 01:34:52-07:00,['af0411cd96552b5bfcf8d1d1f52d170ca9007286'],47,47,94,3035454,1,,,,5889
8260e755012c30518ee541bf9c812522c4ae4dac,0,Andrew Palumbo,2019-06-20 03:18:51-07:00,['b268bde8a3f693ac94b5f3857c28b3197194a476'],26,48,74,3035528,6,,,,5889
b77c7562972f2b3fbf59f9dfb9a361db5f115db8,1,Andrew Palumbo,2019-06-20 07:22:06-07:00,['8260e755012c30518ee541bf9c812522c4ae4dac'],136,213,349,3035877,9,,,,5890
c67a6c82d68b45d41e7a9eb937579ce9abe9f8e1,0,Andrew Palumbo,2019-06-20 14:21:40-07:00,['b77c7562972f2b3fbf59f9dfb9a361db5f115db8'],7,17,24,3035901,2,,,,5890
421ca7ba7fb3404ff95d6341879d4e647f2bd593,0,Andrew Palumbo,2019-06-20 14:27:11-07:00,['c67a6c82d68b45d41e7a9eb937579ce9abe9f8e1'],163,0,163,3036064,2,,,,5890
a68e397b467f5be41c11f978eba4d3a1f39e5c0e,0,Andrew Palumbo,2019-07-07 14:52:19-07:00,['421ca7ba7fb3404ff95d6341879d4e647f2bd593'],3,19,22,3036086,2,,,,5890
0927858edcc15b011fcbf08ec6208ee28ffb06c9,0,Andrew Palumbo,2019-07-07 23:54:12-07:00,['a68e397b467f5be41c11f978eba4d3a1f39e5c0e'],10,13,23,3036109,1,,,,5890
80e13d63ff596e8b53d525648986ae8340f7c8fa,0,Andrew Palumbo,2019-08-27 01:56:58-07:00,['0927858edcc15b011fcbf08ec6208ee28ffb06c9'],3,170,173,3036282,5,,,,5892
4d074ee67bcbfc9dc9195387afd78da29e8afa16,0,Andrew Palumbo,2019-08-27 02:17:02-07:00,['80e13d63ff596e8b53d525648986ae8340f7c8fa'],0,167,167,3036449,2,,,,5894
f91e320520c59b3764c18b4358a9e4ce17b0ebea,0,Andrew Palumbo,2019-08-27 02:52:59-07:00,['4d074ee67bcbfc9dc9195387afd78da29e8afa16'],0,1,1,3036450,1,,,,5894
10a8294f2c39dd90da4d870d94230b9fc90ce034,0,Andrew Palumbo,2019-08-27 03:09:11-07:00,['f91e320520c59b3764c18b4358a9e4ce17b0ebea'],3,4,7,3036457,1,,,,5894
cca3a47351b70a0fcbafc37eff3fb49fec8341df,0,Andrew Palumbo,2019-09-19 12:31:41-07:00,['10a8294f2c39dd90da4d870d94230b9fc90ce034'],26,26,52,3036509,18,,,,5894
adc42ab684c97df21d3b1f8a525a49937a92609c,0,Andrew Palumbo,2019-09-20 05:38:59-07:00,['cca3a47351b70a0fcbafc37eff3fb49fec8341df'],2,2,4,3036513,1,,,,5894
c53871e0f24eacf8395b9e9f4381727435582966,0,Andrew Palumbo,2019-09-22 01:07:49-07:00,['adc42ab684c97df21d3b1f8a525a49937a92609c'],3,6,9,3036522,1,,,,5894
b002713c69613e5331a1b2fd9bce4be57a58d6e1,0,Andrew Palumbo,2019-09-22 01:31:04-07:00,['c53871e0f24eacf8395b9e9f4381727435582966'],2,4,6,3036528,2,,,,5895
fbe3b28c4223ceeee248eb27f9aecde6b18a774f,0,Andrew Palumbo,2019-09-22 01:59:51-07:00,['b002713c69613e5331a1b2fd9bce4be57a58d6e1'],10,19,29,3036557,1,,,,5895
f5e999dc6cc8f94d0a50d6516e8e04f61ddb1381,0,Andrew Palumbo,2019-09-22 02:09:05-07:00,['fbe3b28c4223ceeee248eb27f9aecde6b18a774f'],0,11,11,3036568,1,,,,5895
df3d13154be6181266e3aa004e4ea50122998f23,0,Andrew Palumbo,2019-09-22 02:48:05-07:00,['f5e999dc6cc8f94d0a50d6516e8e04f61ddb1381'],33,26,59,3036627,8,,,,5895
259ed9ad4a7188b5eb6256c81e47b8df08ee29c9,0,Andrew Palumbo,2019-09-22 03:11:09-07:00,['df3d13154be6181266e3aa004e4ea50122998f23'],6,12,18,3036645,2,,,,5895
4ba7c839d579a708a4400cbaa7c4d2e61167668e,0,Andrew Palumbo,2019-09-22 03:15:46-07:00,['259ed9ad4a7188b5eb6256c81e47b8df08ee29c9'],5,9,14,3036659,5,,,,5895
b2439ae3242e256805ea361db9a4f9d5cb6e18bd,0,Andrew Palumbo,2019-09-22 21:54:45-07:00,['4ba7c839d579a708a4400cbaa7c4d2e61167668e'],2,2,4,3036663,2,,,,5895
f0b33a909fb4ea9e7353b5e54bbbfa573d0f73f4,0,Andrew Palumbo,2019-09-22 22:19:29-07:00,['b2439ae3242e256805ea361db9a4f9d5cb6e18bd'],5,9,14,3036677,2,,,,5895
84bf82069c3146c03f3acd833949b92a97bf04d2,0,Andrew Palumbo,2019-09-22 22:21:03-07:00,['f0b33a909fb4ea9e7353b5e54bbbfa573d0f73f4'],0,0,0,3036677,0,,,,5895
ab4e686e99a6738a45407a60e3beef0da7291e5e,0,Andrew Palumbo,2019-09-22 22:21:21-07:00,['84bf82069c3146c03f3acd833949b92a97bf04d2'],0,0,0,3036677,0,,,,5895
3bb049be556e8b95f02784d39e54d92ef70ee6ec,0,Andrew Palumbo,2019-09-22 22:25:58-07:00,['ab4e686e99a6738a45407a60e3beef0da7291e5e'],8,8,16,3036693,8,,,,5895
455851dddad9d48e0ce2ee8d40be2f1c57a64613,0,Andrew Palumbo,2019-09-22 22:29:49-07:00,['3bb049be556e8b95f02784d39e54d92ef70ee6ec'],11,11,22,3036715,8,,,,5895
92ab261f48b18d79c9695c0b802b46143e971042,0,Andrew Palumbo,2019-09-22 23:20:28-07:00,['455851dddad9d48e0ce2ee8d40be2f1c57a64613'],10,3,13,3036728,1,,,,5895
213736b0c116ca3ebe50c84f879d6a457cb760f5,0,Andrew Palumbo,2019-09-22 23:39:25-07:00,['92ab261f48b18d79c9695c0b802b46143e971042'],14,15,29,3036757,2,,,,5895
e1454376a8c6649ab85e54db0a1617c08fe78598,0,Andrew Palumbo,2019-09-23 06:26:16-07:00,['213736b0c116ca3ebe50c84f879d6a457cb760f5'],14,20,34,3036791,1,,,,5895
875e05829fe7593d0af43dd41a5086a365a7de43,0,Andrew Palumbo,2019-09-23 15:15:26-07:00,['e1454376a8c6649ab85e54db0a1617c08fe78598'],1,6,7,3036798,2,,,,5895
24370fd887c0062f10ddf6063ad24d2a24a431aa,0,Trevor a.k.a @rawkintrevo,2019-09-27 12:17:36-05:00,['875e05829fe7593d0af43dd41a5086a365a7de43'],12,16,28,3036826,7,,,,5895
a1fad8b0b436a9b060c97b804d2f8b1499361cb2,0,Trevor a.k.a @rawkintrevo,2019-09-27 12:33:58-05:00,['24370fd887c0062f10ddf6063ad24d2a24a431aa'],16,16,32,3036858,7,,,,5895
8e48983a66571ab6ac331c1cb2043df58ed1213b,0,Andrew Palumbo,2019-10-17 01:33:03-07:00,['a1fad8b0b436a9b060c97b804d2f8b1499361cb2'],1,2,3,3036861,1,,,,5895
e0015b85026ba96d8cb7f787ae196c4584ce1639,0,GitHub,2019-10-17 01:44:52-07:00,['a1fad8b0b436a9b060c97b804d2f8b1499361cb2'],1,2,3,3036864,1,,,,5895
57c1e601257ca9aa843769eaf709248c1ce8b5ae,0,Andrew Palumbo,2019-10-17 02:04:02-07:00,['8e48983a66571ab6ac331c1cb2043df58ed1213b'],8,10,18,3036882,3,,,,5895
c9f1245eca595ad3e3991adbbca8e5b3c0a78496,0,GitHub,2019-10-17 02:08:59-07:00,['e0015b85026ba96d8cb7f787ae196c4584ce1639'],8,10,18,3036900,3,,,,5895
a96c4bbfdd249571e3e80077c69884e1219700b6,0,Andrew Palumbo,2019-10-17 03:16:24-07:00,['57c1e601257ca9aa843769eaf709248c1ce8b5ae'],202,13,215,3037115,2,,,,5895
56b0e1138b14f78be90745bfb89ab4125fbbe39d,0,Andrew Palumbo,2019-10-17 04:17:53-07:00,['a96c4bbfdd249571e3e80077c69884e1219700b6'],12,12,24,3037139,7,,,,5895
6aa947ff44cf79408997d953f0a6bb32ba2e0aa7,0,GitHub,2019-10-17 04:24:02-07:00,"['56b0e1138b14f78be90745bfb89ab4125fbbe39d', 'c9f1245eca595ad3e3991adbbca8e5b3c0a78496']",0,0,0,3037139,0,,,,5895
b041fb3156ae954352611738a14dca7ecec10905,0,GitHub,2019-10-17 04:24:20-07:00,['c9f1245eca595ad3e3991adbbca8e5b3c0a78496'],214,25,239,3037378,8,,,,5895
cb74cf6da4a722100923a93aeae8a05f6c4181b4,0,Andrew Palumbo,2019-10-17 04:39:05-07:00,['56b0e1138b14f78be90745bfb89ab4125fbbe39d'],12,12,24,3037402,7,,,,5895
7cac67317d97a4938a024ae4fd421a9297a28818,0,Andrew Palumbo,2019-10-17 04:46:10-07:00,['cb74cf6da4a722100923a93aeae8a05f6c4181b4'],1,1,2,3037404,1,,,,5895
54fc1b43421ceb6b70617f44cea73c55c840bc68,0,Andrew Palumbo,2019-10-17 04:48:25-07:00,"['7cac67317d97a4938a024ae4fd421a9297a28818', '6aa947ff44cf79408997d953f0a6bb32ba2e0aa7']",0,0,0,3037404,0,,,,5895
0ac7d9b5ff14e60280e7b01d08aec190587a4a02,0,Andrew Palumbo,2019-10-17 04:48:50-07:00,['54fc1b43421ceb6b70617f44cea73c55c840bc68'],17,17,34,3037438,7,,,,5895
a7fc999546901ae815fe3604fec46749b045d717,0,Andrew Palumbo,2019-10-17 06:12:55-07:00,['0ac7d9b5ff14e60280e7b01d08aec190587a4a02'],0,170,170,3037608,2,,,,5897
82b95dcd044df983e04e515f5db64be0fceec199,0,Andrew Palumbo,2019-10-17 06:50:42-07:00,['a7fc999546901ae815fe3604fec46749b045d717'],2,452,454,3038062,4,,,,5898
5caae55f3ca0a34c37c037fc44aaa3fda9f307b4,0,Andrew Palumbo,2019-10-17 06:52:38-07:00,['82b95dcd044df983e04e515f5db64be0fceec199'],12,12,24,3038086,7,,,,5898
52f527f4f297eab25a6d8d0d4d1d5c80a0c17982,0,Andrew Palumbo,2019-10-17 07:06:30-07:00,['5caae55f3ca0a34c37c037fc44aaa3fda9f307b4'],39,39,78,3038164,1,,,,5898
bf40aafadc2622b848d864aabbd7c385163301c4,1,Andrew Palumbo,2019-10-17 07:42:33-07:00,['52f527f4f297eab25a6d8d0d4d1d5c80a0c17982'],35,41,76,3038240,3,,,,5898
ff2c23da1ca6b4d5cfde64d64ea9eb2105a72f9a,0,Andrew Palumbo,2019-10-17 08:32:34-07:00,['bf40aafadc2622b848d864aabbd7c385163301c4'],24,28,52,3038292,2,,,,5898
3073fa7c0ff2e6d947a41deccb37cc0bfd60b2ed,0,Andrew Palumbo,2019-10-17 09:04:12-07:00,['ff2c23da1ca6b4d5cfde64d64ea9eb2105a72f9a'],0,1,1,3038293,1,,,,5898
3009d6500fd98d4e05f72cb027818c25f41253ca,0,GitHub,2019-10-17 09:11:49-07:00,['b041fb3156ae954352611738a14dca7ecec10905'],53,693,746,3039039,9,,,,5901
15a476fe39dcae713fe4d04d719e73a88324bb8e,0,Andrew Palumbo,2019-10-17 09:21:32-07:00,['3073fa7c0ff2e6d947a41deccb37cc0bfd60b2ed'],13,13,26,3039065,7,,,,5901
6e990183c4517d0b0c561f4b8829f809b4152a1a,0,Andrew Palumbo,2019-10-17 09:49:00-07:00,['15a476fe39dcae713fe4d04d719e73a88324bb8e'],1,1,2,3039067,1,,,,5901
f181080e4141fe91b14d82b7532519f333488752,0,Andrew Palumbo,2019-10-17 09:49:40-07:00,['6e990183c4517d0b0c561f4b8829f809b4152a1a'],12,12,24,3039091,7,,,,5901
22eead7f32376b79336b469a261b7a8a1c94786d,1,Andrew Palumbo,2019-10-18 00:42:19-07:00,['f181080e4141fe91b14d82b7532519f333488752'],30,29,59,3039150,14,,,,5901
e81eae95ac3dee3f11900ba842b7f17a31522c76,0,Andrew Palumbo,2019-10-18 00:50:23-07:00,['22eead7f32376b79336b469a261b7a8a1c94786d'],4,13,17,3039167,1,,,,5901
97aa2420ad636be75d9dc2bf85b45401f8df5516,0,Andrew Palumbo,2019-10-18 00:53:48-07:00,['e81eae95ac3dee3f11900ba842b7f17a31522c76'],23,15,38,3039205,7,,,,5901
53fe38bc1142b26ce947fd7351a2e183746f7b60,0,GitHub,2019-10-18 01:00:33-07:00,['3009d6500fd98d4e05f72cb027818c25f41253ca'],40,270,310,3039515,14,,,,5901
879defb9f9505953faf2a7fa693d2923cb3c4c3d,0,Andrew Palumbo,2019-10-18 01:34:14-07:00,"['97aa2420ad636be75d9dc2bf85b45401f8df5516', '53fe38bc1142b26ce947fd7351a2e183746f7b60']",0,0,0,3039515,0,,,,5901
26c4f1b918288f95a0d2102002a697c20c97dc77,0,Andrew Palumbo,2019-10-18 01:43:27-07:00,['879defb9f9505953faf2a7fa693d2923cb3c4c3d'],13,13,26,3039541,7,,,,5901
acaf3675fd77703204baec8044836fd27712080e,0,Andrew Palumbo,2019-10-18 01:43:52-07:00,['26c4f1b918288f95a0d2102002a697c20c97dc77'],12,12,24,3039565,7,,,,5901
0d570328c4cfe05c8544648b08c4c824ac6aafd1,0,Andrew Palumbo,2019-10-18 02:40:01-07:00,['acaf3675fd77703204baec8044836fd27712080e'],22,34,56,3039621,10,,,,5901
dc2e4eb3c0eab69a63127237b77f0f9c919f50fe,0,Andrew Palumbo,2019-10-18 02:51:45-07:00,['0d570328c4cfe05c8544648b08c4c824ac6aafd1'],8,8,16,3039637,5,,,,5901
82cb521eccb93bbcc201d925ea0d804c7349ee74,0,Andrew Palumbo,2019-10-18 02:57:47-07:00,['dc2e4eb3c0eab69a63127237b77f0f9c919f50fe'],8,8,16,3039653,5,,,,5901
575939307d69921c59f9f26c14a335b3c8fca033,0,Andrew Palumbo,2019-10-18 04:36:37-07:00,['82cb521eccb93bbcc201d925ea0d804c7349ee74'],5,6,11,3039664,6,,,,5901
f6bfc4740c0f43c4c0e35a28888299aed0b29fc7,0,Andrew Palumbo,2019-10-18 04:57:02-07:00,['575939307d69921c59f9f26c14a335b3c8fca033'],0,45,45,3039709,2,,,,5901
5aaa6be5a3f209977d854705ae0405b9d83381e7,0,Andrew Palumbo,2019-10-18 04:59:23-07:00,['f6bfc4740c0f43c4c0e35a28888299aed0b29fc7'],1,1,2,3039711,1,,,,5901
c26286270c8a1d68862f320493bb048241fda781,0,Andrew Palumbo,2019-10-18 05:02:03-07:00,['5aaa6be5a3f209977d854705ae0405b9d83381e7'],6,8,14,3039725,1,,,,5901
28c3ce0b2f1787a25a46fc9ad9734cbc6cd42d87,0,Andrew Palumbo,2019-10-28 14:55:23-07:00,['c26286270c8a1d68862f320493bb048241fda781'],63,86,149,3039874,7,,,,5901
e375e5d9023f2392e6f3581c6d7e89978d237af9,0,Andrew Palumbo,2019-10-28 15:14:41-07:00,['28c3ce0b2f1787a25a46fc9ad9734cbc6cd42d87'],12,12,24,3039898,5,,,,5901
4c034d0f8613d2d273645a999290f40dd2622845,0,Andrew Palumbo,2019-10-28 15:15:05-07:00,['e375e5d9023f2392e6f3581c6d7e89978d237af9'],12,12,24,3039922,5,,,,5901
9b3a056f93f424bedbb4e725a8c7fb4900bd0332,0,Andrew Palumbo,2019-10-28 15:28:11-07:00,['4c034d0f8613d2d273645a999290f40dd2622845'],5,5,10,3039932,5,,,,5901
6366f61be8f38560902f97f1c413cdc95f3c4013,0,Andrew Palumbo,2019-10-28 23:11:35-07:00,['9b3a056f93f424bedbb4e725a8c7fb4900bd0332'],12,10,22,3039954,3,,,,5901
3b992bd76ccd2282be70885c2398543635f3f71b,0,Andrew Palumbo,2019-10-28 23:35:24-07:00,['6366f61be8f38560902f97f1c413cdc95f3c4013'],5,49,54,3040008,4,,,,5901
d91d623ee03cb353197f48f1acbabc210bf300cc,0,Andrew Palumbo,2019-10-30 00:35:39-07:00,['3b992bd76ccd2282be70885c2398543635f3f71b'],63,132,195,3040203,5,,,,5902
88fbbaa2d19376578bed665748a20161f48e77d7,0,Andrew Palumbo,2019-10-30 02:10:44-07:00,['d91d623ee03cb353197f48f1acbabc210bf300cc'],27,34,61,3040264,3,,,,5902
5ccfa8bc1b0dea0064204196e5522c8538d95507,0,Andrew Palumbo,2019-10-30 02:13:38-07:00,['88fbbaa2d19376578bed665748a20161f48e77d7'],18,3,21,3040285,1,,,,5902
91a8865b34599d31a71d83e17672aa71ca726486,0,Andrew Palumbo,2019-10-30 02:33:49-07:00,['5ccfa8bc1b0dea0064204196e5522c8538d95507'],18,43,61,3040346,6,,,,5902
429d0192dabd55cffeda59c70a7afe111f37a81b,0,Andrew Palumbo,2019-10-30 03:10:46-07:00,['91a8865b34599d31a71d83e17672aa71ca726486'],256,40,296,3040642,3,,,,5902
a4a8325fc84937612509125704c0e912625d1c75,0,Andrew Palumbo,2019-10-30 03:34:53-07:00,['429d0192dabd55cffeda59c70a7afe111f37a81b'],2,2,4,3040646,1,,,,5902
1a200e6193d0108d5f5fc503581b501897f8aeef,0,Andrew Palumbo,2019-10-30 03:50:17-07:00,['a4a8325fc84937612509125704c0e912625d1c75'],63,17,80,3040726,7,,,,5902
a468d8effd709a70198ba5567418e05b9d71111c,0,Andrew Palumbo,2019-11-02 00:36:50-07:00,['1a200e6193d0108d5f5fc503581b501897f8aeef'],23,29,52,3040778,9,,,,5902
941d7b41f13482cf07ce6a908f2dfa6dacaf0ff3,0,Andrew Palumbo,2019-11-02 00:58:16-07:00,['a468d8effd709a70198ba5567418e05b9d71111c'],4,7,11,3040789,3,,,,5902
378b2a0ad71337b8983afb47e6a4157906bb345b,0,Andrew Palumbo,2019-11-02 01:08:47-07:00,['941d7b41f13482cf07ce6a908f2dfa6dacaf0ff3'],5,8,13,3040802,2,,,,5902
cb485311b9bb67bce79ae48dc21ba2767ffa320e,0,Andrew Palumbo,2019-11-02 01:17:19-07:00,['378b2a0ad71337b8983afb47e6a4157906bb345b'],3,3,6,3040808,1,,,,5902
9d070afbd7ebd95132012d088cc905cf6579a223,0,Andrew Palumbo,2019-11-02 01:18:40-07:00,['cb485311b9bb67bce79ae48dc21ba2767ffa320e'],2,2,4,3040812,1,,,,5902
4d88d5e4866bbfcec558c33cb59e538c55acc433,0,Andrew Palumbo,2019-11-02 01:19:20-07:00,['9d070afbd7ebd95132012d088cc905cf6579a223'],3,3,6,3040818,1,,,,5902
359b8524c4df4c7ec8038524cc7267dac35a0037,0,Andrew Palumbo,2019-11-02 01:37:28-07:00,['4d88d5e4866bbfcec558c33cb59e538c55acc433'],14,14,28,3040846,8,,,,5902
c0f685af740d4db853578c9fa6f5a2d18c9a0b37,0,Andrew Palumbo,2019-11-02 01:37:54-07:00,['359b8524c4df4c7ec8038524cc7267dac35a0037'],14,14,28,3040874,8,,,,5902
936c4af656f5f2ad4539ef67b84ac43a0809366e,0,Andrew Palumbo,2019-11-02 02:10:57-07:00,['c0f685af740d4db853578c9fa6f5a2d18c9a0b37'],14,14,28,3040902,8,,,,5902
1dd6d33e9641b6bc05ca909c2609ba04e7eda003,0,Andrew Palumbo,2019-11-02 02:30:51-07:00,['936c4af656f5f2ad4539ef67b84ac43a0809366e'],14,14,28,3040930,8,,,,5902
66023490e8499dd25a107dcdfcf80f6cd39d8686,0,Andrew Palumbo,2019-11-02 02:31:15-07:00,['1dd6d33e9641b6bc05ca909c2609ba04e7eda003'],14,14,28,3040958,8,,,,5902
50f2a284205e2bc3670e6fc1bd76a2e9a4aa80b0,0,Andrew Palumbo,2019-11-02 03:13:11-07:00,['66023490e8499dd25a107dcdfcf80f6cd39d8686'],13,13,26,3040984,8,,,,5902
25ae289e53332681104126128f75701317555c23,0,Andrew Palumbo,2019-11-02 03:20:06-07:00,['50f2a284205e2bc3670e6fc1bd76a2e9a4aa80b0'],3,22,25,3041009,4,,,,5902
299b50bc89d998724f7918340a78331cfdf799aa,0,Andrew Palumbo,2019-11-02 03:37:04-07:00,['25ae289e53332681104126128f75701317555c23'],14,14,28,3041037,8,,,,5902
c9956de67aec92bf45d0a00b93e261ac5b572d4c,0,Andrew Palumbo,2019-11-02 03:37:26-07:00,['299b50bc89d998724f7918340a78331cfdf799aa'],14,14,28,3041065,8,,,,5902
27effc6f4c795391af0df1da02634bd2b128d26f,0,Andrew Palumbo,2019-11-02 04:08:34-07:00,['c9956de67aec92bf45d0a00b93e261ac5b572d4c'],21,17,38,3041103,8,,,,5902
f14e831679a70ea8e199935e4038d4f4beaa8148,0,Andrew Palumbo,2019-11-02 04:27:21-07:00,['27effc6f4c795391af0df1da02634bd2b128d26f'],13,13,26,3041129,8,,,,5902
6db68f9691a994015e53182ecd2ec6eb8936e7aa,0,Andrew Palumbo,2019-11-02 04:27:42-07:00,['f14e831679a70ea8e199935e4038d4f4beaa8148'],13,13,26,3041155,8,,,,5902
144179f0ecff09815ed0e6c6931b2d78e3c7fbd1,0,Andrew Palumbo,2019-11-02 05:53:29-07:00,['6db68f9691a994015e53182ecd2ec6eb8936e7aa'],13,13,26,3041181,8,,,,5902
7c28ca99bef3d21fca20665147104d79c8a2e133,0,Andrew Palumbo,2019-11-02 06:10:02-07:00,['144179f0ecff09815ed0e6c6931b2d78e3c7fbd1'],13,13,26,3041207,8,,,,5902
025aafeecac4be5512dab83e44f40bd5e9432628,0,Andrew Palumbo,2019-11-02 06:10:23-07:00,['7c28ca99bef3d21fca20665147104d79c8a2e133'],13,13,26,3041233,8,,,,5902
ed5282eeb6ae7cafc03d51388b009eb6a61286a2,0,Andrew Palumbo,2019-11-02 06:34:01-07:00,['025aafeecac4be5512dab83e44f40bd5e9432628'],13,13,26,3041259,8,,,,5902
765135f1f8fab7b05b5097110d481d0ff906de88,0,Andrew Palumbo,2019-11-02 06:51:38-07:00,['ed5282eeb6ae7cafc03d51388b009eb6a61286a2'],13,13,26,3041285,8,,,,5902
7d4c6113bd048abd1a903393d5416bfbd34bba00,0,Andrew Palumbo,2019-11-02 06:52:00-07:00,['765135f1f8fab7b05b5097110d481d0ff906de88'],13,13,26,3041311,8,,,,5902
98e52ff1c70b021eddb962ac4c8b9af3e9922c27,0,Andrew Palumbo,2019-11-02 07:30:02-07:00,['7d4c6113bd048abd1a903393d5416bfbd34bba00'],13,15,28,3041339,8,,,,5902
81e1dc60f16b50469f3cd640adf8c5a3849a906f,0,Andrew Palumbo,2019-11-02 08:37:53-07:00,['98e52ff1c70b021eddb962ac4c8b9af3e9922c27'],61,16,77,3041416,8,,,,5902
1793f6296f7b20cc17f4933207f5d96c9bc780c1,0,Andrew Palumbo,2019-11-02 08:43:31-07:00,['81e1dc60f16b50469f3cd640adf8c5a3849a906f'],3,0,3,3041419,3,,,,5902
da26b64a0784a1881d8e6ca8e3eb1ecf4ac8d680,0,Andrew Palumbo,2019-11-02 08:52:16-07:00,['1793f6296f7b20cc17f4933207f5d96c9bc780c1'],11,11,22,3041441,8,,,,5902
b84097c7e5c3c2c5ec8a8c85ca226706ba880a9c,0,Andrew Palumbo,2019-11-02 08:52:39-07:00,['da26b64a0784a1881d8e6ca8e3eb1ecf4ac8d680'],11,11,22,3041463,8,,,,5902
f2e9b99f31daa735c7547ce9d43410a36e33f577,0,Andrew Palumbo,2019-11-02 09:28:21-07:00,['b84097c7e5c3c2c5ec8a8c85ca226706ba880a9c'],11,11,22,3041485,8,,,,5902
5c5aadf7601629631410ebea807ceca6b9bc0387,0,Andrew Palumbo,2019-11-02 09:36:02-07:00,['f2e9b99f31daa735c7547ce9d43410a36e33f577'],9,11,20,3041505,1,,,,5902
4ce01cb8bca805f19b2b84caa6e56b51a80e0a33,0,Andrew Palumbo,2019-11-02 09:51:13-07:00,['5c5aadf7601629631410ebea807ceca6b9bc0387'],11,11,22,3041527,8,,,,5902
729d622c6af2855a9d5c99008099f6c6d34feb84,0,Andrew Palumbo,2019-11-02 09:51:35-07:00,['4ce01cb8bca805f19b2b84caa6e56b51a80e0a33'],11,11,22,3041549,8,,,,5902
7269a58c7dfda9311d7b6b078583b862bdd32c22,0,Andrew Palumbo,2019-11-02 18:41:28-07:00,['729d622c6af2855a9d5c99008099f6c6d34feb84'],44,42,86,3041635,9,,,,5902
48e336d0d3e4e04c3114983e2a37ac0bd3a61f1f,0,Andrew Palumbo,2019-11-02 19:35:42-07:00,['7269a58c7dfda9311d7b6b078583b862bdd32c22'],35,63,98,3041733,1,,,,5902
43b693505a8d8768db9251fe427ceccee8ff6bb1,0,Andrew Palumbo,2019-11-02 19:52:53-07:00,['48e336d0d3e4e04c3114983e2a37ac0bd3a61f1f'],2,2,4,3041737,2,,,,5902
701b02ecc9af533ed6e588cd8f140ab7393db1c2,0,Andrew Palumbo,2019-11-02 19:59:44-07:00,['43b693505a8d8768db9251fe427ceccee8ff6bb1'],10,10,20,3041757,8,,,,5902
41c2083c8a5237a47228f1e89bb3e06862d40a04,0,Andrew Palumbo,2019-11-02 20:00:07-07:00,['701b02ecc9af533ed6e588cd8f140ab7393db1c2'],10,10,20,3041777,8,,,,5902
339dfb1f0238373066e9ec669540b10c7fb41d3b,0,Andrew Palumbo,2019-11-02 20:58:44-07:00,['41c2083c8a5237a47228f1e89bb3e06862d40a04'],13,12,25,3041802,8,,,,5902
40e8a7e5b42fcd3fc46d5777e528a36bec86f843,0,Andrew Palumbo,2019-11-02 22:23:58-07:00,['339dfb1f0238373066e9ec669540b10c7fb41d3b'],2,20,22,3041824,1,,,,5902
af28a672db544cccdb4888036f02030ba8a5103c,0,Andrew Palumbo,2019-11-02 22:35:44-07:00,['40e8a7e5b42fcd3fc46d5777e528a36bec86f843'],10,10,20,3041844,8,,,,5902
032b0332ad0e6e105429cc7bb3038ef459efce96,0,Andrew Palumbo,2019-11-02 22:36:05-07:00,['af28a672db544cccdb4888036f02030ba8a5103c'],10,10,20,3041864,8,,,,5902
25f4a3b7da9dfea043b8a7522f7ff10d49cc73a2,0,Andrew Palumbo,2019-11-02 23:06:56-07:00,['032b0332ad0e6e105429cc7bb3038ef459efce96'],14,11,25,3041889,8,,,,5902
a515dd05685a6a996b5f13c2cd7dd3fd537fbc57,0,Andrew Palumbo,2019-11-02 23:21:04-07:00,['25f4a3b7da9dfea043b8a7522f7ff10d49cc73a2'],10,10,20,3041909,8,,,,5902
9c81e28ae1933fd0285ca773f81d501732f0f3c8,0,Andrew Palumbo,2019-11-02 23:21:25-07:00,['a515dd05685a6a996b5f13c2cd7dd3fd537fbc57'],10,10,20,3041929,8,,,,5902
70112f4bc813ce797cd54b770ab9e6fbf9ec0aa6,0,Andrew Palumbo,2019-11-03 00:42:47-07:00,['9c81e28ae1933fd0285ca773f81d501732f0f3c8'],2,1,3,3041932,1,,,,5902
7fbaae4b820691ff60dc0774e53c2525c27f64db,0,Andrew Palumbo,2019-11-03 00:46:12-07:00,['70112f4bc813ce797cd54b770ab9e6fbf9ec0aa6'],10,10,20,3041952,8,,,,5902
9c936635cb4e78143c708577860a736489837b2a,0,Andrew Palumbo,2019-11-03 00:59:06-07:00,['7fbaae4b820691ff60dc0774e53c2525c27f64db'],14,14,28,3041980,12,,,,5902
daf2df23c901750d7450ec81c2594ceceb0174db,0,Andrew Palumbo,2019-11-03 01:21:34-07:00,['9c936635cb4e78143c708577860a736489837b2a'],13,14,27,3042007,11,,,,5902
cfe6d824777af1bd825a5f0d67c9f18dcdd368df,0,Andrew Palumbo,2019-11-03 01:53:23-07:00,['daf2df23c901750d7450ec81c2594ceceb0174db'],1,3,4,3042011,1,,,,5902
ff691720ba9b6a825860ec88b177c5f282b5dfd4,0,Andrew Palumbo,2019-11-03 02:08:01-08:00,['cfe6d824777af1bd825a5f0d67c9f18dcdd368df'],2,23,25,3042036,1,,,,5902
c80c3e5d3cae573df470e740200bc457d54147ab,0,Andrew Palumbo,2019-11-03 02:19:46-08:00,['ff691720ba9b6a825860ec88b177c5f282b5dfd4'],9,9,18,3042054,8,,,,5902
402fa0d7fa1c1effacab9297b185931f7e8dd85d,0,Andrew Palumbo,2019-11-03 02:45:53-08:00,['c80c3e5d3cae573df470e740200bc457d54147ab'],9,9,18,3042072,8,,,,5902
70287115c2be807bc9f47e4637ea37f1b885a94d,1,Andrew Palumbo,2019-11-03 21:39:37-08:00,['402fa0d7fa1c1effacab9297b185931f7e8dd85d'],31,37,68,3042140,14,,,,5902
979802b5f73d439fd0f09c0e1f0f28d453d70e3f,0,Andrew Palumbo,2019-11-03 21:56:43-08:00,['70287115c2be807bc9f47e4637ea37f1b885a94d'],10,10,20,3042160,8,,,,5902
b013d7e673d69b9377428731f1c5221569c09e06,0,Andrew Palumbo,2019-11-03 21:57:06-08:00,['979802b5f73d439fd0f09c0e1f0f28d453d70e3f'],10,10,20,3042180,8,,,,5902
87acf8b4b35febb7254a7ffd91c56c681b9e60f5,0,Andrew Palumbo,2019-11-03 22:02:28-08:00,['b013d7e673d69b9377428731f1c5221569c09e06'],9,9,18,3042198,8,,,,5902
39c30cb801e6aeea573428f0bfe931826daa960a,0,Andrew Musselman,2019-11-11 15:39:17-08:00,['87acf8b4b35febb7254a7ffd91c56c681b9e60f5'],16,16,32,3042230,14,,,,5902
4458ef7a6bc006d2a17c7cc1b41e96ab40c70915,0,Andrew Musselman,2019-11-11 15:47:50-08:00,['39c30cb801e6aeea573428f0bfe931826daa960a'],4,4,8,3042238,1,,,,5902
67646078840c019805d80b05559b2bcab001a3e9,0,Andrew Musselman,2019-11-11 16:02:08-08:00,['4458ef7a6bc006d2a17c7cc1b41e96ab40c70915'],10,10,20,3042258,8,,,,5902
5250dee6fad895c33958a12b2e107eee3e102ef6,0,Andrew Musselman,2019-11-11 16:05:15-08:00,['67646078840c019805d80b05559b2bcab001a3e9'],10,10,20,3042278,8,,,,5902
50abf94b2b4206f68d35636250eadcbb25487c27,0,Andrew Musselman,2019-11-11 16:15:09-08:00,['5250dee6fad895c33958a12b2e107eee3e102ef6'],10,10,20,3042298,8,,,,5902
1ff489a36cec5465a305ee3487b939cf97111328,0,Andrew Musselman,2019-11-11 16:16:04-08:00,['50abf94b2b4206f68d35636250eadcbb25487c27'],10,10,20,3042318,8,,,,5902
3b1bc874f15835cd4dbf3f25e9a51b3b269a1612,0,Andrew Musselman,2019-11-11 16:27:40-08:00,['1ff489a36cec5465a305ee3487b939cf97111328'],10,10,20,3042338,8,,,,5902
67140ac7be42eea68d16d170a35831b6d3acdb7f,0,Andrew Musselman,2019-11-11 16:28:38-08:00,['3b1bc874f15835cd4dbf3f25e9a51b3b269a1612'],10,10,20,3042358,8,,,,5902
a6938529052ba75c9841a4ea07a0dac1276375da,0,Andrew Musselman,2019-11-11 16:50:18-08:00,['67140ac7be42eea68d16d170a35831b6d3acdb7f'],10,10,20,3042378,8,,,,5902
838ecf7a521e06ab03366f129c880bdd953adc87,0,Andrew Musselman,2019-11-11 17:01:09-08:00,['a6938529052ba75c9841a4ea07a0dac1276375da'],10,10,20,3042398,8,,,,5902
8aec9226eb903b60e74c0b5a07144bac949b4c39,0,Andrew Musselman,2019-11-11 18:36:27-08:00,['838ecf7a521e06ab03366f129c880bdd953adc87'],10,10,20,3042418,8,,,,5902
5eda1b98f8ff1b86c8ca24faca5672f602f50721,0,Andrew Musselman,2019-11-11 18:36:48-08:00,['8aec9226eb903b60e74c0b5a07144bac949b4c39'],10,10,20,3042438,8,,,,5902
3fbfef895d004dfa3a8561d54076aff8061c0b63,0,Andrew Musselman,2019-11-11 18:51:05-08:00,['5eda1b98f8ff1b86c8ca24faca5672f602f50721'],9,9,18,3042456,8,,,,5902
2814553f061d7f63dd9ba52203dcb0522850c059,0,Andrew Musselman,2019-11-11 19:04:38-08:00,['3fbfef895d004dfa3a8561d54076aff8061c0b63'],10,10,20,3042476,8,,,,5902
57d76991b0b5f4cae5c208e574abf27431ab2f36,0,Andrew Musselman,2019-11-11 19:04:58-08:00,['2814553f061d7f63dd9ba52203dcb0522850c059'],10,10,20,3042496,8,,,,5902
d2fa55348780d9168e3d524f926b5f4a3fce7f27,0,Andrew Musselman,2019-11-11 19:51:47-08:00,['57d76991b0b5f4cae5c208e574abf27431ab2f36'],9,9,18,3042514,8,,,,5902
60c7706dbba2cf6a7b04651b5bc7d1684d40e6b1,0,Andrew Musselman,2019-11-11 19:54:00-08:00,['d2fa55348780d9168e3d524f926b5f4a3fce7f27'],0,1,1,3042515,1,,,,5902
aa6948ac3dc7102bef8373575a8f0c7e9090fca3,0,Andrew Musselman,2019-11-11 20:04:25-08:00,['60c7706dbba2cf6a7b04651b5bc7d1684d40e6b1'],10,10,20,3042535,8,,,,5902
ae64e017bb4722d13f2e4fe98796ae9eed3b2415,0,Andrew Musselman,2019-11-11 20:04:46-08:00,['aa6948ac3dc7102bef8373575a8f0c7e9090fca3'],10,10,20,3042555,8,,,,5902
bf7dabd009a2d6773faa96c05e708533a1c1a3b1,0,Andrew Musselman,2019-11-11 21:52:27-08:00,['ae64e017bb4722d13f2e4fe98796ae9eed3b2415'],9,9,18,3042573,8,,,,5902
de1b710e1291a1f63426d7e84b7d9cdb414d934d,0,GitHub,2019-12-14 16:47:15-06:00,['bf7dabd009a2d6773faa96c05e708533a1c1a3b1'],0,21,21,3042594,1,,,,5903
9e02792b16b869289cd1f7506fdbaff8c4652c0a,0,GitHub,2019-12-14 16:48:30-06:00,['de1b710e1291a1f63426d7e84b7d9cdb414d934d'],0,21,21,3042615,1,,,,5904
a440a82fef60bd16a3d91521fbe53bd80d78735b,0,GitHub,2019-12-14 16:56:21-06:00,['9e02792b16b869289cd1f7506fdbaff8c4652c0a'],0,21,21,3042636,1,,,,5905
f7a4f0a23c73c790238b10b7c1b43cd92fab315b,0,GitHub,2019-12-14 16:56:55-06:00,['a440a82fef60bd16a3d91521fbe53bd80d78735b'],1,1,2,3042638,1,,,,5905
db6eb17fd3a66579f3271cbe7f9176e80f611c78,0,GitHub,2019-12-14 16:57:27-06:00,['f7a4f0a23c73c790238b10b7c1b43cd92fab315b'],5,4,9,3042647,1,,,,5905
61f4398131eb35254352275f65716d572d5bf90d,0,GitHub,2019-12-14 16:57:58-06:00,['db6eb17fd3a66579f3271cbe7f9176e80f611c78'],21,0,21,3042668,1,,,,5905
c7696de2742038ccc8d9ad60772957df82753e76,0,GitHub,2019-12-14 16:58:23-06:00,['61f4398131eb35254352275f65716d572d5bf90d'],21,0,21,3042689,1,,,,5905
735ddd05a6dabf37a5e38683ab709850ad0063c5,0,GitHub,2019-12-14 16:58:41-06:00,['c7696de2742038ccc8d9ad60772957df82753e76'],15,0,15,3042704,1,,,,5905
ed886e89d2cdb0826cbd1ce3a5f9f1c85a7673b7,0,GitHub,2019-12-14 16:59:44-06:00,['735ddd05a6dabf37a5e38683ab709850ad0063c5'],1,1,2,3042706,1,,,,5905
06866f6807994ad6aebcbbbb6f98de0036ac553c,0,GitHub,2019-12-14 15:52:23-08:00,['ed886e89d2cdb0826cbd1ce3a5f9f1c85a7673b7'],364,13,377,3043083,10,,,,5905
3a6517b508974cca450b712d08a0c359ffda7649,0,Andrew Palumbo,2019-12-14 16:42:08-08:00,['06866f6807994ad6aebcbbbb6f98de0036ac553c'],10,10,20,3043103,8,,,,5905
22cd07bd331ebc8212b3da07a92405384f656926,0,Andrew Palumbo,2019-12-14 16:42:30-08:00,['3a6517b508974cca450b712d08a0c359ffda7649'],10,10,20,3043123,8,,,,5905
8a0ec2e9855c9b4f09365d56f68d1a6fdd4a9893,0,Andrew Palumbo,2019-12-14 16:57:02-08:00,['22cd07bd331ebc8212b3da07a92405384f656926'],9,9,18,3043141,8,,,,5905
213583f6c1cc61eac480287d6e87bcdcacd7d6af,0,Andrew Palumbo,2019-12-14 18:20:00-08:00,['8a0ec2e9855c9b4f09365d56f68d1a6fdd4a9893'],35,35,70,3043211,14,,,,5905
f8df24367a1fa3f9dbe142ff45568b1932c675b0,0,Andrew Palumbo,2019-12-14 18:35:39-08:00,['213583f6c1cc61eac480287d6e87bcdcacd7d6af'],9,9,18,3043229,8,,,,5905
b24ff9c34a527f62d06e6cd3b6435f3b188ef99b,0,Andrew Palumbo,2019-12-14 18:36:00-08:00,['f8df24367a1fa3f9dbe142ff45568b1932c675b0'],9,9,18,3043247,8,,,,5905
19f1688cad804885d68ba9ddcb56232de3ecdaa9,0,Andrew Palumbo,2019-12-14 18:52:52-08:00,['b24ff9c34a527f62d06e6cd3b6435f3b188ef99b'],12,12,24,3043271,11,,,,5905
7c8169e84ee481b36f05504f15947f5810d9fb27,0,Andrew Palumbo,2019-12-17 21:06:41-08:00,['19f1688cad804885d68ba9ddcb56232de3ecdaa9'],1,1,2,3043273,1,,,,5905
d2ece771762404fe8b434788087eeb40b73c4b50,0,GitHub,2019-12-17 21:47:14-08:00,['7c8169e84ee481b36f05504f15947f5810d9fb27'],0,1,1,3043274,1,,,,5905
b0b45b2db0f8552d0662f91a197f71415521d2fa,0,Andrew Palumbo,2019-12-17 23:23:46-08:00,['d2ece771762404fe8b434788087eeb40b73c4b50'],37,36,73,3043347,15,,,,5905
cad956e68ba75579d7795bed4f48141b18dddbfc,0,Andrew Palumbo,2019-12-18 00:02:58-08:00,['b0b45b2db0f8552d0662f91a197f71415521d2fa'],17,88,105,3043452,1,,,,5905
cd9e3bc3f268c1ff30eff8e92f429bacc7dac645,0,Andrew Palumbo,2019-12-18 01:40:26-08:00,['cad956e68ba75579d7795bed4f48141b18dddbfc'],20,0,20,3043472,1,,,,5905
ff3d72d805cf070025f4f93ad929da23297d826b,0,Andrew Palumbo,2019-12-18 01:44:19-08:00,['cd9e3bc3f268c1ff30eff8e92f429bacc7dac645'],1,1,2,3043474,1,,,,5905
7cf2d7fa63891214963270727103c734ee838693,0,Andrew Palumbo,2019-12-18 01:51:15-08:00,['cd9e3bc3f268c1ff30eff8e92f429bacc7dac645'],1,1,2,3043476,1,,,,5905
3e151c0e920491d4d06ddef8f707fe714a93de1e,0,Andrew Palumbo,2019-12-18 01:52:40-08:00,"['7cf2d7fa63891214963270727103c734ee838693', 'ff3d72d805cf070025f4f93ad929da23297d826b']",1,1,2,3043478,1,,,,5905
91e1e4e88598827df1b5c3cd66583e6aa1b112a4,0,Andrew Palumbo,2019-12-18 02:10:02-08:00,['3e151c0e920491d4d06ddef8f707fe714a93de1e'],10,10,20,3043498,8,,,,5905
47ce5a8245d92b0d2277e48332e8dbc31340e263,0,Andrew Palumbo,2019-12-18 18:15:42-08:00,['91e1e4e88598827df1b5c3cd66583e6aa1b112a4'],10,10,20,3043518,8,,,,5905
4c7b9d432e3584b2b095dbf4760725ec2c902ad1,0,Andrew Palumbo,2020-01-13 18:30:53-08:00,['47ce5a8245d92b0d2277e48332e8dbc31340e263'],10,10,20,3043538,8,,,,5905
9a3f1ed138f72f9df4bf0731481ff36985c5db19,0,Andrew Palumbo,2020-01-13 18:31:15-08:00,['4c7b9d432e3584b2b095dbf4760725ec2c902ad1'],10,10,20,3043558,8,,,,5905
fbd2bfa136c537c34c99cb2ca50f8c4054097ea1,0,Andrew Palumbo,2020-01-13 18:51:12-08:00,['9a3f1ed138f72f9df4bf0731481ff36985c5db19'],9,9,18,3043576,8,,,,5905
8aa8c71b7cbb4d9acd3706d93a632f7182bf7c29,0,Andrew Palumbo,2020-01-13 19:14:53-08:00,['fbd2bfa136c537c34c99cb2ca50f8c4054097ea1'],10,10,20,3043596,8,,,,5905
c4fcf1fdca9bc1a0453bad7ed9dbcde2f3520a1e,0,Andrew Palumbo,2020-01-13 19:15:14-08:00,['8aa8c71b7cbb4d9acd3706d93a632f7182bf7c29'],10,10,20,3043616,8,,,,5905
e730f076d7a6f1bdd2db1a496c2c3a480eb5294b,0,Andrew Palumbo,2020-01-13 19:18:26-08:00,['c4fcf1fdca9bc1a0453bad7ed9dbcde2f3520a1e'],9,9,18,3043634,8,,,,5905
5994243fab97f3fb9930503d005a0eddf36bef41,0,Andrew Palumbo,2020-01-13 19:31:06-08:00,['e730f076d7a6f1bdd2db1a496c2c3a480eb5294b'],10,10,20,3043654,8,,,,5905
cce9126d1a2c22cc405eca4a5d1218a285bcdd2a,0,Andrew Palumbo,2020-01-13 19:31:27-08:00,['5994243fab97f3fb9930503d005a0eddf36bef41'],10,10,20,3043674,8,,,,5905
1dc8fb8a742d44a972e39702c138b89f47d523de,0,Andrew Palumbo,2020-01-13 19:52:38-08:00,['cce9126d1a2c22cc405eca4a5d1218a285bcdd2a'],9,9,18,3043692,8,,,,5905
215f563b0a920ba459610d87ac4d0ebb8bed3da4,0,Andrew Palumbo,2020-01-13 20:12:18-08:00,['1dc8fb8a742d44a972e39702c138b89f47d523de'],1,1,2,3043694,1,,,,5905
3be7f9f29cb81464faacc2b328f17bcd5d458291,0,Andrew Palumbo,2020-01-13 20:12:52-08:00,['215f563b0a920ba459610d87ac4d0ebb8bed3da4'],1,1,2,3043696,1,,,,5905
20ca2827849112ab197eecb904e32b25ebdbecca,0,Andrew Palumbo,2020-01-13 20:16:17-08:00,['3be7f9f29cb81464faacc2b328f17bcd5d458291'],10,10,20,3043716,8,,,,5905
6ea9f3ce254f9900cde950c80214b02e9f7d71f7,0,Andrew Palumbo,2020-01-13 20:29:57-08:00,['20ca2827849112ab197eecb904e32b25ebdbecca'],5,21,26,3043742,1,,,,5905
f28b3a0fe07c5e7ffbbb407a5fcda41208dd327f,0,Andrew Palumbo,2020-01-13 20:42:20-08:00,['6ea9f3ce254f9900cde950c80214b02e9f7d71f7'],10,10,20,3043762,8,,,,5905
5e20509fb6a6620134b6346a73f6d88f81253c5e,0,Andrew Palumbo,2020-01-13 20:42:40-08:00,['f28b3a0fe07c5e7ffbbb407a5fcda41208dd327f'],10,10,20,3043782,8,,,,5905
53ec8f3a1b0b4038b6eab0a4140970274801affd,0,Andrew Palumbo,2020-01-13 21:38:23-08:00,['5e20509fb6a6620134b6346a73f6d88f81253c5e'],26,26,52,3043834,12,,,,5905
dcd1549b48bfa538ef2227fd8b1dafc61e58bc11,0,Andrew Palumbo,2020-01-13 21:40:26-08:00,['53ec8f3a1b0b4038b6eab0a4140970274801affd'],1,1,2,3043836,1,,,,5905
53916859ae016ea3cbe3c20c0f6f1ff3db88de2f,0,Andrew Palumbo,2020-01-13 21:48:13-08:00,['dcd1549b48bfa538ef2227fd8b1dafc61e58bc11'],1,2,3,3043839,1,,,,5905
b24210a0adb4a6134a56f3ad8235ec610c609661,0,Andrew Palumbo,2020-01-13 22:04:24-08:00,['53916859ae016ea3cbe3c20c0f6f1ff3db88de2f'],19,19,38,3043877,8,,,,5905
e4126caf7bcd369c826e2f59de63b5aef6868a93,1,Andrew Palumbo,2020-01-13 22:04:45-08:00,['b24210a0adb4a6134a56f3ad8235ec610c609661'],19,19,38,3043915,8,,,,5905
d28a505c61a5c8284a1b5bcc936a3188e01f530b,0,GitHub,2020-01-22 19:42:45-08:00,['e4126caf7bcd369c826e2f59de63b5aef6868a93'],177,53,230,3044145,14,,,,5905
8df99c7249b99ef137fb0f2935ac0c3050215fe4,1,GitHub,2020-01-23 07:58:49-08:00,['d28a505c61a5c8284a1b5bcc936a3188e01f530b'],60,1153,1213,3045358,9,,,,5907
1739df48fd1d539c3d2b2c40abca868f83a834ef,0,Andrew Palumbo,2020-01-23 08:48:20-08:00,['8df99c7249b99ef137fb0f2935ac0c3050215fe4'],1,1,2,3045360,1,,,,5907
3555bdc0e5d979d1173f98e51f7d7de98ac14a0b,0,Andrew Palumbo,2020-01-23 09:00:08-08:00,['1739df48fd1d539c3d2b2c40abca868f83a834ef'],1093,73,1166,3046526,16,,,,5907
f79a1a6ca8fe9a228f3c5652f407d110db7dc651,0,Andrew Palumbo,2020-01-23 09:20:46-08:00,['3555bdc0e5d979d1173f98e51f7d7de98ac14a0b'],0,0,0,3046526,1,,,,5908
07446b7f130dd975bb287a2bd547bab4c8b4158d,0,GitHub,2020-01-23 09:23:13-08:00,['8df99c7249b99ef137fb0f2935ac0c3050215fe4'],1093,73,1166,3047692,16,,,,5908
6f7203bc30533d536c3cc8b6a2e9f5ceade52bda,0,Andrew Palumbo,2020-01-23 09:25:13-08:00,"['07446b7f130dd975bb287a2bd547bab4c8b4158d', 'f79a1a6ca8fe9a228f3c5652f407d110db7dc651']",0,0,0,3047692,0,,,,5908
d7e998ac121b4bb63383591991f6b62adca31d5e,0,GitHub,2020-01-23 10:23:31-08:00,['07446b7f130dd975bb287a2bd547bab4c8b4158d'],10,1065,1075,3048767,4,,,,5909
b0eda07261a2bd18f7d6a0264191c43b7405876d,0,Andrew Palumbo,2020-01-23 10:27:32-08:00,"['6f7203bc30533d536c3cc8b6a2e9f5ceade52bda', 'd7e998ac121b4bb63383591991f6b62adca31d5e']",10,1065,1075,3049842,4,,,,5909
31332e023361acdf971bbcc83c9b3be0a12f5eb8,0,Andrew Palumbo,2020-01-23 11:36:14-08:00,['b0eda07261a2bd18f7d6a0264191c43b7405876d'],19,17,36,3049878,8,,,,5909
64c03b64b41eaaf2ef5759991c0c4aaf578e25a2,0,Andrew Palumbo,2020-01-23 11:36:37-08:00,['31332e023361acdf971bbcc83c9b3be0a12f5eb8'],16,16,32,3049910,8,,,,5909
d88fde0e1150122158906a4bc307bfc5d437c020,0,Andrew Palumbo,2020-01-24 02:04:24-08:00,['64c03b64b41eaaf2ef5759991c0c4aaf578e25a2'],10,12,22,3049932,8,,,,5909
8c35edb321b44a0caee7d1a0dac7fd2eacb7fbe6,0,Andrew Palumbo,2020-01-31 03:52:22-08:00,['d88fde0e1150122158906a4bc307bfc5d437c020'],6,4,10,3049942,1,,,,5909
69242e380c6064f394352e44440023470b10b291,0,Andrew Palumbo,2020-01-31 04:07:08-08:00,['8c35edb321b44a0caee7d1a0dac7fd2eacb7fbe6'],2,4,6,3049948,3,,,,5909
e273487fd718bc533b1775ded9c1b134752aaf4c,0,Andrew Palumbo,2020-01-31 04:13:31-08:00,['69242e380c6064f394352e44440023470b10b291'],3,18,21,3049969,1,,,,5909
201280fe8692d3aa3980124850ff644eb63f4284,0,Andrew Palumbo,2020-01-31 04:17:15-08:00,['e273487fd718bc533b1775ded9c1b134752aaf4c'],0,0,0,3049969,2,,,,5909
1aa2ea6bcf2c9ac4596dbb9677174dd7fc8c0aa1,0,Andrew Palumbo,2020-01-31 04:36:10-08:00,['201280fe8692d3aa3980124850ff644eb63f4284'],1061,3,1064,3051033,3,,,,5909
bf44ef419c13ffe27867ace6dade99a7f7b577cc,0,Andrew Palumbo,2020-01-31 04:44:25-08:00,['1aa2ea6bcf2c9ac4596dbb9677174dd7fc8c0aa1'],0,0,0,3051033,4,,,,5909
c6235ece23164ea63aced4f6cb1a92876caf86ed,0,Andrew Palumbo,2020-01-31 06:07:42-08:00,['bf44ef419c13ffe27867ace6dade99a7f7b577cc'],462,3,465,3051498,5,,,,5909
84a69aee1de708e71a8d4d5979b9a49d2e3f7c2b,0,Andrew Palumbo,2020-01-31 06:10:30-08:00,['c6235ece23164ea63aced4f6cb1a92876caf86ed'],1,1,2,3051500,1,,,,5909
dc153f7affa631665eeb6b95be7f25b34fd6b601,0,Andrew Palumbo,2020-01-31 06:52:20-08:00,['84a69aee1de708e71a8d4d5979b9a49d2e3f7c2b'],22,3,25,3051525,2,,,,5909
0de6c46d77c91da91bb90b490e77108e0fdda8cf,0,Andrew Palumbo,2020-01-31 07:13:41-08:00,['dc153f7affa631665eeb6b95be7f25b34fd6b601'],16,16,32,3051557,8,,,,5909
a0204e438e88a0896d2aae3f7ae6d2961dcb7e81,0,Andrew Palumbo,2020-01-31 07:14:02-08:00,['0de6c46d77c91da91bb90b490e77108e0fdda8cf'],16,16,32,3051589,8,,,,5909
a913c9b35212f021ad36718b6c55b2cf11c6f015,0,Andrew Palumbo,2020-01-31 07:52:38-08:00,['a0204e438e88a0896d2aae3f7ae6d2961dcb7e81'],1,0,1,3051590,1,,,,5909
71c1db26544ce55a8209fc1ac1bc5ad597abe347,0,Andrew Palumbo,2020-01-31 20:12:08-08:00,['a913c9b35212f021ad36718b6c55b2cf11c6f015'],5,2,7,3051597,2,,,,5909
5932cc168a4df4a28dbff4345c5dc02565bf6abf,0,Andrew Palumbo,2020-01-31 21:03:16-08:00,['71c1db26544ce55a8209fc1ac1bc5ad597abe347'],16,16,32,3051629,8,,,,5909
50b5640588b0f056ea4f28bf6fd7d7916c99e1b6,0,Andrew Palumbo,2020-01-31 21:03:37-08:00,['5932cc168a4df4a28dbff4345c5dc02565bf6abf'],16,16,32,3051661,8,,,,5909
adea0b5d1328b0c622a5377ec71c49f296e4d3a4,0,Andrew Palumbo,2020-01-31 22:09:27-08:00,['50b5640588b0f056ea4f28bf6fd7d7916c99e1b6'],32,29,61,3051722,13,,,,5909
5be58f3558a123838bb87a83b915b086032f5eef,0,Andrew Palumbo,2020-01-31 22:28:23-08:00,['adea0b5d1328b0c622a5377ec71c49f296e4d3a4'],16,16,32,3051754,8,,,,5909
7e35953ad6184478350c63e4248e6f09850d2d7a,0,Andrew Palumbo,2020-01-31 22:28:45-08:00,['5be58f3558a123838bb87a83b915b086032f5eef'],16,16,32,3051786,8,,,,5909
34d89c1692024ffef9d9377ffddc25ecd3a27d11,0,Andrew Palumbo,2020-01-31 23:45:15-08:00,['7e35953ad6184478350c63e4248e6f09850d2d7a'],9,9,18,3051804,8,,,,5909
9fa9b865127c1f435d6b4f99e711ebb929105b50,0,Andrew Palumbo,2020-02-01 02:51:11-08:00,['34d89c1692024ffef9d9377ffddc25ecd3a27d11'],21,21,42,3051846,20,,,,5909
576005dc8bde1a86b3a9aefbacad629be6f670b3,0,Andrew Musselman,2020-02-04 11:46:44-08:00,['9fa9b865127c1f435d6b4f99e711ebb929105b50'],22,22,44,3051890,20,,,,5909
85ce5504dc17dfbcaaee35a76bf46360228961d6,0,Andrew Palumbo,2020-02-20 20:48:48-08:00,['576005dc8bde1a86b3a9aefbacad629be6f670b3'],2,2,4,3051894,1,,,,5909
438dc55573dc0ec414a1eec38a52946184ee5a66,0,Andrew Palumbo,2020-02-20 20:56:47-08:00,['85ce5504dc17dfbcaaee35a76bf46360228961d6'],28,28,56,3051950,13,,,,5909
754068bc3ac62bcf4b9b656cd4a6f413b29b18df,0,GitHub,2020-02-21 00:05:08-08:00,['438dc55573dc0ec414a1eec38a52946184ee5a66'],9,33,42,3051992,1,,,,5909
e02d172e7070354a91368c5e9df1f0952610a9bb,0,Christofer Dutz,2020-04-20 08:50:48+02:00,['754068bc3ac62bcf4b9b656cd4a6f413b29b18df'],1682,1459,3141,3055133,34,0.142857143,0,0,5910
9d59aa1cf7f9a2a364c9ce1065e4ee538a376f41,0,Christofer Dutz,2020-04-20 09:39:46+02:00,['e02d172e7070354a91368c5e9df1f0952610a9bb'],0,6,6,3055139,1,,,,5910
6c21f91f20aa158089a606c127d876263670e079,0,Christofer Dutz,2020-04-22 15:24:10+02:00,['9d59aa1cf7f9a2a364c9ce1065e4ee538a376f41'],1142,1012,2154,3057293,16,,,,5911
f9b8781a3f1bd6be8c7f25db94062376e861c931,0,Christofer Dutz,2020-06-04 17:54:14+02:00,['6c21f91f20aa158089a606c127d876263670e079'],1016,378,1394,3058687,33,,,,5912
9212ae59826bc974c19b55140f8b00273516268f,0,GitHub,2020-06-04 11:20:18-05:00,"['754068bc3ac62bcf4b9b656cd4a6f413b29b18df', 'f9b8781a3f1bd6be8c7f25db94062376e861c931']",2774,1789,4563,3063250,51,,,,5912
0b847cc1eff5631e77a4af23c6c7162ab122ee13,0,Christofer Dutz,2020-06-04 18:56:45+02:00,['f9b8781a3f1bd6be8c7f25db94062376e861c931'],1,9,10,3063260,1,,,,5912
aca4e6e889633d374995d984c7611d4772654f75,0,Christofer Dutz,2020-06-04 19:05:10+02:00,['0b847cc1eff5631e77a4af23c6c7162ab122ee13'],46,53,99,3063359,1,,,,5912
4626fdd7f2f75a5b4d87010bd89a489b066e6a58,0,GitHub,2020-06-04 12:14:11-05:00,"['9212ae59826bc974c19b55140f8b00273516268f', 'aca4e6e889633d374995d984c7611d4772654f75']",47,62,109,3063468,2,,,,5912
7fccb7886d12bce4ad44e78d03bfe6dbb3b76449,0,Trevor a.k.a @rawkintrevo,2020-06-08 14:58:31-05:00,['754068bc3ac62bcf4b9b656cd4a6f413b29b18df'],3,3,6,3063474,2,,,,5912
ae6acffa1889f3b2aa9c5ef5d0a74448bab47f07,0,GitHub,2020-06-09 07:57:26-05:00,"['754068bc3ac62bcf4b9b656cd4a6f413b29b18df', '7fccb7886d12bce4ad44e78d03bfe6dbb3b76449']",3,3,6,3063480,2,,,,5912
f90b7963b34c0735cc02f182e164722ce980a72e,0,GitHub,2020-06-23 11:21:22+03:00,['ae6acffa1889f3b2aa9c5ef5d0a74448bab47f07'],1,1,2,3063482,1,,,,5912
8ef39df1872893b34a9cdf3db3b73720d9b3be3a,0,GitHub,2020-06-23 11:22:57+03:00,['f90b7963b34c0735cc02f182e164722ce980a72e'],1,1,2,3063484,1,,,,5912
3111aa435631bbf60630f5c8e1a27f69fd701870,0,GitHub,2020-06-23 07:08:38-05:00,"['ae6acffa1889f3b2aa9c5ef5d0a74448bab47f07', '8ef39df1872893b34a9cdf3db3b73720d9b3be3a']",2,2,4,3063488,2,,,,5912
bc494c09ec0a9cc4cb82920343ef9ec832a47061,0,Trevor a.k.a @rawkintrevo,2020-06-25 16:46:30-05:00,['3111aa435631bbf60630f5c8e1a27f69fd701870'],4,36,40,3063528,5,,,,5913
a51a8dfde03ac47232f0c4366d34f3fde364b061,0,Trevor a.k.a @rawkintrevo,2020-06-25 16:47:43-05:00,['4626fdd7f2f75a5b4d87010bd89a489b066e6a58'],0,22,22,3063550,1,,,,5914
8d2d346ecf462b5c0f9e30030033ba0dafb1eb6b,0,Trevor a.k.a @rawkintrevo,2020-06-25 16:48:49-05:00,['a51a8dfde03ac47232f0c4366d34f3fde364b061'],0,22,22,3063572,1,,,,5915
9fc20c8d8f138af7dad56630b3bd3674e995174a,0,Christofer Dutz,2020-06-26 08:26:53+02:00,['8d2d346ecf462b5c0f9e30030033ba0dafb1eb6b'],12,10,22,3063594,1,,,,5915
60bdf966ce774db089451f2bcd10166bcf207f8a,0,GitHub,2020-06-26 12:36:03-05:00,"['9fc20c8d8f138af7dad56630b3bd3674e995174a', 'bc494c09ec0a9cc4cb82920343ef9ec832a47061']",4,38,42,3063636,6,,,,5915
ed701bb28757403cb392146dcde7cfb606893772,0,GitHub,2020-06-26 12:36:20-05:00,"['bc494c09ec0a9cc4cb82920343ef9ec832a47061', '60bdf966ce774db089451f2bcd10166bcf207f8a']",2757,1831,4588,3068224,53,,,,5915
8160ee11337c5ae820ca11ce298e41972fefc84f,0,Andrew Musselman,2020-06-26 10:48:04-07:00,['ed701bb28757403cb392146dcde7cfb606893772'],8,6,14,3068238,3,,,,5915
d1cfd56299ffd599a592a4dee75e47a7ce26ef7d,0,Andrew Musselman,2020-06-26 10:48:55-07:00,['8160ee11337c5ae820ca11ce298e41972fefc84f'],16,16,32,3068270,6,,,,5915
ee2c98c57ced64ded818df7b5a2fce11f1ebd0c9,0,Andrew Musselman,2020-06-26 11:20:24-07:00,['d1cfd56299ffd599a592a4dee75e47a7ce26ef7d'],16,16,32,3068302,6,,,,5915
c6fabc5814fb633d5d97afdb6ca5aa28e7543336,0,Andrew Musselman,2020-06-26 11:22:17-07:00,['ee2c98c57ced64ded818df7b5a2fce11f1ebd0c9'],16,16,32,3068334,6,,,,5915
2c2833211d32d2197a6ecc308432428ee5f98df9,0,Andrew Musselman,2020-06-29 21:22:22-07:00,['8160ee11337c5ae820ca11ce298e41972fefc84f'],16,16,32,3068366,6,,,,5915
77fae3affe35a61f6574d042bb2436c58e1bcc89,0,Andrew Musselman,2020-06-29 21:23:23-07:00,['2c2833211d32d2197a6ecc308432428ee5f98df9'],16,16,32,3068398,6,,,,5915
d73e951d9d9925d1f17bca078aa3066df94f68a2,0,Andrew Musselman,2020-06-29 21:32:01-07:00,['77fae3affe35a61f6574d042bb2436c58e1bcc89'],16,16,32,3068430,6,,,,5915
b9c61fb78726cbc11793d67156669124afb9f663,0,Andrew Musselman,2020-06-29 21:32:38-07:00,['d73e951d9d9925d1f17bca078aa3066df94f68a2'],16,16,32,3068462,6,,,,5915
ebb7293e7599e21c18fa33fe874443641256dba9,0,Andrew Musselman,2020-06-29 21:34:15-07:00,['b9c61fb78726cbc11793d67156669124afb9f663'],15,15,30,3068492,6,,,,5915
1173128b7329545e7fbbbc108168277970fc1990,0,Andrew Musselman,2020-06-29 21:43:08-07:00,['ebb7293e7599e21c18fa33fe874443641256dba9'],16,16,32,3068524,6,,,,5915
2d03c001f30a64129136cec006e7a9228e3587d7,0,Andrew Musselman,2020-06-29 21:43:20-07:00,['1173128b7329545e7fbbbc108168277970fc1990'],16,16,32,3068556,6,,,,5915
d6a39569f081ea9e280bc4533469afe0ae044a83,0,Christofer Dutz,2020-07-15 18:33:54+02:00,['c6fabc5814fb633d5d97afdb6ca5aa28e7543336'],24,1,25,3068581,1,,,,5915
9a29ba43ac0e8624c96a2ccf1c25dadd2cdbfa54,0,Andrew Musselman,2020-07-16 09:50:54-07:00,"['2d03c001f30a64129136cec006e7a9228e3587d7', 'd6a39569f081ea9e280bc4533469afe0ae044a83']",25,2,27,3068608,2,,,,5915
72dc2d95fc9e4ca7b1709fb29992b4f5a2571b34,0,Andrew Musselman,2020-07-16 09:58:40-07:00,['9a29ba43ac0e8624c96a2ccf1c25dadd2cdbfa54'],16,16,32,3068640,6,,,,5915
c0a79572b138bd93de957867684b8ca22cc8f560,0,Andrew Musselman,2020-07-16 09:59:27-07:00,['72dc2d95fc9e4ca7b1709fb29992b4f5a2571b34'],16,16,32,3068672,6,,,,5915
81a3fe645bbc1fa2202890e1b70927e7867165a4,0,Andrew Musselman,2020-07-16 10:06:07-07:00,['c0a79572b138bd93de957867684b8ca22cc8f560'],16,16,32,3068704,6,,,,5915
c5ba2201eb055302c14485f5293365d1eeb1277d,0,Andrew Musselman,2020-07-16 10:06:19-07:00,['81a3fe645bbc1fa2202890e1b70927e7867165a4'],16,16,32,3068736,6,,,,5915
487cb14c65e0572a4f46206bec46705616552bb5,0,Andrew Musselman,2020-07-16 10:42:09-07:00,['c5ba2201eb055302c14485f5293365d1eeb1277d'],64,0,64,3068800,1,,,,5915
d7540d9331f3d2d3ebdc447ab1283fc3d24bd801,0,balaShashanka,2020-07-18 01:48:48+05:18,['487cb14c65e0572a4f46206bec46705616552bb5'],0,0,0,3068800,2,,,,5915
fe14445307f11cc915fe5bb8ac0f579f2031d274,0,Christofer Dutz,2020-07-21 08:54:21+02:00,['487cb14c65e0572a4f46206bec46705616552bb5'],1807,5884,7691,3076491,318,,,,5917
b3fa798f32abb89c1f5a3674d5b4df0bdcf153eb,0,GitHub,2020-07-22 15:11:01-05:00,"['487cb14c65e0572a4f46206bec46705616552bb5', 'd7540d9331f3d2d3ebdc447ab1283fc3d24bd801']",0,0,0,3076491,2,,,,5917
afd35700931871cc63ad11176be0a1321c136551,0,rawkintrevo,2020-07-22 15:16:31-05:00,['c6fabc5814fb633d5d97afdb6ca5aa28e7543336'],3,3,6,3076497,2,,,,5917
55ecd35a38cd3bcfe9b4906265fe545970f3ac1e,0,rawkintrevo,2020-07-22 15:16:51-05:00,"['afd35700931871cc63ad11176be0a1321c136551', 'b3fa798f32abb89c1f5a3674d5b4df0bdcf153eb']",88,1,89,3076586,4,,,,5917
81e0f0381171b90994348f6dfcd5d4f3d7248e71,0,Christofer Dutz,2020-07-26 21:58:58+02:00,"['fe14445307f11cc915fe5bb8ac0f579f2031d274', '55ecd35a38cd3bcfe9b4906265fe545970f3ac1e']",2,2,4,3076590,3,,,,5917
21d90502b776840c12b21c711462227be69dc152,0,Christofer Dutz,2020-07-26 22:06:24+02:00,['81e0f0381171b90994348f6dfcd5d4f3d7248e71'],3,17,20,3076610,2,,,,5918
e7dc4aa93bd2913c8d6620cb6845e89861ba9ce4,0,Christofer Dutz,2020-07-28 17:49:21+02:00,['21d90502b776840c12b21c711462227be69dc152'],871,91,962,3077572,45,,,,5918
9af01127cbadca3980c18974c33d1b2dbe8d44c6,0,GitHub,2020-07-29 10:21:17-05:00,"['55ecd35a38cd3bcfe9b4906265fe545970f3ac1e', 'e7dc4aa93bd2913c8d6620cb6845e89861ba9ce4']",2633,5944,8577,3086149,362,,,,5918
50c0e7b05b22e492a985ccb43709f08faa633e0e,0,GitHub,2020-08-07 07:51:18-05:00,['9af01127cbadca3980c18974c33d1b2dbe8d44c6'],0,27,27,3086176,1,,,,5919
1e4e43dab4f09b1da22603a89b57036a3c3b2a6e,0,GitHub,2020-08-07 08:08:00-05:00,['50c0e7b05b22e492a985ccb43709f08faa633e0e'],0,26,26,3086202,1,,,,5920
724c5ac6a1f6dfad428606579271bbc7dba7ff09,0,rawkintrevo,2020-08-07 08:14:03-05:00,['1e4e43dab4f09b1da22603a89b57036a3c3b2a6e'],29,56,85,3086287,3,,,,5921
adb889dcdd1d7aa35ec7660b5005f9312b8c4abc,0,rawkintrevo,2020-08-07 09:18:48-05:00,['724c5ac6a1f6dfad428606579271bbc7dba7ff09'],6,16,22,3086309,2,,,,5921
44249d263560ae291217e638ef573396a29f9d77,0,rawkintrevo,2020-08-07 09:22:24-05:00,['adb889dcdd1d7aa35ec7660b5005f9312b8c4abc'],6,6,12,3086321,2,,,,5921
daca75f6dbc9fd34c4a63cbff51ef920dff21daa,0,rawkintrevo,2020-08-07 09:32:16-05:00,['44249d263560ae291217e638ef573396a29f9d77'],0,2,2,3086323,1,,,,5921
7d3d2c6b6dc75fe05aca51516e75a366f3a2f2cd,0,GitHub,2020-08-07 15:11:10-05:00,['daca75f6dbc9fd34c4a63cbff51ef920dff21daa'],54,55,109,3086432,1,,,,5921
356692d3a0e0304554465c8523b3535c0c6515ef,0,rawkintrevo,2020-09-10 15:23:16-05:00,['7d3d2c6b6dc75fe05aca51516e75a366f3a2f2cd'],0,3109,3109,3089541,4,,,,5925
1fadae0f81bb98025b7b355984eb1f688a30b8fc,0,GitHub,2020-10-10 09:08:46-05:00,['7d3d2c6b6dc75fe05aca51516e75a366f3a2f2cd'],2,4,6,3089547,1,,,,5925
a7a0c82496255482e4b38f74bacbca496cbabac0,0,GitHub,2020-10-10 09:12:55-05:00,['1fadae0f81bb98025b7b355984eb1f688a30b8fc'],5,5,10,3089557,1,,,,5925
8014fa38d214323a784fb19e541b9ef5219397dd,0,GitHub,2020-10-10 09:16:15-05:00,['a7a0c82496255482e4b38f74bacbca496cbabac0'],0,1,1,3089558,1,,,,5925
da7ac056c20fead6abfca6e8517afebd6f07ccbb,0,GitHub,2020-10-10 09:22:46-05:00,['8014fa38d214323a784fb19e541b9ef5219397dd'],0,1,1,3089559,1,,,,5925
4dc63b1ec533a072b7d7f3cd2cef43fcaecc0fd9,0,GitHub,2020-10-10 09:31:10-05:00,['da7ac056c20fead6abfca6e8517afebd6f07ccbb'],1,0,1,3089560,1,,,,5925
51475b62e3e7545dc3b9dc0f28c737a3268941bb,0,GitHub,2020-10-10 09:36:34-05:00,['4dc63b1ec533a072b7d7f3cd2cef43fcaecc0fd9'],2,2,4,3089564,1,,,,5925
5ac7ded2cd7c62f09d90ee5e91ada16bcdc25465,0,GitHub,2020-10-10 09:46:08-05:00,['51475b62e3e7545dc3b9dc0f28c737a3268941bb'],0,27,27,3089591,1,,,,5926
5949c684105a79107683d46d4ae34fbfa5e92754,0,rawkintrevo,2020-10-10 10:03:46-05:00,['356692d3a0e0304554465c8523b3535c0c6515ef'],2,2,4,3089595,2,,,,5926
6f18f3fde4e16a223a84c275b9d95d6d142ead69,0,rawkintrevo,2020-10-10 10:26:56-05:00,['5ac7ded2cd7c62f09d90ee5e91ada16bcdc25465'],295,32,327,3089922,18,,,,5926
487cc358072c68514d2867b4fe1c6a0cf91d835f,0,GitHub,2020-10-10 10:30:20-05:00,"['5ac7ded2cd7c62f09d90ee5e91ada16bcdc25465', '6f18f3fde4e16a223a84c275b9d95d6d142ead69']",295,32,327,3090249,18,,,,5926
581f5ce74b046357c0303e56894f715e69692dbd,0,GitHub,2020-10-13 08:15:00-05:00,['487cc358072c68514d2867b4fe1c6a0cf91d835f'],1,1,2,3090251,1,,,,5926
39875ffd41285381f7d68c0c8fbca722be6b91f1,0,rawkintrevo,2020-10-13 15:18:40-05:00,['6f18f3fde4e16a223a84c275b9d95d6d142ead69'],2055,58,2113,3092364,115,,,,5926
153c9e5787541f20f2273ca6738761267c4ba352,0,GitHub,2020-10-13 15:20:36-05:00,"['581f5ce74b046357c0303e56894f715e69692dbd', '39875ffd41285381f7d68c0c8fbca722be6b91f1']",2055,58,2113,3094477,115,,,,5926
dbdea6ecd0a3f4345b87d3dbe1443b9b75389b64,0,rawkintrevo,2020-10-13 17:19:39-05:00,['39875ffd41285381f7d68c0c8fbca722be6b91f1'],212,5,217,3094694,13,,,,5926
388d585c551342cf26b9fa37866f84b61ee2e180,0,GitHub,2020-10-13 17:20:31-05:00,"['153c9e5787541f20f2273ca6738761267c4ba352', 'dbdea6ecd0a3f4345b87d3dbe1443b9b75389b64']",212,5,217,3094911,13,,,,5926
d041b3fcec7e0b973f0b411bf49fb28719233eca,0,GitHub,2020-10-14 03:58:50-04:00,['388d585c551342cf26b9fa37866f84b61ee2e180'],18,18,36,3094947,1,,,,5926
7acc8640788d71ffdc1bd132f560152cfa27abe5,0,GitHub,2020-10-14 13:52:56-05:00,"['388d585c551342cf26b9fa37866f84b61ee2e180', 'd041b3fcec7e0b973f0b411bf49fb28719233eca']",18,18,36,3094983,1,,,,5926
89487c9c07e564a3d4e959782544a6c93b99dd0a,0,Lewis John McGibbney,2020-10-14 15:34:00-07:00,['7acc8640788d71ffdc1bd132f560152cfa27abe5'],1,1,2,3094985,1,,,,5926
6e0f3a0351d334082378963c4b0e1bf13abfd1fb,0,GitHub,2020-10-14 17:38:02-05:00,"['7acc8640788d71ffdc1bd132f560152cfa27abe5', '89487c9c07e564a3d4e959782544a6c93b99dd0a']",1,1,2,3094987,1,,,,5926
99fcd24765f45660b833547f649c03ca56d4c18e,0,rawkintrevo,2020-10-19 11:24:11-05:00,['5949c684105a79107683d46d4ae34fbfa5e92754'],3,952,955,3095942,6,,,,5930
6e878595d6e5730e2a4af128a820b8a2052b4bfc,0,GitHub,2020-10-20 07:01:31-05:00,['6e0f3a0351d334082378963c4b0e1bf13abfd1fb'],2,1,3,3095945,1,,,,5930
18f5695347fa4a05baa70657c33268fe3047bcd3,0,rawkintrevo,2020-10-23 14:37:52-05:00,['99fcd24765f45660b833547f649c03ca56d4c18e'],0,0,0,3095945,1,,,,5930
7b70ba721ddcd96b5b429d5ff8feca6d102c5e45,0,rawkintrevo,2020-10-23 14:39:04-05:00,['18f5695347fa4a05baa70657c33268fe3047bcd3'],2,2,4,3095949,1,,,,5930
c00d6b407c7e9c163f80e25c437bd950d0602551,0,GitHub,2020-10-23 14:40:09-05:00,['6e878595d6e5730e2a4af128a820b8a2052b4bfc'],2,2,4,3095953,1,,,,5930
8263ad8a7d4ab6d32e809b156572e23129a4e335,0,GitHub,2020-10-23 14:40:55-05:00,"['c00d6b407c7e9c163f80e25c437bd950d0602551', '7b70ba721ddcd96b5b429d5ff8feca6d102c5e45']",0,4058,4058,3100011,8,,,,5930
b6f822604e7d89fe094c527ecadfb85400c05884,0,rawkintrevo,2020-10-30 12:20:16-05:00,['dbdea6ecd0a3f4345b87d3dbe1443b9b75389b64'],0,26,26,3100037,1,,,,5931
fc96a7228e14f9044dd0c9709ab12fa1b33d08f3,0,GitHub,2020-10-30 12:48:16-05:00,"['8263ad8a7d4ab6d32e809b156572e23129a4e335', 'b6f822604e7d89fe094c527ecadfb85400c05884']",0,26,26,3100063,1,,,,5931
fa3a7ccc8906a4349732aaec7c0ef321625bb0bd,0,rawkintrevo,2020-11-06 12:45:58-06:00,['b6f822604e7d89fe094c527ecadfb85400c05884'],0,27,27,3100090,1,,,,5932
2dff2c26a974684fe6c11fbe36057587fec769e4,0,rawkintrevo,2020-11-06 12:46:18-06:00,"['fa3a7ccc8906a4349732aaec7c0ef321625bb0bd', 'fc96a7228e14f9044dd0c9709ab12fa1b33d08f3']",24,4081,4105,3104195,12,,,,5932
22670e6728c2370fa3c0cd64be5216e01a159592,0,rawkintrevo,2020-11-06 12:54:51-06:00,['2dff2c26a974684fe6c11fbe36057587fec769e4'],1,4,5,3104200,1,,,,5932
749c9402dff82b071439fc776298007ecaa8c07d,0,rawkintrevo,2020-11-13 12:16:12-06:00,['22670e6728c2370fa3c0cd64be5216e01a159592'],0,29,29,3104229,1,,,,5933
54d7c513477d6c39d43b3a9676cf9827e3b9b3c4,0,rawkintrevo,2020-11-20 12:10:55-06:00,['749c9402dff82b071439fc776298007ecaa8c07d'],0,12,12,3104241,1,,,,5934
86ae61ee30f6407b3b8702d9f9f49048a8d9b883,0,rawkintrevo,2020-12-13 10:12:20-06:00,['54d7c513477d6c39d43b3a9676cf9827e3b9b3c4'],0,19,19,3104260,1,,,,5935
a5eb73b1511eb4b0289370104f786eadbfbf8490,0,rawkintrevo,2020-12-15 16:23:52-06:00,['86ae61ee30f6407b3b8702d9f9f49048a8d9b883'],2,12,14,3104274,2,,,,5936
792a5c2d14cec143103fd2c2ff30df43cfc8581a,0,rawkintrevo,2021-01-05 16:44:58-06:00,['a5eb73b1511eb4b0289370104f786eadbfbf8490'],0,17,17,3104291,1,,,,5937
784929d778a8f06038673a8eb98bd46fee41c091,0,rawkintrevo,2021-01-06 14:48:27-06:00,['792a5c2d14cec143103fd2c2ff30df43cfc8581a'],0,0,0,3104291,1,,,,5937
1946a67ea5423bdade1047cc00f0a76e5d990840,0,GitHub,2021-01-06 15:00:36-06:00,"['54d7c513477d6c39d43b3a9676cf9827e3b9b3c4', '784929d778a8f06038673a8eb98bd46fee41c091']",0,46,46,3104337,3,,,,5937
63003110e6ca3e3c0820b6012a4f97b1ced9982e,0,Jose Francisco Hernandez Santa Cruz,2021-01-20 17:29:35-05:00,['1946a67ea5423bdade1047cc00f0a76e5d990840'],0,60,60,3104397,1,,,,5938
5b8b7f4c92b1586db59d415a674ea44f96ae5f28,0,Jose Francisco Hernandez Santa Cruz,2021-01-25 10:46:10-05:00,['63003110e6ca3e3c0820b6012a4f97b1ced9982e'],887,201,1088,3105485,5,1,1,1,5940
6ca38dfbd8636a037c430decf00b49e471676809,0,GitHub,2021-01-25 10:48:28-05:00,['5b8b7f4c92b1586db59d415a674ea44f96ae5f28'],60,0,60,3105545,1,,,,5940
2f04afa9e37e9ced724d3d4656f33eccf8b05058,0,Jose Francisco Hernandez Santa Cruz,2021-01-27 12:53:27-05:00,['5b8b7f4c92b1586db59d415a674ea44f96ae5f28'],97,14,111,3105656,4,,,,5940
c1444718a5c1ed251089f5149a0758a3430865f7,0,Jose Francisco Hernandez Santa Cruz,2021-01-27 12:57:56-05:00,"['2f04afa9e37e9ced724d3d4656f33eccf8b05058', '6ca38dfbd8636a037c430decf00b49e471676809']",0,0,0,3105656,0,,,,5940
1f9dbcc97c7e299a2f7f5ece70114f38f4b6656e,0,Jose Francisco Hernandez Santa Cruz,2021-01-27 19:14:00-05:00,['c1444718a5c1ed251089f5149a0758a3430865f7'],1,0,1,3105657,1,,,,5940
80b6fe5506fe48b06b63d121d8ecb15a471111b3,0,GitHub,2021-01-28 08:42:03-06:00,"['1946a67ea5423bdade1047cc00f0a76e5d990840', '1f9dbcc97c7e299a2f7f5ece70114f38f4b6656e']",887,177,1064,3106721,5,,,,5940
9bd2038fdd7d72d084c977330b6cafa6915bccee,0,GitHub,2021-02-02 13:30:40-06:00,['80b6fe5506fe48b06b63d121d8ecb15a471111b3'],39,0,39,3106760,1,,,,5940
7bd77c8490a27372a6e57ce2f58a1bf3035aa9b5,0,GitHub,2021-02-02 13:32:48-06:00,['9bd2038fdd7d72d084c977330b6cafa6915bccee'],7,5,12,3106772,1,,,,5940
d12164ecd8458bf20b337bcbe399b38ef7fdda34,0,GitHub,2021-02-02 13:40:05-06:00,['7bd77c8490a27372a6e57ce2f58a1bf3035aa9b5'],1,1,2,3106774,1,,,,5940
9453f2046e47d1612d4433479a2b3b66e0a42411,0,GitHub,2021-02-02 13:45:13-06:00,['d12164ecd8458bf20b337bcbe399b38ef7fdda34'],1,3,4,3106778,1,,,,5940
f85872168bd1521ec3f900db11ba889e1e55f34d,0,GitHub,2021-02-02 13:55:54-06:00,['9453f2046e47d1612d4433479a2b3b66e0a42411'],1,3,4,3106782,1,,,,5940
8b3ff0051613fceee64c1c174b423e39c1070588,0,GitHub,2021-02-02 14:01:24-06:00,['f85872168bd1521ec3f900db11ba889e1e55f34d'],0,2,2,3106784,1,,,,5940
ad56ec44705e907a3f7f7c9ee6132f83c9d4b74a,0,rawkintrevo,2021-02-02 16:13:45-06:00,['8b3ff0051613fceee64c1c174b423e39c1070588'],0,18,18,3106802,1,,,,5941
f901cf84c364b3c71c3be18a4c2f64496582db3c,0,Trevor Grant,2021-06-01 12:52:29-05:00,['ad56ec44705e907a3f7f7c9ee6132f83c9d4b74a'],1,1,2,3106804,1,,,,5941
23c4aa0037be6cf31d63f2264faec7460fd02404,0,Trevor Grant,2021-06-01 12:59:06-05:00,['f901cf84c364b3c71c3be18a4c2f64496582db3c'],1,1,2,3106806,1,,,,5941
6dab5802de0e3819954b7d00dd7e01015ba1c349,0,Trevor Grant,2021-06-01 13:17:13-05:00,['ad56ec44705e907a3f7f7c9ee6132f83c9d4b74a'],24,30,54,3106860,3,,,,5942
2107c9574fbf6d38bca5786b77d5fb8ea8be080a,0,GitHub,2021-06-04 10:27:55-05:00,"['ad56ec44705e907a3f7f7c9ee6132f83c9d4b74a', '23c4aa0037be6cf31d63f2264faec7460fd02404']",1,1,2,3106862,1,,,,5942
51c405f7779d40ebeadf3fc72b1292bbb6b740ac,0,GitHub,2021-06-04 10:28:15-05:00,"['2107c9574fbf6d38bca5786b77d5fb8ea8be080a', '6dab5802de0e3819954b7d00dd7e01015ba1c349']",24,30,54,3106916,3,,,,5942
293fe719775fbf47de4cc019067d1eba9560c1d7,0,Trevor Grant,2021-06-04 10:48:16-05:00,['6dab5802de0e3819954b7d00dd7e01015ba1c349'],3,7,10,3106926,5,,,,5942
6588ded691b68b9cd1d21b9b1ef1fa0c9bff4191,0,GitHub,2021-06-04 10:50:04-05:00,"['51c405f7779d40ebeadf3fc72b1292bbb6b740ac', '293fe719775fbf47de4cc019067d1eba9560c1d7']",3,7,10,3106936,5,,,,5942
