sha,is_bug,committer_name,commit_time,parents,all_del,all_add,all_change_lines,all_lines,files_change_nums,dmm_unit_size,dmm_unit_complexity,dmm_unit_interfacing,file_nums
4d998c12c95a6e5ce3d66c0d861e75e33b5cf013,1,joewitt,2014-12-08 15:22:14-05:00,[],0,350029,350029,350029,2352,0.512521681,0.654228173,0.847974195,2352
c3ba275c63a05de14ed0fb0055b948697ccb05c5,1,Matt Gilman,2014-12-09 08:17:31-05:00,['4d998c12c95a6e5ce3d66c0d861e75e33b5cf013'],11,22,33,350062,1,1,1,1,2352
203e83ee0da20e2357900dcbe543d21f44e801c4,0,Matt Gilman,2014-12-09 08:20:42-05:00,['c3ba275c63a05de14ed0fb0055b948697ccb05c5'],0,1,1,350063,1,,,,2352
567dfc794c565854850b7e223601528f2a3fd814,1,Mark Payne,2014-12-09 08:48:07-05:00,['203e83ee0da20e2357900dcbe543d21f44e801c4'],0,209,209,350272,4,0.133333333,0.133333333,1,2355
0125f3da3fd0482d4b79e58d977105e1fc034014,1,Matt Gilman,2014-12-09 09:52:11-05:00,['203e83ee0da20e2357900dcbe543d21f44e801c4'],0,9,9,350281,2,,,,2355
4410b7072cfe0daba72a45b6a82e9e5b04dbcaff,0,joewitt,2014-12-09 10:08:57-05:00,['0125f3da3fd0482d4b79e58d977105e1fc034014'],0,0,0,350281,0,,,,2355
cb63c66602a398b0c14cc78732db5ca63e36a94c,0,Mark Payne,2014-12-09 11:20:13-05:00,"['567dfc794c565854850b7e223601528f2a3fd814', '0125f3da3fd0482d4b79e58d977105e1fc034014']",0,9,9,350290,2,,,,2355
1120b0f1abaa1a1a83079b370bc5618885fe4313,1,Matt Gilman,2014-12-09 12:13:26-05:00,['0125f3da3fd0482d4b79e58d977105e1fc034014'],16,33,49,350339,1,1,1,1,2355
646570490c530d0c076c9bd9b7d1170946a9dae8,1,Mark Payne,2014-12-09 12:18:35-05:00,['cb63c66602a398b0c14cc78732db5ca63e36a94c'],18,824,842,351181,8,0.286937901,0.509635974,0.989293362,2359
457787cde08b8d785948713b435d38f816e686da,1,Matt Gilman,2014-12-09 12:42:55-05:00,['1120b0f1abaa1a1a83079b370bc5618885fe4313'],17,1,18,351199,1,0,0,1,2359
eed4a9bb810ceb5a366009c8379b06ed80b833f3,1,Mark Payne,2014-12-09 13:51:15-05:00,['646570490c530d0c076c9bd9b7d1170946a9dae8'],8,79,87,351286,5,0.470588235,0.470588235,1,2363
e544191f1d59dbaf9aec6e1bd708bbe013c6661a,1,Mark Payne,2014-12-09 14:37:31-05:00,['eed4a9bb810ceb5a366009c8379b06ed80b833f3'],10,17,27,351313,2,0,0,1,2363
61c5cb377370e7d5265cce405b42adeafecb1018,0,Matt Gilman,2014-12-09 15:18:52-05:00,['457787cde08b8d785948713b435d38f816e686da'],40,40,80,351393,3,,,,2363
63e80d3fdc62034d445c1d5725af8c83e221a74a,0,Matt Gilman,2014-12-09 15:33:21-05:00,['61c5cb377370e7d5265cce405b42adeafecb1018'],15,14,29,351422,1,0,0,0,2363
386144695831197aef7f1448350be60efbdf1f2f,0,Matt Gilman,2014-12-09 15:58:32-05:00,['63e80d3fdc62034d445c1d5725af8c83e221a74a'],11,15,26,351448,2,0,0,1,2363
c55e8510891c0e2eeb25a0b32fd574ae71aa8a7c,0,joewitt,2014-12-09 20:59:30-05:00,"['4410b7072cfe0daba72a45b6a82e9e5b04dbcaff', '386144695831197aef7f1448350be60efbdf1f2f']",99,103,202,351650,7,,,,2363
51d177b2426e4940134069c28d8d7f70c473a353,0,joewitt,2014-12-10 07:09:18-05:00,['c55e8510891c0e2eeb25a0b32fd574ae71aa8a7c'],1,25,26,351676,1,0,1,1,2363
2735c6c253483fb72f5ec946264f321392950b72,1,joewitt,2014-12-10 07:38:12-05:00,['51d177b2426e4940134069c28d8d7f70c473a353'],2,14,16,351692,1,,,,2363
0ded44245ee9dd86f39ad8b42dddc9be69baf537,0,Matt Gilman,2014-12-10 08:35:31-05:00,['2735c6c253483fb72f5ec946264f321392950b72'],1272,17,1289,352981,12,0.09948542,0.430531732,0.118353345,2364
6d46829795196afc797448cc386783fb147c0a7d,1,Mark Payne,2014-12-10 09:23:51-05:00,['e544191f1d59dbaf9aec6e1bd708bbe013c6661a'],33,144,177,353158,6,0.183098592,0.225352113,0.929577465,2365
eb880757b244858e984822abeef265c9e082ca69,0,Matt Gilman,2014-12-10 10:12:43-05:00,['0ded44245ee9dd86f39ad8b42dddc9be69baf537'],5343,6144,11487,364645,25,0.051724138,0.210727969,0.844827586,2369
192d7822772752cb939921af1610476c8e7dcfda,1,Mark Payne,2014-12-10 11:03:21-05:00,['6d46829795196afc797448cc386783fb147c0a7d'],211,130,341,364986,12,0,0.133333333,0,2369
5ebf3b51cd7a51ed52ac38c37797b5268129d633,0,Mark Payne,2014-12-10 11:08:10-05:00,"['cb63c66602a398b0c14cc78732db5ca63e36a94c', '2735c6c253483fb72f5ec946264f321392950b72']",102,142,244,365230,9,,,,2369
cce36335e1d22a6664d907c55e617d8807bcee90,0,Mark Payne,2014-12-10 11:08:55-05:00,"['5ebf3b51cd7a51ed52ac38c37797b5268129d633', '192d7822772752cb939921af1610476c8e7dcfda']",222,1136,1358,366588,20,,,,2369
fef80713600d87e4bf984f4d090e18dafecae574,0,Matt Gilman,2014-12-10 11:26:27-05:00,['eb880757b244858e984822abeef265c9e082ca69'],5462,42,5504,372092,3,0.146955504,0.246291959,0.120804059,2369
8254b75437a5b5a168259c7e46460ee3a7bc52f0,1,Mark Payne,2014-12-10 11:47:00-05:00,['cce36335e1d22a6664d907c55e617d8807bcee90'],20,96,116,372208,3,0.846153846,0.846153846,1,2370
97f8ab0cc50f77a2ff3a4e9d575ec05c185e5b80,0,Mark Payne,2014-12-10 11:57:33-05:00,['8254b75437a5b5a168259c7e46460ee3a7bc52f0'],6,26,32,372240,2,0,0,0,2370
f63cd9a15ee42715ff0b70873f30f3954242a957,1,Mark Payne,2014-12-10 12:17:32-05:00,['97f8ab0cc50f77a2ff3a4e9d575ec05c185e5b80'],1,5,6,372246,1,0,0,1,2370
f60a97b0262fdd9d753130eb81b48e9326eda3dc,1,Mark Payne,2014-12-10 12:17:55-05:00,['f63cd9a15ee42715ff0b70873f30f3954242a957'],0,22,22,372268,1,0,1,1,2370
57b4178f19960bb4359d79f462c6e790e3e8f1a1,0,Matt Gilman,2014-12-10 12:19:26-05:00,['f60a97b0262fdd9d753130eb81b48e9326eda3dc'],1272,17,1289,373557,12,0.09948542,0.430531732,0.118353345,2371
53f440609bb395393b7fb58e43c06e1fb6f53b30,0,Matt Gilman,2014-12-10 12:19:26-05:00,['57b4178f19960bb4359d79f462c6e790e3e8f1a1'],5343,6144,11487,385044,25,0.051724138,0.210727969,0.844827586,2375
b61a1defa9d9b784491ab802c62381662a5cc719,0,Matt Gilman,2014-12-10 12:19:26-05:00,['53f440609bb395393b7fb58e43c06e1fb6f53b30'],5462,42,5504,390548,3,0.146955504,0.246291959,0.120804059,2375
cb2e855fc7c42536887b055baadf93683d764a47,0,Mark Payne,2014-12-10 12:49:31-05:00,['f60a97b0262fdd9d753130eb81b48e9326eda3dc'],9,17,26,390574,2,0,1,1,2375
9180b7d4a1c05200cddeb946da120643c627037a,0,Matt Gilman,2014-12-10 12:56:04-05:00,['b61a1defa9d9b784491ab802c62381662a5cc719'],9190,228,9418,399992,8,0.525659245,0.546660351,0.344386547,2376
2f2474efbc20f07a5ee2ce10ce48954f4854146e,0,Matt Gilman,2014-12-10 12:58:18-05:00,"['9180b7d4a1c05200cddeb946da120643c627037a', 'fef80713600d87e4bf984f4d090e18dafecae574']",0,0,0,399992,0,,,,2376
fe2a331820ea75e88891a5888365be6eb281c783,0,Matt Gilman,2014-12-10 14:27:11-05:00,['cb2e855fc7c42536887b055baadf93683d764a47'],24,16,40,400032,5,1,1,0,2376
658131de13d3a571d2a764600d7fa5b3f85e8e5f,0,Matt Gilman,2014-12-10 14:36:33-05:00,['fe2a331820ea75e88891a5888365be6eb281c783'],1272,17,1289,401321,12,0.09948542,0.430531732,0.118353345,2377
4c959f72988d13dc2ff54d38eb9efc4682d5b901,0,Matt Gilman,2014-12-10 14:36:34-05:00,['658131de13d3a571d2a764600d7fa5b3f85e8e5f'],5343,6144,11487,412808,25,0.051724138,0.210727969,0.844827586,2381
8a0e2cee4a2ccdf0f253922a3f900409821e4776,0,Matt Gilman,2014-12-10 14:36:35-05:00,['4c959f72988d13dc2ff54d38eb9efc4682d5b901'],5462,42,5504,418312,3,0.146955504,0.246291959,0.120804059,2381
1d23e6e13625a6ce4ae40b71c06d9ae42d771b48,0,Matt Gilman,2014-12-10 14:36:44-05:00,['8a0e2cee4a2ccdf0f253922a3f900409821e4776'],9190,228,9418,427730,8,0.525659245,0.546660351,0.344386547,2382
82e42fad03d706092406e2f62c963da8cbffe1ba,1,Mark Payne,2014-12-10 14:39:59-05:00,['cb2e855fc7c42536887b055baadf93683d764a47'],17,28,45,427775,6,,,,2382
d89ba7392f6aa8eb972cee07dc7ed755c983586f,0,Mark Payne,2014-12-10 14:40:18-05:00,"['82e42fad03d706092406e2f62c963da8cbffe1ba', 'fe2a331820ea75e88891a5888365be6eb281c783']",24,16,40,427815,5,,,,2382
5b0d8a5dc1f7a69d92f42e7d99fe4a84c290845f,0,Matt Gilman,2014-12-10 14:42:01-05:00,"['1d23e6e13625a6ce4ae40b71c06d9ae42d771b48', '2f2474efbc20f07a5ee2ce10ce48954f4854146e']",0,0,0,427815,0,,,,2382
8ed8d69899bbb97ebff0f4c74ff358bd03ee900c,0,joewitt,2014-12-10 23:33:13-05:00,['d89ba7392f6aa8eb972cee07dc7ed755c983586f'],1,3,4,427819,1,,,,2382
6b0a5e8cd75a03a13ca90b08204bccc2a45bee70,1,Mark Payne,2014-12-11 09:03:05-05:00,['8ed8d69899bbb97ebff0f4c74ff358bd03ee900c'],66,232,298,428117,3,0.141732283,0.125984252,0.937007874,2382
cbea1f193620f934d6186d167d0c0fe0723fad7c,1,Mark Payne,2014-12-11 09:16:48-05:00,['6b0a5e8cd75a03a13ca90b08204bccc2a45bee70'],1,70,71,428188,2,0.283018868,0.981132075,1,2382
74c79404873b27cc1eea78d74ff05b5492988ec6,0,Mark Payne,2014-12-11 09:44:38-05:00,['cbea1f193620f934d6186d167d0c0fe0723fad7c'],48,52,100,428288,1,1,1,0,2382
2bcd1e657a5a959fad6572b011924f07d995abe8,0,Mark Payne,2014-12-11 09:45:24-05:00,['74c79404873b27cc1eea78d74ff05b5492988ec6'],3,28,31,428319,1,0,1,1,2382
d517b3fd0932676edddfa2cfbacb320b6142e882,1,Mark Payne,2014-12-11 13:40:56-05:00,['2bcd1e657a5a959fad6572b011924f07d995abe8'],63,387,450,428769,4,0.208333333,0.4125,0.975,2382
f1baec6b66d0bf6e02db7e538b54d92d88a551d2,0,joewitt,2014-12-11 13:52:49-05:00,['2bcd1e657a5a959fad6572b011924f07d995abe8'],0,1,1,428770,1,,,,2382
52eadeba1827e462f34bd6b6df79f88859091ef2,0,joewitt,2014-12-11 13:54:25-05:00,['f1baec6b66d0bf6e02db7e538b54d92d88a551d2'],18,0,18,428788,1,,,,2382
71e53ae5664d04c0410e35b098808c0b45d97a28,1,Matt Gilman,2014-12-11 16:02:44-05:00,['5b0d8a5dc1f7a69d92f42e7d99fe4a84c290845f'],18987,16272,35259,464047,52,0.131864407,0.936610169,0.799322034,2401
76f54f86115e42d16f700aa0d1c5bce22f830734,1,Mark Payne,2014-12-12 09:47:19-05:00,['d517b3fd0932676edddfa2cfbacb320b6142e882'],39,332,371,464418,9,0.658536585,0.756097561,0.865853659,2403
55d4b1c09990a9cff8a235fe65a0056879e6355a,0,Mark Payne,2014-12-12 10:00:40-05:00,['2bcd1e657a5a959fad6572b011924f07d995abe8'],0,21,21,464439,4,0.7,0.7,1,2403
8cf0c7814e7c3b451ba58eb97b8e93a3ce518ed6,0,Mark Payne,2014-12-12 10:01:17-05:00,"['76f54f86115e42d16f700aa0d1c5bce22f830734', '55d4b1c09990a9cff8a235fe65a0056879e6355a']",0,21,21,464460,4,,,,2403
2a2f0f036434c0fa2dd0f6af67e6cf13b0b3183e,1,Mark Payne,2014-12-12 10:18:14-05:00,['8cf0c7814e7c3b451ba58eb97b8e93a3ce518ed6'],0,5,5,464465,1,0,0,1,2403
d57861d8b5283483b5721f5c4be3ce285ea6bcf4,0,Mark Payne,2014-12-12 10:19:20-05:00,['55d4b1c09990a9cff8a235fe65a0056879e6355a'],0,6,6,464471,2,1,1,1,2403
67354bd31cafe1b646e9a4102c251c0772ef39af,0,Mark Payne,2014-12-12 10:25:39-05:00,"['52eadeba1827e462f34bd6b6df79f88859091ef2', 'd57861d8b5283483b5721f5c4be3ce285ea6bcf4']",0,27,27,464498,6,,,,2403
d1271a281e79a714a1c098465e29ef2925675e2b,0,Mark Payne,2014-12-12 10:31:50-05:00,"['2a2f0f036434c0fa2dd0f6af67e6cf13b0b3183e', '67354bd31cafe1b646e9a4102c251c0772ef39af']",18,7,25,464523,4,,,,2403
68e0898399f7a8165fc35fb31157db9763519382,0,Matt Gilman,2014-12-12 10:34:56-05:00,['71e53ae5664d04c0410e35b098808c0b45d97a28'],8,33,41,464564,3,0.833333333,1,1,2403
d307a13c5d4610dd3aa8bdeacab850725bedeb7d,0,Matt Gilman,2014-12-12 10:37:02-05:00,['68e0898399f7a8165fc35fb31157db9763519382'],1,7,8,464572,2,0.833333333,1,1,2403
a8722317abdbf28e86d3d4ed91e18d2f3ac2a40a,0,Mark Payne,2014-12-12 11:09:52-05:00,['67354bd31cafe1b646e9a4102c251c0772ef39af'],1,1,2,464574,1,,,,2403
bc94625142163d60af7aad27ec9de11b79c2ba21,1,Mark Payne,2014-12-12 12:02:49-05:00,['a8722317abdbf28e86d3d4ed91e18d2f3ac2a40a'],1,47,48,464622,1,0,0,1,2403
21c24b6b68ffa4991bd9a15205adb2eb1a71e862,0,joewitt,2014-12-13 20:46:44-05:00,['bc94625142163d60af7aad27ec9de11b79c2ba21'],2,2,4,464626,1,,,,2403
9ccbf8be7bb4385c39905911a659b59fb6b34994,0,joewitt,2014-12-13 20:50:53-05:00,['21c24b6b68ffa4991bd9a15205adb2eb1a71e862'],2,19,21,464647,1,,,,2403
19d4a150a875e0862d458e03ffb413797f2bf81b,1,joewitt,2014-12-15 05:14:32-05:00,['9ccbf8be7bb4385c39905911a659b59fb6b34994'],1811,2451,4262,468909,157,0.50273224,0.836065574,0.956284153,2415
dd57a33500101756d0cf601e1d3d655e6a127033,0,joewitt,2014-12-15 05:52:40-05:00,['19d4a150a875e0862d458e03ffb413797f2bf81b'],843,0,843,469752,4,0.49726776,0.163934426,0.043715847,2415
675ea6611c3e941df05f88dacb6c691bd9712206,0,joewitt,2014-12-15 05:53:03-05:00,['dd57a33500101756d0cf601e1d3d655e6a127033'],0,7,7,469759,2,,,,2415
614349bdfdb4b73509d6c9384b9094aefc41d7a8,1,joewitt,2014-12-15 10:43:07-05:00,['675ea6611c3e941df05f88dacb6c691bd9712206'],13,177,190,469949,6,,,,2415
fc78752e61fcf82b8a39dbb12bd4a3ff4ce21cb6,0,Matt Gilman,2014-12-15 12:02:15-05:00,['d307a13c5d4610dd3aa8bdeacab850725bedeb7d'],20,29,49,469998,3,0,0,0,2415
1a231d8b9599d6ff3aeddb97392acec1b885be70,1,Mark Payne,2014-12-15 13:04:54-05:00,['d1271a281e79a714a1c098465e29ef2925675e2b'],41,39,80,470078,1,,,,2415
73cc6cbe284faab9a91b4816197a105524b1df41,0,Mark Payne,2014-12-15 13:09:08-05:00,['9ccbf8be7bb4385c39905911a659b59fb6b34994'],1,1,2,470080,1,,,,2415
e04a55d3a5097d1ae3ff5c5a4c8f8ad1e1dc56b9,1,Mark Payne,2014-12-15 13:14:42-05:00,['73cc6cbe284faab9a91b4816197a105524b1df41'],32,40,72,470152,1,0,0,0,2415
f0bea5c156fa0bfc1d7773ae45ea73ba594ba77a,0,Mark Payne,2014-12-15 13:21:59-05:00,['e04a55d3a5097d1ae3ff5c5a4c8f8ad1e1dc56b9'],1,1,2,470154,1,,,,2415
13160429777e6a48a7833174a99f2771c11649ed,0,Mark Payne,2014-12-15 13:28:09-05:00,['e04a55d3a5097d1ae3ff5c5a4c8f8ad1e1dc56b9'],1,1,2,470156,1,,,,2415
ddfa621dab4f6614e426314e0685106586e08c9f,0,Mark Payne,2014-12-15 13:29:35-05:00,"['13160429777e6a48a7833174a99f2771c11649ed', 'f0bea5c156fa0bfc1d7773ae45ea73ba594ba77a']",0,0,0,470156,0,,,,2415
9e60aa0f25754751d468ef9cd3da428055c08b4e,0,Mark Payne,2014-12-15 13:53:12-05:00,['ddfa621dab4f6614e426314e0685106586e08c9f'],0,59,59,470215,1,1,1,1,2416
1cc3ce57556eb7cf9a5f94b269eb24b284e518eb,1,Mark Payne,2014-12-15 14:28:11-05:00,['9e60aa0f25754751d468ef9cd3da428055c08b4e'],17,41,58,470273,3,0.666666667,0.666666667,1,2416
ece5ce1409925bdb5a4e02476413d67d2d11ea6e,0,Mark Payne,2014-12-15 14:57:11-05:00,['1cc3ce57556eb7cf9a5f94b269eb24b284e518eb'],23,62,85,470358,1,0.620689655,0.620689655,1,2416
77971847129133bef0d9340e44b23c8d352be303,0,Mark Payne,2014-12-15 15:02:44-05:00,['ece5ce1409925bdb5a4e02476413d67d2d11ea6e'],1,1,2,470360,1,,,,2416
3a4c6ed887cd2e13aa861ed99028de33678bcbe8,0,joewitt,2014-12-16 08:16:52-05:00,"['614349bdfdb4b73509d6c9384b9094aefc41d7a8', '1cc3ce57556eb7cf9a5f94b269eb24b284e518eb']",51,142,193,470553,7,,,,2416
2965258e5da192b8a54dc36f84089be90bc0f1f7,1,Matt Gilman,2014-12-16 08:42:13-05:00,['fc78752e61fcf82b8a39dbb12bd4a3ff4ce21cb6'],18072,719,18791,489344,76,0.572781866,0.472553497,0.083312188,2417
888d1bafc784e6052b14c4e35f1e1c63c246f743,0,Matt Gilman,2014-12-16 09:40:56-05:00,['2965258e5da192b8a54dc36f84089be90bc0f1f7'],96,80,176,489520,4,0,0,0,2417
f10bb3ccade86247b44fe3a1905af94754ab54eb,0,Matt Gilman,2014-12-16 09:44:24-05:00,"['888d1bafc784e6052b14c4e35f1e1c63c246f743', '1cc3ce57556eb7cf9a5f94b269eb24b284e518eb']",210,651,861,490381,27,,,,2417
8fb78d2a5862c7b147e652c1d69c0ba58b10c226,0,joewitt,2014-12-16 10:38:59-05:00,['3a4c6ed887cd2e13aa861ed99028de33678bcbe8'],8,11,19,490400,2,,,,2417
a016bf47bdb778fd436544bd445c1c031aeefb7b,0,Matt Gilman,2014-12-16 11:12:15-05:00,['f10bb3ccade86247b44fe3a1905af94754ab54eb'],152,140,292,490692,2,,,,2417
d7b1113a86a8ed52aa2a7f907d89ab8b8a730c73,0,Matt Gilman,2014-12-16 11:25:25-05:00,['a016bf47bdb778fd436544bd445c1c031aeefb7b'],601,826,1427,492119,6,0,0.357285429,0.127744511,2417
d9dab00612521ba5dd49d8b78c6593b082834c3f,0,joewitt,2014-12-16 11:46:37-05:00,['8fb78d2a5862c7b147e652c1d69c0ba58b10c226'],1,1,2,492121,1,,,,2417
a94cf4be4b339bf520517d2d00390f8bc3b249e1,0,joewitt,2014-12-16 12:53:40-05:00,"['d9dab00612521ba5dd49d8b78c6593b082834c3f', 'd7b1113a86a8ed52aa2a7f907d89ab8b8a730c73']",42974,8307,51281,543402,158,,,,2417
c1681d95f690a971e9a54e424e77661124077c9d,0,Mark Payne,2014-12-16 14:36:38-05:00,['1a231d8b9599d6ff3aeddb97392acec1b885be70'],1,6,7,543409,1,0,1,1,2417
575cc42c72282b24d9a52c666a5934dbd666b116,0,Mark Payne,2014-12-16 15:10:20-05:00,"['a94cf4be4b339bf520517d2d00390f8bc3b249e1', 'c1681d95f690a971e9a54e424e77661124077c9d']",124,749,873,544282,10,,,,2417
15d7031ebda7faa6a2297ddf090c3ea0b17a32fb,0,Matt Gilman,2014-12-16 15:34:39-05:00,['a94cf4be4b339bf520517d2d00390f8bc3b249e1'],5,8,13,544295,1,1,1,1,2417
c2bb1fd5ba1ef4ef0e7c5b6f3b5fe6a1570947d9,0,Matt Gilman,2014-12-16 15:35:44-05:00,"['15d7031ebda7faa6a2297ddf090c3ea0b17a32fb', '575cc42c72282b24d9a52c666a5934dbd666b116']",124,749,873,545168,10,,,,2417
9c2c399198a3faf5f6392740b23086cebfe7037c,0,joewitt,2014-12-16 16:41:41-05:00,['575cc42c72282b24d9a52c666a5934dbd666b116'],5,13,18,545186,4,1,1,1,2417
fdce4f5b1a630e0bd06d479bf3afd40e7ffe7f2a,0,joewitt,2014-12-16 18:20:08-05:00,['9c2c399198a3faf5f6392740b23086cebfe7037c'],2,2,4,545190,1,,,,2417
1b23671eb34ef8ce1835f32f19986c6b854b470e,0,joewitt,2014-12-16 21:21:08-05:00,"['fdce4f5b1a630e0bd06d479bf3afd40e7ffe7f2a', 'c2bb1fd5ba1ef4ef0e7c5b6f3b5fe6a1570947d9']",5,8,13,545203,1,,,,2417
fe3d1a4ca29d1794cfe9efbfdf5b9bb0784336a8,0,joewitt,2014-12-16 23:37:55-05:00,['1b23671eb34ef8ce1835f32f19986c6b854b470e'],0,2,2,545205,1,,,,2417
621b7f41cb6763d40bfc58588186a77781b5608e,0,Matt Gilman,2014-12-17 07:21:20-05:00,['fe3d1a4ca29d1794cfe9efbfdf5b9bb0784336a8'],1,3,4,545209,1,0,1,1,2417
9c08118f5718d21320c35e63144cd4eb0de78a9e,0,Matt Gilman,2014-12-17 09:11:25-05:00,['621b7f41cb6763d40bfc58588186a77781b5608e'],1,50,51,545260,14,0,1,1,2417
ca872badaea08987728a6496eeabf5091163f1ba,0,Matt Gilman,2014-12-17 10:07:45-05:00,['9c08118f5718d21320c35e63144cd4eb0de78a9e'],2,7,9,545269,3,0,1,1,2417
d5b20d463f43fc3dcd1daa242a8f008b05fc23ca,0,Matt Gilman,2014-12-17 10:10:14-05:00,['d7b1113a86a8ed52aa2a7f907d89ab8b8a730c73'],1,6,7,545276,1,0,0,1,2417
5527ccbe945336ca14208c27fa59599612790573,0,Matt Gilman,2014-12-17 10:12:42-05:00,"['fe3d1a4ca29d1794cfe9efbfdf5b9bb0784336a8', 'd5b20d463f43fc3dcd1daa242a8f008b05fc23ca']",1,6,7,545283,1,,,,2417
045afa5b2e6c0d9ce96fd65387d659ce7ac3b47f,0,Matt Gilman,2014-12-17 10:15:47-05:00,"['ca872badaea08987728a6496eeabf5091163f1ba', '5527ccbe945336ca14208c27fa59599612790573']",1,6,7,545290,1,,,,2417
12de20da86f0b6b6ff41230ed9f95c92b2e1028c,0,Matt Gilman,2014-12-17 10:46:54-05:00,['045afa5b2e6c0d9ce96fd65387d659ce7ac3b47f'],13,10,23,545313,1,0,0,0,2417
713312d9e572e50243fb6db07b3cdf0ee6d7cd6f,0,Matt Gilman,2014-12-17 12:14:21-05:00,['12de20da86f0b6b6ff41230ed9f95c92b2e1028c'],12,0,12,545325,1,0.333333333,0,0,2417
578974e5589148af4d533a90c1e0f106c175d6e0,0,Mark Payne,2014-12-17 14:17:54-05:00,['713312d9e572e50243fb6db07b3cdf0ee6d7cd6f'],0,0,0,545325,1,,,,2418
b87b75329d52a0a4b67bc0dc1c3f8c0594da3859,0,Matt Gilman,2014-12-18 14:03:48-05:00,['713312d9e572e50243fb6db07b3cdf0ee6d7cd6f'],0,3,3,545328,1,,,,2418
3d0766b9f5f131f456933f695c3db2c888fbca60,1,Matt Gilman,2014-12-18 14:10:02-05:00,['b87b75329d52a0a4b67bc0dc1c3f8c0594da3859'],269,155,424,545752,14,,,,2421
a23c7f2e2b6b57adf7adbf00e81d05ec1d657bb2,1,Mark Payne,2014-12-18 17:10:42-05:00,['578974e5589148af4d533a90c1e0f106c175d6e0'],4,561,565,546317,33,,,,2453
42566cd6aaa8396d83c547be74a0e77e8981ec02,0,Mark Payne,2014-12-18 17:25:22-05:00,['a23c7f2e2b6b57adf7adbf00e81d05ec1d657bb2'],1,16,17,546334,1,,,,2453
1a6f83e7de479fef5a809f0edbf28d76977b4792,0,joewitt,2014-12-18 20:40:30-05:00,['b87b75329d52a0a4b67bc0dc1c3f8c0594da3859'],1,1,2,546336,1,,,,2453
732cb7071ec8f8f6983d2b5ec1de0928f148b86d,0,Matt Gilman,2014-12-19 07:32:28-05:00,['1a6f83e7de479fef5a809f0edbf28d76977b4792'],1,1,2,546338,1,,,,2453
4146a23cee7fb5d35318a96b1d8cc30a43e8a921,0,Matt Gilman,2014-12-19 07:50:05-05:00,"['3d0766b9f5f131f456933f695c3db2c888fbca60', '732cb7071ec8f8f6983d2b5ec1de0928f148b86d']",2,2,4,546342,2,,,,2453
c213895cc2eb0372335f392cfcb4e3c3af101208,1,Mark Payne,2014-12-19 10:01:09-05:00,['42566cd6aaa8396d83c547be74a0e77e8981ec02'],113,173,286,546628,4,,,,2455
cbb174658790b47faf68ed56343d0d001acea59e,0,Mark Payne,2014-12-19 10:02:53-05:00,['713312d9e572e50243fb6db07b3cdf0ee6d7cd6f'],1,1,2,546630,1,,,,2455
ea17562dd328d5f38e11ca8ff4eb81a617fb8e6e,0,Mark Payne,2014-12-19 10:03:28-05:00,"['cbb174658790b47faf68ed56343d0d001acea59e', '732cb7071ec8f8f6983d2b5ec1de0928f148b86d']",2,5,7,546637,3,,,,2455
5e6de841d06773ff617f70cbae6a655bcab061f1,1,Matt Gilman,2014-12-19 10:47:23-05:00,['4146a23cee7fb5d35318a96b1d8cc30a43e8a921'],27,48,75,546712,7,0.333333333,1,1,2455
d8911e75e6c44857416b96de2c54cb18eaaa2d98,1,Mark Payne,2014-12-19 12:28:14-05:00,['c213895cc2eb0372335f392cfcb4e3c3af101208'],11,142,153,546865,13,,,,2467
782b2c18820b34a7f9ed1bb8df41dacaa928425e,0,joewitt,2014-12-19 13:22:39-05:00,['d8911e75e6c44857416b96de2c54cb18eaaa2d98'],59,62,121,546986,1,,,,2467
62f3354a12d7f5f64c22bc3d11d9c684ad369205,1,Mark Payne,2014-12-19 14:00:49-05:00,['782b2c18820b34a7f9ed1bb8df41dacaa928425e'],1,97,98,547084,2,,,,2468
9c38f358b8a599648f7da13a6d2cc0f3ff879863,0,Mark Payne,2014-12-19 14:11:43-05:00,['62f3354a12d7f5f64c22bc3d11d9c684ad369205'],0,5,5,547089,2,,,,2468
d57b34c452c28c9523850539a3edc5787d76414d,0,Mark Payne,2014-12-19 14:13:34-05:00,['9c38f358b8a599648f7da13a6d2cc0f3ff879863'],1,7,8,547097,2,1,1,1,2468
f048ed710f22f443c0bc972bf9618acfe38e5b35,0,Mark Payne,2014-12-19 14:14:44-05:00,"['ea17562dd328d5f38e11ca8ff4eb81a617fb8e6e', 'd57b34c452c28c9523850539a3edc5787d76414d']",4,877,881,547978,50,,,,2468
b0a5115097eb1fb30a390c0dc5da64edb60ed2dc,1,Mark Payne,2014-12-19 14:25:26-05:00,['f048ed710f22f443c0bc972bf9618acfe38e5b35'],4,16,20,547998,1,,,,2468
4031bd5495bd9ac62a3c3d8da2d3e9083d59fdfa,0,joewitt,2014-12-19 14:57:13-05:00,['b0a5115097eb1fb30a390c0dc5da64edb60ed2dc'],14,15,29,548027,1,,,,2468
d850768765c5012d09134a042eed2d71beb28c45,0,joewitt,2014-12-19 15:32:55-05:00,['4031bd5495bd9ac62a3c3d8da2d3e9083d59fdfa'],18,39,57,548084,1,,,,2468
a2fd2636d011855759846e3ef99172ef905a3d33,1,Mark Payne,2014-12-19 16:03:08-05:00,['d850768765c5012d09134a042eed2d71beb28c45'],5,30,35,548119,5,0.714285714,1,0.928571429,2468
21182ac260f6f40e65d53750804924cf5096370c,1,joewitt,2014-12-19 16:34:25-05:00,['d850768765c5012d09134a042eed2d71beb28c45'],3,83,86,548205,5,,,,2469
c0e4618d4233a2deb70e0ed44e2a936149f740cc,1,joewitt,2014-12-19 17:29:43-05:00,['21182ac260f6f40e65d53750804924cf5096370c'],2,2,4,548209,1,,,,2469
1357a17b6752a78dd87c3de7b0323f22e52731f9,1,joewitt,2014-12-20 00:40:14-05:00,['c0e4618d4233a2deb70e0ed44e2a936149f740cc'],501,205,706,548915,153,0,1,1,2469
965e0ab6130246009e5d8b4c1c6c44e189de1b5d,0,joewitt,2014-12-20 01:06:46-05:00,['1357a17b6752a78dd87c3de7b0323f22e52731f9'],3,3,6,548921,1,,,,2469
1da5a9c175134b822bac04813673a6536f2546e3,0,joewitt,2014-12-20 12:22:13-05:00,['965e0ab6130246009e5d8b4c1c6c44e189de1b5d'],0,114,114,549035,2,,,,2470
a3664a00c8e2ed60b4c159041f8ae3cf108e1840,1,joewitt,2014-12-20 20:42:40-05:00,['1da5a9c175134b822bac04813673a6536f2546e3'],484,88,572,549607,8,,,,2470
42f9cfb2d94519fe11c83a7a28ce8ca2bdf896e1,1,joewitt,2014-12-20 21:43:09-05:00,['a3664a00c8e2ed60b4c159041f8ae3cf108e1840'],4,13,17,549624,1,,,,2470
0d8da145bd5e4c152cb9bbefbb1fefaa1a96e790,1,joewitt,2014-12-21 15:14:53-05:00,['42f9cfb2d94519fe11c83a7a28ce8ca2bdf896e1'],37,402,439,550063,9,1,0,0.777777778,2470
24372962aa823498cf740e44f784ddd90477f428,1,Matt Gilman,2014-12-22 06:58:39-05:00,"['5e6de841d06773ff617f70cbae6a655bcab061f1', '0d8da145bd5e4c152cb9bbefbb1fefaa1a96e790']",930,1712,2642,552705,216,,,,2470
b375f01519da33c24c2ad93d229e70918191838f,1,Matt Gilman,2014-12-22 11:05:48-05:00,['24372962aa823498cf740e44f784ddd90477f428'],11,34,45,552750,2,,,,2470
fa80827de9e59026c8cefe640528ee68d3b7ccbc,1,Matt Gilman,2014-12-22 11:09:51-05:00,['b375f01519da33c24c2ad93d229e70918191838f'],35,95,130,552880,4,0,0,0,2470
d3f082e25c560c2384f0c948330507b744a3f846,1,Matt Gilman,2014-12-22 14:23:02-05:00,['fa80827de9e59026c8cefe640528ee68d3b7ccbc'],10,32,42,552922,5,1,1,1,2470
f180d5d2f1713d5aa7037eceea6cb917e41f3d08,0,Matt Gilman,2014-12-22 14:38:56-05:00,['d3f082e25c560c2384f0c948330507b744a3f846'],6,0,6,552928,1,1,1,0,2470
022ba888bb77f950d8ee0a5408166abf816a2d1f,1,Matt Gilman,2014-12-22 14:56:11-05:00,['f180d5d2f1713d5aa7037eceea6cb917e41f3d08'],6,6,12,552940,2,,,,2470
62965770d091ee86f5a28ed23467b7dbe797faa4,0,Matt Gilman,2014-12-22 15:22:38-05:00,['022ba888bb77f950d8ee0a5408166abf816a2d1f'],5,5,10,552950,2,,,,2470
527bec55c8b8de320ccd7f1b14b8ab681f3749cd,0,joewitt,2014-12-22 15:25:48-05:00,['0d8da145bd5e4c152cb9bbefbb1fefaa1a96e790'],0,1,1,552951,1,,,,2470
13578e2d4172ab15dc840ced52a63e7766f6856a,0,joewitt,2014-12-22 15:27:46-05:00,"['527bec55c8b8de320ccd7f1b14b8ab681f3749cd', '62965770d091ee86f5a28ed23467b7dbe797faa4']",327,332,659,553610,21,,,,2470
3b4a7a63c61ccfd303e7187319b439e85bcc6e58,1,Karl-Heinz Marbaise,2014-12-22 21:48:35+01:00,['0d8da145bd5e4c152cb9bbefbb1fefaa1a96e790'],7,6,13,553623,3,,,,2470
31921212da0e5406d55838493654b429bdc54070,0,Karl-Heinz Marbaise,2014-12-22 22:41:07+01:00,['0d8da145bd5e4c152cb9bbefbb1fefaa1a96e790'],11,1,12,553635,1,,,,2470
9fc7e6463c3fc9af3f43b0ac3ae27147bc270b8b,0,joewitt,2014-12-22 21:11:05-05:00,"['13578e2d4172ab15dc840ced52a63e7766f6856a', '3b4a7a63c61ccfd303e7187319b439e85bcc6e58']",7,6,13,553648,3,,,,2470
df9529c5616844a0f3d7b6854781339f89dd9b55,0,joewitt,2014-12-22 21:18:45-05:00,"['9fc7e6463c3fc9af3f43b0ac3ae27147bc270b8b', '31921212da0e5406d55838493654b429bdc54070']",10,0,10,553658,1,,,,2470
1c9393032d4917bf4b9584a5066d84a85dc68a6b,0,Matt Gilman,2014-12-23 09:30:29-05:00,['df9529c5616844a0f3d7b6854781339f89dd9b55'],285,125,410,554068,6,0.387755102,1,1,2471
2df03143b9c2e419788a80271fceb3c3f5aa9aa9,0,Matt Gilman,2014-12-23 09:30:47-05:00,['1c9393032d4917bf4b9584a5066d84a85dc68a6b'],1,1,2,554070,1,,,,2471
418d6b03b2a2c81597954b6c29469e180c3e780e,0,Matt Gilman,2014-12-23 09:31:46-05:00,['2df03143b9c2e419788a80271fceb3c3f5aa9aa9'],0,103,103,554173,2,1,1,1,2472
e1ffbdf466b6684b9dec57da2f17849b9bc45c72,0,Matt Gilman,2014-12-23 09:31:55-05:00,['418d6b03b2a2c81597954b6c29469e180c3e780e'],0,16,16,554189,1,1,1,1,2472
2fed138888fbc4d4ae4c93f13c9f9cf81dfcae92,1,Matt Gilman,2014-12-23 09:32:54-05:00,['e1ffbdf466b6684b9dec57da2f17849b9bc45c72'],0,32,32,554221,2,0.214285714,0.214285714,0.214285714,2472
1c7208125796ff3c2dcc540ecf7f9c973396664c,0,Matt Gilman,2014-12-23 09:33:17-05:00,['2fed138888fbc4d4ae4c93f13c9f9cf81dfcae92'],0,7,7,554228,1,1,1,1,2472
e67eb4f53bca1b63326efc35b86b2f7a36318d7e,0,Matt Gilman,2014-12-23 09:33:43-05:00,['1c7208125796ff3c2dcc540ecf7f9c973396664c'],0,266,266,554494,2,0.528301887,0.528301887,1,2473
71ab084d399bd09dd273942f42bceda66cf410d6,0,Matt Gilman,2014-12-23 09:46:35-05:00,['e67eb4f53bca1b63326efc35b86b2f7a36318d7e'],0,8,8,554502,1,1,1,1,2473
1f4ae7306584d3cd524c08c19886001456df5fce,0,Matt Gilman,2014-12-23 10:27:09-05:00,['71ab084d399bd09dd273942f42bceda66cf410d6'],3,3,6,554508,1,,,,2473
7a29166d9cf009e7c259ddf48641f45737b4c76b,1,Matt Gilman,2014-12-23 10:28:41-05:00,['1f4ae7306584d3cd524c08c19886001456df5fce'],56,53,109,554617,2,0.571428571,0.571428571,0,2473
1374d1db7ca40ce9faffc51a719be962d2af299a,0,Matt Gilman,2014-12-23 12:17:59-05:00,['df9529c5616844a0f3d7b6854781339f89dd9b55'],8,8,16,554633,1,,,,2473
469502f30ca01953bceabca590bea8e183ed2c7d,0,Matt Gilman,2014-12-23 13:00:38-05:00,['7a29166d9cf009e7c259ddf48641f45737b4c76b'],8,9,17,554650,3,,,,2473
2436b5338ecf1752c0f5b51646f59c9a985ceb9c,0,Matt Gilman,2014-12-23 13:46:48-05:00,['469502f30ca01953bceabca590bea8e183ed2c7d'],6,13,19,554669,1,0,0,1,2473
1a34e75c5b9cd29cf4496a4ff0d10b2b0519dc76,0,Matt Gilman,2014-12-23 14:56:08-05:00,['2436b5338ecf1752c0f5b51646f59c9a985ceb9c'],2,2,4,554673,1,,,,2473
c39445415779cc6c0f21b226ea41c23daf29f6d1,0,joewitt,2014-12-23 15:12:37-05:00,['1374d1db7ca40ce9faffc51a719be962d2af299a'],3,4,7,554680,1,0,0,0,2473
b569a9d7847c90ce89468a21bdcd0e9ae080f433,0,Matt Gilman,2014-12-23 15:36:37-05:00,"['1374d1db7ca40ce9faffc51a719be962d2af299a', '1a34e75c5b9cd29cf4496a4ff0d10b2b0519dc76']",353,630,983,555663,19,,,,2473
ed3452f527aed01318b0a6611fbbe48239e8cb8c,0,joewitt,2014-12-23 15:40:17-05:00,"['c39445415779cc6c0f21b226ea41c23daf29f6d1', 'b569a9d7847c90ce89468a21bdcd0e9ae080f433']",353,630,983,556646,19,,,,2473
79803c1c67f4dabbdea4611ed910d366dfea010a,0,Matt Gilman,2014-12-23 15:58:46-05:00,['b569a9d7847c90ce89468a21bdcd0e9ae080f433'],5,36,41,556687,3,0.421052632,0.421052632,1,2473
7f0eb2e35286b58a1072067599a88ca47af991a8,0,joewitt,2014-12-23 16:05:43-05:00,['ed3452f527aed01318b0a6611fbbe48239e8cb8c'],10,10,20,556707,2,0,0,0,2473
d997fd1b58ffa44a370c235d4ed5b39b0832d68e,0,Matt Gilman,2014-12-23 16:12:38-05:00,"['79803c1c67f4dabbdea4611ed910d366dfea010a', '7f0eb2e35286b58a1072067599a88ca47af991a8']",13,14,27,556734,3,,,,2473
07547a74f1324fb44ae67b2c60c6f9a531db856b,0,Karl-Heinz Marbaise,2014-12-23 22:53:33+01:00,['df9529c5616844a0f3d7b6854781339f89dd9b55'],4,42,46,556780,1,,,,2473
03f2ce50006ef526ae55876492261ef09fe2e789,0,Karl-Heinz Marbaise,2014-12-23 22:58:39+01:00,['df9529c5616844a0f3d7b6854781339f89dd9b55'],25,1,26,556806,1,,,,2473
508b6329c5d7ee255f3b8e6600b9c12894e32fa0,0,joewitt,2014-12-23 22:01:41-05:00,"['d997fd1b58ffa44a370c235d4ed5b39b0832d68e', '07547a74f1324fb44ae67b2c60c6f9a531db856b']",4,42,46,556852,1,,,,2473
32bc17db852140de427406690b02257fc1fc461e,0,joewitt,2014-12-23 22:12:14-05:00,"['508b6329c5d7ee255f3b8e6600b9c12894e32fa0', '03f2ce50006ef526ae55876492261ef09fe2e789']",25,1,26,556878,1,,,,2473
9b0a9a6415f84a170c19cf226b505cb52d48ee04,0,joewitt,2014-12-23 22:28:42-05:00,['32bc17db852140de427406690b02257fc1fc461e'],34,53,87,556965,2,,,,2473
ac3c3bb4d5b18329aa48d4663ca8eda9420f2b83,0,joewitt,2014-12-24 22:12:09-05:00,['9b0a9a6415f84a170c19cf226b505cb52d48ee04'],13,16,29,556994,4,,,,2473
b6f2dd280c4925fcdfd256f96e89b6d2f8b0744b,1,joewitt,2014-12-26 23:06:31-05:00,['ac3c3bb4d5b18329aa48d4663ca8eda9420f2b83'],38,152,190,557184,8,,,,2476
b233eaf20d36cd17de9d79a36a4fe3bafe8f99ba,1,gresockj,2014-12-27 05:50:31-05:00,['ac3c3bb4d5b18329aa48d4663ca8eda9420f2b83'],1,24,25,557209,2,0.153846154,0.153846154,1,2476
c69e4dbec620ff776b42feb25a83a73107a74e41,0,Mark Payne,2014-12-28 13:33:03-05:00,"['a2fd2636d011855759846e3ef99172ef905a3d33', 'b6f2dd280c4925fcdfd256f96e89b6d2f8b0744b']",1730,2060,3790,560999,222,,,,2476
87b07384a5b80886f8b088000fab8676ce482f0d,0,joewitt,2014-12-28 15:23:45-05:00,['b6f2dd280c4925fcdfd256f96e89b6d2f8b0744b'],13,120,133,561132,5,,,,2476
40890c9aeca86d3bed5a29d7387bc16c83f2c413,0,Mark Payne,2014-12-29 11:02:36-05:00,"['c69e4dbec620ff776b42feb25a83a73107a74e41', '87b07384a5b80886f8b088000fab8676ce482f0d']",13,120,133,561265,5,,,,2476
6f1c12f5efa5006685ed89b91df0a75ba2a15a5b,1,Mark Payne,2014-12-29 16:17:48-05:00,['40890c9aeca86d3bed5a29d7387bc16c83f2c413'],6,294,300,561565,12,,,,2485
d27d2e303e8badf24e07259cbc79bfadd0023bbd,1,Matt Gilman,2014-12-30 07:43:20-05:00,['6f1c12f5efa5006685ed89b91df0a75ba2a15a5b'],1,16,17,561582,1,0.333333333,0.333333333,1,2485
0a0b7e05a08428a5e6e78e9f8c204cd05991b4b3,0,Mark Payne,2014-12-30 08:59:10-05:00,['d27d2e303e8badf24e07259cbc79bfadd0023bbd'],7,15,22,561604,1,0,0,1,2485
bfe39c0b82dbf671bebfbda26b11d657a8adba2a,0,Mark Payne,2014-12-30 09:08:19-05:00,"['0a0b7e05a08428a5e6e78e9f8c204cd05991b4b3', '77971847129133bef0d9340e44b23c8d352be303']",24,63,87,561691,1,,,,2485
fed987e778e0e2488888ffe2ac3a916b68255aac,1,Mark Payne,2014-12-30 09:16:14-05:00,['bfe39c0b82dbf671bebfbda26b11d657a8adba2a'],28,42,70,561761,2,0.4,0.4,1,2485
05cc6f045d056e3be3f9c71dbc6f7400a4c01f08,1,Mark Payne,2014-12-30 10:00:24-05:00,['fed987e778e0e2488888ffe2ac3a916b68255aac'],7,56,63,561824,1,0,0.421052632,1,2485
7589ad356ec1b2a6c2c82e50adb971b96e2d4383,1,Mark Payne,2014-12-30 10:29:38-05:00,['05cc6f045d056e3be3f9c71dbc6f7400a4c01f08'],6,4,10,561834,1,1,0,1,2485
b8231894521643ae1706bfbaf18e8e34cf718431,0,Matt Gilman,2014-12-30 10:37:51-05:00,['7589ad356ec1b2a6c2c82e50adb971b96e2d4383'],20,68,88,561922,10,1,1,0.5,2485
3997f9b2b0c944759d9415e3bc4d73fbabe3e9f4,0,Mark Payne,2014-12-30 11:02:52-05:00,['7589ad356ec1b2a6c2c82e50adb971b96e2d4383'],4,75,79,562001,2,0.076923077,0.557692308,1,2485
84d6255d68db27268861c1bf8371217353d7cc94,0,Mark Payne,2014-12-30 11:07:00-05:00,['3997f9b2b0c944759d9415e3bc4d73fbabe3e9f4'],0,7,7,562008,1,0,0,1,2485
9161cabc71a81d33b0aa22acb2c9a9f059dca6f5,0,Mark Payne,2014-12-30 12:07:04-05:00,"['84d6255d68db27268861c1bf8371217353d7cc94', 'b8231894521643ae1706bfbaf18e8e34cf718431']",20,68,88,562096,10,,,,2485
43991777da38b2f1b7837bc1bffdd6325f4d9e1d,1,Mark Payne,2014-12-30 15:44:16-05:00,['9161cabc71a81d33b0aa22acb2c9a9f059dca6f5'],5,83,88,562184,4,,,,2487
394c7116d1ac134265bd2264b78550f485c62996,0,Mark Payne,2014-12-30 16:30:13-05:00,['43991777da38b2f1b7837bc1bffdd6325f4d9e1d'],14,5,19,562203,4,0,0,0,2487
d6c02a564081fa785325196fbf20fd768f941af7,0,joewitt,2014-12-31 02:39:01-05:00,['43991777da38b2f1b7837bc1bffdd6325f4d9e1d'],0,86,86,562289,3,,,,2489
a183d88f28cb69b7f5f1369c0772b317533dd941,0,Mark Payne,2014-12-31 07:37:32-05:00,"['394c7116d1ac134265bd2264b78550f485c62996', 'd6c02a564081fa785325196fbf20fd768f941af7']",0,86,86,562375,3,,,,2489
d879e0d640a1bc6c4de2ea3a4ad2666a00b18e29,0,Mark Payne,2014-12-31 08:07:40-05:00,['a183d88f28cb69b7f5f1369c0772b317533dd941'],0,4,4,562379,1,0,0,1,2489
0297fa465f230028ca83f8a4d573de185fe79f5f,0,Mark Payne,2014-12-31 08:24:44-05:00,['d879e0d640a1bc6c4de2ea3a4ad2666a00b18e29'],8,7,15,562394,1,1,0,0,2489
ebf3cdc7795a4cfab2ec7bd41f1b25e0b246ca7a,0,Mark Payne,2014-12-31 08:45:25-05:00,['0297fa465f230028ca83f8a4d573de185fe79f5f'],1,14,15,562409,1,0,1,1,2489
3c5bb56386e559886d8aa1a3ee447e6b39f2d2d7,1,Matt Gilman,2014-12-31 10:42:42-05:00,['ebf3cdc7795a4cfab2ec7bd41f1b25e0b246ca7a'],1,9,10,562419,4,1,1,1,2489
ad90fbf24f23d4e77a3ea993cff450762e56cae9,0,joewitt,2014-12-31 12:05:00-05:00,['3c5bb56386e559886d8aa1a3ee447e6b39f2d2d7'],55,133,188,562607,1,,,,2489
3004ff172054e8991e9b66a7c71fabd06f8bbc4c,0,joewitt,2014-12-31 14:36:42-05:00,['ad90fbf24f23d4e77a3ea993cff450762e56cae9'],6,20,26,562633,2,0,0,1,2489
e07b910a55f4dd0063207018d3341c9940e72559,0,Mark Payne,2014-12-31 16:08:39-05:00,['ebf3cdc7795a4cfab2ec7bd41f1b25e0b246ca7a'],0,6,6,562639,1,,,,2489
d3d10958a77e423f1c3844bbeb28c2b01afaf24c,0,Mark Payne,2014-12-31 16:17:51-05:00,"['e07b910a55f4dd0063207018d3341c9940e72559', '3004ff172054e8991e9b66a7c71fabd06f8bbc4c']",62,162,224,562863,7,,,,2489
68b7ad78ccb8ee6cd6cad5218fbbd13438085f5f,1,Mark Payne,2014-12-31 16:18:38-05:00,['d3d10958a77e423f1c3844bbeb28c2b01afaf24c'],0,1401,1401,564264,1,,,,2490
3e2f79067251adfd2846a3aea42c052e7cae8e92,1,Mark Payne,2015-01-01 20:52:36-05:00,['68b7ad78ccb8ee6cd6cad5218fbbd13438085f5f'],0,1103,1103,565367,12,0.408560311,0.564202335,1,2500
e35c997436dbce95a2128a86d9321514d69790e9,1,joewitt,2015-01-02 00:59:41-05:00,['68b7ad78ccb8ee6cd6cad5218fbbd13438085f5f'],1,2,3,565370,2,,,,2500
9e35c7da9fbaabca6119257de0979214c3fc8bcb,0,joewitt,2015-01-03 00:58:58-05:00,['e35c997436dbce95a2128a86d9321514d69790e9'],73,73,146,565516,10,,,,2500
5b4211d9af444864c42caeb8c28d6ffff3161b6c,0,joewitt,2015-01-03 01:31:17-05:00,"['9e35c7da9fbaabca6119257de0979214c3fc8bcb', 'b233eaf20d36cd17de9d79a36a4fe3bafe8f99ba']",1,24,25,565541,2,,,,2500
a08d31839e27367e0073ee2c63cf8c985d9c7ed2,0,joewitt,2015-01-03 02:01:42-05:00,['5b4211d9af444864c42caeb8c28d6ffff3161b6c'],0,6,6,565547,1,,,,2500
c91c7e78970a5261b05572dfbad02ee91287bf5e,1,Mark Payne,2015-01-04 21:10:34-05:00,['3e2f79067251adfd2846a3aea42c052e7cae8e92'],131,662,793,566340,6,0.106896552,0.631034483,1,2500
c1eb209d4f927ae58671ec13948cba0835180f4e,1,Matt Gilman,2015-01-05 07:22:10-05:00,['a08d31839e27367e0073ee2c63cf8c985d9c7ed2'],62,44,106,566446,14,,,,2500
b7afc6999e488cac0e9f4003d87f0a6e81541824,0,Matt Gilman,2015-01-05 07:43:19-05:00,['c1eb209d4f927ae58671ec13948cba0835180f4e'],3,9,12,566458,1,1,1,1,2500
a2ecfe3355f1ac75285e42d3f34bb9761723cc5b,0,Mark Payne,2015-01-05 15:36:40-05:00,['68b7ad78ccb8ee6cd6cad5218fbbd13438085f5f'],0,3,3,566461,1,0,0,1,2500
49256d9d83572bf7a0d7b16aa02ad43049bf2585,1,Mark Payne,2015-01-05 15:40:32-05:00,['a2ecfe3355f1ac75285e42d3f34bb9761723cc5b'],76,422,498,566959,10,0.794117647,0.794117647,0.905882353,2506
090ad38679271019a22b6a973c18726db60fd07e,1,Mark Payne,2015-01-05 16:37:17-05:00,['a2ecfe3355f1ac75285e42d3f34bb9761723cc5b'],330,619,949,567908,1,,,,2506
7e70fd53e996018bf86ffc3d79b1e29fb7c16461,0,joewitt,2015-01-05 17:10:23-05:00,['b7afc6999e488cac0e9f4003d87f0a6e81541824'],37,37,74,567982,1,,,,2506
b1e5c5e66a9d07ffefed1687e5054c634e14f68e,0,Mark Payne,2015-01-05 20:33:22-05:00,['090ad38679271019a22b6a973c18726db60fd07e'],1,12,13,567995,1,,,,2506
0b25df490b3c517a5b7d9c89cefe16a6173b2e16,0,Mark Payne,2015-01-05 20:33:32-05:00,"['b1e5c5e66a9d07ffefed1687e5054c634e14f68e', 'c91c7e78970a5261b05572dfbad02ee91287bf5e']",0,1634,1634,569629,12,,,,2506
d8b4a781d2b1ced7deb42b19b41bf6c3c463f623,0,joewitt,2015-01-06 09:23:19-05:00,['7e70fd53e996018bf86ffc3d79b1e29fb7c16461'],1,2,3,569632,1,0,0,1,2506
2d0b163961723e9163c3ed34a7fdab0b5a1dfcac,0,Mark Payne,2015-01-06 10:16:00-05:00,"['0b25df490b3c517a5b7d9c89cefe16a6173b2e16', 'd8b4a781d2b1ced7deb42b19b41bf6c3c463f623']",180,199,379,570011,32,,,,2506
23dcdeb61b9f0e0643e1c0406ce6aca824f347a5,1,Matt Gilman,2015-01-06 11:41:13-05:00,['2d0b163961723e9163c3ed34a7fdab0b5a1dfcac'],443,695,1138,571149,6,0.350318471,0.968152866,0.828025478,2507
33ad7934eaaf257190c3e96f6ecf46b378808912,1,joewitt,2015-01-06 13:43:54-05:00,['23dcdeb61b9f0e0643e1c0406ce6aca824f347a5'],119,116,235,571384,2,,,,2507
142d19a519357577c5cec1e921707bcff15d8df2,0,Mark Payne,2015-01-06 14:54:23-05:00,['2d0b163961723e9163c3ed34a7fdab0b5a1dfcac'],7,25,32,571416,2,0.6,0.6,0,2507
4b322b8f50a59ef098189efc410754cb69237eb2,0,Mark Payne,2015-01-06 14:59:45-05:00,"['142d19a519357577c5cec1e921707bcff15d8df2', '33ad7934eaaf257190c3e96f6ecf46b378808912']",562,811,1373,572789,8,,,,2507
c27f7b05745279491e9c58f8678abd8fe49d6db5,1,joewitt,2015-01-06 21:31:04-05:00,['4b322b8f50a59ef098189efc410754cb69237eb2'],112,208,320,573109,17,,,,2523
4d11ff78303b2039cbe89f5a675bb595388259f8,0,joewitt,2015-01-06 21:54:29-05:00,['c27f7b05745279491e9c58f8678abd8fe49d6db5'],1,2,3,573112,1,,,,2523
645837491c13006b9546dc3c952a90479366e791,0,Matt Gilman,2015-01-07 07:46:57-05:00,['4d11ff78303b2039cbe89f5a675bb595388259f8'],2,26,28,573140,3,1,1,1,2523
93309901bad9a6d2377d742bfd6317a6b665029e,1,Mark Payne,2015-01-07 09:01:42-05:00,['645837491c13006b9546dc3c952a90479366e791'],43,65,108,573248,25,,,,2523
4748cbd185de820083a5dac47e08ab080e80d119,1,Mark Payne,2015-01-07 09:54:05-05:00,['93309901bad9a6d2377d742bfd6317a6b665029e'],17,26,43,573291,7,,,,2523
2de45b62a75deab3b2801b30d5f0a45301afbf90,0,Matt Gilman,2015-01-07 10:22:27-05:00,['645837491c13006b9546dc3c952a90479366e791'],8,62,70,573361,5,0.6,0.68,1,2523
9531219293e9ef8340a502169cca84e6dc94ca0c,0,Matt Gilman,2015-01-07 11:49:40-05:00,['2de45b62a75deab3b2801b30d5f0a45301afbf90'],11,2,13,573374,1,,,,2523
e631c493d49ff71d4407eea281259bdfaeedd3c5,0,Mark Payne,2015-01-07 14:05:05-05:00,['4748cbd185de820083a5dac47e08ab080e80d119'],0,38,38,573412,1,,,,2523
edaa191d37d0abe01a0be1da8c7a317bec96b4ec,1,Matt Gilman,2015-01-07 14:08:13-05:00,['9531219293e9ef8340a502169cca84e6dc94ca0c'],9,34,43,573455,3,0,1,1,2523
14cba2a57ec78cd1bb8e664474f0db1e6f2799b9,1,Mark Payne,2015-01-07 14:16:51-05:00,['49256d9d83572bf7a0d7b16aa02ad43049bf2585'],27,35,62,573517,4,0,0,1,2523
6f2e283166b6a52da762dd1a1fd80c4be74be4c6,1,Matt Gilman,2015-01-07 14:25:27-05:00,['edaa191d37d0abe01a0be1da8c7a317bec96b4ec'],11,33,44,573561,1,0.444444444,1,1,2523
c48745817ceb1aa7ba450b5cdbca48f54e604ad6,0,Mark Payne,2015-01-07 14:33:21-05:00,"['e631c493d49ff71d4407eea281259bdfaeedd3c5', '6f2e283166b6a52da762dd1a1fd80c4be74be4c6']",39,131,170,573731,10,,,,2523
b29333b9b6f04f1f0219c6e3781e1c67b4414be4,0,Mark Payne,2015-01-07 14:33:26-05:00,"['c48745817ceb1aa7ba450b5cdbca48f54e604ad6', '14cba2a57ec78cd1bb8e664474f0db1e6f2799b9']",84,439,523,574254,10,,,,2523
bcc271046e8169b3c4cb82a766bb02758df6a465,0,Mark Payne,2015-01-07 14:38:56-05:00,['b29333b9b6f04f1f0219c6e3781e1c67b4414be4'],2,2,4,574258,1,,,,2523
9ba8defc09c336842f6f1f9d3f34f7f3acd91712,1,Mark Payne,2015-01-07 15:09:40-05:00,['bcc271046e8169b3c4cb82a766bb02758df6a465'],2,2,4,574262,1,,,,2523
22596080c9ae7d1b285a72f446b54f73c4ed7672,0,Matt Gilman,2015-01-08 07:16:45-05:00,['9ba8defc09c336842f6f1f9d3f34f7f3acd91712'],1,1,2,574264,1,,,,2523
bda9985d6a3f7ecb2f20829eb2f084a8bfdd56fe,1,Matt Gilman,2015-01-08 11:02:25-05:00,['22596080c9ae7d1b285a72f446b54f73c4ed7672'],140,269,409,574673,5,0.242857143,0.242857143,1,2523
cb2ceeab796ac935441f6f3e288ef96b587bbc3b,0,Matt Gilman,2015-01-08 12:54:58-05:00,['bda9985d6a3f7ecb2f20829eb2f084a8bfdd56fe'],0,2,2,574675,1,0,0,1,2523
d08cda1b6ab9122c1c8cac51e7bae5d3fb1566ce,1,Matt Gilman,2015-01-08 14:34:49-05:00,['cb2ceeab796ac935441f6f3e288ef96b587bbc3b'],18,62,80,574755,5,,,,2527
a76e91bcc5dc1df06bc46d490ef025f26a33129c,0,joewitt,2015-01-09 00:03:10-05:00,['d08cda1b6ab9122c1c8cac51e7bae5d3fb1566ce'],0,0,0,574755,5,,,,2527
b98819e5af0e93d157d9b92e2034a5c22f749a73,1,Matt Gilman,2015-01-09 08:10:04-05:00,['d08cda1b6ab9122c1c8cac51e7bae5d3fb1566ce'],25,18,43,574798,10,0,0,0,2527
b6d5a68f75f8ca1b3bf484c3f42b83fdb05dfedd,1,Mark Payne,2015-01-09 08:15:29-05:00,['9ba8defc09c336842f6f1f9d3f34f7f3acd91712'],26,14,40,574838,4,,,,2527
3b16d010c0dd2129732db4cf856ff875db65e4bf,0,Mark Payne,2015-01-09 08:20:07-05:00,"['b6d5a68f75f8ca1b3bf484c3f42b83fdb05dfedd', 'b98819e5af0e93d157d9b92e2034a5c22f749a73']",184,352,536,575374,22,,,,2527
76ea1c64ff41ab19c10f3157a15bf9faf619c1fd,0,Mark Payne,2015-01-09 08:26:32-05:00,['3b16d010c0dd2129732db4cf856ff875db65e4bf'],1,1,2,575376,1,,,,2527
d99180a7160ac8a189507168dc97a35e0501eef9,1,Mark Payne,2015-01-09 13:18:00-05:00,['76ea1c64ff41ab19c10f3157a15bf9faf619c1fd'],91,136,227,575603,1,0,0.161290323,1,2527
d996060dbfa63b1e1384289ca32d80e851d0edd7,0,joewitt,2015-01-09 13:33:34-05:00,['3b16d010c0dd2129732db4cf856ff875db65e4bf'],6,67,73,575676,1,,,,2527
dc4c3220361e1e792a40186af54cb7bb81d6371b,0,Mark Payne,2015-01-09 14:46:20-05:00,"['d99180a7160ac8a189507168dc97a35e0501eef9', 'd996060dbfa63b1e1384289ca32d80e851d0edd7']",6,67,73,575749,1,,,,2527
002926882bbe8e6669236c241087c0bcaef3120b,0,joewitt,2015-01-09 14:56:59-05:00,['d996060dbfa63b1e1384289ca32d80e851d0edd7'],0,89,89,575838,1,,,,2527
36d36c43ae377f398210db32ca6ce0100bd52089,1,Mark Payne,2015-01-09 15:25:14-05:00,['dc4c3220361e1e792a40186af54cb7bb81d6371b'],151,464,615,576453,5,0.727272727,0.801652893,1,2529
59113427667b679d0c71cda1ed8878be5cc7db71,0,joewitt,2015-01-09 15:28:28-05:00,['002926882bbe8e6669236c241087c0bcaef3120b'],151,464,615,577068,5,0.727272727,0.801652893,1,2531
7e2aa9f368f9c63c107ff245bca033d4084ab496,0,Mark Payne,2015-01-09 15:35:25-05:00,"['36d36c43ae377f398210db32ca6ce0100bd52089', '59113427667b679d0c71cda1ed8878be5cc7db71']",0,89,89,577157,1,,,,2531
ed8b2f6027c4b180d4e1e012c9d887d866c2169d,0,joewitt,2015-01-09 15:46:14-05:00,['7e2aa9f368f9c63c107ff245bca033d4084ab496'],0,33,33,577190,1,,,,2531
7d85962e4d5274e1e3cda9e3ca9adb40bbd65762,1,joewitt,2015-01-10 22:29:13-05:00,['ed8b2f6027c4b180d4e1e012c9d887d866c2169d'],11,301,312,577502,11,,,,2531
7ded9970a2ec9cacd8862aa9d06e5513dd07cfbf,0,joewitt,2015-01-10 22:49:57-05:00,['7d85962e4d5274e1e3cda9e3ca9adb40bbd65762'],0,1,1,577503,1,,,,2531
83dc133472e36a118bc797da9e9df9f7c10d4fff,0,joewitt,2015-01-11 14:41:10-05:00,['7ded9970a2ec9cacd8862aa9d06e5513dd07cfbf'],11,18,29,577532,1,,,,2531
a58cf4ad66c607429d7db2e8de334bdfb0db0b64,0,joewitt,2015-01-11 14:41:10-05:00,['83dc133472e36a118bc797da9e9df9f7c10d4fff'],0,1,1,577533,1,,,,2531
aaa2992cf156cb7efd4b76a2f4f06e1d5239be86,0,joewitt,2015-01-11 14:41:10-05:00,['a58cf4ad66c607429d7db2e8de334bdfb0db0b64'],1,1,2,577535,1,,,,2531
67362a99084d7c50304d43df846c840ab965923d,0,joewitt,2015-01-11 21:40:43-05:00,"['aaa2992cf156cb7efd4b76a2f4f06e1d5239be86', 'a76e91bcc5dc1df06bc46d490ef025f26a33129c']",0,0,0,577535,5,,,,2531
78c069fb5b14f5f1fe050a48106867f8acf70154,1,joewitt,2015-01-12 07:56:32-05:00,['67362a99084d7c50304d43df846c840ab965923d'],1,64,65,577600,1,,,,2531
f36eea3701598be05f09e7757d06748bda776ed6,0,Mark Payne,2015-01-12 09:09:13-05:00,['78c069fb5b14f5f1fe050a48106867f8acf70154'],3,5,8,577608,2,0,0,0.666666667,2531
6b97a1dda689b634683021e4b7b0d3c2cda590c9,0,Matt Gilman,2015-01-12 09:33:53-05:00,['67362a99084d7c50304d43df846c840ab965923d'],0,2,2,577610,1,,,,2531
5fbee26054e6780b5521f06622b6e9e7408b7572,0,Matt Gilman,2015-01-12 09:34:04-05:00,"['6b97a1dda689b634683021e4b7b0d3c2cda590c9', 'f36eea3701598be05f09e7757d06748bda776ed6']",4,69,73,577683,3,,,,2531
1da5339a2af10b39aa56f6d3f4bf30f48e059e43,1,Matt Gilman,2015-01-12 10:24:38-05:00,['5fbee26054e6780b5521f06622b6e9e7408b7572'],1,9,10,577693,1,1,1,1,2531
b6b1859475eadc7d2802b2da29863878f77d54cd,0,Matt Gilman,2015-01-12 12:56:37-05:00,['1da5339a2af10b39aa56f6d3f4bf30f48e059e43'],3,8,11,577704,1,0,1,1,2531
21e809a7cbb85f450749916e474dec93f0d023d6,0,Mark Payne,2015-01-13 13:28:20-05:00,['f36eea3701598be05f09e7757d06748bda776ed6'],9,30,39,577743,3,0,1,0,2531
95b22a0aee87f29a5ebcfacd6a5fb274ca95b837,0,Mark Payne,2015-01-13 13:35:39-05:00,"['21e809a7cbb85f450749916e474dec93f0d023d6', 'b6b1859475eadc7d2802b2da29863878f77d54cd']",4,19,23,577766,2,,,,2531
549c97d3f4f69a2f04e877bc7b74095fd4a5b0d3,0,Matt Gilman,2015-01-13 15:17:58-05:00,['95b22a0aee87f29a5ebcfacd6a5fb274ca95b837'],0,10,10,577776,1,,,,2531
b142d7a9bdecee96bcc7c1b920b3c2dbb748b5e9,0,Matt Gilman,2015-01-13 15:21:42-05:00,['549c97d3f4f69a2f04e877bc7b74095fd4a5b0d3'],1,1,2,577778,1,,,,2531
80793ccbb829e079ef8cc2fe703bad6397a71d48,0,Matt Gilman,2015-01-13 15:54:21-05:00,['b142d7a9bdecee96bcc7c1b920b3c2dbb748b5e9'],1,22,23,577801,1,1,1,1,2531
a77fb50116642c9692e18046ba42663ea8240087,1,Mark Payne,2015-01-13 19:27:07-05:00,['95b22a0aee87f29a5ebcfacd6a5fb274ca95b837'],12,16,28,577829,1,0,0,1,2531
eaca6a29d3a33fcbe466c8aff87cc8ad3060b9e3,1,Mark Payne,2015-01-13 19:28:53-05:00,['a77fb50116642c9692e18046ba42663ea8240087'],1,1,2,577831,1,,,,2531
67dee2e33b19589ea6756b031ecf68540008bd33,0,Mark Payne,2015-01-14 07:07:20-05:00,"['eaca6a29d3a33fcbe466c8aff87cc8ad3060b9e3', '80793ccbb829e079ef8cc2fe703bad6397a71d48']",2,33,35,577866,3,,,,2531
5fe4c15cd004015f6b18a2d4a5eb3d0cd9b02f7a,1,Matt Gilman,2015-01-14 11:33:58-05:00,['67dee2e33b19589ea6756b031ecf68540008bd33'],11,64,75,577941,7,0.903225806,1,0.967741935,2531
210a21cd8f13fd477a595dc6c83cffce0b6be3e0,1,Mark Payne,2015-01-14 12:19:50-05:00,['67dee2e33b19589ea6756b031ecf68540008bd33'],2,4,6,577947,1,0,0,1,2531
c62aba1336f0a77d9baae8ba261877d959bf97bb,0,Mark Payne,2015-01-14 12:22:10-05:00,"['210a21cd8f13fd477a595dc6c83cffce0b6be3e0', '5fe4c15cd004015f6b18a2d4a5eb3d0cd9b02f7a']",11,64,75,578022,7,,,,2531
7737fbd84d955520e2f6e23bbbfa8a5ebe43b3ed,1,Mark Payne,2015-01-14 12:24:09-05:00,['c62aba1336f0a77d9baae8ba261877d959bf97bb'],14,234,248,578270,4,0.034246575,0.273972603,1,2532
d3aec885145ab46aa79812f613db8a3762adb443,0,Mark Payne,2015-01-14 12:26:43-05:00,['7737fbd84d955520e2f6e23bbbfa8a5ebe43b3ed'],1,1,2,578272,1,,,,2532
a6f0948af1fb12dfbc7f961f5078cd27e12f65cd,0,Matt Gilman,2015-01-14 12:46:53-05:00,['c62aba1336f0a77d9baae8ba261877d959bf97bb'],0,0,0,578272,4,,,,2532
7a9583592729004e2783b60dbfc5fe461ddd17b0,0,Mark Payne,2015-01-14 13:28:39-05:00,"['d3aec885145ab46aa79812f613db8a3762adb443', 'a6f0948af1fb12dfbc7f961f5078cd27e12f65cd']",0,0,0,578272,4,,,,2532
dba884c39a9aee90c491712a2150f435e66a179c,0,Benson Margulies,2015-01-14 17:24:46-05:00,['7a9583592729004e2783b60dbfc5fe461ddd17b0'],0,56,56,578328,1,,,,2533
b5c70587bc2e1bc2060df556c4c7db7b0c374254,0,Benson Margulies,2015-01-14 17:26:20-05:00,['dba884c39a9aee90c491712a2150f435e66a179c'],0,1,1,578329,1,,,,2533
01a63bd04549eb6db167ea99e1cf954727c7f344,0,joewitt,2015-01-14 19:17:31-05:00,['b5c70587bc2e1bc2060df556c4c7db7b0c374254'],0,90,90,578419,1,,,,2533
94a06fc5d5f72e2893ded51533f5d4bf691acad6,0,Mark Payne,2015-01-14 20:41:18-05:00,['01a63bd04549eb6db167ea99e1cf954727c7f344'],2,2,4,578423,2,,,,2533
ad74a4304e11e3a523ea25ab3d9d6c6ac412ee17,0,Matt Gilman,2015-01-15 07:59:02-05:00,['94a06fc5d5f72e2893ded51533f5d4bf691acad6'],10,18,28,578451,12,,,,2533
300952a984dd2d350438a404f4e04884f7a58b53,1,joewitt,2015-01-15 21:11:07-05:00,['ad74a4304e11e3a523ea25ab3d9d6c6ac412ee17'],82,111,193,578644,2451,,,,2534
9335b46aaf0e75f3e227ec903d88c2c9d11891ec,0,Benson Margulies,2015-01-16 07:46:00-05:00,['300952a984dd2d350438a404f4e04884f7a58b53'],20,31,51,578695,2,,,,2534
763251499361f96bdea122c8ba06e669806aae8b,0,Benson Margulies,2015-01-16 07:47:49-05:00,['9335b46aaf0e75f3e227ec903d88c2c9d11891ec'],5,6,11,578706,2,,,,2534
c222859a2510cf27aa1cb24caa719717bf98bb80,0,Benson Margulies,2015-01-16 07:47:59-05:00,['763251499361f96bdea122c8ba06e669806aae8b'],4,4,8,578714,2,,,,2534
3ed0d13da1bf4388f85998da38efc4506ddac7ca,0,Benson Margulies,2015-01-16 08:05:15-05:00,['c222859a2510cf27aa1cb24caa719717bf98bb80'],362,159,521,579235,3,,,,2534
8c5e866b77dc4d5dc01a1288335486e646522433,0,Benson Margulies,2015-01-16 08:12:45-05:00,['3ed0d13da1bf4388f85998da38efc4506ddac7ca'],0,10,10,579245,1,,,,2534
d2160fe985661b79e6d08b863247f8747da27a12,0,Benson Margulies,2015-01-16 08:21:22-05:00,['8c5e866b77dc4d5dc01a1288335486e646522433'],1,1,2,579247,1,,,,2534
7a70a1744e76b571d3ea2c94473e813b06d72bee,0,Benson Margulies,2015-01-16 08:23:44-05:00,['d2160fe985661b79e6d08b863247f8747da27a12'],1,1,2,579249,1,,,,2534
14877a48b9156f7f0cc300bba09fc54f22d93e84,0,Benson Margulies,2015-01-16 08:35:24-05:00,['7a70a1744e76b571d3ea2c94473e813b06d72bee'],2,2,4,579253,1,,,,2534
ab2032e63cdbc481966fda6c6fed53bbfd84b521,0,Benson Margulies,2015-01-16 08:35:34-05:00,['14877a48b9156f7f0cc300bba09fc54f22d93e84'],2,2,4,579257,1,,,,2534
314241ba81d5c0aec53d1df26b3d8d3e92544dba,0,Benson Margulies,2015-01-16 08:40:47-05:00,['ab2032e63cdbc481966fda6c6fed53bbfd84b521'],1,1,2,579259,1,,,,2534
46b0f92cb25876af9c3c6dd485070e78ef0156fd,0,Matt Gilman,2015-01-16 10:07:23-05:00,['ad74a4304e11e3a523ea25ab3d9d6c6ac412ee17'],1,1,2,579261,1,,,,2534
db23609986ba2f47f5ebd12b86d41573e588ba64,0,Matt Gilman,2015-01-16 10:18:07-05:00,"['46b0f92cb25876af9c3c6dd485070e78ef0156fd', '300952a984dd2d350438a404f4e04884f7a58b53']",82,111,193,579454,2451,,,,2534
3a7b8de0e30e7d4dac877611d0aa9bf67bfadffd,1,Mark Payne,2015-01-16 11:27:22-05:00,['94a06fc5d5f72e2893ded51533f5d4bf691acad6'],59,114,173,579627,20,0.3125,0.3125,1,2534
73384b23d1de7c814cd6b8089de7c893db057244,0,Mark Payne,2015-01-16 11:29:35-05:00,"['3a7b8de0e30e7d4dac877611d0aa9bf67bfadffd', 'db23609986ba2f47f5ebd12b86d41573e588ba64']",93,130,223,579850,2451,,,,2534
a2f63c7c886495ccee52a448e7a9625ad65ad1f9,0,joewitt,2015-01-16 11:59:49-05:00,['314241ba81d5c0aec53d1df26b3d8d3e92544dba'],112,93,205,580055,2,,,,2534
eb3d59920aaf329254fe23abb1dbfdd4873fd8dd,0,joewitt,2015-01-16 12:01:17-05:00,['a2f63c7c886495ccee52a448e7a9625ad65ad1f9'],2,2,4,580059,1,,,,2534
b1be36e6221d1275cd81f160238f04ebf0c7dbe1,0,joewitt,2015-01-16 12:01:27-05:00,['eb3d59920aaf329254fe23abb1dbfdd4873fd8dd'],2,2,4,580063,1,,,,2534
1c0eb6c66e297778df04fc7affbfe282068e18cf,1,Mark Payne,2015-01-16 12:05:23-05:00,['73384b23d1de7c814cd6b8089de7c893db057244'],411,1195,1606,581669,104,0.185185185,0,0.425925926,2548
29b3ad89a46b6301e28e158e37edfe0bee808978,0,Mark Payne,2015-01-16 12:05:32-05:00,['1c0eb6c66e297778df04fc7affbfe282068e18cf'],8,142,150,581819,3,0.703703704,0.759259259,1,2549
0f310325a3dde4a6774d2543f2dc11b3df0d8406,0,Mark Payne,2015-01-16 12:12:27-05:00,['29b3ad89a46b6301e28e158e37edfe0bee808978'],0,0,0,581819,15,,,,2549
9c8c1c4f48b951c06301077ffbcd51eb470d31cc,0,joewitt,2015-01-16 12:20:20-05:00,['b1be36e6221d1275cd81f160238f04ebf0c7dbe1'],1,1,2,581821,1,,,,2549
c91d875f3649b73ce909585780b2e218736e76d6,0,joewitt,2015-01-16 12:32:07-05:00,['9c8c1c4f48b951c06301077ffbcd51eb470d31cc'],2,2,4,581825,2,,,,2549
ad1b768fc22633f52e1c8aba9f277ef39d6653fb,0,joewitt,2015-01-16 12:33:33-05:00,"['73384b23d1de7c814cd6b8089de7c893db057244', 'c91d875f3649b73ce909585780b2e218736e76d6']",433,233,666,582491,3,,,,2549
6b5d1a86bec2d1d56bc44c2e400820feb4b42e2a,0,Mark Payne,2015-01-16 12:58:37-05:00,['0f310325a3dde4a6774d2543f2dc11b3df0d8406'],0,3,3,582494,1,,,,2549
dea2f0d71f8af645ef3958ef84b84ed983a9b3e4,0,joewitt,2015-01-16 13:02:38-05:00,['ad1b768fc22633f52e1c8aba9f277ef39d6653fb'],2,2,4,582498,1,,,,2549
6f189266b4c0603daf2e36c7ee2cf8a02709aaa3,0,joewitt,2015-01-16 13:02:48-05:00,['dea2f0d71f8af645ef3958ef84b84ed983a9b3e4'],2,2,4,582502,1,,,,2549
68707ce3c43f96e6a26789686c8f5bc397c6a532,1,Mark Payne,2015-01-16 13:35:17-05:00,['6b5d1a86bec2d1d56bc44c2e400820feb4b42e2a'],26,40,66,582568,3,1,1,0,2549
7bcfc93d6e102691d0e7d7d6b4bc5efb223e8349,0,Mark Payne,2015-01-16 13:41:53-05:00,['68707ce3c43f96e6a26789686c8f5bc397c6a532'],0,92,92,582660,2,,,,2551
d734220d1e59ff02878a2b9f3913348e8d38ae17,1,Mark Payne,2015-01-16 15:51:34-05:00,['7bcfc93d6e102691d0e7d7d6b4bc5efb223e8349'],8,126,134,582794,4,1,1,0.966101695,2551
d8e1f570a68df152f1d29d60acf732a0f6b532ec,1,Mark Payne,2015-01-16 15:52:47-05:00,['d734220d1e59ff02878a2b9f3913348e8d38ae17'],37,238,275,583069,6,0.745762712,0.483050847,0.457627119,2551
bc94f716c6225122323aa82aa1daff93bdc14f93,1,joewitt,2015-01-17 03:18:50-05:00,['6f189266b4c0603daf2e36c7ee2cf8a02709aaa3'],4493,617,5110,588179,155,0.437458194,0.193311037,0.074247492,2556
f21b502ae3a93277a55fe58ba3eeda0c4a0d63df,1,joewitt,2015-01-17 16:54:46-05:00,['bc94f716c6225122323aa82aa1daff93bdc14f93'],18,2,20,588199,3,,,,2556
bc448e59a01b7bdd3bfd6e1a9c1f2f36bd85b0c3,0,joewitt,2015-01-18 14:23:05-05:00,['f21b502ae3a93277a55fe58ba3eeda0c4a0d63df'],19,0,19,588218,2,,,,2556
850396cc979173e2f20ab08004f1983024d66b00,0,Mark Payne,2015-01-18 20:25:32-05:00,['d8e1f570a68df152f1d29d60acf732a0f6b532ec'],1,19,20,588238,5,1,1,1,2556
52e9c4a5a9f02b4a9b52b54e85c2a0aaffe4e416,0,joewitt,2015-01-19 09:38:24-05:00,['bc448e59a01b7bdd3bfd6e1a9c1f2f36bd85b0c3'],3,3,6,588244,2,,,,2556
53328a4a029058c07ff0b429fcac3e29af7f8267,1,Mark Payne,2015-01-20 12:59:13-05:00,['850396cc979173e2f20ab08004f1983024d66b00'],4,332,336,588580,5,0.692307692,1,0.794871795,2556
b5956709b724a2a3520c6b6f5c877653b599ac5e,1,Mark Payne,2015-01-20 12:59:59-05:00,['53328a4a029058c07ff0b429fcac3e29af7f8267'],25,97,122,588702,8,1,1,1,2556
bd290018adf08bf027d19f9891e257517e74a7a4,0,Mark Payne,2015-01-20 13:00:44-05:00,['b5956709b724a2a3520c6b6f5c877653b599ac5e'],3,16,19,588721,1,,,,2556
1b1f45faac1dc611a6df38abd6cdfb51ba382023,1,Mark Payne,2015-01-20 13:02:59-05:00,['bd290018adf08bf027d19f9891e257517e74a7a4'],124,83,207,588928,4,1,0,0,2556
1a402d468a42286fef4276d61de999f0862dc6a3,0,Mark Payne,2015-01-20 13:03:21-05:00,['1b1f45faac1dc611a6df38abd6cdfb51ba382023'],2,2,4,588932,1,,,,2556
f6d9354bfb08a2351aca0b5f2356b766f7e5550e,1,joewitt,2015-01-21 01:47:48-05:00,['52e9c4a5a9f02b4a9b52b54e85c2a0aaffe4e416'],8476,547,9023,597955,2149,0.577394763,0.249254226,0.127278754,2557
cff8b0de40c66a9dfcceafc89502957fd49959ca,0,joewitt,2015-01-21 02:12:20-05:00,['f6d9354bfb08a2351aca0b5f2356b766f7e5550e'],4,4,8,597963,2,,,,2557
db2072ed8aa46bd8d157fe13387558f9ff7e44df,1,bbende,2015-01-22 08:53:23-05:00,['cff8b0de40c66a9dfcceafc89502957fd49959ca'],0,485,485,598448,11,1,1,1,2567
b942daa65ae4e2991d43a087fbcdde5057fbd463,0,Mark Payne,2015-01-22 09:07:51-05:00,['1a402d468a42286fef4276d61de999f0862dc6a3'],2,11,13,598461,2,,,,2567
a0b70fa9c62319670fbb9bb56267e5cbce780bf6,0,Mark Payne,2015-01-22 10:18:55-05:00,['db2072ed8aa46bd8d157fe13387558f9ff7e44df'],19,9,28,598489,4,1,1,1,2567
716e03b502afa2f0f99e6b4a15f46e321c5ffda4,0,Mark Payne,2015-01-22 10:59:36-05:00,"['b942daa65ae4e2991d43a087fbcdde5057fbd463', 'cff8b0de40c66a9dfcceafc89502957fd49959ca']",13284,1244,14528,613017,2205,,,,2567
5161b234a51be5c8694c90b4fa9c8e2991de95f3,1,Mark Payne,2015-01-22 11:59:53-05:00,['716e03b502afa2f0f99e6b4a15f46e321c5ffda4'],4,58,62,613079,10,,,,2567
413a0b22a7d53b27d2344ecf75b7feb66f9145e0,1,Mark Payne,2015-01-22 12:03:24-05:00,['5161b234a51be5c8694c90b4fa9c8e2991de95f3'],24,20,44,613123,6,,,,2567
2f4727db5df97fc9bced2ec4c08800ab63abb8c3,1,Matt Gilman,2015-01-22 15:41:26-05:00,['cff8b0de40c66a9dfcceafc89502957fd49959ca'],3,9,12,613135,1,0,0,1,2567
27f6918445a14f5600446ffab5eb54256f90e305,0,bbende,2015-01-22 21:09:30-05:00,['db2072ed8aa46bd8d157fe13387558f9ff7e44df'],49,58,107,613242,9,,,,2567
5f3653b342d3a6564d19c7b380b6a7e8cd81f6b1,0,bbende,2015-01-22 21:12:18-05:00,"['27f6918445a14f5600446ffab5eb54256f90e305', '2f4727db5df97fc9bced2ec4c08800ab63abb8c3']",3,9,12,613254,1,,,,2567
f85b8714a10dd314c07de8f2150945c0b6191e88,0,joewitt,2015-01-23 01:25:59-05:00,['2f4727db5df97fc9bced2ec4c08800ab63abb8c3'],2,3,5,613259,1,,,,2567
43e646e68e4871325124f9978f24733f717036c3,0,joewitt,2015-01-23 01:26:58-05:00,['f85b8714a10dd314c07de8f2150945c0b6191e88'],2,3,5,613264,1,,,,2567
6e69d99444e22772df300cd777096dc21a7c8e35,0,joewitt,2015-01-23 01:28:31-05:00,['43e646e68e4871325124f9978f24733f717036c3'],2,2,4,613268,1,,,,2567
4431d9c2cf8b3e77c566718d941ef6f0ef581414,0,joewitt,2015-01-23 01:28:41-05:00,['6e69d99444e22772df300cd777096dc21a7c8e35'],2,2,4,613272,1,,,,2567
0b692b1d8205007a796b41b5df692e00d68addc4,0,joewitt,2015-01-23 01:30:27-05:00,['4431d9c2cf8b3e77c566718d941ef6f0ef581414'],1,1,2,613274,1,,,,2567
3a7625920866deaab1f3973fc4db0847d054a9b5,1,joewitt,2015-01-23 01:36:24-05:00,['0b692b1d8205007a796b41b5df692e00d68addc4'],206,204,410,613684,82,,,,2567
418e932ce68b7f21a4ac900e3223972b20edd487,0,joewitt,2015-01-23 01:36:35-05:00,['3a7625920866deaab1f3973fc4db0847d054a9b5'],199,199,398,614082,82,,,,2567
a4e4af7cba686ee3929d4515df77ea26b408c3d9,1,Mark Payne,2015-01-23 10:35:41-05:00,['413a0b22a7d53b27d2344ecf75b7feb66f9145e0'],41,70,111,614193,8,1,1,1,2567
d0e15f1eefacaa127970e9658d922f3bb4888190,0,Mark Payne,2015-01-23 10:46:31-05:00,['a4e4af7cba686ee3929d4515df77ea26b408c3d9'],6,6,12,614205,3,,,,2567
8b3f3c75cd1cd4212afca998d8032455492e55de,0,Mark Payne,2015-01-23 11:13:31-05:00,"['a0b70fa9c62319670fbb9bb56267e5cbce780bf6', '43e646e68e4871325124f9978f24733f717036c3']",7,15,22,614227,3,,,,2567
c8ecdd9ddfe847477cd916eb995ae9266919f8c6,1,Mark Payne,2015-01-23 12:00:21-05:00,['8b3f3c75cd1cd4212afca998d8032455492e55de'],12,22,34,614261,1,0,0.625,1,2567
cd3094d54fa2c8681d072c6c1c3fff6ffde1059b,0,Mark Payne,2015-01-23 12:12:30-05:00,"['c8ecdd9ddfe847477cd916eb995ae9266919f8c6', '5f3653b342d3a6564d19c7b380b6a7e8cd81f6b1']",46,55,101,614362,9,,,,2567
8ee676212677f150d29ec585b5b22d88bffaf34c,1,Jenn Barnabee,2015-01-23 13:17:05-05:00,['43e646e68e4871325124f9978f24733f717036c3'],0,307,307,614669,1,,,,2567
8a9960e4e7771ed0fb6d849847de818389e4f7b1,0,Mark Payne,2015-01-23 13:23:32-05:00,['cd3094d54fa2c8681d072c6c1c3fff6ffde1059b'],0,3,3,614672,1,,,,2567
f9cfbae643d604bb52f73955941872665c7873de,0,Mark Payne,2015-01-23 13:46:11-05:00,['8a9960e4e7771ed0fb6d849847de818389e4f7b1'],0,41,41,614713,2,,,,2567
2fb30c774cfcae39e59ea33f19ca99a2d46cc799,0,Matt Gilman,2015-01-23 13:56:12-05:00,['43e646e68e4871325124f9978f24733f717036c3'],1,3,4,614717,1,0,1,1,2567
c4dffe2ab649e305852ed5bca65558b86a30881e,0,Mark Payne,2015-01-23 13:59:56-05:00,"['f9cfbae643d604bb52f73955941872665c7873de', '8ee676212677f150d29ec585b5b22d88bffaf34c']",0,307,307,615024,1,,,,2567
33cee9d7651c7351714fd736a10803e00fc08f23,0,Matt Gilman,2015-01-23 14:02:35-05:00,"['2fb30c774cfcae39e59ea33f19ca99a2d46cc799', 'c4dffe2ab649e305852ed5bca65558b86a30881e']",12,857,869,615893,15,,,,2567
61e743ff1d106c53dbba47b3ad0f03cae8f04025,0,Mark Payne,2015-01-26 08:30:53-05:00,"['d0e15f1eefacaa127970e9658d922f3bb4888190', '33cee9d7651c7351714fd736a10803e00fc08f23']",20,875,895,616788,18,,,,2567
6b560b95064115a69556e1e661b7ec89dab47fc2,0,Mark Payne,2015-01-26 08:31:57-05:00,['61e743ff1d106c53dbba47b3ad0f03cae8f04025'],0,2,2,616790,1,,,,2567
98afcce0dc3672fe04e2130ac72b9a201e17ba1a,1,gresockj,2015-01-27 17:32:38-05:00,['6b560b95064115a69556e1e661b7ec89dab47fc2'],315,473,788,617578,2,1,1,0,2568
ad40903458cd2bbf98284d693a057519d8bbf775,0,gresockj,2015-01-27 17:51:16-05:00,['98afcce0dc3672fe04e2130ac72b9a201e17ba1a'],1,1,2,617580,1,,,,2568
5830f005f526acbc228eab5201260b0063b8ade6,1,Mark Payne,2015-01-29 08:42:49-05:00,['6b560b95064115a69556e1e661b7ec89dab47fc2'],16,1775,1791,619371,1,,,,2568
bafa945a763380062e5b65838d61735c9c364d26,0,Mark Payne,2015-01-29 15:46:45-05:00,['5830f005f526acbc228eab5201260b0063b8ade6'],77,398,475,619846,1,,,,2568
615794e77fafc79ec6027484e584f76695a89573,0,gresockj,2015-01-29 17:11:56-05:00,['ad40903458cd2bbf98284d693a057519d8bbf775'],7,24,31,619877,1,0.428571429,0.428571429,1,2568
8cd461e276872f56951b5f660732a8fe229ee5ad,0,joewitt,2015-01-30 22:41:52-05:00,"['4d998c12c95a6e5ce3d66c0d861e75e33b5cf013', '6e69d99444e22772df300cd777096dc21a7c8e35']",60974,24770,85744,705621,2537,,,,2568
d2c1144870694876552dbf5d487d6cb415223fe9,0,joewitt,2015-01-30 22:42:12-05:00,"['8cd461e276872f56951b5f660732a8fe229ee5ad', '3a7625920866deaab1f3973fc4db0847d054a9b5']",209,207,416,706037,83,,,,2568
e713258be3c2aa2dc75d860bb14d238268e8dc96,0,joewitt,2015-01-30 22:48:18-05:00,"['d2c1144870694876552dbf5d487d6cb415223fe9', '418e932ce68b7f21a4ac900e3223972b20edd487']",199,199,398,706435,82,,,,2568
2253ee632d4de3023425054588b96ae3ed3f689b,0,joewitt,2015-01-30 22:49:11-05:00,"['6b560b95064115a69556e1e661b7ec89dab47fc2', '418e932ce68b7f21a4ac900e3223972b20edd487']",207,205,412,706847,83,,,,2568
02b402b8c508cf0b7800ae78fef560ba645daad6,0,joewitt,2015-01-30 22:49:29-05:00,"['2253ee632d4de3023425054588b96ae3ed3f689b', 'bafa945a763380062e5b65838d61735c9c364d26']",18,2098,2116,708963,1,,,,2568
21619da1b310d07b4a004463f37e2e91ac1cbc30,0,joewitt,2015-01-30 23:06:31-05:00,['02b402b8c508cf0b7800ae78fef560ba645daad6'],2,2,4,708967,2,,,,2568
037f36dd98833d6524e6e8c6c6b1942d7fafbcbb,0,joewitt,2015-01-30 23:22:23-05:00,"['21619da1b310d07b4a004463f37e2e91ac1cbc30', 'e713258be3c2aa2dc75d860bb14d238268e8dc96']",0,0,0,708967,0,,,,2568
51b34a060ca9b59509360d5eb57a8ac325023142,1,David Moravek,2015-02-02 09:51:11+01:00,['037f36dd98833d6524e6e8c6c6b1942d7fafbcbb'],0,1,1,708968,1,,,,2568
9cd9d126e34a3039fcf42215c4ad6e67551c8f25,1,Matt Gilman,2015-02-02 12:44:51-05:00,['037f36dd98833d6524e6e8c6c6b1942d7fafbcbb'],583,562,1145,710113,6,0,0,1,2568
b4d07e262f05ce16b4731d9a4b57de1d8d35848e,0,Matt Gilman,2015-02-02 12:45:53-05:00,['9cd9d126e34a3039fcf42215c4ad6e67551c8f25'],339,190,529,710642,2,0.024691358,0,0,2568
94b39036dc10b025c321cf983dace0a3b9f45196,0,Matt Gilman,2015-02-02 13:16:34-05:00,['b4d07e262f05ce16b4731d9a4b57de1d8d35848e'],2,2,4,710646,1,,,,2568
c01dff5922239a28d02d407fb86f27f110aceeab,0,Mark Payne,2015-02-02 13:23:36-05:00,"['bafa945a763380062e5b65838d61735c9c364d26', '615794e77fafc79ec6027484e584f76695a89573']",315,490,805,711451,2,,,,2568
600a47be166e942b64bcc7c624af5db7b5c17cc2,0,Matt Gilman,2015-02-02 13:40:07-05:00,['94b39036dc10b025c321cf983dace0a3b9f45196'],4,11,15,711466,1,0,0,1,2568
ec7f7e7717750276a6cbf56edbfcca49b1299fa5,0,Mark Payne,2015-02-02 13:51:51-05:00,['c01dff5922239a28d02d407fb86f27f110aceeab'],95,46,141,711607,2,0.19047619,0.047619048,0.047619048,2568
93b78a7dd5d4e4fa43fc84c5992010389638d595,1,Matt Gilman,2015-02-02 14:02:24-05:00,['600a47be166e942b64bcc7c624af5db7b5c17cc2'],3,13,16,711623,1,0.333333333,0.333333333,1,2568
ed8f7716061055e4039b1586a4c7ff41f6c3e06a,0,Matt Gilman,2015-02-02 14:39:49-05:00,['93b78a7dd5d4e4fa43fc84c5992010389638d595'],0,5,5,711628,1,,,,2568
c0110aa17be41c0bd521151bb3023aa73c635991,1,Jenn Barnabee,2015-02-02 15:18:25-05:00,['6b560b95064115a69556e1e661b7ec89dab47fc2'],27,132,159,711787,3,,,,2569
54e922c8f5740cab723d16b66d12b2a753c242ed,0,Mark Payne,2015-02-02 15:52:26-05:00,"['ec7f7e7717750276a6cbf56edbfcca49b1299fa5', 'ed8f7716061055e4039b1586a4c7ff41f6c3e06a']",1140,990,2130,713917,97,,,,2569
9c61bdb1025d78d49907321f29f91e8dad922fa0,0,Matt Gilman,2015-02-02 23:21:21-05:00,['54e922c8f5740cab723d16b66d12b2a753c242ed'],0,3376,3376,717293,31,0.052631579,1,1,2600
fbfebf622d45d0ae972b9e1c47c617afdb8dc978,0,joewitt,2015-02-03 07:59:50-05:00,"['9c61bdb1025d78d49907321f29f91e8dad922fa0', '51b34a060ca9b59509360d5eb57a8ac325023142']",0,1,1,717294,1,,,,2600
2c2d39c7a24dc77a84e1e095280239e0d56c8357,0,joewitt,2015-02-03 08:18:58-05:00,['fbfebf622d45d0ae972b9e1c47c617afdb8dc978'],3,0,3,717297,1,,,,2600
d926aca951b8169b0c32a583a178dedb6e1dc605,1,joewitt,2015-02-03 09:41:27-05:00,['2c2d39c7a24dc77a84e1e095280239e0d56c8357'],11,67,78,717375,6,,,,2600
d145e2098fcd7f0b1165e0ed37e93ab9482728b2,0,Matt Gilman,2015-02-03 09:43:01-05:00,['9c61bdb1025d78d49907321f29f91e8dad922fa0'],7,18,25,717400,3,1,1,0.909090909,2600
a738be8f27e86fab7cf8c7bd23285fb9cb016cad,0,joewitt,2015-02-03 09:43:19-05:00,['d926aca951b8169b0c32a583a178dedb6e1dc605'],2,2,4,717404,2,,,,2600
4b852ebc651e2af7e9ba8b72494b661a86400993,0,Matt Gilman,2015-02-03 09:51:59-05:00,"['d145e2098fcd7f0b1165e0ed37e93ab9482728b2', 'a738be8f27e86fab7cf8c7bd23285fb9cb016cad']",16,70,86,717490,7,,,,2600
be16371b20eeb94c90cf369917325c76c3549e1c,0,Matt Gilman,2015-02-03 09:54:54-05:00,['4b852ebc651e2af7e9ba8b72494b661a86400993'],1,1,2,717492,1,,,,2600
102e3cb093cd7380ffaf5ebff80a8fe64485c22b,1,Mark Payne,2015-02-03 10:37:28-05:00,['be16371b20eeb94c90cf369917325c76c3549e1c'],12,18,30,717522,1,0,1,1,2600
10714efbd3d73b1abb3d8f5e48114df05ab57b96,1,Mark Payne,2015-02-03 11:57:58-05:00,['102e3cb093cd7380ffaf5ebff80a8fe64485c22b'],7,323,330,717852,3,0.084269663,1,1,2602
3b399d75044ba2bc52d6876e7fe295f85b9a1264,1,Mark Payne,2015-02-03 12:09:42-05:00,['10714efbd3d73b1abb3d8f5e48114df05ab57b96'],2,5,7,717859,1,,,,2602
7724dadf0d4a268181a59c649b3600186e892bdd,1,Mark Payne,2015-02-03 12:20:09-05:00,['3b399d75044ba2bc52d6876e7fe295f85b9a1264'],0,2,2,717861,1,,,,2602
bbb7f8d46c9b5df61747a1dfd28248b99ec00e9a,0,bbende,2015-02-03 22:24:32-05:00,['7724dadf0d4a268181a59c649b3600186e892bdd'],5,5,10,717871,1,,,,2602
8140b2a9475f32e131d2302b74d9864694c06ab5,0,Matt Gilman,2015-02-03 22:44:07-05:00,['be16371b20eeb94c90cf369917325c76c3549e1c'],105,190,295,718166,7,,,,2603
e45dea1b1cb79b1b28e20241fb0e35130b33b2a3,0,Matt Gilman,2015-02-03 22:44:33-05:00,"['8140b2a9475f32e131d2302b74d9864694c06ab5', '7724dadf0d4a268181a59c649b3600186e892bdd']",21,348,369,718535,6,,,,2603
b0b14ed10b79ab3d8d6caa0aef2d337b42cfefdd,0,Matt Gilman,2015-02-04 07:20:49-05:00,['e45dea1b1cb79b1b28e20241fb0e35130b33b2a3'],0,7,7,718542,1,,,,2603
629ec371cdca232c7f40991c35dc628590c11c6f,0,Mark Payne,2015-02-04 08:02:41-05:00,"['bbb7f8d46c9b5df61747a1dfd28248b99ec00e9a', 'b0b14ed10b79ab3d8d6caa0aef2d337b42cfefdd']",105,197,302,718844,8,,,,2603
4e85e34c319c847632574c9589b3aa0fdbc355b6,1,Matt Gilman,2015-02-04 09:05:18-05:00,['b0b14ed10b79ab3d8d6caa0aef2d337b42cfefdd'],51,48,99,718943,4,1,1,0,2603
3a0cb2d63404210da1b4b6827bec84f87166f60b,0,Matt Gilman,2015-02-04 09:35:29-05:00,"['4e85e34c319c847632574c9589b3aa0fdbc355b6', '629ec371cdca232c7f40991c35dc628590c11c6f']",5,5,10,718953,1,,,,2603
ed53b46b7aac460d0b832c20332c8881419c4fab,0,Matt Gilman,2015-02-04 10:02:51-05:00,['3a0cb2d63404210da1b4b6827bec84f87166f60b'],13,7,20,718973,3,1,1,1,2603
4a49ba7f706f2fe7c9ef77524e9dc1353c238ec8,1,joewitt,2015-02-05 00:42:12-05:00,['ed53b46b7aac460d0b832c20332c8881419c4fab'],264,4419,4683,723656,29,,,,2625
d36a71c25c0c9a6f25ce800ba495f04bcb6cb8cd,1,Matt Gilman,2015-02-05 23:33:19-05:00,['4a49ba7f706f2fe7c9ef77524e9dc1353c238ec8'],6,67,73,723729,9,0,1,1,2629
05b64593b6958aa807066e0df1571becf589dc17,1,Mark Payne,2015-02-06 08:19:54-05:00,['ed53b46b7aac460d0b832c20332c8881419c4fab'],1532,3898,5430,729159,94,0.644361834,0.841387856,0.887236679,2676
c14aef4c750d9224ef02a4adb36b07234db5c852,0,Aldrin Piri,2015-02-06 14:51:37-05:00,['d36a71c25c0c9a6f25ce800ba495f04bcb6cb8cd'],1,1,2,729161,1,,,,2676
2197049a6debe55697cbe5fe8cdd6a9d05d62f5f,0,Aldrin Piri,2015-02-06 15:05:14-05:00,['c14aef4c750d9224ef02a4adb36b07234db5c852'],0,4,4,729165,1,,,,2676
c36734eb8833c59329fa6d2c2cdbd5a302b2f27b,0,Aldrin Piri,2015-02-06 15:13:46-05:00,['2197049a6debe55697cbe5fe8cdd6a9d05d62f5f'],1,1,2,729167,1,,,,2676
497767389d8294e20eaefd83c0e94f1f20a18ebc,0,Aldrin Piri,2015-02-06 15:25:19-05:00,['c36734eb8833c59329fa6d2c2cdbd5a302b2f27b'],0,1,1,729168,1,,,,2676
d7cf25be9a157f6934593a325f906a0fc85e4007,1,danbress,2015-02-07 10:47:06-05:00,['497767389d8294e20eaefd83c0e94f1f20a18ebc'],0,1500,1500,730668,24,0.604265403,0.8507109,0.862559242,2696
220fcac169ce180ef0ad34a3d0080a1b03e337a7,0,danbress,2015-02-07 10:47:06-05:00,['d7cf25be9a157f6934593a325f906a0fc85e4007'],3,3,6,730674,2,,,,2696
0fa553ac0265f96cb5c2a5f42bc760aa0c65b590,0,danbress,2015-02-07 10:47:07-05:00,['220fcac169ce180ef0ad34a3d0080a1b03e337a7'],7015,1434,8449,739123,85,,,,2719
f269861d9d5b7e1d2a54750840831239a16490d1,0,danbress,2015-02-07 10:47:08-05:00,['0fa553ac0265f96cb5c2a5f42bc760aa0c65b590'],34,2,36,739159,2,0,0,0,2719
60070706281e8d8cd8ee2a15312f62a1af9e7e0c,1,danbress,2015-02-07 10:47:09-05:00,['f269861d9d5b7e1d2a54750840831239a16490d1'],25,53,78,739237,3,0.380952381,1,0.904761905,2719
5f1fb45c91911fffd58e5ab8b4403265236d9b27,0,danbress,2015-02-07 10:47:10-05:00,['60070706281e8d8cd8ee2a15312f62a1af9e7e0c'],1,9,10,739247,1,0,0,1,2719
c3085b8b21501c48c8debf504a6ce893af552dc8,0,danbress,2015-02-07 10:47:11-05:00,['5f1fb45c91911fffd58e5ab8b4403265236d9b27'],1,2,3,739250,1,0,0,1,2719
6e80ae7b9bc95c86bc907823be4eb0dd41a369e2,0,danbress,2015-02-07 10:47:12-05:00,['c3085b8b21501c48c8debf504a6ce893af552dc8'],44,28,72,739322,1,0.066666667,0,0,2719
4ab278dd197c81e40b73f70e03fbb71997be6823,0,danbress,2015-02-07 11:51:04-05:00,['6e80ae7b9bc95c86bc907823be4eb0dd41a369e2'],23,71,94,739416,1,,,,2719
9552b189c9861d4eb54bb7a2a569e1447c13332a,0,danbress,2015-02-07 11:51:18-05:00,['4ab278dd197c81e40b73f70e03fbb71997be6823'],0,4,4,739420,1,1,1,1,2719
ef6d76cbd92b96c8eb9c5d45f0189888c63d8fb9,0,danbress,2015-02-07 11:54:01-05:00,['9552b189c9861d4eb54bb7a2a569e1447c13332a'],7,7,14,739434,1,,,,2719
34625796880e39a0a453eeb346b15d6ca9d25a7a,0,danbress,2015-02-07 16:52:27-05:00,['497767389d8294e20eaefd83c0e94f1f20a18ebc'],5,9,14,739448,1,,,,2719
82b6a03f14f6f51cd216c3dfcef60115675aac4b,0,danbress,2015-02-07 16:52:28-05:00,['34625796880e39a0a453eeb346b15d6ca9d25a7a'],7,7,14,739462,1,,,,2719
a816486de64fb03c758453d4a54e4c14ca72cf2e,0,danbress,2015-02-07 17:25:45-05:00,['82b6a03f14f6f51cd216c3dfcef60115675aac4b'],2,2,4,739466,1,,,,2719
d53abf02d1fb516cf88cba4a3e30993a8d3bb885,0,danbress,2015-02-08 10:15:51-05:00,['ef6d76cbd92b96c8eb9c5d45f0189888c63d8fb9'],23,23,46,739512,20,,,,2719
488085b8a07a833dd9174897a69d2e2a107654fd,0,danbress,2015-02-08 11:13:48-05:00,['a816486de64fb03c758453d4a54e4c14ca72cf2e'],0,400,400,739912,2,,,,2720
d016c643f32a9b5d40a498731cabe50e08d418f6,0,danbress,2015-02-08 11:23:43-05:00,['488085b8a07a833dd9174897a69d2e2a107654fd'],4,5,9,739921,1,,,,2720
00c010b1bce614e2721ce1b21caabbdf3df3c795,0,danbress,2015-02-08 11:47:33-05:00,['d016c643f32a9b5d40a498731cabe50e08d418f6'],0,19,19,739940,1,,,,2720
dfaac5b579c74218655e88cdef0e374a5b2e29ac,0,joewitt,2015-02-08 13:20:49-05:00,['00c010b1bce614e2721ce1b21caabbdf3df3c795'],15,318,333,740273,6,,,,2722
e7a0d00322c03feb59ab8c819f1b57ea31d6e4f8,0,joewitt,2015-02-08 13:37:52-05:00,['dfaac5b579c74218655e88cdef0e374a5b2e29ac'],1,1,2,740275,1,,,,2722
f6654514523cc303dee511534f872bb64e74fd09,0,joewitt,2015-02-08 13:39:52-05:00,['e7a0d00322c03feb59ab8c819f1b57ea31d6e4f8'],1,1,2,740277,1,,,,2722
74857166f8eb757754283960867ad7fda9541d05,1,danbress,2015-02-08 14:34:56-05:00,['d53abf02d1fb516cf88cba4a3e30993a8d3bb885'],5,122,127,740404,5,0.475,1,1,2724
1dc879c131834682aa2cd26236e26d1bf738e855,1,Matt Gilman,2015-02-09 07:31:15-05:00,['d36a71c25c0c9a6f25ce800ba495f04bcb6cb8cd'],1,1,2,740406,1,,,,2724
0133f8471864efc0c316048b5a26e9d12351bab9,0,Matt Gilman,2015-02-09 07:31:25-05:00,"['1dc879c131834682aa2cd26236e26d1bf738e855', 'f6654514523cc303dee511534f872bb64e74fd09']",28,760,788,741194,9,,,,2724
b64fe4755a13e5c4e53ac38ff2df5879f92029e7,0,Matt Gilman,2015-02-09 08:51:21-05:00,['0133f8471864efc0c316048b5a26e9d12351bab9'],0,3,3,741197,1,1,1,1,2724
081471c420f113f0eb1440df74f7dff0e04067ec,1,Mark Payne,2015-02-09 20:41:39-05:00,['05b64593b6958aa807066e0df1571becf589dc17'],380,436,816,742013,29,0,1,0.924528302,2725
4c04fe65285ca90d86e937eae3438f4dddb6c86f,0,Mark Payne,2015-02-09 20:42:37-05:00,"['081471c420f113f0eb1440df74f7dff0e04067ec', '0133f8471864efc0c316048b5a26e9d12351bab9']",293,5241,5534,747547,45,,,,2725
8a1a4b807e682fc6e69bcc4656682b187f9847fa,1,Adam Sotona,2015-02-10 10:07:03+01:00,['b64fe4755a13e5c4e53ac38ff2df5879f92029e7'],1,121,122,747669,3,0.636363636,0.75,0.727272727,2726
4ab5c308fd7abcabaacea2457fd7867a1e1f9210,0,Matt Gilman,2015-02-10 07:28:12-05:00,['4c04fe65285ca90d86e937eae3438f4dddb6c86f'],1,1,2,747671,1,,,,2726
afe446774d3152aa0d651b97f45c239a7d9e51a2,0,Mark Payne,2015-02-10 09:19:41-05:00,['8a1a4b807e682fc6e69bcc4656682b187f9847fa'],1,6,7,747678,1,0,1,1,2726
602fa7a8605851b565390fefc7d5d3ef3afeb3e2,1,Mark Payne,2015-02-10 09:49:43-05:00,['afe446774d3152aa0d651b97f45c239a7d9e51a2'],55,339,394,748072,3,0.658730159,1,0.96031746,2728
eabf2d52fc48731cd5a78b602d401d441657b3a6,0,Mark Payne,2015-02-10 10:27:17-05:00,['602fa7a8605851b565390fefc7d5d3ef3afeb3e2'],8,11,19,748091,3,0,0,0,2728
56a6bc4fe494828fbfe66b39a16d38cf4133c043,0,Matt Gilman,2015-02-10 20:43:39-05:00,['eabf2d52fc48731cd5a78b602d401d441657b3a6'],0,36,36,748127,2,,,,2728
ee3e92ce63f39d05383ac083d187254292e40935,0,David Medinets,2015-02-11 23:06:38-05:00,['56a6bc4fe494828fbfe66b39a16d38cf4133c043'],0,4,4,748131,1,,,,2728
75b5f489c981305c11092bd7b229780db841dbdb,0,David Medinets,2015-02-11 23:07:05-05:00,"['56a6bc4fe494828fbfe66b39a16d38cf4133c043', 'ee3e92ce63f39d05383ac083d187254292e40935']",0,4,4,748135,1,,,,2728
ab32bbff136a61294f5ee20890bf92340c29b16c,0,Laszlo Hornyak,2015-02-12 08:59:27+01:00,['56a6bc4fe494828fbfe66b39a16d38cf4133c043'],1,1,2,748137,1,,,,2728
685035a8672fee3132d457879482ac51740498b2,0,Matt Gilman,2015-02-12 06:57:05-05:00,"['75b5f489c981305c11092bd7b229780db841dbdb', 'ab32bbff136a61294f5ee20890bf92340c29b16c']",1,1,2,748139,1,,,,2728
e0390ec3f4c9f90112addb00eeaa5882a647cdfc,0,Matt Gilman,2015-02-12 07:09:18-05:00,['685035a8672fee3132d457879482ac51740498b2'],1,3,4,748143,1,1,1,1,2728
e486c5642bf7bf0131f3c19a117e8448a75ba8af,0,Matt Gilman,2015-02-12 07:59:04-05:00,['e0390ec3f4c9f90112addb00eeaa5882a647cdfc'],1,1,2,748145,1,,,,2728
d1e058cde7b011a4daa0d574d392569460fc70ba,1,Mark Payne,2015-02-12 08:16:55-05:00,['4ab5c308fd7abcabaacea2457fd7867a1e1f9210'],382,720,1102,749247,15,0.164179104,0.134328358,0.156716418,2731
5c8a9e22d11007487b00d42455bc630451c76f82,1,Mark Payne,2015-02-12 09:15:07-05:00,['d1e058cde7b011a4daa0d574d392569460fc70ba'],33,47,80,749327,3,0.2,0.1,1,2731
05c01952ad4604c5ca5ff3e75cc7823300de818b,0,Matt Gilman,2015-02-12 09:52:37-05:00,['e486c5642bf7bf0131f3c19a117e8448a75ba8af'],22,38,60,749387,3,0.1875,0.8125,1,2731
a416dfdb0f453861c71aa66be70b0f01e8aee5a5,1,Matt Gilman,2015-02-12 10:19:56-05:00,['05c01952ad4604c5ca5ff3e75cc7823300de818b'],6,13,19,749406,1,0,0,1,2731
a7eb1b76447ead258973aee0e109db5b2c70ef89,0,Matt Gilman,2015-02-12 12:33:59-05:00,['a416dfdb0f453861c71aa66be70b0f01e8aee5a5'],4,30,34,749440,1,0.176470588,0,1,2731
851fe298b836f19e2f3f0fa890639f070de62d3d,0,Matt Gilman,2015-02-12 14:17:36-05:00,['a7eb1b76447ead258973aee0e109db5b2c70ef89'],37,48,85,749525,2,0,1,1,2731
8f0402fbbc75dc20ab226bb05f7cd38df6f929d6,0,Mark Payne,2015-02-12 19:41:51-05:00,['5c8a9e22d11007487b00d42455bc630451c76f82'],23,23,46,749571,1,,,,2731
b37d8fb73302933e33db106637498579aa775b47,0,joewitt,2015-02-12 21:46:55-05:00,['851fe298b836f19e2f3f0fa890639f070de62d3d'],1,1,2,749573,1,,,,2731
ff6e5e681c51f51509ba4bbddff4c54d40a8a0e3,0,Mark Payne,2015-02-13 07:17:20-05:00,['eabf2d52fc48731cd5a78b602d401d441657b3a6'],27,132,159,749732,3,,,,2732
bf97094b8c06c476401ee517e7b4c5e5deb59e12,0,Mark Payne,2015-02-13 07:20:19-05:00,"['ff6e5e681c51f51509ba4bbddff4c54d40a8a0e3', 'b37d8fb73302933e33db106637498579aa775b47']",71,173,244,749976,9,,,,2732
1c8d0057a78ff848dab81f344d7a10cabd3a39b2,0,Jenn Barnabee,2015-02-13 08:07:20-05:00,"['c0110aa17be41c0bd521151bb3023aa73c635991', 'bf97094b8c06c476401ee517e7b4c5e5deb59e12']",1997,13369,15366,765342,198,,,,2732
5c0ed559b566b0c821c1a005d8920d5e2e3fb3f9,0,Matt Gilman,2015-02-13 08:29:24-05:00,['bf97094b8c06c476401ee517e7b4c5e5deb59e12'],18,18,36,765378,6,,,,2732
4ec9548e2c70dff3a0d396c5e00804982231ca5f,1,Matt Gilman,2015-02-13 08:40:36-05:00,['5c0ed559b566b0c821c1a005d8920d5e2e3fb3f9'],2,2,4,765382,2,,,,2732
b8ade5b129d97249e2677ae270900d97bb813400,0,Matt Gilman,2015-02-13 10:41:05-05:00,['4ec9548e2c70dff3a0d396c5e00804982231ca5f'],28,92,120,765502,5,0.52173913,0.695652174,1,2732
446fc2ef8099faff786f11c7d640232191dac2b0,1,Aldrin Piri,2015-02-13 23:42:40-05:00,['b8ade5b129d97249e2677ae270900d97bb813400'],0,9,9,765511,2,,,,2732
0f8d00d5fff947647926570ccfa4b83ac9411e4b,1,danbress,2015-02-14 12:28:33-05:00,['b8ade5b129d97249e2677ae270900d97bb813400'],31,35,66,765577,6,,,,2732
5f03fb11d93791ea9cdde43ffb97bceaf22c0143,0,Aldrin Piri,2015-02-14 12:56:19-05:00,['446fc2ef8099faff786f11c7d640232191dac2b0'],0,59,59,765636,1,1,1,1,2733
ec669e5b42e58335ab511dfa8dfd52bd0848f088,0,Aldrin Piri,2015-02-14 13:26:08-05:00,['5f03fb11d93791ea9cdde43ffb97bceaf22c0143'],10,85,95,765731,1,0.666666667,1,0.9375,2733
e75213eead936baa7046d9c9ba5b86a4508f532a,0,Aldrin Piri,2015-02-14 13:35:53-05:00,['ec669e5b42e58335ab511dfa8dfd52bd0848f088'],0,1,1,765732,1,,,,2733
da6b55f34ced99e3364aa382732a71d2d24b33f5,0,Aldrin Piri,2015-02-14 14:13:49-05:00,['e75213eead936baa7046d9c9ba5b86a4508f532a'],3,476,479,766211,3,1,1,0.666666667,2735
361ac1f1e5c8ee943220b337c92cd49616a02194,0,danbress,2015-02-15 09:08:22-05:00,['0f8d00d5fff947647926570ccfa4b83ac9411e4b'],0,18,18,766229,1,1,1,1,2735
0fa1b16c831c413a2e31e768398da0602ca3758d,1,danbress,2015-02-15 09:24:51-05:00,['361ac1f1e5c8ee943220b337c92cd49616a02194'],0,45,45,766274,1,1,1,1,2736
40da65f1937089ea3935f21da384f4bbbc36d20d,0,Aldrin Piri,2015-02-15 15:25:22-05:00,['da6b55f34ced99e3364aa382732a71d2d24b33f5'],0,0,0,766274,1,,,,2736
c3c4d36944fa8a773d042edefa8cfa0f58edcd07,0,Aldrin Piri,2015-02-16 10:56:06-05:00,['40da65f1937089ea3935f21da384f4bbbc36d20d'],8,62,70,766344,2,0,0,1,2736
e16fc7972c24a04d8212e26f66fdcb6e940ffe86,1,Mark Payne,2015-02-16 14:18:24-05:00,['8f0402fbbc75dc20ab226bb05f7cd38df6f929d6'],140,318,458,766802,10,0.720930233,0.88372093,1,2737
2f60ddc03a3e867ea3b0826621aa63439a10bee7,0,Mark Payne,2015-02-16 15:18:57-05:00,['e16fc7972c24a04d8212e26f66fdcb6e940ffe86'],1,42,43,766845,4,0.428571429,0.428571429,1,2737
a7405b915d059483135d706a7ce6a7b848b4c175,1,Mark Payne,2015-02-16 16:49:15-05:00,['2f60ddc03a3e867ea3b0826621aa63439a10bee7'],105,198,303,767148,8,0.237288136,0.457627119,1,2738
46eebc77abb726ecc56ae7fdc71d575a1f23f39c,0,Mark Payne,2015-02-16 16:53:38-05:00,['a7405b915d059483135d706a7ce6a7b848b4c175'],2,5,7,767155,2,1,1,1,2738
b3328490c65d0b08bed4f711b6990d10262bbef2,0,Aldrin Piri,2015-02-16 18:03:24-05:00,['c3c4d36944fa8a773d042edefa8cfa0f58edcd07'],34,153,187,767342,2,0.506849315,0.506849315,1,2738
974617d44ee41bd5cac9f238eca43cb9f81684a6,0,Aldrin Piri,2015-02-16 18:09:22-05:00,['b3328490c65d0b08bed4f711b6990d10262bbef2'],0,17,17,767359,1,1,1,1,2738
78ad0a3147cf1f3573f94f79685ebb868b5d190d,0,Aldrin Piri,2015-02-16 18:20:31-05:00,['974617d44ee41bd5cac9f238eca43cb9f81684a6'],0,22,22,767381,1,1,1,1,2738
d4a94c37eea9c4a545e9f764c113a3d863257e57,0,Aldrin Piri,2015-02-16 18:24:57-05:00,['78ad0a3147cf1f3573f94f79685ebb868b5d190d'],16,41,57,767438,2,0.9375,0.9375,1,2738
6897090771434fc1553b722b835c3b67e8dd14a9,0,Aldrin Piri,2015-02-16 18:26:35-05:00,['d4a94c37eea9c4a545e9f764c113a3d863257e57'],0,22,22,767460,1,1,1,1,2738
7e581307b7d65da79464914b09fe8a90dd5046e9,0,Aldrin Piri,2015-02-16 18:33:48-05:00,['6897090771434fc1553b722b835c3b67e8dd14a9'],0,35,35,767495,1,1,1,1,2738
5b145e10e8508bec5293aab7318978fc3c9e2b57,0,Aldrin Piri,2015-02-16 18:34:23-05:00,['7e581307b7d65da79464914b09fe8a90dd5046e9'],1,1,2,767497,1,,,,2738
bcebba6632165b6d69eb88ad12895e7678079267,0,Aldrin Piri,2015-02-16 22:44:06-05:00,['5b145e10e8508bec5293aab7318978fc3c9e2b57'],21,61,82,767579,2,0.461538462,0.461538462,1,2738
0a19ada0a3229b1c8a72fe638f286db33b6f7ba6,0,Aldrin Piri,2015-02-16 23:26:45-05:00,['bcebba6632165b6d69eb88ad12895e7678079267'],16,34,50,767629,2,0.857142857,0.857142857,1,2738
fa5a4f26cef8da876a9555becade0a5a20d1506e,0,joewitt,2015-02-16 23:55:36-05:00,['b8ade5b129d97249e2677ae270900d97bb813400'],50,1,51,767680,44,,,,2738
24be4a1dfdd1dd513e39915c5db8939d4806cdd8,0,Aldrin Piri,2015-02-17 00:20:23-05:00,['b8ade5b129d97249e2677ae270900d97bb813400'],1,1,2,767682,1,,,,2738
dde5fd51a406862331c0fecc13fb1dde8d712fbe,0,joewitt,2015-02-17 00:24:58-05:00,"['fa5a4f26cef8da876a9555becade0a5a20d1506e', '24be4a1dfdd1dd513e39915c5db8939d4806cdd8']",1,1,2,767684,1,,,,2738
5a81f19b25bc073ec1089c115b6e6fcf01056f91,0,Aldrin Piri,2015-02-17 09:44:30-05:00,['0a19ada0a3229b1c8a72fe638f286db33b6f7ba6'],15,50,65,767749,2,1,1,1,2739
59ad1948519fa1f8acccfb6eafbda04684edbc96,0,Aldrin Piri,2015-02-17 10:26:18-05:00,['5a81f19b25bc073ec1089c115b6e6fcf01056f91'],89,111,200,767949,3,0.777777778,1,1,2740
7ab4392c1571fffaea1f07fd7a17279122fa3fed,0,Mark Payne,2015-02-17 10:46:29-05:00,['46eebc77abb726ecc56ae7fdc71d575a1f23f39c'],1,24,25,767974,2,0,1,1,2740
c8810c04d8dcb6823c7e59e85158a0c3cb18675f,0,danbress,2015-02-17 11:17:46-05:00,['0fa1b16c831c413a2e31e768398da0602ca3758d'],60,54,114,768088,1,1,1,0,2740
4239797b9f26f3e7be5746b55d5cac9cb7128172,0,Matt Gilman,2015-02-17 11:44:15-05:00,['dde5fd51a406862331c0fecc13fb1dde8d712fbe'],59,62,121,768209,5,0.857142857,1,0,2740
0047fa4502223fbaff858f885496dd00fe035353,1,Matt Gilman,2015-02-17 12:34:01-05:00,['4239797b9f26f3e7be5746b55d5cac9cb7128172'],10,13,23,768232,2,1,1,1,2740
09090825dea376abd5a4c962fa2034e952b7dca1,1,danbress,2015-02-17 12:39:20-05:00,['dde5fd51a406862331c0fecc13fb1dde8d712fbe'],0,8,8,768240,1,0,0,0.5,2740
16fb2b826c0cd983b5d905ceed7aff2a84383d33,1,Adam Lamar,2015-02-17 18:25:17+00:00,['dde5fd51a406862331c0fecc13fb1dde8d712fbe'],399,97,496,768736,5,0.735576923,0.740384615,0.024038462,2741
2e05dcbbfdb37843456dff121d9878d8679d7067,0,Aldrin Piri,2015-02-17 15:17:12-05:00,['59ad1948519fa1f8acccfb6eafbda04684edbc96'],7,268,275,769011,6,0.622807018,0.622807018,1,2743
7a74dd942008bf2178634746e70266f46657d4ef,0,Aldrin Piri,2015-02-17 15:50:42-05:00,['2e05dcbbfdb37843456dff121d9878d8679d7067'],8,43,51,769062,3,0.533333333,0.533333333,1,2743
1a746212bf2e13680d71dd12dfb60df3a20784ab,0,Aldrin Piri,2015-02-17 16:04:21-05:00,['7a74dd942008bf2178634746e70266f46657d4ef'],5,1,6,769068,1,0,0,0,2743
627bd91fa719748b850b6c610a89b44be3e6f35e,0,Aldrin Piri,2015-02-17 16:15:33-05:00,['1a746212bf2e13680d71dd12dfb60df3a20784ab'],3,8,11,769079,2,0,0.25,1,2743
a058fd0460dd5ca91560b1239dd733da37cfa782,0,Aldrin Piri,2015-02-17 16:58:04-05:00,['627bd91fa719748b850b6c610a89b44be3e6f35e'],0,28,28,769107,1,,,,2743
408f636361cbad025752978e10775651b7daddf4,0,Aldrin Piri,2015-02-17 17:01:06-05:00,['a058fd0460dd5ca91560b1239dd733da37cfa782'],1,2,3,769110,1,,,,2743
5f647aa46523ee98c8f8c7339216f852e422f9c7,0,Aldrin Piri,2015-02-17 18:40:12-05:00,['408f636361cbad025752978e10775651b7daddf4'],1,1,2,769112,1,,,,2743
c88b427e8201a1e1ba42720def252e0762e31ed9,0,Aldrin Piri,2015-02-17 18:42:05-05:00,['5f647aa46523ee98c8f8c7339216f852e422f9c7'],5,0,5,769117,1,,,,2743
9a5b6d5ba234c471df8faefb0ebf9470a68bebb5,0,Aldrin Piri,2015-02-17 21:29:40-05:00,['c88b427e8201a1e1ba42720def252e0762e31ed9'],16,11,27,769144,3,1,1,0,2743
f05cc9383cc86f3697aed59edefff00d35336838,0,joewitt,2015-02-17 22:17:05-05:00,"['dde5fd51a406862331c0fecc13fb1dde8d712fbe', '9a5b6d5ba234c471df8faefb0ebf9470a68bebb5']",0,1342,1342,770486,10,,,,2743
2862771235eb7a9e007c1a14096098d9809987be,1,joewitt,2015-02-17 23:29:16-05:00,['f05cc9383cc86f3697aed59edefff00d35336838'],29,65,94,770580,5,,,,2743
8506a0ce4ae71d2a103e11d6b8bf7e5832c81e09,1,Mark Payne,2015-02-18 21:19:58-05:00,['7ab4392c1571fffaea1f07fd7a17279122fa3fed'],0,325,325,770905,6,0.229508197,0.229508197,1,2748
10b5b3c90702115698b9d88180a806a44e96dda1,1,danbress,2015-02-18 21:55:47-05:00,['09090825dea376abd5a4c962fa2034e952b7dca1'],1,1,2,770907,1,,,,2748
d76fe229bb9eeead9a9daa541141588ab8b5d13a,0,Matt Gilman,2015-02-19 06:55:38-05:00,['0047fa4502223fbaff858f885496dd00fe035353'],0,4,4,770911,1,1,1,1,2748
57b5d589ad2c55394c2c96f53efd7e55a0e8c187,1,Matt Gilman,2015-02-19 07:47:58-05:00,['d76fe229bb9eeead9a9daa541141588ab8b5d13a'],8,18,26,770937,1,1,1,1,2748
dbae98f221fd97cc92f8e03c4c57a392d5c9b272,0,Matt Gilman,2015-02-19 11:09:17-05:00,['8506a0ce4ae71d2a103e11d6b8bf7e5832c81e09'],2,1,3,770940,1,,,,2748
8242417388bdfcd63cc80214b1dd1dd9c29382f5,1,Ryan Blue,2015-02-19 15:34:09-08:00,['b8ade5b129d97249e2677ae270900d97bb813400'],0,2169,2169,773109,18,0.495472186,0.769728331,0.978007762,2766
750c4ebb6c1d2f91e408ae7d8cbaf252cbcef30a,1,danbress,2015-02-19 18:54:44-05:00,['10b5b3c90702115698b9d88180a806a44e96dda1'],3,3,6,773115,2,,,,2766
b418b890a63e328136b9f1a7e15e15b01fd8883a,0,Adam Lamar,2015-02-20 09:28:00+00:00,['16fb2b826c0cd983b5d905ceed7aff2a84383d33'],2,3,5,773120,1,,,,2766
b6f40264e8c5c8ec7a15597c7886538f82748a99,0,Jenn Barnabee,2015-02-20 10:41:06-05:00,"['1c8d0057a78ff848dab81f344d7a10cabd3a39b2', 'd76fe229bb9eeead9a9daa541141588ab8b5d13a']",145,170,315,773435,60,,,,2766
81234f3a6dd1effd4c66bcbdbe8d119843b7fdf2,0,Aldrin Piri,2015-02-20 16:05:16-05:00,['2862771235eb7a9e007c1a14096098d9809987be'],54,49,103,773538,1,1,1,0,2766
46bf048b2407ddbd61024d2d0e69beccb2f72014,0,Aldrin Piri,2015-02-21 20:26:58-05:00,['81234f3a6dd1effd4c66bcbdbe8d119843b7fdf2'],94,129,223,773761,4,,,,2767
4cc106a54d9b6528e38cb99ecb15524a07a1f0c9,1,Mark Payne,2015-02-22 10:53:24-05:00,['dde5fd51a406862331c0fecc13fb1dde8d712fbe'],47,163,210,773971,6,0.076923077,0,0.984615385,2767
f1e74cc04199354a6688e15de3c9947274992caa,0,Mark Payne,2015-02-22 10:59:14-05:00,['4cc106a54d9b6528e38cb99ecb15524a07a1f0c9'],4,14,18,773989,1,0,0,1,2767
5291084dc04c5fd328619e004dbd15569e90f70d,0,Mark Payne,2015-02-22 11:18:26-05:00,"['dbae98f221fd97cc92f8e03c4c57a392d5c9b272', 'f1e74cc04199354a6688e15de3c9947274992caa']",308,1071,1379,775368,84,,,,2767
d939359bca5a2494756aa272829db677c7429e38,0,Mark Payne,2015-02-22 11:19:17-05:00,"['f1e74cc04199354a6688e15de3c9947274992caa', '57b5d589ad2c55394c2c96f53efd7e55a0e8c187']",77,97,174,775542,5,,,,2767
40e1fcbb982520851c4591970e70b03b2ab9109e,0,Mark Payne,2015-02-22 11:19:24-05:00,"['d939359bca5a2494756aa272829db677c7429e38', '5291084dc04c5fd328619e004dbd15569e90f70d']",1666,5102,6768,782310,110,,,,2767
a00aade0e5b6f568104d207e38dbdc3d091416f5,0,Mark Payne,2015-02-22 11:46:00-05:00,['40e1fcbb982520851c4591970e70b03b2ab9109e'],1,1,2,782312,1,,,,2767
42f69196c2e9afff18b864a054a5e6e30d5fe351,0,Matt Gilman,2015-02-23 07:24:39-05:00,"['57b5d589ad2c55394c2c96f53efd7e55a0e8c187', '750c4ebb6c1d2f91e408ae7d8cbaf252cbcef30a']",1,9,10,782322,2,,,,2767
01038f4e2c26c21c7443cffb8a7426596687a43e,1,Jenn Barnabee,2015-02-23 14:08:47-05:00,['b6f40264e8c5c8ec7a15597c7886538f82748a99'],2,31,33,782355,2,,,,2767
705ee852bb79dbfa5662ffa9733cbcc7b12410be,0,Mark Payne,2015-02-23 14:56:41-05:00,"['a00aade0e5b6f568104d207e38dbdc3d091416f5', '42f69196c2e9afff18b864a054a5e6e30d5fe351']",1,9,10,782365,2,,,,2767
d8954ab0137b0375dce2be8b65adbe721fc74f1b,0,Mark Payne,2015-02-23 15:34:13-05:00,"['705ee852bb79dbfa5662ffa9733cbcc7b12410be', 'c8810c04d8dcb6823c7e59e85158a0c3cb18675f']",91,152,243,782608,9,,,,2767
d6948601cd26d5a7c6cfccaaef297cebe91a9d2e,0,Aldrin Piri,2015-02-23 22:51:37-05:00,['46bf048b2407ddbd61024d2d0e69beccb2f72014'],2,2,4,782612,1,,,,2767
c5f4dff4bbf2de1c23b5743083845800f0eaccec,0,Jenn Barnabee,2015-02-24 08:17:39-05:00,['01038f4e2c26c21c7443cffb8a7426596687a43e'],15,16,31,782643,2,,,,2767
4ac6dfd5e5121291f11e2180072eb3bd5ff6d0a7,0,Jenn Barnabee,2015-02-24 13:45:49-05:00,"['c5f4dff4bbf2de1c23b5743083845800f0eaccec', 'd8954ab0137b0375dce2be8b65adbe721fc74f1b']",1814,5455,7269,789912,129,,,,2767
e370d7d7e3a78acdda5f7a3bc6d3c0a87768f7fa,0,Mark Payne,2015-02-24 14:03:00-05:00,['d8954ab0137b0375dce2be8b65adbe721fc74f1b'],44,0,44,789956,1,1,1,0,2767
a956623ff92fe35aecabd95d6f6f2b85de6b3edc,0,Mark Payne,2015-02-25 11:38:28-05:00,['e370d7d7e3a78acdda5f7a3bc6d3c0a87768f7fa'],8,8,16,789972,2,,,,2767
5aef55b5f973a290a70aa3607dbcbba47b03fe79,1,Mark Payne,2015-02-25 12:01:31-05:00,['a956623ff92fe35aecabd95d6f6f2b85de6b3edc'],3,19,22,789994,4,1,1,0.333333333,2767
ca23ad8eaa236407daff926d49c73985ed16a41e,1,Mark Payne,2015-02-25 14:06:58-05:00,['5aef55b5f973a290a70aa3607dbcbba47b03fe79'],17,66,83,790077,6,0,1,1,2767
1af8c1e22a32b2e4024a655a31735be1d170b5df,0,Mark Payne,2015-02-25 14:07:21-05:00,['ca23ad8eaa236407daff926d49c73985ed16a41e'],24,26,50,790127,1,0,0,1,2767
97aa53da66048958ebc89b442bc7d2b59e596c73,0,Mark Payne,2015-02-25 14:23:21-05:00,['1af8c1e22a32b2e4024a655a31735be1d170b5df'],0,0,0,790127,27,,,,2767
50744bfdc608c2395b7af281a587d241356e699c,0,Mark Payne,2015-02-25 14:35:45-05:00,"['97aa53da66048958ebc89b442bc7d2b59e596c73', '4ac6dfd5e5121291f11e2180072eb3bd5ff6d0a7']",14,44,58,790185,3,,,,2767
739f0c25e2c885bcfa6eef81a9e4896e618ec0fb,1,Mark Payne,2015-02-26 09:04:05-05:00,['50744bfdc608c2395b7af281a587d241356e699c'],20,26,46,790231,1,0,0,1,2767
2d48323878436c500fc90fd1d839740248d0f63d,1,Mark Payne,2015-02-26 09:05:28-05:00,['739f0c25e2c885bcfa6eef81a9e4896e618ec0fb'],0,1183,1183,791414,17,0.311904762,0.428571429,0.897619048,2777
caed7f8468bfee4db47c892bd17d2e36908fc8d2,0,Aldrin Piri,2015-02-28 12:36:30-05:00,['d6948601cd26d5a7c6cfccaaef297cebe91a9d2e'],1,1,2,791416,1,,,,2777
c53b0f9d15390ccee1c8011e6a05db82ad02f74c,1,Mark Payne,2015-02-28 14:55:56-05:00,['2d48323878436c500fc90fd1d839740248d0f63d'],0,368,368,791784,3,1,1,1,2779
b2935410a2bcae73848e817578f2e777df517a45,1,Adam Lamar,2015-02-28 20:28:37+00:00,['50744bfdc608c2395b7af281a587d241356e699c'],0,490,490,792274,3,0.510548523,0.827004219,0.945147679,2782
6a89745ec8646acfdacbf27511cb992c821c51b9,0,Aldrin Piri,2015-02-28 15:54:52-05:00,['caed7f8468bfee4db47c892bd17d2e36908fc8d2'],0,2,2,792276,1,0,0,1,2782
57aa5dd63f25c281ba95869bfbfab465465b29f8,0,Aldrin Piri,2015-02-28 16:04:43-05:00,['6a89745ec8646acfdacbf27511cb992c821c51b9'],0,2,2,792278,1,0,0,1,2782
162f02b12fd7b6d1a78efab09942ceffea49e07d,1,Aldrin Piri,2015-02-28 21:24:25-05:00,['57aa5dd63f25c281ba95869bfbfab465465b29f8'],34,26,60,792338,3,1,0,0,2782
b1f971335a464f8de34d4f360327f1c9e5e02bbe,0,Aldrin Piri,2015-03-01 00:13:22-05:00,['162f02b12fd7b6d1a78efab09942ceffea49e07d'],0,229,229,792567,2,,,,2784
4d3cff3592d16d1ce5608b20a025edf34a7c69d7,0,Aldrin Piri,2015-03-01 13:26:03-05:00,['b1f971335a464f8de34d4f360327f1c9e5e02bbe'],65,98,163,792730,4,0.296296296,0.962962963,0,2784
84602ca3e9935da74788aa893998efd2685dc873,0,Aldrin Piri,2015-03-01 13:27:40-05:00,['4d3cff3592d16d1ce5608b20a025edf34a7c69d7'],1,0,1,792731,1,1,1,0,2784
5a2a8fc6befb8305407a3f9b90443b66237e14f5,0,Aldrin Piri,2015-03-01 13:37:29-05:00,['84602ca3e9935da74788aa893998efd2685dc873'],0,11,11,792742,2,,,,2784
484687a67b12fb5fc13dabd7851f83a6e4a898be,0,Aldrin Piri,2015-03-01 14:16:22-05:00,['5a2a8fc6befb8305407a3f9b90443b66237e14f5'],2,14,16,792758,3,1,1,1,2784
7c99054183428b0a696cdf16be46267089f9faf4,1,Mark Payne,2015-03-01 14:31:26-05:00,['c53b0f9d15390ccee1c8011e6a05db82ad02f74c'],12,353,365,793123,3,0.165680473,0.846153846,0.958579882,2786
089eec2e0c03d0d3546c36fba716c71f48f66368,0,Adam Lamar,2015-03-01 19:58:46+00:00,['b418b890a63e328136b9f1a7e15e15b01fd8883a'],76,123,199,793322,5,0,0,0,2788
8f5afd0c9af068e8050810ed51ee2a055fcad379,0,Adam Lamar,2015-03-01 19:58:54+00:00,['089eec2e0c03d0d3546c36fba716c71f48f66368'],0,8,8,793330,4,0,1,1,2791
83b33c8050c024404209ad504935a50d478e0db1,1,Mark Payne,2015-03-01 15:12:24-05:00,['7c99054183428b0a696cdf16be46267089f9faf4'],4,47,51,793381,2,0.166666667,0.166666667,0.833333333,2791
96a42cd72b0f009377080d471c420e14d23eca89,0,Mark Payne,2015-03-01 15:30:42-05:00,['83b33c8050c024404209ad504935a50d478e0db1'],1,6,7,793388,2,1,1,1,2791
973b493386c71017f9baa233d4ec178251e64f53,0,Aldrin Piri,2015-03-01 16:31:32-05:00,['484687a67b12fb5fc13dabd7851f83a6e4a898be'],35,34,69,793457,2,1,1,0.692307692,2791
4618f46f278c50238ec98bf7021337564e641de0,0,Aldrin Piri,2015-03-01 21:23:01-05:00,['973b493386c71017f9baa233d4ec178251e64f53'],8,507,515,793972,4,0.102102102,0.177177177,1,2792
e6ebaa4ced457785f33df39c8635056d8a683ac4,0,Aldrin Piri,2015-03-01 21:42:56-05:00,['4618f46f278c50238ec98bf7021337564e641de0'],1,31,32,794004,3,,,,2792
245ec0ca80c6bfec71b61282d47006e41e75c445,0,joewitt,2015-03-01 22:19:27-05:00,"['96a42cd72b0f009377080d471c420e14d23eca89', 'e6ebaa4ced457785f33df39c8635056d8a683ac4']",1,2217,2218,796222,17,,,,2792
67a4faf1353530aae7828252fb474e6117e13bcc,1,joewitt,2015-03-01 23:01:31-05:00,['245ec0ca80c6bfec71b61282d47006e41e75c445'],22,5,27,796249,2,,,,2792
099865a1b6dcdccb0253d765738bed140d6724cb,0,joewitt,2015-03-01 23:12:50-05:00,['67a4faf1353530aae7828252fb474e6117e13bcc'],1,1,2,796251,1,,,,2792
fff37591a3abeb96cede6adf9fed4d5176d8690b,0,Mark Payne,2015-03-02 10:05:29-05:00,"['099865a1b6dcdccb0253d765738bed140d6724cb', 'b2935410a2bcae73848e817578f2e777df517a45']",0,490,490,796741,3,,,,2792
ee795a7d01c6ec35cfa8866c80f285040c559c81,0,Mark Payne,2015-03-02 10:12:28-05:00,"['fff37591a3abeb96cede6adf9fed4d5176d8690b', '8f5afd0c9af068e8050810ed51ee2a055fcad379']",414,168,582,797323,10,,,,2792
5e0026c14c1fea10a1bc13fc159c9b6671835fa5,0,Mark Payne,2015-03-02 11:29:01-05:00,['ee795a7d01c6ec35cfa8866c80f285040c559c81'],8,0,8,797331,4,1,0,0,2792
1263e87cdbe55554f8c133be2e1932b6fc3d7581,0,Aldrin Piri,2015-03-02 19:54:57-05:00,['5e0026c14c1fea10a1bc13fc159c9b6671835fa5'],2,2,4,797335,1,,,,2792
edb46ef311d66e49959684114bd81aeece8882e4,0,Aldrin Piri,2015-03-02 19:59:33-05:00,['1263e87cdbe55554f8c133be2e1932b6fc3d7581'],1,1,2,797337,1,,,,2792
bd74063dde9c2f89698ae8b578dbbd28f12fbb42,0,Mark Payne,2015-03-04 15:15:42-05:00,['5e0026c14c1fea10a1bc13fc159c9b6671835fa5'],2,2,4,797341,1,,,,2792
f06d21fff8e118a0c28363ef5601b676f01e40c3,1,Ryan Blue,2015-03-05 08:54:41-08:00,['8242417388bdfcd63cc80214b1dd1dd9c29382f5'],31,6,37,797378,1,,,,2792
dd879f2324a24e465bfe9cf865282eb8dedcfa2f,0,Mark Payne,2015-03-05 12:28:16-05:00,"['bd74063dde9c2f89698ae8b578dbbd28f12fbb42', 'f06d21fff8e118a0c28363ef5601b676f01e40c3']",0,2144,2144,799522,18,,,,2792
6488f3ca3d896e3eedb8f0274a6831fbc0b15319,1,Mark Payne,2015-03-05 14:56:11-05:00,['dd879f2324a24e465bfe9cf865282eb8dedcfa2f'],38,107,145,799667,6,,,,2792
d2953c6cad54ae01c32aba1d19327a9f585fffb3,0,Mark Payne,2015-03-06 13:43:01-05:00,['6488f3ca3d896e3eedb8f0274a6831fbc0b15319'],1,13,14,799681,3,,,,2792
f9620cc3689d70660b3b3dafca227aa2cba66392,0,Mark Payne,2015-03-06 13:57:57-05:00,['d2953c6cad54ae01c32aba1d19327a9f585fffb3'],0,1,1,799682,1,1,1,1,2792
608f8007ed945f5fd9bcfa6cd31e56a871d0a096,1,Mark Payne,2015-03-06 15:17:56-05:00,['f9620cc3689d70660b3b3dafca227aa2cba66392'],1,6,7,799689,1,0,0,1,2792
342ca1791a643a82ec1a1ce5abc93fcd057982b5,0,Mark Payne,2015-03-06 15:57:34-05:00,['608f8007ed945f5fd9bcfa6cd31e56a871d0a096'],1,11,12,799701,2,1,1,1,2792
3629d2441bace2a3221fa59c549eea1e6aabb786,0,danbress,2015-03-08 11:12:47-04:00,['342ca1791a643a82ec1a1ce5abc93fcd057982b5'],16,16,32,799733,2,,,,2792
12b44ee0b8446346794a25da5b0ab7d5329287a1,1,joewitt,2015-03-09 10:01:57-04:00,['342ca1791a643a82ec1a1ce5abc93fcd057982b5'],0,573,573,800306,3,0.222551929,0.445103858,0.946587537,2794
a066d9b601ae1b8910bd7e526d1c631e4e4e3aae,1,joewitt,2015-03-09 10:01:57-04:00,['12b44ee0b8446346794a25da5b0ab7d5329287a1'],7,110,117,800423,2,0,0,1,2795
3533a4a58ee2533b32c7f6cc6f758a4a5be93da4,1,joewitt,2015-03-09 10:01:57-04:00,['a066d9b601ae1b8910bd7e526d1c631e4e4e3aae'],152,168,320,800743,3,1,1,0,2795
e4ab0f4a76224305180f95567ce436cd52505d66,0,joewitt,2015-03-09 10:40:24-04:00,['3629d2441bace2a3221fa59c549eea1e6aabb786'],0,573,573,801316,3,0.222551929,0.445103858,0.946587537,2797
bd066cd567b7084015aa9c9cf4f729f337c60d4d,0,joewitt,2015-03-09 10:40:24-04:00,['e4ab0f4a76224305180f95567ce436cd52505d66'],7,110,117,801433,2,0,0,1,2798
87c666fadbd79e41ee1b9af7f1d4d00162bed151,0,joewitt,2015-03-09 10:40:24-04:00,['bd066cd567b7084015aa9c9cf4f729f337c60d4d'],152,168,320,801753,3,1,1,0,2798
a8ffbc4fc5b52365a6243352bccf0eb0dde1e623,0,joewitt,2015-03-09 10:46:35-04:00,"['87c666fadbd79e41ee1b9af7f1d4d00162bed151', '3533a4a58ee2533b32c7f6cc6f758a4a5be93da4']",0,0,0,801753,0,,,,2798
4f009fc3fb57a698dd21b7322975b02df4a4a0dc,0,joewitt,2015-03-09 10:50:17-04:00,['a8ffbc4fc5b52365a6243352bccf0eb0dde1e623'],0,0,0,801753,0,,,,2798
4e731254416307c5d027a34ad7910c1d43de1abb,1,joewitt,2015-03-09 13:13:34-04:00,['4f009fc3fb57a698dd21b7322975b02df4a4a0dc'],496,830,1326,803079,12,,,,2800
305322c499ccae55d8754035a21d549b75953b1e,0,joewitt,2015-03-09 15:17:52-04:00,"['4e731254416307c5d027a34ad7910c1d43de1abb', 'edb46ef311d66e49959684114bd81aeece8882e4']",1,1,2,803081,1,,,,2800
1de36927c69ce871c74c290e1f679b05e484fd54,0,joewitt,2015-03-09 16:55:00-04:00,['305322c499ccae55d8754035a21d549b75953b1e'],0,0,0,803081,0,,,,2800
0f68280c296d185e6dac0674902b96c45eece5a2,0,joewitt,2015-03-09 16:59:47-04:00,['1de36927c69ce871c74c290e1f679b05e484fd54'],3,14,17,803098,1,,,,2800
96e0f31ccae9c046bdc1927145aba90ecae71fe6,0,joewitt,2015-03-09 20:45:17-04:00,['0f68280c296d185e6dac0674902b96c45eece5a2'],1,62,63,803161,4,,,,2801
22c6735126ed42dce33386e3ae31e0715d742c89,0,joewitt,2015-03-09 21:10:11-04:00,['96e0f31ccae9c046bdc1927145aba90ecae71fe6'],222,216,438,803599,94,,,,2801
171dae3c8f0ecc77f934f0e5146e4782bc282fb5,1,joewitt,2015-03-09 21:10:22-04:00,['22c6735126ed42dce33386e3ae31e0715d742c89'],176,176,352,803951,94,,,,2801
053d29dc1967133e453c8e07f585def88b752cc7,0,Mark Payne,2015-03-10 12:01:42-04:00,['3533a4a58ee2533b32c7f6cc6f758a4a5be93da4'],1,0,1,803952,1,1,1,0,2801
56cc1860f16d080791772a5b1a6e546f732b41c1,1,Matt Gilman,2015-03-11 10:17:12-04:00,['96e0f31ccae9c046bdc1927145aba90ecae71fe6'],1,1,2,803954,1,,,,2801
e0de183569d3573c275823a747a24506a71eea8f,0,Jenn Barnabee,2015-03-11 11:12:48-04:00,['96e0f31ccae9c046bdc1927145aba90ecae71fe6'],2,4,6,803960,1,,,,2801
5450a5a2f00626b40b199c2ad551ac0c8cc610e5,0,James Owen,2015-03-11 18:29:08-04:00,['56cc1860f16d080791772a5b1a6e546f732b41c1'],6,22,28,803988,1,0,0.5,1,2801
7a9c8e2a4795ae7c91f8d3194d6e6f1401a41cf5,0,Jenn Barnabee,2015-03-12 15:25:37-04:00,"['e0de183569d3573c275823a747a24506a71eea8f', '56cc1860f16d080791772a5b1a6e546f732b41c1']",1,1,2,803990,1,,,,2801
e63268af04b131a4a216b15736a221762476ce20,0,Mark Payne,2015-03-12 15:43:35-04:00,"['053d29dc1967133e453c8e07f585def88b752cc7', '5450a5a2f00626b40b199c2ad551ac0c8cc610e5']",524,946,1470,805460,22,,,,2801
0f0d766707aa98a2302528ab1acfc84f48f69dad,0,Mark Payne,2015-03-12 15:44:18-04:00,"['e63268af04b131a4a216b15736a221762476ce20', '7a9c8e2a4795ae7c91f8d3194d6e6f1401a41cf5']",2,4,6,805466,1,,,,2801
71989128b9e402eab2131dc4a0486ffa1e730474,1,Mark Payne,2015-03-12 18:22:02-04:00,['0f0d766707aa98a2302528ab1acfc84f48f69dad'],2,14,16,805482,1,0,0,1,2801
fcc0078827efbdffc0929019e14103c2cfd1ee8f,1,Jenn Barnabee,2015-03-13 07:24:04-04:00,['71989128b9e402eab2131dc4a0486ffa1e730474'],1,2,3,805485,1,,,,2801
cc890e291c8f05e7369be45b8299af8764414f98,0,Jenn Barnabee,2015-03-13 08:58:23-04:00,['fcc0078827efbdffc0929019e14103c2cfd1ee8f'],2,2,4,805489,1,,,,2801
373f470b6d4c6456d2779e5ff47d2a05a7b2cdeb,1,Mark Payne,2015-03-14 17:07:29-04:00,['71989128b9e402eab2131dc4a0486ffa1e730474'],4,1662,1666,807155,22,0.363489499,0.50726979,0.98546042,2821
cf49dad2712a92cf8c3e53e0d3070b33482cc97b,0,joewitt,2015-03-14 22:36:14-04:00,['cc890e291c8f05e7369be45b8299af8764414f98'],5,0,5,807160,1,,,,2821
2de2134c64ff59ea49abe5397a167a8ae5e00885,0,joewitt,2015-03-14 23:53:23-04:00,['cf49dad2712a92cf8c3e53e0d3070b33482cc97b'],0,223,223,807383,3,,,,2823
eb757a484ebd7856238e13841fb9b994a1174840,0,joewitt,2015-03-16 10:34:00-04:00,"['2de2134c64ff59ea49abe5397a167a8ae5e00885', '171dae3c8f0ecc77f934f0e5146e4782bc282fb5']",221,215,436,807819,94,,,,2823
761e64a410a837b4fd756fd730f07621fcea8b37,1,joewitt,2015-03-16 22:48:14-04:00,['eb757a484ebd7856238e13841fb9b994a1174840'],29,149,178,807997,154,,,,2823
37645b599ec49367e874e726b6b7dadf5234a4bd,1,Ryan Blue,2015-03-16 20:53:39-07:00,['eb757a484ebd7856238e13841fb9b994a1174840'],309,39,348,808345,8,0.100917431,0.357798165,0.155963303,2823
e40cd97bb45ec7362dacf0a82ac94cf812e814b4,1,joewitt,2015-03-17 10:33:44-04:00,['761e64a410a837b4fd756fd730f07621fcea8b37'],175,175,350,808695,94,,,,2823
230e48b9f0493ffdc8a3acc16ceeb7904bd711e1,0,joewitt,2015-03-17 10:46:26-04:00,"['e40cd97bb45ec7362dacf0a82ac94cf812e814b4', '37645b599ec49367e874e726b6b7dadf5234a4bd']",309,39,348,809043,8,,,,2823
fe64d82c5810e4c4d278ae101c2ce18ae5adddfa,0,joewitt,2015-03-17 12:37:39-04:00,['230e48b9f0493ffdc8a3acc16ceeb7904bd711e1'],99,47,146,809189,6,,,,2823
1cca300d1d71a78ba0921b60ef841e3036c1e5b8,0,joewitt,2015-03-17 12:54:45-04:00,['fe64d82c5810e4c4d278ae101c2ce18ae5adddfa'],0,0,0,809189,0,,,,2823
cadfc679d80034c10ac60e2bc4dc23b1979cdffe,0,joewitt,2015-03-17 13:58:00-04:00,"['1cca300d1d71a78ba0921b60ef841e3036c1e5b8', '74857166f8eb757754283960867ad7fda9541d05']",7044,3121,10165,819354,111,,,,2823
e9d31f5d994e5d6d89edf8465942167647959abc,0,joewitt,2015-03-17 23:42:22-04:00,['cadfc679d80034c10ac60e2bc4dc23b1979cdffe'],1632,1067,2699,822053,39,0,1,1,2826
c118ead0bbaa8cd477cde99262d56529a176d41f,0,joewitt,2015-03-18 00:01:19-04:00,['e9d31f5d994e5d6d89edf8465942167647959abc'],0,0,0,822053,0,,,,2826
b560a88cbde48e669cee89e2c6cb18fcae736c72,1,Mark Payne,2015-03-18 10:10:21-04:00,['71989128b9e402eab2131dc4a0486ffa1e730474'],24,26,50,822103,2,0,0,1,2826
e569af60f4c841c91762338d4d1d4b14a614fa91,0,Mark Payne,2015-03-18 10:10:49-04:00,"['b560a88cbde48e669cee89e2c6cb18fcae736c72', 'c118ead0bbaa8cd477cde99262d56529a176d41f']",8567,4090,12657,834760,375,,,,2826
dea9e224752d6fa2c7036174199b819e149ab0ed,1,joewitt,2015-03-18 16:27:01-04:00,['e569af60f4c841c91762338d4d1d4b14a614fa91'],20,22,42,834802,1,,,,2826
eb5ec703ba0d5c188822a37f6d7eed14af56a594,1,Oscar de la Pena,2015-03-19 10:10:27+08:00,['dea9e224752d6fa2c7036174199b819e149ab0ed'],52,114,166,834968,2,0,1,1,2826
7272d0df58c23d099809bf96993b55d73c617476,1,Bobby Owolabi,2015-03-18 23:30:57-04:00,['dea9e224752d6fa2c7036174199b819e149ab0ed'],0,108,108,835076,1,0.06185567,1,1,2826
e2760f8c980583d285137134e05c435c930fb4d2,1,Bobby Owolabi,2015-03-19 00:54:24-04:00,['7272d0df58c23d099809bf96993b55d73c617476'],133,266,399,835475,3,0.5,0.595238095,0.952380952,2827
cd183be4410bdc88de7d3a0026452ab62eb10621,0,Bobby Owolabi,2015-03-19 01:18:22-04:00,['e2760f8c980583d285137134e05c435c930fb4d2'],9,31,40,835515,1,,,,2827
3f3623647367421cd8eb318668144aca1afb9bf4,0,Bobby Owolabi,2015-03-19 01:43:17-04:00,['cd183be4410bdc88de7d3a0026452ab62eb10621'],104,108,212,835727,1,,,,2827
ad18853b589d80331e2f4574bce35d79bce09c28,0,joewitt,2015-03-19 10:05:19-04:00,['eb5ec703ba0d5c188822a37f6d7eed14af56a594'],49,345,394,836121,4,0.284210526,0.357894737,1,2828
a6740a6e2c87f4c994d305db55c0777dc4f99976,1,joewitt,2015-03-19 10:05:19-04:00,['ad18853b589d80331e2f4574bce35d79bce09c28'],79,146,225,836346,4,0.127659574,1,1,2828
8b911c5aab2a4b8283510a3423e3c8962a533b96,1,Mark Payne,2015-03-19 11:04:46-04:00,['eb5ec703ba0d5c188822a37f6d7eed14af56a594'],108,89,197,836543,6,1,0.909090909,0,2828
c9eb237895a94a27fc6f760b82b16ac3e2cdab95,0,Mark Payne,2015-03-19 11:40:01-04:00,['8b911c5aab2a4b8283510a3423e3c8962a533b96'],8,1,9,836552,2,,,,2828
93b361e69bd046d6b2e0f561d8b2231a4505b6a9,0,Mark Payne,2015-03-19 11:49:11-04:00,"['c9eb237895a94a27fc6f760b82b16ac3e2cdab95', 'a6740a6e2c87f4c994d305db55c0777dc4f99976']",57,420,477,837029,6,,,,2828
e88ed13d8d7221f5a91588f553d039d3917494be,0,Mark Payne,2015-03-20 09:11:39-04:00,"['93b361e69bd046d6b2e0f561d8b2231a4505b6a9', '3f3623647367421cd8eb318668144aca1afb9bf4']",13,280,293,837322,4,,,,2828
3ac9cbaa21c5c53a575f4086b2d7456ca22bfa17,1,danbress,2015-03-20 09:38:44-04:00,['e88ed13d8d7221f5a91588f553d039d3917494be'],4,325,329,837651,8,0.465116279,1,1,2833
faf976ca91d4e083d28a520974c98dff1acc1905,1,danbress,2015-03-20 09:42:14-04:00,['3ac9cbaa21c5c53a575f4086b2d7456ca22bfa17'],76,139,215,837866,2,0.052631579,1,0.947368421,2833
9288f237e0e15bc7cf9af67ec7c1dfd96e5dd3dd,0,danbress,2015-03-20 09:42:15-04:00,['faf976ca91d4e083d28a520974c98dff1acc1905'],5,56,61,837927,1,0,0,0,2833
376a9c6acfd6fd6dac7c35124b0763be38e619a1,1,danbress,2015-03-20 09:46:02-04:00,['9288f237e0e15bc7cf9af67ec7c1dfd96e5dd3dd'],110,285,395,838322,29,0,0,1,2833
6722fc9dbc2fcbe91ca69e12a5d85cd3134577de,0,danbress,2015-03-20 09:46:02-04:00,['376a9c6acfd6fd6dac7c35124b0763be38e619a1'],6,9,15,838337,5,1,1,1,2833
84f5a08c04808cfddc047432850b9874a3f7a230,0,danbress,2015-03-20 09:46:03-04:00,['6722fc9dbc2fcbe91ca69e12a5d85cd3134577de'],0,6,6,838343,3,,,,2833
458540e5d2e94af630c5bdeb21976171483c9887,1,danbress,2015-03-20 09:46:05-04:00,['84f5a08c04808cfddc047432850b9874a3f7a230'],15,36,51,838394,5,,,,2833
ff1ba78b342ec7a7780723e3a7f58a81e11ab7e0,1,danbress,2015-03-20 09:46:06-04:00,['458540e5d2e94af630c5bdeb21976171483c9887'],1,1,2,838396,1,,,,2833
68dffdd1d881af617ef95b2980b80ed1ac9fdf75,1,danbress,2015-03-20 09:49:27-04:00,['ff1ba78b342ec7a7780723e3a7f58a81e11ab7e0'],1503,38,1541,839937,30,,,,2833
201cfeaf1c9a79d0607450b1f085c33876a7cd57,1,danbress,2015-03-20 09:49:28-04:00,['68dffdd1d881af617ef95b2980b80ed1ac9fdf75'],4,4,8,839945,1,,,,2833
90fd0edaf85e3d175a5908760d1c841b4ac97096,0,danbress,2015-03-20 09:49:29-04:00,['201cfeaf1c9a79d0607450b1f085c33876a7cd57'],0,35,35,839980,1,,,,2833
72153c94532fc021fd973d3d8c31ed725beddd68,0,danbress,2015-03-20 09:49:29-04:00,['90fd0edaf85e3d175a5908760d1c841b4ac97096'],0,27,27,840007,4,,,,2833
bae2b4069b38e32b4b9243e314597f48633c704d,0,danbress,2015-03-20 09:49:31-04:00,['72153c94532fc021fd973d3d8c31ed725beddd68'],0,143,143,840150,4,0.30952381,1,0.976190476,2835
cce69a2f947cd66d16fcb154692f9d411dd4c815,0,danbress,2015-03-20 09:49:32-04:00,['bae2b4069b38e32b4b9243e314597f48633c704d'],2,86,88,840238,3,0.333333333,1,1,2836
a3e1d3a20bad9d8bcbb26244c0a6f03a38f01c57,0,danbress,2015-03-20 09:50:30-04:00,['cce69a2f947cd66d16fcb154692f9d411dd4c815'],21,65,86,840324,15,,,,2836
fd89849f5f081c4a0c67c0dec63130800ba6f03a,0,danbress,2015-03-20 09:50:31-04:00,['a3e1d3a20bad9d8bcbb26244c0a6f03a38f01c57'],1,3,4,840328,1,1,1,1,2836
c98ddca2eb10d4b73ba8a7a7d017983e624ea21b,0,danbress,2015-03-20 09:51:20-04:00,['fd89849f5f081c4a0c67c0dec63130800ba6f03a'],19,34,53,840381,18,0,1,1,2836
c441f9160dc3e0cc686c7e73109966120666ada6,0,danbress,2015-03-20 09:51:21-04:00,['c98ddca2eb10d4b73ba8a7a7d017983e624ea21b'],121,10,131,840512,5,,,,2836
86a429ff767527c08505c6cdf88d64b87f6fc1cc,0,danbress,2015-03-20 09:51:22-04:00,['c441f9160dc3e0cc686c7e73109966120666ada6'],0,0,0,840512,1,,,,2836
a19215fc8deab582015ace40e41db8095e1f74f1,0,danbress,2015-03-20 09:51:22-04:00,['86a429ff767527c08505c6cdf88d64b87f6fc1cc'],1,49,50,840562,3,,,,2836
5232ba33a21f04f05038837c0973e266793eef87,0,danbress,2015-03-20 09:51:23-04:00,['a19215fc8deab582015ace40e41db8095e1f74f1'],15,15,30,840592,6,,,,2836
3b33d41cc3c98ea3d48afe28e4f5b679c2a8e6e7,1,danbress,2015-03-20 09:51:24-04:00,['5232ba33a21f04f05038837c0973e266793eef87'],98,24,122,840714,4,,,,2836
be78efc010075ecc91d50fdd8f4cd22e78079d80,0,danbress,2015-03-20 09:51:24-04:00,['3b33d41cc3c98ea3d48afe28e4f5b679c2a8e6e7'],1,0,1,840715,1,1,0,0,2836
2c0eb36af8ef7a675b79edee15adfc70f450427f,1,danbress,2015-03-20 10:31:07-04:00,['be78efc010075ecc91d50fdd8f4cd22e78079d80'],2,5,7,840722,1,,,,2836
204112d3d2c6dfb6efffd9c75004e0d456926697,0,danbress,2015-03-20 10:37:13-04:00,['2c0eb36af8ef7a675b79edee15adfc70f450427f'],0,3,3,840725,1,0,1,1,2836
0bd27847ab32a859fe0dcbb80553b40c26a247ff,0,joewitt,2015-03-21 10:18:52-04:00,['204112d3d2c6dfb6efffd9c75004e0d456926697'],111,106,217,840942,41,0,0,0,2836
d696ba53ca7fb24fe586042518540948df60591e,0,joewitt,2015-03-21 17:02:21-04:00,['0bd27847ab32a859fe0dcbb80553b40c26a247ff'],391,288,679,841621,3,,,,2837
be5d13ec3b36850f1bf6d51db2d7147457994d2a,0,joewitt,2015-03-21 17:02:21-04:00,['d696ba53ca7fb24fe586042518540948df60591e'],13,19,32,841653,11,,,,2837
3c3306b7111d186526c80122da5536da2a58cef6,1,joewitt,2015-03-21 17:02:21-04:00,['be5d13ec3b36850f1bf6d51db2d7147457994d2a'],28,424,452,842105,6,,,,2841
71b6ffc95885cf648c38b0ae2c8283cd849332e4,1,bbende,2015-03-22 18:59:22-04:00,['0bd27847ab32a859fe0dcbb80553b40c26a247ff'],31,1913,1944,844049,28,0.379154079,0.723564955,0.96978852,2866
e05c9fd20e41cbb25f2e86b8a5b5791e6de65bcb,1,Matt Gilman,2015-03-22 23:13:07-04:00,['0bd27847ab32a859fe0dcbb80553b40c26a247ff'],41,1755,1796,845845,44,0.168859649,0.256578947,0.997807018,2892
511360cf59884bd451385fe005fa96aa61d584b1,0,danbress,2015-03-23 08:04:17-04:00,['0bd27847ab32a859fe0dcbb80553b40c26a247ff'],96,28,124,845969,2,,,,2893
efeba19cb6c72585ecaacbbb6662a274fab8f477,0,danbress,2015-03-23 08:04:18-04:00,['511360cf59884bd451385fe005fa96aa61d584b1'],1,1,2,845971,1,,,,2893
f63e09b9b8480d3bbe78beee4b12cd5cb3ed8979,0,danbress,2015-03-23 08:04:19-04:00,['efeba19cb6c72585ecaacbbb6662a274fab8f477'],0,8,8,845979,1,,,,2893
0f6fb7ecac8fc11a11d947db4fbf310fa1784e34,0,danbress,2015-03-23 08:04:19-04:00,['f63e09b9b8480d3bbe78beee4b12cd5cb3ed8979'],1,1,2,845981,1,,,,2893
3359891c660020cf583a92e738f9ba1b75f21aae,0,danbress,2015-03-23 08:34:41-04:00,['0f6fb7ecac8fc11a11d947db4fbf310fa1784e34'],4,4,8,845989,1,,,,2893
e78aeddb6937d5ed54f73d1f6dcf11547181e374,0,danbress,2015-03-23 09:59:50-04:00,['3359891c660020cf583a92e738f9ba1b75f21aae'],28,0,28,846017,1,,,,2893
e48ea72c305944a7df0d10e5d2a75fd0d9e66d41,0,Mark Payne,2015-03-23 10:07:22-04:00,"['e05c9fd20e41cbb25f2e86b8a5b5791e6de65bcb', 'e78aeddb6937d5ed54f73d1f6dcf11547181e374']",97,9,106,846123,3,,,,2893
b97396c0fabe5a13043e6243c2e578e527b4f0c5,1,Mark Payne,2015-03-23 10:10:49-04:00,['e48ea72c305944a7df0d10e5d2a75fd0d9e66d41'],22,167,189,846312,2,0.619047619,1,1,2893
0c5abce5f95876320586453d1391fe2588371ec3,1,danbress,2015-03-23 10:29:37-04:00,['0bd27847ab32a859fe0dcbb80553b40c26a247ff'],3,31,34,846346,2,0.4375,0.75,0.5625,2893
2f09e6ec5a1b1b4f652d46a804962a048adaceb9,1,danbress,2015-03-23 10:29:56-04:00,['0c5abce5f95876320586453d1391fe2588371ec3'],0,4,4,846350,1,,,,2893
10f724753c6e819a11a295baba0d79e292617beb,0,danbress,2015-03-23 10:30:09-04:00,['2f09e6ec5a1b1b4f652d46a804962a048adaceb9'],2,2,4,846354,1,,,,2893
2c418ece71ee20a2585364458ca4f67d96e7bd5f,0,danbress,2015-03-23 10:30:25-04:00,['10f724753c6e819a11a295baba0d79e292617beb'],1,1,2,846356,1,,,,2893
220ec94c092daf0821373b7f3d1bf91a22f096c6,0,Mark Payne,2015-03-23 14:50:57-04:00,"['b97396c0fabe5a13043e6243c2e578e527b4f0c5', '2c418ece71ee20a2585364458ca4f67d96e7bd5f']",5,37,42,846398,3,,,,2893
2429e0540fcce90bfd2ced450d4cd124cff3a6b4,0,Mark Payne,2015-03-23 15:02:03-04:00,['220ec94c092daf0821373b7f3d1bf91a22f096c6'],21,175,196,846594,6,0,0,0.831578947,2893
12fa9e79f767cabc01f6779bc5a3295fa3c595f3,0,Mark Payne,2015-03-23 15:02:42-04:00,['2429e0540fcce90bfd2ced450d4cd124cff3a6b4'],41,47,88,846682,9,0,1,1,2893
d6408046bca336e4a11a9c123eef38139f05af78,1,Mark Payne,2015-03-23 15:11:41-04:00,['12fa9e79f767cabc01f6779bc5a3295fa3c595f3'],3,8,11,846693,1,0,0,1,2893
54f3476a4cc975f52d543a53f1f9aec97ba3b858,0,Mark Payne,2015-03-23 15:19:18-04:00,['d6408046bca336e4a11a9c123eef38139f05af78'],37,41,78,846771,1,0,0,1,2893
a7b826ae20588705868749390187852f2c05e0ff,0,Mark Payne,2015-03-23 15:39:53-04:00,['54f3476a4cc975f52d543a53f1f9aec97ba3b858'],2,2,4,846775,1,,,,2893
4107a0e93492037c39333ef082da22725ce500cb,0,bbende,2015-03-23 19:46:14-04:00,"['71b6ffc95885cf648c38b0ae2c8283cd849332e4', 'a7b826ae20588705868749390187852f2c05e0ff']",270,2242,2512,849287,70,,,,2893
06ee1291c2e4a9fbfc1d79d19e426ffff9ade232,0,danbress,2015-03-24 11:56:02-04:00,['a7b826ae20588705868749390187852f2c05e0ff'],19,10,29,849316,1,0,0,0,2893
a5e140f10705e119c6aa7d52be03f01b94b75709,0,danbress,2015-03-24 14:18:56-04:00,['06ee1291c2e4a9fbfc1d79d19e426ffff9ade232'],0,8,8,849324,1,,,,2893
3a27c378cc143abc5e59dfb746c5e0d09341b185,0,Tony Kurc,2015-03-25 23:10:36-04:00,['a5e140f10705e119c6aa7d52be03f01b94b75709'],1,1,2,849326,1,,,,2893
041f543283aab1305c401e5da1378d502beea73c,0,bbende,2015-03-26 21:16:51-04:00,"['4107a0e93492037c39333ef082da22725ce500cb', '3a27c378cc143abc5e59dfb746c5e0d09341b185']",20,19,39,849365,3,,,,2893
23989609ae418bba7f18c573a8078ddecf0e8035,1,bbende,2015-03-26 22:27:09-04:00,['041f543283aab1305c401e5da1378d502beea73c'],92,115,207,849572,6,1,1,1,2893
42a4f9024262c2b6e1871d6406e81ba72695f9ab,1,Mark Payne,2015-03-27 14:46:20-04:00,['3a27c378cc143abc5e59dfb746c5e0d09341b185'],1,4,5,849577,1,0,0,1,2893
909ded32aaa4cc5f70b162792e9a4216357826e1,0,Mark Payne,2015-03-27 15:06:11-04:00,['42a4f9024262c2b6e1871d6406e81ba72695f9ab'],5,5,10,849587,1,,,,2893
878e950accd1822a50c792a6466645208bb4dffb,0,Mark Payne,2015-03-27 15:16:37-04:00,['909ded32aaa4cc5f70b162792e9a4216357826e1'],3,13,16,849603,1,0,0.5,1,2893
ed5fd733d8a80b5adbaed7389e9369c192a6f07b,0,joewitt,2015-03-30 08:55:28-04:00,['909ded32aaa4cc5f70b162792e9a4216357826e1'],4,17,21,849624,1,,,,2893
ac409fd69aefedbfa72f90d1647da4309cf46dfc,1,Brandon DeVries,2015-03-30 12:11:15-04:00,['3a27c378cc143abc5e59dfb746c5e0d09341b185'],0,153,153,849777,4,0.916666667,0.916666667,0.854166667,2896
e7d6d94584b3f04e709eeaba532f142d11d75b39,0,Brandon DeVries,2015-03-30 12:14:20-04:00,"['ed5fd733d8a80b5adbaed7389e9369c192a6f07b', 'ac409fd69aefedbfa72f90d1647da4309cf46dfc']",0,153,153,849930,4,,,,2896
509933f631533a659551c2f0c5c9d12e3f47b8e5,0,Mark Payne,2015-03-31 08:34:23-04:00,['878e950accd1822a50c792a6466645208bb4dffb'],14,202,216,850146,2,0.092307692,0.861538462,1,2896
e9647717e39d4046092ff669e5ccbcd0c2ffbd89,1,Matt Gilman,2015-03-31 16:45:05-04:00,['e7d6d94584b3f04e709eeaba532f142d11d75b39'],5096,20804,25900,876046,332,0.462603104,0.666853069,0.788759961,2958
4752e284f6b4c4d3ae082af6b6f66d393c2a1ad3,1,joewitt,2015-03-31 23:03:25-04:00,['e9647717e39d4046092ff669e5ccbcd0c2ffbd89'],14,202,216,876262,2,0.092307692,0.861538462,1,2958
30fc75e2b8a3a8cf0a36d66d5ee3eed6bc9dedb7,1,Matt Gilman,2015-04-01 09:42:33-04:00,['4752e284f6b4c4d3ae082af6b6f66d393c2a1ad3'],34,86,120,876382,5,0.111111111,0.111111111,1,2958
e2878170a1ddf680800409134684a62bc5ea0373,0,Matt Gilman,2015-04-01 11:15:07-04:00,['30fc75e2b8a3a8cf0a36d66d5ee3eed6bc9dedb7'],62,125,187,876569,8,0.916666667,1,1,2958
2c352267afec2a1a2d7bab731b55837a6f123428,0,Matt Gilman,2015-04-01 11:40:17-04:00,['e2878170a1ddf680800409134684a62bc5ea0373'],0,1,1,876570,1,,,,2958
6bbd172399f9a9966c666bb51ea3ff09affbcd11,1,Matt Gilman,2015-04-02 22:34:34-04:00,['2c352267afec2a1a2d7bab731b55837a6f123428'],1,15,16,876586,1,0,1,1,2958
2b21b46501f03b7560e09c723117abffb0065da4,1,Mark Payne,2015-04-05 09:43:10-04:00,['2c352267afec2a1a2d7bab731b55837a6f123428'],22,22,44,876630,9,,,,2958
4a16845309fce1f2cdbad3b31926563dd27b2c3c,0,Mark Payne,2015-04-05 14:22:46-04:00,['2b21b46501f03b7560e09c723117abffb0065da4'],0,1,1,876631,1,0,0,1,2958
bd6159e97f3b81468f9e63c90c3235c598b38729,0,bbende,2015-04-05 18:49:27-04:00,"['23989609ae418bba7f18c573a8078ddecf0e8035', '4a16845309fce1f2cdbad3b31926563dd27b2c3c']",5152,21334,26486,903117,340,,,,2958
5b3709fe0c9a0ba416e97832bf0a9de2806358d4,1,bbende,2015-04-05 22:22:49-04:00,['bd6159e97f3b81468f9e63c90c3235c598b38729'],172,74,246,903363,5,0,0,0,2959
e79db821b613143483c4959177b19aa4428d20a9,0,Matt Gilman,2015-04-06 07:20:24-04:00,"['6bbd172399f9a9966c666bb51ea3ff09affbcd11', '4a16845309fce1f2cdbad3b31926563dd27b2c3c']",22,23,45,903408,10,,,,2959
50986932d6cdd0ffc7a8f0a828808bb72bb4fdf5,0,Mark Payne,2015-04-06 17:59:07-04:00,['4a16845309fce1f2cdbad3b31926563dd27b2c3c'],1,3,4,903412,1,0,0,1,2959
3a2b12d7c9919c8f3be2a01125ad60ca22fecc03,0,joewitt,2015-04-06 21:13:30-04:00,['4a16845309fce1f2cdbad3b31926563dd27b2c3c'],1,3,4,903416,1,0,0,1,2959
4f015f5f435c9cf4d27c522e2363c5b2d338525c,0,Matt Gilman,2015-04-07 10:14:09-04:00,"['e79db821b613143483c4959177b19aa4428d20a9', '3a2b12d7c9919c8f3be2a01125ad60ca22fecc03']",1,3,4,903420,1,,,,2959
7369730cea59da19203e50a31cfb760db3a99023,0,Matt Gilman,2015-04-07 10:15:54-04:00,['4f015f5f435c9cf4d27c522e2363c5b2d338525c'],1,1,2,903422,1,,,,2959
a7862a19ba56f4ce8350d34b38d7d4edc6002a66,1,Mark Payne,2015-04-07 12:36:35-04:00,['50986932d6cdd0ffc7a8f0a828808bb72bb4fdf5'],1,7,8,903430,1,0,0,1,2959
c974ea90f89186bfd5f12e34f2cec3728d237b89,0,Mark Payne,2015-04-07 12:41:31-04:00,['a7862a19ba56f4ce8350d34b38d7d4edc6002a66'],3,3,6,903436,2,,,,2959
39735c30bcf2dccb090dd8c60a8668c27d9c7517,0,Mark Payne,2015-04-07 12:46:48-04:00,"['c974ea90f89186bfd5f12e34f2cec3728d237b89', '7369730cea59da19203e50a31cfb760db3a99023']",2,16,18,903454,2,,,,2959
8d20b82095857e06ee58ae892039a5f10613b125,1,Mark Payne,2015-04-07 14:16:54-04:00,['39735c30bcf2dccb090dd8c60a8668c27d9c7517'],0,14,14,903468,1,0,0,1,2959
b1970ecc1046955bcaa8ad7e4cfd9c3f92a8a306,0,Brandon DeVries,2015-04-07 16:05:55-04:00,['2c352267afec2a1a2d7bab731b55837a6f123428'],6,501,507,903975,5,0.574074074,0.722222222,1,2963
275735648aa97a59eee42d0b343411e01f71a7fb,0,Brandon DeVries,2015-04-07 16:18:48-04:00,['b1970ecc1046955bcaa8ad7e4cfd9c3f92a8a306'],8,327,335,904310,6,0.504854369,0.922330097,1,2968
89b0de85729973ddcbc1e0aa0e467ab9dc74a17c,0,bbende,2015-04-07 18:29:38-04:00,"['5b3709fe0c9a0ba416e97832bf0a9de2806358d4', '39735c30bcf2dccb090dd8c60a8668c27d9c7517']",7,29,36,904346,5,,,,2968
d769b50e39a7802dad55544f56759b976f162f70,1,Matt Gilman,2015-04-08 08:39:05-04:00,['7369730cea59da19203e50a31cfb760db3a99023'],10,13,23,904369,2,,,,2968
e456ea37f4232e9072631af986f54336904318bd,0,Matt Gilman,2015-04-08 11:28:44-04:00,"['d769b50e39a7802dad55544f56759b976f162f70', '39735c30bcf2dccb090dd8c60a8668c27d9c7517']",4,10,14,904383,3,,,,2968
2154b822bf32b661c80bb41d96d569ee3491a41b,1,Matt Gilman,2015-04-08 12:25:48-04:00,['e456ea37f4232e9072631af986f54336904318bd'],595,657,1252,905635,15,1,0.387755102,1,2968
ee0f4ef21e54278f68df5ea758e576c0d3103d6e,1,Brandon DeVries,2015-04-08 12:39:23-04:00,['39735c30bcf2dccb090dd8c60a8668c27d9c7517'],6,501,507,906142,5,0.574074074,0.722222222,1,2972
3c4ea67dde811fdf48d5e22085fde3276934252d,1,Brandon DeVries,2015-04-08 12:39:24-04:00,['ee0f4ef21e54278f68df5ea758e576c0d3103d6e'],8,327,335,906477,6,0.504854369,0.922330097,1,2977
e1e1aecc8b8e6c75f260edf248f046c1557c088b,0,Brandon DeVries,2015-04-08 12:39:41-04:00,"['3c4ea67dde811fdf48d5e22085fde3276934252d', '275735648aa97a59eee42d0b343411e01f71a7fb']",0,0,0,906477,0,,,,2977
7819afbefd980ce68f43093302997024926d9f51,1,Mark Payne,2015-04-08 13:38:33-04:00,['8d20b82095857e06ee58ae892039a5f10613b125'],1,4,5,906482,1,0,0,1,2977
abd279c1e01e3aea3332e6b378701554722317e6,0,Mark Payne,2015-04-08 13:41:34-04:00,['7819afbefd980ce68f43093302997024926d9f51'],17,119,136,906618,2,0.111111111,0.518518519,0.864197531,2977
a58891af1f232245188716fe292aea1e1dfd2c48,0,bbende,2015-04-08 17:48:26-04:00,"['89b0de85729973ddcbc1e0aa0e467ab9dc74a17c', '2154b822bf32b661c80bb41d96d569ee3491a41b']",605,670,1275,907893,17,,,,2977
e8fde859141e55fd13a1eaae77f4705e61f6071d,0,Mark Payne,2015-04-09 09:31:20-04:00,['abd279c1e01e3aea3332e6b378701554722317e6'],2,13,15,907908,1,1,1,0.625,2977
eb023e57b2b4f449e8ae9c0fb369f9197eb5510d,1,Matt Gilman,2015-04-09 15:49:46-04:00,['2154b822bf32b661c80bb41d96d569ee3491a41b'],30,165,195,908103,16,0.678571429,0.678571429,1,2979
45416dc66bc212bacf5a8429e4ae2ae880c0672c,1,Mark Payne,2015-04-09 17:54:33-04:00,['e8fde859141e55fd13a1eaae77f4705e61f6071d'],0,3862,3862,911965,66,0.51141925,0.765905383,0.931484502,3045
ff0bd2c6696e73d3157eb2d0116913e337410f38,1,Mark Payne,2015-04-09 17:54:59-04:00,['45416dc66bc212bacf5a8429e4ae2ae880c0672c'],0,631,631,912596,7,0.467391304,0.706521739,0.858695652,3052
178c5cd287eed734bd3d93665df27682db941a8b,1,Mark Payne,2015-04-09 17:55:33-04:00,['ff0bd2c6696e73d3157eb2d0116913e337410f38'],0,816,816,913412,10,0.472,0.688,0.964,3062
e9cb3b300c6b5e223744925cee1d0c59dd97d29a,1,Mark Payne,2015-04-09 17:56:52-04:00,['178c5cd287eed734bd3d93665df27682db941a8b'],449,1060,1509,914921,11,0.333333333,0.333333333,0.929824561,3068
b682b6fab543cabeb3a321d6e5cf22f7ce9968c1,1,Mark Payne,2015-04-09 17:59:02-04:00,['e9cb3b300c6b5e223744925cee1d0c59dd97d29a'],19,61,80,915001,5,0.233333333,0.8,0.966666667,3068
c1959b3e2d8f48247642655d3e8cbeb08baa3cef,1,Matt Gilman,2015-04-10 06:56:51-04:00,['eb023e57b2b4f449e8ae9c0fb369f9197eb5510d'],46,36,82,915083,1,0.583333333,0,0,3068
10d002c78a7fbd31669d840199f3138d715d6189,0,Mark Payne,2015-04-10 08:40:22-04:00,['b682b6fab543cabeb3a321d6e5cf22f7ce9968c1'],2,2,4,915087,1,,,,3068
512ac9c704e155461dac0c0c905ecccaba645c3b,0,Mark Payne,2015-04-10 08:42:43-04:00,['10d002c78a7fbd31669d840199f3138d715d6189'],1,1,2,915089,1,,,,3068
e18c0a7d267460293a7e5a0189b223607212354f,1,Mark Payne,2015-04-10 09:37:53-04:00,['512ac9c704e155461dac0c0c905ecccaba645c3b'],16,31,47,915136,4,1,1,1,3068
c201aa1d088e6e041fce8a25ca974c5759e5d61c,0,Mark Payne,2015-04-10 09:39:20-04:00,"['e18c0a7d267460293a7e5a0189b223607212354f', 'c1959b3e2d8f48247642655d3e8cbeb08baa3cef']",664,854,1518,916654,32,,,,3068
93a121044b1a7efcfc3023178fb39f2f44ad836c,0,Mark Payne,2015-04-10 09:42:53-04:00,"['373f470b6d4c6456d2779e5ff47d2a05a7b2cdeb', 'c201aa1d088e6e041fce8a25ca974c5759e5d61c']",15220,35274,50494,967148,875,,,,3068
322be256b561cd4e2af84118c64eb594ccafd285,0,Matt Gilman,2015-04-10 11:03:05-04:00,['c1959b3e2d8f48247642655d3e8cbeb08baa3cef'],2,2,4,967152,2,,,,3068
2c6b2a56640df57cb816b84b39f061d0d5271bce,0,Mark Payne,2015-04-10 11:06:12-04:00,['c201aa1d088e6e041fce8a25ca974c5759e5d61c'],1,1,2,967154,1,,,,3068
3515f2c12fedb8cd1e88bb8793b75a31317038b3,0,Mark Payne,2015-04-10 11:20:23-04:00,['2c6b2a56640df57cb816b84b39f061d0d5271bce'],119,17,136,967290,2,0.888888889,0.481481481,0.135802469,3068
9299355ae9fe31d47824acab21aa02fc92c5d897,1,Matt Gilman,2015-04-10 11:30:54-04:00,['322be256b561cd4e2af84118c64eb594ccafd285'],26,48,74,967364,1,0,1,1,3068
cd845c08f27a44092389af18a9753f328f46b622,0,Matt Gilman,2015-04-10 12:34:52-04:00,['9299355ae9fe31d47824acab21aa02fc92c5d897'],3,4,7,967371,1,,,,3068
c83c7afd9898e1032984a81d3792b174222930df,0,Mark Payne,2015-04-10 14:25:53-04:00,['3515f2c12fedb8cd1e88bb8793b75a31317038b3'],183,77,260,967631,15,1,0,0,3068
df5755514c43bc297295ac8d39c650ab2aa381db,0,Matt Gilman,2015-04-10 14:48:01-04:00,['cd845c08f27a44092389af18a9753f328f46b622'],7,14,21,967652,2,1,1,1,3068
1963c27409d99d2a05a68a8ed5ededd076bf0da7,1,Mark Payne,2015-04-10 14:51:27-04:00,['c83c7afd9898e1032984a81d3792b174222930df'],37,130,167,967819,2,0.415384615,1,0.815384615,3068
f1c36e64f1e4e5f2f24eb91291dd51cfe8893a85,0,Mark Payne,2015-04-10 14:55:23-04:00,"['1963c27409d99d2a05a68a8ed5ededd076bf0da7', 'df5755514c43bc297295ac8d39c650ab2aa381db']",38,68,106,967925,6,,,,3068
9054dd4e4273846ffd8c24e8ed1b26a6000209b6,0,Matt Gilman,2015-04-10 16:07:45-04:00,['df5755514c43bc297295ac8d39c650ab2aa381db'],4,4,8,967933,1,,,,3068
7aca8eaeae7c8907bc1f5a4ba8e4fc74e011d710,0,Matt Gilman,2015-04-11 07:55:28-04:00,"['9054dd4e4273846ffd8c24e8ed1b26a6000209b6', 'f1c36e64f1e4e5f2f24eb91291dd51cfe8893a85']",488,6480,6968,974901,99,,,,3068
9ee34e2e3cc72b579c49f97b5ae6f2601bc75087,0,joewitt,2015-04-11 12:06:45-04:00,['7aca8eaeae7c8907bc1f5a4ba8e4fc74e011d710'],2,0,2,974903,1,1,1,0,3068
0211d0d71561fb63df4a06cd7b1a3b430b7a3e6c,1,Mark Payne,2015-04-11 14:34:11-04:00,['93a121044b1a7efcfc3023178fb39f2f44ad836c'],83,246,329,975232,15,1,0.909090909,0,3068
e8134870fda7b2b8eac4033b6c9217ae2839f04c,0,Mark Payne,2015-04-11 14:38:51-04:00,"['0211d0d71561fb63df4a06cd7b1a3b430b7a3e6c', '7aca8eaeae7c8907bc1f5a4ba8e4fc74e011d710']",380,295,675,975907,26,,,,3068
58ea7af9a73deadba2b57d5c30f73179e56622c4,0,Mark Payne,2015-04-11 14:39:07-04:00,"['9ee34e2e3cc72b579c49f97b5ae6f2601bc75087', 'e8134870fda7b2b8eac4033b6c9217ae2839f04c']",2,1824,1826,977733,22,,,,3068
b2a806ab2ebbe48089acf9612e0ce1630e806ba3,0,Matt Gilman,2015-04-11 18:49:03-04:00,['58ea7af9a73deadba2b57d5c30f73179e56622c4'],12,3,15,977748,3,0,0,0,3068
8bcaca75146885fa01ad75de7121d3f9669746f7,0,Mark Payne,2015-04-11 20:01:22-04:00,['58ea7af9a73deadba2b57d5c30f73179e56622c4'],10,10,20,977768,2,,,,3068
8270791b1dd857f32e9f0dd02aa02ddca035a857,0,Matt Gilman,2015-04-11 20:47:38-04:00,"['b2a806ab2ebbe48089acf9612e0ce1630e806ba3', '8bcaca75146885fa01ad75de7121d3f9669746f7']",10,10,20,977788,2,,,,3068
751d601a92605c7fa323c58dd247e68d3dff4738,0,bbende,2015-04-13 20:03:30-04:00,"['a58891af1f232245188716fe292aea1e1dfd2c48', '8270791b1dd857f32e9f0dd02aa02ddca035a857']",574,8532,9106,986894,144,,,,3068
7843132228522fb2192e3078e512cefc1e4d2156,1,Jenn Barnabee,2015-04-15 07:45:29-04:00,['8270791b1dd857f32e9f0dd02aa02ddca035a857'],16,82,98,986992,13,,,,3080
a9ef5ec1bc718ba9fa62d8c4dddba3217a712f65,1,bbende,2015-04-16 22:09:11-04:00,['751d601a92605c7fa323c58dd247e68d3dff4738'],20,22,42,987034,4,1,1,1,3080
ce5a654e96ef257d900a555b595831dd944cb616,0,joewitt,2015-04-17 07:59:54-04:00,['8270791b1dd857f32e9f0dd02aa02ddca035a857'],4,1,5,987039,2,,,,3080
a06c25373fbd4103c2c9ba1ba0d75d94726700d2,1,Mark Payne,2015-04-17 09:13:57-04:00,['509933f631533a659551c2f0c5c9d12e3f47b8e5'],14,47,61,987100,2,0,0.173913043,1,3080
3667a28e87224a02ae2a7a5a29e36543c242f5be,0,Mark Payne,2015-04-17 12:06:52-04:00,"['509933f631533a659551c2f0c5c9d12e3f47b8e5', 'ce5a654e96ef257d900a555b595831dd944cb616']",5652,29685,35337,1022437,470,,,,3080
c5b961be5bf9668e210cfb36fb727dd6bcc88194,0,Mark Payne,2015-04-17 12:09:07-04:00,"['3667a28e87224a02ae2a7a5a29e36543c242f5be', 'a06c25373fbd4103c2c9ba1ba0d75d94726700d2']",14,47,61,1022498,2,,,,3080
e9402a0ddc0ef9f5c0aa47e34a6726610d1b71c1,0,bbende,2015-04-17 18:06:14-04:00,"['a9ef5ec1bc718ba9fa62d8c4dddba3217a712f65', 'c5b961be5bf9668e210cfb36fb727dd6bcc88194']",21,61,82,1022580,5,,,,3080
d09d58ddf2e0eed7164ff92ed41fb4a76bd30aed,0,bbende,2015-04-17 18:25:23-04:00,['e9402a0ddc0ef9f5c0aa47e34a6726610d1b71c1'],8,59,67,1022647,3,0.85,0.85,1,3080
fb2206a9bb5653196e5dc673f7b71ca0f8bc87b9,0,Aldrin Piri,2015-04-17 23:30:26-04:00,['c5b961be5bf9668e210cfb36fb727dd6bcc88194'],23,217,240,1022887,5,0.016129032,0.967741935,1,3080
13cd2a67c89e2c08880247c5837360f370fc9922,0,Jenn Barnabee,2015-04-18 07:05:29-04:00,"['7843132228522fb2192e3078e512cefc1e4d2156', 'fb2206a9bb5653196e5dc673f7b71ca0f8bc87b9']",44,278,322,1023209,10,,,,3080
53b6ac3333d19aff0cc68341fe944da9b0e445f9,0,Aldrin Piri,2015-04-19 09:24:45-04:00,['13cd2a67c89e2c08880247c5837360f370fc9922'],2,19,21,1023230,1,0.25,0.25,1,3080
574e57a4fbf57857cba05b605e05212e36aa485d,1,Jenn Barnabee,2015-04-19 16:01:19-04:00,['13cd2a67c89e2c08880247c5837360f370fc9922'],5,7,12,1023242,8,,,,3082
8a296aacc956cf967406626e9ce0ae296b71c4e2,0,joewitt,2015-04-19 23:12:22-04:00,"['3c3306b7111d186526c80122da5536da2a58cef6', '53b6ac3333d19aff0cc68341fe944da9b0e445f9']",5931,32446,38377,1061619,537,,,,3082
bef65db72ca3465fd202ba4b0c033fbccabc92ac,0,Jenn Barnabee,2015-04-20 04:36:30-04:00,"['574e57a4fbf57857cba05b605e05212e36aa485d', '53b6ac3333d19aff0cc68341fe944da9b0e445f9']",2,19,21,1061640,1,,,,3082
0594a433126888c458be6bc867cb4c7e3ecbd6a6,0,bbende,2015-04-20 18:40:05-04:00,"['d09d58ddf2e0eed7164ff92ed41fb4a76bd30aed', 'bef65db72ca3465fd202ba4b0c033fbccabc92ac']",43,322,365,1062005,20,,,,3082
2d61073beb6bc3147531b138c191501fe18b639f,1,bbende,2015-04-20 19:04:08-04:00,['0594a433126888c458be6bc867cb4c7e3ecbd6a6'],5,1,6,1062011,1,1,0,0,3082
8374d12e5e8fc6f55cc1dcf0b0ada547c90d2018,1,bbende,2015-04-20 20:13:13-04:00,['2d61073beb6bc3147531b138c191501fe18b639f'],33,67,100,1062111,1,0,1,1,3082
156d9409ff331a0d22a98667dbfb22b8db0e6645,1,Mike Moser,2015-04-20 21:26:24-04:00,['53b6ac3333d19aff0cc68341fe944da9b0e445f9'],329,1170,1499,1063610,11,0.266821346,0.371229698,0.872389791,3088
a4285e9464617a008205d0ccff0379d5e7fd4756,0,Mike Moser,2015-04-20 21:35:35-04:00,['156d9409ff331a0d22a98667dbfb22b8db0e6645'],0,1,1,1063611,1,,,,3088
9faaef8cfae703c5b3a77796620c03787767cc28,1,joewitt,2015-04-21 02:15:46-04:00,['8a296aacc956cf967406626e9ce0ae296b71c4e2'],5584,4484,10068,1073679,242,0,0.058823529,0.470588235,3089
fe8e30a03414f0c3d454b165063e308e692ab77f,0,joewitt,2015-04-21 02:18:34-04:00,['9faaef8cfae703c5b3a77796620c03787767cc28'],22,0,22,1073701,1,,,,3089
c026dff40c469f37e29a07fbfaa64a2a4575f92c,0,Matt Gilman,2015-04-21 08:01:11-04:00,['bef65db72ca3465fd202ba4b0c033fbccabc92ac'],4,7,11,1073712,1,,,,3089
bcb3ca8f9886dca675e4b3a895abf83501435eed,1,joewitt,2015-04-21 12:21:16-04:00,['fe8e30a03414f0c3d454b165063e308e692ab77f'],1684,1170,2854,1076566,116,,,,3089
6d728406de755ce2d9d655890aa2012895382b59,0,joewitt,2015-04-21 14:03:22-04:00,"['bcb3ca8f9886dca675e4b3a895abf83501435eed', 'bef65db72ca3465fd202ba4b0c033fbccabc92ac']",5,7,12,1076578,8,,,,3089
afb4fe52b9c7f9527ad6c2aa7e4c4f86994bccbb,1,joewitt,2015-04-21 15:24:04-04:00,['6d728406de755ce2d9d655890aa2012895382b59'],282,328,610,1077188,20,0,0,1,3089
b612b6bcd9f2f29a4466360d5fbbeccee62ae650,1,joewitt,2015-04-21 23:39:31-04:00,['afb4fe52b9c7f9527ad6c2aa7e4c4f86994bccbb'],3082,2944,6026,1083214,94,0,0.337349398,0.78313253,3089
29b4e56a61dc7125e10d7e5d70a0123485717b4d,0,Brian Ghigiarelli,2015-04-22 11:32:36-04:00,"['e7d6d94584b3f04e709eeaba532f142d11d75b39', 'c026dff40c469f37e29a07fbfaa64a2a4575f92c']",5727,30107,35834,1119048,492,,,,3089
888254b2a18174af29d1bd70bf2ce420f41739ba,1,joewitt,2015-04-22 11:46:26-04:00,['b612b6bcd9f2f29a4466360d5fbbeccee62ae650'],4035,3663,7698,1126746,202,0.372093023,0.511627907,0.546511628,3089
6fa596884bcf47774ecb5d8b6a95b30b9c3e7c7b,1,Mark Payne,2015-04-22 12:18:41-04:00,['c026dff40c469f37e29a07fbfaa64a2a4575f92c'],5,13,18,1126764,1,0,0,1,3089
9dda16c995ba55b8025506a12b0844031f5efcf0,0,joewitt,2015-04-22 12:52:00-04:00,['888254b2a18174af29d1bd70bf2ce420f41739ba'],511,469,980,1127744,33,0.166666667,0.166666667,1,3089
6d512f1e017b4d8cf98f3e79915372f5dc96a4d5,1,joewitt,2015-04-22 13:43:44-04:00,['9dda16c995ba55b8025506a12b0844031f5efcf0'],50,398,448,1128192,10,,,,3090
0d7838273ce9438dbb563d4cfa3c63bfb1aa5e3b,0,joewitt,2015-04-22 13:51:36-04:00,['6d512f1e017b4d8cf98f3e79915372f5dc96a4d5'],0,14,14,1128206,1,,,,3090
060a1e0d9cbc15a1a21ac46c9f1ad4f8a7b2a986,1,joewitt,2015-04-22 14:50:03-04:00,['0d7838273ce9438dbb563d4cfa3c63bfb1aa5e3b'],956,1254,2210,1130416,23,,,,3094
06b2c080a528b0fddfacad1bd4ce1cf22eb1cc07,0,Aldrin Piri,2015-04-22 16:49:28-04:00,['060a1e0d9cbc15a1a21ac46c9f1ad4f8a7b2a986'],6,0,6,1130422,1,,,,3094
1367b39b5bf27189228fc5150bde8ccd7b9f1825,0,Aldrin Piri,2015-04-22 16:59:56-04:00,"['c026dff40c469f37e29a07fbfaa64a2a4575f92c', '06b2c080a528b0fddfacad1bd4ce1cf22eb1cc07']",16571,15382,31953,1162375,757,,,,3094
7f9dff52b067022366f194015a274e5af532ec47,0,Aldrin Piri,2015-04-22 17:12:23-04:00,"['1367b39b5bf27189228fc5150bde8ccd7b9f1825', '6fa596884bcf47774ecb5d8b6a95b30b9c3e7c7b']",5,13,18,1162393,1,,,,3094
a53cc3d707c735a42f025c883065b848490ea4db,0,joewitt,2015-04-22 23:42:19-04:00,['7f9dff52b067022366f194015a274e5af532ec47'],1118,1015,2133,1164526,58,,,,3094
ce5ebd9cee0a73262de0d8e2d3062081636eb0e4,1,Aldrin Piri,2015-04-23 10:07:05-04:00,['7f9dff52b067022366f194015a274e5af532ec47'],2,2,4,1164530,2,,,,3094
f5479428e5040aacedee0f75d72ccf15f8169042,0,Matt Gilman,2015-04-23 10:13:05-04:00,['a53cc3d707c735a42f025c883065b848490ea4db'],17,42,59,1164589,2,0,0.304347826,0,3094
7678dd907b209ab4825b08938687602f68e8a1b5,0,Matt Gilman,2015-04-23 10:17:24-04:00,['f5479428e5040aacedee0f75d72ccf15f8169042'],0,1,1,1164590,1,,,,3094
8bfc9691421c8e35f0594fd13a91132f619bc9c0,0,Matt Gilman,2015-04-23 11:28:11-04:00,['7678dd907b209ab4825b08938687602f68e8a1b5'],0,3,3,1164593,1,0,0,0,3094
ff831dc33de98a01f53c79d5c6f04bf93bbaef69,1,Matt Gilman,2015-04-23 12:59:41-04:00,['8bfc9691421c8e35f0594fd13a91132f619bc9c0'],123,1002,1125,1165718,16,0.56851312,0.620991254,0.941690962,3099
0ecc6414dff29d2590dffeaa71c873cbd167a757,0,Aldrin Piri,2015-04-23 13:16:17-04:00,['a53cc3d707c735a42f025c883065b848490ea4db'],0,10,10,1165728,1,0,1,1,3099
503c773f45c00923c926af3777a5feaf77a1e952,0,Aldrin Piri,2015-04-23 13:57:46-04:00,"['ff831dc33de98a01f53c79d5c6f04bf93bbaef69', '0ecc6414dff29d2590dffeaa71c873cbd167a757']",0,10,10,1165738,1,,,,3099
2393a6fc53b4f815569a2fe70eff53b21aea3e48,0,Matt Gilman,2015-04-23 14:00:23-04:00,['ff831dc33de98a01f53c79d5c6f04bf93bbaef69'],1,1,2,1165740,1,,,,3099
61b1d128e13ac3cea311f5d6c4e9f02bddec884a,0,Matt Gilman,2015-04-23 14:01:58-04:00,"['2393a6fc53b4f815569a2fe70eff53b21aea3e48', '503c773f45c00923c926af3777a5feaf77a1e952']",0,10,10,1165750,1,,,,3099
72fd05610f48fdf6863245a1ed225eeb4fbc6e00,0,Aldrin Piri,2015-04-23 14:33:02-04:00,"['61b1d128e13ac3cea311f5d6c4e9f02bddec884a', 'ce5ebd9cee0a73262de0d8e2d3062081636eb0e4']",2,2,4,1165754,2,,,,3099
cc408fa4da9d2c86dcb2435265695498584cf119,0,Matt Gilman,2015-04-23 14:45:59-04:00,['61b1d128e13ac3cea311f5d6c4e9f02bddec884a'],1,1,2,1165756,1,,,,3099
dca93a507090c2972a48e1ae7aea37589c72a66d,0,Matt Gilman,2015-04-23 15:00:41-04:00,"['cc408fa4da9d2c86dcb2435265695498584cf119', '72fd05610f48fdf6863245a1ed225eeb4fbc6e00']",2,2,4,1165760,2,,,,3099
d68f71b126c58112070d81f14e804497f9649e5b,1,joewitt,2015-04-24 16:44:04-04:00,['dca93a507090c2972a48e1ae7aea37589c72a66d'],136,145,281,1166041,3,0,0,1,3099
8fa012c266657c0bfc55d1077b338fe201122594,0,Matt Gilman,2015-04-24 17:24:33-04:00,['dca93a507090c2972a48e1ae7aea37589c72a66d'],0,17,17,1166058,1,,,,3099
9033173eb3b7f22db81f8e9625f159a021417f33,0,Matt Gilman,2015-04-24 17:28:15-04:00,"['8fa012c266657c0bfc55d1077b338fe201122594', 'd68f71b126c58112070d81f14e804497f9649e5b']",136,145,281,1166339,3,,,,3099
94945a6fd5e88c083f1f3e32d3b3d5d5954686d1,1,Mark Payne,2015-04-24 20:13:21-04:00,['6fa596884bcf47774ecb5d8b6a95b30b9c3e7c7b'],38,996,1034,1167373,20,0.278894472,0.645728643,0.871859296,3106
387a97193189f27b112c2b87d9c08fb61e7acd54,1,Mark Payne,2015-04-24 22:01:02-04:00,['6fa596884bcf47774ecb5d8b6a95b30b9c3e7c7b'],0,4,4,1167377,1,,,,3106
953d9e59a8fcc6f12a3fc8fda9d58ad93344c4b0,0,Mark Payne,2015-04-24 22:01:21-04:00,"['387a97193189f27b112c2b87d9c08fb61e7acd54', '9033173eb3b7f22db81f8e9625f159a021417f33']",17949,17601,35550,1202927,831,,,,3106
c14b2cebf8e28d898c39acd661e5923f81c1e5e9,0,joewitt,2015-04-25 08:27:24-04:00,['953d9e59a8fcc6f12a3fc8fda9d58ad93344c4b0'],456,453,909,1203836,6,0,0.5,1,3106
5a559e455761666fc3e1680a3dad934b58d687f2,0,joewitt,2015-04-25 08:38:28-04:00,['c14b2cebf8e28d898c39acd661e5923f81c1e5e9'],404,405,809,1204645,4,,,,3106
90ae022e54f23537c7d619ae404c467371e2a0d4,0,joewitt,2015-04-25 08:43:19-04:00,['5a559e455761666fc3e1680a3dad934b58d687f2'],40,42,82,1204727,2,,,,3106
269e25e9934ca54277f016bdb5a1589bbe021a76,0,joewitt,2015-04-25 08:52:47-04:00,['90ae022e54f23537c7d619ae404c467371e2a0d4'],228,232,460,1205187,2,1,1,1,3106
e93c82919135badd3ed1f5759c61f30c4883eb58,0,joewitt,2015-04-25 09:13:45-04:00,['269e25e9934ca54277f016bdb5a1589bbe021a76'],3,5,8,1205195,2,,,,3106
b2a1f5217dd89e8133887d691e56483e9f0e4214,0,joewitt,2015-04-25 09:15:36-04:00,['e93c82919135badd3ed1f5759c61f30c4883eb58'],739,732,1471,1206666,12,,,,3106
8f2502c4e476ba3ce00943d9d9f777b0637c1114,1,joewitt,2015-04-25 09:20:35-04:00,['b2a1f5217dd89e8133887d691e56483e9f0e4214'],517,525,1042,1207708,7,0,0,1,3106
87e829682fc5a62a2b56e83c98a8be114de9efdb,0,joewitt,2015-04-25 09:37:02-04:00,['8f2502c4e476ba3ce00943d9d9f777b0637c1114'],47,22,69,1207777,2,0,0,1,3106
b097a530760398d18354ff87ba4bf17bfa384899,0,Mark Payne,2015-04-25 12:01:45-04:00,['953d9e59a8fcc6f12a3fc8fda9d58ad93344c4b0'],0,4,4,1207781,2,,,,3106
ba5bcba1b71be9e96ac7d879c9684d2ebd68fc18,0,bbende,2015-04-26 15:55:46-04:00,"['8374d12e5e8fc6f55cc1dcf0b0ada547c90d2018', '87e829682fc5a62a2b56e83c98a8be114de9efdb']",20331,20035,40366,1248147,868,,,,3106
b153ad3e9be95e7f0e2e883b22926a096760ba82,0,bbende,2015-04-26 16:05:19-04:00,['ba5bcba1b71be9e96ac7d879c9684d2ebd68fc18'],55,0,55,1248202,2,,,,3106
f5c46bb15dd05a10400cd21f9bdd9c27f775cdf6,0,bbende,2015-04-26 17:10:49-04:00,['b153ad3e9be95e7f0e2e883b22926a096760ba82'],0,25,25,1248227,1,,,,3106
548188939c44ed02d8b0ef8e0bbd4513afaade60,1,joewitt,2015-04-27 07:44:57-04:00,['87e829682fc5a62a2b56e83c98a8be114de9efdb'],5020,7415,12435,1260662,136,0,0.679440938,0.896753832,3106
f442d55c91d80091c7d2dbf8c5104d6aefcd31c2,0,Mark Payne,2015-04-27 09:29:19-04:00,"['b097a530760398d18354ff87ba4bf17bfa384899', '548188939c44ed02d8b0ef8e0bbd4513afaade60']",7454,9831,17285,1277947,173,,,,3106
a5ac48a03c362dcb0b253741157d79e8791eb2d5,1,Mark Payne,2015-04-27 09:52:33-04:00,['f442d55c91d80091c7d2dbf8c5104d6aefcd31c2'],619,2426,3045,1280992,25,0.163009404,0.594566353,0.78892372,3116
7c41225e89e05fe1a234920fd1aa8ca248f43850,1,Mark Payne,2015-04-27 10:41:18-04:00,['a5ac48a03c362dcb0b253741157d79e8791eb2d5'],1,31,32,1281024,3,0,0,1,3116
c10facae487a900af69df89bf393d413d43725bc,0,Mark Payne,2015-04-27 10:47:07-04:00,"['953d9e59a8fcc6f12a3fc8fda9d58ad93344c4b0', '548188939c44ed02d8b0ef8e0bbd4513afaade60']",7454,9831,17285,1298309,173,,,,3116
0759660897a8ca9e91d02157ec434abd5e2a7d7e,0,Mark Payne,2015-04-27 10:47:38-04:00,"['c10facae487a900af69df89bf393d413d43725bc', '7c41225e89e05fe1a234920fd1aa8ca248f43850']",619,2460,3079,1301388,29,,,,3116
d29a2d688e437bae42c12115768cdb038b7406c5,1,joewitt,2015-04-27 11:54:36-04:00,['548188939c44ed02d8b0ef8e0bbd4513afaade60'],5281,2933,8214,1309602,91,1,0.292807425,0.106728538,3116
ba96e43a8e0fa682e9c803228d292969ffd0c686,0,Mark Payne,2015-04-27 12:01:36-04:00,['0759660897a8ca9e91d02157ec434abd5e2a7d7e'],2,11,13,1309615,1,0,0,1,3116
666de3d410a8f80a8ad4a90e5fbcce08c777103e,0,Mark Payne,2015-04-27 12:04:35-04:00,"['ba96e43a8e0fa682e9c803228d292969ffd0c686', 'd29a2d688e437bae42c12115768cdb038b7406c5']",5281,2933,8214,1317829,91,,,,3116
6a706458d093af061e6b957d99de3ca1bc1f4c30,1,joewitt,2015-04-27 13:25:44-04:00,['666de3d410a8f80a8ad4a90e5fbcce08c777103e'],457,374,831,1318660,50,0.931506849,0.397260274,0.095890411,3116
9a3b6bed62e9962ff97f2c76055cd4d49705ff89,0,joewitt,2015-04-27 13:43:35-04:00,['6a706458d093af061e6b957d99de3ca1bc1f4c30'],435,461,896,1319556,34,1,1,1,3116
10860944d14cc4ddb0805b4085b401ae6dc195b2,0,joewitt,2015-04-27 13:50:09-04:00,['9a3b6bed62e9962ff97f2c76055cd4d49705ff89'],116,81,197,1319753,11,,,,3116
3cd18b0babc5133e35a2771bc0d0acaf974c381f,1,Mark Payne,2015-04-27 14:13:55-04:00,['666de3d410a8f80a8ad4a90e5fbcce08c777103e'],1607,1391,2998,1322751,29,0.723684211,1,0,3116
384b2ac2535987a42ae36568d285c829461a1587,0,Mark Payne,2015-04-27 14:14:48-04:00,"['3cd18b0babc5133e35a2771bc0d0acaf974c381f', '10860944d14cc4ddb0805b4085b401ae6dc195b2']",1008,916,1924,1324675,95,,,,3116
21209b2341533bfd16e751a98d0dc65da8eee45b,1,joewitt,2015-04-27 14:26:14-04:00,['10860944d14cc4ddb0805b4085b401ae6dc195b2'],589,318,907,1325582,50,0.428571429,0.357142857,0.5,3116
43b2f040bcb181abc435e4f8f1c5da0591141254,0,joewitt,2015-04-27 14:26:26-04:00,"['21209b2341533bfd16e751a98d0dc65da8eee45b', '384b2ac2535987a42ae36568d285c829461a1587']",1607,1391,2998,1328580,29,,,,3116
dc7f7a82a68e7e19d0aeb52bd9bca44c277f4fba,1,Mark Payne,2015-04-27 14:51:51-04:00,"['94945a6fd5e88c083f1f3e32d3b3d5d5954686d1', '384b2ac2535987a42ae36568d285c829461a1587']",25142,26375,51517,1380097,1071,,,,3116
e811929f5913586b38f5f95d321623da2f07b64a,0,joewitt,2015-04-27 14:56:45-04:00,['43b2f040bcb181abc435e4f8f1c5da0591141254'],663,305,968,1381065,61,,,,3116
1eb4387dbe8964862316d9a2ce2e999651e2124b,0,joewitt,2015-04-27 21:29:06-04:00,['e811929f5913586b38f5f95d321623da2f07b64a'],120,41,161,1381226,3,,,,3116
a52cf52948d3774f07f8713c5010ee4d7d768a75,0,joewitt,2015-04-27 21:34:55-04:00,['1eb4387dbe8964862316d9a2ce2e999651e2124b'],448,187,635,1381861,98,,,,3116
e1160f5932b59eedf738eca18b8031a58385ca16,1,joewitt,2015-04-28 00:27:12-04:00,['a52cf52948d3774f07f8713c5010ee4d7d768a75'],2553,1165,3718,1385579,85,0.615384615,0.769230769,0.230769231,3116
525ce7fb2db5c039c3b5d1c36085953f6ca9af10,0,joewitt,2015-04-28 00:32:13-04:00,['e1160f5932b59eedf738eca18b8031a58385ca16'],449,203,652,1386231,29,,,,3116
e627482734ab701bd0ccc5b5f389340df8ed90f4,0,joewitt,2015-04-28 00:35:56-04:00,['525ce7fb2db5c039c3b5d1c36085953f6ca9af10'],34,20,54,1386285,2,,,,3116
6c3256e00a2c10f6968aef65cfec90557f8cfab2,0,joewitt,2015-04-28 01:37:38-04:00,['e627482734ab701bd0ccc5b5f389340df8ed90f4'],2,39,41,1386326,2,,,,3116
e4f431561e6af7a603a5c8b7a82910f28dc6d600,1,Mark Payne,2015-04-28 08:46:38-04:00,['dc7f7a82a68e7e19d0aeb52bd9bca44c277f4fba'],44,416,460,1386786,8,0.816216216,0.972972973,0.881081081,3117
3e767fbdf3af66d3348d974a1c8a669819d5f6d9,0,Mark Payne,2015-04-28 08:47:23-04:00,"['e4f431561e6af7a603a5c8b7a82910f28dc6d600', '6c3256e00a2c10f6968aef65cfec90557f8cfab2']",4857,2277,7134,1393920,329,,,,3117
6e492b408233f032087d3294111cc646b443db51,1,Mark Payne,2015-04-28 09:31:51-04:00,['6c3256e00a2c10f6968aef65cfec90557f8cfab2'],1,1,2,1393922,1,,,,3117
b7d2154f7de0e587df35e5e7266233feadf646e0,1,Mark Payne,2015-04-28 09:34:19-04:00,['6e492b408233f032087d3294111cc646b443db51'],6,7,13,1393935,1,0,0,1,3117
62edd7a3ab524eb53d3f739e23aabaf5cf2eec2c,0,Mark Payne,2015-04-28 09:50:01-04:00,['b7d2154f7de0e587df35e5e7266233feadf646e0'],1,1,2,1393937,1,,,,3117
8c006237e308d3c8071cab1f1c529d640761ff6d,0,Mark Payne,2015-04-28 10:12:09-04:00,['62edd7a3ab524eb53d3f739e23aabaf5cf2eec2c'],207,4,211,1394148,6,,,,3117
00b686b0b2a66d4b238a1af0602edae6a36d7786,0,Mark Payne,2015-04-28 10:13:11-04:00,"['3e767fbdf3af66d3348d974a1c8a669819d5f6d9', '8c006237e308d3c8071cab1f1c529d640761ff6d']",213,11,224,1394372,8,,,,3117
57e78bf723c0f1ddb642475e0b16cdf52c8ee1fd,0,joewitt,2015-04-28 15:31:27-04:00,['8c006237e308d3c8071cab1f1c529d640761ff6d'],3,2,5,1394377,1,1,1,0,3117
e557e1e6e72ab269ba234cb85dfd43ea5bcae1e3,0,bbende,2015-04-28 18:29:07-04:00,"['f5c46bb15dd05a10400cd21f9bdd9c27f775cdf6', '57e78bf723c0f1ddb642475e0b16cdf52c8ee1fd']",9214,8020,17234,1411611,532,,,,3117
fabb2c997eb2d9330c7a3527f7371ec9d1ab9a08,1,bbende,2015-04-28 18:55:19-04:00,['e557e1e6e72ab269ba234cb85dfd43ea5bcae1e3'],12,54,66,1411677,5,0,1,1,3117
ebee094ff3ef02c0daea5247989b0d9d6a7337d4,1,Mark Payne,2015-04-29 07:44:19-04:00,['00b686b0b2a66d4b238a1af0602edae6a36d7786'],113,112,225,1411902,7,1,1,0,3117
591b14307cfb061dd2ecc9f57ba0e39a387ebabe,0,Mark Payne,2015-04-29 07:45:02-04:00,"['ebee094ff3ef02c0daea5247989b0d9d6a7337d4', '57e78bf723c0f1ddb642475e0b16cdf52c8ee1fd']",0,0,0,1411902,0,,,,3117
20831c87fc695683c4a796d3906eef2ec939a311,1,Mark Payne,2015-04-29 08:31:13-04:00,['57e78bf723c0f1ddb642475e0b16cdf52c8ee1fd'],75,82,157,1412059,2,0,0,0,3117
4baf48ae958ea5f084f50b0b74d7c0efe417a29f,0,Mark Payne,2015-04-29 09:41:40-04:00,['20831c87fc695683c4a796d3906eef2ec939a311'],11,15,26,1412085,3,0,0,0,3117
20f11b1a7764aabb6656488955ef0b4e5649356e,1,Mark Payne,2015-04-29 13:22:09-04:00,['4baf48ae958ea5f084f50b0b74d7c0efe417a29f'],27,159,186,1412271,9,0.164383562,0.465753425,0.835616438,3117
ad98ac50cafc657374b6ab30de882d893d911ac5,1,Mark Payne,2015-04-29 14:44:03-04:00,['20f11b1a7764aabb6656488955ef0b4e5649356e'],107,211,318,1412589,2,0.170212766,1,0,3117
fb8984cfa55654aeba0c8fe3d14be613af395a94,1,Mark Payne,2015-04-29 14:52:20-04:00,['ad98ac50cafc657374b6ab30de882d893d911ac5'],67,46,113,1412702,1,0,0,0,3117
946fd7ce09c8e5d7224cf8da178eb2189a7a749e,0,Mark Payne,2015-04-29 15:15:45-04:00,['591b14307cfb061dd2ecc9f57ba0e39a387ebabe'],20,20,40,1412742,1,,,,3117
e0d4484ee8e7b80fe3b47d5bb132d95019253a46,0,Mark Payne,2015-04-29 15:48:08-04:00,['946fd7ce09c8e5d7224cf8da178eb2189a7a749e'],9,17,26,1412768,1,0,1,1,3117
25e2b6c8add6ebbc281cb1189d49d7fa14e27228,0,Mark Payne,2015-04-29 16:14:01-04:00,"['e0d4484ee8e7b80fe3b47d5bb132d95019253a46', 'fb8984cfa55654aeba0c8fe3d14be613af395a94']",260,486,746,1413514,13,,,,3117
6e5469c712c0f4cf44491e58bbdea5f6611b3f40,1,Mark Payne,2015-04-29 16:32:52-04:00,['25e2b6c8add6ebbc281cb1189d49d7fa14e27228'],2,4,6,1413520,1,1,1,0,3117
ab6794b29ebd4e7205e9aa0a7e8c227374a4b6d3,0,Mark Payne,2015-04-29 17:02:08-04:00,['6e5469c712c0f4cf44491e58bbdea5f6611b3f40'],47,74,121,1413641,2,0.714285714,0.714285714,1,3117
5aeac2ebf3f3b33d01a8f28b529773cb74d13821,1,Mark Payne,2015-04-29 17:18:35-04:00,['ab6794b29ebd4e7205e9aa0a7e8c227374a4b6d3'],23,29,52,1413693,2,1,0,0,3117
d6160a7d07c86aa04905773ab2cea1ba8bfcc70d,0,Aldrin Piri,2015-04-30 12:17:34-04:00,['6e5469c712c0f4cf44491e58bbdea5f6611b3f40'],23,114,137,1413830,5,,,,3118
594262a84371cc45b024499943848b33f6b853ae,0,Aldrin Piri,2015-04-30 12:31:33-04:00,['d6160a7d07c86aa04905773ab2cea1ba8bfcc70d'],1,1,2,1413832,1,,,,3118
e30cd23fc258c5831761249536e6a1a83b93f5e0,1,Mark Payne,2015-04-30 13:12:07-04:00,['5aeac2ebf3f3b33d01a8f28b529773cb74d13821'],56,59,115,1413947,1,1,1,0,3118
e7954cf04a8523e393327f5391dbc5209d887e98,0,Mark Payne,2015-04-30 13:12:40-04:00,['e30cd23fc258c5831761249536e6a1a83b93f5e0'],20,20,40,1413987,1,,,,3118
21c5c48cabe8631a173fb2513f7e224bac7a59ab,0,Mark Payne,2015-04-30 13:13:22-04:00,['e7954cf04a8523e393327f5391dbc5209d887e98'],0,118,118,1414105,3,1,1,1,3120
8ed131b635796c08a222b9496122ea006d2710e9,1,Mark Payne,2015-04-30 13:37:42-04:00,['21c5c48cabe8631a173fb2513f7e224bac7a59ab'],2,47,49,1414154,2,0.925925926,0.925925926,1,3120
89db6650bbe9509ec14393318fe4b5553e9345f5,1,Mark Payne,2015-04-30 19:33:41-04:00,['8ed131b635796c08a222b9496122ea006d2710e9'],10,96,106,1414260,1,,,,3120
14e73bc24d4eaf673eb2cacb9b0ebea828d4de31,0,Mark Payne,2015-04-30 19:40:58-04:00,"['8ed131b635796c08a222b9496122ea006d2710e9', '594262a84371cc45b024499943848b33f6b853ae']",23,114,137,1414397,5,,,,3120
d9a86e5b2ea6004c2d7532b92e2c11d10b47a51e,1,danbress,2015-05-01 07:54:42-04:00,['14e73bc24d4eaf673eb2cacb9b0ebea828d4de31'],12,63,75,1414472,3,0.615384615,0.615384615,1,3120
93f246a3fdda70458b6d3b9fad362b7b4ce03d25,0,danbress,2015-05-01 07:54:43-04:00,['d9a86e5b2ea6004c2d7532b92e2c11d10b47a51e'],5,9,14,1414486,1,,,,3120
6fc823e0fe87218051d932e40814a4548f13d470,0,danbress,2015-05-01 07:58:28-04:00,['93f246a3fdda70458b6d3b9fad362b7b4ce03d25'],13,11,24,1414510,2,,,,3120
b86fe2d17844d9b7c8bd2ae54b63ad7e3692b4ab,0,Mark Payne,2015-05-01 09:05:34-04:00,['89db6650bbe9509ec14393318fe4b5553e9345f5'],4,3,7,1414517,1,,,,3120
262a8735cf8a63fb2355ff3d1035ba83b518445f,0,Mark Payne,2015-05-01 09:05:47-04:00,"['14e73bc24d4eaf673eb2cacb9b0ebea828d4de31', 'b86fe2d17844d9b7c8bd2ae54b63ad7e3692b4ab']",10,95,105,1414622,1,,,,3120
054f044fc5f0af900f2ed8e5cb580ad11c713cac,0,Brandon DeVries,2015-05-01 09:08:33-04:00,"['262a8735cf8a63fb2355ff3d1035ba83b518445f', 'e1e1aecc8b8e6c75f260edf248f046c1557c088b']",14,828,842,1415464,11,,,,3120
ba4a8937f895cecd4ffba2e9b9e8f5ee7be8dfb3,1,Brandon DeVries,2015-05-01 09:42:23-04:00,['054f044fc5f0af900f2ed8e5cb580ad11c713cac'],276,347,623,1416087,4,0,0.724137931,0.896551724,3120
393efc836e47382c22f9fc57ca205901ab386ca0,0,Aldrin Piri,2015-05-01 10:08:56-04:00,"['ba4a8937f895cecd4ffba2e9b9e8f5ee7be8dfb3', '6fc823e0fe87218051d932e40814a4548f13d470']",12,65,77,1416164,3,,,,3120
7db27c01b2e1f0e1aa66ee3a861997e24b618502,1,Mark Payne,2015-05-01 10:28:26-04:00,"['262a8735cf8a63fb2355ff3d1035ba83b518445f', 'a4285e9464617a008205d0ccff0379d5e7fd4756']",368,1169,1537,1417701,11,,,,3120
1a1cfe23447d980b6625fb6efae6fb777c6237c5,0,Mark Payne,2015-05-01 10:30:55-04:00,"['7db27c01b2e1f0e1aa66ee3a861997e24b618502', '393efc836e47382c22f9fc57ca205901ab386ca0']",86,1024,1110,1418811,14,,,,3120
5bf610a11e7bf85770a05e4e1e585a5fdbe85a3a,0,Mark Payne,2015-05-01 10:46:41-04:00,['1a1cfe23447d980b6625fb6efae6fb777c6237c5'],8,8,16,1418827,1,,,,3120
73a368f861de76638daac6787eea310cd1010ba6,0,Mark Payne,2015-05-01 10:48:23-04:00,['5bf610a11e7bf85770a05e4e1e585a5fdbe85a3a'],18,8,26,1418853,1,0,0,0,3120
6394c8ee40be6053595a48c9aab76318e5ceae6f,1,Mark Payne,2015-05-01 11:37:24-04:00,['73a368f861de76638daac6787eea310cd1010ba6'],4,3,7,1418860,1,,,,3120
3ddfeaf07257e45c58622082beec5fa6308b6918,0,Mark Payne,2015-05-01 11:59:29-04:00,"['6394c8ee40be6053595a48c9aab76318e5ceae6f', 'fabb2c997eb2d9330c7a3527f7371ec9d1ab9a08']",24,1981,2005,1420865,27,,,,3120
d8ad2689c926948b34f0f67cb79954a6734e9996,0,Mark Payne,2015-05-01 14:12:07-04:00,['3ddfeaf07257e45c58622082beec5fa6308b6918'],0,381,381,1421246,2,,,,3122
a69ed6bae9aab66da4280deb89270f821d5d9b32,0,Mark Payne,2015-05-01 14:21:52-04:00,['d8ad2689c926948b34f0f67cb79954a6734e9996'],1,12,13,1421259,1,,,,3122
997ed94653b66292c2a9b2d565a5a83f4ccaddb8,1,Matt Gilman,2015-05-01 16:42:44-04:00,['a69ed6bae9aab66da4280deb89270f821d5d9b32'],805,7202,8007,1429266,132,0,0.707317073,0.423577236,3129
be12203f8f2d455171e2bb18c7fb2b91dc4956d1,1,Matt Gilman,2015-05-02 15:18:41-04:00,['997ed94653b66292c2a9b2d565a5a83f4ccaddb8'],1,3,4,1429270,2,,,,3129
7853e3c165bbbf0d4c3bcb116bd9d9512f5e3578,0,joewitt,2015-05-02 16:03:28-04:00,['997ed94653b66292c2a9b2d565a5a83f4ccaddb8'],874,0,874,1430144,8,0.214285714,0,0,3129
4f35637a297640e6274771e23c1960f748196350,0,joewitt,2015-05-02 16:03:28-04:00,['7853e3c165bbbf0d4c3bcb116bd9d9512f5e3578'],8,5,13,1430157,2,,,,3129
b6b8c95bf440b3d0467fa678adff543619ea0494,0,Matt Gilman,2015-05-02 16:41:42-04:00,"['be12203f8f2d455171e2bb18c7fb2b91dc4956d1', '4f35637a297640e6274771e23c1960f748196350']",882,5,887,1431044,9,,,,3129
34c81e1e70b0314da27150bd4e824024e53da206,0,joewitt,2015-05-02 16:43:32-04:00,['4f35637a297640e6274771e23c1960f748196350'],0,32,32,1431076,2,,,,3129
a43eecf1bde9b7ab30fbfdcdf5bd1d04fa2f0985,0,joewitt,2015-05-02 16:43:44-04:00,"['34c81e1e70b0314da27150bd4e824024e53da206', 'b6b8c95bf440b3d0467fa678adff543619ea0494']",1,3,4,1431080,2,,,,3129
fea59e3249324caa37d14c3a3366321e3f2f8242,1,Mark Payne,2015-05-03 16:42:54-04:00,['a43eecf1bde9b7ab30fbfdcdf5bd1d04fa2f0985'],8,8,16,1431096,1,,,,3129
018473b352ef5216e8581fa843b1a3a958c51d9b,0,Mark Payne,2015-05-03 17:13:22-04:00,['fea59e3249324caa37d14c3a3366321e3f2f8242'],1,2,3,1431099,1,0,0,1,3129
22ded807be8a81f09b618af4c79a9b2d8ee7496f,1,Mark Payne,2015-05-03 17:13:30-04:00,['018473b352ef5216e8581fa843b1a3a958c51d9b'],0,7,7,1431106,1,0,0.714285714,1,3129
40438f12352a41fbb6de4c60b02153b48e15bf5f,0,Matt Gilman,2015-05-03 17:59:41-04:00,['a43eecf1bde9b7ab30fbfdcdf5bd1d04fa2f0985'],4,18,22,1431128,3,1,1,1,3129
f59491c8db7588bbe65bb8d5a76adf7f448583a0,0,Mark Payne,2015-05-03 18:03:03-04:00,['22ded807be8a81f09b618af4c79a9b2d8ee7496f'],4,18,22,1431150,3,1,1,1,3129
684ed8e1f5c3b3b2d440990e88e02b3d60a24fbd,0,Matt Gilman,2015-05-03 19:51:36-04:00,"['40438f12352a41fbb6de4c60b02153b48e15bf5f', '22ded807be8a81f09b618af4c79a9b2d8ee7496f']",9,17,26,1431176,3,,,,3129
c21288763d2b85e9dad1aff0fe952bac27c4f1e8,0,Mark Payne,2015-05-03 20:01:45-04:00,['f59491c8db7588bbe65bb8d5a76adf7f448583a0'],0,5,5,1431181,1,,,,3129
4d8a14ae97849fc089044d5e9689f2f02559e696,0,Mark Payne,2015-05-03 20:01:56-04:00,"['c21288763d2b85e9dad1aff0fe952bac27c4f1e8', '684ed8e1f5c3b3b2d440990e88e02b3d60a24fbd']",0,0,0,1431181,0,,,,3129
e98c074fc9455cfb0011cdcab59865f3fe6b8946,1,Matt Gilman,2015-05-04 14:52:02-04:00,['4d8a14ae97849fc089044d5e9689f2f02559e696'],16,33,49,1431230,8,1,1,0,3129
37e5548ac19ee1580663f66682020c04272798c2,0,Matt Gilman,2015-05-04 16:46:44-04:00,['e98c074fc9455cfb0011cdcab59865f3fe6b8946'],22,46,68,1431298,4,0.666666667,1,0.944444444,3129
41b21af5769211b9a57e5bef47fe40c6d34839b1,0,joewitt,2015-05-05 00:59:28-04:00,['37e5548ac19ee1580663f66682020c04272798c2'],11,21,32,1431330,1,,,,3129
3472bf3f52c875c38a0dc97645f99c909a4ac304,0,Mark Payne,2015-05-05 13:58:18-04:00,['41b21af5769211b9a57e5bef47fe40c6d34839b1'],1,1,2,1431332,1,,,,3129
f3e76fef1b9830080d0dc10d8c6e8851eeb26e90,1,Matt Gilman,2015-05-05 16:11:29-04:00,['37e5548ac19ee1580663f66682020c04272798c2'],167,410,577,1431909,18,0.205128205,1,1,3132
c90bb8a60064cf8f3abfe702118997fc70547413,0,Matt Gilman,2015-05-05 16:23:58-04:00,['f3e76fef1b9830080d0dc10d8c6e8851eeb26e90'],0,0,0,1431909,1,,,,3132
cf3dbef2a8917191464708060d49449cb2e23160,0,Matt Gilman,2015-05-05 23:04:18-04:00,"['c90bb8a60064cf8f3abfe702118997fc70547413', '3472bf3f52c875c38a0dc97645f99c909a4ac304']",12,22,34,1431943,2,,,,3132
251f0e53b06191c2f55fccc19ac4912c6c7f05b8,0,Matt Gilman,2015-05-05 23:06:07-04:00,['cf3dbef2a8917191464708060d49449cb2e23160'],0,58,58,1432001,1,,,,3132
1381920479e4f1403646997c782304e3a8b36854,0,Aldrin Piri,2015-05-06 09:04:03-04:00,['3472bf3f52c875c38a0dc97645f99c909a4ac304'],18,34,52,1432053,2,0.6,1,1,3132
b70845b31e8ff49cfe958c53feb9752b8dac0aa7,0,Aldrin Piri,2015-05-06 09:11:24-04:00,"['251f0e53b06191c2f55fccc19ac4912c6c7f05b8', '1381920479e4f1403646997c782304e3a8b36854']",18,34,52,1432105,2,,,,3132
81e40d43480cc42a4e8e9edf1a6360c1a54449db,1,Matt Gilman,2015-05-06 10:04:18-04:00,['251f0e53b06191c2f55fccc19ac4912c6c7f05b8'],26,48,74,1432179,3,0,1,1,3132
f0a5c11f1bfa840ebc218d148702c9a716461334,1,Matt Gilman,2015-05-06 10:32:28-04:00,['81e40d43480cc42a4e8e9edf1a6360c1a54449db'],1,19,20,1432199,2,1,0,0,3132
e1aa4890a003309f8a9038cd05f47af54aff4452,0,Matt Gilman,2015-05-06 10:58:54-04:00,"['f0a5c11f1bfa840ebc218d148702c9a716461334', 'b70845b31e8ff49cfe958c53feb9752b8dac0aa7']",18,34,52,1432251,2,,,,3132
c12778f17f593064bb51a37fc4e074a0574da355,0,Aldrin Piri,2015-05-06 12:43:48-04:00,['e1aa4890a003309f8a9038cd05f47af54aff4452'],224,0,224,1432475,224,,,,3132
a973cc4f2a39cce356125a40b1a4d16fb54601ac,1,Tim Reardon,2015-05-07 20:41:11-04:00,['e1aa4890a003309f8a9038cd05f47af54aff4452'],7,98,105,1432580,6,0.410714286,0.410714286,0.928571429,3133
b760505bf388848d5329a658bb429d4ef34afcf7,1,Mark Payne,2015-05-08 12:02:39-04:00,['c12778f17f593064bb51a37fc4e074a0574da355'],22,92,114,1432694,3,0.38,0,0,3133
1dce27ff2cfe20e6ee5dcf103d5bc56975e94c60,0,joewitt,2015-05-08 22:48:42-04:00,['b760505bf388848d5329a658bb429d4ef34afcf7'],12,6,18,1432712,1,,,,3133
c4d1666a26c86a89ced186caf638ecf6c4437a38,0,Mark Payne,2015-05-11 13:37:30-04:00,['1dce27ff2cfe20e6ee5dcf103d5bc56975e94c60'],13,15,28,1432740,1,,,,3133
37732bddcfcb2affcba1f3b4a9e3dd5ebd7b5a30,0,Mark Payne,2015-05-11 13:58:36-04:00,['c4d1666a26c86a89ced186caf638ecf6c4437a38'],2,2,4,1432744,1,,,,3133
a25fcb7a02cfcd34658ddd0e02979abfb85e7e6b,0,Mark Payne,2015-05-11 13:58:46-04:00,['37732bddcfcb2affcba1f3b4a9e3dd5ebd7b5a30'],2,2,4,1432748,1,,,,3133
0b8533f8ffbd2563cb2e52dd2fd99b0ec11173d4,0,Mark Payne,2015-05-11 14:00:51-04:00,['a25fcb7a02cfcd34658ddd0e02979abfb85e7e6b'],1,1,2,1432750,1,,,,3133
1fc8453b36c1a1d600a911668f10249cf1e52ea7,0,Mark Payne,2015-05-11 14:01:54-04:00,['0b8533f8ffbd2563cb2e52dd2fd99b0ec11173d4'],1,5,6,1432756,1,,,,3133
0cc481d4ce5e4b889d0ad088f27fe05cf60cf38e,0,Mark Payne,2015-05-11 14:02:04-04:00,['1fc8453b36c1a1d600a911668f10249cf1e52ea7'],5,1,6,1432762,1,,,,3133
32909ead21130269c22c74c3a9e3ea1c2c54dc7e,0,Mark Payne,2015-05-11 14:13:42-04:00,['0cc481d4ce5e4b889d0ad088f27fe05cf60cf38e'],2,2,4,1432766,1,,,,3133
65a07b6b634e04f44b5b89bfaf95e0ff35c3c68c,0,Mark Payne,2015-05-11 14:21:13-04:00,['32909ead21130269c22c74c3a9e3ea1c2c54dc7e'],409,409,818,1433584,118,,,,3133
fdc801bc183b2435b658b3a7e3076ef45135e550,0,Mark Payne,2015-05-11 14:21:29-04:00,['65a07b6b634e04f44b5b89bfaf95e0ff35c3c68c'],223,219,442,1434026,118,,,,3133
badf1018c1765e4d1b277f3ede5a3231d3fe1734,1,bbende,2015-05-13 18:09:16-04:00,['c4d1666a26c86a89ced186caf638ecf6c4437a38'],13,32,45,1434071,6,0.833333333,0,0,3133
951cff9bda0e1efafd6dd7b5a13592cab668778b,1,Matt Gilman,2015-05-13 18:57:51-04:00,['c12778f17f593064bb51a37fc4e074a0574da355'],3,100,103,1434174,2,0.340909091,1,1,3133
3f3fe3c359c2bfdff55a08b46087974d5ad49c23,0,Matt Gilman,2015-05-13 19:27:06-04:00,['951cff9bda0e1efafd6dd7b5a13592cab668778b'],4,38,42,1434216,1,,,,3133
1f139e21988c822114a6bed8adda197d1414722c,0,Matt Gilman,2015-05-13 19:27:46-04:00,"['3f3fe3c359c2bfdff55a08b46087974d5ad49c23', 'c4d1666a26c86a89ced186caf638ecf6c4437a38']",47,113,160,1434376,5,,,,3133
e2750d4089c0684002dd672e932f27c388cafdbf,0,Matt Gilman,2015-05-13 19:30:57-04:00,['1f139e21988c822114a6bed8adda197d1414722c'],4,3,7,1434383,1,,,,3133
421ad8fb133d3bab32bc20d98011e9dfa0caff99,0,Brian Ghigiarelli,2015-05-13 20:32:23-04:00,"['29b4e56a61dc7125e10d7e5d70a0123485717b4d', 'e2750d4089c0684002dd672e932f27c388cafdbf']",31676,42113,73789,1508172,1392,,,,3133
30fcf882ec2fcbeefec2229393f5ca453d922d05,0,joewitt,2015-05-13 22:30:50-04:00,['e2750d4089c0684002dd672e932f27c388cafdbf'],157,22,179,1508351,1,,,,3133
483958ba0fb74d6ca0a3bf1b0e1ccbd1ab8af1b0,0,Matt Gilman,2015-05-14 08:07:32-04:00,['30fcf882ec2fcbeefec2229393f5ca453d922d05'],11,15,26,1508377,2,1,1,1,3133
9653770ac4a050f4439c07f7ae6e34658f08e5a0,1,Brian Ghigiarelli,2015-05-14 08:55:04-04:00,['421ad8fb133d3bab32bc20d98011e9dfa0caff99'],3,171,174,1508551,2,0.371428571,1,1,3133
b71b51976eb6e5afba636c8dd16e33a7436e3999,0,Brian Ghigiarelli,2015-05-14 08:57:25-04:00,"['9653770ac4a050f4439c07f7ae6e34658f08e5a0', '483958ba0fb74d6ca0a3bf1b0e1ccbd1ab8af1b0']",168,37,205,1508756,3,,,,3133
322dac6223e3c369a838c73a5bfb376e29650c25,0,Mark Payne,2015-05-15 13:54:11-04:00,"['483958ba0fb74d6ca0a3bf1b0e1ccbd1ab8af1b0', 'a973cc4f2a39cce356125a40b1a4d16fb54601ac']",7,98,105,1508861,6,,,,3133
48564b512519146dcdd353fc51eb484658dc3e20,0,Andrew Hulbert,2015-05-15 14:30:43-04:00,['483958ba0fb74d6ca0a3bf1b0e1ccbd1ab8af1b0'],1,3,4,1508865,1,,,,3133
6787afc30fd43a25e296b80ae928ed0703c3e885,0,Mark Payne,2015-05-15 14:52:32-04:00,"['322dac6223e3c369a838c73a5bfb376e29650c25', '48564b512519146dcdd353fc51eb484658dc3e20']",1,3,4,1508869,1,,,,3133
ca7e3c0daf04f1485e752a78d930b4ead944b2f8,0,Mark Payne,2015-05-15 14:58:35-04:00,"['6787afc30fd43a25e296b80ae928ed0703c3e885', 'badf1018c1765e4d1b277f3ede5a3231d3fe1734']",13,32,45,1508914,6,,,,3133
b7ddf8945024876e2a84a904c278e933e5a33937,0,Mark Payne,2015-05-17 20:13:47-04:00,"['ca7e3c0daf04f1485e752a78d930b4ead944b2f8', 'fdc801bc183b2435b658b3a7e3076ef45135e550']",414,410,824,1509738,120,,,,3133
add03e3893bcb2cabf563f45d929b0f6ab0ffc65,1,Tim Reardon,2015-05-19 08:15:13-04:00,['b7ddf8945024876e2a84a904c278e933e5a33937'],8,1159,1167,1510905,13,0.427251732,0.709006928,1,3142
5273a63bf100af307014d304d52ae5bf5644a8da,0,Mark Payne,2015-05-19 08:58:03-04:00,['add03e3893bcb2cabf563f45d929b0f6ab0ffc65'],3,1,4,1510909,1,1,0,0,3142
3cf65261aa141ef116b762d821cc5dbe26bb2bdd,1,bbende,2015-05-19 21:12:24-04:00,['5273a63bf100af307014d304d52ae5bf5644a8da'],10,179,189,1511098,2,0.194915254,1,0.805084746,3142
abf8652e845fdc0515b80ed9ada4cd7763b92d9d,0,Matt Gilman,2015-05-19 22:03:22-04:00,['483958ba0fb74d6ca0a3bf1b0e1ccbd1ab8af1b0'],1,3,4,1511102,2,,,,3143
a610cc6e5cde53b87808ba4dedf5ba51427575b1,0,Matt Gilman,2015-05-19 22:06:02-04:00,['abf8652e845fdc0515b80ed9ada4cd7763b92d9d'],0,18,18,1511120,1,,,,3143
a66848b263a2c5122ec758cfc28dd8f1c3c9c9ae,0,Matt Gilman,2015-05-19 22:07:15-04:00,"['a610cc6e5cde53b87808ba4dedf5ba51427575b1', '5273a63bf100af307014d304d52ae5bf5644a8da']",443,1700,2143,1513263,143,,,,3143
589e2b7ebf6ef70307ff1a2ab67c473d2f19a9a9,1,Mark Payne,2015-05-20 08:35:53-04:00,['5273a63bf100af307014d304d52ae5bf5644a8da'],0,793,793,1514056,13,0.4,1,0.923529412,3154
d1cace6a8a3105d852a595a0e8ca0ec2d397293a,1,Mark Payne,2015-05-20 08:35:54-04:00,['589e2b7ebf6ef70307ff1a2ab67c473d2f19a9a9'],64,98,162,1514218,4,0.636363636,1,1,3155
864e0996ca0cbbe922d4db25ede0d3ad1e38c3c5,1,Mark Payne,2015-05-20 08:35:54-04:00,['d1cace6a8a3105d852a595a0e8ca0ec2d397293a'],24,167,191,1514409,2,0.4,1,1,3155
1682d62d7f46ba854f77923352a77ff9f6a1b746,1,Mark Payne,2015-05-20 08:35:55-04:00,['864e0996ca0cbbe922d4db25ede0d3ad1e38c3c5'],19,113,132,1514541,3,0.307692308,0.487179487,1,3156
78906a9427757b5d387a18282191835089faebac,1,Mark Payne,2015-05-20 08:35:55-04:00,['1682d62d7f46ba854f77923352a77ff9f6a1b746'],38,32,70,1514611,5,0.857142857,0,0,3156
91aaabfa4c0533641568d82f0940402a28e5e8b7,1,Mark Payne,2015-05-20 09:53:36-04:00,['78906a9427757b5d387a18282191835089faebac'],392,497,889,1515500,18,0.285714286,0.857142857,1,3157
281ebafc2c84c37c0bf0b27f5d17c732ab3662b4,0,Mark Payne,2015-05-20 09:54:16-04:00,"['a66848b263a2c5122ec758cfc28dd8f1c3c9c9ae', '91aaabfa4c0533641568d82f0940402a28e5e8b7']",0,1163,1163,1516663,19,,,,3157
031c22e61e8130c69f59e26443722962c3913155,0,Matt Gilman,2015-05-20 10:18:47-04:00,['a66848b263a2c5122ec758cfc28dd8f1c3c9c9ae'],0,1,1,1516664,1,,,,3157
8c7dd6ab3d6fb50b91903688b0b5eb5e8a4e3e99,0,Matt Gilman,2015-05-20 10:19:46-04:00,['031c22e61e8130c69f59e26443722962c3913155'],0,10,10,1516674,1,0.1,1,1,3157
e0ee55e6c44fc563b7a376857d0f81c8133bae74,0,Mark Payne,2015-05-20 10:53:22-04:00,['281ebafc2c84c37c0bf0b27f5d17c732ab3662b4'],1,1,2,1516676,1,,,,3157
149ad130d91b06167db7fb45112d16fa341ad04b,0,Mark Payne,2015-05-20 12:41:51-04:00,"['e0ee55e6c44fc563b7a376857d0f81c8133bae74', '8c7dd6ab3d6fb50b91903688b0b5eb5e8a4e3e99']",0,11,11,1516687,2,,,,3157
f247e515dcd8f6f2ec1ddeb95dd4dfa6a0dfb165,0,Mark Payne,2015-05-20 14:47:53-04:00,"['149ad130d91b06167db7fb45112d16fa341ad04b', '3cf65261aa141ef116b762d821cc5dbe26bb2bdd']",10,179,189,1516876,2,,,,3157
82174e460c2f150d0d56f74a426e84a5b92efa1e,0,Mark Payne,2015-05-20 15:47:45-04:00,['f247e515dcd8f6f2ec1ddeb95dd4dfa6a0dfb165'],4,5,9,1516885,1,,,,3157
ce16aab6c57a5b3d771149a1720471b980cf5a1c,0,Brian Ghigiarelli,2015-05-21 08:42:32-04:00,"['421ad8fb133d3bab32bc20d98011e9dfa0caff99', '82174e460c2f150d0d56f74a426e84a5b92efa1e']",622,3112,3734,1520619,165,,,,3157
f160728253150e690408b760286a11e8adbb88eb,1,BELUGABEHR,2015-05-26 21:52:08-04:00,['82174e460c2f150d0d56f74a426e84a5b92efa1e'],165,235,400,1521019,5,,,,3157
de46a7c30ce60ba49138684c13f466397ca1df61,1,danbress,2015-05-27 21:57:15-04:00,['fdc801bc183b2435b658b3a7e3076ef45135e550'],10,171,181,1521200,9,1,1,1,3160
7f4e3d8afc184493ce3a8ea379d161010bb880fd,0,Matt Gilman,2015-05-28 19:16:59-04:00,['82174e460c2f150d0d56f74a426e84a5b92efa1e'],1,1,2,1521202,1,,,,3160
e2eb6f7c09abdb0dfd1c0db845f36f6d6c4aff10,0,Matt Gilman,2015-05-29 08:16:11-04:00,['7f4e3d8afc184493ce3a8ea379d161010bb880fd'],58,34,92,1521294,8,0.636363636,0,0,3161
84e56f2ef500ce5fdd12db7eca9eeedf77745c0f,1,Matt Gilman,2015-06-01 17:23:13-04:00,['e2eb6f7c09abdb0dfd1c0db845f36f6d6c4aff10'],44,53,97,1521391,13,1,1,1,3161
c0570fb395ebfeb2ccaac1a29ed6c31a835ca325,1,danbress,2015-06-01 19:56:51-04:00,['de46a7c30ce60ba49138684c13f466397ca1df61'],4,8,12,1521403,3,,,,3161
f2894edadc1b4a82f99d1287c9678cb54dd48f4f,0,Matt Gilman,2015-06-02 08:57:50-04:00,['84e56f2ef500ce5fdd12db7eca9eeedf77745c0f'],8,13,21,1521424,3,0.333333333,1,1,3161
b7504ccb10a5384df50960836549c10857efc1da,0,Matt Gilman,2015-06-02 09:27:28-04:00,['f2894edadc1b4a82f99d1287c9678cb54dd48f4f'],0,1,1,1521425,1,,,,3161
89801675b4bf66ee106bb452ba89996e4f0be56e,0,Matt Gilman,2015-06-02 11:57:07-04:00,['b7504ccb10a5384df50960836549c10857efc1da'],0,3,3,1521428,1,1,1,1,3161
88bfa664dc0986be3987b685fe65d7fb0e114870,0,Aldrin Piri,2015-06-02 15:29:52-04:00,['89801675b4bf66ee106bb452ba89996e4f0be56e'],2,0,2,1521430,1,1,1,0,3161
fa7aa808917def8f1da072e73534d9c25996f05c,0,danbress,2015-06-03 07:11:25-04:00,['c0570fb395ebfeb2ccaac1a29ed6c31a835ca325'],10,172,182,1521612,5,1,1,0.759036145,3162
310ae3ebcd7dfa62a14275a0aa7b67159ab957c0,0,joewitt,2015-06-04 09:09:30-04:00,['89801675b4bf66ee106bb452ba89996e4f0be56e'],235,235,470,1522082,125,,,,3162
07628f76fedfe8596c62fbfb2edd159ddf051665,1,joewitt,2015-06-04 11:01:39-04:00,['310ae3ebcd7dfa62a14275a0aa7b67159ab957c0'],21,25,46,1522128,2,,,,3162
fb75a4ba692ec834e470fc89de24bdd483439796,0,joewitt,2015-06-04 12:11:35-04:00,['07628f76fedfe8596c62fbfb2edd159ddf051665'],10,10,20,1522148,10,,,,3162
9fbd88f034e6d5006b0f9cc7c4ffcd09c7c65a01,0,Mark Payne,2015-06-04 12:42:56-04:00,['310ae3ebcd7dfa62a14275a0aa7b67159ab957c0'],85,88,173,1522321,1,0,0,1,3162
be50793decde1279f78e68548f5807a4cc646780,1,Matt Gilman,2015-06-04 12:53:42-04:00,['07628f76fedfe8596c62fbfb2edd159ddf051665'],103,111,214,1522535,2,0,0,1,3162
fcadaa894b39318d11fa6dffa7846d87c9a50d8c,0,Mark Payne,2015-06-04 13:01:23-04:00,['9fbd88f034e6d5006b0f9cc7c4ffcd09c7c65a01'],35,8,43,1522578,3,,,,3162
efc862eac8f24058916b6c37c1674f2aa9577e01,0,Mark Payne,2015-06-04 13:09:07-04:00,"['fcadaa894b39318d11fa6dffa7846d87c9a50d8c', 'fb75a4ba692ec834e470fc89de24bdd483439796']",31,35,66,1522644,12,,,,3162
e2227cdafadabf9d8e57437a5b71bc01d21d3367,0,Matt Gilman,2015-06-04 13:10:27-04:00,"['be50793decde1279f78e68548f5807a4cc646780', 'efc862eac8f24058916b6c37c1674f2aa9577e01']",130,106,236,1522880,14,,,,3162
8f55e35a0a63e9d106c1270962e531ed87a1d987,0,Aldrin Piri,2015-06-04 13:19:31-04:00,"['e2227cdafadabf9d8e57437a5b71bc01d21d3367', '88bfa664dc0986be3987b685fe65d7fb0e114870']",2,0,2,1522882,1,,,,3162
0aa904c82a467fa25623d6439579533f6206aa99,0,joewitt,2015-06-04 13:21:57-04:00,['e2227cdafadabf9d8e57437a5b71bc01d21d3367'],8,8,16,1522898,1,,,,3162
8201381c9b89addf63c50c2e098cd97b51071c08,0,joewitt,2015-06-04 13:49:38-04:00,"['0aa904c82a467fa25623d6439579533f6206aa99', '8f55e35a0a63e9d106c1270962e531ed87a1d987']",2,0,2,1522900,1,,,,3162
66f3b7e30f7726308ac25b7d0f2a2856880d1852,0,Mark Payne,2015-06-04 14:10:43-04:00,['efc862eac8f24058916b6c37c1674f2aa9577e01'],14,20,34,1522934,1,0.4,0.4,1,3162
6f32e6e9776548b746f6388d25067cd17aa1898c,1,joewitt,2015-06-04 14:52:16-04:00,['8201381c9b89addf63c50c2e098cd97b51071c08'],14,47,61,1522995,2,0,0.222222222,1,3162
5eed335804ccbbb15316e80fb5fb09b36897c69f,1,joewitt,2015-06-04 15:34:58-04:00,['6f32e6e9776548b746f6388d25067cd17aa1898c'],15,8,23,1523018,3,,,,3162
c7c4427cbf964e932be32b2000df26958255b043,1,joewitt,2015-06-04 15:37:32-04:00,['5eed335804ccbbb15316e80fb5fb09b36897c69f'],14,20,34,1523052,1,0.4,0.4,1,3162
aeefe73f0b7bdbbe18ef38457fbc3521da3fba3d,0,joewitt,2015-06-04 15:59:06-04:00,['c7c4427cbf964e932be32b2000df26958255b043'],4,4,8,1523060,4,,,,3162
b53948a6ba1b3d1615d402eb49238dd5fd0f316b,1,Aldrin Piri,2015-06-04 21:41:00-04:00,['aeefe73f0b7bdbbe18ef38457fbc3521da3fba3d'],0,75,75,1523135,5,0.326086957,0.847826087,1,3164
819b65f7e08ff5a836bd7c9fd29826539344abe9,1,joewitt,2015-06-04 22:48:38-04:00,['b53948a6ba1b3d1615d402eb49238dd5fd0f316b'],12,31,43,1523178,2,1,1,1,3164
1fb6aa49ba6a5e2fd45e8482deaf35401bcaace2,1,joewitt,2015-06-04 23:22:23-04:00,['819b65f7e08ff5a836bd7c9fd29826539344abe9'],1,20,21,1523199,2,1,1,1,3164
a49a03da43c52cd84a154f53aaa0ddbd366e6c1b,0,joewitt,2015-06-04 23:29:32-04:00,['1fb6aa49ba6a5e2fd45e8482deaf35401bcaace2'],3,2,5,1523204,2,,,,3164
8d1536ed24ea0b149f9fa14ead073b8decdead7d,0,Mark Payne,2015-06-05 08:49:01-04:00,['66f3b7e30f7726308ac25b7d0f2a2856880d1852'],4,22,26,1523230,3,0.5,0.5,1,3164
8d745c2b7699ab9fc66b8d816a6b9be5caf2efa1,1,joewitt,2015-06-05 10:36:51-04:00,['a49a03da43c52cd84a154f53aaa0ddbd366e6c1b'],17,10,27,1523257,1,1,1,0,3164
ba785564687d7118551c84a4ca46ddfb2b615c96,0,Aldrin Piri,2015-06-05 10:43:33-04:00,['8d745c2b7699ab9fc66b8d816a6b9be5caf2efa1'],9,38,47,1523304,1,0,0,1,3164
960560723dc4ed8968c1a4d072a5b4902c371298,0,Aldrin Piri,2015-06-05 13:39:36-04:00,['ba785564687d7118551c84a4ca46ddfb2b615c96'],0,310,310,1523614,4,0.358024691,0.358024691,0.901234568,3167
42a2fc5f649bf3e0028aa8c7f030b94df43f6422,0,Aldrin Piri,2015-06-05 13:57:30-04:00,['960560723dc4ed8968c1a4d072a5b4902c371298'],1,1,2,1523616,1,,,,3167
6d1128497bcfcfd105fd3d18305051615b254576,1,Aldrin Piri,2015-06-05 14:17:39-04:00,['42a2fc5f649bf3e0028aa8c7f030b94df43f6422'],4,48,52,1523668,2,0,0.807692308,1,3167
750d215635797cb6aef2bdfbc6c0aecf1c74a853,0,Matt Gilman,2015-06-05 14:24:10-04:00,['42a2fc5f649bf3e0028aa8c7f030b94df43f6422'],5,22,27,1523695,7,0.583333333,1,1,3167
73b08d8202d1c33428a73a900c354f1ac564a7f5,0,Matt Gilman,2015-06-05 14:50:56-04:00,"['750d215635797cb6aef2bdfbc6c0aecf1c74a853', '6d1128497bcfcfd105fd3d18305051615b254576']",4,48,52,1523747,2,,,,3167
63bdda4b5baaa398368ab085a6148fb785d1b87c,0,Mark Payne,2015-06-05 15:06:35-04:00,"['8d1536ed24ea0b149f9fa14ead073b8decdead7d', '73b08d8202d1c33428a73a900c354f1ac564a7f5']",180,717,897,1524644,33,,,,3167
6324442acf77be1a9dd677bba0c44d2061cb9af2,1,Matt Gilman,2015-06-05 16:08:46-04:00,['73b08d8202d1c33428a73a900c354f1ac564a7f5'],4,4,8,1524652,1,,,,3167
5c1afc0897a939bcde803c07216be91b6c4d0c03,1,Mark Payne,2015-06-05 16:17:50-04:00,['8d1536ed24ea0b149f9fa14ead073b8decdead7d'],24,75,99,1524751,2,0.242424242,0,1,3167
245fef4ee2728bdb6f69106853ed865540cd5bb5,0,Matt Gilman,2015-06-05 23:38:59-04:00,"['6324442acf77be1a9dd677bba0c44d2061cb9af2', '63bdda4b5baaa398368ab085a6148fb785d1b87c']",4,22,26,1524777,3,,,,3167
ffc5cdb92c2d4b1e37645ad0a7f4ac18233de5d8,0,Mark Payne,2015-06-06 11:28:44-04:00,['63bdda4b5baaa398368ab085a6148fb785d1b87c'],17,17,34,1524811,1,1,0,0,3167
c9ddf21ad63c032ec936adc25e2886b7632be098,1,Aldrin Piri,2015-06-06 11:31:15-04:00,['245fef4ee2728bdb6f69106853ed865540cd5bb5'],17,17,34,1524845,1,1,0,0,3167
c30950928e60c78512963cf50740651d8013e075,0,danbress,2015-06-06 13:31:02-04:00,"['c9ddf21ad63c032ec936adc25e2886b7632be098', 'fa7aa808917def8f1da072e73534d9c25996f05c']",14,341,355,1525200,12,,,,3167
35308edf4ef9a996af3c3b502353cdcddc3679b4,0,Mark Payne,2015-06-06 20:22:48-04:00,"['ffc5cdb92c2d4b1e37645ad0a7f4ac18233de5d8', 'c9ddf21ad63c032ec936adc25e2886b7632be098']",4,4,8,1525208,1,,,,3167
56c173fbd8df7ab6001a5e2f0480e78e00d73644,0,Mark Payne,2015-06-06 20:24:05-04:00,"['35308edf4ef9a996af3c3b502353cdcddc3679b4', '5c1afc0897a939bcde803c07216be91b6c4d0c03']",24,75,99,1525307,2,,,,3167
b9b628dece37f76d95278e4481ea6c81fb07cbf1,1,joewitt,2015-06-07 03:13:42-04:00,['56c173fbd8df7ab6001a5e2f0480e78e00d73644'],242,705,947,1526254,25,,,,3170
83785a97989b31180a5925060604a27084dc62cf,0,Mark Payne,2015-06-07 08:03:07-04:00,['8d1536ed24ea0b149f9fa14ead073b8decdead7d'],39,90,129,1526383,2,0.323529412,1,1,3170
68be759fe48e194fe5b2966512057b54a67b08a5,0,Mark Payne,2015-06-07 08:08:47-04:00,"['56c173fbd8df7ab6001a5e2f0480e78e00d73644', '83785a97989b31180a5925060604a27084dc62cf']",39,90,129,1526512,2,,,,3170
11bbd9cb42b1a61f3cf44b46e731d3eff15c1c90,0,Mark Payne,2015-06-07 08:09:00-04:00,"['68be759fe48e194fe5b2966512057b54a67b08a5', 'b9b628dece37f76d95278e4481ea6c81fb07cbf1']",242,705,947,1527459,25,,,,3170
ecb3680a77cfda2fd7589703253a61a63b977790,0,danbress,2015-06-07 08:10:56-04:00,"['c30950928e60c78512963cf50740651d8013e075', '11bbd9cb42b1a61f3cf44b46e731d3eff15c1c90']",305,870,1175,1528634,29,,,,3170
5fb5fa6da2504a8e73e1514031dfbb9557765442,0,Matt Gilman,2015-06-07 11:26:14-04:00,['ecb3680a77cfda2fd7589703253a61a63b977790'],1,1,2,1528636,1,,,,3170
ceda66159e6b73f6abaf03bf580e2878624c23ad,0,Mark Payne,2015-06-07 15:02:01-04:00,"['5fb5fa6da2504a8e73e1514031dfbb9557765442', 'f160728253150e690408b760286a11e8adbb88eb']",165,235,400,1529036,5,,,,3170
096ca61e255a6b4f91d525239ca95aefb508fb2e,1,Aldrin Piri,2015-06-07 16:01:54-04:00,['ceda66159e6b73f6abaf03bf580e2878624c23ad'],21,23,44,1529080,1,1,1,0,3170
0b4cddbe4911cd04e1727ca4305aead6fed4cb60,1,Aldrin Piri,2015-06-08 19:16:45-04:00,['096ca61e255a6b4f91d525239ca95aefb508fb2e'],4,8,12,1529092,1,,,,3170
089897190c9b904701649a9e0cb1ad92e9549996,0,Mark Payne,2015-06-08 20:20:33-04:00,['096ca61e255a6b4f91d525239ca95aefb508fb2e'],7,1,8,1529100,1,0,0,0,3170
facc4242bd1cf601fb2fc6b81745f7867c207616,0,Mark Payne,2015-06-08 20:20:34-04:00,['089897190c9b904701649a9e0cb1ad92e9549996'],9,5,14,1529114,1,0,0,0,3170
b82d1428b24b40fc2f003655979969632e0f5b7f,0,Mark Payne,2015-06-08 20:22:48-04:00,"['facc4242bd1cf601fb2fc6b81745f7867c207616', '0b4cddbe4911cd04e1727ca4305aead6fed4cb60']",4,8,12,1529126,1,,,,3170
86cbfab14ad13ce5adbb591deae9c8d46fd7274e,1,Mark Payne,2015-06-09 18:32:34-04:00,['b82d1428b24b40fc2f003655979969632e0f5b7f'],84,123,207,1529333,3,0.88,0.92,1,3170
30055dd0c84909a1c8fcd9113ee2f1a3d5467a50,1,danbress,2015-06-09 21:34:20-04:00,['86cbfab14ad13ce5adbb591deae9c8d46fd7274e'],0,213,213,1529546,3,0.4,1,1,3172
b4ee97c77135379bb1f659dced51e790050c5eb4,1,danbress,2015-06-09 21:34:21-04:00,['30055dd0c84909a1c8fcd9113ee2f1a3d5467a50'],0,306,306,1529852,8,0.612244898,1,1,3179
6f36c7939ba2eba1decfe87d26b152507207119b,1,danbress,2015-06-09 21:34:23-04:00,['b4ee97c77135379bb1f659dced51e790050c5eb4'],6,12,18,1529870,6,0,1,1,3182
4074ec37858b5fc42074468c981d507cdae4d402,1,danbress,2015-06-09 21:34:23-04:00,['6f36c7939ba2eba1decfe87d26b152507207119b'],9,22,31,1529901,2,0,1,1,3182
e4e9efad4428cf3dd57ee52658f93d75c1a55be5,0,danbress,2015-06-09 21:34:24-04:00,['4074ec37858b5fc42074468c981d507cdae4d402'],12,19,31,1529932,1,1,0,0,3182
f2818d2263c807f90761b5697ad3df3c727b23fd,0,danbress,2015-06-09 21:34:24-04:00,['e4e9efad4428cf3dd57ee52658f93d75c1a55be5'],4,8,12,1529944,3,0,1,1,3182
dc4065a97589fa4e60c18fecea13029b309af95e,0,danbress,2015-06-09 21:34:25-04:00,['f2818d2263c807f90761b5697ad3df3c727b23fd'],1,1,2,1529946,1,,,,3182
995a01636e12d73d6b8ccb292c49bf32efd0b179,0,danbress,2015-06-09 21:34:26-04:00,['dc4065a97589fa4e60c18fecea13029b309af95e'],0,0,0,1529946,2,,,,3182
196da2b443645f5029ab9d8ddf381e3a58e42969,1,danbress,2015-06-09 21:34:26-04:00,['995a01636e12d73d6b8ccb292c49bf32efd0b179'],25,21,46,1529992,5,1,0,0,3182
089a27f227afac1bff960d0b8cc0f31d206156d2,1,danbress,2015-06-09 21:34:27-04:00,['196da2b443645f5029ab9d8ddf381e3a58e42969'],5,9,14,1530006,1,1,1,1,3182
56d369e3357c91effffa42c8c96e9c8706422590,1,danbress,2015-06-09 21:34:27-04:00,['089a27f227afac1bff960d0b8cc0f31d206156d2'],0,60,60,1530066,4,,,,3186
53b86d7a6cdde754d34a9eb2745f270a4b57d5a9,1,danbress,2015-06-09 21:34:28-04:00,['56d369e3357c91effffa42c8c96e9c8706422590'],29,478,507,1530573,11,0.5,0.638888889,0.638888889,3189
976cfaf60253e54b18248b7ee58b982a0749e9d1,0,Mark Payne,2015-06-10 10:41:18-04:00,['86cbfab14ad13ce5adbb591deae9c8d46fd7274e'],1,1,2,1530575,1,,,,3189
9480c7a9c54a64f36a178875aa0ebd082190f644,0,Matt Gilman,2015-06-10 12:27:00-04:00,['86cbfab14ad13ce5adbb591deae9c8d46fd7274e'],17,34,51,1530626,1,0.142857143,0.928571429,1,3189
1404275bdfbd85ef405c269f48fddc7db103fb6c,0,Matt Gilman,2015-06-10 12:28:42-04:00,"['9480c7a9c54a64f36a178875aa0ebd082190f644', '976cfaf60253e54b18248b7ee58b982a0749e9d1']",1,1,2,1530628,1,,,,3189
6b51455f4c089df50120dc4040bdfee8ea7ca0cf,0,danbress,2015-06-13 08:29:13-04:00,['1404275bdfbd85ef405c269f48fddc7db103fb6c'],0,5,5,1530633,1,,,,3189
e1a59c47b7373c1165cc10623e4a2c945e470a4b,1,danbress,2015-06-13 12:22:38-04:00,['53b86d7a6cdde754d34a9eb2745f270a4b57d5a9'],21,21,42,1530675,2,0,1,,3189
cad8aa11e1adb57052303912b9adc90aaeff708f,0,danbress,2015-06-13 12:23:04-04:00,['e1a59c47b7373c1165cc10623e4a2c945e470a4b'],2,4,6,1530681,2,,,,3189
a1472701ad5c01a0a8622adf6e75b6824136b7f7,0,Aldrin Piri,2015-06-13 16:28:48-04:00,['6b51455f4c089df50120dc4040bdfee8ea7ca0cf'],3,3,6,1530687,1,,,,3189
081994e1192744fac621c98a6d9dd5d8b9341512,0,danbress,2015-06-14 21:11:01-04:00,['a1472701ad5c01a0a8622adf6e75b6824136b7f7'],1,1,2,1530689,1,,,,3189
3295f7f193e719346fef6237aaf1a5c40767c6f7,1,Aldrin Piri,2015-06-15 16:21:48-04:00,['081994e1192744fac621c98a6d9dd5d8b9341512'],4,35,39,1530728,4,1,1,1,3190
46aa2685e3162ee6afbf68a0ac68d5206cb9c500,0,danbress,2015-06-15 20:38:54-04:00,"['cad8aa11e1adb57052303912b9adc90aaeff708f', '3295f7f193e719346fef6237aaf1a5c40767c6f7']",26,79,105,1530833,9,,,,3190
f72fdcdb150582880bfe5087743d179f32e869ad,1,Matt Gilman,2015-06-15 21:27:06-04:00,['3295f7f193e719346fef6237aaf1a5c40767c6f7'],49,110,159,1530992,5,0.87804878,0.926829268,1,3191
28abc9acba55139b8809def5960e35778ead3e51,0,Bryan Bende,2015-06-15 22:25:15-04:00,['f72fdcdb150582880bfe5087743d179f32e869ad'],0,5,5,1530997,1,,,,3191
739baa2e5711b0677a451c4acadb10e232d5bf2b,1,Mark Payne,2015-06-17 07:56:49-04:00,['28abc9acba55139b8809def5960e35778ead3e51'],166,499,665,1531662,13,0.792307692,0.819230769,0.507692308,3191
315af02c595fdf62881b839f44227d121cbda46d,1,Mark Payne,2015-06-17 08:15:10-04:00,['739baa2e5711b0677a451c4acadb10e232d5bf2b'],182,185,367,1532029,4,1,0,0,3191
69f04cbb8668b9c1500e23c2dbe41ebf97644bd0,1,Mark Payne,2015-06-17 08:19:36-04:00,['315af02c595fdf62881b839f44227d121cbda46d'],274,320,594,1532623,11,0.291666667,0.291666667,0.583333333,3191
a4d21e3cd642dcbafa18a3be4995465755487e16,0,Matt Gilman,2015-06-17 08:52:17-04:00,['69f04cbb8668b9c1500e23c2dbe41ebf97644bd0'],5,5,10,1532633,4,,,,3191
13addeb571746f8ace93928ab423af3ed1a3bc3c,1,Mark Payne,2015-06-17 12:35:53-04:00,['69f04cbb8668b9c1500e23c2dbe41ebf97644bd0'],270,1126,1396,1534029,7,0.218934911,0.786982249,0.931952663,3196
14bcad212a4e2c7242e892c0389c8da885e87e9c,1,Mark Payne,2015-06-17 12:35:54-04:00,['13addeb571746f8ace93928ab423af3ed1a3bc3c'],81,101,182,1534211,4,0,1,1,3196
d98757e4c79a0c036165e6278fc99909fc2ebcaf,1,Mark Payne,2015-06-17 12:35:55-04:00,['14bcad212a4e2c7242e892c0389c8da885e87e9c'],6,34,40,1534251,2,0.636363636,1,1,3196
a3b8e44ad5aff7b68dde26c242ba171d1884b948,1,Mark Payne,2015-06-17 12:37:25-04:00,['d98757e4c79a0c036165e6278fc99909fc2ebcaf'],293,280,573,1534824,5,1,0,0,3196
ae9b40ec6f71f69b7866d309464476686d3eebfa,0,Mark Payne,2015-06-17 12:37:26-04:00,['a3b8e44ad5aff7b68dde26c242ba171d1884b948'],82,25,107,1534931,4,0.619047619,0,0,3196
ec02e58d3c0a8162a32fb5c51651accf1d961d1b,0,Mark Payne,2015-06-17 12:37:27-04:00,['ae9b40ec6f71f69b7866d309464476686d3eebfa'],1,15,16,1534947,1,0,0,1,3196
118b6608c7334b577e4957653661ef4a488ebc6b,1,Mark Payne,2015-06-17 13:31:02-04:00,['ec02e58d3c0a8162a32fb5c51651accf1d961d1b'],330,350,680,1535627,8,0,0,0,3196
0af9c75d78c37f1551c53c0a4043d9f3fa5a82e3,0,Mark Payne,2015-06-17 13:33:08-04:00,"['a4d21e3cd642dcbafa18a3be4995465755487e16', '118b6608c7334b577e4957653661ef4a488ebc6b']",476,1344,1820,1537447,12,,,,3196
66365b0e1d1a290722bd1a4cfb5821b27fb68648,0,Matt Gilman,2015-06-17 22:43:33-04:00,['0af9c75d78c37f1551c53c0a4043d9f3fa5a82e3'],7,13,20,1537467,5,0,0,1,3196
e50b20c4ce513046b692154e370b0b1f87e21e0a,1,Mark Payne,2015-06-18 09:03:54-04:00,['66365b0e1d1a290722bd1a4cfb5821b27fb68648'],6,2,8,1537475,1,1,0,0,3196
b7b42c7423a348ff7c867a17cfbfa106fbc2fbab,1,Matt Gilman,2015-06-18 10:20:49-04:00,['e50b20c4ce513046b692154e370b0b1f87e21e0a'],9,16,25,1537500,3,0,0,0,3196
c4d186bdd997f3f697bf6c9d3ed8a09bbe970e8b,0,Mark Payne,2015-06-18 11:30:04-04:00,['b7b42c7423a348ff7c867a17cfbfa106fbc2fbab'],5,15,20,1537520,1,0,1,1,3196
8b5a8ab0540649cb106e75b7699e2b41a40e1124,0,Aldrin Piri,2015-06-18 23:12:24-04:00,['b7b42c7423a348ff7c867a17cfbfa106fbc2fbab'],7,20,27,1537547,2,0,0,1,3196
64502d0e10e964bebddd0ad35c4c074f002d536d,1,Aldrin Piri,2015-06-18 23:13:49-04:00,['8b5a8ab0540649cb106e75b7699e2b41a40e1124'],26,91,117,1537664,4,0.1,1,1,3196
cef720679686c48327b919ff2eeb192659e4f287,0,Matt Gilman,2015-06-19 08:51:22-04:00,['64502d0e10e964bebddd0ad35c4c074f002d536d'],37,0,37,1537701,3,1,1,0,3196
5fe99752927f4f2fb460ecb5cd651089770d811f,0,Matt Gilman,2015-06-19 09:57:30-04:00,['cef720679686c48327b919ff2eeb192659e4f287'],0,5,5,1537706,1,0,0,1,3196
a1f0438451e5893770616e2829a3f4ea034f625f,0,Mark Payne,2015-06-19 11:10:11-04:00,['cef720679686c48327b919ff2eeb192659e4f287'],18,12,30,1537736,1,1,0,1,3196
2d0bb1c1cd3ab4aaade11a13fa718b331fbe1b7f,0,Matt Gilman,2015-06-19 11:50:02-04:00,"['5fe99752927f4f2fb460ecb5cd651089770d811f', 'a1f0438451e5893770616e2829a3f4ea034f625f']",18,12,30,1537766,1,,,,3196
a5d6f88c2e0c6fc753fa753f259aaa6e3475049a,1,Mark Payne,2015-06-19 12:55:04-04:00,['a1f0438451e5893770616e2829a3f4ea034f625f'],7,11,18,1537784,1,0,0,1,3196
548f6d08352291c0e553a8d081732b16405609c2,0,Mark Payne,2015-06-19 13:08:49-04:00,"['a5d6f88c2e0c6fc753fa753f259aaa6e3475049a', '2d0bb1c1cd3ab4aaade11a13fa718b331fbe1b7f']",0,5,5,1537789,1,,,,3196
531136db98743664fbe01f10947a7d7c26ecb4aa,0,Mark Payne,2015-06-19 13:12:09-04:00,"['548f6d08352291c0e553a8d081732b16405609c2', 'c4d186bdd997f3f697bf6c9d3ed8a09bbe970e8b']",2,12,14,1537803,1,,,,3196
3045a52e354dd1f4cec380747b3d9cd6b1feba56,0,Brian Ghigiarelli,2015-06-19 17:46:08-04:00,"['ce16aab6c57a5b3d771149a1720471b980cf5a1c', '531136db98743664fbe01f10947a7d7c26ecb4aa']",2495,5459,7954,1545757,294,,,,3196
5b0648cf3f98c91b5d392eff3cd9fd22422abeef,0,Brian Ghigiarelli,2015-06-19 17:46:53-04:00,"['b71b51976eb6e5afba636c8dd16e33a7436e3999', '3045a52e354dd1f4cec380747b3d9cd6b1feba56']",2469,8055,10524,1556281,322,,,,3196
8af84f3f73bd7890c44c1f3b7597330023e34d16,1,Brian Ghigiarelli,2015-06-19 18:49:21-04:00,['5b0648cf3f98c91b5d392eff3cd9fd22422abeef'],40,167,207,1556488,2,0.573770492,1,1,3196
33848b30369900b56ae127e24d39ad03ba99d289,0,danbress,2015-06-20 11:10:03-04:00,['531136db98743664fbe01f10947a7d7c26ecb4aa'],1,1,2,1556490,1,,,,3196
0f01b3c96fb0a12df7fe5159adf99d899eef46d5,0,Mark Payne,2015-06-20 17:20:42-04:00,['33848b30369900b56ae127e24d39ad03ba99d289'],2,15,17,1556507,1,0,0,1,3196
47847ab404d325663ed08b400da81337a79e298d,0,danbress,2015-06-20 18:07:39-04:00,['33848b30369900b56ae127e24d39ad03ba99d289'],16,59,75,1556582,1,0.615384615,0.615384615,1,3196
6b4e90dd5dabff82b1aeae8d9c64cdd32112b33d,0,danbress,2015-06-20 19:48:02-04:00,['47847ab404d325663ed08b400da81337a79e298d'],0,126,126,1556708,3,0.846153846,0.846153846,0.730769231,3197
28bfb70e46a3099139e810b5ee93d7335ddb880c,0,danbress,2015-06-21 13:21:55-04:00,"['46aa2685e3162ee6afbf68a0ac68d5206cb9c500', '33848b30369900b56ae127e24d39ad03ba99d289']",1271,2650,3921,1560629,71,,,,3197
c4c98fc4a92ef44993324c5510cc31ba4736d4b8,1,Mark Payne,2015-06-22 09:04:55-04:00,['0f01b3c96fb0a12df7fe5159adf99d899eef46d5'],286,532,818,1561447,62,0.519685039,0.68503937,1,3198
e5444aa3cf6ca941827a3110195424c73cf445f4,0,Brian Ghigiarelli,2015-06-22 09:21:58-04:00,"['3045a52e354dd1f4cec380747b3d9cd6b1feba56', 'c4c98fc4a92ef44993324c5510cc31ba4736d4b8']",289,548,837,1562284,64,,,,3198
f5226ad3c6da00197b62cabd935e0e2d0c453cd9,0,Mark Payne,2015-06-22 10:37:42-04:00,"['c4c98fc4a92ef44993324c5510cc31ba4736d4b8', '8af84f3f73bd7890c44c1f3b7597330023e34d16']",2,298,300,1562584,2,,,,3198
f2f90560557de70ef4404672ce53c4593995a5f1,1,Mark Payne,2015-06-22 12:05:02-04:00,['f5226ad3c6da00197b62cabd935e0e2d0c453cd9'],195,203,398,1562982,2,1,1,1,3198
5d8bfa7c806549f5ede6eec5047dc66696bc95d8,1,Mark Payne,2015-06-22 12:08:41-04:00,['f2f90560557de70ef4404672ce53c4593995a5f1'],0,126,126,1563108,3,0.846153846,0.846153846,0.730769231,3199
ddad70ba009a875e088020ae1ea8f29caeb529f9,1,Mark Payne,2015-06-22 12:42:22-04:00,['5d8bfa7c806549f5ede6eec5047dc66696bc95d8'],26,31,57,1563165,1,,,,3199
77a0561bc059b7503867d583245b025d08244dc8,0,Mark Payne,2015-06-22 12:50:17-04:00,['5d8bfa7c806549f5ede6eec5047dc66696bc95d8'],1,1,2,1563167,1,,,,3199
b22a1261c3f29c8714d043174b7beff36ebe5549,1,Mark Payne,2015-06-22 13:30:53-04:00,['77a0561bc059b7503867d583245b025d08244dc8'],2,8,10,1563177,2,0,1,0,3199
979671ca9719aca6789f213529991fc99d86979d,0,Mark Payne,2015-06-22 15:58:08-04:00,['b22a1261c3f29c8714d043174b7beff36ebe5549'],12,3,15,1563192,1,0,0,0,3199
25146a5828bc5dd1d04c5252843bef93ea87afac,1,Mark Payne,2015-06-22 16:06:40-04:00,['979671ca9719aca6789f213529991fc99d86979d'],43,180,223,1563415,13,0.268292683,0.243902439,0.158536585,3199
908ec18b59030f0b43637ca3c90654040566c99e,0,Matt Gilman,2015-06-22 16:39:18-04:00,['979671ca9719aca6789f213529991fc99d86979d'],0,4,4,1563419,3,,,,3199
628e63998c43934432bbf02219bc20991545223e,0,Matt Gilman,2015-06-22 16:43:25-04:00,"['908ec18b59030f0b43637ca3c90654040566c99e', '25146a5828bc5dd1d04c5252843bef93ea87afac']",43,180,223,1563642,13,,,,3199
b38d74a65f9f58e8a628c648ab48ee3c7cace0db,0,Matt Gilman,2015-06-23 07:26:43-04:00,['628e63998c43934432bbf02219bc20991545223e'],9,13,22,1563664,1,0,0,1,3199
1faca8c93ea617a80bbeaa7ebd318b477f4ebd07,0,Mark Payne,2015-06-23 09:53:40-04:00,['25146a5828bc5dd1d04c5252843bef93ea87afac'],0,4,4,1563668,1,,,,3199
c45dcf0b52b6a856bc238a54adf45addc78651e8,0,Mark Payne,2015-06-23 10:24:58-04:00,['25146a5828bc5dd1d04c5252843bef93ea87afac'],0,0,0,1563668,0,,,,3199
a6de1b42504471f9f99aca8f8fe78f1cba85c8e1,0,Mark Payne,2015-06-23 10:29:11-04:00,"['c45dcf0b52b6a856bc238a54adf45addc78651e8', 'b38d74a65f9f58e8a628c648ab48ee3c7cace0db']",9,17,26,1563694,4,,,,3199
169256015bdef5d2bae6d4676ef776b06cdb42cd,0,Mark Payne,2015-06-23 11:03:47-04:00,"['a6de1b42504471f9f99aca8f8fe78f1cba85c8e1', '1faca8c93ea617a80bbeaa7ebd318b477f4ebd07']",0,4,4,1563698,1,,,,3199
e767f5ce02c36f41874d4f97abdb50c643662deb,0,Mark Payne,2015-06-23 11:17:30-04:00,"['169256015bdef5d2bae6d4676ef776b06cdb42cd', 'ddad70ba009a875e088020ae1ea8f29caeb529f9']",26,31,57,1563755,1,,,,3199
a896510d7f0c60184ac37159f39c2f2fbc11208f,0,Matt Gilman,2015-06-23 14:09:45-04:00,['e767f5ce02c36f41874d4f97abdb50c643662deb'],3,4,7,1563762,3,,,,3199
3a05a7da721d70767ab3ad9a6827a10e2d318725,1,Matt Gilman,2015-06-23 16:15:33-04:00,['a896510d7f0c60184ac37159f39c2f2fbc11208f'],0,17,17,1563779,1,,,,3199
0c5b78f03f9fa2a91a52347114a073a8c6ee59e6,0,Aldrin Piri,2015-06-23 19:59:00-04:00,['e767f5ce02c36f41874d4f97abdb50c643662deb'],2,2,4,1563783,1,,,,3199
ba3155980efd846b45bd47eefa14f503a13908f3,1,Mark Payne,2015-06-24 08:13:06-04:00,['e767f5ce02c36f41874d4f97abdb50c643662deb'],43,89,132,1563915,9,0,1,0,3199
0df351dcb47432dd0cacf31a2ed5e5765aa96f03,0,Matt Gilman,2015-06-24 09:13:29-04:00,['3a05a7da721d70767ab3ad9a6827a10e2d318725'],1,1,2,1563917,1,,,,3199
69297a3aa0608e3be3b6d609e623b0b7bef263d6,0,Matt Gilman,2015-06-24 09:15:27-04:00,"['0df351dcb47432dd0cacf31a2ed5e5765aa96f03', '0c5b78f03f9fa2a91a52347114a073a8c6ee59e6']",2,2,4,1563921,1,,,,3199
f1adb8bf034a8407dfdd655e441c74c10a61b18f,0,Mark Payne,2015-06-24 14:03:34-04:00,['e767f5ce02c36f41874d4f97abdb50c643662deb'],68,341,409,1564330,16,0.259615385,0.432692308,0.644230769,3202
f58972e566448886cdf984e6c8a34c83674b0705,1,Mark Payne,2015-06-25 09:56:07-04:00,['69297a3aa0608e3be3b6d609e623b0b7bef263d6'],3,19,22,1564352,2,1,1,0.545454545,3202
e240e07aaebea1fd66b22fce8aec3f0005fd3f60,1,Mark Payne,2015-06-25 10:56:49-04:00,['e767f5ce02c36f41874d4f97abdb50c643662deb'],71,349,420,1564772,16,0.287037037,0.453703704,0.657407407,3205
0a7ab1a06dd8b7164413bdcd0a85a4c457d3da71,0,Mark Payne,2015-06-25 10:58:01-04:00,"['e240e07aaebea1fd66b22fce8aec3f0005fd3f60', 'f1adb8bf034a8407dfdd655e441c74c10a61b18f']",0,0,0,1564772,0,,,,3205
7a28903402192819accaded9a90adfdfad852776,1,Matt Gilman,2015-06-25 14:38:47-04:00,['0a7ab1a06dd8b7164413bdcd0a85a4c457d3da71'],35,230,265,1565037,4,0.607476636,0.962616822,0.962616822,3205
97f33d5c51dfd5178c10ad88fb3701f363ae39a4,0,Brian Ghigiarelli,2015-06-26 11:21:49-04:00,"['e5444aa3cf6ca941827a3110195424c73cf445f4', 'f58972e566448886cdf984e6c8a34c83674b0705']",180,795,975,1566012,34,,,,3205
40b55efbd7082935accb37c17bacbcb8d1f1cd38,0,danbress,2015-06-26 19:14:23-04:00,"['28bfb70e46a3099139e810b5ee93d7335ddb880c', 'f58972e566448886cdf984e6c8a34c83674b0705']",468,1342,1810,1567822,97,,,,3205
cc3be416b26c9733f84b2acff590389ed1dd1abc,0,danbress,2015-06-26 20:18:56-04:00,"['6b4e90dd5dabff82b1aeae8d9c64cdd32112b33d', '40b55efbd7082935accb37c17bacbcb8d1f1cd38']",589,2397,2986,1570808,131,,,,3205
8f36ba1ab417bdd6f6d3c3884e4abf750c5ea226,1,joewitt,2015-06-27 13:45:00-04:00,['cc3be416b26c9733f84b2acff590389ed1dd1abc'],5,19,24,1570832,6,,,,3208
e35f348b831f5a27960d0d2dec4787860941fe29,0,joewitt,2015-06-27 13:55:33-04:00,['8f36ba1ab417bdd6f6d3c3884e4abf750c5ea226'],6,0,6,1570838,3,,,,3208
bd9782cb43ece682c853d9a75279ebe76f968044,1,danbress,2015-06-27 14:38:45-04:00,['e35f348b831f5a27960d0d2dec4787860941fe29'],7,42,49,1570887,7,0.80952381,1,1,3208
846d2f4472edd0795f1647686821576669ee1cb3,0,danbress,2015-06-27 15:13:03-04:00,['e35f348b831f5a27960d0d2dec4787860941fe29'],1,1,2,1570889,1,,,,3208
4dc2ea6d477ca0c03d78c42e8958e0af58e084be,0,danbress,2015-06-28 16:01:14-04:00,"['e35f348b831f5a27960d0d2dec4787860941fe29', '846d2f4472edd0795f1647686821576669ee1cb3']",1,1,2,1570891,1,,,,3208
93546760be2223f40215a0aeb9614dbb9bdb148f,0,danbress,2015-06-28 16:03:32-04:00,"['bd9782cb43ece682c853d9a75279ebe76f968044', '4dc2ea6d477ca0c03d78c42e8958e0af58e084be']",1,1,2,1570893,1,,,,3208
c769742d9b10145c26a0b6cd75b9ae75bbdc9589,1,danbress,2015-06-28 16:42:52-04:00,['93546760be2223f40215a0aeb9614dbb9bdb148f'],12,6,18,1570911,5,0,0,0,3208
2e32e0e2b82e071734919589ed680513edfd39ed,0,joewitt,2015-06-29 22:00:22-04:00,['4dc2ea6d477ca0c03d78c42e8958e0af58e084be'],67,384,451,1571362,5,0.073529412,0.823529412,1,3209
50215707f7e4ab2207041ed1e31e7ba2d88de7b4,0,joewitt,2015-06-29 22:16:44-04:00,['2e32e0e2b82e071734919589ed680513edfd39ed'],0,0,0,1571362,0,,,,3209
59aa8ffe100645498fdd4cea2214a203e3a3d433,1,Matt Gilman,2015-06-30 14:14:57-04:00,['7a28903402192819accaded9a90adfdfad852776'],49,313,362,1571724,11,0.208633094,0.73381295,0.856115108,3209
a09180799d8a84108c3f5665668bded284768ecf,0,Mark Payne,2015-07-01 10:44:42-04:00,"['50215707f7e4ab2207041ed1e31e7ba2d88de7b4', 'ba3155980efd846b45bd47eefa14f503a13908f3']",43,99,142,1571866,10,,,,3209
e7c0461b15bff045d68e7ae8814eda2073cba209,1,Mark Payne,2015-07-01 12:54:18-04:00,['59aa8ffe100645498fdd4cea2214a203e3a3d433'],27,78,105,1571971,1,0,0,1,3209
4fd1e9494e41bea198dabedacee16ed018a3a7b7,0,Matt Gilman,2015-07-01 14:25:12-04:00,['e7c0461b15bff045d68e7ae8814eda2073cba209'],4,4,8,1571979,2,,,,3209
c3dff409024d00208c68323ad1989bd2b93b7c0c,0,Matt Gilman,2015-07-02 10:22:42-04:00,['4fd1e9494e41bea198dabedacee16ed018a3a7b7'],1,4,5,1571984,1,1,1,1,3209
566c4fe8d78b769fc31c8d5bed90daccbc817e27,0,Matt Gilman,2015-07-02 13:45:14-04:00,['c3dff409024d00208c68323ad1989bd2b93b7c0c'],0,36,36,1572020,4,1,1,1,3209
eddc071b8efc3c6ca86e373b56f214514b2abd0a,0,Matt Gilman,2015-07-02 16:27:05-04:00,"['566c4fe8d78b769fc31c8d5bed90daccbc817e27', 'a09180799d8a84108c3f5665668bded284768ecf']",174,1692,1866,1573886,56,,,,3209
063afe2a0dfbd7d256ad6e1df07886013f6b9503,0,Aldrin Piri,2015-07-03 00:55:15-04:00,['eddc071b8efc3c6ca86e373b56f214514b2abd0a'],1,2,3,1573889,1,,,,3209
9d6458ab2800add00312e129bf60cd04ead350f9,1,Matt Gilman,2015-07-03 08:51:46-04:00,['eddc071b8efc3c6ca86e373b56f214514b2abd0a'],1,154,155,1574044,2,0.172839506,0.604938272,0.827160494,3209
786bc1d61260e2d8558747ca206d360aebdd1994,1,Mark Payne,2015-07-03 09:04:52-04:00,['063afe2a0dfbd7d256ad6e1df07886013f6b9503'],6,22,28,1574072,1,0,1,1,3209
b1718494679c83a61e4f37976a58b29caba8b00f,0,Matt Gilman,2015-07-03 09:09:15-04:00,"['9d6458ab2800add00312e129bf60cd04ead350f9', '063afe2a0dfbd7d256ad6e1df07886013f6b9503']",1,2,3,1574075,1,,,,3209
322ac6fba6bec0e691b29cea74af7a93572677a5,0,Mark Payne,2015-07-03 09:38:19-04:00,"['786bc1d61260e2d8558747ca206d360aebdd1994', 'b1718494679c83a61e4f37976a58b29caba8b00f']",1,154,155,1574230,2,,,,3209
136974af7c63bdb8c4c99c1a02c6b34011e2e17f,1,Aldrin Piri,2015-07-03 10:39:40-04:00,['322ac6fba6bec0e691b29cea74af7a93572677a5'],23,33,56,1574286,4,1,1,0,3209
74b48009376e950bfa455be31e15f13cde7d27b9,1,Mark Payne,2015-07-03 12:45:33-04:00,['136974af7c63bdb8c4c99c1a02c6b34011e2e17f'],22,22,44,1574330,1,1,0,0,3209
159615bb8e6ca6e48a8418e9059874cdd4b4eee1,0,Mark Payne,2015-07-03 12:48:44-04:00,['74b48009376e950bfa455be31e15f13cde7d27b9'],5,61,66,1574396,2,0,0.642857143,1,3209
05772a07cf9a8c14143d805c9698634326d5024f,0,Mark Payne,2015-07-03 12:48:45-04:00,['159615bb8e6ca6e48a8418e9059874cdd4b4eee1'],1,1,2,1574398,1,,,,3209
2ac61c5972d30eb3840ca6d4066f14f87e5adb00,0,Mark Payne,2015-07-03 12:48:46-04:00,['05772a07cf9a8c14143d805c9698634326d5024f'],2,14,16,1574414,2,0,0.5,1,3209
2a4e5e12855364c6d4b14f1ef1445e08d1f4fe08,1,Mark Payne,2015-07-03 12:55:32-04:00,['2ac61c5972d30eb3840ca6d4066f14f87e5adb00'],13,17,30,1574444,1,,,,3209
8da7327188ebdb3cbadda257429e4967be07bf77,1,Mark Payne,2015-07-03 13:14:16-04:00,['2a4e5e12855364c6d4b14f1ef1445e08d1f4fe08'],29,154,183,1574627,3,0.763157895,0.763157895,1,3210
a2b9d70ac43f6f3162abb7706f9021ce3e3993f0,0,Mark Payne,2015-07-03 13:33:06-04:00,['8da7327188ebdb3cbadda257429e4967be07bf77'],2,2,4,1574631,1,,,,3210
63a900852769bbd7bedc2b460a291a9de0bd9a15,1,Mark Payne,2015-07-03 13:37:44-04:00,['8da7327188ebdb3cbadda257429e4967be07bf77'],13,56,69,1574700,4,0.4375,1,1,3210
f3b55d46d6a374ee27b2decb3ee7284fd294a10d,0,Mark Payne,2015-07-03 13:50:43-04:00,"['63a900852769bbd7bedc2b460a291a9de0bd9a15', 'a2b9d70ac43f6f3162abb7706f9021ce3e3993f0']",2,2,4,1574704,1,,,,3210
208402472dd99c629afc056f4464b925b8f834ab,1,Mark Payne,2015-07-03 15:00:31-04:00,['f3b55d46d6a374ee27b2decb3ee7284fd294a10d'],27,22,49,1574753,2,1,1,0,3210
0d2842e4f9df2c1734c409d80511601765d8dc1b,0,Bryan Bende,2015-07-04 12:38:33-04:00,['208402472dd99c629afc056f4464b925b8f834ab'],3,37,40,1574793,2,1,1,1,3210
9fa03b43245cfba27fe084ac46b44f39856dbcbb,0,danbress,2015-07-06 20:25:54-04:00,"['0d2842e4f9df2c1734c409d80511601765d8dc1b', 'c769742d9b10145c26a0b6cd75b9ae75bbdc9589']",16,45,61,1574854,7,,,,3210
c0f110467997d1e05e58ef444385478ba05a59e5,0,Mark Payne,2015-07-07 20:44:03-04:00,['208402472dd99c629afc056f4464b925b8f834ab'],1,9,10,1574864,1,0,1,1,3210
3125036d3f463c97a10466d244952f10f0054b64,0,Mark Payne,2015-07-07 21:08:34-04:00,"['c0f110467997d1e05e58ef444385478ba05a59e5', '9fa03b43245cfba27fe084ac46b44f39856dbcbb']",19,82,101,1574965,9,,,,3210
df92dff8bb1ca0bdcebd5658aaae1234b2f5f209,1,Aldrin Piri,2015-07-08 13:12:04-04:00,['3125036d3f463c97a10466d244952f10f0054b64'],1,1,2,1574967,1,,,,3210
48a4c2a32061ada03b7243318c2bb255feb9317b,0,Aldrin Piri,2015-07-08 14:22:17-04:00,['df92dff8bb1ca0bdcebd5658aaae1234b2f5f209'],1,52,53,1575020,1,,,,3210
e4f51eac9d1b9eabbb091a9f2c3eb1fee453cfc6,0,Matt Gilman,2015-07-08 14:44:44-04:00,['df92dff8bb1ca0bdcebd5658aaae1234b2f5f209'],386,389,775,1575795,129,,,,3210
de8ec6f92c85970b1665765e0b11d04e486cc966,0,Matt Gilman,2015-07-08 14:44:55-04:00,['e4f51eac9d1b9eabbb091a9f2c3eb1fee453cfc6'],245,241,486,1576281,129,,,,3210
7f6f404baa1826462384de6c35be823189a36821,0,joewitt,2015-07-11 09:44:56-04:00,['48a4c2a32061ada03b7243318c2bb255feb9317b'],0,0,0,1576281,0,,,,3210
8bd20510ee348e497b6039e083b32e37a4d3a20e,1,Mark Payne,2015-07-13 14:17:42-04:00,['7f6f404baa1826462384de6c35be823189a36821'],14,311,325,1576606,8,0.344537815,0.605042017,0.983193277,3211
bb64e70e6fbda12a9e0388b5c2240d96d34ac6bf,1,joewitt,2015-07-14 07:22:34-04:00,['8bd20510ee348e497b6039e083b32e37a4d3a20e'],0,1219,1219,1577825,6,0.15920398,0.532338308,0.857379768,3216
8ff69ca2d1bc5b7d651b7495f2ce45def12bebc2,0,joewitt,2015-07-14 07:41:07-04:00,['bb64e70e6fbda12a9e0388b5c2240d96d34ac6bf'],1,1,2,1577827,1,,,,3216
4dc126aff8751e66018ac03260f3061b97719487,0,Mark Payne,2015-07-14 08:40:04-04:00,['8bd20510ee348e497b6039e083b32e37a4d3a20e'],0,0,0,1577827,0,,,,3216
483b3dddfb7fc0cb569f8553513286d1d2cf1cf2,0,Mark Payne,2015-07-14 08:40:22-04:00,"['4dc126aff8751e66018ac03260f3061b97719487', '8ff69ca2d1bc5b7d651b7495f2ce45def12bebc2']",0,1219,1219,1579046,6,,,,3216
b251ab44258a840c5bacd973776b26dacbdbbbc2,1,Matt Gilman,2015-07-14 14:50:16-04:00,['483b3dddfb7fc0cb569f8553513286d1d2cf1cf2'],0,1330,1330,1580376,19,0.508438819,0.797468354,0.928270042,3234
cf29029a4db4cc606b417889296abb97e460d586,1,Matt Gilman,2015-07-14 14:50:16-04:00,['b251ab44258a840c5bacd973776b26dacbdbbbc2'],229,257,486,1580862,6,0,1,1,3234
3b9e48246641e617cd3fef987ce6facd283f6f3e,0,Matt Gilman,2015-07-14 14:50:16-04:00,['cf29029a4db4cc606b417889296abb97e460d586'],20,61,81,1580943,8,0.35483871,0,1,3234
3529bb33178ce70a33cc7ab21d7334ba3411048b,1,Matt Gilman,2015-07-14 14:50:16-04:00,['3b9e48246641e617cd3fef987ce6facd283f6f3e'],149,261,410,1581353,14,0.769230769,0,0,3236
419f9455a21eeb2b0bf6360204ee1175b62df805,0,Matt Gilman,2015-07-14 14:50:16-04:00,['3529bb33178ce70a33cc7ab21d7334ba3411048b'],0,9,9,1581362,1,,,,3236
3af73c9b824f5131eac9ea37045daec88b33a293,0,Matt Gilman,2015-07-14 14:50:16-04:00,['419f9455a21eeb2b0bf6360204ee1175b62df805'],283,451,734,1582096,15,0.911111111,1,1,3239
c4dd1e65b1be905dc712f1907ff1156e60d02a79,0,Matt Gilman,2015-07-14 14:50:16-04:00,['3af73c9b824f5131eac9ea37045daec88b33a293'],27,31,58,1582154,3,0,1,1,3239
16134a2dfedf2f05f7d798082bfd86a5a13bda5a,0,Matt Gilman,2015-07-14 14:50:17-04:00,['c4dd1e65b1be905dc712f1907ff1156e60d02a79'],5,6,11,1582165,2,0,,,3239
286e4738b8bea6e8a386b630822a897ca07410d2,1,Matt Gilman,2015-07-14 14:50:17-04:00,['16134a2dfedf2f05f7d798082bfd86a5a13bda5a'],67,656,723,1582888,13,1,0,0,3241
e7e15facc4587a7cd0862d3b8f00a280b15392fa,0,Matt Gilman,2015-07-14 14:50:17-04:00,['286e4738b8bea6e8a386b630822a897ca07410d2'],8,280,288,1583176,5,,,,3243
2a3deed573b5d44bc79a49ea4bbdc5a49d4ebecd,0,Matt Gilman,2015-07-14 14:50:17-04:00,['e7e15facc4587a7cd0862d3b8f00a280b15392fa'],2,4,6,1583182,2,,,,3243
6f3039c8c38d6af399f5a896fb7879db111ab4fe,1,Matt Gilman,2015-07-14 17:11:08-04:00,['2a3deed573b5d44bc79a49ea4bbdc5a49d4ebecd'],3,113,116,1583298,2,,,,3243
95b22713fc848005a526b3e71f7b19bb7ae1db00,0,Matt Gilman,2015-07-14 17:22:57-04:00,['6f3039c8c38d6af399f5a896fb7879db111ab4fe'],0,0,0,1583298,0,,,,3243
65c82cc0ea4ccde35b5ded34b6b84afe959f62cb,0,Aldrin Piri,2015-07-14 18:39:17-04:00,['95b22713fc848005a526b3e71f7b19bb7ae1db00'],0,0,0,1583298,0,,,,3243
ec6be9eaa3942e9ca9f8e4a1e788ab831e739514,0,Aldrin Piri,2015-07-14 18:42:06-04:00,['65c82cc0ea4ccde35b5ded34b6b84afe959f62cb'],0,0,0,1583298,0,,,,3243
00344624855f0ed215857a01593c397dd39d99ec,0,joewitt,2015-07-16 08:04:58-04:00,['ec6be9eaa3942e9ca9f8e4a1e788ab831e739514'],146,64,210,1583508,8,,,,3243
5662436b9f6a7f4403f55e7ffd81b6d26ca3cb7c,0,Matt Gilman,2015-07-16 10:48:42-04:00,"['00344624855f0ed215857a01593c397dd39d99ec', 'de8ec6f92c85970b1665765e0b11d04e486cc966']",386,385,771,1584279,129,,,,3243
adddd3fab8f1244e02e8bdcf3f775af35ab37d4a,0,Matt Gilman,2015-07-16 10:59:34-04:00,['5662436b9f6a7f4403f55e7ffd81b6d26ca3cb7c'],5,5,10,1584289,3,,,,3243
bde107d4a87eb19881feaf208df52db7dec6cda5,0,Matt Gilman,2015-07-16 11:12:55-04:00,['adddd3fab8f1244e02e8bdcf3f775af35ab37d4a'],1,1,2,1584291,1,,,,3243
54ad9c89914a265c5e8e89fdf83cd83d83a83ff5,0,Matt Gilman,2015-07-16 11:20:27-04:00,['bde107d4a87eb19881feaf208df52db7dec6cda5'],1,1,2,1584293,1,,,,3243
16cc08748d4063d3440a12f9dd3f9f248e2814ee,0,Matt Gilman,2015-07-17 09:09:43-04:00,['54ad9c89914a265c5e8e89fdf83cd83d83a83ff5'],0,19,19,1584312,1,,,,3243
d68c7ec24a4736854bd9319640af8c5113641fae,0,joewitt,2015-07-17 20:47:42-04:00,['16cc08748d4063d3440a12f9dd3f9f248e2814ee'],8,8,16,1584328,4,,,,3243
cbfe3fc31746cc0944a69731728bf227c10af9eb,0,joewitt,2015-07-18 00:41:05-04:00,['d68c7ec24a4736854bd9319640af8c5113641fae'],1,1,2,1584330,1,,,,3243
808c772c38dff01490c273a4bcc52712a995bdbd,0,joewitt,2015-07-18 00:48:14-04:00,['cbfe3fc31746cc0944a69731728bf227c10af9eb'],37,0,37,1584367,1,,,,3243
3982294ced19c6e2a253299f7880acbcb1a1c95f,0,joewitt,2015-07-18 00:50:15-04:00,['808c772c38dff01490c273a4bcc52712a995bdbd'],1,1,2,1584369,1,,,,3243
f76aeb22706fe686e0f73523f67c858335433e2d,0,joewitt,2015-07-18 00:52:30-04:00,['3982294ced19c6e2a253299f7880acbcb1a1c95f'],1,1,2,1584371,1,,,,3243
dae1b9656f36fee6c5381b9bbe8d88556bb3021e,0,joewitt,2015-07-18 01:13:40-04:00,['f76aeb22706fe686e0f73523f67c858335433e2d'],385,325,710,1585081,148,,,,3243
a8eb0c7d868648f9bb3da89fc1894ceed728ec4b,0,joewitt,2015-07-18 02:06:29-04:00,['dae1b9656f36fee6c5381b9bbe8d88556bb3021e'],40,8,48,1585129,1,,,,3243
6cac136b480bd42ecf03c99fe30e9ab519f04cfb,0,joewitt,2015-07-18 08:58:30-04:00,['a8eb0c7d868648f9bb3da89fc1894ceed728ec4b'],0,5,5,1585134,1,,,,3243
fb570ed7ef70c18444075cbfee4339b93a4a12d9,1,joewitt,2015-07-18 22:12:39-04:00,['6cac136b480bd42ecf03c99fe30e9ab519f04cfb'],248,248,496,1585630,132,,,,3243
42c07a38d4eb003e54ff89c18bb99beb474c4c0e,0,Mark Payne,2015-07-19 10:40:46-04:00,['fb570ed7ef70c18444075cbfee4339b93a4a12d9'],4,7,11,1585641,2,,,,3243
bca9acbf4f19d4b946c66571ee421a19718d21b9,0,Aldrin Piri,2015-07-19 14:20:49-04:00,['42c07a38d4eb003e54ff89c18bb99beb474c4c0e'],6,6,12,1585653,1,,,,3243
9f75cad4110ba549c7f560c72c8ad0a69101cd56,0,Matt Gilman,2015-07-19 15:08:48-04:00,['42c07a38d4eb003e54ff89c18bb99beb474c4c0e'],0,1,1,1585654,1,,,,3243
eee5a22f0daf8e35e42238f59a55a2775653197d,0,Matt Gilman,2015-07-19 15:24:59-04:00,"['9f75cad4110ba549c7f560c72c8ad0a69101cd56', 'bca9acbf4f19d4b946c66571ee421a19718d21b9']",6,6,12,1585666,1,,,,3243
a19390cdecfd85f1b165f95cb4901b9366e627a0,0,Matt Gilman,2015-07-20 09:46:58-04:00,['eee5a22f0daf8e35e42238f59a55a2775653197d'],6,10,16,1585682,1,1,1,0,3243
dcd9739bc36f1ba73d27b4bcb1c7158bcd9da5cd,1,Mark Payne,2015-07-20 11:25:36-04:00,['a19390cdecfd85f1b165f95cb4901b9366e627a0'],0,56,56,1585738,2,0.05,1,1,3244
bddb8b1fe568d8e1e181d007666fa262a8a19b96,1,Bryan Bende,2015-07-20 11:44:43-04:00,['dcd9739bc36f1ba73d27b4bcb1c7158bcd9da5cd'],5,17,22,1585760,2,,,,3244
5b47f52f62284f35506fd55a672915a4003a60a4,0,Bryan Bende,2015-07-21 08:18:54-04:00,['bddb8b1fe568d8e1e181d007666fa262a8a19b96'],0,23,23,1585783,1,,,,3244
133649b4b4001f55dcb8cd756c461ad9cc5fc264,0,Aldrin Piri,2015-07-21 14:46:53-07:00,['5b47f52f62284f35506fd55a672915a4003a60a4'],1,1,2,1585785,1,,,,3244
c0144f23a34f975febbfccc361f80ccfaea840cd,1,Bryan Bende,2015-07-22 15:04:26-04:00,['133649b4b4001f55dcb8cd756c461ad9cc5fc264'],0,11,11,1585796,1,,,,3244
cafddb6568818cdb669472f56fe4702c04809a7b,0,joewitt,2015-07-23 08:56:03-07:00,['c0144f23a34f975febbfccc361f80ccfaea840cd'],0,2,2,1585798,1,,,,3244
712d60700c46f06e6df6ca10d8eb93cafa5ddd76,0,joewitt,2015-07-23 09:25:45-07:00,['e4f51eac9d1b9eabbb091a9f2c3eb1fee453cfc6'],315,259,574,1586372,133,,,,3244
106d5dbdc562083b441831e8259c3d0dca063710,0,joewitt,2015-07-23 09:31:58-07:00,['712d60700c46f06e6df6ca10d8eb93cafa5ddd76'],19,19,38,1586410,6,,,,3244
8d0b1ef1f590f67ad81a3e0972ef2496ce26c5bd,0,joewitt,2015-07-23 09:32:17-07:00,['106d5dbdc562083b441831e8259c3d0dca063710'],6,10,16,1586426,1,1,1,0,3244
08cd40ddcbee21b7a7d9ff5980264a2b4ee5f1f3,0,joewitt,2015-07-23 10:09:27-07:00,['8d0b1ef1f590f67ad81a3e0972ef2496ce26c5bd'],241,245,486,1586912,129,,,,3244
3a75b3e8bd4f9bdfe815a67fcaa7a5f8a1f06183,0,joewitt,2015-07-23 10:09:39-07:00,['08cd40ddcbee21b7a7d9ff5980264a2b4ee5f1f3'],246,241,487,1587399,129,,,,3244
a1af29eca06fa56903ca2fa28945a0f922d6e8e9,0,Brian Ghigiarelli,2015-07-23 21:43:06-04:00,"['97f33d5c51dfd5178c10ad88fb3701f363ae39a4', 'cafddb6568818cdb669472f56fe4702c04809a7b']",1102,8056,9158,1596557,289,,,,3244
4a43e81343b4eaf967a7e5a5417fd7bb35226503,1,Brian Ghigiarelli,2015-07-23 22:52:35-04:00,['a1af29eca06fa56903ca2fa28945a0f922d6e8e9'],11,28,39,1596596,1,1,1,1,3244
85079020967918a5afeb4eba8c9e6e99766a1718,1,Brian Ghigiarelli,2015-07-24 15:26:22-04:00,['4a43e81343b4eaf967a7e5a5417fd7bb35226503'],9,15,24,1596620,1,,,,3244
f26e1432f1a284c3e50e851dfb1ec94752f9d1de,0,Aldrin Piri,2015-07-26 00:34:24-04:00,['cafddb6568818cdb669472f56fe4702c04809a7b'],1,1,2,1596622,1,,,,3244
6e3ec1b8c488486729a094be0f39a9b2adac1c2f,0,joewitt,2015-07-26 22:36:04-04:00,"['de8ec6f92c85970b1665765e0b11d04e486cc966', '3a75b3e8bd4f9bdfe815a67fcaa7a5f8a1f06183']",354,305,659,1597281,140,,,,3244
354ce9c8882c871453083b2654dc412cd8af089d,0,joewitt,2015-07-27 00:18:08-04:00,['f26e1432f1a284c3e50e851dfb1ec94752f9d1de'],0,18,18,1597299,1,,,,3244
c541728e0f7304b3429463ab02a222b203d48f5c,0,joewitt,2015-07-28 01:12:55-04:00,['354ce9c8882c871453083b2654dc412cd8af089d'],1,2,3,1597302,1,,,,3244
fba3c3705f79e9cae515947264db38bbbdeac457,0,Mark Payne,2015-07-29 09:12:04-04:00,['c541728e0f7304b3429463ab02a222b203d48f5c'],0,16,16,1597318,1,,,,3244
75ed16c8fe17ffa5041e57192a5783f004965810,0,Mark Payne,2015-07-29 09:34:08-04:00,['fba3c3705f79e9cae515947264db38bbbdeac457'],7,67,74,1597392,1,,,,3244
82a79f197107534776d34a53d874c97cefd395b0,0,Matt Gilman,2015-07-30 22:57:56-04:00,['75ed16c8fe17ffa5041e57192a5783f004965810'],1,1,2,1597394,1,,,,3244
3dd6b24ceb954afabb6e49ae5090e5915813dfd3,1,Mark Payne,2015-07-31 09:01:35-04:00,['75ed16c8fe17ffa5041e57192a5783f004965810'],78,127,205,1597599,3,1,1,1,3245
bf84ce6608a8ea70d465228d728774b092dbb193,0,Mark Payne,2015-07-31 09:18:30-04:00,"['3dd6b24ceb954afabb6e49ae5090e5915813dfd3', '82a79f197107534776d34a53d874c97cefd395b0']",1,1,2,1597601,1,,,,3245
496ebfb3be78bf47c0aa957a3f44fdc76e488e5a,0,Mark Payne,2015-07-31 09:55:08-04:00,['bf84ce6608a8ea70d465228d728774b092dbb193'],1,4,5,1597606,1,0,1,1,3245
34e08ba7752a8543df4155951d57cb432ed2fc63,1,Mark Payne,2015-08-03 08:43:18-04:00,['496ebfb3be78bf47c0aa957a3f44fdc76e488e5a'],8,238,246,1597852,4,0.049689441,0.161490683,0.98136646,3245
90ebc3a91ef6873a884cce6730d229d6700f0cef,0,joewitt,2015-08-03 23:32:48-04:00,['496ebfb3be78bf47c0aa957a3f44fdc76e488e5a'],376,374,750,1598602,18,,,,3245
6a0a321b64568c70e417b78b2c52ab39af1c3d63,1,Mark Payne,2015-08-04 08:54:03-04:00,['496ebfb3be78bf47c0aa957a3f44fdc76e488e5a'],80,294,374,1598976,5,0.113207547,0.113207547,0.877358491,3245
2600877080b4ae8beedf0fc2060577c83627cded,0,Mark Payne,2015-08-04 08:54:28-04:00,"['6a0a321b64568c70e417b78b2c52ab39af1c3d63', '90ebc3a91ef6873a884cce6730d229d6700f0cef']",376,374,750,1599726,18,,,,3245
15d49025f21a3263fab797c758c2f95bc18df2b4,0,Mark Payne,2015-08-04 08:55:47-04:00,"['34e08ba7752a8543df4155951d57cb432ed2fc63', '2600877080b4ae8beedf0fc2060577c83627cded']",458,669,1127,1600853,24,,,,3245
e59ee5dda18bda9184e7eac211517ced181d1508,0,Mark Payne,2015-08-04 14:37:54-04:00,['15d49025f21a3263fab797c758c2f95bc18df2b4'],17,44,61,1600914,1,0,0.444444444,1,3245
4b9ee460a8ea67ceff89b6dc9ecbb7d06f596c21,0,Mark Payne,2015-08-06 11:55:08-04:00,['e59ee5dda18bda9184e7eac211517ced181d1508'],64,34,98,1601012,1,1,0.153846154,0.769230769,3245
33279fd9d7f93f23137e8259febf709f50306012,1,Mark Payne,2015-08-08 15:52:49-04:00,['4b9ee460a8ea67ceff89b6dc9ecbb7d06f596c21'],4,2,6,1601018,1,1,1,0,3245
e5fa763458b1dd07585e1b0ec7b8c52340f2fdf8,1,Mark Payne,2015-08-10 13:44:15-04:00,['33279fd9d7f93f23137e8259febf709f50306012'],12,117,129,1601147,2,,,,3245
6a7a4d0762f7f5fd306f8def019ee904180043d7,1,Mark Payne,2015-08-10 17:31:44-04:00,['33279fd9d7f93f23137e8259febf709f50306012'],10,29,39,1601186,2,0,1,1,3245
7cd84967dd90a122aaeede30b3b640f3591ebdee,0,Mark Payne,2015-08-10 17:32:38-04:00,['33279fd9d7f93f23137e8259febf709f50306012'],1,2,3,1601189,1,1,1,1,3245
82e421a18328de893a444e066d4f23af46398e12,0,Mark Payne,2015-08-10 20:03:28-04:00,"['e5fa763458b1dd07585e1b0ec7b8c52340f2fdf8', '7cd84967dd90a122aaeede30b3b640f3591ebdee']",1,2,3,1601192,1,,,,3245
d328ca0a48f23e770e9ef08f342413c66237440e,0,Mark Payne,2015-08-10 20:04:10-04:00,"['82e421a18328de893a444e066d4f23af46398e12', '6a7a4d0762f7f5fd306f8def019ee904180043d7']",10,29,39,1601231,2,,,,3245
c2c513e51122bf09d0f7cb717a59272c305341d6,0,Mark Payne,2015-08-11 08:55:04-04:00,['d328ca0a48f23e770e9ef08f342413c66237440e'],1,2,3,1601234,1,0,0,1,3245
bbacc3d8caf55a7773797208cc744debd11cf1bc,0,Mark Payne,2015-08-12 09:59:50-04:00,"['c2c513e51122bf09d0f7cb717a59272c305341d6', '85079020967918a5afeb4eba8c9e6e99766a1718']",11,34,45,1601279,1,,,,3245
b31c76bf30f847842e3ef1c6f928b2e93f517b34,1,Bryan Bende,2015-08-12 10:30:30-04:00,['bbacc3d8caf55a7773797208cc744debd11cf1bc'],1,313,314,1601593,5,0.18226601,0.571428571,0.477832512,3247
0a279ff538a69709e97285ad4c9b8de01bd68627,0,Matt Gilman,2015-08-12 12:59:58-04:00,['b31c76bf30f847842e3ef1c6f928b2e93f517b34'],121,655,776,1602369,16,0,0.890995261,0.260663507,3248
91f4dae0605130ecaf38f4712937c6ebdfa59f0d,0,Matt Gilman,2015-08-12 13:33:47-04:00,['0a279ff538a69709e97285ad4c9b8de01bd68627'],1,1,2,1602371,1,,,,3248
103153cdd8ba253fb083a5f71ea2437a2767ff0d,0,Matt Gilman,2015-08-12 14:24:21-04:00,['91f4dae0605130ecaf38f4712937c6ebdfa59f0d'],4,0,4,1602375,2,,,,3248
c6d500b3157ed7158fbaa5aa2a51549741328958,0,Aldrin Piri,2015-08-12 18:17:08-04:00,['103153cdd8ba253fb083a5f71ea2437a2767ff0d'],2,2,4,1602379,1,,,,3248
13042dc2e901442b873709fa4ab443b1342e7b35,0,Aldrin Piri,2015-08-12 23:22:30-04:00,['c6d500b3157ed7158fbaa5aa2a51549741328958'],2,2,4,1602383,1,,,,3248
b51433e97c5b51b0e8f35450c3e4265fd747f51a,0,Aldrin Piri,2015-08-12 23:29:54-04:00,['13042dc2e901442b873709fa4ab443b1342e7b35'],5,8,13,1602396,1,,,,3248
c169bedbfdbb236edab59b3943c106a3f617beaa,0,Mark Payne,2015-08-13 11:45:33-04:00,['103153cdd8ba253fb083a5f71ea2437a2767ff0d'],1,0,1,1602397,1,,,,3248
5962404379fce200e82651e6dbfcab9dad0532fb,0,Mark Payne,2015-08-13 12:08:01-04:00,"['c169bedbfdbb236edab59b3943c106a3f617beaa', 'b51433e97c5b51b0e8f35450c3e4265fd747f51a']",9,12,21,1602418,3,,,,3248
1eeed730103e5c231b27365eda9aec25ec2c8e12,0,Mark Payne,2015-08-14 09:35:06-04:00,['5962404379fce200e82651e6dbfcab9dad0532fb'],0,10,10,1602428,1,0,1,1,3248
e9c2535df73ab72d7a20f9dc2f27ae2bd6ad02e5,0,Mark Payne,2015-08-14 10:07:20-04:00,['5962404379fce200e82651e6dbfcab9dad0532fb'],11,8,19,1602447,1,0,0,0,3248
a4f0afce7b8ad3023a7454c7d32701592aae174a,0,Mark Payne,2015-08-14 10:08:20-04:00,"['1eeed730103e5c231b27365eda9aec25ec2c8e12', 'e9c2535df73ab72d7a20f9dc2f27ae2bd6ad02e5']",11,8,19,1602466,1,,,,3248
6fc52a4e9977cc219430f5c8e0e7aa41f7043066,1,Bryan Bende,2015-08-14 11:00:21-04:00,['a4f0afce7b8ad3023a7454c7d32701592aae174a'],0,535,535,1603001,13,1,1,1,3260
aa99884782e54c54ee138f5609b3be84628e96f9,1,joewitt,2015-08-15 13:12:22-04:00,['6fc52a4e9977cc219430f5c8e0e7aa41f7043066'],5896,480,6376,1609377,2873,0.705752212,0.066371681,0.017699115,3260
cd745191330f8b153fee47ba82dcf9fcb149daf9,0,joewitt,2015-08-16 15:56:46-04:00,"['6e3ec1b8c488486729a094be0f39a9b2adac1c2f', 'aa99884782e54c54ee138f5609b3be84628e96f9']",6739,7648,14387,1623764,2876,,,,3260
3e7fe93fdb7e4253e3bfa30bd2dcdd58fb64e525,0,joewitt,2015-08-16 16:25:56-04:00,['cd745191330f8b153fee47ba82dcf9fcb149daf9'],6,0,6,1623770,1,,,,3260
a837fa5f38973896b225dde07aefa2f44ed6a50c,0,joewitt,2015-08-16 22:42:28-04:00,['3e7fe93fdb7e4253e3bfa30bd2dcdd58fb64e525'],5,6,11,1623781,4,,,,3260
6066557e667f0f86593f3eb351f06fcbe517c62d,0,joewitt,2015-08-17 09:16:34-04:00,['a837fa5f38973896b225dde07aefa2f44ed6a50c'],1,4,5,1623786,1,,,,3260
c0dad8d1d881d3e6d21f63c4559f9157634dbbc4,1,Aldrin Piri,2015-08-17 10:46:13-04:00,['6066557e667f0f86593f3eb351f06fcbe517c62d'],2,20,22,1623808,1,,,,3260
740b09b182a2b5f2c8530336df6c7c788e73700d,1,Aldrin Piri,2015-08-17 11:51:10-04:00,['c0dad8d1d881d3e6d21f63c4559f9157634dbbc4'],2,2,4,1623812,1,,,,3260
ffa7ceb2b1e761e5ed1157058ebd9b74c5e54078,0,Matt Gilman,2015-08-17 15:23:36-04:00,['740b09b182a2b5f2c8530336df6c7c788e73700d'],1,1,2,1623814,1,,,,3260
1c34478eb8304c81919e2929ca6d0889fe93006b,1,Bryan Bende,2015-08-17 15:47:49-04:00,['740b09b182a2b5f2c8530336df6c7c788e73700d'],1,1128,1129,1624943,19,0.374251497,0.889221557,1,3275
a264c49d80a5c967bcb5d03677bbd36c4c1e6d49,0,Bryan Bende,2015-08-17 17:33:26-04:00,"['ffa7ceb2b1e761e5ed1157058ebd9b74c5e54078', '1c34478eb8304c81919e2929ca6d0889fe93006b']",1,1128,1129,1626072,19,,,,3275
35439db347a05376e29c65363cbe47a122ce840c,1,Mark Payne,2015-08-18 20:06:41-04:00,['a264c49d80a5c967bcb5d03677bbd36c4c1e6d49'],138,165,303,1626375,1,0.125,0,1,3275
c3731703f397574399e14a7b1589bda9e9177fd9,0,Mark Payne,2015-08-18 20:06:42-04:00,['35439db347a05376e29c65363cbe47a122ce840c'],248,260,508,1626883,1,,,,3275
8e5347156f5e96d912be58a6a60a54a7a93a1faf,0,Mark Payne,2015-08-18 20:06:42-04:00,['c3731703f397574399e14a7b1589bda9e9177fd9'],8,13,21,1626904,1,,,,3275
8f98f8093868e0ed2fb1dfbe3947f1afc1bdd10b,1,Chin Huang,2015-08-18 21:35:28-07:00,['8e5347156f5e96d912be58a6a60a54a7a93a1faf'],1,21,22,1626926,5,0.444444444,1,1,3275
e409b6c5c10626fdd8c817793dca3d82638f4696,1,Mark Payne,2015-08-19 08:55:15-04:00,['8e5347156f5e96d912be58a6a60a54a7a93a1faf'],73,226,299,1627225,6,0.373134328,0,1,3275
f171756a8891433f620d549b622e278baf2c954a,1,Mark Payne,2015-08-19 10:12:57-04:00,['e409b6c5c10626fdd8c817793dca3d82638f4696'],3,115,118,1627343,4,0.884615385,0.884615385,1,3277
f044ba5d45150a0d17990b4c1a304fbbdf35a010,1,Aldrin Piri,2015-08-19 12:00:25-04:00,['f171756a8891433f620d549b622e278baf2c954a'],2,54,56,1627399,2,0.92,0.96,1,3277
19f7db69863f26fae8eb98b08300a31dcf7cb8cc,1,Mark Payne,2015-08-19 12:24:25-04:00,['f171756a8891433f620d549b622e278baf2c954a'],25,127,152,1627551,6,0.121621622,0.121621622,0.283783784,3277
e345218eaa3448b9f67f48d39b3ce8a077400ce8,0,Mark Payne,2015-08-19 12:27:41-04:00,"['19f7db69863f26fae8eb98b08300a31dcf7cb8cc', 'f044ba5d45150a0d17990b4c1a304fbbdf35a010']",2,54,56,1627607,2,,,,3277
8ebf1f03c212f7d38e83cd72e1373bfd1d8703f0,0,Mark Payne,2015-08-19 12:56:26-04:00,"['e345218eaa3448b9f67f48d39b3ce8a077400ce8', '8f98f8093868e0ed2fb1dfbe3947f1afc1bdd10b']",1,21,22,1627629,5,,,,3277
16dc5d5fd9a1538880312fea9438e0f00e4b7538,1,Mark Payne,2015-08-19 13:53:13-04:00,['8ebf1f03c212f7d38e83cd72e1373bfd1d8703f0'],19,243,262,1627891,4,0.28057554,0.525179856,0.589928058,3277
1a37c95f5883cdca858c175a637c67d5f012908c,1,Mark Payne,2015-08-19 17:36:29-04:00,['16dc5d5fd9a1538880312fea9438e0f00e4b7538'],0,1389,1389,1629280,11,0.182619647,0.583123426,0.744332494,3285
28549c2b1e8970ce8be68e1907830e85676c42a3,1,Mark Payne,2015-08-19 17:36:29-04:00,['1a37c95f5883cdca858c175a637c67d5f012908c'],1343,2738,4081,1633361,17,0.111638955,0.640142518,0.954869359,3292
0410c1b7aa958e29aa1607e925763c4d0127638f,1,Mark Payne,2015-08-19 19:56:46-04:00,['16dc5d5fd9a1538880312fea9438e0f00e4b7538'],4,140,144,1633505,4,0.448979592,1,0.857142857,3293
d94f7f0b5895688b2f872abe4f0baee7d7f13352,0,Mark Payne,2015-08-19 19:56:56-04:00,"['28549c2b1e8970ce8be68e1907830e85676c42a3', '0410c1b7aa958e29aa1607e925763c4d0127638f']",4,140,144,1633649,4,,,,3293
4f921931599f29e1554ca44b106cccf45fc85e22,0,joewitt,2015-08-19 20:11:01-04:00,['d94f7f0b5895688b2f872abe4f0baee7d7f13352'],4,61,65,1633714,3,1,1,1,3293
3cca0465508b8b821678ca77f547a3c2589667d5,1,Bryan Bende,2015-08-19 20:42:27-04:00,['4f921931599f29e1554ca44b106cccf45fc85e22'],5,88,93,1633807,1,0,0.565217391,0.47826087,3293
706edeb01fad32aca2dce280bde16f1926e2f76c,0,Bryan Bende,2015-08-19 20:57:57-04:00,['3cca0465508b8b821678ca77f547a3c2589667d5'],49,294,343,1634150,4,0.778761062,0.566371681,0.902654867,3296
d992730fb79fb689db4353de3ce823ea92c2324a,1,Matt Gilman,2015-08-21 08:56:41-04:00,['706edeb01fad32aca2dce280bde16f1926e2f76c'],0,1020,1020,1635170,19,0.466135458,0.717131474,0.93625498,3311
dedff148caa8536fe1c6c06a4b4aba4d4d6f1736,0,Matt Gilman,2015-08-21 08:56:41-04:00,['d992730fb79fb689db4353de3ce823ea92c2324a'],11,28,39,1635209,2,0.75,0,0.833333333,3311
b17be66a104b79fd9883c0ce2fade713877c56a8,0,Matt Gilman,2015-08-21 08:56:42-04:00,['dedff148caa8536fe1c6c06a4b4aba4d4d6f1736'],26,13,39,1635248,2,0,1,0,3311
d421e3c2424b224522e9e5a83f014ccda2496739,1,Bryan Bende,2015-08-21 11:06:20-04:00,['b17be66a104b79fd9883c0ce2fade713877c56a8'],18,63,81,1635329,2,1,1,1,3311
68d94cc01b59187e71f32624c5251d332d39e8ab,1,Mark Payne,2015-08-21 11:08:34-04:00,['706edeb01fad32aca2dce280bde16f1926e2f76c'],1052,1406,2458,1637787,25,1,1,1,3314
15a8699dc49d6d5ac4a450f3eaea52def7addb63,1,Mark Payne,2015-08-21 11:08:34-04:00,['68d94cc01b59187e71f32624c5251d332d39e8ab'],83,46,129,1637916,6,0,0,1,3314
4f6c1cfff3eda2f4878e978c2d0e64101b691db7,0,Mark Payne,2015-08-21 11:29:20-04:00,"['15a8699dc49d6d5ac4a450f3eaea52def7addb63', 'd421e3c2424b224522e9e5a83f014ccda2496739']",18,1087,1105,1639021,21,,,,3314
82d32230e6fa528694322adcfe8e77450c89136e,1,Aldrin Piri,2015-08-21 11:35:30-04:00,['4f6c1cfff3eda2f4878e978c2d0e64101b691db7'],15,57,72,1639093,1,0.5625,0.5625,1,3314
1ddd73655878a146cd99d2fd2746504fe33acee5,1,Mark Payne,2015-08-21 14:46:20-04:00,['82d32230e6fa528694322adcfe8e77450c89136e'],14,42,56,1639149,2,0.2,0.2,0,3314
1f6805f06d39410c64b47447a36945afbd16229b,0,joewitt,2015-08-21 15:40:26-04:00,['1ddd73655878a146cd99d2fd2746504fe33acee5'],1,2,3,1639152,1,,,,3314
d351f3ed1b80e8bb1ec5a078bdde2d36dbc7f088,0,Mark Payne,2015-08-21 15:55:04-04:00,['1ddd73655878a146cd99d2fd2746504fe33acee5'],1,35,36,1639188,1,0,0.037037037,1,3314
0931c6b0d6f12baf9b7c24b45c9a61c8eca25197,1,Bryan Bende,2015-08-21 16:40:37-04:00,['1f6805f06d39410c64b47447a36945afbd16229b'],5,4,9,1639197,1,,,,3314
a9c2bf58b80ad94428d33cc014f11c8c7875592b,1,Mark Payne,2015-08-21 17:11:56-04:00,['4f6c1cfff3eda2f4878e978c2d0e64101b691db7'],59,561,620,1639817,15,0.378947368,0.568421053,0.894736842,3323
e8248353df5316320c6c74f65c0e505dd4730371,0,Mark Payne,2015-08-21 17:13:43-04:00,"['0931c6b0d6f12baf9b7c24b45c9a61c8eca25197', 'd351f3ed1b80e8bb1ec5a078bdde2d36dbc7f088']",1,35,36,1639853,1,,,,3323
671445f10a0debfd9deba9e3444a67f84d701cfe,0,Mark Payne,2015-08-21 17:15:39-04:00,"['e8248353df5316320c6c74f65c0e505dd4730371', 'a9c2bf58b80ad94428d33cc014f11c8c7875592b']",59,561,620,1640473,15,,,,3323
4d4f74cf054d1072d9057cabd5a4231b045fafd5,0,Mark Payne,2015-08-22 20:47:45-04:00,['671445f10a0debfd9deba9e3444a67f84d701cfe'],0,1,1,1640474,1,1,1,1,3323
6f8eb9f5e3c96991bcd521bac3a4a2015e4a8908,0,Matt Gilman,2015-08-23 12:32:52-04:00,['4d4f74cf054d1072d9057cabd5a4231b045fafd5'],4,4,8,1640482,3,,,,3323
df1066d2ed381220a760e62bd671730f703dca13,0,joewitt,2015-08-23 22:42:32-04:00,['6f8eb9f5e3c96991bcd521bac3a4a2015e4a8908'],2,2,4,1640486,1,,,,3323
b30fbe1f3bb2996e048112482cae51c9deedfd20,0,Aldrin Piri,2015-08-23 23:07:26-04:00,['df1066d2ed381220a760e62bd671730f703dca13'],108,143,251,1640737,1,0,0,0.771428571,3323
c7f770422029b56690a39bb28b464d91b10eeb8c,0,Aldrin Piri,2015-08-23 23:07:50-04:00,['b30fbe1f3bb2996e048112482cae51c9deedfd20'],96,67,163,1640900,1,1,0.666666667,0.333333333,3323
3bfe830afc363d70925cecca4472ae34da6795bb,0,Bryan Bende,2015-08-24 12:00:21-04:00,['c7f770422029b56690a39bb28b464d91b10eeb8c'],8,74,82,1640982,4,0.648148148,0.555555556,1,3323
7fb6e884a72acfd32c97b96058909c0cf6434061,1,Bryan Bende,2015-08-24 15:36:22-04:00,['c7f770422029b56690a39bb28b464d91b10eeb8c'],78,206,284,1641266,6,0.324675325,1,0.623376623,3323
58aedd785dc727b61ce9f789f4216e0eb375c8d9,0,Bryan Bende,2015-08-24 15:38:30-04:00,['7fb6e884a72acfd32c97b96058909c0cf6434061'],0,0,0,1641266,0,,,,3323
310347fd6608f3f23318afff5bfed9c4f94c842d,0,Bryan Bende,2015-08-24 18:58:56-04:00,"['58aedd785dc727b61ce9f789f4216e0eb375c8d9', '3bfe830afc363d70925cecca4472ae34da6795bb']",8,74,82,1641348,4,,,,3323
4baffacc42d1201e4cbdbcb1601bfa810a2e9267,0,Mark Payne,2015-08-25 09:58:37-04:00,['310347fd6608f3f23318afff5bfed9c4f94c842d'],2,38,40,1641388,2,0,0.923076923,0.923076923,3323
f34d73e73e2216c15e0a10df7092287df665a001,0,Bryan Bende,2015-08-26 11:21:08-04:00,['4baffacc42d1201e4cbdbcb1601bfa810a2e9267'],0,1,1,1641389,1,0,1,1,3323
d39848f06eff3fa6c53a6632ccb8a9b67c60582f,0,Bryan Bende,2015-08-27 10:06:02-04:00,['f34d73e73e2216c15e0a10df7092287df665a001'],0,31,31,1641420,1,0.32,0.32,1,3323
fbec28bad93a1263b2fe4da74ec597c0d35996fe,1,Mark Payne,2015-08-27 15:17:55-04:00,['4baffacc42d1201e4cbdbcb1601bfa810a2e9267'],7,136,143,1641563,2,0.101123596,0.898876404,1,3323
9cefc4a5a54adf63bf4eb67c4b8211f2a2b5dd14,1,ricky,2015-08-27 15:26:56-04:00,['d39848f06eff3fa6c53a6632ccb8a9b67c60582f'],53,166,219,1641782,6,0.677419355,1,0.483870968,3324
76b5b38cc478ef362a8dcc7394c1b9c071e21942,0,Mark Payne,2015-08-27 17:34:27-04:00,"['d39848f06eff3fa6c53a6632ccb8a9b67c60582f', 'fbec28bad93a1263b2fe4da74ec597c0d35996fe']",7,136,143,1641925,2,,,,3324
85cb5dd1e7dd324268f60d10ae922d66f11e1369,0,joewitt,2015-08-27 23:22:41-04:00,['d39848f06eff3fa6c53a6632ccb8a9b67c60582f'],0,1,1,1641926,1,0,1,0,3324
5de37f63d920e63d001eaa479e5f9164923ec78a,0,Mark Payne,2015-08-28 10:04:58-04:00,['76b5b38cc478ef362a8dcc7394c1b9c071e21942'],11,51,62,1641988,3,0.121212121,0.696969697,1,3324
3159cec7825a4085898b64f29a0dc4cc7d803f17,1,Mark Payne,2015-08-28 14:15:35-04:00,['85cb5dd1e7dd324268f60d10ae922d66f11e1369'],29,57,86,1642074,1,0.444444444,0.611111111,1,3324
a8b063d61b1646d595a8f4ea5a54ea7867292779,0,Mark Payne,2015-08-30 19:48:19-04:00,['5de37f63d920e63d001eaa479e5f9164923ec78a'],1,28,29,1642103,1,,,,3324
c68da68dc2867f991808f3c34404af15e872a83d,0,Mark Payne,2015-08-30 19:48:27-04:00,"['85cb5dd1e7dd324268f60d10ae922d66f11e1369', 'a8b063d61b1646d595a8f4ea5a54ea7867292779']",19,215,234,1642337,5,,,,3324
f8c216b0617068995aa7a4575cd6298f0e59378d,1,Mark Payne,2015-08-31 10:50:00-04:00,['c68da68dc2867f991808f3c34404af15e872a83d'],2,7,9,1642346,1,0,1,1,3324
2bb7853001c680b54282c0720ceba4ae9c477556,0,Mark Payne,2015-08-31 11:14:17-04:00,"['f8c216b0617068995aa7a4575cd6298f0e59378d', '3159cec7825a4085898b64f29a0dc4cc7d803f17']",29,57,86,1642432,1,,,,3324
c72fb201d52113a16b176be3e0337b4303124244,1,ricky,2015-08-31 14:38:15-04:00,['2bb7853001c680b54282c0720ceba4ae9c477556'],38,111,149,1642581,5,0.930232558,0.651162791,0.697674419,3324
cd2e1424cb3ccd975d87193603669269899aac2a,1,Matt Gilman,2015-08-31 14:58:38-04:00,['2bb7853001c680b54282c0720ceba4ae9c477556'],4,43,47,1642628,2,1,1,1,3324
e4e263c292677b8749b2729a86bc00734dcaee2e,0,Mark Payne,2015-08-31 15:18:33-04:00,['cd2e1424cb3ccd975d87193603669269899aac2a'],2,3,5,1642633,1,1,1,1,3324
d1dbd37629baeb9a1570f47f7583d07f54b38b5c,1,Yuu ISHIKAWA,2015-09-01 22:35:11+09:00,['e4e263c292677b8749b2729a86bc00734dcaee2e'],0,246,246,1642879,3,0.735849057,1,1,3326
7e6834937b01f035666b113a6c2735e4156ea4f3,0,Yuu ISHIKAWA,2015-09-01 22:36:50+09:00,['d1dbd37629baeb9a1570f47f7583d07f54b38b5c'],2,2,4,1642883,1,,,,3326
6cbc6db860d730954ce8cadc56b6d8446fe085d8,0,Yuu ISHIKAWA,2015-09-02 06:49:46+09:00,['7e6834937b01f035666b113a6c2735e4156ea4f3'],9,0,9,1642892,1,0,0,0,3326
213f507f53b3afa3eef3398ebdd3006fa1cbe292,0,Yu ISHIKAWA,2015-09-02 13:02:39+09:00,['6cbc6db860d730954ce8cadc56b6d8446fe085d8'],0,2,2,1642894,1,,,,3326
0334f04640c7ae0b070214df7e356b2b05a8051c,1,Yu ISHIKAWA,2015-09-02 13:48:39+09:00,['213f507f53b3afa3eef3398ebdd3006fa1cbe292'],9,42,51,1642945,3,0.571428571,1,1,3326
c492a1aaae14efae3506ae43979fb93ba6655438,0,Yuu ISHIKAWA,2015-09-02 21:54:02+09:00,['0334f04640c7ae0b070214df7e356b2b05a8051c'],1,1,2,1642947,1,,,,3326
72ccc252fe118c51ccd3ddb6cba7df6b3d85397a,0,Mark Payne,2015-09-04 12:22:19-04:00,['e4e263c292677b8749b2729a86bc00734dcaee2e'],12,44,56,1643003,2,1,1,1,3327
85534ca860b6e0169a7d66c99ac3f293031ccbbc,1,Bryan Bende,2015-09-06 13:22:07-04:00,['72ccc252fe118c51ccd3ddb6cba7df6b3d85397a'],4,10,14,1643017,1,0,0,1,3327
d1206fe0742d0c560de546ae6033f0f473bd2f7a,1,Matt Gilman,2015-09-07 08:41:47-04:00,['85534ca860b6e0169a7d66c99ac3f293031ccbbc'],0,40,40,1643057,1,0.615384615,0.615384615,0.615384615,3327
d32a32a92d29707d22899862594a2679d3fb2273,1,Yu ISHIKAWA,2015-09-07 23:32:48+09:00,['c492a1aaae14efae3506ae43979fb93ba6655438'],27,2,29,1643086,2,0.466666667,0,0,3327
f718b4bf46f441fde2f02065b6d55ac294fe60ce,1,Yu ISHIKAWA,2015-09-07 23:34:22+09:00,['d32a32a92d29707d22899862594a2679d3fb2273'],1,1,2,1643088,1,,,,3327
a9f4b6ca7afb92a98486d040452c60631e0191b6,0,Matt Gilman,2015-09-09 11:19:13-04:00,['d1206fe0742d0c560de546ae6033f0f473bd2f7a'],1,1,2,1643090,1,,,,3327
3b675e99e31962a424422aa1d6982ef6182c73b9,0,Matt Gilman,2015-09-09 11:21:36-04:00,['a9f4b6ca7afb92a98486d040452c60631e0191b6'],0,0,0,1643090,0,,,,3327
690e674a0d5c578960aa24506bfc9503be295cb8,0,Matt Gilman,2015-09-09 13:45:56-04:00,['3b675e99e31962a424422aa1d6982ef6182c73b9'],1,21,22,1643112,2,,,,3327
47e9a3cdee58bf0187c2a461520926275319782e,0,Matt Gilman,2015-09-09 13:45:56-04:00,['690e674a0d5c578960aa24506bfc9503be295cb8'],9,10,19,1643131,1,,,,3327
59b7a71c8abae1f64bb64446327b9ad85b252ea6,0,Matt Gilman,2015-09-09 13:45:56-04:00,['47e9a3cdee58bf0187c2a461520926275319782e'],7,7,14,1643145,2,,,,3327
9dae76b9c4aba55cbec9d75cf1af406da10461ee,0,Matt Gilman,2015-09-09 15:09:33-04:00,['59b7a71c8abae1f64bb64446327b9ad85b252ea6'],0,24,24,1643169,1,,,,3327
a83ed34f91432de22552b8ab1abfd7791fbb4412,0,Matt Gilman,2015-09-10 12:05:47-04:00,['9dae76b9c4aba55cbec9d75cf1af406da10461ee'],53,53,106,1643275,15,,,,3327
eb1d6b554cc589d7a62b4bf452bf4ebfbad1f8ff,0,Yu ISHIKAWA,2015-09-11 18:05:20+09:00,['f718b4bf46f441fde2f02065b6d55ac294fe60ce'],9,1,10,1643285,1,,,,3327
291e65c6ef2157453e86f14853c8e6679e8ef085,1,Matt Gilman,2015-09-11 10:17:33-04:00,['a83ed34f91432de22552b8ab1abfd7791fbb4412'],0,25,25,1643310,1,,,,3327
3780159d012e0a5c8693c690a0f4c06cb1ce4c7c,1,Mark Payne,2015-09-11 12:50:39-04:00,['291e65c6ef2157453e86f14853c8e6679e8ef085'],9,79,88,1643398,2,0,1,1,3327
4a7d1fe618b38d214c0ac11ffd2fcdca02026da6,1,Mark Payne,2015-09-11 14:55:48-04:00,['3780159d012e0a5c8693c690a0f4c06cb1ce4c7c'],144,190,334,1643732,1,0.5,0.5625,1,3327
992e84102786b9e2f0cf906b55243779e1707c10,1,Mark Payne,2015-09-13 19:55:12-04:00,['4a7d1fe618b38d214c0ac11ffd2fcdca02026da6'],49,1561,1610,1645342,17,0.425493716,0.617594255,0.822262118,3338
3d4ce34529533ff801a2febae7e669248cb80324,1,Mark Payne,2015-09-14 11:47:02-04:00,['992e84102786b9e2f0cf906b55243779e1707c10'],1,33,34,1645376,2,0.666666667,0.666666667,1,3338
2ec735e35025fed3c63d51128ec0609ffe1fa7e3,1,Matt Gilman,2015-09-14 21:48:00-04:00,['3d4ce34529533ff801a2febae7e669248cb80324'],424,412,836,1646212,142,,,,3338
ded74ec94c8da9c8c46ffae2f79a05a83d1623e1,0,Matt Gilman,2015-09-14 21:48:11-04:00,['2ec735e35025fed3c63d51128ec0609ffe1fa7e3'],264,264,528,1646740,142,,,,3338
100799941510b085b71394a757d86b9845ab993d,1,Bryan Bende,2015-09-16 09:59:50-04:00,['3d4ce34529533ff801a2febae7e669248cb80324'],20,528,548,1647288,7,0.585774059,0.748953975,1,3342
b36841e2134fc2d3aea0cafdf84ea9b0bafd3e50,1,Bryan Bende,2015-09-16 10:11:30-04:00,['100799941510b085b71394a757d86b9845ab993d'],1,689,690,1647978,3,0.408284024,0.75739645,0.683431953,3344
624bb5dd74ad93da381eeff5c8abe6e2fb999ac2,0,Matt Gilman,2015-09-18 08:48:40-04:00,"['b36841e2134fc2d3aea0cafdf84ea9b0bafd3e50', 'ded74ec94c8da9c8c46ffae2f79a05a83d1623e1']",428,417,845,1648823,142,,,,3344
1fd45958d3ff3725ced3978de5a955a13b600a9e,0,Matt Gilman,2015-09-18 08:48:48-04:00,['624bb5dd74ad93da381eeff5c8abe6e2fb999ac2'],1,1,2,1648825,1,,,,3344
600f91a26236b11f9a7ab7fc96ee9e861b016ebd,1,Bryan Bende,2015-09-18 17:05:31-04:00,['1fd45958d3ff3725ced3978de5a955a13b600a9e'],31,225,256,1649081,11,1,0.486842105,0.565789474,3344
d75c7b54e8d6ab9374d6cf6afd1638270388c0f8,1,Matt Gilman,2015-09-18 18:17:12-04:00,['600f91a26236b11f9a7ab7fc96ee9e861b016ebd'],0,192,192,1649273,7,1,1,1,3349
14eaeeb1eef1afef1ead9cb69bf5baa5303eb228,0,Aldrin Piri,2015-09-22 08:51:58-04:00,['d75c7b54e8d6ab9374d6cf6afd1638270388c0f8'],1,1,2,1649275,1,,,,3349
5764e892933f3fac958b39fe2c9a3cfde8afd59e,1,Bryan Bende,2015-09-22 13:19:15-04:00,['14eaeeb1eef1afef1ead9cb69bf5baa5303eb228'],1,25,26,1649301,2,0,0.105263158,0.842105263,3349
8615941c893828ccf1f9b4c671d76e5d076dbefa,0,Bryan Bende,2015-09-22 15:38:53-04:00,['5764e892933f3fac958b39fe2c9a3cfde8afd59e'],1,55,56,1649357,2,1,1,1,3349
6b1328f3f181a27a5856d26983ed3329ee317522,1,Joe,2015-09-23 14:31:13+02:00,['14eaeeb1eef1afef1ead9cb69bf5baa5303eb228'],0,245,245,1649602,2,0.353658537,0.353658537,1,3350
ee7d89cb01d4661cfff2c4f0d093e38758680a56,1,Joe,2015-09-23 14:32:37+02:00,['6b1328f3f181a27a5856d26983ed3329ee317522'],0,280,280,1649882,1,0.5,1,0.875,3351
da56b49b88ee2e6491d893d2a6571cf457bb032c,0,Mark Payne,2015-09-23 12:06:50-04:00,"['1fd45958d3ff3725ced3978de5a955a13b600a9e', 'c72fb201d52113a16b176be3e0337b4303124244']",38,111,149,1650031,5,,,,3351
f884086fc2085cc0dbf5e1a80bca4a6a5138e42a,0,Mark Payne,2015-09-23 15:20:25-04:00,['da56b49b88ee2e6491d893d2a6571cf457bb032c'],2,2,4,1650035,1,,,,3351
26f80095b7f7db4b41f66e15b81268a2fbb19682,0,Mark Payne,2015-09-23 15:31:19-04:00,"['f884086fc2085cc0dbf5e1a80bca4a6a5138e42a', '8615941c893828ccf1f9b4c671d76e5d076dbefa']",34,498,532,1650567,23,,,,3351
193dbe65335700cf577d9090797ebf12b3105023,0,Mark Payne,2015-09-23 16:03:46-04:00,"['26f80095b7f7db4b41f66e15b81268a2fbb19682', '9cefc4a5a54adf63bf4eb67c4b8211f2a2b5dd14']",53,166,219,1650786,6,,,,3351
24c080788fe92af8a66fb8f2f2392273bd8f4553,0,Mark Payne,2015-09-24 10:06:39-04:00,['193dbe65335700cf577d9090797ebf12b3105023'],218,217,435,1651221,1,,,,3351
e12da7c9a332e6f318ee3eb313b55aa0f4ddf822,1,Aldrin Piri,2015-09-24 10:31:04-04:00,['26f80095b7f7db4b41f66e15b81268a2fbb19682'],2,26,28,1651249,1,0.1,0.1,0.1,3351
a414f1d514ddb5788c3d02843873651b04c9602e,0,Aldrin Piri,2015-09-24 10:37:08-04:00,['e12da7c9a332e6f318ee3eb313b55aa0f4ddf822'],0,0,0,1651249,0,,,,3351
e53ab391fa0a9a8e97b82367f92e820d0dcb3937,1,Bryan Bende,2015-09-24 10:46:10-04:00,['a414f1d514ddb5788c3d02843873651b04c9602e'],35,178,213,1651462,3,0.522222222,0.755555556,0.755555556,3351
eb94dab00cf6011cfb59e5e0b08fd840184a5b12,0,Mark Payne,2015-09-24 11:51:44-04:00,['24c080788fe92af8a66fb8f2f2392273bd8f4553'],207,207,414,1651876,1,,,,3351
96764ed6a14fadbc925e64c47f10e1b76256a389,0,Mark Payne,2015-09-25 09:15:34-04:00,"['eb94dab00cf6011cfb59e5e0b08fd840184a5b12', 'e53ab391fa0a9a8e97b82367f92e820d0dcb3937']",37,204,241,1652117,4,,,,3351
034ee6de6bc4c6923a835fbeaab4fb05fd694434,0,Mark Payne,2015-09-25 11:39:58-04:00,['96764ed6a14fadbc925e64c47f10e1b76256a389'],2027,2418,4445,1656562,93,0.06,0.06,0.88,3353
2215bc848b7db395b2ca9ac7cc4dc10891393721,0,Matt Gilman,2015-09-25 17:46:58-04:00,['034ee6de6bc4c6923a835fbeaab4fb05fd694434'],6,36,42,1656604,6,0.578947368,0,1,3353
2466a24530f493238024eb22dc041eebe96621f3,1,Bryan Bende,2015-09-28 11:21:42-04:00,['96764ed6a14fadbc925e64c47f10e1b76256a389'],0,1643,1643,1658247,19,0.334608031,0.75334608,1,3368
72eb64e8a43a08a5be988a3826b0a116c57915ea,1,Bryan Bende,2015-09-29 13:48:13-04:00,['2466a24530f493238024eb22dc041eebe96621f3'],272,626,898,1659145,10,0.004132231,1,0.917355372,3370
033a1553abe7c83d4d9c49b753911355a881dcc5,1,Bryan Bende,2015-10-01 14:13:20-04:00,['72eb64e8a43a08a5be988a3826b0a116c57915ea'],42,76,118,1659263,6,0.125,0,0,3370
883333cb00083fc5b0ee169122d1a4b41ee9d524,0,Bryan Bende,2015-10-01 15:12:22-04:00,['033a1553abe7c83d4d9c49b753911355a881dcc5'],0,0,0,1659263,0,,,,3370
6b2f5ad1f59c6cd2ced5e7225454260cefbbbcce,0,Bryan Bende,2015-10-01 16:56:49-04:00,['883333cb00083fc5b0ee169122d1a4b41ee9d524'],0,21,21,1659284,1,,,,3371
31fba6b3332978ca2f6a1d693f6053d719fb9daa,0,Aldrin Piri,2015-10-05 10:39:22-04:00,['6b2f5ad1f59c6cd2ced5e7225454260cefbbbcce'],2,2,4,1659288,1,,,,3371
4afd8f88f8a34cf87f2a06221667166a54c99a15,1,Mark Payne,2015-10-07 17:26:14-04:00,['31fba6b3332978ca2f6a1d693f6053d719fb9daa'],2027,2418,4445,1663733,93,0.06,0.06,0.88,3373
13edcfda2ef830e1b160b31f7cd3bea874ccd3f0,1,Mark Payne,2015-10-07 17:26:14-04:00,['4afd8f88f8a34cf87f2a06221667166a54c99a15'],6,36,42,1663775,6,0.578947368,0,1,3373
5ecdb1858e94938cd426b12bc48d3725109c6e96,0,Mark Payne,2015-10-07 17:26:14-04:00,['13edcfda2ef830e1b160b31f7cd3bea874ccd3f0'],1238,1237,2475,1666250,1,0,0,0,3373
b974445ddd38ec7e84995225b86987e6af1af52c,0,Mark Payne,2015-10-07 17:28:39-04:00,"['5ecdb1858e94938cd426b12bc48d3725109c6e96', '2215bc848b7db395b2ca9ac7cc4dc10891393721']",9,9,18,1666268,1,,,,3373
ccfb57fe9ff43f11319dcb1625bfc78b1d88f56a,0,Mark Payne,2015-10-07 17:48:51-04:00,['b974445ddd38ec7e84995225b86987e6af1af52c'],520,534,1054,1667322,6,,,,3373
8e2308b78de480dd7848ffe8efb485a5ee61c42a,1,Mark Payne,2015-10-07 17:53:04-04:00,['ccfb57fe9ff43f11319dcb1625bfc78b1d88f56a'],4,4,8,1667330,1,,,,3373
2583d7869acedcbe536d4dd5eaf2e7c8f9cf149c,1,Matt Gilman,2015-10-07 19:11:55-04:00,['31fba6b3332978ca2f6a1d693f6053d719fb9daa'],125,105,230,1667560,8,0.56097561,1,1,3373
b4bfcc1f21fed3209bf4a8f187616cdbb3d1a5c9,0,Aldrin Piri,2015-10-08 15:46:12-04:00,['2583d7869acedcbe536d4dd5eaf2e7c8f9cf149c'],0,1,1,1667561,1,,,,3373
f798127290c5a0bf7fba9ea0aae8cbb733e67f40,0,Aldrin Piri,2015-10-09 10:53:23-04:00,['b4bfcc1f21fed3209bf4a8f187616cdbb3d1a5c9'],1,1,2,1667563,1,,,,3373
f6d3427955c48052bc214e08efcb24934d9a4cba,0,Aldrin Piri,2015-10-09 14:22:00-04:00,['f798127290c5a0bf7fba9ea0aae8cbb733e67f40'],2,2,4,1667567,1,,,,3373
b8c51dc35d1a7fdbf3e6449bbe297db667a1176c,1,Mark Payne,2015-10-11 10:27:07-04:00,['b4bfcc1f21fed3209bf4a8f187616cdbb3d1a5c9'],604,769,1373,1668940,24,0.05,1,0,3376
fad81d872d51d797bcc681977cfcb5fbda482257,0,danbress,2015-10-12 09:55:52-04:00,"['f6d3427955c48052bc214e08efcb24934d9a4cba', 'eb1d6b554cc589d7a62b4bf452bf4ebfbad1f8ff']",1,240,241,1669181,4,,,,3376
e0ac7cde372f428b0655465b7adc59ad41f8f270,1,Matt Gilman,2015-10-12 10:00:54-04:00,['b4bfcc1f21fed3209bf4a8f187616cdbb3d1a5c9'],2,542,544,1669725,9,0.554455446,1,0.732673267,3378
49ee06b0a256b9b4b7550acccb6facceb3c31c21,1,danbress,2015-10-12 19:59:46-04:00,['fad81d872d51d797bcc681977cfcb5fbda482257'],1,2,3,1669728,1,,,,3378
49a781df2d44859ec59672c2755b7346452cd74a,1,Mark Payne,2015-10-13 10:03:03-04:00,['b8c51dc35d1a7fdbf3e6449bbe297db667a1176c'],625,1155,1780,1671508,22,0.602787456,0.909407666,0.965156794,3380
9be37914ddb9c8c017cc4d6b3209340a19a7cb8d,0,Mark Payne,2015-10-13 10:03:31-04:00,"['49a781df2d44859ec59672c2755b7346452cd74a', 'e0ac7cde372f428b0655465b7adc59ad41f8f270']",2,542,544,1672052,9,,,,3380
ad6af95d079c277bf2a7bc63277f14a91fddebf7,0,Mark Payne,2015-10-13 10:09:21-04:00,['9be37914ddb9c8c017cc4d6b3209340a19a7cb8d'],3,4,7,1672059,2,,,,3381
09d6fe5cdb93ed3660263165f909e088244796db,0,Matt Gilman,2015-10-13 10:12:58-04:00,['ad6af95d079c277bf2a7bc63277f14a91fddebf7'],16,16,32,1672091,5,,,,3381
af78354d84dcd72a23f1101567729a04ee008110,1,Mark Payne,2015-10-13 12:20:18-04:00,['09d6fe5cdb93ed3660263165f909e088244796db'],14,48,62,1672153,5,0.75,0.9375,1,3381
4b41aaab029518909b58bf069a0c8b2a2bdca91b,0,Matt Gilman,2015-10-13 13:43:10-04:00,['af78354d84dcd72a23f1101567729a04ee008110'],55,231,286,1672439,9,0.6875,1,0.6,3381
72ff2a25d5455442d5aec27835f953e6ab36eca3,0,Mark Payne,2015-10-13 15:46:56-04:00,['4b41aaab029518909b58bf069a0c8b2a2bdca91b'],1,9,10,1672449,1,0,0,1,3381
afb76afcd0fd7d0c144a37621fdabc181bd42307,1,Mark Payne,2015-10-13 15:57:18-04:00,['72ff2a25d5455442d5aec27835f953e6ab36eca3'],8,53,61,1672510,3,0.24137931,0.24137931,1,3381
77f7d7524cb8b07ed2976088f0e57d99233c8327,1,Mark Payne,2015-10-14 09:14:15-04:00,['afb76afcd0fd7d0c144a37621fdabc181bd42307'],109,213,322,1672832,5,0.26744186,0.453488372,0.941860465,3381
0af1acaafaf28844b31c41e276c4dbce18390acb,1,Mark Payne,2015-10-14 09:46:21-04:00,['77f7d7524cb8b07ed2976088f0e57d99233c8327'],14,22,36,1672868,3,0,1,1,3381
5867193bc131962d05985f405ea199840a99feb9,0,Mark Payne,2015-10-14 09:56:52-04:00,['0af1acaafaf28844b31c41e276c4dbce18390acb'],1,8,9,1672877,1,0,1,1,3381
a2ae99f89965a3fe1bd6591204bdb187a377ae1c,0,Mark Payne,2015-10-14 11:11:48-04:00,['5867193bc131962d05985f405ea199840a99feb9'],1,16,17,1672894,2,0,0,1,3381
cad0e7cf0f7b5c8f0d4607c55a514e419a1caafc,1,Matt Gilman,2015-10-14 12:39:19-04:00,['a2ae99f89965a3fe1bd6591204bdb187a377ae1c'],206,407,613,1673507,14,0.72815534,1,0.980582524,3383
84db3725386fe44bbef8a18d84852a4f716addb6,1,Mark Payne,2015-10-14 13:12:10-04:00,['49ee06b0a256b9b4b7550acccb6facceb3c31c21'],83,119,202,1673709,2,0,1,1,3383
98a04eec741d5ed72405c6549970de5f1281239e,0,Mark Payne,2015-10-14 13:48:59-04:00,['cad0e7cf0f7b5c8f0d4607c55a514e419a1caafc'],0,1,1,1673710,1,0,0,1,3383
09a3f6dadd5ccff75590c53d071cc4ebe6c6175b,0,Mark Payne,2015-10-14 16:32:39-04:00,['98a04eec741d5ed72405c6549970de5f1281239e'],4,4,8,1673718,2,,,,3383
39a050d2fdc2437576d860b968ab1ec78d18fa21,1,Matt Gilman,2015-10-14 17:47:06-04:00,['09a3f6dadd5ccff75590c53d071cc4ebe6c6175b'],23,144,167,1673885,4,0.231707317,0.219512195,0.280487805,3383
b8dbd1018cf0b2d09bf7371849cf8b588d5f3f7c,0,Mark Payne,2015-10-16 08:53:40-04:00,['39a050d2fdc2437576d860b968ab1ec78d18fa21'],1,1,2,1673887,1,,,,3383
2b4999c0185ad6009dda33badfef3ade6cb2fde6,0,Mark Payne,2015-10-16 09:06:13-04:00,['b8dbd1018cf0b2d09bf7371849cf8b588d5f3f7c'],10,0,10,1673897,2,0.142857143,0.142857143,0,3383
a872403831a2e816ae41c5ac11d43f7067ce32cc,0,Matt Gilman,2015-10-16 09:37:57-04:00,['2b4999c0185ad6009dda33badfef3ade6cb2fde6'],12,60,72,1673969,5,0.137931034,1,1,3383
570202eb3059595394599300e810c22eb801d3cd,0,Matt Gilman,2015-10-16 10:47:02-04:00,['a872403831a2e816ae41c5ac11d43f7067ce32cc'],4,4,8,1673977,2,,,,3383
ce7d098a485d3a3a58f52e269f48be4969e13f9b,0,Tony Kurc,2015-10-17 09:00:18-04:00,['49ee06b0a256b9b4b7550acccb6facceb3c31c21'],7,4,11,1673988,1,,,,3383
9a8d763d8dddb8feb7e4b176cd97a7790436f60c,0,Tony Kurc,2015-10-17 09:43:10-04:00,['ce7d098a485d3a3a58f52e269f48be4969e13f9b'],77,0,77,1674065,1,1,0,0,3383
22924c656bfdcf749bd618f055ffa816aca17ae5,0,Tony Kurc,2015-10-17 10:46:49-04:00,['9a8d763d8dddb8feb7e4b176cd97a7790436f60c'],2,19,21,1674086,1,0,0,1,3383
943ccfedef0cfd8896814db203646e3e4de8cf8f,1,joewitt,2015-10-18 18:56:26-04:00,['22924c656bfdcf749bd618f055ffa816aca17ae5'],4,7,11,1674097,1,0,0,1,3383
31f0909bd315af43936b844327454ba2c48611e4,1,Mark Payne,2015-10-18 19:00:24-04:00,['49ee06b0a256b9b4b7550acccb6facceb3c31c21'],0,885,885,1674982,4,0.115463918,0.435051546,0.884536082,3385
bd47f36c06db91d497a4b33117c386666f17729c,1,joewitt,2015-10-18 19:13:26-04:00,['943ccfedef0cfd8896814db203646e3e4de8cf8f'],1,1,2,1674984,1,,,,3385
ad73a23affe32e77a5295c829a4958da440d24cb,0,joewitt,2015-10-18 19:42:46-04:00,['bd47f36c06db91d497a4b33117c386666f17729c'],4,7,11,1674995,2,,,,3385
88b1b844fba5e4dded6242bb17f2096ff4172ed3,1,Tony Kurc,2015-10-18 20:04:24-04:00,['ad73a23affe32e77a5295c829a4958da440d24cb'],9,29,38,1675033,3,0.4,0.4,1,3385
9200542298c33bd7527a5329205527445613b2b4,0,Tony Kurc,2015-10-18 20:34:36-04:00,['88b1b844fba5e4dded6242bb17f2096ff4172ed3'],9,8,17,1675050,1,,,,3385
58d9b0251734f124dae40443a295821ca2f653b3,0,Tony Kurc,2015-10-19 20:33:52-04:00,['9200542298c33bd7527a5329205527445613b2b4'],11,11,22,1675072,1,,,,3385
9aa716b0592bfd3552880b4d0042db499307f778,1,Tony Kurc,2015-10-19 20:36:07-04:00,['58d9b0251734f124dae40443a295821ca2f653b3'],12,14,26,1675098,1,,,,3385
b809031195405c04ec7a950c293482225f64e8dc,1,Tony Kurc,2015-10-19 20:36:58-04:00,['9aa716b0592bfd3552880b4d0042db499307f778'],38,38,76,1675174,1,,,,3385
518670dbf66a20855357fc379f516f488921d0c5,0,Tony Kurc,2015-10-19 23:43:44-04:00,['b809031195405c04ec7a950c293482225f64e8dc'],0,1,1,1675175,1,0,0,1,3385
e68fdca517eac53700c0f38bbaa7a893cfc28d9c,0,Tony Kurc,2015-10-21 00:01:38-04:00,['518670dbf66a20855357fc379f516f488921d0c5'],2,55,57,1675232,2,0.233333333,1,1,3385
97441ea0c23ebdc7c51939ff28ba270012c0fe55,0,Mark Payne,2015-10-21 10:18:05-04:00,"['22924c656bfdcf749bd618f055ffa816aca17ae5', 'ee7d89cb01d4661cfff2c4f0d093e38758680a56']",0,525,525,1675757,3,,,,3385
da28b81eece1277c7500f28708155239ae317e57,0,Mark Payne,2015-10-21 10:44:06-04:00,"['e68fdca517eac53700c0f38bbaa7a893cfc28d9c', '97441ea0c23ebdc7c51939ff28ba270012c0fe55']",0,525,525,1676282,3,,,,3385
a5a5badb88311cb29cbe39088b57b9686314a1c6,1,Tony Kurc,2015-10-21 20:15:29-04:00,['da28b81eece1277c7500f28708155239ae317e57'],7,89,96,1676378,2,0.431818182,0.886363636,0.772727273,3385
ba3225fe92258a6aca3cb706412ab62955914dc8,1,Mark Payne,2015-10-23 09:28:03-04:00,['da28b81eece1277c7500f28708155239ae317e57'],15,357,372,1676750,4,0.25,0.85,1,3387
a9e5325047fbe3ad8a7d53b664e7944e39fcf658,1,Mark Payne,2015-10-23 09:28:03-04:00,['ba3225fe92258a6aca3cb706412ab62955914dc8'],14,8,22,1676772,2,0,0,1,3387
bd506b1e10ebc2ce025e836f83cb0f77562deba4,1,Mark Payne,2015-10-23 09:52:09-04:00,['a9e5325047fbe3ad8a7d53b664e7944e39fcf658'],7,47,54,1676826,3,0,0.962962963,1,3387
5d90c9be07b40455c831e5a602eeeb6660cdd8c6,0,Mark Payne,2015-10-23 09:52:33-04:00,"['bd506b1e10ebc2ce025e836f83cb0f77562deba4', 'a5a5badb88311cb29cbe39088b57b9686314a1c6']",7,89,96,1676922,2,,,,3387
0fc5d3046178836365f710d312cef6568126a99d,1,Mark Payne,2015-10-23 10:08:44-04:00,['5d90c9be07b40455c831e5a602eeeb6660cdd8c6'],138,140,278,1677200,5,1,1,0,3387
88fc8d28a0502fa7d66662d6646f31cf33e131be,1,Mark Payne,2015-10-23 10:25:59-04:00,['22924c656bfdcf749bd618f055ffa816aca17ae5'],1,5,6,1677206,1,0,0,1,3387
d63cd6bd2f9adc3dfc4c7fe168e38081a5b13564,0,Mark Payne,2015-10-23 14:39:16-04:00,"['0fc5d3046178836365f710d312cef6568126a99d', '88fc8d28a0502fa7d66662d6646f31cf33e131be']",1,5,6,1677212,1,,,,3387
f2c4f2d2a15f23edd8933f6dbd10210de1700de3,1,Tony Kurc,2015-10-25 00:49:58-04:00,['d63cd6bd2f9adc3dfc4c7fe168e38081a5b13564'],13,79,92,1677304,1,0.868421053,1,0.815789474,3387
0636f0e731cd28299edd3a6e9db90de5045ab662,0,Mark Payne,2015-10-25 11:02:40-04:00,"['8e2308b78de480dd7848ffe8efb485a5ee61c42a', 'd63cd6bd2f9adc3dfc4c7fe168e38081a5b13564']",507,1725,2232,1679536,40,,,,3387
8a8006085190aae1125c883f2aab16a4ada9beb8,0,Mark Payne,2015-10-25 11:11:49-04:00,"['0636f0e731cd28299edd3a6e9db90de5045ab662', 'f2c4f2d2a15f23edd8933f6dbd10210de1700de3']",13,79,92,1679628,1,,,,3387
d1d57931bf996a230ab7941cb6c1524286c97606,1,Mark Payne,2015-10-25 11:13:02-04:00,['8a8006085190aae1125c883f2aab16a4ada9beb8'],300,1988,2288,1681916,15,0.365986395,0.654421769,0.940136054,3397
b0322d9ffe8d117aae4faf7dd3e2881a28940f96,1,Mark Payne,2015-10-25 11:13:02-04:00,['d1d57931bf996a230ab7941cb6c1524286c97606'],47,265,312,1682228,10,0.271428571,0.342857143,1,3397
4e38288062f33ecafdfd3b4bc453bdffe54e752e,1,Mark Payne,2015-10-25 11:13:02-04:00,['b0322d9ffe8d117aae4faf7dd3e2881a28940f96'],2,18,20,1682248,4,0,1,1,3397
385bfbb2c635f74aca318617175cd57a8e26ecda,0,Mark Payne,2015-10-25 11:14:11-04:00,['4e38288062f33ecafdfd3b4bc453bdffe54e752e'],0,6,6,1682254,2,,,,3397
8d2f9bc64b03702f4db53de6ac741ce102413bfa,1,Tony Kurc,2015-10-25 11:31:30-04:00,['385bfbb2c635f74aca318617175cd57a8e26ecda'],0,51,51,1682305,2,0,0.9375,1,3397
26edab3185008f1d34647ff3c11ba8b87815de02,1,Tony Kurc,2015-10-26 00:29:05-04:00,['8d2f9bc64b03702f4db53de6ac741ce102413bfa'],5,86,91,1682396,4,0.233333333,0.666666667,0.483333333,3397
f8c3377c84189c4688abc7186a99fea44be501f0,1,Matt Gilman,2015-10-26 10:16:01-04:00,['26edab3185008f1d34647ff3c11ba8b87815de02'],22,96,118,1682514,6,0.952380952,1,0.904761905,3397
aec32a277c3f2b707edd20a9eff9c4984f4f28fa,1,Mark Payne,2015-10-26 14:36:03-04:00,['f8c3377c84189c4688abc7186a99fea44be501f0'],8,18,26,1682540,1,0,0,1,3397
51f564024a2fbe7fbd08760635561f08619be0e4,0,Mark Payne,2015-10-26 14:58:50-04:00,['aec32a277c3f2b707edd20a9eff9c4984f4f28fa'],138,258,396,1682936,7,0,1,0.125,3397
fc2aa2764cc9e85a19d3f3eec640873f43c60148,1,Mark Payne,2015-10-26 14:58:50-04:00,['51f564024a2fbe7fbd08760635561f08619be0e4'],66,69,135,1683071,2,1,1,0,3397
17006335e5b687a8a268d1571ae04a98235e6394,0,Mark Payne,2015-10-26 17:09:51-04:00,['fc2aa2764cc9e85a19d3f3eec640873f43c60148'],1,1,2,1683073,1,,,,3397
1c1738670ca5f921863572434b6f4cc4daddad38,1,Mark Payne,2015-10-26 17:14:29-04:00,['17006335e5b687a8a268d1571ae04a98235e6394'],3,2,5,1683078,2,1,1,0,3397
b885f955f4ee97caeaf5c3a28aab967db1be4c94,1,Mark Payne,2015-10-26 20:23:13-04:00,['1c1738670ca5f921863572434b6f4cc4daddad38'],8,95,103,1683181,6,0.204545455,0.477272727,0,3397
07238c79137ac393441e2f4a0d0fdfdf26ebd277,1,Mark Payne,2015-10-27 10:37:43-04:00,['1c1738670ca5f921863572434b6f4cc4daddad38'],476,953,1429,1684610,6,0.568965517,0.798850575,0.522988506,3399
af19053a7f7e23f40530561530cfc56c0ad961d4,0,Mark Payne,2015-10-27 10:42:46-04:00,"['b885f955f4ee97caeaf5c3a28aab967db1be4c94', '07238c79137ac393441e2f4a0d0fdfdf26ebd277']",476,953,1429,1686039,6,,,,3399
4c0cf7d72bdfb0e92159e50d010c3cfa1f264369,1,Mark Payne,2015-10-27 12:01:17-04:00,['af19053a7f7e23f40530561530cfc56c0ad961d4'],1,755,756,1686795,3,,,,3400
dc4004de64d10ba82298eb1f6ecb5924fd0afb62,0,Mark Payne,2015-10-27 16:53:38-04:00,"['4c0cf7d72bdfb0e92159e50d010c3cfa1f264369', '84db3725386fe44bbef8a18d84852a4f716addb6']",83,119,202,1686997,2,,,,3400
edf238e004e45566374fcb520555cf4cc30ed8f7,1,Mark Payne,2015-10-28 10:27:58-04:00,['570202eb3059595394599300e810c22eb801d3cd'],21,6,27,1687024,1,0,0,0,3400
cf8ca3dc2c9ee9220c0b83b6c003ef20c67fbd33,0,Mark Payne,2015-10-28 17:32:51-04:00,['dc4004de64d10ba82298eb1f6ecb5924fd0afb62'],175,327,502,1687526,9,0.090909091,1,1,3400
c4f0cb1c6c5ff64eeff4cf98008ff838e4717abe,0,Bryan Bende,2015-10-29 12:06:25-04:00,['dc4004de64d10ba82298eb1f6ecb5924fd0afb62'],1,0,1,1687527,1,,,,3400
5cc2b04b918a0a3c76c0f1d71c7a416d0dce3f39,1,Bryan Bende,2015-10-29 16:28:36-04:00,['c4f0cb1c6c5ff64eeff4cf98008ff838e4717abe'],322,733,1055,1688582,52,0.689655172,0.5,0.896551724,3407
5c4042bd7c39dd92b1fba665c7b03c670346be8f,1,Oleg Zhurakousky,2015-10-29 16:31:17-04:00,['c4f0cb1c6c5ff64eeff4cf98008ff838e4717abe'],0,24,24,1688606,2,0.777777778,0.777777778,1,3407
a40e5a07ba29177ed22eb88751a8336ed59a7c25,0,Matt Gilman,2015-10-30 10:17:28-04:00,['5cc2b04b918a0a3c76c0f1d71c7a416d0dce3f39'],1189,4397,5586,1694192,84,0.674523008,0.920314254,0.961840629,3450
e7a5e1822163e065fb72c889fcad6f038807e9f7,0,Matt Gilman,2015-10-30 10:17:34-04:00,['a40e5a07ba29177ed22eb88751a8336ed59a7c25'],193,374,567,1694759,22,0.361445783,0.674698795,0.86746988,3453
bfa9e450798591db11a7b520cd01388f8819d865,1,Mark Payne,2015-10-30 11:44:51-04:00,['31f0909bd315af43936b844327454ba2c48611e4'],32,188,220,1694979,2,0.141509434,0.603773585,0.990566038,3453
9515b7460713ba985a6d7c8ad033fe2c1ac98e3d,1,Mark Payne,2015-10-30 14:25:27-04:00,['dc4004de64d10ba82298eb1f6ecb5924fd0afb62'],3,3,6,1694985,1,,,,3453
19b7a4cc7de9da3366aa9c1a15b97c683242b4d0,1,Bryan Bende,2015-10-30 14:29:29-04:00,['5cc2b04b918a0a3c76c0f1d71c7a416d0dce3f39'],0,295,295,1695280,3,0.238095238,0.741496599,1,3455
217b1049cf73c8ecef7dd76a954f07a7c7224cc6,0,Bryan Bende,2015-10-30 14:30:25-04:00,['19b7a4cc7de9da3366aa9c1a15b97c683242b4d0'],43,224,267,1695547,2,0.333333333,1,0.715686275,3455
aef0d8fe9b994ce333d14083d7f39edc77622d72,1,Bryan Bende,2015-10-30 14:30:42-04:00,['217b1049cf73c8ecef7dd76a954f07a7c7224cc6'],37,86,123,1695670,2,0,1,1,3455
eb389cf84cd5f610b5ea2235a4eb78de47f6417e,1,Bryan Bende,2015-10-30 14:30:56-04:00,['aef0d8fe9b994ce333d14083d7f39edc77622d72'],3,3,6,1695676,1,,,,3455
1d97876f82cdd37b2bab5e99ffc170f483c32037,0,Bryan Bende,2015-10-30 14:36:46-04:00,['eb389cf84cd5f610b5ea2235a4eb78de47f6417e'],0,0,0,1695676,0,,,,3455
90aea0135062c50e2c8635e178188d2d8c35b883,1,Mark Payne,2015-10-30 15:52:33-04:00,['dc4004de64d10ba82298eb1f6ecb5924fd0afb62'],1,1,2,1695678,1,,,,3455
a3d43d23dcf68310b518d35751d1835767d895a4,1,Mark Payne,2015-10-30 15:52:33-04:00,['90aea0135062c50e2c8635e178188d2d8c35b883'],9,113,122,1695800,3,1,1,1,3456
ba72452f669b926c2af63ccd5684e0c2b793f405,0,Mark Payne,2015-10-30 16:02:15-04:00,"['a3d43d23dcf68310b518d35751d1835767d895a4', '1d97876f82cdd37b2bab5e99ffc170f483c32037']",323,1258,1581,1697381,56,,,,3456
9c148da1c28fa641b94cd7e8f1f9f07c63f2896a,1,Mark Payne,2015-10-30 16:09:50-04:00,['ba72452f669b926c2af63ccd5684e0c2b793f405'],56,57,113,1697494,1,,,,3456
cef7b6c736721858a8bf11b2c03b0a2b0a49b0df,1,Matt Gilman,2015-10-31 00:19:36-04:00,['9c148da1c28fa641b94cd7e8f1f9f07c63f2896a'],586,972,1558,1699052,4,0.075117371,1,0.549295775,3458
6e193dffa349b1f7627441489b8208666bea684a,0,Mark Payne,2015-11-01 14:16:35-05:00,"['9c148da1c28fa641b94cd7e8f1f9f07c63f2896a', '9515b7460713ba985a6d7c8ad033fe2c1ac98e3d']",3,3,6,1699058,1,,,,3458
b729bf4c196e0fbd33692f76c11931aef61c650b,0,Mark Payne,2015-11-01 14:16:54-05:00,"['6e193dffa349b1f7627441489b8208666bea684a', 'cef7b6c736721858a8bf11b2c03b0a2b0a49b0df']",586,972,1558,1700616,4,,,,3458
ad849c77dff7b379116f4d57510c7b9136c7f4c0,0,Mark Payne,2015-11-01 14:37:01-05:00,['b729bf4c196e0fbd33692f76c11931aef61c650b'],1,9,10,1700626,1,0,0,1,3458
37e2f178f8f0e4a0fed022e2541a64e97e4897d4,0,Mark Payne,2015-11-01 14:47:23-05:00,['ad849c77dff7b379116f4d57510c7b9136c7f4c0'],1,2,3,1700629,1,1,1,1,3458
f5727cfb0fe73b7226fe9eca96fd594f8d423ffa,0,Mark Payne,2015-11-02 08:36:50-05:00,['edf238e004e45566374fcb520555cf4cc30ed8f7'],2,9,11,1700640,1,0,0,1,3458
5a04021dd7a61cc7c76b24405288713116bcd682,0,Matt Gilman,2015-11-02 08:59:11-05:00,['f5727cfb0fe73b7226fe9eca96fd594f8d423ffa'],10,12,22,1700662,1,1,1,1,3458
2ae49026e898ef9ea154990f4d3a5da3ee8d8129,1,Mark Payne,2015-11-02 10:32:14-05:00,['37e2f178f8f0e4a0fed022e2541a64e97e4897d4'],1,22,23,1700685,1,0.2,0.2,1,3458
7a73867c46629ff20ef5d84f1167cb34e503bc75,0,Mark Payne,2015-11-02 10:51:43-05:00,"['2ae49026e898ef9ea154990f4d3a5da3ee8d8129', '5c4042bd7c39dd92b1fba665c7b03c670346be8f']",0,24,24,1700709,2,,,,3458
abf2c6288458958be54a7a9a5fddc91693aaa4cf,0,Mark Payne,2015-11-02 11:01:50-05:00,['7a73867c46629ff20ef5d84f1167cb34e503bc75'],19,19,38,1700747,2,0,0,1,3458
814e8b212cf6cb239418ea25b6f5dd1eb919ae14,0,Mark Payne,2015-11-02 11:29:52-05:00,"['abf2c6288458958be54a7a9a5fddc91693aaa4cf', 'cf8ca3dc2c9ee9220c0b83b6c003ef20c67fbd33']",175,327,502,1701249,9,,,,3458
a549621267c6517c4774579c3d95f0d7a0c1f68b,0,Mark Payne,2015-11-02 11:46:17-05:00,['814e8b212cf6cb239418ea25b6f5dd1eb919ae14'],9,84,93,1701342,3,0.461538462,0.826923077,1,3458
e4cebba3c7868010c2b9fd994b850f40b81aa044,0,Mark Payne,2015-11-02 14:02:16-05:00,"['5a04021dd7a61cc7c76b24405288713116bcd682', 'a549621267c6517c4774579c3d95f0d7a0c1f68b']",2924,9983,12907,1714249,237,,,,3458
ade5dc9baccb55f9675d6ff64097c26a318f7da2,0,Matt Gilman,2015-11-02 14:21:25-05:00,['e7a5e1822163e065fb72c889fcad6f038807e9f7'],387,457,844,1715093,26,0.688073394,0.706422018,0.623853211,3460
dbf0c7893fef964bfbb3a4c039c756396587ce12,1,Mark Payne,2015-11-02 14:31:28-05:00,['e4cebba3c7868010c2b9fd994b850f40b81aa044'],33,40,73,1715166,1,0.4,0.8,0,3460
5e341214a61519eff53596782e78eb1b82a32da6,0,Matt Gilman,2015-11-02 14:54:51-05:00,['ade5dc9baccb55f9675d6ff64097c26a318f7da2'],8,4,12,1715178,4,,,,3460
7f9807f461be110e051ce367569b690787b5e5b6,0,Matt Gilman,2015-11-02 22:55:57-05:00,['5e341214a61519eff53596782e78eb1b82a32da6'],147,149,296,1715474,24,1,0,0,3461
71d84117e4a3b67a90d9c83f2ff3f27bcdea6b95,0,Matt Gilman,2015-11-03 11:10:32-05:00,['7f9807f461be110e051ce367569b690787b5e5b6'],35,382,417,1715891,12,0.531578947,0.773684211,0.626315789,3463
ed27ed04498bd6f0f5c3b65c403aaca19954286a,0,Matt Gilman,2015-11-03 12:45:37-05:00,['71d84117e4a3b67a90d9c83f2ff3f27bcdea6b95'],118,181,299,1716190,7,0.892857143,0,0.964285714,3463
7799deeaa1543d3ba0a6b70cdc0611c968d38b90,0,Matt Gilman,2015-11-03 17:08:37-05:00,['ed27ed04498bd6f0f5c3b65c403aaca19954286a'],131,271,402,1716592,17,0,0.421052632,0,3463
2b1d093120fe3f70594909b97f2658828a09044e,0,Mark Payne,2015-11-04 08:41:10-05:00,['dbf0c7893fef964bfbb3a4c039c756396587ce12'],6,6,12,1716604,3,1,1,1,3463
2214592865da1eda532e6a312b8ab9bf986d7aa3,0,Matt Gilman,2015-11-04 09:07:27-05:00,['7799deeaa1543d3ba0a6b70cdc0611c968d38b90'],145,169,314,1716918,8,0.675675676,0.135135135,1,3464
fedbe403131bc556e3d2d44947b0be5c5a74f10d,0,Mark Payne,2015-11-04 11:11:33-05:00,['2b1d093120fe3f70594909b97f2658828a09044e'],0,3,3,1716921,1,,,,3464
201eac052b155d687393d2698dc9069f0f7c0c1c,0,Tony Kurc,2015-11-04 12:11:19-05:00,['fedbe403131bc556e3d2d44947b0be5c5a74f10d'],1,1,2,1716923,1,,,,3464
6add372bc142304ef25e0bafb49709654a995f08,0,Mike Moser,2015-11-04 12:19:00-05:00,['201eac052b155d687393d2698dc9069f0f7c0c1c'],2,2,4,1716927,1,,,,3464
9c542432da7c9df6087a180cd939820dcce7008d,1,Tony Kurc,2015-11-04 17:56:13-05:00,['201eac052b155d687393d2698dc9069f0f7c0c1c'],2,2494,2496,1719423,10,0.355453852,0.852784134,0.909992372,3472
5611dac3f88efb9ba3148634b0546054363ff5b2,1,Tony Kurc,2015-11-04 18:00:18-05:00,['9c542432da7c9df6087a180cd939820dcce7008d'],129,247,376,1719799,3,0.333333333,0.419753086,0.950617284,3472
618f22e110032df09d77a80587b553e6995038e2,1,Tony Kurc,2015-11-04 18:01:59-05:00,['5611dac3f88efb9ba3148634b0546054363ff5b2'],17,104,121,1719920,5,0.109090909,0.854545455,0.763636364,3472
f1bd3d471de6b84cd2d0eee66233ce8b522e6a5a,0,Tony Kurc,2015-11-04 18:31:34-05:00,['618f22e110032df09d77a80587b553e6995038e2'],1,1,2,1719922,1,,,,3472
93aa09dace01c2abe301ee7781cc8ab54b48197a,0,Matt Gilman,2015-11-04 22:03:52-05:00,['2214592865da1eda532e6a312b8ab9bf986d7aa3'],235,569,804,1720726,18,0.621468927,0.525423729,0.779661017,3474
4ac52bfc0ab5572a308cb97e3124b563eab65194,0,Bryan Bende,2015-11-05 10:42:10-05:00,['f1bd3d471de6b84cd2d0eee66233ce8b522e6a5a'],1,0,1,1720727,1,,,,3474
98f5a1ab779eb3d49f95eda36844d1398af1a1f6,1,Mark Payne,2015-11-05 12:12:02-05:00,['4ac52bfc0ab5572a308cb97e3124b563eab65194'],7,63,70,1720797,2,0.512820513,0.871794872,0.846153846,3474
b6d09b86b6b0b6873dda192d28e704653ac9522d,0,Matt Gilman,2015-11-05 18:26:00-05:00,['93aa09dace01c2abe301ee7781cc8ab54b48197a'],214,522,736,1721533,18,0.440298507,0.828358209,0.992537313,3475
1a388f957e286d394ad11c0b5f192ddf23f7c92b,1,Mark Payne,2015-11-06 09:03:38-05:00,['98f5a1ab779eb3d49f95eda36844d1398af1a1f6'],1,1,2,1721535,1,,,,3475
ee87f33ce7aada9f05f43cb3b00f2fab0793cd82,0,Bryan Bende,2015-11-06 09:10:10-05:00,['98f5a1ab779eb3d49f95eda36844d1398af1a1f6'],2,2,4,1721539,1,,,,3475
0d6e81b54f13575cb960ca65eafcd20cf19db85c,0,Mark Payne,2015-11-06 09:16:12-05:00,"['1a388f957e286d394ad11c0b5f192ddf23f7c92b', 'ee87f33ce7aada9f05f43cb3b00f2fab0793cd82']",2,2,4,1721543,1,,,,3475
06a4736a58da5070259142e3716e24c9bc14b282,0,Matt Gilman,2015-11-06 09:55:40-05:00,['b6d09b86b6b0b6873dda192d28e704653ac9522d'],276,302,578,1722121,48,0.625,1,1,3475
d41b83c19b6a1fb26b0925f896d1af7eef9e99d9,0,Matt Gilman,2015-11-06 10:10:54-05:00,['06a4736a58da5070259142e3716e24c9bc14b282'],1,1,2,1722123,1,,,,3475
d47c00f00e8ea28e023b393cec97cb81ea382a1d,0,Matt Gilman,2015-11-06 18:06:47-05:00,['d41b83c19b6a1fb26b0925f896d1af7eef9e99d9'],42,86,128,1722251,12,0.653846154,0.769230769,1,3475
018c0864e3431bc288adbfd0d6675541cb5243e3,0,Matt Gilman,2015-11-06 18:28:31-05:00,['d47c00f00e8ea28e023b393cec97cb81ea382a1d'],2,2,4,1722255,2,,,,3475
92099ede2ffde8af346b19092977d724442eb33e,1,joewitt,2015-11-06 23:20:03-05:00,['0d6e81b54f13575cb960ca65eafcd20cf19db85c'],3,3,6,1722261,1,,,,3475
99629646fe2bf67e814533c4073247a25506c8fa,0,joewitt,2015-11-06 23:41:15-05:00,['92099ede2ffde8af346b19092977d724442eb33e'],272,272,544,1722805,146,,,,3475
77de51df19b768ea1180d52e0e6106629161add0,1,Tony Kurc,2015-11-07 21:09:18-05:00,['99629646fe2bf67e814533c4073247a25506c8fa'],113,273,386,1723191,7,0.35,0.375,1,3476
440e4c4940a8eed51f8accdaf599e3d4a4b685e7,1,Tony Kurc,2015-11-08 12:27:41-05:00,['77de51df19b768ea1180d52e0e6106629161add0'],1,1,2,1723193,1,,,,3476
59a49aea12170adb51bf64644e0d1664d54f9fd5,1,Mark Payne,2015-11-08 21:46:06-05:00,['0d6e81b54f13575cb960ca65eafcd20cf19db85c'],327,175,502,1723695,9,0.909090909,0,0,3476
de498df4c997c6e51c1031726e5d1f412e62ff5a,0,joewitt,2015-11-08 22:10:30-05:00,['440e4c4940a8eed51f8accdaf599e3d4a4b685e7'],1,1,2,1723697,1,,,,3476
64b1fc983c09d09fd5d8aa7ecd39d4bc487f8094,1,joewitt,2015-11-08 22:15:11-05:00,['de498df4c997c6e51c1031726e5d1f412e62ff5a'],0,59,59,1723756,2,,,,3476
3cf3addd85e3734e089d5d41df8075a7a5b5b9f7,0,Matt Gilman,2015-11-09 09:20:49-05:00,['018c0864e3431bc288adbfd0d6675541cb5243e3'],12,151,163,1723919,6,1,0.666666667,0.888888889,3478
bed35d81a5e9c9a9baf0f7f1e7f3caec392d6f2e,0,Matt Gilman,2015-11-09 10:04:19-05:00,['3cf3addd85e3734e089d5d41df8075a7a5b5b9f7'],253,252,505,1724424,3,0.572916667,0.572916667,1,3478
1350483d36e2d4b40c207bc4b365f348c2c536fc,0,Matt Gilman,2015-11-09 10:19:18-05:00,['bed35d81a5e9c9a9baf0f7f1e7f3caec392d6f2e'],42,32,74,1724498,3,0,0,0,3478
efa1939fc551f4d02de61718e72e1bc896320350,0,Matt Gilman,2015-11-09 10:52:18-05:00,['1350483d36e2d4b40c207bc4b365f348c2c536fc'],9,14,23,1724521,4,0,0,1,3478
5f8fdae909ee19d97690841e8677621c8e134074,0,Mark Payne,2015-11-09 12:07:45-05:00,"['59a49aea12170adb51bf64644e0d1664d54f9fd5', '64b1fc983c09d09fd5d8aa7ecd39d4bc487f8094']",390,609,999,1725520,155,,,,3478
73c167197563d4d07a036739f9341a0f5e36b188,0,Mark Payne,2015-11-09 12:09:56-05:00,['5f8fdae909ee19d97690841e8677621c8e134074'],80,61,141,1725661,5,0.387096774,0,0,3478
bc636f2e081e64f1df988d1a5bbc546188018344,0,Bryan Bende,2015-11-09 13:33:28-05:00,['64b1fc983c09d09fd5d8aa7ecd39d4bc487f8094'],2,27,29,1725690,2,,,,3478
52101181e8ab6083fc8201c4f97d0683229899dc,0,Bryan Bende,2015-11-09 13:40:24-05:00,['bc636f2e081e64f1df988d1a5bbc546188018344'],2,22,24,1725714,2,,,,3478
051d242f014739462bcd198e4699019a7b0c8352,0,Bryan Bende,2015-11-09 13:41:00-05:00,"['5f8fdae909ee19d97690841e8677621c8e134074', '52101181e8ab6083fc8201c4f97d0683229899dc']",4,49,53,1725767,4,,,,3478
f2505604744f92b1da8bf761bd9027f2fbd03efc,0,Matt Gilman,2015-11-09 15:00:33-05:00,['efa1939fc551f4d02de61718e72e1bc896320350'],1293,366,1659,1727426,27,0.260135135,0.391891892,0.077702703,3478
7851a4f506604e63b021845c7f6fd905b77e94a9,0,Matt Gilman,2015-11-09 15:01:05-05:00,['f2505604744f92b1da8bf761bd9027f2fbd03efc'],135,0,135,1727561,1,0.7,0.285714286,0,3478
41f3875347a6ff7c87e35665019c35e99e78eecb,0,joewitt,2015-11-09 15:37:40-05:00,['051d242f014739462bcd198e4699019a7b0c8352'],87,0,87,1727648,3,0,0,0,3478
b75af5b344bc13abd15a6ad413336909a62322cc,0,Mike Moser,2015-11-09 16:13:12-05:00,"['41f3875347a6ff7c87e35665019c35e99e78eecb', '6add372bc142304ef25e0bafb49709654a995f08']",2,2,4,1727652,1,,,,3478
1925392a988b09eac83efd83210c9b0679b81bd5,0,Matt Gilman,2015-11-09 17:46:09-05:00,['7851a4f506604e63b021845c7f6fd905b77e94a9'],92,0,92,1727744,3,0,0,0,3478
a16d8c35c9ae21675a25b034cf20bac0e7c35489,0,Matt Gilman,2015-11-09 17:49:44-05:00,['1925392a988b09eac83efd83210c9b0679b81bd5'],1,2,3,1727747,1,,,,3478
ef0be5a5d6fbfc8abb55e250fc1ddbc294fda743,1,Oleg Zhurakousky,2015-11-09 18:35:31-05:00,['5f8fdae909ee19d97690841e8677621c8e134074'],16,71,87,1727834,4,0,0.833333333,1,3478
e2f7eba7cf9b125a39793cd6e4e08f6c6050f1ee,0,Matt Gilman,2015-11-09 21:08:47-05:00,['a16d8c35c9ae21675a25b034cf20bac0e7c35489'],20,0,20,1727854,1,,,,3478
2a90bd501b5b3aad11ee8b92f276302741e5a91e,0,Tony Kurc,2015-11-10 06:37:56-05:00,['b75af5b344bc13abd15a6ad413336909a62322cc'],5,31,36,1727890,3,1,1,1,3478
358cabafa30166872853dd4a7b64c107d6017268,0,Mark Payne,2015-11-10 10:55:08-05:00,['73c167197563d4d07a036739f9341a0f5e36b188'],1,1,2,1727892,1,,,,3478
e748fd5848eff2332761ef2e4ca2c7603df55ddb,1,Bryan Bende,2015-11-10 11:13:51-05:00,['2a90bd501b5b3aad11ee8b92f276302741e5a91e'],2,4263,4265,1732157,41,0.434752268,0.844382415,0.835310537,3511
11768cc38827023e9a04b65ba5d357bb692a1d10,0,Mark Payne,2015-11-10 11:35:14-05:00,['73c167197563d4d07a036739f9341a0f5e36b188'],1,1,2,1732159,1,,,,3511
8699e351081984a39b1e91ea0c6d878490413274,1,Oleg Zhurakousky,2015-11-10 12:13:16-05:00,['ef0be5a5d6fbfc8abb55e250fc1ddbc294fda743'],24,20,44,1732203,3,1,0,0,3511
2e158d15bea0749e5437559403a7ef6657c756fd,0,Matt Gilman,2015-11-10 12:14:03-05:00,['e2f7eba7cf9b125a39793cd6e4e08f6c6050f1ee'],9,0,9,1732212,1,,,,3511
53725b5c7291b4800e98ba84e01f13ea11943676,0,Mark Payne,2015-11-10 13:34:56-05:00,"['73c167197563d4d07a036739f9341a0f5e36b188', '8699e351081984a39b1e91ea0c6d878490413274']",17,68,85,1732297,5,,,,3511
8f942fcdcc63c5468c6a927010bf4b8377e7d9fc,1,Mark Payne,2015-11-10 14:31:20-05:00,['53725b5c7291b4800e98ba84e01f13ea11943676'],5,13,18,1732315,3,,,,3511
e61ccea7a040683d20e808531c79056a6724657d,0,Matt Gilman,2015-11-10 14:55:02-05:00,['2e158d15bea0749e5437559403a7ef6657c756fd'],132,146,278,1732593,8,1,0,0,3512
0281e2773f3a8942c3794b0945675ef9336e8c28,0,Matt Gilman,2015-11-10 14:58:04-05:00,['e61ccea7a040683d20e808531c79056a6724657d'],12,7,19,1732612,2,,,,3512
72008035b128a60e3e342b318c3e0a50b8928dbb,0,Mark Payne,2015-11-10 15:02:02-05:00,"['e748fd5848eff2332761ef2e4ca2c7603df55ddb', '8f942fcdcc63c5468c6a927010bf4b8377e7d9fc']",95,135,230,1732842,10,,,,3512
cf7bfe9e1cf9d3bab3a0806be66b536b3d7d10cb,0,Mark Payne,2015-11-10 15:04:37-05:00,['72008035b128a60e3e342b318c3e0a50b8928dbb'],2,2,4,1732846,2,,,,3512
6ed5f28f260d47ba6691a91facf81c06da669ad7,1,Mike Moser,2015-11-10 15:14:28-05:00,['cf7bfe9e1cf9d3bab3a0806be66b536b3d7d10cb'],24,33,57,1732903,14,0,0.666666667,1,3512
7b9c8df6c593059d063770095ab9efcf3c82467e,1,Mark Payne,2015-11-10 16:53:29-05:00,['bfa9e450798591db11a7b520cd01388f8819d865'],38,174,212,1733115,2,0.034482759,0.643678161,0.862068966,3512
e6644b3747fa4f830be106474c52b6a25294e297,0,Mark Payne,2015-11-10 17:17:55-05:00,"['6ed5f28f260d47ba6691a91facf81c06da669ad7', '11768cc38827023e9a04b65ba5d357bb692a1d10']",1,1,2,1733117,1,,,,3512
a031fb3dc6e43879fb8e26730393f6da7f33cf2c,0,Mark Payne,2015-11-10 17:17:59-05:00,"['e6644b3747fa4f830be106474c52b6a25294e297', '358cabafa30166872853dd4a7b64c107d6017268']",1,1,2,1733119,1,,,,3512
9756e9f1269efc05d1f51ab420e0468d5e2ee769,1,Tony Kurc,2015-11-10 18:46:17-05:00,['a031fb3dc6e43879fb8e26730393f6da7f33cf2c'],12,46,58,1733177,3,0.894736842,0.894736842,1,3512
ba5b1d837ce57f14a13dcd9cd0a18575bca79bd4,0,Tony Kurc,2015-11-10 18:50:57-05:00,['9756e9f1269efc05d1f51ab420e0468d5e2ee769'],327,327,654,1733831,2,,,,3512
d887d8fdf063b26cc76f0d1ba66f7e629ae9dd7f,0,Mark Payne,2015-11-11 08:05:23-05:00,['a031fb3dc6e43879fb8e26730393f6da7f33cf2c'],4,44,48,1733879,2,0,1,1,3512
6c510fae8034ae1e5fdc8514d52f55b5f04c31d9,0,Mark Payne,2015-11-11 08:16:38-05:00,"['d887d8fdf063b26cc76f0d1ba66f7e629ae9dd7f', 'ba5b1d837ce57f14a13dcd9cd0a18575bca79bd4']",296,330,626,1734505,3,,,,3512
76690a8ee9ac1907df711525aa2c169168c8c540,0,Oleg Zhurakousky,2015-11-11 08:33:51-05:00,['ba5b1d837ce57f14a13dcd9cd0a18575bca79bd4'],14,12,26,1734531,2,1,0,0,3512
3e538d9007bd1e67702a31cff71b9bcba85a43ae,1,Mark Payne,2015-11-11 09:12:47-05:00,['6c510fae8034ae1e5fdc8514d52f55b5f04c31d9'],1,1031,1032,1735563,5,0.331730769,0.764423077,0.91025641,3515
62e3cfc6291d1f30ac92f29cf790336644205919,1,Bryan Bende,2015-11-11 10:12:30-05:00,['6c510fae8034ae1e5fdc8514d52f55b5f04c31d9'],9,51,60,1735623,2,0,1,1,3515
70cc61bb53d0fc46468f706465f34790d714fff2,0,Bryan Bende,2015-11-11 10:12:30-05:00,['62e3cfc6291d1f30ac92f29cf790336644205919'],1,2,3,1735626,2,0,1,1,3515
a65a29921a378ed3bed3fe2717f7c418fa532166,1,Bryan Bende,2015-11-11 10:12:30-05:00,['70cc61bb53d0fc46468f706465f34790d714fff2'],13,13,26,1735652,1,,,,3515
429f6a42bb82bc20070668276b884d409d2b0ee9,0,Bryan Bende,2015-11-11 10:17:45-05:00,['a65a29921a378ed3bed3fe2717f7c418fa532166'],0,0,0,1735652,0,,,,3515
e7c6c7cae9a726cd3338e0af1879983822bd5a00,1,Mark Payne,2015-11-11 10:19:07-05:00,['3e538d9007bd1e67702a31cff71b9bcba85a43ae'],19,284,303,1735955,2,0.03125,0.739583333,0.96875,3515
054774fe7b9fa58abb9afcd6773337059c1652f6,0,Mark Payne,2015-11-11 11:17:25-05:00,"['429f6a42bb82bc20070668276b884d409d2b0ee9', '76690a8ee9ac1907df711525aa2c169168c8c540']",14,12,26,1735981,2,,,,3515
11fcad90d10ddeea721a64bb7dcfc009bc0625ba,0,Mark Payne,2015-11-11 12:07:15-05:00,"['054774fe7b9fa58abb9afcd6773337059c1652f6', 'e7c6c7cae9a726cd3338e0af1879983822bd5a00']",1,1296,1297,1737278,5,,,,3515
5baafa156a58eda7fec7366cc5116da9a2a5a9ec,1,Oleg Zhurakousky,2015-11-11 14:06:08-05:00,['6c510fae8034ae1e5fdc8514d52f55b5f04c31d9'],4,38,42,1737320,2,1,1,1,3515
854d20398242a4500b6849d2f9c7f9ec917b4ec7,0,Mark Payne,2015-11-11 14:14:54-05:00,"['11fcad90d10ddeea721a64bb7dcfc009bc0625ba', '5baafa156a58eda7fec7366cc5116da9a2a5a9ec']",4,38,42,1737362,2,,,,3515
7a165b62cc4c46f92b4b4ed7c233f464cf63b3ef,0,Mark Payne,2015-11-11 16:05:40-05:00,"['854d20398242a4500b6849d2f9c7f9ec917b4ec7', '7b9c8df6c593059d063770095ab9efcf3c82467e']",0,1177,1177,1738539,4,,,,3515
cfee612a78e4256fc0295e6ad1315ba26996ed94,0,Matt Gilman,2015-11-11 19:40:40-05:00,['0281e2773f3a8942c3794b0945675ef9336e8c28'],28,532,560,1739099,14,0.175182482,0.416058394,0.98540146,3523
56ad22aea6db7d401a72857b1356dfba85f274b6,1,Tony Kurc,2015-11-11 23:06:04-05:00,['7a165b62cc4c46f92b4b4ed7c233f464cf63b3ef'],3,644,647,1739746,11,0.380645161,1,1,3530
b3ae3e31497f2d6810c202ca0130f398c2f170ca,0,Matt Gilman,2015-11-12 09:10:29-05:00,['cfee612a78e4256fc0295e6ad1315ba26996ed94'],5,13,18,1739764,1,0,0,1,3530
5ce44b1fe29fa9583c2b68b76bc1591af08104ee,0,Matt Gilman,2015-11-12 15:38:33-05:00,['b3ae3e31497f2d6810c202ca0130f398c2f170ca'],43,740,783,1740547,20,0.361344538,0.831932773,0.953781513,3538
02102ea1c2add14df874744633f2f6dcd83d3525,0,joewitt,2015-11-12 18:00:40-05:00,['56ad22aea6db7d401a72857b1356dfba85f274b6'],0,87,87,1740634,3,1,1,1,3541
65bd8c0b1f0a32a43e4f3276bc8e606c12913bd2,0,Tony Kurc,2015-11-12 21:07:01-05:00,['02102ea1c2add14df874744633f2f6dcd83d3525'],150,168,318,1740952,5,0,0,0.777777778,3541
db7b94b8046898517597e570af4530d7e1aa6a28,0,Tony Kurc,2015-11-12 21:26:48-05:00,['65bd8c0b1f0a32a43e4f3276bc8e606c12913bd2'],0,5,5,1740957,1,,,,3541
6f82802f7a22bf0cb92a28d1ba0ebb2ea36ad85a,0,Matt Gilman,2015-11-12 21:37:10-05:00,['5ce44b1fe29fa9583c2b68b76bc1591af08104ee'],1,1,2,1740959,1,,,,3541
09cb6088595918b87753ca4281180e99dc106baa,0,Matt Gilman,2015-11-12 21:37:55-05:00,['6f82802f7a22bf0cb92a28d1ba0ebb2ea36ad85a'],8,13,21,1740980,1,1,1,1,3541
06cb7cfc108fd7809e17d8b627fd680836f42ac7,0,Matt Gilman,2015-11-12 21:48:58-05:00,['09cb6088595918b87753ca4281180e99dc106baa'],5,5,10,1740990,1,,,,3541
33ef59c5bad3715d2a4625d88f018e7adc09a7b4,1,Tony Kurc,2015-11-12 22:14:12-05:00,['db7b94b8046898517597e570af4530d7e1aa6a28'],1,7,8,1740998,3,1,1,1,3541
0900fb80c9deaf96d17c72683b9b4886b44d6180,1,Tony Kurc,2015-11-12 22:41:57-05:00,['33ef59c5bad3715d2a4625d88f018e7adc09a7b4'],2,6,8,1741006,1,0,0,1,3541
e6086420aa8af51f4fbba83810b67fc88f0f938d,0,Tony Kurc,2015-11-12 23:11:43-05:00,['0900fb80c9deaf96d17c72683b9b4886b44d6180'],0,1,1,1741007,1,,,,3541
428b20fc2553ac6ae56867630fa10bd3ac355582,0,Adam Lamar,2015-11-12 22:03:36-07:00,['e6086420aa8af51f4fbba83810b67fc88f0f938d'],1,11,12,1741019,1,0,0,1,3541
3ed0949c5578f379cab7b90ff32778bf6296404a,1,joewitt,2015-11-13 00:06:12-05:00,['e6086420aa8af51f4fbba83810b67fc88f0f938d'],14,150,164,1741183,2,0,0.956043956,1,3541
37d6b7350e964e850685498d2232f2688f1a5afc,0,joewitt,2015-11-13 00:06:12-05:00,['3ed0949c5578f379cab7b90ff32778bf6296404a'],114,139,253,1741436,2,1,1,1,3541
36d00a60f51d123d1109afedc7c49875a940f7d2,0,joewitt,2015-11-13 00:06:12-05:00,['37d6b7350e964e850685498d2232f2688f1a5afc'],1,1,2,1741438,1,,,,3541
22de23baa6ae7318574ccb112d03daf8f8dfa10e,1,Mark Payne,2015-11-13 10:46:46-05:00,['7a165b62cc4c46f92b4b4ed7c233f464cf63b3ef'],429,727,1156,1742594,3,0.267281106,0.640552995,0.700460829,3541
90f6830003b76204e25dec9fafec2488c8bda550,0,Mark Payne,2015-11-13 10:47:05-05:00,"['22de23baa6ae7318574ccb112d03daf8f8dfa10e', '36d00a60f51d123d1109afedc7c49875a940f7d2']",259,1182,1441,1744035,27,,,,3541
a4d93c62c88f594ef0cd3739a0536769f1ab9b26,0,Oleg Zhurakousky,2015-11-13 14:23:31-05:00,['36d00a60f51d123d1109afedc7c49875a940f7d2'],82,132,214,1744249,6,0.653846154,1,1,3541
c82fc18f8e306c5a31345856e529cfd9fe4c81ef,1,Jeremy Dyer,2015-11-13 15:01:10-05:00,['56ad22aea6db7d401a72857b1356dfba85f274b6'],2,1604,1606,1745855,15,0.24577573,0.760368664,0.946236559,3553
f8d26d205901d8cd782c02a5bc57e9ec66ee2f33,0,Jeremy Dyer,2015-11-13 15:02:23-05:00,"['c82fc18f8e306c5a31345856e529cfd9fe4c81ef', '90f6830003b76204e25dec9fafec2488c8bda550']",685,1265,1950,1747805,19,,,,3553
749f4e9be16e63b27c35052c0535546ad9853341,0,Matt Gilman,2015-11-13 16:19:05-05:00,['06cb7cfc108fd7809e17d8b627fd680836f42ac7'],945,1084,2029,1749834,12,0,1,0.918918919,3553
c659485ee433271ed8bdac37b5e42b32afcf0feb,0,Matt Gilman,2015-11-13 16:35:29-05:00,['749f4e9be16e63b27c35052c0535546ad9853341'],7,10,17,1749851,1,1,1,1,3553
01539ed3230894b062a7c2e42ffd9b50e3d51bf3,1,Tony Kurc,2015-11-14 18:47:50-05:00,['90f6830003b76204e25dec9fafec2488c8bda550'],35,87,122,1749973,2,0,1,1,3553
528dab78d6dbc3bb4f61663f423b07284936ec40,1,Tony Kurc,2015-11-14 18:56:43-05:00,['01539ed3230894b062a7c2e42ffd9b50e3d51bf3'],222,271,493,1750466,25,0.25,1,0.861111111,3553
da9f40b3f0aa29ba5e8ba4e257e953b52c6493e6,1,Tony Kurc,2015-11-15 08:38:51-05:00,['528dab78d6dbc3bb4f61663f423b07284936ec40'],1,2,3,1750469,2,,,,3553
64369f67f92c21be3845bf8766ccdd8cecd88adf,1,Matt Gilman,2015-11-16 08:34:04-05:00,['da9f40b3f0aa29ba5e8ba4e257e953b52c6493e6'],2,8,10,1750479,2,1,1,0,3553
15880f9fcc78e7a040e0d64d2a517390122e3fe3,0,Oleg Zhurakousky,2015-11-16 08:39:23-05:00,['a4d93c62c88f594ef0cd3739a0536769f1ab9b26'],12,24,36,1750515,2,1,1,1,3553
b954ca620e619e7961e6a7a58122b844f30862da,0,Naveen Madhire,2015-11-16 11:59:52-06:00,['64369f67f92c21be3845bf8766ccdd8cecd88adf'],19,33,52,1750567,1,0,1,1,3553
03a54bf2d593e07ab602f6a9425d0231a273ba5a,0,Naveen Madhire,2015-11-16 13:32:17-06:00,['b954ca620e619e7961e6a7a58122b844f30862da'],4,2,6,1750573,1,,,,3553
9ccf61aff1ed70534e0d819d8f160990ca5cc35a,0,Matt Gilman,2015-11-16 21:16:23-05:00,['c659485ee433271ed8bdac37b5e42b32afcf0feb'],11,110,121,1750694,3,0.136363636,0,1,3554
7529694f23cf46f977f7f1210f91ec4636f35e3e,0,Matt Gilman,2015-11-16 21:18:04-05:00,['9ccf61aff1ed70534e0d819d8f160990ca5cc35a'],791,666,1457,1752151,17,0.173410405,0.011560694,0.190751445,3557
f98e335cdec4e32fe41b8abaef8118cba7f132d1,1,Mark Payne,2015-11-17 08:16:45-05:00,['03a54bf2d593e07ab602f6a9425d0231a273ba5a'],5,11,16,1752167,1,,,,3557
d16392c6182678119b77de44c910a481305ce990,1,Mark Payne,2015-11-17 08:45:28-05:00,['f98e335cdec4e32fe41b8abaef8118cba7f132d1'],1,3,4,1752171,1,,,,3557
453b140d6bbd73bc63fa3e8cb9e7072eb7709e50,0,Mark Payne,2015-11-17 09:23:10-05:00,"['d16392c6182678119b77de44c910a481305ce990', '15880f9fcc78e7a040e0d64d2a517390122e3fe3']",82,144,226,1752397,6,,,,3557
2b9b5e008f307ff5f31c36840ec503cacae5ff30,1,Bryan Bende,2015-11-17 12:01:46-05:00,['453b140d6bbd73bc63fa3e8cb9e7072eb7709e50'],6,190,196,1752593,4,0.108910891,0.564356436,1,3557
a196207725a37aecaccc8c7858cec3a4d1c4ff55,0,Matt Gilman,2015-11-17 17:02:41-05:00,['7529694f23cf46f977f7f1210f91ec4636f35e3e'],698,971,1669,1754262,34,1,1,0.894736842,3561
4bb8b137f09219ecc7fbc81a25a3079140745b7e,0,Matt Gilman,2015-11-17 18:58:22-05:00,['a196207725a37aecaccc8c7858cec3a4d1c4ff55'],2,18,20,1754282,1,0,0,0,3561
16608aa850c7e2e4b85342cb749f8a83bed54041,0,Matt Gilman,2015-11-17 19:01:07-05:00,['4bb8b137f09219ecc7fbc81a25a3079140745b7e'],1,1,2,1754284,1,,,,3561
45b24a4b6015e14525da0feb93d0a3dbc98180f1,0,Matt Gilman,2015-11-18 08:30:44-05:00,['16608aa850c7e2e4b85342cb749f8a83bed54041'],2,4,6,1754290,1,,,,3561
caeede5773ac75061049a1c792a7b15188cae098,0,Matt Gilman,2015-11-18 08:31:08-05:00,['45b24a4b6015e14525da0feb93d0a3dbc98180f1'],0,36,36,1754326,1,,,,3562
3bc11e13d7f7dd4242881cde03c9b2ff6fc7da02,0,Matt Gilman,2015-11-18 08:31:23-05:00,['caeede5773ac75061049a1c792a7b15188cae098'],29,395,424,1754750,4,0.54601227,1,0.858895706,3563
7d04dfeac012307201e84dd00883dd6a79e6e2cc,0,Matt Gilman,2015-11-18 08:31:39-05:00,['3bc11e13d7f7dd4242881cde03c9b2ff6fc7da02'],90,264,354,1755104,5,0.120689655,0.5,1,3563
93be753301559119205803182a49a550a5aa3486,1,Aldrin Piri,2015-11-18 10:35:37-05:00,['2b9b5e008f307ff5f31c36840ec503cacae5ff30'],13,66,79,1755183,3,0.4,1,1,3563
180ea1ba222a5890541dfbe046f2876695e69239,0,Aldrin Piri,2015-11-18 10:51:22-05:00,['93be753301559119205803182a49a550a5aa3486'],3,1,4,1755187,1,1,1,0,3563
d88b6cb6bca01507103c565d2489dd83ebae5e17,0,Aldrin Piri,2015-11-18 10:56:38-05:00,['180ea1ba222a5890541dfbe046f2876695e69239'],0,1,1,1755188,1,0,0,1,3563
911e1c54126bdff53b0b853274798e4292c63540,1,Aldrin Piri,2015-11-18 13:47:59-05:00,['d88b6cb6bca01507103c565d2489dd83ebae5e17'],0,6,6,1755194,2,,,,3563
773576e041088d9e326f1d2e84b0ad8acbd6cfdc,0,Aldrin Piri,2015-11-18 13:56:21-05:00,['911e1c54126bdff53b0b853274798e4292c63540'],0,24,24,1755218,8,,,,3563
c94d0271d990df6d6cd9a1dfee7b1706f451483c,0,Matt Gilman,2015-11-18 14:01:45-05:00,['7d04dfeac012307201e84dd00883dd6a79e6e2cc'],412,591,1003,1756221,28,1,1,0.745098039,3567
69bce2c2db2619e0323434228c31f98630e43372,1,Aldrin Piri,2015-11-18 14:53:30-05:00,['773576e041088d9e326f1d2e84b0ad8acbd6cfdc'],24,207,231,1756452,13,0.557142857,0.985714286,0.957142857,3568
0fa68a5bac79178836e02627d0030e595a1d8348,0,Matt Gilman,2015-11-18 15:41:08-05:00,['c94d0271d990df6d6cd9a1dfee7b1706f451483c'],31,97,128,1756580,3,0,1,0.9,3568
3da198135e432341eba36b072dfd0f7f6395b4c6,0,Matt Gilman,2015-11-18 15:44:47-05:00,['0fa68a5bac79178836e02627d0030e595a1d8348'],22,33,55,1756635,7,1,1,0.8,3568
c541c82c354a53774743f380e23898cbddd4d203,0,Aldrin Piri,2015-11-18 16:38:15-05:00,['69bce2c2db2619e0323434228c31f98630e43372'],0,2,2,1756637,1,,,,3568
ab7940368a18e8d29d8fadcc435db8ae8b4ee001,0,Aldrin Piri,2015-11-18 17:37:47-05:00,['c541c82c354a53774743f380e23898cbddd4d203'],17,6,23,1756660,2,0.75,0,0,3568
242949ee98836794fd18d2503c275c84bfd41a9f,0,Matt Gilman,2015-11-18 18:23:59-05:00,['3da198135e432341eba36b072dfd0f7f6395b4c6'],21,71,92,1756752,7,0,1,0.571428571,3569
9f60411b1501bb5faf9c2f1812f6e349329dd9b8,0,Matt Gilman,2015-11-18 18:37:12-05:00,['242949ee98836794fd18d2503c275c84bfd41a9f'],1,1,2,1756754,1,,,,3569
52b24b93d9f7763744c792c0cfed8974f8e6cb83,1,Tony Kurc,2015-11-18 19:10:21-05:00,['ab7940368a18e8d29d8fadcc435db8ae8b4ee001'],2,163,165,1756919,2,0.139534884,0.984496124,0.984496124,3569
9e2f6df20511b814b761726e40f2d3b1f498cc9f,0,Tony Kurc,2015-11-18 21:59:42-05:00,['52b24b93d9f7763744c792c0cfed8974f8e6cb83'],1,1,2,1756921,1,,,,3569
1e5cc070a3d29736beea9af0b2d684a9bdcfff8e,1,Tony Kurc,2015-11-18 23:23:10-05:00,['9e2f6df20511b814b761726e40f2d3b1f498cc9f'],55,488,543,1757464,5,0.172638436,0.912052117,0.90228013,3570
e862f7ff0393f60ba96afd9c97e756c745f0a19b,1,Tony Kurc,2015-11-19 01:01:28-05:00,['1e5cc070a3d29736beea9af0b2d684a9bdcfff8e'],44,100,144,1757608,2,0.055555556,0.583333333,0.916666667,3570
fb335ea282961a236381f78fe18939c15afb66a0,0,Tony Kurc,2015-11-19 01:01:34-05:00,['e862f7ff0393f60ba96afd9c97e756c745f0a19b'],1,38,39,1757647,2,0,0,1,3570
8c2323dc8d0e107f1a99898370c7515fa9603122,1,Aldrin Piri,2015-11-19 01:40:21-05:00,['fb335ea282961a236381f78fe18939c15afb66a0'],729,1603,2332,1759979,6,0,0.619642857,0.646428571,3570
2a0439ca06b81b27cbbed2058307af778169d9e6,0,Matt Gilman,2015-11-19 08:29:39-05:00,['9f60411b1501bb5faf9c2f1812f6e349329dd9b8'],96,77,173,1760152,7,1,1,1,3570
40dd8a0a845ef5f4d4fde451f02376ab2fab9758,1,Bryan Bende,2015-11-19 13:49:02-05:00,['8c2323dc8d0e107f1a99898370c7515fa9603122'],192,1099,1291,1761443,15,0.292631579,0.76,0.673684211,3574
08d59e437462dfcec3e1f7347bcd6941ee47818a,1,Aldrin Piri,2015-11-19 17:42:15-05:00,['40dd8a0a845ef5f4d4fde451f02376ab2fab9758'],1,14,15,1761458,6,0,0,1,3574
f1f67f6395e44775c70355688d04a46499176757,0,Bryan Bende,2015-11-20 10:45:21-05:00,['08d59e437462dfcec3e1f7347bcd6941ee47818a'],1,1,2,1761460,1,,,,3574
cdd2c4f22cf9d309aff6ea2fa57f9557bc243006,1,Tony Kurc,2015-11-21 19:20:33-05:00,['f1f67f6395e44775c70355688d04a46499176757'],10,9,19,1761479,1,0,0,1,3574
1580edb558e96dc49a40b50e8f5fd7e31e61371d,0,Tony Kurc,2015-11-21 20:21:36-05:00,['cdd2c4f22cf9d309aff6ea2fa57f9557bc243006'],1,1,2,1761481,1,,,,3574
327342916e353b6c7e7fdc787375b4b30c42fde3,1,Tony Kurc,2015-11-21 22:57:19-05:00,['1580edb558e96dc49a40b50e8f5fd7e31e61371d'],11,94,105,1761586,6,,,,3579
b74617ba6a18247f0c3ab9ee506ce968d9da51af,1,Tony Kurc,2015-11-22 08:29:14-05:00,['327342916e353b6c7e7fdc787375b4b30c42fde3'],26,26,52,1761638,1,,,,3579
48c65e0498b1288729a99bff6247522c982134f0,0,Matt Gilman,2015-11-23 08:09:49-05:00,['2a0439ca06b81b27cbbed2058307af778169d9e6'],18,22,40,1761678,2,0,0,1,3579
91573cb807f6399cebb8ce8d19fad1758578811c,0,Matt Gilman,2015-11-23 08:45:24-05:00,['48c65e0498b1288729a99bff6247522c982134f0'],28,8,36,1761714,2,0,0,0,3579
e61a36908917c4053417cf2717acdc4711962b2b,0,Matt Gilman,2015-11-23 09:19:32-05:00,['91573cb807f6399cebb8ce8d19fad1758578811c'],3,73,76,1761790,2,,,,3579
ec50a2de8c6901bff366539ace328443a2664209,0,Matt Gilman,2015-11-23 09:37:27-05:00,['e61a36908917c4053417cf2717acdc4711962b2b'],2,6,8,1761798,1,,,,3579
3ffb455903745e06e06a3c9f1854cdde243ebfd8,0,Bryan Bende,2015-11-23 10:30:33-05:00,['b74617ba6a18247f0c3ab9ee506ce968d9da51af'],1,3,4,1761802,2,0,0.5,1,3579
5ef53b6fe349c1eb2a1f5d5b91435a5745f57571,0,Matt Gilman,2015-11-23 12:14:01-05:00,['ec50a2de8c6901bff366539ace328443a2664209'],0,5,5,1761807,1,0,0,1,3579
2516b1dad24e39efaeac49a244eea42847602e06,1,Mark Payne,2015-11-23 14:11:14-05:00,['8c2323dc8d0e107f1a99898370c7515fa9603122'],346,487,833,1762640,2,0.229508197,1,0,3579
4e2c94d6590e57b3aa7fa4a9180626a48b9ae2e2,0,Mark Payne,2015-11-23 14:18:50-05:00,"['2516b1dad24e39efaeac49a244eea42847602e06', 'b74617ba6a18247f0c3ab9ee506ce968d9da51af']",235,1237,1472,1764112,29,,,,3579
aaf14c45c96077c0075af8f3442e392b717244c1,1,Matt Gilman,2015-11-23 14:50:13-05:00,['4e2c94d6590e57b3aa7fa4a9180626a48b9ae2e2'],2409,8676,11085,1775197,192,0.504730369,0.771050142,0.886944182,3647
769f19ee867f69e2d3bf157cae0a1f09ea4f24fa,0,Matt Gilman,2015-11-23 15:21:47-05:00,"['aaf14c45c96077c0075af8f3442e392b717244c1', '5ef53b6fe349c1eb2a1f5d5b91435a5745f57571']",0,0,0,1775197,0,,,,3647
a5754986e2d46a13c9b1373d6befba24c08db016,0,Matt Gilman,2015-11-23 15:55:24-05:00,['769f19ee867f69e2d3bf157cae0a1f09ea4f24fa'],1,1,2,1775199,1,,,,3647
36eaddb7de295a313c0e677afd99a956ec15f04f,0,Matt Gilman,2015-11-23 16:51:24-05:00,['a5754986e2d46a13c9b1373d6befba24c08db016'],1,1,2,1775201,1,,,,3647
f2d82ee1403579c73928259c61e129737856e02c,0,Matt Gilman,2015-11-23 16:53:26-05:00,['36eaddb7de295a313c0e677afd99a956ec15f04f'],4,4,8,1775209,3,,,,3647
4281a51c83c45382b828d4bdcd621b2972057d78,0,Bryan Bende,2015-11-23 21:35:57-05:00,"['4e2c94d6590e57b3aa7fa4a9180626a48b9ae2e2', '3ffb455903745e06e06a3c9f1854cdde243ebfd8']",1,3,4,1775213,2,,,,3647
1312bde498aadbafc706f4de7b955d20c6d2d036,1,Matt Gilman,2015-11-24 00:37:47-05:00,['f2d82ee1403579c73928259c61e129737856e02c'],57,87,144,1775357,8,1,0,1,3647
d949ee1a1ee529fbf0103b4620fef47832132a53,1,Oleg Zhurakousky,2015-11-24 12:14:36-05:00,['f1f67f6395e44775c70355688d04a46499176757'],84,213,297,1775654,4,0.470588235,0.568627451,0,3648
657885e5ba8210c76c7d023b2841ef0ac0a64f28,0,Mark Payne,2015-11-25 12:30:15-05:00,"['4e2c94d6590e57b3aa7fa4a9180626a48b9ae2e2', 'd949ee1a1ee529fbf0103b4620fef47832132a53']",84,213,297,1775951,4,,,,3648
4fa2a713a2f4df901f0efa321db40682bb950ce9,1,Mark Payne,2015-11-25 12:57:06-05:00,['657885e5ba8210c76c7d023b2841ef0ac0a64f28'],7,4,11,1775962,1,1,1,0,3648
e1742c5a0414077bfd6688cc96332713b7dc7468,0,Mark Payne,2015-11-25 13:03:22-05:00,"['4fa2a713a2f4df901f0efa321db40682bb950ce9', '4281a51c83c45382b828d4bdcd621b2972057d78']",1,3,4,1775966,2,,,,3648
c073253366acf3bab28e530c1deab512735e5d7c,1,Matt Gilman,2015-11-25 14:17:23-05:00,['1312bde498aadbafc706f4de7b955d20c6d2d036'],441,390,831,1776797,25,0,1,0,3648
04359111869a252039bfce42eccbada8e83a8594,1,joewitt,2015-11-25 14:50:56-05:00,['e1742c5a0414077bfd6688cc96332713b7dc7468'],96,69,165,1776962,4,1,1,0,3648
a29b7b3bf0d564a4f4ae622c7fdc37b80fed6e96,1,joewitt,2015-11-25 15:32:41-05:00,['04359111869a252039bfce42eccbada8e83a8594'],4,16,20,1776982,1,1,1,1,3648
5061e5fa0a5625d1a7605a83795c5ac4cf1c5938,0,joewitt,2015-11-25 16:26:59-05:00,['a29b7b3bf0d564a4f4ae622c7fdc37b80fed6e96'],15,6,21,1777003,1,0.833333333,0.5,0.166666667,3648
6bce858e4ae37fd10a6651428741a99a4b893d52,1,Matt Gilman,2015-11-25 16:42:22-05:00,['c073253366acf3bab28e530c1deab512735e5d7c'],4,41,45,1777048,7,0.857142857,1,1,3651
4c4d62c61f7c828dbcb124090992b91d631cb22e,1,trkurc,2015-11-25 18:03:19-05:00,['5061e5fa0a5625d1a7605a83795c5ac4cf1c5938'],0,996,996,1778044,3,0.159539474,0.703947368,0.960526316,3653
ba83bf9c051b337b98d7c8dfa322364c87ce5955,1,trkurc,2015-11-25 18:03:19-05:00,['4c4d62c61f7c828dbcb124090992b91d631cb22e'],4,574,578,1778622,6,0.266881029,0.691318328,0.971061093,3655
226ac64ef95f3d755dfbb3d5288ba98052855473,0,trkurc,2015-11-25 18:03:19-05:00,['ba83bf9c051b337b98d7c8dfa322364c87ce5955'],9,12,21,1778643,2,1,1,0,3655
66926452091502d621817c5f31f5693f87a2a29b,0,Tony Kurc,2015-11-25 22:06:45-05:00,['226ac64ef95f3d755dfbb3d5288ba98052855473'],2,2,4,1778647,1,,,,3655
a3cb8031473b22bf30ed6301d6035375c918428b,0,Tony Kurc,2015-11-25 23:09:49-05:00,['66926452091502d621817c5f31f5693f87a2a29b'],77,5,82,1778729,1,1,0,0,3655
67aed5eb92f253cb06e13d8bba2feb5af0689897,0,Tony Kurc,2015-11-26 00:33:54-05:00,['a3cb8031473b22bf30ed6301d6035375c918428b'],21,19,40,1778769,1,,,,3655
9aa9c27dbe70d6450b8815a7ee945dc927e7e4c8,1,joewitt,2015-11-26 00:41:15-05:00,['67aed5eb92f253cb06e13d8bba2feb5af0689897'],1,87,88,1778857,2,0.692307692,1,0.769230769,3655
757202b63e98ca0e9b60ca811f48054b0b4cefc7,1,joewitt,2015-11-26 01:03:53-05:00,['9aa9c27dbe70d6450b8815a7ee945dc927e7e4c8'],4,10,14,1778871,1,0,0,1,3655
0609a84fa2b84085cea48cfb60095fd75a3bf07a,0,joewitt,2015-11-26 09:28:50-05:00,['757202b63e98ca0e9b60ca811f48054b0b4cefc7'],2,2,4,1778875,1,,,,3655
c1cc165edb2fdacdcc958f8b4b1dcf97bf40eb5f,0,Matt Gilman,2015-11-27 10:05:58-05:00,['6bce858e4ae37fd10a6651428741a99a4b893d52'],35,47,82,1778957,2,1,1,1,3655
64beeef5937e972c502888abc84adf1328295d04,0,Matt Gilman,2015-11-27 14:13:40-05:00,['c1cc165edb2fdacdcc958f8b4b1dcf97bf40eb5f'],24,34,58,1779015,6,0,0,1,3655
fd35b8ffd7d4a66ef149c1bd1341dfee3ede80c7,0,joewitt,2015-11-28 17:44:31-05:00,['0609a84fa2b84085cea48cfb60095fd75a3bf07a'],2,62,64,1779079,2,1,1,1,3656
3e26ed810596fdc798f1e190958974d9d1b1cd21,0,Jeremy Dyer,2015-11-30 10:12:39-05:00,"['f8d26d205901d8cd782c02a5bc57e9ec66ee2f33', 'fd35b8ffd7d4a66ef149c1bd1341dfee3ede80c7']",2074,7159,9233,1788312,134,,,,3656
c9d59fa8192c8791dd55344ab90f7eddefec2215,0,Jeremy Dyer,2015-11-30 10:13:52-05:00,['3e26ed810596fdc798f1e190958974d9d1b1cd21'],1,1,2,1788314,1,,,,3656
99016a835eba1048a1246f920ed1f8097fd64f3d,0,Matt Gilman,2015-11-30 12:38:17-05:00,['64beeef5937e972c502888abc84adf1328295d04'],0,5,5,1788319,1,0,0,1,3656
a84e505bcd97c79a4c91ed7f34f18988c11bc267,1,Matt Gilman,2015-11-30 14:47:30-05:00,['99016a835eba1048a1246f920ed1f8097fd64f3d'],4,8,12,1788331,3,0,0,1,3656
c722b563351652702db70f1cc1501ff6754ffc70,0,Matt Gilman,2015-11-30 14:57:38-05:00,['a84e505bcd97c79a4c91ed7f34f18988c11bc267'],4,3,7,1788338,1,,,,3656
774d626f88c13098f69aac0fbb88902defa677df,0,Matt Gilman,2015-11-30 15:07:40-05:00,['c722b563351652702db70f1cc1501ff6754ffc70'],6,13,19,1788357,3,,,,3656
07c619cf40affef136e61f87d2075853e392bfc3,1,Mark Payne,2015-11-30 15:37:58-05:00,['04359111869a252039bfce42eccbada8e83a8594'],23,50,73,1788430,2,0,1,1,3656
c59087bc3aeea240a344531e6be0166a25d0d753,0,Mark Payne,2015-11-30 16:02:36-05:00,"['fd35b8ffd7d4a66ef149c1bd1341dfee3ede80c7', '07c619cf40affef136e61f87d2075853e392bfc3']",23,50,73,1788503,2,,,,3656
014b2ac4e8c9e0eb22d9658c79752f6e855e5269,0,Matt Gilman,2015-11-30 16:30:12-05:00,['774d626f88c13098f69aac0fbb88902defa677df'],7,0,7,1788510,1,1,1,0,3656
2b0819a5f2d2d22085caf3d7a9e7779caf91124e,0,Matt Gilman,2015-11-30 16:33:11-05:00,['014b2ac4e8c9e0eb22d9658c79752f6e855e5269'],3,0,3,1788513,1,,,,3656
e5281f1fc1865c653f8e2147622229d55c7d9ab1,1,Bryan Bende,2015-11-30 17:32:49-05:00,['c59087bc3aeea240a344531e6be0166a25d0d753'],169,669,838,1789351,6,0.24291498,0.538461538,1,3658
c100052dac7c1366767e78c088da50ffb27958b4,1,Matt Gilman,2015-12-01 08:51:45-05:00,['2b0819a5f2d2d22085caf3d7a9e7779caf91124e'],12,20,32,1789383,1,0,0,0,3658
85eb8defdd0bb8b91c627493f6218b77c370c071,0,Matt Gilman,2015-12-01 09:36:33-05:00,['c100052dac7c1366767e78c088da50ffb27958b4'],1,1,2,1789385,1,,,,3658
e22b51f3a7fee3b7079ea2007d88ffad4f60596b,1,Matt Gilman,2015-12-01 10:08:36-05:00,['85eb8defdd0bb8b91c627493f6218b77c370c071'],49,49,98,1789483,11,,,,3658
7726d069cdc98ec1b9d9be32c163ab09973e0073,0,Matt Gilman,2015-12-01 11:20:56-05:00,"['e5281f1fc1865c653f8e2147622229d55c7d9ab1', 'e22b51f3a7fee3b7079ea2007d88ffad4f60596b']",2495,8813,11308,1800791,199,,,,3658
307189d15b8fcb5fc49008cf7b9951aeadeed90c,0,Mark Payne,2015-12-01 15:45:51-05:00,"['7726d069cdc98ec1b9d9be32c163ab09973e0073', '428b20fc2553ac6ae56867630fa10bd3ac355582']",1,11,12,1800803,1,,,,3658
9dafe2db6ac17d4475ed61315a145cd419d8e1ef,0,Mark Payne,2015-12-01 15:56:59-05:00,['307189d15b8fcb5fc49008cf7b9951aeadeed90c'],2,3,5,1800808,1,,,,3658
fbaf1c36de0ae8502daf408dea02e900bf642dce,0,joewitt,2015-12-01 16:06:48-05:00,['9dafe2db6ac17d4475ed61315a145cd419d8e1ef'],1,1,2,1800810,1,,,,3658
55352ae5b1252201b2a3058c45392b7fb0ec90df,1,Tony Kurc,2015-12-01 20:32:00-05:00,['fbaf1c36de0ae8502daf408dea02e900bf642dce'],14,114,128,1800938,6,0,0.704545455,1,3658
fcc032c7fd8bc4b0be2e756ca170a5602e18fb85,0,Tony Kurc,2015-12-01 20:33:07-05:00,['55352ae5b1252201b2a3058c45392b7fb0ec90df'],0,5,5,1800943,1,,,,3658
8f92ac99318edd05f261932cdffd24fcaf4afb49,1,Tony Kurc,2015-12-01 20:33:21-05:00,['fcc032c7fd8bc4b0be2e756ca170a5602e18fb85'],1,12,13,1800956,1,1,1,0,3658
0f15f261f85d0ca72560eaef43fc345d6d29b1b5,0,joewitt,2015-12-01 20:43:31-05:00,['8f92ac99318edd05f261932cdffd24fcaf4afb49'],1,1,2,1800958,1,,,,3658
3a7ddc6a35f143c1d4a735226fe7467a83d04583,0,Tony Kurc,2015-12-01 22:49:51-05:00,['0f15f261f85d0ca72560eaef43fc345d6d29b1b5'],21078,21078,42156,1843114,144,,,,3658
ff5330d7f27fefede59b804210741e845d39693f,0,joewitt,2015-12-01 22:53:09-05:00,['3a7ddc6a35f143c1d4a735226fe7467a83d04583'],1,5,6,1843120,1,0,0,1,3658
6a8c2dba12ea852d2b43162196adc6587854fbbf,0,joewitt,2015-12-01 22:53:42-05:00,['ff5330d7f27fefede59b804210741e845d39693f'],2,4,6,1843126,1,,,,3658
663b7f2561424ee9a9ce7070d783f63854e698b2,1,joewitt,2015-12-02 16:23:48-05:00,['6a8c2dba12ea852d2b43162196adc6587854fbbf'],1,1,2,1843128,1,,,,3658
02dc7e82b248e3204554ba0ef41529b094a502b0,0,Mark Payne,2015-12-02 16:39:40-05:00,['6a8c2dba12ea852d2b43162196adc6587854fbbf'],1,1,2,1843130,1,,,,3658
69598a0b40719118cd2b80f88cd818ba87dcf5da,0,Mark Payne,2015-12-02 17:41:18-05:00,"['02dc7e82b248e3204554ba0ef41529b094a502b0', '663b7f2561424ee9a9ce7070d783f63854e698b2']",1,1,2,1843132,1,,,,3658
bde270a9118a00ecd3ee476dc1314a7fc3240a74,1,Aldrin Piri,2015-12-02 19:37:09-05:00,['69598a0b40719118cd2b80f88cd818ba87dcf5da'],2,1,3,1843135,1,0,0,0,3658
ecc240b9181dc7a75758ed39f21ef0a416305ed1,0,Tony Kurc,2015-12-02 20:16:08-05:00,['bde270a9118a00ecd3ee476dc1314a7fc3240a74'],20,122,142,1843277,2,0.444444444,0.952380952,1,3658
6b75eda9ab6fd509bd813e149f99a02bf2466943,1,Mark Payne,2015-12-03 09:48:27-05:00,['ecc240b9181dc7a75758ed39f21ef0a416305ed1'],5,25,30,1843307,1,0.090909091,0.090909091,1,3658
eceb1d20c771cdadc7c1ee8dfefa7abdf9726e42,1,Mark Payne,2015-12-03 10:02:36-05:00,['6b75eda9ab6fd509bd813e149f99a02bf2466943'],46,1,47,1843354,1,1,1,1,3658
4653908b22aebf0f590d2e47c25506ded24ca63e,1,Bryan Bende,2015-12-03 11:42:33-05:00,['eceb1d20c771cdadc7c1ee8dfefa7abdf9726e42'],69,345,414,1843768,5,0.440251572,0.685534591,0.823899371,3658
ca79c146fdf1e3960af1f9d05056323eb34187a6,0,Mark Payne,2015-12-03 12:13:23-05:00,['eceb1d20c771cdadc7c1ee8dfefa7abdf9726e42'],4,0,4,1843772,1,,,,3658
dae25accb781f82f9d55c085ad525a10322e2097,0,Mark Payne,2015-12-03 12:13:33-05:00,"['ca79c146fdf1e3960af1f9d05056323eb34187a6', '4653908b22aebf0f590d2e47c25506ded24ca63e']",69,345,414,1844186,5,,,,3658
6bdcd3913f8ec39633cf4f1dd8c74ad9d59447c3,0,Mark Payne,2015-12-03 14:12:23-05:00,['dae25accb781f82f9d55c085ad525a10322e2097'],1,1,2,1844188,1,,,,3658
3656c883c7ed35f0dcda73ebb89ee83b0bc2f1b1,0,Aldrin Piri,2015-12-03 14:46:02-05:00,['6bdcd3913f8ec39633cf4f1dd8c74ad9d59447c3'],1,2,3,1844191,1,,,,3658
3b7512ebacf6317481315c23c56fdf149167824f,1,Mark Payne,2015-12-03 16:06:03-05:00,['dae25accb781f82f9d55c085ad525a10322e2097'],68,38,106,1844297,2,1,1,0,3658
76914ead03bb43c1666b5d3a87ee8ff96b520447,0,Mark Payne,2015-12-03 16:35:19-05:00,"['6bdcd3913f8ec39633cf4f1dd8c74ad9d59447c3', '3b7512ebacf6317481315c23c56fdf149167824f']",68,38,106,1844403,2,,,,3658
dce039b54f2fa1fbecce5d5d5fac14f54322f32d,0,Mark Payne,2015-12-03 16:35:33-05:00,"['76914ead03bb43c1666b5d3a87ee8ff96b520447', '3656c883c7ed35f0dcda73ebb89ee83b0bc2f1b1']",1,2,3,1844406,1,,,,3658
dae73c52a75f61f3d6c9192df292d2326d76dd43,0,Matt Gilman,2015-12-03 13:49:56-08:00,['dce039b54f2fa1fbecce5d5d5fac14f54322f32d'],0,1,1,1844407,1,0,1,1,3658
0f3a620154beadd172fec708d0a0ad2960fcb688,1,Matt Gilman,2015-12-04 12:58:02-05:00,['dae73c52a75f61f3d6c9192df292d2326d76dd43'],4,4,8,1844415,2,,,,3658
f378ee902127bd29b168c9bb15e991abe4eab0fa,1,Mark Payne,2015-12-04 13:17:37-05:00,['dce039b54f2fa1fbecce5d5d5fac14f54322f32d'],322,654,976,1845391,29,0.411042945,0.656441718,0.552147239,3658
14b3349e8d5bab515d83b854f23fa00439bd408d,0,Mark Payne,2015-12-04 15:11:47-05:00,['dce039b54f2fa1fbecce5d5d5fac14f54322f32d'],27,46,73,1845464,2,0,1,1,3658
903f4981a2916a815bcf88001def73cd1d784af9,0,Mark Payne,2015-12-04 15:14:10-05:00,"['14b3349e8d5bab515d83b854f23fa00439bd408d', '0f3a620154beadd172fec708d0a0ad2960fcb688']",4,5,9,1845473,3,,,,3658
ee14d8f9dd0c3f18920d910fcddd6d79b8b9f9cf,0,Mark Payne,2015-12-04 16:38:49-05:00,"['903f4981a2916a815bcf88001def73cd1d784af9', 'f378ee902127bd29b168c9bb15e991abe4eab0fa']",322,654,976,1846449,29,,,,3658
f83e6d33c592e3a061b0bf6c41884c42f4971379,0,Aldrin Piri,2015-12-04 19:45:10-05:00,['ee14d8f9dd0c3f18920d910fcddd6d79b8b9f9cf'],105,440,545,1846994,9,0.170454545,0.602272727,0.965909091,3662
bd3fd870ac508b41472890dd4410c4bdb23a68e1,0,Mark Payne,2015-12-07 09:53:33-05:00,['f83e6d33c592e3a061b0bf6c41884c42f4971379'],0,4,4,1846998,1,0,1,1,3662
bfe6fad502a30e5b4dbf0973f7c696d7161e4e7d,0,Mark Payne,2015-12-07 10:19:49-05:00,['f83e6d33c592e3a061b0bf6c41884c42f4971379'],10,10,20,1847018,2,,,,3662
4c7894bcccc69589f7efd98e2050ddf19354f4ca,0,Matt Gilman,2015-12-07 12:20:18-05:00,['bd3fd870ac508b41472890dd4410c4bdb23a68e1'],0,1,1,1847019,1,,,,3662
1f4ef9f5fa38bab9a29102b4a1367063b622ed02,0,Matt Gilman,2015-12-07 15:04:09-05:00,['4c7894bcccc69589f7efd98e2050ddf19354f4ca'],0,47,47,1847066,3,,,,3663
46623c2bf3153c50c9187415a2001ac9b3a26baa,0,Mark Payne,2015-12-07 15:13:12-05:00,"['1f4ef9f5fa38bab9a29102b4a1367063b622ed02', 'bfe6fad502a30e5b4dbf0973f7c696d7161e4e7d']",10,10,20,1847086,2,,,,3663
fee9f381a7a90afc703c4e72e5aa6532831447c5,1,joewitt,2015-12-07 17:09:17-05:00,['46623c2bf3153c50c9187415a2001ac9b3a26baa'],1,7,8,1847094,1,0,1,1,3663
ee7eeb0493a850c932b5e5e72eb24cdbb359b4ed,0,Aldrin Piri,2015-12-07 19:50:37-05:00,['46623c2bf3153c50c9187415a2001ac9b3a26baa'],31,37,68,1847162,2,0,1,1,3663
08d0f3e59622d26ebc90d9fd61561e6be3e151fa,0,Aldrin Piri,2015-12-07 20:12:44-05:00,['ee7eeb0493a850c932b5e5e72eb24cdbb359b4ed'],14,13,27,1847189,2,1,0,0,3663
9524f637666136a3c69cd852137c2262eee9efda,0,joewitt,2015-12-07 20:38:44-05:00,"['fee9f381a7a90afc703c4e72e5aa6532831447c5', '08d0f3e59622d26ebc90d9fd61561e6be3e151fa']",45,50,95,1847284,3,,,,3663
0c7617b686ac6cf0904fed1ab8afa1ba2ea6fa83,0,joewitt,2015-12-07 20:42:07-05:00,['9524f637666136a3c69cd852137c2262eee9efda'],11,0,11,1847295,1,1,0,0,3663
3ecccf02def9a284fa3da0eb0c3cc7e531b1df7d,0,joewitt,2015-12-07 20:44:21-05:00,['0c7617b686ac6cf0904fed1ab8afa1ba2ea6fa83'],4,0,4,1847299,1,1,0,0,3663
d1395ea7eea71fa20b520bc61d9278b2a1b33938,0,joewitt,2015-12-07 21:18:33-05:00,['3ecccf02def9a284fa3da0eb0c3cc7e531b1df7d'],0,3,3,1847302,1,0,1,1,3663
10803c81d9d54cdca320647b290aa14b886c8063,0,joewitt,2015-12-07 21:28:07-05:00,['d1395ea7eea71fa20b520bc61d9278b2a1b33938'],1,0,1,1847303,1,1,0,0,3663
ba2719836bdcd36aa328dc784311bf6d84f14ea5,0,joewitt,2015-12-07 22:18:31-05:00,['10803c81d9d54cdca320647b290aa14b886c8063'],2,0,2,1847305,1,,,,3663
fb65cf1235d7a1176c58244bc4307f72de0e2a5d,1,Aldrin Piri,2015-12-08 10:54:29-05:00,['ba2719836bdcd36aa328dc784311bf6d84f14ea5'],5,6,11,1847316,2,0,0,1,3663
854c667bd3382c370bee39a778597562c05f418e,1,Aldrin Piri,2015-12-08 11:13:05-05:00,['fb65cf1235d7a1176c58244bc4307f72de0e2a5d'],1,18,19,1847335,3,,,,3664
b66c029090f395c0cbc001fd483e86895b133e46,0,joewitt,2015-12-08 12:59:59-05:00,['fb65cf1235d7a1176c58244bc4307f72de0e2a5d'],312,308,620,1847955,159,,,,3664
d755e43ec8f38e82b4517d950b88ea14dc80a6dd,0,joewitt,2015-12-08 13:00:10-05:00,['b66c029090f395c0cbc001fd483e86895b133e46'],302,302,604,1848559,159,,,,3664
8070a9f1ccbb620429812dc80e74494d2df10c99,0,Matt Gilman,2015-12-11 10:59:41-05:00,['854c667bd3382c370bee39a778597562c05f418e'],4,9,13,1848572,1,0,0,0,3664
a7b09a57c59a72c11b5f956a044bb009606218b1,0,joewitt,2015-12-11 17:14:26-05:00,"['8070a9f1ccbb620429812dc80e74494d2df10c99', 'd755e43ec8f38e82b4517d950b88ea14dc80a6dd']",311,307,618,1849190,159,,,,3664
f9f04439fd9ff2debc28720d8257bd552ca014a7,0,Matt Gilman,2015-12-14 12:41:45-05:00,['a7b09a57c59a72c11b5f956a044bb009606218b1'],1,28,29,1849219,1,,,,3664
17be1c2d9fb711c5dc2288bb1cc995bc0b355fba,1,Joseph Percivall,2015-12-14 18:09:11-05:00,['f9f04439fd9ff2debc28720d8257bd552ca014a7'],41,134,175,1849394,4,0.145833333,0.9375,1,3664
c75b5cfcea7719550841cad08fba726d718b8ce8,0,jpercivall,2015-12-15 10:05:44-05:00,['17be1c2d9fb711c5dc2288bb1cc995bc0b355fba'],3,8,11,1849405,2,1,1,1,3664
51b8ecd01b8d83c76e69259188df05916695771b,0,Matt Gilman,2015-12-15 12:51:14-05:00,['c75b5cfcea7719550841cad08fba726d718b8ce8'],5,1,6,1849411,1,1,0,0,3664
b19ff7cf37162934cafabdf46dedd4afc46f2a82,1,Matt Gilman,2015-12-16 10:53:15-05:00,['51b8ecd01b8d83c76e69259188df05916695771b'],13,63,76,1849487,6,0.608695652,0.869565217,1,3664
37635232c708ed5bdb63033751a74a9aca40b12f,0,jpercivall,2015-12-16 14:25:28-05:00,['b19ff7cf37162934cafabdf46dedd4afc46f2a82'],6,19,25,1849512,4,1,1,1,3664
7c87968260a293388ba0081104fb7ac4b836430e,0,jpercivall,2015-12-16 14:25:28-05:00,['37635232c708ed5bdb63033751a74a9aca40b12f'],4,3,7,1849519,1,,,,3664
04e9606770a47d36aae07f152e52e055c5bb3a62,0,joewitt,2015-12-17 09:24:28-08:00,['7c87968260a293388ba0081104fb7ac4b836430e'],3,4,7,1849526,1,,,,3664
f239be289e280b1b7d458fbfe028944c089c2501,0,joewitt,2015-12-18 09:12:32-05:00,['04e9606770a47d36aae07f152e52e055c5bb3a62'],6,7,13,1849539,1,0,1,1,3664
fa4c5314caed6960f9d2a9e9c115e7594972cee3,0,Mark Payne,2015-12-18 11:50:39-05:00,['f239be289e280b1b7d458fbfe028944c089c2501'],1,1,2,1849541,1,,,,3664
9ca0f95d0685fc1a76a50eae978638916f1dbbcd,0,Mark Payne,2015-12-18 11:51:42-05:00,['fa4c5314caed6960f9d2a9e9c115e7594972cee3'],0,14,14,1849555,1,1,1,1,3664
1869b44682b44fbd5e12b164a45178a235554baf,0,joewitt,2015-12-18 12:08:23-05:00,['9ca0f95d0685fc1a76a50eae978638916f1dbbcd'],1,2,3,1849558,1,1,1,1,3664
bd4f31a4c20e104aa886edfe643b7eb175046467,1,joewitt,2015-12-18 12:08:31-05:00,['1869b44682b44fbd5e12b164a45178a235554baf'],2,12,14,1849572,2,1,0,1,3664
4249fc943a5c6487cd2c19c646497bb95893a96e,1,Bryan Bende,2015-12-18 13:08:51-05:00,['bd4f31a4c20e104aa886edfe643b7eb175046467'],105,208,313,1849885,3,1,1,1,3664
608287f9fe925acc1257866a34cc40dfd228cbd3,1,Matt Gilman,2015-12-18 15:57:38-05:00,['4249fc943a5c6487cd2c19c646497bb95893a96e'],47,56,103,1849988,4,1,,,3664
bef3fc8b40cec21fd7ce86fde3e812fd348f1341,1,joewitt,2015-12-18 16:08:41-05:00,['608287f9fe925acc1257866a34cc40dfd228cbd3'],30,32,62,1850050,1,0,0,1,3664
0436383f497a444d545fb4ba8291fded2b3ee992,0,joewitt,2015-12-18 17:02:33-05:00,['bef3fc8b40cec21fd7ce86fde3e812fd348f1341'],1,2,3,1850053,1,1,0,1,3664
43c7ecd221a5c3253562ec4805719b9848002a71,0,joewitt,2015-12-18 17:02:40-05:00,['0436383f497a444d545fb4ba8291fded2b3ee992'],10,40,50,1850103,4,0.333333333,1,1,3664
0a58ab47b96d1fdf5e283f4f7d0fa2a27f06d1c4,1,joewitt,2015-12-18 17:35:46-05:00,['43c7ecd221a5c3253562ec4805719b9848002a71'],1,5,6,1850109,1,1,1,1,3664
05395eeca597aefc1b96e0353e46b668f9056bbc,0,joewitt,2015-12-18 21:33:07-05:00,['0a58ab47b96d1fdf5e283f4f7d0fa2a27f06d1c4'],16,25,41,1850150,1,0,0,1,3664
51821e01b69093cf8b55f1e63981399d9ba7a4f3,0,joewitt,2015-12-19 00:06:35-05:00,['05395eeca597aefc1b96e0353e46b668f9056bbc'],3,4,7,1850157,1,,,,3664
fb514837770ea082c349822a689da3ff7400690f,0,joewitt,2015-12-19 00:07:34-05:00,['51821e01b69093cf8b55f1e63981399d9ba7a4f3'],19,6,25,1850182,4,0,0,0,3664
d624ea48665041ffd9aa4f246b374bde10cfc878,0,joewitt,2015-12-19 00:40:53-05:00,['fb514837770ea082c349822a689da3ff7400690f'],302,302,604,1850786,159,,,,3664
f4ac8d75c5f1d2bb6789d0ef0761a88cc9108596,0,joewitt,2015-12-19 00:41:04-05:00,['d624ea48665041ffd9aa4f246b374bde10cfc878'],302,302,604,1851390,159,,,,3664
8d46041a134fa134fec59ef384d32d19fd1bfb96,1,Bryan Bende,2015-12-23 10:03:30-05:00,['f4ac8d75c5f1d2bb6789d0ef0761a88cc9108596'],0,75,75,1851465,2,0,0.896551724,1,3664
3189a13da1f231cdad8c2e3b9734a1c7d5205ad9,1,Bryan Bende,2015-12-23 13:08:56-05:00,['8d46041a134fa134fec59ef384d32d19fd1bfb96'],24,79,103,1851568,1,0,0,0,3664
2845e938121c48a932ec5341aad69e615534e9c4,1,Bryan Bende,2015-12-23 14:30:08-05:00,['3189a13da1f231cdad8c2e3b9734a1c7d5205ad9'],3,22,25,1851593,2,1,1,1,3664
ebcefaac23a890233703fe1fd7f43997cb4541c6,0,Tony Kurc,2015-12-26 09:58:08-05:00,['2845e938121c48a932ec5341aad69e615534e9c4'],18,16,34,1851627,2,1,1,1,3664
909c0decd68a54f36eb61f815d10bd34e6a5b862,1,Oleg Zhurakousky,2015-12-28 09:22:23-05:00,['ebcefaac23a890233703fe1fd7f43997cb4541c6'],178,429,607,1852234,7,0.224299065,1,0.672897196,3664
0d09054d9f40f433c156712421c18cde313b1e07,1,Oleg Zhurakousky,2015-12-28 15:16:32-05:00,['909c0decd68a54f36eb61f815d10bd34e6a5b862'],21,130,151,1852385,3,0.516129032,0.919354839,0.919354839,3664
c45060f703cc728aa2a0770e5dbc9ef66f65a367,1,ricky,2015-12-28 15:45:11-05:00,['ebcefaac23a890233703fe1fd7f43997cb4541c6'],1,765,766,1853151,10,0.198501873,0.535580524,0.812734082,3671
602c4a9639af39d407976b3840bd842e5b665b2c,0,Oleg Zhurakousky,2015-12-28 16:26:00-05:00,['0d09054d9f40f433c156712421c18cde313b1e07'],14,6,20,1853171,2,0.833333333,0.666666667,0.666666667,3671
9bb77163cf8a0a4912959a1d3a8134ffb17b537e,1,Aldrin Piri,2015-12-29 12:20:21-05:00,['c45060f703cc728aa2a0770e5dbc9ef66f65a367'],8,8,16,1853187,1,,,,3671
03730adb3f93047768810295ef5cda7ead0e5606,0,joewitt,2015-12-31 13:48:00-05:00,['9bb77163cf8a0a4912959a1d3a8134ffb17b537e'],3,4,7,1853194,1,,,,3671
71544cd22b0e1269bc3f3afa672da3897a6176ed,0,Mark Payne,2015-12-31 15:22:09-05:00,"['03730adb3f93047768810295ef5cda7ead0e5606', '602c4a9639af39d407976b3840bd842e5b665b2c']",178,530,708,1853902,7,,,,3671
8e031c987bc0781f02e1ca90b37ffc379f835eeb,0,Mark Payne,2015-12-31 15:37:00-05:00,['71544cd22b0e1269bc3f3afa672da3897a6176ed'],2,6,8,1853910,1,0,0,0,3671
02b325b07e67a641c727665177d88d06566ac8c5,0,joewitt,2016-01-01 13:34:07-05:00,['8e031c987bc0781f02e1ca90b37ffc379f835eeb'],4,20,24,1853934,1,0,0,0,3671
b043d04ecfb47233402d83d307de590fae8aecb7,1,Mark Payne,2016-01-01 13:48:22-05:00,['8e031c987bc0781f02e1ca90b37ffc379f835eeb'],0,655,655,1854589,6,0.534562212,1,1,3677
4ab6e3cb3fa3ca9aad2df1132d0820042c900b8a,0,Mark Payne,2016-01-01 13:48:22-05:00,['b043d04ecfb47233402d83d307de590fae8aecb7'],4,20,24,1854613,4,,,,3677
336a7f56ffa5267649a1b5b741ae1ab0d727e077,0,Mark Payne,2016-01-01 13:53:01-05:00,['4ab6e3cb3fa3ca9aad2df1132d0820042c900b8a'],0,0,0,1854613,0,,,,3677
e16a9a0c68b1aad60921e78b93f24aeaa77e3524,0,joewitt,2016-01-01 14:08:46-05:00,['02b325b07e67a641c727665177d88d06566ac8c5'],0,36,36,1854649,1,1,1,1,3677
a915534e23ff0955fcab2fc6cd017d45d5db5268,0,joewitt,2016-01-01 14:09:23-05:00,"['e16a9a0c68b1aad60921e78b93f24aeaa77e3524', '336a7f56ffa5267649a1b5b741ae1ab0d727e077']",0,671,671,1855320,6,,,,3677
236a2b72b6f1074040b3800377216af2bcba65af,1,ricky,2016-01-03 11:42:18-05:00,['a915534e23ff0955fcab2fc6cd017d45d5db5268'],16,42,58,1855378,2,0,0.875,1,3677
c696cb09b610bc91e3f2e0fcec18e2bc96fe71d5,0,joewitt,2016-01-03 16:12:06-05:00,['236a2b72b6f1074040b3800377216af2bcba65af'],7,9,16,1855394,2,0,0,1,3677
34bd2061f7714575dca935b9c2eae597f0af6b51,1,joewitt,2016-01-03 23:05:28-05:00,['c696cb09b610bc91e3f2e0fcec18e2bc96fe71d5'],3,812,815,1856209,9,0.38147139,0.675749319,0.885558583,3681
de2dd93f26dd34271632451621d5521fae11c979,1,Tony Kurc,2016-01-04 00:26:21-05:00,['34bd2061f7714575dca935b9c2eae597f0af6b51'],2,568,570,1856779,2,0.184895833,0.997395833,0.986979167,3682
b330fd160182a28a9c9d469f1ac081d71a6b8894,1,Matt Gilman,2016-01-06 16:20:23-05:00,['de2dd93f26dd34271632451621d5521fae11c979'],179,4208,4387,1861166,45,0.41529052,0.76941896,0.678899083,3701
8f0e7a1ac521518739ab53a6b8c52b813b841456,0,Aldrin Piri,2016-01-06 18:16:37-05:00,['b330fd160182a28a9c9d469f1ac081d71a6b8894'],0,0,0,1861166,2,,,,3701
3d487a538188d11980da01c62295e67080c68ad1,0,Aldrin Piri,2016-01-06 18:16:37-05:00,['8f0e7a1ac521518739ab53a6b8c52b813b841456'],1,1,2,1861168,11,,,,3701
fba006c8e30c3228c0eac1e4ea9912596a87cda5,0,Aldrin Piri,2016-01-07 12:05:23-05:00,['3d487a538188d11980da01c62295e67080c68ad1'],1,1,2,1861170,1,,,,3701
aca114926be5e6c2a80884030b970a737991c40f,0,Aldrin Piri,2016-01-07 12:05:23-05:00,['fba006c8e30c3228c0eac1e4ea9912596a87cda5'],3,3,6,1861176,2,,,,3701
c18514fe2f40b6adbebf05d7d9b2e90bd30c9d29,0,Aldrin Piri,2016-01-07 12:05:23-05:00,['aca114926be5e6c2a80884030b970a737991c40f'],2,5,7,1861183,1,,,,3701
47453d2c4762633dae9e195a51d35e652f470d32,1,Aldrin Piri,2016-01-07 12:05:23-05:00,['c18514fe2f40b6adbebf05d7d9b2e90bd30c9d29'],2,18,20,1861203,4,0.714285714,1,1,3701
8639513c4bb640bbfc266da580902572b5d6bd14,0,Aldrin Piri,2016-01-07 12:05:50-05:00,['47453d2c4762633dae9e195a51d35e652f470d32'],1,1,2,1861205,1,,,,3701
5273109ab1ddcf654f4bda59617d2d4a36f08cda,0,Aldrin Piri,2016-01-07 13:51:52-05:00,['8639513c4bb640bbfc266da580902572b5d6bd14'],5,0,5,1861210,1,,,,3701
6c46f22b6214067751bc420968f1a3580e4c8b1c,1,jpercivall,2016-01-07 15:51:49-05:00,['5273109ab1ddcf654f4bda59617d2d4a36f08cda'],3,2,5,1861215,2,1,0,0,3701
6e9175459f31ddbbf8b09b92bc13245861756766,1,jpercivall,2016-01-07 17:15:44-05:00,['6c46f22b6214067751bc420968f1a3580e4c8b1c'],3,3,6,1861221,1,,,,3701
317b2f4a4aae43a3312b704eebe78ece0bf448a5,1,Aldrin Piri,2016-01-08 10:43:14-05:00,['6e9175459f31ddbbf8b09b92bc13245861756766'],41,228,269,1861490,5,0.845454545,1,1,3701
8a8ae5508f7146e89cd2386e0ef334948e447c27,0,Matt Gilman,2016-01-08 16:22:55-05:00,['317b2f4a4aae43a3312b704eebe78ece0bf448a5'],1,3,4,1861494,1,,,,3701
035562bb33d1393d1de4c52d9ec9dd45b1be8770,1,joewitt,2016-01-09 22:18:39-05:00,['8a8ae5508f7146e89cd2386e0ef334948e447c27'],3,10,13,1861507,2,,,,3701
684f48ff926c83c8c6529985410b87d07935826e,1,Aldrin Piri,2016-01-10 14:48:20-05:00,['035562bb33d1393d1de4c52d9ec9dd45b1be8770'],107,75,182,1861689,1,,,,3701
ad4019f9aa97747860dabadd3885cdeef12cbe3b,1,joewitt,2016-01-10 14:52:10-05:00,['684f48ff926c83c8c6529985410b87d07935826e'],0,8,8,1861697,2,,,,3702
fddb4cd52a218434e8ff3e137cd6a12add3274c9,0,joewitt,2016-01-10 14:56:08-05:00,['ad4019f9aa97747860dabadd3885cdeef12cbe3b'],118,118,236,1861933,3,,,,3702
fdef994ead2c4ef86ff52d73af85c90cbf2ec28b,0,joewitt,2016-01-10 15:08:09-05:00,['fddb4cd52a218434e8ff3e137cd6a12add3274c9'],77,41,118,1862051,1,1,1,0,3702
4f7a4e83b15f1c36713eafd0c4434b360930a951,1,joewitt,2016-01-10 15:22:45-05:00,['fdef994ead2c4ef86ff52d73af85c90cbf2ec28b'],2,6,8,1862059,1,,,,3702
0c68e2c3a8a81f1ef48fd72061fed4302ec399ef,1,Aldrin Piri,2016-01-10 16:07:56-05:00,['4f7a4e83b15f1c36713eafd0c4434b360930a951'],2,48,50,1862109,3,1,1,1,3702
57dadb7286c49d035df83ac565b0d72817469ba4,0,Mark Payne,2016-01-11 08:28:32-05:00,['0c68e2c3a8a81f1ef48fd72061fed4302ec399ef'],795,4209,5004,1867113,130,0.499561788,0.69675723,0.626643295,3736
d2a969e3d63689624f7482a11fe57ece19147e4f,1,Mark Payne,2016-01-11 16:38:52-05:00,['0c68e2c3a8a81f1ef48fd72061fed4302ec399ef'],795,4643,5438,1872551,136,0.459029435,0.723945903,0.660302307,3770
c526656a228389aa972ce7ebc1df037333000516,1,James Wing,2016-01-11 13:39:15-08:00,['0c68e2c3a8a81f1ef48fd72061fed4302ec399ef'],2,2,4,1872555,1,,,,3770
7a3e3efce1071c60ae90fde65be4ec92dbccf66c,0,Mark Payne,2016-01-11 16:43:46-05:00,"['d2a969e3d63689624f7482a11fe57ece19147e4f', '57dadb7286c49d035df83ac565b0d72817469ba4']",4,0,4,1872559,3,,,,3770
6b54753dbb9bf6b2694a0cee7ac485fdcc8c3d01,0,Aldrin Piri,2016-01-11 22:59:24-05:00,['0c68e2c3a8a81f1ef48fd72061fed4302ec399ef'],7,104,111,1872670,2,0.126760563,0.85915493,0.887323944,3770
ffbfffce6dd381ffdac5704ef2279f1fe5345e89,1,Matt Gilman,2016-01-12 09:22:51-05:00,['6b54753dbb9bf6b2694a0cee7ac485fdcc8c3d01'],232,1127,1359,1874029,18,0.363636364,0.941348974,0.759530792,3778
44ffddd8b9da43ca27de09bc70fbf3e694649c05,0,Matt Gilman,2016-01-12 09:42:31-05:00,['ffbfffce6dd381ffdac5704ef2279f1fe5345e89'],5,11,16,1874045,3,0.25,1,0.75,3778
e559c68766b3e7377f783f76ea1a980ecd18f35b,1,Mark Payne,2016-01-12 10:21:47-05:00,['7a3e3efce1071c60ae90fde65be4ec92dbccf66c'],269,488,757,1874802,10,1,1,0.979591837,3778
f6b34cbbc5313b803c09c5083ef908dada31191e,0,Mark Payne,2016-01-12 10:40:00-05:00,['e559c68766b3e7377f783f76ea1a980ecd18f35b'],14,0,14,1874816,1,0,0,0,3778
bbd35a025840128c26caee5af3540a442d715f43,1,Matt Gilman,2016-01-12 10:43:30-05:00,['f6b34cbbc5313b803c09c5083ef908dada31191e'],132,1704,1836,1876652,24,0.386321627,1,0.61922366,3786
b4bc105ea955e7babd517f127f5f093144191211,0,Mark Payne,2016-01-12 10:49:04-05:00,"['44ffddd8b9da43ca27de09bc70fbf3e694649c05', 'c526656a228389aa972ce7ebc1df037333000516']",2,2,4,1876656,1,,,,3786
287d3ef531a745ce5f0d59e0acb1ec4754d9d5ee,0,Mark Payne,2016-01-12 10:58:27-05:00,['b4bc105ea955e7babd517f127f5f093144191211'],0,0,0,1876656,0,,,,3786
774c29a4da8fdb73d4ad92c2b25ecb54b4bcde3c,1,Mark Payne,2016-01-12 15:28:35-05:00,['bbd35a025840128c26caee5af3540a442d715f43'],29,265,294,1876950,22,0.653846154,0.961538462,0.884615385,3787
133838a93fa5a5771e9812a14845003ad8782c96,1,jpercivall,2016-01-12 18:21:38-05:00,['287d3ef531a745ce5f0d59e0acb1ec4754d9d5ee'],7,19,26,1876976,4,1,1,1,3787
c757c4d6ead4b2a3f47d282fea3bd7f43de167c5,0,trkurc,2016-01-12 19:16:29-05:00,['133838a93fa5a5771e9812a14845003ad8782c96'],1,1,2,1876978,1,,,,3787
c3ac772b9230e3fc8053650142f0ad921fd98169,1,trkurc,2016-01-12 19:37:45-05:00,['c757c4d6ead4b2a3f47d282fea3bd7f43de167c5'],3,3,6,1876984,1,,,,3787
bbce596d741d8c660291bc8c788c44173c0bb39c,1,Mark Payne,2016-01-13 12:47:08-05:00,['774c29a4da8fdb73d4ad92c2b25ecb54b4bcde3c'],102,248,350,1877334,6,0.103896104,0.194805195,1,3787
d39067ede6b7ef03b211e2d040db244018fc510f,1,Mark Payne,2016-01-13 13:30:05-05:00,['bbce596d741d8c660291bc8c788c44173c0bb39c'],6,54,60,1877394,2,0,0.84375,1,3787
d05314c54ba0b9cd8b3f19cb3267706ec02f2b4a,1,Matt Gilman,2016-01-13 13:35:24-05:00,['d39067ede6b7ef03b211e2d040db244018fc510f'],13,649,662,1878056,18,0.557823129,0.931972789,0.894557823,3791
0151b1eed1b232f886539c2ddd7b9305eeea65c7,0,Mark Payne,2016-01-13 13:57:47-05:00,['d39067ede6b7ef03b211e2d040db244018fc510f'],16,16,32,1878088,11,,,,3791
06f525b674dd01306a40a0bb7323c9727cdad414,0,Mark Payne,2016-01-13 13:57:57-05:00,"['0151b1eed1b232f886539c2ddd7b9305eeea65c7', 'd05314c54ba0b9cd8b3f19cb3267706ec02f2b4a']",13,649,662,1878750,18,,,,3791
0cd6f80f3624f4d46af63f444c3a0175021d2891,1,Mark Payne,2016-01-13 15:11:53-05:00,['06f525b674dd01306a40a0bb7323c9727cdad414'],9,16,25,1878775,4,0.25,0.25,0.25,3791
3f4bd919a9455998209ad7de4dde8e8a3e65e985,1,Matt Gilman,2016-01-13 15:12:17-05:00,['06f525b674dd01306a40a0bb7323c9727cdad414'],8,76,84,1878859,3,0.543478261,0.695652174,0.565217391,3791
c65829f0cbf5e2b48165efe8284862f43255496e,0,Mark Payne,2016-01-13 15:12:44-05:00,"['0cd6f80f3624f4d46af63f444c3a0175021d2891', '3f4bd919a9455998209ad7de4dde8e8a3e65e985']",8,76,84,1878943,3,,,,3791
ee7400ef5389fd177c570f524ff29b51d667b09c,1,Jeremy Dyer,2016-01-13 15:59:47-05:00,['c9d59fa8192c8791dd55344ab90f7eddefec2215'],222,219,441,1879384,11,1,0.022222222,0,3792
f0d8f73f267c9593e72e4a0df11ae0edf172d42d,1,Matt Gilman,2016-01-13 16:57:59-05:00,['c65829f0cbf5e2b48165efe8284862f43255496e'],25,51,76,1879460,4,0,1,1,3792
1a7e6c735d0dc458fd99e825f6659483b148d418,0,Matt Gilman,2016-01-13 17:20:11-05:00,['f0d8f73f267c9593e72e4a0df11ae0edf172d42d'],0,1,1,1879461,1,,,,3792
92062f9beb2690dceec5876ab48ea2af0bc877b7,0,Tony Kurc,2016-01-14 00:43:09-05:00,['c3ac772b9230e3fc8053650142f0ad921fd98169'],9,3,12,1879473,2,0.333333333,0.333333333,0,3792
e943c41a4760b4f72b0743e2ba9e425d4602ff7b,1,Mark Payne,2016-01-14 09:26:26-05:00,['1a7e6c735d0dc458fd99e825f6659483b148d418'],1,30,31,1879504,3,0.444444444,0.444444444,0.444444444,3792
65dfcd06a329a6ae6f22f6f80ccf4f5a519eeade,0,Matt Gilman,2016-01-14 11:16:35-05:00,['e943c41a4760b4f72b0743e2ba9e425d4602ff7b'],2,2,4,1879508,2,1,0,1,3792
ae6f615365210ed2063871e78ad62da6d59a15ea,0,Matt Gilman,2016-01-14 13:09:39-05:00,['65dfcd06a329a6ae6f22f6f80ccf4f5a519eeade'],41,62,103,1879611,5,0,0,0,3792
4236125f2b0aaef356d10b5ab4b6acfede0210c5,0,Matt Gilman,2016-01-14 15:35:53-05:00,['ae6f615365210ed2063871e78ad62da6d59a15ea'],3,3,6,1879617,3,,,,3792
5b62ff0fc3eda382f8577edff60f1b03d631c8e9,0,Matt Gilman,2016-01-14 15:36:57-05:00,['4236125f2b0aaef356d10b5ab4b6acfede0210c5'],0,5,5,1879622,1,1,1,1,3792
ecb81ec113e20f3850fd3f7080da2360035cabd8,1,Aldrin Piri,2016-01-15 16:40:36-05:00,['92062f9beb2690dceec5876ab48ea2af0bc877b7'],2,47,49,1879671,2,0,0.903225806,1,3792
eba25ecacad3372e78b72948f2e1617bbae1fcdc,1,Mark Payne,2016-01-17 14:40:27-05:00,['5b62ff0fc3eda382f8577edff60f1b03d631c8e9'],64,216,280,1879951,20,0.524590164,0.950819672,1,3793
95a3115f9bf075b704bc393bddba235e4a946710,0,Mark Payne,2016-01-17 20:32:04-05:00,['eba25ecacad3372e78b72948f2e1617bbae1fcdc'],3,4,7,1879958,1,1,0,1,3793
16dcf4595c03426505f411f587fb61c1a47485a7,0,Mark Payne,2016-01-18 08:48:30-05:00,"['95a3115f9bf075b704bc393bddba235e4a946710', 'ecb81ec113e20f3850fd3f7080da2360035cabd8']",259,1308,1567,1881525,29,,,,3793
f53aaed122bc859472735bd3aec68689ceee0014,1,Matt Gilman,2016-01-19 09:09:24-05:00,['ecb81ec113e20f3850fd3f7080da2360035cabd8'],47,80,127,1881652,6,,,,3793
9e9182aa639fb2358c950a19cb87d1ad3ddf67ab,0,Matt Gilman,2016-01-19 09:44:03-05:00,['f53aaed122bc859472735bd3aec68689ceee0014'],14,11,25,1881677,1,0.666666667,0,0,3793
d6a21537c19f98039735d407e9d52224ab39acf5,1,Mark Payne,2016-01-19 11:03:31-05:00,['16dcf4595c03426505f411f587fb61c1a47485a7'],2,2,4,1881681,1,,,,3793
704c333b0d9067d2ff3d2ba1e53e15ffb4b041e9,1,Aldrin Piri,2016-01-19 10:17:25-08:00,['9e9182aa639fb2358c950a19cb87d1ad3ddf67ab'],25,1040,1065,1882746,24,0.40438247,0.888446215,0.974103586,3799
8f688d49219161f3f71f63035408ef4ef26a82b8,0,Aldrin Piri,2016-01-19 10:46:37-08:00,['704c333b0d9067d2ff3d2ba1e53e15ffb4b041e9'],1,3,4,1882750,1,1,1,1,3799
6af2d4a342a2a578e764b9e5222f69f9c4405f4d,0,Mark Payne,2016-01-19 14:01:45-05:00,['d6a21537c19f98039735d407e9d52224ab39acf5'],8,29,37,1882787,2,0,1,0.888888889,3799
1845f6df8d4589e0a53df6c79008dfe165765db3,0,Mark Payne,2016-01-20 09:12:14-05:00,['8f688d49219161f3f71f63035408ef4ef26a82b8'],14,15,29,1882816,1,0,0,1,3799
7ef8af9eeadbb3a94fbc1dbcea5a7cb9704d9b63,0,Mark Payne,2016-01-20 09:14:04-05:00,['6af2d4a342a2a578e764b9e5222f69f9c4405f4d'],14,15,29,1882845,1,0,0,1,3799
593f1288d821b1728273b2433df0c889d86d4d54,0,Mark Payne,2016-01-20 10:16:14-05:00,['7ef8af9eeadbb3a94fbc1dbcea5a7cb9704d9b63'],17,75,92,1882937,4,0,1,1,3800
d696391f76cb14bf4bdaedb4e88d129aa2e54dc2,0,Mark Payne,2016-01-20 11:52:41-05:00,['593f1288d821b1728273b2433df0c889d86d4d54'],24,42,66,1883003,2,0,0,1,3800
2c9fb676cdb9c5831b7b1c92e5e7c9936c911e58,1,Mark Payne,2016-01-20 15:27:58-05:00,"['8f688d49219161f3f71f63035408ef4ef26a82b8', 'ee7400ef5389fd177c570f524ff29b51d667b09c']",2,1881,1883,1884886,19,,,,3800
9ebcc9e4fa14d8ae9e6b312865f11c4661bc1a68,1,Matt Gilman,2016-01-20 16:46:57-05:00,['2c9fb676cdb9c5831b7b1c92e5e7c9936c911e58'],46,122,168,1885054,3,0.94,0.94,0.94,3800
e1588d41367287af05ab3b5bd33dc1df80960024,1,Mark Payne,2016-01-20 16:51:58-05:00,['9ebcc9e4fa14d8ae9e6b312865f11c4661bc1a68'],40,38,78,1885132,3,0.571428571,0,0,3800
ddd71b0a4efb2268f3aa118ccd79677cb6bb3746,0,Mark Payne,2016-01-20 16:57:33-05:00,['e1588d41367287af05ab3b5bd33dc1df80960024'],0,0,0,1885132,0,,,,3800
3fc8bc00f11a32ee20d7aa4ad0615868d8aab684,0,Matt Gilman,2016-01-20 17:07:20-05:00,['ddd71b0a4efb2268f3aa118ccd79677cb6bb3746'],14,15,29,1885161,1,0,0,1,3800
348831b20c1300b6208eb0b7c58eecff73e27fed,0,Mark Payne,2016-01-20 17:31:34-05:00,"['ddd71b0a4efb2268f3aa118ccd79677cb6bb3746', '1845f6df8d4589e0a53df6c79008dfe165765db3']",14,15,29,1885190,1,,,,3800
a2fb5fc22ada79ddffe68e04684c833f0a9b539a,0,Mark Payne,2016-01-20 17:31:44-05:00,"['348831b20c1300b6208eb0b7c58eecff73e27fed', '3fc8bc00f11a32ee20d7aa4ad0615868d8aab684']",0,0,0,1885190,0,,,,3800
bc75dd3c175e48629aa0971c701b3df93433ac9b,0,Tony Kurc,2016-01-20 21:08:15-05:00,['a2fb5fc22ada79ddffe68e04684c833f0a9b539a'],5,5,10,1885200,1,,,,3800
7d73ae77f824f8c0860f6c31818813d978a6f155,0,Aldrin Piri,2016-01-21 00:28:42-08:00,['bc75dd3c175e48629aa0971c701b3df93433ac9b'],6,6,12,1885212,2,,,,3800
0d7edcb3ace95e8729c4bc27457d702fdd879f09,1,Matt Gilman,2016-01-21 08:13:32-05:00,['7d73ae77f824f8c0860f6c31818813d978a6f155'],742,377,1119,1886331,25,1,0.582608696,0.552173913,3801
f6ec437bc79b42eb516429381f117a9dd20050d3,0,Mark Payne,2016-01-21 09:32:02-05:00,"['d696391f76cb14bf4bdaedb4e88d129aa2e54dc2', '0d7edcb3ace95e8729c4bc27457d702fdd879f09']",880,3516,4396,1890727,77,,,,3801
c18f75c59707cc1e4165a8906ec849f55d50eb76,0,Matt Gilman,2016-01-21 11:25:17-05:00,['f6ec437bc79b42eb516429381f117a9dd20050d3'],0,1,1,1890728,1,1,1,1,3801
09357297e283d72eea288cf91e383d1fdfb3d9f3,0,Mark Payne,2016-01-21 12:00:40-05:00,['f6ec437bc79b42eb516429381f117a9dd20050d3'],0,3,3,1890731,2,0.5,0.5,0.5,3801
8f9c0b9ca338380d3e90b422402e4d84d08e24ce,0,Mark Payne,2016-01-21 12:00:44-05:00,"['09357297e283d72eea288cf91e383d1fdfb3d9f3', 'c18f75c59707cc1e4165a8906ec849f55d50eb76']",0,1,1,1890732,1,,,,3801
561f5b740a65a00e938b48c10c370279a27faf20,1,Matt Gilman,2016-01-21 12:39:28-05:00,['0d7edcb3ace95e8729c4bc27457d702fdd879f09'],11,25,36,1890768,3,0,0,0,3801
53322c99ac0ec71d0bf2684d9b56c47b24b8774f,0,Matt Gilman,2016-01-21 12:39:45-05:00,['561f5b740a65a00e938b48c10c370279a27faf20'],11,20,31,1890799,2,0,0,1,3801
b07e13a1d82af20919349387841833dc2daa16c7,0,Mark Payne,2016-01-21 13:44:44-05:00,['8f9c0b9ca338380d3e90b422402e4d84d08e24ce'],39,53,92,1890891,4,0.75,0.5,1,3801
3e139965122ef60de8aaf916aa4c72c4dd18f460,0,Mark Payne,2016-01-21 15:02:00-05:00,"['b07e13a1d82af20919349387841833dc2daa16c7', '53322c99ac0ec71d0bf2684d9b56c47b24b8774f']",20,43,63,1890954,4,,,,3801
fcf837b5afd77861e4df028ccb7a138721ae5a33,0,Matt Gilman,2016-01-21 16:35:59-05:00,['3e139965122ef60de8aaf916aa4c72c4dd18f460'],1,1,2,1890956,1,,,,3801
68a9375f3e22109c68d048748c66228de7a8b4c4,1,Richard Miskin,2016-01-21 22:19:15+00:00,['92062f9beb2690dceec5876ab48ea2af0bc877b7'],0,65,65,1891021,3,0.282051282,0.282051282,0.641025641,3802
3db6fffa6875482b117e74391658dcdaae0c1a11,1,Tony Kurc,2016-01-21 22:29:50-05:00,['53322c99ac0ec71d0bf2684d9b56c47b24b8774f'],42,68,110,1891131,4,0.529411765,1,1,3802
4d88aaedc58a6aded0b5dc546469a0f9b8bf513b,1,Aldrin Piri,2016-01-21 22:09:25-08:00,['3db6fffa6875482b117e74391658dcdaae0c1a11'],3,423,426,1891557,7,0.147727273,0.357954545,0.704545455,3804
8392b46597eee715c1ca20d96a5e6e447b60dfab,0,Aldrin Piri,2016-01-22 13:20:58-05:00,['4d88aaedc58a6aded0b5dc546469a0f9b8bf513b'],12,14,26,1891583,1,,,,3804
2f5f7b83028b6ba6920a81442880b1c30178c648,0,Mark Payne,2016-01-22 16:22:40-05:00,['8392b46597eee715c1ca20d96a5e6e447b60dfab'],2,6,8,1891591,1,1,1,1,3804
1089f0a956fbe1e302bb9d37fe6be05be5860646,1,Matt Gilman,2016-01-22 16:28:58-05:00,['2f5f7b83028b6ba6920a81442880b1c30178c648'],593,4450,5043,1896634,57,0.495502249,0.88155922,0.805097451,3849
b25db650fdac917ad1dad2ac21e57334b7e705aa,0,Aldrin Piri,2016-01-22 16:41:14-05:00,['1089f0a956fbe1e302bb9d37fe6be05be5860646'],8,34,42,1896676,2,0,0,1,3849
92e6961b50a131fa073a790fe36377a07dcc2ca4,1,Aldrin Piri,2016-01-22 18:15:19-05:00,['b25db650fdac917ad1dad2ac21e57334b7e705aa'],1,36,37,1896713,3,0,0.730769231,1,3849
a7d3f8d75f9b42289892b5b0d25354d69868683e,1,Aldrin Piri,2016-01-22 18:26:52-05:00,['92e6961b50a131fa073a790fe36377a07dcc2ca4'],7,50,57,1896770,5,0,1,1,3849
93e2c5219599f24b54517dd43195c3d121030c5e,0,Aldrin Piri,2016-01-22 20:46:14-05:00,['a7d3f8d75f9b42289892b5b0d25354d69868683e'],18,0,18,1896788,1,0,0,0,3849
dfed7e727d698de7f1d0e97c73517d65b733e49e,0,Richard Miskin,2016-01-23 08:52:54+00:00,['68a9375f3e22109c68d048748c66228de7a8b4c4'],0,14,14,1896802,1,,,,3849
5c36358bc21256bbb726a3702255385524fd5425,1,Aldrin Piri,2016-01-23 21:28:46-05:00,['93e2c5219599f24b54517dd43195c3d121030c5e'],2,1,3,1896805,1,1,1,0,3849
05dabe034c3bc9db73e8e83d1b026212ca871aad,1,Aldrin Piri,2016-01-24 15:29:47-05:00,['5c36358bc21256bbb726a3702255385524fd5425'],74,209,283,1897088,4,0.341463415,0.853658537,0.93902439,3849
0db2dc9fc3466051869bbf7ad8b2961405554d80,1,Aldrin Piri,2016-01-24 15:52:05-05:00,['05dabe034c3bc9db73e8e83d1b026212ca871aad'],1,72,73,1897161,2,0,0.975,0.875,3849
d42f1d4addc9c90c7a2e331e3e71fc5a94e009e4,0,Aldrin Piri,2016-01-24 20:36:04-05:00,['0db2dc9fc3466051869bbf7ad8b2961405554d80'],1,1,2,1897163,1,,,,3849
8d37af07b9f4486a063fda69f289bada97fac640,0,joewitt,2016-01-24 23:10:47-05:00,['d42f1d4addc9c90c7a2e331e3e71fc5a94e009e4'],2,46,48,1897211,2,0,1,1,3849
91e7ba84e06eef67baff489a1f7d8bf83f1ed663,1,Matt Burgess,2016-01-25 08:35:14-05:00,['8d37af07b9f4486a063fda69f289bada97fac640'],34,60,94,1897305,2,0.785714286,0.785714286,1,3849
fdda8f3e0f9577345bd3e805c77af7236c55cb48,0,Aldrin Piri,2016-01-25 09:26:33-05:00,['8d37af07b9f4486a063fda69f289bada97fac640'],6,10,16,1897321,1,0,0,1,3849
8966643d483d57ec9ee5154210049d4bccf177d6,0,Jeremy Dyer,2016-01-25 10:05:18-05:00,['8d37af07b9f4486a063fda69f289bada97fac640'],0,744,744,1898065,5,0.211940299,1,0.931343284,3853
dc2e8ce512eeb1e6f9cbe05d0278e67c14949f54,0,Jeremy Dyer,2016-01-25 10:05:18-05:00,['8966643d483d57ec9ee5154210049d4bccf177d6'],0,1,1,1898066,1,,,,3853
f8e3bef60615b882f0254b0223848cea81cc2428,0,joewitt,2016-01-25 10:14:45-05:00,['fdda8f3e0f9577345bd3e805c77af7236c55cb48'],1,1,2,1898068,1,,,,3853
d71266502c80a58fa51e642d7a88cf5825a60e65,0,Matt Gilman,2016-01-25 10:42:37-05:00,['f8e3bef60615b882f0254b0223848cea81cc2428'],2,2,4,1898072,1,,,,3853
329e1fe2f4f17832d38e5058f39cef483bde986c,0,Mark Payne,2016-01-25 14:33:22-05:00,['fcf837b5afd77861e4df028ccb7a138721ae5a33'],19,27,46,1898118,1,0,1,1,3853
4a5fb37b331fae307a2530598d5bb9e7b105d2d0,0,Mark Payne,2016-01-25 15:38:08-05:00,"['d71266502c80a58fa51e642d7a88cf5825a60e65', 'dfed7e727d698de7f1d0e97c73517d65b733e49e']",0,79,79,1898197,3,,,,3853
beb92492bee282a0a5bdffa2e1009ccb3692c9f4,0,Mark Payne,2016-01-25 16:04:47-05:00,['4a5fb37b331fae307a2530598d5bb9e7b105d2d0'],1,10,11,1898208,5,0,1,1,3855
13c6aeec952488acf6d4181700bc6606f552e9f5,1,Mark Payne,2016-01-25 16:32:28-05:00,['beb92492bee282a0a5bdffa2e1009ccb3692c9f4'],6,510,516,1898724,6,0.993150685,1,0.633561644,3857
43b4cb728a95492009f82f56b00d2039d07b40b9,0,Mark Payne,2016-01-25 16:32:28-05:00,['13c6aeec952488acf6d4181700bc6606f552e9f5'],17,46,63,1898787,5,,,,3857
fca0b4c433abc7b84fb7ecea9ba553de91c03524,0,Mark Payne,2016-01-25 16:40:09-05:00,['43b4cb728a95492009f82f56b00d2039d07b40b9'],0,0,0,1898787,0,,,,3857
7008a3054eb8304bd6160c520846fce6a6837321,1,Jeremy Dyer,2016-01-25 18:28:38-05:00,['dc2e8ce512eeb1e6f9cbe05d0278e67c14949f54'],745,1425,2170,1900957,14,0.835164835,0,0,3865
925138b6c443ca5e2b9129c379298d6e99582d8e,0,joewitt,2016-01-25 21:55:48-05:00,['fca0b4c433abc7b84fb7ecea9ba553de91c03524'],1,3,4,1900961,1,0,1,1,3865
b7f7e6ed80ce1aa257cb6bcbd9add89c84549e01,1,joewitt,2016-01-25 22:50:25-05:00,['925138b6c443ca5e2b9129c379298d6e99582d8e'],35,38,73,1901034,6,0,0,1,3865
c16c8db4594e977320a2fc8c29501ac40933ec87,0,Richard Miskin,2016-01-26 05:35:07+00:00,['b7f7e6ed80ce1aa257cb6bcbd9add89c84549e01'],2,3,5,1901039,1,,,,3865
5ded6b223b2c1c53529ebcf50b895b2a7c4e7a63,0,Mark Payne,2016-01-26 08:51:34-05:00,"['b7f7e6ed80ce1aa257cb6bcbd9add89c84549e01', '7008a3054eb8304bd6160c520846fce6a6837321']",0,1425,1425,1902464,10,,,,3865
68975dc2d70f46bcae3c14a0750123f012dec7ea,1,Mark Payne,2016-01-26 09:04:13-05:00,['5ded6b223b2c1c53529ebcf50b895b2a7c4e7a63'],2,2,4,1902468,1,,,,3865
1c6abcbd55b7d18f2a057ac05cebc92973d9ae89,0,Mark Payne,2016-01-26 09:20:33-05:00,"['68975dc2d70f46bcae3c14a0750123f012dec7ea', 'c16c8db4594e977320a2fc8c29501ac40933ec87']",2,3,5,1902473,1,,,,3865
0e926074661302c65c74ddee3af183ff49642da7,0,Mark Payne,2016-01-26 12:30:19-05:00,"['1c6abcbd55b7d18f2a057ac05cebc92973d9ae89', '91e7ba84e06eef67baff489a1f7d8bf83f1ed663']",34,60,94,1902567,2,,,,3865
9dfef8f4327ec4e58c5307fcde758e455267fddd,0,ricky,2016-01-26 13:52:03-05:00,['0e926074661302c65c74ddee3af183ff49642da7'],4,160,164,1902731,2,,,,3865
0395b903152caef57644662dc4a00bcd490e26d7,1,Oleg Zhurakousky,2016-01-26 16:37:19-05:00,['68975dc2d70f46bcae3c14a0750123f012dec7ea'],12,62,74,1902805,2,0,1,1,3865
0d45f21f4ba59ab65105255b3c93eeb869f8306f,0,Mark Payne,2016-01-26 16:38:47-05:00,"['9dfef8f4327ec4e58c5307fcde758e455267fddd', '0395b903152caef57644662dc4a00bcd490e26d7']",12,62,74,1902879,2,,,,3865
93aac8cff38741454211c331451372b68b745148,1,Matt Gilman,2016-01-26 17:37:59-05:00,['0d45f21f4ba59ab65105255b3c93eeb869f8306f'],6,459,465,1903344,4,0,0,0,3866
c5a174ae6de9e18b53d9077300781def17c129f0,0,Aldrin Piri,2016-01-27 10:03:41-05:00,['93aac8cff38741454211c331451372b68b745148'],160,4,164,1903508,2,,,,3866
aa6bc5d505dde3078505199b8aae5eb2c399086a,1,jpercivall,2016-01-27 18:23:32-05:00,['c5a174ae6de9e18b53d9077300781def17c129f0'],47,84,131,1903639,2,0.517241379,0.517241379,1,3866
f70f7e34470142437f2e4f2c7ef78fa7711858aa,0,Matt Gilman,2016-01-28 08:31:30-05:00,['aa6bc5d505dde3078505199b8aae5eb2c399086a'],10,17,27,1903666,1,0,0,1,3866
23364f554c4b5b4de407ef6e96ad45ec41469cd8,1,Mark Payne,2016-01-28 08:56:31-05:00,['f70f7e34470142437f2e4f2c7ef78fa7711858aa'],15,22,37,1903703,1,,,,3866
8a9a44c102f6e60e826fa85115ce31084eab4f17,0,Mark Payne,2016-01-28 09:35:05-05:00,['23364f554c4b5b4de407ef6e96ad45ec41469cd8'],2,14,16,1903719,1,,,,3866
b3990ecdcf0adc17dbcc442a09351e333dd291cf,1,Aldrin Piri,2016-01-28 12:23:02-06:00,['8a9a44c102f6e60e826fa85115ce31084eab4f17'],211,339,550,1904269,32,0.542168675,0.795180723,0.927710843,3867
ee30b27cc8872f9a666da1daab8e4ee942b97610,1,jpercivall,2016-01-28 14:50:22-05:00,['b3990ecdcf0adc17dbcc442a09351e333dd291cf'],5,62,67,1904336,2,0,0.276595745,1,3867
4e50263581b6a6847a5d5cefee90636014738479,1,Matt Gilman,2016-01-28 15:04:48-05:00,['ee30b27cc8872f9a666da1daab8e4ee942b97610'],6,24,30,1904366,1,,,,3867
a0224f1b4c3a8ee737f91d70b5d8b2cb9a1a1f1c,0,Matt Gilman,2016-01-28 16:02:05-05:00,['4e50263581b6a6847a5d5cefee90636014738479'],1,3,4,1904370,1,,,,3867
73c0637c255813a4ff9a9bde60eaa1daf7080012,1,ricky,2016-01-29 10:19:29-05:00,['a0224f1b4c3a8ee737f91d70b5d8b2cb9a1a1f1c'],4,194,198,1904568,2,,,,3867
be27c07c7f5f3c1984e3a3a76e49fd0ec0be5d44,1,jpercivall,2016-01-29 12:12:23-05:00,['73c0637c255813a4ff9a9bde60eaa1daf7080012'],1,453,454,1905022,4,0.65625,0.739583333,0.885416667,3869
807eb8de6d7054cef1fac91cbf2e2a1eb37d30ed,1,jpercivall,2016-01-29 12:39:27-05:00,['be27c07c7f5f3c1984e3a3a76e49fd0ec0be5d44'],23,14,37,1905059,1,0,0,0.333333333,3869
012680020173a2e3db2df2f7a1cb633bf356c2f0,0,Oleg Zhurakousky,2016-01-29 13:41:27-05:00,['73c0637c255813a4ff9a9bde60eaa1daf7080012'],6,245,251,1905310,2,0.005376344,0.908602151,0.919354839,3869
2f80cd504b1916cccfe32e2d32c2386b4c180d27,0,jpercivall,2016-01-29 14:52:56-05:00,['807eb8de6d7054cef1fac91cbf2e2a1eb37d30ed'],0,0,0,1905310,0,,,,3869
8ef337b65e479cb57bedd8023772e591c02dca74,1,jpercivall,2016-01-30 10:56:31-05:00,['2f80cd504b1916cccfe32e2d32c2386b4c180d27'],38,189,227,1905537,2,0.476190476,1,0.75,3869
06d621f35806951b8d0cdc0f7b4c23ea4110983d,1,joewitt,2016-01-31 20:19:59-05:00,['8ef337b65e479cb57bedd8023772e591c02dca74'],1,16,17,1905554,2,,,,3869
1bf7a585b2c622069ba6e9cd84b041997d367e01,0,joewitt,2016-01-31 21:56:53-05:00,['06d621f35806951b8d0cdc0f7b4c23ea4110983d'],32,24,56,1905610,1,1,0,0,3869
dbe8ff3f44acf1340d664e85991bdcc67bc1ac40,0,Matt Gilman,2016-02-01 08:28:18-05:00,['1bf7a585b2c622069ba6e9cd84b041997d367e01'],2,1,3,1905613,1,,,,3869
690281267858a91d7b8893f329d3f2925a408701,1,Aldrin Piri,2016-02-01 10:38:45-05:00,['329e1fe2f4f17832d38e5058f39cef483bde986c'],31,34,65,1905678,6,,,,3869
171b9c4e94113dc6e3c42154eb500e046620249e,1,Mark Payne,2016-02-01 11:45:15-05:00,['dbe8ff3f44acf1340d664e85991bdcc67bc1ac40'],37,258,295,1905973,2,0.005747126,0.91954023,0.931034483,3869
ef80549d63a5dc347731701d32a80c2446c46523,0,Mark Payne,2016-02-01 11:51:27-05:00,"['171b9c4e94113dc6e3c42154eb500e046620249e', '012680020173a2e3db2df2f7a1cb633bf356c2f0']",24,31,55,1906028,2,,,,3869
f47168213b90e378e35be807c31e068a1974b9f2,0,Aldrin Piri,2016-02-01 14:07:38-05:00,['690281267858a91d7b8893f329d3f2925a408701'],5,16,21,1906049,1,,,,3869
72c8467b9f2d64d0d441331851dc23f25e927736,0,Aldrin Piri,2016-02-01 14:07:38-05:00,['f47168213b90e378e35be807c31e068a1974b9f2'],4,50,54,1906103,3,0.205882353,0.911764706,1,3869
f2c366cf9cc45613ab6b687ee187efc330be6116,0,Aldrin Piri,2016-02-01 15:26:27-05:00,['72c8467b9f2d64d0d441331851dc23f25e927736'],1,1,2,1906105,1,,,,3869
257eca9c46a8dae94ca76fa79b829db6bde091eb,1,Aldrin Piri,2016-02-01 16:29:11-05:00,['f2c366cf9cc45613ab6b687ee187efc330be6116'],42,14,56,1906161,4,,,,3869
447e401912100ab9ed73d442e1e8c0c0bb229725,0,Aldrin Piri,2016-02-01 16:29:12-05:00,['257eca9c46a8dae94ca76fa79b829db6bde091eb'],2,32,34,1906195,4,0.545454545,0.545454545,0.545454545,3869
a931e7278719f0b6030ca5c7da66cae22f4d08dd,0,Aldrin Piri,2016-02-01 16:29:12-05:00,['447e401912100ab9ed73d442e1e8c0c0bb229725'],15,18,33,1906228,1,0,0.2,0.6,3869
35d2b921ea90eb42ff09b1d77bb70fef827eb22f,0,Aldrin Piri,2016-02-01 16:29:12-05:00,['a931e7278719f0b6030ca5c7da66cae22f4d08dd'],1,9,10,1906238,1,0,1,0,3869
1e56de9521e4bc0752b419ffc7d62e096db1c389,0,Bryan Bende,2016-02-01 18:42:00-05:00,['ef80549d63a5dc347731701d32a80c2446c46523'],10,105,115,1906353,4,0,1,1,3869
77ab5d36843370a30141f660c0b4dd146b007ff7,1,joewitt,2016-02-01 21:09:06-05:00,['1e56de9521e4bc0752b419ffc7d62e096db1c389'],4,3694,3698,1910051,49,0.490358127,0.729109275,0.876951331,3913
8cf34c3ea5a86a18d3bc7496be7319df0b051999,0,Matt Gilman,2016-02-02 13:16:10-05:00,['77ab5d36843370a30141f660c0b4dd146b007ff7'],0,3,3,1910054,1,0,0,1,3913
e6cfcf40d0bcafa720449e163b8981958662c2d1,1,Matt Burgess,2016-02-02 17:26:39-05:00,['8cf34c3ea5a86a18d3bc7496be7319df0b051999'],0,762,762,1910816,9,0.267489712,0.617283951,1,3922
943d0a6e539608baf548b226322b4a07e80f977b,1,Matt Burgess,2016-02-02 17:26:40-05:00,['e6cfcf40d0bcafa720449e163b8981958662c2d1'],417,832,1249,1912065,13,0.6,0.577777778,0.777777778,3925
0c137bc22d18b23b121e42de0dd03297fffa2b5f,0,Matt Burgess,2016-02-02 17:26:40-05:00,['943d0a6e539608baf548b226322b4a07e80f977b'],9,114,123,1912188,3,0,0.942857143,0.9,3925
75af3a2ebeed3fdf41d2e1e8d6fafe9a733d986c,1,jpercivall,2016-02-02 18:21:31-05:00,['0c137bc22d18b23b121e42de0dd03297fffa2b5f'],406,1401,1807,1913995,15,0.326975477,0.866485014,0.91280654,3928
dc8b62c3a6d0905a22ced0522c30dc374ff1dc04,1,Bryan Bende,2016-02-02 20:57:10-05:00,['75af3a2ebeed3fdf41d2e1e8d6fafe9a733d986c'],0,2965,2965,1916960,26,0.78335005,0.946840522,0.776328987,3951
2d6fec5fa9abfd64439cf89d8b11a6f53a205544,0,joewitt,2016-02-02 21:13:28-05:00,['dc8b62c3a6d0905a22ced0522c30dc374ff1dc04'],19,0,19,1916979,2,,,,3951
8a668fd344f202060d45f0a506f3ab19943f57ee,0,Aldrin Piri,2016-02-02 23:03:31-05:00,['35d2b921ea90eb42ff09b1d77bb70fef827eb22f'],14,83,97,1917076,4,0.452380952,0.571428571,0.785714286,3951
7711106d620d7150e50d1f58a10f7e7fd2d3a88c,0,Aldrin Piri,2016-02-03 10:13:19-05:00,['8a668fd344f202060d45f0a506f3ab19943f57ee'],13,32,45,1917121,2,,,,3951
adfa5dc0ebc8446c8a4e2eeea882e27e526bc798,0,Aldrin Piri,2016-02-03 10:13:23-05:00,['7711106d620d7150e50d1f58a10f7e7fd2d3a88c'],104,104,208,1917329,1,,,,3951
478226451ce2e7a2831814abfbea5367e0c66eed,1,Matt Burgess,2016-02-03 10:41:47-05:00,['2d6fec5fa9abfd64439cf89d8b11a6f53a205544'],79,234,313,1917642,10,0,0.178571429,0.910714286,3953
55b77fe03b6c4efa032e0d2979ce0495b0edf437,0,Aldrin Piri,2016-02-03 16:05:38-05:00,['adfa5dc0ebc8446c8a4e2eeea882e27e526bc798'],24,5,29,1917671,1,0,0,0,3953
88d4d2ce5fe421b6e8955a7b875ad3e01195bd13,0,jpercivall,2016-02-03 20:04:39-05:00,['55b77fe03b6c4efa032e0d2979ce0495b0edf437'],26,156,182,1917853,2,0.072289157,0.56626506,0.445783133,3953
769b044e301d6487a3adbe240df35a92a3e7eb14,1,Tony Kurc,2016-02-03 20:54:32-05:00,['478226451ce2e7a2831814abfbea5367e0c66eed'],57,1273,1330,1919183,3,0.158438576,0.639494834,0.911595867,3953
0690aee452f01806b941ad80535d0220aa380597,0,Tony Kurc,2016-02-03 21:50:24-05:00,['769b044e301d6487a3adbe240df35a92a3e7eb14'],1,5,6,1919189,1,1,1,1,3953
6f4c3db1861004018ca0624690a7784524328980,0,Matt Gilman,2016-02-04 08:59:26-05:00,['88d4d2ce5fe421b6e8955a7b875ad3e01195bd13'],6,14,20,1919209,4,,,,3953
29fb9c939368054bd199edca2f3653796e586927,1,jpercivall,2016-02-04 16:07:18-05:00,['6f4c3db1861004018ca0624690a7784524328980'],14,12,26,1919235,2,0,0,0,3953
498b5023ce4f99e67184f399de740b142fca510d,1,Aldrin Piri,2016-02-04 19:40:55-05:00,['0690aee452f01806b941ad80535d0220aa380597'],441,8513,8954,1928189,56,0.418772563,0.620938628,0.555956679,3993
16f185245309ac3bcf9629b1c4d4dc655f18ca68,1,Aldrin Piri,2016-02-05 12:55:06-05:00,['29fb9c939368054bd199edca2f3653796e586927'],1,1,2,1928191,1,,,,3993
4df65121263fe9b3e488f81ce50d8f96e3643c21,1,Aldrin Piri,2016-02-05 14:09:29-05:00,"['498b5023ce4f99e67184f399de740b142fca510d', '16f185245309ac3bcf9629b1c4d4dc655f18ca68']",1312,8744,10056,1938247,191,,,,3993
7314af61778b0803a3529551bcc169e981897a6c,0,Aldrin Piri,2016-02-05 17:47:56-05:00,['4df65121263fe9b3e488f81ce50d8f96e3643c21'],95,51,146,1938393,1,0,0,1,3993
0d72969053e67043cb5843b499bb5e33ab267de0,0,Aldrin Piri,2016-02-05 23:35:10-05:00,['7314af61778b0803a3529551bcc169e981897a6c'],1,1,2,1938395,1,,,,3993
b4073796708193a2d0c8742455bf1ac612b4cafe,0,Aldrin Piri,2016-02-05 23:38:58-05:00,['0d72969053e67043cb5843b499bb5e33ab267de0'],40,172,212,1938607,10,0.510638298,1,1,3993
303f8eabf16f05549c3bec0e7edac80973e1542a,0,Tony Kurc,2016-02-06 08:49:48-05:00,['b4073796708193a2d0c8742455bf1ac612b4cafe'],328,387,715,1939322,175,,,,3993
0849489a879c53f99c5fdd180737630a296ab6cb,0,Tony Kurc,2016-02-06 16:51:34-05:00,['303f8eabf16f05549c3bec0e7edac80973e1542a'],0,1,1,1939323,1,,,,3993
5be83166ee8416f5c26187464b9b36fd82204acc,0,Tony Kurc,2016-02-07 13:52:00-05:00,['0849489a879c53f99c5fdd180737630a296ab6cb'],42,42,84,1939407,42,,,,3993
ea5818c3984a6dcf49755ceabce143e1a1966caf,0,Tony Kurc,2016-02-07 17:27:53-05:00,['5be83166ee8416f5c26187464b9b36fd82204acc'],0,18,18,1939425,1,,,,3993
2673370cba9678e879cc78899a62f99bff611f9a,1,Tony Kurc,2016-02-07 17:40:12-05:00,['ea5818c3984a6dcf49755ceabce143e1a1966caf'],8,63,71,1939496,2,0.347826087,1,0.869565217,3993
eb6f9f0fec3042350864afee17a67ea62ef5f37a,1,jpercivall,2016-02-08 11:20:08-05:00,['2673370cba9678e879cc78899a62f99bff611f9a'],8,141,149,1939645,6,0.052631579,0.421052632,0.968421053,3993
a33289393d9161e50899121c62ff7706095c7b87,0,Aldrin Piri,2016-02-09 15:33:46-05:00,['eb6f9f0fec3042350864afee17a67ea62ef5f37a'],2,2,4,1939649,1,,,,3993
1c03fc7871dd347cc35f3eac96deb70ed0ddc61b,0,Aldrin Piri,2016-02-09 16:13:16-05:00,['a33289393d9161e50899121c62ff7706095c7b87'],1,0,1,1939650,1,,,,3993
8a05f6880a31f2db12d824db318d105fe01bb024,0,joewitt,2016-02-09 20:31:57-05:00,['1c03fc7871dd347cc35f3eac96deb70ed0ddc61b'],77,14,91,1939741,1,1,1,0,3993
f4487dd5f6338c9b5fa384e36e3e2ee62aeab987,0,joewitt,2016-02-09 20:48:56-05:00,['8a05f6880a31f2db12d824db318d105fe01bb024'],12,144,156,1939897,8,0.2,0.44,1,3994
d01449ee72b4ef7762ca77632efcd26bd2cc1a2c,0,Matt Gilman,2016-02-10 08:46:42-05:00,['f4487dd5f6338c9b5fa384e36e3e2ee62aeab987'],1,1,2,1939899,1,,,,3994
1a512cd1e67e6d0231e9dcde9d32472fad4c5bd2,1,Aldrin Piri,2016-02-10 10:25:47-05:00,['d01449ee72b4ef7762ca77632efcd26bd2cc1a2c'],207,498,705,1940604,6,0,0.922155689,1,3994
778229eb528fc0184d9ef5706de4e04cd8f299ab,0,joewitt,2016-02-10 19:15:48-05:00,['1a512cd1e67e6d0231e9dcde9d32472fad4c5bd2'],0,2,2,1940606,1,,,,3994
e00652e625e9ad0cf054fb84a05db5bd27b6926d,1,joewitt,2016-02-10 21:21:10-05:00,['778229eb528fc0184d9ef5706de4e04cd8f299ab'],2,13,15,1940621,1,,,,3994
f44eb643dd4ccd50e804d1a96bae305f84c3dc2d,1,joewitt,2016-02-10 21:21:19-05:00,['e00652e625e9ad0cf054fb84a05db5bd27b6926d'],17,25,42,1940663,2,,,,3994
180a90d12b9b36c25c35f28c7e7435de03e0ea7b,0,mans2singh,2016-02-11 20:59:54-08:00,['f44eb643dd4ccd50e804d1a96bae305f84c3dc2d'],0,459,459,1941122,5,0.49382716,0.617283951,0.87654321,3997
cd05bedda84fdb6bf63fae2b973c708a54b18a56,0,mans2singh,2016-02-11 21:14:28-08:00,['180a90d12b9b36c25c35f28c7e7435de03e0ea7b'],1,1,2,1941124,1,,,,3997
528c4bc59109c5c1c45b67983e0e17bb7be1b8fc,0,mans2singh,2016-02-12 09:22:41-08:00,['cd05bedda84fdb6bf63fae2b973c708a54b18a56'],3,9,12,1941136,1,0,0,1,3997
cae5b109c09be80df77f2d767220b82850178ed5,0,Tony Kurc,2016-02-12 16:58:26-05:00,['f44eb643dd4ccd50e804d1a96bae305f84c3dc2d'],7,7,14,1941150,3,,,,3997
8309dba80bbc0e6c0dfe5b8f93750d424f5b9a90,1,Tony Kurc,2016-02-12 17:27:59-05:00,['cae5b109c09be80df77f2d767220b82850178ed5'],410,367,777,1941927,174,,,,3997
ad73b5c9d999fde749817d0a632f636201bef515,0,Tony Kurc,2016-02-12 17:28:10-05:00,['8309dba80bbc0e6c0dfe5b8f93750d424f5b9a90'],329,329,658,1942585,174,,,,3997
ef0018cf662de6c1d2272f3d62a4d0bbc53d8bfb,1,joewitt,2016-02-16 09:38:56-05:00,['cae5b109c09be80df77f2d767220b82850178ed5'],2,7,9,1942594,1,0,1,1,3997
36f1caad332b7c02991c2142332e33a5486b55d8,1,Aldrin Piri,2016-02-16 14:51:06-05:00,['ef0018cf662de6c1d2272f3d62a4d0bbc53d8bfb'],7,110,117,1942711,9,0.333333333,0.861111111,1,3998
e4d0ec7e6025d5cfb3034da94cb2ab1a0424d2e6,0,Aldrin Piri,2016-02-16 15:17:28-05:00,['36f1caad332b7c02991c2142332e33a5486b55d8'],2,2,4,1942715,1,,,,3998
ad39b1c41f83d88d34e074fcb35bfa2604662f24,0,mans2singh,2016-02-16 13:25:28-08:00,['528c4bc59109c5c1c45b67983e0e17bb7be1b8fc'],12,10,22,1942737,2,,,,3998
b921bf602e5c6454aad65dc1859fcdce1f9ca898,0,mans2singh,2016-02-16 13:33:48-08:00,['ad39b1c41f83d88d34e074fcb35bfa2604662f24'],1,1,2,1942739,1,,,,3998
6c2ba997a098f05bd827612c273e509dbfe37ec6,0,Tony Kurc,2016-02-16 20:13:41-05:00,"['e4d0ec7e6025d5cfb3034da94cb2ab1a0424d2e6', 'ad73b5c9d999fde749817d0a632f636201bef515']",409,366,775,1943514,174,,,,3998
c2998a71ec4e262363858e7d54bb2e47afcda8c2,1,Aldrin Piri,2016-02-17 17:48:23-05:00,['6c2ba997a098f05bd827612c273e509dbfe37ec6'],2,2,4,1943518,1,,,,3998
502aebc66aba2731949f7d482ac7c5285c9dfff6,0,Tony Kurc,2016-02-17 20:59:31-05:00,['c2998a71ec4e262363858e7d54bb2e47afcda8c2'],1,1,2,1943520,1,,,,3998
1c73d9090ac556900c78b43fefb7935183caf137,0,Tony Kurc,2016-02-17 21:55:10-05:00,['502aebc66aba2731949f7d482ac7c5285c9dfff6'],9,25,34,1943554,1,0,1,1,3998
bdc1ef1f8c3b7be2c76fa08e30ad6acd78c072ec,0,mans2singh,2016-02-17 21:36:53-08:00,['b921bf602e5c6454aad65dc1859fcdce1f9ca898'],2,2,4,1943558,1,,,,3998
3bb18b965348b439cadc8f548429ab1347f9c305,1,Mark Payne,2016-02-18 16:25:57-05:00,['1c73d9090ac556900c78b43fefb7935183caf137'],99,418,517,1944075,10,0.406666667,0.593333333,0.966666667,4000
86ab4428f02739b0822083c78db1e89a60d8dbc3,0,Tony Kurc,2016-02-18 18:45:26-05:00,['3bb18b965348b439cadc8f548429ab1347f9c305'],1,186,187,1944262,47,,,,4000
a8edab2e7955b175c5cbd2a3266fb51fa9712aee,1,Bryan Bende,2016-02-19 10:54:53-05:00,['86ab4428f02739b0822083c78db1e89a60d8dbc3'],177,1498,1675,1945937,47,0.719269103,0.800664452,0.995016611,4007
9576f416037db35df0f480c01f6f69c08aee2f34,1,Bryan Bende,2016-02-19 16:35:49-05:00,['a8edab2e7955b175c5cbd2a3266fb51fa9712aee'],64,20,84,1946021,5,,,,4007
4c5263220c5b45ca82a2d5119311f4a481d9bbba,1,Tony Kurc,2016-02-21 18:11:23-05:00,['9576f416037db35df0f480c01f6f69c08aee2f34'],2,14,16,1946037,1,0,0,0,4007
122cba0ee79b7a9bfdded094c76bc14f76735ca6,1,joewitt,2016-02-22 12:36:08-05:00,['4c5263220c5b45ca82a2d5119311f4a481d9bbba'],2,2,4,1946041,1,,,,4007
e7676ffae535b48763077d350072e273ae301af5,0,joewitt,2016-02-22 12:39:37-05:00,['122cba0ee79b7a9bfdded094c76bc14f76735ca6'],4,7,11,1946052,1,0,1,1,4007
8cff13e7497a89e44ece1ddcaa9746c42fcb650c,1,Matt Gilman,2016-02-22 15:21:56-05:00,['e7676ffae535b48763077d350072e273ae301af5'],90,110,200,1946252,1,,,,4007
bb2d2c367442e57be2fdb92639f6043280c96dda,0,Matt Gilman,2016-02-22 16:34:43-05:00,['8cff13e7497a89e44ece1ddcaa9746c42fcb650c'],2,2,4,1946256,1,,,,4007
a87230358d9a1f0d2676339fcd2354ae5732f6f2,0,joewitt,2016-02-22 17:23:53-05:00,['bb2d2c367442e57be2fdb92639f6043280c96dda'],3,5,8,1946264,1,0,1,0,4007
5ee83574d8c7557c31a6e556381623395302de9f,1,Tony Kurc,2016-02-22 19:16:55-05:00,['a87230358d9a1f0d2676339fcd2354ae5732f6f2'],4,4,8,1946272,4,,,,4007
24a77755de8d99467a883c964737eeceb886219e,0,Matt Gilman,2016-02-22 21:09:01-05:00,['5ee83574d8c7557c31a6e556381623395302de9f'],2,22,24,1946296,1,1,1,0,4007
50da696cda5d30f50fa956acd54e05356161f201,0,mans2singh,2016-02-22 19:56:12-08:00,['bdc1ef1f8c3b7be2c76fa08e30ad6acd78c072ec'],1,3,4,1946300,1,,,,4007
6138b0332e5a8af0e77a86a3c5742b8c461633c7,0,mans2singh,2016-02-22 20:12:24-08:00,['50da696cda5d30f50fa956acd54e05356161f201'],1,1,2,1946302,1,,,,4007
6af108c0ca7ad61b23b0e60aff9a9f1ac0e4982e,1,Tony Kurc,2016-02-23 18:02:58-05:00,['24a77755de8d99467a883c964737eeceb886219e'],12,48,60,1946362,1,0,0,0,4007
fc92441981ff6e5c7b625e6b77f477031bb62af7,0,Matt Gilman,2016-02-25 10:12:45-05:00,['6af108c0ca7ad61b23b0e60aff9a9f1ac0e4982e'],2,18,20,1946382,2,0,0,1,4007
0d13de0cf350cd6f5bef985303fe41fd8d769731,0,Matt Gilman,2016-02-25 10:13:07-05:00,['fc92441981ff6e5c7b625e6b77f477031bb62af7'],1,1,2,1946384,1,,,,4007
32f476aaa7040ed4718713f2ed11e11bc7ef4f1c,1,Aldrin Piri,2016-02-25 12:47:01-05:00,['0d13de0cf350cd6f5bef985303fe41fd8d769731'],3,102,105,1946489,5,0.685714286,0.714285714,1,4009
c7e24c75699a0b55b9f29f3bd2e5f5e2184833f5,1,Matt Gilman,2016-02-25 15:21:40-05:00,['32f476aaa7040ed4718713f2ed11e11bc7ef4f1c'],68,78,146,1946635,11,0,0.75,0.75,4009
28c2a3e5a65e640935f0259bd162967ef3e0b396,0,jpercivall,2016-02-25 15:59:57-05:00,['c7e24c75699a0b55b9f29f3bd2e5f5e2184833f5'],17,93,110,1946745,4,0,0.490909091,0.909090909,4009
58e50ae39d5565592ae7b8368889209afab86e7c,1,Matt Gilman,2016-02-26 10:25:45-05:00,['28c2a3e5a65e640935f0259bd162967ef3e0b396'],88,57,145,1946890,4,,,,4009
99c7fe3b44f4c661366bb048bcc3f1eef7e757c7,1,Aldrin Piri,2016-02-27 10:01:38-05:00,['58e50ae39d5565592ae7b8368889209afab86e7c'],1,10,11,1946901,1,,,,4009
738236a41dc9f0f5f2c50dc425aa12948275aad6,1,Richard Miskin,2016-02-27 15:18:22+00:00,['58e50ae39d5565592ae7b8368889209afab86e7c'],0,30,30,1946931,6,1,1,1,4009
1149bc61cb3390210be4566dafba80564c4ab8d9,1,Mark Payne,2016-02-29 15:42:33-05:00,['99c7fe3b44f4c661366bb048bcc3f1eef7e757c7'],0,8,8,1946939,1,0,0,1,4009
62333c9e0ae77854761cf019a65f54ccedc7af6b,0,Mark Payne,2016-02-29 15:42:54-05:00,['1149bc61cb3390210be4566dafba80564c4ab8d9'],28,208,236,1947175,2,0.092436975,1,1,4009
6776060ac80e4b47d0fadede3c7a5873fd9e374f,0,Mark Payne,2016-02-29 16:02:26-05:00,['62333c9e0ae77854761cf019a65f54ccedc7af6b'],1,2,3,1947178,1,,,,4009
19e53962ca45fd00a46efd671b674d388ff10053,1,Bryan Bende,2016-03-04 09:17:45-05:00,['6776060ac80e4b47d0fadede3c7a5873fd9e374f'],18,52,70,1947248,4,0.222222222,0,0,4009
a7e6820fd983ee0211a8d273815bacc3dab39e49,0,Matt Burgess,2016-03-07 10:42:21-05:00,['19e53962ca45fd00a46efd671b674d388ff10053'],1,20,21,1947269,2,1,1,1,4009
4ce7b679e17b14ae88991bf9132a144e068ac0f0,1,Aldrin Piri,2016-03-07 15:27:35-05:00,['a7e6820fd983ee0211a8d273815bacc3dab39e49'],159,272,431,1947700,2,1,1,1,4010
6f5fb5947911baf3da6892310d01148d8aa50f30,1,Bryan Bende,2016-03-07 18:21:17-05:00,['4ce7b679e17b14ae88991bf9132a144e068ac0f0'],242,3711,3953,1951653,33,0.40403338,0.721140473,0.824756606,4029
998ac1c830c217e6150aec1151e3acf5806b572f,0,Matt Burgess,2016-03-08 10:03:27-05:00,['6f5fb5947911baf3da6892310d01148d8aa50f30'],2,0,2,1951655,1,,,,4029
9874d35b6befddc341833e2c65af301d99090dd7,0,Mark Payne,2016-03-08 12:09:45-05:00,['998ac1c830c217e6150aec1151e3acf5806b572f'],0,6,6,1951661,1,1,1,1,4029
1211996d35d20934dc4fb6c533d32acc90642f96,0,mans2singh,2016-03-08 21:12:49-08:00,['6138b0332e5a8af0e77a86a3c5742b8c461633c7'],7,11,18,1951679,1,1,1,0,4029
0f9b55afb6869767ea871c5f9ab92db001274d8e,0,Mark Payne,2016-03-09 08:19:45-05:00,"['9874d35b6befddc341833e2c65af301d99090dd7', '1211996d35d20934dc4fb6c533d32acc90642f96']",2,471,473,1952152,6,,,,4029
a2164136dbd1d0a6a7afe305b4b74064e271c984,0,Mark Payne,2016-03-09 09:40:37-05:00,"['0f9b55afb6869767ea871c5f9ab92db001274d8e', '738236a41dc9f0f5f2c50dc425aa12948275aad6']",0,30,30,1952182,6,,,,4029
7f15626af507469d087a621dde4f75a41683fbb4,1,ricky,2016-03-09 15:51:30-05:00,['a2164136dbd1d0a6a7afe305b4b74064e271c984'],5,138,143,1952325,7,0.306451613,0.661290323,0.967741935,4031
2839a2f21542abf1224dec2726268e40a4cd1d74,1,Aldrin Piri,2016-03-09 23:46:53-05:00,['7f15626af507469d087a621dde4f75a41683fbb4'],148,447,595,1952920,9,0.342857143,0.95,0.8,4034
da234abd7609c149db96049aa5168cc18cd2a7fd,0,Aldrin Piri,2016-03-10 08:58:12-05:00,['2839a2f21542abf1224dec2726268e40a4cd1d74'],3,14,17,1952937,2,,,,4034
73e168e954ad8304bbd7f4a078031c106cf2e8e3,0,Aldrin Piri,2016-03-10 14:56:46-05:00,['da234abd7609c149db96049aa5168cc18cd2a7fd'],0,21,21,1952958,2,1,1,1,4034
d3367a7dc306d68eea5f94b3a1479fdb2fea90d3,0,Mark Payne,2016-03-10 16:01:29-05:00,['73e168e954ad8304bbd7f4a078031c106cf2e8e3'],8,3,11,1952969,1,0,0,0,4034
784f2a2c2094ae30b7f07a80cf41b1b548929211,1,Tony Kurc,2016-03-10 21:36:31-05:00,['d3367a7dc306d68eea5f94b3a1479fdb2fea90d3'],3,431,434,1953403,3,0.979591837,1,1,4035
8f0116544ab80ed5a76a7665e9258bdfbeb4def2,1,Tony Kurc,2016-03-10 22:15:13-05:00,['784f2a2c2094ae30b7f07a80cf41b1b548929211'],3,85,88,1953491,2,0.233333333,0.233333333,0.033333333,4035
1373bf672586ba5ddcfa697c45c832ccc79425cb,1,Bryan Bende,2016-03-11 09:07:05-05:00,['8f0116544ab80ed5a76a7665e9258bdfbeb4def2'],972,1044,2016,1955507,23,1,1,0,4039
f6705f234cd527c2bc0edd670854f2947277f3f5,0,Matt Burgess,2016-03-11 11:15:15-05:00,['1373bf672586ba5ddcfa697c45c832ccc79425cb'],2,6,8,1955515,1,,,,4039
e1cf37fb8953cc04a8f92382b558cf89c1563a5d,1,Aldrin Piri,2016-03-11 12:01:28-05:00,['f6705f234cd527c2bc0edd670854f2947277f3f5'],18,44,62,1955577,2,0,0.85,1,4039
0c5b1c27f26a008baedac4eb0c69f9b01080eaec,1,Mark Payne,2016-03-11 12:54:50-05:00,['f6705f234cd527c2bc0edd670854f2947277f3f5'],736,1654,2390,1957967,17,0.353571429,1,0.735714286,4042
f53f45def3ed353232ec65d656bba4eee922b252,1,Mark Payne,2016-03-11 12:54:50-05:00,['0c5b1c27f26a008baedac4eb0c69f9b01080eaec'],128,7,135,1958102,5,0.9875,1,0,4042
48af0bfbc5cafe06e003b2bd086b970cf49b5025,1,Mark Payne,2016-03-11 12:54:50-05:00,['f53f45def3ed353232ec65d656bba4eee922b252'],41,143,184,1958286,6,0.258064516,1,1,4042
1c22f3f0123632b544de484d9f42a02f64dfc768,1,Mark Payne,2016-03-11 12:54:50-05:00,['48af0bfbc5cafe06e003b2bd086b970cf49b5025'],37,37,74,1958360,4,,,,4042
59fac58c96f4127b1bf6fb7a501e934692534a03,1,Mark Payne,2016-03-11 12:54:50-05:00,['1c22f3f0123632b544de484d9f42a02f64dfc768'],38,49,87,1958447,4,0,0.125,0,4042
8e7e2916fabcf0be86602d3f4c382718eed2b433,1,Mark Payne,2016-03-11 12:54:50-05:00,['59fac58c96f4127b1bf6fb7a501e934692534a03'],1,1,2,1958449,1,,,,4042
a85c1195336a8c78c8e0d08d27dc429a881e3bc1,0,Mark Payne,2016-03-11 12:55:23-05:00,"['8e7e2916fabcf0be86602d3f4c382718eed2b433', 'e1cf37fb8953cc04a8f92382b558cf89c1563a5d']",18,44,62,1958511,2,,,,4042
7400b6f7c5a6f7ac3a682623772a306610036e72,1,joewitt,2016-03-12 20:06:23-05:00,['a85c1195336a8c78c8e0d08d27dc429a881e3bc1'],6,16,22,1958533,1,0,0.5,0,4042
0cb4047adde5f82a1554fa13431909c5e5eb4f25,1,joewitt,2016-03-13 13:28:43-04:00,['7400b6f7c5a6f7ac3a682623772a306610036e72'],120,264,384,1958917,2,0.010309278,0.742268041,1,4042
730d999d4b6b0cc869e77460e3b025deabc2b7d8,1,joewitt,2016-03-13 13:28:48-04:00,['0cb4047adde5f82a1554fa13431909c5e5eb4f25'],70,68,138,1959055,1,1,1,0,4042
ce068ffc6c4f9b979d2736b5c5527326f2d9c3a8,0,joewitt,2016-03-13 13:40:45-04:00,['730d999d4b6b0cc869e77460e3b025deabc2b7d8'],7,8,15,1959070,1,1,1,1,4042
07d4d7005b9fbd1147eebce147f2e8172cf0a787,0,joewitt,2016-03-13 13:40:56-04:00,['ce068ffc6c4f9b979d2736b5c5527326f2d9c3a8'],1,4,5,1959075,1,0,0,1,4042
5a8b2cf7f1c8df13720a74dd7f755343208c030f,1,joewitt,2016-03-13 14:08:24-04:00,['07d4d7005b9fbd1147eebce147f2e8172cf0a787'],8,36,44,1959119,3,0.666666667,0.666666667,1,4042
8c488d7e8efcc2029079bb33aa3b859ba44b931f,0,joewitt,2016-03-13 14:36:36-04:00,['5a8b2cf7f1c8df13720a74dd7f755343208c030f'],38,10,48,1959167,2,0,0.642857143,0,4042
56f79e1e8560ba9343b4da072673fcfe894d156b,1,joewitt,2016-03-14 15:59:24-04:00,['8c488d7e8efcc2029079bb33aa3b859ba44b931f'],107,278,385,1959552,3,0.22826087,0.326086957,1,4042
c7df94e00f5ac456b2ca094841ffee9325c2ea53,1,joewitt,2016-03-14 17:13:55-04:00,['56f79e1e8560ba9343b4da072673fcfe894d156b'],46,98,144,1959696,8,0,0.619047619,0.761904762,4043
76ce3f75201c9327578453635a8472ac68608faf,0,Tony Kurc,2016-03-14 19:24:21-04:00,['c7df94e00f5ac456b2ca094841ffee9325c2ea53'],10,88,98,1959794,2,0,0,1,4043
f22db218e3903191acef7eec593bdefbd2685b74,0,trkurc,2016-03-14 22:40:25-04:00,['76ce3f75201c9327578453635a8472ac68608faf'],1,2,3,1959797,1,,,,4043
3f295b13c97d77811477f9d19480b02003209529,1,Matt Burgess,2016-03-15 10:03:32-04:00,['f22db218e3903191acef7eec593bdefbd2685b74'],34,41,75,1959872,2,,,,4043
54670486bc1a736a659001678ad51cd477f239ea,0,Matt Burgess,2016-03-15 10:08:41-04:00,['3f295b13c97d77811477f9d19480b02003209529'],40,43,83,1959955,1,,,,4043
a4a7d537696a279bbd9171aee916f33b679051ea,1,joewitt,2016-03-15 12:54:03-04:00,['54670486bc1a736a659001678ad51cd477f239ea'],11,3,14,1959969,2,0.714285714,0,0,4043
cfeebfe7c744f4f0f239ea8256f1adfb62ae6049,0,joewitt,2016-03-15 12:54:13-04:00,['a4a7d537696a279bbd9171aee916f33b679051ea'],7,1,8,1959977,1,1,1,1,4043
812da19cad5f33437c3ae7a35fa758af3de54a11,1,jpercivall,2016-03-15 15:48:03-04:00,['cfeebfe7c744f4f0f239ea8256f1adfb62ae6049'],1,3181,3182,1963159,38,0.466272189,0.84852071,0.938461538,4078
d78c7faf14550b991cf4f6a9f7725d958fa6d38a,0,joewitt,2016-03-15 21:35:50-04:00,['812da19cad5f33437c3ae7a35fa758af3de54a11'],0,4,4,1963163,1,,,,4078
2b0a0c0597c75b199f793acd7f8419f88a387b16,0,joewitt,2016-03-15 21:40:08-04:00,['d78c7faf14550b991cf4f6a9f7725d958fa6d38a'],0,4,4,1963167,1,,,,4078
8ed64c90835abb6f387d982115615ebc67a53393,0,joewitt,2016-03-15 21:43:06-04:00,['2b0a0c0597c75b199f793acd7f8419f88a387b16'],0,4,4,1963171,1,,,,4078
19bc5ba999219bc24a2b09246498cfdf23c96c7c,0,Aldrin Piri,2016-03-16 09:56:08-04:00,['8ed64c90835abb6f387d982115615ebc67a53393'],0,750,750,1963921,5,0.203309693,0.843971631,0.959810875,4082
e83429a08c4c2b316567477c5cb9db2bf25a7018,1,joewitt,2016-03-16 11:06:21-04:00,['19bc5ba999219bc24a2b09246498cfdf23c96c7c'],2,2,4,1963925,1,,,,4082
0f61079300fdf63dd24288c0d2e70d7707dab08f,1,jpercivall,2016-03-16 14:09:15-04:00,['e83429a08c4c2b316567477c5cb9db2bf25a7018'],0,2809,2809,1966734,16,0.252738654,0.578247261,0.734741784,4095
68cfc8c61272bc278af853f290e96c87681098b1,0,joewitt,2016-03-16 15:19:17-04:00,['0f61079300fdf63dd24288c0d2e70d7707dab08f'],7,34,41,1966775,2,0,0.888888889,1,4095
148b4497b4a31f292e9b5b2fba3ee19555bf808b,1,joewitt,2016-03-16 15:38:46-04:00,['68cfc8c61272bc278af853f290e96c87681098b1'],25,143,168,1966943,6,0,0.04950495,0,4095
98395de74ffb0d5cd6c7b8842b501f81b2d3ed92,1,Mark Payne,2016-03-16 15:55:57-04:00,['148b4497b4a31f292e9b5b2fba3ee19555bf808b'],5,998,1003,1967946,4,0.173112339,0.515653775,0.832412523,4097
a7b97419e5e0addba6a4758fc735e6259cc06e44,1,jpercivall,2016-03-16 16:12:00-04:00,['98395de74ffb0d5cd6c7b8842b501f81b2d3ed92'],27,118,145,1968091,5,0.076923077,0.076923077,0,4098
b188b0abd6901f702c58737b616fa7cd1874c1df,1,joewitt,2016-03-16 17:43:28-04:00,['a7b97419e5e0addba6a4758fc735e6259cc06e44'],1,32,33,1968124,3,0.9375,0.9375,0.8125,4098
76f2d5702fe3465471c78a1d23d557f33d0b7664,1,Matt Gilman,2016-03-17 13:10:09-04:00,['b188b0abd6901f702c58737b616fa7cd1874c1df'],548,1342,1890,1970014,30,0.920731707,0.932926829,1,4108
94cf1beebaa4dd3c4c5382e09f2dfa286d0920de,0,Matt Gilman,2016-03-17 13:53:07-04:00,['76f2d5702fe3465471c78a1d23d557f33d0b7664'],2,2,4,1970018,1,,,,4108
8773ec3d3e829bc3f7e78a5b08a04b1681b909e0,1,Bryan Bende,2016-03-17 17:12:57-04:00,['94cf1beebaa4dd3c4c5382e09f2dfa286d0920de'],505,1274,1779,1971797,51,0.625827815,0.913907285,0.874172185,4118
138c71de8279b439a8f51e6c3489634a0e29955a,0,joewitt,2016-03-17 17:18:56-04:00,['8773ec3d3e829bc3f7e78a5b08a04b1681b909e0'],2,0,2,1971799,1,0,0,0,4118
b44b177039e312ee7553494ebdc7b732cace779e,1,Matt Burgess,2016-03-17 22:14:24-04:00,['138c71de8279b439a8f51e6c3489634a0e29955a'],10,10,20,1971819,10,,,,4118
e7a254f78ee5846e38487b02ffa6857ff9f41ea6,0,Aldrin Piri,2016-03-17 23:03:51-04:00,['b44b177039e312ee7553494ebdc7b732cace779e'],1,100,101,1971920,3,0.176470588,1,1,4119
e12e7a55b75f5e358bdbcea79be9baba77532f94,0,Matt Burgess,2016-03-17 23:15:12-04:00,['e7a254f78ee5846e38487b02ffa6857ff9f41ea6'],23,32,55,1971975,2,0,1,1,4119
8f40d2b18161a3db9abb954fc31cb7e77e989a99,1,trkurc,2016-03-17 23:43:47-04:00,['e12e7a55b75f5e358bdbcea79be9baba77532f94'],0,1740,1740,1973715,23,0.345814978,0.702643172,0.865638767,4139
3a4546c08a2804433627f0a9190c37ae657a139e,0,Matt Burgess,2016-03-18 00:23:16-04:00,['8f40d2b18161a3db9abb954fc31cb7e77e989a99'],10,21,31,1973746,4,0,0.333333333,1,4140
bb738f978a44e787f8b73ece37361c067a258400,0,joewitt,2016-03-18 10:11:00-04:00,['3a4546c08a2804433627f0a9190c37ae657a139e'],30,32,62,1973808,2,1,1,0,4140
3921ab827b650da9142e0b6986c6986d69fdb42d,1,Tony Kurc,2016-03-20 15:01:57-04:00,['bb738f978a44e787f8b73ece37361c067a258400'],17,39,56,1973864,3,0.882352941,1,1,4140
9cde92da164393c50d74c4cc4c0d6bf82c975e9c,1,trkurc,2016-03-21 01:44:46-04:00,['3921ab827b650da9142e0b6986c6986d69fdb42d'],9,154,163,1974027,4,0,0.969387755,0.93877551,4140
d3578a7c03835fb55f90fa25856f6cc7ae824994,1,Mark Payne,2016-03-21 10:30:23-04:00,['9cde92da164393c50d74c4cc4c0d6bf82c975e9c'],2,11,13,1974040,1,0,1,0,4140
38c782c30bde7d687fd6d0596fbc167c1f3f2243,0,Mark Payne,2016-03-21 10:30:24-04:00,['d3578a7c03835fb55f90fa25856f6cc7ae824994'],3,3,6,1974046,1,,,,4140
736896246cf021dbed31d4eb1e22e0755e4705f0,1,Mark Payne,2016-03-21 13:26:32-04:00,['38c782c30bde7d687fd6d0596fbc167c1f3f2243'],34,559,593,1974639,2,0.18,0.722857143,0.88,4140
4babd067c17bee335667eb81df8fb922e1fe4893,1,Aldrin Piri,2016-03-22 14:13:37-04:00,['736896246cf021dbed31d4eb1e22e0755e4705f0'],40,88,128,1974767,4,0,1,1,4140
bbbc77707f324670de63730e39804c2196178b16,0,Matt Burgess,2016-03-22 15:10:27-04:00,['4babd067c17bee335667eb81df8fb922e1fe4893'],5,60,65,1974832,2,0,1,1,4140
423b333b7128db987bac86c3104546468beea852,0,Matt Gilman,2016-03-22 15:23:42-04:00,['bbbc77707f324670de63730e39804c2196178b16'],12,229,241,1975073,2,0.031007752,0.813953488,0.976744186,4140
f120952ab79d844b92c9d7e1014068065250635f,1,Aldrin Piri,2016-03-22 20:49:39-04:00,['423b333b7128db987bac86c3104546468beea852'],3,13,16,1975089,1,0,0,1,4140
a68f87f96efdfb3c13d2032410aae38857f51183,0,joewitt,2016-03-22 21:48:47-06:00,['f120952ab79d844b92c9d7e1014068065250635f'],3,3,6,1975095,1,0,0,,4140
e0e00ff282510904e2705616164280cbd670a7d9,1,Oleg Zhurakousky,2016-03-23 10:31:34-04:00,['736896246cf021dbed31d4eb1e22e0755e4705f0'],1145,1155,2300,1977395,8,1,0.605,0.6,4145
9e39653192161c44b5a591bcfb8517f2df32dc2b,0,Mark Payne,2016-03-23 10:31:57-04:00,"['423b333b7128db987bac86c3104546468beea852', 'e0e00ff282510904e2705616164280cbd670a7d9']",1145,1155,2300,1979695,8,,,,4145
f7ecb47e29f92e4c7790358cb6205c6c13606141,0,Mark Payne,2016-03-23 11:24:28-04:00,"['9e39653192161c44b5a591bcfb8517f2df32dc2b', 'a68f87f96efdfb3c13d2032410aae38857f51183']",6,16,22,1979717,2,,,,4145
b95a82f4a516249f240075e3c402655be70106ca,1,Mark Payne,2016-03-23 11:31:20-04:00,['423b333b7128db987bac86c3104546468beea852'],2,3,5,1979722,1,0,0,1,4145
e4b7e47836edf47042973e604005058c28eed23b,0,Mark Payne,2016-03-23 12:14:35-04:00,"['f7ecb47e29f92e4c7790358cb6205c6c13606141', 'b95a82f4a516249f240075e3c402655be70106ca']",2,3,5,1979727,1,,,,4145
0b9bd20d31d7f805300254da768d91b973480151,0,Aldrin Piri,2016-03-23 18:56:22-04:00,['e4b7e47836edf47042973e604005058c28eed23b'],371,368,739,1980466,192,,,,4145
e977729b562c02f6eeb3c66e6e5187c631b9b168,0,Aldrin Piri,2016-03-23 18:56:34-04:00,['0b9bd20d31d7f805300254da768d91b973480151'],365,365,730,1981196,192,,,,4145
8000304e6a07d9cd850a0a1352095010e206d398,0,joewitt,2016-03-28 13:35:36-04:00,['e977729b562c02f6eeb3c66e6e5187c631b9b168'],32,57,89,1981285,2,0,1,1,4146
e35c40b0fd6c707e4c2f6cbf1bda7c6ab610ce3c,1,joewitt,2016-03-29 09:56:04-04:00,['8000304e6a07d9cd850a0a1352095010e206d398'],7,79,86,1981371,2,1,1,0.909090909,4147
8d960f52436a516776d6fe775be6c6f47645078b,0,joewitt,2016-03-29 09:56:04-04:00,['e35c40b0fd6c707e4c2f6cbf1bda7c6ab610ce3c'],1,1,2,1981373,1,,,,4147
1292581ec822f7e595e037aad437c2bb837b83eb,0,joewitt,2016-03-29 09:56:04-04:00,['8d960f52436a516776d6fe775be6c6f47645078b'],1,1,2,1981375,1,,,,4147
9912f18de54c6d8d7d7aaadd704199061e259330,1,joewitt,2016-03-29 09:56:08-04:00,['1292581ec822f7e595e037aad437c2bb837b83eb'],3,1,4,1981379,1,,,,4147
c3d54ab7246fba5ea1432d949c79f97f0e97f25c,0,joewitt,2016-03-29 09:56:24-04:00,['9912f18de54c6d8d7d7aaadd704199061e259330'],19,37,56,1981435,2,0,0.933333333,1,4147
65b26e6f41e9de5a198a1b310811ffa825104923,0,Bryan Bende,2016-03-29 10:51:30-04:00,['c3d54ab7246fba5ea1432d949c79f97f0e97f25c'],0,22,22,1981457,2,0.1,0.2,1,4147
65b5c1a5f1899fd58d306b81983a015e79f9355f,1,Matt Gilman,2016-04-04 09:22:55-04:00,['65b26e6f41e9de5a198a1b310811ffa825104923'],4,12,16,1981473,2,0,0,1,4147
25290cedc4f31c3bece3af34333b96d816dd9ec4,1,Mark Payne,2016-04-04 09:55:16-04:00,['65b5c1a5f1899fd58d306b81983a015e79f9355f'],69,361,430,1981903,8,0.681564246,0.972067039,0.944134078,4148
b531b97a4da2fc35b16e5bed0d24028865383ee4,0,Oleg Zhurakousky,2016-04-04 10:05:01-04:00,['25290cedc4f31c3bece3af34333b96d816dd9ec4'],36,255,291,1982194,3,0.462121212,0.545454545,1,4148
e02c79975ed8db69e63d96a28e81db08bc869e54,1,Oleg Zhurakousky,2016-04-04 10:07:50-04:00,['25290cedc4f31c3bece3af34333b96d816dd9ec4'],36,255,291,1982485,3,0.462121212,0.545454545,1,4148
bd9519182a7fb641da502dfc49d82681e0662045,0,Oleg Zhurakousky,2016-04-04 10:10:34-04:00,"['e02c79975ed8db69e63d96a28e81db08bc869e54', 'b531b97a4da2fc35b16e5bed0d24028865383ee4']",0,0,0,1982485,0,,,,4148
04c683093746da26ec72da05a530d61471d8a6d4,1,Matt Gilman,2016-04-04 10:14:05-04:00,['e02c79975ed8db69e63d96a28e81db08bc869e54'],4,68,72,1982557,3,0.64516129,0.806451613,1,4148
2337f5cad326f0992478d0f1a23727fe9b67ba9b,0,Oleg Zhurakousky,2016-04-04 10:43:26-04:00,"['bd9519182a7fb641da502dfc49d82681e0662045', '04c683093746da26ec72da05a530d61471d8a6d4']",4,68,72,1982629,3,,,,4148
16108467c19f5954ed1d31b5466471607da85bee,0,Oleg Zhurakousky,2016-04-04 11:26:55-04:00,['2337f5cad326f0992478d0f1a23727fe9b67ba9b'],4,4,8,1982637,3,,,,4148
2de7f3f8846094c2055753b3a391c6d391d3349d,1,Matt Gilman,2016-04-04 11:36:20-04:00,['16108467c19f5954ed1d31b5466471607da85bee'],364,364,728,1983365,192,,,,4148
0d3bd2c401aacc5bcd602afe90883d751ff773f3,1,Matt Gilman,2016-04-04 11:42:39-04:00,['2de7f3f8846094c2055753b3a391c6d391d3349d'],6532,7126,13658,1997023,108,0.994923858,1,0.233502538,4168
1ac05266a5cbab0c05551fc40201376cca13b540,1,Matt Gilman,2016-04-04 11:47:08-04:00,['0d3bd2c401aacc5bcd602afe90883d751ff773f3'],409,495,904,1997927,19,1,1,0,4171
9aa69b242efca4d5103852facacb412e0f0b6022,1,Matt Gilman,2016-04-04 11:47:43-04:00,['1ac05266a5cbab0c05551fc40201376cca13b540'],37,1480,1517,1999444,25,0.665226782,0.848812095,0.939524838,4190
9f7dba491f7585216b3bc3ad9fdf9234feb0f165,0,Matt Gilman,2016-04-04 11:49:25-04:00,['9aa69b242efca4d5103852facacb412e0f0b6022'],1,0,1,1999445,1,,,,4190
1c025dd4be05e6864190f0128d38e160d4857d95,1,jpercivall,2016-04-04 13:13:17-04:00,['9f7dba491f7585216b3bc3ad9fdf9234feb0f165'],0,2,2,1999447,1,0,0,1,4190
0e9e9b36d94b5a69f1a38d2838117eba79b79487,0,joewitt,2016-04-05 09:38:39-04:00,['1c025dd4be05e6864190f0128d38e160d4857d95'],28,29,57,1999504,3,0,1,1,4190
3effc6cca5b44475e7added81649afc9d76f8a9b,1,joewitt,2016-04-05 09:38:48-04:00,['0e9e9b36d94b5a69f1a38d2838117eba79b79487'],13,18,31,1999535,1,1,1,1,4190
e66315c4db9049562155db63724d76c0dd60b1ee,1,Andy LoPresto,2016-04-05 10:47:52-07:00,['3effc6cca5b44475e7added81649afc9d76f8a9b'],13,13,26,1999561,1,,,,4190
b0cc6ae7e84365f57be0518423dfb4fd67843b20,1,Bryan Bende,2016-04-06 11:04:01-04:00,['e66315c4db9049562155db63724d76c0dd60b1ee'],39,623,662,2000223,6,0.969924812,1,0.793233083,4193
84b1c60d541081bbff1eb1a6275adbf886cec26b,0,joewitt,2016-04-06 11:27:53-04:00,['b0cc6ae7e84365f57be0518423dfb4fd67843b20'],2,5,7,2000230,1,0,0,1,4193
3adb45eafc4cd2eebe2ac589ec91112006de0466,1,joewitt,2016-04-06 23:39:30-04:00,['84b1c60d541081bbff1eb1a6275adbf886cec26b'],32,26,58,2000288,2,0,0,1,4193
9235a28f82cece2eeb6de1b4767910d9b8bf8ddc,0,Oleg Zhurakousky,2016-04-07 07:37:28-04:00,['3adb45eafc4cd2eebe2ac589ec91112006de0466'],9,10,19,2000307,3,,,,4193
2bcc31330cafbba4f342e9ea464399fd6c7b575b,1,Andy LoPresto,2016-04-07 11:19:22-07:00,['9235a28f82cece2eeb6de1b4767910d9b8bf8ddc'],2,178,180,2000487,6,0.416666667,0.833333333,1,4194
c4d06f203d204d4a3128e1b997144edcd82e48a5,0,Matt Gilman,2016-04-07 16:18:36-04:00,['2bcc31330cafbba4f342e9ea464399fd6c7b575b'],11412,959,12371,2012858,155,0.712415244,0.437456161,0.082300678,4201
3f4ac3156cbf7573a2f8c3a042d9a57469518b57,0,Matt Gilman,2016-04-07 16:22:35-04:00,['c4d06f203d204d4a3128e1b997144edcd82e48a5'],959,11412,12371,2025229,155,0.287584756,0.562543839,0.917699322,4277
5de40ccec3c330c097aa9ebc2d99cb01a1e55487,1,Matt Gilman,2016-04-07 16:28:42-04:00,['3f4ac3156cbf7573a2f8c3a042d9a57469518b57'],6,735,741,2025970,13,0.470873786,0.553398058,1,4283
41583e6dc04f6fd15c812d677447588f2a4c0f51,0,Aldrin Piri,2016-04-08 09:11:20-04:00,['5de40ccec3c330c097aa9ebc2d99cb01a1e55487'],290,0,290,2026260,2,0.747252747,0.67032967,0,4283
e3155a8a4ba49bb6c4f324ebf090a92d6dd97389,1,Aldrin Piri,2016-04-08 11:23:04-04:00,['41583e6dc04f6fd15c812d677447588f2a4c0f51'],1,3019,3020,2029280,14,0.135166764,0.870684611,0.923932124,4295
47cd9ff22c3fe5657822779a4a0e03615e5b12de,0,Aldrin Piri,2016-04-10 13:21:37-04:00,['e3155a8a4ba49bb6c4f324ebf090a92d6dd97389'],6,0,6,2029286,1,,,,4295
696a12e4e796307e39afd6ed01b3e6ea35f5d501,0,Joe Skora,2016-04-11 02:05:24-04:00,['47cd9ff22c3fe5657822779a4a0e03615e5b12de'],0,6,6,2029292,1,,,,4295
5625686ea4abdd38cc168607157ac34622e7b105,0,Joe Skora,2016-04-11 02:05:48-04:00,['696a12e4e796307e39afd6ed01b3e6ea35f5d501'],1,4,5,2029297,1,1,1,1,4295
95dda1d92019401e37a4e62450c30c8edf528f18,0,Joe Skora,2016-04-11 02:24:45-04:00,['5625686ea4abdd38cc168607157ac34622e7b105'],6,0,6,2029303,1,,,,4295
e76a75c26bbe64adc8a35fa1f8846c3fd45f632d,0,joewitt,2016-04-11 13:22:00-04:00,['95dda1d92019401e37a4e62450c30c8edf528f18'],22,106,128,2029431,7,0.172413793,1,1,4296
bd1f0a82aedb6939a74a6d9428e623d8ff83b863,0,Joe Skora,2016-04-11 19:50:22-04:00,['e76a75c26bbe64adc8a35fa1f8846c3fd45f632d'],37,7,44,2029475,1,1,0,0,4296
acfc01213cf81bb920d2917bc89dcb8f4cd14f63,1,Andy LoPresto,2016-04-12 17:08:15-07:00,['bd1f0a82aedb6939a74a6d9428e623d8ff83b863'],25,23,48,2029523,1,,,,4296
dfa27263d22c6348873a751dc5cb4e5ba52bf860,1,Andy LoPresto,2016-04-12 17:44:29-07:00,['acfc01213cf81bb920d2917bc89dcb8f4cd14f63'],1,68,69,2029592,2,0,1,1,4296
378ccf53c26ef40ca56512247c93243546fefa8b,1,Andy LoPresto,2016-04-13 18:30:21-07:00,['dfa27263d22c6348873a751dc5cb4e5ba52bf860'],100,435,535,2030127,10,1,1,1,4297
b59d3ece75c3ea8eb0df1ff4827308412b967044,1,Matt Gilman,2016-04-14 10:38:03-04:00,['378ccf53c26ef40ca56512247c93243546fefa8b'],811,214,1025,2031152,4,1,0,0.775862069,4298
7db78e87a5df11820891a3e5dbc32ab7c9ad5026,0,Matt Gilman,2016-04-15 09:46:06-04:00,['b59d3ece75c3ea8eb0df1ff4827308412b967044'],159,25337,25496,2056648,44,0.988406512,0.8875185,0.843611248,4328
153f63ef43fd4511026653122fbde27e68221a57,1,Mark Payne,2016-04-15 16:03:00-04:00,['7db78e87a5df11820891a3e5dbc32ab7c9ad5026'],20549,4791,25340,2081988,284,0.684542102,0.422556853,0.193915181,4336
10986553aa8abfdae200735b1d60fe1b2423d050,0,Matt Gilman,2016-04-15 16:12:51-04:00,['153f63ef43fd4511026653122fbde27e68221a57'],4,0,4,2081992,1,,,,4336
678d64d1d4a05122182b0d57901bda685e0506dc,1,Joe Skora,2016-04-16 20:15:42-04:00,['10986553aa8abfdae200735b1d60fe1b2423d050'],164,78,242,2082234,2,1,0,0,4336
ad56f1f8535560f6486ccecc550c37d048a4133a,0,Oleg Zhurakousky,2016-04-17 14:36:13-04:00,['678d64d1d4a05122182b0d57901bda685e0506dc'],0,13,13,2082247,2,0,1,1,4336
1a57b37dc9b3d7d3cbfd41d7a7f6f152b7a6dac2,1,Oleg Zhurakousky,2016-04-17 15:53:13-04:00,['ad56f1f8535560f6486ccecc550c37d048a4133a'],2,48,50,2082297,2,1,1,1,4337
f719cbf60c58d52facaad69daf8c75f4cca5b8b6,1,Oleg Zhurakousky,2016-04-18 07:55:59-04:00,['1a57b37dc9b3d7d3cbfd41d7a7f6f152b7a6dac2'],0,77,77,2082374,2,0,0.692307692,1,4337
5e55a543eb32859878040fc6aa12c2286e09ddde,1,Oleg Zhurakousky,2016-04-18 08:15:27-04:00,['f719cbf60c58d52facaad69daf8c75f4cca5b8b6'],2,308,310,2082684,6,0.047244094,0.047244094,0.291338583,4337
5b2490f1e87505526a410a65e4b35e068a725000,1,Oleg Zhurakousky,2016-04-18 08:59:44-04:00,['5e55a543eb32859878040fc6aa12c2286e09ddde'],1,1,2,2082686,1,,,,4337
13488fd9b34dd8054e5d8c600dd20227263ccd7f,0,Andy LoPresto,2016-04-18 11:00:33-07:00,['5b2490f1e87505526a410a65e4b35e068a725000'],1,7,8,2082694,1,,,,4337
8c09a5c8d269a0bff7e6635581dc7ed316170f8c,0,Bryan Bende,2016-04-19 09:53:26-04:00,['13488fd9b34dd8054e5d8c600dd20227263ccd7f'],9,17,26,2082720,5,,,,4337
f54e5d4b1b2f5a784eeaf2f194b878adff1b8aa0,0,Bryan Bende,2016-04-19 10:23:10-04:00,['8c09a5c8d269a0bff7e6635581dc7ed316170f8c'],4,4,8,2082728,1,,,,4337
e12a79ea929a222a93fd64bfc63382441e31060f,0,Oleg Zhurakousky,2016-04-19 12:58:39-04:00,['f54e5d4b1b2f5a784eeaf2f194b878adff1b8aa0'],12,598,610,2083338,8,0.478448276,0.900862069,0.909482759,4343
0fed158d14d7c73d91d3516d2af1ea1acf902463,0,Bryan Bende,2016-04-19 16:19:17-04:00,['e12a79ea929a222a93fd64bfc63382441e31060f'],0,32,32,2083370,2,1,1,1,4343
0f05c77a7376bc44ca1e2242c03cc11f201e6a1f,1,Andy LoPresto,2016-04-19 20:25:19-07:00,['0fed158d14d7c73d91d3516d2af1ea1acf902463'],49,235,284,2083654,8,0,0.1,1,4344
b5a8f4f73bfd01bff4b31777c188f83d2130a28b,0,Oleg Zhurakousky,2016-04-20 06:57:43-04:00,['0f05c77a7376bc44ca1e2242c03cc11f201e6a1f'],1,1,2,2083656,1,,,,4344
dd8c26e35cd8066dfc7f161a89ec67de80e15b89,0,Matt Gilman,2016-04-20 10:07:18-04:00,['b5a8f4f73bfd01bff4b31777c188f83d2130a28b'],40,33,73,2083729,1,0,1,0,4344
3d6e6640972f62bb748c0c741fc74e1f7835a920,0,Oleg Zhurakousky,2016-04-20 10:33:03-04:00,['dd8c26e35cd8066dfc7f161a89ec67de80e15b89'],7,46,53,2083782,2,0.3125,1,0.6875,4344
293a3042cd4d8f0340f6e6be3f082acac97aaa67,0,Oleg Zhurakousky,2016-04-20 10:48:54-04:00,['3d6e6640972f62bb748c0c741fc74e1f7835a920'],3,16,19,2083801,3,0.777777778,1,0.777777778,4344
f94b0f2ed2734787a106b2db2e958f0d15b6e6a1,1,Andy LoPresto,2016-04-20 19:20:41-07:00,['293a3042cd4d8f0340f6e6be3f082acac97aaa67'],1,3,4,2083805,1,,,,4344
b50cf7d4d43a4efc28091978d763873255aba90f,1,Andy LoPresto,2016-04-20 22:23:38-07:00,['f94b0f2ed2734787a106b2db2e958f0d15b6e6a1'],1,136,137,2083942,4,0.511111111,0.133333333,1,4345
32398693d5917e35d3a6cd1549edd795e16fa8ec,1,Joe Skora,2016-04-21 14:05:00-04:00,['b50cf7d4d43a4efc28091978d763873255aba90f'],1,100,101,2084043,8,0.806451613,0.806451613,0.903225806,4346
add298168dcfe2d841d81d7680ea5a1179f5eb2b,1,Matt Gilman,2016-04-21 17:29:58-04:00,['32398693d5917e35d3a6cd1549edd795e16fa8ec'],4905,5139,10044,2094087,86,0.929936306,0,1,4356
531491131473ba3da9a6019b1a0861d4eddb99cd,0,Andy LoPresto,2016-04-21 20:47:23-07:00,['add298168dcfe2d841d81d7680ea5a1179f5eb2b'],0,1,1,2094088,1,,,,4356
9ea22756774a69db274513ceb83706ee95c9ed21,0,Andy LoPresto,2016-04-21 21:18:14-07:00,['531491131473ba3da9a6019b1a0861d4eddb99cd'],2,10,12,2094100,2,,,,4356
fb7b3fe4b87b8c9f45a43d460a3020947ef55dcc,1,Matt Gilman,2016-04-22 15:01:04-04:00,['9ea22756774a69db274513ceb83706ee95c9ed21'],991,2620,3611,2097711,57,0.628432956,0.838449111,0.743134087,4372
b4309e86bd15720ade5530b4f6eb0b1e603b3935,1,Aldrin Piri,2016-04-23 14:53:27-04:00,['fb7b3fe4b87b8c9f45a43d460a3020947ef55dcc'],3,3,6,2097717,1,,,,4372
eded0de154e2fcb543eda68e510bee06f0779f10,1,Aldrin Piri,2016-04-23 14:53:51-04:00,['b4309e86bd15720ade5530b4f6eb0b1e603b3935'],0,15,15,2097732,1,,,,4372
6938c3db54401e46fd7fb5f61321e7683f5a276c,1,Aldrin Piri,2016-04-27 15:22:19-04:00,['eded0de154e2fcb543eda68e510bee06f0779f10'],1,1,2,2097734,1,,,,4372
11cff0dd39bef193565e8023c8f69d9f44615927,0,Andy LoPresto,2016-04-27 15:52:54-07:00,['6938c3db54401e46fd7fb5f61321e7683f5a276c'],2,6,8,2097742,1,0,0,0,4372
a4409d366c6b1a40525cf68457da31a0cc51825d,0,Andy LoPresto,2016-04-27 16:05:16-07:00,['11cff0dd39bef193565e8023c8f69d9f44615927'],1,1,2,2097744,1,,,,4372
ff98d823e20f5042dfbb05d9f8efda0daf3d3ba4,1,Matt Gilman,2016-04-29 14:49:14-04:00,['a4409d366c6b1a40525cf68457da31a0cc51825d'],3845,5227,9072,2106816,167,1,0,1,4384
45ca978498725ca19530ed51138a252d17e4d676,0,Matt Gilman,2016-05-02 08:46:50-04:00,['ff98d823e20f5042dfbb05d9f8efda0daf3d3ba4'],1,18,19,2106835,1,0,0,1,4384
833601406496fcae4c66c93f587287f0303f069e,0,Matt Gilman,2016-05-03 08:00:34-04:00,['45ca978498725ca19530ed51138a252d17e4d676'],2,2,4,2106839,1,,,,4384
106b0fa0fcef329ffe2bef0ececa0ff2523c31d9,1,Bryan Bende,2016-05-03 13:51:38-04:00,['833601406496fcae4c66c93f587287f0303f069e'],2,2770,2772,2109611,18,0.170048309,0.620289855,0.800966184,4398
05570956134cdd23adc3324087a441943ba3dec0,1,Oleg Zhurakousky,2016-05-03 14:01:45-04:00,['106b0fa0fcef329ffe2bef0ececa0ff2523c31d9'],0,210,210,2109821,9,,,,4406
50c02ee4592d5383a2381152aa8ca822d758acad,1,Aldrin Piri,2016-05-03 14:19:28-04:00,['05570956134cdd23adc3324087a441943ba3dec0'],0,25,25,2109846,2,,,,4407
1df8fe44c4aaa3eb51246a1a2804050b412ee123,1,Matt Gilman,2016-05-03 14:20:46-04:00,['50c02ee4592d5383a2381152aa8ca822d758acad'],27038,4588,31626,2141472,138,0,0.151580239,0.167842897,4432
e3bdee8b1ea27d3fe4f525f87912de74d1f6b68d,1,Oleg Zhurakousky,2016-05-03 14:27:13-04:00,['1df8fe44c4aaa3eb51246a1a2804050b412ee123'],37,196,233,2141705,3,0.046511628,1,1,4432
defb6f5b6103ba7ee6be1644f7649402cdf97953,1,Matt Burgess,2016-05-03 14:38:11-04:00,['e3bdee8b1ea27d3fe4f525f87912de74d1f6b68d'],0,826,826,2142531,22,0.789115646,0.948979592,1,4447
194fc048fb856c079e1e55e746b82375b836397d,0,Matt Burgess,2016-05-03 15:09:29-04:00,['defb6f5b6103ba7ee6be1644f7649402cdf97953'],1,16,17,2142548,3,1,1,1,4447
2824f5a23c446bc2306751a890cbeca41dd0c2e4,0,Oleg Zhurakousky,2016-05-03 15:32:49-04:00,['194fc048fb856c079e1e55e746b82375b836397d'],44,56,100,2142648,13,,,,4447
46f8693bc6e906d66326e48233e139924648b904,0,Oleg Zhurakousky,2016-05-04 11:44:09-04:00,['2824f5a23c446bc2306751a890cbeca41dd0c2e4'],1,2,3,2142651,1,,,,4447
ddf8c6f8fa6bf808ef407708d5e70529b721468f,1,Aldrin Piri,2016-05-04 12:15:45-04:00,['46f8693bc6e906d66326e48233e139924648b904'],3,386,389,2143040,7,0.438502674,0.64171123,1,4449
5999eab43fea5d7efc481182e0af0e2a19f960d4,1,Oleg Zhurakousky,2016-05-04 14:23:10-04:00,['ddf8c6f8fa6bf808ef407708d5e70529b721468f'],1,1,2,2143042,1,,,,4449
c527f642308ad229f0f2527368d3202c19ff3be9,0,Matt Gilman,2016-05-04 15:23:11-04:00,['5999eab43fea5d7efc481182e0af0e2a19f960d4'],8,30,38,2143080,1,,,,4449
3db14f58fe0fea2aabf32915c82731078579b921,0,ijokarumawak,2016-05-06 14:35:16+09:00,['c527f642308ad229f0f2527368d3202c19ff3be9'],1,0,1,2143081,1,,,,4449
04c41c0654b166c9f42844cc9907ea791f4563bc,1,Matt Gilman,2016-05-06 15:23:12-04:00,['3db14f58fe0fea2aabf32915c82731078579b921'],3931,9874,13805,2156886,135,0.522922636,0.746418338,0.840019102,4511
9db1def6c6c850ba6c0dddb1414b09985a2e3298,1,Matt Gilman,2016-05-06 15:50:06-04:00,['04c41c0654b166c9f42844cc9907ea791f4563bc'],2681,2990,5671,2162557,60,0.770334928,0.846889952,1,4511
e2bbea1c531e7a5240fe9eeded7ec87a28e054f5,1,jpercivall,2016-05-06 18:00:40-04:00,['9db1def6c6c850ba6c0dddb1414b09985a2e3298'],26,56,82,2162639,2,0.045454545,1,1,4511
e5925ff4b33c7768666099ab683e68b8bc2efec4,0,jpercivall,2016-05-06 18:02:44-04:00,['e2bbea1c531e7a5240fe9eeded7ec87a28e054f5'],7,6,13,2162652,6,0,1,0,4511
63a0d0c211be8038905752a162732eef8ad1c436,1,jpercivall,2016-05-06 19:38:52-04:00,['e5925ff4b33c7768666099ab683e68b8bc2efec4'],0,1,1,2162653,1,0,0,1,4511
993d3cd78f66c24ccad2c4b5c6b5b2ddaf957832,0,Aldrin Piri,2016-05-06 23:04:11-04:00,['63a0d0c211be8038905752a162732eef8ad1c436'],8,12,20,2162673,1,,,,4511
9064b976317e316f42ac279dd026105b54a17ddb,0,jpercivall,2016-05-07 11:51:26-04:00,['993d3cd78f66c24ccad2c4b5c6b5b2ddaf957832'],20,86,106,2162779,4,0.523809524,0.904761905,1,4512
b4e4f3eed5be766cc7e14b96db96a86a54b051ee,0,Aldrin Piri,2016-05-07 15:01:24-04:00,['9064b976317e316f42ac279dd026105b54a17ddb'],124,0,124,2162903,2,,,,4512
7a5d53b8d394a7d446ff84be35dd1a39253f25bc,0,Aldrin Piri,2016-05-08 14:31:25-04:00,['b4e4f3eed5be766cc7e14b96db96a86a54b051ee'],0,13,13,2162916,1,,,,4512
257590dec3756b9576faec0543b3ca6a74d114ca,0,Matt Gilman,2016-05-08 21:32:34-04:00,['7a5d53b8d394a7d446ff84be35dd1a39253f25bc'],2,1,3,2162919,1,,,,4512
5fb27e608f3b83772d6d6f2c710db7938e280ea5,1,Matt Gilman,2016-05-09 08:17:46-04:00,['257590dec3756b9576faec0543b3ca6a74d114ca'],0,171,171,2163090,3,0.153846154,1,1,4514
dc4f983c7a5baa787de898bcf373b17d27badeb1,1,Andy LoPresto,2016-05-09 10:31:33-07:00,['5fb27e608f3b83772d6d6f2c710db7938e280ea5'],26,25,51,2163141,1,,,,4514
cb67520129fcc589521d6f014f517c18eaca3df3,1,Matt Gilman,2016-05-09 15:16:12-04:00,['dc4f983c7a5baa787de898bcf373b17d27badeb1'],2662,2584,5246,2168387,22,1,0,0.044642857,4514
887648c86f6dc52f6dd2d48b02a4993bdafb1bb7,0,Matt Burgess,2016-05-10 13:46:40-04:00,['cb67520129fcc589521d6f014f517c18eaca3df3'],3,2,5,2168392,1,,,,4514
1370eefdd7218256fc7c68f6d72819fda737e68e,1,Andy LoPresto,2016-05-10 16:37:30-07:00,['887648c86f6dc52f6dd2d48b02a4993bdafb1bb7'],38,132,170,2168562,9,0.454545455,0.454545455,0,4516
7bd2c64adb6a6abb012861d40d84b30841043b23,1,Matt Burgess,2016-05-10 22:02:15-04:00,['1370eefdd7218256fc7c68f6d72819fda737e68e'],10,58,68,2168630,3,0,0.972222222,1,4516
7910e98ba1687a3cdeb798d88f11e72c2a4dcebe,1,Matt Burgess,2016-05-11 10:01:15-04:00,['7bd2c64adb6a6abb012861d40d84b30841043b23'],2,87,89,2168719,5,0.810810811,0.810810811,0.810810811,4517
b7aa381ab478746839ef0f4855c424edf584a4d8,0,Matt Burgess,2016-05-11 10:02:11-04:00,['7910e98ba1687a3cdeb798d88f11e72c2a4dcebe'],0,22,22,2168741,1,,,,4517
25e7f314b10ba6b49e350d9f1cc026b3bc0a3194,1,Matt Gilman,2016-05-11 14:56:05-04:00,['b7aa381ab478746839ef0f4855c424edf584a4d8'],224,1197,1421,2170162,60,0.825112108,0.923766816,0.939461883,4519
3c3304aff4a576f32bf3f18ded9a8e718280e4e8,1,Matt Gilman,2016-05-11 16:39:38-04:00,['25e7f314b10ba6b49e350d9f1cc026b3bc0a3194'],458,574,1032,2171194,14,1,1,0.923076923,4520
687a686b21457df2f5503ff5535c3d18e5949189,1,Mark Payne,2016-05-12 11:57:40-04:00,['3c3304aff4a576f32bf3f18ded9a8e718280e4e8'],0,2,2,2171196,1,,,,4520
3cc16d35ed93446a70cda7f3d8360ab3563e4179,1,Matt Gilman,2016-05-12 12:41:11-04:00,['687a686b21457df2f5503ff5535c3d18e5949189'],2317,2719,5036,2176232,53,0,0,0.129496403,4520
707aeb423129602d495481011f4ae91b54004c5c,1,Mark Payne,2016-05-13 11:27:54-04:00,['3cc16d35ed93446a70cda7f3d8360ab3563e4179'],0,1,1,2176233,1,,,,4520
87d96c022545dd359aa61113ff80b07348eb9bc3,0,Mark Payne,2016-05-13 13:28:38-04:00,['707aeb423129602d495481011f4ae91b54004c5c'],21,40,61,2176294,1,0,0,1,4520
b2ce6f1f96a0efedbffe71f33768df9d32cdd910,0,Oleg Zhurakousky,2016-05-16 13:37:51-04:00,['87d96c022545dd359aa61113ff80b07348eb9bc3'],15,15,30,2176324,1,,,,4520
347b281b2da7778fd658e3e5e81bab86c2df4b2c,1,James Wing,2016-05-16 11:57:33-07:00,['b2ce6f1f96a0efedbffe71f33768df9d32cdd910'],1,1,2,2176326,1,,,,4520
270944ec692e12c221cdff202bdab56309dfcfd7,1,Matt Gilman,2016-05-16 16:12:43-04:00,['347b281b2da7778fd658e3e5e81bab86c2df4b2c'],1000,1325,2325,2178651,41,0.73605948,0.892193309,0.765799257,4522
fa390112cec29813921d1818623904b01604beb1,1,Oleg Zhurakousky,2016-05-16 18:58:15-04:00,['270944ec692e12c221cdff202bdab56309dfcfd7'],0,219,219,2178870,5,1,1,1,4523
3070bd5e1305d5355a6d5cf6496713ad671e22ca,0,Andy LoPresto,2016-05-16 20:25:38-07:00,['fa390112cec29813921d1818623904b01604beb1'],0,82,82,2178952,1,,,,4523
cfd36c55395fdcd433202f06eac80bf12411e6e9,0,Matt Gilman,2016-05-17 08:38:26-04:00,['3070bd5e1305d5355a6d5cf6496713ad671e22ca'],14,11,25,2178977,1,0,1,1,4523
8bb56fca68b66af9f06f13e2a530681e2d561f54,1,Matt Gilman,2016-05-17 10:32:55-04:00,['cfd36c55395fdcd433202f06eac80bf12411e6e9'],2581,1461,4042,2183019,81,1,0.670529801,1,4523
17c5496c04ebbf836a0752b0e249f5e783a8651d,1,Bryan Bende,2016-05-17 10:38:47-04:00,['8bb56fca68b66af9f06f13e2a530681e2d561f54'],1,927,928,2183947,11,0.178294574,0.679586563,0.746770026,4531
a81c204565715ea36fdb2249f60440e46af0ef0e,0,Mark Payne,2016-05-17 13:31:50-04:00,['17c5496c04ebbf836a0752b0e249f5e783a8651d'],2,4,6,2183953,1,,,,4531
c13fb3159f59778e78769a1ad3a9f7131cfb7d96,1,Andy LoPresto,2016-05-17 14:58:00-07:00,['a81c204565715ea36fdb2249f60440e46af0ef0e'],64,312,376,2184329,7,0.333333333,0.380952381,1,4533
2d03489ec5dbc56bcb0dbd7b694cdf030d2532a5,1,Oleg Zhurakousky,2016-05-19 07:33:03-04:00,['c13fb3159f59778e78769a1ad3a9f7131cfb7d96'],822,5108,5930,2190259,43,0.407544836,0.863945578,0.932591218,4563
372ffb8aa08ad51a8faf25e56b794183df9f8a4a,1,Aldrin Piri,2016-05-19 13:08:09-04:00,['2d03489ec5dbc56bcb0dbd7b694cdf030d2532a5'],381,362,743,2191002,130,,,,4563
1bd2cf0d09a7111bcecffd0f473aa71c25a69845,1,Aldrin Piri,2016-05-19 14:38:41-04:00,['372ffb8aa08ad51a8faf25e56b794183df9f8a4a'],46,44,90,2191092,14,,,,4563
d6674fbb8e20ce6daeeac8cd7b07271963744bde,0,Aldrin Piri,2016-05-19 16:07:57-04:00,['1bd2cf0d09a7111bcecffd0f473aa71c25a69845'],4,2,6,2191098,2,,,,4563
afc8c645a10d0ccd5c0a6c81d319d238fc4c765b,0,Aldrin Piri,2016-05-19 16:21:45-04:00,['d6674fbb8e20ce6daeeac8cd7b07271963744bde'],6,6,12,2191110,2,,,,4563
4b74e4de7403b1798b604f21450a8687e45d7978,1,Matt Gilman,2016-05-20 14:04:24-04:00,['afc8c645a10d0ccd5c0a6c81d319d238fc4c765b'],1310,685,1995,2193105,43,0.663865546,0.659663866,0.352941176,4563
f40a090073d62160302b849a46c72ef413905b15,1,Oleg Zhurakousky,2016-05-22 10:36:03-04:00,['4b74e4de7403b1798b604f21450a8687e45d7978'],10,53,63,2193168,2,0.266666667,1,1,4563
d42ea467ca5b6d3410a9a2bcf1627de8cae16006,0,Oleg Zhurakousky,2016-05-22 10:58:48-04:00,['f40a090073d62160302b849a46c72ef413905b15'],4,4,8,2193176,1,,,,4563
4dd50c80a4fe086d94998c8e7738dcf149734a84,1,Matt Gilman,2016-05-23 14:15:32-04:00,['d42ea467ca5b6d3410a9a2bcf1627de8cae16006'],2199,3397,5596,2198772,64,0,1,0.465779468,4568
9bb6dcb5e58e3557a8545b97fa9ceef26124903c,1,Joe Skora,2016-05-24 00:27:13-04:00,['4dd50c80a4fe086d94998c8e7738dcf149734a84'],131,1283,1414,2200186,16,0.874626866,1,0.970149254,4582
714925358e9b2394aabd1ef9a63ca80b8320f42f,1,Matt Gilman,2016-05-24 09:24:11-04:00,['9bb6dcb5e58e3557a8545b97fa9ceef26124903c'],0,1822,1822,2202008,8,0.528409091,0.957954545,1,4590
5df67c5dc2be0570eb833a9be5b352a4b2b7246c,1,Bryan Bende,2016-05-24 09:51:18-04:00,['714925358e9b2394aabd1ef9a63ca80b8320f42f'],53,54,107,2202115,2,,,,4590
e1b654655a6345f441bcfc2f84bbf8e310f25ae2,1,jpercivall,2016-05-24 10:54:46-04:00,['5df67c5dc2be0570eb833a9be5b352a4b2b7246c'],2,79,81,2202196,2,0.131147541,0.983606557,0.967213115,4590
7a4c71fec76f00ce9071aef13b1da88dfef1cfc5,1,Oleg Zhurakousky,2016-05-24 13:17:31-04:00,['e1b654655a6345f441bcfc2f84bbf8e310f25ae2'],3,685,688,2202884,12,0.54375,0.775,1,4599
7923fd04c35737df8145b213536bdf333ef72713,1,Oleg Zhurakousky,2016-05-24 13:18:25-04:00,['7a4c71fec76f00ce9071aef13b1da88dfef1cfc5'],485,2667,3152,2206036,26,0.499514091,0.899902818,0.941690962,4616
433db2356710597d8ca813737a5256e1102878be,1,Andy LoPresto,2016-05-24 14:26:28-07:00,['7923fd04c35737df8145b213536bdf333ef72713'],53,2023,2076,2208112,15,0.972222222,0.972222222,0.5,4621
ae3012a9928f1063e533f263e141ed155ec61a9a,0,Matt Burgess,2016-05-24 22:43:17-04:00,['433db2356710597d8ca813737a5256e1102878be'],0,2,2,2208114,1,,,,4621
9152a9fdbb804930e4d3e6dfb44cddfa866d9338,1,Matt Gilman,2016-05-26 14:15:56-04:00,['ae3012a9928f1063e533f263e141ed155ec61a9a'],1474,2047,3521,2211635,35,1,0.88559322,0.991525424,4622
a0ff2f7a9f354ec5d9a7ee17885e96636036ed78,1,Matt Gilman,2016-05-26 14:28:24-04:00,['9152a9fdbb804930e4d3e6dfb44cddfa866d9338'],330,228,558,2212193,5,0.088888889,0.066666667,0.088888889,4622
b075f238a5d0898e5acc0b7f0d10bec6e02ddfd6,0,Matt Gilman,2016-05-26 15:23:29-04:00,['a0ff2f7a9f354ec5d9a7ee17885e96636036ed78'],4,4,8,2212201,3,,,,4622
893daf567de6c2d227ff79ba00197aad5c86cc6d,0,Matt Gilman,2016-05-30 14:40:52-04:00,['b075f238a5d0898e5acc0b7f0d10bec6e02ddfd6'],425,6604,7029,2219230,10,1,0,1,4625
f47af1ce8336c9305916f00738976f3505b01b0b,1,Oleg Zhurakousky,2016-06-01 11:37:06-04:00,['893daf567de6c2d227ff79ba00197aad5c86cc6d'],35,108,143,2219373,7,0.264705882,0.941176471,1,4626
c6af6be44cc64b851d8d1c3888e6d2c3f9bf6e05,1,trkurc,2016-06-01 08:43:54-07:00,['f47af1ce8336c9305916f00738976f3505b01b0b'],0,44,44,2219417,1,0,0,1,4626
93795bc7ba411077649351b935cb15970a7c417f,1,Pierre Villard,2016-06-01 20:17:59+02:00,['c6af6be44cc64b851d8d1c3888e6d2c3f9bf6e05'],4,47,51,2219468,2,1,1,1,4626
bcead3500d878a29c752a53cba4f244b694dc170,0,Pierre Villard,2016-06-01 21:13:59+02:00,['93795bc7ba411077649351b935cb15970a7c417f'],1,1,2,2219470,1,,,,4626
812731497553404161eb51100ba34f5121fffad9,1,Andy LoPresto,2016-06-01 16:39:58-07:00,['bcead3500d878a29c752a53cba4f244b694dc170'],6,313,319,2219789,6,0.739130435,0.739130435,0.52173913,4628
3e064101e9df8cfef037a20a69b7735771722370,0,Matt Gilman,2016-06-02 09:29:11-04:00,['812731497553404161eb51100ba34f5121fffad9'],0,2,2,2219791,1,1,1,1,4628
e587c998551d1652f480ab9f23d6a426b1068602,1,Mark Payne,2016-06-02 09:49:57-04:00,['3e064101e9df8cfef037a20a69b7735771722370'],188,53,241,2220032,16,0.666666667,0.666666667,0.666666667,4628
4f101294ebb7fc3b10fd2ec53a7ce86487835005,1,Mark Payne,2016-06-02 09:49:57-04:00,['e587c998551d1652f480ab9f23d6a426b1068602'],21,26,47,2220079,2,0,1,0,4628
950e0cfa58269d9d64e799197a1833119bc71ddc,0,Mark Payne,2016-06-02 09:49:57-04:00,['4f101294ebb7fc3b10fd2ec53a7ce86487835005'],4,2,6,2220085,1,,,,4628
f0f74fe4049f38a8c022c4bf47494b12f9ce7174,1,Matt Gilman,2016-06-02 11:56:10-04:00,['950e0cfa58269d9d64e799197a1833119bc71ddc'],451,269,720,2220805,24,0.417910448,0.850746269,0.388059701,4628
54c5c28cbb0f9f50d4aacf22cf6c819dcf0eb02d,0,jpercivall,2016-06-02 13:04:14-04:00,['f0f74fe4049f38a8c022c4bf47494b12f9ce7174'],0,2,2,2220807,1,,,,4628
5a8979150ccef1bee9f90270dd1e37efa1d020ea,1,Aldrin Piri,2016-06-02 21:58:41-04:00,['54c5c28cbb0f9f50d4aacf22cf6c819dcf0eb02d'],3,2329,2332,2223139,30,0.47879617,0.775649795,0.827633379,4655
cd011731abc4d2741c5b7bc37eb124aa041ce361,1,Mark Payne,2016-06-03 15:23:39-04:00,['5a8979150ccef1bee9f90270dd1e37efa1d020ea'],113,171,284,2223423,1,,,,4655
df0e4e7960f715a8cf7d1ae38250b7122b3a0e47,1,Matt Gilman,2016-06-03 15:29:16-04:00,['cd011731abc4d2741c5b7bc37eb124aa041ce361'],12991,5436,18427,2241850,189,0.470555086,0.315581854,0.120315582,4666
806f4d549d390feae2211c071d9556df930e686e,1,Matt Gilman,2016-06-03 16:52:02-04:00,['df0e4e7960f715a8cf7d1ae38250b7122b3a0e47'],1069,253,1322,2243172,19,0.058035714,0.334821429,0.366071429,4666
8d8a9cba794fbea0d6a940f9aa0f286b5a076784,1,Matt Gilman,2016-06-03 17:26:22-04:00,['806f4d549d390feae2211c071d9556df930e686e'],358,2000,2358,2245530,28,0.412969283,0.751990899,0.980659841,4670
b32c70c419d794a84e2ff602c0b16d511ec3e8be,1,Pierre Villard,2016-06-06 11:58:55+02:00,['8d8a9cba794fbea0d6a940f9aa0f286b5a076784'],1,52,53,2245583,2,0,0.885714286,1,4670
c090cdf29a37fafe896fdfc773a487c34f7c04c0,0,Oleg Zhurakousky,2016-06-06 09:50:57-04:00,['b32c70c419d794a84e2ff602c0b16d511ec3e8be'],1,1,2,2245585,1,,,,4670
55d32ae61013f368424bfe286ec86a1a1b25b5b5,0,Oleg Zhurakousky,2016-06-06 10:33:28-04:00,['c090cdf29a37fafe896fdfc773a487c34f7c04c0'],1,1,2,2245587,1,,,,4670
cee2426df6e85336db2f92311e9cb4e193b30332,0,Pierre Villard,2016-06-06 19:32:16+02:00,['55d32ae61013f368424bfe286ec86a1a1b25b5b5'],1,1,2,2245589,1,,,,4670
91cdd78ebcc11e7997326b9e8f6462ca45098114,1,jpercivall,2016-06-06 13:55:49-04:00,['cee2426df6e85336db2f92311e9cb4e193b30332'],65,13,78,2245667,1,1,0.040816327,0,4670
d4395a8a0820e849b27772d330d0bcffbeb8beea,0,Matt Burgess,2016-06-06 21:37:53-04:00,['91cdd78ebcc11e7997326b9e8f6462ca45098114'],51,55,106,2245773,3,1,1,1,4670
a490c29a4fe5170c6f192dfa7df4ebc752480abb,0,Matt Burgess,2016-06-07 11:20:21-04:00,['d4395a8a0820e849b27772d330d0bcffbeb8beea'],7,9,16,2245789,2,0,0,1,4670
1ac44a0a4be94da5c88a994a39b7c803e12a291b,0,Mike Moser,2016-06-07 11:37:23-04:00,['a490c29a4fe5170c6f192dfa7df4ebc752480abb'],139,590,729,2246518,2,0.096418733,0.70523416,0.831955923,4670
6710094bd79ff2570c252f739debe4bf648c795f,0,Matt Burgess,2016-06-07 14:05:32-04:00,['1ac44a0a4be94da5c88a994a39b7c803e12a291b'],7,11,18,2246536,1,,,,4670
abad7d805efe6f9d03a813097734c3615261bc76,1,Mark Payne,2016-06-07 15:34:36-04:00,['6710094bd79ff2570c252f739debe4bf648c795f'],4,276,280,2246816,8,0.321100917,0.71559633,0.944954128,4672
6de738fd04f773ba6b05b3768c5214847b55cf50,0,Mark Payne,2016-06-07 15:34:37-04:00,['abad7d805efe6f9d03a813097734c3615261bc76'],21,34,55,2246871,4,,1,1,4672
3b99e1235200a505c42b7da00f923a8193b55a7f,0,Bryan Bende,2016-06-07 17:26:58-04:00,['6de738fd04f773ba6b05b3768c5214847b55cf50'],9,70,79,2246950,2,0.538461538,0,0.846153846,4672
37488d27891f65fe22e450e6477ea7b9746c7f47,0,Bryan Bende,2016-06-07 17:55:07-04:00,['3b99e1235200a505c42b7da00f923a8193b55a7f'],1,10,11,2246961,1,,,,4672
18133988a02d80180ee55b91bc5b80807ec9f3de,0,Matt Burgess,2016-06-08 10:31:36-04:00,['37488d27891f65fe22e450e6477ea7b9746c7f47'],1,111,112,2247073,2,0.320987654,0.864197531,0.864197531,4672
8a447eec6607a2487cb9ea6a0d48717e856d15c0,1,Bryan Bende,2016-06-08 15:23:29-04:00,['18133988a02d80180ee55b91bc5b80807ec9f3de'],91,586,677,2247750,30,0.623134328,0.585820896,0.731343284,4675
9e705a8468e924df3a18a4101afd2b8c4c654ffa,0,Mark Payne,2016-06-08 15:58:27-04:00,['8a447eec6607a2487cb9ea6a0d48717e856d15c0'],7,77,84,2247834,2,0,0.25,1,4675
1c22bc015c4394adda2c36526c945f9bda4b643d,0,Mark Payne,2016-06-08 16:19:01-04:00,['9e705a8468e924df3a18a4101afd2b8c4c654ffa'],0,0,0,2247834,0,,,,4675
a5fecda5a2ffb35e21d950aa19a07127e19a419e,1,Matt Burgess,2016-06-09 12:07:00-04:00,['1c22bc015c4394adda2c36526c945f9bda4b643d'],0,8862,8862,2256696,133,0.696688742,0.929470199,0.804304636,4803
c120c4982d4fc811b06b672e3983b8ca5fb8ae64,1,Mark Payne,2016-06-09 15:09:57-04:00,['a5fecda5a2ffb35e21d950aa19a07127e19a419e'],1961,9975,11936,2268632,105,0.396337168,0.805118572,0.875557643,4839
1b965cb667e6a3c3112e05777cc369357b5d3f71,1,Matt Burgess,2016-06-10 12:19:50-04:00,['c120c4982d4fc811b06b672e3983b8ca5fb8ae64'],1,1,2,2268634,1,,,,4839
cc95e5d8c5f5d602779292cfd2abae7d594d21c4,0,Tony Kurc,2016-06-11 11:22:33-04:00,['1b965cb667e6a3c3112e05777cc369357b5d3f71'],2,234,236,2268870,4,0.151515152,0.848484848,1,4841
75bb4bfaa2d0ba99d30a550670b35d12801e8f04,1,Matt Gilman,2016-06-13 16:55:01-04:00,['cc95e5d8c5f5d602779292cfd2abae7d594d21c4'],231,251,482,2269352,11,0,0,0,4841
6cbc585438572e440c07722dc8c13d6be63e9966,0,Pierre Villard,2016-06-13 23:28:14+02:00,['75bb4bfaa2d0ba99d30a550670b35d12801e8f04'],26,44,70,2269422,7,0.272727273,0.272727273,0,4841
8b0c5a49113b026441f516df90dbad4b4ac6b012,1,Matt Burgess,2016-06-14 11:18:31-04:00,['6cbc585438572e440c07722dc8c13d6be63e9966'],7,279,286,2269708,3,0.243902439,0,1,4841
a8b42c26b615794f422c67ac205b3ed13782c89d,0,jpercivall,2016-06-14 15:15:37-04:00,['8b0c5a49113b026441f516df90dbad4b4ac6b012'],5,4,9,2269717,2,0,0,0,4841
992b5552bb30bc838db1a0dc2a0ffbfd8a57c00d,0,Oleg Zhurakousky,2016-06-15 09:33:30-04:00,['a8b42c26b615794f422c67ac205b3ed13782c89d'],1,9,10,2269727,2,0.5,1,1,4841
83d5cb365dcb3edcdc036fa6cda1aba47138d9e7,1,Pierre Villard,2016-06-15 18:54:25+02:00,['992b5552bb30bc838db1a0dc2a0ffbfd8a57c00d'],17,11,28,2269755,2,0.333333333,0.333333333,0.666666667,4841
7facf95cc5eda83d2c7f29d63691b4480304392d,0,Oleg Zhurakousky,2016-06-15 12:55:34-04:00,['992b5552bb30bc838db1a0dc2a0ffbfd8a57c00d'],41,1,42,2269797,5,0,0,0,4841
849c43b162583d23473fd899f38c568260b02c7c,0,Pierre Villard,2016-06-15 18:55:18+02:00,"['83d5cb365dcb3edcdc036fa6cda1aba47138d9e7', '7facf95cc5eda83d2c7f29d63691b4480304392d']",41,1,42,2269839,5,,,,4841
b753a82d7e9f2585a973e2fe9d0749747a2e6505,1,Oleg Zhurakousky,2016-06-15 13:00:37-04:00,['849c43b162583d23473fd899f38c568260b02c7c'],57,46,103,2269942,4,0,0,0,4841
b3de8f76febbe5e7eb871f389a2342a7fff089e6,0,Matt Gilman,2016-06-16 09:55:10-04:00,['b753a82d7e9f2585a973e2fe9d0749747a2e6505'],64,58,122,2270064,3,,,,4841
6e74c10f49d25d3160d157678ed1217a8d4adc3b,0,Matt Gilman,2016-06-16 16:51:35-04:00,['b3de8f76febbe5e7eb871f389a2342a7fff089e6'],2,2,4,2270068,1,,,,4841
4723f8e24c83b3fda68a091be7deabfd84f2b40a,1,Mike Moser,2016-06-16 17:23:19-04:00,['6e74c10f49d25d3160d157678ed1217a8d4adc3b'],0,896,896,2270964,4,0.408695652,0.684782609,1,4844
2ce785766d82c3ba390e37cb965d86e394db63d0,1,Pierre Villard,2016-06-17 00:02:28+02:00,['4723f8e24c83b3fda68a091be7deabfd84f2b40a'],0,942,942,2271906,9,0.594405594,0.792540793,0.941724942,4852
8e4a4532df92e6b1e0a461454a7440005a6bee7d,1,Andy LoPresto,2016-06-16 15:17:13-07:00,['2ce785766d82c3ba390e37cb965d86e394db63d0'],110,317,427,2272333,10,0.697674419,1,1,4855
3156220a579dd2b456acd71c4d439008c2138c43,0,Matt Gilman,2016-06-16 20:00:39-04:00,['6e74c10f49d25d3160d157678ed1217a8d4adc3b'],29,26,55,2272388,1,,1,1,4855
edce66d34f711e667225903b5c9adace502ba135,0,Matt Gilman,2016-06-16 20:17:16-04:00,['3156220a579dd2b456acd71c4d439008c2138c43'],6,6,12,2272400,1,,,,4855
c2b26eb311b1bb0edc7725f8381482fef24c82ec,0,James Wing,2016-06-16 22:05:59-07:00,"['8e4a4532df92e6b1e0a461454a7440005a6bee7d', 'edce66d34f711e667225903b5c9adace502ba135']",35,32,67,2272467,2,,,,4855
fbd299e885499170b550d17662cc482f550e0b3e,1,Bryan Bende,2016-06-17 10:16:09-04:00,['c2b26eb311b1bb0edc7725f8381482fef24c82ec'],156,3241,3397,2275864,25,0.531914894,0.973995272,0.947990544,4863
e27c2556db17dea2b5adce8ed4291d92595fe6a7,0,Matt Burgess,2016-06-17 11:22:47-04:00,['fbd299e885499170b550d17662cc482f550e0b3e'],2,56,58,2275922,2,0,0.675675676,1,4863
541bbc09328cdb49d5a7dfe5ef17dd55697e73ea,0,Oleg Zhurakousky,2016-06-17 12:16:36-04:00,['e27c2556db17dea2b5adce8ed4291d92595fe6a7'],1,1,2,2275924,1,,,,4863
548561ed4ca54cb655b072aa7536249da88b1abf,0,Oleg Zhurakousky,2016-06-17 12:32:53-04:00,['541bbc09328cdb49d5a7dfe5ef17dd55697e73ea'],4,32,36,2275960,3,0,0,0,4863
0b437e09a7a6a47ac0f717ffe695ed036d840f1c,1,Mark Payne,2016-06-17 13:20:20-04:00,['548561ed4ca54cb655b072aa7536249da88b1abf'],891,1990,2881,2278841,61,0.168103448,0.625,1,4886
2c69c2532374a23feaddf1117870986d4f376dc4,1,Mark Payne,2016-06-17 13:20:20-04:00,['0b437e09a7a6a47ac0f717ffe695ed036d840f1c'],2,2,4,2278845,1,,,,4886
c955ec1689da0bfec9531a6698acc67780a55788,1,Matt Gilman,2016-06-17 13:26:30-04:00,['2c69c2532374a23feaddf1117870986d4f376dc4'],554,826,1380,2280225,35,0.474358974,0.429487179,0.929487179,4887
db9a79f79d730db70f5ce9df0191e2d9bebf552c,1,Matt Burgess,2016-06-17 15:32:17-04:00,['c955ec1689da0bfec9531a6698acc67780a55788'],0,1060,1060,2281285,14,0.638069705,0.809651475,0.978552279,4898
679ad93f577e70d5d322fe368a5c333b525fb6da,1,Matt Gilman,2016-06-17 16:33:00-04:00,['db9a79f79d730db70f5ce9df0191e2d9bebf552c'],128,1211,1339,2282624,15,0.340567613,0.732888147,0.968280467,4903
9546bef86e8b9eaf293943bfbdaeaefedb0b8fc1,0,Andy LoPresto,2016-06-17 17:24:19-07:00,['679ad93f577e70d5d322fe368a5c333b525fb6da'],1,139,140,2282764,3,0,0,1,4904
e6250d18cfc5bb2a1d0c6b4910931b0ba3b72d22,1,Aldrin Piri,2016-06-18 12:47:07-04:00,['9546bef86e8b9eaf293943bfbdaeaefedb0b8fc1'],19,63,82,2282846,2,0.037037037,1,0.555555556,4904
406d8a19911152112794fe89f835b8f325848947,0,Aldrin Piri,2016-06-18 23:05:32-04:00,['e6250d18cfc5bb2a1d0c6b4910931b0ba3b72d22'],0,26,26,2282872,2,0.6,0.9,1,4904
b1b7e35bedf6af7e8271afabc5c43705ce89504a,0,Aldrin Piri,2016-06-19 02:21:50-04:00,['406d8a19911152112794fe89f835b8f325848947'],5,6,11,2282883,1,,,,4904
86bba1b20241fb8f21eccf08f5a56b2fda12e740,1,Oleg Zhurakousky,2016-06-19 14:58:41-04:00,['b1b7e35bedf6af7e8271afabc5c43705ce89504a'],0,3774,3774,2286657,28,0.351762821,0.774839744,0.921474359,4929
f5060a6d63dced1ac2a34b49ba134d578d9cd97a,1,Matt Burgess,2016-06-20 10:44:38-04:00,['86bba1b20241fb8f21eccf08f5a56b2fda12e740'],79,264,343,2287000,2,0.346153846,0.953846154,1,4929
0d2a9dc7e51dc9c271276ce42fa7fe140857aeae,1,Bryan Bende,2016-06-20 13:19:13-04:00,['f5060a6d63dced1ac2a34b49ba134d578d9cd97a'],62,173,235,2287235,7,0.666666667,1,1,4929
8593bd771f12834ece278eb3f511592df045a874,0,Bryan Bende,2016-06-20 13:19:20-04:00,['0d2a9dc7e51dc9c271276ce42fa7fe140857aeae'],16,72,88,2287323,4,0.142857143,0.285714286,0.142857143,4929
274dc0902efaebf98aeb46a96bccba9c9218e25c,0,Mark Payne,2016-06-20 13:48:03-04:00,['8593bd771f12834ece278eb3f511592df045a874'],31,190,221,2287544,2,0.008928571,0.803571429,1,4929
cb3aa8f5c9bd8632ad2f454dd3d73e33063e05e8,1,Matt Gilman,2016-06-20 20:30:25-04:00,['274dc0902efaebf98aeb46a96bccba9c9218e25c'],452,6089,6541,2294085,76,0.457050823,0.478525412,0.843593414,4974
d64fe416be6627682c7458ded71ba2ea6e05a899,1,Andy LoPresto,2016-06-20 18:56:41-07:00,['cb3aa8f5c9bd8632ad2f454dd3d73e33063e05e8'],89,207,296,2294381,5,0.37254902,1,1,4975
ce8a0de368f6fe9bdbf746879717c1741d8114b6,1,Matt Gilman,2016-06-20 22:24:25-04:00,['d64fe416be6627682c7458ded71ba2ea6e05a899'],177,160,337,2294718,7,0,1,1,4975
a7c912ac18c790a5701fbd4ceb355d5b874e49dd,1,jpercivall,2016-06-21 12:05:13-04:00,['ce8a0de368f6fe9bdbf746879717c1741d8114b6'],1,769,770,2295488,5,0.693298969,0.801546392,0.850515464,4978
cd846c8d627efb2606f72b6af009358dec27be63,1,jpercivall,2016-06-21 12:05:39-04:00,['a7c912ac18c790a5701fbd4ceb355d5b874e49dd'],329,484,813,2296301,9,0.677966102,0.949152542,0.762711864,4980
a6e96953f65d4bbdee8bd105ebc986e7b2e059cd,0,Pierre Villard,2016-06-21 19:25:01+02:00,['cd846c8d627efb2606f72b6af009358dec27be63'],5,0,5,2296306,1,,,,4980
c360b57a1e32ae8d6ff7696bd04037142a50c926,0,jpercivall,2016-06-21 13:44:45-04:00,['a6e96953f65d4bbdee8bd105ebc986e7b2e059cd'],1,1,2,2296308,1,,,,4980
ef192cc859c30ba0022c0124c4bac22c5930e82f,1,Aldrin Piri,2016-06-21 14:09:02-04:00,['c360b57a1e32ae8d6ff7696bd04037142a50c926'],11,136,147,2296455,3,0.254545455,0.890909091,1,4981
6f3abdbcbd4aa0d36428c623c83b0c1e18481e39,1,Oleg Zhurakousky,2016-06-21 14:46:21-04:00,['ef192cc859c30ba0022c0124c4bac22c5930e82f'],56,117,173,2296628,10,0.92,1,0.96,4982
8b27ed905d076b7571736995ef0d2ca48132b156,1,Matt Gilman,2016-06-21 14:48:14-04:00,['6f3abdbcbd4aa0d36428c623c83b0c1e18481e39'],6100,6311,12411,2309039,193,0,0.705302096,0.985203453,4984
9e54a3d260e037dd2ad154777771883a12ec42ba,1,Bryan Bende,2016-06-21 17:11:21-04:00,['8b27ed905d076b7571736995ef0d2ca48132b156'],95,324,419,2309458,26,0.163043478,0.494565217,0.989130435,4984
61a2054b38f53ca2cd26f111c7dbc7772bf5e825,0,jpercivall,2016-06-21 17:31:09-04:00,['9e54a3d260e037dd2ad154777771883a12ec42ba'],2,3,5,2309463,1,,,,4984
8ed66e5df19785ae31ee6512e93f20d36c05e2f2,0,Matt Gilman,2016-06-21 21:49:36-04:00,['61a2054b38f53ca2cd26f111c7dbc7772bf5e825'],4,7,11,2309474,1,1,1,1,4984
1eeef0e1c0f68b01ebbc6f9b83d0296f74d94555,1,jpercivall,2016-06-21 22:18:13-04:00,['8ed66e5df19785ae31ee6512e93f20d36c05e2f2'],0,3,3,2309477,1,,,,4984
27ff5f9a8734b535f3a34b257fd6b8dadc5d19f4,1,Matt Gilman,2016-06-22 07:47:03-04:00,['1eeef0e1c0f68b01ebbc6f9b83d0296f74d94555'],21,29,50,2309527,5,1,0,0,4984
32facaedb44785942a01dd392645f0f150848cdc,0,Matt Gilman,2016-06-22 08:11:12-04:00,['27ff5f9a8734b535f3a34b257fd6b8dadc5d19f4'],4,7,11,2309538,5,0,0,1,4984
f47be77b6a8b45b878777a45ba776d67e4d9504f,1,Matt Gilman,2016-06-22 10:12:41-04:00,['32facaedb44785942a01dd392645f0f150848cdc'],347,3879,4226,2313764,29,0.492467043,0.779661017,0.701506591,4998
36ab8474dd49267ca0db8b176b7b61d9d31c8dc4,1,Matt Burgess,2016-06-22 12:39:53-04:00,['f47be77b6a8b45b878777a45ba776d67e4d9504f'],0,7,7,2313771,1,0,1,1,4998
0e085bdddd8a993237e0a237588f4abf0544bcea,0,Matt Burgess,2016-06-22 13:27:31-04:00,['36ab8474dd49267ca0db8b176b7b61d9d31c8dc4'],11,36,47,2313818,6,0,0,0.058823529,4998
7e7d79fc6a0376ed27c37bd75ef5bd57d439979d,1,Joe Skora,2016-06-22 15:06:52-04:00,['0e085bdddd8a993237e0a237588f4abf0544bcea'],43,2821,2864,2316682,33,0.117370892,0.828638498,0.908450704,5007
be83f401fac8801b2bb00fdc692e6c89ad1845f4,0,Joe Skora,2016-06-22 15:13:58-04:00,['7e7d79fc6a0376ed27c37bd75ef5bd57d439979d'],1,1,2,2316684,1,,,,5007
521ce63cc383fb457e2542374e89b575ea946cd1,0,jpercivall,2016-06-22 16:45:40-04:00,['be83f401fac8801b2bb00fdc692e6c89ad1845f4'],5,64,69,2316753,3,0.243902439,1,1,5007
baed85fa3d107ae1092556e4312e33b8a8e229b4,0,James Wing,2016-06-22 21:12:35-07:00,['521ce63cc383fb457e2542374e89b575ea946cd1'],21,67,88,2316841,1,,,,5007
4f2643f668a7e028edc9d5112d0e98b411d3d9ef,1,Matt Gilman,2016-06-23 14:36:04-04:00,['baed85fa3d107ae1092556e4312e33b8a8e229b4'],68,915,983,2317824,20,0.3655706,0.773694391,0.936170213,5007
fd5327e1b94e665a048a3127471c730a1f564da8,0,Matt Gilman,2016-06-23 16:32:25-04:00,['4f2643f668a7e028edc9d5112d0e98b411d3d9ef'],13,34,47,2317871,4,1,1,0.375,5007
f0662a24ef6ddd73eecf5393cb83718d38ae5cd5,1,jpercivall,2016-06-23 16:40:00-04:00,['fd5327e1b94e665a048a3127471c730a1f564da8'],2,2,4,2317875,2,,,,5007
f0811ca45adf15edf02f0f2d5f1d2d6929edd329,1,Matt Gilman,2016-06-23 17:09:54-04:00,['f0662a24ef6ddd73eecf5393cb83718d38ae5cd5'],5670,2801,8471,2326346,103,0.229357798,0,0,5014
8da571d6d67d0f6bd870a408210cadf9dae9f61e,0,jpercivall,2016-06-23 18:43:20-04:00,['f0811ca45adf15edf02f0f2d5f1d2d6929edd329'],6,17,23,2326369,2,0,0,1,5014
82268afb0d9b3fbd7949c430b2cd4be80bdba8c2,1,Bryan Bende,2016-06-24 16:59:06-04:00,['8da571d6d67d0f6bd870a408210cadf9dae9f61e'],111,90,201,2326570,5,0,0,0,5014
b911c9dbdf00559f20dd0b063f945c5873611b4e,1,Matt Gilman,2016-06-25 17:10:59-04:00,['82268afb0d9b3fbd7949c430b2cd4be80bdba8c2'],55,68,123,2326693,2,0.4,0.4,1,5014
64719b6f9bb7bf6a70c6ffb5b287f998f3d10f6a,1,Matt Gilman,2016-06-26 22:23:25-04:00,['b911c9dbdf00559f20dd0b063f945c5873611b4e'],968,1665,2633,2329326,23,0.125,1,1,5017
ff341271a9ec77cac7d6b8ccc231007e0673e808,0,Matt Burgess,2016-06-26 22:48:32-04:00,['64719b6f9bb7bf6a70c6ffb5b287f998f3d10f6a'],32,34,66,2329392,2,,,,5017
e3d13ecf50f5096328d7576d1e97de939ddd3009,1,Bryan Bende,2016-06-27 13:49:49-04:00,['ff341271a9ec77cac7d6b8ccc231007e0673e808'],1,2,3,2329395,1,,,,5017
bb0ea78741b5576da09a87d90afeb0f600ad1ee1,1,Matt Gilman,2016-06-28 08:16:50-04:00,['e3d13ecf50f5096328d7576d1e97de939ddd3009'],336,388,724,2330119,41,1,0.168539326,0,5017
8c837ba1eacb1227d9b51b6dbc8fbcd5f204954a,1,Matt Gilman,2016-06-28 14:25:38-04:00,['bb0ea78741b5576da09a87d90afeb0f600ad1ee1'],8,138,146,2330265,4,0,0.484210526,1,5017
41f32534450f9331487120a1e68c08c77f1c755d,1,Matt Gilman,2016-06-28 15:38:01-04:00,['8c837ba1eacb1227d9b51b6dbc8fbcd5f204954a'],177,284,461,2330726,14,1,1,0.612903226,5019
f43f47694c9d55617a068bed62f7d70267c25bee,1,Matt Gilman,2016-06-28 16:32:27-04:00,['41f32534450f9331487120a1e68c08c77f1c755d'],192,110,302,2331028,13,0.660377358,0.830188679,0,5019
d6391652e06548427ff0e66021cb9a69e0551bdb,1,Mark Payne,2016-06-29 12:18:27-04:00,['f43f47694c9d55617a068bed62f7d70267c25bee'],47,4549,4596,2335624,10,0.293376414,0.504684976,0.6,5024
65d895827b3ca979c41daa781f1cd0d04e24c65a,1,jpercivall,2016-06-29 17:48:39-04:00,['d6391652e06548427ff0e66021cb9a69e0551bdb'],0,1740,1740,2337364,23,0.506147541,0.834016393,0.858606557,5043
ae9e2fdf0bfce31c38020784b78171709618903c,1,Matt Gilman,2016-06-30 07:57:17-04:00,['65d895827b3ca979c41daa781f1cd0d04e24c65a'],616,1598,2214,2339578,65,0.525879917,0.915113872,0.770186335,5048
8eb0a3882c4e7ff5b2b7f9ab527277fc432c6b3c,1,Matt Gilman,2016-07-01 14:21:02-04:00,['ae9e2fdf0bfce31c38020784b78171709618903c'],46,118,164,2339742,4,0,0.403846154,0.692307692,5048
ce5330330ac1e377144fc1d29d5ef9fb2f60e29f,1,Matt Gilman,2016-07-01 15:10:27-04:00,['8eb0a3882c4e7ff5b2b7f9ab527277fc432c6b3c'],2316,2055,4371,2344113,102,1,0.922077922,0.246753247,5050
e7e349631f2805662e418a3d72ab335d1211807d,0,Matt Gilman,2016-07-01 16:42:10-04:00,['ce5330330ac1e377144fc1d29d5ef9fb2f60e29f'],1,1,2,2344115,1,,,,5050
7e63b0036429d739b5d2ee4bca578d99db2b0037,0,Matt Burgess,2016-07-05 13:38:38-04:00,['e7e349631f2805662e418a3d72ab335d1211807d'],4,45,49,2344164,2,0,0.971428571,0.971428571,5050
32b8a9b9f4c07b4f5d3049c33880b547481cbb24,1,Matt Burgess,2016-07-05 14:59:08-04:00,['7e63b0036429d739b5d2ee4bca578d99db2b0037'],16,193,209,2344373,14,0.342342342,0.117117117,0.567567568,5050
470513fa2ec10dbc328b80b8b72f88f1539e523c,1,Matt Burgess,2016-07-05 15:41:36-04:00,['32b8a9b9f4c07b4f5d3049c33880b547481cbb24'],37,351,388,2344761,6,0.017777778,0.413333333,1,5050
293dc299363713097752ee8ae3ab8ff3509ee0a2,1,Matt Gilman,2016-07-06 08:02:49-04:00,['470513fa2ec10dbc328b80b8b72f88f1539e523c'],493,933,1426,2346187,73,0.20123839,0.492260062,1,5050
9d273b1e2f25e76d901fe143da97f86d575f845b,1,Oleg Zhurakousky,2016-07-06 13:03:08-04:00,['293dc299363713097752ee8ae3ab8ff3509ee0a2'],26,27,53,2346240,7,,,,5050
181386b943ea693fd62ad2fbfff65277d22834b0,1,jpercivall,2016-07-06 13:12:29-04:00,['9d273b1e2f25e76d901fe143da97f86d575f845b'],332,1986,2318,2348558,14,0.18265896,0.661271676,0.954913295,5056
f4c94e349cdf819aa5e16957ff1c6897c469dc50,1,Matt Gilman,2016-07-06 14:36:12-04:00,['181386b943ea693fd62ad2fbfff65277d22834b0'],2226,1548,3774,2352332,20,0.592964824,0.02638191,0.00879397,5066
c5889314ca2d2c936145b2a51c29c55dd4d94fd5,1,Matt Gilman,2016-07-06 16:56:07-04:00,['f4c94e349cdf819aa5e16957ff1c6897c469dc50'],531,311,842,2353174,16,1,0.858974359,0,5066
4f2d17a8d4a8a674cd22bf9df68f9d64bff93b92,1,jpercivall,2016-07-06 17:01:14-04:00,['c5889314ca2d2c936145b2a51c29c55dd4d94fd5'],9,14,23,2353197,4,0,1,1,5066
b7a584122d6c38fa32649504d8e6677caa37f84b,0,Matt Gilman,2016-07-07 07:52:28-04:00,['4f2d17a8d4a8a674cd22bf9df68f9d64bff93b92'],38,54,92,2353289,3,,,,5066
8f1202899b2be8ebae58746a9be564225a3514ce,0,Matt Burgess,2016-07-07 13:33:34-04:00,['b7a584122d6c38fa32649504d8e6677caa37f84b'],9,42,51,2353340,3,1,1,1,5066
6edfa634d4664f95a49217a88d764df37232a226,0,jpercivall,2016-07-07 15:31:38-04:00,['8f1202899b2be8ebae58746a9be564225a3514ce'],2,2,4,2353344,2,,,,5066
2ed1ab7630a91a0f966954f9821048693fe65598,1,Oleg Zhurakousky,2016-07-07 22:37:20-04:00,['6edfa634d4664f95a49217a88d764df37232a226'],37,82,119,2353463,3,0.323529412,1,1,5066
fa351a61ab6e79e9ce12ffc0dc660da877de2165,1,Matt Gilman,2016-07-08 08:50:16-04:00,['2ed1ab7630a91a0f966954f9821048693fe65598'],43,102,145,2353608,15,1,1,1,5066
22f72c3d2ed66251c1b3f020a1407463201b18c0,0,Matt Gilman,2016-07-08 08:52:29-04:00,['fa351a61ab6e79e9ce12ffc0dc660da877de2165'],28,62,90,2353698,7,1,0.653846154,1,5066
7a901952b5e9bb2ce711c6b85305fc1382354727,1,Mark Payne,2016-07-08 15:33:49-04:00,['22f72c3d2ed66251c1b3f020a1407463201b18c0'],18,122,140,2353838,4,0.134146341,0.182926829,1,5066
d61b80758c34a12535012867541313966a323216,0,joewitt,2016-07-08 16:06:04-07:00,['7a901952b5e9bb2ce711c6b85305fc1382354727'],0,0,0,2353838,2,,,,5068
59ad51af6d2e193f4c224819e3814647993fc8f3,0,joewitt,2016-07-08 16:17:43-07:00,['d61b80758c34a12535012867541313966a323216'],113,115,228,2354066,1,,,,5068
b836db21a604871f1f40abddb70ef066083b73a1,1,Matt Gilman,2016-07-11 07:15:48-04:00,['59ad51af6d2e193f4c224819e3814647993fc8f3'],19,42,61,2354127,9,0.916666667,1,1,5068
cf183e15e3d400a138791ee5ca79287e87ebd932,1,Matt Gilman,2016-07-11 08:12:44-04:00,['b836db21a604871f1f40abddb70ef066083b73a1'],1254,628,1882,2356009,33,0.494505495,0.214285714,0.434065934,5068
039fd70ded045b5afcf24f0c17595a074ebef895,1,Matt Gilman,2016-07-11 23:01:46-04:00,['cf183e15e3d400a138791ee5ca79287e87ebd932'],69,89,158,2356167,6,0,0.888888889,1,5068
4b9df7d1e24c8a8fa32ece2ee5d4118ebe5ffe18,1,Matt Gilman,2016-07-11 23:15:28-04:00,['039fd70ded045b5afcf24f0c17595a074ebef895'],17,149,166,2356333,5,0.026315789,0.5,0.973684211,5068
ba763b95e8147be159a39031b9c7396e88293ebd,1,Matt Gilman,2016-07-12 11:20:29-04:00,['4b9df7d1e24c8a8fa32ece2ee5d4118ebe5ffe18'],146,915,1061,2357394,41,0.179906542,0.792056075,0.845794393,5072
e0c96794fae85776b8b0fbb3cb236217eb591960,1,Matt Gilman,2016-07-12 15:45:13-04:00,['ba763b95e8147be159a39031b9c7396e88293ebd'],2324,6176,8500,2365894,109,0.705813953,0.811627907,0.968023256,5091
8db89c8c0b2d8e8c0c2948e92866992337f01194,1,Matt Gilman,2016-07-12 23:33:21-04:00,['e0c96794fae85776b8b0fbb3cb236217eb591960'],196,171,367,2366261,32,0,0,0.652173913,5091
3c49a932894514e44b2cad5a6dd4d7f7b78cb968,0,Matt Gilman,2016-07-13 08:19:01-04:00,['8db89c8c0b2d8e8c0c2948e92866992337f01194'],4,11,15,2366276,1,0,0,0,5091
cfaacb1d5c3726b6027934a30bc8108afd147773,1,Mark Payne,2016-07-13 08:45:57-04:00,['3c49a932894514e44b2cad5a6dd4d7f7b78cb968'],34,93,127,2366403,9,0,0.117647059,1,5091
9e2f52c8b56ba6638158c180e18c3c03551fbe16,1,Mark Payne,2016-07-13 09:01:05-04:00,['cfaacb1d5c3726b6027934a30bc8108afd147773'],580,250,830,2367233,47,0.006134969,0.006134969,0,5091
8ab9fca7f859001d6a2ec261bc2ae3fb0dc4b4b8,0,Mark Payne,2016-07-13 09:21:55-04:00,['9e2f52c8b56ba6638158c180e18c3c03551fbe16'],14,25,39,2367272,1,1,1,1,5091
1e1630cc692a79f8ac58c3d74d14f5fe225dce8d,1,Mark Payne,2016-07-13 09:32:47-04:00,['8ab9fca7f859001d6a2ec261bc2ae3fb0dc4b4b8'],199,68,267,2367539,8,0.755555556,0.344444444,0.2,5091
317918a9bbe40bf201a02daa1b147e8b624f7242,1,Mark Payne,2016-07-13 10:25:02-04:00,['1e1630cc692a79f8ac58c3d74d14f5fe225dce8d'],229,619,848,2368387,7,0.983333333,0.772222222,0.888888889,5093
e88c0d2e7081275197e52785fb51759d8a87735b,0,Mark Payne,2016-07-13 10:25:02-04:00,['317918a9bbe40bf201a02daa1b147e8b624f7242'],33,31,64,2368451,3,,,,5093
97366d61bc13892ac6da8bcea0efae575dfac49e,0,Mark Payne,2016-07-13 10:25:02-04:00,['e88c0d2e7081275197e52785fb51759d8a87735b'],32,291,323,2368774,4,,,,5094
7db728d2199cfadf77d1b2388944a57e03fce602,0,joewitt,2016-07-13 10:40:53-04:00,['97366d61bc13892ac6da8bcea0efae575dfac49e'],171,244,415,2369189,4,1,1,1,5094
252bfb5c3168a17fbbadffa0101f3e0ae3416253,0,Matt Gilman,2016-07-13 14:29:31-04:00,['7db728d2199cfadf77d1b2388944a57e03fce602'],1,1,2,2369191,1,,,,5094
6b87e1ea84d1ec42d7bdb6a7a335c8cc04416779,1,Matt Gilman,2016-07-13 14:40:43-04:00,['252bfb5c3168a17fbbadffa0101f3e0ae3416253'],4,4,8,2369199,3,,,,5094
a989f6b9c27a60e38f11518c529266d90688478d,1,jpercivall,2016-07-13 16:18:09-04:00,['6b87e1ea84d1ec42d7bdb6a7a335c8cc04416779'],8,15,23,2369222,8,1,1,1,5094
6f6e1b32d98af87c335772fc00089a63b23e7bdf,0,Matt Burgess,2016-07-13 17:35:15-04:00,['a989f6b9c27a60e38f11518c529266d90688478d'],6,136,142,2369364,4,0.2,0.816666667,0.2,5095
68242d404685d250c166ee0213942037fe8a260d,0,Matt Burgess,2016-07-13 18:10:43-04:00,['6f6e1b32d98af87c335772fc00089a63b23e7bdf'],136,6,142,2369506,4,0.8,0.183333333,0.8,5095
d403254b49ed492a24a55e72a8f6f0499312d3d5,0,jpercivall,2016-07-13 19:27:43-04:00,['68242d404685d250c166ee0213942037fe8a260d'],1,1,2,2369508,1,,,,5095
6e5e4cf52ba2599c8ec2cd9734040004acc9da14,1,Mark Payne,2016-07-14 08:50:26-04:00,['d403254b49ed492a24a55e72a8f6f0499312d3d5'],135,365,500,2370008,16,0.382978723,0.510638298,0.968085106,5097
4c9d4655a84ab4d308fcd7234fbdd8942e71e403,0,Mark Payne,2016-07-14 09:32:34-04:00,['6e5e4cf52ba2599c8ec2cd9734040004acc9da14'],6,6,12,2370020,1,,,,5097
961be21a3899191f49279295564bc22b8787b11a,1,Mark Payne,2016-07-14 09:32:34-04:00,['4c9d4655a84ab4d308fcd7234fbdd8942e71e403'],1229,129,1358,2371378,59,0.599137931,0.49137931,0.271551724,5097
f987b216090f29719976ed1693be2ea358523aa5,1,Mark Payne,2016-07-14 09:32:35-04:00,['961be21a3899191f49279295564bc22b8787b11a'],1844,129,1973,2373351,87,0.528363047,0.319286872,0.153970827,5097
cd1bccef8cb1deaa198d239804b24791207e0d39,0,Mark Payne,2016-07-14 10:10:35-04:00,['f987b216090f29719976ed1693be2ea358523aa5'],36,36,72,2373423,2,,,,5097
30889995cb6001864dd5007b12c70ac9948907da,1,Mark Payne,2016-07-14 10:35:16-04:00,['cd1bccef8cb1deaa198d239804b24791207e0d39'],152,407,559,2373982,18,0.234848485,0.598484848,0.954545455,5099
0ce352d203b6b2d274a81dccea796deaa2698af6,1,Mark Payne,2016-07-14 11:09:42-04:00,['30889995cb6001864dd5007b12c70ac9948907da'],8,8,16,2373998,2,,,,5099
3373e181584a9a5d12ca22a5be83f122320a25c4,1,Mark Payne,2016-07-14 11:31:48-04:00,['0ce352d203b6b2d274a81dccea796deaa2698af6'],120,349,469,2374467,17,0.780821918,0.780821918,1,5101
4f2607244423df678f39d29bff7e74aadb26073c,1,Mark Payne,2016-07-14 13:59:26-04:00,['3373e181584a9a5d12ca22a5be83f122320a25c4'],6,19,25,2374492,4,0.222222222,1,0.111111111,5101
b83d9bde1a42aab33e768014e89377e8b28b5336,0,Mark Payne,2016-07-14 14:01:28-04:00,['4f2607244423df678f39d29bff7e74aadb26073c'],1,1,2,2374494,1,,,,5101
2540573d77c026585eed03bf0d7cd2f042bb1df2,0,jpercivall,2016-07-14 14:49:30-04:00,['b83d9bde1a42aab33e768014e89377e8b28b5336'],8,63,71,2374565,2,1,1,1,5102
02784b5fcae02dabfdf6902e9c712ddb6205c0a8,0,Matt Gilman,2016-07-14 14:50:14-04:00,['2540573d77c026585eed03bf0d7cd2f042bb1df2'],56,60,116,2374681,4,0.5,1,1,5102
329192a7d3cee0689d8d438e8a452d52f93dd933,1,Matt Burgess,2016-07-14 15:01:46-04:00,['02784b5fcae02dabfdf6902e9c712ddb6205c0a8'],6,136,142,2374823,4,0.2,0.816666667,0.2,5103
f6136b69e53feeb77768096afba6f5cd800014a1,1,Matt Burgess,2016-07-14 15:19:47-04:00,['329192a7d3cee0689d8d438e8a452d52f93dd933'],4,5,9,2374832,1,,,,5103
a7c5b88a470d832e1690faede9a5b2f606196342,0,Aldrin Piri,2016-07-14 15:27:26-04:00,['f6136b69e53feeb77768096afba6f5cd800014a1'],5,5,10,2374842,4,1,1,1,5103
6d2168049a1dceefe0ca4277954b35c0861fdacb,0,jpercivall,2016-07-14 15:59:45-04:00,['a7c5b88a470d832e1690faede9a5b2f606196342'],1,1,2,2374844,1,,,,5103
4e3580f58e62e972f5924571a3352394213f0075,1,Aldrin Piri,2016-07-14 16:43:48-04:00,['6d2168049a1dceefe0ca4277954b35c0861fdacb'],3,466,469,2375313,4,0,1,1,5106
1da18a3f40a45a5896c1a409024bf46ec1e4b7da,1,James Wing,2016-07-14 14:07:24-07:00,['4e3580f58e62e972f5924571a3352394213f0075'],5,95,100,2375413,2,1,1,1,5107
048ba5366c7c4155e990c42f0e602b34076fc205,1,Matt Burgess,2016-07-14 18:04:14-04:00,['1da18a3f40a45a5896c1a409024bf46ec1e4b7da'],38,716,754,2376167,20,0.528395062,0.659259259,0.918518519,5115
d1129706e235548daaf4eecf7001b244300761e9,1,joewitt,2016-07-14 18:24:48-04:00,['048ba5366c7c4155e990c42f0e602b34076fc205'],263,474,737,2376904,168,0.923076923,1,0.923076923,5117
54574e3889e1ce89648d5e1af1db625274576f94,0,Matt Burgess,2016-07-15 09:55:37-04:00,['d1129706e235548daaf4eecf7001b244300761e9'],1,1,2,2376906,1,,,,5117
afc038d2c021d224d575ad4bbb05a7840d679bb7,0,joewitt,2016-07-15 11:25:22-04:00,['54574e3889e1ce89648d5e1af1db625274576f94'],17,28,45,2376951,1,0.25,1,1,5117
53326c7f9bad7322893664f9a7bc1d36399049bf,1,jpercivall,2016-07-15 11:38:50-04:00,['afc038d2c021d224d575ad4bbb05a7840d679bb7'],4,170,174,2377125,12,0.911111111,0.911111111,0.977777778,5119
5cd5a4ce788bec39e0dc5c7db93356610a9fa84e,1,Mark Payne,2016-07-15 12:14:24-04:00,['53326c7f9bad7322893664f9a7bc1d36399049bf'],143,130,273,2377398,13,0,0,0,5119
e89ee11199eb1cc4a008a7bf2658865d445b4e05,0,jpercivall,2016-07-15 12:47:37-04:00,['5cd5a4ce788bec39e0dc5c7db93356610a9fa84e'],25,694,719,2378117,2,0.175946548,0.875278396,1,5119
b67c9b6f76b0e23a2a46560ff1b43515bbc06945,0,jpercivall,2016-07-15 12:59:37-04:00,['e89ee11199eb1cc4a008a7bf2658865d445b4e05'],4,25,29,2378146,2,0.933333333,0.933333333,1,5119
c81dc1959aa48910f772b41e09b86efb15c3be49,1,Matt Gilman,2016-07-15 16:13:59-04:00,['b67c9b6f76b0e23a2a46560ff1b43515bbc06945'],761,567,1328,2379474,35,0.477876106,0,0.03539823,5120
4d4c525d9c74e81a50d582bd6b7f7045f1d322a6,0,jpercivall,2016-07-15 16:36:19-04:00,['c81dc1959aa48910f772b41e09b86efb15c3be49'],2,4,6,2379480,1,0,0,1,5120
52a961873b47d8abbe86f46be154ef6508d255ca,1,joewitt,2016-07-15 20:41:18-04:00,['4d4c525d9c74e81a50d582bd6b7f7045f1d322a6'],51,396,447,2379927,11,0.244047619,0.994047619,0.994047619,5122
1c5975da86c6684a4f50f79dc7b7e61e89895415,0,jpercivall,2016-07-16 13:31:21-04:00,['52a961873b47d8abbe86f46be154ef6508d255ca'],0,6,6,2379933,1,0,0,0,5122
ad02b43099312d0a3552cd7e032385272d076d8d,0,Mark Payne,2016-07-16 16:07:12-04:00,['1c5975da86c6684a4f50f79dc7b7e61e89895415'],28,0,28,2379961,1,0,0,0,5122
01cae237454c0d7ffedbe7dd08dbe705bc22cb09,1,jpercivall,2016-07-17 17:54:42-04:00,['ad02b43099312d0a3552cd7e032385272d076d8d'],381,1204,1585,2381546,12,0.258522727,0.366477273,0.332386364,5131
5c8636edf4bd8ee32892440794e9b40bd009abb6,1,Bryan Bende,2016-07-18 10:13:42-04:00,['01cae237454c0d7ffedbe7dd08dbe705bc22cb09'],11,100,111,2381657,3,0,0.438596491,0.877192982,5131
aa91032cde8ad1cf2caf18fc0f02b5f678e1f3a7,1,Mark Payne,2016-07-18 15:05:54-04:00,['5c8636edf4bd8ee32892440794e9b40bd009abb6'],112,961,1073,2382730,12,0.342372881,0.677966102,0.294915254,5134
f4d2919955ff3cbbd0ce4309f2f18ff295481a01,1,Oleg Zhurakousky,2016-07-18 15:49:24-04:00,['aa91032cde8ad1cf2caf18fc0f02b5f678e1f3a7'],26,28,54,2382784,5,1,1,0,5134
41c0f19e48cab615415be8a3ffbb6e467815f630,0,jpercivall,2016-07-18 15:54:14-04:00,['f4d2919955ff3cbbd0ce4309f2f18ff295481a01'],6,11,17,2382801,2,1,1,1,5134
e308c6464c543eee670e6db536345113b7f4d853,0,jpercivall,2016-07-18 17:27:15-04:00,['41c0f19e48cab615415be8a3ffbb6e467815f630'],7,55,62,2382863,1,0.085714286,0.085714286,1,5134
deb2819bfbd77557a6ee70186bd4d875144ecb13,0,Matt Gilman,2016-07-19 07:33:34-04:00,['e308c6464c543eee670e6db536345113b7f4d853'],103,101,204,2383067,6,0,0,1,5134
8e2663c54da800aadb2de1d3a72bf10ffd6cc247,0,jpercivall,2016-07-19 11:35:09-04:00,['deb2819bfbd77557a6ee70186bd4d875144ecb13'],3,11,14,2383081,3,0,1,1,5134
f1ba2403265b7f8b170862039212c341bb9e352c,1,jpercivall,2016-07-19 13:00:43-04:00,['8e2663c54da800aadb2de1d3a72bf10ffd6cc247'],0,565,565,2383646,3,0.190677966,0.576271186,1,5136
1c6d58b959bba47a67b09f562d30f47b617c3168,0,jpercivall,2016-07-19 15:15:16-04:00,['f1ba2403265b7f8b170862039212c341bb9e352c'],1,3,4,2383650,1,0,1,1,5136
6c7c3c0822919d1dc70fd4a7c162ce3118967625,1,Mark Payne,2016-07-19 15:52:35-04:00,['1c6d58b959bba47a67b09f562d30f47b617c3168'],3,3,6,2383656,1,,,,5136
8f23afde5009d992410e5f63e1f960a39a1ef419,1,Matt Gilman,2016-07-20 06:59:30-04:00,['6c7c3c0822919d1dc70fd4a7c162ce3118967625'],788,839,1627,2385283,34,0,1,1,5138
76fe751c22ce8e63ad72efcc8605f1cffb8c0e8f,0,Koji Kawamura,2016-07-21 00:09:16+09:00,['8f23afde5009d992410e5f63e1f960a39a1ef419'],0,59,59,2385342,1,,,,5138
108c815988c8473989ebff35eb0f89120cb5cc19,1,jpercivall,2016-07-20 11:22:24-04:00,['76fe751c22ce8e63ad72efcc8605f1cffb8c0e8f'],13,20,33,2385375,1,0.125,0.125,0.125,5138
2a7f135f1c8c9a31b1084860419383f4196e386c,0,jpercivall,2016-07-20 11:39:57-04:00,['108c815988c8473989ebff35eb0f89120cb5cc19'],7,17,24,2385399,3,0.333333333,0,0,5138
259f5bba47b2890af936419e27a4dff141a7aeaa,1,Pierre Villard,2016-07-20 18:39:19+02:00,['2a7f135f1c8c9a31b1084860419383f4196e386c'],0,1932,1932,2387331,19,0.163551402,0.91588785,0.92834891,5153
2a8be95480f52975f739c8e6fc09c31c50e489e7,1,joewitt,2016-07-20 15:13:37-04:00,['259f5bba47b2890af936419e27a4dff141a7aeaa'],89,115,204,2387535,12,1,0.235294118,0.411764706,5153
39a4d84a62859a1d0ef51a5755e7b4c61086a800,0,jpercivall,2016-07-20 16:05:42-04:00,['2a8be95480f52975f739c8e6fc09c31c50e489e7'],10,10,20,2387555,1,,,,5153
7f2bda29d968694f62c7e776839efb448215f6f9,0,jpercivall,2016-07-20 16:50:25-04:00,['39a4d84a62859a1d0ef51a5755e7b4c61086a800'],1,1,2,2387557,1,,,,5153
10b91ffe6c192b15c643f6d17c29924676208cc0,1,jpercivall,2016-07-20 19:44:32-04:00,['7f2bda29d968694f62c7e776839efb448215f6f9'],3,19,22,2387579,3,0,0.090909091,0.181818182,5153
370d88eeebcc3c02d5452a3c77e545093c45db3f,0,jpercivall,2016-07-20 20:06:05-04:00,['10b91ffe6c192b15c643f6d17c29924676208cc0'],1,1,2,2387581,1,,,,5153
35c0e1436ef79d2c9ba3e943b2e5dee7a1d18577,1,Koji Kawamura,2016-07-21 10:35:42+09:00,['370d88eeebcc3c02d5452a3c77e545093c45db3f'],5,5,10,2387591,3,,,,5153
5eba2b763edaac6889b4389c4b9fb03768091a75,0,jpercivall,2016-07-20 21:38:53-04:00,['35c0e1436ef79d2c9ba3e943b2e5dee7a1d18577'],24,30,54,2387645,1,1,1,1,5153
f352ea10b7645fa3e58030e49364cfa4c6641ccd,1,Matt Gilman,2016-07-21 08:22:22-04:00,['5eba2b763edaac6889b4389c4b9fb03768091a75'],47,87,134,2387779,14,,,,5153
4f672832c0efb95e324e8f48c995be6d50a1b67c,1,jpercivall,2016-07-21 10:26:30-04:00,['f352ea10b7645fa3e58030e49364cfa4c6641ccd'],0,2107,2107,2389886,20,0.287104623,0.620437956,0.952554745,5169
4e224c283f84e25c08ad4371f6ab2c323c02dd25,1,jpercivall,2016-07-21 10:39:21-04:00,['4f672832c0efb95e324e8f48c995be6d50a1b67c'],177,214,391,2390277,5,0.296296296,0.537037037,1,5169
0e8e19a4796aa96eae2a192473482a9a39f0a346,0,joewitt,2016-07-21 10:57:06-04:00,['4e224c283f84e25c08ad4371f6ab2c323c02dd25'],0,0,0,2390277,19,,,,5169
99b4af7820dc3c218f52de04982869d5bdb389b0,0,joewitt,2016-07-21 12:16:21-04:00,['0e8e19a4796aa96eae2a192473482a9a39f0a346'],0,0,0,2390277,2,,,,5169
0dbba811f364768224a8a2e4a18f07d40568d133,1,joewitt,2016-07-21 22:56:24-04:00,['99b4af7820dc3c218f52de04982869d5bdb389b0'],0,16,16,2390293,2,0,0.272727273,1,5169
4a4d60e6af5014342039f751c7b058079d643f7b,1,jpercivall,2016-07-21 23:52:01-04:00,['0dbba811f364768224a8a2e4a18f07d40568d133'],617,1150,1767,2392060,111,0.507518797,0.718045113,0,5170
4179ce6644beba27fdc9e7586fcecd792594654a,1,joewitt,2016-07-22 10:11:03-04:00,['4a4d60e6af5014342039f751c7b058079d643f7b'],63,402,465,2392525,2,0.153846154,0.207692308,0.926923077,5170
7e2740160a04bd8aa1a55a24a30f6417bf5e70ed,0,joewitt,2016-07-22 14:15:00-04:00,['4179ce6644beba27fdc9e7586fcecd792594654a'],71,71,142,2392667,3,,,,5171
393a3925dd1cd375dd1397deff7a78a96e7e1bb7,1,jpercivall,2016-07-22 18:24:52-04:00,['7e2740160a04bd8aa1a55a24a30f6417bf5e70ed'],3,127,130,2392797,2,0.31147541,0.62295082,1,5172
6932a53ec91513e7c300fdfba2a79c45614a8cea,1,jpercivall,2016-07-22 23:57:00-04:00,['393a3925dd1cd375dd1397deff7a78a96e7e1bb7'],95,76,171,2392968,6,0.6,1,1,5172
4e08ea65254edd80d487ffc17b5046c37184467c,1,joewitt,2016-07-24 17:00:21-04:00,['6932a53ec91513e7c300fdfba2a79c45614a8cea'],17,212,229,2393197,5,0.109375,0.9453125,1,5172
26ffc6d7ec1f9bebfa9a1dfe5b5e94374379c27e,1,Matt Gilman,2016-07-25 08:24:23-04:00,['4e08ea65254edd80d487ffc17b5046c37184467c'],106,152,258,2393455,21,1,0.636363636,1,5172
35ff0975bf1193a1c787af365e15a4e0da970ed9,0,Mark Payne,2016-07-25 12:14:13-04:00,['26ffc6d7ec1f9bebfa9a1dfe5b5e94374379c27e'],41,124,165,2393620,14,0.307692308,0,0.653846154,5172
b082858595c8207b124c52c765a6b93a0188d643,1,Mark Payne,2016-07-25 12:35:43-04:00,['35ff0975bf1193a1c787af365e15a4e0da970ed9'],124,41,165,2393785,14,0.692307692,1,0.346153846,5172
3e9867d5da3b11f7ebba33844bb360024f662aee,1,Mark Payne,2016-07-25 12:37:26-04:00,['b082858595c8207b124c52c765a6b93a0188d643'],98,419,517,2394302,8,0.382165605,0.573248408,1,5175
7779af69b4f6fb562e9ff0a9d135e355b8245854,1,jpercivall,2016-07-25 23:17:37-04:00,['3e9867d5da3b11f7ebba33844bb360024f662aee'],129,213,342,2394644,18,0.133333333,0,0.6,5175
67876f707b7a0547e2be9bb270eb84c14ac3c718,1,joewitt,2016-07-25 23:37:08-04:00,['7779af69b4f6fb562e9ff0a9d135e355b8245854'],42,95,137,2394781,2,0.115384615,1,1,5175
2ec43076faa98723e638c7951ed2853785de52cb,1,joewitt,2016-07-26 00:48:24-04:00,['67876f707b7a0547e2be9bb270eb84c14ac3c718'],2,6,8,2394789,2,0,1,1,5175
c27763a12fd93a94f8067188108b857de313ee61,1,Bryan Bende,2016-07-26 10:15:22-04:00,['2ec43076faa98723e638c7951ed2853785de52cb'],112,2780,2892,2397681,32,0.360225141,0.806754221,0.941838649,5196
69586d8bd00b0e1e6cc606411363851b75684554,1,Mark Payne,2016-07-26 14:15:36-04:00,['c27763a12fd93a94f8067188108b857de313ee61'],465,688,1153,2398834,33,0.615384615,0.007692308,0.284615385,5198
52bc23f5dbcc3a236df1fa88744c277e5d60e244,1,jpercivall,2016-07-26 14:24:32-04:00,['69586d8bd00b0e1e6cc606411363851b75684554'],61,113,174,2399008,6,0,0,1,5198
c3b4872b552922058c6536e0810dabfe9ca20b10,1,Matt Gilman,2016-07-26 15:24:50-04:00,['52bc23f5dbcc3a236df1fa88744c277e5d60e244'],144,402,546,2399554,10,0.13592233,0.980582524,1,5202
15d1e1bbf83fb8d5259d24997b7c0c56aa8e636e,0,Pierre Villard,2016-07-26 23:04:38+02:00,['c3b4872b552922058c6536e0810dabfe9ca20b10'],2,2,4,2399558,1,,,,5202
f3e49fefa083667fd9638dc38fa23ffa7d4d8ba0,1,Matt Gilman,2016-07-27 16:29:25-04:00,['15d1e1bbf83fb8d5259d24997b7c0c56aa8e636e'],142,239,381,2399939,21,0,0,0.939393939,5202
ae344806c0cdbe81104c339d9e810fb3cff1a3c1,1,jpercivall,2016-07-27 17:38:12-04:00,['f3e49fefa083667fd9638dc38fa23ffa7d4d8ba0'],171,193,364,2400303,25,1,0,1,5202
dedd4fcda15f952f1afc1dee398b1c8989dfcae7,1,Matt Gilman,2016-07-28 08:45:47-04:00,['ae344806c0cdbe81104c339d9e810fb3cff1a3c1'],143,706,849,2401152,11,0.672727273,0.9,0.933333333,5204
25cadf5db1e8b7f1a687a6630976379b357ea8c1,0,Matt Gilman,2016-07-28 09:09:25-04:00,['dedd4fcda15f952f1afc1dee398b1c8989dfcae7'],25,28,53,2401205,9,0,1,1,5204
09b124714eb0f97b68a77e6c2b3243a5e9ec8e06,1,jpercivall,2016-07-28 09:43:40-04:00,['25cadf5db1e8b7f1a687a6630976379b357ea8c1'],192,400,592,2401797,3,0.014814815,0.62962963,0.377777778,5204
01adb050f93ced1fe0ff85963265d286e1817a69,0,jpercivall,2016-07-28 13:01:20-04:00,['09b124714eb0f97b68a77e6c2b3243a5e9ec8e06'],2,28,30,2401827,4,0.214285714,0,0.785714286,5204
5e4ba04589686963de1fc4218dd1365197c31c02,1,Matt Gilman,2016-07-28 16:41:52-04:00,['01adb050f93ced1fe0ff85963265d286e1817a69'],277,511,788,2402615,8,0.21875,0.8203125,1,5205
da238b16efacb46cb78847027de07b197f3f88d0,0,jpercivall,2016-07-28 16:51:40-04:00,['5e4ba04589686963de1fc4218dd1365197c31c02'],18,272,290,2402905,17,0.285714286,0.642857143,0.589285714,5207
986f951ae82c1f0bac5f3658b8a749fbd5756646,0,joewitt,2016-07-28 22:00:04-04:00,['da238b16efacb46cb78847027de07b197f3f88d0'],43,53,96,2403001,4,,,,5210
b3968678471dec1eafd1f8d90eab86fd7035a4e2,1,joewitt,2016-07-28 22:23:39-04:00,['986f951ae82c1f0bac5f3658b8a749fbd5756646'],3,91,94,2403095,2,0.536585366,1,0.87804878,5211
3a153d3a486bf201d2bc755f12701e9b7230d5e0,0,joewitt,2016-07-28 22:29:08-04:00,['b3968678471dec1eafd1f8d90eab86fd7035a4e2'],0,2,2,2403097,1,,,,5211
cddbe7d41f52c28606a0c125f6916b2e96d93232,1,joewitt,2016-07-29 09:14:50-04:00,['3a153d3a486bf201d2bc755f12701e9b7230d5e0'],2,4,6,2403103,1,1,1,1,5211
cfc8a9613cb071247ef22f8fe4a3abb4e6b83151,1,joewitt,2016-07-29 09:33:47-04:00,['cddbe7d41f52c28606a0c125f6916b2e96d93232'],12,106,118,2403221,2,0.044776119,0.671641791,0.671641791,5211
bc0b5fe154c8473220c5a119434e79ca279be2c3,1,joewitt,2016-07-29 09:42:38-04:00,['cfc8a9613cb071247ef22f8fe4a3abb4e6b83151'],15,36,51,2403272,3,1,1,1,5211
70d70732b510283e8b22c603ab7db72589102d1e,1,joewitt,2016-07-29 11:02:52-04:00,['bc0b5fe154c8473220c5a119434e79ca279be2c3'],6,6,12,2403284,1,,,,5211
a73c8bba30fdd46ae53c3090c548c7ae6bc706c7,0,jpercivall,2016-07-29 11:27:09-04:00,['70d70732b510283e8b22c603ab7db72589102d1e'],9,44,53,2403337,3,1,1,1,5211
da5e468489edc2ae588ef84f6d3e231a9e6f5f5f,0,joewitt,2016-07-29 12:12:00-04:00,['a73c8bba30fdd46ae53c3090c548c7ae6bc706c7'],17,21,38,2403375,2,,,,5211
f5dfa580db15f45deaefb25ddfce410f9882676b,0,joewitt,2016-07-29 12:12:00-04:00,['da5e468489edc2ae588ef84f6d3e231a9e6f5f5f'],3,0,3,2403378,1,1,1,0,5211
a8224edb8d8c26aad8975eb2d40c2209448127fe,0,joewitt,2016-07-29 12:12:00-04:00,['f5dfa580db15f45deaefb25ddfce410f9882676b'],4,4,8,2403386,2,,,,5211
0c8fc25ba44901375d6d1a20eb9f349f0c292061,1,joewitt,2016-07-29 12:54:31-04:00,['a8224edb8d8c26aad8975eb2d40c2209448127fe'],19,19,38,2403424,2,,,,5211
a6d259ee01a72b6b7e1cd2a8e0813adb5114e418,1,Mark Payne,2016-07-29 15:29:06-04:00,['0c8fc25ba44901375d6d1a20eb9f349f0c292061'],0,4,4,2403428,1,0,1,0,5211
b213ed95e02392093925c3f2195ef2382423f2b1,0,Bryan Bende,2016-07-29 15:38:32-04:00,['a6d259ee01a72b6b7e1cd2a8e0813adb5114e418'],2,14,16,2403444,1,0,0,0,5211
8412d2662ae1cab6c52be62272a2971d199719df,1,jpercivall,2016-07-29 17:10:20-04:00,['b213ed95e02392093925c3f2195ef2382423f2b1'],608,1769,2377,2405821,87,0.92722372,1,1,5226
1bf10944eaee0e408d870c9e17a6c8224b630fad,1,Mark Payne,2016-07-31 15:24:02-04:00,['8412d2662ae1cab6c52be62272a2971d199719df'],147,460,607,2406428,11,0.024096386,0.614457831,0.813253012,5228
bfdf94d522b2f812e447d5a973e8a880cc9233bb,0,Bryan Bende,2016-08-01 11:07:26-04:00,['1bf10944eaee0e408d870c9e17a6c8224b630fad'],23,0,23,2406451,1,,,,5228
4d17504a0fd1a78f55aad2241bb426583f3a6c5a,1,joewitt,2016-08-01 11:38:59-04:00,['bfdf94d522b2f812e447d5a973e8a880cc9233bb'],38,24,62,2406513,3,,,,5228
372a316debcf271ff959d09b57e3b25f05c68cb6,0,jpercivall,2016-08-01 11:39:55-04:00,['4d17504a0fd1a78f55aad2241bb426583f3a6c5a'],5,5,10,2406523,2,,,,5228
8c011d91e147a9bab0e2ab5b2d59f5926269a654,0,Matt Burgess,2016-08-01 12:46:51-04:00,['372a316debcf271ff959d09b57e3b25f05c68cb6'],25,10,35,2406558,2,0,0,0,5228
5d63ba6a19289889f81559b7929bee0b62dae68c,1,joewitt,2016-08-01 13:30:58-04:00,['8c011d91e147a9bab0e2ab5b2d59f5926269a654'],314,284,598,2407156,9,1,0,0,5228
7f45251bbd735c8941db384e4d31860798c66b4d,0,Matt Gilman,2016-08-01 13:32:42-04:00,['5d63ba6a19289889f81559b7929bee0b62dae68c'],6,5,11,2407167,1,0,0,0,5228
05a99a93cbd255554c7b52313a4c5505c55d6572,1,joewitt,2016-08-01 14:17:26-04:00,['7f45251bbd735c8941db384e4d31860798c66b4d'],1455,1403,2858,2410025,69,0,0.276923077,0.384615385,5233
731050352d987e781cdbf726fe6546fd4c589c05,0,joewitt,2016-08-01 21:55:52-04:00,['05a99a93cbd255554c7b52313a4c5505c55d6572'],7,3,10,2410035,6,,,,5233
7a5560c33f3171d2934ae12f1b8828e579e3805f,1,joewitt,2016-08-01 22:25:08-04:00,['731050352d987e781cdbf726fe6546fd4c589c05'],1,414,415,2410450,28,,,,5260
9a2f8c598e7e067b371a6cb8f67f227e982f5b9a,0,joewitt,2016-08-01 22:54:37-04:00,['7a5560c33f3171d2934ae12f1b8828e579e3805f'],14,3,17,2410467,1,1,1,0,5260
09840027a37c076f5df6239c669fc77315b761d9,0,Koji Kawamura,2016-08-02 12:09:34+09:00,['9a2f8c598e7e067b371a6cb8f67f227e982f5b9a'],9,3,12,2410479,1,1,0,1,5260
809f042353ce0a23c25d864db810a7dc64fbcfa0,1,joewitt,2016-08-02 09:08:00-04:00,['09840027a37c076f5df6239c669fc77315b761d9'],84,404,488,2410967,22,0.141975309,0.944444444,0.703703704,5261
aae2d2787911938deb271272dd7400357a5e94c5,1,joewitt,2016-08-02 09:08:00-04:00,['809f042353ce0a23c25d864db810a7dc64fbcfa0'],23,49,72,2411039,4,1,1,0.3,5261
e23b2356172e128086585fe2c425523c3628d0e7,0,joewitt,2016-08-02 09:13:41-04:00,['aae2d2787911938deb271272dd7400357a5e94c5'],22,22,44,2411083,6,,,,5261
6bcc415eb80ea094e1245927cc2bbaa4641e6b12,0,Bryan Bende,2016-08-02 12:11:43-04:00,['e23b2356172e128086585fe2c425523c3628d0e7'],215,157,372,2411455,2,0.975,0.875,0,5261
c10d11d378ffd7c3044446830e24d50c5befc98a,1,Matt Gilman,2016-08-02 12:21:43-04:00,['6bcc415eb80ea094e1245927cc2bbaa4641e6b12'],188,190,378,2411833,19,1,1,0,5261
df11e1d2c07c841561ed085810e2a712b84e02bc,1,Matt Gilman,2016-08-02 13:58:19-04:00,['c10d11d378ffd7c3044446830e24d50c5befc98a'],5,30,35,2411868,2,0,0,1,5261
a1bb94c08a82a459341c0a63c4679bd839104c6a,1,Matt Gilman,2016-08-02 16:09:54-04:00,['df11e1d2c07c841561ed085810e2a712b84e02bc'],42,487,529,2412397,7,0.366013072,1,0.699346405,5265
ecca76099afea4944ce097981f14a4dd6b3c5142,0,jpercivall,2016-08-02 16:25:02-04:00,['a1bb94c08a82a459341c0a63c4679bd839104c6a'],2,32,34,2412431,1,0,0.6,1,5265
2a6580992bdbcd4994ddaac29c125a874e39f614,0,Matt Gilman,2016-08-02 17:01:58-04:00,['ecca76099afea4944ce097981f14a4dd6b3c5142'],3,1,4,2412435,2,,,,5265
52d97f966d2994eed2a09764da63b9764983db29,0,jpercivall,2016-08-02 17:06:25-04:00,['2a6580992bdbcd4994ddaac29c125a874e39f614'],3,0,3,2412438,1,0,0,0.75,5265
54549891e3c6fd6a3a625ec24facc0bd5de6d556,1,Mark Payne,2016-08-02 20:30:34-04:00,['52d97f966d2994eed2a09764da63b9764983db29'],73,96,169,2412607,8,0,1,0,5265
bc5237593e438405c33713602e78cf009f6614e9,1,Yolanda M. Davis,2016-08-03 10:35:11-04:00,['54549891e3c6fd6a3a625ec24facc0bd5de6d556'],10,59,69,2412676,5,0.565217391,0.695652174,0.913043478,5265
e9b87dd73436b1659b1fddcc400e7248bc00f1ee,1,joewitt,2016-08-03 07:54:10-07:00,['bc5237593e438405c33713602e78cf009f6614e9'],22,223,245,2412921,6,0.132867133,0.132867133,0.979020979,5265
16348b071d361697f517397b2da2ea32c5599c11,1,joewitt,2016-08-03 08:05:26-07:00,['e9b87dd73436b1659b1fddcc400e7248bc00f1ee'],101,160,261,2413182,13,0,0.55,0.85,5265
698cde69bad146e5e577a5f83bf3717920883d72,0,Yolanda M. Davis,2016-08-03 11:59:03-04:00,['16348b071d361697f517397b2da2ea32c5599c11'],37,93,130,2413312,2,0.366666667,1,1,5265
fca59ff9d0226ecc4d62d078291413d2fbdb1781,0,Mark Payne,2016-08-03 15:01:04-04:00,['698cde69bad146e5e577a5f83bf3717920883d72'],10,24,34,2413346,1,0,0,0,5265
9338f102cbfa681525cbf806ae71481944ac3516,1,Matt Gilman,2016-08-03 16:18:30-04:00,['fca59ff9d0226ecc4d62d078291413d2fbdb1781'],2981,2466,5447,2418793,29,0.037267081,0,0,5265
1511887a6825c1bc96285b8b3ac999cb9d2601cb,1,jpercivall,2016-08-03 18:06:30-04:00,['9338f102cbfa681525cbf806ae71481944ac3516'],110,325,435,2419228,15,0,1,1,5266
83a23f90d46201d63593f13ea4be4d88013ad765,1,Andy LoPresto,2016-08-03 15:56:12-07:00,['1511887a6825c1bc96285b8b3ac999cb9d2601cb'],7,147,154,2419382,5,0.260869565,1,0.68115942,5267
c26398eabae7f1c1ee5b489057b7924259c2d5e1,0,jpercivall,2016-08-03 19:08:25-04:00,['83a23f90d46201d63593f13ea4be4d88013ad765'],194,43,237,2419619,4,0,0,0,5267
f0401e47747e8bfc0b96ff824f23f6f0f91017f1,1,Yolanda M. Davis,2016-08-03 23:38:50-04:00,['c26398eabae7f1c1ee5b489057b7924259c2d5e1'],86,8,94,2419713,5,0.166666667,0.071428571,1,5267
fa4c6ab03cae9dae98e41ac984901df90fdd1b2a,1,Andy LoPresto,2016-08-03 21:34:11-07:00,['f0401e47747e8bfc0b96ff824f23f6f0f91017f1'],251,6000,6251,2425964,62,0.629450549,0.863736264,0.832967033,5322
ed5c44ba532111471976eb04eb8f8967c773d45c,1,Matt Gilman,2016-08-04 07:59:13-04:00,['fa4c6ab03cae9dae98e41ac984901df90fdd1b2a'],38,49,87,2426051,6,,,,5322
7a7165152e655e2633856a22ce5138ea8da68337,1,Mark Payne,2016-08-04 08:19:04-04:00,['ed5c44ba532111471976eb04eb8f8967c773d45c'],1,1,2,2426053,1,,,,5322
cda4310ad898904a13d9aeb2c6092ad1c934a919,1,Yolanda M. Davis,2016-08-04 09:11:25-04:00,['7a7165152e655e2633856a22ce5138ea8da68337'],2,36,38,2426091,2,0,0,0.739130435,5322
c2019b9339c479d0c6a50fa7894a983d336640a3,1,Bryan Bende,2016-08-04 10:05:44-04:00,['cda4310ad898904a13d9aeb2c6092ad1c934a919'],87,2270,2357,2428448,21,0.472448058,0.826558266,0.923215899,5337
59659232c729e968b30e177a3939c912aa9a7712,1,Bryan Bende,2016-08-04 10:05:45-04:00,['c2019b9339c479d0c6a50fa7894a983d336640a3'],4485,5,4490,2432938,7,0.706623586,0.495315024,0.4,5337
3943d72e95ff7b18c32d12020d34f134f4e86125,1,Bryan Bende,2016-08-04 10:05:56-04:00,['59659232c729e968b30e177a3939c912aa9a7712'],103,432,535,2433473,5,0.118644068,0.5,1,5337
1db5e73102adf0704a8050a0837eda3ad9d5ca2d,0,Yolanda M. Davis,2016-08-04 10:11:33-04:00,['3943d72e95ff7b18c32d12020d34f134f4e86125'],14,120,134,2433607,7,1,1,1,5338
321a2398ba7a729b45c3faa66926f2c890f7c97d,0,Bryan Bende,2016-08-04 11:22:01-04:00,['1db5e73102adf0704a8050a0837eda3ad9d5ca2d'],3,11,14,2433621,2,0.8,1,1,5338
0d730c5cc15c6183dbce904842656ae3ee8f9702,1,Bryan Bende,2016-08-04 14:01:05-04:00,['321a2398ba7a729b45c3faa66926f2c890f7c97d'],8,164,172,2433793,5,1,1,0.7875,5339
1ea49ad8cff63dd9e31fc4d1f6907222563306ea,1,Mark Payne,2016-08-04 14:23:29-04:00,['0d730c5cc15c6183dbce904842656ae3ee8f9702'],137,102,239,2434032,15,0,0,1,5339
bc6b22389b94b95fe3bae79a141e20d007c58ea5,0,Mark Payne,2016-08-04 14:50:30-04:00,['1ea49ad8cff63dd9e31fc4d1f6907222563306ea'],4,2,6,2434038,1,0,0,0,5339
b7b1dc2fe6f2ce4d08d3e6790034c9418e40221d,0,Mark Payne,2016-08-04 14:51:03-04:00,['bc6b22389b94b95fe3bae79a141e20d007c58ea5'],3,6,9,2434047,2,1,1,0,5339
aca2a92d6bea9e1bee48be695a84120a88c2df66,0,Bryan Bende,2016-08-04 15:08:08-04:00,['b7b1dc2fe6f2ce4d08d3e6790034c9418e40221d'],2,0,2,2434049,1,,,,5339
7ba10a6deaf2b580ff02431a81dd04b8e5065a53,1,Bryan Bende,2016-08-04 15:34:10-04:00,['aca2a92d6bea9e1bee48be695a84120a88c2df66'],0,187,187,2434236,3,0.121212121,0.96969697,0.98989899,5340
0e0166cec548d201d84426f6653a483c3147f7db,0,Bryan Bende,2016-08-04 16:12:21-04:00,['7ba10a6deaf2b580ff02431a81dd04b8e5065a53'],16,2,18,2434254,1,1,1,0,5340
d223423de91798dbccc893aebda67c331aade475,1,Andy LoPresto,2016-08-04 13:53:53-07:00,['0e0166cec548d201d84426f6653a483c3147f7db'],20,29,49,2434303,4,0,0,0,5340
04147ac22a8384ec8989100ec4954af4374ceaa9,1,Bryan Bende,2016-08-04 17:09:21-04:00,['d223423de91798dbccc893aebda67c331aade475'],3,70,73,2434376,5,1,1,1,5341
c0a253568ed0dabae42ecd14f8dfee7cec87667f,1,jpercivall,2016-08-04 18:41:18-04:00,['04147ac22a8384ec8989100ec4954af4374ceaa9'],39,97,136,2434512,3,0,0.208333333,1,5341
8d3422326520bda2c7a7afd3f400bdd3d6875bf2,1,jpercivall,2016-08-04 19:46:39-04:00,['c0a253568ed0dabae42ecd14f8dfee7cec87667f'],33,61,94,2434606,1,0,0,0.526315789,5341
8d380dcdace356f57b3dd3808518ce6f1b7c7eb5,0,Oleg Zhurakousky,2016-08-05 12:27:09-04:00,['8d3422326520bda2c7a7afd3f400bdd3d6875bf2'],2,3,5,2434611,1,,,,5341
c39a127ec8e0d27efa6cedb2c5837310dccd3d6a,1,Oleg Zhurakousky,2016-08-05 14:14:38-04:00,['8d380dcdace356f57b3dd3808518ce6f1b7c7eb5'],5,86,91,2434702,4,0,0.368421053,1,5341
7ffa30d21b2bc97ca280f881dc75a2f385deec1d,1,Oleg Zhurakousky,2016-08-05 14:14:38-04:00,['c39a127ec8e0d27efa6cedb2c5837310dccd3d6a'],26,43,69,2434771,4,0,0,1,5341
f2f070c5bec65d3a49afb0b9daf91823530f0e8e,1,Andy LoPresto,2016-08-05 12:32:06-07:00,['7ffa30d21b2bc97ca280f881dc75a2f385deec1d'],307,160,467,2435238,37,0,0.019607843,0.019607843,5341
903b1fe46511026231ab9ca5b8bdc7aa6eeaa1d6,0,Matt Gilman,2016-08-05 16:03:26-04:00,['f2f070c5bec65d3a49afb0b9daf91823530f0e8e'],2,2,4,2435242,1,,,,5341
29f53c07f5b6831d057f409b83735d8c7331ce7b,1,joewitt,2016-08-07 23:48:57-04:00,['903b1fe46511026231ab9ca5b8bdc7aa6eeaa1d6'],1,1,2,2435244,1,,,,5341
e2f649cfea4b487416255f39a9cc47aaf8a9d52e,0,joewitt,2016-08-07 23:58:09-04:00,['29f53c07f5b6831d057f409b83735d8c7331ce7b'],7,11,18,2435262,1,,,,5341
d094130a2694c1e0d3aa0538a01ed733f943d2e7,0,Matt Gilman,2016-08-08 09:06:47-04:00,['e2f649cfea4b487416255f39a9cc47aaf8a9d52e'],3,6,9,2435271,3,,,,5341
c1c052af71d4cfc8a40974e1482d5b0f3c78c902,1,Yolanda M. Davis,2016-08-08 09:15:10-04:00,['d094130a2694c1e0d3aa0538a01ed733f943d2e7'],69,326,395,2435666,15,0.372262774,0.197080292,0.95620438,5343
026a8d53d23aeea31220ad9e224fdcb323eebe22,1,joewitt,2016-08-08 09:53:56-04:00,['c1c052af71d4cfc8a40974e1482d5b0f3c78c902'],5,32,37,2435703,5,,,,5343
3fc67df0b4884a7662d77b307605e2950009ff7c,0,joewitt,2016-08-08 10:04:00-04:00,['026a8d53d23aeea31220ad9e224fdcb323eebe22'],0,0,0,2435703,1,,,,5343
120d2100a3640803746b83d36612e334012cd72b,0,joewitt,2016-08-08 10:04:51-04:00,['3fc67df0b4884a7662d77b307605e2950009ff7c'],16,8,24,2435727,1,,,,5343
9b647cd53842e442e294dc62033c8e6df6078b81,1,Matt Burgess,2016-08-08 11:57:28-04:00,['120d2100a3640803746b83d36612e334012cd72b'],67,896,963,2436690,8,0.476190476,1,0.869047619,5349
66888d2ad703246f5166716489e433c29b3c0b53,0,joewitt,2016-08-08 12:52:33-04:00,['9b647cd53842e442e294dc62033c8e6df6078b81'],17,21,38,2436728,1,,,,5349
4e08d941784bfd5926d83650a3108e1374f3015d,0,Matt Burgess,2016-08-08 13:08:18-04:00,['66888d2ad703246f5166716489e433c29b3c0b53'],0,55,55,2436783,1,,,,5349
493919922ec948175e9613bba40c820afb3c214f,1,Pierre Villard,2016-08-08 22:27:22+02:00,['4e08d941784bfd5926d83650a3108e1374f3015d'],14,14,28,2436811,11,,,,5349
d6a2409d71f52b691d4202792419dfea48a422aa,1,Pierre Villard,2016-08-08 22:27:40+02:00,['493919922ec948175e9613bba40c820afb3c214f'],1,731,732,2437543,6,0.311827957,0.752688172,0.906810036,5353
8752d11f18736648c78d2e5f0a6950a3448c7c79,1,joewitt,2016-08-08 16:54:27-04:00,['d6a2409d71f52b691d4202792419dfea48a422aa'],9,20,29,2437572,1,0.153846154,0.153846154,1,5353
ed14bf22e716e1d290ed03284699ae9421ed7fab,0,joewitt,2016-08-08 16:54:27-04:00,['8752d11f18736648c78d2e5f0a6950a3448c7c79'],2,51,53,2437625,2,0,0,0,5353
5e5c3f7c3bd6ee81666689ac41f385a7efe8bd5a,0,joewitt,2016-08-08 16:54:27-04:00,['ed14bf22e716e1d290ed03284699ae9421ed7fab'],15,10,25,2437650,1,1,1,0,5353
cb76e67a3dc3f54917f1bc4629250ac1b3ecf1ea,1,joewitt,2016-08-08 16:54:51-04:00,['5e5c3f7c3bd6ee81666689ac41f385a7efe8bd5a'],55,93,148,2437798,1,,,,5353
aae6325603aa191173b6f34545bf7111c960be6e,1,Bryan Bende,2016-08-09 12:04:31-04:00,['cb76e67a3dc3f54917f1bc4629250ac1b3ecf1ea'],46,128,174,2437972,5,,,,5353
ae8045d99bcb5edf695c96d07850282208f31e0f,0,Bryan Bende,2016-08-09 13:07:50-04:00,['aae6325603aa191173b6f34545bf7111c960be6e'],8,8,16,2437988,2,,,,5353
f6ba92229224504d0bbd1126bd8428a010bb4c45,0,joewitt,2016-08-09 14:25:07-04:00,['ae8045d99bcb5edf695c96d07850282208f31e0f'],11,12,23,2438011,2,,,,5353
18f415001589a7298f3d59c3f844d8865d719050,1,joewitt,2016-08-09 14:28:51-04:00,['f6ba92229224504d0bbd1126bd8428a010bb4c45'],16,67,83,2438094,5,0.146341463,0.048780488,1,5353
42df02f014df6ac332f41120d1d01eac0118d946,1,joewitt,2016-08-09 15:19:49-04:00,['18f415001589a7298f3d59c3f844d8865d719050'],27,41,68,2438162,6,0.375,1,1,5353
7575e87cb14074bd2156addefb4140d51c4eb178,1,joewitt,2016-08-09 15:27:24-04:00,['42df02f014df6ac332f41120d1d01eac0118d946'],13,73,86,2438248,3,,,,5353
7a1f749f6900399685f5d5e5a4c737e66c569c6b,0,Matt Burgess,2016-08-09 15:40:28-04:00,['7575e87cb14074bd2156addefb4140d51c4eb178'],46,143,189,2438437,3,0.31372549,1,0.68627451,5353
b2401522ead954c31004fa5877d51fc69d72e4da,0,joewitt,2016-08-09 15:46:58-04:00,['7a1f749f6900399685f5d5e5a4c737e66c569c6b'],1776,0,1776,2440213,8,0.628797886,0,0.039630119,5353
45c31c8305aa1b833591eaa8d6d88bf94513f2ad,1,James Wing,2016-08-09 13:20:52-07:00,['b2401522ead954c31004fa5877d51fc69d72e4da'],3,68,71,2440284,3,0.228571429,0.257142857,1,5353
fbb705e461e8bb89049973646b2016042123305f,1,Bryan Bende,2016-08-09 16:28:57-04:00,['45c31c8305aa1b833591eaa8d6d88bf94513f2ad'],51,95,146,2440430,7,0,0,0.717948718,5353
623d56c0d51f85a41c9f914029db41f8748bb291,1,joewitt,2016-08-09 16:37:20-04:00,['fbb705e461e8bb89049973646b2016042123305f'],355,373,728,2441158,82,,,,5355
f7d2cd69d447fccd4f9089143220fc2caff62fc7,1,joewitt,2016-08-09 16:37:20-04:00,['623d56c0d51f85a41c9f914029db41f8748bb291'],106,106,212,2441370,1,,,,5355
2dc094765d2b7393834ec649a5b35fb374b315fe,1,Pierre Villard,2016-08-09 22:43:29+02:00,['f7d2cd69d447fccd4f9089143220fc2caff62fc7'],32,32,64,2441434,22,,,,5355
84cac0daca24ac28d9239250a977da9076784ca5,0,Mark Payne,2016-08-09 17:15:44-04:00,['2dc094765d2b7393834ec649a5b35fb374b315fe'],6,33,39,2441473,3,,,,5355
219234d0011bfb3f12d145ec2e4dcfddfbbd8e0f,0,Bryan Bende,2016-08-10 11:06:16-04:00,['84cac0daca24ac28d9239250a977da9076784ca5'],156,2,158,2441631,1,0.793814433,0.793814433,0.453608247,5355
557d6365bf27ee2271cd9d3a147361acb6cc9c6c,0,Oleg Zhurakousky,2016-08-10 11:10:17-04:00,['219234d0011bfb3f12d145ec2e4dcfddfbbd8e0f'],8,65,73,2441704,2,0,0.971428571,0.971428571,5355
bb243127092b9524d881c2c0e75566cda0285c00,0,jpercivall,2016-08-10 11:13:30-04:00,['557d6365bf27ee2271cd9d3a147361acb6cc9c6c'],35,153,188,2441892,6,0.524590164,0.868852459,1,5355
d9720239f52261225191b28e7804d0ed2636ee0f,1,Oleg Zhurakousky,2016-08-10 12:37:15-04:00,['bb243127092b9524d881c2c0e75566cda0285c00'],14,3996,4010,2445902,8,0.405155829,0.646787226,0.788380146,5360
85877a73dc454a4b7f2b567517d345332ccb3b52,0,Oleg Zhurakousky,2016-08-10 13:27:20-04:00,['d9720239f52261225191b28e7804d0ed2636ee0f'],15,38,53,2445955,2,0.909090909,0.909090909,1,5360
2938a5353afe29d43ed3275e7d84525d60b72ec8,1,Matt Burgess,2016-08-10 14:51:05-04:00,['85877a73dc454a4b7f2b567517d345332ccb3b52'],0,17,17,2445972,3,,,,5360
d544274881f738d387ffad51b85c344a8f097238,1,Bryan Bende,2016-08-10 15:19:34-04:00,['2938a5353afe29d43ed3275e7d84525d60b72ec8'],3,35,38,2446010,1,0,0,0.25,5360
916292994c6253e5be673804abb2e659ff755f5d,0,joewitt,2016-08-10 15:47:59-04:00,['d544274881f738d387ffad51b85c344a8f097238'],0,2,2,2446012,1,,,,5360
76a4a2c48b154719c3ea750b14d568f9998069ba,1,Bryan Bende,2016-08-11 10:43:38-04:00,['916292994c6253e5be673804abb2e659ff755f5d'],60,1077,1137,2447149,21,0.407024793,0.954545455,0.859504132,5367
25a2fac453f1a39db9d1f7f759a4fdca80269eca,1,Bryan Bende,2016-08-11 10:44:28-04:00,['76a4a2c48b154719c3ea750b14d568f9998069ba'],4,9,13,2447162,1,0,0,0,5367
fa639e2596cc125af80615066f500cc908d4db6a,1,jpercivall,2016-08-11 20:42:35-04:00,['25a2fac453f1a39db9d1f7f759a4fdca80269eca'],75,150,225,2447387,3,0.181818182,0.227272727,0.909090909,5367
e5e86cf07caedede4add1935bc0f893168b78115,0,Koji Kawamura,2016-08-12 20:41:49+09:00,['fa639e2596cc125af80615066f500cc908d4db6a'],27,67,94,2447481,2,0.9375,1,1,5367
ebd11b1d8f7e656d8b38d5b2ba76377278df5b1b,0,Matt Burgess,2016-08-12 11:30:06-04:00,['e5e86cf07caedede4add1935bc0f893168b78115'],13,75,88,2447569,5,0.789473684,0.789473684,0.789473684,5368
6f85440ebddf96caf37a550a6b83b2aa724af0a5,0,Matt Burgess,2016-08-12 11:30:06-04:00,['ebd11b1d8f7e656d8b38d5b2ba76377278df5b1b'],1,1,2,2447571,1,,,,5368
8f74241a1067b79beb31cf96b9c6fe4f1dff62ad,1,Matt Burgess,2016-08-12 11:30:06-04:00,['6f85440ebddf96caf37a550a6b83b2aa724af0a5'],51,131,182,2447753,6,0.462686567,0.462686567,0.462686567,5369
219e0e96fbcdbab7903641a584bd52f7f3dca7ad,0,Matt Burgess,2016-08-12 11:30:06-04:00,['8f74241a1067b79beb31cf96b9c6fe4f1dff62ad'],0,32,32,2447785,1,1,1,1,5369
c385651209e6a7f48332880be8154da225f2718b,1,Matt Burgess,2016-08-12 11:30:06-04:00,['219e0e96fbcdbab7903641a584bd52f7f3dca7ad'],111,294,405,2448190,1,,,,5369
28b5dbec3a3009c3f74a8e1ec60e5962293cba8c,0,Matt Burgess,2016-08-12 11:30:06-04:00,['c385651209e6a7f48332880be8154da225f2718b'],3,3,6,2448196,1,,,,5369
098a35c915bbd809d7e8e99dac3371a90c0909e9,0,Matt Burgess,2016-08-12 11:31:50-04:00,['28b5dbec3a3009c3f74a8e1ec60e5962293cba8c'],22,36,58,2448254,1,,,,5369
a9675552d90d0a1a0429785f3684145a6ef0d16a,0,Matt Gilman,2016-08-12 11:40:45-04:00,['098a35c915bbd809d7e8e99dac3371a90c0909e9'],94,90,184,2448438,3,0.666666667,0.666666667,1,5369
572dfed78a579150adcedf416c600aaba0ab7efc,1,jpercivall,2016-08-12 17:22:17-04:00,['a9675552d90d0a1a0429785f3684145a6ef0d16a'],1018,3022,4040,2452478,101,0.403441683,0.552581262,0.267686424,5395
e81147c92ab9757698e59bdfb0e6f6403df7f3a5,0,jpercivall,2016-08-12 17:22:26-04:00,['572dfed78a579150adcedf416c600aaba0ab7efc'],177,67,244,2452722,13,0.029850746,0,0,5395
bbdd087d7790592569b3d9440d66722c17500852,1,jpercivall,2016-08-12 17:22:37-04:00,['e81147c92ab9757698e59bdfb0e6f6403df7f3a5'],101,250,351,2453073,10,0.788461538,0,1,5397
6799bd4919384441d062e412d54aa6163d3ad98a,0,jpercivall,2016-08-12 17:23:12-04:00,['bbdd087d7790592569b3d9440d66722c17500852'],1,1,2,2453075,1,,,,5397
0855cb9bd4197257b158c4fbf17821210c507e09,0,Andy LoPresto,2016-08-12 15:08:00-07:00,['6799bd4919384441d062e412d54aa6163d3ad98a'],4,12,16,2453091,2,0,1,1,5397
48fa76ecfff410b09a0b97fd70468e028066e990,1,joewitt,2016-08-14 13:31:46-04:00,['0855cb9bd4197257b158c4fbf17821210c507e09'],963,1248,2211,2455302,13,0,1,1,5403
d3b96dcac1d18c2da3d5cab2238e5de0936f63c6,1,joewitt,2016-08-14 13:32:00-04:00,['48fa76ecfff410b09a0b97fd70468e028066e990'],814,342,1156,2456458,9,0.920704846,0.114537445,0,5404
b7b56b1cade12489309ea6e8843336f82cde4b23,0,joewitt,2016-08-14 14:06:07-04:00,['d3b96dcac1d18c2da3d5cab2238e5de0936f63c6'],2,20,22,2456480,1,1,0,1,5404
9c7668948c9a1541b9b317ab5352570910037d20,1,joewitt,2016-08-14 14:35:25-04:00,['b7b56b1cade12489309ea6e8843336f82cde4b23'],14,32,46,2456526,2,0,1,1,5404
d32a7ba76145182944fb7e0a86578da570ba1edc,0,joewitt,2016-08-14 14:38:01-04:00,['9c7668948c9a1541b9b317ab5352570910037d20'],0,21,21,2456547,2,,,,5404
4ec34da99b6d3097293ec60710a29697e3b5bbec,0,joewitt,2016-08-14 14:42:12-04:00,['d32a7ba76145182944fb7e0a86578da570ba1edc'],1,1,2,2456549,1,,,,5404
ca5a7fbf095b1020eeacd5ed76dc9d55ba59960b,0,joewitt,2016-08-14 15:47:19-04:00,['4ec34da99b6d3097293ec60710a29697e3b5bbec'],0,1,1,2456550,1,,,,5404
fd0dd51ff555e919ecd771bec9361dfc0bc86eb6,1,Yolanda M. Davis,2016-08-15 08:59:42-04:00,['ca5a7fbf095b1020eeacd5ed76dc9d55ba59960b'],84,364,448,2456998,12,0.546511628,1,1,5405
fa5da543e6334aec363f5fb0c470a7e0b682042d,1,Bryan Bende,2016-08-15 10:21:34-04:00,['fd0dd51ff555e919ecd771bec9361dfc0bc86eb6'],184,882,1066,2458064,19,0.469767442,0.653488372,1,5407
44057f097a00771e405e075de5c1d9f57ef34958,0,Bryan Bende,2016-08-15 14:17:16-04:00,['fa5da543e6334aec363f5fb0c470a7e0b682042d'],1,14,15,2458079,1,0,0,1,5407
fbd3201157883e2606746af448f5f3057d214d1e,1,Oleg Zhurakousky,2016-08-15 14:43:38-04:00,['44057f097a00771e405e075de5c1d9f57ef34958'],34,89,123,2458202,2,0,1,1,5407
51c566ffc8cb89d28b2e5e4b40fe1fa60a2d477a,0,Bryan Bende,2016-08-15 14:55:20-04:00,['fbd3201157883e2606746af448f5f3057d214d1e'],1,1,2,2458204,1,,,,5407
d45114e48dafe357742c8766250e096c690e499e,1,jpercivall,2016-08-15 15:16:58-04:00,['51c566ffc8cb89d28b2e5e4b40fe1fa60a2d477a'],96,79,175,2458379,14,0.807692308,0.307692308,1,5407
2a92747046b39d7b3f7604258c1d3bb81a9447bd,1,Oleg Zhurakousky,2016-08-15 16:27:12-04:00,['d45114e48dafe357742c8766250e096c690e499e'],45,94,139,2458518,30,,,,5407
7d8dd27027b42134d4825f3d5a5da6aedb962b1a,1,Bryan Bende,2016-08-15 16:46:58-04:00,['2a92747046b39d7b3f7604258c1d3bb81a9447bd'],114,489,603,2459121,16,0,0.62987013,0.75974026,5409
ed42f2e3e339b5db9113fbbc60db94c74c1f9d29,1,Yolanda M. Davis,2016-08-15 16:53:57-04:00,['7d8dd27027b42134d4825f3d5a5da6aedb962b1a'],0,33,33,2459154,2,,,,5409
6af768d0a133c63239e50213f69ee7d36d91448e,1,Mark Payne,2016-08-15 17:02:15-04:00,['ed42f2e3e339b5db9113fbbc60db94c74c1f9d29'],199,423,622,2459776,20,0.14,0.89,0.99,5410
03d3b3961d9fb91a9f1ca83d883522ac11f7a86c,0,Pierre Villard,2016-08-16 11:53:05+02:00,['6af768d0a133c63239e50213f69ee7d36d91448e'],1,1,2,2459778,1,,,,5410
b22500d0a322794aa8a3e95b570bb58e6d62d33e,1,Bryan Bende,2016-08-16 10:26:24-04:00,['03d3b3961d9fb91a9f1ca83d883522ac11f7a86c'],2,62,64,2459842,2,0,0.279069767,0.813953488,5410
26f5c496d1d5345d4ab7e9f7a7af523e70101f44,1,Bryan Bende,2016-08-16 11:09:41-04:00,['b22500d0a322794aa8a3e95b570bb58e6d62d33e'],10,24,34,2459876,2,0,1,0.75,5410
b0122c6a73846eba4dcbff402c19b2cf1ded7951,0,Bryan Bende,2016-08-16 12:50:53-04:00,['26f5c496d1d5345d4ab7e9f7a7af523e70101f44'],22,91,113,2459989,2,0,1,1,5410
2fd39676a887151aa4124a824fc0cd756b9fac3b,1,Bryan Bende,2016-08-16 15:20:46-04:00,['b0122c6a73846eba4dcbff402c19b2cf1ded7951'],246,1312,1558,2461547,21,0.761431412,1,0.767395626,5421
b3f36489adb863759faa5b003d2dd01eef65c8f7,0,Bryan Bende,2016-08-16 16:05:20-04:00,['2fd39676a887151aa4124a824fc0cd756b9fac3b'],67,52,119,2461666,13,1,0.083333333,0.25,5421
e42ea9ad457c5b5a1d2da5fa3d3494aacb0cb8d4,1,jpercivall,2016-08-16 20:39:04-04:00,['b3f36489adb863759faa5b003d2dd01eef65c8f7'],1024,1054,2078,2463744,49,1,1,0,5425
7d7401add4699cd7d543ce18d11d7c9d6ab6e20c,1,joewitt,2016-08-17 00:10:07-07:00,['b3f36489adb863759faa5b003d2dd01eef65c8f7'],1573,2034,3607,2467351,120,0.397435897,1,0.329059829,5426
6bf7e7f3251068d245903b1740e821457fb14d6c,1,joewitt,2016-08-17 01:23:54-07:00,"['7d7401add4699cd7d543ce18d11d7c9d6ab6e20c', 'e42ea9ad457c5b5a1d2da5fa3d3494aacb0cb8d4']",890,1053,1943,2469294,48,,,,5426
d9633757a624dedd0dce4a61fd4bc66eab900265,1,joewitt,2016-08-17 03:38:31-07:00,['6bf7e7f3251068d245903b1740e821457fb14d6c'],7,23,30,2469324,6,1,1,1,5426
3f7216ab847b0e2329a5d7a91af2f0e845e9879f,1,Yolanda M. Davis,2016-08-17 08:14:05-04:00,['e42ea9ad457c5b5a1d2da5fa3d3494aacb0cb8d4'],29,88,117,2469441,11,0.6875,1,1,5426
7c99b5e638bfbff7a3f69e78e0dbfef105004995,0,joewitt,2016-08-17 09:05:36-07:00,['d9633757a624dedd0dce4a61fd4bc66eab900265'],0,1,1,2469442,1,0,1,0,5426
a5261914fbb9e83df3d9c164f3ed1993f607715a,0,joewitt,2016-08-17 09:06:18-07:00,"['7c99b5e638bfbff7a3f69e78e0dbfef105004995', '3f7216ab847b0e2329a5d7a91af2f0e845e9879f']",29,88,117,2469559,11,,,,5426
1470a52b1bf3a1c2f9101306c70db0b08692301f,1,Matt Burgess,2016-08-17 13:19:56-04:00,['3f7216ab847b0e2329a5d7a91af2f0e845e9879f'],54,290,344,2469903,3,0.149350649,0.448051948,0.974025974,5426
a0d1aae603a64adc31bc0177576c2463b7a22d36,1,Matt Burgess,2016-08-17 13:20:44-04:00,['1470a52b1bf3a1c2f9101306c70db0b08692301f'],7,44,51,2469954,2,0.095238095,0.095238095,1,5426
b2e468ecf880475c23bb3ccaa98619a576bd1a0e,0,Andy LoPresto,2016-08-17 10:51:55-07:00,['a5261914fbb9e83df3d9c164f3ed1993f607715a'],3,3,6,2469960,3,,,,5426
0ffdc2eb927ee8c78104f51bce9d2c45a1025121,0,Andy LoPresto,2016-08-17 10:58:38-07:00,"['b2e468ecf880475c23bb3ccaa98619a576bd1a0e', 'a0d1aae603a64adc31bc0177576c2463b7a22d36']",46,319,365,2470325,3,,,,5426
e7288af859d00d6a4d12631d73a92404e31ba7f4,1,Oleg Zhurakousky,2016-08-17 14:58:02-04:00,['0ffdc2eb927ee8c78104f51bce9d2c45a1025121'],2,2,4,2470329,2,,,,5426
a0fab15eb747426dd4be8cae5378715dd80f6d55,0,Oleg Zhurakousky,2016-08-17 15:13:05-04:00,['e7288af859d00d6a4d12631d73a92404e31ba7f4'],2,12,14,2470343,1,0,0,1,5426
3d1a24ab7d5ac86d58c139b760d417789cc9bd5d,1,Mark Payne,2016-08-17 15:35:16-04:00,['a0fab15eb747426dd4be8cae5378715dd80f6d55'],370,21,391,2470734,7,0,0,0.178861789,5426
7bc7b7f6836b44403d525f089bc6f610f9b3802e,0,Bryan Bende,2016-08-17 16:10:56-04:00,['3d1a24ab7d5ac86d58c139b760d417789cc9bd5d'],4,4,8,2470742,2,,,,5426
74661e662327415493c87cd6bbd39311ab1c7c9d,0,joewitt,2016-08-17 13:24:49-07:00,['7bc7b7f6836b44403d525f089bc6f610f9b3802e'],0,30,30,2470772,1,,,,5426
9a16ca72d767b3392f1c2e04a07b94ae4029ce06,0,Bryan Bende,2016-08-17 16:36:25-04:00,['74661e662327415493c87cd6bbd39311ab1c7c9d'],35,104,139,2470911,2,,,,5426
5b58e5a251e5165b0e09beb07594f23c3179c8dd,0,Bryan Bende,2016-08-17 16:36:40-04:00,['9a16ca72d767b3392f1c2e04a07b94ae4029ce06'],5,28,33,2470944,1,,,,5426
91a59a8a5af72d4e8b92476ffeb679b189e9542a,1,Mark Payne,2016-08-18 08:33:45-04:00,['5b58e5a251e5165b0e09beb07594f23c3179c8dd'],98,190,288,2471232,10,0,1,0,5426
567535c3d03dd09dc0ec9f44af7a4041daf087af,0,Mark Payne,2016-08-18 09:15:55-04:00,['91a59a8a5af72d4e8b92476ffeb679b189e9542a'],1,1,2,2471234,1,,,,5426
d4bbd647c5df38da4e9b371fbd99d38ac7605957,0,Bryan Bende,2016-08-18 09:26:32-04:00,['567535c3d03dd09dc0ec9f44af7a4041daf087af'],68,354,422,2471656,30,0.75,1,1,5426
08735a4f570473db13ddc0ed1840411205647bee,1,Matt Gilman,2016-08-18 09:37:11-04:00,['d4bbd647c5df38da4e9b371fbd99d38ac7605957'],160,368,528,2472184,16,0.95,0.96,0.86,5427
0e90a0f76ad72c7694f22a4e94a3d4f9ad8e1a4a,0,Matt Gilman,2016-08-18 09:38:16-04:00,['08735a4f570473db13ddc0ed1840411205647bee'],13,20,33,2472217,5,0.6,0.8,0.4,5428
e0e4b3407a3b90d29858fdc0c73ccccd8862abc7,1,joewitt,2016-08-18 12:19:46-04:00,['0e90a0f76ad72c7694f22a4e94a3d4f9ad8e1a4a'],35,26,61,2472278,16,0,0,0,5428
a74bc2c7c75b05d2dea87d829ab71798121e6175,0,joewitt,2016-08-18 13:38:22-04:00,['e0e4b3407a3b90d29858fdc0c73ccccd8862abc7'],8,8,16,2472294,1,1,1,1,5428
4847ed28a19b11bc890b72da7f7c03ebbe02307d,1,joewitt,2016-08-18 13:48:00-04:00,['a74bc2c7c75b05d2dea87d829ab71798121e6175'],8,42,50,2472344,1,,,,5428
6874a5d82da27c1dfa41dfdd3fb8db25584c3bc0,0,joewitt,2016-08-18 15:15:51-04:00,['4847ed28a19b11bc890b72da7f7c03ebbe02307d'],2,153,155,2472499,3,0,0.804597701,1,5429
f3387426a097f0e853f898c91ec379278642f6d6,1,Mark Payne,2016-08-18 17:05:32-04:00,['6874a5d82da27c1dfa41dfdd3fb8db25584c3bc0'],3,36,39,2472538,1,0,1,1,5429
87161ab96ec5b491e571860fd05266c8b5c899c4,1,Bryan Bende,2016-08-18 17:06:28-04:00,['f3387426a097f0e853f898c91ec379278642f6d6'],115,77,192,2472730,8,1,1,0.117647059,5429
57648308db333d843e3d5eae770b285ccd8d297e,0,Mark Payne,2016-08-18 17:15:16-04:00,['87161ab96ec5b491e571860fd05266c8b5c899c4'],3,3,6,2472736,1,,,,5429
6b5950647a8d773bf1625b5a5cb1d680551693e2,1,Mark Payne,2016-08-18 17:23:30-04:00,['57648308db333d843e3d5eae770b285ccd8d297e'],1,1,2,2472738,1,,,,5429
46b81058c7fa0914bf5df34d82430bb77bffa6c5,0,Pierre Villard,2016-08-19 09:56:26+02:00,['6b5950647a8d773bf1625b5a5cb1d680551693e2'],7,21,28,2472766,2,0,0,0,5429
31ca8d02f7af5cdb82970d31501574bb4d6b7a3b,0,Matt Gilman,2016-08-19 08:32:00-04:00,['46b81058c7fa0914bf5df34d82430bb77bffa6c5'],31,10,41,2472807,1,0,0,0,5429
a181c7b9d70a224e2aae1af830ddb38adbb39a24,0,Matt Gilman,2016-08-19 10:34:48-04:00,['31ca8d02f7af5cdb82970d31501574bb4d6b7a3b'],5,8,13,2472820,1,,,,5429
3378426f3520cf66ec0525382a3596ce25915a15,0,Pierre Villard,2016-08-19 19:36:26+02:00,['a181c7b9d70a224e2aae1af830ddb38adbb39a24'],52,79,131,2472951,5,0,1,1,5429
02071103d0bbe369039763ba0d8a2100f3383228,0,Pierre Villard,2016-08-19 20:05:14+02:00,['3378426f3520cf66ec0525382a3596ce25915a15'],30,96,126,2473077,2,0.96875,1,1,5429
a919844461d63a26fa6c1d8c7daa447cd5ef912e,1,Mark Payne,2016-08-19 14:24:53-04:00,['02071103d0bbe369039763ba0d8a2100f3383228'],66,219,285,2473362,5,0.302752294,0.862385321,1,5431
26d362b144e15ea4a224e346c340d74e978c134c,1,Matt Burgess,2016-08-21 10:10:21-04:00,['a919844461d63a26fa6c1d8c7daa447cd5ef912e'],0,367,367,2473729,3,0.31147541,0.726775956,1,5433
b7dc21bd95f61734fefb7f1d8b6494b4461f84ae,0,Matt Burgess,2016-08-21 10:26:40-04:00,['26d362b144e15ea4a224e346c340d74e978c134c'],4,5,9,2473738,1,,,,5433
a2d3d0c2890b8a5a3433017b3077c704583b1277,0,Mark Payne,2016-08-22 11:02:48-04:00,['b7dc21bd95f61734fefb7f1d8b6494b4461f84ae'],3,3,6,2473744,1,,,,5433
95b5877f5de679da689b76917d93b3ad7fc9b890,1,Matt Burgess,2016-08-22 12:03:47-04:00,['a2d3d0c2890b8a5a3433017b3077c704583b1277'],95,194,289,2474033,4,1,1,0.954545455,5434
5fab783b50e56811cd4a51fd8cf2063da9517ec5,1,Bryan Bende,2016-08-22 13:21:42-04:00,['95b5877f5de679da689b76917d93b3ad7fc9b890'],5,71,76,2474109,2,0.12,0,0.92,5435
1fcec3747bf88d4d136cbe46e02c0f3b2677b37a,1,Yolanda M. Davis,2016-08-22 13:24:22-04:00,['5fab783b50e56811cd4a51fd8cf2063da9517ec5'],6,10,16,2474125,1,1,1,1,5435
087622eadc5863cfce615dd22dc5584639146e4a,1,Mark Payne,2016-08-22 13:35:15-04:00,['1fcec3747bf88d4d136cbe46e02c0f3b2677b37a'],314,445,759,2474884,24,1,0,0,5436
17dec04939efda59345f5c2de49b575fd7d8dfcc,1,Mike Moser,2016-08-22 14:47:24-04:00,['087622eadc5863cfce615dd22dc5584639146e4a'],51,57,108,2474992,2,0,0.333333333,1,5436
7884d09948381c655571c5868a40ba5b7e9c1c76,0,Matt Gilman,2016-08-22 15:07:54-04:00,['17dec04939efda59345f5c2de49b575fd7d8dfcc'],13,17,30,2475022,1,,,,5436
7123a1a2761d238b2d1e300e33f2f3ade54347e1,0,Yolanda M. Davis,2016-08-22 15:29:03-04:00,['7884d09948381c655571c5868a40ba5b7e9c1c76'],23,52,75,2475097,2,0.529411765,0.529411765,0.882352941,5436
dca3764ed11789da6e5a44f8940c6e23da713128,0,Matt Gilman,2016-08-22 15:58:06-04:00,['7123a1a2761d238b2d1e300e33f2f3ade54347e1'],1,10,11,2475108,1,1,0.375,1,5436
376d3c4ef4a837fd18213fa3d77eda7d12beed25,1,jpercivall,2016-08-22 21:34:51-04:00,['dca3764ed11789da6e5a44f8940c6e23da713128'],1,1872,1873,2476981,21,0.714028777,0.933453237,0.980215827,5452
6e82ec738cbd6c8461ea90183cbf418f1f0e1f1f,1,jpercivall,2016-08-22 21:34:51-04:00,['376d3c4ef4a837fd18213fa3d77eda7d12beed25'],166,27,193,2477174,9,,,,5452
23350543ff638a198a35ae04daac8498f4e9651e,0,Andy LoPresto,2016-08-23 01:37:25-07:00,['6e82ec738cbd6c8461ea90183cbf418f1f0e1f1f'],3,95,98,2477272,2,1,1,1,5452
3f60eac54413e90e8137471dcd1e50fa6137ef5a,1,Matt Gilman,2016-08-23 10:53:10-04:00,['23350543ff638a198a35ae04daac8498f4e9651e'],671,641,1312,2478584,6,0.421052632,0,0.947368421,5452
8cc670c8a690efea8eee4d090486d724d0069cbd,0,jpercivall,2016-08-23 11:19:44-04:00,['3f60eac54413e90e8137471dcd1e50fa6137ef5a'],1,6,7,2478591,1,0,0,1,5452
fbec3b9c13dce360a501790b8e215646101d4e77,0,Bryan Bende,2016-08-23 11:43:46-04:00,['8cc670c8a690efea8eee4d090486d724d0069cbd'],5,13,18,2478609,1,0,0,0,5452
4a495875334997cca4a92d540945d4491f0000d6,0,Matt Burgess,2016-08-23 13:13:05-04:00,['fbec3b9c13dce360a501790b8e215646101d4e77'],26,31,57,2478666,3,1,0,0,5452
0303805c014b54c095827a7b191e5efb136a4e2e,1,Bryan Bende,2016-08-23 13:25:55-04:00,['4a495875334997cca4a92d540945d4491f0000d6'],44,178,222,2478888,12,0.089552239,0.955223881,0.865671642,5452
5d1a4f343f11606af5f45d1db4d58ca31a59e524,0,Bryan Bende,2016-08-23 15:52:16-04:00,['0303805c014b54c095827a7b191e5efb136a4e2e'],0,4,4,2478892,1,0,0,1,5452
ee9bd94082cb27694e94b6bd5907b52a641e86d9,0,Yolanda M. Davis,2016-08-23 16:30:57-04:00,['5d1a4f343f11606af5f45d1db4d58ca31a59e524'],48,105,153,2479045,4,0,0.703703704,1,5452
7a4fed189c8275414694f53f33c599240ec672bd,0,jpercivall,2016-08-23 18:07:13-04:00,['ee9bd94082cb27694e94b6bd5907b52a641e86d9'],0,0,0,2479045,1,,,,5452
c638191a47ae5767de82b383ecb04496ce18877b,1,Andy LoPresto,2016-08-23 20:34:31-07:00,['7a4fed189c8275414694f53f33c599240ec672bd'],364,10687,11051,2490096,115,0.704359673,0.826975477,0.967302452,5520
a2ed0f06109f1b1c19db4a8c45aae06d74029888,0,jpercivall,2016-08-24 11:30:14-04:00,['c638191a47ae5767de82b383ecb04496ce18877b'],0,2,2,2490098,1,,,,5520
c2ae7a6d7cf94b817e288c28038d18db51fcb457,1,jpercivall,2016-08-24 12:30:48-04:00,['a2ed0f06109f1b1c19db4a8c45aae06d74029888'],71,220,291,2490389,27,0.320512821,0.461538462,0.846153846,5520
6475924f53404939214c7519f5e411ffa1ed27c0,0,Oleg Zhurakousky,2016-08-24 15:55:04-04:00,['c2ae7a6d7cf94b817e288c28038d18db51fcb457'],2,7,9,2490398,1,0,0,0,5520
487f05a2b1ffe376218f289c890856713f969a4d,0,Andy LoPresto,2016-08-24 13:08:38-07:00,['6475924f53404939214c7519f5e411ffa1ed27c0'],1,110,111,2490509,1,,,,5520
6331dda8d3c3fd195551f23479069864845cd6bd,1,Oleg Zhurakousky,2016-08-24 16:20:10-04:00,['487f05a2b1ffe376218f289c890856713f969a4d'],2,2,4,2490513,2,,,,5520
1a9d505b4ed5be3c36e583134a51022cef5b5e92,1,jpercivall,2016-08-24 17:07:35-04:00,['6331dda8d3c3fd195551f23479069864845cd6bd'],30,127,157,2490670,3,,,,5520
a3586e04d9978e105cc5645e893dc6d77b79b86e,1,Mark Payne,2016-08-24 17:28:10-04:00,['1a9d505b4ed5be3c36e583134a51022cef5b5e92'],57,216,273,2490943,5,0.73015873,1,1,5520
7bc255b9b1fa932ea65b0aa78eed8506a5224c54,0,Andy LoPresto,2016-08-24 14:37:35-07:00,['a3586e04d9978e105cc5645e893dc6d77b79b86e'],21,22,43,2490986,1,,,,5520
2ceb5c80971de86710e884703ef5999df603512d,0,Andy LoPresto,2016-08-24 15:52:20-07:00,['7bc255b9b1fa932ea65b0aa78eed8506a5224c54'],10,10,20,2491006,2,,,,5520
671301193bf5b05a42d0e19aaa9503424ec04bc3,1,Yolanda M. Davis,2016-08-24 20:39:17-04:00,['2ceb5c80971de86710e884703ef5999df603512d'],114,497,611,2491617,4,0.842105263,0.5,1,5520
e9da90812b27f5f67fc614ae25d83273f06d63a9,0,jpercivall,2016-08-24 21:31:29-04:00,['671301193bf5b05a42d0e19aaa9503424ec04bc3'],0,7,7,2491624,1,,,,5520
c2bfc4ef245d5c95dc103139cf386896d6ec3023,1,jpercivall,2016-08-24 22:42:10-04:00,['e9da90812b27f5f67fc614ae25d83273f06d63a9'],1347,1804,3151,2494775,27,0.168975069,0.473684211,0.35734072,5521
8536ad65f4b6736b5b27eebd63b346f0f8d064f7,1,Koji Kawamura,2016-08-25 15:33:10+09:00,['c2bfc4ef245d5c95dc103139cf386896d6ec3023'],5,43,48,2494823,5,0.62962963,0.62962963,1,5521
afb9a0016f044e92b9970f6c88bd5888b24c2fa4,0,Matt Gilman,2016-08-25 08:34:17-04:00,['8536ad65f4b6736b5b27eebd63b346f0f8d064f7'],2,2,4,2494827,1,,,,5521
e210172d93d6d5be45c061039bb7e0a2896c6e14,1,Matt Burgess,2016-08-25 08:41:23-04:00,['afb9a0016f044e92b9970f6c88bd5888b24c2fa4'],74,267,341,2495168,2,0.113475177,0.815602837,0.843971631,5521
6fd1c17ca4907be1f60b312a7a6203be57b09e89,1,Matt Burgess,2016-08-25 08:55:34-04:00,['e210172d93d6d5be45c061039bb7e0a2896c6e14'],14,22,36,2495204,3,0,0.75,0.5,5521
56e515f7ae42ed0ad609ddb38f9b0a7026c9bee8,0,Matt Gilman,2016-08-25 09:27:41-04:00,['6fd1c17ca4907be1f60b312a7a6203be57b09e89'],1,1,2,2495206,1,,,,5521
626e23e0abde6bdb8f3f5fb7c5630835748b0b72,1,joewitt,2016-08-25 09:47:26-04:00,['56e515f7ae42ed0ad609ddb38f9b0a7026c9bee8'],0,224,224,2495430,2,1,1,0.851851852,5523
1745c1274b274a994a92312054d8951ce1c499d0,1,joewitt,2016-08-25 10:09:50-04:00,['626e23e0abde6bdb8f3f5fb7c5630835748b0b72'],1845,6604,8449,2503879,102,0.387518142,0.790517658,0.779874214,5556
a6133d4ce322b28169290810bb7b7eafd2501486,1,jpercivall,2016-08-25 13:08:35-04:00,['1745c1274b274a994a92312054d8951ce1c499d0'],149,128,277,2504156,14,0.888888889,0.222222222,0.444444444,5556
04db806aceca433e05b68d2b317e07780f150e43,1,joewitt,2016-08-25 13:51:08-04:00,['a6133d4ce322b28169290810bb7b7eafd2501486'],74,40,114,2504270,6,1,0,0,5556
ad7808f63dd86632b89463e72bd1ad0be48e9b59,1,joewitt,2016-08-25 14:13:55-04:00,['04db806aceca433e05b68d2b317e07780f150e43'],4,18,22,2504292,2,0,0.7,1,5556
3224b1a5dd5d5652c16a85b72487d1179f954cfc,0,joewitt,2016-08-25 14:41:08-04:00,['ad7808f63dd86632b89463e72bd1ad0be48e9b59'],0,27,27,2504319,3,,,,5556
218408953a7568b4ed31f8f3834fe57f475c2269,0,joewitt,2016-08-25 14:50:38-04:00,['3224b1a5dd5d5652c16a85b72487d1179f954cfc'],0,69,69,2504388,2,,,,5556
1624dd8e4da04fdd162b3c0598dd0ffd32552e3b,0,joewitt,2016-08-25 14:59:46-04:00,['218408953a7568b4ed31f8f3834fe57f475c2269'],3,4,7,2504395,3,,,,5556
a84d3c987378763d09f4b87c5287ad6f9eb13f78,1,joewitt,2016-08-25 15:34:50-04:00,['1624dd8e4da04fdd162b3c0598dd0ffd32552e3b'],25,17,42,2504437,2,0,0,,5556
f908ae3c3bf6fcb95fc2ef9727e675a560a2a970,1,joewitt,2016-08-25 16:39:00-04:00,['a84d3c987378763d09f4b87c5287ad6f9eb13f78'],37,69,106,2504543,7,0.4,0.4,0,5556
957c120343172d96b04e4955049ef621b44b2c86,1,Yolanda M. Davis,2016-08-25 17:26:37-04:00,['f908ae3c3bf6fcb95fc2ef9727e675a560a2a970'],18,10,28,2504571,4,1,0,0,5556
7879a9920635c36f626ab5070041a8c795e8b65d,0,Andy LoPresto,2016-08-25 16:44:02-07:00,['957c120343172d96b04e4955049ef621b44b2c86'],1,1,2,2504573,1,,,,5556
102a9a2b74968ad111fb54cdaa16a2609ea73e85,0,Matt Burgess,2016-08-25 21:16:26-04:00,['7879a9920635c36f626ab5070041a8c795e8b65d'],12,53,65,2504638,2,0.133333333,0.833333333,1,5556
58e0ce7f92f708422276a68f4e04c61470c71b11,1,joewitt,2016-08-25 21:39:40-04:00,['102a9a2b74968ad111fb54cdaa16a2609ea73e85'],49,538,587,2505225,12,0.184713376,0.993630573,0.961783439,5556
405252244ec7539abb02ff43d25ff17682fd2fa7,1,joewitt,2016-08-25 22:17:07-04:00,['58e0ce7f92f708422276a68f4e04c61470c71b11'],1,1,2,2505227,1,,,,5556
e1da9fc11fb3c0e1b7bcb429cdf098de4561b901,1,jpercivall,2016-08-25 22:42:37-04:00,['405252244ec7539abb02ff43d25ff17682fd2fa7'],7,859,866,2506093,5,,,,5556
6ef1cca18f40c149c5dcab9ac10d3a54bc2fd309,0,jpercivall,2016-08-25 22:43:00-04:00,['e1da9fc11fb3c0e1b7bcb429cdf098de4561b901'],37,122,159,2506252,3,,,,5556
0745990c2d3608ef0c0aba222e31d5f0b0abc71b,1,jpercivall,2016-08-25 23:35:41-04:00,['6ef1cca18f40c149c5dcab9ac10d3a54bc2fd309'],28,226,254,2506506,5,0,0.563492063,0.801587302,5557
2ed58912b2399ece73f796f1f6201f40d4c440c0,0,Matt Gilman,2016-08-26 10:27:27-04:00,['0745990c2d3608ef0c0aba222e31d5f0b0abc71b'],3,2,5,2506511,1,1,1,1,5557
c8ae7fcbe14383e14ff6e211758ca53022d86788,0,Matt Gilman,2016-08-26 11:03:10-04:00,['2ed58912b2399ece73f796f1f6201f40d4c440c0'],19,15,34,2506545,7,,,,5557
74d5224783dfdc513f6b3ad5ed96671d3c581707,0,Joseph Percivall,2016-08-26 11:40:44-04:00,['c8ae7fcbe14383e14ff6e211758ca53022d86788'],493,480,973,2507518,241,,,,5557
1fe18a156721d9e2947b11cae0047ef227654351,0,Joseph Percivall,2016-08-26 11:40:58-04:00,['74d5224783dfdc513f6b3ad5ed96671d3c581707'],469,469,938,2508456,241,,,,5557
daf48555705721faa8ec9a3e2e03f6119d1543d5,0,Matt Gilman,2016-08-29 10:14:55-04:00,['c8ae7fcbe14383e14ff6e211758ca53022d86788'],2,2,4,2508460,1,,,,5557
6916c5363abca7a80d5259155f56403d60099973,0,Andy LoPresto,2016-08-29 10:43:11-07:00,['daf48555705721faa8ec9a3e2e03f6119d1543d5'],1,1,2,2508462,1,,,,5557
1752a5719730ed6b4d80112593ed61e9351bb0a2,0,jpercivall,2016-08-31 14:01:57+10:00,"['6916c5363abca7a80d5259155f56403d60099973', '1fe18a156721d9e2947b11cae0047ef227654351']",492,479,971,2509433,241,,,,5557
d600b065bbc33d0624b241eee4a6b937546f580b,0,Andy LoPresto,2016-08-30 08:25:38-07:00,['1752a5719730ed6b4d80112593ed61e9351bb0a2'],1,17,18,2509451,1,,,,5557
8556777bf69ddeda13a7f68fc9fd212a23e7ea5b,1,Andy LoPresto,2016-08-30 09:27:24-07:00,['d600b065bbc33d0624b241eee4a6b937546f580b'],17,1,18,2509469,1,,,,5557
ba19238757bf33b5e8926e01b1b2240c98d80d36,0,Bryan Bende,2016-08-30 15:50:48-04:00,['8556777bf69ddeda13a7f68fc9fd212a23e7ea5b'],19,25,44,2509513,4,0,0.75,0.75,5557
1213b46632e29ba8fd6f46a1633c8be23c352a82,0,Oleg Zhurakousky,2016-08-30 16:13:45-04:00,['ba19238757bf33b5e8926e01b1b2240c98d80d36'],0,1,1,2509514,1,0,0,1,5557
648ddb6158ef7d7b76e78c204c53f2ae59c83dc9,0,Matt Gilman,2016-08-31 09:11:46-04:00,['1213b46632e29ba8fd6f46a1633c8be23c352a82'],1,2,3,2509517,1,1,0,1,5557
1bb909ebcabb9f95f0d946df6c6e1eb59e6e0692,0,Matt Gilman,2016-08-31 09:28:08-04:00,['648ddb6158ef7d7b76e78c204c53f2ae59c83dc9'],0,74,74,2509591,1,,,,5558
9e10371c8a391a3ffcb5d8b307aaac6839e9d792,1,Matt Gilman,2016-08-31 15:09:17-04:00,['1bb909ebcabb9f95f0d946df6c6e1eb59e6e0692'],82,119,201,2509792,5,0,1,0,5558
96a766464c2b2402e73ef77ef91222069ca54ab1,1,Bryan Bende,2016-08-31 15:59:52-04:00,['9e10371c8a391a3ffcb5d8b307aaac6839e9d792'],52,154,206,2509998,8,1,1,1,5558
bc50329d5e3df2ce5bb7b9d3a1f8d4413ee24da0,0,Andy LoPresto,2016-08-31 15:21:04-07:00,['96a766464c2b2402e73ef77ef91222069ca54ab1'],10,44,54,2510052,1,,,,5558
867c84f32c9cd07dbfda8e1c255707d7b92a6917,0,Matt Gilman,2016-09-01 09:53:12-04:00,['bc50329d5e3df2ce5bb7b9d3a1f8d4413ee24da0'],12,43,55,2510107,7,0.958333333,1,1,5558
d37480eaffec7f24238798d54dd09b3d8526cef8,0,Koji Kawamura,2016-09-02 22:25:25+09:00,['867c84f32c9cd07dbfda8e1c255707d7b92a6917'],3,3,6,2510113,1,,,,5558
97e2f406da83602ab2cf42bf3b7fbfcb9ea1686c,0,Matt Gilman,2016-09-02 14:55:08-04:00,['d37480eaffec7f24238798d54dd09b3d8526cef8'],1,113,114,2510227,3,0.176470588,0.196078431,0.196078431,5559
0e64c3ed30841fbca898376585f8c909bebad59f,1,James Wing,2016-09-03 16:04:42-07:00,['97e2f406da83602ab2cf42bf3b7fbfcb9ea1686c'],40,213,253,2510480,3,0.691489362,0.882978723,0.904255319,5559
a9d029d74ebf7284850df2708f6a2337e4cea73d,0,Koji Kawamura,2016-09-06 10:57:53+09:00,['0e64c3ed30841fbca898376585f8c909bebad59f'],1,1,2,2510482,1,,,,5559
088125451b7f15684752a914a3a83a834fac1a50,1,Bryan Bende,2016-09-06 12:25:28-04:00,['a9d029d74ebf7284850df2708f6a2337e4cea73d'],598,923,1521,2512003,7,0.418918919,0.959459459,0.959459459,5562
7a451935a583d4d7fd4eccf47a869552c2f8dda7,1,Bryan Bende,2016-09-06 15:48:40-04:00,['088125451b7f15684752a914a3a83a834fac1a50'],1873,1413,3286,2515289,14,1,0.489959839,0.248995984,5562
a7e76cc00a13815d899267ce9e4ca1ad6cf51ce1,1,Matt Gilman,2016-09-06 16:31:37-04:00,['7a451935a583d4d7fd4eccf47a869552c2f8dda7'],193,1052,1245,2516534,34,0.457627119,0.793785311,0.573446328,5568
2afc739ab72fa2bce8f64c8833f3eae1399966ce,0,Matt Gilman,2016-09-06 16:52:40-04:00,['a7e76cc00a13815d899267ce9e4ca1ad6cf51ce1'],11,130,141,2516675,5,0.0125,0.975,0.9875,5568
8d6e12fdc4002f6eba52edcf0670df40217eb43a,0,Mark Payne,2016-09-07 08:56:23-04:00,['2afc739ab72fa2bce8f64c8833f3eae1399966ce'],2,102,104,2516779,4,0.096774194,0.096774194,1,5568
80224e3e5ed7ee7b09c4985a920a7fa393bff26c,1,Bryan Bende,2016-09-07 12:06:01-04:00,['8d6e12fdc4002f6eba52edcf0670df40217eb43a'],14,18,32,2516811,9,,,,5568
938e32ed97265c4b084c3405b79c493f1b08d91c,0,Matt Gilman,2016-09-07 14:11:46-04:00,['80224e3e5ed7ee7b09c4985a920a7fa393bff26c'],2,10,12,2516823,3,1,1,0,5568
d36b76cc600b76748ffba9b94d6b702af552756f,1,Oleg Zhurakousky,2016-09-07 15:28:34-04:00,['938e32ed97265c4b084c3405b79c493f1b08d91c'],1,9,10,2516833,3,0.25,1,0.75,5568
bc7c42efa53b363741a974a7fcf25e04f9208086,0,Bryan Bende,2016-09-08 10:48:24-04:00,['d36b76cc600b76748ffba9b94d6b702af552756f'],4,85,89,2516922,3,0,1,1,5569
ae251c1a6f0550c02deee3b42ba64aadc934483e,1,Matt Gilman,2016-09-08 13:43:38-04:00,['bc7c42efa53b363741a974a7fcf25e04f9208086'],34,217,251,2517173,10,0,0.974358974,0.961538462,5570
abaacfa5e59c15cad642ec2bd7a1fbdb7bb3c925,0,Matt Gilman,2016-09-09 12:31:46-04:00,['ae251c1a6f0550c02deee3b42ba64aadc934483e'],4,13,17,2517190,1,0,0,0,5570
e25885650a169ae2639355f2ba69a0405071188b,0,Joe Skora,2016-09-09 22:44:23-04:00,['abaacfa5e59c15cad642ec2bd7a1fbdb7bb3c925'],12,19,31,2517221,2,0,1,1,5570
9ff5c0b25fb2fd88a852fec4aae250431a696dd7,0,Bryan Bende,2016-09-12 14:18:11-04:00,['e25885650a169ae2639355f2ba69a0405071188b'],0,9,9,2517230,1,,,,5570
d32577376021c94a8d713d6f55b22a6aff60b57d,1,Pierre Villard,2016-09-13 15:46:33+02:00,['9ff5c0b25fb2fd88a852fec4aae250431a696dd7'],34,73,107,2517337,8,0,0.647058824,0,5570
b48355e75a6369d0aac2c0127a5b99e96157230b,0,Bryan Bende,2016-09-13 10:59:26-04:00,['d32577376021c94a8d713d6f55b22a6aff60b57d'],0,6,6,2517343,1,0,0,1,5570
6c9291ad530c3b47ed58db9d2c23195cf5f07df7,0,Bryan Bende,2016-09-13 11:13:06-04:00,['b48355e75a6369d0aac2c0127a5b99e96157230b'],25,20,45,2517388,1,0,1,1,5570
5dd743947cfaf1b5d35f40952da65b5aadece951,0,Bryan Bende,2016-09-13 11:41:51-04:00,['6c9291ad530c3b47ed58db9d2c23195cf5f07df7'],2,2,4,2517392,2,,0,,5570
02ca2a0d78fe5189a3fb220ee7c8409737e26c18,0,Pierre Villard,2016-09-13 22:17:37+02:00,['5dd743947cfaf1b5d35f40952da65b5aadece951'],1,1,2,2517394,1,,,,5570
c72a9aa54ba349bdc7567ec741a36e11b6463a3e,1,Pierre Villard,2016-09-13 22:55:55+02:00,['02ca2a0d78fe5189a3fb220ee7c8409737e26c18'],9,60,69,2517463,2,1,1,1,5570
36846e0fe77b06a34a3fcf99af78c64ab7ecf16e,0,Bryan Bende,2016-09-14 10:33:10-04:00,['c72a9aa54ba349bdc7567ec741a36e11b6463a3e'],70,345,415,2517878,9,0.386503067,0.987730061,1,5570
bc005e3398c2a73b8149d85fd3598dd4b5616b11,0,Bryan Bende,2016-09-14 10:39:11-04:00,['36846e0fe77b06a34a3fcf99af78c64ab7ecf16e'],0,4,4,2517882,1,1,1,1,5570
67a47dbead2ea4e06c637bc50c64fbdc2c66a546,0,Matt Gilman,2016-09-14 14:23:46-04:00,['bc005e3398c2a73b8149d85fd3598dd4b5616b11'],65,105,170,2518052,4,0.267605634,1,0.746478873,5570
8a28395e9feafdb3af8c76137bfe0f5f7a07e27e,0,Matt Gilman,2016-09-14 14:27:50-04:00,['67a47dbead2ea4e06c637bc50c64fbdc2c66a546'],1,28,29,2518081,2,0,0.888888889,1,5570
c1ad913598c9c41fdc99a53d9939fece9c3250b9,0,Oleg Zhurakousky,2016-09-15 09:57:09-04:00,['8a28395e9feafdb3af8c76137bfe0f5f7a07e27e'],0,9,9,2518090,2,1,1,1,5570
aa933a194110b58a8c2fe07013f37a6fc1d10e71,0,Oleg Zhurakousky,2016-09-15 10:12:04-04:00,['c1ad913598c9c41fdc99a53d9939fece9c3250b9'],1,2,3,2518093,1,,,,5570
abcfbeb062ff014e3ffefaaa1a689e0646af1d42,0,Oleg Zhurakousky,2016-09-15 10:27:39-04:00,['aa933a194110b58a8c2fe07013f37a6fc1d10e71'],39,40,79,2518172,2,1,1,1,5570
022f5a506dfb961dce955a2341544de184327b5e,1,Pierre Villard,2016-09-16 00:08:08+02:00,['abcfbeb062ff014e3ffefaaa1a689e0646af1d42'],5,489,494,2518666,5,0.833333333,1,1,5573
d838f61291d2582592754a37314911b701c6891b,1,jpercivall,2016-09-16 11:13:07-04:00,['022f5a506dfb961dce955a2341544de184327b5e'],0,988,988,2519654,5,0.42687747,0.480237154,0.972332016,5576
feaa4c9db82f6d29777d82df45beb43879be87cf,1,Bryan Bende,2016-09-19 12:56:54-04:00,['d838f61291d2582592754a37314911b701c6891b'],4,115,119,2519773,3,0.195652174,1,0.934782609,5577
c23867605857f8380140ba4d69437b58585e9cba,1,Oleg Zhurakousky,2016-09-20 09:30:14-04:00,['feaa4c9db82f6d29777d82df45beb43879be87cf'],38,89,127,2519900,9,0,1,0,5577
b693a4a5611b7ef48787cfa9cdde0bbffc95939f,1,Oleg Zhurakousky,2016-09-20 09:32:43-04:00,['c23867605857f8380140ba4d69437b58585e9cba'],17,19,36,2519936,5,1,0,0,5577
ad3d63d204c1e4408c91728d4c5d76a75e14c8f9,1,jpercivall,2016-09-20 10:25:36-04:00,['b693a4a5611b7ef48787cfa9cdde0bbffc95939f'],0,153,153,2520089,4,1,1,1,5577
4fc0e9c40763d05eee01b48f76cd4cf273b61330,1,Pierre Villard,2016-09-20 18:21:42+02:00,['ad3d63d204c1e4408c91728d4c5d76a75e14c8f9'],0,243,243,2520332,3,0.135338346,0.654135338,1,5577
52fa50cdebbfe3843f140b04bf24182a06761786,1,Matt Gilman,2016-09-20 13:46:23-04:00,['4fc0e9c40763d05eee01b48f76cd4cf273b61330'],3,30,33,2520365,2,,,,5577
68291636cb3e823013c430ccbffbc449d178b89d,1,Bryan Bende,2016-09-20 15:33:06-04:00,['52fa50cdebbfe3843f140b04bf24182a06761786'],8,156,164,2520529,2,0,0.642201835,0.642201835,5577
930e95aa0023b12e5618068ea144808e5627cea7,1,Oleg Zhurakousky,2016-09-21 10:05:39-04:00,['68291636cb3e823013c430ccbffbc449d178b89d'],111,916,1027,2521556,3,0.222748815,0.696682464,0.32464455,5578
684f417406107b33ecdca9a36fa4ab31ae4facca,0,Pierre Villard,2016-09-21 16:31:40+02:00,['930e95aa0023b12e5618068ea144808e5627cea7'],1,2,3,2521559,1,1,1,1,5578
e10b4beb9062c65e86a19ae16b6636768ac29bde,0,Bryan Bende,2016-09-21 10:33:39-04:00,['684f417406107b33ecdca9a36fa4ab31ae4facca'],8,8,16,2521575,2,,,,5578
fda15d916df12e627651469d2002eb84a72d77f4,0,Oleg Zhurakousky,2016-09-21 10:36:24-04:00,['e10b4beb9062c65e86a19ae16b6636768ac29bde'],4,0,4,2521579,1,,,,5578
938c7cccb8b251d4a1390cf0078b14f53bc94a57,0,Matt Burgess,2016-09-21 11:16:57-04:00,['fda15d916df12e627651469d2002eb84a72d77f4'],10,20,30,2521609,2,0,1,1,5578
be83c0c5b2b8a435b4745cbfc43f7c9251561727,1,Pierre Villard,2016-09-21 17:40:38+02:00,['938c7cccb8b251d4a1390cf0078b14f53bc94a57'],1,191,192,2521801,3,0.203389831,1,1,5580
b304f70f3ee3715dd744e03bc94c231853abf2b5,0,Bryan Bende,2016-09-21 14:40:10-04:00,['be83c0c5b2b8a435b4745cbfc43f7c9251561727'],1,5,6,2521807,1,0.387096774,1,0.903225806,5580
5198e70d1460134689c11f6bbbc6147b4292fb0b,0,Bryan Bende,2016-09-21 17:20:44-04:00,['b304f70f3ee3715dd744e03bc94c231853abf2b5'],11,2,13,2521820,2,0.2,0,0,5580
77f8503e98faa8d76c33756670e3d23bf189ef58,0,Pierre Villard,2016-09-22 12:21:43+02:00,['5198e70d1460134689c11f6bbbc6147b4292fb0b'],3,3,6,2521826,3,,,,5580
f11682202b57edab585967e033839800d4159f4e,0,Pierre Villard,2016-09-22 13:08:34+02:00,['77f8503e98faa8d76c33756670e3d23bf189ef58'],0,492,492,2522318,8,0.714285714,1,1,5586
0218bc61ef6a8f2e2bd1147477eeaa967d29607f,0,Bryan Bende,2016-09-22 11:32:19-04:00,['f11682202b57edab585967e033839800d4159f4e'],488,609,1097,2523415,4,0,0.515463918,0,5586
e9738747930406cf1611ec9f08031f4c3c0e5fee,0,Matt Gilman,2016-09-22 14:50:21-04:00,['0218bc61ef6a8f2e2bd1147477eeaa967d29607f'],75,75,150,2523565,8,,,,5588
00412f6e97fdc077cf9c8c0d365ebe4876a33305,1,Matt Burgess,2016-09-22 15:00:06-04:00,['e9738747930406cf1611ec9f08031f4c3c0e5fee'],1,2126,2127,2525692,16,0.198824682,0.712047013,0.778648384,5602
937dc71aec107cdd0367d75d91435eaa5c7e73d9,1,Matt Burgess,2016-09-22 15:00:06-04:00,['00412f6e97fdc077cf9c8c0d365ebe4876a33305'],25,46,71,2525763,3,0,0,0,5602
49297b725d4770040c2cc2c01514ef49b2680c88,0,Pierre Villard,2016-09-22 21:46:23+02:00,['937dc71aec107cdd0367d75d91435eaa5c7e73d9'],10,47,57,2525820,2,0,0.578947368,1,5602
f06aeaee2afbd7e606c98c630a3b20487e8d2e29,0,Pierre Villard,2016-09-23 15:46:53+02:00,['49297b725d4770040c2cc2c01514ef49b2680c88'],16,42,58,2525878,1,1,0,0,5602
b34de74db296c5848e92c3804510c05e0df4e782,1,Pierre Villard,2016-09-23 17:12:30+02:00,['f06aeaee2afbd7e606c98c630a3b20487e8d2e29'],1,43,44,2525922,2,0.736842105,0.736842105,1,5602
5a3d00c7bb171b4ca35c5533f670ade9513ab6d3,0,Joe Skora,2016-09-23 13:25:03-04:00,['b34de74db296c5848e92c3804510c05e0df4e782'],36,62,98,2526020,2,0,1,1,5602
66fe004058ca9f4d9933f49865572c4dac3cbfdb,1,Pierre Villard,2016-09-23 19:30:51+02:00,['5a3d00c7bb171b4ca35c5533f670ade9513ab6d3'],0,4,4,2526024,1,0,0,0,5602
25150d4016557300119c11d0a0db71e994a68e8a,0,Matt Gilman,2016-09-23 14:35:38-04:00,['66fe004058ca9f4d9933f49865572c4dac3cbfdb'],0,3,3,2526027,1,,,,5602
85a1f753a7c7b83330077a83df11bfaa4fd128ad,1,Joe Skora,2016-09-23 16:01:23-04:00,['25150d4016557300119c11d0a0db71e994a68e8a'],1,86,87,2526114,3,0,1,1,5602
56f7cd085fbd043aa64d1626d4ba3e1377b59cbe,0,Andre F de Miranda,2016-09-24 14:30:40+10:00,['85a1f753a7c7b83330077a83df11bfaa4fd128ad'],1,2,3,2526117,1,,,,5602
44d4b882bf90c6fc8a9c924e17ce3256f9f0e486,1,Koji Kawamura,2016-09-26 17:22:21+09:00,['56f7cd085fbd043aa64d1626d4ba3e1377b59cbe'],8,78,86,2526203,2,0,0.888888889,1,5602
be85d9ddff1a3c39631718d936afdf5a6199c335,0,Aldrin Piri,2016-09-26 11:30:44-04:00,['44d4b882bf90c6fc8a9c924e17ce3256f9f0e486'],2,15,17,2526220,2,,,,5602
1b88552b4677ceb1dfef0119c9c5a0306761ec95,0,Aldrin Piri,2016-09-26 11:43:33-04:00,['be85d9ddff1a3c39631718d936afdf5a6199c335'],5,5,10,2526230,2,,,,5602
446cd4470251e6a400fde14eca69db8b10969d40,1,Pierre Villard,2016-09-26 17:47:31+02:00,['1b88552b4677ceb1dfef0119c9c5a0306761ec95'],108,105,213,2526443,75,,,,5602
88682359937afbc0e48df769c296606316c7b1d0,0,Matt Burgess,2016-09-26 12:05:16-04:00,['446cd4470251e6a400fde14eca69db8b10969d40'],9,9,18,2526461,2,,,,5602
30f008d6764ac9f41c9bbdeec723ed09ac5c44a6,1,Matt Gilman,2016-09-26 15:16:32-04:00,['88682359937afbc0e48df769c296606316c7b1d0'],2,9,11,2526472,2,1,1,0,5602
28acb07433106db0ab17da9719cd877ae8a6d2ce,1,Matt Burgess,2016-09-27 10:18:48-04:00,['30f008d6764ac9f41c9bbdeec723ed09ac5c44a6'],2,11,13,2526485,1,0,0,0,5602
508b218b592b88baecdf67dec8c27447b602a2bd,1,Matt Gilman,2016-09-27 10:58:01-04:00,['28acb07433106db0ab17da9719cd877ae8a6d2ce'],222,789,1011,2527496,10,0.732193732,0.965811966,0.94017094,5602
3ac3b8dc91d02f1dbf6e9f39febef95ee434543c,0,jpercivall,2016-09-27 11:41:48-04:00,['508b218b592b88baecdf67dec8c27447b602a2bd'],33,34,67,2527563,8,,,,5602
dd9ecc2907acc6d186fc000e3ab00d241bd1b296,0,Yolanda M. Davis,2016-09-27 11:44:21-04:00,['508b218b592b88baecdf67dec8c27447b602a2bd'],5,12,17,2527580,1,1,1,0.5,5602
de717da73f58cabc09813498668afe02bf07f462,0,Yolanda M. Davis,2016-09-27 12:01:46-04:00,"['dd9ecc2907acc6d186fc000e3ab00d241bd1b296', '3ac3b8dc91d02f1dbf6e9f39febef95ee434543c']",33,34,67,2527647,8,,,,5602
d674cdfc799a5bb588540d7ceea150086c742feb,1,Matt Gilman,2016-09-27 15:08:11-04:00,['de717da73f58cabc09813498668afe02bf07f462'],11,25,36,2527683,3,1,1,0,5602
c4826cac5417f3b1308f14aa1de9b426d1ae82be,0,Matt Gilman,2016-09-27 15:38:10-04:00,['d674cdfc799a5bb588540d7ceea150086c742feb'],7,6,13,2527696,4,1,1,1,5602
d4948a377802ecc07f196370eefe92195d8a773f,1,Yolanda M. Davis,2016-09-28 13:14:57-04:00,['c4826cac5417f3b1308f14aa1de9b426d1ae82be'],31,293,324,2528020,19,0.569230769,0.553846154,1,5604
cfc738ec197c3a17c1f2cffba3e6094ea562fab9,1,James Wing,2016-09-28 10:32:11-07:00,['d4948a377802ecc07f196370eefe92195d8a773f'],10,36,46,2528066,9,0.666666667,1,0.833333333,5604
833ec4409c20c5f2323b61b87bab7c10557f7041,1,jpercivall,2016-09-28 15:01:38-04:00,['cfc738ec197c3a17c1f2cffba3e6094ea562fab9'],0,25,25,2528091,1,0,0,1,5604
12e3315ae9037e47e42e0238c1625556d1a7149c,0,Matt Gilman,2016-09-29 11:57:04-04:00,['833ec4409c20c5f2323b61b87bab7c10557f7041'],0,2,2,2528093,1,,,,5604
1a24f5f34c7a73d8b866fe99621c9d21442a498e,0,Matt Gilman,2016-09-29 13:09:29-04:00,['12e3315ae9037e47e42e0238c1625556d1a7149c'],3,3,6,2528099,3,,,,5604
e230e50f9dea80faaf1177cf5cfc0ab9cfabc353,0,Matt Gilman,2016-09-29 13:25:19-04:00,['1a24f5f34c7a73d8b866fe99621c9d21442a498e'],0,2,2,2528101,1,0,0,1,5604
4e13fef7243935962848ae83b3e31a5283c71c66,1,Bryan Bende,2016-09-30 09:12:16-04:00,['e230e50f9dea80faaf1177cf5cfc0ab9cfabc353'],0,1493,1493,2529594,16,0.504587156,0.837920489,0.957186544,5617
d6867283b55a8b40a4467197ed611c5c8669dff8,1,Matt Gilman,2016-09-30 09:59:35-04:00,['4e13fef7243935962848ae83b3e31a5283c71c66'],4,47,51,2529645,3,0,1,0.958333333,5617
cc5e827aa1dfe2f376e9836380ba63c15269eea8,0,Andre F de Miranda,2016-10-01 01:04:21+10:00,['d6867283b55a8b40a4467197ed611c5c8669dff8'],0,0,0,2529645,0,,,,5617
2054888fb1cbb442a70e3677139dc7a26348671d,0,Bryan Bende,2016-09-30 14:23:50-04:00,['cc5e827aa1dfe2f376e9836380ba63c15269eea8'],8,15,23,2529668,3,,,,5617
25b7dfa9b1ba8f2bda445a0ddfe55c198dffde38,0,Pierre Villard,2016-10-01 18:38:58+02:00,['2054888fb1cbb442a70e3677139dc7a26348671d'],13,698,711,2530379,8,0.083916084,0.555944056,0.828671329,5619
bec7dbbad6ed10950411955d4718d99dc84746c1,0,Andre F de Miranda,2016-10-04 01:35:34+11:00,['25b7dfa9b1ba8f2bda445a0ddfe55c198dffde38'],169,191,360,2530739,4,1,0,0.3,5620
34e5a5321ab5e5d02e22932f115be982b3b5b304,1,jpercivall,2016-10-03 10:41:33-04:00,['bec7dbbad6ed10950411955d4718d99dc84746c1'],3,47,50,2530789,4,0.357142857,1,1,5620
17a36c6fd525dba837e13a71a52ddfd224782fae,1,Bryan Bende,2016-10-03 13:28:01-04:00,['34e5a5321ab5e5d02e22932f115be982b3b5b304'],36,414,450,2531239,19,0.476923077,0.974358974,0.98974359,5623
4dbdfea5dcdf6c6ef6a70589302b1fb9b7893b3d,0,Andy LoPresto,2016-10-04 17:27:44-07:00,['17a36c6fd525dba837e13a71a52ddfd224782fae'],1,1,2,2531241,1,,,,5623
44cc7e00728892a3025d7554ffd7df432b32b02e,0,Matt Gilman,2016-10-05 08:14:15-04:00,['4dbdfea5dcdf6c6ef6a70589302b1fb9b7893b3d'],3,3,6,2531247,1,,,,5623
2c907c63af921a9968bafd87903c93fe732c692f,0,Matt Gilman,2016-10-05 08:59:26-04:00,['44cc7e00728892a3025d7554ffd7df432b32b02e'],2,11,13,2531260,2,0,0,1,5623
75d0c74d273600629d7a6e7027196c39b66513bb,0,Andre F de Miranda,2016-10-06 00:20:52+11:00,['2c907c63af921a9968bafd87903c93fe732c692f'],12,219,231,2531491,7,0,0.757352941,1,5624
7fd293f3390ab4785bdbe53069ddffeee529a4ed,0,Aldrin Piri,2016-10-05 10:52:16-04:00,['75d0c74d273600629d7a6e7027196c39b66513bb'],0,43,43,2531534,1,,,,5625
9a7c36dc13477b688e68aeaf0a6d847c5dbbb465,0,Aldrin Piri,2016-10-05 11:14:24-04:00,['7fd293f3390ab4785bdbe53069ddffeee529a4ed'],26,12,38,2531572,2,,,,5625
f157076378abef2d4973a04a86f5dc867838fdc4,0,Bryan Bende,2016-10-05 11:37:05-04:00,['9a7c36dc13477b688e68aeaf0a6d847c5dbbb465'],137,3,140,2531712,2,,,,5625
3b408f560124efec40983eb218109afc4ba19c95,1,Matt Gilman,2016-10-05 13:07:57-04:00,['f157076378abef2d4973a04a86f5dc867838fdc4'],196,196,392,2532104,90,,,,5625
c764f83506165c99e77c707e358cb327e9af16b8,0,Matt Gilman,2016-10-05 14:23:13-04:00,['3b408f560124efec40983eb218109afc4ba19c95'],0,5,5,2532109,1,0,0,1,5625
e46fea920af11d2527f4eb4da3a191e309d12618,0,Matt Gilman,2016-10-05 16:15:11-04:00,['c764f83506165c99e77c707e358cb327e9af16b8'],0,1,1,2532110,1,,,,5625
da33e2859ce45321d28901e5820c38a37dcfc709,1,Pierre Villard,2016-10-05 22:31:01+02:00,['e46fea920af11d2527f4eb4da3a191e309d12618'],50,817,867,2532977,9,0.086956522,0.927536232,1,5628
6ad633d17422f2110645553cb03ae3b364926eee,0,Matt Gilman,2016-10-05 16:40:06-04:00,['da33e2859ce45321d28901e5820c38a37dcfc709'],20,37,57,2533034,4,1,1,1,5628
6f1af31ff28f60d0eddbee5dafe909bc66cc9c71,1,jpercivall,2016-10-05 17:33:07-04:00,['6ad633d17422f2110645553cb03ae3b364926eee'],3,181,184,2533218,8,0.846153846,0.846153846,0.846153846,5630
3c8545a90266b8f82a6c541c9a68daad107b0f23,1,Andre F de Miranda,2016-10-06 21:34:56+11:00,['6f1af31ff28f60d0eddbee5dafe909bc66cc9c71'],1,50,51,2533269,2,0,1,1,5630
3c673972e035f1168e509128150444da78af5292,0,Matt Gilman,2016-10-06 09:29:59-04:00,['3c8545a90266b8f82a6c541c9a68daad107b0f23'],10,10,20,2533289,1,,,,5630
8bd85e20853c44bbb33bcad2795bfb4ac8819e1a,0,Matt Gilman,2016-10-06 09:51:05-04:00,['3c673972e035f1168e509128150444da78af5292'],13,44,57,2533346,3,1,1,1,5630
92cca96d49042f9898f93b3a2d2210b924708e52,1,Bryan Bende,2016-10-06 10:05:51-04:00,['8bd85e20853c44bbb33bcad2795bfb4ac8819e1a'],3665,2837,6502,2539848,45,0.725888325,0.16751269,0.005076142,5647
53f7a2166360de4f73a2fefbb0e6b6349ba92455,0,Andre F de Miranda,2016-10-07 01:22:49+11:00,['92cca96d49042f9898f93b3a2d2210b924708e52'],3,3,6,2539854,2,,,,5647
a4ed622152187155463af2b748c9bf492621bbc7,1,Bryan Bende,2016-10-06 15:19:00-04:00,['53f7a2166360de4f73a2fefbb0e6b6349ba92455'],2837,3665,6502,2546356,45,0.274111675,0.83248731,0.994923858,5661
b9cb6b1b475eb4688b7cd32f6d343c5dffb20567,1,Bryan Bende,2016-10-06 15:51:16-04:00,['a4ed622152187155463af2b748c9bf492621bbc7'],3665,2837,6502,2552858,45,0.725888325,0.16751269,0.005076142,5678
9304df4de060335526d29a77aa093db4004c8b2e,0,Bryan Bende,2016-10-06 15:51:37-04:00,['b9cb6b1b475eb4688b7cd32f6d343c5dffb20567'],0,1,1,2552859,1,0,0,1,5678
bb6c5d9d4ea02433ee8cb63cd142327c02f6e9da,1,Mark Payne,2016-10-06 16:19:19-04:00,['9304df4de060335526d29a77aa093db4004c8b2e'],63,66,129,2552988,7,1,1,0,5678
09568d092b5329e4732f2e05c10fad181c344b8d,1,Matt Gilman,2016-10-06 16:41:05-04:00,['bb6c5d9d4ea02433ee8cb63cd142327c02f6e9da'],163,353,516,2553504,3,0.02919708,0.708029197,0.708029197,5678
540ef63efa9d6b2af84f57fe4eae2f08e6dd1693,1,Koji Kawamura,2016-10-07 15:00:37+09:00,['09568d092b5329e4732f2e05c10fad181c344b8d'],17,50,67,2553571,3,0,0,1,5678
4a4c87fa15efa7adbb08b414bc5a5a280a41803d,1,Andy LoPresto,2016-10-11 00:06:09-07:00,['540ef63efa9d6b2af84f57fe4eae2f08e6dd1693'],39,149,188,2553759,7,0.288135593,1,0.966101695,5679
ee14ae8af0740b4ca442b2662c48f422c53b144e,1,Mike Moser,2016-10-11 10:32:00-04:00,['4a4c87fa15efa7adbb08b414bc5a5a280a41803d'],70,238,308,2554067,7,0.021978022,0.593406593,1,5679
6d5f4777c5ce2e7e361dd0d794d6bdd706222c82,1,Matt Burgess,2016-10-11 14:57:40-04:00,['ee14ae8af0740b4ca442b2662c48f422c53b144e'],156,350,506,2554573,4,0.008695652,1,0.504347826,5680
af27179322a29259fb831bbc20f84f70c415ef56,0,James Wing,2016-10-11 20:21:29-07:00,['6d5f4777c5ce2e7e361dd0d794d6bdd706222c82'],32,855,887,2555460,8,0.254117647,0.877647059,0.943529412,5685
a25b651da9da57a20431b9eedcd8a8860aaa4242,0,Bryan Bende,2016-10-12 09:18:58-04:00,['af27179322a29259fb831bbc20f84f70c415ef56'],10,18,28,2555488,1,1,0,0,5685
893fed794c20f8f9ce87e7e60f5ad9722a67b3bd,0,Matt Burgess,2016-10-12 13:20:37-04:00,['a25b651da9da57a20431b9eedcd8a8860aaa4242'],0,4,4,2555492,1,,,,5685
979b4d8ab9af41861d1f92cdd5fb96ee05460442,0,Andy LoPresto,2016-10-12 10:35:45-07:00,['893fed794c20f8f9ce87e7e60f5ad9722a67b3bd'],29,28,57,2555549,11,,,,5685
6dc2f14198bb475ace8e762e348ca5294400cccb,0,James Wing,2016-10-12 17:19:13-07:00,['979b4d8ab9af41861d1f92cdd5fb96ee05460442'],11,123,134,2555683,5,0.716666667,0.866666667,1,5685
c470fae0653add23ff5ceaf04a814b98f3f612cb,1,Matt Gilman,2016-10-13 09:50:50-04:00,['6dc2f14198bb475ace8e762e348ca5294400cccb'],30,166,196,2555879,6,0.130952381,1,1,5685
26f46538b3cb6649918a64014f92d4adb9165133,1,Mark Payne,2016-10-13 12:14:16-04:00,['c470fae0653add23ff5ceaf04a814b98f3f612cb'],62,532,594,2556473,9,0.663043478,0.789855072,0.916666667,5685
6e7793305d4ebcf154cf42ae7f6e9e17cab4e857,0,Mark Payne,2016-10-13 15:13:47-04:00,['26f46538b3cb6649918a64014f92d4adb9165133'],1,2,3,2556476,1,,,,5685
33ba1a822e8af48e74b6c8faac5feb754f515121,1,Andy LoPresto,2016-10-13 17:21:11-07:00,['6e7793305d4ebcf154cf42ae7f6e9e17cab4e857'],1,1,2,2556478,1,,,,5685
7107616420ed31c057ff7bf7f06bf36e5740b3ea,1,James Wing,2016-10-13 19:53:53-07:00,['33ba1a822e8af48e74b6c8faac5feb754f515121'],1,483,484,2556962,5,0.395721925,1,0.957219251,5689
e969a5ffe3a1e03b0b6a0f0a11e954dc396bf25a,1,Matt Burgess,2016-10-14 09:23:19-04:00,['7107616420ed31c057ff7bf7f06bf36e5740b3ea'],1,12,13,2556975,3,0.857142857,1,1,5689
88d125137e3bf3faf80b522edf5cf14f99419d60,1,Andre F de Miranda,2016-10-15 00:48:04+11:00,['e969a5ffe3a1e03b0b6a0f0a11e954dc396bf25a'],1,1,2,2556977,1,,,,5689
b52b8398957dcb60b93ea5f697f45d3e0e212082,0,Oleg Zhurakousky,2016-10-14 12:35:38-04:00,['88d125137e3bf3faf80b522edf5cf14f99419d60'],0,10,10,2556987,1,0,0,0,5689
d63e675a7d2905ae8408adc8114c01c2ea4604c8,1,Oleg Zhurakousky,2016-10-14 12:40:31-04:00,['b52b8398957dcb60b93ea5f697f45d3e0e212082'],3,6,9,2556996,1,,,,5689
596b98865b1c3526072ea120f86f0ff9627f82a8,0,Oleg Zhurakousky,2016-10-14 12:45:34-04:00,['d63e675a7d2905ae8408adc8114c01c2ea4604c8'],1,1,2,2556998,1,,,,5689
c883f98cbf803e5d8982a2a811c3ca46c5c249ca,0,Pierre Villard,2016-10-17 22:32:23+02:00,['596b98865b1c3526072ea120f86f0ff9627f82a8'],2,0,2,2557000,1,1,1,0,5689
b9a940bbd1c7afede946e2e7db948cc38582208f,1,Pierre Villard,2016-10-17 22:51:45+02:00,['c883f98cbf803e5d8982a2a811c3ca46c5c249ca'],1,65,66,2557066,2,0,1,1,5690
9fb3039416d05ea1e76e530c29527d466927e1d1,0,Pierre Villard,2016-10-17 23:07:39+02:00,['b9a940bbd1c7afede946e2e7db948cc38582208f'],0,3,3,2557069,2,0,1,1,5690
5afbc433642a51a40c22a2048cfa7d0e9cf0a86a,1,joewitt,2016-10-18 14:47:49-04:00,['9fb3039416d05ea1e76e530c29527d466927e1d1'],8,18,26,2557095,1,1,0,0,5690
f287bc9119c2f0d018329f53c85fb502b5c96f18,0,Andy LoPresto,2016-10-18 15:24:18-07:00,['5afbc433642a51a40c22a2048cfa7d0e9cf0a86a'],0,1,1,2557096,1,,,,5690
27dba60f27579ca9f33aa1afbf4bb46182d57df4,0,Andy LoPresto,2016-10-18 15:56:27-07:00,['f287bc9119c2f0d018329f53c85fb502b5c96f18'],2,47,49,2557145,2,0.5,1,1,5690
3914141c45c574fb8d22a72af99165cb535f5f17,1,Andy LoPresto,2016-10-18 16:43:03-07:00,['27dba60f27579ca9f33aa1afbf4bb46182d57df4'],2,26,28,2557173,1,,,,5690
a8e1c775fd95cfb73ab5453a8e7ec7c1d3e03b98,0,Matt Gilman,2016-10-19 15:39:58-04:00,['3914141c45c574fb8d22a72af99165cb535f5f17'],5,13,18,2557191,2,0,1,1,5690
611cadd231309126a0a7737391f6e07730bb3864,0,Andy LoPresto,2016-10-19 16:33:33-04:00,['a8e1c775fd95cfb73ab5453a8e7ec7c1d3e03b98'],23,87,110,2557301,2,0,0.983606557,0.983606557,5690
ae503f5d456a6170bd67cc9ce26c4eb6ed5c7673,0,Joe Skora,2016-10-20 00:59:16-04:00,['611cadd231309126a0a7737391f6e07730bb3864'],0,58,58,2557359,1,,,,5690
231f5143ab8100d6a5d4543a5476694378fdcf6d,0,Andre F de Miranda,2016-10-20 23:02:33+11:00,['ae503f5d456a6170bd67cc9ce26c4eb6ed5c7673'],0,0,0,2557359,0,,,,5690
99d3c397481a98a5b3d2d4e44b84516fc0e3675e,1,Andre F de Miranda,2016-10-20 23:12:23+11:00,['231f5143ab8100d6a5d4543a5476694378fdcf6d'],5,12,17,2557376,2,0,0,1,5690
af27e4070b6ec2fb4bb7acfe4c2fd573849c802c,0,jpercivall,2016-10-20 12:45:37-04:00,['99d3c397481a98a5b3d2d4e44b84516fc0e3675e'],3,0,3,2557379,1,1,1,0,5690
f5f132b1abc63a0b3612e4efe6a3faa129c337e2,1,Oleg Zhurakousky,2016-10-20 14:56:01-04:00,['af27e4070b6ec2fb4bb7acfe4c2fd573849c802c'],0,13,13,2557392,3,,,,5690
9f6fb617ba440a77cc0e44dcf38ab0ce09a7a15c,0,Matt Burgess,2016-10-20 16:46:54-04:00,['f5f132b1abc63a0b3612e4efe6a3faa129c337e2'],0,3,3,2557395,1,,,,5690
b864d49f66692dabeb805965a08e83e14d27fd58,1,Matt Burgess,2016-10-20 17:16:57-04:00,['9f6fb617ba440a77cc0e44dcf38ab0ce09a7a15c'],0,594,594,2557989,6,0.147679325,0.708860759,0.974683544,5692
220b76803b2f70ddd6dcc366478d722599349983,0,Andre F de Miranda,2016-10-21 23:17:44+11:00,['b864d49f66692dabeb805965a08e83e14d27fd58'],0,0,0,2557989,0,,,,5692
6676e94a7cce68501dc5c010e42c036a2d92a472,0,Matt Gilman,2016-10-21 16:11:27-04:00,['220b76803b2f70ddd6dcc366478d722599349983'],51,12,63,2558052,4,1,0,0,5692
9b08f23b2436225e385a6134063b9d5f8cebcc54,0,Aldrin Piri,2016-10-23 10:29:09-04:00,['6676e94a7cce68501dc5c010e42c036a2d92a472'],55,0,55,2558107,32,,,,5692
94ab99902602d20d53a63ac86bed7c99cf06c9c9,1,Matt Burgess,2016-10-24 10:20:21-04:00,['9b08f23b2436225e385a6134063b9d5f8cebcc54'],328,820,1148,2559255,35,0.241042345,0.439739414,0.899022801,5698
557e0b9f27fe8fd99aa0ac6feda597ea26fc3357,1,Matt Burgess,2016-10-24 10:20:21-04:00,['94ab99902602d20d53a63ac86bed7c99cf06c9c9'],1,60,61,2559316,5,0.769230769,0.769230769,1,5699
e4a3e096432f43087c499d69bcbb4f2a013269a7,0,Matt Burgess,2016-10-24 10:31:16-04:00,['557e0b9f27fe8fd99aa0ac6feda597ea26fc3357'],6,28,34,2559350,4,0.25,0.25,1,5699
368ea7a2d20461406db2c7d2f1dc3eca8dea4aeb,0,jpercivall,2016-10-25 12:44:19-04:00,['e4a3e096432f43087c499d69bcbb4f2a013269a7'],1,0,1,2559351,1,,,,5699
1d74b5d3cea7cc844ebb97bb4af1d3c9110ed487,1,Pierre Villard,2016-10-25 19:45:38+02:00,['368ea7a2d20461406db2c7d2f1dc3eca8dea4aeb'],6,273,279,2559630,7,0.048192771,0.325301205,0.915662651,5700
8c09bef4f8d06b4ee5b0b9e5d5ec88cdcd4a372c,0,Yolanda M. Davis,2016-10-25 14:30:04-04:00,['1d74b5d3cea7cc844ebb97bb4af1d3c9110ed487'],20,97,117,2559747,5,0.357142857,1,1,5700
8dc60c72d48dba910e97bb36d400031c5f0882d0,0,Bryan Bende,2016-10-27 11:50:46-04:00,['8c09bef4f8d06b4ee5b0b9e5d5ec88cdcd4a372c'],109,262,371,2560118,8,0.7,0.84,1,5700
9e90aae066b3dd79261cd0d8999d34090d7be042,0,Pierre Villard,2016-10-28 10:35:37+02:00,['8dc60c72d48dba910e97bb36d400031c5f0882d0'],1,31,32,2560150,1,0,1,1,5700
7fd2c42b198f3350d36bf995af2a0ab29ea7e0de,0,joewitt,2016-10-28 12:15:12-04:00,['9e90aae066b3dd79261cd0d8999d34090d7be042'],3,292,295,2560445,3,0.69047619,0.023809524,0.69047619,5702
e1f0ba5a43811561d2dce09914ca87db4a3e1738,1,Bryan Bende,2016-10-31 09:59:06-04:00,['7fd2c42b198f3350d36bf995af2a0ab29ea7e0de'],38,93,131,2560576,12,0.75862069,0.75862069,0.379310345,5702
56da2b51e16d92df07e25277d01c85ad622015a9,1,Matt Gilman,2016-11-02 09:39:48-04:00,['e1f0ba5a43811561d2dce09914ca87db4a3e1738'],44,120,164,2560740,39,,,,5702
511f2a0c8bcae5a588073cfb34dbdafb5ee478c3,1,Andre F de Miranda,2016-11-03 02:26:20+11:00,['56da2b51e16d92df07e25277d01c85ad622015a9'],1,22,23,2560763,1,,,,5702
4acc9ad288cc005127d1709adbb1134f6dab94c6,0,Andre F de Miranda,2016-11-03 02:29:11+11:00,['511f2a0c8bcae5a588073cfb34dbdafb5ee478c3'],0,0,0,2560763,0,,,,5702
7fbc23639af654fcee72e8ef74340b9f093658d6,1,Oleg Zhurakousky,2016-11-02 12:15:26-04:00,['4acc9ad288cc005127d1709adbb1134f6dab94c6'],27,19,46,2560809,1,1,1,0,5702
5f9cae97b763186e23b0c970ea4f3d9a8866a885,0,Oleg Zhurakousky,2016-11-02 12:29:09-04:00,['7fbc23639af654fcee72e8ef74340b9f093658d6'],0,0,0,2560809,2,,,,5702
05ea76dd6f7ecece9bb7675c81f02d7b36fbd916,1,Matt Gilman,2016-11-02 12:54:58-04:00,['5f9cae97b763186e23b0c970ea4f3d9a8866a885'],51,199,250,2561059,9,0,0.481481481,1,5702
892c74dff26c1b56860131489f6ee56018631c9d,0,Oleg Zhurakousky,2016-11-02 13:02:25-04:00,['05ea76dd6f7ecece9bb7675c81f02d7b36fbd916'],2,39,41,2561100,2,1,1,1,5702
2fb3b01ebe2a0519b98e4450cd89204b4225657d,0,Oleg Zhurakousky,2016-11-02 13:13:34-04:00,['892c74dff26c1b56860131489f6ee56018631c9d'],1,27,28,2561128,2,0,0.947368421,0.947368421,5702
60423f05b5b0c52c12233dcdda3076b1fa18175b,0,Matt Gilman,2016-11-02 14:11:56-04:00,['2fb3b01ebe2a0519b98e4450cd89204b4225657d'],44,104,148,2561276,17,1,1,1,5702
769530beae7b0a6dba848ae4610e38d847045fa7,1,Matt Gilman,2016-11-02 15:15:29-04:00,['60423f05b5b0c52c12233dcdda3076b1fa18175b'],142,276,418,2561694,22,0.588607595,0.620253165,1,5702
b5550ffcf5d3b968551b91a41f146b18dcc0a9ec,1,Oleg Zhurakousky,2016-11-02 16:10:37-04:00,['769530beae7b0a6dba848ae4610e38d847045fa7'],1,36,37,2561731,2,0,1,1,5702
1abd017c353d2b45319e3a9e03281bba170c7d55,1,Oleg Zhurakousky,2016-11-02 16:15:09-04:00,['b5550ffcf5d3b968551b91a41f146b18dcc0a9ec'],3,100,103,2561834,2,0.651515152,0.106060606,1,5702
9e44734042cb7dfb5e17b2cf2137f8641be5bf16,0,Oleg Zhurakousky,2016-11-02 16:18:30-04:00,['1abd017c353d2b45319e3a9e03281bba170c7d55'],1,1,2,2561836,1,,,,5702
edb0ebe52b8ade4842cad6b5e3aa489288e18d75,0,Bryan Bende,2016-11-03 09:47:26-04:00,['9e44734042cb7dfb5e17b2cf2137f8641be5bf16'],3,2,5,2561841,1,0,0,1,5702
a486fefb1e938532636e9235eaf03ee70dc972aa,1,Matt Gilman,2016-11-03 11:16:20-04:00,['edb0ebe52b8ade4842cad6b5e3aa489288e18d75'],6,489,495,2562336,18,0.657142857,0.6,1,5702
60da897e10663275d5fb9373755570a6d403b907,0,Matt Gilman,2016-11-03 12:24:09-04:00,['a486fefb1e938532636e9235eaf03ee70dc972aa'],5,2,7,2562343,3,,,,5702
ed035f85e38f7c9efe6ac84c8f13c9a455f7014c,1,Matt Burgess,2016-11-03 12:25:31-04:00,['60da897e10663275d5fb9373755570a6d403b907'],2,20,22,2562365,2,0.642857143,0.642857143,1,5702
b7c63921833974e3b3baad641ec55774228380c9,0,Matt Gilman,2016-11-03 13:54:04-04:00,['ed035f85e38f7c9efe6ac84c8f13c9a455f7014c'],0,0,0,2562365,14,,,,5702
0841f14c18eb3798ebc798406109bd3f9bdb6643,0,Bryan Rosander,2016-11-03 14:46:10-04:00,['b7c63921833974e3b3baad641ec55774228380c9'],1,2,3,2562368,1,0,0,1,5702
50010fb34064d9cf622e265ed57c9ab0be39318e,0,Oleg Zhurakousky,2016-11-04 07:04:25-04:00,['0841f14c18eb3798ebc798406109bd3f9bdb6643'],0,6,6,2562374,1,1,1,1,5702
a7d06412f8e4809157bf1074d659b5420546190f,0,Oleg Zhurakousky,2016-11-04 08:23:10-04:00,['50010fb34064d9cf622e265ed57c9ab0be39318e'],23,39,62,2562436,1,0,0,1,5702
c13cfa6ea6009070db74d7dd9be9c66703d56942,0,Oleg Zhurakousky,2016-11-04 08:23:10-04:00,['a7d06412f8e4809157bf1074d659b5420546190f'],17,21,38,2562474,1,,,,5702
6aefc0b9102bc83456ff537ade22946715bdcd30,1,Matt Burgess,2016-11-07 14:01:18-05:00,['c13cfa6ea6009070db74d7dd9be9c66703d56942'],2,32,34,2562508,1,0,0.086956522,0.086956522,5702
5fd4a55791da27fdba577636ac985a294618328a,0,Matt Burgess,2016-11-07 16:28:16-05:00,['6aefc0b9102bc83456ff537ade22946715bdcd30'],2,30,32,2562540,3,1,1,1,5702
89eb2ce28c835a56452162002c46101288e61203,0,Andy LoPresto,2016-11-07 15:33:10-08:00,['5fd4a55791da27fdba577636ac985a294618328a'],67,725,792,2563332,7,,,,5706
aa8ba0bd1ceaad34da3b85b8f2b727176dde0824,0,Pierre Villard,2016-11-08 14:49:12+01:00,['89eb2ce28c835a56452162002c46101288e61203'],1,12,13,2563345,2,1,1,1,5706
9d3fe3f03ee5d4c565638c4c8ccb7d03f5305165,1,Pierre Villard,2016-11-08 14:58:11+01:00,['aa8ba0bd1ceaad34da3b85b8f2b727176dde0824'],3,5,8,2563353,1,1,1,1,5706
2f0d9a34f1351622bbf2cfb16d784034164136b0,0,Pierre Villard,2016-11-08 16:55:27+01:00,['9d3fe3f03ee5d4c565638c4c8ccb7d03f5305165'],4,4,8,2563361,2,,,,5706
d1d053725b72d91fbfca1a2e86691e9c9a1a3f2f,1,Oleg Zhurakousky,2016-11-08 13:21:27-05:00,['2f0d9a34f1351622bbf2cfb16d784034164136b0'],376,1280,1656,2565017,48,0.425655977,0.950437318,0.839650146,5714
78020825e9edfee1842e3d642ef762e5be1ab4bd,0,Oleg Zhurakousky,2016-11-08 13:50:42-05:00,['d1d053725b72d91fbfca1a2e86691e9c9a1a3f2f'],2,5,7,2565024,1,0,0,0,5714
63bda32a8befe7f0da01a6c543462f6b2b2daced,0,Oleg Zhurakousky,2016-11-08 14:14:40-05:00,['78020825e9edfee1842e3d642ef762e5be1ab4bd'],2,29,31,2565055,2,0,1,1,5714
4b4e099f2ecd990f67f0afc994ecc4d46cbfc595,1,Matt Burgess,2016-11-08 14:45:49-05:00,['63bda32a8befe7f0da01a6c543462f6b2b2daced'],1,42,43,2565098,2,0,0.9375,0.9375,5714
7eca2037bd602ecd2b26281d91ac3af9bc72a3f5,1,jpercivall,2016-11-08 17:06:36-05:00,['4b4e099f2ecd990f67f0afc994ecc4d46cbfc595'],28,220,248,2565346,21,0.168831169,0,0.935064935,5715
bff89f17b3bf84e802532e2649bd1424855987b5,1,jpercivall,2016-11-08 17:06:43-05:00,['7eca2037bd602ecd2b26281d91ac3af9bc72a3f5'],131,131,262,2565608,12,1,0.357142857,0.071428571,5715
3e892c55ec35bb47c67e6a5d6d16e168f1b2f0fe,1,joewitt,2016-11-09 11:08:43-05:00,['bff89f17b3bf84e802532e2649bd1424855987b5'],84,147,231,2565839,8,0.545454545,1,1,5715
cc2fbcaac457ebbfeaada4a0fba84db784bfc9a4,1,Oleg Zhurakousky,2016-11-09 12:11:11-05:00,['3e892c55ec35bb47c67e6a5d6d16e168f1b2f0fe'],10,32,42,2565881,2,0,1,0.941176471,5715
c441a8696d8dce47f263846cdf5ecac8506ba5d3,1,joewitt,2016-11-09 16:25:03-05:00,['cc2fbcaac457ebbfeaada4a0fba84db784bfc9a4'],325,800,1125,2567006,18,0.261290323,0.341935484,1,5715
0cc176553101fe8bcb6b3f3c229cb8e1e4589236,0,Yolanda M. Davis,2016-11-09 16:49:04-05:00,['c441a8696d8dce47f263846cdf5ecac8506ba5d3'],10,92,102,2567108,10,0.568965517,0.965517241,0.327586207,5715
1b5a28d1304dcddf0ca4ad8595292e3b87e2fc1f,0,Pierre Villard,2016-11-10 13:30:16+01:00,['0cc176553101fe8bcb6b3f3c229cb8e1e4589236'],0,2,2,2567110,1,0,0,1,5715
435d9cf3538a905e3c0bb6f9c0ad1dc49868f933,1,joewitt,2016-11-10 08:33:43-05:00,['1b5a28d1304dcddf0ca4ad8595292e3b87e2fc1f'],0,6,6,2567116,1,,,,5715
b426de179318daef15019157d683265061728db9,0,Matt Gilman,2016-11-10 09:25:08-05:00,['435d9cf3538a905e3c0bb6f9c0ad1dc49868f933'],2,2,4,2567120,1,,,,5715
f83863ebae700ade07aa8b93ac1e2d82a6cf053c,0,Scott Aslan,2016-11-10 11:39:08-05:00,['b426de179318daef15019157d683265061728db9'],2,10,12,2567132,1,1,1,1,5715
4957b628fbce1b31391a3be390c68f9289ea5615,0,Pierre Villard,2016-11-10 22:12:08+01:00,['f83863ebae700ade07aa8b93ac1e2d82a6cf053c'],1,2,3,2567135,1,0,1,1,5715
9f417a84b9e631c1021d4e550015360e86f4babb,0,Mark Payne,2016-11-11 10:06:41-05:00,['4957b628fbce1b31391a3be390c68f9289ea5615'],70,14,84,2567219,4,0.975,0.325,0,5715
06f191ca102d306be1c895b0e8a925ee3abcdc5e,0,Andy LoPresto,2016-11-11 10:18:43-08:00,['9f417a84b9e631c1021d4e550015360e86f4babb'],2,89,91,2567310,2,0.939393939,1,1,5716
ed6e03399f63d53aafdc2faadfa0878ff0b42188,1,Bryan Rosander,2016-11-11 14:24:56-05:00,['06f191ca102d306be1c895b0e8a925ee3abcdc5e'],0,1521,1521,2568831,17,0.510204082,0.731778426,0.635568513,5730
91f01704165162415f5dec5c20dbb07ed03f8bf8,0,Mark Payne,2016-11-11 14:41:35-05:00,['ed6e03399f63d53aafdc2faadfa0878ff0b42188'],3,30,33,2568864,2,0.1,1,1,5730
57e6a2d515e78793d58b5c0359e5102566f0babc,0,Mark Payne,2016-11-11 14:43:42-05:00,['91f01704165162415f5dec5c20dbb07ed03f8bf8'],0,0,0,2568864,0,,,,5730
52cde9ad1397e7785fbe12379cf2b50c3b275722,0,Matt Gilman,2016-11-11 14:46:20-05:00,['57e6a2d515e78793d58b5c0359e5102566f0babc'],45,91,136,2569000,10,0.29787234,1,1,5730
f32bdf7be9d4eaa62d5fdce375e8e3fa2bfa3557,1,joewitt,2016-11-11 14:49:33-05:00,['52cde9ad1397e7785fbe12379cf2b50c3b275722'],5,22,27,2569027,2,1,1,1,5730
b9ef0fb847cd2678a62964698f17a5afb37684b9,0,joewitt,2016-11-11 14:52:13-05:00,['f32bdf7be9d4eaa62d5fdce375e8e3fa2bfa3557'],8,13,21,2569048,1,1,0,1,5730
b73ba7f8d4f6319881c26b8faad121ceb12041ab,0,Oleg Zhurakousky,2016-11-11 15:13:49-05:00,['b9ef0fb847cd2678a62964698f17a5afb37684b9'],0,23,23,2569071,4,1,1,1,5730
41f519e84cb5d0bf8be4ce93e26a042d16cda273,1,Mark Payne,2016-11-11 15:45:40-05:00,['b73ba7f8d4f6319881c26b8faad121ceb12041ab'],513,772,1285,2570356,4,1,1,1,5732
ad924745933c3e018e0d78282d9d085978b8cd2b,0,Mark Payne,2016-11-11 15:45:40-05:00,['41f519e84cb5d0bf8be4ce93e26a042d16cda273'],0,24,24,2570380,1,0,1,1,5732
13ea909122a39f36b7c63effabca0fe8a43298aa,0,Andy LoPresto,2016-11-14 00:44:16-08:00,['ad924745933c3e018e0d78282d9d085978b8cd2b'],1,1,2,2570382,1,,,,5732
8d3177c38a4fed3b7040f03d17f28b1fc76525d8,0,Oleg Zhurakousky,2016-11-14 09:33:55-05:00,['13ea909122a39f36b7c63effabca0fe8a43298aa'],1,1,2,2570384,1,,,,5732
65b7b377e3072b83f75e63b053a4f080726d824d,1,Mark Payne,2016-11-14 12:04:21-05:00,['8d3177c38a4fed3b7040f03d17f28b1fc76525d8'],1,243,244,2570628,7,0.314285714,0,0.314285714,5736
b0f6825e09caa94b0aa03b9c9611ec3f5ce0ac7b,0,Mark Payne,2016-11-14 12:35:18-05:00,['65b7b377e3072b83f75e63b053a4f080726d824d'],0,0,0,2570628,0,,,,5736
2c91a1a33d2d085f50ac25addffd2981af347551,1,Scott Aslan,2016-11-14 16:03:47-05:00,['b0f6825e09caa94b0aa03b9c9611ec3f5ce0ac7b'],2,2,4,2570632,1,,,,5736
ae4f27a627a14960d764aa330424745263edde8b,0,Scott Aslan,2016-11-14 16:23:36-05:00,['2c91a1a33d2d085f50ac25addffd2981af347551'],10,2,12,2570644,1,0,0,0,5736
7e237341810763ed4631fec8f568c04d8f928788,1,Bryan Rosander,2016-11-14 16:59:24-05:00,['ae4f27a627a14960d764aa330424745263edde8b'],16,16,32,2570676,4,,,,5736
4d1bcc808f5c75a7b7bb3a42d79b5a8f28c44d4f,0,Bryan Rosander,2016-11-14 17:50:32-05:00,['7e237341810763ed4631fec8f568c04d8f928788'],18,325,343,2571019,7,1,1,1,5738
a347ebf87b509d54b3fd2aac33f202920b59a4b6,0,joewitt,2016-11-14 21:04:12-05:00,['4d1bcc808f5c75a7b7bb3a42d79b5a8f28c44d4f'],3,764,767,2571786,11,0.453781513,0.453781513,1,5743
8ad31251687d492639bc6e1a8cf2dea85316b869,1,joewitt,2016-11-14 21:04:33-05:00,['a347ebf87b509d54b3fd2aac33f202920b59a4b6'],427,126,553,2572339,5,,,,5743
59fea1cb4ed440ad0e68d96a412792c3e4551309,1,Yolanda M. Davis,2016-11-14 22:39:06-05:00,['8ad31251687d492639bc6e1a8cf2dea85316b869'],91,2418,2509,2574848,24,0.96,0.96,1,5755
8f928e5d6e9701646947ad43ef0a42b461661cc8,1,Mark Payne,2016-11-15 09:58:58-05:00,['59fea1cb4ed440ad0e68d96a412792c3e4551309'],123,923,1046,2575894,36,0.569014085,0.692957746,0.766197183,5759
ef2c50577dd07a7850c06d5d0666152590ac5fd7,1,Matt Burgess,2016-11-15 11:48:33-05:00,['8f928e5d6e9701646947ad43ef0a42b461661cc8'],1,3,4,2575898,1,0,0,1,5759
97cd94d260716011a1a0225387c2a0970658ec2a,1,Matt Burgess,2016-11-15 11:48:50-05:00,['ef2c50577dd07a7850c06d5d0666152590ac5fd7'],2,3,5,2575903,1,0,0,1,5759
45bf8430fc035b34c20df165f8976e2bbc16140c,0,Matt Gilman,2016-11-15 11:55:42-05:00,['97cd94d260716011a1a0225387c2a0970658ec2a'],76,171,247,2576150,8,0,1,1,5759
76b859c4efbf621066be4e4e8bb14efd8be6b818,0,Matt Gilman,2016-11-15 16:10:46-05:00,['45bf8430fc035b34c20df165f8976e2bbc16140c'],11,18,29,2576179,25,,,,5760
45bc3e054d3c241e6abf79fc1dfe4bf22ae90a6f,0,Mark Payne,2016-11-15 16:19:00-05:00,['76b859c4efbf621066be4e4e8bb14efd8be6b818'],0,4,4,2576183,1,0,1,1,5760
3c694b641e3a85a55e0b09e7020d5d3cda75ac10,0,Mark Payne,2016-11-15 16:19:28-05:00,['45bc3e054d3c241e6abf79fc1dfe4bf22ae90a6f'],0,0,0,2576183,0,,,,5760
fe59b3415c0215a9a4eb01c32838c5dbb584c009,1,Oleg Zhurakousky,2016-11-15 16:23:27-05:00,['3c694b641e3a85a55e0b09e7020d5d3cda75ac10'],203,319,522,2576705,13,0.304347826,0.623188406,0.927536232,5760
2614b8354319a9b54264d26b072eb8ef340fd9b8,0,joewitt,2016-11-15 16:31:10-05:00,['fe59b3415c0215a9a4eb01c32838c5dbb584c009'],2,2,4,2576709,2,,,,5760
9f3bf121f989765e630da4c7c46e1100fb40a248,1,Oleg Zhurakousky,2016-11-15 16:37:51-05:00,['2614b8354319a9b54264d26b072eb8ef340fd9b8'],1,2,3,2576712,1,0,0,1,5760
81357d4456037aa081a5ed76d146299a78bc2449,0,Matt Gilman,2016-11-15 16:43:27-05:00,['9f3bf121f989765e630da4c7c46e1100fb40a248'],2,2,4,2576716,2,,,,5760
721964b7d87c696f293f7c769b274fc6364ff034,1,jpercivall,2016-11-15 16:51:34-05:00,['81357d4456037aa081a5ed76d146299a78bc2449'],5,33,38,2576754,3,0.555555556,0,1,5760
1c9077334f8672e10d765b5346b0282fec06126c,1,jpercivall,2016-11-15 18:09:09-05:00,['721964b7d87c696f293f7c769b274fc6364ff034'],10,17,27,2576781,4,,,,5760
6696529c99b5b564b076e4012abff3a54755370b,0,jpercivall,2016-11-15 18:09:14-05:00,['1c9077334f8672e10d765b5346b0282fec06126c'],492,0,492,2577273,8,0.285714286,0,0,5760
b026f0bebe737aa62ab7de48a776d851807b1350,1,jpercivall,2016-11-15 18:09:27-05:00,['6696529c99b5b564b076e4012abff3a54755370b'],14,4,18,2577291,4,,,,5760
26a5881d21d4187abd5ec8a47895bbdf7c914857,1,Oleg Zhurakousky,2016-11-15 19:34:59-05:00,['b026f0bebe737aa62ab7de48a776d851807b1350'],0,4019,4019,2581310,54,0.460546282,0.92185129,0.913505311,5811
3e571f9f1fe5ae4d58ed829a0d1e823a7a97d368,0,joewitt,2016-11-15 22:42:21-05:00,['26a5881d21d4187abd5ec8a47895bbdf7c914857'],1,6,7,2581317,1,,,,5811
45a5f5295c611625cac700412630c16de2270b27,0,joewitt,2016-11-15 23:18:55-05:00,['3e571f9f1fe5ae4d58ed829a0d1e823a7a97d368'],3,6,9,2581326,4,,,,5811
49afacc3abf810aafbd10398ea243fce1da7cc4e,1,Mark Payne,2016-11-16 10:13:18-05:00,['45a5f5295c611625cac700412630c16de2270b27'],7,32,39,2581365,2,0,1,1,5811
2f9ec03242546dcae694ac0effa52d9185850af7,1,Matt Burgess,2016-11-16 11:34:52-05:00,['49afacc3abf810aafbd10398ea243fce1da7cc4e'],7,98,105,2581470,3,0.052631579,0.842105263,1,5811
31ea50bce9c2faa012a47f05218b74db99b5d197,1,Oleg Zhurakousky,2016-11-16 12:17:37-05:00,['2f9ec03242546dcae694ac0effa52d9185850af7'],6,688,694,2582164,9,,,,5817
2c135c44f27478c4c151b9b347d3ee98d6921181,0,Pierre Villard,2016-11-16 20:58:10+01:00,['31ea50bce9c2faa012a47f05218b74db99b5d197'],15,24,39,2582203,11,,,,5821
f1eca0a09a887620da4251468178ee3a3e56faf5,0,Matt Burgess,2016-11-16 15:30:47-05:00,['2c135c44f27478c4c151b9b347d3ee98d6921181'],0,88,88,2582291,3,,,,5821
878db823754d647dadb0d5fa16a4b0b7be76bda0,0,Matt Gilman,2016-11-16 17:08:06-05:00,['f1eca0a09a887620da4251468178ee3a3e56faf5'],18,25,43,2582334,2,0,0,1,5821
fa13832a9c07b20e968efc5d8baf7e7e09e1a7b1,0,Andy LoPresto,2016-11-16 15:33:11-08:00,['878db823754d647dadb0d5fa16a4b0b7be76bda0'],108,63,171,2582505,8,1,1,1,5822
e5eda6370510337a1660008f80bf7ebf4a0ba288,1,Andy LoPresto,2016-11-16 17:13:10-08:00,['fa13832a9c07b20e968efc5d8baf7e7e09e1a7b1'],101,403,504,2583009,28,0.734265734,0.93006993,0.874125874,5824
c4be800688bf23a3bdea8def75b84c0f4ded243d,1,Oleg Zhurakousky,2016-11-17 07:27:51-05:00,['e5eda6370510337a1660008f80bf7ebf4a0ba288'],11,141,152,2583161,10,0.591836735,0.591836735,0.918367347,5825
06d7ecd324ff8c352c512f3f4709f77786f46325,1,Oleg Zhurakousky,2016-11-17 18:24:58-05:00,['c4be800688bf23a3bdea8def75b84c0f4ded243d'],5,37,42,2583203,3,0.5,0.5,1,5825
7206318ecfb3ae973059bb850a2a7d87134bd0c4,0,Koji Kawamura,2016-11-18 11:06:20+09:00,['06d7ecd324ff8c352c512f3f4709f77786f46325'],1,50,51,2583254,2,0.696969697,0,1,5825
8568d40cd80ad12a258fbee498b733b78428a608,0,Andy LoPresto,2016-11-18 01:12:00-08:00,['7206318ecfb3ae973059bb850a2a7d87134bd0c4'],161,325,486,2583740,7,,,,5826
5a25884f52e92b3c73f425a1dd6c0993866b1b8f,0,Scott Aslan,2016-11-18 14:05:17-05:00,['8568d40cd80ad12a258fbee498b733b78428a608'],0,0,0,2583740,6,,,,5826
1be08714731f01347ac1f98e18047fe7d9ab8afd,1,Oleg Zhurakousky,2016-11-18 14:53:13-05:00,['5a25884f52e92b3c73f425a1dd6c0993866b1b8f'],2084,7671,9755,2593495,85,0.363558597,0.757912746,0.758340462,5881
c8830742eee4470b371246ec9bf14d2fea5fa522,1,Oleg Zhurakousky,2016-11-19 08:38:41-05:00,['1be08714731f01347ac1f98e18047fe7d9ab8afd'],31,102,133,2593628,6,0.214285714,0.357142857,1,5882
e731f0957369f695c46acc8ab4b0c487b4d6bf71,0,Koji Kawamura,2016-11-21 10:30:28+09:00,['c8830742eee4470b371246ec9bf14d2fea5fa522'],1,1,2,2593630,1,,,,5882
2ee66de1a6f9afb495c6e6565f4d4ba9cff68f88,0,Oleg Zhurakousky,2016-11-21 11:34:14-05:00,['e731f0957369f695c46acc8ab4b0c487b4d6bf71'],1,27,28,2593658,2,1,1,1,5882
d65f46f7a5d03a4b2e979117e740e43017ed675c,1,Matt Burgess,2016-11-21 12:58:17-05:00,['2ee66de1a6f9afb495c6e6565f4d4ba9cff68f88'],12,197,209,2593867,2,0.034246575,0.842465753,0.849315068,5882
7e7739819a2f5add34e1fd6f632f1977e4920cb2,0,Bryan Bende,2016-11-21 13:37:57-05:00,['d65f46f7a5d03a4b2e979117e740e43017ed675c'],2,94,96,2593963,1,,,,5882
eb5abf809d04ca44f8c426dbfd5ade545688c892,0,Bryan Bende,2016-11-21 14:21:22-05:00,['7e7739819a2f5add34e1fd6f632f1977e4920cb2'],0,19,19,2593982,1,0.166666667,0,1,5882
7f5eabd603bfc326dadc35590bbe69304e8c90fa,1,Andy LoPresto,2016-11-21 12:07:48-08:00,['eb5abf809d04ca44f8c426dbfd5ade545688c892'],376,1211,1587,2595569,70,0.714723926,0.987730061,0.889570552,5886
dba9d5924a29d42f9f914320f6215a1849bbb54f,1,jpercivall,2016-11-21 15:58:40-05:00,['7f5eabd603bfc326dadc35590bbe69304e8c90fa'],6,2958,2964,2598533,20,0.211283186,0.723451327,0.894911504,5899
fb9cbccc381d12594222566cba56826792f69414,1,joewitt,2016-11-21 16:30:42-05:00,['dba9d5924a29d42f9f914320f6215a1849bbb54f'],896,2755,3651,2602184,90,0.693069307,0.405940594,0,5907
15af764dd8ad8c4a6789c556635e817a2a553828,1,Matt Gilman,2016-11-21 17:02:25-05:00,['fb9cbccc381d12594222566cba56826792f69414'],70,115,185,2602369,7,0.870967742,0.193548387,1,5907
ead92054584b67289a2d80565c352355947a9c15,0,Matt Gilman,2016-11-21 17:27:03-05:00,['15af764dd8ad8c4a6789c556635e817a2a553828'],13,4,17,2602386,2,0.083333333,0,0,5907
aa99cc68224f104ad13396e2102126db6332e5c7,1,Bryan Bende,2016-11-22 11:26:22-05:00,['ead92054584b67289a2d80565c352355947a9c15'],4,6,10,2602396,1,0,0,0,5907
9e884f61208c2d732847007219d7da7f681a0888,0,Matt Burgess,2016-11-22 11:49:25-05:00,['aa99cc68224f104ad13396e2102126db6332e5c7'],2,36,38,2602434,3,0,1,1,5907
fa5fed9bb59eb485e48dd7350bf693a3039307ef,0,Pierre Villard,2016-11-22 21:32:03+01:00,['9e884f61208c2d732847007219d7da7f681a0888'],4,19,23,2602457,2,0,0.571428571,1,5907
36796b544007c7dc6f114be10718a7a8ce87bef5,1,Pierre Villard,2016-11-22 21:42:36+01:00,['fa5fed9bb59eb485e48dd7350bf693a3039307ef'],0,424,424,2602881,4,0.767195767,1,0.968253968,5911
d5387679d1a534cce29a814fde09a409248d581e,0,Pierre Villard,2016-11-22 21:55:10+01:00,['36796b544007c7dc6f114be10718a7a8ce87bef5'],2,0,2,2602883,1,,,,5911
78fed3ed561b145e5c4043e1a4398485d7f639f7,1,Bryan Bende,2016-11-22 16:41:44-05:00,['d5387679d1a534cce29a814fde09a409248d581e'],0,2,2,2602885,1,,,,5911
913ae91614b25dfd3fd668c475acd712d00de5a2,0,jpercivall,2016-11-22 17:11:25-05:00,['78fed3ed561b145e5c4043e1a4398485d7f639f7'],0,14,14,2602899,1,0,1,1,5911
50667ed2225fe3f5b1461f1a48db32d5f637009a,0,Mark Payne,2016-11-22 17:31:47-05:00,['913ae91614b25dfd3fd668c475acd712d00de5a2'],0,3,3,2602902,2,0,0.5,0.5,5911
066accc274540bb2bfd392cffd1e86bb9ff48bb0,1,jpercivall,2016-11-23 00:01:12-05:00,['50667ed2225fe3f5b1461f1a48db32d5f637009a'],31,63,94,2602996,2,0,0.785714286,0.785714286,5911
d3dbac50a8f354503838e5a0bdf22872d878b078,0,joewitt,2016-11-23 08:11:49-05:00,['066accc274540bb2bfd392cffd1e86bb9ff48bb0'],11,15,26,2603022,2,0,0,1,5911
7fc7494b2174340a3caa0292b4a54859eaf16a34,1,joewitt,2016-11-23 08:22:34-05:00,['d3dbac50a8f354503838e5a0bdf22872d878b078'],13,25,38,2603060,2,0,1,1,5911
22143e386d07761ca92b7cb889ec8c11d7d130e9,0,joewitt,2016-11-23 10:21:41-05:00,['7fc7494b2174340a3caa0292b4a54859eaf16a34'],19,52,71,2603131,4,,,,5911
91ff810dbae71ac9d49bb5bcb0ef6b7c8dac8036,1,jpercivall,2016-11-23 11:27:14-05:00,['22143e386d07761ca92b7cb889ec8c11d7d130e9'],4,29,33,2603164,4,0.578947368,0.684210526,1,5911
7ff14f7191f8bbb1722340ccdd963d3e7d24b9e4,0,jpercivall,2016-11-23 12:07:44-05:00,['91ff810dbae71ac9d49bb5bcb0ef6b7c8dac8036'],1,61,62,2603226,2,0.97826087,0.97826087,1,5911
cdb9b81f4283052f6626a96e31e44c7da11d25a8,0,joewitt,2016-11-23 15:00:40-05:00,['7ff14f7191f8bbb1722340ccdd963d3e7d24b9e4'],4,4,8,2603234,4,,,,5911
2c3714536fc516fc1712dac2a7a9ccd855e6f25b,0,Andy LoPresto,2016-11-23 13:26:18-08:00,['cdb9b81f4283052f6626a96e31e44c7da11d25a8'],83,1960,2043,2605277,13,0.375,0.375,1,5917
1b2b9f136df73a8b0d5d21419b6ebc2206f78393,0,Andy LoPresto,2016-11-23 15:12:05-08:00,['2c3714536fc516fc1712dac2a7a9ccd855e6f25b'],103,46,149,2605426,2,,,,5917
f4f60c3610b5a408fcf85d396d005cd7487e1b20,1,joewitt,2016-11-25 19:33:48-05:00,['1b2b9f136df73a8b0d5d21419b6ebc2206f78393'],0,13,13,2605439,1,,,,5917
617b62ac7ab9a8959e749804bca78f22bf4b899b,0,joewitt,2016-11-25 19:39:36-05:00,['f4f60c3610b5a408fcf85d396d005cd7487e1b20'],239,0,239,2605678,3,1,0,0,5917
a1ab5e844bfabfbbb41da393c10952a25b0fa0da,1,joewitt,2016-11-25 19:41:15-05:00,['617b62ac7ab9a8959e749804bca78f22bf4b899b'],48,83,131,2605809,1,0.727272727,0.090909091,1,5917
29265815d1d28b5c2974a6da18c42afd82b8edec,0,joewitt,2016-11-25 22:11:01-05:00,['a1ab5e844bfabfbbb41da393c10952a25b0fa0da'],21,35,56,2605865,1,,,,5917
f61e42c65e1c2387591ee368c2148cd5bda646bd,0,joewitt,2016-11-25 23:34:47-05:00,['29265815d1d28b5c2974a6da18c42afd82b8edec'],35,21,56,2605921,1,,,,5917
5536f690a81418955442d52687695f65f0a44cd0,1,joewitt,2016-11-25 23:49:13-05:00,['f61e42c65e1c2387591ee368c2148cd5bda646bd'],504,502,1006,2606927,253,,,,5917
92f17a995b7c6b7aaaa63a55974fffda00780c56,1,joewitt,2016-11-25 23:49:27-05:00,['5536f690a81418955442d52687695f65f0a44cd0'],497,497,994,2607921,253,,,,5917
9d6ca6e1e60e604852cb3ad46eba6d58189b0864,0,Bryan Bende,2016-11-29 09:54:15-05:00,['92f17a995b7c6b7aaaa63a55974fffda00780c56'],1,5,6,2607927,1,0,0,1,5917
e3c7611347a57df1e50ce495efb4fc5d777ba4f6,1,Andy LoPresto,2016-11-29 17:32:47-08:00,['9d6ca6e1e60e604852cb3ad46eba6d58189b0864'],1,1,2,2607929,1,,,,5917
bc223fa197ae0d49f7f8cead3a4acc6c6a1cb023,1,Bryan Bende,2016-11-30 12:50:25-05:00,['e3c7611347a57df1e50ce495efb4fc5d777ba4f6'],267,475,742,2608671,11,1,1,0,5917
ba513447d75dc5e95ddcdfcac1a1fefe2eb175ce,1,Bryan Bende,2016-11-30 13:05:38-05:00,['bc223fa197ae0d49f7f8cead3a4acc6c6a1cb023'],1,38,39,2608710,2,0,1,1,5917
fff0148a0e057277b34e647ef31c441ed5b4bdc3,1,Matt Gilman,2016-11-30 13:07:51-05:00,['ba513447d75dc5e95ddcdfcac1a1fefe2eb175ce'],7,20,27,2608737,2,0,0.571428571,0,5917
1f40f298c0a27518939b3cc38875241a9b6b73fa,0,Bryan Bende,2016-11-30 14:13:43-05:00,['fff0148a0e057277b34e647ef31c441ed5b4bdc3'],3,3,6,2608743,2,,,,5917
02f02b245a3704666b2e2951c8d29277538d9f25,0,Matt Gilman,2016-11-30 14:51:28-05:00,['1f40f298c0a27518939b3cc38875241a9b6b73fa'],30,24,54,2608797,3,0.25,0,0.25,5917
0297352350aab3585951ccddbe2edd059cad755c,0,Bryan Bende,2016-12-01 14:02:05-05:00,['02f02b245a3704666b2e2951c8d29277538d9f25'],6,6,12,2608809,1,,,,5917
893f87a3897694da0e635d044034eed40ca7fff3,0,Scott Aslan,2016-12-01 15:43:20-05:00,['0297352350aab3585951ccddbe2edd059cad755c'],0,15,15,2608824,6,,,,5921
afe742700c09fad1be5346f36759ce1d068ee202,0,Andy LoPresto,2016-12-01 22:52:42-08:00,['893f87a3897694da0e635d044034eed40ca7fff3'],1,1,2,2608826,13,,,,5921
8da38acf31688569bcc0a1d79c2f90d2e4e535d4,1,Oleg Zhurakousky,2016-12-02 07:53:04-05:00,['afe742700c09fad1be5346f36759ce1d068ee202'],0,122,122,2608948,2,0,0.236111111,1,5921
69b23adf1b0fdfb7e1e344c833adfbeb1f4980e5,1,jpercivall,2016-12-02 11:16:23-05:00,['8da38acf31688569bcc0a1d79c2f90d2e4e535d4'],126,371,497,2609445,15,0,0.810810811,1,5921
d8d29811f559b3ae293475a88d52a3c62f9681be,1,Bryan Bende,2016-12-02 12:55:23-05:00,['69b23adf1b0fdfb7e1e344c833adfbeb1f4980e5'],126,639,765,2610210,12,0.388888889,0.883838384,0.797979798,5923
7c5bd876bdd49ec14482a24dd31a073757f06ed4,1,Mark Payne,2016-12-02 14:01:39-05:00,['d8d29811f559b3ae293475a88d52a3c62f9681be'],306,785,1091,2611301,37,0.420074349,0.80669145,1,5925
316cae16d310f6131852e158f8ab274249f0ecc3,1,jpercivall,2016-12-02 14:10:52-05:00,['7c5bd876bdd49ec14482a24dd31a073757f06ed4'],6,46,52,2611353,2,0.75,1,0.928571429,5925
c5ef0767864b90ee9a013a60405c08ce6192d2bc,0,Andy LoPresto,2016-12-02 12:41:03-08:00,['316cae16d310f6131852e158f8ab274249f0ecc3'],64,200,264,2611617,5,0.66,0.66,0.82,5926
bfe91db85707a7cd00c2b9a79340c24cdcfd8c5e,0,Andy LoPresto,2016-12-02 12:49:14-08:00,['c5ef0767864b90ee9a013a60405c08ce6192d2bc'],22,26,48,2611665,20,,,,5926
8f8b8cdf464642e46e3cdda623c80047d079b921,1,Mark Payne,2016-12-05 09:29:19-05:00,['bfe91db85707a7cd00c2b9a79340c24cdcfd8c5e'],1269,59,1328,2612993,10,0.384428224,0.386861314,0.01703163,5926
f0f75e74803c16eb571d5e7dffaac7c7ccc532d1,1,Matt Burgess,2016-12-05 11:04:33-05:00,['8f8b8cdf464642e46e3cdda623c80047d079b921'],47,168,215,2613208,2,0.075,1,1,5926
2b6d6c25d8a35625697d98b4827a6badfb8e2f69,0,Matt Burgess,2016-12-05 12:50:43-05:00,['f0f75e74803c16eb571d5e7dffaac7c7ccc532d1'],3,3,6,2613214,2,,,,5926
7633fe35c1e73037b00e8d3a098546c6fde8d53c,0,Matt Burgess,2016-12-05 13:34:54-05:00,['2b6d6c25d8a35625697d98b4827a6badfb8e2f69'],40,48,88,2613302,3,0,1,1,5926
fc0d336f36a7ea8d6ba960eead48f4e7e41c070d,0,Bryan Bende,2016-12-05 16:07:54-05:00,['7633fe35c1e73037b00e8d3a098546c6fde8d53c'],2,5,7,2613309,1,0,1,1,5926
2d6bba080f90a45a9f4149f6844f452150ed6bc1,1,jpercivall,2016-12-05 19:45:45-05:00,['fc0d336f36a7ea8d6ba960eead48f4e7e41c070d'],219,417,636,2613945,25,0.013333333,0.273333333,0.793333333,5926
78de10dec0127598fbbbb8ac7f7048cec3aecb6b,0,Bryan Rosander,2016-12-05 22:06:00-05:00,['2d6bba080f90a45a9f4149f6844f452150ed6bc1'],1,35,36,2613981,1,0,0,0.296296296,5926
d1f2492dec386228432dc3374d26944c8bef501e,0,Bryan Rosander,2016-12-05 22:16:24-05:00,['78de10dec0127598fbbbb8ac7f7048cec3aecb6b'],7,9,16,2613997,5,,,,5926
97d2d30423b023abdf9c582d4590ddc8fe41a4d8,0,Bryan Rosander,2016-12-05 23:03:41-05:00,['d1f2492dec386228432dc3374d26944c8bef501e'],8,4,12,2614009,7,,,,5926
e36b37692c528b2e9774f9f49737eb2d1a05960f,1,Matt Burgess,2016-12-06 16:52:02-05:00,['97d2d30423b023abdf9c582d4590ddc8fe41a4d8'],131,819,950,2614959,19,0.283887468,0.797953964,0.831202046,5928
6b82e25c74431bd6f1407e4dffb5cab904ee7ef8,1,Matt Gilman,2016-12-07 16:42:19-05:00,['e36b37692c528b2e9774f9f49737eb2d1a05960f'],1,1,2,2614961,1,,,,5928
9ce0af22afa1f6e2c1c75e31aa9740727054a287,0,Koji Kawamura,2016-12-08 14:37:07+09:00,['6b82e25c74431bd6f1407e4dffb5cab904ee7ef8'],1,7,8,2614969,1,,,,5928
d15bd0c00c665f2d692efc96b7c251f962619aff,0,Matt Gilman,2016-12-08 08:34:07-05:00,['9ce0af22afa1f6e2c1c75e31aa9740727054a287'],4,6,10,2614979,1,0.5,0.5,1,5928
2c84b44f54181871a9f987a9319225659583712d,0,Matt Gilman,2016-12-08 12:52:01-05:00,['d15bd0c00c665f2d692efc96b7c251f962619aff'],42,40,82,2615061,8,,,,5928
d701cd8364d89d2369087e428162abed1b916426,0,Bryan Bende,2016-12-12 09:25:15-05:00,['2c84b44f54181871a9f987a9319225659583712d'],0,0,0,2615061,4,,,,5932
32e1603bd6950c13727dc596d09ae150676eeba7,1,Bryan Bende,2016-12-12 09:30:38-05:00,['d701cd8364d89d2369087e428162abed1b916426'],0,2,2,2615063,1,,,,5932
45e4514a40c75128aaa09ac8f64a7a4efd69296e,0,Matt Gilman,2016-12-12 11:45:10-05:00,['32e1603bd6950c13727dc596d09ae150676eeba7'],2,1,3,2615066,1,,,,5932
868795cdaafbbba75432bcc2ec7e88110722db56,0,Matt Gilman,2016-12-13 09:41:31-05:00,['45e4514a40c75128aaa09ac8f64a7a4efd69296e'],12,17,29,2615095,1,0,1,1,5932
266bd80bde15abb72e316c2386b4664c7c58a1e6,0,Matt Burgess,2016-12-13 11:30:24-05:00,['868795cdaafbbba75432bcc2ec7e88110722db56'],0,3,3,2615098,1,0,0,1,5932
e59cf8665660507e3e53edbc480b76be48595a62,0,Koji Kawamura,2016-12-14 10:57:11+09:00,['266bd80bde15abb72e316c2386b4664c7c58a1e6'],0,34,34,2615132,1,0,1,1,5932
0f462a7c4907cb7bd03b7e2005692389bba15986,0,Matt Burgess,2016-12-14 10:51:27-05:00,['e59cf8665660507e3e53edbc480b76be48595a62'],0,63,63,2615195,2,0,0.85,1,5932
5776c4b1f99df4662dd878c8183a8c03e6861cd2,1,jpercivall,2016-12-14 14:10:59-05:00,['0f462a7c4907cb7bd03b7e2005692389bba15986'],11,85,96,2615291,1,0,0,0,5932
ab2d07aa5a9cf0f766b437ca5617e9e878751399,0,Bryan Bende,2016-12-15 12:56:23-05:00,['5776c4b1f99df4662dd878c8183a8c03e6861cd2'],0,29,29,2615320,2,0.142857143,1,1,5932
9a5986b0f6f1e44d04be5569206ca1992759073a,1,Pierre Villard,2016-12-15 22:43:15+01:00,['ab2d07aa5a9cf0f766b437ca5617e9e878751399'],3,27,30,2615350,2,0,1,0.777777778,5932
34627f78b7816f5c0cf9d919787408aefb204545,1,Bryan Bende,2016-12-16 10:29:16-05:00,['9a5986b0f6f1e44d04be5569206ca1992759073a'],0,1079,1079,2616429,7,0.616591928,0.769058296,0.901345291,5938
21ed556691719c592df89f36f0ccec26364e3997,1,jpercivall,2016-12-16 15:13:01-05:00,['34627f78b7816f5c0cf9d919787408aefb204545'],6,112,118,2616547,6,0.828571429,0.828571429,0.685714286,5939
aef17f9a8b5d9ce336f208987655134b59004b9a,0,Matt Gilman,2016-12-19 10:07:15-05:00,['21ed556691719c592df89f36f0ccec26364e3997'],9,16,25,2616572,2,1,1,0,5939
3b916353983a547e03ca79f4c7d0f01831c326b4,0,jpercivall,2016-12-19 14:51:41-05:00,['aef17f9a8b5d9ce336f208987655134b59004b9a'],26,58,84,2616656,2,0,0.769230769,1,5939
445c075963422e9dd2eccb634dd5065a5fbd5230,0,Aldrin Piri,2016-12-20 11:18:06-05:00,['3b916353983a547e03ca79f4c7d0f01831c326b4'],1,1,2,2616658,1,,,,5939
00149603c81593b502f8527f9b1d4c247499f60a,0,jpercivall,2016-12-20 17:41:08-05:00,['445c075963422e9dd2eccb634dd5065a5fbd5230'],2,2,4,2616662,1,,,,5939
721c9ee7f0095fee547bd3d384ffb94b82aa629f,1,Yolanda M. Davis,2016-12-21 12:02:44-05:00,['00149603c81593b502f8527f9b1d4c247499f60a'],43,26,69,2616731,4,0.125,0.25,1,5939
42851576759fdba9de19b24f1ca102cf53cbc4a0,0,Bryan Bende,2016-12-21 16:29:23-05:00,['721c9ee7f0095fee547bd3d384ffb94b82aa629f'],71,85,156,2616887,1,1,1,1,5939
44c9ea0a660b5d3ee9551307a6b83249f4e8491c,0,Koji Kawamura,2016-12-22 15:22:53+09:00,['42851576759fdba9de19b24f1ca102cf53cbc4a0'],20,19,39,2616926,1,1,1,0,5939
28e5d85493e43a6df7ec7f39657373734cb162ed,0,Bryan Bende,2016-12-22 10:59:55-05:00,['44c9ea0a660b5d3ee9551307a6b83249f4e8491c'],0,6,6,2616932,1,0,0,1,5939
f7d761a28ae3a07cb8e614e243e197716df025b1,1,Bryan Bende,2016-12-22 10:59:56-05:00,['28e5d85493e43a6df7ec7f39657373734cb162ed'],13,77,90,2617022,5,0.352941176,1,0.235294118,5940
908e7d3131908671d7e7df4b4aa4a29a9ec91694,1,Bryan Bende,2016-12-22 11:00:00-05:00,['f7d761a28ae3a07cb8e614e243e197716df025b1'],272,308,580,2617602,6,0,0.647058824,1,5940
acc9e0b45ca726a6dc5f4725336a5d6d1fb9ff5d,0,Scott Aslan,2016-12-22 11:52:20-05:00,['908e7d3131908671d7e7df4b4aa4a29a9ec91694'],3,12,15,2617617,3,1,1,1,5940
e65aad8fe61a806540d13a91e06bfdf22c51bf2f,0,Yolanda M. Davis,2016-12-22 14:39:56-05:00,['acc9e0b45ca726a6dc5f4725336a5d6d1fb9ff5d'],1,127,128,2617745,9,0,0,0,5940
5ea17d30c5858fd9e56498e01a6cbd9fa3423c73,0,Matt Gilman,2016-12-22 16:47:34-05:00,['e65aad8fe61a806540d13a91e06bfdf22c51bf2f'],140,353,493,2618238,5,0.658119658,0.538461538,1,5940
6ca25e10ef05d94a5650e92f951ea04d053d03ad,1,Koji Kawamura,2016-12-26 15:41:24+09:00,['5ea17d30c5858fd9e56498e01a6cbd9fa3423c73'],28,139,167,2618405,5,0.28125,0.640625,1,5940
6c5d4084d586698575a75ee11b4407e4257254b4,0,Koji Kawamura,2016-12-27 15:44:25+09:00,['6ca25e10ef05d94a5650e92f951ea04d053d03ad'],9,7,16,2618421,1,1,1,1,5940
af8ed8b7de4580ddcf48dbdd8227124d0fe93200,0,Aldrin Piri,2016-12-27 12:19:08-05:00,['6c5d4084d586698575a75ee11b4407e4257254b4'],1,1,2,2618423,1,,,,5940
978f483ba84b323674fc0134660bed2ee30da079,0,Aldrin Piri,2016-12-27 12:52:01-05:00,['af8ed8b7de4580ddcf48dbdd8227124d0fe93200'],6,62,68,2618491,2,0,0.967741935,1,5940
2f3017638f39fb6f30ccecc56aad04d31a7ab68f,0,Aldrin Piri,2016-12-27 13:06:07-05:00,['978f483ba84b323674fc0134660bed2ee30da079'],3,7,10,2618501,2,0.666666667,1,1,5940
2ea8b4122b342de39388f0f71769b77b59c57617,0,Koji Kawamura,2016-12-28 11:21:44+09:00,['2f3017638f39fb6f30ccecc56aad04d31a7ab68f'],4,32,36,2618537,2,0.909090909,0.909090909,1,5940
16898668c26c6445e2454a844a638858b4bff000,0,James Wing,2016-12-28 10:54:21-08:00,['2ea8b4122b342de39388f0f71769b77b59c57617'],1,3,4,2618541,1,0,0,1,5940
35e8bedcc878ceb67638a50ff6c2506a7bb92c75,1,jpercivall,2016-12-28 14:54:05-05:00,['16898668c26c6445e2454a844a638858b4bff000'],46,75,121,2618662,2,0,0,0,5940
5c095f3a184ec7dffe28581b395f8518f0032cda,0,James Wing,2016-12-28 14:10:30-08:00,['35e8bedcc878ceb67638a50ff6c2506a7bb92c75'],0,1,1,2618663,1,0,0,1,5940
4986b83b8317fff90c80c4068fead1b09db519fc,0,James Wing,2016-12-29 10:29:03-08:00,['5c095f3a184ec7dffe28581b395f8518f0032cda'],0,3,3,2618666,1,0,0,1,5940
8acbe9aa3f72c4da3cc5d19f9827718b2ce8cc56,1,Bryan Rosander,2016-12-29 15:49:52-05:00,['4986b83b8317fff90c80c4068fead1b09db519fc'],92,312,404,2619070,3,0,0.815789474,1,5940
0d14db72f52005e5da3b01582ec8594ed9686226,0,Pierre Villard,2016-12-30 16:05:06+01:00,['8acbe9aa3f72c4da3cc5d19f9827718b2ce8cc56'],6,9,15,2619085,2,1,1,1,5940
55f4716f3d2bed47f422251c97155abcf197a480,1,Pierre Villard,2016-12-30 16:35:46+01:00,['0d14db72f52005e5da3b01582ec8594ed9686226'],18,194,212,2619297,2,0.707865169,0.707865169,1,5941
67cbef5df33ec3194f8086589911398d9d57b4b1,0,Andy LoPresto,2017-01-02 16:32:05-08:00,['55f4716f3d2bed47f422251c97155abcf197a480'],2,17,19,2619316,2,0.5,0.5,1,5941
be6bcf20adea6798c528a2e3b8824b48a5a9772e,0,Andy LoPresto,2017-01-02 20:25:03-08:00,['67cbef5df33ec3194f8086589911398d9d57b4b1'],9,72,81,2619397,3,0.179487179,1,1,5941
1b4729e448394177cddeccb700f9215d6ec7b570,1,Bryan Bende,2017-01-03 10:20:16-05:00,['be6bcf20adea6798c528a2e3b8824b48a5a9772e'],68,171,239,2619636,2,0.026666667,1,1,5941
9b47961d1c0dcc29f91c083e0affb99e1db07084,1,Bryan Bende,2017-01-03 12:09:19-05:00,['1b4729e448394177cddeccb700f9215d6ec7b570'],12,42,54,2619690,6,0.888888889,1,1,5941
2c0f1c348e15b35355ec2a1e2ff5503c331c7ad9,0,Bryan Bende,2017-01-03 16:18:53-05:00,['9b47961d1c0dcc29f91c083e0affb99e1db07084'],35,117,152,2619842,8,0.25,0.090909091,0.840909091,5941
41189b055f3f23010db5b1f410adc55d052805f2,0,Andy LoPresto,2017-01-03 15:31:15-08:00,['2c0f1c348e15b35355ec2a1e2ff5503c331c7ad9'],10,81,91,2619933,2,0,0.485714286,0.771428571,5941
b1c9f0e76428d69e7ee39448ef182ad0a23327ec,1,Bryan Bende,2017-01-04 13:06:19-05:00,['41189b055f3f23010db5b1f410adc55d052805f2'],100,400,500,2620433,29,0,0.479338843,0.599173554,5941
083d4043e06ce5bdab56131515e2213cf33fad67,0,Pierre Villard,2017-01-04 19:24:37+01:00,['b1c9f0e76428d69e7ee39448ef182ad0a23327ec'],0,9,9,2620442,1,1,1,1,5941
bba675a11dce4fe28617ef93a1c807aba77da200,1,Matt Burgess,2017-01-04 15:52:23-05:00,['083d4043e06ce5bdab56131515e2213cf33fad67'],2,26,28,2620470,2,0,0,1,5941
64bb55ef3c240ea11940757a96d92c609c1edc41,0,Matt Gilman,2017-01-05 09:07:35-05:00,['bba675a11dce4fe28617ef93a1c807aba77da200'],2,35,37,2620507,4,1,1,1,5941
7c956342037bfdc2afef9cc22a917d4494288ea4,0,Pierre Villard,2017-01-05 18:48:35+01:00,['64bb55ef3c240ea11940757a96d92c609c1edc41'],4,4,8,2620515,1,,,,5941
ac42178e9b133131eff2f91435d17e9efbf45efa,0,Pierre Villard,2017-01-05 18:51:40+01:00,['7c956342037bfdc2afef9cc22a917d4494288ea4'],1,1,2,2620517,1,,,,5941
68057cb4af3a0207671c2654eabbcbd07284a18e,1,Pierre Villard,2017-01-05 18:55:21+01:00,['ac42178e9b133131eff2f91435d17e9efbf45efa'],1,1,2,2620519,1,,,,5941
273e69f2cb833fd8cdcc99f70b8ab23fcc16d5f0,0,Pierre Villard,2017-01-05 19:59:58+01:00,['68057cb4af3a0207671c2654eabbcbd07284a18e'],8,58,66,2620585,3,0.4,0.7,0.9,5941
474df053d64deb0783cf02830f9092ca9d24edb2,1,Pierre Villard,2017-01-05 21:44:59+01:00,['273e69f2cb833fd8cdcc99f70b8ab23fcc16d5f0'],3,36,39,2620624,2,0.333333333,1,1,5941
3259b01f8ec2c1492c7acf3c9b9b29b8402dda6a,0,Pierre Villard,2017-01-05 22:19:25+01:00,['474df053d64deb0783cf02830f9092ca9d24edb2'],0,3,3,2620627,1,0,1,1,5941
970c46ccfe55ad37b9f83dff016df334838e5293,1,Andy LoPresto,2017-01-05 17:32:01-08:00,['3259b01f8ec2c1492c7acf3c9b9b29b8402dda6a'],0,44,44,2620671,2,0.129032258,1,0.870967742,5941
31ec01b5f9a78bf96eefb4990dd59202fcd6b5bd,1,Andy LoPresto,2017-01-05 17:32:11-08:00,['970c46ccfe55ad37b9f83dff016df334838e5293'],12,110,122,2620793,2,0.137254902,0.235294118,1,5941
675f4f544cb87bef0ec51b8dee5023088ad224ad,1,Andy LoPresto,2017-01-06 11:56:19-08:00,['31ec01b5f9a78bf96eefb4990dd59202fcd6b5bd'],250,886,1136,2621929,22,0.656,0.672,1,5948
47d7157412ff8235ba567bb2dbb8f6e6ca4d660e,0,Andy LoPresto,2017-01-06 17:55:27-08:00,['675f4f544cb87bef0ec51b8dee5023088ad224ad'],0,23,23,2621952,1,,,,5948
81aca7b97d04023a17772e89c68695d061140594,0,Matt Burgess,2017-01-09 10:40:29-05:00,['47d7157412ff8235ba567bb2dbb8f6e6ca4d660e'],3,2,5,2621957,1,,,,5948
1195d4c186ac1cba2e595c2068ea24d5f80fab19,1,Pierre Villard,2017-01-09 17:49:17+01:00,['81aca7b97d04023a17772e89c68695d061140594'],2,2,4,2621961,2,,,,5948
a794166d2170f68f18cda5b34a7e8bd3f22e5583,1,Pierre Villard,2017-01-09 18:09:25+01:00,['1195d4c186ac1cba2e595c2068ea24d5f80fab19'],23,42,65,2622026,3,0.5625,0.625,1,5948
c8f437e83315882e3c9204ec8d2f46fc7f3f8f06,1,Aldrin Piri,2017-01-10 13:24:33-05:00,['a794166d2170f68f18cda5b34a7e8bd3f22e5583'],1,292,293,2622319,9,,,,5956
2fbeabb95f3976637cc78bd818c65ce59fb253f3,0,Bryan Bende,2017-01-12 11:21:46-05:00,['c8f437e83315882e3c9204ec8d2f46fc7f3f8f06'],4,22,26,2622345,3,0.625,0.625,1,5956
4d533a99b3790ec842a7230fd6cae0d59158c2b5,1,Mike Moser,2017-01-12 21:43:12+00:00,['2fbeabb95f3976637cc78bd818c65ce59fb253f3'],4,52,56,2622401,2,0.107142857,0.785714286,1,5956
def4918af0fc448726f8725b6ea3bb8636310795,1,Bryan Rosander,2017-01-13 18:09:28-05:00,['4d533a99b3790ec842a7230fd6cae0d59158c2b5'],5,7,12,2622413,1,0,0,1,5956
9609dafc34f40178d30480a41288fe4a89c2eb79,0,afucs,2017-01-14 22:57:33+11:00,['def4918af0fc448726f8725b6ea3bb8636310795'],2,2,4,2622417,2,,,,5956
5b69c97f4157736c39b9d33e3beb43872979e2dc,0,Andre F de Miranda,2017-01-17 01:43:15+11:00,['9609dafc34f40178d30480a41288fe4a89c2eb79'],1,1,2,2622419,1,,,,5956
8c7539b20a08ae39345ee1cf73dccea792b2bd8a,1,Andre F de Miranda,2017-01-17 01:53:18+11:00,['5b69c97f4157736c39b9d33e3beb43872979e2dc'],2,2,4,2622423,2,,,,5956
ef54a8ec69b6b363eedd50944c48d5d013cf5ccc,1,Bryan Bende,2017-01-16 12:15:06-05:00,['8c7539b20a08ae39345ee1cf73dccea792b2bd8a'],86,682,768,2623191,18,0.3728223,0.923344948,0.672473868,5959
3bb876eb835499845e66848e815cd166b683232c,1,Koji Kawamura,2017-01-17 10:36:47+09:00,['ef54a8ec69b6b363eedd50944c48d5d013cf5ccc'],21,68,89,2623280,6,0,0,0.454545455,5959
ad98ac179f69bc938ac4c972548a6fa205074fe7,0,Bryan Bende,2017-01-17 13:29:59-05:00,['3bb876eb835499845e66848e815cd166b683232c'],1,1,2,2623282,1,,,,5959
6170f6442ed45dd084617cb4f39085640f49ebc5,0,Scott Aslan,2017-01-17 14:54:59-05:00,['ad98ac179f69bc938ac4c972548a6fa205074fe7'],7706,628,8334,2631616,90,0.396864282,0.33137351,0.082965866,5959
82cf0c6fa87ff8e5057b94020ca935daa4381289,0,Scott Aslan,2017-01-17 15:42:34-05:00,['6170f6442ed45dd084617cb4f39085640f49ebc5'],0,10,10,2631626,3,,,,5959
e925b18fe617ff4e04f86e44ee3500225c7157e6,1,Mark Payne,2017-01-18 10:34:56-05:00,['82cf0c6fa87ff8e5057b94020ca935daa4381289'],369,413,782,2632408,9,0,0.8125,0,5959
bbc714e73ba245de7bc32fd9958667c847101f7d,1,Matt Burgess,2017-01-18 14:47:31-05:00,['e925b18fe617ff4e04f86e44ee3500225c7157e6'],197,527,724,2633132,6,0.202702703,0.317567568,0.540540541,5960
7a2751bf5d5ee7b6c988a14f75d769a67b9b80cf,0,Koji Kawamura,2017-01-19 11:16:30+09:00,['bbc714e73ba245de7bc32fd9958667c847101f7d'],1,4,5,2633137,2,1,1,1,5960
e62eeb7563da7486f4dc7925764ed1226fd9dc45,0,Scott Aslan,2017-01-19 11:13:44-05:00,['7a2751bf5d5ee7b6c988a14f75d769a67b9b80cf'],34,57,91,2633228,11,0.8,1,1,5960
7f0171ffa25bfd8932e49b3367049b101799dea4,1,Bryan Bende,2017-01-19 15:17:59-05:00,['e62eeb7563da7486f4dc7925764ed1226fd9dc45'],250,1214,1464,2634692,25,0.016064257,0.889558233,0.895582329,5963
516075de027ad25fd8015fedff3b7d0d9d5e3b3e,0,Bryan Rosander,2017-01-20 10:17:21-05:00,['7f0171ffa25bfd8932e49b3367049b101799dea4'],16,36,52,2634744,4,0,0.6875,0.8125,5963
dc934cbb8e4ad7078de555a112d92f05fd1e879f,1,Matt Gilman,2017-01-20 16:18:08-05:00,['516075de027ad25fd8015fedff3b7d0d9d5e3b3e'],5270,6873,12143,2646887,88,0.248427673,1,0.830188679,5966
79ca30be4a84cd6c1d218e1a00af7946405b6f30,0,James Wing,2017-01-20 18:40:36-08:00,['dc934cbb8e4ad7078de555a112d92f05fd1e879f'],271,283,554,2647441,2,1,1,1,5966
ddda602620053dd578cf2b96d7733538bc67a82a,0,James Wing,2017-01-22 14:27:19-08:00,['79ca30be4a84cd6c1d218e1a00af7946405b6f30'],3,13,16,2647457,1,0,0.666666667,0.666666667,5966
7340078de2229a4fc094cd2185117a7772389ec0,1,James Wing,2017-01-24 13:24:29-08:00,['ddda602620053dd578cf2b96d7733538bc67a82a'],15,141,156,2647613,23,0.547619048,1,0.69047619,5966
e0e6f0bacb722a9b7a1bb38b531e67154237eedb,0,Andy LoPresto,2017-01-24 18:18:14-08:00,['7340078de2229a4fc094cd2185117a7772389ec0'],29,59,88,2647701,1,,,,5966
e113511fef2f408f24b05da28046d8a3de3b228a,0,Matt Gilman,2017-01-25 10:25:36-05:00,['e0e6f0bacb722a9b7a1bb38b531e67154237eedb'],0,4,4,2647705,1,0,1,1,5966
1a6802a0166127e80700d13581aaac2166047d4b,0,Matt Gilman,2017-01-25 12:24:45-05:00,['e113511fef2f408f24b05da28046d8a3de3b228a'],0,6,6,2647711,1,0,1,1,5966
3626abd78a807a4ff806d51e7d27194f9fb7c961,1,Oleg Zhurakousky,2017-01-25 13:22:50-05:00,['1a6802a0166127e80700d13581aaac2166047d4b'],0,1629,1629,2649340,16,0.274167987,0.668779715,0.946117274,5981
f0856565ad3979148c82fcef2865340a40ab61f5,1,Oleg Zhurakousky,2017-01-25 13:22:50-05:00,['3626abd78a807a4ff806d51e7d27194f9fb7c961'],63,88,151,2649491,8,1,1,1,5981
506709922b5dfe3be4261a46d6f184924e1322d7,0,Andy LoPresto,2017-01-25 19:03:13-08:00,['f0856565ad3979148c82fcef2865340a40ab61f5'],13,45,58,2649549,4,,,,5981
a1ecea3600b1dda8a9505aa1cca3caf31548c6c5,0,Andy LoPresto,2017-01-25 19:04:37-08:00,['506709922b5dfe3be4261a46d6f184924e1322d7'],9,56,65,2649614,2,,,,5981
c15111d98511bcbb9f6076e00441e7ec58bc79a1,0,Matt Gilman,2017-01-26 08:59:18-05:00,['a1ecea3600b1dda8a9505aa1cca3caf31548c6c5'],5,5,10,2649624,3,,,,5981
250c4a89416b0150e5a90488e72464e431efb540,0,Andy LoPresto,2017-01-26 13:05:33-08:00,['c15111d98511bcbb9f6076e00441e7ec58bc79a1'],6,27,33,2649657,3,,,,5981
bd4ea488bb457041147aaba753fc75319a3eb573,0,Koji Kawamura,2017-01-27 08:44:11+09:00,['250c4a89416b0150e5a90488e72464e431efb540'],1,1,2,2649659,1,,,,5981
0950186fbbc69575825da49d4f355314d2e2d178,0,Scott Aslan,2017-01-27 11:47:09-05:00,['bd4ea488bb457041147aaba753fc75319a3eb573'],10,16,26,2649685,7,,,,5981
f8f66fa22b10012759a56dd190b22e6b96f6c92c,0,Scott Aslan,2017-01-27 11:50:56-05:00,['0950186fbbc69575825da49d4f355314d2e2d178'],8,0,8,2649693,1,0,0,0,5981
63c763885c36ab06111edf2c9d7743563ea57fcb,0,Oleg Zhurakousky,2017-01-27 12:48:23-05:00,['f8f66fa22b10012759a56dd190b22e6b96f6c92c'],41,93,134,2649827,2,0,1,0.806451613,5981
67e2459660c7eddac35e8f55e7e5955e6a329bbb,1,Oleg Zhurakousky,2017-01-29 11:16:22-05:00,['63c763885c36ab06111edf2c9d7743563ea57fcb'],7,7,14,2649841,2,,,,5981
89f1bd3189970f9930bfdd4861fc2043dfd30c90,1,Oleg Zhurakousky,2017-01-30 08:35:39-05:00,['67e2459660c7eddac35e8f55e7e5955e6a329bbb'],5,70,75,2649916,4,0,1,0.318181818,5982
78a0e1e18b9d40a10bac4612a9a0ebdc4b7d13bb,1,Oleg Zhurakousky,2017-01-30 09:03:35-05:00,['89f1bd3189970f9930bfdd4861fc2043dfd30c90'],2,425,427,2650343,4,0.111111111,0.632850242,0.8647343,5984
d5b139ffd4fea53bc004e86087beba4c204eed70,1,Matt Burgess,2017-01-30 11:46:42-05:00,['78a0e1e18b9d40a10bac4612a9a0ebdc4b7d13bb'],3,14,17,2650360,1,0,1,1,5984
910c1fa6f6bbf95c13ca646ee57be197f6ba9069,0,Pierre Villard,2017-01-30 22:06:40+01:00,['d5b139ffd4fea53bc004e86087beba4c204eed70'],0,6,6,2650366,1,,,,5984
6518778c1158e52461d832ab18c44d1a5ed5cefb,0,Pierre Villard,2017-01-30 22:10:50+01:00,['910c1fa6f6bbf95c13ca646ee57be197f6ba9069'],3,5,8,2650374,1,0,0,1,5984
390754c5754f821e66d519a269cd0ee56f5e3622,0,Pierre Villard,2017-01-31 15:33:20+01:00,['6518778c1158e52461d832ab18c44d1a5ed5cefb'],6,6,12,2650386,1,,,,5984
0bfa06a6b10a52d106734361eda046743b37a3af,0,Bryan Bende,2017-01-31 13:43:35-05:00,['390754c5754f821e66d519a269cd0ee56f5e3622'],0,57,57,2650443,1,,,,5984
f77b5a501485fbdc19e21dd53b037af6ae2e3bdf,0,Pierre Villard,2017-02-01 11:36:18+01:00,['0bfa06a6b10a52d106734361eda046743b37a3af'],0,74,74,2650517,1,,,,5984
af2861f1057bc71b450fca883449588a79a7f058,0,Bryan Rosander,2017-02-01 17:02:17-05:00,['f77b5a501485fbdc19e21dd53b037af6ae2e3bdf'],140,177,317,2650834,7,0.166666667,0,0.166666667,5984
ea3c294f94093d57a47982a7167126c718383a3c,1,Aldrin Piri,2017-02-02 09:56:53-05:00,['af2861f1057bc71b450fca883449588a79a7f058'],2,76,78,2650912,2,0.355555556,0.844444444,1,5984
6d4901cd26388e1810cb670a135d2cf0e87cc8d0,1,Koji Kawamura,2017-02-03 08:51:13+09:00,['ea3c294f94093d57a47982a7167126c718383a3c'],68,494,562,2651474,5,0.088709677,0.810483871,0.983870968,5984
2d6d7710c776a4e5608f1da63eba9e8435f72506,0,James Wing,2017-02-03 11:09:02-08:00,['6d4901cd26388e1810cb670a135d2cf0e87cc8d0'],0,98,98,2651572,2,0.769230769,1,1,5985
376af83a3dcfa5361be0859b54d91d30c685494e,1,Mike Moser,2017-02-03 20:52:32+00:00,['2d6d7710c776a4e5608f1da63eba9e8435f72506'],11,285,296,2651868,6,0.359550562,1,1,5985
adfaffc7736a6b85fe8c65d138043d717ccc7198,0,Mike Moser,2017-02-03 22:53:29+00:00,['376af83a3dcfa5361be0859b54d91d30c685494e'],1,3,4,2651872,1,,,,5985
76e31dfd19d1ccc0d4c7431d81774f56ad5ab905,0,joewitt,2017-02-06 09:36:52-05:00,['adfaffc7736a6b85fe8c65d138043d717ccc7198'],0,9,9,2651881,1,,,,5985
e4cee7ee0d9ee4dfe3dcd2ba99f7bd1f6b3d38e4,0,Pierre Villard,2017-02-06 18:06:58+01:00,['76e31dfd19d1ccc0d4c7431d81774f56ad5ab905'],5,11,16,2651897,1,0,0,1,5985
6466931c236aa29bfd95da63e0e6588fca420f97,1,Pierre Villard,2017-02-06 18:32:57+01:00,['e4cee7ee0d9ee4dfe3dcd2ba99f7bd1f6b3d38e4'],9,83,92,2651989,2,0,0.55,0.883333333,5985
229b20f3954e66f3f8a5c373e08b887f1209a315,1,Pierre Villard,2017-02-06 19:34:49+01:00,['6466931c236aa29bfd95da63e0e6588fca420f97'],5,35,40,2652029,2,0,1,1,5985
31b943d2c137f4ded254d4beb7c1d3268ce1bac8,1,Pierre Villard,2017-02-07 08:51:22+01:00,['229b20f3954e66f3f8a5c373e08b887f1209a315'],1,32,33,2652062,2,0.823529412,0.823529412,1,5985
3d3faada5c614b4ac40c866775492fa6b7e202e3,1,Pierre Villard,2017-02-07 09:04:48+01:00,['31b943d2c137f4ded254d4beb7c1d3268ce1bac8'],6,8,14,2652076,1,1,1,0,5985
9a638cc865518aef71ee34330c5192786bbfff44,1,Pierre Villard,2017-02-07 09:06:43+01:00,['3d3faada5c614b4ac40c866775492fa6b7e202e3'],1,31,32,2652108,2,1,1,1,5985
68c2d7862fd14367626227b341f78cbf36dfdff1,1,Pierre Villard,2017-02-07 11:42:03+01:00,['9a638cc865518aef71ee34330c5192786bbfff44'],5,64,69,2652177,2,,,,5985
839dd5ac182b300e9b3ea261a3a9bb29c0df12d2,1,Pierre Villard,2017-02-07 11:42:15+01:00,['68c2d7862fd14367626227b341f78cbf36dfdff1'],1,1,2,2652179,1,,,,5985
027fbf48b8ec825dc16e3a8030654f8ae3725aae,1,Pierre Villard,2017-02-07 15:45:56+01:00,['839dd5ac182b300e9b3ea261a3a9bb29c0df12d2'],75,48,123,2652302,4,0,0,0,5985
46fa6a167ade701cd9dfa83180615226b2f182da,1,Pierre Villard,2017-02-07 16:48:38+01:00,['027fbf48b8ec825dc16e3a8030654f8ae3725aae'],17,121,138,2652440,2,0.012820513,0.782051282,0.794871795,5985
ea0f5690cc62ac8b73394e076dcac218f2edb37b,1,Pierre Villard,2017-02-07 17:14:37+01:00,['46fa6a167ade701cd9dfa83180615226b2f182da'],0,119,119,2652559,2,0,0.977011494,0.977011494,5985
93150d3efaf517d638bb3ca88766e98281824532,0,Bryan Bende,2017-02-07 13:37:32-05:00,['ea0f5690cc62ac8b73394e076dcac218f2edb37b'],8,15,23,2652582,6,1,1,1,5985
5af6eb17b0c1be9aca201507769f6b530d5ba0f6,0,Matt Gilman,2017-02-07 16:22:51-05:00,['93150d3efaf517d638bb3ca88766e98281824532'],147,830,977,2653559,2,0.963855422,1,1,5986
da5aafdf3f1b30347a6d6272256b306d26e30a31,0,Matt Gilman,2017-02-07 17:01:51-05:00,['5af6eb17b0c1be9aca201507769f6b530d5ba0f6'],13,1,14,2653573,3,0.9,0.1,0,5986
83ee7590a62816ee9991b532dc098be280b454b3,0,Matt Gilman,2017-02-08 10:45:34-05:00,['da5aafdf3f1b30347a6d6272256b306d26e30a31'],1,3,4,2653577,1,0,1,0,5986
f0c6739a1f826813820b94455039692fd680d654,1,Scott Aslan,2017-02-08 15:13:20-05:00,['83ee7590a62816ee9991b532dc098be280b454b3'],3,3,6,2653583,1,,,,5986
bc7b17a64c8e995952fb6579ec577167453022ef,0,Scott Aslan,2017-02-09 09:29:18-05:00,['f0c6739a1f826813820b94455039692fd680d654'],4,4,8,2653591,2,0,1,1,5986
74ecc20f00fe140e89d42fcc47b33000bb818c80,0,Scott Aslan,2017-02-09 09:42:36-05:00,['bc7b17a64c8e995952fb6579ec577167453022ef'],1,1,2,2653593,1,,,,5986
4e4d14f86ff21d2c7d20d9e180acee54a2ddf93b,1,Matt Burgess,2017-02-10 11:22:43-05:00,['74ecc20f00fe140e89d42fcc47b33000bb818c80'],105,118,223,2653816,11,0,0.103448276,1,5986
2e1b87fa43e8af05ae9f08970b5d78c60e58c1c8,1,Mike Moser,2017-02-10 20:59:18+00:00,['4e4d14f86ff21d2c7d20d9e180acee54a2ddf93b'],1,30,31,2653847,2,0,1,1,5986
bf3b1640fce1cded2197b8a898e0f58081a89df4,1,Matt Gilman,2017-02-10 16:03:23-05:00,['2e1b87fa43e8af05ae9f08970b5d78c60e58c1c8'],6512,9072,15584,2669431,96,0.207797594,0.993363749,0.767316466,5987
e4b74b3d718dcdd08d3322642677978ce62b70f6,0,Matt Gilman,2017-02-10 17:01:33-05:00,['bf3b1640fce1cded2197b8a898e0f58081a89df4'],6,6,12,2669443,2,,,,5987
5cfba6ace324d3537bf70f5c76f883f380503a10,0,Koji Kawamura,2017-02-11 08:54:06+09:00,['e4b74b3d718dcdd08d3322642677978ce62b70f6'],2,2,4,2669447,2,,,,5987
1e5570d9b09d80a47eab45a4901eca8c092a21a5,1,Pierre Villard,2017-02-11 15:07:55+01:00,['5cfba6ace324d3537bf70f5c76f883f380503a10'],2,43,45,2669492,3,,,,5988
febe6da4a2c85b8fdda7c80bd7626e8a3f54536f,0,Pierre Villard,2017-02-11 15:36:19+01:00,['1e5570d9b09d80a47eab45a4901eca8c092a21a5'],0,4,4,2669496,1,,,,5988
897c70298a9049d1a4c743b4eca97f108961b3ae,1,James Wing,2017-02-12 19:52:38-08:00,['febe6da4a2c85b8fdda7c80bd7626e8a3f54536f'],0,6542,6542,2676038,53,0.307753165,0.816060127,0.993670886,6036
932b5bb91b6983da18b38c33e8901b881811666a,0,Matt Gilman,2017-02-13 09:02:54-05:00,['897c70298a9049d1a4c743b4eca97f108961b3ae'],1,1,2,2676040,1,,,,6036
4274481f1d63f9e8ea109e02e2169e8b1f6000ae,0,Matt Gilman,2017-02-13 09:32:02-05:00,['932b5bb91b6983da18b38c33e8901b881811666a'],13,8,21,2676061,3,0.75,1,0.75,6036
2bc7d526265eb2ff2a7b3f17a5a2d810bb431662,0,Matt Gilman,2017-02-13 09:46:20-05:00,['4274481f1d63f9e8ea109e02e2169e8b1f6000ae'],1,1,2,2676063,1,,,,6036
41ad032151ffaf0b56b18400be61e12e2742a58d,0,Mike Moser,2017-02-13 20:15:59+00:00,['2bc7d526265eb2ff2a7b3f17a5a2d810bb431662'],105,108,213,2676276,3,1,0,0,6036
8d082d1aca99e12795dc97ecc5fc70af8e2324e2,1,joewitt,2017-02-13 22:16:22-05:00,['41ad032151ffaf0b56b18400be61e12e2742a58d'],85,686,771,2677047,30,0.438931298,0.942748092,0.908396947,6049
f1d0a6b36b86b8ad4b86f77e4341be5723cb4b8c,1,joewitt,2017-02-13 22:38:54-05:00,['8d082d1aca99e12795dc97ecc5fc70af8e2324e2'],79,193,272,2677319,4,,,,6049
7e97946c359bfcb62ef39a2ce37083554501f1b0,0,Andy LoPresto,2017-02-13 22:46:44-08:00,['f1d0a6b36b86b8ad4b86f77e4341be5723cb4b8c'],0,3,3,2677322,1,,,,6049
b2290b24a6a0c556b52f4bd9343970c9d1a5268d,0,Andy LoPresto,2017-02-13 23:09:07-08:00,['7e97946c359bfcb62ef39a2ce37083554501f1b0'],2,2,4,2677326,1,,,,6049
1a91ecc379675912d03e5f2bda150eab0038e641,0,Andy LoPresto,2017-02-13 23:55:21-08:00,['b2290b24a6a0c556b52f4bd9343970c9d1a5268d'],2,2,4,2677330,2,,,,6049
17cb2e284daf22a4b87864a5462ebc24c23e3f31,1,Andy LoPresto,2017-02-14 01:00:50-08:00,['1a91ecc379675912d03e5f2bda150eab0038e641'],17,44,61,2677391,2,1,1,1,6049
2ef7c15b5d300e8c5932b7b03800fcbd969aff3b,1,Andre F de Miranda,2017-02-14 21:11:03+11:00,['17cb2e284daf22a4b87864a5462ebc24c23e3f31'],0,534,534,2677925,9,0.287671233,0.575342466,1,6054
1e4369414568f61172f99ec9676ac0c7568934ee,1,Andre F de Miranda,2017-02-15 01:37:14+11:00,['2ef7c15b5d300e8c5932b7b03800fcbd969aff3b'],1,26,27,2677952,4,0,0.307692308,1,6054
93ea348159e02887d05a138acc489b4dc0ffcf1f,0,Andre F de Miranda,2017-02-15 01:57:22+11:00,['1e4369414568f61172f99ec9676ac0c7568934ee'],0,0,0,2677952,0,,,,6054
bd3e0438a32a7107d91d2e98e47dcf64af2021b4,1,Mark Payne,2017-02-14 10:02:16-05:00,['93ea348159e02887d05a138acc489b4dc0ffcf1f'],27,393,420,2678372,2,0.207612457,0.930795848,0.892733564,6054
690130b063619adc8ead954afcd62e8dc7db02df,1,Aldrin Piri,2017-02-14 10:20:39-05:00,['bd3e0438a32a7107d91d2e98e47dcf64af2021b4'],8,218,226,2678598,5,0.157894737,1,1,6055
7963df89ebf190a48ccacb118d5bf6c2c9bd2f3a,1,Andre F de Miranda,2017-02-15 02:52:11+11:00,['690130b063619adc8ead954afcd62e8dc7db02df'],3,546,549,2679147,14,0.891025641,1,0.903846154,6063
0aa4b72678a3543f2b02a484d9ba7da7997b9a34,0,Matt Burgess,2017-02-14 11:19:35-05:00,['7963df89ebf190a48ccacb118d5bf6c2c9bd2f3a'],56,73,129,2679276,2,0,0,1,6063
df91169512b864c0fe66f746546aa5097b5256b3,1,Aldrin Piri,2017-02-14 12:37:31-05:00,['0aa4b72678a3543f2b02a484d9ba7da7997b9a34'],2,2,4,2679280,1,,,,6063
ca887308af80ac34b756e1d2655c2a95fafeaf94,1,Aldrin Piri,2017-02-14 12:58:06-05:00,['df91169512b864c0fe66f746546aa5097b5256b3'],0,4,4,2679284,1,,,,6063
8ffa1703ba0ff82aa2127c511adfaf2241fb1c8e,1,Mark Payne,2017-02-14 13:04:09-05:00,['ca887308af80ac34b756e1d2655c2a95fafeaf94'],19,383,402,2679686,7,0.639344262,1,0.972677596,6064
9cfc13423dd1a18dd4f4554eb0fb0d5b300c3e6e,1,Pierre Villard,2017-02-14 19:09:12+01:00,['8ffa1703ba0ff82aa2127c511adfaf2241fb1c8e'],13,64,77,2679763,6,0,1,1,6064
e46f4131f9eade2eb9fe108241107688795904f5,0,Pierre Villard,2017-02-14 19:15:27+01:00,['9cfc13423dd1a18dd4f4554eb0fb0d5b300c3e6e'],41,95,136,2679899,2,0.611111111,0.611111111,1,6064
3dc7a160ce83a1e83edacc54941ac4d0f5fff718,1,joewitt,2017-02-14 13:33:27-05:00,['e46f4131f9eade2eb9fe108241107688795904f5'],3,363,366,2680265,2,0.336448598,1,1,6065
4bf267c8bb11939d715c02c3ca818dec372bec26,0,joewitt,2017-02-14 15:28:46-05:00,['3dc7a160ce83a1e83edacc54941ac4d0f5fff718'],5,121,126,2680391,5,0.763888889,1,0.944444444,6065
bd88e4335ad151592f1310996e9a0513b7f0829a,1,Andy LoPresto,2017-02-14 13:39:05-08:00,['4bf267c8bb11939d715c02c3ca818dec372bec26'],247,1183,1430,2681821,17,0.798449612,1,1,6069
6279fd41844205a14cf1f2fb225ead8881b197eb,0,joewitt,2017-02-14 22:08:09-05:00,['bd88e4335ad151592f1310996e9a0513b7f0829a'],7,24,31,2681852,2,0,0,0,6069
2d58497c2e888e7a28bc28b4f7a091c46cf70c31,1,joewitt,2017-02-14 23:21:44-05:00,['6279fd41844205a14cf1f2fb225ead8881b197eb'],16,43,59,2681911,2,1,1,1,6069
71e2061b5dbd286e45855c81473e849583ead9df,0,joewitt,2017-02-14 23:25:29-05:00,['2d58497c2e888e7a28bc28b4f7a091c46cf70c31'],1,2,3,2681914,1,0,0,0,6069
6fc30900b94308b8651eee368c39e272fe8e40de,1,Andy LoPresto,2017-02-14 23:09:51-08:00,['71e2061b5dbd286e45855c81473e849583ead9df'],139,345,484,2682398,11,0.302083333,0.75,0.75,6069
86fb67d55cae49c085bed87287c70d365ce71766,1,Koji Kawamura,2017-02-15 16:53:53+09:00,['6fc30900b94308b8651eee368c39e272fe8e40de'],2,64,66,2682464,7,0.631578947,0.789473684,1,6069
b7cdc6b382b09d601b1e9ecf81ef16b9246309b3,1,Andre F de Miranda,2017-02-15 23:48:34+11:00,['86fb67d55cae49c085bed87287c70d365ce71766'],6,619,625,2683089,7,0.253164557,0.675105485,0.864978903,6070
a90fa9c285cce2beb1fea8fb266df402f8926fcf,1,Pierre Villard,2017-02-15 15:51:31+01:00,['b7cdc6b382b09d601b1e9ecf81ef16b9246309b3'],91,333,424,2683513,4,0.109677419,0.851612903,0.961290323,6070
b207397a11c593958f408783b29f12f62edc0a39,1,joewitt,2017-02-15 12:59:38-05:00,['a90fa9c285cce2beb1fea8fb266df402f8926fcf'],31,1603,1634,2685147,16,0.457264957,0.886039886,0.799145299,6078
39cfd0339756e3869d0e3f3bcf45569855d6bca3,1,joewitt,2017-02-15 13:15:56-05:00,['b207397a11c593958f408783b29f12f62edc0a39'],11,213,224,2685371,7,0.666666667,0.810810811,1,6079
a62523c7f5747e29fa2d15ccc5f6f0b96484d4ca,0,Pierre Villard,2017-02-15 20:20:30+01:00,['39cfd0339756e3869d0e3f3bcf45569855d6bca3'],0,22,22,2685393,1,0,0,1,6079
4a68dacc431bfbb2d6ce1d9827fce4c8690e24d3,0,Andy LoPresto,2017-02-15 11:29:04-08:00,['a62523c7f5747e29fa2d15ccc5f6f0b96484d4ca'],0,169,169,2685562,1,,,,6079
8b90343715be8e28e465991fcdde00f64a8c6c6f,1,Bryan Rosander,2017-02-15 18:39:26-05:00,['4a68dacc431bfbb2d6ce1d9827fce4c8690e24d3'],27,159,186,2685748,5,0.424657534,0.424657534,1,6079
598563277e039b7a4b5c2a1212c817a11cce482e,0,joewitt,2017-02-16 00:07:00-05:00,['8b90343715be8e28e465991fcdde00f64a8c6c6f'],1,11,12,2685760,1,1,1,1,6079
76fcf5def1c06a2579604bd8c46f79037e05dd15,0,joewitt,2017-02-16 00:10:02-05:00,['598563277e039b7a4b5c2a1212c817a11cce482e'],79,79,158,2685918,65,,,,6079
1eb98aefee8b422d4de46f1652475a2c9ac0470a,1,Koji Kawamura,2017-02-16 14:19:39+09:00,['76fcf5def1c06a2579604bd8c46f79037e05dd15'],112,241,353,2686271,6,1,0.844155844,0.974025974,6079
ef69fd61a10fa69452110079cd0fb890a21f5690,0,joewitt,2017-02-16 01:34:44-05:00,['1eb98aefee8b422d4de46f1652475a2c9ac0470a'],1,2,3,2686274,1,1,0,1,6079
702a0dcf17d9a6e1372935ef0363fe59bd216a65,1,Scott Aslan,2017-02-16 09:45:41-05:00,['ef69fd61a10fa69452110079cd0fb890a21f5690'],6,2,8,2686282,1,,,,6079
855743f9333f1eb16a24d271b3222a84999ea0b2,0,Bryan Rosander,2017-02-16 13:04:16-05:00,['702a0dcf17d9a6e1372935ef0363fe59bd216a65'],1,1,2,2686284,1,,,,6079
d9828c240b87f36af7e3d9aefed753d4315f8b0a,0,Matt Gilman,2017-02-16 15:54:00-05:00,['855743f9333f1eb16a24d271b3222a84999ea0b2'],30,32,62,2686346,1,1,1,1,6079
a1a974785726bebe3a8533f6c37ee1ade9d3e152,0,Andy LoPresto,2017-02-16 19:22:28-08:00,['d9828c240b87f36af7e3d9aefed753d4315f8b0a'],2,272,274,2686620,1,,,,6079
e4eda188b8dc7b66cd0ec6f2b34235f70214725f,0,Andy LoPresto,2017-02-16 19:31:05-08:00,['a1a974785726bebe3a8533f6c37ee1ade9d3e152'],59,0,59,2686679,1,,,,6079
095c04eda0c604a02c51df085ba67847448224c0,1,Andre F de Miranda,2017-02-18 00:56:46+11:00,['e4eda188b8dc7b66cd0ec6f2b34235f70214725f'],226,110,336,2687015,3,1,0,0,6079
ec868362f3317a79b6518c780af1b9debb843f32,0,Mark Payne,2017-02-17 10:27:40-05:00,['095c04eda0c604a02c51df085ba67847448224c0'],7,57,64,2687079,2,0,0.806451613,1,6079
ded18b94dbcaa91dcad2d6ff995e0a9c1282323b,0,Oleg Zhurakousky,2017-02-17 12:31:21-05:00,['ec868362f3317a79b6518c780af1b9debb843f32'],6,32,38,2687117,1,1,1,0,6079
6a1854c9758005a67d5315f31533fdb88ec55b81,1,Oleg Zhurakousky,2017-02-17 14:32:06-05:00,['ded18b94dbcaa91dcad2d6ff995e0a9c1282323b'],0,2561,2561,2689678,57,0.585409253,0.807829181,0.597864769,6133
19302263c35c8f648feb378a0eaab4af43aa1366,0,Matt Gilman,2017-02-17 15:40:23-05:00,['6a1854c9758005a67d5315f31533fdb88ec55b81'],26,90,116,2689794,4,0.090909091,0.878787879,0.666666667,6133
a8b8f1530bad45f8d6372ef4046b87e92f9e9633,0,Andre F de Miranda,2017-02-19 21:25:08+11:00,['19302263c35c8f648feb378a0eaab4af43aa1366'],1,1,2,2689796,1,,,,6133
4f49095d750f55d05eaf75d6e0b60f778eef8513,1,ijokarumawak,2017-02-20 11:04:11+09:00,['a8b8f1530bad45f8d6372ef4046b87e92f9e9633'],19,19,38,2689834,1,,,,6133
f9c4d3ce3ad29fd484feead456f28a8fad3e0684,1,ijokarumawak,2017-02-21 16:23:23+09:00,['4f49095d750f55d05eaf75d6e0b60f778eef8513'],8,99,107,2689941,2,0.537313433,0.940298507,0.940298507,6133
5df6622d2aad8ba2cbdff53a16dbe15a66fd5c93,0,Andre F de Miranda,2017-02-22 00:58:13+11:00,['f9c4d3ce3ad29fd484feead456f28a8fad3e0684'],0,0,0,2689941,0,,,,6133
364efa96cc640f44af9ff7e74d554d7a01407ccd,0,Matt Gilman,2017-02-21 10:17:34-05:00,['5df6622d2aad8ba2cbdff53a16dbe15a66fd5c93'],69,12,81,2690022,12,0,0.080191912,0.089787526,6133
8d467f3d1fe9b9e96e67f2979aa5676465afedc1,0,Aldrin Piri,2017-02-22 10:47:39-05:00,['364efa96cc640f44af9ff7e74d554d7a01407ccd'],1,8,9,2690031,1,,,,6133
96ed405d708894ee5400ebbdbf335325219faa09,1,Oleg Zhurakousky,2017-02-22 12:40:06-05:00,['8d467f3d1fe9b9e96e67f2979aa5676465afedc1'],1030,12165,13195,2703226,138,0.29760274,0.635273973,0.840239726,6198
cefc02c5fb04451026a5f8d84e8fb56625468284,0,James Wing,2017-02-22 10:24:37-08:00,['96ed405d708894ee5400ebbdbf335325219faa09'],0,7,7,2703233,1,,,,6198
64379d2007ab7d6976783d104c451fdd8ff0556d,1,Oleg Zhurakousky,2017-02-22 17:16:14-05:00,['cefc02c5fb04451026a5f8d84e8fb56625468284'],1,1,2,2703235,1,,,,6198
2c374bafaa34f48810717455bc36a7ad0ad9b4b9,1,Matt Gilman,2017-02-23 09:14:33-05:00,['64379d2007ab7d6976783d104c451fdd8ff0556d'],2700,2738,5438,2708673,85,1,0,0,6198
dfd04e638bf1a331e47ec20781843964058693aa,0,Aldrin Piri,2017-02-23 09:30:47-05:00,['2c374bafaa34f48810717455bc36a7ad0ad9b4b9'],1,1,2,2708675,1,,,,6198
fba17159a94e639bce3b1af367e095c2bda4ab9d,0,Matt Gilman,2017-02-24 08:05:34-05:00,['dfd04e638bf1a331e47ec20781843964058693aa'],4,0,4,2708679,1,0,0,0,6198
8e17929d6a68171666a79711023b79c28f476d1a,0,Mark Payne,2017-02-24 10:06:53-05:00,['fba17159a94e639bce3b1af367e095c2bda4ab9d'],260,376,636,2709315,6,1,1,0.826086957,6199
a76641b252a6fdb9e7c80611089c71d9bd065042,0,Matt Gilman,2017-02-27 09:21:55-05:00,['8e17929d6a68171666a79711023b79c28f476d1a'],3,0,3,2709318,1,1,1,0,6199
d98426cc3d15ea6b506c2d3173e0ce5d8a4b5565,1,Matt Gilman,2017-02-27 09:57:43-05:00,['a76641b252a6fdb9e7c80611089c71d9bd065042'],14,23,37,2709355,12,1,1,1,6199
1978c986b532d0869c3398eb1018514ba9b8de24,0,Matt Gilman,2017-02-27 13:18:14-05:00,['d98426cc3d15ea6b506c2d3173e0ce5d8a4b5565'],4,4,8,2709363,2,,,,6199
cfe899d1898aa6c5f8d36e6e92562805b54f7d5d,1,Matt Burgess,2017-02-27 15:01:59-05:00,['1978c986b532d0869c3398eb1018514ba9b8de24'],29,41,70,2709433,5,1,0.75,0,6199
c3dbbb845fd0cb9079a3a1652930976e098fa2b6,0,Matt Gilman,2017-02-28 09:47:47-05:00,['cfe899d1898aa6c5f8d36e6e92562805b54f7d5d'],84,156,240,2709673,7,,,,6199
a32e1509b67e2f3855af7b160c6cf3575eaac165,1,Matt Burgess,2017-03-01 21:41:51-05:00,['c3dbbb845fd0cb9079a3a1652930976e098fa2b6'],2,2308,2310,2711983,42,0.548104956,0.733236152,0.841107872,6225
dcdfd3dad9f02ec8d85a3e1da2f82c30e20b6dae,0,Andre F de Miranda,2017-03-02 22:19:34+11:00,['a32e1509b67e2f3855af7b160c6cf3575eaac165'],13,176,189,2712172,4,0,0.9,1,6225
0d66b6dcdafdc07c3ef517f55d8ebaa4ea5d67bd,0,Andre F de Miranda,2017-03-02 22:52:10+11:00,['dcdfd3dad9f02ec8d85a3e1da2f82c30e20b6dae'],1,2,3,2712175,1,,,,6225
bf2f04fb5f96af854d5b6e57efb18f9a8eb544b8,1,Matt Burgess,2017-03-02 10:04:09-05:00,['0d66b6dcdafdc07c3ef517f55d8ebaa4ea5d67bd'],3,5,8,2712183,1,1,1,0,6225
d689ac561eadd848043017112a763d3d26a3857f,1,Matt Burgess,2017-03-02 11:12:54-05:00,['bf2f04fb5f96af854d5b6e57efb18f9a8eb544b8'],1,4,5,2712188,1,,,,6225
ac5a7960e861c5802374bb875057253d61f8a286,0,Aldrin Piri,2017-03-02 15:37:39-05:00,['d689ac561eadd848043017112a763d3d26a3857f'],1,1,2,2712190,1,,,,6225
7c6f2dc677d62d19b81d237cadbb08c3989ce341,0,Pierre Villard,2017-03-02 23:09:04+01:00,['ac5a7960e861c5802374bb875057253d61f8a286'],1,1,2,2712192,1,,,,6225
5990db39aeae399eedc82a37cb478e14ce278f63,0,Andy LoPresto,2017-03-02 16:19:11-08:00,['7c6f2dc677d62d19b81d237cadbb08c3989ce341'],1,1,2,2712194,1,,,,6225
4ed64e7561986c70a396a9c1af59b0efcc075c6c,1,Matt Gilman,2017-03-03 09:13:28-05:00,['5990db39aeae399eedc82a37cb478e14ce278f63'],2,36,38,2712232,2,0,0.863636364,1,6225
6c44d6be2e31eae491f236f3be39eb3309c45cda,0,Oleg Zhurakousky,2017-03-03 09:18:29-05:00,['4ed64e7561986c70a396a9c1af59b0efcc075c6c'],21,26,47,2712279,5,0,0,0,6225
9f669aa944ff8e0ee70608e89e0c3ef61253252d,0,Matt Gilman,2017-03-03 09:38:29-05:00,['6c44d6be2e31eae491f236f3be39eb3309c45cda'],6,10,16,2712295,2,0,1,1,6225
f8cad0f8c94869e2fd2a30896033c3c48eadbf14,0,Andy LoPresto,2017-03-03 17:36:40-08:00,['9f669aa944ff8e0ee70608e89e0c3ef61253252d'],1,2,3,2712298,1,,,,6225
33a702500c30e585bf5b59e6a25b99daa9b492df,0,Andre F de Miranda,2017-03-05 10:15:06+11:00,['f8cad0f8c94869e2fd2a30896033c3c48eadbf14'],1,1,2,2712300,1,,,,6225
7f5c0dfb54309cd4383799139992898f4e8e76a1,1,Pierre Villard,2017-03-05 15:27:48+01:00,['33a702500c30e585bf5b59e6a25b99daa9b492df'],3,3,6,2712306,1,,,,6225
000414e7eaa4c4f459779e73c331f3021f9a5049,1,Aldrin Piri,2017-03-06 09:29:44-05:00,['7f5c0dfb54309cd4383799139992898f4e8e76a1'],97,617,714,2713020,5,0,0.773519164,0.951219512,6225
9e68f02f1fb7eb442f6c9580b46255f713d8b191,1,Aldrin Piri,2017-03-06 10:36:30-05:00,['000414e7eaa4c4f459779e73c331f3021f9a5049'],126,303,429,2713449,10,0.44047619,0.857142857,1,6225
16bde02ed079150c1fbf80806537137613ae2d10,1,Aldrin Piri,2017-03-06 10:38:15-05:00,['9e68f02f1fb7eb442f6c9580b46255f713d8b191'],106,226,332,2713781,28,0.227272727,0.636363636,0.803030303,6225
b7f946e8472271597db165beec69e50ae139b420,1,Pierre Villard,2017-03-06 19:42:25+01:00,['16bde02ed079150c1fbf80806537137613ae2d10'],0,1074,1074,2714855,11,0.087209302,0.575581395,0.575581395,6233
bf112d065434ed536fff10b7aaa5eb3b70bc4b9d,0,Andy LoPresto,2017-03-06 16:50:18-08:00,['b7f946e8472271597db165beec69e50ae139b420'],11,37,48,2714903,6,1,0.785714286,1,6233
70175816b319974128da67c7fbd3c80ec8bc1ffe,0,Koji Kawamura,2017-03-07 22:17:23+09:00,['bf112d065434ed536fff10b7aaa5eb3b70bc4b9d'],4,2,6,2714909,2,,,,6233
01979aebec15dae755538e6c9b99ee952dfe523c,0,Aldrin Piri,2017-03-07 16:41:45-05:00,['70175816b319974128da67c7fbd3c80ec8bc1ffe'],1,1,2,2714911,1,,,,6233
1376e5fbd0cd5187ec319ab5ddf4f8e9e9f7297b,0,Aldrin Piri,2017-03-07 20:07:59-05:00,['01979aebec15dae755538e6c9b99ee952dfe523c'],0,2,2,2714913,1,,,,6233
90ff275bb9d792c97dc1c1ece3262a36b79bf623,0,Pierre Villard,2017-03-08 13:16:58+01:00,['1376e5fbd0cd5187ec319ab5ddf4f8e9e9f7297b'],6,40,46,2714959,2,0,0,1,6233
27afd2e0cccba77fd2a371f976deeb1ce2a56cde,1,Mark Payne,2017-03-08 17:31:22-05:00,['90ff275bb9d792c97dc1c1ece3262a36b79bf623'],316,147,463,2715422,2,1,1,0.847133758,6233
37e9c5efc7b4f1d88cc6a59fb81da301c74b6e1c,0,James Wing,2017-03-08 14:57:33-08:00,['27afd2e0cccba77fd2a371f976deeb1ce2a56cde'],1,10,11,2715433,2,0.714285714,0.714285714,1,6233
7f6373239fe8f0ce713e7ec6d35ae2831f382840,0,Andy LoPresto,2017-03-08 19:24:43-08:00,['37e9c5efc7b4f1d88cc6a59fb81da301c74b6e1c'],0,3,3,2715436,1,,,,6233
5a6373b16cb66d2c03fae31206caae7c20c23790,1,Andy LoPresto,2017-03-08 20:56:01-08:00,['7f6373239fe8f0ce713e7ec6d35ae2831f382840'],1,182,183,2715619,5,0.139534884,1,1,6235
3c862a151536f89155e0e132e0393f5e21477ae5,0,Matt Gilman,2017-03-09 08:13:46-05:00,['5a6373b16cb66d2c03fae31206caae7c20c23790'],3,5,8,2715627,1,,,,6235
c9097e7db3015ce43c1aa8980cfeba55a6b871f7,0,Matt Gilman,2017-03-09 08:23:28-05:00,['3c862a151536f89155e0e132e0393f5e21477ae5'],0,1,1,2715628,1,0,1,1,6235
c1e47f9b44a57304962b12524f999360e0faf365,0,joewitt,2017-03-09 21:50:02-05:00,['c9097e7db3015ce43c1aa8980cfeba55a6b871f7'],57,103,160,2715788,4,0,0,0,6235
443803e729d1f81ed5e0c8248d30a60ad0790614,0,joewitt,2017-03-09 22:00:41-05:00,['c1e47f9b44a57304962b12524f999360e0faf365'],2,7,9,2715797,3,,,,6235
cd8eb775e626cca351bf24f9ae174c38d32d591b,1,Matt Burgess,2017-03-10 10:50:52-05:00,['443803e729d1f81ed5e0c8248d30a60ad0790614'],6,58,64,2715861,5,0.324324324,0.864864865,0.945945946,6235
18f05856ffebd911a9681845434a3415a215451a,1,Matt Burgess,2017-03-10 11:34:16-05:00,['cd8eb775e626cca351bf24f9ae174c38d32d591b'],4,194,198,2716059,8,0.6,0.6,0.6,6237
977aa6919cd97dacb1214c631f7055646e109472,0,Andy LoPresto,2017-03-10 17:56:57-08:00,['18f05856ffebd911a9681845434a3415a215451a'],19,57,76,2716135,5,0.8,0.9,1,6237
ccd11816e451446bef2627ca642ece6785e4c339,0,joewitt,2017-03-12 16:34:33-04:00,['977aa6919cd97dacb1214c631f7055646e109472'],0,169,169,2716304,3,1,1,1,6239
9bb31a70d9e5ea7d8dabc017d5e1eb9c603f59e1,0,Scott Aslan,2017-03-13 12:18:22-04:00,['ccd11816e451446bef2627ca642ece6785e4c339'],0,9,9,2716313,1,0.333333333,1,1,6239
a61f353051cf065f053d7f186fb32b137986e13d,1,Bryan Bende,2017-03-13 12:21:49-04:00,['9bb31a70d9e5ea7d8dabc017d5e1eb9c603f59e1'],12,25,37,2716350,6,0,1,1,6239
620c572703e8cd55ef73e2c869932717ee88a29a,1,Scott Aslan,2017-03-13 12:35:46-04:00,['a61f353051cf065f053d7f186fb32b137986e13d'],4,37,41,2716391,1,0.111111111,0.111111111,0.481481481,6239
9d4239be1ead6f1501d1d39f148f701d7ff506a4,0,Scott Aslan,2017-03-13 13:48:11-04:00,['620c572703e8cd55ef73e2c869932717ee88a29a'],1,34,35,2716426,7,0,0,1,6239
bd9139010528b1ee2eb6351956e18cc592f1487d,1,Bryan Bende,2017-03-13 15:08:25-04:00,['9d4239be1ead6f1501d1d39f148f701d7ff506a4'],2,82,84,2716510,2,0.189655172,1,1,6239
94248364125d34527238220d82820160a2009108,0,James Wing,2017-03-13 14:22:14-07:00,['bd9139010528b1ee2eb6351956e18cc592f1487d'],2,4,6,2716516,2,0,0.5,1,6239
78382c66bc93181b3cfa2268a13da60074c9962f,1,Mike Moser,2017-03-14 13:58:06-04:00,['94248364125d34527238220d82820160a2009108'],5,15,20,2716536,1,0.727272727,0.727272727,1,6239
768e89b57938c41e64a275dc92053c88e7a421e2,1,Scott Aslan,2017-03-14 14:15:14-04:00,['78382c66bc93181b3cfa2268a13da60074c9962f'],29,65,94,2716630,3,0.576923077,0.538461538,0.538461538,6239
47c6718fe26c27b957f6b4a30f57eaf4089630ec,1,Scott Aslan,2017-03-17 11:46:25-04:00,['768e89b57938c41e64a275dc92053c88e7a421e2'],13,13,26,2716656,3,,,,6239
d05727b8c0bc08630a57457e3b39ae2deebbd6d3,1,James Wing,2017-03-17 10:39:05-07:00,['47c6718fe26c27b957f6b4a30f57eaf4089630ec'],0,1022,1022,2717678,15,0.238596491,0.628070175,0.561403509,6250
5daeba6e039d465b3ff19b5523b4c10d53475c83,0,Pierre Villard,2017-03-20 14:51:56+01:00,['d05727b8c0bc08630a57457e3b39ae2deebbd6d3'],0,23,23,2717701,2,0.9375,0.9375,1,6250
552148e9e7d45be4d298ee48afd7471405a5bfad,0,Mark Payne,2017-03-20 10:15:24-04:00,['5daeba6e039d465b3ff19b5523b4c10d53475c83'],6,2,8,2717709,1,0,0,0,6250
8e61aa3c43dcf7fb32d7607278d8c85869600c2e,1,Matt Gilman,2017-03-21 13:44:26-04:00,['552148e9e7d45be4d298ee48afd7471405a5bfad'],13,28,41,2717750,4,1,0,0,6251
b3b65219a0866a1fddcdc39a8475fd0d665a1476,1,Matt Gilman,2017-03-21 14:48:40-04:00,['8e61aa3c43dcf7fb32d7607278d8c85869600c2e'],57,142,199,2717949,3,,,,6251
40acd4a6e1e99ab21504e62977f2a268e23fbf06,1,Matt Gilman,2017-03-21 15:17:02-04:00,['b3b65219a0866a1fddcdc39a8475fd0d665a1476'],19,37,56,2718005,1,0,1,0.851851852,6251
c4d0c0bbd18759100641d0cbca0b584f8f20a813,1,Bryan Bende,2017-03-21 17:20:27-04:00,['40acd4a6e1e99ab21504e62977f2a268e23fbf06'],4,230,234,2718239,2,0,0.637837838,0.654054054,6251
37a1e6d07f9f8b10201c82f8610897f99142bd97,1,Joey Frazee,2017-03-22 14:57:42+00:00,['c4d0c0bbd18759100641d0cbca0b584f8f20a813'],1,175,176,2718415,3,0.52173913,0.52173913,0.52173913,6253
0b737155627533ac318f575ec4a899a36c120b88,0,Matt Burgess,2017-03-22 13:40:59-04:00,['37a1e6d07f9f8b10201c82f8610897f99142bd97'],28,55,83,2718498,2,0.869565217,0.956521739,0.826086957,6253
d1ebddce988da81737120de530a9c1bb28d1683d,1,Pierre Villard,2017-03-22 19:22:08+01:00,['0b737155627533ac318f575ec4a899a36c120b88'],62,226,288,2718786,14,0.711111111,0.955555556,0.955555556,6253
a90a770244fa9002a0999c20175e36582fbf994d,1,Matt Gilman,2017-03-22 14:23:02-04:00,['d1ebddce988da81737120de530a9c1bb28d1683d'],25,312,337,2719123,16,0.536585366,0.56097561,0.829268293,6253
eb37f300c71b71eed81a662d8fa51b4eef75975a,0,James Wing,2017-03-22 16:48:09-07:00,['a90a770244fa9002a0999c20175e36582fbf994d'],2,2,4,2719127,1,,,,6253
a298f1a7076a2a306a38e71bff1eb45da9614517,0,Pierre Villard,2017-03-23 09:04:16+01:00,['eb37f300c71b71eed81a662d8fa51b4eef75975a'],3,120,123,2719250,3,0.230769231,0.984615385,0.784615385,6253
2dd61125d13dd04798663cc8f1ef06436cf7bb16,1,Andre F de Miranda,2017-03-24 22:49:01+11:00,['a298f1a7076a2a306a38e71bff1eb45da9614517'],2,2,4,2719254,1,,,,6253
d90cf846b9dcd49acdeac7bb5fcd13ee80dcdba6,1,Mark Payne,2017-03-24 11:06:44-04:00,['2dd61125d13dd04798663cc8f1ef06436cf7bb16'],2261,8598,10859,2730113,335,0.398527865,0.772169646,0.794602173,6293
f0a1c14f025f6013ed3667ea4470cd34846756d7,0,Bryan Bende,2017-03-25 11:13:58-04:00,['d90cf846b9dcd49acdeac7bb5fcd13ee80dcdba6'],1,1,2,2730115,1,,,,6293
a26689318d68441f1e55b62e8ba64aab5bdfe053,0,Aldrin Piri,2017-03-26 11:41:15-04:00,['f0a1c14f025f6013ed3667ea4470cd34846756d7'],0,24,24,2730139,1,0,1,0.928571429,6293
ced6708d4bca6d179e5f9fbc0b2324102879d21e,1,Matt Burgess,2017-03-27 08:50:55-04:00,['a26689318d68441f1e55b62e8ba64aab5bdfe053'],6,48,54,2730193,2,0,0.558823529,1,6293
f15e0d8e1e5b7cbb727b2a6604d807c089e8abed,0,Bryan Bende,2017-03-27 16:43:15-04:00,['ced6708d4bca6d179e5f9fbc0b2324102879d21e'],2,2,4,2730197,1,,,,6293
4432958a65b0a3531004988fccc2339ec12f6d96,0,Bryan Bende,2017-03-27 16:44:21-04:00,['f15e0d8e1e5b7cbb727b2a6604d807c089e8abed'],4,4,8,2730205,1,,,,6293
17ec6264a0c9f494db1d8fbfc4a145222fccf591,0,Andy LoPresto,2017-03-27 14:19:49-07:00,['4432958a65b0a3531004988fccc2339ec12f6d96'],2,3,5,2730210,1,,,,6293
f9b5bcf7bba0147821b2862b9d015378260cebc1,1,Mark Payne,2017-03-28 10:53:16-04:00,['17ec6264a0c9f494db1d8fbfc4a145222fccf591'],0,71,71,2730281,5,0.833333333,0.916666667,1,6294
8eb377e308d25cf3a3f3b839e586a67fb9bc0763,0,Aldrin Piri,2017-03-28 16:11:00-04:00,['f9b5bcf7bba0147821b2862b9d015378260cebc1'],2,7,9,2730290,1,,,,6294
c324c9e21c464702cef5224bebd2748585264439,0,joewitt,2017-03-28 16:17:17-04:00,['8eb377e308d25cf3a3f3b839e586a67fb9bc0763'],0,4,4,2730294,2,,,,6294
168fc72bbab4a6516f6264f9e6ed7d0abc31d722,1,Matt Burgess,2017-03-29 10:31:56-04:00,['c324c9e21c464702cef5224bebd2748585264439'],1,1,2,2730296,1,,,,6294
83fa24b68f74843cc609bbc113ba930f847e4025,0,Yolanda M. Davis,2017-03-29 10:45:34-04:00,['168fc72bbab4a6516f6264f9e6ed7d0abc31d722'],77,105,182,2730478,1,0.461538462,0.461538462,1,6294
457df93dd6b0dccbe0dd437234aee53b76f010b4,1,Joey Frazee,2017-03-29 20:30:57+00:00,['83fa24b68f74843cc609bbc113ba930f847e4025'],31,1086,1117,2731595,14,0.351598174,0.776255708,0.753424658,6304
a7bf683a0da932ba70210878321d75999dfa8c0b,0,Matt Gilman,2017-03-30 08:54:24-04:00,['457df93dd6b0dccbe0dd437234aee53b76f010b4'],16,23,39,2731634,4,0,1,0.6,6304
3aa1db6ee5d952aa67601e460331940f5e20a166,1,Matt Burgess,2017-03-30 09:53:39-04:00,['a7bf683a0da932ba70210878321d75999dfa8c0b'],163,362,525,2732159,10,0,0.772727273,0.386363636,6306
e20353516339b78d2a1eae2828c620c4d4876805,1,joewitt,2017-03-30 14:55:17-04:00,['3aa1db6ee5d952aa67601e460331940f5e20a166'],100,179,279,2732438,2,0.362204724,1,0.976377953,6306
282e1a7b1a7123abe21de8ac022b7f5636da79da,0,joewitt,2017-03-30 15:14:41-04:00,['e20353516339b78d2a1eae2828c620c4d4876805'],11,12,23,2732461,1,0,0,0,6306
fd92999dafc040940011c87bb2ee2c8edf5f96a2,1,Bryan Bende,2017-03-30 16:29:40-04:00,['282e1a7b1a7123abe21de8ac022b7f5636da79da'],10,157,167,2732628,6,0.177570093,0.626168224,1,6306
091359b450a7d0fb6bb04e2238c9171728cd2720,0,joewitt,2017-03-30 16:46:53-04:00,['fd92999dafc040940011c87bb2ee2c8edf5f96a2'],4,7,11,2732639,1,0,0,1,6306
6a64b3cd9cca70e6a27b9034eba520ae0c0cb6ca,1,joewitt,2017-03-31 01:59:35-04:00,['091359b450a7d0fb6bb04e2238c9171728cd2720'],27,122,149,2732788,11,0.465116279,0.976744186,0.976744186,6306
84f1fb395963614a2ff78a615c92fc79a52e2942,0,Matt Burgess,2017-03-31 23:41:02-04:00,['6a64b3cd9cca70e6a27b9034eba520ae0c0cb6ca'],6,9,15,2732803,6,,,,6306
5e62b4ae72c6fa8c81aa3ee817ad1bd14e350c4a,0,Mark Payne,2017-04-03 09:50:47-04:00,['84f1fb395963614a2ff78a615c92fc79a52e2942'],32,36,68,2732871,1,0,0,0,6306
a565484ddd5600adf9cdd811f7abe4a45cbbfb27,1,Bryan Bende,2017-04-04 17:40:09-04:00,['5e62b4ae72c6fa8c81aa3ee817ad1bd14e350c4a'],4,337,341,2733212,3,0.203296703,0.346153846,1,6307
f5f54c468c96eeef7726864a4af354882fbea712,0,Bryan Bende,2017-04-05 13:22:35-04:00,['a565484ddd5600adf9cdd811f7abe4a45cbbfb27'],14,43,57,2733269,2,1,1,1,6307
3386839ebc4a16029fc40a1b2702017b1ab39fa3,1,Tony Kurc,2017-04-05 23:09:48-04:00,['f5f54c468c96eeef7726864a4af354882fbea712'],24,147,171,2733440,5,0.36,1,1,6308
8f37ad4512fdca1627938b9ae4fd40b02ab2999d,1,ijokarumawak,2017-04-07 00:44:42+09:00,['3386839ebc4a16029fc40a1b2702017b1ab39fa3'],0,4111,4111,2737551,50,0.444237918,0.6133829,0.57063197,6355
556f309df086fefdcc6ca717294eaa91d3a4e113,1,Matt Gilman,2017-04-06 13:51:08-04:00,['8f37ad4512fdca1627938b9ae4fd40b02ab2999d'],810,1408,2218,2739769,98,0.424657534,1,1,6360
614fa6a6c4272d07c7db6273c15c97c215ad8e7e,0,Bryan Bende,2017-04-06 15:09:49-04:00,['556f309df086fefdcc6ca717294eaa91d3a4e113'],1,88,89,2739858,2,0.340425532,0.723404255,0.914893617,6360
c7ecaba234ced2de4985fca1a4e653462d7bb590,1,Matt Gilman,2017-04-06 16:04:27-04:00,['614fa6a6c4272d07c7db6273c15c97c215ad8e7e'],20,18,38,2739896,1,1,1,0,6360
6a75ab1740397ae5247f9bd302182cc846a8a2bd,0,Bryan Bende,2017-04-07 09:58:15-04:00,['c7ecaba234ced2de4985fca1a4e653462d7bb590'],8,8,16,2739912,1,,,,6360
292dd1d66b1726794f0d34523578727ea3a7fe08,0,Bryan Bende,2017-04-07 10:28:27-04:00,['6a75ab1740397ae5247f9bd302182cc846a8a2bd'],14,104,118,2740030,3,0,0.890410959,1,6360
e8771e59a7ebb40541d532f4c7aa6b0b3c830667,1,Bryan Bende,2017-04-07 10:42:11-04:00,['292dd1d66b1726794f0d34523578727ea3a7fe08'],5,27,32,2740062,1,1,1,1,6360
35f4f48f3778b7f358ac763fea1a8b7de4b354e4,0,Scott Aslan,2017-04-07 13:03:01-04:00,['e8771e59a7ebb40541d532f4c7aa6b0b3c830667'],4,24,28,2740090,1,1,1,1,6360
a5d630672a7b24ca1f60073182209b998172c0b3,0,joewitt,2017-04-07 13:22:46-04:00,['35f4f48f3778b7f358ac763fea1a8b7de4b354e4'],81,49,130,2740220,2,1,1,0,6360
778ba3957e7d1b9ddc105b1655f53e85cf6ec2ab,0,joewitt,2017-04-07 14:42:18-04:00,['a5d630672a7b24ca1f60073182209b998172c0b3'],26,55,81,2740301,3,0,1,1,6360
4bfb905f37d5084f70f228185431c16ce73369fb,1,joewitt,2017-04-07 21:52:33-04:00,['778ba3957e7d1b9ddc105b1655f53e85cf6ec2ab'],11,95,106,2740407,4,0,0.467741935,0.64516129,6360
61c799d88b53c72cd38fad820284ecd115a6cf1b,0,joewitt,2017-04-10 08:51:10-04:00,['4bfb905f37d5084f70f228185431c16ce73369fb'],58,56,114,2740521,2,1,1,0,6360
02d38b55bf43e8becf62029c994eba4535cae8f8,1,Andre F de Miranda,2017-04-11 00:00:07+10:00,['61c799d88b53c72cd38fad820284ecd115a6cf1b'],1,58,59,2740580,2,0,0.547619048,1,6360
2589df80ab1eb70327c6ed836f269967caee35fe,0,Andre F de Miranda,2017-04-11 02:05:20+10:00,['02d38b55bf43e8becf62029c994eba4535cae8f8'],11,0,11,2740591,1,,,,6360
c614a744377d2f26883d79aaf06862e832e99755,0,Andre F de Miranda,2017-04-11 02:08:14+10:00,['2589df80ab1eb70327c6ed836f269967caee35fe'],0,0,0,2740591,0,,,,6360
9583ca99c1e4b2d3c43511939a2a148d20f8e1ac,1,Matt Burgess,2017-04-10 14:03:22-04:00,['c614a744377d2f26883d79aaf06862e832e99755'],29,1086,1115,2741706,8,0.301204819,0.901893287,0.950086059,6362
8a5398eba771f0cb7733eb552c91e072c1ed40f8,1,joewitt,2017-04-11 00:00:09-04:00,['9583ca99c1e4b2d3c43511939a2a148d20f8e1ac'],18,93,111,2741817,4,0,0,1,6362
5419891fe760746f3fd4bb5c397d9a43b79f8281,1,joewitt,2017-04-11 00:37:12-04:00,['8a5398eba771f0cb7733eb552c91e072c1ed40f8'],18,663,681,2742498,15,0.365482234,0.847715736,0.847715736,6368
776a00b0be4cc9160e0596b714ff7613cc248e14,0,Andre F de Miranda,2017-04-11 21:18:49+10:00,['5419891fe760746f3fd4bb5c397d9a43b79f8281'],5,5,10,2742508,2,,,,6368
7c19796eb22ced9aba703e52e76e58450e34d018,0,Andre F de Miranda,2017-04-11 21:27:53+10:00,['776a00b0be4cc9160e0596b714ff7613cc248e14'],1,1,2,2742510,1,,,,6368
4a8398bb31173f4a00bb52bbf227af0c5b49876d,0,joewitt,2017-04-11 14:25:04-04:00,['7c19796eb22ced9aba703e52e76e58450e34d018'],58,6,64,2742574,3,,,,6368
52cf9a7953ef1e80087dfbc2fb42ee9c0bd2f2de,1,James Wing,2017-04-11 15:56:25-07:00,['4a8398bb31173f4a00bb52bbf227af0c5b49876d'],78,430,508,2743082,5,,,,6368
4d5872a38500ed0541d7689107b34daedb5b7e34,0,Matt Burgess,2017-04-11 19:29:04-04:00,['52cf9a7953ef1e80087dfbc2fb42ee9c0bd2f2de'],0,1066,1066,2744148,11,0.43452381,0.636904762,0.773809524,6378
a88d3bfa3c53d9cbe375f2b89eaa9248eb92df29,1,Matt Burgess,2017-04-11 19:29:04-04:00,['4d5872a38500ed0541d7689107b34daedb5b7e34'],1140,9838,10978,2755126,110,0.273471775,0.639368236,0.824217607,6467
68c592ea43d30754ec07c42cf10563fe9db185ae,1,Matt Burgess,2017-04-11 19:29:35-04:00,['a88d3bfa3c53d9cbe375f2b89eaa9248eb92df29'],4379,4336,8715,2763841,129,0,1,1,6486
deed25656facf6cf88bcd9425a1ddc66cf23d332,0,Matt Gilman,2017-04-13 14:32:30-04:00,['68c592ea43d30754ec07c42cf10563fe9db185ae'],11,5,16,2763857,1,0.4,0.4,0,6486
5f73ba7f2cca845a3e2afca715e60e7b1e3c4bc9,0,Matt Burgess,2017-04-14 22:13:09-04:00,['deed25656facf6cf88bcd9425a1ddc66cf23d332'],1,1,2,2763859,1,,,,6486
edb9c644ddd75be058e600e2dbe1950270115299,0,ijokarumawak,2017-04-18 00:55:17+09:00,['5f73ba7f2cca845a3e2afca715e60e7b1e3c4bc9'],5,5,10,2763869,4,,,,6486
d08233b9fe35b8e0182f5357b833a302993d1d6e,1,Yolanda M. Davis,2017-04-18 07:41:21-04:00,['edb9c644ddd75be058e600e2dbe1950270115299'],106,34,140,2764009,8,0.428571429,0,0,6486
7e1ecad738396e78b4cf7997548d539cb5df8bf2,0,Bryan Bende,2017-04-18 09:46:21-04:00,['d08233b9fe35b8e0182f5357b833a302993d1d6e'],3,2,5,2764014,2,1,1,0,6486
cd260bab9f768b28e030794358d263d2b175baa0,0,Aldrin Piri,2017-04-18 10:27:15-04:00,['7e1ecad738396e78b4cf7997548d539cb5df8bf2'],1,824,825,2764839,12,0.464646465,0.626262626,1,6494
189b4ad63dc88eacccc22cdba9f46ef5f88f5363,0,joewitt,2017-04-18 14:07:38-04:00,['cd260bab9f768b28e030794358d263d2b175baa0'],2,0,2,2764841,1,,,,6494
220a870a1ece8c6cff589321de13e99850748e92,0,Scott Aslan,2017-04-18 16:08:10-04:00,['189b4ad63dc88eacccc22cdba9f46ef5f88f5363'],3,3,6,2764847,1,,,,6494
7e7f9a5deb4f60d4612e7419902e12ac82ad4c52,0,Mark Payne,2017-04-19 15:49:11-04:00,['220a870a1ece8c6cff589321de13e99850748e92'],27,26,53,2764900,1,0,0,1,6494
b93cf7bbdb3daf400845be6538b4eea66be571cc,1,Matt Burgess,2017-04-19 16:12:14-04:00,['7e7f9a5deb4f60d4612e7419902e12ac82ad4c52'],4,337,341,2765241,5,0.135135135,0.722972973,0.966216216,6496
141334c3c9db76c658af2edcd62652a50ba26a4b,1,Matt Burgess,2017-04-19 17:04:45-04:00,['b93cf7bbdb3daf400845be6538b4eea66be571cc'],2,4,6,2765247,1,0,1,1,6496
0207f21ce4bb68536843d65ecc9110ec834028cd,1,joewitt,2017-04-19 21:44:23-07:00,['141334c3c9db76c658af2edcd62652a50ba26a4b'],96,983,1079,2766326,27,0.503225806,0.789247312,0.984946237,6502
0f2ac39f69c1a744f151f0d924c9978f6790b7f7,1,joewitt,2017-04-19 22:08:59-07:00,['0207f21ce4bb68536843d65ecc9110ec834028cd'],13,219,232,2766558,3,0.173913043,0.724637681,0.898550725,6502
0ddb90cd2deff32a20df6a7e60009758ce21712d,0,joewitt,2017-04-19 22:18:43-07:00,['0f2ac39f69c1a744f151f0d924c9978f6790b7f7'],48,313,361,2766919,6,0.090909091,1,0.825757576,6504
8ce2a1b3a7318de244f4c6a22a20943d1b056c4e,0,joewitt,2017-04-19 22:19:41-07:00,['0ddb90cd2deff32a20df6a7e60009758ce21712d'],11,16,27,2766946,5,0,0.75,1,6504
816034bd01c2ac2ee480f6a82aca146e250c2101,1,joewitt,2017-04-19 22:50:48-07:00,['8ce2a1b3a7318de244f4c6a22a20943d1b056c4e'],6,22,28,2766974,2,0.875,0.875,0.125,6504
769e874677ee5cfe1ee483c6a9b49f8db89ed93f,0,Koji Kawamura,2017-04-21 08:21:56+09:00,['816034bd01c2ac2ee480f6a82aca146e250c2101'],57,80,137,2767111,3,0.733333333,0.6,1,6504
1c9ea249f77f5cc7675510a143a8f6c15ddeaa85,0,Koji Kawamura,2017-04-21 16:24:13+09:00,['769e874677ee5cfe1ee483c6a9b49f8db89ed93f'],7,1,8,2767119,2,0,0,0,6504
2f928490e3c787aba21b7fbe0c8614a17aef1454,1,Matt Gilman,2017-04-21 08:24:14-04:00,['1c9ea249f77f5cc7675510a143a8f6c15ddeaa85'],9,9,18,2767137,2,0.666666667,0,0,6504
0b95ccb90a7ef10039ca9941e4297aa90b2a0615,0,Scott Aslan,2017-04-21 09:48:24-04:00,['2f928490e3c787aba21b7fbe0c8614a17aef1454'],3,9,12,2767149,2,0,0,1,6504
57ccf97c587834f36fac5328cdfe75043d833f94,0,Matt Gilman,2017-04-21 14:37:27-04:00,['0b95ccb90a7ef10039ca9941e4297aa90b2a0615'],27,58,85,2767234,1,0,0,1,6504
50ea1083ec416c5d6e70c4e7bb5b2abde8f6266c,1,joewitt,2017-04-24 17:02:45-04:00,['57ccf97c587834f36fac5328cdfe75043d833f94'],838,3684,4522,2771756,100,0.628892734,0.806228374,0.438581315,6531
ba2bdf858672e935da60861cfc412e2b55f35652,1,Koji Kawamura,2017-04-25 14:40:24+09:00,['50ea1083ec416c5d6e70c4e7bb5b2abde8f6266c'],8,85,93,2771849,2,0,0,0.142857143,6531
c0f0462e8bc829d5e4ac2415a9fa77d3f5d6bdc3,1,Andy LoPresto,2017-04-24 23:08:37-07:00,['ba2bdf858672e935da60861cfc412e2b55f35652'],3,3900,3903,2775752,51,0.162790698,0.162790698,1,6572
995c7ce2fa5799bd2bbcc09c205dc823b2b405d5,1,Andy LoPresto,2017-04-25 00:32:58-07:00,['c0f0462e8bc829d5e4ac2415a9fa77d3f5d6bdc3'],41,105,146,2775898,3,0,0.585365854,1,6572
9ed001869b4887f57e108764354557391092ecab,0,Mark Payne,2017-04-25 09:59:43-04:00,['995c7ce2fa5799bd2bbcc09c205dc823b2b405d5'],22,22,44,2775942,2,1,1,1,6572
26ca40c0d916b4ac1426ee15535601b2c1c493e9,1,Koji Kawamura,2017-04-25 23:37:09+09:00,['9ed001869b4887f57e108764354557391092ecab'],10,103,113,2776055,2,0,0,0.25,6572
879fe3efd6100c0ec5ad23efa705ce3f54a3b365,0,Scott Aslan,2017-04-25 12:28:49-04:00,['26ca40c0d916b4ac1426ee15535601b2c1c493e9'],0,0,0,2776055,159,,,,6572
ee4b88620aeb72ab2ff8fe62de474a1f0a8dd4ad,0,Scott Aslan,2017-04-25 12:47:48-04:00,['879fe3efd6100c0ec5ad23efa705ce3f54a3b365'],0,0,0,2776055,5,,,,6572
49a62448ce397aa7719b556c26742b8193be281e,1,Andy LoPresto,2017-04-25 10:57:21-07:00,['ee4b88620aeb72ab2ff8fe62de474a1f0a8dd4ad'],0,1111,1111,2777166,10,0.32,0.431111111,0.862222222,6581
ef5bac207ee52d493c5cfaa5908cf3d839c05e10,1,Bryan Bende,2017-04-25 16:38:46-04:00,['49a62448ce397aa7719b556c26742b8193be281e'],30,233,263,2777429,5,1,0,1,6583
4303e4742adc0b9707b88427c8a167580f5d717d,1,Koji Kawamura,2017-04-26 09:50:50+09:00,['ef5bac207ee52d493c5cfaa5908cf3d839c05e10'],1,1658,1659,2779088,4,0.171851852,0.202962963,0.58962963,6586
5cacc52cfc70877f262218297fd54bb3ace72ce3,1,Matt Burgess,2017-04-26 09:10:48-04:00,['4303e4742adc0b9707b88427c8a167580f5d717d'],93,597,690,2779778,5,0.42920354,0.703539823,1,6589
97461657b1fe3193e028d2a085734415563a26d8,0,Pierre Villard,2017-04-26 22:54:49+02:00,['5cacc52cfc70877f262218297fd54bb3ace72ce3'],11,13,24,2779802,2,0.25,0.25,1,6589
24bb8cf95d7228555215aadb1e46c62e1f0bff91,1,Koji Kawamura,2017-04-27 08:26:33+09:00,['97461657b1fe3193e028d2a085734415563a26d8'],18,18,36,2779838,6,,,,6589
da0454d80f5c0e5b0268dbd279a80d21d62e7c85,0,Koji Kawamura,2017-04-27 08:35:34+09:00,['24bb8cf95d7228555215aadb1e46c62e1f0bff91'],0,31,31,2779869,2,0,0,0,6589
d66eac2ea10047d0e12eadb597333e5095076953,0,Koji Kawamura,2017-04-27 08:42:01+09:00,['da0454d80f5c0e5b0268dbd279a80d21d62e7c85'],0,41,41,2779910,2,0,0,0,6589
097548da9db218d251b43e73e2e189b89eef8510,1,Koji Kawamura,2017-04-27 08:43:13+09:00,['d66eac2ea10047d0e12eadb597333e5095076953'],35,77,112,2780022,2,1,1,0,6589
cf0e8bb1d39e4407f497f6bc03fc4fc7f8209c9a,0,Koji Kawamura,2017-04-27 10:40:35+09:00,['097548da9db218d251b43e73e2e189b89eef8510'],1,37,38,2780060,2,0,0,0,6589
a41a2a9b1ab79b558831177e91e8fde49d6e748a,1,Matt Gilman,2017-04-27 10:35:07-04:00,['cf0e8bb1d39e4407f497f6bc03fc4fc7f8209c9a'],39,908,947,2781007,24,0.26119403,0.552238806,0.835820896,6591
55b8c7ddadfd3704c6dde07c1276dab81942538c,1,Matt Gilman,2017-04-27 12:42:12-04:00,['a41a2a9b1ab79b558831177e91e8fde49d6e748a'],59,713,772,2781779,12,0,0,0,6593
a1bffbcc872c009e4de477f72a29ebe33310ec3f,1,joewitt,2017-04-27 12:51:01-04:00,['55b8c7ddadfd3704c6dde07c1276dab81942538c'],1,514,515,2782294,6,0.173745174,0.671814672,0.930501931,6596
d9acdb54bec96695837f8fcde54c58403aa46f29,1,Matt Burgess,2017-04-27 13:44:56-04:00,['a1bffbcc872c009e4de477f72a29ebe33310ec3f'],1005,3856,4861,2787155,22,0.404903418,1,0.718424963,6606
726d15d1f79cb2514abb26710dbe4e60448eb874,1,joewitt,2017-04-27 14:56:52-04:00,['d9acdb54bec96695837f8fcde54c58403aa46f29'],48,1094,1142,2788297,13,0.404255319,0.39893617,0.989361702,6614
49a9bc88c66d84c30d7ed2f213b35d2835ffc3e5,0,joewitt,2017-04-27 15:04:51-04:00,['726d15d1f79cb2514abb26710dbe4e60448eb874'],5,6,11,2788308,1,0,0,0,6614
6512306fa4b18a4f9ee688eb1af62b2cd6bd24b8,0,Scott Aslan,2017-04-27 15:42:44-04:00,['49a9bc88c66d84c30d7ed2f213b35d2835ffc3e5'],14,12,26,2788334,1,,,,6614
8651d7977872b5a45df3fbf2c801ef3d5877b286,0,Koji Kawamura,2017-04-28 11:16:35+09:00,['6512306fa4b18a4f9ee688eb1af62b2cd6bd24b8'],1,1,2,2788336,1,,,,6614
d61f5193261844661aedec68152db6fa78787a31,1,Koji Kawamura,2017-04-28 11:34:43+09:00,['8651d7977872b5a45df3fbf2c801ef3d5877b286'],8,71,79,2788415,2,0,0,0,6614
2664ea093d7afa33a7bf3780ea8b84608ee7783c,0,joewitt,2017-04-28 00:02:03-04:00,['d61f5193261844661aedec68152db6fa78787a31'],1,2,3,2788418,1,,,,6614
aa4efb43ca5dc85b55bc39c180ca447f4e9e3e01,1,Koji Kawamura,2017-04-28 13:16:01+09:00,['2664ea093d7afa33a7bf3780ea8b84608ee7783c'],14,129,143,2788561,6,0.888888889,0.888888889,0.814814815,6614
0054a9e35fb06b749c4ef2253c918e74c3899ef9,1,Bryan Bende,2017-04-28 11:45:43-04:00,['aa4efb43ca5dc85b55bc39c180ca447f4e9e3e01'],8,265,273,2788834,4,0.453125,0.609375,0.9296875,6616
7df5c2dc891a57f382075d868244f843de6fd960,1,Andre F de Miranda,2017-05-01 09:31:24+10:00,['0054a9e35fb06b749c4ef2253c918e74c3899ef9'],9,75,84,2788918,4,0.378378378,1,1,6616
ea6320d621398713c6aec98e0d79509fd8586e17,1,Bryan Bende,2017-05-01 09:55:10-04:00,['7df5c2dc891a57f382075d868244f843de6fd960'],1,763,764,2789682,3,0.279749478,0.64091858,0.532359081,6618
de67e5f7d5e294dee4df6e809fad8b7aa507468b,0,Bryan Bende,2017-05-01 09:55:17-04:00,['ea6320d621398713c6aec98e0d79509fd8586e17'],7,7,14,2789696,2,,,,6618
9ad7802284e2688f8682869f62bbd3605dde357c,0,Bryan Bende,2017-05-01 10:00:33-04:00,['de67e5f7d5e294dee4df6e809fad8b7aa507468b'],4,44,48,2789744,4,1,1,1,6618
25295cdb4d4653303e9b3ba7bd2c518b8d81295c,0,Andre F de Miranda,2017-05-02 00:20:04+10:00,['9ad7802284e2688f8682869f62bbd3605dde357c'],1,1,2,2789746,1,,,,6618
a9a9b67430b33944b5eefa17cb85b5dd42c8d1fc,0,Andre F de Miranda,2017-05-02 00:25:42+10:00,['25295cdb4d4653303e9b3ba7bd2c518b8d81295c'],5,2,7,2789753,1,,,,6618
da6ad4f3bcdeb43783aafa9f8942c5fa2a7da20b,1,Bryan Bende,2017-05-01 10:41:12-04:00,['a9a9b67430b33944b5eefa17cb85b5dd42c8d1fc'],41,72,113,2789866,1,0,0,0.7,6618
0a7b9467e9f102caf8a12b36a3f92ff43918ad9d,1,Scott Aslan,2017-05-01 13:13:54-04:00,['da6ad4f3bcdeb43783aafa9f8942c5fa2a7da20b'],6,8,14,2789880,1,,,,6618
11b935a27baa3852fb066ed96fd3b66fef3ae070,0,Scott Aslan,2017-05-01 15:37:13-04:00,['0a7b9467e9f102caf8a12b36a3f92ff43918ad9d'],0,10,10,2789890,2,,,,6619
60d88b5a64286776ffc2c9088905ac78a1a56786,1,Andy LoPresto,2017-05-01 16:10:35-04:00,['11b935a27baa3852fb066ed96fd3b66fef3ae070'],964,4364,5328,2795218,163,0.458254269,0.759962049,0.908918406,6651
946f4a1a28454763ede76553a554ef62197fdc51,0,Andy LoPresto,2017-05-01 17:19:25-04:00,['60d88b5a64286776ffc2c9088905ac78a1a56786'],12,110,122,2795340,3,,,,6652
07989b84601a41ea50038d456da3c0964d45ff83,1,joewitt,2017-05-01 18:47:51-04:00,['946f4a1a28454763ede76553a554ef62197fdc51'],305,2579,2884,2798224,50,0.213002566,0.634730539,0.686056459,6659
b96e402e78caca0dae58b7def37992cb56ee246e,0,joewitt,2017-05-01 22:51:05-04:00,['07989b84601a41ea50038d456da3c0964d45ff83'],1,6,7,2798231,1,,,,6659
40de1b18d9e6c55cdf39842c5200b5d43f10dbde,0,joewitt,2017-05-02 00:21:15-04:00,['b96e402e78caca0dae58b7def37992cb56ee246e'],1,7,8,2798239,1,0.4,0.4,0.4,6659
016ae3191e936a3f87b895efd36654852c21238c,1,joewitt,2017-05-02 00:31:30-04:00,['40de1b18d9e6c55cdf39842c5200b5d43f10dbde'],43,169,212,2798451,5,0.036144578,0.963855422,1,6659
be9e317000fadc9746f89fd12a0a45a418091f12,0,Andre F de Miranda,2017-05-02 18:48:48+10:00,['016ae3191e936a3f87b895efd36654852c21238c'],0,0,0,2798451,0,,,,6659
3bfe323a5dc33cf9ffbef8d0f5ee5f43ca507696,0,Mark Payne,2017-05-02 08:44:01-04:00,['be9e317000fadc9746f89fd12a0a45a418091f12'],1,1,2,2798453,1,,,,6659
82829927aed904434c18cb55d589209a9aa02a46,1,Scott Aslan,2017-05-02 09:43:54-04:00,['3bfe323a5dc33cf9ffbef8d0f5ee5f43ca507696'],33,73,106,2798559,4,1,1,1,6659
8fa35294eb5c11ee368a76d5e5ecdf171633d7c4,0,Bryan Bende,2017-05-02 09:59:39-04:00,['82829927aed904434c18cb55d589209a9aa02a46'],11,22,33,2798592,1,1,1,1,6659
0a014b471bb11c2d15b5f166e09915eeb319f352,0,Jeremy Dyer,2017-05-02 10:02:55-04:00,['8fa35294eb5c11ee368a76d5e5ecdf171633d7c4'],35,217,252,2798844,11,0,0.734513274,1,6659
cca5c420954527d44cadf08b7d23edfdfb5314e9,1,Jeremy Dyer,2017-05-02 10:02:55-04:00,['0a014b471bb11c2d15b5f166e09915eeb319f352'],3,16,19,2798863,2,1,1,1,6659
eb12b932ab209d41cde5ad62668011043e0daebf,0,Matt Burgess,2017-05-02 10:08:56-04:00,['cca5c420954527d44cadf08b7d23edfdfb5314e9'],1,6,7,2798870,1,,,,6659
fae2e3aa21201d3aa826c96129661cb68f7a2453,1,Matt Gilman,2017-05-02 13:07:18-04:00,['eb12b932ab209d41cde5ad62668011043e0daebf'],24,129,153,2799023,2,,,,6659
7d242076ce1d0a555e2ea68d88f29b7461d37b9a,1,Andy LoPresto,2017-05-02 13:24:07-04:00,['fae2e3aa21201d3aa826c96129661cb68f7a2453'],462,3962,4424,2803447,85,0.63670412,0.685393258,0.759051186,6678
3488a169caa06edaf527edc1273acb36682a1d77,1,Bryan Rosander,2017-05-02 14:39:16-04:00,['7d242076ce1d0a555e2ea68d88f29b7461d37b9a'],10,1114,1124,2804571,14,0.587378641,0.871359223,1,6689
f30c8169abe8705911b0cdac18aa90f3a217dc78,0,Bryan Rosander,2017-05-02 14:39:37-04:00,['3488a169caa06edaf527edc1273acb36682a1d77'],109,205,314,2804885,14,0,0,0,6692
26d90fbccfa2c4c376e663f6be9c12856decc592,1,Bryan Rosander,2017-05-02 14:39:46-04:00,['f30c8169abe8705911b0cdac18aa90f3a217dc78'],283,193,476,2805361,26,0,0,1,6692
580d65dfdef8c233a9457d848bba6ff1df02c39c,1,Andy LoPresto,2017-05-02 16:41:47-04:00,['26d90fbccfa2c4c376e663f6be9c12856decc592'],43,53,96,2805457,2,,,,6692
16f37763f6d7c678757889a4cff914c2f65f4ed1,0,Andy LoPresto,2017-05-02 17:37:18-04:00,['580d65dfdef8c233a9457d848bba6ff1df02c39c'],0,35,35,2805492,3,,,,6694
daa277b06772f2408895a01bf19c0aa09a4f177d,0,joewitt,2017-05-02 17:43:26-04:00,['16f37763f6d7c678757889a4cff914c2f65f4ed1'],2,3,5,2805497,2,1,1,1,6694
960ef9142d08be3d93837e1551029616f2dd5d91,0,Yolanda M. Davis,2017-05-03 09:01:59-04:00,['daa277b06772f2408895a01bf19c0aa09a4f177d'],0,142,142,2805639,2,,,,6695
54d47c7f74831c5b68d71788acb3a7b396757f8f,1,Matt Burgess,2017-05-03 09:18:17-04:00,['960ef9142d08be3d93837e1551029616f2dd5d91'],49,1140,1189,2806828,16,0.512605042,0.859243697,1,6706
ce233bdbbb78f55ff2c41681bdb709c3e3ec0bf9,1,Bryan Bende,2017-05-03 11:04:08-04:00,['54d47c7f74831c5b68d71788acb3a7b396757f8f'],18,27,45,2806873,1,0,0,0,6706
e723a2c5c4ae49f97b367d3495bf2a6686be8f91,1,Matt Gilman,2017-05-03 11:15:48-04:00,['ce233bdbbb78f55ff2c41681bdb709c3e3ec0bf9'],6,40,46,2806919,1,0.545454545,0.545454545,1,6706
b7c15c360b63c717c7de0e724573a24b3b346d85,1,Matt Burgess,2017-05-03 11:53:40-04:00,['e723a2c5c4ae49f97b367d3495bf2a6686be8f91'],1,1,2,2806921,1,,,,6706
9b177fbcbabe67b9ebb1d0a5d3fafe7b67aebda1,0,Bryan Bende,2017-05-03 13:13:43-04:00,['b7c15c360b63c717c7de0e724573a24b3b346d85'],30,169,199,2807120,15,0.873015873,0.904761905,0.73015873,6707
1e75f33677b47900a402e772901d80a7076c34fe,0,Bryan Bende,2017-05-03 14:07:18-04:00,['9b177fbcbabe67b9ebb1d0a5d3fafe7b67aebda1'],45,0,45,2807165,1,,,,6707
98fb58975f25b3d58868a9c18e5f1869fe97efa6,0,Pierre Villard,2017-05-04 07:45:08+02:00,['1e75f33677b47900a402e772901d80a7076c34fe'],0,1,1,2807166,1,,,,6707
5dac189601e6738cc9a1882a8c46d71ec1b7535d,1,Bryan Bende,2017-05-04 08:56:06-04:00,['98fb58975f25b3d58868a9c18e5f1869fe97efa6'],5,2,7,2807173,2,,,,6707
b710420f091605640bf47ec1565102bd9d8cc754,0,Bryan Bende,2017-05-04 09:08:18-04:00,['5dac189601e6738cc9a1882a8c46d71ec1b7535d'],2,2,4,2807177,1,,,,6707
970ddf8f7e471f02835b3b2e3cf46cfabcc801e0,1,Bryan Bende,2017-05-04 10:50:22-04:00,['b710420f091605640bf47ec1565102bd9d8cc754'],3,39,42,2807219,1,0,1,1,6707
f3745065b058d2ed6fa17336ae73a8329c250f9a,1,Andy LoPresto,2017-05-04 12:05:24-04:00,['970ddf8f7e471f02835b3b2e3cf46cfabcc801e0'],55,73,128,2807347,3,0.2,0.2,1,6707
4f40eca16ce64b0acfd60fe76d974a4e13a9951b,0,Bryan Rosander,2017-05-04 12:09:52-04:00,['f3745065b058d2ed6fa17336ae73a8329c250f9a'],15,14,29,2807376,1,,,,6707
7f2f38be5237a2f8064ca58b52f9587b4f0920a3,0,Matt Gilman,2017-05-04 12:13:06-04:00,['4f40eca16ce64b0acfd60fe76d974a4e13a9951b'],10,41,51,2807427,1,,,,6707
d9410d640475b73d215bd3da6c14cb599e778a64,0,James Wing,2017-05-04 10:09:25-07:00,['7f2f38be5237a2f8064ca58b52f9587b4f0920a3'],35,17,52,2807479,2,,,,6707
85405dae15ee76128818634c7bd45201a8b1a2d2,0,Matt Gilman,2017-05-05 12:37:56-04:00,['d9410d640475b73d215bd3da6c14cb599e778a64'],3,4,7,2807486,1,,,,6707
af6f63691cdeee802da7f6d9ddf8b21b2bc40760,0,Bryan Bende,2017-05-05 13:25:59-04:00,['85405dae15ee76128818634c7bd45201a8b1a2d2'],75,45,120,2807606,1,0.208333333,1,0,6707
e6be5d327688e94c149c02d4be61aadaa017fef0,0,Andy LoPresto,2017-05-05 13:50:21-04:00,['af6f63691cdeee802da7f6d9ddf8b21b2bc40760'],6,9,15,2807621,2,,,,6707
12249e5a08e40c550786edc83abd9d11454002fb,0,Bryan Bende,2017-05-05 13:58:10-04:00,['e6be5d327688e94c149c02d4be61aadaa017fef0'],1,8,9,2807630,1,0,0,1,6707
ee8dc7640fe36a99195c5ffd62610a76738f77d9,0,Bryan Bende,2017-05-05 14:45:40-04:00,['12249e5a08e40c550786edc83abd9d11454002fb'],37,44,81,2807711,22,,,,6707
f0dfcc180de9fd23db0141b2f48126d90bc23760,0,Scott Aslan,2017-05-05 15:19:28-04:00,['ee8dc7640fe36a99195c5ffd62610a76738f77d9'],10,10,20,2807731,2,,,,6707
5f65b2561a25a10289a1a10c5325042ed988b105,0,Matt Burgess,2017-05-05 15:25:08-04:00,['f0dfcc180de9fd23db0141b2f48126d90bc23760'],13,58,71,2807802,2,0,0.653846154,1,6707
d069bf9c3ee83a6fa41f36065131f72ade74fc70,0,joewitt,2017-05-05 16:12:28-04:00,['5f65b2561a25a10289a1a10c5325042ed988b105'],16,4,20,2807822,1,,,,6707
829c02b058199bff167b4e78934584cabc92de78,0,Scott Aslan,2017-05-05 18:43:04-04:00,['d069bf9c3ee83a6fa41f36065131f72ade74fc70'],99,90,189,2808011,9,,,,6707
f4f174b899bd1278dffea343c688cab7b07851fd,0,Bryan Bende,2017-05-05 20:00:22-04:00,['829c02b058199bff167b4e78934584cabc92de78'],9,27,36,2808047,4,,,,6707
3a605af8e0ac024fb0ba67262d49dab2727b2576,1,Bryan Bende,2017-05-05 20:50:14-04:00,['f4f174b899bd1278dffea343c688cab7b07851fd'],704,659,1363,2809410,308,,,,6707
3af53419afe415cb02743a60e4d3cc5fa8ca068d,0,Bryan Bende,2017-05-05 20:50:28-04:00,['3a605af8e0ac024fb0ba67262d49dab2727b2576'],612,612,1224,2810634,308,,,,6707
744ecc3d83a203db67cc8e99aa97bf1985e16470,0,Mark Payne,2017-05-09 14:11:43-04:00,['3af53419afe415cb02743a60e4d3cc5fa8ca068d'],3,8,11,2810645,2,,,,6707
b6bdc4a0a81b43eba11f99c864f613788e1cf15a,1,Scott Aslan,2017-05-09 15:06:23-04:00,['744ecc3d83a203db67cc8e99aa97bf1985e16470'],110,109,219,2810864,1,,,,6707
72de1cbdef05b0b61ed78871b15f2d06711760a1,1,Mark Payne,2017-05-10 10:08:22-04:00,['b6bdc4a0a81b43eba11f99c864f613788e1cf15a'],193,212,405,2811269,6,1,1,0,6708
361a58c531c59bd638dcc8f55d2991cbaf4b087e,1,James Wing,2017-05-10 10:37:39-07:00,['72de1cbdef05b0b61ed78871b15f2d06711760a1'],5,7,12,2811281,2,0,1,1,6708
dc44e306989520c1ef4600b8c4e5521af8520b1e,1,James Wing,2017-05-10 12:07:04-07:00,['361a58c531c59bd638dcc8f55d2991cbaf4b087e'],9,292,301,2811582,2,0.475935829,0.620320856,0.941176471,6708
cf497c9cf9a6dc1a2a8ff19348a0b44e7ab0253f,1,Bryan Bende,2017-05-10 15:51:00-04:00,['dc44e306989520c1ef4600b8c4e5521af8520b1e'],29,28,57,2811639,2,,,,6708
0f693e94480c4090a66bf3044fe79dae65338a71,1,Andre F de Miranda,2017-05-11 09:04:04+10:00,['cf497c9cf9a6dc1a2a8ff19348a0b44e7ab0253f'],14,14,28,2811667,1,,,,6708
6e4db6b11a9177052d193fcd66b01dad1fa645d2,1,Mark Payne,2017-05-11 20:25:19-04:00,['0f693e94480c4090a66bf3044fe79dae65338a71'],4,31,35,2811702,3,0,0.263157895,0.684210526,6708
0b0ac196ea4574aa491ce56a1efa8d677536ae2a,0,Matt Burgess,2017-05-11 21:31:07-04:00,['6e4db6b11a9177052d193fcd66b01dad1fa645d2'],1,1,2,2811704,1,,,,6708
dd0306cce79695d916f0a10c1174919610584172,1,Matt Burgess,2017-05-11 22:16:46-04:00,['0b0ac196ea4574aa491ce56a1efa8d677536ae2a'],30,62,92,2811796,2,0,1,1,6708
1c58e78ce97ca59861235a00921cd327f2d86824,0,Pierre Villard,2017-05-12 16:01:43+02:00,['dd0306cce79695d916f0a10c1174919610584172'],0,1,1,2811797,1,1,1,1,6708
b1901d5fe0bf87be3dcce144f13b74eb995be168,1,Matt Burgess,2017-05-12 12:36:52-04:00,['1c58e78ce97ca59861235a00921cd327f2d86824'],235,5420,5655,2817452,90,0.463427377,0.775862069,0.91954023,6764
afd2b04afde2e843f46718ede01e3f8e31d2780c,1,Matt Burgess,2017-05-12 13:52:07-04:00,['b1901d5fe0bf87be3dcce144f13b74eb995be168'],15,137,152,2817604,6,0.255102041,1,1,6764
e9848f42767338d794f985c72a8be04fe5d1e698,0,Matt Burgess,2017-05-12 14:06:32-04:00,['afd2b04afde2e843f46718ede01e3f8e31d2780c'],34,2,36,2817640,2,1,0,0,6764
382eef2183192357c3823c207f1835711f57688c,1,Mark Payne,2017-05-12 14:58:43-04:00,['e9848f42767338d794f985c72a8be04fe5d1e698'],1,6,7,2817647,1,0,1,0,6764
09f6a7040cc99acb26a52cfee98e1e977afa863a,0,Matt Gilman,2017-05-13 07:34:33-04:00,['382eef2183192357c3823c207f1835711f57688c'],0,4,4,2817651,1,,,,6764
e717fb3f79a77ff591ae5aa1cbaafd8797b95ddc,0,Andre F de Miranda,2017-05-14 22:29:37+10:00,['09f6a7040cc99acb26a52cfee98e1e977afa863a'],62,62,124,2817775,4,1,1,1,6764
0af799a633c2b9d88335a2ad97f8a7b7e8227d2e,0,Andre F de Miranda,2017-05-14 22:34:51+10:00,['e717fb3f79a77ff591ae5aa1cbaafd8797b95ddc'],0,0,0,2817775,0,,,,6764
bc68eb754faefe40238ebd2a101f80430272b0de,0,Pierre Villard,2017-05-15 13:27:26+02:00,['0af799a633c2b9d88335a2ad97f8a7b7e8227d2e'],3,2,5,2817780,2,,,,6764
3353865ce916b8b332ba62782e1d808ffff68d83,1,Pierre Villard,2017-05-15 13:46:29+02:00,['bc68eb754faefe40238ebd2a101f80430272b0de'],12,68,80,2817860,3,0,0.405405405,1,6764
d092551211afe300c3e08a017d6256cf268313b4,1,Matt Gilman,2017-05-15 08:43:32-04:00,['3353865ce916b8b332ba62782e1d808ffff68d83'],70,536,606,2818466,13,0.320652174,0.869565217,0.673913043,6766
196ca237e6d054198ebad343847758f001b240bf,0,Matt Burgess,2017-05-15 09:08:43-04:00,['d092551211afe300c3e08a017d6256cf268313b4'],7,146,153,2818619,3,0.457446809,0.85106383,1,6766
20a1fc24d712e1be2f26a203cbbf8c789bdf940f,0,James Wing,2017-05-15 10:13:53-07:00,['196ca237e6d054198ebad343847758f001b240bf'],17,21,38,2818657,4,,,,6766
1811ba568152d0586c29861899e7ceb2c6b06d24,1,Matt Burgess,2017-05-15 14:15:23-04:00,['20a1fc24d712e1be2f26a203cbbf8c789bdf940f'],46,364,410,2819067,10,0.369458128,0.709359606,0.901477833,6766
bf15502e1994c68d706a2a2749495b57fd9a11e4,1,Matt Burgess,2017-05-15 14:18:57-04:00,['1811ba568152d0586c29861899e7ceb2c6b06d24'],0,343,343,2819410,4,0.248322148,0.523489933,0.77852349,6768
6ffb78d40465daff3b77a3b426732b5b515e3233,1,Andy LoPresto,2017-05-15 19:02:03-07:00,['bf15502e1994c68d706a2a2749495b57fd9a11e4'],31,226,257,2819667,11,0.55,1,1,6771
603f713a4020a29f21a868dfec10a07c1c03b1b2,1,Mark Payne,2017-05-16 08:51:41-04:00,['6ffb78d40465daff3b77a3b426732b5b515e3233'],242,624,866,2820533,6,0.066666667,0.570833333,1,6771
824712bffe3195ad4fb4a004c6c8f19daeb12170,0,Aldrin Piri,2017-05-16 12:36:27-04:00,['603f713a4020a29f21a868dfec10a07c1c03b1b2'],6,21,27,2820560,2,0.555555556,0.444444444,1,6771
3f4b276b713464ad0ccf13b5164e08d118e2cc25,1,Mark Payne,2017-05-16 13:16:46-04:00,['824712bffe3195ad4fb4a004c6c8f19daeb12170'],5,40,45,2820605,2,0,0.923076923,1,6771
58cf15a912b5413a4a6e511352b4dac4f7a5dfdd,0,Yolanda M. Davis,2017-05-16 13:31:15-04:00,['3f4b276b713464ad0ccf13b5164e08d118e2cc25'],1,1,2,2820607,1,,,,6771
4fdea680ecd9f4ea982961f37bb870b4bbad7e45,0,joewitt,2017-05-16 13:48:16-04:00,['58cf15a912b5413a4a6e511352b4dac4f7a5dfdd'],25,25,50,2820657,1,1,0,1,6771
77a676bf9225d506de77ebec4cd029c917047321,1,Mark Payne,2017-05-16 13:49:31-04:00,['4fdea680ecd9f4ea982961f37bb870b4bbad7e45'],2,19,21,2820678,4,0.25,0.25,0.625,6771
f5f6cab64681c16664a71e8c1374f8e9c34d4931,1,Andy LoPresto,2017-05-16 11:17:29-07:00,['77a676bf9225d506de77ebec4cd029c917047321'],96,328,424,2821102,14,0.09375,1,0.90625,6771
fb94990e60068eb244cae1d12d3a0790ece29adc,0,joewitt,2017-05-16 14:42:42-04:00,['f5f6cab64681c16664a71e8c1374f8e9c34d4931'],0,34,34,2821136,3,0.125,0.791666667,0.791666667,6771
ac8e57259f8e4d8183d938f46a28f3c73b595940,0,Andy LoPresto,2017-05-16 11:55:36-07:00,['fb94990e60068eb244cae1d12d3a0790ece29adc'],0,33,33,2821169,1,0,0.944444444,0.944444444,6771
494a0e89288c5e51f9467b719e7ee582cd74c875,1,Bryan Bende,2017-05-16 16:04:09-04:00,['ac8e57259f8e4d8183d938f46a28f3c73b595940'],14,50,64,2821233,7,0.5,0.5,0,6772
3a0004a665c2f7bebe10ec54db08e2b8c7e2804f,1,Matt Gilman,2017-05-16 16:08:28-04:00,['494a0e89288c5e51f9467b719e7ee582cd74c875'],63,133,196,2821429,7,0,0.4,0.657142857,6772
2f3ba57dd658372366672509ed0fa9fec5973f76,0,Aldrin Piri,2017-05-16 16:10:00-04:00,['3a0004a665c2f7bebe10ec54db08e2b8c7e2804f'],2,6,8,2821437,1,0,0,1,6772
ce1bc42ac556e8a0847553a33b112b74bd6fc10f,0,joewitt,2017-05-16 16:17:04-04:00,['2f3ba57dd658372366672509ed0fa9fec5973f76'],0,38,38,2821475,3,1,0.318181818,0.727272727,6772
6b71b4cbb860c04431d3c54ef75d71fe44c59382,1,Matt Burgess,2017-05-16 16:54:30-04:00,['ce1bc42ac556e8a0847553a33b112b74bd6fc10f'],10,130,140,2821615,5,0.203389831,0.610169492,1,6773
c50d5160767e01373ca5785f7cb8856bff311dd5,1,Jeff Storck,2017-05-16 17:09:48-04:00,['6b71b4cbb860c04431d3c54ef75d71fe44c59382'],8,39,47,2821662,9,0,0.391304348,1,6773
33dc3e36fbb7910b9d1ee05091b37b08f32aae6a,1,Mark Payne,2017-05-17 09:45:21-04:00,['c50d5160767e01373ca5785f7cb8856bff311dd5'],19,17,36,2821698,2,1,1,1,6773
f019d509f38afc0685f361647ee20f798583dfa8,1,Mark Payne,2017-05-17 09:49:11-04:00,['33dc3e36fbb7910b9d1ee05091b37b08f32aae6a'],0,34,34,2821732,2,0,0.88,0.88,6773
40a9cd4f2ead4d0388581921b0de9108a6e97946,1,Mark Payne,2017-05-17 10:53:27-04:00,['f019d509f38afc0685f361647ee20f798583dfa8'],5,75,80,2821812,4,0,0.837837838,0.837837838,6774
9198bee0382be60b90191369d8fcc99deebcb2b9,1,Matt Gilman,2017-05-17 11:12:59-04:00,['40a9cd4f2ead4d0388581921b0de9108a6e97946'],3,3,6,2821818,1,,,,6774
2dde48002953b490d3ce487082831ba5349e8395,0,Matt Gilman,2017-05-17 13:04:31-04:00,['9198bee0382be60b90191369d8fcc99deebcb2b9'],2,3,5,2821823,2,0,1,1,6774
3fd7d3b272fcbf4778ab8b6315113b63747697ee,0,Matt Burgess,2017-05-17 13:08:00-04:00,['2dde48002953b490d3ce487082831ba5349e8395'],2,28,30,2821853,2,0,0,1,6774
5cf4bf61b384a97ff8430447f7e02afe1aa6ba2a,0,Matt Gilman,2017-05-17 13:31:53-04:00,['3fd7d3b272fcbf4778ab8b6315113b63747697ee'],1,1,2,2821855,1,,,,6774
289dde098e8f14c7ed586e03a0d9f70ccc8b97ac,1,Matt Gilman,2017-05-17 16:37:11-04:00,['5cf4bf61b384a97ff8430447f7e02afe1aa6ba2a'],3,20,23,2821878,4,,,,6774
8e1c79eaafe886e85e4ceaf8436b961eccfef568,1,Matt Gilman,2017-05-17 17:35:33-04:00,['289dde098e8f14c7ed586e03a0d9f70ccc8b97ac'],24,80,104,2821982,7,0,1,1,6774
36e7bd6164f6d7294ec17fe6487a74b042ba2f25,0,joewitt,2017-05-17 22:57:33-04:00,['8e1c79eaafe886e85e4ceaf8436b961eccfef568'],10,5,15,2821997,2,1,1,0,6774
be67f3552ba9abbb98aa29ab48c06264b77ab661,1,Bryan Bende,2017-05-18 13:36:02-04:00,['36e7bd6164f6d7294ec17fe6487a74b042ba2f25'],59,582,641,2822638,10,1,1,1,6778
762293c01cc9b843abd5378f5de51f626050f498,0,Matt Burgess,2017-05-18 14:42:46-04:00,['be67f3552ba9abbb98aa29ab48c06264b77ab661'],53,50,103,2822741,2,,,,6778
28eadaa683b41833987b6d20bd79d03f43d61259,0,Andy LoPresto,2017-05-18 19:20:39-07:00,['762293c01cc9b843abd5378f5de51f626050f498'],57,58,115,2822856,24,,,,6787
3b98abbf416974a7e94ef4e1ca3fc169bbf66393,1,Andy LoPresto,2017-05-18 21:37:25-07:00,['28eadaa683b41833987b6d20bd79d03f43d61259'],12,6,18,2822874,3,,,,6787
9bd0246a96cfcda01b972834823250a9cddf77a8,1,joewitt,2017-05-19 01:02:41-04:00,['3b98abbf416974a7e94ef4e1ca3fc169bbf66393'],430,2619,3049,2825923,66,0.613601236,0.595054096,0.522411128,6809
ae9953db646f54f3731c56c8ff97503aacc041f3,1,joewitt,2017-05-19 02:08:52-04:00,['9bd0246a96cfcda01b972834823250a9cddf77a8'],111,1158,1269,2827192,26,0.38534279,0.460992908,0.921985816,6812
d4f0c1d048f0539a226b4b5ce33b9d172402f50e,0,joewitt,2017-05-19 13:59:27-04:00,['ae9953db646f54f3731c56c8ff97503aacc041f3'],0,502,502,2827694,4,,,,6814
9294a2613913f28789a1989744c5c79108768eeb,1,Andy LoPresto,2017-05-19 11:20:38-07:00,['d4f0c1d048f0539a226b4b5ce33b9d172402f50e'],214,821,1035,2828729,33,0.111650485,0.072815534,0.902912621,6818
58ce52d5d64d0599110c5b66addb1b093246f157,0,joewitt,2017-05-19 15:51:23-04:00,['9294a2613913f28789a1989744c5c79108768eeb'],25,17,42,2828771,8,1,0,0,6818
c49933f03df295760e1b6764e38dddbc9b2d31e6,1,joewitt,2017-05-19 23:05:04-04:00,['58ce52d5d64d0599110c5b66addb1b093246f157'],69,61,130,2828901,13,0,0.1,0,6818
f35e0ecdd0e0fd8940b1caa688405d2128f8eb61,1,Mark Payne,2017-05-22 09:06:42-04:00,['c49933f03df295760e1b6764e38dddbc9b2d31e6'],26,109,135,2829036,1,0.4,0.84,1,6818
71cd497fefd9b173f6b017f69a31fc7d57e906c7,1,Mark Payne,2017-05-22 09:12:51-04:00,['f35e0ecdd0e0fd8940b1caa688405d2128f8eb61'],4,46,50,2829086,1,0,0,1,6818
7f8987471d18deececd71bed0cbdee28b9c6254f,1,Bryan Bende,2017-05-22 11:52:41-04:00,['71cd497fefd9b173f6b017f69a31fc7d57e906c7'],100,265,365,2829451,10,0.336842105,0.873684211,0.915789474,6818
1a3c525dd68d7ad5403a23aaabda131edbf489fa,0,Bryan Bende,2017-05-22 12:39:32-04:00,['7f8987471d18deececd71bed0cbdee28b9c6254f'],2,6,8,2829459,1,1,1,1,6818
6d16fdf170db72cca41ef5c450f2b75ae2e74699,1,Bryan Bende,2017-05-22 14:32:45-04:00,['1a3c525dd68d7ad5403a23aaabda131edbf489fa'],4,119,123,2829582,5,0,1,0.71875,6819
6937a6cf64c2f9e437b96550259575488eb284ec,1,joewitt,2017-05-22 14:37:53-04:00,['6d16fdf170db72cca41ef5c450f2b75ae2e74699'],85,120,205,2829787,6,0.476190476,0.476190476,0.523809524,6819
a1b07b1e9c388d8642699b1d8b101a606dc5bd6a,1,Bryan Bende,2017-05-22 16:30:47-04:00,['6937a6cf64c2f9e437b96550259575488eb284ec'],12,73,85,2829872,2,0,0.428571429,0.428571429,6819
d33c4c72d49979ab04db489e429dd202d51585b1,1,Mark Payne,2017-05-22 16:50:30-04:00,['a1b07b1e9c388d8642699b1d8b101a606dc5bd6a'],41,119,160,2830032,4,0.216216216,0.702702703,1,6819
ded396f0ef2c090456a532f2ce427525c8a1a4b6,0,Mark Payne,2017-05-22 16:51:13-04:00,['d33c4c72d49979ab04db489e429dd202d51585b1'],7,7,14,2830046,2,,,,6819
a8de27e69b8c8cf553b7e1d44699a1f68e53c5bd,0,Koji Kawamura,2017-05-23 15:43:27+09:00,['ded396f0ef2c090456a532f2ce427525c8a1a4b6'],10,30,40,2830086,4,1,1,0,6819
49270f8a8c3968a53662922d44f8396358441a36,1,Scott Aslan,2017-05-23 11:06:59-04:00,['a8de27e69b8c8cf553b7e1d44699a1f68e53c5bd'],13,40,53,2830139,31,,,,6826
b64232117f2273c36473122bd6378aa013be458d,0,Pierre Villard,2017-05-23 18:06:18+02:00,['49270f8a8c3968a53662922d44f8396358441a36'],1,4,5,2830144,1,0.5,1,1,6826
3ec0aa947f2d939ce37fb1a65cd089857a41e0c0,0,Pierre Villard,2017-05-23 18:48:29+02:00,['b64232117f2273c36473122bd6378aa013be458d'],49,51,100,2830244,2,0,1,1,6826
0a7d14965619fd4a0248729c964e7688f3630456,0,Pierre Villard,2017-05-23 19:04:54+02:00,['3ec0aa947f2d939ce37fb1a65cd089857a41e0c0'],2,2,4,2830248,2,,,,6826
9238fdb493fe56704958dc8fc465d109939a994e,1,Pierre Villard,2017-05-23 19:25:55+02:00,['0a7d14965619fd4a0248729c964e7688f3630456'],193,1529,1722,2831970,16,0.407514451,1,1,6835
fb925fc182c78cdb31c699c203657ac55ec774a9,0,Pierre Villard,2017-05-23 21:28:59+02:00,['9238fdb493fe56704958dc8fc465d109939a994e'],4,3,7,2831977,2,,1,,6835
2c751a8e5bdf784513fabf1da029bb12cd076732,1,joewitt,2017-05-23 23:20:13-04:00,['fb925fc182c78cdb31c699c203657ac55ec774a9'],77,113,190,2832167,1,1,0.904761905,1,6835
6d07ebf50c397458d639b3713525f6bbab4c7901,1,joewitt,2017-05-23 23:42:28-04:00,['2c751a8e5bdf784513fabf1da029bb12cd076732'],1,10,11,2832178,2,,,,6835
d63fa8a822a755e12a30c05a00c73786ade1c657,0,joewitt,2017-05-24 00:09:17-04:00,['6d07ebf50c397458d639b3713525f6bbab4c7901'],1,4,5,2832183,1,,,,6835
ba49b8427c3c4be0a5a972f95286e29b08350f2e,0,Bryan Bende,2017-05-24 11:04:00-04:00,['d63fa8a822a755e12a30c05a00c73786ade1c657'],8,33,41,2832224,2,1,0.928571429,1,6835
7a46238baf076710df160519488174d1aa25bac5,0,Matt Gilman,2017-05-24 11:14:48-04:00,['ba49b8427c3c4be0a5a972f95286e29b08350f2e'],22,12,34,2832258,2,1,0,0,6835
bb96b0f46412008ade2b5abe2d4ee9970af576fd,1,Koji Kawamura,2017-05-25 00:33:50+09:00,['7a46238baf076710df160519488174d1aa25bac5'],1,7,8,2832266,2,0,0,1,6835
08b66b5b6a2fd4194d55a98900c1d898b4e74a28,0,Pierre Villard,2017-05-24 19:36:18+02:00,['bb96b0f46412008ade2b5abe2d4ee9970af576fd'],1,19,20,2832286,2,1,1,1,6835
fb7d6d1150bfa4338b31e73c244d039f57819c94,0,James Wing,2017-05-24 10:45:45-07:00,['08b66b5b6a2fd4194d55a98900c1d898b4e74a28'],0,42,42,2832328,3,0,1,0.958333333,6835
b12cf8a6d28c2a025831fff9363adf2b13199071,0,joewitt,2017-05-24 14:21:18-04:00,['fb7d6d1150bfa4338b31e73c244d039f57819c94'],2,19,21,2832349,2,0,1,1,6835
232380dbfd59de45c4c6623f141d6e7052c367f9,0,Mark Payne,2017-05-24 14:24:29-04:00,['b12cf8a6d28c2a025831fff9363adf2b13199071'],4,9,13,2832362,2,0,0,1,6835
152f002abfb5ab07cdcee9209839574454d690be,1,Bryan Bende,2017-05-24 14:59:23-04:00,['232380dbfd59de45c4c6623f141d6e7052c367f9'],1,786,787,2833149,8,0.550684932,0.956164384,0.591780822,6837
ae3db823037ef01f8dc123e494f1d9e6522f29fe,1,Bryan Bende,2017-05-24 14:59:28-04:00,['152f002abfb5ab07cdcee9209839574454d690be'],260,189,449,2833598,4,0.727272727,0,0.651515152,6838
f97b3fe455e7cf8bd051c7a40f3e3f7ee1d1a16a,1,Bryan Bende,2017-05-24 15:58:22-04:00,['ae3db823037ef01f8dc123e494f1d9e6522f29fe'],44,90,134,2833732,3,0.333333333,0.333333333,1,6839
86728bac7ef091dba79cd3ffd3219c80f4fca8ba,0,Matt Gilman,2017-05-24 16:15:42-04:00,['f97b3fe455e7cf8bd051c7a40f3e3f7ee1d1a16a'],3,6,9,2833741,2,1,0,0,6839
5aa3baca79eb6111c7b84e7adbdd7e1e50b71b8e,1,joewitt,2017-05-24 21:21:45-04:00,['86728bac7ef091dba79cd3ffd3219c80f4fca8ba'],61,99,160,2833901,8,0,1,0.647058824,6839
eaefec6d81f9dbf0d239776ef465b14109e28d18,0,joewitt,2017-05-24 22:14:56-04:00,['5aa3baca79eb6111c7b84e7adbdd7e1e50b71b8e'],2,2,4,2833905,1,,,,6839
b6eb0ac0fb382b5cc2e3f60196e36835437883f3,1,Koji Kawamura,2017-05-25 14:10:50+09:00,['eaefec6d81f9dbf0d239776ef465b14109e28d18'],32,300,332,2834237,2,0.511764706,0.776470588,1,6839
e05005584d52b560771a0ccf2766ee9ee92b6518,1,Koji Kawamura,2017-05-25 15:31:49+09:00,['b6eb0ac0fb382b5cc2e3f60196e36835437883f3'],12,69,81,2834318,3,0,0,1,6839
c07850aec3a9017ffd35d571fcb4324396de09d9,0,Pierre Villard,2017-05-25 08:44:39+02:00,['e05005584d52b560771a0ccf2766ee9ee92b6518'],6,15,21,2834339,3,,,,6839
dc5e032368f09681bde680fc467512ea3f28dfa3,1,Koji Kawamura,2017-05-25 18:20:11+09:00,['c07850aec3a9017ffd35d571fcb4324396de09d9'],2,24,26,2834365,2,0.764705882,1,0.764705882,6839
23cbc3b3463dcbd477b6ebcdbfbb2784f42e0749,0,joewitt,2017-05-25 10:59:53-04:00,['dc5e032368f09681bde680fc467512ea3f28dfa3'],8,4,12,2834377,3,1,0,1,6839
46e2420d7425a26f5ec6bc787f375b741a0d8ca2,1,Joey Frazee,2017-05-25 10:05:32-05:00,['23cbc3b3463dcbd477b6ebcdbfbb2784f42e0749'],27,1259,1286,2835663,21,0.392857143,0.816666667,0.904761905,6853
4d0667380a62510e9a10896be41ce1b2c5538db9,1,Joey Frazee,2017-05-25 10:05:32-05:00,['46e2420d7425a26f5ec6bc787f375b741a0d8ca2'],11,61,72,2835735,8,0,1,1,6853
44fdc0e4ef3f0e9e99c2e39c1994e641ce02d146,1,Jeff Storck,2017-05-25 13:14:51-04:00,['4d0667380a62510e9a10896be41ce1b2c5538db9'],3,19,22,2835757,1,0,0.5,1,6853
eb25c8547a8fec278296ab7b846deac2295f4af4,0,joewitt,2017-05-25 13:31:53-04:00,['44fdc0e4ef3f0e9e99c2e39c1994e641ce02d146'],2,7,9,2835766,1,0,0,1,6853
36911957dce87d37e2342bec5d25a934583852d8,1,joewitt,2017-05-25 13:32:02-04:00,['eb25c8547a8fec278296ab7b846deac2295f4af4'],6,24,30,2835796,1,0,0,1,6853
13b59b56210eff6f06f6cfb3020953666d502604,1,Matt Burgess,2017-05-25 14:37:17-04:00,['36911957dce87d37e2342bec5d25a934583852d8'],18,129,147,2835943,5,0.44,0.62,0.04,6853
5cb928131ca418c67827a536b02a046b34d14c7f,1,Bryan Bende,2017-05-25 16:45:20-04:00,['13b59b56210eff6f06f6cfb3020953666d502604'],16,78,94,2836037,4,0.019230769,0.538461538,1,6853
118f4e8cca8a8528debade90dad41239b070c199,0,Koji Kawamura,2017-05-26 14:12:02+09:00,['5cb928131ca418c67827a536b02a046b34d14c7f'],1,1,2,2836039,1,,,,6853
e85081ed201bc7413e3d2d062c814e23c0ff5467,0,Pierre Villard,2017-05-26 10:40:22+02:00,['118f4e8cca8a8528debade90dad41239b070c199'],8,11,19,2836058,1,,,,6853
3966f5ce866ab0d62ce966266bb074704c3d95f2,0,Scott Aslan,2017-05-26 08:51:25-04:00,['e85081ed201bc7413e3d2d062c814e23c0ff5467'],17,13,30,2836088,4,,,,6853
80dfe0257ffbafe45e6d49433405f5be1214401e,0,Andre F de Miranda,2017-05-27 00:56:25+10:00,['3966f5ce866ab0d62ce966266bb074704c3d95f2'],9,2,11,2836099,1,1,0,0,6853
dd50745a9f53982a3e53f9adbc0e1c45fb9e75bc,0,Bryan Bende,2017-05-26 17:59:53-04:00,['80dfe0257ffbafe45e6d49433405f5be1214401e'],1,1,2,2836101,1,,,,6853
2b435cdfc6fd0824d9eb5f2cf140a330c9f258ed,1,joewitt,2017-05-26 21:05:45-05:00,['dd50745a9f53982a3e53f9adbc0e1c45fb9e75bc'],19,135,154,2836255,3,0.388888889,0.333333333,1,6854
7bcccb10f4102daf73c99f7cc80b0036af0025b3,0,Mark Payne,2017-05-30 15:01:39-04:00,['2b435cdfc6fd0824d9eb5f2cf140a330c9f258ed'],12,42,54,2836309,2,0.32,1,1,6854
a0b2311ff6a81dfa33e652e754368f5404ace7d5,0,joewitt,2017-05-31 13:41:25-04:00,['7bcccb10f4102daf73c99f7cc80b0036af0025b3'],2,1,3,2836312,2,0,0,0,6854
7035694e37b79bd58d9168cb5010b14a15db0396,0,Bryan Bende,2017-06-01 10:29:58-04:00,['a0b2311ff6a81dfa33e652e754368f5404ace7d5'],1,56,57,2836369,2,1,1,1,6855
2595d816c4c9ef47a66f1aed477932c589588823,0,joewitt,2017-06-01 15:08:12-04:00,['7035694e37b79bd58d9168cb5010b14a15db0396'],1,12,13,2836382,1,0,0,1,6855
067e9dfeb0a7830a13003a04e4cfc3fd800f019b,1,Bryan Bende,2017-06-01 15:31:35-04:00,['2595d816c4c9ef47a66f1aed477932c589588823'],60,314,374,2836756,4,0.163636364,1,1,6857
37be0b9820097160d393d90f1dcf84d2d08669b0,1,joewitt,2017-06-02 10:01:40-04:00,['067e9dfeb0a7830a13003a04e4cfc3fd800f019b'],35,58,93,2836849,4,0,1,0,6857
239bbfbb9d08a8b39f330d2ac0a6c4fd6f59dd67,1,joewitt,2017-06-02 10:09:38-04:00,['37be0b9820097160d393d90f1dcf84d2d08669b0'],20,106,126,2836975,1,1,0.902439024,0.43902439,6857
de6a98618abcb6b695c1afe33164ec7d88e76a75,0,Scott Aslan,2017-06-02 12:05:20-04:00,['239bbfbb9d08a8b39f330d2ac0a6c4fd6f59dd67'],0,110,110,2837085,1,,,,6857
0bddcfe730841ab838a9539421d4aaf15fa57a49,1,Bryan Rosander,2017-06-02 13:01:13-04:00,['de6a98618abcb6b695c1afe33164ec7d88e76a75'],0,1105,1105,2838190,5,0.122205663,0.555886736,0.797317437,6860
32314d70fdea6e87fa38729956fa24b3298f5727,1,Matt Burgess,2017-06-02 14:06:05-04:00,['0bddcfe730841ab838a9539421d4aaf15fa57a49'],58,1912,1970,2840160,33,0.480349345,0.825327511,0.829694323,6880
39ad7a369ec14c3b3a9786ab2b75f106d2fc5424,0,Aldrin Piri,2017-06-02 15:04:41-04:00,['32314d70fdea6e87fa38729956fa24b3298f5727'],2,2,4,2840164,2,,,,6880
4d78052dd4f19372161391e93cde688f2fa8b864,1,Andre F de Miranda,2017-06-03 08:12:52+10:00,['39ad7a369ec14c3b3a9786ab2b75f106d2fc5424'],5,24,29,2840193,1,,,,6880
082b99640e9cc19d0fe3d18b84032a1c0e28c7ad,1,Pierre Villard,2017-06-03 12:11:38+02:00,['4d78052dd4f19372161391e93cde688f2fa8b864'],1,1,2,2840195,1,,,,6880
ddb73612bd1512d8b2151b81f9aa40811bca2aaa,0,Matt Gilman,2017-06-05 11:07:28-04:00,['082b99640e9cc19d0fe3d18b84032a1c0e28c7ad'],626,624,1250,2841445,313,,,,6880
6ee12e9b475a55f2a30e5d2cc59a008271fa0760,0,Matt Gilman,2017-06-05 11:07:43-04:00,['ddb73612bd1512d8b2151b81f9aa40811bca2aaa'],622,622,1244,2842689,313,,,,6880
f31f2a5f2663844874d017c69f941458bedeaf51,0,Andy LoPresto,2017-06-05 18:58:07-07:00,['082b99640e9cc19d0fe3d18b84032a1c0e28c7ad'],0,9,9,2842698,1,,,,6880
e1880785d0fa5995507479d8d74a1189968a661c,1,Andy LoPresto,2017-06-05 19:25:07-07:00,['f31f2a5f2663844874d017c69f941458bedeaf51'],6,7,13,2842711,1,,,,6880
3ef0fa48da93118193b5c808ea81fc1135760e85,0,Pierre Villard,2017-06-06 12:06:04+02:00,['e1880785d0fa5995507479d8d74a1189968a661c'],1,1,2,2842713,1,,,,6880
c86190c513ae567d1ceef263b61781efaaf58c45,0,Scott Aslan,2017-06-06 17:35:43-04:00,['3ef0fa48da93118193b5c808ea81fc1135760e85'],1,9,10,2842723,1,0,1,1,6880
45e035686f0a51c29629f6f6dfa1d26496e21997,1,Bryan Bende,2017-06-07 12:03:53-04:00,['c86190c513ae567d1ceef263b61781efaaf58c45'],119,13,132,2842855,3,0.868421053,0.868421053,0.131578947,6880
b0c942877682d7aaebe4bec003fae3bff9be263e,0,Mark Payne,2017-06-07 13:59:40-04:00,['45e035686f0a51c29629f6f6dfa1d26496e21997'],0,9,9,2842864,1,0,0,1,6880
1bf0a1a849d5d93248d1665907cad92a7a84a0fa,0,Matt Gilman,2017-06-08 14:30:10-04:00,"['b0c942877682d7aaebe4bec003fae3bff9be263e', '6ee12e9b475a55f2a30e5d2cc59a008271fa0760']",625,623,1248,2844112,313,,,,6880
cc741d2be62b24862ec6623b3a23da0e5a130a3b,0,Matt Gilman,2017-06-08 15:22:51-04:00,['1bf0a1a849d5d93248d1665907cad92a7a84a0fa'],623,623,1246,2845358,315,,,,6880
d8dc2bb00b6ccfe3faa42481ae541616401b4075,0,Joe Percivall,2017-06-09 12:05:11-04:00,['cc741d2be62b24862ec6623b3a23da0e5a130a3b'],1,1,2,2845360,1,,,,6880
f447fc73fa2de55babcdf4a195466724fc94dd32,0,Scott Aslan,2017-06-09 12:59:22-04:00,['d8dc2bb00b6ccfe3faa42481ae541616401b4075'],0,1,1,2845361,1,,,,6880
4ed7511bee11b319487d07b4bdcff3438a44b6dc,1,Bryan Bende,2017-06-09 13:54:10-04:00,['f447fc73fa2de55babcdf4a195466724fc94dd32'],2351,9476,11827,2857188,129,0.327023879,0.817122889,0.956901573,6924
e7dcb6f6c5665a2a2b8b96b39b76417f92e4f190,1,Matt Burgess,2017-06-09 16:13:25-04:00,['4ed7511bee11b319487d07b4bdcff3438a44b6dc'],359,562,921,2858109,45,0.173913043,0.586956522,0,6927
77619033521c64fea95fea3827993a4ce2d0746c,0,Koji Kawamura,2017-06-12 10:53:09+09:00,['e7dcb6f6c5665a2a2b8b96b39b76417f92e4f190'],6,8,14,2858123,3,0,1,1,6927
8ef4fddddd815e373523ac6a3e10012d34fe4a78,1,Bryan Rosander,2017-06-12 09:50:02-04:00,['77619033521c64fea95fea3827993a4ce2d0746c'],76,3131,3207,2861330,36,,,,6955
de1b84e2aa419a93095f90025082e536e19dda5c,1,Bryan Bende,2017-06-12 10:34:48-04:00,['8ef4fddddd815e373523ac6a3e10012d34fe4a78'],90,99,189,2861519,7,0.666666667,1,1,6955
2b47ade0c4fa9c5f05fe79446c12cdcd16859236,1,Bryan Bende,2017-06-12 16:36:23-04:00,['de1b84e2aa419a93095f90025082e536e19dda5c'],4,4,8,2861527,1,,,,6955
c0ad5bcc7bf487c4097c7e6db77bf4e3254c0618,0,Matt Burgess,2017-06-13 12:29:03-04:00,['2b47ade0c4fa9c5f05fe79446c12cdcd16859236'],3,4,7,2861534,1,,,,6955
490e1da5dbfcf4a39e43c1559d5e6ca75f021011,1,Jeff Storck,2017-06-15 14:17:35-04:00,['c0ad5bcc7bf487c4097c7e6db77bf4e3254c0618'],228,278,506,2862040,81,0.75,0.75,1,6955
2800df30d383030a02c4e1547a9eab1fb88cc59e,0,Pierre Villard,2017-06-17 15:22:33+02:00,['490e1da5dbfcf4a39e43c1559d5e6ca75f021011'],66,58,124,2862164,2,1,0,0,6955
5a7e6c6ac121f24228ffaecd29b46a08d2a1a6d3,0,Pierre Villard,2017-06-17 15:50:40+02:00,['2800df30d383030a02c4e1547a9eab1fb88cc59e'],3,101,104,2862268,3,0.136363636,0.954545455,1,6957
ad6af1d94111e9d24989701a153e410d1db8e4e9,0,James Wing,2017-06-17 16:46:31-07:00,['5a7e6c6ac121f24228ffaecd29b46a08d2a1a6d3'],1,1,2,2862270,1,,,,6957
6bc6f955c077bd4ce3bf06de15ac8693725ebc85,1,Pierre Villard,2017-06-19 19:25:33+02:00,['ad6af1d94111e9d24989701a153e410d1db8e4e9'],0,1869,1869,2864139,14,0.445614035,0.580116959,0.983625731,6963
aabd4a25d2cb8b2a6108be6c16315acee08ee712,1,Mark Payne,2017-06-21 12:47:19-04:00,['6bc6f955c077bd4ce3bf06de15ac8693725ebc85'],64,3372,3436,2867575,57,0.5,0.891735537,0.89338843,6989
77e49b749e6ab0ab0e91827cb0a58680ad52d910,1,Mark Payne,2017-06-21 14:20:22-04:00,['aabd4a25d2cb8b2a6108be6c16315acee08ee712'],12,14,26,2867601,2,,,0,6989
ba3372a1dc0a5f72f82fb5cadab773872e5d4ecb,0,Mark Payne,2017-06-21 14:56:07-04:00,['77e49b749e6ab0ab0e91827cb0a58680ad52d910'],0,11,11,2867612,1,,,,6989
73e601bc55dca951b093c4e96098d001477f4a47,1,Matt Burgess,2017-06-21 15:10:22-04:00,['ba3372a1dc0a5f72f82fb5cadab773872e5d4ecb'],14,82,96,2867708,2,0,1,1,6989
86fa1bba4f3de373f05f73b5be691b5f935c215d,0,Bryan Bende,2017-06-21 17:14:27-04:00,['73e601bc55dca951b093c4e96098d001477f4a47'],0,2,2,2867710,1,0,1,1,6989
59a32948ea9ad4f1e8018ff07e994320c966ac0b,0,Bryan Bende,2017-06-21 17:14:28-04:00,['86fa1bba4f3de373f05f73b5be691b5f935c215d'],14,14,28,2867738,4,,,,6989
c99100c934085495880ed4ed04fe48c98cfebcfe,0,Bryan Bende,2017-06-21 17:14:49-04:00,['59a32948ea9ad4f1e8018ff07e994320c966ac0b'],5,40,45,2867783,6,0.7,0,1,6989
668a64cd566682c1a13064d3b2b8a5a14aab5f4c,1,Mark Payne,2017-06-22 09:30:38-04:00,['c99100c934085495880ed4ed04fe48c98cfebcfe'],0,13,13,2867796,1,0,0.666666667,1,6989
5b82b735ab88e13e7d1bd1dc103912ecb873d226,0,Andy LoPresto,2017-06-22 14:03:25-04:00,['668a64cd566682c1a13064d3b2b8a5a14aab5f4c'],1,1,2,2867798,1,,,,6989
f54e1465619f363ef095ce05d61dcf5fd0ee2e4d,1,Andy LoPresto,2017-06-22 16:06:18-04:00,['5b82b735ab88e13e7d1bd1dc103912ecb873d226'],2,2,4,2867802,2,,,,6989
5c755c006b37c0b65cce930d291c747155f58916,0,Andy LoPresto,2017-06-22 16:49:31-04:00,['f54e1465619f363ef095ce05d61dcf5fd0ee2e4d'],3,17,20,2867822,2,0,0.875,1,6989
253ea2e73bd271e82dcfd6c706f679ddad014101,1,Pierre Villard,2017-06-22 23:31:35+02:00,['5c755c006b37c0b65cce930d291c747155f58916'],31,86,117,2867939,2,0.382352941,1,1,6989
7c27d4c58872e8f6891ae6735cda409161c1fb6b,0,Koji Kawamura,2017-06-23 17:38:19+09:00,['253ea2e73bd271e82dcfd6c706f679ddad014101'],4,40,44,2867983,1,0,0.133333333,0,6989
ff65b42e88dbea823877ac58e72b4b126ccb20c1,0,Scott Aslan,2017-06-23 08:48:34-04:00,['7c27d4c58872e8f6891ae6735cda409161c1fb6b'],0,3,3,2867986,1,,,,6989
8878d732dd4d6e862712aeaa5cc46e7c06d28892,0,Matt Burgess,2017-06-23 11:14:57-04:00,['ff65b42e88dbea823877ac58e72b4b126ccb20c1'],0,4,4,2867990,1,0,0,1,6989
47165afc0cc9c6a0fe55e61cdefb86c48b52e716,1,Andy LoPresto,2017-06-23 11:20:07-04:00,['8878d732dd4d6e862712aeaa5cc46e7c06d28892'],1,1,2,2867992,1,,,,6989
69613f29c90d5f5e757e80e6d89a3e7d34f028d0,0,Bryan Bende,2017-06-23 13:58:22-04:00,['47165afc0cc9c6a0fe55e61cdefb86c48b52e716'],6,17,23,2868015,1,0,0,1,6989
91ed96f8c43fece2e92f557ca56a50a48a95dfdf,0,Pierre Villard,2017-06-26 19:09:22+02:00,['69613f29c90d5f5e757e80e6d89a3e7d34f028d0'],3,10,13,2868028,1,0,0,1,6989
68b42c9e547608d78d301d5b3a3856fe4853b4cd,1,Pierre Villard,2017-06-26 19:16:31+02:00,['91ed96f8c43fece2e92f557ca56a50a48a95dfdf'],3,70,73,2868101,3,0.552631579,0.552631579,0.763157895,6989
24e2981012e7907dfdea70cd38a793d9dd295669,0,Pierre Villard,2017-06-26 20:25:50+02:00,['68b42c9e547608d78d301d5b3a3856fe4853b4cd'],0,1,1,2868102,1,1,0,0,6989
7314066b6a2d5716e00884e9b6992ad60823d4a3,1,Andy LoPresto,2017-06-26 15:24:30-07:00,['24e2981012e7907dfdea70cd38a793d9dd295669'],0,438,438,2868540,8,0.316239316,0.452991453,1,6994
2b5aaec6d9a11b71d7fbf3423c7193fcd8a25ca5,0,Andy LoPresto,2017-06-26 17:06:49-07:00,['7314066b6a2d5716e00884e9b6992ad60823d4a3'],2,2,4,2868544,2,,,,6994
c37aed4de291936ea684f0e2ef1a0bd33285d643,0,James Wing,2017-06-26 22:25:16-07:00,['2b5aaec6d9a11b71d7fbf3423c7193fcd8a25ca5'],0,1,1,2868545,1,0,0,1,6994
202eb5ccbee5e7033de59fcfc59384254c4ae4ed,0,Andy LoPresto,2017-06-27 10:38:35-07:00,['c37aed4de291936ea684f0e2ef1a0bd33285d643'],0,3,3,2868548,1,0.75,1,1,6994
1e7eceee8433d59904551d14856d66498785fdf2,0,Pierre Villard,2017-06-27 20:56:56+02:00,['202eb5ccbee5e7033de59fcfc59384254c4ae4ed'],1,6,7,2868555,1,,,,6994
c99c036c207d6e434295bb1200dbcffacdffd128,0,Pierre Villard,2017-06-27 21:48:55+02:00,['1e7eceee8433d59904551d14856d66498785fdf2'],29,41,70,2868625,6,0,0,1,6994
9bfa7469cb8a2ea3ce6cec9ae5766efe2213ea4c,1,Yolanda M. Davis,2017-06-28 16:41:14-04:00,['c99c036c207d6e434295bb1200dbcffacdffd128'],0,16,16,2868641,3,0,0.333333333,1,6994
bdfd710692c809b63951a9855c5f46962db937ed,1,Koji Kawamura,2017-06-29 10:23:15+09:00,['9bfa7469cb8a2ea3ce6cec9ae5766efe2213ea4c'],12,85,97,2868738,4,0,0.3,0,6994
82ef671953a726bae2d4529df03f29fad401fb26,0,Pierre Villard,2017-06-29 09:30:39+02:00,['bdfd710692c809b63951a9855c5f46962db937ed'],12,6,18,2868756,2,,,,6994
51727974485ffb9617c8d510377e70ea7b50cb53,1,Pierre Villard,2017-06-29 12:43:52+02:00,['82ef671953a726bae2d4529df03f29fad401fb26'],13,91,104,2868860,2,0.49122807,0.49122807,0.789473684,6994
3089d9dce00e04d94572245f9ac65fd936615c88,0,Scott Aslan,2017-06-29 11:54:56-04:00,['51727974485ffb9617c8d510377e70ea7b50cb53'],0,25,25,2868885,5,,,,6998
3bf1d127062a2d52d7be32e5ef29e19242219f48,0,Andy LoPresto,2017-06-29 10:40:33-07:00,['3089d9dce00e04d94572245f9ac65fd936615c88'],3,24,27,2868912,1,1,1,1,6998
58a623dfa270a77fa6fdd0fb3ac551eda663d64c,1,Tony Kurc,2017-06-29 22:01:22-04:00,['3bf1d127062a2d52d7be32e5ef29e19242219f48'],95,3395,3490,2872402,22,0.129613734,0.745922747,0.891845494,7015
cdc154f7c84a0e5e28d30cc8ee0d49ee5f8892ce,1,Koji Kawamura,2017-06-30 17:56:14+09:00,['58a623dfa270a77fa6fdd0fb3ac551eda663d64c'],21,53,74,2872476,1,0.222222222,1,0.259259259,7015
7f4cfd51ea07ead6c9b71b6c6d6f87a352b801d3,0,Pierre Villard,2017-06-30 13:53:05+02:00,['cdc154f7c84a0e5e28d30cc8ee0d49ee5f8892ce'],2,91,93,2872569,2,0,0,1,7015
902b6e205db086aaa0f2f3a2faea66806d756e4b,1,Matt Burgess,2017-06-30 15:12:10-04:00,['7f4cfd51ea07ead6c9b71b6c6d6f87a352b801d3'],0,3,3,2872572,1,1,1,1,7015
0c27a0888d3bd1b26c30df9fb5191e49d356d4e8,0,Andy LoPresto,2017-06-30 14:45:35-07:00,['902b6e205db086aaa0f2f3a2faea66806d756e4b'],56,94,150,2872722,1,,,,7015
8b5342dec0c5d7f60a8c4d3f6d52b7eae9645d84,1,Tony Kurc,2017-07-02 12:03:07-04:00,['0c27a0888d3bd1b26c30df9fb5191e49d356d4e8'],3,20,23,2872745,1,0.8,0.8,0.8,7015
7843b885ee061880d9ef7a4f3e1a39ad8ca40d00,0,Tony Kurc,2017-07-04 21:18:43-04:00,['8b5342dec0c5d7f60a8c4d3f6d52b7eae9645d84'],3,123,126,2872871,2,0.205882353,0.882352941,1,7015
47eece57980782a245a13c693d0bffc2c78f5695,1,Tony Kurc,2017-07-05 15:28:54-04:00,['7843b885ee061880d9ef7a4f3e1a39ad8ca40d00'],8,45,53,2872924,4,0.75,0.75,1,7015
e6b166a3a275cb0e4a088ed47607a43f6154df38,0,Tony Kurc,2017-07-05 21:21:50-04:00,['47eece57980782a245a13c693d0bffc2c78f5695'],15,297,312,2873236,2,0,0.890243902,1,7016
cff81c0cd24aa044602bbcc5ffc4c85918e9d484,1,Matt Gilman,2017-07-06 10:11:48-04:00,['e6b166a3a275cb0e4a088ed47607a43f6154df38'],10,17,27,2873263,1,0,0,0,7016
ba56774fa1c16d935f592df482e74bfa1564b5a3,1,Matt Gilman,2017-07-06 13:43:56-04:00,['cff81c0cd24aa044602bbcc5ffc4c85918e9d484'],136,352,488,2873751,12,0.722627737,0.751824818,1,7016
a3b72f1bb7435f987a618eda85008d187332ad21,1,Matt Gilman,2017-07-06 15:38:55-04:00,['ba56774fa1c16d935f592df482e74bfa1564b5a3'],11,23,34,2873785,6,0,1,0.8,7016
3906d4e1d215f41cdf075ac23a63e9e740391b33,1,Yolanda M. Davis,2017-07-06 15:52:07-04:00,['a3b72f1bb7435f987a618eda85008d187332ad21'],66,1333,1399,2875184,22,0.533864542,1,0.912350598,7029
45f82dc855177702a0c1a0e4c38af334b713c278,1,Koji Kawamura,2017-07-07 14:23:18+09:00,['3906d4e1d215f41cdf075ac23a63e9e740391b33'],7,31,38,2875222,3,0.611111111,0.555555556,1,7029
50c364a793e8605f0b6f2e48ef5e0e08cfcf817d,0,Pierre Villard,2017-07-07 12:25:10+02:00,['45f82dc855177702a0c1a0e4c38af334b713c278'],2,2,4,2875226,1,,,,7029
e84f9a24164a3c939664a2259f3a0c07c20cfb97,0,Pierre Villard,2017-07-07 12:31:50+02:00,['50c364a793e8605f0b6f2e48ef5e0e08cfcf817d'],2,3,5,2875231,1,0,0,1,7029
e89512e7449e8cda4a4793368339b61b8c4283fe,0,Pierre Villard,2017-07-07 13:28:33+02:00,['e84f9a24164a3c939664a2259f3a0c07c20cfb97'],2,2,4,2875235,1,,,,7029
6df97bbc88beedff8bed516ffef6e083d3172ad8,1,Bryan Bende,2017-07-07 10:08:48-04:00,['e89512e7449e8cda4a4793368339b61b8c4283fe'],19,32,51,2875286,4,0,1,0,7029
9e296830ab813bbdecf65b57ba723ae822abeff5,0,Matt Gilman,2017-07-07 16:41:32-04:00,['6df97bbc88beedff8bed516ffef6e083d3172ad8'],4,4,8,2875294,2,,,,7029
affc88e5998e8e31b241d8e56f7e508928963292,1,James Wing,2017-07-09 11:10:23-07:00,['9e296830ab813bbdecf65b57ba723ae822abeff5'],1,1403,1404,2876698,14,0.209393346,0.898238748,0.968688845,7039
2dc45a4dd74c42f456ed0135fc8c5a04d0036410,0,James Wing,2017-07-09 12:13:15-07:00,['affc88e5998e8e31b241d8e56f7e508928963292'],412,412,824,2877522,7,,,,7039
87e062ff557d18aa3f1f7e2906357c81236f0328,0,Matt Gilman,2017-07-10 14:33:07-04:00,['2dc45a4dd74c42f456ed0135fc8c5a04d0036410'],4,42,46,2877568,2,0,1,1,7039
78fbb8f2ee70d264787856e4a6337217bcfeba79,0,Matt Gilman,2017-07-10 14:40:13-04:00,['87e062ff557d18aa3f1f7e2906357c81236f0328'],14,16,30,2877598,8,,,,7039
0fd51b4d12d65abbaad02c88c42c30d015b5d653,0,James Wing,2017-07-10 21:25:26-07:00,['78fbb8f2ee70d264787856e4a6337217bcfeba79'],0,5,5,2877603,1,,,,7039
58f60b3cf0430e1ca5141c550595cd827b7e4b3e,1,Joe Skora,2017-07-11 13:51:13+00:00,['0fd51b4d12d65abbaad02c88c42c30d015b5d653'],0,16,16,2877619,2,1,1,1,7039
07a6499dae93344b0e8a8e8cd890ba16cf667fe2,0,Joe Skora,2017-07-11 13:51:40+00:00,['58f60b3cf0430e1ca5141c550595cd827b7e4b3e'],3,3,6,2877625,1,,,,7039
58fc5f24b8f8256846b0782f17b3b090c841f94b,0,Matt Gilman,2017-07-11 10:04:08-04:00,['07a6499dae93344b0e8a8e8cd890ba16cf667fe2'],1,1,2,2877627,1,,,,7039
325fe53fa1bdb03b89a88a3c4c74a3623aaea6ec,0,Pierre Villard,2017-07-11 18:04:50+02:00,['58fc5f24b8f8256846b0782f17b3b090c841f94b'],1,5,6,2877633,1,0,0,0,7039
eefad291674905b6e6df078f6bf07f7526ddc575,1,Pierre Villard,2017-07-11 18:13:04+02:00,['325fe53fa1bdb03b89a88a3c4c74a3623aaea6ec'],9,1327,1336,2878969,23,0.654895666,0.887640449,0.95505618,7046
b603cb955dcd1d3d9b5e374e5760f2f9b047bda9,1,Matt Burgess,2017-07-12 16:36:48-04:00,['eefad291674905b6e6df078f6bf07f7526ddc575'],113,2076,2189,2881158,16,0.277066356,0.571594878,0.72991851,7057
3b2e43b75c80be854cc854c3941e882c794c1d76,1,Matt Burgess,2017-07-12 17:02:55-04:00,['b603cb955dcd1d3d9b5e374e5760f2f9b047bda9'],177,187,364,2881522,2,1,0,0,7057
3844a821f18e6a76e44e289c923be333e49d5251,0,Matt Burgess,2017-07-12 17:02:55-04:00,['3b2e43b75c80be854cc854c3941e882c794c1d76'],105,6,111,2881633,2,1,0.08045977,0.08045977,7057
8acee02393f9557b9679038b933ba49705984cf8,1,Matt Burgess,2017-07-12 17:02:55-04:00,['3844a821f18e6a76e44e289c923be333e49d5251'],1,45,46,2881679,4,0,0.7,0.7,7058
5c48655e69d1e1d9745a02099357f6b8b3d9d874,0,Matt Burgess,2017-07-13 10:40:01-04:00,['8acee02393f9557b9679038b933ba49705984cf8'],16,227,243,2881922,6,0.781818182,0.781818182,0.781818182,7061
a9529adab130c3c5a6b9ae4a93cf27c34484b055,0,Matt Burgess,2017-07-13 10:51:02-04:00,['5c48655e69d1e1d9745a02099357f6b8b3d9d874'],5,5,10,2881932,1,,,,7061
3da8b94dddc3b08ecbf10f368240dd1b3e992bbf,1,Aldrin Piri,2017-07-17 17:18:32-04:00,['a9529adab130c3c5a6b9ae4a93cf27c34484b055'],38,45,83,2882015,4,,,,7061
03bff7c9fc320a95dbacef1eb8390a1aae174dc4,1,Koji Kawamura,2017-07-18 14:11:37+09:00,['3da8b94dddc3b08ecbf10f368240dd1b3e992bbf'],7,208,215,2882230,2,0,0.773584906,0.773584906,7061
a6e94de0bbea99561f0ff788b54db4d9af7e8f6a,1,Koji Kawamura,2017-07-18 14:16:10+09:00,['03bff7c9fc320a95dbacef1eb8390a1aae174dc4'],19,59,78,2882308,2,0,1,1,7061
844dbe4edbc1cc0d24abe394cd276b9925627240,0,Pierre Villard,2017-07-18 11:31:16+02:00,['a6e94de0bbea99561f0ff788b54db4d9af7e8f6a'],5,42,47,2882355,2,0,0.806451613,0.838709677,7061
a307ea3a000b0307d14cec5db8a5f7be875afa60,1,joewitt,2017-07-18 22:02:39-04:00,['844dbe4edbc1cc0d24abe394cd276b9925627240'],4,84,88,2882443,4,0,0,1,7061
59754500d5e51c6d89f24268b3ca1c48b5ae1473,1,joewitt,2017-07-18 22:23:10-04:00,['a307ea3a000b0307d14cec5db8a5f7be875afa60'],0,2,2,2882445,1,,,,7061
f87d2a2f572692a7e0a4078822539f424a0438e7,1,Pierre Villard,2017-07-19 12:25:42+02:00,['59754500d5e51c6d89f24268b3ca1c48b5ae1473'],61,58,119,2882564,4,0,0,1,7061
451a88df438f1ea2ed14c862a95aaed13b8c1ee3,0,Matt Gilman,2017-07-19 11:50:48-04:00,['f87d2a2f572692a7e0a4078822539f424a0438e7'],7,32,39,2882603,2,0.823529412,0.823529412,0.764705882,7061
ea1fe1a9c0a645d5ba2e81a519847e56a46aeb89,0,James Wing,2017-07-19 20:56:47-07:00,['451a88df438f1ea2ed14c862a95aaed13b8c1ee3'],7,676,683,2883286,8,0.400621118,0.854037267,1,7064
1f330b4fe4dbd986d7dd366e93ec8c9617503c78,0,James Wing,2017-07-19 22:46:15-07:00,['ea1fe1a9c0a645d5ba2e81a519847e56a46aeb89'],1,0,1,2883287,1,,,,7064
b4e0a6e20683253abe021acb9048602abc250668,1,Pierre Villard,2017-07-20 12:14:05+02:00,['1f330b4fe4dbd986d7dd366e93ec8c9617503c78'],2,1,3,2883290,1,1,1,1,7064
b0be99036dd261166fd5330710dd0bac193a40ae,1,Pierre Villard,2017-07-20 23:14:32+02:00,['b4e0a6e20683253abe021acb9048602abc250668'],14,13,27,2883317,3,0,0,0,7064
d334532b169e53f18765eb20c93ebcee1ac7ade0,0,Koji Kawamura,2017-07-21 16:31:46+09:00,['b0be99036dd261166fd5330710dd0bac193a40ae'],6,13,19,2883336,2,1,0,0,7064
c54b2ad81c07e96f26d1ef19d0f887a0f7704da5,1,Mark Payne,2017-07-21 09:32:45-04:00,['d334532b169e53f18765eb20c93ebcee1ac7ade0'],13,58,71,2883407,4,0.238095238,0.333333333,1,7064
695e8aa98f1d9cce5a9b3025193ac57f9acd598e,1,Matt Gilman,2017-07-21 14:18:11-04:00,['c54b2ad81c07e96f26d1ef19d0f887a0f7704da5'],394,679,1073,2884480,22,0,0,0.971153846,7069
3371e915ccf29f6d7a240dd52ea11cc10cf8bc5c,0,joewitt,2017-07-21 16:56:56-04:00,['695e8aa98f1d9cce5a9b3025193ac57f9acd598e'],2,62,64,2884544,3,0.888888889,1,1,7070
082919f91987dc86e5acce5cda50a5385e031a5e,0,James Wing,2017-07-22 11:11:24-07:00,['3371e915ccf29f6d7a240dd52ea11cc10cf8bc5c'],8,8,16,2884560,1,,,,7070
10692256d62348b3616d95ed3252eb58a8ce05ef,0,James Wing,2017-07-23 11:30:04-07:00,['082919f91987dc86e5acce5cda50a5385e031a5e'],1,8,9,2884569,3,,,,7070
743c6b9c17e4176a4cad35f7898d8026052bfb85,1,Yolanda M. Davis,2017-07-24 15:51:27-04:00,['10692256d62348b3616d95ed3252eb58a8ce05ef'],841,1629,2470,2887039,34,1,0.670833333,0.716666667,7076
9a5d4ff6b3a5656918d08c829a72a7579cb55541,0,Pierre Villard,2017-07-25 17:54:11+02:00,['743c6b9c17e4176a4cad35f7898d8026052bfb85'],1,5,6,2887045,2,,,,7076
759f81bc1b084a42ddbaf2f300f2f369ed87f039,0,Andy LoPresto,2017-07-25 15:25:55-07:00,['9a5d4ff6b3a5656918d08c829a72a7579cb55541'],4,8,12,2887057,2,0,0,1,7076
dc4006f423b83e7819981569d17e8d90b9a9d1a4,1,Pierre Villard,2017-07-27 08:43:00+02:00,['759f81bc1b084a42ddbaf2f300f2f369ed87f039'],34,126,160,2887217,4,0.031746032,0.80952381,1,7076
1d6b486b631b897626aee6872e39522eb77fc217,1,Pierre Villard,2017-07-27 08:57:25+02:00,['dc4006f423b83e7819981569d17e8d90b9a9d1a4'],14,16,30,2887247,1,0,0,0,7076
70878fe6d63798b50c3f3ae5440833462e1ec43a,0,Pierre Villard,2017-07-28 17:12:06+02:00,['1d6b486b631b897626aee6872e39522eb77fc217'],0,3,3,2887250,1,,,,7076
0bb141153282888427656d1471c35a5d83958780,0,James Wing,2017-07-29 14:49:22-07:00,['70878fe6d63798b50c3f3ae5440833462e1ec43a'],82,785,867,2888117,10,0.366197183,0.867605634,0.957746479,7080
cf49a58ee75601e1d0d7512104b9ed0ca2e8ec41,1,James Wing,2017-07-30 16:31:39-07:00,['0bb141153282888427656d1471c35a5d83958780'],41,222,263,2888380,3,0.117647059,0.764705882,1,7080
ef9cb5be235e48533848a6b5f87cbdeefc8933a3,1,Scott Aslan,2017-07-31 10:36:37-04:00,['cf49a58ee75601e1d0d7512104b9ed0ca2e8ec41'],22,125,147,2888527,9,0.844827586,1,0.931034483,7081
bcf60aa556ca61029025bb10f04d011018e056a0,0,Scott Aslan,2017-07-31 10:58:49-04:00,['ef9cb5be235e48533848a6b5f87cbdeefc8933a3'],3,6,9,2888536,2,0.5,1,0,7081
2502b79baef72e7e633a623784548ca7d25eeeb0,1,James Wing,2017-08-01 21:03:04-07:00,['bcf60aa556ca61029025bb10f04d011018e056a0'],222,41,263,2888799,3,0.882352941,0.235294118,0,7081
2d335821471ec10f48e3e586f66f3f14c2e0dd96,0,Pierre Villard,2017-08-03 09:59:29+02:00,['2502b79baef72e7e633a623784548ca7d25eeeb0'],0,143,143,2888942,3,0.536231884,0.536231884,0.536231884,7083
40cde0466a31e7378553dea2e9a9101a057f083a,1,Mark Payne,2017-08-03 15:13:07-04:00,['2d335821471ec10f48e3e586f66f3f14c2e0dd96'],41,222,263,2889205,3,0.117647059,0.764705882,1,7083
969bbe654c572f4156c71f1d05045219d433eab6,0,Pierre Villard,2017-08-04 16:31:56+02:00,['40cde0466a31e7378553dea2e9a9101a057f083a'],1,7,8,2889213,1,0,1,0,7083
afd4f9e034e70e996abcf7e31382ee5c42a72445,1,Bryan Bende,2017-08-04 14:19:35-04:00,['969bbe654c572f4156c71f1d05045219d433eab6'],4,275,279,2889492,8,0.764705882,1,0.957983193,7085
496a32e12c4da869996ccee4c1dcf797b229cec3,1,Bryan Bende,2017-08-04 14:54:01-04:00,['afd4f9e034e70e996abcf7e31382ee5c42a72445'],12,620,632,2890124,11,0.365325077,0.665634675,0.650154799,7087
f8f1cc8d0df4893f35d7cbe3413b7a3dd521bd18,1,Bryan Bende,2017-08-04 14:54:05-04:00,['496a32e12c4da869996ccee4c1dcf797b229cec3'],43,61,104,2890228,1,0,0,0.045454545,7087
329b1caf824055f3cdbc8640698416f8ffe7b953,0,Scott Aslan,2017-08-07 08:44:13-04:00,['f8f1cc8d0df4893f35d7cbe3413b7a3dd521bd18'],0,4,4,2890232,1,0.75,1,1,7087
8b54c2604cde4f3516d89a0f48650f7c30e34c3b,1,Matt Burgess,2017-08-07 13:40:27-04:00,['329b1caf824055f3cdbc8640698416f8ffe7b953'],24,61,85,2890317,5,0.2,0.88,1,7087
675d9890031ebc79a21e136f82046c90dc8ddd89,0,Matt Gilman,2017-08-07 15:21:58-04:00,['8b54c2604cde4f3516d89a0f48650f7c30e34c3b'],86,471,557,2890874,21,0.552631579,0,0,7091
f7f64a572c326282a20ac5249fd5466e60914227,1,Pierre Villard,2017-08-07 21:38:55+02:00,['675d9890031ebc79a21e136f82046c90dc8ddd89'],1,1,2,2890876,1,,,,7091
ee3b58368dae167b6e642ec646cb8743daaaaccf,0,Pierre Villard,2017-08-07 21:42:46+02:00,['f7f64a572c326282a20ac5249fd5466e60914227'],5,4,9,2890885,1,,,,7091
e44f436bd870dd449f4d6b34db0e0dae18134cf2,0,Scott Aslan,2017-08-07 15:58:48-04:00,['ee3b58368dae167b6e642ec646cb8743daaaaccf'],1,1,2,2890887,1,,,,7091
0029f025f833ca3addc7efc81cec575ec07cb1ef,1,Pierre Villard,2017-08-07 22:44:11+02:00,['e44f436bd870dd449f4d6b34db0e0dae18134cf2'],1,1250,1251,2892138,12,0.365200765,0.707456979,0.86998088,7098
67819e5019893fc02022a5d361759b3504276753,1,Andy LoPresto,2017-08-07 22:10:27-07:00,['0029f025f833ca3addc7efc81cec575ec07cb1ef'],16,221,237,2892375,5,0.077922078,0.077922078,1,7099
9c4fdd4ef3589d64e4e15822fc9fdb79a2315535,1,Pierre Villard,2017-08-09 12:55:12+02:00,['67819e5019893fc02022a5d361759b3504276753'],17,306,323,2892698,2,0.028846154,0.961538462,0.971153846,7099
9f1267e9490084219517e4a56c7fa7fcb0d4063e,1,Andy LoPresto,2017-08-09 19:04:36-07:00,['9c4fdd4ef3589d64e4e15822fc9fdb79a2315535'],13,25,38,2892736,3,0,1,1,7099
6ff8321cf71fb07a5d961a30b035e31c48829c91,0,Andy LoPresto,2017-08-09 21:20:08-07:00,['9f1267e9490084219517e4a56c7fa7fcb0d4063e'],5,27,32,2892768,2,0.8,1,1,7099
5150dff70b4aa210abb86e6d8c1aeb03c8c364e3,1,Pierre Villard,2017-08-10 10:05:16+02:00,['6ff8321cf71fb07a5d961a30b035e31c48829c91'],28,173,201,2892969,2,1,0,0,7100
505e93065ec98a45d75f0308255d4b3f42ba4389,0,Pierre Villard,2017-08-10 10:54:47+02:00,['5150dff70b4aa210abb86e6d8c1aeb03c8c364e3'],0,14,14,2892983,1,0.230769231,1,1,7100
528b82634f528468970eaa655c0085b1c9592b71,1,Andy LoPresto,2017-08-10 11:15:35-07:00,['505e93065ec98a45d75f0308255d4b3f42ba4389'],30,1373,1403,2894386,24,0.444646098,0.66969147,0.958257713,7105
18c82eb6af6648460365f8db286729629258e95c,0,Andy LoPresto,2017-08-10 11:54:32-07:00,['528b82634f528468970eaa655c0085b1c9592b71'],5,72,77,2894463,2,1,1,1,7106
c03f4e731bbc9ac3a74d1e1ca800942b5b73dc23,0,Andy LoPresto,2017-08-10 12:21:04-07:00,['18c82eb6af6648460365f8db286729629258e95c'],0,22,22,2894485,1,,,,7106
20d6596df097e4fd3716b25ff9927e93f7bff3a9,1,Scott Aslan,2017-08-10 17:01:25-04:00,['c03f4e731bbc9ac3a74d1e1ca800942b5b73dc23'],80,243,323,2894808,2,0.503937008,1,0.724409449,7106
ec0c8278b42916637c7ce76b05aff3f35a77ece8,0,Andy LoPresto,2017-08-10 17:08:59-07:00,['20d6596df097e4fd3716b25ff9927e93f7bff3a9'],0,57,57,2894865,1,,,,7106
96f5407ed9d1fca9a6975ddb5c93355343aa791c,0,joewitt,2017-08-10 18:13:28-07:00,['ec0c8278b42916637c7ce76b05aff3f35a77ece8'],3,0,3,2894868,1,1,1,0,7106
69f263c4d116ed10f659ef121df948d9780f8d46,1,Andy LoPresto,2017-08-10 18:41:24-07:00,['96f5407ed9d1fca9a6975ddb5c93355343aa791c'],2,65,67,2894935,4,0,0.87755102,0.918367347,7106
a6e8f0afe3407bf668e234dcce3c474f1ceb86c8,1,joewitt,2017-08-10 19:35:46-07:00,['69f263c4d116ed10f659ef121df948d9780f8d46'],0,24,24,2894959,1,0,0,1,7106
760fd75bee450a886180ff22526696f95fe4a624,1,Pierre Villard,2017-08-11 13:02:38+02:00,['a6e8f0afe3407bf668e234dcce3c474f1ceb86c8'],31,47,78,2895037,1,0.571428571,1,1,7106
f7da7e67f49fe9a22eb5357410f0bffd9f589276,0,Pierre Villard,2017-08-11 18:04:13+02:00,['760fd75bee450a886180ff22526696f95fe4a624'],24,248,272,2895309,9,0.10625,0.79375,0.68125,7106
d6ebc53076f597c038e81600dccddc5d16b27663,0,Mark Payne,2017-08-11 15:53:36-04:00,['f7da7e67f49fe9a22eb5357410f0bffd9f589276'],1,1,2,2895311,1,,,,7106
28d5a70ec0bf1c5b2126ae4bbb5af470012ed6b1,1,Andy LoPresto,2017-08-11 17:27:55-07:00,['d6ebc53076f597c038e81600dccddc5d16b27663'],0,4,4,2895315,2,,,,7106
ae940d862420e00023eca2e996ad03646f3ed5a4,0,Matt Burgess,2017-08-11 23:57:15-04:00,['28d5a70ec0bf1c5b2126ae4bbb5af470012ed6b1'],10,171,181,2895496,2,1,1,1,7107
84935d4f7840fe9b22aa929afb403718c073e627,1,joewitt,2017-08-11 22:01:46-07:00,['ae940d862420e00023eca2e996ad03646f3ed5a4'],35,111,146,2895642,6,0.396226415,1,1,7107
451f9cf12407c4f7abeb8e538e3f55ecbf40abab,1,joewitt,2017-08-11 22:01:46-07:00,['84935d4f7840fe9b22aa929afb403718c073e627'],250,2929,3179,2898821,46,0.187803188,0.623700624,0.683991684,7119
bac175a00f47fd3e9cdf45e69d80ffa3c2e4f97c,0,Scott Aslan,2017-08-13 10:01:36-04:00,['451f9cf12407c4f7abeb8e538e3f55ecbf40abab'],2,41,43,2898864,2,,,,7119
8aa445008499377c779b43fb3c5529023c14142f,1,Matt Burgess,2017-08-14 13:41:10-04:00,['bac175a00f47fd3e9cdf45e69d80ffa3c2e4f97c'],1,184,185,2899049,3,0.338235294,1,1,7120
50f22162b06df99094fb8ac99e6520a2ad1d9d92,0,Bryan Bende,2017-08-14 15:28:07-04:00,['8aa445008499377c779b43fb3c5529023c14142f'],3,33,36,2899085,2,0,1,1,7120
a1706d12f5bbe824c440a375945dd6038baee4cf,1,Koji Kawamura,2017-08-15 11:24:48+09:00,['50f22162b06df99094fb8ac99e6520a2ad1d9d92'],24,111,135,2899220,9,0.098360656,0.901639344,0.245901639,7120
abca9d1464fe0d6a5deefb28260465a310a97bd4,0,Andy LoPresto,2017-08-15 12:10:43-04:00,['a1706d12f5bbe824c440a375945dd6038baee4cf'],1,37,38,2899258,2,1,1,0.777777778,7120
79300de7a9866993a2e401ac7580892b7ce1512c,0,Scott Aslan,2017-08-16 10:31:10-04:00,['abca9d1464fe0d6a5deefb28260465a310a97bd4'],1,14,15,2899273,2,0.25,1,1,7120
02c05bc2037ca2e4ee1850a8cb765d85a4f3b8a3,0,Scott Aslan,2017-08-16 11:56:23-04:00,['79300de7a9866993a2e401ac7580892b7ce1512c'],9,28,37,2899310,3,1,1,1,7120
6df112e4b1c2495d281b1edfce84219e3bea581a,0,Koji Kawamura,2017-08-17 08:07:37+09:00,['02c05bc2037ca2e4ee1850a8cb765d85a4f3b8a3'],9,274,283,2899593,6,0.768656716,0.768656716,1,7122
9f23ec360acd2bf4d949f08b3eb0cea3decc5263,0,Koji Kawamura,2017-08-17 08:20:30+09:00,['6df112e4b1c2495d281b1edfce84219e3bea581a'],0,2,2,2899595,1,,,,7122
c1b99d584d93bb6f26ba0986f2fcaf663b0caef3,0,Koji Kawamura,2017-08-17 08:30:07+09:00,['9f23ec360acd2bf4d949f08b3eb0cea3decc5263'],31,203,234,2899829,4,0.040322581,1,0.967741935,7122
5cd8e93beb30075ebe8623c2a278a5c9cf1afc75,1,Matt Gilman,2017-08-17 10:42:29-04:00,['c1b99d584d93bb6f26ba0986f2fcaf663b0caef3'],1702,5129,6831,2906660,93,0.394942806,0.701384708,0.555689344,7143
69a08e78c2cd47661e3d775ceece94ae82ac567e,0,Matt Gilman,2017-08-17 12:47:46-04:00,['5cd8e93beb30075ebe8623c2a278a5c9cf1afc75'],14,11,25,2906685,1,1,1,0,7143
6b5015e39b4233cf230151fb45bebcb21df03730,1,Bryan Bende,2017-08-17 14:29:05-04:00,['69a08e78c2cd47661e3d775ceece94ae82ac567e'],43,288,331,2907016,11,0.232876712,0.698630137,0.821917808,7143
60d4672195b89cb12e1f75f0a537c9adbab654bd,1,Matthew Burgess,2017-08-17 16:07:03-04:00,['6b5015e39b4233cf230151fb45bebcb21df03730'],3,4,7,2907023,3,,,,7143
0bcb19771f923b64b28f808bdbf98128387dd445,0,Scott Aslan,2017-08-18 09:08:46-04:00,['60d4672195b89cb12e1f75f0a537c9adbab654bd'],4,4,8,2907031,1,,,,7143
41984bed1302f5c8bd898c9d1772357f67363194,0,Scott Aslan,2017-08-18 12:48:49-04:00,['0bcb19771f923b64b28f808bdbf98128387dd445'],1,3,4,2907035,2,,,,7143
8cb501443bbe27fa043572cc3b993529ff245722,0,Matt Burgess,2017-08-21 08:49:57-04:00,['41984bed1302f5c8bd898c9d1772357f67363194'],0,752,752,2907787,6,0.134517766,0.822335025,0.992385787,7146
a3401c3b95361cc895da8e3a1cf47e60d354c311,1,Scott Aslan,2017-08-21 12:56:12-04:00,['8cb501443bbe27fa043572cc3b993529ff245722'],10,13,23,2907810,2,,,,7146
05700a20086233cf8dbe7832e165a1959d610a83,1,Scott Aslan,2017-08-21 12:56:19-04:00,['a3401c3b95361cc895da8e3a1cf47e60d354c311'],1,1,2,2907812,1,,,,7146
cf5763939658826fcfe3318ba100c834e30b50c5,0,Pierre Villard,2017-08-22 22:40:26+02:00,['05700a20086233cf8dbe7832e165a1959d610a83'],17,30,47,2907859,3,0.5,1,1,7146
acee2627ca562a4dc94adfe9836ecd32a4666902,0,Jeff Storck,2017-08-23 15:38:44-04:00,['cf5763939658826fcfe3318ba100c834e30b50c5'],16,89,105,2907964,5,0,0.375,0,7146
a7ea178cdc02355cf8fa1b83555351a477522ecd,1,Scott Aslan,2017-08-24 18:38:29-04:00,['acee2627ca562a4dc94adfe9836ecd32a4666902'],1,9,10,2907974,2,0,0,1,7146
a9ee2aa5e4cd3eafa7369840f199e2f1b48900ca,1,Scott Aslan,2017-08-24 18:38:29-04:00,['a7ea178cdc02355cf8fa1b83555351a477522ecd'],2,3,5,2907979,2,,,,7146
6c426f7a12d636df66d224a982617bc34535b3e1,0,Scott Aslan,2017-08-24 18:39:12-04:00,['a9ee2aa5e4cd3eafa7369840f199e2f1b48900ca'],2,2,4,2907983,1,,,,7146
0eda71a9a642432accc536206516df0f114b176a,0,Mark Payne,2017-08-25 10:15:55-04:00,['6c426f7a12d636df66d224a982617bc34535b3e1'],2,209,211,2908194,5,0.26984127,0.761904762,1,7149
e3da44fb626a495f18ead72955a0854d6b1f7151,1,ricky,2017-08-25 10:53:31-04:00,['0eda71a9a642432accc536206516df0f114b176a'],0,983,983,2909177,13,0.486153846,0.695384615,0.830769231,7159
a4e729c7a77e73fad6d827df6411f040461d060a,0,Scott Aslan,2017-08-25 16:20:32-04:00,['e3da44fb626a495f18ead72955a0854d6b1f7151'],1,2,3,2909180,1,1,1,1,7159
28ee70222b892fb799f5f74a31a9de678d9fb629,1,Bryan Bende,2017-08-28 11:31:03-04:00,['a4e729c7a77e73fad6d827df6411f040461d060a'],130,463,593,2909773,9,0.737226277,0.846715328,0.664233577,7160
e68ff153e81ddb82d1136d44a96bdb7a70da86d1,1,Bryan Bende,2017-08-28 11:31:04-04:00,['28ee70222b892fb799f5f74a31a9de678d9fb629'],26,137,163,2909936,5,0.351351351,0.72972973,0.837837838,7160
e2b8be53cbd0485f5aeec713100ddf1f7b6ed3f4,1,Matt Gilman,2017-08-28 15:10:24-04:00,['e68ff153e81ddb82d1136d44a96bdb7a70da86d1'],6,10,16,2909952,2,,,,7160
3de0b8edff22616165f6fb0c5beebe31ac27ad17,0,Mark Payne,2017-08-30 11:54:31-04:00,['e2b8be53cbd0485f5aeec713100ddf1f7b6ed3f4'],27,25,52,2910004,1,,,,7160
a53a37f9cabab6a3d52018cde88aceebf994c7c3,0,Matthew Burgess,2017-08-30 13:52:05-04:00,['3de0b8edff22616165f6fb0c5beebe31ac27ad17'],2,58,60,2910064,3,0.255813953,0.953488372,1,7160
e62417ea6b189ad0e7522cffd68481dd5df7ffd8,1,Matthew Burgess,2017-08-30 14:01:27-04:00,['a53a37f9cabab6a3d52018cde88aceebf994c7c3'],10,73,83,2910147,2,0.097560976,0.756097561,0.756097561,7160
d28e61c5ddc7486747d431dfd82e17dc435ca817,1,Andy LoPresto,2017-08-30 20:17:01-07:00,['e62417ea6b189ad0e7522cffd68481dd5df7ffd8'],56,369,425,2910572,9,0.740384615,0.971153846,1,7163
20a6374bf788827fc12c4636093d905312552d92,0,Pierre Villard,2017-08-31 09:22:22+02:00,['d28e61c5ddc7486747d431dfd82e17dc435ca817'],0,12,12,2910584,2,,,,7163
bfd6c0aef768f53be8fdea62afdcd5404099e089,1,James Wing,2017-09-05 21:29:16-07:00,['20a6374bf788827fc12c4636093d905312552d92'],5,224,229,2910813,2,0.158730159,0.841269841,0.841269841,7163
c3754c3921ec4f1786bbd36dbfbc9190d6900d1c,0,Matthew Burgess,2017-09-06 13:05:18-04:00,['bfd6c0aef768f53be8fdea62afdcd5404099e089'],3,6,9,2910822,3,1,1,1,7163
0536c3edf146b27c50e26c026e4cce2c1624acbd,0,Matt Gilman,2017-09-06 13:13:24-04:00,['c3754c3921ec4f1786bbd36dbfbc9190d6900d1c'],4,309,313,2911135,4,1,1,1,7165
458c987fe3396ecce460c6ae7c099ab8f8b6546d,1,Matthew Burgess,2017-09-06 13:29:19-04:00,['0536c3edf146b27c50e26c026e4cce2c1624acbd'],3,12,15,2911150,2,0,0,0.333333333,7165
9ac88d210a181b36679db701766c35d662fa7ce2,0,Matthew Burgess,2017-09-06 13:33:18-04:00,['458c987fe3396ecce460c6ae7c099ab8f8b6546d'],8,20,28,2911178,2,0,1,1,7165
527ce0b4efe7e23f95f89f57ace7944aafee8df0,1,Matthew Burgess,2017-09-06 15:56:12-04:00,['9ac88d210a181b36679db701766c35d662fa7ce2'],24,146,170,2911348,3,0.489361702,0.829787234,0.936170213,7166
ae30c7f35013e1faf26c6bd3af122362fa4b361e,1,Matthew Burgess,2017-09-07 11:05:38-04:00,['527ce0b4efe7e23f95f89f57ace7944aafee8df0'],36,309,345,2911693,2,0.098445596,1,0.958549223,7166
c10ff574c4602fe05f5d1dae5eb0b1bd24026c02,1,Matthew Burgess,2017-09-07 14:41:26-04:00,['ae30c7f35013e1faf26c6bd3af122362fa4b361e'],17,288,305,2911998,5,0,0.958549223,0.984455959,7166
03e51ee8acea7d72a13aea96f60bb726087136ee,1,Andy LoPresto,2017-09-07 17:34:00-07:00,['c10ff574c4602fe05f5d1dae5eb0b1bd24026c02'],44,69,113,2912111,18,,,,7166
20d23e836ea28198a2cc2234d09362b674f2a19d,0,Andy LoPresto,2017-09-07 18:29:13-07:00,['03e51ee8acea7d72a13aea96f60bb726087136ee'],6,6,12,2912123,2,,,,7166
1f67cbf62886019d1148468fd8683ed78b4d0a12,1,Mark Payne,2017-09-08 12:37:40-04:00,['20d23e836ea28198a2cc2234d09362b674f2a19d'],203,208,411,2912534,48,0.5,0.666666667,0.333333333,7166
65596044563bd8217a1fcfcd9bfafa02f2f13160,1,Mark Payne,2017-09-08 12:44:37-04:00,['1f67cbf62886019d1148468fd8683ed78b4d0a12'],14,57,71,2912605,3,0.027777778,0.861111111,0.972222222,7166
9ebf2cfaf1fdb1a28427aed5a8168004071efd12,1,Pierre Villard,2017-09-08 18:50:49+02:00,['65596044563bd8217a1fcfcd9bfafa02f2f13160'],15,257,272,2912877,8,0,0.843537415,0.80952381,7170
c9789adf21452d1ea3829b7a85b039ab3ece6a77,0,Mark Payne,2017-09-08 14:14:42-04:00,['9ebf2cfaf1fdb1a28427aed5a8168004071efd12'],0,4,4,2912881,1,0,0,1,7170
e203358bf34db53a6e21e505ec2854995a6b6f38,0,Mark Payne,2017-09-08 16:17:38-04:00,['c9789adf21452d1ea3829b7a85b039ab3ece6a77'],1,1,2,2912883,1,,,,7170
9367c280645b6a8f29a4905537ac6c3db03c6737,1,Tony Kurc,2017-09-10 22:50:37-04:00,['e203358bf34db53a6e21e505ec2854995a6b6f38'],117,167,284,2913167,3,0,1,0,7170
1aeb517c273d28f252f5d1fee62fa564cd9e8269,0,Matt Gilman,2017-09-11 09:46:32-04:00,['9367c280645b6a8f29a4905537ac6c3db03c6737'],0,11,11,2913178,1,1,1,1,7170
897b8ab601c2c5912163a8fc3c492cfd41d8e129,1,Koji Kawamura,2017-09-11 23:43:56+09:00,['1aeb517c273d28f252f5d1fee62fa564cd9e8269'],0,12,12,2913190,5,0,0.8,1,7170
5957f6ee95052a2d97377f422900087dade67470,1,Matt Gilman,2017-09-11 13:16:53-04:00,['897b8ab601c2c5912163a8fc3c492cfd41d8e129'],71,451,522,2913712,18,0.714285714,0.211428571,0.474285714,7170
cb7bc93e28a9285e2b250dadd0e3496f9e01fac6,0,Matt Gilman,2017-09-11 14:21:37-04:00,['5957f6ee95052a2d97377f422900087dade67470'],3,9,12,2913724,1,,,,7170
d698f227df09743148067ec183bcf2f672a8a8c4,0,Koji Kawamura,2017-09-12 10:30:44+09:00,['cb7bc93e28a9285e2b250dadd0e3496f9e01fac6'],0,4,4,2913728,1,1,1,1,7170
7423b41e3cfbace8a01ca9734521ae49117dbba8,0,Mark Payne,2017-09-12 15:31:10-04:00,['d698f227df09743148067ec183bcf2f672a8a8c4'],0,4,4,2913732,1,0,0,1,7170
b452f8c251a01b52fbab25d05ff9208f46c2b8b5,1,Pierre Villard,2017-09-12 21:41:59+02:00,['7423b41e3cfbace8a01ca9734521ae49117dbba8'],16,167,183,2913915,4,0.261904762,0.952380952,0.94047619,7171
0e5027946756ca4696aeb9ecd769b2cddf1f16cb,0,Pierre Villard,2017-09-13 12:14:13+02:00,['b452f8c251a01b52fbab25d05ff9208f46c2b8b5'],2,2,4,2913919,1,,,,7171
1f1269c817a32b32fd19f32f942dc92cbf1e4a8d,1,Scott Aslan,2017-09-13 13:04:24-04:00,['0e5027946756ca4696aeb9ecd769b2cddf1f16cb'],32,33,65,2913984,2,1,0.333333333,1,7171
e52e9acc598e4b31a6bd9720ba866567190fb8a6,0,Pierre Villard,2017-09-14 09:40:36+02:00,['1f1269c817a32b32fd19f32f942dc92cbf1e4a8d'],0,158,158,2914142,5,0.508474576,0.508474576,0.898305085,7173
1e70e24267351a9c189ea26ee0536fdc8dbd7bd6,1,Pierre Villard,2017-09-14 11:02:48+02:00,['e52e9acc598e4b31a6bd9720ba866567190fb8a6'],0,32,32,2914174,2,0,0,0.038461538,7173
e01d59a462e3047ccd8bbfdc608631bfd90db533,0,Pierre Villard,2017-09-14 15:39:32+02:00,['1e70e24267351a9c189ea26ee0536fdc8dbd7bd6'],89,104,193,2914367,2,0.4,0.4,0.9,7173
91383264d853881d920f07b1e9c928dff2906c52,1,Pierre Villard,2017-09-14 16:46:18+02:00,['e01d59a462e3047ccd8bbfdc608631bfd90db533'],2,6,8,2914375,1,0.25,0.25,1,7173
eac47e90cbfa39a8e40512379b02ff745262b5af,1,Mark Payne,2017-09-14 11:12:54-04:00,['91383264d853881d920f07b1e9c928dff2906c52'],490,2897,3387,2917762,33,0.460875332,0.770557029,0.854774536,7178
66479464be67917c308ccc344cfff58da325748c,1,Pierre Villard,2017-09-16 14:41:07+02:00,['eac47e90cbfa39a8e40512379b02ff745262b5af'],2,2,4,2917766,2,,,,7178
2ee21b9255f8188b2843314e7fc0bcd0e7bb7bb8,0,Pierre Villard,2017-09-19 17:37:21+02:00,['66479464be67917c308ccc344cfff58da325748c'],0,1,1,2917767,1,1,1,1,7178
90ed08ec338d014d6ed5ae6ab2b14f230ccd724a,1,Pierre Villard,2017-09-21 15:21:22+02:00,['2ee21b9255f8188b2843314e7fc0bcd0e7bb7bb8'],37,181,218,2917985,4,0.46835443,1,0.873417722,7178
7b07eb0577d17132374203627bd759771fc62868,1,Pierre Villard,2017-09-21 16:11:07+02:00,['90ed08ec338d014d6ed5ae6ab2b14f230ccd724a'],4,70,74,2918059,2,,,,7178
a813ae113e4d1dfb797845136d65521eb8dc60bb,0,Pierre Villard,2017-09-21 16:30:10+02:00,['7b07eb0577d17132374203627bd759771fc62868'],26,41,67,2918126,2,0,0.076923077,0.923076923,7178
329dbe3a64f70e283ee131f8313dadf8ec96f3d4,0,Pierre Villard,2017-09-21 17:10:47+02:00,['a813ae113e4d1dfb797845136d65521eb8dc60bb'],1,12,13,2918139,1,0.5,0.5,1,7178
0c0c33411d586af8c0c195181747e9d55709a574,1,Pierre Villard,2017-09-22 10:56:15+02:00,['329dbe3a64f70e283ee131f8313dadf8ec96f3d4'],5,42,47,2918186,2,0.666666667,1,1,7178
50d018566db4d2c6f97995dcde7a180d7e154ae6,0,Matt Gilman,2017-09-22 11:53:58-04:00,['0c0c33411d586af8c0c195181747e9d55709a574'],7,64,71,2918257,11,0.872340426,0.978723404,0.382978723,7178
05b5dd14884c3ce27f9978f84b357397f1d6f20a,1,Matthew Burgess,2017-09-22 12:41:17-04:00,['50d018566db4d2c6f97995dcde7a180d7e154ae6'],20,19,39,2918296,1,1,1,0,7178
9a8e6b2eb150865361dda241d71405c5a969f5e8,1,Matthew Burgess,2017-09-22 13:33:07-04:00,['05b5dd14884c3ce27f9978f84b357397f1d6f20a'],2,1399,1401,2919697,19,0.358974359,0.792540793,0.946386946,7193
9e2c7be7d3c6a380c5f61074d9a5a690b617c3dc,1,Matt Gilman,2017-09-22 14:31:38-04:00,['9a8e6b2eb150865361dda241d71405c5a969f5e8'],220,396,616,2920313,22,0.888888889,0,0.944444444,7196
a29348f2a4d8ec6576f1ec73c57911b827d46315,1,Matthew Burgess,2017-09-22 14:34:00-04:00,['9e2c7be7d3c6a380c5f61074d9a5a690b617c3dc'],11,82,93,2920406,3,0.06,0.24,0.38,7196
3fb704c58f44f106779ac536bb6d5802c829f626,1,joewitt,2017-09-22 22:08:19-04:00,['a29348f2a4d8ec6576f1ec73c57911b827d46315'],0,7049,7049,2927455,39,0.354663774,0.74692697,0.78054953,7232
c6f4421c8e59c896ed9887ced256a73b920f4ccb,0,Jeff Storck,2017-09-23 17:41:42-04:00,['3fb704c58f44f106779ac536bb6d5802c829f626'],33,25,58,2927513,2,1,0,0,7232
6eab91923e8deb149a0c2d851d4d9063e5eb5838,1,Mark Payne,2017-09-25 13:19:23-04:00,['c6f4421c8e59c896ed9887ced256a73b920f4ccb'],10,716,726,2928239,4,0.379518072,0.68373494,0.858433735,7234
1ca4fa3a831bfabecf699541375af2551b80177d,1,Bryan Bende,2017-09-25 14:52:33-04:00,['6eab91923e8deb149a0c2d851d4d9063e5eb5838'],6,17,23,2928262,4,,,,7234
3b1b326b1316d3ec2cc186ae6a7c77228ab1ed22,1,Matthew Burgess,2017-09-25 22:32:15-04:00,['1ca4fa3a831bfabecf699541375af2551b80177d'],76,257,333,2928595,7,0.484848485,0.737373737,0.878787879,7237
2c1f5b49e449d34c030080ee46b6b580772c5378,1,joewitt,2017-09-26 10:55:29-04:00,['3b1b326b1316d3ec2cc186ae6a7c77228ab1ed22'],630,1507,2137,2930732,33,0.867924528,1,0.844339623,7238
b7b6d9082c4b5aba5c380f3b48088207d8424909,1,Andy LoPresto,2017-09-26 18:48:19-07:00,['2c1f5b49e449d34c030080ee46b6b580772c5378'],2,110,112,2930844,2,0.317073171,0.987804878,0.987804878,7238
d47bbd12ce41d2bfebf255e303cbeb95362e7888,1,Bryan Bende,2017-09-27 09:51:06-04:00,['b7b6d9082c4b5aba5c380f3b48088207d8424909'],11,23,34,2930878,2,0,1,1,7238
6c798d18ef2e20ff6d575cdcd63618fe05e71012,1,Jeff Storck,2017-09-27 16:22:18-04:00,['d47bbd12ce41d2bfebf255e303cbeb95362e7888'],58,1203,1261,2932139,22,0.818380744,0.938730853,0.960612691,7247
d27103100db253824a82fbdecc5836607d07fff3,0,Koji Kawamura,2017-09-28 08:30:47+09:00,['6c798d18ef2e20ff6d575cdcd63618fe05e71012'],16,32,48,2932187,16,,,,7247
9ff7d15603a339c65ecc4319d87ac75f8d6e4526,0,Koji Kawamura,2017-09-28 08:31:13+09:00,['d27103100db253824a82fbdecc5836607d07fff3'],27,27,54,2932241,16,,,,7247
502adc6e8a01b171aa5274bdbd8f0deac63ee5e5,0,Jeff Storck,2017-09-28 11:08:47-04:00,['9ff7d15603a339c65ecc4319d87ac75f8d6e4526'],5,0,5,2932246,1,,,,7247
cd213db0e211617937b3322b39f5e4b60a812f6c,0,Jeff Storck,2017-09-28 12:20:40-04:00,['502adc6e8a01b171aa5274bdbd8f0deac63ee5e5'],0,59,59,2932305,1,,,,7247
bdab3cda0a0552f663d3c0350240afc21c4906cd,0,Mark Payne,2017-09-28 13:39:55-04:00,['cd213db0e211617937b3322b39f5e4b60a812f6c'],0,140,140,2932445,9,0,1,1,7252
e6508ba7d3da5bba54abd6233a7a8f9dd4c32151,1,Jeff Storck,2017-09-28 13:45:21-04:00,['cd213db0e211617937b3322b39f5e4b60a812f6c'],689,684,1373,2933818,337,,,,7252
a57911d3db076743854caa59dc1425b5a44fda07,1,Jeff Storck,2017-09-28 13:45:36-04:00,['e6508ba7d3da5bba54abd6233a7a8f9dd4c32151'],676,676,1352,2935170,337,,,,7252
feaf44b623be3201987bcfb44e05b7bb96d0149f,0,Andy LoPresto,2017-09-28 14:49:29-07:00,['bdab3cda0a0552f663d3c0350240afc21c4906cd'],12,61,73,2935243,1,1,1,1,7252
2d5b8c7267eca6e0f234eeaf9e3553bdfba75da9,1,gardellajuanpablo,2017-09-29 10:57:53-03:00,['feaf44b623be3201987bcfb44e05b7bb96d0149f'],14,38,52,2935295,3,0.375,0,0,7252
b3be2459e4d07f0150c0b0938ea709f954d77d18,0,Mark Payne,2017-09-29 10:33:56-04:00,['2d5b8c7267eca6e0f234eeaf9e3553bdfba75da9'],6,6,12,2935307,3,,,,7252
2694adcca9bf22993bc166d257c6f4d7951c4d79,0,Jeff Storck,2017-10-02 13:58:54-04:00,"['b3be2459e4d07f0150c0b0938ea709f954d77d18', 'a57911d3db076743854caa59dc1425b5a44fda07']",688,683,1371,2936678,337,,,,7252
36b16c9cdd7a4a4c36f7f2618416fd5eea7ed34a,1,Jeff Storck,2017-10-02 14:20:40-04:00,['2694adcca9bf22993bc166d257c6f4d7951c4d79'],2,2,4,2936682,2,,,,7252
58e4fb576e457b3ce515a1b22ec383b606efd297,1,Mark Payne,2017-10-02 15:40:29-04:00,['36b16c9cdd7a4a4c36f7f2618416fd5eea7ed34a'],80,75,155,2936837,2,0.5,0,1,7252
697c382d9bd4a3aaa05bc28b64a5e74592101c61,1,Matt Gilman,2017-10-03 09:50:11-04:00,['58e4fb576e457b3ce515a1b22ec383b606efd297'],633,647,1280,2938117,189,,,,7252
e773fa551362d9adf9c9544b1525fd38e9c07887,0,Mark Payne,2017-10-03 13:23:58-04:00,['697c382d9bd4a3aaa05bc28b64a5e74592101c61'],2,7,9,2938126,1,,,,7252
8741b6f6a5fea9815984f1e48dbe723d7948746f,1,Bryan Bende,2017-10-04 11:45:35-04:00,['e773fa551362d9adf9c9544b1525fd38e9c07887'],42,65,107,2938233,3,0,0.4,0.7,7252
0a47a3bde58ce6b07ef10c6ecd6fd9d415b76127,0,Bryan Bende,2017-10-04 12:47:28-04:00,['8741b6f6a5fea9815984f1e48dbe723d7948746f'],1,12,13,2938246,1,0,0,1,7252
f1bd866005e8e06e502ebf67fa6540bf379adfcf,0,Bryan Bende,2017-10-04 15:49:51-04:00,['0a47a3bde58ce6b07ef10c6ecd6fd9d415b76127'],26,61,87,2938333,4,1,,,7252
ea2c91f9d052016390c07bbc06fd7f8c734d373b,0,Mark Payne,2017-10-04 16:02:52-04:00,['f1bd866005e8e06e502ebf67fa6540bf379adfcf'],1,4,5,2938338,1,,,,7252
c29ee4a6fac9b36050e3c5af064232240c205474,1,Matt Gilman,2017-10-05 09:45:26-04:00,['ea2c91f9d052016390c07bbc06fd7f8c734d373b'],40,194,234,2938572,6,0,0.095238095,0.952380952,7253
5e2fb8cff1f74fba8c354157475fe0edaf4b2ec9,0,Matt Gilman,2017-10-05 13:55:59-04:00,['c29ee4a6fac9b36050e3c5af064232240c205474'],18,29,47,2938619,2,0.666666667,1,1,7253
d4168f5ff1c5afb03f3797ad4573aef9512d4aff,1,Matt Gilman,2017-10-05 15:23:52-04:00,['5e2fb8cff1f74fba8c354157475fe0edaf4b2ec9'],38,69,107,2938726,26,,,,7253
0876cf12b17ca247703f30c87773d7efac947bdd,1,Matthew Burgess,2017-10-05 16:05:22-04:00,['d4168f5ff1c5afb03f3797ad4573aef9512d4aff'],31,86,117,2938843,3,0,0.25,1,7253
701597775fd2e98d7c577c5c1c683ac15d42098c,0,Matthew Burgess,2017-10-05 16:44:43-04:00,['0876cf12b17ca247703f30c87773d7efac947bdd'],1,55,56,2938899,2,1,1,0.666666667,7254
4ca0fe289ebd0ce97b5ab575a8111b37b7e7878e,0,Matthew Burgess,2017-10-05 17:26:04-04:00,['701597775fd2e98d7c577c5c1c683ac15d42098c'],1,1,2,2938901,1,,,,7254
1d5df4a5ecdf11bd411c941e8054b6e260824c70,0,Mark Payne,2017-10-06 11:15:59-04:00,['4ca0fe289ebd0ce97b5ab575a8111b37b7e7878e'],267,253,520,2939421,6,,,,7254
582df7f4e8d462e87958e4894bdeac323dc69803,1,joewitt,2017-10-06 15:03:37-04:00,['1d5df4a5ecdf11bd411c941e8054b6e260824c70'],55,58,113,2939534,2,0,0,0,7254
7ad752015037794b30827dcf728afabed925b778,0,joewitt,2017-10-06 15:06:32-04:00,['582df7f4e8d462e87958e4894bdeac323dc69803'],0,1,1,2939535,1,1,1,0,7254
59b60e62d86d5008abbce4db4f3505706b0a52bb,0,Bryan Bende,2017-10-06 15:37:22-04:00,['7ad752015037794b30827dcf728afabed925b778'],1,1,2,2939537,1,,,,7254
39c5c5ab42e2d376741d388a43db03c11eb7ac00,0,joewitt,2017-10-06 16:02:10-04:00,['59b60e62d86d5008abbce4db4f3505706b0a52bb'],1,1,2,2939539,1,,,,7254
eb97a68110c76725ce4cbb6d5682d0625527f10f,0,Bryan Bende,2017-10-07 15:36:44-04:00,['39c5c5ab42e2d376741d388a43db03c11eb7ac00'],1,373,374,2939913,6,0.453125,0.7578125,1,7257
5930c0c21246c4365698cfb1c90ebe2c5a446d07,1,Bryan Bende,2017-10-07 15:36:49-04:00,['eb97a68110c76725ce4cbb6d5682d0625527f10f'],353,439,792,2940705,7,0.571428571,1,1,7260
6201c06c996746024249b1f448cea09d16dc7ba8,1,Bryan Bende,2017-10-08 10:44:11-04:00,['5930c0c21246c4365698cfb1c90ebe2c5a446d07'],1,1297,1298,2942003,20,0.822335025,1,0.923857868,7276
acf05e0636f6a766d3cfa3d76c10ab6dbbb78c93,0,Joe Skora,2017-10-08 15:34:48-04:00,['6201c06c996746024249b1f448cea09d16dc7ba8'],49,64,113,2942116,1,0,1,1,7276
b5e1fa7ff66fd81e3f585ca771c90857c1edc011,1,Scott Aslan,2017-10-09 10:10:17-04:00,['acf05e0636f6a766d3cfa3d76c10ab6dbbb78c93'],1,1,2,2942118,1,,,,7276
b2c68d2b2930b9f7befe35a38681650f6cde893c,0,Scott Aslan,2017-10-09 15:21:42-04:00,['b5e1fa7ff66fd81e3f585ca771c90857c1edc011'],16,111,127,2942245,17,,,,7291
13e42678b64953de593456363fcf3ffb97e00731,0,joewitt,2017-10-10 00:17:44-04:00,['b2c68d2b2930b9f7befe35a38681650f6cde893c'],2,104,106,2942351,3,,,,7292
883c223ced84de2b9440ed3c5e3686533c03365f,1,Pierre Villard,2017-10-10 08:50:57+02:00,['13e42678b64953de593456363fcf3ffb97e00731'],97,110,207,2942558,1,0,0,1,7292
9324a2a74200e96dce9574e1b0105e9ac4a46871,0,Pierre Villard,2017-10-10 09:02:02+02:00,['883c223ced84de2b9440ed3c5e3686533c03365f'],10,85,95,2942653,5,0.526315789,0.105263158,1,7292
6baea8ccffe93e6ea6289cac8970f95e95f797bf,1,Andy LoPresto,2017-10-12 10:27:02-07:00,['9324a2a74200e96dce9574e1b0105e9ac4a46871'],2127,2976,5103,2947756,190,0,1,1,7293
0e3d83c3b848bed5e32c93371375aa4514137986,0,Matt Gilman,2017-10-13 14:31:10-04:00,['6baea8ccffe93e6ea6289cac8970f95e95f797bf'],0,0,0,2947756,2,,,,7293
ba8f17bac0d5117daa5f660ff79c86c62017528e,0,Scott Aslan,2017-10-16 12:04:16-04:00,['0e3d83c3b848bed5e32c93371375aa4514137986'],1,1,2,2947758,1,,,,7293
b950eed1a5a3c7c604ecc6c46edc397fda597cfe,0,joewitt,2017-10-16 17:18:01-04:00,['ba8f17bac0d5117daa5f660ff79c86c62017528e'],25,34,59,2947817,1,0,0,1,7293
fd00df3d2f593b6da6c7498fa66ec6917e1639e0,1,Koji Kawamura,2017-10-17 14:56:49+09:00,['b950eed1a5a3c7c604ecc6c46edc397fda597cfe'],220,510,730,2948547,7,0.148148148,0.925925926,1,7294
4edafad6e5dc268136e191cdb7e8056af95e14cc,0,Pierre Villard,2017-10-18 13:37:31+02:00,['fd00df3d2f593b6da6c7498fa66ec6917e1639e0'],93,416,509,2949056,4,0.116402116,0.703703704,0.465608466,7294
1a1e01c5680ad8e5ba605254c4b4b12fe0e2c071,0,Matthew Burgess,2017-10-18 10:13:03-04:00,['4edafad6e5dc268136e191cdb7e8056af95e14cc'],1,37,38,2949094,2,0,1,1,7294
b8a3862078c91e1184575ebf469b1660539860be,0,Scott Aslan,2017-10-18 13:42:58-04:00,['1a1e01c5680ad8e5ba605254c4b4b12fe0e2c071'],2,9,11,2949105,1,0.833333333,1,1,7294
53e63eaf7cae4ce683010489fdc8dedd49bc52b0,1,Mark Payne,2017-10-18 15:25:23-04:00,['b8a3862078c91e1184575ebf469b1660539860be'],9,111,120,2949225,8,0.490566038,0.943396226,0.811320755,7294
95e86c1f51bb0ede2f9a02e2f7bfccf5c8e7200b,0,Pierre Villard,2017-10-19 10:20:40+02:00,['53e63eaf7cae4ce683010489fdc8dedd49bc52b0'],0,1,1,2949226,1,1,1,1,7294
fb839fff5617a91b9d6c6fd4f43d78d1e12c560a,0,Matt Gilman,2017-10-19 15:34:39-04:00,['95e86c1f51bb0ede2f9a02e2f7bfccf5c8e7200b'],1,1,2,2949228,1,,,,7294
2acf6bdf7ad66a3927c99e5f767f4007eecd9274,0,Pierre Villard,2017-10-20 18:15:02+02:00,['fb839fff5617a91b9d6c6fd4f43d78d1e12c560a'],2,2,4,2949232,1,,,,7294
c894246e036b7733a4ca3808aaea203b9a82812e,1,James Wing,2017-10-21 12:58:40-07:00,['2acf6bdf7ad66a3927c99e5f767f4007eecd9274'],10,503,513,2949745,25,,,,7299
c06dee2321360b1eebce420d4edb36b629ee8b64,1,Koji Kawamura,2017-10-23 18:53:54+09:00,['c894246e036b7733a4ca3808aaea203b9a82812e'],258,629,887,2950632,12,0,0.761904762,0.994047619,7301
10f27cd5f0c077ad99848453ecaa253ca8ee5f9a,0,Mark Payne,2017-10-25 11:31:09-04:00,['c06dee2321360b1eebce420d4edb36b629ee8b64'],2,2,4,2950636,2,,,,7301
32c0e2be3b824deaf749278718d9ca35e43e33e3,1,Matt Gilman,2017-10-26 10:27:57-04:00,['10f27cd5f0c077ad99848453ecaa253ca8ee5f9a'],14,89,103,2950739,2,0.622641509,0.754716981,1,7301
f2bd9f87ba3ec6c3aca502aaccf7227b58cd3a0b,0,Matt Gilman,2017-10-26 12:43:02-04:00,['32c0e2be3b824deaf749278718d9ca35e43e33e3'],3,8,11,2950750,2,1,1,1,7301
1625f719e6c7bbe37fdd9335bc28a5398fbcb856,0,Scott Aslan,2017-10-26 20:53:37-04:00,['f2bd9f87ba3ec6c3aca502aaccf7227b58cd3a0b'],0,3,3,2950753,1,0,1,1,7301
856dedab122f767cf52b18d28b0adf3ba3c09c70,1,Pierre Villard,2017-10-27 09:17:51+02:00,['1625f719e6c7bbe37fdd9335bc28a5398fbcb856'],3,69,72,2950825,2,0.111111111,1,1,7301
e3482cc772c9e6324382aeb09a09f7a93898ece1,1,Pierre Villard,2017-10-27 10:34:15+02:00,['856dedab122f767cf52b18d28b0adf3ba3c09c70'],20,53,73,2950898,7,0,1,1,7301
d6744b9ee561b0b77b5c7fb3d0d066326ad7c375,0,Bryan Bende,2017-10-27 16:06:28-04:00,['e3482cc772c9e6324382aeb09a09f7a93898ece1'],4,40,44,2950942,1,0.75,1,1,7301
68715a0dd43133e821c87010bcf98532a6ba0853,1,Matthew Burgess,2017-10-27 18:15:27-04:00,['d6744b9ee561b0b77b5c7fb3d0d066326ad7c375'],9,18,27,2950969,2,0,1,1,7301
fb94e983b66772cd7a8e30ab08e82d2364b21176,0,Pierre Villard,2017-10-30 09:29:52+01:00,['68715a0dd43133e821c87010bcf98532a6ba0853'],3,10,13,2950982,1,,,,7301
d914ad2924c8b2811b8b89d37b8139d14a77b641,1,Pierre Villard,2017-10-30 09:50:44+01:00,['fb94e983b66772cd7a8e30ab08e82d2364b21176'],177,349,526,2951508,7,0.941176471,1,0,7303
a73b5bda4233fd28f3ddeca789ec6150a4e9878f,0,Pierre Villard,2017-10-30 11:22:03+01:00,['d914ad2924c8b2811b8b89d37b8139d14a77b641'],6,46,52,2951560,8,1,1,0.866666667,7303
448f03edae05679f0bc0ae6072d2f56e871e42c7,0,Koji Kawamura,2017-10-30 22:13:06+09:00,['a73b5bda4233fd28f3ddeca789ec6150a4e9878f'],19,34,53,2951613,2,0,1,1,7303
9a850c7ed221e99ab266e06810d068186b1d87d2,0,Matthew Burgess,2017-11-01 14:49:02-04:00,['448f03edae05679f0bc0ae6072d2f56e871e42c7'],0,6,6,2951619,1,,,,7303
64133379188eabbb672f695b2ab9c168f49c10b4,1,Pierre Villard,2017-11-02 09:16:56+01:00,['9a850c7ed221e99ab266e06810d068186b1d87d2'],8,30,38,2951657,2,0.833333333,0.833333333,1,7303
77a51e1a9ebee2162af48c5bdd5b79703e65b4e2,0,Pierre Villard,2017-11-02 10:10:03+01:00,['64133379188eabbb672f695b2ab9c168f49c10b4'],19,41,60,2951717,9,0,1,1,7303
116c8463428c1fb51bfb7a8adfcf23c32fded964,1,Pierre Villard,2017-11-02 18:24:40+01:00,['77a51e1a9ebee2162af48c5bdd5b79703e65b4e2'],12,35,47,2951764,6,1,1,1,7303
2a69b35f12586da16288e1a6d5e1dd3562490b92,0,Pierre Villard,2017-11-02 19:32:22+01:00,['116c8463428c1fb51bfb7a8adfcf23c32fded964'],20,119,139,2951903,7,0.418604651,0.88372093,0.441860465,7303
b5d7aecfac6b5f4424b3bc775c1477281f599846,0,Pierre Villard,2017-11-03 11:10:00+01:00,['2a69b35f12586da16288e1a6d5e1dd3562490b92'],1,7,8,2951911,1,,,,7303
5cd8a3e729cb9cbd64d97289d610c6e25fe87b9a,0,Pierre Villard,2017-11-03 17:03:27+01:00,['b5d7aecfac6b5f4424b3bc775c1477281f599846'],3,28,31,2951942,2,0,0.944444444,1,7303
296928c513031703675cc23cecb336f739ccac61,0,Pierre Villard,2017-11-06 13:56:16+01:00,['5cd8a3e729cb9cbd64d97289d610c6e25fe87b9a'],10,18,28,2951970,1,0,1,1,7303
f4a1c9b5472fcd6390643cd332051f894814fca8,0,Matthew Burgess,2017-11-06 11:27:05-05:00,['296928c513031703675cc23cecb336f739ccac61'],0,12,12,2951982,1,0,1,1,7303
d0502285f29495245c12e6b8383e60ddb8c832ad,0,Pierre Villard,2017-11-08 09:50:14+01:00,['f4a1c9b5472fcd6390643cd332051f894814fca8'],0,1,1,2951983,1,1,1,1,7303
37ef2839e00a31c33b13da98dcb7aebe9ea77923,1,Matthew Burgess,2017-11-09 12:53:28-05:00,['d0502285f29495245c12e6b8383e60ddb8c832ad'],28,442,470,2952453,9,0.397887324,0.482394366,0.978873239,7304
9ecb26a52b3caa5ae1a3962ccd5582752a619324,0,Pierre Villard,2017-11-09 20:25:13+01:00,['37ef2839e00a31c33b13da98dcb7aebe9ea77923'],3,29,32,2952485,5,,,,7304
f11e03886f51a570c05c7936e9472a7b9e643ba0,0,Pierre Villard,2017-11-09 21:04:50+01:00,['9ecb26a52b3caa5ae1a3962ccd5582752a619324'],1,1,2,2952487,1,,,,7304
387dce5ad09c3902983a1d4a74660d24d69d34d4,1,Scott Aslan,2017-11-09 16:41:45-05:00,['f11e03886f51a570c05c7936e9472a7b9e643ba0'],19,28,47,2952534,1,0,0,0,7304
fe3f288944eb02243ec446af17d23527f05a080d,1,Matthew Burgess,2017-11-13 11:44:22-05:00,['387dce5ad09c3902983a1d4a74660d24d69d34d4'],17,72,89,2952623,2,0,0,1,7304
c70a86eac00c149f8d9036db02525d9483bfd809,1,Matthew Burgess,2017-11-13 12:57:39-05:00,['fe3f288944eb02243ec446af17d23527f05a080d'],0,48,48,2952671,2,0.769230769,0.769230769,0.769230769,7305
2d3e5abf81d5fa70cd6efd60644755b51c785369,1,Matt Gilman,2017-11-13 13:54:34-05:00,['c70a86eac00c149f8d9036db02525d9483bfd809'],25,98,123,2952794,16,0.475,0.675,0.7,7305
c7a5a09b8aeb54931e9f59a1437d0ae7a8299cfd,1,Matthew Burgess,2017-11-13 14:32:58-05:00,['2d3e5abf81d5fa70cd6efd60644755b51c785369'],0,3876,3876,2956670,34,0.654183267,0.75059761,0.882071713,7336
af3a578711b7ed574ab37257822baa67fdbe8a26,1,Bryan Bende,2017-11-13 14:46:38-05:00,['c7a5a09b8aeb54931e9f59a1437d0ae7a8299cfd'],6,139,145,2956815,11,0.514285714,0.6,0.971428571,7336
9e9c129c21061f5c66ba4246774738de7184406b,0,Matthew Burgess,2017-11-13 21:48:30-05:00,['af3a578711b7ed574ab37257822baa67fdbe8a26'],2,21,23,2956838,2,0,0.333333333,1,7336
ad2d12a20cdfdd93e99be84a52918eaf39269063,0,Koji Kawamura,2017-11-14 13:59:30+09:00,['9e9c129c21061f5c66ba4246774738de7184406b'],2,35,37,2956875,1,0.066666667,0.066666667,0.4,7336
b9c53083c4f7c5218b6438af89baed19d62444fa,0,Matthew Burgess,2017-11-14 13:08:53-05:00,['ad2d12a20cdfdd93e99be84a52918eaf39269063'],5,5,10,2956885,2,,,,7336
7f8007f22a7be9e4c13505f9c41af541b5a676e8,1,Pierre Villard,2017-11-15 10:09:18+01:00,['b9c53083c4f7c5218b6438af89baed19d62444fa'],28,13,41,2956926,3,0,0,0,7336
53de8c93baba53e2929bde7d48fc0294dd3002a9,0,Pierre Villard,2017-11-15 10:12:39+01:00,['7f8007f22a7be9e4c13505f9c41af541b5a676e8'],3,13,16,2956942,5,0.75,0.75,1,7336
2da72f15243ef62d47369e8a87cc202a82dbe004,1,Bryan Bende,2017-11-16 15:44:37-05:00,['53de8c93baba53e2929bde7d48fc0294dd3002a9'],0,12,12,2956954,1,,,,7336
c89d79336435ee754c0f297a9fa78f059c321a59,1,Matt Gilman,2017-11-17 15:44:09-05:00,['2da72f15243ef62d47369e8a87cc202a82dbe004'],0,3,3,2956957,2,0,1,0.5,7336
5d643edfaba4f5369c94ee1b4eaa5c59e3a9f37a,1,Matt Gilman,2017-11-17 20:36:55-05:00,['c89d79336435ee754c0f297a9fa78f059c321a59'],183,1162,1345,2958302,17,0.844919786,1,0.764705882,7340
6b759217252821a059e5f87cd9cde33892349584,1,Mark Payne,2017-11-20 09:39:23-05:00,['5d643edfaba4f5369c94ee1b4eaa5c59e3a9f37a'],19,23,42,2958344,2,0,1,0,7340
439e13a8d510a6954b9a4d5cd8fa81f9d9ce95cc,1,Bryan Bende,2017-11-20 10:09:53-05:00,['6b759217252821a059e5f87cd9cde33892349584'],41,353,394,2958738,5,0.288288288,0.918918919,1,7340
ff5325b923b63ceb3ba964233e2cbe05bff3e920,0,Bryan Bende,2017-11-20 10:20:01-05:00,['439e13a8d510a6954b9a4d5cd8fa81f9d9ce95cc'],1,90,91,2958829,2,0,0.741935484,1,7340
8f2501ffac68885c2baee4b313ff016454e038a3,0,Pierre Villard,2017-11-21 11:14:19+01:00,['ff5325b923b63ceb3ba964233e2cbe05bff3e920'],11,120,131,2958960,2,0.169230769,1,0.969230769,7340
020f9d0596c779bad831c9e412545a3bb303f3ff,0,Pierre Villard,2017-11-21 11:29:42+01:00,['8f2501ffac68885c2baee4b313ff016454e038a3'],0,2,2,2958962,1,,,,7340
ce1b227e8559a842d13a8f7a97dff73ad8a7b68f,0,Marc Parisi,2017-11-21 09:42:22-05:00,['020f9d0596c779bad831c9e412545a3bb303f3ff'],0,58,58,2959020,1,,,,7340
e8b2387cb29ed35e5819ac8cf95af7cf020bbc7a,0,joewitt,2017-11-21 12:16:54-05:00,['ce1b227e8559a842d13a8f7a97dff73ad8a7b68f'],20,4,24,2959044,6,,,,7340
73702004b955598bde264b1cf55bfca2f8a50a50,0,joewitt,2017-11-21 12:40:13-05:00,['e8b2387cb29ed35e5819ac8cf95af7cf020bbc7a'],0,2,2,2959046,1,,,,7340
412b3fbbe2d43ad67e1e119586c507bd5258cccb,1,joewitt,2017-11-21 12:52:05-05:00,['73702004b955598bde264b1cf55bfca2f8a50a50'],10,29,39,2959085,3,0.125,0,0.875,7340
16a23f5a0fe841a609abaf11f19b4d580a88c401,0,Mike Moser,2017-11-21 20:13:35+00:00,['412b3fbbe2d43ad67e1e119586c507bd5258cccb'],40,305,345,2959430,9,0.291428571,0.771428571,0.68,7340
ce9787a414e70f0fbcdbd3534eb87824fb0da288,1,Bryan Bende,2017-11-27 09:52:46-05:00,['16a23f5a0fe841a609abaf11f19b4d580a88c401'],133,549,682,2960112,11,0.752747253,0.730769231,1,7345
9766558cab563a89e89e113082fc0bd2fabb1907,1,Matt Gilman,2017-11-27 10:50:32-05:00,['ce9787a414e70f0fbcdbd3534eb87824fb0da288'],13,69,82,2960194,4,0.27027027,0.459459459,0.810810811,7345
ecb9c5e92927d756d99b9eb5aa5f1b5a8cd95f8c,0,Matthew Burgess,2017-11-27 11:47:54-05:00,['9766558cab563a89e89e113082fc0bd2fabb1907'],1,1,2,2960196,1,,,,7345
6169061456bf8ff98e511ddb0966ed692d98b6e1,1,Aldrin Piri,2017-11-27 20:41:59-05:00,['ecb9c5e92927d756d99b9eb5aa5f1b5a8cd95f8c'],44,110,154,2960350,2,,,,7346
cec276414051e99d704064799675f0504bd35cc1,1,Andy LoPresto,2017-11-27 19:08:29-08:00,['6169061456bf8ff98e511ddb0966ed692d98b6e1'],0,14,14,2960364,2,0,1,1,7346
73fa0429f0dada32a1935a307dbb39308bd21f54,0,Aldrin Piri,2017-11-28 20:02:58-05:00,['cec276414051e99d704064799675f0504bd35cc1'],3,2,5,2960369,1,,,,7346
9ea9996b36b2f7ef393b7005bf56c7264b17b6e7,1,Matt Gilman,2017-11-29 13:33:17-05:00,['73fa0429f0dada32a1935a307dbb39308bd21f54'],27,49,76,2960445,2,,,,7346
3df3ff6c610760c3adb1dffdd75d8cbaed1b471b,0,joewitt,2017-11-30 09:02:21-05:00,['9ea9996b36b2f7ef393b7005bf56c7264b17b6e7'],12,14,26,2960471,1,0,0,1,7346
33281300cd90842da426d6824e942c43d4cf4916,1,joewitt,2017-11-30 10:02:32-05:00,['3df3ff6c610760c3adb1dffdd75d8cbaed1b471b'],33,96,129,2960600,3,0.897435897,0.897435897,1,7346
3b15ed855cc4319844dac13ba3244dc8ddde6207,0,Matthew Burgess,2017-11-30 10:12:00-05:00,['33281300cd90842da426d6824e942c43d4cf4916'],17,64,81,2960681,2,0,0.911764706,1,7346
45df23b1e09f340fb2c7f3c3234462570ddb5f6b,0,joewitt,2017-11-30 11:10:46-05:00,['3b15ed855cc4319844dac13ba3244dc8ddde6207'],279,160,439,2961120,5,0.177777778,0.133333333,0,7346
dd981e87ddadc907590a1d89ef3925f668cb00c1,1,Mark Payne,2017-11-30 14:59:58-05:00,['45df23b1e09f340fb2c7f3c3234462570ddb5f6b'],75,53,128,2961248,1,1,0,0,7346
103a345e859ef16088fd8a92ba40422d25213c56,1,James Wing,2017-11-30 21:53:05-08:00,['dd981e87ddadc907590a1d89ef3925f668cb00c1'],4,125,129,2961377,2,0.233766234,0.961038961,1,7346
9fdab10c7c989b395e31e7bbee138bc4fa82f369,1,Matt Gilman,2017-12-01 12:47:40-05:00,['103a345e859ef16088fd8a92ba40422d25213c56'],6,4,10,2961387,2,,,,7346
a458a139b31d8526690471aafdb582dcb1885217,1,joewitt,2017-12-02 12:58:29-05:00,['9fdab10c7c989b395e31e7bbee138bc4fa82f369'],1,2,3,2961390,2,,,,7346
596a329dc77aa9571fcdcc5ad4fba89db510b940,0,Mark Payne,2017-12-04 09:31:54-05:00,['a458a139b31d8526690471aafdb582dcb1885217'],1,1,2,2961392,1,,,,7346
2c68d0e09822b352be99aaf5227eb14f4c246251,1,Matt Gilman,2017-12-04 09:59:23-05:00,['596a329dc77aa9571fcdcc5ad4fba89db510b940'],150,72,222,2961614,11,1,0,0,7346
7b6aab7f9825ef10a72af5a7cfc7606fbf1966fd,1,Aldrin Piri,2017-12-04 12:01:55-05:00,['2c68d0e09822b352be99aaf5227eb14f4c246251'],0,226,226,2961840,4,,,,7349
00b11e82b73eccf739b533814189e64d101fbfa7,1,joewitt,2017-12-04 16:51:59-05:00,['7b6aab7f9825ef10a72af5a7cfc7606fbf1966fd'],0,7050,7050,2968890,43,0.354699316,0.734245589,0.777457688,7385
b3e05a7672996265af23edce5d73e0586de8a848,1,joewitt,2017-12-04 22:29:52-05:00,['00b11e82b73eccf739b533814189e64d101fbfa7'],1,1,2,2968892,1,,,,7385
0222bf8ef153427893539c9ebc8edfa98dfc7c12,1,joewitt,2017-12-04 22:34:10-05:00,['b3e05a7672996265af23edce5d73e0586de8a848'],5,1,6,2968898,1,,,,7385
9736cb9d338b611ff3a096d97fd439cf8b8bbac3,0,joewitt,2017-12-05 12:44:54-05:00,['0222bf8ef153427893539c9ebc8edfa98dfc7c12'],3,3,6,2968904,3,,,,7385
a0f568b69c96b6b0559100e6a48f237034b8e70b,0,Matt Gilman,2017-12-05 14:26:05-05:00,['9736cb9d338b611ff3a096d97fd439cf8b8bbac3'],8,10,18,2968922,2,,,,7385
c730f802b7a20e53ee381e11c5b1d4a5b487c912,0,Aldrin Piri,2017-12-06 10:48:21-05:00,['a0f568b69c96b6b0559100e6a48f237034b8e70b'],1,1,2,2968924,1,,,,7385
cdc1facf398e6d99cc746b70350ff754e2a975ad,0,Matt Gilman,2017-12-06 10:53:09-05:00,['c730f802b7a20e53ee381e11c5b1d4a5b487c912'],1111,1401,2512,2971436,17,1,1,1,7391
7e61c6333cc04359a98bfe80c3f72a39fee135da,1,Matt Gilman,2017-12-06 11:53:15-05:00,['cdc1facf398e6d99cc746b70350ff754e2a975ad'],47,468,515,2971951,14,1,0,0,7391
a774f1df69b1d7fd6c3fda2acf7e0adf883def25,1,joewitt,2017-12-06 16:13:42-05:00,['7e61c6333cc04359a98bfe80c3f72a39fee135da'],7,10,17,2971968,4,,,,7391
8e6649ba157f1389be4434f4f8e7fc81ae907ffc,1,joewitt,2017-12-07 15:45:18-05:00,['a774f1df69b1d7fd6c3fda2acf7e0adf883def25'],104,138,242,2972210,16,0.2,0,0,7391
c9cc76b5c849613b2d3d24f00ed8fa46204668b3,1,Mark Payne,2017-12-08 08:39:22-05:00,['8e6649ba157f1389be4434f4f8e7fc81ae907ffc'],6,102,108,2972318,4,0,0.916666667,0.916666667,7391
113ad5ecfa8990c97a56b8fc31656f3542735906,1,Mark Payne,2017-12-08 09:14:17-05:00,['c9cc76b5c849613b2d3d24f00ed8fa46204668b3'],3,49,52,2972370,2,0,0.913043478,0.913043478,7391
3b74d2ddad10de9105f38db3f555ec6f024afcd4,1,joewitt,2017-12-08 15:30:01-05:00,['113ad5ecfa8990c97a56b8fc31656f3542735906'],7,111,118,2972488,2,0.263888889,0.972222222,1,7391
1fc1d38fd8bec39d7358c7e04e024d563fc26492,0,joewitt,2017-12-08 15:35:36-05:00,['3b74d2ddad10de9105f38db3f555ec6f024afcd4'],187,212,399,2972887,1,0,0.4,1,7391
c138987bb46b975379daa00e57c42f498b6ef207,1,joewitt,2017-12-08 16:01:14-05:00,['1fc1d38fd8bec39d7358c7e04e024d563fc26492'],91,160,251,2973138,5,0.545454545,1,1,7391
3731fbee8883885a87f5f7548f46d9190aa3045d,1,joewitt,2017-12-11 08:41:25-05:00,['c138987bb46b975379daa00e57c42f498b6ef207'],0,723,723,2973861,3,0.400473934,0.481042654,0.684834123,7393
600586d6be1ee2b7f8fb9397623a2bc8d72df1b7,1,joewitt,2017-12-11 08:41:36-05:00,['3731fbee8883885a87f5f7548f46d9190aa3045d'],618,685,1303,2975164,4,0.970588235,0.941176471,0.970588235,7394
f772f2f093de38a97e6a71988628b5fd5aa4139c,1,joewitt,2017-12-11 11:46:15-05:00,['600586d6be1ee2b7f8fb9397623a2bc8d72df1b7'],8,18,26,2975190,5,0,0.875,1,7394
59d3c64195d59b659e7fa70026a8d8c35bf78c8b,0,Matthew Burgess,2017-12-11 12:49:42-05:00,['f772f2f093de38a97e6a71988628b5fd5aa4139c'],4,21,25,2975215,2,1,1,1,7394
63840377dda653146884a96b7955092f24f34dea,1,Matthew Burgess,2017-12-11 19:14:27-05:00,['59d3c64195d59b659e7fa70026a8d8c35bf78c8b'],0,302,302,2975517,3,0.234234234,0.441441441,1,7396
bfe92b9000f0d8203cbc1d95a897d96d2c65f092,1,Matthew Burgess,2017-12-11 19:16:34-05:00,['63840377dda653146884a96b7955092f24f34dea'],25,28,53,2975570,1,1,1,0,7396
d7347a2dc3f73e76d03b9b3ef95015dd539e16ac,1,Mark Payne,2017-12-13 16:04:23-05:00,['bfe92b9000f0d8203cbc1d95a897d96d2c65f092'],58,36,94,2975664,16,0,0,0.75,7396
2608351113f22490f724e5816a01c688bd8cbe92,0,Matt Gilman,2017-12-14 15:01:52-05:00,['d7347a2dc3f73e76d03b9b3ef95015dd539e16ac'],5,10,15,2975679,3,0,0,1,7396
b8375a681a360152c8fb7d80d238fa572d0f36eb,0,Mark Payne,2017-12-14 15:02:40-05:00,['2608351113f22490f724e5816a01c688bd8cbe92'],3,4,7,2975686,1,,,0,7396
57947d64cd3ac4602d9376595cbc39c2578bb9fb,0,Mark Payne,2017-12-14 15:05:40-05:00,['b8375a681a360152c8fb7d80d238fa572d0f36eb'],13,11,24,2975710,2,0,0,0,7396
48ae4be0159a8a351eba71264ff78f87719dd8c2,0,Mark Payne,2017-12-14 15:08:55-05:00,['57947d64cd3ac4602d9376595cbc39c2578bb9fb'],90,140,230,2975940,2,0.382352941,1,1,7396
d543cfde2552b6ac5f66d3c723afe60142f3d625,0,Mark Payne,2017-12-14 15:15:13-05:00,['48ae4be0159a8a351eba71264ff78f87719dd8c2'],36,20,56,2975996,8,1,0.25,0.25,7396
2192138b06eade6ceb6b2475580f005f4b75ee69,1,joewitt,2017-12-14 16:23:41-05:00,['d543cfde2552b6ac5f66d3c723afe60142f3d625'],1,2318,2319,2978315,24,0.392296719,0.641940086,0.750356633,7417
a12abc24e5ee49472d8fb9633f3b426d623bc4f0,0,joewitt,2017-12-14 16:23:41-05:00,['2192138b06eade6ceb6b2475580f005f4b75ee69'],68,180,248,2978563,6,0.571428571,0.085714286,0.485714286,7417
68016ddbe80dcc10848b35b3342566add4ebf43f,0,joewitt,2017-12-14 17:08:13-05:00,['a12abc24e5ee49472d8fb9633f3b426d623bc4f0'],172,86,258,2978821,8,,,,7417
5b2e2afc1746ec5d8d395cdebce2db3a25027a0e,0,joewitt,2017-12-14 17:09:12-05:00,['68016ddbe80dcc10848b35b3342566add4ebf43f'],43,28,71,2978892,2,,,,7417
15eeb22116ae54241acbb7a25856f4469eab15c9,1,Matthew Burgess,2017-12-14 20:18:20-05:00,['5b2e2afc1746ec5d8d395cdebce2db3a25027a0e'],42,368,410,2979302,5,0.551724138,0.689655172,1,7420
463dcd88129a4b99a08072ece787b2146b5fb790,1,joewitt,2017-12-15 10:35:13-05:00,['15eeb22116ae54241acbb7a25856f4469eab15c9'],1,25,26,2979328,2,0.823529412,0.823529412,1,7420
9217e2fc6386e3d9ce665a183b6c0127ead67baf,1,James Wing,2017-12-17 12:51:34-08:00,['463dcd88129a4b99a08072ece787b2146b5fb790'],12,39,51,2979379,2,1,1,1,7420
f50a07ec888094cb610e5e12f6b52599143c42ea,1,joewitt,2017-12-18 09:11:53-05:00,['9217e2fc6386e3d9ce665a183b6c0127ead67baf'],33,128,161,2979540,3,0.8125,1,0.8125,7421
406db4867a60d830218de70e00ad7b9f9686b54a,0,Matthew Burgess,2017-12-18 09:41:05-05:00,['f50a07ec888094cb610e5e12f6b52599143c42ea'],1,10,11,2979551,1,0,0,1,7421
44a3ac9eff6d0e4bda193d9169989915dd716d51,1,joewitt,2017-12-18 10:13:34-05:00,['406db4867a60d830218de70e00ad7b9f9686b54a'],1,1,2,2979553,1,,,,7421
fc73c609240de81d7379bda7c281f064ebe02714,1,Mark Payne,2017-12-18 12:23:58-05:00,['44a3ac9eff6d0e4bda193d9169989915dd716d51'],0,20345,20345,2999898,103,0.422901757,0.805248319,0.857297766,7521
9750cf2fcda0209e897e98e632f7e42f3f17e3d9,0,Mark Payne,2017-12-18 12:24:09-05:00,['fc73c609240de81d7379bda7c281f064ebe02714'],9,48,57,2999955,2,,,,7521
17718940d7e5aaa2ec8682c6aedd03736ec4a0b6,0,Pierre Villard,2017-12-19 09:44:25+01:00,['9750cf2fcda0209e897e98e632f7e42f3f17e3d9'],0,2,2,2999957,1,,,,7521
612675e4283a22481ee76a0ad81a092f500150a9,0,Pierre Villard,2017-12-19 10:32:52+01:00,['17718940d7e5aaa2ec8682c6aedd03736ec4a0b6'],27,73,100,3000057,2,0,0.96,1,7521
f04ddcf44294db64738cb7505c488b83d52c9135,0,Pierre Villard,2017-12-19 15:49:14+01:00,['612675e4283a22481ee76a0ad81a092f500150a9'],2,34,36,3000093,2,0,1,1,7521
17ddaf6be0d4c75aa8b0d86f84f1f90757f8368f,1,Matt Gilman,2017-12-19 10:30:45-05:00,['f04ddcf44294db64738cb7505c488b83d52c9135'],230,236,466,3000559,12,0,0,1,7522
1ee8d16a211c247d1d3d7f1189be36a866d0ee98,1,Matt Gilman,2017-12-19 10:34:54-05:00,['17ddaf6be0d4c75aa8b0d86f84f1f90757f8368f'],53,54,107,3000666,9,,,,7522
febb119faca57e8c9deaa9530434e93e2286d7de,0,Pierre Villard,2017-12-20 12:11:38+01:00,['1ee8d16a211c247d1d3d7f1189be36a866d0ee98'],80,144,224,3000890,1,0.060606061,0,1,7522
e8f6ff440a6b7114f9374c227ef2fa896e707f26,1,Pierre Villard,2017-12-21 14:38:36+01:00,['febb119faca57e8c9deaa9530434e93e2286d7de'],4,4,8,3000898,2,,,,7522
62e388aa4fd0216abe7626902612196e7c9e41c8,0,Pierre Villard,2017-12-21 15:15:09+01:00,['e8f6ff440a6b7114f9374c227ef2fa896e707f26'],1,29,30,3000928,2,0.666666667,0.666666667,1,7522
14d2291db87d8ea160f538c10de31ac69fc996ae,1,Mark Payne,2017-12-22 08:56:29-05:00,['62e388aa4fd0216abe7626902612196e7c9e41c8'],1,804,805,3001733,6,0.245823389,0.6849642,0.787589499,7526
49285d325f9ec8fe687b513ee4d2146d99ef6579,0,Pierre Villard,2017-12-23 18:15:49+01:00,['14d2291db87d8ea160f538c10de31ac69fc996ae'],1,1,2,3001735,1,,,,7526
353fcdda9cd9e4bc42e63a7ddad993ba75bab9b1,0,joewitt,2017-12-26 17:46:35-05:00,['49285d325f9ec8fe687b513ee4d2146d99ef6579'],18,126,144,3001879,3,0.179775281,1,1,7526
2fbe922a2b0388f7541b2704ab621a9c7f9ba37d,1,joewitt,2017-12-26 18:02:02-05:00,['353fcdda9cd9e4bc42e63a7ddad993ba75bab9b1'],6,63,69,3001948,2,0.142857143,1,0.892857143,7526
c59a967623da5c1dede58e4b8ff21ddadab913fe,1,Koji Kawamura,2017-12-29 00:23:09+09:00,['2fbe922a2b0388f7541b2704ab621a9c7f9ba37d'],8,246,254,3002202,13,0.251572327,0.358490566,0.471698113,7526
c91d99884a3263d88908c97a1a48ca6178ea7379,1,Matthew Burgess,2017-12-29 10:43:21-05:00,['c59a967623da5c1dede58e4b8ff21ddadab913fe'],96,236,332,3002534,15,0.098039216,0.480392157,0.637254902,7526
482f371958a96b33791c3f6cc4c26efd47c43169,1,Andy LoPresto,2017-12-31 17:41:04-05:00,['c91d99884a3263d88908c97a1a48ca6178ea7379'],166,4386,4552,3007086,17,1,1,1,7537
b7c9c88f9f786f9a84b0c1dc34026194010755e2,0,Andy LoPresto,2018-01-02 10:01:03-05:00,['482f371958a96b33791c3f6cc4c26efd47c43169'],0,2,2,3007088,1,,,,7537
1f793923a4f7663cdab6c259b49e6b4167553109,1,Matthew Burgess,2018-01-02 14:46:36-05:00,['b7c9c88f9f786f9a84b0c1dc34026194010755e2'],53,143,196,3007284,4,0.450980392,0.509803922,0.68627451,7538
d65e6b25630fa918ede2cd6922dc777e816679c3,1,Matthew Burgess,2018-01-02 14:46:42-05:00,['1f793923a4f7663cdab6c259b49e6b4167553109'],34,66,100,3007384,4,0.6,0.6,1,7538
97dc20e2d95057b890b3fecbe6f6e8877923e6b3,1,Matthew Burgess,2018-01-02 14:46:48-05:00,['d65e6b25630fa918ede2cd6922dc777e816679c3'],46,91,137,3007521,4,0,0.2,1,7539
84cecfbeea82e81faef77c5b9de76f54bd965316,0,Matthew Burgess,2018-01-02 14:49:00-05:00,['97dc20e2d95057b890b3fecbe6f6e8877923e6b3'],30,180,210,3007731,3,0.083333333,1,0.111111111,7539
9f919b9b650bbec647d1d5acbc1a63b721ce84e3,1,Koji Kawamura,2018-01-03 10:10:42+09:00,['84cecfbeea82e81faef77c5b9de76f54bd965316'],322,431,753,3008484,7,1,0,0,7540
19595863894a762b42fe7d6226835aacf207dcb6,0,joewitt,2018-01-02 22:01:40-05:00,['9f919b9b650bbec647d1d5acbc1a63b721ce84e3'],3,2,5,3008489,2,,,,7540
ff7283d65df551e647025e3f8277949ce9e5dfd8,1,Mark Payne,2018-01-03 11:01:33-05:00,['19595863894a762b42fe7d6226835aacf207dcb6'],0,416,416,3008905,5,0.672131148,0.956284153,0.836065574,7542
7467bb7b0f4ed4546926ac379385268eab41948e,1,Bryan Bende,2018-01-03 11:21:52-05:00,['ff7283d65df551e647025e3f8277949ce9e5dfd8'],21,450,471,3009376,14,,,,7546
42a1ee011b683da06011a946cbacaf0e8d3b2c81,1,joewitt,2018-01-03 11:31:47-05:00,['7467bb7b0f4ed4546926ac379385268eab41948e'],154,124,278,3009654,13,0.483333333,0,0.1,7546
6ee6b5e57c5ad932c43f08be1f45acb37f2ffe45,1,Mark Payne,2018-01-04 09:16:17-05:00,['42a1ee011b683da06011a946cbacaf0e8d3b2c81'],829,406,1235,3010889,32,0.447852761,0,0.006134969,7550
a2a8fcb31c3f845e05502fb5c0bad44ba82a97ed,0,joewitt,2018-01-04 09:38:35-05:00,['6ee6b5e57c5ad932c43f08be1f45acb37f2ffe45'],36,24,60,3010949,4,0,0,0,7550
e439cfef1010af9ad8b8360fe66626aefee9ef02,0,joewitt,2018-01-04 10:20:47-05:00,['a2a8fcb31c3f845e05502fb5c0bad44ba82a97ed'],0,66,66,3011015,5,,,,7550
c832a2ed7c74a648c84853f3682505a271afdf6f,1,joewitt,2018-01-04 10:37:37-05:00,['e439cfef1010af9ad8b8360fe66626aefee9ef02'],37,239,276,3011291,7,,,,7554
f7f001eb9ac604421cdcecc208563e60a9e9d627,1,joewitt,2018-01-04 12:09:46-05:00,['c832a2ed7c74a648c84853f3682505a271afdf6f'],27,122,149,3011440,6,,,,7555
7a8dbb8b1512d7bd7a26e1b996a7ef859ccfcd4e,0,Matt Gilman,2018-01-04 13:03:11-05:00,['f7f001eb9ac604421cdcecc208563e60a9e9d627'],25,62,87,3011527,1,0.826086957,0.782608696,0.52173913,7555
98af3dc4cd56da324bb4572aab2dc395338ed45d,1,joewitt,2018-01-04 14:14:17-05:00,['7a8dbb8b1512d7bd7a26e1b996a7ef859ccfcd4e'],6,1091,1097,3012624,6,0.277777778,0.777777778,0.73015873,7557
99d767aa44e4d5b1bc9fbca9a1e0ee6803972fea,1,Mark Payne,2018-01-04 14:30:14-05:00,['98af3dc4cd56da324bb4572aab2dc395338ed45d'],16,561,577,3013201,14,0.038251366,1,1,7562
ce4374ee0017708252e955ac94d34b61c481a1ce,0,Matt Gilman,2018-01-04 15:20:35-05:00,['99d767aa44e4d5b1bc9fbca9a1e0ee6803972fea'],1,36,37,3013238,2,0,1,1,7562
41d9506a2beea9506d6ee09e3ee9a154c13378e3,1,Matt Gilman,2018-01-05 09:09:37-05:00,['ce4374ee0017708252e955ac94d34b61c481a1ce'],6,37,43,3013281,1,1,1,1,7562
3b10a8479e954b5cfc0313c1646b424dd9375378,0,Mark Payne,2018-01-05 09:59:01-05:00,['41d9506a2beea9506d6ee09e3ee9a154c13378e3'],0,2,2,3013283,1,0,1,1,7562
e5ed62a98fe0c15fcba865edfe00eac673a6ac51,1,Mark Payne,2018-01-05 10:42:58-05:00,['3b10a8479e954b5cfc0313c1646b424dd9375378'],12,299,311,3013594,12,0.014851485,0.787128713,0.787128713,7562
4b8c80cccc3207dc9fe6895266af95cca7c72250,1,Matt Gilman,2018-01-05 11:17:33-05:00,['e5ed62a98fe0c15fcba865edfe00eac673a6ac51'],58,44,102,3013696,6,0,0,1,7562
81d3f6f3269efacfadbeabd6ec84fad990535299,1,Matt Gilman,2018-01-05 14:22:35-05:00,['4b8c80cccc3207dc9fe6895266af95cca7c72250'],218,521,739,3014435,11,0.383233533,0.586826347,1,7564
e43f07e31db34fbdaebc2a57ab3548cfaf4322da,0,Matt Gilman,2018-01-05 16:00:13-05:00,['81d3f6f3269efacfadbeabd6ec84fad990535299'],0,3,3,3014438,1,0,0,0,7564
89fb1b37d92acb3c480bddcf16a8da239bbe5ead,0,Jeff Storck,2018-01-05 16:41:33-05:00,['e43f07e31db34fbdaebc2a57ab3548cfaf4322da'],2,2,4,3014442,1,,,,7564
d9866c75e2475986ed799c9fb75c622fc38f5a4f,1,Matthew Burgess,2018-01-05 18:14:30-05:00,['89fb1b37d92acb3c480bddcf16a8da239bbe5ead'],0,288,288,3014730,4,0.416666667,1,1,7566
8d4fe38bb44e34197e64d7a7e7e9b3787144e34d,0,James Wing,2018-01-06 17:33:31-08:00,['d9866c75e2475986ed799c9fb75c622fc38f5a4f'],5,53,58,3014788,2,0,1,1,7566
6a58d780d7041eb2b29d4da7a4c60c525d63f66d,1,Bryan Bende,2018-01-08 12:44:52-05:00,['8d4fe38bb44e34197e64d7a7e7e9b3787144e34d'],222,8319,8541,3023329,106,0.351408951,0.602652143,0.672981293,7607
7a0a900a0ff8b9329296b9a19b9239b63fc2d76d,1,Bryan Bende,2018-01-08 12:44:52-05:00,['6a58d780d7041eb2b29d4da7a4c60c525d63f66d'],246,2465,2711,3026040,55,0.505144995,0.876520112,0.886810103,7616
6aa8b5c61c734ce56aad7816b40df88d8316feeb,1,Bryan Bende,2018-01-08 12:44:52-05:00,['7a0a900a0ff8b9329296b9a19b9239b63fc2d76d'],361,1173,1534,3027574,29,0.449074074,0.625,0.699074074,7620
696d583b148b60d41853add8d3e2d24b4ff907f3,1,Bryan Bende,2018-01-08 12:44:52-05:00,['6aa8b5c61c734ce56aad7816b40df88d8316feeb'],404,1698,2102,3029676,36,0.74743025,0.983847283,0.900146843,7625
6b00dff1a88a00d87dc77480853cc7c5637ab774,1,Bryan Bende,2018-01-08 12:44:53-05:00,['696d583b148b60d41853add8d3e2d24b4ff907f3'],383,1470,1853,3031529,34,0.597662771,0.602671119,0.629382304,7627
d6e54f19ee249da45fe8d625cf68ce3d3e61380a,0,Bryan Bende,2018-01-08 12:44:53-05:00,['6b00dff1a88a00d87dc77480853cc7c5637ab774'],176,653,829,3032358,15,0.106463878,1,1,7627
f6cc5b6cdca86b3f535754f7ec4d91ca61f2e35b,1,Bryan Bende,2018-01-08 12:44:53-05:00,['d6e54f19ee249da45fe8d625cf68ce3d3e61380a'],798,424,1222,3033580,12,0.920577617,0.805054152,0.108303249,7627
3d8b1e4890d5802677e978a6a7588a97bf4177f2,1,Bryan Bende,2018-01-08 12:44:53-05:00,['f6cc5b6cdca86b3f535754f7ec4d91ca61f2e35b'],321,1008,1329,3034909,13,0.424757282,0.757281553,0.873786408,7630
adacb204a8b6518a79600253463a36c9f8afaa37,1,Bryan Bende,2018-01-08 12:44:53-05:00,['3d8b1e4890d5802677e978a6a7588a97bf4177f2'],258,490,748,3035657,18,0.146551724,0.344827586,0,7630
c92022dd60e599ef6ed176d31489ba265acedd48,0,Bryan Bende,2018-01-08 12:44:54-05:00,['adacb204a8b6518a79600253463a36c9f8afaa37'],110,31,141,3035798,7,0.042253521,0.169014085,0,7630
e1606701c78984f794f96814d8f84a3f686099cf,1,Bryan Bende,2018-01-08 12:44:54-05:00,['c92022dd60e599ef6ed176d31489ba265acedd48'],115,143,258,3036056,12,0.333333333,0,0,7631
d34fb5e2ef967b0704621ffa0115283c3ccdc070,1,Bryan Bende,2018-01-08 12:44:54-05:00,['e1606701c78984f794f96814d8f84a3f686099cf'],215,687,902,3036958,20,1,1,0.865671642,7632
fdef5b560544a8da33068b4acb6d4404fe193ed9,1,Bryan Bende,2018-01-08 12:44:54-05:00,['d34fb5e2ef967b0704621ffa0115283c3ccdc070'],592,751,1343,3038301,30,0,0,0,7635
49aad2c3a8a56602712ff3ede78a29221b492f3d,1,Bryan Bende,2018-01-08 12:44:54-05:00,['fdef5b560544a8da33068b4acb6d4404fe193ed9'],167,293,460,3038761,11,0.120481928,0.337349398,0.939759036,7636
014c542f48b61c027152129ae7cd8c8535dd6a64,1,Bryan Bende,2018-01-08 12:44:55-05:00,['49aad2c3a8a56602712ff3ede78a29221b492f3d'],57,156,213,3038974,12,0.776119403,0.447761194,1,7636
db2cc9fec1ca3ad4382f8dee25ce9790ad53c1f7,1,Bryan Bende,2018-01-08 12:44:55-05:00,['014c542f48b61c027152129ae7cd8c8535dd6a64'],203,502,705,3039679,25,0.433333333,1,0.873333333,7638
fe8b30bf2608e6b321c54ad812e7a85e13acaa5f,1,Bryan Bende,2018-01-08 12:44:55-05:00,['db2cc9fec1ca3ad4382f8dee25ce9790ad53c1f7'],309,384,693,3040372,19,0,0.409836066,0.967213115,7639
1266235c00345f222b34480be00ba0db951e2077,1,Bryan Bende,2018-01-08 12:44:55-05:00,['fe8b30bf2608e6b321c54ad812e7a85e13acaa5f'],252,456,708,3041080,18,0.471544715,0.276422764,0.886178862,7639
181d6809c126da862417e79fb5d794ed5f8eefac,1,Bryan Bende,2018-01-08 12:44:55-05:00,['1266235c00345f222b34480be00ba0db951e2077'],78,246,324,3041404,16,0.187969925,0.458646617,0.541353383,7639
f48808b1f4b817203aa5fec92b2a90bfeefb59e9,1,Bryan Bende,2018-01-08 12:44:56-05:00,['181d6809c126da862417e79fb5d794ed5f8eefac'],70,152,222,3041626,15,0.218181818,0.290909091,0.345454545,7639
416b86145f58210baf548d422865068faf7acf39,1,Bryan Bende,2018-01-08 12:44:56-05:00,['f48808b1f4b817203aa5fec92b2a90bfeefb59e9'],11,11,22,3041648,1,1,1,1,7639
c5b0931e558f7043b29ae1d2edc38dbd5607d289,1,Bryan Bende,2018-01-08 12:44:56-05:00,['416b86145f58210baf548d422865068faf7acf39'],21,18,39,3041687,9,0.857142857,0.857142857,1,7639
0127b02617530491a1a55aa72395cee583083956,1,Bryan Bende,2018-01-08 12:44:56-05:00,['c5b0931e558f7043b29ae1d2edc38dbd5607d289'],7,11,18,3041705,1,0,1,1,7639
20b539aac3ea4d42d38df2278821c4f0021c0a2f,1,Bryan Bende,2018-01-08 12:44:56-05:00,['0127b02617530491a1a55aa72395cee583083956'],4,11,15,3041720,3,0,1,1,7639
118667a60182b5a73ac8cdd3c843f8827d9b4389,0,Bryan Bende,2018-01-08 12:44:56-05:00,['20b539aac3ea4d42d38df2278821c4f0021c0a2f'],2,33,35,3041755,2,0.6,0.6,0.6,7639
fd18eeb84e976c7ac77a92ee5e36764697e63abb,1,Bryan Bende,2018-01-08 12:44:57-05:00,['118667a60182b5a73ac8cdd3c843f8827d9b4389'],57,37,94,3041849,9,0,0,0,7639
63544c880ff173213f24db7bcf57fcf97a925556,0,Bryan Bende,2018-01-08 12:44:57-05:00,['fd18eeb84e976c7ac77a92ee5e36764697e63abb'],1,1,2,3041851,1,,,,7639
b3e1584ef4f5b7de8cf8517a8b950125f82832cb,1,Bryan Bende,2018-01-08 12:44:57-05:00,['63544c880ff173213f24db7bcf57fcf97a925556'],47,134,181,3042032,2,0.64,0.88,0.84,7639
f702f808a70929980f862ef62c2359b73f5e6b6b,0,Bryan Bende,2018-01-08 12:44:57-05:00,['b3e1584ef4f5b7de8cf8517a8b950125f82832cb'],3,23,26,3042058,3,0,1,1,7639
fa996cd418601b0f1abeb5a926ac6146a96b0c07,0,Bryan Bende,2018-01-08 12:44:57-05:00,['f702f808a70929980f862ef62c2359b73f5e6b6b'],25,11,36,3042094,4,1,0,0,7639
b6117743d4c1c1a37a16ba746b9edbbdd276d69f,1,Bryan Bende,2018-01-08 13:10:13-05:00,['fa996cd418601b0f1abeb5a926ac6146a96b0c07'],98,520,618,3042712,16,0.354609929,0.322695035,0.75177305,7640
a8817e023805499491f9fc62495208d198de84f0,0,Andy LoPresto,2018-01-08 11:17:21-08:00,['b6117743d4c1c1a37a16ba746b9edbbdd276d69f'],26,5044,5070,3047782,45,,,,7678
33b40fb87fc64263bf91eae8022cdf97bb1840a6,1,Jeff Storck,2018-01-08 15:02:12-05:00,['a8817e023805499491f9fc62495208d198de84f0'],1,1,2,3047784,1,,,,7678
acdaeebac7f95862197deee84661e7438f687c24,0,Matt Gilman,2018-01-08 15:07:27-05:00,['33b40fb87fc64263bf91eae8022cdf97bb1840a6'],83,245,328,3048112,53,,,,7714
8f635f1c0ddd1a4d05ecbfa69804003cabe1d3a3,0,Bryan Bende,2018-01-08 15:13:31-05:00,['acdaeebac7f95862197deee84661e7438f687c24'],6,4,10,3048122,1,,,,7714
4196140e4c36a56957ea3c3bd3b5423f0731eda6,0,Matt Gilman,2018-01-08 16:40:40-05:00,['8f635f1c0ddd1a4d05ecbfa69804003cabe1d3a3'],2,49,51,3048173,3,0.261904762,0.261904762,1,7714
a7f1eb89c23e90f813be12adc4dca99de36c7c15,1,Andy LoPresto,2018-01-08 14:26:14-08:00,['4196140e4c36a56957ea3c3bd3b5423f0731eda6'],0,695,695,3048868,5,0.278688525,0.319672131,1,7717
953e922d324d37c3771f46a2f371026814d92282,1,joewitt,2018-01-08 19:47:18-07:00,['a7f1eb89c23e90f813be12adc4dca99de36c7c15'],9,41,50,3048918,2,0,0,0.5,7717
08c391067980d745fb823cb7c5a1d02eb1423304,0,joewitt,2018-01-08 20:34:53-07:00,['953e922d324d37c3771f46a2f371026814d92282'],1,1,2,3048920,1,,,,7717
3157b00a7a4c2e85cf109f833e9603919812717f,0,joewitt,2018-01-08 21:30:11-07:00,['08c391067980d745fb823cb7c5a1d02eb1423304'],38,456,494,3049414,4,,,,7717
182e2c6e94a4b1f225ff1902f048e9cb5c3c400c,0,joewitt,2018-01-08 21:31:57-07:00,['3157b00a7a4c2e85cf109f833e9603919812717f'],1,5,6,3049420,2,,,,7717
6e7544bd3786fa829fedf1e284488e6756664f2c,1,joewitt,2018-01-08 21:47:27-07:00,['182e2c6e94a4b1f225ff1902f048e9cb5c3c400c'],3,4,7,3049427,1,,,,7717
10e3b14433fecc91a6f51ab0459adbc8f93f18ad,0,joewitt,2018-01-08 22:07:14-07:00,['6e7544bd3786fa829fedf1e284488e6756664f2c'],27,67,94,3049521,8,0,1,1,7717
46d30c7e92f0ad034d9b35bf1d05c350ab5547ed,1,joewitt,2018-01-08 23:39:32-07:00,['10e3b14433fecc91a6f51ab0459adbc8f93f18ad'],787,764,1551,3051072,365,,,,7717
36405e888cb367a6449e6db936cc07f837334dd5,1,joewitt,2018-01-08 23:39:49-07:00,['46d30c7e92f0ad034d9b35bf1d05c350ab5547ed'],745,745,1490,3052562,365,,,,7717
6153fb64655701f7bfdaadfe1ff7c8def111422c,0,Koji Kawamura,2018-01-10 17:42:04+09:00,['10e3b14433fecc91a6f51ab0459adbc8f93f18ad'],8,35,43,3052605,3,0,0,0.045454545,7717
674c9e468785fd0c0f7b4cc68fa35f9707e36a71,0,Mark Payne,2018-01-11 10:34:46-05:00,['6153fb64655701f7bfdaadfe1ff7c8def111422c'],9,10,19,3052624,2,0,,,7717
bcac2766bce63508b7930344b9dc21ceef33bf98,0,Mark Payne,2018-01-11 11:23:04-05:00,['674c9e468785fd0c0f7b4cc68fa35f9707e36a71'],10,14,24,3052648,1,0,0,1,7717
39a484b631d4a53820c60c1c5c388fd33fcf8ddd,0,Matt Gilman,2018-01-11 12:25:33-05:00,['bcac2766bce63508b7930344b9dc21ceef33bf98'],29,69,98,3052746,3,0,1,1,7717
5f7bd81af97523b6b25f206cd0810c148d8dcd4a,1,Mark Payne,2018-01-11 15:04:42-05:00,['39a484b631d4a53820c60c1c5c388fd33fcf8ddd'],0,64,64,3052810,5,0.5,0.5,1,7719
a36afe0bbe0051b528810d0670757d3401c80215,0,Pierre Villard,2018-01-11 23:24:12+01:00,['5f7bd81af97523b6b25f206cd0810c148d8dcd4a'],34,75,109,3052919,6,0,1,1,7719
42edfa75b72b15aa3e0ce6d2aef7af39718409ce,0,joewitt,2018-01-12 15:00:32-05:00,"['a36afe0bbe0051b528810d0670757d3401c80215', '36405e888cb367a6449e6db936cc07f837334dd5']",786,763,1549,3054468,365,,,,7719
41ce788812d4119cbbddad019d22e7239e7c3f5f,1,joewitt,2018-01-12 15:15:32-05:00,['42edfa75b72b15aa3e0ce6d2aef7af39718409ce'],744,744,1488,3055956,365,,,,7719
5e3867011e106b8dab4097ff5dac1d462f687a81,0,joewitt,2018-01-12 15:19:15-05:00,['41ce788812d4119cbbddad019d22e7239e7c3f5f'],2,2,4,3055960,2,,,,7719
83d29300953fa86e89cb30c59dcb86ed660557cc,0,Koji Kawamura,2018-01-13 09:47:21+09:00,['5e3867011e106b8dab4097ff5dac1d462f687a81'],14,188,202,3056162,3,0.618181818,0.381818182,1,7719
83701632fb7216fba40d2e5cc3cd87bd8116c385,0,Koji Kawamura,2018-01-13 09:57:25+09:00,['83d29300953fa86e89cb30c59dcb86ed660557cc'],9,30,39,3056201,4,0,1,0,7719
d93d53817761772e623d4dd2411fc5474797ec42,1,Bryan Bende,2018-01-16 12:48:17-05:00,['83701632fb7216fba40d2e5cc3cd87bd8116c385'],1,20,21,3056222,3,0,0.416666667,0.416666667,7719
7fa0a34aba23ea390720a8f41aefbe59f26b15c9,1,joewitt,2018-01-16 13:07:56-05:00,['d93d53817761772e623d4dd2411fc5474797ec42'],0,1163,1163,3057385,15,0.250996016,0.533864542,1,7732
ecb8067883817c97dc4a54951171c37e36af2f03,1,joewitt,2018-01-16 13:08:02-05:00,['7fa0a34aba23ea390720a8f41aefbe59f26b15c9'],474,2761,3235,3060620,26,0.285714286,0.546938776,0.916326531,7740
7e29103995e4b4838616c29770b91b762adac375,1,joewitt,2018-01-16 13:27:29-05:00,['ecb8067883817c97dc4a54951171c37e36af2f03'],60,61,121,3060741,7,,,,7740
28e1bcc9d034261c8045c6b2c76ff21839f7eb95,1,Bryan Bende,2018-01-16 14:14:25-05:00,['7e29103995e4b4838616c29770b91b762adac375'],7,19,26,3060767,3,0.666666667,0.833333333,1,7740
7c1ce172232d5fd8ab2a1c1649a9dcbf1a9d08d7,1,Bryan Bende,2018-01-16 16:31:34-05:00,['28e1bcc9d034261c8045c6b2c76ff21839f7eb95'],611,74,685,3061452,15,0,0,0,7740
790f14b8ef77740fc79839f51a3521db39afde09,1,Matt Gilman,2018-01-17 10:55:11-05:00,['7c1ce172232d5fd8ab2a1c1649a9dcbf1a9d08d7'],5,11,16,3061468,1,0,0,1,7740
e4dda497bb8c8bb44ebc562f3562f65801dfc338,1,Matt Gilman,2018-01-17 10:59:09-05:00,['790f14b8ef77740fc79839f51a3521db39afde09'],2,3,5,3061473,2,,,,7740
ea2519e3ea5edba8b91b37e9d815bc711b3a997c,0,Pierre Villard,2018-01-17 21:42:19+01:00,['e4dda497bb8c8bb44ebc562f3562f65801dfc338'],2,167,169,3061642,5,0.982758621,1,1,7742
ca54186b608682d028719ae836bd8d8f83fd24d7,0,Pierre Villard,2018-01-17 21:48:31+01:00,['ea2519e3ea5edba8b91b37e9d815bc711b3a997c'],11,62,73,3061715,2,0,1,1,7742
94eb11bfa6428b46c7807b0607b94957d4230d89,0,Pierre Villard,2018-01-18 16:16:00+01:00,['ca54186b608682d028719ae836bd8d8f83fd24d7'],0,14,14,3061729,2,0.9,0.9,1,7742
8cb09c301d6fef70cc8a02a4a7e80f3062ab58ae,1,Matt Gilman,2018-01-19 10:53:13-05:00,['94eb11bfa6428b46c7807b0607b94957d4230d89'],146,744,890,3062619,8,0.445652174,0.532608696,1,7743
4b3b2ebf2486c1e8b4e91005a0b2a685a1cebd00,0,Matt Gilman,2018-01-19 11:03:55-05:00,['8cb09c301d6fef70cc8a02a4a7e80f3062ab58ae'],0,16,16,3062635,1,,,,7743
a3ddb3b4fae69c4d841caa8c5d6d342ef94a9884,0,Bryan Bende,2018-01-19 11:26:05-05:00,['4b3b2ebf2486c1e8b4e91005a0b2a685a1cebd00'],4,1,5,3062640,1,1,1,0,7743
e3c661daac69cdb2de43c3d66d9ed1ccc9c8dbc6,0,Andy LoPresto,2018-01-19 09:47:31-08:00,['a3ddb3b4fae69c4d841caa8c5d6d342ef94a9884'],5,10,15,3062655,1,0,1,1,7743
94d0974003071986c63106f8310fc0c7c677d21f,0,Matt Gilman,2018-01-19 12:58:36-05:00,['e3c661daac69cdb2de43c3d66d9ed1ccc9c8dbc6'],1,1,2,3062657,1,,,,7743
59970344fe992c8a2bc3d173cf3683d8130bfdc6,0,Pierre Villard,2018-01-20 15:15:48+01:00,['94d0974003071986c63106f8310fc0c7c677d21f'],76,81,157,3062814,7,,,,7743
5d5edfa8960bf7785200912959eb69f313c3c181,0,Bryan Bende,2018-01-22 09:45:17-05:00,['59970344fe992c8a2bc3d173cf3683d8130bfdc6'],28,183,211,3063025,7,0,0.106382979,1,7744
05e9e6eaa5f92a0277ef1a283c6470db08d34de8,0,Mark Payne,2018-01-22 12:53:23-05:00,['5d5edfa8960bf7785200912959eb69f313c3c181'],0,3,3,3063028,1,0,0,0,7744
3ebfcd5ae5132e29482d571e767142c806e30469,1,Andy LoPresto,2018-01-22 12:00:33-08:00,['05e9e6eaa5f92a0277ef1a283c6470db08d34de8'],40,147,187,3063215,3,1,1,0,7745
6f282c6843066f79fc7d53ebec98b4e4bb39f833,0,Bryan Bende,2018-01-22 15:37:31-05:00,['3ebfcd5ae5132e29482d571e767142c806e30469'],0,2,2,3063217,1,1,1,1,7745
84848f7cbb55fe6b6ad7d1c22166cef6d5a0b39c,1,Pierre Villard,2018-01-23 15:10:34+01:00,['6f282c6843066f79fc7d53ebec98b4e4bb39f833'],40,61,101,3063318,3,0.090909091,0.090909091,0.181818182,7745
37271e82414b9386bb735b61ef54e891300117bf,1,Pierre Villard,2018-01-24 17:51:28+01:00,['84848f7cbb55fe6b6ad7d1c22166cef6d5a0b39c'],4,36,40,3063358,1,0,0.2,0.8,7745
c4e2ac7cda45591d357519217687aa7979bae8fb,0,Matt Gilman,2018-01-25 10:02:56-05:00,['37271e82414b9386bb735b61ef54e891300117bf'],1,13,14,3063372,2,,,,7745
8bdc2910e1e0da4e49dd45123327b4b1d37ca640,0,James Wing,2018-01-27 16:01:09-08:00,['c4e2ac7cda45591d357519217687aa7979bae8fb'],88,133,221,3063593,6,0,0,1,7745
d8cfb8e6c516698d65880bbc86a10048b9fbcab8,0,Mark Payne,2018-01-29 11:02:19-05:00,['8bdc2910e1e0da4e49dd45123327b4b1d37ca640'],0,15,15,3063608,3,0.818181818,1,1,7745
6e7dfb9935622a5215115df93503ef4bfba75949,0,Jeremy Dyer,2018-01-31 11:34:31-05:00,['d8cfb8e6c516698d65880bbc86a10048b9fbcab8'],14,53,67,3063675,2,0.238095238,1,0.238095238,7745
dc67bd2fdd762e48075dfa5edbe1a427025c6576,1,Jeremy Dyer,2018-01-31 12:01:17-05:00,['6e7dfb9935622a5215115df93503ef4bfba75949'],11,21,32,3063707,2,0.714285714,1,1,7745
e74c67f77965b8c0cd1bea4d1f1924b2dcebfa07,0,Jeremy Dyer,2018-01-31 15:50:42-05:00,['dc67bd2fdd762e48075dfa5edbe1a427025c6576'],13,24,37,3063744,4,,,,7745
4df3eb567d8dff396b0e2380949e971d074dd04b,0,Pierre Villard,2018-02-02 10:35:03+01:00,['e74c67f77965b8c0cd1bea4d1f1924b2dcebfa07'],18,71,89,3063833,3,0.071428571,0.595238095,1,7745
9bc00b6b6475a0bc65dea4c1d299b583cd50bea9,0,Pierre Villard,2018-02-02 15:59:54+01:00,['4df3eb567d8dff396b0e2380949e971d074dd04b'],1,15,16,3063849,2,0.9,0.9,1,7745
b5938062a8ff0d7c8bb2c1985dc2605b2a69b6dd,1,Matthew Burgess,2018-02-02 11:15:46-05:00,['9bc00b6b6475a0bc65dea4c1d299b583cd50bea9'],6,63,69,3063918,2,0,1,1,7745
3ca7c3e7a19c7f496a214d9b93ace43b1507c9ec,1,Andy LoPresto,2018-02-02 16:10:07-05:00,['b5938062a8ff0d7c8bb2c1985dc2605b2a69b6dd'],403,415,818,3064736,10,0,0,0,7745
f16cbd462b8d5bfea2cf4e1d02910f22e77d0354,1,Matt Gilman,2018-02-07 08:49:35-05:00,['3ca7c3e7a19c7f496a214d9b93ace43b1507c9ec'],19,179,198,3064934,5,0,0.932038835,1,7745
dbbf78f22c1046ae1f9a47780d6b731531d7e445,1,Matt Gilman,2018-02-07 08:55:43-05:00,['f16cbd462b8d5bfea2cf4e1d02910f22e77d0354'],5,3,8,3064942,3,,,,7745
2b062e211f36a0833c273e1a552d42723fdf54fe,1,Matthew Burgess,2018-02-07 10:38:45-05:00,['dbbf78f22c1046ae1f9a47780d6b731531d7e445'],9,52,61,3065003,2,0,0.956521739,0.956521739,7745
d7da04209af6af42f8cb542c2c02779eb696a75f,0,Mark Payne,2018-02-07 15:08:52-05:00,['2b062e211f36a0833c273e1a552d42723fdf54fe'],4,3,7,3065010,2,,,,7745
e9af6c6ad85bb7eafbd8d0703e783032120ea577,1,Mark Payne,2018-02-07 15:45:39-05:00,['d7da04209af6af42f8cb542c2c02779eb696a75f'],67,47,114,3065124,3,1,1,1,7745
f3013d0764202dfb936231eceecc64f40540e0c3,1,Bryan Bende,2018-02-07 16:40:23-05:00,['e9af6c6ad85bb7eafbd8d0703e783032120ea577'],1,9,10,3065134,1,0,0,1,7745
270892f9268bc8e5824a0104f968126aa96d5fa2,1,Matthew Burgess,2018-02-07 19:42:26-05:00,['f3013d0764202dfb936231eceecc64f40540e0c3'],2,39,41,3065175,2,0,0.75,0.75,7745
836c3242587b0246af4a10497dfd8ce90cf642a9,0,Pierre Villard,2018-02-08 11:56:42+01:00,['270892f9268bc8e5824a0104f968126aa96d5fa2'],5,40,45,3065220,2,0,1,1,7745
ba192d22da9bccab255fc26ee9c839d05a567940,0,Pierre Villard,2018-02-08 11:56:49+01:00,['836c3242587b0246af4a10497dfd8ce90cf642a9'],33,28,61,3065281,2,0,0,,7745
16e56ccfcacb64c96fb0d46e5ca61973e8ab0adb,0,Pierre Villard,2018-02-08 11:56:56+01:00,['ba192d22da9bccab255fc26ee9c839d05a567940'],1,32,33,3065314,2,0.047619048,1,1,7745
a2f2ddd6b82ab611e34301e67acf30b30b5a5964,0,Mike Moser,2018-02-08 18:36:11+00:00,['16e56ccfcacb64c96fb0d46e5ca61973e8ab0adb'],115,229,344,3065658,2,0.067567568,0.432432432,0.635135135,7745
4428fe28bfac53ea859741cec2cb04212c5a6034,1,Bryan Bende,2018-02-08 17:38:13-05:00,['a2f2ddd6b82ab611e34301e67acf30b30b5a5964'],1,29,30,3065688,5,0.818181818,0.818181818,1,7745
7d6bbce123a75eb889ee6d2c8b2a0ed786b78cb7,1,Koji Kawamura,2018-02-09 11:45:12+09:00,['4428fe28bfac53ea859741cec2cb04212c5a6034'],5,15,20,3065708,2,0,1,1,7745
25e0bbb68dfb26ee49216c53a481280c776cce45,0,Pierre Villard,2018-02-09 15:32:38+01:00,['7d6bbce123a75eb889ee6d2c8b2a0ed786b78cb7'],19,203,222,3065930,3,0.261682243,0.981308411,1,7746
34b678d30d25c930678b008a5db8a26a6a2938b3,1,Mark Payne,2018-02-09 10:26:19-05:00,['25e0bbb68dfb26ee49216c53a481280c776cce45'],6,169,175,3066105,7,0.671875,0.53125,0.890625,7748
336d3cf1f2641bdf72e8f1847f16f01d4780b186,0,Kevin Doran,2018-02-09 10:49:58-05:00,['34b678d30d25c930678b008a5db8a26a6a2938b3'],3,34,37,3066142,2,0.15,1,1,7748
61c6f0305bc7b5c68456fc2d40e0536698821c47,1,Bryan Bende,2018-02-09 15:45:54-05:00,['336d3cf1f2641bdf72e8f1847f16f01d4780b186'],63,138,201,3066343,10,0,0.425,0.75,7748
b7fdb235ee1055e24fdb3ac000cc8039751199ad,0,Andy LoPresto,2018-02-09 17:43:41-08:00,['61c6f0305bc7b5c68456fc2d40e0536698821c47'],9,51,60,3066403,4,0.189189189,0.189189189,1,7748
b4a9f52a4efd8747c34fa9b88e898ed21976fbf1,0,Matt Gilman,2018-02-11 16:14:52-05:00,['b7fdb235ee1055e24fdb3ac000cc8039751199ad'],6,4,10,3066413,1,0,0,0,7748
b5ca7adbb97c603cbc721e105c4fe279cdcb085b,1,Pierre Villard,2018-02-12 20:44:31+01:00,['b4a9f52a4efd8747c34fa9b88e898ed21976fbf1'],289,319,608,3067021,4,1,1,0,7748
a3edd34db031d5d5efc83a90e99368a1dfd20a4f,0,Pierre Villard,2018-02-13 09:33:53+01:00,['b5ca7adbb97c603cbc721e105c4fe279cdcb085b'],9,2,11,3067032,1,,,,7748
28067a29fd13cdf8e21b440fc65c6dd67872522f,0,Matt Gilman,2018-02-13 15:29:29-05:00,['a3edd34db031d5d5efc83a90e99368a1dfd20a4f'],16,354,370,3067402,6,1,1,1,7751
143d7e6829c7ac5967dceb0df4a9f7f4456720eb,0,Koji Kawamura,2018-02-14 10:04:25+09:00,['28067a29fd13cdf8e21b440fc65c6dd67872522f'],1,580,581,3067983,7,0.437275986,0.663082437,0.792114695,7754
b855d0acaef7aa399469529b3133a7027bbb2f24,1,Matt Gilman,2018-02-16 09:27:36-05:00,['143d7e6829c7ac5967dceb0df4a9f7f4456720eb'],1,1,2,3067985,1,,,,7754
82e36f3c71220821ded66e6795d9aaf3b0ccd41d,1,Pierre Villard,2018-02-17 15:49:01+01:00,['b855d0acaef7aa399469529b3133a7027bbb2f24'],8,210,218,3068203,10,0.254545455,1,1,7758
2a5e21c11b4c801c6b14e978f80f79cf807483a0,0,Pierre Villard,2018-02-17 15:56:05+01:00,['82e36f3c71220821ded66e6795d9aaf3b0ccd41d'],20,104,124,3068327,2,0,0.816326531,1,7758
14fef2de146eab8a42a3b72eda1744378c9584a2,1,Matthew Burgess,2018-02-19 09:19:53-05:00,['2a5e21c11b4c801c6b14e978f80f79cf807483a0'],239,625,864,3069191,12,0.37414966,0.836734694,0.653061224,7763
0bcb241db30f6f2560d305de8a3f50184b731e08,1,Matthew Burgess,2018-02-19 09:26:01-05:00,['14fef2de146eab8a42a3b72eda1744378c9584a2'],48,2960,3008,3072199,26,0.231796927,0.577822311,0.964595858,7783
9f95a10df93f4e1cb5c80b62e06afe8b1d64314f,0,Matthew Burgess,2018-02-19 09:31:11-05:00,['0bcb241db30f6f2560d305de8a3f50184b731e08'],99,264,363,3072562,8,0.861538462,0.861538462,0.784615385,7786
91e98aa50b27800d79c2f9db9a226237b87e65cb,1,Matt Gilman,2018-02-20 12:42:09-05:00,['9f95a10df93f4e1cb5c80b62e06afe8b1d64314f'],410,1069,1479,3074041,7,0.345794393,0.956386293,0.869158879,7789
9cd631f963a0df85ed03ca046780bb762626d848,0,Scott Aslan,2018-02-20 14:51:44-05:00,['91e98aa50b27800d79c2f9db9a226237b87e65cb'],860,982,1842,3075883,36,0,0.35483871,0,7789
bf72d058254968a06cc7f640f39a35a155fb4abb,0,Scott Aslan,2018-02-20 14:51:44-05:00,['9cd631f963a0df85ed03ca046780bb762626d848'],0,3,3,3075886,1,0,1,1,7789
ba9e72ed8b0d1cea08ce206b5cbd71bc6cdaab74,0,Scott Aslan,2018-02-20 16:25:12-05:00,['bf72d058254968a06cc7f640f39a35a155fb4abb'],6,14,20,3075906,2,1,1,1,7789
160bea8bf3020d4a76b5519d553e35bb017dbf89,0,Matt Gilman,2018-02-20 17:14:49-05:00,['ba9e72ed8b0d1cea08ce206b5cbd71bc6cdaab74'],0,3,3,3075909,1,0,1,0,7789
54b1659704aa42111e6d42bd7a2a3dfc1a65ae67,1,Matthew Burgess,2018-02-21 08:58:38-05:00,['160bea8bf3020d4a76b5519d553e35bb017dbf89'],106,609,715,3076624,7,0.340101523,0.725888325,1,7792
b4b970b8762262b51da6bb5fcfe56d026f17b2cb,0,Scott Aslan,2018-02-21 09:42:25-05:00,['54b1659704aa42111e6d42bd7a2a3dfc1a65ae67'],0,32,32,3076656,5,1,1,1,7792
bc37015693be559d6a6d533c34f8fdff4f055c6e,0,Matthew Burgess,2018-02-21 11:14:38-05:00,['b4b970b8762262b51da6bb5fcfe56d026f17b2cb'],0,9,9,3076665,3,0,0,1,7792
ff95be2a118ec5bde1ad88ae2ad8557cd93323a4,0,Matthew Burgess,2018-02-21 12:47:33-05:00,['bc37015693be559d6a6d533c34f8fdff4f055c6e'],5,10,15,3076680,2,0,1,1,7792
d75f118ae116e5c352fdbd02086cafd33dca7e5f,0,Scott Aslan,2018-02-21 13:09:59-05:00,['ff95be2a118ec5bde1ad88ae2ad8557cd93323a4'],3,21,24,3076704,2,0.9,1,1,7792
62732cbb8827d0e41dde90af325775a727501f45,1,Pierre Villard,2018-02-22 20:56:30+01:00,['d75f118ae116e5c352fdbd02086cafd33dca7e5f'],1,1,2,3076706,1,,,,7792
f7fe2da106d0110841796e5c0f59c078f40cefae,1,Pierre Villard,2018-02-24 14:46:35+01:00,['62732cbb8827d0e41dde90af325775a727501f45'],1,1409,1410,3078116,14,0.482758621,0.898467433,0.978927203,7802
3d9c470be39a94767d1acdb2599dbf9e27df8ab3,0,Matthew Burgess,2018-02-26 14:19:35-05:00,['f7fe2da106d0110841796e5c0f59c078f40cefae'],29,219,248,3078364,2,0.496,0.728,1,7802
1ec7bcd28667a52f3135a80e06d96c82302790ed,0,James Wing,2018-02-26 21:01:32-08:00,['3d9c470be39a94767d1acdb2599dbf9e27df8ab3'],1,1,2,3078366,1,,,,7802
19b5b60b0fab909530ae723d4c3997b3042e8e98,0,Scott Aslan,2018-02-27 08:54:58-05:00,['1ec7bcd28667a52f3135a80e06d96c82302790ed'],0,2,2,3078368,2,,,,7802
77dc1860970619eedc083f6017b6737401ee6228,1,Pierre Villard,2018-02-28 12:01:35+01:00,['19b5b60b0fab909530ae723d4c3997b3042e8e98'],3,69,72,3078440,2,0,0.9375,1,7802
9cf9e866ba10a4dd009a9595bd53e8b7f0de3e00,1,Pierre Villard,2018-02-28 17:22:28+01:00,['77dc1860970619eedc083f6017b6737401ee6228'],0,5843,5843,3084283,75,0.613793103,0.764039409,0.963054187,7874
8b490134c76e839e19b77961fb77f6753d7232cc,0,Pierre Villard,2018-02-28 17:22:43+01:00,['9cf9e866ba10a4dd009a9595bd53e8b7f0de3e00'],1,1,2,3084285,1,,,,7874
9c3594ded62101cb6e4e81bbc69c3a783e887bbb,0,Pierre Villard,2018-02-28 17:22:52+01:00,['8b490134c76e839e19b77961fb77f6753d7232cc'],11,539,550,3084835,17,0.384259259,0.805555556,0.907407407,7879
e3cc7bee057e7cbc3c7c852f170d5fa34749cdb5,0,Pierre Villard,2018-02-28 17:23:01+01:00,['9c3594ded62101cb6e4e81bbc69c3a783e887bbb'],4,189,193,3085028,5,0.340425532,0.776595745,1,7880
c1c808002c32008f31ec80664046c1857782e5a9,0,Pierre Villard,2018-02-28 17:23:10+01:00,['e3cc7bee057e7cbc3c7c852f170d5fa34749cdb5'],305,1496,1801,3086829,58,0.551257253,0.827852998,1,7889
fe71c18ec58c1b4b2971d32b8184dd0d2dbba402,0,Pierre Villard,2018-02-28 17:23:18+01:00,['c1c808002c32008f31ec80664046c1857782e5a9'],48,66,114,3086943,5,0,1,1,7889
69367ff0bf9321c498973e64103e2a1477037383,0,Pierre Villard,2018-02-28 17:23:27+01:00,['fe71c18ec58c1b4b2971d32b8184dd0d2dbba402'],6,204,210,3087153,8,0.793650794,0.317460317,1,7891
cc3c1b17142ef7767d429481008b2643e890f875,0,Pierre Villard,2018-02-28 17:23:35+01:00,['69367ff0bf9321c498973e64103e2a1477037383'],10,153,163,3087316,1,0,1,1,7891
b68eebd4293bc921148d933ad94d890c388ce4d0,0,Pierre Villard,2018-02-28 17:23:44+01:00,['cc3c1b17142ef7767d429481008b2643e890f875'],858,2681,3539,3090855,85,0.458119658,0.924786325,0.736752137,7923
d1027879ebd606f8781b5024b1ca2ce3f4f54068,0,Pierre Villard,2018-02-28 17:23:57+01:00,['b68eebd4293bc921148d933ad94d890c388ce4d0'],0,2,2,3090857,1,0,1,1,7923
1911635a3a39ca0ee3e4c7163a0aa6d14c0b401f,0,Pierre Villard,2018-02-28 17:24:05+01:00,['d1027879ebd606f8781b5024b1ca2ce3f4f54068'],41,254,295,3091152,11,0.06122449,0.93877551,0.93877551,7925
2fd24b78e6883b9c52ca53a626db17957a066276,0,Pierre Villard,2018-02-28 17:24:15+01:00,['1911635a3a39ca0ee3e4c7163a0aa6d14c0b401f'],1,1,2,3091154,1,,,,7925
5041bea773c47b0b16b0a0e713d13c16f0cd66b6,0,Pierre Villard,2018-02-28 17:24:24+01:00,['2fd24b78e6883b9c52ca53a626db17957a066276'],103,892,995,3092149,31,0.534013605,0.772108844,1,7932
44bc2d41d7d1c0140fc2daac5ce957641bf983b5,0,Mark Payne,2018-02-28 14:19:53-05:00,['5041bea773c47b0b16b0a0e713d13c16f0cd66b6'],2,30,32,3092181,1,0.933333333,0.933333333,1,7932
eb844d8c6f7fa9b9704d9480b6340bb824dcb667,0,Mark Payne,2018-02-28 14:22:54-05:00,['44bc2d41d7d1c0140fc2daac5ce957641bf983b5'],0,0,0,3092181,0,,,,7932
b4a4cc564e23f7be4512cdc443b2275714c1aea2,0,Mark Payne,2018-03-02 08:44:25-05:00,['eb844d8c6f7fa9b9704d9480b6340bb824dcb667'],9,9,18,3092199,2,,,,7932
c58b02518699c68bf73b77c70e563712db3fe12c,0,Mark Payne,2018-03-02 08:47:32-05:00,['b4a4cc564e23f7be4512cdc443b2275714c1aea2'],2,9,11,3092210,2,0,1,1,7932
42e6fa42a38b8208e5aebc22968b62b4a2856e2e,1,Mark Payne,2018-03-02 09:11:58-05:00,['c58b02518699c68bf73b77c70e563712db3fe12c'],61,251,312,3092522,11,0.205882353,0.794117647,1,7932
74bb341abce78d3e4823f47f894ea6122db5213f,0,Mark Payne,2018-03-02 09:37:00-05:00,['42e6fa42a38b8208e5aebc22968b62b4a2856e2e'],1,1,2,3092524,1,,,,7932
179e967b47920173c013d81411c6086ac1bff326,0,Mark Payne,2018-03-02 11:15:39-05:00,['74bb341abce78d3e4823f47f894ea6122db5213f'],1,14,15,3092539,1,0,0,0,7932
dd58a376c9050bdb280e29125cce4c55701b29df,0,Pierre Villard,2018-03-02 17:32:14+01:00,['179e967b47920173c013d81411c6086ac1bff326'],8,183,191,3092730,4,0,0.992063492,1,7932
c5c508114a6867a4500d4da25c249564077139dc,0,James Wing,2018-03-03 16:58:21-08:00,['dd58a376c9050bdb280e29125cce4c55701b29df'],1,4,5,3092735,1,,,,7932
e916594b69601bce58e045ba8ae2acf6af66eb46,1,Mark Payne,2018-03-05 15:32:23-05:00,['c5c508114a6867a4500d4da25c249564077139dc'],1,274,275,3093010,33,0,1,0.976190476,7935
91f40febebe7c199272375b02299bf2f678b123b,0,Mark Payne,2018-03-05 15:37:31-05:00,['e916594b69601bce58e045ba8ae2acf6af66eb46'],14,83,97,3093107,5,0.545454545,0.575757576,0.666666667,7936
bfecf0f06c43262536bf320a551bf993bc7a941e,0,Matt Gilman,2018-03-06 10:30:18-05:00,['91f40febebe7c199272375b02299bf2f678b123b'],39,57,96,3093203,2,,,,7936
2e4ddbf3b2b27c45c1bf746cbc0358b0b4576a25,0,Mark Payne,2018-03-06 14:09:39-05:00,['bfecf0f06c43262536bf320a551bf993bc7a941e'],97,264,361,3093564,7,1,1,0.703703704,7940
dfd5339690cab8612f4a97a82e99499c2484569f,0,Mark Payne,2018-03-06 15:13:48-05:00,['2e4ddbf3b2b27c45c1bf746cbc0358b0b4576a25'],0,0,0,3093564,0,,,,7940
bff5b7ab713c989f6209eac2a539cd6c60dc2b9e,1,Pierre Villard,2018-03-08 09:02:57+01:00,['dfd5339690cab8612f4a97a82e99499c2484569f'],3,3,6,3093570,1,,,,7940
dae2b73d94f51230ff3193fe7baae657ff10ce82,0,Pierre Villard,2018-03-08 19:23:44+01:00,['bff5b7ab713c989f6209eac2a539cd6c60dc2b9e'],16,6,22,3093592,5,,,,7940
1f8af1bde394e2ab4df4191fcb251555817e470a,0,Matthew Burgess,2018-03-08 13:28:41-05:00,['dae2b73d94f51230ff3193fe7baae657ff10ce82'],12,14,26,3093618,3,,0,,7940
fdca7d0a01000dae4c32792c4ae8e974ac97e673,0,Matt Gilman,2018-03-08 14:30:30-05:00,['1f8af1bde394e2ab4df4191fcb251555817e470a'],4,4,8,3093626,4,,,,7940
79fa4ad46fceaa8393d8cdc22d25c1d6ac8b47dc,0,Matt Gilman,2018-03-08 14:30:31-05:00,['fdca7d0a01000dae4c32792c4ae8e974ac97e673'],2,4,6,3093632,1,,,,7940
3cdd3f60f60914eb92fef95884946ffa2ebcd07e,0,Pierre Villard,2018-03-09 09:36:15+01:00,['79fa4ad46fceaa8393d8cdc22d25c1d6ac8b47dc'],6,2,8,3093640,2,,,,7940
e9d585a785d6b1c802af4e3bb0126fe2ab5c6d46,1,Matt Gilman,2018-03-09 13:59:13-05:00,['3cdd3f60f60914eb92fef95884946ffa2ebcd07e'],4,4,8,3093648,3,,,,7940
8f6645445578019ecf7a20f6522df0043cefce22,1,Andy LoPresto,2018-03-09 11:50:26-08:00,['e9d585a785d6b1c802af4e3bb0126fe2ab5c6d46'],1,1,2,3093650,1,,,,7940
c71409fb5d0a3aef95b05fca9538258d2e2fb907,1,Matt Gilman,2018-03-09 16:34:53-05:00,['8f6645445578019ecf7a20f6522df0043cefce22'],2023,1937,3960,3097610,227,,,,7940
49c7af03c1ae8a5bd7c727b9a5d59b9d7e2d487e,0,Mike Moser,2018-03-09 21:49:13+00:00,['c71409fb5d0a3aef95b05fca9538258d2e2fb907'],6,9,15,3097625,1,1,1,1,7940
06cb354c5e5654878eda582ddf620691360adb49,0,Mark Payne,2018-03-12 09:44:23-04:00,['49c7af03c1ae8a5bd7c727b9a5d59b9d7e2d487e'],2,2,4,3097629,1,,,,7940
32a8db22530fa5b3726b6b08f36adf2ffd6cd5c5,0,Bryan Bende,2018-03-12 10:39:54-04:00,['06cb354c5e5654878eda582ddf620691360adb49'],1,2,3,3097632,3,,,,7940
d4632bdd5dce85cc7adb8c70bafda44d6a333da9,0,Matt Gilman,2018-03-12 13:22:40-04:00,['32a8db22530fa5b3726b6b08f36adf2ffd6cd5c5'],0,12,12,3097644,1,1,1,1,7940
b1217f529bfc5ea9296d1d55c6b0fe92a881a485,1,Mark Payne,2018-03-12 14:19:42-04:00,['d4632bdd5dce85cc7adb8c70bafda44d6a333da9'],256,2021,2277,3099921,69,0.38962963,0.697777778,0.936296296,7947
373cf090a46e03bca49335b9df7d5de0bd94a086,0,Pierre Villard,2018-03-12 20:21:40+01:00,['b1217f529bfc5ea9296d1d55c6b0fe92a881a485'],1,1,2,3099923,1,,,,7947
9158c19123f29130a62d3d1ea059377cf2ad1e6f,0,joewitt,2018-03-12 16:33:20-04:00,['373cf090a46e03bca49335b9df7d5de0bd94a086'],1,1,2,3099925,1,,,,7947
d78d95ad6f31614745bef4c26ba8e9f4c3b27dd2,0,joewitt,2018-03-12 22:22:59-04:00,['9158c19123f29130a62d3d1ea059377cf2ad1e6f'],5,6,11,3099936,1,,,,7947
7aabb99bccc946d460088dc2ba24d45f5c5d1937,0,Pierre Villard,2018-03-13 09:28:22+01:00,['d78d95ad6f31614745bef4c26ba8e9f4c3b27dd2'],3,78,81,3100017,2,0.833333333,1,1,7947
6471f66acd763794f42c1bf968c7e53f04058e76,1,Pierre Villard,2018-03-13 10:00:11+01:00,['7aabb99bccc946d460088dc2ba24d45f5c5d1937'],1,55,56,3100073,2,0.2,0.266666667,0.933333333,7947
c2616e6fe78da68f391c3a4e5bb8a4a44d6b62a9,0,Bryan Bende,2018-03-13 10:07:07-04:00,['6471f66acd763794f42c1bf968c7e53f04058e76'],0,1127,1127,3101200,8,0.204081633,0.664965986,0.778911565,7949
d14229e4407ce4587ba422fbd85e15a9d4f66f85,0,Matthew Burgess,2018-03-13 13:03:39-04:00,['c2616e6fe78da68f391c3a4e5bb8a4a44d6b62a9'],30,138,168,3101368,4,0.030769231,0.692307692,1,7949
f1d7518547c0a5d1c4a6a47cbf1c4c54e68164e6,1,Matt Gilman,2018-03-13 13:15:24-04:00,['d14229e4407ce4587ba422fbd85e15a9d4f66f85'],3,4,7,3101375,2,1,1,1,7949
fad152f389f6be420f30d9500b58cad35a236b05,1,Bryan Bende,2018-03-13 13:23:16-04:00,['f1d7518547c0a5d1c4a6a47cbf1c4c54e68164e6'],4,114,118,3101493,10,0.472222222,1,1,7949
9b098f3235c05e1f47cbb109cffacbaf2baee398,1,Bryan Bende,2018-03-13 13:23:28-04:00,['fad152f389f6be420f30d9500b58cad35a236b05'],38,19,57,3101550,4,1,0,0,7949
29c2e1883217377b22de2aaaef975015b92ba563,1,Matthew Burgess,2018-03-13 16:40:49-04:00,['9b098f3235c05e1f47cbb109cffacbaf2baee398'],1,10,11,3101561,1,0,0,0.75,7949
c75604a564c4abf5c4d26b512b4c6d7639fa592b,1,Matthew Burgess,2018-03-13 16:49:47-04:00,['29c2e1883217377b22de2aaaef975015b92ba563'],2,25,27,3101588,2,0,1,1,7949
95e543d4cce9148c91898827f15c2c61d3565265,1,Matthew Burgess,2018-03-13 16:54:46-04:00,['c75604a564c4abf5c4d26b512b4c6d7639fa592b'],0,25,25,3101613,2,0,0.894736842,0.894736842,7949
11a7d5c09fb4fa965e7b240080f9a8b6b5730c62,1,Matthew Burgess,2018-03-13 17:09:07-04:00,['95e543d4cce9148c91898827f15c2c61d3565265'],2,64,66,3101679,2,0.136363636,1,1,7950
37ad48844a61e7cecaf5650f2d3a4d6f02483d99,1,Pierre Villard,2018-03-13 22:33:53+01:00,['11a7d5c09fb4fa965e7b240080f9a8b6b5730c62'],1,22,23,3101702,3,0,1,1,7950
b0e5e1644c17930ab3df7cc3682d62ed64b7bc1d,0,Pierre Villard,2018-03-13 22:59:03+01:00,['37ad48844a61e7cecaf5650f2d3a4d6f02483d99'],1,1,2,3101704,1,,,,7950
d3f54994a6510b5a428f30e65b3d456225749937,1,Pierre Villard,2018-03-14 10:17:19+01:00,['b0e5e1644c17930ab3df7cc3682d62ed64b7bc1d'],5,21,26,3101730,3,1,1,1,7950
867ffdb52edac5cd616f9f05b48bbb76a8c5cfa9,0,Pierre Villard,2018-03-14 22:50:34+01:00,['d3f54994a6510b5a428f30e65b3d456225749937'],37,30,67,3101797,3,0.5,1,0.416666667,7950
844da063442c1819457108ff872881277c0e8e54,1,Matt Gilman,2018-03-15 15:10:41-04:00,['867ffdb52edac5cd616f9f05b48bbb76a8c5cfa9'],37,3048,3085,3104882,55,0.654569892,0.766129032,0.82594086,7974
930417b9dcabb430df79c683acb9c927aa4f5b8b,0,Matthew Burgess,2018-03-15 15:58:31-04:00,['844da063442c1819457108ff872881277c0e8e54'],228,1141,1369,3106251,22,0.18128655,0.754385965,0.903508772,7979
de71a41bd0d2d8fd90884d8a246ef4c537d48196,1,Mark Payne,2018-03-15 16:16:12-04:00,['930417b9dcabb430df79c683acb9c927aa4f5b8b'],293,1276,1569,3107820,35,0.557603687,0.647465438,0.778801843,7988
7d5f803ce6aa8e4a831094bcc2168013b5a13bab,0,Mark Payne,2018-03-15 16:16:12-04:00,['de71a41bd0d2d8fd90884d8a246ef4c537d48196'],1,0,1,3107821,1,,,,7988
ada069ce426c4c84465425d83fcb8497a14cc4aa,0,Pierre Villard,2018-03-16 10:19:59+01:00,['7d5f803ce6aa8e4a831094bcc2168013b5a13bab'],0,8,8,3107829,2,0.666666667,1,1,7988
3f0aa6e13cba9b96fbe2839a9ad232dab574c720,0,Mark Payne,2018-03-16 12:07:33-04:00,['ada069ce426c4c84465425d83fcb8497a14cc4aa'],28,2,30,3107859,3,1,0,0,7988
86f162b611f89a483a95e362cac32153a055f057,0,Mark Payne,2018-03-16 12:24:00-04:00,['3f0aa6e13cba9b96fbe2839a9ad232dab574c720'],2,18,20,3107879,1,0,0,1,7988
a1c917656e2beec2f57953ee4717ef1e3599489d,1,Mark Payne,2018-03-16 13:03:09-04:00,['86f162b611f89a483a95e362cac32153a055f057'],49,126,175,3108054,3,0,1,1,7989
c056ede6cccb4a93426425fa0c5dbc02d555b6cc,1,Mark Payne,2018-03-16 14:08:14-04:00,['a1c917656e2beec2f57953ee4717ef1e3599489d'],8,19,27,3108081,1,0.625,0.625,0,7989
8b2c5b72469dd9715c532164f288acae835a0fd6,0,Mike Moser,2018-03-16 18:31:43+00:00,['c056ede6cccb4a93426425fa0c5dbc02d555b6cc'],1,58,59,3108140,3,0.029411765,0.235294118,1,7989
9cd0aab696971d00b4ca32defde1b60cafb21d27,0,Mark Payne,2018-03-16 14:40:59-04:00,['8b2c5b72469dd9715c532164f288acae835a0fd6'],19,56,75,3108215,2,0,0,1,7989
c9f1c9789d03c9b25c52d0f2ba3973284ff5037e,0,Mike Moser,2018-03-16 19:15:52+00:00,['9cd0aab696971d00b4ca32defde1b60cafb21d27'],1,17,18,3108233,1,,,,7989
4687e0fb353f565efe990933afb547df7484c936,1,James Wing,2018-03-18 11:35:43-07:00,['c9f1c9789d03c9b25c52d0f2ba3973284ff5037e'],6,74,80,3108313,2,0,1,0.525,7989
1091093133fdc3b9b970e23787b7bfa1dafdbc11,1,Mark Payne,2018-03-19 09:57:38-04:00,['4687e0fb353f565efe990933afb547df7484c936'],33,57,90,3108403,1,0.473684211,1,0,7989
5bdb7cf6e723ba20f4dacaa14fb63d88490d022a,0,joewitt,2018-03-19 10:22:50-04:00,['1091093133fdc3b9b970e23787b7bfa1dafdbc11'],25,25,50,3108453,21,,,,7989
39556e35131638bfb5795dd41736c0faae8aaf39,1,joewitt,2018-03-19 11:40:49-04:00,['5bdb7cf6e723ba20f4dacaa14fb63d88490d022a'],887,632,1519,3109972,16,0.664,0.512,0,7990
78daaf40f80eaebb8e9bf8c6abf79f4081b9e8b0,0,joewitt,2018-03-19 11:41:56-04:00,['39556e35131638bfb5795dd41736c0faae8aaf39'],1,1,2,3109974,1,,,,7990
2590c883187f0a4828151504b7dd48441eaff3fb,0,Pierre Villard,2018-03-19 17:56:13+01:00,['78daaf40f80eaebb8e9bf8c6abf79f4081b9e8b0'],20,91,111,3110085,2,,,,7990
d09145e3e326e5e9a40251831bf00c9f90aba34f,1,Pierre Villard,2018-03-20 11:23:45+01:00,['2590c883187f0a4828151504b7dd48441eaff3fb'],23,64,87,3110172,2,,,,7990
e8a8c19db22fd4a10b48c5286c2660ac7f3db74b,0,joewitt,2018-03-20 12:58:50-04:00,['d09145e3e326e5e9a40251831bf00c9f90aba34f'],1141,228,1369,3111541,22,0.81871345,0.245614035,0.096491228,7991
478e34082db2a028a7771157efb1449fdfa286b4,0,joewitt,2018-03-20 14:32:00-04:00,['e8a8c19db22fd4a10b48c5286c2660ac7f3db74b'],1,1,2,3111543,1,,,,7991
98cd9ad531433adecbe6b591035d71e92c6e0a26,0,Bryan Bende,2018-03-21 11:45:13-04:00,['478e34082db2a028a7771157efb1449fdfa286b4'],42,63,105,3111648,5,0,0.571428571,0.857142857,7991
9c9215982ff02295a79300424c3a5d154869b9ee,0,Mark Payne,2018-03-21 13:17:17-04:00,['98cd9ad531433adecbe6b591035d71e92c6e0a26'],0,1,1,3111649,1,0,0,1,7991
0b0aebe1488b26b87134210fc7a51803e78e1d93,1,Bryan Bende,2018-03-21 14:23:41-04:00,['9c9215982ff02295a79300424c3a5d154869b9ee'],376,1224,1600,3113249,53,0,0.081151832,0.947643979,8000
95dd1ebffcc9b03c292589fa2b81f077d86a5e20,1,Koji Kawamura,2018-03-22 09:18:00+09:00,['0b0aebe1488b26b87134210fc7a51803e78e1d93'],151,345,496,3113745,4,0.628099174,1,1,8001
66590b78f59c553ecccd74acf080ac12a86479a6,1,Pierre Villard,2018-03-23 14:46:50+01:00,['95dd1ebffcc9b03c292589fa2b81f077d86a5e20'],36,308,344,3114089,5,0.209821429,0.986607143,0.919642857,8001
758e44682f994b76fcb9fec900eece2061be7f07,1,Mark Payne,2018-03-23 11:00:21-04:00,['66590b78f59c553ecccd74acf080ac12a86479a6'],63,49,112,3114201,1,0.615384615,1,1,8001
03f4c0fc475558cadbc3a821e375a4ed8092689e,1,Mark Payne,2018-03-23 15:46:17-04:00,['758e44682f994b76fcb9fec900eece2061be7f07'],6,12,18,3114219,1,0,1,1,8001
98c295dfc71ff866a44d3accafb613043ef88789,1,Aldrin Piri,2018-03-24 10:18:46-04:00,['03f4c0fc475558cadbc3a821e375a4ed8092689e'],495,28,523,3114742,9,0.282352941,0,0,8001
69a564e4c83c452f8be819d8e978c28d43c13d7b,0,Bryan Bende,2018-03-26 09:47:54-04:00,['98c295dfc71ff866a44d3accafb613043ef88789'],25,28,53,3114795,23,1,1,1,8001
3612fbe5222b5a0db10b73b070f8b6fbdc03def2,0,Bryan Bende,2018-03-26 10:49:20-04:00,['69a564e4c83c452f8be819d8e978c28d43c13d7b'],0,6,6,3114801,1,0,1,1,8001
456c9c8fc0f8ebd0131ea02aaa89fc374e3c6882,0,Bryan Bende,2018-03-26 13:07:58-04:00,['3612fbe5222b5a0db10b73b070f8b6fbdc03def2'],0,44,44,3114845,1,0.363636364,0.363636364,0.363636364,8001
6b34d3bea9a1fd0923024018d73c3c0b0a807a67,0,Pierre Villard,2018-03-26 20:41:21+02:00,['456c9c8fc0f8ebd0131ea02aaa89fc374e3c6882'],4,245,249,3115094,3,0.263157895,0.827067669,0.969924812,8002
aa947e4d3e0e54877d24683fefa5da651332c433,1,Joe Percivall,2018-03-26 15:01:37-04:00,['6b34d3bea9a1fd0923024018d73c3c0b0a807a67'],16,3368,3384,3118478,29,0.304428044,0.778597786,0.784132841,8024
56ad14ad1eb5bc1d716f6d2664618a07fd049e07,1,Bryan Bende,2018-03-26 15:49:52-04:00,['aa947e4d3e0e54877d24683fefa5da651332c433'],42,99,141,3118619,5,0,1,1,8024
7b5bf265a6d180cbfafd939c82808f016932fbab,0,joewitt,2018-03-26 21:54:10-04:00,['56ad14ad1eb5bc1d716f6d2664618a07fd049e07'],62,56,118,3118737,56,,,,8024
9de73fbe1f1a7ab226d138732ece8c6e9a0c0fba,1,Matthew Burgess,2018-03-27 11:20:40-04:00,['7b5bf265a6d180cbfafd939c82808f016932fbab'],4,1,5,3118742,1,1,1,1,8024
f394c874e1c96d7105cdc20cb0cc13e1fb9710be,1,Matt Gilman,2018-03-28 12:02:47-04:00,['9de73fbe1f1a7ab226d138732ece8c6e9a0c0fba'],1097,2341,3438,3122180,64,0.7640625,1,0.81875,8035
641ba29cc8a9b2790aa66ef8a26a35e11f44912b,0,Mark Payne,2018-03-28 12:15:05-04:00,['f394c874e1c96d7105cdc20cb0cc13e1fb9710be'],69,62,131,3122311,7,0,0,0,8035
c1459825bb09a5d3ed527ac59c83cf3470b41e23,1,Matt Gilman,2018-03-28 16:49:32-04:00,['641ba29cc8a9b2790aa66ef8a26a35e11f44912b'],21,29,50,3122361,3,,,,8035
bbbe428e7bf6f0a6cc7687cbd750431ae81fad8f,0,Pierre Villard,2018-03-29 10:31:15+02:00,['c1459825bb09a5d3ed527ac59c83cf3470b41e23'],8,49,57,3122418,2,0,0.9,1,8035
fd31c161a25fe6009ce35c1e554d4eeb6ed320fd,1,Pierre Villard,2018-03-29 10:54:25+02:00,['bbbe428e7bf6f0a6cc7687cbd750431ae81fad8f'],28,116,144,3122562,7,0.8125,0.8125,0.9375,8037
c4dcde837e10663ced280b99bd64dc1409f951ee,0,joewitt,2018-03-29 12:21:40-04:00,['fd31c161a25fe6009ce35c1e554d4eeb6ed320fd'],1,19,20,3122582,1,,,,8037
5d90d14f17b530e5c328ccb3e8cee4e2e41b9c52,1,Pierre Villard,2018-03-30 11:45:48+02:00,['c4dcde837e10663ced280b99bd64dc1409f951ee'],6,66,72,3122654,2,0,1,1,8037
134339c4b77a9d6798dab57e6d5964fd8bdca94d,0,Bryan Bende,2018-04-02 09:49:05-04:00,['5d90d14f17b530e5c328ccb3e8cee4e2e41b9c52'],10,58,68,3122722,10,,,,8038
bbe79d22603feb3092b61fd3da14ea5ac1fc900f,1,Mark Payne,2018-04-02 10:35:04-04:00,['134339c4b77a9d6798dab57e6d5964fd8bdca94d'],10,16,26,3122748,3,1,1,0,8038
94d444abb00e941df4fdf249053aa3f6999252f6,1,Pierre Villard,2018-04-02 18:16:40+02:00,['bbe79d22603feb3092b61fd3da14ea5ac1fc900f'],4,96,100,3122848,2,0.017241379,0.948275862,1,8038
b7e1f48133b721f0da8410fd19a366b3e7b0d6dd,0,Matthew Burgess,2018-04-02 12:18:27-04:00,['94d444abb00e941df4fdf249053aa3f6999252f6'],53,77,130,3122978,22,,,,8039
c59b6fdf66a33b68a6dd6a0a2b1da90cd98d9825,0,Mike Moser,2018-04-02 20:42:04-04:00,['b7e1f48133b721f0da8410fd19a366b3e7b0d6dd'],9,43,52,3123030,4,0,1,1,8039
2279fad673f6370ee78c43761e5e9b4b9676aa43,0,Pierre Villard,2018-04-03 14:38:38+02:00,['c59b6fdf66a33b68a6dd6a0a2b1da90cd98d9825'],2,7,9,3123039,1,0,0,0,8039
924c935a3856e69cdea06252403dc9f6a9a1c8e2,1,Mark Payne,2018-04-03 10:34:33-04:00,['2279fad673f6370ee78c43761e5e9b4b9676aa43'],2,2,4,3123043,1,,,,8039
364985fb412790155bd2665e861de046c42dddb8,0,Mark Payne,2018-04-03 10:34:33-04:00,['924c935a3856e69cdea06252403dc9f6a9a1c8e2'],26,30,56,3123099,1,0,0,1,8039
7c0ee014d339588547a2bab18a68f7d1dfdd28af,1,joewitt,2018-04-03 07:49:06-07:00,['364985fb412790155bd2665e861de046c42dddb8'],0,15,15,3123114,3,,,,8039
f8466cb16d6723ddc3bf5f0e7f8ce8a47d27cbe5,0,joewitt,2018-04-03 08:28:15-07:00,['7c0ee014d339588547a2bab18a68f7d1dfdd28af'],1207,1202,2409,3125523,385,,,,8039
d511fe3e4bbfccf7f3afb1636dbdcb19e9e15fa1,0,joewitt,2018-04-03 08:28:34-07:00,['f8466cb16d6723ddc3bf5f0e7f8ce8a47d27cbe5'],1197,1197,2394,3127917,385,,,,8039
1913b1e2a8c798eac066c9ab3baab7843e115ef1,1,Matt Gilman,2018-04-03 15:40:28-04:00,['7c0ee014d339588547a2bab18a68f7d1dfdd28af'],31,1025,1056,3128973,13,0.26044226,0.749385749,0.923832924,8045
7abb02fff000e70523c8b7afb6d3b9a7df5c929f,0,Pierre Villard,2018-04-04 23:26:24+02:00,['1913b1e2a8c798eac066c9ab3baab7843e115ef1'],0,765,765,3129738,11,0.319672131,0.431693989,1,8052
dc9b4cb516da346a2942d0bef2810b60ac179cc7,1,Matt Gilman,2018-04-05 13:50:16-04:00,['7abb02fff000e70523c8b7afb6d3b9a7df5c929f'],16,106,122,3129860,16,0.551020408,1,0.551020408,8052
c119547222514cf09dd457f0f21b54b307f5f56d,1,Mark Payne,2018-04-05 13:53:01-04:00,['dc9b4cb516da346a2942d0bef2810b60ac179cc7'],9,16,25,3129885,1,1,1,1,8052
7ff38f690d54cdc607383f1a4be252395b8c5c27,1,Matt Gilman,2018-04-05 16:03:42-04:00,['c119547222514cf09dd457f0f21b54b307f5f56d'],2,17,19,3129904,2,0,0,1,8052
4c787799ff7d971eb924df1e496da8338e6ab192,1,Mark Payne,2018-04-06 12:40:54-04:00,['7ff38f690d54cdc607383f1a4be252395b8c5c27'],1691,2192,3883,3133787,314,1,0,0,8053
644133dc353e8ca3b66658e768b1199c4820da06,0,Mark Payne,2018-04-06 12:42:38-04:00,['4c787799ff7d971eb924df1e496da8338e6ab192'],14,14,28,3133815,6,,,,8053
7cc77937d8636feb65d708d14c3b22a6c71a1ed7,0,Pierre Villard,2018-04-06 20:38:04+02:00,['644133dc353e8ca3b66658e768b1199c4820da06'],10,11,21,3133836,2,,,,8053
8e10f0bd5430e9cbf19851db52a697c0fd76e77b,0,Scott Aslan,2018-04-06 15:17:03-04:00,['7cc77937d8636feb65d708d14c3b22a6c71a1ed7'],1,1,2,3133838,1,,,,8053
63d4bba5a41d4eed40fb3324f124ba02e196d28c,0,Pierre Villard,2018-04-06 21:36:30+02:00,['8e10f0bd5430e9cbf19851db52a697c0fd76e77b'],0,79,79,3133917,3,0.055555556,0.388888889,1,8054
b414132324e945d1c6340f812efe5e6024fad2c1,0,Scott Aslan,2018-04-06 16:07:25-04:00,['63d4bba5a41d4eed40fb3324f124ba02e196d28c'],3,3,6,3133923,2,,,,8054
59f625d3c28cde1cbceff6cf1fafa09e07a8ff84,0,joewitt,2018-04-06 16:48:08-07:00,"['b414132324e945d1c6340f812efe5e6024fad2c1', 'd511fe3e4bbfccf7f3afb1636dbdcb19e9e15fa1']",1206,1201,2407,3136330,385,,,,8054
50137531195752f53698444308598870b3116186,0,joewitt,2018-04-06 17:03:18-07:00,['59f625d3c28cde1cbceff6cf1fafa09e07a8ff84'],2,2,4,3136334,2,,,,8054
ae1d3e39456b364b776d73f46b39e87272e52865,0,Koji Kawamura,2018-04-09 12:31:05+09:00,['50137531195752f53698444308598870b3116186'],4,8,12,3136346,2,0,1,1,8054
5f16f48a2728d6c279768e68e9833f0fa133a758,0,Bryan Bende,2018-04-09 09:53:22-04:00,['ae1d3e39456b364b776d73f46b39e87272e52865'],6,106,112,3136458,24,,,,8077
b29304df79e78c5687b0c9411d5fab6cb93e6541,1,Mark Payne,2018-04-09 14:53:21-04:00,['5f16f48a2728d6c279768e68e9833f0fa133a758'],29,483,512,3136970,10,0.51417004,0.748987854,0.259109312,8079
b6c052066a7700510bfe1d4c254736eed44ca560,0,Scott Aslan,2018-04-10 09:29:39-04:00,['b29304df79e78c5687b0c9411d5fab6cb93e6541'],4,4,8,3136978,1,,,,8079
eb3391f1d2491509c9efff039c3702b70e9b7d6a,0,Scott Aslan,2018-04-10 13:34:18-04:00,['b6c052066a7700510bfe1d4c254736eed44ca560'],24,30,54,3137032,3,,,,8081
274ed46d923e7d080b57ed121596b4ecfa997a2c,0,Mike Thomsen,2018-04-10 14:55:46-04:00,['eb3391f1d2491509c9efff039c3702b70e9b7d6a'],5,27,32,3137064,3,1,1,1,8081
b2fae5f56ee13cba96d112d45b6a8f90af250317,0,Mike Thomsen,2018-04-10 16:08:11-04:00,['274ed46d923e7d080b57ed121596b4ecfa997a2c'],2,2,4,3137068,1,,,,8081
4366c67b27cace82d23ba2d9e1d99b0749860de9,0,Mike Thomsen,2018-04-11 06:58:07-04:00,['b2fae5f56ee13cba96d112d45b6a8f90af250317'],61,917,978,3138046,9,0.329317269,0.855421687,0.937751004,8085
ce0855e9883ef353108a3989350d1e8097ac5191,1,Pierre Villard,2018-04-11 18:53:07+02:00,['4366c67b27cace82d23ba2d9e1d99b0749860de9'],1,35,36,3138082,9,,,,8093
6fbe1515eefd2071dc75a1de2c1fc15cc282da76,1,Matthew Burgess,2018-04-11 14:44:30-04:00,['ce0855e9883ef353108a3989350d1e8097ac5191'],228,1458,1686,3139768,22,0.158432709,0.504258944,0.751277683,8098
b7272e3f3282c6e42eb7ada86d15f32188527ccf,1,Mark Payne,2018-04-11 16:18:36-04:00,['6fbe1515eefd2071dc75a1de2c1fc15cc282da76'],336,174,510,3140278,13,0,0,1,8098
82ac815536d53c00f848f2eae79474035a9eb126,1,Koji Kawamura,2018-04-13 16:30:13+09:00,['b7272e3f3282c6e42eb7ada86d15f32188527ccf'],7,264,271,3140549,4,0.057803468,0.832369942,0.815028902,8098
6d06defa6336a0902180007182024219571e12e7,1,Yolanda Davis,2018-04-13 18:25:09-04:00,['82ac815536d53c00f848f2eae79474035a9eb126'],37,1398,1435,3141984,9,1,1,1,8101
6d804ee1fe117555093cf78437ea762c653a3711,0,Kevin Doran,2018-04-18 12:28:11-04:00,['6d06defa6336a0902180007182024219571e12e7'],1,1,2,3141986,1,,,,8101
a0c9bebe241e8960363490cc0378f22d034f8db7,0,Matthew Burgess,2018-04-18 13:18:30-04:00,['6d804ee1fe117555093cf78437ea762c653a3711'],106,108,214,3142200,1,0,0,1,8101
aa196bc01f438a3e2da04419f619c7baf3fc001d,1,Mike Thomsen,2018-04-18 17:47:04-04:00,['a0c9bebe241e8960363490cc0378f22d034f8db7'],72,2265,2337,3144537,10,0.161363636,0.70530303,1,8105
090e748726b319a96ec941f51299d1436f5f5136,1,Pierre Villard,2018-04-19 09:49:32+02:00,['aa196bc01f438a3e2da04419f619c7baf3fc001d'],1,26,27,3144564,2,0.764705882,0.764705882,1,8105
af12923da4f86fa4736036ee0f4a201725f666a0,0,joewitt,2018-04-19 15:01:33-04:00,['090e748726b319a96ec941f51299d1436f5f5136'],1,2,3,3144567,1,,,,8105
fc902234b60380a6779ba2b2183e1453b123762b,0,Koji Kawamura,2018-04-20 05:15:47+00:00,['af12923da4f86fa4736036ee0f4a201725f666a0'],4,28,32,3144599,5,,,,8106
1dbfcb94453cdfb50666b876c6836d924fae9048,0,Mike Thomsen,2018-04-20 08:50:25-04:00,['fc902234b60380a6779ba2b2183e1453b123762b'],21,142,163,3144762,6,0.53164557,0.734177215,0.556962025,8107
c575a98936087dcd360ed7715a9e2341e46c7f0d,0,Matthew Burgess,2018-04-20 11:24:02-04:00,['1dbfcb94453cdfb50666b876c6836d924fae9048'],10,70,80,3144842,2,1,1,1,8107
262bf011e495a2e94c3975b91ba7c24d822e0a86,0,Matthew Burgess,2018-04-20 11:50:06-04:00,['c575a98936087dcd360ed7715a9e2341e46c7f0d'],1,13,14,3144856,2,0,1,0.636363636,8107
54eb6bc23211ad2b499f42e14759f3646f806d2f,0,Matt Gilman,2018-04-20 16:51:02-04:00,['262bf011e495a2e94c3975b91ba7c24d822e0a86'],5,62,67,3144923,1,0.461538462,0.461538462,0.871794872,8107
8b6539e3c7e56298b70865b6bf2aba3e33b4eb10,0,Mike Thomsen,2018-04-22 15:58:06-04:00,['54eb6bc23211ad2b499f42e14759f3646f806d2f'],0,15,15,3144938,1,0,0,1,8107
ba32879ec81cdfa3c44734ab8b210b13fa0581ac,1,Mike Thomsen,2018-04-22 19:59:48-04:00,['8b6539e3c7e56298b70865b6bf2aba3e33b4eb10'],1,28,29,3144967,2,0,0,0.25,8107
27992119463c82e2065c03608a2b80b709fabc8c,0,Mike Thomsen,2018-04-23 07:08:00-04:00,['ba32879ec81cdfa3c44734ab8b210b13fa0581ac'],0,1,1,3144968,1,0,0,1,8107
8e4aa6bf22ec216824db49fdfaa684e4fec9cb6a,0,Mark Payne,2018-04-23 10:37:22-04:00,['27992119463c82e2065c03608a2b80b709fabc8c'],19,120,139,3145107,2,0.407407407,0.759259259,1,8107
d21bd3870b1edd107bc6ef12bc5f12820a10bebb,1,Mark Payne,2018-04-23 14:39:18-04:00,['8e4aa6bf22ec216824db49fdfaa684e4fec9cb6a'],1,3329,3330,3148437,28,0.303549572,0.788861689,0.772949816,8133
0e736f59fdc29db471cecb4c7a885bf378e9ae71,1,Mark Payne,2018-04-23 14:41:17-04:00,['d21bd3870b1edd107bc6ef12bc5f12820a10bebb'],39,40,79,3148516,2,0,0,0,8133
45bc1f1b4f590db0e4a3cb76fcd4cd89ca1a06bf,1,Mike Thomsen,2018-04-23 15:38:27-04:00,['27992119463c82e2065c03608a2b80b709fabc8c'],11,452,463,3148979,3,0.258964143,0.960159363,0.697211155,8134
5ca6261de009f57ed238bc30191e2f7404762f5c,0,Mike Thomsen,2018-04-23 15:39:20-04:00,"['45bc1f1b4f590db0e4a3cb76fcd4cd89ca1a06bf', '0e736f59fdc29db471cecb4c7a885bf378e9ae71']",20,3450,3470,3152449,30,,,,8134
0390c0f1967d1a57a333d15e1ec41b06ceb88590,1,Mike Thomsen,2018-04-24 10:27:44-04:00,['5ca6261de009f57ed238bc30191e2f7404762f5c'],38,87,125,3152574,2,0,0.548387097,1,8134
e3f4720797a9777264d1732b2e1475b8f344a8f0,1,Bryan Bende,2018-04-24 10:50:40-04:00,['0390c0f1967d1a57a333d15e1ec41b06ceb88590'],31,1465,1496,3154070,7,0.177831912,0.777101096,0.836784409,8137
ac9944ccee7e085cba3c0addd7d8584f3863631f,0,Andy LoPresto,2018-04-24 15:16:04-04:00,['e3f4720797a9777264d1732b2e1475b8f344a8f0'],7,13,20,3154090,5,,,,8137
c118e9623899a34613f0ac8a6f02eafe76df12ae,1,Pierre Villard,2018-04-25 18:03:44+02:00,['ac9944ccee7e085cba3c0addd7d8584f3863631f'],5,34,39,3154129,2,0,0.761904762,1,8137
72f8999b1518d7a6e8e09ba29ffb9b883c9b09d4,0,Pierre Villard,2018-04-25 20:07:15+02:00,['c118e9623899a34613f0ac8a6f02eafe76df12ae'],8,924,932,3155061,9,0.454068241,0.797900262,1,8144
6938e58c81d857f5d56a694a6fef8cf94e60bce2,0,Mark Payne,2018-04-25 14:58:29-04:00,['72f8999b1518d7a6e8e09ba29ffb9b883c9b09d4'],113,329,442,3155503,12,0.043478261,0.347826087,0.246376812,8144
88c079e447b355b5eb9e127a33571969d66aea24,0,Bryan Bende,2018-04-25 15:34:14-04:00,['6938e58c81d857f5d56a694a6fef8cf94e60bce2'],3,9,12,3155515,3,,,,8144
fdea876ede6b503c703e9a816e9a29137be868f9,0,Mark Payne,2018-04-25 15:40:20-04:00,['88c079e447b355b5eb9e127a33571969d66aea24'],2,4,6,3155521,3,0,1,1,8144
af2513adf843f26b4e80a1526e67095a69d85adf,1,Mark Payne,2018-04-25 16:23:34-04:00,['fdea876ede6b503c703e9a816e9a29137be868f9'],120,423,543,3156064,20,0.464646465,0.727272727,0.843434343,8144
23937835f30ffa4082360f71ce0526d794f514bd,0,Matthew Burgess,2018-04-25 16:25:00-04:00,['af2513adf843f26b4e80a1526e67095a69d85adf'],101,0,101,3156165,2,0.873239437,0.253521127,0,8144
3719a6268c3ff020ab3083751bd48e652e668695,0,Pierre Villard,2018-04-26 14:05:53+02:00,['23937835f30ffa4082360f71ce0526d794f514bd'],1,3,4,3156169,1,,,,8144
4e4aa54c69ce991f7f7772cf95c666cd31610d23,1,Bryan Bende,2018-04-26 09:59:59-04:00,['3719a6268c3ff020ab3083751bd48e652e668695'],23,521,544,3156713,2,,,,8144
159b64b4c8bb1b32f6ec9ddba3b98e0faa82c72a,0,Andy LoPresto,2018-04-26 11:50:01-04:00,['4e4aa54c69ce991f7f7772cf95c666cd31610d23'],0,0,0,3156713,1,,,,8144
6e8b1c8f74b957eaef04d1fa7574c29d9c3acbe0,1,Matthew Burgess,2018-04-27 11:48:26-04:00,['159b64b4c8bb1b32f6ec9ddba3b98e0faa82c72a'],50,361,411,3157124,8,0.510989011,0.994505495,1,8145
ba84ad1e380f0e45348f36b91a46b97c258752b4,0,James Wing,2018-04-28 14:03:14-07:00,['6e8b1c8f74b957eaef04d1fa7574c29d9c3acbe0'],17,10,27,3157151,2,,,,8145
579078e3521040a6e37ce08cadf4c79942a4229e,0,James Wing,2018-04-29 17:06:10-07:00,['ba84ad1e380f0e45348f36b91a46b97c258752b4'],5,63,68,3157219,2,1,1,1,8146
4ed6631edc716f6a0bcd92ade4074a5b952bd70b,0,Andy LoPresto,2018-05-02 08:20:33-07:00,['579078e3521040a6e37ce08cadf4c79942a4229e'],0,9,9,3157228,1,,,,8146
0289ca7114484e9d5295cb62e741d7793ed8c85c,1,Mark Payne,2018-05-02 15:22:01-04:00,['4ed6631edc716f6a0bcd92ade4074a5b952bd70b'],39,406,445,3157673,14,0.086419753,0.969135802,0.975308642,8151
18ad3481071e5863d77fcbad7d99623fd9717956,0,Matt Gilman,2018-05-02 15:53:52-04:00,['0289ca7114484e9d5295cb62e741d7793ed8c85c'],3,7,10,3157683,2,0,0,1,8151
2007c207ab1fac0c1d030cf29623796997650b20,0,Mike Thomsen,2018-05-03 09:06:05-04:00,['18ad3481071e5863d77fcbad7d99623fd9717956'],28,113,141,3157824,9,0.535714286,1,0.321428571,8152
3ad324351140d3fb539548fa431463c7decec0c3,0,Matthew Burgess,2018-05-03 09:12:07-04:00,['2007c207ab1fac0c1d030cf29623796997650b20'],2,13,15,3157839,1,0,1,1,8152
ed30bb9b7872840b3b5348766c0e68b69617abd8,0,Mike Thomsen,2018-05-04 17:32:10-04:00,['3ad324351140d3fb539548fa431463c7decec0c3'],28,135,163,3158002,4,0.322580645,0.983870968,0.725806452,8152
ff04f8efee6c93c90f3155d70d3814a4140879f3,0,Mike Thomsen,2018-05-07 06:08:59-04:00,['ed30bb9b7872840b3b5348766c0e68b69617abd8'],1,1,2,3158004,1,,,,8152
5cfa29e48f8e0e88a270488770a268199a588f68,0,Bryan Bende,2018-05-07 11:17:26-04:00,['ff04f8efee6c93c90f3155d70d3814a4140879f3'],85,323,408,3158412,12,0.179856115,0.633093525,0.64028777,8152
868808f4b44a5f071285cadc76b5b1d793e29e11,0,Bryan Bende,2018-05-07 11:44:52-04:00,['5cfa29e48f8e0e88a270488770a268199a588f68'],1,33,34,3158446,2,0,1,1,8152
4544f3969d6978f6637c59206c978281d377d1c3,0,Bryan Bende,2018-05-07 13:20:56-04:00,['868808f4b44a5f071285cadc76b5b1d793e29e11'],18,17,35,3158481,1,0,0,0,8152
8acac9cba5b9d409e4ba885ce5dba15ef416de0e,0,Bryan Bende,2018-05-07 15:41:38-04:00,['4544f3969d6978f6637c59206c978281d377d1c3'],3,6,9,3158490,1,0,0,0,8152
fb48ae2f8853e30562d87595b52febe230a26596,1,Matt Gilman,2018-05-07 16:01:26-04:00,['8acac9cba5b9d409e4ba885ce5dba15ef416de0e'],5,70,75,3158565,2,0,0.5,1,8152
a9e85c358c802ccfa7fa3f6d20e5758ec6295bde,0,Kevin Doran,2018-05-07 16:13:26-04:00,['fb48ae2f8853e30562d87595b52febe230a26596'],0,1,1,3158566,1,0,1,1,8152
2094786ec83567a375a719adacc71341bd81408b,0,Andy LoPresto,2018-05-07 14:07:20-07:00,['a9e85c358c802ccfa7fa3f6d20e5758ec6295bde'],6,77,83,3158649,5,1,1,1,8152
92b4a3208fddd44f0d7e3d618761b9db238b758c,1,Mark Payne,2018-05-08 15:29:37-04:00,['2094786ec83567a375a719adacc71341bd81408b'],14,106,120,3158769,7,0.076923077,0.557692308,0.961538462,8152
7a4990e7fe7c38c95b4ee1436a822428ff1f5f98,1,Kevin Doran,2018-05-09 12:14:11-04:00,['92b4a3208fddd44f0d7e3d618761b9db238b758c'],90,451,541,3159310,5,1,1,0,8154
f742a3a6accd7695a32b1e4c42c2ec93619a7b9a,1,Pierre Villard,2018-05-09 18:19:17+02:00,['7a4990e7fe7c38c95b4ee1436a822428ff1f5f98'],54,40,94,3159404,11,1,0,0,8154
4700b8653dc980b1cf8985430683b79eb64922a4,1,Pierre Villard,2018-05-09 18:38:04+02:00,['f742a3a6accd7695a32b1e4c42c2ec93619a7b9a'],9,154,163,3159567,8,0,0.455696203,1,8156
0a44bad76e6db2c163f6d6a78bbaf8184cdce7f7,0,Pierre Villard,2018-05-09 18:46:35+02:00,['4700b8653dc980b1cf8985430683b79eb64922a4'],15,12,27,3159594,1,1,1,0,8156
02ba4cf2c85221af731f310b9f2d1624f4e2f446,1,Pierre Villard,2018-05-09 19:39:29+02:00,['0a44bad76e6db2c163f6d6a78bbaf8184cdce7f7'],97,426,523,3160117,5,0.317307692,0.4375,0.735576923,8156
4f1444c0e09d974cbdca51abdd916e49fa0cfd62,0,joewitt,2018-05-09 13:52:05-04:00,['02ba4cf2c85221af731f310b9f2d1624f4e2f446'],11,146,157,3160274,3,,,,8157
22342a0e0c426e0a784925ac59161cbf7eba0c42,1,Scott Aslan,2018-05-09 14:06:19-04:00,['4f1444c0e09d974cbdca51abdd916e49fa0cfd62'],9,7,16,3160290,2,1,0,0,8157
def9741a3986db954fcb8f0c99445e47c63f3ad9,0,Pierre Villard,2018-05-10 10:47:20+02:00,['22342a0e0c426e0a784925ac59161cbf7eba0c42'],5,5,10,3160300,3,,,,8157
6e0be8e6414b489aa4c86a71cd0b271ce4e23f96,0,Pierre Villard,2018-05-10 11:04:32+02:00,['def9741a3986db954fcb8f0c99445e47c63f3ad9'],3,74,77,3160377,4,1,1,0.722222222,8157
0b851910f3968e32ec51d2b92bf53c6f9453edb0,1,Koji Kawamura,2018-05-11 00:55:40+00:00,['6e0be8e6414b489aa4c86a71cd0b271ce4e23f96'],213,1390,1603,3161980,35,0.518134715,0.569948187,0.75388601,8170
500a254e3f5fe709a2cf6bd1268d57710334ea27,0,Koji Kawamura,2018-05-11 07:30:19+00:00,['0b851910f3968e32ec51d2b92bf53c6f9453edb0'],2,2,4,3161984,4,,,,8170
099bfcdf3a5873a311312eb7e9e85b7b22ef1b98,1,Mike Thomsen,2018-05-11 08:19:16-04:00,['500a254e3f5fe709a2cf6bd1268d57710334ea27'],18,41,59,3162043,15,1,1,1,8170
64356e001432b78d919604d13787ea7b40e80e8e,0,Mike Thomsen,2018-05-11 09:51:24-04:00,['099bfcdf3a5873a311312eb7e9e85b7b22ef1b98'],8,133,141,3162184,4,0.083333333,0.5,0.513888889,8171
61fe493786425826e46cab737be9def11300dd19,1,Mike Thomsen,2018-05-13 08:40:20-04:00,['64356e001432b78d919604d13787ea7b40e80e8e'],130,345,475,3162659,10,0.180327869,1,0.819672131,8172
03adaeca222e2b040fce5680bbc03572d0ba473e,1,Mike Thomsen,2018-05-14 14:26:47-04:00,['61fe493786425826e46cab737be9def11300dd19'],9,229,238,3162897,5,0.418918919,0.527027027,1,8173
04745a556a3805597948f672292959e684401ddf,0,Mike Thomsen,2018-05-14 14:35:12-04:00,['03adaeca222e2b040fce5680bbc03572d0ba473e'],1,23,24,3162921,4,1,1,1,8174
ed9263811b9d0ac8d757f8d20463cc8216b5ad8a,0,Pierre Villard,2018-05-15 11:40:11+02:00,['04745a556a3805597948f672292959e684401ddf'],1,1,2,3162923,1,,,,8174
79a7014a95dc3087f88248c732fb1e4ad8e6e128,1,Mike Thomsen,2018-05-15 05:50:26-04:00,['ed9263811b9d0ac8d757f8d20463cc8216b5ad8a'],81,688,769,3163692,6,0.244582043,0.941176471,0.820433437,8176
620d44686041a24ce03eb5d864b128c0e61e9dc5,0,Pierre Villard,2018-05-15 11:52:55+02:00,['79a7014a95dc3087f88248c732fb1e4ad8e6e128'],3,6,9,3163701,1,0,1,1,8176
2c8c9374af7785fc92ec603669c6763a7d311d3b,1,Mark Payne,2018-05-15 11:07:19-04:00,['620d44686041a24ce03eb5d864b128c0e61e9dc5'],2,3339,3341,3167042,15,0.338028169,0.788732394,0.799024919,8185
ccedc71c8b89e1792d79197f399b37b1ac541e3f,0,Pierre Villard,2018-05-15 19:24:10+02:00,['2c8c9374af7785fc92ec603669c6763a7d311d3b'],0,42,42,3167084,2,0.904761905,0.952380952,1,8185
01a01a3dfc1769988be82b43f1eb8c9340e2e159,0,Koji Kawamura,2018-05-16 14:01:19+09:00,['ccedc71c8b89e1792d79197f399b37b1ac541e3f'],4,233,237,3167321,8,0.094890511,0.773722628,1,8185
de1ad3eb6f68d060fc8584d2b1275a295b82078a,0,Koji Kawamura,2018-05-16 14:02:28+09:00,['01a01a3dfc1769988be82b43f1eb8c9340e2e159'],2,4,6,3167327,1,,,,8185
c3059939e8dc39f26394cc88e608dca7de3f8e1f,0,Scott Aslan,2018-05-16 11:12:16-04:00,['de1ad3eb6f68d060fc8584d2b1275a295b82078a'],9,2,11,3167338,1,1,0,0,8185
10254a03c2127c58d8efc2fecfba3c4e2147143d,1,Pierre Villard,2018-05-16 18:15:20+02:00,['c3059939e8dc39f26394cc88e608dca7de3f8e1f'],10,110,120,3167458,3,0.447368421,1,1,8186
0688363d87ecdcc68a9dd18888c64a06063c3a15,1,Mike Thomsen,2018-05-16 12:27:19-04:00,['10254a03c2127c58d8efc2fecfba3c4e2147143d'],5,27,32,3167490,2,0.933333333,0.933333333,0.933333333,8186
ea41b41ede3cc9832cf0b95c3f51ca29fda67fc3,1,Matthew Burgess,2018-05-16 13:50:27-04:00,['0688363d87ecdcc68a9dd18888c64a06063c3a15'],15,16,31,3167521,5,0.666666667,0.666666667,1,8186
604656fe8829a79549c24d34c0149891e0edebe9,1,Matt Gilman,2018-05-16 14:39:23-04:00,['ea41b41ede3cc9832cf0b95c3f51ca29fda67fc3'],1343,3556,4899,3172420,105,0.622004357,1,0.91503268,8207
775cf425607165b5396ffec6c21ddcb177a3798a,0,Mike Thomsen,2018-05-16 16:18:52-04:00,['604656fe8829a79549c24d34c0149891e0edebe9'],2,20,22,3172442,1,,,,8207
807e1e5c7a6e0af1917bbdf912cd9bc17561ae2a,1,Mike Thomsen,2018-05-17 07:00:46-04:00,['775cf425607165b5396ffec6c21ddcb177a3798a'],5,40,45,3172487,3,0,0,1,8207
5613bf4012447c4a1dd5e0d969098efcd156fa88,0,Mike Thomsen,2018-05-17 07:10:35-04:00,['807e1e5c7a6e0af1917bbdf912cd9bc17561ae2a'],2,5,7,3172494,1,0,1,1,8207
f5108ea839fa6377af864c8235f320f7283a8d69,1,Matthew Burgess,2018-05-17 09:57:35-04:00,['5613bf4012447c4a1dd5e0d969098efcd156fa88'],33,51,84,3172578,18,1,1,1,8207
2afbf963812bccdec8c997e6c63a93c644016769,0,Matt Gilman,2018-05-17 13:44:52-04:00,['f5108ea839fa6377af864c8235f320f7283a8d69'],16,57,73,3172651,4,0.413793103,0,0.413793103,8207
8aaa51af311b25a7479062de3e4c558769144363,0,Scott Aslan,2018-05-17 15:09:37-04:00,['2afbf963812bccdec8c997e6c63a93c644016769'],6,6,12,3172663,1,,,,8207
6bb43bd4716dda44738d4754518cb60467b62ea6,1,Matthew Burgess,2018-05-17 20:00:24-04:00,['8aaa51af311b25a7479062de3e4c558769144363'],1,2,3,3172666,1,,,,8207
29e96ed0e0b63bc2f5b0f07751fe7efbc10f18ab,1,Matthew Burgess,2018-05-17 21:33:46-04:00,['6bb43bd4716dda44738d4754518cb60467b62ea6'],2,1,3,3172669,1,,,,8207
d79216d6b08a842dc0c5f6b847429aae87fb5561,0,Matthew Burgess,2018-05-18 15:59:12-04:00,['29e96ed0e0b63bc2f5b0f07751fe7efbc10f18ab'],2,6,8,3172677,2,1,1,0,8207
2834fa4ce477014dfad8c96b6d326d0f1f06a23e,1,Mike Thomsen,2018-05-20 17:57:47-04:00,['d79216d6b08a842dc0c5f6b847429aae87fb5561'],195,1326,1521,3174198,64,0.583333333,0.705729167,0.856770833,8217
6bf6a92abd1f90ea61154dc84fb18a600e4cebfa,0,Koji Kawamura,2018-05-22 09:28:30+09:00,['2834fa4ce477014dfad8c96b6d326d0f1f06a23e'],3,51,54,3174252,2,0.714285714,0.714285714,1,8217
6356d7b9ee7cd9a84515a441724a2659397a0ffa,0,joewitt,2018-05-22 10:24:57-04:00,['6bf6a92abd1f90ea61154dc84fb18a600e4cebfa'],2,35,37,3174289,4,0,1,1,8218
568288dbcd143bb874d64417f0ecd1fe10dfee9e,1,Scott Aslan,2018-05-22 11:05:28-04:00,['6356d7b9ee7cd9a84515a441724a2659397a0ffa'],145,273,418,3174707,25,0.320754717,0.132075472,0.754716981,8218
0305ca0fb8ed6968458d2ced8453da0bee12e0d5,0,Scott Aslan,2018-05-22 11:05:35-04:00,['568288dbcd143bb874d64417f0ecd1fe10dfee9e'],4,4,8,3174715,2,,,,8218
470d85042df61ff4bab75e3f3a1fbd1085158d56,0,Scott Aslan,2018-05-22 12:03:37-04:00,['0305ca0fb8ed6968458d2ced8453da0bee12e0d5'],0,1,1,3174716,1,,,,8218
dd8b25ab48314dde8cad351a9b564196d807d90e,0,Koji Kawamura,2018-05-23 08:52:49+09:00,['470d85042df61ff4bab75e3f3a1fbd1085158d56'],2,44,46,3174762,2,0,0.84,1,8218
f7035f0497314d10d0e245a22127dfbedb36e850,0,Mike Thomsen,2018-05-23 07:34:49-04:00,['dd8b25ab48314dde8cad351a9b564196d807d90e'],55,11,66,3174828,4,0,0,0,8218
3a29c1e4ca703a8d042438cd7b576485371dacbd,1,Matthew Burgess,2018-05-23 09:14:04-04:00,['f7035f0497314d10d0e245a22127dfbedb36e850'],102,765,867,3175695,14,0.551094891,0.861313869,0.824817518,8224
23feb8f42958b45a95c369eb95eee4541586ea19,0,Mike Thomsen,2018-05-23 10:00:25-04:00,['3a29c1e4ca703a8d042438cd7b576485371dacbd'],5,13,18,3175713,2,1,1,1,8224
167014441bc9044bfcbee25a07f813e9f9f3b34a,0,Matt Gilman,2018-05-23 10:50:01-04:00,['23feb8f42958b45a95c369eb95eee4541586ea19'],49,63,112,3175825,1,0.384615385,0,0,8224
cca520aab7b924f0d6e6a60f85c3d144784229ad,0,Matt Gilman,2018-05-23 10:50:01-04:00,['167014441bc9044bfcbee25a07f813e9f9f3b34a'],32,49,81,3175906,1,0.25,0.5,0.75,8224
d75ba167cd93042c3f747f4aacb507617694bc0c,0,Mark Payne,2018-05-23 13:39:20-04:00,['cca520aab7b924f0d6e6a60f85c3d144784229ad'],8,60,68,3175974,4,0.361111111,1,1,8224
06d45c3a6ea30c5dc51d5f320d423dafc10271f8,1,Bryan Bende,2018-05-23 15:28:39-04:00,['d75ba167cd93042c3f747f4aacb507617694bc0c'],3,32,35,3176009,1,0.727272727,0,0.363636364,8224
716587d09f97cb01d685b79c010534af9aea1985,0,joewitt,2018-05-23 16:16:25-05:00,['06d45c3a6ea30c5dc51d5f320d423dafc10271f8'],511,52,563,3176572,6,0.876582278,0.924050633,0,8224
db259628c7ea359c0783a3cb800f5d58da9e09ed,1,Mark Payne,2018-05-24 11:29:47-04:00,['716587d09f97cb01d685b79c010534af9aea1985'],88,70,158,3176730,7,1,0.966666667,0.9,8227
1597492fed749c13a97f44d0d8ed633787702d3c,0,Mark Payne,2018-05-24 11:30:39-04:00,['db259628c7ea359c0783a3cb800f5d58da9e09ed'],11,4,15,3176745,1,1,0,0,8227
3b3d6d4eb2c9de250f22598f16b05811cf3ff17f,0,Mark Payne,2018-05-24 14:35:33-04:00,['1597492fed749c13a97f44d0d8ed633787702d3c'],10,24,34,3176779,3,1,1,0,8227
be0ed704231fb51ed233b58575e1378fc2c93e1d,1,Mark Payne,2018-05-24 15:55:17-04:00,['3b3d6d4eb2c9de250f22598f16b05811cf3ff17f'],0,1995,1995,3178774,15,0.184100418,0.748953975,0.979079498,8240
397e88c8582d6fffe7fd3c21be1663a0c4c22877,0,Mark Payne,2018-05-24 15:57:28-04:00,['be0ed704231fb51ed233b58575e1378fc2c93e1d'],3,3,6,3178780,1,,,,8240
f15e6c7ab3c72610cffa03475b27ca3349aa53f7,0,Mark Payne,2018-05-24 16:03:36-04:00,['397e88c8582d6fffe7fd3c21be1663a0c4c22877'],0,0,0,3178780,0,,,,8240
cf6089196f7780e546bdd9d36ce52f535149fabf,1,Mike Thomsen,2018-05-25 08:54:03-04:00,['f15e6c7ab3c72610cffa03475b27ca3349aa53f7'],1,324,325,3179105,3,0.683098592,1,1,8242
64cd34016bbef89701a82f790a59756157f9d4ab,0,Mike Thomsen,2018-05-25 10:37:45-04:00,['cf6089196f7780e546bdd9d36ce52f535149fabf'],13,23,36,3179141,3,0,1,1,8242
18ec3861509193ab1affd196c01b315db6b98919,0,Mark Payne,2018-05-25 11:22:21-04:00,['64cd34016bbef89701a82f790a59756157f9d4ab'],1,45,46,3179187,5,0.7,0.7,0,8242
dbef69040fe18ad9408937c78eb469ec5872eddc,0,Mark Payne,2018-05-25 11:22:21-04:00,['18ec3861509193ab1affd196c01b315db6b98919'],2,2,4,3179191,1,,,,8242
0973c2d8d13940323ebb30eaa383608bf9e7cbb5,0,Mark Payne,2018-05-25 11:50:29-04:00,['dbef69040fe18ad9408937c78eb469ec5872eddc'],25,157,182,3179373,21,1,1,1,8244
eb0b4283e800636b8722fadfebce34e3df094196,1,Mark Payne,2018-05-25 13:44:15-04:00,['0973c2d8d13940323ebb30eaa383608bf9e7cbb5'],494,410,904,3180277,13,0.131782946,0.589147287,0.80620155,8244
65beec39bb94e1a3af8654bdc2741892526b8193,0,Mike Thomsen,2018-05-27 19:00:34-04:00,['eb0b4283e800636b8722fadfebce34e3df094196'],0,18,18,3180295,2,,,,8244
688f906a7348903db173f1025dc10fcbce06abb3,0,Bryan Bende,2018-05-29 10:31:14-04:00,['65beec39bb94e1a3af8654bdc2741892526b8193'],1,121,122,3180417,3,,,,8245
9aa7e65f70821665f9913170caf13730b2c9b586,1,Matt Gilman,2018-05-29 13:20:49-04:00,['688f906a7348903db173f1025dc10fcbce06abb3'],11,536,547,3180964,6,,,,8246
1663a6c09428cb0301c84e547cefc7e17ff2cd20,1,Pierre Villard,2018-05-30 09:47:18+02:00,['9aa7e65f70821665f9913170caf13730b2c9b586'],3,791,794,3181758,10,0.638157895,0.694078947,1,8253
1d21e3baf85ec622fd9d0fb9d3f18c27802a0978,1,Mike Thomsen,2018-05-30 06:58:01-04:00,['1663a6c09428cb0301c84e547cefc7e17ff2cd20'],18,393,411,3182169,16,0.448275862,0.965517241,0.75862069,8258
3a248e96deaee731b6d701d47fd37e5a7f4997b9,1,Mike Thomsen,2018-05-30 07:10:00-04:00,['1d21e3baf85ec622fd9d0fb9d3f18c27802a0978'],41,122,163,3182332,6,0.85,0.85,1,8259
05a1d63090d97d06bf823821d1b0e9b5482c7cd2,1,Scott Aslan,2018-05-30 13:41:03-04:00,['3a248e96deaee731b6d701d47fd37e5a7f4997b9'],323,1103,1426,3183758,91,0.546583851,0.623188406,0.256728778,8259
9093d280f2be6faaa847d7537fef8e7e72c28e9a,0,Scott Aslan,2018-05-30 13:41:20-04:00,['05a1d63090d97d06bf823821d1b0e9b5482c7cd2'],13,0,13,3183771,1,0,0,0,8259
f69b720464d540c8ea32f7ddbc58d08cb566a630,1,Matt Gilman,2018-05-30 14:22:28-04:00,['9093d280f2be6faaa847d7537fef8e7e72c28e9a'],120,1146,1266,3185037,19,0.644836272,0.947103275,0.967254408,8267
498fd8f22dbe6ef322d77eb13d37ab8d49d69461,0,Mike Thomsen,2018-05-31 06:35:39-04:00,['f69b720464d540c8ea32f7ddbc58d08cb566a630'],20,179,199,3185236,6,0.166666667,0.766666667,1,8270
83fccc4bebd9eb508c2f64752f24d79e7bd0db37,0,Mike Thomsen,2018-05-31 08:35:25-04:00,['498fd8f22dbe6ef322d77eb13d37ab8d49d69461'],0,1,1,3185237,1,,,,8270
a1794b101ea843410606b65bbb75fd8bc87ccd39,0,Matthew Burgess,2018-05-31 11:07:11-04:00,['83fccc4bebd9eb508c2f64752f24d79e7bd0db37'],71,461,532,3185769,15,0.463157895,0.842105263,1,8276
caa71fce9260ed717d501bd962a6a26ae61c25ea,1,Jeff Storck,2018-06-01 13:20:33-04:00,['a1794b101ea843410606b65bbb75fd8bc87ccd39'],22,102,124,3185893,15,,,,8278
06d1276f0948fd44975a6c8e5758fd39148e5506,0,Matthew Burgess,2018-06-04 12:23:57-04:00,['caa71fce9260ed717d501bd962a6a26ae61c25ea'],5,35,40,3185933,2,0,1,1,8278
cb216b79ece5a149e3b1d023bb6cd6f3764af0b8,0,Scott Aslan,2018-06-05 09:33:25-04:00,['06d1276f0948fd44975a6c8e5758fd39148e5506'],8,14,22,3185955,2,0,1,1,8278
504152eaa1cd377e4e9c94d2e5670855c8d2f7b0,0,Mike Thomsen,2018-06-05 18:24:47-04:00,['cb216b79ece5a149e3b1d023bb6cd6f3764af0b8'],45,73,118,3186073,8,0,1,1,8278
71cf3fd46dfabe867ceb4d59451e855a0c968711,0,Pierre Villard,2018-06-06 09:37:02+02:00,['504152eaa1cd377e4e9c94d2e5670855c8d2f7b0'],6,37,43,3186116,2,0.269230769,0.923076923,1,8278
5eaed6fad5275322bad6964bbd6816982a0c7359,0,Pierre Villard,2018-06-06 09:44:19+02:00,['71cf3fd46dfabe867ceb4d59451e855a0c968711'],0,5,5,3186121,3,,,,8278
c3af53ce65f4206ce279f61dc0ea7bad823cc8ec,0,Pierre Villard,2018-06-06 10:03:42+02:00,['5eaed6fad5275322bad6964bbd6816982a0c7359'],15,5,20,3186141,1,0.666666667,0.666666667,0.666666667,8278
eedf1237a1d94b9d23ad494ce82ffc13eb9f1476,0,Pierre Villard,2018-06-06 10:10:29+02:00,['c3af53ce65f4206ce279f61dc0ea7bad823cc8ec'],17,55,72,3186213,2,0,0,0,8279
f7f809c3d3632eea5234b31740984b73de322464,0,Mike Moser,2018-06-06 17:23:20+00:00,['eedf1237a1d94b9d23ad494ce82ffc13eb9f1476'],22,150,172,3186385,2,0.658227848,0.658227848,0.898734177,8279
ff00050266e1b607babd957253ecce08ec324c1a,1,Matt Gilman,2018-06-07 09:15:32-04:00,['f7f809c3d3632eea5234b31740984b73de322464'],149,102,251,3186636,4,0,0,0,8279
d2fd7e5e7dd5185adc737d9f3b1f225d4ed9ecb0,1,zenfenan,2018-06-07 20:26:25+05:18,['ff00050266e1b607babd957253ecce08ec324c1a'],90,242,332,3186968,16,1,0,0,8282
c412445a1f15c9138009b52a2dd518ab5c69a3f4,0,Mark Payne,2018-06-07 13:51:47-04:00,['d2fd7e5e7dd5185adc737d9f3b1f225d4ed9ecb0'],5,4,9,3186977,1,1,1,0,8282
f5364875e82aa18aa157c0fedc152cf209110ba6,0,Matthew Burgess,2018-06-07 14:48:53-04:00,['c412445a1f15c9138009b52a2dd518ab5c69a3f4'],0,1157,1157,3188134,3,0.100890208,0.850148368,0.921364985,8284
7b9d779a4bf6b36d44802909bcba539b1739d716,0,Scott Aslan,2018-06-07 18:26:13-04:00,['f5364875e82aa18aa157c0fedc152cf209110ba6'],5,55,60,3188194,5,0.458333333,0.604166667,1,8284
729f8aa246767df4a2930771673ca2a7e18957bd,0,Andy LoPresto,2018-06-07 16:32:19-07:00,['7b9d779a4bf6b36d44802909bcba539b1739d716'],2,15,17,3188211,1,0.9,1,1,8284
0e09b98b02bcfae21841cb7dda176c7c1c33f4d8,1,Pierre Villard,2018-06-08 09:36:27+02:00,['729f8aa246767df4a2930771673ca2a7e18957bd'],105,685,790,3189001,15,0.171348315,0.654494382,0.668539326,8286
49228aa5dcbae5c4216310117daba586a63e6778,0,Pierre Villard,2018-06-08 10:07:43+02:00,['0e09b98b02bcfae21841cb7dda176c7c1c33f4d8'],4,7,11,3189012,1,0,0,0,8286
6e067734d5bed7dbabc4af2dae1f23bb980e3957,0,zenfenan,2018-06-08 19:04:20+05:18,['49228aa5dcbae5c4216310117daba586a63e6778'],1,15,16,3189028,2,0,0.333333333,1,8286
05d7b6c6e7d640a300b580724e460d45eaed1938,0,zenfenan,2018-06-08 20:42:47+05:18,['6e067734d5bed7dbabc4af2dae1f23bb980e3957'],10,89,99,3189127,4,0.2,0.866666667,1,8287
4bccab7e0576a913926702af036f5414aeede6fd,0,Scott Aslan,2018-06-08 13:50:25-04:00,['05d7b6c6e7d640a300b580724e460d45eaed1938'],0,58,58,3189185,1,,,,8287
00a63d17af3c82727b9119acb00fccfcf6639fc5,0,Matthew Burgess,2018-06-08 16:47:28-04:00,['4bccab7e0576a913926702af036f5414aeede6fd'],5,24,29,3189214,2,1,1,1,8287
cf3c6666835595aaedaf6b7769fe17e018117019,1,Mike Thomsen,2018-06-09 14:19:45-04:00,['00a63d17af3c82727b9119acb00fccfcf6639fc5'],27,36,63,3189277,25,,,,8287
794a642310bc147885bbb6212563b1c2417f3f18,1,Mike Thomsen,2018-06-10 06:45:21-04:00,['cf3c6666835595aaedaf6b7769fe17e018117019'],47,88,135,3189412,4,0,0.92,1,8287
ead3969ab70255a2286cf7bac96693555eb0d126,0,Andy LoPresto,2018-06-10 13:09:13-07:00,['794a642310bc147885bbb6212563b1c2417f3f18'],43,44,87,3189499,41,,,,8287
d02cd4f909c5c58b5606b3636726d872f2a10ce5,0,Kevin Doran,2018-06-10 21:54:25-04:00,['ead3969ab70255a2286cf7bac96693555eb0d126'],1133,5,1138,3190637,2,,,,8287
5a39d2a819ab18ee119b4eb63813f2c5aae2a50d,0,Matthew Burgess,2018-06-10 22:10:12-04:00,['d02cd4f909c5c58b5606b3636726d872f2a10ce5'],1,81,82,3190719,3,0.541666667,0.729166667,1,8287
1803c15bcd552ca05cbb116ed0ffb8a7fe92519a,0,Koji Kawamura,2018-06-11 13:35:01+09:00,['5a39d2a819ab18ee119b4eb63813f2c5aae2a50d'],0,436,436,3191155,4,0.584158416,0.584158416,0.435643564,8290
18a4819d51df3c00523f28f7b120b7e535860e47,0,Pierre Villard,2018-06-11 09:40:38+02:00,['1803c15bcd552ca05cbb116ed0ffb8a7fe92519a'],0,4,4,3191159,2,0,0.75,0,8290
e3b0949b6b92d154f96b709ad219408c54b28ee4,1,joewitt,2018-06-11 10:27:28-04:00,['18a4819d51df3c00523f28f7b120b7e535860e47'],64,350,414,3191573,7,0.238095238,0.785714286,0.666666667,8290
946c2fe6b3a094026c5d376676c67e7684bd18ee,1,joewitt,2018-06-11 10:49:41-04:00,['e3b0949b6b92d154f96b709ad219408c54b28ee4'],4,3688,3692,3195265,21,0.269756098,0.772195122,0.785853659,8305
ee18ead16c7b0697560e27c63cf1dd06b1c38c4f,0,Mike Thomsen,2018-06-11 18:48:38-04:00,['946c2fe6b3a094026c5d376676c67e7684bd18ee'],4,6,10,3195275,2,0,1,1,8305
09f926003521ce33eb441edb2fe6c5942059e98b,1,zenfenan,2018-06-12 19:04:17+05:18,['ee18ead16c7b0697560e27c63cf1dd06b1c38c4f'],3,10,13,3195288,3,0.666666667,0.666666667,1,8305
8feac9ae54f84fbc86f957732e193e91726ea785,1,Bryan Bende,2018-06-12 12:50:37-04:00,['09f926003521ce33eb441edb2fe6c5942059e98b'],2,8,10,3195298,1,1,1,1,8305
da99f873a7d2f636465efd86178e578da75674a0,1,Bryan Bende,2018-06-13 14:32:58-04:00,['8feac9ae54f84fbc86f957732e193e91726ea785'],52,8587,8639,3203937,50,0.300405631,0.675733715,0.789310427,8348
275b8cbf231f2c41aa2d79d69d8abf6dbaabd278,0,Matt Gilman,2018-06-13 16:00:01-04:00,['da99f873a7d2f636465efd86178e578da75674a0'],23,9,32,3203969,1,1,0,0,8348
dbf259508c2b8e176d8cb837177aaadbf44f0670,1,Andy LoPresto,2018-06-13 16:13:53-07:00,['275b8cbf231f2c41aa2d79d69d8abf6dbaabd278'],40,84,124,3204093,3,0,1,1,8348
0831059d2caca366b208df72d3160ee825f78c98,1,Koji Kawamura,2018-06-14 10:54:44+09:00,['dbf259508c2b8e176d8cb837177aaadbf44f0670'],14,127,141,3204234,5,0.513888889,0.986111111,0.986111111,8348
4349a8e07873e44dccfd42ca33b2a9b25587bc3c,0,Mike Thomsen,2018-06-14 07:02:47-04:00,['0831059d2caca366b208df72d3160ee825f78c98'],5,5,10,3204244,2,,,,8348
8370a56dce0432e01fe2ad5d4a712c0fde081b0e,0,Mike Thomsen,2018-06-14 07:09:23-04:00,['4349a8e07873e44dccfd42ca33b2a9b25587bc3c'],1,1,2,3204246,1,,,,8348
d98d335497b20a0ad16934495d423d2129cd1c79,0,Mark Payne,2018-06-14 10:10:45-04:00,['8370a56dce0432e01fe2ad5d4a712c0fde081b0e'],10,32,42,3204288,1,0.777777778,0.888888889,1,8348
e27798797a19837ea05ccfa05c2169dd15f30276,1,Matt Gilman,2018-06-14 10:59:17-04:00,['d98d335497b20a0ad16934495d423d2129cd1c79'],113,475,588,3204876,21,0.804020101,0.768844221,0.979899497,8350
fe31a06fdc4c76b94f47194d87f5a811b06e8f88,0,Matt Gilman,2018-06-14 12:21:47-04:00,['e27798797a19837ea05ccfa05c2169dd15f30276'],106,88,194,3205070,9,0.064516129,0,0.096774194,8350
d0499eb8675250ed0b0b19581d66796130f95d0d,0,Matt Gilman,2018-06-14 13:24:27-04:00,['fe31a06fdc4c76b94f47194d87f5a811b06e8f88'],13,19,32,3205102,1,0,1,0.166666667,8350
be31c1efd3020c25fedd22aa6868e9801e8006a2,1,Jeff Storck,2018-06-14 15:29:39-04:00,['d0499eb8675250ed0b0b19581d66796130f95d0d'],21,403,424,3205526,11,,,,8356
be63378a1e2d822103427aaac74599f8125f5ebb,1,Koji Kawamura,2018-06-15 15:18:03+09:00,['be31c1efd3020c25fedd22aa6868e9801e8006a2'],15,1640,1655,3207181,36,0.4,0.4,0.83902439,8372
37523989430e51da95c921e4cda7865d34721352,1,Pierre Villard,2018-06-15 13:49:13+02:00,['be63378a1e2d822103427aaac74599f8125f5ebb'],39,251,290,3207471,8,0.344262295,0.918032787,0.959016393,8372
90b8e7f9ff8f8674ec7747c58b547c8499eb4574,0,Pierre Villard,2018-06-15 13:52:33+02:00,['37523989430e51da95c921e4cda7865d34721352'],34,0,34,3207505,4,0,0,0,8372
0886dcb0b4b66712fe94d6ecbb1377d807e862a0,0,Pierre Villard,2018-06-15 13:56:52+02:00,['90b8e7f9ff8f8674ec7747c58b547c8499eb4574'],0,10,10,3207515,1,0,0,1,8372
2277b9411e5ef7974a96b743bc14e0a94ba319f1,1,Pierre Villard,2018-06-15 14:29:56+02:00,['0886dcb0b4b66712fe94d6ecbb1377d807e862a0'],0,38,38,3207553,2,0.19047619,0,1,8372
f05c5e6ea0b48783f425ad25ecc80bacfe096314,0,Matt Gilman,2018-06-15 08:48:46-04:00,['2277b9411e5ef7974a96b743bc14e0a94ba319f1'],8,83,91,3207644,2,0,0,1,8372
52d6b9cfa218e52e037a43d94b413953d7a63c00,1,Matt Gilman,2018-06-15 09:14:30-04:00,['f05c5e6ea0b48783f425ad25ecc80bacfe096314'],139,1183,1322,3208966,22,0.433566434,0.867132867,0.832167832,8381
9b461027a4e9940f7ade40e9169fc926f9289eca,0,Matthew Burgess,2018-06-15 09:52:14-04:00,['52d6b9cfa218e52e037a43d94b413953d7a63c00'],61,34,95,3209061,3,0.192307692,0.846153846,0,8381
187417d0772d8c08c7efb04c7a0dfda31b20d607,1,Matthew Burgess,2018-06-15 15:48:16-04:00,['9b461027a4e9940f7ade40e9169fc926f9289eca'],56,230,286,3209347,2,0.694444444,0.962962963,0.851851852,8381
97f71fd6c72d7053ecf13d4c58be56f04fa2064d,1,Pierre Villard,2018-06-15 22:42:59+02:00,['187417d0772d8c08c7efb04c7a0dfda31b20d607'],61,256,317,3209664,2,0.704918033,0.967213115,0.868852459,8381
021ee6faf21bd553e742640d6cc3a58b8cdc798d,1,Pierre Villard,2018-06-18 10:45:56+02:00,['97f71fd6c72d7053ecf13d4c58be56f04fa2064d'],8,13,21,3209685,2,1,1,0,8381
e5322b5d336b3285964e49320096f69fb323cb24,0,zenfenan,2018-06-18 18:23:12+05:18,['021ee6faf21bd553e742640d6cc3a58b8cdc798d'],0,290,290,3209975,4,0.835051546,1,0.845360825,8383
2fb213d26c554445c7df0c4b6e5c669200b831e3,0,Matthew Burgess,2018-06-18 09:14:25-04:00,['e5322b5d336b3285964e49320096f69fb323cb24'],2,7,9,3209984,1,1,1,1,8383
568959baf50626cb8954fab19901590024aba755,1,Bryan Bende,2018-06-18 09:33:42-04:00,['2fb213d26c554445c7df0c4b6e5c669200b831e3'],0,1536,1536,3211520,11,0.249732047,0.41693462,0.814576635,8392
d4d925966416a449ccb1aac0296e2eed7e8b43e1,1,Matthew Burgess,2018-06-18 12:00:30-04:00,['568959baf50626cb8954fab19901590024aba755'],1,36,37,3211557,2,0.7,0.7,1,8392
0b0ba1eae366475da3687a94d7c96719bef6ee8d,0,Andy LoPresto,2018-06-18 15:37:05-07:00,['d4d925966416a449ccb1aac0296e2eed7e8b43e1'],54,58,112,3211669,9,0,0,1,8392
aa339891923e933098460aa76353d525db6a6509,1,Andy LoPresto,2018-06-18 17:59:28-07:00,['0b0ba1eae366475da3687a94d7c96719bef6ee8d'],84,173,257,3211926,7,0.637931034,1,0.344827586,8392
8996b7f6d6f9aeead067681fe69cba5a7e1f0482,0,Bryan Bende,2018-06-19 13:27:47-04:00,['aa339891923e933098460aa76353d525db6a6509'],41,644,685,3212611,5,,,,8394
2760b077700d31ea4a4b11c8769341cdd00e2453,1,Matthew Burgess,2018-06-19 16:01:33-04:00,['8996b7f6d6f9aeead067681fe69cba5a7e1f0482'],3,43,46,3212657,3,0,0.8,0.633333333,8394
235463af7b24914271fc6e2d0263f23d3ea15843,0,Matthew Burgess,2018-06-19 16:12:52-04:00,['2760b077700d31ea4a4b11c8769341cdd00e2453'],1,32,33,3212690,2,1,1,1,8394
b068f0ae6f66edab74212aa1790087f80768d7c0,0,Andy LoPresto,2018-06-19 14:28:08-07:00,['235463af7b24914271fc6e2d0263f23d3ea15843'],6,0,6,3212696,1,,,,8394
99bcd1f88dc826f857ae4ab33e842110bfc6ce21,0,Andy LoPresto,2018-06-19 20:02:01-07:00,['b068f0ae6f66edab74212aa1790087f80768d7c0'],1267,1257,2524,3215220,394,,,,8394
d42a1e8bf44c70c148aef79e5540f49c1fd00de2,0,Andy LoPresto,2018-06-19 20:02:21-07:00,['99bcd1f88dc826f857ae4ab33e842110bfc6ce21'],1251,1251,2502,3217722,394,,,,8394
a64680bfa56eeec17aeba805cb9990d6a6b84270,1,Bryan Bende,2018-06-21 12:38:41-04:00,['b068f0ae6f66edab74212aa1790087f80768d7c0'],1,983,984,3218706,15,0.658291457,0.909547739,1,8403
241bc2aa8927ec3e4483598f4b2ed9fd464689c3,0,Matthew Burgess,2018-06-21 14:46:41-04:00,['a64680bfa56eeec17aeba805cb9990d6a6b84270'],87,87,174,3218880,7,0,0,0,8403
ea9b0db2f620526c8dd0db595cf8b44c3ef835be,0,Andy LoPresto,2018-06-25 12:03:00-07:00,"['241bc2aa8927ec3e4483598f4b2ed9fd464689c3', 'd42a1e8bf44c70c148aef79e5540f49c1fd00de2']",1266,1256,2522,3221402,394,,,,8403
ffcff8bfb539dd0cdbab755e6dddf15ab9d1ff05,0,Andy LoPresto,2018-06-25 12:06:57-07:00,['ea9b0db2f620526c8dd0db595cf8b44c3ef835be'],2,2,4,3221406,2,,,,8403
0721d9a0ee5eda2fbc7fb1925060f1217f92b887,0,Matthew Burgess,2018-06-25 15:18:17-04:00,['ffcff8bfb539dd0cdbab755e6dddf15ab9d1ff05'],1,1,2,3221408,2,,,,8403
9af61d3a2d81f2809eee83694b2ed901ddb72009,0,Mike Thomsen,2018-06-25 20:59:48-04:00,['0721d9a0ee5eda2fbc7fb1925060f1217f92b887'],6,6,12,3221420,1,,,,8403
a274918dc54a60d6a88b4f97110abb6bcc9a2427,1,Andy LoPresto,2018-06-25 18:22:55-07:00,['9af61d3a2d81f2809eee83694b2ed901ddb72009'],27,30,57,3221477,1,1,1,0,8403
921403ff558a7922210db6107ff33dff4c879483,0,Mike Thomsen,2018-06-26 05:33:07-04:00,['a274918dc54a60d6a88b4f97110abb6bcc9a2427'],0,4,4,3221481,1,,,,8403
022b64be08f1c9a178f0fb917402c10bc7f4ec9b,1,zenfenan,2018-06-28 22:01:23+05:18,['921403ff558a7922210db6107ff33dff4c879483'],6,146,152,3221633,5,0.357142857,0.880952381,0.880952381,8405
3be08b7e495ea55593e5687fe21f48d3b89e10ea,0,zenfenan,2018-06-28 22:27:45+05:18,['022b64be08f1c9a178f0fb917402c10bc7f4ec9b'],2,2,4,3221637,1,,,,8405
e741ba1ce4bf1ec8ecdf9aea1e0040deda430775,0,Pierre Villard,2018-06-29 14:51:59+02:00,['3be08b7e495ea55593e5687fe21f48d3b89e10ea'],30,261,291,3221928,5,0.048192771,0.993975904,1,8405
6508c191bffc855bf9c8d11de06ef1eca3d83d26,0,Pierre Villard,2018-06-29 14:56:24+02:00,['e741ba1ce4bf1ec8ecdf9aea1e0040deda430775'],2,20,22,3221950,2,1,1,1,8405
c1083dfb62185567dca0b3bcd6b1202cd34093dd,1,Pierre Villard,2018-06-29 14:59:27+02:00,['6508c191bffc855bf9c8d11de06ef1eca3d83d26'],4,22,26,3221976,2,0,0,0.4,8405
a14dbc7dbe20d31e919d52e349efbabc73caf19f,1,Pierre Villard,2018-06-29 16:47:55+02:00,['c1083dfb62185567dca0b3bcd6b1202cd34093dd'],1,3,4,3221980,1,,,,8405
3fd45ac4c4155311966f675c6a504d683796b172,0,Yolanda Davis,2018-06-29 23:36:54-04:00,['a14dbc7dbe20d31e919d52e349efbabc73caf19f'],3,16,19,3221999,2,,,,8405
4ea6e6a40e3b28883cb3db075622546978621ccd,0,Mike Thomsen,2018-07-01 21:25:21-04:00,['3fd45ac4c4155311966f675c6a504d683796b172'],0,8,8,3222007,1,0,1,1,8405
7fb931889f37ecec7d14665e58c3332423916b64,0,Mike Thomsen,2018-07-02 06:20:21-04:00,['4ea6e6a40e3b28883cb3db075622546978621ccd'],0,429,429,3222436,3,0.438202247,0.831460674,0.898876404,8407
b549fbb67bddb642d8e23669506ecb15341fa067,0,Pierre Villard,2018-07-02 16:20:20+02:00,['7fb931889f37ecec7d14665e58c3332423916b64'],0,1,1,3222437,1,0,1,1,8407
790102d8b1442731201c19a8614d0aa11334434d,0,Mike Thomsen,2018-07-02 16:03:28-04:00,['b549fbb67bddb642d8e23669506ecb15341fa067'],429,0,429,3222866,3,0.561797753,0.168539326,0.101123596,8407
d4d4ddadee8b7fcba17ea25b008fa75185336efc,0,Matt Gilman,2018-07-02 16:36:07-04:00,['790102d8b1442731201c19a8614d0aa11334434d'],3,7,10,3222876,2,0,0,0,8407
22ec069acb39d59388d4adc4965929cfdba8f36b,0,Matthew Burgess,2018-07-02 21:57:50-04:00,['d4d4ddadee8b7fcba17ea25b008fa75185336efc'],63,663,726,3223602,15,0.317757009,0.887850467,0.855140187,8414
ee86af0c15718a3e3310039ee252ea60f92c5f05,0,Pierre Villard,2018-07-03 10:23:34+02:00,['22ec069acb39d59388d4adc4965929cfdba8f36b'],19,36,55,3223657,2,0.181818182,0.272727273,1,8414
df4931280496dd1540317e4fb392755426690263,1,Pierre Villard,2018-07-03 11:42:35+02:00,['ee86af0c15718a3e3310039ee252ea60f92c5f05'],0,6,6,3223663,3,,,,8414
3164759d7ffb8ba5be360796fd4bfc004f2c79c0,0,Mike Thomsen,2018-07-03 07:51:20-04:00,['df4931280496dd1540317e4fb392755426690263'],9,31,40,3223703,2,1,1,1,8414
d3222b85ab92be19e2f622228ea5f7bc757fc07d,1,Aldrin Piri,2018-07-03 11:40:31-04:00,['3164759d7ffb8ba5be360796fd4bfc004f2c79c0'],2,183,185,3223888,6,,,,8417
f8b1ae6d3fc85f877c1ec77ca275dc42551d14c1,0,Aldrin Piri,2018-07-03 15:26:01-04:00,['d3222b85ab92be19e2f622228ea5f7bc757fc07d'],1,1,2,3223890,1,,,,8417
b77d66889a27ac2e50bd1412f45fe9acb8852aed,0,Andy LoPresto,2018-07-03 18:17:22-07:00,['f8b1ae6d3fc85f877c1ec77ca275dc42551d14c1'],1,116,117,3224007,3,0.526315789,1,0.421052632,8418
3764b77b7ccf6e8edb5eb4ed153adaa285dd5657,0,Mike Thomsen,2018-07-04 19:04:24-04:00,['b77d66889a27ac2e50bd1412f45fe9acb8852aed'],44,59,103,3224110,2,,,,8419
d31a919553c533a7385a5274d15c72a2a82a9c21,1,Mike Thomsen,2018-07-06 21:01:54-04:00,['3764b77b7ccf6e8edb5eb4ed153adaa285dd5657'],1,1,2,3224112,1,,,,8419
8fd8a247d9d504f28f710676b13d795763073bed,0,Mike Thomsen,2018-07-06 21:06:40-04:00,['d31a919553c533a7385a5274d15c72a2a82a9c21'],10,0,10,3224122,1,,,,8419
87f3a99adfd202965643fd524ec0729d38e52f37,0,Mike Thomsen,2018-07-06 21:08:51-04:00,['8fd8a247d9d504f28f710676b13d795763073bed'],1,0,1,3224123,1,,,,8419
a8a0b0d075ccf1d6a71f88a973e6878cec4889e4,0,Mike Thomsen,2018-07-06 21:12:07-04:00,['87f3a99adfd202965643fd524ec0729d38e52f37'],7,7,14,3224137,3,,,,8419
40c4b2c771aaf61292294f59a7bdb9f6d262cb7a,0,Mike Thomsen,2018-07-06 22:05:01-04:00,['a8a0b0d075ccf1d6a71f88a973e6878cec4889e4'],7,7,14,3224151,3,,,,8419
0c5e159ebc0d49cedfc209302a514e9f423298fd,0,Mike Thomsen,2018-07-07 07:26:21-04:00,['40c4b2c771aaf61292294f59a7bdb9f6d262cb7a'],2,2,4,3224155,1,,,,8419
d50e3f17471e4ade3373b9e95e5c6a8e364248a6,1,Mike Thomsen,2018-07-07 07:56:53-04:00,['0c5e159ebc0d49cedfc209302a514e9f423298fd'],3,33,36,3224191,2,0.947368421,0.947368421,1,8419
46014bc96298080ff7ce4736e69b08d0d66d8e67,0,Mike Thomsen,2018-07-08 07:23:19-04:00,['d50e3f17471e4ade3373b9e95e5c6a8e364248a6'],1,2,3,3224194,1,,,,8419
a3a2cbcfc1437a418b604f24327ff83d829c9fbc,0,Matthew Burgess,2018-07-09 11:40:29-04:00,['46014bc96298080ff7ce4736e69b08d0d66d8e67'],22,0,22,3224216,1,,,,8419
0ff85180686d9f5cdf66e615215f62178980749e,0,Matthew Burgess,2018-07-09 11:51:15-04:00,['a3a2cbcfc1437a418b604f24327ff83d829c9fbc'],0,43,43,3224259,1,,,,8420
1e75f8c78908546fe287e8f8d3c03524f5e58e8f,1,Matthew Burgess,2018-07-09 12:15:23-04:00,['0ff85180686d9f5cdf66e615215f62178980749e'],5,16,21,3224280,3,0,0,1,8420
12e384b4be1a186e7e5bb3cf2ebe58124d3c56b5,0,Matthew Burgess,2018-07-09 12:24:02-04:00,['1e75f8c78908546fe287e8f8d3c03524f5e58e8f'],0,58,58,3224338,1,,,,8421
382653654652ac6677b6171a48018f648952428b,1,Matthew Burgess,2018-07-09 13:36:45-04:00,['12e384b4be1a186e7e5bb3cf2ebe58124d3c56b5'],44,234,278,3224616,4,0,0.633663366,1,8421
f60585a9b6df6b3b28be1eb80a0a60deac6c0493,1,Andy LoPresto,2018-07-09 20:45:34-07:00,['382653654652ac6677b6171a48018f648952428b'],830,783,1613,3226229,98,0,1,1,8421
19636978f9a2fe3a1d5e4e046c60d6ede530a25b,0,Pierre Villard,2018-07-10 09:35:30+02:00,['f60585a9b6df6b3b28be1eb80a0a60deac6c0493'],5,71,76,3226305,2,0,0.916666667,1,8421
275789f8cade60dfe217056297769927063ca65f,0,Pierre Villard,2018-07-10 09:51:52+02:00,['19636978f9a2fe3a1d5e4e046c60d6ede530a25b'],35,36,71,3226376,1,0,0,1,8421
3ef8b4ab8d732af9af4fbdb9d6df407af6481993,0,Mark Payne,2018-07-10 08:45:33-04:00,['275789f8cade60dfe217056297769927063ca65f'],28,18,46,3226422,3,1,0,0,8421
0d07bc495118889aaf28a8d4bcb7e32796c99b99,0,Matt Gilman,2018-07-10 09:57:13-04:00,['3ef8b4ab8d732af9af4fbdb9d6df407af6481993'],1,1,2,3226424,1,,,,8421
35bfc939011f5289eb65949c41f61fdea1d1b1fa,1,Matt Gilman,2018-07-10 09:57:13-04:00,['0d07bc495118889aaf28a8d4bcb7e32796c99b99'],56,27,83,3226507,3,0.708333333,0.791666667,0,8421
23c3bb886c4b10cf39ae1da85ce4fd31816501f4,0,joewitt,2018-07-10 10:56:15-04:00,['35bfc939011f5289eb65949c41f61fdea1d1b1fa'],0,0,0,3226507,0,,,,8421
b27962439826bef1f7a1f026c6bf65c47c1c1f5d,1,Mark Payne,2018-07-10 11:23:40-04:00,['23c3bb886c4b10cf39ae1da85ce4fd31816501f4'],31,82,113,3226620,11,0,0,1,8421
e94f0757db617c649ae054d7c914feade9e1185e,0,Matt Gilman,2018-07-10 11:44:00-04:00,['b27962439826bef1f7a1f026c6bf65c47c1c1f5d'],27,1882,1909,3228529,12,0.094086022,0.994623656,0.994623656,8424
624bbab8f06cf8e49c6229d8a2473a429548fcac,0,Matthew Burgess,2018-07-10 12:56:53-04:00,['e94f0757db617c649ae054d7c914feade9e1185e'],1,67,68,3228597,3,0.131578947,0.868421053,1,8424
bef91008bb86de9b541fbe1fd82ed37eef1784d5,0,Andy LoPresto,2018-07-10 11:15:07-07:00,['624bbab8f06cf8e49c6229d8a2473a429548fcac'],0,10,10,3228607,1,,,,8424
e13602f752144e13969f7a08f0b476c61f6edac9,0,Matthew Burgess,2018-07-10 15:30:07-04:00,['bef91008bb86de9b541fbe1fd82ed37eef1784d5'],4,5,9,3228616,2,,,,8424
0dd4a91a6741eec04965a260c8aff38b72b3828d,0,Matthew Burgess,2018-07-10 19:03:14-04:00,['e13602f752144e13969f7a08f0b476c61f6edac9'],4,65,69,3228685,3,0.131578947,0.973684211,0.947368421,8424
eaef91fabb0eb9bcead624fe60d312b47be70451,0,Matthew Burgess,2018-07-10 20:38:16-04:00,['0dd4a91a6741eec04965a260c8aff38b72b3828d'],2,2,4,3228689,1,,,,8424
4dd3495c7724657273d5d1ea32b3179a4c318e44,0,James Wing,2018-07-10 21:26:18-07:00,['eaef91fabb0eb9bcead624fe60d312b47be70451'],2,2,4,3228693,2,,,,8424
ffbff42421c285400f4425206490faba07036946,0,Matthew Burgess,2018-07-13 09:57:50-04:00,['4dd3495c7724657273d5d1ea32b3179a4c318e44'],2,2,4,3228697,1,,,,8424
31bb89514cfa0e5df9db578387d566c7b5117c45,0,Mark Payne,2018-07-13 13:54:27-04:00,['ffbff42421c285400f4425206490faba07036946'],102,62,164,3228861,2,0.166666667,0.166666667,1,8424
ec7f1316021841a67303a56218eb61d5828eda2e,1,Matt Gilman,2018-07-16 10:14:31-04:00,['31bb89514cfa0e5df9db578387d566c7b5117c45'],2,141,143,3229004,8,0.632653061,1,0.734693878,8425
b10220439cfddd876e01f1a2279b33552e47c7ac,1,Bryan Bende,2018-07-16 11:50:55-04:00,['ec7f1316021841a67303a56218eb61d5828eda2e'],373,1290,1663,3230667,41,0.439189189,1,0.918918919,8439
b191f6a62a717cb37a318e1a4180aa5ebcaae29e,0,Bryan Bende,2018-07-16 15:29:06-04:00,['b10220439cfddd876e01f1a2279b33552e47c7ac'],0,119,119,3230786,5,0.972972973,1,1,8441
0a493bf7fdac5b16225e6e692d2a03e095765f7a,1,Bryan Bende,2018-07-17 13:40:47-04:00,['b191f6a62a717cb37a318e1a4180aa5ebcaae29e'],0,517,517,3231303,5,0.431472081,1,0.923857868,8445
8b9d4461185848fd552a639ac14b7926164d5426,1,Mark Payne,2018-07-17 13:59:57-04:00,['0a493bf7fdac5b16225e6e692d2a03e095765f7a'],41,705,746,3232049,11,0.37694704,0.660436137,0.604361371,8447
3746ae258d619c38d763c580f1acb6521c6c3bc5,1,Andy LoPresto,2018-07-17 14:42:37-07:00,['8b9d4461185848fd552a639ac14b7926164d5426'],23,101,124,3232173,5,1,1,0.5,8447
d126743d93f6d754774b0d3074f3464e01430eda,0,Mike Thomsen,2018-07-17 19:58:33-04:00,['3746ae258d619c38d763c580f1acb6521c6c3bc5'],5,45,50,3232223,3,0.875,0.875,1,8448
72a5e6bfba1597f6174223f3afc85de478d49898,1,Pierre Villard,2018-07-18 10:52:13+02:00,['d126743d93f6d754774b0d3074f3464e01430eda'],152,279,431,3232654,4,0,0.602941176,1,8448
461eca0d147b915fd1c806b17e6dff39d585e3f1,0,Pierre Villard,2018-07-18 11:07:31+02:00,['72a5e6bfba1597f6174223f3afc85de478d49898'],8,73,81,3232735,7,0.12,1,1,8448
4e09a03f86b50a8b5b26d00542aabbd48bbc4b9d,0,Pierre Villard,2018-07-18 11:27:51+02:00,['461eca0d147b915fd1c806b17e6dff39d585e3f1'],2,5,7,3232742,1,1,1,1,8448
66783c18b24b1c6b1cfd662c58ca9df1e60b866e,0,Mike Thomsen,2018-07-18 13:50:53-04:00,['4e09a03f86b50a8b5b26d00542aabbd48bbc4b9d'],4,11,15,3232757,2,0,0,0.75,8448
46ce7aaa3298fa32d7f0c6beca9d45c5d43d3180,1,Andy LoPresto,2018-07-18 11:35:55-07:00,['66783c18b24b1c6b1cfd662c58ca9df1e60b866e'],38,78,116,3232873,4,0.571428571,0,1,8448
d139b285640c01a7bfd9f7b5e99b2ce37f8ec913,0,Matthew Burgess,2018-07-23 08:52:57-04:00,['46ce7aaa3298fa32d7f0c6beca9d45c5d43d3180'],0,41,41,3232914,1,,,,8449
c3cad2b38b5bdef2a0a63a880dcdceec7419938f,0,Matthew Burgess,2018-07-23 08:55:36-04:00,['d139b285640c01a7bfd9f7b5e99b2ce37f8ec913'],0,59,59,3232973,1,,,,8450
78d908bc0e4911ccf64501f8cd29a8ad5e9d85e8,0,Matthew Burgess,2018-07-23 09:11:59-04:00,['c3cad2b38b5bdef2a0a63a880dcdceec7419938f'],0,77,77,3233050,1,,,,8451
9a23d5bc60251ad922effc4c3fbab0dc9742491f,0,Andy LoPresto,2018-07-23 18:14:51-07:00,['78d908bc0e4911ccf64501f8cd29a8ad5e9d85e8'],1,1,2,3233052,1,,,,8451
0ad30e188f1b8c39d0598656793d7682f7fc8dd7,1,Mike Moser,2018-07-25 15:21:13+00:00,['9a23d5bc60251ad922effc4c3fbab0dc9742491f'],19,406,425,3233477,3,,,,8453
692943f016b19a5b8ff915c5921194081418e9ea,0,Pierre Villard,2018-07-26 14:13:14+02:00,['0ad30e188f1b8c39d0598656793d7682f7fc8dd7'],6,45,51,3233528,2,1,1,1,8453
4baf35db5ba296d246e3491e8d8c84408306f685,0,zenfenan,2018-07-26 21:52:49+05:18,['692943f016b19a5b8ff915c5921194081418e9ea'],7,7,14,3233542,7,,,,8453
610cbb66b2e644a782f4714e749da932131d4d9d,0,zenfenan,2018-07-26 23:08:13+05:18,['4baf35db5ba296d246e3491e8d8c84408306f685'],5,0,5,3233547,1,,,,8453
b1f78d58a6f5250b4f4e6873b03459a8e987407a,0,zenfenan,2018-07-26 23:22:12+05:18,['610cbb66b2e644a782f4714e749da932131d4d9d'],1,29,30,3233577,2,0.875,0.875,1,8453
473221368c75d371cbabf7e68b0bfb62fbe56c00,1,Mark Payne,2018-07-27 09:13:50-04:00,['b1f78d58a6f5250b4f4e6873b03459a8e987407a'],16,49,65,3233642,5,0.125,0.208333333,0,8453
56dfcc2cd60e751d163d8bc403846c37f7dee4b9,0,Aldrin Piri,2018-07-27 14:38:18-04:00,['473221368c75d371cbabf7e68b0bfb62fbe56c00'],12,30,42,3233684,2,,,,8453
44face10bf9837308587dc1d46326e4a5764435f,1,Pierre Villard,2018-07-30 23:28:46+02:00,['56dfcc2cd60e751d163d8bc403846c37f7dee4b9'],11,13,24,3233708,5,1,0,0,8453
e97ae921f759e51ee1709ef0884fc029bd40d26b,0,Matthew Burgess,2018-07-30 19:04:19-04:00,['44face10bf9837308587dc1d46326e4a5764435f'],2,2,4,3233712,1,,,,8453
9742dd2fac42d4afb8b1e009535ed50c02373493,0,Pierre Villard,2018-07-31 10:14:27+02:00,['e97ae921f759e51ee1709ef0884fc029bd40d26b'],4,18,22,3233734,5,1,1,0.666666667,8453
e62aa0252dfcf34dff0c3a9c51265b1d0f9dfc9f,1,Matt Gilman,2018-08-01 12:10:14-04:00,['9742dd2fac42d4afb8b1e009535ed50c02373493'],89,192,281,3234015,9,0.954545455,0.954545455,0.272727273,8454
b4894c5572fd81713de57d866e13bd72130c5157,0,Matt Gilman,2018-08-01 13:42:31-04:00,['e62aa0252dfcf34dff0c3a9c51265b1d0f9dfc9f'],11,16,27,3234042,3,0,0,0,8454
8309747889c3187005a0ce4e4c0c11b1e3281e10,1,Mike Moser,2018-08-01 20:11:40+00:00,['b4894c5572fd81713de57d866e13bd72130c5157'],4,6,10,3234052,1,0,0,0,8454
4cca9bef7c9bcad912cb7df6f3976715d09a6daf,0,Jeremy Dyer,2018-08-01 19:33:56-04:00,['b4894c5572fd81713de57d866e13bd72130c5157'],122,130,252,3234304,8,0.75,0.75,0,8454
b7fe04257d10ab7bf9df2661260d731ce92a223a,1,Andrew I. Christianson,2018-08-02 09:44:14-04:00,['4cca9bef7c9bcad912cb7df6f3976715d09a6daf'],23,180,203,3234507,12,,,,8456
5e6c43f83ed818308bdd04d84037bdce6d13206a,0,Andy LoPresto,2018-08-02 20:55:39-07:00,['b7fe04257d10ab7bf9df2661260d731ce92a223a'],1,274,275,3234782,2,,,,8456
3d546b8d87178ad84a76734938aa1eecccb8c38a,0,Matt Gilman,2018-08-03 10:36:56-04:00,['5e6c43f83ed818308bdd04d84037bdce6d13206a'],8,96,104,3234886,4,0.824561404,0.824561404,1,8456
d1ab17580fe02766318e4a2d0ee5a76b0742d137,0,Mark Payne,2018-08-06 10:33:24-04:00,['3d546b8d87178ad84a76734938aa1eecccb8c38a'],0,6,6,3234892,1,0,0,1,8456
9ee2316ff676acc413f28f86e8d9924947cb63ea,1,Mark Payne,2018-08-06 14:33:49-04:00,['d1ab17580fe02766318e4a2d0ee5a76b0742d137'],11,167,178,3235070,3,0,0.67961165,0.67961165,8457
a19134f32560ae044cb898a7654ada31338e20c2,0,Mike Moser,2018-08-06 21:02:29+00:00,['9ee2316ff676acc413f28f86e8d9924947cb63ea'],1,1,2,3235072,1,,,,8457
8106af699c4dba21c03b1d8ba6c3e702dc7b1380,1,Andy LoPresto,2018-08-06 19:57:49-07:00,['a19134f32560ae044cb898a7654ada31338e20c2'],127,326,453,3235525,6,1,1,0,8457
57baae9ae28f63877e66cbc178cdd127a82d4841,1,Andy LoPresto,2018-08-07 12:07:35-07:00,['8106af699c4dba21c03b1d8ba6c3e702dc7b1380'],31,709,740,3236265,10,0.26744186,0.488372093,1,8460
9a79c94f809a29ebb5c36ccca8a680f1875af1f2,1,Aldrin Piri,2018-08-08 09:57:22-04:00,['57baae9ae28f63877e66cbc178cdd127a82d4841'],28,76,104,3236369,4,,,,8460
451084e11f8c3dc2a0c68ffb739dff58de479cff,0,zenfenan,2018-08-08 21:54:50+05:18,['9a79c94f809a29ebb5c36ccca8a680f1875af1f2'],10,316,326,3236695,3,0.07079646,0.725663717,0.902654867,8461
32ee552ada328ed1189ed2bd0a2af18ed213ddc8,1,zenfenan,2018-08-09 22:29:50+05:18,['451084e11f8c3dc2a0c68ffb739dff58de479cff'],24,87,111,3236806,2,0.054054054,0.702702703,1,8461
3731cc855849c6bc971909f561be56138f13d182,0,zenfenan,2018-08-09 22:45:23+05:18,['32ee552ada328ed1189ed2bd0a2af18ed213ddc8'],8,13,21,3236827,1,,,,8461
17ea29244ec6f481a8c90ee922230d9ee33e1044,1,Pierre Villard,2018-08-10 20:17:28+02:00,['3731cc855849c6bc971909f561be56138f13d182'],0,507,507,3237334,4,0.458333333,1,1,8464
86beca0c58231174c33a532daed085b1752c3304,1,zenfenan,2018-08-13 14:51:41+05:18,['17ea29244ec6f481a8c90ee922230d9ee33e1044'],516,622,1138,3238472,1,,,,8464
59a79c134f1def152ae17c0d0b4dd7218a0c7f87,0,Matt Gilman,2018-08-13 11:40:59-04:00,['86beca0c58231174c33a532daed085b1752c3304'],40,40,80,3238552,2,,,,8464
5106dc0af96d93bcd978c66d27c0164ec7cd4f20,0,Matt Gilman,2018-08-13 12:46:16-04:00,['59a79c134f1def152ae17c0d0b4dd7218a0c7f87'],1,11,12,3238564,1,0,0,1,8464
66eeb48802317cdff69fe83070d26dac7245294a,1,Mike Moser,2018-08-14 16:37:35+00:00,['5106dc0af96d93bcd978c66d27c0164ec7cd4f20'],4,139,143,3238707,2,0.083333333,0.930555556,0.958333333,8464
c2657ee0439c9453a30ce3b49b944d5b870c75ea,0,Mike Thomsen,2018-08-15 11:01:51-04:00,['5106dc0af96d93bcd978c66d27c0164ec7cd4f20'],379,1,380,3239087,48,,,,8464
9d2b698c1cdfb54411b9f147573767bdda6e355c,0,Mike Thomsen,2018-08-15 21:35:09-04:00,['c2657ee0439c9453a30ce3b49b944d5b870c75ea'],1,1,2,3239089,1,,,,8464
410176ed226b4db44b08c13b9f70bb70107e73e4,1,Mark Payne,2018-08-16 14:22:27-04:00,['9d2b698c1cdfb54411b9f147573767bdda6e355c'],1,22,23,3239112,2,1,1,1,8464
7bbb5a823aa3d338cecf45bd683f9f34a1338d02,1,Mark Payne,2018-08-21 11:44:25-04:00,['410176ed226b4db44b08c13b9f70bb70107e73e4'],607,1589,2196,3241308,38,0.605577689,0.828685259,1,8473
82c5126f3c94fd075bd5bb7bcef187c3507faaea,0,Pierre Villard,2018-08-22 13:04:21+02:00,['7bbb5a823aa3d338cecf45bd683f9f34a1338d02'],2,4,6,3241314,2,,,,8473
5b57935baebc3bbf99035afcf17b870655d1ec5e,1,Mark Payne,2018-08-22 10:51:47-04:00,['82c5126f3c94fd075bd5bb7bcef187c3507faaea'],40,44,84,3241398,1,,,,8473
744b15b4a7a7533ef81fc2333df0cd212c3779eb,1,Bryan Bende,2018-08-22 13:56:16-04:00,['5b57935baebc3bbf99035afcf17b870655d1ec5e'],7,637,644,3242042,6,0.710843373,0.602409639,0.987951807,8474
aac2c6a60ed1ffd574f0c3386fc29c2c3b8092c1,1,Andy LoPresto,2018-08-23 16:49:55-07:00,['744b15b4a7a7533ef81fc2333df0cd212c3779eb'],61,67,128,3242170,4,,,,8474
cfc858c901b82eb6fba60a844cb370e1b59aaa77,0,Pierre Villard,2018-08-24 11:09:05+02:00,['aac2c6a60ed1ffd574f0c3386fc29c2c3b8092c1'],7,47,54,3242224,3,0,0.76,0.76,8474
8c0705cb6bb0a937f992adc7a5078fa4483a54d9,0,Brandon Devries,2018-08-24 10:07:11-04:00,['cfc858c901b82eb6fba60a844cb370e1b59aaa77'],209,247,456,3242680,1,0,0,0.826086957,8474
6ceee2585998b105926484b871bc6a4d7913f609,0,Pierre Villard,2018-08-27 16:52:07+02:00,['8c0705cb6bb0a937f992adc7a5078fa4483a54d9'],0,4,4,3242684,1,1,1,1,8474
58cb900b904be7e37b22d9811e4fb00e5992d9a3,0,Matt Gilman,2018-08-27 11:04:07-04:00,['6ceee2585998b105926484b871bc6a4d7913f609'],2,2,4,3242688,1,,,,8474
a27ccd8a56fb52a61d79f87711324142a5b4a141,0,Koji Kawamura,2018-08-28 15:28:11+09:00,['58cb900b904be7e37b22d9811e4fb00e5992d9a3'],11,19,30,3242718,5,0,1,0,8474
f04cd8681d3532f9c8f2eb7306962056a287e2ad,1,Koji Kawamura,2018-08-28 15:28:30+09:00,['a27ccd8a56fb52a61d79f87711324142a5b4a141'],2,7,9,3242727,2,1,1,1,8474
53969adcc8a68185447b4e3546d634663e74c6f0,1,Mark Payne,2018-08-28 14:32:27-04:00,['f04cd8681d3532f9c8f2eb7306962056a287e2ad'],0,2803,2803,3245530,59,0.340819022,0.826948481,0.960369881,8531
8a8a8cb072c458a0cea458ae026a2e5ffebccfaf,0,Pierre Villard,2018-08-29 13:22:10+02:00,['53969adcc8a68185447b4e3546d634663e74c6f0'],38,81,119,3245649,2,0,0.689655172,1,8531
e83ea1f9ae6e32ccaa07e1c49c82b1bb3df0d79c,0,Andy LoPresto,2018-08-29 14:52:07-07:00,['8a8a8cb072c458a0cea458ae026a2e5ffebccfaf'],2,3,5,3245654,1,,,,8531
860663ae3e2d2da0b725c66d96aeeab146c0a43c,0,Andy LoPresto,2018-08-29 15:07:22-07:00,['e83ea1f9ae6e32ccaa07e1c49c82b1bb3df0d79c'],6,43,49,3245703,2,,,,8532
c755ed9322c7362a99524e5a816f5b1407c291c4,0,zenfenan,2018-08-30 09:31:44+05:18,['860663ae3e2d2da0b725c66d96aeeab146c0a43c'],2,6,8,3245711,2,,,,8532
89186fb96d0bd1367f234d36f8c45e130e6aad4b,0,Mike Thomsen,2018-08-30 07:08:00-04:00,['c755ed9322c7362a99524e5a816f5b1407c291c4'],6,18,24,3245735,4,1,1,1,8532
cbd942df10440405927f80bc71040f6218610ebc,0,Andy LoPresto,2018-08-30 11:30:10-07:00,['89186fb96d0bd1367f234d36f8c45e130e6aad4b'],47,242,289,3246024,4,0.352941176,0.901960784,1,8533
c9267347edf6664a65317cfe4498d190ac9e7a28,0,Andy LoPresto,2018-08-30 12:15:44-07:00,['cbd942df10440405927f80bc71040f6218610ebc'],793,8,801,3246825,4,0.9,0.55,0,8533
8f37b5ee10650fb36a4ea85f8ff817e4b745c45c,0,Andy LoPresto,2018-08-30 13:05:09-07:00,['c9267347edf6664a65317cfe4498d190ac9e7a28'],3,0,3,3246828,1,,,,8533
cdae2b14b3ec596887585f921a9490ded737b345,0,Koji Kawamura,2018-08-31 20:28:00+09:00,['8f37b5ee10650fb36a4ea85f8ff817e4b745c45c'],6,83,89,3246917,5,0,1,1,8533
5a58c9a1715df1da32f053ac8af5c73c593a569e,1,Matt Gilman,2018-08-31 11:07:09-04:00,['cdae2b14b3ec596887585f921a9490ded737b345'],106,181,287,3247204,15,1,1,1,8534
97e0f6a6a700e425bf9fd39711da78dda74b87c9,0,Andy LoPresto,2018-08-31 10:35:21-07:00,['5a58c9a1715df1da32f053ac8af5c73c593a569e'],8,11,19,3247223,1,,,,8534
05e32cff28b44fcfc6504dc22fe6972d8f79b7eb,1,Mike Thomsen,2018-08-31 15:32:44-04:00,['97e0f6a6a700e425bf9fd39711da78dda74b87c9'],120,129,249,3247472,2,1,1,0,8534
1b73578c48d66f6bab7b90f49cbe837a4d7169c0,0,Mike Thomsen,2018-08-31 19:09:58-04:00,['05e32cff28b44fcfc6504dc22fe6972d8f79b7eb'],2,2,4,3247476,2,,,,8534
3efcd45e99e481784c6dc8c60cbc9bcc15394ea1,0,Mike Thomsen,2018-09-01 07:32:32-04:00,['1b73578c48d66f6bab7b90f49cbe837a4d7169c0'],0,1,1,3247477,1,,,,8534
4f0e2f5562eef793f2d0df3d314e186332f8d207,1,Pierre Villard,2018-09-05 15:04:29+02:00,['3efcd45e99e481784c6dc8c60cbc9bcc15394ea1'],1,1,2,3247479,1,,,,8534
fc1461298a0a137d0fae3cd3b494fc6dec25070a,0,Andy LoPresto,2018-09-05 17:38:53-07:00,['4f0e2f5562eef793f2d0df3d314e186332f8d207'],0,144,144,3247623,4,0.9,0.9,0.7,8536
57820d0d8894aa76b9540e66d485e09bd33e711e,0,zenfenan,2018-09-09 12:21:34+05:18,['fc1461298a0a137d0fae3cd3b494fc6dec25070a'],4,67,71,3247694,6,0,0.85,1,8536
87cf474e542ef16601a86cc66c624fb8902c9fc2,1,Matt Gilman,2018-09-10 09:43:53-04:00,['57820d0d8894aa76b9540e66d485e09bd33e711e'],32,32,64,3247758,1,1,0,0,8536
0274bd4ff3f4199838ff1307c9c01d98fcc9150b,1,Matthew Burgess,2018-09-11 11:07:33-04:00,['87cf474e542ef16601a86cc66c624fb8902c9fc2'],167,93,260,3248018,2,0.295454545,0.295454545,0,8536
7e8b7752ca8ef03498e76ad2a07b51b195f219ed,0,Pierre Villard,2018-09-11 18:09:48+02:00,['0274bd4ff3f4199838ff1307c9c01d98fcc9150b'],21,11,32,3248050,4,1,1,0,8536
e0f7f244b81a2ca0900c93117bb9b971c59ea14d,0,Mike Thomsen,2018-09-12 17:46:43-04:00,['7e8b7752ca8ef03498e76ad2a07b51b195f219ed'],2,5,7,3248057,1,,,,8536
647152ab1628ee2817a2d494ad86774eb1824d94,0,Bryan Bende,2018-09-14 09:52:39-04:00,['e0f7f244b81a2ca0900c93117bb9b971c59ea14d'],0,2,2,3248059,1,,,,8536
14729be837109af9fe986d61a0b3abcb2288672a,0,Mark Payne,2018-09-14 11:33:53-04:00,['647152ab1628ee2817a2d494ad86774eb1824d94'],34,7,41,3248100,1,1,1,1,8536
4a25402c1af7e51b1a7bf61f185dc58b5c40e90b,0,Mark Payne,2018-09-14 11:37:18-04:00,['14729be837109af9fe986d61a0b3abcb2288672a'],13,86,99,3248199,2,0,0.902439024,1,8536
57ae9b65a0fd9f9f0880331debabbd75e64e1c40,1,Mike Thomsen,2018-09-14 13:30:03-04:00,['4a25402c1af7e51b1a7bf61f185dc58b5c40e90b'],53,140,193,3248392,1,1,1,0.851851852,8536
5a84d650c3a35b6d48d662c47e10fd2fc733f89b,0,Mike Thomsen,2018-09-14 14:04:25-04:00,['57ae9b65a0fd9f9f0880331debabbd75e64e1c40'],0,251,251,3248643,5,0.205607477,0.925233645,0.925233645,8538
c8fc1327eea046b03f47180334eeeb603bc4ea39,0,Pierre Villard,2018-09-15 14:49:24+02:00,['5a84d650c3a35b6d48d662c47e10fd2fc733f89b'],128,140,268,3248911,2,0,0,0,8538
07ad132a2bded79e7b08019ad683388eac1604d5,0,Mike Thomsen,2018-09-17 12:52:17-04:00,['c8fc1327eea046b03f47180334eeeb603bc4ea39'],2,46,48,3248959,3,,,,8538
cd6877404b8f9eee151815dd1451c18cc79e707c,0,Andy LoPresto,2018-09-17 17:03:57-07:00,['07ad132a2bded79e7b08019ad683388eac1604d5'],38,2087,2125,3251084,16,0.767123288,0.880136986,0.869863014,8546
7e627f2fed9652440578c407516a51285228445c,0,Andy LoPresto,2018-09-17 17:12:53-07:00,['cd6877404b8f9eee151815dd1451c18cc79e707c'],0,57,57,3251141,1,,,,8546
c56a7e9ba5808ead129d462c369e73c710dd3145,0,Mike Thomsen,2018-09-18 08:10:14-04:00,['7e627f2fed9652440578c407516a51285228445c'],46,591,637,3251778,8,0.365853659,0.764227642,0.853658537,8549
1dea8faa06fc954f6ee7e27082d25b63b65c231e,1,zenfenan,2018-09-19 16:52:25+05:18,['c56a7e9ba5808ead129d462c369e73c710dd3145'],523,427,950,3252728,16,0.602564103,0.256410256,0.294871795,8549
0da4f50ea03eaf887981de6d654ea9eb6532cd32,1,Pierre Villard,2018-09-19 15:50:08+02:00,['1dea8faa06fc954f6ee7e27082d25b63b65c231e'],15,6765,6780,3259508,35,0.314795009,0.713368984,0.771479501,8582
ad80f5f064a2895390bdff77278162a1fba68543,1,Matthew Burgess,2018-09-19 12:56:58-04:00,['0da4f50ea03eaf887981de6d654ea9eb6532cd32'],0,290,290,3259798,3,0.409836066,0.409836066,1,8584
9161b1787a57f158107653aa4cecc0f0b4f98499,0,Mike Thomsen,2018-09-19 13:15:41-04:00,['ad80f5f064a2895390bdff77278162a1fba68543'],0,1252,1252,3261050,15,0.469230769,0.874358974,0.68974359,8597
f570cb980ddbb8292044ba3ff30304ed157dc839,1,Matt Gilman,2018-09-19 15:28:41-04:00,['9161b1787a57f158107653aa4cecc0f0b4f98499'],607,2513,3120,3264170,63,0.320936639,1,0.450413223,8611
3dd548e807c80749a99f83e18857cab879cd9c21,0,Matthew Burgess,2018-09-19 16:56:42-04:00,['f570cb980ddbb8292044ba3ff30304ed157dc839'],1,23,24,3264194,1,0,1,1,8611
854ee3021c3e8ac0d8eaa6dfe5848ef6de341fbb,0,zenfenan,2018-09-20 14:21:23+05:18,['3dd548e807c80749a99f83e18857cab879cd9c21'],3,3,6,3264200,1,,,,8611
8cf0662e5b0ab99f49d7ffb12ca06516a0bf8632,0,Pierre Villard,2018-09-20 12:07:43+02:00,['854ee3021c3e8ac0d8eaa6dfe5848ef6de341fbb'],0,6,6,3264206,3,0,0,1,8611
73a7c8c6b4b5d3a774c0937b31ec6d2536c0b483,0,Pierre Villard,2018-09-20 13:55:13+02:00,['8cf0662e5b0ab99f49d7ffb12ca06516a0bf8632'],10,12,22,3264228,2,1,1,1,8611
2ee0af9663d56b5c0d709d77c83cda4ba2f75ade,0,Mike Thomsen,2018-09-20 08:17:52-04:00,['73a7c8c6b4b5d3a774c0937b31ec6d2536c0b483'],12,14,26,3264254,4,1,0,0,8611
be2ed060a29228424ee647fd617ff0e1010dc25e,1,Kevin Doran,2018-09-20 10:27:28-04:00,['2ee0af9663d56b5c0d709d77c83cda4ba2f75ade'],3,129,132,3264386,4,0,0.097222222,0.583333333,8611
f5e9ea680a0f3247759defc84c7e61331b2a47f3,0,Pierre Villard,2018-09-21 11:03:36+02:00,['be2ed060a29228424ee647fd617ff0e1010dc25e'],20,26,46,3264432,1,,,,8611
2a964681eca443cc335b6f269d2b9ddab57250c7,1,Pierre Villard,2018-09-24 22:36:02+02:00,['f5e9ea680a0f3247759defc84c7e61331b2a47f3'],53,121,174,3264606,4,0.34,0.34,1,8611
c4d3b5e94f80b3973e18a49007a5e51728c62d74,0,zenfenan,2018-09-25 12:07:54+05:18,['2a964681eca443cc335b6f269d2b9ddab57250c7'],3,59,62,3264668,2,0.368421053,0.368421053,1,8611
4b4c9e14cb06928fb72cc883fd7c8551e6e8f01c,0,Pierre Villard,2018-09-25 12:24:17+02:00,['c4d3b5e94f80b3973e18a49007a5e51728c62d74'],3,14,17,3264685,1,1,1,1,8611
030129c7ceacfd4e32db5dc1d00d6c86c8c3aaa7,0,Pierre Villard,2018-09-25 12:28:58+02:00,['4b4c9e14cb06928fb72cc883fd7c8551e6e8f01c'],2,5,7,3264692,1,0,0,1,8611
78c4e223fcaf78a819e04f8b6fa6541bfff2782f,1,Mike Thomsen,2018-09-25 09:25:13-04:00,['030129c7ceacfd4e32db5dc1d00d6c86c8c3aaa7'],2,117,119,3264811,4,0.125,0.604166667,0.9375,8612
5d3558a79d83defb4dd7484da3303cb04013cc6c,1,Mark Payne,2018-09-25 14:07:00-04:00,['78c4e223fcaf78a819e04f8b6fa6541bfff2782f'],1,32,33,3264844,2,0,0.125,1,8612
db645ec475416b77018fcae0d25e5b5dfd801b15,0,Pierre Villard,2018-09-25 23:07:24+02:00,['5d3558a79d83defb4dd7484da3303cb04013cc6c'],1,11,12,3264856,1,,,,8612
db023f368bbdc22ecb48ac5bca2ae2ed92317596,0,Pierre Villard,2018-09-25 23:47:51+02:00,['db645ec475416b77018fcae0d25e5b5dfd801b15'],0,0,0,3264856,0,,,,8612
ca70dbbb364996f3314df77c43d09e8e5c49a95a,0,Pierre Villard,2018-09-26 13:05:22+02:00,['db023f368bbdc22ecb48ac5bca2ae2ed92317596'],0,0,0,3264856,0,,,,8612
ad4c886fbf2af2bc98ebe12200c4b119df67b90f,0,Matt Gilman,2018-09-27 10:11:15-04:00,['ca70dbbb364996f3314df77c43d09e8e5c49a95a'],2,91,93,3264949,2,0,0.878787879,1,8612
2e1005e884cef70ea9c2eb1152d70e546ad2b5c3,0,Matthew Burgess,2018-09-27 15:38:47-04:00,['ad4c886fbf2af2bc98ebe12200c4b119df67b90f'],122,241,363,3265312,7,0.944444444,0.944444444,0.805555556,8613
0f55cbfb9f49087492a333c59b63e146a1444d55,0,Jeff Storck,2018-09-27 16:24:31-04:00,['2e1005e884cef70ea9c2eb1152d70e546ad2b5c3'],0,33,33,3265345,1,0.421052632,0.421052632,0.578947368,8613
e24388aa7f23f056ec93b3205dd501514806672e,0,Jeff Storck,2018-09-27 16:24:31-04:00,['0f55cbfb9f49087492a333c59b63e146a1444d55'],46,63,109,3265454,1,0,1,1,8613
0dd382370bf139e0f8c1b22761e4aa306943dd77,1,Matthew Burgess,2018-09-28 13:46:04-04:00,['e24388aa7f23f056ec93b3205dd501514806672e'],28,293,321,3265775,4,0.377777778,0.874074074,0.896296296,8615
748cf745628dab20b7e71f12b5dcfe6ed0bbf134,1,Matt Gilman,2018-09-28 14:34:03-04:00,['0dd382370bf139e0f8c1b22761e4aa306943dd77'],37,197,234,3266009,2,1,1,0.923076923,8616
b1478cdb195722d7d285cad53d1f89c325868f55,1,Matthew Burgess,2018-10-01 10:48:45-04:00,['748cf745628dab20b7e71f12b5dcfe6ed0bbf134'],184,979,1163,3267172,13,0.425,0.8375,1,8624
813cc1f6a25417c47eafd409089c7d2dec7ac12a,0,Mike Thomsen,2018-10-01 10:57:58-04:00,['b1478cdb195722d7d285cad53d1f89c325868f55'],0,20,20,3267192,2,,,,8624
4f538f1ecb8e73859e8875bff10ab18971897180,0,Brandon Devries,2018-10-02 09:39:17-04:00,['66eeb48802317cdff69fe83070d26dac7245294a'],1,5,6,3267198,1,,,,8624
895323f3c2ab8541a663ba35ed98209c256f7c12,0,Brandon Devries,2018-10-02 09:40:36-04:00,"['813cc1f6a25417c47eafd409089c7d2dec7ac12a', '4f538f1ecb8e73859e8875bff10ab18971897180']",5,144,149,3267347,3,,,,8624
76a9f98d7f43b0b23c7360a2d21ee81f5d19309e,0,Brandon Devries,2018-10-02 11:06:51-04:00,['8309747889c3187005a0ce4e4c0c11b1e3281e10'],1,1,2,3267349,1,,,,8624
b4c8e0179bc4b4e196eac15c7478fed784ee2bdc,0,Brandon Devries,2018-10-02 11:08:43-04:00,"['895323f3c2ab8541a663ba35ed98209c256f7c12', '76a9f98d7f43b0b23c7360a2d21ee81f5d19309e']",4,6,10,3267359,1,,,,8624
de685a7a741888c6ffd6468d89b536276975934c,0,Kevin Doran,2018-10-03 11:12:19-04:00,['b4c8e0179bc4b4e196eac15c7478fed784ee2bdc'],9,53,62,3267421,3,0.774193548,0.774193548,1,8624
8e233ca2ef55b2100174ee2b32a8668e9190a85c,1,Matt Gilman,2018-10-04 09:32:04-04:00,['de685a7a741888c6ffd6468d89b536276975934c'],226,237,463,3267884,100,1,0.5,0,8624
f65286be83f03258964cdec9395c4148c29ec8f8,1,Matt Gilman,2018-10-04 09:50:09-04:00,['8e233ca2ef55b2100174ee2b32a8668e9190a85c'],638,283,921,3268805,87,1,1,1,8649
8f4d13eeacc0bb1bd159ecb8fedf71eda5ea15a9,1,Matt Gilman,2018-10-04 10:25:42-04:00,['f65286be83f03258964cdec9395c4148c29ec8f8'],51,50,101,3268906,7,0,1,1,8649
5872eb3c4a060684a88555f1c697f07bec4c26dd,0,Brandon Devries,2018-10-04 15:25:53-04:00,['8f4d13eeacc0bb1bd159ecb8fedf71eda5ea15a9'],17,35,52,3268958,4,0.272727273,0.272727273,1,8650
619f1ffe8fbbca61bc5545f13920190a77006e08,1,Jeff Storck,2018-10-04 16:11:05-04:00,['5872eb3c4a060684a88555f1c697f07bec4c26dd'],2646,14489,17135,3286093,143,0.335811034,0.690617773,0.877436406,8729
b4810b8dd76cae6272a0e9fc2c2cff2eddb80c8b,0,Mark Payne,2018-10-05 12:08:55-04:00,['619f1ffe8fbbca61bc5545f13920190a77006e08'],0,0,0,3286093,0,,,,8729
c6572f042bf1637f6faaa2b2ffe4a56e297c6d1a,1,Pierre Villard,2018-10-06 10:53:11+02:00,['b4810b8dd76cae6272a0e9fc2c2cff2eddb80c8b'],783,3261,4044,3290137,15,0.162861492,0.905631659,0.917808219,8738
246c090526143943557b15868db6e8fe3fb30cf6,1,Andy LoPresto,2018-10-06 16:24:17-07:00,['c6572f042bf1637f6faaa2b2ffe4a56e297c6d1a'],0,16,16,3290153,1,1,1,1,8738
768bcfb5092fb240adbe528103c06d7796a709bc,1,Mike Moser,2018-10-07 17:21:01-04:00,['246c090526143943557b15868db6e8fe3fb30cf6'],8,18,26,3290179,2,0,1,1,8738
c87d791938562de04ee598ebffa296f954130ca7,0,Koji Kawamura,2018-10-09 21:14:31+09:00,['768bcfb5092fb240adbe528103c06d7796a709bc'],2,12,14,3290193,1,0,0,1,8738
c425bd2880dc2c45c96e0dfcc4990f1e20e14d0a,1,Matthew Burgess,2018-10-09 09:18:02-04:00,['c87d791938562de04ee598ebffa296f954130ca7'],226,828,1054,3291247,21,0.389880952,0.404761905,0.818452381,8740
117e60c8e338fb78db2e7014042834f541720136,0,Mark Payne,2018-10-09 12:23:44-04:00,['c425bd2880dc2c45c96e0dfcc4990f1e20e14d0a'],0,0,0,3291247,0,,,,8740
77edddd98828157d7f495c5b0ea667a0c36e96cc,1,Matt Gilman,2018-10-09 14:14:48-04:00,['117e60c8e338fb78db2e7014042834f541720136'],42,80,122,3291369,23,,,,8740
9dfc6683eef93290f118ccf6bc2b93f6370bddc5,1,Matt Gilman,2018-10-09 15:24:43-04:00,['77edddd98828157d7f495c5b0ea667a0c36e96cc'],15,20,35,3291404,2,1,1,1,8740
dd50322749aa667beb0dc16b2535a7aa1da1ca73,0,Pierre Villard,2018-10-10 09:32:54+02:00,['9dfc6683eef93290f118ccf6bc2b93f6370bddc5'],165,181,346,3291750,2,0,0.777777778,0.888888889,8740
fc5c8baeb3c0e2fbed2cefd11752c40aa06e5783,0,Pierre Villard,2018-10-10 09:38:06+02:00,['dd50322749aa667beb0dc16b2535a7aa1da1ca73'],1,6,7,3291757,1,0,1,1,8740
6c17685cbee059c479b0cdfbfaa50ec613b78575,1,Pierre Villard,2018-10-10 09:44:00+02:00,['fc5c8baeb3c0e2fbed2cefd11752c40aa06e5783'],22,28,50,3291807,1,0,1,1,8740
83ca67649263bd5451807c446e03fa02a2429410,0,Pierre Villard,2018-10-11 11:47:39+02:00,['6c17685cbee059c479b0cdfbfaa50ec613b78575'],5,5,10,3291817,1,0,1,1,8740
04d8da8f46c26bd829c4411ea92692589d93278a,1,Mark Payne,2018-10-11 09:23:00-04:00,['83ca67649263bd5451807c446e03fa02a2429410'],44,1299,1343,3293160,43,0.677932406,0.765407555,0.815109344,8754
be2c24cfaf00f74ba9dfa1b5cf04aa43ee818afb,1,Mark Payne,2018-10-11 09:23:00-04:00,['04d8da8f46c26bd829c4411ea92692589d93278a'],51,101,152,3293312,4,0,0,0.902439024,8754
01e2098d242f45f519bee0572de3c86cc7837645,1,Mark Payne,2018-10-11 09:23:01-04:00,['be2c24cfaf00f74ba9dfa1b5cf04aa43ee818afb'],62,527,589,3293901,23,0.685714286,1,1,8758
a1a4c997634aa7edabda42407a0a7627d33e73fd,0,Mark Payne,2018-10-11 09:23:01-04:00,['01e2098d242f45f519bee0572de3c86cc7837645'],10,24,34,3293935,4,0,1,1,8758
97afa4e7bab53f707c8299adaab9cb30a8777dd5,0,Mark Payne,2018-10-11 09:52:16-04:00,['a1a4c997634aa7edabda42407a0a7627d33e73fd'],10,14,24,3293959,1,0,1,1,8758
a6f722222a7fa31fef06a465efe506fd0a773eec,1,Matt Gilman,2018-10-11 10:05:26-04:00,['97afa4e7bab53f707c8299adaab9cb30a8777dd5'],23,76,99,3294058,2,0.466666667,0,1,8758
8a751e80183d46febd7abc6e66b72342ca5a5f38,0,Matt Gilman,2018-10-11 11:36:28-04:00,['a6f722222a7fa31fef06a465efe506fd0a773eec'],46,341,387,3294445,8,0.306666667,0.593333333,0.98,8758
64de5c70e19ae0e608a61f2f978661585140b777,0,Matt Gilman,2018-10-11 12:11:44-04:00,['8a751e80183d46febd7abc6e66b72342ca5a5f38'],0,3,3,3294448,1,,,,8758
79c03caf4f57a1273cbe5856ec7b6fc007f00a3e,0,Matt Gilman,2018-10-11 12:23:53-04:00,['64de5c70e19ae0e608a61f2f978661585140b777'],39,23,62,3294510,4,1,0.625,0.1875,8758
8da403ce9e8135ea7fc86fa7eb308ad5dda9dabd,0,Matt Gilman,2018-10-11 13:21:20-04:00,['79c03caf4f57a1273cbe5856ec7b6fc007f00a3e'],1,13,14,3294524,1,0,1,1,8758
8398ea77bc2cb15068ebba37dd8f7f270befe308,0,Matt Gilman,2018-10-11 15:06:06-04:00,['8da403ce9e8135ea7fc86fa7eb308ad5dda9dabd'],0,1,1,3294525,1,0,1,1,8758
c81a135161c7af106117dcc616706798c4564669,1,Mark Payne,2018-10-11 15:41:19-04:00,['8398ea77bc2cb15068ebba37dd8f7f270befe308'],140,392,532,3295057,3,0.436046512,1,0,8758
5aa426358802bfac91657fdb8a8a83094239ced8,0,Mark Payne,2018-10-11 15:41:38-04:00,['c81a135161c7af106117dcc616706798c4564669'],227,223,450,3295507,2,1,0,1,8758
a6b9364ebf649679a739bfe4988899c4d9186f76,0,Mike Thomsen,2018-10-12 06:28:56-04:00,['5aa426358802bfac91657fdb8a8a83094239ced8'],0,18,18,3295525,2,0.666666667,0.666666667,0.666666667,8758
6b77e7dd895affa739c55a7db969fa6bcde44ad1,0,joewitt,2018-10-12 11:08:22-04:00,['a6b9364ebf649679a739bfe4988899c4d9186f76'],1,1,2,3295527,1,,,,8758
e25b26e9cf860db038da8e23e8e64bdb1b8dba88,0,joewitt,2018-10-12 11:27:48-04:00,['6b77e7dd895affa739c55a7db969fa6bcde44ad1'],87,24,111,3295638,2,0.945945946,0.297297297,0,8758
0f8880547fad35243dae0d4d4ab6d8a5eb38d516,1,Aldrin Piri,2018-10-12 13:19:43-04:00,['e25b26e9cf860db038da8e23e8e64bdb1b8dba88'],0,46,46,3295684,2,,,,8758
02e0a16a681bea3a2bee6a90aa87baed2404a25e,1,Mark Payne,2018-10-12 14:18:42-04:00,['0f8880547fad35243dae0d4d4ab6d8a5eb38d516'],2,229,231,3295915,8,0.31496063,0.535433071,0.921259843,8759
5eb5e96b1621d87bf8cca96d18a2c36177a1f54e,0,Matt Gilman,2018-10-12 15:56:52-04:00,['02e0a16a681bea3a2bee6a90aa87baed2404a25e'],3,90,93,3296008,13,,,,8759
270ce8570df7a00a26f431d8d8ae0245b898bf69,1,Bryan Bende,2018-10-12 16:26:59-04:00,['5eb5e96b1621d87bf8cca96d18a2c36177a1f54e'],24,63,87,3296095,2,0.5,1,0.5,8759
e30a21cfc5e8bed187ec18e35ab0f21e6a16fb71,0,Aldrin Piri,2018-10-13 05:53:30-04:00,['270ce8570df7a00a26f431d8d8ae0245b898bf69'],1,1,2,3296097,1,,,,8759
0229a5c10953b0b003e3613e4a172a1641c6452d,1,Koji Kawamura,2018-10-15 10:27:15+09:00,['e30a21cfc5e8bed187ec18e35ab0f21e6a16fb71'],5,34,39,3296136,1,0.833333333,1,1,8759
7cb39d636c33289a1f93417c1750ef6173df348e,0,Koji Kawamura,2018-10-15 10:43:31+09:00,['0229a5c10953b0b003e3613e4a172a1641c6452d'],2,4,6,3296142,2,1,1,0,8759
ce25ae54196a318cbfcdb4dfe178607f4ac135c6,1,Bryan Bende,2018-10-15 10:10:47-04:00,['7cb39d636c33289a1f93417c1750ef6173df348e'],348,419,767,3296909,7,1,1,1,8760
d5f071b2fe5240d4face9b7c8582ba45fd668294,1,Mark Payne,2018-10-15 13:14:31-04:00,['ce25ae54196a318cbfcdb4dfe178607f4ac135c6'],142,497,639,3297548,3,0.179824561,0.964912281,0.307017544,8760
f55204cb69d065b8cedddaaa82c5e6e87e651c83,0,Matt Gilman,2018-10-15 13:52:49-04:00,['d5f071b2fe5240d4face9b7c8582ba45fd668294'],3,3,6,3297554,3,,,,8760
218063a0b57c609cbc30276907c0c254d88c699c,0,Mark Payne,2018-10-15 14:33:21-04:00,['f55204cb69d065b8cedddaaa82c5e6e87e651c83'],13,32,45,3297599,2,0,0.368421053,1,8760
32db43b3069b3c982b9c96576c11b447c229b360,0,Matthew Burgess,2018-10-15 15:21:05-04:00,['218063a0b57c609cbc30276907c0c254d88c699c'],137,130,267,3297866,5,1,1,0,8760
11afb0115e0dac3092a02e9c5fb3997e79704113,0,joewitt,2018-10-15 16:43:05-04:00,['32db43b3069b3c982b9c96576c11b447c229b360'],248,7,255,3298121,3,,,,8760
fd5eccc593b97ec3c836d870adde079cd78b374c,1,Jeff Storck,2018-10-15 18:02:14-04:00,['11afb0115e0dac3092a02e9c5fb3997e79704113'],27,65,92,3298213,8,,,,8767
11fd67cd1eff774a7df7a2d7a55b995fb9611582,0,Bryan Bende,2018-10-16 14:59:27-04:00,['fd5eccc593b97ec3c836d870adde079cd78b374c'],1,19,20,3298233,6,1,0,1,8767
4d21f9b34eb254014ba1e4a997417236c914fd08,1,Matt Gilman,2018-10-16 15:25:29-04:00,['11fd67cd1eff774a7df7a2d7a55b995fb9611582'],8,86,94,3298327,5,0.28125,0.25,0.84375,8768
51ed618cf02b56fcb1683f6e4f6069a70e8e5ca6,0,Matthew Burgess,2018-10-16 15:38:32-04:00,['4d21f9b34eb254014ba1e4a997417236c914fd08'],1,2,3,3298330,1,,,,8768
4039c21d6746b624618487a1209813c776620741,0,Jeff Storck,2018-10-16 21:00:38-04:00,['51ed618cf02b56fcb1683f6e4f6069a70e8e5ca6'],11,68,79,3298409,11,,,,8775
87c6b3aa7c44ab71612f77e190e56152bfada61f,0,Kevin Doran,2018-10-17 10:33:53-04:00,['4039c21d6746b624618487a1209813c776620741'],5,9,14,3298423,5,,,,8775
95e42946738fb4875e66ef80755d1a668df45954,1,Mark Payne,2018-10-17 10:57:53-04:00,['87c6b3aa7c44ab71612f77e190e56152bfada61f'],119,27,146,3298569,1,0.970149254,0.970149254,0,8775
d6422e2d2caf855125583455e3c97496e66cc964,1,Mark Payne,2018-10-17 10:57:57-04:00,['95e42946738fb4875e66ef80755d1a668df45954'],27,14,41,3298610,1,,,,8775
c752ec8394ed8906009759161fb8da08ea32251c,0,Matt Gilman,2018-10-17 12:24:32-04:00,['d6422e2d2caf855125583455e3c97496e66cc964'],1,7,8,3298618,3,,,,8775
5ec85299e78331fbdfe03b536c040e2e26bbdf61,1,Jeff Storck,2018-10-17 15:29:11-04:00,['c752ec8394ed8906009759161fb8da08ea32251c'],2,31,33,3298651,1,,,,8775
f3f7cdbab9248ba13c00d0e27a398e820e9ec7ed,1,Koji Kawamura,2018-10-18 14:37:55+09:00,['5ec85299e78331fbdfe03b536c040e2e26bbdf61'],0,85,85,3298736,2,0.015384615,0.830769231,1,8775
ec8afd18d6ae39dc1b09698fabfd1d3e7eaa70cf,1,Koji Kawamura,2018-10-18 15:09:23+09:00,['f3f7cdbab9248ba13c00d0e27a398e820e9ec7ed'],1,2,3,3298739,1,,,,8775
08c54bc48d14d559ce38970ecde0b9583ecc96a5,0,Jeff Storck,2018-10-20 17:50:24-04:00,['ec8afd18d6ae39dc1b09698fabfd1d3e7eaa70cf'],11,8,19,3298758,1,,,,8775
5561c29ed3b8c635f499582e983a5147cb06e306,0,Matthew Burgess,2018-10-22 12:22:05-04:00,['08c54bc48d14d559ce38970ecde0b9583ecc96a5'],1,1,2,3298760,1,,,,8775
ebaaf5797e94d7177633cf4e85f0fbeada0765ba,0,Aldrin Piri,2018-10-22 15:13:14-04:00,['5561c29ed3b8c635f499582e983a5147cb06e306'],213,181,394,3299154,9,0,1,0,8775
4fe7cb33e460e506b0ea66b38f621ecf84700e5c,0,Bryan Bende,2018-10-22 15:19:06-04:00,['ebaaf5797e94d7177633cf4e85f0fbeada0765ba'],0,1,1,3299155,1,,,,8775
c6106d1d885598dcc16dd0420112f6624e5685da,0,Matthew Burgess,2018-10-22 16:58:36-04:00,['4fe7cb33e460e506b0ea66b38f621ecf84700e5c'],6,12,18,3299173,2,0,1,1,8775
02261311b3b3f765ebb394f8f101b0373a7fb3ab,0,Jeff Storck,2018-10-22 20:02:47-04:00,['c6106d1d885598dcc16dd0420112f6624e5685da'],122,31,153,3299326,63,1,0.3,0,8775
98aabf2c50f857efc72fd6f2bfdd9965b97fa195,0,Jeff Storck,2018-10-22 22:16:23-04:00,['02261311b3b3f765ebb394f8f101b0373a7fb3ab'],1318,1311,2629,3301955,405,,,,8775
c0182294ed914b9bc5fbeb4ff2b084b246e454ca,0,Jeff Storck,2018-10-22 22:16:43-04:00,['98aabf2c50f857efc72fd6f2bfdd9965b97fa195'],1304,1304,2608,3304563,405,,,,8775
e45584d0fb8e19f6913fb25a8db3ce8303b73cd0,1,Bryan Bende,2018-10-23 14:08:07-04:00,['02261311b3b3f765ebb394f8f101b0373a7fb3ab'],161,871,1032,3305595,11,0.302238806,0.97761194,0.914179104,8781
c8928ce3509facbf4b6501295273849de2288fab,0,Matthew Burgess,2018-10-23 14:46:14-04:00,['e45584d0fb8e19f6913fb25a8db3ce8303b73cd0'],1,7,8,3305603,1,0,0,1,8781
10479a5a2af4a3e53ef3d3f8f71e84122965fbf2,0,Matthew Burgess,2018-10-23 15:26:33-04:00,['c8928ce3509facbf4b6501295273849de2288fab'],7,11,18,3305621,1,0,1,1,8781
ebead820f9d9ac7d629bd099791acf4dcd95e13f,0,Bryan Bende,2018-10-23 16:17:25-04:00,['10479a5a2af4a3e53ef3d3f8f71e84122965fbf2'],70,94,164,3305785,5,0,1,0.157894737,8781
d28b1172db974cb1bd6aeba479b7655ce89c42db,0,Pierre Villard,2018-10-24 09:26:41+02:00,['ebead820f9d9ac7d629bd099791acf4dcd95e13f'],19,61,80,3305865,2,0.846153846,0.846153846,1,8781
2201f7746fd16874aefbd12d546565f5d105ab04,0,Matthew Burgess,2018-10-24 13:33:30-04:00,['d28b1172db974cb1bd6aeba479b7655ce89c42db'],26,174,200,3306065,8,0,0.973684211,1,8781
c7ff2fc5dba7c8aaeae07f4819c320e2a96555f0,1,Koji Kawamura,2018-10-26 10:24:12+09:00,['2201f7746fd16874aefbd12d546565f5d105ab04'],36,43,79,3306144,9,1,0,0,8781
234ddb0fe1a36ad947c340114058d82c777d791f,0,Koji Kawamura,2018-10-26 16:04:46+09:00,['c7ff2fc5dba7c8aaeae07f4819c320e2a96555f0'],2,18,20,3306164,4,0.833333333,1,0.833333333,8781
fdbcf34281bf6ee71f4f5ba6b9445254bc874752,1,Koji Kawamura,2018-10-26 17:08:17+09:00,['234ddb0fe1a36ad947c340114058d82c777d791f'],3,7,10,3306174,1,0,0,1,8781
e4b702ed4f1e144f8ad667789ac3cddc981803f8,0,Mike Thomsen,2018-10-26 08:57:05-04:00,['fdbcf34281bf6ee71f4f5ba6b9445254bc874752'],1,1,2,3306176,1,,,,8781
4f14e517db122b56da22df050a31ac08216a8305,0,Jeff Storck,2018-10-26 13:56:23-04:00,"['e4b702ed4f1e144f8ad667789ac3cddc981803f8', 'c0182294ed914b9bc5fbeb4ff2b084b246e454ca']",1317,1310,2627,3308803,405,,,,8781
f6d8eada6a1f131345495f00f09729adcaa58cce,0,Jeff Storck,2018-10-26 14:10:45-04:00,['4f14e517db122b56da22df050a31ac08216a8305'],2,2,4,3308807,2,,,,8781
db966cf34879ea0d750ae7ab72344b228f889f59,0,Koji Kawamura,2018-10-30 11:51:17+09:00,['f6d8eada6a1f131345495f00f09729adcaa58cce'],27,56,83,3308890,3,0,1,1,8781
fdb1fd1a64d85caefb6be328d1e169c57b5a9777,0,Scott Aslan,2018-10-30 12:04:29-04:00,['db966cf34879ea0d750ae7ab72344b228f889f59'],60,57,117,3309007,3,,,,8782
1f2cf4bc6128e2a09dcc378bdf66b46302d44754,0,Koji Kawamura,2018-10-31 12:01:16+09:00,['fdb1fd1a64d85caefb6be328d1e169c57b5a9777'],3,41,44,3309051,4,0.777777778,0.777777778,1,8782
4c10b47e602741adc52ad693a9bc56b9964cd7ef,0,Bryan Bende,2018-10-31 15:25:24-04:00,['1f2cf4bc6128e2a09dcc378bdf66b46302d44754'],14,28,42,3309093,3,0,1,1,8782
2a035cc3902f60dff754a1df3c1dbe1571a5d1e1,0,Pierre Villard,2018-11-01 12:56:01+01:00,['4c10b47e602741adc52ad693a9bc56b9964cd7ef'],0,2,2,3309095,1,,,,8782
f0a7dda8423304ac424971b8c2aa54f4f6d5260d,0,Pierre Villard,2018-11-01 13:01:40+01:00,['2a035cc3902f60dff754a1df3c1dbe1571a5d1e1'],1,1,2,3309097,1,,,,8782
bcfd6f0b13ec9bf595652c8cf11be55b63b30ba7,0,Matthew Burgess,2018-11-01 10:58:46-04:00,['f0a7dda8423304ac424971b8c2aa54f4f6d5260d'],32,32,64,3309161,2,,,,8782
89295e52ef33963e97f14e9aa207a93d71acdfb6,1,Matthew Burgess,2018-11-01 11:28:48-04:00,['bcfd6f0b13ec9bf595652c8cf11be55b63b30ba7'],7,9,16,3309177,1,1,1,1,8782
fdd8cdbb31a8977967d4437ba9a09104bf6cf450,1,Mark Payne,2018-11-01 14:41:10-04:00,['89295e52ef33963e97f14e9aa207a93d71acdfb6'],1162,3147,4309,3313486,122,0.249047014,0.733163914,0.687420584,8805
d8d220ccb86d1797f56f34649d70a1acff278eb5,0,patricker,2018-11-01 15:14:29-06:00,['fdd8cdbb31a8977967d4437ba9a09104bf6cf450'],13,47,60,3313546,4,0,0.625,1,8805
2812fe60a2ed486b1a6cb80916e764aa9af10f9b,0,Pierre Villard,2018-11-02 09:46:45+01:00,['d8d220ccb86d1797f56f34649d70a1acff278eb5'],1,91,92,3313638,5,0.463414634,1,0.853658537,8805
0a014dcdb13e30084e6378c14f8c8e5568493c33,1,James Wing,2018-11-03 14:24:21-07:00,['2812fe60a2ed486b1a6cb80916e764aa9af10f9b'],6,7,13,3313651,1,0,0,1,8805
37a0e1b3048b5db067b6485bb437887cb0869888,1,James Wing,2018-11-03 14:26:00-07:00,['0a014dcdb13e30084e6378c14f8c8e5568493c33'],9,23,32,3313683,1,0,0,1,8805
d0688d0785dd7dee0e761975f993bdaf8e374139,0,Koji Kawamura,2018-11-06 15:17:32+09:00,['37a0e1b3048b5db067b6485bb437887cb0869888'],1,3,4,3313687,1,,,,8805
aabb5d7832cbedb54d385db9d75f565ae3043dc7,0,Koji Kawamura,2018-11-06 15:49:03+09:00,['d0688d0785dd7dee0e761975f993bdaf8e374139'],1,1,2,3313689,1,,,,8805
0c9120a73fe99bc4ced50997ee9d65250fb7cf3a,0,Koji Kawamura,2018-11-06 16:20:40+09:00,['aabb5d7832cbedb54d385db9d75f565ae3043dc7'],2,3,5,3313694,1,,,,8805
59e102ad47d676f34bffc5422d3218c71e7c2b65,1,Pierre Villard,2018-11-06 11:23:54+01:00,['0c9120a73fe99bc4ced50997ee9d65250fb7cf3a'],0,1262,1262,3314956,2,,,,8806
931bb0bc3b1c0205b260261ce9730af87204e115,1,Bryan Bende,2018-11-06 11:23:33-05:00,['59e102ad47d676f34bffc5422d3218c71e7c2b65'],3994,4837,8831,3323787,75,1,1,1,8819
4069d755505444b8730fe7f3f4a1a702a281e78c,0,Bryan Bende,2018-11-06 17:55:09-05:00,['931bb0bc3b1c0205b260261ce9730af87204e115'],69,181,250,3324037,6,1,1,0.644444444,8821
da1f9eaf6a82f7cb0b10cf94c708e3b800071972,0,Bryan Bende,2018-11-06 17:55:21-05:00,['4069d755505444b8730fe7f3f4a1a702a281e78c'],1,1,2,3324039,1,,,,8821
13232c74136e8452b3cbd708e535af7a1fc0d1cb,0,Koji Kawamura,2018-11-07 17:16:20+09:00,['da1f9eaf6a82f7cb0b10cf94c708e3b800071972'],51,60,111,3324150,5,0.333333333,0,1,8821
3ba0c0ca82b6bf2eb7d855e2b9025a7a9ccb324c,0,Pierre Villard,2018-11-08 09:27:30+01:00,['13232c74136e8452b3cbd708e535af7a1fc0d1cb'],1,13,14,3324164,2,,,,8821
5cf58b42e0dbed7d25f43c189ce6b07a295c0f20,1,Pierre Villard,2018-11-08 09:32:51+01:00,['3ba0c0ca82b6bf2eb7d855e2b9025a7a9ccb324c'],933,47,980,3325144,2,,,,8821
a9045d54a143dac984c545d0f14627e4151af713,0,Pierre Villard,2018-11-08 09:36:47+01:00,['5cf58b42e0dbed7d25f43c189ce6b07a295c0f20'],6,34,40,3325184,3,1,1,1,8821
78a1cb7c5eb84da5d25d50d0df69970b6d732f0a,1,Pierre Villard,2018-11-08 09:50:45+01:00,['a9045d54a143dac984c545d0f14627e4151af713'],5,41,46,3325230,2,0,1,1,8821
50c0d1ed5d055fbfadbac64e6d0f841d27254371,0,Mark Payne,2018-11-08 16:17:50-05:00,['78a1cb7c5eb84da5d25d50d0df69970b6d732f0a'],2,2,4,3325234,1,,,,8821
49ba3643c7ac9dcce74d28df947393041160aa24,1,Mark Payne,2018-11-08 16:20:28-05:00,['50c0d1ed5d055fbfadbac64e6d0f841d27254371'],2,2,4,3325238,1,,,,8821
d5bce91970b287009dc09d0ce197a537dc0be207,0,Koji Kawamura,2018-11-09 09:41:45+09:00,['49ba3643c7ac9dcce74d28df947393041160aa24'],5,10,15,3325253,5,,,,8821
63f55d05b4f3f83b9e9f2206f4129ae7a4ade569,1,Koji Kawamura,2018-11-09 17:07:27+09:00,['d5bce91970b287009dc09d0ce197a537dc0be207'],4,49,53,3325306,1,0.133333333,0.966666667,1,8821
a628aced6b32b16eb4509094d214266938a915b9,1,Peter Wicks,2018-11-09 11:29:11-07:00,['63f55d05b4f3f83b9e9f2206f4129ae7a4ade569'],1,275,276,3325582,2,0.169491525,1,1,8821
765df6781782d0988e958fb69d9825797a086fe7,1,Mark Payne,2018-11-09 14:50:24-05:00,['a628aced6b32b16eb4509094d214266938a915b9'],402,253,655,3326237,15,0.654320988,0.555555556,0,8821
564ad0cd71e56b426e02757c7a0a70e28ccbea12,1,Peter Wicks,2018-11-09 14:26:20-07:00,['765df6781782d0988e958fb69d9825797a086fe7'],133,549,682,3326919,7,0.81871345,0.760233918,0.707602339,8825
830f7aa84d2f61781422daa43648a09c3a08f392,0,Peter Wicks,2018-11-09 14:27:32-07:00,['564ad0cd71e56b426e02757c7a0a70e28ccbea12'],0,28,28,3326947,1,0,1,1,8825
878a0b8b74e89763ee59106e4f62c19896adafee,0,Pierre Villard,2018-11-10 10:33:40+01:00,['830f7aa84d2f61781422daa43648a09c3a08f392'],2,3,5,3326952,1,,,,8825
08189596d27af7bb4518646245549b480d4bb05a,1,Koji Kawamura,2018-11-12 14:39:27+09:00,['878a0b8b74e89763ee59106e4f62c19896adafee'],31,64,95,3327047,2,0,1,1,8825
d3b16748139efe78373ca22ed116b0c7ed5dbbe3,0,Mark Payne,2018-11-12 09:32:12-05:00,['08189596d27af7bb4518646245549b480d4bb05a'],53,153,206,3327253,4,0.131578947,1,0.842105263,8825
9e7610ac70c389ecfb3a4d389e4e28a41249af2b,0,Koji Kawamura,2018-11-14 13:50:00+09:00,['d3b16748139efe78373ca22ed116b0c7ed5dbbe3'],1,7,8,3327261,1,,,,8825
4112af013d1b1f49e83f881d85ebe66e097840b5,0,Matthew Burgess,2018-11-14 09:45:20-05:00,['9e7610ac70c389ecfb3a4d389e4e28a41249af2b'],27,238,265,3327526,2,0.226950355,0.75177305,1,8825
13011ac6d61961ecd3f3524b1e0dfda382ed4dd6,0,Koji Kawamura,2018-11-15 15:14:57+09:00,['4112af013d1b1f49e83f881d85ebe66e097840b5'],13,2,15,3327541,1,0.25,0.25,0,8825
d319a3ef2f14317f29a1be5a189bc34f8b3fdbd6,1,Matthew Burgess,2018-11-15 10:31:34-05:00,['13011ac6d61961ecd3f3524b1e0dfda382ed4dd6'],2,130,132,3327673,2,0,0,0,8825
76b0065a67c0e3270d44d85e1933c41bfaba8841,0,Bryan Bende,2018-11-15 13:25:33-05:00,['d319a3ef2f14317f29a1be5a189bc34f8b3fdbd6'],5,2,7,3327680,1,0,0,1,8825
be0949570a66f672e128ac97c936df546c7d2521,0,Bryan Bende,2018-11-15 15:01:56-05:00,['76b0065a67c0e3270d44d85e1933c41bfaba8841'],7,38,45,3327725,4,0.833333333,0.833333333,1,8825
75906226a6f265acc7d87414ff477a5b0646b6d8,1,Peter Wicks,2018-11-15 13:18:31-07:00,['be0949570a66f672e128ac97c936df546c7d2521'],3,362,365,3328090,6,0.105932203,0.894067797,1,8825
0207d0813ef164ee7227ded61fb10960a4842e2d,0,Peter Wicks,2018-11-15 13:37:43-07:00,['75906226a6f265acc7d87414ff477a5b0646b6d8'],33,118,151,3328241,2,0,0.653846154,1,8825
102a5288efb2a22cd54815dd7331dfc5826aee91,0,Koji Kawamura,2018-11-16 11:16:55+09:00,['0207d0813ef164ee7227ded61fb10960a4842e2d'],2,2,4,3328245,1,,,,8825
023f0c41cec8aca798f17cb5f9ef13c589db23f8,0,Pierre Villard,2018-11-17 16:36:04+01:00,['102a5288efb2a22cd54815dd7331dfc5826aee91'],1,28,29,3328274,2,0.909090909,0.909090909,0.909090909,8825
54402a1ecda4b11ca10472fada9adce484b031c1,0,Koji Kawamura,2018-11-19 14:18:31+09:00,['023f0c41cec8aca798f17cb5f9ef13c589db23f8'],4,8,12,3328286,1,,,,8825
7bcf9fcb5da4f9b71a65314dd369d786ad032e69,0,Pierre Villard,2018-11-19 11:41:43+01:00,['54402a1ecda4b11ca10472fada9adce484b031c1'],82,70,152,3328438,5,1,0,0.357142857,8825
3c7012ffda777b4692e4ea8db042ee1943a7a66a,0,Peter Wicks,2018-11-20 09:00:46-07:00,['7bcf9fcb5da4f9b71a65314dd369d786ad032e69'],1,55,56,3328494,5,0,0.965517241,1,8825
f6b171d5f76aabf59c1e4644927ab6484be9839a,0,joewitt,2018-11-21 10:02:25-05:00,['3c7012ffda777b4692e4ea8db042ee1943a7a66a'],19,100,119,3328613,2,,,,8825
444caf8a788c8c0a21c45558bb16cd8ee4b42872,1,joewitt,2018-11-21 10:27:41-05:00,['f6b171d5f76aabf59c1e4644927ab6484be9839a'],25,1060,1085,3329698,15,0.463556851,0.711370262,1,8833
03ef6465478eea09704a2b6eb9be16f5001007b9,1,joewitt,2018-11-21 10:28:40-05:00,['444caf8a788c8c0a21c45558bb16cd8ee4b42872'],188,405,593,3330291,9,0.366666667,0.716666667,1,8833
286a1c880a9c640e6918783f2bd8619ad7e71769,1,joewitt,2018-11-21 10:49:22-05:00,['03ef6465478eea09704a2b6eb9be16f5001007b9'],1,7,8,3330299,1,,,,8833
71499f774d5c118c58c38be76283a512005f1e92,0,joewitt,2018-11-21 10:53:38-05:00,['286a1c880a9c640e6918783f2bd8619ad7e71769'],4,23,27,3330326,7,0,0.666666667,0.666666667,8833
2a4745c07770b1c28ab0a4d0fea1be34f74f08cb,0,joewitt,2018-11-21 13:11:06-05:00,['71499f774d5c118c58c38be76283a512005f1e92'],1,1,2,3330328,1,,,,8833
e34d653ba18b3fee7cb4ae72da633f938f8582e4,0,Pierre Villard,2018-11-22 09:33:01+01:00,['2a4745c07770b1c28ab0a4d0fea1be34f74f08cb'],0,4,4,3330332,2,,,,8833
e603c486f49f058d5f37892d172c1d6dddff55c7,1,zenfenan,2018-11-23 14:49:45+05:18,['e34d653ba18b3fee7cb4ae72da633f938f8582e4'],111,602,713,3331045,8,0.247058824,0.247058824,0.823529412,8837
455e3c1bc8d4e12ea75d4e6ac2e4c58cbb535e5d,0,Koji Kawamura,2018-11-27 18:10:26+09:00,['e603c486f49f058d5f37892d172c1d6dddff55c7'],6,179,185,3331230,4,0.049586777,0.73553719,1,8837
98cdb50cc0a72957959188d352b9507d4f85dea1,0,Matthew Burgess,2018-11-28 11:13:17-05:00,['455e3c1bc8d4e12ea75d4e6ac2e4c58cbb535e5d'],2,2,4,3331234,1,,,,8837
68a49cfad04df2f467f9529c0fc1b6daf1781192,1,Koji Kawamura,2018-11-29 09:50:21+09:00,['98cdb50cc0a72957959188d352b9507d4f85dea1'],0,34,34,3331268,3,0,0,0.08,8837
30f2f4205121113c26bb00ac5a8697dffaeb8206,0,Pierre Villard,2018-11-29 10:31:35+01:00,['68a49cfad04df2f467f9529c0fc1b6daf1781192'],3,5,8,3331276,1,0,0,0.5,8837
72662f0b2c5ec5f088aade94337f7edce665ee7e,0,Peter Wicks,2018-11-29 08:16:39-07:00,['30f2f4205121113c26bb00ac5a8697dffaeb8206'],1,1,2,3331278,1,,,,8837
8a12307d1a5269954cc64b6bab73590b15a67444,0,Pierre Villard,2018-11-30 10:54:23+01:00,['72662f0b2c5ec5f088aade94337f7edce665ee7e'],4,6,10,3331288,2,0,0,1,8837
7df537aecaf48b533da5cb6a2e1c26979b82e965,0,Pierre Villard,2018-12-02 13:09:21+01:00,['8a12307d1a5269954cc64b6bab73590b15a67444'],61,2,63,3331351,3,0,0,0,8837
cc9f89b00326af02a2968d3724d8625791278af7,0,Pierre Villard,2018-12-03 10:37:47+01:00,['7df537aecaf48b533da5cb6a2e1c26979b82e965'],1,2,3,3331354,1,,,,8837
986a2a484285a342e20494107abe52ff98ad2880,0,Koji Kawamura,2018-12-05 09:53:52+09:00,['cc9f89b00326af02a2968d3724d8625791278af7'],10,33,43,3331397,2,0.769230769,1,1,8837
6c1c9017e98b8467296bc90746dab73a60cb9c1b,0,Koji Kawamura,2018-12-05 10:09:31+09:00,['986a2a484285a342e20494107abe52ff98ad2880'],1,1,2,3331399,1,,,,8837
8ebb4d19740a3ccb879c03b322b335d02b6b16dc,0,Pierre Villard,2018-12-05 11:29:50+01:00,['6c1c9017e98b8467296bc90746dab73a60cb9c1b'],2,1,3,3331402,1,1,1,0,8837
72ea93a657cd673bfc40ef74e172f5efb950e95d,1,Bryan Bende,2018-12-05 13:01:14-05:00,['8ebb4d19740a3ccb879c03b322b335d02b6b16dc'],96,1032,1128,3332530,2,0.487132353,0.832720588,0.867647059,8837
f1e03b5ed5b53dd909f0e20d8684113120cd73e5,0,Pierre Villard,2018-12-06 22:03:23+01:00,['72ea93a657cd673bfc40ef74e172f5efb950e95d'],14,12,26,3332556,1,0,1,1,8837
84c32f913780d585ba16960c3f23e83313e1bcab,0,Pierre Villard,2018-12-06 23:31:25+01:00,['f1e03b5ed5b53dd909f0e20d8684113120cd73e5'],30,30,60,3332616,1,0,1,1,8837
ecbed6a7828b0edf108f71e4cea77e9c072267d0,0,Pierre Villard,2018-12-07 14:43:54+01:00,['84c32f913780d585ba16960c3f23e83313e1bcab'],1,1,2,3332618,1,,,,8837
e76c54234dc8997e22aa0227f969b5808eccacbf,0,Koji Kawamura,2018-12-10 09:51:46+09:00,['ecbed6a7828b0edf108f71e4cea77e9c072267d0'],2,14,16,3332634,1,0,1,1,8837
60064a9f6874f56bc946dfd71c2568528040de0c,0,Koji Kawamura,2018-12-10 11:00:08+09:00,['e76c54234dc8997e22aa0227f969b5808eccacbf'],3,4,7,3332641,2,,,,8837
a6f91a197516128a1809c7563efaaf3e5fe63a17,1,Koji Kawamura,2018-12-10 16:25:59+09:00,['60064a9f6874f56bc946dfd71c2568528040de0c'],25,191,216,3332857,6,0.026666667,0.493333333,0.493333333,8839
4e7a856f77fb8b7fbe1067ce667d8dff93dbd271,1,Pierre Villard,2018-12-10 11:47:58+01:00,['a6f91a197516128a1809c7563efaaf3e5fe63a17'],3,59,62,3332919,3,0,1,1,8839
1ac5b93144ebd92c907fb49664a524e196ae20c6,1,Bryan Bende,2018-12-10 11:16:01-05:00,['4e7a856f77fb8b7fbe1067ce667d8dff93dbd271'],141,1510,1651,3334570,32,0.872600349,1,0.912739965,8852
1a937b65111173d77255984f9856bbc63f2c22f0,0,Koji Kawamura,2018-12-11 10:43:25+09:00,['1ac5b93144ebd92c907fb49664a524e196ae20c6'],1,5,6,3334576,1,,,,8852
13a7f168604f20da3c837ce3bf91a3472a9708f1,0,Koji Kawamura,2018-12-12 11:08:18+09:00,['1a937b65111173d77255984f9856bbc63f2c22f0'],0,15,15,3334591,1,1,1,1,8852
85cc5aa9eb99fce8268a476fa8a645184478be1d,0,Koji Kawamura,2018-12-12 11:15:48+09:00,['13a7f168604f20da3c837ce3bf91a3472a9708f1'],2,3,5,3334596,1,,,,8852
9a1ab4c504eb2707448e24388c66efbf15fec3bb,1,Mike Thomsen,2018-12-12 09:59:32-05:00,['85cc5aa9eb99fce8268a476fa8a645184478be1d'],108,2008,2116,3336712,23,0.571428571,0.583333333,0.916666667,8865
c51512f5e33cbd413b1fda8700408aa95614680e,0,Matthew Burgess,2018-12-13 10:23:18-05:00,['9a1ab4c504eb2707448e24388c66efbf15fec3bb'],9,159,168,3336880,2,0,0.915966387,0.915966387,8865
0efddf47d516b62d7d9c61142d20ce40bcec675f,0,Matthew Burgess,2018-12-13 16:10:41-05:00,['c51512f5e33cbd413b1fda8700408aa95614680e'],7,234,241,3337121,2,0,1,1,8865
ee24a593e984eabafdeb0b27c03367e67a4f26f1,1,zenfenan,2018-12-15 19:25:31+05:18,['0efddf47d516b62d7d9c61142d20ce40bcec675f'],1,33,34,3337155,1,0.6875,0,1,8865
10e29ee4d6109c61ee7277e9b3839452bfe99d81,0,zenfenan,2018-12-16 16:53:52+05:18,['0efddf47d516b62d7d9c61142d20ce40bcec675f'],2,2,4,3337159,1,,,,8865
d34789881b66461b64931bfb09c25cf68ccb7636,0,Matthew Burgess,2018-12-17 14:12:18-05:00,['0efddf47d516b62d7d9c61142d20ce40bcec675f'],8,55,63,3337222,2,0.243243243,0.891891892,0.783783784,8865
7c9617a0ec56649370b17f9f276a660119c94f05,0,GitHub,2018-12-17 11:39:09-08:00,"['0efddf47d516b62d7d9c61142d20ce40bcec675f', '10e29ee4d6109c61ee7277e9b3839452bfe99d81']",2,2,4,3337226,1,,,,8865
cc47a8c0e1762b17f3889bf8e36b92cf51a8e7af,1,Kevin Doran,2018-12-17 17:32:06-05:00,['7c9617a0ec56649370b17f9f276a660119c94f05'],34,195,229,3337455,9,0.387096774,0.451612903,1,8865
4b70465ea574b461e105c5fb2bafedd96589dd08,0,Koji Kawamura,2018-12-18 15:03:31+09:00,['cc47a8c0e1762b17f3889bf8e36b92cf51a8e7af'],8,6,14,3337469,1,1,1,1,8865
7548d7c85914d9c64efeccce62d61de522170286,0,Koji Kawamura,2018-12-18 15:07:43+09:00,['cc47a8c0e1762b17f3889bf8e36b92cf51a8e7af'],3,37,40,3337509,2,0,0.55,1,8865
c52f880cc1148bde12bc6333ed74483882c28e0d,0,GitHub,2018-12-18 09:50:25+01:00,"['7548d7c85914d9c64efeccce62d61de522170286', 'd34789881b66461b64931bfb09c25cf68ccb7636']",8,55,63,3337572,2,,,,8865
e9cb915ca9800df4aae6b0d9f860409a38f29832,0,GitHub,2018-12-18 10:21:29+01:00,"['c52f880cc1148bde12bc6333ed74483882c28e0d', '4b70465ea574b461e105c5fb2bafedd96589dd08']",8,6,14,3337586,1,,,,8865
590fa2063cd915123c5f46dac07890ff7607ffb0,0,Koji Kawamura,2018-12-19 11:20:55+09:00,['e9cb915ca9800df4aae6b0d9f860409a38f29832'],40,62,102,3337688,2,1,1,1,8865
f22a6c46ad05289f4211186a8f5854b5413da2d3,0,GitHub,2018-12-19 10:50:05+01:00,"['590fa2063cd915123c5f46dac07890ff7607ffb0', 'ee24a593e984eabafdeb0b27c03367e67a4f26f1']",1,33,34,3337722,1,,,,8865
f9f386b0f01fb7492ea6e9a56ca6cbc3d4578ad3,0,Peter Wicks,2018-12-20 10:05:25-07:00,['f22a6c46ad05289f4211186a8f5854b5413da2d3'],14,8,22,3337744,3,0,0,0,8865
8ccf890a55a9007749e353b3eceb920d1d4caced,0,Peter Wicks,2018-12-20 10:11:07-07:00,['f22a6c46ad05289f4211186a8f5854b5413da2d3'],2,2,4,3337748,2,,,,8865
2e4f002945e0810377f3d28911a288382a7fb9de,0,GitHub,2018-12-21 14:33:16+01:00,"['f9f386b0f01fb7492ea6e9a56ca6cbc3d4578ad3', '8ccf890a55a9007749e353b3eceb920d1d4caced']",2,2,4,3337752,2,,,,8865
1330b92cfa01f9dd04bade7a05a047ad6f080c4b,1,Koji Kawamura,2018-12-28 10:30:02+09:00,['2e4f002945e0810377f3d28911a288382a7fb9de'],5,45,50,3337802,2,0.2,0.666666667,1,8865
595a2decc67d464534ce33f18440543620165bbb,1,Pierre Villard,2019-01-03 11:31:38+01:00,['1330b92cfa01f9dd04bade7a05a047ad6f080c4b'],2,8,10,3337812,2,1,1,1,8865
fea17d0ca875d2450c21b69dc0c6c241374834e5,0,Pierre Villard,2019-01-03 11:35:23+01:00,['595a2decc67d464534ce33f18440543620165bbb'],1,19,20,3337832,1,,,,8865
6fa5deafc26139a13720b05b0b25d2a5055fc55b,0,Pierre Villard,2019-01-03 18:10:08+01:00,['fea17d0ca875d2450c21b69dc0c6c241374834e5'],0,5,5,3337837,1,1,1,0.333333333,8865
cd91197a45a94465874cbaf68ffa11df8bc63011,0,Pierre Villard,2019-01-04 10:32:12+01:00,['6fa5deafc26139a13720b05b0b25d2a5055fc55b'],10,21,31,3337868,3,0,1,0,8865
432ba8787f99848d939596aad73f10315b80bf12,1,Pierre Villard,2019-01-04 12:28:13+01:00,['cd91197a45a94465874cbaf68ffa11df8bc63011'],15,15,30,3337898,4,1,,0,8865
c5c2b308ed4653b79ec303977b811ef90a0c49c1,0,Andy LoPresto,2019-01-04 09:38:58-08:00,['432ba8787f99848d939596aad73f10315b80bf12'],23,32,55,3337953,2,,,,8865
c206c0fcf990f359acbea8c29c5c16f6330a434c,0,Andy LoPresto,2019-01-04 09:53:53-08:00,['c5c2b308ed4653b79ec303977b811ef90a0c49c1'],4,57,61,3338014,2,,,,8866
b59fa5af1f3232581e1b3903e3e2f408d9daa323,0,Matthew Burgess,2019-01-07 09:55:06-05:00,['c206c0fcf990f359acbea8c29c5c16f6330a434c'],160,685,845,3338859,3,0.566666667,1,1,8867
cf41c10546d940aa86d0287bbeb2cdaf4a6c8a2a,1,Matthew Burgess,2019-01-07 11:06:17-05:00,['b59fa5af1f3232581e1b3903e3e2f408d9daa323'],41,94,135,3338994,5,0.939393939,0.939393939,0.96969697,8867
a8e59e52af5144c6238230bd792d01ca6daafadf,0,Koji Kawamura,2019-01-08 12:12:13+09:00,['cf41c10546d940aa86d0287bbeb2cdaf4a6c8a2a'],0,671,671,3339665,4,0.17765043,0.845272206,0.965616046,8870
93efc2affcd899aaa38cd98799f6c308df517148,0,Pierre Villard,2019-01-08 11:13:38+01:00,['a8e59e52af5144c6238230bd792d01ca6daafadf'],2,21,23,3339688,2,0,0,1,8870
ae67346648953fe8c3fc218f5f00d25554b9cffd,0,Ed,2019-01-08 16:50:20-05:00,['93efc2affcd899aaa38cd98799f6c308df517148'],3,130,133,3339821,4,0,1,1,8870
e6e4175d71d23157c152e7337e97fc45533b3869,0,Koji Kawamura,2019-01-09 12:06:27+09:00,['ae67346648953fe8c3fc218f5f00d25554b9cffd'],3,0,3,3339824,1,1,1,0,8870
1a443c73ecb0ed00233b66d282031aa5b37afb24,1,Ed,2019-01-08 23:28:23-05:00,['e6e4175d71d23157c152e7337e97fc45533b3869'],26,73,99,3339923,2,0.075,0,1,8870
3e52ae952d05867f3366dc4f796ae193a84b4b2c,1,Ed,2019-01-09 21:55:09-05:00,['1a443c73ecb0ed00233b66d282031aa5b37afb24'],10,85,95,3340018,4,0,1,1,8870
706cf7dcff1eddaf86e6dd7496734ec637d31810,1,Matt Gilman,2019-01-10 11:15:17-05:00,['3e52ae952d05867f3366dc4f796ae193a84b4b2c'],91,158,249,3340267,11,0.03030303,0.363636364,0.757575758,8870
cf7ab0ce180ecfdeaf1758e896540b58036896b0,0,Peter Wicks,2019-01-10 12:13:35-07:00,['706cf7dcff1eddaf86e6dd7496734ec637d31810'],3,0,3,3340270,1,1,0,0,8870
2bbfb3217be40abe4af7ddb8627808d12d99bb17,0,Matthew Burgess,2019-01-10 15:05:31-05:00,['cf7ab0ce180ecfdeaf1758e896540b58036896b0'],112,320,432,3340702,12,1,1,1,8873
89adb039d28d119a942eab6045320d2bf26c5db2,0,Matt Gilman,2019-01-11 10:22:22-05:00,['2bbfb3217be40abe4af7ddb8627808d12d99bb17'],0,1,1,3340703,1,0,0,0,8873
05de73d6a0c53714f0c4accccc3704fc0eeeac96,0,Matthew Burgess,2019-01-17 17:11:39-05:00,['89adb039d28d119a942eab6045320d2bf26c5db2'],0,10,10,3340713,4,0,0.9,0.1,8873
4ef2251d74e25e0e55ea911e7041fc97b1497ae9,0,Koji Kawamura,2019-01-21 17:19:42+09:00,['05de73d6a0c53714f0c4accccc3704fc0eeeac96'],1,38,39,3340752,2,0,0.142857143,1,8873
fd3d69bc9097e273756432a545eab7d15253d794,1,Jeff Storck,2019-01-24 19:47:03-05:00,['4ef2251d74e25e0e55ea911e7041fc97b1497ae9'],374,315,689,3341441,5,0.785714286,0,0,8873
410c9a4ecd6492a1ddae4c51862e4a25c004ceda,1,Mike Thomsen,2019-01-25 07:19:54-05:00,['fd3d69bc9097e273756432a545eab7d15253d794'],5,3657,3662,3345103,26,0.390513834,0.774703557,0.724110672,8896
531c84ac31f93ef72521134a7cc5ea19a2f1e276,0,Pierre Villard,2019-01-25 15:00:12+01:00,['410c9a4ecd6492a1ddae4c51862e4a25c004ceda'],5,8,13,3345116,1,0,0,1,8896
2eac0e96c73e03809b02b4a3be029842754e649f,0,Bryan Bende,2019-01-28 13:13:48-05:00,['531c84ac31f93ef72521134a7cc5ea19a2f1e276'],3,6,9,3345125,1,0,0,1,8896
8e777203a02c6e6d9772c9dec86966c9516d56fe,0,Matthew Burgess,2019-01-30 09:40:36-05:00,['2eac0e96c73e03809b02b4a3be029842754e649f'],24,53,77,3345202,2,0,1,1,8896
8a3d7a453a7792d89f6f099e53cd9fc301efcf4c,1,Matthew Burgess,2019-01-30 10:14:35-05:00,['8e777203a02c6e6d9772c9dec86966c9516d56fe'],1,68,69,3345271,6,0.833333333,0.833333333,1,8897
79a3696e5ebed8d87f7e377d429db91e8d74b4fd,0,Mark Payne,2019-01-30 11:14:53-05:00,['8a3d7a453a7792d89f6f099e53cd9fc301efcf4c'],1,1,2,3345273,1,,,,8897
fef41b302216934886817fd9335ea4b5d62c4c1e,0,Matthew Burgess,2019-02-01 13:33:33-05:00,['79a3696e5ebed8d87f7e377d429db91e8d74b4fd'],2,24,26,3345299,2,0.214285714,0.214285714,1,8897
ad1f2fb666a2d98b05c56119c1e1ae8cc5fd2e7d,0,GitHub,2019-02-01 13:04:51-07:00,['fef41b302216934886817fd9335ea4b5d62c4c1e'],8,40,48,3345347,5,0.5,1,1,8897
2c2b47ab85b7a788ad2be3aecab1f8371e1cf13b,0,Pierre Villard,2019-02-04 15:53:31+01:00,['ad1f2fb666a2d98b05c56119c1e1ae8cc5fd2e7d'],3,3,6,3345353,1,,0,,8897
83ac191736e8036f82da467ceb1940b50d9886f0,1,Bryan Bende,2019-02-04 14:29:17-05:00,['2c2b47ab85b7a788ad2be3aecab1f8371e1cf13b'],118,536,654,3346007,18,0.256410256,0.853479853,0.923076923,8898
412c4908e2c5d79d958b09403c816db57c828179,0,Bryan Bende,2019-02-05 15:23:24-05:00,['83ac191736e8036f82da467ceb1940b50d9886f0'],16,62,78,3346085,7,0.806451613,0.806451613,1,8898
35147a620f2ae4e2164ba342e77976667837d5f3,1,Mark Payne,2019-02-06 12:42:43-05:00,['412c4908e2c5d79d958b09403c816db57c828179'],1,3,4,3346089,1,0,1,1,8898
24a7d480c8fde18a7dd64d7de80812d18eb2c5a4,0,Matthew Burgess,2019-02-06 15:54:15-05:00,['35147a620f2ae4e2164ba342e77976667837d5f3'],40,93,133,3346222,4,0,0.882352941,1,8898
f81d6bd63b50c27dc62aabb85a6d864db991c9dd,1,Andy LoPresto,2019-02-07 11:13:28+11:00,['24a7d480c8fde18a7dd64d7de80812d18eb2c5a4'],118,289,407,3346629,7,1,0.928571429,0.107142857,8901
8c58d518578c12fa335b6ecb092e50e355e7d0da,0,joewitt,2019-02-06 21:04:21-05:00,['f81d6bd63b50c27dc62aabb85a6d864db991c9dd'],11,11,22,3346651,1,,,,8901
cdf3c69208ffbaa831b68b9d9eb4621c57c51582,1,Jeff Storck,2019-02-08 00:11:38-05:00,['8c58d518578c12fa335b6ecb092e50e355e7d0da'],0,5695,5695,3352346,33,0.248672566,0.642035398,0.780973451,8932
e4be06c7c8a4801e375344954e442bb15aa3f636,0,Jeff Storck,2019-02-08 00:22:56-05:00,['cdf3c69208ffbaa831b68b9d9eb4621c57c51582'],10,12,22,3352368,2,0,1,1,8932
4e914cea1f4c12b7ea020c40a155398a52b89ecf,0,Bryan Bende,2019-02-08 10:52:04-05:00,['e4be06c7c8a4801e375344954e442bb15aa3f636'],6,15,21,3352389,1,0,0,0,8932
29d54126e4afac1e984912b1ccb0a5fb222c7928,0,Mark Payne,2019-02-08 15:41:02-05:00,['4e914cea1f4c12b7ea020c40a155398a52b89ecf'],2,19,21,3352410,2,0.666666667,0.666666667,1,8932
bc0e68ff2abbfc2a1f38f3fe34812eb4adfc92fd,0,Mark Payne,2019-02-08 15:58:43-05:00,['29d54126e4afac1e984912b1ccb0a5fb222c7928'],0,1,1,3352411,1,,,,8932
8c8a9b4d53584913881d16771c8ace05a6cf6819,0,Bryan Bende,2019-02-11 09:45:55-05:00,['bc0e68ff2abbfc2a1f38f3fe34812eb4adfc92fd'],36,146,182,3352593,7,0,0.96,1,8932
3a4c3ccbaae6f443910a264ccc57f48acd21d713,0,joewitt,2019-02-11 12:40:10-05:00,['8c8a9b4d53584913881d16771c8ace05a6cf6819'],1,6,7,3352600,1,0,1,1,8932
36c0a99e91c492329c0df69ee4ae961e57295f84,1,Matthew Burgess,2019-02-11 12:56:50-05:00,['3a4c3ccbaae6f443910a264ccc57f48acd21d713'],1006,5485,6491,3359091,116,0.505126821,0.649217485,0.939557474,8971
3d408f2b30fbb35fd507577a7032821044a7dcd9,1,Jeff Storck,2019-02-11 18:15:16-05:00,['36c0a99e91c492329c0df69ee4ae961e57295f84'],36,220,256,3359347,4,0.5625,1,0.366071429,8971
a940ff634399ded5d97eba4620116bc88ae88d03,1,Kevin Doran,2019-02-12 11:12:38-05:00,['3d408f2b30fbb35fd507577a7032821044a7dcd9'],13,72,85,3359432,1,0.333333333,0.333333333,0.166666667,8971
7278a3970d0a397564dd08dd89c770d6d14820ae,0,Kevin Doran,2019-02-12 11:54:54-05:00,['a940ff634399ded5d97eba4620116bc88ae88d03'],0,7,7,3359439,1,,,,8971
82a0434901c9c7d2f507f57f177073c3a18a30d4,1,Matthew Burgess,2019-02-12 16:44:17-05:00,['7278a3970d0a397564dd08dd89c770d6d14820ae'],31,1494,1525,3360964,9,0.430579965,0.919156415,0.905096661,8973
b74d71b64738545c9e02e601b028de19c137af3b,0,Pierre Villard,2019-02-13 13:54:24+01:00,['82a0434901c9c7d2f507f57f177073c3a18a30d4'],2,18,20,3360984,2,1,1,1,8973
da8c8a14a13e0f52ba6bdeaa34afdf3bf259d6b7,0,Mark Payne,2019-02-13 08:53:19-05:00,['b74d71b64738545c9e02e601b028de19c137af3b'],1,1,2,3360986,1,,,,8973
3492313d0b3436cdd0f7390d46d403fed9d65b77,0,Matthew Burgess,2019-02-13 14:18:05-05:00,['da8c8a14a13e0f52ba6bdeaa34afdf3bf259d6b7'],22,90,112,3361098,7,0.145833333,0,0.666666667,8973
2938454ae4fc200fd5f6aeffe23bc4b33c83e783,0,Matt Gilman,2019-02-13 16:03:46-05:00,['3492313d0b3436cdd0f7390d46d403fed9d65b77'],1,27,28,3361126,2,1,1,1,8973
7a763d3c496049725524a0022e86775b3d0fd760,1,Jeff Storck,2019-02-13 16:08:57-05:00,['2938454ae4fc200fd5f6aeffe23bc4b33c83e783'],6,90,96,3361222,3,0.636363636,1,1,8974
72244d09ff193131119c10492b9327af35a64f02,1,Jeff Storck,2019-02-13 16:09:12-05:00,['7a763d3c496049725524a0022e86775b3d0fd760'],17,28,45,3361267,2,0,1,1,8974
033b2a1940bf97bb213347a53d2d2a6c0b4cd12b,0,Matthew Burgess,2019-02-13 16:51:17-05:00,['72244d09ff193131119c10492b9327af35a64f02'],20,1587,1607,3362874,15,0.474878444,0.794165316,0.756888169,8986
45b32e3bc11feea1958902cecc3c84b26b5b2b20,1,Mike Thomsen,2019-02-14 08:02:29-05:00,['033b2a1940bf97bb213347a53d2d2a6c0b4cd12b'],8,176,184,3363058,5,1,1,1,8988
e7ae97797efe591e4c2e46a70f3e9c834072c8e9,0,Mike Thomsen,2019-02-14 08:31:42-05:00,['45b32e3bc11feea1958902cecc3c84b26b5b2b20'],19,85,104,3363162,2,0.245614035,0.701754386,0.701754386,8988
8a197e5a96479b4b298aa821a8ab9fdfdc1deb60,1,Matthew Burgess,2019-02-14 12:19:13-05:00,['e7ae97797efe591e4c2e46a70f3e9c834072c8e9'],17,331,348,3363510,5,0.781609195,0.977011494,1,8991
ae8a794ff04ce28c9cfee887981635577645e0f1,0,Bryan Bende,2019-02-14 13:29:00-05:00,['8a197e5a96479b4b298aa821a8ab9fdfdc1deb60'],0,3,3,3363513,2,0,0,1,8991
e598b30d6dc85111762f9618f1b7cfefc68e612b,0,Matthew Burgess,2019-02-14 15:08:54-05:00,['ae8a794ff04ce28c9cfee887981635577645e0f1'],3,149,152,3363665,4,0.330357143,0.973214286,1,8991
f61947627eeb707b13af2395da9c8ebc749fe811,1,Matt Gilman,2019-02-14 16:43:15-05:00,['e598b30d6dc85111762f9618f1b7cfefc68e612b'],1,1,2,3363667,1,,,,8991
b508d6bfbc2b6a68fe2ab152de96611f06a8724a,1,Bryan Bende,2019-02-15 11:59:47-05:00,['f61947627eeb707b13af2395da9c8ebc749fe811'],106,101,207,3363874,11,1,0,0,8991
319979f2563fc2631f08c4611ff9484a03b483bf,0,Bryan Bende,2019-02-15 13:06:30-05:00,['b508d6bfbc2b6a68fe2ab152de96611f06a8724a'],8,14,22,3363896,1,0,0,0,8991
b7ca59f568a71ba476cdee95348b8ce3edd381f4,0,Bryan Bende,2019-02-15 14:12:04-05:00,['319979f2563fc2631f08c4611ff9484a03b483bf'],13,3,16,3363912,2,0.333333333,0,0,8991
9e0687ab6b3bb3923aa334e9d4b86712e5982ff3,0,Andy LoPresto,2019-02-15 14:09:26-08:00,['b7ca59f568a71ba476cdee95348b8ce3edd381f4'],204,213,417,3364329,7,,,,8991
82f44155f62b0d3f90f60cfd611c6ae12761c873,0,joewitt,2019-02-16 20:57:42-05:00,['9e0687ab6b3bb3923aa334e9d4b86712e5982ff3'],18,69,87,3364416,6,0.714285714,1,1,8992
45bb53d2aafd6ec5cb6bb794b3f7f8fc8300a04b,0,joewitt,2019-02-16 21:50:15-05:00,['82f44155f62b0d3f90f60cfd611c6ae12761c873'],1364,1356,2720,3367136,415,,,,8992
0e204f35761ed4a502c690d96a42ecf1b24320d2,1,joewitt,2019-02-16 21:50:35-05:00,['45bb53d2aafd6ec5cb6bb794b3f7f8fc8300a04b'],1352,1352,2704,3369840,415,,,,8992
53ca9eb7e51d69aebd692b43d5861180098a7dc6,0,zenfenan,2019-02-19 16:12:15+05:18,['82f44155f62b0d3f90f60cfd611c6ae12761c873'],9,67,76,3369916,3,0,1,1,8992
af6039a5b06af70fe4c1c14abcba5f7b381535ee,0,Mike Thomsen,2019-02-19 10:34:43-05:00,['53ca9eb7e51d69aebd692b43d5861180098a7dc6'],4,12,16,3369932,3,1,1,1,8992
d59a07245ff08117b3b4245dbba84b0b093c68a8,0,Mike Thomsen,2019-02-19 12:41:57-05:00,['af6039a5b06af70fe4c1c14abcba5f7b381535ee'],7,22,29,3369961,4,0,0.090909091,0.090909091,8992
76e92c8682af951cc327814dcc54cfd2f9813194,0,Mike Thomsen,2019-02-19 18:32:15-05:00,['d59a07245ff08117b3b4245dbba84b0b093c68a8'],111,111,222,3370183,111,,,,8992
25cc7b4a1edb80217370f9dac2990245cca340bd,0,joewitt,2019-02-19 22:55:49-05:00,"['76e92c8682af951cc327814dcc54cfd2f9813194', '0e204f35761ed4a502c690d96a42ecf1b24320d2']",1363,1355,2718,3372901,415,,,,8992
d1388bbd7f6c85e0ecdc61198d0b7d93bf59295e,0,joewitt,2019-02-19 23:17:48-05:00,['25cc7b4a1edb80217370f9dac2990245cca340bd'],2,2,4,3372905,2,,,,8992
ed21d02fa78bb234c3afdb264a6f770de923f4b5,1,Mike Thomsen,2019-02-20 20:46:30-05:00,['d1388bbd7f6c85e0ecdc61198d0b7d93bf59295e'],0,23,23,3372928,5,,,,8992
0ec69efe9a96c75e192b0542f72f3900dc5856aa,0,Mike Thomsen,2019-02-20 20:49:06-05:00,['ed21d02fa78bb234c3afdb264a6f770de923f4b5'],1,1,2,3372930,1,,,,8992
60b00a1e38682d9cf79d6a5d1adbaa185df1ccaa,0,Mike Thomsen,2019-02-21 06:34:27-05:00,['0ec69efe9a96c75e192b0542f72f3900dc5856aa'],31,1,32,3372962,9,,,,8992
270b6d5897117cb282bb59cc26abd29e1c54765d,1,Mike Thomsen,2019-02-21 07:09:25-05:00,['60b00a1e38682d9cf79d6a5d1adbaa185df1ccaa'],0,194,194,3373156,3,,,,8993
a0c28ee19e1b29b30e17946f074a01f94cfbc3c0,0,Mike Moser,2019-02-21 14:45:04-05:00,['270b6d5897117cb282bb59cc26abd29e1c54765d'],3,15,18,3373174,3,0,0.363636364,1,8993
2336044b90aa6a9f669e9416850fc642d2590501,0,Mark Payne,2019-02-22 09:45:13-05:00,['a0c28ee19e1b29b30e17946f074a01f94cfbc3c0'],1,1,2,3373176,1,,,,8993
e26bacf69799fc98ce9b4674551ecb520488a6e6,0,Brandon Devries,2019-02-22 10:12:20-05:00,['2336044b90aa6a9f669e9416850fc642d2590501'],15,39,54,3373230,3,0,0.933333333,1,8993
414bfc94fc6248155fa32eb117d658f067b2e3f1,0,Mark Payne,2019-02-22 11:55:25-05:00,['e26bacf69799fc98ce9b4674551ecb520488a6e6'],3,5,8,3373238,1,0.333333333,1,1,8993
26c00f1080741327bcac103eb106cacfbdfe6571,1,Mark Payne,2019-02-22 12:13:13-05:00,['414bfc94fc6248155fa32eb117d658f067b2e3f1'],49,68,117,3373355,3,1,0,0,8994
4b45e85327bfb47669c09cde0c59c58812365998,1,Mark Payne,2019-02-22 12:19:12-05:00,['26c00f1080741327bcac103eb106cacfbdfe6571'],48,98,146,3373501,9,0,0.35483871,1,8995
b0a93b473b428f9aa43502411818564703cec59b,1,Bryan Bende,2019-02-25 16:42:11-05:00,['4b45e85327bfb47669c09cde0c59c58812365998'],248,785,1033,3374534,9,0.611111111,0.811111111,1,9001
be6cd4f0f2eac8651a230bc4ddfe82ab77bd0f28,0,Bryan Bende,2019-02-25 16:52:41-05:00,['b0a93b473b428f9aa43502411818564703cec59b'],1,1,2,3374536,1,,,,9001
cd7edb1c04fdd977de1fa30d1dbe4bf93c4afda2,1,Matthew Burgess,2019-02-25 17:15:39-05:00,['be6cd4f0f2eac8651a230bc4ddfe82ab77bd0f28'],21,214,235,3374771,2,0.25,0.558333333,1,9001
922da68a235b5e8f20095ead6a3258490ba9323a,1,Bryan Bende,2019-02-26 09:39:09-05:00,['cd7edb1c04fdd977de1fa30d1dbe4bf93c4afda2'],2,29,31,3374802,2,0,1,1,9001
6d4504d662fc7a65110261d205f102360a90b544,1,Aldrin Piri,2019-02-27 20:15:23-05:00,['922da68a235b5e8f20095ead6a3258490ba9323a'],2,24,26,3374828,7,,,,9001
2a6c3c16862d14e5b3a34043e880a60e2c251c43,1,Pierre Villard,2019-02-28 09:15:59+01:00,['6d4504d662fc7a65110261d205f102360a90b544'],0,189,189,3375017,3,0.230769231,0.725274725,1,9002
e5fa18d63cda60f0b10a8a1a2abff1cf69e976bd,0,Mike Thomsen,2019-02-28 05:51:33-05:00,['2a6c3c16862d14e5b3a34043e880a60e2c251c43'],3,112,115,3375132,4,0,1,1,9004
32bd7ed8b42ca76f2fb9ca65046989368c6459ac,0,Mike Thomsen,2019-02-28 08:59:37-05:00,['e5fa18d63cda60f0b10a8a1a2abff1cf69e976bd'],6,173,179,3375311,3,0.062015504,0.434108527,0.434108527,9004
5249a85030eafb5db63650fadbc2c03d257e7cc0,1,Kevin Doran,2019-02-28 15:32:37-05:00,['32bd7ed8b42ca76f2fb9ca65046989368c6459ac'],43,103,146,3375457,5,0.482758621,1,0.724137931,9004
36bbc777230da539724a0e3d9bf815fb68c06654,1,Mike Thomsen,2019-03-04 19:30:35-05:00,['5249a85030eafb5db63650fadbc2c03d257e7cc0'],42,26,68,3375525,32,,,,9004
4f2b0156fb8a95d4a975274ed0f3184797900f66,0,Kevin Doran,2019-03-04 22:25:50-05:00,['36bbc777230da539724a0e3d9bf815fb68c06654'],1,1,2,3375527,1,,,,9004
c32ea618c5f454d9af25082452595b57c064b001,1,Bryan Bende,2019-03-06 13:44:33-05:00,['4f2b0156fb8a95d4a975274ed0f3184797900f66'],23,173,196,3375723,3,0,0.961904762,1,9004
08a307cc6443de15713daa6ed29ed36a4b3e549f,1,Matthew Burgess,2019-03-06 13:59:35-05:00,['c32ea618c5f454d9af25082452595b57c064b001'],5,149,154,3375877,3,0.75308642,1,1,9005
1d06044e3b08a886c6d8990ce5bfaa69e63d7324,0,Bryan Bende,2019-03-06 17:07:18-05:00,['08a307cc6443de15713daa6ed29ed36a4b3e549f'],26,9,35,3375912,1,1,1,1,9005
d53cefa2a75d47b5e75c6fb55e86bada759cce79,1,Koji Kawamura,2019-03-07 14:26:40+09:00,['1d06044e3b08a886c6d8990ce5bfaa69e63d7324'],17,62,79,3375991,2,0.84,1,1,9005
79e05c9f583aa1e4d390f380e375253bd7be198e,0,Matthew Burgess,2019-03-07 13:00:31-05:00,['d53cefa2a75d47b5e75c6fb55e86bada759cce79'],1,1484,1485,3377476,9,0.583456425,0.747415066,0.908419498,9011
58a25cfa5a9b9e4af9a5e9b7e5c3be9a676d8e87,1,Bryan Bende,2019-03-08 10:32:38-05:00,['79e05c9f583aa1e4d390f380e375253bd7be198e'],38,170,208,3377684,5,0.033333333,0.988888889,1,9011
c84f40ee36c253dfc7166a9af385ea1c10a14757,0,Bryan Bende,2019-03-08 17:27:49-05:00,['58a25cfa5a9b9e4af9a5e9b7e5c3be9a676d8e87'],10,25,35,3377719,3,0,1,1,9011
160ade9f9d3588d8afb053360e58fd189475ab75,0,Matt Gilman,2019-03-11 13:52:09-04:00,['c84f40ee36c253dfc7166a9af385ea1c10a14757'],31,49,80,3377799,8,0,0,0,9011
98ca28d50ddf67ee77c6212ac1da75aa62a3c633,0,Bryan Bende,2019-03-12 12:29:22-04:00,['160ade9f9d3588d8afb053360e58fd189475ab75'],6,11,17,3377816,6,,,,9011
35d1cace080a476910b007e67ce4e90661a0d299,0,Bryan Bende,2019-03-13 11:12:00-04:00,['98ca28d50ddf67ee77c6212ac1da75aa62a3c633'],12,234,246,3378062,4,,,,9011
f91311da9d759fb5712ee8121d54d27a7deea236,1,Matthew Burgess,2019-03-13 11:47:55-04:00,['35d1cace080a476910b007e67ce4e90661a0d299'],0,62,62,3378124,2,0.1,0.54,1,9011
2846d3c3c6e454f7960763bd69e36e879684a033,1,Matthew Burgess,2019-03-13 11:49:00-04:00,['f91311da9d759fb5712ee8121d54d27a7deea236'],54,42,96,3378220,1,0.823529412,0.823529412,0,9011
0e10e417df4d63f3815874fbbf11fc3a450e67af,0,Joe Witt,2019-03-13 15:56:13-04:00,['2846d3c3c6e454f7960763bd69e36e879684a033'],547,584,1131,3379351,7,0,0,0.230769231,9011
ca76fe178cfae8890b347081260cd59a62321219,1,Koji Kawamura,2019-03-14 09:33:30+09:00,['0e10e417df4d63f3815874fbbf11fc3a450e67af'],132,1343,1475,3380826,35,0.276422764,0.276422764,0.760162602,9020
4db5446c878a9be1d621429686f2835dc642d550,1,Koji Kawamura,2019-03-14 09:33:39+09:00,['ca76fe178cfae8890b347081260cd59a62321219'],34,53,87,3380913,4,0,1,1,9020
82e2c97782f2aa60d87615c6aaa54e9f78b79fe8,0,Bryan Bende,2019-03-14 12:22:41-04:00,['4db5446c878a9be1d621429686f2835dc642d550'],8,29,37,3380950,5,0,0,0.5,9020
45ebeba846cf257c0dd27669c25e244208758fb9,0,Bryan Bende,2019-03-15 09:18:39-04:00,['82e2c97782f2aa60d87615c6aaa54e9f78b79fe8'],0,26,26,3380976,14,0.333333333,0.916666667,0.333333333,9020
43235724e2031c30fc48e05be0d2136fd58efa52,0,Mike Thomsen,2019-03-16 10:08:44-04:00,['45ebeba846cf257c0dd27669c25e244208758fb9'],0,2252,2252,3383228,21,0.660060976,0.858231707,0.867378049,9040
6401e32a330fa1b82e19bf73cb4d7e7695afade1,1,Matt Gilman,2019-03-18 14:08:56-04:00,['43235724e2031c30fc48e05be0d2136fd58efa52'],1,1,2,3383230,1,,,,9040
0cb15cfb1a5425704a60db2d49415f745df48b1b,0,Matt Gilman,2019-03-18 14:48:41-04:00,['6401e32a330fa1b82e19bf73cb4d7e7695afade1'],5,10,15,3383245,1,1,1,1,9040
06f41ac6f8645fc2e37be2529200e89177f48197,1,Koji Kawamura,2019-03-20 10:30:55+09:00,['0cb15cfb1a5425704a60db2d49415f745df48b1b'],2,16,18,3383263,3,0,1,1,9040
77b84edf5bd3eca03d7b2ef1d17e4cf6e2f5e15c,1,Koji Kawamura,2019-03-20 10:51:39+09:00,['06f41ac6f8645fc2e37be2529200e89177f48197'],31,65,96,3383359,3,0.85,1,1,9040
9d21a106ad6674ab4f12828b9dd007f28e5808f2,0,Koji Kawamura,2019-03-20 10:56:10+09:00,['77b84edf5bd3eca03d7b2ef1d17e4cf6e2f5e15c'],2,2,4,3383363,3,,,,9040
b97fbd2c89caafec4bde485c6118a6daa087fcb2,1,Koji Kawamura,2019-03-20 12:15:40+09:00,['9d21a106ad6674ab4f12828b9dd007f28e5808f2'],44,31,75,3383438,3,1,0,0,9040
cd3567873be7586aa285bd6b27e928e320299bee,0,Koji Kawamura,2019-03-20 12:36:08+09:00,['b97fbd2c89caafec4bde485c6118a6daa087fcb2'],4,59,63,3383501,1,0,1,1,9040
d35d15cdda32c2aedd5bfd4124662f522461c159,0,Kevin Doran,2019-03-20 13:38:46-04:00,['cd3567873be7586aa285bd6b27e928e320299bee'],31,58,89,3383590,2,0,1,0.631578947,9040
48a6c81fa261339c645773a3124ce0ee351346c4,0,Matthew Burgess,2019-03-20 14:12:03-04:00,['d35d15cdda32c2aedd5bfd4124662f522461c159'],10,43,53,3383643,6,1,1,0.545454545,9042
ce09b93ef1d104d65968054b97c2c9b2c5eaef3e,0,Koji Kawamura,2019-03-22 10:41:10+09:00,['48a6c81fa261339c645773a3124ce0ee351346c4'],0,18,18,3383661,2,0,0.3,1,9042
1bdab73201afbf420e13e7834f9d62da763848cc,0,Mike Thomsen,2019-03-22 09:01:21-04:00,['ce09b93ef1d104d65968054b97c2c9b2c5eaef3e'],62,68,130,3383791,36,,,,9042
c8eff590efa3babcda0b755009224dcac168708b,0,Pierre Villard,2019-03-24 12:29:46+01:00,['1bdab73201afbf420e13e7834f9d62da763848cc'],7,7,14,3383805,2,,,,9042
ead6a3b842422ca4dd9a34482e162ca80a0a55c5,0,Koji Kawamura,2019-03-25 11:52:28+09:00,['c8eff590efa3babcda0b755009224dcac168708b'],2,2,4,3383809,1,,,,9042
c2dc0910b76565817e95fa349e56aca5d8f2328e,1,Matthew Burgess,2019-03-26 10:39:29-04:00,['ead6a3b842422ca4dd9a34482e162ca80a0a55c5'],1,50,51,3383860,2,0.395348837,0.395348837,1,9042
cae01d555cc2f30b2a302b9dc8ec84db2a04469c,0,Matthew Burgess,2019-03-26 10:39:35-04:00,['c2dc0910b76565817e95fa349e56aca5d8f2328e'],30,42,72,3383932,2,0,1,1,9042
d3d43262db7fc5558a3a8a9c70926501ddb93e53,1,Bryan Bende,2019-03-27 10:22:01-04:00,['cae01d555cc2f30b2a302b9dc8ec84db2a04469c'],99,54,153,3384085,7,1,0.933333333,0.2,9042
4de51fd3d5ac9240540f5738858ce0c8cf8a0bab,0,Mike Thomsen,2019-03-28 11:06:25-04:00,['d3d43262db7fc5558a3a8a9c70926501ddb93e53'],1,15,16,3384101,1,0,0,1,9042
76392ee862294cdf783e20df6c7db39b6dc2f95d,0,Bryan Bende,2019-03-29 10:09:35-04:00,['4de51fd3d5ac9240540f5738858ce0c8cf8a0bab'],0,54,54,3384155,2,0.925,0.925,0.7,9042
3696b5bfcf0bd9e12ee4e9472f3413a93c9c0fcd,0,Bryan Bende,2019-03-29 11:45:52-04:00,['76392ee862294cdf783e20df6c7db39b6dc2f95d'],1,3536,3537,3387692,55,0.665644172,0.866564417,0.939417178,9083
e907b689e8ea4ae9deb30812d43d66a23440b6ae,0,Matthew Burgess,2019-04-03 12:24:32-04:00,['3696b5bfcf0bd9e12ee4e9472f3413a93c9c0fcd'],1,2,3,3387695,1,,,,9083
3a63de2ae2debea95244bc5c424d8669d5833cd9,0,Matthew Burgess,2019-04-03 12:31:57-04:00,['e907b689e8ea4ae9deb30812d43d66a23440b6ae'],3,17,20,3387715,2,0,1,0.5,9083
73571ae30933063b121f9a757a64cf5f7f9c500e,0,Koji Kawamura,2019-04-04 12:24:47+09:00,['3a63de2ae2debea95244bc5c424d8669d5833cd9'],65,71,136,3387851,1,0,0,1,9083
1b196ea2134e3fd5075c910cd43aef544f44cb3e,1,Mike Thomsen,2019-04-04 08:41:34-04:00,['73571ae30933063b121f9a757a64cf5f7f9c500e'],352,624,976,3388827,6,1,1,1,9087
cb4fdc2ae1823e44579917997973b65ffd8af0d6,1,Matt Gilman,2019-04-04 09:51:41-04:00,['1b196ea2134e3fd5075c910cd43aef544f44cb3e'],9,193,202,3389029,18,0.5,1,0.625,9087
c93ee5ad5949858bd3f4eec2067ae30016ea76ac,1,Matthew Burgess,2019-04-04 11:13:18-04:00,['cb4fdc2ae1823e44579917997973b65ffd8af0d6'],1,131,132,3389161,3,0.196721311,1,0.672131148,9088
d36fa6a210261c147453144ef2fb202745319c84,0,Matthew Burgess,2019-04-04 11:26:08-04:00,['c93ee5ad5949858bd3f4eec2067ae30016ea76ac'],0,1,1,3389162,1,0,0,1,9088
e374d2cc30e7ad68aee59722cbb946b3909acba1,0,Matt Gilman,2019-04-04 13:40:14-04:00,['d36fa6a210261c147453144ef2fb202745319c84'],0,4,4,3389166,1,,,,9088
d372318d479c8943a10015e83ef017622731761a,0,Koji Kawamura,2019-04-05 14:55:58+09:00,['e374d2cc30e7ad68aee59722cbb946b3909acba1'],2,1,3,3389169,1,,,,9088
4810f6d32e7f30763b22c704a65603120e4b3c54,0,Matthew Burgess,2019-04-05 11:12:30-04:00,['d372318d479c8943a10015e83ef017622731761a'],2,6,8,3389177,2,1,1,1,9088
96279415a711f41a07eec5fc77f032b98f0ee014,0,Brandon Devries,2019-04-05 12:32:40-04:00,['4810f6d32e7f30763b22c704a65603120e4b3c54'],0,1,1,3389178,1,0,1,1,9088
75217b33d0fc43a64b1b80dd581561fda1ece904,1,Pierre Villard,2019-04-06 14:27:39+02:00,['96279415a711f41a07eec5fc77f032b98f0ee014'],2,28,30,3389208,4,0.777777778,1,1,9088
25cb29e10949f9ea64d815aa64ecdedd71805f3c,0,Pierre Villard,2019-04-06 14:31:50+02:00,['75217b33d0fc43a64b1b80dd581561fda1ece904'],26,47,73,3389281,2,1,,,9088
d222f14a9e9962fac1953180dfb4c0fe2bec524f,1,Koji Kawamura,2019-04-08 16:19:27+09:00,['25cb29e10949f9ea64d815aa64ecdedd71805f3c'],159,680,839,3390120,11,1,1,1,9096
1c588f10b276dc8d2937b2c78caf0e034bc43fa8,0,Koji Kawamura,2019-04-08 16:19:48+09:00,['d222f14a9e9962fac1953180dfb4c0fe2bec524f'],128,105,233,3390353,1,0,0,0.764705882,9096
da593a2e8ebd3e2909c75999e4585991c6a2369c,0,Matthew Burgess,2019-04-08 13:18:00-04:00,['1c588f10b276dc8d2937b2c78caf0e034bc43fa8'],2,2,4,3390357,1,,,,9096
8572852bdfb96995e66ead9c5f01ae259d2f96b0,0,Joe Witt,2019-04-08 14:52:40-04:00,['da593a2e8ebd3e2909c75999e4585991c6a2369c'],7,1,8,3390365,2,1,1,1,9096
fb9f2af04afa5570f413806427319797dbff5194,0,Matt Gilman,2019-04-08 15:45:19-04:00,['8572852bdfb96995e66ead9c5f01ae259d2f96b0'],6,14,20,3390385,2,1,1,1,9096
cded30b3d2dc0497cf3d06051f55ca304c744250,0,Koji Kawamura,2019-04-09 09:14:44+09:00,['fb9f2af04afa5570f413806427319797dbff5194'],0,19,19,3390404,2,0.625,0.75,1,9096
49e74b29dbb3b839af3c793ab266775195c476fd,0,Koji Kawamura,2019-04-09 09:29:32+09:00,['cded30b3d2dc0497cf3d06051f55ca304c744250'],2,2,4,3390408,2,,,,9096
38db4e97cd619b3a3c46e2e6a2e71e25df98ad0b,0,Bryan Bende,2019-04-09 10:19:24-04:00,['49e74b29dbb3b839af3c793ab266775195c476fd'],8,16,24,3390432,1,0,1,1,9096
bf7e70e4c3a30bec5121333faa6ebfe8d054c180,1,Bryan Bende,2019-04-09 11:15:45-04:00,['38db4e97cd619b3a3c46e2e6a2e71e25df98ad0b'],8,28,36,3390468,1,0,0,1,9096
0f10010683674e43c3118085d33f75930fd82676,0,Bryan Bende,2019-04-09 11:24:58-04:00,['bf7e70e4c3a30bec5121333faa6ebfe8d054c180'],9,5,14,3390482,2,1,0,0,9096
8d92a29fb9a6339023f28b892503a8722f78323f,0,Matt Gilman,2019-04-10 14:28:15-04:00,['0f10010683674e43c3118085d33f75930fd82676'],1,2,3,3390485,1,,,,9096
91b2283f49262b7d4c8a2fecbc757a360b0f8321,1,Bryan Bende,2019-04-10 16:47:08-04:00,['8d92a29fb9a6339023f28b892503a8722f78323f'],252,2906,3158,3393643,50,0.369360902,0.914473684,0.945488722,9118
97690275acb666c0598896cf0a96273d65cfae7b,0,Bryan Bende,2019-04-12 15:09:52-04:00,['91b2283f49262b7d4c8a2fecbc757a360b0f8321'],2,13,15,3393658,1,0,1,1,9118
b5ff62211808afbb427ece220e55ddfba048cf8a,0,Matt Gilman,2019-04-12 15:27:26-04:00,['97690275acb666c0598896cf0a96273d65cfae7b'],6,144,150,3393808,2,0.480519481,0.714285714,1,9118
bfcc0ebd03b761fdc4f415d3c2e0229384a29efa,0,Pierre Villard,2019-04-13 03:29:15+02:00,['b5ff62211808afbb427ece220e55ddfba048cf8a'],99,99,198,3394006,1,,,,9118
cbc07eb663cd4cb67fc13fad93813b60204518c5,1,Brandon,2019-04-15 14:13:11+00:00,['bfcc0ebd03b761fdc4f415d3c2e0229384a29efa'],17,199,216,3394222,5,0.387096774,1,1,9120
3ce5d935a5274e13b76e573cafeb799416303feb,0,Scott Aslan,2019-04-15 11:03:24-04:00,['cbc07eb663cd4cb67fc13fad93813b60204518c5'],2,6,8,3394230,1,,,,9120
f8ad27d92aa8ef984759d2476d0668bf16560180,0,Scott Aslan,2019-04-15 11:19:49-04:00,['3ce5d935a5274e13b76e573cafeb799416303feb'],0,0,0,3394230,0,,,,9120
7b945182af250f3cb820f1d6fdc35bd31d21ba29,0,Matthew Burgess,2019-04-15 15:54:41-04:00,['f8ad27d92aa8ef984759d2476d0668bf16560180'],1,2,3,3394233,1,1,0,1,9120
22563fcb9af481e59e40d723fc052d5274ff5a97,1,Kevin Doran,2019-04-15 16:52:13-04:00,['7b945182af250f3cb820f1d6fdc35bd31d21ba29'],367,400,767,3395000,5,0,0.481481481,1,9120
d0224f78970b8f30ae63f698f0a22239f22f1f9a,0,Mark Payne,2019-04-16 09:43:10-04:00,['22563fcb9af481e59e40d723fc052d5274ff5a97'],2,6,8,3395008,2,0,0.75,1,9120
2453c36710b4752c653752fe2991771a92a13de8,1,Mark Payne,2019-04-16 10:52:08-04:00,['d0224f78970b8f30ae63f698f0a22239f22f1f9a'],2,94,96,3395104,4,0,0,1,9120
8411b6a46f5a2bf83eb3899cca3374bd863da1a0,0,Andy LoPresto,2019-04-16 11:00:48-07:00,['2453c36710b4752c653752fe2991771a92a13de8'],13,13,26,3395130,7,,,,9120
cd2c3fd4e6fb9863c116d01bf8d274b80867622f,0,Pierre Villard,2019-04-19 10:47:13+02:00,['8411b6a46f5a2bf83eb3899cca3374bd863da1a0'],264,0,264,3395394,1,,,,9120
512555dbb0808d1b4c5b60a6478af0578a6c9abc,0,Peter Wicks,2019-04-19 16:25:15-06:00,['cd2c3fd4e6fb9863c116d01bf8d274b80867622f'],22,45,67,3395461,1,0.846153846,0,0,9120
161e4b57632b2d5454390871980288eb66df2502,0,Koji Kawamura,2019-04-22 10:13:07+09:00,['512555dbb0808d1b4c5b60a6478af0578a6c9abc'],0,0,0,3395461,32,,,,9120
94c2b1e76ebab33b6417fb46ce046e59c51fcdca,1,Peter Wicks,2019-04-22 10:12:16-06:00,['161e4b57632b2d5454390871980288eb66df2502'],11,5,16,3395477,1,0,0,0,9120
c5d0643d1da2dbf5c2355a4ec8527073a99989f3,1,Mark Payne,2019-04-22 13:27:40-04:00,['94c2b1e76ebab33b6417fb46ce046e59c51fcdca'],11,53,64,3395541,3,0.473684211,0.473684211,0.736842105,9120
055b3cac54e3e234c0ee07189b7b7b85e0582d58,1,Koji Kawamura,2019-04-23 17:08:26+09:00,['c5d0643d1da2dbf5c2355a4ec8527073a99989f3'],89,160,249,3395790,2,0,0.84,1,9120
5e2559db427af7306128e18414f5026ae35cf517,0,Bryan Bende,2019-04-23 13:10:14-04:00,['055b3cac54e3e234c0ee07189b7b7b85e0582d58'],0,26,26,3395816,1,0.944444444,0.944444444,1,9120
d429470cc19b0a604f394cbd7181e8bf79e8fb7b,0,Mark Payne,2019-04-23 13:14:47-04:00,['5e2559db427af7306128e18414f5026ae35cf517'],1,44,45,3395861,2,0,1,1,9120
e8174fb99fd84edfeb1dda267550735db4d74638,0,Bryan Bende,2019-04-24 10:05:21-04:00,['d429470cc19b0a604f394cbd7181e8bf79e8fb7b'],2,2,4,3395865,1,,,,9120
2b83b7d9e8a090f42825ef6569d9595c95c28a33,0,Bryan Bende,2019-04-24 13:20:55-04:00,['e8174fb99fd84edfeb1dda267550735db4d74638'],3,74,77,3395942,8,0.888888889,0.888888889,0.972222222,9120
0e5a80d23f0432947b4ef05b45ea3571686304ba,0,Kevin Doran,2019-04-24 14:55:41-04:00,['2b83b7d9e8a090f42825ef6569d9595c95c28a33'],6,147,153,3396095,4,0,0,1,9122
31463c5dad38be0dcb5f8872c4b423f1f01cc786,1,Matt Gilman,2019-04-24 16:47:11-04:00,['0e5a80d23f0432947b4ef05b45ea3571686304ba'],328,192,520,3396615,25,0.992,0,1,9122
c5c9425989ebd6d2b162b599da9dd12aadc72a6d,0,Matt Gilman,2019-04-26 12:07:02-04:00,['31463c5dad38be0dcb5f8872c4b423f1f01cc786'],27,756,783,3397398,16,0.567282322,0.656992084,1,9124
0650521eb276bb4a68c271be9f49325fdcffaee0,1,Matt Gilman,2019-04-26 16:40:37-04:00,['c5c9425989ebd6d2b162b599da9dd12aadc72a6d'],30,167,197,3397595,7,0.704918033,1,1,9125
7d02ab1e2fc9a5a424b3cfe9cd4a872f5c5c97ae,0,Mike Thomsen,2019-04-27 20:02:03-04:00,['0650521eb276bb4a68c271be9f49325fdcffaee0'],0,95,95,3397690,2,1,1,1,9125
7fc49c2cb80ce765afd940d1e4209a8677e5d3f2,0,Bryan Bende,2019-04-29 13:14:49-04:00,['7d02ab1e2fc9a5a424b3cfe9cd4a872f5c5c97ae'],5,21,26,3397716,4,0.666666667,0.666666667,0.666666667,9125
5825e7bc76a7a590a14ad75041b393c92c0ad038,1,Bryan Bende,2019-04-30 09:39:24-04:00,['7fc49c2cb80ce765afd940d1e4209a8677e5d3f2'],38,3,41,3397757,1,1,0.047619048,0,9125
9194726b35ca06fc590c06674bb0cf4c7200d7b4,0,Matthew Burgess,2019-05-03 10:05:59-04:00,['5825e7bc76a7a590a14ad75041b393c92c0ad038'],2,0,2,3397759,1,,,,9125
1cadc722229ad50cf569ee107eaeeb95dc216ea2,1,Andy LoPresto,2019-05-03 20:46:35-07:00,['9194726b35ca06fc590c06674bb0cf4c7200d7b4'],17,52,69,3397828,2,0.166666667,0.8,0.833333333,9125
a5dff7b45cbba788cc499db301315a306f7a8b5c,0,Mike Thomsen,2019-05-07 11:31:17-04:00,['1cadc722229ad50cf569ee107eaeeb95dc216ea2'],1,101,102,3397930,5,0,1,1,9127
12a7456f743f524b919e4d6b7baa6c3a20a13dd9,0,Mike Thomsen,2019-05-07 11:41:50-04:00,['a5dff7b45cbba788cc499db301315a306f7a8b5c'],3,1,4,3397934,1,,,,9127
fdea4c54dfb1b66073aa1ff603b5e814721ac5a7,0,Andy LoPresto,2019-05-07 09:59:24-07:00,['12a7456f743f524b919e4d6b7baa6c3a20a13dd9'],107,437,544,3398478,9,0.825242718,0.951456311,0.844660194,9130
4484565df19e2731810c7f2bc9d32e991e6f54e8,0,Matt Gilman,2019-05-07 15:34:12-04:00,['fdea4c54dfb1b66073aa1ff603b5e814721ac5a7'],25,50,75,3398553,4,0,1,0.75,9130
25d8f64bedc3867f8eab7cd74166cc22edb91527,0,thenatog,2019-05-07 15:59:19-04:00,['4484565df19e2731810c7f2bc9d32e991e6f54e8'],2,6,8,3398561,6,0,1,1,9130
f40b7fc6bad14a64bce104b3748baa95847a674c,1,Mike Thomsen,2019-05-07 20:05:33-04:00,['25d8f64bedc3867f8eab7cd74166cc22edb91527'],3,51,54,3398615,2,0.083333333,0.083333333,1,9130
1705ee3b6656a4b347220577d90c2a71b7cbb084,0,Mike Thomsen,2019-05-07 20:26:25-04:00,['f40b7fc6bad14a64bce104b3748baa95847a674c'],2,2,4,3398619,1,,,,9130
ba642485ccad9775d5b04e94e5e7c144e93691df,0,Mike Thomsen,2019-05-07 21:58:16-04:00,['1705ee3b6656a4b347220577d90c2a71b7cbb084'],151,76,227,3398846,5,0.516129032,0,0.35483871,9130
376c344edbbeb578ecd450a48a7c9241d7dd4aeb,1,Mike Thomsen,2019-05-08 07:38:40-04:00,['ba642485ccad9775d5b04e94e5e7c144e93691df'],2,2,4,3398850,1,,,,9130
cf6f5172503ce438c6c22c334c9367f774db7b24,1,Andy LoPresto,2019-05-08 17:45:39-07:00,['376c344edbbeb578ecd450a48a7c9241d7dd4aeb'],15,381,396,3399246,8,0.136363636,0.853535354,1,9130
65c41ab917d7b5f323aa71d841cc03b29e12d480,1,thenatog,2019-05-09 12:05:12-04:00,['cf6f5172503ce438c6c22c334c9367f774db7b24'],52,212,264,3399510,28,0.603960396,0.97029703,0.168316832,9131
dc38a6bdceec0095ae322f225401b3f505af1da5,0,Mike Thomsen,2019-05-10 09:30:33-04:00,['65c41ab917d7b5f323aa71d841cc03b29e12d480'],10,15,25,3399535,6,0,0,1,9131
a2bacde62ce24acd0332b2147b4fe5834d14f210,0,Matt Gilman,2019-05-10 15:00:45-04:00,['dc38a6bdceec0095ae322f225401b3f505af1da5'],0,11,11,3399546,1,0,0,1,9131
060f4fe73f087b9de103905ee3d8dd1d1b2ee64c,1,Mike Thomsen,2019-05-10 18:20:18-04:00,['a2bacde62ce24acd0332b2147b4fe5834d14f210'],20,39,59,3399605,4,1,1,0.769230769,9131
ecc014937a71ba6a1c8c9b26aed409714833488b,0,Mike Thomsen,2019-05-11 18:26:34-04:00,['060f4fe73f087b9de103905ee3d8dd1d1b2ee64c'],22,2,24,3399629,2,,,,9131
535d65370fa3b225b59bd681ccbe4b8cf898abb3,0,Mike Thomsen,2019-05-11 19:02:59-04:00,['ecc014937a71ba6a1c8c9b26aed409714833488b'],6,6,12,3399641,1,,,,9131
95fd14866e263059c3a25bead5baa9c4c5cc368f,0,Matt Gilman,2019-05-13 09:57:19-04:00,['535d65370fa3b225b59bd681ccbe4b8cf898abb3'],6,7,13,3399654,1,,,,9131
12e210277bc1489d480c1ae99bcfed9c32203ff6,0,Andy LoPresto,2019-05-13 18:50:27-07:00,['95fd14866e263059c3a25bead5baa9c4c5cc368f'],29,317,346,3400000,12,0.201030928,0.608247423,1,9131
3a6e28eaa4e4fea7080057d02a00b189d2a7d1bd,0,Mike Thomsen,2019-05-14 06:35:45-04:00,['12e210277bc1489d480c1ae99bcfed9c32203ff6'],9,3,12,3400012,1,1,1,0,9131
7825e40d15c267deb91bf6af0df5c0e08096765e,0,Bryan Bende,2019-05-14 11:00:21-04:00,['3a6e28eaa4e4fea7080057d02a00b189d2a7d1bd'],3,10,13,3400025,3,,,,9131
595835f6ee4fa024799827f89d9b55dfabcced23,0,Mike Thomsen,2019-05-14 12:45:49-04:00,['7825e40d15c267deb91bf6af0df5c0e08096765e'],3,6,9,3400034,1,,,,9131
f08c2ee43f39584b7d4e76d61d7d4aaa889068fd,1,Bryan Bende,2019-05-14 15:31:15-04:00,['595835f6ee4fa024799827f89d9b55dfabcced23'],119,1130,1249,3401283,20,0.325581395,1,0.993355482,9139
d1fd1f50922cf658dcbe1cbbef1e583ab63b95a8,1,Mike Thomsen,2019-05-15 12:31:11-04:00,['f08c2ee43f39584b7d4e76d61d7d4aaa889068fd'],9,6,15,3401298,1,0,0,0,9139
4b509aa5a5b3d98d0a23d1c8fce090c8bee1e6d8,0,Joe Witt,2019-05-15 15:03:07-04:00,['d1fd1f50922cf658dcbe1cbbef1e583ab63b95a8'],7,795,802,3402100,2,0,0.932153392,1,9139
4d18eaa481a26609b3cb5f2d7e609ba4b3a37a1f,1,Mike Thomsen,2019-05-21 07:33:45-04:00,['4b509aa5a5b3d98d0a23d1c8fce090c8bee1e6d8'],17,106,123,3402223,7,0,0.507246377,0.028985507,9139
417b3955d796857209000f497b817268a7cf3bdb,1,Mark Payne,2019-05-21 11:19:17-04:00,['4d18eaa481a26609b3cb5f2d7e609ba4b3a37a1f'],0,5629,5629,3407852,28,0.548256538,0.719489415,0.73630137,9167
cbafd8f834813f4e23c961a282a6f44b5a62c078,1,Mark Payne,2019-05-21 11:19:17-04:00,['417b3955d796857209000f497b817268a7cf3bdb'],1544,4096,5640,3413492,57,0.33032491,0.626353791,0.532490975,9193
146689b36fb75bb1b14f408a9b7771505215ca4e,1,Mark Payne,2019-05-21 11:19:17-04:00,['cbafd8f834813f4e23c961a282a6f44b5a62c078'],954,971,1925,3415417,55,0.679487179,0.038461538,0,9197
60b8fcac1ba4dff64c28139ddf282d915f4c221b,1,Mark Payne,2019-05-21 11:19:17-04:00,['146689b36fb75bb1b14f408a9b7771505215ca4e'],39,188,227,3415644,10,0.548780488,0.743902439,0.597560976,9198
650c6aa820fca0eb8d35c506c7a2e71ca892370d,1,Mark Payne,2019-05-21 11:19:17-04:00,['60b8fcac1ba4dff64c28139ddf282d915f4c221b'],1,16,17,3415661,2,1,1,1,9198
8245bc3f804f701da52a4e64a000b04aff718948,1,Mark Payne,2019-05-21 11:19:17-04:00,['650c6aa820fca0eb8d35c506c7a2e71ca892370d'],10,30,40,3415701,6,0.090909091,0.272727273,0.181818182,9198
81ddd02ca89cc068a6367eaeae575bac5c5e2ad5,0,Mike Thomsen,2019-05-21 14:22:56-04:00,['8245bc3f804f701da52a4e64a000b04aff718948'],1,5,6,3415707,1,0,0,0,9198
c470608daf7e5d3267a73fc4b718cd738f17108a,1,Koji Kawamura,2019-05-22 16:07:17+09:00,['81ddd02ca89cc068a6367eaeae575bac5c5e2ad5'],1,2,3,3415710,1,0,1,1,9198
a97766d62f067845869c44b39604851c7ca91d02,0,Mark Payne,2019-05-22 14:12:50-04:00,['c470608daf7e5d3267a73fc4b718cd738f17108a'],0,10,10,3415720,1,0,0,0,9198
8a50cb10b20bfdbf61fa1a769b817c86eab9653a,1,Mark Payne,2019-05-22 15:44:16-04:00,['a97766d62f067845869c44b39604851c7ca91d02'],710,1501,2211,3417931,66,1,1,0.876404494,9204
fe68d43e1dfd00807ccbc43fd43bff73d49de26c,1,Andy LoPresto,2019-05-22 17:05:06-07:00,['8a50cb10b20bfdbf61fa1a769b817c86eab9653a'],85,317,402,3418333,12,0.0625,1,1,9205
b09b84226c28a01452d4e0c0796056140392ec58,1,Bryan Bende,2019-05-23 12:48:33-04:00,['fe68d43e1dfd00807ccbc43fd43bff73d49de26c'],1,45,46,3418379,2,1,1,1,9205
410854f53e4a012b75c7c0f2acc2249df024d68c,0,Matt Gilman,2019-05-24 09:52:02-04:00,['b09b84226c28a01452d4e0c0796056140392ec58'],8,8,16,3418395,2,,,,9205
0a31c38790794411ca3a9dbe6eebbc36058c7da2,0,Matt Gilman,2019-05-24 11:02:09-04:00,['410854f53e4a012b75c7c0f2acc2249df024d68c'],3,1,4,3418399,1,0,0,0,9205
2bfffd35b2d6785f6b15f4314b462a1430c6bc39,1,Mark Payne,2019-05-24 14:43:50-04:00,['0a31c38790794411ca3a9dbe6eebbc36058c7da2'],15,24,39,3418438,2,1,0.5,1,9205
6be47de87e6eb7570d22a79ce7f6d0ced54fb645,0,thenatog,2019-05-24 16:18:08-04:00,['2bfffd35b2d6785f6b15f4314b462a1430c6bc39'],7,13,20,3418458,1,,,,9205
99b20ac2d18c5c92a2c74a0459cd74655c41b73c,0,Mike Thomsen,2019-05-26 16:52:12-04:00,['6be47de87e6eb7570d22a79ce7f6d0ced54fb645'],3,5,8,3418466,2,,,,9205
6a06cd3094eccaa264d575906106504092f95cd6,0,Koji Kawamura,2019-05-28 21:06:20+09:00,['99b20ac2d18c5c92a2c74a0459cd74655c41b73c'],15,338,353,3418819,8,0.870967742,0.870967742,0.827956989,9209
e6c843f465da98fd7dc640e53214e4aeefa61b7d,1,Matt Gilman,2019-05-29 14:36:40-04:00,['6a06cd3094eccaa264d575906106504092f95cd6'],470,470,940,3419759,456,,,,9209
999cfdcac9bde93b125a809340ab9cfea6936bd6,0,Andy LoPresto,2019-05-29 14:45:00-07:00,['e6c843f465da98fd7dc640e53214e4aeefa61b7d'],4,30,34,3419793,1,0.818181818,1,0.909090909,9209
8560eb995a94a157684b2ab753f1635f8335fea3,1,Mike Thomsen,2019-05-30 08:08:07-04:00,['999cfdcac9bde93b125a809340ab9cfea6936bd6'],1,1250,1251,3421044,13,0.246445498,1,0.843601896,9220
de27ab94b0c969f8b70ec624442af7bc088aae72,0,Joe Witt,2019-05-30 09:47:00-04:00,['8560eb995a94a157684b2ab753f1635f8335fea3'],0,2,2,3421046,1,,,,9220
097b9c30754c77858aff684b113ed305cec7cf57,0,Koji Kawamura,2019-05-31 08:51:36+09:00,['de27ab94b0c969f8b70ec624442af7bc088aae72'],1,6,7,3421053,1,0,0,0,9220
a951a8ec610c128f5b0d6ade033ebdc7ccd94b11,0,Andy LoPresto,2019-05-30 18:05:40-07:00,['097b9c30754c77858aff684b113ed305cec7cf57'],4,1,5,3421058,1,,,,9220
a9d1dd7b08f7d7a9ab7056393e042dc984e817ba,0,Matthew Burgess,2019-05-31 08:44:17-04:00,['a951a8ec610c128f5b0d6ade033ebdc7ccd94b11'],29,54,83,3421141,5,,,,9220
ed19f616821ae70cbca4dfdf56e51859b61c415c,0,Andy LoPresto,2019-05-31 13:01:46-07:00,['a9d1dd7b08f7d7a9ab7056393e042dc984e817ba'],2252,0,2252,3423393,21,0.339939024,0.141768293,0.132621951,9220
407add7847f9d79ea9c7b604fd57c3160ff30c06,0,Matthew Burgess,2019-06-01 11:27:53-04:00,['ed19f616821ae70cbca4dfdf56e51859b61c415c'],3,48,51,3423444,2,0.68,0.68,1,9220
e7f4af68014ea99f1e351436d6a078ad4b3346a6,1,Koji Kawamura,2019-06-03 11:25:04+09:00,['407add7847f9d79ea9c7b604fd57c3160ff30c06'],30,214,244,3423688,9,0.737288136,0.881355932,0.838983051,9220
08d2e698788e47fb11435ab2bcd863563ca72eb7,0,Matt Gilman,2019-06-04 09:02:03-04:00,['e7f4af68014ea99f1e351436d6a078ad4b3346a6'],21,5,26,3423714,4,0.333333333,0.333333333,0.333333333,9220
60b5c13ce95fd4d4a5edf0f08b81af19e71b67ee,0,Bryan Bende,2019-06-04 09:55:26-04:00,['08d2e698788e47fb11435ab2bcd863563ca72eb7'],47,27,74,3423788,2,0,0,0,9220
1d18735076d134af2ec7c484c982746e261ed4a5,0,Bryan Bende,2019-06-05 10:00:12-04:00,['60b5c13ce95fd4d4a5edf0f08b81af19e71b67ee'],1,64,65,3423853,2,0,0.973684211,1,9220
2d3fce81c1876747c5296991a9eb11304dc6c6a4,0,Andy LoPresto,2019-06-05 19:25:13-07:00,['1d18735076d134af2ec7c484c982746e261ed4a5'],1,1,2,3423855,1,,,,9220
aefdc9377cc00c82ab70d44da5effd42da63bb04,0,Koji Kawamura,2019-06-07 17:55:52+09:00,['2d3fce81c1876747c5296991a9eb11304dc6c6a4'],26,258,284,3424139,18,0,1,0.944444444,9223
99d6ed244cd8808646eaa9fbf446e4be36defafc,1,Kevin Doran,2019-06-07 15:30:38-04:00,['aefdc9377cc00c82ab70d44da5effd42da63bb04'],81,296,377,3424516,4,0.066666667,0,0,9223
0b8d05aabd75696118963ac6535fd657b5dd5706,0,Koji Kawamura,2019-06-10 14:18:55+09:00,['99d6ed244cd8808646eaa9fbf446e4be36defafc'],67,40,107,3424623,6,,,,9225
99350b761dda3458757563b633ed21e5524257d4,1,Koji Kawamura,2019-06-10 14:33:11+09:00,['0b8d05aabd75696118963ac6535fd657b5dd5706'],24,53,77,3424700,3,0,1,1,9225
1975101292fcd0fceb0d30594da54e5257bc7700,0,Koji Kawamura,2019-06-10 15:45:19+09:00,['99350b761dda3458757563b633ed21e5524257d4'],3,222,225,3424925,2,0.258741259,0.993006993,1,9226
f15332ff87b2aee04a87c8577184294d662bd020,1,Mark Payne,2019-06-11 09:45:46-04:00,['1975101292fcd0fceb0d30594da54e5257bc7700'],1344,1293,2637,3427562,46,1,1,0,9235
05f3cadee8ee76aa05a1d35ffb4598ddeca4f549,1,Koji Kawamura,2019-06-12 10:32:11+09:00,['f15332ff87b2aee04a87c8577184294d662bd020'],4,107,111,3427673,2,0,0,0,9235
91584987198b2c2c6060f324df8ce79f38d16226,0,Koji Kawamura,2019-06-12 15:08:49+09:00,['05f3cadee8ee76aa05a1d35ffb4598ddeca4f549'],59,59,118,3427791,1,,,,9235
e913f5706f3b3a0a2e98cf77ac4c96f63ba4f104,0,Koji Kawamura,2019-06-12 15:31:39+09:00,['91584987198b2c2c6060f324df8ce79f38d16226'],20,232,252,3428043,6,0.328125,1,0.671875,9235
2465f67dfe4132b3a52c14a7c0bb9cbdf21e507c,0,Bryan Bende,2019-06-12 10:56:04-04:00,['e913f5706f3b3a0a2e98cf77ac4c96f63ba4f104'],4,9,13,3428056,1,0,0.5,0,9235
8bed249f37bfe5102c38c0e280c213c6705f6965,1,Bryan Bende,2019-06-12 11:32:41-04:00,['2465f67dfe4132b3a52c14a7c0bb9cbdf21e507c'],2,12,14,3428070,3,0.857142857,0.857142857,1,9235
3e7816da43cabf95f26f80fcf4dae2dfd848dfa1,0,Matthew Burgess,2019-06-12 15:25:42-04:00,['8bed249f37bfe5102c38c0e280c213c6705f6965'],75,731,806,3428876,12,0.256521739,0.569565217,0.760869565,9242
75fb34c8ee4fd364fbfa81c433b2cc26304a33f7,1,Andy LoPresto,2019-06-12 16:40:49-07:00,['3e7816da43cabf95f26f80fcf4dae2dfd848dfa1'],18,584,602,3429478,15,0.563218391,0.735632184,0.735632184,9251
2102d8a0bd4478ae9d89907c91cfcdf9af8bd835,1,Matt Gilman,2019-06-13 10:42:13-04:00,['75fb34c8ee4fd364fbfa81c433b2cc26304a33f7'],28,132,160,3429638,11,0.351351351,0.459459459,0.959459459,9251
68d05ab575767c812dbbf7507859a1a59fbba37e,1,Mark Payne,2019-06-13 11:34:06-04:00,['2102d8a0bd4478ae9d89907c91cfcdf9af8bd835'],295,617,912,3430550,97,0.628571429,0.942857143,0.994285714,9252
c456b30b9b75c6c6c48a57917196e32d8ab181e2,0,Mark Payne,2019-06-13 11:34:06-04:00,['68d05ab575767c812dbbf7507859a1a59fbba37e'],192,211,403,3430953,95,,,,9252
aab3af4b718f2174f23d14c30765a74492da758f,0,Mark Payne,2019-06-13 11:36:33-04:00,['c456b30b9b75c6c6c48a57917196e32d8ab181e2'],0,0,0,3430953,0,,,,9252
0e1a37fcb9bc6fcc5c801a34d19673745c908437,0,Koji Kawamura,2019-06-17 17:19:09+09:00,['aab3af4b718f2174f23d14c30765a74492da758f'],14,19,33,3430986,10,,,,9252
c7768c909a95cda591ef5c44cdabf530c508a782,0,GitHub,2019-06-17 08:22:19-04:00,['0e1a37fcb9bc6fcc5c801a34d19673745c908437'],82,1370,1452,3432438,80,0.643442623,0.971311475,0.928278689,9268
1d560e2b021bc796fe3adc957270daa3be621668,1,Mike Thomsen,2019-06-17 12:21:07-04:00,['c7768c909a95cda591ef5c44cdabf530c508a782'],1529,1510,3039,3435477,192,1,0,0,9268
64b0d88d833fce1df5308b795736f1a3b6a64c51,0,Joe Witt,2019-06-19 12:39:15-04:00,['1d560e2b021bc796fe3adc957270daa3be621668'],2,1,3,3435480,2,,,,9268
e7aac049ef096369096cb0161d4088caf99eb616,0,Joe Witt,2019-06-19 12:41:18-04:00,['64b0d88d833fce1df5308b795736f1a3b6a64c51'],1,1,2,3435482,1,,,,9268
82a6c430a4cea116d011991173f867c8bc3fc35e,1,Matthew Burgess,2019-06-19 15:50:42-04:00,['e7aac049ef096369096cb0161d4088caf99eb616'],694,1774,2468,3437950,48,1,1,0.963235294,9274
c352c2cc3efc03821aa4ef16b6e7ffa45c99843f,0,Matthew Burgess,2019-06-20 12:34:43-04:00,['82a6c430a4cea116d011991173f867c8bc3fc35e'],1,34,35,3437985,6,,,,9276
1b28c7b45c3eb4b7c58214ae64688226fcb866b1,1,Matthew Burgess,2019-06-20 13:38:59-04:00,['c352c2cc3efc03821aa4ef16b6e7ffa45c99843f'],0,1438,1438,3439423,13,0.507575758,1,0.962121212,9286
82f177c63245b2d14204ff3b45e09860af8ede47,1,Matthew Burgess,2019-06-20 13:39:20-04:00,['1b28c7b45c3eb4b7c58214ae64688226fcb866b1'],881,3197,4078,3443501,45,0.480916031,0.671755725,0.053435115,9319
58ae7d4f9248f336d8bc357096736b66d6dcddc0,0,Mike Thomsen,2019-06-20 19:10:22-04:00,['82f177c63245b2d14204ff3b45e09860af8ede47'],1,1,2,3443503,1,,,,9319
e973cacb2fe349028dae03b85a00ed89f3049967,1,Andy LoPresto,2019-06-20 16:22:42-07:00,['58ae7d4f9248f336d8bc357096736b66d6dcddc0'],2,1590,1592,3445095,18,0.395899054,0.916403785,0.922712934,9329
f1ae05974e305b8487b26a87338d2faf9c2d851f,0,Koji Kawamura,2019-07-01 17:58:22+09:00,['e973cacb2fe349028dae03b85a00ed89f3049967'],24,220,244,3445339,2,0.073333333,0.58,1,9329
3d21059e95920ded8034e0bdc7d318571ffef54a,0,Jeff Storck,2019-07-01 16:35:24-04:00,['f1ae05974e305b8487b26a87338d2faf9c2d851f'],14,44,58,3445397,5,0,0.137931034,1,9329
41663929a4727592972e6be04b3c516a752e760e,1,Koji Kawamura,2019-07-02 11:54:44+09:00,['3d21059e95920ded8034e0bdc7d318571ffef54a'],3,27,30,3445427,1,0,1,1,9329
40dcd1577b5738f06f480196d74c76c779ac057b,1,Matt Gilman,2019-07-02 10:15:52-04:00,['41663929a4727592972e6be04b3c516a752e760e'],12,188,200,3445627,2,0,0,1,9329
846c9b0a3fbbe7ca366b34c89e0f5885750b8a59,0,Matt Gilman,2019-07-02 16:02:39-04:00,['40dcd1577b5738f06f480196d74c76c779ac057b'],1,1,2,3445629,1,,,,9329
0857d5f89dd47863698e54544dd5871975a154b4,0,Matthew Burgess,2019-07-03 13:30:12-04:00,['846c9b0a3fbbe7ca366b34c89e0f5885750b8a59'],5,0,5,3445634,1,,,,9329
44b84a678f0c0c9769351e0418ec71ab42e966da,0,Koji Kawamura,2019-07-05 15:02:05+09:00,['0857d5f89dd47863698e54544dd5871975a154b4'],0,572,572,3446206,3,0.445205479,0.732876712,1,9331
5127cb209a8382e07eb8ee27ee16e79f16e2f97e,0,Mike Thomsen,2019-07-06 18:39:29-04:00,['44b84a678f0c0c9769351e0418ec71ab42e966da'],0,3,3,3446209,1,0,1,1,9331
f851ed4887e503c49bd254357b703c6a66afa2fa,0,Mark Payne,2019-07-08 12:25:59-04:00,['5127cb209a8382e07eb8ee27ee16e79f16e2f97e'],2,41,43,3446252,1,0,1,1,9331
31097c96d6f77e1493c331f76838190d4df2b9e2,0,Mark Payne,2019-07-09 09:44:04-04:00,['f851ed4887e503c49bd254357b703c6a66afa2fa'],0,361,361,3446613,3,0.166666667,0.595238095,1,9332
95f5b2278ca44b0a6d1be208cf404fae102c81e0,0,Mike Thomsen,2019-07-09 12:08:27-04:00,['31097c96d6f77e1493c331f76838190d4df2b9e2'],45,36,81,3446694,15,,,,9332
fa1ed16e2bfc389466941e3bfe36a7a6ff08403b,1,Koji Kawamura,2019-07-10 11:38:20+09:00,['95f5b2278ca44b0a6d1be208cf404fae102c81e0'],4,31,35,3446729,3,0,0.611111111,1,9332
15b0f1cfc2d022005c90f4852a2696b19c5ac816,0,Joe Witt,2019-07-10 12:51:46-04:00,['fa1ed16e2bfc389466941e3bfe36a7a6ff08403b'],2,6,8,3446737,1,0,1,0,9332
0ccc346aec1828d0522631247b3ef22de6a8cee2,1,Yolanda Davis,2019-07-10 23:46:13-04:00,['15b0f1cfc2d022005c90f4852a2696b19c5ac816'],421,597,1018,3447755,5,0,0.870689655,0.629310345,9332
4783b12a9ccfcd744e2c909447810c3c6870a0a4,1,Mike Thomsen,2019-07-11 14:17:35-04:00,['0ccc346aec1828d0522631247b3ef22de6a8cee2'],315,2761,3076,3450831,44,,,,9332
24e50953a3e2dde4cda0261e4f7dba083d5ed602,0,Koji Kawamura,2019-07-12 17:07:02+09:00,['4783b12a9ccfcd744e2c909447810c3c6870a0a4'],2,109,111,3450942,5,0.28358209,1,0.71641791,9333
e277545cea0bfc79fd7fc54c77a3d873df3853d1,0,Koji Kawamura,2019-07-12 17:07:11+09:00,['24e50953a3e2dde4cda0261e4f7dba083d5ed602'],0,1,1,3450943,1,1,1,1,9333
f2db1539a84c4e265edc9ad0c403fe61e7c57c6c,0,Koji Kawamura,2019-07-16 13:43:26+09:00,['e277545cea0bfc79fd7fc54c77a3d873df3853d1'],32,32,64,3451007,2,1,1,0.666666667,9333
3fb445437580bf47f1bec2b553aaff5424eb9eef,1,Pierre Villard,2019-07-18 16:01:32+02:00,['f2db1539a84c4e265edc9ad0c403fe61e7c57c6c'],12,13,25,3451032,7,0,1,1,9333
d8388c1887375ce5323114da24b56c74bf4658fc,1,Pierre Villard,2019-07-18 16:16:34+02:00,['3fb445437580bf47f1bec2b553aaff5424eb9eef'],6,73,79,3451111,3,0,0,0.84,9333
2b0b96e59ed8f73c2756a0515a38bc7c6aee6552,0,Andy LoPresto,2019-07-18 11:08:07-07:00,['d8388c1887375ce5323114da24b56c74bf4658fc'],7,7,14,3451125,7,,,,9333
630c651226228ab2ed990d679b7588b93303682e,0,Koji Kawamura,2019-07-19 13:49:23+09:00,['2b0b96e59ed8f73c2756a0515a38bc7c6aee6552'],2,12,14,3451139,2,1,1,1,9333
3bfef3356e158d8691008e3675bb7a5cc65064fb,1,Koji Kawamura,2019-07-19 14:47:07+09:00,['630c651226228ab2ed990d679b7588b93303682e'],13,28,41,3451180,3,1,1,1,9333
6d5acf1cb2fa7e802c5aac84a0a4a0f9d8eaf1c3,0,Matt Gilman,2019-07-22 15:47:24-04:00,['3bfef3356e158d8691008e3675bb7a5cc65064fb'],1,2,3,3451183,1,,,,9333
c6e6a418aa1ff78bf508b75dc923f6c8965bb76b,1,Koji Kawamura,2019-07-25 17:04:22+09:00,['6d5acf1cb2fa7e802c5aac84a0a4a0f9d8eaf1c3'],1331,1877,3208,3454391,65,0.358433735,0.954819277,0.786144578,9334
7dda04e8951228992681538ef3cca4eb99fce026,0,Peter Wicks,2019-07-25 13:54:12-06:00,['c6e6a418aa1ff78bf508b75dc923f6c8965bb76b'],1,1,2,3454393,1,,,,9334
d1c30d14777354de2288b67184ffe9e1ceb98cf1,1,Mark Payne,2019-07-26 11:27:06-04:00,['7dda04e8951228992681538ef3cca4eb99fce026'],8,261,269,3454662,2,0.355263158,0.934210526,0.921052632,9335
66e3617ba73808515a04f85bda4130e9a1ff2efd,0,Koji Kawamura,2019-07-29 11:42:33+09:00,['d1c30d14777354de2288b67184ffe9e1ceb98cf1'],16,24,40,3454702,2,,,,9335
f8e93186f53917b1fddbc2ae3de26b65a99b9246,1,Bryan Bende,2019-07-29 10:28:53-04:00,['66e3617ba73808515a04f85bda4130e9a1ff2efd'],60,289,349,3455051,12,0.280821918,0.493150685,0,9335
1d22e8a86d001540bb86d017a9139393778628cb,0,Koji Kawamura,2019-07-31 16:36:42+09:00,['f8e93186f53917b1fddbc2ae3de26b65a99b9246'],4,122,126,3455177,3,0,0.8,1,9335
cdee1d8c09c52dd2aa78311cf8c8fe9b2f449d44,1,Koji Kawamura,2019-07-31 16:47:54+09:00,['1d22e8a86d001540bb86d017a9139393778628cb'],18,117,135,3455312,4,0.266666667,0.95,0.9,9335
639e81e5a12f5fccb35a581e009eee5bcdb4bff6,0,Koji Kawamura,2019-07-31 17:07:37+09:00,['cdee1d8c09c52dd2aa78311cf8c8fe9b2f449d44'],2,18,20,3455332,4,0,0.5,1,9335
a9a4b765b179ceb573b87c17a8a1ab495b80e84a,0,Bryan Bende,2019-08-01 15:21:53-04:00,['639e81e5a12f5fccb35a581e009eee5bcdb4bff6'],7,7,14,3455346,1,,,,9335
f851a9e96fa72cb7fe8a5a2bcb177e3e59ec1f61,0,Aldrin Piri,2019-08-02 09:03:49-04:00,['a9a4b765b179ceb573b87c17a8a1ab495b80e84a'],1,1,2,3455348,1,,,,9335
4f50f30ad7329540a707be835c23acee86d4cfb4,1,Matt Gilman,2019-08-02 10:45:39-04:00,['f851a9e96fa72cb7fe8a5a2bcb177e3e59ec1f61'],1995,11317,13312,3468660,312,0.441880905,0.650406504,0.749945067,9401
944d256d3130aa37ec5473a79067270b6667ee70,0,Matt Gilman,2019-08-02 14:21:56-04:00,['4f50f30ad7329540a707be835c23acee86d4cfb4'],1,0,1,3468661,1,,,,9401
05cbf8b24ff6b17c69cc12311d7a786c295d75b4,1,Pierre Villard,2019-08-05 10:30:50+02:00,['944d256d3130aa37ec5473a79067270b6667ee70'],5,28,33,3468694,2,0.6,0.6,0.6,9401
52645e8aa70525b87001376b4cbfc85f0753ca14,1,Pierre Villard,2019-08-06 09:25:23+02:00,['05cbf8b24ff6b17c69cc12311d7a786c295d75b4'],1,1,2,3468696,1,,,,9401
164e0c41867bb3a486f077dbd79e8c9d379120e8,0,Matt Gilman,2019-08-06 10:19:20-04:00,['52645e8aa70525b87001376b4cbfc85f0753ca14'],1,11,12,3468708,1,1,1,1,9401
2491c51d34a4012dd6c9058f60f80ea2203e311b,0,Pierre Villard,2019-08-07 09:42:20+02:00,['164e0c41867bb3a486f077dbd79e8c9d379120e8'],86,311,397,3469105,8,0.844155844,1,0.935064935,9403
403c07d4e8462b5ffc6b50ed9f63a9095c94daed,1,Pierre Villard,2019-08-08 21:39:20+02:00,['2491c51d34a4012dd6c9058f60f80ea2203e311b'],91,171,262,3469367,4,0.185714286,1,0.914285714,9403
b938fc20a3cf93547e3250f850db33eacb8ab083,1,Koji Kawamura,2019-08-09 16:29:40+09:00,['403c07d4e8462b5ffc6b50ed9f63a9095c94daed'],26,58,84,3469451,1,0,1,0.571428571,9403
a5bdecbd25a5ef46bd75bdb926d44cde8bc79c96,1,Pierre Villard,2019-08-09 10:37:29+02:00,['b938fc20a3cf93547e3250f850db33eacb8ab083'],28,70,98,3469549,4,0.5,0.958333333,1,9403
35d79eaf0fbd2361b3950a8417cb5f5b82d8cd44,1,Mark Payne,2019-08-09 15:22:14-04:00,['a5bdecbd25a5ef46bd75bdb926d44cde8bc79c96'],271,125,396,3469945,13,0,0,0.096774194,9404
2baafcc2e688d84f1531aa95bf7a6c6203fbdb6b,0,Matthew Burgess,2019-08-09 17:19:26-04:00,['35d79eaf0fbd2361b3950a8417cb5f5b82d8cd44'],0,44,44,3469989,3,0,0.571428571,1,9404
7d77b464ccfbd86ff1f2057c44bc35580d7f9fe2,1,Brandon,2019-08-12 19:03:38+00:00,['2baafcc2e688d84f1531aa95bf7a6c6203fbdb6b'],27,3409,3436,3473425,11,0.387046632,0.687564767,0.967357513,9411
32c46f0bdd49f039cabebe7c6652693e6948081f,1,Pierre Villard,2019-08-13 09:15:10+02:00,['7d77b464ccfbd86ff1f2057c44bc35580d7f9fe2'],3,238,241,3473666,4,0.086705202,0.976878613,1,9411
e841f4d5b7da7cf88cbb1805d351bf75ca8a3280,1,Andy LoPresto,2019-08-13 12:18:46-07:00,['32c46f0bdd49f039cabebe7c6652693e6948081f'],32,1347,1379,3475045,22,0.544857768,0.925601751,0.772428884,9423
b99cecd4e7da9e37d8a8d634f6673d7fd81b55bd,0,Pierre Villard,2019-08-14 00:16:17+02:00,['e841f4d5b7da7cf88cbb1805d351bf75ca8a3280'],2,2,4,3475049,2,,,,9423
33187f8058b0f0a5808059795c5982dac24e5300,1,thenatog,2019-08-13 18:41:39-04:00,['b99cecd4e7da9e37d8a8d634f6673d7fd81b55bd'],97,1267,1364,3476413,52,0.506493506,0.844155844,0.701298701,9423
f671a37aedd273203861c20d7840979b7262d8d6,1,Pierre Villard,2019-08-15 00:37:49+02:00,['33187f8058b0f0a5808059795c5982dac24e5300'],15,83,98,3476511,1,,,,9423
5f696482b06b868c88a96cf6666e21642dea386b,1,Brandon,2019-08-15 15:28:48+00:00,['f671a37aedd273203861c20d7840979b7262d8d6'],4,120,124,3476635,3,,,,9423
9c8f40415e61ee421e6f12d4e145f07984393f91,0,Mike Thomsen,2019-08-16 05:45:48-04:00,['5f696482b06b868c88a96cf6666e21642dea386b'],2,30,32,3476667,3,0,0,1,9423
bcf373a049dd8d393b8cc3c36e2a26950d07a636,1,Bryan Bende,2019-08-16 16:47:27-04:00,['9c8f40415e61ee421e6f12d4e145f07984393f91'],153,530,683,3477350,25,0.643617021,0.840425532,0.388297872,9426
bd8342c5e06e71846d1e5976bfe9de45690b974d,1,Bryan Bende,2019-08-16 16:47:49-04:00,['bcf373a049dd8d393b8cc3c36e2a26950d07a636'],55,901,956,3478306,16,0.331786543,0.955916473,0.723897912,9428
16f3dbdc6a2ac2d1b666f060792a29c7fc9eec89,0,Mark Payne,2019-08-19 11:16:44-04:00,['bd8342c5e06e71846d1e5976bfe9de45690b974d'],16,1600,1616,3479922,24,0.505988024,0.869760479,0.941616766,9444
e32689a60262110c9ff0ee6c4c9a3623ea789e57,0,Mark Payne,2019-08-19 15:33:26-04:00,['16f3dbdc6a2ac2d1b666f060792a29c7fc9eec89'],24,26,50,3479972,9,0,0.6,0.8,9444
326bc91405aefadc7a86f8d4bb0ad3be54024faa,0,Bryan Bende,2019-08-19 17:04:05-04:00,['e32689a60262110c9ff0ee6c4c9a3623ea789e57'],26,156,182,3480154,5,0,0.871794872,1,9444
81136bf5502458521eb4841be7e45b3f6223241b,0,Mike Thomsen,2019-08-19 17:26:19-04:00,['326bc91405aefadc7a86f8d4bb0ad3be54024faa'],24,739,763,3480917,10,0.444444444,0.594982079,0.534050179,9447
e822a1612b9121106a2644931e0717ddf8804bfe,0,Mike Thomsen,2019-08-19 21:15:56-04:00,['81136bf5502458521eb4841be7e45b3f6223241b'],2,2,4,3480921,1,,,,9447
1cb1b00c090afc85e5c4024a0339d5b508c231f8,0,Koji Kawamura,2019-08-20 10:59:00+09:00,['e822a1612b9121106a2644931e0717ddf8804bfe'],0,1,1,3480922,1,0,0,1,9447
00f0f84856226ac39c92807c01945bb017e99bb4,1,Koji Kawamura,2019-08-20 11:55:54+09:00,['1cb1b00c090afc85e5c4024a0339d5b508c231f8'],2,2,4,3480926,1,,,,9447
0b74795578ab929a672c07b0ee92d3912bcfa83f,1,Pierre Villard,2019-08-20 11:13:55+02:00,['00f0f84856226ac39c92807c01945bb017e99bb4'],0,37,37,3480963,6,1,1,1,9447
bb9758be2cc2f1dd3d58166025d55f37d770823d,0,Mike Thomsen,2019-08-23 22:34:39-04:00,['0b74795578ab929a672c07b0ee92d3912bcfa83f'],1,282,283,3481246,8,0.117647059,0.607843137,0.617647059,9450
cc88dd428f6784e1bf8c72a52ed291fed96eb80b,1,Koji Kawamura,2019-08-26 10:57:28+09:00,['bb9758be2cc2f1dd3d58166025d55f37d770823d'],36,131,167,3481413,7,0.685185185,0.907407407,0.907407407,9451
3de81d618ea45bd6cf26c33ccabf94b561733d67,0,Koji Kawamura,2019-08-26 11:02:35+09:00,['cc88dd428f6784e1bf8c72a52ed291fed96eb80b'],73,74,147,3481560,1,1,0,0,9451
fbd201f1162609cf2d85875980c19d4ca25b2b22,0,Andy LoPresto,2019-08-27 18:58:04-04:00,['3de81d618ea45bd6cf26c33ccabf94b561733d67'],7,10,17,3481577,5,,,,9451
3c9426d287d34a617496fc75b1e1ffde485da2e4,1,Pierre Villard,2019-08-28 10:33:13+02:00,['fbd201f1162609cf2d85875980c19d4ca25b2b22'],44,124,168,3481745,2,0.262295082,0.295081967,0.901639344,9451
59734dad88303591c96b175ab81d6415c6b5e04c,1,Bryan Bende,2019-08-28 10:38:56-04:00,['3c9426d287d34a617496fc75b1e1ffde485da2e4'],17,185,202,3481947,6,0.201834862,0.532110092,0.596330275,9451
b78aeb67a1aa29ff86515467e5e2ffdb463af0c3,1,Mark Payne,2019-08-28 11:29:00-04:00,['59734dad88303591c96b175ab81d6415c6b5e04c'],7,13,20,3481967,1,0,0,0,9451
e2ca50e66a3b1a7d810ea8eac256d21bca3fd07f,0,Joe Witt,2019-08-28 19:42:47-04:00,['b78aeb67a1aa29ff86515467e5e2ffdb463af0c3'],0,43,43,3482010,2,0.65625,0.65625,1,9451
01503b51870158b389c0e0c087c79338bfb36d0c,0,Pierre Villard,2019-08-29 11:42:19+02:00,['e2ca50e66a3b1a7d810ea8eac256d21bca3fd07f'],0,1,1,3482011,1,,,,9451
4ae1fec78a77be5b9b06bd79fa22ae020f3365bc,1,Bryan Bende,2019-08-29 10:35:03-04:00,['01503b51870158b389c0e0c087c79338bfb36d0c'],4,17,21,3482032,3,0,1,0.777777778,9451
2e554cbb67bd96e0a38a202e96cd9a58de5260a0,0,Bryan Bende,2019-08-29 10:58:25-04:00,['4ae1fec78a77be5b9b06bd79fa22ae020f3365bc'],24,32,56,3482088,1,,,,9451
f678c75d7004656918d42496666db49350515cc2,1,Matt Gilman,2019-08-29 14:48:53-04:00,['2e554cbb67bd96e0a38a202e96cd9a58de5260a0'],105,3331,3436,3485524,39,0.426360726,0.863927428,0.921558164,9457
254a84d74da1cd5299e67605e8e20e6e4f839457,1,Bryan Bende,2019-08-29 16:24:40-04:00,['f678c75d7004656918d42496666db49350515cc2'],17,38,55,3485579,3,1,1,1,9458
5df6b0edbb8de259c871e7843c2057b6938af20f,0,Mike Thomsen,2019-08-29 18:13:09-04:00,['254a84d74da1cd5299e67605e8e20e6e4f839457'],52,260,312,3485891,8,1,0.684931507,0.260273973,9459
07baf723f72d0190cb8ba40b9ecf75ff3f23e3e0,1,Andy I. Christianson,2019-08-30 13:38:38-04:00,['5df6b0edbb8de259c871e7843c2057b6938af20f'],312,573,885,3486776,12,0.176470588,0.727272727,0.85026738,9459
75e452b45c5d3096667b8acbd1ae1ad1444e7e12,0,Scott Aslan,2019-08-30 13:51:37-04:00,['07baf723f72d0190cb8ba40b9ecf75ff3f23e3e0'],575,912,1487,3488263,15,0.601941748,0.883495146,0.946601942,9460
7228496801735054c44fb9d0dbc75ce51be05f56,0,Scott Aslan,2019-08-30 13:51:37-04:00,['75e452b45c5d3096667b8acbd1ae1ad1444e7e12'],2,230,232,3488495,4,0.225806452,1,0.978494624,9460
d93ae47afcdea8df6982f9d093830caa607a833c,0,Scott Aslan,2019-08-30 13:51:37-04:00,['7228496801735054c44fb9d0dbc75ce51be05f56'],72,265,337,3488832,3,0.164179104,0.223880597,0.910447761,9460
d18c98ce780447b2059872a45a0200f578587d4e,0,Scott Aslan,2019-08-30 13:51:37-04:00,['d93ae47afcdea8df6982f9d093830caa607a833c'],252,329,581,3489413,2,0.377777778,0,1,9460
5b409d6facd92d288f87c0b379f9cb8b8cafb631,0,Scott Aslan,2019-08-30 13:51:37-04:00,['d18c98ce780447b2059872a45a0200f578587d4e'],79,174,253,3489666,5,0.404761905,0.785714286,0.880952381,9460
e5850fa1a3e37daabd6b6596c869ac903daf340a,0,Scott Aslan,2019-08-30 13:51:37-04:00,['5b409d6facd92d288f87c0b379f9cb8b8cafb631'],102,167,269,3489935,7,1,0,0.869565217,9460
f318a8c68524a268b819b1faa1b37f3f9e3190a4,0,Scott Aslan,2019-08-30 13:51:37-04:00,['e5850fa1a3e37daabd6b6596c869ac903daf340a'],0,6,6,3489941,1,0,0,1,9460
c6e500dfa44704568b58d5a867eb51eff91fd4da,0,Scott Aslan,2019-08-30 13:51:37-04:00,['f318a8c68524a268b819b1faa1b37f3f9e3190a4'],17,13,30,3489971,2,1,0,1,9460
bfbf3b753276015523fd9e56e397c8d3039fdfdb,0,Scott Aslan,2019-08-30 13:53:12-04:00,['c6e500dfa44704568b58d5a867eb51eff91fd4da'],1,2,3,3489974,2,0,1,1,9460
fc3477bd69be066ba7f75b90f9e58e18ee3b176c,0,Matthew Burgess,2019-08-30 14:01:44-04:00,['bfbf3b753276015523fd9e56e397c8d3039fdfdb'],3,13,16,3489990,5,0.75,1,1,9460
26b203616e79032bdcd47ac927d488a2ce68c656,1,Pierre Villard,2019-09-01 13:34:55+02:00,['fc3477bd69be066ba7f75b90f9e58e18ee3b176c'],197,401,598,3490588,6,0.511363636,0.715909091,0.522727273,9461
9ba280680ff8b40b15d460e6f822c2b10d4373c3,0,Koji Kawamura,2019-09-02 11:51:03+09:00,['26b203616e79032bdcd47ac927d488a2ce68c656'],60,62,122,3490710,3,1,1,1,9461
180a188096905ec3c599f45a4c0235778951fb7c,0,Mark Payne,2019-09-03 11:32:03-04:00,['9ba280680ff8b40b15d460e6f822c2b10d4373c3'],1,2,3,3490713,1,0,0,1,9461
07e1c11520aa5490c6d10afae17ab74b2fab0d1c,0,Scott Aslan,2019-09-03 12:08:19-04:00,['180a188096905ec3c599f45a4c0235778951fb7c'],38,53,91,3490804,1,,,,9461
4851e00f1da758468984c198b8e9f49a006d5f0c,0,Matt Gilman,2019-09-03 12:55:55-04:00,['07e1c11520aa5490c6d10afae17ab74b2fab0d1c'],2,50,52,3490856,3,0,0,1,9461
459ef24e99dc6fcdea53e6b264adba048b7c0592,0,Matt Gilman,2019-09-03 13:28:06-04:00,['4851e00f1da758468984c198b8e9f49a006d5f0c'],1,35,36,3490892,1,0.8,1,0.833333333,9461
a2edc2aa870ee465b70d9b5e319548e478e481a9,0,Bryan Bende,2019-09-03 13:48:05-04:00,['459ef24e99dc6fcdea53e6b264adba048b7c0592'],0,25,25,3490917,4,0.705882353,0.058823529,1,9461
4c6c1cbb14aaedda649981f76d71ced2e8a36eac,0,Andy LoPresto,2019-09-03 10:59:20-07:00,['a2edc2aa870ee465b70d9b5e319548e478e481a9'],121,340,461,3491378,6,0.034722222,0.805555556,0.916666667,9461
768a7b8c004f2ab0a4284ab29479cd917f486c1b,0,Matthew Burgess,2019-09-03 15:06:22-04:00,['4c6c1cbb14aaedda649981f76d71ced2e8a36eac'],2,16,18,3491396,1,1,1,0.083333333,9461
9071e5baa7a8af03392fce703d539e9fa94980be,0,Matthew Burgess,2019-09-03 15:45:08-04:00,['768a7b8c004f2ab0a4284ab29479cd917f486c1b'],29,12,41,3491437,2,0.428571429,0.285714286,0,9461
76c2c3fee298ae33775ce794fef7f3a0851eb179,1,Mike Thomsen,2019-09-04 08:52:17-04:00,['9071e5baa7a8af03392fce703d539e9fa94980be'],314,1339,1653,3493090,69,0.777777778,0.839506173,0.832098765,9471
6731e4c8eeee69e518362839e470274c90b58a5b,0,Bryan Bende,2019-09-04 11:49:19-04:00,['76c2c3fee298ae33775ce794fef7f3a0851eb179'],1,3,4,3493094,1,,,,9471
78d9f13ded17901741ffe72801611c4a59f0489a,0,Joe Witt,2019-09-04 17:47:59-04:00,['6731e4c8eeee69e518362839e470274c90b58a5b'],1,5,6,3493100,2,0,1,1,9471
eddc5624d8b4da4707d790c563c929dfd1af4bf1,0,Scott Aslan,2019-09-05 13:39:47-04:00,['78d9f13ded17901741ffe72801611c4a59f0489a'],127,418,545,3493645,6,0.382716049,0.728395062,0.938271605,9471
f3a04521c2cb37c1bc03a0c458e90889b43a9878,0,Scott Aslan,2019-09-05 13:39:47-04:00,['eddc5624d8b4da4707d790c563c929dfd1af4bf1'],10,22,32,3493677,1,0,1,0,9471
aa07378a0322ca314524154066dc552739adbae5,0,Scott Aslan,2019-09-05 13:39:47-04:00,['f3a04521c2cb37c1bc03a0c458e90889b43a9878'],85,56,141,3493818,1,1,0,0,9471
10b4f6fd89cfb7f996a9ab1258eee7c8e00f6a8a,0,Scott Aslan,2019-09-05 13:39:47-04:00,['aa07378a0322ca314524154066dc552739adbae5'],19,37,56,3493874,2,0,0.625,0.625,9471
385c06750705c280f0768f214d3c5bfb63b4b4ef,0,Scott Aslan,2019-09-05 13:39:47-04:00,['10b4f6fd89cfb7f996a9ab1258eee7c8e00f6a8a'],13,18,31,3493905,1,1,0,0,9471
5936fe34877ca1a5730b7f7fe5fda6cd16ff9213,0,Scott Aslan,2019-09-05 13:39:47-04:00,['385c06750705c280f0768f214d3c5bfb63b4b4ef'],0,2,2,3493907,1,1,1,1,9471
93d99820b775b48905ad670ad5bcda7b7535186f,0,Scott Aslan,2019-09-05 13:39:47-04:00,['5936fe34877ca1a5730b7f7fe5fda6cd16ff9213'],30,40,70,3493977,4,1,1,1,9471
183ece194e1ca6957981f8521a5d6813f1310f4e,0,Scott Aslan,2019-09-05 13:39:47-04:00,['93d99820b775b48905ad670ad5bcda7b7535186f'],1,1,2,3493979,1,,,,9471
a52d17628a0ebfab6ca749abf546a9e5e0875eff,0,Scott Aslan,2019-09-05 13:39:47-04:00,['183ece194e1ca6957981f8521a5d6813f1310f4e'],15,10,25,3494004,1,1,1,1,9471
5cbade7b1d6ab3fe19827d393b4066db677ed309,1,Scott Aslan,2019-09-05 13:39:48-04:00,['a52d17628a0ebfab6ca749abf546a9e5e0875eff'],6,14,20,3494024,1,0.857142857,1,1,9471
3c918e25bd08d9dea4dc3c92e7a410839045ed92,0,Scott Aslan,2019-09-05 13:39:48-04:00,['5cbade7b1d6ab3fe19827d393b4066db677ed309'],0,4,4,3494028,1,0,0,0,9471
fa8a4462e73a7ef417b23644edb9629f2955c0b0,0,Scott Aslan,2019-09-05 13:39:48-04:00,['3c918e25bd08d9dea4dc3c92e7a410839045ed92'],6,14,20,3494048,1,0,0.333333333,1,9471
92fd3129bacf3276369a944136474cfa0f29d951,0,Scott Aslan,2019-09-05 14:54:47-04:00,['fa8a4462e73a7ef417b23644edb9629f2955c0b0'],2,22,24,3494072,1,0.9375,1,1,9471
f01668e66ad2e45197915769e966a4be27e1592e,1,Koji Kawamura,2019-09-06 19:27:59+09:00,['92fd3129bacf3276369a944136474cfa0f29d951'],73,253,326,3494398,18,0.576086957,0.076086957,0.869565217,9473
710c02c673570d09a7e61ea6f95015b6c36382cd,1,Scott Aslan,2019-09-06 08:10:28-04:00,['f01668e66ad2e45197915769e966a4be27e1592e'],11,54,65,3494463,4,0.111111111,1,0.972222222,9473
9aed19137c739ff766ed5a37510bc02f6cf361cd,0,Scott Aslan,2019-09-06 09:31:46-04:00,['710c02c673570d09a7e61ea6f95015b6c36382cd'],0,2,2,3494465,2,1,1,1,9473
4868308fd8e3e630c8dfaa9c418aa64f1f8a74b4,1,Matt Gilman,2019-09-06 11:28:53-04:00,['9aed19137c739ff766ed5a37510bc02f6cf361cd'],2,44,46,3494511,1,0.952380952,0.952380952,1,9473
a672294f3f3edf2f3fbd05a20d0585dc1a431c79,0,Matthew Burgess,2019-09-06 13:18:34-04:00,['4868308fd8e3e630c8dfaa9c418aa64f1f8a74b4'],10,13,23,3494534,3,1,1,1,9473
731df87f22d5028f044c3c6d5f34a3a6da4972ca,0,Matt Gilman,2019-09-06 13:24:10-04:00,['a672294f3f3edf2f3fbd05a20d0585dc1a431c79'],8,14,22,3494556,1,1,1,0,9473
b9c0f513560298acab3ab5630910b504a0abf984,0,Scott Aslan,2019-09-06 13:42:23-04:00,['731df87f22d5028f044c3c6d5f34a3a6da4972ca'],1,4,5,3494561,1,,,,9473
7af710f168716767706dc6bcade3a35f3c68ea9c,0,Matt Gilman,2019-09-06 14:15:38-04:00,['b9c0f513560298acab3ab5630910b504a0abf984'],0,17,17,3494578,2,0,1,1,9473
f867e9260656bad306612b0a94219370c8390525,0,Mark Payne,2019-09-06 15:20:24-04:00,['7af710f168716767706dc6bcade3a35f3c68ea9c'],2,326,328,3494906,5,0.268656716,0.552238806,0.447761194,9474
625d4a13ca57b80c10255295689e097ef5a8119d,0,Mark Payne,2019-09-09 10:24:28-04:00,['f867e9260656bad306612b0a94219370c8390525'],84,268,352,3495258,23,1,1,0.923076923,9475
8a8b9c1d086ac41b10647f09bdd7d8174a921de5,1,GitHub,2019-09-09 15:37:11+00:00,['625d4a13ca57b80c10255295689e097ef5a8119d'],220,3980,4200,3499458,71,0.565093803,0.772029562,0.876065947,9503
21a27c8bb00c3f41836c938c3bb59ff428a27ca4,0,Mark Payne,2019-09-09 13:32:17-04:00,['8a8b9c1d086ac41b10647f09bdd7d8174a921de5'],66,361,427,3499885,2,0,1,1,9503
f89ea8cf2130348e752286d0e76173f52c3d6912,1,Bryan Bende,2019-09-09 15:21:21-04:00,['21a27c8bb00c3f41836c938c3bb59ff428a27ca4'],2,2,4,3499889,2,,,,9503
5ddc01eb9f8546a09fabf08890873c4f0e1bdd02,0,Matt Gilman,2019-09-09 16:11:20-04:00,['f89ea8cf2130348e752286d0e76173f52c3d6912'],16,25,41,3499930,3,0.25,0.25,0.75,9503
70af2acc06157245d8d8bf2bb8600c2e782e12fd,0,Rob Fellows,2019-09-10 10:03:06-04:00,['5ddc01eb9f8546a09fabf08890873c4f0e1bdd02'],14,98,112,3500042,3,0.186046512,0,0.813953488,9503
29708d836257f152d7893bc11fea0ebb24555538,0,Scott Aslan,2019-09-10 10:50:52-04:00,['70af2acc06157245d8d8bf2bb8600c2e782e12fd'],4,12,16,3500058,2,0,0.333333333,1,9503
9ec6314687dfc78ff28566770777e5ec0544f238,0,Matthew Burgess,2019-09-11 11:07:59-04:00,['29708d836257f152d7893bc11fea0ebb24555538'],42,238,280,3500338,9,0.423076923,0.75,0.807692308,9505
758035b964c213649742b9072a5c3f4b057c63c3,1,Peter Wicks,2019-09-11 09:27:52-06:00,['9ec6314687dfc78ff28566770777e5ec0544f238'],0,18,18,3500356,1,0.916666667,0.916666667,1,9505
250e1b0297c353086e593ea14b6ee2f5f32eebce,0,Matt Gilman,2019-09-11 13:09:32-04:00,['758035b964c213649742b9072a5c3f4b057c63c3'],11,59,70,3500426,3,0.9,0.975,1,9505
d9c8d0c5a7814619125332bfb69a72ad27023500,0,Matt Gilman,2019-09-11 13:27:55-04:00,['250e1b0297c353086e593ea14b6ee2f5f32eebce'],5,5,10,3500436,2,,,,9505
c187292fd972f3e5ccd8100f5b6debba15cfd25c,0,Matt Gilman,2019-09-11 15:06:56-04:00,['d9c8d0c5a7814619125332bfb69a72ad27023500'],3,3,6,3500442,2,,,,9505
8e1452a3f342ee45dfd589d343c9ecf6a7cf6825,1,Matthew Burgess,2019-09-12 12:13:19-04:00,['c187292fd972f3e5ccd8100f5b6debba15cfd25c'],14,62,76,3500518,11,0.515151515,0.575757576,0.575757576,9505
2f7448c9e5ab010520d0567b1bba9300415720ce,0,Matt Gilman,2019-09-12 12:44:52-04:00,['8e1452a3f342ee45dfd589d343c9ecf6a7cf6825'],7,18,25,3500543,3,0.428571429,1,1,9505
75c47388a611a2bb3ef398ad331cb0d05a88acd6,1,Scott Aslan,2019-09-12 13:23:32-04:00,['2f7448c9e5ab010520d0567b1bba9300415720ce'],37,79,116,3500659,4,0.371428571,0.485714286,0.885714286,9505
5106b764da021149054231d08c25381c736964bb,1,Matthew Burgess,2019-09-12 16:08:31-04:00,['75c47388a611a2bb3ef398ad331cb0d05a88acd6'],13,13,26,3500685,2,,,,9505
93e6f195d939ea0187f48f306a750ee41ac82de8,0,Koji Kawamura,2019-09-13 08:55:05+09:00,['5106b764da021149054231d08c25381c736964bb'],0,4,4,3500689,2,,,,9505
6b17c4b1347d91177bdece540b3485e962e30a2b,0,Koji Kawamura,2019-09-13 09:02:45+09:00,['93e6f195d939ea0187f48f306a750ee41ac82de8'],6,14,20,3500709,1,1,1,1,9505
3d1bb09ff85462b08ffadcd2cbc8a5d6036a7cdc,0,Matthew Burgess,2019-09-13 09:08:57-04:00,['6b17c4b1347d91177bdece540b3485e962e30a2b'],136,679,815,3501524,6,0.079365079,1,0.825396825,9508
af94b035cbb1e71ee9bca59e4215044ecc97f116,0,Mark Payne,2019-09-13 09:34:13-04:00,['3d1bb09ff85462b08ffadcd2cbc8a5d6036a7cdc'],1,1,2,3501526,1,,,,9508
e659e3b606cc3e41816081046f07d9a8d33c88f6,1,Mark Payne,2019-09-13 10:30:04-04:00,['af94b035cbb1e71ee9bca59e4215044ecc97f116'],531,362,893,3502419,12,0.3125,0,0,9508
70c428f0970e1c79c14532169a727db85cb1bd66,0,Mark Payne,2019-09-13 10:30:41-04:00,['e659e3b606cc3e41816081046f07d9a8d33c88f6'],0,0,0,3502419,0,,,,9508
eb6085a31d9b8e3f041ff59fc3dcbb2a110b3f95,1,Bryan Bende,2019-09-13 10:45:53-04:00,['70c428f0970e1c79c14532169a727db85cb1bd66'],211,2436,2647,3505066,50,0.419095477,0.708542714,0.932663317,9532
5fd6b873feac38d2e5f5a8e767c87f16c710ec8f,0,Mark Payne,2019-09-13 10:54:05-04:00,['eb6085a31d9b8e3f041ff59fc3dcbb2a110b3f95'],2,152,154,3505220,4,0.527272727,1,1,9534
f42d5e56fc1a11d0d8851ce3c642029df691b8bc,0,Mark Payne,2019-09-13 10:54:12-04:00,['5fd6b873feac38d2e5f5a8e767c87f16c710ec8f'],3,4,7,3505227,1,0,0,0,9534
7623e6f5a1bd135ab58bbb9fb4b25686931d8fbf,0,Bryan Bende,2019-09-13 11:21:32-04:00,['f42d5e56fc1a11d0d8851ce3c642029df691b8bc'],2,40,42,3505269,1,0.964285714,1,1,9534
8a8852e73dbcc9653ac49662df44576ec338ebb1,0,Bryan Bende,2019-09-13 12:08:27-04:00,['7623e6f5a1bd135ab58bbb9fb4b25686931d8fbf'],3,41,44,3505313,2,0,0.740740741,1,9534
5ca3655dbff449ad9536e143c27bf2218c43695a,1,Matt Gilman,2019-09-13 16:52:14-04:00,['8a8852e73dbcc9653ac49662df44576ec338ebb1'],32,297,329,3505642,6,0.137142857,0.657142857,0.885714286,9534
7e9277a2bcf70ad800e6c4e143e870f1dd0d0b33,0,Matt Gilman,2019-09-16 10:03:10-04:00,['5ca3655dbff449ad9536e143c27bf2218c43695a'],1,2,3,3505645,1,1,1,1,9534
9e2a959778cdd7b6891937d37a52cc57f8b7405e,0,Scott Aslan,2019-09-16 11:16:25-04:00,['7e9277a2bcf70ad800e6c4e143e870f1dd0d0b33'],0,11,11,3505656,1,0,1,1,9534
fd3f0707c66b78622ed4e7f5aeaff63580c46d44,0,Bryan Bende,2019-09-17 10:02:06-04:00,['9e2a959778cdd7b6891937d37a52cc57f8b7405e'],6,10,16,3505672,1,1,1,1,9534
a1b02ec1137025858239e821d5db0c249b92ff45,1,Matt Gilman,2019-09-17 12:07:32-04:00,['fd3f0707c66b78622ed4e7f5aeaff63580c46d44'],73,286,359,3506031,23,,,,9555
4596ef7c8a1b4a002dd81d210ceab4f99bc32fd6,1,Matt Gilman,2019-09-18 09:08:41-04:00,['a1b02ec1137025858239e821d5db0c249b92ff45'],284,234,518,3506549,5,1,0,0,9555
171e37ddda501d218c1d18fa4bebc9d729d69459,0,Matt Gilman,2019-09-18 14:01:52-04:00,['4596ef7c8a1b4a002dd81d210ceab4f99bc32fd6'],7,6,13,3506562,1,,,,9555
3686ee2a164266543daea7395c211a1bdb31afb9,0,Andy LoPresto,2019-09-18 16:54:09-07:00,['171e37ddda501d218c1d18fa4bebc9d729d69459'],1,9,10,3506572,1,0,0,1,9555
f6842a52005af7300280f0b817de229425f3f896,0,Mike Thomsen,2019-09-19 07:56:42-04:00,['3686ee2a164266543daea7395c211a1bdb31afb9'],1,1,2,3506574,1,,,,9555
ff6a7d95613fc01601d3f60b5fb976c10d89949f,1,Joe Witt,2019-09-19 10:58:53-04:00,['f6842a52005af7300280f0b817de229425f3f896'],823,1390,2213,3508787,15,0.622641509,1,1,9558
34112519c2dde19d704ef624e62e51b399cf1ce7,1,Mark Payne,2019-09-19 11:02:30-04:00,['ff6a7d95613fc01601d3f60b5fb976c10d89949f'],39,1233,1272,3510059,24,0.653784219,0.898550725,0.821256039,9570
79e4f360f489764ab95b416658844c18cc7a7998,0,Joe Witt,2019-09-19 21:19:18-04:00,['34112519c2dde19d704ef624e62e51b399cf1ce7'],5,184,189,3510248,7,0.8,0.8,0.692307692,9571
13381c225439709bd054f560228ba3158f1c2755,1,Joe Witt,2019-09-19 21:46:06-04:00,['79e4f360f489764ab95b416658844c18cc7a7998'],2,2,4,3510252,1,,,,9571
d0371a5ef1f1abe59b7f1de310f21fb93e8fbacb,1,Joe Witt,2019-09-19 22:53:39-04:00,['13381c225439709bd054f560228ba3158f1c2755'],27,182,209,3510461,6,0.103092784,0.298969072,1,9573
e18d9ce1e8d576a21630dcd67e9260ff5c3f9bf0,1,Joe Witt,2019-09-19 23:16:34-04:00,['d0371a5ef1f1abe59b7f1de310f21fb93e8fbacb'],76,285,361,3510822,14,0.322580645,0.503225806,0,9576
be1acd07c59e256e9633cd5958f0b3356b5873f3,0,Joe Witt,2019-09-19 23:39:03-04:00,['e18d9ce1e8d576a21630dcd67e9260ff5c3f9bf0'],42,0,42,3510864,1,,,,9576
282c271c7c29933ca6429acff04806aceb6a5029,1,Mark Payne,2019-09-20 10:49:04-04:00,['be1acd07c59e256e9633cd5958f0b3356b5873f3'],37,55,92,3510956,7,1,0,0,9576
219a83b023b50a30bb03271edbf242c18b14d323,0,Matt Gilman,2019-09-20 15:21:38-04:00,['282c271c7c29933ca6429acff04806aceb6a5029'],0,3,3,3510959,1,0,1,1,9576
4cf961690acef8d41a55b0f928eb2532443bcf3e,0,Matt Gilman,2019-09-20 15:29:30-04:00,['219a83b023b50a30bb03271edbf242c18b14d323'],8,37,45,3511004,4,,,,9579
870a9529c57a39a6fb5e34fe1b68ba16534279e0,0,Joe Witt,2019-09-20 15:40:29-04:00,['4cf961690acef8d41a55b0f928eb2532443bcf3e'],12,14,26,3511030,1,,,,9579
17a16ba68b4d306f391a303cc39a393ea441df0e,1,Pierre Villard,2019-09-21 21:37:25+02:00,['870a9529c57a39a6fb5e34fe1b68ba16534279e0'],9,9,18,3511048,1,1,1,1,9579
6d8968cc87668c30e46a9d3a0a49a790ad32a936,0,Mike Thomsen,2019-09-23 08:18:55-04:00,['17a16ba68b4d306f391a303cc39a393ea441df0e'],9,3,12,3511060,4,1,0,0,9579
c721a9ee5fddfefa6b4dc87afa1b6c45cb09d101,0,Bryan Bende,2019-09-23 10:07:21-04:00,['6d8968cc87668c30e46a9d3a0a49a790ad32a936'],36,17,53,3511113,1,1,1,0,9579
c7a2885c0c5c9241976e10bef21d182d1f63d5aa,0,Bryan Bende,2019-09-24 14:29:25-04:00,['c721a9ee5fddfefa6b4dc87afa1b6c45cb09d101'],5,52,57,3511170,2,0.321428571,1,0.321428571,9579
aba450d658e232b69add2eb942520c26cfc756b4,0,Pierre Villard,2019-09-24 20:51:57+02:00,['c7a2885c0c5c9241976e10bef21d182d1f63d5aa'],12,1,13,3511183,2,1,1,0,9579
bb1018baa7796f4a62dccb6033630c3c3c234eef,0,Pierre Villard,2019-09-24 20:54:42+02:00,['aba450d658e232b69add2eb942520c26cfc756b4'],1,1,2,3511185,1,,,,9579
a4c3ca50dd819e7cffb563c46675bc7ab9d6cd5c,1,Koji Kawamura,2019-09-27 01:36:28+09:00,['bb1018baa7796f4a62dccb6033630c3c3c234eef'],892,1963,2855,3514040,36,1,0.949438202,0.997191011,9595
7cb87328c85dd2f78abf5d9b2f71bf66b64a2e9c,0,Nathan Gough,2019-09-27 16:07:59-04:00,['a4c3ca50dd819e7cffb563c46675bc7ab9d6cd5c'],1,1,2,3514042,1,,,,9595
d5a7fc5daa27104e7b0bd208dc0e35ce18ef769f,0,Joe Witt,2019-09-30 10:33:50-04:00,['7cb87328c85dd2f78abf5d9b2f71bf66b64a2e9c'],2,7,9,3514051,2,,,,9595
48759be9746443aad8107aa77e710e6014b178c5,0,Joe Witt,2019-09-30 10:34:02-04:00,['d5a7fc5daa27104e7b0bd208dc0e35ce18ef769f'],1,55,56,3514107,2,,,,9595
5562c587fe4115097a143186c5d7a0efe7086b9c,0,Joe Witt,2019-09-30 11:51:27-04:00,['48759be9746443aad8107aa77e710e6014b178c5'],3,4,7,3514114,1,,,,9595
6dccdd586e6ef8d1bda625982814f2a073918924,1,Bryan Bende,2019-09-30 11:55:46-04:00,['5562c587fe4115097a143186c5d7a0efe7086b9c'],4,76,80,3514194,3,0,0.75,0.75,9596
8132d182c7f5e7865fbce39f08bbaabf120c9905,1,Joe Witt,2019-09-30 12:38:36-04:00,['6dccdd586e6ef8d1bda625982814f2a073918924'],6,6,12,3514206,1,,,,9596
2493665c2758f1568225d9f6b8e6bd5acd411aed,0,Scott Aslan,2019-09-30 13:18:08-04:00,['8132d182c7f5e7865fbce39f08bbaabf120c9905'],9,6,15,3514221,1,0,0,0,9596
2ab99970b778b09e3544867310458acd0913fbbc,1,Joe Witt,2019-09-30 14:38:33-04:00,['2493665c2758f1568225d9f6b8e6bd5acd411aed'],1,762,763,3514984,6,0.404929577,0.855633803,1,9600
7ac6e4c50ef5cc851e3f224445a788f709f08929,0,Kevin Doran,2019-09-30 15:31:57-04:00,['2ab99970b778b09e3544867310458acd0913fbbc'],0,1,1,3514985,1,0,0,1,9600
fbd6200ab3e4410fd9cf05f31348ec56a89d5af7,0,Joe Witt,2019-09-30 16:47:27-04:00,['7ac6e4c50ef5cc851e3f224445a788f709f08929'],20,42,62,3515047,6,0,1,1,9600
61baa41e7b5a86618e5b8773569c4805867f211b,0,Joe Witt,2019-09-30 23:23:15-04:00,['fbd6200ab3e4410fd9cf05f31348ec56a89d5af7'],741,94,835,3515882,13,1,1,0,9600
2f3ed5c40ce3301493db782d6c6a10b47194e598,0,Jeff Storck,2019-10-01 00:06:58-04:00,['61baa41e7b5a86618e5b8773569c4805867f211b'],1,1,2,3515884,1,,,,9600
6541eac625ff1d721867152d728c53483eab822a,1,Bryan Bende,2019-10-01 09:56:10-04:00,['2f3ed5c40ce3301493db782d6c6a10b47194e598'],118,674,792,3516676,28,0.281938326,1,0.977973568,9604
c0de26b8d6ee99212659e1a58f46fb7956636a93,0,Joe Witt,2019-10-01 13:06:45-04:00,['6541eac625ff1d721867152d728c53483eab822a'],2,14,16,3516692,2,,,,9604
c2746fac5ff210a56704bf5ffe278359b9c85b54,0,Joe Witt,2019-10-01 13:26:05-04:00,['c0de26b8d6ee99212659e1a58f46fb7956636a93'],49,157,206,3516898,2,,,,9604
8abf330328953022c6506c173a11e12bde1abd64,0,Joe Witt,2019-10-01 15:33:07-04:00,['c2746fac5ff210a56704bf5ffe278359b9c85b54'],94,741,835,3517733,13,0,0,1,9609
39a258dc38f9b037bb0ee75c8f9a3da2b12b0946,1,Andy LoPresto,2019-10-01 12:53:44-07:00,['8abf330328953022c6506c173a11e12bde1abd64'],2,13,15,3517748,3,1,1,1,9609
8d748223ff8f80c7a85fc38013ecf0b221adc2da,0,Koji Kawamura,2019-10-02 17:08:37+09:00,['39a258dc38f9b037bb0ee75c8f9a3da2b12b0946'],37,316,353,3518101,6,0.203703704,1,0.777777778,9609
2f6f8529157ac6c7434eae0ab4004a78fd49d547,0,Bryan Bende,2019-10-02 10:55:55-04:00,['8d748223ff8f80c7a85fc38013ecf0b221adc2da'],0,1,1,3518102,1,1,1,1,9609
99cf87c330a2b27757cb188a4e806a46c31ecd1b,1,Bryan Bende,2019-10-02 14:29:00-04:00,['2f6f8529157ac6c7434eae0ab4004a78fd49d547'],87,99,186,3518288,6,1,1,0,9609
261a39599231aaab0115d30eaf8340fdf3801965,1,Pierre Villard,2019-10-03 11:07:58+02:00,['99cf87c330a2b27757cb188a4e806a46c31ecd1b'],3,6,9,3518297,1,0,0,0,9609
a0a66839c4edafff410d82c7bb9cbcd5e80aacb3,1,Pierre Villard,2019-10-03 11:33:49+02:00,['261a39599231aaab0115d30eaf8340fdf3801965'],4,37,41,3518338,2,0.565217391,0.608695652,0.608695652,9609
b12a9ad446773f9f043dfef10327691bf3963a07,1,Pierre Villard,2019-10-03 11:37:00+02:00,['a0a66839c4edafff410d82c7bb9cbcd5e80aacb3'],135,628,763,3519101,12,0.142076503,0.595628415,1,9613
f1d35f46cede60401190777d55350439af106ba7,1,Peter Wicks,2019-10-03 07:24:29-06:00,['b12a9ad446773f9f043dfef10327691bf3963a07'],44,197,241,3519342,6,0.142857143,0.428571429,1,9614
9c9f9c10a980342b57ae13f38239fd809578d822,0,Mark Payne,2019-10-03 12:32:46-04:00,['f1d35f46cede60401190777d55350439af106ba7'],6,26,32,3519374,1,0,0,0,9614
02d3b7e92be73af6ee9fa2f4ea24fd9d483bfca7,0,Bryan Bende,2019-10-03 12:53:53-04:00,['9c9f9c10a980342b57ae13f38239fd809578d822'],7,46,53,3519427,3,1,1,0.8,9614
d7ca37d065677e3016477f74ecdfe233ccd725c7,1,Matthew Burgess,2019-10-03 13:17:42-04:00,['02d3b7e92be73af6ee9fa2f4ea24fd9d483bfca7'],7,56,63,3519490,1,0.227272727,0.227272727,0.227272727,9614
03473b922b5feeb21c9cd65589c4067273aa4061,0,Bryan Bende,2019-10-03 16:41:55-04:00,['d7ca37d065677e3016477f74ecdfe233ccd725c7'],0,14,14,3519504,1,0,0,0,9614
555004cdde7ad4757ee8118638e4b7620d722697,0,GitHub,2019-10-04 08:41:56-06:00,['03473b922b5feeb21c9cd65589c4067273aa4061'],1,0,1,3519505,1,,,,9614
df90c6524695ea10d76d58873dfdf4af4b206a96,1,Mark Payne,2019-10-04 15:48:09-04:00,['555004cdde7ad4757ee8118638e4b7620d722697'],41,259,300,3519805,3,0.452380952,0.642857143,0.476190476,9614
ba141690c50a019939cb12af17b3bcbecf577b36,0,Andy LoPresto,2019-10-04 15:57:06-07:00,['df90c6524695ea10d76d58873dfdf4af4b206a96'],162,900,1062,3520867,18,0.689119171,0.803108808,1,9618
b588073cbbb9655f43b26d854262f449d7de6607,0,Andy LoPresto,2019-10-04 17:37:53-07:00,['ba141690c50a019939cb12af17b3bcbecf577b36'],0,158,158,3521025,3,0,1,1,9619
0f02de60024b7b8db58ef31482307ac1f0134543,1,Aldrin Piri,2019-10-07 22:20:48-04:00,['b588073cbbb9655f43b26d854262f449d7de6607'],26,26,52,3521077,22,,,,9619
2d9014584209da5906d2b288612f5be82349dc16,0,Joe Witt,2019-10-08 11:48:10-04:00,['0f02de60024b7b8db58ef31482307ac1f0134543'],1,1,2,3521079,1,,,,9619
e394f6683aaadc20f59ab467ab781e50c86ba958,0,Matthew Burgess,2019-10-09 09:54:45-04:00,['2d9014584209da5906d2b288612f5be82349dc16'],9,68,77,3521156,2,0,0.590909091,1,9619
47f45abdf9d99ac4b46dbed56c6dac3e0404d8be,0,Bryan Bende,2019-10-09 10:20:45-04:00,['e394f6683aaadc20f59ab467ab781e50c86ba958'],49,105,154,3521310,4,0.923076923,0.897435897,0.487179487,9619
9a496fe9d2681fca06fb6f071d0fa39d71bc5268,1,Rob Fellows,2019-10-09 12:00:22-04:00,['47f45abdf9d99ac4b46dbed56c6dac3e0404d8be'],2,2,4,3521314,1,,,,9619
5414cd50163e4ae7d7b8bae8f3ecb4d00e4123ff,0,Mark Payne,2019-10-09 16:05:44-04:00,['9a496fe9d2681fca06fb6f071d0fa39d71bc5268'],0,1,1,3521315,1,0,0,1,9619
99e9010b323c7dadeca6abd1ea4635c944e7a526,0,Joe Witt,2019-10-10 00:19:22-04:00,['5414cd50163e4ae7d7b8bae8f3ecb4d00e4123ff'],3,3,6,3521321,1,,,,9619
4e8dd6557faaa61981ff19cc1e841230afc65ffb,1,Joe Witt,2019-10-10 00:55:47-04:00,['99e9010b323c7dadeca6abd1ea4635c944e7a526'],8,35,43,3521364,5,0.454545455,0.818181818,0.909090909,9619
d64f4fa942342482012b3caf4f8e3bf475685d03,0,Bryan Bende,2019-10-10 10:19:21-04:00,['4e8dd6557faaa61981ff19cc1e841230afc65ffb'],12,11,23,3521387,4,,,,9619
ed1e843609af32711daac88bd423428b86a58a7c,0,Rob Fellows,2019-10-10 11:30:14-04:00,['d64f4fa942342482012b3caf4f8e3bf475685d03'],13,41,54,3521441,2,0.875,1,1,9619
5238dc20b1868ada96dc55d38dcbdf401a129a97,0,Bryan Bende,2019-10-10 11:36:29-04:00,['ed1e843609af32711daac88bd423428b86a58a7c'],12,37,49,3521490,1,1,1,1,9619
7db6ba841fa49633ad54b03c09802bbe11dfa20d,0,Bryan Bende,2019-10-10 11:49:39-04:00,['5238dc20b1868ada96dc55d38dcbdf401a129a97'],24,27,51,3521541,1,0,0,1,9619
a273ff10f98b77e108aebf34dfbe847f473132ae,0,Joe Witt,2019-10-10 15:04:16-04:00,['7db6ba841fa49633ad54b03c09802bbe11dfa20d'],4,4,8,3521549,1,,,,9619
5d65e6aba4d6f98f18aeddf0e17e19fbd881d07a,0,Bryan Bende,2019-10-10 15:09:16-04:00,['a273ff10f98b77e108aebf34dfbe847f473132ae'],1,39,40,3521589,2,0,1,1,9619
af81afce408a4d4e731d2431fb1b9b2b26def1fe,0,Bryan Bende,2019-10-10 15:09:28-04:00,['5d65e6aba4d6f98f18aeddf0e17e19fbd881d07a'],2,4,6,3521595,2,0,1,1,9619
08fe648b1c61ba38d6332661219ebeaf67c3486b,1,Koji Kawamura,2019-10-11 15:10:11+09:00,['af81afce408a4d4e731d2431fb1b9b2b26def1fe'],1,2,3,3521598,1,0,0,0,9619
9dd0dda6880ca473b230e5325920834abc213627,0,Matt Gilman,2019-10-14 11:32:47-04:00,['08fe648b1c61ba38d6332661219ebeaf67c3486b'],3,393,396,3521994,7,0.421383648,0.698113208,0.880503145,9623
266a59d05a5cfb66ac18d1ae20bb5f43b8440fa3,0,Kevin Doran,2019-10-14 15:54:03-04:00,['9dd0dda6880ca473b230e5325920834abc213627'],1,1,2,3521996,1,,,,9623
77e9bda0fff8166e21d237f9f92e5ef6348799ac,0,Pierre Villard,2019-10-15 11:55:52+02:00,['266a59d05a5cfb66ac18d1ae20bb5f43b8440fa3'],1,4,5,3522001,1,1,1,0,9623
d570fe81543b706acf9a797fb05fac68a384b3f4,1,Joe Witt,2019-10-15 14:05:25-04:00,['77e9bda0fff8166e21d237f9f92e5ef6348799ac'],20,203,223,3522224,4,0.616161616,0.777777778,1,9623
c4ccd5f5054312c5b429be896bd35b5bea5ba143,0,Joe Witt,2019-10-15 14:52:39-04:00,['d570fe81543b706acf9a797fb05fac68a384b3f4'],1,1,2,3522226,1,,,,9623
cd90b1d3e1b623556f17106c637b60eb1eaa37f0,0,Joe Witt,2019-10-16 17:45:32-04:00,['c4ccd5f5054312c5b429be896bd35b5bea5ba143'],3,49,52,3522278,3,0.685714286,0.714285714,1,9624
b004f1f94c5857e89d4410153f43dc0000709ff5,0,Matt Gilman,2019-10-17 11:21:17-04:00,['cd90b1d3e1b623556f17106c637b60eb1eaa37f0'],55,90,145,3522423,3,1,0.947368421,1,9624
ea1becac4fc519c54b8b4d21773e68f8da364755,1,Bryan Bende,2019-10-17 15:46:32-04:00,['b004f1f94c5857e89d4410153f43dc0000709ff5'],1389,174,1563,3523986,56,0,0,1,9625
a30eb3a08af72f60d271f73e276c4f1cbb2a7298,0,Andy LoPresto,2019-10-18 13:25:48-07:00,['ea1becac4fc519c54b8b4d21773e68f8da364755'],13,199,212,3524198,1,,,,9625
e9717c76ac008962923dcbf9747dfcafd0e51de9,0,Pierre Villard,2019-10-19 16:41:02+02:00,['a30eb3a08af72f60d271f73e276c4f1cbb2a7298'],0,9,9,3524207,1,,,,9625
8b239296388ae2df6b6dbb402a1b615b82eb327f,0,Bryan Bende,2019-10-21 11:41:29-04:00,['e9717c76ac008962923dcbf9747dfcafd0e51de9'],2,2,4,3524211,1,,,,9625
7c9d34f820ea063349f7405c31d5587a040eb779,0,Matthew Burgess,2019-10-21 12:16:11-04:00,['8b239296388ae2df6b6dbb402a1b615b82eb327f'],2,1729,1731,3525942,28,0.647058824,0.976982097,0.877237852,9648
d148fb18540b410361a91f22e421867910d2f7c9,0,Joe Witt,2019-10-21 13:03:59-04:00,['7c9d34f820ea063349f7405c31d5587a040eb779'],251,4382,4633,3530575,40,0.759936407,0.990461049,0.658187599,9673
ace23c35b5f5c298af64e5bd6aa62c797cecc4fc,1,Yolanda Davis,2019-10-22 08:56:42-04:00,['d148fb18540b410361a91f22e421867910d2f7c9'],261,6173,6434,3537009,64,0.418768086,0.805704837,0.841256718,9719
3543b9c42cb00b8365059a990aa4f77f23c4892b,1,Bryan Bende,2019-10-23 14:59:33-04:00,['ace23c35b5f5c298af64e5bd6aa62c797cecc4fc'],202,605,807,3537816,18,0.433962264,0.575471698,0.924528302,9719
c2da6e7aa2bb0a0e11a0b61ebb411c75d7bea86d,0,Bryan Bende,2019-10-23 15:02:05-04:00,['3543b9c42cb00b8365059a990aa4f77f23c4892b'],35,1,36,3537852,2,,,,9719
147365285cbe385a85e58371dd9570dc01683936,1,Matthew Burgess,2019-10-24 08:51:50-04:00,['c2da6e7aa2bb0a0e11a0b61ebb411c75d7bea86d'],46,42,88,3537940,10,0.8,1,1,9719
8771c35f4a01c38ab94ab80b96997ee5f82af094,1,Yolanda Davis,2019-10-24 11:53:28-04:00,['147365285cbe385a85e58371dd9570dc01683936'],108,512,620,3538560,11,0.284848485,0.424242424,0.739393939,9722
8079d2531e561ad5dbbfe9e8dc4b818d694d57a6,1,Mike Thomsen,2019-10-24 19:27:30-04:00,['8771c35f4a01c38ab94ab80b96997ee5f82af094'],45,26,71,3538631,5,0,0,0,9722
87838e6c31ed8b104f79b7c7930b110e31bf7de7,0,Mike Thomsen,2019-10-25 05:48:50-04:00,['8079d2531e561ad5dbbfe9e8dc4b818d694d57a6'],1,1,2,3538633,1,,,,9722
20f70357a364c103f4d669c48bc8920550993467,0,Mike Thomsen,2019-10-25 09:09:28-04:00,['87838e6c31ed8b104f79b7c7930b110e31bf7de7'],3,3,6,3538639,2,,,,9722
2cef010b06ee0e3db82ea0272733e426c8e5d884,0,Bryan Bende,2019-10-25 09:31:34-04:00,['20f70357a364c103f4d669c48bc8920550993467'],3,3,6,3538645,2,,,,9722
81fc2768c9d6cb61be10ba5adc805517c29816c7,1,Bryan Bende,2019-10-25 09:52:44-04:00,['2cef010b06ee0e3db82ea0272733e426c8e5d884'],3,3,6,3538651,1,,,,9722
3f270f184c22f9686587bcedff396c434bd8f7d5,0,Matt Gilman,2019-10-25 11:38:34-04:00,['81fc2768c9d6cb61be10ba5adc805517c29816c7'],15,7,22,3538673,3,1,1,0,9722
9364f7d2e80e7f3695f175d2d3c5d23883ad2ce4,0,Rob Fellows,2019-10-25 12:07:03-04:00,['3f270f184c22f9686587bcedff396c434bd8f7d5'],28,36,64,3538737,2,0.6,1,0.8,9722
4f5718bf50f0e53f859824bd0fbb29e4ec27e8ff,0,Joe Witt,2019-10-25 13:30:54-04:00,['9364f7d2e80e7f3695f175d2d3c5d23883ad2ce4'],0,265,265,3539002,2,,,,9724
4d25b6341ccba0ee24da15198d030d8132972e7c,0,Andy LoPresto,2019-10-25 14:28:46-07:00,['4f5718bf50f0e53f859824bd0fbb29e4ec27e8ff'],2,138,140,3539142,3,0,1,0.733333333,9724
cfcf2e698df34eb097c23a404c1a346a4aeb9c60,0,Mike Thomsen,2019-10-25 17:43:13-04:00,['4d25b6341ccba0ee24da15198d030d8132972e7c'],0,30,30,3539172,2,0.105263158,1,1,9724
ccf85777c46bec3ad8b562b933142bfb4f9aeae9,0,Mike Thomsen,2019-10-28 12:49:08-04:00,['cfcf2e698df34eb097c23a404c1a346a4aeb9c60'],129,0,129,3539301,19,,,,9724
5c69faf9bb46a9be9b3e7616f981c11437d33ac1,0,Mark Payne,2019-10-28 15:33:32-04:00,['ccf85777c46bec3ad8b562b933142bfb4f9aeae9'],149,146,295,3539596,7,0,0.681818182,0.227272727,9724
dda29cd90be54d7ef448d34c7aabb0a5e2f8b2cd,0,Joe Witt,2019-10-28 12:40:03-07:00,['5c69faf9bb46a9be9b3e7616f981c11437d33ac1'],2,2,4,3539600,2,,,,9724
d5fbfd1a128c52430026af3e1c9aa959025eda8a,1,Joe Witt,2019-10-28 12:42:37-07:00,['dda29cd90be54d7ef448d34c7aabb0a5e2f8b2cd'],2,6,8,3539608,1,,,,9724
c6e8bf204cf02066905999d9957901e1a124afca,0,Joe Witt,2019-10-28 12:55:26-07:00,['d5fbfd1a128c52430026af3e1c9aa959025eda8a'],0,1,1,3539609,1,,,,9724
5fd8df57806ecd3a76be1a66f4a9206b3acd29ed,0,Joe Witt,2019-10-28 12:56:06-07:00,['c6e8bf204cf02066905999d9957901e1a124afca'],0,3,3,3539612,3,,,,9724
dccbde40f3da5aecf8299513bcd4691702ffc02a,0,Joe Witt,2019-10-28 14:23:44-07:00,['5fd8df57806ecd3a76be1a66f4a9206b3acd29ed'],1,26,27,3539639,1,0,0.125,1,9724
b217ae20ad6a04cac874b2b00d93b7f7514c0b88,1,Joe Witt,2019-10-28 15:12:57-07:00,['dccbde40f3da5aecf8299513bcd4691702ffc02a'],1541,1514,3055,3542694,447,,,,9724
418179f5b29959e2bdeb9ffedc4a87e0736105a4,0,Joe Witt,2019-10-28 15:13:13-07:00,['b217ae20ad6a04cac874b2b00d93b7f7514c0b88'],1495,1495,2990,3545684,447,,,,9724
67f1677212368290228b373fdbeb73f0265e2211,1,Mark Payne,2019-10-29 10:16:49-04:00,['dccbde40f3da5aecf8299513bcd4691702ffc02a'],1,5,6,3545690,1,0,1,1,9724
ce5eae5b2cd5cf49a90d2980c58cd6647f4af292,1,Mark Payne,2019-10-29 10:17:27-04:00,['67f1677212368290228b373fdbeb73f0265e2211'],2,46,48,3545738,1,0,1,1,9724
3d56e2f26d2943c00f4ffdfe8629c6faf8be4998,0,Pierre Villard,2019-10-30 09:58:55+01:00,['ce5eae5b2cd5cf49a90d2980c58cd6647f4af292'],0,16,16,3545754,2,1,1,1,9724
245e055d5da9699c1b7a2c248d764642b871eac3,0,Pierre Villard,2019-10-31 11:20:21+01:00,['3d56e2f26d2943c00f4ffdfe8629c6faf8be4998'],4,3,7,3545761,1,,,,9724
5b28f6dad9ea507dd1419ae4ed4e5fff8032b83d,0,Matthew Burgess,2019-11-01 10:41:25-04:00,['245e055d5da9699c1b7a2c248d764642b871eac3'],1,1922,1923,3547684,20,0.594634873,0.916542474,0.929955291,9742
0b3a60ae3e8af9d4079c3e177dfbd568c93f6cfe,0,Bryan Bende,2019-11-01 16:22:17-04:00,['5b28f6dad9ea507dd1419ae4ed4e5fff8032b83d'],1,5,6,3547690,1,0,0,0,9742
6864f3eb2509bd4eacd9028e3343f383a3b8bd7b,1,Mike Thomsen,2019-11-02 10:23:07-04:00,['0b3a60ae3e8af9d4079c3e177dfbd568c93f6cfe'],1,90,91,3547781,6,0.866666667,0.866666667,0.866666667,9743
b1f97708aa4e6b6b03c16c103de50280e391b73d,0,Joe Witt,2019-11-04 07:42:47-05:00,['6864f3eb2509bd4eacd9028e3343f383a3b8bd7b'],2,2,4,3547785,2,,,,9743
a7c56cfd9a27f2be8809c87ad427dc2ba892da1f,0,Joe Witt,2019-11-04 07:54:17-05:00,['b1f97708aa4e6b6b03c16c103de50280e391b73d'],1507,1507,3014,3550799,450,,,,9743
363b7513101d3449bdc40e64f679402d4ff12ffd,0,Joe Witt,2019-11-04 13:24:13-05:00,['a7c56cfd9a27f2be8809c87ad427dc2ba892da1f'],1507,1507,3014,3553813,450,,,,9743
4119279c0360b7c0cc6381e3d1cefd1c4eae36ad,0,Joe Witt,2019-11-04 13:24:29-05:00,"['363b7513101d3449bdc40e64f679402d4ff12ffd', '418179f5b29959e2bdeb9ffedc4a87e0736105a4']",1540,1513,3053,3556866,447,,,,9743
eb046c4fabab6f6a6c55187d8d368a759b49f6a4,0,Joe Witt,2019-11-04 13:28:39-05:00,['4119279c0360b7c0cc6381e3d1cefd1c4eae36ad'],16,16,32,3556898,4,,,,9743
f8c3d877cf806f68300a8a42115d489b8750d2d7,0,Joe Witt,2019-11-04 13:31:39-05:00,['eb046c4fabab6f6a6c55187d8d368a759b49f6a4'],1507,1507,3014,3559912,450,,,,9743
7f1886adad8627d4019fc0ac51158068dca621c3,0,Andrew Lim,2019-11-04 15:22:52-05:00,['f8c3d877cf806f68300a8a42115d489b8750d2d7'],1,1,2,3559914,1,,,,9743
d6b4bce6688b159b30cb0333cb4f4ac1f29c2ffc,0,Andrew Lim,2019-11-04 15:26:25-05:00,['7f1886adad8627d4019fc0ac51158068dca621c3'],1,1,2,3559916,1,,,,9743
0a2629627638b8ebe442c5e1a144f7b013f670a7,0,Mike Thomsen,2019-11-04 16:24:35-05:00,['d6b4bce6688b159b30cb0333cb4f4ac1f29c2ffc'],47,47,94,3560010,1,,,,9743
af0777b2c947ac2d2fd41cd879fe4b947186d919,0,Pierre Villard,2019-11-05 11:10:15+01:00,['0a2629627638b8ebe442c5e1a144f7b013f670a7'],2,6,8,3560018,2,0,1,1,9743
7f96fa1d0dbcfd061fba1e061c891ac35da4333d,0,Koji Kawamura,2019-11-05 20:54:25+09:00,['af0777b2c947ac2d2fd41cd879fe4b947186d919'],25,34,59,3560077,1,1,0,0,9743
84a05c8595a5aa61c33723aa20418048230bf7e3,0,Peter Turcsanyi,2019-11-05 14:02:03+01:00,['7f96fa1d0dbcfd061fba1e061c891ac35da4333d'],187,524,711,3560788,8,0.884615385,1,1,9746
a9db5a8cb7313005b4077b66ce10ef81d3055ee8,1,Matt Gilman,2019-11-05 13:06:06-05:00,['84a05c8595a5aa61c33723aa20418048230bf7e3'],8,77,85,3560873,2,0.058823529,1,1,9746
481f9f67bff771b9a2133022382e56ded4a6ee8c,0,Andy LoPresto,2019-11-05 10:41:01-08:00,['a9db5a8cb7313005b4077b66ce10ef81d3055ee8'],2,18,20,3560893,2,0,1,0.454545455,9746
12bb284453a19c24d87aca460e89f06b7928d119,0,Andy LoPresto,2019-11-05 13:12:40-08:00,['481f9f67bff771b9a2133022382e56ded4a6ee8c'],1,1,2,3560895,1,,,,9746
442a80bf1bfc76d3937dbaefde471223bacbec52,0,Yolanda Davis,2019-11-05 16:44:37-05:00,['12bb284453a19c24d87aca460e89f06b7928d119'],290,1308,1598,3562493,16,0.086956522,0.785024155,0.855072464,9752
7ac41576e3711ccc752d730f0b39a474235c701c,1,Matthew Burgess,2019-11-05 16:52:20-05:00,['442a80bf1bfc76d3937dbaefde471223bacbec52'],1,3,4,3562497,1,,,,9752
8dadebafdca64f64b6ec453d24eef6672a65b30b,0,Bryan Bende,2019-11-05 16:58:37-05:00,['7ac41576e3711ccc752d730f0b39a474235c701c'],1,1,2,3562499,1,,,,9752
e3f72c5ed09382144c01caa5ff7cfc9c72a9ce38,0,Matthew Burgess,2019-11-06 08:57:31-05:00,['8dadebafdca64f64b6ec453d24eef6672a65b30b'],1,6,7,3562506,1,0,0,0.333333333,9752
49b7a7cd6b2645188a732bc57122d1757516e2bd,1,Matt Gilman,2019-11-06 09:53:25-05:00,['e3f72c5ed09382144c01caa5ff7cfc9c72a9ce38'],22,32,54,3562560,2,0.666666667,0.666666667,1,9752
36bdb474c30c8a88530cee1d220e9d3c1e0dc888,1,Andy LoPresto,2019-11-06 12:55:11-08:00,['49b7a7cd6b2645188a732bc57122d1757516e2bd'],6,162,168,3562728,4,0,1,1,9755
eb366c8d0ab6a071f0f593fcbf227856243fdd5b,1,Joe Witt,2019-11-07 18:24:42-05:00,['36bdb474c30c8a88530cee1d220e9d3c1e0dc888'],44,87,131,3562859,4,0.653846154,0.807692308,0.692307692,9755
c998a7259aca73e716433d0582b30d7ed986c4b2,1,Matthew Burgess,2019-11-08 10:25:54-05:00,['eb366c8d0ab6a071f0f593fcbf227856243fdd5b'],101,1257,1358,3564217,21,0.274231678,1,0.877068558,9767
a37b57e96b7e0d1d048f0d4344b1cec692216617,0,Matthew Burgess,2019-11-08 11:24:18-05:00,['c998a7259aca73e716433d0582b30d7ed986c4b2'],17,312,329,3564546,13,0.297142857,1,0.971428571,9770
5f4ce8f431d1cb90451102efb516140d87610c52,1,Bryan Bende,2019-11-08 12:33:16-05:00,['a37b57e96b7e0d1d048f0d4344b1cec692216617'],311,7204,7515,3572061,83,0.65202844,0.947302384,0.910915935,9831
c947e57d5e4dda8682a6ec1c6bc6850a65ab912e,0,Matt Gilman,2019-11-08 15:43:13-05:00,['5f4ce8f431d1cb90451102efb516140d87610c52'],0,4,4,3572065,1,,,,9831
d87604a1cf27bd14364f3b75f55a124a93bf6484,0,Mike Thomsen,2019-11-11 18:32:10-05:00,['c947e57d5e4dda8682a6ec1c6bc6850a65ab912e'],0,6,6,3572071,1,,,,9831
5d9bba2f6fc93cb064f2e93090ce01d6c8643a0f,0,Mike Thomsen,2019-11-12 09:53:30-05:00,['d87604a1cf27bd14364f3b75f55a124a93bf6484'],1,1,2,3572073,1,,,,9831
d6c645a9e23e119c335598339ee1ecf979fbce2e,0,Pierre Villard,2019-11-13 10:28:45+01:00,['5d9bba2f6fc93cb064f2e93090ce01d6c8643a0f'],5,30,35,3572108,2,0.210526316,0.210526316,1,9831
86cae184ff1cfe8e81f7e1d2d393c39c17bca02a,1,Pierre Villard,2019-11-14 14:44:01+01:00,['d6c645a9e23e119c335598339ee1ecf979fbce2e'],58,119,177,3572285,5,0.225,1,0.975,9831
55c334feb8ad9fd9bc6353e33f7c9594c5258f49,1,Yolanda Davis,2019-11-14 14:20:58-05:00,['86cae184ff1cfe8e81f7e1d2d393c39c17bca02a'],0,1427,1427,3573712,15,0.242016807,0.52605042,0.94789916,9842
ea31c1fcbb270031339f75b1d6ca4a157fdb7594,0,Rob Fellows,2019-11-14 15:37:39-05:00,['55c334feb8ad9fd9bc6353e33f7c9594c5258f49'],11,126,137,3573849,5,0.479452055,1,1,9842
1dfbc97c074a5fc5c8e68124e0984504cfa97813,0,Koji Kawamura,2019-11-18 16:55:23+09:00,['ea31c1fcbb270031339f75b1d6ca4a157fdb7594'],129,685,814,3574663,4,0.958506224,0.941908714,1,9843
c72a5618c0d61cbd2001e0453b402b8e3ec6cd90,0,Koji Kawamura,2019-11-18 17:29:24+09:00,['1dfbc97c074a5fc5c8e68124e0984504cfa97813'],48,52,100,3574763,3,,,,9843
f1be730c9470e56e6042be8418cb03a70845eb69,0,Mike Thomsen,2019-11-18 18:44:28-05:00,['c72a5618c0d61cbd2001e0453b402b8e3ec6cd90'],1,172,173,3574936,6,0.164556962,0.544303797,0.772151899,9844
4c79ff057638d703cedad1f33855bc066c71f357,1,Matthew Burgess,2019-11-19 13:53:34-05:00,['f1be730c9470e56e6042be8418cb03a70845eb69'],459,2187,2646,3577582,38,0.197761194,0.5,0.541044776,9862
efff1b41f07e4d473de68c91706509c9ab104d58,0,Matt Gilman,2019-11-19 16:14:51-05:00,['4c79ff057638d703cedad1f33855bc066c71f357'],0,8,8,3577590,1,,,,9862
b3880a4a067915c56aa3d1b602717eab7ffa02fb,0,Matthew Burgess,2019-11-19 16:48:14-05:00,['efff1b41f07e4d473de68c91706509c9ab104d58'],17,223,240,3577830,11,0.234848485,0.962121212,0.909090909,9862
d617c0b96ab5d2f42c467643aa55cc4ab9a70b27,1,Peter Turcsanyi,2019-11-19 23:33:46+01:00,['b3880a4a067915c56aa3d1b602717eab7ffa02fb'],0,24,24,3577854,4,0,0.272727273,1,9862
18245a4441406d7e4295997cba4369a27834dafd,0,Matthew Burgess,2019-11-20 12:24:41-05:00,['d617c0b96ab5d2f42c467643aa55cc4ab9a70b27'],18,488,506,3578360,8,0.175287356,1,0.954022989,9862
388683a5c56e3fd1fed2305aca574a2f8191f4e2,0,jstorck,2019-11-20 20:00:46-05:00,['18245a4441406d7e4295997cba4369a27834dafd'],1,34,35,3578395,2,0.529411765,1,1,9862
0acdde827e02304426f8fee6be0b58848100a6b8,1,Mark Payne,2019-11-21 13:01:38-05:00,['388683a5c56e3fd1fed2305aca574a2f8191f4e2'],2,1385,1387,3579782,13,0.531100478,0.939393939,0.767145136,9873
ae2b3d6b45fafb83bedd86f4d6da8d74a4b6ee6d,0,Matthew Burgess,2019-11-21 16:34:52-05:00,['0acdde827e02304426f8fee6be0b58848100a6b8'],2,2,4,3579786,1,,,,9873
3f3b778f2492c7756876730c11669ca0ce0bae6d,0,Scott Aslan,2019-11-21 16:45:33-05:00,['ae2b3d6b45fafb83bedd86f4d6da8d74a4b6ee6d'],40,40,80,3579866,2,,,,9873
5bfc86737db4f6caadab3a765b85f349ef7f31ab,0,Pierre Villard,2019-11-22 14:05:36+01:00,['3f3b778f2492c7756876730c11669ca0ce0bae6d'],0,0,0,3579866,2,,,,9873
6507b789483f9de9faf8dabd8d668abab0b0db78,0,Peter Turcsanyi,2019-11-22 15:14:58+01:00,['5bfc86737db4f6caadab3a765b85f349ef7f31ab'],28,40,68,3579934,4,0.75,1,1,9873
bed3dd2fffd9427b7ce2fd759d2c9a793d633cd0,0,Mark Payne,2019-11-22 10:55:08-05:00,['6507b789483f9de9faf8dabd8d668abab0b0db78'],10,6,16,3579950,2,,,,9873
5cfc68d26d97ff57c44ea1ea4cc610740a1b6079,1,Matthew Burgess,2019-11-22 11:14:46-05:00,['bed3dd2fffd9427b7ce2fd759d2c9a793d633cd0'],48,248,296,3580246,14,,,,9873
58130485a3ae3387eefef85b6115563d9a9aeb6c,0,Matthew Burgess,2019-11-22 11:17:48-05:00,['5cfc68d26d97ff57c44ea1ea4cc610740a1b6079'],36,211,247,3580493,5,0.045454545,1,0.939393939,9873
ac5bacccb850774443489a3ab0acc7c541566cca,0,Mike Thomsen,2019-11-25 10:58:22-05:00,['58130485a3ae3387eefef85b6115563d9a9aeb6c'],28,29,57,3580550,29,,,,9873
dd620680b1e3e053acfc7c1b1e3f000de57351c8,0,Matt Gilman,2019-11-25 13:35:21-05:00,['ac5bacccb850774443489a3ab0acc7c541566cca'],6,9,15,3580565,1,0,1,0,9873
955784031fcd00e40cd43c86a4cde22dd4d2713a,0,Bryan Bende,2019-11-27 15:37:48-05:00,['dd620680b1e3e053acfc7c1b1e3f000de57351c8'],1,99,100,3580665,3,,,,9873
1898ad44be3186410e01baef60325a6fa5e81187,1,Pierre Villard,2019-12-03 03:46:12+01:00,['955784031fcd00e40cd43c86a4cde22dd4d2713a'],27,286,313,3580978,5,0.5,0.91025641,0.91025641,9874
41fef551c3cc4e33e9586351f4507b4f090be3a6,0,Matthew Burgess,2019-12-04 16:12:18-05:00,['1898ad44be3186410e01baef60325a6fa5e81187'],2,23,25,3581003,2,1,1,1,9874
885f1d1e5e7097794e2fe76198f6ffd9eddbd656,0,Pierre Villard,2019-12-06 07:04:37+01:00,['41fef551c3cc4e33e9586351f4507b4f090be3a6'],1,1,2,3581005,1,,,,9874
ba6d050ba814c2e10e9cdeff2d55f75b4faf2036,0,Matt Gilman,2019-12-09 16:31:33-05:00,['885f1d1e5e7097794e2fe76198f6ffd9eddbd656'],2,72,74,3581079,3,0.964285714,0.964285714,1,9875
452ca98c29eeda6a89c60350e4577f82138d7ef0,1,Bryan Bende,2019-12-10 15:27:53-05:00,['ba6d050ba814c2e10e9cdeff2d55f75b4faf2036'],25,92,117,3581196,3,0,0.270833333,1,9875
92b9a05309592e86e23eb316e39a3572ecb23c3a,0,mtien,2019-12-12 12:09:42-08:00,['ba6d050ba814c2e10e9cdeff2d55f75b4faf2036'],1,98,99,3581295,2,1,1,1,9875
29e7adb2b4fa4b385dcfc758083479516fb1b4be,0,Mark Payne,2019-12-13 12:55:26-05:00,['452ca98c29eeda6a89c60350e4577f82138d7ef0'],51,109,160,3581455,4,0.906976744,0.906976744,1,9876
442858127bedda992921953fc1943f1973803bb5,0,Mark Payne,2019-12-13 12:58:31-05:00,['29e7adb2b4fa4b385dcfc758083479516fb1b4be'],1,3,4,3581459,1,0,1,1,9876
3c3eba190937aee849da52149953b7cc63304166,0,Mark Payne,2019-12-13 13:03:23-05:00,['442858127bedda992921953fc1943f1973803bb5'],2,3,5,3581464,1,1,1,1,9876
43bc6c6ed9308b32659333fc93d2fc21d74aceac,0,Mark Payne,2019-12-13 13:41:21-05:00,['3c3eba190937aee849da52149953b7cc63304166'],2,29,31,3581495,1,0.714285714,0.714285714,1,9876
65ba4a2d9353b8a2038e45b1079739bf016d7b56,1,Mark Payne,2019-12-13 14:23:50-05:00,['43bc6c6ed9308b32659333fc93d2fc21d74aceac'],3,38,41,3581536,2,0,0,1,9876
773160958209a8a173b4f741517c4bda63a28e82,1,Mark Payne,2019-12-13 14:36:44-05:00,['65ba4a2d9353b8a2038e45b1079739bf016d7b56'],1,278,279,3581815,3,0.742857143,1,0.914285714,9878
e05d11c0b4fef2935c2ae0c3265853bbe63ab2b0,0,Mark Payne,2019-12-13 15:09:15-05:00,['773160958209a8a173b4f741517c4bda63a28e82'],3,7,10,3581825,3,0,1,1,9878
599fb9841579e83f37cb0902ff2124ffda468b98,0,Peter Turcsanyi,2019-12-16 17:33:47+01:00,['e05d11c0b4fef2935c2ae0c3265853bbe63ab2b0'],13,13,26,3581851,1,,0,,9878
8b3f6fa61c3eaa297f2ba8d44337f659c7c6f0e5,0,Matt Gilman,2019-12-16 14:48:12-05:00,['599fb9841579e83f37cb0902ff2124ffda468b98'],1,5,6,3581857,2,,,,9878
67fca6832a528fc1bfe996f3d95a6ac250f6894c,0,Peter Turcsanyi,2019-12-16 20:55:13+01:00,['8b3f6fa61c3eaa297f2ba8d44337f659c7c6f0e5'],6,148,154,3582011,2,0.169491525,0.93220339,0.542372881,9878
4b08cf116c852a0a969ba0bea0be0bc4811f20bb,0,Pierre Villard,2019-12-17 16:40:42+01:00,['67fca6832a528fc1bfe996f3d95a6ac250f6894c'],6,9,15,3582026,3,1,1,1,9878
6d1bcc22e78129b2669c2e41af0c6b246e6780a9,0,Yolanda Davis,2019-12-17 11:42:24-05:00,['4b08cf116c852a0a969ba0bea0be0bc4811f20bb'],53,80,133,3582159,6,0.6,0.68,1,9878
f398299cfe891c4bdec655f15ee4445e090e47c6,0,Yolanda Davis,2019-12-17 14:49:04-05:00,['6d1bcc22e78129b2669c2e41af0c6b246e6780a9'],3,55,58,3582217,2,0,0.953488372,1,9878
058883091cf2cae0ff344136d6d58dd8efe0fd6c,1,Matt Gilman,2019-12-18 16:37:47-05:00,['f398299cfe891c4bdec655f15ee4445e090e47c6'],310,1506,1816,3584033,19,0.346094946,0.906584992,0.485451761,9881
ab155369765f04b7a196864324047045214558c7,0,mtien,2019-12-18 15:06:45-08:00,['92b9a05309592e86e23eb316e39a3572ecb23c3a'],2,2,4,3584037,2,,,,9881
3a5a2da73c2a74ad390487bd2d22dac1dd3954ac,0,Pierre Villard,2019-12-19 11:44:55+01:00,['058883091cf2cae0ff344136d6d58dd8efe0fd6c'],21,33,54,3584091,2,0,1,1,9881
0024668dd51516276517dca50eb478a8fb0fadff,0,Pierre Villard,2019-12-19 11:51:18+01:00,['3a5a2da73c2a74ad390487bd2d22dac1dd3954ac'],12,30,42,3584133,2,0,1,1,9881
2959c436b1ee78d09000adb6c3065190cf19902c,0,mtien,2019-12-19 10:47:23-08:00,['ab155369765f04b7a196864324047045214558c7'],1,1,2,3584135,1,,,,9881
8f9fc49ca0277ea4a6429effd8b9090a1cd6a4da,0,KovalevIV,2019-12-19 22:26:31+03:00,['4b08cf116c852a0a969ba0bea0be0bc4811f20bb'],7,15,22,3584157,2,1,1,0,9881
2277d08c8ec20101797a0642b629133d136bdfb1,0,Pierre Villard,2019-12-20 16:17:48+00:00,['0024668dd51516276517dca50eb478a8fb0fadff'],1,1,2,3584159,1,,,,9881
42cb6e84898e66672878f61f99543d6af3c0a567,0,Andy LoPresto,2019-12-23 16:07:52-05:00,['2277d08c8ec20101797a0642b629133d136bdfb1'],2,0,2,3584161,2,1,1,0,9881
ec5bc7ea7a6b0d4667bee3d7de58b49a64571d43,0,Pierre Villard,2019-12-26 10:58:54+01:00,['42cb6e84898e66672878f61f99543d6af3c0a567'],1,1,2,3584163,1,,,,9881
7f49c6b76aa930e8c00d5e3d11dd6d947cc31a3e,0,Pierre Villard,2019-12-26 16:41:31+01:00,['ec5bc7ea7a6b0d4667bee3d7de58b49a64571d43'],0,3,3,3584166,1,,,,9881
5f0f801e4600d12e05466bd19abbfc9d745c7994,1,Pierre Villard,2019-12-26 18:05:08+01:00,['7f49c6b76aa930e8c00d5e3d11dd6d947cc31a3e'],29,392,421,3584587,7,0.472477064,0.935779817,0.981651376,9882
ad636789f0213fb13f108277ba2bca6b15889ecd,0,Mike Thomsen,2019-12-29 19:10:30-05:00,['5f0f801e4600d12e05466bd19abbfc9d745c7994'],1,28,29,3584616,1,0,0,1,9882
82b4fb06338aa1019f70950b0d467352d36d66b0,1,Pierre Villard,2019-12-30 09:55:39+01:00,['ad636789f0213fb13f108277ba2bca6b15889ecd'],13,106,119,3584735,6,0,0.703703704,0.648148148,9882
41b47a51560748514ccdf7a880463ef97100fdee,0,Pierre Villard,2019-12-30 10:01:25+01:00,['82b4fb06338aa1019f70950b0d467352d36d66b0'],2,2,4,3584739,1,,,,9882
c15876494a7fb9ea5eb6cacf02a6ee5f46faa333,0,Mike Thomsen,2019-12-30 08:10:37-05:00,['41b47a51560748514ccdf7a880463ef97100fdee'],11,177,188,3584927,5,,,,9882
b470db620b512e25f9c091ddae7de98e18a347d2,0,Mike Thomsen,2020-01-03 19:25:01-05:00,['c15876494a7fb9ea5eb6cacf02a6ee5f46faa333'],5,36,41,3584968,4,0,0.952380952,0.952380952,9882
b03e5b0520230d90d112a1e7958fc17adbed3834,0,Bryan Bende,2020-01-06 11:34:51-05:00,['b470db620b512e25f9c091ddae7de98e18a347d2'],244,375,619,3585587,9,0.337209302,0.662790698,1,9882
c958deb5b01bf26c856b5d6a2b93cee87163c10f,1,Mark Payne,2020-01-06 13:05:19-05:00,['b470db620b512e25f9c091ddae7de98e18a347d2'],23,111,134,3585721,3,0.14084507,1,0.591549296,9882
e4bdc79ea64f25cdadd6a666b4e37a96682be1f1,0,GitHub,2020-01-06 15:01:42-05:00,"['b03e5b0520230d90d112a1e7958fc17adbed3834', 'c958deb5b01bf26c856b5d6a2b93cee87163c10f']",23,111,134,3585855,3,,,,9882
65ca8e6c8defbc82bbac8c510cf16621a34418e9,1,Joe Witt,2020-01-06 15:42:15-05:00,['e4bdc79ea64f25cdadd6a666b4e37a96682be1f1'],185,788,973,3586828,6,0.304878049,0.527439024,0.713414634,9885
1ee6dba00a1ce8654b730245bba7e43395e99fac,1,Pierre Villard,2020-01-07 15:15:44+07:00,['65ca8e6c8defbc82bbac8c510cf16621a34418e9'],21,33,54,3586882,6,0.285714286,0.285714286,1,9885
9ed4623817da0a3156db3f479741e007b8142ffe,0,Pierre Villard,2020-01-07 15:15:54+07:00,['1ee6dba00a1ce8654b730245bba7e43395e99fac'],69,67,136,3587018,6,1,0,0,9885
596e0ffbdc6759dcf6b9ceadedefbb9a600d36a2,0,GitHub,2020-01-07 10:48:50-05:00,"['9ed4623817da0a3156db3f479741e007b8142ffe', '2959c436b1ee78d09000adb6c3065190cf19902c']",1,98,99,3587117,2,,,,9885
209c560ff55a0d8aeeca91f29dbb48531ba71fa3,0,GitHub,2020-01-07 10:55:27-05:00,"['596e0ffbdc6759dcf6b9ceadedefbb9a600d36a2', '8f9fc49ca0277ea4a6429effd8b9090a1cd6a4da']",7,15,22,3587139,2,,,,9885
f4ef45678eff4ca0612f03ff4de3e5d2e29e4e2a,0,Pierre Villard,2020-01-08 02:02:04+07:00,['209c560ff55a0d8aeeca91f29dbb48531ba71fa3'],1,127,128,3587267,6,0,0.785714286,1,9888
f641a15c5fbc3b99931989ecf05cf9df12a5a9c6,1,Pierre Villard,2020-01-08 13:56:42+07:00,['f4ef45678eff4ca0612f03ff4de3e5d2e29e4e2a'],10,32,42,3587309,2,1,0.866666667,0.866666667,9888
c604923c0b20533299cbc2fa7e88dbfc0d790f80,0,Yolanda Davis,2020-01-08 04:25:14-04:00,['f641a15c5fbc3b99931989ecf05cf9df12a5a9c6'],0,480,480,3587789,6,0.343915344,0.746031746,0.899470899,9892
cc74534bc0c4556816e2f3d9b04dbf76f73ab22c,0,Matt Gilman,2020-01-08 13:25:45-05:00,['c604923c0b20533299cbc2fa7e88dbfc0d790f80'],409,403,812,3588601,41,1,0.5,1,9892
ebd33452c446db0fa4a57eb65c9e78fd32712739,0,Andy LoPresto,2020-01-08 11:10:58-08:00,['cc74534bc0c4556816e2f3d9b04dbf76f73ab22c'],12,3,15,3588616,4,,,,9892
28aa155fd43af1eef8ece38cf1ca2581be6c21cf,0,Pierre Villard,2020-01-09 17:16:23+07:00,['ebd33452c446db0fa4a57eb65c9e78fd32712739'],2,0,2,3588618,1,1,1,1,9892
8d214f99a4c2f58210279b918ca0d974ef6eb733,0,Pierre Villard,2020-01-09 17:26:43+07:00,['28aa155fd43af1eef8ece38cf1ca2581be6c21cf'],16,719,735,3589353,9,0.298102981,0.780487805,0.91598916,9896
08d0352ac11398f3400e3d23a99ff7d6546261ce,1,Pierre Villard,2020-01-09 17:35:25+07:00,['8d214f99a4c2f58210279b918ca0d974ef6eb733'],2,39,41,3589394,1,0,0.857142857,0.857142857,9896
a6f0498cf9d137f064959535f15f35564a820243,0,Kevin Doran,2020-01-09 11:53:15-05:00,['08d0352ac11398f3400e3d23a99ff7d6546261ce'],1,29,30,3589424,2,1,1,1,9896
0ae200252fb3f02b7659b189eaa6868ac67e0069,0,Andy LoPresto,2020-01-09 13:50:27-08:00,['a6f0498cf9d137f064959535f15f35564a820243'],0,147,147,3589571,3,0,1,1,9897
fc2e6b347103b2067b711e8efa05cb61fbe7e2f5,0,Andy LoPresto,2020-01-09 19:10:03-08:00,['0ae200252fb3f02b7659b189eaa6868ac67e0069'],1,1,2,3589573,1,,,,9897
b8ffb5461216b8330fb464162316197458f482c7,0,Matt Gilman,2020-01-10 09:03:07-05:00,['fc2e6b347103b2067b711e8efa05cb61fbe7e2f5'],2,2,4,3589577,1,,,,9897
2cc467eb587247f1e8e0f02285ee01acc4ec9918,1,Andy LoPresto,2020-01-10 10:44:59-08:00,['b8ffb5461216b8330fb464162316197458f482c7'],321,2466,2787,3592364,35,0.804713805,0.895622896,0.848484848,9907
2c18cf22ad0972aebf8c5c547b5b70823238de62,1,Joe Witt,2020-01-13 11:39:39-05:00,['2cc467eb587247f1e8e0f02285ee01acc4ec9918'],2,591,593,3592957,16,0.505681818,1,1,9918
bec1f772db0181c251588fa7294026a1363f464d,0,Joe Witt,2020-01-13 11:43:17-05:00,['2c18cf22ad0972aebf8c5c547b5b70823238de62'],0,16,16,3592973,1,,,,9918
26fcf8158a3e10c490db11340e95e1c7943eae06,1,Peter Turcsanyi,2020-01-13 17:50:33+01:00,['bec1f772db0181c251588fa7294026a1363f464d'],26,304,330,3593303,2,0.557788945,0.91959799,0.658291457,9918
ccb85cf8b7e6ee98e1e800e5db93c0a0c3b81feb,0,Joe Witt,2020-01-13 12:45:59-05:00,['26fcf8158a3e10c490db11340e95e1c7943eae06'],14,79,93,3593396,2,0,1,1,9919
b7fb94723c06ef0277ae0c274f6dd318c90f00ea,1,Mark Payne,2020-01-13 13:59:11-05:00,['ccb85cf8b7e6ee98e1e800e5db93c0a0c3b81feb'],117,1716,1833,3595229,27,0.458398744,0.87755102,0.959183673,9936
0dc6439ddb09d635576ce56632e8eca93aa864fd,0,Joe Witt,2020-01-13 15:08:13-05:00,['b7fb94723c06ef0277ae0c274f6dd318c90f00ea'],4,8,12,3595241,1,0,0,1,9936
4e2b61efe417da643d5fa234a4bf1abd286b7fb7,0,Andy LoPresto,2020-01-13 12:12:34-08:00,['0dc6439ddb09d635576ce56632e8eca93aa864fd'],3,9,12,3595253,2,1,1,1,9936
66d5ab80eb22f535da0898ae0d6a4a5da2dd7bd9,0,Joe Witt,2020-01-13 22:02:05-05:00,['4e2b61efe417da643d5fa234a4bf1abd286b7fb7'],53,255,308,3595561,5,0.076923077,0.979020979,1,9936
2601f722b3230a640e86c83320a75b86288c0e60,1,Joe Witt,2020-01-13 22:37:46-05:00,['66d5ab80eb22f535da0898ae0d6a4a5da2dd7bd9'],46,494,540,3596101,3,0.14953271,1,0.546728972,9937
eb37e7475f9e8473f3cbc64dc5fba1e086bfa417,1,Joe Witt,2020-01-14 11:58:45-05:00,['2601f722b3230a640e86c83320a75b86288c0e60'],1,1,2,3596103,1,,,,9937
6dbcf9d521cbda499877dce30c41602b66496ec8,0,Joe Witt,2020-01-14 11:59:08-05:00,['eb37e7475f9e8473f3cbc64dc5fba1e086bfa417'],0,10,10,3596113,1,0,1,1,9937
824cc0ed77b93d69a33358b1e8323102f30837ff,0,Joe Witt,2020-01-14 12:58:21-05:00,['6dbcf9d521cbda499877dce30c41602b66496ec8'],17,166,183,3596296,5,0.054545455,0.818181818,1,9938
421bfdd5fff87e477a91450f8414d7a989bd083f,0,Matthew Burgess,2020-01-14 16:14:48-05:00,['824cc0ed77b93d69a33358b1e8323102f30837ff'],20,51,71,3596367,2,0,1,1,9938
103325354b6930bf92e0f99b332866cbb2ffeb31,1,markap14,2020-01-14 17:07:44-05:00,['421bfdd5fff87e477a91450f8414d7a989bd083f'],17,704,721,3597088,7,0.363028953,0.79064588,0.781737194,9939
bb699e749755432837b3a4132372f635d7480be3,1,Joe Witt,2020-01-15 08:27:49-05:00,['103325354b6930bf92e0f99b332866cbb2ffeb31'],9,37,46,3597134,2,0,0.92,0.92,9939
cdbcc4725cb1f1b67f527dabb1ae7cd5dcdaa541,0,Scott Aslan,2020-01-15 09:24:45-05:00,['bb699e749755432837b3a4132372f635d7480be3'],15,0,15,3597149,1,,,,9939
aa2466480171a31cda970f500df53753765aceab,0,Joe Witt,2020-01-15 14:43:21-05:00,['cdbcc4725cb1f1b67f527dabb1ae7cd5dcdaa541'],0,4,4,3597153,1,,,,9939
23c8234586287f4ddb23bcfb3c155fe793048d63,0,Joe Witt,2020-01-15 16:10:31-05:00,['aa2466480171a31cda970f500df53753765aceab'],118,118,236,3597389,118,,,,9939
48d4e6d14c6d835e091d7609930b7eec5b977db3,0,Pierre Villard,2020-01-16 19:11:26+07:00,['23c8234586287f4ddb23bcfb3c155fe793048d63'],0,9,9,3597398,1,1,1,1,9939
91e9e65a5c302eac324bcd3a9a84c347238e3649,0,Pierre Villard,2020-01-16 19:11:35+07:00,['48d4e6d14c6d835e091d7609930b7eec5b977db3'],1,102,103,3597501,4,0.384615385,1,1,9941
ce050f4ecb839df24b8e5235f91a48acfde30e01,0,Matt Gilman,2020-01-16 11:31:18-05:00,['91e9e65a5c302eac324bcd3a9a84c347238e3649'],4,34,38,3597539,1,0,0.947368421,1,9941
34f2a592df8996b5f9e65039a35ecd8c31417fbd,0,Joe Witt,2020-01-16 13:00:08-05:00,['ce050f4ecb839df24b8e5235f91a48acfde30e01'],65,254,319,3597858,3,1,1,1,9942
3ef62dd11818d839f766aa2c7773ca948e1e5f0a,0,Pierre Villard,2020-01-17 18:03:02+07:00,['34f2a592df8996b5f9e65039a35ecd8c31417fbd'],1,1,2,3597860,1,,,,9942
f8057d0c2f0e12aeb9a03c49828db5d5211d5bd3,0,Joe Witt,2020-01-17 15:29:40-05:00,['3ef62dd11818d839f766aa2c7773ca948e1e5f0a'],1,1,2,3597862,2,,,1,9942
4ec9155cbc1796c0fc31893cdd91733b7f9cec45,1,Andy LoPresto,2020-01-17 20:01:06-08:00,['f8057d0c2f0e12aeb9a03c49828db5d5211d5bd3'],370,748,1118,3598980,16,1,0,0,9947
71226ce077c2e2369adb268207ba22907534b8b1,0,Mike Thomsen,2020-01-18 10:39:47-05:00,['4ec9155cbc1796c0fc31893cdd91733b7f9cec45'],3,34,37,3599017,4,0.833333333,0.833333333,1,9947
0789ec3a6b8a3a56afdb2f844937b0b39729aa3d,0,Joe Witt,2020-01-18 21:02:50-05:00,['71226ce077c2e2369adb268207ba22907534b8b1'],1,35,36,3599053,2,1,1,1,9947
3d99d02f93067937aa58859e9868b13e942630e1,0,Joe Witt,2020-01-18 21:07:31-05:00,['0789ec3a6b8a3a56afdb2f844937b0b39729aa3d'],1,11,12,3599065,1,0,0,1,9947
b205b99668152683384219f821854c0e563c2b46,0,Joe Witt,2020-01-19 08:47:58-05:00,['3d99d02f93067937aa58859e9868b13e942630e1'],1,5,6,3599071,1,0,0,0,9947
c1301e196c5be89819e702ec76912f3c426f3055,0,Joe Witt,2020-01-19 10:04:39-05:00,['b205b99668152683384219f821854c0e563c2b46'],16,183,199,3599270,3,0.670103093,1,0.948453608,9947
e51ab8c9d6b678dc4e9549562d7c9f58f0445a04,0,Joe Witt,2020-01-19 10:58:40-05:00,['c1301e196c5be89819e702ec76912f3c426f3055'],10,82,92,3599362,2,0.050847458,0.237288136,0.610169492,9947
b35ad7cd2089c20f34692fff51f39488df0feaf9,0,Joe Witt,2020-01-19 11:04:39-05:00,['e51ab8c9d6b678dc4e9549562d7c9f58f0445a04'],12,9,21,3599383,2,1,1,1,9947
4fec54debfdf8face33cb1738a0d2b340e249f09,0,Joe Witt,2020-01-19 11:06:37-05:00,['b35ad7cd2089c20f34692fff51f39488df0feaf9'],2,6,8,3599391,1,1,1,1,9947
ab0113664d5e6b96ffcbc70feaea73d3b71eb51a,1,Joe Witt,2020-01-19 11:09:52-05:00,['4fec54debfdf8face33cb1738a0d2b340e249f09'],0,7,7,3599398,1,0,1,1,9947
de2a286a7a01725ee11d839ead7811a4135f8b41,1,Joe Witt,2020-01-19 11:43:19-05:00,['ab0113664d5e6b96ffcbc70feaea73d3b71eb51a'],2,2617,2619,3602017,23,0.416289593,0.464932127,0.514705882,9967
3015ee39da293938c8119e6f48b2d32548b14b96,0,Joe Witt,2020-01-19 11:45:21-05:00,['de2a286a7a01725ee11d839ead7811a4135f8b41'],3,4,7,3602024,2,,,,9967
ddaaded08f467bd7a4ccb7c167704d711545d4ce,0,Joe Witt,2020-01-19 12:02:03-05:00,['3015ee39da293938c8119e6f48b2d32548b14b96'],0,1,1,3602025,1,,,,9967
b045c4ce0b7fe3ad3b9f87fd8eb419021688dddb,1,Joe Witt,2020-01-19 12:06:04-05:00,['ddaaded08f467bd7a4ccb7c167704d711545d4ce'],1,25,26,3602051,1,,,,9967
cddaac591bbf13ad19490bfaebf92a5b17993e18,0,Joe Witt,2020-01-19 12:08:22-05:00,['b045c4ce0b7fe3ad3b9f87fd8eb419021688dddb'],40,171,211,3602262,3,0,0.957746479,1,9967
67c36f3c3e1ff7080c72d948b0b8e02caceda675,0,Joe Witt,2020-01-19 13:32:37-05:00,['cddaac591bbf13ad19490bfaebf92a5b17993e18'],15,11,26,3602288,2,,,,9967
ed324058c7026958b444a4ecd921c0e3347880a1,0,Joe Witt,2020-01-19 13:49:56-05:00,['67c36f3c3e1ff7080c72d948b0b8e02caceda675'],1,0,1,3602289,1,,,,9967
633408bce7ad34dad727ed9c4edfd36a224f3f12,0,Joe Witt,2020-01-19 14:14:38-05:00,['ed324058c7026958b444a4ecd921c0e3347880a1'],1664,1647,3311,3605600,467,,,,9967
3de77ebaccfdf10095db2eeb6559ff0de5194515,1,Joe Witt,2020-01-19 14:14:40-05:00,['633408bce7ad34dad727ed9c4edfd36a224f3f12'],1605,1605,3210,3608810,467,,,,9967
24ef8ba4cbd28a481d475356a17b76b2af924da5,1,Matt Gilman,2020-01-21 13:54:12-05:00,['ed324058c7026958b444a4ecd921c0e3347880a1'],8,12,20,3608830,1,0,1,1,9967
24b846d08ab4fe19318fe33104dab7ccc419a375,0,Bryan Bende,2020-01-22 15:51:42-05:00,['24ef8ba4cbd28a481d475356a17b76b2af924da5'],35,118,153,3608983,4,0.092307692,0.015384615,0.861538462,9967
535cafdb83d1b70b7763c3e63b2d219e32e610f4,0,Joe Witt,2020-01-22 21:15:12-05:00,"['24b846d08ab4fe19318fe33104dab7ccc419a375', '3de77ebaccfdf10095db2eeb6559ff0de5194515']",1663,1646,3309,3612292,467,,,,9967
379c3fbe5110df02d7278a4ff27f4cefafdb6b1c,0,Joe Witt,2020-01-22 22:09:29-05:00,['535cafdb83d1b70b7763c3e63b2d219e32e610f4'],3,3,6,3612298,3,,,,9967
be34767c8a0670bce564f6aac4490e3250817675,1,Joe Witt,2020-01-22 23:30:41-05:00,['379c3fbe5110df02d7278a4ff27f4cefafdb6b1c'],36,157,193,3612491,5,0.313253012,0.987951807,0.987951807,9967
aedccb8297cab014103df2a98803259334ceb15c,0,Yolanda Davis,2020-01-27 20:07:21-05:00,['be34767c8a0670bce564f6aac4490e3250817675'],7,7,14,3612505,1,,,,9967
37ef10e6fb8a65c9ae563756f7cb26515c1eea0c,0,Joe Witt,2020-01-29 15:50:55-05:00,['aedccb8297cab014103df2a98803259334ceb15c'],278,1,279,3612784,3,0.257142857,0,0.085714286,9967
04fae9cb5f8bb8d98576baa57f4b06ed6c260e02,0,Pierre Villard,2020-01-30 14:49:41+07:00,['37ef10e6fb8a65c9ae563756f7cb26515c1eea0c'],1,49,50,3612834,6,,,,9967
850869c6d212324e1aad96878f5b142797667c45,1,Arpad Boda,2020-01-30 15:15:43+01:00,['04fae9cb5f8bb8d98576baa57f4b06ed6c260e02'],8,41,49,3612883,2,0,1,1,9967
76e8c51e11ce42fc99d48722507e101a05bec868,0,Joe Witt,2020-01-30 13:06:46-05:00,['850869c6d212324e1aad96878f5b142797667c45'],5,49,54,3612937,2,0.444444444,1,0.722222222,9967
c8af8eaa766407cb137d0074f824981b5bc07d93,0,Kevin Doran,2020-01-31 01:03:32-05:00,['76e8c51e11ce42fc99d48722507e101a05bec868'],0,2,2,3612939,4,,,,9967
95746d346cddbd6134c4b28fdc39d5813a626f97,1,markap14,2020-01-31 08:58:51-05:00,['c8af8eaa766407cb137d0074f824981b5bc07d93'],74,1053,1127,3614066,12,0.692307692,1,0.794871795,9974
d7c29f46378379fb596e4d1e59d1a3c41063db5b,1,markap14,2020-01-31 08:58:51-05:00,['95746d346cddbd6134c4b28fdc39d5813a626f97'],12,8,20,3614086,3,0,0,0,9974
d80875e6bad48ff004495aa03a496453252803f0,0,GitHub,2020-01-31 10:18:05-08:00,['d7c29f46378379fb596e4d1e59d1a3c41063db5b'],0,2,2,3614088,1,,,,9974
dd6bcc74850daf8f5d7a8621aacd6140eedd4001,0,GitHub,2020-02-03 09:45:08-05:00,['d80875e6bad48ff004495aa03a496453252803f0'],0,812,812,3614900,11,0.53030303,1,0.833333333,9983
98f9b7c033a8d80ddf43aa77f63107703077d297,0,Pierre Villard,2020-02-04 17:07:44-05:00,['dd6bcc74850daf8f5d7a8621aacd6140eedd4001'],1,5,6,3614906,1,1,1,1,9983
5d851e6a136ce28cc4ccd262b4d15a2f37856255,0,Matt Gilman,2020-02-05 09:19:18-05:00,['98f9b7c033a8d80ddf43aa77f63107703077d297'],26,46,72,3614978,3,0,1,0.666666667,9983
b1b06bf5e17b3b59c279e13d2011214c647d4042,0,markap14,2020-02-05 13:49:06-05:00,['5d851e6a136ce28cc4ccd262b4d15a2f37856255'],2,2,4,3614982,1,,,,9983
7503e5f43ff81619f0a115b0f14de5b7a08aff43,0,GitHub,2020-02-05 14:13:00-05:00,['b1b06bf5e17b3b59c279e13d2011214c647d4042'],1,1,2,3614984,1,,,,9983
425ba63e6693967f545d409b9b4ccefe6485cee5,0,Andy LoPresto,2020-02-06 10:32:59-05:00,['7503e5f43ff81619f0a115b0f14de5b7a08aff43'],6,68,74,3615058,1,0.911111111,0.977777778,0.822222222,9983
089013aa596216024c1870e6941b8037654ca000,0,GitHub,2020-02-06 14:10:48-05:00,['425ba63e6693967f545d409b9b4ccefe6485cee5'],2,2,4,3615062,2,,,,9983
ac0382c7aea5d921ede5cc7008a72e349eb2d39d,0,GitHub,2020-02-06 14:17:39-05:00,['089013aa596216024c1870e6941b8037654ca000'],0,6,6,3615068,1,,,,9983
62830122cb72b0b0f5b083786d4c1294ebae6976,0,Andy LoPresto,2020-02-06 14:30:51-05:00,['ac0382c7aea5d921ede5cc7008a72e349eb2d39d'],14,21,35,3615103,2,,,,9983
f738e19a757675228f8e594ef1461ce5084eeb56,1,Pierre Villard,2020-02-06 19:34:18-05:00,['62830122cb72b0b0f5b083786d4c1294ebae6976'],10,350,360,3615463,6,0.118811881,0.881188119,1,9985
58bcd6c5ddc1989e99b5630b89f413ef4726b4a0,0,Matthew Burgess,2020-02-10 12:07:21-05:00,['f738e19a757675228f8e594ef1461ce5084eeb56'],25,46,71,3615534,4,0.181818182,0.545454545,0.454545455,9985
8faea04ff13b847fa2065ed127273d706be89064,0,GitHub,2020-02-10 17:22:49-08:00,['58bcd6c5ddc1989e99b5630b89f413ef4726b4a0'],3,3,6,3615540,3,,,,9985
5e964fbc474034cb5342e22aa290f1040af377ea,1,Matthew Burgess,2020-02-11 10:59:20-05:00,['8faea04ff13b847fa2065ed127273d706be89064'],6,214,220,3615760,5,0.226950355,0.957446809,0.90070922,9985
65b2a9bc2c91657bc160fe93d6051da95ab5db34,0,Pierre Villard,2020-02-11 10:59:19-08:00,['5e964fbc474034cb5342e22aa290f1040af377ea'],5,103,108,3615868,6,0,0.947368421,0.50877193,9985
a80b2475f79ae8142202e64bb7822f05814b2dd4,0,Pierre Villard,2020-02-11 11:21:27-08:00,['65b2a9bc2c91657bc160fe93d6051da95ab5db34'],2,76,78,3615946,2,0,0.983606557,0.983606557,9985
62606ff89a5947197fc0a92adae9e7a5104ca2b7,1,Mark Payne,2020-02-11 14:46:40-05:00,['a80b2475f79ae8142202e64bb7822f05814b2dd4'],1110,1757,2867,3618813,25,1,1,0,9992
6e8f10c4f66f0167b9a43c91c549f1d36208d9cc,0,Matthew Burgess,2020-02-12 11:22:31-05:00,['62606ff89a5947197fc0a92adae9e7a5104ca2b7'],14,243,257,3619070,3,0.61971831,1,0.887323944,9994
37614d02cd6721a33504ac2918b28243700632d1,0,GitHub,2020-02-14 20:46:08-08:00,['6e8f10c4f66f0167b9a43c91c549f1d36208d9cc'],2,2,4,3619074,1,,,,9994
7e5e332842685fc2cd222a60b75d1ea8506023b9,1,Pierre Villard,2020-02-17 12:11:16-08:00,['37614d02cd6721a33504ac2918b28243700632d1'],2,2,4,3619078,2,,,,9994
fe416d1ea0e1b7f15c1fdf8884d10f280d126f4e,0,Pierre Villard,2020-02-18 12:30:25-08:00,['7e5e332842685fc2cd222a60b75d1ea8506023b9'],0,24,24,3619102,2,1,1,0.733333333,9994
268ba1d23e34252ca9a6f61b7caacdc36a0be48d,1,Pierre Villard,2020-02-18 12:33:58-08:00,['fe416d1ea0e1b7f15c1fdf8884d10f280d126f4e'],12,121,133,3619235,3,0.1,0.242857143,0.5,9994
09c7406d1835dc9828e6aa798db934830fb1f548,0,Pierre Villard,2020-02-18 14:36:02-08:00,['268ba1d23e34252ca9a6f61b7caacdc36a0be48d'],5,38,43,3619278,2,0,1,1,9994
4098404596ab9994cb9cb3ca57a58a7b2f593d70,0,Pierre Villard,2020-02-18 15:30:08-08:00,['09c7406d1835dc9828e6aa798db934830fb1f548'],28,40,68,3619346,3,0.333333333,0.5,0.5,9994
0de89452f1975c5724e75e5f9d5865bb814cf4de,1,Andy LoPresto,2020-02-19 16:19:39-08:00,['4098404596ab9994cb9cb3ca57a58a7b2f593d70'],307,184,491,3619837,10,0,0,0,9994
41518d953cde9776451a7f395747acd7cc8beb7a,0,Andy LoPresto,2020-02-19 20:36:57-08:00,['0de89452f1975c5724e75e5f9d5865bb814cf4de'],14,34,48,3619885,2,,,,9994
c5873eceb716c3d8ea014513d629748b5a4ceb40,0,Pierre Villard,2020-02-19 21:00:33-08:00,['41518d953cde9776451a7f395747acd7cc8beb7a'],2,2,4,3619889,1,,,,9994
f8a5d1295c13aac0a3efaeec91f7ab3d0b5a5573,0,Pierre Villard,2020-02-20 16:36:51-08:00,['c5873eceb716c3d8ea014513d629748b5a4ceb40'],320,122,442,3620331,8,1,0.518072289,0,9995
c5c1fa4e8557c9546f8f275635023040422c0993,0,Pierre Villard,2020-02-20 16:41:40-08:00,['f8a5d1295c13aac0a3efaeec91f7ab3d0b5a5573'],1,1,2,3620333,1,,,,9995
eef04709b97f41a9c27cca82a9b885d03cb43784,0,GitHub,2020-02-21 10:41:41-08:00,['c5c1fa4e8557c9546f8f275635023040422c0993'],13,17,30,3620363,1,,,,9995
8fa855c8c3947151213bae830721c220ef20ef20,0,Bryan Bende,2020-02-21 14:56:33-05:00,['eef04709b97f41a9c27cca82a9b885d03cb43784'],201,1861,2062,3622425,9,0.422244094,0.797244094,0.842519685,10000
1b0e3865e9ba160bf3b68e33f1938bc6c03229bd,0,Joe Witt,2020-02-21 17:37:54-05:00,['eef04709b97f41a9c27cca82a9b885d03cb43784'],17,55,72,3622497,6,0.05,0.05,0.85,10000
6ea78c55480f306ce3f49bc6636e73d11e7e44c5,0,Joe Witt,2020-02-21 17:38:36-05:00,['1b0e3865e9ba160bf3b68e33f1938bc6c03229bd'],2,2,4,3622501,1,,,,10000
49ba9e8196636ff75adc064c0f1e5b3d13506f56,0,Joe Witt,2020-02-21 18:05:40-05:00,['6ea78c55480f306ce3f49bc6636e73d11e7e44c5'],1,1,2,3622503,1,,,,10000
e631851e0f7e82b1e4bd33eb214fbd875a0d6cb1,0,Pierre Villard,2020-02-22 11:07:31-08:00,['49ba9e8196636ff75adc064c0f1e5b3d13506f56'],3,7,10,3622513,3,0,1,1,10000
722b99432ce075f93659c168ba367d38006fdf1c,0,Pierre Villard,2020-02-22 11:18:56-08:00,['e631851e0f7e82b1e4bd33eb214fbd875a0d6cb1'],6,6,12,3622525,1,,,,10000
9a8a551e03753c8bd9b256613572e42b7d831e8f,0,Joe Witt,2020-02-23 11:50:34-08:00,['722b99432ce075f93659c168ba367d38006fdf1c'],13,24,37,3622562,1,0,0,1,10000
fd7c01453bd9512d836568ef9aae1fd0dd2bc0a2,0,Joe Witt,2020-02-23 11:54:28-08:00,['9a8a551e03753c8bd9b256613572e42b7d831e8f'],1,18,19,3622581,2,0.625,0.625,1,10000
4f315edc6eb829dd2127030f440a177c6dd1047e,0,Joe Witt,2020-02-23 11:59:49-08:00,['fd7c01453bd9512d836568ef9aae1fd0dd2bc0a2'],1,1,2,3622583,1,,,,10000
9848eb4409fe672e7d321ea3ac3351e8a5972e14,1,Matthew Burgess,2020-02-24 15:14:16-05:00,['4f315edc6eb829dd2127030f440a177c6dd1047e'],14,900,914,3623497,3,0.443123939,0.842105263,0.872665535,10001
acaf321af022929533f0dc25e0e1eba796bc3e46,0,Matthew Burgess,2020-02-24 16:14:21-05:00,['9848eb4409fe672e7d321ea3ac3351e8a5972e14'],2,98,100,3623597,4,0.476190476,0.761904762,0.825396825,10001
479fcfdc0bbd97dd0635bbec0273cc25fcf9cc03,0,Nathan Gough,2020-02-24 16:35:19-05:00,['acaf321af022929533f0dc25e0e1eba796bc3e46'],800,5260,6060,3629657,69,0.651543793,0.899810964,0.971644612,10034
778012412a0265d2ac3fc4802e16cdcdf99f9f93,1,Joe Witt,2020-02-24 22:07:53-08:00,['479fcfdc0bbd97dd0635bbec0273cc25fcf9cc03'],5260,800,6060,3635717,69,0.348456207,0.100189036,0.028355388,10036
abf223d574f0d5c1d3484374535e6ae1d0f6c6c0,0,Matthew Burgess,2020-02-25 09:59:39-05:00,['778012412a0265d2ac3fc4802e16cdcdf99f9f93'],184,844,1028,3636745,19,0.782426778,1,0.90376569,10045
cff1e329a25403eddeb686e820774f98b26634b6,0,Joe Witt,2020-02-25 13:12:53-08:00,['abf223d574f0d5c1d3484374535e6ae1d0f6c6c0'],0,8,8,3636753,1,,,,10045
815e4cf51f913645352899837f702c7cd4f3a246,0,GitHub,2020-02-25 13:14:52-08:00,['cff1e329a25403eddeb686e820774f98b26634b6'],2,268,270,3637023,5,0.485714286,1,1,10049
c092a23bdf787f68fc061aa4c546d87a05b5753c,0,Pierre Villard,2020-02-25 14:05:47-08:00,['815e4cf51f913645352899837f702c7cd4f3a246'],1,1,2,3637025,1,,,,10049
bad0f10a52de4822147dfb8a13f35eccdbc0bb3c,1,Pierre Villard,2020-02-25 17:38:33-08:00,['c092a23bdf787f68fc061aa4c546d87a05b5753c'],29,129,158,3637183,5,,,,10049
0bb8ce7438d9855dcca6bf89e3a672d1f9477593,0,Matthew Burgess,2020-02-26 08:50:32-05:00,['bad0f10a52de4822147dfb8a13f35eccdbc0bb3c'],7,22,29,3637212,4,0,0.25,1,10049
4cd63c99e8f412650caa2f3b775a9647f6414a98,0,Pierre Villard,2020-02-26 14:02:49-08:00,['0bb8ce7438d9855dcca6bf89e3a672d1f9477593'],7,7,14,3637226,2,,,,10049
23b04ae96863fc3b0fd3b268bcb7d155edf17f26,0,Pierre Villard,2020-02-26 15:54:53-08:00,['4cd63c99e8f412650caa2f3b775a9647f6414a98'],5,31,36,3637262,3,0.2,0,1,10049
ccb62826b7a3a9434f3cc078e9af292f1c67f0a0,0,Joey Frazee,2020-02-27 14:57:55-06:00,['23b04ae96863fc3b0fd3b268bcb7d155edf17f26'],13,306,319,3637581,10,0.111111111,0.920634921,0.920634921,10051
ddfc425d9867f4247bb1ec88e8dba97a5fe642e0,0,Joey Frazee,2020-02-27 14:57:55-06:00,['ccb62826b7a3a9434f3cc078e9af292f1c67f0a0'],4,2,6,3637587,2,1,0,0,10051
614136ce51638fc8ca28cab47d4e5bfa253b6cc4,1,Bryan Bende,2020-02-28 10:10:19-05:00,['23b04ae96863fc3b0fd3b268bcb7d155edf17f26'],40,519,559,3638146,17,0.0078125,0.90625,0.921875,10055
167853163884a20c27cd44b38679918220774411,0,Bryan Bende,2020-03-02 11:28:59-05:00,['614136ce51638fc8ca28cab47d4e5bfa253b6cc4'],147,505,652,3638798,20,0.124352332,0,0.911917098,10055
ab1658130d4fa9041c1cceaffeab2836ef9cbe15,0,Bryan Bende,2020-03-02 11:43:13-05:00,['167853163884a20c27cd44b38679918220774411'],23,131,154,3638952,6,0.27027027,0.72972973,0.891891892,10055
c74e71306eae381fee7b0bf5f643ae7462461461,0,GitHub,2020-03-02 12:50:20-05:00,"['ab1658130d4fa9041c1cceaffeab2836ef9cbe15', '8fa855c8c3947151213bae830721c220ef20ef20']",201,1861,2062,3641014,9,,,,10055
5b93e537d59bc005e5e1cab0aa14537566dbac2c,1,jstorck,2020-03-02 14:03:37-05:00,['c74e71306eae381fee7b0bf5f643ae7462461461'],12,121,133,3641147,4,0,0.5625,1,10055
e0fc75a963ba88fd9d272244df920d210a98a895,0,jstorck,2020-03-02 14:20:20-05:00,['5b93e537d59bc005e5e1cab0aa14537566dbac2c'],4,81,85,3641232,3,0,0,1,10055
852d2f32104f96e47e6d42ddfaba3747d0e05dc0,0,jstorck,2020-03-02 16:01:39-05:00,['e0fc75a963ba88fd9d272244df920d210a98a895'],44,204,248,3641480,7,0,0.156862745,1,10055
2cf4fde6868aa7148148fa45371c255b75579faf,0,Pierre Villard,2020-03-03 16:43:56+01:00,['852d2f32104f96e47e6d42ddfaba3747d0e05dc0'],2,2,4,3641484,1,,,,10055
cb08382da4cb888c1d8cdfab078a57c0c2986501,0,GitHub,2020-03-03 15:47:42-08:00,['2cf4fde6868aa7148148fa45371c255b75579faf'],1,1,2,3641486,1,,,,10055
0b2816baa4a44ac8e2128e4730796cc193d8bced,0,GitHub,2020-03-03 15:50:49-08:00,['cb08382da4cb888c1d8cdfab078a57c0c2986501'],1,1,2,3641488,1,,,,10055
bad254ec5b3ea6ab70a9aed673158a21ec40c378,1,Pierre Villard,2020-03-04 10:36:06+01:00,['0b2816baa4a44ac8e2128e4730796cc193d8bced'],1,39,40,3641528,2,0.28,1,0.72,10055
4b6de8d164a2fe52d03fe06e751e2ece4ce7c680,0,Matthew Burgess,2020-03-04 11:21:27-05:00,['bad254ec5b3ea6ab70a9aed673158a21ec40c378'],145,184,329,3641857,2,0.21875,0.71875,1,10055
74b1b2fc596f43389b9a7629e4c8544e9e008997,1,markap14,2020-03-04 11:46:47-05:00,['4b6de8d164a2fe52d03fe06e751e2ece4ce7c680'],16,18,34,3641891,2,0,0.8,0.8,10055
7773681eeaa82f9c4099a3191d1f7f784f91bf7a,0,GitHub,2020-03-04 12:59:05-08:00,['74b1b2fc596f43389b9a7629e4c8544e9e008997'],1,1,2,3641893,1,,,,10055
f1c6e92df58bf24eb5199cdcb1784cbc438946db,0,Matthew Burgess,2020-03-04 18:34:18-05:00,['7773681eeaa82f9c4099a3191d1f7f784f91bf7a'],0,24,24,3641917,2,0,0.8,0.8,10055
b82fec41d96ccf808ab060ac68433cb95421212b,0,Pierre Villard,2020-03-05 11:01:48+01:00,['f1c6e92df58bf24eb5199cdcb1784cbc438946db'],26,0,26,3641943,1,1,0,0,10055
040c8a0af9f2058188dacd5818ec7acbe2635788,1,Pierre Villard,2020-03-06 12:48:15+01:00,['b82fec41d96ccf808ab060ac68433cb95421212b'],120,91,211,3642154,7,0,0,0,10055
7c57e75da42bf9ca8b8c0b609717314c84124970,0,Mark Payne,2020-03-06 09:51:37-05:00,['040c8a0af9f2058188dacd5818ec7acbe2635788'],685,1499,2184,3644338,20,0.952861953,0.885521886,0.952861953,10063
20dda05f2622fe9153c50989d36d7fa0268136e9,0,Joe Witt,2020-03-06 12:46:02-05:00,['7c57e75da42bf9ca8b8c0b609717314c84124970'],2,4,6,3644344,2,0,0,1,10063
f283c1191ca207217f3e22c24574e340b10db580,0,Joe Witt,2020-03-06 12:46:17-05:00,['20dda05f2622fe9153c50989d36d7fa0268136e9'],2,10,12,3644356,1,0.75,1,1,10063
cca54f7ff22709debe9f3b3b9b97eee92e1e0193,0,Kevin Doran,2020-03-06 13:34:23-05:00,['f283c1191ca207217f3e22c24574e340b10db580'],0,143,143,3644499,3,,,,10063
57947cd2a205a522b3d929fde8c0cf102a7a59c6,0,GitHub,2020-03-06 16:06:21-03:00,['cca54f7ff22709debe9f3b3b9b97eee92e1e0193'],1,3,4,3644503,1,1,1,0,10063
f4b65afb6462dc52420fe93eaca55f0a319ec0ae,1,Mark Payne,2020-03-06 15:01:19-05:00,['cca54f7ff22709debe9f3b3b9b97eee92e1e0193'],17,12,29,3644532,3,0,0,,10063
578430c9d9d52cabb0d60dd4a21634475ba2db9e,1,Mark Payne,2020-03-06 15:35:59-05:00,['f4b65afb6462dc52420fe93eaca55f0a319ec0ae'],16,446,462,3644994,6,0.081967213,0.344262295,0.62295082,10066
ac4d52b6ca7c4a11a8f3a303aebac3e3ebed6144,0,Pierre Villard,2020-03-07 15:21:31+01:00,['578430c9d9d52cabb0d60dd4a21634475ba2db9e'],1,5,6,3645000,1,0,1,1,10066
0f775f3a578ad855d4768619d361ff30a0f380ab,0,Mike Thomsen,2020-03-08 08:10:54-04:00,['ac4d52b6ca7c4a11a8f3a303aebac3e3ebed6144'],1,2,3,3645003,1,,,,10066
a33a5e35b3e56ed66c7befb82e2b7d97e9c8131b,0,GitHub,2020-03-08 13:18:12-04:00,"['0f775f3a578ad855d4768619d361ff30a0f380ab', '57947cd2a205a522b3d929fde8c0cf102a7a59c6']",1,3,4,3645007,1,,,,10066
12c8402ac3e648dd63b959b415cea61099b10864,0,Matthew Burgess,2020-03-09 16:29:22-04:00,['a33a5e35b3e56ed66c7befb82e2b7d97e9c8131b'],4,64,68,3645075,10,0.903846154,0.961538462,0.423076923,10066
7b0ae56a2c08de8898cc55ce8e4d44b2e1767fcd,0,GitHub,2020-03-09 16:54:56-07:00,['12c8402ac3e648dd63b959b415cea61099b10864'],0,3,3,3645078,2,,,,10066
afad982e91debd1109a6ec6d1865a77e8b3470ee,1,Joe Witt,2020-03-10 14:32:43-04:00,['7b0ae56a2c08de8898cc55ce8e4d44b2e1767fcd'],252,72,324,3645402,18,0.423913043,0.923913043,0.130434783,10066
a679e88b6f4f0e5f800aba5a6891494bdbdfb193,1,Pierre Villard,2020-03-11 10:08:51+01:00,['afad982e91debd1109a6ec6d1865a77e8b3470ee'],2,15,17,3645419,2,0,1,1,10066
9cb85a4fd0b42d0b78e4c9a957cd6f659e1c91d0,0,Pierre Villard,2020-03-11 10:26:10+01:00,['a679e88b6f4f0e5f800aba5a6891494bdbdfb193'],1,1,2,3645421,1,,,,10066
89d8b877f9adc3f474983c4dec45bf4586a6baef,0,Peter Turcsanyi,2020-03-11 10:54:20+01:00,['9cb85a4fd0b42d0b78e4c9a957cd6f659e1c91d0'],0,26,26,3645447,2,0,1,0.95,10066
3de3ad40290ccd4c9e09d5c4fd03e83a6cbf0d86,0,Pierre Villard,2020-03-11 19:24:10+01:00,['89d8b877f9adc3f474983c4dec45bf4586a6baef'],1,58,59,3645506,3,0,0.85,1,10066
cd83e70b91fb1e07381ec55bd86605c376b8db44,0,markap14,2020-03-11 14:29:44-04:00,['3de3ad40290ccd4c9e09d5c4fd03e83a6cbf0d86'],2,121,123,3645629,5,0,0,0.96875,10068
67676ba5b48c72c5b3dc9994d386e99832e708df,1,markap14,2020-03-11 14:29:44-04:00,['cd83e70b91fb1e07381ec55bd86605c376b8db44'],7,26,33,3645662,2,0,0,0.133333333,10068
d68720920fa10155eff81e1c1314a9286ba7a51c,1,Pierre Villard,2020-03-11 21:00:43+01:00,['67676ba5b48c72c5b3dc9994d386e99832e708df'],51,499,550,3646212,17,0.43373494,0.606425703,0.931726908,10070
290bd378d5e219dabac8f3ecf2bf9c69451f1c3c,0,GitHub,2020-03-11 15:51:15-07:00,['d68720920fa10155eff81e1c1314a9286ba7a51c'],10,284,294,3646506,2,0.50877193,0.50877193,0.596491228,10070
d4a2afc25ce35570dff73e6cb02a6820dd7062e1,0,Pierre Villard,2020-03-12 10:25:04+01:00,['290bd378d5e219dabac8f3ecf2bf9c69451f1c3c'],18,24,42,3646548,1,0,0,0,10070
dfaef3880515c4018727589a3f5e681a34b55e5e,0,Pierre Villard,2020-03-12 10:44:48+01:00,['d4a2afc25ce35570dff73e6cb02a6820dd7062e1'],3,14,17,3646565,2,0,1,1,10070
97e250cdaa4731e9d2b8cca9ed041848b1410e7a,1,Pierre Villard,2020-03-12 19:13:59+01:00,['dfaef3880515c4018727589a3f5e681a34b55e5e'],41,396,437,3647002,66,0.85840708,1,1,10070
decb5d062ea20714b666906e1414e0c9a8e4064c,0,Marc Parisi,2020-03-12 20:48:52-04:00,['97e250cdaa4731e9d2b8cca9ed041848b1410e7a'],63,25,88,3647090,1,0.964285714,1,0,10070
dbda8c7f7eb4de035414bb5c478d6969c387d3e3,1,Pierre Villard,2020-03-13 10:07:34+01:00,['decb5d062ea20714b666906e1414e0c9a8e4064c'],1,1,2,3647092,1,,,,10070
dc95cff3b75dbaba5a95044c07da7ce0936522b3,0,Matt Gilman,2020-03-13 12:02:24-04:00,['dbda8c7f7eb4de035414bb5c478d6969c387d3e3'],1,1,2,3647094,1,,,,10070
798a8eeb509209015e619f0ec4b6826f2754634f,1,Pierre Villard,2020-03-13 17:20:45+01:00,['dc95cff3b75dbaba5a95044c07da7ce0936522b3'],1,99,100,3647194,3,0.297297297,0.810810811,1,10070
561be89a2174542f2e089e72a64225d8300a623b,0,Pierre Villard,2020-03-13 17:30:19+01:00,['798a8eeb509209015e619f0ec4b6826f2754634f'],5,13,18,3647212,3,1,1,1,10070
0ad58200af01c5c07e25770acd967e7321800547,0,Joe Witt,2020-03-13 14:05:40-04:00,['561be89a2174542f2e089e72a64225d8300a623b'],31,30,61,3647273,1,,,,10070
ace575452415a092fb6923d947e010eeb1e41c96,0,markap14,2020-03-13 15:00:24-04:00,['0ad58200af01c5c07e25770acd967e7321800547'],5,8,13,3647286,2,0,1,1,10070
60b6327757aaf23b0f93acd4c27bdb5d45e40732,0,GitHub,2020-03-15 09:26:44-04:00,"['ddfc425d9867f4247bb1ec88e8dba97a5fe642e0', 'ace575452415a092fb6923d947e010eeb1e41c96']",1910,7589,9499,3656785,235,,,,10070
62c34d7e237a0aefcf71aa3ad9fe04986a10100f,0,GitHub,2020-03-15 10:27:20-04:00,"['ace575452415a092fb6923d947e010eeb1e41c96', '60b6327757aaf23b0f93acd4c27bdb5d45e40732']",14,305,319,3657104,10,,,,10070
7374361b5c6398a92577479d297e55dbe7ea2f63,1,Joe Witt,2020-03-16 12:26:50-04:00,['62c34d7e237a0aefcf71aa3ad9fe04986a10100f'],13,273,286,3657390,7,0,0.962025316,1,10072
f9d75056fa293acf7c2965d9cdba62f2b151886e,1,Joe Witt,2020-03-16 12:28:01-04:00,['7374361b5c6398a92577479d297e55dbe7ea2f63'],44,99,143,3657533,2,0.75,1,1,10072
69b6c231fddb4c547905e85c4087af18ea77c38f,0,Joe Witt,2020-03-16 12:28:18-04:00,['f9d75056fa293acf7c2965d9cdba62f2b151886e'],0,23,23,3657556,1,,,,10072
3feb85a030c6766941e64875ff825560878d54cc,1,Joe Witt,2020-03-16 12:47:41-04:00,['69b6c231fddb4c547905e85c4087af18ea77c38f'],11,13,24,3657580,1,,,,10072
71bf12976f98d7d4cad7edf53bd4707856187590,0,Pierre Villard,2020-03-16 21:28:12+01:00,['3feb85a030c6766941e64875ff825560878d54cc'],2,7,9,3657589,1,0,1,1,10072
7105bf36a8e191cacf43ed8ac6171be64a8c2e02,0,GitHub,2020-03-17 15:51:28-07:00,['71bf12976f98d7d4cad7edf53bd4707856187590'],1,1,2,3657591,1,,,,10072
f91d6c420d78aa000f1cc894636f56b533b589b8,1,GitHub,2020-03-17 19:49:15-07:00,['7105bf36a8e191cacf43ed8ac6171be64a8c2e02'],195,97,292,3657883,14,1,1,1,10072
943de310ad5b5fa6c128882da84c88621abd69b3,0,Mike Thomsen,2020-03-18 18:36:09-04:00,['f91d6c420d78aa000f1cc894636f56b533b589b8'],3,31,34,3657917,2,0.041666667,1,1,10072
23fa2d3138c13e418b40be760e33d7d386ddf98e,0,Mike Thomsen,2020-03-19 12:24:26-04:00,['943de310ad5b5fa6c128882da84c88621abd69b3'],0,10,10,3657927,1,0,1,1,10072
f694e6464f25059dc74417656b780d4e5f075efa,1,Mark Payne,2020-03-20 10:07:56-04:00,['23fa2d3138c13e418b40be760e33d7d386ddf98e'],114,126,240,3658167,65,1,1,1,10072
1fe79021b59fb8763b4af3e911658800bed3d41a,0,Bryan Bende,2020-03-20 10:56:32-04:00,['f694e6464f25059dc74417656b780d4e5f075efa'],84,257,341,3658508,8,0.064516129,0.419354839,0.661290323,10072
2feeb57159799928bdaebd3bc272f9e924a29a2f,0,Bryan Bende,2020-03-20 10:56:47-04:00,['1fe79021b59fb8763b4af3e911658800bed3d41a'],169,639,808,3659316,17,0.34551495,0.853820598,0.96013289,10073
254b20fa5ff3b3a00ccbe80b3a7f8954cb86db49,0,Joe Witt,2020-03-22 09:54:43-04:00,['2feeb57159799928bdaebd3bc272f9e924a29a2f'],1,5,6,3659322,2,0,1,1,10073
7f32aa56db9156d197666821fc90a1edd2ba755d,1,Bryan Bende,2020-03-23 20:43:06-04:00,['254b20fa5ff3b3a00ccbe80b3a7f8954cb86db49'],34,123,157,3659479,4,0.447761194,0.820895522,0.76119403,10073
6412097eb2e42ed09f0683c74f72e421cab1652c,1,Bryan Bende,2020-03-24 11:05:18-04:00,['7f32aa56db9156d197666821fc90a1edd2ba755d'],40,1605,1645,3661124,22,0.308962264,0.558962264,0.974056604,10089
9b4292024be6fae188cb1efa3a07dc9489e9a5b4,0,Bryan Bende,2020-03-24 14:55:51-04:00,['6412097eb2e42ed09f0683c74f72e421cab1652c'],109,150,259,3661383,9,0.227272727,0.727272727,1,10090
4d84c144d2e03ad43d78cf12481ce245d6f57d74,0,Joe Witt,2020-03-24 16:41:23-04:00,['9b4292024be6fae188cb1efa3a07dc9489e9a5b4'],34,90,124,3661507,1,,,,10090
5fd25d623518680350d4657fde9a3005bd8b5065,0,Joe Witt,2020-03-24 16:53:22-04:00,['4d84c144d2e03ad43d78cf12481ce245d6f57d74'],9,39,48,3661555,2,0.833333333,0.888888889,1,10090
aeaf953e06615bd2c05b6ced4b8d475af09b00af,0,Mike Thomsen,2020-03-25 08:55:44-04:00,['5fd25d623518680350d4657fde9a3005bd8b5065'],0,189,189,3661744,4,0.073170732,0.87804878,0.756097561,10090
efe2bca4cb4c8a57b5ee3fe6a1525aa33d4aa235,0,Joe Witt,2020-03-25 11:44:20-04:00,['aeaf953e06615bd2c05b6ced4b8d475af09b00af'],58,58,116,3661860,1,,,,10090
7d83622f05bc7139fca9cc5b3d26d38a6e477665,0,Joe Witt,2020-03-25 12:01:45-04:00,['efe2bca4cb4c8a57b5ee3fe6a1525aa33d4aa235'],4,0,4,3661864,1,,,,10090
271de920464d7e9001d100d971defcd2471fbd5e,0,Joe Witt,2020-03-25 15:21:25-04:00,['7d83622f05bc7139fca9cc5b3d26d38a6e477665'],8,4,12,3661876,1,,,,10090
57848880827bd2fe24a88a21ae56b6f46df40d27,0,Joe Witt,2020-03-25 17:39:44-04:00,['271de920464d7e9001d100d971defcd2471fbd5e'],1,3,4,3661880,1,1,1,1,10090
975f2bdc4faabadec75e75079e6e458ef4fcc261,0,Joe Witt,2020-03-25 17:40:20-04:00,['57848880827bd2fe24a88a21ae56b6f46df40d27'],1,13,14,3661894,2,0.5,1,1,10090
483f23a8aac7af780feda4b0193401366172b119,1,Andy LoPresto,2020-03-25 17:23:22-07:00,['975f2bdc4faabadec75e75079e6e458ef4fcc261'],3,423,426,3662320,10,0.259090909,0.995454545,0.9,10092
c79473baf5a8bb3dc054b13c57eefef1a4088d4c,1,Bryan Bende,2020-03-26 11:45:09-04:00,['483f23a8aac7af780feda4b0193401366172b119'],5,9,14,3662334,2,1,1,1,10092
be2929b8b02859bc1ad0b779d3234547297052f2,0,Matthew Burgess,2020-03-27 08:48:41-04:00,['c79473baf5a8bb3dc054b13c57eefef1a4088d4c'],6,6,12,3662346,2,,,,10092
1343b00e0beb3d9930cedb438a3468cb02e8d8c8,0,Joe Witt,2020-03-27 13:12:13-04:00,['be2929b8b02859bc1ad0b779d3234547297052f2'],0,6,6,3662352,1,,,,10092
992d990dd26df583fe456045ae50286c81ccb70a,1,Joe Witt,2020-03-27 16:34:59-04:00,['1343b00e0beb3d9930cedb438a3468cb02e8d8c8'],6,59,65,3662417,3,,,,10092
fee1b8b8e04e5901db612e52c9d53f9096f6d558,0,Bryan Bende,2020-03-30 16:49:24-04:00,['992d990dd26df583fe456045ae50286c81ccb70a'],22,121,143,3662560,6,0.851851852,0.851851852,1,10092
f4a7aafe4a243e6eea43781ce0a3bd3f42714617,0,Pierre Villard,2020-03-31 09:47:01+02:00,['fee1b8b8e04e5901db612e52c9d53f9096f6d558'],0,5,5,3662565,1,0,1,1,10092
daddf400a2628c8768c452d6f835613916ae8139,1,Peter Turcsanyi,2020-03-31 11:15:07+02:00,['f4a7aafe4a243e6eea43781ce0a3bd3f42714617'],2,345,347,3662912,6,0.436893204,0.854368932,1,10095
4a2a91135e9a744d393b8e2478a66b87e5d81446,0,Matthew Burgess,2020-04-01 10:00:41-04:00,['daddf400a2628c8768c452d6f835613916ae8139'],0,302,302,3663214,6,0.576923077,1,0.576923077,10099
d9ac9e44a7bd6fff086d5d24b7a39bed32f1ab2e,0,Matthew Burgess,2020-04-02 09:29:06-04:00,['4a2a91135e9a744d393b8e2478a66b87e5d81446'],2,160,162,3663376,2,0.041666667,0.979166667,0.9375,10099
a9bed56f684685e660fc60a9e65673b756ad116a,0,Joe Witt,2020-04-02 12:54:49-04:00,['d9ac9e44a7bd6fff086d5d24b7a39bed32f1ab2e'],63,99,162,3663538,1,,,,10099
c0f5fcb48437e4d3c148bd2742a9fc92eb49630a,1,Peter Turcsanyi,2020-04-02 21:49:40+02:00,['a9bed56f684685e660fc60a9e65673b756ad116a'],1204,8171,9375,3672913,89,0.901121728,1,0.799335272,10178
a093af2d42c34200011847f8bf40f92ccb89614d,1,GitHub,2020-04-03 16:12:53-04:00,['c0f5fcb48437e4d3c148bd2742a9fc92eb49630a'],56,343,399,3673312,12,0.210526316,0.473684211,0.705263158,10179
f0e8daf45d733cdbca0f4e441e009506ebfad497,0,Pierre Villard,2020-04-06 12:19:46+02:00,['a093af2d42c34200011847f8bf40f92ccb89614d'],0,0,0,3673312,2,,,,10179
59c756c72b756a497003cc59020de229bd45260f,0,GitHub,2020-04-06 18:26:32-07:00,['f0e8daf45d733cdbca0f4e441e009506ebfad497'],1,2,3,3673315,1,,,,10179
445efcfde615e94f03a0a42fab4309313d821046,0,GitHub,2020-04-06 20:36:56-07:00,['59c756c72b756a497003cc59020de229bd45260f'],3,3,6,3673321,1,,,,10179
09cece8e9936f7d8e6662e6f887444e85a36f79f,1,Peter Turcsanyi,2020-04-07 20:12:18+02:00,['445efcfde615e94f03a0a42fab4309313d821046'],213,400,613,3673934,2,0.392592593,0.955555556,0.888888889,10179
63379c35201cb58d0a5c5a4d55bb72504551973c,1,Peter Turcsanyi,2020-04-08 10:58:48+02:00,['09cece8e9936f7d8e6662e6f887444e85a36f79f'],335,467,802,3674736,6,0.454545455,1,1,10181
08dcd4af14386183d0cd84690772b5ad93f75b9f,1,Pierre Villard,2020-04-09 14:13:54+02:00,['63379c35201cb58d0a5c5a4d55bb72504551973c'],40,41,81,3674817,4,1,1,0,10181
683b1d995200384dcde8ec269163bc57f25b23ce,1,Matt Gilman,2020-04-09 10:42:05-04:00,['08dcd4af14386183d0cd84690772b5ad93f75b9f'],1572,2890,4462,3679279,80,0.501597444,1,0.873801917,10198
84968e70d293e49888addc3870c6a9cf222103b0,1,Matthew Burgess,2020-04-09 12:59:01-04:00,['683b1d995200384dcde8ec269163bc57f25b23ce'],18,21,39,3679318,4,1,1,1,10198
1ec7e31f11698a9d40986c517384777ec8b3aa24,0,GitHub,2020-04-09 10:13:53-07:00,['84968e70d293e49888addc3870c6a9cf222103b0'],28,40,68,3679386,1,,,,10198
728bdec0f480e5585809ea7f841eee38b2ddab84,1,Bryan Bende,2020-04-09 13:32:34-04:00,['1ec7e31f11698a9d40986c517384777ec8b3aa24'],25,111,136,3679522,4,0.382352941,1,0.970588235,10199
c99a1870184087a5a3ff3e7ac032c4c0f98a352b,0,Bryan Bende,2020-04-09 13:34:37-04:00,['728bdec0f480e5585809ea7f841eee38b2ddab84'],2,11,13,3679535,1,0.5,1,1,10199
07a8311b4cedfc1b45ccc8e1a11324bcd3c71da7,1,GitHub,2020-04-10 22:25:40-07:00,['c99a1870184087a5a3ff3e7ac032c4c0f98a352b'],0,1109,1109,3680644,25,,,,10223
c9f48e378837a67a4d0c05e4d1b3bf5ade9cab18,1,Aldrin Piri,2020-04-13 09:15:05-04:00,['07a8311b4cedfc1b45ccc8e1a11324bcd3c71da7'],0,16,16,3680660,2,,,,10223
a61a4c2b5878f53777df8df1dd91a78629ba23bb,1,Pierre Villard,2020-04-15 12:39:13+02:00,['c9f48e378837a67a4d0c05e4d1b3bf5ade9cab18'],9,9,18,3680678,1,,,,10223
9df53e7204789ff84fc4ed7bd4ed4675588a21d9,1,Pierre Villard,2020-04-15 12:53:18+02:00,['a61a4c2b5878f53777df8df1dd91a78629ba23bb'],5,13,18,3680696,2,1,1,0.571428571,10223
c263daf20ba534aaca435826b21435c529a05505,0,Matt Gilman,2020-04-15 10:06:38-04:00,['9df53e7204789ff84fc4ed7bd4ed4675588a21d9'],13,25,38,3680734,1,1,1,1,10223
83400789f6a8fc1edcbf0d622ae7063cb30e738d,0,Pierre Villard,2020-04-15 18:54:51+02:00,['c263daf20ba534aaca435826b21435c529a05505'],83,143,226,3680960,2,0.285714286,0.261904762,1,10223
2224ace968b911f98f6df7a7647f59eab109b93e,0,GitHub,2020-04-15 12:34:03-07:00,['83400789f6a8fc1edcbf0d622ae7063cb30e738d'],0,2,2,3680962,1,,,,10223
b113a022e46ee755e6b9d4395b908c7f54b2bd37,1,Matthew Burgess,2020-04-15 20:27:44-04:00,['2224ace968b911f98f6df7a7647f59eab109b93e'],12,12,24,3680986,1,,,,10223
8e3f42051fb3c7da27873de8b6d4507827a7b80d,0,Koji Kawamura,2020-04-16 15:56:40+09:00,['b113a022e46ee755e6b9d4395b908c7f54b2bd37'],29,37,66,3681052,2,0.214285714,1,1,10223
58118cf904cfb58ea119e5507a9a9549cda53bd9,1,Peter Turcsanyi,2020-04-16 11:49:44+02:00,['8e3f42051fb3c7da27873de8b6d4507827a7b80d'],4,136,140,3681192,6,0.444444444,1,1,10225
8e9dbd73350dce7e3aff1cf0734eeaa3b449d78e,0,Pierre Villard,2020-04-17 15:59:15+02:00,['58118cf904cfb58ea119e5507a9a9549cda53bd9'],5,19,24,3681216,1,0,0,0,10225
99e69f0252ad727a187f2218fa9ca6a84782b5c2,0,Pierre Villard,2020-04-18 16:25:05+02:00,['8e9dbd73350dce7e3aff1cf0734eeaa3b449d78e'],2,3,5,3681221,1,,,,10225
923a07a5db9c57014d5d39c8e0e672889d38f236,1,Mark Payne,2020-04-20 11:19:21-04:00,['99e69f0252ad727a187f2218fa9ca6a84782b5c2'],22,498,520,3681741,5,0.791044776,0.712686567,1,10225
c19db9d623455b157d59c75c49f4ba0726693b43,0,Joe Witt,2020-04-20 13:40:07-04:00,['923a07a5db9c57014d5d39c8e0e672889d38f236'],19,613,632,3682373,22,0.59929078,0.865248227,0.911347518,10229
e2716a6c9458d980513684b05497042f4f38b476,1,Peter Turcsanyi,2020-04-20 22:34:03+02:00,['c19db9d623455b157d59c75c49f4ba0726693b43'],419,855,1274,3683647,44,0.448412698,0.988095238,0.78968254,10231
cd10435b9fa5ab180c80ef5c04069971b32b0fa9,1,GitHub,2020-04-22 10:37:04-04:00,['e2716a6c9458d980513684b05497042f4f38b476'],28,81,109,3683756,3,0,0,0.473684211,10231
6c2701abef4ad3274399e946d60925be9bbecd22,0,markap14,2020-04-25 11:01:08-04:00,['cd10435b9fa5ab180c80ef5c04069971b32b0fa9'],0,5,5,3683761,1,0,0,1,10231
996688b4194fbae27b1fca005e9031276487597d,0,Andy LoPresto,2020-04-27 13:21:21-07:00,['6c2701abef4ad3274399e946d60925be9bbecd22'],4,15,19,3683780,7,1,1,1,10231
148537d64a017b73160b0d49943183c18f883ab0,1,Andy LoPresto,2020-04-27 17:29:42-07:00,['996688b4194fbae27b1fca005e9031276487597d'],100,679,779,3684559,13,0.658823529,0.658823529,0.964705882,10234
a7008903edf3cc751a48695ba09701667892e545,1,Pierre Villard,2020-04-28 19:03:56+02:00,['148537d64a017b73160b0d49943183c18f883ab0'],31,437,468,3685027,7,0.959390863,0.771573604,0.842639594,10236
1259bd5bd17c9ebecf918b23f31ca83678c7a3b8,0,GitHub,2020-04-28 16:56:49-04:00,['a7008903edf3cc751a48695ba09701667892e545'],443,618,1061,3686088,10,0.098425197,0.964566929,0.858267717,10241
659a3837235aab03538f30d88c7786e59dc654f2,1,Mark Payne,2020-04-29 13:01:06-04:00,['1259bd5bd17c9ebecf918b23f31ca83678c7a3b8'],49,461,510,3686598,2,0.069343066,0.565693431,0.733576642,10241
7784178abda47d267db3a335018e123f3ffdf676,0,Matthew Burgess,2020-04-29 13:11:06-04:00,['659a3837235aab03538f30d88c7786e59dc654f2'],0,24,24,3686622,2,0.157894737,0.789473684,0.789473684,10241
e81960f8e8a6bd446bb766a5fb2e00c7e2e973f8,1,Nathan Gough,2020-04-30 15:20:19-04:00,['7784178abda47d267db3a335018e123f3ffdf676'],144,951,1095,3687717,23,0.788659794,0.969072165,0.994845361,10251
7d494011eaef030b28f390fd84ba74f664cd2fac,1,GitHub,2020-04-30 12:36:30-07:00,['e81960f8e8a6bd446bb766a5fb2e00c7e2e973f8'],2,5,7,3687724,1,,,,10251
aa1e272052e0c271458ee458a79a1fecbc7f7376,0,Peter Turcsanyi,2020-04-30 23:17:20+02:00,['7d494011eaef030b28f390fd84ba74f664cd2fac'],54,246,300,3688024,8,0.105691057,0.382113821,0.682926829,10252
bce82a5e6f500ccfc43a7ea99d40f9954e3e88a0,0,Pierre Villard,2020-05-01 16:17:07+02:00,['aa1e272052e0c271458ee458a79a1fecbc7f7376'],1,1,2,3688026,1,,,,10252
e66844e6c8331e705dd3dc4022fafd3eb3e9f5a3,0,Pierre Villard,2020-05-01 16:19:55+02:00,['bce82a5e6f500ccfc43a7ea99d40f9954e3e88a0'],0,34,34,3688060,1,,,,10253
aa986e0bfb6b787fd16de82e4708def42ea0f6af,1,Pierre Villard,2020-05-01 16:46:52+02:00,['e66844e6c8331e705dd3dc4022fafd3eb3e9f5a3'],0,18,18,3688078,2,1,1,1,10253
2a44f0ff2f457baf7dd1d1db83026e228f893896,1,Peter Turcsanyi,2020-05-01 22:57:02+02:00,['aa986e0bfb6b787fd16de82e4708def42ea0f6af'],107,107,214,3688292,3,,,,10253
0448e23a963a4f34f12cfa96e13d81675eb2b33b,0,Matt Gilman,2020-05-04 14:49:15-04:00,['2a44f0ff2f457baf7dd1d1db83026e228f893896'],6,18,24,3688316,2,0,1,1,10253
effa9301511c0aa9a80d8c9d644a11b073ace15b,1,Pierre Villard,2020-05-06 09:40:46+02:00,['0448e23a963a4f34f12cfa96e13d81675eb2b33b'],0,1,1,3688317,1,0,0,1,10253
f22cd26cf41cdce95106a05f8be3ad41c8d89f45,0,Mark Payne,2020-05-06 17:20:08-04:00,['effa9301511c0aa9a80d8c9d644a11b073ace15b'],7,2,9,3688326,1,1,1,1,10253
b7c81d6007852d933961d0067030bc807363e2ee,0,Matt Gilman,2020-05-06 19:38:23-04:00,['f22cd26cf41cdce95106a05f8be3ad41c8d89f45'],28,10,38,3688364,4,,,,10253
6e2f86d716cebedf4ce7a34ffdeb348fb313a23a,0,Nathan Gough,2020-05-07 14:19:55-04:00,['b7c81d6007852d933961d0067030bc807363e2ee'],6,6,12,3688376,6,,,,10253
66b175f405e727aba650f67872292ff8c8ccb14d,0,Matthew Burgess,2020-05-08 13:11:19-04:00,['6e2f86d716cebedf4ce7a34ffdeb348fb313a23a'],1,52,53,3688429,2,0.441176471,1,1,10253
647a9a60b73794106d70941e1ab62f7f25040350,0,Matt Gilman,2020-05-08 13:13:38-04:00,['66b175f405e727aba650f67872292ff8c8ccb14d'],9,10,19,3688448,3,,,,10253
851359c1fc09f65661ae236660b5ebcb655d9e67,1,Pierre Villard,2020-05-09 15:37:14+02:00,['647a9a60b73794106d70941e1ab62f7f25040350'],1,2,3,3688451,2,0,0,1,10253
6b73ea48bc4d2b80e69ba37efa3a4c6ed8f80e6a,0,Matthew Burgess,2020-05-12 16:00:41-04:00,['851359c1fc09f65661ae236660b5ebcb655d9e67'],0,2,2,3688453,2,,,,10253
302a42185c0e1e06c7c7869aa6245dfd88ad7338,0,Andy LoPresto,2020-05-12 14:19:23-07:00,['6b73ea48bc4d2b80e69ba37efa3a4c6ed8f80e6a'],0,10,10,3688463,4,0.8,1,0.8,10253
9608fe33fa4a3f39ee6ddca54184ccc85ef1a163,1,Peter Turcsanyi,2020-05-13 14:50:31+02:00,['302a42185c0e1e06c7c7869aa6245dfd88ad7338'],30,450,480,3688943,6,0.733870968,1,0.814516129,10253
53a161234e651c9b5259723d5ffc986cc6eab7dd,0,Pierre Villard,2020-05-14 11:41:35+02:00,['9608fe33fa4a3f39ee6ddca54184ccc85ef1a163'],3,28,31,3688974,2,0,1,0.875,10253
c51b9051a8f503af1e1793c952b150895a0399ce,1,Bryan Bende,2020-05-15 16:16:39-04:00,['53a161234e651c9b5259723d5ffc986cc6eab7dd'],33,72,105,3689079,3,0.193548387,0.322580645,0.741935484,10253
13418ccb91e8f41e98287d7839d12500c3734052,0,Matthew Burgess,2020-05-18 14:57:54-04:00,['c51b9051a8f503af1e1793c952b150895a0399ce'],121,120,241,3689320,8,0.6,0,0,10253
a3cc2c58ff05e8d0008a5953c976d7ae3169c2d7,1,Mark Payne,2020-05-18 15:11:33-04:00,['13418ccb91e8f41e98287d7839d12500c3734052'],4,248,252,3689572,6,0.788235294,1,0.952941176,10256
179675f0b42e61ce125932fcf57086024d5e6f57,1,Mark Payne,2020-05-18 16:11:40-04:00,['a3cc2c58ff05e8d0008a5953c976d7ae3169c2d7'],29,59,88,3689660,3,0.833333333,0.833333333,0.777777778,10256
9aae58f1178cacb6ee4814f26288bf8ca5150d71,0,Peter Turcsanyi,2020-05-18 23:50:05+02:00,['179675f0b42e61ce125932fcf57086024d5e6f57'],5,11,16,3689676,3,0.4,0,0.4,10256
3fec4d8c270385e10fab843254ee851614fa4738,1,Pierre Villard,2020-05-19 10:38:45+02:00,['9aae58f1178cacb6ee4814f26288bf8ca5150d71'],13,11,24,3689700,1,1,1,0,10256
852715aadd9e989d37aeadecfe92093e212a5ad1,1,Peter Turcsanyi,2020-05-19 11:50:08+02:00,['3fec4d8c270385e10fab843254ee851614fa4738'],44,147,191,3689891,5,0,0.518518519,1,10256
d6240a1074aa33d650cb91dec3e69b7d5e3da9b5,1,Peter Turcsanyi,2020-05-19 18:35:33+02:00,['852715aadd9e989d37aeadecfe92093e212a5ad1'],31,384,415,3690306,3,0.668246445,1,0.796208531,10256
5826a09a8316b2e0fc57ed89646c05b1977ab297,0,Joey Frazee,2020-05-19 13:47:08-05:00,['d6240a1074aa33d650cb91dec3e69b7d5e3da9b5'],1,23,24,3690330,1,1,1,1,10256
441781cec50f77d9f1e65093f55bbd614b8c5ec6,1,Andy LoPresto,2020-05-19 12:56:59-07:00,['5826a09a8316b2e0fc57ed89646c05b1977ab297'],3774,4793,8567,3698897,165,1,1,0,10274
7034d7e44c0644fb126136b503da4c11d6c41aff,0,markap14,2020-05-20 10:49:49-04:00,['441781cec50f77d9f1e65093f55bbd614b8c5ec6'],3,4,7,3698904,1,,,,10274
a9e9e5d137d9798888d3082dd1fbccef18c4fc50,0,Joey Frazee,2020-05-20 15:17:39-05:00,['7034d7e44c0644fb126136b503da4c11d6c41aff'],2,16,18,3698922,4,0,0,1,10274
d195702ee2cbc44bb303003e989308d432038a38,0,Mark Payne,2020-05-20 17:09:40-04:00,['a9e9e5d137d9798888d3082dd1fbccef18c4fc50'],11,11,22,3698944,1,,,,10274
c7edcd68e1d6d98472953897ec8c9a18d2f7d290,0,Mike Thomsen,2020-05-20 19:54:24-04:00,['d195702ee2cbc44bb303003e989308d432038a38'],1,34,35,3698979,2,0,0.851851852,1,10274
b6ef7e13bf076fb88fd94ce49d2a217db3f19aaa,0,Matthew Burgess,2020-05-21 13:13:12-04:00,['c7edcd68e1d6d98472953897ec8c9a18d2f7d290'],14,199,213,3699192,3,0,0.664285714,0.971428571,10274
97a919a3be37c8e78b623ffacf9b1f22db534644,1,Andy LoPresto,2020-05-22 11:44:53-07:00,['b6ef7e13bf076fb88fd94ce49d2a217db3f19aaa'],1,28,29,3699221,2,1,1,1,10274
45e626f6a872296cdd08fcfc533c7ce7e3624fca,0,GitHub,2020-05-22 12:19:58-07:00,['97a919a3be37c8e78b623ffacf9b1f22db534644'],1,2,3,3699224,1,,,,10274
0f4b79b55ec7e4a85334d4a0d3e7200021950d1a,1,Mike Thomsen,2020-05-25 06:23:00-04:00,['45e626f6a872296cdd08fcfc533c7ce7e3624fca'],3,238,241,3699465,11,0.891566265,0.891566265,0.831325301,10276
b0251178243650e3256a8b0649f0196c6868fcba,0,Mike Thomsen,2020-05-25 06:58:15-04:00,['0f4b79b55ec7e4a85334d4a0d3e7200021950d1a'],1,1,2,3699467,1,,,,10276
1ba8f76a44bdf6fb3a6af8c74e678dd7d21ad70b,0,Mike Thomsen,2020-05-25 07:01:02-04:00,['b0251178243650e3256a8b0649f0196c6868fcba'],1,1,2,3699469,1,,,,10276
788f8b0389f989436c937214b9d01a901bac2f06,0,Mike Thomsen,2020-05-25 07:06:22-04:00,['1ba8f76a44bdf6fb3a6af8c74e678dd7d21ad70b'],1,1,2,3699471,1,,,,10276
443f969d3626ac2791f4095de7dc59de7a9733e7,0,Mike Thomsen,2020-05-25 10:24:38-04:00,['788f8b0389f989436c937214b9d01a901bac2f06'],1,2,3,3699474,1,,,,10276
101387bfaac1397add03af0a6967cda393970eea,0,Mike Thomsen,2020-05-25 16:22:08-04:00,['443f969d3626ac2791f4095de7dc59de7a9733e7'],8,63,71,3699545,3,0.666666667,0.717948718,1,10277
ca65bba5d720550aab97fcfc58be46e1b77001d3,1,Peter Turcsanyi,2020-05-26 18:01:08+02:00,['101387bfaac1397add03af0a6967cda393970eea'],32,90,122,3699667,3,0.95,1,0,10277
aa804cfcebea23f1316b0c5ad5a6140bec57de01,1,Mike Thomsen,2020-05-26 17:11:24-04:00,['ca65bba5d720550aab97fcfc58be46e1b77001d3'],3,3,6,3699673,3,,,,10277
1dd0e920402d20917bf3bf421ce14ab3dc0749a5,0,Peter Turcsanyi,2020-05-27 09:13:41+02:00,['aa804cfcebea23f1316b0c5ad5a6140bec57de01'],29,136,165,3699838,2,0.683333333,0.683333333,0.966666667,10277
4ced1775b5da8dae5963a89e4776d99bad37cd41,0,Pierre Villard,2020-05-29 10:28:37+02:00,['1dd0e920402d20917bf3bf421ce14ab3dc0749a5'],0,5,5,3699843,1,,,,10277
e04e6793caddbfb7b5c93c35f3ed51f1e0a761aa,0,Pierre Villard,2020-05-29 10:39:04+02:00,['4ced1775b5da8dae5963a89e4776d99bad37cd41'],17,2,19,3699862,2,,,,10277
a1f277fdf792c7c92b7ed1df35d7721b8c2ab810,0,Pierre Villard,2020-05-29 10:41:19+02:00,['e04e6793caddbfb7b5c93c35f3ed51f1e0a761aa'],3,3,6,3699868,2,,,,10277
06864c830cfd67b28b447085fdec59db2934d70b,0,Pierre Villard,2020-05-29 14:22:58+02:00,['a1f277fdf792c7c92b7ed1df35d7721b8c2ab810'],1,266,267,3700135,4,0.689320388,1,1,10279
8162edfd9891159cc1636c4f496de911ee752b9c,1,markap14,2020-05-29 13:38:11-04:00,['06864c830cfd67b28b447085fdec59db2934d70b'],14,6,20,3700155,4,0.833333333,0.833333333,0,10279
af5871460659bd01c641d6bab588bf830860ceac,1,markap14,2020-05-29 13:54:11-04:00,['8162edfd9891159cc1636c4f496de911ee752b9c'],7,18,25,3700180,2,1,1,1,10279
2a82efc417e64e59b11370bf929e490e6d3ddebe,1,Mike Thomsen,2020-05-29 21:39:14-04:00,['af5871460659bd01c641d6bab588bf830860ceac'],8,374,382,3700562,8,0.111111111,0.944444444,0.694444444,10281
2e45d959ba238a6f8e12f7eb40189a72e93ed82a,0,Pierre Villard,2020-05-30 22:03:59+02:00,['2a82efc417e64e59b11370bf929e490e6d3ddebe'],0,155,155,3700717,1,,,,10281
1ec6675f3867f5ce454de2668d5a9d8b85b04085,1,Matthew Burgess,2020-06-01 11:33:10-04:00,['2e45d959ba238a6f8e12f7eb40189a72e93ed82a'],31,125,156,3700873,4,0.682539683,0.682539683,0.888888889,10281
04711ab466a2b2c8c3b618f7617fc243c6576156,0,Matthew Burgess,2020-06-01 14:08:08-04:00,['1ec6675f3867f5ce454de2668d5a9d8b85b04085'],3,89,92,3700965,2,0,1,0.775510204,10281
e31c323aa70dfe8f1bc7a3f39c216f9154529654,1,Bryan Bende,2020-06-02 12:13:51-04:00,['04711ab466a2b2c8c3b618f7617fc243c6576156'],7,397,404,3701369,3,0.502857143,0.845714286,0.702857143,10283
91dd59dbdfd66423f1226c7eb1e20dcd2f0ed18d,0,Mark Payne,2020-06-02 13:25:00-04:00,['e31c323aa70dfe8f1bc7a3f39c216f9154529654'],49,184,233,3701602,8,0.393258427,1,1,10283
5c2bfcf7d3b8fdafe70ee4920645bb3e8fa5e539,1,Mark Payne,2020-06-02 15:13:14-04:00,['91dd59dbdfd66423f1226c7eb1e20dcd2f0ed18d'],65,1146,1211,3702813,54,0.660583942,0.729927007,0.905109489,10288
e0dd6d466e07b3c41fc64bcc40f5e4abe7680c71,0,Mark Payne,2020-06-02 15:13:14-04:00,['5c2bfcf7d3b8fdafe70ee4920645bb3e8fa5e539'],0,1,1,3702814,1,1,0,1,10288
915617dbe76d6842bb971e193e7399c8eda76121,1,Jeremy Dyer,2020-06-04 08:43:27-04:00,['e0dd6d466e07b3c41fc64bcc40f5e4abe7680c71'],2,1152,1154,3703968,16,0.620071685,1,0.70609319,10301
359fd3ff299c6abb7e7b4d5dfb99e48570aeede5,1,Pierre Villard,2020-06-04 23:24:03+02:00,['915617dbe76d6842bb971e193e7399c8eda76121'],36,919,955,3704923,27,0.428915663,0.742168675,0.874698795,10307
dfefeb7b18ebcc46807d82acda5b37ed6477c321,0,markap14,2020-06-05 16:23:01-04:00,['359fd3ff299c6abb7e7b4d5dfb99e48570aeede5'],2,11,13,3704936,2,1,1,1,10307
845b66ab9204cc4e8f2418ee6fd154191c3c3941,1,Andy LoPresto,2020-06-05 13:40:16-07:00,['dfefeb7b18ebcc46807d82acda5b37ed6477c321'],795,1824,2619,3707555,16,1,0.666666667,0,10309
f2368a0dd14aff31c5c5e7b4b9b7e470baf87fa7,0,Joey Frazee,2020-06-08 09:29:10-05:00,['845b66ab9204cc4e8f2418ee6fd154191c3c3941'],0,29,29,3707584,1,0,0,1,10309
463d72117b61738c9359da15e9be556897e8ea9e,0,Matthew Burgess,2020-06-08 14:03:00-04:00,['f2368a0dd14aff31c5c5e7b4b9b7e470baf87fa7'],2,79,81,3707665,2,,,,10310
aa7c5e21782cf4d2f4b10ae63851c53f7c47a80f,0,Mark Payne,2020-06-08 16:04:15-04:00,['463d72117b61738c9359da15e9be556897e8ea9e'],62,133,195,3707860,2,1,1,1,10310
01e42dfb3291c3a3549023edadafd2d8023f3042,0,Andy LoPresto,2020-06-08 19:36:14-07:00,['aa7c5e21782cf4d2f4b10ae63851c53f7c47a80f'],57,604,661,3708521,6,1,1,0.970149254,10312
eb2ebefc4682d3f95ba5c9cbb8f604f5331ec79e,0,Rob Fellows,2020-06-09 15:23:58-04:00,['01e42dfb3291c3a3549023edadafd2d8023f3042'],21,37,58,3708579,4,0.272727273,0.727272727,1,10312
a2f521297f32baeb27479b87386353f2f9c24632,0,Matthew Burgess,2020-06-09 15:37:08-04:00,['eb2ebefc4682d3f95ba5c9cbb8f604f5331ec79e'],27,81,108,3708687,6,0,0,0.909090909,10312
3c757b6ba8518160bb4e07130d4f92c7b3b6c124,1,Matthew Burgess,2020-06-09 16:02:25-04:00,['a2f521297f32baeb27479b87386353f2f9c24632'],30,80,110,3708797,2,0,0,0,10312
73008451d45b93f649c4db928599eff5754bbc0e,0,Joey Frazee,2020-06-10 09:45:04-05:00,['3c757b6ba8518160bb4e07130d4f92c7b3b6c124'],74,161,235,3709032,11,0.791666667,0.833333333,0.8125,10312
d99983bdc70c8a91ea9b389fc576e6b84c76a27e,0,Bryan Bende,2020-06-12 12:43:27-04:00,['73008451d45b93f649c4db928599eff5754bbc0e'],7,1449,1456,3710488,17,0.605313093,0.768500949,0.924098672,10325
a126d0a6b6ae0d59c6b1deee3ef5252cb6d3e33b,0,Bryan Bende,2020-06-12 12:43:41-04:00,['d99983bdc70c8a91ea9b389fc576e6b84c76a27e'],429,1213,1642,3712130,27,0.592145015,1,0.839879154,10335
e02ffdd99fb3e0f561a50903f491b392a1a505cc,1,Peter Turcsanyi,2020-06-15 14:17:34+02:00,['a126d0a6b6ae0d59c6b1deee3ef5252cb6d3e33b'],51,36,87,3712217,3,0,0,1,10335
9828e7dd14d13a5c375c71b5ccbaa5dd049fa508,0,markap14,2020-06-16 12:24:41-04:00,['e02ffdd99fb3e0f561a50903f491b392a1a505cc'],0,4,4,3712221,1,,,,10335
8b1a23a99cc25c8395117b609fd8e16c88f9518d,1,markap14,2020-06-16 14:48:14-04:00,['9828e7dd14d13a5c375c71b5ccbaa5dd049fa508'],13,61,74,3712295,5,1,0.933333333,1,10336
c18b27af185453816dffe6e9ed22fe9be41646f6,1,GitHub,2020-06-16 17:45:37-07:00,['8b1a23a99cc25c8395117b609fd8e16c88f9518d'],130,163,293,3712588,4,0.117647059,0,0,10336
2b25ccc2988693f116bc7d10e98de6271bbbe1a6,1,Bryan Bende,2020-06-17 16:33:02-04:00,['c18b27af185453816dffe6e9ed22fe9be41646f6'],6,7,13,3712601,1,,,,10336
27b5bb7a209bdf12eb14e653d9d4c42f444018be,0,GitHub,2020-06-17 17:15:18-07:00,['2b25ccc2988693f116bc7d10e98de6271bbbe1a6'],1,83,84,3712685,3,0.769230769,0.769230769,0.538461538,10337
a1b245e051245bb6c65e7b5ffc6ee982669b7ab7,0,Pierre Villard,2020-06-19 09:19:12+02:00,['27b5bb7a209bdf12eb14e653d9d4c42f444018be'],14,42,56,3712741,7,0.375,0.833333333,0.666666667,10337
c9d08a76b1a68cfee979382adadd3f56c92f96f5,1,Mark Payne,2020-06-19 10:14:12-04:00,['a1b245e051245bb6c65e7b5ffc6ee982669b7ab7'],102,562,664,3713405,16,0.74301676,0.87150838,0.837988827,10342
0a16002076ad563ce6464c1ecb0440c6caec357b,1,Pierre Villard,2020-06-19 17:30:40+02:00,['c9d08a76b1a68cfee979382adadd3f56c92f96f5'],1033,2539,3572,3716977,37,1,0.8625,0,10353
57c7883f647348aba181440950f01cf1d62846c6,0,Andy LoPresto,2020-06-19 15:37:02-07:00,['0a16002076ad563ce6464c1ecb0440c6caec357b'],21,41,62,3717039,1,0,1,1,10353
64b544d5afb21a2da3cfe89cae78883600d958a8,0,Mike Thomsen,2020-06-21 12:40:53-04:00,['57c7883f647348aba181440950f01cf1d62846c6'],1,1,2,3717041,1,,,,10353
32fa9ae51bfa486f463862a97817e2cf1702532d,0,GitHub,2020-06-22 09:15:41-04:00,['64b544d5afb21a2da3cfe89cae78883600d958a8'],19,23,42,3717083,2,1,1,1,10353
704260755a5de756aefc303029cf7b3dda556993,0,Mike Thomsen,2020-06-22 11:12:22-04:00,['32fa9ae51bfa486f463862a97817e2cf1702532d'],2,2,4,3717087,1,,,,10353
94c98c019f6704bea92ec15c1a5aa71b42e521ab,1,Andy LoPresto,2020-06-22 12:20:28-07:00,['704260755a5de756aefc303029cf7b3dda556993'],189,490,679,3717766,14,1,1,1,10355
005d05f20bdecd8578b386d0eba3a6f2e05d95c0,1,Mike Thomsen,2020-06-22 17:37:57-04:00,['94c98c019f6704bea92ec15c1a5aa71b42e521ab'],1,65,66,3717832,7,,,,10355
327d73f5cdde18278b2db7f9fec7d90938d3451c,0,GitHub,2020-06-23 14:22:50-04:00,['005d05f20bdecd8578b386d0eba3a6f2e05d95c0'],74,132,206,3718038,3,0,0.827586207,1,10355
91cd74d7254993a891f2a45c4f09c94c36f030c3,0,Mark Payne,2020-06-23 14:26:45-04:00,['327d73f5cdde18278b2db7f9fec7d90938d3451c'],5,43,48,3718086,2,0,0.8,1,10355
a2c88bc98fb937eedf50dbb998a87727a98f04f7,0,Pierre Villard,2020-06-26 16:48:55+02:00,['91cd74d7254993a891f2a45c4f09c94c36f030c3'],0,4,4,3718090,1,1,1,1,10355
7df2421fe76c0ab2649bc0ad6539c2edad1622ed,0,Scott Aslan,2020-06-26 14:39:47-04:00,['a2c88bc98fb937eedf50dbb998a87727a98f04f7'],4,4,8,3718098,2,,,,10355
87ec8558a40819fec6adfb78e6d463f1d94d55ab,0,Scott Aslan,2020-06-26 15:01:30-04:00,['7df2421fe76c0ab2649bc0ad6539c2edad1622ed'],9,9,18,3718116,5,,,,10355
c2f46c44ca29a07a0f418f6d46845f7ae7bccf91,1,Peter Turcsanyi,2020-06-30 15:21:03+02:00,['87ec8558a40819fec6adfb78e6d463f1d94d55ab'],5,45,50,3718166,3,0.133333333,0.133333333,0.666666667,10355
c221e4934d0d4be3215e9766c93c85472f91aef2,0,Bryan Bende,2020-06-30 09:48:45-04:00,['c2f46c44ca29a07a0f418f6d46845f7ae7bccf91'],0,79,79,3718245,2,0.346153846,1,1,10356
045027892ab5e35c6a9984df303c4de6a6b30c14,0,Joe Witt,2020-06-30 09:27:43-07:00,['c221e4934d0d4be3215e9766c93c85472f91aef2'],1,1,2,3718247,1,,,,10356
197df577ac9ade19dd1c2c807231212757bbd3d7,0,Peter Turcsanyi,2020-06-30 21:56:14+02:00,['045027892ab5e35c6a9984df303c4de6a6b30c14'],11,2,13,3718260,1,0,0,0,10356
239a2e884c8a5c8215cf41c55122472e11dc419a,0,GitHub,2020-07-01 10:52:22-07:00,['197df577ac9ade19dd1c2c807231212757bbd3d7'],1,103,104,3718364,1,,,,10356
e1584207d114d4915cc793d633039b724f6a07cb,0,Joey Frazee,2020-07-03 16:43:29-05:00,['239a2e884c8a5c8215cf41c55122472e11dc419a'],26,511,537,3718901,6,0.547511312,1,0.488687783,10360
c396927299586b896df4ebc745793b4c451f3898,1,Peter Turcsanyi,2020-07-06 14:15:43+02:00,['e1584207d114d4915cc793d633039b724f6a07cb'],1,12,13,3718914,1,0,0,1,10360
74b4d5ac5ff359103886d1bd575d15bcb4c2530f,0,Mike Thomsen,2020-07-07 07:28:45-04:00,['c396927299586b896df4ebc745793b4c451f3898'],2,2,4,3718918,2,,,,10360
ea02788de63c44434eee01dc3776ed85a9b3fea4,0,Mike Thomsen,2020-07-07 07:35:48-04:00,['74b4d5ac5ff359103886d1bd575d15bcb4c2530f'],1,1,2,3718920,1,,,,10360
f8e5be3c09de7cfc4d040743d739ddc1fc823aab,0,Mike Thomsen,2020-07-07 07:40:42-04:00,['ea02788de63c44434eee01dc3776ed85a9b3fea4'],3,3,6,3718926,1,,,,10360
f43dc8063f4f7c3ddd7efe700c9c9be4da4179fb,0,Mike Thomsen,2020-07-07 08:26:13-04:00,['f8e5be3c09de7cfc4d040743d739ddc1fc823aab'],3,3,6,3718932,3,,,,10360
f040c6aadbedb0fb5e778e7e13069d66cc97af45,0,Mike Thomsen,2020-07-07 14:43:57-04:00,['f43dc8063f4f7c3ddd7efe700c9c9be4da4179fb'],7,167,174,3719106,6,0.056338028,1,0.76056338,10364
43fb57e7bb4b3a3a7714578816ab57ece63349c8,1,Kevin Doran,2020-07-07 15:54:32-04:00,['f040c6aadbedb0fb5e778e7e13069d66cc97af45'],156,847,1003,3720109,5,1,1,0.981132075,10365
e17db80514870077ac379186b73762833dcacff1,0,GitHub,2020-07-07 16:38:42-04:00,['43fb57e7bb4b3a3a7714578816ab57ece63349c8'],1,2,3,3720112,1,0,0,0,10365
6cece9cad746c39ada327d064e67e52dd8b7d959,1,Mike Thomsen,2020-07-08 15:52:06-04:00,['e17db80514870077ac379186b73762833dcacff1'],74,1377,1451,3721563,13,0.310776942,0.829573935,0.749373434,10371
ca384b3f3b346685c2174b0996126f6b71892d4b,1,GitHub,2020-07-09 09:14:34-04:00,['6cece9cad746c39ada327d064e67e52dd8b7d959'],1,1,2,3721565,1,,,,10371
ad95287e782d71a778dfa89b3cb2a17637b32bf5,1,Matthew Burgess,2020-07-09 11:26:41-04:00,['ca384b3f3b346685c2174b0996126f6b71892d4b'],50,377,427,3721992,5,0.721088435,0.897959184,0.421768707,10373
b0494603dab17988f59102871fa7d6c4e2cae53d,0,Matthew Burgess,2020-07-09 12:17:32-04:00,['ad95287e782d71a778dfa89b3cb2a17637b32bf5'],5,5,10,3722002,1,,,,10373
ee91341ec3ce6009b6632d624defe00bd9b082ea,0,Mike Thomsen,2020-07-10 09:19:58-04:00,['b0494603dab17988f59102871fa7d6c4e2cae53d'],3,39,42,3722044,5,0.352941176,0,1,10373
1fc25db47cdecef404548ac011de2c2564574932,1,Bryan Bende,2020-07-10 10:44:51-04:00,['ee91341ec3ce6009b6632d624defe00bd9b082ea'],56,86,142,3722186,12,0.210526316,0.473684211,0,10373
ae877b9908aa1357c71e2e3d039829d6b7658fd4,0,Pierre Villard,2020-07-10 18:24:44+02:00,['1fc25db47cdecef404548ac011de2c2564574932'],53,89,142,3722328,4,1,0,1,10373
8d53f5d0c91a4e759ea7033bb4d0143ba96d2c21,0,Mike Thomsen,2020-07-10 17:12:27-04:00,['ae877b9908aa1357c71e2e3d039829d6b7658fd4'],5,8,13,3722341,3,,,,10373
19a84dd3dd1e40a41cf8e2daf88092d946043aac,0,Peter Turcsanyi,2020-07-12 11:56:31+02:00,['8d53f5d0c91a4e759ea7033bb4d0143ba96d2c21'],175,640,815,3723156,13,1,0.959390863,0.868020305,10377
c7a235f85478d39bb11eb44994a8719fd1f4294c,0,markap14,2020-07-13 08:54:41-04:00,['19a84dd3dd1e40a41cf8e2daf88092d946043aac'],2,2,4,3723160,2,,,,10377
bb5e9fb00b21c6cbf782c9ce4ddf818789b92084,0,GitHub,2020-07-13 09:34:24-04:00,['c7a235f85478d39bb11eb44994a8719fd1f4294c'],0,0,0,3723160,0,,,,10377
72666a9c7e87c39110039ac38b4ea303c317330d,0,Peter Turcsanyi,2020-07-14 17:32:51+02:00,['bb5e9fb00b21c6cbf782c9ce4ddf818789b92084'],1,1,2,3723162,1,,,,10377
b1e77019accec8cb32c41d34838f2225299f72b4,1,Peter Turcsanyi,2020-07-14 18:04:56+02:00,['72666a9c7e87c39110039ac38b4ea303c317330d'],1,106,107,3723269,4,0.522727273,1,0.863636364,10378
4f11e3626093d3090f97c0efc5e229d83b6006e4,0,Mark Payne,2020-07-14 13:20:59-04:00,['b1e77019accec8cb32c41d34838f2225299f72b4'],9,5,14,3723283,1,0,0,0,10378
0fa8776f4d2305b9cd5d46525e45dc73678dac52,0,Andy LoPresto,2020-07-14 10:39:28-07:00,['4f11e3626093d3090f97c0efc5e229d83b6006e4'],350,340,690,3723973,56,1,1,0,10378
dbee774c5b95121b2d89621fc66f8a215c15ad7c,1,Andy LoPresto,2020-07-14 10:42:00-07:00,['0fa8776f4d2305b9cd5d46525e45dc73678dac52'],236,685,921,3724894,15,1,0,0,10380
f8a730568fcb7734fb0e70755581622d8261d424,0,GitHub,2020-07-14 15:44:52-04:00,['dbee774c5b95121b2d89621fc66f8a215c15ad7c'],9,10,19,3724913,3,1,1,1,10380
77078a85d921070c24903b6e79aa20e0493a7f9b,0,Joe Witt,2020-07-14 13:30:53-07:00,['f8a730568fcb7734fb0e70755581622d8261d424'],1,3,4,3724917,1,,,,10380
44fc4d9f27cad664186e1b7a397a785dd90644ec,1,Pierre Villard,2020-07-17 10:33:59+02:00,['77078a85d921070c24903b6e79aa20e0493a7f9b'],16,330,346,3725263,9,0.257575758,0.651515152,1,10383
f6c2824f74990f22da4fc1f2e73607daa3fd00e6,0,Pierre Villard,2020-07-17 11:21:28+02:00,['44fc4d9f27cad664186e1b7a397a785dd90644ec'],0,195,195,3725458,4,0.388349515,0.572815534,1,10384
21c3085d15a75ee2699e3cce06518125bf45202f,1,Pierre Villard,2020-07-17 11:29:49+02:00,['f6c2824f74990f22da4fc1f2e73607daa3fd00e6'],89,125,214,3725672,4,0.533333333,1,1,10384
7e09e0db339a07670eba47c138959d79663400ee,1,Pierre Villard,2020-07-17 11:35:10+02:00,['21c3085d15a75ee2699e3cce06518125bf45202f'],20,77,97,3725769,3,1,0.304347826,1,10385
b8d51333d593fe2decade72079b805006dbdfb6a,0,Pierre Villard,2020-07-17 11:38:42+02:00,['7e09e0db339a07670eba47c138959d79663400ee'],12,28,40,3725809,1,,,,10385
950437b2d77958d9a1e4e5191c79ed10cee08455,0,Pierre Villard,2020-07-17 11:54:57+02:00,['b8d51333d593fe2decade72079b805006dbdfb6a'],0,12,12,3725821,1,0.230769231,1,1,10385
958d9c4cb674a4723a6b8ac59f0a176447844f45,0,Pierre Villard,2020-07-17 12:22:47+02:00,['950437b2d77958d9a1e4e5191c79ed10cee08455'],1,0,1,3725822,1,,,,10385
5da596ea8dfd70c181f518a8db1497bd8fe7b363,0,Pierre Villard,2020-07-17 13:53:13+02:00,['958d9c4cb674a4723a6b8ac59f0a176447844f45'],1,0,1,3725823,1,,,,10385
a72c3d685cdd694249b71b6f579a2830b67bf9b1,1,Pierre Villard,2020-07-17 14:25:56+02:00,['5da596ea8dfd70c181f518a8db1497bd8fe7b363'],0,137,137,3725960,1,0.317460317,0.634920635,1,10386
e18b4f0c75849355d11519eab23815f894e5c365,0,Pierre Villard,2020-07-17 14:39:30+02:00,['a72c3d685cdd694249b71b6f579a2830b67bf9b1'],29,143,172,3726132,2,0.638888889,1,1,10387
2e803e0e8fb0ea2e58446cd2fabe64e96f7b5640,0,Pierre Villard,2020-07-17 17:03:47+02:00,['e18b4f0c75849355d11519eab23815f894e5c365'],3,0,3,3726135,1,,,,10387
a473fc037385a3da68a3a0a305db6489f89aef67,1,Pierre Villard,2020-07-20 12:02:54+02:00,['2e803e0e8fb0ea2e58446cd2fabe64e96f7b5640'],40,1034,1074,3727209,27,0.314720812,0.550761421,0.946700508,10395
6297310a90f95b90f377729494b29da22b90d320,0,Pierre Villard,2020-07-21 13:42:43+02:00,['a473fc037385a3da68a3a0a305db6489f89aef67'],2,2,4,3727213,1,,,,10395
f80b844907ed201a29713f7a3253e73455ef02c6,1,Joe Witt,2020-07-21 16:46:46-07:00,['6297310a90f95b90f377729494b29da22b90d320'],1,31,32,3727245,1,,,,10395
78d88b46ef36da1b587882a2e1ff296babbc3095,0,Pierre Villard,2020-07-22 14:35:09+02:00,['f80b844907ed201a29713f7a3253e73455ef02c6'],11,95,106,3727351,4,0.909090909,1,1,10397
43c6ecd3ebff776b3944661cd502a84b95d3ead8,0,Bryan Bende,2020-07-22 14:19:51-04:00,['78d88b46ef36da1b587882a2e1ff296babbc3095'],1,20,21,3727372,5,0,0.571428571,0.428571429,10397
2c45a80ef4c87a0747d0246a2d2aa7c417cd8804,0,Bryan Bende,2020-07-22 14:20:09-04:00,['43c6ecd3ebff776b3944661cd502a84b95d3ead8'],3,6,9,3727381,3,0,0,0,10397
7f0b188be45a845cd01c75c3ca0ed7d54d3b6723,0,Bryan Bende,2020-07-22 14:31:48-04:00,['2c45a80ef4c87a0747d0246a2d2aa7c417cd8804'],3,3,6,3727387,3,,,,10397
0e61dbc9a02801f7bef21b43c3a7bdd644c5b281,0,Bryan Bende,2020-07-23 07:38:59-04:00,['7f0b188be45a845cd01c75c3ca0ed7d54d3b6723'],6,285,291,3727678,11,0.158469945,1,0.754098361,10397
99b3780ad96df3e54584362a5d8edf6967668d2d,0,Bryan Bende,2020-07-23 07:39:15-04:00,['0e61dbc9a02801f7bef21b43c3a7bdd644c5b281'],0,8,8,3727686,1,0,1,0,10397
e371f4ac7ccaa212439f9f0e4b519cfdad0c3af0,0,Bryan Bende,2020-07-23 08:14:21-04:00,['99b3780ad96df3e54584362a5d8edf6967668d2d'],81,13,94,3727780,5,0.035714286,0,0,10397
e9a443fe2e1424087fd4063f6d43e55a461ffbcb,0,Bryan Bende,2020-07-23 08:14:39-04:00,['e371f4ac7ccaa212439f9f0e4b519cfdad0c3af0'],3,0,3,3727783,3,,,,10397
4b0d349a49685fa2445a14f6f7b2f0e85c05ea51,0,GitHub,2020-07-23 09:29:44-04:00,['e9a443fe2e1424087fd4063f6d43e55a461ffbcb'],9,10,19,3727802,1,,,,10397
eeeda844747207102711cc2caad4c9a93982371a,1,Andy LoPresto,2020-07-24 12:31:39-07:00,['4b0d349a49685fa2445a14f6f7b2f0e85c05ea51'],486,6042,6528,3734330,49,0.665024631,0.807881773,0.584975369,10413
d846a74730edb4d142e0a3051c60e9fec33f1f09,1,Andy LoPresto,2020-07-24 13:28:01-07:00,['eeeda844747207102711cc2caad4c9a93982371a'],78,613,691,3735021,17,0.541899441,0.983240223,0.955307263,10416
5cb8d246899df914781001415d0e155f90ef6ed3,1,Andy LoPresto,2020-07-24 14:15:57-07:00,['d846a74730edb4d142e0a3051c60e9fec33f1f09'],1,9,10,3735031,2,0,1,0.166666667,10416
7d20c03f89358a5d5c6db63e631013e1c4be4bc4,0,Andy LoPresto,2020-07-24 18:11:37-07:00,['5cb8d246899df914781001415d0e155f90ef6ed3'],74,240,314,3735345,4,0,0.693877551,0.897959184,10416
cdd766d64989d06f33661f1685b1608ddef34896,0,Pierre Villard,2020-07-27 12:50:44+02:00,['7d20c03f89358a5d5c6db63e631013e1c4be4bc4'],18,69,87,3735432,4,0,0.96875,0.9375,10416
0b9f2fbe3bd3739d1df22623b347b3b514242191,1,Pierre Villard,2020-07-27 13:28:15+02:00,['cdd766d64989d06f33661f1685b1608ddef34896'],93,90,183,3735615,6,0,0,0.333333333,10416
90c9db8208d1713b05526d9e3f91f9a484382263,1,Pierre Villard,2020-07-28 10:22:24+02:00,['0b9f2fbe3bd3739d1df22623b347b3b514242191'],22,192,214,3735829,5,0.815789474,1,1,10416
e926a179689a777f81823225b2366415b48e0475,0,Matthew Burgess,2020-07-28 14:52:57-04:00,['90c9db8208d1713b05526d9e3f91f9a484382263'],51,22,73,3735902,1,0.772727273,0.636363636,0.5,10416
cee6cfddf2e1918a1edda5fb1e02c151663a2d97,0,Pierre Villard,2020-07-28 21:17:46+02:00,['e926a179689a777f81823225b2366415b48e0475'],1,1,2,3735904,1,,,,10416
7f0416ee8bdcee95e28409cc6fae9c1394c2a798,1,Matthew Burgess,2020-07-28 17:02:42-04:00,['cee6cfddf2e1918a1edda5fb1e02c151663a2d97'],343,447,790,3736694,27,1,1,1,10418
716ba992f5b4641c20465638d62d1e3ffe91d118,0,Pierre Villard,2020-07-29 09:29:00+02:00,['7f0416ee8bdcee95e28409cc6fae9c1394c2a798'],83,286,369,3737063,6,0,1,1,10420
455f48fce4fbbae19df27a7702d49f1912f8753a,0,GitHub,2020-07-29 13:57:34-07:00,['716ba992f5b4641c20465638d62d1e3ffe91d118'],3,5,8,3737071,2,,,,10420
0cff54097edef4c402a04c1d73127204b744f69b,0,Peter Turcsanyi,2020-07-30 08:37:10+02:00,['455f48fce4fbbae19df27a7702d49f1912f8753a'],2,37,39,3737110,3,0.588235294,0.647058824,1,10420
ac60bf6507c8f95db7a86d08263285dd9f33b7e6,1,Pierre Villard,2020-07-30 09:47:14+02:00,['0cff54097edef4c402a04c1d73127204b744f69b'],14,136,150,3737260,3,0.95,0.95,1,10421
633fd8883da4ba4c01867c5f6d14d813112ef89e,0,Pierre Villard,2020-07-31 10:44:47+02:00,['ac60bf6507c8f95db7a86d08263285dd9f33b7e6'],3,3,6,3737266,3,,,,10421
83fd4ca291bd8cb95e611511a73894a9318e820a,1,Pierre Villard,2020-07-31 10:51:15+02:00,['633fd8883da4ba4c01867c5f6d14d813112ef89e'],147,44,191,3737457,3,0.926829268,0,0.926829268,10421
30b328ceab01ee6a1a730780f7985addcd3a3b62,0,Pierre Villard,2020-07-31 11:00:14+02:00,['83fd4ca291bd8cb95e611511a73894a9318e820a'],2,3,5,3737462,1,,,,10421
84586a67722d2123834c25ff9989570d5548af15,0,markap14,2020-07-31 11:17:17-04:00,['30b328ceab01ee6a1a730780f7985addcd3a3b62'],1,1,2,3737464,1,,,,10421
1b91a6caf32f60e08c2b4f0a7b2d95d9fb8ed22d,0,Mark Payne,2020-07-31 14:09:12-04:00,['84586a67722d2123834c25ff9989570d5548af15'],73,2819,2892,3740356,45,0.451704545,0.752840909,0.880681818,10438
2de4962ff1a46a0f1b9c9029ccce5c8206a04eb5,0,Mark Payne,2020-07-31 14:11:48-04:00,['1b91a6caf32f60e08c2b4f0a7b2d95d9fb8ed22d'],2,2,4,3740360,1,,,,10438
6a497aa8c30523f7c1724fef70e160a7782d8792,0,markap14,2020-07-31 15:31:32-04:00,['2de4962ff1a46a0f1b9c9029ccce5c8206a04eb5'],1,29,30,3740390,4,0,0,0.714285714,10438
255d0c0f193c0d2f77a2fe6e039266bdfa6aab0c,0,Matthew Burgess,2020-07-31 16:12:20-04:00,['6a497aa8c30523f7c1724fef70e160a7782d8792'],6,14,20,3740410,1,,,,10438
ddb304a927b372c518ae84572315f07b75733a28,1,Peter Turcsanyi,2020-08-03 18:27:35+02:00,['255d0c0f193c0d2f77a2fe6e039266bdfa6aab0c'],13,111,124,3740534,4,0.516666667,0.866666667,1,10438
7b4cce9e219b86e6c6ade357d57a5f9b87c5c70e,1,Joe Witt,2020-08-03 09:43:25-07:00,['ddb304a927b372c518ae84572315f07b75733a28'],130,278,408,3740942,14,0.481481481,0.222222222,0.901234568,10440
c980b64bf56f6da39f385ebbc71aa8fc3cd95936,1,Pierre Villard,2020-08-03 19:27:21+02:00,['7b4cce9e219b86e6c6ade357d57a5f9b87c5c70e'],76,956,1032,3741974,13,0.926829268,1,0.945799458,10444
0861b2f632694435b1d115bbe6e04eb453518728,1,Andy LoPresto,2020-08-03 17:23:56-07:00,['c980b64bf56f6da39f385ebbc71aa8fc3cd95936'],100,129,229,3742203,2,0,1,1,10444
24d4ad348a251da88ffeffb2cc21640cd9c868cc,0,Joe Witt,2020-08-04 09:48:54-07:00,['0861b2f632694435b1d115bbe6e04eb453518728'],1,9,10,3742213,2,0,0,1,10444
536dbb72bbbb13b58ea1cf7dfa538cffdf3a0836,0,Andy LoPresto,2020-08-04 12:11:57-07:00,['24d4ad348a251da88ffeffb2cc21640cd9c868cc'],7,7,14,3742227,7,,,,10444
1df7025ae8091276ca47ed2ffd59f7135092740a,1,Bryan Bende,2020-08-04 16:59:39-04:00,['536dbb72bbbb13b58ea1cf7dfa538cffdf3a0836'],1,8448,8449,3750676,40,0.313696172,0.722787081,0.796052632,10482
93e5abf27475e10586d71ca12a41a4df0860ca9f,0,Bryan Bende,2020-08-04 16:59:54-04:00,['1df7025ae8091276ca47ed2ffd59f7135092740a'],108,162,270,3750946,3,,,,10482
6596fb1f8724d6163db3c4f899a57049a8355274,0,Rob Fellows,2020-08-06 10:48:24-04:00,['93e5abf27475e10586d71ca12a41a4df0860ca9f'],69,71,140,3751086,5,,,,10482
eca7f153d0b23d39f14e5c65d1f96c7f663b2bbe,1,Bryan Bende,2020-08-06 10:55:56-04:00,['6596fb1f8724d6163db3c4f899a57049a8355274'],35,331,366,3751452,18,0.169491525,0.604519774,0.898305085,10483
5cc7c0485aedfac7ad731aba5fcfbec67e8806f2,1,Joey Frazee,2020-08-06 10:55:31-07:00,['eca7f153d0b23d39f14e5c65d1f96c7f663b2bbe'],2,549,551,3752003,4,,,,10483
6488db13762fd42ce6c51f574e2e47ac29006ab5,0,Andy LoPresto,2020-08-06 17:40:12-07:00,['5cc7c0485aedfac7ad731aba5fcfbec67e8806f2'],0,62,62,3752065,2,0.022727273,1,1,10483
339e09a6e040303177f99131bf235365c5d9889a,0,GitHub,2020-08-07 09:06:56-04:00,['6488db13762fd42ce6c51f574e2e47ac29006ab5'],8,289,297,3752362,7,0.366666667,0.373333333,1,10484
3ef566f7da5db4a63ecff2b704ebd872dc070542,1,Peter Turcsanyi,2020-08-07 16:23:00+02:00,['339e09a6e040303177f99131bf235365c5d9889a'],3,811,814,3753176,14,0.459134615,0.980769231,0.882211538,10485
27e7d0b02ab353989857662a5e9a94b11ed7691c,0,Joe Witt,2020-08-07 08:14:19-07:00,['3ef566f7da5db4a63ecff2b704ebd872dc070542'],1,5,6,3753182,1,,,,10485
b8a1a4c5780eadd18b4cfc77f43820e47c4411fd,0,Mark Payne,2020-08-07 12:50:48-04:00,['27e7d0b02ab353989857662a5e9a94b11ed7691c'],2,2,4,3753186,1,,,,10485
55adb11f06eba4ea47ccd1508fab710f95ac4f13,1,Mark Payne,2020-08-07 12:50:48-04:00,['b8a1a4c5780eadd18b4cfc77f43820e47c4411fd'],2819,73,2892,3756078,45,0.548295455,0.247159091,0.119318182,10485
0f18c5966ed09d94d26842c4e057cf4f93420796,0,Mark Payne,2020-08-07 12:51:17-04:00,['55adb11f06eba4ea47ccd1508fab710f95ac4f13'],7,1,8,3756086,2,,,,10485
58e324e9f1414ebdbe3d295645d38f4b6692864d,0,Pierre Villard,2020-08-10 09:55:53+02:00,['0f18c5966ed09d94d26842c4e057cf4f93420796'],165,165,330,3756416,40,,,,10485
71d155e874e98d5904c11ce1972b566fb77f523b,1,Joe Witt,2020-08-10 09:43:43-07:00,['58e324e9f1414ebdbe3d295645d38f4b6692864d'],6,1902,1908,3758324,18,0.298270893,0.608069164,0.880403458,10495
51091a5fca8dde3116c46e3135de14c658140c1e,0,Joe Witt,2020-08-10 09:44:52-07:00,['71d155e874e98d5904c11ce1972b566fb77f523b'],2,11,13,3758337,3,0,0.6,0.4,10495
5470de949e72459f84de5a468d576c1817eff66d,0,Joe Witt,2020-08-10 10:22:34-07:00,['51091a5fca8dde3116c46e3135de14c658140c1e'],0,1,1,3758338,1,,,,10495
cea569169f22113e1242dd8ef9b0eb2684156d29,0,markap14,2020-08-10 14:33:49-04:00,['5470de949e72459f84de5a468d576c1817eff66d'],2,1,3,3758341,1,,,,10495
96810f677f15f7bf3a33a03dc76703fe55f63488,0,Bryan Bende,2020-08-11 14:08:57-04:00,['cea569169f22113e1242dd8ef9b0eb2684156d29'],12,12,24,3758365,7,,,,10495
a79493082c8ab90b40e40fd21ffe08008857cac0,0,Andy LoPresto,2020-08-11 14:43:06-07:00,['96810f677f15f7bf3a33a03dc76703fe55f63488'],1,1,2,3758367,1,,,,10495
869c4236c46694a8deda9c2b4d11172558728eb9,0,Matthew Burgess,2020-08-11 18:06:55-04:00,['a79493082c8ab90b40e40fd21ffe08008857cac0'],56,332,388,3758755,6,0.310344828,0.655172414,0.646551724,10496
9e1e17d3f372cdb2ed3bc100a2e960faa179f159,0,Bryan Bende,2020-08-12 11:27:21-04:00,['869c4236c46694a8deda9c2b4d11172558728eb9'],1,47,48,3758803,3,0.96969697,0.96969697,1,10496
3e18d5b23603ec69e7b4ad277b79fe9620b7afb4,0,markap14,2020-08-12 12:38:56-04:00,['9e1e17d3f372cdb2ed3bc100a2e960faa179f159'],4,4,8,3758811,1,,,,10496
4417b9d64a48b52927c67e42a7bb278e92403e9c,1,Andy LoPresto,2020-08-12 17:49:51-07:00,['3e18d5b23603ec69e7b4ad277b79fe9620b7afb4'],276,4,280,3759091,7,0.529411765,0,0.058823529,10496
b7b2533ffe556ef5bb1982e819f465ce1c74881b,1,markap14,2020-08-12 22:05:08-04:00,['4417b9d64a48b52927c67e42a7bb278e92403e9c'],1,21,22,3759113,3,0.923076923,1,1,10496
6c3c2c173bbcdf32a91d604857cae3d5f9b348b6,0,markap14,2020-08-13 10:42:44-04:00,['b7b2533ffe556ef5bb1982e819f465ce1c74881b'],16,6,22,3759135,1,0,0,0,10496
1b121ba18f625d03f263a241c987d42be66a83fb,0,Joe Witt,2020-08-13 08:49:07-07:00,['6c3c2c173bbcdf32a91d604857cae3d5f9b348b6'],2,2,4,3759139,2,,,,10496
303d6c59ba79b1eed425ee03b807948c7c400e99,0,Joe Witt,2020-08-13 09:20:36-07:00,['1b121ba18f625d03f263a241c987d42be66a83fb'],1683,1682,3365,3762504,483,,,,10496
fb57bcbc110f0374e9b6bf8e1ee65d8352d6b4eb,0,Joe Witt,2020-08-13 09:20:39-07:00,['303d6c59ba79b1eed425ee03b807948c7c400e99'],1680,1680,3360,3765864,483,,,,10496
9c821bc0aaa5f681eadb7033896439fc49f220fb,0,Joe Witt,2020-08-18 14:13:30-07:00,"['1b121ba18f625d03f263a241c987d42be66a83fb', 'fb57bcbc110f0374e9b6bf8e1ee65d8352d6b4eb']",1682,1681,3363,3769227,483,,,,10496
8baa5c9940b4299ce7b80d5d4f5eefe147a2aa10,1,Joe Witt,2020-08-18 14:48:02-07:00,['9c821bc0aaa5f681eadb7033896439fc49f220fb'],1691,1681,3372,3772599,485,,,,10496
11a4127a9f89474a42f182c0b83e365a6b468e71,1,Pierre Villard,2020-08-24 16:26:52+02:00,['8baa5c9940b4299ce7b80d5d4f5eefe147a2aa10'],7,7,14,3772613,1,,,,10496
d0c0f9704c7b9261b84f662373dc289f81d55bf1,0,Joe Witt,2020-08-24 12:52:07-07:00,['11a4127a9f89474a42f182c0b83e365a6b468e71'],2,2,4,3772617,1,,,,10496
aaab9ee0cfbd52cba2fd7ecdcada39c96b1169cc,0,Peter Turcsanyi,2020-08-25 19:37:18+02:00,['d0c0f9704c7b9261b84f662373dc289f81d55bf1'],14,4,18,3772635,2,0,0,0,10496
bdfe1f23705a3df86eafed12ac8839ee76662730,0,markap14,2020-08-26 10:50:49-04:00,['aaab9ee0cfbd52cba2fd7ecdcada39c96b1169cc'],3,4,7,3772642,1,1,1,1,10496
ca43615702eabddc6f7bbf280f0d181d7aa0b0d4,0,Peter Turcsanyi,2020-08-27 17:06:57+02:00,['bdfe1f23705a3df86eafed12ac8839ee76662730'],9,129,138,3772780,3,0.721311475,1,0.918032787,10496
861b83f31429645abf84ba25ebe3f4af1908ed7d,0,Pierre Villard,2020-08-28 14:38:21+02:00,['ca43615702eabddc6f7bbf280f0d181d7aa0b0d4'],17,6,23,3772803,1,,,,10496
483af3a46023a8c7d44af634b70372c8bb75d0e3,1,Bryan Bende,2020-08-28 09:58:39-04:00,['861b83f31429645abf84ba25ebe3f4af1908ed7d'],3,5,8,3772811,1,,,,10496
3952c70448f053cd3f7cea27665dc29ac0a999f4,0,Joey Frazee,2020-08-28 14:28:19-05:00,['483af3a46023a8c7d44af634b70372c8bb75d0e3'],0,797,797,3773608,4,0.178191489,0.768617021,0.970744681,10499
87685dd4e16f0ab6edda571a7bde819b14117dc7,1,markap14,2020-08-31 15:33:45-04:00,['3952c70448f053cd3f7cea27665dc29ac0a999f4'],12,377,389,3773997,3,0.742424242,0.492424242,0.954545455,10501
bdead4d040dab7c7b23328dcd3208627183b3506,0,markap14,2020-08-31 15:56:12-04:00,['87685dd4e16f0ab6edda571a7bde819b14117dc7'],2,19,21,3774018,4,0,0,0,10501
943904c12c56a1f658ae7144e7c2bbb29d746659,0,markap14,2020-09-01 09:40:32-04:00,['bdead4d040dab7c7b23328dcd3208627183b3506'],1,3,4,3774022,1,0,0,1,10501
45470b0984ab83750155e9c7a540c79bfe862817,0,Peter Turcsanyi,2020-09-01 17:17:02+02:00,['943904c12c56a1f658ae7144e7c2bbb29d746659'],20,106,126,3774148,5,0.586206897,0.137931034,0,10502
b4a820e7c3d46fecec10ebed390e5a453be7e057,0,Matthew Burgess,2020-09-01 13:21:56-04:00,['45470b0984ab83750155e9c7a540c79bfe862817'],1,1,2,3774150,1,,,,10502
e884b3cdb2bf2df7c00c914edf520394081f3628,0,GitHub,2020-09-01 13:07:47-07:00,['b4a820e7c3d46fecec10ebed390e5a453be7e057'],3,3,6,3774156,1,,,,10502
1e6619b91f2d9a7af2d7195464d4a0f5b595b93d,1,Andy LoPresto,2020-09-01 16:32:16-07:00,['e884b3cdb2bf2df7c00c914edf520394081f3628'],24,145,169,3774325,4,0.405405405,0.594594595,1,10502
c3cab48325a8c013f267c9ccc3a375ceb0e3c5e9,1,Andy LoPresto,2020-09-01 18:32:03-07:00,['1e6619b91f2d9a7af2d7195464d4a0f5b595b93d'],98,136,234,3774559,18,0.857142857,0.428571429,0.285714286,10504
9a1ae469d86e53d84f683194dccb6bf4e4196582,0,Joe Witt,2020-09-02 13:22:26-05:00,['c3cab48325a8c013f267c9ccc3a375ceb0e3c5e9'],4,5,9,3774568,1,0,0,1,10504
29e23e57b909f0deed2929249792ba04d2b6f590,0,Matthew Burgess,2020-09-02 17:14:17-04:00,['9a1ae469d86e53d84f683194dccb6bf4e4196582'],35,45,80,3774648,4,,,,10504
fd068fe978da5a4a3e5df14b9a8e43f51e88c606,1,Bryan Bende,2020-09-03 10:21:50-04:00,['29e23e57b909f0deed2929249792ba04d2b6f590'],106,275,381,3775029,21,1,0.9,0.425,10507
0d4def7843874b7f97cd53b878048d054170dc64,0,Matthew Burgess,2020-09-04 11:41:33-04:00,['fd068fe978da5a4a3e5df14b9a8e43f51e88c606'],1,1,2,3775031,1,,,,10507
85501e08e620caf9a668271e28d8bc99dc8307ba,0,Pierre Villard,2020-09-07 13:54:33+02:00,['0d4def7843874b7f97cd53b878048d054170dc64'],11,68,79,3775110,2,0.756097561,0.780487805,1,10507
44738b72cd4c63521cc9a61a7339eb9420936d09,0,Pierre Villard,2020-09-07 17:10:11+02:00,['85501e08e620caf9a668271e28d8bc99dc8307ba'],1,87,88,3775198,2,0.857142857,0.857142857,1,10507
73b7ff8fd4a5f4b0b4e7ff4bdf1b7f97728df9f5,1,Pierre Villard,2020-09-08 10:46:29+02:00,['44738b72cd4c63521cc9a61a7339eb9420936d09'],202,219,421,3775619,7,0,1,1,10509
0dff3bc065159d5dd6d39bae8778809d314e328a,1,Pierre Villard,2020-09-10 16:19:11+02:00,['73b7ff8fd4a5f4b0b4e7ff4bdf1b7f97728df9f5'],28,1172,1200,3776819,20,0.550247117,0.876441516,0.81878089,10513
6b34a8b36e18b94732adcfe7b5ef19b30e4fd1f0,0,Pierre Villard,2020-09-11 16:41:25+02:00,['0dff3bc065159d5dd6d39bae8778809d314e328a'],1,1,2,3776821,1,,,,10513
f6d6e4adc9c58f1b9120f3f5b2f605587a0e6599,0,Pierre Villard,2020-09-11 16:51:43+02:00,['6b34a8b36e18b94732adcfe7b5ef19b30e4fd1f0'],17,69,86,3776907,7,0.5,0.9375,0.125,10513
fd8b0b286fbb83cfdba3a24b2a3e6f647cf395bf,0,Matthew Burgess,2020-09-11 13:05:40-04:00,['f6d6e4adc9c58f1b9120f3f5b2f605587a0e6599'],62,111,173,3777080,3,0.925925926,0.925925926,0.925925926,10513
b5c3a2d7f9bfbd7364f0110aebd1fcd5a30bde1f,1,Nathan Gough,2020-09-12 19:25:20-04:00,['fd8b0b286fbb83cfdba3a24b2a3e6f647cf395bf'],5,84,89,3777169,5,,,,10514
e3d551e87d1de4e350772b3b8ac9fcef80bcdfcd,1,Scott Aslan,2020-09-14 10:03:41-04:00,['b5c3a2d7f9bfbd7364f0110aebd1fcd5a30bde1f'],6,33,39,3777208,1,0.533333333,1,1,10514
80bc40a9af3994c35d74fdbc5cb6d3c030e81037,1,Scott Aslan,2020-09-14 10:03:41-04:00,['e3d551e87d1de4e350772b3b8ac9fcef80bcdfcd'],14,3,17,3777225,1,0.166666667,0,0,10514
dc4daa29233a52e172b1e644ebda575b5f9e4679,0,Scott Aslan,2020-09-14 10:50:06-04:00,['80bc40a9af3994c35d74fdbc5cb6d3c030e81037'],6,4,10,3777235,1,1,0,0,10514
b3ae27a4cabbd3b4d9e30a18afac00224cd5fc8b,0,Pierre Villard,2020-09-14 19:13:57+02:00,['dc4daa29233a52e172b1e644ebda575b5f9e4679'],1,186,187,3777422,2,,,,10515
60a5d71809a91f2322e89c5c2a45ac24073890ea,0,Pierre Villard,2020-09-15 21:02:52+02:00,['b3ae27a4cabbd3b4d9e30a18afac00224cd5fc8b'],11,14,25,3777447,4,0,1,1,10515
df64416e91244a0ead7c2511117bab98ceaa16ce,0,Pierre Villard,2020-09-16 09:26:15+02:00,['60a5d71809a91f2322e89c5c2a45ac24073890ea'],2082,2082,4164,3781611,2,,,,10515
800655c938d7dea24923d499422765dd079ca098,1,Pierre Villard,2020-09-16 18:05:12+02:00,['df64416e91244a0ead7c2511117bab98ceaa16ce'],4,9,13,3781624,2,0,1,1,10515
f4ee9fefa9b1e14f4f0449f92fba9dcf0d4ea0f9,0,Joey Frazee,2020-09-16 18:40:02-07:00,['800655c938d7dea24923d499422765dd079ca098'],28,13,41,3781665,3,0,1,1,10515
fc610eaeda8369988ef65be1e39f53fd7627a9cb,0,Pierre Villard,2020-09-17 12:28:32+02:00,['f4ee9fefa9b1e14f4f0449f92fba9dcf0d4ea0f9'],49,393,442,3782107,13,0.382978723,0.553191489,0.29787234,10515
266433e13d7885d44e2bbeb28da867d8477bd683,0,Pierre Villard,2020-09-17 12:37:58+02:00,['fc610eaeda8369988ef65be1e39f53fd7627a9cb'],6,2615,2621,3784728,24,0.775528979,1,0.850045998,10534
624678466b98d2617856adb4cab413bf4fa6cdce,1,Pierre Villard,2020-09-17 12:50:13+02:00,['266433e13d7885d44e2bbeb28da867d8477bd683'],0,62,62,3784790,1,,,,10534
93705711316a7e17508ca9fe57eec20d681b470d,1,GitHub,2020-09-17 12:52:22-04:00,['624678466b98d2617856adb4cab413bf4fa6cdce'],971,1247,2218,3787008,185,1,1,1,10538
7e145142e126df71abdb06c996479b78230293e5,0,GitHub,2020-09-17 13:33:54-04:00,['93705711316a7e17508ca9fe57eec20d681b470d'],61,208,269,3787277,9,0,1,1,10541
f531b7a780619ba6b0662a181a31d42c16f795cf,0,Pierre Villard,2020-09-18 16:13:46+02:00,['7e145142e126df71abdb06c996479b78230293e5'],48,117,165,3787442,5,0.886792453,1,0.886792453,10541
953abba6d609f93f5b4e12772e25802007719901,1,Pierre Villard,2020-09-20 19:48:14+02:00,['f531b7a780619ba6b0662a181a31d42c16f795cf'],4,16,20,3787462,1,,,,10541
dbf92b9a728c9b739d79d98bbe56ec6ce3681999,1,Matthew Burgess,2020-09-21 14:57:06-04:00,['953abba6d609f93f5b4e12772e25802007719901'],0,830,830,3788292,7,0.61971831,1,0.887323944,10547
40406648864240b83ab91a711b8fe70fd3c02d57,0,GitHub,2020-09-21 12:12:23-07:00,['dbf92b9a728c9b739d79d98bbe56ec6ce3681999'],2,2,4,3788296,1,,,,10547
73df6f1edff7d82dd336f0171f11d423cbbca80b,0,Joey Frazee,2020-09-21 14:18:56-05:00,['40406648864240b83ab91a711b8fe70fd3c02d57'],2,20,22,3788318,2,0.333333333,0.333333333,1,10547
caf79601ac54249cd61cf7b69112257764d4cb3f,0,GitHub,2020-09-22 09:11:46-07:00,['73df6f1edff7d82dd336f0171f11d423cbbca80b'],0,2,2,3788320,1,0.5,0.5,1,10547
09966745220e263cc7ca1e1c8b20a73dd262b64e,0,markap14,2020-09-22 15:58:16-04:00,['caf79601ac54249cd61cf7b69112257764d4cb3f'],2,0,2,3788322,1,,,,10547
7e0bcb98e1ebc3bc64d1a33dbb7d626496f6e1d0,0,GitHub,2020-09-23 16:37:26-07:00,['09966745220e263cc7ca1e1c8b20a73dd262b64e'],1,1,2,3788324,1,,,,10547
e09317223e0ec0571e16247691497daf1cdbb736,1,Pierre Villard,2020-09-28 15:08:07+02:00,['7e0bcb98e1ebc3bc64d1a33dbb7d626496f6e1d0'],69,110,179,3788503,7,0,0.714285714,0.714285714,10547
9c83908c9c94dc34b640aececa87e8ace302d8d5,0,Pierre Villard,2020-09-28 15:10:46+02:00,['e09317223e0ec0571e16247691497daf1cdbb736'],1,1,2,3788505,1,,,,10547
f73a019f36f0ef6ebc4dfc634a856fd92a36f3df,0,Peter Turcsanyi,2020-09-28 19:52:41+02:00,['9c83908c9c94dc34b640aececa87e8ace302d8d5'],0,59,59,3788564,7,0,0.457142857,1,10549
02ee999efbb41ad0bc7c754d3cc322a7a553ce5e,1,Peter Turcsanyi,2020-09-28 23:12:29+02:00,['f73a019f36f0ef6ebc4dfc634a856fd92a36f3df'],6,14,20,3788584,3,0.4,0.8,0.8,10549
95fb8e314421221a2fd062e67974b8a5199914ea,1,Pierre Villard,2020-09-29 11:08:44+02:00,['02ee999efbb41ad0bc7c754d3cc322a7a553ce5e'],3,36,39,3788623,2,0,0.84,1,10549
740bfee8f4c11f0c0f904b17ec2c82ff604b8d76,0,GitHub,2020-09-29 09:06:13-04:00,['95fb8e314421221a2fd062e67974b8a5199914ea'],0,58,58,3788681,4,,,,10549
fa0a1df23fd446db4b9e1b526341168a5f2c6046,0,GitHub,2020-09-29 09:08:29-04:00,['740bfee8f4c11f0c0f904b17ec2c82ff604b8d76'],4,134,138,3788819,5,0.428571429,0.952380952,1,10551
a57d38c58d6fb3ea84d64dbd26a62d4a444ec48c,1,GitHub,2020-09-29 09:15:09-04:00,['fa0a1df23fd446db4b9e1b526341168a5f2c6046'],59,79,138,3788957,2,0.8,1,1,10551
f9ae3bb9c970cd8d6d1d9e10f07cab9bdb66baa9,1,Pierre Villard,2020-09-30 11:16:31+02:00,['a57d38c58d6fb3ea84d64dbd26a62d4a444ec48c'],8,36,44,3789001,5,1,1,0.230769231,10551
a66c3d8168cc1bf8e6bb074d4cb570742e49f643,0,Pierre Villard,2020-09-30 14:15:07+02:00,['f9ae3bb9c970cd8d6d1d9e10f07cab9bdb66baa9'],0,7,7,3789008,1,,,,10551
62f4d098837daab94c559f75a0eef5427e6234f1,0,markap14,2020-09-30 11:42:39-04:00,['a66c3d8168cc1bf8e6bb074d4cb570742e49f643'],0,1,1,3789009,1,0,0,1,10551
b2489f764419a6f6420dfc4533adf427108e54c0,1,GitHub,2020-09-30 19:58:20-04:00,['62f4d098837daab94c559f75a0eef5427e6234f1'],36,162,198,3789207,5,1,1,0.818181818,10551
e2ccfbbacfa7321e0bed2e7a23e4e26ca6e2b36c,0,Matthew Burgess,2020-10-01 09:06:01-04:00,['b2489f764419a6f6420dfc4533adf427108e54c0'],2,186,188,3789395,4,0,0.890625,0.875,10551
6990f0d3a9962144c99994ab9156780e633023f9,1,Matthew Burgess,2020-10-01 17:35:46-04:00,['e2ccfbbacfa7321e0bed2e7a23e4e26ca6e2b36c'],165,137,302,3789697,4,1,0.943396226,0,10551
f32405ed16b7e07a0d445f1ed19032acaf33246d,0,Mike Thomsen,2020-10-01 19:45:26-04:00,['6990f0d3a9962144c99994ab9156780e633023f9'],7,22,29,3789726,3,0,1,1,10551
5d37809d30aa8037c2306c875a0240248767d076,1,Pierre Villard,2020-10-02 19:12:40+02:00,['f32405ed16b7e07a0d445f1ed19032acaf33246d'],11,31,42,3789768,2,0,0,1,10551
be72dbb8155709cad1d0c0141a960c5177c77041,0,Mike Thomsen,2020-10-04 14:55:57-04:00,['5d37809d30aa8037c2306c875a0240248767d076'],1,1,2,3789770,1,,,,10551
b4faf210d8666c65cf746f57a9ed1b5f54fc3e3f,0,Mike Thomsen,2020-10-05 09:17:27-04:00,['be72dbb8155709cad1d0c0141a960c5177c77041'],2,19,21,3789791,3,,,,10553
0d9f2087fa8d67725576479226ca17ed534aeebf,0,Mike Thomsen,2020-10-05 09:27:12-04:00,['b4faf210d8666c65cf746f57a9ed1b5f54fc3e3f'],2,2,4,3789795,1,,,,10553
f4473afad615dbbd3605d99696e8f6261f15916f,0,Matthew Burgess,2020-10-05 16:23:01-04:00,['0d9f2087fa8d67725576479226ca17ed534aeebf'],0,1,1,3789796,1,,,,10553
7cc37133898b365e81eda884cf386a4f7e3a7022,1,GitHub,2020-10-06 09:26:27-04:00,['f4473afad615dbbd3605d99696e8f6261f15916f'],16,160,176,3789972,11,0.53968254,0.698412698,1,10553
325a49556c6cb2effbdb936889ebf45b212d2a46,1,GitHub,2020-10-07 09:12:16-04:00,['7cc37133898b365e81eda884cf386a4f7e3a7022'],81,3089,3170,3793142,48,0.478835979,0.76984127,0.888888889,10570
de39a3d9f4c8a01f193b0258173cee5694c87f0d,1,GitHub,2020-10-07 12:17:00-04:00,['325a49556c6cb2effbdb936889ebf45b212d2a46'],5,269,274,3793416,10,1,1,1,10576
ea6b01159d16a1d14e611f3a211caa42fe5577f2,1,Andy LoPresto,2020-10-07 10:56:23-07:00,['de39a3d9f4c8a01f193b0258173cee5694c87f0d'],10,108,118,3793534,4,0.333333333,1,0.9375,10576
efb629e37d487ea72d3e08e1c479e98f7ffc8291,0,Andy LoPresto,2020-10-07 10:59:50-07:00,['ea6b01159d16a1d14e611f3a211caa42fe5577f2'],18,36,54,3793588,2,1,1,0,10576
dee2fcedfed4a20f565eec66425a8790088e05c1,0,Andy LoPresto,2020-10-07 16:35:21-07:00,['efb629e37d487ea72d3e08e1c479e98f7ffc8291'],17,27,44,3793632,1,,,,10576
668c278e3099598f7a42aaf6da1ce833c951fab2,0,Pierre Villard,2020-10-08 11:44:52+02:00,['dee2fcedfed4a20f565eec66425a8790088e05c1'],5,14,19,3793651,1,1,1,0,10576
82d3fd6cd628a6045b4fb87007190abd7ba8dbe5,1,markap14,2020-10-08 08:58:14-04:00,['668c278e3099598f7a42aaf6da1ce833c951fab2'],2,2,4,3793655,1,,,,10576
a95ffce6bd451fc4a65bb1be9346a05fd42c0f41,0,Pierre Villard,2020-10-08 15:38:37+02:00,['82d3fd6cd628a6045b4fb87007190abd7ba8dbe5'],2,2,4,3793659,1,,,,10576
c2960998ac70009d9365326dce47b3d15ad299e4,0,GitHub,2020-10-09 09:42:20-04:00,['a95ffce6bd451fc4a65bb1be9346a05fd42c0f41'],0,88,88,3793747,4,,,,10576
99a75e833b8b26e8ff7dbea739886193f92ba01d,0,GitHub,2020-10-12 19:17:09+00:00,['c2960998ac70009d9365326dce47b3d15ad299e4'],1,1,2,3793749,1,,,,10576
4c235f040562e2ca5b723bd3cc85be435c48682e,1,Mike Thomsen,2020-10-12 17:53:27-04:00,['c2960998ac70009d9365326dce47b3d15ad299e4'],1,44,45,3793794,4,0,1,1,10577
8aa001a918413c68f7d6f46559982f391eb1fa9c,1,GitHub,2020-10-12 21:54:52+00:00,['4c235f040562e2ca5b723bd3cc85be435c48682e'],3,3,6,3793800,3,,,,10577
2d3b171d636bdd6754b49df524252888c5aa2135,0,GitHub,2020-10-13 11:31:36+02:00,"['4c235f040562e2ca5b723bd3cc85be435c48682e', '8aa001a918413c68f7d6f46559982f391eb1fa9c']",3,3,6,3793806,3,,,,10577
52f1fe54a517c924e4f3bfa7a4ab2e612ae0db8e,0,GitHub,2020-10-13 11:32:11+02:00,"['2d3b171d636bdd6754b49df524252888c5aa2135', '99a75e833b8b26e8ff7dbea739886193f92ba01d']",0,0,0,3793806,0,,,,10577
5b5b9a780073f8eabadea7edb3b26f2b5328ed6d,0,Mike Thomsen,2020-10-14 09:09:42-04:00,['52f1fe54a517c924e4f3bfa7a4ab2e612ae0db8e'],4,72,76,3793882,2,1,1,1,10577
4a370eae8c58163fc15263a2855b0b0f15c4c51b,0,Pierre Villard,2020-10-16 18:13:29+02:00,['5b5b9a780073f8eabadea7edb3b26f2b5328ed6d'],1,1,2,3793884,1,,,,10577
b442df58e2f1270589b25ab5575101bf2f9860f3,0,Mike Thomsen,2020-10-16 18:44:27-04:00,['4a370eae8c58163fc15263a2855b0b0f15c4c51b'],0,1,1,3793885,1,0,0,1,10577
55cb8d73cb76419ad1a0d67dae3246415af6b81c,1,Nathan Gough,2020-10-20 11:20:43-04:00,['b442df58e2f1270589b25ab5575101bf2f9860f3'],19,620,639,3794524,9,0.394409938,0.909937888,0.779503106,10578
d05d0c6240217da9cc72c07110ed273f37b0fa21,0,markap14,2020-10-21 09:17:29-04:00,['55cb8d73cb76419ad1a0d67dae3246415af6b81c'],38,125,163,3794687,8,0.276595745,0.808510638,1,10580
d1bfa679276e4d73f10a2d0287ca76b4791c8a00,0,Joe Witt,2020-10-22 07:16:31-07:00,['d05d0c6240217da9cc72c07110ed273f37b0fa21'],32,32,64,3794751,1,,,,10580
b980a8ea8caf077be8046de3f7b5c1bd337864d8,0,Peter Turcsanyi,2020-10-22 19:22:49+02:00,['d1bfa679276e4d73f10a2d0287ca76b4791c8a00'],2,2907,2909,3797660,35,0.717213115,0.903005464,0.913934426,10608
718b77c7c4b56e6b064f8bd257dde25d069e014f,0,GitHub,2020-10-26 09:11:58-04:00,['b980a8ea8caf077be8046de3f7b5c1bd337864d8'],21,135,156,3797816,1,,,,10608
c8ea7523effc9d2507fdecf2d38a9d783103f732,0,Pierre Villard,2020-10-26 19:31:05+01:00,['718b77c7c4b56e6b064f8bd257dde25d069e014f'],3,42,45,3797861,2,0,1,1,10608
9a11d23c833a941106e464b6d6d09bd0b3ffbba6,1,Pierre Villard,2020-10-26 19:36:27+01:00,['c8ea7523effc9d2507fdecf2d38a9d783103f732'],6,63,69,3797930,6,0.894736842,0.947368421,0.947368421,10608
3dd024fb66f11d45a188e2281966a51ff198250a,1,Bryan Bende,2020-10-26 16:21:16-04:00,['9a11d23c833a941106e464b6d6d09bd0b3ffbba6'],15,325,340,3798270,15,0.318181818,1,1,10611
9c1656dbff55cefe66a2b13331c1e0ec8735a0b2,0,Peter Turcsanyi,2020-10-27 00:22:15+01:00,['3dd024fb66f11d45a188e2281966a51ff198250a'],8,13,21,3798291,8,0,1,1,10611
6e9bef14287267b5d28129c0fb68fbc7a3e218d8,0,Pierre Villard,2020-10-27 13:44:42+01:00,['9c1656dbff55cefe66a2b13331c1e0ec8735a0b2'],1419,1325,2744,3801035,60,0.014925373,0,0.686567164,10625
67d1b73a85946fda246d358a1cb7dec1ebd463a6,0,GitHub,2020-10-27 08:57:05-04:00,['6e9bef14287267b5d28129c0fb68fbc7a3e218d8'],3,3,6,3801041,1,,,0,10625
dc25d4c39e731a0170f3ad76e8700a2b7c72c30c,1,Bryan Bende,2020-10-27 10:17:52-04:00,['67d1b73a85946fda246d358a1cb7dec1ebd463a6'],1,135,136,3801177,4,0.626865672,1,1,10627
3612973a47d7b9134a8852e0a26f3f92c8a99529,0,Bryan Bende,2020-10-27 10:18:06-04:00,['dc25d4c39e731a0170f3ad76e8700a2b7c72c30c'],23,1,24,3801201,2,0.333333333,0,0,10627
77b4abc21e25dff0063fb634a56818aff2f5060e,1,GitHub,2020-10-27 11:24:48-04:00,['3612973a47d7b9134a8852e0a26f3f92c8a99529'],47,56,103,3801304,1,0,0,1,10627
4fee07656169e4f1df723ad5e5b8769dddcfdb04,1,GitHub,2020-10-27 11:39:28-04:00,['77b4abc21e25dff0063fb634a56818aff2f5060e'],4,23,27,3801331,2,1,0.0625,1,10627
e7f244f267172e0307f21e60504982717d0a431a,0,GitHub,2020-10-27 12:33:08-04:00,['4fee07656169e4f1df723ad5e5b8769dddcfdb04'],2,2,4,3801335,1,,,,10627
bcf625f4c8cf8a7733cd8efad0b0b1be940ca253,0,markap14,2020-10-27 14:30:13-04:00,['e7f244f267172e0307f21e60504982717d0a431a'],2,13,15,3801350,2,0.666666667,1,1,10627
c70f4ac530772a24c21dc032cd1b78d4657d54e1,0,Joe Witt,2020-10-27 13:19:16-07:00,['bcf625f4c8cf8a7733cd8efad0b0b1be940ca253'],0,0,0,3801350,1,,,,10627
bf962f62275071dfe5f00aedd028b8231680450c,1,Nathan Gough,2020-10-27 17:18:05-04:00,['c70f4ac530772a24c21dc032cd1b78d4657d54e1'],236,1130,1366,3802716,9,0.572,0.5,0.896,10628
74968991d5034c96c481386f76929e9a49cab8a1,1,markap14,2020-10-27 19:03:35-04:00,['bf962f62275071dfe5f00aedd028b8231680450c'],131,241,372,3803088,3,0.098039216,0.450980392,0.450980392,10628
c610aab3cb017d7030381f2715de446923870966,0,markap14,2020-10-27 19:04:19-04:00,['74968991d5034c96c481386f76929e9a49cab8a1'],59,194,253,3803341,13,0.11627907,0,0.395348837,10628
2232e280523f47daebf3ce5ff5f0080261d78928,1,Joe Witt,2020-10-27 21:23:59-07:00,['c610aab3cb017d7030381f2715de446923870966'],1,57,58,3803399,1,0,0.5,0.5,10628
a115894984c73556bbf2a1635c363ee2b13035ca,0,Joey Frazee,2020-10-28 21:09:10-05:00,['2232e280523f47daebf3ce5ff5f0080261d78928'],1,1,2,3803401,1,,,,10628
2b461bbf295b0065ec1adacac4d3d14190e75f16,0,Pierre Villard,2020-10-30 13:50:53+01:00,['a115894984c73556bbf2a1635c363ee2b13035ca'],1,254,255,3803656,4,0.583333333,0.796296296,1,10630
80f49eb7bdcd761cdf42631d4d9378c4004fb4e7,1,Joey Frazee,2020-11-03 01:54:33-06:00,['2b461bbf295b0065ec1adacac4d3d14190e75f16'],3,1750,1753,3805409,15,0.442536328,0.722589168,0.973579921,10640
8b78277a4500ad35d76e87faf6eea3a0d502df4d,0,Pierre Villard,2020-11-03 11:46:29+01:00,['80f49eb7bdcd761cdf42631d4d9378c4004fb4e7'],12,11,23,3805432,4,,,,10640
d8d9aa9cec0cd23f285ac65c6aba3280aa5b960d,0,markap14,2020-11-03 12:22:41-05:00,['8b78277a4500ad35d76e87faf6eea3a0d502df4d'],0,61,61,3805493,2,0.022222222,0.711111111,1,10640
f7f336a4b0ad121e127a7c8c539bbb110ca53b40,0,Bryan Bende,2020-11-03 15:37:08-05:00,['d8d9aa9cec0cd23f285ac65c6aba3280aa5b960d'],63,309,372,3805865,7,0.765957447,0.946808511,1,10642
4bd9d7b4139bb05db96a15c9cf770ccd3c33bb38,1,Bryan Bende,2020-11-03 15:37:16-05:00,['f7f336a4b0ad121e127a7c8c539bbb110ca53b40'],2,73,75,3805940,1,0.886363636,0.886363636,1,10642
e2e901b6b97c8099038230b430905bd5c85bf6ae,0,Bryan Bende,2020-11-03 15:37:26-05:00,['4bd9d7b4139bb05db96a15c9cf770ccd3c33bb38'],23,37,60,3806000,1,1,1,1,10642
535cab3167a5c2cd88ef560494628186317bf0d3,1,Bryan Bende,2020-11-03 15:37:33-05:00,['e2e901b6b97c8099038230b430905bd5c85bf6ae'],20,46,66,3806066,4,0.913043478,0.913043478,1,10642
4b9014b9596a8f479a32d0b3e52bc6649b0f0d1b,1,Bryan Bende,2020-11-03 15:37:42-05:00,['535cab3167a5c2cd88ef560494628186317bf0d3'],147,911,1058,3807124,35,0.26645768,0.536050157,0.677115987,10646
42c2cda9a21fc1d66040c6b95dcff1164515e2a6,1,Bryan Bende,2020-11-03 15:37:51-05:00,['4b9014b9596a8f479a32d0b3e52bc6649b0f0d1b'],6,18,24,3807148,2,0,0,1,10646
d773521ee01f3a34fdd21365a86c8de7b82077a6,0,Bryan Bende,2020-11-03 15:38:41-05:00,['42c2cda9a21fc1d66040c6b95dcff1164515e2a6'],2,2,4,3807152,1,,,,10646
71a5735f63182e93418a36af1946645805938c44,0,Mike Thomsen,2020-11-03 15:43:15-05:00,['d773521ee01f3a34fdd21365a86c8de7b82077a6'],11,16,27,3807179,4,0,0.25,1,10646
0805670263152fb6908f3865fb1cfe55c22c55ff,0,Mike Thomsen,2020-11-04 07:20:21-05:00,['71a5735f63182e93418a36af1946645805938c44'],13,11,24,3807203,3,,,,10646
59e00c4b6f941964e054d5921647f850b6831af3,1,Mark Payne,2020-11-04 10:09:46-05:00,['0805670263152fb6908f3865fb1cfe55c22c55ff'],57,421,478,3807681,20,0.38,0.94,0.93,10647
1366d017b8cbd684308f49a6875d65bf7c61c9d6,0,Pierre Villard,2020-11-05 13:18:35+01:00,['59e00c4b6f941964e054d5921647f850b6831af3'],1,6,7,3807688,1,0,1,1,10647
9a3a659c441f7d4d61f7b526777f1a2def9198ac,0,Pierre Villard,2020-11-05 13:21:11+01:00,['1366d017b8cbd684308f49a6875d65bf7c61c9d6'],8,8,16,3807704,8,,,,10647
14ec02f21dde3489e02b94c204eb9b9e24f3c665,0,Mike Thomsen,2020-11-05 18:19:55-05:00,['9a3a659c441f7d4d61f7b526777f1a2def9198ac'],30,234,264,3807968,19,0.3,0.8375,0.8125,10650
940bc3056cc59fc54e59c50084d942d667f95a46,1,GitHub,2020-11-09 09:00:20-05:00,['14ec02f21dde3489e02b94c204eb9b9e24f3c665'],245,333,578,3808546,5,1,0.890909091,0.381818182,10650
badcfe1ab7b7166decb92a0d427ba48fbf613400,1,Bryan Bende,2020-11-10 15:27:51-05:00,['940bc3056cc59fc54e59c50084d942d667f95a46'],12,45,57,3808603,1,0,0,1,10650
479ee6e3db58ee22dc1c7f4510eed5767c4458a0,1,Bryan Bende,2020-11-10 17:05:05-05:00,['badcfe1ab7b7166decb92a0d427ba48fbf613400'],106,802,908,3809511,13,0.405612245,0.75255102,0.969387755,10653
018778a25d34eea243a3407d79c57d76f92155c8,0,markap14,2020-11-12 10:45:10-05:00,['479ee6e3db58ee22dc1c7f4510eed5767c4458a0'],5,2,7,3809518,1,0.5,0.5,0.5,10653
c79ad1502e7938822e5c10693c294538996f5a61,0,Pierre Villard,2020-11-12 17:44:46+01:00,['018778a25d34eea243a3407d79c57d76f92155c8'],3,12,15,3809533,3,0.75,0.75,1,10653
8a4079cd783bd8d6c78542f38e08726dda54ec04,0,Pierre Villard,2020-11-13 13:27:12+01:00,['c79ad1502e7938822e5c10693c294538996f5a61'],14,21,35,3809568,2,1,1,1,10653
c57d0abcd3773d260621cb274e2aa429e034f996,0,markap14,2020-11-13 11:25:34-05:00,['8a4079cd783bd8d6c78542f38e08726dda54ec04'],1,39,40,3809608,2,0,1,1,10653
e66362194db07798eadb68724072f5e299c65902,1,Peter Turcsanyi,2020-11-16 12:20:30+01:00,['c57d0abcd3773d260621cb274e2aa429e034f996'],65,177,242,3809850,4,0.897959184,1,0.693877551,10654
83948db989bf2f682dfa18c56293ec431f546e1c,1,Pierre Villard,2020-11-16 17:40:40+01:00,['e66362194db07798eadb68724072f5e299c65902'],3,42,45,3809895,2,0,1,1,10654
5c925371c2fe21adad11541a3c17a15bb1896d4c,1,Pierre Villard,2020-11-16 18:19:35+01:00,['83948db989bf2f682dfa18c56293ec431f546e1c'],56,204,260,3810155,10,0,0.533333333,0.973333333,10654
47cc2867baf5372d018332cc229b3bac470b26a8,1,Mark Payne,2020-11-16 15:16:12-05:00,['5c925371c2fe21adad11541a3c17a15bb1896d4c'],3,139,142,3810297,2,0.718309859,0.718309859,0.605633803,10654
d5dc63ded93220ced8e861de69a679868532f7d3,0,Mike Thomsen,2020-11-17 07:05:52-05:00,['47cc2867baf5372d018332cc229b3bac470b26a8'],1,8,9,3810306,1,,,,10654
a0328ff8d1d00e7a540676530278839905168ab7,0,GitHub,2020-11-17 10:23:30-05:00,['d5dc63ded93220ced8e861de69a679868532f7d3'],63,334,397,3810703,2,0,1,0.942307692,10654
4aaec5aa3878f1abd3c2b98ba7659431f0a8c9c3,1,Pierre Villard,2020-11-18 00:26:27+01:00,['a0328ff8d1d00e7a540676530278839905168ab7'],0,1,1,3810704,1,0,0,0,10654
edc060bd92b689c4d610f5ac4aef83073167c8a6,0,Peter Turcsanyi,2020-11-18 00:39:07+01:00,['4aaec5aa3878f1abd3c2b98ba7659431f0a8c9c3'],0,2773,2773,3813477,12,0.200980392,0.394957983,0.598739496,10660
7848ba59a250ba4ae98d7062869bcf01a9a58b71,1,Pierre Villard,2020-11-18 16:03:24+01:00,['edc060bd92b689c4d610f5ac4aef83073167c8a6'],43,1206,1249,3814726,18,0.335504886,0.625407166,0.960912052,10664
dcc4fb00a51ac4f5798a39a43d8033bb1b65a306,1,Matt Gilman,2020-11-18 12:44:02-05:00,['7848ba59a250ba4ae98d7062869bcf01a9a58b71'],340,7031,7371,3822097,109,0.447165381,0.825561892,0.846024824,10710
40fdcd814438598ecbda5fd36d9b409e58c90c72,1,Nathan Gough,2020-11-18 14:56:59-05:00,['dcc4fb00a51ac4f5798a39a43d8033bb1b65a306'],0,1,1,3822098,1,1,1,0,10710
dc6ba2541f13db9666a491fd3b0ce701f318f900,0,markap14,2020-11-19 09:11:49-05:00,['40fdcd814438598ecbda5fd36d9b409e58c90c72'],0,11,11,3822109,2,0,1,1,10710
2bf5d1a56d0e0803020df859dff616f88db4c3cd,0,markap14,2020-11-19 16:01:42-05:00,['dc6ba2541f13db9666a491fd3b0ce701f318f900'],0,2,2,3822111,1,1,1,1,10710
932496e10667a27b836bbf68c8084414bc992f4f,0,Joey Frazee,2020-11-20 12:10:01-06:00,['2bf5d1a56d0e0803020df859dff616f88db4c3cd'],48,287,335,3822446,11,0.373134328,0.850746269,0.776119403,10713
87fd9f968fceaccac8c115cc4cd83c608d4e04b7,0,Matthew Burgess,2020-11-23 13:00:54-05:00,['932496e10667a27b836bbf68c8084414bc992f4f'],14,58,72,3822518,3,0.5,0.657894737,0.973684211,10713
3c9d8a7007cab279b0cc6ebd2f56bce7bcddba80,1,Bryan Bende,2020-11-24 11:37:45-05:00,['87fd9f968fceaccac8c115cc4cd83c608d4e04b7'],9756,13913,23669,3846187,344,1,1,1,10813
7ad9520079fdbe4efe47ed5b6248ec513fd0ca0b,1,Bryan Bende,2020-11-24 15:12:51-05:00,['3c9d8a7007cab279b0cc6ebd2f56bce7bcddba80'],187,965,1152,3847339,21,0.301470588,1,0.966911765,10821
857eeca3c7d4b275fd698430594e7fae4864feff,0,Mike Thomsen,2020-11-24 18:01:16-05:00,['7ad9520079fdbe4efe47ed5b6248ec513fd0ca0b'],2,2,4,3847343,1,,,,10821
a3d845a38f93fed1f65ec85c851ca845ef186556,1,Koji Kawamura,2020-11-26 15:08:05+09:00,['857eeca3c7d4b275fd698430594e7fae4864feff'],51,405,456,3847799,14,0,0.926470588,0.893382353,10821
124cdbd3fe5446bff08346e5a28f2883f13e2848,0,Koji Kawamura,2020-11-26 15:08:13+09:00,['a3d845a38f93fed1f65ec85c851ca845ef186556'],321,225,546,3848345,17,1,0.222222222,0.185185185,10821
5ea18f39b572b9c552ed066f32be08f14384452d,0,Pierre Villard,2020-11-26 10:49:52+01:00,['124cdbd3fe5446bff08346e5a28f2883f13e2848'],1,4,5,3848350,1,1,1,1,10821
fe950131c35756dabd677fb21b436a1f85eabced,1,Peter Turcsanyi,2020-11-27 19:23:44+01:00,['5ea18f39b572b9c552ed066f32be08f14384452d'],10,14,24,3848374,2,0.75,1,1,10821
3625a73d91f9504e7117043402613ddbe3a0cbe9,1,Matthew Burgess,2020-11-29 18:58:57-05:00,['fe950131c35756dabd677fb21b436a1f85eabced'],0,550,550,3848924,8,1,1,0.621621622,10827
39f8a008d4bde2024eb804ff7017542a6e86b572,0,Peter Turcsanyi,2020-11-30 10:17:15+01:00,['3625a73d91f9504e7117043402613ddbe3a0cbe9'],183,366,549,3849473,16,0.775,1,0.65,10830
fe53f8090d3d046b60d551e83bcd6f43c560a461,0,Matthew Burgess,2020-11-30 14:55:20-05:00,['39f8a008d4bde2024eb804ff7017542a6e86b572'],9,63,72,3849545,2,0.717948718,0.717948718,1,10830
aaa1452d041ff34f3647004e73a1f78f59c561d4,0,GitHub,2020-11-30 16:14:12-05:00,['fe53f8090d3d046b60d551e83bcd6f43c560a461'],71,57,128,3849673,2,0,1,1,10830
1e13b62e78a95f869a770771d5e2cde5bd828cad,0,Matthew Burgess,2020-11-30 18:33:32-05:00,['aaa1452d041ff34f3647004e73a1f78f59c561d4'],4,11,15,3849688,1,,,,10830
64e3599f05865c0adfce95da15e1677744ea39f4,1,Mike Thomsen,2020-12-01 09:42:14-05:00,['1e13b62e78a95f869a770771d5e2cde5bd828cad'],5,143,148,3849836,5,0.692307692,0.615384615,0.923076923,10832
c29cced269dcce28fb9ba034025d01e76a79b037,0,Mike Thomsen,2020-12-01 11:13:10-05:00,['64e3599f05865c0adfce95da15e1677744ea39f4'],0,633,633,3850469,9,0.1875,0.584558824,0.830882353,10839
b90a6e893d4920a0e1038ad286b96520d74ab070,0,Joe Witt,2020-12-03 07:22:40-07:00,['c29cced269dcce28fb9ba034025d01e76a79b037'],4,24,28,3850497,1,1,1,1,10839
8ac8a2bd1fbf75b8458554988eb1b3b1851b25d9,0,markap14,2020-12-03 14:42:50-05:00,['b90a6e893d4920a0e1038ad286b96520d74ab070'],20,411,431,3850928,4,1,1,0.921296296,10840
2b1359a8080ac8b05058beffd272cf3f41ba9e1e,0,markap14,2020-12-03 14:42:50-05:00,['8ac8a2bd1fbf75b8458554988eb1b3b1851b25d9'],39,6,45,3850973,2,0,0,0.3,10840
312fa8e85e46e6d90973ff9a549e086084251afe,0,markap14,2020-12-03 14:46:13-05:00,['2b1359a8080ac8b05058beffd272cf3f41ba9e1e'],3,3,6,3850979,2,,,,10840
8055c47a84197eeaac41d3dfb2e2fb16e44806dd,0,Matthew Burgess,2020-12-03 15:44:56-05:00,['312fa8e85e46e6d90973ff9a549e086084251afe'],34,40,74,3851053,1,0,1,1,10840
04aaf2513102ae9ba2a74aaef9faa70e92ceb37d,0,markap14,2020-12-03 16:39:46-05:00,['8055c47a84197eeaac41d3dfb2e2fb16e44806dd'],1,1,2,3851055,1,,,,10840
d84583690f9323932cce851679770dea9d7a435f,0,markap14,2020-12-03 17:23:11-05:00,['04aaf2513102ae9ba2a74aaef9faa70e92ceb37d'],30,227,257,3851312,4,0.265625,0.875,0.875,10841
29ea872f2cd06a61db36785caba027eb9699e744,0,Mike Thomsen,2020-12-04 07:30:09-05:00,['d84583690f9323932cce851679770dea9d7a435f'],2,62,64,3851376,2,1,1,1,10841
71d5162965cc8c7aa23d675240f5e75b1c86d3fd,0,Mike Thomsen,2020-12-04 07:39:08-05:00,['29ea872f2cd06a61db36785caba027eb9699e744'],4,39,43,3851419,2,0.035714286,0.892857143,1,10841
37c2284d04ccf7ceb0d8ede62dafe6dce5ab835e,1,Pierre Villard,2020-12-04 19:31:23+01:00,['71d5162965cc8c7aa23d675240f5e75b1c86d3fd'],45,136,181,3851600,5,0.658536585,1,1,10843
2f99d6fce472af9a4c3d63689343e64fbc0c6dd1,0,Pierre Villard,2020-12-07 13:11:22+01:00,['37c2284d04ccf7ceb0d8ede62dafe6dce5ab835e'],2,63,65,3851665,2,0,0,1,10843
405c393cb59407aec89280934e353db7252b4b20,1,Mike Thomsen,2020-12-07 08:51:07-05:00,['2f99d6fce472af9a4c3d63689343e64fbc0c6dd1'],1,184,185,3851850,4,0.625,0.886363636,0.488636364,10844
d7ca4c920c645280ef7a809cf5993ca587e8927a,0,Bryan Bende,2020-12-07 10:03:04-05:00,['405c393cb59407aec89280934e353db7252b4b20'],1,1,2,3851852,1,,,,10844
039a09923a25d37d86e6db615736322deefb7e35,1,Bryan Bende,2020-12-07 10:03:16-05:00,['d7ca4c920c645280ef7a809cf5993ca587e8927a'],8,7,15,3851867,1,,,,10844
cfbcecc4c6ceae805bf26588a4c587d4ca37763a,0,GitHub,2020-12-08 15:56:46-05:00,['039a09923a25d37d86e6db615736322deefb7e35'],10,12,22,3851889,9,,,,10844
2c0671cf807f4730173f63fde129d5c6328b138d,1,Mike Thomsen,2020-12-09 08:57:21-05:00,['cfbcecc4c6ceae805bf26588a4c587d4ca37763a'],12,44,56,3851945,2,0.052631579,1,0.578947368,10844
0af736dc0b1cb159555b42b61908266fc76bd96e,0,GitHub,2020-12-09 09:29:42-05:00,['2c0671cf807f4730173f63fde129d5c6328b138d'],3,77,80,3852025,4,0.826086957,0.826086957,0.891304348,10844
8d2fd39bdb790fa2c5f3adaea69092b582d3d7ac,0,GitHub,2020-12-09 09:37:01-05:00,['0af736dc0b1cb159555b42b61908266fc76bd96e'],18,17,35,3852060,4,,,,10844
1d31434c48fa897098e7aff227fa05eec7523f84,0,Joey Frazee,2020-12-09 17:13:25-06:00,['8d2fd39bdb790fa2c5f3adaea69092b582d3d7ac'],1,1,2,3852062,1,,,,10844
1f8b4e477943eb5b7edadec8b30f3c8f123593c0,1,Mike Thomsen,2020-12-09 21:05:44-05:00,['1d31434c48fa897098e7aff227fa05eec7523f84'],30,103,133,3852195,17,1,1,0,10845
8e4948322e0e799a5bc216343c201737ecf6bc18,0,Mike Thomsen,2020-12-10 10:30:11-05:00,['1f8b4e477943eb5b7edadec8b30f3c8f123593c0'],1,4,5,3852200,2,1,1,1,10845
7bff64b3cf37700407a51d896d0349853eaed733,1,Nathan Gough,2020-12-10 11:53:20-05:00,['8e4948322e0e799a5bc216343c201737ecf6bc18'],86,181,267,3852467,7,1,1,1,10845
8eb0db6b38173b3993c8e10babd42284ee42f35b,1,Matthew Burgess,2020-12-11 10:06:06-05:00,['7bff64b3cf37700407a51d896d0349853eaed733'],12,3,15,3852482,1,1,1,0,10845
ec3d5f89f08c4b6730e2c3413d48e40800b2d7d1,0,Pierre Villard,2020-12-13 10:18:32+01:00,['8eb0db6b38173b3993c8e10babd42284ee42f35b'],2,38,40,3852522,2,1,1,1,10845
91f6b42985c20ee9b1ef177d16c70c820a5cdf0e,0,Pierre Villard,2020-12-13 10:23:35+01:00,['ec3d5f89f08c4b6730e2c3413d48e40800b2d7d1'],16,18,34,3852556,4,,,,10845
a73cd6a610f2e4a43e82bb26e2e4f983b9bfa1a5,0,Matthew Burgess,2020-12-14 11:49:47-05:00,['91f6b42985c20ee9b1ef177d16c70c820a5cdf0e'],6,32,38,3852594,2,0.166666667,0.166666667,1,10845
5bcb5abc8680d02f50c235f824050d8a044de1b7,1,Nathan Gough,2020-12-14 14:31:08-05:00,['a73cd6a610f2e4a43e82bb26e2e4f983b9bfa1a5'],41,125,166,3852760,5,0.632653061,1,0.755102041,10845
28ca7478d6c209f7029670dd4ced5ed9206ecc9f,0,Nathan Gough,2020-12-14 19:34:58-05:00,['5bcb5abc8680d02f50c235f824050d8a044de1b7'],80,220,300,3853060,7,1,1,1,10847
f29d6a6046ddec83f2570942bac638ec67ec81e4,0,Peter Turcsanyi,2020-12-15 22:05:53+01:00,['28ca7478d6c209f7029670dd4ced5ed9206ecc9f'],472,984,1456,3854516,6,0,0.656346749,0.888544892,10847
02665d756197cbeeb99f8f635811d442e88cdd1a,0,Pierre Villard,2020-12-16 12:43:24+01:00,['f29d6a6046ddec83f2570942bac638ec67ec81e4'],0,10,10,3854526,1,0,1,1,10847
989287adafefd38273c85ec5e7391d131197a90b,0,Matthew Burgess,2020-12-16 14:57:59-05:00,['02665d756197cbeeb99f8f635811d442e88cdd1a'],1,86,87,3854613,2,1,0.967741935,1,10848
942030579a055b568eef9de2849e804ad034f174,0,Joey Frazee,2020-12-16 18:11:06-06:00,['989287adafefd38273c85ec5e7391d131197a90b'],14,191,205,3854818,7,0.612244898,1,1,10851
31c5dc5ab41ebf909b7512154e7519d22936bf89,1,Mark Payne,2020-12-18 14:20:41-05:00,['942030579a055b568eef9de2849e804ad034f174'],3,15,18,3854836,2,0,0,0,10851
19bf89f7ed277520f69c7bfb5e1c59c3e8c669f3,0,Pierre Villard,2020-12-22 11:27:49+01:00,['31c5dc5ab41ebf909b7512154e7519d22936bf89'],1,1,2,3854838,1,,,,10851
de88ce7a618aac4f7c886ccd1be39d3047313adb,0,Mike Thomsen,2020-12-23 12:41:42-05:00,['19bf89f7ed277520f69c7bfb5e1c59c3e8c669f3'],72,122,194,3855032,3,0.634146341,0.707317073,0.926829268,10851
5c79553af6dc5e20830a12a4dc6c56b07692c1fa,0,markap14,2021-01-04 11:58:47-05:00,['de88ce7a618aac4f7c886ccd1be39d3047313adb'],7,19,26,3855058,2,,,,10851
112b893bf261b29f62b8e89cc8e7f40d20d60c3b,0,markap14,2021-01-04 13:41:03-05:00,['5c79553af6dc5e20830a12a4dc6c56b07692c1fa'],5,15,20,3855078,2,0.5,0.5,0.5,10851
0f667cb4f3f84b6f0978d5d976d6163f6ca1653c,0,markap14,2021-01-04 14:14:29-05:00,['112b893bf261b29f62b8e89cc8e7f40d20d60c3b'],1,2,3,3855081,1,,,,10851
e7c6bdad42514200d8732b644c59dcb789e358da,0,markap14,2021-01-04 14:20:05-05:00,['0f667cb4f3f84b6f0978d5d976d6163f6ca1653c'],43,125,168,3855249,11,0.875,0.875,1,10853
ceb9dff3b9a8511c61e39e0728fcdd63f545ce91,1,Pierre Villard,2021-01-05 09:42:41+01:00,['e7c6bdad42514200d8732b644c59dcb789e358da'],5,112,117,3855366,2,0,0.716216216,0.864864865,10853
584adc3b917a015b20171b473f2b677343d01779,0,Pierre Villard,2021-01-05 11:31:00+01:00,['ceb9dff3b9a8511c61e39e0728fcdd63f545ce91'],125,133,258,3855624,6,1,1,0,10853
bb178f371b879adff823517917426532627c5872,0,Pierre Villard,2021-01-06 09:34:43+01:00,['584adc3b917a015b20171b473f2b677343d01779'],5,194,199,3855823,5,0.211267606,0.422535211,0.887323944,10855
1e227ca6436899b8109a3443aa4487bd43146fca,1,Peter Turcsanyi,2021-01-06 13:47:05+01:00,['bb178f371b879adff823517917426532627c5872'],1,30,31,3855854,1,0.769230769,0.769230769,1,10855
c9d778a8eedad64b243d28fa481fedbe21222e6e,0,Peter Turcsanyi,2021-01-06 14:15:27+01:00,['1e227ca6436899b8109a3443aa4487bd43146fca'],9,43,52,3855906,2,1,0,0,10856
80eb570ee10a0ee40e154699a712f5e414d38c44,0,Peter Turcsanyi,2021-01-06 16:46:17+01:00,['c9d778a8eedad64b243d28fa481fedbe21222e6e'],2,30,32,3855938,2,0.727272727,0,1,10856
8b2712e537a2348cf5e231928fc597d56835df49,0,Mark Payne,2021-01-06 11:02:45-05:00,['80eb570ee10a0ee40e154699a712f5e414d38c44'],0,416,416,3856354,5,0.614973262,1,0.903743316,10861
954c09d0c31fa6f31d414c364f142742bf7cda91,0,Mark Payne,2021-01-06 11:09:07-05:00,['8b2712e537a2348cf5e231928fc597d56835df49'],9,6,15,3856369,2,0,0,0,10861
7214dc0f853e960a3803ce07d6c49237af747488,1,markap14,2021-01-06 12:10:20-05:00,['954c09d0c31fa6f31d414c364f142742bf7cda91'],1,104,105,3856474,3,0,0.961038961,1,10861
ea80dad16a433c08f18990a0ed4b8da60aa7d136,1,Pierre Villard,2021-01-06 19:27:33+01:00,['7214dc0f853e960a3803ce07d6c49237af747488'],19,45,64,3856538,3,1,1,0.80952381,10861
783633cac5e02e96086ab2d36c92d8057df93c01,1,Pierre Villard,2021-01-06 19:28:09+01:00,['ea80dad16a433c08f18990a0ed4b8da60aa7d136'],19,45,64,3856602,3,1,1,0.80952381,10861
817f621d6fc7fa44860dc9378b3473bfaa266a53,1,Mark Payne,2021-01-06 16:24:26-05:00,['783633cac5e02e96086ab2d36c92d8057df93c01'],305,147,452,3857054,53,0.989247312,0.752688172,0.387096774,10861
f330078fffd39feeb2b289f7e9de5113f9c78bb4,0,Joey Frazee,2021-01-07 14:57:57-06:00,['817f621d6fc7fa44860dc9378b3473bfaa266a53'],3,48,51,3857105,6,0.529411765,0,1,10861
a4027e8e77facdf94817e343d88ecbfeeacbf7fc,0,Peter Turcsanyi,2021-01-08 17:13:10+00:00,['f330078fffd39feeb2b289f7e9de5113f9c78bb4'],82,113,195,3857300,2,0.222222222,1,0.722222222,10861
d41f2e1d0abb5305cb9650ade948e336f31be7de,1,Peter Turcsanyi,2021-01-11 18:02:09+01:00,['a4027e8e77facdf94817e343d88ecbfeeacbf7fc'],54,147,201,3857501,2,0.901639344,0.918032787,1,10861
84b561ad33fa0d37a7e175c1dd03d2412dbffaea,0,Pierre Villard,2021-01-11 21:53:12+04:00,['d41f2e1d0abb5305cb9650ade948e336f31be7de'],106,322,428,3857929,9,0.333333333,0.666666667,0.983333333,10863
5f7558cecf4580106e6c14e6f565974b4abc2140,1,Mark Payne,2021-01-11 13:42:52-05:00,['84b561ad33fa0d37a7e175c1dd03d2412dbffaea'],4,100,104,3858033,4,0.574468085,0.957446809,0.872340426,10864
82c84492ced10b135242c86afd2e4ff1d0083ff9,0,Matthew Burgess,2021-01-12 10:32:08-05:00,['5f7558cecf4580106e6c14e6f565974b4abc2140'],11,37,48,3858081,2,0,0,1,10864
7d76bcd5202a8680c952d3a19072087a971d0b69,1,Nathan Gough,2021-01-12 10:52:49-05:00,['82c84492ced10b135242c86afd2e4ff1d0083ff9'],46,56,102,3858183,12,1,1,1,10864
2d6917918439153e8e20629efb3925dba4efdcf7,0,Pierre Villard,2021-01-13 00:44:03+04:00,['7d76bcd5202a8680c952d3a19072087a971d0b69'],0,3,3,3858186,1,0,0,1,10864
0b966cdb141a89d5cef49e93653ace83217752bf,0,Matthew Burgess,2021-01-12 16:09:38-05:00,['2d6917918439153e8e20629efb3925dba4efdcf7'],6,85,91,3858277,1,0,0,0,10864
382439c1d02a65473b229fb52969a1d6f4d26215,1,Mark Payne,2021-01-13 08:41:12-05:00,['0b966cdb141a89d5cef49e93653ace83217752bf'],29,137,166,3858443,17,0.288135593,0.745762712,0.305084746,10864
3cc8d767b3cd4442a3a55bf62ec302eeec26ab58,0,Mark Payne,2021-01-13 09:35:05-05:00,['382439c1d02a65473b229fb52969a1d6f4d26215'],80,381,461,3858904,19,0,0.717514124,0.745762712,10865
b9076ca26eb444ebda28ef6c5efbb759e4d1af0f,0,Peter Turcsanyi,2021-01-13 23:26:44+01:00,['3cc8d767b3cd4442a3a55bf62ec302eeec26ab58'],30,761,791,3859695,5,0.064239829,0.370449679,0.685224839,10866
097edf4f7c5f9135f0ab9ab1c229bbbb35696b3f,1,Matthew Burgess,2021-01-15 10:02:09-05:00,['b9076ca26eb444ebda28ef6c5efbb759e4d1af0f'],507,968,1475,3861170,40,0.646387833,0.764258555,1,10866
40f193098b897869f42360ee35c60487bf0c235a,0,Pierre Villard,2021-01-19 10:40:38+04:00,['097edf4f7c5f9135f0ab9ab1c229bbbb35696b3f'],2,2,4,3861174,2,,,,10866
3e72dfe421fc5166bdc135a23e7ff1520b373697,0,Pierre Villard,2021-01-19 21:21:44+04:00,['40f193098b897869f42360ee35c60487bf0c235a'],2,36,38,3861212,2,1,1,1,10866
f02079c2faa008c9d2a5fc0cebafcb398c22bf0c,1,Matthew Burgess,2021-01-19 13:23:54-05:00,['3e72dfe421fc5166bdc135a23e7ff1520b373697'],372,583,955,3862167,4,0.440860215,0.172043011,0.838709677,10867
b4ddeb8997a3650b4f461cd0444497b4e752ccdc,0,Mark Payne,2021-01-19 16:25:09-05:00,['f02079c2faa008c9d2a5fc0cebafcb398c22bf0c'],19,92,111,3862278,8,0.105263158,0.263157895,0.947368421,10867
930e8d9e0e59ff24f50d7e3a052870b1112f076a,0,Matthew Burgess,2021-01-19 17:20:06-05:00,['b4ddeb8997a3650b4f461cd0444497b4e752ccdc'],62,319,381,3862659,7,0.352941176,0.823529412,1,10869
88de03aebb5f8641324ff7c8a60cb5aed0bcd187,0,Peter Turcsanyi,2021-01-20 00:29:30+01:00,['930e8d9e0e59ff24f50d7e3a052870b1112f076a'],8,60,68,3862727,3,0,0.390243902,1,10869
25ab050ed78cedd11450cdc7e3165a58682fddb2,0,Pierre Villard,2021-01-20 13:04:08+04:00,['88de03aebb5f8641324ff7c8a60cb5aed0bcd187'],1,1,2,3862729,1,,,,10869
803ba882aa15142a9986dc0c23bbf4db11fe15a7,0,Matthew Burgess,2021-01-20 13:48:57-05:00,['25ab050ed78cedd11450cdc7e3165a58682fddb2'],91,115,206,3862935,1,0.315789474,0.315789474,0.578947368,10869
27f57e64635c9478b811886b6a0b207c5972d5ac,0,GitHub,2021-01-20 16:00:41-05:00,['803ba882aa15142a9986dc0c23bbf4db11fe15a7'],8,8,16,3862951,4,,,,10869
fb2a8b5820b816d7afddb5141cd064275267f796,1,Pierre Villard,2021-01-21 11:17:13+04:00,['27f57e64635c9478b811886b6a0b207c5972d5ac'],5,28,33,3862984,2,0.733333333,0.733333333,0.733333333,10869
953327cdf587c6b68765c0d32508873d8a0031e7,0,Pierre Villard,2021-01-21 11:23:14+04:00,['fb2a8b5820b816d7afddb5141cd064275267f796'],1,16,17,3863001,1,0,0,0,10869
93a5823f8ab9b1e6b71fe418e8af3756f4c1c1c2,1,Peter Turcsanyi,2021-01-21 11:16:07+00:00,['953327cdf587c6b68765c0d32508873d8a0031e7'],13,578,591,3863592,4,0,0.550561798,1,10869
525e4105eb2eec6deb45e07c39397d5fb181af16,1,Mark Payne,2021-01-21 10:56:28-05:00,['93a5823f8ab9b1e6b71fe418e8af3756f4c1c1c2'],184,4408,4592,3868184,61,0.35153019,0.623655914,0.971877585,10892
8c49f0688beaa69c50e857665a5d713a07ad0033,0,Pierre Villard,2021-01-21 21:21:47+04:00,['525e4105eb2eec6deb45e07c39397d5fb181af16'],1,1,2,3868186,1,,,,10892
400d180ae71255849d47cd171397feb064dc9fdf,0,Mark Payne,2021-01-21 12:31:39-05:00,['8c49f0688beaa69c50e857665a5d713a07ad0033'],1,24,25,3868211,2,1,1,1,10892
6741317cc45d333cce81c3341bebd9643bde90cd,0,Mark Payne,2021-01-21 12:52:30-05:00,['400d180ae71255849d47cd171397feb064dc9fdf'],6,8,14,3868225,2,,,,10892
76648bdc0b2a077bed6073d30345e9d1af876920,0,Nathan Gough,2021-01-21 13:47:53-05:00,['6741317cc45d333cce81c3341bebd9643bde90cd'],30,1239,1269,3869494,19,0.646959459,1,0.976351351,10901
f2a16cd02e80734f3f5e7c66c8d82211a659e34b,0,Nathan Gough,2021-01-21 15:09:42-05:00,['76648bdc0b2a077bed6073d30345e9d1af876920'],1,1,2,3869496,1,,,,10901
1c361d45ae94f155b6e2def7bd4430b1c9ca8b3b,0,Nathan Gough,2021-01-21 15:29:29-05:00,['f2a16cd02e80734f3f5e7c66c8d82211a659e34b'],169,322,491,3869987,6,,,,10901
0ff43677819f4c556215dd5218577c8b31c0350f,0,Pierre Villard,2021-01-22 09:57:51+04:00,['1c361d45ae94f155b6e2def7bd4430b1c9ca8b3b'],1,1,2,3869989,1,,,,10901
0a10557dd5ee155e0136bedba33ffd64fb40c6d5,0,Mark Payne,2021-01-26 15:20:20-05:00,['0ff43677819f4c556215dd5218577c8b31c0350f'],1,1438,1439,3871428,11,0.706131078,0.706131078,0.976744186,10911
67d06003b7f8a4332e72dd54814cb5fb8bed9989,1,exceptionfactory,2021-01-26 14:39:02-06:00,['0a10557dd5ee155e0136bedba33ffd64fb40c6d5'],59,277,336,3871764,9,0.396396396,0.90990991,0.90990991,10911
2cdb0fb6a39dae3453dc36e810039a25e32d913e,1,Nathan Gough,2021-01-26 16:50:33-05:00,['67d06003b7f8a4332e72dd54814cb5fb8bed9989'],30,10,40,3871804,8,0.454545455,0.454545455,0,10911
abb6ed3128d789316e6741c3bf25ffd9bed8cf77,1,Joe Witt,2021-01-26 21:24:07-07:00,['2cdb0fb6a39dae3453dc36e810039a25e32d913e'],372,455,827,3872631,21,0,0.571428571,0,10912
4ff9cddf159e974c7a5a5c9aa9e238c520d37dc3,1,Joe Witt,2021-01-26 21:55:18-07:00,['abb6ed3128d789316e6741c3bf25ffd9bed8cf77'],60,510,570,3873201,17,0,0.577669903,1,10914
813ac539b3ac7e57edd1f5e3b98b08ebeeefcb96,1,Joe Witt,2021-01-26 22:13:26-07:00,['4ff9cddf159e974c7a5a5c9aa9e238c520d37dc3'],6,128,134,3873335,2,0.175,0.5375,0.85,10914
6a0fb3e09e2d702d05e282acf5bea42ced4f82db,0,Joe Witt,2021-01-26 23:12:10-07:00,['813ac539b3ac7e57edd1f5e3b98b08ebeeefcb96'],24,0,24,3873359,1,,,,10914
d08a0babb7eb8d89f07fa752c099c46da77c1b56,0,Joe Witt,2021-01-27 09:26:41-07:00,['6a0fb3e09e2d702d05e282acf5bea42ced4f82db'],4,4,8,3873367,1,,,,10914
04fb1aca47d3723aad4052d29a7df54c78c972f0,1,Matthew Burgess,2021-01-27 11:50:40-05:00,['d08a0babb7eb8d89f07fa752c099c46da77c1b56'],4,179,183,3873550,6,0.366972477,0.688073394,0.266055046,10914
8c1fe84f62e549b0f87741dc2b83dc7c28aab4e8,1,Joe Witt,2021-01-27 15:04:23-07:00,['04fb1aca47d3723aad4052d29a7df54c78c972f0'],8,30,38,3873588,2,1,1,1,10914
11e9ff377333784974fa55f41483c4281d80da50,1,Joe Witt,2021-01-27 17:48:06-07:00,['8c1fe84f62e549b0f87741dc2b83dc7c28aab4e8'],1578,502,2080,3875668,18,1,0.023668639,0.053254438,10915
5e84cf6ff96d96b75c505d0fa2614d773ea2286f,0,exceptionfactory,2021-01-29 15:16:19-06:00,['11e9ff377333784974fa55f41483c4281d80da50'],1,1136,1137,3876805,9,0.110465116,0.372093023,0.531007752,10922
d72bfc76b58e035d5a10caa3a06efbcd7daab776,0,Matthew Burgess,2021-01-29 19:20:34-05:00,['5e84cf6ff96d96b75c505d0fa2614d773ea2286f'],2,5,7,3876812,1,1,0,1,10922
29a1d6badc08e648a50d8077905dacbf65345952,1,markap14,2021-02-01 12:10:19-05:00,['d72bfc76b58e035d5a10caa3a06efbcd7daab776'],61,90,151,3876963,6,0,0,0.35483871,10922
b4e213cb2c80f50592564b27d952dbb672966f9b,0,GitHub,2021-02-01 13:21:46-05:00,['29a1d6badc08e648a50d8077905dacbf65345952'],0,7,7,3876970,1,,,,10922
e0a8b479fd01d6d5dcac3df8aa32daaff67eb0c4,0,markap14,2021-02-01 15:47:52-05:00,['b4e213cb2c80f50592564b27d952dbb672966f9b'],2,8,10,3876980,1,0,1,1,10922
5fea9179c474e775ae94c27e99b179941827afa9,0,exceptionfactory,2021-02-01 15:12:13-06:00,['e0a8b479fd01d6d5dcac3df8aa32daaff67eb0c4'],0,38,38,3877018,2,0.636363636,1,0.636363636,10922
0a829469463fb1a0931d9f77e086f005ca17705d,0,Joe Witt,2021-02-01 15:11:59-07:00,['5fea9179c474e775ae94c27e99b179941827afa9'],261,0,261,3877279,4,,,,10922
434c995185785eae4036b95e0c705e1d0018c774,0,Joe Witt,2021-02-01 15:13:19-07:00,['0a829469463fb1a0931d9f77e086f005ca17705d'],10,4,14,3877293,2,,,,10922
77eb8af275fc76fdbdc7e657bc821fc19bac3f0a,1,Matthew Burgess,2021-02-02 19:02:02-05:00,['434c995185785eae4036b95e0c705e1d0018c774'],131,100,231,3877524,4,1,0,0,10922
d8264162171d917a9cee970715df0990ac187d01,0,Pierre Villard,2021-02-03 12:56:28+04:00,['77eb8af275fc76fdbdc7e657bc821fc19bac3f0a'],73,74,147,3877671,73,,,,10922
5a8b18b12d8b50f145ae5e21bded9bd5d9d918ad,1,Mark Payne,2021-02-03 09:40:09-05:00,['d8264162171d917a9cee970715df0990ac187d01'],38,148,186,3877857,7,0,0.96875,0.90625,10922
6e1f737c53523843b7a3222d0c6dbc2d84e4aa09,1,exceptionfactory,2021-02-03 08:53:47-06:00,['5a8b18b12d8b50f145ae5e21bded9bd5d9d918ad'],177,563,740,3878597,8,0.362385321,0.52293578,0.839449541,10922
c1f88ec740acf57847db84ea23939a054e325bd5,0,Mark Payne,2021-02-03 13:09:00-05:00,['6e1f737c53523843b7a3222d0c6dbc2d84e4aa09'],28,85,113,3878710,2,0.358974359,0.974358974,0.666666667,10922
b55998afc18e6765204bac5493f29c47c9f66f9a,1,Peter Turcsanyi,2021-02-04 17:04:37+01:00,['c1f88ec740acf57847db84ea23939a054e325bd5'],9,252,261,3878971,7,0.057142857,0.457142857,0.971428571,10922
3f26e54521b02896a7b3ba9752e5218ee91a9f01,0,markap14,2021-02-05 13:20:37-05:00,['b55998afc18e6765204bac5493f29c47c9f66f9a'],5,5,10,3878981,2,,,,10922
07dfdff3895a8d86429799ed426646fe587eb196,0,Pierre Villard,2021-02-05 23:46:54+04:00,['3f26e54521b02896a7b3ba9752e5218ee91a9f01'],3,3,6,3878987,1,,,,10922
a9b8635ac9a188ed454b21a9fe6957a9da22243e,0,Pierre Villard,2021-02-05 23:53:29+04:00,['07dfdff3895a8d86429799ed426646fe587eb196'],1,1,2,3878989,1,,,,10922
b77dbd503099addb760e2d1f4b1249a90839cd97,0,Pierre Villard,2021-02-06 00:00:58+04:00,['a9b8635ac9a188ed454b21a9fe6957a9da22243e'],45,171,216,3879205,2,0,0,0,10922
03fd59eb2fa21fdd693a37da0f7fd402bbc74933,1,Bryan Bende,2021-02-05 15:18:07-05:00,['b77dbd503099addb760e2d1f4b1249a90839cd97'],60,201,261,3879466,14,0.453333333,0,0.973333333,10922
749d05840ba88efc8b42f5434d9223104edfab68,0,Bryan Bende,2021-02-05 15:18:44-05:00,['03fd59eb2fa21fdd693a37da0f7fd402bbc74933'],162,389,551,3880017,27,0.779816514,0.944954128,0.899082569,10924
40d8c41656b1a734c182769d1cede533e4456a0e,0,Matthew Burgess,2021-02-05 16:17:10-05:00,['749d05840ba88efc8b42f5434d9223104edfab68'],39,103,142,3880159,3,0.304347826,0.543478261,1,10924
4ebeb4e146390816cb5a0316a3a83e56e0d85f16,1,exceptionfactory,2021-02-08 14:53:35-06:00,['40d8c41656b1a734c182769d1cede533e4456a0e'],4,22,26,3880185,2,0,0,1,10924
13d6da73ac273662b8871b6b75446a04c01d1f86,1,Pierre Villard,2021-02-09 21:22:59+04:00,['4ebeb4e146390816cb5a0316a3a83e56e0d85f16'],1,1,2,3880187,1,,,,10924
b9b131239cba705b2838c0eef5e3c1c1aaaed19a,0,Joey Frazee,2021-02-09 11:10:15-08:00,['13d6da73ac273662b8871b6b75446a04c01d1f86'],17,14,31,3880218,1,,,,10924
d5d520764d3f1864f501d560ba8e724d61f6d7b1,0,Matthew Burgess,2021-02-09 15:32:15-05:00,['b9b131239cba705b2838c0eef5e3c1c1aaaed19a'],18,110,128,3880346,3,0.075757576,0.424242424,1,10924
1d82fb8e01f3e8d3b25fcd773eaa7add03aad363,1,Joe Witt,2021-02-10 13:34:57-07:00,['d5d520764d3f1864f501d560ba8e724d61f6d7b1'],187,696,883,3881229,10,1,1,0.98974359,10929
8057f8f6c50928fbba1992743d0b2dfee49503c2,0,exceptionfactory,2021-02-10 14:46:37-06:00,['1d82fb8e01f3e8d3b25fcd773eaa7add03aad363'],2,13,15,3881244,3,,,,10929
d08f02428d6313b4acbe4b1b43b238a74addec0c,1,Joe Witt,2021-02-10 18:01:43-07:00,['8057f8f6c50928fbba1992743d0b2dfee49503c2'],5,178,183,3881427,3,0.057692308,0.057692308,0.75,10929
a1c82a66a1705c12c7917b232a7f85dc93981143,0,exceptionfactory,2021-02-15 10:42:19-06:00,['d08f02428d6313b4acbe4b1b43b238a74addec0c'],2,2,4,3881431,1,,,,10929
487280bee993ae07aa66a043999664e650af9b64,0,Joe Witt,2021-02-15 12:09:30-07:00,['a1c82a66a1705c12c7917b232a7f85dc93981143'],1842,1833,3675,3885106,506,,,,10929
4afb2ba743d1c84875db9f09d5c2cc04af32055d,0,Joe Witt,2021-02-15 12:09:31-07:00,['487280bee993ae07aa66a043999664e650af9b64'],1823,1823,3646,3888752,506,,,,10929
88fab00e299b3ff161e5a40a4326f93c054b2bf9,1,Joe Witt,2021-02-15 12:09:32-07:00,['4afb2ba743d1c84875db9f09d5c2cc04af32055d'],1822,1822,3644,3892396,506,,,,10929
a69313e34cd2f40e0ef88d53cdf410451f221dc1,0,Joe Witt,2021-02-15 12:12:51-07:00,['88fab00e299b3ff161e5a40a4326f93c054b2bf9'],2,2,4,3892400,2,,,,10929
fd50d6f0429ebbd676da745ba2bd7def81ad66e6,1,Joey Frazee,2021-02-16 17:25:28-06:00,['a69313e34cd2f40e0ef88d53cdf410451f221dc1'],3,13,16,3892416,1,0.6,0.6,1,10929
042b34cb435c6a54ed94b8149e1d4b4dfbec4ce1,0,markap14,2021-02-18 09:58:48-05:00,['fd50d6f0429ebbd676da745ba2bd7def81ad66e6'],2,5,7,3892423,1,,,,10929
68017048465fbf9ba12cc5ccbdb6c0717502f3c6,0,markap14,2021-02-18 13:12:09-05:00,['042b34cb435c6a54ed94b8149e1d4b4dfbec4ce1'],2,1,3,3892426,1,,,,10929
aa726040c567818cef097fe10905badc82996bb2,1,Mark Payne,2021-02-18 14:51:28-05:00,['68017048465fbf9ba12cc5ccbdb6c0717502f3c6'],103,452,555,3892981,26,0.455223881,0.947761194,0.641791045,10931
f532b3ae1df8c131c77cfc4b7d56cdc66747f56d,0,Pierre Villard,2021-02-19 14:42:16+04:00,['aa726040c567818cef097fe10905badc82996bb2'],465,270,735,3893716,17,0.641025641,0,0,10932
cd6418cdafd804fbaef74822659969458be10700,0,Pierre Villard,2021-02-19 14:44:42+04:00,['f532b3ae1df8c131c77cfc4b7d56cdc66747f56d'],0,2,2,3893718,1,0,1,1,10932
662a35b7de8de06ad0da06eaa8e0804e8ba9d9e8,0,Pierre Villard,2021-02-19 20:42:30+04:00,['cd6418cdafd804fbaef74822659969458be10700'],9,5,14,3893732,3,,,,10932
59ad21fbaa3399b3bb6c46a7ad4a3ff8384b0c43,0,Joey Frazee,2021-02-21 13:35:28-08:00,['662a35b7de8de06ad0da06eaa8e0804e8ba9d9e8'],1,86,87,3893819,3,0.823529412,0.823529412,1,10933
51e7bdf94088215a89845f9fdc22d15597445a2c,0,Pierre Villard,2021-02-22 11:29:59+04:00,['59ad21fbaa3399b3bb6c46a7ad4a3ff8384b0c43'],45,313,358,3894177,6,0.538461538,0.846153846,0.892307692,10935
6ed496c714712b979d12f1eeba7da946e086c925,0,Pierre Villard,2021-02-22 12:48:42+04:00,['51e7bdf94088215a89845f9fdc22d15597445a2c'],2,4,6,3894183,1,,,,10935
b08d6071dda9102dc928d64848fdee76cf1c384c,0,Pierre Villard,2021-02-22 12:55:53+04:00,['6ed496c714712b979d12f1eeba7da946e086c925'],1,205,206,3894389,6,0.333333333,1,0.681818182,10937
80da0cf47d4619d89620aea0ab8be762f1dde384,0,Pierre Villard,2021-02-22 12:59:03+04:00,['b08d6071dda9102dc928d64848fdee76cf1c384c'],6,11,17,3894406,2,0,1,1,10937
703c3cfe63580eef3ef065487afc2cfb19090922,0,Pierre Villard,2021-02-22 13:04:03+04:00,['80da0cf47d4619d89620aea0ab8be762f1dde384'],2,0,2,3894408,1,,,,10937
ebef823cb93539fede8c1fc10347253d33fdb9af,0,Joe Witt,2021-02-22 08:53:32-07:00,['703c3cfe63580eef3ef065487afc2cfb19090922'],0,8,8,3894416,1,1,1,1,10937
418e2cc2cba69afb522a61bfeaf61ae213d101ed,0,Nathan Gough,2021-02-22 17:52:24-05:00,['ebef823cb93539fede8c1fc10347253d33fdb9af'],136,208,344,3894760,12,1,0,0,10939
3cb26aec728b578a9ccf397a338b4c7fcc334d89,0,Pierre Villard,2021-02-23 09:50:18+04:00,['418e2cc2cba69afb522a61bfeaf61ae213d101ed'],57,201,258,3895018,7,0,0.84,1,10939
9101160cbfbc8bf39c2d781522ee6919fbd0c7ec,1,Joe Witt,2021-02-23 08:05:32-07:00,['3cb26aec728b578a9ccf397a338b4c7fcc334d89'],0,2,2,3895020,2,0,0.5,1,10939
200c04c6d04ef56b45e8d85621e834c67f22cea4,1,Joe Witt,2021-02-23 08:08:09-07:00,['9101160cbfbc8bf39c2d781522ee6919fbd0c7ec'],6,56,62,3895082,3,0,0,0.666666667,10939
528fce2407d092d4ced1a58fcc14d0bc6e660b89,1,Matthew Burgess,2021-02-23 10:57:54-05:00,['200c04c6d04ef56b45e8d85621e834c67f22cea4'],461,344,805,3895887,23,0.969230769,1,0.107692308,10939
d049bca7948227cdddcd59a50c2daf104e2883f8,0,Pierre Villard,2021-02-23 21:22:19+04:00,['528fce2407d092d4ced1a58fcc14d0bc6e660b89'],22,127,149,3896036,2,,,,10939
f2555f27f18bceab7ca1b35905721ff668e8e4f5,0,Matthew Burgess,2021-02-23 16:47:32-05:00,['d049bca7948227cdddcd59a50c2daf104e2883f8'],6,7,13,3896049,1,0,0,0,10939
f101a2bba51d518f7eb1fb929c18999ec6334a9a,0,Pierre Villard,2021-02-24 12:04:52+04:00,['f2555f27f18bceab7ca1b35905721ff668e8e4f5'],2,31,33,3896082,3,0.55,1,0.55,10939
2dedd8bf0fd3251acd1fdd2e269c7fd79b6bc349,0,Pierre Villard,2021-02-24 15:57:16+04:00,['f101a2bba51d518f7eb1fb929c18999ec6334a9a'],1,16,17,3896099,3,0,0.833333333,1,10939
2322b2cddf8eac123e2ecb1bf48c7daaca932565,1,Peter Turcsanyi,2021-02-24 13:15:12+01:00,['2dedd8bf0fd3251acd1fdd2e269c7fd79b6bc349'],207,217,424,3896523,1,1,1,1,10939
34fc94454feab76cf048a4dc030d97b0d8781216,1,markap14,2021-02-24 10:10:32-05:00,['2322b2cddf8eac123e2ecb1bf48c7daaca932565'],1,45,46,3896569,2,0,0.966666667,1,10939
93b1a05dc3e98e2271ddc65af4b7ea969abd1462,0,Pierre Villard,2021-02-25 18:37:19+04:00,['34fc94454feab76cf048a4dc030d97b0d8781216'],21,255,276,3896845,9,0.731182796,1,0.516129032,10942
29cc3886fcdb5322162a12c531468a9415fee9ed,1,markap14,2021-02-25 12:45:12-05:00,['93b1a05dc3e98e2271ddc65af4b7ea969abd1462'],1,44,45,3896890,3,0,0.40625,1,10942
68d38dd0a688c855b9d67d2a60bb02712879fb9a,1,Matthew Burgess,2021-02-25 12:58:05-05:00,['29cc3886fcdb5322162a12c531468a9415fee9ed'],14,5081,5095,3901985,50,0.482479784,0.948113208,0.82884097,10986
82eedea659a08581f21d31c6dc4516d615b25e37,0,Pierre Villard,2021-02-25 22:21:03+04:00,['68d38dd0a688c855b9d67d2a60bb02712879fb9a'],4,33,37,3902022,1,0.583333333,0.583333333,1,10986
7730777d6632590b5433442bcf90b495a1da97ee,1,Mark Payne,2021-02-25 15:59:01-05:00,['82eedea659a08581f21d31c6dc4516d615b25e37'],548,3956,4504,3906526,64,0.68209607,0.986899563,0.897816594,11025
99fe548e6bacb1c9ecc4a4a043197ae49962c177,0,Mark Payne,2021-02-25 16:08:07-05:00,['7730777d6632590b5433442bcf90b495a1da97ee'],10,13,23,3906549,1,,,,11025
5608f4389aa5509f5c19bbcba207dfc37b5674cc,1,Nathan Gough,2021-02-25 17:00:32-05:00,['99fe548e6bacb1c9ecc4a4a043197ae49962c177'],1917,1570,3487,3910036,68,1,1,1,11038
a54f73922984a859c162f1ec303ce71e7634a3ee,0,Peter Turcsanyi,2021-03-01 16:04:11+01:00,['5608f4389aa5509f5c19bbcba207dfc37b5674cc'],4,211,215,3910251,2,0,0.5,1,11039
4a27b23b1f5b5abd159ee541b5d912c548dafd58,0,Pierre Villard,2021-03-01 20:14:34+04:00,['a54f73922984a859c162f1ec303ce71e7634a3ee'],1,85,86,3910337,2,0.95,0.975,1,11039
bbd37b8db79709208d38a4a869883585502bf460,0,Matthew Burgess,2021-03-01 15:18:42-05:00,['4a27b23b1f5b5abd159ee541b5d912c548dafd58'],12,60,72,3910409,7,,,,11039
ea8727a278c5375f53f285bd589d4832746f2ef8,0,Matthew Burgess,2021-03-01 16:34:24-05:00,['bbd37b8db79709208d38a4a869883585502bf460'],0,33,33,3910442,2,0,0.869565217,0.869565217,11039
7876f412fbf1785322c06f6bac32804f28d66512,0,exceptionfactory,2021-03-01 22:34:59-06:00,['ea8727a278c5375f53f285bd589d4832746f2ef8'],71,407,478,3910920,4,0.648241206,0.748743719,0.934673367,11039
0d473bacf66898bc9269784249c31c787c997233,0,Pierre Villard,2021-03-02 12:41:50+04:00,['7876f412fbf1785322c06f6bac32804f28d66512'],4,8,12,3910932,1,0,0,1,11039
91fed2a99328894a3b1b8fa8ce9dbb470d92cec7,0,Mark Payne,2021-03-02 09:17:44-05:00,['0d473bacf66898bc9269784249c31c787c997233'],2,2,4,3910936,1,,,,11039
481046f5be89831517952d1d930a189a8425cfe4,0,exceptionfactory,2021-03-02 12:33:18-06:00,['91fed2a99328894a3b1b8fa8ce9dbb470d92cec7'],0,30,30,3910966,2,0,0,1,11039
c5abf2ba5443cf952eccb0e00d0858de49511f4f,1,exceptionfactory,2021-03-02 21:38:30-06:00,['481046f5be89831517952d1d930a189a8425cfe4'],158,416,574,3911540,15,0.609195402,0.977011494,0.75862069,11044
b9a0991157ec8bb6b1d5f8d9c8335b5a1a481a72,0,Pierre Villard,2021-03-03 14:38:45+04:00,['c5abf2ba5443cf952eccb0e00d0858de49511f4f'],108,838,946,3912486,7,0.269230769,0.429487179,0.432692308,11045
e2e137fced39f184e5998f7c4befe03e70f53016,0,Pierre Villard,2021-03-03 21:26:18+04:00,['b9a0991157ec8bb6b1d5f8d9c8335b5a1a481a72'],14,3,17,3912503,2,0,0,0,11045
ff93ec42c3730f1ba8acc4843e8504f2ff47a5cf,0,Mike Thomsen,2021-03-04 19:55:44-05:00,['e2e137fced39f184e5998f7c4befe03e70f53016'],6,0,6,3912509,1,,,,11045
29ebec071edc0a7384f84098e7128f7e1179aa6c,0,Pierre Villard,2021-03-07 18:51:07+04:00,['ff93ec42c3730f1ba8acc4843e8504f2ff47a5cf'],2,45,47,3912556,2,0,0.903225806,0.903225806,11045
9266212117cfcb337bc51b8db3f97c6c54f86857,0,GitHub,2021-03-08 09:08:34-05:00,['29ebec071edc0a7384f84098e7128f7e1179aa6c'],1,0,1,3912557,1,,,,11045
f2a03fca2a05fc20eafe826804724a4e6d9d67e8,0,GitHub,2021-03-08 09:10:12-05:00,['9266212117cfcb337bc51b8db3f97c6c54f86857'],1,15,16,3912573,1,0,0,1,11045
c5b5be89a2991ae83d380fe2ea141ae306611486,0,GitHub,2021-03-08 09:12:37-05:00,['f2a03fca2a05fc20eafe826804724a4e6d9d67e8'],3,3,6,3912579,1,,,,11045
0965523bab370ae3f91c4ea94e7cf750b4601249,0,Mark Payne,2021-03-08 11:30:13-05:00,['c5b5be89a2991ae83d380fe2ea141ae306611486'],46,44,90,3912669,4,1,1,1,11045
b523698534679938865a3ac401d901e8db411225,1,exceptionfactory,2021-03-08 12:21:19-06:00,['0965523bab370ae3f91c4ea94e7cf750b4601249'],340,892,1232,3913901,37,0.414847162,0.716157205,0.80349345,11049
98ab42aebc11a56da79c2aac849d5463dadb4ef4,0,Nathan Gough,2021-03-08 22:16:21-05:00,['b523698534679938865a3ac401d901e8db411225'],55,28,83,3913984,2,0,0,0,11049
dc94ef568a1da1617ddb3cb18b82d3913219a6b4,0,Pierre Villard,2021-03-09 11:44:51+04:00,['98ab42aebc11a56da79c2aac849d5463dadb4ef4'],1,1,2,3913986,1,,,,11049
8c0f0a40ccffcacf50c291f057f00903e21f574d,0,Pierre Villard,2021-03-09 11:48:44+04:00,['dc94ef568a1da1617ddb3cb18b82d3913219a6b4'],2,2,4,3913990,2,,,,11049
79121a142ee2c0cf70ec3cd5dab180a23661602a,0,Pierre Villard,2021-03-09 11:51:52+04:00,['8c0f0a40ccffcacf50c291f057f00903e21f574d'],1,1,2,3913992,1,,,,11049
f09f2a6c85fd1c69808353eeea97f956d9e9271d,0,exceptionfactory,2021-03-09 11:43:07-06:00,['79121a142ee2c0cf70ec3cd5dab180a23661602a'],2,2,4,3913996,1,,,,11049
97536e9070bed72d10a4889195801d73454ca135,0,Joe Witt,2021-03-09 14:39:46-07:00,['f09f2a6c85fd1c69808353eeea97f956d9e9271d'],0,46,46,3914042,3,,,,11049
160297f6ba47590afd68f54c8f352fe48fe56c10,0,Joey Frazee,2021-03-10 01:11:41+00:00,['97536e9070bed72d10a4889195801d73454ca135'],9,33,42,3914084,4,,,,11049
a9b435e8d393611455ad1b7d6b835998f7d73ba3,1,Pierre Villard,2021-03-10 20:13:42+04:00,['160297f6ba47590afd68f54c8f352fe48fe56c10'],6,18,24,3914108,3,0.428571429,0.857142857,0.857142857,11049
97b2e691017063c8eebc5721255d77be87386a5b,0,markap14,2021-03-10 17:18:04-05:00,['a9b435e8d393611455ad1b7d6b835998f7d73ba3'],2,1,3,3914111,2,,,,11049
9f0b47af7724af2e3d7e11b1226e5419cdf3a8bb,0,Pierre Villard,2021-03-12 12:11:09+04:00,['97b2e691017063c8eebc5721255d77be87386a5b'],25,746,771,3914882,4,0.232919255,0.770186335,1,11051
09692c5f695e20ddc374182b7b2f4a42fbf4c040,1,Pierre Villard,2021-03-12 12:21:07+04:00,['9f0b47af7724af2e3d7e11b1226e5419cdf3a8bb'],2,2,4,3914886,2,,,,11051
931f8fe798bd66473f5e394c0ad0d9fc8d9a4b07,0,Pierre Villard,2021-03-12 12:24:06+04:00,['09692c5f695e20ddc374182b7b2f4a42fbf4c040'],9,10,19,3914905,1,,,,11051
b039606cf84e0a9f6c934b3d7a1ce02fb0b47642,0,Pierre Villard,2021-03-12 19:40:19+04:00,['931f8fe798bd66473f5e394c0ad0d9fc8d9a4b07'],0,24,24,3914929,2,1,1,1,11051
57cca88eea545560c4e0a8f1958f552d55ef4d67,0,Joey Frazee,2021-03-12 09:10:02-08:00,['b039606cf84e0a9f6c934b3d7a1ce02fb0b47642'],82,181,263,3915192,2,1,1,0.894736842,11051
b1f513a2caeb043abc8ff77d2230bad87fd8a2de,1,Pierre Villard,2021-03-15 21:28:40+04:00,['57cca88eea545560c4e0a8f1958f552d55ef4d67'],3212,1090,4302,3919494,10,1,0.113275613,0.24025974,11052
f00f0ad269c2fab8ce7b88fb6226fdf88ffce33a,0,markap14,2021-03-16 14:36:51-04:00,['b1f513a2caeb043abc8ff77d2230bad87fd8a2de'],0,110,110,3919604,5,0.465116279,0.953488372,0.976744186,11053
2ad88bbffff3c90bca7404d10ebc40953c1b3c63,1,Joe Witt,2021-03-16 15:30:11-07:00,['f00f0ad269c2fab8ce7b88fb6226fdf88ffce33a'],835,483,1318,3920922,9,0.956756757,0.589189189,0.718918919,11053
be7233d252e4b06a6787940cc0983fec4e0a77b1,0,Pierre Villard,2021-03-17 11:41:21+04:00,['2ad88bbffff3c90bca7404d10ebc40953c1b3c63'],19,30,49,3920971,1,0.6,1,1,11053
f9e469ffa21093e6f109f309b0aa8846c642c785,0,exceptionfactory,2021-03-17 08:10:40-05:00,['be7233d252e4b06a6787940cc0983fec4e0a77b1'],3,3,6,3920977,1,,,,11053
04cd4186189c6b4e458b38f5d96459945c9c0dfe,0,exceptionfactory,2021-03-17 13:53:47-05:00,['f9e469ffa21093e6f109f309b0aa8846c642c785'],72,178,250,3921227,3,0.928571429,1,0.742857143,11053
e16cc9df46bf46d461b605d3ca5ff29b18fe6a78,0,Pierre Villard,2021-03-17 22:58:25+04:00,['04cd4186189c6b4e458b38f5d96459945c9c0dfe'],4,75,79,3921306,3,0.418604651,1,1,11053
cf4e966d912975dfeac1cbf80f9e073536405897,0,Joe Witt,2021-03-17 14:12:35-07:00,['e16cc9df46bf46d461b605d3ca5ff29b18fe6a78'],5,407,412,3921718,8,0.35828877,1,0.930481283,11056
8202bffc9835f9c989e4fd3977a98d46a2df77e7,0,Joe Witt,2021-03-17 14:15:25-07:00,['cf4e966d912975dfeac1cbf80f9e073536405897'],138,139,277,3921995,5,1,0,0.476190476,11056
a7ba5bb4f8cb4af9bf9e0db176202365570b7e28,0,Pierre Villard,2021-03-18 01:40:18+04:00,['8202bffc9835f9c989e4fd3977a98d46a2df77e7'],128,113,241,3922236,9,0,0,0,11056
105a76b7b7d665335d53111817867e9ab53b957c,0,Pierre Villard,2021-03-18 02:40:39+04:00,['a7ba5bb4f8cb4af9bf9e0db176202365570b7e28'],7,16,23,3922259,2,0.5,1,0,11056
61c4261bb748c099593197975e877fef55c0a889,0,Joey Frazee,2021-03-18 12:52:33-07:00,['105a76b7b7d665335d53111817867e9ab53b957c'],933,1,934,3923193,11,0.530674847,0.23006135,0.088957055,11056
446401b6f153df9260349050ae228fda5ca98525,0,exceptionfactory,2021-03-19 09:26:00-05:00,['61c4261bb748c099593197975e877fef55c0a889'],50,79,129,3923322,4,0,1,1,11056
fedeafb43fe150db4e00c426bb13777aa8ae8a70,0,Mark Payne,2021-03-19 10:48:29-04:00,['446401b6f153df9260349050ae228fda5ca98525'],0,7,7,3923329,1,0,0,1,11056
4d68509212335d2c4fa28910ffab891d595be9af,0,Peter Turcsanyi,2021-03-19 17:55:11+01:00,['fedeafb43fe150db4e00c426bb13777aa8ae8a70'],2,0,2,3923331,1,1,0,0,11056
0e659981d4f9bcf8e188599bf39f98dfe2156768,1,Nathan Gough,2021-03-19 13:12:19-04:00,['4d68509212335d2c4fa28910ffab891d595be9af'],74,168,242,3923573,44,1,1,1,11058
07a4966d10c884e2d7c194af7ab5afb495ab58ea,1,exceptionfactory,2021-03-19 14:46:33-05:00,['0e659981d4f9bcf8e188599bf39f98dfe2156768'],67,63,130,3923703,50,,,,11058
3508b5b12f0c29c74d6902c1d6f851f990a21498,1,Joey Frazee,2021-03-19 15:30:23-07:00,['07a4966d10c884e2d7c194af7ab5afb495ab58ea'],0,4,4,3923707,2,,,,11058
e1b9548ab68ece3a9904f50cd42898e0d41ce166,1,Tamas Palfy,2021-03-22 18:22:00+01:00,['3508b5b12f0c29c74d6902c1d6f851f990a21498'],11,130,141,3923848,2,0.013888889,0.666666667,0.666666667,11058
4189a1c1eb4625b5db4dd670688eae61eb9223fd,1,Joe Witt,2021-03-23 07:09:59-07:00,['e1b9548ab68ece3a9904f50cd42898e0d41ce166'],4,4,8,3923856,1,,,,11058
e505e8b42df77034629bb88eebc8e5f7c87fd82d,0,Joe Witt,2021-03-23 07:15:48-07:00,['4189a1c1eb4625b5db4dd670688eae61eb9223fd'],40,35,75,3923931,2,0.166666667,0.166666667,0,11058
321e979673139310b7f92dfccd926092a2b6c1c9,1,GitHub,2021-03-23 14:17:54-04:00,['e505e8b42df77034629bb88eebc8e5f7c87fd82d'],156,203,359,3924290,12,0.340909091,0,0.068181818,11059
22fcb594d9c5c08120072e5e600a2fb306f665bf,0,Joey Frazee,2021-03-23 11:28:04-07:00,['321e979673139310b7f92dfccd926092a2b6c1c9'],3,69,72,3924362,3,1,1,0.869565217,11060
788abe9eb3d447ff803eadec280996925105d4bb,0,markap14,2021-03-23 17:18:54-04:00,['22fcb594d9c5c08120072e5e600a2fb306f665bf'],29,0,29,3924391,1,1,0,0,11060
7fe8858d22f580ad9dcd96ebafb59dbe5e73f5cb,0,Joe Witt,2021-03-23 14:30:28-07:00,['788abe9eb3d447ff803eadec280996925105d4bb'],1,0,1,3924392,1,,,,11060
1719e3616591e96a39662d3a3684f27ef2505322,0,markap14,2021-03-24 09:18:31-04:00,['7fe8858d22f580ad9dcd96ebafb59dbe5e73f5cb'],17,1,18,3924410,9,,,,11060
057b4af48249b8c22f4f914aac4c7ac4c3f5693c,1,Pierre Villard,2021-03-24 14:23:41+01:00,['1719e3616591e96a39662d3a3684f27ef2505322'],13,31,44,3924454,1,0,0,1,11060
2f08d1f466b9f6f0b0b8a7b5893341a0d1433a4e,0,Peter Turcsanyi,2021-03-24 14:58:51+01:00,['057b4af48249b8c22f4f914aac4c7ac4c3f5693c'],39,175,214,3924668,3,0.541666667,0.958333333,1,11060
74ea3840ac98c8deff1ab83f673cc8fcb7072bcd,0,Peter Turcsanyi,2021-03-24 14:59:13+01:00,['2f08d1f466b9f6f0b0b8a7b5893341a0d1433a4e'],38,175,213,3924881,3,0.541666667,0.958333333,1,11060
91313a2e75b264601984c9c3ead68f9b75e3e478,0,Pierre Villard,2021-03-24 15:30:22+01:00,['74ea3840ac98c8deff1ab83f673cc8fcb7072bcd'],2,2,4,3924885,1,,,,11060
4473d23ccdd3bda782b20be84b48a19ebecc5564,1,exceptionfactory,2021-03-24 10:29:59-05:00,['91313a2e75b264601984c9c3ead68f9b75e3e478'],4,167,171,3925056,2,0.423076923,1,0.871794872,11061
0f28702b475e5cf00ccb5b7e01b68119e645ad7d,0,GitHub,2021-03-24 12:26:56-04:00,['4473d23ccdd3bda782b20be84b48a19ebecc5564'],0,7,7,3925063,1,0,0,1,11061
9df717f69b1c3ae509cec0e4552a0c7efba13478,0,Pierre Villard,2021-03-25 13:00:04+01:00,['0f28702b475e5cf00ccb5b7e01b68119e645ad7d'],2,37,39,3925102,1,0.733333333,0.733333333,0.066666667,11061
36e01876489dd3832ffdb49758f6b1541bed4cfc,0,Peter Turcsanyi,2021-03-25 15:51:22+01:00,['9df717f69b1c3ae509cec0e4552a0c7efba13478'],29,92,121,3925223,2,0,1,1,11061
54d2222fb0054c263049ff83653d4ba2d29e439f,0,Joe Witt,2021-03-25 09:33:19-07:00,['36e01876489dd3832ffdb49758f6b1541bed4cfc'],361,234,595,3925818,2,1,0.7,0,11061
66e2741871e4de25631ffe32b961a622ca5e3ceb,0,Joe Witt,2021-03-25 09:59:59-07:00,['54d2222fb0054c263049ff83653d4ba2d29e439f'],103,38,141,3925959,5,0.536585366,0,0.268292683,11061
1cd3fbb4eb6f1a531ca9259af9b24e2cc6ca25c7,0,Nathan Gough,2021-03-25 15:38:24-04:00,['66e2741871e4de25631ffe32b961a622ca5e3ceb'],357,93,450,3926409,23,0,0,0,11061
bff3e94c01bc7afbed46fce892a2ab8d14130205,0,exceptionfactory,2021-03-25 15:40:35-05:00,['1cd3fbb4eb6f1a531ca9259af9b24e2cc6ca25c7'],0,51,51,3926460,3,0,0,1,11062
a5dbf561143fccffc408bd379de1ec590f1d399d,1,exceptionfactory,2021-03-29 10:53:46-05:00,['bff3e94c01bc7afbed46fce892a2ab8d14130205'],54,86,140,3926600,4,0.608695652,0.739130435,0.869565217,11062
02ea103c6ba22c1085e43a14c2939da9702ca7c8,0,Joe Witt,2021-03-30 07:24:35-07:00,['a5dbf561143fccffc408bd379de1ec590f1d399d'],532,81,613,3927213,1,0.842307692,0,0,11062
ee1386db0229ebf84ead0001607ed03a4cd0fc53,0,Matthew Burgess,2021-03-30 11:06:52-04:00,['02ea103c6ba22c1085e43a14c2939da9702ca7c8'],2,4,6,3927219,1,1,1,1,11062
89dda0b6a437f741ca011eb186decc35d92d9428,0,Joe Witt,2021-03-30 16:05:04-07:00,['ee1386db0229ebf84ead0001607ed03a4cd0fc53'],9,12,21,3927240,1,,,,11062
2edf5514b72691fb77a3fe391a48808155d3b29b,1,Tamas Palfy,2021-03-31 13:40:08+02:00,['89dda0b6a437f741ca011eb186decc35d92d9428'],103,178,281,3927521,2,0.088888889,0.133333333,0.133333333,11062
7db1b8d564c1bbfa252d7f33dc809f8ed4accb40,0,Matt Gilman,2021-04-01 14:11:32-04:00,['2edf5514b72691fb77a3fe391a48808155d3b29b'],15,88,103,3927624,8,0,0,0.7,11062
87b561f026366096dee6dc3f15715e11d9e56e6c,0,GitHub,2021-04-02 09:59:34-04:00,['7db1b8d564c1bbfa252d7f33dc809f8ed4accb40'],423,423,846,3928470,6,1,1,1,11062
f21c1be60f01049f4ea40ff2e5b77445370d8f57,0,Mike Thomsen,2021-04-02 14:22:07-04:00,['87b561f026366096dee6dc3f15715e11d9e56e6c'],88,93,181,3928651,40,,,,11062
64b12176b2abdf548da3b0987eb1b5b70cb989d4,0,Pierre Villard,2021-04-05 11:46:32+02:00,['f21c1be60f01049f4ea40ff2e5b77445370d8f57'],52,24,76,3928727,5,1,0,0,11062
fa3da2aa1ce602b2806d841cf28398afdd2d5e53,0,Pierre Villard,2021-04-06 11:10:01+02:00,['64b12176b2abdf548da3b0987eb1b5b70cb989d4'],9,15,24,3928751,3,0,0,0,11062
ef60e7e404e111852b0fa7f4059ef6aea421f7f8,0,Nathan Gough,2021-04-06 19:48:05-04:00,['fa3da2aa1ce602b2806d841cf28398afdd2d5e53'],174,124,298,3929049,3,1,1,1,11063
4b852ba7c89097da25bcf9160631eca6e9d9ac28,0,Pierre Villard,2021-04-07 08:57:29+02:00,['ef60e7e404e111852b0fa7f4059ef6aea421f7f8'],42,109,151,3929200,2,1,1,0,11063
f4ad658faee24b48a266e9efc53d2b275a473cdd,0,Peter Turcsanyi,2021-04-07 09:11:44+02:00,['4b852ba7c89097da25bcf9160631eca6e9d9ac28'],68,347,415,3929615,5,0,0.96,0.984,11064
b79987918a3f8e3cb69e3d21176f09704c441707,0,Pierre Villard,2021-04-07 13:28:12+02:00,['f4ad658faee24b48a266e9efc53d2b275a473cdd'],80,220,300,3929915,17,0.019230769,0,0.826923077,11065
9da3b1ec01555a5f36047f500b784edffd2f80b3,0,exceptionfactory,2021-04-07 07:40:03-05:00,['b79987918a3f8e3cb69e3d21176f09704c441707'],6,49,55,3929970,6,0.84,0.84,0.8,11065
77a73a603b9cb27bda31118c44b13dda2489526c,0,Joey Frazee,2021-04-07 11:23:25-07:00,['9da3b1ec01555a5f36047f500b784edffd2f80b3'],2,12,14,3929984,1,0,0,1,11065
33ec8c8427eb2cebf52f5f91e81785bc285e6544,0,Peter Turcsanyi,2021-04-08 10:06:26+02:00,['77a73a603b9cb27bda31118c44b13dda2489526c'],12,18,30,3930014,2,0,0,0,11065
78b69f10dcef71ea149bdeb8e97073b7175b8e7b,0,Peter Turcsanyi,2021-04-08 17:47:13+02:00,['33ec8c8427eb2cebf52f5f91e81785bc285e6544'],37,380,417,3930431,12,0.975609756,0.975609756,1,11067
14e6dc3dc6533fc6189a301cf720c0ee57650729,0,exceptionfactory,2021-04-08 15:41:44-05:00,['78b69f10dcef71ea149bdeb8e97073b7175b8e7b'],42,384,426,3930857,6,0.961748634,0.983606557,0.956284153,11069
bfd964b9c7fdac7190780dc03a5fe02ce754b66b,0,Tamas Palfy,2021-04-09 17:22:56+02:00,['14e6dc3dc6533fc6189a301cf720c0ee57650729'],25,24,49,3930906,4,0,0,0,11069
76f33e42c675fe9ed7fdf716e8609b0aad11520b,0,exceptionfactory,2021-04-09 10:36:31-05:00,['bfd964b9c7fdac7190780dc03a5fe02ce754b66b'],2,114,116,3931022,3,0.540983607,0.06557377,1,11069
d0045c13b1c79bf435a62a20de4b1b2dd633dedb,0,Pierre Villard,2021-04-09 17:42:24+02:00,['76f33e42c675fe9ed7fdf716e8609b0aad11520b'],10,33,43,3931065,4,0.454545455,0,1,11069
365dde2d1151a9a3d5b0d7ef58e4e0b8726d802b,1,Joey Frazee,2021-04-09 15:06:14-07:00,['d0045c13b1c79bf435a62a20de4b1b2dd633dedb'],13,1243,1256,3932321,13,0.606164384,0.738013699,0.821917808,11075
74531fa1ca389e9872393c3a1d9a3ccf037b0ac0,0,Mark Payne,2021-04-10 10:33:16-04:00,['365dde2d1151a9a3d5b0d7ef58e4e0b8726d802b'],1,1,2,3932323,1,,,,11075
052c60dc53385828eb0015b165249ddece40c00d,1,GitHub,2021-04-12 08:48:20-04:00,['74531fa1ca389e9872393c3a1d9a3ccf037b0ac0'],0,1487,1487,3933810,21,0.778666667,0.925333333,0.904,11095
7d1d536da68b00d1c0a7ec8548acf459f2e1845a,1,Bryan Bende,2021-04-12 11:48:04-04:00,['052c60dc53385828eb0015b165249ddece40c00d'],1821,2720,4541,3938351,136,0.694235589,0.894736842,0.839598997,11111
2298953f90e8023afc4f032dd1dad99c054de5c3,0,exceptionfactory,2021-04-12 11:38:47-05:00,['7d1d536da68b00d1c0a7ec8548acf459f2e1845a'],11,147,158,3938509,6,0.631578947,1,0.035087719,11112
55236e6fd70519d1ef89d909ae0e60d89de37398,0,exceptionfactory,2021-04-12 11:50:05-05:00,['2298953f90e8023afc4f032dd1dad99c054de5c3'],13,13,26,3938535,2,,,,11112
ef794c56b64d5c2ac83f8fff7dfad2b92637ace0,0,Matthew Burgess,2021-04-12 14:45:02-04:00,['55236e6fd70519d1ef89d909ae0e60d89de37398'],8,10,18,3938553,3,,,,11112
6309ab96d11f61560d4c887fcf076ef3dc03d6e1,1,Joe Witt,2021-04-12 20:31:53-07:00,['ef794c56b64d5c2ac83f8fff7dfad2b92637ace0'],10,13,23,3938576,3,,,,11112
1ab4cf5307d3b4aa8bf9bf750613b48acc59ad9c,0,Joe Witt,2021-04-12 20:35:44-07:00,['6309ab96d11f61560d4c887fcf076ef3dc03d6e1'],4,5,9,3938585,3,0,0,0,11112
06ebb761a2306458799b7c15426eb95c169fb7bc,0,Joe Witt,2021-04-12 20:46:51-07:00,['1ab4cf5307d3b4aa8bf9bf750613b48acc59ad9c'],0,52,52,3938637,2,,,,11113
7d5903c3233c50f6a8f237c528689958f497092b,0,Joe Witt,2021-04-13 07:25:50-07:00,['06ebb761a2306458799b7c15426eb95c169fb7bc'],8,8,16,3938653,4,,,,11113
de3e1a0d0d6c85cb89ce66c08a476048f003c9d1,0,exceptionfactory,2021-04-13 12:23:33-05:00,['7d5903c3233c50f6a8f237c528689958f497092b'],22,11,33,3938686,6,,,,11113
f0611f31da6b643e9ed4bbf2c98faf6c44e29ba6,0,Pierre Villard,2021-04-14 09:26:30+02:00,['de3e1a0d0d6c85cb89ce66c08a476048f003c9d1'],2,68,70,3938756,4,,,,11114
8c66049d1d5f6a47ec2c4ed6cfcb22496504130c,0,Mike Thomsen,2021-04-14 08:43:43-04:00,['f0611f31da6b643e9ed4bbf2c98faf6c44e29ba6'],8,12,20,3938776,1,,,,11114
2fb05cd8dc6b71d1808cc7447ce085a8e7ab8236,0,exceptionfactory,2021-04-14 15:30:08-05:00,['8c66049d1d5f6a47ec2c4ed6cfcb22496504130c'],33,38,71,3938847,2,0.75,0.75,1,11114
4fb86d79e48781deb45ca78c6d95f060d7d9cd18,0,exceptionfactory,2021-04-14 15:56:06-05:00,['2fb05cd8dc6b71d1808cc7447ce085a8e7ab8236'],2,2,4,3938851,1,,,,11114
0f8789b8b07df40336386b2831721f1e0c4a497b,0,exceptionfactory,2021-04-14 16:08:44-05:00,['4fb86d79e48781deb45ca78c6d95f060d7d9cd18'],4,7,11,3938862,2,0,1,1,11114
f0ca63b2ab4a630f600c66cf7c581a4565bb525a,0,Peter Turcsanyi,2021-04-16 09:26:50+02:00,['0f8789b8b07df40336386b2831721f1e0c4a497b'],119,28,147,3939009,2,0.172413793,0.896551724,0,11114
78c03795f62bee5d5249688ff699c5911da11bcf,0,Peter Turcsanyi,2021-04-19 08:33:38+02:00,['f0ca63b2ab4a630f600c66cf7c581a4565bb525a'],136,156,292,3939301,1,1,1,1,11114
173daae6649ed02e88a2b95146de573aab12b9d5,0,Joe Witt,2021-04-19 07:03:40-07:00,['78c03795f62bee5d5249688ff699c5911da11bcf'],1,1,2,3939303,1,,,,11114
77c353219b3cbfb4bf889a7b757db26ada5ef6b8,0,Joe Witt,2021-04-19 07:03:58-07:00,['173daae6649ed02e88a2b95146de573aab12b9d5'],1,1,2,3939305,1,,,,11114
a50957161cef12a63a1ff76bcaf718ecab2e71b5,0,Mark Payne,2021-04-19 12:56:09-04:00,['77c353219b3cbfb4bf889a7b757db26ada5ef6b8'],33,905,938,3940243,13,0.106719368,0.893280632,0.664031621,11120
bbe75e81dd9f6bf0d7ab9b8d5ffddfd499f7130e,0,Pierre Villard,2021-04-20 09:23:17+02:00,['a50957161cef12a63a1ff76bcaf718ecab2e71b5'],0,1,1,3940244,1,,,,11120
a44ab0d683e053057338b70aa47109e3b5797f1d,0,Pierre Villard,2021-04-20 09:28:29+02:00,['bbe75e81dd9f6bf0d7ab9b8d5ffddfd499f7130e'],5,26,31,3940275,2,1,1,1,11120
1497a6ea0dd9dd54834de54c747102e78d6eb5a7,0,GitHub,2021-04-20 11:47:16+02:00,['a44ab0d683e053057338b70aa47109e3b5797f1d'],0,129,129,3940404,1,,,,11120
be716c1621d101b8910f43dee3985023100e0c12,1,Peter Turcsanyi,2021-04-20 13:09:53+02:00,['1497a6ea0dd9dd54834de54c747102e78d6eb5a7'],27,105,132,3940536,3,0,0.75,0.8125,11120
1ef1905461a793ce690534ec96247614fa1f548a,0,Tamas Palfy,2021-04-20 14:51:24+02:00,['be716c1621d101b8910f43dee3985023100e0c12'],8,43,51,3940587,2,0,0.666666667,0.666666667,11120
ed6d5bacba45e4a8015cf224366845b16b82b13e,0,Nathan Gough,2021-04-21 13:45:50-04:00,['1ef1905461a793ce690534ec96247614fa1f548a'],320,66,386,3940973,3,0,0,1,11120
8207c9db202cca571344fea5852c749617e10854,1,Joe Witt,2021-04-21 14:30:24-07:00,['ed6d5bacba45e4a8015cf224366845b16b82b13e'],93,4,97,3941070,1,,,,11120
aedacdf86f33ef944c17f3926656e35b7742bdff,0,exceptionfactory,2021-04-21 18:18:25-05:00,['8207c9db202cca571344fea5852c749617e10854'],2,6,8,3941078,2,0.5,0.5,1,11120
17fa0cf3c1a509ad87386127def9373eb0c1e5df,0,exceptionfactory,2021-04-22 11:31:19-05:00,['aedacdf86f33ef944c17f3926656e35b7742bdff'],0,92,92,3941170,5,0.567567568,0.621621622,1,11120
a1597ced890a5a1570ad7a7f9dcaac0d62dbbd9a,0,exceptionfactory,2021-04-22 12:01:44-05:00,['17fa0cf3c1a509ad87386127def9373eb0c1e5df'],4,0,4,3941174,1,,,,11120
92bdc23adbe867c93f6e43c6665e84108d743fb2,0,Nathan Gough,2021-04-22 15:48:49-04:00,['a1597ced890a5a1570ad7a7f9dcaac0d62dbbd9a'],0,4074,4074,3945248,36,0.768686074,0.966168371,0.938630999,11154
9f45b48866eb87737ff370dd55b37de768f4d754,0,Mark Payne,2021-04-23 13:46:41-04:00,['92bdc23adbe867c93f6e43c6665e84108d743fb2'],4,2,6,3945254,1,0,0,1,11154
835f50c83a9b2ed89374da127893cb40db5b3c79,0,exceptionfactory,2021-04-26 11:34:20-05:00,['9f45b48866eb87737ff370dd55b37de768f4d754'],1,12,13,3945267,1,,,,11154
f9d3bb7f697778ae35846af3927fa7df4dfefcf8,0,Pierre Villard,2021-04-27 12:23:33+02:00,['835f50c83a9b2ed89374da127893cb40db5b3c79'],3,12,15,3945282,2,,,,11154
525bfe00b3858d9836c736d5c60acce3c1e13239,0,Pierre Villard,2021-04-27 13:03:21+02:00,['f9d3bb7f697778ae35846af3927fa7df4dfefcf8'],1,89,90,3945372,2,0.548387097,0.935483871,0.451612903,11154
90c7d03ed385478820fc24f922b550e2327d0565,1,GitHub,2021-04-27 09:34:44-04:00,['525bfe00b3858d9836c736d5c60acce3c1e13239'],18,1000,1018,3946390,19,0.531914894,0.574468085,0.726950355,11167
16dc61e151e7463314a2ffbafb68f25ca6da0ad0,0,Mark Payne,2021-04-27 09:44:39-04:00,['90c7d03ed385478820fc24f922b550e2327d0565'],23,556,579,3946969,4,0.646825397,1,0.972222222,11170
0ed35345245da057400a7d875e47f57bc2d3794d,1,Joey Frazee,2021-04-27 12:08:06-07:00,['16dc61e151e7463314a2ffbafb68f25ca6da0ad0'],46,378,424,3947393,9,0.819444444,0.604166667,0.888888889,11170
3fb76400db25a2db853802b03517e072bd361105,0,exceptionfactory,2021-04-27 17:49:23-05:00,['0ed35345245da057400a7d875e47f57bc2d3794d'],1,1,2,3947395,1,,,,11170
a0655bff1adb411829bb9675a46957bf2900a7a1,1,Kevin Doran,2021-04-27 21:06:56-04:00,['3fb76400db25a2db853802b03517e072bd361105'],40,67916,67956,4015351,549,0.551456311,0.745487235,0.858540093,11706
93dcf25d33fe9f4cb581c33a220aba41e99ea5db,0,Matthew Burgess,2021-04-28 11:47:04-04:00,['a0655bff1adb411829bb9675a46957bf2900a7a1'],1,1,2,4015353,1,,,,11706
54a0e27c937aeef98e17e999a6e61591a46bf91c,0,exceptionfactory,2021-04-29 08:29:42-05:00,['93dcf25d33fe9f4cb581c33a220aba41e99ea5db'],0,311,311,4015664,7,0.742647059,0.75,1,11708
e1c99e3a5c1d138c322b412a66c4027359c84088,0,exceptionfactory,2021-04-29 10:45:43-05:00,['54a0e27c937aeef98e17e999a6e61591a46bf91c'],20,57,77,4015741,2,1,1,0.8,11708
3963f66dffcdc0ca8c3c5a35844007c077d77f41,1,exceptionfactory,2021-04-30 10:41:36-05:00,['e1c99e3a5c1d138c322b412a66c4027359c84088'],4,304,308,4016049,3,0.438202247,0.853932584,0.820224719,11709
1090a9748a8ce5fe21d5a79d85a46858f1288f85,1,exceptionfactory,2021-04-30 22:29:55-05:00,['3963f66dffcdc0ca8c3c5a35844007c077d77f41'],338,457,795,4016844,16,1,0.973684211,0.960526316,11714
935566ba235cc5705301305b6c88d4b24094cffe,0,Joey Frazee,2021-05-01 12:45:48-07:00,['1090a9748a8ce5fe21d5a79d85a46858f1288f85'],98,511,609,4017453,16,0.430327869,0.68852459,0.676229508,11716
e1697a8d5874b3a2e15b4cafee05cc60465f97a1,0,exceptionfactory,2021-05-03 13:30:08-05:00,['935566ba235cc5705301305b6c88d4b24094cffe'],2,41,43,4017496,2,1,1,1,11717
cc554a6b110dfa45767bcb13d834ea4265d6dfe6,1,exceptionfactory,2021-05-03 13:40:01-05:00,['e1697a8d5874b3a2e15b4cafee05cc60465f97a1'],19,130,149,4017645,7,1,1,1,11718
24d3d4325c9a6f91f6af3e6c868fad14ef5d863b,0,Joey Frazee,2021-05-03 13:19:31-07:00,['cc554a6b110dfa45767bcb13d834ea4265d6dfe6'],6,1,7,4017652,3,,,,11718
a74c17616dec05375a075c0200d66c6321fb9a83,0,Joe Witt,2021-05-03 16:55:37-07:00,['24d3d4325c9a6f91f6af3e6c868fad14ef5d863b'],1,0,1,4017653,1,,,,11718
13d5be622bc60d7eaa60e2deb8b64c64057f298f,0,Mark Payne,2021-05-04 08:49:34-04:00,['a74c17616dec05375a075c0200d66c6321fb9a83'],667,1083,1750,4019403,37,0.760784314,1,0.909803922,11730
5bcfcf42bb121e5a8324bf7443359c0461965233,1,Peter Turcsanyi,2021-05-04 16:49:21+02:00,['13d5be622bc60d7eaa60e2deb8b64c64057f298f'],30,274,304,4019707,6,0.485714286,0.528571429,0.528571429,11730
328b9e540b7f95f8b564339c71caa57aeb786055,0,Pierre Villard,2021-05-04 18:45:26+02:00,['5bcfcf42bb121e5a8324bf7443359c0461965233'],58,68,126,4019833,23,,,,11730
30fc26647e06a9a38b95ac050722bf752bb392b0,1,exceptionfactory,2021-05-04 14:58:14-05:00,['328b9e540b7f95f8b564339c71caa57aeb786055'],9,270,279,4020112,4,0.05,0.05,0.1,11730
2895bac2c088aa66c8b86ecba680f80e1323105a,0,Matthew Burgess,2021-05-06 16:06:23-04:00,['30fc26647e06a9a38b95ac050722bf752bb392b0'],3,11,14,4020126,1,0,0,0,11730
1e75b7ef0630ed05d289e8b637277d6427eadde4,0,Matthew Burgess,2021-05-07 11:26:21-04:00,['2895bac2c088aa66c8b86ecba680f80e1323105a'],0,5,5,4020131,1,,,,11730
284322feede8387b3a05038ef61fffb7ce54a176,1,exceptionfactory,2021-05-10 08:39:10-05:00,['1e75b7ef0630ed05d289e8b637277d6427eadde4'],29,87,116,4020247,19,1,0,0,11731
5062f2e54e27e6605e9828661a85695176abeab8,0,Matthew Burgess,2021-05-10 11:13:31-04:00,['284322feede8387b3a05038ef61fffb7ce54a176'],12,3,15,4020262,3,,,,11731
5c2df42be32d9baee518fcc9bb0e47b25ab93882,0,Matthew Burgess,2021-05-10 13:54:18-04:00,['5062f2e54e27e6605e9828661a85695176abeab8'],15,0,15,4020277,1,1,1,0,11731
1645886e5a42579b21ccc9c44f4db8b08fc2e8df,0,Mark Payne,2021-05-10 16:15:00-04:00,['5c2df42be32d9baee518fcc9bb0e47b25ab93882'],1,2,3,4020280,1,0,0,1,11731
1791f4cc35f3977e44312aed4a2ecd173b8c43c4,0,exceptionfactory,2021-05-11 08:27:49-05:00,['1645886e5a42579b21ccc9c44f4db8b08fc2e8df'],0,27,27,4020307,2,1,1,1,11731
48a9054731c2246be913e1e191b93e082f7ec0f8,0,Nathan Gough,2021-05-11 11:48:41-04:00,['1791f4cc35f3977e44312aed4a2ecd173b8c43c4'],1,10,11,4020318,3,,,,11731
86d5b08d232e54e5af0beac1fcc6c1509b0b303e,0,markap14,2021-05-11 14:40:12-04:00,['48a9054731c2246be913e1e191b93e082f7ec0f8'],1,3,4,4020322,1,,,,11731
340b13033f1012a2de2cec582b019ad0e01ead4a,0,markap14,2021-05-11 14:50:49-04:00,['86d5b08d232e54e5af0beac1fcc6c1509b0b303e'],4,0,4,4020326,1,,,,11731
a4d435c9952f306f748fa004fc839eba318f6187,1,Mark Payne,2021-05-11 16:51:23-04:00,['340b13033f1012a2de2cec582b019ad0e01ead4a'],10,161,171,4020497,15,0.377358491,0.396226415,0.716981132,11733
fdda3582e3f60da74d82713e8677a1560d04a008,0,Matthew Burgess,2021-05-11 17:46:38-04:00,['a4d435c9952f306f748fa004fc839eba318f6187'],2,2,4,4020501,2,1,1,,11733
4db50f2f40480c852342796d999f71dff316eaa2,0,Pierre Villard,2021-05-12 12:49:01+02:00,['fdda3582e3f60da74d82713e8677a1560d04a008'],139,197,336,4020837,48,1,1,0,11733
09e54c1dad09a6b91d5e9a08ee53de42afa56c53,0,Pierre Villard,2021-05-12 12:58:50+02:00,['4db50f2f40480c852342796d999f71dff316eaa2'],4,4,8,4020845,3,,,,11733
ab8b7444b5587adfc7548a1da99c57040dc418c0,1,Pierre Villard,2021-05-12 13:05:48+02:00,['09e54c1dad09a6b91d5e9a08ee53de42afa56c53'],22,57,79,4020924,2,1,1,1,11733
a274c12bbbbc225ab976daff26f8bc67a6fe7614,0,Peter Turcsanyi,2021-05-12 20:03:28+02:00,['ab8b7444b5587adfc7548a1da99c57040dc418c0'],160,3220,3380,4024304,29,0.413239075,0.888174807,0.793701799,11745
97ed0efbc23356297ecd2568d1d3b3305fc2a9e7,0,Matthew Burgess,2021-05-13 11:37:57-04:00,['a274c12bbbbc225ab976daff26f8bc67a6fe7614'],3,8,11,4024315,2,0,0.333333333,1,11745
73a2283c279390a8d31d67eec8d0d190a2115131,0,Matthew Burgess,2021-05-13 14:05:30-04:00,['97ed0efbc23356297ecd2568d1d3b3305fc2a9e7'],6,10,16,4024331,3,0,1,1,11745
6776765a928952a68373d633fac1d848ddcc7b50,0,Matthew Burgess,2021-05-14 09:31:48-04:00,['73a2283c279390a8d31d67eec8d0d190a2115131'],91,232,323,4024654,54,,,,11745
7e54ef9421901f15bf7030cd71087457b65b5d68,0,exceptionfactory,2021-05-14 11:38:07-05:00,['6776765a928952a68373d633fac1d848ddcc7b50'],27,29,56,4024710,3,,,,11745
7c08fbc4d495bf592ef5993e52c1e5aed20a450b,0,Matthew Burgess,2021-05-14 12:57:01-04:00,['7e54ef9421901f15bf7030cd71087457b65b5d68'],1,102,103,4024813,3,0.142857143,0,0.976190476,11746
51aae5bcf6dd7ec1aaece74ec69744817e923011,0,Mark Payne,2021-05-14 13:14:06-04:00,['7c08fbc4d495bf592ef5993e52c1e5aed20a450b'],111,1193,1304,4026117,22,0.545905707,0.727047146,0.885856079,11757
ed591e0f222cab83ca0c4bff830274ae8f48bcea,0,exceptionfactory,2021-05-14 12:27:01-05:00,['51aae5bcf6dd7ec1aaece74ec69744817e923011'],0,1301,1301,4027418,17,0.859122402,1,0.891454965,11773
f812dfdfc0f008d372581c6e4c8770c88ad1c3e6,1,GitHub,2021-05-14 15:13:00-04:00,['ed591e0f222cab83ca0c4bff830274ae8f48bcea'],2,30,32,4027450,2,0,0,0,11773
2309d75d3d564f51b363820738dd348ec74f31ab,0,Mark Payne,2021-05-18 17:09:53-04:00,['f812dfdfc0f008d372581c6e4c8770c88ad1c3e6'],32,483,515,4027965,29,0.404580153,0.786259542,0.961832061,11773
1f0425b86d9cf3e7bb9f628e8b34c96c1a153f49,0,Mark Payne,2021-05-18 17:10:09-04:00,['2309d75d3d564f51b363820738dd348ec74f31ab'],10,17,27,4027992,1,,,,11773
a223f1e71f809893cdb702380e929e5206512e0b,1,Matthew Burgess,2021-05-18 18:05:25-04:00,['1f0425b86d9cf3e7bb9f628e8b34c96c1a153f49'],6,90,96,4028088,2,1,1,1,11774
ecacfdaa4c663ff2831dd13a840aabd0ff3349e8,1,Mark Payne,2021-05-19 08:51:16-04:00,['a223f1e71f809893cdb702380e929e5206512e0b'],1107,3986,5093,4033181,149,0.496251874,0.898050975,0.755622189,11790
e19940ea7ecff9b88b1fc2ac1aa5c1c8b3c3a777,0,Nathan Gough,2021-05-19 14:34:28-04:00,['ecacfdaa4c663ff2831dd13a840aabd0ff3349e8'],16,51,67,4033248,2,0.619047619,0.619047619,1,11790
13e5dc4691c8d6f7fb8fafe6ed16caeb603cd315,1,Pierre Villard,2021-05-19 21:33:34+02:00,['e19940ea7ecff9b88b1fc2ac1aa5c1c8b3c3a777'],73,146,219,4033467,4,0.063829787,1,0.553191489,11790
a3eaf0a37a939b42106bee2e24482e44f0d30763,1,Peter Turcsanyi,2021-05-19 23:26:31+02:00,['13e5dc4691c8d6f7fb8fafe6ed16caeb603cd315'],1339,3241,4580,4038047,54,0.963737796,1,0.836820084,11830
c113960b81eff7613ac6d0f6a6e3a6cba10b95f4,0,exceptionfactory,2021-05-20 15:04:23-05:00,['a3eaf0a37a939b42106bee2e24482e44f0d30763'],42,266,308,4038355,4,0.294117647,1,1,11830
154e4f3df30267cd1b7c9ddb30597f64d611c542,0,Matthew Burgess,2021-05-20 22:13:53-04:00,['c113960b81eff7613ac6d0f6a6e3a6cba10b95f4'],144,1769,1913,4040268,118,0.970588235,1,0.955882353,11848
48b75c15aa888cf0c106ab06652bc04d1bf4fdd9,0,Pierre Villard,2021-05-21 10:40:21+02:00,['154e4f3df30267cd1b7c9ddb30597f64d611c542'],1,1,2,4040270,1,,,,11848
4888eaf62d2026067c40caa91e7bf6d4f2917c9f,0,Matthew Burgess,2021-05-21 08:07:09-04:00,['48b75c15aa888cf0c106ab06652bc04d1bf4fdd9'],3,3,6,4040276,1,,,,11848
b6f84413c4c1b740a7e4c5d5a17930bdbf7bdf18,0,Tamas Palfy,2021-05-21 14:11:15+02:00,['4888eaf62d2026067c40caa91e7bf6d4f2917c9f'],46,381,427,4040703,8,0.538461538,0.538461538,0.984615385,11849
1c17da562bcf581af93a22577067c26fe2c7444d,0,Nathan Gough,2021-05-21 11:49:49-04:00,['b6f84413c4c1b740a7e4c5d5a17930bdbf7bdf18'],1,1,2,4040705,1,,,,11849
0b29a42991a63da3b2bacad94c4f6e49ca5e1862,0,Matthew Burgess,2021-05-21 13:55:46-04:00,['1c17da562bcf581af93a22577067c26fe2c7444d'],9,167,176,4040881,5,0.430379747,0.873417722,0.708860759,11850
01783a295c164dde29e5796fd2c010f2197a58b9,0,Nathan Gough,2021-05-23 23:52:01-04:00,['0b29a42991a63da3b2bacad94c4f6e49ca5e1862'],202,157,359,4041240,9,1,1,1,11851
622507f994002a1716564dafd84236ba160a25d2,0,Matthew Burgess,2021-05-24 14:35:27-04:00,['01783a295c164dde29e5796fd2c010f2197a58b9'],9,11,20,4041260,5,,,,11851
5108d7cdd015ef14e98f2acfb61b0213972fe29e,0,Peter Turcsanyi,2021-05-25 13:18:46+02:00,['622507f994002a1716564dafd84236ba160a25d2'],6,48,54,4041314,9,0,0.62962963,0.62962963,11851
a3365c883359d8a06c0ef4e9b370aa83e7d6c67b,1,Nathan Gough,2021-05-25 10:54:15-04:00,['5108d7cdd015ef14e98f2acfb61b0213972fe29e'],1784,2080,3864,4045178,36,1,0.487252125,0.218130312,11877
beb1d2f4451c2e3311f0edc4ba2effd8ce8f914a,0,Pierre Villard,2021-05-25 19:45:21+02:00,['a3365c883359d8a06c0ef4e9b370aa83e7d6c67b'],0,1,1,4045179,1,0,1,1,11877
103aae64cb28de235983880ba2b78f935ca56767,0,GitHub,2021-05-25 16:53:02-04:00,['beb1d2f4451c2e3311f0edc4ba2effd8ce8f914a'],13,11,24,4045203,3,0,0,0,11877
dfa683af0e00cd631905d45365bc797fbdce66ee,1,GitHub,2021-05-26 09:34:55-04:00,['103aae64cb28de235983880ba2b78f935ca56767'],17,161397,161414,4206617,1113,0.504622422,0.832497261,0.899613677,12978
1e1c4462431776716b731bb59abe022be2ff70bb,0,Pierre Villard,2021-05-26 18:04:03+02:00,['dfa683af0e00cd631905d45365bc797fbdce66ee'],0,3,3,4206620,1,0.5,1,1,12978
1e6161c0aaddb1a11aae27dec2ea9761ca3a10ac,1,Pierre Villard,2021-05-26 20:21:11+02:00,['1e1c4462431776716b731bb59abe022be2ff70bb'],3,3,6,4206626,2,,,,12978
46b1f6755c5ca3cc4bdb55e48fd09e1216b66d71,0,Peter Turcsanyi,2021-05-26 21:54:31+02:00,['1e6161c0aaddb1a11aae27dec2ea9761ca3a10ac'],13,19,32,4206658,1,1,1,1,12978
08edc33eb7eb87c3790b7512948bdec5ed58652f,1,exceptionfactory,2021-05-26 20:07:26-05:00,['46b1f6755c5ca3cc4bdb55e48fd09e1216b66d71'],12,293,305,4206963,6,0.35483871,0.993548387,0.696774194,12979
7fb0293c3eedc5f1c7d4a9acccbd2b55d0b969c8,0,Nathan Gough,2021-05-27 12:41:11-04:00,['08edc33eb7eb87c3790b7512948bdec5ed58652f'],7,5,12,4206975,3,,,,12979
9fe1f56019ac623156f0b186cee21fbdcd9a42cb,0,exceptionfactory,2021-05-27 20:42:33-05:00,['7fb0293c3eedc5f1c7d4a9acccbd2b55d0b969c8'],45,41,86,4207061,6,,,,12979
bf960cae2e71f06e027ccd63da47bf9e6bb29e95,1,Pierre Villard,2021-05-29 16:42:20+02:00,['9fe1f56019ac623156f0b186cee21fbdcd9a42cb'],83,47,130,4207191,1,1,1,1,12979
e0a1cb8a01d7f69200b5042ae1c68042098b27b7,0,Matthew Burgess,2021-05-29 13:29:14-04:00,['bf960cae2e71f06e027ccd63da47bf9e6bb29e95'],39,87,126,4207317,6,1,1,0,12979
96d521159bebda2f1270b023d677c0bdff7ca1d6,0,Arpad Boda,2021-06-01 12:32:57+02:00,['e0a1cb8a01d7f69200b5042ae1c68042098b27b7'],0,4,4,4207321,1,,,,12979
f23dcb05f6d6c869fab453634bf094a01b42d121,0,Tamas Palfy,2021-06-01 14:37:51+02:00,['96d521159bebda2f1270b023d677c0bdff7ca1d6'],49,97,146,4207467,1,0,0,0,12979
66f0f902525fe8303389c316f3b63029e96a565f,0,Pierre Villard,2021-06-02 18:22:35+02:00,['f23dcb05f6d6c869fab453634bf094a01b42d121'],0,105,105,4207572,2,0.666666667,0.954545455,1,12979
40dd45b71c6c8f33da1c5706dabcf0223db431d8,0,Pierre Villard,2021-06-03 12:22:16+02:00,['66f0f902525fe8303389c316f3b63029e96a565f'],25,18,43,4207615,7,,,,12979
5045adf29c8c8a06fdf15e8d8ce43665c97c008f,0,GitHub,2021-06-03 14:14:05-04:00,['40dd45b71c6c8f33da1c5706dabcf0223db431d8'],5,5,10,4207625,1,,,,12979
bc5204d4df8017cbde5f2d050d466cdb04e7f969,1,GitHub,2021-06-04 09:19:24-04:00,['5045adf29c8c8a06fdf15e8d8ce43665c97c008f'],9,402,411,4208036,7,0.137142857,0.954285714,0.868571429,12981
e883aa6b0be30ac18d7c2faa0bf01cbe7f5304bf,0,GitHub,2021-06-04 11:56:28-04:00,['bc5204d4df8017cbde5f2d050d466cdb04e7f969'],33,33,66,4208102,5,,,,12981
d340ad79ed82f3fa07ed37412ae686453029bf6f,0,Matthew Burgess,2021-06-04 16:21:05-04:00,['e883aa6b0be30ac18d7c2faa0bf01cbe7f5304bf'],127,117,244,4208346,4,0.875,0,0.9375,12981
9af136ad13034d24c877b01000dec4e28134801d,0,Pierre Villard,2021-06-04 23:10:51+02:00,['d340ad79ed82f3fa07ed37412ae686453029bf6f'],4,4,8,4208354,1,,,,12981
c9dee3029422a172c181d6c2d8d8e54e2ecd013e,0,Matthew Burgess,2021-06-04 17:17:33-04:00,['9af136ad13034d24c877b01000dec4e28134801d'],20,236,256,4208610,10,0.25,0.724137931,0.784482759,12982
f07e17ba74da2759213d52431e00f9d0ba5d39a5,0,Arpad Boda,2021-06-07 11:26:16+02:00,['c9dee3029422a172c181d6c2d8d8e54e2ecd013e'],4,66,70,4208680,2,0.0625,1,1,12982
659fda10f3b7ed3d398c2ab8c1cb505880924594,0,GitHub,2021-06-07 15:30:41-04:00,['f07e17ba74da2759213d52431e00f9d0ba5d39a5'],13,169,182,4208862,6,0,0.576086957,1,12985
07ff4f2592b26a5b556bb1297c42325233bdb101,0,Matthew Burgess,2021-06-08 11:59:24-04:00,['659fda10f3b7ed3d398c2ab8c1cb505880924594'],6,16,22,4208884,1,0,1,1,12985
a3c1cd074bafe6ed1975cef2a08793b2a47e4dff,1,exceptionfactory,2021-06-08 13:23:22-05:00,['07ff4f2592b26a5b556bb1297c42325233bdb101'],10,239,249,4209133,5,0.505882353,1,1,12987
8641b54a49d2215b870acc0f96203cbc7f61abe2,1,exceptionfactory,2021-06-08 15:46:31-05:00,['a3c1cd074bafe6ed1975cef2a08793b2a47e4dff'],0,4,4,4209137,2,,,,12987
69c10f5a69811d21de5bfff634ab85202e5738ae,0,GitHub,2021-06-09 11:26:04-04:00,['8641b54a49d2215b870acc0f96203cbc7f61abe2'],81,2356,2437,4211574,29,0.40619137,1,0.875234522,12999
d44dec7345bea5671b6858927dc71f8318c592d4,1,GitHub,2021-06-09 13:07:33-04:00,['69c10f5a69811d21de5bfff634ab85202e5738ae'],21,70,91,4211665,10,0.727272727,0.818181818,0.818181818,12999
7cb3bce6a7bfb9290f4311d35048b710ebe8e989,0,GitHub,2021-06-09 15:22:22-04:00,['d44dec7345bea5671b6858927dc71f8318c592d4'],1,88,89,4211754,5,0.333333333,1,1,13001
4df2a79c8a4c84263f05a5272c3fc88958b1ff13,0,Matthew Burgess,2021-06-10 10:02:50-04:00,['7cb3bce6a7bfb9290f4311d35048b710ebe8e989'],8,19,27,4211781,1,,,,13001
5c91143dc2f77d3656ff29f7a31fb341ded1cf76,0,Matthew Burgess,2021-06-10 10:10:51-04:00,['4df2a79c8a4c84263f05a5272c3fc88958b1ff13'],8,116,124,4211905,5,0,0.442307692,1,13002
d7a8d275c96040627dd357fa76ba4a8276df8682,1,Tamas Palfy,2021-06-11 14:06:15+02:00,['5c91143dc2f77d3656ff29f7a31fb341ded1cf76'],6,15,21,4211926,1,0,0,0,13002
db40989b4833cb4281b7082712b43be78998d071,1,Mark Payne,2021-06-11 14:18:53-04:00,['d7a8d275c96040627dd357fa76ba4a8276df8682'],147,681,828,4212754,45,0.67961165,1,0.951456311,13011
3e774bc5beadd62a646794cc659db9902c5ab1fa,1,GitHub,2021-06-11 14:44:55-04:00,['db40989b4833cb4281b7082712b43be78998d071'],692,680,1372,4214126,26,1,1,0,13015
172afac6ab32350caf6f882e6e7c18e86a5c8c82,0,Joe Witt,2021-06-11 13:10:32-07:00,['3e774bc5beadd62a646794cc659db9902c5ab1fa'],12,50,62,4214188,1,0.296296296,0.962962963,1,13015
64f600d0ce28be3856c1abdf947d05058ea548a7,0,Joe Witt,2021-06-11 13:15:03-07:00,['172afac6ab32350caf6f882e6e7c18e86a5c8c82'],21,40,61,4214249,5,1,1,0,13015
1ccc4fbb0ff6a4041ddff180ab07a1675308e4a3,1,exceptionfactory,2021-06-11 15:44:37-05:00,['64f600d0ce28be3856c1abdf947d05058ea548a7'],3369,2865,6234,4220483,108,0.932432432,0.716216216,0,13032
38cf25c7cfc9fc6d80d5f5a77a28b29da53a8fd2,0,GitHub,2021-06-11 16:48:58-04:00,['1ccc4fbb0ff6a4041ddff180ab07a1675308e4a3'],0,154,154,4220637,5,0.939393939,0.939393939,0.939393939,13035
6f04b457735bb6d511332cdcc3b0dabf302bf775,0,GitHub,2021-06-11 16:58:20-04:00,['38cf25c7cfc9fc6d80d5f5a77a28b29da53a8fd2'],10,10,20,4220657,4,,,,13035
1a515ee74a18d1ec881cc028b6d53bddbfbf2f8b,0,Joey Frazee,2021-06-11 14:11:07-07:00,['6f04b457735bb6d511332cdcc3b0dabf302bf775'],23,104,127,4220784,5,1,1,1,13036
ab851b9cde4fdab291dffdfcc602d19f90ecda21,0,Nathan Gough,2021-06-12 17:14:34-04:00,['1a515ee74a18d1ec881cc028b6d53bddbfbf2f8b'],3,124,127,4220911,5,0.904761905,1,1,13038
48befe22f6af6791361ed7037b8bda372d0ee5c9,0,exceptionfactory,2021-06-14 08:50:34-05:00,['ab851b9cde4fdab291dffdfcc602d19f90ecda21'],18,41,59,4220970,4,0.8,0.8,0.8,13038
20c889cf826781b16a95a485b649e1829b070804,1,Matthew Burgess,2021-06-14 10:00:49-04:00,['48befe22f6af6791361ed7037b8bda372d0ee5c9'],1,119,120,4221090,3,0.04494382,0.842696629,1,13038
de7fef8a0a28010b0dc30ec551f648c7d07ead77,0,Matthew Burgess,2021-06-14 10:04:05-04:00,['20c889cf826781b16a95a485b649e1829b070804'],0,27,27,4221117,3,1,1,1,13039
576338cd55ea01a0b00952f486d063ee67b7ee13,1,Nathan Gough,2021-06-14 16:06:18-04:00,['de7fef8a0a28010b0dc30ec551f648c7d07ead77'],4,9,13,4221130,1,0.25,0.25,1,13039
87c02c17d2567aeb7be58118a30ea8a9a6369950,1,exceptionfactory,2021-06-14 15:47:47-05:00,['576338cd55ea01a0b00952f486d063ee67b7ee13'],1,1,2,4221132,1,,,,13039
e88d610da6794a6273075ade2bc16f1dd309c61b,0,exceptionfactory,2021-06-14 19:49:53-05:00,['87c02c17d2567aeb7be58118a30ea8a9a6369950'],31,36,67,4221199,5,,,,13039
b49a62e1b53d3d52e243ca49ec070c6f8bd0d6b0,0,exceptionfactory,2021-06-15 08:30:50-05:00,['e88d610da6794a6273075ade2bc16f1dd309c61b'],1,1,2,4221201,1,,,,13039
96a8b2d090441ff4ed184b39d40cb316159d24d3,0,GitHub,2021-06-15 09:37:34-04:00,['b49a62e1b53d3d52e243ca49ec070c6f8bd0d6b0'],3,37,40,4221241,3,1,1,1,13039
8004aa5e6efcd1a61e4a3a7c0c0a929bcebfeed8,0,Matthew Burgess,2021-06-15 09:45:18-04:00,['96a8b2d090441ff4ed184b39d40cb316159d24d3'],25,66,91,4221332,1,0,0,0,13039
e06afbdd22139a1744e83b46ce1d6e9c78bbdc36,0,exceptionfactory,2021-06-15 09:05:38-05:00,['8004aa5e6efcd1a61e4a3a7c0c0a929bcebfeed8'],19,76,95,4221427,2,0,0,0.558139535,13039
14265a401510d825a65b2c101738a12fc6bcd62c,0,Pierre Villard,2021-06-15 19:53:43+02:00,['e06afbdd22139a1744e83b46ce1d6e9c78bbdc36'],1,1,2,4221429,1,,,,13039
8ea27d515a93c12418a2f2d155f5cb919283a37f,0,Pierre Villard,2021-06-15 20:06:04+02:00,['14265a401510d825a65b2c101738a12fc6bcd62c'],12,12,24,4221453,12,,,,13039
f923b757f7cb3c88f2331e26300c8f6bfde4d34c,0,exceptionfactory,2021-06-15 15:03:15-05:00,['8ea27d515a93c12418a2f2d155f5cb919283a37f'],1,1,2,4221455,1,,,,13039
3cdab0d752946ce9d5ec83c9130113155560a31a,0,Pierre Villard,2021-06-16 12:06:06+02:00,['f923b757f7cb3c88f2331e26300c8f6bfde4d34c'],1,1,2,4221457,1,,,,13039
520ee8274513abda923b2a61863a3e7c6edfc049,0,Pierre Villard,2021-06-16 13:42:04+02:00,['3cdab0d752946ce9d5ec83c9130113155560a31a'],1,7,8,4221465,1,0,0,1,13039
0f1c9445f0418741e06651b1fe56d3ad981b4963,0,exceptionfactory,2021-06-16 07:15:49-05:00,['520ee8274513abda923b2a61863a3e7c6edfc049'],0,16,16,4221481,1,0,0,1,13039
9be9b9dbe2ba574ab71321bdbb70defcfb59078b,0,Pierre Villard,2021-06-16 18:18:54+02:00,['0f1c9445f0418741e06651b1fe56d3ad981b4963'],4,37,41,4221522,3,,,,13039
90f44d9d62edf0fee5543adf48441a7a205f29f4,0,Mike Thomsen,2021-06-16 14:07:16-04:00,['9be9b9dbe2ba574ab71321bdbb70defcfb59078b'],2,3,5,4221527,1,,,,13039
820b2cff29bf3a0d97399667264591b995cc9e45,0,Tamas Palfy,2021-06-16 21:50:25+02:00,['90f44d9d62edf0fee5543adf48441a7a205f29f4'],24,49,73,4221600,2,1,1,1,13039
9fd8042cfbfa8cbbea602cb85f3adaab1d07eba5,1,Matthew Burgess,2021-06-21 11:01:10-04:00,['820b2cff29bf3a0d97399667264591b995cc9e45'],5,5,10,4221610,5,,,,13039
2efc2b6b8b309aa198143e02084449a6069d7e62,0,Matthew Burgess,2021-06-21 11:29:27-04:00,['9fd8042cfbfa8cbbea602cb85f3adaab1d07eba5'],52,62,114,4221724,53,,,,13039
b1ad13c83588d9206ceb8a157acb9bdb7fdbd4f8,0,Matthew Burgess,2021-06-21 12:55:17-04:00,['2efc2b6b8b309aa198143e02084449a6069d7e62'],0,3,3,4221727,1,0,0,1,13039
6fc9f33ba23066afca1f33497829cdc35e3b6d5b,0,Matthew Burgess,2021-06-21 13:09:20-04:00,['b1ad13c83588d9206ceb8a157acb9bdb7fdbd4f8'],1,1,2,4221729,1,,,,13039
5196ba9e14266ddd9a897b04959a9c2036286219,0,Matthew Burgess,2021-06-21 13:14:10-04:00,['6fc9f33ba23066afca1f33497829cdc35e3b6d5b'],1,1,2,4221731,1,,,,13039
02b4e33aa6cbcba4e3dea706aa9b20e8b501b06f,0,exceptionfactory,2021-06-21 14:39:35-05:00,['5196ba9e14266ddd9a897b04959a9c2036286219'],93,112,205,4221936,2,1,1,1,13039
9744644b9d643dada81566f58dc8a78f008e8fe6,1,exceptionfactory,2021-06-21 16:37:06-05:00,['02b4e33aa6cbcba4e3dea706aa9b20e8b501b06f'],1137,1255,2392,4224328,11,1,1,0,13042
006e3498b746c8480ac1e6afdb75efd5bc62f5c8,0,Matthew Burgess,2021-06-22 11:13:37-04:00,['9744644b9d643dada81566f58dc8a78f008e8fe6'],1,1,2,4224330,1,,,,13042
f2698a4e1eb5afaeb091935d3e69dd0d4d87adf7,1,Matthew Burgess,2021-06-22 11:21:45-04:00,['006e3498b746c8480ac1e6afdb75efd5bc62f5c8'],6,210,216,4224546,22,,,,13042
bd265bd5083e674db76fad88b3d5e8ba41132223,0,Matthew Burgess,2021-06-22 12:28:28-04:00,['f2698a4e1eb5afaeb091935d3e69dd0d4d87adf7'],1,1,2,4224548,1,,,,13042
73363d9aea789d60009afb08a543ea5aa40eac8b,1,GitHub,2021-06-22 13:13:14-04:00,['bd265bd5083e674db76fad88b3d5e8ba41132223'],279,385,664,4225212,2,1,1,0.444444444,13043
6a83115d6aea68a857c7cd409f33b6ba1d519a1e,1,Nathan Gough,2021-06-22 22:29:16-04:00,['73363d9aea789d60009afb08a543ea5aa40eac8b'],412,862,1274,4226486,4,0.878787879,1,0.924242424,13044
8e5ce46f6c4d20c57ed6e315bfe262550b6b2671,0,Pierre Villard,2021-06-23 10:38:19+02:00,['6a83115d6aea68a857c7cd409f33b6ba1d519a1e'],2,3,5,4226491,2,,,,13044
0c748a5a2b366990c544e0580ca8626f0b9e3ed1,1,Tamas Palfy,2021-06-23 17:34:01+02:00,['8e5ce46f6c4d20c57ed6e315bfe262550b6b2671'],25,43,68,4226559,4,1,1,1,13044
1d9ea6d4cf7d27fe6d49f6ceae35e0b48bfde2f0,1,GitHub,2021-06-23 12:42:44-04:00,['0c748a5a2b366990c544e0580ca8626f0b9e3ed1'],10,45,55,4226614,5,,,,13044
ea710e44a37b6f2b3e5903ecc039037b28ef9705,0,GitHub,2021-06-23 16:50:10-04:00,['1d9ea6d4cf7d27fe6d49f6ceae35e0b48bfde2f0'],1,15,16,4226630,3,0,1,1,13044
115bba9ab01d432da60d1fc29359812690a5b453,1,exceptionfactory,2021-06-24 11:51:04-05:00,['ea710e44a37b6f2b3e5903ecc039037b28ef9705'],0,167,167,4226797,6,0.075,0.9875,1,13044
a3f54fa578f86220ff63e73f526e510de3485f41,0,Pierre Villard,2021-06-24 19:37:19+02:00,['115bba9ab01d432da60d1fc29359812690a5b453'],1,10,11,4226808,2,0.25,0.25,1,13044
5ebbe0028b9ff4d23f86d87e4942665db62e9bc0,0,Matthew Burgess,2021-06-24 14:03:51-04:00,['a3f54fa578f86220ff63e73f526e510de3485f41'],45,450,495,4227303,32,0.506976744,0.781395349,0.748837209,13044
27c35c8c428e31a45e98e80f75e2acd735fa1276,0,GitHub,2021-06-24 17:42:04-04:00,['5ebbe0028b9ff4d23f86d87e4942665db62e9bc0'],1,19,20,4227323,4,0.5,1,1,13044
5e4f32663e8e553b022c5d5541072dd71e42f94c,0,Matthew Burgess,2021-06-24 18:52:17-04:00,['27c35c8c428e31a45e98e80f75e2acd735fa1276'],450,45,495,4227818,32,0.493023256,0.218604651,0.251162791,13044
726082ffa6c9f4b350fd6026152c50dc5bae2151,0,exceptionfactory,2021-06-24 22:06:42-05:00,['5e4f32663e8e553b022c5d5541072dd71e42f94c'],131,733,864,4228682,30,0.630208333,1,1,13048
39ffa4a8ac21b83f0b269828d4b162131e393903,1,Pierre Villard,2021-06-25 14:19:57+02:00,['726082ffa6c9f4b350fd6026152c50dc5bae2151'],43,117,160,4228842,12,1,1,0.808510638,13048
49d10dbcbd584075f9cfb0d04772fb553277c7da,0,Kevin Doran,2021-06-25 10:46:23-04:00,['39ffa4a8ac21b83f0b269828d4b162131e393903'],6,31,37,4228879,1,,,,13048
1313ee3d9029cfd7fa0ee85fb4a767ae1b9ed8c4,0,GitHub,2021-06-25 17:37:51+02:00,['49d10dbcbd584075f9cfb0d04772fb553277c7da'],1,2,3,4228882,1,,,,13048
88cc232f15d01ee1c902854054ab994e3f9a5a6e,1,GitHub,2021-06-25 12:40:49-04:00,['1313ee3d9029cfd7fa0ee85fb4a767ae1b9ed8c4'],40,134,174,4229056,9,0.803921569,0.803921569,0.803921569,13048
1dc528ae80f15d87f439117fd7928ff89af22932,0,exceptionfactory,2021-06-25 11:53:29-05:00,['88cc232f15d01ee1c902854054ab994e3f9a5a6e'],0,9,9,4229065,2,,,,13048
786f17182b11cfd5ea28678853a4d401a51c6aff,0,Pierre Villard,2021-06-25 19:18:16+02:00,['1dc528ae80f15d87f439117fd7928ff89af22932'],93,435,528,4229593,8,1,0.333333333,0.416666667,13048
f11c99f9ec2ed71d7ac017bd198d6bcd8248eb25,0,Matthew Burgess,2021-06-25 13:59:11-04:00,['786f17182b11cfd5ea28678853a4d401a51c6aff'],0,13,13,4229606,2,0,0.9,1,13048
1033e77e7f675a8ac56375ea1e4c180cf39f0874,0,Matthew Burgess,2021-06-25 16:15:24-04:00,['f11c99f9ec2ed71d7ac017bd198d6bcd8248eb25'],0,6,6,4229612,1,,,,13048
70d8fe8e0032e27eace5d82e5cdbe389e533b00e,0,exceptionfactory,2021-06-28 20:47:35-05:00,['1033e77e7f675a8ac56375ea1e4c180cf39f0874'],7,7,14,4229626,3,,,,13048
b27c2b500e1c2d889078d0a63fcb10556cfbe621,1,Pierre Villard,2021-06-30 13:40:34+02:00,['70d8fe8e0032e27eace5d82e5cdbe389e533b00e'],3,57,60,4229686,2,0.24,0.92,0.8,13048
632fbcca7d7e028c4526ab2b643c6b83cfadef99,0,Pierre Villard,2021-06-30 13:44:52+02:00,['b27c2b500e1c2d889078d0a63fcb10556cfbe621'],29,45,74,4229760,9,0,0,1,13048
6c7c3b3c1b6383485dd4666c44e63d1f6f86aa47,1,Pierre Villard,2021-06-30 14:03:28+02:00,['632fbcca7d7e028c4526ab2b643c6b83cfadef99'],42,125,167,4229927,2,0.824561404,1,0.842105263,13048
0b15606faedea044b40a0dff156bb267968fefb0,0,exceptionfactory,2021-07-05 13:09:54-05:00,['6c7c3b3c1b6383485dd4666c44e63d1f6f86aa47'],2,2,4,4229931,2,,,,13048
54624bc26df7e3978b6da52cb11332e7592f9968,0,Pierre Villard,2021-07-06 11:29:53+02:00,['0b15606faedea044b40a0dff156bb267968fefb0'],6,6,12,4229943,1,,,,13048
ace27e5f693a0942afed1deaba0eca6aefe9077e,0,Joey Frazee,2021-07-06 13:00:15-07:00,['54624bc26df7e3978b6da52cb11332e7592f9968'],17,742,759,4230702,12,0.817919075,0.875722543,0.849710983,13052
6df07df3b2d2dbabeb279ac749ed45c37efd5d01,0,exceptionfactory,2021-07-06 16:45:02-05:00,['ace27e5f693a0942afed1deaba0eca6aefe9077e'],180,1150,1330,4232032,37,0.400966184,0.70531401,1,13063
edee7a71ec7003aa58da9582f912e5f7e01f9965,0,Pierre Villard,2021-07-07 10:53:03+02:00,['6df07df3b2d2dbabeb279ac749ed45c37efd5d01'],56,56,112,4232144,3,,,,13063
1de01e34daeb22e19fef88d5c9e26e19dc492fcd,0,Pierre Villard,2021-07-07 10:55:32+02:00,['edee7a71ec7003aa58da9582f912e5f7e01f9965'],10,13,23,4232167,1,,,,13063
e16016b4abc771f9e4d62ec9d8a0e626ea9dba08,0,exceptionfactory,2021-07-07 14:51:40-05:00,['1de01e34daeb22e19fef88d5c9e26e19dc492fcd'],18,34,52,4232219,2,0.333333333,0.333333333,0.25,13063
9a125dcaafbaa922066f067d0c5e65f7286f8d44,1,exceptionfactory,2021-07-07 16:24:49-05:00,['e16016b4abc771f9e4d62ec9d8a0e626ea9dba08'],859,556,1415,4233634,19,0.719230769,0.515384615,0.019230769,13067
ea31634ea772b7af567a2f2ccb06f7478cff8ecc,1,Matthew Burgess,2021-07-07 17:45:54-04:00,['9a125dcaafbaa922066f067d0c5e65f7286f8d44'],45,522,567,4234201,37,0.477443609,0.755639098,0.751879699,13067
775130580ac34037ef2378d497fa02150976138f,0,GitHub,2021-07-07 18:36:58-04:00,['ea31634ea772b7af567a2f2ccb06f7478cff8ecc'],9,3,12,4234213,1,0,0,0,13067
9d29e8bae48b0d8a09b90bcaacbd0be9c943cb23,0,Joe Witt,2021-07-08 07:14:22-07:00,['775130580ac34037ef2378d497fa02150976138f'],16,0,16,4234229,2,,,,13067
777f9029b19c06cab0d4973e7ac1156693b31d9b,0,Joe Witt,2021-07-08 07:40:07-07:00,['9d29e8bae48b0d8a09b90bcaacbd0be9c943cb23'],3,2,5,4234234,1,,,,13067
202599931076e11acc2569ccec93db3845a30dae,0,Joe Witt,2021-07-08 14:26:06-07:00,['777f9029b19c06cab0d4973e7ac1156693b31d9b'],0,8,8,4234242,2,0,0,0.142857143,13067
aedbd0d753a143361f46b813a566f35c722f9049,0,Nathan Gough,2021-07-09 12:12:25-04:00,['202599931076e11acc2569ccec93db3845a30dae'],916,1488,2404,4236646,45,1,1,1,13084
b75965d08fba2bb33ba1581e90100d19336fd68b,0,Joe Witt,2021-07-09 09:25:46-07:00,['aedbd0d753a143361f46b813a566f35c722f9049'],206,0,206,4236852,2,,,,13084
75de68e013ca0becb9c0b3cf2503e4e1ea39d951,0,Matthew Burgess,2021-07-09 13:15:44-04:00,['b75965d08fba2bb33ba1581e90100d19336fd68b'],134,192,326,4237178,2,1,1,0.8,13084
a4cfdbb69537b3f499b6274919d0d755b0ae5b0a,0,Matthew Burgess,2021-07-09 21:56:00-04:00,['75de68e013ca0becb9c0b3cf2503e4e1ea39d951'],38,46,84,4237262,2,0,1,0,13084
3bc64754c3eee68cd77df8c68b5688ae2ab401f3,0,Matthew Burgess,2021-07-09 22:26:37-04:00,['a4cfdbb69537b3f499b6274919d0d755b0ae5b0a'],0,3,3,4237265,1,,,,13084
fcbf1d5f975dd984e34f3a543b9480c779b0dc2f,0,Joe Witt,2021-07-10 12:17:05-07:00,['3bc64754c3eee68cd77df8c68b5688ae2ab401f3'],2198,2184,4382,4241647,618,,,,13084
97feacc18146e95d86070ac6a51c9f89c215e45b,0,Joe Witt,2021-07-10 12:17:09-07:00,['fcbf1d5f975dd984e34f3a543b9480c779b0dc2f'],2171,2171,4342,4245989,618,,,,13084
1793af4987fd2d0112c0717d8ce293c919a8ac83,0,Matthew Burgess,2021-07-12 12:45:07-04:00,['3bc64754c3eee68cd77df8c68b5688ae2ab401f3'],169,116,285,4246274,2,0,0,0,13084
ce90249f7cf556c0c834666832ae0d8c3b609238,0,exceptionfactory,2021-07-12 16:55:21-05:00,['1793af4987fd2d0112c0717d8ce293c919a8ac83'],12,2,14,4246288,6,,,,13084
4fde9648dd8ec621ebcdf1bfd0b80786a0ff68da,0,Matthew Burgess,2021-07-13 13:27:58-04:00,['ce90249f7cf556c0c834666832ae0d8c3b609238'],5,29,34,4246322,2,0.823529412,1,0.647058824,13084
05d7867a1689c27b5b229480dab716f0a047f4b8,1,Matthew Burgess,2021-07-13 16:17:36-04:00,['4fde9648dd8ec621ebcdf1bfd0b80786a0ff68da'],198,381,579,4246901,20,1,0.677083333,0.791666667,13084
2c4c4cc22db0fc323a5f85e4fefd760cc4d238ba,0,Matthew Burgess,2021-07-13 16:22:12-04:00,['05d7867a1689c27b5b229480dab716f0a047f4b8'],2,2,4,4246905,2,,,,13084
73563328522b70ef0b024196b2518c9276bf62ae,0,Joe Witt,2021-07-14 09:07:22-05:00,"['2c4c4cc22db0fc323a5f85e4fefd760cc4d238ba', '97feacc18146e95d86070ac6a51c9f89c215e45b']",2197,2183,4380,4251285,618,,,,13084
c668d3df1baa4dd40f727aaa2bc1fab697520913,1,Nathan Gough,2021-07-14 14:24:45-04:00,['73563328522b70ef0b024196b2518c9276bf62ae'],76,79,155,4251440,6,0,0.833333333,1,13084
e4ff6f95a0c3630ea4fc3f18d5563c33cdf243b4,0,GitHub,2021-07-15 16:19:04-04:00,['c668d3df1baa4dd40f727aaa2bc1fab697520913'],13,58,71,4251511,2,1,1,1,13084
00f385b51bd4fda06269881ef7a64b4e59c68227,0,Pierre Villard,2021-07-16 15:13:05+02:00,['e4ff6f95a0c3630ea4fc3f18d5563c33cdf243b4'],35,31,66,4251577,1,1,0,0,13084
44779216658c55a2278dbc523ba1b4b08b8ef083,0,GitHub,2021-07-16 11:24:14-04:00,['00f385b51bd4fda06269881ef7a64b4e59c68227'],1,88,89,4251666,2,0.37254902,1,0.901960784,13084
af0f3403a5374a428db854ec8273c30bf6ec6451,0,exceptionfactory,2021-07-16 14:12:09-05:00,['44779216658c55a2278dbc523ba1b4b08b8ef083'],17,5,22,4251688,6,,,,13084
b99e7fc56099655a7a3d3636343780e1db3907f4,1,Tamas Palfy,2021-07-16 21:20:27+02:00,['af0f3403a5374a428db854ec8273c30bf6ec6451'],40,359,399,4252087,11,0.153225806,0.693548387,0.701612903,13088
1354f731939f5f30e97e74bb6e5f7b24aa4722af,0,exceptionfactory,2021-07-16 17:50:01-05:00,['b99e7fc56099655a7a3d3636343780e1db3907f4'],11,1,12,4252099,2,,,,13088
49cbc9bd6b5e2049705c392be73796462ccd5adf,0,Pierre Villard,2021-07-19 20:24:03+02:00,['1354f731939f5f30e97e74bb6e5f7b24aa4722af'],444,0,444,4252543,5,0.452631579,0.231578947,0.105263158,13088
ebdc5eb92b5faf71c5300195d63573792135275d,1,Pierre Villard,2021-07-19 20:26:45+02:00,['49cbc9bd6b5e2049705c392be73796462ccd5adf'],10,54,64,4252607,2,1,1,1,13088
828b6c1bcce9f5bb4305a0e3c2a7a763e9b1745c,0,Matthew Burgess,2021-07-19 17:58:05-04:00,['ebdc5eb92b5faf71c5300195d63573792135275d'],9,3,12,4252619,3,,,,13088
47eeabd8a5045d21bbcd0d2001bebac8344cec4c,0,Pierre Villard,2021-07-20 15:05:48+02:00,['828b6c1bcce9f5bb4305a0e3c2a7a763e9b1745c'],22,41,63,4252682,2,1,1,1,13088
cb020072f70f444dcae6e5e32e9f25d21495cec5,0,Nathan Gough,2021-07-20 13:21:48-04:00,['47eeabd8a5045d21bbcd0d2001bebac8344cec4c'],178,211,389,4253071,2,0.037037037,1,0.814814815,13088
73ddb43f53e956d20248891354e800474bda32e0,0,Pierre Villard,2021-07-21 11:43:36+02:00,['cb020072f70f444dcae6e5e32e9f25d21495cec5'],19,9,28,4253099,3,0,0,0,13088
74c0a91b6c9c25f348518c8700f998b422a341f9,0,Pierre Villard,2021-07-21 11:46:45+02:00,['73ddb43f53e956d20248891354e800474bda32e0'],2,4,6,4253105,2,1,1,1,13088
4856c800344b82123cd0a417c687029486e984ae,0,Matthew Burgess,2021-07-21 14:04:03-04:00,['74c0a91b6c9c25f348518c8700f998b422a341f9'],1,1,2,4253107,1,,,,13088
d4a560c59a05261b21bbf4dc124f7eb985b9a487,0,exceptionfactory,2021-07-22 08:24:52-05:00,['4856c800344b82123cd0a417c687029486e984ae'],7,651,658,4253765,17,0.577464789,1,1,13092
0ba9f0dc216387b6748f1a0cdf84a5804241029c,0,Nathan Gough,2021-07-22 11:43:33-04:00,['d4a560c59a05261b21bbf4dc124f7eb985b9a487'],2059,110,2169,4255934,24,0.188802083,0.040364583,0.032552083,13092
0c96e573a4c473fc0e5c6bef3455aabe388dfab3,0,Pierre Villard,2021-07-22 20:05:53+02:00,['0ba9f0dc216387b6748f1a0cdf84a5804241029c'],4,336,340,4256274,6,0,0.917525773,1,13095
f78a983bead42249294fc91c2e704578b87a46b2,0,Pierre Villard,2021-07-22 20:08:55+02:00,['0c96e573a4c473fc0e5c6bef3455aabe388dfab3'],5,80,85,4256359,3,0.634615385,0.519230769,0.884615385,13095
55de7de448510b838890ee6abe0eb9fc5cdcfda5,1,exceptionfactory,2021-07-22 15:30:58-05:00,['f78a983bead42249294fc91c2e704578b87a46b2'],1,37,38,4256397,2,,,,13095
871360a5ee0281c3ecfcc79047003df82cc0a9c6,1,exceptionfactory,2021-07-22 15:54:42-05:00,['55de7de448510b838890ee6abe0eb9fc5cdcfda5'],26,22,48,4256445,4,,,,13095
d2756d4658120d6292d8643c1fb20281d219a177,0,Pierre Villard,2021-07-23 20:02:28+02:00,['871360a5ee0281c3ecfcc79047003df82cc0a9c6'],5,32,37,4256482,5,0.545454545,0.909090909,1,13095
7a1b4b055a0982b18fe44c380fc183e08de5db95,0,Pierre Villard,2021-07-26 13:19:26+02:00,['d2756d4658120d6292d8643c1fb20281d219a177'],0,4,4,4256486,1,,,,13095
1d61be776b4ccb4388bc7f8ddd93f0157f8f995e,1,Pierre Villard,2021-07-26 13:29:02+02:00,['7a1b4b055a0982b18fe44c380fc183e08de5db95'],2,6,8,4256494,2,,,,13095
80456d681e109031d82f1d10912fc28dcd5f333d,0,GitHub,2021-07-26 12:54:41-04:00,['1d61be776b4ccb4388bc7f8ddd93f0157f8f995e'],56,164,220,4256714,11,0,0.652777778,0.472222222,13095
e16bf644e3d51c737f9a08c3f5c6795ed631e4b3,0,Pierre Villard,2021-07-27 10:21:27+02:00,['80456d681e109031d82f1d10912fc28dcd5f333d'],27,40,67,4256781,17,,,,13095
2daac5714a6050dd872522ff74d7fe71f700db6e,1,exceptionfactory,2021-07-27 15:37:29-05:00,['e16bf644e3d51c737f9a08c3f5c6795ed631e4b3'],198,417,615,4257396,39,0.983333333,1,0.433333333,13096
f539d9886e3e0f3f1068e9e13af0988dae70377a,0,Pierre Villard,2021-07-29 09:44:43+02:00,['2daac5714a6050dd872522ff74d7fe71f700db6e'],23,2,25,4257421,2,0,0,0,13096
a466e714a0b4ad1c6acd088faf131610097ac9a1,0,Pierre Villard,2021-07-30 09:13:22+02:00,['f539d9886e3e0f3f1068e9e13af0988dae70377a'],1,21,22,4257443,2,0,0,0,13096
5117fc0619a5f618100f210474ed3aff3a58c60a,0,exceptionfactory,2021-07-30 16:16:25-05:00,['a466e714a0b4ad1c6acd088faf131610097ac9a1'],35,107,142,4257585,1,0.208333333,0,0.583333333,13096
8c4c6cedf6fd56de1c465b7cb3f5d10694a53b01,0,exceptionfactory,2021-08-02 09:17:27-05:00,['5117fc0619a5f618100f210474ed3aff3a58c60a'],20,20,40,4257625,9,,,,13096
3621a2182c71b9b5fe9af53c584cc6b8ae4e2712,0,Pierre Villard,2021-08-02 20:20:11+02:00,['8c4c6cedf6fd56de1c465b7cb3f5d10694a53b01'],3,1,4,4257629,2,,,,13096
44f7a2f5b5882e5ca7fdd217f61bd6df0d9dc26b,1,Pierre Villard,2021-08-02 20:22:52+02:00,['3621a2182c71b9b5fe9af53c584cc6b8ae4e2712'],3,2,5,4257634,1,1,1,0,13096
1ea47d6888c011275d71a0471b2cf5579313fa4f,1,Pierre Villard,2021-08-02 20:27:12+02:00,['44f7a2f5b5882e5ca7fdd217f61bd6df0d9dc26b'],7,5,12,4257646,1,1,1,1,13096
ba7271c85b59cb62a66282360f90eba3e3f0b5ba,0,Pierre Villard,2021-08-03 10:02:20+02:00,['1ea47d6888c011275d71a0471b2cf5579313fa4f'],5,60,65,4257711,15,,,,13096
fb96590586f36e37d4fc050e912434ec65bfe85d,0,Pierre Villard,2021-08-03 10:06:54+02:00,['ba7271c85b59cb62a66282360f90eba3e3f0b5ba'],8,7,15,4257726,2,,,,13096
0497129aa674889b378d8d32a061d050d1bc0ac0,0,Pierre Villard,2021-08-03 10:14:47+02:00,['fb96590586f36e37d4fc050e912434ec65bfe85d'],1,14,15,4257741,2,,,,13096
d93e9f152cad2f7f40c026604ff62fd7f0ba1c55,0,Pierre Villard,2021-08-03 15:52:45+02:00,['0497129aa674889b378d8d32a061d050d1bc0ac0'],9,231,240,4257981,36,,,,13096
633cdab12120c980bfae4495b28b98eff5eb753e,0,GitHub,2021-08-03 10:38:59-04:00,['d93e9f152cad2f7f40c026604ff62fd7f0ba1c55'],2,28,30,4258011,1,,,,13096
a239eea8ff07e836d391ff0c5e73503c28369d9b,0,Matthew Burgess,2021-08-04 09:13:15-04:00,['633cdab12120c980bfae4495b28b98eff5eb753e'],68,71,139,4258150,3,,,,13096
a4375a046f901056e2b6fc9636e81981b8d518d3,0,Matthew Burgess,2021-08-04 09:18:38-04:00,['a239eea8ff07e836d391ff0c5e73503c28369d9b'],13,53,66,4258216,12,,,,13096
6139c51063bcd957432e7108fb1198a43683e252,0,Matthew Burgess,2021-08-04 09:23:35-04:00,['a4375a046f901056e2b6fc9636e81981b8d518d3'],2,2,4,4258220,2,,,,13096
713f997f87a77b446b0933036b88e3351105f5e7,0,exceptionfactory,2021-08-04 08:54:01-05:00,['6139c51063bcd957432e7108fb1198a43683e252'],3,2,5,4258225,4,,,,13096
f47603ee484f9e66ad9c5628b6fd44acf417d726,0,Pierre Villard,2021-08-05 11:56:02+02:00,['713f997f87a77b446b0933036b88e3351105f5e7'],35,85,120,4258345,10,0.2,0.96,0,13096
c273b02ebee7994d76771745e686032f3da39449,0,Pierre Villard,2021-08-05 12:01:02+02:00,['f47603ee484f9e66ad9c5628b6fd44acf417d726'],4,98,102,4258447,3,,,,13096
9bf3b5503434e8a1dad5453b54a38dfaf079467c,0,Peter Turcsanyi,2021-08-05 13:21:44+02:00,['c273b02ebee7994d76771745e686032f3da39449'],32,160,192,4258639,3,0.909090909,1,0.872727273,13096
4fa357ed9e9f0d1f61a98910eec2e9e193aebc87,0,Pierre Villard,2021-08-05 13:35:16+02:00,['9bf3b5503434e8a1dad5453b54a38dfaf079467c'],0,98,98,4258737,1,,,,13096
47d5ae5d75ee94b4f8613f7eccfced243d2a4d89,0,exceptionfactory,2021-08-05 16:30:38-05:00,['4fa357ed9e9f0d1f61a98910eec2e9e193aebc87'],12,60,72,4258809,2,,,,13096
787f16da3fe6c6660dd4c3d103432496e217bcf6,0,Mike Thomsen,2021-08-05 20:36:01-04:00,['47d5ae5d75ee94b4f8613f7eccfced243d2a4d89'],10,5,15,4258824,2,,,,13096
cc1e9665cda8ae91c2c067f567013efe69fe448c,1,exceptionfactory,2021-08-06 07:39:34-05:00,['787f16da3fe6c6660dd4c3d103432496e217bcf6'],65,321,386,4259210,13,0.728813559,0.728813559,0.915254237,13097
82bd72b83d78bd57eded9fb73a1a273145892b7c,0,GitHub,2021-08-06 13:01:26-04:00,['cc1e9665cda8ae91c2c067f567013efe69fe448c'],151,152,303,4259513,21,1,1,1,13097
bf52973d628b092902f389e638448a6cd458d6a2,1,exceptionfactory,2021-08-06 15:52:55-05:00,['82bd72b83d78bd57eded9fb73a1a273145892b7c'],47,292,339,4259852,4,0,0.631578947,0.705263158,13097
0a827d6cd77a4a06d7c69048afe8bdd0a77117a3,0,Joey Frazee,2021-08-07 15:40:26-07:00,['bf52973d628b092902f389e638448a6cd458d6a2'],1,1,2,4259854,1,,,,13097
462306369f6cb041cdc4aa63d8579030aafa65ce,0,Peter Turcsanyi,2021-08-09 12:57:56+02:00,['0a827d6cd77a4a06d7c69048afe8bdd0a77117a3'],19,243,262,4260116,4,0.696969697,0.593939394,0.636363636,13097
f57685e971c44c62bcebf8b964cf427bbc30b7c8,0,Peter Turcsanyi,2021-08-09 15:15:18+02:00,['462306369f6cb041cdc4aa63d8579030aafa65ce'],12,85,97,4260213,6,0.535714286,0.857142857,1,13097
34ab0d8c2560a4e08e1e77c2580c61a3ae9d0159,0,Matthew Burgess,2021-08-09 12:19:22-04:00,['f57685e971c44c62bcebf8b964cf427bbc30b7c8'],1,285,286,4260499,26,0.230769231,1,1,13099
8d2ced429d7a14354e4ed554c6ddc9b7dc162d4d,0,GitHub,2021-08-09 12:55:54-04:00,['34ab0d8c2560a4e08e1e77c2580c61a3ae9d0159'],1,3,4,4260503,1,,,,13099
2e1f276f063d6309ddba830ae224c7840dae0f64,0,Matthew Burgess,2021-08-09 13:51:15-04:00,['8d2ced429d7a14354e4ed554c6ddc9b7dc162d4d'],27,80,107,4260610,2,0,0.909090909,1,13099
f27cd012f33593902ddca11021a33c55224fac6a,0,Matthew Burgess,2021-08-09 15:55:20-04:00,['2e1f276f063d6309ddba830ae224c7840dae0f64'],98,67,165,4260775,2,1,1,0.6,13099
77cf9a11df570f4cc6af016e3e3a96cd741925d7,1,GitHub,2021-08-09 16:55:39-04:00,['f27cd012f33593902ddca11021a33c55224fac6a'],282,334,616,4261391,123,0.333333333,0,0.333333333,13099
b34b5b8eef9f26ec73229bcc7b5b4072cc49b89f,1,Matthew Burgess,2021-08-09 19:27:46-04:00,['77cf9a11df570f4cc6af016e3e3a96cd741925d7'],198,167,365,4261756,6,,,,13100
9a56d233115f725822828b2790b8c3eda4d79b53,0,exceptionfactory,2021-08-10 15:02:53-05:00,['b34b5b8eef9f26ec73229bcc7b5b4072cc49b89f'],0,5,5,4261761,1,,,,13100
5ff4974b1fe742faa06fa3209466077fc27cf54d,0,Mike Thomsen,2021-08-11 07:16:11-04:00,['9a56d233115f725822828b2790b8c3eda4d79b53'],21,43,64,4261825,6,0.352941176,0.647058824,1,13100
5106197b3b5cb439d0ba486216ce800ba917c6b5,1,GitHub,2021-08-11 14:26:08+02:00,['5ff4974b1fe742faa06fa3209466077fc27cf54d'],53,231,284,4262109,3,0.619469027,0.292035398,0.690265487,13100
fb4edfa0d6ac72b4a1949739c78bd3c6b3d0de28,0,exceptionfactory,2021-08-11 12:01:07-05:00,['5106197b3b5cb439d0ba486216ce800ba917c6b5'],47,697,744,4262853,26,0.627840909,0.801136364,0.928977273,13102
4c6bd856c010253df3a14084a5e0f8dfde70b190,0,exceptionfactory,2021-08-12 17:39:42-05:00,['fb4edfa0d6ac72b4a1949739c78bd3c6b3d0de28'],361,361,722,4263575,34,1,0,0.111111111,13102
714670b8e660772613184d5f64c09936def71268,0,exceptionfactory,2021-08-13 10:54:48-05:00,['4c6bd856c010253df3a14084a5e0f8dfde70b190'],194,740,934,4264509,15,0.648809524,0.857142857,1,13106
c3ecf2fea841c8e6971290bd5ea6b6c0d92f4632,1,Tamas Palfy,2021-08-17 16:57:27+02:00,['714670b8e660772613184d5f64c09936def71268'],425,431,856,4265365,8,1,1,0.953125,13106
1ce897f43ab55718820cfed72db2a94583741667,0,GitHub,2021-08-18 15:54:57-04:00,['c3ecf2fea841c8e6971290bd5ea6b6c0d92f4632'],1,73,74,4265439,3,,,,13106
fc1fa3f32c0a734e04817b8f241453f5b504bed1,0,exceptionfactory,2021-08-18 18:29:06-05:00,['1ce897f43ab55718820cfed72db2a94583741667'],0,4,4,4265443,1,,,,13106
21c2fb95d3c73f6fb512bca3ddd0adfa02b388e5,1,exceptionfactory,2021-08-18 19:54:56-05:00,['fc1fa3f32c0a734e04817b8f241453f5b504bed1'],82,1795,1877,4267320,46,0.475655431,0.786516854,0.941947566,13124
c2c3727dd5914fb8e3800723067caf91935919c2,0,GitHub,2021-08-19 09:52:16-04:00,['21c2fb95d3c73f6fb512bca3ddd0adfa02b388e5'],10,128,138,4267458,6,1,0,0,13125
388b79d1ee48f532b726872c0a21fb9f6284baca,0,GitHub,2021-08-19 09:57:17-04:00,['c2c3727dd5914fb8e3800723067caf91935919c2'],10,10,20,4267478,2,,1,,13125
9bcbf83e5a73ec471f2dcf081e7ca4ed00b45eb2,1,Tamas Palfy,2021-08-19 18:09:58+02:00,['388b79d1ee48f532b726872c0a21fb9f6284baca'],85,293,378,4267856,5,0.833333333,0.988095238,1,13126
a652280fbb45c94b6ba9be5e7f4f9cd8c708f5ca,1,Nathan Gough,2021-08-19 12:26:12-04:00,['9bcbf83e5a73ec471f2dcf081e7ca4ed00b45eb2'],3137,3038,6175,4274031,85,1,0.163461538,0,13162
9ebdd4bdf1d15586d1d1415551467ee0650cc0b0,0,GitHub,2021-08-24 14:38:16+02:00,['a652280fbb45c94b6ba9be5e7f4f9cd8c708f5ca'],57,272,329,4274360,10,0.429487179,0.916666667,1,13163
1d1b805f0406130b478836c0defd516e83561185,0,GitHub,2021-08-24 16:34:58+02:00,['9ebdd4bdf1d15586d1d1415551467ee0650cc0b0'],0,3,3,4274363,1,,,,13163
aa5babbb9738bd3737a65e1678e064bd159fe95c,0,exceptionfactory,2021-08-24 10:37:07-05:00,['1d1b805f0406130b478836c0defd516e83561185'],5,32,37,4274400,5,,,,13164
73062146c6b3e2f388055b2613adf3e8e21d4825,0,Tamas Palfy,2021-08-25 19:18:48+02:00,['aa5babbb9738bd3737a65e1678e064bd159fe95c'],6,17,23,4274423,1,0,0,0.666666667,13164
0cf09840eabd6131be8a9a928c1b2e7df03eb0ee,0,GitHub,2021-08-26 21:12:34+02:00,['73062146c6b3e2f388055b2613adf3e8e21d4825'],48,107,155,4274578,8,0.34375,1,0.9375,13164
ee7ca5dcfd260ed502a82af7f19f7be870e29f7b,0,Mike Thomsen,2021-08-27 10:07:58-04:00,['0cf09840eabd6131be8a9a928c1b2e7df03eb0ee'],1,1,2,4274580,1,,,,13164
ed4d4d59388ebedd9df17c9c457130b8764e4624,0,Nathan Gough,2021-08-27 12:29:16-04:00,['ee7ca5dcfd260ed502a82af7f19f7be870e29f7b'],63,52,115,4274695,1,,,,13164
4ccb2b6b4acc83fb86b7021ddadcadade6043490,1,Nathan Gough,2021-08-27 16:58:52-04:00,['ed4d4d59388ebedd9df17c9c457130b8764e4624'],40,160,200,4274895,22,0.49122807,0.929824561,1,13165
e436381c3afb9585c8c6299eddb1e71dcb7666f1,0,exceptionfactory,2021-08-27 17:41:58-05:00,['4ccb2b6b4acc83fb86b7021ddadcadade6043490'],162,452,614,4275509,26,0.123529412,0.947058824,1,13166
d90ef0675290f8d7cdb07bf33be3a1e01576145a,0,GitHub,2021-08-27 21:37:06-04:00,['e436381c3afb9585c8c6299eddb1e71dcb7666f1'],9,158,167,4275676,4,0,0.91011236,0.966292135,13166
60b08cc5695da73496710e062ef2a8ac889700db,0,Mike Thomsen,2021-08-28 08:34:29-04:00,['d90ef0675290f8d7cdb07bf33be3a1e01576145a'],388,325,713,4276389,13,0.186046512,0,0.395348837,13166
4a3e81531be2d631ac7fc4f83fa93c247d711f7b,1,GitHub,2021-08-30 10:44:31-04:00,['60b08cc5695da73496710e062ef2a8ac889700db'],182,2418,2600,4278989,64,0.371818182,0.732727273,0.760909091,13173
59f0b6bac3dd95cef1030ade3ebd2d647a677feb,0,GitHub,2021-08-30 11:26:02-04:00,['4a3e81531be2d631ac7fc4f83fa93c247d711f7b'],82,207,289,4279278,21,0.960784314,0.725490196,0,13174
2ab23efb743e004f67d30431a3f264d1a54f3611,0,exceptionfactory,2021-08-30 19:15:34-05:00,['59f0b6bac3dd95cef1030ade3ebd2d647a677feb'],34,534,568,4279846,16,0.754098361,0.989071038,1,13178
758e1850ed0e4af5063877c7e3a56628e5e7ed78,1,Matthew Burgess,2021-08-31 10:40:57-04:00,['2ab23efb743e004f67d30431a3f264d1a54f3611'],159,149,308,4280154,11,1,0,0,13178
dfa6592a478669e928870207bcee3987bf480d51,1,Matthew Burgess,2021-08-31 13:33:53-04:00,['758e1850ed0e4af5063877c7e3a56628e5e7ed78'],149,159,308,4280462,11,0,1,1,13178
20804ff2b1d8258cdd9f37f81b5dee4fd67feb57,1,Matthew Burgess,2021-08-31 16:07:53-04:00,['dfa6592a478669e928870207bcee3987bf480d51'],159,169,328,4280790,11,1,0,0,13178
d702506f0de6c5818bdbfec56055f95dbf79142b,1,exceptionfactory,2021-09-06 09:42:36-05:00,['20804ff2b1d8258cdd9f37f81b5dee4fd67feb57'],408,241,649,4281439,27,1,0,0,13178
05adcbcc615bc204120d9e5cfa613b4ac5450872,0,exceptionfactory,2021-09-06 17:03:46-05:00,['d702506f0de6c5818bdbfec56055f95dbf79142b'],2,2,4,4281443,2,,,,13178
fa79571e309b117d86fced82d7a962ffaad5e06a,0,Tamas Palfy,2021-09-07 16:50:35+02:00,['05adcbcc615bc204120d9e5cfa613b4ac5450872'],79,126,205,4281648,3,0,0.6875,0.4375,13178
f5a421ccb13e853d89f1fa3e648d49b62a19e3ed,1,Mike Thomsen,2021-09-07 13:27:53-04:00,['fa79571e309b117d86fced82d7a962ffaad5e06a'],460,244,704,4282352,55,,,,13178
2c5cf8ba0a97375d41b0ef2feb8a9b9ed3a66753,1,Mike Thomsen,2021-09-07 13:33:15-04:00,['f5a421ccb13e853d89f1fa3e648d49b62a19e3ed'],789,328,1117,4283469,20,0.855319149,0.106382979,0.025531915,13178
acb25c1130a4a329141dc09750d6a79d2f5a3315,0,Mike Thomsen,2021-09-07 16:24:57-04:00,['2c5cf8ba0a97375d41b0ef2feb8a9b9ed3a66753'],0,63,63,4283532,11,,,,13178
6ce9919a1fa9733be43b726ecd85fc6dc4845f56,0,Mike Thomsen,2021-09-08 06:46:26-04:00,['acb25c1130a4a329141dc09750d6a79d2f5a3315'],0,3,3,4283535,2,0,1,1,13178
cbc25aa1802b823ddea40c8bd36d0a0813419a52,0,Mike Thomsen,2021-09-08 06:46:48-04:00,['6ce9919a1fa9733be43b726ecd85fc6dc4845f56'],2,2,4,4283539,1,,,,13178
98e3b465c3f94bf693b57808b05cc715fba18855,1,Mike Thomsen,2021-09-08 09:11:26-04:00,['cbc25aa1802b823ddea40c8bd36d0a0813419a52'],11,51,62,4283601,2,1,1,0.958333333,13178
0a9a8aa1906d84e1b16d80b5e1dd50ba6af53ccf,0,Mike Thomsen,2021-09-08 11:51:33-04:00,['98e3b465c3f94bf693b57808b05cc715fba18855'],3,3,6,4283607,3,,,,13178
6e059ef7c6175e9fea7d2fc787810bed60c6393d,0,GitHub,2021-09-08 16:48:42-04:00,['0a9a8aa1906d84e1b16d80b5e1dd50ba6af53ccf'],3,12,15,4283622,4,,,,13178
d96398feb89a77a27370c47e7e52d7f90721193e,0,Peter Turcsanyi,2021-09-09 09:45:57+02:00,['6e059ef7c6175e9fea7d2fc787810bed60c6393d'],36,91,127,4283749,4,1,1,1,13178
977800b8350d396ba2319a3c54d2ce10812f5584,0,Mike Thomsen,2021-09-11 12:44:29-04:00,['d96398feb89a77a27370c47e7e52d7f90721193e'],6,14,20,4283769,4,,,,13178
6a55c6ca447ea902e454daf29eb9d17720310219,0,exceptionfactory,2021-09-11 14:57:38-05:00,['977800b8350d396ba2319a3c54d2ce10812f5584'],187,167,354,4284123,19,0.181818182,0,0,13178
5e2ec9b4543fe06accbeefa22cf09572a01e28cf,0,exceptionfactory,2021-09-11 16:45:21-05:00,['6a55c6ca447ea902e454daf29eb9d17720310219'],22,203,225,4284348,15,1,1,1,13179
3fbd9c9e1431371aa3ec4e5a2cbf45ea7d733a25,0,GitHub,2021-09-13 11:04:39-04:00,['5e2ec9b4543fe06accbeefa22cf09572a01e28cf'],3,5,8,4284356,1,0,1,1,13179
38a1f476e3ecf425d7fd333e04c262d009bf2c96,0,GitHub,2021-09-13 19:19:19+02:00,['3fbd9c9e1431371aa3ec4e5a2cbf45ea7d733a25'],1,15,16,4284372,1,,,,13179
73f88b3239f3177006635906a946b838551bb4cf,0,GitHub,2021-09-13 14:36:35-04:00,['38a1f476e3ecf425d7fd333e04c262d009bf2c96'],82,194,276,4284648,20,0.153846154,0.128205128,0.153846154,13180
bb638b13aa64369114ef57b5ba663bbf41aa71ab,0,Mike Thomsen,2021-09-14 15:19:18-04:00,['73f88b3239f3177006635906a946b838551bb4cf'],0,6,6,4284654,1,,,,13180
4af3fac07a521b8334b36e55ad9b4929e182c3d8,0,GitHub,2021-09-15 15:40:33-04:00,['bb638b13aa64369114ef57b5ba663bbf41aa71ab'],32,41,73,4284727,1,1,1,1,13180
1ab47ce931eb2ded7a5d09b492d8ad551f4cd188,1,exceptionfactory,2021-09-16 09:38:49-05:00,['4af3fac07a521b8334b36e55ad9b4929e182c3d8'],13,214,227,4284954,14,0.961538462,1,0.653846154,13182
229f45997d7e4e07e7ad95196b2ee1fd0a886365,0,Peter Turcsanyi,2021-09-17 16:24:04+02:00,['1ab47ce931eb2ded7a5d09b492d8ad551f4cd188'],8,195,203,4285157,5,0,0.926315789,0.926315789,13184
3df2fff6e0ee35dd664568046dd0b803c62a9998,0,exceptionfactory,2021-09-17 12:26:07-05:00,['229f45997d7e4e07e7ad95196b2ee1fd0a886365'],0,603,603,4285760,11,0.661764706,1,1,13192
6f87865e27f5043f51abdcfdb678834206fda74d,0,Joe Gresock,2021-09-18 07:42:42-04:00,['3df2fff6e0ee35dd664568046dd0b803c62a9998'],3,30,33,4285793,2,,,,13192
1374f66f093dd049f0824f3e73625e0b27cc7ce4,0,Pierre Villard,2021-09-18 14:55:42+02:00,['6f87865e27f5043f51abdcfdb678834206fda74d'],23,161,184,4285977,8,0.095744681,0.712765957,1,13192
9dfcba24cde0f0e17699f35f574766d7057db4be,0,Pierre Villard,2021-09-18 15:02:54+02:00,['1374f66f093dd049f0824f3e73625e0b27cc7ce4'],21,13,34,4286011,4,,,,13192
50e60c812d6b73137a1ffb178c4c903f66203f49,0,Pierre Villard,2021-09-18 15:08:02+02:00,['9dfcba24cde0f0e17699f35f574766d7057db4be'],1,67,68,4286079,2,0,0.743589744,1,13192
1fdae088cf909a141a7093fff0726a75ef7381a5,0,Pierre Villard,2021-09-18 15:13:24+02:00,['50e60c812d6b73137a1ffb178c4c903f66203f49'],1,1,2,4286081,1,,,,13192
d97bec63edb4f870423f47a465704008a6e2a7ec,0,Pierre Villard,2021-09-18 15:17:06+02:00,['1fdae088cf909a141a7093fff0726a75ef7381a5'],1,1,2,4286083,1,,,,13192
d70359d3e8c590de4c93b1fac4665e62d9c9230f,0,exceptionfactory,2021-09-18 09:08:18-05:00,['d97bec63edb4f870423f47a465704008a6e2a7ec'],0,12,12,4286095,4,0,0.75,1,13192
2e998839eb50fe873b0487bed73049b6e878e75c,0,exceptionfactory,2021-09-20 07:43:56-05:00,['d70359d3e8c590de4c93b1fac4665e62d9c9230f'],2,4,6,4286101,1,,,,13192
ba775d28deeaa8d0a5a40b7c24fff72ae01d1706,0,Matthew Burgess,2021-09-21 11:06:19-04:00,['2e998839eb50fe873b0487bed73049b6e878e75c'],2525,395,2920,4289021,74,0.580327869,0,0.003278689,13192
e78674ec596bdd806b06a24a63be7714e1572390,0,Nathan Gough,2021-09-21 15:47:19-04:00,['ba775d28deeaa8d0a5a40b7c24fff72ae01d1706'],914,1138,2052,4291073,23,0,0,0,13203
b4e0416b5ea57213e23ee95299f8db58c276155f,0,Matthew Burgess,2021-09-21 16:07:13-04:00,['e78674ec596bdd806b06a24a63be7714e1572390'],945,777,1722,4292795,43,0.830388693,1,0.982332155,13207
4240a9f28508fc09a77491dca2b3305014720273,0,Pierre Villard,2021-09-22 19:49:32+02:00,['b4e0416b5ea57213e23ee95299f8db58c276155f'],47,130,177,4292972,3,0.463414634,0.853658537,1,13207
baf29e59f1ce06b17164304e69173ae85bf5f121,1,Joe Gresock,2021-09-22 19:00:23-04:00,['4240a9f28508fc09a77491dca2b3305014720273'],222,5086,5308,4298280,108,0.404494382,0.642247191,0.713707865,13234
e29c8af70892715a71940a09fc7911ecbe60adab,0,exceptionfactory,2021-09-22 18:54:32-05:00,['baf29e59f1ce06b17164304e69173ae85bf5f121'],5,97,102,4298382,4,0.9,0.9,1,13236
4a5fe698f71743d413e8342494abf33fb58001ad,0,Peter Turcsanyi,2021-09-23 14:25:54+02:00,['e29c8af70892715a71940a09fc7911ecbe60adab'],4,4,8,4298390,4,,,,13236
db5b618550dd061711295f5cae8abe5f0fb4d0f0,0,Mark Payne,2021-09-23 09:13:36-04:00,['4a5fe698f71743d413e8342494abf33fb58001ad'],218,2334,2552,4300942,20,0.548828125,0.673828125,0.6640625,13254
5b7af511fc1187676d5e0eefe7c3899ef102246d,0,Mark Payne,2021-09-23 09:14:00-04:00,['db5b618550dd061711295f5cae8abe5f0fb4d0f0'],17,17,34,4300976,4,,,,13254
84dbf915a9b55100ad631305fa5f1b86e578a0b8,1,Nathan Gough,2021-09-23 18:03:48-04:00,['5b7af511fc1187676d5e0eefe7c3899ef102246d'],187,572,759,4301735,17,1,1,0.55,13258
2d7e9c1c9a4b59bf7609564f2d67e618e4283862,0,Pierre Villard,2021-09-24 11:08:19+02:00,['84dbf915a9b55100ad631305fa5f1b86e578a0b8'],53,32,85,4301820,16,,,,13258
30cf49db7eb6442c40a11dee7e31f545386f169c,0,Pierre Villard,2021-09-26 11:48:18+02:00,['2d7e9c1c9a4b59bf7609564f2d67e618e4283862'],2,44,46,4301866,3,0,0.909090909,1,13258
bf7d1ffa1bd90a9d0539a3b4608e2bc362fc4849,0,Pierre Villard,2021-09-27 10:08:00+02:00,['30cf49db7eb6442c40a11dee7e31f545386f169c'],12,90,102,4301968,3,0.772727273,0.772727273,1,13258
3a8da7b33e2973e0bee58b4d47a814dc92b14a99,0,Pierre Villard,2021-09-27 10:09:57+02:00,['bf7d1ffa1bd90a9d0539a3b4608e2bc362fc4849'],13,71,84,4302052,4,0,0.605263158,1,13258
2ae4f908f5f8708572a2a49c5ccdb9f6bb5f59b3,0,Pierre Villard,2021-09-27 10:12:31+02:00,['3a8da7b33e2973e0bee58b4d47a814dc92b14a99'],8,164,172,4302224,7,0.173913043,0.565217391,1,13258
38d26dafa36888826b1017f9f36725628dc40430,1,Matthew Burgess,2021-09-27 16:27:39-04:00,['2ae4f908f5f8708572a2a49c5ccdb9f6bb5f59b3'],127,641,768,4302992,4,0.855113636,0.997159091,0.556818182,13258
720e7ef353ac2a62836f8b5ac8b4df3422e602d9,1,exceptionfactory,2021-09-27 21:00:58-05:00,['38d26dafa36888826b1017f9f36725628dc40430'],889,2816,3705,4306697,35,1,0.88592233,1,13285
fa2be2ee63f0e6e62ac35593e0d7540648f72363,0,Matthew Burgess,2021-09-27 22:11:29-04:00,['720e7ef353ac2a62836f8b5ac8b4df3422e602d9'],1,1,2,4306699,1,,,,13285
6ef638d13d430e02b368d3566f47ae4e8fd7db08,0,Pierre Villard,2021-09-28 19:23:19+02:00,['fa2be2ee63f0e6e62ac35593e0d7540648f72363'],0,13,13,4306712,1,1,1,1,13285
efc1cb012f95a625e7ae64a56dd733912e53c4a8,0,Joe Witt,2021-09-29 11:02:41-07:00,['6ef638d13d430e02b368d3566f47ae4e8fd7db08'],4,210,214,4306926,2,0.091549296,1,1,13285
46a5e3f0968ae16d32b378cd422293e7ad4713bf,1,exceptionfactory,2021-09-29 13:48:08-05:00,['efc1cb012f95a625e7ae64a56dd733912e53c4a8'],33,126,159,4307085,10,0.407407407,0.962962963,0.925925926,13285
be57a210ffb2e3e3eefccabfe7100edaf2e9a43b,0,GitHub,2021-09-29 17:04:35-04:00,['46a5e3f0968ae16d32b378cd422293e7ad4713bf'],194,699,893,4307978,11,0.90776699,1,0.912621359,13285
1379674240f390ba5f6e345d65bf5b2a591cd4ad,0,GitHub,2021-09-29 18:16:47-04:00,['be57a210ffb2e3e3eefccabfe7100edaf2e9a43b'],5,16,21,4307999,1,0,0,0,13285
e16a6c2b89879034be65cca56b33724914b54033,0,Nathan Gough,2021-09-30 20:36:15-04:00,['1379674240f390ba5f6e345d65bf5b2a591cd4ad'],500,631,1131,4309130,23,1,1,0.976744186,13289
494356052139080442bdab0c45e91f41439e4b57,1,Pierre Villard,2021-10-01 09:24:46+02:00,['e16a6c2b89879034be65cca56b33724914b54033'],101,101,202,4309332,8,0.833333333,0,1,13289
24c0c39ebb84648ae753e0e9756d7dcce08abfeb,0,Pierre Villard,2021-10-01 09:29:02+02:00,['494356052139080442bdab0c45e91f41439e4b57'],1,62,63,4309395,2,0,0.769230769,1,13289
a94b47ecf8d97778c7375e34d07964a6ab326cc5,0,Joe Gresock,2021-10-01 15:55:06-04:00,['24c0c39ebb84648ae753e0e9756d7dcce08abfeb'],19,140,159,4309554,4,0.631578947,0.964912281,1,13290
00b2358c278a5cde6b524ffb753762cdb38c1608,0,Joe Gresock,2021-10-01 22:20:13-04:00,['a94b47ecf8d97778c7375e34d07964a6ab326cc5'],144,1,145,4309699,129,0.272727273,0,0,13290
ae0154de5af5862ea913ccd59b75a04edf5d2666,0,Pierre Villard,2021-10-02 18:26:40+02:00,['00b2358c278a5cde6b524ffb753762cdb38c1608'],6,6,12,4309711,6,,,,13290
defea610754a53abe71a2edd00c5485646d424f3,0,Pierre Villard,2021-10-02 18:31:05+02:00,['ae0154de5af5862ea913ccd59b75a04edf5d2666'],147,166,313,4310024,3,1,1,1,13290
cacd6bb88adea2889ddbeadb83299114e45cefae,0,Pierre Villard,2021-10-03 10:54:30+02:00,['defea610754a53abe71a2edd00c5485646d424f3'],2,2,4,4310028,2,,,,13290
72660af479d726061eb76854398cb88ae4f25c30,1,GitHub,2021-10-04 09:14:36+02:00,['cacd6bb88adea2889ddbeadb83299114e45cefae'],4,281,285,4310313,2,0.039473684,0.710526316,0.710526316,13290
a675023b71fc8ffcb9bc2c73dd29abed7cd9f3c6,0,Joe Gresock,2021-10-04 14:22:39-04:00,['72660af479d726061eb76854398cb88ae4f25c30'],9,85,94,4310407,3,0,1,1,13291
525a1859a79cae4344e29a8c3f0ae71e3b1fd7c7,0,Joe Gresock,2021-10-04 14:24:46-04:00,['a675023b71fc8ffcb9bc2c73dd29abed7cd9f3c6'],19,1,20,4310427,2,,,,13291
607480c1a0f8153f7d1a6470a7b797e3eaed5eb4,1,Joe Gresock,2021-10-04 15:32:21-04:00,['525a1859a79cae4344e29a8c3f0ae71e3b1fd7c7'],432,4058,4490,4314917,94,0.345425868,0.600946372,0.735804416,13320
3a63bd579e059763c21c0b8355d8686ec5c222d4,1,Joe Gresock,2021-10-04 19:27:12-04:00,['607480c1a0f8153f7d1a6470a7b797e3eaed5eb4'],731,3504,4235,4319152,39,0.540642722,0.894139887,0.56710775,13335
36f8b6a200c5fa2be9637baa89a0b171be9f2d51,0,Pierre Villard,2021-10-05 09:51:25+02:00,['3a63bd579e059763c21c0b8355d8686ec5c222d4'],1,16,17,4319169,1,,,,13335
2f36159a2102d50bc73425d8265dbc79f7c74381,0,Pierre Villard,2021-10-05 09:56:03+02:00,['36f8b6a200c5fa2be9637baa89a0b171be9f2d51'],0,8,8,4319177,2,,,,13335
d6805abf9bc9d32c138f12fdc33e39da8e1c5fff,1,exceptionfactory,2021-10-05 13:04:33-05:00,['2f36159a2102d50bc73425d8265dbc79f7c74381'],3,154,157,4319334,3,0.157894737,0.810526316,1,13335
fe423263350439971a75d519f66e278d1286bcc5,0,Pierre Villard,2021-10-06 09:40:27+02:00,['d6805abf9bc9d32c138f12fdc33e39da8e1c5fff'],0,18,18,4319352,1,,,,13336
4bcd03024a419afdf40d464bda716f0b9d21925b,0,Joe Gresock,2021-10-06 11:17:36-04:00,['fe423263350439971a75d519f66e278d1286bcc5'],439,512,951,4320303,59,0,0,0,13336
9d578e63fd4f402183b54ac0aba93919819192e7,0,Joe Gresock,2021-10-07 05:32:39-04:00,['4bcd03024a419afdf40d464bda716f0b9d21925b'],1,75,76,4320379,11,,,,13336
3892e50991ff803b762c26aec6067aecacda548e,1,Joe Gresock,2021-10-07 05:58:10-04:00,['9d578e63fd4f402183b54ac0aba93919819192e7'],156,665,821,4321200,6,0.115384615,0.568376068,0.696581197,13336
8d0eec2d620d994c77c01388e7df9cf2a227c3c9,0,Pierre Villard,2021-10-08 10:01:09+02:00,['3892e50991ff803b762c26aec6067aecacda548e'],21,616,637,4321837,15,0.947368421,0.947368421,1,13342
f50c002692d18e6ab427c3664947e8163e7d54ca,1,Joe Gresock,2021-10-08 07:33:49-04:00,['8d0eec2d620d994c77c01388e7df9cf2a227c3c9'],577,1521,2098,4323935,44,1,0.702702703,0.662162162,13350
70432507dfb9d5a477f14bfe8454153b81747df0,1,Joe Gresock,2021-10-08 11:57:10-04:00,['f50c002692d18e6ab427c3664947e8163e7d54ca'],5932,2236,8168,4332103,90,0.5625,0.358870968,0.328629032,13373
f3136f07ebd3609cda715056d72f19fa7bc9e706,0,exceptionfactory,2021-10-08 11:44:43-05:00,['70432507dfb9d5a477f14bfe8454153b81747df0'],97,661,758,4332861,20,0.550925926,0.861111111,1,13378
05407476b44d306820f254fcf880926b1bf297b3,1,GitHub,2021-10-08 16:56:45-04:00,['f3136f07ebd3609cda715056d72f19fa7bc9e706'],0,645,645,4333506,8,0.731818182,1,0.804545455,13383
ebcb1cc0d5935d8325121a16fdc01bfcc1a7790e,0,Scott Aslan,2021-10-11 09:50:58-04:00,['05407476b44d306820f254fcf880926b1bf297b3'],42,42,84,4333590,18,,,,13383
9588758aac4ea90c115dda4448ccaddf72779997,0,exceptionfactory,2021-10-11 10:40:05-05:00,['ebcb1cc0d5935d8325121a16fdc01bfcc1a7790e'],7,48,55,4333645,4,0.04,0.96,1,13383
650da75f2dbaa15cc10bd64fe102ef0f6d7c8bc3,0,Scott Aslan,2021-10-11 16:15:21-04:00,['9588758aac4ea90c115dda4448ccaddf72779997'],138,150,288,4333933,2,0,1,1,13383
231dd57e11d455c7015bafba2c0657b8f6921306,0,Joe Gresock,2021-10-12 07:32:42-04:00,['650da75f2dbaa15cc10bd64fe102ef0f6d7c8bc3'],4,42,46,4333979,2,1,1,0.681818182,13383
15c1fd11506703595d846538c3eaa6046f657e15,1,Pierre Villard,2021-10-12 16:16:58+02:00,['231dd57e11d455c7015bafba2c0657b8f6921306'],14,112,126,4334105,5,0,0.5,0.357142857,13383
f7df3265215cfe74769b908db1d3298c7529ba00,1,Tamas Palfy,2021-10-12 16:35:20+02:00,['15c1fd11506703595d846538c3eaa6046f657e15'],90,601,691,4334796,27,0.429378531,0.723163842,0.95480226,13390
e681d4767a4d461cd0c0011d88dbc57e27322b4a,0,GitHub,2021-10-12 11:21:23-04:00,['f7df3265215cfe74769b908db1d3298c7529ba00'],6,101,107,4334903,4,1,1,1,13391
6d3a7539ebbdbbe94bf859bf1c780173321f9193,0,Scott Aslan,2021-10-12 15:35:26-04:00,['e681d4767a4d461cd0c0011d88dbc57e27322b4a'],1,1,2,4334905,1,,,,13391
1b69c1f9f1f7fea5360744154596426d2fcd9eb9,0,GitHub,2021-10-13 12:14:01-04:00,['6d3a7539ebbdbbe94bf859bf1c780173321f9193'],10,193,203,4335108,3,0.670731707,1,0.865853659,13392
507a8f5bc3ca8ad05b08c43c278ca407220a3cd6,0,GitHub,2021-10-13 21:10:19-04:00,['1b69c1f9f1f7fea5360744154596426d2fcd9eb9'],1,2,3,4335111,1,,,,13392
32c7d856c8fd591ce85fff21c47ec7dec0a12a63,0,GitHub,2021-10-14 10:46:15-04:00,['507a8f5bc3ca8ad05b08c43c278ca407220a3cd6'],9,7,16,4335127,1,0,0,0,13392
0147b15e3718331405ac77480ce3b569842df869,0,Pierre Villard,2021-10-15 11:36:45+02:00,['32c7d856c8fd591ce85fff21c47ec7dec0a12a63'],1,1,2,4335129,1,,,,13392
207894ebe007a2c7de658f9faad2a7f899f3655a,0,Tamas Palfy,2021-10-15 18:27:53+02:00,['0147b15e3718331405ac77480ce3b569842df869'],97,263,360,4335489,4,1,1,0.723076923,13393
151a9361facfe8d0a71203584b7bf4330e8e8f38,1,Joe Gresock,2021-10-18 11:42:47-04:00,['207894ebe007a2c7de658f9faad2a7f899f3655a'],579,578,1157,4336646,35,0,0,1,13394
d722b820a18836b13df5fb5d85b62f07e5979720,0,Matthew Burgess,2021-10-18 11:55:43-04:00,['151a9361facfe8d0a71203584b7bf4330e8e8f38'],0,83,83,4336729,1,,,,13394
be2b80d9094beeb3a2fa2b6a0ecbee2eb8b0935d,1,Joe Gresock,2021-10-18 12:22:12-04:00,['d722b820a18836b13df5fb5d85b62f07e5979720'],36,279,315,4337044,19,0.632,0.872,0.968,13395
70274ebcfc08103fd25d23903468a55fb51b27ed,0,Pierre Villard,2021-10-19 11:26:37+02:00,['be2b80d9094beeb3a2fa2b6a0ecbee2eb8b0935d'],24,24,48,4337092,16,,,,13395
da1b1dfd4be1e7e2ac5096eedbc954da95f713a8,0,Joe Gresock,2021-10-19 06:47:21-04:00,['70274ebcfc08103fd25d23903468a55fb51b27ed'],122,2008,2130,4339222,18,0.75491481,0.914809961,0.850589777,13407
4bcfc615636ef2491847288656b816c752957d37,0,Pierre Villard,2021-10-19 16:48:15+02:00,['da1b1dfd4be1e7e2ac5096eedbc954da95f713a8'],4,4,8,4339230,2,,,,13407
2268daf681eb9d1143dc5e254231d5295f0ca7df,0,Pierre Villard,2021-10-19 17:04:26+02:00,['4bcfc615636ef2491847288656b816c752957d37'],1,0,1,4339231,1,,,,13407
a380fb29649708f04ed7049402dee693cd76d4be,0,Pierre Villard,2021-10-19 17:25:17+02:00,['2268daf681eb9d1143dc5e254231d5295f0ca7df'],1,1,2,4339233,1,,,,13407
90ae271692af69b2be99f32388a3088e19ef1cdd,0,GitHub,2021-10-20 11:07:17-04:00,['a380fb29649708f04ed7049402dee693cd76d4be'],23,68,91,4339324,9,0.555555556,0.555555556,0.972222222,13407
51c6910510345b6d721a7730692baf4b31ee7dc2,0,Scott Aslan,2021-10-20 16:47:21-04:00,['90ae271692af69b2be99f32388a3088e19ef1cdd'],2,2,4,4339328,2,,,,13407
1e2783ba63c3b19093e0b594d8dfa1455e633ce0,0,Pierre Villard,2021-10-21 10:55:54+02:00,['51c6910510345b6d721a7730692baf4b31ee7dc2'],20,12,32,4339360,4,1,1,0,13407
1133ed1e839974d7c3232b186b0c64ef6f3addbd,0,Pierre Villard,2021-10-21 10:58:07+02:00,['1e2783ba63c3b19093e0b594d8dfa1455e633ce0'],0,0,0,4339360,1,,,,13407
66b5fd1c6d1242bcbcdef8ac07bc437f47141556,0,Pierre Villard,2021-10-21 11:00:27+02:00,['1133ed1e839974d7c3232b186b0c64ef6f3addbd'],3,47,50,4339410,14,,,,13413
8e1b7629985bf2d03efa54450bbfd6407dcdbbe1,0,Pierre Villard,2021-10-21 11:02:20+02:00,['66b5fd1c6d1242bcbcdef8ac07bc437f47141556'],10,10,20,4339430,2,,,,13413
1bec905890b73972d93fac6c3c0d087bb79a69a3,0,Scott Aslan,2021-10-21 10:06:58-04:00,['8e1b7629985bf2d03efa54450bbfd6407dcdbbe1'],50,1231,1281,4340711,17,0.537517053,1,0.934515689,13416
d2f8f97b10a3e5f45d31cebf743e5240ca215b85,1,GitHub,2021-10-21 12:22:50-04:00,['1bec905890b73972d93fac6c3c0d087bb79a69a3'],244,571,815,4341526,17,0.302884615,0.586538462,0,13416
207da405eeb47ea5848c0951b3108c7742752d25,0,Nathan Gough,2021-10-21 16:43:53-04:00,['d2f8f97b10a3e5f45d31cebf743e5240ca215b85'],50,156,206,4341732,6,0.896551724,1,0.75862069,13416
77c6f0a819d2b52d986042ab7dd5bed6ca500ae5,0,Pierre Villard,2021-10-22 09:50:38+02:00,['207da405eeb47ea5848c0951b3108c7742752d25'],26,26,52,4341784,3,,,,13416
f7e4e52caf51e00139fab6f46317d705041ca95f,0,Pierre Villard,2021-10-22 09:52:17+02:00,['77c6f0a819d2b52d986042ab7dd5bed6ca500ae5'],1,1,2,4341786,1,,,,13416
5766d33fce1093fc4c532a684bc1d2e8410b09c4,1,GitHub,2021-10-23 19:42:31-04:00,['f7e4e52caf51e00139fab6f46317d705041ca95f'],218,284,502,4342288,17,1,1,0,13416
8fe7f372d6231a138da7e96b94ce642d0f1ae5b1,0,GitHub,2021-10-25 14:37:39+02:00,['5766d33fce1093fc4c532a684bc1d2e8410b09c4'],1,45,46,4342334,2,0.047619048,0.952380952,1,13416
309ab8f4ab1dafdd2386ba9f2d17376bc75b691e,0,exceptionfactory,2021-10-25 15:53:58-05:00,['8fe7f372d6231a138da7e96b94ce642d0f1ae5b1'],977,1174,2151,4344485,33,1,0,0,13427
8d513c5ed37b95cc84416fe4f3f6b609e7117dcb,1,exceptionfactory,2021-10-25 21:07:54-05:00,['309ab8f4ab1dafdd2386ba9f2d17376bc75b691e'],1852,1257,3109,4347594,110,0.897009967,0.548172757,0,13428
7b2f364cf556bc90a34622d90bc3f5ffd02a0c81,0,Pierre Villard,2021-10-26 09:56:28+02:00,['8d513c5ed37b95cc84416fe4f3f6b609e7117dcb'],3,103,106,4347700,3,1,1,1,13429
a9af5d34651318f938a12461cb5524bca17cb750,0,Pierre Villard,2021-10-26 09:59:08+02:00,['7b2f364cf556bc90a34622d90bc3f5ffd02a0c81'],127,28,155,4347855,5,,,,13429
27da172f4e9e557ef07bb3647a8f7f14a18f9579,1,GitHub,2021-10-26 10:22:50-04:00,['a9af5d34651318f938a12461cb5524bca17cb750'],2,16,18,4347873,1,,,,13429
8506a6012ffa1591f6a8895460f47dad8efa4599,0,GitHub,2021-10-26 11:25:52-04:00,['27da172f4e9e557ef07bb3647a8f7f14a18f9579'],0,1,1,4347874,1,,,,13429
1191e511a5306d6c23ed0b289db85c11c0373690,1,Matthew Burgess,2021-10-26 12:15:54-04:00,['8506a6012ffa1591f6a8895460f47dad8efa4599'],2,33,35,4347909,2,0.608695652,0.608695652,0.608695652,13429
d7e41e2005724fb5aed0e5dbab5a3036c45a85bd,0,exceptionfactory,2021-10-26 11:17:33-05:00,['1191e511a5306d6c23ed0b289db85c11c0373690'],18,63,81,4347990,2,0.806451613,0.806451613,1,13429
67ccdf615923b9bd7dced04ddf5ce8de46d6ae11,0,Pierre Villard,2021-10-26 19:44:56+02:00,['d7e41e2005724fb5aed0e5dbab5a3036c45a85bd'],2,31,33,4348023,3,0.7,1,1,13429
30efcd35e438f409b050e780213ad180fe9b296b,0,exceptionfactory,2021-10-26 16:14:55-05:00,['67ccdf615923b9bd7dced04ddf5ce8de46d6ae11'],39,108,147,4348170,14,0,0,1,13429
0eee70c4b90884c90510dc17dae41251fa69b384,0,Nathan Gough,2021-10-27 11:40:30-04:00,['30efcd35e438f409b050e780213ad180fe9b296b'],2,3,5,4348175,1,,,,13429
ca530f40d8ef25a7c6834c96de982accb75368ee,1,GitHub,2021-10-27 13:47:58-04:00,['0eee70c4b90884c90510dc17dae41251fa69b384'],37,92,129,4348304,3,0.189189189,0,0.513513514,13429
104078868ed2e90eca805b9bddc6e7f02c29851c,1,GitHub,2021-10-27 14:40:17-04:00,['ca530f40d8ef25a7c6834c96de982accb75368ee'],46,194,240,4348544,18,0.56,1,0.56,13429
059f14fd62508cd44e2c724f81256d37f90aa2e2,1,GitHub,2021-10-27 16:06:30-04:00,['104078868ed2e90eca805b9bddc6e7f02c29851c'],525,711,1236,4349780,31,1,1,1,13429
3114bdb70121b444208a39959c6567a378a775e6,0,Matthew Burgess,2021-10-27 17:08:06-04:00,['059f14fd62508cd44e2c724f81256d37f90aa2e2'],1,1,2,4349782,1,,,,13429
60d6d469bff511c8a890209ef60f58034792a5f6,0,Pierre Villard,2021-10-28 09:34:31+02:00,['3114bdb70121b444208a39959c6567a378a775e6'],29,172,201,4349983,27,,,,13429
75d1d7f6e7a6a11dbe404a347937187fbc51b72e,0,Pierre Villard,2021-10-28 10:47:53+02:00,['60d6d469bff511c8a890209ef60f58034792a5f6'],28,48,76,4350059,2,0,1,1,13429
74151eab1f87e12cff01de2744c2cdd1f74ce578,0,Joe Witt,2021-10-28 08:35:45-07:00,['75d1d7f6e7a6a11dbe404a347937187fbc51b72e'],2,2,4,4350063,2,,,,13429
28cd5d1300f9d2c9fd957a9d92a9096b5cd0edfb,0,GitHub,2021-10-28 12:06:56-04:00,['74151eab1f87e12cff01de2744c2cdd1f74ce578'],7,11,18,4350081,3,0,0,1,13429
9865ea2bfbb50682f322377dbd42830c15e5915f,1,Nathan Gough,2021-10-28 12:12:57-04:00,['28cd5d1300f9d2c9fd957a9d92a9096b5cd0edfb'],78,156,234,4350315,6,0.739130435,1,1,13429
16e6045d13452cbff7da9685f0da4e2278a06434,0,Nathan Gough,2021-10-28 13:10:04-04:00,['9865ea2bfbb50682f322377dbd42830c15e5915f'],14,13,27,4350342,1,1,1,0,13429
1c4ee93e687c2396ca07c22ee97bd11af78f68c9,0,Matthew Burgess,2021-10-29 17:25:14-04:00,['16e6045d13452cbff7da9685f0da4e2278a06434'],6,28,34,4350376,4,,,,13429
09feed9df6002e3687e52d109c3dca351e945247,0,exceptionfactory,2021-10-30 11:16:57-05:00,['1c4ee93e687c2396ca07c22ee97bd11af78f68c9'],1,1,2,4350378,1,,,,13429
12edc865f66978db50fa618c3a0a8dd1d3410ee8,0,Joe Gresock,2021-11-01 09:35:36-04:00,['09feed9df6002e3687e52d109c3dca351e945247'],1,1,2,4350380,1,,,,13429
f01fb175553e0d2825e9802f902d116434ead504,0,Scott Aslan,2021-11-01 15:28:54-04:00,['12edc865f66978db50fa618c3a0a8dd1d3410ee8'],6,0,6,4350386,2,,,,13429
362a243e0fe6a2712c38cf3aabab1b79610d9328,0,exceptionfactory,2021-11-02 21:57:03-05:00,['f01fb175553e0d2825e9802f902d116434ead504'],4,12,16,4350402,2,0,0,1,13429
decfad394d3b5fe8e91e9a732966a811119a521a,0,GitHub,2021-11-03 09:25:57-04:00,['362a243e0fe6a2712c38cf3aabab1b79610d9328'],0,4,4,4350406,2,0.5,0.5,1,13429
7fdc07cccdc0e23d4986557a9314e36859704a3b,0,Joe Witt,2021-11-03 08:53:32-07:00,['decfad394d3b5fe8e91e9a732966a811119a521a'],2262,2253,4515,4354921,632,,,,13429
c0558959523cdf8ed28f4ff42594133948bd67f0,1,Joe Witt,2021-11-03 08:53:37-07:00,['7fdc07cccdc0e23d4986557a9314e36859704a3b'],2243,2243,4486,4359407,632,,,,13429
2bd752d868a8f3e36113b078bb576cf054e945e8,0,Matthew Burgess,2021-11-03 15:09:37-04:00,['decfad394d3b5fe8e91e9a732966a811119a521a'],19,212,231,4359638,3,1,1,0.867924528,13430
a9685b36fc65d6a5d62afaebf853d7b40e7b4c1e,0,GitHub,2021-11-04 09:29:11-04:00,['2bd752d868a8f3e36113b078bb576cf054e945e8'],2,0,2,4359640,1,,,,13430
705c65c86cc15b88b27e4e5651c1c0ec319e38f6,0,Matthew Burgess,2021-11-04 13:46:41-04:00,['a9685b36fc65d6a5d62afaebf853d7b40e7b4c1e'],11,55,66,4359706,2,0,0.92,1,13430
9b724df6d94eb40be321cea07dfbabf02092de0f,0,Peter Turcsanyi,2021-11-04 20:19:26+01:00,['705c65c86cc15b88b27e4e5651c1c0ec319e38f6'],19,90,109,4359815,2,0,0.8125,1,13430
373498445fe589e2d4855a0730fbb9127f0b4452,0,Joe Gresock,2021-11-04 16:48:24-04:00,['9b724df6d94eb40be321cea07dfbabf02092de0f'],0,15,15,4359830,1,1,1,0.666666667,13430
9e845d87ff04e8fac38154418d3b73b39ea31ac5,0,Joe Witt,2021-11-07 16:23:10-07:00,"['373498445fe589e2d4855a0730fbb9127f0b4452', 'c0558959523cdf8ed28f4ff42594133948bd67f0']",2262,2253,4515,4364345,632,,,,13430
f86fe0d61ae0310a191e14f7521ef9e3e4d0727c,0,exceptionfactory,2021-11-08 07:40:05-06:00,['9e845d87ff04e8fac38154418d3b73b39ea31ac5'],32,43,75,4364420,1,,,,13430
c96809012b51156872c0446473953f0cf8548f93,1,Joe Gresock,2021-11-08 09:18:10-05:00,['f86fe0d61ae0310a191e14f7521ef9e3e4d0727c'],9,826,835,4365255,17,0.919354839,0.947580645,0.939516129,13440
37c0527a72971051fab48224c7e8800e41e0bb62,1,Joe Gresock,2021-11-08 09:25:35-05:00,['c96809012b51156872c0446473953f0cf8548f93'],46,675,721,4365976,7,0.39862543,0.810996564,0.869415808,13442
8491486181df6bd346b5953b1665d77113d72f5e,0,Matthew Burgess,2021-11-08 13:59:46-05:00,['37c0527a72971051fab48224c7e8800e41e0bb62'],13,202,215,4366191,3,0.1,0.741666667,0.75,13442
f410c8df0a2b05cdf078e3d3f6b086ac7ebed5f9,0,Matthew Burgess,2021-11-08 20:26:30-05:00,['8491486181df6bd346b5953b1665d77113d72f5e'],19,175,194,4366385,6,1,1,1,13442
e906c1d70fcea31a4a797541d23fb95108790165,0,Matthew Burgess,2021-11-08 20:45:25-05:00,['f410c8df0a2b05cdf078e3d3f6b086ac7ebed5f9'],5,179,184,4366569,2,0.719626168,0.719626168,0.345794393,13442
01f9d59ee3f8129eca5f7cd27fac8c66c07a9968,0,Pierre Villard,2021-11-09 11:38:36+01:00,['e906c1d70fcea31a4a797541d23fb95108790165'],31,2602,2633,4369202,28,0.818905473,0.974129353,0.870646766,13460
ca5a92399ac79ab244fc9ee538182164c4c6e0f5,0,exceptionfactory,2021-11-09 08:49:54-06:00,['01f9d59ee3f8129eca5f7cd27fac8c66c07a9968'],0,11,11,4369213,1,,,,13460
9d54fc6a3c48162aac4e6ca93401873755b2f87b,0,Pierre Villard,2021-11-09 15:57:41+01:00,['ca5a92399ac79ab244fc9ee538182164c4c6e0f5'],0,1,1,4369214,1,1,1,0,13460
119ba17bf105f2c057aa5d8f1546867401200856,1,exceptionfactory,2021-11-09 09:50:48-06:00,['9d54fc6a3c48162aac4e6ca93401873755b2f87b'],2,139,141,4369355,3,0.486111111,1,1,13461
5aced2b4bc66d2dd85b1507755fff2b1fb8c4a64,1,GitHub,2021-11-10 09:18:41-05:00,['119ba17bf105f2c057aa5d8f1546867401200856'],12,16,28,4369383,3,,,,13461
2730a9000e7996a0f05735854e28507e499166ac,0,Peter Turcsanyi,2021-11-10 18:39:35+01:00,['5aced2b4bc66d2dd85b1507755fff2b1fb8c4a64'],23,639,662,4370045,2,0.058968059,0.906633907,0.936117936,13461
f05443ddf7c044f1f718c6fc2dfe1ecc8498718e,0,exceptionfactory,2021-11-10 16:19:35-06:00,['2730a9000e7996a0f05735854e28507e499166ac'],0,521,521,4370566,4,0.389830508,1,0.881355932,13463
8a85e5c16f5857766bc1ac3b7eb618a79155ba81,0,Pierre Villard,2021-11-14 15:54:39+01:00,['f05443ddf7c044f1f718c6fc2dfe1ecc8498718e'],1,6,7,4370573,1,,,,13463
30293b23395b468929c233437d2c2ce9a4bcc837,0,Pierre Villard,2021-11-14 15:57:01+01:00,['8a85e5c16f5857766bc1ac3b7eb618a79155ba81'],139,5,144,4370717,3,1,0.428571429,0,13463
ab662434cef13f9ad26355af4bed6ec293689ae9,0,Pierre Villard,2021-11-14 16:00:40+01:00,['30293b23395b468929c233437d2c2ce9a4bcc837'],860,171,1031,4371748,9,1,1,1,13465
fe4161b1c2137e3f7e78e4c6ba557889e05a7bd9,0,Pierre Villard,2021-11-14 16:03:17+01:00,['ab662434cef13f9ad26355af4bed6ec293689ae9'],2,2,4,4371752,2,,,,13465
6fd1f03bd63d41b9c5105a458eb7d81e8ae79700,0,exceptionfactory,2021-11-15 07:46:37-06:00,['fe4161b1c2137e3f7e78e4c6ba557889e05a7bd9'],54,188,242,4371994,4,0.516129032,0.903225806,0.774193548,13466
1ae6dbdfb62fe51cc1743150b27080d3e5e5ccf9,0,exceptionfactory,2021-11-15 10:41:42-06:00,['6fd1f03bd63d41b9c5105a458eb7d81e8ae79700'],0,22,22,4372016,1,,,,13466
f7466fd0f10f31b95e5adad31da23da48f1c965d,0,exceptionfactory,2021-11-16 11:27:38-06:00,['1ae6dbdfb62fe51cc1743150b27080d3e5e5ccf9'],120,202,322,4372338,2,0.945454545,1,0.909090909,13466
15465bb4b83d833e438fa2f5ad6d057d5fa077c7,0,Matthew Burgess,2021-11-16 15:51:20-05:00,['f7466fd0f10f31b95e5adad31da23da48f1c965d'],0,9,9,4372347,1,,,,13466
77f235bf1cf24c26458414238a3eaeba23ba9a23,0,Joe Gresock,2021-11-17 06:36:10-05:00,['15465bb4b83d833e438fa2f5ad6d057d5fa077c7'],0,3519,3519,4375866,8,0.457142857,1,1,13472
0cf515c9c0d58ae41218135a331ca09fe3bb4fec,0,Nathan Gough,2021-11-17 11:54:51-05:00,['77f235bf1cf24c26458414238a3eaeba23ba9a23'],38,29,67,4375933,2,0.333333333,0.5,0.5,13472
d66219739bce8cb585e5a9890c6e15a138c3598e,0,Matthew Burgess,2021-11-17 12:32:55-05:00,['0cf515c9c0d58ae41218135a331ca09fe3bb4fec'],1,68,69,4376002,2,0.956521739,0.956521739,1,13473
5016eac0105923a852634748d6922a4ab864e3a8,0,GitHub,2021-11-17 13:55:02-05:00,['d66219739bce8cb585e5a9890c6e15a138c3598e'],7,99,106,4376108,4,0.924528302,1,1,13473
18fc492e4ce97d2bca4f96df1a1f1eb2b3e80899,0,GitHub,2021-11-17 14:38:26-05:00,['5016eac0105923a852634748d6922a4ab864e3a8'],12,88,100,4376208,3,,,,13474
605346ae0f15dd755c37b7e8802039fba8e5afd1,0,Joe Gresock,2021-11-18 10:30:50-05:00,['18fc492e4ce97d2bca4f96df1a1f1eb2b3e80899'],7,546,553,4376761,16,0.794117647,0.990196078,0.725490196,13483
785021dade215fdbf9b6ffcce2817d4509cadeac,0,exceptionfactory,2021-11-18 11:51:53-06:00,['605346ae0f15dd755c37b7e8802039fba8e5afd1'],0,24,24,4376785,1,0,0,1,13483
848a22eb2967819ec27b992b8f33aa6dbcc7b9ac,0,exceptionfactory,2021-11-19 08:52:20-06:00,['785021dade215fdbf9b6ffcce2817d4509cadeac'],24,0,24,4376809,1,1,1,0,13483
1724cb0d3be9d865acf48efa45504db84e734f8d,0,exceptionfactory,2021-11-19 09:09:50-06:00,['848a22eb2967819ec27b992b8f33aa6dbcc7b9ac'],1,1,2,4376811,1,,,,13483
1745d2a88e3afc95fa91dda9ab23e8abe4a85ed1,0,Joe Gresock,2021-11-20 06:26:55-05:00,['1724cb0d3be9d865acf48efa45504db84e734f8d'],75,680,755,4377566,24,0.307692308,0.282051282,0.923076923,13485
c033debdf3077ef465b62e76c3878df325e1203b,0,Joe Witt,2021-11-22 09:18:57-07:00,['1745d2a88e3afc95fa91dda9ab23e8abe4a85ed1'],111,164,275,4377841,8,1,1,1,13487
839fbf7d19a428069355d7bf79b8df7fa68b30a3,0,GitHub,2021-11-22 14:55:19-05:00,['c033debdf3077ef465b62e76c3878df325e1203b'],179,654,833,4378674,33,0.545454545,1,0.754010695,13491
0e09750a4d771cfba11cc996baa2025a8faf8c14,0,Nathan Gough,2021-11-22 18:16:42-05:00,['839fbf7d19a428069355d7bf79b8df7fa68b30a3'],2,22,24,4378698,3,0,1,0.5625,13491
c1e54276b872e2c36150c16ed05d589bdac03a3b,0,Nathan Gough,2021-11-22 18:24:39-05:00,['0e09750a4d771cfba11cc996baa2025a8faf8c14'],25,11,36,4378734,3,,,,13491
6259269f73a486b7d834d701e44362880b8a6a85,0,Kevin Doran,2021-11-22 19:19:19-05:00,['c1e54276b872e2c36150c16ed05d589bdac03a3b'],409,118,527,4379261,16,,,,13492
1ca5a1dbbf0ad570512cc67cae87c5202c2f2218,1,exceptionfactory,2021-11-23 08:25:30-06:00,['6259269f73a486b7d834d701e44362880b8a6a85'],643,630,1273,4380534,49,1,0,0.205882353,13492
bb97ecb2b1873bc88dd7306b887110a65872b5c9,0,Matthew Burgess,2021-11-23 09:59:56-05:00,['1ca5a1dbbf0ad570512cc67cae87c5202c2f2218'],1,1,2,4380536,1,,,,13492
f28e755bc302e83cbdc446da27fa23e76ba796b3,0,Matthew Burgess,2021-11-23 10:01:19-05:00,['bb97ecb2b1873bc88dd7306b887110a65872b5c9'],0,4,4,4380540,1,,,,13492
fea6a7f6dbbf63da9b3cefa0025af2a080a972f6,0,Matthew Burgess,2021-11-23 10:03:18-05:00,['f28e755bc302e83cbdc446da27fa23e76ba796b3'],15,0,15,4380555,1,,,,13492
2dcff09f7f97539fdf1ffd9e7b3fe75670a5adf2,0,Peter Turcsanyi,2021-11-24 10:05:43+01:00,['fea6a7f6dbbf63da9b3cefa0025af2a080a972f6'],3,5,8,4380563,1,0,1,1,13492
dfd8adfd8eec8fdc66e2a88de102e221bbc44ddb,0,Pierre Villard,2021-11-24 18:01:48+01:00,['2dcff09f7f97539fdf1ffd9e7b3fe75670a5adf2'],0,2,2,4380565,1,0,1,1,13492
bd7536b257907d9012084c27dc5cc3595e5dba3d,1,Tamas Palfy,2021-11-24 21:12:15+01:00,['dfd8adfd8eec8fdc66e2a88de102e221bbc44ddb'],1598,5243,6841,4387406,79,0.681695828,0.977119785,0.944818304,13539
99954204b63017071bb4a33e3ae7bf6953453616,0,Chris Sampson,2021-11-27 13:47:06+00:00,['bd7536b257907d9012084c27dc5cc3595e5dba3d'],2,8,10,4387416,2,,,,13539
d6b6dd1eb440e200c0588079a6b5a8da50dff651,0,exceptionfactory,2021-11-29 09:27:04-06:00,['99954204b63017071bb4a33e3ae7bf6953453616'],2,13,15,4387431,3,1,1,1,13539
a5581562bf0bb86caee78181cc116b0bd6f240a4,0,GitHub,2021-11-29 11:29:33-05:00,['d6b6dd1eb440e200c0588079a6b5a8da50dff651'],3,5,8,4387439,1,1,1,1,13539
8171ecb2c1f9d2ea56f330dafd1df6e100f15413,0,exceptionfactory,2021-11-29 10:45:59-06:00,['a5581562bf0bb86caee78181cc116b0bd6f240a4'],3,3,6,4387445,1,,,,13539
6a6b755aaadf4c88a54406e4b9d5e77ea05bbb06,0,Joe Gresock,2021-11-29 12:55:39-05:00,['8171ecb2c1f9d2ea56f330dafd1df6e100f15413'],183,0,183,4387628,9,0.421052632,0,0.789473684,13539
e6b573e79e08d36d15eba0184841b2ca01c9031f,0,exceptionfactory,2021-11-30 11:27:50-06:00,['6a6b755aaadf4c88a54406e4b9d5e77ea05bbb06'],5,49,54,4387682,3,0.038461538,0.961538462,1,13539
07c4a05cdf432689feb12ebb150552aa44d41f1d,0,exceptionfactory,2021-11-30 13:57:07-06:00,['e6b573e79e08d36d15eba0184841b2ca01c9031f'],50,53,103,4387785,7,1,1,1,13539
55e91d607cd64c7aefcf8a7cd66daa559b07fae2,0,Matthew Burgess,2021-11-30 15:02:08-05:00,['07c4a05cdf432689feb12ebb150552aa44d41f1d'],8,8,16,4387801,2,,,,13539
2844652f72e2d3f30a855b2561f4285d0f509875,0,Matthew Burgess,2021-11-30 20:39:04-05:00,['55e91d607cd64c7aefcf8a7cd66daa559b07fae2'],10,0,10,4387811,2,,,,13539
d45b23d89f1af203ff9971a96799dbde4e9f7bde,0,Joe Gresock,2021-12-01 07:28:41-05:00,['2844652f72e2d3f30a855b2561f4285d0f509875'],21,168,189,4388000,2,0,0.954545455,1,13539
2b415de912879dc92995a482d44b7092e18f44c8,0,GitHub,2021-12-02 13:31:19-05:00,['d45b23d89f1af203ff9971a96799dbde4e9f7bde'],5,53,58,4388058,2,0.466666667,0,0.833333333,13539
ff864266f59e70a67b2a1f2c787a0f74464b6a9d,0,Matthew Burgess,2021-12-02 14:24:12-05:00,['2b415de912879dc92995a482d44b7092e18f44c8'],2,12,14,4388072,1,0,0,1,13539
fede6b9354b7f125b908e6d9c84c47a774752008,0,GitHub,2021-12-02 15:25:23-05:00,['ff864266f59e70a67b2a1f2c787a0f74464b6a9d'],1,1,2,4388074,1,,,,13539
90b39b593a0958122f950ed1b49e4098d2935d2a,1,exceptionfactory,2021-12-02 15:10:38-06:00,['fede6b9354b7f125b908e6d9c84c47a774752008'],2997,8863,11860,4399934,137,0.490298291,0.688097307,0.764842166,13567
f95044ff877004e4b6cd3c0d399525ae9a07cfb0,1,Joe Gresock,2021-12-03 10:31:31-05:00,['90b39b593a0958122f950ed1b49e4098d2935d2a'],11,13,24,4399958,3,0,0,1,13567
41ff6f076b2e5346cf695ff2064e5dcfe249c124,0,Andrew Lim,2021-12-03 13:27:34-05:00,['f95044ff877004e4b6cd3c0d399525ae9a07cfb0'],2,2,4,4399962,1,,,,13567
7a83c32a01a55c62918efaad2597cdb281499422,0,Pierre Villard,2021-12-04 23:49:27+01:00,['41ff6f076b2e5346cf695ff2064e5dcfe249c124'],8,8,16,4399978,1,0,0,1,13567
2a3f7dafd657a8f1a2d638688889710df3ef8acd,1,Joe Gresock,2021-12-05 06:39:52-05:00,['7a83c32a01a55c62918efaad2597cdb281499422'],5,28,33,4400011,1,1,1,1,13567
53809dd83f1b2e150aaf70a607f6885fa292cbdd,0,Joe Gresock,2021-12-05 15:39:35-05:00,['2a3f7dafd657a8f1a2d638688889710df3ef8acd'],118,770,888,4400899,16,0.615384615,1,0.951923077,13571
0f027743d1bbf0abd94e3b3a953e180e9d40176c,0,Joe Gresock,2021-12-06 08:58:40-05:00,['53809dd83f1b2e150aaf70a607f6885fa292cbdd'],33,317,350,4401249,7,0.834532374,0.71942446,1,13573
1eb4264e3469069a665ac87868515c8b973e3dc3,0,Tamas Palfy,2021-12-06 21:00:40+01:00,['0f027743d1bbf0abd94e3b3a953e180e9d40176c'],21,21,42,4401291,7,,,,13573
70822b9c8d9105518f759f44ff4f828fc3fb6732,0,Joe Witt,2021-12-07 08:17:31-07:00,['1eb4264e3469069a665ac87868515c8b973e3dc3'],0,23,23,4401314,1,0,0.333333333,1,13573
12015a17dd93a1d42c9d6ddab6cc5ce606fef16a,0,exceptionfactory,2021-12-07 10:54:58-06:00,['70822b9c8d9105518f759f44ff4f828fc3fb6732'],2,52,54,4401368,2,0.857142857,0.142857143,1,13573
563df24067274221f0527bccbd66526f5440cb6e,0,Joe Gresock,2021-12-08 09:33:55-05:00,['12015a17dd93a1d42c9d6ddab6cc5ce606fef16a'],167,216,383,4401751,6,1,0,1,13575
bf288f3ba1e95dad6b16457079208c6f25fa31be,0,GitHub,2021-12-08 13:38:45-05:00,['563df24067274221f0527bccbd66526f5440cb6e'],5,10,15,4401766,1,1,1,0,13575
dafa03a21a7a9b017e621c4319a058ea9b291951,0,Joe Gresock,2021-12-08 15:59:31-05:00,['bf288f3ba1e95dad6b16457079208c6f25fa31be'],22,36,58,4401824,4,1,1,0.4,13575
c1bb0c0c3421136b045a66415be9b17947952492,1,Matthew Burgess,2021-12-09 13:27:35-05:00,['dafa03a21a7a9b017e621c4319a058ea9b291951'],5,5,10,4401834,1,,,,13575
97198e35a04c12e66684d9545ff24156d16c60f6,0,Joe Witt,2021-12-09 12:41:57-07:00,['c1bb0c0c3421136b045a66415be9b17947952492'],35,208,243,4402077,11,0.090909091,0.977272727,1,13575
f5dccb552210fa02d6084f7c0e3ab0f329847735,0,Nathan Gough,2021-12-09 16:13:15-05:00,['97198e35a04c12e66684d9545ff24156d16c60f6'],7,136,143,4402220,2,0.829787234,0.829787234,0.829787234,13576
3d3f6ac070a10a951073829c61e88d9f938af915,0,Pierre Villard,2021-12-10 10:26:59+01:00,['f5dccb552210fa02d6084f7c0e3ab0f329847735'],10,21,31,4402251,2,0.875,0.875,0.875,13576
b7ad1f924d2a279f6b87748639a5a677f8e340a6,0,Pierre Villard,2021-12-10 10:31:52+01:00,['3d3f6ac070a10a951073829c61e88d9f938af915'],3,304,307,4402558,5,0.671875,0.671875,0.671875,13579
a475e7e4e29ae0291f5e19fae9e8b56803da34c1,0,exceptionfactory,2021-12-10 06:48:48-06:00,['b7ad1f924d2a279f6b87748639a5a677f8e340a6'],7,15,22,4402580,1,,,,13579
7dc0f847bd38d892b9073e9406c4f57edd88eaf0,0,exceptionfactory,2021-12-10 06:59:43-06:00,['a475e7e4e29ae0291f5e19fae9e8b56803da34c1'],1,1,2,4402582,1,,,,13579
f7a300d27d75e28307759d2f3b9a6e25f8453512,0,exceptionfactory,2021-12-10 07:43:48-06:00,['7dc0f847bd38d892b9073e9406c4f57edd88eaf0'],1,1,2,4402584,1,,,,13579
8fdde86997fd17e152a21b9cce2b1ce725124df2,0,exceptionfactory,2021-12-10 08:00:23-06:00,['f7a300d27d75e28307759d2f3b9a6e25f8453512'],6,6,12,4402596,6,,,,13579
b578f183cb593eae8a845d82f7fc28615e043ae9,0,GitHub,2021-12-10 09:12:38-05:00,['8fdde86997fd17e152a21b9cce2b1ce725124df2'],5,3109,3114,4405710,43,1,0.994291151,0.995242626,13618
24422c4ec8910aa3360d5521a744c87901f3635e,0,GitHub,2021-12-10 16:57:23-05:00,['b578f183cb593eae8a845d82f7fc28615e043ae9'],0,1261,1261,4406971,15,0.322766571,0.654178674,0.599423631,13630
6f22d3ad11a372f9ed7feccd9c900eea3ff1345a,0,exceptionfactory,2021-12-10 21:47:12-06:00,['24422c4ec8910aa3360d5521a744c87901f3635e'],1,32,33,4407004,3,,,,13630
f07c37285ebfb6af33fa8a5906bd605890e66908,0,Chris Sampson,2021-12-11 14:33:23+00:00,['6f22d3ad11a372f9ed7feccd9c900eea3ff1345a'],362,706,1068,4408072,15,0.45814978,0.929515419,0.220264317,13630
f3c7537d9b8f84a4769ce8eba74a551dce3836a0,0,Pierre Villard,2021-12-11 19:58:01+01:00,['f07c37285ebfb6af33fa8a5906bd605890e66908'],216,867,1083,4409155,19,0.299065421,0.885514019,0.245327103,13630
429087c11df463eb9dc6b5247057679e8eaeaca7,0,Pierre Villard,2021-12-13 12:08:54+01:00,['f3c7537d9b8f84a4769ce8eba74a551dce3836a0'],19,201,220,4409375,15,0.482352941,0.929411765,1,13631
b5414ab195a0e7b5c7a358e9db089f12c34bebc6,1,exceptionfactory,2021-12-13 10:54:45-06:00,['429087c11df463eb9dc6b5247057679e8eaeaca7'],73,10,83,4409458,10,,,,13631
3d5f357de896e81084049df3ad10ca64e6390f65,0,GitHub,2021-12-13 16:01:42-05:00,['b5414ab195a0e7b5c7a358e9db089f12c34bebc6'],25,112,137,4409595,4,0,0,0.511627907,13631
1321b25f6670fb96e3e75076addb6fbe7e691c84,1,Joe Witt,2021-12-13 14:12:11-07:00,['3d5f357de896e81084049df3ad10ca64e6390f65'],2,2,4,4409599,1,,,,13631
09f254c6113c4c0747201eed67a0e0101424cd12,1,Joe Witt,2021-12-14 12:32:32-07:00,['1321b25f6670fb96e3e75076addb6fbe7e691c84'],118,2,120,4409719,10,,,,13631
e7449bf0d3fa1612f2019603f09b8bc99d0b26a7,0,Joe Witt,2021-12-14 13:17:37-07:00,['09f254c6113c4c0747201eed67a0e0101424cd12'],0,5,5,4409724,2,,,,13631
90930ca1970450255ace314d050914293f2e6599,0,Matthew Burgess,2021-12-15 17:37:24-05:00,['e7449bf0d3fa1612f2019603f09b8bc99d0b26a7'],1,35,36,4409760,3,0,1,0.75,13631
5e9c86885ce4557f41a955adcaa3a6e70df3f501,0,exceptionfactory,2021-12-15 16:59:07-06:00,['90930ca1970450255ace314d050914293f2e6599'],20,21,41,4409801,8,0,1,1,13631
03cf976c0740e5e3f36b386f41b1821014cf687e,0,Matthew Burgess,2021-12-16 15:07:55-05:00,['5e9c86885ce4557f41a955adcaa3a6e70df3f501'],2,4,6,4409807,2,,,,13631
8638b7c0d88583059eb88c789cc598350b516a2e,0,Matthew Burgess,2021-12-16 15:10:32-05:00,['03cf976c0740e5e3f36b386f41b1821014cf687e'],4,4,8,4409815,4,,,,13631
293919f881873d40e1d7e11fb1996ca7345e2f52,0,GitHub,2021-12-16 14:28:02-08:00,['8638b7c0d88583059eb88c789cc598350b516a2e'],18463,18634,37097,4446912,20,,,,13631
784ee680d54bc2f9cda182762db1349a312e0c4e,0,Matthew Burgess,2021-12-16 18:44:07-05:00,['293919f881873d40e1d7e11fb1996ca7345e2f52'],32,45,77,4446989,1,1,1,0,13631
7d8f99a1f41bb1806706c5db857f109c5d7b4e7f,1,GitHub,2021-12-16 17:09:26-08:00,['784ee680d54bc2f9cda182762db1349a312e0c4e'],1,18,19,4447008,2,0.928571429,0.928571429,1,13631
7c6bdcb035094db521b3007e1ccd298052cbfddd,1,Matthew Burgess,2021-12-17 07:21:03-05:00,['7d8f99a1f41bb1806706c5db857f109c5d7b4e7f'],457,784,1241,4448249,114,,,,13631
be9f2540562b614650bbf80a576f7e13f845f5c3,0,Pierre Villard,2021-12-17 17:31:47+01:00,['7c6bdcb035094db521b3007e1ccd298052cbfddd'],1,1,2,4448251,1,,,,13631
66f36eaf5ab5798d60cba59b0a7b1a758671f3c7,0,Peter Turcsanyi,2021-12-17 18:05:35+01:00,['be9f2540562b614650bbf80a576f7e13f845f5c3'],1,9,10,4448261,2,0,1,1,13631
20392d5ef417b71968ef1e8de553a45367e19f33,0,exceptionfactory,2021-12-18 19:59:54-06:00,['66f36eaf5ab5798d60cba59b0a7b1a758671f3c7'],10,14,24,4448285,2,1,0,0,13631
bda48b3f87ad11ffcee54cd465ae6384c26fa3f1,0,Chris Sampson,2021-12-19 18:19:19+00:00,['20392d5ef417b71968ef1e8de553a45367e19f33'],5,5,10,4448295,1,,,,13631
9dd6b5f3e5fb7b2cfeab3a9b174132344a17db85,0,Joe Witt,2021-12-20 10:02:08-07:00,['bda48b3f87ad11ffcee54cd465ae6384c26fa3f1'],4,91,95,4448390,9,,,,13631
f85ae68fb5c37732dd05617c54e06827886d089f,0,GitHub,2021-12-20 09:13:29-08:00,['9dd6b5f3e5fb7b2cfeab3a9b174132344a17db85'],8,87,95,4448485,5,1,1,1,13632
4f28b28ba2b8ad049f4477335e9a85135cd0d0c1,1,Joe Witt,2021-12-20 20:23:31-07:00,['f85ae68fb5c37732dd05617c54e06827886d089f'],364,917,1281,4449766,15,1,1,0.72972973,13643
9747d6a410441bba6e8a7da6c60041b5b8d7fb3f,0,Joe Witt,2021-12-21 12:14:23-07:00,['4f28b28ba2b8ad049f4477335e9a85135cd0d0c1'],1,74,75,4449841,2,0.15,1,0.15,13644
0f02dac3fa57885ed47957211f1abd36af69f7ed,1,Matthew Burgess,2021-12-21 16:35:15-05:00,['9747d6a410441bba6e8a7da6c60041b5b8d7fb3f'],20,2424,2444,4452285,33,0.55955956,0.910910911,0.844844845,13664
4ee5bb65b87db2e3de2b43df62e710cee3616f66,0,exceptionfactory,2021-12-21 22:32:16-06:00,['0f02dac3fa57885ed47957211f1abd36af69f7ed'],9,9,18,4452303,1,,,,13664
0d49371c53e1a6da80fdb33ecfbad13eb5b8cad1,0,exceptionfactory,2021-12-21 22:35:31-06:00,['4ee5bb65b87db2e3de2b43df62e710cee3616f66'],6,125,131,4452434,6,0.4,0.946666667,0.786666667,13664
d6efc6958536dc2d0bc00de74ecd172e01571aef,0,Matthew Burgess,2021-12-22 10:46:59-05:00,['0d49371c53e1a6da80fdb33ecfbad13eb5b8cad1'],222,457,679,4453113,92,1,1,1,13669
0ac8f1b32c5c0194e8e1bc7384bec81ed7500dfc,0,Matthew Burgess,2021-12-30 18:35:50-05:00,['d6efc6958536dc2d0bc00de74ecd172e01571aef'],158,217,375,4453488,5,0.551724138,0.620689655,0.793103448,13669
e54cbe6451dbe89d372792d6ae2418ff9cd28557,0,GitHub,2022-01-04 09:14:04-05:00,['0ac8f1b32c5c0194e8e1bc7384bec81ed7500dfc'],12,88,100,4453588,4,,,,13669
4346dd8faf692968716669117e799afadc60150c,1,GitHub,2022-01-04 11:36:56-05:00,['e54cbe6451dbe89d372792d6ae2418ff9cd28557'],57,61,118,4453706,4,0,0,1,13669
be138ab656c42b580ee003e6058608f4dcf82a7c,1,GitHub,2022-01-04 15:59:32-05:00,['4346dd8faf692968716669117e799afadc60150c'],42,170,212,4453918,15,0.135135135,0.648648649,1,13671
f80e2ec70b4af45156f0e57197f3f3d6e2313874,0,Pierre Villard,2022-01-05 15:19:26+01:00,['be138ab656c42b580ee003e6058608f4dcf82a7c'],1,1,2,4453920,1,,,,13671
abd154026e4c42ce8ed53bdd0285a14ce334c3f5,0,Pierre Villard,2022-01-05 15:21:45+01:00,['f80e2ec70b4af45156f0e57197f3f3d6e2313874'],2,2,4,4453924,1,,,,13671
81e57c9651b8ebc1bc2cfe612e18161c8feabade,0,Pierre Villard,2022-01-05 15:30:03+01:00,['abd154026e4c42ce8ed53bdd0285a14ce334c3f5'],276,19,295,4454219,28,,,,13671
7c407cf58071bd7d57b7f54edada0aec7de9707b,0,Pierre Villard,2022-01-05 16:02:01+01:00,['81e57c9651b8ebc1bc2cfe612e18161c8feabade'],48,2,50,4454269,2,,,,13671
d783e10e6819594b1cee4bbc5d3bffa570afc3ed,0,Pierre Villard,2022-01-05 18:58:16+01:00,['7c407cf58071bd7d57b7f54edada0aec7de9707b'],2,2,4,4454273,1,,,,13671
b0b1a57b9874cbbbd57122970db96464c7dd1279,0,GitHub,2022-01-05 16:28:12-05:00,['d783e10e6819594b1cee4bbc5d3bffa570afc3ed'],21,23,44,4454317,1,0,0,0,13671
12ba579b8f6c506288458fb6cd2191ea26da2cb3,0,Nathan Gough,2022-01-05 18:11:03-05:00,['b0b1a57b9874cbbbd57122970db96464c7dd1279'],175,8,183,4454500,16,,,,13671
dc4201275524c88506a478c0c3b26354f68008ed,0,exceptionfactory,2022-01-05 22:59:36-06:00,['12ba579b8f6c506288458fb6cd2191ea26da2cb3'],18,18,36,4454536,5,,,,13671
bd1b2b4d6972058f7f3aba7784a6d23fb37c013a,0,Peter Turcsanyi,2022-01-06 13:43:23+01:00,['dc4201275524c88506a478c0c3b26354f68008ed'],362,306,668,4455204,4,1,0,0.176470588,13671
56593ad12f40bbacd4627436eadc38a24f58ee16,1,exceptionfactory,2022-01-06 15:52:37-06:00,['bd1b2b4d6972058f7f3aba7784a6d23fb37c013a'],196,43,239,4455443,5,0,0,0.625,13671
d9b863a84bcd60bffd85ab9506484fcd20ff0607,0,exceptionfactory,2022-01-06 22:46:55-06:00,['56593ad12f40bbacd4627436eadc38a24f58ee16'],0,15,15,4455458,1,1,1,0.666666667,13671
287e41d8a69f9d201e77840a3cced6fd576387ed,1,Pierre Villard,2022-01-07 12:30:13+01:00,['d9b863a84bcd60bffd85ab9506484fcd20ff0607'],8,31,39,4455497,2,0,1,1,13671
c5d174e280c435b97d6cf53259ecb76fa2a379b8,0,Joe Gresock,2022-01-07 10:08:45-05:00,['287e41d8a69f9d201e77840a3cced6fd576387ed'],0,1,1,4455498,1,,,,13671
109e4d1c9548c383a1a2d50d5d73a5a451cb8585,0,Mike Thomsen,2022-01-07 14:30:29-05:00,['c5d174e280c435b97d6cf53259ecb76fa2a379b8'],3523,0,3523,4459021,17,0.815372425,0.253565769,0.077654517,13671
42626adab8e4d3bf32f5addef310c927228cdd7e,0,GitHub,2022-01-07 14:45:18-05:00,['109e4d1c9548c383a1a2d50d5d73a5a451cb8585'],20,112,132,4459153,2,0.053571429,0.892857143,0.892857143,13671
ca8bc17c0aa26a3ffd4ab171e964a60c1518361b,1,Pierre Villard,2022-01-08 11:02:12+01:00,['42626adab8e4d3bf32f5addef310c927228cdd7e'],216,85,301,4459454,6,1,0,0.170731707,13671
5832dff25e174a4743f47e040ffbef1c21e9e3ec,0,Pierre Villard,2022-01-08 11:06:07+01:00,['ca8bc17c0aa26a3ffd4ab171e964a60c1518361b'],96,20,116,4459570,13,,,,13671
60390956256e6bd605e05d20d2cd577eaf2fba2f,1,Joe Gresock,2022-01-09 05:25:32-05:00,['5832dff25e174a4743f47e040ffbef1c21e9e3ec'],3156,447,3603,4463173,30,0.662162162,0.112331081,0.269425676,13671
16bedc50fa271d8f383e8f61c572704bfc6f9f17,1,Peter Turcsanyi,2022-01-10 13:11:39+01:00,['60390956256e6bd605e05d20d2cd577eaf2fba2f'],3,2,5,4463178,1,1,0,0,13671
990285ba1c1429b436af1cab4b36ab8a3797bb14,0,Peter Turcsanyi,2022-01-10 20:35:04+01:00,['16bedc50fa271d8f383e8f61c572704bfc6f9f17'],83,566,649,4463827,6,0.541666667,0.700757576,0.522727273,13672
72e54f4fab9e8b49a85825f0a85f466e7e2564df,0,Peter Turcsanyi,2022-01-11 09:45:00+01:00,['990285ba1c1429b436af1cab4b36ab8a3797bb14'],60,476,536,4464363,19,0.392473118,0.865591398,0.967741935,13674
64495e99e97e9f7279ed8b5317b070fd64944fbf,0,Joe Gresock,2022-01-12 10:50:01-05:00,['72e54f4fab9e8b49a85825f0a85f466e7e2564df'],4,191,195,4464558,7,0.625,1,1,13677
6caffca811bcebcd1d83561cb5a036a80206ea95,0,Joe Witt,2022-01-12 10:25:07-07:00,['64495e99e97e9f7279ed8b5317b070fd64944fbf'],36,205,241,4464799,3,0.2109375,0.7578125,0.8515625,13677
5054fc3ac68b3a5cef7429a6dc380cb446d0c685,0,Joe Witt,2022-01-12 10:39:32-07:00,['6caffca811bcebcd1d83561cb5a036a80206ea95'],11,0,11,4464810,2,,,,13677
476c70e220099e7d0e59d8100a8e57e95bc50474,0,Joe Witt,2022-01-12 15:51:41-07:00,['5054fc3ac68b3a5cef7429a6dc380cb446d0c685'],134,5,139,4464949,1,,,,13677
bc2ba9537ac37e0907828a2fc6d7545413749e17,0,Joe Witt,2022-01-12 15:52:03-07:00,['476c70e220099e7d0e59d8100a8e57e95bc50474'],45,5,50,4464999,1,,,,13677
d1599eebcf312c4be1cb9427646875698d8bff35,1,Joe Gresock,2022-01-13 10:59:02-05:00,['bc2ba9537ac37e0907828a2fc6d7545413749e17'],1,1,2,4465001,1,,,,13677
7aadb0f0fd124f716d59187fc3fbe4e4e23c7920,0,Joe Witt,2022-01-13 09:27:19-07:00,['d1599eebcf312c4be1cb9427646875698d8bff35'],1,1,2,4465003,1,,,,13677
2ffd4a5a9a9ded05b39dabc13056a1edc67511c5,1,Joe Gresock,2022-01-13 13:18:04-05:00,['7aadb0f0fd124f716d59187fc3fbe4e4e23c7920'],3381,1601,4982,4469985,85,1,0,0.18,13695
7c50f1429edef6efedb7bfeaff388f22c0eeaa69,0,Pierre Villard,2022-01-13 19:50:44+01:00,['2ffd4a5a9a9ded05b39dabc13056a1edc67511c5'],7,53,60,4470045,4,0,1,1,13696
dd7131b257113581a8485b2c59184c7eecc96ce6,0,Joe Gresock,2022-01-13 15:59:00-05:00,['7c50f1429edef6efedb7bfeaff388f22c0eeaa69'],148,623,771,4470816,9,1,1,1,13702
4847926a4b70d4d02660c7f1cedbf57388b4c3f5,1,Joe Gresock,2022-01-13 16:13:24-05:00,['dd7131b257113581a8485b2c59184c7eecc96ce6'],7,44,51,4470867,5,0,0.333333333,0.333333333,13704
9783f1c5c3b68342708e323bab7ed369d74f6695,0,exceptionfactory,2022-01-18 08:52:43-06:00,['4847926a4b70d4d02660c7f1cedbf57388b4c3f5'],1,6,7,4470874,1,,,,13704
18f2384d0a1659b20261e1cffb69f8d4f1dccb28,0,exceptionfactory,2022-01-18 09:57:30-06:00,['9783f1c5c3b68342708e323bab7ed369d74f6695'],1,2,3,4470877,1,,,,13704
405934dcd216db24a4d1009dc8e8da5f76bf165d,0,Joe Gresock,2022-01-18 15:31:36-05:00,['18f2384d0a1659b20261e1cffb69f8d4f1dccb28'],92,63,155,4471032,4,1,0,0.363636364,13704
e603b0179bf46ef26bbf4713ae68553b19d4c485,0,Kevin Doran,2022-01-18 16:45:45-05:00,['405934dcd216db24a4d1009dc8e8da5f76bf165d'],12,283,295,4471327,5,0.347593583,0.994652406,0.818181818,13704
aa61494fc3a68b4806784f67ad837ee821d26da4,1,Pierre Villard,2022-01-19 13:29:11+01:00,['e603b0179bf46ef26bbf4713ae68553b19d4c485'],24,944,968,4472295,11,0.405727924,0.961813842,0.99522673,13707
3811eea4a21f754c5ee059e16c2a5a992130ee11,0,Joe Witt,2022-01-19 09:08:13-07:00,['aa61494fc3a68b4806784f67ad837ee821d26da4'],1,1,2,4472297,1,,,,13707
2f95eed8cb7115b9070d46fe4853753f034ed585,0,Joe Witt,2022-01-19 09:14:09-07:00,['3811eea4a21f754c5ee059e16c2a5a992130ee11'],84,84,168,4472465,84,,,,13707
8edb5faac9ff469e4c810891c30892962ed83b29,0,Joe Witt,2022-01-19 09:24:23-07:00,['2f95eed8cb7115b9070d46fe4853753f034ed585'],6337,0,6337,4478802,35,0.751621872,0.265987025,0.077386469,13707
48c8193c4c6bff988de14cb80da6b2c4daacd0c7,0,exceptionfactory,2022-01-19 11:18:36-06:00,['8edb5faac9ff469e4c810891c30892962ed83b29'],22460,0,22460,4501262,125,0.669437709,0.240734326,0.186237155,13707
3f69eeceb2baa5706f37f2b98e6a92b76728ff4f,0,Joe Witt,2022-01-19 10:52:30-07:00,['48c8193c4c6bff988de14cb80da6b2c4daacd0c7'],19,27,46,4501308,4,,,,13707
139a269c4105c48823f9aaa59a0c8d17cb8aa7f7,0,Joe Witt,2022-01-19 11:17:15-07:00,['3f69eeceb2baa5706f37f2b98e6a92b76728ff4f'],5,5,10,4501318,5,,,,13707
1d353435a54d0fde8a12eed456e5114e54274e83,0,Pierre Villard,2022-01-19 19:20:53+01:00,['139a269c4105c48823f9aaa59a0c8d17cb8aa7f7'],2,23,25,4501343,2,1,1,1,13707
70aa719cbfd9e9ca5ce38252ba16c345657d8bea,0,exceptionfactory,2022-01-19 13:50:05-06:00,['1d353435a54d0fde8a12eed456e5114e54274e83'],1,38,39,4501382,2,,,,13707
fc27b3138bba69c52d3c7e4158c77a265410981f,0,Joe Gresock,2022-01-19 16:11:53-05:00,['70aa719cbfd9e9ca5ce38252ba16c345657d8bea'],585,582,1167,4502549,10,1,1,1,13715
c42cc61f71478e6d80434787b11521c5c12c8c18,1,Pierre Villard,2022-01-20 10:28:24+01:00,['fc27b3138bba69c52d3c7e4158c77a265410981f'],125,144,269,4502818,5,0.086956522,1,1,13716
fd1c1e354ef933ce16f5e187d0032f18299bd4a9,0,Pierre Villard,2022-01-20 10:32:37+01:00,['c42cc61f71478e6d80434787b11521c5c12c8c18'],7,10,17,4502835,1,,,,13716
a4791a55d41cd077d0135f903974ac6d142e7a9e,0,Joe Gresock,2022-01-20 07:17:00-05:00,['fd1c1e354ef933ce16f5e187d0032f18299bd4a9'],2813,0,2813,4505648,17,0.834097859,0.146788991,0.037461774,13716
3c2793be099fd5cc2ba6682acd379cec18277e2f,0,GitHub,2022-01-20 10:58:05-05:00,['a4791a55d41cd077d0135f903974ac6d142e7a9e'],1,54,55,4505703,6,0.535714286,0.571428571,1,13716
d9873510311fefcb86f7699a31755a621a79f8e5,0,exceptionfactory,2022-01-20 10:42:25-06:00,['3c2793be099fd5cc2ba6682acd379cec18277e2f'],8,0,8,4505711,1,,,,13716
ccd47de6dca4f9be90bfdbeb193c81e85b953170,0,exceptionfactory,2022-01-20 11:14:01-06:00,['d9873510311fefcb86f7699a31755a621a79f8e5'],39,375,414,4506125,6,0.724867725,1,0.915343915,13718
0da3994ac890c3cec4d5ca12c1debea2e4016669,0,Joe Witt,2022-01-20 10:53:41-07:00,['ccd47de6dca4f9be90bfdbeb193c81e85b953170'],6,0,6,4506131,1,,,,13718
695c3aabcb920668b5bc89134b1614e8dbc99c76,0,Joe Witt,2022-01-20 10:54:12-07:00,['0da3994ac890c3cec4d5ca12c1debea2e4016669'],26,34,60,4506191,1,0,0,1,13718
73de3a0fe7eb0bdc449b6170aaf426213816f53f,1,exceptionfactory,2022-01-21 13:24:42-06:00,['695c3aabcb920668b5bc89134b1614e8dbc99c76'],2,7,9,4506200,1,,,,13718
93b58ccffebebd7cd26a66a8ba020c1735db9c92,0,Matthew Burgess,2022-01-21 15:24:29-05:00,['73de3a0fe7eb0bdc449b6170aaf426213816f53f'],7,74,81,4506281,3,1,1,1,13719
6ef6e71d05d6f63a362b6195ce9bb9c652174293,1,exceptionfactory,2022-01-21 15:37:04-06:00,['93b58ccffebebd7cd26a66a8ba020c1735db9c92'],173,399,572,4506853,30,0,0,0.690909091,13722
3d05844b713142851584d4990da2828c81cc1cfa,0,exceptionfactory,2022-01-21 16:15:03-06:00,['6ef6e71d05d6f63a362b6195ce9bb9c652174293'],4,4,8,4506861,1,,,,13722
e2243500d3c878fbb33b8f642462a7b29c441fa3,0,exceptionfactory,2022-01-21 20:08:16-06:00,['3d05844b713142851584d4990da2828c81cc1cfa'],39,27,66,4506927,15,,,,13722
82f78f01b9c553c65d14631593c23d70bf70ea3f,0,GitHub,2022-01-24 08:33:11-05:00,['e2243500d3c878fbb33b8f642462a7b29c441fa3'],0,17,17,4506944,1,,,,13722
3d36a1718549e72948d6bbe3a7b6b23e5c7a24d0,0,Pierre Villard,2022-01-24 17:21:52+01:00,['82f78f01b9c553c65d14631593c23d70bf70ea3f'],0,0,0,4506944,3,,,,13722
ec26ec9904c54548f6a2258ab16a831d80c69fdb,0,Peter Turcsanyi,2022-01-24 18:24:45+01:00,['3d36a1718549e72948d6bbe3a7b6b23e5c7a24d0'],18,16,34,4506978,7,,,,13722
b5dd35431e2251802bd0c13c5de016477ede49c5,0,Peter Turcsanyi,2022-01-24 22:07:31+01:00,['ec26ec9904c54548f6a2258ab16a831d80c69fdb'],3,190,193,4507171,5,0.614035088,1,1,13724
4000b01909a790195a744d48f8f08f214d1f0ef2,0,exceptionfactory,2022-01-25 09:21:01-06:00,['b5dd35431e2251802bd0c13c5de016477ede49c5'],28,175,203,4507374,25,0.6,0,1,13725
bb24030f4ad0a97b7156916531c20226891a3400,0,exceptionfactory,2022-01-25 09:47:30-06:00,['4000b01909a790195a744d48f8f08f214d1f0ef2'],84,67,151,4507525,21,,,,13725
b40b5a7c96d973f08a04a8d382e8c9fbce9f758a,0,Joe Witt,2022-01-25 09:03:39-07:00,['bb24030f4ad0a97b7156916531c20226891a3400'],813,603,1416,4508941,6,1,0.386138614,0,13727
96b53d894375e98370d2bc41c8f4b3a9a1f1881d,0,Pierre Villard,2022-01-25 18:12:14+01:00,['b40b5a7c96d973f08a04a8d382e8c9fbce9f758a'],1,276,277,4509218,5,0.08045977,0.862068966,1,13727
a2cfbe4ac70d9d73bd3ab5bbfd702eaebb524c71,0,Matthew Burgess,2022-01-25 13:30:33-05:00,['96b53d894375e98370d2bc41c8f4b3a9a1f1881d'],42,36,78,4509296,33,,,,13727
3eef7e0a3e9e68b0acb5129416a1bc824a124baf,0,GitHub,2022-01-25 14:52:07-05:00,['a2cfbe4ac70d9d73bd3ab5bbfd702eaebb524c71'],32,64,96,4509392,3,1,1,1,13727
5022a5ee07e61614e585b3fd86c410ac9e04e750,0,GitHub,2022-01-26 09:03:26-05:00,['3eef7e0a3e9e68b0acb5129416a1bc824a124baf'],867,167,1034,4510426,10,,,,13728
16174060411a7943c21d60cd2916ec4b3c682d90,1,Peter Turcsanyi,2022-01-26 17:28:15+01:00,['5022a5ee07e61614e585b3fd86c410ac9e04e750'],27,222,249,4510675,5,0.458333333,0.729166667,0,13729
9075fc2cd8d79d8493d3cfab2788f56a448c4082,1,Joe Gresock,2022-01-26 11:52:08-05:00,['16174060411a7943c21d60cd2916ec4b3c682d90'],110,96,206,4510881,40,,,,13729
278967829af6fac5130ddcc705576096acfb16d2,0,GitHub,2022-01-26 12:15:27-05:00,['9075fc2cd8d79d8493d3cfab2788f56a448c4082'],0,2,2,4510883,1,1,1,1,13729
08153b826014a252ad078dd17c929fe1e13ad7ba,0,exceptionfactory,2022-01-26 14:40:32-06:00,['278967829af6fac5130ddcc705576096acfb16d2'],897,396,1293,4512176,18,0.483870968,0.430107527,0.317204301,13733
0eff2498708af7071b92fcd0d6e35c82c1bf2198,0,exceptionfactory,2022-01-26 19:07:29-06:00,['08153b826014a252ad078dd17c929fe1e13ad7ba'],5,0,5,4512181,1,,,,13733
3ea9faccc692554d5c352562e462cc1a8e06c177,0,Pierre Villard,2022-01-27 15:06:40+01:00,['0eff2498708af7071b92fcd0d6e35c82c1bf2198'],3,18,21,4512202,2,0.916666667,1,1,13733
3ccc9d29b6653717f4d41ba1ef33f4ef20e77901,0,exceptionfactory,2022-01-27 10:07:01-06:00,['3ea9faccc692554d5c352562e462cc1a8e06c177'],9,631,640,4512842,5,0.676691729,0.741854637,0.721804511,13734
8f2a9f94fece6d700542d70b9970f714ed4753ef,0,exceptionfactory,2022-01-27 14:43:19-06:00,['3ccc9d29b6653717f4d41ba1ef33f4ef20e77901'],3276,1,3277,4516119,37,0.579279279,0.306306306,0.228828829,13734
95abc35463d43ea9ee62dc041f85dca38579fec2,1,Nathan Gough,2022-01-27 17:36:27-05:00,['8f2a9f94fece6d700542d70b9970f714ed4753ef'],498,500,998,4517117,14,1,1,0.598360656,13739
c8fe5149a5ca3afcb955cd4d572d1081595b564d,0,Nathan Gough,2022-01-27 20:31:18-05:00,['95abc35463d43ea9ee62dc041f85dca38579fec2'],4,4,8,4517125,2,,,,13739
6fca4eb3ce99c140c055286ba4004f12fbcc0716,0,Joe Gresock,2022-01-28 10:11:34-05:00,['c8fe5149a5ca3afcb955cd4d572d1081595b564d'],627,84,711,4517836,13,0.63028169,0,0.007042254,13739
ed5e90fb815318470bf875d166b61c3b317f4e42,0,GitHub,2022-01-28 13:37:33-05:00,['6fca4eb3ce99c140c055286ba4004f12fbcc0716'],0,9,9,4517845,1,0,0,1,13739
49978cdd9167d12fd235888a17b45d5a5a2ee42a,0,exceptionfactory,2022-01-28 12:42:51-06:00,['ed5e90fb815318470bf875d166b61c3b317f4e42'],99,2586,2685,4520530,35,0.836795252,0.909990109,0.863501484,13769
43a24743cc91d171ceda1da877b887ab2acde41a,0,exceptionfactory,2022-01-28 13:24:41-06:00,['49978cdd9167d12fd235888a17b45d5a5a2ee42a'],3,0,3,4520533,3,,,,13769
038811d0dd8d317b6cfe0cffd3f1f4be78753250,0,Pierre Villard,2022-01-29 13:56:53+01:00,['43a24743cc91d171ceda1da877b887ab2acde41a'],3,23,26,4520559,2,0.875,0.875,0.875,13769
27ceda38bf77f5e8403a4427cdda2eaa1838520c,0,GitHub,2022-01-31 09:20:54-05:00,['038811d0dd8d317b6cfe0cffd3f1f4be78753250'],11,19,30,4520589,1,0,0,1,13769
7afb34ab394a1467ba3c1c54bb5c21a78635d70d,0,Pierre Villard,2022-01-31 18:42:12+01:00,['27ceda38bf77f5e8403a4427cdda2eaa1838520c'],1,1,2,4520591,1,,,,13769
dc7d9510cd5e63dfe3888d6c9f5464fe6eb843f8,1,Nathan Gough,2022-02-01 12:59:16-05:00,['7afb34ab394a1467ba3c1c54bb5c21a78635d70d'],654,301,955,4521546,65,0.638554217,0,0.052208835,13773
43748a5523dd5fbf020f8023c7dcf8406dcb4971,1,Kevin Doran,2022-02-01 15:17:50-05:00,['dc7d9510cd5e63dfe3888d6c9f5464fe6eb843f8'],713,212,925,4522471,43,1,0,0,13773
cbb5909466fcecb4f7b0ab8c10cc4655d82f5ecd,0,Pierre Villard,2022-02-02 11:41:23+01:00,['43748a5523dd5fbf020f8023c7dcf8406dcb4971'],6,3,9,4522480,1,,,,13773
ba0bf2ede0deb32c50c15fd6dbce33ed004303b4,0,Pierre Villard,2022-02-02 11:45:18+01:00,['cbb5909466fcecb4f7b0ab8c10cc4655d82f5ecd'],22,11,33,4522513,13,,,,13773
0e53a1cb4e8e985badc9f6dab4777f0ba3a8e41f,0,Pierre Villard,2022-02-02 11:48:33+01:00,['ba0bf2ede0deb32c50c15fd6dbce33ed004303b4'],44,42,86,4522599,2,,,,13773
9d8b39529ef5f877e5e8790973ca43ac049be85a,0,Mike Thomsen,2022-02-02 08:46:29-05:00,['0e53a1cb4e8e985badc9f6dab4777f0ba3a8e41f'],23,18,41,4522640,3,,,,13773
b669d08173e3c94a45461c465a4907096ec7673f,0,exceptionfactory,2022-02-02 20:30:11-06:00,['9d8b39529ef5f877e5e8790973ca43ac049be85a'],0,4,4,4522644,1,,,,13773
11bad7b4edb9da66b88f0ddedba68703294a84c7,0,Nathan Gough,2022-02-02 22:41:44-05:00,['b669d08173e3c94a45461c465a4907096ec7673f'],2,8,10,4522654,1,,,,13773
9dbd06623813dbaf416162227e67850452e0f124,0,GitHub,2022-02-03 10:20:55-05:00,['11bad7b4edb9da66b88f0ddedba68703294a84c7'],20,25,45,4522699,1,0,0.5,1,13773
230ed9c98d5b704ab0803d14441531948b0915da,0,GitHub,2022-02-03 15:53:23-05:00,['9dbd06623813dbaf416162227e67850452e0f124'],30,149,179,4522878,11,0.512820513,0.333333333,0.884615385,13773
bab430990538cd9c453fef15e3bac748e32e4708,0,GitHub,2022-02-04 18:41:38-05:00,['230ed9c98d5b704ab0803d14441531948b0915da'],2,175,177,4523055,3,0.986111111,0.986111111,0.888888889,13775
ce66cf41e2e16a0aa4098d8ae5a69cd73851986d,0,GitHub,2022-02-04 18:43:42-05:00,['bab430990538cd9c453fef15e3bac748e32e4708'],235,227,462,4523517,2,1,0.285714286,0.071428571,13775
8d143e83677c6a40ac13bc9f98404dcc6817cc36,0,Nathan Gough,2022-02-04 18:44:15-05:00,['ce66cf41e2e16a0aa4098d8ae5a69cd73851986d'],1,21,22,4523539,1,1,1,1,13775
94668dee6e0da404a8ba7ba03a5d13ce315ce196,0,exceptionfactory,2022-02-04 20:19:07-06:00,['8d143e83677c6a40ac13bc9f98404dcc6817cc36'],73,195,268,4523807,6,0.86440678,0.745762712,0.847457627,13776
ad5b816626f6721b787ea4142831042f82cdb7cc,0,exceptionfactory,2022-02-04 21:37:59-06:00,['94668dee6e0da404a8ba7ba03a5d13ce315ce196'],1,18,19,4523826,2,,,,13777
61b867cda284e1b5437e621ade9775b1b2743b58,0,GitHub,2022-02-07 14:07:45-05:00,['ad5b816626f6721b787ea4142831042f82cdb7cc'],2,2,4,4523830,1,,,,13777
72e6accc1240f7a4e7e7ee1f658615349e9db0e1,0,Tamas Palfy,2022-02-08 17:41:34+01:00,['61b867cda284e1b5437e621ade9775b1b2743b58'],155,648,803,4524633,11,0.225092251,1,0.955719557,13779
bbc78f154701941688ee227c6190cfcfdbc0848f,0,exceptionfactory,2022-02-08 21:02:55-06:00,['72e6accc1240f7a4e7e7ee1f658615349e9db0e1'],7,97,104,4524737,3,0.75,1,1,13779
e584d3cf0466a8cef565a8f973ca5074dd48e6ad,0,Pierre Villard,2022-02-09 11:11:46+01:00,['bbc78f154701941688ee227c6190cfcfdbc0848f'],39,22,61,4524798,6,1,0,0,13779
a2f6420f43099ce3ef42d9ed00592c295c8a66bf,1,Matthew Burgess,2022-02-09 16:39:53-05:00,['e584d3cf0466a8cef565a8f973ca5074dd48e6ad'],473,438,911,4525709,61,0,0,0,13779
357a8667f98b054436a789a008e9c56ca07417d6,0,Pierre Villard,2022-02-10 10:32:27+01:00,['a2f6420f43099ce3ef42d9ed00592c295c8a66bf'],1,1,2,4525711,1,,,,13779
a3fb61d9e64bf2283f7e7b6e149e90413721dcf8,0,Pierre Villard,2022-02-10 15:03:38+01:00,['357a8667f98b054436a789a008e9c56ca07417d6'],0,4,4,4525715,1,0,0,1,13779
b8af44d81bff403654289e7837237088e4dc7a40,0,exceptionfactory,2022-02-10 13:02:31-06:00,['a3fb61d9e64bf2283f7e7b6e149e90413721dcf8'],1,750,751,4526466,7,0.487394958,0.806722689,1,13783
9e06d13ad9d9da50aa41934f5f49ef18e20efdb8,0,Matthew Burgess,2022-02-11 10:43:15-05:00,['b8af44d81bff403654289e7837237088e4dc7a40'],324,147,471,4526937,6,1,0,0,13783
766c4e392c53a0cbc81b558c8530c46ffb203157,0,exceptionfactory,2022-02-12 23:17:56-06:00,['9e06d13ad9d9da50aa41934f5f49ef18e20efdb8'],927,909,1836,4528773,70,0.956521739,0,0,13783
f6f50e6b3ac0ed9fef5ecb68e991f335792535aa,0,Pierre Villard,2022-02-14 18:30:36+01:00,['766c4e392c53a0cbc81b558c8530c46ffb203157'],35,15,50,4528823,6,,,,13783
b8ec6d38dc6f4c9dc54278686d9171d4f8d8c57e,0,Kevin Doran,2022-02-14 14:24:02-05:00,['f6f50e6b3ac0ed9fef5ecb68e991f335792535aa'],15458,24862,40320,4569143,51,0,1,1,13783
b09a778d9016e09f23c3aa065f740bb7156e07ec,0,Pierre Villard,2022-02-15 10:52:54+01:00,['b8ec6d38dc6f4c9dc54278686d9171d4f8d8c57e'],25,67,92,4569235,4,1,1,1,13783
4815df29db8b32b6992622b77ff1c7f7e9001989,0,Matthew Burgess,2022-02-15 11:46:21-05:00,['b09a778d9016e09f23c3aa065f740bb7156e07ec'],6,46,52,4569287,9,0.272727273,0.272727273,1,13783
51202d7c2d95fdb4f5d80621efe8e2d8b269bd94,1,exceptionfactory,2022-02-15 11:07:34-06:00,['4815df29db8b32b6992622b77ff1c7f7e9001989'],9,9,18,4569305,4,,,,13783
87cfd43f6f872e14e904d63fe74645d41aaa8a02,0,GitHub,2022-02-15 13:14:01-05:00,['51202d7c2d95fdb4f5d80621efe8e2d8b269bd94'],12,63,75,4569380,8,0.823529412,0.970588235,1,13783
84b2484fd46a0fc883e8b9d380ccef199432db35,0,GitHub,2022-02-15 14:55:17-05:00,['87cfd43f6f872e14e904d63fe74645d41aaa8a02'],2,2,4,4569384,1,,,,13783
63a543cd672bc9ab053b6b6d448570ab8b4b4aaa,1,GitHub,2022-02-15 15:40:41-05:00,['84b2484fd46a0fc883e8b9d380ccef199432db35'],16,1642,1658,4571042,39,0.332608696,0.82173913,0.904347826,13787
7dfbf99d5f2ab0d05e4ee524718f1107a7bc7eda,0,Matthew Burgess,2022-02-15 16:12:36-05:00,['63a543cd672bc9ab053b6b6d448570ab8b4b4aaa'],5,6,11,4571053,2,,,,13787
67880765365e033d0d772f5c7b5c2e2186a1086c,0,exceptionfactory,2022-02-15 15:51:39-06:00,['7dfbf99d5f2ab0d05e4ee524718f1107a7bc7eda'],6,32,38,4571091,2,0.684210526,1,1,13787
fe1139b8bb58acab3fa9a59dd64669848caf480a,0,Matthew Burgess,2022-02-16 09:28:21-05:00,['67880765365e033d0d772f5c7b5c2e2186a1086c'],201,160,361,4571452,71,1,1,1,13788
6ad28046c3b4fa6cecb40088c42c95ff939be74f,0,GitHub,2022-02-16 13:18:36-05:00,['fe1139b8bb58acab3fa9a59dd64669848caf480a'],2,2,4,4571456,1,,,,13788
4210e30047b7d7db17375caaba70d3465450d423,1,GitHub,2022-02-16 13:30:40-05:00,['6ad28046c3b4fa6cecb40088c42c95ff939be74f'],2,97,99,4571555,7,0.94,0.94,1,13788
2aa6bd1e135cd4959cef5a483c454dc9a1591439,0,Matthew Burgess,2022-02-16 15:30:00-05:00,['4210e30047b7d7db17375caaba70d3465450d423'],58,235,293,4571848,20,0.433333333,0.677777778,0.944444444,13789
4d8c79d7f326da46755aef7ea9c1d74295ab7f2f,0,Chris Sampson,2022-02-16 20:37:50+00:00,['2aa6bd1e135cd4959cef5a483c454dc9a1591439'],3,28,31,4571879,2,0,1,1,13789
03165ad817bae0c981f82e92c5b916324da5a5bf,0,Nathan Gough,2022-02-16 16:07:34-05:00,['4d8c79d7f326da46755aef7ea9c1d74295ab7f2f'],17,60,77,4571956,2,0,0,0,13789
a837397d563588c2659043659487b55cabd5923d,1,Matthew Burgess,2022-02-17 10:28:12-05:00,['03165ad817bae0c981f82e92c5b916324da5a5bf'],155,1069,1224,4573180,16,0.467948718,1,0.846153846,13796
2f3380390db2aba9fbafcdca5a8b3ffbb92acac4,0,Nathan Gough,2022-02-17 12:55:12-05:00,['a837397d563588c2659043659487b55cabd5923d'],25,35,60,4573240,1,1,1,1,13796
a8fd5993eb164d2b8b1d531ecf9b95e79232404f,0,Joey Frazee,2022-02-18 10:40:52-08:00,['2f3380390db2aba9fbafcdca5a8b3ffbb92acac4'],0,5,5,4573245,1,,,,13796
7ef2fd2986461b632e398b7ddff47db153c3c0e5,0,exceptionfactory,2022-02-18 15:19:22-05:00,['a8fd5993eb164d2b8b1d531ecf9b95e79232404f'],28,122,150,4573395,7,0.5,1,0.921052632,13797
dfbf2e3cea5485196c18934d0c01f49103f12727,0,Mike Thomsen,2022-02-19 14:11:44-05:00,['7ef2fd2986461b632e398b7ddff47db153c3c0e5'],33,123,156,4573551,4,0,0.797468354,0.670886076,13797
8d80fb29300964be1ada0c433d3bc8e24df1e382,0,Mike Thomsen,2022-02-19 18:46:20-05:00,['dfbf2e3cea5485196c18934d0c01f49103f12727'],4,5,9,4573560,1,0,0,1,13797
635824904db67d9cebc2f3073c7aeb2ea59e2b9f,0,exceptionfactory,2022-02-21 19:38:47-06:00,['8d80fb29300964be1ada0c433d3bc8e24df1e382'],17,645,662,4574222,12,0.698113208,1,1,13805
4141ed29ecfcd6329e3af0b7f7290a9d6aa7d8c7,0,exceptionfactory,2022-02-21 20:01:25-06:00,['635824904db67d9cebc2f3073c7aeb2ea59e2b9f'],0,395,395,4574617,7,0.625,1,1,13810
07131a66ea39155f4523b974912b6820058cad5b,0,Mike Thomsen,2022-02-22 06:32:56-05:00,['4141ed29ecfcd6329e3af0b7f7290a9d6aa7d8c7'],6,70,76,4574693,3,0.25,0,0.25,13810
54b4209798e3224881b8bc1ae5d5bebc9f82251c,0,Mike Thomsen,2022-02-22 07:58:45-05:00,['07131a66ea39155f4523b974912b6820058cad5b'],2,4,6,4574699,1,0,0,1,13810
0ade040b76f232ecd394b1ed93c8d2c9134768bb,0,Mike Thomsen,2022-02-22 08:01:59-05:00,['54b4209798e3224881b8bc1ae5d5bebc9f82251c'],2,4,6,4574705,1,0,1,1,13810
22b47ccc7b8af2a432ac46e893388da1afefa611,0,Mike Thomsen,2022-02-22 08:06:52-05:00,['0ade040b76f232ecd394b1ed93c8d2c9134768bb'],5,6,11,4574716,1,,,,13810
04d061a7bd2109af18a49950c88d89391ee9840c,0,Joe Gresock,2022-02-22 11:42:01-05:00,['22b47ccc7b8af2a432ac46e893388da1afefa611'],92,432,524,4575240,8,0,0,0.477876106,13810
d0a23bc26baf7775affebaf3de66fb4d674f17c0,0,Joe Gresock,2022-02-22 12:06:54-05:00,['04d061a7bd2109af18a49950c88d89391ee9840c'],18,139,157,4575397,9,0.591549296,0.591549296,1,13810
45f87951778f31d3bee06da7cd03ca5bc9e82c0f,0,Joe Gresock,2022-02-22 12:58:30-05:00,['d0a23bc26baf7775affebaf3de66fb4d674f17c0'],34,117,151,4575548,6,0.925925926,1,0,13811
dc1117d10470b4f57fd9cca3c91f9e9a37a1dbb1,0,exceptionfactory,2022-02-22 14:55:43-06:00,['45f87951778f31d3bee06da7cd03ca5bc9e82c0f'],0,18,18,4575566,3,,,,13811
ce0122bd2530e37eb57ace919a42bb2eb3cd5c02,1,Joe Gresock,2022-02-22 18:54:32-05:00,['dc1117d10470b4f57fd9cca3c91f9e9a37a1dbb1'],367,3204,3571,4579137,42,0.482721382,0.796976242,0.778617711,13839
a3e1f32cae964df9dee47600016db9d2baba5d34,0,Peter Turcsanyi,2022-02-23 16:09:31+01:00,['ce0122bd2530e37eb57ace919a42bb2eb3cd5c02'],16,639,655,4579792,6,0.657718121,0.711409396,0.802013423,13841
3511ce3d132f18fffd6e2a7aaf14962314d556ef,0,Joe Gresock,2022-02-23 11:29:26-05:00,['a3e1f32cae964df9dee47600016db9d2baba5d34'],24,66,90,4579882,9,0.142857143,0,1,13841
ab4cadc20444bc6c1539ae1806f3747552cac8cb,0,Joe Gresock,2022-02-23 12:44:57-05:00,['3511ce3d132f18fffd6e2a7aaf14962314d556ef'],0,16,16,4579898,2,0.666666667,0.666666667,0.666666667,13841
8b62ebeb7602872b3fd6c43e0d4de9b9a297f33c,0,exceptionfactory,2022-02-23 21:03:43-06:00,['ab4cadc20444bc6c1539ae1806f3747552cac8cb'],287,258,545,4580443,25,1,0,0,13841
51cf0fb0d1bc43d90c18969ed4f24d8992271872,0,exceptionfactory,2022-02-23 21:18:25-06:00,['8b62ebeb7602872b3fd6c43e0d4de9b9a297f33c'],651,462,1113,4581556,41,1,0,0,13841
9237b4e923eeac6016d0ac605abf36c745ef0c63,0,Joe Gresock,2022-02-24 08:58:54-05:00,['51cf0fb0d1bc43d90c18969ed4f24d8992271872'],42,116,158,4581714,2,0.306122449,1,1,13841
39483b9c121b11abbc00f12232075ef4328a17ee,1,Joe Gresock,2022-02-24 09:13:16-05:00,['9237b4e923eeac6016d0ac605abf36c745ef0c63'],28,47,75,4581789,3,0.875,1,1,13841
c331f9cb9ad53f6d413b6174456edc48af3763d4,0,GitHub,2022-02-24 12:27:01-05:00,['39483b9c121b11abbc00f12232075ef4328a17ee'],7,24,31,4581820,3,0,1,1,13841
c453d2ba8f1748dd9d26b218705c3372c081110b,0,Joe Gresock,2022-02-24 15:13:14-05:00,['c331f9cb9ad53f6d413b6174456edc48af3763d4'],27,242,269,4582089,7,0.325,0.825,0.975,13842
13be48cfe35f896d5c54e00f9b0d03c4f8ac950a,0,exceptionfactory,2022-02-24 16:59:44-06:00,['c453d2ba8f1748dd9d26b218705c3372c081110b'],517,528,1045,4583134,90,1,0,0,13842
432f98714fb700b038baf043053f0bf20b8b72bf,0,exceptionfactory,2022-02-24 22:16:01-06:00,['13be48cfe35f896d5c54e00f9b0d03c4f8ac950a'],5,5,10,4583144,1,0,0,1,13842
a6aba3bf8e43734bb1f10347e66e6a17a9d4646a,0,Matthew Burgess,2022-02-25 10:40:24-05:00,['432f98714fb700b038baf043053f0bf20b8b72bf'],10,0,10,4583154,2,,,,13842
49d1c747cac465f8f40758142e5c5c549d5d618f,0,Joe Gresock,2022-02-25 11:03:55-05:00,['a6aba3bf8e43734bb1f10347e66e6a17a9d4646a'],272,518,790,4583944,8,0.584415584,0.792207792,1,13846
e74991e7059adfd5528e615131590a2e98c2b836,0,exceptionfactory,2022-02-25 11:42:02-05:00,['49d1c747cac465f8f40758142e5c5c549d5d618f'],5,1,6,4583950,1,0,0,0,13846
6cea5ea520f48c5d05a30df93fa582cf42d3438e,1,Joe Gresock,2022-02-25 14:29:38-05:00,['e74991e7059adfd5528e615131590a2e98c2b836'],15,298,313,4584263,7,0.503448276,1,0.896551724,13848
4e3871fec751cfcccb3a34a724d338321e1e8067,0,GitHub,2022-02-25 14:57:04-05:00,['6cea5ea520f48c5d05a30df93fa582cf42d3438e'],31,305,336,4584599,3,0.567010309,0.402061856,0.927835052,13849
bcc8d03314889e7d2d0724390059d0315efe2a34,1,exceptionfactory,2022-02-25 19:20:48-06:00,['4e3871fec751cfcccb3a34a724d338321e1e8067'],296,503,799,4585398,27,0.42,0,0,13856
ae1731c79ebe073c7f31a19ef586bf95d7e6dc85,0,exceptionfactory,2022-02-26 08:18:08-06:00,['bcc8d03314889e7d2d0724390059d0315efe2a34'],796,737,1533,4586931,41,1,0,0,13856
1eede30974734b7d556135d0b5f52910277ffd38,0,Mike Thomsen,2022-02-27 06:09:14-05:00,['ae1731c79ebe073c7f31a19ef586bf95d7e6dc85'],1,1,2,4586933,1,,,,13856
4b41570d173132ae04d64095cd7e9d0d5df8e312,0,Matthew Burgess,2022-02-28 09:12:51-05:00,['1eede30974734b7d556135d0b5f52910277ffd38'],1,97,98,4587031,2,0,0.512820513,1,13856
483968bac38c946afef685e306884ff066b24769,0,Matthew Burgess,2022-02-28 10:24:32-05:00,['4b41570d173132ae04d64095cd7e9d0d5df8e312'],87,256,343,4587374,3,0.091549296,0.64084507,0.908450704,13856
589a1c24d1931159c286c8150fd1d7685a40cd2e,0,exceptionfactory,2022-02-28 10:39:47-06:00,['483968bac38c946afef685e306884ff066b24769'],1476,1324,2800,4590174,85,1,0,0,13856
649e2d25560318b7d8a0a6b7e5d2ab9c899e1af6,0,Matthew Burgess,2022-02-28 13:21:10-05:00,['589a1c24d1931159c286c8150fd1d7685a40cd2e'],6,15,21,4590195,1,1,1,1,13856
ddecfa201badbf1a936bb12fe1d3f650ea43cf99,0,GitHub,2022-02-28 14:26:19-05:00,['649e2d25560318b7d8a0a6b7e5d2ab9c899e1af6'],12,11,23,4590218,1,1,0,0,13856
52f21390dbbf619bb38699d66df3cf6ed322e303,0,GitHub,2022-02-28 14:29:44-05:00,['ddecfa201badbf1a936bb12fe1d3f650ea43cf99'],2,22,24,4590242,9,,,,13856
875f589548429b234faf408cbb5f019e11c422b8,0,Joe Gresock,2022-03-01 06:06:48-05:00,['52f21390dbbf619bb38699d66df3cf6ed322e303'],15,9,24,4590266,4,1,0,0,13856
9bb34188c98b9ffef24310f0c62a669b9241b3f9,1,Joe Gresock,2022-03-01 06:49:34-05:00,['875f589548429b234faf408cbb5f019e11c422b8'],14,17,31,4590297,2,,,,13856
dd3c9be847c3c1802ef72525d89a8a8fc820218a,0,Joe Gresock,2022-03-01 06:51:16-05:00,['9bb34188c98b9ffef24310f0c62a669b9241b3f9'],6,71,77,4590374,3,0.225,1,1,13856
db28c91cdbe33407448106bc6fd9649762a65f94,0,GitHub,2022-03-01 09:57:51-05:00,['dd3c9be847c3c1802ef72525d89a8a8fc820218a'],1,1,2,4590376,1,,,,13856
9d3788ff05a9774bb79ef34ac648266981f3864c,0,Joe Gresock,2022-03-01 13:49:47-05:00,['db28c91cdbe33407448106bc6fd9649762a65f94'],4,38,42,4590418,3,0.034482759,0,0.965517241,13856
0d0912d34b7d2fb9415ad6ffb782edd32b57eb22,0,Joe Gresock,2022-03-01 14:17:32-05:00,['9d3788ff05a9774bb79ef34ac648266981f3864c'],6,7,13,4590431,1,,,,13856
4719f78ef4be3508008bb5c49dbb16942cb51a7e,0,GitHub,2022-03-01 14:57:18-05:00,['0d0912d34b7d2fb9415ad6ffb782edd32b57eb22'],74,323,397,4590828,8,0,0.597826087,1,13856
d17fcf6427e0b00b6e48c0c80a4ca111925fa41b,0,Nathan Gough,2022-03-01 15:49:23-05:00,['4719f78ef4be3508008bb5c49dbb16942cb51a7e'],8,1,9,4590837,1,1,0,0,13856
a327ba478ad87d28342c582de0b683b672fd4525,0,Matthew Burgess,2022-03-01 17:52:02-05:00,['d17fcf6427e0b00b6e48c0c80a4ca111925fa41b'],0,6,6,4590843,1,1,1,1,13856
53a35ae4c999824b1c79c31954d2b9b719efd997,0,Joe Gresock,2022-03-02 06:22:37-05:00,['a327ba478ad87d28342c582de0b683b672fd4525'],2,29,31,4590874,1,0,0,1,13856
cf7af1b4637093888df5c1a9bacef749a30f4e7a,0,Pierre Villard,2022-03-02 12:48:15+01:00,['53a35ae4c999824b1c79c31954d2b9b719efd997'],1,1,2,4590876,1,,,,13856
4cc20e6c0687277394f021ca1f3ececd430c5a0e,1,Joe Gresock,2022-03-02 10:04:34-05:00,['cf7af1b4637093888df5c1a9bacef749a30f4e7a'],19,147,166,4591042,12,1,1,1,13857
a85cafe7718aee5a4080ccd35432b6517d90dab4,0,Joe Gresock,2022-03-02 11:18:58-05:00,['4cc20e6c0687277394f021ca1f3ececd430c5a0e'],21,22,43,4591085,2,0.8,0.6,1,13857
fee7c16732983d1b7f185e23e63105d250bb87ae,0,Joe Gresock,2022-03-02 12:31:09-05:00,['a85cafe7718aee5a4080ccd35432b6517d90dab4'],0,23,23,4591108,3,,,,13857
db7690769d5966d390638461e13f8896fc4cb840,0,Joe Gresock,2022-03-02 19:12:32-05:00,['fee7c16732983d1b7f185e23e63105d250bb87ae'],14,55,69,4591177,1,1,1,1,13857
272f4122542c6a77d7867b4728a8c0f9165551a4,1,exceptionfactory,2022-03-02 18:49:34-06:00,['db7690769d5966d390638461e13f8896fc4cb840'],8,10,18,4591195,2,1,1,0,13857
6bc85155f9aa829ca93696db189460543d75953f,0,exceptionfactory,2022-03-02 18:52:43-06:00,['272f4122542c6a77d7867b4728a8c0f9165551a4'],4,22,26,4591221,3,,,,13857
7a16619969a90655b5aed6bf938fa0a3019ab673,0,GitHub,2022-03-03 09:13:00-05:00,['6bc85155f9aa829ca93696db189460543d75953f'],1,36,37,4591258,2,0.342857143,1,1,13857
d2e90dd160a4d95c1ae685b1271c050fe7f9bf84,0,exceptionfactory,2022-03-03 15:24:52-06:00,['7a16619969a90655b5aed6bf938fa0a3019ab673'],80,81,161,4591419,16,1,0,,13858
c91f543c2b6c820946ab1bc19706638c4bfb37cc,0,Kevin Doran,2022-03-03 16:30:47-05:00,['d2e90dd160a4d95c1ae685b1271c050fe7f9bf84'],27,129,156,4591575,12,0,1,1,13858
6f5fda54e5f0510f7fc34c8860b942d33db13d1c,0,GitHub,2022-03-03 14:45:35-08:00,['c91f543c2b6c820946ab1bc19706638c4bfb37cc'],11,11,22,4591597,6,,,,13858
6cd30e3d0aa6e7f8763afc7c4cb007b322555573,1,GitHub,2022-03-03 18:50:15-05:00,['6f5fda54e5f0510f7fc34c8860b942d33db13d1c'],44,214,258,4591855,21,0.063063063,0.846846847,0.837837838,13858
923e9f4e4fef6df622bfdb1c82fbd3abfa2899ed,0,Mike Thomsen,2022-03-04 06:18:09-05:00,['6cd30e3d0aa6e7f8763afc7c4cb007b322555573'],1,1,2,4591857,1,,,,13858
7438bc9244169801b3d1fe0f06d147f5742e1516,0,Mike Thomsen,2022-03-04 06:23:51-05:00,['923e9f4e4fef6df622bfdb1c82fbd3abfa2899ed'],5,5,10,4591867,4,,,,13858
8959226b50cb2f3fc46722f32810ec06037985e4,1,Joe Gresock,2022-03-04 07:19:38-05:00,['7438bc9244169801b3d1fe0f06d147f5742e1516'],288,479,767,4592634,60,0.666666667,1,0.962962963,13861
65dd62716a62164f44be85657283103885f0f3ae,0,Mike Thomsen,2022-03-04 08:24:39-05:00,['8959226b50cb2f3fc46722f32810ec06037985e4'],32,80,112,4592746,1,0,0.105263158,0.105263158,13861
12685a4af442eb343808d9017f29b5087520a146,0,Mike Thomsen,2022-03-05 19:05:02-05:00,['65dd62716a62164f44be85657283103885f0f3ae'],4,6,10,4592756,2,,,,13861
9782a5156433f036079d930d9b92231764cd1cab,0,Mike Thomsen,2022-03-06 08:27:06-05:00,['12685a4af442eb343808d9017f29b5087520a146'],11,26,37,4592793,22,,,,13862
7d046fe3de247f9dc72497391a84a48829d7f018,0,Matthew Burgess,2022-03-07 08:53:08-05:00,['9782a5156433f036079d930d9b92231764cd1cab'],1,1,2,4592795,1,,,,13862
d062029258631114f201ef6c64f1552622bc9aee,0,GitHub,2022-03-07 13:57:35-05:00,['7d046fe3de247f9dc72497391a84a48829d7f018'],0,55,55,4592850,2,0.864864865,1,0.864864865,13862
fc5c810de7a93ca39ed92530013d7ed426f28700,0,exceptionfactory,2022-03-07 13:41:07-06:00,['d062029258631114f201ef6c64f1552622bc9aee'],20,23,43,4592893,4,0,0.5,0,13862
743020eeb45382295e1cb4c4399dc7389d17946c,0,Matthew Burgess,2022-03-07 14:43:11-05:00,['fc5c810de7a93ca39ed92530013d7ed426f28700'],23,118,141,4593034,2,0.538461538,0.333333333,0,13862
43bf2b59750e93e60c2e6497ba7ae1914400961a,0,exceptionfactory,2022-03-07 19:18:02-06:00,['743020eeb45382295e1cb4c4399dc7389d17946c'],1,1,2,4593036,1,,,,13862
f35f010deb069bb050bfc3a6061b0eef6a01f68e,1,exceptionfactory,2022-03-07 21:49:23-06:00,['43bf2b59750e93e60c2e6497ba7ae1914400961a'],3544,2462,6006,4599042,173,0.930576071,0,0.013293944,13862
e6229ab938571f5339805797b6a6ffeebcfad652,0,Joe Gresock,2022-03-08 06:42:27-05:00,['f35f010deb069bb050bfc3a6061b0eef6a01f68e'],24,33,57,4599099,1,0,0,1,13862
227dcf54566ae10648881169f5ce881fc3d28c5f,0,GitHub,2022-03-08 16:25:32-05:00,['e6229ab938571f5339805797b6a6ffeebcfad652'],0,19,19,4599118,1,0.529411765,1,0.823529412,13862
3b8afee9d6b84f4b4467a81ddac6e3d5bae573ac,0,Pierre Villard,2022-03-09 14:49:28+01:00,['227dcf54566ae10648881169f5ce881fc3d28c5f'],0,0,0,4599118,1,,,,13862
c8f8747dbc6075be4feb3549fa5cc4b2e8a0fb7c,0,Mike Thomsen,2022-03-09 08:51:00-05:00,['3b8afee9d6b84f4b4467a81ddac6e3d5bae573ac'],1,1,2,4599120,1,,,,13862
b86466b4a5eae655a0a708430da722a164cef8aa,0,Peter Turcsanyi,2022-03-09 16:20:33+01:00,['c8f8747dbc6075be4feb3549fa5cc4b2e8a0fb7c'],44,1832,1876,4600996,19,0.519083969,0.828244275,0.899491094,13874
3219c105ebd6d3a648c84684b2cb78efe81da438,0,Pierre Villard,2022-03-09 16:50:38+01:00,['b86466b4a5eae655a0a708430da722a164cef8aa'],76,178,254,4601250,11,0.459016393,0.786885246,0.803278689,13874
6a1c7c72d5b91b9ce5d5cb5b86e3155d21e2c19b,0,Joe Gresock,2022-03-09 13:07:15-05:00,['3219c105ebd6d3a648c84684b2cb78efe81da438'],3,18,21,4601271,2,0,0,0,13874
c73573b325a6e370bb3031e6906c786bcbf72ebc,0,GitHub,2022-03-09 15:15:52-05:00,['6a1c7c72d5b91b9ce5d5cb5b86e3155d21e2c19b'],43,385,428,4601699,3,0.388571429,0.982857143,0.8,13875
73356ea448dced6a789f2d71c5cb5aceac45520e,1,Joe Witt,2022-03-09 13:26:32-07:00,['c73573b325a6e370bb3031e6906c786bcbf72ebc'],4,50,54,4601753,2,0,0.685714286,1,13875
4a46b087b866205fb85d92853fc82398612d35c9,0,Joe Witt,2022-03-09 13:26:54-07:00,['73356ea448dced6a789f2d71c5cb5aceac45520e'],0,4,4,4601757,1,,,,13875
df2f1f3b49cf90d2c9a97e41cea67aae40598681,0,Joe Witt,2022-03-09 13:35:25-07:00,['4a46b087b866205fb85d92853fc82398612d35c9'],2,2,4,4601761,2,,,,13875
23132fb89f63b8eb1305103934cb5aaed061eefe,0,Matthew Burgess,2022-03-09 19:06:08-05:00,['df2f1f3b49cf90d2c9a97e41cea67aae40598681'],0,1031,1031,4602792,5,0.431524548,0.550387597,0.963824289,13879
df00cc6cb576c11ae3ef0f1c6f64454598298936,1,Matthew Burgess,2022-03-09 19:06:44-05:00,['23132fb89f63b8eb1305103934cb5aaed061eefe'],655,682,1337,4604129,7,0.933333333,1,0.2,13881
92202a5b9502609c6d26f7b5ee299bfc36441fb1,0,Pierre Villard,2022-03-10 13:16:24+01:00,['df00cc6cb576c11ae3ef0f1c6f64454598298936'],17,21,38,4604167,2,0,0,1,13881
546f986603458062d9676b8511f8e566d0748f26,0,Joe Gresock,2022-03-10 07:52:16-05:00,['92202a5b9502609c6d26f7b5ee299bfc36441fb1'],66,388,454,4604621,8,0.288135593,1,0.93220339,13886
859d5fe8cfe05ad24600b021f0ebf15753a8105c,0,Nathan Gough,2022-03-10 11:47:32-05:00,['546f986603458062d9676b8511f8e566d0748f26'],19,35,54,4604675,2,1,1,1,13886
72fadf9e510c38288c37c539b47cd9b05187cda2,0,Joe Witt,2022-03-10 11:15:16-07:00,['859d5fe8cfe05ad24600b021f0ebf15753a8105c'],70,71,141,4604816,69,,,,13886
885c475f905f563b02d0779bf5c64635ca4c4d2e,1,exceptionfactory,2022-03-11 11:40:47-06:00,['72fadf9e510c38288c37c539b47cd9b05187cda2'],57,202,259,4605075,2,1,1,0.841269841,13887
6e974a1fd21dc95f78450ced7a4811e1b6e60466,0,Mike Thomsen,2022-03-11 18:01:45-05:00,['885c475f905f563b02d0779bf5c64635ca4c4d2e'],1,1,2,4605077,1,,,,13887
d424537c53e8b9a79cc91260d63220738616d685,0,GitHub,2022-03-11 17:25:47-08:00,['6e974a1fd21dc95f78450ced7a4811e1b6e60466'],17,258,275,4605352,14,0.971428571,1,1,13892
e226d3be525e40c42d9b42835757790063b5a504,0,Mike Thomsen,2022-03-12 12:04:28-05:00,['d424537c53e8b9a79cc91260d63220738616d685'],2,14,16,4605368,2,0,1,1,13892
237e481c4a2acadc67cd65001b52e74874741ccd,0,GitHub,2022-03-14 08:51:16-04:00,['e226d3be525e40c42d9b42835757790063b5a504'],0,39,39,4605407,2,,,,13892
7ff70706ee6c9b3ea1c508701936c07bb0e6da40,0,Joe Witt,2022-03-14 08:38:39-07:00,['237e481c4a2acadc67cd65001b52e74874741ccd'],0,2,2,4605409,1,0,0,1,13892
713e2fd03cc1f7084dc9f5ab14636a6986390257,0,exceptionfactory,2022-03-14 11:15:16-05:00,['7ff70706ee6c9b3ea1c508701936c07bb0e6da40'],2,66,68,4605477,4,0.894736842,1,1,13893
a7abe6d722067a4f4a38372916f32051b79ea72b,0,Nathan Gough,2022-03-14 13:08:03-04:00,['713e2fd03cc1f7084dc9f5ab14636a6986390257'],1,15,16,4605493,2,,,,13893
a7edabb4ff674042848b2a20b9456e96469029b5,0,exceptionfactory,2022-03-14 12:15:11-05:00,['a7abe6d722067a4f4a38372916f32051b79ea72b'],18,310,328,4605821,4,,,,13895
21922af90cf5b9b31995d1489d1c80d803dd6842,0,GitHub,2022-03-14 15:45:02-04:00,['a7edabb4ff674042848b2a20b9456e96469029b5'],5,29,34,4605855,2,0.4375,0.625,0.4375,13895
36b3f184249c2184df7ae69a23c30144f5c2c2b2,0,Joe Witt,2022-03-14 12:52:36-07:00,['21922af90cf5b9b31995d1489d1c80d803dd6842'],13,12,25,4605880,1,0,1,1,13895
77c45cabc5c236b9b3cb563b143e53abafbd1921,1,Nathan Gough,2022-03-14 18:31:44-04:00,['36b3f184249c2184df7ae69a23c30144f5c2c2b2'],50,86,136,4606016,3,1,1,1,13896
a0fc7f5e614fc17b67b1082eba6e10bffb5a2df3,0,exceptionfactory,2022-03-16 10:53:35-05:00,['77c45cabc5c236b9b3cb563b143e53abafbd1921'],2,0,2,4606018,1,,,,13896
a4a46d50c3d35191dc2e8d72514d4045776f87d9,0,Matthew Burgess,2022-03-16 14:25:32-04:00,['a0fc7f5e614fc17b67b1082eba6e10bffb5a2df3'],7,7,14,4606032,2,,,,13896
412e21be977a6eb04cc247ceb3f9b178d6b19d97,1,Mike Thomsen,2022-03-17 14:08:38-04:00,['a4a46d50c3d35191dc2e8d72514d4045776f87d9'],824,318,1142,4607174,43,0.594594595,0.115830116,0,13896
e17a436797bb7075c5747cb7b3bcdd62620a7875,0,Mike Thomsen,2022-03-17 14:38:57-04:00,['412e21be977a6eb04cc247ceb3f9b178d6b19d97'],8,0,8,4607182,4,,,,13896
fc30b649cccbbecaf8b861def94b6a3a75e532ea,0,Mike Thomsen,2022-03-17 20:01:32-04:00,['e17a436797bb7075c5747cb7b3bcdd62620a7875'],29,69,98,4607280,3,1,1,1,13896
ab0d2c2f72d51fd78dd9dfe1d976153a56aff8fd,0,Mike Thomsen,2022-03-18 08:32:05-04:00,['fc30b649cccbbecaf8b861def94b6a3a75e532ea'],34,45,79,4607359,4,0,0,0,13896
193bcbe33a320699eb2c6c62a16072830422cab7,0,GitHub,2022-03-18 08:43:17-04:00,['ab0d2c2f72d51fd78dd9dfe1d976153a56aff8fd'],237,135,372,4607731,8,0,0,0,13898
7823156606ca541ef9cae7192b092efd2cfe4e9a,0,Mike Thomsen,2022-03-18 20:11:05-04:00,['193bcbe33a320699eb2c6c62a16072830422cab7'],36,28,64,4607795,16,1,0.333333333,0.333333333,13898
8d5de6b292981818e81ffd6cb3b8773c710884ca,0,Mike Thomsen,2022-03-21 08:23:40-04:00,['7823156606ca541ef9cae7192b092efd2cfe4e9a'],7,9,16,4607811,3,,,,13898
2bb1a06a8c5efa9eb95ebd9c26983190d09b4211,0,exceptionfactory,2022-03-21 09:13:05-05:00,['8d5de6b292981818e81ffd6cb3b8773c710884ca'],14,29,43,4607854,21,,,,13898
a8cd7e5200332b38006a99a55e600de3650377a1,0,exceptionfactory,2022-03-21 10:48:00-05:00,['2bb1a06a8c5efa9eb95ebd9c26983190d09b4211'],0,1,1,4607855,1,0,0,0,13898
2dc23e7309c6b15231b66d933fe0d77ac5db083d,0,exceptionfactory,2022-03-21 12:33:38-05:00,['a8cd7e5200332b38006a99a55e600de3650377a1'],6,0,6,4607861,1,,,,13898
c84f43878205726a4e7b891ebd64068516bcfe68,0,Matthew Burgess,2022-03-21 14:00:13-04:00,['2dc23e7309c6b15231b66d933fe0d77ac5db083d'],10,21,31,4607892,1,0,0,0,13898
b019a9191f1c83bc7f547dc02c1b679b8936acee,0,Joe Witt,2022-03-21 11:58:09-07:00,['c84f43878205726a4e7b891ebd64068516bcfe68'],2293,4802,7095,4614987,649,,,,13898
0419dc2939d726c9bc489d7eca8f7eed085c0e89,0,Joe Witt,2022-03-21 11:58:27-07:00,['b019a9191f1c83bc7f547dc02c1b679b8936acee'],4997,2290,7287,4622274,649,,,,13898
5928d2048ee9e9f8b4572832a12816bde5419e23,0,Paul Grey,2022-03-21 16:13:32-04:00,['c84f43878205726a4e7b891ebd64068516bcfe68'],0,20,20,4622294,1,0.058823529,1,1,13898
772adbc70957cc47256c8f7ea3668b2187e12923,1,exceptionfactory,2022-03-23 13:30:15-05:00,['5928d2048ee9e9f8b4572832a12816bde5419e23'],22,280,302,4622596,2,,,,13898
72435c3c6dc0e436bbb5767ed4cdf0ae26f33476,0,exceptionfactory,2022-03-23 15:55:40-05:00,['772adbc70957cc47256c8f7ea3668b2187e12923'],0,110,110,4622706,4,0.444444444,0.8,1,13899
a75381abbe50c964b5ad0d531ce39044b4cdfb30,0,Chris Sampson,2022-03-24 13:24:28+00:00,['72435c3c6dc0e436bbb5767ed4cdf0ae26f33476'],1,1,2,4622708,1,,,,13899
2ac90a644186bd1b78299a4537fd773000363998,0,GitHub,2022-03-25 06:48:57-04:00,['a75381abbe50c964b5ad0d531ce39044b4cdfb30'],0,5,5,4622713,1,0,0,1,13899
63f02c99bf0b0e4c47a20d8b09b638ebec2345b6,0,exceptionfactory,2022-03-25 12:42:03-05:00,['2ac90a644186bd1b78299a4537fd773000363998'],45,42,87,4622800,5,0.555555556,0.555555556,0,13899
16c9bd535bebb1438f28c4ed1ec30f02cc994c60,0,Peter Turcsanyi,2022-03-25 21:07:25+01:00,['63f02c99bf0b0e4c47a20d8b09b638ebec2345b6'],1,5,6,4622806,1,1,1,1,13899
105890ef37ee12edfd082cadc74abf0513cf86a4,1,Mike Thomsen,2022-03-26 07:22:07-04:00,['16c9bd535bebb1438f28c4ed1ec30f02cc994c60'],316,352,668,4623474,60,0,0,0,13901
2fbe10b4bc246eaec8ab289d88f7cf3b46b75496,1,exceptionfactory,2022-03-28 12:47:30-05:00,['105890ef37ee12edfd082cadc74abf0513cf86a4'],80,183,263,4623737,4,1,0.985074627,1,13902
9566d3fa786c074491096009da075f26d7188bde,0,exceptionfactory,2022-03-28 13:28:28-05:00,['2fbe10b4bc246eaec8ab289d88f7cf3b46b75496'],26,8,34,4623771,2,,,,13902
6ade47ac4f4fb6a4e0be84d5f2431e0c2f2718eb,0,exceptionfactory,2022-03-28 13:36:16-05:00,['9566d3fa786c074491096009da075f26d7188bde'],5,65,70,4623841,4,0.441176471,0.970588235,0.941176471,13902
0fa4490a9857f67427d21397f7292fdfeaeac77d,0,Mike Thomsen,2022-03-28 16:00:23-04:00,['6ade47ac4f4fb6a4e0be84d5f2431e0c2f2718eb'],167,148,315,4624156,22,,,,13902
b03fdac1b5d91f867bd8f8e7591bbb373f4b9901,0,GitHub,2022-03-28 16:58:45-04:00,['0fa4490a9857f67427d21397f7292fdfeaeac77d'],1,1,2,4624158,1,,,,13902
2a6e521549e08d7290acf6a96a3b344f3cd60f7f,0,exceptionfactory,2022-03-28 16:03:00-05:00,['b03fdac1b5d91f867bd8f8e7591bbb373f4b9901'],2,9,11,4624169,3,0.333333333,1,0.333333333,13902
bf5168729142168d2549d898e6752a2f83b58067,0,Mike Thomsen,2022-03-29 07:15:54-04:00,['2a6e521549e08d7290acf6a96a3b344f3cd60f7f'],895,4,899,4625068,6,0.459259259,0.227777778,0.109259259,13902
2f501fcbe5ee8867a6ab98d7568a1c2694f58d40,0,GitHub,2022-03-29 11:32:21-04:00,['bf5168729142168d2549d898e6752a2f83b58067'],2,2,4,4625072,1,,,,13902
14e4f1bfc27251059c5ac8ed381ef63b5e6ac0f1,0,GitHub,2022-03-29 11:18:53-07:00,['2f501fcbe5ee8867a6ab98d7568a1c2694f58d40'],2,5,7,4625079,1,,,,13902
cf21bc47cd63e316eaa4a899f8b3373a6ca1b1fc,0,Nathan Gough,2022-03-29 17:53:13-04:00,['14e4f1bfc27251059c5ac8ed381ef63b5e6ac0f1'],1163,402,1565,4626644,6,1,1,0.909090909,13904
d09b8283336b71b666c9484c471399df60689ec4,0,exceptionfactory,2022-03-30 08:38:46-05:00,['cf21bc47cd63e316eaa4a899f8b3373a6ca1b1fc'],27,28,55,4626699,23,,,,13904
b53fb87aa1af5638744f4b35d074c8ae433f98a2,0,Joe Gresock,2022-03-30 11:03:30-04:00,['d09b8283336b71b666c9484c471399df60689ec4'],2,2,4,4626703,1,,,,13904
cd0b289146cc4a2d893a58adebd3dca013a866a0,0,exceptionfactory,2022-03-30 10:23:40-05:00,['b53fb87aa1af5638744f4b35d074c8ae433f98a2'],1,4,5,4626708,2,0,0,0,13904
0f8183dd953c6f7bd173ba07618beaa0bf199c32,1,exceptionfactory,2022-03-30 11:04:22-05:00,['cd0b289146cc4a2d893a58adebd3dca013a866a0'],631,239,870,4627578,14,0,0.025641026,1,13904
940fd8e81c91f171f5f034550fbadb47e322229b,0,GitHub,2022-03-30 15:25:14-04:00,['0f8183dd953c6f7bd173ba07618beaa0bf199c32'],180,246,426,4628004,12,1,0.612903226,0.870967742,13904
8abdd163ba85546372f80227fa4055cf03fa97e2,0,exceptionfactory,2022-03-30 20:09:44-05:00,['940fd8e81c91f171f5f034550fbadb47e322229b'],5,4,9,4628013,3,,,,13904
3c10910fe266ca8274ef8d14ad2423e5bef6c7be,0,Kevin Doran,2022-03-31 13:42:25-04:00,['8abdd163ba85546372f80227fa4055cf03fa97e2'],112,41,153,4628166,7,0,0,0,13904
7fde2bbfd1afdd6037765340eca9fc675542323e,0,Nathan Gough,2022-03-31 18:22:54-04:00,['3c10910fe266ca8274ef8d14ad2423e5bef6c7be'],2,2,4,4628170,2,,,,13904
2e66cf711469da804a60bcd596a10ea8ea5afb0a,1,Peter Turcsanyi,2022-04-01 17:51:07+02:00,['7fde2bbfd1afdd6037765340eca9fc675542323e'],2,11,13,4628183,2,0,1,0,13904
c9dee4ddba006bd8ae407cf893b0760ba5070b3a,0,Nathan Gough,2022-04-01 12:07:48-04:00,['2e66cf711469da804a60bcd596a10ea8ea5afb0a'],2,2,4,4628187,2,,,,13904
a4087f32bbc7fd7cd387f8c5dfe2d6586970d5ed,0,GitHub,2022-04-01 14:28:38-04:00,['c9dee4ddba006bd8ae407cf893b0760ba5070b3a'],111,460,571,4628758,9,0.664948454,1,1,13905
f57facdbcf53ae44a52c0b67e442caebf17c64eb,0,Paul Grey,2022-04-01 16:10:37-04:00,['a4087f32bbc7fd7cd387f8c5dfe2d6586970d5ed'],32,166,198,4628956,7,0.448275862,1,1,13906
e6e4109cf901d19e99f5d6b9df7a988750a16065,0,GitHub,2022-04-02 13:30:55-04:00,['f57facdbcf53ae44a52c0b67e442caebf17c64eb'],215,263,478,4629434,4,1,1,0.916666667,13906
4a90334728372d35b326948e112fb79457bd5548,0,Peter Turcsanyi,2022-04-04 15:18:49+02:00,['e6e4109cf901d19e99f5d6b9df7a988750a16065'],50,73,123,4629557,3,0,0.333333333,0,13906
873d25585c26428467d0993906ed10d5a8e32487,0,Joe Witt,2022-04-04 08:35:23-07:00,"['4a90334728372d35b326948e112fb79457bd5548', '0419dc2939d726c9bc489d7eca8f7eed085c0e89']",2489,2291,4780,4634337,649,,,,13906
44cdc8e38e50d39bce72e28ff443ad956d61ac3c,0,Matthew Burgess,2022-04-04 13:48:46-04:00,['873d25585c26428467d0993906ed10d5a8e32487'],3,3,6,4634343,3,,,,13906
c02b4feee25c84098ab5a7f0c1cafefa8e442675,0,Mike Thomsen,2022-04-04 19:15:16-04:00,['44cdc8e38e50d39bce72e28ff443ad956d61ac3c'],2,22,24,4634367,3,,,,13906
e052cf81ba040cf761b1ac33719e51fa4d2afe71,0,Mike Thomsen,2022-04-04 21:26:32-04:00,['c02b4feee25c84098ab5a7f0c1cafefa8e442675'],94,47,141,4634508,3,1,1,1,13907
3ef2ad99434461e603e7cd8b611906db05866568,0,Peter Turcsanyi,2022-04-05 15:20:58+02:00,['e052cf81ba040cf761b1ac33719e51fa4d2afe71'],7,8,15,4634523,2,1,1,0,13907
c7fa3a2a1c4a63196e72c19af8ddfa836ad0af6c,0,Paul Grey,2022-04-05 09:40:37-04:00,['3ef2ad99434461e603e7cd8b611906db05866568'],1,1,2,4634525,1,,,,13907
dd612a861a5d5a457297202edabee704872699dd,0,Mike Thomsen,2022-04-05 09:46:29-04:00,['c7fa3a2a1c4a63196e72c19af8ddfa836ad0af6c'],0,8,8,4634533,1,,,,13907
d78c65996e1cb46d98e2b449f21de25d0d1d0a05,1,exceptionfactory,2022-04-05 10:28:04-05:00,['dd612a861a5d5a457297202edabee704872699dd'],3,8,11,4634544,2,,,,13907
9c71d83c5c7b46e363529bce94b7ab6fd2807b86,0,Mark Payne,2022-04-06 11:54:31-04:00,['d78c65996e1cb46d98e2b449f21de25d0d1d0a05'],450,2514,2964,4637508,52,0.844851904,0.925246827,0.882933709,13936
74a4104259e83b302d139fbc4216f9e3b2fe3c3e,0,Mike Thomsen,2022-04-06 14:37:38-04:00,['9c71d83c5c7b46e363529bce94b7ab6fd2807b86'],22,28,50,4637558,2,0,1,0.333333333,13936
fdca3dd6b05567f4e5bdc4c6988fc95c2bdb7fe4,0,exceptionfactory,2022-04-06 15:03:42-05:00,['74a4104259e83b302d139fbc4216f9e3b2fe3c3e'],39,39,78,4637636,9,,,,13936
39a08025c3a3d2556ae11c2bf2fcda5154cde470,0,Joey Frazee,2022-04-06 13:22:29-07:00,['fdca3dd6b05567f4e5bdc4c6988fc95c2bdb7fe4'],49,87,136,4637772,6,1,0.769230769,0,13936
324e4797e688d0f68593a395a66ed1425f6743e0,0,Mike Thomsen,2022-04-06 17:28:02-04:00,['39a08025c3a3d2556ae11c2bf2fcda5154cde470'],1,1,2,4637774,1,,,,13936
af3375669c374ab0ca703aee42d4ae32cea10efc,0,Mike Thomsen,2022-04-07 06:53:03-04:00,['324e4797e688d0f68593a395a66ed1425f6743e0'],1,5,6,4637780,2,,,,13936
1cf4e72084f30707ffb0676f77355a810c2d6e9e,0,GitHub,2022-04-08 10:08:31-04:00,['af3375669c374ab0ca703aee42d4ae32cea10efc'],188,103,291,4638071,2,1,1,1,13936
2c83149c6d387ef022d7f59bd35ebda51f502b37,0,Matthew Burgess,2022-04-08 13:20:12-04:00,['1cf4e72084f30707ffb0676f77355a810c2d6e9e'],2,27,29,4638100,2,0,1,1,13936
252a8abadd5b37cc40aad0d0fb10b44bd065ad6b,0,Mike Thomsen,2022-04-09 06:00:02-04:00,['2c83149c6d387ef022d7f59bd35ebda51f502b37'],2,0,2,4638102,1,1,1,1,13936
c75fa3857e4df9df14e8c0af3f1fed1658c3f990,0,Joe Witt,2022-04-11 07:34:22-07:00,['252a8abadd5b37cc40aad0d0fb10b44bd065ad6b'],1,1,2,4638104,1,,,,13936
157a5d342afdc799604fe73dd3ec7da165d60a30,1,Pierre Villard,2022-04-11 16:50:07+02:00,['c75fa3857e4df9df14e8c0af3f1fed1658c3f990'],10,10,20,4638124,2,,,,13936
900a34971ce5e93f8a457a56979775aefc4dd5f7,0,Mike Thomsen,2022-04-11 13:22:13-04:00,['157a5d342afdc799604fe73dd3ec7da165d60a30'],9,14,23,4638147,5,1,1,1,13936
b67b2bc3565ac7f2463ca19a1b1245ebc46bb74e,0,Joe Witt,2022-04-11 15:17:30-07:00,['900a34971ce5e93f8a457a56979775aefc4dd5f7'],3,8,11,4638158,1,0,0,1,13936
0bd5f5f34e1a47af28f3ac7e8809e6bd62c6fe92,0,Matthew Burgess,2022-04-11 19:26:02-04:00,['b67b2bc3565ac7f2463ca19a1b1245ebc46bb74e'],1,6,7,4638165,1,0.75,0.75,0.75,13936
47f75651bb49d7868f63b02668300f702cbde3ea,0,Matthew Burgess,2022-04-12 08:50:49-04:00,['0bd5f5f34e1a47af28f3ac7e8809e6bd62c6fe92'],3,25,28,4638193,2,1,0,1,13936
27e78c6f0cd380830e964c2e98774b1e12889050,1,GitHub,2022-04-12 11:14:36-04:00,['47f75651bb49d7868f63b02668300f702cbde3ea'],295,459,754,4638947,3,0.409836066,0,0.836065574,13936
68c6722f76aedd24805ff4999331af5e97ccf9b2,0,GitHub,2022-04-12 11:41:50-04:00,['27e78c6f0cd380830e964c2e98774b1e12889050'],59,561,620,4639567,9,0.3125,0.973214286,0.714285714,13938
0a25f394102fcf334916579ffa45c58d05205a39,0,GitHub,2022-04-12 11:44:58-04:00,['68c6722f76aedd24805ff4999331af5e97ccf9b2'],27682,27671,55353,4694920,2,,,,13938
5ec02c346402e05dc6948c09233435c3c4a62ea8,0,GitHub,2022-04-12 11:45:13-04:00,['0a25f394102fcf334916579ffa45c58d05205a39'],468,461,929,4695849,2,,,,13938
3034f2637a99dca92fc7ab200e7d8a938f57916f,0,GitHub,2022-04-13 13:44:28-04:00,['5ec02c346402e05dc6948c09233435c3c4a62ea8'],3,4,7,4695856,1,,,,13938
05f3d7510f24c24bd307461399c74195859d40e6,1,Joe Witt,2022-04-13 13:49:26-07:00,['3034f2637a99dca92fc7ab200e7d8a938f57916f'],366,459,825,4696681,3,0.481012658,0.848101266,0.341772152,13938
15f7590f7ab27c16166200028d86f3ebd2974092,0,Paul Grey,2022-04-13 19:56:57-04:00,['05f3d7510f24c24bd307461399c74195859d40e6'],1268,2082,3350,4700031,120,1,1,1,13964
e76acabe9eda709f580a8d8a535cba78c2b61d18,0,Joe Gresock,2022-04-14 12:30:57-04:00,['15f7590f7ab27c16166200028d86f3ebd2974092'],8,15,23,4700054,2,1,1,1,13964
efd2421154e07172b068056d4959711376c3c0d5,0,Joe Witt,2022-04-14 09:40:19-07:00,['e76acabe9eda709f580a8d8a535cba78c2b61d18'],44,324,368,4700422,6,0.965116279,1,1,13967
4310df054417e95a4c3a9768c98f492085cab8de,0,exceptionfactory,2022-04-14 14:58:22-05:00,['efd2421154e07172b068056d4959711376c3c0d5'],11,14,25,4700447,2,,,,13967
7f95de27fb5f8ead755133ef1f3d74777c6c8578,0,exceptionfactory,2022-04-14 15:50:02-05:00,['4310df054417e95a4c3a9768c98f492085cab8de'],473,932,1405,4701852,15,0.60952381,0.871428571,0.504761905,13971
84340962d452a9b883f14de1f8f594eeb89bd80f,0,Mike Thomsen,2022-04-16 12:05:07-04:00,['7f95de27fb5f8ead755133ef1f3d74777c6c8578'],195,65,260,4702112,116,,,,13971
ce95097aee562430281a7b7a23de9c9879896d78,0,exceptionfactory,2022-04-18 10:33:27-05:00,['84340962d452a9b883f14de1f8f594eeb89bd80f'],9,4,13,4702125,1,,,0,13971
57a4dce28b43290c58aae84924af23f18759c400,0,Paul Grey,2022-04-18 18:05:53-04:00,['ce95097aee562430281a7b7a23de9c9879896d78'],18,4,22,4702147,2,1,0,1,13971
ecf0a931242bf3690bc6abdd8b83115ecebf345f,0,Pierre Villard,2022-04-19 09:36:29+02:00,['57a4dce28b43290c58aae84924af23f18759c400'],1,1,2,4702149,1,,,,13971
081154530ab0fba5405169f4f48276d9ba5a31fb,0,Pierre Villard,2022-04-19 09:38:02+02:00,['ecf0a931242bf3690bc6abdd8b83115ecebf345f'],21,1,22,4702171,1,,,,13971
876e16f6a8e356d136d6d3a8cd6c48ee9c9f4566,0,Pierre Villard,2022-04-19 09:39:54+02:00,['081154530ab0fba5405169f4f48276d9ba5a31fb'],0,48,48,4702219,5,,,,13971
18a4182cb0bd5787dc77265b0485851a13f96ac3,0,GitHub,2022-04-19 11:08:04-04:00,['876e16f6a8e356d136d6d3a8cd6c48ee9c9f4566'],5401,1261,6662,4708881,70,1,0.38547486,0,13985
0a9476211907df520e58256fdca2b17686b396a2,1,exceptionfactory,2022-04-19 14:13:00-05:00,['18a4182cb0bd5787dc77265b0485851a13f96ac3'],7,11,18,4708899,3,0,0,1,13985
e98b68cc3a16b2992b74d627ab5156c310cb319c,0,Pierre Villard,2022-04-20 15:21:22+02:00,['0a9476211907df520e58256fdca2b17686b396a2'],75,3,78,4708977,3,0.85,0,0.85,13985
9774bb90ca0eec78a8a2ba7d52aaa1d0097afda9,0,Pierre Villard,2022-04-20 16:25:42+02:00,['e98b68cc3a16b2992b74d627ab5156c310cb319c'],12,12,24,4709001,6,,,,13985
285a8cbc3ca88d8b5f0cec519268b793daefef0c,1,GitHub,2022-04-20 10:29:38-04:00,['9774bb90ca0eec78a8a2ba7d52aaa1d0097afda9'],11,162,173,4709174,8,0,0.635416667,0.96875,13985
73ee1a9a1e355d31f348a82acdfff4a387ef485b,1,exceptionfactory,2022-04-20 13:59:21-05:00,['285a8cbc3ca88d8b5f0cec519268b793daefef0c'],0,1407,1407,4710581,16,0.359342916,0.60164271,0.907597536,13999
c88c404dd872e159810c60b0e342ce465b284af2,0,exceptionfactory,2022-04-20 14:19:00-05:00,['73ee1a9a1e355d31f348a82acdfff4a387ef485b'],19,114,133,4710714,5,0,1,1,14001
aeaec170d58d6765459462110e8846cb5cedf047,1,Peter Turcsanyi,2022-04-20 22:49:43+02:00,['c88c404dd872e159810c60b0e342ce465b284af2'],88,118,206,4710920,5,0,0,1,14001
28c7583bdb70055ea19767abe29bce5ea2f63b66,0,GitHub,2022-04-21 09:12:02-04:00,['aeaec170d58d6765459462110e8846cb5cedf047'],1,1,2,4710922,1,,,,14001
1e345db64962c024ce91cc1717d444630b125347,0,Paul Grey,2022-04-21 09:45:00-04:00,['28c7583bdb70055ea19767abe29bce5ea2f63b66'],126,79,205,4711127,1,0,0,0.344827586,14001
5a3c7d1fbd78e78c79d206e34b6f30e25b108faf,0,Bryan Bende,2022-04-21 10:28:21-04:00,['1e345db64962c024ce91cc1717d444630b125347'],209,2842,3051,4714178,26,0.376863447,0.615384615,0.574836017,14004
be65743727420ff6f1ae528802d694b85a2355d8,0,exceptionfactory,2022-04-21 12:02:55-05:00,['5a3c7d1fbd78e78c79d206e34b6f30e25b108faf'],0,2,2,4714180,1,,,,14004
4450f4ce50f23e5fc185a2597b3f891cbc7f820f,0,Matthew Burgess,2022-04-21 14:18:09-04:00,['be65743727420ff6f1ae528802d694b85a2355d8'],5,15,20,4714200,5,0.777777778,0.777777778,1,14004
b288810316f7ecbc3ec943f64284f0494379b371,0,Paul Grey,2022-04-21 15:14:54-04:00,['4450f4ce50f23e5fc185a2597b3f891cbc7f820f'],165,364,529,4714729,15,1,0.25,1,14008
4b7f8cbe1f860dc99d72a86ea3c211c86b2f7aa8,0,Joe Witt,2022-04-21 12:23:07-07:00,['b288810316f7ecbc3ec943f64284f0494379b371'],182,137,319,4715048,1,0.2,0,0,14008
3a15d4fbe5c35a4c5adcf1e1046a37cfd8c12b89,0,Nathan Gough,2022-04-21 22:43:34-04:00,['4b7f8cbe1f860dc99d72a86ea3c211c86b2f7aa8'],1,28,29,4715077,2,,,,14008
4f423a59ba6ef40cbed8dda225c6cbba7bc94dc6,0,Mike Thomsen,2022-04-23 08:23:39-04:00,['3a15d4fbe5c35a4c5adcf1e1046a37cfd8c12b89'],518,2,520,4715597,82,,,,14008
83a9e965d285d77e7f85bd0df7d18e774d20d845,0,Kevin Doran,2022-04-23 22:11:40-04:00,['4f423a59ba6ef40cbed8dda225c6cbba7bc94dc6'],1,4,5,4715602,1,,,,14008
ac08d3311e62b64e52c772cbd7742f69be8957fb,0,Peter Turcsanyi,2022-04-24 08:53:03+02:00,['83a9e965d285d77e7f85bd0df7d18e774d20d845'],2,0,2,4715604,1,,,,14008
56fecbb7d819dd825298244cac4b58be9fb959e9,0,Peter Turcsanyi,2022-04-24 15:46:55+02:00,['ac08d3311e62b64e52c772cbd7742f69be8957fb'],9,29,38,4715642,9,,,,14008
6ae1590aef4a2104595458b7fba31601eac12b29,0,Joe Witt,2022-04-25 07:36:50-07:00,['56fecbb7d819dd825298244cac4b58be9fb959e9'],4,4,8,4715650,2,,,,14008
6ee3d32ca3e5a901c65d05d1ec3b9fb186dce659,0,Nathan Gough,2022-04-26 22:07:59-04:00,['6ae1590aef4a2104595458b7fba31601eac12b29'],189,461,650,4716300,7,0.347826087,0.927536232,0.789855072,14008
4b66299cf656e3a835d9926215a847607ec2397e,1,Matthew Burgess,2022-04-27 09:52:44-04:00,['6ee3d32ca3e5a901c65d05d1ec3b9fb186dce659'],10,8,18,4716318,5,1,1,1,14009
8b08795e18f69825e2b73760af79ab0530f93d70,0,Matthew Burgess,2022-04-27 09:52:47-04:00,['4b66299cf656e3a835d9926215a847607ec2397e'],33,55,88,4716406,3,1,0,0,14009
ac2d7d1e54ac729f9e717d9d9e1bb89d02d3276b,0,Matthew Burgess,2022-04-27 14:38:33-04:00,['8b08795e18f69825e2b73760af79ab0530f93d70'],2,6,8,4716414,2,0.5,1,1,14009
fbfdcdca9f0a3a0f11096b0ff9e1b29ab05e1b3a,0,Pierre Villard,2022-04-28 10:04:11+02:00,['ac2d7d1e54ac729f9e717d9d9e1bb89d02d3276b'],50,54,104,4716518,1,,,,14009
a97c20cdb23fb124e8559a7392279500e7515530,0,exceptionfactory,2022-04-28 10:04:44-05:00,['fbfdcdca9f0a3a0f11096b0ff9e1b29ab05e1b3a'],26,143,169,4716687,5,1,1,1,14011
569929269ae72f69b5aa34b4883ebeb2d06b395f,0,Tamas Palfy,2022-04-28 17:17:24+02:00,['a97c20cdb23fb124e8559a7392279500e7515530'],1,1,2,4716689,1,,,,14011
2d5e24c0a22b98e45b4298d14bcf75281362ce91,0,Pierre Villard,2022-04-29 10:08:49+02:00,['569929269ae72f69b5aa34b4883ebeb2d06b395f'],21,1,22,4716711,2,,,,14011
fc2f539c7dfc2b288efb0ab08f8b770d55ed180a,0,Pierre Villard,2022-04-29 10:12:41+02:00,['2d5e24c0a22b98e45b4298d14bcf75281362ce91'],5,6,11,4716722,2,,,,14011
7271e8cea799ddeae5a1a767d0371e255fd15c67,0,Matthew Burgess,2022-04-29 17:48:59-04:00,['fc2f539c7dfc2b288efb0ab08f8b770d55ed180a'],260,289,549,4717271,27,0.75,0.375,0.875,14011
5aa71570ff1781f83f9fb8bf16ed3ab386d06b85,0,Pierre Villard,2022-04-30 16:41:27+02:00,['7271e8cea799ddeae5a1a767d0371e255fd15c67'],0,19,19,4717290,1,0.142857143,1,1,14011
21b263bd714077e9d45d532db9d22acb26f0f89d,0,Pierre Villard,2022-04-30 16:43:36+02:00,['5aa71570ff1781f83f9fb8bf16ed3ab386d06b85'],3110,0,3110,4720400,19,0.766556291,0.493377483,0.114238411,14011
b04632129faa0dbaef3705bd2ea7a1d5fc3dac0e,0,exceptionfactory,2022-05-02 11:37:47-05:00,['21b263bd714077e9d45d532db9d22acb26f0f89d'],14,101,115,4720515,3,0.1875,0.979166667,0.979166667,14012
e175b146cdc6a7fc49f12cad492f6dadf5010624,0,Peter Turcsanyi,2022-05-02 19:40:48+02:00,['b04632129faa0dbaef3705bd2ea7a1d5fc3dac0e'],2,2,4,4720519,1,,,,14012
04121c9d6a4f3ba78232e5e22fe30bd97b133f09,1,exceptionfactory,2022-05-02 15:47:23-05:00,['e175b146cdc6a7fc49f12cad492f6dadf5010624'],3,3,6,4720525,1,,,,14012
0f6679f2df9a94b288ddb5c2be1ea58e223eb27c,0,Pierre Villard,2022-05-03 13:51:34+02:00,['04121c9d6a4f3ba78232e5e22fe30bd97b133f09'],23,3,26,4720551,3,,,,14012
3699d421161c534fec11af46a54d5b7317e721de,0,exceptionfactory,2022-05-03 13:49:45-05:00,['0f6679f2df9a94b288ddb5c2be1ea58e223eb27c'],110,6,116,4720667,1,,,,14012
e20aa0ea2ae114288f78911ded16e6b111426534,0,exceptionfactory,2022-05-03 21:36:48-05:00,['3699d421161c534fec11af46a54d5b7317e721de'],1,767,768,4721435,8,0.384615385,1,0.850202429,14016
272325cb4ed00682d4d1471ccda8e670f3ef504e,0,Nathan Gough,2022-05-04 15:19:17-04:00,['e20aa0ea2ae114288f78911ded16e6b111426534'],1,12,13,4721448,2,1,1,1,14016
64f9b66141f89439923250bf2c263d5af022badb,0,Mike Thomsen,2022-05-04 17:31:07-04:00,['272325cb4ed00682d4d1471ccda8e670f3ef504e'],15,17,32,4721480,2,1,1,1,14016
ea75a0a996ad937dcf501ab1dda8411b93d2f093,0,Nathan Gough,2022-05-06 12:22:30-04:00,['64f9b66141f89439923250bf2c263d5af022badb'],478,31,509,4721989,9,0.034782609,0,0.260869565,14016
5e8b4d3144973a80a814afd9ddc00ff51f432f58,0,GitHub,2022-05-06 16:07:53-04:00,['ea75a0a996ad937dcf501ab1dda8411b93d2f093'],4,3,7,4721996,3,,,,14016
8f3445d48fe2ff0878c8b8c4d78d010b90d186bc,0,Joe Gresock,2022-05-06 18:36:27-04:00,['5e8b4d3144973a80a814afd9ddc00ff51f432f58'],3,3,6,4722002,1,,,,14016
65dbbc9e76d618c538f8fc79e4c0343998ca719d,0,Chris Sampson,2022-05-07 13:37:28+01:00,['8f3445d48fe2ff0878c8b8c4d78d010b90d186bc'],1,33,34,4722036,2,0.045454545,1,1,14016
0c8305950c19f9208d1719528150120e4d08d9ff,0,Pierre Villard,2022-05-09 12:06:37+02:00,['65dbbc9e76d618c538f8fc79e4c0343998ca719d'],165,13,178,4722214,58,1,1,0,14016
9c2e255fae50be2f2cf8fe5949b9851e77e487fe,0,Pierre Villard,2022-05-09 16:53:34+02:00,['0c8305950c19f9208d1719528150120e4d08d9ff'],0,6,6,4722220,1,,,,14016
b25201dd222d8847427bddd6c5a681d41b613bf2,0,Joe Gresock,2022-05-09 12:22:00-04:00,['9c2e255fae50be2f2cf8fe5949b9851e77e487fe'],7,41,48,4722268,2,0.791666667,0.875,1,14016
728744a49b66ecaf57f6c634b66d40bbf146ced9,0,Joe Witt,2022-05-09 10:53:32-07:00,['b25201dd222d8847427bddd6c5a681d41b613bf2'],71,8,79,4722347,2,,,,14016
c3829e2198d56a3893a6c17214bc55c648c40cab,0,Matthew Burgess,2022-05-09 14:05:38-04:00,['728744a49b66ecaf57f6c634b66d40bbf146ced9'],564,489,1053,4723400,54,0,0,0,14016
93111887859543439ed7ec7b1bfc312e34a90695,0,Matthew Burgess,2022-05-09 14:54:01-04:00,['c3829e2198d56a3893a6c17214bc55c648c40cab'],1,105,106,4723506,4,0.277777778,0.277777778,0.305555556,14018
a038309ba4209fe19e09e6be579fefcf0f6486f3,0,exceptionfactory,2022-05-09 14:02:05-05:00,['93111887859543439ed7ec7b1bfc312e34a90695'],6,6,12,4723518,1,,,,14018
8aaa3d2f10205425be94fc9f97c499eab9224b30,0,Peter Turcsanyi,2022-05-09 20:37:41+00:00,['a038309ba4209fe19e09e6be579fefcf0f6486f3'],17,43,60,4723578,2,0.75,1,0,14018
8247910a819bd1e1f9873956a4bb5b1a9f5e0c98,0,Peter Turcsanyi,2022-05-10 11:04:30+00:00,['8aaa3d2f10205425be94fc9f97c499eab9224b30'],29,276,305,4723883,5,0.818181818,1,0.715909091,14021
dfc8b9c4c8ce2e63ce3b25cbe5c4cd7894ff91a7,0,exceptionfactory,2022-05-10 13:21:07-05:00,['8247910a819bd1e1f9873956a4bb5b1a9f5e0c98'],1,1,2,4723885,1,,,,14021
e2b57730272d9fb49caa306d104817b8fb504f5b,0,Matthew Burgess,2022-05-10 18:56:22-04:00,['dfc8b9c4c8ce2e63ce3b25cbe5c4cd7894ff91a7'],0,135,135,4724020,4,0.661764706,0.852941176,0.852941176,14022
a528b8916961c99e1ae25bf83a2abe6b60e55c38,0,Matthew Burgess,2022-05-12 13:55:51-04:00,['e2b57730272d9fb49caa306d104817b8fb504f5b'],1,1,2,4724022,1,,,,14022
4a60d1673eb1f163c19ba7a44b945e605b27d037,0,Matthew Burgess,2022-05-12 15:38:49-04:00,['a528b8916961c99e1ae25bf83a2abe6b60e55c38'],3,78,81,4724103,3,0.48,0.84,1,14022
7cdbde1eba924b0c63a02ad81e86ab1062d938a2,1,Joe Witt,2022-05-12 12:46:41-07:00,['4a60d1673eb1f163c19ba7a44b945e605b27d037'],0,6,6,4724109,1,,,,14022
e826aca8f2b863056d75af3dff605fd04e8937e9,0,Joe Witt,2022-05-12 12:48:21-07:00,['7cdbde1eba924b0c63a02ad81e86ab1062d938a2'],1,1,2,4724111,1,,,,14022
eecdf38158e362580539250a54719a2937fcba07,0,Pierre Villard,2022-05-12 22:41:00+02:00,['e826aca8f2b863056d75af3dff605fd04e8937e9'],31,11,42,4724153,3,0,0,0,14022
5215cc0ca0ac0cc3f58b7e16241dff91ab4a111e,1,Joe Witt,2022-05-13 06:56:14-07:00,['eecdf38158e362580539250a54719a2937fcba07'],0,6,6,4724159,1,,,,14022
313d70520dfbd9d02d020d6623ba7a1483e4715e,0,Joe Witt,2022-05-13 07:39:11-07:00,['5215cc0ca0ac0cc3f58b7e16241dff91ab4a111e'],3,3,6,4724165,1,,,,14022
30f7c1ba1e03396b08bc255d9aa03bd7ed234a61,1,Joe Witt,2022-05-13 07:44:22-07:00,['313d70520dfbd9d02d020d6623ba7a1483e4715e'],18,66,84,4724249,2,0.787878788,1,0.757575758,14022
8031b6235145963c6c8c30d136a9bb9061d625a1,1,GitHub,2022-05-13 15:09:23-04:00,['30f7c1ba1e03396b08bc255d9aa03bd7ed234a61'],25,59,84,4724333,5,1,0.714285714,0.571428571,14022
3f16a41ca13ecfb3d975f47092f16b0e180fe1c7,0,exceptionfactory,2022-05-13 15:48:12-05:00,['8031b6235145963c6c8c30d136a9bb9061d625a1'],9,135,144,4724477,5,0.1,1,0.9,14023
bd1e033d55e5bf7b3778bb8f8d0999f2b32f99bb,0,Kevin Doran,2022-05-16 16:22:19-04:00,['3f16a41ca13ecfb3d975f47092f16b0e180fe1c7'],12,60,72,4724549,7,0.777777778,1,0.722222222,14024
eba13185290c6a911d36f42aeb64b4199a1612c0,0,exceptionfactory,2022-05-16 16:24:20-05:00,['bd1e033d55e5bf7b3778bb8f8d0999f2b32f99bb'],9,78,87,4724636,2,,,,14025
2a8d07641e63d84613286e63b68a25a5caf9b0ce,0,GitHub,2022-05-16 17:55:03-04:00,['eba13185290c6a911d36f42aeb64b4199a1612c0'],61,414,475,4725111,15,0.21875,0.59375,0.53125,14026
85d5e2071bec6ac5ee1873440189ec5bbf006ac4,0,GitHub,2022-05-18 11:38:36-04:00,['2a8d07641e63d84613286e63b68a25a5caf9b0ce'],19,26,45,4725156,8,0,0,0,14026
fe424a2d420945847172fbcb3aedd070e5b7b953,0,Paul Grey,2022-05-18 12:40:16-04:00,['85d5e2071bec6ac5ee1873440189ec5bbf006ac4'],1237,1932,3169,4728325,39,1,1,1,14049
88e53eae8ca1869bcf87d199dbef311080ac7a1e,0,GitHub,2022-05-18 13:53:36-04:00,['fe424a2d420945847172fbcb3aedd070e5b7b953'],42,124,166,4728491,17,0.375,0.833333333,0.958333333,14049
7754e8903e18ccb18c3ac22165ebfa64e3375860,0,Pierre Villard,2022-05-19 17:33:53+02:00,['88e53eae8ca1869bcf87d199dbef311080ac7a1e'],1,1,2,4728493,1,,,,14049
1cfca0d978322ef5b42d8128d88f41031cf025ad,0,exceptionfactory,2022-05-19 13:02:40-05:00,['7754e8903e18ccb18c3ac22165ebfa64e3375860'],5,5,10,4728503,1,,,,14049
38b51b0dde24929563c4fc6c9a8c7a10e39ef713,0,exceptionfactory,2022-05-19 13:14:30-05:00,['1cfca0d978322ef5b42d8128d88f41031cf025ad'],23,64,87,4728590,8,0,0.863636364,0.863636364,14049
e0976f42d33d151035d7bd8207342afb53d12745,0,Nathan Gough,2022-05-19 16:21:53-04:00,['38b51b0dde24929563c4fc6c9a8c7a10e39ef713'],124,835,959,4729549,16,0.95959596,1,0.95959596,14057
9c9c708c14a29b4b7527a801ca1dfd243c923b32,0,Joe Gresock,2022-05-20 12:27:53-04:00,['e0976f42d33d151035d7bd8207342afb53d12745'],16,16,32,4729581,3,,,,14057
e74557f990ef96bb5f9af9ff827f6ade341f6e48,0,exceptionfactory,2022-05-23 09:06:27-05:00,['9c9c708c14a29b4b7527a801ca1dfd243c923b32'],2,4,6,4729587,2,1,1,1,14057
41b3778d67296245675f41e17825aceca49eee49,0,exceptionfactory,2022-05-23 11:46:15-05:00,['e74557f990ef96bb5f9af9ff827f6ade341f6e48'],2,41,43,4729630,4,0,0,1,14057
a4797327fc36ce9a1bc151a1e3edfb366e21ce59,0,Tamas Palfy,2022-05-23 19:19:06+02:00,['41b3778d67296245675f41e17825aceca49eee49'],8,759,767,4730397,15,0.583333333,0.756410256,0.858974359,14064
c9c7d5f5a353dd39e25c7771ef7e588b07f47905,0,GitHub,2022-05-23 16:31:42-04:00,['a4797327fc36ce9a1bc151a1e3edfb366e21ce59'],0,42,42,4730439,1,,,,14064
99be62be67a3eb850839ff187950cca19eed0c82,0,GitHub,2022-05-23 17:20:54-04:00,['c9c7d5f5a353dd39e25c7771ef7e588b07f47905'],147,1110,1257,4731696,59,0.529157667,0.816414687,0.492440605,14070
205c58230b03131f15b6d0bc41cc82d9f3806016,0,Peter Turcsanyi,2022-05-24 17:22:52+02:00,['99be62be67a3eb850839ff187950cca19eed0c82'],47,300,347,4732043,13,0.805084746,0.805084746,0.805084746,14071
d664708dd336b7e133a39f69a790aa40f087d347,0,exceptionfactory,2022-05-24 17:54:17-05:00,['205c58230b03131f15b6d0bc41cc82d9f3806016'],1,10,11,4732054,1,0,0,1,14071
e5203db96090c099d1303e1636bc13e855002e22,0,Matthew Burgess,2022-05-25 14:14:44-04:00,['d664708dd336b7e133a39f69a790aa40f087d347'],7,6,13,4732067,8,,,,14071
f66540eb6de45c513d0138f073ed210c73688932,0,Peter Turcsanyi,2022-05-25 20:33:14+02:00,['e5203db96090c099d1303e1636bc13e855002e22'],100,377,477,4732544,26,0.903225806,1,1,14072
83316736f8f2c657c96aca6d6346f53be061b4d7,0,GitHub,2022-05-25 21:36:31-04:00,['f66540eb6de45c513d0138f073ed210c73688932'],98,190,288,4732832,14,0.455882353,0.647058824,0.632352941,14072
35d8bb5ca95c077268f5b442222e3086cfd97377,0,Matthew Burgess,2022-05-26 10:31:55-04:00,['83316736f8f2c657c96aca6d6346f53be061b4d7'],2,3,5,4732837,2,,,,14072
98ec2563e9afdee83badd250d37f4a96d7e068c1,0,GitHub,2022-05-26 17:13:28-04:00,['35d8bb5ca95c077268f5b442222e3086cfd97377'],1,0,1,4732838,1,0,0,0,14072
d79b3908360265eb0d50a5ce298a00c3054cdf82,0,Peter Turcsanyi,2022-05-27 18:43:46+02:00,['98ec2563e9afdee83badd250d37f4a96d7e068c1'],0,12,12,4732850,1,1,1,1,14072
9878df9f5a3980e150351f61cf131df4f19ea880,0,exceptionfactory,2022-05-31 09:53:29-05:00,['d79b3908360265eb0d50a5ce298a00c3054cdf82'],7,191,198,4733048,1,0.704,1,1,14072
005fbe3c507be9953301c94e9f2ef38ee91476a5,0,exceptionfactory,2022-05-31 10:34:02-05:00,['9878df9f5a3980e150351f61cf131df4f19ea880'],0,1,1,4733049,1,0,1,1,14072
314232ca6c85f5280ee5319414c3339f1fb851b3,0,GitHub,2022-05-31 16:27:23-04:00,['005fbe3c507be9953301c94e9f2ef38ee91476a5'],0,74,74,4733123,4,0.162162162,0.243243243,0.756756757,14073
45cc3cefe5f94915d8665d962e1d6b326c8cca99,0,Kevin Doran,2022-06-01 11:26:41-04:00,['314232ca6c85f5280ee5319414c3339f1fb851b3'],57,53,110,4733233,4,1,0.363636364,0.272727273,14073
0d45fef7027758339b05d77b742a6bbdb398d6be,0,GitHub,2022-06-01 14:27:07-04:00,['45cc3cefe5f94915d8665d962e1d6b326c8cca99'],1,1,2,4733235,1,,,,14073
48de70a56883c69a7bc51545c7cd410563b995ec,0,GitHub,2022-06-01 15:09:01-04:00,['0d45fef7027758339b05d77b742a6bbdb398d6be'],55,155,210,4733445,11,0.732142857,0.017857143,1,14073
1f9672c18bd6ccac4386bae8083793d8e74dd9df,0,Pierre Villard,2022-06-02 11:36:25+02:00,['48de70a56883c69a7bc51545c7cd410563b995ec'],25,21,46,4733491,1,0,0,0,14073
7f93cb4c91914d7e5cf4b2933deafa99d52893ee,0,Pierre Villard,2022-06-02 11:40:53+02:00,['1f9672c18bd6ccac4386bae8083793d8e74dd9df'],65,48,113,4733604,2,1,0,0,14073
04aa32cd576ef47a7ec1b7a2df4f5f60b8b9a6bd,0,Pierre Villard,2022-06-02 11:43:24+02:00,['7f93cb4c91914d7e5cf4b2933deafa99d52893ee'],2,49,51,4733655,2,0.933333333,1,1,14073
5a2992c243e81724ce13033a9818df28d4c3af95,0,GitHub,2022-06-02 08:12:22-04:00,['04aa32cd576ef47a7ec1b7a2df4f5f60b8b9a6bd'],6,61,67,4733722,5,0.8,0.9,1,14074
b5e61109f6d5d7331d7cd0c7027ad9250c347852,0,Kevin Doran,2022-06-02 14:29:05-04:00,['5a2992c243e81724ce13033a9818df28d4c3af95'],21,577,598,4734320,15,0.401869159,0.485981308,0.626168224,14079
2015a4f22c20caaa353cf4d686a90b998f6abdc9,0,Pierre Villard,2022-06-03 10:30:03+02:00,['b5e61109f6d5d7331d7cd0c7027ad9250c347852'],3,3,6,4734326,2,,,,14079
4c2fc216ab95d2028c8d30478300a1ae3a564cd7,0,Pierre Villard,2022-06-03 10:31:41+02:00,['2015a4f22c20caaa353cf4d686a90b998f6abdc9'],0,3,3,4734329,1,,,,14079
639ab328c9e717e259740133a5571b9ab7123f0d,0,Pierre Villard,2022-06-03 10:33:41+02:00,['4c2fc216ab95d2028c8d30478300a1ae3a564cd7'],0,2,2,4734331,2,0,0,0.5,14079
4b655ecb688685016f67fba7a9386683f8429df6,0,Joe Gresock,2022-06-03 11:54:21-04:00,['639ab328c9e717e259740133a5571b9ab7123f0d'],491,490,981,4735312,11,0,1,1,14081
1342ea70250840f1543d11a8e0d62c58590f049d,0,Nathan Gough,2022-06-03 19:05:21-04:00,['4b655ecb688685016f67fba7a9386683f8429df6'],23,22,45,4735357,13,0,0.5,1,14081
4aa0d31d9f43848714463eda2c4d3539825b73d6,0,Nathan Gough,2022-06-03 19:10:28-04:00,['1342ea70250840f1543d11a8e0d62c58590f049d'],0,7,7,4735364,1,0,0,1,14081
58f93d1f8b812b87a82348b7b60ecd1f376441a5,0,exceptionfactory,2022-06-06 08:49:39-05:00,['4aa0d31d9f43848714463eda2c4d3539825b73d6'],238,11,249,4735613,10,0.844444444,1,0.511111111,14081
5591bec44b6b69d9a4581de055041fe8cd88d1e1,0,exceptionfactory,2022-06-06 13:43:02-05:00,['58f93d1f8b812b87a82348b7b60ecd1f376441a5'],11,36,47,4735660,1,0,0,1,14081
e618e85da72af7e5e6c8e7cd2f7a2e0fff3fbe4a,0,GitHub,2022-06-06 16:23:17-04:00,['5591bec44b6b69d9a4581de055041fe8cd88d1e1'],41,19,60,4735720,2,0,0,0,14081
24adc73862466603eb08a526adcca065d0c71241,0,exceptionfactory,2022-06-06 20:14:39-05:00,['e618e85da72af7e5e6c8e7cd2f7a2e0fff3fbe4a'],60,350,410,4736130,7,0.49382716,0.432098765,0.438271605,14084
18ecb73441372f840d7fb34889c48802f2b48962,0,Pierre Villard,2022-06-07 14:31:09+01:00,['24adc73862466603eb08a526adcca065d0c71241'],5,33,38,4736168,2,,,,14084
2455ba2c459f3ba963a94a2046f73849dc76352f,0,Pierre Villard,2022-06-07 14:33:57+01:00,['18ecb73441372f840d7fb34889c48802f2b48962'],625,0,625,4736793,4,0.385057471,0.270114943,0,14084
e19efa6658d798d5f29cd92688286d9cbde2c572,0,Pierre Villard,2022-06-07 14:36:47+01:00,['2455ba2c459f3ba963a94a2046f73849dc76352f'],3,26,29,4736822,3,0.882352941,1,1,14084
49f36b6bbc2c8ebbba6c65a3fb2aa827b1f9e1e5,0,Pierre Villard,2022-06-07 17:52:42+01:00,['e19efa6658d798d5f29cd92688286d9cbde2c572'],1,1,2,4736824,1,,,,14084
a5bed1391e3fcd8c5a8eedf97b34967648e62126,0,Pierre Villard,2022-06-07 17:53:58+01:00,['49f36b6bbc2c8ebbba6c65a3fb2aa827b1f9e1e5'],4,8,12,4736836,3,,,,14084
54f1372b78de48ca8afa6ce0333179c5f7de8084,0,Pierre Villard,2022-06-08 14:14:02+01:00,['a5bed1391e3fcd8c5a8eedf97b34967648e62126'],1,1,2,4736838,1,,,,14084
2072e4ed2a51c927a7eddce9ef0099bc31d1d144,0,Tamas Palfy,2022-06-09 14:26:32+02:00,['54f1372b78de48ca8afa6ce0333179c5f7de8084'],1,3,4,4736842,1,,,,14084
d92598981124e1b73b958c54b9d4dd9b47f0b298,0,Tamas Palfy,2022-06-09 19:42:16+02:00,['2072e4ed2a51c927a7eddce9ef0099bc31d1d144'],56,282,338,4737180,10,0.375,0.841666667,1,14086
c51f70b6e6472792610d26d866213b7d9163d081,0,Joe Gresock,2022-06-09 21:10:44-04:00,['d92598981124e1b73b958c54b9d4dd9b47f0b298'],23,50,73,4737253,1,0.461538462,0.807692308,0,14086
f99298f98e3b5a959e8a9d69c5d68316408a925d,0,Bence Simon,2022-06-10 09:40:27+02:00,['c51f70b6e6472792610d26d866213b7d9163d081'],0,4,4,4737257,1,0,0,0,14086
00a96d79e07c7e4bea886f3992d94e3d96dddcd0,0,Joe Witt,2022-06-10 10:57:53-07:00,['f99298f98e3b5a959e8a9d69c5d68316408a925d'],1,1,2,4737259,1,,,,14086
f91d877043e894d22a75ecc19c496796c38e67e1,0,Joe Witt,2022-06-13 14:38:19-07:00,['00a96d79e07c7e4bea886f3992d94e3d96dddcd0'],435,5,440,4737699,13,0.813471503,0,0.041450777,14086
554f648f003790727c4f28381e9e78d32f46cbd6,0,Pierre Villard,2022-06-14 15:47:38+02:00,['f91d877043e894d22a75ecc19c496796c38e67e1'],2,25,27,4737726,1,0.933333333,1,1,14086
459daf6600bf3e1de112bba67ce42a4b0bad8737,0,Pierre Villard,2022-06-14 15:54:58+02:00,['554f648f003790727c4f28381e9e78d32f46cbd6'],12,32,44,4737770,1,,,,14086
f08c971a89654bae0be7a7807076c8c7393bab7a,0,exceptionfactory,2022-06-14 09:24:09-05:00,['459daf6600bf3e1de112bba67ce42a4b0bad8737'],3,3,6,4737776,3,,,,14086
0f5d8517b526f74e94b989b11c0eb68f33acf43d,0,exceptionfactory,2022-06-14 11:06:35-05:00,['f08c971a89654bae0be7a7807076c8c7393bab7a'],13,96,109,4737885,4,0.829268293,0.829268293,1,14087
d298a3ab83ebfb41e65a9c4f52f5838c17cee74e,0,exceptionfactory,2022-06-14 14:26:14-05:00,['0f5d8517b526f74e94b989b11c0eb68f33acf43d'],1,1,2,4737887,1,,,,14087
6c6cb99b3808ea76f56c14899691c48ee5756ad9,0,exceptionfactory,2022-06-14 16:17:50-05:00,['d298a3ab83ebfb41e65a9c4f52f5838c17cee74e'],1,36,37,4737924,2,,,,14087
1f2820a39a3720b25bf0e19f07e83da58fdfa639,0,exceptionfactory,2022-06-15 13:14:59-05:00,['6c6cb99b3808ea76f56c14899691c48ee5756ad9'],20,17,37,4737961,2,0,0,0,14087
07bbcb771e537c10f96d1d9246cc6aa66be0a1e0,0,Paul Grey,2022-06-15 17:58:17-04:00,['1f2820a39a3720b25bf0e19f07e83da58fdfa639'],0,367,367,4738328,4,0.685950413,1,0.818181818,14089
6a285c67e54b5977f19b36ccbe1a685f4edaa8c1,0,Pierre Villard,2022-06-16 18:12:47+02:00,['07bbcb771e537c10f96d1d9246cc6aa66be0a1e0'],42,15,57,4738385,2,,,,14089
a30ac23e90cb1471735a0b423e6e425c2619c153,0,exceptionfactory,2022-06-16 14:53:04-05:00,['6a285c67e54b5977f19b36ccbe1a685f4edaa8c1'],1,69,70,4738455,3,0.944444444,1,1,14090
2161d0fe9c2c91e424507779d46983aea142b2e0,1,exceptionfactory,2022-06-16 16:38:34-05:00,['a30ac23e90cb1471735a0b423e6e425c2619c153'],188,153,341,4738796,28,0,1,0,14090
bd45eb4995ad661f5b524e08bb0f6785cf0cdfb0,0,Nathan Gough,2022-06-16 23:09:22-04:00,['2161d0fe9c2c91e424507779d46983aea142b2e0'],192,19,211,4739007,27,,,,14090
d89f98f5b46a1f4a072dfb923475ea4821524f36,0,exceptionfactory,2022-06-17 09:23:52-05:00,['bd45eb4995ad661f5b524e08bb0f6785cf0cdfb0'],2313,5573,7886,4746893,107,1,1,0.737777778,14141
5e01d3de060bdf119580469819822e3d0e99e16f,0,GitHub,2022-06-17 14:28:14-04:00,['d89f98f5b46a1f4a072dfb923475ea4821524f36'],1,33,34,4746927,1,0.24137931,0.931034483,0.931034483,14141
4db3c76e90acaf463d88090bc0df47ee19b16e48,0,Pierre Villard,2022-06-18 09:40:01+02:00,['5e01d3de060bdf119580469819822e3d0e99e16f'],8,1,9,4746936,1,,,,14141
4aee4546b9da439a7e04dc297cdd193c6d6b91a2,0,Pierre Villard,2022-06-18 09:43:46+02:00,['4db3c76e90acaf463d88090bc0df47ee19b16e48'],202,1,203,4747139,4,,,,14141
eef4ea1fc6d9e11008da61ebecde6dc8e6c1a2c9,0,Pierre Villard,2022-06-18 09:46:23+02:00,['4aee4546b9da439a7e04dc297cdd193c6d6b91a2'],44,8,52,4747191,3,0,0,0,14141
1de9c727790df6aba5997bdc2f7cb12ac4e0657f,0,Joe Gresock,2022-06-21 10:43:38-04:00,['eef4ea1fc6d9e11008da61ebecde6dc8e6c1a2c9'],0,8,8,4747199,1,0,0,0,14141
b60b9b8e29be4839b93c4baeacdd63802a693c29,0,GitHub,2022-06-21 16:53:30-04:00,['1de9c727790df6aba5997bdc2f7cb12ac4e0657f'],1,1,2,4747201,1,,,,14141
ac8c1b0326fc83b3e574bf9e7eb8ad1a26f7c918,0,exceptionfactory,2022-06-21 15:55:47-05:00,['b60b9b8e29be4839b93c4baeacdd63802a693c29'],24,157,181,4747382,6,0.442857143,0.985714286,0.885714286,14141
47121614a205d99f53a619a656456757056fb595,0,Pierre Villard,2022-06-21 22:58:40+02:00,['ac8c1b0326fc83b3e574bf9e7eb8ad1a26f7c918'],8,3,11,4747393,3,,,,14141
5febd47c72db79a0dd063b662ed8f23c2d9530be,0,GitHub,2022-06-21 17:00:34-04:00,['47121614a205d99f53a619a656456757056fb595'],7,27,34,4747427,3,1,1,1,14141
c08996515bbf76253563e6f050b32dd8549919e7,0,GitHub,2022-06-21 17:03:44-04:00,['5febd47c72db79a0dd063b662ed8f23c2d9530be'],1,25,26,4747453,2,0.388888889,0.388888889,0.388888889,14141
f9beb507fdbde55c62170949393aeb542fe23b39,0,GitHub,2022-06-21 17:23:49-04:00,['c08996515bbf76253563e6f050b32dd8549919e7'],10,39,49,4747502,2,0,1,1,14141
bc84532a8b27eae2e7f3ab284473c1cbc9035be6,0,GitHub,2022-06-21 17:55:07-04:00,['f9beb507fdbde55c62170949393aeb542fe23b39'],3,67,70,4747572,2,0,0.872340426,1,14141
edd862bf55f34c8f45c1817603e303cea6254f81,0,Peter Turcsanyi,2022-06-22 18:19:52+02:00,['bc84532a8b27eae2e7f3ab284473c1cbc9035be6'],0,60,60,4747632,3,0.488888889,1,0.777777778,14142
3dda694fd633562392ec1a80daa9f1d108b324ff,0,GitHub,2022-06-22 12:24:23-04:00,['edd862bf55f34c8f45c1817603e303cea6254f81'],0,48,48,4747680,3,0.514285714,0.771428571,0.914285714,14142
b1b20968d636045257f13773bb70ce798b718976,0,exceptionfactory,2022-06-22 15:47:23-05:00,['3dda694fd633562392ec1a80daa9f1d108b324ff'],2,3,5,4747685,2,,,,14142
59806250146fa49edf3baf5225b22addbb718f6e,0,exceptionfactory,2022-06-22 16:17:48-05:00,['b1b20968d636045257f13773bb70ce798b718976'],4,0,4,4747689,1,,,,14142
a3e8048b2d9c42d975965d482e33c28885f198e2,0,exceptionfactory,2022-06-23 08:35:31-05:00,['59806250146fa49edf3baf5225b22addbb718f6e'],2,164,166,4747855,14,0.438461538,0.630769231,0.823076923,14142
62eb565daf8079a0aa5d0eee4cf4540239371598,0,Paul Grey,2022-06-23 13:52:41-04:00,['a3e8048b2d9c42d975965d482e33c28885f198e2'],5,507,512,4748367,11,,,,14142
0e52ccf9e9822627640e0a71914c26ff2b30894b,0,exceptionfactory,2022-06-23 15:45:45-05:00,['62eb565daf8079a0aa5d0eee4cf4540239371598'],28,24,52,4748419,22,,,,14142
1442dcef233d627b1e34fee15c0d012005f749f2,0,Matthew Burgess,2022-06-24 13:12:14-04:00,['0e52ccf9e9822627640e0a71914c26ff2b30894b'],55,323,378,4748797,20,0.204724409,0.236220472,0.173228346,14143
b6a32a9c5d738e5508ebed919bd263da7d40f349,0,Peter Turcsanyi,2022-06-24 22:22:35+02:00,['1442dcef233d627b1e34fee15c0d012005f749f2'],1552,208,1760,4750557,4,0.598108747,0.11820331,0.191489362,14144
d8ebfb25d09536a9201959c0e1d4e2454ca68c64,0,Pierre Villard,2022-06-26 22:23:32+02:00,['b6a32a9c5d738e5508ebed919bd263da7d40f349'],47,199,246,4750803,5,0.179487179,0.743589744,0.782051282,14145
9d379121c42f2502ad56d1e1e9b7324847f89718,0,Tamas Palfy,2022-06-27 21:53:20+02:00,['d8ebfb25d09536a9201959c0e1d4e2454ca68c64'],15,72,87,4750890,4,0.025,0.55,0.525,14145
c1c1d0da8261004559029c11c59fb9b019df27a2,0,Kevin Doran,2022-06-27 22:05:53-04:00,['9d379121c42f2502ad56d1e1e9b7324847f89718'],208,69,277,4751167,6,1,1,1,14145
b3b13a4ee05b011a48ee87748adddf3bf3feb8a2,0,Pierre Villard,2022-06-28 16:19:38+02:00,['c1c1d0da8261004559029c11c59fb9b019df27a2'],5,196,201,4751368,17,,,,14145
db11961026e88d19efc8d5e6b68e4723840c27a1,0,Matthew Burgess,2022-06-28 10:44:45-04:00,['b3b13a4ee05b011a48ee87748adddf3bf3feb8a2'],5,171,176,4751544,28,0,0.844444444,0.777777778,14145
1465c2c629e1a56c354292db7859e6a4074dff59,0,exceptionfactory,2022-06-28 12:02:31-05:00,['db11961026e88d19efc8d5e6b68e4723840c27a1'],58,729,787,4752331,12,1,1,1,14151
0de83292dec9f3077e5f06ebb5c6f14f01b74129,0,Nathan Gough,2022-06-28 13:57:35-04:00,['1465c2c629e1a56c354292db7859e6a4074dff59'],4159,3346,7505,4759836,87,0.973760933,0.530612245,0.275510204,14176
a098653d07522c6bf9ab329b29c4175f545536e3,0,exceptionfactory,2022-06-28 14:56:55-05:00,['0de83292dec9f3077e5f06ebb5c6f14f01b74129'],1,1,2,4759838,1,,,,14176
4cb9997ea299ba1b112dc58f19e73f8349551f34,0,Pierre Villard,2022-06-29 17:11:39+02:00,['a098653d07522c6bf9ab329b29c4175f545536e3'],1,1,2,4759840,1,,,,14176
5bdede1fab7cbde997e686283e312cc8a3de8746,0,Pierre Villard,2022-06-29 17:17:06+02:00,['4cb9997ea299ba1b112dc58f19e73f8349551f34'],1,1,2,4759842,1,,,,14176
4a9c3435dbf466e6df6e1ac62bac4b89c88a195e,0,Pierre Villard,2022-06-29 17:18:41+02:00,['5bdede1fab7cbde997e686283e312cc8a3de8746'],3,3,6,4759848,2,,,,14176
39c366eeef6a8c5be496ccab9c395a4fe94be9c3,0,Pierre Villard,2022-06-29 17:28:15+02:00,['4a9c3435dbf466e6df6e1ac62bac4b89c88a195e'],3,76,79,4759927,4,0.083333333,0.333333333,0.833333333,14177
ee3dcc78bf58ff02af9351ac9593978b0b5cd0e4,0,Joe Witt,2022-06-29 10:04:09-07:00,['39c366eeef6a8c5be496ccab9c395a4fe94be9c3'],43,31,74,4760001,3,,,,14177
6997f17bff9270da4877fad3a53a8f4a9feae9ad,0,Joe Witt,2022-06-29 10:04:47-07:00,['ee3dcc78bf58ff02af9351ac9593978b0b5cd0e4'],145,7,152,4760153,2,,,,14177
7a47c8cfbd458ab037275762c385d50372c130a3,0,Kevin Doran,2022-06-29 16:52:19-04:00,['6997f17bff9270da4877fad3a53a8f4a9feae9ad'],692,713,1405,4761558,5,1,1,1,14179
0458b6432dd010e6727ac5df7d96310e22c5f0a4,0,Nathan Gough,2022-06-29 22:11:11-04:00,['7a47c8cfbd458ab037275762c385d50372c130a3'],18,50,68,4761626,2,0,0.727272727,1,14179
f3455372bd6981cfe8b1f4c8fabb6426a8dbef75,0,Pierre Villard,2022-06-30 12:50:46+02:00,['0458b6432dd010e6727ac5df7d96310e22c5f0a4'],25,0,25,4761651,1,,,,14179
d5b626f0e40bba7cb8fb0af14a4e344f24954c68,0,GitHub,2022-06-30 10:11:13-04:00,['f3455372bd6981cfe8b1f4c8fabb6426a8dbef75'],64,234,298,4761949,22,0.340659341,0.340659341,1,14179
5e83bda9e9986001a060171df1bca609b4c9aad1,0,exceptionfactory,2022-06-30 10:50:24-05:00,['d5b626f0e40bba7cb8fb0af14a4e344f24954c68'],67,1049,1116,4763065,35,0.624750499,0.9500998,0.822355289,14185
9cf5c170b1142351089fb2663b58581b61efb29f,0,exceptionfactory,2022-06-30 14:23:10-05:00,['5e83bda9e9986001a060171df1bca609b4c9aad1'],42,499,541,4763606,17,0,1,1,14190
7eec5071189095eab3da9b901781850697e0a01f,0,exceptionfactory,2022-06-30 14:47:00-05:00,['9cf5c170b1142351089fb2663b58581b61efb29f'],5,6,11,4763617,3,,,,14190
943197c18b3b0ae3f3eb6c2dcf396a95c2389506,1,Nathan Gough,2022-06-30 18:42:44-04:00,['7eec5071189095eab3da9b901781850697e0a01f'],1,169,170,4763787,2,1,0.960784314,1,14191
1f18345929bcf60047010b1584366f3981ca8494,0,exceptionfactory,2022-06-30 19:10:57-05:00,['943197c18b3b0ae3f3eb6c2dcf396a95c2389506'],2,7,9,4763796,1,,,,14191
26a10d772f3b552d460a55634107cb3022a490cd,0,exceptionfactory,2022-06-30 19:12:28-05:00,['1f18345929bcf60047010b1584366f3981ca8494'],1,7,8,4763804,1,,,,14191
ea0e1b446ef83021f9e685975b3eb643a207af1f,0,Pierre Villard,2022-07-01 14:24:21+02:00,['26a10d772f3b552d460a55634107cb3022a490cd'],1,1,2,4763806,1,,,,14191
d78c667c197cf126e31d291e5f61e41629073d18,0,exceptionfactory,2022-07-01 14:45:31-05:00,['ea0e1b446ef83021f9e685975b3eb643a207af1f'],360,1750,2110,4765916,42,0.841059603,0.969094923,0.962472406,14204
685088a59c034d415c820d7724a2e16dfa4ac6a2,1,Tamas Palfy,2022-07-04 16:43:20+02:00,['d78c667c197cf126e31d291e5f61e41629073d18'],191,723,914,4766830,23,0.423913043,0.597826087,0.880434783,14215
328d38facb25936f8050cb4364757b7994ed3bde,0,Tamas Palfy,2022-07-05 16:55:57+02:00,['685088a59c034d415c820d7724a2e16dfa4ac6a2'],43,1,44,4766874,2,0,0,0,14215
46bb7d153d5b17db77fc70042396973cbfa561a9,0,Tamas Palfy,2022-07-06 10:30:47+02:00,['328d38facb25936f8050cb4364757b7994ed3bde'],25,23,48,4766922,4,1,1,0,14215
1685204cc1030b2228725eb4ba157539634d5149,0,exceptionfactory,2022-07-08 16:51:20-05:00,['46bb7d153d5b17db77fc70042396973cbfa561a9'],0,1,1,4766923,1,0,0,1,14215
3a31dff76b93b05f7f8ac97fbf655ffeff0911a6,0,exceptionfactory,2022-07-11 10:27:17-05:00,['1685204cc1030b2228725eb4ba157539634d5149'],3,3,6,4766929,3,,,,14215
291bd40013613d38ec5df7493669c0a8bcbbcaf9,0,exceptionfactory,2022-07-11 10:37:39-05:00,['3a31dff76b93b05f7f8ac97fbf655ffeff0911a6'],4,4,8,4766937,4,,,,14215
06db7968fa0436661fac89e74e621b5b2301212d,0,exceptionfactory,2022-07-11 12:57:27-05:00,['291bd40013613d38ec5df7493669c0a8bcbbcaf9'],1,1,2,4766939,1,,,,14215
cf4eed0224dabea3d8e739ae31f69354cc4542c6,0,Tamas Palfy,2022-07-11 21:34:27+02:00,['06db7968fa0436661fac89e74e621b5b2301212d'],1,2,3,4766942,1,,,,14215
274e4feeaa4f8173657fe0bfdb66291ef33073ed,0,exceptionfactory,2022-07-11 20:00:40-05:00,['cf4eed0224dabea3d8e739ae31f69354cc4542c6'],6,310,316,4767258,2,0.278106509,1,1,14216
996d8faaf48afa97591534c1c2f8dca1aa8c68d5,0,Paul Grey,2022-07-12 09:52:49-04:00,['274e4feeaa4f8173657fe0bfdb66291ef33073ed'],6,49,55,4767313,2,0,1,1,14216
0bea430c00c896e025e78f20f381da6c1409b06c,0,Joe Witt,2022-07-12 09:50:43-07:00,['996d8faaf48afa97591534c1c2f8dca1aa8c68d5'],1,2,3,4767316,1,,,,14216
51626d728be6b65e3d98add32257b45e753e9ba7,0,Joe Witt,2022-07-12 09:51:26-07:00,['0bea430c00c896e025e78f20f381da6c1409b06c'],2,2,4,4767320,2,,,,14216
2a9139c57ab5c68387d3ed84e3d28119f33d9168,0,Joey Frazee,2022-07-12 18:36:10+00:00,['51626d728be6b65e3d98add32257b45e753e9ba7'],40,4,44,4767364,3,0.166666667,1,0,14216
4c0555a47624cd9776d6d9fd06eca9aecae553c3,0,Paul Grey,2022-07-12 19:01:41-04:00,['2a9139c57ab5c68387d3ed84e3d28119f33d9168'],4,12,16,4767380,2,0,0.4,1,14216
0dea0ae364c3492d7f12b2238880729a2a55d3b0,0,Matthew Burgess,2022-07-13 15:25:16-04:00,['4c0555a47624cd9776d6d9fd06eca9aecae553c3'],5,3,8,4767388,1,0,0,1,14216
a9b5bebb1545bfd555abaac43421309fa3d5f0be,0,Nathan Gough,2022-07-13 19:11:03-04:00,['0dea0ae364c3492d7f12b2238880729a2a55d3b0'],261,147,408,4767796,11,0,0,0,14216
f05d0f10f364654acfffad647e81b885f24e8696,0,Matthew Burgess,2022-07-14 09:16:07-04:00,['a9b5bebb1545bfd555abaac43421309fa3d5f0be'],5,131,136,4767932,8,0.933333333,0.933333333,0.933333333,14216
d0db4c44bb71acc76141df29205a28c18c7faa47,0,GitHub,2022-07-14 11:49:00-04:00,['f05d0f10f364654acfffad647e81b885f24e8696'],2,1,3,4767935,1,,,,14216
047b3611bf411fb0398591df73f1798020c4efab,0,Nathan Gough,2022-07-14 23:27:54-04:00,['d0db4c44bb71acc76141df29205a28c18c7faa47'],1,10,11,4767946,2,1,0,1,14216
cb0753b03cc7fe55b86cc795d9b7cd328c783fc0,0,exceptionfactory,2022-07-15 10:58:31-05:00,['047b3611bf411fb0398591df73f1798020c4efab'],17,110,127,4768073,2,0.37704918,0.68852459,0.590163934,14216
14a31c81dd17f6d5fd3df38317673850a7e86b26,0,exceptionfactory,2022-07-15 12:43:05-05:00,['cb0753b03cc7fe55b86cc795d9b7cd328c783fc0'],0,20,20,4768093,1,,,,14216
4d219689f12823fa351253dd12d8a61ad5f4a5a0,0,exceptionfactory,2022-07-18 09:08:27-05:00,['14a31c81dd17f6d5fd3df38317673850a7e86b26'],6,2,8,4768101,2,0,0,0,14216
f8844440f5dac78f8933cbb11b194a31321ee868,0,Tamas Palfy,2022-07-18 16:15:15+02:00,['4d219689f12823fa351253dd12d8a61ad5f4a5a0'],492,603,1095,4769196,27,0,1,0,14216
eb91eb12b04ca35aeb69b8c576d576998b0df87f,0,Paul Grey,2022-07-18 12:46:30-04:00,['f8844440f5dac78f8933cbb11b194a31321ee868'],100,56,156,4769352,3,,,,14216
148834e71b93fd6f243fe8b93d93f6562851c3bd,0,exceptionfactory,2022-07-19 07:51:32-05:00,['eb91eb12b04ca35aeb69b8c576d576998b0df87f'],1,1,2,4769354,1,,,,14216
97e7a3c030dba7925cb4e15708d003bda36903ad,0,exceptionfactory,2022-07-19 07:56:26-05:00,['148834e71b93fd6f243fe8b93d93f6562851c3bd'],16,72,88,4769442,3,,,,14216
1a1037022f128782b24c7d928a69b06daf3cd08a,0,exceptionfactory,2022-07-19 08:03:16-05:00,['97e7a3c030dba7925cb4e15708d003bda36903ad'],2,68,70,4769512,2,,,,14216
8185ad05986d4b2c24cb892adce0422031cb1d06,0,Kevin Doran,2022-07-19 09:51:31-04:00,['1a1037022f128782b24c7d928a69b06daf3cd08a'],23,16,39,4769551,2,,,,14216
ccf386626142e8e8447e0983d75b893d289cc5b8,0,exceptionfactory,2022-07-19 11:38:26-05:00,['8185ad05986d4b2c24cb892adce0422031cb1d06'],43,34,77,4769628,4,0,0,0,14216
ad781170e31682ddb9be1c3dc906e758c5909ed4,0,Peter Turcsanyi,2022-07-20 13:38:47+02:00,['ccf386626142e8e8447e0983d75b893d289cc5b8'],8,877,885,4770513,9,0.452830189,0.787061995,0.730458221,14220
eab687ee5017cdebaccd8ed5d6dde2adc5e1e92e,0,exceptionfactory,2022-07-21 09:41:53-05:00,['ad781170e31682ddb9be1c3dc906e758c5909ed4'],2,2,4,4770517,1,,,,14220
302bdbfb113ea7cdcb552d90d4d30e0b19215d09,0,exceptionfactory,2022-07-21 13:28:36-05:00,['eab687ee5017cdebaccd8ed5d6dde2adc5e1e92e'],2,6,8,4770525,2,,,,14220
74b25c73069350354acc875420e834605e1a8bef,0,GitHub,2022-07-22 11:14:23-04:00,['302bdbfb113ea7cdcb552d90d4d30e0b19215d09'],4,25,29,4770554,4,0.75,0.75,1,14221
bc4e3e850bd2973a59b1d4726e439aa38d0559bc,0,exceptionfactory,2022-07-22 13:31:06-05:00,['74b25c73069350354acc875420e834605e1a8bef'],33,170,203,4770757,10,0.339285714,0.821428571,1,14222
d7ed66032e191b9a1c05bd998fe24ea3eb3d4084,0,exceptionfactory,2022-07-22 16:25:58-05:00,['bc4e3e850bd2973a59b1d4726e439aa38d0559bc'],1,6,7,4770764,1,0,0,0,14222
a661b035e8903c69d63f8427d4f2f7bdaf309d89,0,Nathan Gough,2022-07-22 17:33:51-04:00,['d7ed66032e191b9a1c05bd998fe24ea3eb3d4084'],3,222,225,4770989,4,0.987341772,0.987341772,0.873417722,14224
40d7d88bc0b1513604a021f9dad662906b624b70,0,exceptionfactory,2022-07-22 19:49:22-05:00,['a661b035e8903c69d63f8427d4f2f7bdaf309d89'],13,24,37,4771026,5,1,1,0,14224
0cd438d9e9b6826a4166200e2efeda0b8db0de92,0,exceptionfactory,2022-07-23 10:18:27-05:00,['40d7d88bc0b1513604a021f9dad662906b624b70'],39,114,153,4771179,3,0.638297872,1,1,14224
69b0a20e670c7d83fa74748075291bb902f2d6a1,0,Joe Witt,2022-07-23 17:56:09-07:00,['0cd438d9e9b6826a4166200e2efeda0b8db0de92'],1,1,2,4771181,1,,,,14224
21b57e36e809fe80cc9db442fb7db46e301e0687,0,Joe Witt,2022-07-23 17:58:18-07:00,['69b0a20e670c7d83fa74748075291bb902f2d6a1'],2,2,4,4771185,2,,,,14224
077e09cf3ea13d1b959791c297810cecfad823f5,0,Joe Witt,2022-07-23 17:58:42-07:00,['21b57e36e809fe80cc9db442fb7db46e301e0687'],5,7,12,4771197,2,0,0,0,14224
7d920b9bc6331255a76f3a99e45cc5b64bf6ee51,0,Joe Witt,2022-07-23 17:59:04-07:00,['077e09cf3ea13d1b959791c297810cecfad823f5'],2,2,4,4771201,2,,,,14224
7244b9cfc43dcb73ff1d088ecec7c1cf0b045e28,0,Joe Witt,2022-07-23 17:59:33-07:00,['7d920b9bc6331255a76f3a99e45cc5b64bf6ee51'],1,22,23,4771224,4,,,,14224
c6328cc203d9dc351ba095408141982308911d4a,0,Joe Witt,2022-07-23 18:11:59-07:00,['7244b9cfc43dcb73ff1d088ecec7c1cf0b045e28'],1,1,2,4771226,1,,,,14224
c61efecbdc0f97f57f512938b50b924adeba2c04,0,Matthew Burgess,2022-07-25 08:48:06-04:00,['c6328cc203d9dc351ba095408141982308911d4a'],1,96,97,4771323,2,0,0,0,14224
7767a5b85d1633fde17414bf203f6e6e659236f6,0,Matthew Burgess,2022-07-25 09:36:54-04:00,['c61efecbdc0f97f57f512938b50b924adeba2c04'],43,72,115,4771438,2,0.666666667,0.555555556,1,14224
0497907829ca25523622c021073b90c1aa9a3094,0,exceptionfactory,2022-07-25 10:02:21-05:00,['7767a5b85d1633fde17414bf203f6e6e659236f6'],53,236,289,4771727,7,1,1,1,14226
92750c2746924c0f31377787ffcffe619b6c41e7,0,exceptionfactory,2022-07-25 10:52:46-05:00,['0497907829ca25523622c021073b90c1aa9a3094'],19,171,190,4771917,5,0.395061728,0.87654321,0.790123457,14227
1199b3173bb8b4855f244a90c3a730fc3775a39d,0,Joe Witt,2022-07-25 10:03:20-07:00,['92750c2746924c0f31377787ffcffe619b6c41e7'],2,2,4,4771921,2,,,,14227
adf8b0d359e3b0aae768ff77b68a7003872b0593,0,Joe Witt,2022-07-25 12:27:05-07:00,['1199b3173bb8b4855f244a90c3a730fc3775a39d'],1,0,1,4771922,1,,,,14227
8a1249ee3945b6a6c2cf7ea32542da0aab82ea0b,0,Joe Witt,2022-07-25 14:33:48-07:00,['adf8b0d359e3b0aae768ff77b68a7003872b0593'],10,4,14,4771936,3,,,,14227
c6999ba9d80b792cbeea889fc76462568cc22bc8,0,Joe Witt,2022-07-25 14:45:54-07:00,['8a1249ee3945b6a6c2cf7ea32542da0aab82ea0b'],5,9,14,4771950,1,,,,14227
02e37713b3d6a3bfee0420b12626d89bdb2e1acc,0,Joe Witt,2022-07-25 15:10:27-07:00,['c6999ba9d80b792cbeea889fc76462568cc22bc8'],141,150,291,4772241,2,1,1,0.793650794,14228
9bb22fcb11d5304610b484fa99dab250aabca1d3,0,Paul Grey,2022-07-27 10:26:43-04:00,['02e37713b3d6a3bfee0420b12626d89bdb2e1acc'],2,7,9,4772250,2,1,1,1,14228
afa85a03ce1a0b012e11189290384cdc3b58efc5,0,Joe Witt,2022-07-27 08:01:24-07:00,['9bb22fcb11d5304610b484fa99dab250aabca1d3'],13,2,15,4772265,5,0.5,0.5,1,14228
2fae3bb9a8a8c046b9430469b16d66044a39d9dc,0,Peter Turcsanyi,2022-07-27 18:59:06+02:00,['afa85a03ce1a0b012e11189290384cdc3b58efc5'],177,1371,1548,4773813,12,0.342059337,0.933682373,0.811518325,14236
c77f85aafb7d055caf2215fc6d382cb3faed1544,0,exceptionfactory,2022-07-27 14:48:02-05:00,['2fae3bb9a8a8c046b9430469b16d66044a39d9dc'],64,245,309,4774122,16,1,1,1,14238
8d256784d84cc28bf5642e1bf38dec3eba0c5f23,0,Joe Witt,2022-07-27 13:24:06-07:00,['c77f85aafb7d055caf2215fc6d382cb3faed1544'],2272,4813,7085,4781207,659,,,,14238
8c66bf948cf6eaff910a9e650217946d63663726,0,Joe Witt,2022-07-27 13:24:09-07:00,['8d256784d84cc28bf5642e1bf38dec3eba0c5f23'],4812,2254,7066,4788273,659,,,,14238
d5386acb4fd4d37629835665b9aa27056f20de71,0,exceptionfactory,2022-07-28 13:36:22-05:00,['c77f85aafb7d055caf2215fc6d382cb3faed1544'],49,88,137,4788410,13,1,1,1,14238
4e49a55e93cd1f5013c4c73146e53672c2d69a33,0,Kevin Doran,2022-07-28 18:47:37-04:00,['d5386acb4fd4d37629835665b9aa27056f20de71'],7,2,9,4788419,2,,,,14238
67c463627c0d67810493f8b8fb4e75bd63bb65c6,0,exceptionfactory,2022-07-29 10:48:11-05:00,['4e49a55e93cd1f5013c4c73146e53672c2d69a33'],229,213,442,4788861,6,0.820512821,1,0.820512821,14239
296f308cdc7f765051b04f903fa1ad4af2d03106,0,exceptionfactory,2022-07-29 13:44:26-05:00,['67c463627c0d67810493f8b8fb4e75bd63bb65c6'],35,280,315,4789176,3,0,1,1,14240
