sha,is_bug,committer_name,commit_time,parents,all_del,all_add,all_change_lines,all_lines,files_change_nums,dmm_unit_size,dmm_unit_complexity,dmm_unit_interfacing,file_nums
7defc061d6c3eab376e2413926a71f5b6ee0ad2e,1,Owen O'Malley,2014-08-14 13:48:58-07:00,[],0,97388,97388,97388,688,0.498218457,0.677057033,0.8469525,688
185f7c506f9f69fb1d427dae013de3520ffef77b,1,Selvamohan Neethiraj,2014-08-14 18:11:06-04:00,['7defc061d6c3eab376e2413926a71f5b6ee0ad2e'],0,180747,180747,278135,686,0.307926007,0.736043526,0.878354733,1374
820f1aeeab949bd1db39bb14635bf63ce74b632a,1,mneethiraj,2014-08-14 18:31:40-07:00,['185f7c506f9f69fb1d427dae013de3520ffef77b'],37,127,164,278299,3,0,0.059701493,0.268656716,1374
9f8c580a0c1668618e3f21c46e0eca45e09fca69,0,Selvamohan Neethiraj,2014-08-14 22:20:29-04:00,['185f7c506f9f69fb1d427dae013de3520ffef77b'],1,1,2,278301,1,,,,1374
be1d961c23e2fc67e7a2032665fbb398f66c3f9d,0,sneethiraj,2014-08-14 23:53:26-04:00,['9f8c580a0c1668618e3f21c46e0eca45e09fca69'],13,13,26,278327,7,,,,1374
0d0637972e07cc8c34a4539192eac998f40dffed,0,sneethiraj,2014-08-15 00:06:28-04:00,['be1d961c23e2fc67e7a2032665fbb398f66c3f9d'],24,24,48,278375,18,,,,1374
cb7363d7e0c109a9ea1adc6d510928caa694b9a9,0,mneethiraj,2014-08-14 21:34:52-07:00,"['820f1aeeab949bd1db39bb14635bf63ce74b632a', '0d0637972e07cc8c34a4539192eac998f40dffed']",38,38,76,278451,24,,,,1374
f0218462c1865593cb9c56d7622a710852881ea6,1,mneethiraj,2014-08-15 15:32:42-07:00,['cb7363d7e0c109a9ea1adc6d510928caa694b9a9'],11,18,29,278480,2,0.5,1,1,1374
8908fb8c2eac90648beeb44ea46d73191e00659d,1,mneethiraj,2014-08-15 17:15:22-07:00,['f0218462c1865593cb9c56d7622a710852881ea6'],3,68,71,278551,1,0,0.921568627,0,1374
3495911bd721aa6f66958e9c914716ece3b512d6,1,sneethiraj,2014-08-17 15:36:45-04:00,['cb7363d7e0c109a9ea1adc6d510928caa694b9a9'],4,32,36,278587,9,,,,1379
2e06b5998f891f09d76d7048bf08d9d72e628766,0,sneethiraj,2014-08-17 18:39:59-04:00,['3495911bd721aa6f66958e9c914716ece3b512d6'],7,62,69,278656,4,1,1,1,1379
bce5a1c85d50dd41fe26dc93eae7511482f66562,0,sneethiraj,2014-08-17 21:47:04-07:00,"['2e06b5998f891f09d76d7048bf08d9d72e628766', '8908fb8c2eac90648beeb44ea46d73191e00659d']",14,86,100,278756,2,,,,1379
466f72fb4a20a1a133065d9d029f50af9d53d130,1,sneethiraj,2014-08-18 01:33:54-04:00,['bce5a1c85d50dd41fe26dc93eae7511482f66562'],1,53,54,278810,2,0,0.484848485,1,1379
086831ef838f6dc3619618051c28b38b9efd0e70,1,Dilli Dorai Arumugam,2014-08-18 18:18:46-07:00,['466f72fb4a20a1a133065d9d029f50af9d53d130'],66,172,238,279048,8,0,0,1,1379
0166486f36b56a8e8e34fc8161330b69999632b1,0,rmani,2014-08-19 13:58:20-07:00,['086831ef838f6dc3619618051c28b38b9efd0e70'],17,69,86,279134,6,,,,1379
866b977dda0e18174f942fe84437b52a88b9aaf3,1,sneethiraj,2014-08-19 14:18:34-07:00,['086831ef838f6dc3619618051c28b38b9efd0e70'],101,148,249,279383,12,1,1,0.972972973,1379
67f8a000da3692cb8103c2a1da8743a94b576b44,0,sneethiraj,2014-08-19 14:36:24-07:00,['866b977dda0e18174f942fe84437b52a88b9aaf3'],22,22,44,279427,17,,,,1379
dfa698f2ab2d3ab0e5aa0a0fd342f4f3c2fa6db4,0,rmani,2014-08-19 15:23:10-07:00,['0166486f36b56a8e8e34fc8161330b69999632b1'],4,4,8,279435,3,,,,1379
72054a366e85b089df9937e55ded6b05a2e73ead,0,rmani,2014-08-19 18:20:25-07:00,"['dfa698f2ab2d3ab0e5aa0a0fd342f4f3c2fa6db4', '67f8a000da3692cb8103c2a1da8743a94b576b44']",123,170,293,279728,29,,,,1379
e5656c1b7e21dd45b0219a7f6cd6dfc96f72b030,1,sneethiraj,2014-08-20 17:28:51-07:00,['72054a366e85b089df9937e55ded6b05a2e73ead'],3,47,50,279778,2,1,1,0,1379
05e62b8e1f449d4bd7548ae3610a3348c006fe37,1,mneethiraj,2014-08-20 17:51:12-07:00,['e5656c1b7e21dd45b0219a7f6cd6dfc96f72b030'],71,1034,1105,280883,18,0.403985507,0.733695652,0.675724638,1382
6b5bf61cf389b304583eea62b9189768aa14499f,1,Dilli Dorai Arumugam,2014-08-20 17:58:46-07:00,['e5656c1b7e21dd45b0219a7f6cd6dfc96f72b030'],48,39,87,280970,8,,,,1382
704f626145bf9e1e0ce53e6126d41f008c3e2f53,0,mneethiraj,2014-08-20 23:18:59-07:00,"['05e62b8e1f449d4bd7548ae3610a3348c006fe37', '6b5bf61cf389b304583eea62b9189768aa14499f']",48,39,87,281057,8,,,,1382
2c56c5604e5bc1d4082acb19bb2ebfaf0de92102,1,mneethiraj,2014-08-21 16:36:29-07:00,['704f626145bf9e1e0ce53e6126d41f008c3e2f53'],246,224,470,281527,8,0,1,0,1382
77245582fd69af6b064f2b9b4fed286a4a249580,1,mneethiraj,2014-08-21 20:11:02-07:00,['2c56c5604e5bc1d4082acb19bb2ebfaf0de92102'],5,10,15,281542,1,0,1,0,1382
ef29bfa3e86718c4e858b9efe78ea224d6d87b68,1,sneethiraj,2014-08-21 22:56:41-07:00,['704f626145bf9e1e0ce53e6126d41f008c3e2f53'],5,22,27,281569,2,0,0,1,1382
95251893891b71e41c65a1916b36a215a4f317dd,1,sneethiraj,2014-08-21 23:15:41-07:00,['ef29bfa3e86718c4e858b9efe78ea224d6d87b68'],17,32,49,281618,3,0,0,1,1382
e36722006e36702db9c39ee83e521e556853da92,0,mneethiraj,2014-08-22 00:17:16-07:00,"['77245582fd69af6b064f2b9b4fed286a4a249580', '95251893891b71e41c65a1916b36a215a4f317dd']",22,54,76,281694,5,,,,1382
a349df8999f27e289ab9a2fb32033760120ea991,1,sneethiraj,2014-08-22 21:16:08-07:00,['e36722006e36702db9c39ee83e521e556853da92'],1,7,8,281702,1,,,,1382
c8f2b519b4f5806fd237df3a6caedc421620b62c,0,sneethiraj,2014-08-23 12:28:03-07:00,['a349df8999f27e289ab9a2fb32033760120ea991'],111,17,128,281830,24,,,,1382
dfdd5176c7ec407c047802c26e45a373c9e6b417,1,sneethiraj,2014-08-25 13:28:19-07:00,['c8f2b519b4f5806fd237df3a6caedc421620b62c'],62,77,139,281969,6,,,,1382
c90142915232826a759fab34b111b62b5a484108,1,sneethiraj,2014-08-25 14:02:25-07:00,['dfdd5176c7ec407c047802c26e45a373c9e6b417'],39,483,522,282491,9,0,0,0.606060606,1385
f2034ba72fb320a6a211b62f963a3971247f6096,1,sneethiraj,2014-08-25 15:37:55-07:00,['c90142915232826a759fab34b111b62b5a484108'],28,233,261,282752,9,0.120300752,0.082706767,0.195488722,1385
ecc9dbcafee71468dd21f140a13b42ac9087242e,1,sneethiraj,2014-08-25 15:50:57-07:00,['f2034ba72fb320a6a211b62f963a3971247f6096'],15,10,25,282777,3,0,0,0,1385
c89af3a1411c573f9d0386fd35e28cfd4b1ec1b6,1,Dilli Dorai Arumugam,2014-08-25 16:01:09-07:00,['f2034ba72fb320a6a211b62f963a3971247f6096'],8,825,833,283610,1,0.009584665,1,0.985623003,1385
6cc76fdd71c84603c03f0285e2d51a69fee6e114,0,sneethiraj,2014-08-25 19:44:49-07:00,"['ecc9dbcafee71468dd21f140a13b42ac9087242e', 'c89af3a1411c573f9d0386fd35e28cfd4b1ec1b6']",8,825,833,284443,1,,,,1385
eb8a9f59f13fbfc43b47641a2f002a4d49187495,1,sneethiraj,2014-08-25 19:52:13-07:00,['6cc76fdd71c84603c03f0285e2d51a69fee6e114'],141,714,855,285298,9,0,0.265060241,1,1385
eddffcb4d0d6844b48bd0e3805fa2acfc023cbc8,1,sneethiraj,2014-08-26 11:48:15-07:00,['eb8a9f59f13fbfc43b47641a2f002a4d49187495'],0,5,5,285303,2,,,,1385
42748388d9045c55e37e78e5c7df5a35f220b90c,1,mneethiraj,2014-08-26 14:16:06-07:00,['eddffcb4d0d6844b48bd0e3805fa2acfc023cbc8'],26,976,1002,286305,13,0,0.050516648,0.774971297,1385
3aaaf186e93500bcfc3e589f5348c7d3ac343ba4,1,Dilli Dorai Arumugam,2014-08-26 16:48:13-07:00,['42748388d9045c55e37e78e5c7df5a35f220b90c'],2,29,31,286336,2,0,1,1,1385
5f3c1d58ead703c731d4ba75712eeceba15fd0bd,1,mneethiraj,2014-08-26 17:32:14-07:00,['42748388d9045c55e37e78e5c7df5a35f220b90c'],19,205,224,286560,3,1,1,1,1386
2da197d40c719b334ba8c6d42dd637a9b67ea053,0,mneethiraj,2014-08-26 18:26:37-07:00,['5f3c1d58ead703c731d4ba75712eeceba15fd0bd'],28,45,73,286633,1,1,1,1,1386
90f8628a9d9ebb403d180c07bda3620d31400e28,0,mneethiraj,2014-08-26 20:39:25-07:00,"['2da197d40c719b334ba8c6d42dd637a9b67ea053', '3aaaf186e93500bcfc3e589f5348c7d3ac343ba4']",2,29,31,286664,2,,,,1386
2003d3ae647ba038b3ca1e318c55a5c554aeaf23,1,sneethiraj,2014-08-27 11:52:26-07:00,['90f8628a9d9ebb403d180c07bda3620d31400e28'],13,11,24,286688,2,1,1,1,1386
0521c14261b2d07fc0f76c9a039fa0eed8eba3db,1,sneethiraj,2014-08-27 14:02:55-07:00,['2003d3ae647ba038b3ca1e318c55a5c554aeaf23'],14,15,29,286717,6,0,0,1,1386
b27ae69da6a7ee311e48112bb36a662278d0cb35,0,Dilli Dorai Arumugam,2014-08-27 14:22:42-07:00,['0521c14261b2d07fc0f76c9a039fa0eed8eba3db'],102,95,197,286914,2,,,,1386
895f0f2c7992c1ba0ccf85a931311272c8043702,1,Dilli Dorai Arumugam,2014-08-27 14:53:20-07:00,['b27ae69da6a7ee311e48112bb36a662278d0cb35'],2,2,4,286918,1,,,,1386
1ed94eca432c770c67cea104578c5e42c6538429,1,sneethiraj,2014-08-27 18:43:23-07:00,['895f0f2c7992c1ba0ccf85a931311272c8043702'],49,169,218,287136,8,0,0.987951807,1,1386
593540f6f78bedf5206cb34fe4703858fb955ea1,1,mneethiraj,2014-08-27 18:44:36-07:00,['895f0f2c7992c1ba0ccf85a931311272c8043702'],139,883,1022,288158,8,0.613402062,0.603092784,0.543814433,1388
ebbb163070568df4282d53ae3dbfe814f5ceb200,0,mneethiraj,2014-08-27 18:45:09-07:00,"['593540f6f78bedf5206cb34fe4703858fb955ea1', '1ed94eca432c770c67cea104578c5e42c6538429']",49,169,218,288376,8,,,,1388
45150f00539a32f28e4c217c06282ab4149aa530,1,mneethiraj,2014-08-28 07:09:16-07:00,['ebbb163070568df4282d53ae3dbfe814f5ceb200'],58,71,129,288505,5,0,0,0,1388
d59e0ee41037b47b34a6bc48d455e7ba88f05c83,0,mneethiraj,2014-08-28 07:25:29-07:00,['45150f00539a32f28e4c217c06282ab4149aa530'],1,39,40,288545,3,1,1,1,1388
cb728432cb83ebb39681ae729613681aed2a9c41,1,mneethiraj,2014-08-28 09:56:28-07:00,['d59e0ee41037b47b34a6bc48d455e7ba88f05c83'],3,84,87,288632,8,0.12962963,0.166666667,0.962962963,1388
41842dff581c632eb69a344023b902cf1afb6973,1,mneethiraj,2014-08-28 13:31:21-07:00,['cb728432cb83ebb39681ae729613681aed2a9c41'],15,21,36,288668,2,1,1,1,1388
10de28040e0ca864868a549a636be3170828b080,1,mneethiraj,2014-08-29 15:31:05-07:00,['41842dff581c632eb69a344023b902cf1afb6973'],11,59,70,288738,2,0.234042553,1,1,1388
a9fcdf9d2067fe41a1088f0d71717b7142d11d17,1,sneethiraj,2014-09-03 00:12:49-04:00,['10de28040e0ca864868a549a636be3170828b080'],39,1699,1738,290476,42,0.452873563,0.498850575,0.652873563,1414
9eb5bd2fa77fd4a230adf4e8d0333516840e4121,1,sneethiraj,2014-09-03 08:00:06-04:00,['a9fcdf9d2067fe41a1088f0d71717b7142d11d17'],10,11,21,290497,1,,,,1414
6c3a74e2bb88f4cde97456cca706dccc7c5ebe03,0,sneethiraj,2014-09-03 14:46:51-04:00,['9eb5bd2fa77fd4a230adf4e8d0333516840e4121'],2,32,34,290531,1,,,,1414
d70c51929e7761f65dad459efdc3fd8963fd9148,0,sneethiraj,2014-09-04 00:35:30-04:00,['6c3a74e2bb88f4cde97456cca706dccc7c5ebe03'],5,10,15,290546,2,0.9375,0,0,1414
a735e9f0945bee2ea689888c1defd57196cfae2f,0,sneethiraj,2014-09-04 09:05:15-04:00,['d70c51929e7761f65dad459efdc3fd8963fd9148'],10,5,15,290561,2,0.0625,1,1,1414
933bae568a1b002eb1d09e1ed030923953d9e7ef,1,sneethiraj,2014-09-04 09:16:46-04:00,['a735e9f0945bee2ea689888c1defd57196cfae2f'],6,19,25,290586,3,1,0,0,1414
914f0bae342ebdb0dab403d87272f84c9062cb35,1,mneethiraj,2014-09-04 13:26:55-07:00,['933bae568a1b002eb1d09e1ed030923953d9e7ef'],242,98,340,290926,15,0.024691358,0.209876543,0,1414
83eca5e2314a92f3be0da328764a5f73bc0f859e,0,mneethiraj,2014-09-04 13:47:00-07:00,['914f0bae342ebdb0dab403d87272f84c9062cb35'],17,14,31,290957,5,,,,1414
ea17097a2a21a7aa971abb29be7f18a15591a0ef,1,mneethiraj,2014-09-04 16:26:50-07:00,['83eca5e2314a92f3be0da328764a5f73bc0f859e'],49,37,86,291043,8,1,0,1,1414
1ae7dc8a233fc6440d871c4f81189c3efd9ad8e5,1,sneethiraj,2014-09-04 21:32:13-04:00,['933bae568a1b002eb1d09e1ed030923953d9e7ef'],114,195,309,291352,7,0,0,0,1414
31b101b3e0527cfb8c3667dd08167de661116893,0,sneethiraj,2014-09-04 22:16:46-04:00,"['1ae7dc8a233fc6440d871c4f81189c3efd9ad8e5', 'ea17097a2a21a7aa971abb29be7f18a15591a0ef']",285,126,411,291763,15,,,,1414
bcc71ef225e0d06fe2ac03a3185369ac50696988,1,sneethiraj,2014-09-04 22:40:58-04:00,['31b101b3e0527cfb8c3667dd08167de661116893'],1,2,3,291766,1,1,1,1,1414
2ddb59fb4b8ba2ee7761c22368b76e1f68f4d7ad,1,sneethiraj,2014-09-04 22:43:30-04:00,['bcc71ef225e0d06fe2ac03a3185369ac50696988'],8,36,44,291810,9,0,0.071428571,0.571428571,1414
78281ae0db9b88c9a0178cc7d1560e6af7e0e7fc,1,sneethiraj,2014-09-04 22:45:25-04:00,['2ddb59fb4b8ba2ee7761c22368b76e1f68f4d7ad'],10,20,30,291840,1,0,,,1414
65c4c17f45abc9d2874967596f10ef251f673d31,0,sneethiraj,2014-09-04 22:48:41-04:00,['78281ae0db9b88c9a0178cc7d1560e6af7e0e7fc'],17,43,60,291900,3,0,0,1,1414
b0ea201ff7fb58a836c5622f7b0486eff954eced,0,sneethiraj,2014-09-04 22:50:22-04:00,['65c4c17f45abc9d2874967596f10ef251f673d31'],0,15,15,291915,1,0,0,0,1414
0c8da1adfc437ca88ce468cdc9fcc0aaaed0c19c,1,sneethiraj,2014-09-04 22:52:13-04:00,['b0ea201ff7fb58a836c5622f7b0486eff954eced'],4,4,8,291923,4,0,1,1,1414
da2ed83a0b1def28ef7b5d9a892ae60d519cc490,1,Dilli Dorai Arumugam,2014-09-05 10:54:48-07:00,['0c8da1adfc437ca88ce468cdc9fcc0aaaed0c19c'],94,30,124,292047,2,1,0,0,1414
2f4ff7e036af4175b1e91983f30d43c0ddbaa538,1,sneethiraj,2014-09-05 17:40:29-04:00,['0c8da1adfc437ca88ce468cdc9fcc0aaaed0c19c'],16,113,129,292176,2,0,0,0.278688525,1414
8233fc256016b1e63a91392a3b695b1837b197b4,0,sneethiraj,2014-09-05 17:47:10-04:00,"['2f4ff7e036af4175b1e91983f30d43c0ddbaa538', 'da2ed83a0b1def28ef7b5d9a892ae60d519cc490']",94,30,124,292300,2,,,,1414
1490df27b22c6b0cd5d35b596f9850ca440e2e65,0,mneethiraj,2014-09-10 07:00:45-07:00,['8233fc256016b1e63a91392a3b695b1837b197b4'],3,42,45,292345,5,,,,1416
2b0ee4219db5bd79c930e6ac579ecffcb5e67168,0,rmani,2014-09-11 12:30:32-07:00,['1490df27b22c6b0cd5d35b596f9850ca440e2e65'],0,1437,1437,293782,1,0.318181818,0.617045455,0.886363636,1417
043d3da121f968039b3eb87222f83a6876d0f241,0,Dilli Dorai Arumugam,2014-09-11 13:18:25-07:00,['1490df27b22c6b0cd5d35b596f9850ca440e2e65'],1892,4121,6013,299795,231,,,,1417
b7c6e9efebc47242df84fda8dd98b2df3226e95f,0,mneethiraj,2014-09-11 14:36:31-07:00,['1490df27b22c6b0cd5d35b596f9850ca440e2e65'],442,120,562,300357,4,1,1,1,1417
3272c005b3af021974e9f85cbc3e3e409d60c532,1,rmani,2014-09-11 16:44:58-07:00,['2b0ee4219db5bd79c930e6ac579ecffcb5e67168'],6,9,15,300372,1,0,0,1,1417
8be10c1eb6d898acdbd646672351356c9f30c789,0,mneethiraj,2014-09-11 19:12:11-07:00,['b7c6e9efebc47242df84fda8dd98b2df3226e95f'],2,0,2,300374,1,1,1,1,1417
02a35cc6144e308f37e27a978aed114568c95aed,0,mneethiraj,2014-09-11 19:12:20-07:00,"['8be10c1eb6d898acdbd646672351356c9f30c789', '043d3da121f968039b3eb87222f83a6876d0f241']",1892,4121,6013,306387,231,,,,1417
cc358afe29285796a7a63b09816c05e938f62c73,0,sneethiraj,2014-09-12 12:48:32-04:00,['02a35cc6144e308f37e27a978aed114568c95aed'],0,18,18,306405,1,0,1,1,1417
30ddcba68a57c46a4b7cb64d469ff3dec1bb68d6,0,sneethiraj,2014-09-12 12:50:45-04:00,['cc358afe29285796a7a63b09816c05e938f62c73'],0,6,6,306411,1,0,0,1,1417
84c22443d2a5aa8207062132f17652fd3d028509,0,rmani,2014-09-12 11:22:10-07:00,['3272c005b3af021974e9f85cbc3e3e409d60c532'],211,134,345,306756,1,0.347826087,1,0.391304348,1417
3df530d67ccf6e2dd25e8e32834ff3c46f4e96e9,0,Dilli Dorai Arumugam,2014-09-12 16:32:08-07:00,['30ddcba68a57c46a4b7cb64d469ff3dec1bb68d6'],202,4116,4318,311074,206,,,,1417
d197741d325d279d79e6088b57df83c69dd47f70,0,mneethiraj,2014-09-12 23:21:19-07:00,['30ddcba68a57c46a4b7cb64d469ff3dec1bb68d6'],8,8,16,311090,1,,,,1417
6fb304002c2cca8a4894353f1e03184cdb88656e,0,mneethiraj,2014-09-12 23:21:57-07:00,"['d197741d325d279d79e6088b57df83c69dd47f70', '3df530d67ccf6e2dd25e8e32834ff3c46f4e96e9']",202,4116,4318,315408,206,,,,1417
5c29ec203fab50f8a2ad037185bd89d7db33a7aa,0,rmani,2014-09-12 23:22:20-07:00,['84c22443d2a5aa8207062132f17652fd3d028509'],17,17,34,315442,1,0,1,0,1417
f9f9f0eb4dd2fabd309017decd12c1994d1033b0,1,sneethiraj,2014-09-14 15:14:13-04:00,['6fb304002c2cca8a4894353f1e03184cdb88656e'],5,373,378,315820,10,0.392473118,0.322580645,0.532258065,1420
c3513b23e7a5f9f57b0fb2001705fea09426fa79,0,sneethiraj,2014-09-14 15:44:12-04:00,['f9f9f0eb4dd2fabd309017decd12c1994d1033b0'],34,23,57,315877,1,,,,1420
7c1f9f90aa88779c4522894c47094feadbd3f80d,0,sneethiraj,2014-09-15 08:16:53-04:00,['c3513b23e7a5f9f57b0fb2001705fea09426fa79'],6,8,14,315891,1,1,0,1,1420
5975d2816fa77dbb3ee5a95138fbc90b055fa683,1,sneethiraj,2014-09-15 09:51:37-04:00,['c3513b23e7a5f9f57b0fb2001705fea09426fa79'],65,136,201,316092,31,0,0,0,1420
1479499b8b4cbf4ca151e12ef109caee2f12f22c,1,sneethiraj,2014-09-15 09:53:29-04:00,['5975d2816fa77dbb3ee5a95138fbc90b055fa683'],0,171,171,316263,1,,,,1421
d44f0cae233c30bd81ba8c0c0f451de26d427de5,1,sneethiraj,2014-09-15 09:54:55-04:00,['1479499b8b4cbf4ca151e12ef109caee2f12f22c'],0,129,129,316392,1,,,,1422
b1370f3a509a6b16942ca1d80fd8b71d6220e4af,0,sneethiraj,2014-09-15 09:56:14-04:00,['d44f0cae233c30bd81ba8c0c0f451de26d427de5'],3,3,6,316398,1,,,,1422
bf6402e3a52585dae6ce130ae30fa1fcfecdf0f1,0,sneethiraj,2014-09-15 10:25:36-04:00,"['7c1f9f90aa88779c4522894c47094feadbd3f80d', 'b1370f3a509a6b16942ca1d80fd8b71d6220e4af']",68,439,507,316905,34,,,,1422
6fdad49d14470697b6156a01775f3f29960bc554,0,mneethiraj,2014-09-15 13:20:02-07:00,['bf6402e3a52585dae6ce130ae30fa1fcfecdf0f1'],1,1,2,316907,1,,,,1422
40b82337b9046d51484dd8f272e25ce991f5fe54,1,mneethiraj,2014-09-15 15:26:29-07:00,['6fdad49d14470697b6156a01775f3f29960bc554'],16,29,45,316952,2,1,1,1,1422
d3e9ad6d10419ffd31039150c54b167464bf8a59,0,mneethiraj,2014-09-15 15:58:57-07:00,['40b82337b9046d51484dd8f272e25ce991f5fe54'],12,4,16,316968,1,0,0,0,1422
830c62124c02c6d323555cabbe460b388b950f0c,1,mneethiraj,2014-09-16 00:01:26-07:00,['d3e9ad6d10419ffd31039150c54b167464bf8a59'],10,31,41,317009,2,1,1,0.785714286,1422
c99b51c76007fa9c286c5ecb047142109da899aa,1,sneethiraj,2014-09-16 11:04:03-04:00,['d3e9ad6d10419ffd31039150c54b167464bf8a59'],2,8,10,317019,1,0,0,1,1422
e3f255e6e52b657bb413cc1f8e047da2be2b0ccb,1,sneethiraj,2014-09-16 11:05:54-04:00,['c99b51c76007fa9c286c5ecb047142109da899aa'],7,8,15,317034,6,0,1,1,1423
57c364586116c9a7634c03671d5cbf22848df714,1,sneethiraj,2014-09-16 11:07:19-04:00,['e3f255e6e52b657bb413cc1f8e047da2be2b0ccb'],3,32,35,317069,4,0.347826087,0.782608696,1,1423
0ee4b9b2f7d0d5e6d0156faa53595b4d1b588d93,1,sneethiraj,2014-09-16 11:35:09-04:00,['57c364586116c9a7634c03671d5cbf22848df714'],10,72,82,317151,3,0,0.70212766,1,1423
a4ec210ed4987952fd8dcdfe2adaf6b09e680682,1,sneethiraj,2014-09-16 11:43:28-04:00,['0ee4b9b2f7d0d5e6d0156faa53595b4d1b588d93'],0,8,8,317159,1,1,1,1,1423
852ec251628fa1b82ca863334c1d1301e8303d0b,0,mneethiraj,2014-09-16 09:17:29-07:00,"['830c62124c02c6d323555cabbe460b388b950f0c', 'a4ec210ed4987952fd8dcdfe2adaf6b09e680682']",22,128,150,317309,13,,,,1423
26705298bdbeadfc2357e5595e5c48bfbd214edf,1,mneethiraj,2014-09-16 13:29:24-07:00,['852ec251628fa1b82ca863334c1d1301e8303d0b'],3,5,8,317317,1,1,1,1,1423
a6f5be8a7b7d7a4daa3358d386d2a5467bb6bebf,1,rmani,2014-09-16 18:21:13-07:00,['5c29ec203fab50f8a2ad037185bd89d7db33a7aa'],26,54,80,317397,2,0.2,1,1,1423
9736e8b7889b9d5f1af74756ada4eb7f258207a6,1,sneethiraj,2014-09-17 11:12:14-04:00,['26705298bdbeadfc2357e5595e5c48bfbd214edf'],0,4,4,317401,2,0,0.5,1,1423
5e2c79235c07e37a8610eebb10afe97ffcfe1362,0,sneethiraj,2014-09-17 11:13:30-04:00,['9736e8b7889b9d5f1af74756ada4eb7f258207a6'],9,9,18,317419,1,,,,1423
ee0a04eb7c8c7b932784ae4946bfa430ee35a299,1,sneethiraj,2014-09-17 11:14:28-04:00,['5e2c79235c07e37a8610eebb10afe97ffcfe1362'],28,35,63,317482,1,,,,1423
e5dab0670ac490f8d3a5ef68fd4eb06168ebae8f,1,sneethiraj,2014-09-17 11:16:09-04:00,['ee0a04eb7c8c7b932784ae4946bfa430ee35a299'],4,375,379,317861,7,0.204633205,0.351351351,1,1425
d34e05656568bb308f8b5f583409a0f333c328d5,0,rmani,2014-09-17 11:13:51-07:00,['a6f5be8a7b7d7a4daa3358d386d2a5467bb6bebf'],0,4,4,317865,2,,,,1425
3c597342363d9303fff82e70f9964c4bda43e619,1,Dilli Dorai Arumugam,2014-09-17 13:05:16-07:00,['e5dab0670ac490f8d3a5ef68fd4eb06168ebae8f'],0,32,32,317897,32,,,,1425
3b7c71211a458fe809c3df55ab64ce61db2a3415,0,rmani,2014-09-17 14:43:43-07:00,['d34e05656568bb308f8b5f583409a0f333c328d5'],2,5,7,317904,1,1,1,1,1425
9660b4e5b15a222c7dfc7750055db2f7f7054cc0,0,Dilli Dorai Arumugam,2014-09-17 19:03:24-07:00,['3c597342363d9303fff82e70f9964c4bda43e619'],6,0,6,317910,6,,,,1425
a0a18007f123c156f4e973eee0dd6543c13f52e0,1,sneethiraj,2014-09-18 23:53:28-04:00,['9660b4e5b15a222c7dfc7750055db2f7f7054cc0'],305,2006,2311,320221,49,1,1,1,1432
4f5fa69fe94549faccd5c33bc0c0651f51b07a63,0,sneethiraj,2014-09-19 00:36:26-04:00,['a0a18007f123c156f4e973eee0dd6543c13f52e0'],6,6,12,320233,3,,,,1432
daac1c6def680ce8a6fc399c8b1f0dce1c4645c6,0,sneethiraj,2014-09-19 00:39:21-04:00,['4f5fa69fe94549faccd5c33bc0c0651f51b07a63'],21,40,61,320294,1,0,0,1,1432
be47e6402804b013cfcf76aae27f899010b721ed,1,mneethiraj,2014-09-18 23:40:57-07:00,['daac1c6def680ce8a6fc399c8b1f0dce1c4645c6'],14,1245,1259,321553,9,0.537226277,0.846715328,1,1439
f7c934cf47ca566530badd821a54eaf4481db197,1,mneethiraj,2014-09-19 00:09:43-07:00,['be47e6402804b013cfcf76aae27f899010b721ed'],2,3,5,321558,2,1,1,1,1439
a9a959919aa939e15d2bdada155da22720422420,0,sneethiraj,2014-09-19 15:10:49-04:00,['daac1c6def680ce8a6fc399c8b1f0dce1c4645c6'],3,43,46,321604,1,0,0.043478261,1,1439
6d3618fcbc5fa1ff6f67388ce0bb1c2b9fda47e3,1,rmani,2014-09-19 14:29:53-07:00,['3b7c71211a458fe809c3df55ab64ce61db2a3415'],7,24,31,321635,1,0,0,1,1439
4eacc7a8dcd8f473f45bee0b6819f2535597c3dc,0,rmani,2014-09-19 14:32:41-07:00,"['6d3618fcbc5fa1ff6f67388ce0bb1c2b9fda47e3', 'a9a959919aa939e15d2bdada155da22720422420']",3028,11888,14916,336551,517,,,,1439
2fde332537b74a74e0bad8ac1a0debbe40570c56,0,mneethiraj,2014-09-19 17:49:51-07:00,"['f7c934cf47ca566530badd821a54eaf4481db197', '4eacc7a8dcd8f473f45bee0b6819f2535597c3dc']",37,1477,1514,338065,7,,,,1439
bb161f3347c5f52eedaf33f0abb010d18ed3f167,0,sneethiraj,2014-09-20 02:45:35-04:00,['4eacc7a8dcd8f473f45bee0b6819f2535597c3dc'],12,12,24,338089,4,,,,1439
8bafd82db15554c9d8f8c1756c26f16cd10b136f,0,mneethiraj,2014-09-20 01:49:24-07:00,"['2fde332537b74a74e0bad8ac1a0debbe40570c56', 'bb161f3347c5f52eedaf33f0abb010d18ed3f167']",12,12,24,338113,4,,,,1439
1e1fcff180736a915a95903353e8c3ff7fa612c2,0,Dilli Dorai Arumugam,2014-09-20 15:02:37-07:00,['bb161f3347c5f52eedaf33f0abb010d18ed3f167'],2,2,4,338117,1,,,,1439
886e9c241e3919ff2a17767a4db3e1328ed7d655,0,mneethiraj,2014-09-20 23:58:07-07:00,"['8bafd82db15554c9d8f8c1756c26f16cd10b136f', '1e1fcff180736a915a95903353e8c3ff7fa612c2']",2,2,4,338121,1,,,,1439
5ccf382d13d046179d2b1bbd20449917cfc7b8c1,1,mneethiraj,2014-09-21 00:37:28-07:00,['886e9c241e3919ff2a17767a4db3e1328ed7d655'],74,1708,1782,339903,14,0.43543956,0.76510989,1,1446
c324e8dfa123091a49bff1b3d3f34675f232c7e2,0,mneethiraj,2014-09-21 14:11:16-07:00,['5ccf382d13d046179d2b1bbd20449917cfc7b8c1'],71,114,185,340088,9,1,0,1,1446
efd3501dcc79c5a4985b881fbb36b84e374bae63,0,mneethiraj,2014-09-22 00:09:21-07:00,['c324e8dfa123091a49bff1b3d3f34675f232c7e2'],22,175,197,340285,13,1,1,1,1446
46584e44293f2bf379f5206c374ad7644a7b54b7,0,mneethiraj,2014-09-22 11:13:34-07:00,['efd3501dcc79c5a4985b881fbb36b84e374bae63'],47,58,105,340390,13,0.555555556,0.888888889,1,1446
cfec85a65894eed3f1bcda2ee19281d66ad58bb4,0,mneethiraj,2014-09-22 11:28:34-07:00,['46584e44293f2bf379f5206c374ad7644a7b54b7'],0,1,1,340391,1,1,1,1,1446
3838f13df286c1fb08bfee958b8ae3ab1615c7ea,1,sneethiraj,2014-09-22 21:28:41-04:00,['cfec85a65894eed3f1bcda2ee19281d66ad58bb4'],0,29,29,340420,3,0.833333333,0.833333333,0.833333333,1446
6ad612029385a0515f3fca4deec8d3ec7bc309ea,1,sneethiraj,2014-09-22 21:30:01-04:00,['3838f13df286c1fb08bfee958b8ae3ab1615c7ea'],0,2,2,340422,1,0,1,1,1446
7bfb3cb9d14eb762bcb65bd17d81891fd520be54,0,sneethiraj,2014-09-22 21:31:07-04:00,['6ad612029385a0515f3fca4deec8d3ec7bc309ea'],13,24,37,340459,3,,,,1446
acd088613c1e9cd8c684eda8ca7f441ee0623bbf,1,sneethiraj,2014-09-22 21:34:29-04:00,['7bfb3cb9d14eb762bcb65bd17d81891fd520be54'],2,4,6,340465,2,0,1,1,1446
40ab8ebcd69e5000d8fd44a306edd36d2138ec51,0,mneethiraj,2014-09-22 18:52:04-07:00,['cfec85a65894eed3f1bcda2ee19281d66ad58bb4'],39,72,111,340576,3,0.074074074,0.777777778,1,1446
81f76076e4575d49bcffdd2447381b58af6be4f0,0,mneethiraj,2014-09-22 19:30:24-07:00,"['40ab8ebcd69e5000d8fd44a306edd36d2138ec51', 'acd088613c1e9cd8c684eda8ca7f441ee0623bbf']",15,59,74,340650,5,,,,1446
74d83939558f6378ccb2cc2e4e6498cc980b1776,0,mneethiraj,2014-09-22 21:02:23-07:00,['81f76076e4575d49bcffdd2447381b58af6be4f0'],1,116,117,340767,18,0.28125,0.4375,1,1446
ea4df438291cb981326056adb3eb3e1bf349c66f,1,mneethiraj,2014-09-22 23:56:40-07:00,['74d83939558f6378ccb2cc2e4e6498cc980b1776'],9,65,74,340841,6,0.925925926,0.925925926,1,1446
b6f46df12f4463d4c87ab3082a37f479eace3a89,0,sneethiraj,2014-09-23 09:27:55-04:00,['81f76076e4575d49bcffdd2447381b58af6be4f0'],1,1,2,340843,1,,,,1446
db0b1b8add46f1311304154f7013e4d16cd848e1,0,sneethiraj,2014-09-23 09:30:04-04:00,['b6f46df12f4463d4c87ab3082a37f479eace3a89'],1,1,2,340845,1,,,,1446
6c11ec265288439600da645870e0280ff65ef40f,1,sneethiraj,2014-09-23 09:32:13-04:00,['db0b1b8add46f1311304154f7013e4d16cd848e1'],1,1,2,340847,1,,,,1446
7201bf87c8001cfd8657a298faf2809b0a0a5028,0,mneethiraj,2014-09-23 10:00:42-07:00,"['ea4df438291cb981326056adb3eb3e1bf349c66f', '6c11ec265288439600da645870e0280ff65ef40f']",3,3,6,340853,2,,,,1446
b6efd47136bf449ce12966af9cd2e9b398cf6415,1,mneethiraj,2014-09-23 11:12:35-07:00,['7201bf87c8001cfd8657a298faf2809b0a0a5028'],24,34,58,340911,5,0,0,1,1446
647cdb7eea386b34db1c300996a13b848eefc361,0,mneethiraj,2014-09-23 11:32:49-07:00,['b6efd47136bf449ce12966af9cd2e9b398cf6415'],12,12,24,340935,2,,,,1446
e1a66e582810994156f145b516461c859510ecd2,0,Dilli Dorai Arumugam,2014-09-23 13:12:02-07:00,['647cdb7eea386b34db1c300996a13b848eefc361'],1,1,2,340937,1,,,,1446
c47bcb51d6390c533a1376cffe3813e888be89f5,0,mneethiraj,2014-09-23 15:59:12-07:00,['647cdb7eea386b34db1c300996a13b848eefc361'],1,1,2,340939,1,,,,1446
0e7cfbf4913b5d886619d4a99e511d95c6ece6b8,0,mneethiraj,2014-09-23 15:59:40-07:00,"['c47bcb51d6390c533a1376cffe3813e888be89f5', 'e1a66e582810994156f145b516461c859510ecd2']",1,1,2,340941,1,,,,1446
cdb53604dd3fa175ef3c8db71848f97877532a72,0,rmani,2014-09-23 16:02:08-07:00,['cfec85a65894eed3f1bcda2ee19281d66ad58bb4'],1,1,2,340943,1,,,,1446
105e71e9444054509ae9cfa2e5495fd3d47d362b,0,rmani,2014-09-23 16:20:16-07:00,"['cdb53604dd3fa175ef3c8db71848f97877532a72', 'e1a66e582810994156f145b516461c859510ecd2']",79,337,416,341359,33,,,,1446
1d6351a6753920ef1d9abaef20ef64228037d890,1,sneethiraj,2014-09-23 21:39:15-04:00,['105e71e9444054509ae9cfa2e5495fd3d47d362b'],4,8,12,341371,1,0,0,0,1446
609abd8c5fd9671a4d0904b06a5d31761b7427b7,1,sneethiraj,2014-09-23 21:40:50-04:00,['1d6351a6753920ef1d9abaef20ef64228037d890'],0,21,21,341392,2,0,0,1,1446
d4dd0ea0c70d88ea4142de1846dd32fa77fba07b,0,mneethiraj,2014-09-23 21:14:53-07:00,"['0e7cfbf4913b5d886619d4a99e511d95c6ece6b8', '609abd8c5fd9671a4d0904b06a5d31761b7427b7']",5,30,35,341427,4,,,,1446
bffdbd999f75b3f83cbb56876e10176d73460cab,1,Dilli Dorai Arumugam,2014-09-23 21:17:59-07:00,['609abd8c5fd9671a4d0904b06a5d31761b7427b7'],0,33,33,341460,1,,,,1446
4058fd2bbc5065b0a1303d620d43eaf34854c1c2,0,mneethiraj,2014-09-24 10:03:16-07:00,"['d4dd0ea0c70d88ea4142de1846dd32fa77fba07b', 'bffdbd999f75b3f83cbb56876e10176d73460cab']",0,33,33,341493,1,,,,1446
fcf01f981bf810d868f15b65b5d7b802851e3cf4,1,mneethiraj,2014-09-24 22:57:23-07:00,['4058fd2bbc5065b0a1303d620d43eaf34854c1c2'],71,221,292,341785,11,0.13,0.14,0.86,1446
674c615ddebf4a0910819f41c543fcc76770f712,0,sneethiraj,2014-09-24 23:50:34-07:00,['4058fd2bbc5065b0a1303d620d43eaf34854c1c2'],0,36,36,341821,1,,,,1446
27b7fd709335e8e4ac68365478dce90f62ef13fe,0,mneethiraj,2014-09-25 01:13:44-07:00,"['fcf01f981bf810d868f15b65b5d7b802851e3cf4', '674c615ddebf4a0910819f41c543fcc76770f712']",0,36,36,341857,1,,,,1446
7a01fbbe267816320f0f80f6293a4bd2c83d00f6,0,mneethiraj,2014-09-25 01:17:12-07:00,['27b7fd709335e8e4ac68365478dce90f62ef13fe'],141,41,182,342039,12,,,,1446
031c84836ea08db0fe888a554110ae5e9718ce6d,1,sneethiraj,2014-09-25 10:15:47-07:00,['7a01fbbe267816320f0f80f6293a4bd2c83d00f6'],231,773,1004,343043,11,0,0,1,1450
e19fd6d7f5294c4d91f9ecd769891e746042d412,0,mneethiraj,2014-09-25 13:44:27-07:00,['7a01fbbe267816320f0f80f6293a4bd2c83d00f6'],10,10,20,343063,5,,,,1450
ad55c2bbe34699122f855392542a6571c60a2e5d,1,sneethiraj,2014-09-25 13:49:41-07:00,['031c84836ea08db0fe888a554110ae5e9718ce6d'],60,56,116,343179,19,,,,1450
290128b9aa3ef34687ee669a822ae82271f8ba48,0,mneethiraj,2014-09-25 15:10:54-07:00,"['e19fd6d7f5294c4d91f9ecd769891e746042d412', 'ad55c2bbe34699122f855392542a6571c60a2e5d']",291,829,1120,344299,30,,,,1450
055d5b062bad1d4e23f1bceb7d745201c8403992,1,mneethiraj,2014-09-25 15:32:04-07:00,['290128b9aa3ef34687ee669a822ae82271f8ba48'],4,1,5,344304,1,0,0,0,1450
802fadf73bd031ad1b8150f3f57e35b095064ca2,0,mneethiraj,2014-09-25 18:44:34-07:00,['055d5b062bad1d4e23f1bceb7d745201c8403992'],10,10,20,344324,5,,,,1450
2261a84c3f6653c2ee022374bd478e7f968df533,1,sneethiraj,2014-09-25 22:05:27-07:00,['802fadf73bd031ad1b8150f3f57e35b095064ca2'],42,58,100,344424,9,,,,1450
909b4e55a05ed39fb10e69225805bcd9df5cc3c5,0,mneethiraj,2014-09-25 23:55:02-07:00,['2261a84c3f6653c2ee022374bd478e7f968df533'],12,12,24,344448,6,,,,1450
dc66161a9d9d8d4fd34170f2273736bef4d5a9cf,1,sneethiraj,2014-09-26 09:02:43-07:00,['909b4e55a05ed39fb10e69225805bcd9df5cc3c5'],0,5,5,344453,1,,,,1450
f154dfe696920dbcc6f0c5ef1ea36c5b0ac8049c,1,mneethiraj,2014-09-26 14:23:30-07:00,['dc66161a9d9d8d4fd34170f2273736bef4d5a9cf'],19,20,39,344492,7,0,0,0,1450
8bc6a08abc57aa4cc84d7feb435350a84a0c4c96,0,mneethiraj,2014-09-26 16:21:46-07:00,['f154dfe696920dbcc6f0c5ef1ea36c5b0ac8049c'],6,6,12,344504,1,,,,1450
d82aa399f1b82f107d721f328085a7dc95b7da77,1,sneethiraj,2014-09-26 17:23:16-07:00,['8bc6a08abc57aa4cc84d7feb435350a84a0c4c96'],2,3,5,344509,1,,,,1450
5ff59f41c410a21740be361f20abb8e48056d8b6,1,sneethiraj,2014-09-26 18:30:22-07:00,['d82aa399f1b82f107d721f328085a7dc95b7da77'],1,2,3,344512,1,,,,1450
548aa516ae0ef47240465a6a928c2d8101c1bbe1,1,sneethiraj,2014-09-27 15:27:08-07:00,['5ff59f41c410a21740be361f20abb8e48056d8b6'],178,121,299,344811,14,0.842105263,0.947368421,1,1450
ee6d77c811a75943ca90fea7ccabca316483f19f,1,sneethiraj,2014-09-27 15:33:57-07:00,['548aa516ae0ef47240465a6a928c2d8101c1bbe1'],26,159,185,344996,7,0.132743363,0.132743363,1,1450
4076fac82fc7a6c7ef43fd745bb4e78e2ad1a52a,0,sneethiraj,2014-09-27 17:33:05-07:00,['ee6d77c811a75943ca90fea7ccabca316483f19f'],0,1,1,344997,1,,,,1450
76acd8308ffdab8368a69616cbc972a712c59ad8,0,sneethiraj,2014-09-28 18:45:45-07:00,['4076fac82fc7a6c7ef43fd745bb4e78e2ad1a52a'],8,4,12,345009,1,,,,1450
da0c05a65eee6d1a1b18bf2650a2f15b5cdf0e16,0,sneethiraj,2014-09-29 20:16:33-07:00,['76acd8308ffdab8368a69616cbc972a712c59ad8'],7,21,28,345037,3,,,,1450
cc6c4394e817f187a95faeb18afefcb09bbe4299,0,sneethiraj,2014-09-29 20:35:28-07:00,['da0c05a65eee6d1a1b18bf2650a2f15b5cdf0e16'],2,2,4,345041,2,,,,1450
24526c6ec55a2c529cec84dc32652c6127433eba,1,sneethiraj,2014-09-30 19:10:45-07:00,['cc6c4394e817f187a95faeb18afefcb09bbe4299'],24,60,84,345125,6,,,,1454
85d672f3077eb08fc0e4f10bce04eb46d31d6f0d,1,mneethiraj,2014-09-30 19:12:55-07:00,['cc6c4394e817f187a95faeb18afefcb09bbe4299'],19,66,85,345210,3,0.882352941,1,1,1454
db6acff810720efbe6c7e909293b71cd090ab5a3,0,mneethiraj,2014-09-30 19:36:28-07:00,"['85d672f3077eb08fc0e4f10bce04eb46d31d6f0d', '24526c6ec55a2c529cec84dc32652c6127433eba']",24,60,84,345294,6,,,,1454
3990ef31e247c51cdc7ec9d8c89554d5175ab6ba,0,sneethiraj,2014-09-30 21:47:16-07:00,['db6acff810720efbe6c7e909293b71cd090ab5a3'],3,3,6,345300,1,,,,1454
91dbc72c36204c85dcd6f7e7d1beb3575c33fc8b,1,mneethiraj,2014-10-01 22:50:31-07:00,['3990ef31e247c51cdc7ec9d8c89554d5175ab6ba'],36,36,72,345372,12,,,,1454
d11f2ede5e4d857053d8f11cbffa51872279a7e7,1,sneethiraj,2014-10-02 13:49:21-07:00,['91dbc72c36204c85dcd6f7e7d1beb3575c33fc8b'],26,139,165,345537,4,0,0.018181818,0.645454545,1454
e8eb9aeb3fcc0cb13c8b32d705714bf306439c43,0,sneethiraj,2014-10-02 14:58:59-07:00,['d11f2ede5e4d857053d8f11cbffa51872279a7e7'],1,3,4,345541,1,,,,1454
1927499d9ce4e5e5e482db272bd4c80138e55c9d,1,mneethiraj,2014-10-02 16:00:48-07:00,['91dbc72c36204c85dcd6f7e7d1beb3575c33fc8b'],105,171,276,345817,5,0.22,1,0.88,1454
63437fdcfa2d9199bdff50c035ce51683e2b68d8,0,mneethiraj,2014-10-02 16:01:00-07:00,"['1927499d9ce4e5e5e482db272bd4c80138e55c9d', 'd11f2ede5e4d857053d8f11cbffa51872279a7e7']",26,139,165,345982,4,,,,1454
3c7f3ff4d2d165318049df9118b54e2e361d893f,1,rmani,2014-10-02 16:37:03-07:00,['d11f2ede5e4d857053d8f11cbffa51872279a7e7'],81,84,165,346147,6,1,0,0,1454
61b3f4a356df262bbcb1d9e0c6c4d62b6d500beb,0,rmani,2014-10-02 17:34:15-07:00,"['3c7f3ff4d2d165318049df9118b54e2e361d893f', 'e8eb9aeb3fcc0cb13c8b32d705714bf306439c43']",1,3,4,346151,1,,,,1454
83c336de5be71f1f902734ecc0f52802a6c95a6c,1,sneethiraj,2014-10-02 17:50:55-07:00,['61b3f4a356df262bbcb1d9e0c6c4d62b6d500beb'],5,5,10,346161,3,,,,1454
b83ae91f3e326682de9ffe262650124900016c65,0,mneethiraj,2014-10-02 18:55:46-07:00,"['63437fdcfa2d9199bdff50c035ce51683e2b68d8', '83c336de5be71f1f902734ecc0f52802a6c95a6c']",87,92,179,346340,10,,,,1454
01fb970fe1494735ed2aeffa881b6d59d20150f7,1,sneethiraj,2014-10-02 19:17:42-07:00,['b83ae91f3e326682de9ffe262650124900016c65'],0,66,66,346406,2,,,,1454
185ab0862432060288c81aed419507e450e0bef2,0,mneethiraj,2014-10-04 12:16:48-07:00,['01fb970fe1494735ed2aeffa881b6d59d20150f7'],70,144,214,346620,5,1,0.944444444,0.805555556,1456
d95b51934149cee33b84ec8a5c349c3a6ca47ffb,1,sneethiraj,2014-10-04 23:25:05-05:00,['01fb970fe1494735ed2aeffa881b6d59d20150f7'],98,760,858,347478,8,0.067395264,0.227686703,0.843351548,1456
7a9ee4d1253effe990069d193ec667f746c0f835,0,mneethiraj,2014-10-04 21:43:51-07:00,"['185ab0862432060288c81aed419507e450e0bef2', 'd95b51934149cee33b84ec8a5c349c3a6ca47ffb']",98,760,858,348336,8,,,,1456
cc386acec9f1ff0cf9cf4b2ff589b1b053927cb2,1,rmani,2014-10-05 23:53:29-07:00,['01fb970fe1494735ed2aeffa881b6d59d20150f7'],2,2,4,348340,1,,,,1456
32dbf7173d7c474cd5a2fa47c4cb0055df87f347,0,rmani,2014-10-05 23:54:01-07:00,"['cc386acec9f1ff0cf9cf4b2ff589b1b053927cb2', '7a9ee4d1253effe990069d193ec667f746c0f835']",168,904,1072,349412,13,,,,1456
500edcff6c6165190876fd7b43f48710789caba5,1,sneethiraj,2014-10-07 23:05:43-04:00,['32dbf7173d7c474cd5a2fa47c4cb0055df87f347'],11,33,44,349456,1,0,0,1,1456
cd7e677aee3c8185ce6f3d3953144e97c55a4d2f,1,sneethiraj,2014-10-07 23:12:34-04:00,['500edcff6c6165190876fd7b43f48710789caba5'],17,25,42,349498,1,0,0,1,1456
e5b95a7d0a5a0d39650f01c948ebdc4de788caee,1,sneethiraj,2014-10-07 23:14:37-04:00,['cd7e677aee3c8185ce6f3d3953144e97c55a4d2f'],4,12,16,349514,4,,,,1456
49892c0d12fe621b4cb4c9a5d787da53021529ab,0,sneethiraj,2014-10-08 13:11:59-04:00,['e5b95a7d0a5a0d39650f01c948ebdc4de788caee'],0,51,51,349565,1,,,,1457
7b1b3e4365c35ffd80c3cba1f49d16592eafc64e,1,sneethiraj,2014-10-08 18:15:06-04:00,['49892c0d12fe621b4cb4c9a5d787da53021529ab'],28,202,230,349795,5,0.012903226,0.329032258,0.774193548,1457
e93b05fdf8af2cc8918dc647e0d1579f7a84131f,1,sneethiraj,2014-10-08 21:13:37-04:00,['7b1b3e4365c35ffd80c3cba1f49d16592eafc64e'],9,17,26,349821,4,1,1,1,1457
091efb7d9af8945c65106410b2df9466dd473c86,1,sneethiraj,2014-10-08 21:16:11-04:00,['e93b05fdf8af2cc8918dc647e0d1579f7a84131f'],2,2,4,349825,1,,,,1457
5dfd15e3ccf5c7d4507e8a073a339dd299b0077b,1,sneethiraj,2014-10-09 09:25:37-04:00,['091efb7d9af8945c65106410b2df9466dd473c86'],4,6,10,349835,1,,,,1457
fa1aaa5b7349d1b81c6d46ae1d380a4ce4e7926c,1,sneethiraj,2014-10-09 23:22:03-04:00,['5dfd15e3ccf5c7d4507e8a073a339dd299b0077b'],34,30,64,349899,9,0,0,1,1457
68ee07f3b29e32ada4b74739abe52839f165fa3e,1,sneethiraj,2014-10-09 23:23:57-04:00,['fa1aaa5b7349d1b81c6d46ae1d380a4ce4e7926c'],1,3,4,349903,1,0,0,1,1457
38ed20357ec013515cf345980be1784d20b026f4,0,sneethiraj,2014-10-10 01:52:43-04:00,['68ee07f3b29e32ada4b74739abe52839f165fa3e'],2,2,4,349907,2,,,,1457
cd863f20d8f2c7c43f28adc720fbc0498ba4bc28,0,mneethiraj,2014-10-11 01:06:07-07:00,['38ed20357ec013515cf345980be1784d20b026f4'],55,85,140,350047,8,1,0,1,1457
5f4053e66ad5a505054ddf413f6654b4be896407,0,mneethiraj,2014-10-12 00:54:18-07:00,['cd863f20d8f2c7c43f28adc720fbc0498ba4bc28'],3,47,50,350097,1,0.34375,0.34375,1,1457
65b6d83d993980dc46037a0078d8368d08026bca,1,sneethiraj,2014-10-12 12:42:38-04:00,['38ed20357ec013515cf345980be1784d20b026f4'],807,2938,3745,353842,13,0.613861386,1,0.98019802,1467
1b8fff511d0cc967dd3333ff23672728853e24b3,1,sneethiraj,2014-10-12 12:52:23-04:00,['65b6d83d993980dc46037a0078d8368d08026bca'],1,1,2,353844,1,0,0,1,1467
6beed95f5b805a0ee2846fb14eeaa214bcc745f5,1,sneethiraj,2014-10-12 12:57:17-04:00,['1b8fff511d0cc967dd3333ff23672728853e24b3'],30,35,65,353909,2,0.5,0.5,1,1467
b5dbed684be615864e22c39cd6761f499af89b7a,0,mneethiraj,2014-10-12 14:15:13-07:00,['5f4053e66ad5a505054ddf413f6654b4be896407'],3,8,11,353920,2,0,0.75,1,1467
72d5a91bf1e4aa5e7945096feebb54f89c98bd75,0,mneethiraj,2014-10-12 14:24:58-07:00,"['b5dbed684be615864e22c39cd6761f499af89b7a', '6beed95f5b805a0ee2846fb14eeaa214bcc745f5']",838,2974,3812,357732,16,,,,1467
09bd79abdfed2a54ce56d695f2bea47c7df6c62d,0,mneethiraj,2014-10-13 10:53:37-07:00,['72d5a91bf1e4aa5e7945096feebb54f89c98bd75'],0,4,4,357736,1,,,,1467
9b21e5c9c360949d32ff07f5f2b12f6b8919ab6e,0,mneethiraj,2014-10-13 16:31:25-07:00,['09bd79abdfed2a54ce56d695f2bea47c7df6c62d'],2,10,12,357748,2,,,,1467
99c462d2c3140b672af6574947bbcd5cb6ccb197,1,Dilli Dorai Arumugam,2014-10-13 17:52:54-07:00,['09bd79abdfed2a54ce56d695f2bea47c7df6c62d'],0,3423,3423,361171,217,,,,1467
75950752e8f3b0406b2c2cee3feb1b2a90d5dc72,0,mneethiraj,2014-10-13 20:22:17-07:00,"['9b21e5c9c360949d32ff07f5f2b12f6b8919ab6e', '99c462d2c3140b672af6574947bbcd5cb6ccb197']",0,3423,3423,364594,217,,,,1467
b456922dbe4069df896e4ecc50dedfd5d0081d56,0,mneethiraj,2014-10-14 13:41:43-07:00,['75950752e8f3b0406b2c2cee3feb1b2a90d5dc72'],8,17,25,364619,6,,,,1467
47987b48d4842adaff0b7c564d9b8a2b28170115,0,rmani,2014-10-14 16:06:43-07:00,['b456922dbe4069df896e4ecc50dedfd5d0081d56'],7,0,7,364626,2,,,,1467
df157f668dede9bfb5d6c4ada7f886eff8151caf,1,Dilli Dorai Arumugam,2014-10-15 07:21:52-07:00,['47987b48d4842adaff0b7c564d9b8a2b28170115'],146,162,308,364934,63,,,,1467
31801c0a594c6267c470120bba3f6bb2c2c2761a,0,rmani,2014-10-16 13:44:15-07:00,['df157f668dede9bfb5d6c4ada7f886eff8151caf'],7,7,14,364948,1,,,,1467
d789b9c08e3a8f4ab12b621271943d9f1f0e9ff0,1,sneethiraj,2014-10-17 03:14:06-04:00,['31801c0a594c6267c470120bba3f6bb2c2c2761a'],0,1,1,364949,1,1,1,1,1467
920814bae98a1ea769eb61cfc01513f4ac635ac4,1,sneethiraj,2014-10-17 03:15:28-04:00,['d789b9c08e3a8f4ab12b621271943d9f1f0e9ff0'],1,8,9,364958,1,0.8,0.8,1,1467
8bb34f22c77185c36b04137b9d7a43d3d6ee7a3f,1,mneethiraj,2014-10-17 00:40:54-07:00,['31801c0a594c6267c470120bba3f6bb2c2c2761a'],7,14,21,364979,1,,,,1467
48e3730f0eeeb1249c9eb74dcb91056d6cbeabb2,0,mneethiraj,2014-10-17 00:41:25-07:00,"['8bb34f22c77185c36b04137b9d7a43d3d6ee7a3f', '920814bae98a1ea769eb61cfc01513f4ac635ac4']",1,9,10,364989,2,,,,1467
662cd2b6935750668d0e27ce4e50c339ddc5be20,1,Dilli Dorai Arumugam,2014-10-18 05:53:20-07:00,['48e3730f0eeeb1249c9eb74dcb91056d6cbeabb2'],52,89,141,365130,1,0,0,1,1467
f09d66ad5035cb6886deca1806fda88b0d9b3d62,1,sneethiraj,2014-10-21 02:52:11-04:00,['920814bae98a1ea769eb61cfc01513f4ac635ac4'],1,294,295,365425,16,,,,1470
81504d1bf2975ebdd3612c1b9db897f4a87b29c1,0,sneethiraj,2014-10-21 03:01:33-04:00,"['f09d66ad5035cb6886deca1806fda88b0d9b3d62', '662cd2b6935750668d0e27ce4e50c339ddc5be20']",59,103,162,365587,2,,,,1470
23464e6180000d910142f86267dbd7cbded32edf,0,sneethiraj,2014-10-21 11:57:04-04:00,['81504d1bf2975ebdd3612c1b9db897f4a87b29c1'],0,0,0,365587,1,,,,1471
33778bc46c42ed4b69b458caacdde81aaa5e906a,1,mneethiraj,2014-10-21 16:01:25-07:00,['23464e6180000d910142f86267dbd7cbded32edf'],23,189,212,365799,3,0.836538462,0.836538462,0.701923077,1471
5039dbde402d557d9badd51bab9d770e8e30f51d,0,mneethiraj,2014-10-21 16:52:41-07:00,['33778bc46c42ed4b69b458caacdde81aaa5e906a'],2,0,2,365801,1,,,,1471
547eab56c528579775fc1ad3ee4f760d2dcd614d,0,mneethiraj,2014-10-21 18:27:25-07:00,['5039dbde402d557d9badd51bab9d770e8e30f51d'],73,1,74,365875,3,0,0,0,1471
f1930dbc8c22adbf5c25abecd7b761847a1035e7,1,sneethiraj,2014-10-21 22:56:02-04:00,['547eab56c528579775fc1ad3ee4f760d2dcd614d'],170,219,389,366264,6,,,,1471
65f21ec11414417590862fca85ed4654f76586d2,0,sneethiraj,2014-10-21 22:59:55-04:00,['f1930dbc8c22adbf5c25abecd7b761847a1035e7'],14,14,28,366292,1,,,,1471
12c082f184cceb2538250e7bb1087bcfcfd4c2ab,0,sneethiraj,2014-10-21 23:46:37-04:00,['65f21ec11414417590862fca85ed4654f76586d2'],3,6,9,366301,2,,,,1471
dfa34218e2a96efdcd448e48a02cd39dab06d6c7,0,rmani,2014-10-21 21:13:11-07:00,['12c082f184cceb2538250e7bb1087bcfcfd4c2ab'],5,3,8,366309,1,,,,1471
45d208cf9b82e1ee1c7303ea2b30996ff16b56b3,0,rmani,2014-10-21 21:27:15-07:00,['dfa34218e2a96efdcd448e48a02cd39dab06d6c7'],1,1,2,366311,1,,,,1471
38906d8cd90255b07a86161d474fa8d168440beb,1,sneethiraj,2014-10-22 01:52:42-04:00,['45d208cf9b82e1ee1c7303ea2b30996ff16b56b3'],2,2,4,366315,1,1,1,0,1471
43d5e8d05558284f8e43f54c7eeb8216a85f5c30,0,sneethiraj,2014-10-22 01:59:45-04:00,['38906d8cd90255b07a86161d474fa8d168440beb'],4,4,8,366323,5,,,,1471
1fd51cdf088700d222a42fc9b3de1ea75607bce0,1,sneethiraj,2014-10-22 02:01:33-04:00,['43d5e8d05558284f8e43f54c7eeb8216a85f5c30'],0,41,41,366364,1,,,,1471
a8f75bd61637a543d13cd7f7ad28031b59b83acb,1,sneethiraj,2014-10-22 02:18:04-04:00,['1fd51cdf088700d222a42fc9b3de1ea75607bce0'],1,5,6,366370,1,0,0,1,1471
dd87ada1b507109272cb5110473852b1fa4243ce,1,sneethiraj,2014-10-22 15:26:46-04:00,['a8f75bd61637a543d13cd7f7ad28031b59b83acb'],10,20,30,366400,2,0,0.3,1,1471
e57ee6c51dfd6c309ec0b77d3e87aa3ab61bd9ae,0,sneethiraj,2014-10-23 14:21:03-04:00,['dd87ada1b507109272cb5110473852b1fa4243ce'],5,7,12,366412,1,0,0,0,1471
a6aab65eb85d0b888130e613b73803bf4bc207bc,0,sneethiraj,2014-10-23 23:31:41-04:00,['e57ee6c51dfd6c309ec0b77d3e87aa3ab61bd9ae'],7,29,36,366448,2,,,,1471
f43c21bcc0df3e5a45b5ebbacd04261a4415119e,0,sneethiraj,2014-10-24 07:28:27-04:00,['a6aab65eb85d0b888130e613b73803bf4bc207bc'],0,1,1,366449,1,,,,1472
398ebc1f8252c47a06030a25b7bfeb52b352ca0b,0,rmani,2014-10-24 16:11:36-07:00,['f43c21bcc0df3e5a45b5ebbacd04261a4415119e'],411,13,424,366873,24,,,,1472
2c3926b558c4714434b058c83d0a784a749dda1b,1,mneethiraj,2014-10-24 18:26:21-07:00,['f43c21bcc0df3e5a45b5ebbacd04261a4415119e'],191,208,399,367272,11,1,1,0,1472
5ee2ed2b72dd9b45ebb0f9b86c2bc2ae33e68399,0,mneethiraj,2014-10-24 18:26:37-07:00,"['2c3926b558c4714434b058c83d0a784a749dda1b', '398ebc1f8252c47a06030a25b7bfeb52b352ca0b']",411,13,424,367696,24,,,,1472
af1f67db1e67bdcc93774ed02779ae569fc214e0,0,sneethiraj,2014-10-24 22:36:39-04:00,['398ebc1f8252c47a06030a25b7bfeb52b352ca0b'],13,411,424,368120,24,,,,1487
a62cb5abe93cddde479662207ce53210cefde544,0,sneethiraj,2014-10-24 22:42:21-04:00,['af1f67db1e67bdcc93774ed02779ae569fc214e0'],912,5,917,369037,35,,,,1487
776d3856fb8da46ce2c165871254e16c27a3442c,1,sneethiraj,2014-10-24 23:07:34-04:00,['a62cb5abe93cddde479662207ce53210cefde544'],11,31,42,369079,19,,,,1487
908724f3e3ac5876b467899c2f513edf770fb280,1,sneethiraj,2014-10-24 23:19:40-04:00,['776d3856fb8da46ce2c165871254e16c27a3442c'],1,9,10,369089,1,,,,1487
07a838d38cbc9648f716fc82aac0042d5419c16e,0,sneethiraj,2014-10-24 23:40:48-04:00,['908724f3e3ac5876b467899c2f513edf770fb280'],2,70,72,369161,1,,,,1487
069e55678597d2e0fa9c901ec4b017b54920632b,0,sneethiraj,2014-10-25 00:31:33-04:00,['07a838d38cbc9648f716fc82aac0042d5419c16e'],70,448,518,369679,31,,,,1487
3c07f476f78df1830eebbb675014203970cb7d8e,0,mneethiraj,2014-10-25 08:03:01-07:00,"['5ee2ed2b72dd9b45ebb0f9b86c2bc2ae33e68399', '069e55678597d2e0fa9c901ec4b017b54920632b']",538,503,1041,370720,70,,,,1487
372b98002ec2116210038b711cc4541f3b96d64e,1,mneethiraj,2014-10-25 08:40:13-07:00,['3c07f476f78df1830eebbb675014203970cb7d8e'],6,8,14,370734,6,,,,1487
26cd9d32f0512d176ada5c45b4ca9b859465590b,0,mneethiraj,2014-10-25 22:48:19-07:00,['372b98002ec2116210038b711cc4541f3b96d64e'],7,13,20,370754,4,,,,1487
d224b21d9fa50ab6ba1e71c4e0fa1aa45460f11c,0,mneethiraj,2014-10-27 17:21:18-07:00,['372b98002ec2116210038b711cc4541f3b96d64e'],7,13,20,370774,4,,,,1487
5b4cf70bd70368d2d45b2e8e9e2afd3b49711b1c,0,mneethiraj,2014-10-27 17:22:38-07:00,"['d224b21d9fa50ab6ba1e71c4e0fa1aa45460f11c', '26cd9d32f0512d176ada5c45b4ca9b859465590b']",0,0,0,370774,0,,,,1487
7c32f5093f920e14234fd0c365feec69b027df50,0,mneethiraj,2014-10-27 23:53:16-07:00,['5b4cf70bd70368d2d45b2e8e9e2afd3b49711b1c'],2,19,21,370795,1,1,1,1,1487
a51988539ad1c8d34fadd48d0e6dd475e6c88395,0,mneethiraj,2014-10-28 10:00:03-07:00,['7c32f5093f920e14234fd0c365feec69b027df50'],0,0,0,370795,4,,,,1487
6af44c4f4f75bdc52039d829f5fb9d3ccbecfb81,1,sneethiraj,2014-10-29 19:09:28-07:00,['a51988539ad1c8d34fadd48d0e6dd475e6c88395'],747,5973,6720,377515,75,0.274125874,0.717482517,0.865734266,1509
6c127542ca99b71e664968421b476b0fe994fae8,1,sneethiraj,2014-10-29 20:46:55-07:00,['6af44c4f4f75bdc52039d829f5fb9d3ccbecfb81'],14,20,34,377549,6,,,,1509
d0509b63d2f513702bdef8bc9f0aa81ae39f6497,1,mneethiraj,2014-10-30 00:26:32-07:00,['6c127542ca99b71e664968421b476b0fe994fae8'],11,5,16,377565,1,,,,1509
779c38598f6bddc6eee0c0814da3621ee70c56bc,1,sneethiraj,2014-10-30 12:43:16-07:00,['d0509b63d2f513702bdef8bc9f0aa81ae39f6497'],2,2,4,377569,2,,,,1509
e652492d6aa716e303e78a380bea3b126d39eca6,1,sneethiraj,2014-10-30 18:13:53-07:00,['a51988539ad1c8d34fadd48d0e6dd475e6c88395'],0,15,15,377584,3,0,0,1,1509
f72e61f6eff8ff49bfde82d748b8d8f0d104a6e7,0,sneethiraj,2014-10-30 18:17:44-07:00,['e652492d6aa716e303e78a380bea3b126d39eca6'],3,3,6,377590,3,,,,1509
38c35947034f2e844d0a425ed11c8b718bbf2438,1,Madhan Neethiraj,2014-10-30 18:25:36-07:00,['f72e61f6eff8ff49bfde82d748b8d8f0d104a6e7'],5,77,82,377672,3,1,1,0.939393939,1509
fa2ff5ae72077b5b6f764a6386c15c661570d6b8,1,Madhan Neethiraj,2014-10-30 19:07:39-07:00,['38c35947034f2e844d0a425ed11c8b718bbf2438'],24,17,41,377713,1,0,0,0,1509
6a923848d327197540a016a8bcda9b780749457f,1,Madhan Neethiraj,2014-10-30 23:46:42-07:00,['779c38598f6bddc6eee0c0814da3621ee70c56bc'],10,24,34,377747,3,,,,1509
eca811d2137055efce9d512b96fc55f4561a0025,1,sneethiraj,2014-10-31 11:58:39-07:00,['6a923848d327197540a016a8bcda9b780749457f'],44,72,116,377863,5,0.428571429,0,0,1509
a28f5f6b62d4b89e04e99d7f1dfb1f02c089c378,0,sneethiraj,2014-10-31 14:01:17-07:00,"['eca811d2137055efce9d512b96fc55f4561a0025', 'fa2ff5ae72077b5b6f764a6386c15c661570d6b8']",32,112,144,378007,10,,,,1509
5e48367506feeb330722711eda907b01bd92cab9,0,Madhan Neethiraj,2014-10-31 15:02:46-07:00,['a28f5f6b62d4b89e04e99d7f1dfb1f02c089c378'],4845,0,4845,382852,5,,,,1509
8fedc05d788d855a16b2b72712328157402edaac,0,sneethiraj,2014-10-31 17:40:08-07:00,['a28f5f6b62d4b89e04e99d7f1dfb1f02c089c378'],20,29,49,382901,12,1,1,0,1509
6dc34963f40fc96f6eaf689bfb7b54db2fbdb4ef,0,sneethiraj,2014-10-31 17:46:25-07:00,"['8fedc05d788d855a16b2b72712328157402edaac', '5e48367506feeb330722711eda907b01bd92cab9']",4845,0,4845,387746,5,,,,1509
c62c5e1652469b008af1823c86a48d0b75e99b97,1,Madhan Neethiraj,2014-11-01 11:05:22-07:00,['6dc34963f40fc96f6eaf689bfb7b54db2fbdb4ef'],8,19,27,387773,2,0.266666667,0.266666667,1,1509
83d004358c3ee4993f29c3c75581ff5bb21c78d5,1,rmani,2014-11-01 23:10:42-07:00,['c62c5e1652469b008af1823c86a48d0b75e99b97'],0,26,26,387799,1,,,,1509
cfd8da5b550f56f750ad3d62091ebbcd46251e33,1,Madhan Neethiraj,2014-11-02 22:06:46-08:00,['83d004358c3ee4993f29c3c75581ff5bb21c78d5'],248,378,626,388425,11,0.707692308,0.369230769,1,1510
7b287b7a5e3cac069470f22206ee62a7c28be9e9,1,sneethiraj,2014-11-04 17:13:16-05:00,['cfd8da5b550f56f750ad3d62091ebbcd46251e33'],33,477,510,388935,4,,,,1510
b61836fae9f8a5bfeed37bff18afb036e2ce1ab3,0,Dilli Dorai Arumugam,2014-11-05 14:42:57-08:00,['7b287b7a5e3cac069470f22206ee62a7c28be9e9'],1,5,6,388941,1,0,0,1,1510
5883627dfd9c1b74fa055321593ccd7549f2185c,1,sneethiraj,2014-11-05 18:32:08-05:00,['b61836fae9f8a5bfeed37bff18afb036e2ce1ab3'],1,28,29,388970,2,0,0,1,1510
01a2ad2d0beaf499d26519f52e5505c4d1a4ec72,1,rmani,2014-11-05 17:05:14-08:00,['7b287b7a5e3cac069470f22206ee62a7c28be9e9'],10,52,62,389032,1,0.853658537,1,0.731707317,1510
5e45f7d3b16a5de5b1ca341ceb95678acf232fee,0,rmani,2014-11-05 17:07:14-08:00,"['01a2ad2d0beaf499d26519f52e5505c4d1a4ec72', '5883627dfd9c1b74fa055321593ccd7549f2185c']",2,33,35,389067,3,,,,1510
4fcbf1675c19dd2eb2bef2e85b17978e16e35a82,0,Madhan Neethiraj,2014-11-05 17:28:41-08:00,['5e45f7d3b16a5de5b1ca341ceb95678acf232fee'],30,32,62,389129,1,0,0,1,1510
3b87db6c456b37e07c067f3e7469bd696c5100f4,1,Madhan Neethiraj,2014-11-05 17:57:36-08:00,['4fcbf1675c19dd2eb2bef2e85b17978e16e35a82'],9,159,168,389297,11,0.538461538,1,1,1512
bc502520eec334c6d6d78d84cb240cb293c78e78,1,Madhan Neethiraj,2014-11-05 18:32:29-08:00,['3b87db6c456b37e07c067f3e7469bd696c5100f4'],42,362,404,389701,4,0.238410596,1,0.940397351,1513
df39ada9d05e23733a6b8c9da9cc015040c0bc51,0,sneethiraj,2014-11-05 21:59:24-05:00,['bc502520eec334c6d6d78d84cb240cb293c78e78'],1,72,73,389774,4,,,,1513
17adc4c7f5a4c887595785b8b08f4f6eaed24360,0,sneethiraj,2014-11-05 22:18:01-05:00,['df39ada9d05e23733a6b8c9da9cc015040c0bc51'],48,2,50,389824,11,,,,1513
4d66a52409c39d9ea840123901061a8acb668725,0,sneethiraj,2014-11-05 23:43:36-05:00,['17adc4c7f5a4c887595785b8b08f4f6eaed24360'],1433,1093,2526,392350,24,,,,1513
666f96775bafe824e64732be2bc4e18140431337,0,sneethiraj,2014-11-05 23:56:42-05:00,['4d66a52409c39d9ea840123901061a8acb668725'],15,25,40,392390,3,,,,1513
44722c6106c27b4a78a0f5c21aefc9961e1919ef,1,Madhan Neethiraj,2014-11-06 18:01:28-08:00,['666f96775bafe824e64732be2bc4e18140431337'],446,506,952,393342,16,0,0.555555556,1,1513
d9bb3f258df2107f8d58a6d9079d4cbfc88e7bd1,0,Madhan Neethiraj,2014-11-06 18:37:45-08:00,['44722c6106c27b4a78a0f5c21aefc9961e1919ef'],2,2,4,393346,1,,,,1513
9ad99f60dfb374bce832c537d432df50b540719f,1,rmani,2014-11-07 11:54:21-08:00,['d9bb3f258df2107f8d58a6d9079d4cbfc88e7bd1'],4,16,20,393366,1,0,0,1,1513
9d584eb580165267163c48081c7be2ccb96328a3,1,rmani,2014-11-07 21:13:32-08:00,['9ad99f60dfb374bce832c537d432df50b540719f'],0,3,3,393369,1,0,0,1,1513
2357a91392ab4c8a4d2c9edb9fe10cbc0964383d,0,sneethiraj,2014-11-08 10:51:42-05:00,['9d584eb580165267163c48081c7be2ccb96328a3'],0,10,10,393379,1,,,,1513
e67fb5842e13d395f85d3722c1ef23ddb40b967a,0,sneethiraj,2014-11-08 13:54:45-05:00,['666f96775bafe824e64732be2bc4e18140431337'],203,0,203,393582,1,,,,1513
a47120a30e5e397eb723fe9472595c45a9aff1a6,0,sneethiraj,2014-11-08 13:59:35-05:00,"['e67fb5842e13d395f85d3722c1ef23ddb40b967a', '2357a91392ab4c8a4d2c9edb9fe10cbc0964383d']",452,537,989,394571,20,,,,1513
e93e2a96624e174ddf5f5a2347da47e97bd303ce,0,sneethiraj,2014-11-08 14:04:26-05:00,['2357a91392ab4c8a4d2c9edb9fe10cbc0964383d'],4,1,5,394576,9,1,0,0,1513
a9b6331317a6413406860860f4cd1fae3b60ecf2,0,sneethiraj,2014-11-08 14:04:38-05:00,"['e93e2a96624e174ddf5f5a2347da47e97bd303ce', 'a47120a30e5e397eb723fe9472595c45a9aff1a6']",203,0,203,394779,1,,,,1513
38fc24cd5d8cc7e338fe51c565efb4553c0de9d3,0,sneethiraj,2014-11-08 14:08:56-05:00,['a9b6331317a6413406860860f4cd1fae3b60ecf2'],1,97,98,394877,6,,,,1513
e0fe4865f103c591b727865536659c6e4755dc66,1,sneethiraj,2014-11-08 15:24:45-05:00,['38fc24cd5d8cc7e338fe51c565efb4553c0de9d3'],29,12,41,394918,13,,,,1513
bd9039ba3a8b3f382cbdf464b934d8d3d11121f5,0,Don Bosco Durai,2014-11-08 14:24:23-08:00,['e0fe4865f103c591b727865536659c6e4755dc66'],21,15,36,394954,1,,,,1513
6a3118ae6396f4beb8989a6384b24130f19afc5d,1,sneethiraj,2014-11-09 03:36:47-05:00,['e0fe4865f103c591b727865536659c6e4755dc66'],53,82,135,395089,10,0,0,1,1513
c282dca296a5cd3df1ce9d9249efdde4c4194fb5,0,sneethiraj,2014-11-09 04:19:20-05:00,['6a3118ae6396f4beb8989a6384b24130f19afc5d'],6,18,24,395113,2,0,1,1,1513
d0b0ffc7397baf33fec2e9bfc672d5730db461db,0,Don Bosco Durai,2014-11-09 01:45:09-08:00,"['bd9039ba3a8b3f382cbdf464b934d8d3d11121f5', 'c282dca296a5cd3df1ce9d9249efdde4c4194fb5']",59,100,159,395272,12,,,,1513
3125d80dd7d74a6f31919923d7c417d654418b21,1,sneethiraj,2014-11-09 17:31:25-05:00,['d0b0ffc7397baf33fec2e9bfc672d5730db461db'],1,24,25,395297,1,,,,1513
191a528067277a9719fc467d21b36347567725c1,0,sneethiraj,2014-11-09 23:16:06-05:00,['3125d80dd7d74a6f31919923d7c417d654418b21'],570,65,635,395932,8,,,,1513
b9da138be117ea3ce370a9bfd8da1a9bf3f2602f,0,sneethiraj,2014-11-10 00:06:55-05:00,['191a528067277a9719fc467d21b36347567725c1'],992,0,992,396924,2,,,,1513
02f4df19a095e609f4d18a63a695560ee7727d2b,1,sneethiraj,2014-11-12 17:01:42-05:00,['b9da138be117ea3ce370a9bfd8da1a9bf3f2602f'],1,1,2,396926,1,,,,1513
5ea50f29495ebd43773fff8aa37cc4d4e541756a,1,rmani,2014-11-12 22:45:25-08:00,['b9da138be117ea3ce370a9bfd8da1a9bf3f2602f'],0,5,5,396931,3,0,0,1,1513
17bcc918f9741306af8c00312656a723fec5b905,0,rmani,2014-11-12 22:55:45-08:00,"['5ea50f29495ebd43773fff8aa37cc4d4e541756a', '02f4df19a095e609f4d18a63a695560ee7727d2b']",1,1,2,396933,1,,,,1513
eba80f70458d9dd0275a23ef661d6725d5fd9c27,1,Madhan Neethiraj,2014-11-12 23:14:37-08:00,['17bcc918f9741306af8c00312656a723fec5b905'],6,68,74,397007,7,,,,1513
f446cbe9bf330028a5a2aa3780ae8097e4e70c98,1,sneethiraj,2014-11-13 05:05:22-05:00,['eba80f70458d9dd0275a23ef661d6725d5fd9c27'],1,9,10,397017,3,0,0.857142857,1,1513
1d9ffb4f7a0c6b3de7f728a9fa772d2981c0601b,1,sneethiraj,2014-11-13 19:21:22-05:00,['f446cbe9bf330028a5a2aa3780ae8097e4e70c98'],1,91,92,397109,4,0.483870968,0.5,1,1513
526345bdb3a76cbb2c8a8a22e3d5cfd7a18ecf6e,0,Madhan Neethiraj,2014-11-17 11:58:38-08:00,['1d9ffb4f7a0c6b3de7f728a9fa772d2981c0601b'],1,1,2,397111,1,,,,1513
e902c5c9c14fbe4c6a9eb6444c00b6fc90a4be9b,1,Madhan Neethiraj,2014-11-18 13:54:18-08:00,['526345bdb3a76cbb2c8a8a22e3d5cfd7a18ecf6e'],7,8,15,397126,1,0,0,1,1513
cd0bfd917725aac882fe0941f927fcdd9c545385,1,Madhan Neethiraj,2014-11-19 14:02:29-08:00,['e902c5c9c14fbe4c6a9eb6444c00b6fc90a4be9b'],9,11,20,397146,1,,,,1513
b2d1002bc854cf7da84c45053d5b3270f09bd09b,1,rmani,2014-11-24 12:49:13-08:00,['cd0bfd917725aac882fe0941f927fcdd9c545385'],2,251,253,397399,5,0.625,1,0.8,1515
76f7c29442eb62e3a08d765738c24bf9e7cfe49f,0,rmani,2014-11-24 21:14:23-08:00,['b2d1002bc854cf7da84c45053d5b3270f09bd09b'],0,19,19,397418,1,,,,1515
28a401f426ea4806d2346b5cbad21a78686b3226,1,sneethiraj,2014-11-26 21:53:49-05:00,['76f7c29442eb62e3a08d765738c24bf9e7cfe49f'],0,1310,1310,398728,11,,,,1526
80ec0732a5eb1f568e862d60ba378f40aa0ddb25,1,sneethiraj,2014-11-29 10:49:53-05:00,['28a401f426ea4806d2346b5cbad21a78686b3226'],2,3,5,398733,2,,,,1527
78940677b50dea8565a4d461633e0a05132c1e94,1,sneethiraj,2014-12-03 14:01:46-05:00,['80ec0732a5eb1f568e862d60ba378f40aa0ddb25'],62,89,151,398884,9,0,0,0,1527
326b8a0bfb1cf243d8dd89ce2471db71dc1a37c0,0,sneethiraj,2014-12-03 14:02:58-05:00,['78940677b50dea8565a4d461633e0a05132c1e94'],0,17,17,398901,2,,,,1527
96d7fb48e04e3cabb8bd283e27626007bde1453e,1,sneethiraj,2014-12-07 10:57:15-05:00,['326b8a0bfb1cf243d8dd89ce2471db71dc1a37c0'],0,3,3,398904,1,,,,1527
7fc7c9f27f931c3c260f66cc967c7d1ae983954c,1,sneethiraj,2014-12-08 07:46:55-05:00,['96d7fb48e04e3cabb8bd283e27626007bde1453e'],3,3,6,398910,2,1,1,0,1527
351e26fa45f12f31d6a73e26973dc31d3cf39e03,1,sneethiraj,2014-12-09 18:47:19-05:00,['7fc7c9f27f931c3c260f66cc967c7d1ae983954c'],10,122,132,399042,3,0.260869565,0.260869565,1,1528
459d57a55f1461fe987bd957ceb4f0f876207589,0,sneethiraj,2014-12-09 20:08:48-05:00,['351e26fa45f12f31d6a73e26973dc31d3cf39e03'],34,1,35,399077,2,,,,1528
830fe61cdd52807a0b89278ff4552fb6472b9e47,0,sneethiraj,2014-12-10 08:44:19-05:00,['459d57a55f1461fe987bd957ceb4f0f876207589'],0,18,18,399095,1,,,,1528
413fcb68f0368b35b2b0bc3c71bb8e71af6704ed,1,Madhan Neethiraj,2014-12-11 17:22:43-08:00,['830fe61cdd52807a0b89278ff4552fb6472b9e47'],2605,2421,5026,404121,434,,,,1530
ef7b11da4ba565f9171f97eeaca8fb91b0b9c019,1,sneethiraj,2014-12-11 20:53:33-05:00,['413fcb68f0368b35b2b0bc3c71bb8e71af6704ed'],72,77,149,404270,2,,,,1530
06ca85385867ab4274afa0852268e0875c814d17,1,Madhan Neethiraj,2014-12-15 18:43:44-08:00,['ef7b11da4ba565f9171f97eeaca8fb91b0b9c019'],1261,1318,2579,406849,186,,,,1530
e99d911dc94fd70ad46e6c2e5568aa64d9eb1bab,1,Madhan Neethiraj,2014-12-18 14:47:56-08:00,['06ca85385867ab4274afa0852268e0875c814d17'],0,4850,4850,411699,26,0.616659584,0.7280068,0.936676583,1554
941ae6924e610bf44d9ccddca52e3f21f82310e1,1,Madhan Neethiraj,2014-12-18 14:51:10-08:00,['e99d911dc94fd70ad46e6c2e5568aa64d9eb1bab'],0,1036,1036,412735,2,0.52724359,0.72275641,0.985576923,1556
a0d23c776c246ef9c1c7a530fe14585ad9785777,1,Madhan Neethiraj,2014-12-19 14:43:16-08:00,['06ca85385867ab4274afa0852268e0875c814d17'],1407,104,1511,414246,8,0.680904523,0.390703518,0.115577889,1556
2242c44183f2ecb1a631db9d7b483119d59e7c3c,1,Madhan Neethiraj,2014-12-19 17:24:01-08:00,['941ae6924e610bf44d9ccddca52e3f21f82310e1'],80,171,251,414497,6,0.634615385,0.942307692,0.557692308,1557
2203ffbeb756e63781c7806edcdada28ea415817,1,rmani,2014-12-19 23:40:07-08:00,['a0d23c776c246ef9c1c7a530fe14585ad9785777'],92,538,630,415127,10,0.701570681,0.717277487,1,1561
565351c4cba0f4b2185fda26b8f958ef8df996cd,1,Madhan Neethiraj,2014-12-20 13:45:17-08:00,['2242c44183f2ecb1a631db9d7b483119d59e7c3c'],13,329,342,415469,9,0.184713376,0.197452229,0.987261146,1564
8a9ebff14736fa6c0e8b13c27afeec87d4d40b63,0,Don Bosco Durai,2014-12-30 21:55:42-08:00,['a0d23c776c246ef9c1c7a530fe14585ad9785777'],1,1,2,415471,1,,,,1564
97d8d80361c0b6db22ceca6832e826f22dc3edb3,1,Don Bosco Durai,2014-12-30 22:10:03-08:00,['8a9ebff14736fa6c0e8b13c27afeec87d4d40b63'],10,9,19,415490,6,,,,1564
580f2c7fe7ff697833449886d6ada170bf70829f,1,Madhan Neethiraj,2014-12-31 01:27:46-08:00,['565351c4cba0f4b2185fda26b8f958ef8df996cd'],321,1297,1618,417108,18,0.526819923,0.616858238,0.9348659,1570
d4a79f50c23232a570cdccb15ef4cc658a6d248b,1,Madhan Neethiraj,2015-01-01 23:58:22-08:00,['580f2c7fe7ff697833449886d6ada170bf70829f'],87,159,246,417354,4,0,0.113636364,1,1570
c0abd84c533651fc3728a7933ecfd760cb8507e6,1,Madhan Neethiraj,2015-01-02 18:43:01-08:00,['d4a79f50c23232a570cdccb15ef4cc658a6d248b'],120,87,207,417561,5,0.729166667,0.0625,0,1571
63923bf6d51dcb135fc2a1edfe06b2af702d8cb6,1,Madhan Neethiraj,2015-01-04 14:16:47-08:00,['c0abd84c533651fc3728a7933ecfd760cb8507e6'],136,267,403,417964,16,1,0.821428571,0.607142857,1573
3106b1122b816c0cc458f0ff14957fc6f1b541da,1,Madhan Neethiraj,2015-01-04 22:28:01-08:00,['63923bf6d51dcb135fc2a1edfe06b2af702d8cb6'],31,261,292,418256,4,1,0.4,1,1573
1d0c14908e9a1c4e8ceb5f27dcd7e7392f3f06bc,0,rmani,2015-01-05 00:02:56-08:00,['2203ffbeb756e63781c7806edcdada28ea415817'],72,118,190,418446,1,0.333333333,1,1,1573
29747dcd6eedb117ccfcdb18835a2d6eda3ddeff,1,Madhan Neethiraj,2015-01-05 13:58:58-08:00,['3106b1122b816c0cc458f0ff14957fc6f1b541da'],184,316,500,418946,7,0.548387097,0.258064516,1,1573
3326e1cd0c6b3a8a87964cb7ede68bbbb853e6bb,0,rmani,2015-01-05 16:52:57-08:00,"['1d0c14908e9a1c4e8ceb5f27dcd7e7392f3f06bc', '97d8d80361c0b6db22ceca6832e826f22dc3edb3']",11,10,21,418967,7,,,,1573
4701f98c513efb73f8cfecd47bf209b31fe9c568,1,Madhan Neethiraj,2015-01-05 19:49:18-08:00,['29747dcd6eedb117ccfcdb18835a2d6eda3ddeff'],44,88,132,419099,14,0.19047619,0.19047619,1,1573
7771e7efbbb71198f88974022d18117b2872a669,1,Madhan Neethiraj,2015-01-05 22:06:13-08:00,['4701f98c513efb73f8cfecd47bf209b31fe9c568'],85,115,200,419299,12,1,1,0,1573
0f177a62c5a5fe8d48266a6c2e21a8b554ba2089,1,Madhan Neethiraj,2015-01-05 23:45:09-08:00,['7771e7efbbb71198f88974022d18117b2872a669'],219,4993,5212,424511,47,0.694837476,0.869216061,0.97208413,1608
121e577ee17c34d8ab7a7fa7a2518d2e8038f37b,0,Madhan Neethiraj,2015-01-06 10:31:02-08:00,['0f177a62c5a5fe8d48266a6c2e21a8b554ba2089'],21,62,83,424594,12,,,,1609
02063004ef5c83190b3c6efa94f36ebcba09af7c,0,Don Bosco Durai,2015-01-06 12:46:27-08:00,['3326e1cd0c6b3a8a87964cb7ede68bbbb853e6bb'],2,8,10,424604,2,,,,1609
66b1f95d55926ef1788107192c65a1eef9a04abb,0,Madhan Neethiraj,2015-01-07 10:35:00-08:00,['121e577ee17c34d8ab7a7fa7a2518d2e8038f37b'],1810,707,2517,427121,33,0.027303754,0,0.197952218,1610
a93e31c898b74a2a0ef5c902c3babe309d1a7f03,1,Madhan Neethiraj,2015-01-07 11:18:36-08:00,['02063004ef5c83190b3c6efa94f36ebcba09af7c'],0,4850,4850,431971,26,0.616659584,0.7280068,0.936676583,1634
ccdeb2874b4b884dcf0eab4dca752b93cea2e868,1,Madhan Neethiraj,2015-01-07 11:18:37-08:00,['a93e31c898b74a2a0ef5c902c3babe309d1a7f03'],0,1036,1036,433007,2,0.52724359,0.72275641,0.985576923,1636
033e4eca4b418b897ecd437f655c2e56f4e72c66,1,Madhan Neethiraj,2015-01-07 11:18:37-08:00,['ccdeb2874b4b884dcf0eab4dca752b93cea2e868'],80,171,251,433258,6,0.634615385,0.942307692,0.557692308,1637
8928c2e59ffc7881cea588c66188d7e9a88243d3,1,Madhan Neethiraj,2015-01-07 11:18:37-08:00,['033e4eca4b418b897ecd437f655c2e56f4e72c66'],13,329,342,433600,9,0.184713376,0.197452229,0.987261146,1640
59417d3944d697a8a4c8f7e8382c7a5655e9e757,1,Madhan Neethiraj,2015-01-07 11:18:37-08:00,['8928c2e59ffc7881cea588c66188d7e9a88243d3'],321,1297,1618,435218,18,0.526819923,0.616858238,0.9348659,1646
3c52e0ed8a29fcdbb9d7c8e145a0a42580e20a29,1,Madhan Neethiraj,2015-01-07 11:18:37-08:00,['59417d3944d697a8a4c8f7e8382c7a5655e9e757'],87,159,246,435464,4,0,0.113636364,1,1646
3cfe45b75ffa99079c547c193e58ed2a689d9103,1,Madhan Neethiraj,2015-01-07 11:18:37-08:00,['3c52e0ed8a29fcdbb9d7c8e145a0a42580e20a29'],120,87,207,435671,5,0.729166667,0.0625,0,1647
3c9397154cc2de8682b6ae4cee90c1afedb37c0e,1,Madhan Neethiraj,2015-01-07 11:18:37-08:00,['3cfe45b75ffa99079c547c193e58ed2a689d9103'],136,267,403,436074,16,1,0.821428571,0.607142857,1649
006f2702dd7fe01ab5afb6bce81de4b2b03671f3,1,Madhan Neethiraj,2015-01-07 11:18:37-08:00,['3c9397154cc2de8682b6ae4cee90c1afedb37c0e'],31,261,292,436366,4,1,0.4,1,1649
f30911e09dd59de4383c115ccdce737d9acbf137,1,Madhan Neethiraj,2015-01-07 11:18:37-08:00,['006f2702dd7fe01ab5afb6bce81de4b2b03671f3'],184,316,500,436866,7,0.548387097,0.258064516,1,1649
09fdd96d18f1f1e74332d054f58aec9dbcf180d9,1,Madhan Neethiraj,2015-01-07 11:18:37-08:00,['f30911e09dd59de4383c115ccdce737d9acbf137'],44,88,132,436998,14,0.19047619,0.19047619,1,1649
418b0fa16788092f5e2ee4dc86c03574aca89e5f,1,Madhan Neethiraj,2015-01-07 11:18:37-08:00,['09fdd96d18f1f1e74332d054f58aec9dbcf180d9'],85,115,200,437198,12,1,1,0,1649
9d85cb76a05f1e1bf57039047dc710b1034c059e,1,Madhan Neethiraj,2015-01-07 11:18:37-08:00,['418b0fa16788092f5e2ee4dc86c03574aca89e5f'],219,4993,5212,442410,47,0.694837476,0.869216061,0.97208413,1684
665af618acf6d44d3b34f784a95e3c9e437eca68,1,Madhan Neethiraj,2015-01-07 11:18:37-08:00,['9d85cb76a05f1e1bf57039047dc710b1034c059e'],21,62,83,442493,12,,,,1685
2b00241aaf7e46dd77439593afb47c9d1595b072,1,Madhan Neethiraj,2015-01-07 11:18:37-08:00,['665af618acf6d44d3b34f784a95e3c9e437eca68'],1810,707,2517,445010,33,0.027303754,0,0.197952218,1686
6ac2708b51602ea32bf1f35fe4221494743059ee,0,Madhan Neethiraj,2015-01-07 11:31:16-08:00,"['2b00241aaf7e46dd77439593afb47c9d1595b072', '66b1f95d55926ef1788107192c65a1eef9a04abb']",0,0,0,445010,0,,,,1686
21152a57cda53d064d86ae79b19ca2d53f8ab7fb,0,rmani,2015-01-07 15:22:56-08:00,['02063004ef5c83190b3c6efa94f36ebcba09af7c'],59,89,148,445158,5,1,0,1,1686
bd8c234c3155559101a89576714b78e6f6fefea4,1,Madhan Neethiraj,2015-01-07 17:42:57-08:00,['6ac2708b51602ea32bf1f35fe4221494743059ee'],42,295,337,445495,12,0.336956522,0.347826087,0.739130435,1686
83ef5e8644216c00648f23ba11509026675809e2,0,Madhan Neethiraj,2015-01-07 22:11:34-08:00,['bd8c234c3155559101a89576714b78e6f6fefea4'],50,0,50,445545,1,0,0,0,1686
23da1956e39b2b56236d93ebe27a16bad5cc1653,0,Madhan Neethiraj,2015-01-07 22:12:13-08:00,['83ef5e8644216c00648f23ba11509026675809e2'],1,0,1,445546,1,,,,1686
1f458f00f57c0e118a5822353795b2ef874a210d,1,Madhan Neethiraj,2015-01-08 00:50:15-08:00,['23da1956e39b2b56236d93ebe27a16bad5cc1653'],233,206,439,445985,13,0.459854015,0.737226277,0,1687
e8b58a91306be000894f6f4a7b0d98bdd5e3b6fb,1,Madhan Neethiraj,2015-01-08 00:53:58-08:00,['bd8c234c3155559101a89576714b78e6f6fefea4'],236,370,606,446591,13,1,1,0.260869565,1687
7d00538b372442f663c06177d19ce0e6346ea69c,0,Madhan Neethiraj,2015-01-08 00:54:39-08:00,"['e8b58a91306be000894f6f4a7b0d98bdd5e3b6fb', '1f458f00f57c0e118a5822353795b2ef874a210d']",283,206,489,447080,14,,,,1687
ef152319198af7689ebf8838e90a5c7fa8a0dbd4,0,rmani,2015-01-08 11:45:39-08:00,['21152a57cda53d064d86ae79b19ca2d53f8ab7fb'],10,23,33,447113,2,1,1,0,1687
7a87f4d6c28149f4e306ddbf04c506e2a33405c7,1,Madhan Neethiraj,2015-01-08 13:05:59-08:00,['7d00538b372442f663c06177d19ce0e6346ea69c'],179,216,395,447508,6,0,0,0.965517241,1687
82400d2b60563bd143b3e795b636d8d401fc10a9,1,Madhan Neethiraj,2015-01-08 16:55:19-08:00,['7a87f4d6c28149f4e306ddbf04c506e2a33405c7'],21,279,300,447808,6,0,0.205479452,1,1688
ee9ecde98fc38be97ea100cd5227b945e7ed0f57,1,Madhan Neethiraj,2015-01-09 09:59:36-08:00,['82400d2b60563bd143b3e795b636d8d401fc10a9'],13,173,186,447994,4,0.538461538,0.538461538,1,1689
cc5e3f71491d749dc0200f7c01c5827d8a5de073,1,Madhan Neethiraj,2015-01-09 17:42:29-08:00,['ee9ecde98fc38be97ea100cd5227b945e7ed0f57'],482,238,720,448714,10,0,0,0,1691
f49cac435d7cac126666ef9c60180274b365fd32,1,Madhan Neethiraj,2015-01-10 00:07:03-08:00,['cc5e3f71491d749dc0200f7c01c5827d8a5de073'],0,184,184,448898,3,1,1,1,1694
50c639ab13eb4718466cc8dc1a75cd795de14774,1,Madhan Neethiraj,2015-01-13 15:21:25-08:00,['f49cac435d7cac126666ef9c60180274b365fd32'],621,1075,1696,450594,14,0.313953488,0.600775194,0.934108527,1697
ea89bb5f4aa5e8a92c7e2bfb04d694195c78f42d,1,Madhan Neethiraj,2015-01-13 16:21:30-08:00,['50c639ab13eb4718466cc8dc1a75cd795de14774'],48,48,96,450690,2,1,1,1,1697
81cfaef6d7c3e2a5c63c56e36dab0381788c08be,1,Madhan Neethiraj,2015-01-13 17:33:20-08:00,['ea89bb5f4aa5e8a92c7e2bfb04d694195c78f42d'],353,416,769,451459,18,0.415254237,0.669491525,0.991525424,1697
fbe800a16d9df250a11dfbb4459d22aa865db14e,1,Madhan Neethiraj,2015-01-14 20:35:27-08:00,['81cfaef6d7c3e2a5c63c56e36dab0381788c08be'],1332,105,1437,452896,12,0.43615495,0.153515065,0,1697
87fffe02e0e12b58d1e731b6f0b46c4375f1d281,1,Madhan Neethiraj,2015-01-15 23:31:55-08:00,['fbe800a16d9df250a11dfbb4459d22aa865db14e'],158,1188,1346,454242,12,0.218905473,0.71973466,1,1699
e551d589bcaf04324d5dcf53bbb83b06c8e572f5,1,Madhan Neethiraj,2015-01-16 07:51:50-08:00,['87fffe02e0e12b58d1e731b6f0b46c4375f1d281'],1449,183,1632,455874,21,0.290277778,0.088888889,0,1700
eb271129c4d868b12fb9e13d1ae59d56036b884e,1,Madhan Neethiraj,2015-01-16 13:54:17-08:00,['e551d589bcaf04324d5dcf53bbb83b06c8e572f5'],219,329,548,456422,7,0.733333333,0.133333333,0.833333333,1702
b4d1bca6c2f998085d32fea4b0f5599f95c7fca7,0,Madhan Neethiraj,2015-01-16 16:09:31-08:00,"['eb271129c4d868b12fb9e13d1ae59d56036b884e', 'ef152319198af7689ebf8838e90a5c7fa8a0dbd4']",59,102,161,456583,5,,,,1702
da58bb09b678f5727cf3abfd2012cde798bce38b,1,sneethiraj,2015-01-19 00:18:48-05:00,['ef152319198af7689ebf8838e90a5c7fa8a0dbd4'],11,252,263,456846,5,,,,1702
765266e6529c79ba40f510339721e249c7230a8e,0,sneethiraj,2015-01-19 02:13:22-05:00,['da58bb09b678f5727cf3abfd2012cde798bce38b'],2,0,2,456848,1,,,,1702
8a0dab306bd4f3166e4a71dd79269d7d7c3e0479,1,Madhan Neethiraj,2015-01-19 23:07:48-08:00,['b4d1bca6c2f998085d32fea4b0f5599f95c7fca7'],0,3,3,456851,1,,,,1702
9a81396ab5c67ee5a12c4902f91c709dd04470df,0,Madhan Neethiraj,2015-01-19 23:08:57-08:00,"['8a0dab306bd4f3166e4a71dd79269d7d7c3e0479', '765266e6529c79ba40f510339721e249c7230a8e']",11,250,261,457112,5,,,,1702
31db54702abeb2443b04255c1c36599bdca89b3a,1,Madhan Neethiraj,2015-01-19 23:55:04-08:00,['9a81396ab5c67ee5a12c4902f91c709dd04470df'],0,5,5,457117,1,,,,1702
0d7f8dea8a507c602d860e39d6d94738bbbc3a54,1,Madhan Neethiraj,2015-01-20 09:06:32-08:00,['31db54702abeb2443b04255c1c36599bdca89b3a'],10,183,193,457310,6,0.771929825,0.815789474,1,1702
1e590f35d1761804f077da03dab0cd1d8eacde5d,1,Madhan Neethiraj,2015-01-20 13:44:15-08:00,['0d7f8dea8a507c602d860e39d6d94738bbbc3a54'],51,53,104,457414,2,0.058823529,1,1,1702
3493c02f3aab82ffdad52d65f8cfa9b01476c9f7,0,Madhan Neethiraj,2015-01-20 16:01:11-08:00,['1e590f35d1761804f077da03dab0cd1d8eacde5d'],25,4,29,457443,2,0.272727273,0.272727273,0.454545455,1702
84382d38779b40b1e30e0dde6fe0559d2e975c99,1,Madhan Neethiraj,2015-01-20 23:48:16-08:00,['3493c02f3aab82ffdad52d65f8cfa9b01476c9f7'],299,228,527,457970,3,0.459459459,0,1,1702
55c260923b571ae29c7d92641fe8ac59b73a1b9d,1,Madhan Neethiraj,2015-01-21 19:21:43-08:00,['84382d38779b40b1e30e0dde6fe0559d2e975c99'],55,72,127,458097,8,0.888888889,0.888888889,0.555555556,1702
814404a97d4651757426cda6b76dd05397f47acb,1,Madhan Neethiraj,2015-01-21 21:28:35-08:00,['55c260923b571ae29c7d92641fe8ac59b73a1b9d'],0,121,121,458218,5,0.848484848,0.383838384,1,1702
78cc53a11a5c987e9c9533f0b421cdb68f4e52b9,1,Dilli Dorai Arumugam,2015-01-22 06:47:26-08:00,['765266e6529c79ba40f510339721e249c7230a8e'],84,367,451,458669,2,0.494897959,0.423469388,1,1702
6f06c8cdad58603d2a3a1b90f379f24ac8177070,1,Madhan Neethiraj,2015-01-22 18:18:37-08:00,['814404a97d4651757426cda6b76dd05397f47acb'],12,11,23,458692,6,,,,1702
2ca971756db6ff2a1c812dcab527ff79968122e5,0,Madhan Neethiraj,2015-01-22 18:21:08-08:00,['6f06c8cdad58603d2a3a1b90f379f24ac8177070'],45,2,47,458739,1,1,1,0,1702
6a803eaa1a569753974e2c550a58fa1c2cf7e443,1,Madhan Neethiraj,2015-01-22 18:31:53-08:00,['2ca971756db6ff2a1c812dcab527ff79968122e5'],220,265,485,459224,8,1,1,1,1702
1e8dc41a82e2217a5c10a67c8f6bb58b6e06342e,1,Madhan Neethiraj,2015-01-22 18:50:58-08:00,['6a803eaa1a569753974e2c550a58fa1c2cf7e443'],1,2,3,459227,1,0,0,1,1702
615e2c52ea0835152a57da7732960af3ba43bec5,1,Madhan Neethiraj,2015-01-23 01:22:20-08:00,['1e8dc41a82e2217a5c10a67c8f6bb58b6e06342e'],51,126,177,459404,5,1,1,1,1702
7c4ff133b6329c711ce2be093814f09a32d45f4f,1,Madhan Neethiraj,2015-01-25 00:41:03-08:00,['615e2c52ea0835152a57da7732960af3ba43bec5'],112,110,222,459626,8,0,0,0,1702
8d0378c567aac7701d388c6be96c6e5794bb9a52,1,Madhan Neethiraj,2015-01-26 01:03:19-08:00,['7c4ff133b6329c711ce2be093814f09a32d45f4f'],16,37,53,459679,6,1,1,1,1702
ce1808afe7e904b0d3f3da9fea762e5102f178e7,0,Madhan Neethiraj,2015-01-26 16:03:02-08:00,['8d0378c567aac7701d388c6be96c6e5794bb9a52'],1278,0,1278,460957,6,0.725782414,0.338301043,0.202682563,1702
57ded063dee603767d06af2e9d6bcd442af564a2,1,Madhan Neethiraj,2015-01-26 16:07:31-08:00,['ce1808afe7e904b0d3f3da9fea762e5102f178e7'],13,36,49,461006,4,0.583333333,0.583333333,1,1702
5a50f5fb03581fa99577076c60ae9edadc9ef476,1,Madhan Neethiraj,2015-01-26 16:08:54-08:00,['57ded063dee603767d06af2e9d6bcd442af564a2'],27,23,50,461056,1,0,0,0,1702
7758ed1cabb2052d1d212bd3f118036dd2f89efb,1,Madhan Neethiraj,2015-01-26 17:56:07-08:00,['5a50f5fb03581fa99577076c60ae9edadc9ef476'],1571,722,2293,463349,17,0.819512195,0.460162602,0.455284553,1705
d7bf8e09de7c047e3f566c5ce3955ac3a25ab6fe,1,Madhan Neethiraj,2015-01-26 17:57:32-08:00,['7758ed1cabb2052d1d212bd3f118036dd2f89efb'],7,3,10,463359,1,1,1,0,1705
4130d7a5c4418376ab2942f95b6de43ef9976d2f,1,Madhan Neethiraj,2015-01-27 10:47:16-08:00,['d7bf8e09de7c047e3f566c5ce3955ac3a25ab6fe'],27,45,72,463431,5,1,1,0.5,1705
6781cc9c4593b22cc3b497f46b7be8ec7bfaabd6,1,sneethiraj,2015-01-27 21:32:12-05:00,['78cc53a11a5c987e9c9533f0b421cdb68f4e52b9'],1,1954,1955,465386,10,0.174791914,0.322235434,0.892984542,1713
286acf6d27be73a2993e5f8ff0b1347b13f11840,1,Madhan Neethiraj,2015-01-28 08:56:24-08:00,['4130d7a5c4418376ab2942f95b6de43ef9976d2f'],7375,230,7605,472991,33,0.287196416,0.193822212,0.064135817,1713
23f2a09f05d13dfb1a18eaf2e95640ed046cbf1b,0,Madhan Neethiraj,2015-01-28 09:03:26-08:00,"['286acf6d27be73a2993e5f8ff0b1347b13f11840', '6781cc9c4593b22cc3b497f46b7be8ec7bfaabd6']",85,2321,2406,475397,12,,,,1713
67dbdc45ad85a6dbccc8a6dd83ebfd43f881b08b,1,Madhan Neethiraj,2015-01-28 14:19:54-08:00,['23f2a09f05d13dfb1a18eaf2e95640ed046cbf1b'],70,70,140,475537,5,,,,1713
df0fcd4c342d0ddb0fbce5f6f9ea07c0cb4179ce,0,Dilli Dorai Arumugam,2015-01-28 14:26:12-08:00,['6781cc9c4593b22cc3b497f46b7be8ec7bfaabd6'],6,158,164,475701,4,,,,1713
91405dc5d92b689ef1fe24ebe579282af8695210,0,Dilli Dorai Arumugam,2015-01-28 14:51:57-08:00,['df0fcd4c342d0ddb0fbce5f6f9ea07c0cb4179ce'],3,6,9,475710,1,,,,1713
1201f2e3f06693f5c8cc115835020a9dbf185c20,1,Madhan Neethiraj,2015-01-28 20:44:25-08:00,['67dbdc45ad85a6dbccc8a6dd83ebfd43f881b08b'],476,254,730,476440,14,0.355072464,0.710144928,0,1713
c68e226893ff5e434d8e81be483a18b4abb4b046,0,sneethiraj,2015-01-29 09:35:27-05:00,['91405dc5d92b689ef1fe24ebe579282af8695210'],0,1,1,476441,1,,,,1713
25517f0b1ff57e2da4a0844f4559390508ecb57e,1,sneethiraj,2015-01-29 15:48:46-05:00,['c68e226893ff5e434d8e81be483a18b4abb4b046'],17,19,36,476477,13,,,,1713
ff4a817e592f423d0b248bacf4823eafdddff766,1,Madhan Neethiraj,2015-01-29 18:25:26-08:00,['1201f2e3f06693f5c8cc115835020a9dbf185c20'],273,756,1029,477506,11,0.012121212,0.160606061,0.996969697,1713
188b7b62cbbec5f84201efd7fdd814d87c17f728,1,Madhan Neethiraj,2015-01-30 08:55:07-08:00,['ff4a817e592f423d0b248bacf4823eafdddff766'],64,153,217,477723,6,1,1,1,1714
c3a336ea20178081165bab212cf6e03bb330ce20,1,Madhan Neethiraj,2015-01-30 13:01:41-08:00,['188b7b62cbbec5f84201efd7fdd814d87c17f728'],391,631,1022,478745,7,0.347826087,0.461956522,1,1714
9784f5343fa710c3b9199b58e7e221b5739a20a4,1,Madhan Neethiraj,2015-01-30 16:22:56-08:00,['c3a336ea20178081165bab212cf6e03bb330ce20'],234,227,461,479206,10,0,0.517241379,0.068965517,1714
1d6a2590f850248d20065e2b3a58ed8bc86b9e95,1,Madhan Neethiraj,2015-01-31 00:37:29-08:00,['9784f5343fa710c3b9199b58e7e221b5739a20a4'],2106,697,2803,482009,40,0.411161731,0.482915718,0.437357631,1714
46633a9ed2ed3499e95ad87409ce5b0460929da7,1,Madhan Neethiraj,2015-01-31 00:42:21-08:00,['1d6a2590f850248d20065e2b3a58ed8bc86b9e95'],0,1559,1559,483568,16,0.613559322,0.755932203,0.974576271,1730
217e18924017500a0871b2a7cb47d2095960b8cf,1,Madhan Neethiraj,2015-01-31 12:38:28-08:00,['46633a9ed2ed3499e95ad87409ce5b0460929da7'],32,22,54,483622,58,,,,1731
447658578decf33d2b68d872a32db59227dfef1b,1,rmani,2015-02-01 12:41:35-08:00,['217e18924017500a0871b2a7cb47d2095960b8cf'],4,1995,1999,485621,18,0.353647276,0.558633426,0.771006464,1746
adbc5e88a13840d8132ed5b5fabf0a4b02468f95,1,sneethiraj,2015-02-03 00:31:47-05:00,['25517f0b1ff57e2da4a0844f4559390508ecb57e'],220,724,944,486565,20,1,1,1,1754
2e486daa43bc219b430ccf73463d5fd65d3a0c79,1,Madhan Neethiraj,2015-02-03 15:57:00-08:00,['447658578decf33d2b68d872a32db59227dfef1b'],381,436,817,487382,27,0,0,0.9625,1757
fba0f8c4b89b301748533dac557846f2bc8b2c91,0,sneethiraj,2015-02-03 22:58:45-05:00,['adbc5e88a13840d8132ed5b5fabf0a4b02468f95'],14,19,33,487415,3,,,,1757
28c49b6dfc3f932aed4302092bdb81a7ba8cf644,1,sneethiraj,2015-02-03 23:33:18-05:00,['fba0f8c4b89b301748533dac557846f2bc8b2c91'],19,14,33,487448,3,,,,1757
163a6d0a5346623226ea3e463d55c9d2e535d1f9,1,sneethiraj,2015-02-03 23:37:14-05:00,['28c49b6dfc3f932aed4302092bdb81a7ba8cf644'],14,19,33,487481,3,,,,1757
2abad1a1913173b75c0ac0d4cce2f4ba10a72296,1,Madhan Neethiraj,2015-02-03 23:34:00-08:00,['2e486daa43bc219b430ccf73463d5fd65d3a0c79'],4,54,58,487539,1,0.913043478,1,0.913043478,1757
760e5f74d5c492664bd8f4f26a5d1f118be7fab5,0,Madhan Neethiraj,2015-02-04 08:52:13-08:00,"['2abad1a1913173b75c0ac0d4cce2f4ba10a72296', '163a6d0a5346623226ea3e463d55c9d2e535d1f9']",255,922,1177,488716,36,,,,1757
0b4363df72b1d3ea4c886d447c90fef507873e39,1,Madhan Neethiraj,2015-02-04 13:36:31-08:00,['760e5f74d5c492664bd8f4f26a5d1f118be7fab5'],1,17,18,488734,1,,,,1757
fda7b9fb3a6af60b321d5869ef433b7be4eb0096,0,Madhan Neethiraj,2015-02-04 16:52:07-08:00,['0b4363df72b1d3ea4c886d447c90fef507873e39'],4,4,8,488742,8,,,,1757
93e578d48bf5caa36097ca84b432312919be7884,1,Madhan Neethiraj,2015-02-04 23:54:16-08:00,['fda7b9fb3a6af60b321d5869ef433b7be4eb0096'],206,319,525,489267,11,0,0,1,1757
145fe6d6ef5b1e71498657031943aa1b728a1cb9,1,Madhan Neethiraj,2015-02-05 11:13:52-08:00,['93e578d48bf5caa36097ca84b432312919be7884'],28,43,71,489338,3,0.875,1,0,1757
1f0dccadf28fe86ae075abde8dbdf3426ce6e6d6,1,Madhan Neethiraj,2015-02-05 15:18:18-08:00,['145fe6d6ef5b1e71498657031943aa1b728a1cb9'],49,89,138,489476,8,0,0,0,1757
5c4b59af7e5f7ea9382d18566ff2835235f63375,1,Madhan Neethiraj,2015-02-05 15:33:39-08:00,['1f0dccadf28fe86ae075abde8dbdf3426ce6e6d6'],19,159,178,489654,5,0.166666667,0.615384615,0.820512821,1758
5d6881babb239108096542be1b051e2fc3266512,1,Madhan Neethiraj,2015-02-05 22:38:39-08:00,['5c4b59af7e5f7ea9382d18566ff2835235f63375'],15,174,189,489843,6,0.153846154,0.987179487,1,1759
45e335c8fb4aeb0ee922ca7c669c86d3d1324e02,1,Madhan Neethiraj,2015-02-06 17:45:08-08:00,['163a6d0a5346623226ea3e463d55c9d2e535d1f9'],1,22,23,489866,2,1,1,1,1759
4e121ea0da3f846d65abc8d1c79396f32de28406,1,Madhan Neethiraj,2015-02-08 14:26:58-08:00,['5d6881babb239108096542be1b051e2fc3266512'],660,1041,1701,491567,19,0.341836735,0.135204082,0.275510204,1760
6edf6d8686c3e8078ca7b95f96affa6b25e8dc2c,1,Madhan Neethiraj,2015-02-08 15:24:02-08:00,['4e121ea0da3f846d65abc8d1c79396f32de28406'],296,1015,1311,492878,23,0.255421687,0.559036145,1,1765
63952722220d2ffc6f55e6cebe23f09a7a5960f4,1,Madhan Neethiraj,2015-02-09 07:58:16-08:00,['6edf6d8686c3e8078ca7b95f96affa6b25e8dc2c'],50,210,260,493138,13,0.554545455,0.2,0.663636364,1765
4bef89c8ed558eaa7b6f99b7863684d6308caa55,1,Madhan Neethiraj,2015-02-09 16:11:53-08:00,['6edf6d8686c3e8078ca7b95f96affa6b25e8dc2c'],152,140,292,493430,20,1,1,1,1765
a10093bab9cdace0617f37eeeffbac798d9940b0,0,Madhan Neethiraj,2015-02-09 16:53:44-08:00,"['4bef89c8ed558eaa7b6f99b7863684d6308caa55', '63952722220d2ffc6f55e6cebe23f09a7a5960f4']",50,210,260,493690,13,,,,1765
a6f8050b54206dfa61d87a756d7434ec70131d88,0,Madhan Neethiraj,2015-02-09 17:31:46-08:00,['a10093bab9cdace0617f37eeeffbac798d9940b0'],58,0,58,493748,1,1,1,0,1765
8f386d15f7a77bce2a1c18cd46f31c40451a5b41,0,sneethiraj,2015-02-10 11:10:42-05:00,['45e335c8fb4aeb0ee922ca7c669c86d3d1324e02'],1,2,3,493751,1,,,,1765
b8ebee5b0924368dc131a1f0b78d1fd684e8cbda,1,Madhan Neethiraj,2015-02-10 17:07:50-08:00,['a6f8050b54206dfa61d87a756d7434ec70131d88'],279,470,749,494500,12,0,0,0.716535433,1765
575fc1b43e232849a257e76c4d5597bf1e9be157,0,sneethiraj,2015-02-10 22:41:51-05:00,['8f386d15f7a77bce2a1c18cd46f31c40451a5b41'],26,2,28,494528,3,,,,1767
0f3ace824a88e5b90d509646339deee961b87066,1,sneethiraj,2015-02-10 22:47:10-05:00,['575fc1b43e232849a257e76c4d5597bf1e9be157'],0,1891,1891,496419,11,0.171542553,0.35106383,0.941489362,1777
c4d066b6be26be7b1cc4c9a67b6dd7fae93f1fc2,1,Dilli Dorai Arumugam,2015-02-10 20:00:27-08:00,['a6f8050b54206dfa61d87a756d7434ec70131d88'],20,41,61,496480,4,0.928571429,1,0,1777
dc0b2c8ebce9b6ae54113be4484099d2d441d5a6,0,Madhan Neethiraj,2015-02-10 21:02:54-08:00,"['b8ebee5b0924368dc131a1f0b78d1fd684e8cbda', 'c4d066b6be26be7b1cc4c9a67b6dd7fae93f1fc2']",20,41,61,496541,4,,,,1777
7690db8292a8bb42f10fa2a8db4326f759a781a6,1,Madhan Neethiraj,2015-02-10 22:03:47-08:00,['dc0b2c8ebce9b6ae54113be4484099d2d441d5a6'],24,20,44,496585,1,1,0,0,1777
5a713177963989e6028e1918fd1c97e40c03023f,1,rmani,2015-02-10 22:18:11-08:00,['a6f8050b54206dfa61d87a756d7434ec70131d88'],77,3263,3340,499925,26,0.160316675,0.352300841,0.647204354,1795
3215fc1903c3a40bd648e4c234370643c1a1e1b0,0,rmani,2015-02-10 22:20:06-08:00,"['5a713177963989e6028e1918fd1c97e40c03023f', 'dc0b2c8ebce9b6ae54113be4484099d2d441d5a6']",299,511,810,500735,16,,,,1795
3565427b2ce9df1df14ef253416056083717c13a,0,Madhan Neethiraj,2015-02-11 09:36:45-08:00,"['7690db8292a8bb42f10fa2a8db4326f759a781a6', '3215fc1903c3a40bd648e4c234370643c1a1e1b0']",77,3263,3340,504075,26,,,,1795
7a6412dcd3e9799dd0fb9c7948fad5448664b896,1,Madhan Neethiraj,2015-02-11 18:37:43-08:00,['3565427b2ce9df1df14ef253416056083717c13a'],800,203,1003,505078,20,0.640816327,0.493877551,0.253061224,1798
89f7103cc40040b82862ff6faa30dfb5186e32bd,1,Madhan Neethiraj,2015-02-11 19:05:45-08:00,['7a6412dcd3e9799dd0fb9c7948fad5448664b896'],86,126,212,505290,10,0.381578947,0.973684211,1,1798
aa7edc1e99d19934b9918487db8c399c23692459,1,Madhan Neethiraj,2015-02-11 19:11:32-08:00,['89f7103cc40040b82862ff6faa30dfb5186e32bd'],1412,3,1415,506705,6,0.955555556,0.28115942,0.182608696,1798
604d3bb797c5e5ecfcc4ed8c62f4e614abf56a73,1,Madhan Neethiraj,2015-02-11 20:31:45-08:00,['aa7edc1e99d19934b9918487db8c399c23692459'],24,74,98,506803,7,0.854368932,0,0,1798
9f559d5fe955dc103792a5bd40caa7cb12d4c5c7,1,Madhan Neethiraj,2015-02-12 00:03:42-08:00,['604d3bb797c5e5ecfcc4ed8c62f4e614abf56a73'],225,466,691,507494,9,0.435897436,0.929487179,0.762820513,1798
091677bba0008d11fe6b5911b4320dec59eb5e9d,1,Madhan Neethiraj,2015-02-12 09:20:56-08:00,"['9f559d5fe955dc103792a5bd40caa7cb12d4c5c7', '0f3ace824a88e5b90d509646339deee961b87066']",3,1913,1916,509410,14,,,,1798
fb1a99a965294d8b0485c011221cbb1bc8d4d030,0,Madhan Neethiraj,2015-02-12 11:13:18-08:00,['091677bba0008d11fe6b5911b4320dec59eb5e9d'],2404,4,2408,511818,20,0.613389121,0.507112971,0.10376569,1798
432b4b11d632071bd69ae08fe00bc1d6be6bc84e,1,Madhan Neethiraj,2015-02-12 14:11:34-08:00,['fb1a99a965294d8b0485c011221cbb1bc8d4d030'],1,73,74,511892,6,,,,1800
a67360d26a350dcf2d59fa09ae48f42ca3ca3f95,1,rmani,2015-02-12 19:39:08-08:00,['432b4b11d632071bd69ae08fe00bc1d6be6bc84e'],0,688,688,512580,6,0.153266332,0.364321608,0.552763819,1806
30722773231fcbc6a624a108775fab52ed191594,1,Madhan Neethiraj,2015-02-13 09:33:14-08:00,['a67360d26a350dcf2d59fa09ae48f42ca3ca3f95'],7,548,555,513135,6,0.31496063,0.31496063,1,1806
c928a415951ffa46986e26a99ba38e52f285ee0d,1,Madhan Neethiraj,2015-02-13 09:34:13-08:00,['30722773231fcbc6a624a108775fab52ed191594'],0,9367,9367,522502,50,0.440686522,0.547450782,0.937405351,1856
d07c61ab691e7841bc0bf8e5bf0b9e054a445a92,0,rmani,2015-02-13 13:41:27-08:00,['a67360d26a350dcf2d59fa09ae48f42ca3ca3f95'],41,24,65,522567,4,0.111111111,0,0,1856
32af455bf1ca0b8b69de5eb7f020f3ed5a8407d8,0,rmani,2015-02-13 13:43:28-08:00,"['d07c61ab691e7841bc0bf8e5bf0b9e054a445a92', 'c928a415951ffa46986e26a99ba38e52f285ee0d']",7,9915,9922,532489,56,,,,1856
3471cc5806a614efe55422ae0756b9e20777a5f3,1,Madhan Neethiraj,2015-02-15 10:37:52-08:00,['32af455bf1ca0b8b69de5eb7f020f3ed5a8407d8'],89,287,376,532865,5,0.776595745,1,1,1857
f9791b46701de67d0f7adbe5b0b07d0e044b9a92,0,Madhan Neethiraj,2015-02-16 00:50:51-08:00,['3471cc5806a614efe55422ae0756b9e20777a5f3'],1,1,2,532867,1,,,,1857
63030e280257e909f84c1441d9060a9d7a6dcceb,0,sneethiraj,2015-02-17 11:17:05-05:00,['f9791b46701de67d0f7adbe5b0b07d0e044b9a92'],58,108,166,533033,5,0,0,1,1857
1283c965203472d562ef8dfe3fd03ac68fe0a407,0,rmani,2015-02-18 00:19:37-08:00,['63030e280257e909f84c1441d9060a9d7a6dcceb'],140,155,295,533328,4,1,1,1,1857
9c2f0d1fb722dfcc3155ee928f0ef2739a9cc79f,1,vel,2015-02-19 15:05:10-05:00,['1283c965203472d562ef8dfe3fd03ac68fe0a407'],343,1526,1869,535197,46,0.276699029,0.457928803,0.165048544,1861
8df90d467fac60e716599113b3994ef435d8dff4,1,Madhan Neethiraj,2015-02-21 02:27:54-08:00,['9c2f0d1fb722dfcc3155ee928f0ef2739a9cc79f'],230,835,1065,536262,24,0.621513944,0.637450199,1,1863
c11c7f2f8bbc7b3f2e9b2ab876d1dac255571485,1,Madhan Neethiraj,2015-02-21 03:06:41-08:00,['8df90d467fac60e716599113b3994ef435d8dff4'],0,12,12,536274,1,0,0,1,1863
02083dc06f1f4325c2bcc6f277c20ddfabae5109,1,Madhan Neethiraj,2015-02-21 08:31:06-08:00,['c11c7f2f8bbc7b3f2e9b2ab876d1dac255571485'],54,534,588,536862,17,0.602739726,0.431506849,0.979452055,1867
c59617d6f74df41316a59d65ed90c574527987de,1,Madhan Neethiraj,2015-02-21 09:22:21-08:00,['02083dc06f1f4325c2bcc6f277c20ddfabae5109'],73,95,168,537030,7,0.653846154,0.807692308,0.730769231,1867
788897211404666cbdbed19316cba65e3afacffa,1,Madhan Neethiraj,2015-02-21 09:22:51-08:00,['c59617d6f74df41316a59d65ed90c574527987de'],0,703,703,537733,5,0.244552058,0.515738499,0.973365617,1872
aedb1fc81a2eaaf2c9268e1a28c782f55a90fb45,0,vel,2015-02-22 13:06:54-08:00,['788897211404666cbdbed19316cba65e3afacffa'],979,1256,2235,539968,8,0.043956044,0.043956044,1,1872
084ff13e0851bc07bbd5422a299d6a1f55658d69,1,sneethiraj,2015-02-22 16:24:33-08:00,['aedb1fc81a2eaaf2c9268e1a28c782f55a90fb45'],4,951,955,540923,15,0.378378378,0.716216216,0.945945946,1885
fa1248a2a6074c6e6666b3d5675a8ff188076cad,0,rmani,2015-02-22 16:43:05-08:00,['aedb1fc81a2eaaf2c9268e1a28c782f55a90fb45'],1,8,9,540932,1,,,,1885
23518903c3604f70b684d1ccdf705085ab9dd525,0,sneethiraj,2015-02-22 16:45:45-08:00,"['084ff13e0851bc07bbd5422a299d6a1f55658d69', 'fa1248a2a6074c6e6666b3d5675a8ff188076cad']",1,8,9,540941,1,,,,1885
377eecbb7e85626fd547a7eec1322a53cb34effa,1,sneethiraj,2015-02-22 16:54:21-08:00,['23518903c3604f70b684d1ccdf705085ab9dd525'],7,20,27,540968,21,,,,1885
fc2cc55043e0ce34460861ec9613e022edf4752d,0,sneethiraj,2015-02-22 16:58:50-08:00,['377eecbb7e85626fd547a7eec1322a53cb34effa'],90,0,90,541058,14,,,,1885
873430ade78a6987973bed4eb5bb47c8fd2f4b43,0,sneethiraj,2015-02-22 17:04:03-08:00,['fc2cc55043e0ce34460861ec9613e022edf4752d'],267,0,267,541325,53,,,,1885
0be1d9897b2fe492872bdd301b75d50cbc038130,0,sneethiraj,2015-02-22 17:31:40-08:00,['873430ade78a6987973bed4eb5bb47c8fd2f4b43'],2,2,4,541329,1,,,,1885
b1f4daf8a3f6e37e07750bc0f0498ca1b92cc678,1,sneethiraj,2015-02-22 18:03:53-08:00,['0be1d9897b2fe492872bdd301b75d50cbc038130'],2,44,46,541375,3,1,1,1,1886
5580ca24d2b6bd76601571ab8f8e64bc40731c18,0,Madhan Neethiraj,2015-02-23 00:56:37-08:00,['b1f4daf8a3f6e37e07750bc0f0498ca1b92cc678'],0,3,3,541378,2,0,0,1,1886
c0bb7ecc6d8e0e28fe645314f87428cbccedbc70,1,Madhan Neethiraj,2015-02-23 01:59:19-08:00,['5580ca24d2b6bd76601571ab8f8e64bc40731c18'],83,1644,1727,543105,21,0,0.836956522,0.635869565,1902
60cae1a745cce961bc33c455fcba21e32739b31d,1,sneethiraj,2015-02-23 09:35:26-08:00,['5580ca24d2b6bd76601571ab8f8e64bc40731c18'],9,8,17,543122,1,1,1,0,1902
72934e061e40c1708efdc06551349cb2d9345051,1,Don Bosco Durai,2015-02-23 13:29:30-08:00,['60cae1a745cce961bc33c455fcba21e32739b31d'],2,193,195,543317,4,0.381818182,0.645454545,1,1903
a6b93f0e924ad8e0da090568e442f99618b77e0c,0,Don Bosco Durai,2015-02-23 14:24:11-08:00,['72934e061e40c1708efdc06551349cb2d9345051'],1,26,27,543344,1,0,0,1,1903
acefb0737bc25ad6cf2f23dc0c2fb7002837d84f,1,Madhan Neethiraj,2015-02-23 15:26:55-08:00,['a6b93f0e924ad8e0da090568e442f99618b77e0c'],102,767,869,544213,15,0.400560224,0.515406162,0.980392157,1907
6ac22dbb95e6c5679f0b2c7c4c19f39253915c11,0,Madhan Neethiraj,2015-02-23 15:40:51-08:00,['acefb0737bc25ad6cf2f23dc0c2fb7002837d84f'],1,1,2,544215,1,,,,1907
307d51c2da351f3e370d820fb8fdcda10d84a6a9,1,Madhan Neethiraj,2015-02-23 16:05:15-08:00,['c0bb7ecc6d8e0e28fe645314f87428cbccedbc70'],439,94,533,544748,8,0.4375,0.4375,0.5625,1907
86ba5853caaeee821f101b14dd70d8b6e1750427,0,Madhan Neethiraj,2015-02-23 16:05:20-08:00,"['307d51c2da351f3e370d820fb8fdcda10d84a6a9', '6ac22dbb95e6c5679f0b2c7c4c19f39253915c11']",114,994,1108,545856,21,,,,1907
aceff0e8ebedb490d8e4446fab8829a138fadd4b,0,Madhan Neethiraj,2015-02-24 23:47:59-08:00,['86ba5853caaeee821f101b14dd70d8b6e1750427'],1,0,1,545857,1,0,0,1,1907
3a57aa3c324b5d3580209cdf96cd19451ee5efd5,1,Madhan Neethiraj,2015-02-25 00:49:30-08:00,['aceff0e8ebedb490d8e4446fab8829a138fadd4b'],14,34,48,545905,3,0,0.384615385,1,1907
4dd6903450bc8097562bfb143f65d6f45a44185b,1,Madhan Neethiraj,2015-02-25 01:04:21-08:00,['3a57aa3c324b5d3580209cdf96cd19451ee5efd5'],256,396,652,546557,11,0.25,0.285714286,0.973214286,1907
a63bf0aaabd1be9094e0029bc0e50a7439733f9f,1,Madhan Neethiraj,2015-02-25 01:06:20-08:00,['4dd6903450bc8097562bfb143f65d6f45a44185b'],0,175,175,546732,3,1,1,1,1910
5f29db871e6536dc790f9717664b01bd55898974,0,sneethiraj,2015-02-25 13:52:40-08:00,['a63bf0aaabd1be9094e0029bc0e50a7439733f9f'],1,16,17,546749,1,0,1,1,1910
ab44b6508ecb1e9c286aedef59e3a9add23d6677,0,sneethiraj,2015-02-25 18:09:13-08:00,['5f29db871e6536dc790f9717664b01bd55898974'],1,32,33,546782,1,0.551724138,1,1,1910
641be5c0a4577c4f6b0af9dae434d93a7ec2f01f,1,sneethiraj,2015-02-27 08:53:44-08:00,['ab44b6508ecb1e9c286aedef59e3a9add23d6677'],17,18,35,546817,2,1,1,0.8,1910
62a3bd07a3fe59907001951759642107af8e692d,0,sneethiraj,2015-02-27 10:40:35-08:00,['641be5c0a4577c4f6b0af9dae434d93a7ec2f01f'],3568,0,3568,550385,14,,,,1910
839884094f35e5c08402b4fdcbb3ef2739a56851,1,sneethiraj,2015-02-27 10:51:44-08:00,['62a3bd07a3fe59907001951759642107af8e692d'],1155,279,1434,551819,9,0,0,0,1910
4a0d467d92e000fab5ba75ff9782cd433d8f4e2f,1,sneethiraj,2015-02-27 10:57:14-08:00,['839884094f35e5c08402b4fdcbb3ef2739a56851'],0,992,992,552811,2,,,,1912
78c61a601fb9ca93f9389b3b633e44f6594b6355,0,sneethiraj,2015-02-27 14:55:45-08:00,['4a0d467d92e000fab5ba75ff9782cd433d8f4e2f'],0,1,1,552812,1,,,,1912
210e236065547ae64c47ac61f47aa27b0e2752e0,1,Madhan Neethiraj,2015-03-01 18:56:09-08:00,['78c61a601fb9ca93f9389b3b633e44f6594b6355'],384,1629,2013,554825,14,0.467980296,0.911330049,0.921182266,1912
962ad52741f0fbff60ac2b89a1d84631cddec081,1,vel,2015-03-03 13:45:07-05:00,['210e236065547ae64c47ac61f47aa27b0e2752e0'],29,1277,1306,556131,12,0.514619883,0.918128655,0.081871345,1915
3df7c45d74320edaad562b388753edd2f21a35c5,1,Velmurugan Periasamy,2015-03-03 14:23:21-05:00,['962ad52741f0fbff60ac2b89a1d84631cddec081'],2,3025,3027,559158,12,0.578947368,0.907894737,0.092105263,1918
abea4ca39b52c4c5c8af2302f45011e8de828f51,1,Velmurugan Periasamy,2015-03-03 14:57:37-05:00,['3df7c45d74320edaad562b388753edd2f21a35c5'],5,2,7,559165,1,0,0,1,1918
054a973df9ff26ab01c0720792580b794d4927bb,1,rmani,2015-03-03 13:46:59-08:00,['abea4ca39b52c4c5c8af2302f45011e8de828f51'],142,122,264,559429,18,0,1,0,1918
d69fc28d2fbd5efe3741819cc8010e56ed5b9fa8,1,Madhan Neethiraj,2015-03-03 14:40:23-08:00,['054a973df9ff26ab01c0720792580b794d4927bb'],31,1217,1248,560677,15,0.441348974,0.590909091,0.988269795,1927
c45e1e72a8547b3605a78d19628973936397090e,1,Madhan Neethiraj,2015-03-03 16:43:53-08:00,['d69fc28d2fbd5efe3741819cc8010e56ed5b9fa8'],75,132,207,560884,8,0,0.032258065,0.193548387,1927
9b0c5a71919a62c1db8bbfcc1fc3086f1ee3d4a5,1,Velmurugan Periasamy,2015-03-04 09:48:42-05:00,['c45e1e72a8547b3605a78d19628973936397090e'],2,2,4,560888,1,,,,1927
cfc9ce3e9e6b5f61b9d82e769b484b8c3b713990,0,Velmurugan Periasamy,2015-03-04 09:57:55-05:00,['9b0c5a71919a62c1db8bbfcc1fc3086f1ee3d4a5'],7,12,19,560907,2,,,,1927
d4b50119ddc7a0c3e81cd8ff84ededb93737b1f3,0,Madhan Neethiraj,2015-03-04 11:06:56-08:00,['c45e1e72a8547b3605a78d19628973936397090e'],142,0,142,561049,6,0.567567568,0,0,1927
f1ae106af4c8ea1af48c98fc38071490d5cc4fab,1,sneethiraj,2015-03-04 15:17:11-05:00,['cfc9ce3e9e6b5f61b9d82e769b484b8c3b713990'],10,43,53,561102,2,0.272727273,1,1,1927
fa3e38c22f6401222d7f972498f1ce78cf30ad29,0,sneethiraj,2015-03-04 15:46:40-05:00,['f1ae106af4c8ea1af48c98fc38071490d5cc4fab'],2,3,5,561107,1,0,1,1,1927
9ee9b2c142c6e8a176f026ad3b8ff283fe5c9f0f,0,sneethiraj,2015-03-04 21:29:37-05:00,['fa3e38c22f6401222d7f972498f1ce78cf30ad29'],14,43,57,561164,3,0,0,1,1927
b8d94100f160810808378db216710192d35ae7ac,1,sneethiraj,2015-03-04 22:02:15-05:00,['9ee9b2c142c6e8a176f026ad3b8ff283fe5c9f0f'],4,77,81,561245,2,0.125,0.395833333,1,1927
7cd51c9d9cfa7b6abf5dc58131d8a616cc731050,0,Madhan Neethiraj,2015-03-04 21:22:48-08:00,"['d4b50119ddc7a0c3e81cd8ff84ededb93737b1f3', 'b8d94100f160810808378db216710192d35ae7ac']",37,178,215,561460,10,,,,1927
895ac2b194bc54853224001c5f7f483cd7e6e2d9,0,Dilli Dorai Arumugam,2015-03-05 18:14:47-08:00,['7cd51c9d9cfa7b6abf5dc58131d8a616cc731050'],2,2,4,561464,1,,,,1927
3aba2530211bfce6a5cd4bd373b8f7e50abe7fe5,0,Madhan Neethiraj,2015-03-07 10:47:23-08:00,['895ac2b194bc54853224001c5f7f483cd7e6e2d9'],78,47,125,561589,3,0.684210526,0,0,1927
7c161433bd1cc9dc39149e44abdfb70ef18555d7,1,Madhan Neethiraj,2015-03-08 20:31:19-07:00,['3aba2530211bfce6a5cd4bd373b8f7e50abe7fe5'],150,213,363,561952,3,0.975609756,1,0.87804878,1927
4434e4d3c36e05f85251940a23140e177754357c,0,Madhan Neethiraj,2015-03-08 21:15:25-07:00,['7c161433bd1cc9dc39149e44abdfb70ef18555d7'],2,8,10,561962,7,,,,1927
2a309b5c1a44de97cae1657278407037d0f33054,1,Velmurugan Periasamy,2015-03-09 10:59:49-04:00,['4434e4d3c36e05f85251940a23140e177754357c'],42,959,1001,562963,30,0.634577603,0.886051081,0.990176817,1929
e97c99d8b17c8cd8b7b578e44acd020e6605911d,1,rmani,2015-03-09 10:47:21-07:00,['895ac2b194bc54853224001c5f7f483cd7e6e2d9'],426,1272,1698,564661,4,0.201413428,0.425795053,0.992932862,1929
ca75aadc6be398fc0eac317c9c58ca928b6f152c,0,rmani,2015-03-09 10:47:49-07:00,"['e97c99d8b17c8cd8b7b578e44acd020e6605911d', '2a309b5c1a44de97cae1657278407037d0f33054']",272,1227,1499,566160,43,,,,1929
2c61f7ecd8d5273745e9ac3dee6b1ffb599fba78,1,rmani,2015-03-09 15:52:07-07:00,['ca75aadc6be398fc0eac317c9c58ca928b6f152c'],0,30,30,566190,1,,,,1929
96fd15e46ce2f929707a6d7f24b252124af4930a,0,Madhan Neethiraj,2015-03-10 00:03:41-07:00,['2c61f7ecd8d5273745e9ac3dee6b1ffb599fba78'],10,0,10,566200,1,,,,1929
f721abec9cd95ac4c6b70fb964884346f2814ed1,1,Madhan Neethiraj,2015-03-10 15:13:32-07:00,['96fd15e46ce2f929707a6d7f24b252124af4930a'],482,2126,2608,568808,13,0.127608347,0.371589085,0.548154093,1932
de07826d3011234741c4bde19dae3689717d3af1,0,Madhan Neethiraj,2015-03-10 23:58:40-07:00,['f721abec9cd95ac4c6b70fb964884346f2814ed1'],0,1,1,568809,1,,,,1932
ac37541310327ca3b1c506818e0f9e09b15a00b1,0,Madhan Neethiraj,2015-03-11 11:10:55-07:00,['de07826d3011234741c4bde19dae3689717d3af1'],54,54,108,568917,2,1,1,0,1932
cedd97aa9b332f7014da52d7c8d1b585e5711cc7,1,Dilli Dorai Arumugam,2015-03-11 11:25:08-07:00,['ac37541310327ca3b1c506818e0f9e09b15a00b1'],11,233,244,569161,2,0.621428571,0.442857143,1,1933
4d1abc89cca52e8dad3b2f98bc722439184a29d3,1,Madhan Neethiraj,2015-03-11 19:42:27-07:00,['cedd97aa9b332f7014da52d7c8d1b585e5711cc7'],38,82,120,569281,2,0,0.533333333,0.533333333,1933
6e9f2a3b5a9cc2a04927ca6a99f8c3ec93f1891b,1,Madhan Neethiraj,2015-03-12 16:13:03-07:00,['4d1abc89cca52e8dad3b2f98bc722439184a29d3'],61,1167,1228,570509,11,0.20278834,0.541191381,0.793409379,1935
23482defe710346dc0c833caeac927f8c241659d,0,Velmurugan Periasamy,2015-03-13 15:23:31-04:00,['6e9f2a3b5a9cc2a04927ca6a99f8c3ec93f1891b'],49,168,217,570726,10,,,,1937
03d1dec3800c554b36fa897c0c679c3b352af617,1,Velmurugan Periasamy,2015-03-13 16:57:20-04:00,['23482defe710346dc0c833caeac927f8c241659d'],715,1868,2583,573309,5,0.200661521,0.496141125,0.197353914,1938
d4f2eb20f5d8c03e61a4967b96a39935a5e4c65a,1,Madhan Neethiraj,2015-03-13 19:06:08-07:00,['03d1dec3800c554b36fa897c0c679c3b352af617'],34,238,272,573581,10,0.167785235,0.308724832,0.563758389,1938
2e0be82df973a6f37e766b7e9fff2b41431d0db1,1,Madhan Neethiraj,2015-03-13 19:50:19-07:00,['d4f2eb20f5d8c03e61a4967b96a39935a5e4c65a'],271,913,1184,574765,12,0.410764873,0.368271955,1,1943
29fc2708263d76bffacb0ccfe86f605bcdf0a79b,1,rmani,2015-03-13 23:15:53-07:00,['03d1dec3800c554b36fa897c0c679c3b352af617'],0,599,599,575364,5,0.213622291,0.489164087,0.721362229,1948
dc87ef9860ae78b256d713383eb17769d6b22d5e,0,rmani,2015-03-13 23:16:14-07:00,"['29fc2708263d76bffacb0ccfe86f605bcdf0a79b', '2e0be82df973a6f37e766b7e9fff2b41431d0db1']",305,1151,1456,576820,22,,,,1948
9b35976172498ae55787c05bd9d25c0f48137813,1,rmani,2015-03-13 23:17:13-07:00,['dc87ef9860ae78b256d713383eb17769d6b22d5e'],24,27,51,576871,1,0,0,0,1948
7bb686873805b8157644dbd3e9e27632ef8c5590,1,Madhan Neethiraj,2015-03-14 11:41:44-07:00,['9b35976172498ae55787c05bd9d25c0f48137813'],26,34,60,576931,14,,,,1948
d017b31f913087613623a1cf711f3455153845ad,1,Madhan Neethiraj,2015-03-16 00:54:02-07:00,['7bb686873805b8157644dbd3e9e27632ef8c5590'],1128,317,1445,578376,10,0.780687398,0.68903437,0.332242226,1948
8335bdeacc0fcda9aabff8eb4cee14b2e682c9f5,1,Madhan Neethiraj,2015-03-16 00:54:02-07:00,['d017b31f913087613623a1cf711f3455153845ad'],18,14,32,578408,2,,,,1948
ccf8d62642c41e5225a531403a4f9b7aef44d63a,1,Madhan Neethiraj,2015-03-16 11:08:19-07:00,['8335bdeacc0fcda9aabff8eb4cee14b2e682c9f5'],24,19,43,578451,6,0,1,1,1948
a200d82d8dd08d7b562019d57ba9aa681abd185c,1,Dilli Dorai Arumugam,2015-03-16 15:10:33-07:00,['ccf8d62642c41e5225a531403a4f9b7aef44d63a'],342,103,445,578896,13,0.821428571,0.678571429,0.133928571,1948
15b13901119c7bd4e8dc23260622328a0e2a1aa2,1,Velmurugan Periasamy,2015-03-16 20:11:33-04:00,['a200d82d8dd08d7b562019d57ba9aa681abd185c'],93,1817,1910,580806,16,0.160424028,0.209893993,0.715194346,1948
4338911690977ad8fa5de84e8c93867dbbef8183,1,Madhan Neethiraj,2015-03-16 22:21:19-07:00,['15b13901119c7bd4e8dc23260622328a0e2a1aa2'],7,12,19,580825,2,,,,1948
8e6acd5d5dc0164bc6d87714645b8715cee355f4,0,Velmurugan Periasamy,2015-03-17 13:20:34-04:00,['4338911690977ad8fa5de84e8c93867dbbef8183'],2,12,14,580839,2,0,0,0,1948
40aa090d7b23a524b9900f5b722d02b48c06b947,1,Don Bosco Durai,2015-03-17 14:17:30-07:00,['8e6acd5d5dc0164bc6d87714645b8715cee355f4'],219,30674,30893,611732,207,0.54488761,0.620819627,0.819010417,2120
82f714208cdf7d82ccfeae83225a7ddac1720aec,0,Don Bosco Durai,2015-03-17 15:48:51-07:00,['40aa090d7b23a524b9900f5b722d02b48c06b947'],18,18,36,611768,6,,,,2120
c530e2c6cb05cc1268650686c8ae5f01c94482fb,1,Madhan Neethiraj,2015-03-18 11:45:58-07:00,['82f714208cdf7d82ccfeae83225a7ddac1720aec'],7,13,20,611788,8,,,,2120
f867161acf1c6e5169410740f97cee274027ef67,0,Dilli Dorai Arumugam,2015-03-18 17:53:07-07:00,['c530e2c6cb05cc1268650686c8ae5f01c94482fb'],0,1,1,611789,1,,,,2120
8f392e1770741f0922696361d243f8d99a247aed,0,Don Bosco Durai,2015-03-18 20:22:29-07:00,['f867161acf1c6e5169410740f97cee274027ef67'],2,3,5,611794,3,,,,2120
01206387761576a8d2d53df1e2bb194d987a0c10,1,Velmurugan Periasamy,2015-03-18 23:41:52-04:00,['8f392e1770741f0922696361d243f8d99a247aed'],0,12,12,611806,2,0,0,1,2120
6618b9c2d9a9ea144ff3902bf7e19b305e858947,0,Velmurugan Periasamy,2015-03-19 03:00:54-04:00,['01206387761576a8d2d53df1e2bb194d987a0c10'],1,1,2,611808,1,,,,2120
4435b434f881deaee985603847545515e2ec17eb,1,Velmurugan Periasamy,2015-03-19 15:29:28-04:00,['6618b9c2d9a9ea144ff3902bf7e19b305e858947'],7,13,20,611828,3,0.875,1,0.875,2120
e039b7ca45ee566af5decf18830417fa2af55e3c,1,Velmurugan Periasamy,2015-03-19 15:29:40-04:00,['4435b434f881deaee985603847545515e2ec17eb'],1084,177,1261,613089,10,0.53875969,0.656976744,0,2122
4a34f48af48f7ed13cacdf6bcf501b1f9331af39,1,Velmurugan Periasamy,2015-03-19 15:29:50-04:00,['e039b7ca45ee566af5decf18830417fa2af55e3c'],54,69,123,613212,11,0.9,1,0.7,2122
cf05516bf556ac325d524b694c2ec241306ff4fe,1,Velmurugan Periasamy,2015-03-20 03:07:44-04:00,['4a34f48af48f7ed13cacdf6bcf501b1f9331af39'],85,148,233,613445,3,0.272727273,0,1,2122
4bf8a3fae805e1175ba62588ea578abb4a9d9880,1,Madhan Neethiraj,2015-03-20 00:25:14-07:00,['cf05516bf556ac325d524b694c2ec241306ff4fe'],505,388,893,614338,27,0,0.028571429,0.028571429,2123
85d5658fc205a647bb397ee83d81df4cbaa5f53d,1,Velmurugan Periasamy,2015-03-20 04:18:15-04:00,['4bf8a3fae805e1175ba62588ea578abb4a9d9880'],1149,971,2120,616458,22,0.054545455,1,0.236363636,2126
87b6d4b59425cdaa319b6022453488ded10f4938,0,Madhan Neethiraj,2015-03-20 20:02:54-07:00,['85d5658fc205a647bb397ee83d81df4cbaa5f53d'],9,257,266,616724,5,0.322916667,0.541666667,1,2129
04536c6c74cd54378156f9c365973b3d53033f25,1,Madhan Neethiraj,2015-03-20 22:12:49-07:00,['85d5658fc205a647bb397ee83d81df4cbaa5f53d'],9,257,266,616990,5,0.322916667,0.541666667,1,2132
b3dc07ce8523af3aeedd671668abef773f60e897,0,Madhan Neethiraj,2015-03-20 22:13:11-07:00,"['04536c6c74cd54378156f9c365973b3d53033f25', '87b6d4b59425cdaa319b6022453488ded10f4938']",0,0,0,616990,0,,,,2132
5d074d56e0f933570863802435bab589afe9c2ef,1,sneethiraj,2015-03-23 00:18:42-04:00,['b3dc07ce8523af3aeedd671668abef773f60e897'],30,28,58,617048,23,,,,2132
b780714ec2ce326a40b135748ac588078d2456c1,1,Velmurugan Periasamy,2015-03-23 09:57:59-04:00,['5d074d56e0f933570863802435bab589afe9c2ef'],2,82,84,617132,6,,,,2136
cbfbf7f04d3644dd730af2a76707cdd7ef853c14,0,Velmurugan Periasamy,2015-03-23 10:35:36-04:00,['b780714ec2ce326a40b135748ac588078d2456c1'],1,1,2,617134,1,,,,2136
66e5cfd96afe612dfcddd9e6fdf01885320f03de,0,sneethiraj,2015-03-23 14:06:15-04:00,['cbfbf7f04d3644dd730af2a76707cdd7ef853c14'],2,2,4,617138,2,,,,2136
878e2ac3f656502bd9aba150579de28b657845a1,1,Madhan Neethiraj,2015-03-23 17:35:40-07:00,['66e5cfd96afe612dfcddd9e6fdf01885320f03de'],2,21,23,617161,1,0,0.833333333,0.916666667,2136
ddf9cfa74f22a7852430324e1c57be87dc72078e,0,sneethiraj,2015-03-23 22:43:35-04:00,['878e2ac3f656502bd9aba150579de28b657845a1'],3,3,6,617167,1,,,,2136
405c518531f63dd932791f9e5f0f6214aa7bd0a8,1,Dilli Dorai Arumugam,2015-03-23 21:01:13-07:00,['ddf9cfa74f22a7852430324e1c57be87dc72078e'],4,37,41,617208,1,0,0,1,2136
0ab48758fb0089da3b81978d00e2122f535c14ad,1,Velmurugan Periasamy,2015-03-24 01:15:28-04:00,['405c518531f63dd932791f9e5f0f6214aa7bd0a8'],3,335,338,617546,8,0.597222222,0.902777778,1,2138
ce139e013aa4f0e6472ac910b9c62073ed902f35,1,sneethiraj,2015-03-24 10:30:21-04:00,['0ab48758fb0089da3b81978d00e2122f535c14ad'],22,191,213,617759,13,0,0.207142857,0.935714286,2138
bb0bdcedeb134f5aadeef17be11f4df7e8150b71,1,Velmurugan Periasamy,2015-03-24 13:26:30-04:00,['ce139e013aa4f0e6472ac910b9c62073ed902f35'],47,7418,7465,625224,54,0.464625446,0.720570749,0.82372176,2185
dc49a1a495794fa7140b335f9a4a5298d3fa3b3d,1,Velmurugan Periasamy,2015-03-24 15:06:35-04:00,['bb0bdcedeb134f5aadeef17be11f4df7e8150b71'],1233,702,1935,627159,2,0.988095238,0.269047619,1,2185
8e786fa6838bdbfa154c1987196ce0bdcc47db47,1,Velmurugan Periasamy,2015-03-24 16:14:17-04:00,['dc49a1a495794fa7140b335f9a4a5298d3fa3b3d'],375,917,1292,628451,20,0.651685393,0.325842697,1,2189
4dd804138a772ccfb30e66bd3e8672ab09642272,1,sneethiraj,2015-03-24 16:29:34-04:00,['8e786fa6838bdbfa154c1987196ce0bdcc47db47'],113,146,259,628710,4,0.106382979,0.106382979,0.936170213,2190
e5436877bda7405a327df4ef1a5d5e96b2d98a45,0,sneethiraj,2015-03-24 16:48:57-04:00,['4dd804138a772ccfb30e66bd3e8672ab09642272'],4,4,8,628718,1,,,,2190
cfdd38268c106b242749c224e623fdd3c95fe830,1,Madhan Neethiraj,2015-03-24 15:12:18-07:00,['4dd804138a772ccfb30e66bd3e8672ab09642272'],1,3,4,628722,1,,,,2190
59304ba8d42bbbb533841a78d09854a351361dc3,0,Madhan Neethiraj,2015-03-24 17:05:31-07:00,"['cfdd38268c106b242749c224e623fdd3c95fe830', 'e5436877bda7405a327df4ef1a5d5e96b2d98a45']",4,4,8,628730,1,,,,2190
cb4eb54b68b0bf54497a572cc81a4e17a72363b7,1,Madhan Neethiraj,2015-03-24 17:12:58-07:00,['59304ba8d42bbbb533841a78d09854a351361dc3'],57,78,135,628865,9,0.333333333,0.333333333,0.777777778,2190
81783f322bb8bf5f61aaba562fda6a0625ed67a0,1,Velmurugan Periasamy,2015-03-25 07:27:43-04:00,['cb4eb54b68b0bf54497a572cc81a4e17a72363b7'],11,426,437,629302,5,0.115523466,0.115523466,0.772563177,2191
ab8915bbb0f0d11bf543413f8b897d852e2e1533,0,Don Bosco Durai,2015-03-25 16:17:14-07:00,['6618b9c2d9a9ea144ff3902bf7e19b305e858947'],6,0,6,629308,6,,,,2191
81f9b194926b9bcb3d6e92f875b10a2e00d2a5ab,0,Don Bosco Durai,2015-03-25 16:24:16-07:00,"['ab8915bbb0f0d11bf543413f8b897d852e2e1533', '81783f322bb8bf5f61aaba562fda6a0625ed67a0']",4647,12261,16908,646216,196,,,,2191
5aa812fa9f786e16eb54dc46d427ea20d1a777ed,0,Velmurugan Periasamy,2015-03-26 10:25:28-04:00,['81f9b194926b9bcb3d6e92f875b10a2e00d2a5ab'],1,0,1,646217,1,,,,2191
cc74ff2e91898faec40c77fe24f83ad09802c298,1,Velmurugan Periasamy,2015-03-26 15:43:50-04:00,['5aa812fa9f786e16eb54dc46d427ea20d1a777ed'],12,18,30,646247,5,0.666666667,1,0.833333333,2191
2b046206975e4e7d37ea399e50d5113e526f61a9,1,Velmurugan Periasamy,2015-03-26 15:45:26-04:00,['cc74ff2e91898faec40c77fe24f83ad09802c298'],14,58,72,646319,2,,,,2191
24543ec1d171134f33bdd2544299b7ce2eec2c9d,0,sneethiraj,2015-03-26 18:35:52-04:00,['2b046206975e4e7d37ea399e50d5113e526f61a9'],1,2,3,646322,2,,,,2191
87446272e0e3678463aad96770c7f957f1d9418b,1,Madhan Neethiraj,2015-03-26 15:59:59-07:00,['24543ec1d171134f33bdd2544299b7ce2eec2c9d'],31,29,60,646382,9,1,1,0.75,2191
b1bfbc572cd2a2974403abb7c023b5390c21f55d,1,Madhan Neethiraj,2015-03-26 16:52:54-07:00,['87446272e0e3678463aad96770c7f957f1d9418b'],177,190,367,646749,15,0.16,0,0.88,2191
ca40e35c7aa499dd8e87514814b86bb2fe854d73,1,Madhan Neethiraj,2015-03-27 17:31:07-07:00,['b1bfbc572cd2a2974403abb7c023b5390c21f55d'],196,183,379,647128,17,1,1,1,2191
f88382b6f11f4317fcf5cba77025f14e1f647231,0,Madhan Neethiraj,2015-03-27 18:50:11-07:00,['ca40e35c7aa499dd8e87514814b86bb2fe854d73'],6,24,30,647158,3,0,0,1,2191
7058bbbed1ce1415e6b76bbefbed2ffb1a899c90,0,rmani,2015-03-30 14:52:08-07:00,['f88382b6f11f4317fcf5cba77025f14e1f647231'],1,1,2,647160,1,,0,,2191
56be1198139612c2577b42203f998075bd569987,1,Velmurugan Periasamy,2015-03-30 18:55:58-04:00,['7058bbbed1ce1415e6b76bbefbed2ffb1a899c90'],3,5,8,647168,1,,,,2191
60a235c66bca2381316cedabb2be28a090556e91,1,Madhan Neethiraj,2015-03-30 17:09:32-07:00,['56be1198139612c2577b42203f998075bd569987'],269,349,618,647786,49,0,0,0.571428571,2191
2dc01d08b27e31a3af260b71f59a9585d853c5c3,1,Don Bosco Durai,2015-03-30 17:23:35-07:00,['60a235c66bca2381316cedabb2be28a090556e91'],2,1352,1354,649140,19,0.268292683,0.495934959,0.975609756,2207
73387f30cd03d853a81fa3923364efa2f59e7113,0,sneethiraj,2015-03-30 23:26:49-04:00,['60a235c66bca2381316cedabb2be28a090556e91'],8,34,42,649182,1,,,,2207
e86f7f840580e5a83c3b7cd42287c1693c9e9772,0,Don Bosco Durai,2015-03-30 20:33:15-07:00,"['2dc01d08b27e31a3af260b71f59a9585d853c5c3', '73387f30cd03d853a81fa3923364efa2f59e7113']",8,34,42,649224,1,,,,2207
1295055d1e8a429e6ba71144cf97b4f38249c9dc,0,Don Bosco Durai,2015-03-30 20:35:23-07:00,['e86f7f840580e5a83c3b7cd42287c1693c9e9772'],1,1,2,649226,1,,,,2207
d27cacd7dbe966c13fc8dd962e66eb306f3b36a1,0,Don Bosco Durai,2015-03-30 20:57:12-07:00,['1295055d1e8a429e6ba71144cf97b4f38249c9dc'],6,54,60,649286,2,,,,2207
e44c5113e0e6c160399794c65ac76bae0c3302f2,0,Velmurugan Periasamy,2015-03-31 00:30:07-04:00,['d27cacd7dbe966c13fc8dd962e66eb306f3b36a1'],9,25,34,649320,1,0,1,1,2207
0922144064f5ea8f6c217843d952decad0f9bb5c,1,Madhan Neethiraj,2015-03-30 22:58:31-07:00,['e44c5113e0e6c160399794c65ac76bae0c3302f2'],1,34,35,649355,2,1,1,0.4,2207
a697bca04a16b7e9abc506835813a48c50012a67,1,Madhan Neethiraj,2015-03-30 23:37:57-07:00,['0922144064f5ea8f6c217843d952decad0f9bb5c'],29,310,339,649694,11,0.464646465,0.565656566,0.919191919,2207
d4ca4ef6299a23be6088eb71b35625dbc2e31674,1,rmani,2015-03-31 09:38:02-07:00,['7058bbbed1ce1415e6b76bbefbed2ffb1a899c90'],5,376,381,650075,3,0.364485981,0.528037383,1,2209
3487811ecb3717d306f3c6834b5dae3d6c6c2892,0,rmani,2015-03-31 09:38:21-07:00,"['d4ca4ef6299a23be6088eb71b35625dbc2e31674', 'a697bca04a16b7e9abc506835813a48c50012a67']",318,2154,2472,652547,82,,,,2209
ded323b776e6b5bf92c0c643c3e50e5377a8fd93,1,Velmurugan Periasamy,2015-03-31 12:55:22-04:00,['3487811ecb3717d306f3c6834b5dae3d6c6c2892'],14,84,98,652645,6,0.655172414,1,0.74137931,2209
d804499aed86205dc00d3e838209be195c92cc88,1,Madhan Neethiraj,2015-03-31 10:28:26-07:00,['ded323b776e6b5bf92c0c643c3e50e5377a8fd93'],12,26,38,652683,1,0,0,1,2209
ff347709cfc04f1d90f1744fec89762d736698f7,1,Madhan Neethiraj,2015-03-31 13:11:31-07:00,['d804499aed86205dc00d3e838209be195c92cc88'],156,415,571,653254,13,0.409836066,0.486338798,0.699453552,2209
d13617aa7dca31f996cb2090d19bad2176248955,1,Madhan Neethiraj,2015-03-31 14:34:37-07:00,['ff347709cfc04f1d90f1744fec89762d736698f7'],64,15,79,653333,3,1,1,0,2209
e70adbe4a91b9bfca26b41326345cfa63120bb46,0,Velmurugan Periasamy,2015-04-01 20:34:10-04:00,['d13617aa7dca31f996cb2090d19bad2176248955'],5,7,12,653345,2,0,0,1,2209
c4a1a2b1304839a24074c9682abcae0edc6821d5,0,Madhan Neethiraj,2015-04-01 18:56:13-07:00,['d13617aa7dca31f996cb2090d19bad2176248955'],2,0,2,653347,1,,,,2209
e274dc3473cec3b123c05adee4c93066e3d4679f,0,Madhan Neethiraj,2015-04-01 19:01:06-07:00,['c4a1a2b1304839a24074c9682abcae0edc6821d5'],2,0,2,653349,1,,,,2209
77f8ad98d4a6693a3eea8f38dfbe729301bf023c,0,Madhan Neethiraj,2015-04-01 19:07:04-07:00,['e274dc3473cec3b123c05adee4c93066e3d4679f'],2,0,2,653351,1,,,,2209
32f3262bcf44622b3f0af3d5ac323ed761ea337a,1,Madhan Neethiraj,2015-04-01 19:26:43-07:00,['77f8ad98d4a6693a3eea8f38dfbe729301bf023c'],70,598,668,654019,8,0.479495268,0.769716088,0.785488959,2212
62fa3616a33bc9a540d43888cb18f39c6cbdf165,0,Velmurugan Periasamy,2015-04-01 23:01:10-04:00,"['e70adbe4a91b9bfca26b41326345cfa63120bb46', '32f3262bcf44622b3f0af3d5ac323ed761ea337a']",76,598,674,654693,11,,,,2212
5df9aa6457776e411525fe83d269455be7861ab6,1,Madhan Neethiraj,2015-04-01 21:21:48-07:00,['62fa3616a33bc9a540d43888cb18f39c6cbdf165'],49,265,314,655007,13,0.571428571,0.921428571,0.914285714,2212
c934b7906d5aab2194dee5c7297f83fc116b5974,0,sneethiraj,2015-04-02 02:09:59-04:00,['5df9aa6457776e411525fe83d269455be7861ab6'],1,2,3,655010,1,,,,2212
49bebb59f793fa550242bbc34c2bb3173b6be2b5,1,Madhan Neethiraj,2015-04-02 00:04:31-07:00,['c934b7906d5aab2194dee5c7297f83fc116b5974'],474,505,979,655989,7,0,0,0,2213
be34cc2929e0cb4c4a43d5a2eece40683e61a62d,1,Madhan Neethiraj,2015-04-02 00:44:40-07:00,['49bebb59f793fa550242bbc34c2bb3173b6be2b5'],3,38,41,656030,2,0,0,1,2213
10b57288904da5e832300850e799f8debb4cc909,1,Don Bosco Durai,2015-04-02 12:18:33-07:00,['be34cc2929e0cb4c4a43d5a2eece40683e61a62d'],8,1285,1293,657323,19,0.224242424,0.606060606,1,2229
0d9a31a93af7b5540444ebe45d53073adc0c746b,1,Madhan Neethiraj,2015-04-02 13:46:57-07:00,['be34cc2929e0cb4c4a43d5a2eece40683e61a62d'],139,306,445,657768,8,0.074074074,0.148148148,0.148148148,2229
399ed34b29fa96bac4970251044ad1476d056f57,0,Don Bosco Durai,2015-04-02 15:30:04-07:00,"['10b57288904da5e832300850e799f8debb4cc909', '0d9a31a93af7b5540444ebe45d53073adc0c746b']",139,306,445,658213,8,,,,2229
42262d09dddfb5bd4e6706343d6392cc2075a3d9,1,rmani,2015-04-02 16:07:11-07:00,['be34cc2929e0cb4c4a43d5a2eece40683e61a62d'],1,11,12,658225,1,0,0,1,2229
3fae96ce8778cb08c3854ca366c1aa96147e22c8,0,rmani,2015-04-02 16:07:49-07:00,"['42262d09dddfb5bd4e6706343d6392cc2075a3d9', '399ed34b29fa96bac4970251044ad1476d056f57']",147,1591,1738,659963,27,,,,2229
0d5844ae8f4da7d91aa8d8d6524f154b293aee99,0,Madhan Neethiraj,2015-04-02 16:12:49-07:00,['3fae96ce8778cb08c3854ca366c1aa96147e22c8'],5,140,145,660108,2,0.205479452,0.205479452,1,2230
984fd5b861c131f94a10002f064cfab2d1899d6a,0,Dilli Dorai Arumugam,2015-04-03 10:18:11-07:00,['0d5844ae8f4da7d91aa8d8d6524f154b293aee99'],9,9,18,660126,8,,,,2230
520ae585b948e13c082f7911db7978d505bd9eac,1,rmani,2015-04-03 12:10:39-07:00,['3fae96ce8778cb08c3854ca366c1aa96147e22c8'],11,28,39,660165,1,0,0.117647059,0.882352941,2230
6ba785079cc4d09e25718b120fd8f0691e2ba10a,0,rmani,2015-04-03 12:10:48-07:00,"['520ae585b948e13c082f7911db7978d505bd9eac', '984fd5b861c131f94a10002f064cfab2d1899d6a']",14,149,163,660328,10,,,,2230
b15105336769622148e9cc81e2be48b48e46dda9,1,Velmurugan Periasamy,2015-04-03 17:50:33-04:00,['6ba785079cc4d09e25718b120fd8f0691e2ba10a'],199,277,476,660804,8,0.72327044,1,0.874213836,2230
f5317ec954c49c74b207ef00b36e6028454810bb,1,Madhan Neethiraj,2015-04-03 16:33:51-07:00,['b15105336769622148e9cc81e2be48b48e46dda9'],4,7,11,660815,1,0,0,1,2230
10f5fd6072c46222022816f302f06e51ea078597,1,Madhan Neethiraj,2015-04-04 15:09:33-07:00,['f5317ec954c49c74b207ef00b36e6028454810bb'],654,786,1440,662255,12,0.53968254,0.952380952,1,2231
9313153838c1cdf0249c1908cf80ca45f719ade7,1,Madhan Neethiraj,2015-04-06 19:52:51-07:00,['10f5fd6072c46222022816f302f06e51ea078597'],9,30,39,662294,2,0,0.666666667,0.583333333,2231
0ea6b16a281d5aa14383eb3921c268ee18abacde,1,rmani,2015-04-06 23:15:12-07:00,['9313153838c1cdf0249c1908cf80ca45f719ade7'],1,7,8,662302,2,1,1,1,2231
b73b2904251a6b99556fe0c8a6e67ea77f226053,0,Madhan Neethiraj,2015-04-07 00:36:01-07:00,['0ea6b16a281d5aa14383eb3921c268ee18abacde'],56,84,140,662442,7,0,0,0.846153846,2231
ae39d3eeb2b54d4aad228202b6cca9d3a5a768ca,1,Madhan Neethiraj,2015-04-07 00:42:19-07:00,['0ea6b16a281d5aa14383eb3921c268ee18abacde'],56,84,140,662582,7,0,0,0.846153846,2231
0711abe23b4660019ad72ae0dfbac64ddd68e50d,0,Madhan Neethiraj,2015-04-07 00:42:45-07:00,"['ae39d3eeb2b54d4aad228202b6cca9d3a5a768ca', 'b73b2904251a6b99556fe0c8a6e67ea77f226053']",0,0,0,662582,0,,,,2231
a263431a5aed18a668fd93e6e3fa17341db64800,1,Velmurugan Periasamy,2015-04-07 09:50:39-04:00,['0711abe23b4660019ad72ae0dfbac64ddd68e50d'],341,4402,4743,667325,58,0.645193261,0.845887017,0.951437066,2265
52ae9819161e9c3cd42df4315db94baab992da3c,1,Velmurugan Periasamy,2015-04-07 10:00:32-04:00,['a263431a5aed18a668fd93e6e3fa17341db64800'],37,33,70,667395,7,0.615384615,0.461538462,0.230769231,2265
75783f728178f227ac5d6252e6b7d2e1e6ec02a3,1,Velmurugan Periasamy,2015-04-07 10:44:06-04:00,['52ae9819161e9c3cd42df4315db94baab992da3c'],5,2281,2286,669681,26,0.354330709,0.568897638,0.785433071,2286
efc2c12d53267cdee89ec0500c7a1b5bf2e55b86,0,sneethiraj,2015-04-07 10:46:17-04:00,['52ae9819161e9c3cd42df4315db94baab992da3c'],1,1,2,669683,1,,,,2286
982a3cb900ce316effd5200c4401aadc95c2e910,0,sneethiraj,2015-04-07 10:51:58-04:00,"['efc2c12d53267cdee89ec0500c7a1b5bf2e55b86', '75783f728178f227ac5d6252e6b7d2e1e6ec02a3']",5,2281,2286,671969,26,,,,2286
7ecfa05366af6bc5e69dc41ffc1eff4515b25788,1,Velmurugan Periasamy,2015-04-07 11:20:44-04:00,['982a3cb900ce316effd5200c4401aadc95c2e910'],1,1,2,671971,1,,,,2286
53709aad8bca8b326c81766738a4ffbaeff66fb8,1,Velmurugan Periasamy,2015-04-07 14:28:32-04:00,['7ecfa05366af6bc5e69dc41ffc1eff4515b25788'],789,1222,2011,673982,21,0.96969697,0.54040404,0.944444444,2294
b253a4e2d19dd7bcc38870edb732ba8d9d73e220,1,Madhan Neethiraj,2015-04-07 12:35:38-07:00,['53709aad8bca8b326c81766738a4ffbaeff66fb8'],81,414,495,674477,2,0.868965517,1,0.668965517,2295
63399d07da7da6b957f1f4f2f7a85a668e191117,1,Dilli Dorai Arumugam,2015-04-07 12:45:25-07:00,['53709aad8bca8b326c81766738a4ffbaeff66fb8'],3,20,23,674500,2,0,0,1,2295
aae97d7676482a4daebb57b89ab2e85ce0699b16,0,Dilli Dorai Arumugam,2015-04-07 13:07:12-07:00,"['b253a4e2d19dd7bcc38870edb732ba8d9d73e220', '63399d07da7da6b957f1f4f2f7a85a668e191117']",3,20,23,674523,2,,,,2295
b3b773216ca7d0ccfec7b31ae2ca0b4de2f4d086,1,Velmurugan Periasamy,2015-04-07 21:53:40-04:00,['aae97d7676482a4daebb57b89ab2e85ce0699b16'],40,83,123,674646,3,,,,2295
cb2dc314688eb2d88526bb627d84c91508ee95f3,1,sneethiraj,2015-04-08 02:14:40-04:00,['b3b773216ca7d0ccfec7b31ae2ca0b4de2f4d086'],285,1446,1731,676377,8,0.057088487,0,0.325404377,2296
63c7893aeb7edadd24b8076e7c2ed18e4cf1065f,1,sneethiraj,2015-04-08 02:28:40-04:00,['cb2dc314688eb2d88526bb627d84c91508ee95f3'],30,61,91,676468,3,1,1,1,2296
c50acc4482f9dd7ac42f9350e1fc3899df5334a8,1,sneethiraj,2015-04-08 02:32:07-04:00,['63c7893aeb7edadd24b8076e7c2ed18e4cf1065f'],16,97,113,676581,8,0,0.811320755,0.452830189,2296
4b0fd5dc874fbfb6952746413b2ff2caa17580b1,0,sneethiraj,2015-04-08 02:56:39-04:00,['c50acc4482f9dd7ac42f9350e1fc3899df5334a8'],3,11,14,676595,1,0,1,1,2296
f2ed981966246e4cfb15e94b9639618108e14b7f,1,sneethiraj,2015-04-08 07:51:30-04:00,['4b0fd5dc874fbfb6952746413b2ff2caa17580b1'],2,3,5,676600,1,1,0,1,2296
2e2bdd8a1c1804e7e729967aa1b441b6779d3b4d,1,sneethiraj,2015-04-08 07:57:15-04:00,['f2ed981966246e4cfb15e94b9639618108e14b7f'],204,67,271,676871,3,0.869047619,0,0,2296
503c827f83c2d15a8c4b14963f51a18b2a340db2,0,sneethiraj,2015-04-08 10:30:25-04:00,['2e2bdd8a1c1804e7e729967aa1b441b6779d3b4d'],8,14,22,676893,1,,,,2296
35a6454bff021a18fa42476d6388aace5edde905,0,sneethiraj,2015-04-08 10:34:03-04:00,['503c827f83c2d15a8c4b14963f51a18b2a340db2'],6,1471,1477,678370,88,,,,2296
785fe3d4c7e2de2350693b0c170b91df48071fc7,0,sneethiraj,2015-04-08 12:14:43-04:00,['35a6454bff021a18fa42476d6388aace5edde905'],4,26,30,678400,2,,,,2297
405b3e6a8835c4f2036a9596570759fa64210aff,0,rmani,2015-04-09 01:38:09-07:00,['785fe3d4c7e2de2350693b0c170b91df48071fc7'],2,2,4,678404,2,,,,2297
d673e5940680a69e600b87f017d3d76ac39cd4e0,1,Madhan Neethiraj,2015-04-09 07:50:47-07:00,['405b3e6a8835c4f2036a9596570759fa64210aff'],21,85,106,678510,10,0.742857143,0.771428571,0.942857143,2297
376d32497487b38d2d0a34f31e96c28d3068a2dd,1,Velmurugan Periasamy,2015-04-09 14:49:14-04:00,['d673e5940680a69e600b87f017d3d76ac39cd4e0'],163,7206,7369,685879,10,0.120911215,1,1,2305
0e5e27896aecd58534e6d90c57eac7c626a0ca06,0,Madhan Neethiraj,2015-04-09 16:14:21-07:00,['376d32497487b38d2d0a34f31e96c28d3068a2dd'],29,96,125,686004,3,1,1,0,2305
dc0047e9af90f204ca78c93209a363a5ba790b91,1,Madhan Neethiraj,2015-04-09 17:40:57-07:00,['376d32497487b38d2d0a34f31e96c28d3068a2dd'],29,96,125,686129,3,1,1,0,2305
d6797e40a54e02a9399d4e4c7fdc4172bf9cabdd,0,Madhan Neethiraj,2015-04-09 17:41:05-07:00,"['dc0047e9af90f204ca78c93209a363a5ba790b91', '0e5e27896aecd58534e6d90c57eac7c626a0ca06']",0,0,0,686129,0,,,,2305
57625ff7a4ae92482cdf99b3e6b3d9c7b3ee108f,1,Madhan Neethiraj,2015-04-09 22:07:28-07:00,['d6797e40a54e02a9399d4e4c7fdc4172bf9cabdd'],76,846,922,687051,20,0.33220339,0.369491525,0.725423729,2309
e391bdbdd63c077ed1c21bfd4ad73a774d3361f4,0,Madhan Neethiraj,2015-04-09 22:43:17-07:00,['57625ff7a4ae92482cdf99b3e6b3d9c7b3ee108f'],0,38,38,687089,2,,,,2309
7684e5f492d3d6810dcd1b9b59e59e06d4ee9cf1,1,Velmurugan Periasamy,2015-04-10 10:09:32-04:00,['e391bdbdd63c077ed1c21bfd4ad73a774d3361f4'],424,706,1130,688219,14,0,0.534246575,0.780821918,2310
ef0f20d242545c0eb6bb772479bbbde59c7df9dd,1,Velmurugan Periasamy,2015-04-10 11:08:18-04:00,['7684e5f492d3d6810dcd1b9b59e59e06d4ee9cf1'],43,85,128,688347,3,0,0,0,2310
9693fb8dec06bb54b2f2e061f073ae608835004d,1,Madhan Neethiraj,2015-04-10 08:42:14-07:00,['ef0f20d242545c0eb6bb772479bbbde59c7df9dd'],33,9,42,688389,10,0,1,0,2310
a93ac46d69b5b5a1eed6a73d1616bac2c1c3a3d6,1,Madhan Neethiraj,2015-04-11 16:03:40-07:00,['9693fb8dec06bb54b2f2e061f073ae608835004d'],646,587,1233,689622,18,0.153846154,0.641025641,0,2311
fabc9e2059f748585799d85eecf012c2fdc22145,1,Madhan Neethiraj,2015-04-11 22:37:05-07:00,['a93ac46d69b5b5a1eed6a73d1616bac2c1c3a3d6'],36,151,187,689809,3,0.032608696,0.043478261,0.880434783,2311
c1de019f45437c632ee4aaf97b9d43cd822a4183,1,Velmurugan Periasamy,2015-04-13 09:55:34-04:00,['fabc9e2059f748585799d85eecf012c2fdc22145'],29,674,703,690512,14,0.163636364,0.163636364,0.418181818,2311
a23e431a3797f9f21dccb8b769cb578f50b6d5d5,1,Velmurugan Periasamy,2015-04-13 09:58:31-04:00,['c1de019f45437c632ee4aaf97b9d43cd822a4183'],18,13,31,690543,8,0,0,0,2311
ac0eac0b9be10dd4c0117bbbfeed020488c09f93,1,Velmurugan Periasamy,2015-04-13 18:17:56-04:00,['a23e431a3797f9f21dccb8b769cb578f50b6d5d5'],27,46,73,690616,8,1,1,0,2311
e34eaf11e334dbf6f95e67f1d0a3573c63da9ee5,1,sneethiraj,2015-04-14 02:20:32-04:00,['ac0eac0b9be10dd4c0117bbbfeed020488c09f93'],6,19,25,690641,1,,,,2311
89661939fbbec5583688f9a7361fa5bc729c4e7a,0,Velmurugan Periasamy,2015-04-14 12:12:02-04:00,['e34eaf11e334dbf6f95e67f1d0a3573c63da9ee5'],0,1,1,690642,1,,,,2311
de598fadac7626f72649c4d60aef1f031cffb7bb,1,Velmurugan Periasamy,2015-04-14 12:16:24-04:00,['89661939fbbec5583688f9a7361fa5bc729c4e7a'],470,659,1129,691771,8,0.166666667,0.5,0.512820513,2311
acfccc4a84fc72596fe258464260c1a0653cd6d3,0,Dilli Dorai Arumugam,2015-04-14 09:39:42-07:00,['de598fadac7626f72649c4d60aef1f031cffb7bb'],29,35,64,691835,3,0,0.666666667,1,2311
60ec3378913308825f428f73f3b56db5e363d2fd,1,Madhan Neethiraj,2015-04-14 13:45:04-07:00,['acfccc4a84fc72596fe258464260c1a0653cd6d3'],20,37,57,691892,1,0,1,1,2311
917833cd320757028a41e56d8c9eb92e052015f2,1,sneethiraj,2015-04-14 18:56:16-04:00,['60ec3378913308825f428f73f3b56db5e363d2fd'],285,2928,3213,695105,15,0.30477908,0.331830478,0.22723174,2316
eb1e9b5c447dc3960d132bd2dc5adfbb33d5cb2c,1,Don Bosco Durai,2015-04-14 18:02:57-07:00,['917833cd320757028a41e56d8c9eb92e052015f2'],400,4081,4481,699586,29,0.354509107,0.555308752,0.961350511,2324
d6cce39bbf626fad6150eb85c8766daf5b995917,1,sneethiraj,2015-04-15 03:31:03-04:00,['917833cd320757028a41e56d8c9eb92e052015f2'],727,253,980,700566,16,0,1,0,2324
0ee29405da6e86b2683185ed68861a8f9e626ff0,1,Madhan Neethiraj,2015-04-15 08:48:09-07:00,['d6cce39bbf626fad6150eb85c8766daf5b995917'],56,808,864,701430,8,0.64,0.64,0.84,2327
84a03b1590c4b3857fb6808d1577b4353116a28b,1,Velmurugan Periasamy,2015-04-15 15:23:56-04:00,['0ee29405da6e86b2683185ed68861a8f9e626ff0'],3,78,81,701511,4,0.085106383,0.489361702,0.936170213,2327
258ddbf85d7fa76da84334de9e54702f8924c8dc,1,Madhan Neethiraj,2015-04-15 18:54:11-07:00,['84a03b1590c4b3857fb6808d1577b4353116a28b'],27,53,80,701591,1,1,1,0,2327
113227618db4a2add18c7b6c6d17c66a2abbaff0,0,Madhan Neethiraj,2015-04-15 23:39:06-07:00,['258ddbf85d7fa76da84334de9e54702f8924c8dc'],4,7,11,701602,1,0,1,1,2327
9d2cbfb41ccfed54026589d224d1d012f47d1ae6,0,sneethiraj,2015-04-16 07:30:43-04:00,['113227618db4a2add18c7b6c6d17c66a2abbaff0'],11,71,82,701684,4,0,0,1,2327
6f888a61f2b3a39fb46b04a37b5940d5403a88a1,1,Velmurugan Periasamy,2015-04-16 22:45:03-04:00,['9d2cbfb41ccfed54026589d224d1d012f47d1ae6'],6,7,13,701697,4,0,0,0,2327
b3e31fadd9fc35a4867d5bbbde0320ed791e0d1d,1,Madhan Neethiraj,2015-04-16 21:01:41-07:00,['6f888a61f2b3a39fb46b04a37b5940d5403a88a1'],9,43,52,701749,1,0.357142857,0.214285714,0.357142857,2327
c7727f571fc36b8aaf9c7a2054f23856f456d4f5,1,Madhan Neethiraj,2015-04-16 22:37:59-07:00,['b3e31fadd9fc35a4867d5bbbde0320ed791e0d1d'],63,116,179,701928,3,0,0,1,2328
80c28937043f5b7a5ca26c9d168fb07a7c0ea5df,1,rmani,2015-04-17 20:24:26-07:00,['c7727f571fc36b8aaf9c7a2054f23856f456d4f5'],25,56,81,702009,1,0.64,0.64,1,2328
f8b4d4a9a28e097abe21565a0af9c21ee700c699,0,Madhan Neethiraj,2015-04-17 22:52:19-07:00,['80c28937043f5b7a5ca26c9d168fb07a7c0ea5df'],42,110,152,702161,9,0.268292683,0.12195122,1,2328
0b7bc92bcdac82559f9a4981ab4e4aed915e9eff,1,Madhan Neethiraj,2015-04-19 10:59:44-07:00,['f8b4d4a9a28e097abe21565a0af9c21ee700c699'],62,5,67,702228,3,0,0,0,2328
4a20a9dd92894d852a51f119be2966006fe1e752,0,Madhan Neethiraj,2015-04-19 12:02:21-07:00,['0b7bc92bcdac82559f9a4981ab4e4aed915e9eff'],6,6,12,702240,1,1,0,0,2328
44f403ead9f920495af247e97450eb9e6a3c29b8,0,Don Bosco Durai,2015-04-19 15:10:57-07:00,"['eb1e9b5c447dc3960d132bd2dc5adfbb33d5cb2c', '4a20a9dd92894d852a51f119be2966006fe1e752']",1035,1607,2642,704882,51,,,,2328
3adafa493417bfb17382e1bb4b1fc8eb2e997123,1,Madhan Neethiraj,2015-04-19 20:12:59-07:00,['44f403ead9f920495af247e97450eb9e6a3c29b8'],0,11,11,704893,5,,,,2328
236f1ba67287725544c5a2d07a688d0894de46c3,1,Don Bosco Durai,2015-04-20 10:23:47-07:00,['3adafa493417bfb17382e1bb4b1fc8eb2e997123'],427,975,1402,706295,17,0.363076923,0.624615385,1,2330
da700247066b65a89e67bbcc60bdabe4509995d9,1,Velmurugan Periasamy,2015-04-20 13:36:56-04:00,['3adafa493417bfb17382e1bb4b1fc8eb2e997123'],9,120,129,706424,10,,,,2333
63099f378a8b759deeb9766220348df37c50ef6e,0,Don Bosco Durai,2015-04-20 10:47:58-07:00,"['236f1ba67287725544c5a2d07a688d0894de46c3', 'da700247066b65a89e67bbcc60bdabe4509995d9']",9,120,129,706553,10,,,,2333
0f56f8263afae41534456f1733cd2774a3d27140,1,rmani,2015-04-20 12:51:42-07:00,['da700247066b65a89e67bbcc60bdabe4509995d9'],2,15,17,706570,4,0,0,1,2333
3a98f4ec9a92ce514a3ad278550fd634cd38836a,0,Don Bosco Durai,2015-04-20 16:06:19-07:00,"['63099f378a8b759deeb9766220348df37c50ef6e', '0f56f8263afae41534456f1733cd2774a3d27140']",2,15,17,706587,4,,,,2333
853a932b3e17f08321ea49a39abe286bf4d52a61,1,sneethiraj,2015-04-20 20:26:24-04:00,['0f56f8263afae41534456f1733cd2774a3d27140'],160,160,320,706907,4,,,,2334
6874ec04e1e747ed23f76a71b744f9bb43993acb,0,Don Bosco Durai,2015-04-20 21:08:50-07:00,"['3a98f4ec9a92ce514a3ad278550fd634cd38836a', '853a932b3e17f08321ea49a39abe286bf4d52a61']",160,160,320,707227,4,,,,2334
46b5ecc33c02229d4c8721a8d616f2a788fef6f0,1,sneethiraj,2015-04-21 14:43:32-04:00,['853a932b3e17f08321ea49a39abe286bf4d52a61'],0,831,831,708058,11,0.312977099,0.385496183,0.851145038,2339
b7eafa41f48bce00d9bc9e6473cc08078a071412,0,Don Bosco Durai,2015-04-21 12:38:48-07:00,"['6874ec04e1e747ed23f76a71b744f9bb43993acb', '46b5ecc33c02229d4c8721a8d616f2a788fef6f0']",0,831,831,708889,11,,,,2339
c5716e5dbe058cefd7bb07079fc4bab3f16b2749,0,sneethiraj,2015-04-21 16:17:52-04:00,['46b5ecc33c02229d4c8721a8d616f2a788fef6f0'],1,15,16,708905,2,,,,2339
d6716f6704b7e359e7551b5876619b3c4e2c77ee,0,Don Bosco Durai,2015-04-21 18:07:17-07:00,"['b7eafa41f48bce00d9bc9e6473cc08078a071412', 'c5716e5dbe058cefd7bb07079fc4bab3f16b2749']",1,15,16,708921,2,,,,2339
35c490d607b6f2f0f0c70cdf2da073d1cf41cf6e,1,Madhan Neethiraj,2015-04-21 21:51:04-07:00,['c5716e5dbe058cefd7bb07079fc4bab3f16b2749'],42,161,203,709124,16,0.468085106,1,1,2339
d8542a270906ce896dec3eaa3303de5d41e4113f,0,Don Bosco Durai,2015-04-21 22:56:05-07:00,"['d6716f6704b7e359e7551b5876619b3c4e2c77ee', '35c490d607b6f2f0f0c70cdf2da073d1cf41cf6e']",42,161,203,709327,16,,,,2339
94bf5903baebfd6dfd2e8947aa2099e3b1a524db,1,sneethiraj,2015-04-22 09:17:48-04:00,['35c490d607b6f2f0f0c70cdf2da073d1cf41cf6e'],53,83,136,709463,3,0,0,1,2339
2f8bcd23477a651cc4d70467045765109286b8fa,1,Velmurugan Periasamy,2015-04-22 10:45:46-04:00,['94bf5903baebfd6dfd2e8947aa2099e3b1a524db'],179,2139,2318,711781,35,0.701882845,0.902719665,0.920502092,2354
42a0e254a4f87c5ce661cc9c300aa03f3cd74ab5,0,Don Bosco Durai,2015-04-22 09:13:27-07:00,"['d8542a270906ce896dec3eaa3303de5d41e4113f', '2f8bcd23477a651cc4d70467045765109286b8fa']",232,2222,2454,714235,38,,,,2354
4f3cea223b9bb717577732bf050bc78f16e94a69,1,Don Bosco Durai,2015-04-22 09:49:01-07:00,['42a0e254a4f87c5ce661cc9c300aa03f3cd74ab5'],733,576,1309,715544,23,0,0.458715596,0,2355
00a24fc6fb8912dfaee5958223c4cea454e57893,1,sneethiraj,2015-04-22 14:51:43-04:00,['94bf5903baebfd6dfd2e8947aa2099e3b1a524db'],4,4,8,715552,3,,,,2355
d9edf2fc1ec79057c56ac7a92d41023bb6dd505c,0,sneethiraj,2015-04-22 14:52:08-04:00,"['00a24fc6fb8912dfaee5958223c4cea454e57893', '4f3cea223b9bb717577732bf050bc78f16e94a69']",1205,3556,4761,720313,59,,,,2355
168c1353141c3f756215bb48b6694d6ae277f4c1,0,sneethiraj,2015-04-22 23:08:49-04:00,['d9edf2fc1ec79057c56ac7a92d41023bb6dd505c'],1,4,5,720318,1,0,0,1,2355
b802bd3eeb19fb885c8086dd303c043b05990ee8,1,sneethiraj,2015-04-23 04:40:39-04:00,['168c1353141c3f756215bb48b6694d6ae277f4c1'],7,251,258,720576,5,0.057971014,1,0.673913043,2357
b05edbc8d568119bb709c65ed5007784dc716407,1,sneethiraj,2015-04-23 05:04:14-04:00,['b802bd3eeb19fb885c8086dd303c043b05990ee8'],11,698,709,721285,17,0,0.308333333,0.883333333,2361
353ce61c9b3a08dbf4c476f37ebb214caed3ece7,1,Velmurugan Periasamy,2015-04-23 05:40:51-04:00,['b05edbc8d568119bb709c65ed5007784dc716407'],8,20,28,721313,1,0,1,1,2361
9cf48048de206258c6cde3bf793694b585b00057,1,Velmurugan Periasamy,2015-04-23 14:49:54-04:00,['353ce61c9b3a08dbf4c476f37ebb214caed3ece7'],48,74,122,721435,3,0,0.0625,0.25,2361
1b08191bda7b509aa35cd339e6c6c0df5d18bbbd,0,sneethiraj,2015-04-23 15:25:04-04:00,['9cf48048de206258c6cde3bf793694b585b00057'],0,4,4,721439,1,,,,2361
f61786d5f945c84772a607e10ee5b0caf989c0c4,0,Madhan Neethiraj,2015-04-23 19:15:06-07:00,['1b08191bda7b509aa35cd339e6c6c0df5d18bbbd'],8,0,8,721447,1,,,,2361
0cff775ce18ca43e66c8eeea51995529f4d3ef31,1,Madhan Neethiraj,2015-04-23 19:32:39-07:00,['f61786d5f945c84772a607e10ee5b0caf989c0c4'],0,3,3,721450,1,,,,2361
214f51eff9c13e6eafa4ddcbdb2bbf3b8f141882,0,sneethiraj,2015-04-23 22:35:26-04:00,['0cff775ce18ca43e66c8eeea51995529f4d3ef31'],7,11,18,721468,1,0,1,1,2361
20baa3f8886defa60411d30152977428b4de8b5f,1,Velmurugan Periasamy,2015-04-24 13:45:23-04:00,['214f51eff9c13e6eafa4ddcbdb2bbf3b8f141882'],110,127,237,721705,5,0,0,0,2361
de6e8459c43b9aa00b52ae5dc51b5655fd206be8,0,Don Bosco Durai,2015-04-24 11:25:44-07:00,['20baa3f8886defa60411d30152977428b4de8b5f'],29,32,61,721766,1,0,0,1,2361
c8376979a73712a8b09410e16bba24cc513a1f6b,0,rmani,2015-04-24 11:44:19-07:00,['168c1353141c3f756215bb48b6694d6ae277f4c1'],2,22,24,721790,1,0,1,1,2361
82960509bd59219fb537f76a3620e8fc21b1abfc,0,rmani,2015-04-24 11:44:33-07:00,"['c8376979a73712a8b09410e16bba24cc513a1f6b', '20baa3f8886defa60411d30152977428b4de8b5f']",192,1181,1373,723163,33,,,,2361
d174576a42d21cf175014629287ccf8f536b7da0,0,Don Bosco Durai,2015-04-24 11:45:46-07:00,"['de6e8459c43b9aa00b52ae5dc51b5655fd206be8', '82960509bd59219fb537f76a3620e8fc21b1abfc']",2,22,24,723187,1,,,,2361
967517d3f58a6057553dcf1357b124d5d638b7f9,0,Velmurugan Periasamy,2015-04-24 16:07:00-04:00,['d174576a42d21cf175014629287ccf8f536b7da0'],2,2,4,723191,1,0,1,1,2361
02a0c32a3332585ffc58caa5567598f754881908,0,sneethiraj,2015-04-25 00:03:23-04:00,['967517d3f58a6057553dcf1357b124d5d638b7f9'],0,6,6,723197,1,,,,2361
0e4ced2f848965cab1355f1ca3a4f96f4c611c35,1,rmani,2015-04-25 01:41:16-07:00,['02a0c32a3332585ffc58caa5567598f754881908'],22,56,78,723275,1,0.586206897,0.793103448,1,2361
06fe51834e0f34b33dabe6f90ba7458e7de01a94,1,Madhan Neethiraj,2015-04-25 18:08:57-07:00,['0e4ced2f848965cab1355f1ca3a4f96f4c611c35'],27,25,52,723327,4,1,1,0.2,2361
b8fe3e97b9e33c009e5cbade757f41ad8504e12c,1,Don Bosco Durai,2015-04-26 22:08:18-07:00,['06fe51834e0f34b33dabe6f90ba7458e7de01a94'],37,656,693,724020,26,0,0.540322581,1,2362
7dea108754afe93500e097b7be2c13f96ddff119,1,Don Bosco Durai,2015-04-27 10:55:06-07:00,['b8fe3e97b9e33c009e5cbade757f41ad8504e12c'],34,31,65,724085,1,1,0,,2362
cafe869708244c3334259f5c297e32e8a772204d,1,Velmurugan Periasamy,2015-04-27 16:07:39-04:00,['7dea108754afe93500e097b7be2c13f96ddff119'],12,294,306,724391,20,0.479674797,0.37398374,0.894308943,2364
dd996d25bb976c9f723eab0b5f89907225f2c039,1,Velmurugan Periasamy,2015-04-27 16:09:00-04:00,['cafe869708244c3334259f5c297e32e8a772204d'],20,414,434,724825,14,0.20661157,0.243801653,0.301652893,2366
88db7079500a6b07e5bc3e03970a2542c2364f1e,1,Madhan Neethiraj,2015-04-27 13:55:30-07:00,['dd996d25bb976c9f723eab0b5f89907225f2c039'],55,52,107,724932,13,,,,2366
27c81a236cec7100cd7ed204d0e888848bf19778,0,Madhan Neethiraj,2015-04-27 17:07:59-07:00,['88db7079500a6b07e5bc3e03970a2542c2364f1e'],57,65,122,725054,2,0,0,0,2366
c18adf68670828bba3e8d54f9fc75625450c5c5b,0,sneethiraj,2015-04-27 21:06:15-04:00,['27c81a236cec7100cd7ed204d0e888848bf19778'],1,11,12,725066,1,1,1,1,2366
06ca4e5f40b237c633f372322ba6be6c4f2c4aac,0,sneethiraj,2015-04-27 23:07:49-04:00,['c18adf68670828bba3e8d54f9fc75625450c5c5b'],0,1,1,725067,1,,,,2366
eb1355eaa2ab9c8747cf0a18290afe601b5a5418,1,sneethiraj,2015-04-27 23:30:03-04:00,['c18adf68670828bba3e8d54f9fc75625450c5c5b'],0,2,2,725069,1,,,,2366
fa7645f2d023b415c8e177ad516b59a342c475be,0,sneethiraj,2015-04-27 23:30:25-04:00,"['eb1355eaa2ab9c8747cf0a18290afe601b5a5418', '06ca4e5f40b237c633f372322ba6be6c4f2c4aac']",0,0,0,725069,0,,,,2366
aac45d633b2d8589446d23326918b6109065dbff,0,Madhan Neethiraj,2015-04-27 20:54:53-07:00,['fa7645f2d023b415c8e177ad516b59a342c475be'],1,2,3,725072,1,,,,2366
101d17673d553dbd2c2369837a8243ab8727bc30,0,Madhan Neethiraj,2015-04-27 22:59:48-07:00,['aac45d633b2d8589446d23326918b6109065dbff'],7,23,30,725102,2,0.692307692,0.692307692,0.692307692,2366
11bb55ba23684293bb4c37b05b8bc19463c76141,1,sneethiraj,2015-04-28 10:47:24-04:00,['101d17673d553dbd2c2369837a8243ab8727bc30'],1415,2589,4004,729106,52,0.292134831,0.192616372,0.878009631,2375
91d1e137483a1c3739cf395f710ca5d37b20019d,1,sneethiraj,2015-04-28 23:38:53-04:00,['11bb55ba23684293bb4c37b05b8bc19463c76141'],164,295,459,729565,12,0.6,0.6,1,2376
3efc0df82150e4c048af08c0911c1db2eab06334,1,sneethiraj,2015-04-29 08:01:35-04:00,['91d1e137483a1c3739cf395f710ca5d37b20019d'],68,45,113,729678,5,,,,2377
e57a5480d0c009e11aefb0205d3f4c560a05d3e1,0,sneethiraj,2015-04-29 14:08:19-04:00,['3efc0df82150e4c048af08c0911c1db2eab06334'],1,1,2,729680,1,,,,2377
dd1ca6f34bb4b316fa6ee97a464c121a541c662d,0,sneethiraj,2015-04-30 10:54:48-04:00,['e57a5480d0c009e11aefb0205d3f4c560a05d3e1'],5,4,9,729689,3,,,,2377
36a6b961d9ceb066ba67a193404bd402fe102110,0,Velmurugan Periasamy,2015-04-30 11:03:39-04:00,['e57a5480d0c009e11aefb0205d3f4c560a05d3e1'],1,1,2,729691,1,,,,2377
218d05ba82351d366081ef1bca4c2a630dbfd3e5,0,sneethiraj,2015-04-30 11:09:31-04:00,"['dd1ca6f34bb4b316fa6ee97a464c121a541c662d', '36a6b961d9ceb066ba67a193404bd402fe102110']",1,1,2,729693,1,,,,2377
2ba2a2e581cb2e6afd1bc288d26fdc8ef369d55c,1,Velmurugan Periasamy,2015-04-30 12:55:23-04:00,['218d05ba82351d366081ef1bca4c2a630dbfd3e5'],0,70,70,729763,2,0.378378378,1,0.378378378,2378
8b092fa299e14a58276375ebefc073b3771481fa,1,Velmurugan Periasamy,2015-04-30 15:31:29-04:00,['2ba2a2e581cb2e6afd1bc288d26fdc8ef369d55c'],7,13,20,729783,1,,,,2378
7c6d268f32da2c00ee6a462772e49f24f13d0069,1,sneethiraj,2015-05-01 02:51:30-04:00,['8b092fa299e14a58276375ebefc073b3771481fa'],7,6,13,729796,1,1,1,0,2378
dd547b8bbf0a9a9a09851ac6b2343743591e9334,1,sneethiraj,2015-05-01 14:39:39-04:00,['7c6d268f32da2c00ee6a462772e49f24f13d0069'],8,22,30,729826,4,0,0,1,2378
adbee0ebe75638a3c8a4b43626b63b55936b1b86,1,sneethiraj,2015-05-01 20:00:30-04:00,['dd547b8bbf0a9a9a09851ac6b2343743591e9334'],3,38,41,729867,2,0,0,1,2378
9adfcbe06fc38dcfad25cfbf4ea8515103b1c074,1,Madhan Neethiraj,2015-05-01 17:34:38-07:00,['dd547b8bbf0a9a9a09851ac6b2343743591e9334'],99,813,912,730779,7,0.7,0.845714286,0.811428571,2381
dbc489a7ffd8e95b7d067a5dea836d840dee9209,1,Madhan Neethiraj,2015-05-01 17:43:18-07:00,['9adfcbe06fc38dcfad25cfbf4ea8515103b1c074'],3102,161,3263,734042,6,0.895171814,0.67246629,0.043497173,2381
b09694dea5607dba7c99d4b7cf64f120d21140c7,0,sneethiraj,2015-05-01 21:36:53-04:00,"['adbee0ebe75638a3c8a4b43626b63b55936b1b86', 'dbc489a7ffd8e95b7d067a5dea836d840dee9209']",3201,974,4175,738217,13,,,,2381
ea9954f4d17ea02c54e7ca9f8f894176846c6462,0,Madhan Neethiraj,2015-05-01 22:07:25-07:00,['b09694dea5607dba7c99d4b7cf64f120d21140c7'],0,4,4,738221,1,1,1,1,2381
2abe4db53c0f6be6a49d50a133eb611a116c6dcd,0,Madhan Neethiraj,2015-05-02 13:55:59-07:00,['ea9954f4d17ea02c54e7ca9f8f894176846c6462'],6,4,10,738231,1,,,,2381
cab5b3da81d7fcfeda86dfaf9b63f936a45e3161,1,Velmurugan Periasamy,2015-05-04 10:19:03-04:00,['2abe4db53c0f6be6a49d50a133eb611a116c6dcd'],117,161,278,738509,1,0.25,0.25,0.708333333,2381
83b6a0a0399fa3d6f51fb6e8eb6b19467904213b,1,Velmurugan Periasamy,2015-05-04 10:44:00-04:00,['cab5b3da81d7fcfeda86dfaf9b63f936a45e3161'],11,27,38,738547,6,0,0,1,2381
73b22d3eba0b150907349ecfed39136f1d4bf772,1,Velmurugan Periasamy,2015-05-04 12:43:59-04:00,['83b6a0a0399fa3d6f51fb6e8eb6b19467904213b'],25,26,51,738598,16,,,,2381
5ac7c52ad1b9f4d68cd2226e29af412c127d5c53,1,Madhan Neethiraj,2015-05-04 13:50:16-07:00,['73b22d3eba0b150907349ecfed39136f1d4bf772'],93,266,359,738957,15,0.408602151,1,1,2382
4faca7151f72c39a5997e4b79bd250183ad14987,0,Madhan Neethiraj,2015-05-04 14:04:42-07:00,['5ac7c52ad1b9f4d68cd2226e29af412c127d5c53'],14,21,35,738992,2,0,0.5,1,2382
b28a924dc3199dfd1986419c1f9f63cfcdeadd32,1,Madhan Neethiraj,2015-05-04 15:12:58-07:00,['4faca7151f72c39a5997e4b79bd250183ad14987'],0,9,9,739001,1,0,0,1,2382
ee9d78bbb96c7d1eecf05ec5494d7c728ac220f6,1,Madhan Neethiraj,2015-05-04 16:49:45-07:00,['b28a924dc3199dfd1986419c1f9f63cfcdeadd32'],9,17,26,739027,6,,,,2382
8a9b57ed59ddd1d20b5529b9a8336d8e179c5165,1,Madhan Neethiraj,2015-05-05 11:04:31-07:00,['ee9d78bbb96c7d1eecf05ec5494d7c728ac220f6'],19,39,58,739085,2,0,0,0,2382
9a2aefb7281934b52a5050d0cbbc2119c17f3210,1,Velmurugan Periasamy,2015-05-06 00:33:32-04:00,['8a9b57ed59ddd1d20b5529b9a8336d8e179c5165'],390,46,436,739521,13,0.142857143,0.142857143,0.102040816,2382
8f30ebd353e4f1b2542bf42bd6a13bfc09592a2b,0,Velmurugan Periasamy,2015-05-06 00:35:23-04:00,['9a2aefb7281934b52a5050d0cbbc2119c17f3210'],75,206,281,739802,23,0.070707071,0.090909091,0.96969697,2382
51184bb89d72fc51a96702d3c22b66f03ffe13cb,1,Velmurugan Periasamy,2015-05-06 01:53:25-04:00,['8f30ebd353e4f1b2542bf42bd6a13bfc09592a2b'],68,381,449,740251,6,0,0,1,2382
a8b093ad44611c895140dc59cba2c25c627fc2a1,0,sneethiraj,2015-05-06 00:56:28-07:00,['51184bb89d72fc51a96702d3c22b66f03ffe13cb'],0,1,1,740252,1,0,1,1,2382
39136c5d6dd391caa9b1a365cb02d0675557ce07,1,Velmurugan Periasamy,2015-05-06 08:28:32-04:00,['a8b093ad44611c895140dc59cba2c25c627fc2a1'],206,75,281,740533,23,0.929292929,0.909090909,0.03030303,2382
376b0ea65919176dcdc194da5f9559a66f80bd8c,1,Velmurugan Periasamy,2015-05-06 08:31:15-04:00,['39136c5d6dd391caa9b1a365cb02d0675557ce07'],78,219,297,740830,26,0.064220183,0.082568807,0.972477064,2382
6a9b140c7b0b749fdd6c5d860b3762fab0702643,0,Velmurugan Periasamy,2015-05-06 16:48:05-04:00,['376b0ea65919176dcdc194da5f9559a66f80bd8c'],0,2,2,740832,1,,,,2382
b19fd5bf0e84a4d1b20837061922f78c67c77a2b,0,Velmurugan Periasamy,2015-05-06 16:49:29-04:00,['6a9b140c7b0b749fdd6c5d860b3762fab0702643'],12,0,12,740844,1,1,1,0,2382
cdcb1c049ea838184f0dfd70cacc6f835062401d,0,sneethiraj,2015-05-07 10:13:10-07:00,['b19fd5bf0e84a4d1b20837061922f78c67c77a2b'],5,153,158,741002,10,,,,2382
7ac04f9d3389aa71b6b0ce6804abe6e8d527ca5e,1,Madhan Neethiraj,2015-05-08 12:36:28-07:00,['cdcb1c049ea838184f0dfd70cacc6f835062401d'],297,1075,1372,742374,15,0.206773619,0.643493761,0.67201426,2382
2a429d7036ebf019b6b87900ef1ca89372f4ff97,0,sneethiraj,2015-05-09 10:59:38-07:00,['7ac04f9d3389aa71b6b0ce6804abe6e8d527ca5e'],0,1,1,742375,1,,,,2382
f991a8b62c3b735c0e30518bc3b0df3de46035e5,1,Madhan Neethiraj,2015-05-11 14:53:56-07:00,['2a429d7036ebf019b6b87900ef1ca89372f4ff97'],123,239,362,742737,13,0,0.417582418,0.098901099,2382
ff9609cf7f77074fd291250f32f8494786415982,1,sneethiraj,2015-05-11 22:03:53-07:00,['2a429d7036ebf019b6b87900ef1ca89372f4ff97'],1,1,2,742739,1,,,,2382
603812176e0f034a7a5b5fd06e5a7cef84442e37,0,sneethiraj,2015-05-11 22:04:13-07:00,"['ff9609cf7f77074fd291250f32f8494786415982', 'f991a8b62c3b735c0e30518bc3b0df3de46035e5']",123,239,362,743101,13,,,,2382
fd7d0805f726c8a4f2b32295160c116c5106e2ae,0,sneethiraj,2015-05-11 22:07:40-07:00,['603812176e0f034a7a5b5fd06e5a7cef84442e37'],22,28,50,743151,1,0.5,0.5,1,2382
5c3bc5c8d082a3e39f6aab94f0c8dab2acbd2628,0,sneethiraj,2015-05-11 23:18:25-07:00,['fd7d0805f726c8a4f2b32295160c116c5106e2ae'],1,1,2,743153,1,,,,2382
5ef5ed1ade1ccaf2b6ab03914d28c068ee855417,0,Madhan Neethiraj,2015-05-11 23:23:29-07:00,['fd7d0805f726c8a4f2b32295160c116c5106e2ae'],4,14,18,743171,4,0,1,1,2382
2dcbb3436bdc2ff777a4f14efc1019710f2fdd1c,0,sneethiraj,2015-05-11 23:25:40-07:00,"['5c3bc5c8d082a3e39f6aab94f0c8dab2acbd2628', '5ef5ed1ade1ccaf2b6ab03914d28c068ee855417']",4,14,18,743189,4,,,,2382
f01ac18f3386db9725debfb293d972691a88d18b,0,Velmurugan Periasamy,2015-05-12 12:29:15-04:00,['2dcbb3436bdc2ff777a4f14efc1019710f2fdd1c'],0,30,30,743219,6,,,,2382
8cedfa55cbdb73b8a3be59d287a6ce02c43cc1ca,1,Madhan Neethiraj,2015-05-12 10:27:59-07:00,['f01ac18f3386db9725debfb293d972691a88d18b'],307,560,867,744086,26,1,0.408450704,1,2382
faad91ad074355f737e099c9864b3dac1a8caae8,1,sneethiraj,2015-05-12 16:38:15-07:00,['8cedfa55cbdb73b8a3be59d287a6ce02c43cc1ca'],0,7,7,744093,1,,,,2382
0c55fa61b2aab5195134df59a93cd419790e7a78,0,Madhan Neethiraj,2015-05-13 10:23:54-07:00,['faad91ad074355f737e099c9864b3dac1a8caae8'],1,1,2,744095,1,,,,2382
fa4f291a26cc7dea1238eb2eb6e0bcfc7c6cf95a,1,Madhan Neethiraj,2015-05-14 09:02:46-07:00,['0c55fa61b2aab5195134df59a93cd419790e7a78'],35,42,77,744172,2,0,0,0,2382
8aef120e72545f014a438a31c7c20c5398f3cf62,1,Madhan Neethiraj,2015-05-14 09:32:00-07:00,['fa4f291a26cc7dea1238eb2eb6e0bcfc7c6cf95a'],88,9,97,744269,2,0,0,0,2382
97f1d5d05d5851c81d4ef57960b4c891d7633952,1,rmani,2015-05-14 14:58:58-07:00,['8aef120e72545f014a438a31c7c20c5398f3cf62'],5,24,29,744298,2,0,0.090909091,1,2382
f9fb6110274803c949b6262270b288b0274aa299,1,rmani,2015-05-14 15:12:05-07:00,['97f1d5d05d5851c81d4ef57960b4c891d7633952'],77,104,181,744479,1,0.0625,1,1,2382
e3f0f41d7d8b4637dce50680c463578f1eacb9a9,1,rmani,2015-05-14 15:51:06-07:00,['f9fb6110274803c949b6262270b288b0274aa299'],36,54,90,744569,8,0.444444444,0.444444444,0,2382
be2c12ff8332b901f02c30b95dd4ecac3a9ffdfd,1,Madhan Neethiraj,2015-05-14 16:11:12-07:00,['e3f0f41d7d8b4637dce50680c463578f1eacb9a9'],5,98,103,744672,4,0.607843137,0.607843137,0.647058824,2382
362acbcbe8f95643a6b47784388b38085d38d750,0,Madhan Neethiraj,2015-05-14 21:17:14-07:00,['be2c12ff8332b901f02c30b95dd4ecac3a9ffdfd'],213,263,476,745148,9,1,1,1,2383
0cf4d406a66663eb05527a35fa18e657ab232997,1,Madhan Neethiraj,2015-05-14 21:25:11-07:00,['be2c12ff8332b901f02c30b95dd4ecac3a9ffdfd'],213,263,476,745624,9,1,1,1,2384
6222b9d09bcfafc56e9e53e725c9c665213573b6,0,Madhan Neethiraj,2015-05-14 21:25:32-07:00,"['0cf4d406a66663eb05527a35fa18e657ab232997', '362acbcbe8f95643a6b47784388b38085d38d750']",0,0,0,745624,0,,,,2384
a7ca7c67488cddcd85364bbfcb91fc9f36d1b504,1,Don Bosco Durai,2015-05-15 14:06:42-07:00,['6222b9d09bcfafc56e9e53e725c9c665213573b6'],131,486,617,746241,11,0.38277512,0.444976077,0.813397129,2385
0f8d0c5f7550d0c5109face03fce4ea24247a663,1,Madhan Neethiraj,2015-05-17 00:04:42-07:00,['a7ca7c67488cddcd85364bbfcb91fc9f36d1b504'],5,16,21,746262,1,0,0,0,2385
cdf6df9350f7040364d8a4b0295b54589568cc23,1,Velmurugan Periasamy,2015-05-17 11:29:30-04:00,['0f8d0c5f7550d0c5109face03fce4ea24247a663'],2,15,17,746279,2,,,,2385
64582f029e4eedc38e636aac0144134b1146abd7,1,sneethiraj,2015-05-17 13:33:14-04:00,['cdf6df9350f7040364d8a4b0295b54589568cc23'],8,135,143,746422,4,0.142857143,0,0.969387755,2385
0336e2b2c7a0cadd99b2dcc2a1afa7fb3439f503,1,sneethiraj,2015-05-17 14:11:18-04:00,['64582f029e4eedc38e636aac0144134b1146abd7'],57,72,129,746551,5,1,0,1,2385
f72e949ebdbac471ad858f74839f5341bbe43275,1,Velmurugan Periasamy,2015-05-17 15:29:22-04:00,['0336e2b2c7a0cadd99b2dcc2a1afa7fb3439f503'],6,4,10,746561,1,,,,2385
5ac45ecc0c7a2dbfe0630441795a0bdaab5ec8b3,1,Velmurugan Periasamy,2015-05-17 16:00:34-04:00,['f72e949ebdbac471ad858f74839f5341bbe43275'],3,28,31,746592,3,0.15,0.15,1,2385
ec1543926abf2bb88bbad8ac61d84e9b5858b06e,0,sneethiraj,2015-05-17 16:51:57-04:00,['0336e2b2c7a0cadd99b2dcc2a1afa7fb3439f503'],9,31,40,746632,4,0,0,1,2385
5b98513833465c3ded8ed8e1c5e89ec8d7a42594,0,sneethiraj,2015-05-17 17:01:43-04:00,"['ec1543926abf2bb88bbad8ac61d84e9b5858b06e', '5ac45ecc0c7a2dbfe0630441795a0bdaab5ec8b3']",9,32,41,746673,4,,,,2385
a5f8531a17558cfc75e2ad216816f272705898cf,0,Don Bosco Durai,2015-05-17 14:44:51-07:00,['5b98513833465c3ded8ed8e1c5e89ec8d7a42594'],71,259,330,747003,6,0.406593407,0.802197802,0.604395604,2385
82743e2a49de5cd7a25f226a285c65be79bdc215,1,sneethiraj,2015-05-17 17:55:16-04:00,['5b98513833465c3ded8ed8e1c5e89ec8d7a42594'],1,79,80,747083,4,1,1,1,2386
a65852b2ff5c5d1f299b075245ef5f541547b046,0,sneethiraj,2015-05-17 17:55:46-04:00,"['82743e2a49de5cd7a25f226a285c65be79bdc215', 'a5f8531a17558cfc75e2ad216816f272705898cf']",71,259,330,747413,6,,,,2386
aff40741dc0aba53dbd492921bfbce7ede7be475,0,sneethiraj,2015-05-17 17:58:09-04:00,['a65852b2ff5c5d1f299b075245ef5f541547b046'],1,10,11,747424,4,,,,2386
33ec87ec660e447b16bce4d6181b4ed877c572c2,1,sneethiraj,2015-05-17 18:12:00-04:00,['aff40741dc0aba53dbd492921bfbce7ede7be475'],259,71,330,747754,6,0.593406593,0.197802198,0.395604396,2386
1031041296e64d193e4234e80823ebc8e4ee7e91,0,sneethiraj,2015-05-17 18:30:27-04:00,['33ec87ec660e447b16bce4d6181b4ed877c572c2'],0,3,3,747757,2,0,0,0.666666667,2386
f0c9216dafbe81cbbe7ae9696c9f6de456ebfac6,1,sneethiraj,2015-05-17 18:40:00-04:00,['1031041296e64d193e4234e80823ebc8e4ee7e91'],74,258,332,748089,6,0.406593407,0.802197802,0.604395604,2386
88d2ebe29e262823441a440d93375e154b1812f5,0,sneethiraj,2015-05-18 00:21:32-04:00,['f0c9216dafbe81cbbe7ae9696c9f6de456ebfac6'],1,1,2,748091,1,,,,2386
a5c771bc58340ac016c98081729b4c04caba59f7,1,sneethiraj,2015-05-18 01:07:08-04:00,['88d2ebe29e262823441a440d93375e154b1812f5'],6,6,12,748103,1,,,,2386
c484cecae0ea726ea74a8a97f9724f9076edb584,0,sneethiraj,2015-05-18 02:07:57-04:00,['a5c771bc58340ac016c98081729b4c04caba59f7'],0,5,5,748108,1,,,,2386
fa19908a9bc6d2f80a26635d48012c87341b1f5d,1,sneethiraj,2015-05-18 02:36:31-04:00,['c484cecae0ea726ea74a8a97f9724f9076edb584'],3,6,9,748117,1,0,1,1,2386
049c13be5a2e3f6bade6f9589937bd0225563ce0,0,Madhan Neethiraj,2015-05-18 06:27:43-07:00,['fa19908a9bc6d2f80a26635d48012c87341b1f5d'],0,5,5,748122,1,,,,2386
49d1fdbd166bec6c90878d007c90ded3631acccb,0,Madhan Neethiraj,2015-05-18 06:27:43-07:00,['049c13be5a2e3f6bade6f9589937bd0225563ce0'],11,100,111,748233,12,0.444444444,0.805555556,0.638888889,2386
79a4f9dbd62900459959a7183fe173ffb8d95865,1,Madhan Neethiraj,2015-05-18 15:06:00-07:00,['49d1fdbd166bec6c90878d007c90ded3631acccb'],1,141,142,748375,4,0.540540541,0.756756757,1,2386
b84b391e88066cd3a00daf8bcb97611149fcd8eb,0,sneethiraj,2015-05-18 18:38:19-04:00,['fa19908a9bc6d2f80a26635d48012c87341b1f5d'],1,1,2,748377,1,,,,2386
7ed35a9b0cbf589ff9964c0c2670907c58a98caf,1,Velmurugan Periasamy,2015-05-18 19:45:18-04:00,['fa19908a9bc6d2f80a26635d48012c87341b1f5d'],179,207,386,748763,23,0.714285714,1,1,2386
804e666340f69a3dc9643943aba847c14de85b4a,0,sneethiraj,2015-05-18 20:29:50-04:00,"['b84b391e88066cd3a00daf8bcb97611149fcd8eb', '7ed35a9b0cbf589ff9964c0c2670907c58a98caf']",179,207,386,749149,23,,,,2386
df27a36038f52c34fb323dbfc54b4670c27431b8,1,sneethiraj,2015-05-19 01:39:55-04:00,['804e666340f69a3dc9643943aba847c14de85b4a'],11,19,30,749179,1,,,,2386
6ffacc62327e28746a17adfe247a8f952982d3f5,0,sneethiraj,2015-05-19 01:42:40-04:00,['804e666340f69a3dc9643943aba847c14de85b4a'],10,18,28,749207,1,,,,2386
80ce0eff60f0684caef5e3cc188833574c34bde8,0,sneethiraj,2015-05-19 01:43:02-04:00,"['6ffacc62327e28746a17adfe247a8f952982d3f5', 'df27a36038f52c34fb323dbfc54b4670c27431b8']",1,1,2,749209,1,,,,2386
0c0d8e3c303f6e76c17ef45c94a795330356169b,1,sneethiraj,2015-05-19 01:44:24-04:00,['80ce0eff60f0684caef5e3cc188833574c34bde8'],1,1,2,749211,1,,,,2386
58b8d36930ec396670fc3de0b4d021e2ebc16dbd,1,sneethiraj,2015-05-19 03:00:11-04:00,['0c0d8e3c303f6e76c17ef45c94a795330356169b'],0,74,74,749285,1,,,,2387
d03332064db212dea8c54e108356432f9ce54feb,1,sneethiraj,2015-05-19 03:02:56-04:00,['58b8d36930ec396670fc3de0b4d021e2ebc16dbd'],8,78,86,749371,2,0,0,1,2387
3c2facfda17d05089935ecdb8adbad40bd41f393,1,sneethiraj,2015-05-19 03:05:51-04:00,['d03332064db212dea8c54e108356432f9ce54feb'],20,24,44,749415,2,,,,2387
a2c9654a40886e5708cb1adf6d6486c77b71a45d,0,sneethiraj,2015-05-19 03:13:34-04:00,['3c2facfda17d05089935ecdb8adbad40bd41f393'],1,0,1,749416,1,,,,2387
18595792f3b47b69eee652cb1136426dd3b9b113,0,Madhan Neethiraj,2015-05-19 08:45:06-07:00,['a2c9654a40886e5708cb1adf6d6486c77b71a45d'],8,3,11,749427,2,0,0,0,2387
68d01056ca4386c541dfc4cde9fc974391d12749,1,sneethiraj,2015-05-19 13:56:26-04:00,['18595792f3b47b69eee652cb1136426dd3b9b113'],153,194,347,749774,8,0,0,1,2387
154c49041863f040ce99c5d45fa5e996968ced96,0,Madhan Neethiraj,2015-05-19 11:57:28-07:00,['68d01056ca4386c541dfc4cde9fc974391d12749'],23,637,660,750434,9,0.549828179,0.75257732,0.731958763,2390
afe001bb7c734d10cca1f9189241f1bdecae7de1,1,Madhan Neethiraj,2015-05-19 12:51:11-07:00,['154c49041863f040ce99c5d45fa5e996968ced96'],14,22,36,750470,1,0,0,0,2390
3ecc107409265a4a61edf4784aa6234af7d2cd3c,0,Madhan Neethiraj,2015-05-19 15:08:22-07:00,['79a4f9dbd62900459959a7183fe173ffb8d95865'],1,1,2,750472,1,,,,2390
ce43b3978adef90fba382f81f809fe2a6780848b,1,Madhan Neethiraj,2015-05-19 15:08:22-07:00,['3ecc107409265a4a61edf4784aa6234af7d2cd3c'],179,207,386,750858,23,0.714285714,1,1,2390
dc8ef17ae5ce17892844fb2b408c95d61b19d000,0,Madhan Neethiraj,2015-05-19 15:08:22-07:00,['ce43b3978adef90fba382f81f809fe2a6780848b'],11,19,30,750888,1,,,,2390
2c16bc8fcdb166b823f126b61e893bdb35f3f170,0,Madhan Neethiraj,2015-05-19 15:08:22-07:00,['dc8ef17ae5ce17892844fb2b408c95d61b19d000'],1,1,2,750890,1,,,,2390
803485841366d4c73ef3dd0add178ee7a952d178,0,Madhan Neethiraj,2015-05-19 15:08:22-07:00,['2c16bc8fcdb166b823f126b61e893bdb35f3f170'],0,74,74,750964,1,,,,2391
5dc535e61185a305c74d567c83963752338e21f0,0,Madhan Neethiraj,2015-05-19 15:08:22-07:00,['803485841366d4c73ef3dd0add178ee7a952d178'],8,78,86,751050,2,0,0,1,2391
8c3504ca5c9f78d154f719fdc477a88fa3bd3ec6,0,Madhan Neethiraj,2015-05-19 15:08:22-07:00,['5dc535e61185a305c74d567c83963752338e21f0'],20,24,44,751094,2,,,,2391
f0ce97300aefffee29b034f060b319bda588faed,0,Madhan Neethiraj,2015-05-19 15:08:23-07:00,['8c3504ca5c9f78d154f719fdc477a88fa3bd3ec6'],1,0,1,751095,1,,,,2391
a826b1bbc7f3ef334ec1e087d354839dfb7cb3ac,0,Madhan Neethiraj,2015-05-19 15:08:23-07:00,['f0ce97300aefffee29b034f060b319bda588faed'],8,3,11,751106,2,0,0,0,2391
9a06c6461b43bd82746d258f5be901c926f36c5d,1,Madhan Neethiraj,2015-05-19 15:08:23-07:00,['a826b1bbc7f3ef334ec1e087d354839dfb7cb3ac'],153,194,347,751453,8,0,0,1,2391
7381bc4e971bf4383669584415143dccb6b0a918,1,Madhan Neethiraj,2015-05-19 15:08:23-07:00,['9a06c6461b43bd82746d258f5be901c926f36c5d'],23,637,660,752113,9,0.549828179,0.75257732,0.731958763,2394
0e076ddc7e011bd0f248ebbf15a3860f8ea3390f,0,Madhan Neethiraj,2015-05-19 15:08:23-07:00,['7381bc4e971bf4383669584415143dccb6b0a918'],14,22,36,752149,1,0,0,0,2394
b5a23b273e39a606b19673018290e124d4527620,0,Madhan Neethiraj,2015-05-19 15:08:23-07:00,['0e076ddc7e011bd0f248ebbf15a3860f8ea3390f'],1,1,2,752151,1,,,,2394
de5ea54217ffe910664e7844c7038876ecf76fa7,0,rmani,2015-05-19 15:15:39-07:00,['afe001bb7c734d10cca1f9189241f1bdecae7de1'],3,4,7,752158,1,0,0,0,2394
6e017928ef11e9031f404ee06a44f659a8192b98,0,Don Bosco Durai,2015-05-19 15:55:32-07:00,['de5ea54217ffe910664e7844c7038876ecf76fa7'],1,1,2,752160,1,,,,2394
9578f94cdf0dd0e6ea31bb4c524edfda82576ef4,1,Madhan Neethiraj,2015-05-19 20:14:43-07:00,['b5a23b273e39a606b19673018290e124d4527620'],199,2752,2951,755111,27,0.395516413,0.680544436,0.951160929,2408
e9d9aed394cc6ecf26ec7d2711f951de3866520d,0,sneethiraj,2015-05-20 17:09:27-04:00,['6e017928ef11e9031f404ee06a44f659a8192b98'],0,5,5,755116,1,,,,2408
d04a9a2fb3d0b7f64820d0db8476a08748ab15dd,1,Don Bosco Durai,2015-05-21 01:02:47-07:00,['e9d9aed394cc6ecf26ec7d2711f951de3866520d'],7,18,25,755141,1,0,0,1,2408
54caee221cb7a04b8b61d857464d1faf66ac9830,0,Don Bosco Durai,2015-05-21 01:05:58-07:00,['d04a9a2fb3d0b7f64820d0db8476a08748ab15dd'],3,11,14,755155,1,0,0,1,2408
0ed45e380c02ce606a8c063c75d4ad854537a66f,0,Madhan Neethiraj,2015-05-21 15:44:03-07:00,['9578f94cdf0dd0e6ea31bb4c524edfda82576ef4'],1,1,2,755157,1,,,,2408
b42dfb0a57d643374761673bf2c6ec1380d306c2,0,Madhan Neethiraj,2015-05-21 15:50:16-07:00,['0ed45e380c02ce606a8c063c75d4ad854537a66f'],3,4,7,755164,1,0,0,0,2408
3c22cfa12b86e400bf8d6af4407010b9becd58fc,0,Madhan Neethiraj,2015-05-21 15:50:16-07:00,['b42dfb0a57d643374761673bf2c6ec1380d306c2'],1,1,2,755166,1,,,,2408
ea7f715bae3a9c96b018b79195c5a7721e79f19d,0,Madhan Neethiraj,2015-05-21 15:50:16-07:00,['3c22cfa12b86e400bf8d6af4407010b9becd58fc'],0,5,5,755171,1,,,,2408
b8d5bb27f57f6df7be4b527352a1ae70b3bdd495,1,Madhan Neethiraj,2015-05-21 15:50:16-07:00,['ea7f715bae3a9c96b018b79195c5a7721e79f19d'],7,18,25,755196,1,0,0,1,2408
6568faabbdb2a593ad276c8a9db2a0523195ed6e,1,Madhan Neethiraj,2015-05-21 15:50:16-07:00,['b8d5bb27f57f6df7be4b527352a1ae70b3bdd495'],3,11,14,755210,1,0,0,1,2408
6de1bbc8f6382a3fa774205ddbb4b9d36dec769e,0,sneethiraj,2015-05-22 08:49:17-04:00,['54caee221cb7a04b8b61d857464d1faf66ac9830'],15,15,30,755240,3,,,,2408
0421271e2b891a7fe0ade809e0e41f720fafe62a,1,sneethiraj,2015-05-22 09:31:48-04:00,['6de1bbc8f6382a3fa774205ddbb4b9d36dec769e'],20,125,145,755385,9,0,0,1,2408
0247590194798870a528fc32088a37b329d69fae,1,Madhan Neethiraj,2015-05-22 17:05:37-07:00,['6568faabbdb2a593ad276c8a9db2a0523195ed6e'],71,314,385,755770,6,0.156069364,0.138728324,1,2408
14ec7d526b344a597f81b31613416c383c94f467,1,sneethiraj,2015-05-22 20:24:41-04:00,['0421271e2b891a7fe0ade809e0e41f720fafe62a'],180,457,637,756407,2,0.024793388,0.070247934,0.76446281,2408
f31274b8694563655691734ed74f6617109dc794,1,Madhan Neethiraj,2015-05-22 17:55:34-07:00,['14ec7d526b344a597f81b31613416c383c94f467'],122,270,392,756799,21,0,0.884615385,1,2409
3e4af58f53a31da151cad1b1d91602861db88f26,0,Madhan Neethiraj,2015-05-22 18:20:19-07:00,"['0247590194798870a528fc32088a37b329d69fae', 'f31274b8694563655691734ed74f6617109dc794']",337,867,1204,758003,35,,,,2409
115577a6f1afdc0cee2b029117c9796a98574755,1,Don Bosco Durai,2015-05-23 21:17:12-07:00,['f31274b8694563655691734ed74f6617109dc794'],282,404,686,758689,8,0.373626374,0.098901099,0.593406593,2409
ec7ac830af30fefd617f831d9f099bf58dc42a4b,1,Madhan Neethiraj,2015-05-24 03:07:51-07:00,['115577a6f1afdc0cee2b029117c9796a98574755'],5,12,17,758706,8,0,0.2,0,2409
5e9ff8a200cbe37ebe278c379993ec415b84376e,0,Madhan Neethiraj,2015-05-24 21:23:27-07:00,"['3e4af58f53a31da151cad1b1d91602861db88f26', 'ec7ac830af30fefd617f831d9f099bf58dc42a4b']",292,416,708,759414,16,,,,2409
d61bce5c4431a5dda9a5b21aeaa320690795ec99,1,Madhan Neethiraj,2015-05-25 11:41:18-07:00,['5e9ff8a200cbe37ebe278c379993ec415b84376e'],454,862,1316,760730,26,0.164179104,0.059701493,0.791044776,2410
48a2cd1ec74e1b90fd606042646f62d60c331007,1,Don Bosco Durai,2015-05-26 11:22:18-07:00,['ec7ac830af30fefd617f831d9f099bf58dc42a4b'],109,68,177,760907,1,0.869565217,0.326086957,0.065217391,2410
0d8479394c4912d18ccad61979cd4e9bb8cc6713,0,Don Bosco Durai,2015-05-26 12:40:01-07:00,['48a2cd1ec74e1b90fd606042646f62d60c331007'],5,13,18,760925,1,0,1,1,2410
5596d2ecda5e50a3d3883b97d5ec3eac298df6f9,0,Don Bosco Durai,2015-05-26 13:55:07-07:00,['0d8479394c4912d18ccad61979cd4e9bb8cc6713'],2,0,2,760927,1,1,0,0,2410
d8f7a960540860137656ace18dd668f1465fd556,0,Madhan Neethiraj,2015-05-26 16:49:56-07:00,['d61bce5c4431a5dda9a5b21aeaa320690795ec99'],46,132,178,761105,17,0.659090909,0.659090909,0.954545455,2410
80c46f22f2790f8dfe5eea66d4fd433c469c2a0d,1,Don Bosco Durai,2015-05-26 16:51:09-07:00,['5596d2ecda5e50a3d3883b97d5ec3eac298df6f9'],0,79,79,761184,2,0.75,1,1,2410
51fba28de89992a92e06804711823370a3e674b9,1,Madhan Neethiraj,2015-05-26 18:24:08-07:00,['d8f7a960540860137656ace18dd668f1465fd556'],22,267,289,761473,11,0.168316832,0.683168317,1,2412
f796d82bdb3104dd3f74afa51d36c414e9e88041,0,Madhan Neethiraj,2015-05-26 19:52:06-07:00,"['51fba28de89992a92e06804711823370a3e674b9', '80c46f22f2790f8dfe5eea66d4fd433c469c2a0d']",118,158,276,761749,3,,,,2412
893cfc664a6a75efa5ba1d33cfff1e4d7c669cbb,1,Madhan Neethiraj,2015-05-26 23:37:03-07:00,['f796d82bdb3104dd3f74afa51d36c414e9e88041'],2,7,9,761758,1,1,1,1,2412
776533f9463a2c9e7c6e4c83845e955bc70d4820,1,Madhan Neethiraj,2015-05-27 17:30:30-07:00,['80c46f22f2790f8dfe5eea66d4fd433c469c2a0d'],217,430,647,762405,3,0.890243902,1,1,2414
c8c98ea97a35a36821d2842b0beaf37cf2b68bcf,0,Madhan Neethiraj,2015-05-27 21:09:34-07:00,"['893cfc664a6a75efa5ba1d33cfff1e4d7c669cbb', '776533f9463a2c9e7c6e4c83845e955bc70d4820']",217,430,647,763052,3,,,,2414
0d73c38af9a80c00ff2ddfd7dba09c4b6b914990,0,Dilli Dorai Arumugam,2015-05-27 22:07:06-07:00,['776533f9463a2c9e7c6e4c83845e955bc70d4820'],8,0,8,763060,1,,,,2414
d79401bb429754ef9d4203f6c78c28606c922ccb,1,Velmurugan Periasamy,2015-05-28 21:18:24-04:00,['0d73c38af9a80c00ff2ddfd7dba09c4b6b914990'],94,273,367,763427,3,0.111111111,0.283950617,0.827160494,2414
fb6e94f13e674988d7d237211f29a24a80fdc3d4,1,Madhan Neethiraj,2015-05-28 20:27:57-07:00,['d79401bb429754ef9d4203f6c78c28606c922ccb'],18,7,25,763452,1,1,0.818181818,1,2414
525fd59ce576f9a002d817938214ce36aa3ab10b,1,Madhan Neethiraj,2015-05-28 20:31:49-07:00,['c8c98ea97a35a36821d2842b0beaf37cf2b68bcf'],412,423,835,764287,20,0,1,0,2417
2474fed115430d54be8be95caec5f66703b3c83c,0,Madhan Neethiraj,2015-05-28 20:40:45-07:00,"['525fd59ce576f9a002d817938214ce36aa3ab10b', 'fb6e94f13e674988d7d237211f29a24a80fdc3d4']",120,280,400,764687,5,,,,2417
f0a8931a8c1847470e486ffdf59c70814270ce9d,1,Madhan Neethiraj,2015-05-28 20:47:54-07:00,['fb6e94f13e674988d7d237211f29a24a80fdc3d4'],6,66,72,764759,2,0,1,1,2417
dda7a165c5a7c80d13023c91a095a373a6dd3e70,1,Velmurugan Periasamy,2015-05-29 10:16:55-04:00,['f0a8931a8c1847470e486ffdf59c70814270ce9d'],63,57,120,764879,5,0,0,0,2417
9e5bd854013e7529994ab81fff53c18d57aa4081,1,Velmurugan Periasamy,2015-05-29 10:48:58-04:00,['dda7a165c5a7c80d13023c91a095a373a6dd3e70'],0,12,12,764891,2,,,,2417
a2de2450a572468af1928d5d021567c39544e193,1,Don Bosco Durai,2015-05-29 14:54:22-07:00,['9e5bd854013e7529994ab81fff53c18d57aa4081'],5,409,414,765305,10,0.190114068,0.634980989,1,2418
94ba6beb3841f094d5800619275d80296a8b54b6,1,Don Bosco Durai,2015-05-30 12:14:19-07:00,['a2de2450a572468af1928d5d021567c39544e193'],62,66,128,765433,9,1,0,1,2418
ab4683eb1fa325494b36b516ef2d80a2962f4548,1,sneethiraj,2015-05-30 23:15:04-04:00,['94ba6beb3841f094d5800619275d80296a8b54b6'],77,49,126,765559,6,1,1,1,2418
29f8f2027f7703dcb144f4bd87499fe3d8459a88,1,sneethiraj,2015-05-30 23:48:27-04:00,['ab4683eb1fa325494b36b516ef2d80a2962f4548'],2,4,6,765565,1,0,0,1,2418
a097b7f8f2919544819f35edced710c8020dc0d1,1,sneethiraj,2015-05-30 23:57:24-04:00,['29f8f2027f7703dcb144f4bd87499fe3d8459a88'],23,34,57,765622,5,0.333333333,0.333333333,0.666666667,2418
3250e5c22fb4d4f5048b62bb2d26fc8b706d5caa,0,sneethiraj,2015-05-31 00:27:34-04:00,['a097b7f8f2919544819f35edced710c8020dc0d1'],12,7,19,765641,3,1,1,1,2418
c510b449d0564aa165007810fcf87a3587cec291,1,sneethiraj,2015-05-31 09:39:13-04:00,['3250e5c22fb4d4f5048b62bb2d26fc8b706d5caa'],182,610,792,766433,26,0.190661479,0.373540856,0.922178988,2418
e92b2d38fa513ae9b92644f9cd72e61818dc41b6,1,Don Bosco Durai,2015-05-31 23:47:26-07:00,['c510b449d0564aa165007810fcf87a3587cec291'],33,384,417,766850,14,0.478991597,0.588235294,1,2419
e0e5105c9c2ef6a92f47c723fee3b8948518e28c,0,Don Bosco Durai,2015-06-01 00:11:47-07:00,['e92b2d38fa513ae9b92644f9cd72e61818dc41b6'],23,3,26,766876,3,0,0,0,2419
681e1ef5ca8d1475a47fd434bd53afbee5b8a51d,1,sneethiraj,2015-06-01 10:55:40-04:00,['e0e5105c9c2ef6a92f47c723fee3b8948518e28c'],214,1206,1420,768296,7,0,0.963133641,1,2419
144c2153b7379761a0531d822013460962d55a9f,1,sneethiraj,2015-06-01 11:58:00-04:00,['681e1ef5ca8d1475a47fd434bd53afbee5b8a51d'],23,49,72,768368,9,0.3,0.3,1,2419
c5264171128330e630e8be26ef7347b2f0fb69e8,1,Velmurugan Periasamy,2015-06-01 17:45:21-04:00,['144c2153b7379761a0531d822013460962d55a9f'],9,16,25,768393,1,0,1,0.833333333,2419
5a022141c5394b4ee60e95a8303545585d927c84,1,Madhan Neethiraj,2015-06-01 16:19:26-07:00,"['2474fed115430d54be8be95caec5f66703b3c83c', '144c2153b7379761a0531d822013460962d55a9f']",699,2941,3640,772033,79,,,,2419
8469e643da3a81312aff58dc74673ed48e440f95,1,Don Bosco Durai,2015-06-01 18:02:42-07:00,['c5264171128330e630e8be26ef7347b2f0fb69e8'],23,79,102,772135,9,0.888888889,0.933333333,1,2419
ce663e407cf8ab9081e04f6c2e9a6dac38d49172,1,Don Bosco Durai,2015-06-02 08:35:06-07:00,['8469e643da3a81312aff58dc74673ed48e440f95'],0,20,20,772155,1,,,,2420
f51878c16a6bb37fda21491a864266363b518ae9,0,Don Bosco Durai,2015-06-02 09:04:56-07:00,['ce663e407cf8ab9081e04f6c2e9a6dac38d49172'],3,0,3,772158,1,,,,2420
3ffde5de3eb079d48593a34027d0556f7d38a4d6,1,Madhan Neethiraj,2015-06-02 09:14:21-07:00,['5a022141c5394b4ee60e95a8303545585d927c84'],83,166,249,772407,18,0.305555556,1,0.972222222,2420
f35d53b8770c406c7cbeef00562333de5225fb32,1,Madhan Neethiraj,2015-06-02 10:23:59-07:00,['f51878c16a6bb37fda21491a864266363b518ae9'],41,77,118,772525,14,0.76,1,1,2420
5d437fae5576404ed8c8c882711188c50790c1f1,0,Madhan Neethiraj,2015-06-02 12:42:39-07:00,"['3ffde5de3eb079d48593a34027d0556f7d38a4d6', 'f35d53b8770c406c7cbeef00562333de5225fb32']",85,202,287,772812,28,,,,2420
e7be55f7be695b14c8613fca58b215df095e5eb2,0,Madhan Neethiraj,2015-06-02 13:25:38-07:00,['f35d53b8770c406c7cbeef00562333de5225fb32'],11,1,12,772824,1,,,,2420
4c4567182f467d5301b78e214e551801e374faaa,1,Madhan Neethiraj,2015-06-02 19:21:16-07:00,['e7be55f7be695b14c8613fca58b215df095e5eb2'],28,32,60,772884,3,,,,2420
4915b823fa247b6fe6c1035a9ec15c7cfec5571c,0,Madhan Neethiraj,2015-06-02 20:11:52-07:00,"['5d437fae5576404ed8c8c882711188c50790c1f1', '4c4567182f467d5301b78e214e551801e374faaa']",43,43,86,772970,5,,,,2420
e0261055d86b6c09f23b2773e0ee2470fe08aac7,1,Madhan Neethiraj,2015-06-02 23:41:42-07:00,['4c4567182f467d5301b78e214e551801e374faaa'],14,54,68,773038,3,0,0,0.1875,2420
866c01aaecedf9e0e3d87561fae183c64793803b,1,sneethiraj,2015-06-03 06:04:34-04:00,['e0261055d86b6c09f23b2773e0ee2470fe08aac7'],697,54,751,773789,3,0.532142857,0.314285714,0,2420
3a0582d893cd5a2168f34e6d723e019ce628929e,0,Madhan Neethiraj,2015-06-03 08:38:05-07:00,"['4915b823fa247b6fe6c1035a9ec15c7cfec5571c', '866c01aaecedf9e0e3d87561fae183c64793803b']",711,108,819,774608,6,,,,2420
de019a805622b5013a68949a1167dd67c2d90cbe,1,Madhan Neethiraj,2015-06-03 13:36:47-07:00,['866c01aaecedf9e0e3d87561fae183c64793803b'],508,760,1268,775876,23,0.848837209,0.5,0.918604651,2424
cfc0f39acfeab1d03eb186492f43e6cc0e93c2b2,1,Madhan Neethiraj,2015-06-03 17:31:41-07:00,['de019a805622b5013a68949a1167dd67c2d90cbe'],43,140,183,776059,4,0.833333333,1,0.777777778,2424
3683ac0f7279c8c71bfadff3abb93bc8aa281fe5,0,Madhan Neethiraj,2015-06-04 08:46:09-07:00,['cfc0f39acfeab1d03eb186492f43e6cc0e93c2b2'],4,2,6,776065,1,1,1,1,2424
89c524da9ea7b3360ffb460007df1570ca31d1b8,1,Madhan Neethiraj,2015-06-04 10:48:58-07:00,['3683ac0f7279c8c71bfadff3abb93bc8aa281fe5'],8,17,25,776090,1,0,0,1,2424
016f0f6fd4132a4843f69354b6a4d413ff9c289e,1,Madhan Neethiraj,2015-06-04 17:36:03-07:00,['89c524da9ea7b3360ffb460007df1570ca31d1b8'],1,14,15,776105,2,0,0,0,2424
e25baa775a0322baa436fdb6215ae73563a0d33b,1,Madhan Neethiraj,2015-06-04 18:51:45-07:00,['3a0582d893cd5a2168f34e6d723e019ce628929e'],141,972,1113,777218,23,0.488,0.528,0.986666667,2431
0d37d980eca3e182ea8c597120c584ea4384b8f7,0,Madhan Neethiraj,2015-06-04 19:40:20-07:00,"['e25baa775a0322baa436fdb6215ae73563a0d33b', '016f0f6fd4132a4843f69354b6a4d413ff9c289e']",589,962,1551,778769,30,,,,2431
4311677127428892ad527ddf48fc1f5087eb3c67,0,Madhan Neethiraj,2015-06-04 22:39:40-07:00,['0d37d980eca3e182ea8c597120c584ea4384b8f7'],0,1,1,778770,1,,,,2431
b12e761dbfb63d765bcfa8b1265f0a5b8955d2a4,1,Madhan Neethiraj,2015-06-04 23:49:47-07:00,['016f0f6fd4132a4843f69354b6a4d413ff9c289e'],0,7,7,778777,1,0,0,1,2431
85e13c4deb7dc97db81c7918b3c6efedda3f8e92,1,Madhan Neethiraj,2015-06-05 00:08:03-07:00,['4311677127428892ad527ddf48fc1f5087eb3c67'],30,353,383,779160,8,0.683206107,0.893129771,1,2431
859f3bd3ec7a9098b27429646547d1d52f0f353c,1,Don Bosco Durai,2015-06-05 08:26:48-07:00,['b12e761dbfb63d765bcfa8b1265f0a5b8955d2a4'],74,327,401,779561,17,0.10982659,0.526011561,0.832369942,2431
83583dbe0a820a432e76f34d79ad315b1a9eec86,1,Don Bosco Durai,2015-06-05 08:26:48-07:00,['859f3bd3ec7a9098b27429646547d1d52f0f353c'],1,1,2,779563,1,,,,2431
5a743e0aee657e6ddadf60b920df50ff580d99bf,1,Madhan Neethiraj,2015-06-05 09:47:03-07:00,['83583dbe0a820a432e76f34d79ad315b1a9eec86'],5,17,22,779585,2,0,0,0.7,2431
d0850993033e740660d9b47ac8020523f4b07c9d,1,Don Bosco Durai,2015-06-05 10:22:21-07:00,['5a743e0aee657e6ddadf60b920df50ff580d99bf'],6,31,37,779622,2,,,,2431
9d15be5856ea19efded57114e71b069921b57704,1,sneethiraj,2015-06-05 15:14:46-04:00,['d0850993033e740660d9b47ac8020523f4b07c9d'],2,3,5,779627,2,,,,2431
104d1b897e33159f1019a1691bbca6b063332a5d,1,Madhan Neethiraj,2015-06-05 17:16:42-07:00,['9d15be5856ea19efded57114e71b069921b57704'],73,159,232,779859,2,0.440677966,0.711864407,0.745762712,2431
0c6d87890994f32e13b28f44e10fb4c5ec2a60ec,1,Madhan Neethiraj,2015-06-05 18:36:30-07:00,['85e13c4deb7dc97db81c7918b3c6efedda3f8e92'],29,29,58,779917,4,1,1,0,2431
f7ec8219d2c8ff18f9806034b302720f7c62d1af,0,Madhan Neethiraj,2015-06-05 18:59:34-07:00,"['0c6d87890994f32e13b28f44e10fb4c5ec2a60ec', '9d15be5856ea19efded57114e71b069921b57704']",87,385,472,780389,23,,,,2431
8cf18577a99539c32b1f674c45c26a53eb40df80,1,sneethiraj,2015-06-06 11:34:40-04:00,['104d1b897e33159f1019a1691bbca6b063332a5d'],187,52,239,780628,2,1,1,0,2431
94cf87d8854873d6db4b94fc634ec996fc406f52,1,Don Bosco Durai,2015-06-06 19:21:31-07:00,['8cf18577a99539c32b1f674c45c26a53eb40df80'],14,21,35,780663,6,0,0.5,0.5,2431
e3bc6613e778219fa182ebba2007f762a52f8930,1,Don Bosco Durai,2015-06-06 19:31:44-07:00,['94cf87d8854873d6db4b94fc634ec996fc406f52'],1,1,2,780665,1,,,,2431
0512610e19c69188ca9f0e44a0f7701888c1b404,1,Madhan Neethiraj,2015-06-08 00:16:15-07:00,['e3bc6613e778219fa182ebba2007f762a52f8930'],66,104,170,780835,9,1,1,1,2431
f360a3ba30dc56c958cb1162566f82a72205ae82,0,Madhan Neethiraj,2015-06-08 01:14:27-07:00,"['f7ec8219d2c8ff18f9806034b302720f7c62d1af', '0512610e19c69188ca9f0e44a0f7701888c1b404']",338,334,672,781507,18,,,,2431
c6133b7e70b6bee237d4f339156538d783af61a1,1,Madhan Neethiraj,2015-06-08 11:37:35-07:00,['f360a3ba30dc56c958cb1162566f82a72205ae82'],37,107,144,781651,2,0,0,0.413793103,2431
065b431ff78b219ebc0ec7997d1c4f3a67298d7e,0,Don Bosco Durai,2015-06-08 20:00:06-07:00,['0512610e19c69188ca9f0e44a0f7701888c1b404'],34,1,35,781686,1,,,,2431
2c54590a83ab4cf37924876ae468699746d2a751,1,sneethiraj,2015-06-08 23:26:27-07:00,['065b431ff78b219ebc0ec7997d1c4f3a67298d7e'],15,42,57,781743,5,0,0.444444444,1,2431
4c75d2822927de4215da2b55523328a1ec3e15e0,1,Madhan Neethiraj,2015-06-08 23:38:56-07:00,['2c54590a83ab4cf37924876ae468699746d2a751'],2,2,4,781747,1,,,,2431
08990c5bdee9aacc4f69eaf777202904fcc92ef6,1,Madhan Neethiraj,2015-06-09 17:55:13-07:00,['4c75d2822927de4215da2b55523328a1ec3e15e0'],45,40,85,781832,2,1,1,0,2431
43841b7a546fd7857a24dea8dad3bdfe7c84a0fa,1,Madhan Neethiraj,2015-06-09 18:56:24-07:00,['08990c5bdee9aacc4f69eaf777202904fcc92ef6'],82,134,216,782048,5,0.156862745,0,1,2431
0d38f0f2c37fef8fb293c37899dfd377afe7688e,1,Madhan Neethiraj,2015-06-10 00:33:11-07:00,['43841b7a546fd7857a24dea8dad3bdfe7c84a0fa'],224,419,643,782691,7,0.259259259,0.00617284,0.425925926,2431
89002025e57cf235cbf4c248eb7e468dad9378fb,1,Velmurugan Periasamy,2015-06-10 14:42:35-07:00,['0d38f0f2c37fef8fb293c37899dfd377afe7688e'],27,33,60,782751,2,1,1,1,2431
c5f61c898244aa436997990df19778766b0db295,1,Madhan Neethiraj,2015-06-10 21:33:52-07:00,['89002025e57cf235cbf4c248eb7e468dad9378fb'],600,707,1307,784058,12,1,0.317365269,0.784431138,2435
ea3bcb38eb28ebebed8a29d3429ce6b3ee794141,0,Madhan Neethiraj,2015-06-10 22:09:30-07:00,"['c6133b7e70b6bee237d4f339156538d783af61a1', 'c5f61c898244aa436997990df19778766b0db295']",1038,1385,2423,786481,35,,,,2435
12ab54a0eb2a35c5bb9428c83dd003ce82732bab,0,Madhan Neethiraj,2015-06-12 01:12:28-07:00,['c5f61c898244aa436997990df19778766b0db295'],1,1,2,786483,1,,,,2435
b70ec703ad34e4c4996b7ba5a41a233d338297da,1,sneethiraj,2015-06-12 09:16:24-07:00,['12ab54a0eb2a35c5bb9428c83dd003ce82732bab'],33,90,123,786606,8,0.575,0,1,2435
bef9c7a4c031e4bbe9c307b0b5df65371c24b3bc,1,Madhan Neethiraj,2015-06-13 09:29:11-07:00,['b70ec703ad34e4c4996b7ba5a41a233d338297da'],144,71,215,786821,3,0.180327869,0.180327869,0.196721311,2435
a1706e83da238f23b036fdb95265bc68298ff9a8,0,Madhan Neethiraj,2015-06-13 09:38:16-07:00,['bef9c7a4c031e4bbe9c307b0b5df65371c24b3bc'],1,1,2,786823,1,,,,2435
d85beb4e4ca214e57b748e1ec55ab6929cf06494,1,Madhan Neethiraj,2015-06-13 09:55:29-07:00,['a1706e83da238f23b036fdb95265bc68298ff9a8'],31,38,69,786892,1,1,1,0,2435
d283d6cca8917bc7f7ed6b1729a6d8fe531601c3,1,Don Bosco Durai,2015-06-13 13:00:01-07:00,['d85beb4e4ca214e57b748e1ec55ab6929cf06494'],45,225,270,787162,4,0.15,0.533333333,0.5,2435
aa695b17adf099e8860e5108e0bbf36bdd86f819,1,Don Bosco Durai,2015-06-13 13:00:01-07:00,['d283d6cca8917bc7f7ed6b1729a6d8fe531601c3'],39,79,118,787280,3,0.419354839,0.451612903,0.677419355,2435
96e450a43dabbf924665190c561dd6f30ec00be5,0,Madhan Neethiraj,2015-06-13 17:56:39-07:00,"['ea3bcb38eb28ebebed8a29d3429ce6b3ee794141', 'd85beb4e4ca214e57b748e1ec55ab6929cf06494']",210,201,411,787691,14,,,,2435
327ecb3c572962c13e9e4cdec4157291df97517a,0,Madhan Neethiraj,2015-06-14 00:18:41-07:00,"['96e450a43dabbf924665190c561dd6f30ec00be5', 'aa695b17adf099e8860e5108e0bbf36bdd86f819']",49,269,318,788009,6,,,,2435
eb01a1d062605b3c7bfc8394685287030a752070,0,Madhan Neethiraj,2015-06-14 22:54:36-07:00,['aa695b17adf099e8860e5108e0bbf36bdd86f819'],19,19,38,788047,1,,,,2435
9a0330ccef16a7cf10435f4592fc5bda0798afe2,1,sneethiraj,2015-06-15 22:56:29-04:00,['aa695b17adf099e8860e5108e0bbf36bdd86f819'],13,42,55,788102,2,0,0,1,2435
4d60d6228c754b560d10a87993d567a18bf01433,0,sneethiraj,2015-06-15 22:56:48-04:00,"['9a0330ccef16a7cf10435f4592fc5bda0798afe2', 'eb01a1d062605b3c7bfc8394685287030a752070']",19,19,38,788140,1,,,,2435
6411479b8836f11df4abea9702e67c8ad29049ce,1,sneethiraj,2015-06-15 22:57:52-04:00,['4d60d6228c754b560d10a87993d567a18bf01433'],2,18,20,788160,1,0,1,0,2435
858156ee225152e42baa14e7a20d9e3c952b480b,1,Madhan Neethiraj,2015-06-16 19:07:44-07:00,['327ecb3c572962c13e9e4cdec4157291df97517a'],191,847,1038,789198,12,0.24137931,0.349137931,1,2437
9d29006ee770487b84fa94c37918d99163a62053,0,rmani,2015-06-16 19:50:30-07:00,['6411479b8836f11df4abea9702e67c8ad29049ce'],27,35,62,789260,1,0,0,0,2437
e73fe78462e2129018ef4e8cecd8d5dff36f7a03,1,Madhan Neethiraj,2015-06-17 17:12:13-07:00,['9d29006ee770487b84fa94c37918d99163a62053'],10,45,55,789315,6,0.85,0.95,0.6,2437
c8ab096cf8f28b78b41e1de6574ab0f0ccf58c2b,0,Madhan Neethiraj,2015-06-17 19:30:50-07:00,"['858156ee225152e42baa14e7a20d9e3c952b480b', 'e73fe78462e2129018ef4e8cecd8d5dff36f7a03']",71,161,232,789547,12,,,,2437
6f903e3ab0394c1c98abc014362a317eea7e79ea,1,Madhan Neethiraj,2015-06-18 17:56:25-04:00,['e73fe78462e2129018ef4e8cecd8d5dff36f7a03'],14,168,182,789729,6,0,0.704545455,0.909090909,2438
e2a590096a3637398565f70a53726e4b253ed1f9,0,Madhan Neethiraj,2015-06-19 18:34:50-04:00,['6f903e3ab0394c1c98abc014362a317eea7e79ea'],1,27,28,789757,1,0,0,1,2438
2b348260097c87455a04df8aa46897fbb6ff51cd,1,Madhan Neethiraj,2015-06-20 10:35:41-04:00,['c8ab096cf8f28b78b41e1de6574ab0f0ccf58c2b'],57,172,229,789986,28,0.64,1,1,2438
3afb0d69e398bc0fde628a6e81310bbfde4888d1,0,Madhan Neethiraj,2015-06-20 11:42:59-04:00,"['2b348260097c87455a04df8aa46897fbb6ff51cd', 'e2a590096a3637398565f70a53726e4b253ed1f9']",15,195,210,790196,7,,,,2438
ec701f279847550229b2f44509b68edb8f995713,0,sneethiraj,2015-06-22 09:42:18-07:00,['e2a590096a3637398565f70a53726e4b253ed1f9'],3,19,22,790218,1,1,1,1,2438
b85b36378a734a09bcc40570dba6186fa63ff2eb,1,Madhan Neethiraj,2015-06-22 19:35:06-05:00,['ec701f279847550229b2f44509b68edb8f995713'],11,13,24,790242,2,1,0,0,2438
c3b7cf9ae172a5c89598119691e197261e87f903,0,sneethiraj,2015-06-22 18:56:34-07:00,['ec701f279847550229b2f44509b68edb8f995713'],1,2,3,790245,1,,,,2438
3a0982b5133ab9d786956d15e07d65f2af6401b9,0,Madhan Neethiraj,2015-06-23 01:40:34-07:00,"['3afb0d69e398bc0fde628a6e81310bbfde4888d1', 'b85b36378a734a09bcc40570dba6186fa63ff2eb']",14,32,46,790291,3,,,,2438
b625bb0c7d9911380c2ab8d344056b1cf1b41c1b,0,sneethiraj,2015-06-23 16:59:55-07:00,"['c3b7cf9ae172a5c89598119691e197261e87f903', 'b85b36378a734a09bcc40570dba6186fa63ff2eb']",11,13,24,790315,2,,,,2438
0614046a4e273a48b3d659e590bdc63e54559aeb,1,sneethiraj,2015-06-23 17:01:11-07:00,['b625bb0c7d9911380c2ab8d344056b1cf1b41c1b'],1,7,8,790323,4,1,1,0,2438
3bed641fe69ba15d69a0c88a81eecab905fff8e0,1,Madhan Neethiraj,2015-06-23 17:56:21-07:00,['3a0982b5133ab9d786956d15e07d65f2af6401b9'],14,18,32,790355,1,0.5,0,0.5,2438
088f3cf6aea19e4b46d5296fd2c17bdd87111fc5,1,sneethiraj,2015-06-23 21:54:27-07:00,['0614046a4e273a48b3d659e590bdc63e54559aeb'],19,43,62,790417,4,0.08,0.08,0.16,2438
a31d901cc0cbc608550e1c99c60c1fb6e7d13388,1,Madhan Neethiraj,2015-06-25 08:04:23-07:00,['088f3cf6aea19e4b46d5296fd2c17bdd87111fc5'],65,148,213,790630,2,1,0.543478261,1,2438
f0b129b7924f57c00a38fed11cb9754dc7c22c18,0,Madhan Neethiraj,2015-06-25 08:07:19-07:00,['a31d901cc0cbc608550e1c99c60c1fb6e7d13388'],3,66,69,790699,2,0.089285714,0.857142857,1,2438
d026a7e2b4c38273a47767c032eda9d03a30c14e,0,sneethiraj,2015-06-25 16:19:45-07:00,['f0b129b7924f57c00a38fed11cb9754dc7c22c18'],0,25,25,790724,1,,,,2439
d23eccc834cc4d48fa1c3e980d8781bb6d14f774,0,sneethiraj,2015-06-25 16:35:23-07:00,['d026a7e2b4c38273a47767c032eda9d03a30c14e'],2,2,4,790728,1,,,,2439
73513e8fdcf8f2cb7131607ac1748b918c221591,0,sneethiraj,2015-06-25 19:42:19-07:00,['d23eccc834cc4d48fa1c3e980d8781bb6d14f774'],0,32,32,790760,1,,,,2440
ca88798585780e4f7f8bd0859a6d0fedc468fbfd,1,Madhan Neethiraj,2015-06-26 14:58:31-07:00,['3bed641fe69ba15d69a0c88a81eecab905fff8e0'],14,912,926,791686,17,0.171149144,0.386308068,0.86797066,2443
26778304fcfff9cf3fe7e88bb46761c91ef1d7ae,1,Madhan Neethiraj,2015-06-26 15:46:43-07:00,['ca88798585780e4f7f8bd0859a6d0fedc468fbfd'],134,135,269,791955,18,,,,2443
673b6d551c564bf04b5173f3f1a2d95a17e03d5f,1,Madhan Neethiraj,2015-06-26 23:51:44-07:00,['26778304fcfff9cf3fe7e88bb46761c91ef1d7ae'],77,152,229,792184,9,0.473684211,1,1,2444
7b4c6223b2b927ddc3247bcc26d34e28129a8f89,0,Madhan Neethiraj,2015-06-27 00:09:31-07:00,"['673b6d551c564bf04b5173f3f1a2d95a17e03d5f', '73513e8fdcf8f2cb7131607ac1748b918c221591']",91,325,416,792600,14,,,,2444
7ac57a4a46a59bae926bbf0d275e93cdf348ff45,1,sneethiraj,2015-06-29 01:46:13-04:00,['73513e8fdcf8f2cb7131607ac1748b918c221591'],2,4,6,792606,2,,,,2444
e63a48e9544fa32813901fbcc92ef4926b8cd331,0,Madhan Neethiraj,2015-06-29 00:33:16-07:00,"['7b4c6223b2b927ddc3247bcc26d34e28129a8f89', '7ac57a4a46a59bae926bbf0d275e93cdf348ff45']",2,4,6,792612,2,,,,2444
bfe4ab2e16cd3a66a24e3e9dd6a2bdc8f0aa4bbe,1,sneethiraj,2015-06-30 10:21:46-04:00,['7ac57a4a46a59bae926bbf0d275e93cdf348ff45'],5,48,53,792665,7,,,,2444
07ab4e8f24406b46fb7a1d738c21487c2053ac79,1,sneethiraj,2015-07-01 12:28:43-04:00,['bfe4ab2e16cd3a66a24e3e9dd6a2bdc8f0aa4bbe'],10,10,20,792685,7,,,,2444
c930d563372d898d7ca4c79a252b4b150486b4d3,1,Madhan Neethiraj,2015-07-03 19:49:46-07:00,['e63a48e9544fa32813901fbcc92ef4926b8cd331'],321,923,1244,793929,32,0.309352518,0.892086331,0.255395683,2448
e95d83fee3a7c2936025d8a4c963329972be16e5,0,Madhan Neethiraj,2015-07-03 20:00:38-07:00,"['c930d563372d898d7ca4c79a252b4b150486b4d3', '07ab4e8f24406b46fb7a1d738c21487c2053ac79']",8,51,59,793988,7,,,,2448
3651862943b5ac9b3fe353adb1c7948ef00ff919,1,sneethiraj,2015-07-06 05:11:43-04:00,['07ab4e8f24406b46fb7a1d738c21487c2053ac79'],11,3,14,794002,2,0,0,0,2448
fa6b45d20c95691c1a89c57bb12bd2fec1f03e91,0,Madhan Neethiraj,2015-07-06 10:37:36-07:00,['e95d83fee3a7c2936025d8a4c963329972be16e5'],9,9,18,794020,9,,,,2448
024dfbf09638bb7a98b955cd3e3f9b8c45eefee0,0,Madhan Neethiraj,2015-07-07 12:50:50+05:18,['fa6b45d20c95691c1a89c57bb12bd2fec1f03e91'],0,6,6,794026,1,1,1,1,2448
4bbf3906b080c9d5f31eec10344a7680ea97d8ca,0,Madhan Neethiraj,2015-07-08 07:16:13+05:18,['024dfbf09638bb7a98b955cd3e3f9b8c45eefee0'],9,22,31,794057,3,0,0,1,2448
493b8d9c48cb2e3b68edb6589e2e32ca7db61944,1,Madhan Neethiraj,2015-07-08 10:09:04+05:18,['4bbf3906b080c9d5f31eec10344a7680ea97d8ca'],167,37,204,794261,8,0,0,0,2448
747105c0bdfd4ce31fddbf3788a834ab24f6ce07,1,Madhan Neethiraj,2015-07-09 07:15:25+05:18,['493b8d9c48cb2e3b68edb6589e2e32ca7db61944'],202,119,321,794582,15,1,1,1,2448
f34eb3d0704e57129dd5f12a58cae8db9cc2c385,0,rmani,2015-07-09 17:37:06-07:00,['3651862943b5ac9b3fe353adb1c7948ef00ff919'],0,1,1,794583,1,0,1,0,2448
28a48c07c22f272cc4d96a3b614eba845dc8dc04,0,Madhan Neethiraj,2015-07-10 07:57:39+05:18,['747105c0bdfd4ce31fddbf3788a834ab24f6ce07'],7,12,19,794602,4,1,1,0,2448
f2124c4640907b66b6bab6d622fe044903e6ad9b,0,Madhan Neethiraj,2015-07-16 11:36:46+05:18,"['28a48c07c22f272cc4d96a3b614eba845dc8dc04', 'f34eb3d0704e57129dd5f12a58cae8db9cc2c385']",11,4,15,794617,3,,,,2448
a87442a666f6f8770ea48445e9f296cfbfc16a19,0,Madhan Neethiraj,2015-07-26 22:53:48-07:00,['f2124c4640907b66b6bab6d622fe044903e6ad9b'],1,3,4,794621,1,,,,2448
21fe732a8e31fda55832cd16bcaf96bf7e4b6755,0,Madhan Neethiraj,2015-07-26 23:06:12-07:00,['f34eb3d0704e57129dd5f12a58cae8db9cc2c385'],1,3,4,794625,1,,,,2448
dcd3ea0d8429516c7ef20eddce095fa9f7f9a9a1,1,rmani,2015-07-28 10:54:49-07:00,['f34eb3d0704e57129dd5f12a58cae8db9cc2c385'],2,19,21,794646,1,1,1,1,2448
e35e1c1916bc5ed9118d76469e643a0c9c41f1fb,1,Madhan Neethiraj,2015-07-28 22:27:45-07:00,['21fe732a8e31fda55832cd16bcaf96bf7e4b6755'],80,345,425,795071,6,0.264705882,0.404411765,0.669117647,2449
f80cb1dd613a507927d7609cfa4fd391773d971d,0,Madhan Neethiraj,2015-07-28 23:52:33-07:00,['e35e1c1916bc5ed9118d76469e643a0c9c41f1fb'],0,19,19,795090,1,,,,2449
39fc361f817da1cfaca1d21ed679134414bfda93,1,rmani,2015-07-30 14:20:29-07:00,['dcd3ea0d8429516c7ef20eddce095fa9f7f9a9a1'],16,68,84,795174,2,0,1,1,2450
d8e3225974fb2b7b47ca5d80bc691e3bdd4b09f6,0,rmani,2015-07-30 14:27:20-07:00,"['39fc361f817da1cfaca1d21ed679134414bfda93', 'f80cb1dd613a507927d7609cfa4fd391773d971d']",81,367,448,795622,7,,,,2450
fcf0a6efd735bb59063c04b13bf67bb2ab9c722f,0,Madhan Neethiraj,2015-07-30 14:28:26-07:00,"['a87442a666f6f8770ea48445e9f296cfbfc16a19', 'd8e3225974fb2b7b47ca5d80bc691e3bdd4b09f6']",98,451,549,796171,9,,,,2450
7917b7013c7189def4c7f8a22768065713484b0d,0,Madhan Neethiraj,2015-07-30 15:32:35-07:00,['fcf0a6efd735bb59063c04b13bf67bb2ab9c722f'],4,31,35,796206,1,0.105263158,1,0.368421053,2450
e22fbb10716e34738a35788bbce573545688388e,0,rmani,2015-07-30 16:27:42-07:00,['d8e3225974fb2b7b47ca5d80bc691e3bdd4b09f6'],9,0,9,796215,1,0,0,0,2450
d1e2f3b7e14a803ad4d9f117cf8f483e51c25d55,1,Alok Lal,2015-07-31 13:39:40-07:00,['e22fbb10716e34738a35788bbce573545688388e'],62,248,310,796525,4,0.528571429,0.757142857,0.714285714,2452
974034bee9512a927540ee2f29a29e3b7c4d7fc1,1,Madhan Neethiraj,2015-07-31 16:04:11-07:00,['7917b7013c7189def4c7f8a22768065713484b0d'],18,5684,5702,802227,8,0.276926595,0.355362451,0.934369998,2453
8df9b1014607e0a6d5d11e6881024613e2fdd7ba,0,Madhan Neethiraj,2015-07-31 16:42:18-07:00,['974034bee9512a927540ee2f29a29e3b7c4d7fc1'],0,19,19,802246,1,,,,2453
2d931dbe4520f43edc1bdcb867f8fd6f2b35392b,1,Alok Lal,2015-08-03 12:50:39-07:00,['d1e2f3b7e14a803ad4d9f117cf8f483e51c25d55'],63,155,218,802464,3,0.36,0.4,0.6,2453
edf2af7aa11ab64c8f4a63936001baa3e9da46e9,0,Alok Lal,2015-08-05 11:00:13-07:00,['2d931dbe4520f43edc1bdcb867f8fd6f2b35392b'],1,1,2,802466,1,,,,2453
68a4352b3e2ee3ba6c2f9904104641b7a387065b,1,Alok Lal,2015-08-05 12:02:43-07:00,['edf2af7aa11ab64c8f4a63936001baa3e9da46e9'],10,26,36,802502,5,,,,2454
79bd7e3c8dd5903c5ed2089416cb33ef4d566cf7,1,Alok Lal,2015-08-05 13:21:39-07:00,['68a4352b3e2ee3ba6c2f9904104641b7a387065b'],391,185,576,803078,7,0.454545455,0.166666667,0,2454
d3d591385ceb23dd179e1869886d10aae8ad9990,1,Velmurugan Periasamy,2015-08-06 01:57:56-04:00,['79bd7e3c8dd5903c5ed2089416cb33ef4d566cf7'],0,16,16,803094,1,,,,2454
d1cf555bfb4e53c0f71637080406eaeefbfb1622,0,Velmurugan Periasamy,2015-08-07 11:27:01-04:00,['d3d591385ceb23dd179e1869886d10aae8ad9990'],46,3,49,803143,2,1,0.15,0.85,2454
416e13a71842f883179d10ae995137bf69b756e6,0,Velmurugan Periasamy,2015-08-07 14:09:21-04:00,['d1cf555bfb4e53c0f71637080406eaeefbfb1622'],0,2364,2364,805507,6,0.071700163,0.192829984,0.975556763,2457
e169b2713edd100cc238f5d417a9e46ac70f595c,0,Alok Lal,2015-08-07 13:42:06-07:00,['416e13a71842f883179d10ae995137bf69b756e6'],1,1,2,805509,1,,,,2457
31a65f48a7f67c351e16abc4e606b37bcadfaca7,1,Madhan Neethiraj,2015-08-07 18:24:32-07:00,['8df9b1014607e0a6d5d11e6881024613e2fdd7ba'],11,1360,1371,806880,18,0.491778774,0.559043348,0.949177877,2469
9a6e641fa9a79ef7558cc01ea212f8f974abaac0,0,Madhan Neethiraj,2015-08-10 09:49:06-07:00,"['31a65f48a7f67c351e16abc4e606b37bcadfaca7', 'e169b2713edd100cc238f5d417a9e46ac70f595c']",445,2861,3306,810186,23,,,,2469
dba2bea65734c375b9f2497bd83f371ddca9fdda,0,Madhan Neethiraj,2015-08-10 20:08:53-07:00,['9a6e641fa9a79ef7558cc01ea212f8f974abaac0'],1,1,2,810188,2,,,,2469
bc090a66987b0421616802d5bc52e5567d5a030a,1,Madhan Neethiraj,2015-08-11 08:12:19-07:00,['dba2bea65734c375b9f2497bd83f371ddca9fdda'],30,3639,3669,813857,31,0.573239437,0.602112676,0.973239437,2492
8c37c47faa36daf8b0d087499ff61708ab5097e9,1,Madhan Neethiraj,2015-08-12 20:46:16-07:00,['bc090a66987b0421616802d5bc52e5567d5a030a'],11,124,135,813992,1,0.048780488,0.048780488,1,2492
6ba371535ee99aa236a16d96922652e2fa056422,1,Madhan Neethiraj,2015-08-13 11:43:12-07:00,['8c37c47faa36daf8b0d087499ff61708ab5097e9'],159,156,315,814307,15,0.511111111,0.6,1,2492
3130174ef6764d6c2f87f42d0e07529b6685fe1c,1,Madhan Neethiraj,2015-08-13 22:00:44-07:00,['6ba371535ee99aa236a16d96922652e2fa056422'],32,40,72,814379,1,0,0,0,2492
532e2e04da0b7c537c3dc3351bb59b0af8eecc53,0,Madhan Neethiraj,2015-08-14 17:24:48-07:00,['3130174ef6764d6c2f87f42d0e07529b6685fe1c'],55,338,393,814772,11,0.410526316,0.436842105,0.884210526,2492
d79e8566fda5700683dc9d519392129ef8a7e9fe,1,sneethiraj,2015-08-17 18:19:25-04:00,['e169b2713edd100cc238f5d417a9e46ac70f595c'],22,2180,2202,816974,25,0.362139918,0.411522634,0.102880658,2496
6f972e9cfe3b9c1a4d018d0e6187baf862c004d3,0,Madhan Neethiraj,2015-08-17 17:58:02-07:00,"['532e2e04da0b7c537c3dc3351bb59b0af8eecc53', 'd79e8566fda5700683dc9d519392129ef8a7e9fe']",22,2180,2202,819176,25,,,,2496
722a5ba49709f6a87263d06559866f4bcc0e11d7,1,Madhan Neethiraj,2015-08-19 00:59:24-07:00,['6f972e9cfe3b9c1a4d018d0e6187baf862c004d3'],3,67,70,819246,9,0.448275862,0.724137931,0.965517241,2496
7ac1b6c87d6363ac2b124a1e2d843ff185de5109,1,Madhan Neethiraj,2015-08-19 08:07:59-07:00,['722a5ba49709f6a87263d06559866f4bcc0e11d7'],5,50,55,819301,5,0.56,0.56,0.88,2496
990213ca4fbd484339c39f745db0ca3b5e2eaaa3,1,Madhan Neethiraj,2015-08-19 23:13:01-07:00,['7ac1b6c87d6363ac2b124a1e2d843ff185de5109'],42,630,672,819973,11,0.154545455,0.331818182,0.995454545,2499
b362c17e115cac506f1b4af07d67640f82ed9b1e,1,Madhan Neethiraj,2015-08-20 00:40:59-07:00,['990213ca4fbd484339c39f745db0ca3b5e2eaaa3'],62,241,303,820276,5,0.411764706,0.745098039,1,2500
9bc895321c3e74bde904e385539c5f0f0c18a288,0,Alok Lal,2015-08-20 19:12:26-07:00,['d79e8566fda5700683dc9d519392129ef8a7e9fe'],0,8,8,820284,1,0,0,0,2500
8c76e1436211e867d8f9a5514ed939a4900d333e,0,Madhan Neethiraj,2015-08-21 00:04:18-07:00,"['b362c17e115cac506f1b4af07d67640f82ed9b1e', '9bc895321c3e74bde904e385539c5f0f0c18a288']",0,8,8,820292,1,,,,2500
2e4b430fd6b408b92b18e31fdaf29e2f902c8028,0,Madhan Neethiraj,2015-08-21 01:22:08-07:00,['8c76e1436211e867d8f9a5514ed939a4900d333e'],17,2,19,820311,2,1,0,0,2500
a6243203949ce2b9559420f866c402a11cfc6b9e,1,Alok Lal,2015-08-21 10:09:36-07:00,['9bc895321c3e74bde904e385539c5f0f0c18a288'],34,144,178,820489,5,0,0.444444444,0.444444444,2500
05df8e782b538bf305789882d9819eb755766fc0,1,Madhan Neethiraj,2015-08-24 14:05:03-07:00,['2e4b430fd6b408b92b18e31fdaf29e2f902c8028'],86,99,185,820674,3,1,1,0,2500
d37e39e34db920be0f8e83e5c9f2bc674ff86a49,0,Velmurugan Periasamy,2015-08-24 15:59:51-07:00,['a6243203949ce2b9559420f866c402a11cfc6b9e'],3,1,4,820678,1,1,0,0,2500
beb08512936dc8537c36a4f5b3dd6355ad57ed94,0,Velmurugan Periasamy,2015-08-24 16:00:58-07:00,['d37e39e34db920be0f8e83e5c9f2bc674ff86a49'],2,3,5,820683,1,1,1,1,2500
5026f1952dbf2e69cf3c21249318f824ec9fdfe8,0,Velmurugan Periasamy,2015-08-24 16:35:10-07:00,['beb08512936dc8537c36a4f5b3dd6355ad57ed94'],1,3,4,820687,1,0,0,1,2500
f5ef6f164879ca2f5b049bd33d7d3c1d4cf3370e,1,Velmurugan Periasamy,2015-08-24 21:04:07-07:00,['5026f1952dbf2e69cf3c21249318f824ec9fdfe8'],26,28,54,820741,16,0.666666667,0.666666667,1,2500
f1e7e15772619ae8dd4e34d4432894eb505dfc8d,0,Madhan Neethiraj,2015-08-24 22:27:52-07:00,['05df8e782b538bf305789882d9819eb755766fc0'],5,5,10,820751,1,0,0,0,2500
f29f4fcd26fb49b9a077e84bc177ab24fa12436f,1,Madhan Neethiraj,2015-08-25 11:24:06-07:00,['f1e7e15772619ae8dd4e34d4432894eb505dfc8d'],5,16,21,820772,2,1,0,1,2500
13cdf4fb66fbc490bceafce6b9b6fed966e4bb35,0,Madhan Neethiraj,2015-08-25 15:11:41-07:00,['f5ef6f164879ca2f5b049bd33d7d3c1d4cf3370e'],5,5,10,820782,1,0,0,0,2500
cc2b96ec808d0748049ecd57f8ef05052a6095e3,0,Madhan Neethiraj,2015-08-25 16:01:37-07:00,"['f29f4fcd26fb49b9a077e84bc177ab24fa12436f', '13cdf4fb66fbc490bceafce6b9b6fed966e4bb35']",71,179,250,821032,24,,,,2500
83cb21e0b26d10e2f61f1219431f352227c8c437,1,Madhan Neethiraj,2015-08-26 17:35:34-07:00,['cc2b96ec808d0748049ecd57f8ef05052a6095e3'],1562,3282,4844,825876,44,0.615602837,1,1,2508
303f7b7023f2e20464186babf97c461ea598062c,1,Madhan Neethiraj,2015-08-28 14:54:02-07:00,['83cb21e0b26d10e2f61f1219431f352227c8c437'],1580,2782,4362,830238,41,0.859375,0.768554688,0.995117188,2512
5876e22723c3ba82c405efbb29d97fae28e189aa,1,Madhan Neethiraj,2015-08-28 16:59:33-07:00,['303f7b7023f2e20464186babf97c461ea598062c'],36,77,113,830351,10,0.37037037,1,0.962962963,2512
f8bea62bccbca1eaf16083dec4cf1b43ac9b439d,1,Madhan Neethiraj,2015-08-28 18:11:08-07:00,['5876e22723c3ba82c405efbb29d97fae28e189aa'],61,58,119,830470,9,0,1,0,2512
da8327114a50ba664ee9c652ff889be22d88fbeb,1,Madhan Neethiraj,2015-08-31 17:27:28-07:00,['f8bea62bccbca1eaf16083dec4cf1b43ac9b439d'],605,981,1586,832056,37,0.542635659,0.968992248,0.976744186,2512
92c96502a89dfad8471e7c7c4abb20e8d1ad92bf,1,Madhan Neethiraj,2015-08-31 18:14:35-07:00,['da8327114a50ba664ee9c652ff889be22d88fbeb'],14,35,49,832105,3,0,1,1,2512
d3ba1492546da44f288bcaa52e7ded7260010fc2,1,Madhan Neethiraj,2015-09-01 20:57:28-07:00,['92c96502a89dfad8471e7c7c4abb20e8d1ad92bf'],171,524,695,832800,17,0.562790698,0.209302326,0.934883721,2515
7f8e0605af68f92177b4aa54e0cc429dc809a457,1,Madhan Neethiraj,2015-09-03 13:24:26-07:00,['d3ba1492546da44f288bcaa52e7ded7260010fc2'],77,350,427,833227,28,0.431034483,0.448275862,0.965517241,2516
03083e74ded843060f385d119875e8ee9eb8ddc1,0,Madhan Neethiraj,2015-09-03 21:24:13-07:00,['7f8e0605af68f92177b4aa54e0cc429dc809a457'],31,255,286,833513,6,1,1,0,2518
801d332640a32fe5d018aff6673657a9e866385c,1,Madhan Neethiraj,2015-09-04 23:28:54-07:00,['03083e74ded843060f385d119875e8ee9eb8ddc1'],237,292,529,834042,15,0.372881356,0.423728814,0.186440678,2518
6784a66e2b0e03482e0fca272c3465822811db04,1,Velmurugan Periasamy,2015-09-06 10:02:12-04:00,['13cdf4fb66fbc490bceafce6b9b6fed966e4bb35'],6,14,20,834062,1,0.666666667,1,0.833333333,2518
c4b9499a95791ef20725d6724e54cfaeb665889b,0,Velmurugan Periasamy,2015-09-06 22:21:11-04:00,['6784a66e2b0e03482e0fca272c3465822811db04'],0,4,4,834066,1,,,,2518
44246aec4388525e14f0730aa231521fe2f7d637,0,Velmurugan Periasamy,2015-09-06 23:24:16-04:00,['c4b9499a95791ef20725d6724e54cfaeb665889b'],6,36,42,834108,4,0,0,1,2518
ab6494eddccec0e620762d21292b7dff0ea12ae7,1,Velmurugan Periasamy,2015-09-07 01:28:55-04:00,['44246aec4388525e14f0730aa231521fe2f7d637'],4,25,29,834137,6,0.846153846,0.846153846,1,2518
034e9de4b41ba44fb03248bbad08339e9b74c69e,0,Velmurugan Periasamy,2015-09-07 01:41:43-04:00,['ab6494eddccec0e620762d21292b7dff0ea12ae7'],0,3,3,834140,1,0,1,1,2518
b5fca95734a06d794daf88cc08ed16b6794d5ea7,0,sneethiraj,2015-09-08 16:16:55-04:00,['034e9de4b41ba44fb03248bbad08339e9b74c69e'],13,14,27,834167,1,,,,2518
e8ceab409927f91a51035f0b614eb331cab6f666,0,Madhan Neethiraj,2015-09-08 15:46:30-07:00,['801d332640a32fe5d018aff6673657a9e866385c'],4,4,8,834175,1,,,,2518
c18f8bf7407809e2917abd7f00406043281a7e27,1,Madhan Neethiraj,2015-09-08 15:47:33-07:00,['e8ceab409927f91a51035f0b614eb331cab6f666'],416,864,1280,835455,39,0.335740072,0.667870036,0.689530686,2518
0e47fbf659f94ca8b0ab3d2f3a9ab639d7d7e1fd,0,Madhan Neethiraj,2015-09-08 20:29:41-07:00,"['c18f8bf7407809e2917abd7f00406043281a7e27', 'b5fca95734a06d794daf88cc08ed16b6794d5ea7']",29,96,125,835580,14,,,,2518
c80ee0470eb5f3704bd7acfa7fb9dca831bc5c9c,0,Madhan Neethiraj,2015-09-09 17:23:16-07:00,['b5fca95734a06d794daf88cc08ed16b6794d5ea7'],3,1,4,835584,1,,,,2518
a7453154663bc2532894dda78ac43b24b9d27ef1,1,Madhan Neethiraj,2015-09-09 17:38:12-07:00,['0e47fbf659f94ca8b0ab3d2f3a9ab639d7d7e1fd'],128,342,470,836054,11,0.395973154,0.624161074,0.919463087,2518
2a6efecc3c5586238601226185e49ef4f31886c0,0,Velmurugan Periasamy,2015-09-10 01:45:19-04:00,['c80ee0470eb5f3704bd7acfa7fb9dca831bc5c9c'],0,8,8,836062,1,0,0,1,2518
95920591b0ee325b1bc340fb0ce4a9d9bb7f3ed7,1,Don Bosco Durai,2015-09-10 14:50:39-07:00,['2a6efecc3c5586238601226185e49ef4f31886c0'],3,22,25,836087,1,,,,2518
68a406e052550e52bf01aad75cfcf192ce276432,1,Don Bosco Durai,2015-09-10 15:23:07-07:00,['95920591b0ee325b1bc340fb0ce4a9d9bb7f3ed7'],11,33,44,836131,1,0,0,1,2518
69e0cf656a4b6c3cbb2aa9bd6545f248ba9aef15,0,Madhan Neethiraj,2015-09-10 21:38:41-07:00,['a7453154663bc2532894dda78ac43b24b9d27ef1'],4,59,63,836194,3,,,,2518
214a68fb06f3f853cccd360a9d57196d56ecf6e2,0,Madhan Neethiraj,2015-09-11 08:23:26-07:00,['69e0cf656a4b6c3cbb2aa9bd6545f248ba9aef15'],36,83,119,836313,2,,,,2518
34d68b61bb8781a10df96ff0eb1dbe74b65a7f43,0,Velmurugan Periasamy,2015-09-11 13:00:09-04:00,['68a406e052550e52bf01aad75cfcf192ce276432'],3,7,10,836323,2,,,,2518
6d79e1ca973c228324b979a380653869da8fa675,1,Alok Lal,2015-09-11 14:56:25-07:00,['34d68b61bb8781a10df96ff0eb1dbe74b65a7f43'],35,47,82,836405,4,0,0.9375,1,2518
6fc2c0ace63ae1a1a93d30583192ab43742b40a2,1,Don Bosco Durai,2015-09-12 00:42:57-07:00,['6d79e1ca973c228324b979a380653869da8fa675'],32,35,67,836472,2,1,0,1,2518
58c7de610b1788ff4442a50fb1b3d68e1ebf9502,0,Madhan Neethiraj,2015-09-14 11:59:56-07:00,['214a68fb06f3f853cccd360a9d57196d56ecf6e2'],120,233,353,836825,5,0.130952381,1,1,2518
6e7af74fca6d64bdf0b4d82533c472760ae4c15e,1,Madhan Neethiraj,2015-09-14 12:18:43-07:00,['58c7de610b1788ff4442a50fb1b3d68e1ebf9502'],72,118,190,837015,5,1,1,0.4,2518
67ca2092f262cf446c3943f3100fee2cbf060bb9,1,Alok Lal,2015-09-14 22:47:24-07:00,['6fc2c0ace63ae1a1a93d30583192ab43742b40a2'],29,48,77,837092,3,0,0,0,2518
f6b6da53d49316db9f1b10e986fb3f2ffd389044,0,Madhan Neethiraj,2015-09-15 11:02:45-07:00,['6e7af74fca6d64bdf0b4d82533c472760ae4c15e'],1,1,2,837094,1,1,1,1,2518
bd35ca49ce8b37d24203f7fc47e0c9421836807d,0,Alok Lal,2015-09-15 14:21:24-07:00,['67ca2092f262cf446c3943f3100fee2cbf060bb9'],30,80,110,837204,5,0.5,1,1,2518
9c6c64d4f485454c13d93d165d890233cca72c7e,1,Velmurugan Periasamy,2015-09-16 00:33:05-04:00,['bd35ca49ce8b37d24203f7fc47e0c9421836807d'],256,1450,1706,838910,24,0.524786325,1,0.982905983,2521
be6bc405541da982f8339c9db3664011fddad357,1,Alok Lal,2015-09-15 23:03:00-07:00,['9c6c64d4f485454c13d93d165d890233cca72c7e'],80,30,110,839020,5,0.5,0,0,2521
a350aa893d78d64e927bed55ee523e63063ccc50,1,Velmurugan Periasamy,2015-09-18 00:51:47-04:00,['be6bc405541da982f8339c9db3664011fddad357'],30,80,110,839130,5,0.5,1,1,2521
2aa6a89b6b2f7f0263d0af2ae00f0bc821179101,1,Velmurugan Periasamy,2015-09-18 12:40:57-04:00,['a350aa893d78d64e927bed55ee523e63063ccc50'],88,108,196,839326,3,0.882352941,0,0.941176471,2521
d84e17f96ec040713989688fa7c5440c112201e5,0,Don Bosco Durai,2015-09-18 21:26:54-04:00,['2aa6a89b6b2f7f0263d0af2ae00f0bc821179101'],4,12,16,839342,3,0,0,1,2521
d3c8b3a33d1441f0b2d354419e6126b8873c8e3a,0,Don Bosco Durai,2015-09-19 20:08:43-04:00,['d84e17f96ec040713989688fa7c5440c112201e5'],1,1,2,839344,1,,,,2521
3852419c32e5f42452f7a83f495f04b9c7c48817,0,Madhan Neethiraj,2015-09-20 19:11:18-07:00,"['9da461d272ad7627479def92e9b9c048ff8f97e2', 'd3c8b3a33d1441f0b2d354419e6126b8873c8e3a']",124,203,327,839671,12,,,,2521
b6aca92b0398598eb3db8a28722eb0303cee3433,0,rmani,2015-09-22 11:43:00-07:00,['d3c8b3a33d1441f0b2d354419e6126b8873c8e3a'],0,1,1,839672,1,,,,2521
001ec88376cf51d43174aa3631e18b512bdd1333,1,Madhan Neethiraj,2015-09-22 17:23:34-07:00,['3852419c32e5f42452f7a83f495f04b9c7c48817'],0,2329,2329,842001,18,0.373283396,0.609238452,1,2538
f08d5b361f633952bf00a8660cab0e0f4e00c7f5,1,Madhan Neethiraj,2015-09-23 13:26:57-07:00,['001ec88376cf51d43174aa3631e18b512bdd1333'],392,153,545,842546,8,0.672413793,0.931034483,0.017241379,2538
baf0ddd6f656ca0abff6ee800228f0e757855904,0,Madhan Neethiraj,2015-09-23 22:19:21-07:00,['b6aca92b0398598eb3db8a28722eb0303cee3433'],42,14,56,842602,14,0.96875,0.5625,0.0625,2538
5b371c7a6666bf1504b84ce59caaaa44d49e46e6,1,Madhan Neethiraj,2015-09-24 13:44:00-07:00,['baf0ddd6f656ca0abff6ee800228f0e757855904'],25,13,38,842640,2,1,1,0,2538
133b82cb29ed91d3dd0bf3afa57993ff34d6fb97,0,Madhan Neethiraj,2015-09-24 20:34:32-07:00,"['f08d5b361f633952bf00a8660cab0e0f4e00c7f5', '5b371c7a6666bf1504b84ce59caaaa44d49e46e6']",67,27,94,842734,15,,,,2538
e250f0291a23775a8f18f2a34f401575ddf2ed91,1,Madhan Neethiraj,2015-09-25 11:14:21-07:00,['133b82cb29ed91d3dd0bf3afa57993ff34d6fb97'],43,182,225,842959,13,0.344827586,1,0.965517241,2538
f52458921ca47e53331ef2d14acb66200c90aedf,1,Madhan Neethiraj,2015-09-25 14:01:18-07:00,['e250f0291a23775a8f18f2a34f401575ddf2ed91'],188,1531,1719,844678,35,0,0,1,2546
a57caadabfa4e1c1197442f3beed757d606978bf,1,Madhan Neethiraj,2015-09-26 09:40:32-07:00,['f52458921ca47e53331ef2d14acb66200c90aedf'],283,137,420,845098,10,1,0.391304348,0,2546
9c42a8a84bd46486db3e27663aa8139572a34b3d,0,Madhan Neethiraj,2015-09-26 23:54:50-07:00,['a57caadabfa4e1c1197442f3beed757d606978bf'],46,82,128,845226,6,0,0,1,2546
adae75020168b835e6b290cf1c9bd49a97e1dd5b,0,Velmurugan Periasamy,2015-09-27 21:51:06-04:00,['5b371c7a6666bf1504b84ce59caaaa44d49e46e6'],0,8,8,845234,1,,,,2546
d5c9dade84984e995cb9a971be27db9331e14d02,0,Velmurugan Periasamy,2015-09-27 21:55:33-04:00,['adae75020168b835e6b290cf1c9bd49a97e1dd5b'],42,11,53,845287,3,0,0,0,2546
95cd9e834f3d07cd9897ef9ea8293c5d4d5c2fd4,0,Velmurugan Periasamy,2015-09-27 21:57:26-04:00,['d5c9dade84984e995cb9a971be27db9331e14d02'],1,1,2,845289,1,,,,2546
f33879b4f1d13cf0b08f74b90f2e4607c00d24d4,1,Velmurugan Periasamy,2015-09-28 01:37:53-04:00,['95cd9e834f3d07cd9897ef9ea8293c5d4d5c2fd4'],56,33,89,845378,3,1,1,1,2546
eb8740380fc53a353ddfc239455c5e9254476056,1,Madhan Neethiraj,2015-09-28 09:57:15-07:00,['9c42a8a84bd46486db3e27663aa8139572a34b3d'],464,1962,2426,847804,33,0.237831858,0.347345133,0.956858407,2554
53ec707b3ac67e5d84d3fb949682c48428ad7fdc,0,Madhan Neethiraj,2015-09-28 12:04:58-07:00,['eb8740380fc53a353ddfc239455c5e9254476056'],0,1,1,847805,1,,,,2554
b6728b7c22313798fa103db8d9e0a1d6e16337fc,0,Madhan Neethiraj,2015-09-28 20:45:50-07:00,['53ec707b3ac67e5d84d3fb949682c48428ad7fdc'],3,13,16,847821,2,0.666666667,0.666666667,0.666666667,2554
fe44eb027a063739fd71d9936281338ed29285da,0,rmani,2015-09-28 22:32:41-07:00,['f33879b4f1d13cf0b08f74b90f2e4607c00d24d4'],20,211,231,848052,21,0.05,1,0.15,2554
5ea6395470f958fd2a571521f19d50de353e0612,0,sneethiraj,2015-09-29 11:11:04-04:00,['fe44eb027a063739fd71d9936281338ed29285da'],1,1,2,848054,1,,,,2554
919b550fa4fd94e6f8091f1865d3c43687c17210,0,sneethiraj,2015-09-29 11:43:17-04:00,['5ea6395470f958fd2a571521f19d50de353e0612'],1,46,47,848101,1,,,,2554
e2075ffa93d727c49f04d3ce937a87bd6b966cbe,1,Madhan Neethiraj,2015-09-29 08:53:52-07:00,['b6728b7c22313798fa103db8d9e0a1d6e16337fc'],66,68,134,848235,7,0.615384615,1,0.692307692,2554
483ea47f3700c124bd045b42ce8f68aa8cb4231d,1,Alok Lal,2015-09-29 17:29:19-07:00,['919b550fa4fd94e6f8091f1865d3c43687c17210'],1,31,32,848267,2,0,0,1,2554
44ddd59706e2d61678cb1f487276fcb06eb70ea5,1,Madhan Neethiraj,2015-09-30 18:21:51-07:00,['e2075ffa93d727c49f04d3ce937a87bd6b966cbe'],182,621,803,849070,19,0.358024691,0.259259259,0.942386831,2557
e0faf52d92271dbdceb787585124c859f571355f,1,Madhan Neethiraj,2015-09-30 19:59:42-07:00,['44ddd59706e2d61678cb1f487276fcb06eb70ea5'],17,15,32,849102,6,0,0,1,2557
a9b153d3ae8c86eac683fb12c43f85c38ec1e6e2,1,Madhan Neethiraj,2015-09-30 20:16:49-07:00,['e0faf52d92271dbdceb787585124c859f571355f'],3,4,7,849109,2,,,,2557
c5ae2edd9948b9cbb463533589b356c9b4313fae,1,Don Bosco Durai,2015-10-01 11:00:55-07:00,['483ea47f3700c124bd045b42ce8f68aa8cb4231d'],0,2991,2991,852100,20,,,,2576
5872445a064df2e393459cc7657a7e8844d74f3d,1,Don Bosco Durai,2015-10-01 11:00:55-07:00,['c5ae2edd9948b9cbb463533589b356c9b4313fae'],0,4,4,852104,1,,,,2576
89b7ba227ae27f3c78ce86e4e4b268beaeba22a0,1,Madhan Neethiraj,2015-10-01 14:15:11-07:00,['a9b153d3ae8c86eac683fb12c43f85c38ec1e6e2'],42,69,111,852215,4,0.619047619,0.666666667,0.952380952,2576
54270d556f0341920f25d141c55746e8ec8bbea3,1,Madhan Neethiraj,2015-10-01 18:23:11-07:00,['89b7ba227ae27f3c78ce86e4e4b268beaeba22a0'],14,29,43,852258,3,1,1,1,2576
5db147378f004176638cddc626f6a0e9baa5efc1,1,Madhan Neethiraj,2015-10-01 19:07:41-07:00,['54270d556f0341920f25d141c55746e8ec8bbea3'],75,88,163,852421,3,0,0,1,2576
9aa396b5029c48aa49d954492b5d36c2afb14d83,1,Madhan Neethiraj,2015-10-01 20:18:02-07:00,['5db147378f004176638cddc626f6a0e9baa5efc1'],5,9,14,852435,2,0,0.5,1,2576
819426928a7615a4de538e37c6d226def8fb21ad,1,Madhan Neethiraj,2015-10-03 10:37:52-07:00,['9aa396b5029c48aa49d954492b5d36c2afb14d83'],13,54,67,852502,7,0.434782609,0.47826087,1,2576
ea0872f69e7738c9ecd90becc4f9545948713622,0,Gautam Borad,2015-10-06 10:42:43+05:18,['5872445a064df2e393459cc7657a7e8844d74f3d'],1,1,2,852504,1,,,,2576
ed27cecb62fe4ec7f9855326b5a8d3632ca0a3c9,0,Don Bosco Durai,2015-10-05 23:07:58-07:00,['ea0872f69e7738c9ecd90becc4f9545948713622'],0,133,133,852637,2,,,,2578
9cb055fc1a2f568f5b5fa9ab8ca0db43c56cf096,0,Don Bosco Durai,2015-10-05 23:07:59-07:00,['ed27cecb62fe4ec7f9855326b5a8d3632ca0a3c9'],31,55,86,852723,2,,,,2578
4b2fd94fbce6d3a5d54a537430d0a1fda9a95741,1,Gautam Borad,2015-10-07 11:47:55+05:18,['9cb055fc1a2f568f5b5fa9ab8ca0db43c56cf096'],8,8,16,852739,4,0,0,0,2578
689dc76bc49da8e669e6e6e1ffd865f16a11aacc,1,Madhan Neethiraj,2015-10-07 17:30:31-07:00,['819426928a7615a4de538e37c6d226def8fb21ad'],247,729,976,853715,5,0,0.066666667,0,2578
a9e1135cd4b4184b4102146c159455e8d43f99af,0,Madhan Neethiraj,2015-10-07 18:25:55-07:00,['689dc76bc49da8e669e6e6e1ffd865f16a11aacc'],2,2,4,853719,1,,,,2578
140f7efb8ad202105bb23aa16469a961004b0c4f,1,Gautam Borad,2015-10-08 12:02:35+05:18,['4b2fd94fbce6d3a5d54a537430d0a1fda9a95741'],243,503,746,854465,15,0.898203593,1,1,2579
35aa706ecbdd86b25a13f20e79248e59060935b9,0,Alok Lal,2015-10-09 16:19:54-07:00,['140f7efb8ad202105bb23aa16469a961004b0c4f'],24,580,604,855069,32,0.623188406,0.652173913,1,2579
c22bdecf8e028ec9e91d948d61d3dbbfbd00935e,1,Velmurugan Periasamy,2015-10-10 12:02:57-04:00,['35aa706ecbdd86b25a13f20e79248e59060935b9'],7,205,212,855281,15,0,0,1,2579
a2c4bb2941cf5f1026c50e7bc35494231a7da65f,0,Velmurugan Periasamy,2015-10-10 12:25:41-04:00,['c22bdecf8e028ec9e91d948d61d3dbbfbd00935e'],0,2276,2276,857557,9,0.217677137,0.277574872,0.873630387,2587
5ce7cc38b2628380deab1f78bfa373f389c72faa,1,Velmurugan Periasamy,2015-10-10 12:28:32-04:00,['c22bdecf8e028ec9e91d948d61d3dbbfbd00935e'],0,2276,2276,859833,9,0.217677137,0.277574872,0.873630387,2595
9474fe9d55e2e9a85923781fec88e1e3829c6224,0,Velmurugan Periasamy,2015-10-10 12:28:55-04:00,"['5ce7cc38b2628380deab1f78bfa373f389c72faa', 'a2c4bb2941cf5f1026c50e7bc35494231a7da65f']",0,0,0,859833,0,,,,2595
9a398915883d6d1924b0d1689992059bea5c032c,1,Madhan Neethiraj,2015-10-12 22:45:54-07:00,['a9e1135cd4b4184b4102146c159455e8d43f99af'],58,67,125,859958,3,0,0,0,2595
de170ab2358739f938f52ccc871d4d9e3ebb52ef,1,Velmurugan Periasamy,2015-10-13 20:26:33-04:00,['9474fe9d55e2e9a85923781fec88e1e3829c6224'],32,922,954,860912,20,0.101910828,0.858598726,0.987261146,2595
22d3ad0ef7482b087b9866a5ef6c8ec630d72125,1,Velmurugan Periasamy,2015-10-13 20:27:56-04:00,['de170ab2358739f938f52ccc871d4d9e3ebb52ef'],6,15,21,860933,1,0,0,1,2595
cd58419919aaac19a59e4f59981b0ff34374bb7a,1,Velmurugan Periasamy,2015-10-13 20:32:31-04:00,['22d3ad0ef7482b087b9866a5ef6c8ec630d72125'],1,13,14,860947,1,0,1,1,2595
2f64a68999fafdd0eea5cadfb6180d6d5d464d11,1,Madhan Neethiraj,2015-10-13 18:11:24-07:00,['9a398915883d6d1924b0d1689992059bea5c032c'],4,4,8,860955,2,,,,2595
892f6bf3002ee18225bfcf758b9662513d3d1171,1,Madhan Neethiraj,2015-10-14 09:52:31-07:00,['2f64a68999fafdd0eea5cadfb6180d6d5d464d11'],3,39,42,860997,5,0,0,0,2595
3452ce8570d059f142c217c4b5f506f6d072769b,1,Madhan Neethiraj,2015-10-14 11:54:59-07:00,['892f6bf3002ee18225bfcf758b9662513d3d1171'],52,347,399,861396,16,0.379844961,0.294573643,0.860465116,2599
d734a2116556ef9eb0362591c1abee3458381d3f,0,Madhan Neethiraj,2015-10-14 13:14:19-07:00,['3452ce8570d059f142c217c4b5f506f6d072769b'],1,17,18,861414,1,,,,2599
1f43245f2adceaed6b6ca3f45925b586d0f24d77,1,Gautam Borad,2015-10-15 12:12:55+05:18,['cd58419919aaac19a59e4f59981b0ff34374bb7a'],65,131,196,861610,10,0.825,1,0.6,2599
8f07737f97c111eb6c088917076a2d86eb117a86,1,Madhan Neethiraj,2015-10-15 16:03:14-07:00,['1f43245f2adceaed6b6ca3f45925b586d0f24d77'],0,6,6,861616,1,0,0,1,2599
6f7587154d977290fe8b39ffecef5cd793eb0000,0,Velmurugan Periasamy,2015-10-15 23:47:53-04:00,['8f07737f97c111eb6c088917076a2d86eb117a86'],1,2,3,861619,2,,,,2599
be03c44b6e978dea70cac629566c3826a835db6a,1,Madhan Neethiraj,2015-10-16 08:50:34-07:00,['d734a2116556ef9eb0362591c1abee3458381d3f'],11,45,56,861675,1,0.416666667,0.416666667,1,2599
f17ed11505a8504954dc3a0f4a7a8751507a1315,1,Madhan Neethiraj,2015-10-21 17:40:32-07:00,['be03c44b6e978dea70cac629566c3826a835db6a'],28,45,73,861748,2,0,0,1,2599
66b778832907cef61d6930b0995aacb07251db9b,0,Madhan Neethiraj,2015-10-22 10:59:20-07:00,['6f7587154d977290fe8b39ffecef5cd793eb0000'],4,28,32,861780,2,0,0,1,2599
bc4ee643b6c73d2c357a26383767094f1f2bc3ea,1,Gautam Borad,2015-10-26 14:48:53+05:18,['66b778832907cef61d6930b0995aacb07251db9b'],146,417,563,862343,14,0.337662338,0.662337662,0.688311688,2599
5b5e0120fa8dfb3427885b34607a6508e10798d5,0,Madhan Neethiraj,2015-10-26 18:07:49-07:00,"['f17ed11505a8504954dc3a0f4a7a8751507a1315', 'bc4ee643b6c73d2c357a26383767094f1f2bc3ea']",604,8503,9107,871450,147,,,,2599
11f73cd8ada0776b90f611ccacb7f0dd4fa7a780,1,rmani,2015-10-27 11:30:16-07:00,['bc4ee643b6c73d2c357a26383767094f1f2bc3ea'],2,9,11,871461,1,0,0,1,2599
a2c729021d7e3c04680c1c1002a17dac92b06d32,1,rmani,2015-10-27 16:30:08-07:00,['11f73cd8ada0776b90f611ccacb7f0dd4fa7a780'],82,6201,6283,877744,40,0.716708368,0.968306922,0.53294412,2622
22859f5bc6d4b1c708162f5e863e4ddafbf1da04,0,Madhan Neethiraj,2015-10-27 16:57:25-07:00,['5b5e0120fa8dfb3427885b34607a6508e10798d5'],40,34,74,877818,3,0.5,0.5,0,2622
757d1eb211922be7f09cfb773d839f23ef98f147,1,Madhan Neethiraj,2015-10-27 17:03:51-07:00,['22859f5bc6d4b1c708162f5e863e4ddafbf1da04'],937,693,1630,879448,15,0.388571429,0,0,2624
a03a317490901e5a82b4b3cd71af76fe760fc785,0,Madhan Neethiraj,2015-10-27 17:12:58-07:00,"['757d1eb211922be7f09cfb773d839f23ef98f147', 'a2c729021d7e3c04680c1c1002a17dac92b06d32']",84,6210,6294,885742,41,,,,2624
21204fe6226710cc3837758f67e0fa76d077dfb0,1,Madhan Neethiraj,2015-10-28 14:01:00-07:00,['a03a317490901e5a82b4b3cd71af76fe760fc785'],1,1,2,885744,1,,,,2624
d60c4df2af863e38a4253ced8e510b36d5e606a1,0,rmani,2015-10-28 16:18:35-07:00,['21204fe6226710cc3837758f67e0fa76d077dfb0'],0,81,81,885825,2,,,,2625
f1135ea2ea6cd48209b73a25be77613c9d355abf,1,Don Bosco Durai,2015-10-29 20:25:24-07:00,['d60c4df2af863e38a4253ced8e510b36d5e606a1'],102,236,338,886163,3,0.037383178,0.485981308,1,2625
a57740e277bf777e78cc0807349a9bcd96a80f3e,1,Velmurugan Periasamy,2015-10-30 18:32:07-04:00,['f1135ea2ea6cd48209b73a25be77613c9d355abf'],0,340,340,886503,7,0.487341772,0.284810127,1,2629
99b97e21bf4dd9c136319471daf7b18ad719d508,0,Velmurugan Periasamy,2015-10-30 18:32:07-04:00,['a57740e277bf777e78cc0807349a9bcd96a80f3e'],10,15,25,886528,3,0,1,1,2629
e83d4a703c533ce1e8b58ac5cf1dd2df83a25240,0,Velmurugan Periasamy,2015-10-30 18:32:07-04:00,['99b97e21bf4dd9c136319471daf7b18ad719d508'],18,27,45,886573,4,0.5,0.5,1,2629
fab2a10c45e56e4d3253641c2a1f862bc989597c,0,Velmurugan Periasamy,2015-10-30 18:32:07-04:00,['e83d4a703c533ce1e8b58ac5cf1dd2df83a25240'],3,2,5,886578,1,,,,2629
6b79130d9b7076b7ce796b7acef29544be2d82b0,1,Madhan Neethiraj,2015-10-30 15:54:20-07:00,['fab2a10c45e56e4d3253641c2a1f862bc989597c'],55,112,167,886745,14,0.090909091,0.477272727,1,2629
fb56f9c22f319e70819e6405fad255bf82935daa,0,Madhan Neethiraj,2015-10-30 17:08:15-07:00,['6b79130d9b7076b7ce796b7acef29544be2d82b0'],19,6,25,886770,1,1,1,0,2629
efd317f90ec0a2ffd750292807ea2116054d8cc2,0,rmani,2015-10-31 09:55:50-07:00,['fb56f9c22f319e70819e6405fad255bf82935daa'],4,3,7,886777,3,,,,2629
1b3e6c6dfd3b5aa844aed84f9ba50aa1a15a2a00,0,Madhan Neethiraj,2015-10-31 21:44:03-07:00,['efd317f90ec0a2ffd750292807ea2116054d8cc2'],24,27,51,886828,1,0,0,1,2629
433ab85239f3969c445903f992b982a66d455cf6,1,Alok Lal,2015-11-01 14:17:08-08:00,['1b3e6c6dfd3b5aa844aed84f9ba50aa1a15a2a00'],136,395,531,887359,9,0,0,1,2632
3e462d15fe1b141e7ec90ed07cf03af8d418ef62,0,rmani,2015-11-02 16:33:00-08:00,['433ab85239f3969c445903f992b982a66d455cf6'],12,22,34,887393,1,0,1,1,2632
ec3d1121d8a7b6e6018f1d6c5330ccd902884025,0,Velmurugan Periasamy,2015-11-03 17:45:32-05:00,['3e462d15fe1b141e7ec90ed07cf03af8d418ef62'],5,15,20,887413,1,,,,2632
0158e1a1c7ca7997e3865693f599e5caaa69f505,1,sneethiraj,2015-11-05 16:36:58-05:00,['ec3d1121d8a7b6e6018f1d6c5330ccd902884025'],27,59,86,887499,1,0.037037037,0.037037037,0.037037037,2632
c89b01f28aeda1fa7fc05de7546e1e12614a4319,0,Madhan Neethiraj,2015-11-08 11:07:14-08:00,['0158e1a1c7ca7997e3865693f599e5caaa69f505'],0,2,2,887501,1,0,0,1,2632
8e07c02c754365124524f70676d082067e782c88,0,Madhan Neethiraj,2015-11-08 21:47:57-08:00,['c89b01f28aeda1fa7fc05de7546e1e12614a4319'],41,23,64,887565,2,,,,2632
febe19357cdf4957e4da2007e244d12e5dc8b3f1,0,rmani,2015-11-09 09:46:23-08:00,['8e07c02c754365124524f70676d082067e782c88'],2,7,9,887574,2,0,1,0,2632
c462d0ea9e65c19c5fc38d9d7dd10ed251f51412,1,Gautam Borad,2015-11-10 09:25:11+05:18,['febe19357cdf4957e4da2007e244d12e5dc8b3f1'],1227,1067,2294,889868,20,0.386281588,0.346570397,0.305054152,2632
5b86864a9b042cb023831fe59a5495fbc552b2b2,0,Alok Lal,2015-11-09 21:41:12-08:00,['c462d0ea9e65c19c5fc38d9d7dd10ed251f51412'],1,21,22,889890,11,,,,2642
49e890e26360c742ccbf80d2741df7bec48c6319,1,Madhan Neethiraj,2015-11-11 12:29:47-08:00,['5b86864a9b042cb023831fe59a5495fbc552b2b2'],485,132,617,890507,12,0.638613861,0.599009901,0,2642
7c185e1f5a8881fd7a7ad0d60abd756b3cd416ec,1,Madhan Neethiraj,2015-11-11 12:39:39-08:00,['49e890e26360c742ccbf80d2741df7bec48c6319'],1046,1394,2440,892947,18,1,0,0.779220779,2644
79d4fa41f23cb0929ea4071fc2f014f4b640e4b9,1,Madhan Neethiraj,2015-11-12 11:29:10-08:00,['7c185e1f5a8881fd7a7ad0d60abd756b3cd416ec'],36,24,60,893007,1,1,1,0,2644
4db23568ce81169ca8d750b9953110b0efb169ba,0,rmani,2015-11-12 23:22:13-08:00,['79d4fa41f23cb0929ea4071fc2f014f4b640e4b9'],0,1,1,893008,1,,,,2644
427ed4a2b84139c8137becb4d06cdacbf890740d,1,Madhan Neethiraj,2015-11-13 08:30:08-08:00,['4db23568ce81169ca8d750b9953110b0efb169ba'],1,5,6,893014,1,0,0,1,2644
18e63978666eba70b67519501cc7871b3a8c79d7,0,Velmurugan Periasamy,2015-11-13 12:57:25-05:00,['427ed4a2b84139c8137becb4d06cdacbf890740d'],8,0,8,893022,1,1,0,1,2644
e267c09235c81e5d9a98318b504b139c3686c88c,0,rmani,2015-11-16 13:30:55-08:00,['18e63978666eba70b67519501cc7871b3a8c79d7'],2,0,2,893024,1,,,,2644
d5c707ffc5517722d6a5514ded2ed31a0d4ae6e4,1,sneethiraj,2015-11-19 11:53:08-05:00,['e267c09235c81e5d9a98318b504b139c3686c88c'],93,749,842,893866,17,0.457583548,0.544987147,0.781491003,2647
0b725f04460b5422277dd0e1b362a121665296fa,0,sneethiraj,2015-11-19 14:52:45-05:00,['d5c707ffc5517722d6a5514ded2ed31a0d4ae6e4'],1,58,59,893925,3,,,,2647
e47756ced5b9307e4e0c29543847d9ba0f6fad2b,1,Madhan Neethiraj,2015-11-19 23:09:42-08:00,['0b725f04460b5422277dd0e1b362a121665296fa'],72,146,218,894143,6,0,0.043478261,0.934782609,2648
624310dcf1d1a3a1823834681e949dbd89fd09c0,1,Gautam Borad,2015-11-20 22:46:53+05:18,['e47756ced5b9307e4e0c29543847d9ba0f6fad2b'],48,65,113,894256,19,0.2,0,1,2648
766f100e3457e42f59d35ede53d4c97488eb7398,0,Velmurugan Periasamy,2015-11-20 17:28:15-05:00,['624310dcf1d1a3a1823834681e949dbd89fd09c0'],11,4,15,894271,1,,,,2648
04c5dc364f3e4f69a858292f558b016f4e73c882,0,rmani,2015-11-20 14:39:56-08:00,['766f100e3457e42f59d35ede53d4c97488eb7398'],40,40,80,894351,1,,,,2648
7b7b314d89fab7c40f747c04c3bca989c4593de3,0,Velmurugan Periasamy,2015-11-23 17:08:36-05:00,['04c5dc364f3e4f69a858292f558b016f4e73c882'],12,11,23,894374,2,1,1,0,2648
ad45c554fe244ce1567c0560b52ae42f8d3a9d4b,1,Don Bosco Durai,2015-11-23 22:44:28-08:00,['7b7b314d89fab7c40f747c04c3bca989c4593de3'],1,2,3,894377,1,,,,2648
428afbce3b80d0bbcdb079ee7b0f9ed072fe8919,1,Don Bosco Durai,2015-11-24 05:20:14-08:00,['ad45c554fe244ce1567c0560b52ae42f8d3a9d4b'],26,74,100,894477,1,0,0,1,2648
0dadcd1089fc093ad4b4a0196b1760886f7f55d4,0,Don Bosco Durai,2015-11-24 12:52:19-08:00,['428afbce3b80d0bbcdb079ee7b0f9ed072fe8919'],6,27,33,894510,1,0.916666667,0.916666667,0.916666667,2648
fa435a922ff03fc19d8416f0b304999b5b1b9806,0,Don Bosco Durai,2015-11-24 22:48:34-08:00,['0dadcd1089fc093ad4b4a0196b1760886f7f55d4'],7,22,29,894539,2,1,1,1,2648
38fea60b7e8ee213d11ec8f4e01d3d25b0b9c8a9,0,Don Bosco Durai,2015-11-25 18:11:02-08:00,['fa435a922ff03fc19d8416f0b304999b5b1b9806'],1,1,2,894541,1,,,,2648
5216a89d20813e3a57ca68a383a92513bad955e8,1,Gautam Borad,2015-11-27 11:42:24+05:18,['38fea60b7e8ee213d11ec8f4e01d3d25b0b9c8a9'],35,53,88,894629,3,,,,2648
5fec40fe64e16142b17cc1d9bac24f626919d053,1,sneethiraj,2015-11-28 11:07:21-05:00,['5216a89d20813e3a57ca68a383a92513bad955e8'],35,49,84,894713,4,,,,2648
7a95ff0de1ca4b340deebf6c53e8559a025df750,1,Gautam Borad,2015-11-28 23:05:40+05:18,['5fec40fe64e16142b17cc1d9bac24f626919d053'],16,130,146,894859,3,0.089285714,0.089285714,1,2648
19c21348621498dcc50d5808aa8b636251a90c17,0,Velmurugan Periasamy,2015-12-01 13:39:52-08:00,['7a95ff0de1ca4b340deebf6c53e8559a025df750'],1,1,2,894861,1,,,,2648
7ac6a02a3b12a453c03d9e5868010fda4fdfa61d,0,Velmurugan Periasamy,2015-12-01 14:23:26-08:00,['19c21348621498dcc50d5808aa8b636251a90c17'],12,10,22,894883,2,1,1,0,2648
ec2ea92135cfae32378c377a1fad73039f3e1f3f,1,Velmurugan Periasamy,2015-12-01 14:46:01-08:00,['7ac6a02a3b12a453c03d9e5868010fda4fdfa61d'],178,210,388,895271,1,1,1,1,2648
44d365434a37ccd5a4fb8fc2988d17c8d9098046,1,Gautam Borad,2015-12-02 08:52:53+05:18,['ec2ea92135cfae32378c377a1fad73039f3e1f3f'],8,188,196,895467,5,0.044247788,1,0.787610619,2650
68ab77b298f817b3e3bd6544921d27bcae5e98b4,0,Gautam Borad,2015-12-02 09:25:33+05:18,['44d365434a37ccd5a4fb8fc2988d17c8d9098046'],2,3,5,895472,1,,,,2650
7a80c8e3522fb62ae5f3f53f6df786720a0569be,1,Madhan Neethiraj,2015-12-01 21:14:37-08:00,['68ab77b298f817b3e3bd6544921d27bcae5e98b4'],269,1287,1556,897028,33,0.293354943,0.542949757,0.905996759,2653
a733b7c3312f7bf954a233acaaf50ebf85b93b1b,1,Madhan Neethiraj,2015-12-02 11:36:19-08:00,['7a80c8e3522fb62ae5f3f53f6df786720a0569be'],49,61,110,897138,3,1,1,1,2653
90b7f0ba3f4bfa16060709e643b48a017ff43863,1,rmani,2015-12-02 15:31:37-08:00,['0dadcd1089fc093ad4b4a0196b1760886f7f55d4'],140,217,357,897495,5,0,0.52,1,2653
af8377f27d281c5c769d8ee0ede6e3e441658c30,0,rmani,2015-12-02 15:32:12-08:00,"['90b7f0ba3f4bfa16060709e643b48a017ff43863', 'a733b7c3312f7bf954a233acaaf50ebf85b93b1b']",598,2000,2598,900093,54,,,,2653
10d755acd15d4b7a604571838559eca0e9f44150,1,Gautam Borad,2015-12-03 08:50:08+05:18,['af8377f27d281c5c769d8ee0ede6e3e441658c30'],22,39,61,900154,4,0.2,0.266666667,0.2,2653
cd234cd617090f1a23e61e78bfe17219e54a2eca,0,Madhan Neethiraj,2015-12-03 11:27:44-08:00,['10d755acd15d4b7a604571838559eca0e9f44150'],6,0,6,900160,1,,,,2653
87d97cd14903b1bada33225081ec67d0ea6079da,0,Madhan Neethiraj,2015-12-03 16:36:38-08:00,['cd234cd617090f1a23e61e78bfe17219e54a2eca'],18,23,41,900201,2,0,0,0.5,2653
d0c8e4fc88886779a3cf93f951364cc6df785868,0,Velmurugan Periasamy,2015-12-03 17:49:50-08:00,['87d97cd14903b1bada33225081ec67d0ea6079da'],4,11,15,900216,1,0,0,1,2653
70df061dcaa2d670e823d44c86e7b11eb036f56d,1,Gautam Borad,2015-12-04 08:57:01+05:18,['d0c8e4fc88886779a3cf93f951364cc6df785868'],0,35,35,900251,1,0.6875,0.21875,0.6875,2653
591fdceba493d4ad8cf5ac5bb818558763b1a725,1,Alok Lal,2015-12-04 10:55:03-08:00,['70df061dcaa2d670e823d44c86e7b11eb036f56d'],4,18,22,900273,3,0,0,0,2653
dc9240d83e6ae2b7a676c151f265a91a327e4fb7,0,rmani,2015-12-04 11:09:51-08:00,['70df061dcaa2d670e823d44c86e7b11eb036f56d'],1,1,2,900275,1,,,,2653
dca76775e7243bf28b9425634009b9f6636ea5e4,0,rmani,2015-12-04 12:19:29-08:00,"['dc9240d83e6ae2b7a676c151f265a91a327e4fb7', '591fdceba493d4ad8cf5ac5bb818558763b1a725']",4,18,22,900297,3,,,,2653
3a60d698a7b946d1424772cd787ec4e956d7afb1,1,Velmurugan Periasamy,2015-12-04 19:45:20-05:00,['dca76775e7243bf28b9425634009b9f6636ea5e4'],8,13,21,900318,1,0,0,1,2653
3c62fdadaa2f718683c98a36e558b9cae9ac314f,1,Velmurugan Periasamy,2015-12-04 19:49:34-05:00,['3a60d698a7b946d1424772cd787ec4e956d7afb1'],681,3,684,901002,1,0.712871287,0.378712871,0,2653
99469d9b9bd0baac46ca6b2ece51932b387cc3c7,0,Velmurugan Periasamy,2015-12-04 20:12:25-05:00,['3c62fdadaa2f718683c98a36e558b9cae9ac314f'],9,0,9,901011,1,0,0,0,2653
8057944c2ee659fa3d97969811a59ae9c380eab6,1,Gautam Borad,2015-12-05 12:15:34+05:18,['99469d9b9bd0baac46ca6b2ece51932b387cc3c7'],9,66,75,901086,4,0.577777778,0,0.933333333,2653
f3467abc3dce82c66acaa4530ce8c6d34bb455a2,0,Gautam Borad,2015-12-07 10:48:30+05:18,['8057944c2ee659fa3d97969811a59ae9c380eab6'],14,150,164,901250,4,0.179104478,1,0.731343284,2654
8e1e54e6518ea7e485cd3ec580f9ccc9ab82b4bf,0,Gautam Borad,2015-12-08 13:35:20+05:18,['f3467abc3dce82c66acaa4530ce8c6d34bb455a2'],33,53,86,901336,3,0,1,1,2654
99121ecc50c617ad335508b1b6bffa61ca4ee3b2,0,Alok Lal,2015-12-08 15:28:26-08:00,['8e1e54e6518ea7e485cd3ec580f9ccc9ab82b4bf'],0,15,15,901351,1,0,0,0,2654
b16ac8a3ad091fde822d1227ce077b2e12b26adf,0,Velmurugan Periasamy,2015-12-08 21:41:36-05:00,['99121ecc50c617ad335508b1b6bffa61ca4ee3b2'],1,1,2,901353,1,,,,2654
d586d08e4329c0a41cbe27b1a5efbae0515651e6,0,Velmurugan Periasamy,2015-12-09 14:20:51-05:00,['b16ac8a3ad091fde822d1227ce077b2e12b26adf'],9,19,28,901381,2,0.166666667,0,0.416666667,2654
8af01a9989c5375bc712d5da6f8a7b7cd7700ec3,1,Velmurugan Periasamy,2015-12-09 14:29:55-05:00,['d586d08e4329c0a41cbe27b1a5efbae0515651e6'],0,118,118,901499,5,,,,2657
59c0e70c22fbac99da60cbaebb7c25030438740e,1,Madhan Neethiraj,2015-12-09 14:18:11-08:00,['8af01a9989c5375bc712d5da6f8a7b7cd7700ec3'],0,55,55,901554,2,,,,2657
bb81459e0f17b1d344541d956e1ab37ae2c14e3a,0,Velmurugan Periasamy,2015-12-10 13:22:37-05:00,['59c0e70c22fbac99da60cbaebb7c25030438740e'],2,1,3,901557,1,1,1,0,2657
269617d5dbf13fcbf9600efca72bc5a803f49a92,1,Don Bosco Durai,2015-12-10 12:17:19-08:00,['bb81459e0f17b1d344541d956e1ab37ae2c14e3a'],186,2318,2504,904061,20,,,,2663
6194ea0c4d4059669f4f679741991fcfba3e495c,1,Madhan Neethiraj,2015-12-12 09:30:25-08:00,['269617d5dbf13fcbf9600efca72bc5a803f49a92'],43,106,149,904210,2,0.658536585,1,1,2663
e2c638c9d361dd3b5b7a1c5e44c26c05b2278f74,0,Madhan Neethiraj,2015-12-14 09:48:04-08:00,['6194ea0c4d4059669f4f679741991fcfba3e495c'],49,3,52,904262,4,1,0.571428571,0,2663
40f225f0f103a8ad47683219afd6814c0e2d99b7,1,Alok Lal,2015-12-14 17:06:21-08:00,['e2c638c9d361dd3b5b7a1c5e44c26c05b2278f74'],8,8,16,904278,2,0,1,1,2663
e9e5060853ea0813288fb2d5a03aa2011369ce37,1,Madhan Neethiraj,2015-12-15 17:05:44-08:00,['40f225f0f103a8ad47683219afd6814c0e2d99b7'],52,50,102,904380,9,,,,2663
2d3bf53d94d8cb70dc230bf273dfcec8f1af0c81,0,Madhan Neethiraj,2015-12-15 18:14:18-08:00,['e9e5060853ea0813288fb2d5a03aa2011369ce37'],10,16,26,904406,3,,,,2663
93b562951f5ec61c31edf9f7bc8b85a583ea8870,1,Madhan Neethiraj,2015-12-18 08:57:09-08:00,['2d3bf53d94d8cb70dc230bf273dfcec8f1af0c81'],2,2,4,904410,1,,,,2663
9a4837dbf05c3678260480fbf8d811c391147e7c,1,Madhan Neethiraj,2015-12-18 16:16:50-08:00,['93b562951f5ec61c31edf9f7bc8b85a583ea8870'],1,1,2,904412,1,,,,2663
80cef9d43bf0e1f481861c258da64dc0e4c2a5ba,0,Madhan Neethiraj,2015-12-19 01:33:16-08:00,['9a4837dbf05c3678260480fbf8d811c391147e7c'],14,15,29,904441,1,0,0,0,2663
1ba7d49e7e852a2b7307460685ba22ba67469610,0,Madhan Neethiraj,2015-12-21 12:48:58-08:00,['80cef9d43bf0e1f481861c258da64dc0e4c2a5ba'],0,4,4,904445,1,1,1,1,2663
ea559d39d4a46d79f9c18b721eed31bb1b2c3307,1,Madhan Neethiraj,2015-12-21 14:59:10-08:00,['1ba7d49e7e852a2b7307460685ba22ba67469610'],0,7,7,904452,1,,,,2663
fbf4f3533d0c39d018d2ac92538f77761ca461d3,1,Madhan Neethiraj,2015-12-21 17:53:51-08:00,['ea559d39d4a46d79f9c18b721eed31bb1b2c3307'],13,279413,279426,1183878,30,0.252854812,0.316476346,0.913539967,2690
d94aecff9374dfa4a93685c8d215b55af219b68d,1,Madhan Neethiraj,2015-12-21 17:58:30-08:00,['fbf4f3533d0c39d018d2ac92538f77761ca461d3'],69,336,405,1184283,5,0.030150754,0.417085427,1,2690
5f79eec5097b0d7688159ccc579ae1117273686f,1,Madhan Neethiraj,2015-12-21 18:41:32-08:00,['d94aecff9374dfa4a93685c8d215b55af219b68d'],5,5,10,1184293,2,,,,2690
f326e5efdcacd1a0506fe988fe6b980e614d4ff0,1,rmani,2016-01-04 14:17:46-08:00,['5f79eec5097b0d7688159ccc579ae1117273686f'],0,2,2,1184295,1,,,,2690
5526e60c7055a66b033d66bd337272a0b8f130bf,1,sneethiraj,2016-01-04 18:33:51-05:00,['f326e5efdcacd1a0506fe988fe6b980e614d4ff0'],3,12,15,1184310,2,1,1,1,2690
8b4ba8efc83499ed38c0554ea2d7efb64464befd,0,Alok Lal,2016-01-06 14:12:09-08:00,['5526e60c7055a66b033d66bd337272a0b8f130bf'],0,0,0,1184310,1,,,,2690
fec84603f5139daea8730a4281400c2c426a234e,1,Madhan Neethiraj,2016-01-06 18:06:09-08:00,['8b4ba8efc83499ed38c0554ea2d7efb64464befd'],93,125,218,1184528,7,0.6,1,0.75,2690
5b9c094ff501ec591f6334bcea10ce37a2163711,1,Madhan Neethiraj,2016-01-09 23:59:10-08:00,['fec84603f5139daea8730a4281400c2c426a234e'],781,1734,2515,1187043,26,0.265206813,0.739659367,0.917274939,2699
a6a0d94cbd40ce1323d044b4a509add1f1aa15b3,0,Madhan Neethiraj,2016-01-11 16:10:51-08:00,['5b9c094ff501ec591f6334bcea10ce37a2163711'],190,0,190,1187233,1,,,,2699
1db9a55906b1ebb539c2a742aad0beab2c78c866,1,Madhan Neethiraj,2016-01-11 18:03:42-08:00,['a6a0d94cbd40ce1323d044b4a509add1f1aa15b3'],96,164,260,1187493,5,1,1,1,2699
1e3e53f4cb61a01f666f224ff559d00aa5830570,0,Gautam Borad,2016-01-12 14:16:21+05:18,['1db9a55906b1ebb539c2a742aad0beab2c78c866'],0,12,12,1187505,2,,,,2699
ffb895e2c2fd522a69018aff6e7bc6b322b46a69,0,rmani,2016-01-12 15:54:12-08:00,['1e3e53f4cb61a01f666f224ff559d00aa5830570'],5,27,32,1187537,1,1,1,1,2699
9ea1d4ad74b1ac7ffc0530aefadf87ffb4f33ec2,1,Madhan Neethiraj,2016-01-12 16:58:36-08:00,['ffb895e2c2fd522a69018aff6e7bc6b322b46a69'],103,112,215,1187752,5,0,0,1,2699
17dd5c3359fe1dccd25c4540a02c6b995d74f16f,1,Madhan Neethiraj,2016-01-12 17:28:33-08:00,['9ea1d4ad74b1ac7ffc0530aefadf87ffb4f33ec2'],0,518,518,1188270,3,1,1,1,2701
321d029d2679d555f23061e10e48ad02b2951ae5,0,Don Bosco Durai,2016-01-12 18:18:50-08:00,['17dd5c3359fe1dccd25c4540a02c6b995d74f16f'],10,10,20,1188290,2,,,,2701
d8a6621906a29d565f36dac45810eed2f5532378,0,Don Bosco Durai,2016-01-12 18:19:18-08:00,['321d029d2679d555f23061e10e48ad02b2951ae5'],2,2,4,1188294,1,,,,2701
cf29bb9a8b145be23675e5aa798b32b9d1c2a273,0,Madhan Neethiraj,2016-01-13 10:59:34-08:00,['d8a6621906a29d565f36dac45810eed2f5532378'],0,1,1,1188295,1,0,1,1,2701
88b1ae6c3da37800fb73fcf3b2220187d0d7b359,1,Don Bosco Durai,2016-01-13 12:00:57-08:00,['cf29bb9a8b145be23675e5aa798b32b9d1c2a273'],7,23,30,1188325,1,,,,2701
88bb615dc82c4502d3e61bb86fe48ad7828cca3a,1,Don Bosco Durai,2016-01-13 12:00:57-08:00,['88b1ae6c3da37800fb73fcf3b2220187d0d7b359'],3,10,13,1188338,1,,,,2701
5b169d42d177984e2534bc76b293944610be987d,0,Don Bosco Durai,2016-01-13 12:40:52-08:00,['88bb615dc82c4502d3e61bb86fe48ad7828cca3a'],10,17,27,1188365,1,,,,2701
f79bc59a0b4756ca5195a2ffb30759b4a82175ef,1,Madhan Neethiraj,2016-01-18 08:20:09-08:00,['5b169d42d177984e2534bc76b293944610be987d'],175,144,319,1188684,14,1,0.648648649,0.756756757,2701
fc5314e8b79e9d754c12a63bb67a0f0190ddfe9f,1,Madhan Neethiraj,2016-01-19 12:45:08-08:00,['f79bc59a0b4756ca5195a2ffb30759b4a82175ef'],47,101,148,1188832,10,0.958333333,1,1,2701
7f451e62bbbe0e7e82e693eca7c0323e014e0ab1,1,sneethiraj,2016-01-25 23:11:34-05:00,['fc5314e8b79e9d754c12a63bb67a0f0190ddfe9f'],2,39,41,1188873,2,,,,2701
2ea6975bcc2c5d148647d6410a84ed3f85c6e1af,0,sneethiraj,2016-01-26 01:19:39-05:00,['7f451e62bbbe0e7e82e693eca7c0323e014e0ab1'],0,106,106,1188979,2,,,,2702
fe0858a6c11d0a3c44611c2c4f58c1db0df002c4,0,Alok Lal,2016-01-25 23:08:39-08:00,['7f451e62bbbe0e7e82e693eca7c0323e014e0ab1'],4,0,4,1188983,1,,,,2702
4f6c351462546201cbb23a6377fb2de12de60299,0,sneethiraj,2016-01-26 09:59:51-05:00,"['2ea6975bcc2c5d148647d6410a84ed3f85c6e1af', 'fe0858a6c11d0a3c44611c2c4f58c1db0df002c4']",4,0,4,1188987,1,,,,2702
4bc45ee0380d91bb85b2cfb23ed58d92e537e842,1,sneethiraj,2016-01-26 11:06:27-05:00,['4f6c351462546201cbb23a6377fb2de12de60299'],3540,3444,6984,1195971,39,,,,2702
9475c0f1f8fad707652f1c64dd0100093002c290,1,sneethiraj,2016-01-26 11:45:17-05:00,['4bc45ee0380d91bb85b2cfb23ed58d92e537e842'],43,43,86,1196057,39,,,,2702
3634faa1253bbb3298e61630defbaf76d032dff6,1,Alok Lal,2016-01-26 11:49:37-08:00,['9475c0f1f8fad707652f1c64dd0100093002c290'],11,68,79,1196136,1,0.125,1,0.875,2702
2e4ed83a983298da0c96cf08fecc86ed33c23db5,0,sneethiraj,2016-01-27 11:06:44-05:00,['3634faa1253bbb3298e61630defbaf76d032dff6'],2,2,4,1196140,1,,,,2702
870070f2e24ed0bf95c42a56d014f0e0db8ba795,0,sneethiraj,2016-01-28 10:40:21-05:00,['2e4ed83a983298da0c96cf08fecc86ed33c23db5'],1,1,2,1196142,1,,,,2702
6fd9608735b4403d6229ba88ceaebd7be520810e,1,Gautam Borad,2016-02-02 10:56:45+05:18,['870070f2e24ed0bf95c42a56d014f0e0db8ba795'],11,41,52,1196194,10,0.75,1,1,2702
636ae2ad1fd0e32f0ac87e0281ab9859e09b4162,1,Gautam Borad,2016-02-02 11:09:23+05:18,['6fd9608735b4403d6229ba88ceaebd7be520810e'],6,53,59,1196253,4,0,0,0.76744186,2702
de9327df0a2f7b5e8fcea976dbc253d7098e2578,0,Gautam Borad,2016-02-02 11:18:50+05:18,['636ae2ad1fd0e32f0ac87e0281ab9859e09b4162'],70,42,112,1196365,1,1,1,0,2702
018644b9451b2b57b949ac3aae3f14910f2c4fb7,1,Gautam Borad,2016-02-02 11:23:47+05:18,['de9327df0a2f7b5e8fcea976dbc253d7098e2578'],4334,530,4864,1201229,117,0.133187773,0.031659389,0,2702
a6f4edd2714d4845ca1aa011492f0ba5d1f80c7e,1,Gautam Borad,2016-02-02 12:15:28+05:18,['018644b9451b2b57b949ac3aae3f14910f2c4fb7'],1,1,2,1201231,1,,,,2702
c62aef11b41bfa6774b2bd2d5795d9cef2aeb861,1,Gautam Borad,2016-02-02 12:48:13+05:18,['a6f4edd2714d4845ca1aa011492f0ba5d1f80c7e'],4,28,32,1201263,3,0.44,0.44,0.96,2702
2c89cf5107d6f1316bd6a72f8ccebbbc4c20ebe9,1,Velmurugan Periasamy,2016-02-03 11:37:35-05:00,['c62aef11b41bfa6774b2bd2d5795d9cef2aeb861'],0,2829,2829,1204092,6,1,1,1,2706
ee496c1396a00c41e754a2e512f9b72307b20cba,1,sneethiraj,2016-02-03 19:44:59-05:00,['2c89cf5107d6f1316bd6a72f8ccebbbc4c20ebe9'],18,18,36,1204128,5,,,,2706
81c2588c0e3c84616c24f21c68269d7b928fca0e,1,Alok Lal,2016-02-03 23:37:51-08:00,['ee496c1396a00c41e754a2e512f9b72307b20cba'],8,124,132,1204260,5,1,1,1,2708
41a877b4984cd6305209a0ffcd554481e7a100a3,0,sneethiraj,2016-02-04 04:22:59-05:00,['81c2588c0e3c84616c24f21c68269d7b928fca0e'],6,38,44,1204304,2,,,,2708
9286cf28e589ae0ef630e309cd5f6057448d09f1,1,Alok Lal,2016-02-04 15:37:51-08:00,['41a877b4984cd6305209a0ffcd554481e7a100a3'],217,130,347,1204651,43,,,,2708
9ea73e418b9c813a97722ff1782dd38e07614647,1,Gautam Borad,2016-02-09 10:04:45+05:18,['9286cf28e589ae0ef630e309cd5f6057448d09f1'],5,5,10,1204661,2,,,,2708
6ca739b0406ee2b513f83e9d4f7ada19c5f932ee,1,Gautam Borad,2016-02-10 16:11:57+05:18,['9ea73e418b9c813a97722ff1782dd38e07614647'],106,754,860,1205521,11,0.121268657,0.442164179,0.962686567,2708
4e2e83eef660fae5287d4d1dc7bbea68015445ee,1,Madhan Neethiraj,2016-02-10 17:24:34-08:00,['6ca739b0406ee2b513f83e9d4f7ada19c5f932ee'],150,949,1099,1206620,17,0.37109375,0.544921875,0.974609375,2710
e7fe42f6b2e375be20cf2b20c7417f38b8e67874,0,Madhan Neethiraj,2016-02-11 08:45:22-08:00,['4e2e83eef660fae5287d4d1dc7bbea68015445ee'],0,342,342,1206962,5,,,,2715
0966bbccbf8e1781219a3933a0ab17a0a06051ba,0,Alok Lal,2016-02-11 10:54:13-08:00,['e7fe42f6b2e375be20cf2b20c7417f38b8e67874'],34,16,50,1207012,2,0,0,0,2715
658f2310dc674391b7d930e4d3a43cc976693370,1,Velmurugan Periasamy,2016-02-11 17:49:06-05:00,['0966bbccbf8e1781219a3933a0ab17a0a06051ba'],148,481,629,1207641,3,0.43,0.52,0.695,2716
63c54729603323d8b625ae6941aea0abe80df2b3,0,Velmurugan Periasamy,2016-02-11 18:38:32-05:00,['658f2310dc674391b7d930e4d3a43cc976693370'],2,9,11,1207652,1,1,1,1,2716
c20a0d1ad1995c404c0d32e85f820397226ea882,1,Madhan Neethiraj,2016-02-12 02:18:02-08:00,['63c54729603323d8b625ae6941aea0abe80df2b3'],106,185,291,1207943,9,0.363636364,0.727272727,1,2716
a918de33da1c9e2db511e623f8f9f46f532fb7a3,0,Velmurugan Periasamy,2016-02-14 17:03:12-05:00,['c20a0d1ad1995c404c0d32e85f820397226ea882'],1,1,2,1207945,1,,,,2716
91b10ac8ea4acec0ec1533573778a4d20a7dd20e,0,Madhan Neethiraj,2016-02-16 11:41:10-08:00,['a918de33da1c9e2db511e623f8f9f46f532fb7a3'],5,2,7,1207952,2,0,0,1,2716
db3f7ceb5f2be9f2d788c868ae4d61664795d9fb,1,Madhan Neethiraj,2016-02-16 13:21:50-08:00,['91b10ac8ea4acec0ec1533573778a4d20a7dd20e'],23,31,54,1208006,2,0,0,1,2716
b1ff4797fb0879183edcd05e8653ebb4e461f921,1,Velmurugan Periasamy,2016-02-17 00:46:34-05:00,['db3f7ceb5f2be9f2d788c868ae4d61664795d9fb'],3,201,204,1208210,3,0.210526316,0.210526316,0.921052632,2717
13f3b998155330132af5c14d6c397ccfe6cb2d0c,0,Velmurugan Periasamy,2016-02-18 11:26:17-05:00,['b1ff4797fb0879183edcd05e8653ebb4e461f921'],83,111,194,1208404,1,0,0,0.375,2717
02b4790aae3e0b3da797499f6a275edb3385bdda,1,Velmurugan Periasamy,2016-02-18 12:15:21-05:00,['13f3b998155330132af5c14d6c397ccfe6cb2d0c'],143,320,463,1208867,5,0.939759036,0.939759036,1,2717
a9775857dcfb36477bd282e97e0a71380ffb700f,0,Alok Lal,2016-02-18 11:55:31-08:00,['02b4790aae3e0b3da797499f6a275edb3385bdda'],1,2,3,1208870,1,,,,2717
928a5ef9f452894023b1409d8b189c739e7a748f,0,Velmurugan Periasamy,2016-02-19 13:43:52-05:00,['a9775857dcfb36477bd282e97e0a71380ffb700f'],7,40,47,1208917,3,0.541666667,0.541666667,1,2717
84ceac76abfbcfafbbaadc7c9e3d1c9fffbb452f,1,Velmurugan Periasamy,2016-02-19 13:59:30-05:00,['928a5ef9f452894023b1409d8b189c739e7a748f'],1,2,3,1208920,1,0,0,1,2717
073577dd786b105aa67d414f1e48b4e7d4aac1f4,0,Alok Lal,2016-02-19 13:39:15-08:00,['84ceac76abfbcfafbbaadc7c9e3d1c9fffbb452f'],62,31,93,1209013,8,0.739130435,0.652173913,0.391304348,2717
46895de3af07d3934fd776b8eedc5bc031fdfa3e,0,Alok Lal,2016-02-19 14:51:19-08:00,['073577dd786b105aa67d414f1e48b4e7d4aac1f4'],3409,0,3409,1212422,25,0.796859666,0.65750736,0.15063788,2717
b2eb42532ddf6c84dd1e1246ceaf08753f3d6044,1,Gautam Borad,2016-02-22 09:59:03+05:18,['46895de3af07d3934fd776b8eedc5bc031fdfa3e'],129,774,903,1213325,24,0,0,0.024390244,2717
b1e1135b65ad51bcc3a7ce54ae74f1696932220f,1,Alok Lal,2016-02-22 09:01:15-08:00,['b2eb42532ddf6c84dd1e1246ceaf08753f3d6044'],21,21,42,1213367,12,,,,2717
edc4f2b6eab3dc3637788c0be21213be94ade17e,1,Alok Lal,2016-02-22 12:30:18-08:00,['b1e1135b65ad51bcc3a7ce54ae74f1696932220f'],8,129,137,1213504,4,0.80952381,1,0.773809524,2717
bdf44e402bed529f21d93cd86429163c8d6b69b2,0,Alok Lal,2016-03-01 09:49:31-08:00,['edc4f2b6eab3dc3637788c0be21213be94ade17e'],138,10,148,1213652,62,,,,2717
d40a0205433c526261ad408f2ddcf640b6b81f7a,0,Madhan Neethiraj,2016-03-01 13:48:14-08:00,['bdf44e402bed529f21d93cd86429163c8d6b69b2'],3,157,160,1213812,2,0.433333333,1,1,2718
b1b0fb16cd4197a67a61d8a1db2c40863739327c,1,Madhan Neethiraj,2016-03-01 18:48:45-08:00,['d40a0205433c526261ad408f2ddcf640b6b81f7a'],184,331,515,1214327,10,0.322222222,0.811111111,1,2718
d879a2567f10038996ce201e94b6bcc25df51b38,0,Alok Lal,2016-03-02 08:45:30-08:00,['b1b0fb16cd4197a67a61d8a1db2c40863739327c'],3,0,3,1214330,3,,,,2718
3df4ae5ea5ebb52587e1a46b69b3fa16bba2dcd2,0,Madhan Neethiraj,2016-03-02 10:29:56-08:00,['d879a2567f10038996ce201e94b6bcc25df51b38'],0,23,23,1214353,1,,,,2718
e7541c9da82add57dd64d2f2cac6f94fa16b49fe,1,Madhan Neethiraj,2016-03-02 11:11:10-08:00,['3df4ae5ea5ebb52587e1a46b69b3fa16bba2dcd2'],81,95,176,1214529,9,1,1,1,2718
53623080a218954e8ce1464342c13a196d58127f,1,Madhan Neethiraj,2016-03-02 21:12:57-08:00,['e7541c9da82add57dd64d2f2cac6f94fa16b49fe'],15,137,152,1214681,8,0.2875,0.2875,1,2718
4577aff909c145ebbfeaa70ebdd76be9e045acc6,0,sneethiraj,2016-03-03 13:05:00-05:00,['53623080a218954e8ce1464342c13a196d58127f'],6,0,6,1214687,4,,,,2718
0fe605a97945ac927ee4f9097e23163acce9409d,1,Madhan Neethiraj,2016-03-04 10:19:10-08:00,['4577aff909c145ebbfeaa70ebdd76be9e045acc6'],62,59,121,1214808,20,,,,2718
f46c5cd910bbe52796d3555d55c381a8186eea4e,1,Gautam Borad,2016-03-05 15:30:16+05:18,['0fe605a97945ac927ee4f9097e23163acce9409d'],4,33,37,1214845,1,0.3125,0.96875,1,2718
6dbd2b8f14ded9f1cbcfe896b1d1c2b2141ce41d,1,Gautam Borad,2016-03-05 19:57:41+05:18,['f46c5cd910bbe52796d3555d55c381a8186eea4e'],2,270,272,1215117,5,0.317204301,0.61827957,1,2719
5423ee4f6074f3a4a01991431fd7d03e8712ddf1,1,Madhan Neethiraj,2016-03-06 22:08:07-08:00,['6dbd2b8f14ded9f1cbcfe896b1d1c2b2141ce41d'],282,1181,1463,1216580,4,0.031496063,0.414173228,0.732283465,2720
dddc4d42011adf28062853317908259e894964da,1,Madhan Neethiraj,2016-03-07 17:26:30-08:00,['5423ee4f6074f3a4a01991431fd7d03e8712ddf1'],157,189,346,1216926,10,1,1,1,2720
3620842ae3841ed14bb1b00d5fbd802ae84d2f39,0,Madhan Neethiraj,2016-03-07 17:38:19-08:00,['dddc4d42011adf28062853317908259e894964da'],1,78,79,1217005,5,1,1,0.62962963,2721
8f1ac35a01a61213beab09f471501f01177ff275,1,Madhan Neethiraj,2016-03-08 09:54:48-08:00,['3620842ae3841ed14bb1b00d5fbd802ae84d2f39'],49,47,96,1217101,23,,,,2721
a1977b6afc45367c35052d07d5ea1923dc8e6504,0,Madhan Neethiraj,2016-03-08 14:34:43-08:00,['8f1ac35a01a61213beab09f471501f01177ff275'],1,1,2,1217103,1,,,,2721
13e6b95864e0c91619cfb106b3d15ce7ff8b6152,0,Madhan Neethiraj,2016-03-08 15:29:42-08:00,['a1977b6afc45367c35052d07d5ea1923dc8e6504'],2,8,10,1217113,2,0.25,0.25,1,2721
f06795e2e3ed70cc3c1970a25fa1c483a60362c2,1,Madhan Neethiraj,2016-03-09 11:09:30-08:00,['13e6b95864e0c91619cfb106b3d15ce7ff8b6152'],15,1138,1153,1218266,23,0.555555556,0.709401709,0.914529915,2739
46c2f94abd0b95b8b9da741b9cdb21a9422c009b,1,Madhan Neethiraj,2016-03-09 13:47:12-08:00,['f06795e2e3ed70cc3c1970a25fa1c483a60362c2'],13,50,63,1218329,3,0.4,0,0.4,2739
bda66dd48dfbac136d1d1f6171245883374cb0f8,0,Madhan Neethiraj,2016-03-10 16:03:23-08:00,['46c2f94abd0b95b8b9da741b9cdb21a9422c009b'],1,2,3,1218332,1,,,,2739
880692ae98f7008ec5d5bf34a029cc461dbb0318,1,Alok Lal,2016-03-11 17:40:30-08:00,['bda66dd48dfbac136d1d1f6171245883374cb0f8'],0,32,32,1218364,1,0,0.038461538,0.961538462,2739
f04e111018e2db7079538036f21a3da024c823b8,0,sneethiraj,2016-03-14 12:30:24-04:00,['880692ae98f7008ec5d5bf34a029cc461dbb0318'],0,3,3,1218367,3,,,,2742
1fe2d3ec612587abb2cb59dd9776de701cd288ca,1,Alok Lal,2016-03-14 12:32:06-07:00,['f04e111018e2db7079538036f21a3da024c823b8'],34,23,57,1218424,19,0.5,0,0,2742
3a21f74494ad253afb7919939491258a52a4d655,1,rmani,2016-03-14 15:22:56-07:00,['1fe2d3ec612587abb2cb59dd9776de701cd288ca'],123,284,407,1218831,17,0,0.185714286,0.742857143,2742
d36a04a84cff2bb10f1ea221fb731972cdedd38e,0,rmani,2016-03-15 09:54:45-07:00,['3a21f74494ad253afb7919939491258a52a4d655'],1,0,1,1218832,1,,,,2742
3abd4be2555dc135067245a70d002920f1e9cb39,1,Gautam Borad,2016-03-16 17:37:16+05:18,['d36a04a84cff2bb10f1ea221fb731972cdedd38e'],10,313,323,1219155,7,0.108614232,0.082397004,0.872659176,2743
0ecac71fd5fc61642fef9b25fb2e12ea69052187,1,Alok Lal,2016-03-17 12:36:33-07:00,['3abd4be2555dc135067245a70d002920f1e9cb39'],5,11,16,1219171,1,1,1,1,2743
4b6068c5be42607e0a731c612a1a9294eae1b9c7,1,rmani,2016-03-17 14:12:55-07:00,['0ecac71fd5fc61642fef9b25fb2e12ea69052187'],2,4,6,1219177,1,0,0,1,2743
a4c3beb7137013f7d5c338b17e3e465cc4a20031,0,rmani,2016-03-18 10:00:42-07:00,['4b6068c5be42607e0a731c612a1a9294eae1b9c7'],2,3,5,1219182,1,,,,2743
7e429405c46fb8f9c5e19682db275be5a308a171,1,Velmurugan Periasamy,2016-03-18 19:03:06-04:00,['a4c3beb7137013f7d5c338b17e3e465cc4a20031'],113,45,158,1219340,3,0.984848485,1,1,2743
ca84cf77907062b17dcaf4e7a0af02ddedff07dc,1,Alok Lal,2016-03-21 16:59:54-07:00,['7e429405c46fb8f9c5e19682db275be5a308a171'],5,4,9,1219349,2,,,,2743
d242dd6e9dea78586393e6a50b47944652502eb1,1,Madhan Neethiraj,2016-03-22 16:43:50-07:00,['ca84cf77907062b17dcaf4e7a0af02ddedff07dc'],277,2859,3136,1222485,37,0.444113264,0.538002981,0.83681073,2752
9b1fa33ce0326fb19e8641f0a3b105c8b714f8b5,1,Gautam Borad,2016-03-23 14:07:59+05:18,['d242dd6e9dea78586393e6a50b47944652502eb1'],10,36,46,1222531,3,0,0,0,2752
66c3034891958bc7038af960e155bdaeb6b0c559,1,Madhan Neethiraj,2016-03-23 04:08:34-07:00,['9b1fa33ce0326fb19e8641f0a3b105c8b714f8b5'],7,24,31,1222562,3,1,1,0.666666667,2752
2836dea0b2ff4ed42e0130086d07e183b03362fc,1,Gautam Borad,2016-03-23 17:53:48+05:18,['66c3034891958bc7038af960e155bdaeb6b0c559'],8,177,185,1222747,6,0.75862069,0.298850575,1,2752
9fd63d0061997bb2d20f860f5df70c195363a0f0,1,rmani,2016-03-23 13:20:08-07:00,['2836dea0b2ff4ed42e0130086d07e183b03362fc'],18,24,42,1222789,1,0,0,0,2752
147ff4b11efcea5d5443ae5bc6c7867ad6626734,1,Madhan Neethiraj,2016-03-23 17:40:38-07:00,['9fd63d0061997bb2d20f860f5df70c195363a0f0'],2,6,8,1222797,1,1,1,1,2752
31c2b030c50ff473d29d12897a03828071618615,0,sneethiraj,2016-03-23 22:43:03-04:00,['147ff4b11efcea5d5443ae5bc6c7867ad6626734'],39,130,169,1222966,1,0.207792208,0.207792208,0.662337662,2752
e5ca0fe51390c48d4a5f67ca46db9ecd53b41c0a,1,Madhan Neethiraj,2016-03-23 23:28:31-07:00,['31c2b030c50ff473d29d12897a03828071618615'],6,391,397,1223363,10,0.258426966,0.258426966,0.887640449,2754
13973e7531c634c4d8659f398940c8c1120e8829,0,Madhan Neethiraj,2016-03-24 09:38:27-07:00,['e5ca0fe51390c48d4a5f67ca46db9ecd53b41c0a'],4,0,4,1223367,2,,,,2754
9a424cece10d8bf31ce8a1f326487c0d5c843622,1,Alok Lal,2016-03-24 09:56:42-07:00,['13973e7531c634c4d8659f398940c8c1120e8829'],173,31,204,1223571,16,0,0,0,2754
e15662509f2d911b637918e155e4133899839e78,1,Alok Lal,2016-03-24 18:28:07-07:00,['9a424cece10d8bf31ce8a1f326487c0d5c843622'],4,3,7,1223578,4,,,,2754
760fbdbae6e85cc8d4ecbd6f187b61997bbced58,0,Madhan Neethiraj,2016-03-26 01:29:53-07:00,['e15662509f2d911b637918e155e4133899839e78'],1,3,4,1223582,1,,,,2754
a0d63e7518f7b6ab2f02ea416b1433ba80cf193b,0,Madhan Neethiraj,2016-03-27 18:55:37-07:00,['760fbdbae6e85cc8d4ecbd6f187b61997bbced58'],36,38,74,1223656,1,,,,2754
5702966e74198ea6d1d9a78c962001d0b71b078a,1,Gautam Borad,2016-03-29 12:54:49+05:18,['a0d63e7518f7b6ab2f02ea416b1433ba80cf193b'],33,94,127,1223783,9,0.555555556,0.555555556,1,2754
62532a11d4bb796d54c3efc13889c870748223dc,0,Alok Lal,2016-03-29 15:21:08-07:00,['5702966e74198ea6d1d9a78c962001d0b71b078a'],2,54,56,1223839,3,0,1,1,2754
da10d09953a83695a262d3016991e444a4def797,0,Velmurugan Periasamy,2016-03-30 14:46:57-04:00,['62532a11d4bb796d54c3efc13889c870748223dc'],10,25,35,1223874,1,0,0,1,2754
9264dd00656a33f1cac0599788fbd362789a1145,1,rmani,2016-03-30 18:20:32-07:00,['da10d09953a83695a262d3016991e444a4def797'],28,113,141,1224015,8,0,0.53968254,1,2754
a50fcf1167cf0ef12da908c10c987b75e823ece2,1,Gautam Borad,2016-03-31 11:42:09+05:18,['9264dd00656a33f1cac0599788fbd362789a1145'],112,135,247,1224262,2,0,1,1,2754
164d46fd188789fdae8f3f1f28e08941a1dc530e,1,Madhan Neethiraj,2016-03-31 15:18:07-07:00,['a50fcf1167cf0ef12da908c10c987b75e823ece2'],198,689,887,1225149,25,0.288288288,0.378378378,0.945945946,2755
d878f4e7eed13a85c0805bacf2a239968f439d56,1,Madhan Neethiraj,2016-04-01 11:35:45-07:00,['164d46fd188789fdae8f3f1f28e08941a1dc530e'],3,168,171,1225320,8,0.684210526,0.210526316,0.894736842,2760
37351fbc85a8c05eed38e2329cbba96db0cd3c12,0,Madhan Neethiraj,2016-04-01 11:49:38-07:00,['d878f4e7eed13a85c0805bacf2a239968f439d56'],14,88,102,1225422,6,0.348837209,0.348837209,0.976744186,2760
47c0356037ef47dfbe5590a5e72f1bb23277f914,1,Madhan Neethiraj,2016-04-01 20:21:10-07:00,['37351fbc85a8c05eed38e2329cbba96db0cd3c12'],16,1365,1381,1226803,19,0.527573529,0.595588235,0.751838235,2772
1d5471ae30e6231e9475f447ded24033efe3547d,1,Velmurugan Periasamy,2016-04-02 10:09:17-04:00,['47c0356037ef47dfbe5590a5e72f1bb23277f914'],129,609,738,1227541,8,0.580555556,0.583333333,1,2772
79947f10a29c3e01d009c956cfd8a9c6bce7af0b,0,Madhan Neethiraj,2016-04-02 22:04:32-07:00,['1d5471ae30e6231e9475f447ded24033efe3547d'],2,2,4,1227545,1,,,,2772
59b49610a8d4f46a71b665e811749c1e2385b366,0,Gautam Borad,2016-04-04 10:32:57+05:18,['79947f10a29c3e01d009c956cfd8a9c6bce7af0b'],12,13,25,1227570,6,,,,2772
3e59571c65e4bfc66f2f753cc9adabdd9451d3c4,1,Alok Lal,2016-04-03 22:25:12-07:00,['59b49610a8d4f46a71b665e811749c1e2385b366'],393,390,783,1228353,40,,,,2772
285ed0dda47b26503280de067ca4f5871a031923,1,Gautam Borad,2016-04-04 10:59:05+05:18,['3e59571c65e4bfc66f2f753cc9adabdd9451d3c4'],19,19,38,1228391,3,,,,2772
e474d3ed0c67692e3c7fde895d391592c9917af8,0,rmani,2016-04-04 11:33:13-07:00,['285ed0dda47b26503280de067ca4f5871a031923'],1,3,4,1228395,2,,,,2772
38b79e7253a6ad8dd5a38f4775ec1ac5b70b05b1,1,Madhan Neethiraj,2016-04-04 23:59:34-07:00,['e474d3ed0c67692e3c7fde895d391592c9917af8'],185,341,526,1228921,22,0.009803922,0.37254902,1,2772
2c7f617be49fb9fc93b1e0e4fab62701602f6c55,1,Madhan Neethiraj,2016-04-05 09:20:12-07:00,['38b79e7253a6ad8dd5a38f4775ec1ac5b70b05b1'],402,1798,2200,1231121,36,0.272727273,0.44214876,0.899449036,2777
19c3744b1ece45be9b33a6075472bfc37bc9bd28,1,Madhan Neethiraj,2016-04-05 11:51:26-07:00,['2c7f617be49fb9fc93b1e0e4fab62701602f6c55'],161,546,707,1231828,17,0.468992248,0.717054264,0.980620155,2777
ece9810f1d38b57b0be6251e1693279053b88d5e,1,Madhan Neethiraj,2016-04-05 13:15:24-07:00,['19c3744b1ece45be9b33a6075472bfc37bc9bd28'],2,31,33,1231861,2,0,0,1,2777
93cb024dda8e902c511c7a18a86b5d9a08cc722a,0,Madhan Neethiraj,2016-04-05 13:45:28-07:00,['ece9810f1d38b57b0be6251e1693279053b88d5e'],1,1,2,1231863,1,,,,2777
93e3bf1cd2d7e26152b5c92cb9a9e767f714431c,0,Madhan Neethiraj,2016-04-05 23:31:13-07:00,['93cb024dda8e902c511c7a18a86b5d9a08cc722a'],98,516,614,1232477,5,,,,2780
093ea3da796f3df488019e6eea66392fa5205cae,1,Gautam Borad,2016-04-07 09:07:40+05:18,['93e3bf1cd2d7e26152b5c92cb9a9e767f714431c'],232,777,1009,1233486,6,0,0,0.087523277,2780
9c4d8e9cd060747468a94233b0efa30f11ac055b,0,Velmurugan Periasamy,2016-04-07 11:36:43-07:00,['093ea3da796f3df488019e6eea66392fa5205cae'],1,1,2,1233488,1,,,,2780
6cd0dbfc00f6ceb5ec16550c8f23e23d4f9deb29,1,Madhan Neethiraj,2016-04-07 14:09:07-07:00,['9c4d8e9cd060747468a94233b0efa30f11ac055b'],30,6,36,1233524,3,0.333333333,0.333333333,0.333333333,2780
6a8e3ae922ba2efc598881d3eed97385dae9fb77,0,Madhan Neethiraj,2016-04-07 16:34:40-07:00,['6cd0dbfc00f6ceb5ec16550c8f23e23d4f9deb29'],8,0,8,1233532,1,,,,2780
3a363c53037453efcd2e4c51324f92daf9a291b7,1,Madhan Neethiraj,2016-04-08 10:48:54-07:00,['6a8e3ae922ba2efc598881d3eed97385dae9fb77'],39,58,97,1233629,2,0.5,0.5625,0.5625,2780
2867cc55e7f4a4923bc9e73c5b3854d2cfe7305f,1,Madhan Neethiraj,2016-04-09 01:25:07-07:00,['3a363c53037453efcd2e4c51324f92daf9a291b7'],3,161,164,1233793,7,0.42,0.42,1,2780
efdde916c60a93bb0bce634ebee3c7000f52646f,1,Madhan Neethiraj,2016-04-11 02:02:54-07:00,['2867cc55e7f4a4923bc9e73c5b3854d2cfe7305f'],10,53,63,1233856,2,0,0,1,2780
5386d4bdb2d2e1c5f1a0ed7ce73443b00f6c4a80,0,Madhan Neethiraj,2016-04-11 09:54:24-07:00,['efdde916c60a93bb0bce634ebee3c7000f52646f'],2,4,6,1233862,1,0,0,1,2780
2bbb47619c63840fff2caef621c3fc2339798c57,1,Madhan Neethiraj,2016-04-11 09:56:42-07:00,['5386d4bdb2d2e1c5f1a0ed7ce73443b00f6c4a80'],12,14,26,1233888,1,0,0,1,2780
d20c0a9fd45a5470300b7ccf1265122a59d907e8,0,sneethiraj,2016-04-11 13:52:28-04:00,['2bbb47619c63840fff2caef621c3fc2339798c57'],0,11,11,1233899,1,1,1,0.428571429,2780
984d3ffb8a5394d6a77f7cae97b062a6f07bf328,0,sneethiraj,2016-04-11 16:06:25-04:00,['d20c0a9fd45a5470300b7ccf1265122a59d907e8'],1,1,2,1233901,1,,,,2780
0851489e215473e2a5ef08ef22af45180e16ac32,0,sneethiraj,2016-04-11 20:20:19-04:00,['984d3ffb8a5394d6a77f7cae97b062a6f07bf328'],1,15,16,1233917,1,1,1,0.428571429,2780
53501aab0504cd6e311d64972bb922df3d92f2a2,0,sneethiraj,2016-04-11 21:30:12-04:00,['0851489e215473e2a5ef08ef22af45180e16ac32'],0,6,6,1233923,2,1,1,0.666666667,2780
6cbc170ac9d19dbc9e30eb7be12a8b90cbaedc01,0,sneethiraj,2016-04-12 15:13:49-04:00,['53501aab0504cd6e311d64972bb922df3d92f2a2'],3,13,16,1233939,1,0,0,1,2780
fe81cd7343ebf88d8091c515c76ac2e53955688d,0,sneethiraj,2016-04-12 15:26:16-04:00,['6cbc170ac9d19dbc9e30eb7be12a8b90cbaedc01'],0,1,1,1233940,1,,,,2781
49b816e814709256b5656bb6de65251264c1c68f,0,sneethiraj,2016-04-12 17:20:39-04:00,['fe81cd7343ebf88d8091c515c76ac2e53955688d'],46,46,92,1234032,43,,,,2781
da3a3233d5679284142eb2887c91a754a0da70b9,1,Velmurugan Periasamy,2016-04-13 03:54:23-04:00,['49b816e814709256b5656bb6de65251264c1c68f'],37,50,87,1234119,6,1,1,1,2781
e85eb01d57154c51f248f969084a6ed90a8d19af,1,Gautam Borad,2016-04-14 09:56:55+05:18,['da3a3233d5679284142eb2887c91a754a0da70b9'],2,1,3,1234122,1,,,,2781
73dc5031e3cfd8b9671b41e0f619b854e7aafd23,1,Gautam Borad,2016-04-14 10:15:52+05:18,['e85eb01d57154c51f248f969084a6ed90a8d19af'],6,605,611,1234733,12,0.244360902,0.766917293,1,2787
634e8d4e6a1f9d254d9831e0e2c2427b91232cb0,0,Madhan Neethiraj,2016-04-14 00:20:30-07:00,['73dc5031e3cfd8b9671b41e0f619b854e7aafd23'],22,55,77,1234810,4,0,0,1,2787
428ce978fb04e9679ea7f52312347c762a5b1a9d,1,rmani,2016-04-14 11:35:49-07:00,['da3a3233d5679284142eb2887c91a754a0da70b9'],23,229,252,1235062,6,0.573170732,1,1,2790
80e2eae09f17166f869bc601ac293f8340a6dca8,0,rmani,2016-04-14 11:36:15-07:00,"['428ce978fb04e9679ea7f52312347c762a5b1a9d', '634e8d4e6a1f9d254d9831e0e2c2427b91232cb0']",30,661,691,1235753,17,,,,2790
5c648ee906a667fca9193d7e7c234d51ec5e7f9c,0,rmani,2016-04-14 12:40:24-07:00,['80e2eae09f17166f869bc601ac293f8340a6dca8'],0,20,20,1235773,1,,,,2790
6b47ac115f847d1938a1e00e7288f59e0c724ed5,1,Velmurugan Periasamy,2016-04-14 18:34:21-04:00,['5c648ee906a667fca9193d7e7c234d51ec5e7f9c'],361,154,515,1236288,28,1,1,0,2790
48ab21bd1924b1b05574839331031e3e5d97abb8,1,Velmurugan Periasamy,2016-04-14 18:35:52-04:00,['6b47ac115f847d1938a1e00e7288f59e0c724ed5'],368,597,965,1237253,5,0,1,1,2790
906099e1ec7f1348748c19b09306c49e9f774dc2,0,Velmurugan Periasamy,2016-04-14 18:36:23-04:00,['48ab21bd1924b1b05574839331031e3e5d97abb8'],1,1,2,1237255,1,,,,2790
bc1cf982efa86d0248f7a4351b2233baf1aa6c03,0,Gautam Borad,2016-04-15 11:15:45+05:18,['906099e1ec7f1348748c19b09306c49e9f774dc2'],2,3,5,1237260,2,1,1,1,2790
dbd0bba9e4450c0e2022826f922879907f8495df,1,Gautam Borad,2016-04-15 11:19:36+05:18,['bc1cf982efa86d0248f7a4351b2233baf1aa6c03'],81,624,705,1237965,10,0.197238659,0.313609467,0.850098619,2790
139bdf36af4e3262e8b5cb4a45e0b804b95a8ab6,1,Gautam Borad,2016-04-15 11:22:55+05:18,['dbd0bba9e4450c0e2022826f922879907f8495df'],5,145,150,1238115,8,,,,2793
1d0a8e2393c7b787be84efead2eff7878d89a68f,0,Gautam Borad,2016-04-15 12:34:21+05:18,['139bdf36af4e3262e8b5cb4a45e0b804b95a8ab6'],2,0,2,1238117,1,,,,2793
fc2453794ff59deec93c263917bc6dec42ff9fcf,1,rmani,2016-04-16 09:23:47-07:00,['1d0a8e2393c7b787be84efead2eff7878d89a68f'],13,14,27,1238144,4,,,,2793
f7b1a9d16edb8a23b04738d1500c892a0a213cd3,0,Madhan Neethiraj,2016-04-16 23:27:46-07:00,['fc2453794ff59deec93c263917bc6dec42ff9fcf'],1,1,2,1238146,1,,,,2793
0b258f8fb9be603ce819e1ce85af7f07efdd8319,1,Gautam Borad,2016-04-18 10:38:51+05:18,['f7b1a9d16edb8a23b04738d1500c892a0a213cd3'],3,6,9,1238155,6,0,1,0,2793
27a59341641f02a6f77259a77a0ae140368c1a83,1,Madhan Neethiraj,2016-04-17 23:24:23-07:00,['0b258f8fb9be603ce819e1ce85af7f07efdd8319'],53,53,106,1238261,4,,,,2793
259fad12bf86c93a8eef09dc4d1b134543211b48,1,Madhan Neethiraj,2016-04-18 09:04:45-07:00,['27a59341641f02a6f77259a77a0ae140368c1a83'],23,23,46,1238307,10,,,,2793
953326ebc5db810488532e2a617cab149352d3d9,1,Colm O hEigeartaigh,2016-04-19 11:01:26+01:00,['259fad12bf86c93a8eef09dc4d1b134543211b48'],69,34,103,1238410,13,0.263157895,0.210526316,1,2793
702cf84dd36a399dbcefe398919947b278c353fa,0,Colm O hEigeartaigh,2016-04-19 11:08:03+01:00,['953326ebc5db810488532e2a617cab149352d3d9'],0,12,12,1238422,1,,,,2793
54f5573481213d6fe5924ac1b24541c4f4bbc2f6,0,Madhan Neethiraj,2016-04-20 12:34:37-07:00,['702cf84dd36a399dbcefe398919947b278c353fa'],1,1,2,1238424,1,,,,2793
191350ff5400a12053c9fb3f08954f82e25d739b,0,sneethiraj,2016-04-20 18:14:54-04:00,['54f5573481213d6fe5924ac1b24541c4f4bbc2f6'],6,6,12,1238436,3,,,,2793
7b8b6bb7654d5876a8f88a334108457ceddf0715,1,Madhan Neethiraj,2016-04-20 16:52:59-07:00,['191350ff5400a12053c9fb3f08954f82e25d739b'],1067,889,1956,1240392,20,1,0.862068966,0,2798
981f01a7afddbbfb555625de2a8e1d868479ec47,0,Gautam Borad,2016-04-21 10:10:00+05:18,['7b8b6bb7654d5876a8f88a334108457ceddf0715'],16,58,74,1240466,1,,,,2798
8614032c909dd5599fedc35c8f4b80f71b3a950d,1,Gautam Borad,2016-04-21 11:38:01+05:18,['981f01a7afddbbfb555625de2a8e1d868479ec47'],248,2758,3006,1243472,56,0.109555691,0.229458308,0.600730371,2800
017826011cc882d5a49cb27274e545eff269b676,0,Gautam Borad,2016-04-21 11:46:10+05:18,['8614032c909dd5599fedc35c8f4b80f71b3a950d'],1,2,3,1243475,1,,,,2800
00c00253eda9ec63e5876a061d99490d9cdf3753,1,Gautam Borad,2016-04-21 18:03:33+05:18,['017826011cc882d5a49cb27274e545eff269b676'],31,35,66,1243541,2,0,0,1,2800
0699c3401b2d8615683e871c1f68a7534eea9c5c,0,Madhan Neethiraj,2016-04-21 09:23:14-07:00,['00c00253eda9ec63e5876a061d99490d9cdf3753'],17,18,35,1243576,2,,,,2800
cb58449b6b61d65b722f03da6bf9b65a1f5c6fbc,1,Madhan Neethiraj,2016-04-21 12:44:29-07:00,['0699c3401b2d8615683e871c1f68a7534eea9c5c'],126,941,1067,1244643,24,0.348189415,0.493036212,1,2808
252cb4d3c299473e8f50fb7fdba9676adf7db981,0,Colm O hEigeartaigh,2016-04-22 10:34:27+01:00,['cb58449b6b61d65b722f03da6bf9b65a1f5c6fbc'],1,1,2,1244645,1,,,,2808
a3a472d999fe77f516b20f0c0644149c5ebe7470,0,Madhan Neethiraj,2016-04-23 23:56:03-07:00,['252cb4d3c299473e8f50fb7fdba9676adf7db981'],129,289,418,1245063,8,0.49137931,0.603448276,0.689655172,2808
cd7f5b57a465b2162f4e732f69638149eee79d7b,1,Madhan Neethiraj,2016-04-24 00:09:59-07:00,['a3a472d999fe77f516b20f0c0644149c5ebe7470'],293,341,634,1245697,13,0.025641026,0.538461538,0.153846154,2808
f55b3617f5f9220848da1e83c5894d6bb4a5d7fd,0,Colm O hEigeartaigh,2016-04-25 10:25:24+01:00,['cd7f5b57a465b2162f4e732f69638149eee79d7b'],29,1,30,1245727,20,,,,2808
de330e1ca7abbbff64dc39166e555ffbf2e0a57f,0,Colm O hEigeartaigh,2016-04-25 10:36:05+01:00,['f55b3617f5f9220848da1e83c5894d6bb4a5d7fd'],1,8,9,1245736,1,,,,2808
4e37e575178f6667f0dec00b70085d9ba9635ab2,0,Velmurugan Periasamy,2016-04-26 00:22:17-04:00,['de330e1ca7abbbff64dc39166e555ffbf2e0a57f'],1,1,2,1245738,1,,,,2808
95c8f693d40f9980b563463231543d1763b69b0c,1,Colm O hEigeartaigh,2016-04-26 10:40:13+01:00,['4e37e575178f6667f0dec00b70085d9ba9635ab2'],1,1,2,1245740,1,,,,2808
e6ae22fd29a4c7f343da78af5a852032fee92262,0,Colm O hEigeartaigh,2016-04-26 10:41:39+01:00,['95c8f693d40f9980b563463231543d1763b69b0c'],49,3,52,1245792,1,,,,2808
6b22ecbac319f69c1e20abc4ba92c632e11d3a08,0,Colm O hEigeartaigh,2016-04-26 10:46:53+01:00,['e6ae22fd29a4c7f343da78af5a852032fee92262'],97,7,104,1245896,24,,,,2808
cba444bfd621725339b14ee805967d73be849d14,1,Madhan Neethiraj,2016-04-27 18:31:52-07:00,['6b22ecbac319f69c1e20abc4ba92c632e11d3a08'],35,76,111,1246007,10,0,0,1,2808
2bd8581f9cebddb377110f29969ae95aff2f38a2,0,Madhan Neethiraj,2016-04-27 18:46:25-07:00,['cba444bfd621725339b14ee805967d73be849d14'],707,1339,2046,1248053,7,0,0.504065041,1,2808
41a3d67aa2d5cd76f627a8e2c09e36fe5bf28d49,1,Madhan Neethiraj,2016-04-27 21:07:41-07:00,['2bd8581f9cebddb377110f29969ae95aff2f38a2'],1,5,6,1248059,2,,,,2808
782126465adf9ed4a8a29b04c78251c1b2b05c35,1,Gautam Borad,2016-04-28 11:56:46+05:18,['41a3d67aa2d5cd76f627a8e2c09e36fe5bf28d49'],175,162,337,1248396,4,0.853658537,1,0.219512195,2808
2d8d15aebe6b19cd70d994614afe10a328bf8db0,0,Gautam Borad,2016-04-28 11:58:18+05:18,['782126465adf9ed4a8a29b04c78251c1b2b05c35'],10,14,24,1248420,5,0.666666667,0,1,2808
415ed4399f131a02e7141ec347fe653b7db59902,1,Gautam Borad,2016-04-28 12:08:09+05:18,['2d8d15aebe6b19cd70d994614afe10a328bf8db0'],5,5,10,1248430,3,,,,2808
b056c4b77017c64b55d4083b332d464dbdd46825,1,Gautam Borad,2016-04-28 20:22:33+05:18,['415ed4399f131a02e7141ec347fe653b7db59902'],80,176,256,1248686,19,0,0.642857143,0.857142857,2808
3fa3de243cb3857d02de89264a4b9bbf6feb51a8,0,sneethiraj,2016-04-28 12:13:21-04:00,['b056c4b77017c64b55d4083b332d464dbdd46825'],0,86,86,1248772,1,,,,2808
26f959fd23d1967b535a1311e5500cfaca9706d4,1,Gautam Borad,2016-04-29 14:50:51+05:18,['3fa3de243cb3857d02de89264a4b9bbf6feb51a8'],3,14,17,1248789,2,0.538461538,0.692307692,1,2808
296de339ae174ff2c5c4a16c8f81a1bb38defbb3,1,Gautam Borad,2016-04-29 14:51:36+05:18,['26f959fd23d1967b535a1311e5500cfaca9706d4'],6,60,66,1248855,6,0,0.041666667,1,2808
847a73815b061b393c720a593864b07165bd656e,1,Gautam Borad,2016-04-29 14:52:06+05:18,['296de339ae174ff2c5c4a16c8f81a1bb38defbb3'],5,26,31,1248886,6,0.538461538,0.538461538,1,2808
7e08cd9f2ac5ab461333e57e250382545b8e547c,1,Gautam Borad,2016-04-29 14:52:38+05:18,['847a73815b061b393c720a593864b07165bd656e'],1,104,105,1248991,2,0.2,1,1,2809
2c6554ca9df6576a21efb1bf3c7f0b05b1cd9dfc,1,Colm O hEigeartaigh,2016-04-29 10:53:24+01:00,['7e08cd9f2ac5ab461333e57e250382545b8e547c'],35,100,135,1249126,3,,,,2810
1fc84ff6bd864e908ee173aff37d5b0388de2110,0,Madhan Neethiraj,2016-04-29 15:28:25-07:00,['2c6554ca9df6576a21efb1bf3c7f0b05b1cd9dfc'],10,35,45,1249171,3,0,0.25,0.25,2810
be7745c882299cb63b932bef1dc45c8b75e2496e,0,sneethiraj,2016-04-29 22:37:41-04:00,['1fc84ff6bd864e908ee173aff37d5b0388de2110'],45,12,57,1249228,1,,,,2810
6638a11abd94965b3ed4c400b81b99156da24706,0,sneethiraj,2016-05-02 12:50:48-04:00,['be7745c882299cb63b932bef1dc45c8b75e2496e'],14,18,32,1249260,2,,,,2810
6587fc8c2259a561eae33699d51cb8d1f83ba7b5,0,Colm O hEigeartaigh,2016-05-03 16:17:26+01:00,['6638a11abd94965b3ed4c400b81b99156da24706'],1,28,29,1249289,3,,,,2810
e437615f7e7a210e3ebb223a657e3ded2b717de5,0,sneethiraj,2016-05-03 17:53:08-04:00,['6587fc8c2259a561eae33699d51cb8d1f83ba7b5'],7,4,11,1249300,2,,,,2810
39439cebff0e02a3f680b67ce7b3c46380c45c49,1,Colm O hEigeartaigh,2016-05-04 10:52:57+01:00,['e437615f7e7a210e3ebb223a657e3ded2b717de5'],4,27,31,1249331,1,,,,2810
ea5bf67e72f12ae170e3ba93fc279016077013c1,0,rmani,2016-05-04 15:13:07-07:00,['39439cebff0e02a3f680b67ce7b3c46380c45c49'],11,0,11,1249342,1,0.363636364,0.363636364,0,2810
b4157cfa16469153984999debe2afdb187f0701b,1,Madhan Neethiraj,2016-05-04 22:59:20-07:00,['ea5bf67e72f12ae170e3ba93fc279016077013c1'],11,10,21,1249363,2,,,,2810
d58bda23cb8ccbd9b186f49cd8b8e3e53cf9f6aa,0,Madhan Neethiraj,2016-05-05 08:57:24-07:00,['b4157cfa16469153984999debe2afdb187f0701b'],2,7,9,1249372,1,1,1,1,2810
e561bff4b52bf3bc2842ff755bbd35d31443e8a7,0,Madhan Neethiraj,2016-05-05 12:59:25-07:00,['d58bda23cb8ccbd9b186f49cd8b8e3e53cf9f6aa'],4,39,43,1249415,4,0.045454545,0.045454545,1,2810
af3361858734690ddf9b319a3da9ae1b7bca5766,0,Madhan Neethiraj,2016-05-05 13:10:20-07:00,['e561bff4b52bf3bc2842ff755bbd35d31443e8a7'],1,1,2,1249417,1,,,,2810
96dc7f4b01740ca8d55995174b22fede099ebf8e,1,Madhan Neethiraj,2016-05-08 11:38:07-07:00,['af3361858734690ddf9b319a3da9ae1b7bca5766'],82,64,146,1249563,4,,,,2810
ec749f09e0b1b88787690476ea1aca92e603bf32,1,Velmurugan Periasamy,2016-05-09 08:20:28-04:00,['96dc7f4b01740ca8d55995174b22fede099ebf8e'],54,316,370,1249933,10,0.007194245,1,1,2816
b744c8eb6659f319e3d25fa09f010ceb6a667452,1,Gautam Borad,2016-05-10 07:12:26+05:18,['ec749f09e0b1b88787690476ea1aca92e603bf32'],28,28,56,1249989,13,,,,2816
2bd65f7bc9fa5eff9cc33d17c1218571ca756cf6,1,Gautam Borad,2016-05-10 14:37:19+05:18,['b744c8eb6659f319e3d25fa09f010ceb6a667452'],38,142,180,1250169,12,0,0.075757576,0,2816
d4fd012ddb15679f09bd83210b18b20ec0232a6d,0,Gautam Borad,2016-05-10 17:10:47+05:18,['2bd65f7bc9fa5eff9cc33d17c1218571ca756cf6'],31,35,66,1250235,5,0.6,0.8,1,2816
f4a7037dba4e9714535990dc619db5c0b445d90f,1,Gautam Borad,2016-05-10 17:11:38+05:18,['d4fd012ddb15679f09bd83210b18b20ec0232a6d'],51,40,91,1250326,5,0.741935484,0.741935484,0,2816
2b0281390e79310c2eafa4d483b67f044e76a591,1,Madhan Neethiraj,2016-05-10 15:47:05-07:00,['f4a7037dba4e9714535990dc619db5c0b445d90f'],16,98,114,1250440,1,0,1,1,2816
7d8baf866b0cd8ffe9cac9be0fbd4b58bb0174bf,1,Madhan Neethiraj,2016-05-11 14:51:48-07:00,['2b0281390e79310c2eafa4d483b67f044e76a591'],0,12,12,1250452,2,,,,2816
6228e4e3a141fb3e60cdb218a2c1673445db3767,0,Gautam Borad,2016-05-13 10:33:38+05:18,['7d8baf866b0cd8ffe9cac9be0fbd4b58bb0174bf'],17,10,27,1250479,2,,,,2816
60877671289426847a5f54a0ae3877c4f420c75a,1,Gautam Borad,2016-05-13 18:34:19+05:18,['6228e4e3a141fb3e60cdb218a2c1673445db3767'],3,5,8,1250487,3,,,,2816
b64218a347e54aff132f821946de63133258d407,1,Madhan Neethiraj,2016-05-13 11:36:55-07:00,['60877671289426847a5f54a0ae3877c4f420c75a'],0,1079,1079,1251566,13,0.535519126,0.844262295,0.93989071,2826
3595251bcbf82ab704914822695a9265d0158c17,1,Gautam Borad,2016-05-16 09:49:37+05:18,['b64218a347e54aff132f821946de63133258d407'],651,1025,1676,1253242,12,0.422018349,0.30733945,1,2829
d501faa79512a50f79c3ab3d3e84c1e9ce26d8e2,0,Velmurugan Periasamy,2016-05-16 11:18:29-04:00,['3595251bcbf82ab704914822695a9265d0158c17'],5,2,7,1253249,2,1,1,0,2829
b48e0a3f93b7f144287465e95e22dbc8002c6ba4,1,Velmurugan Periasamy,2016-05-16 11:19:14-04:00,['d501faa79512a50f79c3ab3d3e84c1e9ce26d8e2'],16,17,33,1253282,5,0,0,0,2829
d148ce2183205c4c101bccdf5e2338f32376227c,1,Colm O hEigeartaigh,2016-05-16 16:53:09+01:00,['b48e0a3f93b7f144287465e95e22dbc8002c6ba4'],24,1,25,1253307,1,,,,2829
8aa98a37587b76188e49693433a1131e21594b89,1,Velmurugan Periasamy,2016-05-17 10:42:03-04:00,['d148ce2183205c4c101bccdf5e2338f32376227c'],9,18,27,1253334,2,,,,2829
df11ae699f0a07754717b1867bc2b0b359cb4596,1,Velmurugan Periasamy,2016-05-17 11:17:09-04:00,['8aa98a37587b76188e49693433a1131e21594b89'],1,1,2,1253336,1,,,,2829
c3eaa80230d8bd89f70cb223e14634d494ffbcfe,0,Colm O hEigeartaigh,2016-05-18 15:04:48+01:00,['df11ae699f0a07754717b1867bc2b0b359cb4596'],12,1,13,1253349,1,,,,2829
742b81955c8a53318ac95639a4262f16027b3691,0,Velmurugan Periasamy,2016-05-18 10:09:18-04:00,['df11ae699f0a07754717b1867bc2b0b359cb4596'],5,0,5,1253354,1,,,,2829
64c4a9532f6e54fc80c3ab6b109da0b25bd41ae4,0,Velmurugan Periasamy,2016-05-18 10:09:45-04:00,"['742b81955c8a53318ac95639a4262f16027b3691', 'c3eaa80230d8bd89f70cb223e14634d494ffbcfe']",12,1,13,1253367,1,,,,2829
4da0f20ac782b629565fc14d5dc3d329a436181e,1,Velmurugan Periasamy,2016-05-19 01:47:04-04:00,['64c4a9532f6e54fc80c3ab6b109da0b25bd41ae4'],62,294,356,1253723,3,0.091891892,0.756756757,0.756756757,2829
92e798a6560d51ce5eea9422a933e2fc73966d75,0,Colm O hEigeartaigh,2016-05-20 17:18:57+01:00,['4da0f20ac782b629565fc14d5dc3d329a436181e'],2,2,4,1253727,2,,,,2829
0102cdbdef6f7c4d051f34fa9089f150c88c6c36,1,Colm O hEigeartaigh,2016-05-20 17:35:00+01:00,['92e798a6560d51ce5eea9422a933e2fc73966d75'],2,2,4,1253731,1,,,,2829
88d82ae173cc0bd0ba78cc79b6d0b8cf728beabc,1,Velmurugan Periasamy,2016-05-23 14:05:48-04:00,['0102cdbdef6f7c4d051f34fa9089f150c88c6c36'],56,77,133,1253864,5,0,0,0.95,2829
be74659686ffffbd31146242825385280df07342,1,Velmurugan Periasamy,2016-05-23 14:06:20-04:00,['88d82ae173cc0bd0ba78cc79b6d0b8cf728beabc'],18,11,29,1253893,5,,,,2829
72d61a87ed746d0e67cfdc3324faf7f5c5f7be45,0,Gautam Borad,2016-05-24 12:02:33+05:18,['be74659686ffffbd31146242825385280df07342'],120,1500,1620,1255513,23,0.524137931,0.896551724,0.931034483,2848
d21e6bb47edd8d7c6bda014a2899099c501c7585,0,Gautam Borad,2016-05-25 09:25:11+05:18,['72d61a87ed746d0e67cfdc3324faf7f5c5f7be45'],18,484,502,1256015,5,0.267015707,0.287958115,0.895287958,2848
e8c4658a39407685c57966ab1566e8bac5411b5f,1,Gautam Borad,2016-05-25 11:17:09+05:18,['d21e6bb47edd8d7c6bda014a2899099c501c7585'],484,18,502,1256517,5,0.732984293,0.712041885,0.104712042,2848
c28abae1fb525432b90b8c3c87e7c46ca77a861e,1,Madhan Neethiraj,2016-05-24 23:28:26-07:00,['e8c4658a39407685c57966ab1566e8bac5411b5f'],1500,120,1620,1258137,23,0.475862069,0.103448276,0.068965517,2849
982e0a99ffd9b2ffc33643476a3b54b98a931469,1,Gautam Borad,2016-05-25 12:09:04+05:18,['c28abae1fb525432b90b8c3c87e7c46ca77a861e'],18,484,502,1258639,5,0.267015707,0.287958115,0.895287958,2849
5a40ad32947686fa0d21d2edd4aa0c3cf038bef3,1,Gautam Borad,2016-05-25 15:26:25+05:18,['982e0a99ffd9b2ffc33643476a3b54b98a931469'],1,1500,1501,1260140,22,0.475,0.745,0.95,2868
914c235ac12d6d40137e38197388228f76cf975d,0,Colm O hEigeartaigh,2016-05-26 15:39:54+01:00,['5a40ad32947686fa0d21d2edd4aa0c3cf038bef3'],1,1,2,1260142,1,,,,2868
67e64d2e7c1d5ba83078eaaedddd5946c1cba9e0,0,Colm O hEigeartaigh,2016-05-26 16:31:56+01:00,['914c235ac12d6d40137e38197388228f76cf975d'],171,176,347,1260489,66,,,,2868
a5200b49a3d777aeea13c2ac056004e4da71f746,0,Colm O hEigeartaigh,2016-05-26 17:30:40+01:00,['67e64d2e7c1d5ba83078eaaedddd5946c1cba9e0'],11,11,22,1260511,1,,,,2868
6bdc2d27a7bc7919cb3c4d01924cdb7ac4efce34,0,Colm O hEigeartaigh,2016-05-27 13:31:20+01:00,['a5200b49a3d777aeea13c2ac056004e4da71f746'],1,1,2,1260513,1,,,,2868
c498b0fc1cee00e89680b08869d2ec5afbce46fb,0,Colm O hEigeartaigh,2016-05-27 14:32:28+01:00,['6bdc2d27a7bc7919cb3c4d01924cdb7ac4efce34'],5,21,26,1260539,1,0,1,0.928571429,2868
7d452069c636419dcb5084292377f977487cf123,1,Gautam Borad,2016-05-30 17:46:04+05:18,['c498b0fc1cee00e89680b08869d2ec5afbce46fb'],173,612,785,1261324,7,0,0,0.129577465,2868
e11500050d32845441c96adee45d4289624dbf85,1,Gautam Borad,2016-05-30 17:46:10+05:18,['7d452069c636419dcb5084292377f977487cf123'],1,525,526,1261850,7,0.779661017,1,0.936440678,2871
14f8c118368cb9e5ee01a7a59b9ade03de48a288,0,Gautam Borad,2016-05-30 17:46:14+05:18,['e11500050d32845441c96adee45d4289624dbf85'],0,35,35,1261885,2,0.6,0.6,0,2872
ced7c3b7af823614c2fbc5a0858e8954aed42f51,1,Gautam Borad,2016-05-30 17:46:24+05:18,['14f8c118368cb9e5ee01a7a59b9ade03de48a288'],74,76,150,1262035,6,0,1,1,2872
4d3ce6cc036f490921653f9b3385b16b17fda181,1,Gautam Borad,2016-05-31 11:22:00+05:18,['ced7c3b7af823614c2fbc5a0858e8954aed42f51'],56,102,158,1262193,5,0,0,1,2872
69f546a6d15ed08062512e8efdd20410ed3720ea,0,Gautam Borad,2016-05-31 11:22:05+05:18,['4d3ce6cc036f490921653f9b3385b16b17fda181'],6,47,53,1262246,5,1,1,1,2872
bc634846b5e9c177b38ba862e25a559c27adb070,1,Gautam Borad,2016-05-31 11:22:09+05:18,['69f546a6d15ed08062512e8efdd20410ed3720ea'],16,42,58,1262304,8,0.043478261,0.043478261,1,2872
01e1d05923f8ab9f6d2d36ef1e12605e8719cc54,1,Gautam Borad,2016-06-01 19:58:40+05:18,['bc634846b5e9c177b38ba862e25a559c27adb070'],12,51,63,1262367,3,0.225,0.225,0.675,2872
220c13237589e4f3b624bf39074d800d895be909,0,Madhan Neethiraj,2016-06-01 11:16:07-07:00,['01e1d05923f8ab9f6d2d36ef1e12605e8719cc54'],54,57,111,1262478,4,0,0,0,2872
c366a0ae5ec0598215ecb2bbaf7a465f606cdd76,0,Velmurugan Periasamy,2016-06-02 01:00:14-04:00,['220c13237589e4f3b624bf39074d800d895be909'],7,20,27,1262505,5,1,1,1,2872
a3089d1f0bab90692cc7027ca5d7323ea7bca610,1,Velmurugan Periasamy,2016-06-02 01:01:08-04:00,['c366a0ae5ec0598215ecb2bbaf7a465f606cdd76'],13,8,21,1262526,4,1,1,0,2872
f9300ca972cdeda4ec6bb0fe25fbb55853566c3c,1,Velmurugan Periasamy,2016-06-02 01:04:38-04:00,['a3089d1f0bab90692cc7027ca5d7323ea7bca610'],0,249,249,1262775,3,0.14084507,0.246478873,1,2874
c59ea527f5f878dae128c095d737d53a8fbd4ff4,1,Velmurugan Periasamy,2016-06-02 01:06:49-04:00,['f9300ca972cdeda4ec6bb0fe25fbb55853566c3c'],95,143,238,1263013,2,0,0.739130435,1,2874
6e02030caeb8212f84c1b9fb47f5b21d286277dd,0,Velmurugan Periasamy,2016-06-02 01:18:02-04:00,['c59ea527f5f878dae128c095d737d53a8fbd4ff4'],24,16,40,1263053,5,,,,2874
27a70dd1a0cc82f7870d857f348ebf1786b65790,1,Velmurugan Periasamy,2016-06-02 02:42:38-04:00,['6e02030caeb8212f84c1b9fb47f5b21d286277dd'],0,12,12,1263065,2,0,0,0,2874
eb31b7e95783539ccbc67dbc8a70f5544b5c88b0,1,Colm O hEigeartaigh,2016-06-03 15:10:14+01:00,['27a70dd1a0cc82f7870d857f348ebf1786b65790'],217,873,1090,1264155,7,0.024390244,1,0.926829268,2878
4e80d187cbce27aeecef394287be2fb4c890f9e2,1,Velmurugan Periasamy,2016-06-03 12:56:11-04:00,['eb31b7e95783539ccbc67dbc8a70f5544b5c88b0'],28,27,55,1264210,4,,,,2878
f0067ecde46c6291c5f9161aafae9584038d8a80,1,Velmurugan Periasamy,2016-06-03 17:20:22-04:00,['4e80d187cbce27aeecef394287be2fb4c890f9e2'],6,7,13,1264223,1,0,0,1,2878
a4140bc0b183e0d91a597be8d7394cd3a6452097,1,rmani,2016-06-05 10:22:47-07:00,['f0067ecde46c6291c5f9161aafae9584038d8a80'],24,611,635,1264858,22,0.253869969,0.318885449,1,2879
a01cce386a83b6f5f8384b94296c51a45b555536,1,Velmurugan Periasamy,2016-06-07 08:19:52-04:00,['a4140bc0b183e0d91a597be8d7394cd3a6452097'],2,2,4,1264862,2,,,,2879
586753d87c06b96be7fbb58292e4189a26ddb70e,1,rmani,2016-06-07 11:29:08-07:00,['a01cce386a83b6f5f8384b94296c51a45b555536'],17,27,44,1264906,13,,,,2879
9a9f7cd8a9fc29f76429884afc87cb92f84b5ca0,0,Velmurugan Periasamy,2016-06-07 15:55:53-04:00,['a01cce386a83b6f5f8384b94296c51a45b555536'],2,9,11,1264917,1,0.714285714,0.714285714,1,2879
759f52e3ea0fec9b1c6374714e46a8724f378968,1,Velmurugan Periasamy,2016-06-07 15:56:21-04:00,['9a9f7cd8a9fc29f76429884afc87cb92f84b5ca0'],149,512,661,1265578,3,0.336206897,1,0.63362069,2880
724c83c9e59a04a47928400e90e61429ee0e08bc,0,Velmurugan Periasamy,2016-06-07 15:56:36-04:00,['759f52e3ea0fec9b1c6374714e46a8724f378968'],3,5,8,1265586,3,0,0,1,2880
46b23e54e0a872430a3bc5883cf676e5833bd065,0,rmani,2016-06-07 13:18:41-07:00,"['586753d87c06b96be7fbb58292e4189a26ddb70e', '724c83c9e59a04a47928400e90e61429ee0e08bc']",154,526,680,1266266,7,,,,2880
28439c804f8895d8d79ca457422841b6fb86a08d,1,Madhan Neethiraj,2016-06-07 23:39:35-07:00,['46b23e54e0a872430a3bc5883cf676e5833bd065'],17,27,44,1266310,4,0.666666667,1,0,2880
23f540e56c536e96931071cb3a0e19c39684a703,0,Colm O hEigeartaigh,2016-06-09 10:06:39+01:00,['28439c804f8895d8d79ca457422841b6fb86a08d'],2,2,4,1266314,1,,,,2880
c38a718ede6d9888e6c1a413a66f26df0b45a04e,1,Velmurugan Periasamy,2016-06-09 09:02:28-04:00,['23f540e56c536e96931071cb3a0e19c39684a703'],106,93,199,1266513,5,1,0,0,2880
2eb3c2fe63c5c41a855dddd5bbb8d7a24ee226de,1,Madhan Neethiraj,2016-06-09 15:40:49-07:00,['c38a718ede6d9888e6c1a413a66f26df0b45a04e'],57,238,295,1266808,13,0.267241379,0.301724138,0.974137931,2880
6ea86e2cb6266783101dcf0f44c2738f94cb490b,1,rmani,2016-06-09 19:22:32-07:00,['2eb3c2fe63c5c41a855dddd5bbb8d7a24ee226de'],4,51,55,1266863,11,,,,2880
89d4762012295ff77d3bbb938905ccd8c28222a8,0,Velmurugan Periasamy,2016-06-10 10:42:25-04:00,['c38a718ede6d9888e6c1a413a66f26df0b45a04e'],0,1,1,1266864,1,,,,2880
eb739e90734678b10b9c96de73b572f03cb91311,0,Velmurugan Periasamy,2016-06-10 10:43:00-04:00,"['89d4762012295ff77d3bbb938905ccd8c28222a8', '6ea86e2cb6266783101dcf0f44c2738f94cb490b']",61,289,350,1267214,24,,,,2880
0f66b24f855df15f519c4851299cf1ee4748c2cf,1,Velmurugan Periasamy,2016-06-10 11:29:33-04:00,['eb739e90734678b10b9c96de73b572f03cb91311'],6,45,51,1267265,4,0.076923077,0.076923077,1,2880
7ee4aac17fc61414ec97b24ef0c3cfbe2e9f5c71,0,Velmurugan Periasamy,2016-06-10 11:30:02-04:00,['0f66b24f855df15f519c4851299cf1ee4748c2cf'],4,12,16,1267281,4,,,,2880
ae4ce8e080941d9ff6de91982d70efa8d6413ee3,0,Velmurugan Periasamy,2016-06-10 11:30:28-04:00,['7ee4aac17fc61414ec97b24ef0c3cfbe2e9f5c71'],9,28,37,1267318,5,0.2,0.1,1,2880
24b310d6419e779e28f384b39904dec36f484b4d,1,Madhan Neethiraj,2016-06-10 18:08:34-07:00,['ae4ce8e080941d9ff6de91982d70efa8d6413ee3'],0,21,21,1267339,1,0.666666667,1,1,2880
4b892a358089844710c8257a0f87c2096fa9eca8,1,Madhan Neethiraj,2016-06-13 12:55:15-07:00,['24b310d6419e779e28f384b39904dec36f484b4d'],7,11,18,1267357,4,,,,2880
5a4e1a31e8dded60ac288293a14bef5a07fd26c2,1,Madhan Neethiraj,2016-06-13 19:48:30-07:00,['4b892a358089844710c8257a0f87c2096fa9eca8'],4,84,88,1267445,1,0,0,0.971014493,2880
2de668a2d158913beb509b5c4432c1475880277a,1,rmani,2016-06-13 21:37:47-07:00,['5a4e1a31e8dded60ac288293a14bef5a07fd26c2'],3,3,6,1267451,2,,,,2880
97deb2b6f2674f2c23b37e092afbc2d102b79fac,0,Colm O hEigeartaigh,2016-06-14 11:54:36+01:00,['2de668a2d158913beb509b5c4432c1475880277a'],3,3,6,1267457,2,,,,2880
ce45eff839544371c80f68bddf2ef47573cd210c,1,Madhan Neethiraj,2016-06-14 06:20:02-07:00,['97deb2b6f2674f2c23b37e092afbc2d102b79fac'],87,362,449,1267906,11,0.063291139,0,0.917721519,2880
2f648372129ae7486fa562550099830b0c49f922,0,rmani,2016-06-14 22:41:09-07:00,['ce45eff839544371c80f68bddf2ef47573cd210c'],6,350,356,1268262,7,0.524475524,1,0.678321678,2883
8f77aec59ce71bcbfbcc574815749f9f6f21f908,1,rmani,2016-06-16 19:48:41-07:00,['2f648372129ae7486fa562550099830b0c49f922'],6,52,58,1268320,1,0,0.146341463,1,2883
7e5e9704cb54b4a137de7886acd1324fa5f37910,1,Velmurugan Periasamy,2016-06-17 00:10:18-04:00,['8f77aec59ce71bcbfbcc574815749f9f6f21f908'],6,71,77,1268397,7,0,0.290322581,0.596774194,2883
07696a705cea966c4a0b8bfdc85f190e45bc2515,1,Velmurugan Periasamy,2016-06-17 00:11:00-04:00,['7e5e9704cb54b4a137de7886acd1324fa5f37910'],30,51,81,1268478,5,0,0,1,2883
9fd001cae7b4366cbd59a77146137a7088f4a805,0,Velmurugan Periasamy,2016-06-17 00:11:47-04:00,['07696a705cea966c4a0b8bfdc85f190e45bc2515'],12,106,118,1268596,1,0,0,1,2883
fc0294670bb794b3149689a8c6401e261432c344,1,Colm O hEigeartaigh,2016-06-17 15:36:28+01:00,['9fd001cae7b4366cbd59a77146137a7088f4a805'],4,4,8,1268604,1,,,,2883
ee5a6ec1ac0acf0e1fa5dd6364cf48e924cf2935,1,Madhan Neethiraj,2016-06-17 08:19:20-07:00,['fc0294670bb794b3149689a8c6401e261432c344'],20,46,66,1268670,2,0,0,0.869565217,2883
ccbc468cd1a568b18a2331b98986a074683a1b1b,0,Velmurugan Periasamy,2016-06-17 17:06:42-04:00,['ee5a6ec1ac0acf0e1fa5dd6364cf48e924cf2935'],15,1,16,1268686,1,1,1,1,2883
c3d48e6660cd3f9aaf4b202472503fda81709275,1,Madhan Neethiraj,2016-06-17 22:39:45-07:00,['ccbc468cd1a568b18a2331b98986a074683a1b1b'],19,59,78,1268764,3,0,0,1,2883
8d353cb441fae0e47ba434fdf2f9b3cd9834def5,0,Madhan Neethiraj,2016-06-19 02:31:36-07:00,['c3d48e6660cd3f9aaf4b202472503fda81709275'],20,9,29,1268793,1,0.2,0,0,2883
9b791db6d05d521fcd89cec67fe90f5e01fa7aa5,1,Velmurugan Periasamy,2016-06-20 09:02:30-04:00,['8d353cb441fae0e47ba434fdf2f9b3cd9834def5'],1,15,16,1268809,1,0,0,0,2883
2b7122d3ca51623ebe2dc058c228631bd4c37a35,1,Velmurugan Periasamy,2016-06-20 13:46:46-04:00,['9b791db6d05d521fcd89cec67fe90f5e01fa7aa5'],71400,66,71466,1340275,385,0.919141287,0.120492965,0.054914094,2883
4b4790abe921d7cd18532183afaec200208f8e8a,0,sneethiraj,2016-06-20 21:19:00-04:00,['2b7122d3ca51623ebe2dc058c228631bd4c37a35'],1,7,8,1340283,1,0,1,1,2883
04378e386793180c61d1167f168b6aad9620d179,1,Velmurugan Periasamy,2016-06-20 23:07:16-04:00,['4b4790abe921d7cd18532183afaec200208f8e8a'],11,11,22,1340305,2,0,0,0,2883
6e07ed2c9306c8541df24dcfb5f27324b80d45be,0,Velmurugan Periasamy,2016-06-20 23:07:42-04:00,['04378e386793180c61d1167f168b6aad9620d179'],0,158,158,1340463,5,,,,2888
e488e8df57e44ece1a672218eba91223d63b0f87,1,Velmurugan Periasamy,2016-06-21 13:27:31-04:00,['6e07ed2c9306c8541df24dcfb5f27324b80d45be'],29,122,151,1340614,5,,,,2888
e2fe01c390f11750358912504286fbf740e9692d,0,Velmurugan Periasamy,2016-06-21 15:18:25-04:00,['e488e8df57e44ece1a672218eba91223d63b0f87'],4,15,19,1340633,2,1,1,1,2888
321c9d96321ac1e7248ee159723377eb46b5fa08,1,Velmurugan Periasamy,2016-06-21 15:18:36-04:00,['e2fe01c390f11750358912504286fbf740e9692d'],86,137,223,1340856,7,0,0,1,2888
fcb2ad322bf4528dc085b57dac0b7d8bcf431728,1,Velmurugan Periasamy,2016-06-21 17:05:53-04:00,['321c9d96321ac1e7248ee159723377eb46b5fa08'],16,58,74,1340930,3,0.7,0.7,0.7,2888
e85654b20238f4512b1862444a4ba7de55713f93,0,rmani,2016-06-21 17:48:59-07:00,['fcb2ad322bf4528dc085b57dac0b7d8bcf431728'],4,0,4,1340934,1,1,1,0.5,2888
3d2a7c82a4ef2dd65a7ee7cce65acf43418defe1,0,Velmurugan Periasamy,2016-06-22 19:12:51-04:00,['e85654b20238f4512b1862444a4ba7de55713f93'],1,8,9,1340943,2,0,0,0,2888
992f00bb35daa4b52298fa99ff3703192499b816,1,Velmurugan Periasamy,2016-06-22 19:16:20-04:00,['3d2a7c82a4ef2dd65a7ee7cce65acf43418defe1'],15,20,35,1340978,9,0,0,0,2888
0468bc0c116b047d33e35133e2b27db4763ec586,0,Velmurugan Periasamy,2016-06-22 20:16:54-04:00,['992f00bb35daa4b52298fa99ff3703192499b816'],469,0,469,1341447,1,0.802631579,0.585526316,0,2888
559c6f4826c251e5984a694c1c622975465be669,1,Velmurugan Periasamy,2016-06-23 11:12:48-04:00,['0468bc0c116b047d33e35133e2b27db4763ec586'],1,8,9,1341456,1,,,,2888
c3ca247a9730d5491757850bb1d43fe68cfa8d3f,1,Velmurugan Periasamy,2016-06-23 11:13:21-04:00,['559c6f4826c251e5984a694c1c622975465be669'],3,14,17,1341473,2,0,0,0,2888
65d7fbc6ef888a7601b121b5fe7c43f0f69ae8f0,1,Velmurugan Periasamy,2016-06-23 11:13:44-04:00,['c3ca247a9730d5491757850bb1d43fe68cfa8d3f'],2,31,33,1341506,6,1,1,1,2888
62f86ef64c06219e81810946b0c97684d7beccfa,1,Gautam Borad,2016-06-24 15:42:58+05:18,['65d7fbc6ef888a7601b121b5fe7c43f0f69ae8f0'],22,48,70,1341576,5,1,1,1,2888
e2fc9c98fb37ad21e2ebd13020fde1c255fe2410,1,Gautam Borad,2016-06-24 16:42:35+05:18,['62f86ef64c06219e81810946b0c97684d7beccfa'],7,34,41,1341617,7,0.48,0.48,0.64,2888
437e10a908c16b9e7e590be522773071298e547d,0,Madhan Neethiraj,2016-06-24 08:31:39-07:00,['e2fc9c98fb37ad21e2ebd13020fde1c255fe2410'],23,8,31,1341648,1,,,,2888
e7ef5999559065e55dbf6e14ca9c529a8620d528,0,Madhan Neethiraj,2016-06-24 15:17:44-07:00,['437e10a908c16b9e7e590be522773071298e547d'],0,1,1,1341649,1,,,,2888
d1bb82dcf19f956aba03223e898895857a418c63,0,Velmurugan Periasamy,2016-06-25 08:57:25-04:00,['e7ef5999559065e55dbf6e14ca9c529a8620d528'],12,11,23,1341672,1,0,0,1,2888
8a20a6a09cbbec520bb312dae04f93cedce6bd29,1,Velmurugan Periasamy,2016-06-25 09:02:16-04:00,['d1bb82dcf19f956aba03223e898895857a418c63'],35,313,348,1342020,3,,,,2889
8d884392843484245c535104c2184a81aadc8674,0,Madhan Neethiraj,2016-06-27 00:25:16-07:00,['8a20a6a09cbbec520bb312dae04f93cedce6bd29'],1,1,2,1342022,1,,,,2889
155605eb3f001168817187e10a268c604f1ae033,0,Colm O hEigeartaigh,2016-06-27 11:17:16+01:00,['8d884392843484245c535104c2184a81aadc8674'],1,0,1,1342023,1,,,,2889
42501a5425f7731451e62be234995ec71e1d508b,0,Colm O hEigeartaigh,2016-06-27 12:48:47+01:00,['155605eb3f001168817187e10a268c604f1ae033'],4,3,7,1342030,2,,,,2889
0b99043918c867e54d3f46a61b59ae10446dd034,1,rmani,2016-06-27 10:00:02-07:00,['42501a5425f7731451e62be234995ec71e1d508b'],6,31,37,1342067,3,0,1,1,2889
496dee066aaa30d1702a38162d4d5a2e7ac4c41c,0,Don Bosco Durai,2016-06-27 11:18:41-07:00,['0b99043918c867e54d3f46a61b59ae10446dd034'],8,10,18,1342085,4,,,,2889
8336e122a09fcbcc4a61797d80f69fb6cca3f910,0,Don Bosco Durai,2016-06-27 12:32:00-07:00,['496dee066aaa30d1702a38162d4d5a2e7ac4c41c'],1,1,2,1342087,1,,,,2889
0f4d0abde162a0d021da04f32e05b20c6c2f5a57,0,Madhan Neethiraj,2016-06-27 13:39:17-07:00,['8336e122a09fcbcc4a61797d80f69fb6cca3f910'],7,21,28,1342115,2,0,0,1,2889
af564f38f8e895358f69f52e4208f20b5519aff0,1,Madhan Neethiraj,2016-06-27 14:07:26-07:00,['0f4d0abde162a0d021da04f32e05b20c6c2f5a57'],24,24,48,1342163,3,0,0,1,2889
d52eeff5aa321f737883b9d438f7ac12ce353ebb,1,Madhan Neethiraj,2016-06-27 14:42:33-07:00,['af564f38f8e895358f69f52e4208f20b5519aff0'],22,14,36,1342199,2,0.857142857,0.857142857,0.857142857,2889
bbf4d34269ea62eede958fe6ce4e01f9a639f982,0,Colm O hEigeartaigh,2016-06-28 10:24:08+01:00,['d52eeff5aa321f737883b9d438f7ac12ce353ebb'],5,5,10,1342209,3,,,,2889
1bd72ed39cc12a45986e270236b0b2f7b49975a6,1,Gautam Borad,2016-06-29 10:40:41+05:18,['bbf4d34269ea62eede958fe6ce4e01f9a639f982'],93,121,214,1342423,4,,,,2889
97fb9510e0baa3481444d24d7675e90ecd3ea5ad,1,Gautam Borad,2016-06-29 10:43:33+05:18,['1bd72ed39cc12a45986e270236b0b2f7b49975a6'],0,18,18,1342441,1,0.625,0.625,0.625,2889
aa0159f41b8e079dab0a0a50ee47a042b22be4b8,0,rmani,2016-06-29 00:31:31-07:00,['97fb9510e0baa3481444d24d7675e90ecd3ea5ad'],3,3,6,1342447,1,,,,2889
17f40be4d4a8203ed32cfa61a247550b56aec14a,1,Velmurugan Periasamy,2016-06-29 10:30:30-07:00,['aa0159f41b8e079dab0a0a50ee47a042b22be4b8'],27,35,62,1342509,5,0.64,0.68,0.64,2889
fa8b948ca3322832543098f9c5d43653a3228b67,0,Velmurugan Periasamy,2016-06-29 10:40:32-07:00,['17f40be4d4a8203ed32cfa61a247550b56aec14a'],1,6,7,1342516,2,,,,2889
3122d55e223838efe126c71e887c591fdccdd5a4,1,Velmurugan Periasamy,2016-06-29 10:42:39-07:00,['fa8b948ca3322832543098f9c5d43653a3228b67'],18,70,88,1342604,3,0.16,0,0.36,2889
4937bfea8f5a4579deeafde8ae51d7134a27622c,0,Velmurugan Periasamy,2016-06-29 11:02:25-07:00,['3122d55e223838efe126c71e887c591fdccdd5a4'],12,3,15,1342619,2,1,1,0.75,2889
e4229e8af4f13d4d72ee913d61ff4b27e3274a4e,1,Madhan Neethiraj,2016-06-30 09:07:59-07:00,['4937bfea8f5a4579deeafde8ae51d7134a27622c'],5,70,75,1342694,1,0.565217391,1,0.565217391,2889
e71e76a511329d1ec0ae155ba793c6c64bed841e,0,rmani,2016-07-01 14:24:05-07:00,['e4229e8af4f13d4d72ee913d61ff4b27e3274a4e'],21,0,21,1342715,3,,,,2889
1be6d93544448e86d3aa682243499418f2210206,0,Gautam Borad,2016-07-04 12:04:33+05:18,['e71e76a511329d1ec0ae155ba793c6c64bed841e'],0,174,174,1342889,5,,,,2894
e48732c849a9571e7d9c8dcb95d1b955fef38489,0,Colm O hEigeartaigh,2016-07-04 17:58:07+01:00,['1be6d93544448e86d3aa682243499418f2210206'],1,0,1,1342890,1,,,,2894
e50132a92679946f9b221d29a0ffe1ef1dc66f6f,0,Colm O hEigeartaigh,2016-07-05 10:49:03+01:00,['e48732c849a9571e7d9c8dcb95d1b955fef38489'],0,18,18,1342908,1,,,,2894
fc903232796b3b2b684ccfc575ce137ffa3888b6,1,Gautam Borad,2016-07-06 10:17:03+05:18,['e50132a92679946f9b221d29a0ffe1ef1dc66f6f'],11,519,530,1343438,1,0.013944223,0.013944223,0.039840637,2894
dfc903bd7e20928607562d1f97a7ec13f90f41d2,0,Madhan Neethiraj,2016-07-05 22:24:39-07:00,['fc903232796b3b2b684ccfc575ce137ffa3888b6'],11,1,12,1343450,1,1,1,0,2894
15c818c9e6ba86f9ac564a09d3c94fdb60d48c06,0,Colm O hEigeartaigh,2016-07-06 14:44:48+01:00,['dfc903bd7e20928607562d1f97a7ec13f90f41d2'],6,6,12,1343462,6,,,,2894
63d6c8309110127a5d33da4a0073b31b22b11ea6,1,Velmurugan Periasamy,2016-07-06 12:03:36-04:00,['15c818c9e6ba86f9ac564a09d3c94fdb60d48c06'],252,1252,1504,1344966,10,0.225352113,1,0.957746479,2899
3682de5222788da6748354194f0cc7556e42820b,0,Velmurugan Periasamy,2016-07-06 12:45:48-04:00,['63d6c8309110127a5d33da4a0073b31b22b11ea6'],1,1,2,1344968,1,,,,2899
77b101f171fa6df024fa032ce573c3c5f845f61b,1,Velmurugan Periasamy,2016-07-06 13:10:46-04:00,['3682de5222788da6748354194f0cc7556e42820b'],5,25,30,1344998,2,0,0,0,2899
29faab04b0e6d5913f98fabdc3e41fc0d1879d0f,1,Velmurugan Periasamy,2016-07-06 13:11:10-04:00,['77b101f171fa6df024fa032ce573c3c5f845f61b'],2,6,8,1345006,1,,,,2899
df6a6184ad2280d5f49111d78abfb177520b3500,0,rmani,2016-07-06 12:40:23-07:00,['29faab04b0e6d5913f98fabdc3e41fc0d1879d0f'],3,34,37,1345043,1,1,1,1,2899
c19b1813363760ef384134ea1e83fedeb49d25ca,0,rmani,2016-07-07 10:48:14-07:00,['df6a6184ad2280d5f49111d78abfb177520b3500'],1,2,3,1345046,2,0,0,1,2899
80384f0978e04080781ac1d7dab70c352ad06650,1,Velmurugan Periasamy,2016-07-07 14:03:59-04:00,['c19b1813363760ef384134ea1e83fedeb49d25ca'],3,13,16,1345062,4,0.571428571,0.428571429,0.428571429,2899
903e0cdaf39f230a0ba616a1a8d533140085b599,1,Velmurugan Periasamy,2016-07-07 14:04:14-04:00,['80384f0978e04080781ac1d7dab70c352ad06650'],3,6,9,1345071,1,1,0,0,2899
7d95b475b55fdfe8f35e6d4cd574cad923f87a16,1,Madhan Neethiraj,2016-07-07 22:08:20-07:00,['903e0cdaf39f230a0ba616a1a8d533140085b599'],22,90,112,1345183,4,0.416666667,0.354166667,0.979166667,2899
e20ad3d38435f84abfdc4c8fc54026e56b4f263f,1,Madhan Neethiraj,2016-07-07 22:43:07-07:00,['7d95b475b55fdfe8f35e6d4cd574cad923f87a16'],20,46,66,1345249,3,1,1,1,2899
c0785ed49254aa116d14df2169616e54f1483e2c,0,Colm O hEigeartaigh,2016-07-08 12:55:13+01:00,['e20ad3d38435f84abfdc4c8fc54026e56b4f263f'],12,0,12,1345261,1,,,,2899
4b7a1a767211e1ee90348d9806877d4365262543,1,Velmurugan Periasamy,2016-07-08 19:28:07-04:00,['c0785ed49254aa116d14df2169616e54f1483e2c'],1,6,7,1345268,1,0,0,0,2899
ce5f434f50cf67c712c828fe3d6dd198a50a9051,0,Velmurugan Periasamy,2016-07-08 19:33:27-04:00,['4b7a1a767211e1ee90348d9806877d4365262543'],7,59,66,1345334,5,0,0,1,2899
5e565cdde09febdd86dc30de44ccf3607cb1db17,1,rmani,2016-07-08 17:30:00-07:00,['ce5f434f50cf67c712c828fe3d6dd198a50a9051'],1,7,8,1345342,1,1,1,1,2899
2da241b2e2aa6c80b6a27683a46fb98fe9b7ffa3,1,Colm O hEigeartaigh,2016-07-11 10:00:42+01:00,['5e565cdde09febdd86dc30de44ccf3607cb1db17'],1,1,2,1345344,1,,,,2899
84a699a38bd863a42694d47948ec0fd08f856e9e,0,Colm O hEigeartaigh,2016-07-11 10:33:22+01:00,['2da241b2e2aa6c80b6a27683a46fb98fe9b7ffa3'],0,4,4,1345348,1,,,,2899
a5fbb33a2c17a29aea05166a34f0f9ed85adc5a4,0,sneethiraj,2016-07-11 09:25:21-04:00,['84a699a38bd863a42694d47948ec0fd08f856e9e'],0,1,1,1345349,1,,,,2899
8d694aa3d9a837180afe9a8e2b45ce8a3dfb2850,1,sneethiraj,2016-07-11 09:37:01-04:00,['a5fbb33a2c17a29aea05166a34f0f9ed85adc5a4'],51,7,58,1345407,18,1,0.828571429,0.285714286,2899
df5a95e1be8a8b18239cc5fea0646e5c03354bb2,0,sneethiraj,2016-07-11 09:49:32-04:00,['8d694aa3d9a837180afe9a8e2b45ce8a3dfb2850'],24,36,60,1345467,5,0.8,0.8,1,2899
e9421a1459a7ea3014cc048df0b9e282c76b845c,0,sneethiraj,2016-07-11 10:32:48-04:00,['df5a95e1be8a8b18239cc5fea0646e5c03354bb2'],0,7,7,1345474,1,0,1,1,2899
937e0babaddb89ac1c1295a93f84f87adc5bab1b,1,sneethiraj,2016-07-11 11:57:57-04:00,['e9421a1459a7ea3014cc048df0b9e282c76b845c'],1,3,4,1345478,1,0,0,0,2899
42d8db56d51015c65284014e3c08065de4997046,1,rmani,2016-07-11 15:09:02-07:00,['937e0babaddb89ac1c1295a93f84f87adc5bab1b'],25,479,504,1345982,7,0.525179856,0.607913669,0.902877698,2902
5ba4831f3654c0df5f789c62f3850d075cdd278c,1,rmani,2016-07-11 15:09:24-07:00,['42d8db56d51015c65284014e3c08065de4997046'],66,219,285,1346267,9,0,0.864864865,0.135135135,2905
b063a9989e9ceddc251eb02f85ffe5caee180070,0,rmani,2016-07-11 15:09:30-07:00,['5ba4831f3654c0df5f789c62f3850d075cdd278c'],0,18,18,1346285,2,0,0,1,2905
7e3252f305f6e50a2622f302461b44ff5fc4d62f,0,sneethiraj,2016-07-11 18:45:33-04:00,['b063a9989e9ceddc251eb02f85ffe5caee180070'],48,48,96,1346381,48,,,,2905
9c21c33bcd3d26777bfc501e3cd73a2d490c661f,0,sneethiraj,2016-07-11 18:53:10-04:00,['7e3252f305f6e50a2622f302461b44ff5fc4d62f'],48,48,96,1346477,48,,,,2905
e191a4b4e2d465018b56ec18b190655d52fd3acb,0,Colm O hEigeartaigh,2016-07-12 15:02:01+01:00,['9c21c33bcd3d26777bfc501e3cd73a2d490c661f'],4,8,12,1346489,2,0,0,0,2905
4e4bd02fd9f9c7a4c5873f04446e819e4f5353bd,1,rmani,2016-07-12 17:03:29-07:00,['e191a4b4e2d465018b56ec18b190655d52fd3acb'],4,15,19,1346508,1,0,1,1,2905
1bd0e04983ce3c8b2d503b571d50d7431cb0131a,1,Colm O hEigeartaigh,2016-07-13 17:09:56+01:00,['4e4bd02fd9f9c7a4c5873f04446e819e4f5353bd'],1,1,2,1346510,1,,,,2905
07982526f67964f1b32e315fc5382456fafdd7eb,1,Velmurugan Periasamy,2016-07-13 17:15:55-04:00,['1bd0e04983ce3c8b2d503b571d50d7431cb0131a'],10,44,54,1346564,3,0,0.060606061,1,2905
35e9c10e53fd9d7fbef554a1c6fedfe84d36c736,1,Velmurugan Periasamy,2016-07-13 17:16:15-04:00,['07982526f67964f1b32e315fc5382456fafdd7eb'],33,44,77,1346641,3,0,0,1,2905
7bc2f89e25b656ca9e80d41d6f4cb1531350f502,1,Velmurugan Periasamy,2016-07-13 17:16:34-04:00,['35e9c10e53fd9d7fbef554a1c6fedfe84d36c736'],3,12,15,1346656,2,0,0,1,2905
23c7b1148533275dffb37853b49a6ebdb8126a7e,1,Madhan Neethiraj,2016-07-14 00:40:06-07:00,['7bc2f89e25b656ca9e80d41d6f4cb1531350f502'],31,46,77,1346733,1,0,0,0.538461538,2905
8762a8c795d09210fd7293cebf71603bffe644ec,1,Velmurugan Periasamy,2016-07-14 17:22:54-04:00,['23c7b1148533275dffb37853b49a6ebdb8126a7e'],240,331,571,1347304,3,0.195121951,0.195121951,0.707317073,2905
87fe3446d988b72e24467c427ba31ac9d3174de2,0,Gautam Borad,2016-07-15 16:56:31+05:18,['8762a8c795d09210fd7293cebf71603bffe644ec'],3,8,11,1347315,2,,,,2905
e3d50db85c289f30f71ba3ba27eb23192a554281,1,Velmurugan Periasamy,2016-07-17 08:53:41-04:00,['87fe3446d988b72e24467c427ba31ac9d3174de2'],16,20,36,1347351,1,0.25,0.25,1,2905
3c8b40fcf317235bc5597b4d6ffe535c7a5baa34,1,Madhan Neethiraj,2016-07-18 00:16:50-07:00,['e3d50db85c289f30f71ba3ba27eb23192a554281'],8,387,395,1347746,9,0.020512821,0.538461538,0.958974359,2907
8e45cf4808908e866406d35203e49c51f42e362f,0,sneethiraj,2016-07-18 16:06:53-04:00,['3c8b40fcf317235bc5597b4d6ffe535c7a5baa34'],3,0,3,1347749,1,,,,2907
2bf60228fe9f2535ddc293c25ee08864871ca23d,0,Colm O hEigeartaigh,2016-07-19 12:44:42+01:00,['8e45cf4808908e866406d35203e49c51f42e362f'],0,27,27,1347776,1,,,,2907
f66b885dfb8bb7238f265d85dbb4fb11962119ac,0,Colm O hEigeartaigh,2016-07-19 12:45:44+01:00,['2bf60228fe9f2535ddc293c25ee08864871ca23d'],1,1,2,1347778,1,,,,2907
0f0f1d375abf5b3c640c53d75fff38c7405a4e38,0,Gautam Borad,2016-07-19 17:26:47+05:18,['f66b885dfb8bb7238f265d85dbb4fb11962119ac'],1,14,15,1347793,2,0.928571429,1,0.928571429,2907
3a0b69e38a72827df26719e565b43d5bfc33d7c6,0,Gautam Borad,2016-07-19 17:27:55+05:18,['0f0f1d375abf5b3c640c53d75fff38c7405a4e38'],14,26,40,1347833,1,0,0,1,2907
a1fcbf71731a10fe94b26fccdffb8d03703bd64f,0,Colm O hEigeartaigh,2016-07-19 13:10:48+01:00,['3a0b69e38a72827df26719e565b43d5bfc33d7c6'],24,15,39,1347872,2,,,,2907
4c6333f8ffa97be7fea1c67d7b28928624d6e8f9,0,Colm O hEigeartaigh,2016-07-19 13:18:30+01:00,['a1fcbf71731a10fe94b26fccdffb8d03703bd64f'],2,12,14,1347886,1,,,,2907
ad3a3a7829441282beb4dbf92ea50318f0c8b270,0,rmani,2016-07-19 09:21:55-07:00,['4c6333f8ffa97be7fea1c67d7b28928624d6e8f9'],4,320,324,1348210,2,0.451612903,0.460829493,1,2908
d7e5146d573ad05662a6bee21dbfbcf807f3501f,0,Colm O hEigeartaigh,2016-07-20 12:12:34+01:00,['ad3a3a7829441282beb4dbf92ea50318f0c8b270'],6,0,6,1348216,2,,,,2908
47af6cc5406ecaed2aba6345dd61ec6e7456c5b8,1,Velmurugan Periasamy,2016-07-20 10:12:56-04:00,['d7e5146d573ad05662a6bee21dbfbcf807f3501f'],62,97,159,1348375,3,0,0.111111111,0,2908
55c55ca7a1aae73c70db7cab5b39dcf72ae3ef4e,0,Velmurugan Periasamy,2016-07-20 14:17:31-04:00,['47af6cc5406ecaed2aba6345dd61ec6e7456c5b8'],0,1,1,1348376,1,,,,2908
ab131efd32f9ba3622aef865d1fd8b0832730dcc,0,Madhan Neethiraj,2016-07-20 23:57:09-07:00,['55c55ca7a1aae73c70db7cab5b39dcf72ae3ef4e'],1,8,9,1348385,1,0,0,0,2908
ae53958559129da24915f344f6c3cfa89284faaa,0,Colm O hEigeartaigh,2016-07-21 10:39:41+01:00,['ab131efd32f9ba3622aef865d1fd8b0832730dcc'],1,3,4,1348389,1,0,0,1,2908
1aad349874b3afffb1432736420dd41eddde0c6a,1,Colm O hEigeartaigh,2016-07-21 11:19:33+01:00,['ae53958559129da24915f344f6c3cfa89284faaa'],10,11,21,1348410,1,,0,1,2908
847e0733b97238249808f249f44a4d46ff8dfbeb,0,Velmurugan Periasamy,2016-07-21 14:36:58-04:00,['1aad349874b3afffb1432736420dd41eddde0c6a'],9,9,18,1348428,3,,,,2908
62100cdbb3eb5373ddf5d637a502ede20c813a76,0,rmani,2016-07-21 12:33:50-07:00,['847e0733b97238249808f249f44a4d46ff8dfbeb'],0,1,1,1348429,1,0,1,1,2908
35c4d34f6ac17d9cfed78e5633c78ec8904cd3af,0,Colm O hEigeartaigh,2016-07-25 12:20:25+01:00,['62100cdbb3eb5373ddf5d637a502ede20c813a76'],1,1,2,1348431,1,,,,2908
f452c640ce84d2e7709056c20295aaef72a47449,0,Colm O hEigeartaigh,2016-07-25 12:22:03+01:00,['35c4d34f6ac17d9cfed78e5633c78ec8904cd3af'],64,53,117,1348548,27,,,,2908
f0024d518afa3ecfbe75873593516396b78bc0a1,0,Colm O hEigeartaigh,2016-07-25 14:27:49+01:00,['f452c640ce84d2e7709056c20295aaef72a47449'],16,16,32,1348580,16,,,,2908
60fa8f04caf9e50914568dbbc1b14e61a428c01f,0,Colm O hEigeartaigh,2016-07-25 15:31:04+01:00,['f0024d518afa3ecfbe75873593516396b78bc0a1'],13,31,44,1348624,1,0,0.411764706,1,2908
f3d999b4e5731c672a5de0b6e4c90221844f7d53,0,Velmurugan Periasamy,2016-07-26 14:48:26-04:00,['60fa8f04caf9e50914568dbbc1b14e61a428c01f'],0,155,155,1348779,2,0.52173913,0.52173913,1,2909
cc7277118362a26c5300549fc1c5bf2d22719ca4,0,Velmurugan Periasamy,2016-07-26 14:48:49-04:00,['f3d999b4e5731c672a5de0b6e4c90221844f7d53'],1,1,2,1348781,1,,,,2909
2cf47b9fe5228f8f46c63cf0fa370c0fbe5fbd2a,0,rmani,2016-07-26 12:46:25-07:00,['cc7277118362a26c5300549fc1c5bf2d22719ca4'],1,1,2,1348783,1,,,,2909
246d53690eec7db1ac45bc3d598ae6c326e7a8f5,0,Gautam Borad,2016-07-27 13:55:23+05:18,['2cf47b9fe5228f8f46c63cf0fa370c0fbe5fbd2a'],3,0,3,1348786,1,1,1,1,2909
d9a661cfefd6b5c13486bc7d16e66e98dcf05bcd,0,Colm O hEigeartaigh,2016-07-27 10:11:12+01:00,['246d53690eec7db1ac45bc3d598ae6c326e7a8f5'],28892,0,28892,1377678,169,0.438823107,0.36842483,0.179260854,2909
cd2e73030f5749330f1b432dd63d3d8dc6d55cbc,1,Madhan Neethiraj,2016-07-27 07:55:26-07:00,['d9a661cfefd6b5c13486bc7d16e66e98dcf05bcd'],5,20,25,1377703,2,0,0,1,2909
5a18b906b701054d8cbb0acbd5d55af27a0573fc,1,Velmurugan Periasamy,2016-07-27 11:47:45-04:00,['cd2e73030f5749330f1b432dd63d3d8dc6d55cbc'],7,7,14,1377717,2,,,,2909
711c69c87d5315d9936b6a46fe390e2672891402,1,rmani,2016-07-27 14:40:28-07:00,['5a18b906b701054d8cbb0acbd5d55af27a0573fc'],6,16,22,1377739,1,0,0,0,2909
d8e8890ba228a21ea046c70bb4e2ee4c7e6f07b9,1,Madhan Neethiraj,2016-07-27 17:49:57-07:00,['711c69c87d5315d9936b6a46fe390e2672891402'],29,39,68,1377807,10,0,0.583333333,1,2909
4447aa33c890273201ab34236981c0788f199560,1,Velmurugan Periasamy,2016-07-28 10:37:43-04:00,['d8e8890ba228a21ea046c70bb4e2ee4c7e6f07b9'],43,25,68,1377875,6,1,0,0,2909
6bdb535df11f31e5701f1b5865e9da72e5cf44a8,1,Madhan Neethiraj,2016-07-28 16:52:23-07:00,['4447aa33c890273201ab34236981c0788f199560'],23,548,571,1378446,7,0.25,0.1375,0.6875,2911
3caa698f3c6957ec5fe65b6e5bb0b59dc757dc34,1,rmani,2016-07-28 23:00:05-07:00,['6bdb535df11f31e5701f1b5865e9da72e5cf44a8'],17,28,45,1378491,4,0.181818182,0,1,2911
a684b48c5a09b2432017249eefad70bc8e36123a,1,Velmurugan Periasamy,2016-07-29 11:48:15-04:00,['3caa698f3c6957ec5fe65b6e5bb0b59dc757dc34'],304,386,690,1379181,27,0,0.120879121,0.857142857,2911
09b52b939bcd957be7e5a6a85a138c0fee29f9df,0,Velmurugan Periasamy,2016-07-29 11:48:41-04:00,['a684b48c5a09b2432017249eefad70bc8e36123a'],6,20,26,1379207,3,0.142857143,0.142857143,1,2911
24a100081eb05276bca7aa07b3a8c2255646c21a,1,rmani,2016-07-29 23:09:19-07:00,['09b52b939bcd957be7e5a6a85a138c0fee29f9df'],96,115,211,1379418,9,0.090909091,0.636363636,0.863636364,2911
17e37f0b68a5172c6c4b7c6d7c8a188ebc88f44a,0,Colm O hEigeartaigh,2016-08-02 17:28:38+01:00,['24a100081eb05276bca7aa07b3a8c2255646c21a'],9,9,18,1379436,3,,,,2911
787457b588a6e4ddac7d5bd31bfe613ede6478d8,0,rmani,2016-08-02 10:03:20-07:00,['17e37f0b68a5172c6c4b7c6d7c8a188ebc88f44a'],0,13,13,1379449,4,0,1,1,2911
cbee002b8976b1631408ae25d12c4aaf54c01701,0,rmani,2016-08-02 10:05:30-07:00,['787457b588a6e4ddac7d5bd31bfe613ede6478d8'],0,6,6,1379455,2,,,,2911
a171cdbb47d06057c05cd90a642378af04025fa0,0,Colm O hEigeartaigh,2016-08-03 13:01:53+01:00,['cbee002b8976b1631408ae25d12c4aaf54c01701'],7,5,12,1379467,1,0,0,0,2911
6116f91f0edddac4ba6e96f29c23d7a88a106cd1,0,Colm O hEigeartaigh,2016-08-04 09:47:01+01:00,['a171cdbb47d06057c05cd90a642378af04025fa0'],273,18,291,1379758,2,0.620879121,0.467032967,0.214285714,2911
8411c64a6ffefba4332e9f0c74b90d1204fd53c7,1,Colm O hEigeartaigh,2016-08-04 12:19:40+01:00,['6116f91f0edddac4ba6e96f29c23d7a88a106cd1'],24,12,36,1379794,1,0.2,0.1,0,2911
484abfc4b026f007c2dd0d7aac8faa6ea4bf1f28,1,Don Bosco Durai,2016-08-04 22:52:40-07:00,['8411c64a6ffefba4332e9f0c74b90d1204fd53c7'],1,3,4,1379798,1,1,1,1,2911
6f48a62076ba0e5ab738ae3f0fb368b2b81b0529,0,Colm O hEigeartaigh,2016-08-05 11:23:16+01:00,['484abfc4b026f007c2dd0d7aac8faa6ea4bf1f28'],2,1,3,1379801,1,1,0,0,2911
baac2ba9fcbcdf00b08d69c98fa31f453ababc39,1,Velmurugan Periasamy,2016-08-05 19:07:08-04:00,['6f48a62076ba0e5ab738ae3f0fb368b2b81b0529'],24,160,184,1379985,4,0.20212766,0.70212766,0.968085106,2911
fa59f97bc30584e015b52473d15ade903563b26c,1,Velmurugan Periasamy,2016-08-05 19:07:50-04:00,['baac2ba9fcbcdf00b08d69c98fa31f453ababc39'],10,11,21,1380006,1,0,0,1,2911
578b4ed2f0ce6cf53c7fe571c59a0d2e40525287,1,rmani,2016-08-05 18:43:24-07:00,['fa59f97bc30584e015b52473d15ade903563b26c'],90,169,259,1380265,8,0.352941176,0,1,2911
d87ecce141f5f4d36b8490d017ead1c9a4b4aa81,1,sneethiraj,2016-08-08 00:33:55-04:00,['578b4ed2f0ce6cf53c7fe571c59a0d2e40525287'],31,34,65,1380330,7,1,0,0,2911
7993a622e9501521f2dd9d3af19b8704bb499ce1,1,sneethiraj,2016-08-08 02:40:01-04:00,['d87ecce141f5f4d36b8490d017ead1c9a4b4aa81'],23,25,48,1380378,1,,,,2911
f0cae730a8cfba87a5396bf8b6914ba132908c02,0,Velmurugan Periasamy,2016-08-10 17:09:18+05:18,['7993a622e9501521f2dd9d3af19b8704bb499ce1'],33,98,131,1380509,1,1,1,0.916666667,2911
77e2c4429da45c426fd93d68c249ee74b8a77443,0,Velmurugan Periasamy,2016-08-10 21:58:23+05:18,['f0cae730a8cfba87a5396bf8b6914ba132908c02'],0,1,1,1380510,1,,,,2911
a1b2ce54001fc1202bd16f47db0333598f6602c6,0,rmani,2016-08-10 10:25:23-07:00,['77e2c4429da45c426fd93d68c249ee74b8a77443'],3,8,11,1380521,3,,,,2911
cc1bb5a95c36e5d5579742127c13d252b46154a8,0,rmani,2016-08-11 17:36:38-07:00,['a1b2ce54001fc1202bd16f47db0333598f6602c6'],0,3,3,1380524,1,0,1,1,2911
b0d21cffb94d50e6f5e2ea247a39d13fa33d52e4,0,Velmurugan Periasamy,2016-08-12 09:55:30+05:18,['cc1bb5a95c36e5d5579742127c13d252b46154a8'],2,25,27,1380551,1,0,0,0.5,2911
a5d2bedb26e210a43c066112c11ccd81d95672be,0,Gautam Borad,2016-08-12 11:26:33+05:18,['b0d21cffb94d50e6f5e2ea247a39d13fa33d52e4'],1,1,2,1380553,1,,,,2911
250c50daa59412d7a8b519a3b615f1b00c048589,1,Selvamohan Neethiraj,2016-08-12 11:55:02-04:00,['a5d2bedb26e210a43c066112c11ccd81d95672be'],168,109,277,1380830,7,,,,2911
b935426d1856abbe52cfa4a26af9a2110d273ccb,1,rmani,2016-08-14 23:40:50-07:00,['250c50daa59412d7a8b519a3b615f1b00c048589'],2,20,22,1380852,1,1,1,1,2911
3a36875e96aa2f689edd71ab77a8c74a6355493a,1,Madhan Neethiraj,2016-08-15 18:34:14-07:00,['b935426d1856abbe52cfa4a26af9a2110d273ccb'],88,465,553,1381405,18,0.290322581,0.322580645,0.983870968,2911
818e1d354312443fd8e29d49861b91d13e239be2,1,Madhan Neethiraj,2016-08-16 01:02:00-07:00,['3a36875e96aa2f689edd71ab77a8c74a6355493a'],100,443,543,1381948,9,0.795774648,0.908450704,0.985915493,2914
89136413ee589b9b63a83ea8f61402a533a8f621,0,sneethiraj,2016-08-19 11:03:27-04:00,['818e1d354312443fd8e29d49861b91d13e239be2'],2,10,12,1381960,1,0,0,1,2914
bf3f095429b0027213c6e10dd6a32d94608623d3,0,Madhan Neethiraj,2016-08-19 10:44:21-07:00,['89136413ee589b9b63a83ea8f61402a533a8f621'],4,8,12,1381972,3,0,0,1,2914
ac5a03667cf167eb7a1d83d2c9aae8c2ab946494,0,rmani,2016-08-19 15:03:25-07:00,['bf3f095429b0027213c6e10dd6a32d94608623d3'],8,8,16,1381988,1,,,,2914
f734393e68de75dfa37e73ad158aae7e92f04fb2,1,Colm O hEigeartaigh,2016-08-24 15:40:16+01:00,['ac5a03667cf167eb7a1d83d2c9aae8c2ab946494'],4,5,9,1381997,2,,,,2914
c9d1546614b1979980a96165e46542f8bb719cbb,0,Colm O hEigeartaigh,2016-08-25 11:11:33+01:00,['f734393e68de75dfa37e73ad158aae7e92f04fb2'],1,1,2,1381999,1,,,,2914
480776a9eb2004e3684b1d8f92f29fbeb2815233,1,Madhan Neethiraj,2016-08-25 18:17:11-07:00,['c9d1546614b1979980a96165e46542f8bb719cbb'],32,614,646,1382645,16,0.409793814,0.430412371,0.87371134,2915
b56119114cb989c44917dd7fc6d1d8da3b852632,1,Selvamohan Neethiraj,2016-08-29 09:22:22-04:00,['480776a9eb2004e3684b1d8f92f29fbeb2815233'],61,26,87,1382732,23,0.857142857,0.857142857,0.19047619,2915
448dd49a62004ad0a3aeb64c5fabef9c1ec4fe1a,0,Colm O hEigeartaigh,2016-08-29 14:25:52+01:00,['480776a9eb2004e3684b1d8f92f29fbeb2815233'],12,0,12,1382744,2,,,,2915
b15d6fa8a5a2168ccdc3cf1a5566461508aac711,0,Selvamohan Neethiraj,2016-08-29 09:31:09-04:00,"['b56119114cb989c44917dd7fc6d1d8da3b852632', '448dd49a62004ad0a3aeb64c5fabef9c1ec4fe1a']",12,0,12,1382756,2,,,,2915
7729373dea5a560f5cb4b24433d12b25a9dc7519,0,Selvamohan Neethiraj,2016-08-29 10:13:59-04:00,['b15d6fa8a5a2168ccdc3cf1a5566461508aac711'],6,1132,1138,1383894,11,0.512195122,1,0.908536585,2923
7f9395b357db893c7e2ac7219bc07d02cfbdf67b,0,Selvamohan Neethiraj,2016-08-29 12:19:19-04:00,['7729373dea5a560f5cb4b24433d12b25a9dc7519'],40,22,62,1383956,9,1,1,0.571428571,2923
682424276b393c9f6d9fe61f3225f6906b5dce42,0,Madhan Neethiraj,2016-08-29 16:22:47-07:00,['7f9395b357db893c7e2ac7219bc07d02cfbdf67b'],2,6,8,1383964,1,,,,2923
ff4e2e7b6847679388a13ddd8396e191e0106f18,1,Madhan Neethiraj,2016-08-29 16:32:56-07:00,['682424276b393c9f6d9fe61f3225f6906b5dce42'],146,678,824,1384788,14,0.154811715,0.10460251,0.991631799,2926
9918c8d25c35633c86b2a641a29ff1a83dfe51a0,1,Madhan Neethiraj,2016-08-30 11:26:06-07:00,['ff4e2e7b6847679388a13ddd8396e191e0106f18'],55,52,107,1384895,1,0,0,1,2926
1a2f3f33c938f9f9176208d2278d512fab222afe,1,Colm O hEigeartaigh,2016-08-31 10:29:57+01:00,['9918c8d25c35633c86b2a641a29ff1a83dfe51a0'],449,398,847,1385742,21,,,,2926
0bc79e9fb794feb0f7460284c6c355d08dc9de6a,0,Gautam Borad,2016-08-31 21:46:57+05:18,['1a2f3f33c938f9f9176208d2278d512fab222afe'],8,1,9,1385751,1,1,1,0,2926
a39c00f952267bacec5388880f33e694bdd467c1,0,Colm O hEigeartaigh,2016-09-01 10:33:47+01:00,['0bc79e9fb794feb0f7460284c6c355d08dc9de6a'],32,40,72,1385823,11,0.6,1,1,2926
c659d9aa711595af9e701210484dc72cd8ff8985,1,Madhan Neethiraj,2016-09-01 16:25:20-07:00,['a39c00f952267bacec5388880f33e694bdd467c1'],304,809,1113,1386936,37,0.255411255,0.316017316,0.636363636,2929
89e11bcc2a6782dec11f3f88e459dc6aa8691931,1,Madhan Neethiraj,2016-09-02 00:11:17-07:00,['c659d9aa711595af9e701210484dc72cd8ff8985'],3,9,12,1386948,1,1,1,1,2929
2118a71638055f7d44a94cbaed90809c53aead67,0,Madhan Neethiraj,2016-09-02 15:50:06-07:00,['89e11bcc2a6782dec11f3f88e459dc6aa8691931'],1,9,10,1386958,2,0.833333333,0.833333333,1,2929
2fb907c802ca64d0117261ef7f47ab2912578d18,1,Selvamohan Neethiraj,2016-09-02 23:32:18-04:00,['2118a71638055f7d44a94cbaed90809c53aead67'],9,9,18,1386976,1,,,,2929
40d742fa97f710baf636cc2edfc4aa878f168e18,1,Colm O hEigeartaigh,2016-09-05 16:43:21+01:00,['2fb907c802ca64d0117261ef7f47ab2912578d18'],2,2,4,1386980,1,,,,2929
eea868860d283f53d9d24de8909cf5d68b6cf1b7,1,Madhan Neethiraj,2016-09-06 15:45:15-07:00,['40d742fa97f710baf636cc2edfc4aa878f168e18'],9,21,30,1387010,4,0,0,1,2929
3eba2a1edadf7d1c706997401ba46cf13595e82a,1,Velmurugan Periasamy,2016-09-07 15:12:57-04:00,['eea868860d283f53d9d24de8909cf5d68b6cf1b7'],2,2,4,1387014,1,,,,2929
048f6a89d05c39ce3c8363dbd542d98124cce69e,1,Velmurugan Periasamy,2016-09-07 15:13:00-04:00,['3eba2a1edadf7d1c706997401ba46cf13595e82a'],11,16,27,1387041,4,0.833333333,1,1,2929
1115ca8e9bb339b8f8e23909945eb314624e8d4c,0,Colm O hEigeartaigh,2016-09-09 09:48:22+01:00,['048f6a89d05c39ce3c8363dbd542d98124cce69e'],5,1,6,1387047,1,1,1,1,2929
68541c92afe3b6500ef28b3a6ee01149a337ad20,1,Velmurugan Periasamy,2016-09-13 10:38:22-04:00,['1115ca8e9bb339b8f8e23909945eb314624e8d4c'],167,858,1025,1388072,3,0.00148368,0.034124629,0.005934718,2929
ed3f214b2bb44278b27826e7e5de5990df4f62eb,0,Colm O hEigeartaigh,2016-09-14 15:20:05+01:00,['68541c92afe3b6500ef28b3a6ee01149a337ad20'],55,351,406,1388478,3,0,1,1,2929
bb420d5c2493e4aa159f3be7b2cbc213bc3c30b3,0,Colm O hEigeartaigh,2016-09-15 12:58:29+01:00,['ed3f214b2bb44278b27826e7e5de5990df4f62eb'],4,81,85,1388563,2,1,1,1,2929
0af4131570f8a1c97a11c0f22ce69d6613442096,0,Colm O hEigeartaigh,2016-09-16 11:07:38+01:00,['bb420d5c2493e4aa159f3be7b2cbc213bc3c30b3'],24,5,29,1388592,2,0,0,0,2929
5e1a5dc9932e9c25492529f0c6a7f1798c331cc5,0,Colm O hEigeartaigh,2016-09-16 15:29:13+01:00,['0af4131570f8a1c97a11c0f22ce69d6613442096'],5,1,6,1388598,2,,,,2929
1635869172ab15ddda4b770e02b485e597db763b,0,Madhan Neethiraj,2016-09-20 14:22:52-07:00,['5e1a5dc9932e9c25492529f0c6a7f1798c331cc5'],0,1,1,1388599,1,1,1,1,2929
eed536b1335b324232fce02ae2368d479d75c343,1,rmani,2016-09-20 22:53:16-07:00,['1635869172ab15ddda4b770e02b485e597db763b'],4,4,8,1388607,1,,,,2929
868c62b729bb67b8b9db3f2146db1ea442b53ea8,1,Colm O hEigeartaigh,2016-09-26 16:40:26+01:00,['eed536b1335b324232fce02ae2368d479d75c343'],0,1822,1822,1390429,15,0.19630485,1,0.979214781,2941
74959da1617f65bdf74048ecd714dc3aa1d384e9,1,Madhan Neethiraj,2016-09-26 14:48:39-07:00,['868c62b729bb67b8b9db3f2146db1ea442b53ea8'],196,572,768,1391197,8,1,0.875,1,2944
f2c3040a0af472cef1a41e13f5b15a34b31b0f04,1,Madhan Neethiraj,2016-09-26 15:21:10-07:00,['74959da1617f65bdf74048ecd714dc3aa1d384e9'],66,21,87,1391284,4,1,1,0.272727273,2944
5359e376b9c56ca62174722b47ad68cd77b13b73,0,Colm O hEigeartaigh,2016-09-28 10:18:11+01:00,['f2c3040a0af472cef1a41e13f5b15a34b31b0f04'],163,159,322,1391606,1,1,1,1,2944
09700f35ad41dbb7c23cedbc8ee68a16d9565de8,0,Colm O hEigeartaigh,2016-09-28 10:18:59+01:00,['5359e376b9c56ca62174722b47ad68cd77b13b73'],2830,2830,5660,1397266,620,,,,2944
eb21ea6afb9f2ca0e26a769bfc6333ba3cce0e61,0,Colm O hEigeartaigh,2016-09-28 10:25:34+01:00,['09700f35ad41dbb7c23cedbc8ee68a16d9565de8'],1500,1500,3000,1400266,119,,,,2944
1c441f798e1c5da54f6bb9faf211eadb5f10b6b5,1,Velmurugan Periasamy,2016-09-28 11:19:17-04:00,['eb21ea6afb9f2ca0e26a769bfc6333ba3cce0e61'],0,5349,5349,1405615,7,0.445993984,0.96089691,1,2951
53fb16a60aeb9557d56d76003831e9e442351244,1,Velmurugan Periasamy,2016-09-28 11:19:33-04:00,['1c441f798e1c5da54f6bb9faf211eadb5f10b6b5'],0,1052,1052,1406667,2,0.459602649,1,1,2953
774ecf6588ae92cb1c6edde9d1eaf392d2892811,0,Gautam Borad,2016-10-10 17:31:18+05:18,['53fb16a60aeb9557d56d76003831e9e442351244'],2,2,4,1406671,1,,,,2953
10f1282e349de976fce8f38ee529e923c2429cee,1,Velmurugan Periasamy,2016-10-12 22:36:43-04:00,['774ecf6588ae92cb1c6edde9d1eaf392d2892811'],86,345,431,1407102,5,0,0.986899563,1,2953
e0d2402468d782553745d2b781cc10de26fcb7d6,1,Velmurugan Periasamy,2016-10-12 22:40:10-04:00,['10f1282e349de976fce8f38ee529e923c2429cee'],1,24,25,1407127,1,0,0,1,2953
0a160d601c9004697a49c2f2bbcfc1d4382d1c6a,1,Colm O hEigeartaigh,2016-10-13 15:43:40+01:00,['e0d2402468d782553745d2b781cc10de26fcb7d6'],0,1173,1173,1408300,5,0.239808153,1,0.978417266,2957
1f138601aaf8da82c9ba04f39ff0131d70b33ed8,0,Colm O hEigeartaigh,2016-10-17 12:10:09+01:00,['0a160d601c9004697a49c2f2bbcfc1d4382d1c6a'],57,54,111,1408411,2,1,0,0,2957
22259e9d9a3572cf2392996f787a6b3dc8ad0672,1,Selvamohan Neethiraj,2016-10-17 23:58:20-04:00,['1f138601aaf8da82c9ba04f39ff0131d70b33ed8'],80,48,128,1408539,5,1,1,0,2957
148eb5e64bc3819ae49a2a531d85dc63386f65f0,0,Velmurugan Periasamy,2016-10-18 08:33:09-04:00,['22259e9d9a3572cf2392996f787a6b3dc8ad0672'],6,0,6,1408545,4,,,,2957
d2a0f113223603a5a4e19cf741fc3fc1c8c52170,0,Colm O hEigeartaigh,2016-10-19 15:23:02+01:00,['148eb5e64bc3819ae49a2a531d85dc63386f65f0'],378,22,400,1408945,29,0.71257485,0.383233533,0.491017964,2957
c74dc64b642d7d0762846ed76cad16db3b056fb3,0,rmani,2016-10-21 10:13:31-07:00,['d2a0f113223603a5a4e19cf741fc3fc1c8c52170'],1,89,90,1409035,2,0.419354839,1,1,2957
08a17bc5dcccd453dd652fe36b793bd0b9f99f64,0,Colm O hEigeartaigh,2016-10-24 14:18:12+01:00,['c74dc64b642d7d0762846ed76cad16db3b056fb3'],206,2,208,1409243,25,1,1,0,2957
23609f17a91c788b8016e38e13fa2906cff44e5b,0,Colm O hEigeartaigh,2016-10-24 14:47:55+01:00,['08a17bc5dcccd453dd652fe36b793bd0b9f99f64'],8,8,16,1409259,2,,,,2957
d4fd0277a125d9b5c657dd77cff20a58d91dae04,1,Colm O hEigeartaigh,2016-10-25 14:07:19+01:00,['23609f17a91c788b8016e38e13fa2906cff44e5b'],0,826,826,1410085,6,0.132701422,0.90521327,0.862559242,2961
a46ced507d7b47efafcf5bb810b34ef5bbbf0357,1,Velmurugan Periasamy,2016-10-26 09:57:38-04:00,['d4fd0277a125d9b5c657dd77cff20a58d91dae04'],8,52,60,1410145,4,0,0.466666667,1,2961
9ad5348947073523b59c92819dcd92510e6df249,0,Bosco,2016-10-26 20:25:47-07:00,['a46ced507d7b47efafcf5bb810b34ef5bbbf0357'],3,3,6,1410151,1,,,,2961
0999ff6216d531fe1aeac15d4f74c121779b32c9,0,Colm O hEigeartaigh,2016-10-27 14:36:51+01:00,['9ad5348947073523b59c92819dcd92510e6df249'],3,3,6,1410157,2,,,,2961
08a94c741bdfd60c124f824143f476b25bc96167,0,Velmurugan Periasamy,2016-10-27 23:35:29-04:00,['0999ff6216d531fe1aeac15d4f74c121779b32c9'],8,0,8,1410165,1,,,,2961
01326be73368a0700dce2c13e1850d620112780c,1,Madhan Neethiraj,2016-11-01 21:34:40-07:00,['08a94c741bdfd60c124f824143f476b25bc96167'],33,183,216,1410381,12,0.771929825,0.771929825,1,2961
59ba1acf106622a9fad271a7c2197d64a75d4487,1,Colm O hEigeartaigh,2016-11-02 10:10:12+00:00,['01326be73368a0700dce2c13e1850d620112780c'],2,2,4,1410385,1,,,,2961
efbed804f503416cb6a6d051d6283f60758859f9,0,Colm O hEigeartaigh,2016-11-02 10:13:08+00:00,['59ba1acf106622a9fad271a7c2197d64a75d4487'],13,13,26,1410411,1,,,,2961
91f270cfd86e2dcc53f29979bd55cad97b87e45a,1,Madhan Neethiraj,2016-11-02 10:24:59-07:00,['efbed804f503416cb6a6d051d6283f60758859f9'],5,219,224,1410635,6,0.404255319,0.14893617,0.893617021,2962
8b3f0e60eb9d48ee0a89546b009ee84e7013759e,1,Madhan Neethiraj,2016-11-03 02:18:58-07:00,['91f270cfd86e2dcc53f29979bd55cad97b87e45a'],598,2065,2663,1413298,28,0.40625,0.40625,0,2970
3d6476bfb8b391e437a5ba812b0c0a597462fee6,1,Madhan Neethiraj,2016-11-03 09:56:18-07:00,['8b3f0e60eb9d48ee0a89546b009ee84e7013759e'],1,2,3,1413301,2,,,,2970
3bbc3702df19ab23e9efab5ca1730e1827a35589,0,Madhan Neethiraj,2016-11-03 17:11:28-07:00,['3d6476bfb8b391e437a5ba812b0c0a597462fee6'],122,1646,1768,1415069,39,0.49867374,0.668435013,0.859416446,2980
d6d71f8affdae7e3894c220604414ce53140885d,0,Madhan Neethiraj,2016-11-03 17:13:03-07:00,['3bbc3702df19ab23e9efab5ca1730e1827a35589'],74,0,74,1415143,1,,,,2980
92d20fe1dd7ef08b3173a506b85f79009913cae9,1,Madhan Neethiraj,2016-11-03 17:14:22-07:00,['d6d71f8affdae7e3894c220604414ce53140885d'],1646,122,1768,1416911,39,0.50132626,0.331564987,0.140583554,2980
85f27292053d2a08c16b61ac40b4088d55da5d85,0,Don Bosco Durai,2016-11-03 19:56:19-07:00,['92d20fe1dd7ef08b3173a506b85f79009913cae9'],0,12,12,1416923,1,0,0,0,2980
aa474e74db3354d78b845e2090300ab0f8780ce8,0,Gautam Borad,2016-11-04 18:52:17+05:18,['85f27292053d2a08c16b61ac40b4088d55da5d85'],0,7,7,1416930,1,0.5,0.5,1,2980
804753ed2cfb15d87d1c46b2d180e03001547f74,0,Madhan Neethiraj,2016-11-04 11:36:56-07:00,['aa474e74db3354d78b845e2090300ab0f8780ce8'],2,2,4,1416934,1,,,,2980
f4a20e0b9e259a436cb27cb48988076eee4f443a,1,Madhan Neethiraj,2016-11-04 20:49:19-07:00,['804753ed2cfb15d87d1c46b2d180e03001547f74'],125,1771,1896,1418830,41,0.535108959,0.671912833,0.869249395,2990
ad0fe4b8976aa3fcee85d722bf8fa7bb32d16245,1,Madhan Neethiraj,2016-11-06 13:57:16-08:00,['f4a20e0b9e259a436cb27cb48988076eee4f443a'],79,243,322,1419152,13,0.455445545,0.455445545,0.930693069,2990
5fe203f59330f66cd14fa916b9c1a6ebdb9b854d,1,Madhan Neethiraj,2016-11-06 21:05:45-08:00,['ad0fe4b8976aa3fcee85d722bf8fa7bb32d16245'],17,15,32,1419184,2,1,1,0,2990
3c395a53e3d9dc7a21be08765f4293ed9fdb5133,1,Gautam Borad,2016-11-07 16:15:52+05:18,['5fe203f59330f66cd14fa916b9c1a6ebdb9b854d'],14,144,158,1419342,5,,,,2993
ebc63ac3ff26f36e577e333f022459bc44c142a0,1,Madhan Neethiraj,2016-11-07 18:59:55-08:00,['3c395a53e3d9dc7a21be08765f4293ed9fdb5133'],18,20,38,1419380,3,1,1,0,2993
4fbab55157102e0eacb8889d23b9a071f9128533,0,Velmurugan Periasamy,2016-11-08 23:56:50-05:00,['ebc63ac3ff26f36e577e333f022459bc44c142a0'],4,5,9,1419389,2,,,,2993
f70fdbf7947509c0975bd3c61b96b63f9b5daaa4,1,Madhan Neethiraj,2016-11-09 21:41:04-08:00,['4fbab55157102e0eacb8889d23b9a071f9128533'],27,70,97,1419486,1,0,0,0,2993
bf343a0dd9aaa4859035dfaa61fe0c5b005ff5b2,0,Gautam Borad,2016-11-11 11:54:40+05:18,['f70fdbf7947509c0975bd3c61b96b63f9b5daaa4'],66,230,296,1419782,2,0.40397351,0.933774834,0.066225166,2993
d61ef2a0438fd69a9595ddd192bf1b9a01c121d1,1,Gautam Borad,2016-11-11 12:00:50+05:18,['bf343a0dd9aaa4859035dfaa61fe0c5b005ff5b2'],33,119,152,1419934,12,0,0,1,2993
ae8e485f88700ae1f830ac406322e5d94c750864,0,Madhan Neethiraj,2016-11-11 15:52:40-08:00,['d61ef2a0438fd69a9595ddd192bf1b9a01c121d1'],0,2,2,1419936,2,,,,2993
2ed2a009beda2e9c2aea01fa16b9404235a90d2e,1,rmani,2016-11-15 16:56:46-08:00,['ae8e485f88700ae1f830ac406322e5d94c750864'],1,1,2,1419938,1,,,,2993
b4651bc83682758a79659f6ea205b3f5b86408e7,1,Gautam Borad,2016-11-17 21:28:55+05:18,['2ed2a009beda2e9c2aea01fa16b9404235a90d2e'],230,66,296,1420234,2,0.59602649,0.066225166,0.933774834,2993
a6e0eb908e932ace080d2b9c9244be9e0727d2ee,1,Madhan Neethiraj,2016-11-21 15:22:09-08:00,['b4651bc83682758a79659f6ea205b3f5b86408e7'],11,119,130,1420364,2,0,0.369565217,1,2993
a15af08cab65ae631b1a853b6de8fa613925b1fa,1,Gautam Borad,2016-11-22 12:25:18+05:18,['a6e0eb908e932ace080d2b9c9244be9e0727d2ee'],67,256,323,1420687,2,0.354651163,0.819767442,0.180232558,2993
ccd0badd900f4358b9d1db4c8441a4fbd61c63a0,1,Madhan Neethiraj,2016-11-23 14:31:26-08:00,['a15af08cab65ae631b1a853b6de8fa613925b1fa'],4058,10,4068,1424755,10,0.721389108,0.406077348,0.005919495,2993
62160bb81c964fc829b6916f9054faefd1ddfa63,1,rmani,2016-11-23 21:53:06-08:00,['ccd0badd900f4358b9d1db4c8441a4fbd61c63a0'],3,39,42,1424797,3,,,,2993
35ff7ee79a5c18f50e62d4f78ff7a5a03598fe05,0,Gautam Borad,2016-11-24 12:34:09+05:18,['62160bb81c964fc829b6916f9054faefd1ddfa63'],1,208,209,1425006,2,0,1,1,2993
de8f444d27eebfa633ad88e14811bfc1e5d39bd7,1,Madhan Neethiraj,2016-11-26 02:49:30-08:00,['35ff7ee79a5c18f50e62d4f78ff7a5a03598fe05'],0,592,592,1425598,5,0.603508772,0.736842105,1,2997
d328d023ef69bf0c2952a461c547f2a9ff7fb722,1,Gautam Borad,2016-11-28 13:49:31+05:18,['de8f444d27eebfa633ad88e14811bfc1e5d39bd7'],26,151,177,1425775,9,0.444444444,0.936507937,0.825396825,2997
e3a4d80b0adba24aa6eea5556a1928b468aefb8b,0,Madhan Neethiraj,2016-11-29 11:01:04-08:00,['d328d023ef69bf0c2952a461c547f2a9ff7fb722'],2,89,91,1425866,4,0.571428571,0.571428571,1,2998
2465befcaf594c91e9c0124209d3137db04fe476,1,Velmurugan Periasamy,2016-11-30 23:23:50-05:00,['e3a4d80b0adba24aa6eea5556a1928b468aefb8b'],70,219,289,1426155,5,0.757894737,0.368421053,0.557894737,2998
3989b67816807c254edeaccbbd1ba0b3f454fe83,1,Madhan Neethiraj,2016-12-02 13:15:34-08:00,['2465befcaf594c91e9c0124209d3137db04fe476'],7,61,68,1426223,3,,,,2998
39b23e5a6cd6185c45853e43af72e6eb2f68f5cd,1,Madhan Neethiraj,2016-12-02 13:16:14-08:00,['3989b67816807c254edeaccbbd1ba0b3f454fe83'],2,79,81,1426304,3,0.733333333,1,1,2999
883666c6755d6f291650f17ad81ef2e0c87ad872,0,Gautam Borad,2016-12-04 09:43:44+05:18,['39b23e5a6cd6185c45853e43af72e6eb2f68f5cd'],9,9,18,1426322,1,,,,2999
10f2befe97f597ebef7cc7ad032e833633905117,1,Velmurugan Periasamy,2016-12-05 20:15:08-05:00,['883666c6755d6f291650f17ad81ef2e0c87ad872'],8,113,121,1426443,4,0.208333333,0.555555556,1,2999
d8f4b2eab64c902e9e2018c25ef11f2a88acb2b6,1,rmani,2016-12-05 23:55:22-08:00,['10f2befe97f597ebef7cc7ad032e833633905117'],3,21,24,1426467,2,0.083333333,0.083333333,0.083333333,2999
651be2b08ec009f4e7bfc6be6f760db7ab840870,0,Selvamohan Neethiraj,2016-12-09 14:17:55-05:00,['d8f4b2eab64c902e9e2018c25ef11f2a88acb2b6'],0,1,1,1426468,1,,,,2999
36da4241c2c81d6b5fe4d06b9312f1e19060f1f2,1,Gautam Borad,2016-12-12 08:45:52+05:18,['651be2b08ec009f4e7bfc6be6f760db7ab840870'],1,1,2,1426470,1,,,,2999
d3d03a10d6bf30857d50efdc6a6f8cc9fc829397,0,Gautam Borad,2016-12-12 11:56:30+05:18,['36da4241c2c81d6b5fe4d06b9312f1e19060f1f2'],2,2,4,1426474,2,,,,2999
a51da0013e82dd2e416991704a745fbe5d1ef47f,0,Colm O hEigeartaigh,2016-12-12 16:12:33+00:00,['d3d03a10d6bf30857d50efdc6a6f8cc9fc829397'],5,5,10,1426484,2,,,,2999
964253905c0b6d893748180a44d02c13aee851df,1,Colm O hEigeartaigh,2016-12-13 15:21:54+00:00,['a51da0013e82dd2e416991704a745fbe5d1ef47f'],4,4,8,1426492,1,,,,2999
fdc3148b9ddab85d489b9bb0b7bbad54b7499790,0,Colm O hEigeartaigh,2016-12-13 15:22:33+00:00,['964253905c0b6d893748180a44d02c13aee851df'],4,4,8,1426500,1,,,,2999
c0398aaca1c6b00fc82734d896a560066b73a6bc,1,rmani,2016-12-13 13:12:26-08:00,['fdc3148b9ddab85d489b9bb0b7bbad54b7499790'],7,9,16,1426516,1,0,0,0,2999
4148631896dc6576ccc7e9d6eaaeca375c7ce3b8,0,rmani,2016-12-13 15:18:59-08:00,['c0398aaca1c6b00fc82734d896a560066b73a6bc'],2,3,5,1426521,1,0,0,0,2999
b995253899ef6e204be70473e6ed94764f25107b,0,Gautam Borad,2016-12-14 14:51:07+05:18,['4148631896dc6576ccc7e9d6eaaeca375c7ce3b8'],1,1,2,1426523,1,,,,2999
ebcf9dd5e8c35a12b84405067bb7db0c5c3596c6,1,Gautam Borad,2016-12-14 14:52:38+05:18,['b995253899ef6e204be70473e6ed94764f25107b'],171,354,525,1427048,14,0.617886179,0.959349593,0.699186992,2999
83674c7d54d78821edc4a5e72e9ec8dae68fb4ea,1,Madhan Neethiraj,2016-12-14 12:39:17-08:00,['ebcf9dd5e8c35a12b84405067bb7db0c5c3596c6'],2,93,95,1427143,2,0.0625,0.0625,1,2999
a1dd7be65d9e0ac82b45aa6cb357a657ecab8c4f,0,Madhan Neethiraj,2016-12-14 12:43:29-08:00,['83674c7d54d78821edc4a5e72e9ec8dae68fb4ea'],1,20,21,1427164,1,0,1,1,2999
7901d43c21d3e392c2f88ed40c22d5c84e227fac,1,Madhan Neethiraj,2016-12-14 23:50:33-08:00,['a1dd7be65d9e0ac82b45aa6cb357a657ecab8c4f'],10,71,81,1427245,4,0.41025641,0.615384615,0.051282051,2999
72ebe7c248a8c2bbc319146885cfb7cc21d92c81,0,Colm O hEigeartaigh,2016-12-15 10:02:02+00:00,['7901d43c21d3e392c2f88ed40c22d5c84e227fac'],1,1,2,1427247,1,,,,2999
32168d60dc3e0a44c9585a67100c9da8cc7b84e0,0,Colm O hEigeartaigh,2016-12-15 10:04:36+00:00,['72ebe7c248a8c2bbc319146885cfb7cc21d92c81'],1,1,2,1427249,1,,,,2999
dac747548fccb60fe9ff632e5cf66517414385f2,1,Colm O hEigeartaigh,2016-12-15 10:04:46+00:00,['32168d60dc3e0a44c9585a67100c9da8cc7b84e0'],2,2,4,1427253,1,,,,2999
18e248a4c8a52ff61fccc1dede3dac41e2c615e0,1,Colm O hEigeartaigh,2016-12-15 11:36:36+00:00,['dac747548fccb60fe9ff632e5cf66517414385f2'],2,2,4,1427257,1,,,,2999
5e7b555cd44e48f76c4b9939a3504459b9ab9523,0,Madhan Neethiraj,2016-12-15 16:46:28-08:00,['18e248a4c8a52ff61fccc1dede3dac41e2c615e0'],3,43,46,1427303,3,0.647058824,0.647058824,0.705882353,2999
4b9497b62fdd2b7f0bd2c57b0331fe815ae928b8,1,Gautam Borad,2016-12-19 11:04:17+05:18,['5e7b555cd44e48f76c4b9939a3504459b9ab9523'],25,83,108,1427411,11,0,0,0,2999
11e869f42330a00771ab200ad9e0e176cbd7787a,0,Colm O hEigeartaigh,2016-12-19 14:29:32+00:00,['4b9497b62fdd2b7f0bd2c57b0331fe815ae928b8'],1,1,2,1427413,1,,,,2999
45f145093338a1604015ec53670de4384722c530,0,Colm O hEigeartaigh,2016-12-19 14:30:53+00:00,['11e869f42330a00771ab200ad9e0e176cbd7787a'],1,1,2,1427415,1,,,,2999
bf649f0978159cfe8021fa2aa35b4a76e9d7d93b,0,Colm O hEigeartaigh,2016-12-19 14:31:56+00:00,['45f145093338a1604015ec53670de4384722c530'],1,1,2,1427417,1,,,,2999
c51d7900c185395c8b4a18220f7aaec66197d21b,0,Colm O hEigeartaigh,2016-12-19 14:33:36+00:00,['bf649f0978159cfe8021fa2aa35b4a76e9d7d93b'],1,1,2,1427419,1,,,,2999
1ee7025fa6864089df22ccbabc4d860755623bf8,0,Colm O hEigeartaigh,2016-12-19 14:34:35+00:00,['c51d7900c185395c8b4a18220f7aaec66197d21b'],1,1,2,1427421,1,,,,2999
9a9e6e8dc8028c0179f346f05c0ed121b99d72d6,0,Colm O hEigeartaigh,2016-12-19 14:35:28+00:00,['1ee7025fa6864089df22ccbabc4d860755623bf8'],1,1,2,1427423,1,,,,2999
09b57de3b7d3e0365603f4bef8a8655463574913,0,Velmurugan Periasamy,2016-12-19 20:03:39-05:00,['9a9e6e8dc8028c0179f346f05c0ed121b99d72d6'],2,5,7,1427430,1,0,0,1,2999
ba5353df997f68ce224a26757a0cc71d5c3bbabc,0,Velmurugan Periasamy,2016-12-19 20:05:21-05:00,['09b57de3b7d3e0365603f4bef8a8655463574913'],0,6,6,1427436,1,,,,2999
7676341a08664d7726c6aa31510255e90d56aa35,0,Velmurugan Periasamy,2016-12-19 20:06:32-05:00,['ba5353df997f68ce224a26757a0cc71d5c3bbabc'],0,77,77,1427513,1,0,0,0,2999
fcb9a9bc9a48aac62b29f8b3cdf26c8326c7a9a7,1,Madhan Neethiraj,2016-12-19 21:48:49-08:00,['7676341a08664d7726c6aa31510255e90d56aa35'],27,32,59,1427572,1,,,,2999
0ef1622b997861b848c2ab9606932b4316421cbf,0,Gautam Borad,2016-12-20 11:44:10+05:18,['fcb9a9bc9a48aac62b29f8b3cdf26c8326c7a9a7'],1,3,4,1427576,1,,,,2999
510697aef5c782367d918020732b8e307f495909,1,Gautam Borad,2016-12-21 18:44:34+05:18,['0ef1622b997861b848c2ab9606932b4316421cbf'],35,68,103,1427679,8,0.454545455,0,0,2999
263bf4353e6aceceac5d2e522e90eb09392514f1,1,Gautam Borad,2016-12-21 18:48:40+05:18,['510697aef5c782367d918020732b8e307f495909'],33,92,125,1427804,4,0,1,0.15625,2999
c4b0542896714b71bdac0d5e8398354b22e133ed,0,Colm O hEigeartaigh,2016-12-21 15:02:13+00:00,['263bf4353e6aceceac5d2e522e90eb09392514f1'],16,16,32,1427836,1,1,1,0,2999
2f77beafaa0bffe1e6bfc6e6597f1fff7b569e4d,0,Colm O hEigeartaigh,2016-12-21 15:13:46+00:00,['c4b0542896714b71bdac0d5e8398354b22e133ed'],2,2,4,1427840,1,,,,2999
e1993673264810611bf46914c948c225281ec5c1,0,Colm O hEigeartaigh,2016-12-21 16:23:49+00:00,['2f77beafaa0bffe1e6bfc6e6597f1fff7b569e4d'],0,7,7,1427847,1,,,,2999
937613250e4d4793c3ab89ec82d1b28a0b57451b,0,Colm O hEigeartaigh,2016-12-22 12:31:38+00:00,['e1993673264810611bf46914c948c225281ec5c1'],1,10,11,1427858,1,0,0.25,1,2999
62689c3c80b7143309fa3de48202060926ac6025,1,Colm O hEigeartaigh,2016-12-22 12:44:22+00:00,['937613250e4d4793c3ab89ec82d1b28a0b57451b'],10,15,25,1427883,1,,,,2999
fda9a01d049cd6c4c2b8eb525514293e4b2dc785,1,Velmurugan Periasamy,2016-12-22 08:25:16-05:00,['62689c3c80b7143309fa3de48202060926ac6025'],0,1,1,1427884,1,0,0,1,2999
6ba6af021e44d929fe77ef8fb60f0fe6a1c79b7b,0,Colm O hEigeartaigh,2016-12-22 15:59:31+00:00,['fda9a01d049cd6c4c2b8eb525514293e4b2dc785'],1,1,2,1427886,1,,,,2999
57c88b548d74f775255fe94646f0b78de49b1af7,0,Colm O hEigeartaigh,2016-12-22 16:13:28+00:00,['6ba6af021e44d929fe77ef8fb60f0fe6a1c79b7b'],1,0,1,1427887,1,1,1,0,2999
4a565dfbc6661ea74abd70aed4d02e5bbe50bcf6,1,Gautam Borad,2016-12-23 16:36:05+05:18,['57c88b548d74f775255fe94646f0b78de49b1af7'],1,8,9,1427896,1,0,0,1,2999
68898eff03f33e6cf1468c72f32cb4ec2b2d4559,0,rmani,2016-12-27 11:00:43-08:00,['4a565dfbc6661ea74abd70aed4d02e5bbe50bcf6'],4,1,5,1427901,1,1,1,0,2999
1e2e04792975e30d942d208686b0483608639288,0,rmani,2016-12-27 11:51:22-08:00,['68898eff03f33e6cf1468c72f32cb4ec2b2d4559'],52,79,131,1428032,1,0,0,1,2999
ed1670212422a7186974ecd8906393195017ce2c,1,Don Bosco Durai,2016-12-27 15:30:55-08:00,['1e2e04792975e30d942d208686b0483608639288'],1,1,2,1428034,1,,,,2999
43e2f3d1358490390ed115cdf1f4cc841ad7d5a3,1,Don Bosco Durai,2016-12-27 19:25:29-08:00,['ed1670212422a7186974ecd8906393195017ce2c'],0,119,119,1428153,1,,,,3000
31701840c03d2ecd87c282dae874c55865bcf907,0,Madhan Neethiraj,2016-12-27 21:55:17-08:00,['43e2f3d1358490390ed115cdf1f4cc841ad7d5a3'],0,4,4,1428157,1,0,0,0,3000
001c91155a9439c26961277e68c355f86f49fec6,1,Velmurugan Periasamy,2016-12-28 18:07:19-05:00,['31701840c03d2ecd87c282dae874c55865bcf907'],3,14,17,1428174,3,0.111111111,0,1,3000
988b2d7aad34fd3445ab4e70ae7460e3f103d6a0,0,Velmurugan Periasamy,2016-12-28 18:09:37-05:00,['001c91155a9439c26961277e68c355f86f49fec6'],1,1,2,1428176,1,,,,3000
629e2007828db2e594379536802ba8503b179e88,0,Don Bosco Durai,2017-01-02 09:34:35-08:00,['988b2d7aad34fd3445ab4e70ae7460e3f103d6a0'],2,6,8,1428184,1,0,0,1,3000
85093b8b4f99775d0ab08428d2184a77ec3da7f8,1,Don Bosco Durai,2017-01-02 10:57:10-08:00,['629e2007828db2e594379536802ba8503b179e88'],3,8,11,1428195,1,0,0,1,3000
05e179d442192b6e64d174a6786de0a90716ba8a,1,Gautam Borad,2017-01-05 14:02:13+05:18,['85093b8b4f99775d0ab08428d2184a77ec3da7f8'],0,301,301,1428496,4,0.13368984,0.240641711,0.823529412,3002
31118afd4f0d10ad65faadfce69e0c2755cee030,1,rmani,2017-01-05 12:49:36-08:00,['05e179d442192b6e64d174a6786de0a90716ba8a'],49,86,135,1428631,1,0,0,1,3002
b8dada7b01ab136b1c98ffb872f739eba5bc2f8b,1,Gautam Borad,2017-01-06 18:50:06+05:18,['31118afd4f0d10ad65faadfce69e0c2755cee030'],10,9,19,1428650,1,,,,3002
1ff41050015b7be736268f6c84e683121cfffd7b,1,rmani,2017-01-06 17:17:52-08:00,['b8dada7b01ab136b1c98ffb872f739eba5bc2f8b'],1,3,4,1428654,1,0,0,0,3002
22029847559b3881cdc3176b15e545e847ef6d7c,1,Madhan Neethiraj,2017-01-06 18:36:52-08:00,['1ff41050015b7be736268f6c84e683121cfffd7b'],3,155,158,1428812,3,0.296296296,0.962962963,1,3002
f303c1bd419b457e7fb2190cd8c56c4d54d36d43,0,Velmurugan Periasamy,2017-01-10 16:58:29-05:00,['22029847559b3881cdc3176b15e545e847ef6d7c'],4,4,8,1428820,4,,,,3002
d77f02969c7567fc0fb57163724e18a0262134a6,1,Madhan Neethiraj,2017-01-11 12:51:49-08:00,['f303c1bd419b457e7fb2190cd8c56c4d54d36d43'],50,224,274,1429094,3,0.337078652,1,0.966292135,3002
0dc91ed3b089fdce99d63de4a3cbe71b9203f262,0,rmani,2017-01-13 14:10:49-08:00,['d77f02969c7567fc0fb57163724e18a0262134a6'],60,68,128,1429222,1,0,0,0,3002
5357e9e5eee651cf2b464b421ec5272e959f0c86,0,Colm O hEigeartaigh,2017-01-16 15:20:21+00:00,['0dc91ed3b089fdce99d63de4a3cbe71b9203f262'],17,20,37,1429259,1,0,0,1,3002
f895f2a5292a4cd46a5a8f0b69b71682bfe0c1d9,0,Colm O hEigeartaigh,2017-01-16 15:28:29+00:00,['5357e9e5eee651cf2b464b421ec5272e959f0c86'],3,3,6,1429265,1,,,,3002
3031af53e6201b0cb94bf970e46baacf3e2451a9,0,Colm O hEigeartaigh,2017-01-16 16:02:54+00:00,['f895f2a5292a4cd46a5a8f0b69b71682bfe0c1d9'],1,1,2,1429267,1,,,,3002
92200a5f1feff2bea850a750b189b6b15b96c2fa,0,Colm O hEigeartaigh,2017-01-16 16:57:06+00:00,['3031af53e6201b0cb94bf970e46baacf3e2451a9'],35,18,53,1429320,1,1,1,0,3002
37035c36725a04a1f63a776c3037000e803672ca,0,Colm O hEigeartaigh,2017-01-16 16:59:25+00:00,['92200a5f1feff2bea850a750b189b6b15b96c2fa'],23,22,45,1429365,1,1,1,0,3002
2afe8af3697257485c61426832ad290ff9dcc206,1,Colm O hEigeartaigh,2017-01-17 08:54:30+00:00,['37035c36725a04a1f63a776c3037000e803672ca'],0,4,4,1429369,1,0,0,1,3002
da7ae44a644063de12faa7676197b8aa9980a38a,0,Colm O hEigeartaigh,2017-01-17 08:54:36+00:00,['2afe8af3697257485c61426832ad290ff9dcc206'],6,0,6,1429375,1,1,1,0,3002
688f1c09b918190f427cdcee08af1069605467c8,1,Colm O hEigeartaigh,2017-01-17 09:04:50+00:00,['da7ae44a644063de12faa7676197b8aa9980a38a'],47,41,88,1429463,1,1,1,0,3002
af3b31b5319613c82b12cc7bf411a935c03b8c69,0,Colm O hEigeartaigh,2017-01-17 10:39:45+00:00,['688f1c09b918190f427cdcee08af1069605467c8'],310,310,620,1430083,1,,,,3002
8ba81a6e35bb05dae7723138743ccba8c9654048,0,Colm O hEigeartaigh,2017-01-17 12:56:35+00:00,['af3b31b5319613c82b12cc7bf411a935c03b8c69'],11,15,26,1430109,1,1,1,1,3002
a99e377d39bce90b39b9fd7f2cc1068e1856fd1c,1,Velmurugan Periasamy,2017-01-17 12:22:37-05:00,['8ba81a6e35bb05dae7723138743ccba8c9654048'],367,1413,1780,1431889,37,0.485981308,0.490654206,0.352024922,3008
7e1c021bd039d450c4bcdf1056273eee46618cf7,0,Velmurugan Periasamy,2017-01-17 12:37:00-05:00,['a99e377d39bce90b39b9fd7f2cc1068e1856fd1c'],47,34,81,1431970,4,0.133333333,0,0,3008
2fb94cc54e60e87d190f14f21f0d29f750894adf,1,Velmurugan Periasamy,2017-01-17 12:45:59-05:00,['7e1c021bd039d450c4bcdf1056273eee46618cf7'],2,882,884,1432854,9,0.250513347,0.386036961,1,3014
2aca79045ea8892c569319ed552bc4157a9e58a9,1,Velmurugan Periasamy,2017-01-17 13:20:23-05:00,['2fb94cc54e60e87d190f14f21f0d29f750894adf'],25,543,568,1433422,14,0.15339233,0.162241888,0.84660767,3014
387aaf8a96070629a9e1a3014060731fa343f207,1,Velmurugan Periasamy,2017-01-17 13:45:22-05:00,['2aca79045ea8892c569319ed552bc4157a9e58a9'],12,69,81,1433503,6,0.957446809,0.617021277,1,3014
b2774746c65f037d5bab2e04b6db24122abe9405,1,Velmurugan Periasamy,2017-01-17 14:07:15-05:00,['387aaf8a96070629a9e1a3014060731fa343f207'],3,11,14,1433517,2,0.125,0.5,0.5,3014
07f0fee7c8cd8355d5c184ae772ac2aa7dd33563,1,Colm O hEigeartaigh,2017-01-18 09:53:13+00:00,['b2774746c65f037d5bab2e04b6db24122abe9405'],48,371,419,1433936,6,0,0.863013699,1,3017
18406ea591c17c2e8c6d2e522ea8ac6fe7f6b21a,1,Colm O hEigeartaigh,2017-01-18 09:53:20+00:00,['07f0fee7c8cd8355d5c184ae772ac2aa7dd33563'],3,3,6,1433942,1,,,,3017
ae4efea6db2df48fff182284ea65cd1a98ba5b6f,1,Colm O hEigeartaigh,2017-01-18 10:15:45+00:00,['18406ea591c17c2e8c6d2e522ea8ac6fe7f6b21a'],274,274,548,1434490,1,,,,3017
814ed7ee81a6f96ce10ee726d4e02838e178412a,0,Colm O hEigeartaigh,2017-01-18 10:16:34+00:00,['ae4efea6db2df48fff182284ea65cd1a98ba5b6f'],5,6,11,1434501,1,0,0,1,3017
607c341521a87876cc5efc920f2e97c3a2695f3b,1,Velmurugan Periasamy,2017-01-18 12:54:28-05:00,['814ed7ee81a6f96ce10ee726d4e02838e178412a'],3,3,6,1434507,2,,,,3017
6905ade8edae49e88a3a13cfe3bd53badc765ae9,0,Colm O hEigeartaigh,2017-01-19 09:47:04+00:00,['607c341521a87876cc5efc920f2e97c3a2695f3b'],1,1,2,1434509,1,,,,3017
c008f391bfcd577b24388cf9fb6c2ff021a10238,1,Velmurugan Periasamy,2017-01-19 09:23:35-05:00,['6905ade8edae49e88a3a13cfe3bd53badc765ae9'],6,5,11,1434520,1,1,1,0,3017
e024d3cd36ecd66264ceaeaf35c7de0748a8d61b,1,Velmurugan Periasamy,2017-01-19 09:24:29-05:00,['c008f391bfcd577b24388cf9fb6c2ff021a10238'],15,11,26,1434546,1,0,0,0,3017
1796bc1f1d4ddd577f8ca8a515b16685c64ad955,1,Velmurugan Periasamy,2017-01-19 10:26:39-05:00,['e024d3cd36ecd66264ceaeaf35c7de0748a8d61b'],22,23,45,1434591,1,0,0,1,3017
1f855bcf94522f1c492859de92ce0ec7087e88ca,1,Velmurugan Periasamy,2017-01-19 10:26:51-05:00,['1796bc1f1d4ddd577f8ca8a515b16685c64ad955'],18,35,53,1434644,1,0,0,1,3017
6b03a286b188b98928251bce2637ba080f2f9f41,0,Colm O hEigeartaigh,2017-01-20 11:22:07+00:00,['1f855bcf94522f1c492859de92ce0ec7087e88ca'],9,19,28,1434672,3,0,1,0.666666667,3017
c19ec875742665ab96577f5a27ebac2da036d3bc,1,Velmurugan Periasamy,2017-01-20 20:25:27-05:00,['6b03a286b188b98928251bce2637ba080f2f9f41'],58,55,113,1434785,9,,,,3017
823f51fecd63c9d59690de225db224918a3d60d2,1,Velmurugan Periasamy,2017-01-20 20:25:38-05:00,['c19ec875742665ab96577f5a27ebac2da036d3bc'],66,220,286,1435071,15,0.7125,0.5625,1,3017
1a68c9586dcf74c4c0ed29035678d28a907ce94e,0,Velmurugan Periasamy,2017-01-20 20:25:54-05:00,['823f51fecd63c9d59690de225db224918a3d60d2'],3,5,8,1435079,1,1,1,1,3017
51c340ec1d2cd7b0995215c89c5de1939e0ebe13,1,rmani,2017-01-20 18:06:57-08:00,['1a68c9586dcf74c4c0ed29035678d28a907ce94e'],0,116,116,1435195,2,0.5,1,1,3018
fe48d911e2a6829a30cdb0ced3d0e52c6865ac0c,0,Velmurugan Periasamy,2017-01-23 11:02:37-05:00,['51c340ec1d2cd7b0995215c89c5de1939e0ebe13'],1,0,1,1435196,1,1,0,0,3018
11aa58b634606908c217a23159c8a6d8c7733328,1,Velmurugan Periasamy,2017-01-23 11:05:52-05:00,['fe48d911e2a6829a30cdb0ced3d0e52c6865ac0c'],100,232,332,1435528,9,0,0,0.1,3018
eaef96be8f4ac96522cd25173146e3f3fbfa3b37,0,Madhan Neethiraj,2017-01-23 11:28:47-08:00,['11aa58b634606908c217a23159c8a6d8c7733328'],56,239,295,1435823,3,0.086956522,1,1,3018
2a3e15e4cfe7ec67d70a2b45e2598bd889bf6ff6,0,Madhan Neethiraj,2017-01-24 11:27:31-08:00,['eaef96be8f4ac96522cd25173146e3f3fbfa3b37'],0,2,2,1435825,1,1,1,1,3018
7a1c72262684a862f8df4ba908c5a2a918cb1f53,0,Madhan Neethiraj,2017-01-24 11:32:11-08:00,['2a3e15e4cfe7ec67d70a2b45e2598bd889bf6ff6'],1,1,2,1435827,1,,,,3018
2261a9dca231b4b3009fc96e362ac64f9f09ece3,1,Velmurugan Periasamy,2017-01-25 01:36:35-05:00,['7a1c72262684a862f8df4ba908c5a2a918cb1f53'],131,2259,2390,1438217,14,0.242222222,0.45037037,1,3023
bb322268a99b18d029030d0a7987f789b5cf8c48,1,Velmurugan Periasamy,2017-01-25 03:29:18-05:00,['2261a9dca231b4b3009fc96e362ac64f9f09ece3'],68,58,126,1438343,3,1,1,0,3023
d5fee7873a15c914dc705e10dfe5ff03dca91b81,1,Velmurugan Periasamy,2017-01-25 16:52:05-05:00,['bb322268a99b18d029030d0a7987f789b5cf8c48'],1,5,6,1438349,1,0,0,1,3023
8ae952943926a00b2ce2a33690d553dc47472235,1,Velmurugan Periasamy,2017-01-25 16:52:05-05:00,['d5fee7873a15c914dc705e10dfe5ff03dca91b81'],101,431,532,1438881,7,0.228310502,0.242009132,0.863013699,3024
1eb8938debd01c5c7aa5faf6c32179a0f2cddea5,1,Velmurugan Periasamy,2017-01-25 16:52:05-05:00,['8ae952943926a00b2ce2a33690d553dc47472235'],71,56,127,1439008,3,1,1,0.5,3024
28d2ed14d71185103168d407c5c2efb944fb44f0,1,Selvamohan Neethiraj,2017-01-25 17:19:55-05:00,['1eb8938debd01c5c7aa5faf6c32179a0f2cddea5'],72,55,127,1439135,10,,,,3024
de68fbdcee485dacbfa9a7f6841388cc475502d1,0,rmani,2017-01-25 14:34:18-08:00,['28d2ed14d71185103168d407c5c2efb944fb44f0'],0,1,1,1439136,1,,,,3024
05248d513f43a164820339b87b82481e871abf56,0,rmani,2017-01-25 14:35:25-08:00,['de68fbdcee485dacbfa9a7f6841388cc475502d1'],1,1,2,1439138,1,,,,3024
8719e58011e984cc0f421af722723e0a9d986b2e,0,Selvamohan Neethiraj,2017-01-26 13:34:03-05:00,['28d2ed14d71185103168d407c5c2efb944fb44f0'],7,0,7,1439145,1,,,,3024
82682d78296f0c9e83491de37ff64f4370c9bf55,0,Selvamohan Neethiraj,2017-01-26 13:34:25-05:00,"['8719e58011e984cc0f421af722723e0a9d986b2e', '05248d513f43a164820339b87b82481e871abf56']",1,2,3,1439148,2,,,,3024
fb13db8095329f6b0aa9654d8f59e11025e40ba8,1,Velmurugan Periasamy,2017-01-27 17:35:15-05:00,['82682d78296f0c9e83491de37ff64f4370c9bf55'],0,11,11,1439159,4,0,0,1,3024
8f9fec37b0cf2c57b01a965453ef3976791b5a96,1,Velmurugan Periasamy,2017-01-27 17:35:15-05:00,['fb13db8095329f6b0aa9654d8f59e11025e40ba8'],470,476,946,1440105,4,,,,3024
16f481ba888077acb4daf5705896a8318aa6a24e,1,Madhan Neethiraj,2017-01-27 18:17:37-08:00,['8f9fec37b0cf2c57b01a965453ef3976791b5a96'],323,581,904,1441009,20,0.107142857,0,0.18877551,3025
10d8f6a649f52230c85a7c3e2f3b53623892f814,0,Don Bosco Durai,2017-01-30 01:13:11-08:00,['16f481ba888077acb4daf5705896a8318aa6a24e'],16,2,18,1441027,2,,,,3025
337eaac075594328cf8c95d0dbb775489c24027e,0,sneethiraj,2017-01-30 11:00:32-05:00,['10d8f6a649f52230c85a7c3e2f3b53623892f814'],0,3,3,1441030,1,,,,3025
8f19bc5dddf4ad310c584dc2eebed614bb3e32bc,0,Velmurugan Periasamy,2017-01-31 00:03:39-05:00,['337eaac075594328cf8c95d0dbb775489c24027e'],4,5,9,1441039,2,,,,3025
e64af0f51670b831dbb5d97f231df05269fff7a4,0,Madhan Neethiraj,2017-01-30 21:47:14-08:00,['8f19bc5dddf4ad310c584dc2eebed614bb3e32bc'],4,2,6,1441045,1,0,0,0,3025
ed6488361660aecbba1d006f26218e5193995f8f,1,rmani,2017-02-01 10:45:23-08:00,['e64af0f51670b831dbb5d97f231df05269fff7a4'],1,8,9,1441054,1,0,0,1,3025
7fe9290b174121025960535ebccb2b0d91e1855e,1,Velmurugan Periasamy,2017-02-01 15:30:03-05:00,['ed6488361660aecbba1d006f26218e5193995f8f'],137,152,289,1441343,3,0.352941176,0.411764706,0,3025
e3b0ce2d9760f9f85cddaea6adb1db4fb2abdaeb,1,Velmurugan Periasamy,2017-02-01 15:44:18-05:00,['7fe9290b174121025960535ebccb2b0d91e1855e'],619,247,866,1442209,19,0.793103448,0.517241379,0.068965517,3025
4d9eca77698db58097b5266f71535a854d1b9bda,1,Velmurugan Periasamy,2017-02-01 15:52:33-05:00,['e3b0ce2d9760f9f85cddaea6adb1db4fb2abdaeb'],4,3,7,1442216,3,,,,3025
4603dfa3de3921d1b6c6e1be10dfb82720896de6,1,rmani,2017-02-01 19:19:40-08:00,['4d9eca77698db58097b5266f71535a854d1b9bda'],57,47,104,1442320,3,0,0,1,3025
306075df553e295041ef5b6e5b01a8a6799c9654,1,Velmurugan Periasamy,2017-02-02 23:29:53-05:00,['4603dfa3de3921d1b6c6e1be10dfb82720896de6'],12,464,476,1442796,5,0.017985612,0.374100719,0.758992806,3028
9fea06dbb70adc2a0c33d5ab3b019064f571a141,1,Velmurugan Periasamy,2017-02-02 23:30:21-05:00,['306075df553e295041ef5b6e5b01a8a6799c9654'],7,29,36,1442832,2,0,0.944444444,1,3028
987a8c0366c1c6a881a461127b8ac1bdf6d68724,1,Velmurugan Periasamy,2017-02-03 00:09:05-05:00,['9fea06dbb70adc2a0c33d5ab3b019064f571a141'],3,4,7,1442839,1,0,0,1,3028
5c2eee8ab4f64ea5d99c957f50827f3c186a82a1,1,Colm O hEigeartaigh,2017-02-03 11:30:33+00:00,['987a8c0366c1c6a881a461127b8ac1bdf6d68724'],13,3,16,1442855,1,,,,3028
223a14974c4614ecf0d0d537c62b5b1319d8d7b7,1,Velmurugan Periasamy,2017-02-04 11:00:52-05:00,['5c2eee8ab4f64ea5d99c957f50827f3c186a82a1'],13,18,31,1442886,2,0,1,1,3028
d55fad42315022931e210176fb339650181339be,0,rmani,2017-02-05 21:32:34-08:00,['223a14974c4614ecf0d0d537c62b5b1319d8d7b7'],10,12,22,1442908,1,0,0,1,3028
49af166e2a9427480c62d97d85810fc9119d4d7e,0,Colm O hEigeartaigh,2017-02-06 09:37:33+00:00,['d55fad42315022931e210176fb339650181339be'],3,7,10,1442918,1,0,0,1,3028
6c9a84244ffbca2645d2ad190862d8287a01233b,0,Colm O hEigeartaigh,2017-02-06 09:50:03+00:00,['49af166e2a9427480c62d97d85810fc9119d4d7e'],6,6,12,1442930,1,,,,3028
c4e078ecb44583303cead25fe85df78ecda6b545,1,Colm O hEigeartaigh,2017-02-06 09:57:11+00:00,['6c9a84244ffbca2645d2ad190862d8287a01233b'],98,77,175,1443105,82,,,,3028
65bc6a51b8ba4c319515281e3b557f7f0b608a31,0,Colm O hEigeartaigh,2017-02-06 10:04:36+00:00,['c4e078ecb44583303cead25fe85df78ecda6b545'],2,2,4,1443109,2,,,,3028
90619aa108f4bca13f0679a66e3d6aff45ea9215,0,Colm O hEigeartaigh,2017-02-06 14:44:27+00:00,['65bc6a51b8ba4c319515281e3b557f7f0b608a31'],2,2,4,1443113,2,,,,3028
70fc18099bd54c290aa832e3708c72f5307d7d55,0,Colm O hEigeartaigh,2017-02-07 09:45:15+00:00,['90619aa108f4bca13f0679a66e3d6aff45ea9215'],2,2,4,1443117,1,,,,3028
4dc8cc0b763779ee6a0f589285e7dd9d95391038,1,Colm O hEigeartaigh,2017-02-07 09:53:24+00:00,['70fc18099bd54c290aa832e3708c72f5307d7d55'],0,5,5,1443122,1,0,0,1,3028
701a368ada9d3fa0ea446fc6c238a1bfcf0ea1f9,0,Colm O hEigeartaigh,2017-02-07 09:53:46+00:00,['4dc8cc0b763779ee6a0f589285e7dd9d95391038'],2,2,4,1443126,1,,,,3028
653d86c48623abc6fb29ae8b3a759039a7f07afc,1,Colm O hEigeartaigh,2017-02-07 10:08:33+00:00,['701a368ada9d3fa0ea446fc6c238a1bfcf0ea1f9'],240,145,385,1443511,29,0,0,0,3028
d6d5c2c3127f1d47a99637a95d34edb7559ee160,0,Colm O hEigeartaigh,2017-02-07 12:58:47+00:00,['653d86c48623abc6fb29ae8b3a759039a7f07afc'],9,7,16,1443527,4,1,0,0,3028
2135a00370e47d1b46b60d4c39dee82cb1c7fad7,1,Velmurugan Periasamy,2017-02-07 20:54:58-05:00,['d6d5c2c3127f1d47a99637a95d34edb7559ee160'],1,1,2,1443529,1,,,,3028
8a398878a195b2bf2f260bd4019f544b0d6c30eb,1,Velmurugan Periasamy,2017-02-07 20:59:11-05:00,['2135a00370e47d1b46b60d4c39dee82cb1c7fad7'],13,45,58,1443587,4,0.710526316,0.710526316,0.710526316,3028
82189ab24fd6957b5e877a30ddefbfd5c9c1d0b1,1,Colm O hEigeartaigh,2017-02-08 09:44:41+00:00,['8a398878a195b2bf2f260bd4019f544b0d6c30eb'],4,13,17,1443604,2,0,0,1,3028
65f4de2bd69765f63ad95b82a742b2dbb769b273,0,Colm O hEigeartaigh,2017-02-08 10:13:30+00:00,['82189ab24fd6957b5e877a30ddefbfd5c9c1d0b1'],10,17,27,1443631,2,,,,3028
1ffe400869788cb83e9f418f303c964dfabf3a55,0,Colm O hEigeartaigh,2017-02-08 12:21:40+00:00,['65f4de2bd69765f63ad95b82a742b2dbb769b273'],1,1,2,1443633,1,,,,3028
1bcb9ebe55746ae69bd1d099af678a8f24c0c2f2,0,Colm O hEigeartaigh,2017-02-09 11:38:54+00:00,['1ffe400869788cb83e9f418f303c964dfabf3a55'],1,2,3,1443636,1,0,0,1,3028
84b28e9a7137db73a029fd9164d5dffb32cb5d3b,0,Colm O hEigeartaigh,2017-02-09 12:24:19+00:00,['1bcb9ebe55746ae69bd1d099af678a8f24c0c2f2'],2,2,4,1443640,2,0,0,1,3028
d7f73fe4243856c60f1260e72c2e1aec1f96f07a,0,Colm O hEigeartaigh,2017-02-09 13:01:18+00:00,['84b28e9a7137db73a029fd9164d5dffb32cb5d3b'],2,12,14,1443654,2,,,,3028
c929fcdbde4184ba81dcb0e16d5b0a9c931a846e,0,Colm O hEigeartaigh,2017-02-09 15:51:51+00:00,['d7f73fe4243856c60f1260e72c2e1aec1f96f07a'],47,47,94,1443748,47,,,,3028
4a1e4928ac4cdb2c7494d0700efe0e8fbd2980dc,0,rmani,2017-02-09 10:41:58-08:00,['c929fcdbde4184ba81dcb0e16d5b0a9c931a846e'],20,29,49,1443797,3,0,0.25,1,3028
254ebf1569de4ef4792033d21c321e93592ebd14,1,rmani,2017-02-09 22:28:06-08:00,['4a1e4928ac4cdb2c7494d0700efe0e8fbd2980dc'],5,4,9,1443806,1,,,,3028
0981a4628849d4b8f8d5624a10ec74cf013dc188,0,rmani,2017-02-09 22:29:35-08:00,['254ebf1569de4ef4792033d21c321e93592ebd14'],1,1,2,1443808,1,,,,3028
eb101791586fe974fa41671cd0bb004578368d09,0,Colm O hEigeartaigh,2017-02-10 09:52:09+00:00,['0981a4628849d4b8f8d5624a10ec74cf013dc188'],1,1,2,1443810,1,,,,3028
5c5b47b6cbbeba92523d4c393519e8ffd688f0e9,0,Colm O hEigeartaigh,2017-02-10 10:00:56+00:00,['eb101791586fe974fa41671cd0bb004578368d09'],0,7,7,1443817,1,,,,3028
9558aa3a2d629f8955b7491f306590c437c1fda8,0,Colm O hEigeartaigh,2017-02-10 10:06:34+00:00,['5c5b47b6cbbeba92523d4c393519e8ffd688f0e9'],1,2,3,1443820,1,0,0,1,3028
7802c83cb8eb0c76a5e57bea1d7a2aa213483385,0,Colm O hEigeartaigh,2017-02-10 10:40:26+00:00,['9558aa3a2d629f8955b7491f306590c437c1fda8'],0,1,1,1443821,1,,,,3028
525098460de96ce66877929b5cd0039d3fdc7862,0,Colm O hEigeartaigh,2017-02-10 10:44:42+00:00,['7802c83cb8eb0c76a5e57bea1d7a2aa213483385'],20,34,54,1443875,8,1,1,1,3028
691c01f53aacd2ae7da0d51d2c983be739620e96,1,Colm O hEigeartaigh,2017-02-10 14:15:35+00:00,['525098460de96ce66877929b5cd0039d3fdc7862'],627,560,1187,1445062,94,,,,3028
543b591d58910b12516344c7a4a667dfb4942742,1,rmani,2017-02-10 14:58:57-08:00,['691c01f53aacd2ae7da0d51d2c983be739620e96'],9,1075,1084,1446146,4,0.272237197,0.41509434,0.960916442,3030
fbc7f19db32200bc35211cbe6c309e8a3e53fed0,1,Velmurugan Periasamy,2017-02-10 18:02:40-05:00,['543b591d58910b12516344c7a4a667dfb4942742'],6,6,12,1446158,1,0,0,1,3030
e4122919c46bd9fec38a76b27c7e0f5fb98a5f5b,1,Velmurugan Periasamy,2017-02-10 18:41:09-05:00,['fbc7f19db32200bc35211cbe6c309e8a3e53fed0'],36,44,80,1446238,3,0,0,1,3030
239cc55e11b5fc46761d6cde49a5c908938fb111,1,rmani,2017-02-10 15:45:27-08:00,['e4122919c46bd9fec38a76b27c7e0f5fb98a5f5b'],3,23,26,1446264,1,0,1,1,3030
74905128f0ed9c7dd16c4f9bf353b624a343fc46,0,Velmurugan Periasamy,2017-02-12 22:14:30-05:00,['239cc55e11b5fc46761d6cde49a5c908938fb111'],6,7,13,1446277,1,,,,3030
ed152bc6d105d2c4d6e9967e7cc91a9035ffebe1,1,Colm O hEigeartaigh,2017-02-13 12:09:26+00:00,['74905128f0ed9c7dd16c4f9bf353b624a343fc46'],267,121,388,1446665,38,0.568965517,0.293103448,0,3030
4e414fd89682e08a20ce83698c830be453bd8483,1,Colm O hEigeartaigh,2017-02-13 12:10:25+00:00,['ed152bc6d105d2c4d6e9967e7cc91a9035ffebe1'],4,4,8,1446673,2,,,,3030
bc61f4bac1282c6f93157a5a97bc5577ebec4024,1,Colm O hEigeartaigh,2017-02-13 12:29:57+00:00,['4e414fd89682e08a20ce83698c830be453bd8483'],3,3,6,1446679,1,,,,3030
63b211ec25f9730ec1523fa4a2282cf05394cbf6,0,Abhay Kulkarni,2017-02-13 07:28:13-08:00,['bc61f4bac1282c6f93157a5a97bc5577ebec4024'],0,13,13,1446692,1,,,,3030
e5ee51dd0b3ebed7fe00570c99e2805d1c92eb0a,0,Abhay Kulkarni,2017-02-13 07:35:21-08:00,['63b211ec25f9730ec1523fa4a2282cf05394cbf6'],4,0,4,1446696,1,,,,3030
24b411016e879349d557be999cec703c92b601bc,0,sneethiraj,2017-02-13 16:09:12-05:00,['e5ee51dd0b3ebed7fe00570c99e2805d1c92eb0a'],0,5,5,1446701,1,,,,3030
b012a480a397e9e9360a6649ea1183c509824232,0,Sailaja Polavarapu,2017-02-13 13:53:14-08:00,['24b411016e879349d557be999cec703c92b601bc'],4,13,17,1446718,1,,,,3030
bb680265bdbe58b8e1da50d2bcacb77676e15a51,0,Ankita Sinha,2017-02-14 09:15:31+05:18,['b012a480a397e9e9360a6649ea1183c509824232'],4,12,16,1446734,1,,,,3030
3802c841a0fb40f59689523c077269cf4638b3a9,0,Colm O hEigeartaigh,2017-02-14 10:32:47+00:00,['bb680265bdbe58b8e1da50d2bcacb77676e15a51'],5,10,15,1446749,3,,,,3030
2d406044fafb574400bc66d06ee679f6dda5ed23,0,Ankita Sinha,2017-02-14 17:01:42+05:18,['3802c841a0fb40f59689523c077269cf4638b3a9'],46,30,76,1446825,4,0,0,0,3030
63050d27abed5daaca4ae86043264e4a0e779441,0,rmani,2017-02-14 16:44:17-08:00,['2d406044fafb574400bc66d06ee679f6dda5ed23'],29,34,63,1446888,1,0,0.6,1,3030
f8ffd36de7d6327fa24f5a119fd5f1bf924032d7,0,pradeep,2017-02-15 14:03:08+05:18,['63050d27abed5daaca4ae86043264e4a0e779441'],4,12,16,1446904,1,,,,3030
74ec5f38adba600cc79b34880d725e8b0430b31b,1,pradeep,2017-02-16 18:35:08+05:18,['f8ffd36de7d6327fa24f5a119fd5f1bf924032d7'],37,549,586,1447490,16,0,0,1,3030
3d3ea6f6c7759f47a794d25ef5cde3b9eb8d20d2,0,Colm O hEigeartaigh,2017-02-17 10:52:58+00:00,['74ec5f38adba600cc79b34880d725e8b0430b31b'],1,1,2,1447492,1,,,,3030
4734abe7d81caf6bf2fb6287d1e5e00c50c600f2,0,Colm O hEigeartaigh,2017-02-17 11:06:26+00:00,['3d3ea6f6c7759f47a794d25ef5cde3b9eb8d20d2'],4,3,7,1447499,2,,,,3030
983f1bee1121dfe7b3e109761f90c6be351644eb,0,Colm O hEigeartaigh,2017-02-17 11:07:32+00:00,['4734abe7d81caf6bf2fb6287d1e5e00c50c600f2'],19,52,71,1447570,3,,,,3030
7c443ded808e46761dc61c7b9f7fb03f58b8e7b1,0,Abhay Kulkarni,2017-02-17 10:24:37-08:00,['983f1bee1121dfe7b3e109761f90c6be351644eb'],21,23,44,1447614,1,,,,3030
75ed6057b6ebfed8e3736f32c4318d23affd3d3b,0,Sailaja Polavarapu,2017-02-17 17:40:10-08:00,['7c443ded808e46761dc61c7b9f7fb03f58b8e7b1'],2,0,2,1447616,1,1,0,0,3030
f143f8173e3562a71433d6562391eef7e0afa73c,0,Selvamohan Neethiraj,2017-02-19 17:13:52-05:00,['75ed6057b6ebfed8e3736f32c4318d23affd3d3b'],12,8,20,1447636,1,,,,3030
b9b4b80895fa181ee206254332de5dbccb96cf2d,0,Selvamohan Neethiraj,2017-02-20 01:00:40-05:00,['f143f8173e3562a71433d6562391eef7e0afa73c'],0,1,1,1447637,1,0,0,0,3030
c07e8600ae353a156e83d89ebdd1590353bdc47f,1,Selvamohan Neethiraj,2017-02-20 01:00:56-05:00,['b9b4b80895fa181ee206254332de5dbccb96cf2d'],1,14,15,1447652,1,0,0,1,3030
1df13a47ce8b2df5751bfd4fc7490abb5385c344,1,Gautam Borad,2017-02-20 15:18:34+05:18,['c07e8600ae353a156e83d89ebdd1590353bdc47f'],126,148,274,1447926,15,0,0,1,3030
73fbf32721067861ca2b4118efc3935e83b79c37,1,Selvamohan Neethiraj,2017-02-20 11:26:44-05:00,['1df13a47ce8b2df5751bfd4fc7490abb5385c344'],1,1,2,1447928,1,,,,3030
3f6da35ffb0231da0d94d5f58b8a0159dbb1163a,1,Selvamohan Neethiraj,2017-02-20 11:43:54-05:00,['73fbf32721067861ca2b4118efc3935e83b79c37'],2,2,4,1447932,1,,,,3030
52ecc0073267d4388968abfe892c163a3537ddd7,0,Colm O hEigeartaigh,2017-02-21 09:05:27+00:00,['3f6da35ffb0231da0d94d5f58b8a0159dbb1163a'],1,1,2,1447934,1,,,,3030
72f8f093dc5d67ca8d7bf408953f7422de422b48,0,Colm O hEigeartaigh,2017-02-21 09:12:33+00:00,['52ecc0073267d4388968abfe892c163a3537ddd7'],81,0,81,1448015,9,,,,3030
390b97a5a05f58fac969a6950474652be8577bd0,1,Colm O hEigeartaigh,2017-02-21 09:14:50+00:00,['72f8f093dc5d67ca8d7bf408953f7422de422b48'],0,81,81,1448096,9,,,,3030
9aa7262d3fcfb8425823a996eb32cc6fbc062ab5,1,Abhay Kulkarni,2017-02-23 14:25:04-08:00,['390b97a5a05f58fac969a6950474652be8577bd0'],33,990,1023,1449119,11,0.178181818,0.250909091,0.727272727,3033
1409c1889747e1e04d47af00a90ce8676e9793bc,0,Mehul Parikh,2017-02-27 10:14:31+05:18,['9aa7262d3fcfb8425823a996eb32cc6fbc062ab5'],4,12,16,1449135,1,,,,3033
1f65120758a10476e2bdbcb580bea5ba7a8a624b,0,Colm O hEigeartaigh,2017-02-27 09:46:37+00:00,['1409c1889747e1e04d47af00a90ce8676e9793bc'],4,4,8,1449143,1,,,,3033
fdb098c24ba075727dafbb0f9b91e9a026a00db2,0,Colm O hEigeartaigh,2017-02-27 09:54:59+00:00,['1f65120758a10476e2bdbcb580bea5ba7a8a624b'],81,0,81,1449224,9,,,,3033
cd4dbcbdea320f7782a9998a039919694fe544d5,1,Abhay Kulkarni,2017-02-27 12:32:27-08:00,['fdb098c24ba075727dafbb0f9b91e9a026a00db2'],6,7,13,1449237,1,,,,3033
6326d01ca0eea73b48e1f008d5557604bdd48b3d,0,rmani,2017-02-27 21:03:24-08:00,['cd4dbcbdea320f7782a9998a039919694fe544d5'],3,4,7,1449244,1,0,0,1,3033
eaba7530f3f5d3f02db20ec0f57fcc529656b3be,1,Abhay Kulkarni,2017-02-27 22:20:18-08:00,['6326d01ca0eea73b48e1f008d5557604bdd48b3d'],13,23,36,1449280,1,0,0,0.571428571,3033
674cab34f6a021fdf4cc13dbb4039b8e48838d52,1,Colm O hEigeartaigh,2017-02-28 10:58:35+00:00,['eaba7530f3f5d3f02db20ec0f57fcc529656b3be'],13,6,19,1449299,2,1,0,0,3033
8cb01118573e0778a627e67673c39ddd1b619621,0,Colm O hEigeartaigh,2017-02-28 10:58:57+00:00,['674cab34f6a021fdf4cc13dbb4039b8e48838d52'],1,1,2,1449301,1,,,,3033
59ed6628e2b30e63f037a0dbbc27b8d28f773fc4,1,Colm O hEigeartaigh,2017-02-28 11:05:24+00:00,['8cb01118573e0778a627e67673c39ddd1b619621'],64,54,118,1449419,29,1,0.363636364,0.363636364,3033
b83fcdbb4144e18e7e17bd84f5a499e81a1fe588,1,Selvamohan Neethiraj,2017-02-28 10:21:39-05:00,['59ed6628e2b30e63f037a0dbbc27b8d28f773fc4'],12,21,33,1449452,3,,,,3033
24f053e2636e45171b98e84080ca2b8c3b7cc9c7,0,pradeep,2017-02-28 22:10:06+05:18,['b83fcdbb4144e18e7e17bd84f5a499e81a1fe588'],2,3840,3842,1453294,2,,,,3034
748a84cd409b436b12c720a1c67bae62cee6aa4b,0,pradeep,2017-03-01 15:25:18+05:18,['24f053e2636e45171b98e84080ca2b8c3b7cc9c7'],5,8,13,1453307,1,0,0,1,3034
c0c1b155e5edf167b627da9b72d8d3df0ecc13c5,0,pradeep,2017-03-02 09:15:08+05:18,['748a84cd409b436b12c720a1c67bae62cee6aa4b'],9,16,25,1453332,2,0,0,0,3034
360cdd683c0c74db58f12fa0fb3f912a8b6c6a98,1,pradeep,2017-03-02 09:15:17+05:18,['c0c1b155e5edf167b627da9b72d8d3df0ecc13c5'],92,95,187,1453519,2,0,0,1,3034
6a602cadc520d47ec4342161d4db2a5240e40155,1,Colm O hEigeartaigh,2017-03-02 09:46:51+00:00,['360cdd683c0c74db58f12fa0fb3f912a8b6c6a98'],47,33,80,1453599,11,,,,3034
ec858915dc5efa8111de0804005776fb56ac4c23,1,Colm O hEigeartaigh,2017-03-02 09:56:37+00:00,['6a602cadc520d47ec4342161d4db2a5240e40155'],5,5,10,1453609,1,,,,3034
b79e1cf8feeb9269304da16ff44d98ad67e2574e,0,Colm O hEigeartaigh,2017-03-02 11:28:41+00:00,['ec858915dc5efa8111de0804005776fb56ac4c23'],1,1,2,1453611,1,,,,3034
24c83278df4b8c6558fe4373cae7443a74e23a74,1,Colm O hEigeartaigh,2017-03-03 09:10:25+00:00,['b79e1cf8feeb9269304da16ff44d98ad67e2574e'],233,920,1153,1454764,9,0.22754491,0.21756487,0.081836327,3039
b51cd90f8da84cb0b753d25fcb420405fe42972c,0,Colm O hEigeartaigh,2017-03-06 09:38:15+00:00,['24c83278df4b8c6558fe4373cae7443a74e23a74'],4,4,8,1454772,2,,,,3039
362a548efbcf3ca4ea9e60878440265f9c4aa305,0,Colm O hEigeartaigh,2017-03-06 10:06:37+00:00,['b51cd90f8da84cb0b753d25fcb420405fe42972c'],1,1,2,1454774,1,,,,3039
e2f8b6be57f76661c76737f866dbb36d0392e63a,0,Colm O hEigeartaigh,2017-03-06 10:07:10+00:00,['362a548efbcf3ca4ea9e60878440265f9c4aa305'],1,1,2,1454776,1,,,,3039
38ddea3913942ff5a64adab39d9d706fa758b9c1,0,zhangqiang2,2017-03-07 00:42:24-05:00,['e2f8b6be57f76661c76737f866dbb36d0392e63a'],0,12,12,1454788,1,,,,3039
f3473d23fc2c87ff03fc5c2c826a26155742e791,0,pradeep,2017-03-08 09:39:17+05:18,['38ddea3913942ff5a64adab39d9d706fa758b9c1'],480,156,636,1455424,1,,,,3039
759a7b3e61bf281906c6384d47a7f6de25dc791c,0,pradeep,2017-03-08 09:39:23+05:18,['f3473d23fc2c87ff03fc5c2c826a26155742e791'],0,25,25,1455449,1,0,0,0,3039
6ad60b5d3c29685b2867905cfe8386bc71c00fb7,1,Mehul Parikh,2017-03-08 09:48:47+05:18,['759a7b3e61bf281906c6384d47a7f6de25dc791c'],29,190,219,1455668,8,0.171597633,0.177514793,0.828402367,3039
6854f4d3c7624a340a26e4df194effc7d792dbf1,1,zhangqiang2,2017-03-08 01:02:41-05:00,['6ad60b5d3c29685b2867905cfe8386bc71c00fb7'],196,114,310,1455978,1,1,1,0,3039
70ca2df6337b2fb905d1996faabffec06494ff2c,0,zhangqiang2,2017-03-08 01:09:23-05:00,['6854f4d3c7624a340a26e4df194effc7d792dbf1'],1,1,2,1455980,1,,,,3039
f35c8bd546e6d82c605d9f58caa12d3f0bde9e8a,0,rmani,2017-03-07 22:32:16-08:00,['70ca2df6337b2fb905d1996faabffec06494ff2c'],0,1,1,1455981,1,1,1,1,3039
20315eabbc93d824772981d3cec82f4a4e284b7e,1,Colm O hEigeartaigh,2017-03-08 09:36:50+00:00,['f35c8bd546e6d82c605d9f58caa12d3f0bde9e8a'],76,68,144,1456125,33,,,,3039
5ea8062df77769ddb02235c7e8f3b51185143b3d,1,zhangqiang2,2017-03-08 06:34:15-05:00,['20315eabbc93d824772981d3cec82f4a4e284b7e'],486,148,634,1456759,7,1,1,0,3040
7d929b4750f200366ddfc9bf3e620dd8b87b905b,0,Sailaja Polavarapu,2017-03-08 12:02:24-08:00,['5ea8062df77769ddb02235c7e8f3b51185143b3d'],1,16,17,1456776,1,,,,3040
b2a2516d21095046ad9d1c1748e8ee38985f0e17,0,zhangqiang2,2017-03-08 20:02:29-05:00,['7d929b4750f200366ddfc9bf3e620dd8b87b905b'],7,9,16,1456792,1,0,1,1,3040
0492cd578a4c0d9e1b62a94ea6938422c0557120,0,zhangqiang2,2017-03-08 20:09:37-05:00,['b2a2516d21095046ad9d1c1748e8ee38985f0e17'],8,3,11,1456803,1,1,1,0,3040
a15a0bd8157fba6b946ea701589f401dcd914475,1,Sailaja Polavarapu,2017-03-09 12:34:51-08:00,['0492cd578a4c0d9e1b62a94ea6938422c0557120'],16,1,17,1456820,1,,,,3040
6d862ed4339a4589c4ce1be38a119cd2a49e5a5e,1,Sailaja Polavarapu,2017-03-09 16:14:44-08:00,['a15a0bd8157fba6b946ea701589f401dcd914475'],1,15,16,1456836,2,0.214285714,1,1,3040
d5e5ad5f892dea696740bd6834b3c96b213498e1,0,zhangqiang2,2017-03-09 20:01:02-05:00,['6d862ed4339a4589c4ce1be38a119cd2a49e5a5e'],5,5,10,1456846,1,,,,3040
432f9f7ac0b98fb0b1f144f56df4f7a7efcca5f2,1,zhangqiang2,2017-03-09 20:08:28-05:00,['d5e5ad5f892dea696740bd6834b3c96b213498e1'],0,2,2,1456848,1,,,,3040
a118f7100d33d39c2d0c6a99d50769492af444e9,1,zhangqiang2,2017-03-09 22:06:14-05:00,['432f9f7ac0b98fb0b1f144f56df4f7a7efcca5f2'],2,3,5,1456853,1,,,,3040
910aff0edf48b595a4e86b31d2edfda621d2f9ff,1,Ankita Sinha,2017-03-10 20:16:15+05:18,['a118f7100d33d39c2d0c6a99d50769492af444e9'],1,1,2,1456855,1,,,,3040
284ca416a60533139889a0c3f68f20ae12fdd3cc,1,pradeep,2017-03-10 22:44:04+05:18,['910aff0edf48b595a4e86b31d2edfda621d2f9ff'],505,570,1075,1457930,4,0.181818182,0.472727273,0.4,3040
8da88797371c8316ea7539051176e610cfff5125,1,Sailaja Polavarapu,2017-03-10 12:54:34-08:00,['284ca416a60533139889a0c3f68f20ae12fdd3cc'],6,68,74,1458004,5,1,1,1,3042
29eda27ef32146bd490d5005633f06bf68ee8d2a,1,zhangqiang2,2017-03-10 21:37:43-05:00,['8da88797371c8316ea7539051176e610cfff5125'],17,11,28,1458032,11,0.333333333,0,0,3042
a9fb73f420b8a3af9938f8d5f49d43ed4e1d6eb0,0,zhangqiang2,2017-03-10 21:42:32-05:00,['29eda27ef32146bd490d5005633f06bf68ee8d2a'],0,24,24,1458056,2,,,,3043
7ada8bc2cb547b589067aa4ef7e834cb41a42f30,0,zhangqiang2,2017-03-10 21:49:55-05:00,['a9fb73f420b8a3af9938f8d5f49d43ed4e1d6eb0'],3,2,5,1458061,1,1,0,0,3043
2d79a01571acd9bdfe50a3f901b6f5ad9b5d35ed,0,zhangqiang2,2017-03-10 21:54:01-05:00,['7ada8bc2cb547b589067aa4ef7e834cb41a42f30'],0,2,2,1458063,1,0,1,1,3043
4981181a9a9f261d3fb30485aec709a1bccb3292,0,Abhay Kulkarni,2017-03-11 09:13:42-08:00,['2d79a01571acd9bdfe50a3f901b6f5ad9b5d35ed'],2,2,4,1458067,2,,,,3043
58018b21b751293d803f7702920b13247b0c09ba,0,Colm O hEigeartaigh,2017-03-13 09:39:29+00:00,['4981181a9a9f261d3fb30485aec709a1bccb3292'],2,11,13,1458080,1,0,0,0,3043
a4f1be829c2eb1eb5bdaaa721ad30ffee7fe6530,1,Colm O hEigeartaigh,2017-03-13 09:40:33+00:00,['58018b21b751293d803f7702920b13247b0c09ba'],2,5,7,1458087,1,0,0,1,3043
c80d81189e5e15d912176ac8430a3b0e9e7bb0a1,0,Colm O hEigeartaigh,2017-03-13 09:41:07+00:00,['a4f1be829c2eb1eb5bdaaa721ad30ffee7fe6530'],3,7,10,1458097,1,,,,3043
e02967f38993dce2d59bc2dc58a4a3227cd89b7b,0,Colm O hEigeartaigh,2017-03-13 16:00:26+00:00,['c80d81189e5e15d912176ac8430a3b0e9e7bb0a1'],3,2,5,1458102,1,1,1,0,3043
14853bdc61d97fa8d33aa0ab806f8d8abf01bc09,0,zhangqiang2,2017-03-13 21:05:35-04:00,['e02967f38993dce2d59bc2dc58a4a3227cd89b7b'],0,8,8,1458110,1,,,,3043
0ad9539cfd5b8f8f4a0e9a4a5b30b6d198ca2ae7,1,zhangqiang2,2017-03-13 21:26:15-04:00,['14853bdc61d97fa8d33aa0ab806f8d8abf01bc09'],1,12,13,1458123,1,,,,3043
85ddb48e2c7a795969e908ebce377ab4666aecce,1,Abhay Kulkarni,2017-03-13 19:44:29-07:00,['0ad9539cfd5b8f8f4a0e9a4a5b30b6d198ca2ae7'],529,606,1135,1459258,11,1,0,1,3043
5d5a0cd7198ee3590645c193c03708de91899420,0,Mehul Parikh,2017-03-14 13:43:47+05:18,['85ddb48e2c7a795969e908ebce377ab4666aecce'],6,6,12,1459270,2,,,,3043
e6fd8e4e8e817c897f6ccbb4e666bd40c93d1aec,1,Ankita Sinha,2017-03-14 20:03:57+05:18,['5d5a0cd7198ee3590645c193c03708de91899420'],27,45,72,1459342,10,0.625,0.625,0.875,3043
786bb3a22deaab1338f56893841804fc8134da1c,0,zhangqiang2,2017-03-15 02:34:15-04:00,['e6fd8e4e8e817c897f6ccbb4e666bd40c93d1aec'],1,1,2,1459344,1,,,,3043
75f8f1d0b280df1a6d7ddbf7430333691a7da976,0,zhangqiang2,2017-03-15 03:31:56-04:00,['786bb3a22deaab1338f56893841804fc8134da1c'],5,0,5,1459349,1,,,,3043
942f630ba672452c93de684fc156754f7c0fe83f,1,Abhay Kulkarni,2017-03-15 15:56:37-07:00,['75f8f1d0b280df1a6d7ddbf7430333691a7da976'],0,3,3,1459352,1,0,0,1,3043
1ca8de3f4a322e8bc15cd948d616d015bf63625a,0,Colm O hEigeartaigh,2017-03-16 10:02:37+00:00,['942f630ba672452c93de684fc156754f7c0fe83f'],1,2,3,1459355,1,,,,3043
f310aaf6bb7b81825ce2886ba4f16c13a09c603a,0,Gautam Borad,2017-03-16 21:35:21+05:18,['1ca8de3f4a322e8bc15cd948d616d015bf63625a'],17,17,34,1459389,1,,,,3043
d534b16379bcc9b3f48a8c3bf07551ced974909f,0,Abhay Kulkarni,2017-03-16 13:12:05-07:00,['f310aaf6bb7b81825ce2886ba4f16c13a09c603a'],17,19,36,1459425,2,0,1,1,3043
2f8c7f27af7137a36eff68db1c02544916bdc37a,1,zhangqiang2,2017-03-16 21:06:11-04:00,['d534b16379bcc9b3f48a8c3bf07551ced974909f'],1,1,2,1459427,1,,,,3043
149c51662037b45472281bf166b2cb19a5d1262a,0,zhangqiang2,2017-03-16 21:12:03-04:00,['2f8c7f27af7137a36eff68db1c02544916bdc37a'],1,1,2,1459429,1,,,,3043
8166d00b12c920bb48896b69b50eceecde1b6975,0,zhangqiang2,2017-03-16 21:15:30-04:00,['149c51662037b45472281bf166b2cb19a5d1262a'],1,1,2,1459431,1,,,,3043
2d9a322102355f4f998541c2fe9866a85560b2b3,0,zhangqiang2,2017-03-16 21:19:26-04:00,['8166d00b12c920bb48896b69b50eceecde1b6975'],1,9,10,1459441,1,0,1,0,3043
73eed772414e2bf0ae796d0368af20a822916bbd,0,Colm O hEigeartaigh,2017-03-20 11:55:38+00:00,['2d9a322102355f4f998541c2fe9866a85560b2b3'],4,12,16,1459457,2,0,0,1,3043
3632b35d01451d8f6983e46fbbc78ac54d8c0ce4,0,Colm O hEigeartaigh,2017-03-20 11:57:45+00:00,['73eed772414e2bf0ae796d0368af20a822916bbd'],0,1,1,1459458,1,,,,3043
79230377fd1e27c28e330dfac0f382c1a78b710d,1,Colm O hEigeartaigh,2017-03-21 17:11:07+00:00,['3632b35d01451d8f6983e46fbbc78ac54d8c0ce4'],12,14,26,1459484,1,,,,3043
063bf890a46a5a10c84070bae85fe532ef92fd23,0,zhangqiang2,2017-03-22 08:33:46-04:00,['79230377fd1e27c28e330dfac0f382c1a78b710d'],1,1,2,1459486,1,,,,3043
683f1e3a6ced7368891ddd58183e3be46f649004,0,Abhay Kulkarni,2017-03-22 10:46:06-07:00,['063bf890a46a5a10c84070bae85fe532ef92fd23'],2,2,4,1459490,1,,,,3043
a2291f0a821e9c51f4fb5779fae1eb5a9b13f733,1,zhangqiang2,2017-03-22 20:34:32-04:00,['683f1e3a6ced7368891ddd58183e3be46f649004'],1,32,33,1459523,1,,,,3043
5d2f72376ffec2572d2114515ffa7d7f1e096a36,0,zhangqiang2,2017-03-22 21:50:16-04:00,['a2291f0a821e9c51f4fb5779fae1eb5a9b13f733'],2,9,11,1459534,1,,,,3043
acda969b845ed003fed6e40d120074a20a9ec3ac,0,Sailaja Polavarapu,2017-03-23 13:43:04-07:00,['5d2f72376ffec2572d2114515ffa7d7f1e096a36'],1,0,1,1459535,1,,,,3043
37c95f703aa0ae87bb943fc48249b4b302a2cba4,0,Velmurugan Periasamy,2017-03-25 08:31:24-04:00,['acda969b845ed003fed6e40d120074a20a9ec3ac'],2,0,2,1459537,2,1,0.5,0,3043
18abc714ba48dde9f11d930a94a1ce59c292d77f,1,zhangqiang2,2017-03-26 04:59:43-04:00,['37c95f703aa0ae87bb943fc48249b4b302a2cba4'],0,21,21,1459558,2,,,,3043
3bfdf4ee93d66e4ac8011e45f7c07f01db3126d3,0,zhangqiang2,2017-03-26 05:03:12-04:00,['18abc714ba48dde9f11d930a94a1ce59c292d77f'],1,0,1,1459559,1,,,,3043
25435ffa1a439f5db70b1c10e4bc67d19f8a7686,1,Abhay Kulkarni,2017-03-27 16:20:35-07:00,['3bfdf4ee93d66e4ac8011e45f7c07f01db3126d3'],3,275,278,1459837,5,1,1,1,3045
5cab3e2be54a2660148c31432ea0a86764020d67,0,Colm O hEigeartaigh,2017-03-29 17:25:36+01:00,['25435ffa1a439f5db70b1c10e4bc67d19f8a7686'],483,0,483,1460320,1,1,0.882352941,0.529411765,3045
546fc8718fb91c2b1587dd859ec663971f563b10,1,Colm O hEigeartaigh,2017-03-30 11:30:36+01:00,['5cab3e2be54a2660148c31432ea0a86764020d67'],11,11,22,1460342,3,,,,3045
84e90c132062baacf4de65a03bdb7372e479a4c1,0,Mehul Parikh,2017-03-31 12:10:17+05:18,['546fc8718fb91c2b1587dd859ec663971f563b10'],0,1,1,1460343,1,0.5,1,1,3045
6cfb01883fb97bd98e5e5b7baacb3cdd85a15b68,1,ankita,2017-03-31 22:37:21+05:18,['84e90c132062baacf4de65a03bdb7372e479a4c1'],202,419,621,1460964,4,0,0.14893617,0.60106383,3045
5a39409dc0f07db2fcf9175e10e46ca8e1f92f7d,0,Colm O hEigeartaigh,2017-04-03 17:31:04+01:00,['6cfb01883fb97bd98e5e5b7baacb3cdd85a15b68'],26,12,38,1461002,1,0.5,0.5,0,3045
f2ab4279e68d1fd0b4253a519bd063b4d4e0730f,0,rmani,2017-04-03 10:12:57-07:00,['5a39409dc0f07db2fcf9175e10e46ca8e1f92f7d'],0,6,6,1461008,1,0,0,1,3045
3b964a345be4838dfbfb273f1973e0b129da8ca9,1,Abhay Kulkarni,2017-04-03 14:24:05-07:00,['f2ab4279e68d1fd0b4253a519bd063b4d4e0730f'],10,94,104,1461112,2,0,0,1,3045
bdf0b61c0f6e109c2f4e0459676dda71f0265aeb,1,Gautam Borad,2017-04-04 11:31:33+05:18,['3b964a345be4838dfbfb273f1973e0b129da8ca9'],3,1,4,1461116,2,0.5,1,0,3045
cdde1b6e86fcdd92c681b66b9ac291384e41bba5,0,rmani,2017-04-04 13:33:39-07:00,['bdf0b61c0f6e109c2f4e0459676dda71f0265aeb'],10,11,21,1461137,1,0,0,0,3045
1d18e76dacc9326419855c7881ef79cf60f19a61,1,Colm O hEigeartaigh,2017-04-05 17:36:20+01:00,['cdde1b6e86fcdd92c681b66b9ac291384e41bba5'],353,342,695,1461832,52,1,1,0.363636364,3045
8cc43743df75968bf92d52523fd5d4804de98175,0,Colm O hEigeartaigh,2017-04-07 14:31:47+01:00,['1d18e76dacc9326419855c7881ef79cf60f19a61'],0,2,2,1461834,1,,,,3045
a20e7a2f9d5c4ad47030eb07968414fdcadb6c3d,0,Colm O hEigeartaigh,2017-04-07 14:32:34+01:00,['8cc43743df75968bf92d52523fd5d4804de98175'],29,7,36,1461870,3,,,,3045
f84ff8e0fd83d6787847a3c5fe16c73d73daa5a8,0,zhangqiang2,2017-04-10 20:08:31+08:00,['a20e7a2f9d5c4ad47030eb07968414fdcadb6c3d'],1,1,2,1461872,1,,,,3045
c89b555919126bb5501bfc1a80cd6813ca41c9d8,1,zhangqiang2,2017-04-10 20:16:43+08:00,['f84ff8e0fd83d6787847a3c5fe16c73d73daa5a8'],26,42,68,1461940,2,,,,3045
6e512b6ab5c7d2008ff8e1abd2ad9f1b8b12e169,0,Colm O hEigeartaigh,2017-04-11 15:15:48+01:00,['c89b555919126bb5501bfc1a80cd6813ca41c9d8'],26,79,105,1462045,1,1,1,1,3045
50668346b7c73c52b7fe87cf9175af512c5b9855,0,Sailaja Polavarapu,2017-04-12 12:17:05-07:00,['6e512b6ab5c7d2008ff8e1abd2ad9f1b8b12e169'],2,2,4,1462049,2,,,,3045
d456ac7f2e168af0f81a0005f66365a8f9215cef,0,zhangqiang2,2017-04-13 08:47:10-04:00,['6e512b6ab5c7d2008ff8e1abd2ad9f1b8b12e169'],4,12,16,1462065,1,,,,3045
bca550210ce7c863d228e5fe3445cf1ab4da85d1,1,zhangqiang2,2017-04-13 08:56:47-04:00,['d456ac7f2e168af0f81a0005f66365a8f9215cef'],25,24,49,1462114,1,,,,3045
73c2faa494c0af8e7ff4894b5fbcd1a8e49504d0,0,Sailaja Polavarapu,2017-04-13 11:33:26-07:00,"['50668346b7c73c52b7fe87cf9175af512c5b9855', 'bca550210ce7c863d228e5fe3445cf1ab4da85d1']",29,36,65,1462179,2,,,,3045
88c73dfe682c9b868c6c8c8ecc34082afb5e1e71,0,zhangqiang2,2017-04-16 05:47:11-04:00,['73c2faa494c0af8e7ff4894b5fbcd1a8e49504d0'],8,11,19,1462198,2,1,1,0,3045
50fb124e52235fd076b6bf6a68940ac9f5cb0ed5,0,zhangqiang2,2017-04-17 22:10:24-04:00,['88c73dfe682c9b868c6c8c8ecc34082afb5e1e71'],4,46,50,1462248,2,0,0,1,3045
11282a1eae4612fb0619de7a934c776ba3f54fc8,1,Colm O hEigeartaigh,2017-04-18 10:13:09+01:00,['50fb124e52235fd076b6bf6a68940ac9f5cb0ed5'],10,9,19,1462267,3,0,0,0,3045
c60de3a6a690999219f22915f542444783d40bc2,0,Colm O hEigeartaigh,2017-04-18 10:22:41+01:00,['11282a1eae4612fb0619de7a934c776ba3f54fc8'],60,0,60,1462327,4,,,,3045
a4592939b58c9459ac340f70ab4ea86a0b564388,1,Colm O hEigeartaigh,2017-04-18 10:28:53+01:00,['c60de3a6a690999219f22915f542444783d40bc2'],496,4510,5006,1467333,21,0.057416268,1,1,3049
b25026259544d2b210e40d4510a02ba1aaafde2f,0,zhangqiang2,2017-04-18 20:44:49-04:00,['a4592939b58c9459ac340f70ab4ea86a0b564388'],1,1,2,1467335,1,,,,3049
1bdc28c61b934895afde923895caf000d1b95979,1,zhangqiang2,2017-04-18 20:48:38-04:00,['b25026259544d2b210e40d4510a02ba1aaafde2f'],41,394,435,1467770,16,0.875,0.875,0.875,3062
dc31b21fcda9ca0a1f39af6b90599bf600a88290,0,zhangqiang2,2017-04-18 21:00:24-04:00,['1bdc28c61b934895afde923895caf000d1b95979'],0,8,8,1467778,1,,,,3062
8944052fc67d262be0c2677f7d0988679a683b88,1,zhangqiang2,2017-04-18 21:03:18-04:00,['dc31b21fcda9ca0a1f39af6b90599bf600a88290'],2,2,4,1467782,1,,,,3062
79a8d7c86038f4bd67d7d6078d5b17bebf7ec771,1,Colm O hEigeartaigh,2017-04-19 10:16:48+01:00,['8944052fc67d262be0c2677f7d0988679a683b88'],0,964,964,1468746,1,0.283967391,1,1,3063
3362acea8fa966eafa6a61147ed93142475bcb1e,0,Colm O hEigeartaigh,2017-04-20 10:00:21+01:00,['79a8d7c86038f4bd67d7d6078d5b17bebf7ec771'],12,1,13,1468759,2,,,,3063
acee1c4f750637e2103f1134427aacbd4f7fd378,0,Colm O hEigeartaigh,2017-04-20 10:16:46+01:00,['3362acea8fa966eafa6a61147ed93142475bcb1e'],1,1,2,1468761,1,,,,3063
a3d9b0f91d2113a1d1977e6f527d70b76c447f08,1,zhangqiang2,2017-04-20 20:32:55-04:00,['acee1c4f750637e2103f1134427aacbd4f7fd378'],18,18,36,1468797,1,,,,3063
9c1ffb10431b89bcbcceeb9d885b8768b346bfe4,0,Colm O hEigeartaigh,2017-04-21 09:00:47+01:00,['a3d9b0f91d2113a1d1977e6f527d70b76c447f08'],0,3,3,1468800,2,0,0,1,3063
9f0cfcfc06e281fc5781e09dea2bcfa9e677333c,0,zhangqiang2,2017-04-21 22:07:01-04:00,['9c1ffb10431b89bcbcceeb9d885b8768b346bfe4'],1,1,2,1468802,1,,,,3063
770f274d04f1a438b90d3cb6643d587558f6bbf7,0,zhangqiang2,2017-04-21 22:16:56-04:00,['9f0cfcfc06e281fc5781e09dea2bcfa9e677333c'],367,387,754,1469556,1,0.428571429,0.428571429,0.714285714,3063
2a3ada00603b17093678a78c4106ca91a4b5a2fd,1,Colm O hEigeartaigh,2017-04-24 10:41:48+01:00,['770f274d04f1a438b90d3cb6643d587558f6bbf7'],3,3,6,1469562,2,,,,3063
27bd3fe5c5e0c147d386f1c4441253d92f122b30,0,Sailaja Polavarapu,2017-04-24 11:37:55-07:00,['2a3ada00603b17093678a78c4106ca91a4b5a2fd'],1,5,6,1469568,2,0,0,1,3063
fd597296756c0680e136439271c05d1ff38d86c9,0,zhangqiang2,2017-04-24 20:47:59-04:00,['27bd3fe5c5e0c147d386f1c4441253d92f122b30'],5,19,24,1469592,3,,,,3063
8751791d8dae25f2dd6f2499e8f766c5763677db,0,zhangqiang2,2017-04-24 21:27:56-04:00,['fd597296756c0680e136439271c05d1ff38d86c9'],1,0,1,1469593,1,1,1,1,3063
c41f19e47d4e35520eae15b181a4d05baed5ad48,0,zhangqiang2,2017-04-24 21:30:18-04:00,['8751791d8dae25f2dd6f2499e8f766c5763677db'],3,3,6,1469599,1,,,,3063
3bc1229ffd098e28e323eeaed47040277955dccb,0,zhangqiang2,2017-04-24 21:37:47-04:00,['c41f19e47d4e35520eae15b181a4d05baed5ad48'],1,1,2,1469601,1,,,,3063
9a1d5b49bf4c22b8a7847b4637e86bdbe9de9a0c,1,Colm O hEigeartaigh,2017-04-25 10:38:59+01:00,['3bc1229ffd098e28e323eeaed47040277955dccb'],52,57,109,1469710,4,1,1,0,3063
66b258ae951611a4a2862d8f0547071d8d411146,0,Ankita Sinha,2017-04-25 22:59:24+05:18,['9a1d5b49bf4c22b8a7847b4637e86bdbe9de9a0c'],0,3,3,1469713,2,,,,3063
ac24f705fb7d1902c8f8553ed98b988ac59678ec,1,pradeep,2017-04-26 03:39:49+05:18,['66b258ae951611a4a2862d8f0547071d8d411146'],93,455,548,1470261,44,0.183544304,0.664556962,0.563291139,3068
37667d7faf87ec0000e5d236a19891046d66f1c1,0,pradeep,2017-04-26 03:40:20+05:18,['ac24f705fb7d1902c8f8553ed98b988ac59678ec'],0,139,139,1470400,5,,,,3073
a02901c6f613a9bc3d10c31869400496c254b01b,0,zhangqiang2,2017-04-25 20:44:44-04:00,['37667d7faf87ec0000e5d236a19891046d66f1c1'],1,1,2,1470402,1,,,,3073
4294802af0e9f7fc8252105084200f318d667dd6,1,Abhay Kulkarni,2017-04-26 20:01:30-07:00,['a02901c6f613a9bc3d10c31869400496c254b01b'],79,96,175,1470577,5,0.545454545,0.545454545,1,3073
faf5bf177f2f145f40f667a598929a6dbd7e81df,0,Abhay Kulkarni,2017-04-26 20:28:10-07:00,['4294802af0e9f7fc8252105084200f318d667dd6'],2,22,24,1470601,3,1,1,1,3073
c7784876173bc9eafd1c47def7f45bad3b5010ac,1,Gautam Borad,2017-04-27 22:40:03+05:18,['faf5bf177f2f145f40f667a598929a6dbd7e81df'],159,191,350,1470951,13,0.2,1,0,3073
c01d01f54622286de7ef17b302ae0a734664a9d1,1,Gautam Borad,2017-04-28 00:54:46+05:18,['c7784876173bc9eafd1c47def7f45bad3b5010ac'],0,6016,6016,1476967,2,,,,3075
f1117f5fe6cd2749b913986ea7529f99e9706caa,1,Gautam Borad,2017-04-28 01:17:39+05:18,['c01d01f54622286de7ef17b302ae0a734664a9d1'],10,21,31,1476998,4,0,0,0.5,3075
45f30336fd885a7bda5bb3700821ea237fb13b31,1,Gautam Borad,2017-04-28 01:17:48+05:18,['f1117f5fe6cd2749b913986ea7529f99e9706caa'],1,1,2,1477000,1,,,,3075
501e05f1a1225dfbcc16bf4d2c0d86e55d4a928e,1,Gautam Borad,2017-05-02 00:55:26+05:18,['45f30336fd885a7bda5bb3700821ea237fb13b31'],14,24,38,1477038,1,0.090909091,0.090909091,0.090909091,3075
21066540d388402d12413144e63a2d74becf1fd1,0,pradeep,2017-05-02 21:24:06+05:18,['501e05f1a1225dfbcc16bf4d2c0d86e55d4a928e'],1,1,2,1477040,1,,,,3075
cd9d1a49105d42eeb3a7aa65205b6f1d3018a180,1,Abhay Kulkarni,2017-05-02 12:01:10-07:00,['21066540d388402d12413144e63a2d74becf1fd1'],0,10,10,1477050,1,0,0,0,3075
e51d992a36acc1714081163f893539753cb5dddb,0,zhangqiang2,2017-05-03 04:44:56-04:00,['cd9d1a49105d42eeb3a7aa65205b6f1d3018a180'],2,2,4,1477054,1,,,,3075
c23b3743fa432fb242bd57da7693d88e1f8033bc,0,Sailaja Polavarapu,2017-05-03 13:27:34-07:00,['e51d992a36acc1714081163f893539753cb5dddb'],34,69,103,1477157,11,0,0,1,3075
93ccc5237384a378416489d68e9e7d4234d07f73,1,Gautam Borad,2017-05-04 07:15:29+05:18,['c23b3743fa432fb242bd57da7693d88e1f8033bc'],0,73,73,1477230,1,0,0.796296296,1,3075
54e0e8d027130224416a235052be9a912a2f85a9,1,Sailaja Polavarapu,2017-05-04 11:21:17-07:00,['93ccc5237384a378416489d68e9e7d4234d07f73'],4,3,7,1477237,1,,,,3075
ba122d3adc0722e62df8abe61319bea23a784a66,0,pradeep,2017-05-05 08:31:22+05:18,['54e0e8d027130224416a235052be9a912a2f85a9'],1,1,2,1477239,1,,,,3075
58116e0118909b7ef495c3721575ba866a919c3a,1,Gautam Borad,2017-05-05 23:18:15+05:18,['ba122d3adc0722e62df8abe61319bea23a784a66'],1,6,7,1477246,2,0,0,1,3075
a5ab9a34d3c8a66d3119f9bd552bd35ce68b03ed,0,Gautam Borad,2017-05-05 23:30:58+05:18,['58116e0118909b7ef495c3721575ba866a919c3a'],5,5,10,1477256,4,,,,3075
02f83498e11754dcbc478ec0946a1ecc582640fe,1,rmani,2017-05-05 11:25:43-07:00,['a5ab9a34d3c8a66d3119f9bd552bd35ce68b03ed'],27,415,442,1477698,6,0.620967742,0.620967742,0.903225806,3076
13f01c82bf50300a48de3a5d0300e29a8bf969cb,0,rmani,2017-05-05 15:27:42-07:00,['02f83498e11754dcbc478ec0946a1ecc582640fe'],53,13,66,1477764,1,,,,3076
87bc2e786cc2159aae274998c8ae52719b06b798,1,zhangqiang2,2017-05-07 21:10:35-04:00,['13f01c82bf50300a48de3a5d0300e29a8bf969cb'],4,4,8,1477772,2,,,,3076
c213c9587dd6c2c8403eab30470575a7e3bbdb07,0,rmani,2017-05-07 19:41:22-07:00,['87bc2e786cc2159aae274998c8ae52719b06b798'],7,10,17,1477789,2,1,1,1,3076
c324ece1144b90cff6e43bf9e2c40fcb07888e0a,0,Colm O hEigeartaigh,2017-05-08 20:40:46+01:00,['c213c9587dd6c2c8403eab30470575a7e3bbdb07'],24,33,57,1477846,3,,,,3076
79da7d92721bb48b6fe96444cfb2c801a524a8a7,0,Colm O hEigeartaigh,2017-05-09 14:20:30+01:00,['c324ece1144b90cff6e43bf9e2c40fcb07888e0a'],1,6,7,1477853,1,0,0,1,3076
7019d3c6b5d5abeaee3d823dfa4bc4c3927474ef,0,Colm O hEigeartaigh,2017-05-09 14:21:12+01:00,['79da7d92721bb48b6fe96444cfb2c801a524a8a7'],1,1,2,1477855,1,,,,3076
095c358b5aac6178cd60d73a429f2d6f7bd10cdc,0,zhangqiang2,2017-05-09 21:33:21-04:00,['7019d3c6b5d5abeaee3d823dfa4bc4c3927474ef'],12,7,19,1477874,2,,,,3076
0ba3e129a068cf68ea8c2a77f003e112d0d54e08,0,Ankita Sinha,2017-05-10 11:16:18+05:18,['095c358b5aac6178cd60d73a429f2d6f7bd10cdc'],3,3,6,1477880,2,,,,3076
a3a5e2a7bc6209f6e93b66858d1f62a44e119d4e,1,Colm O hEigeartaigh,2017-05-10 09:35:35+01:00,['0ba3e129a068cf68ea8c2a77f003e112d0d54e08'],615,184,799,1478679,14,0.981627297,0,0,3076
1327c5530746d10cb2ccf2789ce99000b80c1efd,0,Colm O hEigeartaigh,2017-05-10 09:43:30+01:00,['a3a5e2a7bc6209f6e93b66858d1f62a44e119d4e'],0,5,5,1478684,1,,,,3076
8e19fc4370f6ff93a5387dd56cd4ed97faae74c6,0,Colm O hEigeartaigh,2017-05-10 09:43:56+01:00,['1327c5530746d10cb2ccf2789ce99000b80c1efd'],48,939,987,1479671,6,0.222222222,1,1,3077
cfb6a6d701b2922a342bbefb33ee9155619b54f7,0,Colm O hEigeartaigh,2017-05-10 09:45:04+01:00,['8e19fc4370f6ff93a5387dd56cd4ed97faae74c6'],49,0,49,1479720,3,,,,3077
4f7519293b506340486e2bbdfa93adfb414da126,0,Colm O hEigeartaigh,2017-05-10 09:51:40+01:00,['cfb6a6d701b2922a342bbefb33ee9155619b54f7'],8,16,24,1479744,1,1,1,1,3077
6f51d062a6e698d4100e7725c31782b35182c7b4,0,zhangqiang2,2017-05-10 21:38:57-04:00,['4f7519293b506340486e2bbdfa93adfb414da126'],54,16,70,1479814,1,,,,3077
42e050157b55a9a5bef1f2d913e8c5f0351364ab,1,zhangqiang2,2017-05-11 05:21:15-04:00,['6f51d062a6e698d4100e7725c31782b35182c7b4'],2,2,4,1479818,2,,,,3077
95b2912e93a69fac4bc1081b49cf62f46c78d176,0,zhangqiang2,2017-05-11 07:59:20-04:00,['42e050157b55a9a5bef1f2d913e8c5f0351364ab'],50,18,68,1479886,1,1,0,0,3077
fa38ed737d8696519d39b0cc53c128141e29edc6,1,Gautam Borad,2017-05-12 13:50:53+05:18,['95b2912e93a69fac4bc1081b49cf62f46c78d176'],34,115,149,1480035,5,0,0.050847458,1,3077
a8b4976ded4c4f980c351dd5c90f990c437107cd,0,zhangqiang2,2017-05-12 19:12:12-04:00,['fa38ed737d8696519d39b0cc53c128141e29edc6'],107,9,116,1480151,7,,,,3077
b7c425945bd5323e20ccb690bc7bccb1397727fa,1,Abhay Kulkarni,2017-05-12 17:13:22-07:00,['a8b4976ded4c4f980c351dd5c90f990c437107cd'],5,49,54,1480205,5,0.324324324,0.27027027,1,3077
55329a3e13580f014e282d319dc3168bb3e55507,1,Velmurugan Periasamy,2017-05-13 00:02:46-04:00,['b7c425945bd5323e20ccb690bc7bccb1397727fa'],45,182,227,1480432,3,0.576923077,0.769230769,0.923076923,3077
fe999c662ff15640502c3378b9ce50be41612dec,0,Velmurugan Periasamy,2017-05-13 00:17:56-04:00,['55329a3e13580f014e282d319dc3168bb3e55507'],10,4,14,1480446,1,,,,3077
e05276f05a615590f7bb737bd6bcc8e4763822f1,0,Gautam Borad,2017-05-15 20:11:31+05:18,['fe999c662ff15640502c3378b9ce50be41612dec'],1,1,2,1480448,1,,,,3077
a6daa264b6752ecd64473462799b774f621a2f6f,1,Abhay Kulkarni,2017-05-16 21:08:11-07:00,['e05276f05a615590f7bb737bd6bcc8e4763822f1'],12,77,89,1480537,3,0.371428571,1,1,3077
b451c34d96a37985085c840cef61608fc39ee07b,0,Colm O hEigeartaigh,2017-05-17 12:14:39+01:00,['a6daa264b6752ecd64473462799b774f621a2f6f'],5,0,5,1480542,1,,,,3077
1056997de83fae36a6b966be8ffe24cd89bcf551,0,peng.jianhua,2017-05-18 09:35:07+08:00,['b451c34d96a37985085c840cef61608fc39ee07b'],6,6,12,1480554,1,,,,3077
a8a0b5533c4ef59638a116fadd9f0f0d68f5ee88,1,Colm O hEigeartaigh,2017-05-18 10:19:55+01:00,['1056997de83fae36a6b966be8ffe24cd89bcf551'],1,2,3,1480557,2,0,1,1,3077
b08baf923d1f24434f79edeccc68de2103340275,0,zhangqiang2,2017-05-18 08:01:30-04:00,['a8a0b5533c4ef59638a116fadd9f0f0d68f5ee88'],48,0,48,1480605,1,,,,3077
39184d44aa26645fd000c7e4620807af6a1f2ee7,0,Abhay Kulkarni,2017-05-18 11:19:57-07:00,['b08baf923d1f24434f79edeccc68de2103340275'],19,34,53,1480658,3,0.2,0,1,3077
cbfe184c3b08e2ad4c1090b6a76ca09d92507852,0,Colm O hEigeartaigh,2017-05-19 10:00:37+01:00,['39184d44aa26645fd000c7e4620807af6a1f2ee7'],1,1,2,1480660,1,,,,3077
b8bc69a92d577a503ed4c3ba08a3d64c643d98c3,1,Colm O hEigeartaigh,2017-05-19 10:01:40+01:00,['cbfe184c3b08e2ad4c1090b6a76ca09d92507852'],1,1,2,1480662,1,,,,3077
5d5dee08a041e7366ecb9caa0e060ce4a74e0dde,1,Colm O hEigeartaigh,2017-05-19 10:05:56+01:00,['b8bc69a92d577a503ed4c3ba08a3d64c643d98c3'],0,74,74,1480736,2,0.12,0.96,1,3078
d128b5fe159cc52186c790ab08163718cab65b89,0,zhangqiang2,2017-05-19 17:16:10+08:00,['5d5dee08a041e7366ecb9caa0e060ce4a74e0dde'],1,1,2,1480738,1,,,,3078
66adb23ca5e46710d9c7804e54faa0767ae624e3,0,zhangqiang2,2017-05-19 17:19:11+08:00,['d128b5fe159cc52186c790ab08163718cab65b89'],1,1,2,1480740,1,,,,3078
69204867d4bba0d7094ea5963971baf403af2fe4,1,Gautam Borad,2017-05-19 22:10:21+05:18,['66adb23ca5e46710d9c7804e54faa0767ae624e3'],24,40,64,1480804,4,0,0,1,3078
e22ee9607206ad387572e3cac0aac32a562c57d5,0,peng.jianhua,2017-05-22 15:56:36+08:00,['69204867d4bba0d7094ea5963971baf403af2fe4'],1,1,2,1480806,1,,,,3078
82f2840f33b563924f9704cdafd9b4c590b332d8,0,Colm O hEigeartaigh,2017-05-22 10:20:47+01:00,['e22ee9607206ad387572e3cac0aac32a562c57d5'],264,0,264,1481070,1,,,,3078
47c8da66fac3a166dacae400acd78d94084fc4c1,0,Colm O hEigeartaigh,2017-05-22 10:21:00+01:00,['82f2840f33b563924f9704cdafd9b4c590b332d8'],30,18,48,1481118,1,0.75,0,0,3078
bae15a962ac87f02c4d982edb2d5bd566dec5b7f,0,Abhay Kulkarni,2017-05-22 16:56:39-07:00,['47c8da66fac3a166dacae400acd78d94084fc4c1'],19,293,312,1481430,2,0,0,1,3078
e26bcce249ec1852e4b55daf8e9f78f754e30343,0,peng.jianhua,2017-05-23 08:51:35+08:00,['bae15a962ac87f02c4d982edb2d5bd566dec5b7f'],8,8,16,1481446,1,,,,3078
dae5808f35332270ee5c4b4e5467d860982b532d,0,peng.jianhua,2017-05-23 08:59:25+08:00,['e26bcce249ec1852e4b55daf8e9f78f754e30343'],4,4,8,1481454,1,,,,3078
e8abd7f3dc5617536cad4dc736976c70567fb391,0,peng.jianhua,2017-05-23 09:06:01+08:00,['dae5808f35332270ee5c4b4e5467d860982b532d'],1,1,2,1481456,1,,,,3078
4a87c298362da5bf3265103a37bb25eec6166b85,0,peng.jianhua,2017-05-22 21:25:45-04:00,['e8abd7f3dc5617536cad4dc736976c70567fb391'],7,0,7,1481463,1,,,,3078
03fa94cb91904d33f1fa925581e5978522da998d,0,peng.jianhua,2017-05-22 21:29:37-04:00,['4a87c298362da5bf3265103a37bb25eec6166b85'],1,1,2,1481465,1,,,,3078
fd931f20270d4db8187b885b9e7f95c8261fdd82,0,Colm O hEigeartaigh,2017-05-23 10:03:00+01:00,['03fa94cb91904d33f1fa925581e5978522da998d'],14,62,76,1481541,4,1,0,0,3078
56e28489607eb7e7da68a76edf98c5f8ca78eb6c,1,Gautam Borad,2017-05-23 15:14:47+05:18,['fd931f20270d4db8187b885b9e7f95c8261fdd82'],3,17,20,1481561,1,0,0.75,1,3078
56a93f6e483be0c49e35095f7eb0ea20123628e6,1,Ankita Sinha,2017-05-23 19:02:26+05:18,['56e28489607eb7e7da68a76edf98c5f8ca78eb6c'],2,8,10,1481571,2,0,0,1,3078
d7c0b7a43e1fb1caaaa372495ba8b16a27243197,0,peng.jianhua,2017-05-24 08:52:01+08:00,['56a93f6e483be0c49e35095f7eb0ea20123628e6'],2,0,2,1481573,1,1,1,1,3078
615a70ddbd66d4a2403ef26fa018246b8ac7ddb1,0,zhangqiang2,2017-05-24 00:06:20-04:00,['d7c0b7a43e1fb1caaaa372495ba8b16a27243197'],1,0,1,1481574,1,,,,3078
0c7a2d853251b64de019884f5f8aa1cc1acb29e7,1,Colm O hEigeartaigh,2017-05-24 09:51:47+01:00,['615a70ddbd66d4a2403ef26fa018246b8ac7ddb1'],30,27,57,1481631,1,1,1,0,3078
01be3608f37369663e810a84fbb5b131281fad71,0,Colm O hEigeartaigh,2017-05-24 10:11:50+01:00,['0c7a2d853251b64de019884f5f8aa1cc1acb29e7'],5,7,12,1481643,1,,,,3078
7e223f90b319795c23225b447aded71f74546331,0,zhangqiang2,2017-05-24 12:14:06-04:00,['01be3608f37369663e810a84fbb5b131281fad71'],1,9,10,1481653,1,,,,3078
75ff18b1265e91890302398286ae9dfa1b2e3148,0,Colm O hEigeartaigh,2017-05-25 11:05:06+01:00,['7e223f90b319795c23225b447aded71f74546331'],309,86,395,1482048,5,0.935185185,0,0,3078
24d15821c13dd6727417b244c9f25ce8f77fabfb,0,Colm O hEigeartaigh,2017-05-25 13:09:02+01:00,['75ff18b1265e91890302398286ae9dfa1b2e3148'],174,5,179,1482227,3,,,,3078
d7ea2e27a52e531f883be436a290f0de8f15ff4a,0,peng.jianhua,2017-05-26 09:22:53+08:00,['24d15821c13dd6727417b244c9f25ce8f77fabfb'],2,11,13,1482240,1,,,,3078
734eff61d86243805e578e1fb3a2b7c52cc91acc,0,peng.jianhua,2017-05-26 09:26:32+08:00,['d7ea2e27a52e531f883be436a290f0de8f15ff4a'],1,23,24,1482264,1,,,,3078
f8ed53ef466e3206d743b4b92f48e1889df0cb7b,0,peng.jianhua,2017-05-26 03:01:37-04:00,['734eff61d86243805e578e1fb3a2b7c52cc91acc'],1,1,2,1482266,1,,,,3078
bf7a8bbde061d4ddcc387fb755443a70e85c4181,1,Colm O hEigeartaigh,2017-05-26 10:09:33+01:00,['f8ed53ef466e3206d743b4b92f48e1889df0cb7b'],10,42,52,1482318,2,0,0,0.964285714,3078
0f0bfc6dcece0c19d353cc54c5d08416afa38493,0,pradeep,2017-05-26 17:43:18+05:18,['bf7a8bbde061d4ddcc387fb755443a70e85c4181'],4,140,144,1482462,3,0.174603175,0.174603175,1,3078
dffbad4af43018438faf00b156acf593ab47839c,0,Madhan Neethiraj,2017-05-26 12:18:42-07:00,['0f0bfc6dcece0c19d353cc54c5d08416afa38493'],121,179,300,1482762,2,1,1,1,3079
0da1b424f3cf9574e31375251b4c78ee1f0e10a0,1,rmani,2017-05-26 13:21:06-07:00,['dffbad4af43018438faf00b156acf593ab47839c'],2,139,141,1482903,1,0,0,1,3079
bc4ab70bf4e4c32882392366bc653dde64a253f4,0,Gautam Borad,2017-05-28 12:55:05+05:18,['0da1b424f3cf9574e31375251b4c78ee1f0e10a0'],3,16,19,1482922,1,,,,3079
e10bad4da7a73d398a788d0881b4944dadf69b61,0,rmani,2017-05-29 11:46:22-07:00,['bc4ab70bf4e4c32882392366bc653dde64a253f4'],2,2,4,1482926,1,,,,3079
bac22f2216022a4b56b5a90eee0b928bb03d1dc9,0,rmani,2017-05-29 14:37:07-07:00,['e10bad4da7a73d398a788d0881b4944dadf69b61'],0,2,2,1482928,1,0,0,0,3079
9a943f1bf915247c01c1ac4322e8e56e63386a04,1,Madhan Neethiraj,2017-05-31 17:05:38-07:00,['bac22f2216022a4b56b5a90eee0b928bb03d1dc9'],40,355,395,1483323,5,0.207207207,0.36036036,1,3080
3f07cc36890cdc9c6f0b7c132253fe85409abbd8,0,Madhan Neethiraj,2017-05-31 17:42:43-07:00,['9a943f1bf915247c01c1ac4322e8e56e63386a04'],85,340,425,1483748,2,0.019607843,0.098039216,0.039215686,3080
dae46059b940d258449779d3fbb0963df82936c0,0,Velmurugan Periasamy,2017-05-31 21:29:47-04:00,['3f07cc36890cdc9c6f0b7c132253fe85409abbd8'],1,8,9,1483757,1,,,,3080
f26bac88fdce0faa0309a7b13e93990af3838a47,1,Abhay Kulkarni,2017-06-02 11:27:39-07:00,['dae46059b940d258449779d3fbb0963df82936c0'],79,72,151,1483908,13,1,0.615384615,0,3080
2a5b55e1bbae108432c20a5977f8ce4fe757b5a0,1,Abhay Kulkarni,2017-06-05 13:50:08-07:00,['f26bac88fdce0faa0309a7b13e93990af3838a47'],5,10,15,1483923,5,,,,3080
2e193e124399cf685c17798b8243e1d62f223315,0,rmani,2017-06-05 14:36:50-07:00,['2a5b55e1bbae108432c20a5977f8ce4fe757b5a0'],0,3,3,1483926,1,0,0,0,3080
208acf8eca45152e99da200e21847e01cab59604,0,Colm O hEigeartaigh,2017-06-06 09:50:43+01:00,['2e193e124399cf685c17798b8243e1d62f223315'],1,8,9,1483935,1,,,,3080
c7ad5012be0c6542eae5eff57f29538a0d4498ad,0,Colm O hEigeartaigh,2017-06-06 10:11:04+01:00,['208acf8eca45152e99da200e21847e01cab59604'],70,75,145,1484080,1,1,1,1,3080
16f3dd3c350ac9ea85b157b81ceddfcdb761e128,1,Velmurugan Periasamy,2017-06-07 12:44:06-04:00,['c7ad5012be0c6542eae5eff57f29538a0d4498ad'],4,5,9,1484089,2,,,,3080
e1fa93de70bdb61fbcc05bda0d5786b7451c2b8c,0,Colm O hEigeartaigh,2017-06-08 11:06:07+01:00,['16f3dd3c350ac9ea85b157b81ceddfcdb761e128'],118,71,189,1484278,25,0.808510638,0,0,3080
2d8895e6de2b1d04ce57e18c8b21a1fdff3b44b8,0,Colm O hEigeartaigh,2017-06-08 11:06:43+01:00,['e1fa93de70bdb61fbcc05bda0d5786b7451c2b8c'],2,2,4,1484282,2,,,,3080
fbfa3193d9b267c18e95048d177f8d68f31a61ff,0,zhangqiang2,2017-06-09 02:45:03-04:00,['2d8895e6de2b1d04ce57e18c8b21a1fdff3b44b8'],4,15,19,1484301,1,,,,3080
93b489e4c5741ccb27e57361fb17958b5ba5f15a,0,Colm O hEigeartaigh,2017-06-09 10:32:53+01:00,['fbfa3193d9b267c18e95048d177f8d68f31a61ff'],1,1,2,1484303,1,,,,3080
2814f71fa3fc4d31836ff55eddaff5d49e34494c,1,Colm O hEigeartaigh,2017-06-09 11:19:27+01:00,['93b489e4c5741ccb27e57361fb17958b5ba5f15a'],0,5,5,1484308,1,0,0,1,3080
f2c4f90f07f6cddc008b560aa361b5a0b1e04a00,0,zhangqiang2,2017-06-12 03:24:39-04:00,['2814f71fa3fc4d31836ff55eddaff5d49e34494c'],87,2,89,1484397,2,,,,3080
5e82ed83c4f6f360aefd2818c1485cb7dce2027c,1,Madhan Neethiraj,2017-06-12 11:17:35-07:00,['f2c4f90f07f6cddc008b560aa361b5a0b1e04a00'],88,273,361,1484758,13,0.357142857,0.507936508,0.992063492,3080
9a99e3f41cc2125295058a8fc32e5b9e53bb48a4,1,Ankita Sinha,2017-06-13 17:29:51+05:18,['5e82ed83c4f6f360aefd2818c1485cb7dce2027c'],17,40,57,1484815,2,0,0.052631579,0.473684211,3080
2c57feaf8b53f719d889f07a21cbdfafe6608dc4,0,peng.jianhua,2017-06-13 21:54:18-04:00,['9a99e3f41cc2125295058a8fc32e5b9e53bb48a4'],3,2,5,1484820,2,,,1,3080
08d9c4e332cc54bf900002771b63c480d8e1dcc4,1,Colm O hEigeartaigh,2017-06-14 10:48:19+01:00,['2c57feaf8b53f719d889f07a21cbdfafe6608dc4'],11,21,32,1484852,1,0,0,1,3080
42657fdb849f9e96e87c3f16f7c06a639600253a,0,zhangqiang2,2017-06-14 20:46:56-04:00,['08d9c4e332cc54bf900002771b63c480d8e1dcc4'],4,7,11,1484863,1,,,,3080
57783900cad2d2a28f47e36ebea3864b8ffe38bd,1,Mehul Parikh,2017-06-15 16:42:45+05:18,['42657fdb849f9e96e87c3f16f7c06a639600253a'],136,275,411,1485274,14,0.045454545,0,0.090909091,3080
a94de11049c498cb93a96f00eae51af817b56d6b,0,Mehul Parikh,2017-06-15 16:46:27+05:18,['57783900cad2d2a28f47e36ebea3864b8ffe38bd'],0,4,4,1485278,1,0,1,1,3080
fdd1d294c6b3c0e3cd8dd4219d034ad63210b380,0,rmani,2017-06-16 16:26:52-07:00,['a94de11049c498cb93a96f00eae51af817b56d6b'],2,0,2,1485280,1,1,1,1,3080
7e75e9b1c4a0e6dd64d3ff09da1f713bc43b7e26,0,peng.jianhua,2017-06-19 05:43:47-04:00,['fdd1d294c6b3c0e3cd8dd4219d034ad63210b380'],32,5,37,1485317,1,,,,3080
f2e36940c11642b7385e4af6d3b736ff952a7245,1,Colm O hEigeartaigh,2017-06-20 15:13:33+01:00,['7e75e9b1c4a0e6dd64d3ff09da1f713bc43b7e26'],1,306,307,1485624,4,0.079136691,1,1,3082
e07556457c8b159046016c97aedaa4dc4d0c3ef2,0,zhangqiang2,2017-06-20 20:29:32-04:00,['f2e36940c11642b7385e4af6d3b736ff952a7245'],4,22,26,1485650,2,,,,3082
dbbc2eab1c5400a20245f04672dc7b9932969d43,0,Colm O hEigeartaigh,2017-06-21 10:48:59+01:00,['e07556457c8b159046016c97aedaa4dc4d0c3ef2'],65,87,152,1485802,2,1,1,1,3082
ba29b40946bf98be6a5776e09ecaa056e4754109,1,Abhay Kulkarni,2017-06-21 14:09:28-07:00,['dbbc2eab1c5400a20245f04672dc7b9932969d43'],0,56,56,1485858,1,0,0,1,3082
84de2f030d92798e6715e180e00785f19d7c09bc,0,peng.jianhua,2017-06-21 21:29:55-04:00,['ba29b40946bf98be6a5776e09ecaa056e4754109'],3,18,21,1485879,1,,,,3082
fd9abc800bbac553434b7a2d911a277ed6b70119,1,Colm O hEigeartaigh,2017-06-22 09:39:34+01:00,['84de2f030d92798e6715e180e00785f19d7c09bc'],21,33,54,1485933,1,1,0,1,3082
64a8c9f381ece94f0cbe35f3dbd97e5b56af093d,1,Sailaja Polavarapu,2017-06-22 10:51:41-07:00,['fd9abc800bbac553434b7a2d911a277ed6b70119'],21,237,258,1486191,8,0.410714286,0.410714286,1,3083
51a96a86e88fb545b392704c4ddffe1e4957ff42,1,Abhay Kulkarni,2017-06-22 15:34:25-07:00,['fd9abc800bbac553434b7a2d911a277ed6b70119'],19,31,50,1486241,1,0,0.5,0.5,3083
f6ff008a13d2fe25196d8f939369a1273829b927,1,peng.jianhua,2017-06-22 20:51:48-04:00,['51a96a86e88fb545b392704c4ddffe1e4957ff42'],1,10,11,1486252,2,0,1,1,3083
820c6d251c44899c23e6f189eefeb9a79ca7384f,1,Abhay Kulkarni,2017-06-23 15:46:16-07:00,['f6ff008a13d2fe25196d8f939369a1273829b927'],70,546,616,1486868,13,0.308681672,0.263665595,0.607717042,3085
1a24d019e5875e97d13c833991f3c439d65a1dd7,0,Sailaja Polavarapu,2017-06-25 10:48:44-07:00,['64a8c9f381ece94f0cbe35f3dbd97e5b56af093d'],23,23,46,1486914,5,,,,3085
a75eed841423addd53f26fcb57f55eca494e04fa,0,Sailaja Polavarapu,2017-06-25 10:59:25-07:00,"['1a24d019e5875e97d13c833991f3c439d65a1dd7', '820c6d251c44899c23e6f189eefeb9a79ca7384f']",90,587,677,1487591,16,,,,3085
e52e2b271399c4d40b23da2a099b0dc16ed840c0,1,Colm O hEigeartaigh,2017-06-26 09:26:11+01:00,['a75eed841423addd53f26fcb57f55eca494e04fa'],3,8,11,1487602,2,0,1,1,3085
11bcd728ef103a1dd34a6d3f2b386bbaaa9ba550,0,rmani,2017-06-26 13:32:16-07:00,['e52e2b271399c4d40b23da2a099b0dc16ed840c0'],13,27,40,1487642,1,0,0,1,3085
84d132fcf8df176e827144b83425fce5f89de312,1,Mehul Parikh,2017-06-27 11:45:40+05:18,['11bcd728ef103a1dd34a6d3f2b386bbaaa9ba550'],3,99,102,1487744,5,,,,3086
f6029f1cc926d8f487368216deb9dbebb3074eac,0,peng.jianhua,2017-06-27 06:44:14-04:00,['84d132fcf8df176e827144b83425fce5f89de312'],3,3,6,1487750,1,,,,3086
fdb74d51f86cc5e464e1beefd910fa3fc73ec45d,1,Ankita Sinha,2017-06-28 08:56:28+05:18,['f6029f1cc926d8f487368216deb9dbebb3074eac'],5,50,55,1487805,1,0.128205128,0.128205128,0.974358974,3086
b7a1cc05c9607e02ce91079ee0d62c5d547ba069,1,Colm O hEigeartaigh,2017-06-28 17:38:46+01:00,['fdb74d51f86cc5e464e1beefd910fa3fc73ec45d'],14,20,34,1487839,2,0,1,1,3086
16353c268e9d4c4c5cfd44f12937386165435493,0,peng.jianhua,2017-06-29 05:13:48-04:00,['b7a1cc05c9607e02ce91079ee0d62c5d547ba069'],9,1,10,1487849,2,,,,3086
b096802bec6fa59142ae924ed09419be5ad719e5,1,peng.jianhua,2017-07-03 02:49:27-04:00,['16353c268e9d4c4c5cfd44f12937386165435493'],1,5,6,1487855,2,0,1,1,3086
655ceb219ab044010bd9e764bb17dccc112c65a0,0,Colm O hEigeartaigh,2017-07-05 11:04:15+01:00,['b096802bec6fa59142ae924ed09419be5ad719e5'],0,1,1,1487856,1,,,,3086
324a8e8728bd8d43c4165c77ed65fe63448533e9,1,peng.jianhua,2017-07-05 22:38:03-04:00,['655ceb219ab044010bd9e764bb17dccc112c65a0'],11,33,44,1487900,2,,,,3087
8d32649f935fc0ade400db94c20d909fa1f767e1,1,Gautam Borad,2017-07-10 14:11:15+05:18,['324a8e8728bd8d43c4165c77ed65fe63448533e9'],4,26,30,1487930,2,0.666666667,0.833333333,1,3087
b47fe34779beb4be49015ca2f3dfecae7413135a,1,Ankita Sinha,2017-07-10 15:29:11+05:18,['8d32649f935fc0ade400db94c20d909fa1f767e1'],83,263,346,1488276,2,0.684782609,0.891304348,0.891304348,3088
f695b5def99d6614f917b393c3802a721b82b687,0,Colm O hEigeartaigh,2017-07-10 12:29:03+01:00,['b47fe34779beb4be49015ca2f3dfecae7413135a'],1,1,2,1488278,1,,,,3088
eb77374d14120f20c50b8e862fd0e7ad2dd53c01,0,Colm O hEigeartaigh,2017-07-10 12:48:10+01:00,['f695b5def99d6614f917b393c3802a721b82b687'],1,10,11,1488289,1,0.8,1,1,3088
b3e4fdb3aa450cbdb93c0f8246bc09ce6d5f4802,1,Mehul Parikh,2017-07-10 17:26:04+05:18,['eb77374d14120f20c50b8e862fd0e7ad2dd53c01'],51,67,118,1488407,3,0,0,1,3088
e7c13864fc37f98b0e1fc4f9add2a681c43197f0,0,Colm O hEigeartaigh,2017-07-10 13:46:29+01:00,['b3e4fdb3aa450cbdb93c0f8246bc09ce6d5f4802'],3,2,5,1488412,1,1,0,0,3088
d2e1d099ebbd16af54144391fbe3803f1f204b79,1,Colm O hEigeartaigh,2017-07-10 15:01:32+01:00,['e7c13864fc37f98b0e1fc4f9add2a681c43197f0'],2,3,5,1488417,1,0,1,1,3088
d592d3fa2c2ea9f48f87b94f9ea5287f928df30d,0,Colm O hEigeartaigh,2017-07-10 15:01:44+01:00,['d2e1d099ebbd16af54144391fbe3803f1f204b79'],10,1,11,1488428,1,0.2,0,0,3088
caf7e9b86ece776de465a1961f89a918ba4cbef7,0,Colm O hEigeartaigh,2017-07-10 18:01:14+01:00,['d592d3fa2c2ea9f48f87b94f9ea5287f928df30d'],8,4,12,1488440,2,1,0,0,3088
03df41fb21f8fe95d9ebaa3604408e2f4432e27b,0,Mehul Parikh,2017-07-11 10:51:10+05:18,['caf7e9b86ece776de465a1961f89a918ba4cbef7'],1,1,2,1488442,1,,,,3088
d4f2340a9f68b046f770bd09f74e243ed28ad167,0,rmani,2017-07-11 10:19:38-07:00,['03df41fb21f8fe95d9ebaa3604408e2f4432e27b'],0,1,1,1488443,1,,,,3088
05a1a40175d6458509e715bb19fd219248e965e1,1,peng.jianhua,2017-07-11 20:16:00-04:00,['d4f2340a9f68b046f770bd09f74e243ed28ad167'],14,45,59,1488502,3,1,1,0,3089
988f8eafeea04772dfbbe5b5ea838984c2bf522e,0,peng.jianhua,2017-07-11 20:18:01-04:00,['05a1a40175d6458509e715bb19fd219248e965e1'],1,1,2,1488504,1,,,,3089
a92129807e4a46c6644c1dd6e430fe8b8b4c1739,0,peng.jianhua,2017-07-12 23:33:12-04:00,['988f8eafeea04772dfbbe5b5ea838984c2bf522e'],1,1,2,1488506,1,,,,3089
7b61f159fa8f5c612c65a2b329fd103153cfb0aa,0,Colm O hEigeartaigh,2017-07-13 10:01:31+01:00,['a92129807e4a46c6644c1dd6e430fe8b8b4c1739'],2,2,4,1488510,1,,,,3089
15fd7fa5d1a734246640e1337d2b2b927dccc486,0,peng.jianhua,2017-07-13 23:33:46-04:00,['7b61f159fa8f5c612c65a2b329fd103153cfb0aa'],3,3,6,1488516,2,,,,3089
c5332d123411535f3dbfeef7b1872d97cc087bb2,0,peng.jianhua,2017-07-15 02:30:40-04:00,['15fd7fa5d1a734246640e1337d2b2b927dccc486'],1,24,25,1488541,1,,,,3089
66e1ce2e1eb2bcf894178be5a6b64f60dc8faeed,1,peng.jianhua,2017-07-15 02:35:47-04:00,['c5332d123411535f3dbfeef7b1872d97cc087bb2'],2,15,17,1488558,4,,,,3089
55e6d4e1398f27d897795a174a332d6e18642b08,0,Ankita Sinha,2017-07-19 08:52:55+05:18,['66e1ce2e1eb2bcf894178be5a6b64f60dc8faeed'],3,0,3,1488561,1,1,0,0,3089
5055db1535098f25603cb63fa4bb5aa521d6161a,1,Abhay Kulkarni,2017-07-24 19:13:30-07:00,['55e6d4e1398f27d897795a174a332d6e18642b08'],14,45,59,1488620,5,0.272727273,0,1,3089
88352408b535d82bbef1b1ffc79b16fb57ffb505,1,peng.jianhua,2017-07-25 08:49:57-04:00,['5055db1535098f25603cb63fa4bb5aa521d6161a'],3,5,8,1488628,1,,,,3089
96b0c48602d777e7f1aacc6b7253fed874811b1a,1,Abhay Kulkarni,2017-07-26 11:31:04-07:00,['88352408b535d82bbef1b1ffc79b16fb57ffb505'],27,428,455,1489083,21,0.132701422,0.374407583,0.469194313,3090
1685bacf057b773210ae8ca055a6668ea2fa7dd5,0,peng.jianhua,2017-07-26 21:01:54-04:00,['96b0c48602d777e7f1aacc6b7253fed874811b1a'],12,65,77,1489160,3,0,1,1,3091
edd0bd6a69b4919745d79119e943ad4b330941d0,1,peng.jianhua,2017-07-26 21:29:45-04:00,['1685bacf057b773210ae8ca055a6668ea2fa7dd5'],0,100,100,1489260,1,0.367088608,0.367088608,1,3091
a89ddecf05b9b22c6b5faf2f2f7acd12cbb1f7ca,0,Colm O hEigeartaigh,2017-07-27 12:37:50+01:00,['edd0bd6a69b4919745d79119e943ad4b330941d0'],1,40,41,1489301,2,,,,3092
7d5d00c15d4fdde8d57182dc67ec05b883474191,0,Ankita Sinha,2017-07-27 18:14:47+05:18,['a89ddecf05b9b22c6b5faf2f2f7acd12cbb1f7ca'],1,1,2,1489303,1,,,,3092
7c401b3e305c3ec7de47105a2980a9152ae04ce4,1,Abhay Kulkarni,2017-07-28 12:20:18-07:00,['7d5d00c15d4fdde8d57182dc67ec05b883474191'],85,38,123,1489426,6,0.545454545,0.113636364,0,3092
13620b2647899732452ad883a33cd4e98fe70edb,1,peng.jianhua,2017-07-30 22:15:11-04:00,['7c401b3e305c3ec7de47105a2980a9152ae04ce4'],2,15,17,1489443,1,0,0,1,3092
b6c631dbdba2329b760eedeb58c983555648f504,1,rmani,2017-08-03 10:50:53-07:00,['13620b2647899732452ad883a33cd4e98fe70edb'],1,24,25,1489468,2,0.6,1,1,3092
c12cfd97728b1209fa5340a42b9528d008f10db5,1,rmani,2017-08-03 10:55:22-07:00,['b6c631dbdba2329b760eedeb58c983555648f504'],7,18,25,1489493,1,1,1,1,3092
1befffcc1c18679cdf2c6413496b2078f6d2a838,1,rmani,2017-08-03 15:07:37-07:00,['c12cfd97728b1209fa5340a42b9528d008f10db5'],3,6,9,1489502,1,0.333333333,0.333333333,1,3092
93c900c346cdac33e268c2e76e2f37568cc1c7f3,0,Colm O hEigeartaigh,2017-08-04 12:04:02+01:00,['1befffcc1c18679cdf2c6413496b2078f6d2a838'],32,30,62,1489564,3,0.5,0.5,1,3092
c5daf83bc225a6249022e23fd0cbcadeb56a0987,1,Mehul Parikh,2017-08-07 10:18:40+05:18,['93c900c346cdac33e268c2e76e2f37568cc1c7f3'],4,14,18,1489582,1,1,1,1,3092
f01bcf3d003500eaa28c1f48b8eac83fb037298a,0,peng.jianhua,2017-08-08 04:03:08-04:00,['c5daf83bc225a6249022e23fd0cbcadeb56a0987'],3,0,3,1489585,3,1,1,0,3092
688807cf74fc434e246a2f7d6c0e71e941178421,0,Colm O hEigeartaigh,2017-08-09 11:49:47+01:00,['f01bcf3d003500eaa28c1f48b8eac83fb037298a'],27,21,48,1489633,1,1,1,0,3092
4ce27cffb96e21e2e7ece628b0a303c52746204d,0,rmani,2017-08-09 13:34:23-07:00,['688807cf74fc434e246a2f7d6c0e71e941178421'],62,2,64,1489697,2,0.979591837,0.979591837,0,3092
0736d98e23441a112567b470254cc47bbdf2cb69,0,peng.jianhua,2017-08-10 03:03:07-04:00,['4ce27cffb96e21e2e7ece628b0a303c52746204d'],17,14,31,1489728,1,1,1,0,3092
0878d19e9fc39c13c136411ee4df6c6fa33c7b43,1,peng.jianhua,2017-08-10 23:12:27-04:00,['0736d98e23441a112567b470254cc47bbdf2cb69'],36,54,90,1489818,2,0.466666667,0.466666667,1,3092
9f5721bbed8057586e63a5ea5552ddecf5cc67ca,1,Gautam Borad,2017-08-11 12:00:57+05:18,['0878d19e9fc39c13c136411ee4df6c6fa33c7b43'],206,777,983,1490801,14,0.007952286,0.133200795,0.918489066,3092
71023632235ec0ad1e85962f47153c586983b225,0,rmani,2017-08-11 11:26:57-07:00,['9f5721bbed8057586e63a5ea5552ddecf5cc67ca'],0,14,14,1490815,1,,,,3092
3dc21364c4b50444147aa45bc9bcc4c1325f8f2d,1,Colm O hEigeartaigh,2017-08-16 12:17:42+01:00,['71023632235ec0ad1e85962f47153c586983b225'],100,49,149,1490964,15,,,,3092
f7230f70a4de21c7bac9028a05f9f7472077e809,0,Colm O hEigeartaigh,2017-08-16 12:17:59+01:00,['3dc21364c4b50444147aa45bc9bcc4c1325f8f2d'],2,3,5,1490969,1,1,1,1,3092
1b4e78b0dcfad74b7fd2baea16364b7daf32159e,0,Abhay Kulkarni,2017-08-16 13:14:32-07:00,['f7230f70a4de21c7bac9028a05f9f7472077e809'],45,65,110,1491079,1,0,0,0,3092
c8058ad8056c534688551b2e1767611d47d66ab7,1,Ankita Sinha,2017-08-17 17:59:34+05:18,['1b4e78b0dcfad74b7fd2baea16364b7daf32159e'],0,1,1,1491080,1,0,0,0,3092
f6d4f116c5ecf0a656b1cba3846cfd3cbd9e5393,1,Mehul Parikh,2017-08-22 09:55:13+05:18,['c8058ad8056c534688551b2e1767611d47d66ab7'],41,162,203,1491283,10,0.754098361,0,0.016393443,3092
d4cf1226427e8c49e63a751f4fe8bada565f64d1,1,Mehul Parikh,2017-08-22 09:56:59+05:18,['f6d4f116c5ecf0a656b1cba3846cfd3cbd9e5393'],53,157,210,1491493,6,0.454545455,0.290909091,1,3092
ca9f7c1824f3d6bd0e2796b9aed4ec5f66bb3baa,1,Sailaja Polavarapu,2017-08-22 15:42:39-07:00,['d4cf1226427e8c49e63a751f4fe8bada565f64d1'],12,66,78,1491571,4,0,0.727272727,1,3092
32999cd07c4dae454e0dde8fc3433c0e822d068d,0,zhangqiang2,2017-08-22 21:31:17-04:00,['ca9f7c1824f3d6bd0e2796b9aed4ec5f66bb3baa'],2,2,4,1491575,1,,,,3092
a9523814cf4b3763a3a8db7d7eb3161e624074c5,0,zhangqiang2,2017-08-22 21:35:09-04:00,['32999cd07c4dae454e0dde8fc3433c0e822d068d'],2,13,15,1491590,1,,,,3092
b676cd920cc64e6e8d286f231a714a65f93031ef,0,zhangqiang2,2017-08-22 21:40:50-04:00,['a9523814cf4b3763a3a8db7d7eb3161e624074c5'],2,6,8,1491598,1,0,0,1,3092
a16889fbbd189ea6282030b528f8d17fac79144a,0,zhangqiang2,2017-08-22 21:43:58-04:00,['b676cd920cc64e6e8d286f231a714a65f93031ef'],6,10,16,1491614,1,,,,3092
02c094393f40b209800f740a1ca8eaa8f7f4e43a,1,Ankita Sinha,2017-08-23 09:50:38+05:18,['a16889fbbd189ea6282030b528f8d17fac79144a'],22,37,59,1491673,3,0.714285714,1,1,3092
e0a010f5c859a52be452f92244c67ac045bdfbdf,1,Ankita Sinha,2017-08-23 18:29:00+05:18,['02c094393f40b209800f740a1ca8eaa8f7f4e43a'],8,9,17,1491690,4,1,0,0,3092
5318e2f5f5610c3765df7971a48d5f3692e3286b,1,Sailaja Polavarapu,2017-08-23 14:36:22-07:00,['e0a010f5c859a52be452f92244c67ac045bdfbdf'],6,14,20,1491710,2,0,0,1,3092
5fc9ee1f9a41d2dd73dad1dc9e32fbfaa38872a6,0,zhangqiang2,2017-08-23 20:43:34-04:00,['5318e2f5f5610c3765df7971a48d5f3692e3286b'],12,6,18,1491728,2,,,,3092
b9cdb0bd540f4e092720026ca92ce934cc13f90d,1,Mehul Parikh,2017-08-24 11:08:36+05:18,['5fc9ee1f9a41d2dd73dad1dc9e32fbfaa38872a6'],57,126,183,1491911,2,0,0,1,3092
053cdd7b7e367aef09ab9d6b862f86fad35de811,1,Mehul Parikh,2017-08-24 11:09:22+05:18,['b9cdb0bd540f4e092720026ca92ce934cc13f90d'],6,26,32,1491943,1,0,0,0.263157895,3092
18a47ed4b8ea910a2c93c8707a0128f9b2af6ce5,1,Ankita Sinha,2017-08-24 16:47:09+05:18,['053cdd7b7e367aef09ab9d6b862f86fad35de811'],31,91,122,1492065,5,0.622807018,1,0.789473684,3092
a43dd80f08857b99464934de9f5262851ab6749f,0,zhangqiang2,2017-08-26 04:23:29-04:00,['18a47ed4b8ea910a2c93c8707a0128f9b2af6ce5'],14,17,31,1492096,1,0,0,1,3092
4daf1e9ed9f89f389f8cdb74baa1792f92fc2466,1,zhangqiang2,2017-08-26 04:38:47-04:00,['a43dd80f08857b99464934de9f5262851ab6749f'],1,1,2,1492098,1,,,,3092
83b67df99b87e8fa14564e237623f8749f1fab81,0,zhangqiang2,2017-08-27 22:23:08-04:00,['4daf1e9ed9f89f389f8cdb74baa1792f92fc2466'],0,20,20,1492118,4,,,,3092
e474c4d7b844c2cb3ac5609b68f56eee43ae4b64,0,rmani,2017-08-29 13:57:20-07:00,['83b67df99b87e8fa14564e237623f8749f1fab81'],1,1,2,1492120,1,,,,3092
c7d1e50b231e10efb543b5ebec578598396b9f68,1,Colm O hEigeartaigh,2017-08-31 10:41:56+01:00,['e474c4d7b844c2cb3ac5609b68f56eee43ae4b64'],16,15,31,1492151,5,1,1,1,3092
a71dab7fdf43cb939221c9aaa0e34a34df153dd6,0,zhangqiang2,2017-08-31 19:35:45+08:00,['c7d1e50b231e10efb543b5ebec578598396b9f68'],1,1,2,1492153,1,,,,3092
95615f8eb7c6acd7c92c75527e8255d59143f68e,0,rmani,2017-08-31 15:37:40-07:00,['a71dab7fdf43cb939221c9aaa0e34a34df153dd6'],1,203,204,1492357,2,0,1,1,3092
792e40bcdf6b209ed47f0508bd11efc820b0a5b8,0,Ankita Sinha,2017-09-01 11:33:02+05:18,['95615f8eb7c6acd7c92c75527e8255d59143f68e'],1,1,2,1492359,1,,,,3092
a8fea7b6d2d40dc13a8aa4e92852fedc2dde5b40,1,Colm O hEigeartaigh,2017-09-01 10:54:39+01:00,['792e40bcdf6b209ed47f0508bd11efc820b0a5b8'],11,10,21,1492380,4,,,,3092
4075c08b9fd1c6ce6ef4fa2d3a1033e95d9d3d8a,0,Colm O hEigeartaigh,2017-09-01 11:39:52+01:00,['a8fea7b6d2d40dc13a8aa4e92852fedc2dde5b40'],1,2,3,1492383,2,,,,3092
5a736c2aaab7a7498dd143ce5078ba4e605536d9,0,Colm O hEigeartaigh,2017-09-01 11:42:26+01:00,['4075c08b9fd1c6ce6ef4fa2d3a1033e95d9d3d8a'],0,3,3,1492386,1,,,,3092
513477d06d3dc2d4ac38eedfca83f58b6b8f28a7,1,Don Bosco Durai,2017-09-05 15:18:23-07:00,['5a736c2aaab7a7498dd143ce5078ba4e605536d9'],2,2,4,1492390,1,,,,3092
c24c9bdfd2bc813febf16736877b7f43cd8bfeb5,0,zhangqiang2,2017-09-07 14:23:18+08:00,['513477d06d3dc2d4ac38eedfca83f58b6b8f28a7'],11,14,25,1492415,1,1,1,1,3092
6890976ee99a2f05fbec214003c67da7b2eb466d,0,Colm O hEigeartaigh,2017-09-07 10:17:01+01:00,['c24c9bdfd2bc813febf16736877b7f43cd8bfeb5'],1,7,8,1492423,2,0,0,0.5,3092
f4019d11ba20fb6d61171876e4f14ea428028887,1,Sailaja Polavarapu,2017-09-07 14:21:27-07:00,['6890976ee99a2f05fbec214003c67da7b2eb466d'],147,524,671,1493094,6,0.074498567,0.154727794,0.601719198,3092
d0cf2dd5545152701355560d2b2dbba19eec0b3b,0,peng.jianhua,2017-09-08 09:56:11+08:00,['f4019d11ba20fb6d61171876e4f14ea428028887'],18,21,39,1493133,1,0,0,1,3092
991481b2795de80c771d7354594b7c59ac5022ce,1,Abhay Kulkarni,2017-09-10 22:22:44-07:00,['d0cf2dd5545152701355560d2b2dbba19eec0b3b'],24,32,56,1493189,1,0,0,1,3092
774f55845921c6a60ce5c06ccb19e339a5529d49,0,peng.jianhua,2017-09-11 16:04:25+08:00,['991481b2795de80c771d7354594b7c59ac5022ce'],0,1,1,1493190,1,0,1,0,3092
b383385fe32e1b7da32bc04ad1d47dd4907a3b38,1,Gautam Borad,2017-09-11 18:17:20+05:18,['774f55845921c6a60ce5c06ccb19e339a5529d49'],1,31,32,1493222,1,0,0,1,3092
7e35e5730f185a024aea20cb45f3fea360fbc4d0,1,Gautam Borad,2017-09-11 18:19:55+05:18,['b383385fe32e1b7da32bc04ad1d47dd4907a3b38'],7,152,159,1493381,4,0.426470588,0.426470588,1,3093
e4dfa818a327b5447eb04d786bef80a6b4d41656,0,Colm O hEigeartaigh,2017-09-11 15:16:25+01:00,['7e35e5730f185a024aea20cb45f3fea360fbc4d0'],0,1,1,1493382,1,,,,3093
2aa96bf6ea5b9b0bf5b9cdbb8603a9ecb6195d4e,0,Colm O hEigeartaigh,2017-09-12 13:33:46+01:00,['e4dfa818a327b5447eb04d786bef80a6b4d41656'],1,1,2,1493384,1,,,,3093
b83b168791ad7adb8d46032d0c111ee86c004fb8,1,pradeep,2017-09-13 19:12:16+05:18,['2aa96bf6ea5b9b0bf5b9cdbb8603a9ecb6195d4e'],3,237,240,1493624,6,,,,3098
65ccdb1491353a2a29376b01f45cd62b601d498d,0,Colm O hEigeartaigh,2017-09-14 11:01:33+01:00,['b83b168791ad7adb8d46032d0c111ee86c004fb8'],0,3,3,1493627,1,1,1,1,3098
8372e3003ee9630b321b4ef4218c37db0ccd38b1,0,Colm O hEigeartaigh,2017-09-14 11:04:06+01:00,['65ccdb1491353a2a29376b01f45cd62b601d498d'],1,1,2,1493629,1,,,,3098
98351d4c1b1a407c37b9ad161a0fb8b4f6efd977,0,Mehul Parikh,2017-09-15 17:45:15+05:18,['8372e3003ee9630b321b4ef4218c37db0ccd38b1'],0,3,3,1493632,1,,,,3098
e7d8dea885da7a5a740852fc0f86fb5435e5a704,0,Colm O hEigeartaigh,2017-09-18 12:59:33+01:00,['98351d4c1b1a407c37b9ad161a0fb8b4f6efd977'],1805,0,1805,1495437,10,0.647122693,0.390879479,0.110749186,3098
dbc84c18ade3c05c0a8f4fe39c495148a65dea03,0,Colm O hEigeartaigh,2017-09-18 12:59:56+01:00,['e7d8dea885da7a5a740852fc0f86fb5435e5a704'],175,1172,1347,1496784,14,0.201581028,1,0.494071146,3107
7d4f652c8cfa12e5bad7b28049bdd85ba37e14ad,1,Mehul Parikh,2017-09-18 17:53:14+05:18,['dbc84c18ade3c05c0a8f4fe39c495148a65dea03'],13,77,90,1496874,14,0.893939394,0.909090909,0.878787879,3107
938b0c8eaf2e898e9420d0f34ef966b16342322b,1,Mehul Parikh,2017-09-19 11:56:01+05:18,['7d4f652c8cfa12e5bad7b28049bdd85ba37e14ad'],1,571,572,1497446,4,0.063888889,0.194444444,1,3110
b028f405a2ae3fb8fc5efd1f3d7da0b83a732d00,0,Colm O hEigeartaigh,2017-09-19 12:45:01+01:00,['938b0c8eaf2e898e9420d0f34ef966b16342322b'],0,1,1,1497447,1,0,0,1,3110
83014529eeac1c9e21c5906720a7df2a3407f444,0,Mehul Parikh,2017-09-19 17:22:10+05:18,['b028f405a2ae3fb8fc5efd1f3d7da0b83a732d00'],0,4,4,1497451,1,1,1,1,3110
d9aff094c7480fa018f2068a463e9338bcb6923a,0,Mehul Parikh,2017-09-19 17:29:08+05:18,['83014529eeac1c9e21c5906720a7df2a3407f444'],10,2,12,1497463,1,1,0,0,3110
8ca94c113ed565f58aa256adb99e6b99ec44ac6a,0,Colm O hEigeartaigh,2017-09-19 14:59:20+01:00,['d9aff094c7480fa018f2068a463e9338bcb6923a'],2,2,4,1497467,1,,,,3110
8a728b5d78495524da75a057d2eb4fd9248f2cef,0,peng.jianhua,2017-09-20 08:46:58+08:00,['8ca94c113ed565f58aa256adb99e6b99ec44ac6a'],1,2,3,1497470,1,0,0,1,3110
1ba7128dcb4f863658c965e061432480ffdd3020,0,Colm O hEigeartaigh,2017-09-20 15:48:58+01:00,['8a728b5d78495524da75a057d2eb4fd9248f2cef'],0,3,3,1497473,1,,,,3110
88d8481d1fa44fd75082866482cf93f7096f5960,0,Deepak Sharma,2017-09-20 23:04:04+05:18,['1ba7128dcb4f863658c965e061432480ffdd3020'],4,12,16,1497489,1,,,,3110
afc5e742d7d15127737bcc0447a9cee78ee523c7,1,peng.jianhua,2017-09-21 10:29:02+08:00,['88d8481d1fa44fd75082866482cf93f7096f5960'],2,1,3,1497492,1,1,1,0,3110
2ec3b646e1cccf9b707f26344b5eb19ffee4bd61,0,peng.jianhua,2017-09-23 12:32:58+08:00,['afc5e742d7d15127737bcc0447a9cee78ee523c7'],1,1,2,1497494,1,,,,3110
99ec61e42599478107a1c186244691aca8afa18f,0,Colm O hEigeartaigh,2017-09-25 15:11:04+01:00,['2ec3b646e1cccf9b707f26344b5eb19ffee4bd61'],1,1,2,1497496,1,,,,3110
1295e83bd43e86c2ab5868d0fd929cec7b772336,0,Colm O hEigeartaigh,2017-09-25 15:37:26+01:00,['99ec61e42599478107a1c186244691aca8afa18f'],4,5,9,1497505,1,0,0,1,3110
77be4025894e976c7d145382f6b43ad56186b046,0,Colm O hEigeartaigh,2017-09-26 11:52:55+01:00,['1295e83bd43e86c2ab5868d0fd929cec7b772336'],1,1,2,1497507,1,,,,3110
2e06919844f59904bcde423e02c59b66217dec6f,0,Colm O hEigeartaigh,2017-09-26 11:53:54+01:00,['77be4025894e976c7d145382f6b43ad56186b046'],13,13,26,1497533,1,,,,3110
51d918f68dc24a5be37b59d0db2709aef26eaf6f,0,Colm O hEigeartaigh,2017-09-26 13:21:14+01:00,['2e06919844f59904bcde423e02c59b66217dec6f'],7,8,15,1497548,2,,,,3110
23624c64f6ea7a8eec7aae72641ecd8ae96b38af,0,Colm O hEigeartaigh,2017-09-26 13:21:23+01:00,['51d918f68dc24a5be37b59d0db2709aef26eaf6f'],0,1,1,1497549,1,0,1,1,3110
d31aabe2fa3f21060a5ec7e8f0263d78c9f357e2,1,Sailaja Polavarapu,2017-09-26 13:53:49-07:00,['23624c64f6ea7a8eec7aae72641ecd8ae96b38af'],2,38,40,1497589,4,0,1,1,3110
17deef643ae1985e74a18273852e205df0b051a6,1,Sailaja Polavarapu,2017-09-26 14:11:49-07:00,['d31aabe2fa3f21060a5ec7e8f0263d78c9f357e2'],2,5,7,1497596,1,0,0,1,3110
a95606928d372f5214b0b55500408ad66a831bc0,1,pradeep,2017-09-27 09:34:22+05:18,['17deef643ae1985e74a18273852e205df0b051a6'],3,65,68,1497664,1,0,0,0,3110
a2145181e1ff3f3bfd922354e62ebd2034ad3aa8,0,peng.jianhua,2017-09-27 16:51:39+08:00,['a95606928d372f5214b0b55500408ad66a831bc0'],0,12,12,1497676,1,,,,3110
243b72965a26e5b2efbb77f00fb88d5ef2ca6b9c,0,Mehul Parikh,2017-09-27 16:32:49+05:18,['a2145181e1ff3f3bfd922354e62ebd2034ad3aa8'],180,179,359,1498035,2,1,0.25,0,3110
5b0fbac8846e9e97398e14307893caabd6ee60bc,1,Velmurugan Periasamy,2017-09-27 14:50:37-04:00,['243b72965a26e5b2efbb77f00fb88d5ef2ca6b9c'],11,52,63,1498098,3,0.095238095,0,0.761904762,3110
e47181f40d98c73b9486616a4d506d82fe7326e7,0,peng.jianhua,2017-09-28 15:58:37+08:00,['5b0fbac8846e9e97398e14307893caabd6ee60bc'],3,4,7,1498105,1,,,,3110
238374e2a9b8335cd94fa8824c87b465b089c933,0,peng.jianhua,2017-09-28 17:07:44+08:00,['e47181f40d98c73b9486616a4d506d82fe7326e7'],0,11,11,1498116,1,1,1,1,3110
da328b55127c48f24f830bd27a029f459c2f0e53,0,Colm O hEigeartaigh,2017-09-28 12:33:06+01:00,['238374e2a9b8335cd94fa8824c87b465b089c933'],1,1,2,1498118,1,,,,3110
a30c43db31bc0c6b69594e2fba0f243a94a789c6,0,Mehul Parikh,2017-09-28 19:40:27+05:18,['da328b55127c48f24f830bd27a029f459c2f0e53'],13,24,37,1498155,2,0,0,0,3110
f0cb6223d5111ac27c717d69e4cd2ef21db09f70,1,Mehul Parikh,2017-09-29 12:52:20+05:18,['a30c43db31bc0c6b69594e2fba0f243a94a789c6'],5,27,32,1498187,3,0,0,1,3110
9cdc1144f4938f666c80bd5cea6f2243492c71a3,0,Colm O hEigeartaigh,2017-10-02 12:33:01+01:00,['f0cb6223d5111ac27c717d69e4cd2ef21db09f70'],29,30,59,1498246,1,0,0.25,1,3110
2e363abc9bbfd6c5cdb45ffd672cb783654dc0da,0,Velmurugan Periasamy,2017-10-02 11:31:27-04:00,['9cdc1144f4938f666c80bd5cea6f2243492c71a3'],0,385,385,1498631,10,,,,3115
ffe32fef6e458627df7a29bdad218cb01176783a,1,Velmurugan Periasamy,2017-10-02 11:31:27-04:00,['2e363abc9bbfd6c5cdb45ffd672cb783654dc0da'],7,11,18,1498649,2,0,1,1,3115
11bf9152753fe20140b8143d437bc7bb4a2159af,0,Mehul Parikh,2017-10-04 11:28:58+05:18,['ffe32fef6e458627df7a29bdad218cb01176783a'],0,1,1,1498650,1,,,,3115
23046e9e81941060df0faa76984a64832a42f516,0,Mehul Parikh,2017-10-04 16:47:11+05:18,['11bf9152753fe20140b8143d437bc7bb4a2159af'],37,66,103,1498753,5,1,1,1,3115
de417e1851603e98c2acb0e6a81b0f2524256a06,1,peng.jianhua,2017-10-10 09:10:45+08:00,['23046e9e81941060df0faa76984a64832a42f516'],11,14,25,1498778,3,,,,3115
a341fa1af3e36c4809d5d834cafb6a3a8168ff4d,0,peng.jianhua,2017-10-10 09:36:08+08:00,['de417e1851603e98c2acb0e6a81b0f2524256a06'],2,2,4,1498782,1,,,,3115
ea9d66a249a169e2de8f90e0452a684c2629e762,1,zhangqiang2,2017-10-09 21:49:59-04:00,['a341fa1af3e36c4809d5d834cafb6a3a8168ff4d'],5,1,6,1498788,1,0,0,0,3115
e0c1e355a94cdecdf60e6d9eb0c54ff6d3bd412d,1,pradeep,2017-10-10 14:25:18+05:18,['ea9d66a249a169e2de8f90e0452a684c2629e762'],19,105,124,1498912,5,0.158730159,0.873015873,0.904761905,3115
7985dd473acb024e8f3c56c12af6608b0cecc3b6,1,Madhan Neethiraj,2017-10-10 22:20:24-07:00,['e0c1e355a94cdecdf60e6d9eb0c54ff6d3bd412d'],842,1578,2420,1501332,19,0.312236287,0.548523207,0.814345992,3117
eed9eb2b5cb19756cab3b9085f930634c7d9dcd5,1,Colm O hEigeartaigh,2017-10-11 09:39:17+01:00,['7985dd473acb024e8f3c56c12af6608b0cecc3b6'],37,20,57,1501389,1,0.25,0.25,0.25,3117
ca9b5f51241a802b0d28152779fe22412dd2f774,1,Mehul Parikh,2017-10-11 19:02:41+05:18,['eed9eb2b5cb19756cab3b9085f930634c7d9dcd5'],40,55,95,1501484,6,0,0.166666667,0.75,3117
478f5ffc737b4c238db67e844e88fd73c61dc5da,1,pradeep,2017-10-13 16:46:14+05:18,['ca9b5f51241a802b0d28152779fe22412dd2f774'],0,55,55,1501539,2,0,0,0.981481481,3117
2cc88970bea34cdeac92182572a5046f09a70306,0,peng.jianhua,2017-10-14 10:16:39+08:00,['478f5ffc737b4c238db67e844e88fd73c61dc5da'],6,7,13,1501552,1,,,,3117
d9f54d72ca7eec9eeeb4f12f5ebfa71b61b2acc0,1,Abhay Kulkarni,2017-10-14 17:03:02-07:00,['2cc88970bea34cdeac92182572a5046f09a70306'],51,57,108,1501660,3,0.714285714,0.714285714,0.142857143,3117
8d39dfe99051968055f0f46a9275f59a276fc84a,1,peng.jianhua,2017-10-16 14:54:18+08:00,['d9f54d72ca7eec9eeeb4f12f5ebfa71b61b2acc0'],5,12,17,1501677,1,,,,3117
a98dc785a61ee9bbb1cdb4f8caac5a87dd163ed1,0,pradeep,2017-10-16 18:28:20+05:18,['8d39dfe99051968055f0f46a9275f59a276fc84a'],1,4,5,1501682,1,0,0,0,3117
6014e64a0fcfe957f4a0ee7e52cc29139b63ac92,0,pradeep,2017-10-16 18:33:47+05:18,['a98dc785a61ee9bbb1cdb4f8caac5a87dd163ed1'],37,3,40,1501722,5,0,0,1,3117
a2e896da0989c90060e767338165b3ccf27f6c67,0,Abhay Kulkarni,2017-10-16 14:39:09-07:00,['6014e64a0fcfe957f4a0ee7e52cc29139b63ac92'],32,96,128,1501850,13,0.244444444,0.755555556,0.511111111,3117
c3fbdae9faf4e53816e9cc7b965f8a5aa59cf1e6,0,Abhay Kulkarni,2017-10-16 16:37:20-07:00,['a2e896da0989c90060e767338165b3ccf27f6c67'],2,2,4,1501854,1,,,,3117
c61f97a3d22c12c7817b0c441a2ba78b5465b3ee,0,Colm O hEigeartaigh,2017-10-17 10:33:26+01:00,['c3fbdae9faf4e53816e9cc7b965f8a5aa59cf1e6'],52,107,159,1502013,2,0,0.333333333,1,3117
97280ee10f8cb1c624e348227fc696adffa731ce,0,pradeep,2017-10-19 00:10:48+05:18,['c61f97a3d22c12c7817b0c441a2ba78b5465b3ee'],0,2,2,1502015,1,,,,3117
33bf690cc7d09aacd10fa9f12ba073e5e6e1e124,1,Abhay Kulkarni,2017-10-18 12:40:52-07:00,['97280ee10f8cb1c624e348227fc696adffa731ce'],43,120,163,1502178,1,0.244897959,0.571428571,0.673469388,3117
9e8bfb9c28cc8eee2972e62dd256e8aa9d933c1e,0,Colm O hEigeartaigh,2017-10-20 09:58:10+01:00,['33bf690cc7d09aacd10fa9f12ba073e5e6e1e124'],6,6,12,1502190,2,,,,3117
caf373daf8cce06c2fad7f6452756708e178cd38,0,Colm O hEigeartaigh,2017-10-20 15:19:59+01:00,['9e8bfb9c28cc8eee2972e62dd256e8aa9d933c1e'],1,27,28,1502218,2,0.461538462,0.461538462,1,3117
8d9bd5fbaeb5a555134de50d3bab3ec560267c6f,1,peng.jianhua,2017-10-23 09:44:36+08:00,['caf373daf8cce06c2fad7f6452756708e178cd38'],6,6,12,1502230,1,,,,3117
a4e69aab29a7c2362af26c0c46f8ed63d983370a,0,Mehul Parikh,2017-10-23 21:15:13+05:18,['8d9bd5fbaeb5a555134de50d3bab3ec560267c6f'],2,2,4,1502234,1,,,,3117
847e121f5e210638d292eee0cb9beef34a037927,1,Abhay Kulkarni,2017-10-23 16:38:17-07:00,['a4e69aab29a7c2362af26c0c46f8ed63d983370a'],80,162,242,1502476,9,0.166666667,0.803030303,0.681818182,3117
ba99369a82914101d0652d68056a0b48eb69eea1,0,Mehul Parikh,2017-10-24 11:50:43+05:18,['847e121f5e210638d292eee0cb9beef34a037927'],0,3,3,1502479,1,0,0,0,3117
79e91fa5f5175b3ddeab8d901f7e98697c9d639f,1,peng.jianhua,2017-10-24 16:20:02+08:00,['ba99369a82914101d0652d68056a0b48eb69eea1'],12,42,54,1502533,3,0,0.035714286,1,3117
6e6e42b0bffb67ad5613b99bf8f6dadbfeeca90b,1,peng.jianhua,2017-10-24 17:08:39+08:00,['79e91fa5f5175b3ddeab8d901f7e98697c9d639f'],3,2029,2032,1504565,26,0.278350515,0.626804124,0.775257732,3137
7fc74fccc9ab4e1b1f9a369b92e762afe241fcb3,0,Abhay Kulkarni,2017-10-24 11:09:01-07:00,['6e6e42b0bffb67ad5613b99bf8f6dadbfeeca90b'],8,26,34,1504599,7,1,0.625,0.875,3137
543b9ff006da4f64b951e2f6c0a6b16d9b703f22,0,zhangqiang2,2017-10-26 20:29:10-04:00,['7fc74fccc9ab4e1b1f9a369b92e762afe241fcb3'],3,5,8,1504607,1,,,,3137
e16fd4c338fc318c26721107107b12f414df79a3,0,zhangqiang2,2017-10-26 20:42:57-04:00,['543b9ff006da4f64b951e2f6c0a6b16d9b703f22'],12,7,19,1504626,2,,,,3137
454be055e496921c7384ada2cb1d00120c83bc48,0,zhangqiang2,2017-10-26 20:48:09-04:00,['e16fd4c338fc318c26721107107b12f414df79a3'],10,13,23,1504649,1,,,,3137
c1b9b90d1ba28b49791dac5877ef8ed643e3fc7b,0,peng.jianhua,2017-10-30 06:35:49+08:00,['454be055e496921c7384ada2cb1d00120c83bc48'],4,4,8,1504657,1,,,,3137
8dc5598c034017a22bacf9e6082aa1f4a7d6cc23,1,peng.jianhua,2017-10-30 06:40:57+08:00,['c1b9b90d1ba28b49791dac5877ef8ed643e3fc7b'],2,3,5,1504662,1,,,,3137
adffc001f44a38965860ce3e720d708ed13f8747,1,Abhay Kulkarni,2017-10-30 14:04:56-07:00,['8dc5598c034017a22bacf9e6082aa1f4a7d6cc23'],50,42,92,1504754,2,0,0,0,3137
a7163cb91dbf459c4e88025415ebab82a4a10f8b,0,Mehul Parikh,2017-10-31 10:44:50+05:18,['adffc001f44a38965860ce3e720d708ed13f8747'],1,5,6,1504760,1,1,1,1,3137
4c1e80e6bb4262a4e11dbf5dfe9b9aad00fabc14,0,peng.jianhua,2017-11-03 14:01:28+08:00,['a7163cb91dbf459c4e88025415ebab82a4a10f8b'],7,8,15,1504775,1,0,1,1,3137
45f40277c996ea754eb7efb995e73efaec311394,0,zhangqiang2,2017-11-03 04:21:00-04:00,['4c1e80e6bb4262a4e11dbf5dfe9b9aad00fabc14'],21,2,23,1504798,1,,,,3137
a62060fb08ab515c6251372098930dcfcd9bbdba,0,peng.jianhua,2017-11-03 16:42:15+08:00,['45f40277c996ea754eb7efb995e73efaec311394'],27,20,47,1504845,9,,,,3137
550cefcb6c7cd9009c123f8052cf6cc45ee6350b,0,zhangqiang2,2017-11-06 08:44:10-05:00,['a62060fb08ab515c6251372098930dcfcd9bbdba'],2,2,4,1504849,1,,,,3137
29d9322ec4a0e12650d4be1e569a945ddde9dfcd,0,Colm O hEigeartaigh,2017-11-07 15:30:03+00:00,['550cefcb6c7cd9009c123f8052cf6cc45ee6350b'],1,6,7,1504856,1,,,,3137
54c87fec53986dbe6e798aeab8e2a1d628c280b3,0,Colm O hEigeartaigh,2017-11-08 09:49:16+00:00,['29d9322ec4a0e12650d4be1e569a945ddde9dfcd'],0,2,2,1504858,1,,,,3137
44691b556dfe427d0c873c4f6537f55fa207a28c,0,peng.jianhua,2017-11-09 10:48:28+08:00,['54c87fec53986dbe6e798aeab8e2a1d628c280b3'],0,1758,1758,1506616,8,0.952054795,1,0.979452055,3144
502f3cea682013f5ca4ea5e702f887aabc60e538,0,zhangqiang2,2017-11-09 04:26:28-05:00,['44691b556dfe427d0c873c4f6537f55fa207a28c'],2,9,11,1506627,1,,,,3144
b3dc7bd42f4144be258265d22040cecef0bc2ee3,0,Colm O hEigeartaigh,2017-11-09 09:51:12+00:00,['502f3cea682013f5ca4ea5e702f887aabc60e538'],0,16,16,1506643,1,,,,3145
f8931ff65721a49cfd7998522f75774bb3e861e6,0,Mehul Parikh,2017-11-09 18:45:07+05:18,['b3dc7bd42f4144be258265d22040cecef0bc2ee3'],0,4,4,1506647,2,0.75,0.75,0.5,3145
0688f5eb7378a120830571260bf483949ccd4a74,1,Abhay Kulkarni,2017-11-09 08:14:17-08:00,['f8931ff65721a49cfd7998522f75774bb3e861e6'],0,1,1,1506648,1,0,0,1,3145
2a1406df8125b96b3051616cb61ba01fc96f93c3,1,Abhay Kulkarni,2017-11-10 07:34:34-08:00,['0688f5eb7378a120830571260bf483949ccd4a74'],733,1967,2700,1509348,18,0.282051282,0.282051282,0.752136752,3149
98cb80e3335e7c9588b9ad5b57667d3421fba4e6,1,Abhay Kulkarni,2017-11-10 19:21:15-08:00,['2a1406df8125b96b3051616cb61ba01fc96f93c3'],20,56,76,1509424,1,0.090909091,0.090909091,1,3149
576b62ad0e9ec4ae6de270a4531eb7eb162d6d8e,0,Colm O hEigeartaigh,2017-11-14 10:26:55+00:00,['98cb80e3335e7c9588b9ad5b57667d3421fba4e6'],142,81,223,1509647,5,1,0,0,3150
58fc47e6247500f8c67c55d933ce99c3c47a97ef,0,Mehul Parikh,2017-11-15 10:04:47+05:18,['576b62ad0e9ec4ae6de270a4531eb7eb162d6d8e'],3,8,11,1509658,2,0,0,1,3150
e65235d1cb52267be16d6b033532d88692fde12f,0,peng.jianhua,2017-11-15 13:51:57+08:00,['58fc47e6247500f8c67c55d933ce99c3c47a97ef'],1,1,2,1509660,1,,,,3150
81d1584a2c8337e5fca81bf5cc237c3e66666e4e,0,Abhay Kulkarni,2017-11-17 16:26:47-08:00,['e65235d1cb52267be16d6b033532d88692fde12f'],16,15,31,1509691,1,,,,3150
6f4e28639ad431cc0073e1af4ed591035d92b734,0,peng.jianhua,2017-11-20 09:40:04+08:00,['81d1584a2c8337e5fca81bf5cc237c3e66666e4e'],3,2,5,1509696,1,,,,3150
10051777edf21c5ab7914c0670e23040d105dc4c,1,Madhan Neethiraj,2017-11-20 02:43:09-08:00,['6f4e28639ad431cc0073e1af4ed591035d92b734'],89,132,221,1509917,5,0,0.023809524,1,3150
8ab766846538ddcb3dd56dc11c174c6a8e3ad83c,1,zhangqiang2,2017-11-20 19:13:21-05:00,['10051777edf21c5ab7914c0670e23040d105dc4c'],2,3,5,1509922,1,1,1,1,3150
41e220381fecb3fcb184b0227152f4e77078ab1c,0,Colm O hEigeartaigh,2017-11-21 16:01:27+00:00,['8ab766846538ddcb3dd56dc11c174c6a8e3ad83c'],57,17,74,1509996,3,1,0.866666667,0,3150
ad2731811d56a2fa357cf06bea5e5c2f1fc1b98d,0,peng.jianhua,2017-11-22 10:34:11+08:00,['41e220381fecb3fcb184b0227152f4e77078ab1c'],29,358,387,1510383,5,0.564935065,0.564935065,1,3154
906613684d0662b22448435fe794b08b217d7021,0,peng.jianhua,2017-11-23 09:49:49+08:00,['ad2731811d56a2fa357cf06bea5e5c2f1fc1b98d'],28,30,58,1510441,2,0,0,1,3154
5824fdc819bf41736ec5d2798ffaa7aba24c8cc7,0,peng.jianhua,2017-11-24 09:07:25+08:00,['906613684d0662b22448435fe794b08b217d7021'],20,0,20,1510461,1,,,,3154
21f8b63f5d0c6e422bc19adb515ba8a542955ab5,0,zhangqiang2,2017-11-23 20:13:55-05:00,['5824fdc819bf41736ec5d2798ffaa7aba24c8cc7'],2,9,11,1510472,2,,,,3154
b70479c4fe1abadf9d94d07a995e0c988dc5ad1c,0,Colm O hEigeartaigh,2017-11-28 09:58:22+00:00,['21f8b63f5d0c6e422bc19adb515ba8a542955ab5'],25,0,25,1510497,2,,,,3154
1e77fa2a4be3425f97d5711ebb0de5db8258c618,0,Abhay Kulkarni,2017-11-28 17:31:37-08:00,['b70479c4fe1abadf9d94d07a995e0c988dc5ad1c'],5,199,204,1510701,3,0.565217391,0.565217391,1,3155
4c2bed53607de1fe8d3565f7a79dc807f6a5008a,0,peng.jianhua,2017-12-01 14:34:36+08:00,['1e77fa2a4be3425f97d5711ebb0de5db8258c618'],5,0,5,1510706,1,,,,3155
fb0b6f6abd06ad051d53fe67ed62a2aaedf518ed,0,zhangqiang2,2017-12-01 01:48:48-05:00,['4c2bed53607de1fe8d3565f7a79dc807f6a5008a'],5,0,5,1510711,1,,,,3155
879a4dfddca4218148a738ef20001b020f4b9f3e,0,zhangqiang2,2017-12-04 19:54:56-05:00,['fb0b6f6abd06ad051d53fe67ed62a2aaedf518ed'],1,1,2,1510713,1,,,,3155
370cb4fc6c634f5eaccb91727ae8fe1b2b262ea1,1,Madhan Neethiraj,2017-12-05 16:43:23-08:00,['879a4dfddca4218148a738ef20001b020f4b9f3e'],20,1877,1897,1512610,6,0.457399103,0.780269058,0.551569507,3158
9260e0de099d1c4c092c276217088b7512db134a,1,peng.jianhua,2017-12-06 10:24:38+08:00,['370cb4fc6c634f5eaccb91727ae8fe1b2b262ea1'],1,8,9,1512619,4,,,,3158
44538159464b1357ed6862c5462ae7a4d48a0b8b,0,peng.jianhua,2017-12-07 09:47:25+08:00,['9260e0de099d1c4c092c276217088b7512db134a'],11,5,16,1512635,1,1,1,1,3158
650b24e5d38c20c20869c0158ed9f35818e79bd0,0,peng.jianhua,2017-12-07 10:00:52+08:00,['44538159464b1357ed6862c5462ae7a4d48a0b8b'],8,5,13,1512648,1,0,0,0,3158
03b052e2ca543ef4724f7b23807ee9bebf0ff34c,0,Colm O hEigeartaigh,2017-12-07 10:14:18+00:00,['650b24e5d38c20c20869c0158ed9f35818e79bd0'],22,0,22,1512670,3,,,,3158
d7557cd01e3a7aacc295c297655753923ac7599a,0,Colm O hEigeartaigh,2017-12-07 10:15:12+00:00,['03b052e2ca543ef4724f7b23807ee9bebf0ff34c'],11,1,12,1512682,2,,,,3158
87428c93c69abf834b9d0814210a9493e5390c1f,0,Colm O hEigeartaigh,2017-12-07 10:15:48+00:00,['d7557cd01e3a7aacc295c297655753923ac7599a'],15,0,15,1512697,1,,,,3158
291bb3e9c2e67a5bacad40f397382e6b896f96a2,1,Colm O hEigeartaigh,2017-12-07 10:16:49+00:00,['87428c93c69abf834b9d0814210a9493e5390c1f'],7,1,8,1512705,1,,,,3158
c806d17779144df3d0c60402a03cb167e69c1582,0,Velmurugan Periasamy,2017-12-07 08:31:47-05:00,['291bb3e9c2e67a5bacad40f397382e6b896f96a2'],35,788,823,1513528,11,0.85440613,1,0.977011494,3165
9750aa3d96336a352a7219cd9041978532642009,1,Velmurugan Periasamy,2017-12-07 08:34:35-05:00,['c806d17779144df3d0c60402a03cb167e69c1582'],55,48,103,1513631,1,1,1,0,3165
2fa6f6ce6255e3a49756a02c65a018b61d1ad9f4,1,Velmurugan Periasamy,2017-12-07 09:49:14-05:00,['9750aa3d96336a352a7219cd9041978532642009'],7,8,15,1513646,2,,,,3165
f79737bb284fd0671a6ad05ccc4c1d16fd4e1603,0,pradeep,2017-12-07 20:46:18+05:18,['2fa6f6ce6255e3a49756a02c65a018b61d1ad9f4'],14,49,63,1513709,2,,,,3165
e2c52d62b100e0ed2b2ce3e47dc8a9ee0aab19d6,0,Colm O hEigeartaigh,2017-12-07 15:42:17+00:00,['f79737bb284fd0671a6ad05ccc4c1d16fd4e1603'],4,1,5,1513714,1,,,,3165
c7260c3eeee0b9f33f01a166b1be5ee6540a10d7,0,Velmurugan Periasamy,2017-12-07 11:07:40-05:00,['e2c52d62b100e0ed2b2ce3e47dc8a9ee0aab19d6'],788,35,823,1514537,11,0.14559387,0,0.022988506,3165
e8afb9faad81e7042877aa528635848a0043cb0c,1,Abhay Kulkarni,2017-12-07 17:29:41-08:00,['c7260c3eeee0b9f33f01a166b1be5ee6540a10d7'],806,679,1485,1516022,24,1,1,0,3167
b8c70c41b9728f9abb22b8cde66cc09ee8dc0845,0,Colm O hEigeartaigh,2017-12-08 12:40:49+00:00,['e8afb9faad81e7042877aa528635848a0043cb0c'],455,0,455,1516477,2,0.526315789,0.229323308,0.293233083,3167
d22398bb4e5ef2efe15d9d55e56e08c0bf37a8b6,0,Colm O hEigeartaigh,2017-12-11 10:37:37+00:00,['b8c70c41b9728f9abb22b8cde66cc09ee8dc0845'],0,1,1,1516478,1,,,,3167
c4020f89b929f323d133fbe81d2571deca29f934,0,Zsombor Gegesy,2017-12-11 13:06:41+01:00,['d22398bb4e5ef2efe15d9d55e56e08c0bf37a8b6'],0,12,12,1516490,1,,,,3167
59b457a451fd0d1b78b658405ad936b5f6f3135a,0,Colm O hEigeartaigh,2017-12-12 09:52:50+00:00,['c4020f89b929f323d133fbe81d2571deca29f934'],28,2,30,1516520,2,,,,3167
30b8ddfbdc946c4a3e07da0121c29e0da1db2587,0,Colm O hEigeartaigh,2017-12-12 09:53:05+00:00,['59b457a451fd0d1b78b658405ad936b5f6f3135a'],15,0,15,1516535,2,,,,3167
58f513215da421a4015e2d080e88d8fdacad3471,0,Colm O hEigeartaigh,2017-12-12 09:53:20+00:00,['30b8ddfbdc946c4a3e07da0121c29e0da1db2587'],15,0,15,1516550,3,,,,3167
d1ee6a578e4d3268bdb220cdb73f481d7403fbc2,0,zhangqiang2,2017-12-14 07:07:09-05:00,['58f513215da421a4015e2d080e88d8fdacad3471'],2,0,2,1516552,2,,,,3167
cd67d7295a95049646c44c3bcf1fdd04895eff5d,0,zhangqiang2,2017-12-14 07:09:06-05:00,['d1ee6a578e4d3268bdb220cdb73f481d7403fbc2'],10,0,10,1516562,4,,,,3167
dec65f164f06c04947c1823f91da7482f9a8067e,0,Abhay Kulkarni,2017-12-14 14:01:20-08:00,['cd67d7295a95049646c44c3bcf1fdd04895eff5d'],296,45,341,1516903,6,0.890410959,0.890410959,0.143835616,3167
ca8f0b76404db53a4b0bdb4f697d14e7adeff175,0,Colm O hEigeartaigh,2017-12-15 16:17:33+00:00,['dec65f164f06c04947c1823f91da7482f9a8067e'],1,1,2,1516905,1,,,,3167
0e5b0775258a251d1846dd9622f234b8b46df742,0,Colm O hEigeartaigh,2017-12-15 16:17:46+00:00,['ca8f0b76404db53a4b0bdb4f697d14e7adeff175'],1,1,2,1516907,1,,,,3167
46164b7514891c67e617ec64bbd770668ef79c89,1,Velmurugan Periasamy,2017-12-18 19:39:29-05:00,['0e5b0775258a251d1846dd9622f234b8b46df742'],35,784,819,1517726,11,0.853281853,1,0.976833977,3174
bba925d48e6381b40c34f3364aa34020a984e284,1,Velmurugan Periasamy,2017-12-18 19:39:39-05:00,['46164b7514891c67e617ec64bbd770668ef79c89'],6,16,22,1517748,3,,,,3174
bd3c1bc7b4869957a3e33320831da0f4938daafe,0,Velmurugan Periasamy,2017-12-18 19:39:53-05:00,['bba925d48e6381b40c34f3364aa34020a984e284'],2,9,11,1517759,2,0,0,1,3174
e71b452f68104922c3c49e18ce99b5d86d9f1084,0,Colm O hEigeartaigh,2017-12-19 12:29:20+00:00,['bd3c1bc7b4869957a3e33320831da0f4938daafe'],3,3,6,1517765,1,,,,3174
567d2c9149dbb625ba65d2668178210eaf1932a2,0,Colm O hEigeartaigh,2017-12-20 11:08:22+00:00,['e71b452f68104922c3c49e18ce99b5d86d9f1084'],109,31,140,1517905,2,0.577777778,0,0,3174
6841f14d563e00e3f94c4dc979528c885d1f1dfe,0,Colm O hEigeartaigh,2017-12-20 11:10:19+00:00,['567d2c9149dbb625ba65d2668178210eaf1932a2'],31,109,140,1518045,2,0.422222222,1,1,3174
f1fb6315f0d4cbc1c32b93d7951fb99ea376c73a,1,Mehul Parikh,2017-12-20 17:31:22+05:18,['6841f14d563e00e3f94c4dc979528c885d1f1dfe'],133,321,454,1518499,7,0,0,0.487179487,3174
52a303218224610d4b7b34f745bacfadaea1420c,0,zhangqiang2,2017-12-20 20:23:19-05:00,['f1fb6315f0d4cbc1c32b93d7951fb99ea376c73a'],6,8,14,1518513,1,0,0,1,3174
3e1168ddb6b322d57d56ebc5c8d87b006df15aa6,1,peng.jianhua,2017-12-21 09:39:43+08:00,['52a303218224610d4b7b34f745bacfadaea1420c'],1,1,2,1518515,1,,,,3174
4ef52b46b1e6dd7bc1991a05b8256984d30a6c58,1,zhangqiang2,2017-12-20 20:45:24-05:00,['3e1168ddb6b322d57d56ebc5c8d87b006df15aa6'],1,436,437,1518952,7,0.471544715,0.756097561,0.991869919,3178
a1c14e3507981968e366924667fa47079208dfda,0,rmani,2017-12-22 10:31:42-08:00,['4ef52b46b1e6dd7bc1991a05b8256984d30a6c58'],20,33,53,1519005,1,0,0,1,3178
12d9e21ac27edb5a23c7505ecb07b47c987bcbdd,0,Velmurugan Periasamy,2018-01-02 15:13:22-05:00,['a1c14e3507981968e366924667fa47079208dfda'],18,18,36,1519041,1,,,,3178
252af49103e8a93517b402be31d7c2822204ff73,1,Abhay Kulkarni,2018-01-03 13:31:25-08:00,['12d9e21ac27edb5a23c7505ecb07b47c987bcbdd'],8,1,9,1519050,1,1,1,0,3178
5da7000f82e8c052aef23bcbdb89dcfc108d6aa3,0,peng.jianhua,2018-01-04 10:55:50+08:00,['252af49103e8a93517b402be31d7c2822204ff73'],1,1,2,1519052,1,,,,3178
d02cdaee6069f5ae350115f46543f7c2da00e4f5,0,peng.jianhua,2018-01-04 10:58:35+08:00,['5da7000f82e8c052aef23bcbdb89dcfc108d6aa3'],4,4,8,1519060,1,,,,3178
b35551124f765d3129eca6922102b29ae6c87586,1,Mehul Parikh,2018-01-04 17:24:52+05:18,['d02cdaee6069f5ae350115f46543f7c2da00e4f5'],5,21,26,1519086,2,0.3125,1,1,3178
7d39a737c6fc873891930e08b364a0e8944a41c9,0,Colm O hEigeartaigh,2018-01-09 16:01:24+00:00,['b35551124f765d3129eca6922102b29ae6c87586'],1,1,2,1519088,1,,,,3178
8db0cec1b7449529a84d3026411a9116a05c6d8a,0,Colm O hEigeartaigh,2018-01-13 11:49:49+00:00,['7d39a737c6fc873891930e08b364a0e8944a41c9'],0,1,1,1519089,1,,,,3178
8ef10c06114fb46f8cea3b3e8f6b2f852a0fb842,1,pradeep,2018-01-17 11:50:53+05:18,['8db0cec1b7449529a84d3026411a9116a05c6d8a'],0,5575,5575,1524664,5,,,,3182
13d1b185f5d59a0ca4d2cf7fe835f840a7001f02,1,pradeep,2018-01-17 12:10:54+05:18,['8ef10c06114fb46f8cea3b3e8f6b2f852a0fb842'],5,17,22,1524686,2,1,1,1,3182
0d9d8aed2b9e3caddfb077b4a122e09982e1c0e0,1,Sailaja Polavarapu,2018-01-18 12:25:46-08:00,['13d1b185f5d59a0ca4d2cf7fe835f840a7001f02'],23,30,53,1524739,1,0,0,1,3182
1a5eba44657e8b6b85322a26725ba7ad23a294ee,0,pradeep,2018-01-22 13:56:56+05:18,['0d9d8aed2b9e3caddfb077b4a122e09982e1c0e0'],8,0,8,1524747,1,1,1,0,3182
a0b11d6217312dcf43effbb91792c3ef370572f4,0,rmani,2018-01-22 17:09:45-08:00,['1a5eba44657e8b6b85322a26725ba7ad23a294ee'],1,1,2,1524749,1,,,,3182
533f8dae644a833dd2d0df2eb7ea4d2c7f9f92f6,1,rmani,2018-01-22 17:12:20-08:00,['a0b11d6217312dcf43effbb91792c3ef370572f4'],1,1,2,1524751,1,,,,3182
c57afe81289a458a8ba122c0e2f88b8ef88f0f43,0,rmani,2018-01-22 17:13:25-08:00,['533f8dae644a833dd2d0df2eb7ea4d2c7f9f92f6'],1,1,2,1524753,1,,,,3182
7968836177a4ba1ba872fbb16518bed03e805193,1,Abhay Kulkarni,2018-01-24 13:08:25-08:00,['c57afe81289a458a8ba122c0e2f88b8ef88f0f43'],1140,680,1820,1526573,23,0.96656535,0.817629179,0,3182
ab4793bce7469bcc80e5a99b0f764f1fbf755efc,0,Mehul Parikh,2018-01-25 09:39:45+05:18,['7968836177a4ba1ba872fbb16518bed03e805193'],2,26,28,1526601,4,0.666666667,1,1,3182
e23977ce61ece178d37b97f95d5353fda53ab71b,1,Mehul Parikh,2018-01-25 16:32:32+05:18,['ab4793bce7469bcc80e5a99b0f764f1fbf755efc'],52,36,88,1526689,19,0.909090909,0.727272727,0,3182
af6b8c4f3d27b2a5adf37b509c036ab3ba63cb75,0,Colm O hEigeartaigh,2018-01-30 09:52:50+00:00,['e23977ce61ece178d37b97f95d5353fda53ab71b'],8,12,20,1526709,1,0,0,1,3182
9da43c7e07ba5eaba31cfd7a4bf4727f9021395c,1,Abhay Kulkarni,2018-01-30 12:00:15-08:00,['af6b8c4f3d27b2a5adf37b509c036ab3ba63cb75'],2,533,535,1527244,3,0.153846154,0.153846154,1,3183
d259ed9da390d09d9a4cb350911d2e2920c6416d,0,Zsombor Gegesy,2018-02-05 10:54:05+01:00,['9da43c7e07ba5eaba31cfd7a4bf4727f9021395c'],1,1,2,1527246,1,,,,3183
9ea96d9f4913bdf05a5656528de9b8424c9daa79,0,Colm O hEigeartaigh,2018-02-05 14:04:38+00:00,['d259ed9da390d09d9a4cb350911d2e2920c6416d'],0,12,12,1527258,1,,,,3183
dab9ed6e0f5d922bbd389358f7eaee66f2aa0fcb,0,Colm O hEigeartaigh,2018-02-05 14:05:01+00:00,['9ea96d9f4913bdf05a5656528de9b8424c9daa79'],0,1,1,1527259,1,,,,3183
75b8a422cfe8ab8f9896720a98ac8bd739c065a1,1,Colm O hEigeartaigh,2018-02-05 14:57:20+00:00,['dab9ed6e0f5d922bbd389358f7eaee66f2aa0fcb'],289,278,567,1527826,21,0.5,0.5,0,3183
f5c15d40b57adc68bed84f3dc89af8038c6bff19,0,Abhay Kulkarni,2018-02-05 11:15:10-08:00,['75b8a422cfe8ab8f9896720a98ac8bd739c065a1'],3,11,14,1527840,2,0,1,1,3183
2de803d1241244a38d30cdb762df3b2608b045da,0,Colm O hEigeartaigh,2018-02-07 15:02:14+00:00,['f5c15d40b57adc68bed84f3dc89af8038c6bff19'],121,43,164,1528004,5,0.577777778,0,0,3183
adea501cdade780bf78360c65904fa0ce8104acb,1,Velmurugan Periasamy,2018-02-08 09:52:56-05:00,['2de803d1241244a38d30cdb762df3b2608b045da'],19,43,62,1528066,2,,,,3183
886a9c6e196b12bc8cc0ae49a6d8e9bd8c244152,0,Selvamohan Neethiraj,2018-02-10 12:40:52-05:00,['adea501cdade780bf78360c65904fa0ce8104acb'],1,1,2,1528068,1,,,,3183
ea30b1355a6184098e803f4cbd59f2e8ec93cb9e,0,Selvamohan Neethiraj,2018-02-12 12:27:51-05:00,['886a9c6e196b12bc8cc0ae49a6d8e9bd8c244152'],3,3,6,1528074,2,,,,3184
1ab501c3bce92d4f6c9d4a5b9168dd34c0310289,1,Madhan Neethiraj,2018-02-12 13:59:54-08:00,['ea30b1355a6184098e803f4cbd59f2e8ec93cb9e'],678,805,1483,1529557,24,0,0,1,3186
740c150b0d1bc716464c2bce1509a3b2c9f8cc07,0,pradeep,2018-02-13 09:12:20+05:18,['1ab501c3bce92d4f6c9d4a5b9168dd34c0310289'],1,1,2,1529559,1,,,,3186
ef214a010d9a99afb7522e413722f2b788df3664,1,pradeep,2018-02-13 09:14:03+05:18,['740c150b0d1bc716464c2bce1509a3b2c9f8cc07'],10,8,18,1529577,3,,,,3186
0c339bdf4577de3ea066ab4ef5e4a18424b875ae,0,pradeep,2018-02-13 09:24:24+05:18,['ef214a010d9a99afb7522e413722f2b788df3664'],1,1,2,1529579,1,,,,3186
ded33518f3bfb153b10c770ffb82dc835c1fc18b,1,Abhay Kulkarni,2018-02-14 13:04:44-08:00,['0c339bdf4577de3ea066ab4ef5e4a18424b875ae'],52,57,109,1529688,6,0,0.571428571,0.857142857,3186
3286f6a55eeb6e5c6d5ecc949373d77916d9a278,0,Abhay Kulkarni,2018-02-20 16:32:19-08:00,['ded33518f3bfb153b10c770ffb82dc835c1fc18b'],9,21,30,1529718,1,1,1,1,3186
9b1ddbf3ffe2ecbbb0912e533c9c5a321dbd37e9,1,Mehul Parikh,2018-02-21 18:07:42+05:18,['3286f6a55eeb6e5c6d5ecc949373d77916d9a278'],25,133,158,1529876,8,0.195402299,0,1,3186
605691882e08771c96371715f52bc34380dd4d27,0,Mehul Parikh,2018-02-22 15:29:15+05:18,['9b1ddbf3ffe2ecbbb0912e533c9c5a321dbd37e9'],1,5,6,1529882,1,0,0,1,3186
6239cb1a96b65f9d3cadbaeebab7e1aecd03343f,1,Mehul Parikh,2018-02-22 15:42:07+05:18,['605691882e08771c96371715f52bc34380dd4d27'],1,9,10,1529892,2,,,,3186
7514a9102b6649f0043220e0708a71d1ec6d0c77,0,Zsombor Gegesy,2018-02-24 11:13:38+01:00,['6239cb1a96b65f9d3cadbaeebab7e1aecd03343f'],1,1,2,1529894,1,,,,3186
04b4e167b14d768a160d4342ed12302f9449994f,1,Zsombor Gegesy,2018-02-24 17:22:55+01:00,['7514a9102b6649f0043220e0708a71d1ec6d0c77'],1,1,2,1529896,1,,,,3186
625cd35a49c772a7df44ae65ba02b0129e98c9f9,1,pradeep,2018-02-26 09:51:11+05:18,['04b4e167b14d768a160d4342ed12302f9449994f'],71,159,230,1530126,13,0,0,0.619047619,3186
44b3738480032c5304aa3f1c2d75e6808d31cc65,1,Mehul Parikh,2018-02-27 14:08:57+05:18,['625cd35a49c772a7df44ae65ba02b0129e98c9f9'],63,1940,2003,1532129,44,0.602465331,0.690292758,0.955315871,3198
7954cbbcd90500ec90d425aa20ca7e2fba34d695,0,Mehul Parikh,2018-02-27 14:52:19+05:18,['44b3738480032c5304aa3f1c2d75e6808d31cc65'],2,2,4,1532133,2,,,,3198
2626e5ccf03860de96b25b428eb4e64a4447cb8c,1,Abhay Kulkarni,2018-02-27 16:40:13-08:00,['7954cbbcd90500ec90d425aa20ca7e2fba34d695'],960,793,1753,1533886,26,1,1,0,3200
49b8a7a26653b028b7adaff3809a88f59fee3bf7,1,Zsombor Gegesy,2018-02-28 11:02:23+01:00,['2626e5ccf03860de96b25b428eb4e64a4447cb8c'],90,75,165,1534051,9,0.8,1,0,3200
9ed210470bbc447d1fbacd9b98421309394061b0,1,Abhay Kulkarni,2018-02-28 12:59:58-08:00,['49b8a7a26653b028b7adaff3809a88f59fee3bf7'],64,283,347,1534398,4,0.129032258,0.251612903,1,3201
91a437a29cd58902dc49b422e0421e36c7a07039,0,Mehul Parikh,2018-03-01 10:02:58+05:18,['9ed210470bbc447d1fbacd9b98421309394061b0'],12,24,36,1534434,2,0,0.466666667,1,3201
dcba4bc40a795156fbac8b747e339dc34a23bec7,0,zhangqiang2,2018-03-02 08:57:20+08:00,['91a437a29cd58902dc49b422e0421e36c7a07039'],10,16,26,1534460,1,1,1,1,3201
d3fffd00dc2846e381cef4a43a31dbabf8f323bd,1,Zsombor Gegesy,2018-03-02 11:33:23+01:00,['dcba4bc40a795156fbac8b747e339dc34a23bec7'],15,100,115,1534575,9,0.609756098,0.219512195,1,3202
6cc62086795a212516b69fd09a1c2ef7a6761e5d,1,Madhan Neethiraj,2018-03-02 11:33:26-08:00,['d3fffd00dc2846e381cef4a43a31dbabf8f323bd'],78,344,422,1534997,18,0.416666667,0.416666667,0.990740741,3203
9a3d4e306b5e536e294cb20fb67664e2e0b7a7f8,1,Madhan Neethiraj,2018-03-02 11:33:26-08:00,['6cc62086795a212516b69fd09a1c2ef7a6761e5d'],1057,801,1858,1536855,6,1,1,1,3203
70379200545a8cd859f9f163da4a4327001f84c1,0,Sailaja Polavarapu,2018-03-02 11:53:28-08:00,['9a3d4e306b5e536e294cb20fb67664e2e0b7a7f8'],48,48,96,1536951,48,,,,3203
844315cdbc5e4589f5a4f873c33533d8f7bb014e,1,Abhay Kulkarni,2018-03-04 22:08:21-08:00,['70379200545a8cd859f9f163da4a4327001f84c1'],825,4738,5563,1542514,60,0.266792216,0.258631513,0.727558067,3221
19d6ef464a39394869ddf49e49c8e39dce96a8a0,0,Abhay Kulkarni,2018-03-05 09:26:19-08:00,['844315cdbc5e4589f5a4f873c33533d8f7bb014e'],1,1,2,1542516,1,,,,3221
52f5249bbdc7f1bd8c8b3aa91d2040a9f63c47ee,1,Sailaja Polavarapu,2018-03-05 16:05:34-08:00,['19d6ef464a39394869ddf49e49c8e39dce96a8a0'],119,2173,2292,1544808,39,0.659914712,0.793176972,0.979744136,3239
f96a9276f1b3ed920735e550a5c1cfe5cf560fe7,1,Abhay Kulkarni,2018-03-05 17:02:57-08:00,['52f5249bbdc7f1bd8c8b3aa91d2040a9f63c47ee'],21,12,33,1544841,1,1,1,0,3239
0ae46b7467594bb01038dac0bc240743cfb4f5ef,0,zhangqiang2,2018-03-06 17:05:08+08:00,['f96a9276f1b3ed920735e550a5c1cfe5cf560fe7'],6,3,9,1544850,1,,,,3239
4d05b1560b5aab4f0df5d43c6a8f10ed98404da0,1,pradeep,2018-03-06 17:38:28+05:18,['0ae46b7467594bb01038dac0bc240743cfb4f5ef'],74,430,504,1545354,28,0.520547945,0.876712329,0.917808219,3241
fa104ec32a00661ed82bc9675460c41e3647e62b,1,pradeep,2018-03-06 18:08:13+05:18,['4d05b1560b5aab4f0df5d43c6a8f10ed98404da0'],13,187,200,1545554,7,0.6,1,0.908333333,3241
4319dea618c97f5f2bc47e6e3152267d6b7c52eb,0,Colm O hEigeartaigh,2018-03-06 14:16:04+00:00,['fa104ec32a00661ed82bc9675460c41e3647e62b'],1,1,2,1545556,1,,,,3241
a9fbbcafa75b48ccfac28544c624bdef7b6ae081,0,Sailaja Polavarapu,2018-03-06 11:05:30-08:00,['4319dea618c97f5f2bc47e6e3152267d6b7c52eb'],3,29,32,1545588,3,0,0,1,3241
1d4afbe57a86bf025b00b0e2c93793d355a9096d,0,Abhay Kulkarni,2018-03-06 15:33:29-08:00,['a9fbbcafa75b48ccfac28544c624bdef7b6ae081'],4,15,19,1545607,1,0.5,0.5,1,3241
2109fe04db224ae91cd9aa98c66cef0af4116d63,0,pradeep,2018-03-07 09:08:59+05:18,['1d4afbe57a86bf025b00b0e2c93793d355a9096d'],8,7,15,1545622,1,0,1,0,3241
06bf91715310915cc5e124ead572c4ee866b59d3,0,pradeep,2018-03-07 09:09:04+05:18,['2109fe04db224ae91cd9aa98c66cef0af4116d63'],21,30,51,1545673,1,1,1,1,3241
8f1625c26bc0dcd8970867c25b6be0b5afbbcb0f,1,pradeep,2018-03-07 09:09:11+05:18,['06bf91715310915cc5e124ead572c4ee866b59d3'],11,63,74,1545747,3,0.133333333,0.133333333,1,3241
e1346179aae59ffc3b3319cfa643f39e9aef863b,0,Zsombor Gegesy,2018-03-07 10:57:51+01:00,['8f1625c26bc0dcd8970867c25b6be0b5afbbcb0f'],2,2,4,1545751,2,,,,3241
809a78b4a9549ac1d28ae600fc23e769c50ede20,1,pradeep,2018-03-07 18:00:18+05:18,['e1346179aae59ffc3b3319cfa643f39e9aef863b'],53,130,183,1545934,9,0.297297297,0.297297297,1,3241
14a0b8ebbe9baf8ad9ea4855187de0ee1e49e708,0,Velmurugan Periasamy,2018-03-08 05:49:19-05:00,['809a78b4a9549ac1d28ae600fc23e769c50ede20'],1,0,1,1545935,1,,,,3241
c85ef54762b94b77fe7ef7b71a97a7acea7e8b26,0,Gautam Borad,2018-03-08 19:30:22+05:18,['14a0b8ebbe9baf8ad9ea4855187de0ee1e49e708'],5,25,30,1545965,2,0.714285714,0.714285714,1,3241
aca4c3b5438e0e52b1e2d24a7e322278d36c7ffc,0,Abhay Kulkarni,2018-03-08 11:00:31-08:00,['c85ef54762b94b77fe7ef7b71a97a7acea7e8b26'],14,83,97,1546062,3,1,1,0,3241
69f4d32da7c1dc2754147cb673aae0eb044e7779,1,Abhay Kulkarni,2018-03-08 11:11:24-08:00,['aca4c3b5438e0e52b1e2d24a7e322278d36c7ffc'],23,96,119,1546181,5,0.511627907,0.511627907,0.23255814,3241
12cfce0010501844baa8bb63c5b6f3138f38d582,1,rmani,2018-03-08 16:10:10-08:00,['69f4d32da7c1dc2754147cb673aae0eb044e7779'],0,10,10,1546191,1,,,,3241
8888b6285fba7373df8b00a0dd5b0ac0c4b17aea,1,pradeep,2018-03-09 13:30:00+05:18,['12cfce0010501844baa8bb63c5b6f3138f38d582'],20,264,284,1546475,12,0.424778761,0.646017699,0.681415929,3242
2b1143abac2a665bbefbbfcd17b57390094a7a2b,1,peng.jianhua,2018-03-11 08:17:47+08:00,['8888b6285fba7373df8b00a0dd5b0ac0c4b17aea'],4,2026,2030,1548505,24,0.278884462,0.707171315,0.71314741,3261
a7d51d496d860715577d1a77117313748c611397,1,pradeep,2018-03-14 16:34:43+05:18,['2b1143abac2a665bbefbbfcd17b57390094a7a2b'],6,158,164,1548669,4,0.325203252,0.325203252,1,3261
94d0566d21a64b795c9a4844354960605bc1f9d9,1,Abhay Kulkarni,2018-03-14 11:09:05-07:00,['a7d51d496d860715577d1a77117313748c611397'],3,19,22,1548691,1,0.666666667,0.666666667,0.666666667,3261
ad426c24c04e36ff6b7fc286501b4b737b317ad3,1,Velmurugan Periasamy,2018-03-14 16:52:20-04:00,['94d0566d21a64b795c9a4844354960605bc1f9d9'],3,6,9,1548700,1,0,0.5,1,3261
2aaa012dcf74dfd3952aabcc5c58681ab5d77054,1,Sailaja Polavarapu,2018-03-14 16:23:05-07:00,['ad426c24c04e36ff6b7fc286501b4b737b317ad3'],29,3,32,1548732,3,1,1,0,3261
0b47455a2efab020825cbcc09f2474e4be59fe62,1,pradeep,2018-03-15 11:31:32+05:18,['2aaa012dcf74dfd3952aabcc5c58681ab5d77054'],262,517,779,1549511,1,0,0.147540984,0.147540984,3261
b068bfe56a63d70f47982f6aa60ebc5c42317b73,1,pradeep,2018-03-15 11:31:44+05:18,['0b47455a2efab020825cbcc09f2474e4be59fe62'],89,376,465,1549976,21,0.091549296,0.23943662,0.950704225,3261
df0e650881b48530f9495fdaca28feb6bc54a719,1,pradeep,2018-03-15 12:46:01+05:18,['b068bfe56a63d70f47982f6aa60ebc5c42317b73'],1,2,3,1549979,1,,,,3261
5aa5657d49990b1a620d880e2c64c5125b2f1b4e,1,pradeep,2018-03-15 12:46:56+05:18,['df0e650881b48530f9495fdaca28feb6bc54a719'],0,6,6,1549985,1,,,,3261
cc21ffa63fcb6953f7bf5c59090af98c73517ab3,0,Colm O hEigeartaigh,2018-03-15 09:19:42+00:00,['5aa5657d49990b1a620d880e2c64c5125b2f1b4e'],0,5,5,1549990,1,,,,3261
57222febb111066c0867618b89e36c0d44c653c5,0,pradeep,2018-03-15 15:07:51+05:18,['cc21ffa63fcb6953f7bf5c59090af98c73517ab3'],439,67,506,1550496,9,0.16091954,0,0,3261
a1929a82446f5aa8ba662649e9ff3af9e61bec4b,1,Abhay Kulkarni,2018-03-18 09:13:25-07:00,['57222febb111066c0867618b89e36c0d44c653c5'],6,64,70,1550566,4,0.432432432,0.189189189,0.945945946,3261
54fab186a40a04ba88527a811e378125fbedd98d,0,Abhay Kulkarni,2018-03-18 13:50:48-07:00,['a1929a82446f5aa8ba662649e9ff3af9e61bec4b'],8,104,112,1550678,4,0.976190476,0.976190476,1,3261
a1a989d1751204ff216479f96f730ccc1648d679,0,Abhay Kulkarni,2018-03-18 14:17:47-07:00,['54fab186a40a04ba88527a811e378125fbedd98d'],19,87,106,1550784,2,0.87804878,0.87804878,1,3261
f95d9ab6ffbef5fc27ec69d97d30a3ddbda119c9,1,Abhay Kulkarni,2018-03-18 15:04:11-07:00,['a1a989d1751204ff216479f96f730ccc1648d679'],111,183,294,1551078,7,0.343283582,0.343283582,0.970149254,3262
4a96827235d6c910a13ffc2587785c9c997ea58c,1,Zsombor Gegesy,2018-03-19 11:25:21+01:00,['f95d9ab6ffbef5fc27ec69d97d30a3ddbda119c9'],0,24,24,1551102,1,,,,3262
c994a111fef904775a51490f20a1cb2b1131b2d9,1,pradeep,2018-03-20 08:50:26+05:18,['4a96827235d6c910a13ffc2587785c9c997ea58c'],1,166,167,1551269,2,0.308510638,0.308510638,1,3263
5c39c2127894f6921500c97f035ef6d83fbea173,0,Velmurugan Periasamy,2018-03-20 00:53:38-04:00,['c994a111fef904775a51490f20a1cb2b1131b2d9'],3,15,18,1551287,4,,,,3263
ab2a7df91736451fe0c1d0e43287b740394f169c,1,pradeep,2018-03-20 16:21:06+05:18,['5c39c2127894f6921500c97f035ef6d83fbea173'],34,449,483,1551770,20,0.671698113,0.803773585,0.943396226,3268
83e19b8d38364282826c824f0f683350479e3189,0,Abhay Kulkarni,2018-03-20 08:03:39-07:00,['ab2a7df91736451fe0c1d0e43287b740394f169c'],11,11,22,1551792,6,1,1,0,3268
4970af966b1b29db729002f4e8130595be4c28db,0,Zsombor Gegesy,2018-03-22 10:52:06+01:00,['83e19b8d38364282826c824f0f683350479e3189'],6,0,6,1551798,1,,,,3268
97b927f9371a0eaa1beb21f252c52904798c6f80,1,Zsombor Gegesy,2018-03-22 10:53:22+01:00,['4970af966b1b29db729002f4e8130595be4c28db'],46,50,96,1551894,11,1,1,1,3268
d2073e774f458079d9e92a610fec2ae22d63cf12,1,pradeep,2018-03-22 19:10:13+05:18,['97b927f9371a0eaa1beb21f252c52904798c6f80'],32,75,107,1552001,7,0.14893617,0.446808511,0.723404255,3268
2925c07bf59c12be43f4a37b521f5f1b79e1125f,0,rmani,2018-03-22 22:30:55-07:00,['d2073e774f458079d9e92a610fec2ae22d63cf12'],11,11,22,1552023,1,,,,3268
44e4269b194a2714e8f01802e1c7d6a6c9d0ae0e,1,Zsombor Gegesy,2018-03-23 10:46:48+01:00,['2925c07bf59c12be43f4a37b521f5f1b79e1125f'],1,1,2,1552025,1,,,,3268
98e6b663156a67ce9ccba4b01a76d24a559eb885,0,Abhay Kulkarni,2018-03-23 11:24:45-07:00,['44e4269b194a2714e8f01802e1c7d6a6c9d0ae0e'],1,1,2,1552027,1,,,,3268
5f6e6ce72e16343c47b5294b93e15b81f4ebf475,1,Abhay Kulkarni,2018-03-23 12:04:37-07:00,['98e6b663156a67ce9ccba4b01a76d24a559eb885'],3,16,19,1552046,1,0.636363636,0.636363636,0.636363636,3268
ab0b91fd666feb034a7a3c06d419d915f8c6721d,1,Zsombor Gegesy,2018-03-26 11:07:27+02:00,['5f6e6ce72e16343c47b5294b93e15b81f4ebf475'],21,20,41,1552087,2,1,1,1,3268
ec754db0fe7ac788a9c9a439c5aa2ae66f32e021,1,pradeep,2018-03-27 11:17:16+05:18,['ab0b91fd666feb034a7a3c06d419d915f8c6721d'],7,30,37,1552124,1,0,0,0,3268
59956846bc915a1b051fecc062440af22f6b7d79,0,pradeep,2018-03-27 12:12:05+05:18,['ec754db0fe7ac788a9c9a439c5aa2ae66f32e021'],43,56,99,1552223,12,,,,3268
b2295a5e2e8b4848c60e6ed9929147748f5d44cb,1,Zsombor Gegesy,2018-03-27 09:08:11+02:00,['59956846bc915a1b051fecc062440af22f6b7d79'],11,13,24,1552247,2,0,0,1,3268
358540dcfbaa78da2cae1c41e81fde983e91e510,1,Abhay Kulkarni,2018-03-27 17:46:02-07:00,['b2295a5e2e8b4848c60e6ed9929147748f5d44cb'],13,18,31,1552278,1,0,0,1,3268
e6c7afaa851cbcd5abe2f4881a6f9eaea6d2d64f,0,pradeep,2018-03-28 10:58:15+05:18,['358540dcfbaa78da2cae1c41e81fde983e91e510'],1,1,2,1552280,1,,,,3268
6da244d6f7f6f43e98e702d83fc3c768b1713f0e,0,Zsombor Gegesy,2018-03-28 09:04:26+02:00,['e6c7afaa851cbcd5abe2f4881a6f9eaea6d2d64f'],28,17,45,1552325,1,1,1,0,3268
2b5a72ea7ce9ea33dd12a223edc2ce0287f37973,1,Colm O hEigeartaigh,2018-03-28 14:55:45+01:00,['6da244d6f7f6f43e98e702d83fc3c768b1713f0e'],0,1166,1166,1553491,9,0.916666667,1,0.9625,3276
e80464244db6f5a1acf393862752cb951155524d,1,zhangqiang2,2018-03-29 10:44:56+08:00,['2b5a72ea7ce9ea33dd12a223edc2ce0287f37973'],0,5,5,1553496,1,,,,3276
b6d45a261810b3ddbf3bca5bb68110a86dd5060c,0,zhangqiang2,2018-03-29 10:47:10+08:00,['e80464244db6f5a1acf393862752cb951155524d'],9,5,14,1553510,1,1,0,1,3276
ceaed3f3dd590078a59ca9007fec3930542b6152,0,zhangqiang2,2018-03-29 10:54:30+08:00,['b6d45a261810b3ddbf3bca5bb68110a86dd5060c'],17,6,23,1553533,1,1,1,0.714285714,3276
7f61b14810c3d8eb84d0e7ab0695672837130235,1,Sailaja Polavarapu,2018-04-02 15:37:41-07:00,['ceaed3f3dd590078a59ca9007fec3930542b6152'],179,594,773,1554306,30,0.754208754,0.606060606,0.983164983,3276
732244640a88b66bc62c0a57d840997d8a70768e,0,Sailaja Polavarapu,2018-04-02 18:00:14-07:00,['7f61b14810c3d8eb84d0e7ab0695672837130235'],13,5,18,1554324,1,1,1,0,3276
cf69754ad3018bcea1846b1bfb0a05d05b3d557a,0,peng.jianhua,2018-04-03 09:44:05+08:00,['ceaed3f3dd590078a59ca9007fec3930542b6152'],1,2,3,1554327,1,,,,3276
cafe7aee09c1f4a51cdfd107d6701d8853928bae,0,Sailaja Polavarapu,2018-04-03 10:39:40-07:00,"['732244640a88b66bc62c0a57d840997d8a70768e', 'cf69754ad3018bcea1846b1bfb0a05d05b3d557a']",1,2,3,1554330,1,,,,3276
d24b04c0da419b481a8a6b62071a8b8854259e2d,0,Sailaja Polavarapu,2018-04-03 15:34:36-07:00,['cafe7aee09c1f4a51cdfd107d6701d8853928bae'],0,19,19,1554349,1,0,0,1,3276
57e01bab63a5d4972886954399e8e4fc240d4431,1,pradeep,2018-04-04 11:37:45+05:18,['cafe7aee09c1f4a51cdfd107d6701d8853928bae'],11,162,173,1554522,7,0.107142857,0.297619048,1,3277
27d6453a935e0f1aa36184fc34e05ca7c4045fa7,0,pradeep,2018-04-04 11:44:14+05:18,['57e01bab63a5d4972886954399e8e4fc240d4431'],32,50,82,1554604,2,0.636363636,0.636363636,1,3277
11a4f40a2a579308e874dca7625e66aa0cf8ed12,1,pradeep,2018-04-04 11:44:53+05:18,['27d6453a935e0f1aa36184fc34e05ca7c4045fa7'],7,6,13,1554617,3,1,1,0,3277
5259c1e9da4591a611e67f6cfdae1f5c350c184a,0,Sailaja Polavarapu,2018-04-04 10:34:22-07:00,"['d24b04c0da419b481a8a6b62071a8b8854259e2d', '11a4f40a2a579308e874dca7625e66aa0cf8ed12']",50,218,268,1554885,12,,,,3277
20db6e67bdaf65e1f6012ac798fe6c9d3b1cd110,0,Mehul Parikh,2018-04-06 16:22:37+05:18,['5259c1e9da4591a611e67f6cfdae1f5c350c184a'],69,255,324,1555209,5,0.252525253,0.04040404,1,3277
091ad6f95c98357b4843bfb94e71b58ba5463aff,1,Mehul Parikh,2018-04-06 16:27:17+05:18,['20db6e67bdaf65e1f6012ac798fe6c9d3b1cd110'],4,157,161,1555370,2,0,0.294573643,0.286821705,3277
122172a0baa4c899a145e119038243da1370788d,1,Mehul Parikh,2018-04-06 16:32:24+05:18,['091ad6f95c98357b4843bfb94e71b58ba5463aff'],0,672,672,1556042,3,0.074074074,1,1,3278
e65a3e81265f46c76611b0c3e7265af932629bb1,0,Mehul Parikh,2018-04-07 11:28:01+05:18,['122172a0baa4c899a145e119038243da1370788d'],44,68,112,1556154,7,0,0.625,1,3278
fe854a061e0948f27437fb5d9e6f24f0cac0f372,1,Abhay Kulkarni,2018-04-07 09:38:54-07:00,['e65a3e81265f46c76611b0c3e7265af932629bb1'],1,1,2,1556156,1,,,,3278
c8f67ce7c9314867b6481ee10e82ed19b15f37e8,1,Mehul Parikh,2018-04-09 11:16:57+05:18,['fe854a061e0948f27437fb5d9e6f24f0cac0f372'],12,55,67,1556223,6,0.181818182,0.909090909,1,3278
3b510f8c07271e2e51b5a9151a0d26f7084e3792,1,Abhay Kulkarni,2018-04-09 14:29:36-07:00,['c8f67ce7c9314867b6481ee10e82ed19b15f37e8'],45,2377,2422,1558645,23,0.352226721,0.414979757,0.751012146,3284
6cb7e82f4926c407028cd9374001e7059a4c5a43,0,Abhay Kulkarni,2018-04-09 15:15:23-07:00,['3b510f8c07271e2e51b5a9151a0d26f7084e3792'],26,54,80,1558725,2,0.958333333,1,1,3284
50e88f2ee6b0100ddd76d35cb25dfbd73f2767b8,0,pradeep,2018-04-10 09:21:56+05:18,['6cb7e82f4926c407028cd9374001e7059a4c5a43'],1,1,2,1558727,1,,,,3284
ad0273f135bafa2b429fdb7b878fd227815a0a5e,1,Abhay Kulkarni,2018-04-10 08:11:43-07:00,['50e88f2ee6b0100ddd76d35cb25dfbd73f2767b8'],2,4,6,1558733,3,0,1,1,3284
343668b42afe7265c08064c7fb0bf40f7184ea1e,1,Mehul Parikh,2018-04-11 14:01:43+05:18,['ad0273f135bafa2b429fdb7b878fd227815a0a5e'],5,11,16,1558749,2,0,0,1,3284
c394fa42c770deb4981e226b8037174f5a9d260a,1,pradeep,2018-04-12 09:18:47+05:18,['343668b42afe7265c08064c7fb0bf40f7184ea1e'],34,137,171,1558920,6,0,0,0.25,3284
8ea482af6fc34cad60817bb1f5ffcf383850784c,1,pradeep,2018-04-13 09:35:03+05:18,['c394fa42c770deb4981e226b8037174f5a9d260a'],44466,29607,74073,1632993,62,0,1,0.683274021,3292
662878d2dcd1ff67642eeeceb108f38ff23036ee,1,Abhay Kulkarni,2018-04-12 22:02:54-07:00,['8ea482af6fc34cad60817bb1f5ffcf383850784c'],69,71,140,1633133,9,0,0,0.8,3292
58aa1bc298e38df0e10c8e0a79cc63a5fb2a5b33,1,Madhan Neethiraj,2018-04-13 09:01:33-07:00,['662878d2dcd1ff67642eeeceb108f38ff23036ee'],27,42,69,1633202,1,0,0,1,3292
35a33288d566cc8b5ffd6218dd0e7ed13598cc70,1,peng.jianhua,2018-04-16 09:53:22+08:00,['58aa1bc298e38df0e10c8e0a79cc63a5fb2a5b33'],2,12,14,1633216,1,1,1,1,3292
b9007bfa646812481199290168557fa96e089a88,0,peng.jianhua,2018-04-18 09:59:59+08:00,['35a33288d566cc8b5ffd6218dd0e7ed13598cc70'],2,2,4,1633220,1,,,,3292
499650ce026f8195c2fd6bb3e8743bcf99ae73a1,0,Mehul Parikh,2018-04-18 09:26:41+05:18,['b9007bfa646812481199290168557fa96e089a88'],9,36,45,1633265,4,0.933333333,0.933333333,1,3292
bc2cd5e00290866eb48f5115edb0e33971e8fca3,1,Mehul Parikh,2018-04-18 12:11:45+05:18,['499650ce026f8195c2fd6bb3e8743bcf99ae73a1'],1529,1915,3444,1636709,9,0,0.129032258,0.899193548,3296
6101a41063e45e5aa2c77fff34fc699e36c2b3ba,0,Sailaja Polavarapu,2018-04-18 12:59:07-07:00,['bc2cd5e00290866eb48f5115edb0e33971e8fca3'],27,37,64,1636773,8,0.545454545,0.454545455,0.090909091,3296
24579e08490b5caf764608c258c3d1befe513017,0,Abhay Kulkarni,2018-04-18 13:48:49-07:00,['bc2cd5e00290866eb48f5115edb0e33971e8fca3'],28,49,77,1636850,2,0,0.944444444,0,3296
cd00c1020af18691c27a156e5180e09b45b6c831,0,Sailaja Polavarapu,2018-04-18 13:59:12-07:00,['6101a41063e45e5aa2c77fff34fc699e36c2b3ba'],1,1,2,1636852,1,,,,3296
bd40d5028f82eabc01615414f29262af22e89074,0,pradeep,2018-04-19 09:22:46+05:18,['24579e08490b5caf764608c258c3d1befe513017'],1026,187,1213,1638065,11,0.676190476,0.923809524,0,3296
d0e5f24b2e412b33442aecce818dea19fdd6761a,0,Mehul Parikh,2018-04-19 15:17:49+05:18,['bd40d5028f82eabc01615414f29262af22e89074'],2,2,4,1638069,2,,,,3296
a4ad1a0b6599cee1831062d73f8515bcd7e0f721,1,Mehul Parikh,2018-04-19 15:27:40+05:18,['d0e5f24b2e412b33442aecce818dea19fdd6761a'],139,536,675,1638744,3,0,0,1,3296
f957fde26c386a6573c8ea1898e90c4a630a03b0,0,Sailaja Polavarapu,2018-04-20 11:01:43-07:00,"['cd00c1020af18691c27a156e5180e09b45b6c831', 'a4ad1a0b6599cee1831062d73f8515bcd7e0f721']",1195,774,1969,1640713,18,,,,3296
e6f96c09225a2e52353f5a338a9f020cbbdc865f,0,Sailaja Polavarapu,2018-04-20 11:02:19-07:00,['f957fde26c386a6573c8ea1898e90c4a630a03b0'],6,2,8,1640721,3,1,0.8,0.4,3296
f3f8ee523b5a7f75ae11f3d3da1c9dc6948a5084,0,Sailaja Polavarapu,2018-04-20 11:02:19-07:00,['e6f96c09225a2e52353f5a338a9f020cbbdc865f'],1,1,2,1640723,1,,,,3296
00ab2a51ae62fbc0b63c6767835ac6121fd29b79,1,Sailaja Polavarapu,2018-04-20 15:09:44-07:00,['f3f8ee523b5a7f75ae11f3d3da1c9dc6948a5084'],1,1,2,1640725,1,,,,3296
bf9876c3a4b837cbda02bfdd83a3ef97fca77315,1,Velmurugan Periasamy,2018-04-24 15:44:05-04:00,['00ab2a51ae62fbc0b63c6767835ac6121fd29b79'],0,9,9,1640734,1,,,,3296
e6ab27ef6cbdea1ea37d52a99ec69eaaf9aa310e,1,Abhay Kulkarni,2018-04-24 13:37:43-07:00,['bf9876c3a4b837cbda02bfdd83a3ef97fca77315'],1,30,31,1640765,4,0,0,1,3296
d8295fe6cf8da0641b3ba851f952290a6686d96e,0,Sailaja Polavarapu,2018-04-24 15:15:14-07:00,['e6ab27ef6cbdea1ea37d52a99ec69eaaf9aa310e'],0,1,1,1640766,1,,,,3296
a6c9065c65e125771cf3b2ffb58599687b7dd387,1,Abhay Kulkarni,2018-04-25 16:19:23-07:00,['d8295fe6cf8da0641b3ba851f952290a6686d96e'],3,8,11,1640777,3,0,0,0,3296
d9ace0393d1226c13848f8d17a40bac13a7d6390,0,Abhay Kulkarni,2018-04-25 17:22:08-07:00,['a6c9065c65e125771cf3b2ffb58599687b7dd387'],48,131,179,1640956,9,0.041666667,0,1,3297
fbaa4537c6fb75b500c4917c76358cbd0cdf3877,0,Abhay Kulkarni,2018-04-26 10:50:26-07:00,['d9ace0393d1226c13848f8d17a40bac13a7d6390'],18,19,37,1640993,1,0,0,1,3297
2b9f76e818e404ae824b40479f6c3cb84d870a92,1,Mehul Parikh,2018-04-30 19:18:43+05:18,['fbaa4537c6fb75b500c4917c76358cbd0cdf3877'],25,132,157,1641150,3,0,0,0,3297
6c6ec75db0c3871ff76fc072e64fbc778d58625c,1,Mehul Parikh,2018-04-30 19:20:32+05:18,['2b9f76e818e404ae824b40479f6c3cb84d870a92'],23,58,81,1641231,4,0.666666667,1,0.904761905,3297
f076f521655c62b8859de12f57dede1b1fa4aa0a,1,Mehul Parikh,2018-04-30 19:22:42+05:18,['6c6ec75db0c3871ff76fc072e64fbc778d58625c'],1,99,100,1641331,2,0,0,1,3297
9c7ef90e65bf27e04ae0950e9d78c767d211991f,0,Abhay Kulkarni,2018-04-30 15:50:50-07:00,['f076f521655c62b8859de12f57dede1b1fa4aa0a'],1,1,2,1641333,1,,,,3297
3edac55fc718baf54edd0148200f461addc60e6e,1,Abhay Kulkarni,2018-04-30 17:12:55-07:00,['9c7ef90e65bf27e04ae0950e9d78c767d211991f'],4,34,38,1641371,3,,,,3297
b66953fd165d0f650141b9d8a68588c5e1689b45,0,Colm O hEigeartaigh,2018-05-02 17:19:19+01:00,['3edac55fc718baf54edd0148200f461addc60e6e'],1,56,57,1641428,3,1,1,0,3297
38141722ee791f8ae0006247af148ed0bfa7db0c,1,Sailaja Polavarapu,2018-05-02 15:10:00-07:00,['b66953fd165d0f650141b9d8a68588c5e1689b45'],1,1,2,1641430,1,,,,3297
b087c4ccb804cb84ffc622a07d8ea25e900eb35a,1,Sailaja Polavarapu,2018-05-03 08:07:31-07:00,['38141722ee791f8ae0006247af148ed0bfa7db0c'],9,19,28,1641458,3,0.625,0.625,1,3297
666f6f6bbc21e66a0d4030031917ae79f29f26b1,0,Mehul Parikh,2018-05-04 09:53:15+05:18,['b087c4ccb804cb84ffc622a07d8ea25e900eb35a'],191,34,225,1641683,11,0.377777778,0.133333333,0,3299
f21e2b4cfa61b9e2d4f28e35e0a965b99090bf6e,0,Mehul Parikh,2018-05-04 17:13:44+05:18,['666f6f6bbc21e66a0d4030031917ae79f29f26b1'],3,1,4,1641687,1,1,1,1,3299
eed027abd9ee65c21867e1a2b9676f491d0d1800,1,Mehul Parikh,2018-05-09 15:01:51+05:18,['f21e2b4cfa61b9e2d4f28e35e0a965b99090bf6e'],1,351,352,1642039,3,0.321100917,1,1,3299
cccb5e1b949e843f6ff756f2019938d65125ea08,1,Mehul Parikh,2018-05-09 15:03:24+05:18,['eed027abd9ee65c21867e1a2b9676f491d0d1800'],8,24,32,1642071,4,0.538461538,0,1,3299
513788f50de261466d98a770204dd6072fa54a27,0,Mehul Parikh,2018-05-09 15:05:02+05:18,['cccb5e1b949e843f6ff756f2019938d65125ea08'],8,12,20,1642091,3,1,1,1,3299
e1912c8dcf1866d552db8e9fcd858f43cb489541,1,Madhan Neethiraj,2018-05-09 18:30:46-07:00,['513788f50de261466d98a770204dd6072fa54a27'],4,5,9,1642100,1,,,,3299
5ab18c4ddd5bda99a7f1722728bed41b84de788c,0,Zsombor Gegesy,2018-05-10 11:23:52+02:00,['e1912c8dcf1866d552db8e9fcd858f43cb489541'],138,3,141,1642241,3,0.387755102,0.37755102,0,3299
cfb2cdaded11c9843411936bf0802d8fd2d2e6e9,0,Mehul Parikh,2018-05-11 11:20:16+05:18,['5ab18c4ddd5bda99a7f1722728bed41b84de788c'],12,2,14,1642255,1,0,0,0,3299
7a216a80afc9fda0a96cb2d07b839dbaf9355946,0,Mehul Parikh,2018-05-14 10:20:43+05:18,['cfb2cdaded11c9843411936bf0802d8fd2d2e6e9'],0,22,22,1642277,1,0,0,0,3299
df4c01307b0542f8c80b6f3b31f34472ff76a307,0,Mehul Parikh,2018-05-14 14:21:08+05:18,['7a216a80afc9fda0a96cb2d07b839dbaf9355946'],7,4,11,1642288,2,0.666666667,0,0,3299
626f92a9226ea6938578b7d18c3ee7bd835c958e,1,Mehul Parikh,2018-05-15 20:39:59+05:18,['df4c01307b0542f8c80b6f3b31f34472ff76a307'],5,725,730,1643018,7,0.201612903,0.260080645,0.943548387,3301
ab6cb3935ad48948047028750fe8167c66111f87,1,Madhan Neethiraj,2018-05-15 11:14:14-07:00,['626f92a9226ea6938578b7d18c3ee7bd835c958e'],47,47,94,1643112,1,1,1,0,3301
081af481923207ee93a3d4a7cc29901b4c972a44,1,Abhay Kulkarni,2018-05-17 09:45:06-07:00,['ab6cb3935ad48948047028750fe8167c66111f87'],7,69,76,1643188,4,0,0,1,3301
d1521dcdc33252c79dc89b7d065c2ebdcaa8a9f4,0,Mehul Parikh,2018-05-18 10:21:02+05:18,['081af481923207ee93a3d4a7cc29901b4c972a44'],6,6,12,1643200,2,,,,3301
751b33c3ecbf498f30e7c904f977822136f90fdb,0,Mehul Parikh,2018-05-21 09:50:53+05:18,['d1521dcdc33252c79dc89b7d065c2ebdcaa8a9f4'],1,5,6,1643206,1,1,1,1,3301
0ff82bcad230ae9e58220c587218972213f593c6,1,Mehul Parikh,2018-05-21 19:20:07+05:18,['751b33c3ecbf498f30e7c904f977822136f90fdb'],0,12,12,1643218,5,,,,3301
6504a70eeeaefa6a7de18a0eb8f78f62dad76d9f,0,rmani,2018-05-21 10:36:47-07:00,['0ff82bcad230ae9e58220c587218972213f593c6'],1,1,2,1643220,1,,,,3301
84513334719958539fbddfbd12e3c95e4804a1fb,0,Zsombor Gegesy,2018-05-22 11:48:18+02:00,['6504a70eeeaefa6a7de18a0eb8f78f62dad76d9f'],720,139,859,1644079,72,0.613402062,0.589347079,0.010309278,3301
95a8dce283647f91d625a732c36db3c8c7434719,0,Mehul Parikh,2018-05-24 15:17:33+05:18,['84513334719958539fbddfbd12e3c95e4804a1fb'],7,19,26,1644105,10,0.916666667,1,0.916666667,3301
5dced6f6695f51e52f66015252059f59ad643108,0,pradeep,2018-05-29 14:43:09+05:18,['95a8dce283647f91d625a732c36db3c8c7434719'],217,217,434,1644539,1,,,,3301
b041df1ddade3d3a78fe86513258d617a42e7f10,1,Abhay Kulkarni,2018-05-30 16:07:18-07:00,['5dced6f6695f51e52f66015252059f59ad643108'],0,43,43,1644582,4,0,0.916666667,0.5,3301
009cef8ab75f724eaf0282529e4e1975d65234e6,0,Mehul Parikh,2018-05-31 09:24:07+05:18,['b041df1ddade3d3a78fe86513258d617a42e7f10'],5,57,62,1644644,3,0.363636364,0.386363636,1,3301
b619bd596f52570150d766216571956f47100dbb,0,Sailaja Polavarapu,2018-05-31 13:02:59-07:00,['009cef8ab75f724eaf0282529e4e1975d65234e6'],1,1,2,1644646,1,,,,3301
987abe8064529b08149a03ab22e2dbfbbe1cc0d8,0,pradeep,2018-06-04 15:40:57+05:18,['b619bd596f52570150d766216571956f47100dbb'],246,301,547,1645193,2,0,0,0,3301
32d73afd6bc5ac5d9b894f3d14f3eaf9b1b4f408,0,Mehul Parikh,2018-06-04 19:28:29+05:18,['987abe8064529b08149a03ab22e2dbfbbe1cc0d8'],88,157,245,1645438,4,0.833333333,0,1,3301
f49820a9b73d80326d7a8f5339c7f7f0bcc40d13,0,rmani,2018-06-04 11:09:12-07:00,['32d73afd6bc5ac5d9b894f3d14f3eaf9b1b4f408'],0,1,1,1645439,1,,,,3301
82ef3daa0af15e254509302bb4e6b4efbc67e71c,0,Abhay Kulkarni,2018-06-04 23:31:22-07:00,['f49820a9b73d80326d7a8f5339c7f7f0bcc40d13'],20,21,41,1645480,4,0,0,0,3301
6922c03f7085dfd37101536f6283d57fc063f581,1,Don Bosco Durai,2018-06-05 16:49:43+05:18,['82ef3daa0af15e254509302bb4e6b4efbc67e71c'],6,6,12,1645492,1,,,,3301
ce725f500ffb826f8d121ddef2514f7052013577,1,rmani,2018-06-05 10:49:03-07:00,['6922c03f7085dfd37101536f6283d57fc063f581'],4,449,453,1645945,5,0.308641975,0.407407407,0.987654321,3302
80c8198337060b89bbcde05331ca65f7e06a0105,0,Mehul Parikh,2018-06-06 19:13:40+05:18,['ce725f500ffb826f8d121ddef2514f7052013577'],32,36,68,1646013,2,0,0,1,3302
06d0813563d118f69ba04a60396016007ac1d77e,1,Sailaja Polavarapu,2018-06-07 11:23:19-07:00,['80c8198337060b89bbcde05331ca65f7e06a0105'],2,6,8,1646021,1,0,0.333333333,1,3302
f54723676d416001b6fb26f5ea281de0b392ec06,1,Mehul Parikh,2018-06-12 10:01:13+05:18,['06d0813563d118f69ba04a60396016007ac1d77e'],196,386,582,1646603,1,0.346405229,1,1,3302
282c1d55d9c5aab4611c3a859169b594c9180b0f,0,Mehul Parikh,2018-06-12 12:16:02+05:18,['f54723676d416001b6fb26f5ea281de0b392ec06'],5,5,10,1646613,2,,,,3302
4e04da6556c53aeb62af5f480db221933075b4d2,0,Mehul Parikh,2018-06-14 19:46:00+05:18,['282c1d55d9c5aab4611c3a859169b594c9180b0f'],3,2162,2165,1648778,7,0.137450199,0.999335989,1,3304
f1a71e0a9381bf53f4f020a92f0315548190bf7f,0,Mehul Parikh,2018-06-14 19:49:54+05:18,['4e04da6556c53aeb62af5f480db221933075b4d2'],15,14,29,1648807,4,1,1,1,3304
6cf1471c240930d33a4d3334a2d011a9dfd22ea8,1,Mehul Parikh,2018-06-18 08:54:58+05:18,['f1a71e0a9381bf53f4f020a92f0315548190bf7f'],2,10,12,1648819,2,0,0,1,3304
49f2aa90e99bc7bf38a8411dab06fe9471955966,0,Colm O hEigeartaigh,2018-06-20 16:32:27+01:00,['6cf1471c240930d33a4d3334a2d011a9dfd22ea8'],1,1,2,1648821,1,,,,3304
ee20663d43468fa7fcc00315dfcfa25fa272404a,0,Mehul Parikh,2018-06-21 19:00:16+05:18,['49f2aa90e99bc7bf38a8411dab06fe9471955966'],5,29,34,1648855,1,0,0,1,3304
29fedc53fdc4a9df9f5857e754cf6fdcad488cef,1,Mehul Parikh,2018-06-22 10:45:55+05:18,['ee20663d43468fa7fcc00315dfcfa25fa272404a'],0,895,895,1649750,10,0.79338843,1,1,3314
63d84316028a28a8b6c8c3b65efd104c89bd9925,0,Mehul Parikh,2018-06-22 16:03:25+05:18,['29fedc53fdc4a9df9f5857e754cf6fdcad488cef'],16,17,33,1649783,3,1,1,1,3314
2c64ee2c80380b1c5e6f53c92007c04ca6219268,0,rmani,2018-06-22 11:15:39-07:00,['63d84316028a28a8b6c8c3b65efd104c89bd9925'],1,9,10,1649793,1,,,,3314
da29d1929a54b2b579a74da32e5ea074d0f8e15d,0,Mehul Parikh,2018-06-23 21:57:49+05:18,['2c64ee2c80380b1c5e6f53c92007c04ca6219268'],0,6,6,1649799,5,,,,3314
3c18a99c2ca5b0a5302d0b646438be2990ee6c34,1,Madhan Neethiraj,2018-06-29 00:21:28-07:00,['da29d1929a54b2b579a74da32e5ea074d0f8e15d'],74,158,232,1650031,4,0.421875,0.421875,0.9375,3314
4209b8d96abf6e827aa320653ba227a6c0c5abdb,1,Madhan Neethiraj,2018-06-30 14:49:26-07:00,['3c18a99c2ca5b0a5302d0b646438be2990ee6c34'],15,5,20,1650051,3,,,,3314
f2be7cdd65539c05153202b823af8953032e0649,0,Abhay Kulkarni,2018-07-02 15:00:58-07:00,['4209b8d96abf6e827aa320653ba227a6c0c5abdb'],2,3,5,1650056,1,,,,3314
8e5f6cb6564fffd696c77b556f101c4bf90245e9,0,Velmurugan Periasamy,2018-07-03 00:53:00-04:00,['f2be7cdd65539c05153202b823af8953032e0649'],49,49,98,1650154,49,,,,3314
c129e7fefe929db9d7381567227580c0a4821663,0,Mehul Parikh,2018-07-03 21:53:54+05:18,['8e5f6cb6564fffd696c77b556f101c4bf90245e9'],0,285,285,1650439,1,0.025641026,1,1,3315
1c6a271974dae1a8727254d15eb3cc51f5fd8dcb,0,Velmurugan Periasamy,2018-07-09 22:17:47-04:00,['c129e7fefe929db9d7381567227580c0a4821663'],2,13,15,1650454,3,,,,3315
0f0686e49ec81e4aa90558b10742e37c593344f4,0,Velmurugan Periasamy,2018-07-19 14:39:43-04:00,['1c6a271974dae1a8727254d15eb3cc51f5fd8dcb'],1,1,2,1650456,1,,,,3315
f368dcb3877581359baf41a2172b2263a04dae84,1,Abhay Kulkarni,2018-07-22 18:52:04-07:00,['0f0686e49ec81e4aa90558b10742e37c593344f4'],140,94,234,1650690,7,1,1,0.195121951,3315
34499290059a28f5084f0fa3b249d70ba11d1e83,1,pradeep,2018-07-23 11:12:22+05:18,['f368dcb3877581359baf41a2172b2263a04dae84'],1191,3166,4357,1655047,4,0.29921671,1,1,3315
86b714048c27515763a69a7a07c307f96a26acb6,0,zhangqiang2,2018-07-26 14:40:24+08:00,['34499290059a28f5084f0fa3b249d70ba11d1e83'],1,1,2,1655049,1,,,,3315
d352dfaab216eb7c2a1abef5b689aa993430a549,1,Mehul Parikh,2018-07-26 13:29:30+05:18,['86b714048c27515763a69a7a07c307f96a26acb6'],0,883,883,1655932,7,0.754208754,1,1,3322
2e73aaae97b25a316f64dbce211c6d8c800ba7c0,0,Mehul Parikh,2018-07-26 14:26:34+05:18,['d352dfaab216eb7c2a1abef5b689aa993430a549'],8,14,22,1655954,3,0,0,0,3322
8702a98e42f14c917010a61e13a37e49a1cd1452,0,pradeep,2018-07-26 22:53:59+05:18,['2e73aaae97b25a316f64dbce211c6d8c800ba7c0'],2,5,7,1655961,3,,,,3322
c219420e7058ee6081408f82992f6ff1e847d5b1,1,Mehul Parikh,2018-07-27 16:39:28+05:18,['8702a98e42f14c917010a61e13a37e49a1cd1452'],1,25,26,1655987,1,0,0,1,3322
4308c8aecbd7c537469475e6f456c0ab043ea931,0,Zsombor Gegesy,2018-07-27 13:58:39+02:00,['c219420e7058ee6081408f82992f6ff1e847d5b1'],5,9,14,1656001,1,1,1,1,3322
74f85991f54c1546d0790f0665339e9feb02b5b7,1,Abhay Kulkarni,2018-07-27 10:59:29-07:00,['4308c8aecbd7c537469475e6f456c0ab043ea931'],0,2,2,1656003,1,,,,3322
3926ef42617e555ab4a1d6740178a1c0ad8f97d9,0,Mehul Parikh,2018-07-30 13:59:05+05:18,['74f85991f54c1546d0790f0665339e9feb02b5b7'],12,26,38,1656041,6,1,1,0,3322
3539051d391172820655392f0ff0e5ebf04be421,0,pengjianhua,2018-07-31 00:20:29+08:00,['3926ef42617e555ab4a1d6740178a1c0ad8f97d9'],1,1,2,1656043,1,,,,3322
edefd567ca2afead045f486ccadc3f30925f877e,1,Abhay Kulkarni,2018-07-31 15:15:33-07:00,['3539051d391172820655392f0ff0e5ebf04be421'],16,175,191,1656234,4,0.172413793,0.517241379,0.663793103,3322
1d47302f937e3fe1d565914c578faaf989e54424,0,Sailaja Polavarapu,2018-07-31 16:22:07-07:00,['edefd567ca2afead045f486ccadc3f30925f877e'],9,16,25,1656259,3,0,0.5,0,3322
ec711360ab0e84905476930b11e92641edf07d7a,0,Abhay Kulkarni,2018-07-31 16:30:47-07:00,['1d47302f937e3fe1d565914c578faaf989e54424'],187,267,454,1656713,2,0.092592593,0.425925926,0.851851852,3322
9fd6acf41f1f647c6948036c22d387f7d0e7b296,1,Pradeep,2018-08-01 09:25:48+05:18,['ec711360ab0e84905476930b11e92641edf07d7a'],12,199,211,1656924,10,,,,3327
ee806ca5fedd868e6e2788566926a0c42b6def16,0,pengjianhua,2018-08-01 15:13:31+08:00,['9fd6acf41f1f647c6948036c22d387f7d0e7b296'],0,30,30,1656954,2,0.875,0.96875,0.75,3327
e693837ac3910dcf045eb3e9bc38f8e0026b6175,0,Abhay Kulkarni,2018-08-01 08:31:41-07:00,['ee806ca5fedd868e6e2788566926a0c42b6def16'],1,1,2,1656956,1,,,,3327
0ebc2d30eb803f61ff51656bbc1a00f148297a08,1,Pradeep,2018-08-01 21:37:01+05:18,['e693837ac3910dcf045eb3e9bc38f8e0026b6175'],19,46,65,1657021,4,1,1,1,3327
47ff1cc204916b9ba8c5664b06fa9403600d8101,0,Abhay Kulkarni,2018-08-02 08:26:28-07:00,['0ebc2d30eb803f61ff51656bbc1a00f148297a08'],7,5,12,1657033,3,1,1,0,3327
d1c1e54216f228e6400d17ec463dd14efe31e49e,0,Sailaja Polavarapu,2018-08-02 12:33:24-07:00,['47ff1cc204916b9ba8c5664b06fa9403600d8101'],2,2,4,1657037,2,,,,3327
c80d0f72c7ae7b81c37154eee6eb3bebca7215bc,0,pengjianhua,2018-08-03 07:42:40+08:00,['d1c1e54216f228e6400d17ec463dd14efe31e49e'],3,7,10,1657047,2,1,1,0,3327
a8c4c0091929fa26a6afcc2946617f5ba9eeca10,0,Pradeep,2018-08-03 21:33:11+05:18,['c80d0f72c7ae7b81c37154eee6eb3bebca7215bc'],3,5,8,1657055,1,0,0,1,3327
eed3accad47f2b1c201b40f0cc292405d8716991,0,Selvamohan Neethiraj,2018-08-04 15:32:06-04:00,['a8c4c0091929fa26a6afcc2946617f5ba9eeca10'],1,1,2,1657057,1,,,,3327
4fc539b783477fd2d209aaf9968de65eeb9aa566,0,Abhay Kulkarni,2018-08-05 09:01:24-07:00,['eed3accad47f2b1c201b40f0cc292405d8716991'],3,7,10,1657067,1,0,0,0.333333333,3327
c7d15b3059c209bd57795dcbe231dafc7e95c62a,0,zhangqiang2,2018-08-07 09:46:03+08:00,['4fc539b783477fd2d209aaf9968de65eeb9aa566'],22,39,61,1657128,3,0.923076923,1,1,3327
8e4a02f9e8c67ce057c358b94a272025b81113d9,0,Mehul Parikh,2018-08-07 13:39:08+05:18,['c7d15b3059c209bd57795dcbe231dafc7e95c62a'],0,91,91,1657219,2,0.616438356,1,1,3327
7af27bea89eafb5cf2478e36e3e37474131a5684,0,Mehul Parikh,2018-08-07 19:44:18+05:18,['8e4a02f9e8c67ce057c358b94a272025b81113d9'],1,0,1,1657220,1,1,0,0,3327
2dfd1ea459ea27461fd2abc108a55ce84e78670a,0,Mehul Parikh,2018-08-08 10:39:36+05:18,['7af27bea89eafb5cf2478e36e3e37474131a5684'],18,278,296,1657516,7,0.093567251,0.900584795,0.935672515,3327
2ce6ce390f527b8c189a91dfc5bb8ffb3ea95319,0,Mehul Parikh,2018-08-09 10:42:53+05:18,['2dfd1ea459ea27461fd2abc108a55ce84e78670a'],17,522,539,1658055,7,0.139917695,0.353909465,1,3328
2429f553ccc835d02c38f720ef64f575e87d68aa,1,Abhay Kulkarni,2018-08-09 14:08:11-07:00,['2ce6ce390f527b8c189a91dfc5bb8ffb3ea95319'],28,69,97,1658152,1,0.129032258,0.129032258,0.129032258,3328
4f55c97f2d31cd3750daf16df52be87772753506,1,Mehul Parikh,2018-08-10 17:48:54+05:18,['2429f553ccc835d02c38f720ef64f575e87d68aa'],7,149,156,1658308,3,0,0.179775281,1,3328
49142eb1b8a31f7ff575eafe74a902bebaf854e3,0,Mehul Parikh,2018-08-11 19:24:51+05:18,['4f55c97f2d31cd3750daf16df52be87772753506'],6,6,12,1658320,4,,,,3328
0db2e80b4de5eb134d2a33ac13c1a648ca113d10,0,zhangqiang2,2018-08-13 13:34:26+08:00,['49142eb1b8a31f7ff575eafe74a902bebaf854e3'],3,6,9,1658329,1,0,,,3328
ecbc7a66f124395f9ddf42d0a60d4ead9e6e0542,0,Gautam Borad,2018-08-14 16:49:49+05:18,['0db2e80b4de5eb134d2a33ac13c1a648ca113d10'],1,33,34,1658363,2,,,,3329
466edce78bd97fbf87b17cd5e3e85c40834b0556,1,Abhay Kulkarni,2018-08-14 10:42:42-07:00,['ecbc7a66f124395f9ddf42d0a60d4ead9e6e0542'],67,372,439,1658802,5,0.302752294,0.389908257,0.509174312,3329
6eac3dfc6bc72ae940cf846a941721e5e75ea812,0,Abhay Kulkarni,2018-08-14 10:49:34-07:00,['466edce78bd97fbf87b17cd5e3e85c40834b0556'],1,3,4,1658806,2,0,1,1,3329
c6a0935dda1c7bbc3c1f556355281ed910e92f3d,1,Colm O hEigeartaigh,2018-08-15 17:29:21+01:00,['6eac3dfc6bc72ae940cf846a941721e5e75ea812'],152,118,270,1659076,24,1,0.833333333,0,3329
9db2667f2a57128d8c729b0f2a195d4d6eba1c75,0,Madhan Neethiraj,2018-08-15 12:16:15-07:00,['c6a0935dda1c7bbc3c1f556355281ed910e92f3d'],46,57,103,1659179,1,1,1,0,3329
3aa94596be73371a64f190ef6e01ab93d6ef8e78,1,Abhay Kulkarni,2018-08-15 21:03:41-07:00,['9db2667f2a57128d8c729b0f2a195d4d6eba1c75'],163,236,399,1659578,7,0.777777778,0.277777778,0,3329
d4efb21aaf28990c80f6f7fd126409c16badce5c,0,Abhay Kulkarni,2018-08-16 23:53:39-07:00,['3aa94596be73371a64f190ef6e01ab93d6ef8e78'],18,106,124,1659702,9,0.826086957,0.043478261,0.913043478,3331
266b1c9cd2b4397fa4d2d158dfdaa2636c53c8de,0,Selvamohan Neethiraj,2018-08-19 15:56:54-04:00,['d4efb21aaf28990c80f6f7fd126409c16badce5c'],0,2,2,1659704,1,,,,3331
07076c18e527606c116a560ff08c171ee39d90bb,0,Abhay Kulkarni,2018-08-21 15:20:45-07:00,['266b1c9cd2b4397fa4d2d158dfdaa2636c53c8de'],2,2,4,1659708,1,,,,3331
0092348e330c4ca407f250935dce905e94704979,1,rmani,2018-08-22 11:55:40-07:00,['07076c18e527606c116a560ff08c171ee39d90bb'],43,51,94,1659802,2,1,1,0,3331
12aebc9e693777c655e6b350612a2567cb4b21a9,0,Abhay Kulkarni,2018-08-22 17:38:46-07:00,['0092348e330c4ca407f250935dce905e94704979'],0,10,10,1659812,6,0.142857143,0.142857143,0.714285714,3331
41edc467584032e4c89f03aae86824ec28a7c154,0,Abhay Kulkarni,2018-08-23 14:59:19-07:00,['12aebc9e693777c655e6b350612a2567cb4b21a9'],1,1,2,1659814,1,,,,3331
e4a11c860ab1a0151618d3579708b2c48076cf10,0,Mehul Parikh,2018-08-27 20:15:12+05:18,['41edc467584032e4c89f03aae86824ec28a7c154'],2,2,4,1659818,1,,,,3331
9f13560204dc2c7e721ac73a4158f5d8ba8e86da,1,Sailaja Polavarapu,2018-08-31 10:02:23-07:00,['e4a11c860ab1a0151618d3579708b2c48076cf10'],15,28,43,1659861,1,0.5,0.5,0.5,3331
09bfd1bb3c314491966123c5274330c53f4683f3,0,Colm O hEigeartaigh,2018-09-11 10:47:51+01:00,['9f13560204dc2c7e721ac73a4158f5d8ba8e86da'],27,25,52,1659913,2,1,1,1,3331
46a75938bfa58676044361b597bd52d1496804a0,1,Colm O hEigeartaigh,2018-09-17 10:28:28+01:00,['09bfd1bb3c314491966123c5274330c53f4683f3'],0,17,17,1659930,2,,,,3331
9f639f3c5876c7134f43df33467691a2b01735a7,0,Abhay Kulkarni,2018-09-17 11:42:02-07:00,['46a75938bfa58676044361b597bd52d1496804a0'],8,10,18,1659948,1,0,0,0,3331
c18b3717e35de2dd8b7aa069494f7b7f50dd6ce1,0,rmani,2018-09-18 15:32:10-07:00,['9f639f3c5876c7134f43df33467691a2b01735a7'],4,1097,1101,1661049,14,0.491891892,0.848648649,0.940540541,3342
90979b4a8d78055fe04a692c6c86c7de33ab07ad,0,Mehul Parikh,2018-09-19 11:21:16+05:18,['c18b3717e35de2dd8b7aa069494f7b7f50dd6ce1'],5,10,15,1661064,1,0,0,1,3342
8e59c92046bd5822c08e60eff187b143d93be238,0,邢鹏 10209390,2018-09-21 17:03:50+08:00,['90979b4a8d78055fe04a692c6c86c7de33ab07ad'],6,15,21,1661085,1,0,0,1,3342
065c03d0c01aa9898fb69a0be9f83ae996d81c79,0,peng.jianhua,2018-09-22 16:16:11+08:00,['8e59c92046bd5822c08e60eff187b143d93be238'],1,1,2,1661087,1,,,,3342
997325b54a34eefbf811b051b7659f76d56f7d29,1,Mehul Parikh,2018-09-24 18:27:41+05:18,['065c03d0c01aa9898fb69a0be9f83ae996d81c79'],1,1,2,1661089,1,,,,3342
ad5d97210427d3e332d195f6d85d979c5223c6a3,0,Velmurugan Periasamy,2018-09-24 14:11:58-04:00,['997325b54a34eefbf811b051b7659f76d56f7d29'],1,1,2,1661091,1,,,,3342
12a27e7c778faee24c18c740285a34abb748963a,1,rmani,2018-09-26 13:22:57-07:00,['ad5d97210427d3e332d195f6d85d979c5223c6a3'],9,9,18,1661109,3,,0,,3342
f2e148abbe473a5fa23419373897082a3bf63974,1,Sailaja Polavarapu,2018-09-26 15:06:26-07:00,['12a27e7c778faee24c18c740285a34abb748963a'],26,149,175,1661284,3,0,0.094017094,0,3342
87a0a13470e9d697dc135550ce3fa24808ba0598,0,Sailaja Polavarapu,2018-09-26 16:06:51-07:00,['f2e148abbe473a5fa23419373897082a3bf63974'],0,1,1,1661285,1,0,1,1,3342
dff98de61397ce7b054e593cadaaf04eb0f9f415,0,peng.jianhua,2018-09-27 10:57:12+08:00,['87a0a13470e9d697dc135550ce3fa24808ba0598'],0,3,3,1661288,1,1,1,1,3342
99a9b1bc4c8f34735fc9d22059e4a2ab030d9830,1,Mehul Parikh,2018-09-27 11:13:21+05:18,['dff98de61397ce7b054e593cadaaf04eb0f9f415'],8,810,818,1662106,6,0.028213166,0.793103448,1,3342
92825c227077e1679a287a0f6b90a475152795f8,0,Colm O hEigeartaigh,2018-09-28 15:57:53+01:00,['99a9b1bc4c8f34735fc9d22059e4a2ab030d9830'],1,1,2,1662108,1,,,,3342
2d770712f790b0dc81e4eb5ecb9d3190542fe3e8,0,Colm O hEigeartaigh,2018-10-03 10:02:10+01:00,['92825c227077e1679a287a0f6b90a475152795f8'],1,1,2,1662110,1,,,,3342
173dabcbbafc07cbc07d9aac214d1f496a2cdf22,0,Velmurugan Periasamy,2018-10-04 13:51:52-04:00,['2d770712f790b0dc81e4eb5ecb9d3190542fe3e8'],1,120,121,1662231,3,,,,3342
e2fa2e2f70ca9bcef33466dc82d4a40b6d13e4fe,0,Velmurugan Periasamy,2018-10-05 15:33:26-04:00,['173dabcbbafc07cbc07d9aac214d1f496a2cdf22'],11,0,11,1662242,1,,,,3342
3bbf770456c45af72a1cd52eb9281902137422bb,0,peng.jianhua,2018-10-08 14:32:50+08:00,['e2fa2e2f70ca9bcef33466dc82d4a40b6d13e4fe'],62,108,170,1662412,3,1,1,0.4375,3342
f8aff4e14e8910e084c089eea8aedfa8ddfacc90,1,Mehul Parikh,2018-10-08 18:19:29+05:18,['3bbf770456c45af72a1cd52eb9281902137422bb'],18,67,85,1662497,2,,,,3342
b6d1730238f65a7d724d307e7552d6e06ebbb9b9,1,rmani,2018-10-08 17:03:18-07:00,['f8aff4e14e8910e084c089eea8aedfa8ddfacc90'],25,900,925,1663422,14,0.248,0.469333333,0.986666667,3345
3d52b76a2e9072a3548fc3818e6f9444c1c34277,1,rmani,2018-10-08 18:11:40-07:00,['b6d1730238f65a7d724d307e7552d6e06ebbb9b9'],1,1,2,1663424,1,,,,3345
234fb4823461c522e40ec4476d6938ac5c660981,0,Pradeep,2018-10-09 10:54:26+05:18,['3d52b76a2e9072a3548fc3818e6f9444c1c34277'],20,18,38,1663462,11,,,,3345
1869f2a761405aa62bfc8533a38255f69d95301e,1,rmani,2018-10-10 10:51:19-07:00,['234fb4823461c522e40ec4476d6938ac5c660981'],4,250,254,1663716,4,0.075,0.05625,0.35,3345
e8f61a93dfbee3b322ac60e11aae6efb3103683c,0,peng.jianhua,2018-10-11 09:51:24+08:00,['1869f2a761405aa62bfc8533a38255f69d95301e'],1,1,2,1663718,1,,,,3345
13a1e7f7123d8316ddc6a61ecaed8214e2e8fd8c,0,Abhay Kulkarni,2018-10-11 11:19:39-07:00,['e8f61a93dfbee3b322ac60e11aae6efb3103683c'],0,3,3,1663721,1,0,0,1,3345
3d59099dcff757d420748793d6d9abe904a59165,0,peng.jianhua,2018-10-12 13:43:33+08:00,['13a1e7f7123d8316ddc6a61ecaed8214e2e8fd8c'],15,15,30,1663751,1,,,,3345
b152d207db038094e95b548e6281e9d768f87341,1,Pradeep,2018-10-12 11:20:52+05:18,['3d59099dcff757d420748793d6d9abe904a59165'],5,6,11,1663762,1,,,,3345
2dae7b0f6edd50c07546b5d1eee87044f02d6b7c,1,Mehul Parikh,2018-10-12 13:43:13+05:18,['b152d207db038094e95b548e6281e9d768f87341'],45,159,204,1663966,10,0.625,1,0,3348
f039a3e2d22f56b2f54173c7817e8bf14baf2ebe,0,rmani,2018-10-12 10:42:38-07:00,['2dae7b0f6edd50c07546b5d1eee87044f02d6b7c'],1,1,2,1663968,1,,,,3348
6fc9a823dbeeb55a8ef767e0da8b5c7be2495ac0,1,Abhay Kulkarni,2018-10-12 16:45:44-07:00,['f039a3e2d22f56b2f54173c7817e8bf14baf2ebe'],10,100,110,1664078,9,0.37804878,0.43902439,1,3348
db7e261448411eabe233bf34631ea209ab6a42bb,0,Velmurugan Periasamy,2018-10-16 16:43:50-04:00,['6fc9a823dbeeb55a8ef767e0da8b5c7be2495ac0'],0,128,128,1664206,2,0.5,1,1,3349
f3221e150a78abdce22698e0409806b95c100de7,0,Mehul Parikh,2018-10-17 09:34:06+05:18,['db7e261448411eabe233bf34631ea209ab6a42bb'],2,3,5,1664211,1,1,1,1,3349
1a553b4c85fbff00a32376e25d2f503644bd0621,0,Mehul Parikh,2018-10-17 10:15:23+05:18,['f3221e150a78abdce22698e0409806b95c100de7'],3,3,6,1664217,2,,,,3349
e20e7f4cacf8830aa6a87c6af366cde75944a6d6,1,rmani,2018-10-17 11:03:58-07:00,['1a553b4c85fbff00a32376e25d2f503644bd0621'],1,1,2,1664219,1,,,,3349
70efa6810d5880184578b54a205b62a1349f426b,0,Abhay Kulkarni,2018-10-17 14:54:33-07:00,['e20e7f4cacf8830aa6a87c6af366cde75944a6d6'],5,25,30,1664249,5,0,0,1,3349
64cb80b7195762f2798f79aaad4df06f43c741c1,0,Colm O hEigeartaigh,2018-10-18 09:40:43+01:00,['70efa6810d5880184578b54a205b62a1349f426b'],1,1,2,1664251,1,,,,3349
d424b1a8dff7755b646279b10e11976d6ab88ef5,1,Abhay Kulkarni,2018-10-18 15:22:48-07:00,['64cb80b7195762f2798f79aaad4df06f43c741c1'],3199,7766,10965,1675216,84,0.702497286,0.813246471,0.883821933,3374
81176a6f739b3ea6fb7be4c0ddf2f3cd3c51b6be,0,Sailaja Polavarapu,2018-10-19 16:16:31-07:00,['d424b1a8dff7755b646279b10e11976d6ab88ef5'],72,406,478,1675694,1,,,,3374
2a46f3cb9c339bee4a949077a067f14c19631910,0,Mehul Parikh,2018-10-22 18:12:06+05:18,['81176a6f739b3ea6fb7be4c0ddf2f3cd3c51b6be'],2,2,4,1675698,1,,,,3374
ac4ef50b01fe35b858fe8ef45a8b5f896e44662b,1,Pradeep,2018-10-22 19:35:13+05:18,['2a46f3cb9c339bee4a949077a067f14c19631910'],23,265,288,1675986,11,0.130952381,0.130952381,0.369047619,3374
851e2f1fbc96f73d68ea54edc3eb55676aa16ad5,0,Pradeep,2018-10-22 19:38:39+05:18,['ac4ef50b01fe35b858fe8ef45a8b5f896e44662b'],14,36,50,1676036,6,0,0,0.181818182,3374
fe4db5764c1140dd663a3a41ef6b13516645ad5e,0,Pradeep,2018-10-23 18:53:40+05:18,['851e2f1fbc96f73d68ea54edc3eb55676aa16ad5'],3,9,12,1676048,1,0,0,0,3374
349a3593c1387d65a28b87ec2bc2b95ef70200e7,0,Sailaja Polavarapu,2018-10-23 09:50:45-07:00,['fe4db5764c1140dd663a3a41ef6b13516645ad5e'],9,7,16,1676064,3,,,,3374
c397d21415958cb2949d383107e472b8dde06105,0,peng.jianhua,2018-10-25 09:32:30+08:00,['349a3593c1387d65a28b87ec2bc2b95ef70200e7'],3,3,6,1676070,2,0,0,0,3374
8a22e5d8ecbd252ab7939f1482e2169c7a37c25a,0,rmani,2018-10-25 11:04:54-07:00,['c397d21415958cb2949d383107e472b8dde06105'],4,71,75,1676145,1,0.24137931,1,0.24137931,3374
da0e8ce36e103481fbce57393085aaa550d1b981,0,peng.jianhua,2018-10-26 10:55:07+08:00,['8a22e5d8ecbd252ab7939f1482e2169c7a37c25a'],1,1,2,1676147,1,,,,3374
3b3e56f27c0f411bfbc36ed493ca4d018a6820c7,0,peng.jianhua,2018-10-26 14:00:32+08:00,['da0e8ce36e103481fbce57393085aaa550d1b981'],1,1,2,1676149,1,,,,3374
2b3873e9b9628a25e36f4dd5198d3789cbcc5476,0,Pradeep,2018-10-26 19:18:12+05:18,['3b3e56f27c0f411bfbc36ed493ca4d018a6820c7'],3,3,6,1676155,1,,,,3374
1c32f55a02ed207ac62e0b3ed8ddbcbcaa9a3d7f,1,Abhay Kulkarni,2018-10-26 17:27:21-07:00,['2b3873e9b9628a25e36f4dd5198d3789cbcc5476'],5,138,143,1676298,2,0.252525253,0.454545455,0.868686869,3374
ae781cc90db322af48cbb88964e73e07df1fa357,0,Abhay Kulkarni,2018-10-30 15:36:23-07:00,['1c32f55a02ed207ac62e0b3ed8ddbcbcaa9a3d7f'],60,63,123,1676421,6,1,0,0,3374
af0f9aafc72ff25b21f9cee82716e961294b8efd,1,Sailaja Polavarapu,2018-10-31 11:00:38-07:00,['ae781cc90db322af48cbb88964e73e07df1fa357'],0,74,74,1676495,1,,,,3374
71ecc5a19a2c58a0875113e53061d30822eb1c94,1,Pradeep,2018-11-01 05:07:15+05:18,['af0f9aafc72ff25b21f9cee82716e961294b8efd'],3,25,28,1676523,4,0.409090909,0.409090909,1,3374
c6b5e845cbb381ed050852706e4064891c02b9f4,1,peng.jianhua,2018-11-01 10:03:31+08:00,['71ecc5a19a2c58a0875113e53061d30822eb1c94'],7,7,14,1676537,2,,,,3374
ac1b1bdf39b96e53282ba989c865cd819d5d4b68,0,Pradeep,2018-11-03 08:02:51+05:18,['c6b5e845cbb381ed050852706e4064891c02b9f4'],0,11,11,1676548,2,0,0,1,3374
2b2cb2daf710f1c6ff68f35e6fdef6b01495c7c2,1,Pradeep,2018-11-03 19:16:20+05:18,['ac1b1bdf39b96e53282ba989c865cd819d5d4b68'],13,172,185,1676733,6,0,0.421487603,1,3374
48bf487e2b1eefad120bf005d8aea019adeb69d8,0,Pradeep,2018-11-06 10:44:26+05:18,['2b2cb2daf710f1c6ff68f35e6fdef6b01495c7c2'],0,25,25,1676758,1,0,1,1,3374
dcb882817df88ae9548a410eabc8944dcc6c0481,0,peng.jianhua,2018-11-13 14:33:09+08:00,['48bf487e2b1eefad120bf005d8aea019adeb69d8'],2,2,4,1676762,1,,,,3374
3afe270e7c69dc643713a25597d0cb2f307e0737,0,peng.jianhua,2018-11-13 14:35:59+08:00,['dcb882817df88ae9548a410eabc8944dcc6c0481'],0,11,11,1676773,1,,,,3374
76bbcdafa1f69b5982dc9cf83d6aac06bfe7dae1,0,peng.jianhua,2018-11-13 14:46:03+08:00,['3afe270e7c69dc643713a25597d0cb2f307e0737'],2,5,7,1676780,1,0,1,1,3374
5285f6c749fe559e58e7c6937c708a2faaea1ca1,0,Sailaja Polavarapu,2018-11-13 16:22:01-08:00,['76bbcdafa1f69b5982dc9cf83d6aac06bfe7dae1'],27,105,132,1676912,1,0.180327869,0.229508197,0.229508197,3374
4b735de08f04ee6ece6b6f57fa4f4c8c17816b8a,1,Pradeep,2018-11-14 18:49:56+05:18,['5285f6c749fe559e58e7c6937c708a2faaea1ca1'],98,718,816,1677728,3,0.006677796,0.015025042,0.156928214,3374
a7d29df1f735a102c59079b4dbe7dde0129554f9,1,Mehul Parikh,2018-11-15 00:04:19+05:18,['4b735de08f04ee6ece6b6f57fa4f4c8c17816b8a'],27,94,121,1677849,3,0.057692308,0.961538462,1,3374
ffedb5fc719754a818a8c77d39e862689482b8eb,0,Sailaja Polavarapu,2018-11-16 13:39:30-08:00,['a7d29df1f735a102c59079b4dbe7dde0129554f9'],5,5,10,1677859,1,0,0,0,3374
181a3635eb38f98ac12e99e1d89cdca9c4b0635e,0,peng.jianhua,2018-11-19 14:58:00+08:00,['ffedb5fc719754a818a8c77d39e862689482b8eb'],12,21,33,1677892,1,0,0,1,3374
b517a47f1d696b3ee6345203db7fb5415c35160c,1,Don Bosco Durai,2018-11-19 14:29:20-08:00,['181a3635eb38f98ac12e99e1d89cdca9c4b0635e'],10,10,20,1677912,1,,,,3374
6d310e23f1b3619895f85e7108a1d5a54999e121,0,peng.jianhua,2018-11-20 11:19:34+08:00,['b517a47f1d696b3ee6345203db7fb5415c35160c'],1,12,13,1677925,1,,,,3374
d24b9a15bdc53539cf4e481bfadd7cc42fa7d229,0,peng.jianhua,2018-11-21 14:00:38+08:00,['6d310e23f1b3619895f85e7108a1d5a54999e121'],3,3,6,1677931,2,,,,3374
b101f44026b3b3ba2d0bb6ca1ca3bbbad87a822b,0,Bhavik Patel,2018-11-21 19:14:44+05:18,['d24b9a15bdc53539cf4e481bfadd7cc42fa7d229'],4,12,16,1677947,1,,,,3374
fed0498de221148cf42c235dad0652087dff8e39,0,Nitin Galave,2018-11-22 12:01:24+05:18,['b101f44026b3b3ba2d0bb6ca1ca3bbbad87a822b'],4,12,16,1677963,1,,,,3374
1cfa50f1e8627ef1c61b6da8c031e4f2b18420e5,1,peng.jianhua,2018-11-22 16:53:24+08:00,['fed0498de221148cf42c235dad0652087dff8e39'],11,10,21,1677984,2,1,0,0,3374
e02ae74c75d90a28bc32a48b9897fda699f2d025,1,Pradeep,2018-11-23 11:55:55+05:18,['1cfa50f1e8627ef1c61b6da8c031e4f2b18420e5'],1118,1782,2900,1680884,2,0,0,0,3374
93116a1c69dc795746b350dd12c94ddbe0e89fe2,0,Mehul Parikh,2018-11-23 18:45:35+05:18,['e02ae74c75d90a28bc32a48b9897fda699f2d025'],5,1,6,1680890,2,1,1,0,3374
760c4a261b1cb7f6eaadfb1040e4a676a00f28a0,0,Mehul Parikh,2018-11-26 17:45:44+05:18,['93116a1c69dc795746b350dd12c94ddbe0e89fe2'],0,2,2,1680892,1,0.5,1,1,3374
6ef3d5415aa1fd9810638738936753cff79f5390,1,Abhay Kulkarni,2018-11-29 11:54:40-08:00,['760c4a261b1cb7f6eaadfb1040e4a676a00f28a0'],5,39,44,1680936,1,0,0,0,3374
e6842a29e28b9c50c9315a68cc04785a312d420f,0,peng.jianhua,2018-12-11 10:41:56+08:00,['6ef3d5415aa1fd9810638738936753cff79f5390'],2,2,4,1680940,2,,,,3374
1af0cc79360a77f17e6044fe2e87be7f2db41be9,0,peng.jianhua,2018-12-11 10:43:03+08:00,['e6842a29e28b9c50c9315a68cc04785a312d420f'],0,2,2,1680942,1,,,,3374
6b944295904fd7372ae6e9e0bc10fd2109ea89ae,0,peng.jianhua,2018-12-12 09:08:20+08:00,['1af0cc79360a77f17e6044fe2e87be7f2db41be9'],1,8,9,1680951,1,,,,3374
8f2337d3dee43942f30068e401efa65cabfa32f8,0,peng.jianhua,2018-12-12 09:09:25+08:00,['6b944295904fd7372ae6e9e0bc10fd2109ea89ae'],2,5,7,1680958,2,1,,,3374
e483c201e9165d44565ff3060767104304cb7584,0,peng.jianhua,2018-12-12 09:11:36+08:00,['8f2337d3dee43942f30068e401efa65cabfa32f8'],4,4,8,1680966,1,,,,3374
3d282ccbff805aee28e08f95729c1bb72cd1c33e,0,Ramesh Mani,2018-12-12 11:45:53-08:00,['e483c201e9165d44565ff3060767104304cb7584'],3,36,39,1681005,2,0.208333333,0.875,0.875,3374
beaa563f11a932a63743a5a59a0a17870a08d3e9,0,Ramesh Mani,2018-12-12 12:05:16-08:00,['3d282ccbff805aee28e08f95729c1bb72cd1c33e'],1,1,2,1681007,1,,,,3374
563c26448ff66856f0896341d1c3a536f966d847,0,Mehul Parikh,2018-12-13 10:01:36+05:18,['beaa563f11a932a63743a5a59a0a17870a08d3e9'],0,2,2,1681009,2,,,,3374
5b07a8dfd7a3ab0d0f10690657d74345e964f163,0,Pradeep,2018-12-13 12:03:19+05:18,['563c26448ff66856f0896341d1c3a536f966d847'],254,1110,1364,1682373,21,,,,3374
51461487f72e0959aa01d657ef77a1a4176b4738,0,Pradeep,2018-12-13 12:04:46+05:18,['5b07a8dfd7a3ab0d0f10690657d74345e964f163'],3,14,17,1682390,5,0.090909091,0.454545455,1,3374
bb03ae43754f38a14e8358138178dea07dcb745a,0,Zsombor Gegesy,2018-12-13 14:01:19+01:00,['51461487f72e0959aa01d657ef77a1a4176b4738'],2,7,9,1682399,2,0,1,0,3374
f80ee0e76f492686a219d7712db2a3a6e34bc7ef,0,Pradeep,2018-12-17 13:45:01+05:18,['bb03ae43754f38a14e8358138178dea07dcb745a'],5,61,66,1682465,1,0,0,0,3374
f65be02bac380b681b204a0880c5cf5ea3f7c37e,0,Velmurugan Periasamy,2018-12-17 15:32:43-05:00,['f80ee0e76f492686a219d7712db2a3a6e34bc7ef'],1,1,2,1682467,1,,,,3374
339950e51eb98f4730409540bb613e8d17f8743f,0,Mehul Parikh,2018-12-19 16:56:03+05:18,['f65be02bac380b681b204a0880c5cf5ea3f7c37e'],1,4,5,1682472,1,0,0,1,3374
00ffa900695c842f95a5e9366768f670b041bde4,0,Selvamohan Neethiraj,2018-12-27 23:12:00-05:00,['339950e51eb98f4730409540bb613e8d17f8743f'],1,1,2,1682474,1,,,,3374
a97f0947e192ea67cba64a9ae4be18f6375b2dc3,0,Velmurugan Periasamy,2018-12-29 06:11:38+05:18,['00ffa900695c842f95a5e9366768f670b041bde4'],85,129,214,1682688,4,0,0,1,3374
26a11263292f05abd62684958ff78f94f67a3370,0,peng.jianhua,2018-12-29 13:24:27+08:00,['a97f0947e192ea67cba64a9ae4be18f6375b2dc3'],13,24,37,1682725,1,0,0,1,3374
38bb3b3fc726e5e7e4f6c315c1c421a678932c0b,0,peng.jianhua,2018-12-29 14:50:36+08:00,['26a11263292f05abd62684958ff78f94f67a3370'],0,9,9,1682734,2,0.9,1,1,3374
39a53b6c448145c2a68839233281671f754e519b,1,peng.jianhua,2018-12-29 15:26:01+08:00,['38bb3b3fc726e5e7e4f6c315c1c421a678932c0b'],3,2793,2796,1685530,33,0.252600297,0.606240713,0.714710253,3402
9ed59b32f790ccdce813f81860d7cdd344881630,1,Nitin Galave,2019-01-03 11:59:38+05:18,['39a53b6c448145c2a68839233281671f754e519b'],2,2,4,1685534,1,,,,3402
ead451a3383f33630f59c1996c478ddb6f6fb39f,0,Zsombor Gegesy,2019-01-03 11:20:21+01:00,['9ed59b32f790ccdce813f81860d7cdd344881630'],1,1,2,1685536,1,,,,3402
e1b0105eee67bb73c56b66b2dda1c3424555ab3e,1,Zsombor Gegesy,2019-01-04 17:13:08+01:00,['ead451a3383f33630f59c1996c478ddb6f6fb39f'],21,4247,4268,1689804,12,0.428571429,1,0.55952381,3407
a3394a19f98cea04dc2824fdaa4e3a3fdbd6beb3,1,Zsombor Gegesy,2019-01-11 20:02:18+01:00,['e1b0105eee67bb73c56b66b2dda1c3424555ab3e'],719,352,1071,1690875,2,,,,3407
2a7782db30f983ddacf9ea3fa53302a37a8b965c,0,Zsombor Gegesy,2019-01-13 21:07:34+01:00,['a3394a19f98cea04dc2824fdaa4e3a3fdbd6beb3'],3597,3664,7261,1698136,8,,,,3409
14d20f88ad012ed5054dc81583be7419b553688c,1,Pradeep,2019-01-23 10:23:50+05:18,['2a7782db30f983ddacf9ea3fa53302a37a8b965c'],165,410,575,1698711,9,,,,3409
ef333a3eec646bad732bdd29c3b6094f8f635ef4,0,Pradeep,2019-01-24 09:03:32+05:18,['14d20f88ad012ed5054dc81583be7419b553688c'],89,81,170,1698881,10,,,,3409
21a6d956833545a2b563abc4f284d32afa11f1f0,1,Pradeep,2019-01-24 18:16:53+05:18,['ef333a3eec646bad732bdd29c3b6094f8f635ef4'],4433,466,4899,1703780,1,0.983272347,0.932566649,1,3409
092320830f89bc426e68e4fe8a3e5e3255693571,1,Abhay Kulkarni,2019-01-26 16:17:53-08:00,['21a6d956833545a2b563abc4f284d32afa11f1f0'],388,11782,12170,1715950,148,0.486503719,0.680340064,0.847396387,3464
5274cc1600affad5c2b059cada4eda4703670477,0,Abhay Kulkarni,2019-01-29 14:28:45-08:00,['092320830f89bc426e68e4fe8a3e5e3255693571'],3,3,6,1715956,2,,,,3464
dac14f91e94af78204997a6cdf172c786a535a05,0,Pradeep,2019-01-30 08:44:07+05:18,['5274cc1600affad5c2b059cada4eda4703670477'],73,71,144,1716100,9,,,,3464
a5d212871588211870b711cd6ec5f3650c14079d,0,rmani,2019-02-12 15:36:53-08:00,['dac14f91e94af78204997a6cdf172c786a535a05'],0,1,1,1716101,1,,,,3464
48b594c0aedede17b6bb241155a3a7426c1c92cc,1,Abhay Kulkarni,2019-02-13 09:13:36-08:00,['a5d212871588211870b711cd6ec5f3650c14079d'],62,229,291,1716392,4,0,0,0.791666667,3464
54d052af00a15f9001c6de5928993e7f99f3b388,1,Abhay Kulkarni,2019-02-14 16:43:04-08:00,['48b594c0aedede17b6bb241155a3a7426c1c92cc'],1,44,45,1716437,3,0.108108108,0.108108108,1,3464
3f82ca40e5e2830e06cae690984fb09fce311ffc,1,Pradeep,2019-02-18 12:04:10+05:18,['54d052af00a15f9001c6de5928993e7f99f3b388'],142,374,516,1716953,21,0.055900621,0.093167702,0.863354037,3464
24e8f31af06433e159a6215b5bfb1588d7eb0700,1,Pradeep,2019-02-18 13:16:42+05:18,['3f82ca40e5e2830e06cae690984fb09fce311ffc'],14,69,83,1717036,5,0.279069767,0.697674419,1,3464
fe8df8598ac9ec73914b0981723f8d34e235f7b5,0,Nitin Galave,2019-02-25 12:34:24+05:18,['24e8f31af06433e159a6215b5bfb1588d7eb0700'],24,21,45,1717081,4,0.25,0.75,1,3464
fc4289222718d0c02ba65a994299d45ea1f4d97b,1,Gautam Borad,2019-02-25 18:42:10+05:18,['fe8df8598ac9ec73914b0981723f8d34e235f7b5'],16,718,734,1717815,13,0.202614379,0.235294118,0.72875817,3469
f78cf3f7aec119f7613b5dca98710aa3138e2d75,1,rmani,2019-02-27 16:05:32-08:00,['fc4289222718d0c02ba65a994299d45ea1f4d97b'],2250,1046,3296,1721111,55,0.113785558,0,0.949671772,3469
8d5659cb2789d971a67380df4d21c5da67ce9425,1,Nitin Galave,2019-03-04 10:58:16+05:18,['f78cf3f7aec119f7613b5dca98710aa3138e2d75'],24,34,58,1721169,11,1,0,1,3469
502cdb5aaead18c44077b209231cbcd1de94fefe,1,Nitin Galave,2019-03-04 11:37:06+05:18,['8d5659cb2789d971a67380df4d21c5da67ce9425'],11,50,61,1721230,2,0.909090909,0.909090909,0.757575758,3469
2f53635eb8a6f88e39e9fd6e948cd7f93d0c4c5a,1,Pradeep,2019-03-06 11:01:20+05:18,['502cdb5aaead18c44077b209231cbcd1de94fefe'],0,17,17,1721247,2,,,,3469
8c4920e70c6e700615a4fc12bfa81684337ad269,0,rmani,2019-03-06 12:15:05-08:00,['2f53635eb8a6f88e39e9fd6e948cd7f93d0c4c5a'],5,0,5,1721252,1,,,,3469
0f229b01e23b12d0c9e0c4ee3de817ce80d68a17,1,Abhay Kulkarni,2019-03-06 13:20:09-08:00,['8c4920e70c6e700615a4fc12bfa81684337ad269'],387,4085,4472,1725724,51,0.193548387,0.234491315,0.504342432,3481
8ebf1dc2fd5a8c4f0e7dca7f55cd7c60916de27a,1,Abhay Kulkarni,2019-03-07 09:49:38-08:00,['0f229b01e23b12d0c9e0c4ee3de817ce80d68a17'],8,16,24,1725748,1,0,0,0,3481
23e5e190e59baf525400633034f64832429a48c7,1,rmani,2019-03-07 11:22:58-08:00,['8ebf1dc2fd5a8c4f0e7dca7f55cd7c60916de27a'],16,295,311,1726059,25,0.348837209,0.697674419,0.790697674,3486
9c668fbdab6a4f327faaf9fc090200c5902e34ed,1,Abhay Kulkarni,2019-03-07 12:55:00-08:00,['23e5e190e59baf525400633034f64832429a48c7'],47,221,268,1726327,6,0.057471264,0.229885057,1,3488
4f0a7eae12850357014bff1ed0545fe401d1400c,1,Sailaja Polavarapu,2019-03-07 17:57:33-08:00,['9c668fbdab6a4f327faaf9fc090200c5902e34ed'],59,66,125,1726452,6,0.666666667,0.666666667,1,3488
a5c6adb025a8c741774ca893a995edd3d7beca25,0,Nitin Galave,2019-03-08 19:42:30+05:18,['4f0a7eae12850357014bff1ed0545fe401d1400c'],15,8,23,1726475,5,0,0,0,3488
a98bc87f84be631ec11f561c2daeea3724136078,0,Pradeep,2019-03-13 09:36:55+05:18,['a5c6adb025a8c741774ca893a995edd3d7beca25'],31,28,59,1726534,11,,,,3488
08f32cd35824399eaac573f47338fbe8433ed97e,1,Zsombor Gegesy,2019-03-13 10:28:15+01:00,['a98bc87f84be631ec11f561c2daeea3724136078'],45,94,139,1726673,13,,,,3488
3e04f089c9ad5b8e749c3faa08447cbe04be6dba,0,Zsombor Gegesy,2019-03-13 10:31:24+01:00,['08f32cd35824399eaac573f47338fbe8433ed97e'],20,20,40,1726713,1,,,,3488
daec465b36d8489c9237b0db9b8dde947d62db04,1,Nitin Galave,2019-03-13 14:50:05+05:18,['3e04f089c9ad5b8e749c3faa08447cbe04be6dba'],96,137,233,1726946,2,0.935483871,0.935483871,0.709677419,3488
b3cb2248aba52af7c6bf977dfe921ca329265f12,0,Mehul Parikh,2019-03-13 18:15:38+05:18,['daec465b36d8489c9237b0db9b8dde947d62db04'],3,3,6,1726952,2,0,0,1,3488
754a0271e882ef55e9ac4fd5a82043e41b350dd9,0,Sailaja Polavarapu,2019-03-13 10:53:11-07:00,['b3cb2248aba52af7c6bf977dfe921ca329265f12'],1,1,2,1726954,1,,,,3488
cd9c2fd6bc013a2e5c2d66cf6ad7843c97a513cb,1,Nitin Galave,2019-03-14 11:01:36+05:18,['754a0271e882ef55e9ac4fd5a82043e41b350dd9'],42,80,122,1727076,5,0.026315789,0.052631579,1,3488
c3b034bff23797130fbf2c718b572bd3a3f56a5d,1,Pradeep,2019-03-15 09:07:10+05:18,['cd9c2fd6bc013a2e5c2d66cf6ad7843c97a513cb'],10,44,54,1727130,6,,,,3488
9f09d87e22ff2eb9324fd46959e21f1a54f69929,0,Abhay Kulkarni,2019-03-21 15:23:41-07:00,['c3b034bff23797130fbf2c718b572bd3a3f56a5d'],21,1095,1116,1728246,8,0.318584071,0.14159292,1,3493
7c52a79a5d0b41bfc94caca9d531e0fefba2bfe7,0,Mehul Parikh,2019-03-22 14:28:10+05:18,['9f09d87e22ff2eb9324fd46959e21f1a54f69929'],20,34,54,1728300,2,0,0.388888889,0,3493
d8ab9468823f5f5c7c46582962f946a2bab5ce05,1,Abhay Kulkarni,2019-03-25 07:53:27-07:00,['7c52a79a5d0b41bfc94caca9d531e0fefba2bfe7'],69,622,691,1728991,7,0.36,1,1,3494
9c39c880971686f0255ac21feb50665b02ce0b04,1,rmani,2019-03-25 14:00:54-07:00,['d8ab9468823f5f5c7c46582962f946a2bab5ce05'],63,673,736,1729727,13,0.138790036,0.284697509,0.647686833,3497
9ea9cc9a09b224d495b7131b87f36f709ac0cfae,1,rmani,2019-03-25 14:28:50-07:00,['9c39c880971686f0255ac21feb50665b02ce0b04'],34,344,378,1730105,10,0.614942529,0.931034483,1,3499
acbaa5c8800917a682ae756b16939c57cfbae948,1,rmani,2019-03-27 00:08:32-07:00,['9ea9cc9a09b224d495b7131b87f36f709ac0cfae'],85,312,397,1730502,5,0.284916201,0.296089385,0.709497207,3499
9ab8bdea0178d0561819ebc53b1ed50cdfd494d0,1,rmani,2019-03-27 00:11:42-07:00,['acbaa5c8800917a682ae756b16939c57cfbae948'],2,14,16,1730518,3,,,,3499
3cd11e75adc5e5ad11aab907f458fd62ec561826,0,rmani,2019-03-27 15:44:02-07:00,['9ab8bdea0178d0561819ebc53b1ed50cdfd494d0'],7,20,27,1730545,1,0,0,1,3499
ec57902585882981b9728fc0d452912b1dd8f529,1,peng.jianhua,2019-03-29 14:14:50+08:00,['3cd11e75adc5e5ad11aab907f458fd62ec561826'],16,26,42,1730587,4,0,1,0,3499
6edc9bf03f9ef26ce14ac9c039fc1a095c71773b,1,Mehul Parikh,2019-03-29 19:10:56+05:18,['ec57902585882981b9728fc0d452912b1dd8f529'],1,733,734,1731321,7,0.127705628,0.66017316,0.688311688,3500
d4d4f655d76e902cc8ad611e5b56d66d4487218e,1,Abhay Kulkarni,2019-04-01 09:18:41-07:00,['6edc9bf03f9ef26ce14ac9c039fc1a095c71773b'],41,131,172,1731493,10,0.838709677,0.967741935,0.741935484,3500
c1d9ae7530d4840fe890c234902c04cd20eeff9d,1,Pradeep,2019-04-03 10:29:50+05:18,['d4d4f655d76e902cc8ad611e5b56d66d4487218e'],6,13,19,1731512,1,,,,3500
a4afbe9ac9067435aecbd7ac370c6b99c0b7593f,1,Abhay Kulkarni,2019-04-07 15:24:33-07:00,['c1d9ae7530d4840fe890c234902c04cd20eeff9d'],93,120,213,1731725,4,0.517241379,0,0.206896552,3500
767d69e335a70bdb96fed39623facd4319397980,0,Nitin Galave,2019-04-10 11:24:10+05:18,['a4afbe9ac9067435aecbd7ac370c6b99c0b7593f'],84,70,154,1731879,8,0.153846154,0,1,3500
a232c6421a5be65cd2a3d4b1f2a1155754f3edb4,0,Nitin Galave,2019-04-10 11:25:17+05:18,['767d69e335a70bdb96fed39623facd4319397980'],6,6,12,1731891,1,,,,3500
4eb557a8d9c15015042765235980678ae8d15fd3,1,Zsombor Gegesy,2019-04-10 12:23:32+02:00,['a232c6421a5be65cd2a3d4b1f2a1155754f3edb4'],28,10,38,1731929,6,0,0,0,3500
cc3be6945aa66af55a2c289ec3c447f760f48c0d,1,rmani,2019-04-11 13:19:44-07:00,['4eb557a8d9c15015042765235980678ae8d15fd3'],31,1347,1378,1733307,16,0.346938776,0.526530612,0.875510204,3504
bcfb4c6b3eceecd819aa0ccbbcb3a1685de447b3,0,rmani,2019-04-11 13:29:03-07:00,['cc3be6945aa66af55a2c289ec3c447f760f48c0d'],12,97,109,1733416,5,0,0.5,0.685714286,3504
33c716502db9498abe34c96ef47591946407c9b1,1,rmani,2019-04-11 14:57:45-07:00,['bcfb4c6b3eceecd819aa0ccbbcb3a1685de447b3'],9,375,384,1733800,15,0.378571429,0.25,0.921428571,3505
fd18bf1d94724876d98ec1fb5ef1c38dc79896ff,1,Mehul Parikh,2019-04-12 14:02:00+05:18,['33c716502db9498abe34c96ef47591946407c9b1'],41,142,183,1733983,10,0,0,1,3506
c1f296949ac34403024fbb478d1c304f2a90c786,1,Mehul Parikh,2019-04-12 14:02:08+05:18,['fd18bf1d94724876d98ec1fb5ef1c38dc79896ff'],0,56,56,1734039,1,1,1,1,3506
c74745d8af0cc72ed893517ac6778fce3a518a9b,1,Mehul Parikh,2019-04-15 10:25:55+05:18,['c1f296949ac34403024fbb478d1c304f2a90c786'],23,105,128,1734167,4,0,0.97260274,0.904109589,3506
1b4c97ab24b36b9193ca5841c311dbb63414b402,0,zhangqiang2,2019-04-15 14:14:20+08:00,['c74745d8af0cc72ed893517ac6778fce3a518a9b'],0,1,1,1734168,1,,,,3506
e986ea6c799b365bf2122d48a894cc7e4aa1c45a,1,Pradeep,2019-04-15 13:12:10+05:18,['1b4c97ab24b36b9193ca5841c311dbb63414b402'],16,52,68,1734236,4,0,0,1,3506
79c2504d1d022ecccfa9ff69e33502bd59c762b5,1,Nitin Galave,2019-04-16 18:42:52+05:18,['e986ea6c799b365bf2122d48a894cc7e4aa1c45a'],109,699,808,1735044,29,1,0.685714286,0.99047619,3508
03043c1c611b9d2177786855864a5471e14ecf50,1,Pradeep,2019-04-16 19:16:24+05:18,['79c2504d1d022ecccfa9ff69e33502bd59c762b5'],8,147,155,1735199,32,0.594594595,0.837837838,0.756756757,3508
4668bf8d7175d8d6dd37c3c6a2663008f7899080,0,rmani,2019-04-16 12:24:50-07:00,['03043c1c611b9d2177786855864a5471e14ecf50'],1,238,239,1735438,7,0.377622378,0.377622378,1,3509
9a9c0818be45475a7609cc1a582add27bbcf761f,0,rmani,2019-04-17 12:08:25-07:00,['4668bf8d7175d8d6dd37c3c6a2663008f7899080'],0,17,17,1735455,1,,,,3509
c5fab5a84df2b68cc4838bd1da6078ba78466603,1,Abhay Kulkarni,2019-04-17 12:25:06-07:00,['9a9c0818be45475a7609cc1a582add27bbcf761f'],118,372,490,1735945,30,0.551724138,0,0,3514
02dbca6c302b8036bdde5fdc30620342bd0b7663,1,Pradeep,2019-04-18 08:55:28+05:18,['c5fab5a84df2b68cc4838bd1da6078ba78466603'],6931,206,7137,1743082,12,,,,3514
050000ceccb616ab5dff109283a1f7c4d42bb878,0,Abhay Kulkarni,2019-04-18 13:21:48-07:00,['02dbca6c302b8036bdde5fdc30620342bd0b7663'],11,13,24,1743106,1,0,0,0,3514
4f1a65ddeceee932444cce7e8354afffe198133b,0,Abhay Kulkarni,2019-04-19 16:43:47-07:00,['050000ceccb616ab5dff109283a1f7c4d42bb878'],27,34,61,1743167,12,0,0,1,3514
7581932cb42ecb908925f4dfc844cb190ad504cd,1,Abhay Kulkarni,2019-04-22 09:37:08-07:00,['4f1a65ddeceee932444cce7e8354afffe198133b'],29,364,393,1743560,9,0.363636364,0.363636364,1,3515
afd54d6b88f4a34db1e63ca47caf28f48b9e8c77,0,Pradeep,2019-04-23 09:57:01+05:18,['7581932cb42ecb908925f4dfc844cb190ad504cd'],12,17,29,1743589,11,1,1,1,3515
2b593e64afcd64301a8c2fed2ca8ce3b5c157293,0,Pradeep,2019-04-23 11:05:02+05:18,['afd54d6b88f4a34db1e63ca47caf28f48b9e8c77'],4,4,8,1743597,2,,,,3515
816a560a91e419662a3f0889938af48694670079,0,Pradeep,2019-04-24 12:27:16+05:18,['2b593e64afcd64301a8c2fed2ca8ce3b5c157293'],1,4,5,1743602,3,0,1,1,3515
456d22d172925a1d763597b98e90eea103c70eae,1,rmani,2019-04-24 15:26:14-07:00,['816a560a91e419662a3f0889938af48694670079'],7,7,14,1743616,1,,,,3515
ded45a82738774097ac5ee4ec7424334dd4f30f0,0,Mehul Parikh,2019-04-25 15:47:49+05:18,['456d22d172925a1d763597b98e90eea103c70eae'],2,23,25,1743641,2,0.736842105,0.947368421,1,3515
d34d024e8afa64e8b5865eb3284ecf6a57928b30,0,rmani,2019-04-25 14:24:58-07:00,['ded45a82738774097ac5ee4ec7424334dd4f30f0'],4,12,16,1743657,1,1,1,1,3515
c9f8102cc8dfe80e15d12fa936e9956224d6238e,1,Pradeep,2019-04-26 11:06:27+05:18,['d34d024e8afa64e8b5865eb3284ecf6a57928b30'],385,744,1129,1744786,18,0.204697987,0.308724832,0.624161074,3515
4096838b60be4190ee9223369f6b27d93eb1190d,1,Abhay Kulkarni,2019-04-27 09:58:21-07:00,['c9f8102cc8dfe80e15d12fa936e9956224d6238e'],104,142,246,1745032,4,0.125,0.125,0.5,3515
8202ed4aed53ad93a21b27dcf83cdf7102678fa0,1,Pradeep,2019-04-29 12:33:20+05:18,['4096838b60be4190ee9223369f6b27d93eb1190d'],60,261,321,1745353,4,0.020408163,0.034013605,1,3515
2c71271223176413f95a9adb82ee72ea82f83881,0,rmani,2019-05-01 13:33:56-07:00,['8202ed4aed53ad93a21b27dcf83cdf7102678fa0'],51,23,74,1745427,8,0,0,0,3515
6e24cb2b9352844f29e82ab8821756cb8588f957,0,Pradeep,2019-05-04 07:20:50+05:18,['2c71271223176413f95a9adb82ee72ea82f83881'],0,40,40,1745467,1,1,1,0,3516
bf4a1ffcb8e17926bf84580b2d1408a2f1436c99,1,Pradeep,2019-05-04 07:22:05+05:18,['6e24cb2b9352844f29e82ab8821756cb8588f957'],109,192,301,1745768,6,1,0.865671642,0.850746269,3516
56fd7ff5ccb5aac38fead8ed6224a030fd010fd7,1,Pradeep,2019-05-06 11:31:08+05:18,['bf4a1ffcb8e17926bf84580b2d1408a2f1436c99'],1,77,78,1745846,2,0.02173913,1,1,3516
45f639f21bb7ae6581443e688392016aa65fb8bb,0,Abhay Kulkarni,2019-05-07 13:02:16-07:00,['56fd7ff5ccb5aac38fead8ed6224a030fd010fd7'],28,164,192,1746038,2,1,1,0,3516
5dd8e4f9d52b0093f242f756d8b007ba7637ff4b,0,Pradeep,2019-05-08 13:18:42+05:18,['45f639f21bb7ae6581443e688392016aa65fb8bb'],9,14,23,1746061,2,,,,3516
91dfeb7d322f56549a5f311ef311a1a3b0cb34da,0,Pradeep,2019-05-09 11:14:19+05:18,['5dd8e4f9d52b0093f242f756d8b007ba7637ff4b'],1,4,5,1746066,1,,,,3516
ecab208744d2fa653259c1db7645dca28ff748ed,1,Pradeep,2019-05-10 17:19:50+05:18,['91dfeb7d322f56549a5f311ef311a1a3b0cb34da'],89,160,249,1746315,7,0,0,1,3516
f2d310a54ee64a1738a9c1a6afdd93d032e64ddf,1,Abhay Kulkarni,2019-05-10 09:32:34-07:00,['ecab208744d2fa653259c1db7645dca28ff748ed'],1,19,20,1746335,3,0,0.5,1,3516
11a88bdc6317ee522d4173a0044d4f5738fe944d,0,Pradeep,2019-05-14 09:14:38+05:18,['f2d310a54ee64a1738a9c1a6afdd93d032e64ddf'],39,40,79,1746414,1,0,0,1,3516
276f2215fc424ba06cef56a4c432e99914482015,0,Mehul Parikh,2019-05-14 13:55:18+05:18,['11a88bdc6317ee522d4173a0044d4f5738fe944d'],1,3,4,1746418,2,0,0,1,3516
f2da9978b593cc777d78d18f54d292c00f18f4ca,0,Abhay Kulkarni,2019-05-14 10:52:24-07:00,['276f2215fc424ba06cef56a4c432e99914482015'],2,2,4,1746422,1,,,,3516
90a99603882494c45102d50059803535bf4d0165,1,Abhay Kulkarni,2019-05-16 13:37:57-07:00,['f2da9978b593cc777d78d18f54d292c00f18f4ca'],28,38,66,1746488,2,0,0,1,3516
e97cd528213c71f0d6c762e504370b423ba58f9a,0,Pradeep,2019-05-17 09:48:00+05:18,['90a99603882494c45102d50059803535bf4d0165'],1,11,12,1746500,2,,,,3516
35eb4511ace03c0d3bfc7b7427b3fdd7b22e85ac,0,Nitin Galave,2019-05-20 18:01:35+05:18,['e97cd528213c71f0d6c762e504370b423ba58f9a'],2,12,14,1746514,2,,,,3516
0adbd66a7a6f27d120641d481a452a2c036e35c0,1,Nitin Galave,2019-05-20 18:01:35+05:18,['35eb4511ace03c0d3bfc7b7427b3fdd7b22e85ac'],2,5,7,1746521,1,0,1,1,3516
43757e798751ffab99dbe15ab3f9ae0773ae69f7,1,Mehul Parikh,2019-05-20 18:43:47+05:18,['0adbd66a7a6f27d120641d481a452a2c036e35c0'],1,3209,3210,1749731,25,0.448916409,0.609907121,0.553405573,3537
50d7d0cc3a33b8d1b89c8ba854e424fc8f86a0a8,0,Pradeep,2019-05-21 08:42:55+05:18,['43757e798751ffab99dbe15ab3f9ae0773ae69f7'],12,14,26,1749757,1,1,1,1,3537
2c8a947f800d705867f5f6a22e6d738b3c5a3d19,0,Pradeep,2019-05-21 10:22:07+05:18,['50d7d0cc3a33b8d1b89c8ba854e424fc8f86a0a8'],0,77,77,1749834,3,0,0.835616438,0.835616438,3537
73283c991a4ffdf72615ee18845df3fe0437fd6e,0,Pradeep,2019-05-21 18:35:44+05:18,['2c8a947f800d705867f5f6a22e6d738b3c5a3d19'],0,2,2,1749836,1,,,,3537
a72724663c7d52baa3bca048a18e9a89fad7b65b,0,Pradeep,2019-05-22 08:48:55+05:18,['73283c991a4ffdf72615ee18845df3fe0437fd6e'],0,136,136,1749972,2,1,1,1,3539
b788f239133fc4ddd376f14ff47db228993168a9,0,Nikhil P,2019-05-23 11:19:38+05:18,['a72724663c7d52baa3bca048a18e9a89fad7b65b'],4,12,16,1749988,1,,,,3539
184c9b74f9999daeed51f5240ce1d47d3829283b,1,Nikhil P,2019-05-27 12:00:02+05:18,['b788f239133fc4ddd376f14ff47db228993168a9'],3,57,60,1750048,5,0.591836735,0.06122449,0.959183673,3539
db10a1d88ea9b7982d332a92044bcada1ea12ff5,1,Nitin Galave,2019-05-27 15:38:11+05:18,['184c9b74f9999daeed51f5240ce1d47d3829283b'],10,137,147,1750195,7,0.20754717,0,0.830188679,3539
4d1156875244c9bc6f9bd34bfae7d65a1e634552,1,Abhay Kulkarni,2019-05-28 14:55:15-07:00,['db10a1d88ea9b7982d332a92044bcada1ea12ff5'],256,141,397,1750592,16,1,0.214285714,0.031746032,3540
373305eb30573685e24a06b1c7e480d023303478,1,Pradeep,2019-05-29 10:41:04+05:18,['4d1156875244c9bc6f9bd34bfae7d65a1e634552'],7,30,37,1750629,5,,,,3540
abfdb0893f3cd50ced6941d059c08fb82380f598,0,Nikhil P,2019-05-29 15:20:59+05:18,['373305eb30573685e24a06b1c7e480d023303478'],7,11,18,1750647,1,0,0,1,3540
a69820be287d9ae1a6ed390a8a2d17dbe44eb88f,0,rmani,2019-05-29 12:42:20-07:00,['abfdb0893f3cd50ced6941d059c08fb82380f598'],12,48,60,1750707,1,1,1,1,3540
37c48a7d04cde78ac023799eaa1ced7ade0fa36d,0,Madhan Neethiraj,2019-05-29 13:01:00-07:00,['a69820be287d9ae1a6ed390a8a2d17dbe44eb88f'],2,2,4,1750711,1,,0,,3540
18d0f1ab8903968f7ed6005b1608ab2e375ce228,0,Pradeep,2019-05-30 14:00:18+05:18,['37c48a7d04cde78ac023799eaa1ced7ade0fa36d'],7,3,10,1750721,1,0,0,0,3540
e9b149324d1856eef88cd28ef8096e48e9842927,1,Abhay Kulkarni,2019-05-30 12:39:03-07:00,['18d0f1ab8903968f7ed6005b1608ab2e375ce228'],148,6809,6957,1757678,94,0.531887202,0.645986985,0.822993492,3578
21d9cbe34d553cdab5090c64214cdd5faa485a07,0,rmani,2019-05-31 15:13:43-07:00,['e9b149324d1856eef88cd28ef8096e48e9842927'],0,1,1,1757679,1,0,0,1,3578
e6a36dbf8a98c1601e56865608292f4523811eab,0,Abhay Kulkarni,2019-06-03 11:03:01-07:00,['21d9cbe34d553cdab5090c64214cdd5faa485a07'],6,341,347,1758026,2,0.310502283,0.420091324,1,3579
d7e11a8fb8af5a255bb99689b6111f2f77a19559,1,Sailaja Polavarapu,2019-06-03 15:40:27-07:00,['e6a36dbf8a98c1601e56865608292f4523811eab'],7,10,17,1758043,1,0,0,0,3579
389a6bc46625b0dad10f6638b3a8160b0d3418c5,0,Mehul Parikh,2019-06-04 14:04:04+05:18,['d7e11a8fb8af5a255bb99689b6111f2f77a19559'],4,4,8,1758051,4,,,,3579
4c3b1149f31173cc7a4c483dcb0aff74904cb3da,1,Nikhil P,2019-06-04 15:02:51+05:18,['389a6bc46625b0dad10f6638b3a8160b0d3418c5'],3,9,12,1758063,1,0,0,0,3579
df1d5f93c5e5abda6aacca4a11b45ff752a565ec,0,Nitin Galave,2019-06-04 17:26:18+05:18,['4c3b1149f31173cc7a4c483dcb0aff74904cb3da'],4,19,23,1758086,4,1,0,,3579
3eabec946903be55bcb4eb12ab40a0421de2a192,1,rmani,2019-06-06 10:29:21-07:00,['df1d5f93c5e5abda6aacca4a11b45ff752a565ec'],0,4,4,1758090,1,0,0,1,3579
444db6edb092f23de89813503dae04f909e5325e,1,Zsombor Gegesy,2019-06-06 21:04:54+02:00,['3eabec946903be55bcb4eb12ab40a0421de2a192'],60,139,199,1758289,6,0.46875,0.109375,1,3579
322cb64cf20ea7e9b3e20aa35761345c78fdd66f,0,Abhay Kulkarni,2019-06-06 13:11:13-07:00,['444db6edb092f23de89813503dae04f909e5325e'],1,1,2,1758291,1,,,,3579
35037380d4eb099c31ee52efcd5d0c0429d8e3b4,1,Pradeep,2019-06-10 13:49:47+05:18,['322cb64cf20ea7e9b3e20aa35761345c78fdd66f'],9,14,23,1758314,3,,,,3579
3a694b71a3535afad941380ccdcd2a177df82fe7,0,rmani,2019-06-11 12:55:59-07:00,['35037380d4eb099c31ee52efcd5d0c0429d8e3b4'],0,80,80,1758394,1,0.466666667,1,1,3580
3e6df72d24c81aea6ef5adb978218a2eb9e3572f,0,rmani,2019-06-13 14:24:24-07:00,['3a694b71a3535afad941380ccdcd2a177df82fe7'],6,123,129,1758523,2,,,,3581
9d8e5274f60b0104a0788a028b9ab91ba72e8d73,0,Mehul Parikh,2019-06-14 11:22:28+05:18,['3e6df72d24c81aea6ef5adb978218a2eb9e3572f'],7,23,30,1758553,4,0,0,0.571428571,3581
581422ce16d696a8d50ff1a25fb2e3bcc7d3ab9f,0,Velmurugan Periasamy,2019-06-14 13:31:46-04:00,['9d8e5274f60b0104a0788a028b9ab91ba72e8d73'],0,3,3,1758556,3,,,,3581
bf5f75532923edd2feca16f9961744e486628bb8,1,rmani,2019-06-18 10:22:23-07:00,['581422ce16d696a8d50ff1a25fb2e3bcc7d3ab9f'],1,2,3,1758559,2,0,0,0,3581
391e2f4359a5450d037f56b190c416af929c7607,0,rmani,2019-06-18 10:23:06-07:00,['bf5f75532923edd2feca16f9961744e486628bb8'],0,1,1,1758560,1,0,0,1,3581
016b32846f855cb76df718aa06f3e872ac80d7ea,0,Mehul Parikh,2019-06-19 10:41:29+05:18,['391e2f4359a5450d037f56b190c416af929c7607'],10470,10708,21178,1779738,7,1,0.678571429,1,3583
eded676d2d727e2aec7c63399890a8eb3e8981d5,0,Nitin Galave,2019-06-20 11:38:21+05:18,['016b32846f855cb76df718aa06f3e872ac80d7ea'],130,104,234,1779972,5,1,1,1,3583
51bb1f831f956c6f88efb5305fd7aeb3859aee1f,1,Nikhil P,2019-06-24 19:22:55+05:18,['eded676d2d727e2aec7c63399890a8eb3e8981d5'],171,208,379,1780351,29,1,0.875,0,3584
a9b5e51b1db5b0ebe5ba43c47ae37227a80e5530,1,Pradeep,2019-06-25 10:15:56+05:18,['51bb1f831f956c6f88efb5305fd7aeb3859aee1f'],1,21,22,1780373,1,,,,3584
a3e0d03ac3882cce7057228df05d0899e6fda4c7,1,Abhay Kulkarni,2019-06-26 17:41:14-07:00,['a9b5e51b1db5b0ebe5ba43c47ae37227a80e5530'],63,206,269,1780642,2,0.150943396,0.150943396,0.952830189,3584
0853d8b47b3ab29287ddd7bbffb9cbcc0527d087,1,Pradeep,2019-06-27 14:04:54+05:18,['a3e0d03ac3882cce7057228df05d0899e6fda4c7'],219,114,333,1780975,4,0.93442623,0.532786885,0.827868852,3585
74b9bf6fe6ae923130635971e374efa0fa0f05b1,0,Pradeep,2019-06-27 14:07:21+05:18,['0853d8b47b3ab29287ddd7bbffb9cbcc0527d087'],3,18,21,1780996,4,0.583333333,0.666666667,1,3585
552d93c7da27f245847a9557c3b5779e05f78a4d,1,Pradeep,2019-06-29 07:32:19+05:18,['74b9bf6fe6ae923130635971e374efa0fa0f05b1'],0,181,181,1781177,13,0.906976744,0.930232558,0.988372093,3587
0b8d942dec39a9db32b0e81cd7e24650a7894000,0,Pradeep,2019-06-29 11:50:38+05:18,['552d93c7da27f245847a9557c3b5779e05f78a4d'],3,13,16,1781193,1,0,0,1,3587
4bb0d6758aadc242d596935453ded02b71b71893,0,Pradeep,2019-07-01 19:15:15+05:18,['0b8d942dec39a9db32b0e81cd7e24650a7894000'],2,137,139,1781332,2,0.101694915,0.101694915,0.101694915,3587
b66eafe0802ba9656b705103e9ed7ab5accbd916,1,Pradeep,2019-07-01 19:26:46+05:18,['4bb0d6758aadc242d596935453ded02b71b71893'],46,61,107,1781439,3,1,1,1,3587
ee4947dcd1fb4935bcd3e531c2df7a6c2460e4b8,0,Pradeep,2019-07-01 19:41:22+05:18,['b66eafe0802ba9656b705103e9ed7ab5accbd916'],1,1,2,1781441,1,,,,3587
7fe2d8e368f71df2c2b0b7c81629402fba6b81bf,0,Nikhil P,2019-07-02 17:58:25+05:18,['ee4947dcd1fb4935bcd3e531c2df7a6c2460e4b8'],0,14,14,1781455,2,0.636363636,0.636363636,0.909090909,3587
4e06740213483663918a14c23523333f117abebc,1,rmani,2019-07-02 15:30:22-07:00,['7fe2d8e368f71df2c2b0b7c81629402fba6b81bf'],0,351,351,1781806,3,0.379746835,1,1,3590
fd9c2852aebb785309825721e3deefdcf5e0d99d,1,rmani,2019-07-02 16:10:51-07:00,['4e06740213483663918a14c23523333f117abebc'],1,619,620,1782426,9,0.461538462,0.461538462,0.875,3593
02251177c90bf023fc50729b2a20e90f9ab52101,0,Abhay Kulkarni,2019-07-08 12:32:30-07:00,['fd9c2852aebb785309825721e3deefdcf5e0d99d'],3,37,40,1782466,3,,,,3593
003ac834be8990b7422c14ac623e76a1eeb7fb2f,0,Abhay Kulkarni,2019-07-08 13:33:52-07:00,['02251177c90bf023fc50729b2a20e90f9ab52101'],37,3,40,1782506,3,,,,3593
79e034414211bae94b8d22f14cf833ef0670297d,0,Abhay Kulkarni,2019-07-08 13:35:53-07:00,['003ac834be8990b7422c14ac623e76a1eeb7fb2f'],3,37,40,1782546,3,,,,3593
93b1674e2d0b48730ec206358bd07da03882c2c6,0,Velmurugan Periasamy,2019-07-09 14:50:40-04:00,['79e034414211bae94b8d22f14cf833ef0670297d'],1,1,2,1782548,1,,,,3593
b75ec8350aa3a3dceb9710fcc98a96cf0efdf6f5,0,Velmurugan Periasamy,2019-07-09 16:32:14-04:00,['93b1674e2d0b48730ec206358bd07da03882c2c6'],2,10,12,1782560,1,,,,3593
1fa2d1715a3915019abc3574d7fe0b96c9c02e0a,1,Abhay Kulkarni,2019-07-10 17:31:50-07:00,['b75ec8350aa3a3dceb9710fcc98a96cf0efdf6f5'],25,64,89,1782649,5,0.037037037,0.851851852,1,3593
84a59fad2a3aa3057c7a47a6ab0cd5e6236a6442,1,Pradeep,2019-07-11 09:16:10+05:18,['1fa2d1715a3915019abc3574d7fe0b96c9c02e0a'],97,258,355,1783004,13,0.164383562,0.328767123,0.534246575,3593
cde99034f656a102d21d507002406a9804b2cd99,1,Pradeep,2019-07-11 09:19:21+05:18,['84a59fad2a3aa3057c7a47a6ab0cd5e6236a6442'],27,61,88,1783092,1,0,0.514285714,0.428571429,3593
a4d1bed527007bcf0c95d9ec7b741cb058e9576c,0,Velmurugan Periasamy,2019-07-11 14:57:35-04:00,['cde99034f656a102d21d507002406a9804b2cd99'],3,3,6,1783098,1,,,,3593
1a133fe1e4203fb684e665009bb9b7dc72bfb5ef,1,Pradeep,2019-07-12 15:58:17+05:18,['a4d1bed527007bcf0c95d9ec7b741cb058e9576c'],6,9,15,1783113,1,0,1,1,3593
c2fdfbc09c29f41d3c02b27faef3c5f7e57ffbb2,1,Sailaja Polavarapu,2019-07-12 16:50:07-07:00,['1a133fe1e4203fb684e665009bb9b7dc72bfb5ef'],411,2820,3231,1786344,40,0.187206573,0.297535211,0.617957746,3596
5100d60ce72333c220eddf3b1d9cb3556de23efd,1,Abhay Kulkarni,2019-07-16 22:24:30-07:00,['c2fdfbc09c29f41d3c02b27faef3c5f7e57ffbb2'],14,227,241,1786585,9,0.086538462,0,0.798076923,3596
61f3e6280e291baf45be652bf0ec4ea0662d623a,1,Nitin Galave,2019-07-18 10:57:40+05:18,['5100d60ce72333c220eddf3b1d9cb3556de23efd'],53,152,205,1786790,8,0.379310345,1,0.948275862,3596
11a2515986bf88c5f7964bd8bbaf657dd18ce606,1,Pradeep,2019-07-19 14:05:50+05:18,['61f3e6280e291baf45be652bf0ec4ea0662d623a'],22,67,89,1786879,2,0,0,0.422222222,3596
1aa4a4b15f1474f6beee72fb6ba7ac178eddc34d,0,Nitin Galave,2019-07-19 18:49:28+05:18,['11a2515986bf88c5f7964bd8bbaf657dd18ce606'],15,22,37,1786916,2,0,0,1,3596
258a59109a04bfa14e694a193b7cbf441d477371,0,Abhay Kulkarni,2019-07-19 11:13:57-07:00,['1aa4a4b15f1474f6beee72fb6ba7ac178eddc34d'],1,1,2,1786918,1,,,,3596
a3ec3a01cc169384ff3352ca992e64c2453e3041,0,Selvamohan Neethiraj,2019-07-21 02:09:17+05:18,['258a59109a04bfa14e694a193b7cbf441d477371'],0,1,1,1786919,1,,,,3596
d0e5fe90752b21365d5b86d92936b48ea53c6ab2,0,Pradeep,2019-07-22 10:44:03+05:18,['a3ec3a01cc169384ff3352ca992e64c2453e3041'],148,417,565,1787484,7,0.670157068,1,1,3596
9cf43fedab0b0c7cd137f212c345d0c01da0c5e3,0,Pradeep,2019-07-24 11:21:18+05:18,['d0e5fe90752b21365d5b86d92936b48ea53c6ab2'],0,26,26,1787510,1,0,1,1,3596
0b59d334ecd150d04c987e261c948edd41077438,0,Pradeep,2019-07-26 14:32:48+05:18,['9cf43fedab0b0c7cd137f212c345d0c01da0c5e3'],8,8,16,1787526,1,,,,3596
992ee374ffe39f5852de2adc57ea3334a11d6572,0,Pradeep,2019-07-26 14:33:48+05:18,['0b59d334ecd150d04c987e261c948edd41077438'],0,2,2,1787528,2,,,,3598
4344fcff44c1bfd7e7a32ad58c426c0c2f00c8b0,1,Abhay Kulkarni,2019-07-28 22:44:28-07:00,['992ee374ffe39f5852de2adc57ea3334a11d6572'],2,18,20,1787548,3,1,1,1,3598
34d233ad00aeb37c5ede84552433c9c2c0e10264,1,Pradeep,2019-07-30 09:14:34+05:18,['4344fcff44c1bfd7e7a32ad58c426c0c2f00c8b0'],27,32,59,1787607,1,0,0.8,0,3598
5aaa99ef1b1c35c702498138c2b9bc38f957e748,1,Pradeep,2019-07-30 11:01:51+05:18,['34d233ad00aeb37c5ede84552433c9c2c0e10264'],13,66,79,1787686,7,0.146341463,0.146341463,0.365853659,3598
f404418a4b220fd0d34333c854e6edf88d061650,1,Nikhil P,2019-07-30 12:04:58+05:18,['5aaa99ef1b1c35c702498138c2b9bc38f957e748'],2,49,51,1787737,1,0.888888889,0.888888889,1,3598
d8486f2888e31262d326fe0b61750542bbddbfac,0,Nikhil P,2019-07-30 19:12:29+05:18,['f404418a4b220fd0d34333c854e6edf88d061650'],59,105,164,1787901,2,0,0,1,3598
9b8eaa3d3179e13fceb896f677debb248b9529f0,1,Sailaja Polavarapu,2019-07-30 15:30:18-07:00,['d8486f2888e31262d326fe0b61750542bbddbfac'],1,2270,2271,1790172,21,0.122905028,0.294227188,0.655493482,3616
0ffdf13d3c8556a75d88404ad90fedd497979754,1,Pradeep,2019-07-31 09:23:38+05:18,['9b8eaa3d3179e13fceb896f677debb248b9529f0'],90,441,531,1790703,1,0,0.051771117,1,3616
fa58e9878c4e1bcfa48d6532dec9d47306c199cc,0,Velmurugan Periasamy,2019-07-31 13:25:49-04:00,['0ffdf13d3c8556a75d88404ad90fedd497979754'],56,56,112,1790815,56,,,,3616
399cf813cafb09d1ae54cb7cfa61044167f8805c,0,Abhay Kulkarni,2019-07-31 15:39:08-07:00,['fa58e9878c4e1bcfa48d6532dec9d47306c199cc'],33,58,91,1790906,6,0.25,0,1,3616
147c28c11896edfd8e52ce275b28ede6204ac695,0,Pradeep,2019-08-01 08:52:44+05:18,['399cf813cafb09d1ae54cb7cfa61044167f8805c'],5,1,6,1790912,2,,,,3616
9fec38f6b77648268c5473aada56c2c1a2c7d08a,0,Nikhil P,2019-08-01 10:58:30+05:18,['147c28c11896edfd8e52ce275b28ede6204ac695'],1,1,2,1790914,1,,,,3616
630d4b7cd112094df1ac9fe55261c112094a9d97,0,Nitin Galave,2019-08-01 18:24:27+05:18,['9fec38f6b77648268c5473aada56c2c1a2c7d08a'],21,95,116,1791030,6,0.916666667,0.291666667,1,3616
716591dec8a80ac50d4fc0ff4a1c3337404e3ec7,1,Nitin Galave,2019-08-01 18:33:00+05:18,['630d4b7cd112094df1ac9fe55261c112094a9d97'],81,317,398,1791428,11,1,0,0.214285714,3616
27948b8fcceab4d615600d5de41df285027caa4a,0,Velmurugan Periasamy,2019-08-07 14:52:49-04:00,['716591dec8a80ac50d4fc0ff4a1c3337404e3ec7'],3,14,17,1791445,4,,,,3616
8323aaf62b76beb4dfcee1bbaaf1365cf9111b3e,1,Sailaja Polavarapu,2019-08-08 15:56:29-07:00,['27948b8fcceab4d615600d5de41df285027caa4a'],11,97,108,1791553,4,0.666666667,0.694444444,1,3616
0bfe8a0b4c521297a91c4421fbe35f30c52608bc,1,Sailaja Polavarapu,2019-08-08 16:32:08-07:00,['8323aaf62b76beb4dfcee1bbaaf1365cf9111b3e'],143,195,338,1791891,2,0.0625,0.083333333,1,3616
e750c52985461649fda5371676d3fe4253d4ea3d,0,Pradeep,2019-08-09 12:09:58+05:18,['0bfe8a0b4c521297a91c4421fbe35f30c52608bc'],1,165,166,1792057,10,,,,3621
1893a36d64a78e3d18cf74e74bf6a88649d15515,1,Pradeep,2019-08-09 16:02:17+05:18,['e750c52985461649fda5371676d3fe4253d4ea3d'],179,256,435,1792492,18,1,1,1,3622
120ea59cd9db1dc835c06a9834b63862c8e03522,1,Pradeep,2019-08-13 18:50:13+05:18,['1893a36d64a78e3d18cf74e74bf6a88649d15515'],51,251,302,1792794,6,0.615384615,0.153846154,0.480769231,3622
12208bd5392d0e93d2d49cf77237498aaaced779,0,rmani,2019-08-15 23:05:59-07:00,['120ea59cd9db1dc835c06a9834b63862c8e03522'],15,302,317,1793111,7,0.38961039,0.298701299,0,3623
928b3253d7068a67cbe8451a560b1d55b2eae7b0,1,rmani,2019-08-16 01:08:08-07:00,['12208bd5392d0e93d2d49cf77237498aaaced779'],302,15,317,1793428,7,0.61038961,0.701298701,1,3623
35bc9c935441b0680fe464c1f3df361c3551a5ca,1,rmani,2019-08-16 01:10:40-07:00,['928b3253d7068a67cbe8451a560b1d55b2eae7b0'],20,380,400,1793828,8,0.336134454,0.277310924,0.277310924,3624
11b3f309176002aac571fbb459695f3106b8c04a,0,rmani,2019-08-16 16:00:21-07:00,['35bc9c935441b0680fe464c1f3df361c3551a5ca'],6,17,23,1793851,2,0.65,0.975,0.65,3624
527ab5a8da9cdb4158b454dbdc382246974dddae,0,Sailaja Polavarapu,2019-08-17 16:02:26-07:00,['11b3f309176002aac571fbb459695f3106b8c04a'],12,48,60,1793911,1,0,0,0,3624
e00e11eb7afb90bfa5d86c55d30efade2a8b99a3,1,peng.jianhua,2019-08-19 10:00:07+08:00,['527ab5a8da9cdb4158b454dbdc382246974dddae'],0,8,8,1793919,2,0,0.142857143,1,3624
17a97fab5c72cc7dff19c2cd688c21b15bd3a71b,0,Pradeep,2019-08-20 19:19:48+05:18,['e00e11eb7afb90bfa5d86c55d30efade2a8b99a3'],9,6,15,1793934,2,1,1,0,3624
719dd4bf6a6b91ed00294f61a4854fac8e2acda8,0,rmani,2019-08-20 08:50:32-07:00,['17a97fab5c72cc7dff19c2cd688c21b15bd3a71b'],1,77,78,1794012,1,0.913043478,0.913043478,1,3624
c3cfb4da74b3a1edb11901f2e59a9fdbf5b7bcbc,0,rmani,2019-08-20 17:44:55-07:00,['719dd4bf6a6b91ed00294f61a4854fac8e2acda8'],0,6,6,1794018,1,0,0,0.5,3624
bb7dee1d51ec702065abff5ecd01a0a02a3dbb08,0,Pradeep,2019-08-21 10:51:32+05:18,['c3cfb4da74b3a1edb11901f2e59a9fdbf5b7bcbc'],0,2,2,1794020,2,,,,3626
65020a7bf1cf3b38b9ed3e558c88c7c3574ebb79,0,Pradeep,2019-08-21 19:50:50+05:18,['bb7dee1d51ec702065abff5ecd01a0a02a3dbb08'],56,81,137,1794157,7,1,0.7,0,3627
f04b3e4e6629dd468765633d8e5f2dcb5008ef6a,1,Pradeep,2019-08-21 21:57:50+05:18,['65020a7bf1cf3b38b9ed3e558c88c7c3574ebb79'],19,76,95,1794252,2,0.265306122,0.020408163,0.020408163,3627
3246f85e8d08b53426e17a30527e24917aea2cec,0,Pradeep,2019-08-25 22:01:40+05:18,['f04b3e4e6629dd468765633d8e5f2dcb5008ef6a'],4,4,8,1794260,2,,,,3627
d8a056e163011602e5722bb1a0293e0151047b1c,0,rmani,2019-08-26 16:20:16-07:00,['3246f85e8d08b53426e17a30527e24917aea2cec'],1,11,12,1794272,1,0,0,1,3627
ba2d55068a0c4e19b29616c1265575da674a5170,1,Sailaja Polavarapu,2019-08-27 10:32:38-07:00,['d8a056e163011602e5722bb1a0293e0151047b1c'],114,44,158,1794430,1,1,1,0,3627
b2cebfd75f7c813651a37db76dc85a67e5e5536e,1,Abhay Kulkarni,2019-08-28 16:15:42-07:00,['ba2d55068a0c4e19b29616c1265575da674a5170'],59,70,129,1794559,9,1,0,1,3627
59b33c505a4393bd014f5c24639dac578f921d68,1,rmani,2019-08-29 16:15:47-07:00,['b2cebfd75f7c813651a37db76dc85a67e5e5536e'],2,6,8,1794567,1,0,0,0,3627
f57022645db36054d2c63f1af503b82363999b47,0,rmani,2019-08-30 13:38:27-07:00,['59b33c505a4393bd014f5c24639dac578f921d68'],7,3,10,1794577,2,1,1,1,3627
f8e89b63f9fde52c54c181b27b353fe93da4751c,0,peng.jianhua,2019-09-09 15:41:03+08:00,['f57022645db36054d2c63f1af503b82363999b47'],3,1,4,1794581,2,1,0.5,0,3627
96560fd86543ffd2fe97531eb862b3c66cf0736a,1,peng.jianhua,2019-09-09 15:42:35+08:00,['f8e89b63f9fde52c54c181b27b353fe93da4751c'],16,16,32,1794613,1,,,,3627
3c788da0080c680c4c0a4220c23970979908277e,0,Nikhil P,2019-09-09 19:48:59+05:18,['96560fd86543ffd2fe97531eb862b3c66cf0736a'],4,41,45,1794658,1,0.032258065,0.032258065,1,3627
27c36c1daedd28ef20872cb786afca177c0a6e23,1,Abhay Kulkarni,2019-09-09 11:22:01-07:00,['3c788da0080c680c4c0a4220c23970979908277e'],145,211,356,1795014,9,1,1,1,3627
0e8831d5da5daba52c67cac24b314cc982d288c6,1,Nitin Galave,2019-09-10 16:30:00+05:18,['27c36c1daedd28ef20872cb786afca177c0a6e23'],84,104,188,1795202,5,0,0,1,3627
084c5993d469faade6d67d0e202e9a212fbcf2ff,1,Mehul Parikh,2019-09-11 17:54:59+05:18,['0e8831d5da5daba52c67cac24b314cc982d288c6'],3,12,15,1795217,2,0.2,0.4,1,3627
35bf9fc966d9993607eb23a98a98610e8765bee4,1,rmani,2019-09-11 13:58:14-07:00,['084c5993d469faade6d67d0e202e9a212fbcf2ff'],8,80,88,1795305,3,0.851851852,0.925925926,1,3628
11c9556c40964cc697e5995e966c9b482482ee48,0,rmani,2019-09-12 11:53:38-07:00,['35bf9fc966d9993607eb23a98a98610e8765bee4'],3,2,5,1795310,1,0,0,0,3628
c46de425783ce0ce2c4ce0a7d4dae58807c626ef,0,Nitin Galave,2019-09-16 15:05:37+05:18,['11c9556c40964cc697e5995e966c9b482482ee48'],46,174,220,1795530,11,,,,3630
a94f6e0d1f39ea51743ea54849313d198237e70f,1,Pradeep,2019-09-18 12:37:48+05:18,['c46de425783ce0ce2c4ce0a7d4dae58807c626ef'],20,405,425,1795955,5,0.286738351,0.344086022,1,3630
67e3ceaf5d7ab6bdd8d7a9550dd2bf9bef13cfc3,1,Abhay Kulkarni,2019-09-18 07:56:22-07:00,['a94f6e0d1f39ea51743ea54849313d198237e70f'],1,1,2,1795957,1,,,,3630
988f31ce174ca1df3b5949cc8e952af5ff10a00f,0,Nitin Galave,2019-09-19 10:48:26+05:18,['67e3ceaf5d7ab6bdd8d7a9550dd2bf9bef13cfc3'],2,10,12,1795969,1,0,0,1,3630
06f329d5fc1e911bde012725f91a4bc46ff802d3,0,Nikhil P,2019-09-19 16:24:56+05:18,['988f31ce174ca1df3b5949cc8e952af5ff10a00f'],4,0,4,1795973,2,0.25,0.25,0.5,3630
d17fa2c7230260cc3d4ddbef3fc6ab8bddb4154a,0,Sailaja Polavarapu,2019-09-19 11:01:30-07:00,['06f329d5fc1e911bde012725f91a4bc46ff802d3'],11,16,27,1796000,2,0,0,1,3630
8fe1ce872ab13c4543f6eb70cfe01bcdc36ff8f3,0,Mehul Parikh,2019-09-19 23:59:40+05:18,['d17fa2c7230260cc3d4ddbef3fc6ab8bddb4154a'],4,35,39,1796039,4,0.727272727,0.727272727,0.818181818,3630
2b988a83638d36528a4690705435023bc1f9fcef,0,Abhay Kulkarni,2019-09-19 14:25:29-07:00,['8fe1ce872ab13c4543f6eb70cfe01bcdc36ff8f3'],24,37,61,1796100,4,0.111111111,1,1,3630
8ed1b3385abfdb1e725f10d131bee7d339bb8fd4,1,Sailaja Polavarapu,2019-09-19 15:18:48-07:00,['2b988a83638d36528a4690705435023bc1f9fcef'],15,308,323,1796423,5,0.505102041,0.530612245,1,3630
0baf6a4c9bc0a35c0d635fa6001c1a0842b20423,0,Pradeep,2019-09-20 10:21:14+05:18,['8ed1b3385abfdb1e725f10d131bee7d339bb8fd4'],13,20,33,1796456,1,0,0,1,3630
5523d16cb1e4612a98af0d5a93842edbb011853a,0,Pradeep,2019-09-20 15:26:39+05:18,['0baf6a4c9bc0a35c0d635fa6001c1a0842b20423'],2,2,4,1796460,2,,,,3630
f9926cd6d4113e00e508496665cc36d092168323,0,Mehul Parikh,2019-09-21 10:34:26+05:18,['5523d16cb1e4612a98af0d5a93842edbb011853a'],6,8,14,1796474,4,1,1,1,3630
46670b24d6a30f9ac7bffd5b1d3c9f1a671b3538,0,Pradeep,2019-09-21 18:00:46+05:18,['f9926cd6d4113e00e508496665cc36d092168323'],0,1,1,1796475,1,,,,3630
c66a77ac18cfa9cd1f59c81ece4235aa84e9d248,0,Zsombor Gegesy,2019-09-22 08:28:25+02:00,['46670b24d6a30f9ac7bffd5b1d3c9f1a671b3538'],4,6,10,1796485,5,,,,3630
f30fa46d4046a69451ffd6a2b77a0d9a333cdfad,0,Sailaja Polavarapu,2019-09-23 10:33:59-07:00,['c66a77ac18cfa9cd1f59c81ece4235aa84e9d248'],13,43,56,1796541,4,0,0.071428571,0.25,3630
2a6dd3d078c52cc1314af581f7b8e6c8cdab933a,0,Pradeep,2019-09-24 11:11:00+05:18,['f30fa46d4046a69451ffd6a2b77a0d9a333cdfad'],95,95,190,1796731,18,,,,3630
c5bf2f6364a97539451656d28fd36e35d8e2736d,1,Pradeep,2019-09-25 15:49:42+05:18,['2a6dd3d078c52cc1314af581f7b8e6c8cdab933a'],56,134,190,1796921,5,0,0.311111111,1,3630
4624da1f47242715865a5197ecd1f0d5adb62617,1,Pradeep,2019-09-25 18:01:57+05:18,['c5bf2f6364a97539451656d28fd36e35d8e2736d'],213,463,676,1797597,4,0.151960784,0.931372549,0.700980392,3630
c31d4e45281d18b2f18be315d58dc21ea02c7c47,1,Abhay Kulkarni,2019-09-25 13:44:05-07:00,['4624da1f47242715865a5197ecd1f0d5adb62617'],533,3382,3915,1801512,60,0.206708976,0.190389846,0.816863101,3648
b69227eb2f6b8aacb539a6454c714923257de059,1,rmani,2019-09-27 13:08:48-07:00,['c31d4e45281d18b2f18be315d58dc21ea02c7c47'],140,1688,1828,1803340,37,0.258169935,0.322440087,0.588235294,3657
02640d3cf520ee5a0dae13dd46b91ff266359e77,1,Mehul Parikh,2019-09-29 12:41:50+05:18,['b69227eb2f6b8aacb539a6454c714923257de059'],859,2547,3406,1806746,16,0.118359739,0.273998136,0.737185461,3661
e5b7838f490d6d526974bf2c6cd24917d2209693,0,Velmurugan Periasamy,2019-09-30 14:04:50-04:00,['02640d3cf520ee5a0dae13dd46b91ff266359e77'],0,0,0,1806746,1,,,,3661
d484e2bad26cc024e36908691138f8c4ac133f47,1,Abhay Kulkarni,2019-10-01 08:19:54-07:00,['e5b7838f490d6d526974bf2c6cd24917d2209693'],324,318,642,1807388,10,1,0.172413793,0,3661
68fa17a19a1032c3b3f2bff0df2f4c922b243595,1,rmani,2019-10-02 11:11:20-07:00,['d484e2bad26cc024e36908691138f8c4ac133f47'],43,133,176,1807564,8,0.565217391,0.434782609,0.942028986,3661
9a62c142ac7dbd7d3412076c26787c2d2e9ec1c6,0,Mehul Parikh,2019-10-03 17:00:24+05:18,['68fa17a19a1032c3b3f2bff0df2f4c922b243595'],2,2,4,1807568,1,,,,3661
52936a50cfde9959825cd57d62593873941dc9b4,1,Abhay Kulkarni,2019-10-03 21:51:43-07:00,['9a62c142ac7dbd7d3412076c26787c2d2e9ec1c6'],2,2,4,1807572,1,,,,3661
13341c7c22ca78eff2d1eb49bb5b56e8cb68f8d3,0,Abhay Kulkarni,2019-10-06 20:31:26-07:00,['52936a50cfde9959825cd57d62593873941dc9b4'],85,124,209,1807781,10,0.606060606,0.636363636,0.757575758,3661
334e22ed1e507ca6477129cc8cccd8789d8f75b2,0,Mehul Parikh,2019-10-07 14:40:21+05:18,['13341c7c22ca78eff2d1eb49bb5b56e8cb68f8d3'],0,3,3,1807784,1,0,0,0,3661
0011a441d0151c9eeec78ab1e5b9e3e3262129b8,1,Zsombor Gegesy,2019-10-07 16:18:19+02:00,['334e22ed1e507ca6477129cc8cccd8789d8f75b2'],5,11,16,1807800,2,1,0,1,3661
0d5fa49f90881fb27b464c25ec28535da036adcd,0,Velmurugan Periasamy,2019-10-08 08:53:55-04:00,['0011a441d0151c9eeec78ab1e5b9e3e3262129b8'],52,104,156,1807956,1,,,,3661
49d092acfd4c4aea86d9ddb64995e61c61828442,0,Velmurugan Periasamy,2019-10-08 08:54:08-04:00,['0d5fa49f90881fb27b464c25ec28535da036adcd'],1,1,2,1807958,1,,,,3661
3145c50365e91a741b1dfaa994afdb964d36799b,0,Velmurugan Periasamy,2019-10-08 13:17:46-04:00,['49d092acfd4c4aea86d9ddb64995e61c61828442'],0,20,20,1807978,1,,,,3661
41b459b0642cbce5fc63d1b0db04d4e06738cef9,0,Velmurugan Periasamy,2019-10-08 13:17:59-04:00,['3145c50365e91a741b1dfaa994afdb964d36799b'],0,3,3,1807981,1,,,,3661
d12f94f681c8406e16d5c0591019dae7ce2d3541,0,Velmurugan Periasamy,2019-10-08 13:18:10-04:00,['41b459b0642cbce5fc63d1b0db04d4e06738cef9'],0,3,3,1807984,1,,,,3661
fb97a18b5f409dc7beb9c0ed5ec43c9daad89f41,0,Abhay Kulkarni,2019-10-08 12:33:08-07:00,['d12f94f681c8406e16d5c0591019dae7ce2d3541'],2,2,4,1807988,2,,,,3661
b58257d23a904f5b046b0777a0497ceb7ea093d4,1,Sailaja Polavarapu,2019-10-09 15:43:53+05:18,['fb97a18b5f409dc7beb9c0ed5ec43c9daad89f41'],4,68,72,1808060,5,0,0.558139535,0.953488372,3661
72be01bb789e369158d73a841800b22f71a5c85a,0,Abhay Kulkarni,2019-10-09 16:29:39-07:00,['b58257d23a904f5b046b0777a0497ceb7ea093d4'],9,6,15,1808075,1,,,,3661
3eef84032aa7b2a55fa0ae5383739b2336d5de6c,1,rmani,2019-10-09 17:53:13-07:00,['72be01bb789e369158d73a841800b22f71a5c85a'],71,265,336,1808411,10,0.356164384,0.48630137,0.52739726,3661
a0b7d9a57c79d48a0fbf21e37ae09c74d6fa11e6,1,Mehul Parikh,2019-10-10 09:00:59+05:18,['3eef84032aa7b2a55fa0ae5383739b2336d5de6c'],574,479,1053,1809464,4,0.8,0,0,3662
085f2c1fc2937695ed0ea9d35dce86b1f152c423,0,rmani,2019-10-10 07:19:38-07:00,['a0b7d9a57c79d48a0fbf21e37ae09c74d6fa11e6'],0,2,2,1809466,1,1,1,1,3662
3f551593f14be940a8179e547b222e3a5134c252,0,rmani,2019-10-10 07:19:54-07:00,['085f2c1fc2937695ed0ea9d35dce86b1f152c423'],0,1,1,1809467,1,0,1,1,3662
4f4e50ff3c21002225f5abd24203e03bd10671c8,0,rmani,2019-10-10 07:49:37-07:00,['3f551593f14be940a8179e547b222e3a5134c252'],1,0,1,1809468,1,1,0,0,3662
e3c642e415f1d805236422b0c0f888cb61ce3362,0,rmani,2019-10-10 07:50:06-07:00,['4f4e50ff3c21002225f5abd24203e03bd10671c8'],4,4,8,1809476,1,,,,3662
3f468bab324b78de86e1efa38bb823c685c2b077,0,Mehul Parikh,2019-10-11 10:14:02+05:18,['e3c642e415f1d805236422b0c0f888cb61ce3362'],1,272,273,1809749,4,0.561797753,1,1,3665
965368da8d56af436af12d5901fb83647ad65725,0,rmani,2019-10-14 13:58:30-07:00,['3f468bab324b78de86e1efa38bb823c685c2b077'],1,8,9,1809758,1,0,0,1,3665
50d8f2fa8ce564cea522c95b97a17421edb7fcd9,0,Mehul Parikh,2019-10-16 11:07:13+05:18,['965368da8d56af436af12d5901fb83647ad65725'],19,57,76,1809834,2,0,0,0,3665
74839e3ed04125b312c09543953b100fb103a8bb,1,Abhay Kulkarni,2019-10-16 17:50:41-07:00,['50d8f2fa8ce564cea522c95b97a17421edb7fcd9'],61,87,148,1809982,8,0.363636364,0.363636364,0,3665
722a660b214aa9301c18b7f123f2ad689cdccf94,1,rmani,2019-10-16 18:26:54-07:00,['74839e3ed04125b312c09543953b100fb103a8bb'],0,329,329,1810311,7,0.214285714,0.306722689,0.31512605,3666
f11d297ad74407e51707ba890b4f07db8ddb3be4,0,Nikhil P,2019-10-17 16:10:23+05:18,['722a660b214aa9301c18b7f123f2ad689cdccf94'],0,60,60,1810371,4,1,1,1,3666
c267ee7ef05078eea77770f7a4701d3189d05ca1,0,Nikhil P,2019-10-17 17:00:20+05:18,['f11d297ad74407e51707ba890b4f07db8ddb3be4'],1,19,20,1810391,1,0.8,1,1,3666
28c1fe70c9ae30adc60968681dbb6f85e9981ee5,0,Mehul Parikh,2019-10-17 19:03:46+05:18,['c267ee7ef05078eea77770f7a4701d3189d05ca1'],19,17,36,1810427,2,1,1,1,3666
bbc5650d71e69c8d852d0bb804faddc8ce078da6,0,rmani,2019-10-17 11:46:43-07:00,['28c1fe70c9ae30adc60968681dbb6f85e9981ee5'],0,1,1,1810428,1,,,,3666
1f5619d156680fc1942a8822841d56168867664a,1,Abhay Kulkarni,2019-10-17 13:11:17-07:00,['bbc5650d71e69c8d852d0bb804faddc8ce078da6'],23,394,417,1810845,15,0.834482759,0.834482759,0.882758621,3669
c600fcbfbde71cbf242b0f68910f5d6c2ae9cb9a,0,Mehul Parikh,2019-10-18 14:34:44+05:18,['1f5619d156680fc1942a8822841d56168867664a'],7,10,17,1810862,5,1,1,1,3669
522d1ccd2a05921d7563b921e617c50fee30c40d,0,Abhay Kulkarni,2019-10-20 07:39:26-07:00,['c600fcbfbde71cbf242b0f68910f5d6c2ae9cb9a'],0,23,23,1810885,4,0.6875,0.6875,0.6875,3669
79b0c121a607ba8653f7983ed52ddbe986533fd4,0,Abhay Kulkarni,2019-10-23 18:06:40-07:00,['522d1ccd2a05921d7563b921e617c50fee30c40d'],9,12,21,1810906,2,0,0,1,3669
c76f8eecf181f813774d8e7a6546f1666287eefe,0,Mehul Parikh,2019-10-30 11:45:41+05:18,['79b0c121a607ba8653f7983ed52ddbe986533fd4'],1,28,29,1810935,6,1,1,1,3669
b348291eaeeefc3723bb5507d3770b463544c24a,1,Mehul Parikh,2019-10-30 11:45:50+05:18,['c76f8eecf181f813774d8e7a6546f1666287eefe'],42,93,135,1811070,9,1,1,1,3669
1a6b97e2c948347383ae2c279721e1c3ea7eaff5,0,Mehul Parikh,2019-10-30 18:22:33+05:18,['b348291eaeeefc3723bb5507d3770b463544c24a'],36,82,118,1811188,2,0.342857143,0,1,3669
f937360f06535afccac39da7e1212820f17cbda6,0,rmani,2019-10-31 00:44:49-07:00,['1a6b97e2c948347383ae2c279721e1c3ea7eaff5'],1,8,9,1811197,1,1,1,0,3669
e5afd844a3020c6c9872481c6dd76a3489dd5c19,1,Mehul Parikh,2019-11-05 16:40:34+05:18,['f937360f06535afccac39da7e1212820f17cbda6'],334,566,900,1812097,9,0,0.677884615,0.860576923,3669
d3ae6231664ea445192c84036ed77a635496f331,0,rmani,2019-11-05 14:36:43-08:00,['e5afd844a3020c6c9872481c6dd76a3489dd5c19'],0,3,3,1812100,1,1,1,1,3669
5ccf414965bff9f79e51738d0bf4ba09880693eb,0,Mehul Parikh,2019-11-07 15:03:37+05:18,['d3ae6231664ea445192c84036ed77a635496f331'],149,749,898,1812998,15,0.320872274,0.92834891,0.738317757,3671
7638d8b9af163484ff1718880356a23328c4904d,0,Velmurugan Periasamy,2019-11-07 17:20:58-05:00,['5ccf414965bff9f79e51738d0bf4ba09880693eb'],34,108,142,1813140,6,0.4375,0,1,3671
72bccb365ef3b473444c10c1c6f802100ed5c242,1,Mehul Parikh,2019-11-08 09:16:04+05:18,['7638d8b9af163484ff1718880356a23328c4904d'],35,969,1004,1814144,72,0.419795222,0.488054608,0.703071672,3681
cd1e9b71a523e12e612e608a3dff15ecd773f652,1,Madhan Neethiraj,2019-11-12 15:58:43-08:00,['72bccb365ef3b473444c10c1c6f802100ed5c242'],767,799,1566,1815710,77,1,0,1,3684
3105b94c03ac2176955dedb2d4ac78ebb4665cf6,0,Madhan Neethiraj,2019-11-13 15:14:41-08:00,['cd1e9b71a523e12e612e608a3dff15ecd773f652'],54,40,94,1815804,13,0.9,0.8,0,3684
d37a6b5a0fd909fe4cbe650a7bdfae401247849c,0,Nikhil P,2019-11-14 12:41:29+05:18,['3105b94c03ac2176955dedb2d4ac78ebb4665cf6'],12,39,51,1815855,3,0.208333333,0.208333333,1,3684
bc74cb2467229bb8b1cf89f593547eec00a6480d,1,Sailaja Polavarapu,2019-11-14 14:44:44-08:00,['d37a6b5a0fd909fe4cbe650a7bdfae401247849c'],18,30,48,1815903,3,0,0.5,0.5,3684
22168d1b0bdf51e1317447cafddeb0f60af10810,1,Mehul Parikh,2019-11-15 18:26:57+05:18,['bc74cb2467229bb8b1cf89f593547eec00a6480d'],187,129,316,1816219,15,,,,3684
618ebd3a9ce93bf348ff48b7c9a687c274d9556c,1,Abhay Kulkarni,2019-11-15 09:53:14-08:00,['22168d1b0bdf51e1317447cafddeb0f60af10810'],71,84,155,1816374,3,1,1,0.4,3684
0a7f809880c38190596945e0c30ac713bf0deeb2,1,Abhay Kulkarni,2019-11-21 22:16:31-08:00,['618ebd3a9ce93bf348ff48b7c9a687c274d9556c'],2531,3431,5962,1822336,46,0.854166667,1,0.779166667,3693
51349e296be6cf83da1f775138b51b175f1f47e7,0,Nitin Galave,2019-11-22 19:04:16+05:18,['0a7f809880c38190596945e0c30ac713bf0deeb2'],27,44,71,1822407,8,0.9,1,1,3693
23d2b935c87a7cb3bf30e562660f897d9afc2fc2,1,Nitin Galave,2019-11-22 19:06:58+05:18,['51349e296be6cf83da1f775138b51b175f1f47e7'],19,46,65,1822472,2,0.166666667,1,1,3693
3fca183e7bd2212489513ced5fa550fe7259e140,1,Madhan Neethiraj,2019-11-22 12:34:01-08:00,['23d2b935c87a7cb3bf30e562660f897d9afc2fc2'],409,489,898,1823370,15,0.043478261,0.869565217,1,3693
a6f6f1f8cbd5c7d8b12631c2c8bdf1acb6c32555,1,Velmurugan Periasamy,2019-11-22 17:58:59-05:00,['3fca183e7bd2212489513ced5fa550fe7259e140'],44,27,71,1823441,8,0.1,0,0,3693
54fa50a3a4a170071ec7ca92ea0d25ad1e497c53,1,Mehul Parikh,2019-11-25 15:44:12+05:18,['a6f6f1f8cbd5c7d8b12631c2c8bdf1acb6c32555'],16,15,31,1823472,1,1,1,1,3693
afb1f208557dbe308d0e2c5fdbe833fcbffb6111,1,Abhay Kulkarni,2019-11-25 18:11:45-08:00,['54fa50a3a4a170071ec7ca92ea0d25ad1e497c53'],123,106,229,1823701,5,0.133333333,0.733333333,0.133333333,3693
0298b7ed15c2a864cdd97a81a3983cba0358b07b,1,Abhay Kulkarni,2019-11-26 22:46:43-08:00,['afb1f208557dbe308d0e2c5fdbe833fcbffb6111'],264,272,536,1824237,8,1,1,0,3693
6cd9e7b9efe7a799ce4d5c3faa6d1d9491dcf1c1,1,Madhan Neethiraj,2019-11-26 23:24:55-08:00,['0298b7ed15c2a864cdd97a81a3983cba0358b07b'],641,640,1281,1825518,32,1,1,0.935483871,3693
7ea6c1f0cf8d1034b05132154bd8198cd9b67039,1,Mehul Parikh,2019-11-27 14:32:19+05:18,['6cd9e7b9efe7a799ce4d5c3faa6d1d9491dcf1c1'],27,44,71,1825589,8,0.9,1,1,3693
25a8c43b92806042f3a9b6823be24006129bfcd3,1,Abhay Kulkarni,2019-11-28 12:40:43-08:00,['7ea6c1f0cf8d1034b05132154bd8198cd9b67039'],2,2,4,1825593,1,,,,3693
50de18f19f14e793e454a598d4569bd598a2cb0f,0,Madhan Neethiraj,2019-12-01 12:30:28-08:00,['25a8c43b92806042f3a9b6823be24006129bfcd3'],1,1,2,1825595,1,,,,3693
2c29f0623c3571fdfad5ddd918e87d8a2c7cd3a2,0,Abhay Kulkarni,2019-12-03 18:29:32-08:00,['50de18f19f14e793e454a598d4569bd598a2cb0f'],13,15,28,1825623,4,0,1,1,3693
8ac5fdd407ecfe69dadad466a78eb283c847c7a1,0,rmani,2019-12-03 22:09:42-08:00,['2c29f0623c3571fdfad5ddd918e87d8a2c7cd3a2'],7,58,65,1825688,4,0.636363636,0.636363636,0.909090909,3693
b581a4b478d6263eea6176fb5c7a51b875821681,0,Madhan Neethiraj,2019-12-03 23:52:16-08:00,['8ac5fdd407ecfe69dadad466a78eb283c847c7a1'],5,9,14,1825702,1,1,1,1,3693
fa0dff146399b97554d4e745e6e2dcbd7510d988,1,Abhay Kulkarni,2019-12-04 14:53:11-08:00,['b581a4b478d6263eea6176fb5c7a51b875821681'],65,355,420,1826122,6,0.60483871,0.443548387,0.879032258,3695
3cba16886cd78a35c61f02ebd1ed4bc8a3767d47,0,rmani,2019-12-04 15:22:31-08:00,['fa0dff146399b97554d4e745e6e2dcbd7510d988'],1,3,4,1826126,1,1,1,1,3695
7c815e8ad71c3168b60195c7b18fdbaa0d4e4e92,0,Abhay Kulkarni,2019-12-04 16:54:02-08:00,['3cba16886cd78a35c61f02ebd1ed4bc8a3767d47'],2,2,4,1826130,1,,,,3695
f028a213463d5ebd5b150c78fc43931fa8e49c92,1,Madhan Neethiraj,2019-12-07 12:19:45-08:00,['7c815e8ad71c3168b60195c7b18fdbaa0d4e4e92'],27,68,95,1826225,20,0.962962963,0.962962963,0.888888889,3695
1368600bc10ed31adbdf6e64530590ed1ad4c9f9,1,Abhay Kulkarni,2019-12-07 17:14:51-08:00,['f028a213463d5ebd5b150c78fc43931fa8e49c92'],34,99,133,1826358,3,0,0,0.671875,3695
f6685bd4af4dd9ef87c10c294709e3a1b37d4f50,1,Abhay Kulkarni,2019-12-07 18:13:15-08:00,['1368600bc10ed31adbdf6e64530590ed1ad4c9f9'],32,32,64,1826422,7,,,,3695
962538b34ef0ad24f74cad029b74b0b2f5b53e9f,0,peng.jianhua,2019-12-09 10:21:22+08:00,['f6685bd4af4dd9ef87c10c294709e3a1b37d4f50'],1,1,2,1826424,1,,,,3695
665ef47e0fdd018a6da8173d2fa88ce4104105d3,0,peng.jianhua,2019-12-09 10:23:51+08:00,['962538b34ef0ad24f74cad029b74b0b2f5b53e9f'],0,2,2,1826426,1,,,,3695
5a201d6caf435bde87731db1ac9da602e871b7b2,1,rmani,2019-12-10 16:33:51-08:00,['665ef47e0fdd018a6da8173d2fa88ce4104105d3'],18,227,245,1826671,2,0.26744186,0.587209302,0.418604651,3695
733c28e640c035526a7656091752b58f2846b506,0,peng.jianhua,2019-12-12 18:16:57+08:00,['5a201d6caf435bde87731db1ac9da602e871b7b2'],1,1,2,1826673,1,,0,,3695
8121961018350014860e29951cbd5b106e8b7923,1,Mehul Parikh,2019-12-13 11:09:50+05:18,['733c28e640c035526a7656091752b58f2846b506'],15,55,70,1826743,7,0.5,0.5,0.5,3695
ba52fa43f245236de94bc36c49f2cd7c5e655f9a,1,Mehul Parikh,2019-12-13 11:09:50+05:18,['8121961018350014860e29951cbd5b106e8b7923'],217,429,646,1827389,13,0.293577982,0,1,3695
446fb478ee49779271557cca1076db2a777bfaa8,0,Mehul Parikh,2019-12-13 11:17:15+05:18,['ba52fa43f245236de94bc36c49f2cd7c5e655f9a'],2,0,2,1827391,1,0,0,0,3695
7bc6266e4d2c30e01fdaedc4b2c5e1d09ed7b79b,1,Pradeep,2019-12-14 06:43:08+05:18,['446fb478ee49779271557cca1076db2a777bfaa8'],5,115,120,1827511,8,0.6125,0.4,0.9375,3695
6396e3a473fe8b2bc7282b402575299d9c09d8df,0,Mehul Parikh,2019-12-16 11:19:59+05:18,['7bc6266e4d2c30e01fdaedc4b2c5e1d09ed7b79b'],1,5,6,1827517,1,0,0,1,3695
d6e0e9af2446d023e68df1e21221d8bf1190615d,1,Nikhil P,2019-12-16 18:29:19+05:18,['6396e3a473fe8b2bc7282b402575299d9c09d8df'],28,86,114,1827631,3,0.828571429,0.828571429,0.828571429,3695
af9e3feaa43b6376101e28efc4926a3188d78653,0,Ramesh Mani,2019-12-18 17:20:48-08:00,['d6e0e9af2446d023e68df1e21221d8bf1190615d'],1,1,2,1827633,1,,,,3695
2c21aadea26e5942117858167e94b31d1adf1b5d,1,Pradeep,2019-12-20 09:12:42+05:18,['af9e3feaa43b6376101e28efc4926a3188d78653'],1,25,26,1827659,1,0,0,1,3695
66ff8bd23a4f7713a6f935c62f398ef54e84da70,0,Nikhil P,2019-12-20 18:20:55+05:18,['2c21aadea26e5942117858167e94b31d1adf1b5d'],1,9,10,1827669,1,1,1,1,3695
1c488dc64acfa850da2426c3ed5ffc03397f224c,0,Mehul Parikh,2019-12-23 12:20:33+05:18,['66ff8bd23a4f7713a6f935c62f398ef54e84da70'],1,46,47,1827716,1,0.263157895,0.263157895,1,3695
e6b1a137cf157e7f9a73a760b8ee036d9cf269f5,0,Nikhil P,2019-12-24 18:49:51+05:18,['1c488dc64acfa850da2426c3ed5ffc03397f224c'],2,2,4,1827720,1,,,,3695
9728fbf7362920ce2c7d8099491c27917c5501da,0,Pradeep,2019-12-24 19:05:43+05:18,['e6b1a137cf157e7f9a73a760b8ee036d9cf269f5'],3,13,16,1827736,3,,,,3695
079967c59f281cf0e7178613a38a4db952e16816,1,Pradeep,2020-01-08 10:05:43+05:18,['9728fbf7362920ce2c7d8099491c27917c5501da'],13,30,43,1827779,3,0,0,1,3695
b24b99b8853b70444fae795ce2a7366b6642eada,0,Pradeep,2020-01-08 19:47:05+05:18,['079967c59f281cf0e7178613a38a4db952e16816'],20,19,39,1827818,3,,,,3695
9108bffe69dff0e2e1896f85f1f48ab882b3ce49,1,Pradeep,2020-01-09 14:45:25+05:18,['b24b99b8853b70444fae795ce2a7366b6642eada'],1,1,2,1827820,1,,,,3695
e06abc00667b3935ad86a146be73853fed807eda,1,Madhan Neethiraj,2020-01-09 17:57:58-08:00,['9108bffe69dff0e2e1896f85f1f48ab882b3ce49'],4667,5073,9740,1837560,55,,,,3720
d991dbb4e3aa7eee6b0cb0d1ba87c8632fba6912,1,Pradeep,2020-01-10 10:43:57+05:18,['e06abc00667b3935ad86a146be73853fed807eda'],0,1,1,1837561,1,0,0,1,3720
eb5aac4babb95a9c06a27d6f6b089aa474eaa2b0,0,Mehul Parikh,2020-01-10 12:30:52+05:18,['d991dbb4e3aa7eee6b0cb0d1ba87c8632fba6912'],15,14,29,1837590,1,,,,3720
797725221637736ae5a9836ff994477a8c5b8fd8,0,Abhay Kulkarni,2020-01-13 09:57:00-08:00,['eb5aac4babb95a9c06a27d6f6b089aa474eaa2b0'],2,2,4,1837594,1,,,,3720
b26e07e44537c5ee90a8a5c58d1235284478398d,0,Ramesh Mani,2020-01-13 18:19:39-08:00,['797725221637736ae5a9836ff994477a8c5b8fd8'],0,3,3,1837597,1,,,,3720
7cfef395c5c1cd8d0cdbf135d0360daff49e8d4c,0,Pradeep,2020-01-16 10:48:06+05:18,['b26e07e44537c5ee90a8a5c58d1235284478398d'],13,13,26,1837623,1,,,,3720
3e5ccd6c7892636a30ab3b1e96d79109b7915268,0,Pradeep,2020-01-16 10:52:27+05:18,['7cfef395c5c1cd8d0cdbf135d0360daff49e8d4c'],2,6,8,1837631,2,,,,3720
281d93f83ec3de932e0fbfdcde4ada2b09145d08,0,Pradeep,2020-01-16 11:53:13+05:18,['3e5ccd6c7892636a30ab3b1e96d79109b7915268'],1,1,2,1837633,1,,,,3720
8e79c971d8cc139f2c719fbc2c5aaa0cc8b7bf72,1,Pradeep,2020-01-16 11:56:33+05:18,['281d93f83ec3de932e0fbfdcde4ada2b09145d08'],1,1,2,1837635,1,,,,3720
580f0aed6a0032c13643b517b8eef795fa2ccf72,0,Pradeep,2020-01-16 11:57:00+05:18,['8e79c971d8cc139f2c719fbc2c5aaa0cc8b7bf72'],1,1,2,1837637,1,,,,3720
ed3a3c62fb5941ad9c11b4c800a26b9d10e49493,0,Pradeep,2020-01-16 18:09:39+05:18,['580f0aed6a0032c13643b517b8eef795fa2ccf72'],0,5,5,1837642,1,0,1,1,3720
d62bedef4232e846cb24d8a1629fb7b242d4575e,1,Abhay Kulkarni,2020-01-16 06:20:53-08:00,['580f0aed6a0032c13643b517b8eef795fa2ccf72'],25,40,65,1837707,4,0,0.333333333,0.333333333,3720
375e736dedd5c766d747e9c68934ef7c3ab2a398,0,Abhay Kulkarni,2020-01-16 06:55:37-08:00,"['d62bedef4232e846cb24d8a1629fb7b242d4575e', 'ed3a3c62fb5941ad9c11b4c800a26b9d10e49493']",0,0,0,1837707,0,,,,3720
ef1e02dc9421e3d56c9ead3d8711d5de6d2ee496,1,Ramesh Mani,2020-01-16 15:36:45-08:00,['375e736dedd5c766d747e9c68934ef7c3ab2a398'],27,593,620,1838327,4,0.221453287,0.363321799,0.878892734,3721
b87dab05c1ef268cdc038668e91c0203fe9bc40d,0,Ramesh Mani,2020-01-19 23:45:36-08:00,['ef1e02dc9421e3d56c9ead3d8711d5de6d2ee496'],13,22,35,1838362,1,0,0,1,3721
27bd9d884f48f3b51b1357de0f9783a82ccaf858,0,Pradeep,2020-01-20 18:29:58+05:18,['b87dab05c1ef268cdc038668e91c0203fe9bc40d'],46,100,146,1838508,1,0,0,0.777777778,3721
41797b2443ffd1f957620931c5ffb145f56cfc8d,0,Pradeep,2020-01-22 18:01:01+05:18,['27bd9d884f48f3b51b1357de0f9783a82ccaf858'],1,1,2,1838510,1,,,,3721
0a39904ac134736d1eeeb03ae83069c9896c8f97,1,Pradeep,2020-01-22 18:35:50+05:18,['41797b2443ffd1f957620931c5ffb145f56cfc8d'],11,103,114,1838624,14,0.592592593,0.62962963,1,3722
3a4bb32abe0a24628f1c16f1eedf792b37906372,0,Pradeep,2020-01-23 16:31:07+05:18,['0a39904ac134736d1eeeb03ae83069c9896c8f97'],8,5,13,1838637,1,1,1,1,3722
f4ba50fcdd26198eeebe3daef79d61061ccdba57,0,Pradeep,2020-01-23 16:42:25+05:18,['3a4bb32abe0a24628f1c16f1eedf792b37906372'],1,1,2,1838639,1,,,,3722
2258ab08caab0439712bf9bdafeeb9db57a23bfd,1,Pradeep,2020-01-28 13:05:50+05:18,['f4ba50fcdd26198eeebe3daef79d61061ccdba57'],69,32,101,1838740,6,1,1,0,3722
cc9220deabbad0d59e2f4e02bdbd7c36301d9d6f,0,Pradeep,2020-01-28 13:11:54+05:18,['2258ab08caab0439712bf9bdafeeb9db57a23bfd'],0,6,6,1838746,1,,,,3722
84453294076e1bfe4739a0008543a8402292014b,1,Nitin Galave,2020-01-30 18:39:34+05:18,['cc9220deabbad0d59e2f4e02bdbd7c36301d9d6f'],193,754,947,1839693,18,0.299212598,0.346456693,0.807086614,3724
6cd9c1416d1540a6ae36640153e7c3f7c01c9e5f,0,Velmurugan Periasamy,2020-01-31 09:47:20-05:00,['84453294076e1bfe4739a0008543a8402292014b'],2,2,4,1839697,2,,,,3724
fc3d9d9daa061f2e4ac6388b15b7504887aa2232,0,Pradeep,2020-02-04 10:07:48+05:18,['6cd9c1416d1540a6ae36640153e7c3f7c01c9e5f'],13,125,138,1839835,7,0.074074074,0.907407407,0.888888889,3724
09707c368eb35bdac91b25dc6ab33cc210ed2e59,1,Pradeep,2020-02-04 10:08:27+05:18,['fc3d9d9daa061f2e4ac6388b15b7504887aa2232'],71,85,156,1839991,2,0.888888889,1,1,3724
75bd661410ad6e4463e7aad68622cf4ca7aac5a0,1,Pradeep,2020-02-04 10:11:47+05:18,['09707c368eb35bdac91b25dc6ab33cc210ed2e59'],9,270,279,1840270,13,0,0,1,3724
a743cbef24303dce2b7674a348b67c3530318dc6,0,Ramesh Mani,2020-02-04 12:44:06-08:00,['75bd661410ad6e4463e7aad68622cf4ca7aac5a0'],4,5,9,1840279,1,,,,3724
b4c32849245b40d100a583b0b214a69f9b678a44,0,Pradeep,2020-02-05 16:29:34+05:18,['a743cbef24303dce2b7674a348b67c3530318dc6'],29,539,568,1840847,14,1,0,0,3729
1518e7124447264e6f2adabb9a267deeb7840030,1,Abhay Kulkarni,2020-02-05 14:57:35-08:00,['b4c32849245b40d100a583b0b214a69f9b678a44'],2,2,4,1840851,1,,,,3729
23b30beed5b7501627c3288275a9cde73048b449,0,Pradeep,2020-02-06 18:31:03+05:18,['1518e7124447264e6f2adabb9a267deeb7840030'],1,317,318,1841169,4,,,,3732
0b23df7801062cc7836f2e162e1775101898add4,0,Hao Hao,2020-02-06 10:15:23-08:00,['23b30beed5b7501627c3288275a9cde73048b449'],1,308,309,1841478,7,0.875,1,1,3736
65b4cec2b68e2e1aa260bfe115d77a60c6d41f20,0,Pradeep,2020-02-10 15:33:56+05:18,['0b23df7801062cc7836f2e162e1775101898add4'],254,139,393,1841871,4,,,,3736
1eec98e4739e47f139776c1ec0ccee57ecb7dd73,0,Pradeep,2020-02-10 19:42:30+05:18,['65b4cec2b68e2e1aa260bfe115d77a60c6d41f20'],18,632,650,1842521,14,0.313915858,0.569579288,1,3739
1718a56d20ea98e128f2152c5370183c946ab155,0,Pradeep,2020-02-10 22:29:33+05:18,['1eec98e4739e47f139776c1ec0ccee57ecb7dd73'],3,3,6,1842527,2,,,,3739
e9959c0c0b41684eace583cb3a68afa5ee97d7c5,1,Abhay Kulkarni,2020-02-11 12:58:22-08:00,['1718a56d20ea98e128f2152c5370183c946ab155'],11,3,14,1842541,1,1,1,0,3739
a5a7ee0511607b9d194cb935b2ece49a9d3da917,0,Ramesh Mani,2020-02-12 10:34:10-08:00,['e9959c0c0b41684eace583cb3a68afa5ee97d7c5'],0,6,6,1842547,5,,,,3739
dc6381372bc49bfdfe8586f24102b7d3c376ca58,1,Sailaja Polavarapu,2020-02-13 09:21:35-08:00,['a5a7ee0511607b9d194cb935b2ece49a9d3da917'],104,1172,1276,1843823,26,0.557120501,0.397496088,0.41627543,3744
eedb5f3f36fcb504f5cc0f0cb8b70299d8773046,0,Pradeep,2020-02-17 14:42:02+05:18,['dc6381372bc49bfdfe8586f24102b7d3c376ca58'],1,1,2,1843825,1,,,,3744
f909896df1310cf198509e5eac474402c9473b47,1,Madhan Neethiraj,2020-02-19 09:48:49-08:00,['eedb5f3f36fcb504f5cc0f0cb8b70299d8773046'],158,245,403,1844228,3,0,0,1,3744
07a70be8cf19157efc0c875a6ddf63ab514ce88a,0,Pradeep,2020-02-24 14:34:00+05:18,['f909896df1310cf198509e5eac474402c9473b47'],50,0,50,1844278,9,0.2,0.2,0,3744
3171f5b38908e18d7ac40d27a1737e3d41370d9a,0,Pradeep,2020-02-24 14:34:06+05:18,['07a70be8cf19157efc0c875a6ddf63ab514ce88a'],32,21,53,1844331,1,0.25,0.25,0,3744
44a84058c9f59c7207283269bc212e722e9330aa,0,Pradeep,2020-02-24 15:05:11+05:18,['3171f5b38908e18d7ac40d27a1737e3d41370d9a'],8,8,16,1844347,2,0,0,0,3744
54083d6bdd7711588e88ff806eab92af3ea05568,1,Pradeep,2020-02-24 21:04:09+05:18,['44a84058c9f59c7207283269bc212e722e9330aa'],10,20,30,1844377,3,1,1,1,3744
51c584682279c799fdc6cad93042e6b7cf461673,0,Pradeep,2020-02-24 22:01:52+05:18,['54083d6bdd7711588e88ff806eab92af3ea05568'],48,142,190,1844567,5,0,0.946428571,0.946428571,3744
575f7093f353a1ec813e344060b5cb2f5adbf392,1,Pradeep,2020-02-26 15:46:11+05:18,['51c584682279c799fdc6cad93042e6b7cf461673'],142,48,190,1844757,5,1,0.053571429,0.053571429,3744
f37f5407eee8d2627a4306a25938b151f8e2ba31,1,Pradeep,2020-02-26 15:46:38+05:18,['575f7093f353a1ec813e344060b5cb2f5adbf392'],539,29,568,1845325,14,0,1,1,3744
3a7f5d7031d415869cfce682c240a9d9b20bbf4d,0,Pradeep,2020-02-29 12:56:09+05:18,['f37f5407eee8d2627a4306a25938b151f8e2ba31'],1,1,2,1845327,1,,,,3744
f849208240ca6bb44a3c85bc0008eb112099507b,0,Pradeep,2020-02-29 13:16:00+05:18,['3a7f5d7031d415869cfce682c240a9d9b20bbf4d'],0,549,549,1845876,2,0.471590909,0.505681818,0.852272727,3746
fec8ed65861997e6141c302be3cbab0861fec072,0,Ramesh Mani,2020-03-04 10:48:26-08:00,['f849208240ca6bb44a3c85bc0008eb112099507b'],2,8,10,1845886,1,,,,3746
0586ed0b97ceecd5d7523377ee92b24093520c73,0,Madhan Neethiraj,2020-03-06 10:38:12-08:00,['fec8ed65861997e6141c302be3cbab0861fec072'],11,11,22,1845908,3,,,,3746
48076d2055ccdc9dbf7cfb46a368c1e0b7d20e6f,0,Sailaja Polavarapu,2020-03-09 09:15:11-07:00,['0586ed0b97ceecd5d7523377ee92b24093520c73'],11,49,60,1845968,5,0.173913043,1,0.956521739,3746
767d9e760b762362fab7e73c8b325b6f24d7a17e,0,Sailaja Polavarapu,2020-03-09 09:20:13-07:00,['48076d2055ccdc9dbf7cfb46a368c1e0b7d20e6f'],49,11,60,1846028,5,0.826086957,0,0.043478261,3746
2ec95d58a9e6b674b7d374f6b1a7a98eeb76195e,1,Sailaja Polavarapu,2020-03-09 13:50:03-07:00,['767d9e760b762362fab7e73c8b325b6f24d7a17e'],18,1202,1220,1847248,11,0.239716312,0.404255319,0.775886525,3751
417a84cacfb74de041aa6e9a4ce20eb078b39816,0,Mehul Parikh,2020-03-11 09:58:51+05:18,['2ec95d58a9e6b674b7d374f6b1a7a98eeb76195e'],0,1,1,1847249,1,,,,3751
6d6682cbf12c04f76545b9e2451c6ba3de06ac74,1,Madhan Neethiraj,2020-03-17 09:28:50-07:00,['417a84cacfb74de041aa6e9a4ce20eb078b39816'],0,2367,2367,1849616,25,0.25,0.670305677,0.865720524,3773
6d8f9179d60f7d5f70852e13779fb096adfcf714,0,Sailaja Polavarapu,2020-03-18 16:53:11-07:00,['6d6682cbf12c04f76545b9e2451c6ba3de06ac74'],11,49,60,1849676,5,0.173913043,1,0.956521739,3773
10f4cff27b703ffbb18e77ac9bd08d4b61e63813,1,Velmurugan Periasamy,2020-03-19 12:16:48-04:00,['6d8f9179d60f7d5f70852e13779fb096adfcf714'],32,81,113,1849789,7,0.125,0.125,0,3773
d157019bf84cea2208001468e2d1affc8c025b3d,0,Madhan Neethiraj,2020-03-19 09:32:57-07:00,['10f4cff27b703ffbb18e77ac9bd08d4b61e63813'],0,4,4,1849793,1,1,1,1,3773
6b2fba5f83288e3f6d8e532748064d52b115ff9e,1,Abhay Kulkarni,2020-03-19 21:49:39-07:00,['d157019bf84cea2208001468e2d1affc8c025b3d'],6,4,10,1849803,1,,,,3773
3b49c2f9fb77d76154911b7dd61f2382d0b56bfb,0,Mehul Parikh,2020-03-20 16:59:40+05:18,['6b2fba5f83288e3f6d8e532748064d52b115ff9e'],0,365,365,1850168,6,0.220264317,0.665198238,0.696035242,3774
3c37e7aea13539f086766a78e2afa3859f9edde4,1,Sailaja Polavarapu,2020-03-20 12:14:49-07:00,['3b49c2f9fb77d76154911b7dd61f2382d0b56bfb'],8,21,29,1850197,3,0,0,0.230769231,3774
896f348636f7df8e64f789a8f24569720afb654b,0,Mehul Parikh,2020-03-23 14:57:20+05:18,['3c37e7aea13539f086766a78e2afa3859f9edde4'],10,67,77,1850274,3,0.0625,0.395833333,0.5,3774
f6ae204704c5e717aaf7d06e05af5534a2ce503a,0,Mehul Parikh,2020-03-24 15:27:53+05:18,['896f348636f7df8e64f789a8f24569720afb654b'],0,3,3,1850277,1,,,,3774
0f507a9270a9bdf4b55ff821dd77d39ba65d2138,0,Mehul Parikh,2020-03-24 18:03:19+05:18,['f6ae204704c5e717aaf7d06e05af5534a2ce503a'],1,3,4,1850281,1,0,0,1,3774
6b5df44448c4524e6881ed3682c4b1ffa2163b28,0,Ramesh Mani,2020-03-26 10:27:52-07:00,['0f507a9270a9bdf4b55ff821dd77d39ba65d2138'],1,286,287,1850568,11,0.333333333,0.333333333,0.938271605,3775
2459a50bb50424b4e9fb1000b1ad6cd683efd58d,0,pradeep,2020-03-29 14:17:17+05:18,['6b5df44448c4524e6881ed3682c4b1ffa2163b28'],0,5,5,1850573,1,,,,3775
bf2206f36343bd0f8562f3a38819217ce0ecffe5,1,Mehul Parikh,2020-03-31 19:03:19+05:18,['2459a50bb50424b4e9fb1000b1ad6cd683efd58d'],23,294,317,1850890,12,0.8,1,1,3780
daeda7ab8aefcfdbe5869ff7c5852fe1ee351635,1,Madhan Neethiraj,2020-04-01 00:28:31-07:00,['bf2206f36343bd0f8562f3a38819217ce0ecffe5'],14,281,295,1851185,5,0.784313725,0.666666667,0.549019608,3781
eafe72eb10fc165e865f3a8a43663e457e1ab96e,1,Abhay Kulkarni,2020-04-01 15:31:32-07:00,['daeda7ab8aefcfdbe5869ff7c5852fe1ee351635'],0,11,11,1851196,1,0,0,1,3781
91885108cda7d247247aa6917d056e121271d8a1,0,Sailaja Polavarapu,2020-04-02 15:02:57-07:00,['eafe72eb10fc165e865f3a8a43663e457e1ab96e'],3,2,5,1851201,1,,,,3781
d65abd8c4f7a5297f376c167f5f31b57e68bf601,0,Velmurugan Periasamy,2020-04-03 16:43:01-04:00,['91885108cda7d247247aa6917d056e121271d8a1'],4,14,18,1851219,1,0,0,1,3781
7b66386ebbd81337888cbc3b5b0fc65c2a8aa4a1,1,Ramesh Mani,2020-04-04 13:36:10-07:00,['d65abd8c4f7a5297f376c167f5f31b57e68bf601'],87,42,129,1851348,2,0,0,0,3781
f0797138f6bdf9432400d1c2743b5ea7351a0c8d,0,Madhan Neethiraj,2020-04-06 09:48:46-07:00,['7b66386ebbd81337888cbc3b5b0fc65c2a8aa4a1'],0,308,308,1851656,3,0.487179487,0.487179487,0.961538462,3783
8b963d304c77f7daf86131a514f1744a44b485b1,1,Madhan Neethiraj,2020-04-06 09:48:49-07:00,['f0797138f6bdf9432400d1c2743b5ea7351a0c8d'],134,486,620,1852276,7,0.803921569,0.294117647,0.882352941,3784
ffb4ce24a10414fa20bf4b686a7b37291ac1db09,0,Madhan Neethiraj,2020-04-06 18:28:19-07:00,['8b963d304c77f7daf86131a514f1744a44b485b1'],111,93,204,1852480,2,1,0.472222222,1,3784
d7bd3336d59a83027a4488ca783dd1ce09c2224d,0,Mehul Parikh,2020-04-08 12:46:25+05:18,['ffb4ce24a10414fa20bf4b686a7b37291ac1db09'],1,1,2,1852482,1,,,,3784
cf775085d6eb850f65ac2de2707d75e36862c1ba,0,Mehul Parikh,2020-04-08 12:51:45+05:18,['d7bd3336d59a83027a4488ca783dd1ce09c2224d'],1,1,2,1852484,1,,,,3784
6827eb7351708c22d45481fda8cfa61467f60741,1,Sailaja Polavarapu,2020-04-08 07:07:01-07:00,['cf775085d6eb850f65ac2de2707d75e36862c1ba'],162,375,537,1853021,5,0,0,0.754901961,3784
d51ec831affbfb1e29215d77a2204423ab77e6d9,0,Sailaja Polavarapu,2020-04-08 11:18:57-07:00,['6827eb7351708c22d45481fda8cfa61467f60741'],3,4,7,1853028,1,,,,3784
bb05c645fccb45dcadeaf557fa7dd174413d7af3,0,Madhan Neethiraj,2020-04-09 09:07:28-07:00,['d51ec831affbfb1e29215d77a2204423ab77e6d9'],27,44,71,1853099,2,1,1,1,3784
7581772df51b7846215bb6f03b929127e423debb,0,Madhan Neethiraj,2020-04-09 15:44:31-07:00,['bb05c645fccb45dcadeaf557fa7dd174413d7af3'],1,0,1,1853100,1,,,,3784
0a998ed76fab3c7898a5d36b0a560f9723c19a75,0,Abhay Kulkarni,2020-04-09 16:31:47-07:00,['7581772df51b7846215bb6f03b929127e423debb'],7,24,31,1853131,2,,,,3784
03fab86922c1cefbee52b6ab343bf471b71b6a98,0,Abhay Kulkarni,2020-04-10 12:11:11-07:00,['0a998ed76fab3c7898a5d36b0a560f9723c19a75'],0,2,2,1853133,1,,,,3784
5b23eff7d1ce5b4cbd0fa1b7ad4709f7e48cd10f,1,Mehul Parikh,2020-04-14 14:04:26+05:18,['03fab86922c1cefbee52b6ab343bf471b71b6a98'],6,20,26,1853159,2,0,0,0,3784
99c15149dc250d56e5145996bc944f0b32e6ac56,0,Mehul Parikh,2020-04-14 16:34:47+05:18,['5b23eff7d1ce5b4cbd0fa1b7ad4709f7e48cd10f'],9,16,25,1853184,2,1,1,1,3784
7dac4e178b94c949da7c727fb2e749b50d933bb5,0,Mehul Parikh,2020-04-14 16:35:29+05:18,['99c15149dc250d56e5145996bc944f0b32e6ac56'],17,30,47,1853231,2,0,0,0,3784
40d935cd635ea23596590f444c3c6ce71474bbb9,0,Mehul Parikh,2020-04-14 18:34:53+05:18,['7dac4e178b94c949da7c727fb2e749b50d933bb5'],2,2,4,1853235,1,,,,3784
4e3500192f88cf6c232d729797d08f475aaef44e,1,Mehul Parikh,2020-04-14 19:34:22+05:18,['40d935cd635ea23596590f444c3c6ce71474bbb9'],6,49,55,1853290,4,0.846153846,1,0.307692308,3784
6b393ddbab3cc3cd8981f77849c915c01cacea24,0,Mehul Parikh,2020-04-16 11:54:58+05:18,['4e3500192f88cf6c232d729797d08f475aaef44e'],1,1,2,1853292,1,,,,3784
0e2f4ba26d83866adb3e924a4e45fbabe0777e27,0,Mehul Parikh,2020-04-16 17:14:13+05:18,['6b393ddbab3cc3cd8981f77849c915c01cacea24'],0,3,3,1853295,1,0,1,1,3784
a9028bb31d143ce527d89413a8d13f6fe56f2bbf,1,pradeep,2020-04-17 18:19:10+05:18,['0e2f4ba26d83866adb3e924a4e45fbabe0777e27'],3,4,7,1853302,1,,,,3784
41f64240fe999028e27c9306ca75ec44c142bf74,1,Sailaja Polavarapu,2020-04-17 09:36:31-07:00,['a9028bb31d143ce527d89413a8d13f6fe56f2bbf'],0,93,93,1853395,1,0.6,1,1,3785
75823ca43035be58ff6d9c4545034b954f595c87,0,Sailaja Polavarapu,2020-04-17 09:49:10-07:00,['41f64240fe999028e27c9306ca75ec44c142bf74'],1,1,2,1853397,1,,,,3785
7bf61cc5835a61c552b709ac3c200f9a69f61a66,0,Sailaja Polavarapu,2020-04-17 16:23:38-07:00,['75823ca43035be58ff6d9c4545034b954f595c87'],4,0,4,1853401,1,,,,3785
6d93ba7158dbc366457613f29b71b25ee6790484,1,Mehul Parikh,2020-04-20 11:01:18+05:18,['7bf61cc5835a61c552b709ac3c200f9a69f61a66'],2,4,6,1853407,1,0,0,1,3785
53890aa7a3c6b6fb6476874c703e12030a4e7033,0,Sailaja Polavarapu,2020-04-20 16:40:25-07:00,['6d93ba7158dbc366457613f29b71b25ee6790484'],1,7,8,1853415,5,,,,3785
b8a3e18e3824ac372ceecef1b2de404105a9722b,1,Sailaja Polavarapu,2020-04-20 16:41:19-07:00,['53890aa7a3c6b6fb6476874c703e12030a4e7033'],2,6,8,1853423,1,,,,3785
b8789eef138f869763d09a442edd515dc2592585,0,Abhay Kulkarni,2020-04-22 12:36:33-07:00,['b8a3e18e3824ac372ceecef1b2de404105a9722b'],3,97,100,1853523,3,0,0,1,3785
a15e49fb53b9a0ea7ae273a26e412e4b065765a1,1,Madhan Neethiraj,2020-04-22 23:19:07-07:00,['b8789eef138f869763d09a442edd515dc2592585'],293,2347,2640,1856163,13,0.785123967,0.842975207,0.716253444,3790
9e1268863d82d5c63a899375d5aa06fdec6a7d53,1,Mehul Parikh,2020-04-23 17:57:52+05:18,['a15e49fb53b9a0ea7ae273a26e412e4b065765a1'],21,227,248,1856411,1,0.448051948,0.863636364,0.837662338,3790
6decd3a0ba8bff83dff0863a9694afdf47a63cd9,0,pradeep,2020-04-23 18:26:54+05:18,['9e1268863d82d5c63a899375d5aa06fdec6a7d53'],7,19,26,1856437,2,1,0,1,3790
fc7873ed00177ac98b6eca6381997cf2af6fcb69,1,Ramesh Mani,2020-04-23 10:07:21-07:00,['6decd3a0ba8bff83dff0863a9694afdf47a63cd9'],2,4,6,1856443,1,0,0,1,3790
b7a2902939f0d5ae64ead9fde539e76a766238a2,1,Abhay Kulkarni,2020-04-23 19:38:33-07:00,['fc7873ed00177ac98b6eca6381997cf2af6fcb69'],33,88,121,1856564,2,0,0.666666667,1,3790
21a4c0dd2feba0b958fbc1a6d8b8009ccbbb818d,0,pradeep,2020-04-24 18:56:44+05:18,['b7a2902939f0d5ae64ead9fde539e76a766238a2'],10,38,48,1856612,4,0.214285714,1,1,3790
fcfe7a54257912f6bcf38d8ba9510f8eb04e1d53,0,pradeep,2020-04-27 18:00:31+05:18,['21a4c0dd2feba0b958fbc1a6d8b8009ccbbb818d'],3,3,6,1856618,2,,,,3790
2b5fc4796f6ab1dafaf682a8fb6f647812261d5a,1,Sailaja Polavarapu,2020-04-27 14:31:30-07:00,['fcfe7a54257912f6bcf38d8ba9510f8eb04e1d53'],8,4,12,1856630,1,1,0,0,3790
0ac7c0c438e85f3b0b83b28efc99ce8221d21d1e,0,pradeep,2020-04-30 20:42:59+05:18,['2b5fc4796f6ab1dafaf682a8fb6f647812261d5a'],11,279,290,1856920,13,,,,3795
91a00f42062bfe01600fd477a4d57d5b1a6b8b06,0,Abhay Kulkarni,2020-04-30 14:32:30-07:00,['0ac7c0c438e85f3b0b83b28efc99ce8221d21d1e'],1,209,210,1857130,7,0.298969072,0.711340206,1,3796
f117b1c245d2f388d262425276e5e9f81f0c9248,1,Ramesh Mani,2020-05-01 20:49:04-07:00,['91a00f42062bfe01600fd477a4d57d5b1a6b8b06'],14,25,39,1857169,1,1,1,1,3796
586c8562043def73ef371e2661c3fccf55a6c6ef,0,Madhan Neethiraj,2020-05-03 10:13:13-07:00,['f117b1c245d2f388d262425276e5e9f81f0c9248'],7,11,18,1857187,1,0,1,1,3796
845700e977d5560186557105ae7bb5c4c5793d92,1,pradeep,2020-05-07 13:49:25+05:18,['586c8562043def73ef371e2661c3fccf55a6c6ef'],2,3,5,1857192,1,0,0,1,3796
c5fb46ebde5d2d257f79ca3b33aff01b286b1664,0,Ramesh Mani,2020-05-07 09:58:14-07:00,['845700e977d5560186557105ae7bb5c4c5793d92'],9,45,54,1857246,7,0,0,1,3796
b374845664bd0e48d2b6debb52097e221c3eac20,0,Sailaja Polavarapu,2020-05-12 12:52:38-07:00,['c5fb46ebde5d2d257f79ca3b33aff01b286b1664'],1,15,16,1857262,2,,,,3796
0db8b4f3f5997fee2f05b35a2488a08873657bcb,1,Sailaja Polavarapu,2020-05-12 13:44:43-07:00,['b374845664bd0e48d2b6debb52097e221c3eac20'],3,8,11,1857273,2,,,,3796
c2155dfad98323df02b05c5852b1a3c3a05aa313,0,Madhan Neethiraj,2020-05-12 18:13:55-07:00,['0db8b4f3f5997fee2f05b35a2488a08873657bcb'],1,89,90,1857363,3,1,1,1,3797
86ea0b4ee722cd9c6c1fdc77b91102f15afda7e4,0,Bhavik Himmatbhai Patel,2020-05-14 10:28:06+05:18,['c2155dfad98323df02b05c5852b1a3c3a05aa313'],29,0,29,1857392,1,0.85,0,0.85,3797
f4ac66d5f2f0014a8b1f6ab043cc1372a55ab6fd,0,pradeep,2020-05-14 20:56:56+05:18,['86ea0b4ee722cd9c6c1fdc77b91102f15afda7e4'],62,181,243,1857635,4,0,0.91954023,0.91954023,3797
acd7516eea2e11921a42478b717d58f2bead54e8,0,pradeep,2020-05-16 10:00:53+05:18,['f4ac66d5f2f0014a8b1f6ab043cc1372a55ab6fd'],19,88,107,1857742,2,0,0.87037037,1,3797
454537a95494477312b592256cd38878d004a167,1,Madhan Neethiraj,2020-05-17 11:08:54-07:00,['acd7516eea2e11921a42478b717d58f2bead54e8'],54,580,634,1858376,7,0.609195402,0.793103448,0.83908046,3798
6effe9615cbf47aa4aadc4cb7874fd87ff5c1bad,0,Madhan Neethiraj,2020-05-17 20:34:38-07:00,['454537a95494477312b592256cd38878d004a167'],2,34,36,1858412,3,0.826086957,0.826086957,0.739130435,3798
9256a436b392e11907d1b1570d69e106c8e5dd7f,0,pradeep,2020-05-19 09:59:44+05:18,['6effe9615cbf47aa4aadc4cb7874fd87ff5c1bad'],4,10,14,1858426,6,,,,3798
45efc9a622a10d963d1b5d406bd9e49fdb6d6589,0,Abhay Kulkarni,2020-05-19 15:23:50-07:00,['9256a436b392e11907d1b1570d69e106c8e5dd7f'],1,3,4,1858430,1,0,0,1,3798
d488d570d6b94a8987431d4424727c6a91d640b7,1,pradeep,2020-05-23 13:01:49+05:18,['45efc9a622a10d963d1b5d406bd9e49fdb6d6589'],52,195,247,1858677,20,0,0,0.850877193,3798
e78498a4c1d767134b4abf4aeeeedc2d8bc69a9f,1,pradeep,2020-05-23 13:02:03+05:18,['d488d570d6b94a8987431d4424727c6a91d640b7'],282,212,494,1859171,7,0.61038961,0.571428571,0,3799
813b67197ae6e58c21a9e72c7f034779c3efed79,0,pradeep,2020-05-23 13:02:41+05:18,['e78498a4c1d767134b4abf4aeeeedc2d8bc69a9f'],0,20,20,1859191,5,,,,3799
cf1e3ef8dcd5a4adc046a3895f49c9deb3069015,1,pradeep,2020-05-27 13:49:36+05:18,['813b67197ae6e58c21a9e72c7f034779c3efed79'],164,1950,2114,1861305,68,0.22106632,0.427828349,0.811443433,3809
a72b5eddecfd61099791eae615716cce430b348a,0,pradeep,2020-05-28 10:43:30+05:18,['cf1e3ef8dcd5a4adc046a3895f49c9deb3069015'],1,6,7,1861312,1,,,,3809
54e54886329f9e46845f11cde066c842525d2e88,0,pradeep,2020-05-28 11:02:51+05:18,['a72b5eddecfd61099791eae615716cce430b348a'],0,1,1,1861313,1,,,,3809
d5e3dc8c722e7ec4f035139c7c20e706aa82b146,0,pradeep,2020-05-28 11:57:50+05:18,['54e54886329f9e46845f11cde066c842525d2e88'],339,393,732,1862045,21,0,0,0,3809
3a4a313e5ed97c7d36340ef59b6a4038e7bae89f,1,Ramesh Mani,2020-05-28 09:49:57-07:00,['d5e3dc8c722e7ec4f035139c7c20e706aa82b146'],22,82,104,1862149,2,0.381818182,0.381818182,1,3809
d8e9c489d4bff72cb80661a268b35d5a01688586,1,Sailaja Polavarapu,2020-05-29 14:19:37-07:00,['3a4a313e5ed97c7d36340ef59b6a4038e7bae89f'],262,432,694,1862843,2,0.145299145,0.145299145,0.991452991,3810
d722786c8914e762ab1334d245855e0e440af5fe,0,Bhavik Himmatbhai Patel,2020-05-31 15:21:25+05:18,['d8e9c489d4bff72cb80661a268b35d5a01688586'],0,61,61,1862904,31,,,,3810
d4d19bb056f1c2d32eda250f8a990bcf3c2d57df,0,Bhavik Himmatbhai Patel,2020-05-31 15:28:01+05:18,['d722786c8914e762ab1334d245855e0e440af5fe'],0,180,180,1863084,15,,,,3810
8050020935618488ba1406f7568c2f1f654029ec,1,Abhay Kulkarni,2020-05-31 15:55:56-07:00,['d4d19bb056f1c2d32eda250f8a990bcf3c2d57df'],102,170,272,1863356,10,0,0.016949153,0.93220339,3810
5dc750994aa0164d519aab709dd28789164b756b,1,pradeep,2020-06-01 14:54:36+05:18,['8050020935618488ba1406f7568c2f1f654029ec'],52,198,250,1863606,13,1,1,0,3810
5d1f87cd92eeed7cc7deb3fd0f7e688ef71e9250,1,pradeep,2020-06-01 16:25:21+05:18,['5dc750994aa0164d519aab709dd28789164b756b'],31,223,254,1863860,1,0.381944444,0.847222222,0.951388889,3810
f45054d1b933b5e65cb19ace014d3b2cb0d78132,1,pradeep,2020-06-02 13:40:50+05:18,['5d1f87cd92eeed7cc7deb3fd0f7e688ef71e9250'],1,295,296,1864156,4,0.211618257,0.323651452,1,3810
cd2165f4b81eff0f29edf30fe73c31d24d9f1d78,0,pradeep,2020-06-02 13:41:07+05:18,['f45054d1b933b5e65cb19ace014d3b2cb0d78132'],3,11,14,1864170,1,0,0,1,3810
6ae055f68adc4f63a36459b27084cc3ab0a8f53e,0,pradeep,2020-06-06 15:18:19+05:18,['cd2165f4b81eff0f29edf30fe73c31d24d9f1d78'],0,422,422,1864592,8,0.192513369,0.465240642,1,3812
05f465ea950530a30e8c8491276d83324a7aa652,0,Madhan Neethiraj,2020-06-07 09:50:16-07:00,['6ae055f68adc4f63a36459b27084cc3ab0a8f53e'],1,1,2,1864594,1,,,,3812
7b0fe697daf162cf326c9d19fed547337da2513a,0,pradeep,2020-06-08 19:50:51+05:18,['05f465ea950530a30e8c8491276d83324a7aa652'],2,1,3,1864597,3,,,,3812
23bef42d73b9b98c77d0e34794b11742c85571c0,0,pradeep,2020-06-08 19:53:17+05:18,['7b0fe697daf162cf326c9d19fed547337da2513a'],74,0,74,1864671,2,1,1,0,3812
8087992d110c7beab059e002e8e8f57485ad544f,1,Abhay Kulkarni,2020-06-09 11:53:44-07:00,['23bef42d73b9b98c77d0e34794b11742c85571c0'],7,8,15,1864686,4,0,0,1,3812
f246f4397f2a2c8bfa596a2b0dada0874c77e6aa,0,pradeep,2020-06-10 12:34:52+05:18,['8087992d110c7beab059e002e8e8f57485ad544f'],845,840,1685,1866371,18,,,,3812
297e8b909a405b7448c699d535299aaf7a2c4d93,0,pradeep,2020-06-10 12:44:49+05:18,['f246f4397f2a2c8bfa596a2b0dada0874c77e6aa'],0,1,1,1866372,1,0,1,1,3812
734485dd2149db628b3353279a9f16b45de91956,0,pradeep,2020-06-10 17:42:19+05:18,['297e8b909a405b7448c699d535299aaf7a2c4d93'],1,16,17,1866389,2,0,0,1,3812
12019572d2a7f77e221ccdb28cec2e58fd776141,0,pradeep,2020-06-11 12:34:53+05:18,['734485dd2149db628b3353279a9f16b45de91956'],0,16,16,1866405,1,,,,3813
63df056c754a2889ee4c6fc17d22529ca0cb7f6d,0,pradeep,2020-06-12 15:05:28+05:18,['12019572d2a7f77e221ccdb28cec2e58fd776141'],13,60,73,1866478,5,0,0,1,3813
691a55cd38ef216258aec370859d5b2d823320da,1,Abhay Kulkarni,2020-06-16 16:03:13-07:00,['63df056c754a2889ee4c6fc17d22529ca0cb7f6d'],342,411,753,1867231,7,0.285714286,0.693877551,0,3813
473d2c99ccee166efa6788a0767d44cb38e336cf,0,Madhan Neethiraj,2020-06-17 16:17:46-07:00,['691a55cd38ef216258aec370859d5b2d823320da'],1,1,2,1867233,1,,,,3813
d6c53d9cdef75c00c28cea487c70b3fceb63e672,1,Abhay Kulkarni,2020-06-18 14:08:50-07:00,['473d2c99ccee166efa6788a0767d44cb38e336cf'],11,15,26,1867259,3,0.5,0.5,1,3813
bcdb1eda7f0d774952facd84da77b69fca149ff1,0,Ramesh Mani,2020-06-22 13:35:15-07:00,['d6c53d9cdef75c00c28cea487c70b3fceb63e672'],28,69,97,1867356,3,0,0.941176471,1,3813
a14b6d6aa57d6bc0026713e73750df716c65aa8f,1,Mehul Parikh,2020-06-26 13:06:06+05:18,['bcdb1eda7f0d774952facd84da77b69fca149ff1'],120,6,126,1867482,1,1,0.432989691,0.391752577,3813
641ef11a2e45887d689c986b2584fd3ba4c9fcc5,0,Mehul Parikh,2020-06-26 13:06:06+05:18,['a14b6d6aa57d6bc0026713e73750df716c65aa8f'],0,1,1,1867483,1,0,1,1,3813
e3e0e0d76774996223a4e1207b1fcae984bf9acb,0,Ramesh Mani,2020-06-26 08:20:31-07:00,['641ef11a2e45887d689c986b2584fd3ba4c9fcc5'],3,15,18,1867501,3,1,1,1,3813
e3ff179223f87b8fe3c66b08d6c48eda3f0e6f7b,0,Ramesh Mani,2020-06-26 11:29:54-07:00,['e3e0e0d76774996223a4e1207b1fcae984bf9acb'],0,4,4,1867505,1,0,0,1,3813
8ed113f424d0054b364cc6bd5874225d6f2011ba,1,Mehul Parikh,2020-06-29 19:01:46+05:18,['e3ff179223f87b8fe3c66b08d6c48eda3f0e6f7b'],736,4155,4891,1872396,40,0.524450744,0.844790928,0.944720057,3822
81dd0f650eb179d29b9d62a6e435fef00e944e40,0,pradeep,2020-06-30 16:37:07+05:18,['8ed113f424d0054b364cc6bd5874225d6f2011ba'],1,5,6,1872402,1,0,0,0,3822
225d00761850301a9f9a346e01808717eb110178,0,Abhay Kulkarni,2020-06-30 16:00:28-07:00,['81dd0f650eb179d29b9d62a6e435fef00e944e40'],10,5,15,1872417,1,1,1,0,3822
de88e7973763b816655f99f917c4f28fe0ced40c,0,pradeep,2020-07-02 10:16:20+05:18,['225d00761850301a9f9a346e01808717eb110178'],1,1,2,1872419,1,,,,3822
23b49c581dedea32bf8a03b503f9337530427521,0,pradeep,2020-07-03 15:38:40+05:18,['de88e7973763b816655f99f917c4f28fe0ced40c'],1,1,2,1872421,1,,,,3822
57e97631bcaf9100e88c4c9e9d091404d93a4c72,1,pradeep,2020-07-05 17:08:08+05:18,['23b49c581dedea32bf8a03b503f9337530427521'],4,4,8,1872429,1,,,,3822
197b27683b5271836a8add2d783ee2889b47d153,1,pradeep,2020-07-05 17:19:56+05:18,['57e97631bcaf9100e88c4c9e9d091404d93a4c72'],0,221,221,1872650,28,,,,3822
a15ec3c1028b01b292e257a1a50d83fcd8d91149,0,pradeep,2020-07-05 17:56:46+05:18,['197b27683b5271836a8add2d783ee2889b47d153'],4,52,56,1872706,2,0,0,1,3822
8391df288a002cd5b0995998df36511d185867e2,0,Madhan Neethiraj,2020-07-05 19:42:09-07:00,['a15ec3c1028b01b292e257a1a50d83fcd8d91149'],2,2,4,1872710,1,,,,3822
0fa35a1d00de7899effa5a589713baf947cabd2b,0,Ramesh Mani,2020-07-05 21:29:13-07:00,['8391df288a002cd5b0995998df36511d185867e2'],0,18,18,1872728,2,1,1,1,3822
e79967389edf007ce181553e5ade8d5912c3a8f4,0,pradeep,2020-07-06 15:37:39+05:18,['0fa35a1d00de7899effa5a589713baf947cabd2b'],18,0,18,1872746,2,0,0,0,3822
4160ebfc7cb1db642e8ba7fdbaa72142978e764b,0,pradeep,2020-07-06 15:39:37+05:18,['e79967389edf007ce181553e5ade8d5912c3a8f4'],2,6,8,1872754,1,0,0,1,3822
400beaa7604e4c83d051dc6e83b8bc109e5d8c53,1,pradeep,2020-07-07 13:16:49+05:18,['4160ebfc7cb1db642e8ba7fdbaa72142978e764b'],3,69,72,1872826,3,0.255319149,0.255319149,1,3822
a4cf0b7c26723db0429f5ef8ac39b64bf1a8762c,0,Sailaja Polavarapu,2020-07-07 10:51:50-07:00,['400beaa7604e4c83d051dc6e83b8bc109e5d8c53'],1,1236,1237,1874063,13,0.650793651,0.870748299,0.793650794,3832
88403100b3c56d0cf41cfb8ac47a0315ab830cad,1,Sailaja Polavarapu,2020-07-07 13:49:56-07:00,['400beaa7604e4c83d051dc6e83b8bc109e5d8c53'],1,1236,1237,1875300,13,0.650793651,0.870748299,0.793650794,3842
64a1d8e2db5201bf7de2f3ea5b6b22b5f2869ec5,0,Sailaja Polavarapu,2020-07-07 13:50:36-07:00,"['88403100b3c56d0cf41cfb8ac47a0315ab830cad', 'a4cf0b7c26723db0429f5ef8ac39b64bf1a8762c']",0,0,0,1875300,0,,,,3842
95a1aa57a96b392227a4f0aa4e7ecc396dca2261,0,Sailaja Polavarapu,2020-07-07 16:28:51-07:00,['64a1d8e2db5201bf7de2f3ea5b6b22b5f2869ec5'],1,4,5,1875305,3,,,,3844
68627f54b681894622808e3cc4f12a6d7a539dd2,1,Abhay Kulkarni,2020-07-08 12:05:00-07:00,['95a1aa57a96b392227a4f0aa4e7ecc396dca2261'],3,28,31,1875336,2,0.523809524,0.523809524,0,3844
8e45df1f117c8a65e05be5218a111078efd6234a,1,pradeep,2020-07-09 20:38:08+05:18,['68627f54b681894622808e3cc4f12a6d7a539dd2'],64,514,578,1875914,8,0.310043668,0.864628821,0.528384279,3848
708085410ff2bbbde5f9343c31cd0a1b45f5efa8,0,pradeep,2020-07-10 10:28:08+05:18,['8e45df1f117c8a65e05be5218a111078efd6234a'],1,1,2,1875916,1,,,,3848
bc94870c3ee448b3d71d709cccfcf6ccfcae3ad4,0,Nitin Galave,2020-07-10 15:41:40+05:18,['708085410ff2bbbde5f9343c31cd0a1b45f5efa8'],10616,10890,21506,1897422,12,0.49122807,0.649122807,0.719298246,3850
f2ca558474e4639d6aa0e1f6a4715fb7f606b3b4,1,pradeep,2020-07-10 20:12:29+05:18,['bc94870c3ee448b3d71d709cccfcf6ccfcae3ad4'],10,48,58,1897480,3,0.5625,0.5625,0.5625,3850
87cc02b103c15297e8b8ddb12a8997517a27fc1c,0,pradeep,2020-07-10 20:38:39+05:18,['f2ca558474e4639d6aa0e1f6a4715fb7f606b3b4'],2,5,7,1897487,2,0,1,1,3850
807cb949dbc46699ba6694d9404158dd61ecc019,0,pradeep,2020-07-10 20:39:23+05:18,['87cc02b103c15297e8b8ddb12a8997517a27fc1c'],12,0,12,1897499,4,,,,3850
c66c8384757be11335d62f72e63b8da5a5f58234,0,pradeep,2020-07-10 20:39:55+05:18,['807cb949dbc46699ba6694d9404158dd61ecc019'],1,1,2,1897501,1,,,,3850
a0ec633e77db702d4fbc9fd97eee44c8467eb035,0,pradeep,2020-07-10 20:40:25+05:18,['c66c8384757be11335d62f72e63b8da5a5f58234'],224,147,371,1897872,45,1,1,0,3850
23fc9bf3bec073fb92f506d4bddc08427961cd89,1,pradeep,2020-07-10 20:40:59+05:18,['a0ec633e77db702d4fbc9fd97eee44c8467eb035'],10,11,21,1897893,3,1,1,0,3850
8626832e6648535c34fa6915f8272c4d671f05ed,0,Abhay Kulkarni,2020-07-14 13:06:53-07:00,['23fc9bf3bec073fb92f506d4bddc08427961cd89'],2,18,20,1897913,1,0,0,1,3850
4a1c375088ad351ea5b1f727bcbb225ec044c344,0,Abhay Kulkarni,2020-07-14 13:26:05-07:00,['8626832e6648535c34fa6915f8272c4d671f05ed'],1,1,2,1897915,1,,,,3850
7f32d49b5c015e3a85b276e1242277be37b1192d,0,pradeep,2020-07-15 19:32:07+05:18,['4a1c375088ad351ea5b1f727bcbb225ec044c344'],1,1,2,1897917,1,,,,3850
850e31e31087fad03ba519d1246d2f0bd70cb669,0,pradeep,2020-07-15 19:33:07+05:18,['7f32d49b5c015e3a85b276e1242277be37b1192d'],4,4,8,1897925,1,,,,3850
11a1cf1c6b35868dc17c3217fa4ec9791dd30886,0,Sailaja Polavarapu,2020-07-16 14:54:56-07:00,['850e31e31087fad03ba519d1246d2f0bd70cb669'],0,327,327,1898252,3,0.47752809,0.47752809,0.966292135,3852
b34bc70edcab38e902df6380f8e2fc8de1464e30,0,pradeep,2020-07-17 10:14:35+05:18,['11a1cf1c6b35868dc17c3217fa4ec9791dd30886'],3,3,6,1898258,1,,,,3852
9cb4f16eaf834a4f8916d43d9f0f8ddd9f781f20,0,Abhay Kulkarni,2020-07-17 09:50:19-07:00,['b34bc70edcab38e902df6380f8e2fc8de1464e30'],23,20,43,1898301,2,,,,3852
0fa3ef5497bc563e0ff80e9696fdb1bc309d7fe1,0,pradeep,2020-07-19 14:41:17+05:18,['9cb4f16eaf834a4f8916d43d9f0f8ddd9f781f20'],15,17,32,1898333,3,0,0,1,3852
f5f0dcafc03d7910d0517845bd7ca43253d07557,0,Ramesh Mani,2020-07-19 22:55:57-07:00,['0fa3ef5497bc563e0ff80e9696fdb1bc309d7fe1'],11,161,172,1898505,2,0.300970874,0.300970874,0.757281553,3853
1628fa74843950119f6bdb8e2cb5a9301c1b2056,1,pradeep,2020-07-21 11:24:43+05:18,['f5f0dcafc03d7910d0517845bd7ca43253d07557'],1,31,32,1898537,3,0,1,0,3853
0ecdb149010a2c75265826bd523b480b20976adb,0,pradeep,2020-07-21 16:48:03+05:18,['1628fa74843950119f6bdb8e2cb5a9301c1b2056'],4,5,9,1898546,2,,,,3853
ec584951a53cb2af558b6ebad9d6612faf070916,1,Abhay Kulkarni,2020-07-21 14:47:11-07:00,['0ecdb149010a2c75265826bd523b480b20976adb'],14,14,28,1898574,3,1,1,0,3853
ad06828d2d0b31731e02247a29bba65b9c9f2cef,0,pradeep,2020-07-24 09:56:12+05:18,['ec584951a53cb2af558b6ebad9d6612faf070916'],0,194,194,1898768,1,0,0,1,3853
4b77aaf68a9c0c3d1b555708b418f915afdffc7a,0,Ramesh Mani,2020-07-23 23:50:22-07:00,['ad06828d2d0b31731e02247a29bba65b9c9f2cef'],0,12,12,1898780,4,,,,3853
78eb798a4a00e289d7e62951b00a4c297b5b3d83,0,Mehul Parikh,2020-07-24 19:21:13+05:18,['4b77aaf68a9c0c3d1b555708b418f915afdffc7a'],6,11,17,1898797,1,0,0,0.75,3853
20561472eba2fc484f33801c5c07fdc9b8edd9d9,0,pradeep,2020-07-25 12:46:13+05:18,['78eb798a4a00e289d7e62951b00a4c297b5b3d83'],2,70,72,1898869,2,1,1,1,3854
694967aff3d09fcb8c27d1733322e92d44209c99,0,Selvamohan Neethiraj,2020-07-25 08:26:57-04:00,['20561472eba2fc484f33801c5c07fdc9b8edd9d9'],5,19,24,1898893,1,0,1,1,3854
b51c110115f6f1872b362884697f0fc15b73e346,1,Sailaja Polavarapu,2020-07-27 16:09:45-07:00,['694967aff3d09fcb8c27d1733322e92d44209c99'],21,191,212,1899105,4,0.344444444,0.344444444,0.844444444,3855
b91d21d194a64fb29d45058cf8bf8a0a289263a9,0,Sailaja Polavarapu,2020-07-28 15:34:55-07:00,['b51c110115f6f1872b362884697f0fc15b73e346'],14,81,95,1899200,3,0.016949153,0.305084746,0.711864407,3855
e3938e97159d1c5fc7bfff10cafbc95e3c3a8396,0,pradeep,2020-07-29 20:29:24+05:18,['b91d21d194a64fb29d45058cf8bf8a0a289263a9'],1,1,2,1899202,1,,,,3855
8f0c6a56773e71d52c96fe998d8bd06e6efbc5c9,0,pradeep,2020-07-30 10:50:31+05:18,['e3938e97159d1c5fc7bfff10cafbc95e3c3a8396'],0,6,6,1899208,1,0,0,1,3855
9683eacca70780ab1d73d74d319dc28c08b0059e,1,Nitin Galave,2020-07-31 18:27:57+05:18,['8f0c6a56773e71d52c96fe998d8bd06e6efbc5c9'],4199,2370,6569,1905777,14,0,0.215250965,0.162162162,3855
b6b53a9c1851825e19d70e92a1d5e63e86163f31,0,Mehul Parikh,2020-08-05 14:33:13+05:18,['9683eacca70780ab1d73d74d319dc28c08b0059e'],1,1,2,1905779,1,,,,3855
57312b4680b2a584a5d4c6857742c5a9e73f595f,0,Madhan Neethiraj,2020-08-05 15:43:58-07:00,['b6b53a9c1851825e19d70e92a1d5e63e86163f31'],72,72,144,1905923,63,,,,3855
7a31970ab0950e175f52c0ff81fafdd4ed1c9440,0,Madhan Neethiraj,2020-08-07 22:23:17-07:00,['57312b4680b2a584a5d4c6857742c5a9e73f595f'],1,3,4,1905927,1,0,0,1,3855
756cf23c4aa7eeae82c9c254409a9c8637d56dec,0,Madhan Neethiraj,2020-08-09 10:29:29-07:00,['7a31970ab0950e175f52c0ff81fafdd4ed1c9440'],0,7,7,1905934,1,0,0,1,3855
f29d29b8da7ac8d4afa0d10e504b146381307d6d,1,Abhay Kulkarni,2020-08-10 21:04:50-07:00,['756cf23c4aa7eeae82c9c254409a9c8637d56dec'],72,122,194,1906128,6,1,1,1,3855
265f7f256b42e321c463f7f26090d995a7932fd1,0,Nitin Galave,2020-08-11 16:33:22+05:18,['f29d29b8da7ac8d4afa0d10e504b146381307d6d'],29,37,66,1906194,13,0.158415842,0.97029703,1,3855
5c5c297a9c66f1a41a8dddf1c0148690b1d1438e,0,Mehul Parikh,2020-08-12 12:55:20+05:18,['265f7f256b42e321c463f7f26090d995a7932fd1'],5,161,166,1906360,10,,,,3860
9631ec440d838b2e9da7c4061d8ae58b75f24b0b,0,Madhan Neethiraj,2020-08-13 08:21:13-07:00,['5c5c297a9c66f1a41a8dddf1c0148690b1d1438e'],1,1,2,1906362,1,,,,3860
876d0bcb853cb46975b8c1b6953c748c2404ea8b,0,Madhan Neethiraj,2020-08-13 09:09:59-07:00,['9631ec440d838b2e9da7c4061d8ae58b75f24b0b'],0,18,18,1906380,2,0,0,0,3860
74d163806fc1e26f955cc38854a77c94e9959102,1,Madhan Neethiraj,2020-08-13 09:57:37-07:00,['876d0bcb853cb46975b8c1b6953c748c2404ea8b'],25,315,340,1906720,12,0.24260355,0.408284024,0.792899408,3862
e6f85bba857175c65e202b1b660b0f50525e83c9,0,Nitin Galave,2020-08-14 19:47:21+05:18,['74d163806fc1e26f955cc38854a77c94e9959102'],7,12,19,1906739,2,1,1,1,3862
e5a7f61a0d8bf8e2c389b06b03ce5c9caa1bf165,0,Nitin Galave,2020-08-14 19:47:25+05:18,['e6f85bba857175c65e202b1b660b0f50525e83c9'],0,3,3,1906742,1,1,1,1,3862
4706b1093da13eae77697ea5efce7b2fae357781,1,Mehul Parikh,2020-08-14 19:52:48+05:18,['e5a7f61a0d8bf8e2c389b06b03ce5c9caa1bf165'],1015,286,1301,1908043,1,,,,3862
a07bde1024518126b4881b0e71f4fd30b8405edd,0,Sailaja Polavarapu,2020-08-14 16:47:33-07:00,['4706b1093da13eae77697ea5efce7b2fae357781'],10,1611,1621,1909664,27,0.745136187,0.714007782,0.328793774,3881
758ef30008d4f4da430417f8d69285679444a562,0,Madhan Neethiraj,2020-08-16 12:34:37-07:00,['a07bde1024518126b4881b0e71f4fd30b8405edd'],44,300,344,1910008,18,0,0,1,3884
b937ab4b878149a9c8d8b4b3e1e85df0a19c532b,0,Madhan Neethiraj,2020-08-18 01:02:38-07:00,['758ef30008d4f4da430417f8d69285679444a562'],0,37,37,1910045,2,,,,3884
1066351cb9813b3e8542467c0ec543835c47aaa9,0,Madhan Neethiraj,2020-08-18 10:09:12-07:00,['b937ab4b878149a9c8d8b4b3e1e85df0a19c532b'],93,15,108,1910153,4,,,,3884
2f7c08838339de37e98b4d3a663cae08f2a9710c,0,Madhan Neethiraj,2020-08-18 12:21:31-07:00,['1066351cb9813b3e8542467c0ec543835c47aaa9'],36,40,76,1910229,3,,,,3884
a19b445f6f8d66b99e41cc458312c6afbc1debe1,0,Madhan Neethiraj,2020-08-21 15:54:58-07:00,['2f7c08838339de37e98b4d3a663cae08f2a9710c'],0,183,183,1910412,6,,,,3890
d65628827bbaeb6b32c1bb52e93532ead56b7878,0,Selvamohan Neethiraj,2020-08-23 22:09:00-04:00,['a19b445f6f8d66b99e41cc458312c6afbc1debe1'],56,1578,1634,1912046,14,,,,3898
ac82c04977e4af5503dbe2e19cdfd2b112c3df82,0,Madhan Neethiraj,2020-08-24 20:05:37-07:00,['d65628827bbaeb6b32c1bb52e93532ead56b7878'],0,1,1,1912047,1,,,,3898
95dfaf80c3f7a67e827580f99934dcbef6f06dc4,1,Madhan Neethiraj,2020-08-25 16:44:07-07:00,['ac82c04977e4af5503dbe2e19cdfd2b112c3df82'],1,337,338,1912385,11,,,,3905
c0aa70bec2c2d0558137c14b59144783a3b914f3,0,Mehul Parikh,2020-08-27 11:51:59+05:18,['95dfaf80c3f7a67e827580f99934dcbef6f06dc4'],1,1,2,1912387,1,,,,3905
d6641cf085661c55dd868e7f92b6e51ab23706ad,0,Madhan Neethiraj,2020-08-27 08:23:17-07:00,['c0aa70bec2c2d0558137c14b59144783a3b914f3'],4,14,18,1912405,2,,,,3905
84c39cbfe3f014d89feabb27748ffe3618fa7d2c,0,Abhay Kulkarni,2020-08-27 13:01:28-07:00,['d6641cf085661c55dd868e7f92b6e51ab23706ad'],21,23,44,1912449,1,0,0,1,3905
f5bcb8232ef27cd5b3dfb3fc5a55a89787537347,1,Madhan Neethiraj,2020-08-27 15:02:08-07:00,['84c39cbfe3f014d89feabb27748ffe3618fa7d2c'],142,351,493,1912942,17,,,,3913
ac4e6639af5a549d6a9253272143a1dc295ff58c,1,Madhan Neethiraj,2020-08-27 15:19:29-07:00,['f5bcb8232ef27cd5b3dfb3fc5a55a89787537347'],3,107,110,1913052,11,,,,3915
21485cb4369de07a18eae411f342d38bb709899d,0,Selvamohan Neethiraj,2020-08-28 14:11:32-04:00,['ac4e6639af5a549d6a9253272143a1dc295ff58c'],10,20,30,1913082,1,,,,3915
6ad164124fc68b2541161f76cf87228e665432d1,1,Madhan Neethiraj,2020-08-28 12:55:00-07:00,['21485cb4369de07a18eae411f342d38bb709899d'],5,232,237,1913319,11,,,,3921
429338a3d6f1454e8215a1ed838b34020a3a3815,0,Madhan Neethiraj,2020-08-29 12:31:20-07:00,['6ad164124fc68b2541161f76cf87228e665432d1'],20,32,52,1913371,1,,,,3921
bda27055c1d7b2df1a2e70a7a9c035759420803b,1,Madhan Neethiraj,2020-08-29 13:53:45-07:00,['429338a3d6f1454e8215a1ed838b34020a3a3815'],1,7,8,1913379,1,0,0,1,3921
0c55a7b4b092a50cbbec6cbd966d174ee1b6886e,0,Madhan Neethiraj,2020-08-29 13:54:00-07:00,['bda27055c1d7b2df1a2e70a7a9c035759420803b'],23,0,23,1913402,23,,,,3921
f754f832fefb2d04053b37dc02024ea251d052cf,1,Madhan Neethiraj,2020-08-30 10:26:22-07:00,['0c55a7b4b092a50cbbec6cbd966d174ee1b6886e'],0,68,68,1913470,5,,,,3921
544dcea94e6c0b426ee9e2fddc349ffa88a96216,1,Sailaja Polavarapu,2020-08-31 11:29:23-07:00,['f754f832fefb2d04053b37dc02024ea251d052cf'],95,315,410,1913880,5,0.178807947,0.19205298,0.874172185,3922
bc22c4d704438df4552ad689b80850302182966a,0,Sailaja Polavarapu,2020-08-31 15:04:13-07:00,['544dcea94e6c0b426ee9e2fddc349ffa88a96216'],3,0,3,1913883,1,,,,3922
51ba30f9e6744139b491e8cd6c22cbf85b3ba31f,0,Mehul Parikh,2020-09-04 16:25:44+05:18,['bc22c4d704438df4552ad689b80850302182966a'],7,349,356,1914239,11,0.473404255,0.558510638,1,3923
184c8794d6468a1418a5ac47a9ef536fd627729d,1,Nitin Galave,2020-09-08 15:28:57+05:18,['51ba30f9e6744139b491e8cd6c22cbf85b3ba31f'],20019,17978,37997,1952236,144,0.38922007,0.478638847,0.960258321,3935
82edb5bd78e0ac2a22cc3fd5dbc399331e7d86a0,1,Sailaja Polavarapu,2020-09-08 11:12:50-07:00,['184c8794d6468a1418a5ac47a9ef536fd627729d'],68,370,438,1952674,12,0.359090909,0.309090909,1,3936
28860a911d9370f9626cac657a08c76509145f09,0,Sailaja Polavarapu,2020-09-08 15:31:12-07:00,['82edb5bd78e0ac2a22cc3fd5dbc399331e7d86a0'],3,5,8,1952682,1,,,,3936
1760b0473d06f069f6b53904f2d5bcfed0c09b71,0,Sailaja Polavarapu,2020-09-08 16:30:11-07:00,['28860a911d9370f9626cac657a08c76509145f09'],2,0,2,1952684,1,,,,3936
a048d5db4b5171544371b80263a75fefc4e5b20f,0,Nitin Galave,2020-09-09 14:39:26+05:18,['1760b0473d06f069f6b53904f2d5bcfed0c09b71'],0,2,2,1952686,2,0,0,0,3936
af56dcae6ac3703357d92747f1f39873c3da1cf6,0,Mehul Parikh,2020-09-09 20:14:22+05:18,['a048d5db4b5171544371b80263a75fefc4e5b20f'],0,12,12,1952698,1,,,,3936
ea89a883591c72397a306dc4a105acb2f0497830,1,Ramesh Mani,2020-09-09 11:47:32-07:00,['af56dcae6ac3703357d92747f1f39873c3da1cf6'],3,21,24,1952722,2,1,1,1,3936
ac9be113f48d5fe4de0a3cf5696b29370a601fe6,0,Madhan Neethiraj,2020-09-09 18:22:43-07:00,['ea89a883591c72397a306dc4a105acb2f0497830'],5,174,179,1952901,4,1,1,1,3937
e7c98ca832f37b0083f7b1bec2894a5a96d6643f,0,Mehul Parikh,2020-09-10 21:27:10+05:18,['ac9be113f48d5fe4de0a3cf5696b29370a601fe6'],0,16,16,1952917,2,0,0,1,3937
d99134e7faa30f4f69156045cf10bd1cfdfec38d,1,Sailaja Polavarapu,2020-09-15 13:23:42-07:00,['e7c98ca832f37b0083f7b1bec2894a5a96d6643f'],13,13,26,1952943,1,1,1,0,3937
4952d138070d02370af8314103972fccda7fab64,0,Nitin Galave,2020-09-16 15:23:15+05:18,['d99134e7faa30f4f69156045cf10bd1cfdfec38d'],3,70,73,1953016,5,0,0.039215686,1,3937
00f5de08592cc3dd00f2678899b9ac6e9f235d35,0,Nitin Galave,2020-09-16 15:23:37+05:18,['4952d138070d02370af8314103972fccda7fab64'],4,10,14,1953030,6,0,1,1,3937
73037420f39446d4166e9ad8996eb5b3807707e4,0,Nitin Galave,2020-09-16 20:34:34+05:18,['00f5de08592cc3dd00f2678899b9ac6e9f235d35'],5,14,19,1953049,2,0,0,1,3937
58a9e67aac3e7d4957e02c5c8daa7fc6dc2b40bd,0,Madhan Neethiraj,2020-09-18 06:29:43-07:00,['73037420f39446d4166e9ad8996eb5b3807707e4'],6,11,17,1953066,1,0,0,1,3937
54415ede5feb0da4903f71a8e47461c6217f532e,0,Mehul Parikh,2020-09-18 19:15:47+05:18,['58a9e67aac3e7d4957e02c5c8daa7fc6dc2b40bd'],3,10,13,1953079,2,1,1,1,3937
ad56ab88984ab03ce36248dd87482a70b8ed74a4,1,Abhay Kulkarni,2020-09-18 14:40:49-07:00,['54415ede5feb0da4903f71a8e47461c6217f532e'],4,2631,2635,1955714,24,0.654218534,0.83264177,0.930843707,3950
3f8df5d9bced7641e29f1469a52b5e8ab686e5d4,0,Mehul Parikh,2020-09-21 17:50:18+05:18,['ad56ab88984ab03ce36248dd87482a70b8ed74a4'],36,91,127,1955841,3,0.333333333,0.666666667,0.333333333,3951
9d3c1eb1b5f0d7c7b73dc0a870df214dc055fad7,0,Sailaja Polavarapu,2020-09-22 10:10:51-07:00,['3f8df5d9bced7641e29f1469a52b5e8ab686e5d4'],1,1,2,1955843,1,,,,3951
634833b79fdb7c5f7bb036c6e06cc3afcb743414,0,Abhay Kulkarni,2020-09-23 16:29:25-07:00,['9d3c1eb1b5f0d7c7b73dc0a870df214dc055fad7'],1,1,2,1955845,1,,,,3951
b444fd9928fd6a7178214ce592b0f10aaf8936ad,0,Madhan Neethiraj,2020-09-28 09:06:12-07:00,['634833b79fdb7c5f7bb036c6e06cc3afcb743414'],48,138,186,1956031,16,,,,3953
71e1dd40366c8eb8e9c498b0b5158d85d603af02,0,Ramesh Mani,2020-09-29 17:22:25-07:00,['b444fd9928fd6a7178214ce592b0f10aaf8936ad'],5,5,10,1956041,1,,,,3953
e47acfa28948a5ce41aef8cd448669a2e7f5b70d,0,Bhavik Himmatbhai Patel,2020-10-01 12:20:38+05:18,['71e1dd40366c8eb8e9c498b0b5158d85d603af02'],2,2,4,1956045,1,,,,3953
9e8c376ff36b279f807ce25c70fd005fc18fdbf3,0,Bhavik Himmatbhai Patel,2020-10-01 12:23:40+05:18,['e47acfa28948a5ce41aef8cd448669a2e7f5b70d'],2,2,4,1956049,1,,,,3953
168f128c29868b93cd8a5c3a3374e48eb40e2cc8,0,Bhavik Himmatbhai Patel,2020-10-01 12:24:17+05:18,['9e8c376ff36b279f807ce25c70fd005fc18fdbf3'],0,7,7,1956056,1,0,0,1,3953
e533963e3f1b7cb7c45241ef02eece15a9ba118c,0,Bhavik Himmatbhai Patel,2020-10-01 12:25:32+05:18,['168f128c29868b93cd8a5c3a3374e48eb40e2cc8'],0,6,6,1956062,1,,,,3953
4763786a4801936f4f651d7fd911907f3b788cd4,0,Mehul Parikh,2020-10-01 15:24:13+05:18,['e533963e3f1b7cb7c45241ef02eece15a9ba118c'],42,60,102,1956164,1,0,0,1,3953
370cb670139a059ac53e6f0b1f18d7ca625650d7,0,Mehul Parikh,2020-10-01 15:32:59+05:18,['4763786a4801936f4f651d7fd911907f3b788cd4'],2,3,5,1956169,1,1,1,1,3953
166dfb6c478faba275766e5e2566031231a7decb,0,Mehul Parikh,2020-10-05 22:44:15+05:18,['370cb670139a059ac53e6f0b1f18d7ca625650d7'],295,1,296,1956465,4,0.788381743,0.676348548,0,3953
664b368c619a36b63926d9c653cfe640983fcff5,1,Ramesh Mani,2020-10-05 23:19:14-07:00,['166dfb6c478faba275766e5e2566031231a7decb'],1,1,2,1956467,1,,,,3953
25169a4eba018025e488cc272003bc3852dda835,0,Abhay Kulkarni,2020-10-06 10:42:41-07:00,['664b368c619a36b63926d9c653cfe640983fcff5'],26,70,96,1956563,1,0.172413793,0,1,3953
4610df1fd126a07f1e19c5bed53e50742bb9f428,1,Sailaja Polavarapu,2020-10-08 17:25:31-07:00,['25169a4eba018025e488cc272003bc3852dda835'],5337,2386,7723,1964286,44,0.880139983,0.755468066,0.08223972,3956
9dd45541bd4da086125b5096919705200559b801,0,Mehul Parikh,2020-10-09 18:21:00+05:18,['4610df1fd126a07f1e19c5bed53e50742bb9f428'],3,3,6,1964292,1,,,,3956
2ea3a87980dd3c1ed4be24787e1366a754741e3c,0,Abhay Kulkarni,2020-10-12 07:06:28-07:00,['9dd45541bd4da086125b5096919705200559b801'],5,4,9,1964301,1,,0,,3956
1d8ff1603674b967a4372e8963136945432e98f5,0,Ramesh Mani,2020-10-12 09:17:34-07:00,['2ea3a87980dd3c1ed4be24787e1366a754741e3c'],39,147,186,1964487,2,0.3,0.0875,1,3956
94dea0aa6497d21c49f3d89aebdf0ed562f66ba9,0,Nitin Galave,2020-10-13 18:45:45+05:18,['1d8ff1603674b967a4372e8963136945432e98f5'],2,12,14,1964501,1,,,,3956
ac24d33f9786b65a3340b97bfc8f2deeb4cd7ab4,0,Abhay Kulkarni,2020-10-13 21:29:11-07:00,['94dea0aa6497d21c49f3d89aebdf0ed562f66ba9'],23,35,58,1964559,4,1,0,0,3956
ac822ee187d1885bc33065dae2b183b8d20f6ac2,0,Sailaja Polavarapu,2020-10-14 07:21:05-07:00,['ac24d33f9786b65a3340b97bfc8f2deeb4cd7ab4'],7,14,21,1964580,2,0,0,0,3956
176577f436a029224e82038283036530f52cf4db,1,Nitin Galave,2020-10-20 11:18:45+05:18,['ac822ee187d1885bc33065dae2b183b8d20f6ac2'],3042,5665,8707,1973287,11,0.610576923,0.59375,0.572115385,3956
e2c15ed30ee35bfeea33dc1af1b8c29fbfbcb7b0,0,Nitin Galave,2020-10-20 11:19:26+05:18,['176577f436a029224e82038283036530f52cf4db'],33,6,39,1973326,3,0.8,0.8,0.8,3956
136ace27c67fded9934803151d94c0bedf44a391,1,Madhan Neethiraj,2020-10-19 23:35:13-07:00,['e2c15ed30ee35bfeea33dc1af1b8c29fbfbcb7b0'],217,225,442,1973768,19,1,1,0,3956
4c2540e765b1682bdcf839aafa3ff318b47762ee,1,Madhan Neethiraj,2020-10-19 23:35:17-07:00,['136ace27c67fded9934803151d94c0bedf44a391'],14,182,196,1973964,5,0.285714286,0.887218045,0.578947368,3956
1b6055993f2f59cf557964a99da9d3e0e98c10e1,0,Madhan Neethiraj,2020-10-20 00:35:37-07:00,['4c2540e765b1682bdcf839aafa3ff318b47762ee'],15,112,127,1974091,12,,,,3958
72a3f9442ef7084323036c0682d5ff65b981d65e,0,Nitin Galave,2020-10-26 18:38:28+05:18,['1b6055993f2f59cf557964a99da9d3e0e98c10e1'],18,227,245,1974336,10,0.240506329,0.632911392,0.892405063,3958
cddb43501f0c2b1dd1a1fc776e823aac4f0b12d8,0,Mehul Parikh,2020-10-27 12:55:20+05:18,['72a3f9442ef7084323036c0682d5ff65b981d65e'],1,26,27,1974363,4,0.666666667,0.888888889,1,3958
e394f970864636a66e984e3efc56e2c1a6e1d547,0,Mehul Parikh,2020-10-27 12:55:30+05:18,['cddb43501f0c2b1dd1a1fc776e823aac4f0b12d8'],13,20,33,1974396,4,0,0,1,3958
081a5c288faa713718cff784702a33a82637edab,0,Mehul Parikh,2020-10-27 13:20:13+05:18,['e394f970864636a66e984e3efc56e2c1a6e1d547'],1,0,1,1974397,1,,,,3958
cb392acc2e62cf6c5e0ba3a8c0215096c3facfda,0,Madhan Neethiraj,2020-10-30 14:21:31-07:00,['081a5c288faa713718cff784702a33a82637edab'],14,17,31,1974428,15,,,,3958
ceffbc5ad6b42a842194a17f21ed7125dea8ab4c,1,Mehul Parikh,2020-11-02 10:30:31+05:18,['cb392acc2e62cf6c5e0ba3a8c0215096c3facfda'],4,13,17,1974445,1,0,0.666666667,1,3958
6a1a4588d2d2f27484c7b42ddd96876c276f2fd1,0,Mehul Parikh,2020-11-02 12:14:25+05:18,['ceffbc5ad6b42a842194a17f21ed7125dea8ab4c'],76,38,114,1974559,1,0.46875,0.46875,0,3958
38f5bc931ad465a4c5539a330860da45b31bdf15,1,Sailaja Polavarapu,2020-11-02 17:21:57-08:00,['6a1a4588d2d2f27484c7b42ddd96876c276f2fd1'],36,57,93,1974652,1,0,0,1,3958
34a948c34ab135e75edba1a48f56fdeca2ad3c74,1,Mehul Parikh,2020-11-10 11:12:56+05:18,['38f5bc931ad465a4c5539a330860da45b31bdf15'],0,212,212,1974864,10,,,,3963
e119ae0d24ea21627ef19978efaee349f471bc3b,1,Nitin Galave,2020-11-10 16:03:50+05:18,['34a948c34ab135e75edba1a48f56fdeca2ad3c74'],1,1,2,1974866,1,,,,3963
587353f13f7626f5e0fd90ec89982bc4dbda86a4,0,Nitin Galave,2020-11-10 16:03:57+05:18,['e119ae0d24ea21627ef19978efaee349f471bc3b'],6,48,54,1974920,2,1,1,1,3963
8d3ef6f8c9bf017f90d8edf52648ce2b04d0cbe6,1,Mehul Parikh,2020-11-10 19:37:01+05:18,['587353f13f7626f5e0fd90ec89982bc4dbda86a4'],20,196,216,1975136,2,,,,3964
63a125c0f4bccc88e5dc4e58759c18880aefb3c1,0,Mehul Parikh,2020-11-11 12:21:49+05:18,['8d3ef6f8c9bf017f90d8edf52648ce2b04d0cbe6'],1,172,173,1975309,7,0.402298851,0.586206897,1,3965
208b6df0d42d63eb5834c889afb092b7a69146a4,1,Abhay Kulkarni,2020-11-12 10:33:28-08:00,['63a125c0f4bccc88e5dc4e58759c18880aefb3c1'],29,156,185,1975494,4,0,0.333333333,0.824074074,3965
298f362f640fd98aba38b693bb7d8a786074af22,0,Abhay Kulkarni,2020-11-12 16:55:11-08:00,['208b6df0d42d63eb5834c889afb092b7a69146a4'],25,103,128,1975622,3,0.65,0.975,0.775,3966
2f916b1ba99cebbd139a228e5f91707e477df617,0,Madhan Neethiraj,2020-11-12 22:23:53-08:00,['298f362f640fd98aba38b693bb7d8a786074af22'],13,13,26,1975648,6,,,,3966
6e8873b03b8dad9e498af69e1cff73ea1889cda6,0,Sailaja Polavarapu,2020-11-13 17:19:15-08:00,['2f916b1ba99cebbd139a228e5f91707e477df617'],18,99,117,1975765,1,0.192307692,0.192307692,0.192307692,3966
ce4de4e7e34f95f6a6df02bc1e9873fd1d423101,0,pradeep,2020-11-15 13:43:21+05:18,['6e8873b03b8dad9e498af69e1cff73ea1889cda6'],2,5,7,1975772,1,0,1,0,3966
7849c658f7b5ca71d43ed3299fb36992c48b4b2c,0,pradeep,2020-11-15 13:43:22+05:18,['ce4de4e7e34f95f6a6df02bc1e9873fd1d423101'],0,100,100,1975872,3,0,0,1,3966
44f633b3de5c68c60a0710327787cc806e48bc8f,0,pradeep,2020-11-15 13:43:22+05:18,['7849c658f7b5ca71d43ed3299fb36992c48b4b2c'],2,2,4,1975876,1,,,,3966
6fc3878171618a16d0d8a12ea10714bf8317a9ae,1,Abhay Kulkarni,2020-11-20 09:51:46-08:00,['44f633b3de5c68c60a0710327787cc806e48bc8f'],3,59,62,1975938,3,0,0,0,3966
7cfc706c3ec53a1d07ce76d079ffb50dbcde0bae,1,pradeep,2020-11-21 16:10:51+05:18,['6fc3878171618a16d0d8a12ea10714bf8317a9ae'],0,19,19,1975957,3,0.666666667,1,1,3966
3a21d6a30232ee44d375a2fad5764798afb74f7e,1,Velmurugan Periasamy,2020-11-23 17:40:22-05:00,['7cfc706c3ec53a1d07ce76d079ffb50dbcde0bae'],67,233,300,1976257,10,0,0.136363636,0.818181818,3966
7f2aca8eb5c30997436d099abd12aaa9aa156bf9,0,Velmurugan Periasamy,2020-11-25 10:34:12-05:00,['3a21d6a30232ee44d375a2fad5764798afb74f7e'],0,10,10,1976267,1,0,0,1,3966
3b543a7549017059e0f49beaa74e2503088128ef,0,Abhay Kulkarni,2020-11-25 09:19:54-08:00,['7f2aca8eb5c30997436d099abd12aaa9aa156bf9'],3,14,17,1976284,3,0.857142857,0.857142857,1,3966
6b5d5fb3469df532df4528e1c4cd8cb503f44eba,1,Abhay Kulkarni,2020-11-25 22:43:10-08:00,['3b543a7549017059e0f49beaa74e2503088128ef'],14,106,120,1976404,6,0.152542373,0.152542373,0.762711864,3966
2030167bfbf4e7241d199fdd353437f5c312d9db,0,Ramesh Mani,2020-11-30 16:32:57-08:00,['6b5d5fb3469df532df4528e1c4cd8cb503f44eba'],1,2,3,1976407,1,0,0,0,3966
3ab1c796312376b738c9b85fb98351c40888cab0,0,Abhay Kulkarni,2020-11-30 20:47:00-08:00,['2030167bfbf4e7241d199fdd353437f5c312d9db'],3,113,116,1976523,5,,,,3967
b8f76a8be532e3d41cca5acfb7cfbe6c35e469f1,1,Ramesh Mani,2020-12-01 08:33:02-08:00,['3ab1c796312376b738c9b85fb98351c40888cab0'],24,1226,1250,1977773,17,0.391136802,0.33911368,0.766859345,3971
7d821605e7f3ac2916970a8a75c67ec649135813,0,Velmurugan Periasamy,2020-12-01 19:56:14-05:00,['b8f76a8be532e3d41cca5acfb7cfbe6c35e469f1'],10,16,26,1977799,4,,,,3971
2f4277eb15f86b82718d05989de5545687c33539,0,Sailaja Polavarapu,2020-12-01 17:48:33-08:00,['7d821605e7f3ac2916970a8a75c67ec649135813'],3,141,144,1977943,7,0.652777778,0.902777778,1,3972
6f9edf94fd38596b8a5a8e86357727b144f05ba9,0,Ramesh Mani,2020-12-02 08:32:44-08:00,['2f4277eb15f86b82718d05989de5545687c33539'],1,1,2,1977945,1,,,,3972
cb702d6cc24e7eff633e9de37acbcbaad48ee5fc,1,Ramesh Mani,2020-12-02 10:26:40-08:00,['6f9edf94fd38596b8a5a8e86357727b144f05ba9'],39,63,102,1978047,10,0,1,1,3972
c23b7961678ace771de70c3458acf7d6530a856c,0,Abhay Kulkarni,2020-12-02 16:42:42-08:00,['cb702d6cc24e7eff633e9de37acbcbaad48ee5fc'],27,38,65,1978112,3,0,0,0.454545455,3972
4542ec6d613f6e27dedde34b83b0c6f9d157c9e1,0,Mehul Parikh,2020-12-03 11:18:28+05:18,['c23b7961678ace771de70c3458acf7d6530a856c'],117,212,329,1978441,9,,,,3972
bebbd6ba7a2cadbaf306e6c8c2d678cb942c1176,0,Madhan Neethiraj,2020-12-03 14:31:45-08:00,['4542ec6d613f6e27dedde34b83b0c6f9d157c9e1'],79,122,201,1978642,2,0,0.571428571,0.142857143,3972
789ce7dacb7c0d7899549dbd8082430f1d4bd4d8,0,Madhan Neethiraj,2020-12-04 00:20:19-08:00,['bebbd6ba7a2cadbaf306e6c8c2d678cb942c1176'],0,47,47,1978689,1,,,,3972
7b82a847134251dcdfdfbcafadd509ba9e926915,0,Madhan Neethiraj,2020-12-04 00:52:09-08:00,['789ce7dacb7c0d7899549dbd8082430f1d4bd4d8'],5,5,10,1978699,2,,,,3972
cbd4cdbb2567e86da7ecd89c0d55b088b107e559,1,pradeep,2020-12-04 20:43:33+05:18,['7b82a847134251dcdfdfbcafadd509ba9e926915'],10,29,39,1978738,4,0,0,1,3972
9146836b281fc7342250f57b40f612060afadb52,0,pradeep,2020-12-04 20:46:23+05:18,['cbd4cdbb2567e86da7ecd89c0d55b088b107e559'],13,21,34,1978772,3,1,1,1,3972
4195eab099682024827fd88f4d2d3a93ce1f250d,1,pradeep,2020-12-04 20:51:41+05:18,['9146836b281fc7342250f57b40f612060afadb52'],0,48,48,1978820,1,0,0,1,3972
67ef8f2205a7f9457b1b76ca891b1b679c1245a2,1,Ramesh Mani,2020-12-05 10:20:15-08:00,['4195eab099682024827fd88f4d2d3a93ce1f250d'],73,96,169,1978989,1,0.65,0.85,1,3972
81b82d839b8ea4867d68785cc4b82d3d27de669d,0,Abhay Kulkarni,2020-12-07 09:34:52-08:00,['67ef8f2205a7f9457b1b76ca891b1b679c1245a2'],12,106,118,1979107,4,0.444444444,0.444444444,1,3973
eb7aacfb1922c2d2c02a169f10da8a85b9a00240,1,Mehul Parikh,2020-12-08 20:00:02+05:18,['81b82d839b8ea4867d68785cc4b82d3d27de669d'],206,601,807,1979914,27,0.24567474,0.442906574,0.446366782,3974
92890a199d2957e0849cab4b099847dc90958bba,0,Abhay Kulkarni,2020-12-08 10:40:24-08:00,['eb7aacfb1922c2d2c02a169f10da8a85b9a00240'],188,324,512,1980426,8,0.208695652,0.217391304,0.956521739,3974
bb4c84f97367d79370508635ae4c23abda6cc3a0,0,Ramesh Mani,2020-12-08 20:55:33-08:00,['92890a199d2957e0849cab4b099847dc90958bba'],5,7,12,1980438,1,0,0,1,3974
877c3d9b60586cf658bceb2916b73246a2a72ddf,0,Mehul Parikh,2020-12-09 13:08:22+05:18,['bb4c84f97367d79370508635ae4c23abda6cc3a0'],96,300,396,1980834,5,0.572916667,0.572916667,0.864583333,3975
8ca158adcc00d0ef4a5bcba82ec9af9a8737c280,1,Mehul Parikh,2020-12-14 11:07:25+05:18,['877c3d9b60586cf658bceb2916b73246a2a72ddf'],100,1317,1417,1982251,11,0.576402321,0.727272727,0.909090909,3977
fa3e3d6e1753eff062d73ba3eca57f71435e8bea,1,Madhan Neethiraj,2020-12-14 10:40:01-08:00,['8ca158adcc00d0ef4a5bcba82ec9af9a8737c280'],725,1162,1887,1984138,14,1,1,1,3979
71bdeacdfaef9f727ef52e2638d7ab339833a00c,0,Sailaja Polavarapu,2020-12-14 17:50:35-08:00,['fa3e3d6e1753eff062d73ba3eca57f71435e8bea'],2,2,4,1984142,1,,,,3979
29228c1618e872097c58c8da8b13d0718862be29,1,Ramesh Mani,2020-12-15 20:24:41-08:00,['71bdeacdfaef9f727ef52e2638d7ab339833a00c'],32,49,81,1984223,1,1,0.75,0,3979
07827e39dc483bb2e6668e426cbf94ffe1a1fb8c,1,Sailaja Polavarapu,2020-12-16 16:29:18-08:00,['29228c1618e872097c58c8da8b13d0718862be29'],15,41,56,1984279,3,0,0,0.25,3979
8d3a4592b5183d7bf767233045083d7212ade570,0,pradeep,2020-12-19 19:28:28+05:18,['07827e39dc483bb2e6668e426cbf94ffe1a1fb8c'],8,48,56,1984335,5,,,,3979
e4a6203cb0c0c877c4dc25d6c3ee042d5c4645f6,0,Madhan Neethiraj,2020-12-19 11:25:10-08:00,['8d3a4592b5183d7bf767233045083d7212ade570'],32,128,160,1984495,8,0.375,1,1,3979
e93af53f9a097170e3e027c44258f8ffe919d28b,1,Mehul Parikh,2020-12-23 09:24:29+05:18,['e4a6203cb0c0c877c4dc25d6c3ee042d5c4645f6'],4,4,8,1984503,1,,,,3979
934096e8ba17f0fe3730042200f7c702feb244dc,0,Mehul Parikh,2020-12-23 09:25:38+05:18,['e93af53f9a097170e3e027c44258f8ffe919d28b'],1,1,2,1984505,1,,,,3979
9d459e0255484277d802b5d8e9fcdd936f3aed04,1,Abhay Kulkarni,2020-12-23 12:06:56-08:00,['934096e8ba17f0fe3730042200f7c702feb244dc'],75,195,270,1984775,8,0,0,0.639175258,3979
f00a4f05d6f8aac276cbceaf914d3e0813e4936c,0,Madhan Neethiraj,2020-12-23 14:21:20-08:00,['9d459e0255484277d802b5d8e9fcdd936f3aed04'],20,24,44,1984819,3,1,1,1,3979
3abe3fe061ca56a43886e5b8cb3655959acc0903,0,Abhay Kulkarni,2020-12-24 07:16:32-08:00,['f00a4f05d6f8aac276cbceaf914d3e0813e4936c'],21,14,35,1984854,1,,,,3979
f13d2081dddba0eb76b999f84ef1006c3f1ef04b,1,Ramesh Mani,2020-12-30 23:24:11-08:00,['3abe3fe061ca56a43886e5b8cb3655959acc0903'],68,668,736,1985590,8,0.478070175,0.736842105,0.956140351,3983
5797bb9541c1bfa84fbfd9bd19dbd635c4928b6f,0,pradeep,2021-01-02 17:12:15+05:18,['f13d2081dddba0eb76b999f84ef1006c3f1ef04b'],8,12,20,1985610,1,0,0,0,3983
bd1cf093b7a03431e3bbddf36dd2a565c32dcd40,0,pradeep,2021-01-02 17:20:17+05:18,['5797bb9541c1bfa84fbfd9bd19dbd635c4928b6f'],1,2,3,1985613,1,0,0,0,3983
6fcab6993e8beb94c80514dd44f53d9d5e63db8c,0,pradeep,2021-01-02 17:23:15+05:18,['bd1cf093b7a03431e3bbddf36dd2a565c32dcd40'],1,4,5,1985618,1,0,0,1,3983
6e2d66a856b33ae70c078875645f38b0cac54114,0,Bhavik Himmatbhai Patel,2021-01-05 10:52:26+05:18,['6fcab6993e8beb94c80514dd44f53d9d5e63db8c'],49,181,230,1985848,4,,,,3983
ae6f6b4cf7c63b4049c38b05cbcb428b5a2a5b4b,0,Bhavik Himmatbhai Patel,2021-01-05 11:00:01+05:18,['6e2d66a856b33ae70c078875645f38b0cac54114'],3,3,6,1985854,1,,,,3983
391877b92e385a0f815798e4fb57cbaf8a93c22b,0,Ramesh Mani,2021-01-05 08:21:05-08:00,['ae6f6b4cf7c63b4049c38b05cbcb428b5a2a5b4b'],2,52,54,1985908,4,0.552631579,0.973684211,1,3983
fcda16ee7ce14abdf2fc16a83c3f64cb591f3401,0,Nitin Galave,2021-01-06 18:53:11+05:18,['391877b92e385a0f815798e4fb57cbaf8a93c22b'],0,9,9,1985917,1,,,,3983
4deb34cb8e189eaa466eec49066338339ed2f88c,1,Abhay Kulkarni,2021-01-06 15:43:22-08:00,['fcda16ee7ce14abdf2fc16a83c3f64cb591f3401'],29,58,87,1986004,1,0,0,0.703703704,3983
cb621c3a07e7f9ec3013fb4b830e356e58051b34,1,Sailaja Polavarapu,2021-01-08 09:47:49-08:00,['4deb34cb8e189eaa466eec49066338339ed2f88c'],194,726,920,1986924,12,0.264563107,0.216019417,0.881067961,3984
d11233ad41311d6fec9e66c4ee91984d7cc216a6,0,Abhay Kulkarni,2021-01-08 12:47:29-08:00,['cb621c3a07e7f9ec3013fb4b830e356e58051b34'],4,5,9,1986933,2,1,0,0,3984
4e3b74da48dd3c586a22b93c91101de288e3bce1,0,Abhay Kulkarni,2021-01-08 16:40:06-08:00,['d11233ad41311d6fec9e66c4ee91984d7cc216a6'],4,0,4,1986937,1,1,0,0,3984
08b09151a5115cdaac9019690a839f7a67330a9b,0,Madhan Neethiraj,2021-01-08 20:25:30-08:00,['4e3b74da48dd3c586a22b93c91101de288e3bce1'],13,64,77,1987014,7,0.976744186,0.976744186,1,3984
d1c39e3c654db3e976f2d2b8f150c014f43da1db,0,Madhan Neethiraj,2021-01-08 23:18:09-08:00,['08b09151a5115cdaac9019690a839f7a67330a9b'],0,1,1,1987015,1,,,,3984
29095b36a9dda4e83ad12cbe8a76e8485ac32d02,1,Abhay Kulkarni,2021-01-11 09:20:52-08:00,['d1c39e3c654db3e976f2d2b8f150c014f43da1db'],207,782,989,1988004,13,0.451612903,0.459677419,0.798387097,3986
24e343d54997a02ef5d232e4b3808a0aa17c559c,0,Nitin Galave,2021-01-18 19:01:20+05:18,['29095b36a9dda4e83ad12cbe8a76e8485ac32d02'],18,54,72,1988076,1,,,,3986
32da93caa79494567043a6ef1eda38e9c50da355,0,Ramesh Mani,2021-01-20 20:52:04-08:00,['24e343d54997a02ef5d232e4b3808a0aa17c559c'],23,477,500,1988576,19,,,,3987
4ff1c7ea9984812ec2ea02910ff8bb9eb9003f9a,1,Ramesh Mani,2021-01-20 21:04:07-08:00,['32da93caa79494567043a6ef1eda38e9c50da355'],477,23,500,1989076,19,,,,3987
4b9ab8a509f2e0d9e8e7dd210505fa7f342c2b44,0,Ramesh Mani,2021-01-20 21:55:12-08:00,['4ff1c7ea9984812ec2ea02910ff8bb9eb9003f9a'],23,74,97,1989173,18,,,,3987
e9b724b05e395587c0fcd67ce576fe3a0bc54b80,1,Abhay Kulkarni,2021-01-23 13:28:42-08:00,['4b9ab8a509f2e0d9e8e7dd210505fa7f342c2b44'],23,1244,1267,1990440,6,0.114197531,0.296296296,0.617283951,3989
1edd0665486da44531fbb2e32cb748476f5731e8,0,Ramesh Mani,2021-01-26 10:35:14-08:00,['e9b724b05e395587c0fcd67ce576fe3a0bc54b80'],4,53,57,1990497,1,0.225,0.225,0.225,3989
47cfd468570600723543923336ab3690275ab1c3,1,Abhay Kulkarni,2021-01-28 08:21:24-08:00,['1edd0665486da44531fbb2e32cb748476f5731e8'],1,150,151,1990648,6,0.417721519,0.670886076,1,3990
5df512439c85199abacb84675b91d0b704fb61f0,0,Sailaja Polavarapu,2021-01-28 13:05:28-08:00,['47cfd468570600723543923336ab3690275ab1c3'],9,9,18,1990666,5,,,,3990
56fb23aa39c828084fea85db2b25a4408a94bbf1,0,Velmurugan Periasamy,2021-02-04 10:24:45-05:00,['5df512439c85199abacb84675b91d0b704fb61f0'],2,2,4,1990670,1,,,,3990
c7694deaab53fd0563193cfb8935213258352447,0,Velmurugan Periasamy,2021-02-04 10:24:56-05:00,['56fb23aa39c828084fea85db2b25a4408a94bbf1'],15,5,20,1990690,4,,,,3990
a37e5da68d0724056147542dc29bf7909dca5460,0,Velmurugan Periasamy,2021-02-04 10:25:08-05:00,['c7694deaab53fd0563193cfb8935213258352447'],89,118,207,1990897,1,0,0,1,3990
c1cb497fab4b00b8c834ba0d3995ae6567ff2406,0,Velmurugan Periasamy,2021-02-05 13:39:19-05:00,['a37e5da68d0724056147542dc29bf7909dca5460'],3,0,3,1990900,1,,,,3990
f2e280c7ab7d86e9a2180914d3a5ffb2119fbdcd,0,Sailaja Polavarapu,2021-02-08 17:18:51-08:00,['c1cb497fab4b00b8c834ba0d3995ae6567ff2406'],2,2,4,1990904,1,,,,3990
daafdf75655d0800ed7cea8fbb3f374c253f6253,1,Sailaja Polavarapu,2021-02-10 16:00:59-08:00,['f2e280c7ab7d86e9a2180914d3a5ffb2119fbdcd'],3,79,82,1990986,2,0.042857143,0.042857143,1,3990
aab05b32612b1d74d7193f30d88465eda4dcaec9,0,Sailaja Polavarapu,2021-02-10 16:48:32-08:00,['daafdf75655d0800ed7cea8fbb3f374c253f6253'],1,1,2,1990988,1,,,,3990
30d253ad777b6df9bfdeef1f61f14ecdf6977918,0,Abhay Kulkarni,2021-02-12 19:44:25-08:00,['aab05b32612b1d74d7193f30d88465eda4dcaec9'],30,51,81,1991069,3,0,0,0,3990
6a61a4d81d95da58c14a8c38821645567bbb44d7,0,Velmurugan Periasamy,2021-02-13 18:25:04-05:00,['30d253ad777b6df9bfdeef1f61f14ecdf6977918'],3,8,11,1991080,2,0,0,1,3990
1d2caab522a62728d1975fcde4b7af0b0afcdb5f,0,Abhay Kulkarni,2021-02-17 10:28:29-08:00,['6a61a4d81d95da58c14a8c38821645567bbb44d7'],43,100,143,1991223,5,0.5,0.5,1,3990
a4d3b725952f9db0b55b5e832b799c5e88213229,1,Nitin Galave,2021-02-22 15:59:17+05:18,['1d2caab522a62728d1975fcde4b7af0b0afcdb5f'],4,672,676,1991899,19,0.359580052,0.923884514,0.755905512,3991
d256fe77dad4c36f4ed0ddcd4a80c0d390098566,1,Sailaja Polavarapu,2021-02-23 11:23:51-08:00,['a4d3b725952f9db0b55b5e832b799c5e88213229'],318,426,744,1992643,3,0,0,1,3991
cbe28e250fbb0ef578a76ba3ebd0e6efb92f3366,0,Ramesh Mani,2021-02-23 13:27:54-08:00,['d256fe77dad4c36f4ed0ddcd4a80c0d390098566'],4,7,11,1992654,1,0,1,1,3991
10c8555055579b34f18088a26949eb1254c0e914,0,Velmurugan Periasamy,2021-02-24 11:09:13-05:00,['cbe28e250fbb0ef578a76ba3ebd0e6efb92f3366'],0,5,5,1992659,2,0,0,0,3991
e6cbe84a2864bdf4a1e7d3f34a4cf824f0e3d6c0,0,Ramesh Mani,2021-02-24 08:39:24-08:00,['10c8555055579b34f18088a26949eb1254c0e914'],0,1,1,1992660,1,,,,3991
a0caeaf6c8c41d6a1f71671b517397771aec4cad,0,Dhaval Shah,2021-02-25 19:08:51+05:18,['e6cbe84a2864bdf4a1e7d3f34a4cf824f0e3d6c0'],0,12,12,1992672,1,,,,3991
97847b62c3a906414c7f89c23f41c78ceb8f6994,0,Sailaja Polavarapu,2021-02-25 17:20:43-08:00,['a0caeaf6c8c41d6a1f71671b517397771aec4cad'],1,5,6,1992678,1,,,,3991
09e8caca7203b6275f25c45bc8546deeb96cd79c,0,Madhan Neethiraj,2021-02-26 17:57:17-08:00,['97847b62c3a906414c7f89c23f41c78ceb8f6994'],2882,12,2894,1995572,67,0.432648402,0.212328767,0.058219178,3991
b69c2df7625696b3d38cf1cfbbcf1db4d634c7b0,1,Abhay Kulkarni,2021-02-27 07:08:47-08:00,['09e8caca7203b6275f25c45bc8546deeb96cd79c'],485,1044,1529,1997101,14,0.50245098,0.75,0.823529412,3992
2595bc32f9494c6ef364ec27f450e2721424bd64,1,Madhan Neethiraj,2021-02-28 18:36:28-08:00,['b69c2df7625696b3d38cf1cfbbcf1db4d634c7b0'],36,414,450,1997551,23,,,,4000
6c5336da05ba64cd993005077034c872b73416a3,0,Mehul Parikh,2021-03-08 09:35:18+05:18,['2595bc32f9494c6ef364ec27f450e2721424bd64'],170,1126,1296,1998847,7,0.377990431,0.43062201,0.976076555,4005
ea68a309da500c8ada275915947de236a8334b83,1,Mehul Parikh,2021-03-09 14:04:21+05:18,['6c5336da05ba64cd993005077034c872b73416a3'],1,1,2,1998849,1,,,,4005
dd965e9b47da4be52b0c1e287fd9b05e03c9df17,0,Nitin Galave,2021-03-10 20:38:05+05:18,['ea68a309da500c8ada275915947de236a8334b83'],3,11,14,1998863,3,,,,4005
6e4f6e2725e60180bf92526b32988e39c2a3e5de,0,Dhaval Shah,2021-03-12 17:32:11+05:18,['dd965e9b47da4be52b0c1e287fd9b05e03c9df17'],0,6,6,1998869,2,,,,4005
4a6b9d19870bd3a272fa86d005899530f7cdf739,0,Abhay Kulkarni,2021-03-12 19:03:54-08:00,['6e4f6e2725e60180bf92526b32988e39c2a3e5de'],9,15,24,1998893,1,,,,4005
5c8db0ff6c760e0e27ce89d4e55820c13c4b362a,1,Madhan Neethiraj,2021-03-13 09:07:54-08:00,['4a6b9d19870bd3a272fa86d005899530f7cdf739'],148,171,319,1999212,26,,,,4008
e1075ac0dbe50a466aba3a7a74014f69166e565c,0,Nitin Galave,2021-03-16 10:41:37+05:18,['5c8db0ff6c760e0e27ce89d4e55820c13c4b362a'],23,1239,1262,2000474,11,0.619109948,0.689790576,0.988219895,4013
9f8efbbca287dd47cebd785abf4a72a5da3940b9,0,Abhay Kulkarni,2021-03-16 10:01:41-07:00,['e1075ac0dbe50a466aba3a7a74014f69166e565c'],1,3,4,2000478,1,1,0,0,4013
34196d031aa09ec69288c4b43dc980c205eb2b4b,1,Sailaja Polavarapu,2021-03-16 14:10:27-07:00,['9f8efbbca287dd47cebd785abf4a72a5da3940b9'],2,36,38,2000516,1,0,0.161290323,1,4013
c1ceea3aada52c92cae70d4aa05b4b9ed8508358,0,Nitin Galave,2021-03-18 10:27:10+05:18,['34196d031aa09ec69288c4b43dc980c205eb2b4b'],33,43,76,2000592,6,0.9,1,1,4013
698c24b729e8be5b03d4112c0f4f91e44fbfee7b,0,Sailaja Polavarapu,2021-03-18 06:46:15-07:00,['c1ceea3aada52c92cae70d4aa05b4b9ed8508358'],2,4,6,2000598,1,0,0,1,4013
f7d460976573e74ca80b9e36e73b37bccecf8790,0,Mehul Parikh,2021-03-22 19:01:56+05:18,['698c24b729e8be5b03d4112c0f4f91e44fbfee7b'],1,1,2,2000600,1,,,,4013
0737fe845c6406af8388d0ef57d0071a8e06dea1,0,Abhay Kulkarni,2021-03-22 11:04:43-07:00,['f7d460976573e74ca80b9e36e73b37bccecf8790'],357,342,699,2001299,8,0.133333333,0,0.4,4013
49b7ec4cdb704148dd8581fb382775f5619cd9fe,1,Sailaja Polavarapu,2021-03-22 13:38:46-07:00,['0737fe845c6406af8388d0ef57d0071a8e06dea1'],169,188,357,2001656,8,0.661016949,0.762711864,0,4015
bf25b9be7880fc70afae2ead42303671c341f9b8,1,Sailaja Polavarapu,2021-03-23 10:24:22-07:00,['49b7ec4cdb704148dd8581fb382775f5619cd9fe'],12,65,77,2001733,4,0.173913043,0.173913043,1,4015
3a504bd5af6946f020fb7e9b2f10610bb2c2dafe,0,Abhay Kulkarni,2021-03-23 14:55:19-07:00,['bf25b9be7880fc70afae2ead42303671c341f9b8'],0,19,19,2001752,1,0,0,1,4015
b9d24af9f93053b70a5c692be13aa212b3e0fb26,0,Abhay Kulkarni,2021-03-23 18:52:22-07:00,['3a504bd5af6946f020fb7e9b2f10610bb2c2dafe'],0,1,1,2001753,1,0,0,1,4015
eae411f005346fc374e78da01acacdc027011575,1,Abhay Kulkarni,2021-03-24 18:18:05-07:00,['b9d24af9f93053b70a5c692be13aa212b3e0fb26'],3,14,17,2001770,1,0.333333333,1,1,4015
58b51a39ebe2e7dc4d253658e423f0afb6a74987,0,Dhaval Shah,2021-03-25 11:17:16+05:18,['eae411f005346fc374e78da01acacdc027011575'],1,1,2,2001772,1,,,,4015
1dc2014218b6ff98de9db5597bfa6ffcb984f5f6,0,Abhay Kulkarni,2021-03-29 07:14:32-07:00,['58b51a39ebe2e7dc4d253658e423f0afb6a74987'],0,136,136,2001908,1,,,,4016
2f05ff6745ac209783067a735f111fa66600849a,0,Ramesh Mani,2021-03-30 09:58:49-07:00,['1dc2014218b6ff98de9db5597bfa6ffcb984f5f6'],1,11,12,2001920,1,0,1,1,4016
acb41b92663670b0bb50863bc2550ac9863e62fb,0,Mehul Parikh,2021-03-31 15:20:18+05:18,['2f05ff6745ac209783067a735f111fa66600849a'],2,3,5,2001925,3,,,,4016
0081a767389738db9fa0c1d1342584a54a522c0b,0,Mehul Parikh,2021-03-31 20:27:14+05:18,['acb41b92663670b0bb50863bc2550ac9863e62fb'],1,1,2,2001927,1,,,,4016
8ab40ff1b521f6aeeb4233bb949c8476aeada9c0,0,Mehul Parikh,2021-04-01 10:43:20+05:18,['0081a767389738db9fa0c1d1342584a54a522c0b'],10,4,14,2001941,4,,,,4016
44b1aa5bf72b88f04c5ced06d5b9fea3b908fdbf,1,Ramesh Mani,2021-04-01 22:32:55-07:00,['8ab40ff1b521f6aeeb4233bb949c8476aeada9c0'],271,2619,2890,2004831,17,0.329698525,0.529185375,0.892238614,4024
b48d2202373604c1363cf79cdc512fed1d50e5d4,0,Abhay Kulkarni,2021-04-02 10:53:03-07:00,['44b1aa5bf72b88f04c5ced06d5b9fea3b908fdbf'],4,120,124,2004955,3,0.047619048,0,0.952380952,4024
fce041bd2dc74d40482d3871fe653a5626a2d731,0,Nitin Galave,2021-04-05 10:43:15+05:18,['b48d2202373604c1363cf79cdc512fed1d50e5d4'],0,30,30,2004985,1,0.538461538,0.538461538,1,4024
1efae2fb3704bfe83bf9cb1a62762a9783696ce0,0,Nitin Galave,2021-04-06 18:33:01+05:18,['fce041bd2dc74d40482d3871fe653a5626a2d731'],274,362,636,2005621,7,0,0.981481481,1,4024
71e503f31a27d561979cc6095a3d0add8e50510f,0,Nitin Galave,2021-04-07 12:05:54+05:18,['1efae2fb3704bfe83bf9cb1a62762a9783696ce0'],0,6,6,2005627,2,0,0,1,4024
d4e647590b882a20f7c7d8d2e5188def17382c4c,0,Nitin Galave,2021-04-07 12:06:08+05:18,['71e503f31a27d561979cc6095a3d0add8e50510f'],20,228,248,2005875,6,0.384615385,1,1,4024
89a803d94f6e05ca65f69a269299d3e0dd6e709d,0,Sailaja Polavarapu,2021-04-08 08:25:48-07:00,['d4e647590b882a20f7c7d8d2e5188def17382c4c'],2,2,4,2005879,1,,,,4024
7f5b82bff2df72f20f5c41ba095406d354f8acf0,1,Mehul Parikh,2021-04-14 15:30:11+05:18,['89a803d94f6e05ca65f69a269299d3e0dd6e709d'],4,482,486,2006365,18,0.29245283,0.448113208,0.933962264,4026
c6734e57362691fbf3456baf7ec130b9876f945a,0,Mehul Parikh,2021-04-14 21:09:26+05:18,['7f5b82bff2df72f20f5c41ba095406d354f8acf0'],6,6,12,2006377,1,,,,4026
a993cda1253422e06c31c9265def5d8d882cbb88,0,Nitin Galave,2021-04-19 19:16:35+05:18,['c6734e57362691fbf3456baf7ec130b9876f945a'],3,44,47,2006424,3,0.333333333,0.333333333,1,4026
2b10d10d8fa2dbe7589b29d2e571e72489b6b8c0,0,Nitin Galave,2021-04-20 18:52:31+05:18,['a993cda1253422e06c31c9265def5d8d882cbb88'],3,43,46,2006470,9,0.470588235,0.470588235,1,4026
4b7bca2da5f724576eafb266405b95f5f71d3637,0,Dhaval Shah,2021-04-22 15:15:28+05:18,['2b10d10d8fa2dbe7589b29d2e571e72489b6b8c0'],2,6,8,2006478,1,0,0,1,4026
c1b8656d03830f524e321d9bcd582784ece3b4e5,0,Mehul Parikh,2021-04-22 17:15:37+05:18,['4b7bca2da5f724576eafb266405b95f5f71d3637'],1,1,2,2006480,1,,,,4026
f5b8481ecc7c45fd181670cc29752a053ed8a30e,0,Mehul Parikh,2021-04-22 17:16:18+05:18,['c1b8656d03830f524e321d9bcd582784ece3b4e5'],2,2,4,2006484,1,,,,4026
559779b74ef97182f5ae490b6d57dd304d36bb45,0,Dhaval Shah,2021-04-26 18:38:28+05:18,['f5b8481ecc7c45fd181670cc29752a053ed8a30e'],5,9,14,2006498,1,0,0,1,4026
9df931a9c091d7ddd5a420a72626f5f63febfc79,0,Abhay Kulkarni,2021-04-26 13:49:47-07:00,['559779b74ef97182f5ae490b6d57dd304d36bb45'],13,49,62,2006560,2,0.222222222,0,1,4026
2af862d96bc3aef2c07f374d5bb862ce127698c9,0,Ramesh Mani,2021-04-27 08:37:18-07:00,['9df931a9c091d7ddd5a420a72626f5f63febfc79'],18,5,23,2006583,1,1,1,0,4026
1608f8cec186880384f5a0c2f6c00adee6c91aa1,1,Abhay Kulkarni,2021-04-27 13:23:18-07:00,['2af862d96bc3aef2c07f374d5bb862ce127698c9'],0,147,147,2006730,10,,,,4031
c770b56d1f627a986055ff29692371fce4bcc1a1,1,Ramesh Mani,2021-04-27 21:36:09-07:00,['1608f8cec186880384f5a0c2f6c00adee6c91aa1'],7,25,32,2006762,1,1,0,1,4031
a617a3e0fa09c856173921366be6ad0a9cf3dbef,0,Ramesh Mani,2021-04-28 07:19:16-07:00,['c770b56d1f627a986055ff29692371fce4bcc1a1'],2,15,17,2006779,2,,,,4031
a808f38cd11f2669a2ae7edf0e12057a85b5bb32,1,Abhay Kulkarni,2021-04-29 09:04:17-07:00,['a617a3e0fa09c856173921366be6ad0a9cf3dbef'],113,116,229,2007008,6,0,0,0,4031
b8562443ad881e3cff9aad270c67650b3575f545,0,Nitin Galave,2021-04-30 10:59:52+05:18,['a808f38cd11f2669a2ae7edf0e12057a85b5bb32'],5,10,15,2007023,5,0,1,1,4031
14c24f022e0fd5f10bd400df9f778236d1ab8c80,0,Nitin Galave,2021-04-30 11:00:36+05:18,['b8562443ad881e3cff9aad270c67650b3575f545'],20,27,47,2007070,3,0.333333333,0.666666667,1,4031
2397818554bbf38a2d254d3eab0ea6492d671f95,0,Mehul Parikh,2021-05-03 15:00:55+05:18,['14c24f022e0fd5f10bd400df9f778236d1ab8c80'],568,0,568,2007638,1,,,,4031
9b0ec4a276dbdcef6550dce6c039f40abff9a7bb,0,Mehul Parikh,2021-05-03 15:01:26+05:18,['2397818554bbf38a2d254d3eab0ea6492d671f95'],0,6,6,2007644,1,,,,4031
9fc74bfeef8420c9d753d3a8e2b8335af7cf5536,0,Sailaja Polavarapu,2021-05-03 08:25:03-07:00,['9b0ec4a276dbdcef6550dce6c039f40abff9a7bb'],40,1,41,2007685,2,1,1,0,4031
6f79dd59786804f9c1e32cf8422adc82bbfcbe01,1,Sailaja Polavarapu,2021-05-04 12:17:00-07:00,['9fc74bfeef8420c9d753d3a8e2b8335af7cf5536'],60,135,195,2007880,7,0.454545455,0.818181818,0.854545455,4032
8df4825aef02364bdda05b3355a7da96e7840706,1,Abhay Kulkarni,2021-05-04 17:44:58-07:00,['6f79dd59786804f9c1e32cf8422adc82bbfcbe01'],18,15,33,2007913,5,1,1,0,4032
775b612f5939337834a3204a07a365195b802efa,0,Sailaja Polavarapu,2021-05-04 18:31:35-07:00,['8df4825aef02364bdda05b3355a7da96e7840706'],3,3,6,2007919,2,,,,4032
e44d5472a2da7b67a73e32d0bcb44362b197005e,0,Madhan Neethiraj,2021-05-05 16:41:51-07:00,['775b612f5939337834a3204a07a365195b802efa'],12,97,109,2008028,7,0.212121212,0.772727273,0.787878788,4032
fb00ef4a2d794c0d837702a3817cc14aa69b1920,0,Mehul Parikh,2021-05-10 14:35:12+05:18,['e44d5472a2da7b67a73e32d0bcb44362b197005e'],3,3,6,2008034,3,,,,4032
ac9d348b0f6ff2e948e4b4b0eaf66be164c7a0b6,0,Mehul Parikh,2021-05-10 14:36:16+05:18,['fb00ef4a2d794c0d837702a3817cc14aa69b1920'],1,1,2,2008036,1,,,,4032
0c2a2a9577fcf4133a9a15338a15bd4169d4f07b,0,Mehul Parikh,2021-05-10 14:39:53+05:18,['ac9d348b0f6ff2e948e4b4b0eaf66be164c7a0b6'],12,16,28,2008064,2,0,1,0,4032
d2d8555df02dd145d308f04c46ca67787289ac5e,0,Nitin Galave,2021-05-10 18:35:28+05:18,['0c2a2a9577fcf4133a9a15338a15bd4169d4f07b'],3,3,6,2008070,1,,,,4032
399cc0d47bd5e1ae1dbc5a9612eababd79f2292a,0,Sailaja Polavarapu,2021-05-13 17:02:32-07:00,['d2d8555df02dd145d308f04c46ca67787289ac5e'],0,24,24,2008094,3,0.35,0.4,1,4032
032ef3996a1366480ff72983bd16ce089c6e8798,1,Abhay Kulkarni,2021-05-13 17:26:43-07:00,['399cc0d47bd5e1ae1dbc5a9612eababd79f2292a'],61,227,288,2008382,12,1,1,0,4037
392629c8fbbdb592b212726c5d8305444b6d47ce,0,Abhay Kulkarni,2021-05-13 18:11:23-07:00,['032ef3996a1366480ff72983bd16ce089c6e8798'],171,99,270,2008652,3,0.935483871,0,0,4037
f6b69ca5846de9a7dfced70ae8e403388ecb89fe,0,Mehul Parikh,2021-05-14 11:07:50+05:18,['392629c8fbbdb592b212726c5d8305444b6d47ce'],1,1,2,2008654,1,,,,4037
747033bb0aaeaa6158a8dd02873b3c21aaadda60,0,Mehul Parikh,2021-05-14 11:07:50+05:18,['f6b69ca5846de9a7dfced70ae8e403388ecb89fe'],1,24,25,2008679,2,,,,4037
d992bb4173043cc5f61ce54ed898a519bf7e38d1,0,Mehul Parikh,2021-05-14 11:07:50+05:18,['747033bb0aaeaa6158a8dd02873b3c21aaadda60'],5,64,69,2008748,5,,,,4037
61490135f100ab91ac6cb98392759e1ec7e4f8dc,0,Mehul Parikh,2021-05-17 10:34:28+05:18,['d992bb4173043cc5f61ce54ed898a519bf7e38d1'],5,11,16,2008764,4,0,0,1,4037
8328f56fb15c24913520ae745858e2a47e317956,0,Nitin Galave,2021-05-17 16:44:52+05:18,['61490135f100ab91ac6cb98392759e1ec7e4f8dc'],3,9,12,2008776,3,,,,4037
1e256ddd09ea9f55fb070401cfdb004d39c54f97,0,Mehul Parikh,2021-05-17 19:51:44+05:18,['8328f56fb15c24913520ae745858e2a47e317956'],1,1,2,2008778,1,,,,4037
c647cfdac8c44b3b7b30e4f02ad8052c935b67ac,0,Mehul Parikh,2021-05-18 19:49:07+05:18,['1e256ddd09ea9f55fb070401cfdb004d39c54f97'],43,195,238,2009016,2,0.401515152,0.272727273,0.96969697,4037
c11c781ac29d3c604e1b90496ffcb337f65b3c65,0,Sailaja Polavarapu,2021-05-19 07:09:35-07:00,['c647cfdac8c44b3b7b30e4f02ad8052c935b67ac'],38,91,129,2009145,2,0.204545455,1,0.454545455,4037
c2f102e6d7d03b21639cdb5ae93cf07c05658cde,0,Ramesh Mani,2021-05-19 16:40:12-07:00,['c11c781ac29d3c604e1b90496ffcb337f65b3c65'],3,1,4,2009149,1,1,1,0,4037
3d0e21230358744f07996945da5b665905284217,1,Madhan Neethiraj,2021-05-20 11:46:05-07:00,['c2f102e6d7d03b21639cdb5ae93cf07c05658cde'],44,40,84,2009233,2,0,0,0,4037
87e7f9c63ec87babcaf2b56faa64cac1e56e2860,0,Abhay Kulkarni,2021-05-20 14:49:56-07:00,['3d0e21230358744f07996945da5b665905284217'],4,22,26,2009259,2,0.133333333,0.133333333,1,4037
425adfaeadef92142e943c5c4137de8e1f6e98c1,1,Dhaval Shah,2021-05-21 11:45:08+05:18,['87e7f9c63ec87babcaf2b56faa64cac1e56e2860'],1,2,3,2009262,1,0,0,1,4037
60875395f76a4bbe810989220b1ae3126755dbfa,1,Abhay Kulkarni,2021-05-24 16:43:22-07:00,['425adfaeadef92142e943c5c4137de8e1f6e98c1'],8,23,31,2009293,2,0,1,1,4037
09eb8ba7fb52239e0019832cb1e58cf310140809,1,Madhan Neethiraj,2021-05-25 21:11:18-07:00,['60875395f76a4bbe810989220b1ae3126755dbfa'],97,907,1004,2010297,8,0.46953405,0.329749104,0.659498208,4038
99f7b571b93718196480559a95f396ed37bb3442,0,Sailaja Polavarapu,2021-05-25 21:38:28-07:00,['09eb8ba7fb52239e0019832cb1e58cf310140809'],4,146,150,2010447,8,0.538461538,0.923076923,1,4038
12eaea189a09dfd01dc1159a5af298290f154f1b,0,Madhan Neethiraj,2021-05-26 01:29:52-07:00,['99f7b571b93718196480559a95f396ed37bb3442'],2,7,9,2010456,1,,,,4038
3af3415f6fae4f655d46ffd80dd8c2ad1c8c1dec,1,Sailaja Polavarapu,2021-05-26 10:25:46-07:00,['12eaea189a09dfd01dc1159a5af298290f154f1b'],12,13,25,2010481,2,0,0,1,4038
2427de8feb5bb9eeedbfbf9cb418e59077052c3a,1,Ramesh Mani,2021-06-01 13:40:44-07:00,['3af3415f6fae4f655d46ffd80dd8c2ad1c8c1dec'],24,62,86,2010567,9,0.56,0.8,0.8,4038
9c6969de882e9c1e63ebbc4f250a0ee2624be7d5,1,Madhan Neethiraj,2021-06-02 22:00:34-07:00,['2427de8feb5bb9eeedbfbf9cb418e59077052c3a'],4,53,57,2010624,2,0,0.888888889,1,4039
a12ed5746c0c9632193d7e20ba501cdff3bbb327,0,Sailaja Polavarapu,2021-06-03 13:30:44-07:00,['9c6969de882e9c1e63ebbc4f250a0ee2624be7d5'],0,2,2,2010626,1,0,0,1,4039
a8887c07323e4ed0e18b8df1b7220056d96def07,0,Madhan Neethiraj,2021-06-04 08:17:49-07:00,['a12ed5746c0c9632193d7e20ba501cdff3bbb327'],3,3,6,2010632,3,,,,4039
4738389a408449ff437513e572fdf7a3a0a03dc4,1,Mehul Parikh,2021-06-07 11:31:27+05:18,['a8887c07323e4ed0e18b8df1b7220056d96def07'],0,155,155,2010787,11,0.7,0.7,1,4044
0c7c12d1da2162d8a605ad394359490d083c38bf,0,pradeep,2021-06-07 20:20:52+05:18,['4738389a408449ff437513e572fdf7a3a0a03dc4'],2,3,5,2010792,3,,,,4044
617d8dd74d1479829b7af9754b5b714059788d8e,0,pradeep,2021-06-07 20:21:03+05:18,['0c7c12d1da2162d8a605ad394359490d083c38bf'],128,116,244,2011036,10,0,1,1,4044
bb82ed38eaba61e67a56e2c9bc26abc4a3f1c7f7,1,Abhay Kulkarni,2021-06-08 16:59:28-07:00,['617d8dd74d1479829b7af9754b5b714059788d8e'],183,352,535,2011571,9,0,0.146551724,1,4044
2719a1ecb20f783c13e2b02af4e05d5dd7d8cf53,0,pradeep,2021-06-10 12:19:45+05:18,['bb82ed38eaba61e67a56e2c9bc26abc4a3f1c7f7'],0,1,1,2011572,1,,,,4044
4bd42903161404552bd5867b376c4fb081df290d,0,Mehul Parikh,2021-06-10 19:35:31+05:18,['2719a1ecb20f783c13e2b02af4e05d5dd7d8cf53'],31,370,401,2011973,9,0.466292135,0.820224719,1,4045
91ef9b5cee87998c2e6a1a215525476094148f58,0,pradeep,2021-06-14 19:34:49+05:18,['4bd42903161404552bd5867b376c4fb081df290d'],1,1,2,2011975,1,,,,4045
87a8eb9dfcd535044fd16b3433f6b4b96750b412,0,Ramesh Mani,2021-06-14 11:15:38-07:00,['91ef9b5cee87998c2e6a1a215525476094148f58'],1,1,2,2011977,1,,,,4045
f0f1877c08a2c92d6de537121106da7decdd5343,0,Asha Ramesh,2021-06-18 09:35:06-07:00,['87a8eb9dfcd535044fd16b3433f6b4b96750b412'],14,14,28,2012005,3,,,,4045
798393c0bff3ad3ffd270e2dc4640780527838e5,0,Abhay Kulkarni,2021-06-22 08:53:33-07:00,['f0f1877c08a2c92d6de537121106da7decdd5343'],44,58,102,2012107,13,,,,4045
e56eac1802ae4a0f0f17d2aa0d15036537e5a526,0,Sailaja Polavarapu,2021-06-22 18:42:55-07:00,['798393c0bff3ad3ffd270e2dc4640780527838e5'],2,2,4,2012111,2,,,,4045
613a1e72e88586c93213a60326925afb383dcf29,0,pradeep,2021-06-23 11:46:37+05:18,['e56eac1802ae4a0f0f17d2aa0d15036537e5a526'],61,91,152,2012263,1,0,0,1,4045
df6467e2581d686496ae75625d455aadeaa45864,0,Mehul Parikh,2021-06-23 14:04:32+05:18,['613a1e72e88586c93213a60326925afb383dcf29'],34,28,62,2012325,3,1,0,0,4045
3db20090ba448f844eee69661e11f008ca259128,0,Nitin Galave,2021-06-28 18:30:29+05:18,['df6467e2581d686496ae75625d455aadeaa45864'],6,29,35,2012360,3,0.620689655,0.620689655,1,4045
66c9534982b0c916ceeac24c79e1d2a410921995,0,Sailaja Polavarapu,2021-07-09 12:28:56-07:00,['3db20090ba448f844eee69661e11f008ca259128'],1,1,2,2012362,1,,,,4045
35aa9830c14aec9ef47456f69dc7f4ff29a96cbc,1,Ramesh Mani,2021-07-11 22:21:28-07:00,['66c9534982b0c916ceeac24c79e1d2a410921995'],132,337,469,2012831,8,0.204819277,0.409638554,0.746987952,4045
4da92b1ad2aaab19d855d6d7215132cf92347454,0,pradeep,2021-07-13 09:33:30+05:18,['35aa9830c14aec9ef47456f69dc7f4ff29a96cbc'],18,16,34,2012865,3,,,,4045
99106a3ea09f24b7f94c801b941b948e16ee6e20,0,pradeep,2021-07-13 09:43:51+05:18,['4da92b1ad2aaab19d855d6d7215132cf92347454'],248,125,373,2013238,6,,,,4045
11f13d4eab5372f8868b53b764a11bedf891a789,0,Abhay Kulkarni,2021-07-13 12:13:24-07:00,['99106a3ea09f24b7f94c801b941b948e16ee6e20'],4,13,17,2013255,2,0,0,0,4045
a81f3026dfea4c5cb067cb499f914e0c54c89dd2,0,pradeep,2021-07-14 11:30:19+05:18,['11f13d4eab5372f8868b53b764a11bedf891a789'],34,67,101,2013356,1,0,0.09375,0.09375,4045
e9b1e1d5f2009e90c6bbf912d5039bdafe319a5c,1,pradeep,2021-07-14 13:06:45+05:18,['a81f3026dfea4c5cb067cb499f914e0c54c89dd2'],46,122,168,2013524,10,1,0.591836735,0.285714286,4046
284e1f0e47530bbff9dee9289f33950680d13403,0,Nitin Galave,2021-07-16 15:14:53+05:18,['e9b1e1d5f2009e90c6bbf912d5039bdafe319a5c'],0,1,1,2013525,1,0,1,1,4046
a2d4360f581ae90d190e73b8947f4db9db132eea,0,Nitin Galave,2021-07-16 15:17:36+05:18,['284e1f0e47530bbff9dee9289f33950680d13403'],0,3,3,2013528,1,1,1,0,4046
44d517e8276c9db765772fbe31f925c3e5e8a110,0,pradeep,2021-07-16 19:44:26+05:18,['a2d4360f581ae90d190e73b8947f4db9db132eea'],20,27,47,2013575,4,0,1,1,4046
14367daa08903b3797edcc628c610561732cf40e,0,Ramesh Mani,2021-07-18 22:25:15-07:00,['44d517e8276c9db765772fbe31f925c3e5e8a110'],27,0,27,2013602,18,,,,4046
2f569ee82106c00da57e9447baf1a9bbf86b26e3,0,Dhaval Shah,2021-07-19 18:42:56+05:18,['14367daa08903b3797edcc628c610561732cf40e'],17,72,89,2013691,7,1,0.727272727,1,4047
5b075e6ca77f387b9e094b8f45947f90902e20d5,0,Abhay Kulkarni,2021-07-20 07:14:53-07:00,['2f569ee82106c00da57e9447baf1a9bbf86b26e3'],15,59,74,2013765,2,0.189189189,0,1,4047
db2bd7c4f50be5987cf272c42a2b8a2565175461,1,Abhay Kulkarni,2021-07-20 08:55:31-07:00,['5b075e6ca77f387b9e094b8f45947f90902e20d5'],80,114,194,2013959,9,0.5,1,0,4047
280d0a694886931fe5587921083a767a70ce7183,0,Madhan Neethiraj,2021-07-20 13:23:07-07:00,['db2bd7c4f50be5987cf272c42a2b8a2565175461'],27,269,296,2014255,5,0.156862745,0.483660131,1,4047
9c722cdcf30edde47a06d35e35b2c82b7db8cae2,0,Nitin Galave,2021-07-21 14:02:44+05:18,['280d0a694886931fe5587921083a767a70ce7183'],3,17,20,2014275,2,0,0,1,4047
18ecd31f30a3fdbc5c8cbab9a4b58b9f1bd759d3,0,Ramesh Mani,2021-07-22 11:52:24-07:00,['9c722cdcf30edde47a06d35e35b2c82b7db8cae2'],0,2,2,2014277,1,,,,4047
83e3b19c5c5ec453a875915b73f80a1326f01631,0,Mehul Parikh,2021-07-27 10:27:08+05:18,['18ecd31f30a3fdbc5c8cbab9a4b58b9f1bd759d3'],1,1,2,2014279,1,,,,4047
dadf92160e311f43747ba6f69c0ca58544ad4210,0,pradeep,2021-07-27 20:45:00+05:18,['83e3b19c5c5ec453a875915b73f80a1326f01631'],3,3,6,2014285,1,,,,4047
8248039709eacab568491601f240d55a7a0d0942,0,Mehul Parikh,2021-07-28 14:32:18+05:18,['dadf92160e311f43747ba6f69c0ca58544ad4210'],1,16,17,2014302,2,0,0,1,4047
b2406be6cfc79d004354222f218261f039d8c5df,0,Mehul Parikh,2021-07-28 17:49:00+05:18,['8248039709eacab568491601f240d55a7a0d0942'],24,22,46,2014348,1,1,1,1,4047
203cd27e7d3fef310011b075b94f59b62cda366a,0,Mehul Parikh,2021-07-30 15:09:30+05:18,['b2406be6cfc79d004354222f218261f039d8c5df'],0,373,373,2014721,4,1,1,0.734177215,4050
16c5145ebfdd92345b6f90d4e2fb3c7c88f87413,0,Mehul Parikh,2021-07-30 15:13:23+05:18,['203cd27e7d3fef310011b075b94f59b62cda366a'],35,81,116,2014837,1,0,0.866666667,1,4050
a7ba77ec973029d5c7cc31d00f5256a6f097e9c7,0,Mehul Parikh,2021-07-30 18:21:27+05:18,['16c5145ebfdd92345b6f90d4e2fb3c7c88f87413'],1,28,29,2014866,3,1,1,1,4050
cfc033007bcafb1d115825a5c9ed23d4a1a30ee0,0,Mehul Parikh,2021-08-02 12:56:22+05:18,['a7ba77ec973029d5c7cc31d00f5256a6f097e9c7'],0,156,156,2015022,5,0.106060606,0.106060606,0.734848485,4050
c9003ff68a35bb1fa56d00b3cb2505ac00fbeb2e,0,Abhay Kulkarni,2021-08-03 10:44:01-07:00,['cfc033007bcafb1d115825a5c9ed23d4a1a30ee0'],1,3,4,2015026,2,0,0,0,4050
91545f7ce2772887465a4d28fb373494ea418d3a,0,Mehul Parikh,2021-08-04 15:03:43+05:18,['c9003ff68a35bb1fa56d00b3cb2505ac00fbeb2e'],0,1,1,2015027,1,0,1,1,4050
def49c74559d24c2c7b0e9244754eebce79f07b1,0,Mehul Parikh,2021-08-09 14:33:30+05:18,['91545f7ce2772887465a4d28fb373494ea418d3a'],7,69,76,2015103,5,0,0,0,4050
9115a20d524ba9173ce5db3e270c385d58d8aeab,0,Ramesh Mani,2021-08-11 00:43:38-07:00,['def49c74559d24c2c7b0e9244754eebce79f07b1'],0,2,2,2015105,1,0,0,0.5,4050
1cd7da91719bc7e63089c47238e76cbedf114c91,0,Ramesh Mani,2021-08-11 23:30:24-07:00,['9115a20d524ba9173ce5db3e270c385d58d8aeab'],6,13,19,2015124,1,0,0,1,4050
e9af2c17d8a402833dd33bb08a91d7a304bdd49f,1,Ramesh Mani,2021-08-12 17:05:29-07:00,['1cd7da91719bc7e63089c47238e76cbedf114c91'],1,107,108,2015232,2,0.043956044,0.461538462,0.21978022,4050
bed66ec23e5bb22126bb766f365eb660a30e2945,0,Madhan Neethiraj,2021-08-13 09:35:06-07:00,['e9af2c17d8a402833dd33bb08a91d7a304bdd49f'],0,5,5,2015237,2,0,0,0,4050
bf2d163d409763594116fb7c55d90cef73d4f4c6,0,Mehul Parikh,2021-08-16 11:03:46+05:18,['bed66ec23e5bb22126bb766f365eb660a30e2945'],0,1,1,2015238,1,0,1,1,4050
dfc018b410ed643a94ad2218c831043bd2195f55,0,Nitin Galave,2021-08-16 14:52:09+05:18,['bf2d163d409763594116fb7c55d90cef73d4f4c6'],6,12,18,2015256,2,0,0.6,0.4,4050
10d0a833eedba764e60ac1012f8371764a2468dd,0,Mehul Parikh,2021-08-17 12:57:54+05:18,['dfc018b410ed643a94ad2218c831043bd2195f55'],0,6,6,2015262,1,,,,4050
8f177b03b22875ba46537371136d3bd6a330fa48,0,Mehul Parikh,2021-08-17 13:48:01+05:18,['10d0a833eedba764e60ac1012f8371764a2468dd'],14,70,84,2015346,2,1,0.954545455,0.818181818,4050
6030613254ae628b924b2337a59c6ddb1fba1155,1,Abhay Kulkarni,2021-08-17 10:51:26-07:00,['8f177b03b22875ba46537371136d3bd6a330fa48'],45,94,139,2015485,6,0.282608696,0.086956522,1,4050
3e381db3fc97b3b8c6e678beac405d608b8b7023,0,Mehul Parikh,2021-08-19 11:40:11+05:18,['6030613254ae628b924b2337a59c6ddb1fba1155'],112,140,252,2015737,1,1,1,0,4050
1dee2b377e20b811cc568f30ff789b50d8e241ec,0,Ramesh Mani,2021-08-23 12:53:59-07:00,['3e381db3fc97b3b8c6e678beac405d608b8b7023'],409,1397,1806,2017543,14,0.369346734,0.246231156,0.664572864,4050
224e5fb50055929d506f7554c1b27ed8d081f5d2,1,Sailaja Polavarapu,2021-08-23 13:51:54-07:00,['1dee2b377e20b811cc568f30ff789b50d8e241ec'],14,373,387,2017930,27,0.470588235,0.901960784,0.901960784,4055
f91d70266332b0c4a7c5bfb55985c5b93c859cd9,0,Sailaja Polavarapu,2021-08-23 15:25:24-07:00,['224e5fb50055929d506f7554c1b27ed8d081f5d2'],29,58,87,2018017,2,0,0,0.5,4055
e1ec22406b915e5930ead8ef79128d74122d2c7e,0,Mehul Parikh,2021-08-24 13:44:51+05:18,['f91d70266332b0c4a7c5bfb55985c5b93c859cd9'],4,4,8,2018025,1,,,,4055
4b97613503197f906ff6fe5b7d9c6ac7470ccc0a,0,pradeep,2021-08-24 19:57:45+05:18,['e1ec22406b915e5930ead8ef79128d74122d2c7e'],2,154,156,2018181,12,0.888888889,0.777777778,0.888888889,4060
f8005de5cb9e69be636dddc3dd2117218ddd20e8,0,pradeep,2021-08-25 15:29:50+05:18,['4b97613503197f906ff6fe5b7d9c6ac7470ccc0a'],2,2,4,2018185,1,,,,4060
c2a9833143289d7ffb18aa1c16e144931dae271c,0,Mehul Parikh,2021-08-25 18:27:09+05:18,['f8005de5cb9e69be636dddc3dd2117218ddd20e8'],13,37,50,2018235,1,0,0,1,4060
b0e970f21f7b2bd3f591e291684014f92434a2d3,0,Madhan Neethiraj,2021-08-25 22:17:33-07:00,['c2a9833143289d7ffb18aa1c16e144931dae271c'],0,13,13,2018248,1,1,1,1,4060
fbc08b35b003da4bc42748636aa0b91c8734f903,0,Madhan Neethiraj,2021-08-25 23:14:14-07:00,['b0e970f21f7b2bd3f591e291684014f92434a2d3'],13,0,13,2018261,1,0,0,0,4060
636dcd70efb4a82470daa69934e2c23eaaa23380,0,Madhan Neethiraj,2021-08-25 23:14:25-07:00,['fbc08b35b003da4bc42748636aa0b91c8734f903'],0,13,13,2018274,1,1,1,1,4060
79f6cdec2cce5d6dc3a8bb72ac2a82329cba7d4a,0,Madhan Neethiraj,2021-08-25 23:43:58-07:00,['636dcd70efb4a82470daa69934e2c23eaaa23380'],3,11,14,2018288,1,0,0,0,4060
fcfed2062b0028b758893d898ec430ed4ea62328,0,Nitin Galave,2021-08-27 15:52:42+05:18,['79f6cdec2cce5d6dc3a8bb72ac2a82329cba7d4a'],19,201,220,2018508,6,0.905405405,0.959459459,0.554054054,4060
93a15b81edf19f0c8d5233ee5213d0b889d5f39a,0,pradeep,2021-08-27 18:55:44+05:18,['fcfed2062b0028b758893d898ec430ed4ea62328'],3,3,6,2018514,1,,,,4060
d0b2ab4d5ecab71231d69934ef473e66a2e36ad5,1,Sailaja Polavarapu,2021-08-27 07:12:49-07:00,['93a15b81edf19f0c8d5233ee5213d0b889d5f39a'],93,158,251,2018765,6,0,0.361702128,0.085106383,4060
f4d18bfeb13e548252cbe0ef988f15b666e9e448,1,pradeep,2021-08-30 20:17:11+05:18,['d0b2ab4d5ecab71231d69934ef473e66a2e36ad5'],0,56,56,2018821,1,,,,4060
8cfcecb1e2a3eac65dc3efdfee50fd093f1603b7,0,Madhan Neethiraj,2021-09-02 10:56:11-07:00,['f4d18bfeb13e548252cbe0ef988f15b666e9e448'],1,1,2,2018823,1,,,,4060
fe27e0b32d388033d305b6e58b9686566ee40eb1,1,Abhay Kulkarni,2021-09-03 16:50:29-07:00,['8cfcecb1e2a3eac65dc3efdfee50fd093f1603b7'],63,597,660,2019483,11,0,0.115,0.75,4062
00d660ceb706832d9b89a0ef778ec3839f10d57f,0,pradeep,2021-09-07 10:29:06+05:18,['fe27e0b32d388033d305b6e58b9686566ee40eb1'],2,52,54,2019537,1,,,,4062
43e3e833cc2a03c4e5ab92e6e41c04847d7193a6,0,Madhan Neethiraj,2021-09-07 08:42:12-07:00,['00d660ceb706832d9b89a0ef778ec3839f10d57f'],4,44,48,2019585,2,1,1,1,4062
e6ef861cac99c19ac583a175be801c077e166685,0,pradeep,2021-09-08 16:54:12+05:18,['43e3e833cc2a03c4e5ab92e6e41c04847d7193a6'],1,1,2,2019587,1,,,,4062
92fdf206d80576deaa2e08702a9138255995a326,0,Ramesh Mani,2021-09-08 09:15:16-07:00,['e6ef861cac99c19ac583a175be801c077e166685'],4,22,26,2019613,1,0.733333333,1,1,4062
3b0a9c8f5273ce7c6d12170b86e7a83a9fdba225,0,Abhay Kulkarni,2021-09-08 09:35:48-07:00,['92fdf206d80576deaa2e08702a9138255995a326'],0,2,2,2019615,1,1,1,1,4062
7e80592481306bb0711f7a7544b2c6c64cbebadf,0,Dhaval Shah,2021-09-09 14:55:35+05:18,['3b0a9c8f5273ce7c6d12170b86e7a83a9fdba225'],29,61,90,2019705,5,0.933333333,0,1,4062
77862fe6544dac6d85830d6e69b9fdbda8be197a,0,pradeep,2021-09-09 15:11:14+05:18,['7e80592481306bb0711f7a7544b2c6c64cbebadf'],3,1,4,2019709,2,,,,4062
15f5c387335a428a36737f54fc803189614c40bd,1,pradeep,2021-09-09 15:11:14+05:18,['77862fe6544dac6d85830d6e69b9fdbda8be197a'],7,91,98,2019807,5,0.574074074,0.611111111,1,4062
6ee120f8d3911701c41b810191249d0b8756db89,0,Ramesh Mani,2021-09-11 22:32:50-07:00,['15f5c387335a428a36737f54fc803189614c40bd'],0,6,6,2019813,3,,,,4062
0f0285cb94e9b36221d673936320a82f5a3f3806,1,Ramesh Mani,2021-09-11 22:33:12-07:00,['6ee120f8d3911701c41b810191249d0b8756db89'],2,38,40,2019853,1,0,0,0.971428571,4062
e5cd204efe69fa62b63cc70bf0960ea71ccc6453,0,Abhay Kulkarni,2021-09-12 09:52:52-07:00,['0f0285cb94e9b36221d673936320a82f5a3f3806'],21,21,42,2019895,2,,,,4062
208367b859a16cd2b8be1ddc67d24ce3b71d8916,0,pradeep,2021-09-13 22:36:50+05:18,['e5cd204efe69fa62b63cc70bf0960ea71ccc6453'],3,3,6,2019901,2,,,,4062
cbbed8b07f38af56294c2b17606c45c172a40997,0,pradeep,2021-09-15 08:55:41+05:18,['208367b859a16cd2b8be1ddc67d24ce3b71d8916'],0,12,12,2019913,3,0,0.363636364,0.636363636,4062
885640eaab7c2229056de41a3535a10d0418b204,1,Ramesh Mani,2021-09-17 10:04:43-07:00,['cbbed8b07f38af56294c2b17606c45c172a40997'],3,110,113,2020026,1,0.129032258,0.76344086,0.301075269,4062
e276af0162d4fe7953dd24e9506d572e38b46471,0,Abhay Kulkarni,2021-09-17 14:53:07-07:00,['885640eaab7c2229056de41a3535a10d0418b204'],1,0,1,2020027,1,1,1,0,4062
53c98116850f90810c0bb85d651a64fe01ef865d,1,Abhay Kulkarni,2021-09-17 22:31:42-07:00,['e276af0162d4fe7953dd24e9506d572e38b46471'],20,28,48,2020075,3,0,0,0.5,4062
321435f45ee6ea2090c5339d1eda6ed5b11693a1,0,Nitin Galave,2021-09-20 10:39:34+05:18,['53c98116850f90810c0bb85d651a64fe01ef865d'],5,126,131,2020206,5,0.684210526,0.768421053,1,4062
18838b6bfe59b1365a296a3050dccad253c340e0,0,Dhaval Shah,2021-09-20 11:09:45+05:18,['321435f45ee6ea2090c5339d1eda6ed5b11693a1'],401,496,897,2021103,4,0.344262295,1,1,4062
3af1378c0570bafc3618fc75683ec4ee8f4daadd,0,Madhan Neethiraj,2021-09-21 08:08:31-07:00,['18838b6bfe59b1365a296a3050dccad253c340e0'],10,1161,1171,2022274,4,0.939393939,0.939393939,1,4063
58a104b862b03c55a6b48235f75718451d7c5098,0,Ramesh Mani,2021-09-23 10:36:39-07:00,['3af1378c0570bafc3618fc75683ec4ee8f4daadd'],13,42,55,2022329,5,0,0,1,4063
f40dc241bccf4a2a369b578a7624d1df8e7abee4,0,Madhan Neethiraj,2021-09-23 11:28:07-07:00,['58a104b862b03c55a6b48235f75718451d7c5098'],3,5,8,2022337,1,0,0,0,4063
5877f3281ffafc6a32036907ef01db4add7d762d,1,Ramesh Mani,2021-09-25 10:22:46-07:00,['f40dc241bccf4a2a369b578a7624d1df8e7abee4'],2,3,5,2022342,1,0,0,0,4063
91aaff459c19316686d3fc53ecd9204c371bcefe,0,Madhan Neethiraj,2021-09-25 12:00:14-07:00,['5877f3281ffafc6a32036907ef01db4add7d762d'],18,68,86,2022428,5,0.2,0.966666667,1,4063
3041d1bff37ce1cd4a53073de6c1c97c03f19844,0,Madhan Neethiraj,2021-09-25 12:04:19-07:00,['91aaff459c19316686d3fc53ecd9204c371bcefe'],0,1,1,2022429,1,,,,4063
dd283ef856f97d85162b3470ab85de9364d1af63,0,Ramesh Mani,2021-09-25 23:55:28-07:00,['3041d1bff37ce1cd4a53073de6c1c97c03f19844'],1,1,2,2022431,1,,,,4063
900eec0e10ed24b936b5dc1d58dabc4e90fde0e4,0,Mehul Parikh,2021-09-27 17:17:09+05:18,['dd283ef856f97d85162b3470ab85de9364d1af63'],1,1,2,2022433,1,,,,4063
7b55dfd36a912e82f3c6a2eae651362affed59d8,0,Ramesh Mani,2021-09-27 11:45:35-07:00,['900eec0e10ed24b936b5dc1d58dabc4e90fde0e4'],22,32,54,2022487,3,,,,4063
30e1c9f671c161cfc419224771d6ec35fccfd92c,1,Sailaja Polavarapu,2021-09-27 15:11:24-07:00,['7b55dfd36a912e82f3c6a2eae651362affed59d8'],60,107,167,2022654,1,0,0,1,4063
3c6b44ebafa2e82dcf8e43ea6003e5e8d0d6b050,1,Ramesh Mani,2021-09-28 12:33:02-07:00,['30e1c9f671c161cfc419224771d6ec35fccfd92c'],0,1,1,2022655,1,0,0,1,4063
f599c916d84461847613560f856be47438bda884,0,Abhay Kulkarni,2021-09-28 12:34:40-07:00,['30e1c9f671c161cfc419224771d6ec35fccfd92c'],4,4,8,2022663,1,,,,4063
0ffc6607c34354b07feebdc0e072a46dc7d1a73f,0,Abhay Kulkarni,2021-09-28 12:50:18-07:00,"['f599c916d84461847613560f856be47438bda884', '3c6b44ebafa2e82dcf8e43ea6003e5e8d0d6b050']",0,1,1,2022664,1,,,,4063
c33ff07b689397520d874cde377c1853b9830278,0,Nitin Galave,2021-09-29 18:21:35+05:18,['0ffc6607c34354b07feebdc0e072a46dc7d1a73f'],3,8,11,2022675,3,1,0,1,4063
1debdbcdec23c6688d4589253e75a32a894659c3,0,Abhay Kulkarni,2021-10-01 12:44:52-07:00,['c33ff07b689397520d874cde377c1853b9830278'],0,2,2,2022677,1,0,0,0,4063
d7a3de193d45f00ef20ef8859d025b444b2dba0b,0,Nitin Galave,2021-10-05 16:33:35+05:18,['1debdbcdec23c6688d4589253e75a32a894659c3'],23,36,59,2022736,4,0.384615385,1,1,4063
db9b264f61617b802b0d2fa9c3e553144fe63ae2,1,pradeep,2021-10-05 21:49:55+05:18,['d7a3de193d45f00ef20ef8859d025b444b2dba0b'],6,114,120,2022856,8,,,,4063
d90361db662de1531eafa4d05853e7bc7e08c2a2,1,Abhay Kulkarni,2021-10-05 19:19:37-07:00,['db9b264f61617b802b0d2fa9c3e553144fe63ae2'],9,63,72,2022928,4,0.222222222,0.666666667,0.305555556,4063
4715c3e81fdf59b3d9bcc9fc0133ec6228799404,0,Abhay Kulkarni,2021-10-06 16:34:04-07:00,['d90361db662de1531eafa4d05853e7bc7e08c2a2'],112,45,157,2023085,2,1,1,0,4063
3977c959e1720c7f984dd601ea54350ad4ec70e0,0,Mehul Parikh,2021-10-08 17:28:29+05:18,['4715c3e81fdf59b3d9bcc9fc0133ec6228799404'],13,13,26,2023111,1,,,,4063
eedbb82f680c9d9b022efe49119610c4f7e77d9f,0,Ramesh Mani,2021-10-11 17:31:40-07:00,['3977c959e1720c7f984dd601ea54350ad4ec70e0'],252,1,253,2023364,2,0.92760181,0.488687783,0.624434389,4063
871b0dcc4422cbe30d8415585ff2d2b00bdc4438,1,Mehul Parikh,2021-10-12 15:02:05+05:18,['eedbb82f680c9d9b022efe49119610c4f7e77d9f'],1,1,2,2023366,1,,,,4063
7dec3015ec82b69ba8f724410f12dfce2480cccd,0,Ramesh Mani,2021-10-12 11:55:30-07:00,['871b0dcc4422cbe30d8415585ff2d2b00bdc4438'],0,55,55,2023421,1,0.019607843,0.431372549,0.431372549,4063
4778fd52dae48e8c5024e87bac9e9622f773112c,0,Abhay Kulkarni,2021-10-12 19:42:37-07:00,['7dec3015ec82b69ba8f724410f12dfce2480cccd'],85,56,141,2023562,1,1,1,0,4063
ec7e57e284a50773f8106a748b117692e9a81105,0,pradeep,2021-10-13 09:29:46+05:18,['4778fd52dae48e8c5024e87bac9e9622f773112c'],1,166,167,2023729,10,,,,4068
b8f8a3e30781a5e3165debe885cdc21e24e5d500,0,Abhay Kulkarni,2021-10-13 13:45:20-07:00,['ec7e57e284a50773f8106a748b117692e9a81105'],14,8,22,2023751,2,1,1,1,4068
db9f9a488e99092b9c0dba125dcb5e5efa2ad9a6,0,pradeep,2021-10-14 09:05:33+05:18,['b8f8a3e30781a5e3165debe885cdc21e24e5d500'],0,105,105,2023856,5,0.325301205,0.325301205,1,4068
b8d15436b0e131dae5fadf17715a4e640d014c0e,0,pradeep,2021-10-14 09:06:26+05:18,['db9f9a488e99092b9c0dba125dcb5e5efa2ad9a6'],0,1,1,2023857,1,0,0,1,4068
b559a1f4137d7409b1114a30226a91fc36e1d8e1,0,Mehul Parikh,2021-10-18 10:24:47+05:18,['b8d15436b0e131dae5fadf17715a4e640d014c0e'],0,2,2,2023859,1,0,0,1,4068
2ca455172c59f190fc49894a9ac7fe1e22fd20c1,0,Mehul Parikh,2021-10-19 11:01:07+05:18,['b559a1f4137d7409b1114a30226a91fc36e1d8e1'],1,1,2,2023861,1,,,,4068
a4121b83684ddfc8b0fb7035bf5aa35c4a9676d0,0,Madhan Neethiraj,2021-10-19 07:33:33-07:00,['2ca455172c59f190fc49894a9ac7fe1e22fd20c1'],1,2,3,2023864,2,,,,4068
efe1bcd5a350ecf32b855a86d6c4e1e60677b2d3,0,Mehul Parikh,2021-10-20 11:59:39+05:18,['a4121b83684ddfc8b0fb7035bf5aa35c4a9676d0'],3,3,6,2023870,1,,,,4068
4ea9ef6d3f459583985c1a3b79abf164170155b9,0,Sailaja Polavarapu,2021-10-20 11:34:48-07:00,['efe1bcd5a350ecf32b855a86d6c4e1e60677b2d3'],14,24,38,2023908,2,,,,4068
27c32c4235df81c73ebbbb626de2940d4103c381,1,Sailaja Polavarapu,2021-10-20 13:41:11-07:00,['4ea9ef6d3f459583985c1a3b79abf164170155b9'],82,75,157,2024065,5,0,1,0.75,4068
ed6ece29088490074afc55c2f3254ed05b4064b8,0,Ramesh Mani,2021-10-20 19:37:13-07:00,['27c32c4235df81c73ebbbb626de2940d4103c381'],35,46,81,2024146,4,0.363636364,0.363636364,1,4068
c4910732086ba9e518b253065805a5f92fdab8dc,0,Ramesh Mani,2021-10-22 17:14:22-07:00,['ed6ece29088490074afc55c2f3254ed05b4064b8'],0,11,11,2024157,7,,,,4068
98c0364b741908bb9dc68c90b2fe434f4d572162,0,Madhan Neethiraj,2021-10-24 22:48:54-07:00,['c4910732086ba9e518b253065805a5f92fdab8dc'],6,53,59,2024216,1,0,1,1,4068
1639896aac695057971c7b73a0b91265b3c3e772,0,Mehul Parikh,2021-10-29 14:26:39+05:18,['98c0364b741908bb9dc68c90b2fe434f4d572162'],17,28,45,2024261,1,0,0,1,4068
5acc0a34e8f0c458e3d73b8a0f29aef050307ef6,1,Ramesh Mani,2021-11-01 00:03:59-07:00,['1639896aac695057971c7b73a0b91265b3c3e772'],3,474,477,2024738,20,,,,4076
5732060da4c4c88c1fba3c89fa5369ea56c9b942,0,Mehul Parikh,2021-11-03 12:14:49+05:18,['5acc0a34e8f0c458e3d73b8a0f29aef050307ef6'],6,160,166,2024904,8,0.3125,1,0.46875,4076
1bdf70cbe946bdb34db753afe43b81410bb25da4,0,Ramesh Mani,2021-11-05 21:05:57-07:00,['5732060da4c4c88c1fba3c89fa5369ea56c9b942'],1,23,24,2024928,2,,,,4076
e2566827e963afe8b939f4f1a22ccab22716ba04,0,Madhan Neethiraj,2021-11-09 02:26:05-08:00,['1bdf70cbe946bdb34db753afe43b81410bb25da4'],1,10,11,2024939,1,0,0,0,4076
5ca622fedeb0db6738ebe4a7628ccdbcc7d22fbd,0,Sailaja Polavarapu,2021-11-10 14:41:14-08:00,['e2566827e963afe8b939f4f1a22ccab22716ba04'],1,1,2,2024941,1,,,,4076
57c6c2407d8150e60180d5b41612897aa1704bac,0,Sailaja Polavarapu,2021-11-10 15:19:03-08:00,['5ca622fedeb0db6738ebe4a7628ccdbcc7d22fbd'],1,232,233,2025174,7,0.330827068,0.330827068,1,4077
63aeb5285c3259e6669f88ffbe4192aedd833733,1,Mehul Parikh,2021-11-15 16:44:14+05:18,['57c6c2407d8150e60180d5b41612897aa1704bac'],2,2,4,2025178,1,,,,4077
7d094723c96b85c43c4a88ec741604316f85ea97,0,Mehul Parikh,2021-11-15 16:44:59+05:18,['63aeb5285c3259e6669f88ffbe4192aedd833733'],1,1,2,2025180,1,,,,4077
befc6d7e28b48c9e783af3e863af891c5fdd2b69,0,Madhan Neethiraj,2021-11-15 21:02:28-08:00,['7d094723c96b85c43c4a88ec741604316f85ea97'],184,566,750,2025930,10,0.545454545,0.767045455,0.761363636,4079
a0363eaba9f708088fd0a83f5c89bda5bec58b3c,0,Madhan Neethiraj,2021-11-15 21:44:11-08:00,['befc6d7e28b48c9e783af3e863af891c5fdd2b69'],1,6,7,2025937,1,1,1,0,4079
efee667c26fc70b5d075e796d630952b7fa2bbc9,0,Madhan Neethiraj,2021-11-15 21:46:57-08:00,['a0363eaba9f708088fd0a83f5c89bda5bec58b3c'],6,1,7,2025944,1,0,0,1,4079
dc6dc621fc99f1dbff355c2e2ac00472155a0baf,0,pradeep,2021-11-18 12:26:43+05:18,['efee667c26fc70b5d075e796d630952b7fa2bbc9'],10,55,65,2026009,1,0,0,0.605263158,4079
8068996e42d79a8c0d9bb56b77bb4ec82bfe4113,0,pradeep,2021-11-18 13:01:00+05:18,['dc6dc621fc99f1dbff355c2e2ac00472155a0baf'],1,2,3,2026012,1,0,1,1,4079
71888f243d38ae7cff5e0406c7d54a386d269664,0,Abhay Kulkarni,2021-11-21 09:38:11-08:00,['8068996e42d79a8c0d9bb56b77bb4ec82bfe4113'],36,227,263,2026275,13,0,0.3875,0.6125,4081
d8f674d3fab849aee7daf8e49a21856fdee82c34,0,Ramesh Mani,2021-11-22 11:59:09-08:00,['71888f243d38ae7cff5e0406c7d54a386d269664'],5,61,66,2026341,4,0.352941176,0.352941176,0.352941176,4081
5fb097fda8c51dc9fe671e4105e8b8a7fb5697cd,1,Sailaja Polavarapu,2021-11-22 12:09:38-08:00,['d8f674d3fab849aee7daf8e49a21856fdee82c34'],0,144,144,2026485,6,0.357142857,0.357142857,1,4082
b56aa63a9e1b2020e208c170642a96f5d62cd892,0,Sailaja Polavarapu,2021-11-22 14:17:31-08:00,['5fb097fda8c51dc9fe671e4105e8b8a7fb5697cd'],3,13,16,2026501,1,1,1,0,4082
3f82858760e01ed186a2b3055c95b9cdd343db4b,1,Abhay Kulkarni,2021-11-22 17:44:44-08:00,['b56aa63a9e1b2020e208c170642a96f5d62cd892'],20,25,45,2026546,1,0,0,1,4082
de8f5e197fb93fcb924f7a59a88013b99bd1194b,0,pradeep,2021-11-24 20:17:20+05:18,['3f82858760e01ed186a2b3055c95b9cdd343db4b'],3,174,177,2026723,10,,,,4087
4fdb3af5fc21f43ab22b2fb4d0e411b500460cbc,0,pradeep,2021-11-24 20:35:45+05:18,['de8f5e197fb93fcb924f7a59a88013b99bd1194b'],0,138,138,2026861,8,0.724137931,1,1,4088
856571c4348e31725498c0922338339c76ebba02,1,Abhay Kulkarni,2021-11-24 07:38:20-08:00,['4fdb3af5fc21f43ab22b2fb4d0e411b500460cbc'],46,95,141,2027002,8,0.055555556,0.222222222,1,4088
5d1272335156dfc6d32862c6ee9af2e92b087169,0,pradeep,2021-11-25 09:22:23+05:18,['856571c4348e31725498c0922338339c76ebba02'],12,8,20,2027022,1,1,1,1,4088
a6583cffdf5813773721f7ae1e02e632de886558,0,Madhan Neethiraj,2021-11-27 13:01:20-08:00,['5d1272335156dfc6d32862c6ee9af2e92b087169'],3,25,28,2027050,2,1,0,1,4088
3045345f3dea4fa44cc522df7b171d6fb3bd5303,0,pradeep,2021-11-29 16:21:40+05:18,['a6583cffdf5813773721f7ae1e02e632de886558'],7,0,7,2027057,1,1,1,1,4088
fe97016e147295aef5aa9041744452bb647cc724,0,Madhan Neethiraj,2021-11-29 13:56:58-08:00,['3045345f3dea4fa44cc522df7b171d6fb3bd5303'],6,10,16,2027073,1,1,1,1,4088
a7b527bbd0df8ba86eee7b3fdc65b470bbbc17fa,0,pradeep,2021-11-30 21:36:41+05:18,['fe97016e147295aef5aa9041744452bb647cc724'],16,34,50,2027123,2,0.428571429,0.428571429,0.428571429,4088
bb9b3cd14d5ebdb5381ca4a03db27b469c2277e1,0,pradeep,2021-11-30 21:36:57+05:18,['a7b527bbd0df8ba86eee7b3fdc65b470bbbc17fa'],1,3,4,2027127,1,0,0,1,4088
6678ef77438d1289e0ade0cc2e7652a6bd836621,1,Sailaja Polavarapu,2021-12-01 14:32:40-08:00,['bb9b3cd14d5ebdb5381ca4a03db27b469c2277e1'],24,39,63,2027190,1,0,1,1,4088
84cdf593423f03c3082db3baee9bb89149205b5a,0,Sailaja Polavarapu,2021-12-01 15:32:48-08:00,['6678ef77438d1289e0ade0cc2e7652a6bd836621'],12,13,25,2027215,1,0,0,0,4088
8968eaef8693b39a32f10c2feebf0035b34e3763,0,pradeep,2021-12-02 13:06:31+05:18,['84cdf593423f03c3082db3baee9bb89149205b5a'],25,27,52,2027267,10,,,,4088
185ca1ca89bb4585c773a31e505502c1ebec51c5,0,pradeep,2021-12-02 13:07:13+05:18,['8968eaef8693b39a32f10c2feebf0035b34e3763'],3,226,229,2027496,10,0.5,0.550847458,0.872881356,4089
5852efde1cba728ad580231ad02145ea72861186,0,Abhay Kulkarni,2021-12-02 09:23:05-08:00,['185ca1ca89bb4585c773a31e505502c1ebec51c5'],17,649,666,2028162,13,0.149425287,0.149425287,1,4090
000e6351ee4628979a20e2b72ac6f226e6dd1c0e,0,pradeep,2021-12-03 08:59:45+05:18,['5852efde1cba728ad580231ad02145ea72861186'],24,50,74,2028236,5,0,0,0,4090
695bedd07b4f58aef4f5747393c06d83c8805438,0,Abhay Kulkarni,2021-12-03 15:01:01-08:00,['000e6351ee4628979a20e2b72ac6f226e6dd1c0e'],43,205,248,2028484,2,0.201492537,0.246268657,0.231343284,4090
b61ed9f7ac3c7a0c07056cba21d8c9440b05d28a,0,pradeep,2021-12-08 05:31:08+05:18,['695bedd07b4f58aef4f5747393c06d83c8805438'],154,557,711,2029195,17,0.14893617,0.629787234,0.974468085,4092
d3af7476dcab3719b8a75b506b10400640f3bf3e,0,Abhay Kulkarni,2021-12-07 16:58:25-08:00,['b61ed9f7ac3c7a0c07056cba21d8c9440b05d28a'],50,89,139,2029334,2,0.5,0.5,0.409090909,4092
25def39b1c833b4e18ff657929656be3c37bcd8f,0,pradeep,2021-12-08 08:10:26+05:18,['d3af7476dcab3719b8a75b506b10400640f3bf3e'],0,534,534,2029868,34,0.432,0.984,0.824,4094
fcea57497766576c97591801fcd81e63b9a532b0,0,Ramesh Mani,2021-12-07 22:26:16-08:00,['25def39b1c833b4e18ff657929656be3c37bcd8f'],28,46,74,2029942,3,0.8,0.8,0.2,4094
0258fcf7ab25473b056fffc103840806c18fdcad,0,Patel,2021-12-08 12:05:08+05:18,['fcea57497766576c97591801fcd81e63b9a532b0'],1,2,3,2029945,1,0,0,1,4094
00dd3fcd88aa6e10bf1f2e3a68c76a85c7218de2,0,pradeep,2021-12-09 09:30:21+05:18,['0258fcf7ab25473b056fffc103840806c18fdcad'],4,3,7,2029952,1,,,,4094
65543320e43b94e09b07eba647bf347b8b64fe14,0,pradeep,2021-12-09 09:32:32+05:18,['00dd3fcd88aa6e10bf1f2e3a68c76a85c7218de2'],2,2,4,2029956,1,,,,4094
a3d798253605b5cb51cbce03489a9e36c3b338b8,0,Dhaval Shah,2021-12-09 18:40:31+05:18,['65543320e43b94e09b07eba647bf347b8b64fe14'],2,6,8,2029964,1,0,1,0,4094
3388a4113e597f22438e1070718e4a30b3895f46,0,pradeep,2021-12-10 10:18:53+05:18,['a3d798253605b5cb51cbce03489a9e36c3b338b8'],30,66,96,2030060,3,,,,4095
07b293187838c00073a34ba63b50bbeff7069e89,0,pradeep,2021-12-10 13:52:35+05:18,['3388a4113e597f22438e1070718e4a30b3895f46'],2,10,12,2030072,1,0,0,1,4095
ce2e3d3f223ab27cf2c2b6891d6f140853d48fa6,1,Ramesh Mani,2021-12-11 18:07:56-08:00,['07b293187838c00073a34ba63b50bbeff7069e89'],1,1,2,2030074,1,,,,4095
3b32ec719e89748f7478e64d5df448d22bfbf5b5,0,Abhay Kulkarni,2021-12-13 12:58:22-08:00,['ce2e3d3f223ab27cf2c2b6891d6f140853d48fa6'],24,63,87,2030161,3,,,,4096
4f3806f3cd955eb91d141cf36df58410fa6cdb35,0,Patel,2021-12-15 15:25:36+05:18,['3b32ec719e89748f7478e64d5df448d22bfbf5b5'],0,9,9,2030170,2,,,,4096
ec74c534210f11a95eddae80a8bd67285fcd9a01,0,Patel,2021-12-15 15:54:15+05:18,['4f3806f3cd955eb91d141cf36df58410fa6cdb35'],3,532,535,2030705,29,,,,4096
ec463f00b5573cd37cd7192d65c552f63bf68917,1,Ramesh Mani,2021-12-15 08:21:43-08:00,['ec74c534210f11a95eddae80a8bd67285fcd9a01'],1,1,2,2030707,1,,,,4096
7406d2d04d473d0dbacb39b9d75d883768a44cea,0,Abhay Kulkarni,2021-12-15 21:18:56-08:00,['ec463f00b5573cd37cd7192d65c552f63bf68917'],2,3,5,2030712,1,,,,4096
cc622161861b2f7a477546b98f2b67f7b848af31,1,pradeep,2021-12-16 14:26:42+05:18,['7406d2d04d473d0dbacb39b9d75d883768a44cea'],10,1088,1098,2031810,2,0.075709779,1,1,4096
64cbfcda4a77dad0416a3e416c761a1a2474b0ff,0,pradeep,2021-12-16 16:26:05+05:18,['cc622161861b2f7a477546b98f2b67f7b848af31'],0,8,8,2031818,2,,,,4096
dc011268318feb46c970e5f3610dc84d9602ea32,0,pradeep,2021-12-16 16:30:36+05:18,['64cbfcda4a77dad0416a3e416c761a1a2474b0ff'],43,16,59,2031877,3,1,0.92,0,4096
a06bc6327ddfa26c97b20c372c9be65f961e58ab,0,pradeep,2021-12-16 16:46:38+05:18,['dc011268318feb46c970e5f3610dc84d9602ea32'],0,1,1,2031878,1,0,0,0,4096
d6f0196bcbde1c0202ee978ebd007003911842f9,0,Abhay Kulkarni,2021-12-17 11:56:04-08:00,['a06bc6327ddfa26c97b20c372c9be65f961e58ab'],2,6,8,2031886,1,0,0,1,4096
993cf0d9a98a2ea8f01d1fbbd3d6a1177a8887ca,0,Abhay Kulkarni,2021-12-18 14:57:18-08:00,['d6f0196bcbde1c0202ee978ebd007003911842f9'],2,3,5,2031891,1,,,,4096
9f08bbd96fd874939628be4a275437d51f83a862,0,pradeep,2021-12-20 09:59:04+05:18,['993cf0d9a98a2ea8f01d1fbbd3d6a1177a8887ca'],8,359,367,2032258,2,0.072847682,1,1,4096
0f9bfbe3f35e9d02edaced2b08214d42edea8382,1,pradeep,2021-12-20 16:31:50+05:18,['9f08bbd96fd874939628be4a275437d51f83a862'],3,3,6,2032264,2,,,,4096
e198d01e3c23b89c9fdbcb2915931a4714185b4e,0,Madhan Neethiraj,2021-12-20 16:54:45-08:00,['0f9bfbe3f35e9d02edaced2b08214d42edea8382'],39,330,369,2032633,9,0.180645161,0.961290323,0.896774194,4098
27b28408a162290c1a195fd89ed6db9e28ddcb0d,0,pradeep,2021-12-22 16:08:49+05:18,['e198d01e3c23b89c9fdbcb2915931a4714185b4e'],37,111,148,2032781,7,0.536231884,0.420289855,0.753623188,4098
71744d3ff8e0db7f0a49881a891e77edf0ea518d,0,pradeep,2021-12-26 05:28:11+05:18,['27b28408a162290c1a195fd89ed6db9e28ddcb0d'],135,868,1003,2033784,51,0.210242588,0.070080863,0.663072776,4101
bbbc23c005432c715d741e6ea61a9aaddc569845,0,pradeep,2021-12-28 09:58:37+05:18,['71744d3ff8e0db7f0a49881a891e77edf0ea518d'],1,5,6,2033790,1,1,1,1,4101
50959d7defd28f0c40226f11bd5beeb3481bda0e,0,Madhan Neethiraj,2021-12-30 00:27:52-08:00,['bbbc23c005432c715d741e6ea61a9aaddc569845'],0,36,36,2033826,6,,,,4101
ca37ccd0d245e17d918b8278342c074522ed32bd,0,Madhan Neethiraj,2021-12-30 01:38:55-08:00,['50959d7defd28f0c40226f11bd5beeb3481bda0e'],0,3,3,2033829,1,,,,4101
8235a8e17465dd63658ab370fd6f70ccaee5b736,0,Madhan Neethiraj,2022-01-01 15:04:29-08:00,['ca37ccd0d245e17d918b8278342c074522ed32bd'],111,205,316,2034145,5,0.295081967,0.918032787,0.163934426,4101
02b071a5c75292b45d429a2c52342cca29ccf1bb,0,Mehul Parikh,2022-01-03 17:41:17+05:18,['8235a8e17465dd63658ab370fd6f70ccaee5b736'],1,14,15,2034160,2,,,,4101
df07b0da94dced97e6022b1d0d243c8b2e358803,1,Abhay Kulkarni,2022-01-03 18:38:55-08:00,['02b071a5c75292b45d429a2c52342cca29ccf1bb'],469,436,905,2035065,5,0,0,1,4101
9a034ab87ae6d8c5a80d1e35dd0e0fd13a9a8dc2,0,Madhan Neethiraj,2022-01-03 23:04:14-08:00,['df07b0da94dced97e6022b1d0d243c8b2e358803'],1,1,2,2035067,1,,,,4101
26401a9024b6e02389a87c4700eccf0a7b96302b,0,Mehul Parikh,2022-01-04 18:22:55+05:18,['9a034ab87ae6d8c5a80d1e35dd0e0fd13a9a8dc2'],1365,1708,3073,2038140,2,0,1,0,4101
56bac60551f77f582bdb9693705a8c8682b17b56,0,Madhan Neethiraj,2022-01-04 14:58:27-08:00,['26401a9024b6e02389a87c4700eccf0a7b96302b'],86,298,384,2038524,12,0.806451613,1,0.241935484,4102
dd7c773dee6d8f15ffcb14304d71b79c29fdf082,0,Abhay Kulkarni,2022-01-05 15:24:39-08:00,['56bac60551f77f582bdb9693705a8c8682b17b56'],34,10,44,2038568,4,1,1,0.5,4102
7fd191e9e3f236807e0a69c31dd881269d550025,0,Abhay Kulkarni,2022-01-05 15:54:51-08:00,['dd7c773dee6d8f15ffcb14304d71b79c29fdf082'],1,1,2,2038570,1,,,,4102
ba917a683dae46e534e4da388128d3eb9ab97af9,0,Abhay Kulkarni,2022-01-08 11:45:50-08:00,['7fd191e9e3f236807e0a69c31dd881269d550025'],85,46,131,2038701,2,1,0.5,1,4102
c644abfd54cdb92019f54dd468d0240100da5451,0,Selvamohan Neethiraj,2022-01-08 18:45:31-05:00,['7fd191e9e3f236807e0a69c31dd881269d550025'],1,11,12,2038713,3,,,,4102
0f6f4d0e56b29dbdc848bcdffa7e2073cf743401,0,Selvamohan Neethiraj,2022-01-08 18:46:19-05:00,"['c644abfd54cdb92019f54dd468d0240100da5451', 'ba917a683dae46e534e4da388128d3eb9ab97af9']",85,46,131,2038844,2,,,,4102
78cfc7531e714cebd2d947203cb38ee992c8853c,0,pradeep,2022-01-11 15:47:47+05:18,['0f6f4d0e56b29dbdc848bcdffa7e2073cf743401'],1,1,2,2038846,1,,,,4102
277f4610118c2cdb6ce9e2bf31e60f4d5b986c59,0,pradeep,2022-01-11 23:18:43+05:18,['78cfc7531e714cebd2d947203cb38ee992c8853c'],113,140,253,2039099,3,1,1,0,4102
47617bb0610bd7a3c722e7ffd4718255ae9041b0,0,Abhay Kulkarni,2022-01-12 16:19:19-08:00,['277f4610118c2cdb6ce9e2bf31e60f4d5b986c59'],0,3,3,2039102,1,0,0,1,4102
20046b242a197b8b0cd9427c51a5ba073907788f,0,Madhan Neethiraj,2022-01-13 13:06:48-08:00,['47617bb0610bd7a3c722e7ffd4718255ae9041b0'],1,625,626,2039728,12,,,,4111
1af1252302a39523b125faaf629b70defde71881,1,Dhaval Shah,2022-01-17 11:14:34+05:18,['20046b242a197b8b0cd9427c51a5ba073907788f'],48,629,677,2040405,14,0.327433628,0.402654867,0.960176991,4115
1bef752d2213b85786c0b761db62253ad1360264,0,Dhaval Shah,2022-01-17 19:12:54+05:18,['1af1252302a39523b125faaf629b70defde71881'],1,11,12,2040417,2,,,,4115
71809108fd106b664b6f9d53e0efd86d4c5cd039,1,Madhan Neethiraj,2022-01-17 10:16:40-08:00,['1bef752d2213b85786c0b761db62253ad1360264'],2661,3630,6291,2046708,572,1,0.472727273,0,4145
c96bc8b4a7ac1412b43524cce193c5006c90516d,0,Madhan Neethiraj,2022-01-17 13:08:34-08:00,['71809108fd106b664b6f9d53e0efd86d4c5cd039'],55,291,346,2047054,2,0.875776398,1,1,4145
07e74c238019933d4944b2ecee7a2ea7799c5354,0,pradeep,2022-01-19 09:54:49+05:18,['c96bc8b4a7ac1412b43524cce193c5006c90516d'],1,32,33,2047087,1,,,,4145
65798673112e037d2f884f78eaeb05588dbf0659,0,pradeep,2022-01-19 09:55:24+05:18,['07e74c238019933d4944b2ecee7a2ea7799c5354'],5,3,8,2047095,1,1,1,1,4145
292528968560429624667fb5ec254eed40e52a52,0,pradeep,2022-01-19 16:16:39+05:18,['65798673112e037d2f884f78eaeb05588dbf0659'],3,5,8,2047103,1,0,0,0,4145
bfc9c544107dd6d2a052dc8941503de335f930b6,0,pradeep,2022-01-20 08:59:07+05:18,['292528968560429624667fb5ec254eed40e52a52'],0,24,24,2047127,1,0.055555556,1,1,4145
09ec4d90fbd9afa643eaeca29765563a00866257,0,pradeep,2022-01-20 08:59:22+05:18,['bfc9c544107dd6d2a052dc8941503de335f930b6'],1,3,4,2047131,1,0,0,1,4145
5d07d125ffd1b331a4c195d68c442e8c94d95237,0,pradeep,2022-01-21 09:04:13+05:18,['09ec4d90fbd9afa643eaeca29765563a00866257'],196,384,580,2047711,18,1,1,1,4147
c169d6d5608172c752c4a44a1b61d2cfd8567158,0,pradeep,2022-01-23 08:21:51+05:18,['5d07d125ffd1b331a4c195d68c442e8c94d95237'],1,5,6,2047717,3,0,0.4,1,4147
d7d58ef548b02347f33253973ecb22cf9b24df1e,0,Madhan Neethiraj,2022-01-23 14:24:00-08:00,['c169d6d5608172c752c4a44a1b61d2cfd8567158'],12,104,116,2047833,15,,,,4147
e5c7ee70239be8e6a1df877deac3dded4ab7fc29,0,pradeep,2022-01-25 20:00:32+05:18,['d7d58ef548b02347f33253973ecb22cf9b24df1e'],3,1,4,2047837,1,1,1,0,4147
ba999ed35d28226a74965bca16b6efc9c46b5df2,0,pradeep,2022-01-26 08:55:32+05:18,['e5c7ee70239be8e6a1df877deac3dded4ab7fc29'],8,14,22,2047859,3,,,,4147
885d12ddd59eaa1401ef7d9ee528553ad836b958,1,pradeep,2022-01-26 10:35:07+05:18,['ba999ed35d28226a74965bca16b6efc9c46b5df2'],1,1,2,2047861,1,,,,4147
0ed9d518d8299ec3708ed93910279a18ad1f903f,0,Madhan Neethiraj,2022-01-26 08:23:33-08:00,['885d12ddd59eaa1401ef7d9ee528553ad836b958'],23,63,86,2047947,2,0.258823529,0.105882353,0.282352941,4147
fedd731978e12cf28b3863b1e646aed22b3f4191,0,pradeep,2022-01-27 19:19:25+05:18,['0ed9d518d8299ec3708ed93910279a18ad1f903f'],32,60,92,2048039,2,0.952380952,1,1,4147
f9b5f6e7378bf6cc8bbfa4002108c19da98a129d,1,pradeep,2022-01-28 18:23:48+05:18,['fedd731978e12cf28b3863b1e646aed22b3f4191'],5,5,10,2048049,2,,,,4147
5543215307b232ea54c037ebad4001819bb6a519,0,pradeep,2022-01-29 10:29:46+05:18,['f9b5f6e7378bf6cc8bbfa4002108c19da98a129d'],8,11,19,2048068,1,0,1,1,4147
f279656bd01b9a3502ae243863060e1afa5442ef,0,Sailaja Polavarapu,2022-02-01 11:35:34-08:00,['5543215307b232ea54c037ebad4001819bb6a519'],32,214,246,2048314,7,0.272727273,0.286713287,0.293706294,4147
6a15ce5ae2e3078f848f76b56b72422642d3e76b,1,pradeep,2022-02-02 12:55:08+05:18,['f279656bd01b9a3502ae243863060e1afa5442ef'],102,143,245,2048559,4,,,,4147
3ab249af086cb10a58f6344d6b4efd482b584a85,0,pradeep,2022-02-02 14:37:08+05:18,['6a15ce5ae2e3078f848f76b56b72422642d3e76b'],5,45,50,2048609,11,,,,4147
a2e1ec4d55d9d87367c5da75763e0a44b5231fcc,0,Madhan Neethiraj,2022-02-03 20:05:19-08:00,['3ab249af086cb10a58f6344d6b4efd482b584a85'],20,213,233,2048842,5,0.228915663,0.710843373,0.987951807,4149
4d4bf464275783a7a24cdd14433238c902cabb96,0,Madhan Neethiraj,2022-02-04 18:27:16-08:00,['a2e1ec4d55d9d87367c5da75763e0a44b5231fcc'],128,153,281,2049123,15,0.142857143,0,1,4149
26070383c6300da91926ed77e128d35c9808056c,0,pradeep,2022-02-07 13:36:47+05:18,['4d4bf464275783a7a24cdd14433238c902cabb96'],1,5,6,2049129,1,1,1,1,4149
a5eee486d08a889ae299094e8da33478a1212d29,0,Madhan Neethiraj,2022-02-07 10:35:28-08:00,['26070383c6300da91926ed77e128d35c9808056c'],0,11,11,2049140,10,,,,4149
07c6875a859a4ac4a5b1feb66b6f7bdc83d99878,1,Madhan Neethiraj,2022-02-11 11:45:33-08:00,['a5eee486d08a889ae299094e8da33478a1212d29'],27,1015,1042,2050182,13,0.388804841,0.56429652,0.813918306,4150
9a2c732d6584802d30e7e847a1e6b8c4050e5652,0,Madhan Neethiraj,2022-02-11 20:40:09-08:00,['07c6875a859a4ac4a5b1feb66b6f7bdc83d99878'],12,124,136,2050318,7,1,1,1,4151
be2373605a3b001d4481971502858b072de42bd5,0,Madhan Neethiraj,2022-02-13 21:24:18-08:00,['9a2c732d6584802d30e7e847a1e6b8c4050e5652'],61,67,128,2050446,9,1,1,1,4152
03f6d3f18f8576d710928be4b148143b8a9f8d91,0,Abhay Kulkarni,2022-02-14 08:18:06-08:00,['be2373605a3b001d4481971502858b072de42bd5'],5,3,8,2050454,1,1,1,0,4152
a5743e873b5fc51748b7e3d5de12e2a18106a6ea,0,Ramesh Mani,2022-02-14 22:25:40-08:00,['03f6d3f18f8576d710928be4b148143b8a9f8d91'],0,17,17,2050471,1,0,0,1,4152
5f8d001bc0cf24efc1f8c52cabeda44275c47a6b,0,Madhan Neethiraj,2022-02-16 11:30:31-08:00,['a5743e873b5fc51748b7e3d5de12e2a18106a6ea'],1,1,2,2050473,1,,,,4152
5221f83db91e89fcbb3df5a66021362c848fbff7,0,Dhaval Shah,2022-02-17 16:29:35+05:18,['5f8d001bc0cf24efc1f8c52cabeda44275c47a6b'],160,402,562,2051035,13,0.546511628,0.860465116,1,4153
605de3cba8d311e983f0aee3490e67266f6668a9,1,Dhaval Shah,2022-02-17 18:14:56+05:18,['5f8d001bc0cf24efc1f8c52cabeda44275c47a6b'],160,402,562,2051597,13,0.546511628,0.860465116,1,4154
1135aaf95f92d01bcb1a7447d946cd6ca0a0152d,0,Dhaval Shah,2022-02-17 18:15:46+05:18,"['605de3cba8d311e983f0aee3490e67266f6668a9', '5221f83db91e89fcbb3df5a66021362c848fbff7']",0,0,0,2051597,0,,,,4154
b0569918c2f36cd0a9c8acc232ce9cd24e275309,0,Madhan Neethiraj,2022-02-18 13:05:50-08:00,['1135aaf95f92d01bcb1a7447d946cd6ca0a0152d'],7,8,15,2051612,2,1,0,1,4154
4473560aa018bec8f3e28bc747a7a68e5f84c556,0,Madhan Neethiraj,2022-02-18 20:01:49-08:00,['b0569918c2f36cd0a9c8acc232ce9cd24e275309'],7,25,32,2051644,5,,,,4154
d9e13b9d0982d7abd67399515e649605411b748d,0,Patel,2022-02-21 12:18:48+05:18,['4473560aa018bec8f3e28bc747a7a68e5f84c556'],1,1,2,2051646,1,,,,4154
97bab144a537b8add3381fb8485baf1da23f2157,0,Dhaval Shah,2022-02-22 15:01:38+05:18,['d9e13b9d0982d7abd67399515e649605411b748d'],44,47,91,2051737,2,1,1,0,4154
227c45b5ccea6d9d0d546c1882a805b0f0b7b617,0,Dhaval Shah,2022-02-23 15:24:15+05:18,['97bab144a537b8add3381fb8485baf1da23f2157'],12,13,25,2051762,2,0,0,0,4154
30486a024aa7be8707ba1050e5ebff6d866c9ba9,0,Patel,2022-02-24 22:24:03+05:18,['227c45b5ccea6d9d0d546c1882a805b0f0b7b617'],2,2,4,2051766,1,,,,4154
3a4667342e653ca6132fcb140740a9e1b19b40b0,0,Patel,2022-02-24 22:24:30+05:18,['30486a024aa7be8707ba1050e5ebff6d866c9ba9'],3,0,3,2051769,1,,,,4154
22d45607b3b9f168587da56440586bc1fe6471f5,0,Sailaja Polavarapu,2022-02-24 17:55:49-08:00,['3a4667342e653ca6132fcb140740a9e1b19b40b0'],6,16,22,2051791,1,0,1,1,4154
4f4184d6183ef52c07f96b1116bf21eae0c32b72,0,Madhan Neethiraj,2022-02-24 19:04:38-08:00,['22d45607b3b9f168587da56440586bc1fe6471f5'],15,2,17,2051808,3,,,,4154
3cdeb8a5fdb14146d285734883bdb877eee79f55,0,Patel,2022-02-28 18:58:01+05:18,['4f4184d6183ef52c07f96b1116bf21eae0c32b72'],1,1,2,2051810,1,,,,4154
438578d2d7eab0d7136149e24cb811bcb8cd0cf2,0,Patel,2022-03-02 16:03:54+05:18,['3cdeb8a5fdb14146d285734883bdb877eee79f55'],408,79,487,2052297,23,0.857142857,0.857142857,1,4154
53b103c5826f115f05e011d883041471d7546a63,0,Ramesh Mani,2022-03-02 12:26:08-08:00,['438578d2d7eab0d7136149e24cb811bcb8cd0cf2'],13,21,34,2052331,5,,,,4154
de710f6620c323e6127c30f735fd348dffe61365,0,Patel,2022-03-03 15:16:06+05:18,['53b103c5826f115f05e011d883041471d7546a63'],192,74,266,2052597,16,1,1,1,4154
9e5d4ec3e50f0e0d2785bb60e8a81b33a8729b4f,0,Madhan Neethiraj,2022-03-03 21:43:41-08:00,['de710f6620c323e6127c30f735fd348dffe61365'],8,33,41,2052638,3,1,1,0.25,4154
4eb8401215549c169f7fb9726eb21527e3f4e151,0,pradeep,2022-03-07 10:12:08+05:18,['9e5d4ec3e50f0e0d2785bb60e8a81b33a8729b4f'],36,21,57,2052695,15,,,,4154
bf18c50f1c04e2a5319d0533c6707110b5b62092,0,Madhan Neethiraj,2022-03-06 21:49:29-08:00,['4eb8401215549c169f7fb9726eb21527e3f4e151'],26,19,45,2052740,1,1,0,0,4154
a607f5af78f0329a6d34653c3cb2716f9337394c,0,Patel,2022-03-08 08:18:32+05:18,['bf18c50f1c04e2a5319d0533c6707110b5b62092'],8,1,9,2052749,2,,,,4154
19ed8415cd2cd26bb07d3aa7d503ae036698c005,0,Ramesh Mani,2022-03-07 20:15:53-08:00,['a607f5af78f0329a6d34653c3cb2716f9337394c'],2,74,76,2052825,2,0.435897436,0.435897436,0.692307692,4154
63704db998840b8f5d50575945691de2e46f3260,0,Sailaja Polavarapu,2022-03-08 17:58:54-08:00,['19ed8415cd2cd26bb07d3aa7d503ae036698c005'],91,421,512,2053337,3,0.058020478,0.078498294,1,4154
63ae590864def7c33d9c2b0b8f8a2faca202abfb,0,Madhan Neethiraj,2022-03-09 13:19:23-08:00,['63704db998840b8f5d50575945691de2e46f3260'],22,44,66,2053403,8,0,0,1,4154
e4a879ca9dafcbb9bb3cd15582241bdfb6b225ba,0,Nitin Galave,2022-03-10 11:20:32+05:18,['63ae590864def7c33d9c2b0b8f8a2faca202abfb'],3,0,3,2053406,3,1,0,0,4154
5575104433f9b0f6be42bff912f00683237d7fc4,0,Nitin Galave,2022-03-10 11:20:33+05:18,['e4a879ca9dafcbb9bb3cd15582241bdfb6b225ba'],998,1347,2345,2055751,7,1,0,0,4154
dec71c1ce8c0262579a85eea36e9581b49de8cd3,0,Sailaja Polavarapu,2022-03-10 14:33:41-08:00,['5575104433f9b0f6be42bff912f00683237d7fc4'],85,131,216,2055967,2,0.366666667,0.366666667,1,4154
e6bb82b8c192707a7f60bc190819a17ee335a3a0,1,Abhay Kulkarni,2022-03-11 15:11:29-08:00,['dec71c1ce8c0262579a85eea36e9581b49de8cd3'],8,2,10,2055977,1,0,0,0,4154
f6f04779261d89438ef408df67257d8e3d326daa,1,Mehul Parikh,2022-03-16 11:16:11+05:18,['e6bb82b8c192707a7f60bc190819a17ee335a3a0'],0,477,477,2056454,6,0.171014493,0.426086957,0.962318841,4155
9c9151e9e6b00ff5c7fe0fadf13d62b932ad2eac,0,Nitin Galave,2022-03-16 18:56:27+05:18,['f6f04779261d89438ef408df67257d8e3d326daa'],10,7,17,2056471,3,0,0,0,4155
e989bfa1c334a5204da084d501e4bec4c6b88491,0,Nitin Galave,2022-03-16 18:56:27+05:18,['9c9151e9e6b00ff5c7fe0fadf13d62b932ad2eac'],1,1,2,2056473,1,,,,4155
84691f9d46d0357b09b4a7afdfcc572aa4d18b46,0,Nitin Galave,2022-03-16 19:16:32+05:18,['e989bfa1c334a5204da084d501e4bec4c6b88491'],3,29,32,2056505,2,0.058823529,0,1,4155
1f56fa1724cb83e142967b15b17a22ec01b65d00,0,Mehul Parikh,2022-03-17 10:02:30+05:18,['84691f9d46d0357b09b4a7afdfcc572aa4d18b46'],186,788,974,2057479,7,0.186666667,0.090666667,1,4157
d2b0d3aa4b68dd8c8145b79020a2f54b79fad295,0,Mehul Parikh,2022-03-17 11:00:43+05:18,['1f56fa1724cb83e142967b15b17a22ec01b65d00'],22,103,125,2057604,3,0,0,0.418918919,4157
943a3a0bb02e7897c7b621994c244733c9dc0d2b,1,Madhan Neethiraj,2022-03-20 21:42:12-07:00,['d2b0d3aa4b68dd8c8145b79020a2f54b79fad295'],2,96,98,2057702,6,0.888888889,0.472222222,1,4157
8fc17b27d34462ba38904dd899d4b920e362f058,0,Patel,2022-03-21 13:15:14+05:18,['943a3a0bb02e7897c7b621994c244733c9dc0d2b'],1,0,1,2057703,1,,,,4157
0d076a0bae37fda198350faee09188be1673c010,0,Madhan Neethiraj,2022-03-22 00:11:17-07:00,['8fc17b27d34462ba38904dd899d4b920e362f058'],4,25,29,2057732,3,1,1,0,4157
34fd0e754e7c236f2944988851b4a2287dbed8e5,0,Mehul Parikh,2022-03-22 14:41:20+05:18,['0d076a0bae37fda198350faee09188be1673c010'],1,1,2,2057734,1,,,,4157
f66c5593ba43d7206df3043add90e967a2f5586d,0,Dhaval Shah,2022-03-22 15:32:21+05:18,['34fd0e754e7c236f2944988851b4a2287dbed8e5'],0,20,20,2057754,1,0,0,1,4157
d8fc10a36c9b23e807f8c8deaecec9bc0ae7ed05,0,Nitin Galave,2022-03-23 12:12:30+05:18,['f66c5593ba43d7206df3043add90e967a2f5586d'],9,19,28,2057782,5,1,1,1,4157
4bac134fcef728862e27bc2c63d2e491eef69226,0,Patel,2022-03-24 18:09:45+05:18,['d8fc10a36c9b23e807f8c8deaecec9bc0ae7ed05'],5,11,16,2057798,3,0,0,0,4157
a72ce30ac989fd47449dd13e6830ecdf30172aa8,1,Patel,2022-03-25 09:29:46+05:18,['4bac134fcef728862e27bc2c63d2e491eef69226'],31,13,44,2057842,4,0.9375,0.75,0,4157
3616be52fe0ba8d68b3ec724f4cd3042d34d9aee,0,Patel,2022-03-25 12:33:19+05:18,['a72ce30ac989fd47449dd13e6830ecdf30172aa8'],4,4,8,2057850,2,,,,4157
82b8e01888dfde3ad2ea4c718ff58a9d60120d39,1,Mehul Parikh,2022-03-28 14:52:22+05:18,['3616be52fe0ba8d68b3ec724f4cd3042d34d9aee'],1,1,2,2057852,1,,,,4157
d74f3fced96459ec8bc8f487b2138e4d680d3b49,0,Madhan Neethiraj,2022-03-28 23:57:54-07:00,['82b8e01888dfde3ad2ea4c718ff58a9d60120d39'],29,149,178,2058030,8,1,1,1,4157
bd4461e245c0f6f1b154c57e1ba6ef1472e5e6e3,1,Madhan Neethiraj,2022-03-30 08:13:01-07:00,['d74f3fced96459ec8bc8f487b2138e4d680d3b49'],2,32,34,2058064,2,1,1,0,4157
85cee40684a097a33c5ea5129aa8a138964b8ee7,1,Madhan Neethiraj,2022-03-31 11:10:55-07:00,['bd4461e245c0f6f1b154c57e1ba6ef1472e5e6e3'],21,293,314,2058378,18,,,,4164
1a2d41ca65e821d0621f8295524c78f87dd22b56,0,pradeep,2022-04-01 15:19:58+05:18,['85cee40684a097a33c5ea5129aa8a138964b8ee7'],72,57,129,2058507,6,1,1,0,4164
9ffa882f731a3d13c6d0bc0791b2363fb9289672,1,pradeep,2022-04-04 12:35:48+05:18,['1a2d41ca65e821d0621f8295524c78f87dd22b56'],2,2,4,2058511,1,,,,4164
7214d6d7ba90bbe377614682f6972479a7722dc5,0,Dhaval Shah,2022-04-05 13:56:41+05:18,['9ffa882f731a3d13c6d0bc0791b2363fb9289672'],1,3,4,2058515,1,1,1,1,4164
8662fb128ca43a2c5b4e0c507a216e2e769de108,0,pradeep,2022-04-06 11:17:50+05:18,['7214d6d7ba90bbe377614682f6972479a7722dc5'],4,5,9,2058524,1,,,,4164
4107b274afcba79ed14e180944eab3affb1e577e,0,Ramesh Mani,2022-04-06 17:06:54-07:00,['8662fb128ca43a2c5b4e0c507a216e2e769de108'],561,478,1039,2059563,4,1,0.923076923,1,4164
49ac30ab5bdc8465156a89783b30c960b7499682,0,pradeep,2022-04-07 09:00:41+05:18,['4107b274afcba79ed14e180944eab3affb1e577e'],29,11,40,2059603,4,1,1,1,4164
a93571daedaa45ffc98869410148cf1c55a90eaf,0,pradeep,2022-04-07 09:00:41+05:18,['49ac30ab5bdc8465156a89783b30c960b7499682'],1,1,2,2059605,1,,,,4164
758926e9ba99d3e6c9331cb8bef09058c1a660f0,0,Patel,2022-04-08 10:36:27+05:18,['a93571daedaa45ffc98869410148cf1c55a90eaf'],6,6,12,2059617,3,,,,4164
fe158d5ba36ebbb0ded649121adfa765f6b1a1d7,0,Patel,2022-04-08 12:19:06+05:18,['758926e9ba99d3e6c9331cb8bef09058c1a660f0'],1,1,2,2059619,1,,,,4164
ffd11894d818e9067d98eb48d0cb3e929f4450a9,0,Abhay Kulkarni,2022-04-11 18:36:35-07:00,['fe158d5ba36ebbb0ded649121adfa765f6b1a1d7'],16,30,46,2059665,3,0.8,0.6,1,4164
8b98899ce42e989523e50f450b9b21a8c9a559a4,0,Patel,2022-04-12 11:05:47+05:18,['ffd11894d818e9067d98eb48d0cb3e929f4450a9'],0,10,10,2059675,1,,,,4164
efcf08d9a7370a903c88cf472ca281b64970660d,0,pradeep,2022-04-12 12:21:38+05:18,['8b98899ce42e989523e50f450b9b21a8c9a559a4'],7,7,14,2059689,3,,,,4164
e5abaff2da14a8accccc8747f7f33c92e79f51eb,0,Mehul Parikh,2022-04-12 12:46:23+05:18,['efcf08d9a7370a903c88cf472ca281b64970660d'],3,68,71,2059760,3,0.0625,0.104166667,0.458333333,4164
838449630a591b4fa2a4ebce137ca8bccd3cff22,0,Patel,2022-04-14 09:38:31+05:18,['e5abaff2da14a8accccc8747f7f33c92e79f51eb'],5,229,234,2059994,14,0.408163265,0.469387755,0.979591837,4169
e39b96e47ab60927e697d65d9fb392c66588a4a1,0,Nitin Galave,2022-04-14 11:04:47+05:18,['838449630a591b4fa2a4ebce137ca8bccd3cff22'],10,42,52,2060046,5,0.964285714,1,1,4169
b0a7df141f7d3325e151fe9866eadc0437e7b151,0,Nitin Galave,2022-04-14 11:04:47+05:18,['e39b96e47ab60927e697d65d9fb392c66588a4a1'],0,7,7,2060053,5,0,0.857142857,1,4169
fd9b789d096cac79fd8892c10349115d54d0a03b,0,pradeep,2022-04-14 11:43:15+05:18,['b0a7df141f7d3325e151fe9866eadc0437e7b151'],17,72,89,2060142,3,0,0,0.12244898,4169
11d998415d196657fb760ae273a8717927b915c4,0,pradeep,2022-04-14 21:33:49+05:18,['fd9b789d096cac79fd8892c10349115d54d0a03b'],1,1,2,2060144,1,,,,4169
663bf6f7ab281c78871026a2feca5a09bc570cb7,0,pradeep,2022-04-19 00:57:46+05:18,['11d998415d196657fb760ae273a8717927b915c4'],229,5,234,2060378,14,0.591836735,0.530612245,0.020408163,4169
034cf851fb25f03ffcf9790d0a3bdd0c4f84d409,0,Patel,2022-04-19 17:22:51+05:18,['663bf6f7ab281c78871026a2feca5a09bc570cb7'],1,11,12,2060390,1,,,,4169
0fb22fae1023de515fbba3c7d795156d56aeb58b,0,pradeep,2022-04-20 22:01:05+05:18,['034cf851fb25f03ffcf9790d0a3bdd0c4f84d409'],1,9,10,2060400,3,,,,4169
5360edc02287da56df935b59bbc579ac3280b2dd,0,pradeep,2022-04-20 22:01:05+05:18,['0fb22fae1023de515fbba3c7d795156d56aeb58b'],1,1,2,2060402,1,,,,4169
6e9a8ccfec9b88abdca7d4dd2fa861c058da1356,0,Madhan Neethiraj,2022-04-20 14:41:31-07:00,['5360edc02287da56df935b59bbc579ac3280b2dd'],6,584,590,2060992,10,0.794979079,1,0.941422594,4174
d0caa3d12076a556d23a1f0a9003c1d7f9eb1efb,0,pradeep,2022-04-21 22:19:43+05:18,['6e9a8ccfec9b88abdca7d4dd2fa861c058da1356'],3,3,6,2060998,2,0,0,1,4174
c3d2b86ff5b464b67469bef0db00a4e8b485d417,0,Patel,2022-04-22 11:07:55+05:18,['d0caa3d12076a556d23a1f0a9003c1d7f9eb1efb'],1,1,2,2061000,1,,,,4174
662e3f5f621fdf94f74fe591464b500091c815bb,0,Patel,2022-04-22 17:41:18+05:18,['c3d2b86ff5b464b67469bef0db00a4e8b485d417'],5,229,234,2061234,14,0.408163265,0.469387755,0.979591837,4179
3d2becbd28cbe1048cb5e0e7138b6aa59babc9cd,1,Patel,2022-04-25 08:49:16+05:18,['662e3f5f621fdf94f74fe591464b500091c815bb'],1,1,2,2061236,1,,,,4179
ecb35c128e50478ceec5208ca098016dea260e88,0,Ramesh Mani,2022-04-25 13:54:32-07:00,['3d2becbd28cbe1048cb5e0e7138b6aa59babc9cd'],22,27,49,2061285,9,1,1,1,4179
2ebd4bb9af8abecb65548686139a1fb30358eef1,0,Patel,2022-04-27 14:02:06+05:18,['ecb35c128e50478ceec5208ca098016dea260e88'],3,3,6,2061291,1,,,,4179
8f6754b573c6bb8821ee0725aa39f1dc7c9349b0,0,Patel,2022-04-27 21:33:52+05:18,['2ebd4bb9af8abecb65548686139a1fb30358eef1'],2,2,4,2061295,1,,,,4179
a613abdc75933077317507c2229722b4d178c670,0,Mehul Parikh,2022-04-28 11:31:26+05:18,['8f6754b573c6bb8821ee0725aa39f1dc7c9349b0'],3,97,100,2061395,3,0.147058824,0.147058824,1,4179
f63aa56fa885642b00ca58d606337cfc6c009914,0,Abhay Kulkarni,2022-04-28 10:43:18-07:00,['a613abdc75933077317507c2229722b4d178c670'],15,22,37,2061432,1,,,,4179
26caf7067df9155b3cf37428c9b7278ab2b57755,0,Nitin Galave,2022-04-29 10:12:48+05:18,['f63aa56fa885642b00ca58d606337cfc6c009914'],3,267,270,2061702,13,0.998714574,0.900104058,0.769051846,4187
da896fdd9f48d84ad01ca326660521d5da5bbef9,0,pradeep,2022-04-29 17:19:39+05:18,['26caf7067df9155b3cf37428c9b7278ab2b57755'],2,46,48,2061750,2,0,0.166666667,1,4187
fb53a3dc0022020e68e4ae9edb316a58f7d0a800,0,pradeep,2022-04-29 17:20:02+05:18,['da896fdd9f48d84ad01ca326660521d5da5bbef9'],0,573,573,2062323,7,0.413793103,0.36637931,1,4193
9e62eccd3727831c209fbc2aa214582f105ad4d2,0,pradeep,2022-04-29 17:20:13+05:18,['fb53a3dc0022020e68e4ae9edb316a58f7d0a800'],1,108,109,2062432,9,0.977777778,0.977777778,1,4194
7216423e0077ad290aaf6080fe1b5a1114716dd2,0,Madhan Neethiraj,2022-05-02 13:45:22-07:00,['9e62eccd3727831c209fbc2aa214582f105ad4d2'],0,2,2,2062434,1,0,0,0,4194
bc65e780f403aa4a2e45fc4937b04ad15f638db4,0,Madhan Neethiraj,2022-05-04 13:54:33-07:00,['7216423e0077ad290aaf6080fe1b5a1114716dd2'],134,134,268,2062702,5,,,,4194
e5efe40dfa4c0e385cb04926ed230513f0ac6b0d,0,Madhan Neethiraj,2022-05-04 13:58:02-07:00,['bc65e780f403aa4a2e45fc4937b04ad15f638db4'],0,63,63,2062765,3,0,0,0.980392157,4194
9fb86ce1689161ff142bfa051e7cbc1ffa18fadb,0,Mehul Parikh,2022-05-06 11:02:47+05:18,['e5efe40dfa4c0e385cb04926ed230513f0ac6b0d'],0,257,257,2063022,3,0.297029703,0.712871287,0.485148515,4196
59a5665e7b744606abb626e1dc8f5676a5f9713f,0,Mehul Parikh,2022-05-06 11:03:36+05:18,['9fb86ce1689161ff142bfa051e7cbc1ffa18fadb'],0,94,94,2063116,3,0.147058824,0.147058824,1,4196
a8c4b57abd11ca2742a390e4292905e34b2543bc,0,pradeep,2022-05-06 20:35:24+05:18,['59a5665e7b744606abb626e1dc8f5676a5f9713f'],1,0,1,2063117,1,1,1,0,4196
466bcaae6bc97d15428d63ae28baad6f5831cecb,0,Ramesh Mani,2022-05-08 20:32:16-07:00,['a8c4b57abd11ca2742a390e4292905e34b2543bc'],1,6008,6009,2069126,34,0.548947368,0.655789474,0.595789474,4224
d43d6a3ad3f7a32435ab964fea261ffa0caf1b37,0,Patel,2022-05-09 09:15:32+05:18,['466bcaae6bc97d15428d63ae28baad6f5831cecb'],1,1,2,2069128,1,,,,4224
e2ab481d87664df10c27235374d65e9fff45fe5b,0,pradeep,2022-05-09 10:56:24+05:18,['d43d6a3ad3f7a32435ab964fea261ffa0caf1b37'],33,104,137,2069265,2,,,,4224
6e6e765191ae5686f166e3b1df010ff34ea869a4,0,Abhay Kulkarni,2022-05-09 12:37:46-07:00,['e2ab481d87664df10c27235374d65e9fff45fe5b'],1,1,2,2069267,1,,,,4224
f5e6fa8b1c12deb0b4f6bfc119d940aa42540a84,0,Abhay Kulkarni,2022-05-09 12:41:35-07:00,['6e6e765191ae5686f166e3b1df010ff34ea869a4'],1,2,3,2069270,1,,,,4224
118f6107975599b7263cbddeb9974b9b22ee792e,0,Abhay Kulkarni,2022-05-09 12:44:52-07:00,['f5e6fa8b1c12deb0b4f6bfc119d940aa42540a84'],3,17,20,2069290,2,,,,4224
87a1dc45944e10717f4d715eb3a8527ee4571d4f,0,Abhay Kulkarni,2022-05-09 14:38:40-07:00,['118f6107975599b7263cbddeb9974b9b22ee792e'],27,90,117,2069407,8,,,,4224
75e113cf7aa4f69cbc3ae3173ba96e0f5f9cdf1b,0,Patel,2022-05-10 11:40:34+05:18,['87a1dc45944e10717f4d715eb3a8527ee4571d4f'],1,1,2,2069409,1,,,,4224
2c62d8b7824351a06861d1acafc853a62dd97e4c,0,Madhan Neethiraj,2022-05-10 09:07:42-07:00,['75e113cf7aa4f69cbc3ae3173ba96e0f5f9cdf1b'],8,21,29,2069438,1,0,0.428571429,0.142857143,4224
deca982d664aa8b7d6d33a2f0d5f1ba146e98719,0,Ramesh Mani,2022-05-10 10:06:00-07:00,['2c62d8b7824351a06861d1acafc853a62dd97e4c'],6008,1,6009,2075447,34,0.451052632,0.344210526,0.404210526,4224
3c2f6127609dd032452165d2cb3d4068de4cfe47,0,pradeep,2022-05-11 00:29:03+05:18,['deca982d664aa8b7d6d33a2f0d5f1ba146e98719'],2,10,12,2075459,1,0,0,0,4224
f27d16b483a58d16d4fe70cfb72712c366868e01,0,Abhay Kulkarni,2022-05-11 12:13:02-07:00,['3c2f6127609dd032452165d2cb3d4068de4cfe47'],1,1,2,2075461,1,,,,4224
2d8e8fd2bf7688920ea418d69afc3fadaeab533f,0,Abhay Kulkarni,2022-05-11 12:13:43-07:00,['f27d16b483a58d16d4fe70cfb72712c366868e01'],1,1,2,2075463,1,,,,4224
f375e3606226e00677a95f9260e2a6e5cbc09983,0,Abhay Kulkarni,2022-05-12 10:41:09-07:00,['2d8e8fd2bf7688920ea418d69afc3fadaeab533f'],4,4,8,2075471,1,,,,4224
2f776deceaccd94ec4402679acbf528af42b1c76,0,Mehul Parikh,2022-05-13 15:29:59+05:18,['f375e3606226e00677a95f9260e2a6e5cbc09983'],10,43,53,2075524,1,0.928571429,0.928571429,1,4224
e309667d12d9bf6020712a9fadce8912bf671bd7,0,Ramesh Mani,2022-05-13 18:27:51-07:00,['2f776deceaccd94ec4402679acbf528af42b1c76'],1,4,5,2075529,1,,,,4224
5ea34fea442848398d2f7e23d839708da1061c8e,0,Madhan Neethiraj,2022-05-16 09:46:08-07:00,['e309667d12d9bf6020712a9fadce8912bf671bd7'],12,94,106,2075635,3,0.5,1,1,4224
35b61fa412889c74163f7ac427d495e0a69f68ea,0,pradeep,2022-05-17 15:34:59+05:18,['5ea34fea442848398d2f7e23d839708da1061c8e'],72,17,89,2075724,3,1,1,0.87755102,4224
ea3b88ec71431e90126fcff13b293ebb3de32359,0,pradeep,2022-05-17 16:40:49+05:18,['35b61fa412889c74163f7ac427d495e0a69f68ea'],21,76,97,2075821,3,0,0,0.12244898,4224
fbe203b55e29716fde3b037aeb336ebbae6c5cd2,0,Madhan Neethiraj,2022-05-17 08:05:42-07:00,['ea3b88ec71431e90126fcff13b293ebb3de32359'],175,70,245,2076066,2,0,0,0,4224
997168a6f7521e15a98c78db117a33a3cf0d8383,1,Ramesh Mani,2022-05-17 10:29:15-07:00,['fbe203b55e29716fde3b037aeb336ebbae6c5cd2'],1,6008,6009,2082075,34,0.548947368,0.655789474,0.595789474,4252
c51bc9fad8b0897c067dd9c392709120fd87265e,0,Ramesh Mani,2022-05-17 10:31:49-07:00,['997168a6f7521e15a98c78db117a33a3cf0d8383'],5,125,130,2082205,2,,,,4252
953f461b2bea5a6b9f3467c21d9d0616ba767bc8,0,Ramesh Mani,2022-05-17 10:34:19-07:00,['c51bc9fad8b0897c067dd9c392709120fd87265e'],0,43,43,2082248,3,,,,4253
a0224b2fdef999b3e23e2374080df94bf38557a4,0,Ramesh Mani,2022-05-17 10:37:41-07:00,['953f461b2bea5a6b9f3467c21d9d0616ba767bc8'],0,12,12,2082260,2,,,,4253
6ed7b23439e648b9db9d9705e602389eacc55942,0,Madhan Neethiraj,2022-05-17 20:59:12-07:00,['a0224b2fdef999b3e23e2374080df94bf38557a4'],3,24,27,2082287,3,0.916666667,0.916666667,1,4253
48c0551b47c41d0b9688fd3cdbf6d2c894bac82c,0,Abhay Kulkarni,2022-05-18 20:07:19-07:00,['6ed7b23439e648b9db9d9705e602389eacc55942'],2,16,18,2082305,2,0,0,0.769230769,4253
dc247d8fdb138972dadc7e9c306532dc8984ceb2,0,Madhan Neethiraj,2022-05-19 10:42:51-07:00,['48c0551b47c41d0b9688fd3cdbf6d2c894bac82c'],6,143,149,2082454,5,0.084337349,0.819277108,0.86746988,4254
667d0f4b70579db923cd17b46f3c923491e18699,0,Ramesh Mani,2022-05-30 23:40:13-07:00,['dc247d8fdb138972dadc7e9c306532dc8984ceb2'],0,7,7,2082461,3,,,,4254
9181c20c2b461ab413bad0c485d99b518352d107,0,Abhay Kulkarni,2022-05-31 08:57:39-07:00,['667d0f4b70579db923cd17b46f3c923491e18699'],19,39,58,2082519,9,,,,4254
20f021c1e642e74f99da8ebee594be21088e7fc3,0,Abhay Kulkarni,2022-05-31 09:00:31-07:00,['9181c20c2b461ab413bad0c485d99b518352d107'],182,117,299,2082818,1,0.903225806,0.903225806,0.112903226,4254
56ccd79bd2840ce9b0b1c7a40dc671f76a88975f,0,Madhan Neethiraj,2022-06-02 06:49:35-07:00,['20f021c1e642e74f99da8ebee594be21088e7fc3'],0,36,36,2082854,3,0.5,1,1,4254
d0a6d30182fe76f66c559539c0734b9e28c8c5c4,0,Abhay Kulkarni,2022-06-02 21:48:32-07:00,['56ccd79bd2840ce9b0b1c7a40dc671f76a88975f'],24,35,59,2082913,2,0,0,1,4254
e182e5b6ca9bf625101f787b4d31e07387ba6a4f,0,Mehul Parikh,2022-06-08 11:28:23+05:18,['d0a6d30182fe76f66c559539c0734b9e28c8c5c4'],6,35,41,2082954,5,0.615384615,1,1,4254
2a057768fc6a345fce013a89c72d5d67d0df666d,0,Mehul Parikh,2022-06-08 14:06:11+05:18,['e182e5b6ca9bf625101f787b4d31e07387ba6a4f'],7,40,47,2083001,1,0.928571429,0.928571429,1,4254
ab096438cf44d1464f32081b4a087b365e57d6dd,0,pradeep,2022-06-08 17:35:49+05:18,['2a057768fc6a345fce013a89c72d5d67d0df666d'],1,1,2,2083003,1,,,,4254
c6306212a97b79d5de32a3a82a872e1945fd070c,0,Madhan Neethiraj,2022-06-14 09:04:35-07:00,['ab096438cf44d1464f32081b4a087b365e57d6dd'],5,0,5,2083008,1,,,,4254
baa903e206e72aa2c391e14c2f83b31cbcb0829e,0,pradeep,2022-06-15 01:32:23+05:18,['c6306212a97b79d5de32a3a82a872e1945fd070c'],1,1,2,2083010,1,,,,4254
f1e5f4b850c93370bcc3b97b782534389eba59d8,0,Ramesh Mani,2022-06-14 23:00:59-07:00,['baa903e206e72aa2c391e14c2f83b31cbcb0829e'],61,13,74,2083084,1,1,1,1,4254
37c664864f96b3cf45b0220f5d4d8e26f7e0251b,0,pradeep,2022-06-15 17:13:05+05:18,['f1e5f4b850c93370bcc3b97b782534389eba59d8'],5,3,8,2083092,1,,,,4254
7c39ffde573c33b86fe49b0c235e2b4c5fd6435b,0,pradeep,2022-06-15 17:49:36+05:18,['37c664864f96b3cf45b0220f5d4d8e26f7e0251b'],1,1,2,2083094,1,,,,4254
2980d5a763e8087708f20c27efc3df7d4d9e8a02,0,pradeep,2022-06-16 09:51:29+05:18,['7c39ffde573c33b86fe49b0c235e2b4c5fd6435b'],4,4,8,2083102,1,,,,4254
5c486a7fa3f585b1e9ed74cc0739f9576dda27db,0,Mehul Parikh,2022-06-20 13:00:34+05:18,['2980d5a763e8087708f20c27efc3df7d4d9e8a02'],4,4,8,2083110,1,,,,4254
d7541959d5263d97c5cbee07295bc7958571bbc3,0,Mehul Parikh,2022-06-23 10:58:29+05:18,['5c486a7fa3f585b1e9ed74cc0739f9576dda27db'],2,1,3,2083113,1,,,,4254
83b7d0fe0b158d73d54bca24d122994c94f82117,0,Patel,2022-06-23 16:34:44+05:18,['d7541959d5263d97c5cbee07295bc7958571bbc3'],2,7,9,2083122,2,1,1,0,4254
c1e577ce8e401525711c391dbfffacb8ce20daba,0,Patel,2022-06-23 16:39:20+05:18,['83b7d0fe0b158d73d54bca24d122994c94f82117'],5,5,10,2083132,2,,,,4254
81b928c8956e2f8d5bf68d451c74f83abc01c48a,0,pradeep,2022-06-23 18:23:55+05:18,['c1e577ce8e401525711c391dbfffacb8ce20daba'],6,33,39,2083171,4,0,0.666666667,1,4254
fc7ad98fbb2ee7bb7d4cd3329abc438a73e0444a,0,pradeep,2022-06-24 12:12:04+05:18,['81b928c8956e2f8d5bf68d451c74f83abc01c48a'],10,46,56,2083227,1,0.035714286,0,1,4254
dfab947ddd71391a22342f0421754ad3cec0a0e1,0,Madhan Neethiraj,2022-06-27 15:14:01-07:00,['fc7ad98fbb2ee7bb7d4cd3329abc438a73e0444a'],347,3681,4028,2087255,26,0.135135135,0.207207207,0.630630631,4257
d247fece1055555d926b4487cfd43fcefedad94c,0,pradeep,2022-06-28 11:17:42+05:18,['dfab947ddd71391a22342f0421754ad3cec0a0e1'],0,3,3,2087258,1,0,0,1,4257
ef641366b861afb7a6451023e6a76ba35aea3f19,0,pradeep,2022-06-28 11:46:08+05:18,['d247fece1055555d926b4487cfd43fcefedad94c'],2,5,7,2087265,1,0,0,1,4257
711a266d2d176920c857b97308f46df2df563f20,0,Madhan Neethiraj,2022-06-28 10:18:57-07:00,['ef641366b861afb7a6451023e6a76ba35aea3f19'],2,31,33,2087298,2,0,1,1,4257
710e7c763e8deebc24b7d8109fe8ef17618f0651,0,Madhan Neethiraj,2022-06-28 10:40:43-07:00,['711a266d2d176920c857b97308f46df2df563f20'],3,6,9,2087307,2,,,,4257
bb64aa4f7db0a2280b0597f70895f0c8f749a6a1,0,Madhan Neethiraj,2022-07-05 19:07:16-07:00,['710e7c763e8deebc24b7d8109fe8ef17618f0651'],3,3,6,2087313,2,,,,4257
29038c4f811125681bdfa3dd347cbcfc44f7bd5e,0,Madhan Neethiraj,2022-07-05 19:18:01-07:00,['bb64aa4f7db0a2280b0597f70895f0c8f749a6a1'],4,39,43,2087356,6,0,1,1,4257
ad472b3738c2424f62a81087937ab358e3efc0f9,0,Madhan Neethiraj,2022-07-08 00:13:08-07:00,['29038c4f811125681bdfa3dd347cbcfc44f7bd5e'],9,56,65,2087421,3,0,0,0.666666667,4257
157587fdb2f81b6785f9943561ac741dd22027c2,0,Ramesh Mani,2022-07-09 00:53:03-07:00,['ad472b3738c2424f62a81087937ab358e3efc0f9'],1,12,13,2087434,2,,,,4257
4e55f5ff2c9e5c1d451aa7928f9e43b98e949e3e,0,Patel,2022-07-12 09:18:32+05:18,['157587fdb2f81b6785f9943561ac741dd22027c2'],4,4,8,2087442,2,,,,4257
2e568a4fc3935c90a998fc7ca01389e1d82bf702,0,Patel,2022-07-12 09:19:00+05:18,['4e55f5ff2c9e5c1d451aa7928f9e43b98e949e3e'],1,1,2,2087444,1,,,,4257
057bba4f570998d1ead6d4c23f7b24a41e7f1e51,0,Madhan Neethiraj,2022-07-12 08:27:44-07:00,['2e568a4fc3935c90a998fc7ca01389e1d82bf702'],1,56,57,2087501,2,0.833333333,1,1,4258
f59f3a7e47ed3673d62df6c2f74450185f6e3b02,0,pradeep,2022-07-12 22:26:38+05:18,['057bba4f570998d1ead6d4c23f7b24a41e7f1e51'],48,35,83,2087584,1,1,1,1,4258
0ec279474e0439f6c5e7d4497db191fb7cc99bc1,0,Ramesh Mani,2022-07-13 10:02:07-07:00,['f59f3a7e47ed3673d62df6c2f74450185f6e3b02'],179,238,417,2088001,7,0,0.842105263,0.736842105,4258
3ce8112e723e65c93de092f6a14a418383abc8d0,0,Sailaja Polavarapu,2022-07-13 16:30:07-07:00,['0ec279474e0439f6c5e7d4497db191fb7cc99bc1'],5,21,26,2088027,2,0.166666667,0.166666667,0,4258
e10a247cccb9db324a0ddbe3b53c3dcb4b271ad4,0,pradeep,2022-07-14 20:28:41+05:18,['3ce8112e723e65c93de092f6a14a418383abc8d0'],2,2,4,2088031,1,,,,4258
c51fedfba9efb61c1ff7bf9b41f4db4b965fe1a7,0,pradeep,2022-07-22 12:06:29+05:18,['e10a247cccb9db324a0ddbe3b53c3dcb4b271ad4'],83,51,134,2088165,1,0.777777778,1,0.111111111,4258
79e96286bbb63aa85ba99d5403db617f3f57c03f,0,Ramesh Mani,2022-07-22 23:10:34-07:00,['c51fedfba9efb61c1ff7bf9b41f4db4b965fe1a7'],12,32,44,2088209,1,0,1,0,4258
8875a7eabbfbaccd454864ac85bf280da6ed12b8,0,Madhan Neethiraj,2022-07-23 17:51:51-07:00,['79e96286bbb63aa85ba99d5403db617f3f57c03f'],9,10,19,2088228,2,1,1,,4258
3bd591fbd1f0434b47263c2d99cf634f5ace8dd0,0,pradeep,2022-07-25 12:31:31+05:18,['8875a7eabbfbaccd454864ac85bf280da6ed12b8'],1,1,2,2088230,1,,,,4258
76349ecaea86f36bd5908151f2ec50943b67ab21,0,Ramesh Mani,2022-07-27 00:04:07-07:00,['3bd591fbd1f0434b47263c2d99cf634f5ace8dd0'],1,0,1,2088231,1,,,,4258
