sha,is_bug,committer_name,commit_time,parents,all_del,all_add,all_change_lines,all_lines,files_change_nums,dmm_unit_size,dmm_unit_complexity,dmm_unit_interfacing,file_nums
5ff71e51f650c74636b17653fcc5172a653eab65,1,Chris Riccomini,2013-08-12 09:19:28-07:00,[],0,25647,25647,25647,304,0.622695347,0.773266023,0.867208077,304
8be96fa1f161f7c87ef416ba6a02ae2f0469d263,1,Chris Riccomini,2013-08-12 09:24:13-07:00,['5ff71e51f650c74636b17653fcc5172a653eab65'],2,2,4,25651,1,,,,304
0fd909237e58c88a2eaa8a027a3a98671d0c5297,1,Chris Riccomini,2013-08-12 09:35:05-07:00,['8be96fa1f161f7c87ef416ba6a02ae2f0469d263'],14,8,22,25673,4,,,,304
795db24664249f7a810a7ace65a19f9636b06e82,1,Chris Riccomini,2013-08-12 09:36:07-07:00,['0fd909237e58c88a2eaa8a027a3a98671d0c5297'],4,5,9,25682,1,,,,304
f2d660844c4aeff2ce40bb2f946f23b22218249c,0,Chris Riccomini,2013-08-12 09:43:44-07:00,['795db24664249f7a810a7ace65a19f9636b06e82'],7,7,14,25696,3,,,,304
1af23c1b9455913b037dfa3127c7747a991ee78c,0,Chris Riccomini,2013-08-12 10:01:24-07:00,['f2d660844c4aeff2ce40bb2f946f23b22218249c'],1,1,2,25698,1,,,,304
62d1a14c955a1cada8aa5d266f75499e4c14d078,0,Chris Riccomini,2013-08-12 14:49:58-07:00,['1af23c1b9455913b037dfa3127c7747a991ee78c'],0,11,11,25709,1,,,,304
bdd4868d84ca9bf8fc191e7d4f21ebde453603ff,1,Chris Riccomini,2013-08-12 15:06:40-07:00,['62d1a14c955a1cada8aa5d266f75499e4c14d078'],42,32,74,25783,8,,,,305
61af7c34944c18040dcf4a23b53d1d423591a3dc,0,Chris Riccomini,2013-08-12 19:09:13-07:00,['bdd4868d84ca9bf8fc191e7d4f21ebde453603ff'],3,3,6,25789,1,,,,305
e6e97389710f0758fc1d0eb5a4968496f8521cae,0,Chris Riccomini,2013-08-16 21:11:14-07:00,['61af7c34944c18040dcf4a23b53d1d423591a3dc'],7,3,10,25799,1,,,,305
9e952ac3d8deb49de9f0c6958e4673617298899b,1,Chris Riccomini,2013-08-19 18:28:42-07:00,['e6e97389710f0758fc1d0eb5a4968496f8521cae'],28,28,56,25855,4,,,,305
f93f7eabe278c4a81b5fcf699b1d480fb9e2f3b7,0,Chris Riccomini,2013-08-22 16:48:58-07:00,['9e952ac3d8deb49de9f0c6958e4673617298899b'],95,0,95,25950,1,,,,305
ff6073d9b447ef5d86442b457fc20ae13335da13,0,Chris Riccomini,2013-08-23 16:07:02-07:00,['f93f7eabe278c4a81b5fcf699b1d480fb9e2f3b7'],1,1,2,25952,1,,,,305
f59be90682fbc99adb0bef220a5e919d876d5ead,0,Chris Riccomini,2013-08-27 15:47:17-07:00,['ff6073d9b447ef5d86442b457fc20ae13335da13'],2,9,11,25963,1,0,0,1,305
251b42deaa04718c93edce69bdf44951ec816342,1,Chris Riccomini,2013-08-28 09:53:04-07:00,['ff6073d9b447ef5d86442b457fc20ae13335da13'],12,13,25,25988,6,,,,305
c587a3513947c4c8c31176a99debff16cc436b18,0,Chris Riccomini,2013-08-28 10:14:03-07:00,['f59be90682fbc99adb0bef220a5e919d876d5ead'],3,4,7,25995,2,1,1,1,305
c688d86ffe52b9a1d187e992657eb054b847a6e0,0,Chris Riccomini,2013-08-28 10:18:56-07:00,"['251b42deaa04718c93edce69bdf44951ec816342', 'c587a3513947c4c8c31176a99debff16cc436b18']",4,12,16,26011,2,,,,305
71f030ee4ae74a30ffa7a933b24ea25eab54486d,0,Chris Riccomini,2013-08-28 10:21:48-07:00,['c688d86ffe52b9a1d187e992657eb054b847a6e0'],1,2,3,26014,1,,,,305
39cf91efc44d756df5db294f49ae9cf4a8c93b52,1,Chris Riccomini,2013-08-28 12:47:05-07:00,['251b42deaa04718c93edce69bdf44951ec816342'],2,9,11,26025,1,0,0,1,305
4ec463b35e71f470e5b296f1ec65bb5866f495c4,0,Chris Riccomini,2013-08-28 12:47:05-07:00,['39cf91efc44d756df5db294f49ae9cf4a8c93b52'],3,4,7,26032,2,1,1,1,305
922c3df89239005851711b054c1bd2e0e0ffa9f5,1,Chris Riccomini,2013-08-28 12:47:06-07:00,['4ec463b35e71f470e5b296f1ec65bb5866f495c4'],34,54,88,26120,9,0.9,1,1,305
c942c28d958ab1e14db2c93367dd9ce5173c3b0f,0,Chris Riccomini,2013-08-28 12:48:51-07:00,"['922c3df89239005851711b054c1bd2e0e0ffa9f5', '71f030ee4ae74a30ffa7a933b24ea25eab54486d']",0,0,0,26120,0,,,,305
8dcfbb8a544fcde3b934e63e2a52edc10abeba16,1,Chris Riccomini,2013-09-02 09:33:19-07:00,['c942c28d958ab1e14db2c93367dd9ce5173c3b0f'],92,117,209,26329,14,,,,305
d03cce078e9a03ec63c6e84ab531b18c36cffbf9,1,Jay Kreps,2013-09-05 17:08:18-07:00,['8dcfbb8a544fcde3b934e63e2a52edc10abeba16'],44,201,245,26574,3,,,,307
0ac53dc5df25d63bd2a830b854181ef42d1c751a,1,Jay Kreps,2013-09-09 13:00:36-07:00,['d03cce078e9a03ec63c6e84ab531b18c36cffbf9'],6,8,14,26588,1,,,,307
ecbebc6e55eab4841414add77a9a7816fd13a82a,1,Jay Kreps,2013-09-11 17:27:55-07:00,['0ac53dc5df25d63bd2a830b854181ef42d1c751a'],25,38,63,26651,2,,,,308
711af423b6e89bc818790f2daaa1874f8292d48b,0,Chris Riccomini,2013-09-19 09:22:19-07:00,['ecbebc6e55eab4841414add77a9a7816fd13a82a'],1,1,2,26653,1,,,,308
819b9960ad155b87c093b0bd3f68855885674078,0,Chris Riccomini,2013-09-19 09:26:06-07:00,['711af423b6e89bc818790f2daaa1874f8292d48b'],1,1,2,26655,1,,,,308
bb0abb670892806d46c64d158cabae8990aceb09,1,Chris Riccomini,2013-09-20 14:52:21-07:00,['819b9960ad155b87c093b0bd3f68855885674078'],278,908,1186,27841,38,0.672222222,0.922222222,0.961111111,319
7bbde2cc288050231c565d308c00cea4287cab4f,1,Chris Riccomini,2013-10-04 15:09:40-07:00,['bb0abb670892806d46c64d158cabae8990aceb09'],26,2458,2484,30325,29,0.405405405,0.528957529,0.806949807,334
79a4376d09e4a8187571f8ac65e41dc75e2aea18,1,Chris Riccomini,2013-10-07 12:46:02-07:00,['7bbde2cc288050231c565d308c00cea4287cab4f'],5,25,30,30355,4,,,,335
ef95569f8cec240cb0214012e5f6b15b8f4d4f6f,1,Chris Riccomini,2013-10-07 12:49:12-07:00,['79a4376d09e4a8187571f8ac65e41dc75e2aea18'],27,37,64,30419,2,1,1,1,335
d5478c2a8d3b84d7e6b9104f87b3a6f1379af683,0,Jakob Glen Homan,2013-10-07 14:26:12-07:00,['ef95569f8cec240cb0214012e5f6b15b8f4d4f6f'],5,0,5,30424,1,,,,335
cb31cb1bf866f0eb3be35b6d4c59acbffcaaeba7,0,Chris Riccomini,2013-10-08 11:22:08-07:00,['d5478c2a8d3b84d7e6b9104f87b3a6f1379af683'],2,20,22,30446,1,0.583333333,1,1,335
e949c810b517a1fb1c01fdc8fd74221de8e076ed,1,Chris Riccomini,2013-10-11 15:22:53-07:00,['cb31cb1bf866f0eb3be35b6d4c59acbffcaaeba7'],2,46,48,30494,2,1,1,1,336
0c3a3ac7bee94d969fcfb184fab1513ab7c6f602,1,Chris Riccomini,2013-10-14 12:18:27-07:00,['e949c810b517a1fb1c01fdc8fd74221de8e076ed'],0,84,84,30578,2,1,1,1,338
63cc71c5f750b8af615e85d46ab35871f6e777b2,1,Chris Riccomini,2013-10-14 12:52:03-07:00,['0c3a3ac7bee94d969fcfb184fab1513ab7c6f602'],1,1,2,30580,1,,,,338
2cd18279c61c92597ad6d2892b1f01b5106ffcb1,1,Chris Riccomini,2013-10-15 15:01:07-07:00,['63cc71c5f750b8af615e85d46ab35871f6e777b2'],6,20,26,30606,3,0,1,1,338
4217fc7f9dd951c2c84b89e06daf8a1b4b0a420f,1,Chris Riccomini,2013-10-22 13:14:25-07:00,['2cd18279c61c92597ad6d2892b1f01b5106ffcb1'],250,234,484,31090,14,0.465116279,0.302325581,0.325581395,338
dbe35de84cc556ae8dff82ca196aeca8909e6b25,0,Chris Riccomini,2013-10-23 09:24:47-07:00,['4217fc7f9dd951c2c84b89e06daf8a1b4b0a420f'],1,3,4,31094,1,,,,338
965bc9338ce8d59192e3abc350cfc7f62a87dbef,1,Chris Riccomini,2013-10-23 11:11:23-07:00,['dbe35de84cc556ae8dff82ca196aeca8909e6b25'],2,7,9,31103,1,0,0,1,338
4e6f1ca5d9c68e5a0a3e14ff1d5089d9a184e1e9,1,Chris Riccomini,2013-10-23 11:16:33-07:00,['965bc9338ce8d59192e3abc350cfc7f62a87dbef'],4,2,6,31109,1,,,,338
32d51a018db71087da8bb72a933ed594601e5b7a,1,Chris Riccomini,2013-10-23 12:19:39-07:00,['4e6f1ca5d9c68e5a0a3e14ff1d5089d9a184e1e9'],2,4,6,31115,2,,,,338
8ea21df752d980c32b1f0c48f6d536ef83e913d5,0,Chris Riccomini,2013-10-23 14:25:10-07:00,['32d51a018db71087da8bb72a933ed594601e5b7a'],2,2,4,31119,1,,,,338
d486de6d8a91e21d9954accce1f95066a865501d,1,Chris Riccomini,2013-10-29 13:06:23-07:00,['8ea21df752d980c32b1f0c48f6d536ef83e913d5'],1,91,92,31211,3,,,,339
f58e09d60c686ad86e1d98c4cbf70bb4e856702e,0,Chris Riccomini,2013-10-30 09:20:30-07:00,['d486de6d8a91e21d9954accce1f95066a865501d'],0,1,1,31212,1,,,,339
7375e32347b4cd151fb34f2e2c636f853444d611,1,Chris Riccomini,2013-10-31 08:07:37-07:00,['f58e09d60c686ad86e1d98c4cbf70bb4e856702e'],18,33,51,31263,9,,,,339
ac11fd92ddb5fc4ceed1aed1bd4de783ee7ed631,0,Chris Riccomini,2013-11-01 10:08:35-07:00,['7375e32347b4cd151fb34f2e2c636f853444d611'],1,5,6,31269,1,,,,339
49134a47bc6916c1ab705ac21b8a97d11d211c8c,1,Jakob Glen Homan,2013-11-11 11:03:26-08:00,['ac11fd92ddb5fc4ceed1aed1bd4de783ee7ed631'],3,3,6,31275,1,1,1,0,339
c512da98cb39f2614c4a379612406d66e53838fa,1,Chris Riccomini,2013-11-21 10:48:07-08:00,['49134a47bc6916c1ab705ac21b8a97d11d211c8c'],4,80,84,31359,3,,,,340
8028d8deb60f94eda383c5f33eba2cd23e8553c4,0,Chris Riccomini,2013-11-22 09:49:54-08:00,['c512da98cb39f2614c4a379612406d66e53838fa'],3,3,6,31365,2,,,,340
65fbc6866e7fd1403a64d3048ac2f0e628f4d0b7,1,Chris Riccomini,2013-11-26 08:16:29-08:00,['8028d8deb60f94eda383c5f33eba2cd23e8553c4'],12,24,36,31401,6,,,,340
39010dbc570a09aed3ca896923b94c302f0d524b,0,Jakob Homan,2013-11-26 13:14:35-08:00,['65fbc6866e7fd1403a64d3048ac2f0e628f4d0b7'],0,19,19,31420,1,,,,340
527113b40b106927b775aaecdf73e5c6fcbcbff9,1,Jakob Homan,2013-12-02 11:00:41-08:00,['39010dbc570a09aed3ca896923b94c302f0d524b'],2,61,63,31483,2,0.272727273,1,1,341
e899784618e45a8b304b7277003dba1003c01e74,1,Jakob Homan,2013-12-02 13:06:38-08:00,['527113b40b106927b775aaecdf73e5c6fcbcbff9'],180,247,427,31910,6,0.227848101,1,0.962025316,341
2ec5eb8d0d55fda20d9cea5625b67897f548bfcd,1,Jakob Homan,2013-12-02 14:38:33-08:00,['e899784618e45a8b304b7277003dba1003c01e74'],0,60,60,31970,1,1,1,0.909090909,342
4bf3f5eb0d2fbbfebc2fdeb6f38bd9b55de61597,1,Chris Riccomini,2013-12-03 09:37:23-08:00,['2ec5eb8d0d55fda20d9cea5625b67897f548bfcd'],8,132,140,32110,3,0.017857143,0.946428571,1,342
c988f4f408303f6c7946e8f8b0229617128b2fe0,0,Jakob Homan,2013-12-08 15:24:15-08:00,['4bf3f5eb0d2fbbfebc2fdeb6f38bd9b55de61597'],2,2,4,32114,1,,,,342
dca9555ed4afebb16d10377b41d8e7d727a053b9,1,Chris Riccomini,2013-12-09 12:21:26-08:00,['c988f4f408303f6c7946e8f8b0229617128b2fe0'],26,71,97,32211,5,0.090909091,1,1,343
9a04ec85b2bc4e5caf4a2aee7a08b2ba48040105,0,Chris Riccomini,2013-12-09 12:41:37-08:00,['dca9555ed4afebb16d10377b41d8e7d727a053b9'],0,19,19,32230,1,,,,343
ae78017076f77077b6b1bf6436ac62d9a1084b90,1,Chris Riccomini,2013-12-10 12:10:39-08:00,['9a04ec85b2bc4e5caf4a2aee7a08b2ba48040105'],0,5,5,32235,1,1,1,1,343
a268b7e0ba763d639fb01513fdc39ac5a4ef1edd,0,Chris Riccomini,2013-12-10 12:38:31-08:00,['ae78017076f77077b6b1bf6436ac62d9a1084b90'],9,9,18,32253,4,,,1,343
04d00f5a4291f54b2e64d555d7ef7f9641011c19,1,Chris Riccomini,2013-12-10 15:09:33-08:00,['a268b7e0ba763d639fb01513fdc39ac5a4ef1edd'],71,153,224,32477,5,1,1,1,344
75711b4f1b0d71e4f1e9829f07b2c19e3e4eb47b,0,Jakob Homan,2013-12-12 11:55:30-08:00,['04d00f5a4291f54b2e64d555d7ef7f9641011c19'],9,9,18,32495,4,,,0,344
01caadbca9e80b72efe404b7f2a5c689588e849e,0,Jakob Homan,2013-12-12 12:00:42-08:00,['75711b4f1b0d71e4f1e9829f07b2c19e3e4eb47b'],1,7,8,32503,1,1,1,0.75,344
b694e7adecb8dc326e8b96cc51b32603ffd4d9f2,1,Jakob Homan,2013-12-12 16:37:04-08:00,['01caadbca9e80b72efe404b7f2a5c689588e849e'],109,224,333,32836,11,0.578125,0.984375,1,345
53d9df7facd4d13144708934b77feca74db0651c,1,Chris Riccomini,2013-12-17 10:14:15-08:00,['b694e7adecb8dc326e8b96cc51b32603ffd4d9f2'],1,30,31,32867,1,,,,345
df6bd392acb5dd1600d191a5157dd6cd54519463,0,Jakob Glen Homan,2013-12-20 13:15:55-08:00,['53d9df7facd4d13144708934b77feca74db0651c'],1,1,2,32869,1,,,,345
bda8df6e21c02060831ca05a1a23af1685f0ea07,1,Chris Riccomini,2014-01-02 10:02:01-08:00,['df6bd392acb5dd1600d191a5157dd6cd54519463'],12,12,24,32893,4,,,1,345
9b360405c598a95e08c41f75a29742b9f20bbcee,1,Chris Riccomini,2014-01-02 15:15:19-08:00,['bda8df6e21c02060831ca05a1a23af1685f0ea07'],75,620,695,33588,9,0.850746269,0.850746269,0.753731343,349
7c5411686540caab08cfa7a4b03d87b1ce8dd691,0,Chris Riccomini,2014-01-03 12:16:47-08:00,['9b360405c598a95e08c41f75a29742b9f20bbcee'],34,13,47,33635,3,,,,349
8ee3abb647d9174e1596f7ea6ce1c47866a23d94,1,Chris Riccomini,2014-01-06 10:18:20-08:00,['7c5411686540caab08cfa7a4b03d87b1ce8dd691'],8,8,16,33651,6,,,,349
4dec9e736cf6dbff48ab80fc48d8a6de1d6bc7c3,0,Chris Riccomini,2014-01-07 09:03:06-08:00,['8ee3abb647d9174e1596f7ea6ce1c47866a23d94'],2,7,9,33660,2,1,1,0,349
ba8ed30d564bac80fdeb7a24433174aee383e6ff,1,Chris Riccomini,2014-01-07 12:21:00-08:00,['4dec9e736cf6dbff48ab80fc48d8a6de1d6bc7c3'],11,10,21,33681,4,,,,349
1df6792e92754c2480d5e0a6cf507db6eda70c63,1,Jakob Glen Homan,2014-01-08 13:36:06-08:00,['ba8ed30d564bac80fdeb7a24433174aee383e6ff'],41,30,71,33752,5,0.5,0,0.5,349
bf6a0eb37e3e5f6d7e657579e0a2bffa0e00d1db,0,Jakob Glen Homan,2014-01-08 13:39:05-08:00,['1df6792e92754c2480d5e0a6cf507db6eda70c63'],4,1,5,33757,1,0,0,0,349
388b992fd358f52258afc04ac67e894db24add41,1,Chris Riccomini,2014-01-09 13:34:58-08:00,['bf6a0eb37e3e5f6d7e657579e0a2bffa0e00d1db'],8,32,40,33797,3,0.055555556,1,1,349
a0d938f5194b39703e2b1a26f794125b79e0b3ec,0,Chris Riccomini,2014-01-09 14:24:43-08:00,['388b992fd358f52258afc04ac67e894db24add41'],4,2,6,33803,1,,,,349
ac7f32c8c69a493ed82ececf723ac569a8dadd2d,1,Chris Riccomini,2014-01-09 16:16:38-08:00,['a0d938f5194b39703e2b1a26f794125b79e0b3ec'],3,4,7,33810,1,1,0,0,349
c64dfda7f2df40a21521b49f79c4eec862c257c7,1,Chris Riccomini,2014-01-15 09:18:05-08:00,['ac7f32c8c69a493ed82ececf723ac569a8dadd2d'],63,36,99,33909,13,0,1,1,352
21c07c8e3b061149ebb4c097d7e02f1b6c2c5e4c,0,Jakob Homan,2014-01-16 14:47:52-08:00,['c64dfda7f2df40a21521b49f79c4eec862c257c7'],1,67,68,33977,6,,,,352
083ade1817af9809977a2801a0e55e0b787318ab,1,Chris Riccomini,2014-01-21 15:09:18-08:00,['21c07c8e3b061149ebb4c097d7e02f1b6c2c5e4c'],13,105,118,34095,2,1,1,0.6,353
9af91314e344f04a5655e352043bcb7b68acad15,1,Chris Riccomini,2014-01-21 15:09:49-08:00,['083ade1817af9809977a2801a0e55e0b787318ab'],1,1,2,34097,1,,,,353
f63ce72ade2390eec091ade5f77e22eb768733d2,0,Jakob Homan,2014-01-21 15:22:30-08:00,['21c07c8e3b061149ebb4c097d7e02f1b6c2c5e4c'],16,133,149,34246,12,,,,353
fe8df637341af1f0af3b7a384f3aa73abdec36e7,0,Jakob Homan,2014-01-21 15:23:20-08:00,"['f63ce72ade2390eec091ade5f77e22eb768733d2', '9af91314e344f04a5655e352043bcb7b68acad15']",14,106,120,34366,3,,,,353
48b946c0d1470c51ea61ea5d509c1b35c949752c,1,Chris Riccomini,2014-01-23 13:59:34-08:00,['fe8df637341af1f0af3b7a384f3aa73abdec36e7'],6,14,20,34386,5,1,1,1,353
86492c430967d53d1f519129a997a3bbf5222a2f,1,Chris Riccomini,2014-01-24 09:17:14-08:00,['48b946c0d1470c51ea61ea5d509c1b35c949752c'],0,1,1,34387,1,0,1,1,353
5264cbb0f7a4c9bcbf613878f2148bbabb0ae486,0,Chris Riccomini,2014-01-30 10:24:00-08:00,['86492c430967d53d1f519129a997a3bbf5222a2f'],6,135,141,34528,1,,,,353
15c4587b43d1e7c097aa97fb2b5487458bdc1b72,0,Chris Riccomini,2014-02-03 09:23:13-08:00,['5264cbb0f7a4c9bcbf613878f2148bbabb0ae486'],1,5,6,34534,1,,,,353
afc2fb7af974aa7780f8ea57a202fe7202780548,1,Chris Riccomini,2014-02-06 09:51:33-08:00,['15c4587b43d1e7c097aa97fb2b5487458bdc1b72'],4,71,75,34609,5,1,1,1,354
5709b27ffe86d928e291ea500a5c9afc14bb42e5,1,Jakob Homan,2014-02-06 11:41:45-08:00,['afc2fb7af974aa7780f8ea57a202fe7202780548'],10,5,15,34624,3,0.333333333,0,0,354
830a23e17efe9b432a2517edc11b4e93b0b22807,1,Chris Riccomini,2014-02-10 12:02:23-08:00,['5709b27ffe86d928e291ea500a5c9afc14bb42e5'],2,4,6,34630,1,1,1,1,354
bf1904d64389412fd20d942c625741c621cb4938,1,Chris Riccomini,2014-02-10 14:51:08-08:00,['830a23e17efe9b432a2517edc11b4e93b0b22807'],2,141,143,34773,4,0.222222222,1,0.777777778,356
c12965ddcaa8a5b9ce9d893392c2c924392ff8ef,1,Chris Riccomini,2014-02-10 15:09:30-08:00,['bf1904d64389412fd20d942c625741c621cb4938'],130,158,288,35061,12,,,,356
30a606370a7bdd0db0449b160f7de9d0862c301e,1,Chris Riccomini,2014-02-12 20:11:01-08:00,['c12965ddcaa8a5b9ce9d893392c2c924392ff8ef'],1,29,30,35091,2,,,,356
5cdbd02b8df1b10195e8b10e786a69c310d12433,1,Jakob Glen Homan,2014-02-13 11:28:34-08:00,['30a606370a7bdd0db0449b160f7de9d0862c301e'],24,170,194,35285,6,0.734375,1,1,358
1852e6149eb1c9c9f96d9b1e5dd10020279224ae,1,Chris Riccomini,2014-02-21 10:42:10-08:00,['5cdbd02b8df1b10195e8b10e786a69c310d12433'],36,84,120,35405,7,0,0.9,0.55,359
6cbe515a3740e9c3b009ab44d37dd523eadad4ad,0,Chris Riccomini,2014-02-21 13:14:41-08:00,['1852e6149eb1c9c9f96d9b1e5dd10020279224ae'],262,766,1028,36433,17,0.1,0.857894737,0.873684211,361
04745c6abd58c80c01fa01e68a41de26829abb88,1,Chris Riccomini,2014-02-21 13:24:14-08:00,['6cbe515a3740e9c3b009ab44d37dd523eadad4ad'],766,262,1028,37461,17,0.9,0.142105263,0.126315789,362
49a473a0c82042a1fc79eab1de7bff79f2feb207,1,Chris Riccomini,2014-02-21 13:48:41-08:00,['04745c6abd58c80c01fa01e68a41de26829abb88'],262,766,1028,38489,17,0.1,0.857894737,0.873684211,364
33308ed47738a00f60da953e9a7eebff94e24d49,0,Chris Riccomini,2014-02-24 10:53:59-08:00,['49a473a0c82042a1fc79eab1de7bff79f2feb207'],15,4,19,38508,1,,,,364
3af899a2cf0c8e2c9f2998f1a43f60238e2c1b4c,0,Chris Riccomini,2014-02-25 12:22:58-08:00,['33308ed47738a00f60da953e9a7eebff94e24d49'],1,1,2,38510,1,,,,364
533b17e4c773be676ebc4fbcf948686801182afa,1,Chris Riccomini,2014-02-25 13:57:54-08:00,['3af899a2cf0c8e2c9f2998f1a43f60238e2c1b4c'],127,213,340,38850,23,0,0.555555556,0,364
ed2358e0a1155be3ab9d91809fcbb269ade8eb58,0,Garry Turkington,2014-02-25 22:31:22+00:00,['533b17e4c773be676ebc4fbcf948686801182afa'],1,0,1,38851,1,,,,364
2c368bdb82e6ee324692f6ac2a48936f59d92bbe,0,Garry Turkington,2014-02-26 14:01:23+00:00,['ed2358e0a1155be3ab9d91809fcbb269ade8eb58'],0,19,19,38870,1,,,,364
534e9f548241f71c8e9ed303becdf02019688dd0,1,Jakob Homan,2014-02-27 17:32:38-08:00,['2c368bdb82e6ee324692f6ac2a48936f59d92bbe'],0,116,116,38986,3,0.925,0.925,1,366
f50f022c7d0fbe648412c26c9d6dc677e7758006,1,Chris Riccomini,2014-02-28 09:26:54-08:00,['534e9f548241f71c8e9ed303becdf02019688dd0'],46,55,101,39087,6,1,0,0,366
c3c06431f18e1b348009e0a4f73304377370d5d7,1,Chris Riccomini,2014-02-28 12:40:12-08:00,['f50f022c7d0fbe648412c26c9d6dc677e7758006'],2,2,4,39091,2,,,,366
2fa280022030b6caa900e62898f77547621a0a82,1,Jakob Homan,2014-02-28 13:20:11-08:00,['c3c06431f18e1b348009e0a4f73304377370d5d7'],13,6,19,39110,7,,,,366
d364a5f703d3db9c839702de107f0515139fcc6f,1,Chris Riccomini,2014-02-28 13:57:43-08:00,['2fa280022030b6caa900e62898f77547621a0a82'],9,6,15,39125,1,,,,366
046ae23bab8f61cdd1e2644c6ee4f9210608e2d7,1,Garry Turkington,2014-03-03 22:33:42+00:00,['d364a5f703d3db9c839702de107f0515139fcc6f'],0,72,72,39197,2,1,1,1,368
d38277ff83956f5885dd6596db9c0e15761964c7,0,Garry Turkington,2014-03-03 23:46:25+00:00,['046ae23bab8f61cdd1e2644c6ee4f9210608e2d7'],3,18,21,39218,2,,,,368
28ac01d145fce741f753a3cad3f6bea8bbc3c0bf,0,Chris Riccomini,2014-03-04 14:58:32-08:00,['d38277ff83956f5885dd6596db9c0e15761964c7'],0,1,1,39219,1,,,,368
74b56d639fed608f6a2e05541ae5a299683b63d3,0,Chris Riccomini,2014-03-04 15:32:57-08:00,['28ac01d145fce741f753a3cad3f6bea8bbc3c0bf'],0,1,1,39220,1,,,,368
f5741125a17f7875054f8c2d9419743d3da111d5,1,Jakob Glen Homan,2014-03-04 16:24:11-08:00,['74b56d639fed608f6a2e05541ae5a299683b63d3'],10,19,29,39249,2,,,,368
5ae02859552778193e4247daa65a00414a8708c1,1,Chris Riccomini,2014-03-05 11:04:27-08:00,['f5741125a17f7875054f8c2d9419743d3da111d5'],114,107,221,39470,6,0.5,0.5,1,370
55929095f5abc0911278ca8336bccbc835122c84,1,Jakob Homan,2014-03-05 12:40:16-08:00,['5ae02859552778193e4247daa65a00414a8708c1'],12,43,55,39525,1,,,,370
12594fb710260b62f9a21a8be785bd8dd5dcdd01,1,Chris Riccomini,2014-03-05 15:55:16-08:00,['55929095f5abc0911278ca8336bccbc835122c84'],14,37,51,39576,3,0.363636364,0,0.272727273,370
38e82883236de40a544d9f7a18cf49c7238dc258,1,Chris Riccomini,2014-03-06 13:10:37-08:00,['12594fb710260b62f9a21a8be785bd8dd5dcdd01'],19,66,85,39661,3,0.857142857,1,1,370
048ffd2fee118b5d15ca9fd962477ee8a1dc67c8,1,Chris Riccomini,2014-03-10 09:31:19-07:00,['38e82883236de40a544d9f7a18cf49c7238dc258'],32,40,72,39733,2,,,,370
c932c50298bdd8cd6022286d364aa6daaaaa5667,1,Chris Riccomini,2014-03-13 12:48:35-07:00,['048ffd2fee118b5d15ca9fd962477ee8a1dc67c8'],0,57,57,39790,2,,,,371
782a0923652b712af84d81dc6688a3880ab040b7,1,Chris Riccomini,2014-03-13 14:06:14-07:00,['c932c50298bdd8cd6022286d364aa6daaaaa5667'],2,3,5,39795,1,,,,371
3a6f2555aa92d47dd85b54f3f1503719c08d31a7,1,Chris Riccomini,2014-03-13 14:08:46-07:00,['782a0923652b712af84d81dc6688a3880ab040b7'],118,737,855,40650,15,0.972477064,1,0.788990826,373
2811c2a758dd2d387ed4ca25c757516dfcece70b,1,Chris Riccomini,2014-03-13 17:11:07-07:00,['3a6f2555aa92d47dd85b54f3f1503719c08d31a7'],737,118,855,41505,15,0.027522936,0,0.211009174,373
9dc5aa2d4fc16691c74ece398896056c3d086040,1,Chris Riccomini,2014-03-14 13:01:49-07:00,['2811c2a758dd2d387ed4ca25c757516dfcece70b'],124,835,959,42464,17,1,1,0.836206897,376
2e7b91b20d0660fe127778d3a1bdca44e16c1245,1,Martin Kleppmann,2014-03-18 00:28:16+00:00,['9dc5aa2d4fc16691c74ece398896056c3d086040'],15,24,39,42503,6,,,,376
f503123929da77b944e3c4a1b2394f53ee09adc5,0,Jakob Homan,2014-03-18 12:10:03-07:00,['2e7b91b20d0660fe127778d3a1bdca44e16c1245'],9,0,9,42512,1,0.166666667,0.166666667,0,376
891a6f8efc5348db3fd186a0dc47e62a0e7c7af5,1,Jakob Homan,2014-03-18 22:02:21-07:00,['f503123929da77b944e3c4a1b2394f53ee09adc5'],3,3,6,42518,2,,,,376
bfd97fce0719fc662cd456c90c6c01f1a0017c15,0,Jakob Homan,2014-03-18 23:29:09-07:00,['891a6f8efc5348db3fd186a0dc47e62a0e7c7af5'],30,31,61,42579,3,1,1,0,376
464a7e27d436b526ad210ec8d0e8e5223ac328f2,1,Jakob Glen Homan,2014-03-19 12:17:40-07:00,['bfd97fce0719fc662cd456c90c6c01f1a0017c15'],6,9,15,42594,2,,,,376
df6e11afc3a0bc981d98281d0c5cdde8f5a56e73,1,Jakob Homan,2014-03-19 14:09:24-07:00,['464a7e27d436b526ad210ec8d0e8e5223ac328f2'],13,300,313,42907,27,,,,376
f2fcb26a33b59da58a852fe81564d60407aa758c,1,Martin Kleppmann,2014-03-20 23:43:45+00:00,['df6e11afc3a0bc981d98281d0c5cdde8f5a56e73'],314,482,796,43703,10,0.580246914,1,0,376
085a8b4b6b425a5cbdfbb115e3b39d19a90d9825,0,Chris Riccomini,2014-03-20 20:59:19-07:00,['f2fcb26a33b59da58a852fe81564d60407aa758c'],1,5,6,43709,1,,,,376
89939a6c91798ae28dbfd552cb7b2dea9efc3d3f,1,Martin Kleppmann,2014-03-21 17:02:07+00:00,['085a8b4b6b425a5cbdfbb115e3b39d19a90d9825'],23,23,46,43755,12,0,1,1,376
decfa3ab511d77d626f797f6743f49fde7178b30,1,Martin Kleppmann,2014-03-22 14:27:17+00:00,['89939a6c91798ae28dbfd552cb7b2dea9efc3d3f'],3,15,18,43773,5,,,,376
8cd3ff12d12da31aba454cd7881d7bbaa3a3a881,0,Chris Riccomini,2014-03-22 13:55:40-07:00,['decfa3ab511d77d626f797f6743f49fde7178b30'],0,1,1,43774,1,1,1,1,376
c96ecc68bf67d919e8d42265acc70fd4b5ea0b51,1,Chris Riccomini,2014-03-24 10:26:17-07:00,['8cd3ff12d12da31aba454cd7881d7bbaa3a3a881'],37,37,74,43848,3,,,,376
429c1edb38b20fb20358062d831b1b9463a7ec9b,1,Jakob Homan,2014-03-24 14:02:38-07:00,['c96ecc68bf67d919e8d42265acc70fd4b5ea0b51'],82,43,125,43973,5,0.68,0,0,376
87f19fcd0ba38124fd231ac314d056180643931b,0,Chris Riccomini,2014-03-25 09:19:14-07:00,['429c1edb38b20fb20358062d831b1b9463a7ec9b'],46,92,138,44111,5,1,1,1,377
a6210778617c1cf5e23fbc2338cc01a5f82e465f,1,Chris Riccomini,2014-03-25 09:24:27-07:00,['87f19fcd0ba38124fd231ac314d056180643931b'],92,46,138,44249,5,0,0,0,377
bbb5a65c19413e8697f8a0872b1f61d894c43b1f,1,Chris Riccomini,2014-03-25 09:39:19-07:00,['a6210778617c1cf5e23fbc2338cc01a5f82e465f'],46,96,142,44391,5,1,1,1,378
e32595bf89e49bfedad579650bad8b8f268a7f1a,0,Chris Riccomini,2014-03-25 10:33:14-07:00,['bbb5a65c19413e8697f8a0872b1f61d894c43b1f'],3,4,7,44398,1,,,,378
1c28f2eaf8ac51af417ef9a6959b32436bd23cd3,0,Chris Riccomini,2014-03-26 11:40:47-07:00,['e32595bf89e49bfedad579650bad8b8f268a7f1a'],1,0,1,44399,1,,,,378
39f9fd06eb9736802fab1f0fb4bc340a546d45b1,1,Jakob Homan,2014-03-27 09:10:50-07:00,['1c28f2eaf8ac51af417ef9a6959b32436bd23cd3'],3,3,6,44405,3,,,,378
10c6338a0f87249d69361226a364796fc5fc162c,1,Jakob Glen Homan,2014-03-27 14:40:10-07:00,['39f9fd06eb9736802fab1f0fb4bc340a546d45b1'],1,1,2,44407,1,,,,378
4d0ad620b7879ae6d051a34766a65cd8e5554b63,1,Chris Riccomini,2014-04-01 10:16:45-07:00,['10c6338a0f87249d69361226a364796fc5fc162c'],13,17,30,44437,2,0,0,0,378
7d7ba7fbc1300c90ed762d8ee5bde800e72bd776,1,Martin Kleppmann,2014-04-02 18:57:21+01:00,['4d0ad620b7879ae6d051a34766a65cd8e5554b63'],49,412,461,44898,9,1,1,0.897435897,382
e66706934ab65889bf141da54f9b3b417573ff6e,1,Chris Riccomini,2014-04-02 15:03:27-07:00,['7d7ba7fbc1300c90ed762d8ee5bde800e72bd776'],0,160,160,45058,2,,,,383
6a7c14e241464ed97057e4242c71f022381d490f,0,Chris Riccomini,2014-04-03 18:17:14-07:00,['e66706934ab65889bf141da54f9b3b417573ff6e'],0,19,19,45077,1,,,,383
bd2fb6776ddaf41e3a6b80adab75656505ee72d7,1,Chris Riccomini,2014-04-05 15:02:23-07:00,['6a7c14e241464ed97057e4242c71f022381d490f'],1,1,2,45079,1,,,,383
4e5573b172a76e8d1413efb4152f2976ea54304f,1,Chris Riccomini,2014-04-07 08:34:32-07:00,['bd2fb6776ddaf41e3a6b80adab75656505ee72d7'],256,230,486,45565,11,0.4,0,1,383
45a33f1fb1642ff0a88fc57ec4f92b238702ac91,0,Martin Kleppmann,2014-04-07 09:18:52-07:00,['4e5573b172a76e8d1413efb4152f2976ea54304f'],0,5,5,45570,1,,,,383
b4a323d167066f42fb5a3f4baeae80dd95013f1f,0,Chris Riccomini,2014-04-07 11:19:19-07:00,['45a33f1fb1642ff0a88fc57ec4f92b238702ac91'],2,9,11,45581,1,,,,383
4b8514f226cc75ca663f81954f4683f61638a80b,1,Martin Kleppmann,2014-04-07 14:00:01-07:00,['b4a323d167066f42fb5a3f4baeae80dd95013f1f'],42,264,306,45887,6,0.185185185,0.962962963,0.814814815,386
7b42045726151eba85efa39d7739d29ae84adad7,1,Martin Kleppmann,2014-04-07 14:17:58-07:00,['4b8514f226cc75ca663f81954f4683f61638a80b'],3,3,6,45893,1,,,,386
b3b485cce56dec3522d86f708c1a55e92d8e1a82,0,Jakob Homan,2014-04-07 18:40:01-07:00,['7b42045726151eba85efa39d7739d29ae84adad7'],0,0,0,45893,1,,,,386
73fea8d630ff8bc2c16ddac2f3a4acf4a61fdb54,0,Jakob Homan,2014-04-08 22:41:45-07:00,['b3b485cce56dec3522d86f708c1a55e92d8e1a82'],3,0,3,45896,1,1,0,1,386
80bf782049bf2bfb6fb431cf83ee77da14701c04,0,Jakob Homan,2014-04-08 22:43:56-07:00,['73fea8d630ff8bc2c16ddac2f3a4acf4a61fdb54'],0,19,19,45915,1,,,,386
74232e2f4fd0551451bf4c3acfe9109c61f4e611,1,Chris Riccomini,2014-04-15 15:55:24-07:00,['80bf782049bf2bfb6fb431cf83ee77da14701c04'],26,93,119,46034,4,1,1,0.939393939,386
392b4c4d81330968cc2e98264b1dcc4cb15b43af,0,Zhijie Shen,2014-04-20 00:10:09-07:00,['74232e2f4fd0551451bf4c3acfe9109c61f4e611'],0,5,5,46039,1,,,,386
156d4a4f74232646cb8dfca3d35566cc1a652f74,0,Jakob Homan,2014-04-21 14:09:24-07:00,['392b4c4d81330968cc2e98264b1dcc4cb15b43af'],1,1,2,46041,1,,,,386
47edbc3a28a269269f2ef4494b2f6c89a6c46450,1,Chris Riccomini,2014-04-22 12:31:53-07:00,['156d4a4f74232646cb8dfca3d35566cc1a652f74'],0,54,54,46095,2,0.769230769,0.769230769,1,386
bbb0b123523e0e050a70ba8fea47438933a9ee46,0,Chris Riccomini,2014-04-22 13:12:03-07:00,['47edbc3a28a269269f2ef4494b2f6c89a6c46450'],10,0,10,46105,2,,,,386
73d604c43812aa30a079bfaf278bcfed10579191,1,Chris Riccomini,2014-04-22 13:17:08-07:00,['bbb0b123523e0e050a70ba8fea47438933a9ee46'],52,62,114,46219,2,,,,387
5c5a95c33b4e254108c25eecd6bf0a7786bd4d4f,1,Chris Riccomini,2014-04-22 14:18:54-07:00,['73d604c43812aa30a079bfaf278bcfed10579191'],65,353,418,46637,3,1,1,0.692307692,389
06b3698d78cc049ba8640ef0a2c29f1f634f0f8c,1,Jakob Homan,2014-04-22 14:54:54-07:00,['5c5a95c33b4e254108c25eecd6bf0a7786bd4d4f'],1,1,2,46639,1,,,,389
ac4feb22fac7b8a082facd5b27bdf86d9144310e,0,Chris Riccomini,2014-04-23 09:28:32-07:00,['06b3698d78cc049ba8640ef0a2c29f1f634f0f8c'],4,52,56,46695,1,0,1,0.25,389
b285feebf29cfce949fb2fa4745bfd861bf31414,1,Chris Riccomini,2014-04-25 12:42:18-07:00,['ac4feb22fac7b8a082facd5b27bdf86d9144310e'],1,5,6,46701,1,,,,389
92f387f133a67da57f6afee323701c050c5bbf98,1,Chris Riccomini,2014-04-25 15:36:06-07:00,['b285feebf29cfce949fb2fa4745bfd861bf31414'],1,1,2,46703,1,,,,389
f3cb109245693d4b08c92e21de85b507bd4d3f70,1,Chris Riccomini,2014-04-30 12:25:30-07:00,['92f387f133a67da57f6afee323701c050c5bbf98'],6,251,257,46960,7,0.228915663,0.987951807,0.734939759,391
354bcdb77bc8d4d1b0efdf9ca405916c7399075a,1,Jakob Homan,2014-05-01 14:50:51-07:00,['f3cb109245693d4b08c92e21de85b507bd4d3f70'],1,51,52,47012,2,1,1,1,391
300ad6a8cfdd22f5a75260afd3a0e6fa87797b61,1,Zhijie Shen,2014-05-01 20:29:06-07:00,['354bcdb77bc8d4d1b0efdf9ca405916c7399075a'],10,63,73,47085,7,1,1,1,392
a796813279e25ac9b5cf47e9675daa9395fba2f2,0,Chris Riccomini,2014-05-05 09:21:12-07:00,['300ad6a8cfdd22f5a75260afd3a0e6fa87797b61'],2,2,4,47089,1,,,,392
cca93bd2d7ad5e8ea57867b919008ef406704b95,0,Chris Riccomini,2014-05-05 12:20:17-07:00,['a796813279e25ac9b5cf47e9675daa9395fba2f2'],3,3,6,47095,1,,,,392
d956e8581885fbeeeab0d4c186f50343b393fa08,1,Chris Riccomini,2014-05-13 14:05:02-07:00,['cca93bd2d7ad5e8ea57867b919008ef406704b95'],0,65,65,47160,3,,,,393
f076c33c123400a6cd899e564065d33fafb67f88,1,Chris Riccomini,2014-05-13 15:04:45-07:00,['d956e8581885fbeeeab0d4c186f50343b393fa08'],106,1022,1128,48288,27,1,0.783783784,0.840540541,413
783b05a637465eef4a177beabbc3e116a7353b37,0,Chris Riccomini,2014-05-20 09:26:53-07:00,['f076c33c123400a6cd899e564065d33fafb67f88'],1,1,2,48290,1,,,,413
873ea69117f4989522f03602514a8fe6acae2ea2,1,Martin Kleppmann,2014-05-20 18:25:47+01:00,['783b05a637465eef4a177beabbc3e116a7353b37'],129,476,605,48895,15,0,0,0,415
4601fdfc2bdcc14a3263ebe5f26d9f0e02fa5abb,0,Martin Kleppmann,2014-05-23 15:30:17+01:00,['873ea69117f4989522f03602514a8fe6acae2ea2'],12,65,77,48972,2,0,0,1,416
494feb0a5f8bb922b6f289ab18e842a0e225c5a9,1,Chris Riccomini,2014-05-23 10:03:47-07:00,['4601fdfc2bdcc14a3263ebe5f26d9f0e02fa5abb'],272,1304,1576,50548,28,1,0.823843416,0.887900356,440
95cee714ef1d017f948233396ca663064df28ab4,1,Chris Riccomini,2014-05-23 11:18:04-07:00,['494feb0a5f8bb922b6f289ab18e842a0e225c5a9'],0,627,627,51175,6,0.42962963,0.585185185,0.8,446
7929e47c27d480d9987357d5532b10d983b7ee32,1,Chris Riccomini,2014-05-29 08:53:02-07:00,['95cee714ef1d017f948233396ca663064df28ab4'],1,29,30,51205,2,,,,446
16be583608c8f0de97141f2524720ba6c5ee61fa,0,Zhijie Shen,2014-05-29 21:32:55-07:00,['7929e47c27d480d9987357d5532b10d983b7ee32'],3,11,14,51219,4,1,1,1,446
f68716d563a2fbdf5f5cdb0de331ca867a072517,0,Chris Riccomini,2014-05-30 10:19:53-07:00,['16be583608c8f0de97141f2524720ba6c5ee61fa'],4,2,6,51225,3,1,0,1,446
39592d49a510e5baaa62d8cb00e08ba4a292ee40,1,Chris Riccomini,2014-06-04 15:42:49-07:00,['f68716d563a2fbdf5f5cdb0de331ca867a072517'],1,1,2,51227,1,,,,446
409ced1f6f4bce134d6136195ba6b611d6c2f206,1,Martin Kleppmann,2014-06-05 20:42:31+01:00,['39592d49a510e5baaa62d8cb00e08ba4a292ee40'],4,4,8,51235,1,,,,446
acf6b6a2749a8b49216747612b1f8dad7c912de9,1,Martin Kleppmann,2014-06-05 22:14:58+01:00,['409ced1f6f4bce134d6136195ba6b611d6c2f206'],12,12,24,51259,7,,,,446
a037d6f25030c2fc11b09ab78d1d4cc122a76c4c,0,Chris Riccomini,2014-06-05 14:46:26-07:00,['acf6b6a2749a8b49216747612b1f8dad7c912de9'],1,0,1,51260,1,,,,446
c72223f994bd73523049238a9e2347bca7bd9f18,1,Martin Kleppmann,2014-06-09 21:14:23+01:00,['a037d6f25030c2fc11b09ab78d1d4cc122a76c4c'],594,648,1242,52502,31,,,,450
868fc7ade3a84a2bbef9970f9cebb9dd956cadd3,1,Chris Riccomini,2014-06-09 15:59:10-07:00,['c72223f994bd73523049238a9e2347bca7bd9f18'],15,64,79,52581,7,0.344827586,1,1,450
f4aa1f103f68dd03dc8db66c46625db460ea73d6,1,Jakob Homan,2014-06-10 15:56:33-07:00,['868fc7ade3a84a2bbef9970f9cebb9dd956cadd3'],0,214,214,52795,1,,,,451
b03acea2734c3ba1f487185850d853d3700f452d,1,Jakob Homan,2014-06-11 09:07:29-07:00,['f4aa1f103f68dd03dc8db66c46625db460ea73d6'],0,5,5,52800,1,,,,452
41403ab378e001027f40091e3fe906dfc438dab4,1,Jakob Homan,2014-06-11 09:23:12-07:00,['b03acea2734c3ba1f487185850d853d3700f452d'],1,980,981,53781,60,,,,452
aaf0f64c45530219c4ec6ee6a163a34015d2fbc9,0,Jakob Homan,2014-06-11 12:42:13-07:00,['41403ab378e001027f40091e3fe906dfc438dab4'],4,0,4,53785,1,,,,452
11566ab7acd05d321ac6d22821f8d2c578e3c121,1,Chris Riccomini,2014-06-11 14:27:16-07:00,['aaf0f64c45530219c4ec6ee6a163a34015d2fbc9'],0,12,12,53797,2,0.666666667,0.666666667,1,452
bb82797e9e1e8eb26a07d873f0ffbd6b23c51451,1,Chris Riccomini,2014-06-11 16:12:29-07:00,['11566ab7acd05d321ac6d22821f8d2c578e3c121'],1,8,9,53806,1,,,,452
31c64f671fb86c66e5130dd06bff3179c2b6605b,0,Chris Riccomini,2014-06-13 09:43:49-07:00,['bb82797e9e1e8eb26a07d873f0ffbd6b23c51451'],4,1,5,53811,1,,,,452
f236734b7a7078e50234e0bb37877fa3de489cba,1,Chris Riccomini,2014-06-13 10:54:41-07:00,['31c64f671fb86c66e5130dd06bff3179c2b6605b'],1,5,6,53817,1,,,,452
5abdf2b039cc6afcb1b0df506eb5d56aa815e3f8,1,Martin Kleppmann,2014-06-13 23:13:15+01:00,['f236734b7a7078e50234e0bb37877fa3de489cba'],2,87,89,53906,5,,,,453
011975f0e0a8f9559ecfdfa560b49a6e49658b3d,1,Jakob Homan,2014-06-13 16:14:41-07:00,['f236734b7a7078e50234e0bb37877fa3de489cba'],3,107,110,54016,8,,,,455
2ff8fe87029cf073be199bae63e70df9873d0d1a,0,Jakob Homan,2014-06-13 16:15:17-07:00,"['011975f0e0a8f9559ecfdfa560b49a6e49658b3d', '5abdf2b039cc6afcb1b0df506eb5d56aa815e3f8']",2,87,89,54105,5,,,,455
5b54d163568e64290688ec3728b150cfaebb2c6d,0,Jakob Homan,2014-06-16 10:16:26-07:00,['2ff8fe87029cf073be199bae63e70df9873d0d1a'],0,50,50,54155,1,,,,456
bad2deb4a2e891fd690f32af96426917adba38ac,1,Jakob Homan,2014-06-17 09:37:34-07:00,['5b54d163568e64290688ec3728b150cfaebb2c6d'],340,350,690,54845,5,,,,456
0705a0b690d1fcbd083c8877179cd68fb7ed7c0f,0,Yan Fang,2014-06-17 23:27:18-07:00,['bad2deb4a2e891fd690f32af96426917adba38ac'],1,1,2,54847,1,,,,456
edcecedc15dfcca4a98b2c96a51b4f34a94229ed,0,Jakob Homan,2014-06-18 10:58:51-07:00,['0705a0b690d1fcbd083c8877179cd68fb7ed7c0f'],34,0,34,54881,1,0,0,0,456
64da867b27ef810a0cc7cc55b13934e6b6708c95,1,Jakob Homan,2014-06-18 11:09:04-07:00,['edcecedc15dfcca4a98b2c96a51b4f34a94229ed'],0,3,3,54884,1,,,,456
f703f97d6aa05597eb42a1be4d726bab6d6e3122,1,Martin Kleppmann,2014-06-18 11:44:47-07:00,['64da867b27ef810a0cc7cc55b13934e6b6708c95'],85,13,98,54982,7,0,0,0,456
8c6002e58fa30cd428624232f44b1815f157e996,1,Martin Kleppmann,2014-06-18 17:41:06-07:00,['f703f97d6aa05597eb42a1be4d726bab6d6e3122'],255,1109,1364,56346,2,,,,456
83c1cf4399df2d2c698cd2fee8b3e5d07a94864d,0,Jakob Homan,2014-06-18 17:59:25-07:00,['8c6002e58fa30cd428624232f44b1815f157e996'],93,278,371,56717,49,0,0,0,456
c788b828c4d19a3691a4f5016b10be37993a5476,1,Yan Fang,2014-06-19 21:24:19-07:00,['83c1cf4399df2d2c698cd2fee8b3e5d07a94864d'],1,1,2,56719,1,,,,456
c642effaec53240a7d944aa36f33b6cfa5fbe848,0,Yan Fang,2014-06-19 23:16:27-07:00,['c788b828c4d19a3691a4f5016b10be37993a5476'],0,5,5,56724,1,,,,456
d913037a878c2530b9fb5c7090116f57f49b5eaf,1,Jakob Homan,2014-06-23 13:42:48-07:00,['c642effaec53240a7d944aa36f33b6cfa5fbe848'],478,654,1132,57856,28,,,,457
702e62483c73660710befcacb2972eea72738d16,1,Martin Kleppmann,2014-06-24 22:54:02+01:00,['d913037a878c2530b9fb5c7090116f57f49b5eaf'],16,90,106,57962,5,,,,459
2c957e7079023faef175f95823ae9e98ea6fb2ff,1,Jakob Homan,2014-06-25 09:49:36-07:00,['702e62483c73660710befcacb2972eea72738d16'],5,3,8,57970,4,,,,459
47c955d5def16793084572e892f33113ee0fa0ab,1,Martin Kleppmann,2014-06-25 17:59:13+01:00,['2c957e7079023faef175f95823ae9e98ea6fb2ff'],13,11,24,57994,1,,,,459
ed6e6e56391e6108a8ab53c1241b2d6e3e0bd0e0,1,Martin Kleppmann,2014-06-26 17:51:50+01:00,['47c955d5def16793084572e892f33113ee0fa0ab'],1,1,2,57996,1,,,,459
4f189128e6cc9c8d87fbe14afed01149a810cda5,0,Garry Turkington,2014-06-30 09:23:21+01:00,['ed6e6e56391e6108a8ab53c1241b2d6e3e0bd0e0'],1,1,2,57998,1,,,,459
2aad5c4c84efe74a953f443616b87e9e69ab14e9,1,Martin Kleppmann,2014-06-30 19:58:26+01:00,['4f189128e6cc9c8d87fbe14afed01149a810cda5'],1,91,92,58090,4,,,,459
7fd52e8700b34e2aa37095edafab3b9aba3b4690,1,Yan Fang,2014-06-30 23:06:36-07:00,['2aad5c4c84efe74a953f443616b87e9e69ab14e9'],4,62,66,58156,8,,,,460
76754f098194f5122868b8bfa2ea3e77230bcd24,1,Chris Riccomini,2014-07-01 15:02:27-07:00,['7fd52e8700b34e2aa37095edafab3b9aba3b4690'],32,18,50,58206,4,,,,460
dd13c3d20f6ab510d0111999d5c2011d1f44db14,1,Chris Riccomini,2014-07-09 09:30:06-07:00,['76754f098194f5122868b8bfa2ea3e77230bcd24'],16,33,49,58255,1,,,,460
9652e6412f668bcd738b02caf77fe685fd56b46f,0,Jakob Homan,2014-07-09 13:06:56-07:00,['dd13c3d20f6ab510d0111999d5c2011d1f44db14'],45,377,422,58677,6,,,,462
8edb3fed7960808b154367666f370439df64b5ca,1,Chris Riccomini,2014-07-09 13:43:15-07:00,['9652e6412f668bcd738b02caf77fe685fd56b46f'],0,5,5,58682,2,1,1,1,462
46bc23b926419751c546d1f59c1c241b56d5cbce,1,Chris Riccomini,2014-07-10 14:07:52-07:00,['8edb3fed7960808b154367666f370439df64b5ca'],138,471,609,59291,22,0.903225806,0.758064516,0.677419355,467
fd5ee548a1966b6679212cd1a09a2d8ec60acdda,0,Chris Riccomini,2014-07-10 14:51:16-07:00,['46bc23b926419751c546d1f59c1c241b56d5cbce'],1,1,2,59293,1,,,,467
7d1a01c7b0a6fc97496f09430d2de883242728a9,0,Jakob Homan,2014-07-11 09:23:37-07:00,['fd5ee548a1966b6679212cd1a09a2d8ec60acdda'],0,45,45,59338,1,,,,467
e0ce7ec00aa3aa5caae7ac8408bc7491b68cb438,1,Yan Fang,2014-07-14 09:41:55-07:00,['7d1a01c7b0a6fc97496f09430d2de883242728a9'],14,227,241,59579,9,0,0,1,468
ffb2827844eaa6eaf91bfc213988e6d37b58ccd6,0,Jakob Homan,2014-07-14 11:25:08-07:00,['e0ce7ec00aa3aa5caae7ac8408bc7491b68cb438'],9,19,28,59607,1,,,,468
610ee8492e0ef537d8a109262bd1ed65aeac1eb8,0,Jakob Homan,2014-07-14 14:22:48-07:00,['ffb2827844eaa6eaf91bfc213988e6d37b58ccd6'],3,35,38,59645,2,0.307692308,0.307692308,1,468
40bbe4da58e8990044ea2ecb65cdd79fb71bdcd2,0,Yan Fang,2014-07-16 09:51:49-07:00,['610ee8492e0ef537d8a109262bd1ed65aeac1eb8'],31,2,33,59678,1,,,,468
5aef56f4c169be354be1dda2ce6126cb67c83009,1,Chris Riccomini,2014-07-17 12:41:29-07:00,['40bbe4da58e8990044ea2ecb65cdd79fb71bdcd2'],8,119,127,59805,7,0.696428571,1,1,468
c06d8cda4d4ff0cefda2bb07a6b1e8b4d4a6fe2a,0,Chris Riccomini,2014-07-23 13:57:39-07:00,['5aef56f4c169be354be1dda2ce6126cb67c83009'],1,1,2,59807,2,,,,468
48f48a8226af2322db5351f9e36b71308a6111e1,0,Yan Fang,2014-07-23 21:59:25-07:00,['c06d8cda4d4ff0cefda2bb07a6b1e8b4d4a6fe2a'],1,107,108,59915,3,,,,469
deb99e57f0b9b365169124a84a85e48884bb8f5a,0,Jakob Homan,2014-07-24 09:17:49-07:00,['5aef56f4c169be354be1dda2ce6126cb67c83009'],7,6,13,59928,1,,,,469
5c65b03a4ddaf675a662e070ff3137e7e3cec271,0,Jakob Homan,2014-07-24 09:18:16-07:00,"['deb99e57f0b9b365169124a84a85e48884bb8f5a', '48f48a8226af2322db5351f9e36b71308a6111e1']",2,108,110,60038,5,,,,469
7cecf0aef9fb968b0851746bdb01eaca1dc81050,1,Chris Riccomini,2014-07-24 15:40:49-07:00,['5c65b03a4ddaf675a662e070ff3137e7e3cec271'],746,453,1199,61237,19,0.139534884,0.11627907,0.093023256,469
da79b6f92f44f44ca7649fbca20cc5389b28e29f,1,Jakob Homan,2014-07-28 15:11:57-07:00,['7cecf0aef9fb968b0851746bdb01eaca1dc81050'],857,2335,3192,64429,65,0.837362637,0.859340659,0.171428571,485
3a8e2f9d1d126cff84b791dd11d624bba8d5c80b,1,Chris Riccomini,2014-07-29 15:01:04-07:00,['da79b6f92f44f44ca7649fbca20cc5389b28e29f'],21,133,154,64583,13,,,,486
2c1391f6721c90e0a004ee25f746e2d627ccf2a0,1,Chris Riccomini,2014-07-30 15:58:40-07:00,['3a8e2f9d1d126cff84b791dd11d624bba8d5c80b'],35,39,74,64657,14,,,,486
cc11e02dd3d1e5aff3e8e766d908431b98219161,0,Chris Riccomini,2014-07-30 16:05:27-07:00,['2c1391f6721c90e0a004ee25f746e2d627ccf2a0'],0,2,2,64659,1,,,,486
97476e322f048c578973e8249359d04a5d533678,1,Chris Riccomini,2014-07-31 14:20:31-07:00,['cc11e02dd3d1e5aff3e8e766d908431b98219161'],80,160,240,64899,12,0,1,1,487
38d659b33565900e96822ac85e4e0a644ac38a66,1,Chris Riccomini,2014-07-31 14:48:34-07:00,['97476e322f048c578973e8249359d04a5d533678'],4,6,10,64909,1,,,,487
e603a27947ed0940167c72ae4fbd8eacd8c7fcbf,1,Yan Fang,2014-08-04 23:48:02-07:00,['38d659b33565900e96822ac85e4e0a644ac38a66'],4,675,679,65588,18,0.96069869,1,0.986899563,494
3f3d80eb466dc42567f3fbf07834b35bc4f958b6,1,Chris Riccomini,2014-08-05 09:34:46-07:00,['e603a27947ed0940167c72ae4fbd8eacd8c7fcbf'],3,318,321,65909,7,0.744186047,1,1,497
5bd081146d5365d10e5c1d0bc06ce8145ed246f4,0,Chris Riccomini,2014-08-05 09:40:12-07:00,['3f3d80eb466dc42567f3fbf07834b35bc4f958b6'],2,2,4,65913,1,,,,497
8acef467ff6f929fa0b3be0f8b52b3f18a67c815,0,Chris Riccomini,2014-08-05 09:55:48-07:00,['5bd081146d5365d10e5c1d0bc06ce8145ed246f4'],5,7,12,65925,1,,,,497
3964ce73530fac3d658b088e1f005054bc7214d1,1,Yan Fang,2014-08-07 23:01:17-07:00,['8acef467ff6f929fa0b3be0f8b52b3f18a67c815'],48,139,187,66112,4,,,,498
39387ec85365fe2d080e10252e41fc6bc6d67881,1,Chris Riccomini,2014-08-08 10:46:05-07:00,['3964ce73530fac3d658b088e1f005054bc7214d1'],1,1,2,66114,1,,,,498
cd17b265ef1941ab7887dfa097e23284b884dc27,0,Chris Riccomini,2014-08-08 10:53:20-07:00,['39387ec85365fe2d080e10252e41fc6bc6d67881'],1,1,2,66116,1,,,,498
8dd3a140fad90d541879b6f474231ca1e7ce8962,0,Chris Riccomini,2014-08-08 15:50:03-07:00,['cd17b265ef1941ab7887dfa097e23284b884dc27'],1,1,2,66118,1,,,,498
fa03273c93c84892afe4522ff53015b0e7a5760e,1,Chris Riccomini,2014-08-14 10:46:29-07:00,['8dd3a140fad90d541879b6f474231ca1e7ce8962'],13,12,25,66143,3,,,,498
1e2cfe22ea0eb0fd2d4e935bfd9b5d45a503d1bd,1,Yan Fang,2014-08-14 22:21:47-07:00,['fa03273c93c84892afe4522ff53015b0e7a5760e'],438,28462,28900,95043,200,,,,625
5cfb13ebdd779bbd59b240e3f9a5fd854715a6ab,0,Chris Riccomini,2014-08-15 09:41:02-07:00,['1e2cfe22ea0eb0fd2d4e935bfd9b5d45a503d1bd'],2,0,2,95045,1,,,,625
82aa01fa6a38a1831828279d0f21ed5ea499d1a0,0,Chris Riccomini,2014-08-15 15:37:23-07:00,['5cfb13ebdd779bbd59b240e3f9a5fd854715a6ab'],0,2,2,95047,1,,,,625
3b15e54d41d2ed02c2f381a5d55b9765f94343ba,1,Yan Fang,2014-08-15 16:01:22-07:00,['82aa01fa6a38a1831828279d0f21ed5ea499d1a0'],1,28,29,95076,1,,,,625
41d17568d3bec61d85d1ed51ae5fee068aa0b087,1,Yan Fang,2014-08-15 16:05:00-07:00,['3b15e54d41d2ed02c2f381a5d55b9765f94343ba'],5,8,13,95089,2,,,,625
a73c4cbc9a1198774d9720e82d6eb515eb9ad8a2,0,Chris Riccomini,2014-08-19 13:58:20-07:00,['41d17568d3bec61d85d1ed51ae5fee068aa0b087'],0,15,15,95104,1,,,,625
0d544aed1ac34fdb8d56bada338de83a1f8126a0,1,Chris Riccomini,2014-08-19 14:21:30-07:00,['a73c4cbc9a1198774d9720e82d6eb515eb9ad8a2'],129,139,268,95372,14,0.25,1,1,626
42df2b44f1552b213547079ca17b6eb0221577e2,0,Chris Riccomini,2014-08-19 14:33:45-07:00,['0d544aed1ac34fdb8d56bada338de83a1f8126a0'],17,41,58,95430,2,1,1,1,626
aef99452ea7e3a343737d3121435dbf164301517,1,Chris Riccomini,2014-08-20 11:09:46-07:00,['42df2b44f1552b213547079ca17b6eb0221577e2'],17,35,52,95482,2,,,,626
df8436ddb0be1c3cdf495671c6e0384e0043cef3,0,Chris Riccomini,2014-08-20 14:21:42-07:00,['aef99452ea7e3a343737d3121435dbf164301517'],2,2,4,95486,1,,,,626
a7b1282b05db88aec1e4aa70a5abaf44fb9fccd9,1,Yan Fang,2014-08-22 09:16:04-07:00,['df8436ddb0be1c3cdf495671c6e0384e0043cef3'],77,201,278,95764,67,1,1,1,627
53ce0bda676e5da4edf425d8b992be55d1bc7f41,1,Jakob Homan,2014-08-23 20:57:51-07:00,['a7b1282b05db88aec1e4aa70a5abaf44fb9fccd9'],5,67,72,95836,3,,,,628
e65de29aa0e495662ebb12488da390df8a1bbe2c,0,Yan Fang,2014-08-25 09:10:47-07:00,['53ce0bda676e5da4edf425d8b992be55d1bc7f41'],1,1,2,95838,1,,,,628
fd3f40f5c0ab0a5f3d68d7737fb8fe896230f99b,1,Jakob Homan,2014-08-25 23:56:40-07:00,['e65de29aa0e495662ebb12488da390df8a1bbe2c'],6,12,18,95856,2,,,,628
5b253485c8e92e52a24dbd7721598c7604d9855a,0,Chris Riccomini,2014-08-26 08:19:21-07:00,['fd3f40f5c0ab0a5f3d68d7737fb8fe896230f99b'],5,17,22,95878,1,,,,628
1be188b6c30310809c322c26a3fc380e7bc4aaf4,0,Chris Riccomini,2014-08-26 08:57:28-07:00,['5b253485c8e92e52a24dbd7721598c7604d9855a'],1,3,4,95882,1,,,,628
d733ed961fec0a08a6706be22ca8a6537693bed2,1,Chris Riccomini,2014-08-26 09:02:39-07:00,['1be188b6c30310809c322c26a3fc380e7bc4aaf4'],16,47,63,95945,3,1,0,0,628
4246137f68b006016b7d23b5355ea64adb4d895d,0,Chris Riccomini,2014-08-26 12:07:25-07:00,['d733ed961fec0a08a6706be22ca8a6537693bed2'],13,10,23,95968,2,1,1,0,628
cdd2ba7c070d7054812f66cba67a157bae9689d3,0,Chris Riccomini,2014-08-26 12:09:19-07:00,['4246137f68b006016b7d23b5355ea64adb4d895d'],0,10,10,95978,1,,,,628
d2bf10eb585df1fa566a2e5314dcdf485561e19f,0,Chris Riccomini,2014-08-26 13:43:06-07:00,['cdd2ba7c070d7054812f66cba67a157bae9689d3'],6,26,32,96010,4,1,1,1,628
28d464c09f84fac8df3055b6857fce9b6dff4891,0,Chinmay Soman,2014-08-26 14:22:01-07:00,['d2bf10eb585df1fa566a2e5314dcdf485561e19f'],0,5,5,96015,1,,,,628
f5778447ef063147210b3dd64a5f8b8ce01b621c,1,Chris Riccomini,2014-09-08 14:25:54-07:00,['28d464c09f84fac8df3055b6857fce9b6dff4891'],8,8,16,96031,4,,,,628
38f421f003826b919a845e75381891773d044fa5,0,Chris Riccomini,2014-09-11 12:21:57-07:00,['f5778447ef063147210b3dd64a5f8b8ce01b621c'],47,62,109,96140,5,,,,629
4a3fd7ab34a91d27f89d44667b0393a00e0b2d5f,1,Chris Riccomini,2014-09-11 14:52:14-07:00,['38f421f003826b919a845e75381891773d044fa5'],1,70,71,96211,2,,,,630
ca01da75bbf21c329130a367fbe56a155151f70a,0,Chris Riccomini,2014-09-11 14:59:40-07:00,['4a3fd7ab34a91d27f89d44667b0393a00e0b2d5f'],4,4,8,96219,1,,,,630
87ce08e028515855dfd381858acfc836d6ecd48f,0,Chris Riccomini,2014-09-11 15:30:29-07:00,['ca01da75bbf21c329130a367fbe56a155151f70a'],1,24,25,96244,5,0.285714286,0.714285714,1,630
9b7e451c82e9f6721c671f17a06250d0138194a1,0,Jakob Homan,2014-09-15 11:54:31-07:00,['87ce08e028515855dfd381858acfc836d6ecd48f'],6,35,41,96285,1,,,,630
cb40a59860bfe0572f59e25a58562c35be6c0e73,1,Chris Riccomini,2014-09-15 13:17:56-07:00,['9b7e451c82e9f6721c671f17a06250d0138194a1'],15,17,32,96317,3,,,,630
811f2897c640c684f4506a6bab7590304de34fca,1,Chris Riccomini,2014-09-16 09:29:20-07:00,['cb40a59860bfe0572f59e25a58562c35be6c0e73'],487,587,1074,97391,61,1,1,1,630
3e0b3a2b6c146b8fab13aaf4b6798a696b2e52f5,1,Chris Riccomini,2014-09-17 15:24:12-07:00,['811f2897c640c684f4506a6bab7590304de34fca'],23,308,331,97722,10,0.978723404,0.978723404,0.787234043,631
fd603c37fd22966df4c3edf358987ce4171489a4,1,Yan Fang,2014-09-19 09:28:56-07:00,['3e0b3a2b6c146b8fab13aaf4b6798a696b2e52f5'],0,3,3,97725,2,,,,631
f371718c5f8b9f2bf97437f5e6cb1aa89eec8be3,1,Yan Fang,2014-09-22 23:04:22-07:00,['fd603c37fd22966df4c3edf358987ce4171489a4'],10,46,56,97781,5,0,1,1,631
350909d6c250fa1ae4d68c0c9b144ca756f84cf1,0,Yan Fang,2014-09-24 10:04:00-07:00,['f371718c5f8b9f2bf97437f5e6cb1aa89eec8be3'],5,9,14,97795,1,,,,631
f4876e35e7b06039dc23cec9874031e72b7d164a,0,Yan Fang,2014-09-29 15:50:00-07:00,['350909d6c250fa1ae4d68c0c9b144ca756f84cf1'],0,1,1,97796,1,,,,631
b934aa8738bd72f73518fbd595767426ca33e307,1,Yan Fang,2014-09-30 00:08:23-07:00,['f4876e35e7b06039dc23cec9874031e72b7d164a'],0,64,64,97860,2,,,,632
90d5a00fc3a729821410756db0754cdc2f327766,0,Chris Riccomini,2014-10-14 15:06:33-07:00,['b934aa8738bd72f73518fbd595767426ca33e307'],2,2,4,97864,2,,,,632
a66a66c534c587f0092d1d87328b4d56810bd315,0,Chris Riccomini,2014-10-15 13:13:47-07:00,['90d5a00fc3a729821410756db0754cdc2f327766'],1,3,4,97868,1,0,0,1,632
9147c343be9a85d49630bd7522c79e825f5682f2,1,Chris Riccomini,2014-10-16 08:48:12-07:00,['a66a66c534c587f0092d1d87328b4d56810bd315'],51,386,437,98305,9,0.596273292,0.726708075,0.925465839,635
adb48411e241b57abc10ba7eefddd4a3ad39460d,0,Chris Riccomini,2014-10-22 15:45:56-07:00,['9147c343be9a85d49630bd7522c79e825f5682f2'],2,2,4,98309,1,,0,,635
ef2050ca65374102d32a709918bc2cb01ec71850,0,Chris Riccomini,2014-10-23 09:43:46-07:00,['adb48411e241b57abc10ba7eefddd4a3ad39460d'],8,18,26,98335,2,0,1,1,635
3b107492f7545fc0a828deb7728e5827a9e6ae1a,1,Chris Riccomini,2014-10-23 10:48:45-07:00,['ef2050ca65374102d32a709918bc2cb01ec71850'],457,649,1106,99441,38,0.218181818,0,0,641
d7bd2df7a8f642daf21ba14ccfd7f9cc006d2801,0,Yan Fang,2014-10-24 14:14:40-07:00,['3b107492f7545fc0a828deb7728e5827a9e6ae1a'],0,6,6,99447,1,,,,641
e63cfd39ca85a78fd429c39ec5f2fbc98f30489a,1,Chris Riccomini,2014-10-27 12:17:45-07:00,['d7bd2df7a8f642daf21ba14ccfd7f9cc006d2801'],21,159,180,99627,3,,,,641
f6d341508ebc6dccc158374130a9a6ecf07422ca,0,Chris Riccomini,2014-10-27 12:35:11-07:00,['e63cfd39ca85a78fd429c39ec5f2fbc98f30489a'],3,0,3,99630,1,1,1,0,641
6f595beda2482ab85c47f40ae8345c2591007367,1,Chris Riccomini,2014-10-28 09:04:14-07:00,['f6d341508ebc6dccc158374130a9a6ecf07422ca'],913,1370,2283,101913,36,0.852173913,0.47826087,1,650
247733e38e00922c6de26465b6ba7148ccc42cd4,0,Chris Riccomini,2014-10-30 12:21:33-07:00,['6f595beda2482ab85c47f40ae8345c2591007367'],23,23,46,101959,7,,,,650
feba2d03c0512832ed0790a0ad46f12eb5fea5d4,0,Chris Riccomini,2014-11-03 14:13:58-08:00,['247733e38e00922c6de26465b6ba7148ccc42cd4'],198,4,202,102161,7,0.882352941,0.882352941,0,650
f37ae367d1d14633801a09407e83625379c57824,0,Yan Fang,2014-11-03 15:21:23-08:00,['feba2d03c0512832ed0790a0ad46f12eb5fea5d4'],2,2,4,102165,1,,,,650
05298ef7a2cfe658954270270d5e0ddde33f77c1,0,Chinmay Soman,2014-11-03 17:28:42-08:00,['f37ae367d1d14633801a09407e83625379c57824'],321,3,324,102489,2,,,,650
f1d595dc815b908d32b276a0bf344c3d1cf4ecef,0,Martin Kleppmann,2014-11-06 14:25:09+00:00,['05298ef7a2cfe658954270270d5e0ddde33f77c1'],2,2,4,102493,1,,,,650
bbf7b2da1a4e4fed0c5beec9e6424cc75dab5cac,0,Martin Kleppmann,2014-11-06 14:26:00+00:00,['f1d595dc815b908d32b276a0bf344c3d1cf4ecef'],1,1,2,102495,1,,,,650
7e84c9ecf110310816ad556e51dde723eda53ed9,0,Yan Fang,2014-11-10 16:41:40-08:00,['bbf7b2da1a4e4fed0c5beec9e6424cc75dab5cac'],4,0,4,102499,1,,,,650
cf90e33a8b3388a57196c892644efabda1dd4a2c,0,Yan Fang,2014-11-11 10:12:24-08:00,['7e84c9ecf110310816ad556e51dde723eda53ed9'],27820,1,27821,130320,125,,,,650
03eff9b5a52a3fafe677d2f5b7cab0090cc5c1c4,0,Chinmay Soman,2014-11-12 15:59:17-08:00,['cf90e33a8b3388a57196c892644efabda1dd4a2c'],0,52,52,130372,1,,,,650
747406eb48aed0abfa118f8d5cc8890dd282cf1c,0,Chris Riccomini,2014-11-17 15:41:46-08:00,['03eff9b5a52a3fafe677d2f5b7cab0090cc5c1c4'],1,0,1,130373,1,,,,650
49571fc9898271a4f175bce3089da31f50d16f48,1,Chris Riccomini,2014-11-18 08:32:19-08:00,['747406eb48aed0abfa118f8d5cc8890dd282cf1c'],41,10,51,130424,8,,,,650
29f6bb8986eefb3482503e1bb40e2bfffd8824db,0,Chris Riccomini,2014-11-18 10:49:48-08:00,['49571fc9898271a4f175bce3089da31f50d16f48'],9,6,15,130439,1,,,,650
a8bbf251c26ff21f3cc49c880011e5927fe628e4,0,Chris Riccomini,2014-11-19 08:28:13-08:00,['29f6bb8986eefb3482503e1bb40e2bfffd8824db'],1,1,2,130441,1,,,,650
2283fd236b4d4e885e39b70d5c07b972d164de27,0,Chris Riccomini,2014-11-21 10:32:18-08:00,['a8bbf251c26ff21f3cc49c880011e5927fe628e4'],1,21,22,130463,2,,,,650
0da1090f24d86a274f26ad6e9e2ee76c78b77427,0,Chris Riccomini,2014-11-21 14:33:59-08:00,['2283fd236b4d4e885e39b70d5c07b972d164de27'],15,1,16,130479,7,,,,650
d8fc65f730cc5aa18af93057de7e4f5bea36e9bb,1,Yan Fang,2014-11-25 16:45:39-08:00,['0da1090f24d86a274f26ad6e9e2ee76c78b77427'],27,582,609,131088,12,0.785046729,1,0.971962617,656
116e600d09338c9400319d976d6372bcc061a364,1,Chris Riccomini,2014-12-04 09:52:17-08:00,['d8fc65f730cc5aa18af93057de7e4f5bea36e9bb'],0,47,47,131135,2,,,,657
cba2231ddef9eef040a45883a81e248d89ce0992,1,Yan Fang,2014-12-05 10:55:30-08:00,['116e600d09338c9400319d976d6372bcc061a364'],3,21,24,131159,3,,,,657
8c546a5ad776f42fa8e00ffc090db276437d518c,1,Chris Riccomini,2014-12-08 14:18:18-08:00,['cba2231ddef9eef040a45883a81e248d89ce0992'],8,27,35,131194,1,,,,657
c790334545ccce6032398ed1f2c172b62a8f4d61,0,Chris Riccomini,2014-12-09 09:24:22-08:00,['8c546a5ad776f42fa8e00ffc090db276437d518c'],1,1,2,131196,1,,,,657
d382cb6f38ee5d6186f5077080bf45fdb33775c9,0,Chris Riccomini,2014-12-09 10:12:09-08:00,['c790334545ccce6032398ed1f2c172b62a8f4d61'],2,18,20,131216,2,,,,657
d497a4079e2f57498f7a16edbcbb8a62dbdec9c8,0,Chris Riccomini,2014-12-09 10:15:33-08:00,['d382cb6f38ee5d6186f5077080bf45fdb33775c9'],1,1,2,131218,1,,,,657
3161c640a4cfada839668054d9e8fd8b9b6cd046,0,Jakob Homan,2014-12-15 10:35:15-08:00,['d497a4079e2f57498f7a16edbcbb8a62dbdec9c8'],13,15,28,131246,6,,,,657
377e5cc3f56549a02cbbb79cc3dc7166df7da585,0,Jakob Homan,2014-12-20 17:42:08-08:00,['3161c640a4cfada839668054d9e8fd8b9b6cd046'],1,1,2,131248,1,,,,657
0ebfcbd0ab39b2e1db4bc31e6cd38ee3113469fe,1,Chris Riccomini,2014-12-22 09:30:38-08:00,['377e5cc3f56549a02cbbb79cc3dc7166df7da585'],71,322,393,131641,19,0.422818792,0.993288591,1,657
6bbbaa597612febaad082aa7cb3b8bf0ac9610e7,1,Chris Riccomini,2015-01-14 09:18:57-08:00,['0ebfcbd0ab39b2e1db4bc31e6cd38ee3113469fe'],1,949,950,132591,27,0.6875,0.94140625,0.56640625,673
56fc502aac9e947b04eb58b383bb3adea1a07ef9,0,Chris Riccomini,2015-01-15 09:09:54-08:00,['6bbbaa597612febaad082aa7cb3b8bf0ac9610e7'],2,2,4,132595,1,,,,673
0ba554afb43c45b62304d01cb5c53dba9eee9137,0,Chris Riccomini,2015-01-20 11:12:57-08:00,['56fc502aac9e947b04eb58b383bb3adea1a07ef9'],3,6,9,132604,1,1,1,1,673
a95eabff1c96e2c231f489ab5810c379eccaa5f7,0,Chris Riccomini,2015-01-24 15:03:34-08:00,['0ba554afb43c45b62304d01cb5c53dba9eee9137'],14,23,37,132641,2,,,,673
f89d6fc085879fb954e2b49b201e75e964fbb2fe,1,Chris Riccomini,2015-01-24 15:29:45-08:00,['a95eabff1c96e2c231f489ab5810c379eccaa5f7'],69,42,111,132752,23,,,,673
7a3d9d9a0c0fab8c52702e577e9dd8901ef6d435,0,Chris Riccomini,2015-01-24 17:18:53-08:00,['f89d6fc085879fb954e2b49b201e75e964fbb2fe'],1,6,7,132759,2,,,,673
6bdc04df6795509219fd421b4daf30a80a613e93,0,Chris Riccomini,2015-01-25 14:44:33-08:00,['7a3d9d9a0c0fab8c52702e577e9dd8901ef6d435'],0,1,1,132760,1,,,,673
12874b46d89ce0446e10f1b014900c7924adb84d,0,Chris Riccomini,2015-01-25 14:50:33-08:00,['6bdc04df6795509219fd421b4daf30a80a613e93'],9,5,14,132774,2,,,,673
b8debad383316b6e4413c875491385b7d4a9bd4a,1,Chris Riccomini,2015-01-26 08:04:22-08:00,['12874b46d89ce0446e10f1b014900c7924adb84d'],0,85,85,132859,2,1,1,1,675
6adf358b83ddc8f2a32c5886873c3a6486bb6a49,0,Chris Riccomini,2015-01-26 12:25:42-08:00,['b8debad383316b6e4413c875491385b7d4a9bd4a'],24,0,24,132883,2,,,,675
a71af9f977412d50f273a78022db1d595bb9557e,1,Chris Riccomini,2015-01-26 12:41:13-08:00,['6adf358b83ddc8f2a32c5886873c3a6486bb6a49'],7,7,14,132897,6,,,,675
8ae92c6bde319cb5683d4fdc8eae58824376c5f5,1,Chris Riccomini,2015-01-26 14:02:28-08:00,['a71af9f977412d50f273a78022db1d595bb9557e'],6,6,12,132909,1,,,,675
fa2c04f581d89c00ccc9fe96b4216bd804c5c403,1,Chris Riccomini,2015-01-27 16:53:45-08:00,['8ae92c6bde319cb5683d4fdc8eae58824376c5f5'],294,709,1003,133912,19,0.565934066,0.758241758,0.967032967,677
2497226df4fa7a7691d5e46278d9854e7bd0dd5d,0,Chris Riccomini,2015-01-28 09:18:01-08:00,['fa2c04f581d89c00ccc9fe96b4216bd804c5c403'],0,4,4,133916,1,,,,677
11df9ff4f1d336eb07baae16fc338c1652070672,0,Chris Riccomini,2015-01-28 09:26:06-08:00,['2497226df4fa7a7691d5e46278d9854e7bd0dd5d'],4,6,10,133926,1,,,,677
c3b469e0ad28995810e4e0067e0e4aa2f57c9619,0,Yan Fang,2015-01-30 10:58:12-08:00,['11df9ff4f1d336eb07baae16fc338c1652070672'],2,48,50,133976,3,0.833333333,1,1,677
f2fd9aaab2dbd2a1508c498a4071f79e29102105,1,Chris Riccomini,2015-02-02 11:08:13-08:00,['c3b469e0ad28995810e4e0067e0e4aa2f57c9619'],8,17,25,134001,2,0,1,1,677
3a3c278a9c16b5cbbedfd11238d3aeb2ef6e61e5,1,Chris Riccomini,2015-02-04 09:32:53-08:00,['f2fd9aaab2dbd2a1508c498a4071f79e29102105'],464,11,475,134476,12,0.29375,0.01875,0.18125,677
e0a24a78b9afa56d61cc6c1ad8c894c5078d956c,1,Chris Riccomini,2015-02-06 12:52:09-08:00,['3a3c278a9c16b5cbbedfd11238d3aeb2ef6e61e5'],28,74,102,134578,4,,,,677
efb9795a2d5c0a9ea6c7957e3909c79ad94e39b0,0,Chris Riccomini,2015-02-09 16:58:57-08:00,['e0a24a78b9afa56d61cc6c1ad8c894c5078d956c'],1,2384,2385,136963,32,0.84765625,1,0.845703125,706
eedf2e7204fc01e32bd21c454ff83a36a23f6105,0,Chris Riccomini,2015-02-11 09:56:32-08:00,['efb9795a2d5c0a9ea6c7957e3909c79ad94e39b0'],18,932,950,137913,14,0.632701422,0.713270142,1,714
8090d6539946cd27fa25e0c0d35925c344a2d3ae,1,Chris Riccomini,2015-02-12 13:34:47-08:00,['eedf2e7204fc01e32bd21c454ff83a36a23f6105'],13,26,39,137952,9,,,,714
f44a692914b3005cd85acd64a52be6415ae49c59,0,Chris Riccomini,2015-02-12 14:10:33-08:00,['8090d6539946cd27fa25e0c0d35925c344a2d3ae'],932,18,950,138902,14,0.367298578,0.286729858,0,714
6743df319fa88bcd3a900a87de94536ba9a6a7d3,0,Chris Riccomini,2015-02-12 14:10:38-08:00,['f44a692914b3005cd85acd64a52be6415ae49c59'],2384,1,2385,141287,32,0.15234375,0,0.154296875,714
5e32a1bb018cb0382ab4911c31554f8889de984f,1,Chris Riccomini,2015-02-12 14:43:31-08:00,['6743df319fa88bcd3a900a87de94536ba9a6a7d3'],0,112,112,141399,2,1,1,1,716
c7ac26377debacbb94f9c5aac951827895c136a2,1,Chris Riccomini,2015-02-13 13:12:14-08:00,['5e32a1bb018cb0382ab4911c31554f8889de984f'],4,106,110,141509,5,0.583333333,1,1,718
41c74b96876473acb6403e544bec7a00a04d2fa3,1,Chris Riccomini,2015-02-13 17:10:03-08:00,['c7ac26377debacbb94f9c5aac951827895c136a2'],108,355,463,141972,13,0.5875,1,0.6,722
9ea3a526a9de0b4bc74f476bd6d565cd192da3d0,1,Yan Fang,2015-02-18 13:23:17-08:00,['41c74b96876473acb6403e544bec7a00a04d2fa3'],2,49,51,142023,2,1,0.210526316,0.210526316,722
11082d344d3059039fd285c0ef6752de02546977,1,Yan Fang,2015-02-18 18:11:37-08:00,['9ea3a526a9de0b4bc74f476bd6d565cd192da3d0'],1,245,246,142269,7,0.797752809,1,0.808988764,725
77359feb83beec7c7ca66f9f1553565e3c826983,0,Yan Fang,2015-02-20 11:43:46-08:00,['11082d344d3059039fd285c0ef6752de02546977'],2,2,4,142273,1,,,,725
a984a6a2c1f91f0d4bccaebbd992dc4c3794a9c9,0,Chris Riccomini,2015-02-25 16:41:32-08:00,['77359feb83beec7c7ca66f9f1553565e3c826983'],124,50,174,142447,6,1,1,1,726
87c4ab658986ac13e9a84b1dbde740c1cbebac73,1,Chris Riccomini,2015-02-26 14:41:17-08:00,['a984a6a2c1f91f0d4bccaebbd992dc4c3794a9c9'],97,530,627,143074,23,1,0.893939394,1,731
04f7ff7b4cee76a11991ac69b3eb60c9d4ede31f,1,Chris Riccomini,2015-02-26 14:47:28-08:00,['87c4ab658986ac13e9a84b1dbde740c1cbebac73'],0,1,1,143075,1,1,1,1,731
922771ea45641b585927c90bd92077179a9420a3,0,Chris Riccomini,2015-02-26 16:21:10-08:00,['04f7ff7b4cee76a11991ac69b3eb60c9d4ede31f'],0,7,7,143082,1,,,,731
dd18d5ae4f4f8440534cbeffdc494b9a07d1f9e8,1,Chris Riccomini,2015-02-27 17:18:04-08:00,['922771ea45641b585927c90bd92077179a9420a3'],53,64,117,143199,9,0,0,0,731
c6fa8edc89779b3e28a264edb264c8f8e9ecd55a,0,Chris Riccomini,2015-03-01 15:54:36-08:00,['dd18d5ae4f4f8440534cbeffdc494b9a07d1f9e8'],6,9,15,143214,2,0,0,0,731
57075c402379a9ba49a44371bc88f34a295d600b,0,Chris Riccomini,2015-03-02 11:16:05-08:00,['c6fa8edc89779b3e28a264edb264c8f8e9ecd55a'],5,5,10,143224,1,,,,731
7a21beff807a40a40457225cbef249fb31b5e7b5,0,Chris Riccomini,2015-03-02 12:26:36-08:00,['57075c402379a9ba49a44371bc88f34a295d600b'],0,4,4,143228,1,,,,731
fcb5cea3fc4767ba6239a5cdf05a5a06a7f92e62,0,Chris Riccomini,2015-03-03 10:20:15-08:00,['7a21beff807a40a40457225cbef249fb31b5e7b5'],14,13,27,143255,1,1,0,0,731
ff40b12e36c0cc3fd8c65b75358be56df4967727,1,Chris Riccomini,2015-03-11 09:04:38-07:00,['fcb5cea3fc4767ba6239a5cdf05a5a06a7f92e62'],1,144,145,143400,7,0.346153846,0.923076923,0.961538462,734
b82d458718e43a4a7a580f5a8e65ee7969b0e0f0,1,Chris Riccomini,2015-03-11 09:06:53-07:00,['ff40b12e36c0cc3fd8c65b75358be56df4967727'],5,60,65,143465,2,1,1,1,734
c725b3ceb6d2e116f5da257ba45fe70fa877747a,1,Chris Riccomini,2015-03-11 09:28:58-07:00,['b82d458718e43a4a7a580f5a8e65ee7969b0e0f0'],7,80,87,143552,2,0.358490566,1,0.962264151,734
13ee706225678172675163f088f499f78474ce43,0,Chris Riccomini,2015-03-12 13:35:05-07:00,['c725b3ceb6d2e116f5da257ba45fe70fa877747a'],1,2,3,143555,1,,,,734
2904bc9be9d3525617d97f1ca32d49722aedc4c6,0,Chris Riccomini,2015-03-12 18:44:58-07:00,['13ee706225678172675163f088f499f78474ce43'],5,5,10,143565,3,,,,734
769844e533b157b504a8459f059dd70ff47fc1eb,0,Chris Riccomini,2015-03-13 11:30:36-07:00,['2904bc9be9d3525617d97f1ca32d49722aedc4c6'],0,5,5,143570,1,,,,734
23c4b391545e68fa005cedc8db9b01d5270000d6,1,Chris Riccomini,2015-03-13 14:40:34-07:00,['769844e533b157b504a8459f059dd70ff47fc1eb'],69,367,436,144006,9,0.564814815,0.601851852,1,736
1202df4171f44a877997301218fe3c3037abf2d5,1,Chris Riccomini,2015-03-13 14:52:03-07:00,['23c4b391545e68fa005cedc8db9b01d5270000d6'],34,107,141,144147,10,1,1,1,737
660d879e7f1218a7289c97d654e8371fd7da6392,0,Jakob Homan,2015-03-14 14:54:06-07:00,['1202df4171f44a877997301218fe3c3037abf2d5'],0,0,0,144147,2,,,,737
7e4f3e490b1adc2f1ce268f814c26ac0dd0b733e,0,Chris Riccomini,2015-03-16 11:19:53-07:00,['660d879e7f1218a7289c97d654e8371fd7da6392'],0,3,3,144150,1,,,,737
817014985b24cda4756437a76592052c39aff2c1,1,Chris Riccomini,2015-03-16 13:24:42-07:00,['7e4f3e490b1adc2f1ce268f814c26ac0dd0b733e'],1,1,2,144152,1,,,,737
cad2c828692244d110e9e3a19c39b257c3040b4c,1,Chris Riccomini,2015-03-16 14:53:32-07:00,['817014985b24cda4756437a76592052c39aff2c1'],7,50,57,144209,7,1,1,1,737
537262e284d6c126ea434c1af74e66e92cf08e5e,1,Chris Riccomini,2015-03-16 16:05:28-07:00,['cad2c828692244d110e9e3a19c39b257c3040b4c'],6,65,71,144280,3,1,1,0.846153846,737
137d0d67e03e7ec598efa8c181d05c358104dd6b,0,Chris Riccomini,2015-03-17 15:26:23-07:00,['537262e284d6c126ea434c1af74e66e92cf08e5e'],1,1,2,144282,1,,,,737
a6ada1f6fa4fa401201ad863eda3264c1782e276,1,Chris Riccomini,2015-03-18 18:47:08-07:00,['137d0d67e03e7ec598efa8c181d05c358104dd6b'],76,142,218,144500,4,1,1,0,737
9a9ab8d243a940701cf8b6374b15d507a484f491,1,Chris Riccomini,2015-03-18 18:50:46-07:00,['a6ada1f6fa4fa401201ad863eda3264c1782e276'],2,2,4,144504,1,,,,737
05a02eed176ae51d350588260fbd70439ac739c7,1,Chris Riccomini,2015-03-19 09:18:54-07:00,['9a9ab8d243a940701cf8b6374b15d507a484f491'],6,8,14,144518,1,,,,737
8b52e8aecbca2915d50f0ae3600ceec799fac60f,1,Chris Riccomini,2015-03-19 09:25:29-07:00,['05a02eed176ae51d350588260fbd70439ac739c7'],4,81,85,144603,5,1,1,0.941176471,738
28e2dbb895d1a9bb4d5d2662966902c7d85546be,1,Chris Riccomini,2015-03-23 12:41:47-07:00,['8b52e8aecbca2915d50f0ae3600ceec799fac60f'],6,37,43,144646,2,0.333333333,0,1,738
6f5bafb6cd93934781161eb6b1868d11ea347c95,0,Yan Fang,2015-03-24 11:05:11-07:00,['28e2dbb895d1a9bb4d5d2662966902c7d85546be'],1,59,60,144706,1,,,,738
91289f491b0e5aa1b0b12b5872181e29438d7350,0,Yan Fang,2015-03-24 11:06:12-07:00,['6f5bafb6cd93934781161eb6b1868d11ea347c95'],2,2,4,144710,1,,,,738
2c9020b7f20d609113868c224fb8138c36521e0e,1,Chris Riccomini,2015-03-24 12:47:00-07:00,['91289f491b0e5aa1b0b12b5872181e29438d7350'],9,29,38,144748,5,0,0,1,738
44d07f681c423167eb320451d913c44d397ab8aa,1,Yan Fang,2015-03-24 13:52:16-07:00,['2c9020b7f20d609113868c224fb8138c36521e0e'],2,2,4,144752,2,,,,738
d20ae5c77170eee1951dc371b27ff14166aa2110,0,Yan Fang,2015-03-25 17:11:50-07:00,['44d07f681c423167eb320451d913c44d397ab8aa'],1,1,2,144754,1,,,,738
8aeec8defcfb62cd805425811520ca6474973126,0,Chris Riccomini,2015-03-27 11:04:09-07:00,['d20ae5c77170eee1951dc371b27ff14166aa2110'],0,1,1,144755,1,,,,738
faf93fff3a40b866e5e03fa3f1dde883dd17a926,1,Chris Riccomini,2015-03-27 13:48:15-07:00,['8aeec8defcfb62cd805425811520ca6474973126'],1,1,2,144757,1,,,,738
95b6afc305270478bfd830527175b20fc18716ec,1,Yan Fang,2015-04-01 11:31:05-07:00,['faf93fff3a40b866e5e03fa3f1dde883dd17a926'],10,11,21,144778,1,,,,738
cde495e161d1a3f29469cb503742da703a0dd4a7,0,Yan Fang,2015-04-01 11:39:46-07:00,['95b6afc305270478bfd830527175b20fc18716ec'],0,9,9,144787,2,,,,738
76e151c14a5d01b88c49edfb2c847ffe3c0e6242,0,Chris Riccomini,2015-04-02 16:07:56-07:00,['cde495e161d1a3f29469cb503742da703a0dd4a7'],2,37,39,144826,3,1,1,1,738
457a5245100749113b57585e559469530d25caa9,0,Jakob Homan,2015-04-06 16:17:40-07:00,['76e151c14a5d01b88c49edfb2c847ffe3c0e6242'],2,5,7,144833,1,0,0,1,738
b276afecfad7b1d542b2a5737471c783bb4ac079,0,Jakob Homan,2015-04-07 14:53:20-07:00,['457a5245100749113b57585e559469530d25caa9'],54,0,54,144887,3,,,,738
edc2c78f8759bb38dae1c2e0472f1123456f30c5,1,Chris Riccomini,2015-04-07 16:18:35-07:00,['b276afecfad7b1d542b2a5737471c783bb4ac079'],4,100,104,144991,4,1,1,1,740
81f54a2b60628a33068ea786a73abc185a4e9258,1,Chris Riccomini,2015-04-08 09:25:11-07:00,['edc2c78f8759bb38dae1c2e0472f1123456f30c5'],71,54,125,145116,5,0,0,1,740
9427c9e17618b7deaf1339125bfe20182961eca6,1,Chris Riccomini,2015-04-08 09:27:24-07:00,['81f54a2b60628a33068ea786a73abc185a4e9258'],44,45,89,145205,3,1,0,0,740
6946f78e1a7066ed58587cc9e2105128e9d8fb51,1,Yan Fang,2015-04-09 15:00:38-07:00,['9427c9e17618b7deaf1339125bfe20182961eca6'],6,77,83,145288,5,0.714285714,0.857142857,0.857142857,741
3eb15a05349936a09aac9086404f57bdc6baf3cc,1,Yan Fang,2015-04-09 15:03:49-07:00,['6946f78e1a7066ed58587cc9e2105128e9d8fb51'],1,29,30,145318,1,,,,741
ffa84c0b724fd2251190a4402a122ac27fded560,0,Chris Riccomini,2015-04-13 10:46:31-07:00,['3eb15a05349936a09aac9086404f57bdc6baf3cc'],6,37,43,145361,2,0.384615385,0.384615385,1,741
a09b1ff926684f040f2978e74fa8506cac6e05ff,0,Jakob Homan,2015-04-13 11:17:23-07:00,['ffa84c0b724fd2251190a4402a122ac27fded560'],5,2,7,145368,2,,,,741
5a035b8c4a4b1bd0ccf4d3df25cc1ce51a8bd06f,0,Yi Pan (Data Infrastructure),2015-04-14 13:59:20-07:00,['a09b1ff926684f040f2978e74fa8506cac6e05ff'],0,5,5,145373,1,,,,741
88a844b066c3d438c9e243997ebdd6e4f98b5f5f,0,Jakob Homan,2015-04-22 13:18:07-07:00,['5a035b8c4a4b1bd0ccf4d3df25cc1ce51a8bd06f'],1,181,182,145555,3,0.629032258,0.629032258,1,743
c37d75270a44ecae4079a8ccbb53022bdf56c8cb,0,Yan Fang,2015-04-24 16:35:18-07:00,['88a844b066c3d438c9e243997ebdd6e4f98b5f5f'],120,120,240,145795,7,,,,743
23fb2e1c097317845439ec0abb938821a6106969,1,Yi Pan (Data Infrastructure),2015-04-28 19:57:06-07:00,['c37d75270a44ecae4079a8ccbb53022bdf56c8cb'],1762,2743,4505,150300,77,0.699130435,1,0.794782609,754
fdb90e7e77993cd26b2c5c0bcbaa48c37e0e6e6f,1,Yan Fang,2015-04-29 13:36:49-07:00,['23fb2e1c097317845439ec0abb938821a6106969'],27,25,52,150352,2,0,0,1,754
9f30ef10b5be133cc33f797227f5274397ebd05d,1,Yi Pan (Data Infrastructure),2015-05-04 13:35:37-07:00,['fdb90e7e77993cd26b2c5c0bcbaa48c37e0e6e6f'],109,499,608,150960,13,0.381481481,1,1,754
bb8a78a85666325641e75fe466476094de716555,1,Yan Fang,2015-05-06 17:22:41-07:00,['9f30ef10b5be133cc33f797227f5274397ebd05d'],36,391,427,151387,7,0.494318182,0.909090909,1,755
f0809a54bd48109373cf000056dd652cb8b298f3,1,Yi Pan (Data Infrastructure),2015-05-07 17:38:53-07:00,['bb8a78a85666325641e75fe466476094de716555'],194,435,629,152016,38,0,0,0.083333333,757
4323003dc4a0749d10b36be590e42697749f7dca,1,Yi Pan (Data Infrastructure),2015-05-07 18:58:23-07:00,['f0809a54bd48109373cf000056dd652cb8b298f3'],100,264,364,152380,6,0.555555556,1,1,758
e801ab2598b98ed6fdd3826760a059026c0dfe55,1,Yan Fang,2015-05-13 11:06:18-07:00,['4323003dc4a0749d10b36be590e42697749f7dca'],9,10,19,152399,2,0,0,1,758
a94e1ed893dcfa7e5ffa3d63cf42afb8c87136e2,1,Yan Fang,2015-05-14 16:06:40-07:00,['e801ab2598b98ed6fdd3826760a059026c0dfe55'],10,152,162,152561,7,0.011235955,0.348314607,0.393258427,759
db2d93e3424713fb0dcbd4349f05995b30e1d864,1,Yan Fang,2015-05-15 11:29:50-07:00,['a94e1ed893dcfa7e5ffa3d63cf42afb8c87136e2'],0,29,29,152590,2,0,0,1,759
a93ab39cd29a48a98ad831826e686d6316d1980b,1,Yan Fang,2015-05-26 12:39:22-07:00,['db2d93e3424713fb0dcbd4349f05995b30e1d864'],9,36,45,152635,3,1,1,1,759
ddee33dbe614e480dd1c3be61ed99be68735b7f9,1,Navina,2015-05-27 18:48:24-07:00,['a93ab39cd29a48a98ad831826e686d6316d1980b'],0,5,5,152640,1,,,,759
f7759580444034c7a030197fcd497d1bd339e792,0,Yan Fang,2015-06-02 13:16:41-07:00,['ddee33dbe614e480dd1c3be61ed99be68735b7f9'],5,5,10,152650,2,,,,759
f320a430692e1b168106f721b4f73f6cfa90e2e1,1,Navina,2015-06-02 14:13:56-07:00,['f7759580444034c7a030197fcd497d1bd339e792'],37,229,266,152916,7,0.777777778,0.375,0.541666667,760
69b1f2e56d14276849be5168953e4fd638b42830,1,Yan Fang,2015-06-03 18:50:36-07:00,['f320a430692e1b168106f721b4f73f6cfa90e2e1'],5,25,30,152946,4,1,1,1,760
0f8d7d121f4a4d21dff5dfb58c1f856a192b04b1,0,Yan Fang,2015-06-09 15:51:55-07:00,['69b1f2e56d14276849be5168953e4fd638b42830'],0,46,46,152992,2,1,1,1,761
133efd9428df296bc90c3f0a2e709cd57c31595f,0,Yan Fang,2015-06-10 17:56:13-07:00,['0f8d7d121f4a4d21dff5dfb58c1f856a192b04b1'],1,16,17,153009,1,,,,761
1b9ddc69fae5bac74cf6967dc97fa806c451f904,0,Yi Pan (Data Infrastructure),2015-06-11 23:33:52-07:00,['133efd9428df296bc90c3f0a2e709cd57c31595f'],1,1,2,153011,1,,,,761
00c8abd7c83e4ba6dba516836728a3b36ddd4555,1,Yan Fang,2015-06-14 01:15:38-07:00,['1b9ddc69fae5bac74cf6967dc97fa806c451f904'],15,29,44,153055,1,,,,761
b1586413c85ab6a03cd00fafa7d38aaa080c62dc,1,Navina,2015-06-15 11:48:18-07:00,['00c8abd7c83e4ba6dba516836728a3b36ddd4555'],8,40,48,153103,2,,,,761
0fc6ad255a48527cdcaa45b6bcc19f66ca9e08f9,1,Yan Fang,2015-06-15 13:26:06-07:00,['b1586413c85ab6a03cd00fafa7d38aaa080c62dc'],6,30,36,153139,2,0,1,1,761
e7cd142eaf503ddb325ecbc24c3f27c0b39c13d5,1,Navina,2015-06-16 16:11:33-07:00,['0fc6ad255a48527cdcaa45b6bcc19f66ca9e08f9'],39,113,152,153291,3,1,1,1,761
c75a71facaa91db77c6bf0981569488062ecb946,0,Chris Riccomini,2015-06-16 17:39:45-07:00,['e7cd142eaf503ddb325ecbc24c3f27c0b39c13d5'],2,2,4,153295,1,,,,761
e9407dfeda2fd854a56bae4aadeaf49bfcedeb10,1,Navina,2015-06-17 14:47:26-07:00,['c75a71facaa91db77c6bf0981569488062ecb946'],5,10,15,153310,1,,,,761
f0f94cda2e34d35a79b765609eb2830ebea2b5c2,0,Yi Pan (Data Infrastructure),2015-06-17 17:41:22-07:00,['e9407dfeda2fd854a56bae4aadeaf49bfcedeb10'],0,116,116,153426,1,,,,761
c04daabd3875c229702a27a0ed104bdb567102e7,0,Yan Fang,2015-06-18 17:02:58-07:00,['f0f94cda2e34d35a79b765609eb2830ebea2b5c2'],1,1,2,153428,1,,,,761
d2de9db9dc1d6500377240f0584c228467f99201,0,Yi Pan (Data Infrastructure),2015-06-19 13:38:25-07:00,['c04daabd3875c229702a27a0ed104bdb567102e7'],0,29,29,153457,2,,,,761
e2906c878328d1baff36a70a78dde496e74f48ac,0,Yi Pan (Data Infrastructure),2015-06-22 15:45:11-07:00,['d2de9db9dc1d6500377240f0584c228467f99201'],0,9,9,153466,2,,,,761
99dbca19dde7df0d2027059b57673536965659b5,1,Yi Pan (Data Infrastructure),2015-06-23 14:02:17-07:00,['e2906c878328d1baff36a70a78dde496e74f48ac'],0,29,29,153495,2,1,1,1,761
fa6ca0b1466099a289a04b5fd5674fffbcca5ca3,1,Yan Fang,2015-07-10 14:18:36-07:00,['99dbca19dde7df0d2027059b57673536965659b5'],9,1287,1296,154791,17,0.881481481,0.935802469,0.955555556,774
d5fbe1b96279baab15580f6e23964ecebcc25748,0,Yan Fang,2015-07-10 14:54:09-07:00,['fa6ca0b1466099a289a04b5fd5674fffbcca5ca3'],2,2,4,154795,2,,,,774
94e37ecb7cbbe2c69d7a54b89b64905b965300a7,0,Yan Fang,2015-07-10 15:08:15-07:00,['d5fbe1b96279baab15580f6e23964ecebcc25748'],1,64,65,154860,4,,,,775
0a10575aac3f9b1163d0068b63b653ae5a476d08,1,Yi Pan (Data Infrastructure),2015-07-10 16:24:08-07:00,['94e37ecb7cbbe2c69d7a54b89b64905b965300a7'],11,12,23,154883,2,,,,775
6cd76a5d539313363715bc9fc0ff4df7ac52fccf,0,Yi Pan (Data Infrastructure),2015-07-12 17:09:17-07:00,['0a10575aac3f9b1163d0068b63b653ae5a476d08'],1,1,2,154885,1,,,,775
3d1fd2171e5f426c15fff457d61d952860b3298e,1,Navina,2015-07-15 10:38:29-07:00,['6cd76a5d539313363715bc9fc0ff4df7ac52fccf'],1,9,10,154895,1,0,0,0,775
9709d9d4632cff6ad7ca34405f733311a9fd64a0,0,Yan Fang,2015-07-15 17:12:40-07:00,['3d1fd2171e5f426c15fff457d61d952860b3298e'],14,1,15,154910,2,,,,775
4f7bbb054ac7c5f6bb5528189d49f0b4942faa7e,1,Yan Fang,2015-07-15 22:38:12-07:00,['9709d9d4632cff6ad7ca34405f733311a9fd64a0'],49,106,155,155065,12,1,1,0,775
81542ecf484eccab2bfbb8f6ce1443c2f57eb6e4,1,Yan Fang,2015-07-15 22:47:53-07:00,['4f7bbb054ac7c5f6bb5528189d49f0b4942faa7e'],43,905,948,156013,17,0.789855072,0.851449275,0.942028986,787
a4b831d3d3a555bc3cca2b0819813c6fad8bd480,0,Navina,2015-07-16 14:20:57-07:00,['81542ecf484eccab2bfbb8f6ce1443c2f57eb6e4'],74,653,727,156740,9,0.591240876,1,1,792
01ee053ed720832a1ac679525f1aa2b29fe0463e,0,Navina,2015-07-16 15:07:54-07:00,['a4b831d3d3a555bc3cca2b0819813c6fad8bd480'],653,74,727,157467,9,0.408759124,0,0,792
b480f2535745a02f2153784c4ba325859e90afaa,1,Navina,2015-07-16 15:39:45-07:00,['01ee053ed720832a1ac679525f1aa2b29fe0463e'],74,470,544,158011,8,0.591240876,1,1,796
e9f70086166fc7c3e54ca5989cff1a63bc427a4b,1,Yan Fang,2015-07-21 09:52:26-07:00,['b480f2535745a02f2153784c4ba325859e90afaa'],9,9,18,158029,4,,,,796
b22909855a1ae9e93e4b1d7282f89dd6b8c10eae,1,Yan Fang,2015-07-21 14:56:57-07:00,['e9f70086166fc7c3e54ca5989cff1a63bc427a4b'],2,6,8,158037,1,,,,796
ff7bc452f261e6c1f18b964568d544ee4f925756,0,Yan Fang,2015-07-22 11:29:23-07:00,['b22909855a1ae9e93e4b1d7282f89dd6b8c10eae'],14,251,265,158302,8,0.987012987,1,0.896103896,800
f49d2c93863fb2c746041ab22bc680edf65500f5,0,Yan Fang,2015-07-27 17:35:20-07:00,['ff7bc452f261e6c1f18b964568d544ee4f925756'],0,4,4,158306,1,,,,800
2554669eaf6417683f5cab4dcb12483f2a9955a1,1,Yan Fang,2015-07-27 17:48:02-07:00,['f49d2c93863fb2c746041ab22bc680edf65500f5'],37,126,163,158469,13,1,1,1,802
5344f7c2f9c7f7e892be796d93232ddb34643847,1,Navina,2015-07-28 17:44:19-07:00,['2554669eaf6417683f5cab4dcb12483f2a9955a1'],3,3,6,158475,1,,,,802
b75d55bff06921002480a46c1bb22dcb5099de3f,0,Yi Pan (Data Infrastructure),2015-07-29 11:05:58-07:00,['5344f7c2f9c7f7e892be796d93232ddb34643847'],1,0,1,158476,1,,,,802
bf094c8e5c4038b158811f51e8ca523bb7c1b182,1,Yi Pan (Data Infrastructure),2015-07-29 12:21:14-07:00,['b75d55bff06921002480a46c1bb22dcb5099de3f'],28,140,168,158644,5,0.21686747,0.590361446,1,802
9d6747598111434270f9be549947df1a1ab3bc1e,0,Navina,2015-08-03 11:50:39-07:00,['bf094c8e5c4038b158811f51e8ca523bb7c1b182'],4,27,31,158675,4,0.285714286,1,0.285714286,802
c9fa7969af5e5337d668d386971fd8446191e5b3,0,Yan Fang,2015-08-03 14:50:46-07:00,['9d6747598111434270f9be549947df1a1ab3bc1e'],0,16,16,158691,1,,,,802
59ec3b789c81d17e820e1587be66e756c4daeaa6,1,Yan Fang,2015-08-03 16:30:15-07:00,['c9fa7969af5e5337d668d386971fd8446191e5b3'],326,563,889,159580,24,0,0,0,808
bd5944af2adc827454684b1b4c7a5aeaf5c67d65,1,Yan Fang,2015-08-07 14:32:20-07:00,['59ec3b789c81d17e820e1587be66e756c4daeaa6'],24,44,68,159648,8,1,1,1,808
c320224983bd9c20d9d134dba337ee9a5f9b6b45,1,Yan Fang,2015-08-07 15:31:53-07:00,['bd5944af2adc827454684b1b4c7a5aeaf5c67d65'],3,1174,1177,160825,21,0.809045226,1,0.894472362,825
98df876dd4492b7d32422de0eccff1cbc26e1888,1,Yi Pan (Data Infrastructure),2015-08-07 17:05:08-07:00,['c320224983bd9c20d9d134dba337ee9a5f9b6b45'],300,511,811,161636,5,1,1,0.583333333,827
623b3d20dc57dad4bdf840af2a8e8a7d2656bb0d,1,Yi Pan (Data Infrastructure),2015-08-10 22:02:52-07:00,['98df876dd4492b7d32422de0eccff1cbc26e1888'],25,117,142,161778,12,0.867924528,1,0.660377358,827
ceaccdde11f13aaffe57c5d14f2a625ca324ef35,1,Navina,2015-08-14 14:48:06-07:00,['623b3d20dc57dad4bdf840af2a8e8a7d2656bb0d'],25,712,737,162515,11,0.381679389,0.515267176,1,830
31a31f4ce4ef10f15cf6db76b43a874fcca27d8a,0,Jakob Homan,2015-08-17 16:15:31-07:00,['ceaccdde11f13aaffe57c5d14f2a625ca324ef35'],0,19,19,162534,1,,,,830
f9a667291862b637dbab3789d06b241c7641d9e9,0,Yi Pan (Data Infrastructure),2015-08-17 23:31:44-07:00,['31a31f4ce4ef10f15cf6db76b43a874fcca27d8a'],1,1,2,162536,1,,,,830
6c4ecb53238b6663f9ebdabf9dbb59491de0beda,0,Yi Pan (Data Infrastructure),2015-08-17 23:53:26-07:00,['f9a667291862b637dbab3789d06b241c7641d9e9'],0,24,24,162560,1,,,,831
3a4886a6531530de67b7cab6ed004653e9e6aa38,1,Yi Pan (Data Infrastructure),2015-08-18 00:45:34-07:00,['6c4ecb53238b6663f9ebdabf9dbb59491de0beda'],54,49,103,162663,6,,,,831
79ec5dbfcf80e9c346baf585dba20e7bd3098ff1,1,Yi Pan (Data Infrastructure),2015-08-24 01:38:59-07:00,['3a4886a6531530de67b7cab6ed004653e9e6aa38'],67,131,198,162861,3,0.409090909,1,0.924242424,831
1f77f8b986e1e58982704b71ea9bb497ac0f70df,1,Yan Fang,2015-08-24 10:46:16-04:00,['79ec5dbfcf80e9c346baf585dba20e7bd3098ff1'],344,1093,1437,164298,41,0.147540984,0.632786885,0.963934426,838
538a18cdfb5f0f557e8628e95d629b26af4d02a1,1,Yan Fang,2015-08-24 11:10:37-04:00,['1f77f8b986e1e58982704b71ea9bb497ac0f70df'],1,3,4,164302,1,,,,838
85b8e931c360dd7a52fb13ef40b230cef7344966,0,Yan Fang,2015-08-24 11:12:48-04:00,['538a18cdfb5f0f557e8628e95d629b26af4d02a1'],1,1,2,164304,1,,,,838
c7c030af74250d5f95fe3774aa8a9131a8ec7ccf,0,Yi Pan (Data Infrastructure),2015-08-31 23:32:46-07:00,['85b8e931c360dd7a52fb13ef40b230cef7344966'],0,8,8,164312,1,,,,838
83ed466166b66fbe6869b0434e5b34093806fe38,0,Yi Pan (Data Infrastructure),2015-09-01 15:32:24-07:00,['c7c030af74250d5f95fe3774aa8a9131a8ec7ccf'],6,52,58,164370,1,,,,838
1aee39ff199743aaf150c3199cdbf65fb09e0dd0,0,Yan Fang,2015-09-08 00:32:04-07:00,['83ed466166b66fbe6869b0434e5b34093806fe38'],2,2,4,164374,1,,,,838
3fb8d6f41199815083c25452d3442fca7110f8d8,0,Yan Fang,2015-09-14 15:54:43-07:00,['1aee39ff199743aaf150c3199cdbf65fb09e0dd0'],1,15,16,164390,2,,,,838
47c33dcfe1f6faaecf5fadcd1ce04af17c9ed7e8,0,Yan Fang,2015-09-16 00:10:23-07:00,['3fb8d6f41199815083c25452d3442fca7110f8d8'],2,2,4,164394,1,,,,838
9ab00c1887470e94e53fe3c6eaef054ae633f672,0,Yi Pan (Data Infrastructure),2015-09-22 10:45:33-07:00,['47c33dcfe1f6faaecf5fadcd1ce04af17c9ed7e8'],3,14,17,164411,2,1,1,1,838
841839de0031f4dc743e1a6f1e795dc18cc13fbc,1,Yi Pan (Data Infrastructure),2015-09-24 14:36:46-07:00,['9ab00c1887470e94e53fe3c6eaef054ae633f672'],2,1383,1385,165796,19,0.333938294,0.838475499,0.814882033,847
34eaec4cdec834b005864741fd8cd031afbf1e1b,0,Yi Pan (Data Infrastructure),2015-09-25 10:28:10-07:00,['841839de0031f4dc743e1a6f1e795dc18cc13fbc'],48,53,101,165897,8,1,1,1,847
c76132ff2703a587f38662adab3d3ff8e5fca6bb,1,Yi Pan (Data Infrastructure),2015-09-25 16:50:45-07:00,['34eaec4cdec834b005864741fd8cd031afbf1e1b'],970,3681,4651,170548,43,0.246692607,0.814007782,0.783657588,868
2b12242c7cc8d120ff33f0d99c94e56274ede9f8,0,Yi Pan (Data Infrastructure),2015-09-28 10:18:22-07:00,['c76132ff2703a587f38662adab3d3ff8e5fca6bb'],1,0,1,170549,1,0,0,0,868
2ba6e348018a0dc9530a8db8d6a2e83d9df12018,0,Navina,2015-09-29 13:31:42-07:00,['2b12242c7cc8d120ff33f0d99c94e56274ede9f8'],1,2,3,170552,1,,,,868
eb80cfee885d10d8d875dc42afdb2868a5fffbb3,0,Navina,2015-09-29 17:47:49-07:00,['2ba6e348018a0dc9530a8db8d6a2e83d9df12018'],4,0,4,170556,1,0,0,0,868
64f3f6b32d024172c9dcc0309af314dd0fb620d4,1,Yi Pan (Data Infrastructure),2015-10-06 16:44:10-07:00,['eb80cfee885d10d8d875dc42afdb2868a5fffbb3'],22,16,38,170594,6,0,0,0,868
dfdc35e7e1484180932591b6d0e804fbcbfd7b40,1,Yi Pan (Data Infrastructure),2015-10-06 17:37:20-07:00,['64f3f6b32d024172c9dcc0309af314dd0fb620d4'],106,253,359,170953,5,1,0.929824561,0.842105263,870
b14da282cd92d28252a77adb80aa038ba0a66bc9,1,Navina,2015-10-08 16:16:26-07:00,['dfdc35e7e1484180932591b6d0e804fbcbfd7b40'],42,68,110,171063,9,0.380952381,1,1,870
9e1906af377b6631842894cfcdfd8c90a18676ca,1,Yi Pan (Data Infrastructure),2015-10-08 23:22:04-07:00,['b14da282cd92d28252a77adb80aa038ba0a66bc9'],7,26,33,171096,2,0.764705882,1,1,870
a2afa361f0761f18654104d77a2488c3a7cbd2fe,0,Navina,2015-10-15 18:08:28-07:00,['9e1906af377b6631842894cfcdfd8c90a18676ca'],1,1,2,171098,1,,,,870
91de984aba6c2cdb782eb2c94937a8a3575d1ba8,0,Navina,2015-10-19 11:44:12-07:00,['a2afa361f0761f18654104d77a2488c3a7cbd2fe'],1,1,2,171100,1,,,,870
f7f237e939f0dabe0cd5130768096083a2b4a543,0,Navina,2015-10-19 13:51:57-07:00,['91de984aba6c2cdb782eb2c94937a8a3575d1ba8'],0,23,23,171123,3,0,0,1,870
f70a11c4a747b77035dddfba2296ba3b667928e2,0,Navina,2015-10-19 15:20:55-07:00,['f7f237e939f0dabe0cd5130768096083a2b4a543'],3,6,9,171132,1,,,,870
775d79195a387f71cf85d77c922de5d76fefd398,0,Yi Pan (Data Infrastructure),2015-10-22 16:32:12-07:00,['f70a11c4a747b77035dddfba2296ba3b667928e2'],2,2,4,171136,1,,,,870
6f23832731ac08cfbe0a9fa412edd8ff0f70775f,0,Yi Pan (Data Infrastructure),2015-10-22 16:52:13-07:00,['775d79195a387f71cf85d77c922de5d76fefd398'],23,39,62,171198,2,0,0.578947368,1,870
07c6984080558f0523fa903d567b35239c421037,1,Navina,2015-10-26 13:56:06-07:00,['6f23832731ac08cfbe0a9fa412edd8ff0f70775f'],95,678,773,171971,15,0.421052632,0.736842105,0.918660287,876
8677a27fd81895324bd99113929255ec56722390,1,Navina,2015-10-27 15:21:41-07:00,['07c6984080558f0523fa903d567b35239c421037'],46,112,158,172129,4,0,1,0.954545455,876
eba9b28f34874b1d9a7e467d8a6046dc5357b4d5,1,Navina,2015-11-02 13:59:42-08:00,['8677a27fd81895324bd99113929255ec56722390'],1057,1398,2455,174584,40,0.891304348,1,0.663043478,885
a0ee94d647cb21cc9f5e2b05cb74068d7d7ca9a4,0,Yi Pan (Data Infrastructure),2015-11-09 11:05:37-08:00,['eba9b28f34874b1d9a7e467d8a6046dc5357b4d5'],0,21,21,174605,1,,,,886
22a1d6f18442d2623f76b769497f6c75004af883,0,Yi Pan (Data Infrastructure),2015-11-09 11:41:55-08:00,['a0ee94d647cb21cc9f5e2b05cb74068d7d7ca9a4'],2,1,3,174608,1,1,0,0,886
8c7e2eb04c783e1f1cb7234c12b39e29cf68c903,1,Yi Pan (Data Infrastructure),2015-11-11 09:01:08-08:00,['22a1d6f18442d2623f76b769497f6c75004af883'],8,37,45,174653,2,0.181818182,1,1,886
bc7a07a1a0b8d610db2aec47d8c8363263478274,1,Yi Pan (Data Infrastructure),2015-11-17 10:19:23-08:00,['8c7e2eb04c783e1f1cb7234c12b39e29cf68c903'],30,30,60,174713,2,,,,886
74aa516fd84f510cd9e92e9bff90e480845763d2,0,Navina,2015-11-17 17:06:01-08:00,['bc7a07a1a0b8d610db2aec47d8c8363263478274'],0,18,18,174731,2,1,1,1,886
0e94975e522e40f7cb89e98bd923a071e4c07301,0,Navina,2015-11-18 12:43:44-08:00,['74aa516fd84f510cd9e92e9bff90e480845763d2'],13,24,37,174768,8,1,1,1,886
6bc141b4780e00e4d151892780d9208944d6730d,0,Yi Pan (Data Infrastructure),2015-11-19 00:00:38-08:00,['0e94975e522e40f7cb89e98bd923a071e4c07301'],7,13,20,174788,3,0,0,1,886
94f1e7ecdcd6d0d15aac9e0a8a050ee183d89b68,1,Navina,2015-11-19 00:23:31-08:00,['6bc141b4780e00e4d151892780d9208944d6730d'],9,105,114,174902,8,0.107142857,0.964285714,0.892857143,886
62254d0de822df878d982c399b08f809eb42ecf8,0,Yi Pan (Data Infrastructure),2015-11-19 11:29:30-08:00,['94f1e7ecdcd6d0d15aac9e0a8a050ee183d89b68'],1,56,57,174959,1,,,,886
092e381131cb7de9e9ffc0807e997418daa3498a,0,Navina,2015-11-19 14:21:16-08:00,['62254d0de822df878d982c399b08f809eb42ecf8'],12,6,18,174977,4,0,1,1,886
e8a2ef5efac39f56120c19abb50d84433df91b02,0,Navina,2015-11-19 14:52:42-08:00,['092e381131cb7de9e9ffc0807e997418daa3498a'],3,19,22,174999,3,0.3,0.3,0.3,886
429f245839bd359c1375302fa488d8c96ca83a45,1,Yi Pan (Data Infrastructure),2015-11-20 01:19:28-08:00,['e8a2ef5efac39f56120c19abb50d84433df91b02'],6,299,305,175304,5,0.394904459,1,0.949044586,887
c84a0b54d634de5a4c996ae3ce9742d98ae23342,1,Navina,2015-11-20 14:43:36-08:00,['429f245839bd359c1375302fa488d8c96ca83a45'],5,29,34,175338,3,0.045454545,1,0.954545455,887
fbfee750e4e85cefa59efba24e5839facc67058a,0,Yi Pan (Data Infrastructure),2015-11-24 09:17:38-08:00,['c84a0b54d634de5a4c996ae3ce9742d98ae23342'],0,2,2,175340,2,,,,887
2ba1ea69edc5699aaf31e4ee0609c31aa1324f47,1,Navina,2015-11-24 12:53:49-08:00,['fbfee750e4e85cefa59efba24e5839facc67058a'],5,163,168,175508,4,,,,888
9b849bb14fd8a8fc50e0ae4fd1a66674d42335d1,1,Navina,2015-11-24 14:01:44-08:00,['2ba1ea69edc5699aaf31e4ee0609c31aa1324f47'],5,122,127,175635,3,,,,889
acd340ecf9c0914a96e45da1289d076939653c99,0,Navina,2015-11-24 14:12:29-08:00,['9b849bb14fd8a8fc50e0ae4fd1a66674d42335d1'],0,0,0,175635,1,,,,890
72a558cebe50d98b5ef6a566b6cd8607b7032d96,1,Yi Pan (Data Infrastructure),2015-11-24 15:50:35-08:00,['acd340ecf9c0914a96e45da1289d076939653c99'],19,308,327,175962,9,0.819148936,0.968085106,0.861702128,890
4822050134e00ab9a48f64395bd5f82e33975ddd,0,Navina,2015-11-24 15:56:49-08:00,['72a558cebe50d98b5ef6a566b6cd8607b7032d96'],6,25,31,175993,2,,,,890
f7c870f8241eb105a9c12469a78241e866f97bdf,1,Yi Pan (Data Infrastructure),2015-11-24 19:30:02-08:00,['4822050134e00ab9a48f64395bd5f82e33975ddd'],24,24,48,176041,6,,,,890
20a1403f0547abaf92ea7faea9473e2a7a3bf239,1,Yi Pan (Data Infrastructure),2015-12-03 14:25:19-08:00,['f7c870f8241eb105a9c12469a78241e866f97bdf'],1,1,2,176043,1,,,,890
5d50c08308b1626be397a11521e3494ce086fb9f,0,Yi Pan (Data Infrastructure),2015-12-03 15:28:44-08:00,['20a1403f0547abaf92ea7faea9473e2a7a3bf239'],1,7,8,176051,1,,,,890
0c64c54eb3597ebd40d237e57c81cb28b80047ae,1,Yi Pan (Data Infrastructure),2015-12-03 16:05:18-08:00,['5d50c08308b1626be397a11521e3494ce086fb9f'],3,36,39,176090,2,0,1,1,890
7d54da21ccad26239f7958d73c4a9ef1940ce8bd,0,Yi Pan (Data Infrastructure),2015-12-03 17:14:55-08:00,['0c64c54eb3597ebd40d237e57c81cb28b80047ae'],1,1,2,176092,1,,,,890
d859378f65808f09dfe485d666b07b0ec75416d8,0,Yi Pan (Data Infrastructure),2015-12-07 14:20:23-08:00,['7d54da21ccad26239f7958d73c4a9ef1940ce8bd'],0,6,6,176098,1,,,,890
adf4f39af6666aeee1e8bc7f2c9ba6d208c6fa6e,0,Yi Pan (Data Infrastructure),2015-12-08 14:56:54-08:00,['d859378f65808f09dfe485d666b07b0ec75416d8'],12,61,73,176171,5,1,1,0.388888889,890
0fb05861017900a06acd38ad55ceef9dce6864d7,0,Yi Pan (Data Infrastructure),2015-12-18 16:52:25-08:00,['adf4f39af6666aeee1e8bc7f2c9ba6d208c6fa6e'],71,34,105,176276,15,,,,890
0bacbbe192d6f97ab6a2ab340e449be732aa3621,1,Navina,2015-12-22 15:52:52-08:00,['0fb05861017900a06acd38ad55ceef9dce6864d7'],3,7,10,176286,2,0,1,1,890
868cff7b6591b8dd4b413649ca4a92ca30dfd731,1,Navina,2016-01-06 14:15:26-08:00,['0bacbbe192d6f97ab6a2ab340e449be732aa3621'],60,143,203,176489,7,1,1,0,890
95ba041bc493769230e3171d95f5b2ab9da68442,1,Navina,2016-01-19 12:12:02-08:00,['868cff7b6591b8dd4b413649ca4a92ca30dfd731'],2,2,4,176493,2,,,,890
fc303e55955d6a4eeb4cbf17c229141b6e54ccaf,0,Yi Pan (Data Infrastructure),2016-01-20 11:12:56-08:00,['95ba041bc493769230e3171d95f5b2ab9da68442'],0,1,1,176494,1,0,0,1,890
73a939554c04a8725549fa8d954632d8ebdb2905,0,Navina,2016-02-03 14:48:27-08:00,['fc303e55955d6a4eeb4cbf17c229141b6e54ccaf'],2,3,5,176499,3,,,,890
6a5d49b84939389cbfebd50682863ae4ee865ec0,0,Navina,2016-02-03 15:20:00-08:00,['73a939554c04a8725549fa8d954632d8ebdb2905'],1,1,2,176501,1,,,,890
7c23e24f21b2e5d9aa2d5f2c66aea885d5ac4674,0,Yi Pan (Data Infrastructure),2016-02-08 11:10:18-08:00,['6a5d49b84939389cbfebd50682863ae4ee865ec0'],0,0,0,176501,3,,,,890
495f2eb8e66d0729f7d5b66cdcff47eda32ef8a6,1,Yi Pan (Data Infrastructure),2016-02-09 23:30:21-08:00,['7c23e24f21b2e5d9aa2d5f2c66aea885d5ac4674'],108,110,218,176719,4,1,1,0,890
2176430379aa6355a27148d1384fbc342b96f24a,1,Yi Pan (Data Infrastructure),2016-02-11 14:34:32-08:00,['495f2eb8e66d0729f7d5b66cdcff47eda32ef8a6'],1,9,10,176729,1,,,,890
4bcf88f5e38ed18ff485a29fa6a472a922c0900d,0,Yi Pan (Data Infrastructure),2016-02-12 17:29:22-08:00,['2176430379aa6355a27148d1384fbc342b96f24a'],7,5,12,176741,1,,,,890
1e97fb2e4322ccb246efcefb6920084e0bb1ac02,1,Yi Pan (Data Infrastructure),2016-02-18 10:53:37-08:00,['4bcf88f5e38ed18ff485a29fa6a472a922c0900d'],17,37,54,176795,3,0.6,1,1,890
9e8107ea7b710b4572fe18c5fd37bc0d0be47ad1,1,Yi Pan (Data Infrastructure),2016-02-19 10:06:31-08:00,['1e97fb2e4322ccb246efcefb6920084e0bb1ac02'],12,73,85,176880,7,0.181818182,1,0.363636364,890
5a2a28316e66bcae25468654c78575987c9c6b78,0,Yi Pan (Data Infrastructure),2016-02-19 10:23:52-08:00,['9e8107ea7b710b4572fe18c5fd37bc0d0be47ad1'],3,4,7,176887,1,,,,890
84e5aad38c874c0ad34457e65a8180a2ca9fe181,1,Yi Pan (Data Infrastructure),2016-02-29 13:28:23-08:00,['5a2a28316e66bcae25468654c78575987c9c6b78'],1,1,2,176889,1,,,,890
9abcc8eeceb54e1924e5da5dd2ff4f22a6a2ae43,1,Yi Pan (Data Infrastructure),2016-03-03 23:00:27-08:00,['84e5aad38c874c0ad34457e65a8180a2ca9fe181'],10,234,244,177133,7,1,1,1,893
d6051086fa09b148e9f7f6572e45e28a996635f7,0,Navina,2016-03-04 23:37:55-08:00,['9abcc8eeceb54e1924e5da5dd2ff4f22a6a2ae43'],1,1,2,177135,1,,,,893
bfba03b7bea731ffe7db1ed7e2a6441369e2cd9a,1,Yi Pan (Data Infrastructure),2016-03-07 16:30:03-08:00,['d6051086fa09b148e9f7f6572e45e28a996635f7'],206,554,760,177895,17,0.688741722,1,0.887417219,894
85ecf0a2c1e54d18f3ba0d2b724746abc15c740c,1,Yi Pan (Data Infrastructure),2016-03-09 16:16:25-08:00,['bfba03b7bea731ffe7db1ed7e2a6441369e2cd9a'],1,92,93,177988,15,1,1,1,894
964f56e752e0860012dbee4634e21743ef50684c,0,Navina Ramesh,2016-03-17 16:55:16-07:00,['85ecf0a2c1e54d18f3ba0d2b724746abc15c740c'],1,1,2,177990,1,,,,894
04ae6f5ce76344b915a011cf1f6447c9faa15485,0,Yi Pan (Data Infrastructure),2016-03-23 15:40:04-07:00,['964f56e752e0860012dbee4634e21743ef50684c'],3,4,7,177997,1,,,,894
a51f7b2b994cd2af0bec586a405fc426a2f8cf1b,1,Navina Ramesh,2016-03-24 19:18:53-07:00,['04ae6f5ce76344b915a011cf1f6447c9faa15485'],54,440,494,178491,13,0.25,0.709090909,1,897
f02386464d31b5a496bb0578838f51a0331bfffa,1,Yi Pan (Data Infrastructure),2016-03-25 11:52:19-07:00,['a51f7b2b994cd2af0bec586a405fc426a2f8cf1b'],6,63,69,178560,2,0.282051282,0.923076923,1,897
9d6831bd1093f6aedc061721c589dfa560132e1d,0,Navina Ramesh,2016-03-29 14:35:25-07:00,['f02386464d31b5a496bb0578838f51a0331bfffa'],6,17,23,178583,1,0.714285714,1,1,897
baf9faa1cc6170a89ea336326f85b2678772eccd,1,Navina Ramesh,2016-03-29 16:30:44-07:00,['9d6831bd1093f6aedc061721c589dfa560132e1d'],25,797,822,179405,13,0.673992674,0.937728938,0.901098901,907
1efcbf136fd989d83110a599ed5b74ab87fd2353,1,Navina Ramesh,2016-04-01 12:53:24-07:00,['baf9faa1cc6170a89ea336326f85b2678772eccd'],19,206,225,179630,10,0.445652174,1,0.945652174,907
5096ddb1bfec23f771f331159a4a11fe85e4760d,1,Yi Pan (Data Infrastructure),2016-04-04 13:35:37-07:00,['1efcbf136fd989d83110a599ed5b74ab87fd2353'],43,134,177,179807,3,0.370967742,1,1,907
3dce4935c3131340ab1e732c382742e086346f00,1,Yi Pan (Data Infrastructure),2016-04-04 13:57:42-07:00,['5096ddb1bfec23f771f331159a4a11fe85e4760d'],7,7,14,179821,4,,,,907
2a531b0bbfb11bfc1409f365d2d2fc920a7825ac,1,Yi Pan (Data Infrastructure),2016-04-04 17:26:25-07:00,['3dce4935c3131340ab1e732c382742e086346f00'],164,1769,1933,181754,18,0.265607264,0.920544835,0.961407491,914
57aae364bb919afcf25164e0204d3a776c779411,0,Yi Pan (Data Infrastructure),2016-04-09 10:11:02-07:00,['2a531b0bbfb11bfc1409f365d2d2fc920a7825ac'],1,2,3,181757,1,,,,914
dc67d1560c0ae76fe75e6b767b857ceb492cb7a8,1,Yi Pan (Data Infrastructure),2016-04-09 21:19:38-07:00,['57aae364bb919afcf25164e0204d3a776c779411'],7,569,576,182333,5,0.533057851,0.818181818,0.925619835,917
c9cc0368fb1dc4d5150a45d847cfd43d76b015f9,0,Chinmay Soman,2016-04-11 12:37:26-07:00,['dc67d1560c0ae76fe75e6b767b857ceb492cb7a8'],3,9,12,182345,2,1,0,0,917
ad23e69b73077e1d29323926d025756ae4a00f67,0,Navina Ramesh,2016-04-14 21:42:26-07:00,['c9cc0368fb1dc4d5150a45d847cfd43d76b015f9'],10,12,22,182367,3,1,1,1,917
0169912c65249ea18e1da856838866ee622006a9,0,Navina Ramesh,2016-04-14 23:12:18-07:00,['ad23e69b73077e1d29323926d025756ae4a00f67'],1,8,9,182376,1,0,1,1,917
ed5be4f927a9e3f5b92641b39b59f10b77cba894,0,Navina Ramesh,2016-04-14 23:33:44-07:00,['0169912c65249ea18e1da856838866ee622006a9'],7,12,19,182395,1,0,0,0,917
1497bf6c2629dd165f02352480584d3b3a9e5c18,0,Navina Ramesh,2016-04-15 14:21:16-07:00,['ed5be4f927a9e3f5b92641b39b59f10b77cba894'],479,464,943,183338,6,0.8,0,0,918
d05f9ca3822c4a9086827ccc9acf60ded9ad1600,0,Navina Ramesh,2016-04-18 16:18:36-07:00,['1497bf6c2629dd165f02352480584d3b3a9e5c18'],3,12,15,183353,2,1,1,1,918
a56a777699bce706dbf7c5086fea8c87e72507aa,0,Navina Ramesh,2016-04-20 10:30:39-07:00,['d05f9ca3822c4a9086827ccc9acf60ded9ad1600'],0,1,1,183354,1,,,,918
7f15302b056f19197fb50733135ab80d479fd1e7,0,Navina Ramesh,2016-04-20 12:53:41-07:00,['a56a777699bce706dbf7c5086fea8c87e72507aa'],17,4,21,183375,1,1,1,0,918
7cd1d397b3845268188a0cda82e0808c85275e18,1,Yi Pan (Data Infrastructure),2016-04-27 15:04:20-07:00,['7f15302b056f19197fb50733135ab80d479fd1e7'],11,58,69,183444,2,0,0,1,918
84cf4ae0a217a91b5cd303c8b536cc4903671411,0,Yi Pan (Data Infrastructure),2016-04-27 15:10:24-07:00,['7cd1d397b3845268188a0cda82e0808c85275e18'],1,1,2,183446,1,,,,918
efa50a7905a0027de15d1c7fe9fea6b256341690,1,Yi Pan (Data Infrastructure),2016-04-27 15:45:36-07:00,['84cf4ae0a217a91b5cd303c8b536cc4903671411'],1,50,51,183497,2,1,1,1,919
373181c5792b34d2c9c86ad1859cb01722584992,0,Yi Pan (Data Infrastructure),2016-04-28 16:02:47-07:00,['efa50a7905a0027de15d1c7fe9fea6b256341690'],92,1,93,183590,15,0,0,0,919
668a952ac628eb1d9cac58ec21797de9be2b9747,1,Yi Pan (Data Infrastructure),2016-05-02 11:06:21-07:00,['373181c5792b34d2c9c86ad1859cb01722584992'],4,168,172,183762,4,1,1,1,921
63ccf5eb14f07840a61fdb8b44d2750019e56181,1,Navina Ramesh,2016-05-05 10:30:33-07:00,['668a952ac628eb1d9cac58ec21797de9be2b9747'],87,177,264,184026,6,1,1,1,922
d4936b8993fd15aad0050c0465449fdc16a9992f,1,Navina Ramesh,2016-05-06 10:27:47-07:00,['63ccf5eb14f07840a61fdb8b44d2750019e56181'],144,286,430,184456,5,0.684210526,1,0.552631579,923
5a673604abe129cfab124265af7eba3eb05fd83b,0,Navina Ramesh,2016-05-06 11:17:46-07:00,['d4936b8993fd15aad0050c0465449fdc16a9992f'],1,13,14,184470,1,,,,923
9d3a687948d8e16550a91d8a560c88a3ac5e9e50,1,Navina Ramesh,2016-05-06 12:32:57-07:00,['5a673604abe129cfab124265af7eba3eb05fd83b'],17,46,63,184533,3,0,1,1,923
78a85047c71d53ad9ad74e5eed5b9ccf1d9cce36,0,Yi Pan (Data Infrastructure),2016-05-12 08:16:46-07:00,['9d3a687948d8e16550a91d8a560c88a3ac5e9e50'],11,12,23,184556,3,1,0,0,923
a460a82e366404498bac676a6b41acc27d458992,0,Yi Pan (Data Infrastructure),2016-05-12 10:56:44-07:00,['78a85047c71d53ad9ad74e5eed5b9ccf1d9cce36'],4,2,6,184562,1,1,1,1,923
023a7ce233631c14c40ee5241e13a298362d07b2,1,Yi Pan (Data Infrastructure),2016-05-12 11:07:49-07:00,['a460a82e366404498bac676a6b41acc27d458992'],57,43,100,184662,3,1,0,0,923
6ae7784a579d6aa310eb0eefdc75c40e4a13d4d7,1,Yi Pan (Data Infrastructure),2016-05-19 13:47:22-07:00,['023a7ce233631c14c40ee5241e13a298362d07b2'],0,65,65,184727,2,0.260869565,1,0.739130435,924
9f7abf535822a1de4d6ac6ee73cb3b879800e4a3,0,Yi Pan (Data Infrastructure),2016-05-23 19:51:17-07:00,['6ae7784a579d6aa310eb0eefdc75c40e4a13d4d7'],32,67,99,184826,5,1,1,0,924
947472a0b471716d88b0381c37ac372bd012fcf6,1,Yi Pan (Data Infrastructure),2016-06-02 14:50:55-07:00,['9f7abf535822a1de4d6ac6ee73cb3b879800e4a3'],63,5255,5318,190144,55,0.449763033,0.876777251,0.867298578,957
47993224273b00d402179dbae57e637619634671,1,Navina Ramesh,2016-06-07 12:05:27-07:00,['947472a0b471716d88b0381c37ac372bd012fcf6'],2,4,6,190150,1,0,0,0,957
7dd356c5010761bce22accf1c8a9f00f0a62d822,0,Yi Pan (Data Infrastructure),2016-06-07 14:39:13-07:00,['47993224273b00d402179dbae57e637619634671'],18,70,88,190238,2,0.392857143,0.75,1,957
76196b63c0ccd8d30646a2a3db6444ec17726715,0,Navina Ramesh,2016-06-07 17:57:13-07:00,['7dd356c5010761bce22accf1c8a9f00f0a62d822'],0,36,36,190274,1,1,1,0.8,957
725a526031848ceae94c8e079feb40af353daff8,1,Yi Pan (Data Infrastructure),2016-06-09 15:50:44-07:00,['76196b63c0ccd8d30646a2a3db6444ec17726715'],91,839,930,191204,16,0.584717608,0.833887043,1,964
f4bd84bbb7fe441355392d7ef0e920bb0b794f96,1,Navina Ramesh,2016-06-14 16:42:52-07:00,['725a526031848ceae94c8e079feb40af353daff8'],85,267,352,191556,12,0.132653061,0.602040816,1,964
312c1b17b047f778cb2915b059f3d7f455da58fe,1,Yi Pan (Data Infrastructure),2016-06-17 11:52:07-07:00,['f4bd84bbb7fe441355392d7ef0e920bb0b794f96'],14,20,34,191590,5,1,1,1,964
27c9e4c2ed114c12c040f449bfa6ed1af71bdb7d,1,Navina Ramesh,2016-06-20 15:55:01-07:00,['312c1b17b047f778cb2915b059f3d7f455da58fe'],28,2084,2112,193702,21,0.739393939,0.84040404,0.941414141,978
1b3b36b6ef7b3d841beec17243943696728b7972,0,Yi Pan (Data Infrastructure),2016-06-21 14:23:43-07:00,['27c9e4c2ed114c12c040f449bfa6ed1af71bdb7d'],2,6,8,193710,3,,,,978
de52eea07cd5ebb26cdfcf2afe9975dd9ab30623,1,Yi Pan (Data Infrastructure),2016-06-21 15:14:06-07:00,['1b3b36b6ef7b3d841beec17243943696728b7972'],3,531,534,194244,9,0.72027972,1,1,983
72daa81d490216100e1b411e42966250e7306f60,0,Yi Pan (Data Infrastructure),2016-06-21 15:28:04-07:00,['de52eea07cd5ebb26cdfcf2afe9975dd9ab30623'],2,135,137,194381,5,,,,984
89272b249d5dea203ce0c1b57e6a560648282958,0,Yi Pan (Data Infrastructure),2016-06-21 15:35:58-07:00,['72daa81d490216100e1b411e42966250e7306f60'],1,1,2,194383,1,,,,984
94e4e396ebf4b4dfbc6856d5f98b6cac90f761c9,0,Yi Pan (Data Infrastructure),2016-06-22 13:52:25-07:00,['89272b249d5dea203ce0c1b57e6a560648282958'],5,5,10,194393,1,,,,984
38e81c0f9b5a1dfeeac1a1c146aaaec9ec0987f2,1,Yi Pan (Data Infrastructure),2016-06-22 16:08:27-07:00,['94e4e396ebf4b4dfbc6856d5f98b6cac90f761c9'],915,466,1381,195774,16,0.358064516,0.967741935,0.916129032,985
5fab34e52982a2fe469106382dbd365fbf6f771f,1,Yi Pan (Data Infrastructure),2016-06-23 15:32:22-07:00,['38e81c0f9b5a1dfeeac1a1c146aaaec9ec0987f2'],1,92,93,195867,5,0.933333333,0.933333333,1,987
920f803a2e3dab809f4d7bb518259b0f4164407f,1,Navina Ramesh,2016-06-24 17:50:33-07:00,['5fab34e52982a2fe469106382dbd365fbf6f771f'],8,4,12,195879,1,1,0,1,987
9396ee5cc0a35e4e32844547eacebb24ae971c67,1,Yi Pan (Data Infrastructure),2016-07-12 10:08:51-07:00,['920f803a2e3dab809f4d7bb518259b0f4164407f'],4238,227,4465,200344,43,0.661263276,0.119060928,0.195640022,988
e5f31c57c957e6a38f566d864d0e5acffba0327d,1,Yi Pan (Data Infrastructure),2016-07-19 11:53:44-07:00,['9396ee5cc0a35e4e32844547eacebb24ae971c67'],477,3098,3575,203919,43,0.568930041,1,1,1005
2187d6bd9d942e0d95189531c4b4db23f30c042b,0,Yi Pan (Data Infrastructure),2016-07-20 17:07:32-07:00,['e5f31c57c957e6a38f566d864d0e5acffba0327d'],33,58,91,204010,4,0.142857143,1,1,1005
40445e2c6ce0e3f31d36373633ee5ea215f3024b,1,Yi Pan (Data Infrastructure),2016-07-27 10:16:30-07:00,['2187d6bd9d942e0d95189531c4b4db23f30c042b'],4,571,575,204585,11,0.524861878,1,1,1011
97a3be397812568e4aec0dffd5b18c0504cd1f67,1,Navina Ramesh,2016-07-29 12:08:34-07:00,['40445e2c6ce0e3f31d36373633ee5ea215f3024b'],4,7,11,204596,4,1,1,1,1011
74b0f8405a73fedda7a0b4b517f3946027d15626,0,Navina Ramesh,2016-07-29 12:58:23-07:00,['97a3be397812568e4aec0dffd5b18c0504cd1f67'],474,1,475,205071,6,0.680555556,0.009259259,0,1011
b3d5c4cc0d2babedc48015aebbbec6fb99d2a1ce,1,Navina Ramesh,2016-07-29 13:10:43-07:00,['74b0f8405a73fedda7a0b4b517f3946027d15626'],1,5,6,205077,2,1,1,0,1011
944dd02e1d00bcce59f1fcc33ecbb2a8acd95870,1,Navina Ramesh,2016-07-29 13:11:36-07:00,['b3d5c4cc0d2babedc48015aebbbec6fb99d2a1ce'],38,33,71,205148,6,,,,1011
60f529379132129766d22bd307c6893cbc9261b7,0,Navina Ramesh,2016-07-30 13:04:24-07:00,['944dd02e1d00bcce59f1fcc33ecbb2a8acd95870'],0,4,4,205152,1,,,,1011
220cfce5c11a4e77df3db906ed68bb8efea624ce,0,Yi Pan (Data Infrastructure),2016-08-01 11:40:09-07:00,['60f529379132129766d22bd307c6893cbc9261b7'],29,30,59,205211,13,,,,1011
0cdc31e5d4720b78b6b763b83935bdbeb9f2c912,1,Yi Pan (Data Infrastructure),2016-08-01 11:48:17-07:00,['220cfce5c11a4e77df3db906ed68bb8efea624ce'],18,59,77,205288,5,1,1,1,1011
4c55a837fadbeb862da33780e3868471f00d0db3,0,Navina Ramesh,2016-08-01 16:14:06-07:00,['0cdc31e5d4720b78b6b763b83935bdbeb9f2c912'],0,58,58,205346,1,,,,1011
2b7c0bdd5b4c8fa94e21d77a79acd403aa53cb83,0,Yi Pan (Data Infrastructure),2016-08-02 16:58:27-07:00,['4c55a837fadbeb862da33780e3868471f00d0db3'],0,88,88,205434,2,0,1,0.9375,1012
a29f2fb22eb84201e0e3b3144bf434f4c534ef93,0,Yi Pan (Data Infrastructure),2016-08-08 09:45:21-07:00,['2b7c0bdd5b4c8fa94e21d77a79acd403aa53cb83'],3,3,6,205440,2,,,,1012
7c783f15c8cf3c56c0c8e6738ba39bce425d777c,0,Navina Ramesh,2016-08-09 11:10:35-07:00,['a29f2fb22eb84201e0e3b3144bf434f4c534ef93'],9,10,19,205459,2,,,,1012
870eb1dd614c77d2626884a6b4d0e4479a254c4a,1,Yi Pan (Data Infrastructure),2016-08-09 11:31:29-07:00,['7c783f15c8cf3c56c0c8e6738ba39bce425d777c'],16,167,183,205642,3,0.623655914,1,1,1013
1bba876babab82845c8ecceb58aa9885216d00ab,1,Navina Ramesh,2016-08-09 18:19:56-07:00,['870eb1dd614c77d2626884a6b4d0e4479a254c4a'],13,21,34,205676,1,,,,1013
fbac87d8a1e36ed241fef7e547136f6d4334e04b,0,Navina Ramesh,2016-08-16 10:33:16-07:00,['1bba876babab82845c8ecceb58aa9885216d00ab'],0,0,0,205676,7,,,,1013
3dcd2e9ec8d0e91049aafbcabd23c716ecf82135,1,Navina Ramesh,2016-08-16 12:03:04-07:00,['fbac87d8a1e36ed241fef7e547136f6d4334e04b'],2,21,23,205699,1,1,1,1,1013
17e65d1cbdda1ad436f47c15fa4c86332e229a93,1,Yi Pan (Data Infrastructure),2016-08-18 16:32:13-07:00,['3dcd2e9ec8d0e91049aafbcabd23c716ecf82135'],6,10,16,205715,1,0,0,1,1013
260d1ff963eaa6ea6b0eb57ea9585a4751f40ddd,1,Navina Ramesh,2016-08-22 23:38:13-07:00,['17e65d1cbdda1ad436f47c15fa4c86332e229a93'],1,3083,3084,208799,45,0.691056911,0.833914053,0.933797909,1054
3902e20474fae3bcdd6a28e2b03eaaf303d0d85d,1,Navina Ramesh,2016-08-23 00:09:29-07:00,['260d1ff963eaa6ea6b0eb57ea9585a4751f40ddd'],4,670,674,209473,11,,,,1061
f493f5b9e7b1537eaf3cadfa3ec5fca6804a7f79,0,Yi Pan (Data Infrastructure),2016-09-07 15:29:37-07:00,['3902e20474fae3bcdd6a28e2b03eaaf303d0d85d'],5,7,12,209485,2,,,,1061
7b07df321b4312c13acc18bc46c765e44f794064,1,Navina Ramesh,2016-09-10 16:43:30-07:00,['f493f5b9e7b1537eaf3cadfa3ec5fca6804a7f79'],15,47,62,209547,9,1,,,1062
4ea6b7e3421772b291342d6fa48a0feebb75d5fc,0,Navina Ramesh,2016-09-10 17:30:23-07:00,['7b07df321b4312c13acc18bc46c765e44f794064'],9,7,16,209563,3,0,1,1,1062
242002ae0a6acd30c71db549c1e26b56e61da360,1,Navina Ramesh,2016-09-13 18:10:41-07:00,['4ea6b7e3421772b291342d6fa48a0feebb75d5fc'],12,892,904,210467,9,0,0,0,1063
0548e6af9f1a31beff0f137af4eb2c5020a51a4a,0,Yi Pan (Data Infrastructure),2016-09-14 01:40:09-07:00,['242002ae0a6acd30c71db549c1e26b56e61da360'],2,11,13,210480,1,0.9,1,1,1063
d0422de5f3a694d10802457d4c70a08dd7dfa1f0,1,Yi Pan (Data Infrastructure),2016-09-19 23:37:10-07:00,['0548e6af9f1a31beff0f137af4eb2c5020a51a4a'],50,138,188,210668,2,,,,1063
49dac97cbcb6fe0fe1b95af1e9cc3378dbd884c7,0,Navina Ramesh,2016-09-21 11:52:54-07:00,['d0422de5f3a694d10802457d4c70a08dd7dfa1f0'],1,1,2,210670,1,,,,1063
1c0a60bb74cc9188413ed99482e910e35359822d,0,vjagadish1989,2016-09-22 11:46:51-07:00,['49dac97cbcb6fe0fe1b95af1e9cc3378dbd884c7'],20,7,27,210697,1,0.625,0.625,0,1063
3228ed9c43fd952490689aea12b1f832055cfec9,0,Jacob Maes,2016-09-22 16:27:06-07:00,['1c0a60bb74cc9188413ed99482e910e35359822d'],0,5,5,210702,1,,,,1063
40ffe4ea5d45f048e12849ca3ac98325bbd9e99b,0,vjagadish1989,2016-09-22 16:45:34-07:00,['3228ed9c43fd952490689aea12b1f832055cfec9'],14,219,233,210935,6,,,,1064
e8e67ab156967eaaad1aed304fd26ef81efea127,1,Jacob Maes,2016-09-23 14:02:50-07:00,['40ffe4ea5d45f048e12849ca3ac98325bbd9e99b'],4,5,9,210944,1,0,1,1,1064
88c1442c449849d713c4920fd75635860e04aba4,0,Xinyu Liu,2016-09-26 16:14:46-07:00,['e8e67ab156967eaaad1aed304fd26ef81efea127'],0,9,9,210953,1,,,,1064
00cbee8c05ef54dc2983df2f1329a57fcd53d220,1,Xinyu Liu,2016-09-26 18:07:10-07:00,['88c1442c449849d713c4920fd75635860e04aba4'],0,60,60,211013,2,,,,1065
9d3803f95463c0fec5026d905cefbae760ca39e1,1,Jacob Maes,2016-09-27 12:15:56-07:00,['00cbee8c05ef54dc2983df2f1329a57fcd53d220'],120,371,491,211504,15,0.547619048,1,0.833333333,1069
fc7a547f33edb28f68a66ac4b5507596ebb1070a,0,Navina Ramesh,2016-09-27 19:40:21-07:00,['9d3803f95463c0fec5026d905cefbae760ca39e1'],0,501,501,212005,1,0.178181818,0.345454545,0.490909091,1070
623a0a9b2a0ae9390bc971b2ebdb005d5007a046,0,Navina Ramesh,2016-09-27 22:05:09-07:00,['fc7a547f33edb28f68a66ac4b5507596ebb1070a'],1,1,2,212007,1,,,,1070
985822028a71547189ce84faae3d6af1edd4c909,0,Jacob Maes,2016-09-29 06:56:24-07:00,['623a0a9b2a0ae9390bc971b2ebdb005d5007a046'],2,2,4,212011,1,,0,,1070
db31e8992c7bcbe17a5ad85bbab6105e232a626a,0,vjagadish1989,2016-09-29 11:48:22-07:00,['985822028a71547189ce84faae3d6af1edd4c909'],55,0,55,212066,3,0,0,0,1070
317b6ff1be8b497cd1468fddf3975b2832cf9d74,0,vjagadish1989,2016-09-29 11:54:49-07:00,['db31e8992c7bcbe17a5ad85bbab6105e232a626a'],14,5,19,212085,6,,,,1070
61d35f26c1f924f376b30f60d05c1957364c05e5,1,vjagadish1989,2016-09-29 14:52:27-07:00,['317b6ff1be8b497cd1468fddf3975b2832cf9d74'],22,47,69,212154,1,0,1,1,1070
e6956a37ba358b45b12df2ceeb6add5834fc8dd6,0,Xinyu Liu,2016-09-29 15:45:17-07:00,['61d35f26c1f924f376b30f60d05c1957364c05e5'],1,1,2,212156,1,,,,1070
36bcbacc27faf07621fad44e8edea58eafb94fae,0,vjagadish1989,2016-09-29 18:09:04-07:00,['e6956a37ba358b45b12df2ceeb6add5834fc8dd6'],83,128,211,212367,7,,,,1071
19ef7cdf75c3d34bb6ee518160b6e7f046e1d1e1,0,vjagadish1989,2016-09-30 11:35:06-07:00,['36bcbacc27faf07621fad44e8edea58eafb94fae'],49,59,108,212475,5,,,,1071
7ae261afa55592934f2c30c69671ed8d7f9e7ce9,0,vjagadish1989,2016-09-30 11:47:53-07:00,['19ef7cdf75c3d34bb6ee518160b6e7f046e1d1e1'],0,47,47,212522,1,,,,1071
9126d373d083787e9489f03c61ae59657705cfdc,1,vjagadish1989,2016-09-30 23:07:30-07:00,['7ae261afa55592934f2c30c69671ed8d7f9e7ce9'],42,407,449,212971,13,0.314720812,0.624365482,0.954314721,1072
f4d924fd23e08eefac746bab5895219184739152,0,Jacob Maes,2016-10-04 08:54:10-07:00,['9126d373d083787e9489f03c61ae59657705cfdc'],18,16,34,213005,1,1,1,1,1072
2216fe0b7b250e2edfc14d150e59f84884e8cba4,1,Xinyu Liu,2016-10-05 11:39:17-07:00,['f4d924fd23e08eefac746bab5895219184739152'],101,2654,2755,215760,27,0.504579517,0.958368027,0.940882598,1092
d5bded34e847375fbd32fd89967608cdac49903c,1,Xinyu Liu,2016-10-18 14:27:16-07:00,['2216fe0b7b250e2edfc14d150e59f84884e8cba4'],20,30,50,215810,11,,,,1092
eed44d52e19883c2bbdbafa2278681121b11a71a,1,Xinyu Liu,2016-10-19 11:27:50-07:00,['d5bded34e847375fbd32fd89967608cdac49903c'],3,2,5,215815,1,,,,1092
2aa9f893dcf6c8403aa0ff68faefebd36f900c1c,0,Jacob Maes,2016-10-19 11:45:03-07:00,['eed44d52e19883c2bbdbafa2278681121b11a71a'],5,90,95,215910,4,0,1,1,1093
4aae9ad8ccd1c5ff9fdecb812d16c5aaf91c4b92,1,Xinyu Liu,2016-10-19 12:05:24-07:00,['2aa9f893dcf6c8403aa0ff68faefebd36f900c1c'],117,559,676,216586,12,0.850961538,1,0.956730769,1096
9b0861f1e776248f25519c04e875e97ecba0a389,0,Xinyu Liu,2016-10-20 17:57:40-07:00,['4aae9ad8ccd1c5ff9fdecb812d16c5aaf91c4b92'],2,32,34,216620,3,0.352941176,0.529411765,1,1096
2c9ea1a5ca6bcebe8560356d82163cf58af60a72,0,Xinyu Liu,2016-10-20 18:01:48-07:00,['9b0861f1e776248f25519c04e875e97ecba0a389'],1,11,12,216632,2,1,1,1,1096
99667d90265e151cf89c035105a9b977bb5b9ac0,0,Navina Ramesh,2016-10-31 17:14:25-07:00,['2c9ea1a5ca6bcebe8560356d82163cf58af60a72'],283,0,283,216915,2,,,,1096
4660d4ddd35b2aedc27fb783483e2928325da7f1,0,vjagadish1989,2016-10-31 17:40:24-07:00,['99667d90265e151cf89c035105a9b977bb5b9ac0'],1,1,2,216917,1,,,,1096
715b67d08165418acdfa4ade3cd5f97a0b62e098,1,Xinyu Liu,2016-11-09 11:09:32-08:00,['4660d4ddd35b2aedc27fb783483e2928325da7f1'],230,223,453,217370,19,0.235294118,0,0.588235294,1096
4b560fc6987ab1ea9e20bb354df5937f4e5e0441,1,Navina Ramesh,2016-11-14 10:30:07-08:00,['715b67d08165418acdfa4ade3cd5f97a0b62e098'],23,156,179,217549,5,0.565217391,0.608695652,0.956521739,1097
362658938d86bdc28557bea6bdf61224e16f3072,1,Jacob Maes,2016-11-21 16:56:22-08:00,['4b560fc6987ab1ea9e20bb354df5937f4e5e0441'],87,190,277,217826,14,0.896551724,1,0.413793103,1099
202a15809ee4abc7700af9b02e903f2ebd57a662,0,vjagadish1989,2016-11-22 14:36:14-08:00,['362658938d86bdc28557bea6bdf61224e16f3072'],0,18,18,217844,1,,,,1099
1e5f30f38e9d67fd73ead817bdeb5eae22da78dd,1,Yi Pan (Data Infrastructure),2016-11-22 15:47:48-08:00,['202a15809ee4abc7700af9b02e903f2ebd57a662'],37,4834,4871,222715,61,0.594414894,0.970744681,0.934175532,1151
3cde990d02d8db70b3396ad8b722cd5441775846,0,Yi Pan (Data Infrastructure),2016-11-29 16:17:37-08:00,['1e5f30f38e9d67fd73ead817bdeb5eae22da78dd'],4,5,9,222724,3,,,,1151
5dd4d02a8307a87a44ec74433e711efd2f2ee937,0,Yi Pan (Data Infrastructure),2016-11-30 14:06:54-08:00,['3cde990d02d8db70b3396ad8b722cd5441775846'],3,6,9,222733,1,,,,1151
a980c962278075b831163351be14abe7f385357e,1,Yi Pan (Data Infrastructure),2016-11-30 14:34:49-08:00,['5dd4d02a8307a87a44ec74433e711efd2f2ee937'],5,14,19,222752,2,0,1,1,1151
00543804b3c32f1cbea0212e4a94e360b5a324cc,1,Yi Pan (Data Infrastructure),2016-12-01 14:50:52-08:00,['a980c962278075b831163351be14abe7f385357e'],2588,2722,5310,228062,71,0.268292683,0.37804878,0.243902439,1174
1d458050c06deefc1dcf3d3e9534631aece64553,0,Navina Ramesh,2016-12-12 11:51:17-08:00,['00543804b3c32f1cbea0212e4a94e360b5a324cc'],1,1,2,228064,1,,,,1174
97edf105edec1d14091ca3eb1fc2449c28817834,0,Navina Ramesh,2016-12-14 18:24:10-08:00,['1d458050c06deefc1dcf3d3e9534631aece64553'],5,61,66,228130,2,0,1,1,1174
7e1c92c08be31a496b053b5a6add2e598352f520,0,Navina Ramesh,2016-12-16 13:56:21-08:00,['97edf105edec1d14091ca3eb1fc2449c28817834'],0,12,12,228142,1,,,,1174
9930e5fee9670ab09807c6437fe0c72567c1aa3c,1,Yi Pan (Data Infrastructure),2016-12-21 17:25:31-08:00,['7e1c92c08be31a496b053b5a6add2e598352f520'],8,37,45,228187,7,,,,1175
6666ced0c5d3c80416a51784dd59d00b3323fc30,0,Yi Pan (Data Infrastructure),2016-12-21 23:14:53-08:00,['9930e5fee9670ab09807c6437fe0c72567c1aa3c'],6,3,9,228196,4,,,,1175
c65802a98ed8ee7c6481352387e42c58682dc067,1,Yi Pan (Data Infrastructure),2016-12-23 12:22:55-08:00,['6666ced0c5d3c80416a51784dd59d00b3323fc30'],335,220,555,228751,19,0,0,0.45,1175
492a3d79dc2c1ad4fe83456dc29a5dffd5fc183e,1,Navina Ramesh,2016-12-23 12:29:45-08:00,['c65802a98ed8ee7c6481352387e42c58682dc067'],3,49,52,228803,2,0.413793103,1,1,1175
52ff04197dacc5ab18137d7c9e0667e8212ab216,1,Yi Pan (Data Infrastructure),2016-12-23 14:32:01-08:00,['492a3d79dc2c1ad4fe83456dc29a5dffd5fc183e'],12,16,28,228831,1,0,0,1,1175
965a645d84f7118cb68f2994233ed61f67dbc690,0,Yi Pan (Data Infrastructure),2016-12-23 15:08:55-08:00,['52ff04197dacc5ab18137d7c9e0667e8212ab216'],11,11,22,228853,2,,,,1175
a47e8819f2a17d3481bbb3e3230019d6a9cbaa4d,0,Yi Pan (Data Infrastructure),2016-12-23 16:13:00-08:00,['965a645d84f7118cb68f2994233ed61f67dbc690'],3,3,6,228859,2,,,,1175
ec1934ca895a57bd2199bd0a34413284914718d9,1,vjagadish1989,2017-01-06 12:22:16-08:00,['a47e8819f2a17d3481bbb3e3230019d6a9cbaa4d'],6,15,21,228880,2,0,1,1,1175
db8b228d95d605503cce7edf8b9c390849247428,0,Xinyu Liu,2017-01-11 10:42:26-08:00,['ec1934ca895a57bd2199bd0a34413284914718d9'],0,36,36,228916,1,,,,1175
f01b2862879b640456a46e0a6fe375cfe7e17b37,1,vjagadish1989,2017-01-30 10:58:46-08:00,['db8b228d95d605503cce7edf8b9c390849247428'],1,151,152,229068,4,,,,1176
6dc33a8504e3e2335cffe3317be1c0ccb5448458,1,vjagadish1989,2017-01-30 13:50:16-08:00,['f01b2862879b640456a46e0a6fe375cfe7e17b37'],1677,1170,2847,231915,42,0.835,0,0,1189
c6c10d31e37be3c9b07d202d17bcba6cb1213c3b,1,vjagadish1989,2017-01-30 14:44:10-08:00,['6dc33a8504e3e2335cffe3317be1c0ccb5448458'],2,61,63,231978,2,1,1,0.6,1189
1c7e4d7aaeb4b5036034c9182fa0259262bcda8e,1,vjagadish1989,2017-01-30 14:58:50-08:00,['c6c10d31e37be3c9b07d202d17bcba6cb1213c3b'],41,69,110,232088,4,0,0,1,1189
bf9bc2c373f3456159fdc610f268992e8d9a476c,0,vjagadish1989,2017-01-30 15:10:06-08:00,['1c7e4d7aaeb4b5036034c9182fa0259262bcda8e'],3,173,176,232264,2,0.166666667,1,1,1190
154cda2c7f7b6569557a188484e262882af3f4f2,0,vjagadish1989,2017-01-30 15:56:56-08:00,['bf9bc2c373f3456159fdc610f268992e8d9a476c'],2,2,4,232268,1,,,,1190
2a3a5ac7f21dc4213ff6ec96e11a798bff096d04,1,navina,2017-01-30 18:30:02-08:00,['154cda2c7f7b6569557a188484e262882af3f4f2'],134,1826,1960,234228,32,0.415437003,0.556186152,0.354143019,1208
d87ca67e5ec4d201d425bebc73968e3699980d1d,1,vjagadish1989,2017-01-31 15:36:18-08:00,['2a3a5ac7f21dc4213ff6ec96e11a798bff096d04'],1,1,2,234230,1,,,,1208
0405f25f066dcf80073f58fbdf636b652b4af67b,0,vjagadish1989,2017-02-01 13:37:23-08:00,['d87ca67e5ec4d201d425bebc73968e3699980d1d'],0,58,58,234288,1,,,,1208
fcb44be80d9a6a4e07a6865efb6ffd7018386f7e,1,vjagadish1989,2017-02-02 14:09:40-08:00,['0405f25f066dcf80073f58fbdf636b652b4af67b'],1,1,2,234290,1,,,,1208
1f4a593288ef5e216377777adb30d91e442c4d7c,0,Xinyu Liu,2017-02-02 14:33:00-08:00,['fcb44be80d9a6a4e07a6865efb6ffd7018386f7e'],4,5,9,234299,1,,,,1208
e57b4a342b4b60c1b8f8db1d088325921814b207,1,vjagadish1989,2017-02-06 15:39:56-08:00,['1f4a593288ef5e216377777adb30d91e442c4d7c'],1,1,2,234301,1,,,,1208
38b1dc38dfc0b71df5dd5ca983c4c668a6cc20be,1,Jacob Maes,2017-02-08 16:07:27-08:00,['e57b4a342b4b60c1b8f8db1d088325921814b207'],34,161,195,234496,6,0.597014925,0.925373134,0.970149254,1208
2226e3e710171336e0904c5a097d8ac8fff9f517,1,navina,2017-02-13 13:32:06-08:00,['38b1dc38dfc0b71df5dd5ca983c4c668a6cc20be'],3,1226,1229,235725,13,0.574861368,0.902033272,0.981515712,1218
09bf8339ce7ed893c3a2971d49c91fda845f1675,1,navina,2017-02-15 17:17:01-08:00,['2226e3e710171336e0904c5a097d8ac8fff9f517'],0,196,196,235921,2,0.166666667,1,0.782051282,1220
c249443b1a5b427bc3fab0303b3069133ec0caad,1,Yi Pan (Data Infrastructure),2017-02-16 10:18:09-08:00,['09bf8339ce7ed893c3a2971d49c91fda845f1675'],1006,3080,4086,240007,73,0.675599436,0.909732017,0.7348378,1242
daaad7b84837a5fc7f995234248d3349a7f6f1d2,1,navina,2017-02-16 11:40:12-08:00,['c249443b1a5b427bc3fab0303b3069133ec0caad'],8,355,363,240370,6,0.290697674,0.848837209,0.976744186,1245
8515448a2023ae6c78b9b0bb8e297cf346775e13,0,Yi Pan (Data Infrastructure),2017-02-16 15:04:01-08:00,['daaad7b84837a5fc7f995234248d3349a7f6f1d2'],42,1,43,240413,43,,,,1245
7e7747fb99b30aa25078b5a59911c39d32f95921,1,Jacob Maes,2017-02-17 12:49:19-08:00,['8515448a2023ae6c78b9b0bb8e297cf346775e13'],130,700,830,241243,8,0.898876404,1,0.758426966,1249
6939b8cf9c4a7b34d2426fb45c0c55d10ebfeafe,0,Jacob Maes,2017-02-17 15:37:22-08:00,['7e7747fb99b30aa25078b5a59911c39d32f95921'],1,1,2,241245,1,,,,1249
062ac56d1169ba4af273d7f92e3d6cb1cc553ca8,1,Jacob Maes,2017-02-21 16:49:37-08:00,['6939b8cf9c4a7b34d2426fb45c0c55d10ebfeafe'],1,1,2,241247,1,,,,1249
eab180010e9e4cd3511b55c838681b0b12e21f94,0,Yi Pan (Data Infrastructure),2017-02-21 17:16:58-08:00,['062ac56d1169ba4af273d7f92e3d6cb1cc553ca8'],2,2,4,241251,2,,,,1249
b5ea8776ee5565cf12ef4bd4a0b1a0fde11154a4,1,vjagadish1989,2017-02-22 12:45:13-08:00,['eab180010e9e4cd3511b55c838681b0b12e21f94'],32,52,84,241335,11,,,,1249
e6147fdac31851e2fe91ab0740d7f2780fc87067,1,Yi Pan (Data Infrastructure),2017-02-23 12:48:56-08:00,['b5ea8776ee5565cf12ef4bd4a0b1a0fde11154a4'],257,69,326,241661,12,0.5078125,0,0,1249
f1bc1d0b36242170930c0001c9efa7e5c24f8dd0,1,navina,2017-02-23 14:02:05-08:00,['e6147fdac31851e2fe91ab0740d7f2780fc87067'],59,549,608,242269,11,0.191570881,0.988505747,0.846743295,1252
65df0b5df2931f9383e4b1f21e5b9f0901b6286f,0,navina,2017-02-24 18:17:44-08:00,['f1bc1d0b36242170930c0001c9efa7e5c24f8dd0'],1,1,2,242271,1,,,,1252
098a11d773590e6323fae21d534c3420f622ec55,0,vjagadish1989,2017-02-27 17:31:29-08:00,['65df0b5df2931f9383e4b1f21e5b9f0901b6286f'],1,1,2,242273,1,,,,1252
c58d74b355d8406dae7428b6ccc15c634a964216,0,vjagadish1989,2017-02-27 17:39:00-08:00,['098a11d773590e6323fae21d534c3420f622ec55'],1,1,2,242275,1,,,,1252
4d7b3b3534ed804ad54227901bf3bbaff32814e1,1,navina,2017-02-28 17:56:50-08:00,['c58d74b355d8406dae7428b6ccc15c634a964216'],16,379,395,242670,8,0.401197605,0.832335329,0.916167665,1255
d104013ef16ffd959916a52e9e3f6e67a6e486b3,1,navina,2017-03-01 13:49:29-08:00,['4d7b3b3534ed804ad54227901bf3bbaff32814e1'],5,128,133,242803,3,0.41025641,1,1,1255
e6c1eed4f1d576661abafce8477c1749c2554b39,1,Jacob Maes,2017-03-06 14:52:18-08:00,['d104013ef16ffd959916a52e9e3f6e67a6e486b3'],113,810,923,243726,15,0.820512821,1,0.996336996,1257
1956dac94b2c41e3e99a0e47d1f5704882b10bbd,1,Xinyu Liu,2017-03-07 15:02:30-08:00,['e6c1eed4f1d576661abafce8477c1749c2554b39'],83,101,184,243910,10,1,1,1,1257
6f811de30a2db7a1616839499f520663087e6345,0,vjagadish1989,2017-03-08 00:26:46-08:00,['1956dac94b2c41e3e99a0e47d1f5704882b10bbd'],3,3,6,243916,1,0,1,1,1257
a974b236a78826d993e50d8936a4cc393a97bfe4,1,Xinyu Liu,2017-03-08 17:16:51-08:00,['6f811de30a2db7a1616839499f520663087e6345'],69,422,491,244407,11,0.676300578,1,0.826589595,1259
e3f85871c40770ea06c99fdd121cbaa883e5d602,1,Xinyu Liu,2017-03-10 14:08:18-08:00,['a974b236a78826d993e50d8936a4cc393a97bfe4'],74,114,188,244595,10,0.178571429,1,0.964285714,1259
5a88b9e47cd9b2a2aba742ff4fe8eeefb7a87e92,1,vjagadish1989,2017-03-11 06:56:48-08:00,['e3f85871c40770ea06c99fdd121cbaa883e5d602'],7,15,22,244617,2,1,1,1,1259
ffd04d9d674437b44d438e3e372aa0cbbf6b7044,1,vjagadish1989,2017-03-13 12:07:45-07:00,['5a88b9e47cd9b2a2aba742ff4fe8eeefb7a87e92'],29,98,127,244744,5,0,1,0.916666667,1259
5910ea66970e1e26d0107e4d2e0ef065a59b3af0,1,vjagadish1989,2017-03-14 13:44:54-07:00,['ffd04d9d674437b44d438e3e372aa0cbbf6b7044'],121,616,737,245481,18,0.906976744,1,0.697674419,1261
5f7b250278f2a1a91b75438a2e80cb70a8347040,1,vjagadish1989,2017-03-14 14:00:19-07:00,['5910ea66970e1e26d0107e4d2e0ef065a59b3af0'],1,5,6,245487,2,,,,1261
1676eabc21eae2b0d5aa7d22890b1f7eb1cbb441,1,Xinyu Liu,2017-03-15 18:27:01-07:00,['5f7b250278f2a1a91b75438a2e80cb70a8347040'],24,1406,1430,246917,10,0.48,0.831428571,0.918571429,1267
628f0d08b9896d518b599c6d69cc62ae562369d8,1,Xinyu Liu,2017-03-16 15:18:37-07:00,['1676eabc21eae2b0d5aa7d22890b1f7eb1cbb441'],2,3,5,246922,1,,,,1267
779c3d80e6c9af05a93286a593a138a2c5f03eb9,0,Xinyu Liu,2017-03-17 11:42:34-07:00,['628f0d08b9896d518b599c6d69cc62ae562369d8'],62,115,177,247099,3,0.348837209,1,1,1267
a080ca21ba24c476fe2136134db93eadc5748a90,1,Xinyu Liu,2017-03-17 11:46:34-07:00,['779c3d80e6c9af05a93286a593a138a2c5f03eb9'],23,178,201,247300,4,0,0.481481481,0.925925926,1267
eb5d452aec39e34ef4ea3b3464cc4c84f1bf32c0,1,Xinyu Liu,2017-03-17 11:54:57-07:00,['a080ca21ba24c476fe2136134db93eadc5748a90'],20,122,142,247442,14,0.384615385,1,1,1269
05915bfc8009780d1ef68a13c54bdda53d05b135,1,Yi Pan (Data Infrastructure),2017-03-18 00:28:41-07:00,['eb5d452aec39e34ef4ea3b3464cc4c84f1bf32c0'],114,714,828,248270,29,0.068493151,0.784246575,0.989726027,1276
d399d6f3ca0fa20afcfad5864ec7f8550aa7a00f,1,vjagadish1989,2017-03-19 12:31:21-07:00,['05915bfc8009780d1ef68a13c54bdda53d05b135'],218,1885,2103,250373,46,0.639053254,0.918639053,0.792899408,1293
26280cac2afb4066c10e669e98e4dfcb4415e79a,1,Xinyu Liu,2017-03-20 10:53:57-07:00,['d399d6f3ca0fa20afcfad5864ec7f8550aa7a00f'],256,1475,1731,252104,32,0.679878049,0.75,1,1309
bd71d609c6472ffef90c59e695fe7d275627bae0,1,Xinyu Liu,2017-03-20 15:18:27-07:00,['26280cac2afb4066c10e669e98e4dfcb4415e79a'],0,571,571,252675,8,0.850574713,0.850574713,0.925287356,1315
e2c35c00068f071840332a200d9879e07fdb1001,1,Jacob Maes,2017-03-22 07:59:08-07:00,['bd71d609c6472ffef90c59e695fe7d275627bae0'],82,85,167,252842,4,1,1,1,1315
1c27ba88a860965ec774d40f65a8b18587ba0d7c,0,vjagadish1989,2017-03-22 13:45:02-07:00,['e2c35c00068f071840332a200d9879e07fdb1001'],1,1,2,252844,1,,,,1315
1bb737a8d049a815927000766f85620f8aec657b,0,navina,2017-03-23 14:25:53-07:00,['1c27ba88a860965ec774d40f65a8b18587ba0d7c'],77,78,155,252999,5,1,1,0,1315
9d52e996b5221c8aae71446b9ce2ebfa0dde3e82,1,Xinyu Liu,2017-03-24 13:49:30-07:00,['1bb737a8d049a815927000766f85620f8aec657b'],159,255,414,253413,11,0.833333333,1,1,1317
e4cfeebebf3ec94ca3b5aca2e4aed10e77db38ae,0,vjagadish1989,2017-03-27 10:34:12-07:00,['9d52e996b5221c8aae71446b9ce2ebfa0dde3e82'],59,836,895,254308,14,0.780058651,0.958944282,0.914956012,1325
61cf4e4dfbb7449b6901673f7b7363d329080300,1,Xinyu Liu,2017-03-27 17:33:42-07:00,['e4cfeebebf3ec94ca3b5aca2e4aed10e77db38ae'],2,3,5,254313,1,1,1,1,1325
553ce33b1ad993f1b62e8a0f735287feffd433e4,1,navina,2017-03-29 10:44:49-07:00,['61cf4e4dfbb7449b6901673f7b7363d329080300'],434,1157,1591,255904,31,0.426923077,0.992307692,0.95,1334
6f1b3db2c4a1a2ef22ec023c6b3ed9f54766ae3e,1,Xinyu Liu,2017-03-29 10:49:25-07:00,['553ce33b1ad993f1b62e8a0f735287feffd433e4'],6,65,71,255975,5,0.428571429,0.857142857,1,1334
b938df623f90b75dd325567bc50354424774927a,0,Xinyu Liu,2017-03-29 13:43:10-07:00,['6f1b3db2c4a1a2ef22ec023c6b3ed9f54766ae3e'],1,0,1,255976,1,,,,1334
daed7a9a31f30dd5d993407b33b5dd30f4ef7dda,1,Jacob Maes,2017-03-29 13:57:26-07:00,['b938df623f90b75dd325567bc50354424774927a'],42,332,374,256350,5,1,1,0.941176471,1335
a989c08b1e4d460eca482452821cb09a57f1805c,1,Jacob Maes,2017-03-29 14:07:34-07:00,['daed7a9a31f30dd5d993407b33b5dd30f4ef7dda'],10,71,81,256431,5,0.3,1,0.9,1336
d7fc811d64255d9a32ca3ecc3484afdef4e5caf5,1,nramesh,2017-03-29 16:25:16-07:00,['a989c08b1e4d460eca482452821cb09a57f1805c'],27,22,49,256480,5,0,0,1,1336
9db47b86120f80b127d2bca857b6a1cd5578a6d4,1,vjagadish1989,2017-03-31 10:26:08-07:00,['d7fc811d64255d9a32ca3ecc3484afdef4e5caf5'],599,595,1194,257674,95,1,1,0.727272727,1337
944c70878797a316be0a5be4f4d3ad9238666f3c,0,nramesh,2017-03-31 13:48:35-07:00,['9db47b86120f80b127d2bca857b6a1cd5578a6d4'],4,8,12,257686,2,,,,1337
71004e1eb07bd57dfd5f5e72148476cbf646f3c3,1,vjagadish1989,2017-03-31 14:00:30-07:00,['944c70878797a316be0a5be4f4d3ad9238666f3c'],41,76,117,257803,1,1,1,1,1337
888e06173603bdeac1923b8f74b3c0c6abe93be4,1,Xinyu Liu,2017-03-31 15:58:22-07:00,['71004e1eb07bd57dfd5f5e72148476cbf646f3c3'],67,56,123,257926,1,1,1,0,1337
101ca439b8b22926db7423309a3ff880f396271a,0,vjagadish1989,2017-04-02 16:18:43-07:00,['888e06173603bdeac1923b8f74b3c0c6abe93be4'],42,9,51,257977,2,0,0,0,1337
311f9d12e983ac3c3ab7dc62a16a145e3d05e1ab,1,Jacob Maes,2017-04-03 09:50:27-07:00,['101ca439b8b22926db7423309a3ff880f396271a'],157,641,798,258775,18,0.625,0.875,1,1340
b70ee983b7af4f5d47e1f7368d5f42e08937d16f,1,Xinyu Liu,2017-04-03 18:24:33-07:00,['311f9d12e983ac3c3ab7dc62a16a145e3d05e1ab'],385,462,847,259622,10,0.367346939,1,0.918367347,1341
65af13df1f8aa29e1bcf9a83232b4c58fde28b09,0,Jacob Maes,2017-04-04 20:37:32-07:00,['b70ee983b7af4f5d47e1f7368d5f42e08937d16f'],1,1,2,259624,1,,,,1341
4bf8ab6ebdf95cdf78f07b81a3b450a7f3fd9d45,1,vjagadish1989,2017-04-05 16:42:15-07:00,['65af13df1f8aa29e1bcf9a83232b4c58fde28b09'],1938,1046,2984,262608,51,0.046428571,0,0.057142857,1345
b5e45b7ec9714391d85af23944efc113905cb5ed,0,vjagadish1989,2017-04-05 22:26:09-07:00,['4bf8ab6ebdf95cdf78f07b81a3b450a7f3fd9d45'],4,0,4,262612,1,,,,1345
c1b778a01277d41e538f3d467d81cd8e69e033a5,0,vjagadish1989,2017-04-05 22:28:38-07:00,['b5e45b7ec9714391d85af23944efc113905cb5ed'],37,54,91,262703,5,0,1,0.764705882,1345
ab7930502253c58facf077d64881691f6bc3b985,1,Xinyu Liu,2017-04-06 09:58:38-07:00,['c1b778a01277d41e538f3d467d81cd8e69e033a5'],115,532,647,263350,9,0.661290323,1,0.822580645,1348
d6bd2d7072b02a4efee3ac90c7389579abbf4dc1,1,Jacob Maes,2017-04-06 15:35:39-07:00,['ab7930502253c58facf077d64881691f6bc3b985'],4,4,8,263358,1,,,,1348
fb51bfae2fd6365554fedcc47db636c339b55714,1,Jacob Maes,2017-04-07 14:32:02-07:00,['d6bd2d7072b02a4efee3ac90c7389579abbf4dc1'],6,67,73,263431,2,1,1,1,1348
c74722b4709962149a2989d66dbc51a68eb469e6,0,nramesh,2017-04-07 15:17:10-07:00,['fb51bfae2fd6365554fedcc47db636c339b55714'],1,2,3,263434,1,,,,1348
a7da1840f17a182b49c30451f35991c97fc51068,1,nramesh,2017-04-07 15:22:13-07:00,['c74722b4709962149a2989d66dbc51a68eb469e6'],634,898,1532,264966,70,0.714285714,0.989795918,1,1351
ca0f3c612c0f4b9b583c33b13e2340ac7910314e,1,nramesh,2017-04-07 17:00:28-07:00,['a7da1840f17a182b49c30451f35991c97fc51068'],241,148,389,265355,6,1,0,0,1351
260414dbf1c90066d9f53cd0e082de728d560988,0,nramesh,2017-04-10 13:53:03-07:00,['ca0f3c612c0f4b9b583c33b13e2340ac7910314e'],1,2,3,265358,1,,,,1351
8a18a708a8ea8490122a649b28dd8c9f59bac044,1,vjagadish1989,2017-04-11 17:56:54-07:00,['260414dbf1c90066d9f53cd0e082de728d560988'],1,545,546,265904,8,0.371069182,0.86163522,0.823899371,1357
f5c8c56b49d8b01b560699bf2b0fe4c592b534bb,1,nramesh,2017-04-12 18:40:01-07:00,['8a18a708a8ea8490122a649b28dd8c9f59bac044'],2,2,4,265908,1,,,,1357
9fb5a827bf84bb5e8ce98d70b9c0abf35a178865,1,Xinyu Liu,2017-04-13 15:39:23-07:00,['f5c8c56b49d8b01b560699bf2b0fe4c592b534bb'],103,662,765,266673,15,0.238562092,1,0.794117647,1359
66cbac5c71c2661ab2bd23e568d8b0149eb4a76f,1,Xinyu Liu,2017-04-13 15:44:13-07:00,['9fb5a827bf84bb5e8ce98d70b9c0abf35a178865'],200,281,481,267154,1,0,1,0.910714286,1359
34178a63fad7103206da265bc25216cf15bb400a,0,Yi Pan (Data Infrastructure),2017-04-14 12:04:08-07:00,['66cbac5c71c2661ab2bd23e568d8b0149eb4a76f'],1,0,1,267155,1,0,0,1,1359
925866d9b0a21fe49cd643544d8cad83f1c124bf,1,Yi Pan (Data Infrastructure),2017-04-14 12:09:07-07:00,['34178a63fad7103206da265bc25216cf15bb400a'],5,40,45,267200,4,1,1,1,1359
8df1e16eee38df1c3b935186ba27e328fb4a1260,1,vjagadish1989,2017-04-17 12:09:25-07:00,['925866d9b0a21fe49cd643544d8cad83f1c124bf'],28,34,62,267262,3,1,1,0.666666667,1359
e95088d96718b7c763c2ea586587a6305e11a9d2,0,vjagadish1989,2017-04-17 14:25:11-07:00,['8df1e16eee38df1c3b935186ba27e328fb4a1260'],1,3,4,267266,1,,,,1359
2e602c46f66a08e39f944c47a2335a3ad00e0364,0,nramesh,2017-04-18 15:05:27-07:00,['e95088d96718b7c763c2ea586587a6305e11a9d2'],13,14,27,267293,1,,,,1359
0b0b2958e34664511b22805543947aa71a7d1d8c,1,Yi Pan (Data Infrastructure),2017-04-18 17:04:29-07:00,['2e602c46f66a08e39f944c47a2335a3ad00e0364'],51,2,53,267346,3,0,0,0,1359
abe39676ef6ab6fd0e87b1d489a3cca7d91852bc,0,Yi Pan (Data Infrastructure),2017-04-18 17:15:32-07:00,['0b0b2958e34664511b22805543947aa71a7d1d8c'],3,3,6,267352,2,,,,1359
d50b1791b059b74ba4e7d4c046535ead4bfc5899,0,Yi Pan (Data Infrastructure),2017-04-18 21:23:39-07:00,['abe39676ef6ab6fd0e87b1d489a3cca7d91852bc'],1,0,1,267353,1,,,,1359
1f3db9cc602f7bdd779afd7f68039f899bf9d2db,1,vjagadish1989,2017-04-18 23:18:13-07:00,['d50b1791b059b74ba4e7d4c046535ead4bfc5899'],48,125,173,267526,5,0,0.80952381,1,1359
2a92980de321e8c7a73296fcead1f8ca4e12860c,1,nramesh,2017-04-19 12:33:37-07:00,['1f3db9cc602f7bdd779afd7f68039f899bf9d2db'],104,194,298,267824,7,0,1,1,1359
de8cffdfa44a7082a4f7eacfc56c8ef425bc638b,1,nramesh,2017-04-19 14:26:00-07:00,['2a92980de321e8c7a73296fcead1f8ca4e12860c'],4,5,9,267833,1,,,,1359
e753c8de306b8427291420f0b1c63d407fb6410e,0,Yi Pan (Data Infrastructure),2017-04-20 01:25:31-07:00,['de8cffdfa44a7082a4f7eacfc56c8ef425bc638b'],8,7,15,267848,4,,,,1359
c91da78428b71bd96a2a3724fa9fe8bfb1dc4f64,1,Yi Pan (Data Infrastructure),2017-04-21 16:14:41-07:00,['e753c8de306b8427291420f0b1c63d407fb6410e'],126,601,727,268575,23,0.026923077,0.996153846,0.896153846,1363
0feb5c2dae2ee5d071f33ae215e549e127b2e8fe,0,vjagadish1989,2017-04-24 15:03:00-07:00,['c91da78428b71bd96a2a3724fa9fe8bfb1dc4f64'],26,29,55,268630,2,1,1,1,1363
49cf06fc5a7db4ad1718bfc2d110db6f48d4f180,1,vjagadish1989,2017-04-24 17:15:47-07:00,['0feb5c2dae2ee5d071f33ae215e549e127b2e8fe'],4,68,72,268702,5,0.472222222,1,0.861111111,1363
edc872272cb6bb3a30a1bb8fafc7dedee333d8c2,1,nramesh,2017-04-25 16:27:02-07:00,['49cf06fc5a7db4ad1718bfc2d110db6f48d4f180'],118,106,224,268926,6,0,0,0,1364
35a5cd9ad210a3246eff530b5d74145225cbe5d2,0,Jacob Maes,2017-04-26 09:05:41-07:00,['edc872272cb6bb3a30a1bb8fafc7dedee333d8c2'],2,14,16,268942,1,0,1,1,1364
d72e47d4d7a1ea5acc817a6d88c1e5a823f4bfed,0,nramesh,2017-04-26 16:55:25-07:00,['35a5cd9ad210a3246eff530b5d74145225cbe5d2'],12,19,31,268973,4,1,1,0,1364
9f44867a43d49ede79f0bfdd91509e97f1bcdd2f,0,nramesh,2017-04-26 16:58:55-07:00,['d72e47d4d7a1ea5acc817a6d88c1e5a823f4bfed'],2,2,4,268977,1,,,,1364
a2220ed2330700a590f1fb4802ac0e8909e7b543,0,Xinyu Liu,2017-04-27 13:21:11-07:00,['9f44867a43d49ede79f0bfdd91509e97f1bcdd2f'],1,6,7,268984,2,1,1,1,1364
05060edfe18a47075dfe80059b0e83102063f587,1,nramesh,2017-04-27 14:37:08-07:00,['a2220ed2330700a590f1fb4802ac0e8909e7b543'],90,218,308,269292,12,1,1,1,1365
f7e1736519915fc284712fd78f2ba7ed5bb55e64,1,Jacob Maes,2017-04-27 15:05:28-07:00,['05060edfe18a47075dfe80059b0e83102063f587'],138,379,517,269809,11,0.930555556,0.847222222,1,1365
92ae4c628abb3d113520ec47ca82f08c480123ad,1,vjagadish1989,2017-04-27 15:55:11-07:00,['f7e1736519915fc284712fd78f2ba7ed5bb55e64'],259,547,806,270615,20,0.586956522,1,0.85326087,1365
a1e03af0da684184fbd95ec4278fc35fe4b4e28b,1,Jacob Maes,2017-05-01 13:44:54-07:00,['92ae4c628abb3d113520ec47ca82f08c480123ad'],19,38,57,270672,3,1,1,1,1365
20b427cc88c5f8d2a6b2e0283ce18b4b5f01cc17,1,Jacob Maes,2017-05-01 13:52:13-07:00,['a1e03af0da684184fbd95ec4278fc35fe4b4e28b'],19,105,124,270796,6,1,1,1,1365
81b17324689696f400f700277ef7b8faa2db484d,1,Jacob Maes,2017-05-01 13:57:25-07:00,['20b427cc88c5f8d2a6b2e0283ce18b4b5f01cc17'],86,132,218,271014,3,0.060606061,1,0.818181818,1365
ad1f161751bbe69220dd2bb0da64be3e2f64d674,1,nramesh,2017-05-01 18:32:48-07:00,['81b17324689696f400f700277ef7b8faa2db484d'],10,5,15,271029,3,0,0,0,1365
b71b253d2ad6bf1dc68c7bc6bb2e30782d86c7ff,1,Xinyu Liu,2017-05-02 10:09:22-07:00,['ad1f161751bbe69220dd2bb0da64be3e2f64d674'],194,651,845,271874,29,0.949329359,0.891207154,0.850596125,1370
6726e1d10964603826a23ad88896a27ae35ec150,0,Xinyu Liu,2017-05-02 12:09:55-07:00,['b71b253d2ad6bf1dc68c7bc6bb2e30782d86c7ff'],4,75,79,271953,4,0,1,0.863636364,1370
46c25cf901647ff0b1fce46ce4545034a42a27c9,1,Xinyu Liu,2017-05-03 12:17:22-07:00,['6726e1d10964603826a23ad88896a27ae35ec150'],26,130,156,272109,8,0.390243902,0.390243902,1,1370
0fb025b2e4ffad13804501f0c58483febe1772d0,0,Jacob Maes,2017-05-03 13:54:35-07:00,['46c25cf901647ff0b1fce46ce4545034a42a27c9'],2,13,15,272124,4,0.857142857,1,0.857142857,1370
475b4654cae52a4f92fe39c931a0e673048dd027,1,nramesh,2017-05-03 15:10:13-07:00,['0fb025b2e4ffad13804501f0c58483febe1772d0'],446,1259,1705,273829,24,0.302052786,0.671554252,0.973607038,1375
8bcfded46a4617cec6d98bc1db79fa13978916bb,0,nramesh,2017-05-03 17:03:08-07:00,['475b4654cae52a4f92fe39c931a0e673048dd027'],5,5,10,273839,1,,,,1375
06b5dbdaec6577644e0204b4f7b5ca91cdb06ab7,1,nramesh,2017-05-03 22:58:51-07:00,['8bcfded46a4617cec6d98bc1db79fa13978916bb'],2,2,4,273843,2,,,,1375
f99de20cca3bde199742290e9b54b6776e7ee46d,1,nramesh,2017-05-03 23:17:59-07:00,['06b5dbdaec6577644e0204b4f7b5ca91cdb06ab7'],2,2,4,273847,1,,,,1375
435d4fe1f9caf7dd310a788e8158bc94c3f23878,1,Jacob Maes,2017-05-04 12:28:58-07:00,['f99de20cca3bde199742290e9b54b6776e7ee46d'],13,36,49,273896,3,1,1,1,1375
5e14946826e6abb8b0a852818f8affce363a7337,0,Jacob Maes,2017-05-04 13:57:50-07:00,['435d4fe1f9caf7dd310a788e8158bc94c3f23878'],9,8,17,273913,2,,,,1375
7dbc4c95f718703170cff3057265e54da390d60a,1,Xinyu Liu,2017-05-04 15:17:56-07:00,['5e14946826e6abb8b0a852818f8affce363a7337'],248,200,448,274361,15,1,0,0.56,1375
67b195363a921de537003faf72615b9349998996,1,nramesh,2017-05-05 13:22:35-07:00,['7dbc4c95f718703170cff3057265e54da390d60a'],62,43,105,274466,7,0.9375,0.1875,1,1375
fb7aa73f5a574a7a57013b49f22896e122668e70,1,nramesh,2017-05-05 13:50:08-07:00,['67b195363a921de537003faf72615b9349998996'],337,254,591,275057,19,0.942857143,0,0.028571429,1375
d8534b5d860dcd89a8163f2faf5efa9836498dc6,0,Jacob Maes,2017-05-05 15:48:32-07:00,['fb7aa73f5a574a7a57013b49f22896e122668e70'],2,3,5,275062,1,0,1,0,1375
e6cc3b713ab42488afa0e9dd111ef0b863fc5382,1,vjagadish1989,2017-05-05 19:21:29-07:00,['d8534b5d860dcd89a8163f2faf5efa9836498dc6'],4,479,483,275545,12,0.751152074,1,1,1379
fa2f475595dcef174ac880a4c21a6c83239fec55,0,Xinyu Liu,2017-05-08 09:39:43-07:00,['e6cc3b713ab42488afa0e9dd111ef0b863fc5382'],23,13,36,275581,8,0,0,0,1379
ad41f9a7fdf30c8b1d91853cbdf70dbef664340e,1,Jacob Maes,2017-05-08 13:29:23-07:00,['fa2f475595dcef174ac880a4c21a6c83239fec55'],6,12,18,275599,4,,,,1379
29c4844fd8403581f0ad0d87fc71a2ab46035dc2,0,vjagadish1989,2017-05-08 17:18:38-07:00,['ad41f9a7fdf30c8b1d91853cbdf70dbef664340e'],4,6,10,275609,1,0,1,0,1379
9d66772d155842cf92f1de859b9e815db6a40fc8,0,vjagadish1989,2017-05-08 17:19:36-07:00,['29c4844fd8403581f0ad0d87fc71a2ab46035dc2'],49,33,82,275691,2,,,,1379
28afae09d030d272b63076d0319bda45d3e15f86,1,vjagadish1989,2017-05-08 17:22:14-07:00,['9d66772d155842cf92f1de859b9e815db6a40fc8'],53,49,102,275793,3,1,1,1,1379
2d47ee8048d71466b1da695832d009f9dfea0b15,1,nramesh,2017-05-08 17:58:55-07:00,['28afae09d030d272b63076d0319bda45d3e15f86'],58,104,162,275955,4,0.151515152,0.121212121,0.636363636,1379
634e568cd38851cfeb376c965056fd7f3f23bc5b,1,Jacob Maes,2017-05-08 19:24:03-07:00,['2d47ee8048d71466b1da695832d009f9dfea0b15'],203,247,450,276405,19,0.2,0,0,1379
d89d1ba3a28c89fde34c87a989367328c682d03e,0,Xinyu Liu,2017-05-09 09:27:28-07:00,['634e568cd38851cfeb376c965056fd7f3f23bc5b'],5,9,14,276419,1,,,,1379
9e2ee35d61b8bf92c1e9b59d821d97face576108,0,vjagadish1989,2017-05-09 10:41:50-07:00,['d89d1ba3a28c89fde34c87a989367328c682d03e'],13,13,26,276445,3,,,,1379
279a2952d031c5d2075d6529c7c32e12112b10b2,0,Jacob Maes,2017-05-09 15:07:32-07:00,['9e2ee35d61b8bf92c1e9b59d821d97face576108'],3,4,7,276452,2,,,,1379
b815e6d91c45171b98e8cda76bf25cf95967e285,0,Jacob Maes,2017-05-09 15:58:14-07:00,['279a2952d031c5d2075d6529c7c32e12112b10b2'],2,91,93,276545,2,0.433333333,1,1,1380
8183781f2e2ea721013456bedcb7af8714581b58,1,nramesh,2017-05-09 18:18:52-07:00,['b815e6d91c45171b98e8cda76bf25cf95967e285'],66,24,90,276635,7,0.785714286,0,0,1380
c50dd080b80c7a64408e824a5ce189eda244b0f7,0,nramesh,2017-05-09 18:24:09-07:00,['8183781f2e2ea721013456bedcb7af8714581b58'],1,1,2,276637,1,,,,1380
df5aa6c4eeb9b89a40780b19e08bb6d96b97730b,0,vjagadish1989,2017-05-10 09:27:57-07:00,['c50dd080b80c7a64408e824a5ce189eda244b0f7'],2,32,34,276671,2,,,,1380
5eb470c028b5658310d19437a1a8987498340b07,0,vjagadish1989,2017-05-10 11:41:17-07:00,['df5aa6c4eeb9b89a40780b19e08bb6d96b97730b'],32,2,34,276705,2,,,,1380
601c11d873e3316aea538f2e0c51ac4a3c1648e7,0,vjagadish1989,2017-05-10 12:03:53-07:00,['5eb470c028b5658310d19437a1a8987498340b07'],2,2,4,276709,1,,,,1380
36b2f23bb706dfa1cc75fcddf5866cd66e6de623,1,Jacob Maes,2017-05-10 15:10:02-07:00,['601c11d873e3316aea538f2e0c51ac4a3c1648e7'],7,147,154,276863,3,1,1,1,1381
71930e22fbb48415d8d9a11ef7cc3478dc004bf8,0,Xinyu Liu,2017-05-10 16:50:49-07:00,['36b2f23bb706dfa1cc75fcddf5866cd66e6de623'],18,7,25,276888,3,0.285714286,0.285714286,0.142857143,1381
46b1333c450abdfc616970b21f6a5582e05ff222,1,Xinyu Liu,2017-05-10 16:57:42-07:00,['71930e22fbb48415d8d9a11ef7cc3478dc004bf8'],0,7,7,276895,1,1,1,1,1381
f6d0d65516aed4f37216dc44ab312cdf1e7b124a,1,vjagadish1989,2017-05-10 16:58:14-07:00,['46b1333c450abdfc616970b21f6a5582e05ff222'],20,624,644,277539,15,0.782978723,1,0.995744681,1388
46263677d84fd2bcd7575941e6b1e5ec671a8e47,1,Xinyu Liu,2017-05-11 11:35:55-07:00,['f6d0d65516aed4f37216dc44ab312cdf1e7b124a'],0,5,5,277544,1,1,1,1,1388
014a59c68b792c8e63639c6f16257c41f0f4e0c6,1,vjagadish1989,2017-05-11 12:56:31-07:00,['46263677d84fd2bcd7575941e6b1e5ec671a8e47'],5,258,263,277807,6,0.77037037,0.925925926,0.955555556,1390
92b67b7a33d8246d96141cd7faa7f5f5e16b2194,0,Xinyu Liu,2017-05-11 13:39:48-07:00,['014a59c68b792c8e63639c6f16257c41f0f4e0c6'],2,2,4,277811,1,,,,1390
b31c0dc6efc43ea6c80c872885283804d7f2188a,1,Xinyu Liu,2017-05-12 09:49:04-07:00,['92b67b7a33d8246d96141cd7faa7f5f5e16b2194'],6,7,13,277824,2,0,1,1,1390
e3e553673c73eeae4540d64b875effeae7a14bf3,0,Xinyu Liu,2017-05-12 14:20:15-07:00,['b31c0dc6efc43ea6c80c872885283804d7f2188a'],3,7,10,277834,3,,,,1390
a637a57e020fad507802b97a8da095a777b02b10,0,Jacob Maes,2017-05-12 15:22:47-07:00,['e3e553673c73eeae4540d64b875effeae7a14bf3'],1,1,2,277836,1,,,,1390
d6e06e9f6fc5db02e044a1380eeec5cb1776033c,0,Xinyu Liu,2017-05-15 14:34:56-07:00,['a637a57e020fad507802b97a8da095a777b02b10'],49,57,106,277942,1,,,,1390
433d5ef6cdad797944414337d83851646c0c179c,1,Xinyu Liu,2017-05-19 10:03:00-07:00,['d6e06e9f6fc5db02e044a1380eeec5cb1776033c'],2,572,574,278516,4,0.213793103,0.875862069,0.620689655,1392
f41fd25450550818184bcef25ec2d300d6f1b1ea,1,Xinyu Liu,2017-05-19 17:25:26-07:00,['433d5ef6cdad797944414337d83851646c0c179c'],19,12,31,278547,1,0,0,0,1392
1e9ae73958b142de5f9c5eb22e7b61f18e0bd6f5,0,Xinyu Liu,2017-05-22 09:36:12-07:00,['f41fd25450550818184bcef25ec2d300d6f1b1ea'],8,56,64,278611,3,,,,1392
f758fb59129264c222c395c262efbc8f7520a7f3,1,vjagadish1989,2017-05-22 11:58:53-07:00,['1e9ae73958b142de5f9c5eb22e7b61f18e0bd6f5'],38,93,131,278742,5,1,1,0.833333333,1392
2a75a209b25fb68b8a9cb217fa909640ea1f1d98,0,vjagadish1989,2017-05-22 15:09:32-07:00,['f758fb59129264c222c395c262efbc8f7520a7f3'],4,154,158,278900,5,,,,1393
c3db2048374f1ed520a32b2f9e5534e8dcdb413b,0,vjagadish1989,2017-05-22 17:42:32-07:00,['2a75a209b25fb68b8a9cb217fa909640ea1f1d98'],40,19,59,278959,1,,,,1393
90f3ff6228355e27dfbc783b0beb96e3a430954f,0,nramesh,2017-05-23 23:33:09-07:00,['c3db2048374f1ed520a32b2f9e5534e8dcdb413b'],17,13,30,278989,2,0,0,0,1393
7355a45035306443544cf44e557322d9dc5fc0be,1,nramesh,2017-05-24 17:46:12-07:00,['90f3ff6228355e27dfbc783b0beb96e3a430954f'],332,445,777,279766,13,0.081081081,1,1,1394
e5e9705c1efef46ee7ac3a1a26c61352ba6d86fc,0,navina,2017-05-25 15:47:57-07:00,['7355a45035306443544cf44e557322d9dc5fc0be'],37,46,83,279849,1,,,,1394
8f1609d0b196f1aa64265d0768825ff7a4e3359c,0,navina,2017-05-26 15:45:52-07:00,['e5e9705c1efef46ee7ac3a1a26c61352ba6d86fc'],8,8,16,279865,4,,,,1394
0c05cb34415cf44d4f547e1986b803c100930db6,1,navina,2017-05-26 16:31:45-07:00,['8f1609d0b196f1aa64265d0768825ff7a4e3359c'],9,25,34,279899,4,0,1,1,1394
026ef7f789685f62380b0a05ded9be6736011950,0,Jacob Maes,2017-05-31 17:23:30-07:00,['0c05cb34415cf44d4f547e1986b803c100930db6'],10,1214,1224,281123,15,,,,1402
a19f86f8f1c322b8eeda2e38eafc901836746cdb,1,vjagadish1989,2017-05-31 22:20:14-07:00,['026ef7f789685f62380b0a05ded9be6736011950'],30,226,256,281379,22,0.766666667,1,0.955555556,1403
19f4d12950dec8bf7f95a7deff7e8bb115609173,0,Jacob Maes,2017-06-01 08:38:36-07:00,['a19f86f8f1c322b8eeda2e38eafc901836746cdb'],1,58,59,281438,1,,,,1403
a90ca11efc7c4ef31b70814caf74233dfc5cea3e,1,Xinyu Liu,2017-06-01 11:51:22-07:00,['19f4d12950dec8bf7f95a7deff7e8bb115609173'],176,333,509,281947,4,0.448275862,0.5,0.879310345,1404
d9bf8256fcd4125cafec488100f41011a33beef1,0,Xinyu Liu,2017-06-01 14:55:17-07:00,['a90ca11efc7c4ef31b70814caf74233dfc5cea3e'],0,0,0,281947,1,,,,1404
e565856aa15169f21b1764374f22aa53fb40c40c,0,vjagadish1989,2017-06-01 19:13:48-07:00,['d9bf8256fcd4125cafec488100f41011a33beef1'],0,3,3,281950,1,,,,1404
373ae1c6d014676c738f8abb52aa27e38db0f91c,0,Jacob Maes,2017-06-02 14:53:31-07:00,['e565856aa15169f21b1764374f22aa53fb40c40c'],11,43,54,282004,2,0,1,1,1404
a4174309a495ff1e43c3d4c82cababa54dd71d54,1,Jacob Maes,2017-06-02 20:42:14-07:00,['373ae1c6d014676c738f8abb52aa27e38db0f91c'],3,27,30,282034,3,1,1,1,1404
ad8ba96e7ee2e98fe62fe0af07cb93e6153c5134,1,vjagadish1989,2017-06-05 10:27:23-07:00,['a4174309a495ff1e43c3d4c82cababa54dd71d54'],18,180,198,282232,9,0.076923077,1,0.692307692,1405
95bb8e27d10df729ce69f1214301a7162ec4395e,0,vjagadish1989,2017-06-05 10:32:20-07:00,['ad8ba96e7ee2e98fe62fe0af07cb93e6153c5134'],1,1,2,282234,1,,,,1405
29cf374c5cbbf3b6cfe7afffb7a049f41a290704,1,Jacob Maes,2017-06-07 10:50:20-07:00,['95bb8e27d10df729ce69f1214301a7162ec4395e'],28,48,76,282310,16,,,,1405
c1c4289c8586457ae35c01f1ccb28fa59697dcb1,1,Xinyu Liu,2017-06-07 12:42:11-07:00,['29cf374c5cbbf3b6cfe7afffb7a049f41a290704'],2060,1405,3465,285775,48,0.726973684,0.111842105,0.375,1409
451b2e538611c51c25579e2cab106c241f4eaf52,1,navina,2017-06-07 14:23:13-07:00,['c1c4289c8586457ae35c01f1ccb28fa59697dcb1'],1,1,2,285777,1,,,,1409
5418a981d4f9de99aac4e7b3d565373d6dd328df,1,Jacob Maes,2017-06-07 17:57:54-07:00,['451b2e538611c51c25579e2cab106c241f4eaf52'],130,87,217,285994,5,1,0,0,1409
53c43dcecad471ef4ff370c166149abb1b4240a8,1,vjagadish1989,2017-06-09 10:32:09-07:00,['5418a981d4f9de99aac4e7b3d565373d6dd328df'],1,8,9,286003,1,,,,1409
371473dd19630578784c644f43018b7981d9d3c0,0,vjagadish1989,2017-06-09 10:33:08-07:00,['53c43dcecad471ef4ff370c166149abb1b4240a8'],23,49,72,286075,2,0,1,1,1409
1eb8fd472458ad1ba03ac4e95627203bc7b7a12f,1,Xinyu Liu,2017-06-12 10:51:27-07:00,['371473dd19630578784c644f43018b7981d9d3c0'],38,174,212,286287,3,1,1,0.971830986,1410
ae29a40d0f6a46a6a3af71f85ca025b0932c95c8,0,Jacob Maes,2017-06-12 14:08:45-07:00,['1eb8fd472458ad1ba03ac4e95627203bc7b7a12f'],1,2,3,286290,1,,,,1410
3375c7116ef68d845b4f96cf5d1b9291397d79ec,1,Xinyu Liu,2017-06-13 09:46:02-07:00,['ae29a40d0f6a46a6a3af71f85ca025b0932c95c8'],27,638,665,286955,13,0.656521739,0.752173913,0.860869565,1416
d1653aad07207db1ca088e6a53e353ec9fe14c47,1,Jacob Maes,2017-06-14 15:18:45-07:00,['3375c7116ef68d845b4f96cf5d1b9291397d79ec'],6,7,13,286968,3,,,,1416
e827d150fc12c81bb64788d28e07488c42a93687,0,Jacob Maes,2017-06-15 13:40:43-07:00,['d1653aad07207db1ca088e6a53e353ec9fe14c47'],7,18,25,286993,2,0.75,0.75,1,1416
8aa75467e1d4cc7eb606f63dfe6cb667c4a58460,1,Yi Pan (Data Infrastructure),2017-06-20 08:35:39-07:00,['e827d150fc12c81bb64788d28e07488c42a93687'],67,268,335,287328,8,0.467532468,0.922077922,0.649350649,1418
4875842b37e0285100e2d1d753a7bc4a1448e897,1,navina,2017-06-26 12:25:48-07:00,['8aa75467e1d4cc7eb606f63dfe6cb667c4a58460'],11,93,104,287432,8,0.555555556,1,1,1418
fde2434751e79f89246cb93bfa6527a3b787d4f6,1,Jacob Maes,2017-06-26 13:43:33-07:00,['4875842b37e0285100e2d1d753a7bc4a1448e897'],88,37,125,287557,2,1,0,0,1418
4072c9e85c86212372eb527509ffa9c3eba97315,1,navina,2017-06-26 16:35:26-07:00,['fde2434751e79f89246cb93bfa6527a3b787d4f6'],17,218,235,287792,12,0.936507937,1,0.904761905,1419
26dc77b08c216596dc2b727e90308d14c77fc7a1,0,navina,2017-06-26 17:25:57-07:00,['4072c9e85c86212372eb527509ffa9c3eba97315'],0,34,34,287826,1,,,,1420
e11ccd241c6dddd1ffb25e5debd4a639930a4660,0,Jacob Maes,2017-06-27 11:42:51-07:00,['26dc77b08c216596dc2b727e90308d14c77fc7a1'],9,41,50,287876,2,0,0.916666667,1,1420
cd925aa17e69e068edb6e6f15f06853b7d3713cd,1,navina,2017-06-28 11:09:27-07:00,['e11ccd241c6dddd1ffb25e5debd4a639930a4660'],51,187,238,288114,4,0.268041237,0.958762887,1,1420
b1679635b39254c2b70d0a456cd16260c946306e,1,navina,2017-06-28 11:12:15-07:00,['cd925aa17e69e068edb6e6f15f06853b7d3713cd'],6,440,446,288560,3,0.279069767,1,0.809302326,1421
6815a4d44da8e9785ae5e9b27ab1e0aeb7dc43a8,0,Xinyu Liu,2017-06-28 14:28:07-07:00,['b1679635b39254c2b70d0a456cd16260c946306e'],0,0,0,288560,0,,,,1421
bb3007d69ae177791aeb00ba5b17fd937628b2b8,1,Xinyu Liu,2017-06-28 17:16:10-07:00,['6815a4d44da8e9785ae5e9b27ab1e0aeb7dc43a8'],81,2792,2873,291433,44,0.420963652,0.851225697,0.856297549,1442
be989935c2fcc6ead114ce308ebaa93855ecb582,0,Yi Pan (Data Infrastructure),2017-07-11 10:55:51-07:00,['b1679635b39254c2b70d0a456cd16260c946306e'],1,15,16,291449,2,0,0.888888889,1,1442
ebb1b7fea2518e827e589fe8523089322c68c9bf,1,navina,2017-07-12 11:13:09-07:00,['be989935c2fcc6ead114ce308ebaa93855ecb582'],34,82,116,291565,11,1,,1,1443
45931fd5d4406f731013b39d10fbfd577d6ac6a4,1,navina,2017-07-13 16:19:56-07:00,['ebb1b7fea2518e827e589fe8523089322c68c9bf'],25,169,194,291759,5,0.95890411,1,1,1443
ce777164dfdef1eda8fa6a9a534a1506dfdfaac5,1,navina,2017-07-17 15:57:29-07:00,['45931fd5d4406f731013b39d10fbfd577d6ac6a4'],161,509,670,292429,21,0.623655914,0.774193548,0.956989247,1444
4eb51531387f018ea4350424edc45516ac3aea46,1,Jagadish,2017-07-21 13:43:18-07:00,['ce777164dfdef1eda8fa6a9a534a1506dfdfaac5'],12,199,211,292640,10,0.395348837,0.410852713,0.829457364,1444
1c1139399599c1cb31249e8d7a28291e2ad9d27e,1,Jagadish,2017-07-21 15:32:58-07:00,['4eb51531387f018ea4350424edc45516ac3aea46'],5,11,16,292656,1,0,1,1,1444
91b22fd773e9e24b77a1f29bde2ba4fa64e5a82a,1,navina,2017-07-25 10:35:31-07:00,['1c1139399599c1cb31249e8d7a28291e2ad9d27e'],8,2,10,292666,1,0.25,0.25,0,1444
35143b676f23f69324b442fd1061318a663538f0,1,Jagadish,2017-07-25 11:18:14-07:00,['91b22fd773e9e24b77a1f29bde2ba4fa64e5a82a'],102,283,385,293051,5,0.071428571,1,0.973214286,1444
57758615b3f8713364ac1afecab4f5355f64d1d4,1,navina,2017-07-25 15:32:22-07:00,['35143b676f23f69324b442fd1061318a663538f0'],91,248,339,293390,7,0.169230769,0.984615385,0.692307692,1445
95d96b9444f86cc34b4faf0790834e692922fc1e,1,navina,2017-07-25 17:04:53-07:00,['57758615b3f8713364ac1afecab4f5355f64d1d4'],3,5,8,293398,3,1,1,1,1445
d32e8bb3a64db5ffdcded3b299e10755e8679e0f,0,navina,2017-07-25 17:29:08-07:00,['95d96b9444f86cc34b4faf0790834e692922fc1e'],1,11,12,293410,1,1,1,1,1445
c27a253283bbc09e82c4e9d669bf54d1460c5299,1,Jagadish,2017-07-27 15:10:43-07:00,['d32e8bb3a64db5ffdcded3b299e10755e8679e0f'],10,27,37,293447,3,,,,1445
c2b55dc3962674f2117a795aa210f9f04557ebbe,1,Jagadish,2017-07-27 15:13:33-07:00,['c27a253283bbc09e82c4e9d669bf54d1460c5299'],9,31,40,293487,5,0.058823529,1,1,1445
fde5564407e97c2d4ed0efa15f4b25d45d0b9f6a,0,Jacob Maes,2017-08-02 09:22:51-07:00,['c2b55dc3962674f2117a795aa210f9f04557ebbe'],2,28,30,293517,2,1,1,1,1445
0a4ecb232a4fec0d083ecc065a0ad8d4518600ae,0,navina,2017-08-03 14:32:09-07:00,['fde5564407e97c2d4ed0efa15f4b25d45d0b9f6a'],1,3,4,293521,1,,,,1445
69dbada6ab8914d4b92fb480b96e2a62ccc8bc51,0,navina,2017-08-03 15:48:23-07:00,['0a4ecb232a4fec0d083ecc065a0ad8d4518600ae'],0,13,13,293534,1,0,1,0,1445
966730ee60e59270ca3c6511554b73421febb205,1,navina,2017-08-03 18:58:10-07:00,['69dbada6ab8914d4b92fb480b96e2a62ccc8bc51'],2,213,215,293749,6,1,1,1,1448
cf5efe761d0d901e8a98d195fba9a6778879d0fc,1,navina,2017-08-04 11:49:29-07:00,['966730ee60e59270ca3c6511554b73421febb205'],62,84,146,293895,2,0,1,0.909090909,1448
f5c5cb2233f6e141c34ea372a49a7b07f163a359,0,navina,2017-08-07 14:15:23-07:00,['cf5efe761d0d901e8a98d195fba9a6778879d0fc'],10,160,170,294065,5,0.634615385,1,1,1450
a9866d629278e156291354bb95985e20c625089c,0,navina,2017-08-07 16:28:05-07:00,['f5c5cb2233f6e141c34ea372a49a7b07f163a359'],1,341,342,294407,3,0.280701754,1,0.736842105,1452
bf4c7619f0c750b351ed28926eca284d93bdbd53,1,navina,2017-08-07 17:17:33-07:00,['a9866d629278e156291354bb95985e20c625089c'],1,256,257,294664,3,0.851851852,1,0.777777778,1454
403042394945deba1affa7269c7ead3129326cbd,0,navina,2017-08-08 18:26:50-07:00,['bf4c7619f0c750b351ed28926eca284d93bdbd53'],0,121,121,294785,2,0.577777778,1,1,1455
23bfaa8d117511ecc1e8a71c0d2695def24158af,0,Yi Pan (Data Infrastructure),2017-08-09 10:39:55-07:00,"['bb3007d69ae177791aeb00ba5b17fd937628b2b8', 'bf4c7619f0c750b351ed28926eca284d93bdbd53']",494,2643,3137,297922,64,,,,1455
8f7f56744c2824426962e1ca4f382b1877e4a9b0,1,Jacob Maes,2017-08-10 15:44:42-07:00,['403042394945deba1affa7269c7ead3129326cbd'],51,154,205,298127,5,0.210526316,1,1,1455
06702af8fda1d016ae55461c404b55b84b20ffd2,0,Jacob Maes,2017-08-11 09:28:20-07:00,['8f7f56744c2824426962e1ca4f382b1877e4a9b0'],3,23,26,298153,2,1,1,1,1455
46b3601f1a3bbe792338f160f8283ff32b65547a,1,Jacob Maes,2017-08-11 11:51:32-07:00,['06702af8fda1d016ae55461c404b55b84b20ffd2'],2,2,4,298157,1,,,,1455
b1277d8b4cbda3a12f00dd2c8e86980086f2c640,0,Jacob Maes,2017-08-11 15:50:12-07:00,['46b3601f1a3bbe792338f160f8283ff32b65547a'],50,29,79,298236,1,,,,1455
a0aae5292c31c8bc260bb15c03396279a30f19ef,0,Jagadish,2017-08-14 17:01:09-07:00,['b1277d8b4cbda3a12f00dd2c8e86980086f2c640'],2,12,14,298250,1,0,1,1,1455
ef6bb8196c669e651ef6628c7b74a5594713ee82,1,navina,2017-08-14 22:02:24-07:00,['a0aae5292c31c8bc260bb15c03396279a30f19ef'],43,195,238,298488,4,0.865853659,1,1,1455
89989fdab8b4cd18f1d06f347d5eca2185f34880,0,Xinyu Liu,2017-08-16 09:53:13-07:00,['ef6bb8196c669e651ef6628c7b74a5594713ee82'],0,57,57,298545,1,,,,1455
119e2fa0126a66f949cba8d2e2d8cbb2a36cc1ec,1,navina,2017-08-16 14:42:18-07:00,['89989fdab8b4cd18f1d06f347d5eca2185f34880'],25,39,64,298609,2,0,1,1,1455
202af33bfe7d60ec9b2f90854abffde4bd55d2e6,0,Jagadish,2017-08-16 15:08:51-07:00,['119e2fa0126a66f949cba8d2e2d8cbb2a36cc1ec'],2,4,6,298615,1,0,1,1,1455
afe3bf8616edcb5e6d16a457ba54234607c6b25b,0,Xinyu Liu,2017-08-16 16:25:49-07:00,['202af33bfe7d60ec9b2f90854abffde4bd55d2e6'],3,20,23,298638,4,,,,1455
e21ff714637238e9fe1011a9f4f20699f1e9e471,0,Xinyu Liu,2017-08-17 11:16:10-07:00,['afe3bf8616edcb5e6d16a457ba54234607c6b25b'],1,2,3,298641,1,,,,1455
1d253c757c74d5a5364d0b270d037361c60d1ee6,0,navina,2017-08-17 17:54:40-07:00,['e21ff714637238e9fe1011a9f4f20699f1e9e471'],0,1,1,298642,1,,,,1455
c3b447ecb343ddc4e48296448127fda5dfafe913,1,navina,2017-08-18 14:38:46-07:00,['1d253c757c74d5a5364d0b270d037361c60d1ee6'],53,1273,1326,299968,18,0.496031746,0.662698413,0.884920635,1465
67f7214aace6f9f98492b53f0a10d703aa8706c1,1,navina,2017-08-18 17:49:52-07:00,['c3b447ecb343ddc4e48296448127fda5dfafe913'],0,255,255,300223,5,0.596774194,1,0.951612903,1470
80d82b6a51f6dc0b65f766b63704b30c780073ac,1,Xinyu Liu,2017-08-22 17:55:54-07:00,['67f7214aace6f9f98492b53f0a10d703aa8706c1'],14,115,129,300352,7,0.081967213,0.590163934,1,1470
2a4ccfdd72513a8a3809c3d01e8fd0d9c23dd1e1,0,Jagadish,2017-08-23 21:47:50-07:00,['80d82b6a51f6dc0b65f766b63704b30c780073ac'],1,1,2,300354,1,,,,1470
3a134386f18c2ac2b957191f258022a817e21ef0,1,Yi Pan (Data Infrastructure),2017-08-25 17:21:21-07:00,['2a4ccfdd72513a8a3809c3d01e8fd0d9c23dd1e1'],12,13,25,300379,5,,,,1470
3636be0316ba1ba53f961dacc5e865798119ab20,1,Xinyu Liu,2017-08-28 12:27:47-07:00,['3a134386f18c2ac2b957191f258022a817e21ef0'],0,14,14,300393,1,0,1,1,1470
65743863626a3d6621ba7a4b101c7a91b807bce2,0,Xinyu Liu,2017-08-28 14:17:32-07:00,['3636be0316ba1ba53f961dacc5e865798119ab20'],4,4,8,300401,1,,,,1470
81b4e6361f8c05e2a670ba6263c3786d0eea9f62,1,navina,2017-08-29 13:23:47-07:00,['65743863626a3d6621ba7a4b101c7a91b807bce2'],108,138,246,300647,16,0.055555556,1,1,1470
dd07e07421bd57e0f927b8974131b949f5ac2e71,1,Xinyu Liu,2017-08-29 15:37:17-07:00,['81b4e6361f8c05e2a670ba6263c3786d0eea9f62'],123,220,343,300990,10,0.916666667,0,0.333333333,1472
fb39a5142283df4dd2c097063d8d85c92a564392,0,navina,2017-08-30 16:56:28-07:00,['dd07e07421bd57e0f927b8974131b949f5ac2e71'],13,80,93,301083,4,1,1,1,1473
79200c73509727abba2d6eb68cfc45ac1d842d35,1,Xinyu Liu,2017-09-07 16:49:20-07:00,['23bfaa8d117511ecc1e8a71c0d2695def24158af'],299,192,491,301574,20,0,0,0,1473
1701ea84a2e029b3297687b5fc814998371b1a6f,0,Xinyu Liu,2017-09-12 11:32:36-07:00,"['79200c73509727abba2d6eb68cfc45ac1d842d35', 'fb39a5142283df4dd2c097063d8d85c92a564392']",339,2589,2928,304502,69,,,,1473
ebce13e7461d80f2331b4005cb287719cdad88ad,0,Xinyu Liu,2017-09-12 14:16:27-07:00,['1701ea84a2e029b3297687b5fc814998371b1a6f'],1,34,35,304537,3,0.6,1,0.4,1474
c45c7747ae371eee11e2f41dd4e32a53b12c6c91,1,navina,2017-09-14 21:18:55-07:00,['ebce13e7461d80f2331b4005cb287719cdad88ad'],68,204,272,304809,3,0.619047619,1,1,1474
e85b01dcb9cfc5b774ec023b7be11998139c1aee,0,Jagadish,2017-09-18 10:32:32-07:00,['fb39a5142283df4dd2c097063d8d85c92a564392'],66,99,165,304974,2,1,1,0,1474
0f06da1f80566f3090f9826b46fe46a3fadcd3f2,0,Jacob Maes,2017-09-19 14:26:38-07:00,['e85b01dcb9cfc5b774ec023b7be11998139c1aee'],23,137,160,305134,6,1,1,1,1475
89f8ca4ec1c72540596ad73e640e331b62b47a93,0,Jacob Maes,2017-09-19 14:43:55-07:00,['0f06da1f80566f3090f9826b46fe46a3fadcd3f2'],2,2,4,305138,1,,,,1475
3773ec699ef07fa421edbb72d3fd83d7b2273144,1,Jacob Maes,2017-09-20 12:40:47-07:00,['89f8ca4ec1c72540596ad73e640e331b62b47a93'],241,705,946,306084,14,1,0.525,0.85,1476
987180a17f73912be89d093268aa64875fe33e14,0,Jacob Maes,2017-09-21 11:57:31-07:00,['3773ec699ef07fa421edbb72d3fd83d7b2273144'],18,21,39,306123,4,0,1,1,1476
475414884ef386af328ed7a07d59f6986713c283,1,Xinyu Liu,2017-09-25 14:52:42-07:00,['c45c7747ae371eee11e2f41dd4e32a53b12c6c91'],184,605,789,306912,26,0.290909091,1,0.915151515,1478
f16ba2692ef85a624ce5f9050ddb6b9bce3dbf6c,1,Jagadish,2017-09-27 17:08:04-07:00,['987180a17f73912be89d093268aa64875fe33e14'],502,1809,2311,309223,74,0.326053042,0.99375975,0.936037441,1486
2819cbc7691b569b3eef66d702746d9e34b3e745,1,Xinyu Liu,2017-09-28 17:11:28-07:00,['475414884ef386af328ed7a07d59f6986713c283'],1929,1297,3226,312449,53,0.934911243,0.50591716,0.062130178,1493
a1f01444ec12f49684213cc69b1cce16ff0f8232,1,Xinyu Liu,2017-09-29 15:05:55-07:00,['2819cbc7691b569b3eef66d702746d9e34b3e745'],5,12,17,312466,4,0.333333333,1,1,1493
56d564c604c810ce7ea549e7dd4581588f8c47b5,1,Jagadish,2017-10-02 12:23:24-07:00,['f16ba2692ef85a624ce5f9050ddb6b9bce3dbf6c'],0,834,834,313300,9,0.730103806,0.948096886,0.837370242,1501
92894e5e283d605e6243177cc5ed11c3139aa7bc,0,Jagadish,2017-10-02 12:55:08-07:00,['56d564c604c810ce7ea549e7dd4581588f8c47b5'],6,0,6,313306,1,0,0,0,1501
6e6e53bfd504611ce882af1eff557a6854d82414,0,Boris S,2017-10-03 00:01:16-07:00,['92894e5e283d605e6243177cc5ed11c3139aa7bc'],0,4,4,313310,1,,,,1501
052a0570cf0f1a1020faef7c3695c0e86c6f348c,1,Xinyu Liu,2017-10-03 15:09:41-07:00,"['a1f01444ec12f49684213cc69b1cce16ff0f8232', 'f16ba2692ef85a624ce5f9050ddb6b9bce3dbf6c']",914,2860,3774,317084,101,,,,1501
db2f121e22ad2ae28f914dd1510d251e713d2e7c,0,Xinyu Liu,2017-10-03 15:10:13-07:00,"['6e6e53bfd504611ce882af1eff557a6854d82414', '052a0570cf0f1a1020faef7c3695c0e86c6f348c']",710,3292,4002,321086,99,,,,1501
1de13f7654a790a6e06de352f7904901414ae9bb,0,Prateek Maheshwari,2017-10-03 16:06:33-07:00,['db2f121e22ad2ae28f914dd1510d251e713d2e7c'],7,3,10,321096,1,,,,1501
471f81d7876b80853372923bdb04108c29141844,0,Prateek Maheshwari,2017-10-03 18:00:04-07:00,['1de13f7654a790a6e06de352f7904901414ae9bb'],0,38,38,321134,1,,,,1501
1cf98443f15fec70ad7a9f77bd5740ab546a4d50,1,Jacob Maes,2017-10-04 10:39:42-07:00,['471f81d7876b80853372923bdb04108c29141844'],3,53,56,321190,3,,,,1502
fd7a57708fd7165c2db74810ca14fc37c50f4cb5,1,Boris S,2017-10-04 10:48:58-07:00,['1cf98443f15fec70ad7a9f77bd5740ab546a4d50'],199,234,433,321623,7,0.416666667,0.416666667,1,1502
8b3fe5d2666a97ee5b3571a3788e8fefd23f55fd,1,Jacob Maes,2017-10-04 14:02:26-07:00,['fd7a57708fd7165c2db74810ca14fc37c50f4cb5'],20,112,132,321755,7,0.511627907,1,0.930232558,1503
ad80cf9f1be427878849a61d77cf1a76381e7642,1,Prateek Maheshwari,2017-10-04 15:28:37-07:00,['8b3fe5d2666a97ee5b3571a3788e8fefd23f55fd'],8,27,35,321790,2,0,1,1,1503
a671288e18dea3336fe1c625233bb7427ed8b5b2,1,Prateek Maheshwari,2017-10-04 15:37:50-07:00,['ad80cf9f1be427878849a61d77cf1a76381e7642'],397,940,1337,323127,39,0.314176245,1,0.908045977,1511
7ad6631bbfca88d759e2cf5d4c0beeb5ef4eb013,1,Jacob Maes,2017-10-05 09:18:37-07:00,['a671288e18dea3336fe1c625233bb7427ed8b5b2'],0,42,42,323169,3,0,1,1,1511
7f1ec6492a4c42e41e732f34cb4180bd154aecc5,1,Prateek Maheshwari,2017-10-05 10:59:39-07:00,['7ad6631bbfca88d759e2cf5d4c0beeb5ef4eb013'],96,239,335,323504,6,0.906666667,1,1,1512
b989e51ae866fee9cdba76a457992afc70695fdb,1,Boris S,2017-10-05 15:36:37-07:00,['7f1ec6492a4c42e41e732f34cb4180bd154aecc5'],95,45,140,323644,4,1,0,1,1512
357d6ca72c73908d38f92aece05fd1e468c53cbe,0,Prateek Maheshwari,2017-10-06 10:47:37-07:00,['b989e51ae866fee9cdba76a457992afc70695fdb'],395,729,1124,324768,26,0.531073446,1,1,1525
f8cce6e1571dd500f32b62fa510715d93e8986fb,0,Prateek Maheshwari,2017-10-06 16:32:06-07:00,['357d6ca72c73908d38f92aece05fd1e468c53cbe'],17,32,49,324817,2,,,,1525
7b0a65b140dbd5e02a783b53e4808b1d8d27e00e,0,Prateek Maheshwari,2017-10-09 14:48:05-07:00,['f8cce6e1571dd500f32b62fa510715d93e8986fb'],2,2,4,324821,1,,,,1525
caec9c5362635478a4272199504950789664d0cd,1,Jacob Maes,2017-10-11 07:49:52-07:00,['7b0a65b140dbd5e02a783b53e4808b1d8d27e00e'],2,9,11,324832,8,0,0.714285714,1,1525
a47ed9d18a104f99ec8036f478f07a0a8b29a35b,0,Jagadish,2017-10-11 12:03:28-07:00,['caec9c5362635478a4272199504950789664d0cd'],1,1,2,324834,1,,,,1525
24170389cbd04f6f39724fd6e786a2abc655a19c,0,Jagadish,2017-10-11 12:09:33-07:00,['a47ed9d18a104f99ec8036f478f07a0a8b29a35b'],4,4,8,324842,1,,,,1525
e6eb13f8525d69ae1f0736339973d31c619add17,0,Prateek Maheshwari,2017-10-11 13:56:24-07:00,['24170389cbd04f6f39724fd6e786a2abc655a19c'],7,6,13,324855,4,,,,1525
072457a2e44e5e041e87e0aafbef1dfbe332f54c,1,Jagadish,2017-10-11 13:57:20-07:00,['e6eb13f8525d69ae1f0736339973d31c619add17'],157,293,450,325305,7,0.930232558,1,1,1528
e94abca72f73a38780c93111f06c69f4aa4255a7,1,Jagadish,2017-10-13 13:22:56-07:00,['072457a2e44e5e041e87e0aafbef1dfbe332f54c'],272,470,742,326047,23,0.373626374,0.153846154,0.406593407,1528
1b9391b9e23a38b898590148dfb3b1e503bdd447,0,Boris S,2017-10-13 15:04:22-07:00,['e94abca72f73a38780c93111f06c69f4aa4255a7'],5,11,16,326063,3,0,1,1,1528
c93dd8f60c4622e30cb2515ac63796f056a05350,0,Xinyu Liu,2017-10-16 11:26:45-07:00,['1b9391b9e23a38b898590148dfb3b1e503bdd447'],3,4,7,326070,2,,,,1528
a31a7aa29b7be4bb46f8e651b6b8fa46a65b48e2,0,Boris Shkolnik,2017-10-16 15:25:49-07:00,['c93dd8f60c4622e30cb2515ac63796f056a05350'],1,1,2,326072,1,,,,1528
343712e30c0a7201d6bb47f340187af51f395671,1,Prateek Maheshwari,2017-10-16 16:06:28-07:00,['c93dd8f60c4622e30cb2515ac63796f056a05350'],12,66,78,326150,3,0,0.684210526,0.684210526,1528
410ce78ba1ff8dafa2587481473e62ac9cfa6f4f,0,Boris S,2017-10-16 18:20:04-07:00,"['a31a7aa29b7be4bb46f8e651b6b8fa46a65b48e2', '343712e30c0a7201d6bb47f340187af51f395671']",12,66,78,326228,3,,,,1528
fd9f0802f9617b03542ee4f42ab8966e6c6df145,1,Jacob Maes,2017-10-18 15:30:34-07:00,['343712e30c0a7201d6bb47f340187af51f395671'],65,40,105,326333,1,1,1,1,1528
62904334b6269f9862b4139987b45bdb3f8b35dd,0,Prateek Maheshwari,2017-10-19 11:01:56-07:00,['fd9f0802f9617b03542ee4f42ab8966e6c6df145'],1,3,4,326337,1,0,1,1,1528
958edc42f59a1891e14276251462236abd2af5b9,1,Prateek Maheshwari,2017-10-19 11:36:02-07:00,['62904334b6269f9862b4139987b45bdb3f8b35dd'],122,51,173,326510,5,0.461538462,0.461538462,0.461538462,1528
d4620d6690f74cad9472d0e27a1b31aeb4156c54,0,Boris S,2017-10-24 17:11:48-07:00,"['410ce78ba1ff8dafa2587481473e62ac9cfa6f4f', '958edc42f59a1891e14276251462236abd2af5b9']",187,93,280,326790,7,,,,1528
cc1ca2c9d5014811f8570512a3e598d58b2560bf,0,Boris S,2017-10-24 17:44:21-07:00,['958edc42f59a1891e14276251462236abd2af5b9'],1,1,2,326792,1,,,,1528
bbffb79b8b9799a41e8e82ded60f83550736886b,0,Boris S,2017-10-24 17:54:20-07:00,"['d4620d6690f74cad9472d0e27a1b31aeb4156c54', 'cc1ca2c9d5014811f8570512a3e598d58b2560bf']",1,1,2,326794,1,,,,1528
e6049b7ddca385b5a1a363020b9d711f4a0b93b6,1,xiliu,2017-10-24 18:20:32-07:00,['cc1ca2c9d5014811f8570512a3e598d58b2560bf'],24,204,228,327022,9,0.12987013,1,1,1530
010fa168ee2a290b93f5a3b0908709b2c19044ec,0,Boris S,2017-10-24 18:33:03-07:00,"['bbffb79b8b9799a41e8e82ded60f83550736886b', 'e6049b7ddca385b5a1a363020b9d711f4a0b93b6']",24,204,228,327250,9,,,,1530
5f81b8d13aa9650ea64e340aedae797ea6f200fa,1,Boris S,2017-10-24 18:43:51-07:00,['e6049b7ddca385b5a1a363020b9d711f4a0b93b6'],4,5,9,327259,2,,,,1530
5e6f5fb5f9a9ee12ce35ee8eb1836a058521df20,0,Boris Shkolnik,2017-10-25 09:50:37-07:00,"['410ce78ba1ff8dafa2587481473e62ac9cfa6f4f', '5f81b8d13aa9650ea64e340aedae797ea6f200fa']",216,303,519,327778,19,,,,1530
06b1ac36e9c67a3bd558a0fa592639b16fcbfda9,0,Boris Shkolnik,2017-10-25 09:50:55-07:00,"['5e6f5fb5f9a9ee12ce35ee8eb1836a058521df20', '010fa168ee2a290b93f5a3b0908709b2c19044ec']",0,0,0,327778,0,,,,1530
85184d05b99a698c08b120914060a3240ea03d2b,1,Jacob Maes,2017-10-25 15:18:11-07:00,['5f81b8d13aa9650ea64e340aedae797ea6f200fa'],25,107,132,327910,3,1,1,0.6875,1531
711dd8dc30cdaf76cbc33bbaf7f80bf2b38347c6,0,Prateek Maheshwari,2017-10-25 16:27:52-07:00,['85184d05b99a698c08b120914060a3240ea03d2b'],33,165,198,328108,5,0.797297297,1,0.837837838,1531
1296c7ff91daff4abeac392cec53600f7c5cb427,1,Prateek Maheshwari,2017-10-25 17:18:36-07:00,['711dd8dc30cdaf76cbc33bbaf7f80bf2b38347c6'],256,425,681,328789,37,0.467391304,1,0.826086957,1531
20698f9d1f6208527b0f0427c2acf98dfc26274a,0,Jacob Maes,2017-10-25 18:03:11-07:00,['1296c7ff91daff4abeac392cec53600f7c5cb427'],1,1,2,328791,1,,,,1531
8b2120954af12e06f8515e98ad41212c42df06e7,0,xiliu,2017-10-26 17:48:47-07:00,['20698f9d1f6208527b0f0427c2acf98dfc26274a'],4,70,74,328865,2,0.3,0.3,1,1531
663b8daffa56e6a5ca1e00641c6566304d8c832d,1,Jagadish,2017-10-26 22:26:29-07:00,['8b2120954af12e06f8515e98ad41212c42df06e7'],0,2754,2754,331619,22,0.433172303,0.95410628,0.875201288,1552
c94a26afece49738ce71c6a31db2ab12b800caa7,1,Jagadish,2017-10-26 23:14:41-07:00,['663b8daffa56e6a5ca1e00641c6566304d8c832d'],8,74,82,331701,3,0.525,1,0.825,1552
2d1073249174975f81b9187004aacbd46a91a1d0,0,Jagadish,2017-10-31 08:50:19-07:00,['c94a26afece49738ce71c6a31db2ab12b800caa7'],1,1,2,331703,1,,,,1552
1ad58d43fbe00a57054cb85b0be2eef6ee6470a6,0,Boris S,2017-10-31 12:46:53-07:00,"['06b1ac36e9c67a3bd558a0fa592639b16fcbfda9', '2d1073249174975f81b9187004aacbd46a91a1d0']",326,3595,3921,335624,70,,,,1552
52d8ddd6e1edeff72c22602f76fc0f014453c0df,1,xiliu,2017-11-07 12:16:15-08:00,['2d1073249174975f81b9187004aacbd46a91a1d0'],19,110,129,335753,8,0.540983607,0.459016393,0.885245902,1552
05113c3395f92b74e41c75b0ca28153fb3dbf915,1,Jagadish,2017-11-07 17:15:28-08:00,['52d8ddd6e1edeff72c22602f76fc0f014453c0df'],2,149,151,335904,4,0.123595506,1,0.887640449,1553
adfc4bfc40a5d92b3cc7e7813dd1a73c0c486e0e,1,Jagadish,2017-11-07 17:25:58-08:00,['05113c3395f92b74e41c75b0ca28153fb3dbf915'],4,501,505,336409,8,0.344978166,0.895196507,0.978165939,1557
d806e9dab12c2299c55fa6e5e95d640f3a008c28,1,xiliu,2017-11-07 18:00:03-08:00,['adfc4bfc40a5d92b3cc7e7813dd1a73c0c486e0e'],4,18,22,336431,2,0,1,1,1557
33010a7314eca58ff6a92c2b1dbee1c331220637,0,Prateek Maheshwari,2017-11-09 10:24:53-08:00,['d806e9dab12c2299c55fa6e5e95d640f3a008c28'],24,18,42,336473,5,,,,1557
4269d62134758bd2ea8ad70df976f1539d92c392,0,Prateek Maheshwari,2017-11-09 10:45:04-08:00,['33010a7314eca58ff6a92c2b1dbee1c331220637'],2,3,5,336478,2,,,,1557
d35355aa018410ab5cf249d128b34912be085ca3,1,Jacob Maes,2017-11-09 11:54:32-08:00,['4269d62134758bd2ea8ad70df976f1539d92c392'],46,234,280,336758,3,0.517482517,1,0.517482517,1557
26dd9c14c778862058ddaf8e866f8f12e77457d9,0,Jacob Maes,2017-11-14 07:56:13-08:00,['d35355aa018410ab5cf249d128b34912be085ca3'],0,5,5,336763,2,0.5,0.5,1,1557
42c194040c9adea29eddc92dc58ca01a59a22445,0,Prateek Maheshwari,2017-11-14 10:48:50-08:00,['26dd9c14c778862058ddaf8e866f8f12e77457d9'],10,3,13,336776,1,1,0,0,1557
20fe6ec6188a21c670b12bbfd1bc8f2f031a7b12,0,Prateek Maheshwari,2017-11-14 10:54:32-08:00,['42c194040c9adea29eddc92dc58ca01a59a22445'],12,11,23,336799,1,,,,1557
3750f5e24b601837b29f3654189159e7f8b828c1,0,Prateek Maheshwari,2017-11-14 11:00:34-08:00,['20fe6ec6188a21c670b12bbfd1bc8f2f031a7b12'],3,1,4,336803,2,,,,1557
6fcf7f3f4cbf8b9c6f69b292e3c1aaa239ab18d3,1,Yi Pan (Data Infrastructure),2017-11-14 12:45:23-08:00,['3750f5e24b601837b29f3654189159e7f8b828c1'],321,669,990,337793,24,0,0.98816568,0.74556213,1560
4ac62231c5bd8379a6bd8694140fada92e76a77c,1,Prateek Maheshwari,2017-11-15 10:27:08-08:00,['6fcf7f3f4cbf8b9c6f69b292e3c1aaa239ab18d3'],0,45,45,337838,2,0,0.090909091,1,1560
fc6c706847f3c075960cc8e8c11f8407a9e1c93e,1,Prateek Maheshwari,2017-11-15 10:45:08-08:00,['4ac62231c5bd8379a6bd8694140fada92e76a77c'],11,21,32,337870,3,0.714285714,1,1,1560
2e2e00ed0dbab3aaa5fcaee18629932747ecba4c,0,xiliu,2017-11-16 10:46:05-08:00,['fc6c706847f3c075960cc8e8c11f8407a9e1c93e'],18,26,44,337914,9,1,1,0,1560
9fa8beed7ac37c33a0c01412b075a9c9a0b47441,1,xiliu,2017-11-16 11:14:32-08:00,['2e2e00ed0dbab3aaa5fcaee18629932747ecba4c'],7,5218,5225,343139,64,0.517365269,0.892814371,0.917365269,1621
edce6b76dbf3768884ea5fdadac748df7dec031b,1,Jagadish,2017-11-17 14:41:05-08:00,['9fa8beed7ac37c33a0c01412b075a9c9a0b47441'],756,822,1578,344717,12,0.752136752,0.666666667,0.888888889,1625
9fb9a76732642c1004cf60b28defdb95a2b4e052,0,Yi Pan (Data Infrastructure),2017-11-20 11:48:14-08:00,['edce6b76dbf3768884ea5fdadac748df7dec031b'],7,7,14,344731,1,,,,1625
f2c14fa632ad201f60a21b52e9d50991954b5195,0,xiliu,2017-11-21 11:26:55-08:00,['9fb9a76732642c1004cf60b28defdb95a2b4e052'],7,31,38,344769,2,0.866666667,1,1,1625
7a2e19250f5a74f34eef1d53de5d52399850bc89,1,Jagadish,2017-11-21 12:42:17-08:00,['f2c14fa632ad201f60a21b52e9d50991954b5195'],9,167,176,344945,7,0.27027027,1,0.990990991,1625
dd39d089437905abb93aa1074474b28a18292a54,0,Boris S,2017-11-22 11:46:37-08:00,"['1ad58d43fbe00a57054cb85b0be2eef6ee6470a6', '7a2e19250f5a74f34eef1d53de5d52399850bc89']",1258,8055,9313,354258,156,,,,1625
a322972d00474082917e6700c450dc1e5e98d7dc,1,Boris S,2017-11-22 11:54:10-08:00,['7a2e19250f5a74f34eef1d53de5d52399850bc89'],5,29,34,354292,3,0.666666667,1,1,1625
a5a69c4df6ea5ba179240d90086dd7ac539d5717,0,xiliu,2017-11-27 13:49:35-08:00,['a322972d00474082917e6700c450dc1e5e98d7dc'],1,1,2,354294,1,,,,1625
5e68d621aa841feaf1650be64ac723c12b996df5,0,Jagadish,2017-11-28 12:30:35-08:00,['a5a69c4df6ea5ba179240d90086dd7ac539d5717'],74,80,154,354448,2,,,,1625
9961023f7bf7c4b19804fb4e50a14c86d6fc9233,1,Jagadish,2017-11-28 13:12:10-08:00,['5e68d621aa841feaf1650be64ac723c12b996df5'],3,2619,2622,357070,22,0.512522361,0.892665474,0.847048301,1645
d262f66635c39cb71a570d8438f48cdf304b07a5,0,Yi Pan (Data Infrastructure),2017-11-28 14:36:24-08:00,['9961023f7bf7c4b19804fb4e50a14c86d6fc9233'],11,11,22,357092,1,,,,1645
3b2a1fa4398dc26f9270c405c01edaac59ba9fc1,0,Jacob Maes,2017-11-28 16:19:45-08:00,['d262f66635c39cb71a570d8438f48cdf304b07a5'],2,16,18,357110,2,1,1,1,1645
12e61e98c18a50cb04e368201d3a5797bc4eb7b0,0,xiliu,2017-11-29 11:34:28-08:00,['3b2a1fa4398dc26f9270c405c01edaac59ba9fc1'],4,13,17,357127,2,0.142857143,1,0,1645
2490e602e9491fdc5323b29987d91af8b8fe5aaf,0,Jacob Maes,2017-11-30 17:37:40-08:00,['12e61e98c18a50cb04e368201d3a5797bc4eb7b0'],3,37,40,357167,2,,,,1645
1ca9e3268a324f8c1c74798bbb8661d1b7c9722f,1,Jacob Maes,2017-12-01 09:08:13-08:00,['2490e602e9491fdc5323b29987d91af8b8fe5aaf'],1,79,80,357247,3,,,,1646
9c9bbc45cfdbf4d14f27c84ab3dc3314169ade7c,1,Jacob Maes,2017-12-01 15:23:12-08:00,['1ca9e3268a324f8c1c74798bbb8661d1b7c9722f'],10,30,40,357287,3,0,1,1,1646
32d2af5dd10b2c2c1cf3f6e683967bafd5285cdf,1,Prateek Maheshwari,2017-12-04 14:21:21-08:00,['9c9bbc45cfdbf4d14f27c84ab3dc3314169ade7c'],32,80,112,357399,12,1,1,0.375,1646
e3efdf5c872cda681d5d012046524b9992ffda91,0,xiliu,2017-12-04 17:11:03-08:00,['32d2af5dd10b2c2c1cf3f6e683967bafd5285cdf'],18,18,36,357435,7,,,,1646
e74998c5e58c891c0744ce1be2b13f7c5861656a,1,Prateek Maheshwari,2017-12-05 13:23:44-08:00,['e3efdf5c872cda681d5d012046524b9992ffda91'],128,3668,3796,361231,59,0.589316988,0.946584939,0.938704028,1683
1d420e750eb8dc7f0715f7e11e01af1e9ce61506,1,Jagadish,2017-12-11 16:45:44-08:00,['e74998c5e58c891c0744ce1be2b13f7c5861656a'],135,272,407,361638,15,0.884615385,0.487179487,0.423076923,1683
42bac30ad1832afa92767a5ea492bfd6c3de664a,1,Jagadish,2017-12-12 10:46:01-08:00,['1d420e750eb8dc7f0715f7e11e01af1e9ce61506'],4,1886,1890,363528,31,0.523138833,0.806841046,0.830985915,1707
608e4e0b7635aa00a9f1e01647de8d978051d2cf,1,xiliu,2017-12-12 12:16:39-08:00,['42bac30ad1832afa92767a5ea492bfd6c3de664a'],7,87,94,363622,4,0.052631579,1,1,1707
cb92cf18b5b1707d98a442a32a9f6c3767e13527,1,xiliu,2017-12-12 17:07:07-08:00,['608e4e0b7635aa00a9f1e01647de8d978051d2cf'],12,58,70,363692,8,,,,1710
7887b6d868ee048767c11c2db3a5d38093d9abf9,1,Jagadish,2017-12-12 21:41:37-08:00,['cb92cf18b5b1707d98a442a32a9f6c3767e13527'],40,315,355,364047,6,0.231884058,0.985507246,0.985507246,1711
2e5ceec19f52b300b98efb06b292cf9a3db60388,1,Jagadish,2017-12-12 21:47:38-08:00,['7887b6d868ee048767c11c2db3a5d38093d9abf9'],0,290,290,364337,4,,,,1713
54dc4a03e0e1c506e7c73e58575e7c51898309a2,1,Prateek Maheshwari,2017-12-14 12:04:34-08:00,['2e5ceec19f52b300b98efb06b292cf9a3db60388'],3,71,74,364411,2,0,0,1,1713
ed8dad54bf04c3f81c2d686786722333325ca432,0,Jagadish,2017-12-14 15:33:29-08:00,['54dc4a03e0e1c506e7c73e58575e7c51898309a2'],2,153,155,364566,3,,,,1714
ea2b6fa915473e2f120a4860c32cd09b4516c283,0,Prateek Maheshwari,2017-12-18 16:45:06-08:00,['ed8dad54bf04c3f81c2d686786722333325ca432'],3,6,9,364575,1,,,,1714
7dc0290ad8babe3abb315bac2aa4155350a7053d,1,Jacob Maes,2017-12-19 08:00:56-08:00,['ea2b6fa915473e2f120a4860c32cd09b4516c283'],5,25,30,364605,3,0.846153846,0.846153846,1,1714
e87165d403ac4ae66e5b0ee6b837420f0de635f0,0,Jacob Maes,2017-12-21 10:43:47-08:00,['7dc0290ad8babe3abb315bac2aa4155350a7053d'],14,14,28,364633,1,,,,1714
29ecae891a2c9158b59e81d060234504d6844f70,0,Jacob Maes,2017-12-21 11:43:09-08:00,['e87165d403ac4ae66e5b0ee6b837420f0de635f0'],38,270,308,364941,4,0.385321101,0.706422018,1,1715
ef1c9625c63b6c169585c5d1928298f36f3037fb,0,Jacob Maes,2017-12-22 10:36:37-08:00,['29ecae891a2c9158b59e81d060234504d6844f70'],71,103,174,365115,2,0.384615385,0.615384615,0,1715
9a8099cdaa2a8ee6fa64d263ebf6704ee5a108da,0,Jacob Maes,2017-12-22 11:41:27-08:00,['ef1c9625c63b6c169585c5d1928298f36f3037fb'],2,3,5,365120,1,0,1,1,1715
93219c78d6f473d2c7ad4d8702a25f704ee61a7a,1,Jagadish,2017-12-22 13:58:33-08:00,['9a8099cdaa2a8ee6fa64d263ebf6704ee5a108da'],2,1,3,365123,2,0,0,0,1715
882f61a6925d3950e408ec8e202c0e8b6cdff450,1,Jagadish,2018-01-02 12:16:51-08:00,['93219c78d6f473d2c7ad4d8702a25f704ee61a7a'],479,498,977,366100,15,1,1,1,1715
f8d91425e04ae46d5d5bfc72f18663f3d1afdc1f,0,xiliu,2018-01-03 09:56:23-08:00,['882f61a6925d3950e408ec8e202c0e8b6cdff450'],18,35,53,366153,8,,,,1715
d8fdb1a586a4379fcbecbc618a2090a508af63b0,0,xiliu,2018-01-03 16:10:45-08:00,['f8d91425e04ae46d5d5bfc72f18663f3d1afdc1f'],7,7,14,366167,7,,,,1715
7954815ca0887f12fa11d4b4239eb5cd867b0711,0,xiliu,2018-01-04 09:51:20-08:00,['d8fdb1a586a4379fcbecbc618a2090a508af63b0'],1,1,2,366169,1,,,,1715
5238aaa6cee81a87079c9d432204422ececea793,0,xiliu,2018-01-09 10:48:10-08:00,['7954815ca0887f12fa11d4b4239eb5cd867b0711'],0,1,1,366170,1,,,,1715
b00ebd21a8a3cc064009509e5b953008c89a08f6,0,xiliu,2018-01-09 15:55:47-08:00,['5238aaa6cee81a87079c9d432204422ececea793'],5,5,10,366180,2,,,,1715
67e611ee47f0747b81c0de5d061f9888145b605a,0,Boris S,2018-01-10 09:50:40-08:00,"['dd39d089437905abb93aa1074474b28a18292a54', 'b00ebd21a8a3cc064009509e5b953008c89a08f6']",1125,10767,11892,378072,212,,,,1715
07f28e9483ba9c69f44fd7634f6fef6dc47ecd0c,0,xiliu,2018-01-10 10:33:23-08:00,['b00ebd21a8a3cc064009509e5b953008c89a08f6'],1,0,1,378073,1,,,,1715
a6540b4e3d1d3916210c50be9b4b2b4920f885bb,1,xiliu,2018-01-10 10:52:38-08:00,['07f28e9483ba9c69f44fd7634f6fef6dc47ecd0c'],72,86,158,378231,16,1,1,1,1715
9893069cb5186d58e3cf5518ce8e5a7251d8b131,1,xiliu,2018-01-10 11:17:39-08:00,['a6540b4e3d1d3916210c50be9b4b2b4920f885bb'],27,64,91,378322,13,0.92,1,0.96,1715
267dfc6ba0eddd78d5913663496c65eaa1aa3c0b,0,Prateek Maheshwari,2018-01-10 17:14:03-08:00,['9893069cb5186d58e3cf5518ce8e5a7251d8b131'],1,4,5,378327,1,1,1,1,1715
3a9e8064211a79827a2a4793c1f159a689dfa256,0,Jagadish,2018-01-17 09:39:26-08:00,['267dfc6ba0eddd78d5913663496c65eaa1aa3c0b'],14,32,46,378373,4,0.357142857,0.5,0.285714286,1715
fcd2b9a53367c2e0b53df7a1fb7eedc8086b285c,1,Jagadish,2018-01-17 10:06:50-08:00,['3a9e8064211a79827a2a4793c1f159a689dfa256'],50,154,204,378577,10,0.363636364,0,0.772727273,1716
95a71fb9e234c9fc7fcb8a4ec0bbab33c9555738,0,Jagadish,2018-01-17 10:11:40-08:00,['fcd2b9a53367c2e0b53df7a1fb7eedc8086b285c'],52,89,141,378718,4,0.166666667,1,0.222222222,1716
b38e6622f0f96437c4809f314ac9a96c0d75de7d,1,Jacob Maes,2018-01-17 14:26:53-08:00,['95a71fb9e234c9fc7fcb8a4ec0bbab33c9555738'],8,24,32,378750,4,0,0,1,1716
b7805df10f74c4a2b9bb89e49bbaefb72a8526b5,0,Jagadish,2018-01-17 18:27:40-08:00,['b38e6622f0f96437c4809f314ac9a96c0d75de7d'],27,72,99,378849,3,0.193548387,0.774193548,1,1716
e075e956ff7d16d26d92567760aa4002c1b1ac5c,0,Jagadish,2018-01-17 18:35:34-08:00,['b7805df10f74c4a2b9bb89e49bbaefb72a8526b5'],1,1,2,378851,1,,,,1716
24d22bb801f5be6ac9b7afea3f0753e04fb2df2c,0,Jagadish,2018-01-22 11:31:08-08:00,['e075e956ff7d16d26d92567760aa4002c1b1ac5c'],6,46,52,378903,3,1,1,1,1716
d6686b0f02a7f16eabdcec5b4fb83f41461829fc,0,Jagadish,2018-01-22 14:05:51-08:00,['24d22bb801f5be6ac9b7afea3f0753e04fb2df2c'],2,2,4,378907,1,,,,1716
1756b05972741c3344a1d3c2660b974b4558a5e3,0,Jagadish,2018-01-22 14:11:25-08:00,['d6686b0f02a7f16eabdcec5b4fb83f41461829fc'],1,1,2,378909,1,,,,1716
2e04e1772da01ce210592b9af4f302e35b6380e6,1,xiliu,2018-01-24 14:27:39-08:00,['1756b05972741c3344a1d3c2660b974b4558a5e3'],33,550,583,379492,21,0.739910314,0.551569507,0.717488789,1720
75e70e5697ae58e560dd84d0cc52df713386fe08,1,Prateek Maheshwari,2018-01-25 17:28:13-08:00,['2e04e1772da01ce210592b9af4f302e35b6380e6'],328,386,714,380206,48,1,1,0,1721
9674836f603e5566eb74b4b04d8d9b735d402271,1,Jagadish,2018-01-26 12:04:29-08:00,['75e70e5697ae58e560dd84d0cc52df713386fe08'],0,4,4,380210,3,0,0.666666667,0.666666667,1721
7e68e4b109624e1f45d5db6325df9577a1573d55,0,xiliu,2018-01-26 14:02:42-08:00,['9674836f603e5566eb74b4b04d8d9b735d402271'],5,4,9,380219,1,,,,1721
03e5026cf56d955c203e701c80e28c42d792fbce,1,Jagadish,2018-01-31 21:38:14-08:00,['7e68e4b109624e1f45d5db6325df9577a1573d55'],41,234,275,380494,4,0.111111111,0.787037037,0.925925926,1722
c51693bcdfb67a96a53c0dd9075e4c552d201eb2,0,Jagadish,2018-02-01 12:07:56-08:00,['03e5026cf56d955c203e701c80e28c42d792fbce'],28,35,63,380557,3,0,0,0,1722
002e131784d52e02f6d4b46453b31d47f20cad31,1,Jagadish,2018-02-13 11:22:34-08:00,['c51693bcdfb67a96a53c0dd9075e4c552d201eb2'],1,34,35,380592,2,0.444444444,0,0.555555556,1722
4123b160d5cb6d92db4848caf8e043f02da94b05,1,Jagadish,2018-02-13 19:30:03-08:00,['002e131784d52e02f6d4b46453b31d47f20cad31'],6,22,28,380620,3,1,1,1,1722
c3e6b5517bdf505b9943b763a8aba35b714019af,1,xiliu,2018-02-15 15:46:17-08:00,['4123b160d5cb6d92db4848caf8e043f02da94b05'],74,81,155,380775,8,1,0.875,1,1722
718c666127624f959a711e08221d8b8c389720a2,0,Prateek Maheshwari,2018-02-16 10:34:21-08:00,['c3e6b5517bdf505b9943b763a8aba35b714019af'],3,21,24,380799,3,0.6,1,1,1722
6dc89e100998a1b1d20681e8fb63803398c904c4,1,Yi Pan (Data Infrastructure),2018-02-16 14:01:06-08:00,['718c666127624f959a711e08221d8b8c389720a2'],519,762,1281,382080,36,0.574257426,0.831683168,1,1724
6270e40b2943523e75de1e919dd864e876038f5c,0,Jagadish,2018-02-21 11:45:23-08:00,['6dc89e100998a1b1d20681e8fb63803398c904c4'],9,16,25,382105,4,,,,1724
526c1d25d0678c08d696059fd0c27dfc469e6cd7,0,xiliu,2018-02-22 12:39:10-08:00,['6270e40b2943523e75de1e919dd864e876038f5c'],5,8,13,382118,2,,,,1724
47881a24b941031f7ac560c4c75c5778aa5bacf9,0,xiliu,2018-02-22 15:58:39-08:00,['526c1d25d0678c08d696059fd0c27dfc469e6cd7'],2,0,2,382120,1,,,,1724
6af104ea3e440f89197073b68ba0f1004e793d45,0,xiliu,2018-02-22 16:44:00-08:00,['47881a24b941031f7ac560c4c75c5778aa5bacf9'],4,4,8,382128,4,,,,1724
963bd3085e0284b40917c3ddfd02e70f882d1a19,0,Jagadish,2018-02-27 11:47:51-08:00,['6af104ea3e440f89197073b68ba0f1004e793d45'],0,672,672,382800,5,0.520833333,1,0.899305556,1729
ed7e4af2fd059910425dec8e3faf7c8e0eecc9fd,0,Jagadish,2018-03-01 10:58:06-08:00,['963bd3085e0284b40917c3ddfd02e70f882d1a19'],5,5,10,382810,4,,,,1729
bc0a47b7ca0f3f2ff506673224ec7da4880429fd,0,Jagadish,2018-03-03 16:29:44-08:00,['ed7e4af2fd059910425dec8e3faf7c8e0eecc9fd'],2,2,4,382814,1,,,,1729
1dfc5cecdfa358851f01b4ef105ccb0f62e9891c,0,Jagadish,2018-03-03 16:30:59-08:00,['bc0a47b7ca0f3f2ff506673224ec7da4880429fd'],201,101,302,383116,16,0,0,0,1729
810d8bd805f386f79ce73efdee0d2ef341a65e83,1,Jagadish,2018-03-05 16:02:49-08:00,['1dfc5cecdfa358851f01b4ef105ccb0f62e9891c'],2,168,170,383286,6,0.909090909,1,0.954545455,1730
78ee98261debd13a5f2a7fb2ea6408c63f9c4c66,0,Jagadish,2018-03-05 19:40:45-08:00,['810d8bd805f386f79ce73efdee0d2ef341a65e83'],11,14,25,383311,2,1,0,0,1730
aa058655890735274f679f009db2a64f87ec3c04,1,xiliu,2018-03-06 18:20:15-08:00,['78ee98261debd13a5f2a7fb2ea6408c63f9c4c66'],48,904,952,384263,31,0.641456583,0.929971989,0.927170868,1737
f7b0d38340ae4485f0ad91c2d2a7ecb7ff2ecd7c,0,xiliu,2018-03-07 13:22:40-08:00,['aa058655890735274f679f009db2a64f87ec3c04'],7,7,14,384277,5,,,,1737
89dc18e9691adb02eb735d55c121d169ea6c99b5,0,xiliu,2018-03-07 13:24:54-08:00,['f7b0d38340ae4485f0ad91c2d2a7ecb7ff2ecd7c'],17,37,54,384331,3,0,1,1,1737
6492826e15ffbe701d5a6a0cc4a4b2a06299c718,1,Jagadish,2018-03-08 18:00:15-08:00,['89dc18e9691adb02eb735d55c121d169ea6c99b5'],5,6,11,384342,2,0,0,1,1737
1971d596c8215ac2b4e07833323f93b637e60c90,1,xiliu,2018-03-09 11:01:07-08:00,['6492826e15ffbe701d5a6a0cc4a4b2a06299c718'],2,60,62,384404,3,1,1,1,1738
2be7061d4a6ef6345b6f0566cdfeb9bbf279686f,1,Jagadish,2018-03-09 14:57:56-08:00,['1971d596c8215ac2b4e07833323f93b637e60c90'],415,1581,1996,386400,26,0.652561247,0.777282851,0.766146993,1747
49e5073c318abcdf64537d403b80dec218274244,0,xiliu,2018-03-13 12:28:11-07:00,['2be7061d4a6ef6345b6f0566cdfeb9bbf279686f'],3,22,25,386425,3,0,1,1,1748
3f9b967041e4108c0071033a73f2595e56ed3e0b,1,Jagadish,2018-03-13 17:43:45-07:00,['49e5073c318abcdf64537d403b80dec218274244'],10,18,28,386453,3,0,0,0,1748
9f8682138e5ec115ff38fb9882305e6921b13f96,1,xiliu,2018-03-15 16:47:22-07:00,['3f9b967041e4108c0071033a73f2595e56ed3e0b'],3,14,17,386470,1,1,1,0,1748
924a78dabc4fd55d5c50ad3a74d46e660e22d0a5,0,xiliu,2018-03-16 09:22:01-07:00,['9f8682138e5ec115ff38fb9882305e6921b13f96'],4,10,14,386484,1,0,1,1,1748
30c6a89b3605ce97c9226656953b62176393d919,0,Prateek Maheshwari,2018-03-16 13:10:56-07:00,['924a78dabc4fd55d5c50ad3a74d46e660e22d0a5'],14,39,53,386537,3,0,1,1,1748
2d7b0f52c316f0007c1217dc29f447b2136eefe3,0,xiliu,2018-03-21 13:13:16-07:00,['30c6a89b3605ce97c9226656953b62176393d919'],1,1,2,386539,1,,,,1748
956cf412a44812d54286fd9a0c4d167239387362,1,xiliu,2018-03-21 17:58:07-07:00,['2d7b0f52c316f0007c1217dc29f447b2136eefe3'],272,2145,2417,388956,40,0.322613065,0.872361809,0.856281407,1762
272aa32e3045a7eb4b429e7790931a914317eef3,1,xiliu,2018-03-22 17:08:11-07:00,['956cf412a44812d54286fd9a0c4d167239387362'],64,66,130,389086,5,0,1,1,1762
b0603c3c7ca155ba507a76fc4f3d5407b7628c30,1,Prateek Maheshwari,2018-03-26 16:08:00-07:00,['272aa32e3045a7eb4b429e7790931a914317eef3'],7,9,16,389102,1,1,1,1,1762
aff805d07e8fc6b50d88d4e78132fa8bd7c3ad5f,1,xiliu,2018-03-27 11:39:52-07:00,['b0603c3c7ca155ba507a76fc4f3d5407b7628c30'],72,267,339,389441,4,0,0.529411765,0.970588235,1763
5431350b7390704e395c947834b01a5f2e76d906,0,xiliu,2018-03-28 10:25:15-07:00,['aff805d07e8fc6b50d88d4e78132fa8bd7c3ad5f'],18,84,102,389543,5,0,0.653061224,0.795918367,1763
c99e57133f5bedab2355f55aefcc7bee8a93cc75,0,Prateek Maheshwari,2018-03-28 17:52:58-07:00,['5431350b7390704e395c947834b01a5f2e76d906'],68,33,101,389644,4,0,0,0,1763
13ff090245b3539ee5c048c707dcee2e5bde5252,1,Prateek Maheshwari,2018-03-28 18:14:34-07:00,['c99e57133f5bedab2355f55aefcc7bee8a93cc75'],5,31,36,389680,5,0.85,1,0.95,1763
57fea260a5dad24b287dad113c78bf23aa3ba8f9,1,Yi Pan (Data Infrastructure),2018-03-29 15:26:28-07:00,['13ff090245b3539ee5c048c707dcee2e5bde5252'],25,92,117,389797,6,0.034482759,0.655172414,0.827586207,1763
e58e3cadc53d85cd35357eff0f9bd1806b16349e,0,Jagadish,2018-03-29 15:57:58-07:00,['57fea260a5dad24b287dad113c78bf23aa3ba8f9'],14,14,28,389825,1,,,,1763
aba739307174db49adf5f833c5b32c8bfb623153,0,Prateek Maheshwari,2018-03-30 17:11:49-07:00,['e58e3cadc53d85cd35357eff0f9bd1806b16349e'],7,7,14,389839,5,,,,1763
8e000f3984e6158b504bc9cad0c81ea3d260cea3,1,xiliu,2018-03-30 17:45:41-07:00,['aba739307174db49adf5f833c5b32c8bfb623153'],123,291,414,390253,3,0.875,1,0.708333333,1764
fda1e37d0862493cb59ed0907c597a2dc973ef6f,1,Prateek Maheshwari,2018-04-10 15:39:21-07:00,['8e000f3984e6158b504bc9cad0c81ea3d260cea3'],187,322,509,390762,17,0,0.962264151,0.79245283,1764
26294151642283c1cfb51590b51a86d2eaedd11f,0,xiliu,2018-04-11 13:21:36-07:00,['fda1e37d0862493cb59ed0907c597a2dc973ef6f'],3,2,5,390767,3,1,0,0,1764
bbcf14ebac47e4dd43e2a190f33f9810482034cf,0,xiliu,2018-04-11 15:34:43-07:00,['26294151642283c1cfb51590b51a86d2eaedd11f'],178,146,324,391091,1,0.769230769,0.038461538,0.153846154,1764
3895a90706a8b5db3e622a0bb7b581852b60f7fa,1,Jagadish,2018-04-12 13:31:39-07:00,['bbcf14ebac47e4dd43e2a190f33f9810482034cf'],5,21,26,391117,3,0,0,1,1764
76de840c734fe2b7987af22d1ba6133437c25a5e,1,Prateek Maheshwari,2018-04-12 14:34:45-07:00,['3895a90706a8b5db3e622a0bb7b581852b60f7fa'],27,27,54,391171,1,1,1,0,1764
96c3334693f7d18d087dc5262dddfc7f315d37f1,0,Jagadish,2018-04-12 16:50:30-07:00,['76de840c734fe2b7987af22d1ba6133437c25a5e'],6,5,11,391182,1,1,0,0,1764
b6219f181ff54e79aedcf6f1b7fff264925a8af7,1,Jagadish,2018-04-12 19:23:44-07:00,['96c3334693f7d18d087dc5262dddfc7f315d37f1'],31,169,200,391382,5,0.204545455,1,0.931818182,1764
bf2a2f76d8632c762a9c337ad6550a56abfb1946,0,Jagadish,2018-04-13 08:37:20-07:00,['b6219f181ff54e79aedcf6f1b7fff264925a8af7'],6,11,17,391399,2,0,0,1,1764
58c39e37121c9e11a5266cf7eaa3aaf6560ac6c9,1,Jagadish,2018-04-16 10:26:51-07:00,['bf2a2f76d8632c762a9c337ad6550a56abfb1946'],206,941,1147,392546,27,0.322485207,0.730769231,0.99408284,1769
67ce608f2e5bea6795b44213f0b90825141a217c,1,xiliu,2018-04-17 09:09:01-07:00,['58c39e37121c9e11a5266cf7eaa3aaf6560ac6c9'],5,833,838,393384,8,0.919847328,1,0.919847328,1775
5b953ac3e0536e73d5b5e1238e92f77f165fe7e4,1,xiliu,2018-04-17 11:55:49-07:00,['67ce608f2e5bea6795b44213f0b90825141a217c'],0,2,2,393386,2,0,1,1,1775
12968cfb6024705d6412b9b9917897f0eb794c3e,1,Jagadish,2018-04-17 15:40:59-07:00,['5b953ac3e0536e73d5b5e1238e92f77f165fe7e4'],0,735,735,394121,10,0.449541284,1,0.944954128,1785
d7a071b346a2a6d31e90fc038bd30c7ba8cb7ef1,1,xiliu,2018-04-17 16:02:16-07:00,['12968cfb6024705d6412b9b9917897f0eb794c3e'],86,102,188,394309,3,0,0,1,1785
aac6368a2409764a98109109547a5af62860ff0f,1,Jagadish,2018-04-17 16:02:49-07:00,['d7a071b346a2a6d31e90fc038bd30c7ba8cb7ef1'],22,373,395,394704,9,0.345238095,1,0.946428571,1788
bca978eb2cf1f1e781ed349ace87729b98be2145,0,xiliu,2018-04-18 10:00:56-07:00,['aac6368a2409764a98109109547a5af62860ff0f'],29,62,91,394795,5,0,0,1,1788
5d73ecdad729f0ab6b1da89fe2dd63460a37df6e,1,Prateek Maheshwari,2018-04-18 13:32:15-07:00,['bca978eb2cf1f1e781ed349ace87729b98be2145'],778,860,1638,396433,80,0.805555556,0,0,1794
3cc2a05f7009c34759baf1533f0a0e58f75839de,1,Prateek Maheshwari,2018-04-18 15:31:06-07:00,['5d73ecdad729f0ab6b1da89fe2dd63460a37df6e'],102,290,392,396825,20,0.325,0.691666667,0.875,1794
2f4d0b953c635e8676b83cc1a4a28213dc21a49d,1,Jagadish,2018-04-20 09:18:31-07:00,['3cc2a05f7009c34759baf1533f0a0e58f75839de'],271,534,805,397630,21,0.475409836,0.975409836,0.893442623,1796
8b7417bcad740f78b23cccbeb523fa902d80b0da,0,Jagadish,2018-04-20 19:52:35-07:00,['2f4d0b953c635e8676b83cc1a4a28213dc21a49d'],4,4,8,397638,1,,,,1796
38559796edf28fd81d9d59078d312aa06d7d075d,1,Jagadish,2018-04-23 13:20:45-07:00,['8b7417bcad740f78b23cccbeb523fa902d80b0da'],3,12,15,397653,2,0.2,1,1,1796
71dba52a86304470659e2e68a6e5fd726dbeba2b,0,Jagadish,2018-04-23 13:24:54-07:00,['38559796edf28fd81d9d59078d312aa06d7d075d'],37,20,57,397710,1,1,0,0,1796
7a32d30db0f474f76a090e6c44e2838986eae800,0,Jagadish,2018-04-23 20:28:43-07:00,['71dba52a86304470659e2e68a6e5fd726dbeba2b'],1,2,3,397713,1,,,,1796
e63d27c0cd08973f35ae5c6967f71ddd3dff31c3,1,Jagadish,2018-04-24 12:26:14-07:00,['7a32d30db0f474f76a090e6c44e2838986eae800'],14,63,77,397790,3,0.225,0.05,1,1796
c89841366d53b9e2733dc72bbf91dea9382099a0,0,Prateek Maheshwari,2018-04-24 15:56:05-07:00,['e63d27c0cd08973f35ae5c6967f71ddd3dff31c3'],1,2,3,397793,1,,,,1796
66525b51ee2cfc82b81798d2c9d450cfe770f21e,1,Jagadish,2018-04-25 09:48:11-07:00,['c89841366d53b9e2733dc72bbf91dea9382099a0'],9,42,51,397844,2,0,0,1,1796
48b17be33d19ca9346cbbade0cca14ba334319ba,0,Jagadish,2018-04-25 17:17:34-07:00,['66525b51ee2cfc82b81798d2c9d450cfe770f21e'],18,26,44,397888,2,1,0,0,1796
af06c8d0c77acf833af1d1ac538763c411b107ef,0,Jagadish,2018-04-25 17:20:01-07:00,['48b17be33d19ca9346cbbade0cca14ba334319ba'],1,1,2,397890,1,,,,1796
db57304ffa29d84912ae4ac69d5a9d1637019405,1,xiliu,2018-04-27 10:22:57-07:00,['af06c8d0c77acf833af1d1ac538763c411b107ef'],97,214,311,398201,6,0,1,1,1796
cf4872e2aee755a1264a3415ed88d955436c239f,0,Jagadish,2018-04-27 11:59:33-07:00,['db57304ffa29d84912ae4ac69d5a9d1637019405'],52,54,106,398307,3,,,,1796
603af35a526a1b241067a5a3d10d8d49d7ac3d58,1,Jagadish,2018-04-27 18:55:15-07:00,['cf4872e2aee755a1264a3415ed88d955436c239f'],163,222,385,398692,2,1,0,1,1796
445d1e26c9a222061b43b9cb5a637358039270b9,1,Jagadish,2018-04-30 16:51:37-07:00,['603af35a526a1b241067a5a3d10d8d49d7ac3d58'],47,175,222,398914,4,1,1,1,1798
94ff28c56271902db18d31b5e7b195caa69e311a,0,Prateek Maheshwari,2018-05-01 13:00:38-07:00,['445d1e26c9a222061b43b9cb5a637358039270b9'],2,2,4,398918,2,,,,1798
906aa6b88900d8cafe6b7a1fa77c3a569caefc46,0,Prateek Maheshwari,2018-05-01 13:49:21-07:00,['94ff28c56271902db18d31b5e7b195caa69e311a'],42,42,84,399002,1,0.25,0,0,1798
51729ac6836f5baa522d7ba6a7308504ba027c5f,0,Jagadish,2018-05-03 17:37:49-07:00,['906aa6b88900d8cafe6b7a1fa77c3a569caefc46'],6,5,11,399013,2,1,0,0,1798
2e461a8804ec568ff52de2d6e81a8edd4865ce12,0,Jagadish,2018-05-04 14:02:35-07:00,['51729ac6836f5baa522d7ba6a7308504ba027c5f'],1,1,2,399015,1,,,,1798
fa49e7228319e845bb81336b97af8e28e04524c9,0,xiliu,2018-05-07 09:51:28-07:00,['2e461a8804ec568ff52de2d6e81a8edd4865ce12'],2,316,318,399333,16,0.710843373,1,0.927710843,1801
40154b4f589f48eeedf2685d706d29ae89af83f1,1,xiliu,2018-05-07 11:11:01-07:00,['fa49e7228319e845bb81336b97af8e28e04524c9'],10,195,205,399538,6,0.457831325,0.674698795,1,1802
164fa5f03f26f3b118675469f236e790c0e48e38,0,xiliu,2018-05-07 12:34:26-07:00,['40154b4f589f48eeedf2685d706d29ae89af83f1'],31,104,135,399673,6,0.375,1,1,1802
9d904b1578827d8ffcf75f8b27d5ca1262f86118,0,Jagadish,2018-05-07 13:43:05-07:00,['164fa5f03f26f3b118675469f236e790c0e48e38'],30,56,86,399759,4,0.842105263,0.947368421,0.736842105,1802
d493f9a46e92dc528cac718310dd4623e7d9cd44,1,Jagadish,2018-05-07 13:45:53-07:00,['9d904b1578827d8ffcf75f8b27d5ca1262f86118'],102,198,300,400059,2,0.8,0,1,1802
58174143c91b8827bd8a228baa09859ee9b1c036,0,xiliu,2018-05-07 16:13:27-07:00,['d493f9a46e92dc528cac718310dd4623e7d9cd44'],26,27,53,400112,13,,,,1802
9ac221e4e99d3e576c7fad03d0b83eeb489564e9,0,xiliu,2018-05-07 17:06:35-07:00,['58174143c91b8827bd8a228baa09859ee9b1c036'],0,1,1,400113,1,,,,1802
31a9e4aea8a8233853334b7ed70da8694f42bd52,0,xiliu,2018-05-07 18:14:29-07:00,['9ac221e4e99d3e576c7fad03d0b83eeb489564e9'],2,2,4,400117,2,,,,1802
727a3c19a1381f35ca650fe1d0398ab2b5e142ed,1,Jagadish,2018-05-07 19:40:03-07:00,['31a9e4aea8a8233853334b7ed70da8694f42bd52'],35,83,118,400235,3,0.111111111,0.740740741,1,1802
89beb1fccb01c781a4de905d57a4bd99df25577a,0,xiliu,2018-05-08 17:48:55-07:00,['727a3c19a1381f35ca650fe1d0398ab2b5e142ed'],63,125,188,400423,16,0.083333333,1,1,1802
9d404bc515a4cbc81bb9922d8d44b02ef1e84fcf,0,Jagadish,2018-05-09 15:32:44-07:00,['89beb1fccb01c781a4de905d57a4bd99df25577a'],33,49,82,400505,1,1,1,1,1802
345f9f2333cdfea65c69e88594f6a5d6ba856145,0,xiliu,2018-05-10 09:21:12-07:00,['9d404bc515a4cbc81bb9922d8d44b02ef1e84fcf'],3,7,10,400515,1,0,1,1,1802
fed8212bd30a6e02248e00ad0b652dd4836ace79,0,Prateek Maheshwari,2018-05-10 10:45:41-07:00,['345f9f2333cdfea65c69e88594f6a5d6ba856145'],171,195,366,400881,17,0.756756757,1,1,1802
54c690e6fc52ac13d1c59fe1bd1c34f35f710164,0,xiliu,2018-05-10 12:16:33-07:00,['fed8212bd30a6e02248e00ad0b652dd4836ace79'],6,9,15,400896,1,0,1,1,1802
e204d298e84f549ecf4d8d9d642304502f046c29,0,xiliu,2018-05-10 14:19:08-07:00,['54c690e6fc52ac13d1c59fe1bd1c34f35f710164'],2,5,7,400903,2,0,1,1,1802
15e0ababb5b5bd08fdbbbeb0b0d971f93c1900de,0,Prateek Maheshwari,2018-05-11 10:55:02-07:00,['e204d298e84f549ecf4d8d9d642304502f046c29'],120,120,240,401143,1,0,1,1,1802
578cc19f69c92dfde5bd0b972ce8147b84988153,1,xiliu,2018-05-14 10:28:52-07:00,['15e0ababb5b5bd08fdbbbeb0b0d971f93c1900de'],123,91,214,401357,8,0.411764706,0,0.058823529,1802
e44b333f17ffcc47bc20ac42daca5231aee19272,0,Jagadish,2018-05-16 22:19:37-07:00,['578cc19f69c92dfde5bd0b972ce8147b84988153'],2,1,3,401360,1,,,,1802
3b9e14be3aa5fc2b6003b7e244fba466db34236f,0,xiliu,2018-05-18 12:29:24-07:00,['e44b333f17ffcc47bc20ac42daca5231aee19272'],4,3,7,401367,2,,,,1802
171793b69b33081fc6277c9505b3055f79fcb4b7,0,xiliu,2018-05-18 12:31:44-07:00,['3b9e14be3aa5fc2b6003b7e244fba466db34236f'],8,11,19,401386,4,1,1,1,1802
7a2b4650cd7c87f0475bc06d306cd4ef834377b0,1,Jacob Maes,2018-05-18 14:23:07-07:00,['171793b69b33081fc6277c9505b3055f79fcb4b7'],73,583,656,402042,8,0.604240283,1,0.869257951,1804
72ad7523fffdcafdc01a0c6922fc94ccd1e482a5,1,Jagadish,2018-05-18 17:29:00-07:00,['7a2b4650cd7c87f0475bc06d306cd4ef834377b0'],34,73,107,402149,3,0,0.944444444,0.944444444,1804
02153fa506e38b2e7f01c0374089e200bfe1e363,1,Jagadish,2018-05-21 11:09:44-07:00,['72ad7523fffdcafdc01a0c6922fc94ccd1e482a5'],148,152,300,402449,2,1,1,0,1804
ebdb5b2f712250f1f3aba92aa2fd033aded690e9,0,Jagadish,2018-05-21 11:15:51-07:00,['02153fa506e38b2e7f01c0374089e200bfe1e363'],28,31,59,402508,4,1,0,1,1804
b0ce5db9b634c4d2f94e16c402537fd05f719558,0,Prateek Maheshwari,2018-05-21 17:15:31-07:00,['ebdb5b2f712250f1f3aba92aa2fd033aded690e9'],1,1,2,402510,1,,,,1804
8f8e7bcb9edaaaa67bd12b5ecd42269bfa6d90a4,1,Jagadish,2018-05-22 15:19:55-07:00,['b0ce5db9b634c4d2f94e16c402537fd05f719558'],36,89,125,402635,9,0.707317073,1,0.951219512,1804
dfc1508aaf3689ed2ac9751619aad10f9a638c07,0,Jagadish,2018-05-23 17:59:51-07:00,['8f8e7bcb9edaaaa67bd12b5ecd42269bfa6d90a4'],0,5,5,402640,1,0,1,1,1804
bc4a0c2defc3c70a66d6dceaf43fca833b24e93f,1,Boris S,2018-05-23 19:27:48-07:00,['dfc1508aaf3689ed2ac9751619aad10f9a638c07'],1,3,4,402644,2,,,,1804
53d7f2625145f560eb6ccc49d48dc176f244f9b3,1,Yi Pan (Data Infrastructure),2018-05-25 09:37:55-07:00,['bc4a0c2defc3c70a66d6dceaf43fca833b24e93f'],1677,5093,6770,409414,126,0.489626556,0.987551867,0.988144635,1823
9f323c950410ad52cd29a9ac8def65af5b578487,1,Jagadish,2018-05-29 16:26:25-07:00,['53d7f2625145f560eb6ccc49d48dc176f244f9b3'],10,6,16,409430,1,1,0,0,1823
4187ba9535da5c88a9e22754927da58600b48447,0,Jagadish,2018-05-29 18:48:02-07:00,['9f323c950410ad52cd29a9ac8def65af5b578487'],9,63,72,409502,2,,,,1823
5534fba33d461aeff174bdf6d6bee24099cdf388,0,Jagadish,2018-05-29 20:13:41-07:00,['4187ba9535da5c88a9e22754927da58600b48447'],1,1,2,409504,1,,,,1823
b9814daf029d1e9017638936b75fff205696b973,1,Prateek Maheshwari,2018-05-30 10:37:23-07:00,['5534fba33d461aeff174bdf6d6bee24099cdf388'],11,35,46,409550,4,0,1,1,1823
4d7482dacef6dcc7eed9576ae997c528567f4c50,1,Jagadish,2018-05-30 15:51:08-07:00,['b9814daf029d1e9017638936b75fff205696b973'],2,14,16,409566,2,1,1,1,1823
ae056ff7bc137e74364c9ff534ab522156f47797,1,Jagadish,2018-05-31 10:43:30-07:00,['4d7482dacef6dcc7eed9576ae997c528567f4c50'],51,1337,1388,410954,14,0.592592593,0.808966862,0.861598441,1834
2227f9f1a56e0336e9ce64188e00620608fbd985,0,Prateek Maheshwari,2018-06-01 13:17:37-07:00,['ae056ff7bc137e74364c9ff534ab522156f47797'],27,47,74,411028,4,0.833333333,1,1,1834
4c0e50581c3a9473fb4cb09103577e468b0fb439,0,Jagadish,2018-06-05 11:44:49-07:00,['2227f9f1a56e0336e9ce64188e00620608fbd985'],1,1,2,411030,1,,,,1834
36c4c4b02df36027fc3516407085175fb565bd70,0,Prateek Maheshwari,2018-06-06 11:00:06-07:00,['4c0e50581c3a9473fb4cb09103577e468b0fb439'],4,5,9,411039,1,0,1,1,1834
161d1c47a2c7322a7d3197d571a227cce0f1cbbf,1,Prateek Maheshwari,2018-06-07 16:51:30-07:00,['36c4c4b02df36027fc3516407085175fb565bd70'],9,32,41,411080,6,0,1,1,1834
f249e71a2281cb91f8d2ba8ef3aa03e0e8efd791,0,Jagadish,2018-06-08 10:05:36-07:00,['161d1c47a2c7322a7d3197d571a227cce0f1cbbf'],16,165,181,411261,3,0,1,0.672131148,1836
0edf343b8c5360437fa10cc5a543696a4edcc319,0,Boris S,2018-06-08 10:15:36-07:00,"['67e611ee47f0747b81c0de5d061f9888145b605a', 'f249e71a2281cb91f8d2ba8ef3aa03e0e8efd791']",6693,23688,30381,441642,538,,,,1836
a706adda8767a057a81b316bced5ef3422def635,0,Jagadish,2018-06-08 14:02:53-07:00,['f249e71a2281cb91f8d2ba8ef3aa03e0e8efd791'],3,11,14,441656,1,1,1,1,1836
2a9e729ad4fbfb69cd8cf1446589a04580bf79ae,0,Boris S,2018-06-08 14:25:27-07:00,['a706adda8767a057a81b316bced5ef3422def635'],3,3,6,441662,1,,,,1836
af4ddc4a97c63ff167e33727ba94da91500b7f42,1,Jagadish,2018-06-11 10:49:45-07:00,['2a9e729ad4fbfb69cd8cf1446589a04580bf79ae'],84,205,289,441951,9,1,1,1,1838
a4ac1791fcd2b45a87c4c866beecbd0206b46c0e,1,Jagadish,2018-06-13 16:04:02-07:00,['af4ddc4a97c63ff167e33727ba94da91500b7f42'],98,732,830,442781,11,0.442176871,1,0.952380952,1841
7fc39e521ace845ac7a3af79b84e9710f09581cd,1,xiliu,2018-06-13 16:12:44-07:00,['a4ac1791fcd2b45a87c4c866beecbd0206b46c0e'],85,138,223,443004,9,0,0.857142857,0,1841
f6a2d54dab51915aeb99d62b7c59523d543e42b7,0,Jagadish,2018-06-13 21:01:53-07:00,['7fc39e521ace845ac7a3af79b84e9710f09581cd'],34,353,387,443391,28,0.758928571,1,0.946428571,1843
5c33fe7724f0ae92208472428a9e442643310957,0,Jagadish,2018-06-14 14:04:53-07:00,['f6a2d54dab51915aeb99d62b7c59523d543e42b7'],9,44,53,443444,5,0.590909091,1,1,1843
42b187a217d5caa882047ca836070f986753a141,0,Jagadish,2018-06-15 16:27:45-07:00,['5c33fe7724f0ae92208472428a9e442643310957'],52,354,406,443850,12,0.632075472,1,0.716981132,1846
991ed99aac4ee56d82002afb030dcabd5e75e83c,1,xiliu,2018-06-22 12:44:57-07:00,['42b187a217d5caa882047ca836070f986753a141'],4,63,67,443917,2,1,1,1,1847
15c5a1a7e3935bd1fc9808e81bb98ec9c98b14a2,1,xiliu,2018-06-22 15:19:50-07:00,['991ed99aac4ee56d82002afb030dcabd5e75e83c'],0,910,910,444827,8,0.65483871,0.838709677,0.861290323,1855
ff251405b745c8aa27a8a490b75c38878b2fb7e4,0,xiliu,2018-06-22 15:46:14-07:00,['15c5a1a7e3935bd1fc9808e81bb98ec9c98b14a2'],10,0,10,444837,1,1,0,0,1855
cdeea9015e21720f830a4983c4ce1531e0499050,1,xiliu,2018-06-22 15:53:43-07:00,['ff251405b745c8aa27a8a490b75c38878b2fb7e4'],10,885,895,445732,13,0.486702128,1,0.928191489,1863
11afae3fd7766c7a7c61e0a0283cbcf22bb41560,0,Jagadish,2018-06-22 17:29:29-07:00,['cdeea9015e21720f830a4983c4ce1531e0499050'],1,17,18,445750,1,0.8,0.8,1,1863
187ec5f2fc81bab63bef5de28865ea267a4400fc,0,Jagadish,2018-06-22 18:06:51-07:00,['11afae3fd7766c7a7c61e0a0283cbcf22bb41560'],360,189,549,446299,9,0,0.404255319,0.191489362,1863
c8b776ec1023599f9dc6c936c483d4eb4227017f,0,Jagadish,2018-06-22 18:18:06-07:00,['187ec5f2fc81bab63bef5de28865ea267a4400fc'],18,10,28,446327,4,,,,1863
a702b3bb4a159804a2f7234710231b0dbf570b90,0,Boris S,2018-06-25 13:08:50-07:00,['c8b776ec1023599f9dc6c936c483d4eb4227017f'],2,15,17,446344,2,0.6,0,0.6,1863
f6c99a4c4f71ef7d98528fac84a7669c5a2b6891,0,xiliu,2018-06-26 14:35:00-07:00,['a702b3bb4a159804a2f7234710231b0dbf570b90'],0,21,21,446365,2,1,1,0,1863
c5557140d454d5e6ddfc4e8eeaae112178a1d54f,0,Yi Pan (Data Infrastructure),2018-06-28 09:10:44-07:00,['f6c99a4c4f71ef7d98528fac84a7669c5a2b6891'],42,303,345,446710,15,0.474074074,0.622222222,1,1865
a6701f64a692b1357138886f652f8a8699ae1534,1,Boris S,2018-06-28 15:48:28-07:00,['c5557140d454d5e6ddfc4e8eeaae112178a1d54f'],9,110,119,446829,4,0.326923077,0.653846154,1,1865
3055e850278eff063d585dcbc194a5d6ab392d38,0,Jacob Maes,2018-06-29 16:40:21-07:00,['a6701f64a692b1357138886f652f8a8699ae1534'],1,6,7,446836,1,,,,1865
08cfad9907e27aad48bc4f3e2ec745b8b9ec60f4,0,Jagadish,2018-07-09 12:29:14-07:00,['3055e850278eff063d585dcbc194a5d6ab392d38'],5,5,10,446846,2,,,,1865
93b397e84056f311d238be72181b2df60cccb6c0,1,Jagadish,2018-07-10 16:34:58-07:00,['08cfad9907e27aad48bc4f3e2ec745b8b9ec60f4'],184,456,640,447486,12,0.25,1,0.994444444,1865
7055ce670a270a14c1833ee0bd05fbd74cb93911,0,Jagadish,2018-07-13 15:26:34-07:00,['93b397e84056f311d238be72181b2df60cccb6c0'],3,11,14,447500,1,0.666666667,0.666666667,1,1865
525e8e2d8205c7e25d6ba3a13ed22521490496e3,1,Jagadish,2018-07-19 15:06:27-07:00,['7055ce670a270a14c1833ee0bd05fbd74cb93911'],41,405,446,447946,5,0.513513514,1,1,1868
d131d4c5571480d3d32c2bab09e2431d75a9de87,0,Jagadish,2018-07-19 20:23:30-07:00,['525e8e2d8205c7e25d6ba3a13ed22521490496e3'],0,6,6,447952,1,0,1,1,1868
9f8d593c41d93977afd1750050d7f8e956b7376b,0,Jagadish,2018-07-23 18:35:20-07:00,['d131d4c5571480d3d32c2bab09e2431d75a9de87'],1,1,2,447954,1,,,,1868
fa56b15dc55f006cda57eec7d8dfc999db8b94fb,1,Prateek Maheshwari,2018-07-24 09:01:09-07:00,['9f8d593c41d93977afd1750050d7f8e956b7376b'],168,983,1151,449105,23,0.599388379,0.862385321,0.678899083,1872
025f617106c75f9807d49172ed98d3b141ced05a,0,Prateek Maheshwari,2018-07-24 12:28:55-07:00,['fa56b15dc55f006cda57eec7d8dfc999db8b94fb'],15,20,35,449140,1,,,,1872
0c0904b01f1467b29d755401aa05cc48d1098270,0,Srinivasulu Punuru,2018-07-24 14:25:19-07:00,['025f617106c75f9807d49172ed98d3b141ced05a'],7,45,52,449192,6,0.238095238,0.714285714,1,1872
3f7ed71f8f5d6efe3567f039734ac96bb12679b6,0,Wei Song,2018-07-24 18:34:06-07:00,['0c0904b01f1467b29d755401aa05cc48d1098270'],0,5,5,449197,1,,,,1872
7a8927de5d52dfd35628631b2558971ff1a413ca,0,Wei Song,2018-07-24 22:12:41-07:00,['0c0904b01f1467b29d755401aa05cc48d1098270'],0,5,5,449202,1,,,,1872
de5d92e51994d77cba6590b6f360f1ddda2fdc4f,0,Prateek Maheshwari,2018-07-24 22:17:25-07:00,['7a8927de5d52dfd35628631b2558971ff1a413ca'],8,4,12,449214,3,1,0,1,1872
c98d7b0d88f3b04faf4ae3fd0151d26e24534724,0,Prateek Maheshwari,2018-07-25 11:19:11-07:00,['de5d92e51994d77cba6590b6f360f1ddda2fdc4f'],1,0,1,449215,1,,,,1872
3235929bc55f9bc0f7cc9a8b7ad2994200cb7f35,0,Jagadish,2018-07-25 15:03:02-07:00,['c98d7b0d88f3b04faf4ae3fd0151d26e24534724'],2,10,12,449227,3,1,1,1,1872
c4dfbd347c822c030ed1bee8a1c5c73bed04779c,0,Prateek Maheshwari,2018-07-26 11:18:04-07:00,['3235929bc55f9bc0f7cc9a8b7ad2994200cb7f35'],6,6,12,449239,1,,,,1872
43c36e6f2e4c51c916011a8a35830eb141b3567f,0,xiliu,2018-07-26 17:17:51-07:00,['c4dfbd347c822c030ed1bee8a1c5c73bed04779c'],13,22,35,449274,1,1,1,1,1872
440a25c97e7c0e7e7339c8cb08813ef08f4cdf19,1,Prateek Maheshwari,2018-07-27 11:24:00-07:00,['43c36e6f2e4c51c916011a8a35830eb141b3567f'],1077,943,2020,451294,57,1,0,0,1874
e0ff4c523e683ff70f9a899725e865062383a8ca,1,Prateek Maheshwari,2018-07-27 11:53:41-07:00,['440a25c97e7c0e7e7339c8cb08813ef08f4cdf19'],6,403,409,451703,9,0.825396825,0.904761905,0.952380952,1879
3e7f2e52b9a5f45a049083c87af5eda09d789dd9,0,Prateek Maheshwari,2018-07-27 18:29:33-07:00,['e0ff4c523e683ff70f9a899725e865062383a8ca'],14,19,33,451736,2,0.8,1,0.8,1879
032a16079db8cbb1caf00117b985f7575d2c823a,0,Jagadish,2018-07-30 09:28:16-07:00,['3e7f2e52b9a5f45a049083c87af5eda09d789dd9'],40,221,261,451997,5,0.238938053,1,0.938053097,1879
01a1795e55b9d5547e1a23575f5a39ceb1954915,0,xiliu,2018-07-30 11:46:39-07:00,['032a16079db8cbb1caf00117b985f7575d2c823a'],3,47,50,452047,4,0,0.806451613,0.806451613,1879
1d2f054ab0c250f33137c11b36c61549549bb0c2,0,Jagadish,2018-08-01 15:20:10-07:00,['01a1795e55b9d5547e1a23575f5a39ceb1954915'],1,79,80,452127,4,0.642857143,0,0.785714286,1879
5587ebfececf27c3a1d38f3b63c8a1072e10816d,0,xiliu,2018-08-01 16:12:06-07:00,['1d2f054ab0c250f33137c11b36c61549549bb0c2'],0,3,3,452130,1,0,0,1,1879
13e26fb45b69c2f6f74a970475cb8239157d069e,1,Boris S,2018-08-01 17:18:21-07:00,['5587ebfececf27c3a1d38f3b63c8a1072e10816d'],168,449,617,452747,16,0.390728477,1,0.761589404,1880
0c488bbb81bdcba033f061ea1187c6233a5be295,0,Jagadish,2018-08-01 18:40:27-07:00,['13e26fb45b69c2f6f74a970475cb8239157d069e'],9,156,165,452912,4,0.972972973,1,0.972972973,1881
8ce1bd5569ba5144a39eb8890986e9db5c27d16a,0,Prateek Maheshwari,2018-08-02 06:55:54-07:00,['0c488bbb81bdcba033f061ea1187c6233a5be295'],88,60,148,453060,1,0,0,0,1881
88f855954e4d98aa3bdd3a3a778eb699a13ff659,0,Boris S,2018-08-02 13:29:58-07:00,"['0edf343b8c5360437fa10cc5a543696a4edcc319', '8ce1bd5569ba5144a39eb8890986e9db5c27d16a']",2550,8593,11143,464203,242,,,,1881
e310c5cd2c561e3f83ec97935a5343bd2866e681,0,Boris S,2018-08-03 11:21:43-07:00,['8ce1bd5569ba5144a39eb8890986e9db5c27d16a'],57,82,139,464342,2,1,1,1,1881
5cbf9af9c12b96c5773a37274538f8baea8347e1,0,Wei Song,2018-08-03 13:38:41-07:00,"['3f7ed71f8f5d6efe3567f039734ac96bb12679b6', 'e310c5cd2c561e3f83ec97935a5343bd2866e681']",1478,2489,3967,468309,106,,,,1881
c1ea1fda7724a6e89872a2640e2a4ec66c94c916,1,Prateek Maheshwari,2018-08-03 17:21:33-07:00,['e310c5cd2c561e3f83ec97935a5343bd2866e681'],10,506,516,468825,4,0.455223881,0.958955224,0.858208955,1883
a15a7c9a231adcc1b441351963e15a7855ea5879,0,Wei Song,2018-08-06 11:49:30-07:00,"['5cbf9af9c12b96c5773a37274538f8baea8347e1', 'c1ea1fda7724a6e89872a2640e2a4ec66c94c916']",10,506,516,469341,4,,,,1883
94951bc815fee439a737562fe13c46aef098f29e,0,Wei Song,2018-08-07 10:13:01-07:00,['c1ea1fda7724a6e89872a2640e2a4ec66c94c916'],1,5,6,469347,2,0,1,1,1883
e2335bd56efd709459e0514971e53eed84ef8f5f,0,Jagadish,2018-08-07 17:39:04-07:00,['94951bc815fee439a737562fe13c46aef098f29e'],1,2,3,469350,1,,,,1883
d28f0c857ea01682690c18b89d79fb2e327458c0,0,Jagadish,2018-08-07 17:43:15-07:00,['e2335bd56efd709459e0514971e53eed84ef8f5f'],2,2,4,469354,1,,,,1883
78ad578cc022af3f9c5f9a15826a9dc010502a89,0,Boris S,2018-08-07 19:04:17-07:00,"['88f855954e4d98aa3bdd3a3a778eb699a13ff659', 'd28f0c857ea01682690c18b89d79fb2e327458c0']",71,597,668,470022,10,,,,1883
8aa879aa62ddf77ad42a01bb905a2561a3744649,0,Boris S,2018-08-09 10:49:51-07:00,['d28f0c857ea01682690c18b89d79fb2e327458c0'],7,11,18,470040,3,1,1,1,1883
a08040dcb7e6e879f55bc45c9f964234a94912c3,1,Jagadish,2018-08-10 11:21:12-07:00,['8aa879aa62ddf77ad42a01bb905a2561a3744649'],469,1911,2380,472420,26,0.624113475,0.955082742,0.781323877,1886
7bb206151e250321eea9a49abd0f2b2bddb1c943,0,Jagadish,2018-08-10 14:26:42-07:00,['a08040dcb7e6e879f55bc45c9f964234a94912c3'],0,153,153,472573,5,1,1,1,1890
b706ecebe6dba21fee6b446abfb7cd002bde17bc,0,Jagadish,2018-08-10 15:55:36-07:00,['7bb206151e250321eea9a49abd0f2b2bddb1c943'],0,44,44,472617,2,0.090909091,1,1,1890
a8ddede18af49d7d1c45fbb2728d375f9ce31210,1,Prateek Maheshwari,2018-08-10 16:45:12-07:00,['b706ecebe6dba21fee6b446abfb7cd002bde17bc'],6,7,13,472630,4,,,,1890
7887d884e8a062563a7e4b8b418d817828f51f23,0,Boris S,2018-08-12 23:48:39-07:00,"['88f855954e4d98aa3bdd3a3a778eb699a13ff659', 'a8ddede18af49d7d1c45fbb2728d375f9ce31210']",531,2701,3232,475862,47,,,,1890
afb34d916b435c1c08fe80009cc7d47d8287e27f,0,Boris S,2018-08-12 23:48:54-07:00,"['7887d884e8a062563a7e4b8b418d817828f51f23', '78ad578cc022af3f9c5f9a15826a9dc010502a89']",0,0,0,475862,0,,,,1890
ce5765796c233341fbe4479db1d475964b9b2b2b,1,Prateek Maheshwari,2018-08-15 10:55:38-07:00,['a8ddede18af49d7d1c45fbb2728d375f9ce31210'],9,35,44,475906,2,0,0,1,1890
57fca52cc48a37622aa6b8b1f71a37733c378524,0,Boris S,2018-08-15 12:13:37-07:00,"['afb34d916b435c1c08fe80009cc7d47d8287e27f', 'ce5765796c233341fbe4479db1d475964b9b2b2b']",9,35,44,475950,2,,,,1890
8f7326be7df15184b3dfb6fb723becaa003d12f8,1,Prateek Maheshwari,2018-08-15 15:18:57-07:00,['ce5765796c233341fbe4479db1d475964b9b2b2b'],7,13,20,475970,1,0,0.2,1,1890
13a38f28a05e00b7f79c2ad165e8a1e2f282208f,0,Jagadish,2018-08-15 17:41:25-07:00,['8f7326be7df15184b3dfb6fb723becaa003d12f8'],3,3,6,475976,1,,,,1890
aae0f380e49950bc36a18e34d08041d554fc13a7,0,Wei Song,2018-08-16 10:50:45-07:00,"['a15a7c9a231adcc1b441351963e15a7855ea5879', '13a38f28a05e00b7f79c2ad165e8a1e2f282208f']",483,2164,2647,478623,45,,,,1890
06488bf7a7dfdfa6d26ed91f79b6c316460960b1,0,Jagadish,2018-08-17 18:41:09-07:00,['13a38f28a05e00b7f79c2ad165e8a1e2f282208f'],24,30,54,478677,4,,,,1890
0440f75fcd16061d8ff87e775d4a1e731936ece0,0,Wei Song,2018-08-20 11:42:56-07:00,"['aae0f380e49950bc36a18e34d08041d554fc13a7', '06488bf7a7dfdfa6d26ed91f79b6c316460960b1']",24,30,54,478731,4,,,,1890
a9ff09373306c423d3998617978ba5e30b155a8e,1,Prateek Maheshwari,2018-08-21 10:59:18-07:00,['06488bf7a7dfdfa6d26ed91f79b6c316460960b1'],64,83,147,478878,4,0,1,1,1890
4782c61df5eb046a57c0401ab94c1d88dc6ba0a7,0,Wei Song,2018-08-21 12:47:29-07:00,"['0440f75fcd16061d8ff87e775d4a1e731936ece0', 'a9ff09373306c423d3998617978ba5e30b155a8e']",64,83,147,479025,4,,,,1890
7f7b5594c21e9e3ebf25d243cbf078dbf6201a0f,0,Boris S,2018-08-22 11:31:26-07:00,"['57fca52cc48a37622aa6b8b1f71a37733c378524', 'a9ff09373306c423d3998617978ba5e30b155a8e']",98,129,227,479252,10,,,,1890
fc7a4dce767c94ed903b24981e0f135d4f7305a1,0,Boris S,2018-08-22 17:51:16-07:00,['a9ff09373306c423d3998617978ba5e30b155a8e'],1,1,2,479254,1,,,,1890
f28b491de20cf18357f9f92b780fb3eba52f6301,0,Wei Song,2018-08-23 15:22:40-07:00,"['4782c61df5eb046a57c0401ab94c1d88dc6ba0a7', 'fc7a4dce767c94ed903b24981e0f135d4f7305a1']",1,1,2,479256,1,,,,1890
493053dff158582d9135f17bf28396e9c65e7e32,1,Wei Song,2018-08-23 16:33:16-07:00,['fc7a4dce767c94ed903b24981e0f135d4f7305a1'],296,481,777,480033,29,0.445378151,0.537815126,1,1892
25d943f1c560d41ec593a0a76262d7aa8ef1da56,0,Srinivasulu Punuru,2018-08-23 17:04:29-07:00,['493053dff158582d9135f17bf28396e9c65e7e32'],5,14,19,480052,3,1,1,1,1892
4394b89ef71a8311fa3a955ec55e3c3e5fd2dcfd,0,Srinivasulu Punuru,2018-08-24 11:44:06-07:00,['25d943f1c560d41ec593a0a76262d7aa8ef1da56'],8,0,8,480060,1,0.285714286,0.285714286,0,1892
2d6b19953a3660f7e2aed3d59b98b1c161333a40,1,Yi Pan (Data Infrastructure),2018-08-26 18:51:12-07:00,['4394b89ef71a8311fa3a955ec55e3c3e5fd2dcfd'],81,89,170,480230,4,0.272727273,0,0,1893
df2f8d7b6ebc714a42376d98a45db20343f0a0fd,0,Wei Song,2018-08-27 09:10:59-07:00,"['f28b491de20cf18357f9f92b780fb3eba52f6301', '2d6b19953a3660f7e2aed3d59b98b1c161333a40']",390,584,974,481204,37,,,,1893
2a71baf7c05eeacdc0bf4463ca946c23da7995a0,1,Prateek Maheshwari,2018-08-27 12:06:27-07:00,['2d6b19953a3660f7e2aed3d59b98b1c161333a40'],719,3541,4260,485464,96,0.394176932,0.920492721,0.889137738,1927
46685406fb55d5488802e43c435005ffe6511194,1,Yi Pan (Data Infrastructure),2018-08-27 14:49:13-07:00,['2a71baf7c05eeacdc0bf4463ca946c23da7995a0'],5,29,34,485498,2,1,1,1,1927
9eadfa059d912503ae6384278e18e056cc9b3a8e,1,Prateek Maheshwari,2018-08-29 15:38:36-07:00,['46685406fb55d5488802e43c435005ffe6511194'],290,864,1154,486652,17,1,1,0.968253968,1934
8ab04b209eec4d035f126259305ae84318737d2e,0,Boris S,2018-08-30 11:43:21-07:00,"['7f7b5594c21e9e3ebf25d243cbf078dbf6201a0f', '9eadfa059d912503ae6384278e18e056cc9b3a8e']",1376,4990,6366,493018,145,,,,1934
28ca72965099301f1446aaaacfd029aac6346e7c,1,Yi Pan (Data Infrastructure),2018-08-31 15:57:58-07:00,['9eadfa059d912503ae6384278e18e056cc9b3a8e'],9,16,25,493043,3,1,1,1,1934
b0b2922002c3e983ca18243bd3d42b3be4e17df8,1,Srinivasulu Punuru,2018-09-04 16:27:30-07:00,['28ca72965099301f1446aaaacfd029aac6346e7c'],4,25,29,493072,3,0.875,1,1,1934
add733b85f78046badd9af36ebf533d19388151c,0,Boris S,2018-09-04 17:23:06-07:00,"['8ab04b209eec4d035f126259305ae84318737d2e', 'b0b2922002c3e983ca18243bd3d42b3be4e17df8']",13,41,54,493126,6,,,,1934
de708f5e93bcdd352137db8c570469dd6a657ee5,0,Wei Song,2018-09-05 12:17:04-07:00,"['df2f8d7b6ebc714a42376d98a45db20343f0a0fd', 'b0b2922002c3e983ca18243bd3d42b3be4e17df8']",1025,4473,5498,498624,118,,,,1934
abf49eaaa59c258255e7436ae323d999e6cba51b,1,Yi Pan (Data Infrastructure),2018-09-06 23:35:59-07:00,['b0b2922002c3e983ca18243bd3d42b3be4e17df8'],2818,4467,7285,505909,117,1,1,0.961077844,1956
728dc18143618b80df6e74a373c0024ced34544b,0,Boris S,2018-09-07 15:17:47-07:00,"['add733b85f78046badd9af36ebf533d19388151c', 'abf49eaaa59c258255e7436ae323d999e6cba51b']",2818,4467,7285,513194,117,,,,1956
ed621b269624bd285333035417dda3158b98c1f0,1,Boris S,2018-09-07 15:44:15-07:00,['abf49eaaa59c258255e7436ae323d999e6cba51b'],3,9,12,513206,1,,,,1956
6668351867a0548a944660f72f953baf74d35707,0,Jagadish,2018-09-10 09:48:35-07:00,['ed621b269624bd285333035417dda3158b98c1f0'],15,107,122,513328,2,0.347826087,1,0.695652174,1957
952dbbe20a23fc318589b62a044ac7e2cc944fc0,0,Boris S,2018-09-10 19:06:24-07:00,"['728dc18143618b80df6e74a373c0024ced34544b', '6668351867a0548a944660f72f953baf74d35707']",18,116,134,513462,3,,,,1957
2b5970d815999870d910792120dea0180ab856a6,0,xiliu,2018-09-11 09:57:59-07:00,['6668351867a0548a944660f72f953baf74d35707'],0,12,12,513474,1,0,0,1,1957
0e0a939df96cbc482c9ae3818cfd95e9d68f4e9e,1,Yi Pan (Data Infrastructure),2018-09-11 11:12:07-07:00,['2b5970d815999870d910792120dea0180ab856a6'],8,8,16,513490,5,0.5,1,0.5,1957
12b6d30302a7d330e967e6ceba35c308eafe7d43,0,Boris S,2018-09-11 11:39:07-07:00,['0e0a939df96cbc482c9ae3818cfd95e9d68f4e9e'],6,6,12,513502,3,,,,1957
5156239155e0a010242fd5f7d96de1892494e376,0,Wei Song,2018-09-11 15:27:45-07:00,"['de708f5e93bcdd352137db8c570469dd6a657ee5', '12b6d30302a7d330e967e6ceba35c308eafe7d43']",2850,4609,7459,520961,125,,,,1957
479103b25da819341d2a23995bc888a55155df69,0,Wei Song,2018-09-11 21:25:06-07:00,['12b6d30302a7d330e967e6ceba35c308eafe7d43'],18,27,45,521006,2,0.4,1,1,1957
02192052f44a27bd3cdbb3dee1eff94f416cf666,1,Jagadish,2018-09-14 10:51:55-07:00,['479103b25da819341d2a23995bc888a55155df69'],183,219,402,521408,5,1,0,0.888888889,1957
e4719b448c4ac0bbdf7c6832e5e7027dd8c49da0,1,xiliu,2018-09-17 12:16:39-07:00,['02192052f44a27bd3cdbb3dee1eff94f416cf666'],44,1274,1318,522726,19,0.480286738,0.806451613,0.842293907,1964
40f74308fec10029c149d5757d6f129bc7c2088e,0,Srinivasulu Punuru,2018-09-17 16:37:30-07:00,['e4719b448c4ac0bbdf7c6832e5e7027dd8c49da0'],1,3,4,522730,1,0,1,1,1964
eca0020411ef3997b947fb8ec7c30a400bd796df,0,Wei Song,2018-09-17 21:33:54-07:00,"['5156239155e0a010242fd5f7d96de1892494e376', '40f74308fec10029c149d5757d6f129bc7c2088e']",246,1523,1769,524499,27,,,,1964
b7219e976c74a52fffc4864548249ef7101cd584,0,Prateek Maheshwari,2018-09-19 10:08:20-07:00,['40f74308fec10029c149d5757d6f129bc7c2088e'],21,1,22,524521,5,,,,1964
19c6f4f6131ce86aa492073720f7168197a1f103,1,Prateek Maheshwari,2018-09-19 10:21:57-07:00,['b7219e976c74a52fffc4864548249ef7101cd584'],955,528,1483,526004,7,0.171052632,1,1,1967
160927adad9843cf5110b341cb0b67413f75249d,1,Prateek Maheshwari,2018-09-19 12:16:15-07:00,['19c6f4f6131ce86aa492073720f7168197a1f103'],57,340,397,526401,13,0.886792453,1,0.905660377,1970
3bb24c8eec40099dbc177df7c77f2793d7d70653,0,Prateek Maheshwari,2018-09-19 12:18:46-07:00,['160927adad9843cf5110b341cb0b67413f75249d'],210,310,520,526921,21,0.471698113,1,1,1970
1755268cff201663a41ca06e9dcc4602d41fc306,1,Prateek Maheshwari,2018-09-19 12:21:12-07:00,['3bb24c8eec40099dbc177df7c77f2793d7d70653'],584,573,1157,528078,12,0,0,1,1973
239a0950539899ea14d1bd40dd462172f477b735,0,Wei Song,2018-09-19 13:37:32-07:00,"['eca0020411ef3997b947fb8ec7c30a400bd796df', '1755268cff201663a41ca06e9dcc4602d41fc306']",1825,1750,3575,531653,56,,,,1973
c48bcd2e1d6892b236b232d8dc569d2388751a4c,0,Prateek Maheshwari,2018-09-19 16:34:40-07:00,['1755268cff201663a41ca06e9dcc4602d41fc306'],4,4,8,531661,1,,,,1973
927adff0b1d65baec79d8b1ca8b8e4cce63be032,0,Boris S,2018-09-20 09:38:51-07:00,"['952dbbe20a23fc318589b62a044ac7e2cc944fc0', 'c48bcd2e1d6892b236b232d8dc569d2388751a4c']",2085,3299,5384,537045,90,,,,1973
41299b5b03ccd6135715a55e39210d2e8cd15fe3,0,Wei Song,2018-09-20 09:41:17-07:00,"['239a0950539899ea14d1bd40dd462172f477b735', 'c48bcd2e1d6892b236b232d8dc569d2388751a4c']",4,4,8,537053,1,,,,1973
d89391231144b1700895673448a13d83b1c92a3a,1,Wei Song,2018-09-20 10:17:49-07:00,['c48bcd2e1d6892b236b232d8dc569d2388751a4c'],61,85,146,537199,14,1,1,1,1973
a6c94add7724c0f1a41873e2c2050a9088ec0850,0,Wei Song,2018-09-20 10:39:31-07:00,"['41299b5b03ccd6135715a55e39210d2e8cd15fe3', 'd89391231144b1700895673448a13d83b1c92a3a']",61,85,146,537345,14,,,,1973
db6996ed99bb6a677f588f247b373345077580b0,1,Wei Song,2018-09-20 11:19:06-07:00,['d89391231144b1700895673448a13d83b1c92a3a'],39,112,151,537496,6,0,0,1,1974
dec16392de2f5d323b6b1b3acf8de1689038f44d,1,Srinivasulu Punuru,2018-09-20 14:22:38-07:00,['db6996ed99bb6a677f588f247b373345077580b0'],285,948,1233,538729,23,0,0.928571429,0.792857143,1981
b8058af0a2e665fd295b9469f77e66e9eb04bd1a,1,Jagadish,2018-09-21 11:43:51-07:00,['dec16392de2f5d323b6b1b3acf8de1689038f44d'],225,6982,7207,545936,118,0,0.601694915,0.508474576,2082
1c6a2eae475127e79078ddd378f95f5bb5a8bd45,0,Wei Song,2018-09-21 14:44:40-07:00,"['a6c94add7724c0f1a41873e2c2050a9088ec0850', 'b8058af0a2e665fd295b9469f77e66e9eb04bd1a']",549,8042,8591,554527,147,,,,2082
ceebdc3be011d2e5e503c9fcbd9a9038feadafd2,0,Boris S,2018-09-24 17:07:30-07:00,"['927adff0b1d65baec79d8b1ca8b8e4cce63be032', 'b8058af0a2e665fd295b9469f77e66e9eb04bd1a']",610,8127,8737,563264,161,,,,2082
66dcc4cb60bb104fa6795b5a1f7dd8442fdf165c,0,Wei Song,2018-09-24 17:19:23-07:00,['b8058af0a2e665fd295b9469f77e66e9eb04bd1a'],2,51,53,563317,1,1,1,0.740740741,2082
8ee784415a329468972e894d96194a8240071ff4,0,Wei Song,2018-09-24 17:31:24-07:00,"['1c6a2eae475127e79078ddd378f95f5bb5a8bd45', '66dcc4cb60bb104fa6795b5a1f7dd8442fdf165c']",2,51,53,563370,1,,,,2082
32bd390fb4ba3d53ae82ae5681dd5c6d8871f576,0,xiliu,2018-09-25 11:20:14-07:00,['66dcc4cb60bb104fa6795b5a1f7dd8442fdf165c'],5,83,88,563458,5,0.413793103,1,0.379310345,2083
e19b4dc9a56dd6d9f18d4fa461c9349d7c29c5e2,0,Wei Song,2018-09-25 15:09:11-07:00,"['8ee784415a329468972e894d96194a8240071ff4', '32bd390fb4ba3d53ae82ae5681dd5c6d8871f576']",5,83,88,563546,5,,,,2083
078afb57f1684a352110854072b958cbe7fff41b,0,Jagadish,2018-09-25 17:08:55-07:00,['32bd390fb4ba3d53ae82ae5681dd5c6d8871f576'],130,57,187,563733,5,,,,2083
003ad1068ac7d36f462b49ded0dbb2e4dedc1089,1,Boris S,2018-09-25 18:07:44-07:00,['078afb57f1684a352110854072b958cbe7fff41b'],1391,1491,2882,566615,26,0.107438017,0.347107438,0.950413223,2088
4f0a7460d09c8819e2e3bf4fa590942a4e70615d,0,Boris S,2018-09-25 18:09:00-07:00,"['ceebdc3be011d2e5e503c9fcbd9a9038feadafd2', '003ad1068ac7d36f462b49ded0dbb2e4dedc1089']",1528,1682,3210,569825,37,,,,2088
e904e70cb4ad649fe64d6572bb98805812eb1851,1,Jagadish,2018-09-25 20:03:14-07:00,['003ad1068ac7d36f462b49ded0dbb2e4dedc1089'],134,301,435,570260,5,1,1,0.658536585,2089
b842626fd5f31f2edbc39b4c81813126fa94d994,0,Jagadish,2018-09-25 21:02:58-07:00,['e904e70cb4ad649fe64d6572bb98805812eb1851'],0,59,59,570319,2,,,,2090
cdd811d3ba874f5b370f4d3352917b2ed2f4cd23,0,Boris S,2018-09-26 10:16:01-07:00,"['4f0a7460d09c8819e2e3bf4fa590942a4e70615d', 'b842626fd5f31f2edbc39b4c81813126fa94d994']",134,360,494,570813,7,,,,2090
cfbb9c6ebabfe1e5e13af50a0487bde3f5c1e925,1,Yi Pan (Data Infrastructure),2018-09-26 11:00:51-07:00,['b842626fd5f31f2edbc39b4c81813126fa94d994'],1192,2162,3354,574167,47,0.699203187,1,0.683266932,2095
ec7d84095142895ce83d3a33120138520d07d872,0,Wei Song,2018-09-26 12:30:01-07:00,"['e19b4dc9a56dd6d9f18d4fa461c9349d7c29c5e2', 'cfbb9c6ebabfe1e5e13af50a0487bde3f5c1e925']",2630,3853,6483,580650,78,,,,2095
03410b80c674fc5001ff02db13b269df76dd0fae,0,Srinivasulu Punuru,2018-09-26 12:42:06-07:00,['cfbb9c6ebabfe1e5e13af50a0487bde3f5c1e925'],34,6,40,580690,3,0,0,0,2095
10607f0a65f1ded52788de490c1fde7ebb6d5bba,0,Prateek Maheshwari,2018-09-26 14:08:20-07:00,['03410b80c674fc5001ff02db13b269df76dd0fae'],299,316,615,581305,36,0,1,1,2096
242d8442b7d0ba458c4b94dce52cebce14d79217,0,Wei Song,2018-09-26 14:15:41-07:00,"['ec7d84095142895ce83d3a33120138520d07d872', '10607f0a65f1ded52788de490c1fde7ebb6d5bba']",333,322,655,581960,39,,,,2096
55989bfc53ab2a97b3c9cd4c607c7a1359a5e47c,1,Jagadish,2018-09-27 08:47:54-07:00,['10607f0a65f1ded52788de490c1fde7ebb6d5bba'],1,624,625,582585,5,,,,2099
66d6c5d09645bcf4dc4051deda3fed31848d0340,0,Jagadish,2018-09-27 08:50:29-07:00,['55989bfc53ab2a97b3c9cd4c607c7a1359a5e47c'],16,203,219,582804,6,,,,2103
c85604e0b1b977eda236e249baf40a718087cea7,0,Wei Song,2018-09-27 10:16:46-07:00,"['242d8442b7d0ba458c4b94dce52cebce14d79217', '66d6c5d09645bcf4dc4051deda3fed31848d0340']",17,827,844,583648,11,,,,2103
f6966a8bf8802d8d547b62c53ea280f292694c34,0,Boris S,2018-09-27 14:26:25-07:00,"['cdd811d3ba874f5b370f4d3352917b2ed2f4cd23', '66d6c5d09645bcf4dc4051deda3fed31848d0340']",1542,3311,4853,588501,95,,,,2103
7eac1b98a53deb0ecc8934ae65dd7a2091a22ae2,0,Jagadish,2018-09-28 10:44:19-07:00,['66d6c5d09645bcf4dc4051deda3fed31848d0340'],0,126,126,588627,1,,,,2104
76dc4cdd43df7694a89f4c2856b8b1d9583c87e3,0,Jagadish,2018-09-28 14:19:31-07:00,['7eac1b98a53deb0ecc8934ae65dd7a2091a22ae2'],177,228,405,589032,25,,,,2107
d88a3cd5ff48289daf46580d24f79fa3fcc6a4ce,0,Prateek Maheshwari,2018-09-28 14:21:47-07:00,['76dc4cdd43df7694a89f4c2856b8b1d9583c87e3'],11,7,18,589050,3,,,,2107
2c4b6d5c969772b8c84f1b99e73752843a0dab6c,0,Jagadish,2018-09-28 14:26:02-07:00,['d88a3cd5ff48289daf46580d24f79fa3fcc6a4ce'],28,200,228,589278,3,,,,2108
1e0c81b60e87a7b8b46c4610d88d31970d5b383a,0,Jagadish,2018-09-28 14:27:01-07:00,['2c4b6d5c969772b8c84f1b99e73752843a0dab6c'],1,218,219,589497,3,,,,2110
11471672d618485118d843aaefdea367f07a8dec,0,Jagadish,2018-09-28 14:28:50-07:00,['1e0c81b60e87a7b8b46c4610d88d31970d5b383a'],43,63,106,589603,2,,,,2110
1e5de45a84e8a55353174ac8afb86ab4d5ed44d0,0,Wei Song,2018-09-28 22:45:06-07:00,"['c85604e0b1b977eda236e249baf40a718087cea7', '11471672d618485118d843aaefdea367f07a8dec']",260,842,1102,590705,36,,,,2110
6c9715fbc85f973907807cccc26c9d7d3ed983df,0,Wei Song,2018-09-28 22:59:19-07:00,['11471672d618485118d843aaefdea367f07a8dec'],1,1202,1203,591908,7,,,,2114
450ea2eaf411672fe72f681f9c3348c94363a577,0,Boris S,2018-10-01 08:53:45-07:00,"['f6966a8bf8802d8d547b62c53ea280f292694c34', '6c9715fbc85f973907807cccc26c9d7d3ed983df']",261,2044,2305,594213,40,,,,2114
5e4ba7de130341ed2c99488f33deda8dfc98738a,0,Jagadish,2018-10-01 12:35:01-07:00,['6c9715fbc85f973907807cccc26c9d7d3ed983df'],208,923,1131,595344,35,0.907079646,0.845132743,0.92920354,2123
f5731b10b8772d318e34b0cd0687361ffa158dcd,0,Wei Song,2018-10-01 13:33:10-07:00,"['1e5de45a84e8a55353174ac8afb86ab4d5ed44d0', '5e4ba7de130341ed2c99488f33deda8dfc98738a']",207,2123,2330,597674,39,,,,2123
334d24e6831679aa4b440e99e613acac7778afe4,0,Jagadish,2018-10-01 14:14:11-07:00,['5e4ba7de130341ed2c99488f33deda8dfc98738a'],3,16,19,597693,2,0.5,0.5,1,2123
094ff1641c330e87f081d650b9066a0842f77963,1,Prateek Maheshwari,2018-10-01 15:11:54-07:00,['334d24e6831679aa4b440e99e613acac7778afe4'],67,40,107,597800,5,0.25,0,0.125,2123
042794d7c0dcd859cdd2ffa2ac95c7b515a482e4,1,Prateek Maheshwari,2018-10-01 15:45:38-07:00,['094ff1641c330e87f081d650b9066a0842f77963'],22,1080,1102,598902,21,1,1,0.830409357,2140
1bf8bf5a632cac7548223ab9d990ce6e70c1c2f0,1,Jagadish,2018-10-01 15:45:42-07:00,['334d24e6831679aa4b440e99e613acac7778afe4'],22,530,552,599454,16,,,,2152
4ae30f18d53cfa74d0b2db44ead235e45530f1b5,1,Jagadish,2018-10-01 15:51:41-07:00,['042794d7c0dcd859cdd2ffa2ac95c7b515a482e4'],22,530,552,600006,16,,,,2164
7706ab1f8f04cb3d90de23eed5d7dbb3d3b8bf3f,0,Wei Song,2018-10-02 10:05:30-07:00,"['f5731b10b8772d318e34b0cd0687361ffa158dcd', '4ae30f18d53cfa74d0b2db44ead235e45530f1b5']",114,1666,1780,601786,44,,,,2164
5f5d7a3e0531c9bf901685046a0f8fcf94596667,0,Boris S,2018-10-02 12:18:57-07:00,"['450ea2eaf411672fe72f681f9c3348c94363a577', '4ae30f18d53cfa74d0b2db44ead235e45530f1b5']",317,2584,2901,604687,76,,,,2164
c480b7ed634f8218fd7b8099bb8d83a7b3489a1a,0,Jagadish,2018-10-02 15:54:19-07:00,['1bf8bf5a632cac7548223ab9d990ce6e70c1c2f0'],3,3,6,604693,1,,,,2164
115041ac48bafff343358a6cedc540a50df67d14,0,Jagadish,2018-10-02 22:05:16-07:00,['c480b7ed634f8218fd7b8099bb8d83a7b3489a1a'],11,28,39,604732,6,,,,2167
187ff8929ca08e50df1b2d76c679a1726b9757bc,0,Jagadish,2018-10-02 22:07:06-07:00,"['115041ac48bafff343358a6cedc540a50df67d14', '4ae30f18d53cfa74d0b2db44ead235e45530f1b5']",89,1120,1209,605941,26,,,,2167
80f5f388fb2a3fb504a86323a809cffa916fe0d9,0,Jagadish,2018-10-02 22:15:10-07:00,['4ae30f18d53cfa74d0b2db44ead235e45530f1b5'],14,31,45,605986,6,,,,2170
ad578e24149f7d94465557dec852d9c36d9ee3b8,1,Jagadish,2018-10-02 22:17:15-07:00,['80f5f388fb2a3fb504a86323a809cffa916fe0d9'],5,225,230,606216,3,,,,2170
73ec4e919e744678b30bf251bc4600386820bf96,0,Jagadish,2018-10-02 22:34:42-07:00,"['187ff8929ca08e50df1b2d76c679a1726b9757bc', 'ad578e24149f7d94465557dec852d9c36d9ee3b8']",5,225,230,606446,3,,,,2170
55455921adff48e604f39b7887730f9a533ca76c,0,Jagadish,2018-10-02 22:39:08-07:00,['ad578e24149f7d94465557dec852d9c36d9ee3b8'],6,308,314,606760,7,,,,2176
8970dd2890073af40b4adad3ca6868dc40edf87d,0,Jagadish,2018-10-02 22:39:50-07:00,"['73ec4e919e744678b30bf251bc4600386820bf96', '55455921adff48e604f39b7887730f9a533ca76c']",6,308,314,607074,7,,,,2176
8ce2a9ebe4b7f28ab8cb7a9e665909fdb1f92173,0,Jagadish,2018-10-02 22:48:04-07:00,['8970dd2890073af40b4adad3ca6868dc40edf87d'],9,6,15,607089,2,,,,2176
7beb09ec0763b3030be4e3033e59e1c5a9b914a9,0,Jagadish,2018-10-02 22:49:02-07:00,['55455921adff48e604f39b7887730f9a533ca76c'],9,6,15,607104,2,,,,2176
76e4a1c633d6d3cf8a0a37d302971469cd9b3558,0,Jagadish,2018-10-02 22:52:56-07:00,['8ce2a9ebe4b7f28ab8cb7a9e665909fdb1f92173'],1,2,3,607107,1,,,,2176
3b7ff0dd7953bc98b17b6a559db2dda267e62f54,0,Jagadish,2018-10-02 22:54:50-07:00,"['76e4a1c633d6d3cf8a0a37d302971469cd9b3558', '7beb09ec0763b3030be4e3033e59e1c5a9b914a9']",0,0,0,607107,0,,,,2176
8e61a45671fec98c83c0346edccfeb27bed4b180,0,Jagadish,2018-10-02 22:56:12-07:00,['7beb09ec0763b3030be4e3033e59e1c5a9b914a9'],1,2,3,607110,1,,,,2176
02fea74bc398fef2c00d166da2530e35dedd68ee,0,Jagadish,2018-10-02 22:56:28-07:00,"['3b7ff0dd7953bc98b17b6a559db2dda267e62f54', '8e61a45671fec98c83c0346edccfeb27bed4b180']",0,0,0,607110,0,,,,2176
603bd8eac302046d9b876b716b2aea48b36df43c,0,Jagadish,2018-10-02 23:06:27-07:00,['8e61a45671fec98c83c0346edccfeb27bed4b180'],158,240,398,607508,9,,,,2178
f748050528cadb9c7126232c24c4a9d66942bf6c,0,Wei Song,2018-10-03 11:49:16-07:00,"['7706ab1f8f04cb3d90de23eed5d7dbb3d3b8bf3f', '603bd8eac302046d9b876b716b2aea48b36df43c']",183,802,985,608493,23,,,,2178
058217eaf9974309684c910781bb67c16500538a,0,Boris S,2018-10-04 10:51:51-07:00,"['5f5d7a3e0531c9bf901685046a0f8fcf94596667', '603bd8eac302046d9b876b716b2aea48b36df43c']",183,802,985,609478,23,,,,2178
6e5e1621abdbbeccdea9906081676c552b1b213b,1,Yi Pan (Data Infrastructure),2018-10-04 10:56:21-07:00,['603bd8eac302046d9b876b716b2aea48b36df43c'],47,185,232,609710,6,0.365384615,0.519230769,0.923076923,2179
05822f0a4001ab7723898ea5f4e61505ef1fe819,0,Wei Song,2018-10-04 15:52:17-07:00,"['f748050528cadb9c7126232c24c4a9d66942bf6c', '6e5e1621abdbbeccdea9906081676c552b1b213b']",47,185,232,609942,6,,,,2179
07120f40e40fc3ae2039ab8525ba4df77e4c8401,0,Jagadish,2018-10-04 18:17:14-07:00,['02fea74bc398fef2c00d166da2530e35dedd68ee'],1,2,3,609945,7,,,,2185
ba03d599e2ba83e5ceee1411e7be140b014c28ef,0,Jagadish,2018-10-04 18:19:01-07:00,['6e5e1621abdbbeccdea9906081676c552b1b213b'],1,2,3,609948,7,,,,2191
d48cf5f74b2268762d3175d8c068769b418b578e,1,Prateek Maheshwari,2018-10-05 10:56:30-07:00,['ba03d599e2ba83e5ceee1411e7be140b014c28ef'],213,77,290,610238,18,1,0,0.229508197,2191
b101ff91a8f9dae77fb64b846f150bcf8154e598,1,Prateek Maheshwari,2018-10-05 10:58:39-07:00,['d48cf5f74b2268762d3175d8c068769b418b578e'],108,144,252,610490,10,0.3,0.5,1,2191
6b318943673253e6c66676073c73517fa1bdc425,1,Jagadish,2018-10-05 11:01:45-07:00,['b101ff91a8f9dae77fb64b846f150bcf8154e598'],177,342,519,611009,5,,,,2192
4baaddbbbb665fefac821eb0aecd1608d5a6bdf4,0,Jagadish,2018-10-05 11:02:45-07:00,['6b318943673253e6c66676073c73517fa1bdc425'],3,31,34,611043,2,,,,2192
2e7a6cdba16349e6bf8b3cdbe0f5128cd0463712,0,Jagadish,2018-10-05 11:04:23-07:00,"['07120f40e40fc3ae2039ab8525ba4df77e4c8401', '6b318943673253e6c66676073c73517fa1bdc425']",703,988,1691,612734,48,,,,2192
e384e5ce0eb347c8cc29101cf5c592e63f44ff4f,0,Jagadish,2018-10-05 11:05:37-07:00,"['2e7a6cdba16349e6bf8b3cdbe0f5128cd0463712', '4baaddbbbb665fefac821eb0aecd1608d5a6bdf4']",3,31,34,612768,2,,,,2192
531b35e9f0f2a26933bb445f2b5a1301580093de,0,Jagadish,2018-10-05 14:30:42-07:00,['4baaddbbbb665fefac821eb0aecd1608d5a6bdf4'],102,27,129,612897,11,0,0.055555556,0.055555556,2192
652260a4cdc5bfb3b89f35807210835d7d5de2f5,0,Jagadish,2018-10-05 14:33:03-07:00,"['e384e5ce0eb347c8cc29101cf5c592e63f44ff4f', '531b35e9f0f2a26933bb445f2b5a1301580093de']",102,27,129,613026,11,,,,2192
097958c897fb2a1ef48e2203b1c2433fe2ecd8d0,0,Wei Song,2018-10-05 15:17:18-07:00,"['05822f0a4001ab7723898ea5f4e61505ef1fe819', '531b35e9f0f2a26933bb445f2b5a1301580093de']",604,623,1227,614253,50,,,,2192
aac73606096f39eaa6041d82617f114bad0df515,1,Wei Song,2018-10-05 15:23:37-07:00,['531b35e9f0f2a26933bb445f2b5a1301580093de'],10,33,43,614296,2,0,1,1,2192
15c6e87feecbc5bda4b123efead6f3386e44cc09,0,Jagadish,2018-10-08 11:57:04-07:00,['652260a4cdc5bfb3b89f35807210835d7d5de2f5'],1,1,2,614298,1,,,,2192
ff3717ddc0a01876aaed643e4b329d227d368c96,0,Jagadish,2018-10-08 11:58:56-07:00,['aac73606096f39eaa6041d82617f114bad0df515'],1,1,2,614300,1,,,,2192
d9431b7005e8cf7d5b40d7ce85c1a14b1f9ca34b,0,Jagadish,2018-10-08 13:45:13-07:00,"['15c6e87feecbc5bda4b123efead6f3386e44cc09', 'ff3717ddc0a01876aaed643e4b329d227d368c96']",10,33,43,614343,2,,,,2192
2f1003bc181853fadad88c91950284bf9468c8af,0,Prateek Maheshwari,2018-10-08 16:39:01-07:00,['ff3717ddc0a01876aaed643e4b329d227d368c96'],1,0,1,614344,1,1,0,0,2192
e312bb552640c4a97b0a99f05586fe6224120537,0,Prateek Maheshwari,2018-10-08 16:41:48-07:00,['2f1003bc181853fadad88c91950284bf9468c8af'],1,28,29,614373,2,1,1,1,2192
78210724f132bbf71f75111fe298b9a55dbb8d52,0,Boris S,2018-10-08 16:51:09-07:00,"['058217eaf9974309684c910781bb67c16500538a', 'e312bb552640c4a97b0a99f05586fe6224120537']",662,868,1530,615903,60,,,,2192
07199cb074db3e2773940e58887efb40d0771278,0,Prateek Maheshwari,2018-10-09 13:05:43-07:00,['e312bb552640c4a97b0a99f05586fe6224120537'],1,10,11,615914,2,0,1,0,2192
1e880ea6302418f1382af662034f7dd0144ba9ad,1,Jagadish,2018-10-09 13:51:39-07:00,['07199cb074db3e2773940e58887efb40d0771278'],80,2015,2095,618009,43,0.605388273,0.88748019,0.920760697,2212
4915baac55383f5d3bad8b9344a34fbc77e7a151,0,Jagadish,2018-10-09 18:43:14-07:00,['1e880ea6302418f1382af662034f7dd0144ba9ad'],52,1038,1090,619099,28,,,,2236
74dd1380411338279c6a7b824fee7536275ef481,0,Boris S,2018-10-10 10:42:04-07:00,"['78210724f132bbf71f75111fe298b9a55dbb8d52', '4915baac55383f5d3bad8b9344a34fbc77e7a151']",133,3063,3196,622295,73,,,,2236
d2c9e81626539016756c3a93876c9f079b77e0f4,0,xiliu,2018-10-10 14:48:14-07:00,['4915baac55383f5d3bad8b9344a34fbc77e7a151'],371,663,1034,623329,7,0.672955975,0.79245283,1,2236
9d2d49e9e987699f053a46eb12a64cfe8cc42907,1,Prateek Maheshwari,2018-10-10 15:34:19-07:00,['d2c9e81626539016756c3a93876c9f079b77e0f4'],1592,1598,3190,626519,138,1,0.709677419,1,2238
aaef1ab1745a85fcc2fc80a3b53b396798f8f3f8,0,Prateek Maheshwari,2018-10-10 17:17:30-07:00,['9d2d49e9e987699f053a46eb12a64cfe8cc42907'],1,18,19,626538,2,,,,2238
623661e020ef1d53f0334037f1efef15c0499e35,0,Jagadish,2018-10-10 18:40:03-07:00,['aaef1ab1745a85fcc2fc80a3b53b396798f8f3f8'],4,261,265,626803,4,,,,2239
44329cf4842252edf0f0a9c4c2e57f6a61696f7b,0,Jagadish,2018-10-10 18:42:16-07:00,"['d9431b7005e8cf7d5b40d7ce85c1a14b1f9ca34b', '623661e020ef1d53f0334037f1efef15c0499e35']",2087,5615,7702,634505,221,,,,2239
a56c28dc09ada7c0783aa0c0b601c36bd63d989f,0,Wei Song,2018-10-11 10:06:44-07:00,"['097958c897fb2a1ef48e2203b1c2433fe2ecd8d0', '623661e020ef1d53f0334037f1efef15c0499e35']",2098,5649,7747,642252,223,,,,2239
482c6a22719b0eec9f49a34146dc291b23bcc3f8,1,Boris S,2018-10-11 11:46:32-07:00,['623661e020ef1d53f0334037f1efef15c0499e35'],2,5,7,642259,1,0,1,1,2239
92180fd9176895210989808b4c1d0f289a072d89,0,Boris S,2018-10-11 11:47:10-07:00,"['74dd1380411338279c6a7b824fee7536275ef481', '482c6a22719b0eec9f49a34146dc291b23bcc3f8']",1970,2545,4515,646774,152,,,,2239
da88096a0235aa8d099fe53191c8007bb1b5eace,1,Prateek Maheshwari,2018-10-11 11:49:00-07:00,['482c6a22719b0eec9f49a34146dc291b23bcc3f8'],98,817,915,647689,15,0.672597865,1,0.893238434,2245
3c78e06ac0913dd35866a9e82d8cd7d9d2cc758a,0,Prateek Maheshwari,2018-10-11 11:56:05-07:00,['da88096a0235aa8d099fe53191c8007bb1b5eace'],12,20,32,647721,7,1,1,1,2245
531b668ea52a701559dbc2b3515031d02cc22407,0,Jagadish,2018-10-11 12:32:27-07:00,"['44329cf4842252edf0f0a9c4c2e57f6a61696f7b', '3c78e06ac0913dd35866a9e82d8cd7d9d2cc758a']",112,842,954,648675,23,,,,2245
63d33fa0617488d25a0d3fb061423271392d20f6,1,Boris S,2018-10-11 14:26:51-07:00,['3c78e06ac0913dd35866a9e82d8cd7d9d2cc758a'],882,1630,2512,651187,19,0.412177986,0.868852459,0.878220141,2249
1eb4c266339693edf6f13a0da036cc7ca6ff3fc3,0,Wei Song,2018-10-11 14:53:54-07:00,['63d33fa0617488d25a0d3fb061423271392d20f6'],35,33,68,651255,4,0,0,0,2249
2c679c3915c96a703c6f528d504ea99063e82401,0,Wei Song,2018-10-11 14:58:19-07:00,"['a56c28dc09ada7c0783aa0c0b601c36bd63d989f', '1eb4c266339693edf6f13a0da036cc7ca6ff3fc3']",1029,2505,3534,654789,46,,,,2249
ace5c653ecd37d5cdd1c0206c21dd119cf733a19,0,Jagadish,2018-10-11 15:04:22-07:00,"['531b668ea52a701559dbc2b3515031d02cc22407', '1eb4c266339693edf6f13a0da036cc7ca6ff3fc3']",917,1663,2580,657369,23,,,,2249
cc490ea89d571809501785834f81ffdcb7b508e7,0,Wei Song,2018-10-11 15:28:30-07:00,['1eb4c266339693edf6f13a0da036cc7ca6ff3fc3'],12,124,136,657505,5,,,,2249
5c5afb82ab12c72a4b114b0858f77779285b86cf,1,Prateek Maheshwari,2018-10-11 16:13:45-07:00,['cc490ea89d571809501785834f81ffdcb7b508e7'],27,198,225,657730,7,0.336633663,1,0.900990099,2249
cad265fa263e31c4d5f477d77084015268954b2f,0,Jagadish,2018-10-11 16:18:52-07:00,['ace5c653ecd37d5cdd1c0206c21dd119cf733a19'],2,128,130,657860,7,,,,2254
992b217d26278731ae386dca24d19a56c27a7cbe,0,Jagadish,2018-10-11 16:19:57-07:00,['5c5afb82ab12c72a4b114b0858f77779285b86cf'],2,128,130,657990,7,,,,2259
85050645cf0673d3f4e89a5461b1f565d2ccf846,0,Jagadish,2018-10-11 16:20:21-07:00,"['cad265fa263e31c4d5f477d77084015268954b2f', '992b217d26278731ae386dca24d19a56c27a7cbe']",39,322,361,658351,12,,,,2259
341c06b47bc4333817d5e53214f8731aeb7e8004,0,Jagadish,2018-10-11 16:21:24-07:00,['85050645cf0673d3f4e89a5461b1f565d2ccf846'],0,0,0,658351,2,,,,2261
efb2180cfe998dcd446efd311c6f275ee699ee1b,0,Jagadish,2018-10-11 16:23:07-07:00,['992b217d26278731ae386dca24d19a56c27a7cbe'],0,0,0,658351,2,,,,2263
9903539a22c49f247cb17022688e80cdd515949e,0,Jagadish,2018-10-11 16:26:24-07:00,['efb2180cfe998dcd446efd311c6f275ee699ee1b'],18,156,174,658525,1,,,,2263
3c8869920be301dd8afeb2cfe287dc58c85a8a4d,0,Jagadish,2018-10-11 16:33:44-07:00,"['341c06b47bc4333817d5e53214f8731aeb7e8004', '9903539a22c49f247cb17022688e80cdd515949e']",18,156,174,658699,1,,,,2263
378fd8a7656e0f487e65a37e455f8c4f709aac8d,1,Prateek Maheshwari,2018-10-11 16:35:08-07:00,['9903539a22c49f247cb17022688e80cdd515949e'],41,39,80,658779,9,1,0,0,2263
2110c5f5d439fa1dc93131f2c0ec92f6a2eabea3,0,Jagadish,2018-10-11 16:49:40-07:00,['3c8869920be301dd8afeb2cfe287dc58c85a8a4d'],29,1,30,658809,2,,,,2263
8926b3e73580814a8207125755073b65d5ddb78e,0,Jagadish,2018-10-11 16:50:47-07:00,['378fd8a7656e0f487e65a37e455f8c4f709aac8d'],29,1,30,658839,2,,,,2263
c35e6c7c9a625a1974e862aa36b3de32f0f0d6e4,0,Jagadish,2018-10-11 19:10:03-07:00,['2110c5f5d439fa1dc93131f2c0ec92f6a2eabea3'],3,418,421,659260,22,,,,2279
c4cbebebc6f3952514eca48cf3fe29640ddba4cf,0,Jagadish,2018-10-11 19:12:41-07:00,"['c35e6c7c9a625a1974e862aa36b3de32f0f0d6e4', '8926b3e73580814a8207125755073b65d5ddb78e']",45,42,87,659347,10,,,,2279
a8d06cc4cc988b9160a9a5d2c2afa52f2145770b,0,Jagadish,2018-10-11 19:16:18-07:00,['c4cbebebc6f3952514eca48cf3fe29640ddba4cf'],2,2,4,659351,1,,,,2279
9cd7cdda97b6b5e75998cab77e93d05ca04770df,0,Jagadish,2018-10-11 19:18:57-07:00,['a8d06cc4cc988b9160a9a5d2c2afa52f2145770b'],56,11,67,659418,13,,,,2279
a05fee910e5878819852bd3f51129849caf87dd6,0,Jagadish,2018-10-11 19:20:16-07:00,['9cd7cdda97b6b5e75998cab77e93d05ca04770df'],9,3,12,659430,3,,,,2279
6dd012217d353b935f727b0382978821a938a216,0,Jagadish,2018-10-11 19:22:17-07:00,['8926b3e73580814a8207125755073b65d5ddb78e'],1,364,365,659795,20,,,,2295
da808fc3b55f7f7feb668e7550434ae66c8fb5d0,0,Jagadish,2018-10-11 19:22:30-07:00,"['a05fee910e5878819852bd3f51129849caf87dd6', '6dd012217d353b935f727b0382978821a938a216']",0,0,0,659795,0,,,,2295
f7ebe5918cb8a040a6b22007ebb1310c72694e89,0,Jagadish,2018-10-11 19:47:22-07:00,['da808fc3b55f7f7feb668e7550434ae66c8fb5d0'],1,1,2,659797,1,,,,2295
4c40e431dfb7ecfafb5eb9ce80e4e0dd96c4c2e5,0,Jagadish,2018-10-11 22:36:58-07:00,['f7ebe5918cb8a040a6b22007ebb1310c72694e89'],7,19,26,659823,19,,,,2295
a4d74d424646d0b3c13306c4c28379eda49af09c,0,Jagadish,2018-10-11 22:38:46-07:00,['f7ebe5918cb8a040a6b22007ebb1310c72694e89'],7,19,26,659849,19,,,,2295
3adc82ee2a52461508e2b1f213c4ae09dbe96f94,0,Jagadish,2018-10-11 23:23:06-07:00,['4c40e431dfb7ecfafb5eb9ce80e4e0dd96c4c2e5'],10,10,20,659869,10,,,,2295
074d70e2c4ee87598cbfa1cdd1b4a5906b8d6ed2,0,Jagadish,2018-10-11 23:24:27-07:00,['a4d74d424646d0b3c13306c4c28379eda49af09c'],10,10,20,659889,10,,,,2295
29f607fba652240a8761a6962e7e7fcdd1533e59,0,Jagadish,2018-10-12 00:07:47-07:00,['3adc82ee2a52461508e2b1f213c4ae09dbe96f94'],13,16,29,659918,15,,,,2295
6793faccd56463779deea536d211c80f6d026a27,0,Jagadish,2018-10-12 00:08:36-07:00,"['29f607fba652240a8761a6962e7e7fcdd1533e59', '074d70e2c4ee87598cbfa1cdd1b4a5906b8d6ed2']",0,0,0,659918,0,,,,2295
59cee32c792ab2bc7281f7abdc968565c006226e,0,Jagadish,2018-10-12 00:11:10-07:00,['074d70e2c4ee87598cbfa1cdd1b4a5906b8d6ed2'],13,16,29,659947,15,,,,2295
178d9a74674581cb45b6b1887af206ca9f651aac,0,Jagadish,2018-10-12 00:23:03-07:00,['6793faccd56463779deea536d211c80f6d026a27'],0,23,23,659970,1,,,,2296
4a5c50d0c0935971386b20aaf8a84747873a516d,0,Jagadish,2018-10-12 00:23:12-07:00,"['178d9a74674581cb45b6b1887af206ca9f651aac', '59cee32c792ab2bc7281f7abdc968565c006226e']",0,0,0,659970,0,,,,2296
8e9b2b9c3ac6c9d0d0eae4c8a7477428b37ffcdb,0,Jagadish,2018-10-12 00:24:46-07:00,['4a5c50d0c0935971386b20aaf8a84747873a516d'],1,1,2,659972,1,,,,2296
17113e163adee9b6ab2d9cb95d2277239f6bc370,0,Jagadish,2018-10-12 00:25:40-07:00,['59cee32c792ab2bc7281f7abdc968565c006226e'],0,23,23,659995,1,,,,2297
954fb25e72b392f4ec4baeeba0d7f8e638ca0d06,0,Prateek Maheshwari,2018-10-12 12:17:48-07:00,['17113e163adee9b6ab2d9cb95d2277239f6bc370'],2,2,4,659999,2,,,,2297
e5ea9bef1d0f363b8c919565ee1919cd0ac248fe,1,Srinivasulu Punuru,2018-10-12 13:13:12-07:00,['954fb25e72b392f4ec4baeeba0d7f8e638ca0d06'],14,101,115,660114,4,0.25,0.961538462,0.461538462,2297
712e68a7d62967322786e238723ea547a7128edc,0,Boris S,2018-10-12 14:00:19-07:00,"['92180fd9176895210989808b4c1d0f289a072d89', 'e5ea9bef1d0f363b8c919565ee1919cd0ac248fe']",1167,3645,4812,664926,117,,,,2297
cd5cbdde118428d4576324bd968182b72af27f8f,0,Jagadish,2018-10-12 17:33:37-07:00,['8e9b2b9c3ac6c9d0d0eae4c8a7477428b37ffcdb'],22,35,57,664983,1,,,,2297
804dd876d2ab25a0d84ff543dbe0f5f5300ff512,0,Jagadish,2018-10-12 17:34:37-07:00,"['cd5cbdde118428d4576324bd968182b72af27f8f', 'e5ea9bef1d0f363b8c919565ee1919cd0ac248fe']",16,103,119,665102,6,,,,2297
eda04c8bc6c4d0cfbc5377a8992e444cc10ed580,0,Jagadish,2018-10-12 17:58:13-07:00,['804dd876d2ab25a0d84ff543dbe0f5f5300ff512'],0,0,0,665102,1,,,,2298
0b0a0cabf3a6edfe4cf9c9de26c2d5185b677d0f,0,Jagadish,2018-10-12 17:58:39-07:00,['e5ea9bef1d0f363b8c919565ee1919cd0ac248fe'],22,35,57,665159,2,,,,2299
2780d37f600435eaab7b35cebf4b673c43a523b9,0,Jagadish,2018-10-12 18:01:34-07:00,"['eda04c8bc6c4d0cfbc5377a8992e444cc10ed580', '0b0a0cabf3a6edfe4cf9c9de26c2d5185b677d0f']",0,0,0,665159,0,,,,2299
9a5094d68e828c18467620830368314818c4ccfb,0,Prateek Maheshwari,2018-10-12 18:18:56-07:00,['0b0a0cabf3a6edfe4cf9c9de26c2d5185b677d0f'],2,2,4,665163,1,,,,2299
74675cea55d163bf18bf16c8619355009af2300c,1,Prateek Maheshwari,2018-10-12 18:34:34-07:00,['9a5094d68e828c18467620830368314818c4ccfb'],557,629,1186,666349,182,1,1,1,2299
ef359972161e6c12f9b4eb16d9c1a34446daa1cb,0,Prateek Maheshwari,2018-10-12 19:22:54-07:00,['74675cea55d163bf18bf16c8619355009af2300c'],551,441,992,667341,12,1,0.909090909,0,2299
988260a2062630856e7b49a137bfa45db9e5b4b1,0,Prateek Maheshwari,2018-10-13 12:38:39-07:00,['ef359972161e6c12f9b4eb16d9c1a34446daa1cb'],12,12,24,667365,4,,,,2299
4e53e3e2917b3272673f69816fc420ebd9cd6b32,0,Jagadish,2018-10-14 10:49:22-07:00,"['2780d37f600435eaab7b35cebf4b673c43a523b9', '988260a2062630856e7b49a137bfa45db9e5b4b1']",1169,1131,2300,669665,185,,,,2299
b2619acec179039a50752a9eb5393728f1bb3544,0,Jagadish,2018-10-15 14:59:18-07:00,['4e53e3e2917b3272673f69816fc420ebd9cd6b32'],83,85,168,669833,8,,,,2299
a7735972e23e5fd48323f5e8145dc32a8edd41e6,0,Jagadish,2018-10-15 15:18:15-07:00,['b2619acec179039a50752a9eb5393728f1bb3544'],2,2,4,669837,1,,,,2299
a468ea1aa8cbb833bf305f08b72ee054c44a8240,0,Jagadish,2018-10-15 15:19:01-07:00,['a7735972e23e5fd48323f5e8145dc32a8edd41e6'],1,1,2,669839,1,,,,2299
b00035b0ab5ca541600ba993108010dbb52a12bb,0,Jagadish,2018-10-15 16:11:56-07:00,['a468ea1aa8cbb833bf305f08b72ee054c44a8240'],2,6,8,669847,1,,,,2299
3dc92511636cfbde50e29bd646d57f27b3c8ffa0,0,Jagadish,2018-10-15 16:14:07-07:00,['b00035b0ab5ca541600ba993108010dbb52a12bb'],6,2,8,669855,1,,,,2299
7942dbe4ac3b619040b543c79e6d2086c6bace36,0,Jagadish,2018-10-15 16:30:30-07:00,['3dc92511636cfbde50e29bd646d57f27b3c8ffa0'],10,10,20,669875,1,,,,2299
f569a5ce67b61955aba03a6c1f0973d9866e84d9,0,Jagadish,2018-10-15 16:32:56-07:00,['7942dbe4ac3b619040b543c79e6d2086c6bace36'],3,3,6,669881,1,,,,2299
7d3eb08b3e0ed025e15a7f70c50ff84e803e39d7,1,Jagadish,2018-10-15 16:46:33-07:00,['988260a2062630856e7b49a137bfa45db9e5b4b1'],88,90,178,670059,8,,,,2299
9e6697b57bb5d431662cb4575a5d243656be67c0,0,Jagadish,2018-10-15 16:48:07-07:00,"['f569a5ce67b61955aba03a6c1f0973d9866e84d9', '7d3eb08b3e0ed025e15a7f70c50ff84e803e39d7']",0,0,0,670059,0,,,,2299
470a4156187c64eb2852811462aeefcda50d4abc,0,Jagadish,2018-10-15 16:48:44-07:00,['7d3eb08b3e0ed025e15a7f70c50ff84e803e39d7'],36,205,241,670300,4,,,,2302
75a53dbe8dd737f190ae1f420332a96aef32baab,0,Jagadish,2018-10-15 16:49:02-07:00,"['9e6697b57bb5d431662cb4575a5d243656be67c0', '470a4156187c64eb2852811462aeefcda50d4abc']",36,205,241,670541,4,,,,2302
62857f6013b2b6a7a8aa41b1bbc2cecfdc3b7bd9,0,Jagadish,2018-10-15 16:54:36-07:00,['470a4156187c64eb2852811462aeefcda50d4abc'],17,11,28,670569,5,,,,2302
080f5e0da94a18569901c28919a2e7a81ba1e718,0,Jagadish,2018-10-15 16:55:07-07:00,"['75a53dbe8dd737f190ae1f420332a96aef32baab', '62857f6013b2b6a7a8aa41b1bbc2cecfdc3b7bd9']",17,11,28,670597,5,,,,2302
96658ee7e1445340ef1799ca93eb6bd335c33690,0,Prateek Maheshwari,2018-10-15 18:36:00-07:00,['62857f6013b2b6a7a8aa41b1bbc2cecfdc3b7bd9'],1,2,3,670600,1,0,1,1,2302
989f8f6ad1e983a81cce8178196306a3ac72fb02,1,Prateek Maheshwari,2018-10-15 18:55:28-07:00,['96658ee7e1445340ef1799ca93eb6bd335c33690'],215,123,338,670938,23,0.3,0,0.56,2302
a06e8ec2088fe0a2737624957077d6260b73e1c6,0,Wei Song,2018-10-16 15:17:02-07:00,"['2c679c3915c96a703c6f528d504ea99063e82401', '989f8f6ad1e983a81cce8178196306a3ac72fb02']",1653,2707,4360,675298,248,,,,2302
947c2f0effd6a05d2fcf01bf85c65320aaa1f47b,1,Srinivasulu Punuru,2018-10-16 16:56:16-07:00,['989f8f6ad1e983a81cce8178196306a3ac72fb02'],149,247,396,675694,13,0,1,0,2302
4d6ff989bcd284c2231ffcbba1bf9e1f5dbe7d7f,0,Wei Song,2018-10-16 18:00:51-07:00,['947c2f0effd6a05d2fcf01bf85c65320aaa1f47b'],15,38,53,675747,3,0,1,1,2302
8b85266829e65ef46ab15d6356e3fa87cd00684f,0,Prateek Maheshwari,2018-10-16 18:56:44-07:00,['4d6ff989bcd284c2231ffcbba1bf9e1f5dbe7d7f'],50,73,123,675870,6,1,1,1,2302
058776d65e79a3d4973f748dc5f57ac7ad36d72e,0,Jagadish,2018-10-17 09:40:39-07:00,['8b85266829e65ef46ab15d6356e3fa87cd00684f'],32,30,62,675932,3,,,,2302
6d20ee7e4c4c6797fee3002102309b2ab2bec46e,0,Jagadish,2018-10-17 12:02:40-07:00,['058776d65e79a3d4973f748dc5f57ac7ad36d72e'],18,42,60,675992,6,0.375,0.375,1,2302
d56feeebb80ec56c6376b778066a8833de1f86ae,0,Boris S,2018-10-17 16:04:35-07:00,"['712e68a7d62967322786e238723ea547a7128edc', '6d20ee7e4c4c6797fee3002102309b2ab2bec46e']",1815,2030,3845,679837,219,,,,2302
a8a8dc78d6aa375ab2220f8fcf3998d3f012d27d,1,Boris S,2018-10-17 16:38:19-07:00,['6d20ee7e4c4c6797fee3002102309b2ab2bec46e'],339,60,399,680236,5,0,0.84375,0.578125,2302
7c777feca9a92244cdcc2e47e0b6367c962e6054,0,Wei Song,2018-10-17 17:56:31-07:00,"['a06e8ec2088fe0a2737624957077d6260b73e1c6', 'a8a8dc78d6aa375ab2220f8fcf3998d3f012d27d']",603,490,1093,681329,35,,,,2302
89649556f8169f0834afe753111d8c85bd5899a9,0,Boris S,2018-10-17 19:15:47-07:00,"['d56feeebb80ec56c6376b778066a8833de1f86ae', 'a8a8dc78d6aa375ab2220f8fcf3998d3f012d27d']",339,60,399,681728,5,,,,2302
88a4a7ccacdabf38edf1fb7ad3e57c5dd0571f0f,0,Jagadish,2018-10-17 19:20:51-07:00,"['080f5e0da94a18569901c28919a2e7a81ba1e718', 'a8a8dc78d6aa375ab2220f8fcf3998d3f012d27d']",819,615,1434,683162,55,,,,2302
5f1e75247db7decf933b508d77ce76abdbabbdf4,1,Jagadish,2018-10-17 23:58:16-07:00,['a8a8dc78d6aa375ab2220f8fcf3998d3f012d27d'],395,518,913,684075,59,,,,2302
44d0685dfbd979b11209903fadaee2468b001092,1,Prateek Maheshwari,2018-10-18 09:56:01-07:00,['5f1e75247db7decf933b508d77ce76abdbabbdf4'],0,2128,2128,686203,12,0.35115304,0.862683438,0.849056604,2314
0c2076cf8504362ce8816728e3384c516ed6cfbb,0,Prateek Maheshwari,2018-10-18 10:44:41-07:00,['44d0685dfbd979b11209903fadaee2468b001092'],2,12,14,686217,1,,,,2314
c9e8bf7c6aa8f84d866d14d6fcf16ff91520a8a8,0,Wei Song,2018-10-18 13:46:06-07:00,"['7c777feca9a92244cdcc2e47e0b6367c962e6054', '0c2076cf8504362ce8816728e3384c516ed6cfbb']",397,2658,3055,689272,72,,,,2314
de91463e2380a466d8477975475d81e5e35a2d34,0,Prateek Maheshwari,2018-10-18 15:21:16-07:00,['0c2076cf8504362ce8816728e3384c516ed6cfbb'],274,5,279,689551,4,0.584415584,0,0,2314
c79cc18084e68da15a51504d27d056136f34206a,0,Prateek Maheshwari,2018-10-18 16:16:29-07:00,['de91463e2380a466d8477975475d81e5e35a2d34'],44,56,100,689651,12,1,1,1,2314
469050240aed010e774b4cd731682ebb457274c8,0,Prateek Maheshwari,2018-10-18 17:13:41-07:00,['c79cc18084e68da15a51504d27d056136f34206a'],6,12,18,689669,1,0,1,1,2314
b729f294186a5a04d4140b97311450ae340d2db3,0,Jagadish,2018-10-18 18:03:59-07:00,['88a4a7ccacdabf38edf1fb7ad3e57c5dd0571f0f'],90,2,92,689761,4,0,0.071428571,0.078817734,2314
ba0b262b8b0de09ef9ca8eaaf25154213ba23b2f,0,Jagadish,2018-10-18 18:09:19-07:00,['469050240aed010e774b4cd731682ebb457274c8'],90,2,92,689853,4,0,0.071428571,0.078817734,2314
19ededccf562bc100be7fedd4fbc6a30c13e9cbe,0,Jagadish,2018-10-18 18:34:32-07:00,"['b729f294186a5a04d4140b97311450ae340d2db3', 'ba0b262b8b0de09ef9ca8eaaf25154213ba23b2f']",701,2711,3412,693265,82,,,,2314
e91223d1df61f5158027733030ac15cc2d844465,0,Jagadish,2018-10-18 18:35:46-07:00,['19ededccf562bc100be7fedd4fbc6a30c13e9cbe'],1,1,2,693267,1,,,,2314
8242fab0f60efd015e2a4095692f3454f6d8bfe6,0,Jagadish,2018-10-18 18:36:54-07:00,['ba0b262b8b0de09ef9ca8eaaf25154213ba23b2f'],1,1,2,693269,1,,,,2314
a53e56281e97c8db81b07453f5c1d0177703019f,0,Wei Song,2018-10-19 11:57:20-07:00,['c9e8bf7c6aa8f84d866d14d6fcf16ff91520a8a8'],11,18,29,693298,4,0.875,0.875,0.875,2314
89bfc14c59da538c6a04d9002d30e69ba8631e92,0,Wei Song,2018-10-19 11:57:42-07:00,"['a53e56281e97c8db81b07453f5c1d0177703019f', '8242fab0f60efd015e2a4095692f3454f6d8bfe6']",415,76,491,693789,22,,,,2314
520da15e682d55499224dc2be5b7964e7780eebf,0,xiliu,2018-10-19 12:32:26-07:00,['8242fab0f60efd015e2a4095692f3454f6d8bfe6'],11,18,29,693818,4,0.875,0.875,0.875,2314
3523122afe3f38c16f58d59446d26ae73f4ac247,0,Prateek Maheshwari,2018-10-19 12:48:13-07:00,['520da15e682d55499224dc2be5b7964e7780eebf'],12,38,50,693868,17,,,,2314
5ba543faf1ce68d1398ebc4ce2da72f70149e576,0,Prateek Maheshwari,2018-10-19 12:49:24-07:00,['3523122afe3f38c16f58d59446d26ae73f4ac247'],213,244,457,694325,7,,,,2315
880d2f0c2dfe1d1005a32e56ecb0b0e76fb80881,0,Jagadish,2018-10-19 14:13:04-07:00,['5ba543faf1ce68d1398ebc4ce2da72f70149e576'],181,841,1022,695347,4,,,,2316
d36d6b6c29e598b968c10b3311ed5a4b8cf23b98,0,Jagadish,2018-10-19 14:13:19-07:00,"['e91223d1df61f5158027733030ac15cc2d844465', '5ba543faf1ce68d1398ebc4ce2da72f70149e576']",236,300,536,695883,28,,,,2316
9412f3ba2c7026e3b49683d65b9f80c46bf919ae,0,Jagadish,2018-10-19 14:13:43-07:00,"['d36d6b6c29e598b968c10b3311ed5a4b8cf23b98', '880d2f0c2dfe1d1005a32e56ecb0b0e76fb80881']",181,841,1022,696905,4,,,,2316
28da01c68e3551ff9ea43b7a1642ca6eb490e9b6,0,Jagadish,2018-10-21 10:47:37-07:00,['9412f3ba2c7026e3b49683d65b9f80c46bf919ae'],18,20,38,696943,5,,,,2316
ce52acf0736349e4ebac66a804471d9a16bdbf9d,0,Jagadish,2018-10-21 10:50:31-07:00,['28da01c68e3551ff9ea43b7a1642ca6eb490e9b6'],5,4,9,696952,2,,,,2316
40aa6a54cba7d12b5292895e8a08c305c9625f7b,0,Jagadish,2018-10-21 10:52:56-07:00,['880d2f0c2dfe1d1005a32e56ecb0b0e76fb80881'],18,19,37,696989,5,,,,2316
937d1de845e838da8ea7b222ad745a1a2fe65a29,0,Jagadish,2018-10-21 11:48:09-07:00,['ce52acf0736349e4ebac66a804471d9a16bdbf9d'],4,5,9,696998,3,,,,2316
50fa974714370f3ae024d38e966ddcbc908a526c,0,Jagadish,2018-10-21 11:49:01-07:00,"['937d1de845e838da8ea7b222ad745a1a2fe65a29', '40aa6a54cba7d12b5292895e8a08c305c9625f7b']",0,0,0,696998,0,,,,2316
fd6f1ed2539c5b055d97e078ccc9b5e9e498d4a5,0,Jagadish,2018-10-21 12:22:16-07:00,['40aa6a54cba7d12b5292895e8a08c305c9625f7b'],4,5,9,697007,3,,,,2316
e203db2aa29614c15ff0ee1593bf41c79b3b5c42,1,Srinivasulu Punuru,2018-10-22 09:51:40-07:00,['fd6f1ed2539c5b055d97e078ccc9b5e9e498d4a5'],5,3764,3769,700776,38,0.392877017,0.626599889,0.942125765,2349
0176138a1680ac77c2894e0bd09bb046ba96a7df,0,Jagadish,2018-10-22 16:29:34-07:00,['e203db2aa29614c15ff0ee1593bf41c79b3b5c42'],1,2,3,700779,1,,,,2349
590eb14b707eccd28bfbe64c8768ea353dc214ac,0,Jagadish,2018-10-22 16:30:01-07:00,"['50fa974714370f3ae024d38e966ddcbc908a526c', 'e203db2aa29614c15ff0ee1593bf41c79b3b5c42']",5,3764,3769,704548,38,,,,2349
00cd44ac9101bd89933b05964ef5168bce4ff334,0,Prateek Maheshwari,2018-10-22 17:55:06-07:00,['0176138a1680ac77c2894e0bd09bb046ba96a7df'],237,32,269,704817,15,,,,2349
15f62c4f19a0d847ec887b65d1e55ae8318dbd6b,0,Boris S,2018-10-22 17:59:49-07:00,"['89649556f8169f0834afe753111d8c85bd5899a9', '00cd44ac9101bd89933b05964ef5168bce4ff334']",1474,7677,9151,713968,176,,,,2349
738410392036746fc51b7360a97d4b1f29ea48dc,1,Prateek Maheshwari,2018-10-22 19:04:58-07:00,['00cd44ac9101bd89933b05964ef5168bce4ff334'],8,7,15,713983,3,,,,2349
473b6c3af511302b572bc6d455f6261c4c6914ae,0,Jagadish,2018-10-22 19:27:24-07:00,"['590eb14b707eccd28bfbe64c8768ea353dc214ac', '738410392036746fc51b7360a97d4b1f29ea48dc']",246,41,287,714270,19,,,,2349
b027b438479153e1ed73ad3b1ecf9de148af8d2b,0,Jagadish,2018-10-22 22:09:20-07:00,['473b6c3af511302b572bc6d455f6261c4c6914ae'],1,1,2,714272,1,,,,2349
91e54568b5be9f4dbc93245e0d7e40b99aae4aaa,0,Prateek Maheshwari,2018-10-23 08:43:37-07:00,['738410392036746fc51b7360a97d4b1f29ea48dc'],2,2,4,714276,1,,,,2349
18b94013428a8efb7642b3fa4dfee2b2f317e913,0,Prateek Maheshwari,2018-10-23 10:31:20-07:00,['91e54568b5be9f4dbc93245e0d7e40b99aae4aaa'],7,3,10,714286,3,,,,2349
7d60510ff56abf285f8df858cf2331108744ff24,0,Boris S,2018-10-23 13:58:02-07:00,"['15f62c4f19a0d847ec887b65d1e55ae8318dbd6b', '18b94013428a8efb7642b3fa4dfee2b2f317e913']",13,8,21,714307,6,,,,2349
282f834943bf3504d17406d93ecd8d92a3b96ced,1,Boris S,2018-10-23 18:11:43-07:00,['18b94013428a8efb7642b3fa4dfee2b2f317e913'],0,1927,1927,716234,7,0.501128668,0.952595937,0.966139955,2356
04a12767b9e7b5246bce51b3f00594e9fd5d7a7d,0,Jagadish,2018-10-23 23:10:51-07:00,"['b027b438479153e1ed73ad3b1ecf9de148af8d2b', '282f834943bf3504d17406d93ecd8d92a3b96ced']",9,1932,1941,718175,11,,,,2356
cd34d98bf638d84ec652f006844e05d343278d7a,0,Jagadish,2018-10-23 23:16:13-07:00,['04a12767b9e7b5246bce51b3f00594e9fd5d7a7d'],12,70,82,718257,4,,,,2357
2615ad5642b3cbcf9de1f79523c531c4204e6b09,0,Jagadish,2018-10-23 23:18:01-07:00,['cd34d98bf638d84ec652f006844e05d343278d7a'],70,12,82,718339,4,,,,2357
14e6220512e6922b89980bdbb6440c09fac380cb,0,Jagadish,2018-10-23 23:18:14-07:00,['2615ad5642b3cbcf9de1f79523c531c4204e6b09'],27,88,115,718454,4,,,,2358
d8336be5c5eaf17f4a0454a02053a133c3e1ebfc,0,Jagadish,2018-10-23 23:34:13-07:00,['14e6220512e6922b89980bdbb6440c09fac380cb'],28,10,38,718492,1,,,,2358
456e697d8034099f032361268f3768b085395696,0,Jagadish,2018-10-23 23:38:13-07:00,['d8336be5c5eaf17f4a0454a02053a133c3e1ebfc'],1,1,2,718494,1,,,,2358
59bc23cf954bf86683c499729930f126af5ebf2b,0,Jagadish,2018-10-23 23:39:54-07:00,['282f834943bf3504d17406d93ecd8d92a3b96ced'],48,91,139,718633,4,,,,2359
70c6f2b15b1528f3bed9ae329bce9935e6289184,0,Boris S,2018-10-24 09:51:08-07:00,"['7d60510ff56abf285f8df858cf2331108744ff24', '59bc23cf954bf86683c499729930f126af5ebf2b']",48,2018,2066,720699,11,,,,2359
424b042dd4e394c4a80ddfdfa4905519a87b3038,0,Jagadish,2018-10-24 14:34:03-07:00,['456e697d8034099f032361268f3768b085395696'],29,35,64,720763,6,1,1,1,2359
796aa4004069ca56923adcf6c544f7a399f72b22,0,Jagadish,2018-10-24 14:36:04-07:00,['424b042dd4e394c4a80ddfdfa4905519a87b3038'],21,5,26,720789,4,0,0,0,2359
c21593bb466a40440e6211821e550e2ad9628d83,0,Jagadish,2018-10-24 15:18:04-07:00,['796aa4004069ca56923adcf6c544f7a399f72b22'],8,10,18,720807,1,,,,2359
48f5f280784fcf52c3148dac8cbece6ae9d3d41e,0,Jagadish,2018-10-24 15:18:41-07:00,"['c21593bb466a40440e6211821e550e2ad9628d83', '59bc23cf954bf86683c499729930f126af5ebf2b']",0,0,0,720807,0,,,,2359
43a501b494ea4b7ee70477686ab60a9b8d13fd03,0,Jagadish,2018-10-24 15:20:02-07:00,['59bc23cf954bf86683c499729930f126af5ebf2b'],25,17,42,720849,2,,,,2359
58f18117ccddc62cf4c74325faa8dfa6ad9ec8e3,1,Srinivasulu Punuru,2018-10-25 14:16:24-07:00,['43a501b494ea4b7ee70477686ab60a9b8d13fd03'],34,111,145,720994,8,0.245614035,0.98245614,0.736842105,2359
5a31be92eb8f4490879b10a30da81e12075ec6dc,1,Srinivasulu Punuru,2018-10-25 14:28:19-07:00,['58f18117ccddc62cf4c74325faa8dfa6ad9ec8e3'],37,51,88,721082,3,0.583333333,1,1,2359
1c2d6effba097202e4ab9bddf9dc060683f0110c,0,Srinivasulu Punuru,2018-10-25 14:32:38-07:00,['5a31be92eb8f4490879b10a30da81e12075ec6dc'],1,2,3,721085,1,,,,2359
08496c96d229582456d5fe48f442876745c11112,0,Jagadish,2018-10-26 17:51:58-07:00,['1c2d6effba097202e4ab9bddf9dc060683f0110c'],17,54,71,721156,3,0.35,1,1,2359
1befcad8fb729996da7597984b814380204ac53c,0,Jagadish,2018-10-27 11:12:38-07:00,['48f5f280784fcf52c3148dac8cbece6ae9d3d41e'],132,93,225,721381,2,,,,2359
2ffedc9a9ab376957371cc0068e85db6e1c62a17,0,Jagadish,2018-10-27 11:15:08-07:00,"['1befcad8fb729996da7597984b814380204ac53c', '08496c96d229582456d5fe48f442876745c11112']",89,218,307,721688,13,,,,2359
45f2558e91eb891368b8445ae54a352e9f4a7486,0,Jagadish,2018-10-27 11:18:08-07:00,['08496c96d229582456d5fe48f442876745c11112'],132,93,225,721913,2,,,,2359
7d4c2ed651d0d1e0325c3539748b7373f954a480,0,Jagadish,2018-10-27 11:18:52-07:00,"['2ffedc9a9ab376957371cc0068e85db6e1c62a17', '45f2558e91eb891368b8445ae54a352e9f4a7486']",0,0,0,721913,0,,,,2359
c9596b243b8c12c502212a0acb413c5f27b3f52e,0,Jagadish,2018-10-28 11:26:46-07:00,['7d4c2ed651d0d1e0325c3539748b7373f954a480'],94,112,206,722119,2,,,,2359
affc312d34f459241ac61d4a8a7b51d79b587dee,0,Jagadish,2018-10-28 11:29:07-07:00,['45f2558e91eb891368b8445ae54a352e9f4a7486'],94,112,206,722325,2,,,,2359
6f6cf928adc771685efaf3291a60d53d28c1d252,0,Boris S,2018-10-29 09:26:53-07:00,"['7d60510ff56abf285f8df858cf2331108744ff24', 'affc312d34f459241ac61d4a8a7b51d79b587dee']",388,2458,2846,725171,30,,,,2359
3273e960ed35671ab04f51a89c826714b12fecea,0,Jagadish,2018-10-29 16:28:14-07:00,['c9596b243b8c12c502212a0acb413c5f27b3f52e'],148,80,228,725399,3,,,,2359
d315cae63bf514a15152c23b8b7e8fde786f8bc5,0,Jagadish,2018-10-29 16:29:39-07:00,"['3273e960ed35671ab04f51a89c826714b12fecea', 'affc312d34f459241ac61d4a8a7b51d79b587dee']",6,6,12,725411,1,,,,2359
ea0bec4a86587e53bd1e5e048d46c531a3bd8bd2,1,Jagadish,2018-10-29 16:31:11-07:00,['affc312d34f459241ac61d4a8a7b51d79b587dee'],143,75,218,725629,3,,,,2359
7d7478192fd2addc69f4dec2dec976e9be6301d8,0,Jagadish,2018-10-29 16:37:07-07:00,"['d315cae63bf514a15152c23b8b7e8fde786f8bc5', 'ea0bec4a86587e53bd1e5e048d46c531a3bd8bd2']",0,0,0,725629,0,,,,2359
64c82634c33c067e2245315b1aa826057f9a2875,1,Prateek Maheshwari,2018-10-29 19:52:04-07:00,['ea0bec4a86587e53bd1e5e048d46c531a3bd8bd2'],0,10,10,725639,2,1,1,1,2359
dcd4b558a2c702f5b5a320fdb9d0c3fcadabd09b,1,Srinivasulu Punuru,2018-10-30 11:25:00-07:00,['64c82634c33c067e2245315b1aa826057f9a2875'],170,570,740,726379,21,0.776190476,0.785714286,0.885714286,2363
0b4c6893502e737816e1ec8c4b47681f2b9e58b4,0,Jagadish,2018-10-30 12:05:49-07:00,['7d7478192fd2addc69f4dec2dec976e9be6301d8'],43,63,106,726485,1,,,,2363
ff6032c300fd301de90695f7d4ec03f852f091bb,0,Jagadish,2018-10-30 12:06:54-07:00,['0b4c6893502e737816e1ec8c4b47681f2b9e58b4'],3,1,4,726489,1,,,,2363
de2b97f8976651946a2d1220259798e459d23a53,0,Jagadish,2018-10-30 12:11:56-07:00,['dcd4b558a2c702f5b5a320fdb9d0c3fcadabd09b'],43,61,104,726593,1,,,,2363
c1e03e65f3844d7cbcf789dd5bffb6dfc5079e79,1,Srinivasulu Punuru,2018-10-30 13:33:33-07:00,['de2b97f8976651946a2d1220259798e459d23a53'],22,33,55,726648,1,1,1,0.4,2363
3f9bbb07b562179704a953c4bf840c32f635a98e,0,Prateek Maheshwari,2018-10-30 15:54:25-07:00,['c1e03e65f3844d7cbcf789dd5bffb6dfc5079e79'],0,500,500,727148,1,,,,2364
d17134e0d76e6c6b0fc24bf23bd63967e749ad1b,0,Jagadish,2018-10-30 16:29:53-07:00,['3f9bbb07b562179704a953c4bf840c32f635a98e'],28,19,47,727195,1,,,,2364
018a6e45ea04a150155788fc32ec7a1ffb81d625,0,Jagadish,2018-10-30 18:45:37-07:00,['ff6032c300fd301de90695f7d4ec03f852f091bb'],5,8,13,727208,2,1,1,0,2364
841b8fafe0d75cc7e46b96584f7959c9baecd2ec,0,Jagadish,2018-10-30 18:46:53-07:00,"['018a6e45ea04a150155788fc32ec7a1ffb81d625', '3f9bbb07b562179704a953c4bf840c32f635a98e']",192,1113,1305,728513,25,,,,2364
7836bf08c54f48cdac50f57e89c4eff8ec1925ea,0,Jagadish,2018-10-30 18:48:40-07:00,['d17134e0d76e6c6b0fc24bf23bd63967e749ad1b'],5,8,13,728526,2,1,1,0,2364
8aa77a1c39698ec7132162a8f651e49aa701d4aa,0,Boris S,2018-10-31 11:31:51-07:00,"['70c6f2b15b1528f3bed9ae329bce9935e6289184', '7836bf08c54f48cdac50f57e89c4eff8ec1925ea']",740,1705,2445,730971,46,,,,2364
10162405911767d7afb7c56c62ddc9f2c2e95766,0,Boris S,2018-10-31 11:32:22-07:00,"['8aa77a1c39698ec7132162a8f651e49aa701d4aa', '6f6cf928adc771685efaf3291a60d53d28c1d252']",0,0,0,730971,0,,,,2364
ea5887178a63fc0ccfaf50bb3d5f826145b9c509,0,Jagadish,2018-10-31 12:41:20-07:00,['7836bf08c54f48cdac50f57e89c4eff8ec1925ea'],6,44,50,731021,2,0,1,1,2364
d16861831f3494dfc270664736c612f6be7aeb04,1,Jagadish,2018-10-31 12:41:40-07:00,['ea5887178a63fc0ccfaf50bb3d5f826145b9c509'],2,2,4,731025,2,,,,2364
9f60e96b1628fe395f771aaccaba077fdce3558e,0,Prateek Maheshwari,2018-10-31 13:36:54-07:00,['d16861831f3494dfc270664736c612f6be7aeb04'],179,222,401,731426,19,,,,2364
8723c3f79f751870ebcece9b5618db009029d691,0,Boris S,2018-10-31 13:45:28-07:00,['9f60e96b1628fe395f771aaccaba077fdce3558e'],199,32,231,731657,10,1,0,0,2364
a528cc6805756c9ee11904e00346e08002dcd143,0,Boris S,2018-10-31 14:22:04-07:00,['8723c3f79f751870ebcece9b5618db009029d691'],59,425,484,732141,6,0.585714286,1,0.914285714,2365
429277b706a7f7fd3c531e38777099aee9c4530c,0,Jagadish,2018-10-31 14:22:21-07:00,"['841b8fafe0d75cc7e46b96584f7959c9baecd2ec', '8723c3f79f751870ebcece9b5618db009029d691']",414,319,733,732874,34,,,,2365
c7d94c895674464d3400fc2a1df78391f2edcf8a,0,Boris S,2018-11-01 09:56:48-07:00,"['10162405911767d7afb7c56c62ddc9f2c2e95766', 'a528cc6805756c9ee11904e00346e08002dcd143']",445,725,1170,734044,39,,,,2365
ed196c7b1f5b06d0d9d59aa04cfe035e7c892cea,0,Jagadish,2018-11-01 15:38:32-07:00,"['429277b706a7f7fd3c531e38777099aee9c4530c', 'a528cc6805756c9ee11904e00346e08002dcd143']",59,425,484,734528,6,,,,2365
743903272ddd4639da32224b1ce544df69314aaa,1,Boris S,2018-11-02 09:38:30-07:00,['a528cc6805756c9ee11904e00346e08002dcd143'],17,185,202,734730,3,0.23853211,0.95412844,0.990825688,2365
f8470b1ed796d00888e4ba176a0105c9b07b2938,0,Jagadish,2018-11-02 17:33:26-07:00,['ed196c7b1f5b06d0d9d59aa04cfe035e7c892cea'],84,50,134,734864,1,,,,2365
859f1b646a75d499405d470116a227d83a5d506d,0,Jagadish,2018-11-02 17:35:20-07:00,['743903272ddd4639da32224b1ce544df69314aaa'],84,50,134,734998,1,,,,2365
29704e463c371229410ed213438625ff21fad67e,0,Boris S,2018-11-05 14:00:38-08:00,"['c7d94c895674464d3400fc2a1df78391f2edcf8a', '859f1b646a75d499405d470116a227d83a5d506d']",101,235,336,735334,4,,,,2365
9c121207389b8067747ee327d252aa9757591829,0,Wei Song,2018-11-06 15:09:01-08:00,"['89bfc14c59da538c6a04d9002d30e69ba8631e92', '859f1b646a75d499405d470116a227d83a5d506d']",1845,9463,11308,746642,185,,,,2365
ad12c6ddd1da54578f503792f66f2c5d645c355f,0,Boris S,2018-11-07 14:39:59-08:00,['859f1b646a75d499405d470116a227d83a5d506d'],117,107,224,746866,5,0.571428571,0,0,2365
2159171ee8df3f7266fe853a72cea4acd6a19d8e,0,Wei Song,2018-11-07 14:46:17-08:00,['ad12c6ddd1da54578f503792f66f2c5d645c355f'],32,32,64,746930,11,,,,2365
e82daa17e6af92570fc952298f4d630678a95809,0,Wei Song,2018-11-07 14:47:31-08:00,"['9c121207389b8067747ee327d252aa9757591829', '2159171ee8df3f7266fe853a72cea4acd6a19d8e']",149,139,288,747218,16,,,,2365
3da75e61ab61dad8aacd31dd38513e4edaa9d36a,1,Wei Song,2018-11-08 14:04:28-08:00,['2159171ee8df3f7266fe853a72cea4acd6a19d8e'],172,178,350,747568,44,0,0,1,2365
838b09974f3270f34cd6507c6a229cc7bffee658,0,Boris S,2018-11-09 08:07:53-08:00,"['29704e463c371229410ed213438625ff21fad67e', '3da75e61ab61dad8aacd31dd38513e4edaa9d36a']",298,294,592,748160,52,,,,2365
12f421ce212949ff3152dc9e0f1e4f38233dc5b8,1,Srinivasulu Punuru,2018-11-09 08:30:59-08:00,['3da75e61ab61dad8aacd31dd38513e4edaa9d36a'],377,1032,1409,749569,26,0.153543307,0.94488189,0.649606299,2374
42636048b987e116548a8ada40fb8056b2b2a28d,0,Boris S,2018-11-09 16:23:05-08:00,['12f421ce212949ff3152dc9e0f1e4f38233dc5b8'],33,195,228,749797,6,0.095744681,0.85106383,0.978723404,2374
6dd3e1823fcc92cc1f52c56056d4e0c49ef5b354,0,Prateek Maheshwari,2018-11-12 11:11:28-08:00,['42636048b987e116548a8ada40fb8056b2b2a28d'],29,30,59,749856,2,,,,2374
1d6f693c84c7476d0d51a3a47e41908f7ddd1646,1,Srinivasulu Punuru,2018-11-12 11:42:51-08:00,['6dd3e1823fcc92cc1f52c56056d4e0c49ef5b354'],34,119,153,750009,9,0,0.606060606,0.696969697,2374
b0c544a79556856162af41a50e88010abd275860,0,Wei Song,2018-11-12 15:33:00-08:00,"['e82daa17e6af92570fc952298f4d630678a95809', '1d6f693c84c7476d0d51a3a47e41908f7ddd1646']",634,1543,2177,752186,80,,,,2374
4e590709061fa8442dc0b0366a1f9976d04db9a0,1,Jagadish,2018-11-13 18:17:17-08:00,['1d6f693c84c7476d0d51a3a47e41908f7ddd1646'],481,483,964,753150,18,,,,2374
e0e5e871477fd2894bf37b74a763c4a35bc4849f,0,Jagadish,2018-11-13 19:17:26-08:00,"['f8470b1ed796d00888e4ba176a0105c9b07b2938', '4e590709061fa8442dc0b0366a1f9976d04db9a0']",1258,2327,3585,756735,109,,,,2374
cc49da0651a0e294b26f7b40e1c8b23c89322686,0,Wei Song,2018-11-15 11:41:27-08:00,"['b0c544a79556856162af41a50e88010abd275860', '4e590709061fa8442dc0b0366a1f9976d04db9a0']",481,483,964,757699,18,,,,2374
7b0082b8c0b5de8e400b8deaae0604bf3cb293a3,0,xinyuiscool,2018-11-15 16:01:53-08:00,['4e590709061fa8442dc0b0366a1f9976d04db9a0'],8,50,58,757757,8,0.666666667,1,1,2374
b25df5f53ddf35564ab8c8df45b86fc2b071b45d,0,Hai Lu,2018-11-16 14:13:03-08:00,['7b0082b8c0b5de8e400b8deaae0604bf3cb293a3'],0,28,28,757785,1,,,,2375
ebeccd203166aa20574a95c07dea70d5db72cd83,1,Srinivasulu Punuru,2018-11-19 09:59:23-08:00,['b25df5f53ddf35564ab8c8df45b86fc2b071b45d'],4,4,8,757793,1,,,,2375
cd14501676b44ace4ac200c04d89df9b9995b364,0,Wei Song,2018-11-19 22:33:57-08:00,"['cc49da0651a0e294b26f7b40e1c8b23c89322686', 'ebeccd203166aa20574a95c07dea70d5db72cd83']",12,82,94,757887,10,,,,2375
b058459121b15d428a1cdf3e9d11f2151e45cd02,0,xinyuiscool,2018-11-20 12:31:56-08:00,['ebeccd203166aa20574a95c07dea70d5db72cd83'],1,98,99,757986,2,0.529411765,1,1,2376
2ee12d042471e3ebcca439c29297bd17e6a32a1c,0,Srinivasulu Punuru,2018-11-20 13:02:13-08:00,['b058459121b15d428a1cdf3e9d11f2151e45cd02'],2,17,19,758005,3,1,1,0.916666667,2376
a6184f1e2af1bfb89afac77861e93df173756efe,1,Srinivasulu Punuru,2018-11-20 13:18:57-08:00,['2ee12d042471e3ebcca439c29297bd17e6a32a1c'],14,246,260,758265,10,0.190184049,0.828220859,0.895705521,2376
cce2b6f2ec080f6e79dc0d85d82eba9443be9710,1,Srinivasulu Punuru,2018-11-20 14:05:47-08:00,['a6184f1e2af1bfb89afac77861e93df173756efe'],81,261,342,758607,12,0.786666667,1,0.626666667,2377
043523d42e8dedbe07b82ac792b789866db6c009,0,Wei Song,2018-11-20 16:45:00-08:00,"['cd14501676b44ace4ac200c04d89df9b9995b364', 'cce2b6f2ec080f6e79dc0d85d82eba9443be9710']",98,622,720,759327,26,,,,2377
5f7a22c3bb991352cba58bc83d0df01a0ba38835,1,Wei Song,2018-11-20 17:22:18-08:00,['cce2b6f2ec080f6e79dc0d85d82eba9443be9710'],1683,1079,2762,762089,71,0.595744681,0.079787234,0,2380
9f6aa1fce91ce1ac36286921ba9b53c0c93d6cf8,0,Wei Song,2018-11-20 21:59:28-08:00,"['043523d42e8dedbe07b82ac792b789866db6c009', '5f7a22c3bb991352cba58bc83d0df01a0ba38835']",1683,1079,2762,764851,71,,,,2380
65f58bfa010ae60af0584e9a464028e338d1995f,0,Jagadish,2018-11-26 14:17:14-08:00,"['e0e5e871477fd2894bf37b74a763c4a35bc4849f', '5f7a22c3bb991352cba58bc83d0df01a0ba38835']",1793,1783,3576,768427,103,,,,2380
072cff600b41aaac564aefebdea2b541c9f59277,0,Jagadish,2018-11-26 14:18:01-08:00,['65f58bfa010ae60af0584e9a464028e338d1995f'],80,23,103,768530,1,,,,2380
dccada916a603fe7a6d7408aca658830bd05b243,0,Jagadish,2018-11-26 14:20:24-08:00,['5f7a22c3bb991352cba58bc83d0df01a0ba38835'],80,23,103,768633,1,,,,2380
9e05362cf7b1bb4453cf05497b94c61f5c388420,0,Wei Song,2018-11-26 15:19:39-08:00,"['9f6aa1fce91ce1ac36286921ba9b53c0c93d6cf8', 'dccada916a603fe7a6d7408aca658830bd05b243']",80,23,103,768736,1,,,,2380
f529722f541e5475d5b558fe4caefd7b9d04f754,0,Wei Song,2018-11-26 15:32:31-08:00,['dccada916a603fe7a6d7408aca658830bd05b243'],70,67,137,768873,19,0.333333333,0.833333333,1,2380
49ea480a04d54343a4f468000d21c7f7f0c40a19,0,Wei Song,2018-11-26 15:34:51-08:00,"['9e05362cf7b1bb4453cf05497b94c61f5c388420', 'f529722f541e5475d5b558fe4caefd7b9d04f754']",70,67,137,769010,19,,,,2380
d6b8988215f959348c4b740b9d40064c3599fdbc,0,Jagadish,2018-11-27 00:26:06-08:00,['072cff600b41aaac564aefebdea2b541c9f59277'],142,35,177,769187,1,,,,2380
32af8e07e1e467a85a6f6a46a813337bc933a886,0,Jagadish,2018-11-27 00:27:11-08:00,"['d6b8988215f959348c4b740b9d40064c3599fdbc', 'f529722f541e5475d5b558fe4caefd7b9d04f754']",70,67,137,769324,19,,,,2380
6f40414d7d6c04db20dac444211b6bfec6cf034b,0,Jagadish,2018-11-27 00:28:39-08:00,['f529722f541e5475d5b558fe4caefd7b9d04f754'],142,35,177,769501,1,,,,2380
2d9836df520a626c97364fdbd057b75daf2d3417,0,Jagadish,2018-11-27 01:46:54-08:00,['32af8e07e1e467a85a6f6a46a813337bc933a886'],2,2,4,769505,1,,,,2380
6cdcdefd448a197ae1634acf5ae8a33e7f15106a,0,Jagadish,2018-11-27 01:47:09-08:00,"['2d9836df520a626c97364fdbd057b75daf2d3417', '6f40414d7d6c04db20dac444211b6bfec6cf034b']",0,0,0,769505,0,,,,2380
428861be157b55dca6c5901a1c5e13b25bd7b1e6,0,Jagadish,2018-11-27 03:20:28-08:00,['6cdcdefd448a197ae1634acf5ae8a33e7f15106a'],35,34,69,769574,6,,,,2380
f86749b69ff9022dce2a1afadb3793d4c92da802,0,Jagadish,2018-11-27 03:21:25-08:00,['6cdcdefd448a197ae1634acf5ae8a33e7f15106a'],35,34,69,769643,6,,,,2380
2855ddaae66d17b52e4d4d092cc185acf0e39fec,0,Jagadish,2018-11-27 03:57:43-08:00,['428861be157b55dca6c5901a1c5e13b25bd7b1e6'],10,22,32,769675,8,,,,2380
2e6a79ad16572161f305b371ad0bc758fb89e163,0,Jagadish,2018-11-27 03:59:13-08:00,['f86749b69ff9022dce2a1afadb3793d4c92da802'],10,22,32,769707,8,,,,2380
0c01b35346543a12c00ba051e7d3a48b36e86dce,0,Jagadish,2018-11-27 04:00:16-08:00,"['2855ddaae66d17b52e4d4d092cc185acf0e39fec', '2e6a79ad16572161f305b371ad0bc758fb89e163']",0,0,0,769707,0,,,,2380
e25e0dab920def6a7d10b3e1741c0805fc071272,0,Jagadish,2018-11-27 05:42:08-08:00,['0c01b35346543a12c00ba051e7d3a48b36e86dce'],1,1,2,769709,1,,,,2380
160f1d70ce4e693f0295241cc59839012681af67,0,Wei Song,2018-11-27 09:23:32-08:00,"['49ea480a04d54343a4f468000d21c7f7f0c40a19', 'e25e0dab920def6a7d10b3e1741c0805fc071272']",189,93,282,769991,16,,,,2380
5069f1ddb74587ad6fb11d515bece45bd2a8f3bc,1,Wei Song,2018-11-27 10:40:34-08:00,['e25e0dab920def6a7d10b3e1741c0805fc071272'],328,833,1161,771152,27,0.356115108,1,0.996402878,2383
094ceb4ffbbd7fdf7a168b9dabb1df168e1f9de0,0,Wei Song,2018-11-27 10:42:32-08:00,"['160f1d70ce4e693f0295241cc59839012681af67', '5069f1ddb74587ad6fb11d515bece45bd2a8f3bc']",328,833,1161,772313,27,,,,2383
ff607cb6b61144ea6feb28842318e1eb1e5eaa5a,1,Srinivasulu Punuru,2018-11-28 15:53:30-08:00,['5069f1ddb74587ad6fb11d515bece45bd2a8f3bc'],257,295,552,772865,9,0,1,1,2383
b90ab50c32d97a31313efdfb26b48c2fcdeb61da,0,Srinivasulu Punuru,2018-11-29 09:46:13-08:00,['ff607cb6b61144ea6feb28842318e1eb1e5eaa5a'],59,49,108,772973,7,0,0,0,2383
25a4a168a3bc1b79a0656cd3b15f974ff27e68f5,0,Wei Song,2018-11-29 11:11:38-08:00,"['094ceb4ffbbd7fdf7a168b9dabb1df168e1f9de0', 'b90ab50c32d97a31313efdfb26b48c2fcdeb61da']",316,344,660,773633,16,,,,2383
d94012607327df3c7c5fff212a3cfc7f0a733e38,0,Boris S,2018-11-29 11:44:37-08:00,"['29704e463c371229410ed213438625ff21fad67e', 'b90ab50c32d97a31313efdfb26b48c2fcdeb61da']",3946,5214,9160,782793,196,,,,2383
08b2c68dae60b0c42de7f3d1be00422816a3d178,0,Boris S,2018-11-29 11:45:09-08:00,"['d94012607327df3c7c5fff212a3cfc7f0a733e38', '838b09974f3270f34cd6507c6a229cc7bffee658']",0,0,0,782793,0,,,,2383
127707384dbc95f7af9045da3978d28e9a2832c3,1,Boris S,2018-11-29 11:53:39-08:00,['b90ab50c32d97a31313efdfb26b48c2fcdeb61da'],62,109,171,782964,2,0.373134328,0.858208955,0.970149254,2383
cfd483e1cd805304e316b553dc640a0465ee225d,0,Wei Song,2018-11-29 13:27:46-08:00,"['25a4a168a3bc1b79a0656cd3b15f974ff27e68f5', '127707384dbc95f7af9045da3978d28e9a2832c3']",62,109,171,783135,2,,,,2383
5154f9eb8f484126dbd810a350bf15a10645a1f7,0,Wei Song,2018-11-29 15:31:58-08:00,['127707384dbc95f7af9045da3978d28e9a2832c3'],12,35,47,783182,3,0,1,1,2383
c738ee6421552758f2fd7904e6a247b39ac85795,0,Wei Song,2018-11-29 15:33:05-08:00,"['cfd483e1cd805304e316b553dc640a0465ee225d', '5154f9eb8f484126dbd810a350bf15a10645a1f7']",12,35,47,783229,3,,,,2383
2aa18b82570e9457f1e36b6fc064eadadfb2304d,0,Prateek Maheshwari,2018-11-29 19:23:46-08:00,['5154f9eb8f484126dbd810a350bf15a10645a1f7'],1,45,46,783275,2,1,1,0.64,2383
bdce47707a32f91032574f1d6d05b6e659a4aa33,0,Prateek Maheshwari,2018-11-30 10:33:35-08:00,['2aa18b82570e9457f1e36b6fc064eadadfb2304d'],4,2,6,783281,1,0,0,1,2383
d8bf7fbfe6e0981088192fcab8399ae511c1ad6c,0,Wei Song,2018-11-30 11:19:26-08:00,"['c738ee6421552758f2fd7904e6a247b39ac85795', 'bdce47707a32f91032574f1d6d05b6e659a4aa33']",1,43,44,783325,2,,,,2383
210631cd5c4487e99978189ee9b8d0b0c8847aba,0,Wei Song,2018-11-30 12:52:59-08:00,['bdce47707a32f91032574f1d6d05b6e659a4aa33'],81,52,133,783458,11,1,0,0.807692308,2383
bee30f5df64634f4acb4b5f1aca0d23c231948a3,1,Srinivasulu Punuru,2018-11-30 13:40:05-08:00,['210631cd5c4487e99978189ee9b8d0b0c8847aba'],8,38,46,783504,2,0,1,1,2383
4dbc2c6de5e9048654eed0195364fdc09cefa3bf,1,Jagadish,2018-11-30 17:06:30-08:00,['bee30f5df64634f4acb4b5f1aca0d23c231948a3'],32,555,587,784091,13,0.326923077,0.995192308,0.903846154,2386
fb293bb8cb2c9f379a29a0702acd574d62f5a2f1,1,Jagadish,2018-11-30 17:07:23-08:00,['4dbc2c6de5e9048654eed0195364fdc09cefa3bf'],57,330,387,784478,7,0.303571429,0.901785714,0.785714286,2388
7fc3704071c9a295027758212f66136afc44370a,0,Aditya Toomula,2018-11-30 17:12:51-08:00,['fb293bb8cb2c9f379a29a0702acd574d62f5a2f1'],0,28,28,784506,1,,,,2389
5827f619b40c6d802b63a16cb881b0699d5e4b29,0,Boris S,2018-12-03 08:47:52-08:00,"['838b09974f3270f34cd6507c6a229cc7bffee658', '7fc3704071c9a295027758212f66136afc44370a']",3840,6049,9889,794395,203,,,,2389
21729af410fa8689b014e3fc1855f2589b5a19c8,0,Boris S,2018-12-03 14:58:46-08:00,"['08b2c68dae60b0c42de7f3d1be00422816a3d178', '5827f619b40c6d802b63a16cb881b0699d5e4b29']",253,1190,1443,795838,38,,,,2389
f4ba9cdc18651b62f833229e00e2fdd07692dfc5,1,Jagadish,2018-12-03 18:08:36-08:00,['7fc3704071c9a295027758212f66136afc44370a'],44,53,97,795935,7,0,0,0,2389
8a22e05c9e5096ccb37ef31bc2bed01127c75ca4,1,Jagadish,2018-12-04 13:53:56-08:00,['f4ba9cdc18651b62f833229e00e2fdd07692dfc5'],169,903,1072,797007,12,0.319410319,0.950859951,0.960687961,2395
0dc9dd24f8839cf5b261b2b42edb27d0b01b162c,1,Jagadish,2018-12-04 14:08:57-08:00,['8a22e05c9e5096ccb37ef31bc2bed01127c75ca4'],20,13,33,797040,7,1,1,1,2395
327b076d44ad55c338c8ec3c4e1693ffa6d847e0,0,Wei Song,2018-12-04 14:40:14-08:00,"['d8bf7fbfe6e0981088192fcab8399ae511c1ad6c', '0dc9dd24f8839cf5b261b2b42edb27d0b01b162c']",391,1952,2343,799383,53,,,,2395
e47edbe559285ba9effe35582946e331dad3580f,0,Aditya Toomula,2018-12-04 15:47:25-08:00,['0dc9dd24f8839cf5b261b2b42edb27d0b01b162c'],1,19,20,799403,2,1,1,0.769230769,2395
eee8d365b2e4806f646d8d3c23e29b677dcce65b,0,Wei Song,2018-12-04 15:47:47-08:00,"['327b076d44ad55c338c8ec3c4e1693ffa6d847e0', 'e47edbe559285ba9effe35582946e331dad3580f']",1,19,20,799423,2,,,,2395
cc314be3b84fbf8c874c9532f1470ea2d9edd116,1,Aditya Toomula,2018-12-04 15:50:07-08:00,['e47edbe559285ba9effe35582946e331dad3580f'],4,124,128,799551,4,0.510638298,1,0.787234043,2396
0e719e41f9e1c4245f9b902558a882c6a5f46f10,0,Wei Song,2018-12-04 15:50:49-08:00,"['eee8d365b2e4806f646d8d3c23e29b677dcce65b', 'cc314be3b84fbf8c874c9532f1470ea2d9edd116']",4,124,128,799679,4,,,,2396
c7e5dcba4c398937de7805b2755e1ac65485cf96,0,Wei Song,2018-12-04 15:51:58-08:00,['cc314be3b84fbf8c874c9532f1470ea2d9edd116'],17,12,29,799708,2,0.333333333,0.333333333,0.333333333,2396
45b50d7ba472bbc65a2ab74c70092f5087690650,0,Boris S,2018-12-04 18:18:40-08:00,"['21729af410fa8689b014e3fc1855f2589b5a19c8', 'c7e5dcba4c398937de7805b2755e1ac65485cf96']",255,1124,1379,801087,33,,,,2396
5ea72584f6b92937ec130f486d6f70603b7188c2,1,Jagadish,2018-12-05 10:56:55-08:00,['c7e5dcba4c398937de7805b2755e1ac65485cf96'],636,1348,1984,803071,38,0.09039548,0.796610169,0.867231638,2399
b668b5bea825cf84c06a342f1a63470d131a5749,1,Boris S,2018-12-05 11:54:44-08:00,['5ea72584f6b92937ec130f486d6f70603b7188c2'],20,59,79,803150,9,0.944444444,1,0.944444444,2399
8ff1c99cdefccbce6bdc4a22f7fd5b5e16b9a80a,0,Boris S,2018-12-05 12:14:46-08:00,"['45b50d7ba472bbc65a2ab74c70092f5087690650', 'b668b5bea825cf84c06a342f1a63470d131a5749']",656,1407,2063,805213,47,,,,2399
1a7e27097c7509863437e96b1c392e3886ca67ab,1,Boris S,2018-12-05 14:13:50-08:00,['b668b5bea825cf84c06a342f1a63470d131a5749'],11,15,26,805239,2,0,1,1,2399
65ce8d3fc8f8ef825f092371f7aca10b923c4e53,0,Boris S,2018-12-05 14:16:40-08:00,"['8ff1c99cdefccbce6bdc4a22f7fd5b5e16b9a80a', '1a7e27097c7509863437e96b1c392e3886ca67ab']",11,15,26,805265,2,,,,2399
e2adf8f9956879061a76b433369dbe3d5f524044,1,Prateek Maheshwari,2018-12-05 16:41:34-08:00,['1a7e27097c7509863437e96b1c392e3886ca67ab'],379,622,1001,806266,40,1,0.918032787,0.704918033,2401
b126683ae9c4d81aeca7b8bc72bf5afd00cd57fe,0,Boris S,2018-12-06 09:54:55-08:00,['e2adf8f9956879061a76b433369dbe3d5f524044'],3,3,6,806272,1,,,,2401
bd9387b7f8a455c733ccbcb2347bdc30be7716dd,1,Srinivasulu Punuru,2018-12-06 10:56:38-08:00,['b126683ae9c4d81aeca7b8bc72bf5afd00cd57fe'],139,541,680,806952,21,0.5,1,0.453333333,2403
df56f2dc1ee1be9b2a3aa9894465e3f870451125,1,Jagadish,2018-12-06 18:11:38-08:00,['bd9387b7f8a455c733ccbcb2347bdc30be7716dd'],138,158,296,807248,17,0,0.052631579,0,2404
970dfe57e5993c93d62cfb50b71167acc7596cad,1,Aditya Toomula,2018-12-07 15:05:43-08:00,['df56f2dc1ee1be9b2a3aa9894465e3f870451125'],6,192,198,807446,7,0.574074074,1,0.907407407,2406
a1418f043dc18e7e4d14acb9c850cda1f7cd213d,0,Jagadish,2018-12-08 20:41:23-08:00,['970dfe57e5993c93d62cfb50b71167acc7596cad'],8,40,48,807494,1,,,,2406
23bf148378c2e6a45aa469f6e21ee8949a69e6ae,0,Jagadish,2018-12-08 21:07:41-08:00,['a1418f043dc18e7e4d14acb9c850cda1f7cd213d'],5,5,10,807504,1,,,,2406
ba2df3a3f704b32eda7de6ca58bb9de3e6bd93c4,0,Jagadish,2018-12-10 23:27:12-08:00,['23bf148378c2e6a45aa469f6e21ee8949a69e6ae'],8,7,15,807519,1,,,,2406
fe40f9e569334e5b2d5471506472ec4536e7ef20,0,Jagadish,2018-12-11 00:02:39-08:00,['ba2df3a3f704b32eda7de6ca58bb9de3e6bd93c4'],1,1,2,807521,1,,,,2406
9696154ab224317af12a4b8a712771c61b585e0d,0,Prateek Maheshwari,2018-12-11 10:34:55-08:00,['fe40f9e569334e5b2d5471506472ec4536e7ef20'],1,5,6,807527,1,,,,2406
2e5e19df3ce092f4f16afb97d0f2f7511b4dd33d,1,Aditya Toomula,2018-12-11 11:16:49-08:00,['9696154ab224317af12a4b8a712771c61b585e0d'],3,9,12,807539,3,0.666666667,0.666666667,0.666666667,2406
60150bfb38038bb9892b9ad2d8dcfac14ad2fd68,0,Jagadish,2018-12-11 21:00:14-08:00,['2e5e19df3ce092f4f16afb97d0f2f7511b4dd33d'],2,4,6,807545,2,,,,2406
28b7a88691af7c63a21993096b3c6315786643a2,0,Wei Song,2018-12-12 10:27:37-08:00,"['0e719e41f9e1c4245f9b902558a882c6a5f46f10', '60150bfb38038bb9892b9ad2d8dcfac14ad2fd68']",1318,2962,4280,811825,120,,,,2406
7b58d5ca07453f6b94afa6de24cac9044fff10b4,1,Prateek Maheshwari,2018-12-12 13:41:48-08:00,['60150bfb38038bb9892b9ad2d8dcfac14ad2fd68'],25,131,156,811981,7,0,0,1,2407
85830be9cd1f418889e2b382564972f86ba309cc,0,Prateek Maheshwari,2018-12-12 13:42:48-08:00,['7b58d5ca07453f6b94afa6de24cac9044fff10b4'],0,1,1,811982,1,1,1,0,2407
c5348bf6b1fcaf7f9db841b815b6b5eeb9937395,0,Hai Lu,2018-12-14 14:35:45-08:00,['85830be9cd1f418889e2b382564972f86ba309cc'],70,883,953,812935,11,0.605932203,1,0.987288136,2415
a824db62f3b24b1a98c6977e5d8dfcd88a507828,0,Wei Song,2018-12-17 15:10:05-08:00,"['28b7a88691af7c63a21993096b3c6315786643a2', 'c5348bf6b1fcaf7f9db841b815b6b5eeb9937395']",95,1015,1110,814045,19,,,,2415
6a75503d74ae65b30e2dcf760bba6e1d8050cdba,1,Wei Song,2018-12-17 15:11:27-08:00,['c5348bf6b1fcaf7f9db841b815b6b5eeb9937395'],753,563,1316,815361,42,0,0.615384615,1,2415
84d144c5120bf8bae8dc02ba7a1de1c68bed6418,0,Prateek Maheshwari,2018-12-18 13:06:04-08:00,['6a75503d74ae65b30e2dcf760bba6e1d8050cdba'],3,5,8,815369,1,0,1,1,2415
9127d9270cac5b481ed8fb09ce7380c646bb8191,0,Wei Song,2018-12-18 20:14:35-08:00,"['a824db62f3b24b1a98c6977e5d8dfcd88a507828', '84d144c5120bf8bae8dc02ba7a1de1c68bed6418']",756,568,1324,816693,43,,,,2415
091caef991236e49856c178f735777decbb49d8f,0,xinyuiscool,2018-12-21 10:54:14-08:00,['84d144c5120bf8bae8dc02ba7a1de1c68bed6418'],0,64,64,816757,1,,,,2415
0937c1dc040cabcf54846862bbb764cde83a6379,1,Jagadish,2018-12-21 14:11:07-08:00,['091caef991236e49856c178f735777decbb49d8f'],19,1698,1717,818474,22,0.640625,0.8515625,0.921875,2432
09725b4d35bb359d8fbe641da93b2ad5548a3b21,1,Aditya Toomula,2019-01-02 13:33:24-08:00,['0937c1dc040cabcf54846862bbb764cde83a6379'],268,455,723,819197,5,,,,2434
afdfd3c700fc88d9c190572c4ba6ff2fac387796,1,Aditya Toomula,2019-01-02 13:35:48-08:00,['09725b4d35bb359d8fbe641da93b2ad5548a3b21'],2,212,214,819411,6,0.702380952,1,1,2436
69895c34ad9746b7130a21e6d140980c395f06f0,0,Aditya Toomula,2019-01-04 15:44:19-08:00,['afdfd3c700fc88d9c190572c4ba6ff2fac387796'],8,9,17,819428,3,,,,2436
a60da1908c280e31a2403cf7ef9afdfd8b605163,1,Boris S,2019-01-07 09:55:23-08:00,['69895c34ad9746b7130a21e6d140980c395f06f0'],11,22,33,819461,1,,,,2436
3f8e97874372ea7bfabb919141213836ff59cf09,0,Boris S,2019-01-11 10:16:19-08:00,"['65ce8d3fc8f8ef825f092371f7aca10b923c4e53', 'a60da1908c280e31a2403cf7ef9afdfd8b605163']",1827,5605,7432,826893,170,,,,2436
612556660f3b80e6b4110dee3ad2392f9786379e,1,Prateek Maheshwari,2019-01-11 16:23:01-08:00,['a60da1908c280e31a2403cf7ef9afdfd8b605163'],539,1190,1729,828622,20,0.375426621,1,0.361774744,2436
7755506d895d7f03d1b905796536f5665a216b4a,0,Prateek Maheshwari,2019-01-12 14:38:16-08:00,['612556660f3b80e6b4110dee3ad2392f9786379e'],4,4,8,828630,1,,,,2436
5fbe3b5daf13c0a13dfcde1ac11ce151c6a05969,0,Wei Song,2019-01-14 16:15:17-08:00,"['9127d9270cac5b481ed8fb09ce7380c646bb8191', '7755506d895d7f03d1b905796536f5665a216b4a']",841,3644,4485,833115,54,,,,2436
54ba4c09fc625024cca145fa340e4ab06571bfcb,0,Shanthoosh Venkataraman,2019-01-14 20:48:12-08:00,['7755506d895d7f03d1b905796536f5665a216b4a'],0,28,28,833143,1,,,,2437
f16d85e1b58411fc921d9930a5df394e49a99bb1,0,Prateek Maheshwari,2019-01-15 08:27:34-08:00,['54ba4c09fc625024cca145fa340e4ab06571bfcb'],1,1,2,833145,1,,,,2437
61492988d26603ab25d39f18e19539be7a2a7845,1,Srinivasulu Punuru,2019-01-15 14:06:04-08:00,['f16d85e1b58411fc921d9930a5df394e49a99bb1'],9,67,76,833221,6,0.424242424,0.939393939,1,2437
130c474bb44e5641267d2df3e71b0e8093a75c8d,1,xiliu,2019-01-15 16:34:27-08:00,['61492988d26603ab25d39f18e19539be7a2a7845'],124,180,304,833525,2,0.727272727,1,0,2438
0c1e025180942189861f7a78a11844b647263a4b,0,xiliu,2019-01-15 17:54:22-08:00,['130c474bb44e5641267d2df3e71b0e8093a75c8d'],9,13,22,833547,7,,,,2438
5ff7f239f1b54af2862496fa9f7839d7c2656f56,0,Prateek Maheshwari,2019-01-16 10:26:07-08:00,['0c1e025180942189861f7a78a11844b647263a4b'],6,0,6,833553,1,,,,2438
0cb8cdbf08b2ed30e0a1c4a1b4fef7e5aaf76bf6,0,Prateek Maheshwari,2019-01-17 10:18:39-08:00,['5ff7f239f1b54af2862496fa9f7839d7c2656f56'],32,232,264,833817,11,0.385714286,0.957142857,0.528571429,2440
94ccc3229cbf29c02172b9a5ef114f856c9bde6c,0,Jagadish,2019-01-17 11:17:26-08:00,['0cb8cdbf08b2ed30e0a1c4a1b4fef7e5aaf76bf6'],0,333,333,834150,2,,,,2441
6bea33ccc85cac9dab1f40a77e9006c23f811bc4,0,Wei Song,2019-01-17 11:20:04-08:00,"['5fbe3b5daf13c0a13dfcde1ac11ce151c6a05969', '94ccc3229cbf29c02172b9a5ef114f856c9bde6c']",181,854,1035,835185,30,,,,2441
4289ca91d674fe69fa3f4ccd79dbf130b02fb6ef,1,Wei Song,2019-01-17 11:56:05-08:00,['94ccc3229cbf29c02172b9a5ef114f856c9bde6c'],371,1459,1830,837015,20,0.34244373,0.966237942,0.963022508,2449
f871463db6b2cb77f05038b9eabeae748ea6eaee,0,Wei Song,2019-01-17 11:57:20-08:00,"['6bea33ccc85cac9dab1f40a77e9006c23f811bc4', '4289ca91d674fe69fa3f4ccd79dbf130b02fb6ef']",371,1459,1830,838845,20,,,,2449
193fd272c931a09305ceced18205e6c4f7c311c7,0,Wei Song,2019-01-17 13:40:21-08:00,['4289ca91d674fe69fa3f4ccd79dbf130b02fb6ef'],2,2,4,838849,1,,,,2449
77fd2c307bf1bd75962696e8c9ad13a06a486a4b,0,Wei Song,2019-01-17 13:42:52-08:00,"['f871463db6b2cb77f05038b9eabeae748ea6eaee', '193fd272c931a09305ceced18205e6c4f7c311c7']",2,2,4,838853,1,,,,2449
cfedd59715260d8f2d2259ddad2ee1e1f7f28944,1,Jagadish,2019-01-17 14:06:00-08:00,['193fd272c931a09305ceced18205e6c4f7c311c7'],0,95,95,838948,1,1,1,1,2450
e753e33127f1f38d2ae29be92a411236cbe00830,0,Shanthoosh Venkataraman,2019-01-18 16:20:07-08:00,['cfedd59715260d8f2d2259ddad2ee1e1f7f28944'],11,72,83,839031,5,,,,2450
4301c2b4f3d922405e4dccb1c65bae819ed36bb0,1,Shanthoosh Venkataraman,2019-01-22 12:42:11-08:00,['e753e33127f1f38d2ae29be92a411236cbe00830'],0,91,91,839122,4,0.4,0.3,0.9,2450
759b7786aa016cf23960a481a1cfde6166dca2f8,1,Srinivasulu Punuru,2019-01-22 12:47:53-08:00,['4301c2b4f3d922405e4dccb1c65bae819ed36bb0'],494,691,1185,840307,32,0,0,0.375,2456
5ce320c26c0bebbccfcbaa6ed9e23b29d5ecd002,0,Shanthoosh Venkataraman,2019-01-22 12:53:04-08:00,['759b7786aa016cf23960a481a1cfde6166dca2f8'],80,123,203,840510,2,0.021505376,1,1,2456
3a2010604468769577bd6e541d5f0e47be322f6c,0,Shanthoosh Venkataraman,2019-01-22 12:55:48-08:00,['5ce320c26c0bebbccfcbaa6ed9e23b29d5ecd002'],0,106,106,840616,3,0.256410256,0.897435897,0.974358974,2457
1cac1c8e5b8ec903dc88c6d60673080885c5f34a,1,Prateek Maheshwari,2019-01-22 15:08:45-08:00,['3a2010604468769577bd6e541d5f0e47be322f6c'],49,346,395,841011,8,0.691729323,0.917293233,0.842105263,2459
18ebfce338ec3a51554a4303566ec706614de68a,0,Prateek Maheshwari,2019-01-22 16:20:29-08:00,['1cac1c8e5b8ec903dc88c6d60673080885c5f34a'],15,157,172,841183,3,0.48,0.48,1,2459
4a08a23ede22c55fb6770e9cff372747a0fb283c,0,Shanthoosh Venkataraman,2019-01-22 16:38:40-08:00,['18ebfce338ec3a51554a4303566ec706614de68a'],13,88,101,841284,4,0.727272727,0.045454545,0.045454545,2459
6a1e85eef298e3587b277bf5745d0b1d9962e4ec,0,Srinivasulu Punuru,2019-01-23 16:51:33-08:00,['4a08a23ede22c55fb6770e9cff372747a0fb283c'],71,71,142,841426,31,0,1,1,2459
8f338a8d36dd3aebc0b378bee0e86d507967fecc,0,Shanthoosh Venkataraman,2019-01-24 10:31:42-08:00,['6a1e85eef298e3587b277bf5745d0b1d9962e4ec'],1,1,2,841428,1,,,,2459
f11648b7925b44d8b9c6ff869fc64f097b60bad9,0,Wei Song,2019-01-24 10:58:36-08:00,"['77fd2c307bf1bd75962696e8c9ad13a06a486a4b', '8f338a8d36dd3aebc0b378bee0e86d507967fecc']",778,1885,2663,844091,91,,,,2459
1b5fec1d594e54d9d1e21833d281bf7bbb24ddc8,0,Jagadish,2019-01-24 16:25:53-08:00,['8f338a8d36dd3aebc0b378bee0e86d507967fecc'],52,323,375,844466,6,0.409638554,1,1,2462
5e28a658c529ade1c65e7ba801ec364ad442af22,0,Wei Song,2019-01-24 16:36:09-08:00,"['f11648b7925b44d8b9c6ff869fc64f097b60bad9', '1b5fec1d594e54d9d1e21833d281bf7bbb24ddc8']",52,323,375,844841,6,,,,2462
fa93d5b026172c7778c0f96039edb78767c5ce0c,0,Jagadish,2019-01-24 16:50:30-08:00,['1b5fec1d594e54d9d1e21833d281bf7bbb24ddc8'],1,0,1,844842,1,,,,2462
b8c8a15f4e8d78b78f5cf1b61afe65d3a3cd3c3d,0,Wei Song,2019-01-24 16:56:43-08:00,"['5e28a658c529ade1c65e7ba801ec364ad442af22', 'fa93d5b026172c7778c0f96039edb78767c5ce0c']",1,0,1,844843,1,,,,2462
09514cd9328bf3ead3e42ade746eb32b0f41eada,0,Prateek Maheshwari,2019-01-25 10:41:23-08:00,['fa93d5b026172c7778c0f96039edb78767c5ce0c'],7,22,29,844872,4,0.75,0.75,0.75,2462
ab694745d6eaed86a0f794803e36199a01a5ecbb,0,Boris S,2019-01-29 11:45:44-08:00,"['3f8e97874372ea7bfabb919141213836ff59cf09', '09514cd9328bf3ead3e42ade746eb32b0f41eada']",1921,5725,7646,852518,159,,,,2462
9f3a1e7f715ceea836cb1311fbbbf2bf21765d76,0,Wei Song,2019-01-30 12:41:51-08:00,"['b8c8a15f4e8d78b78f5cf1b61afe65d3a3cd3c3d', '09514cd9328bf3ead3e42ade746eb32b0f41eada']",7,22,29,852547,4,,,,2462
efc0dca50cd8e20cb22551a48f187e52bd6361eb,1,Shenoda Guirguis,2019-01-30 12:42:32-08:00,['09514cd9328bf3ead3e42ade746eb32b0f41eada'],42,230,272,852819,12,0.793103448,0.793103448,0.724137931,2464
fc23a1f3e68fbb6f82c7cdb43abe266ad87cf8b8,0,GitHub,2019-01-30 16:22:55-08:00,"['09514cd9328bf3ead3e42ade746eb32b0f41eada', 'efc0dca50cd8e20cb22551a48f187e52bd6361eb']",42,230,272,853091,12,,,,2464
0f37c006c1cfb5d05005a67e56fb428fff6c41b9,0,Wei Song,2019-01-30 18:12:38-08:00,['fc23a1f3e68fbb6f82c7cdb43abe266ad87cf8b8'],5,25,30,853121,5,0.857142857,1,1,2464
f9bb6681f7b5a9ea2f45796b6bf96b5eed118942,0,Weiqing Yang,2019-01-31 10:58:45-08:00,['0f37c006c1cfb5d05005a67e56fb428fff6c41b9'],177,612,789,853910,13,0.747311828,0.887096774,1,2469
7fcc444ba25588756bbf8cf0ebd221186f8aaa53,0,Weiqing Yang,2019-01-31 10:59:03-08:00,['f9bb6681f7b5a9ea2f45796b6bf96b5eed118942'],84,159,243,854153,7,1,1,1,2469
f768cc6387e88fede98a41dde6b4c986d3d7db28,0,Weiqing Yang,2019-01-31 10:59:15-08:00,['7fcc444ba25588756bbf8cf0ebd221186f8aaa53'],1,1,2,854155,1,,,,2469
11d255fd5ecd7d60b1adf9ff4d2674c745a22db9,0,Boris S,2019-01-31 11:43:34-08:00,"['ab694745d6eaed86a0f794803e36199a01a5ecbb', '0f37c006c1cfb5d05005a67e56fb428fff6c41b9']",47,255,302,854457,17,,,,2469
a492a1e484d7b35b48ed218868618bc55894850e,1,Weiqing Yang,2019-01-31 12:53:59-08:00,['f768cc6387e88fede98a41dde6b4c986d3d7db28'],318,201,519,854976,11,1,0.038095238,0.076190476,2469
4beaadd82e932294063edf117ace5fe154648e09,0,Weiqing Yang,2019-01-31 13:11:49-08:00,['a492a1e484d7b35b48ed218868618bc55894850e'],3,2,5,854981,1,,,,2469
4f78fe9f92af34a810fef357d0de91a5b37bc574,0,GitHub,2019-01-31 15:10:22-08:00,"['0f37c006c1cfb5d05005a67e56fb428fff6c41b9', '4beaadd82e932294063edf117ace5fe154648e09']",466,858,1324,856305,18,,,,2469
4597c58bf495f9f08abafa4b7f901d2e57908def,0,Weiqing Yang,2019-02-01 11:17:51-08:00,['4f78fe9f92af34a810fef357d0de91a5b37bc574'],4,9,13,856318,2,0,0,0,2469
70bb01e9b2d3e60487e9d6d4e8a570216bd5b328,0,GitHub,2019-02-01 11:38:09-08:00,"['4f78fe9f92af34a810fef357d0de91a5b37bc574', '4597c58bf495f9f08abafa4b7f901d2e57908def']",4,9,13,856331,2,,,,2469
057a90a544a03c3494d22cb43eff7b95a6450acd,0,Jagadish,2019-02-01 13:10:28-08:00,['70bb01e9b2d3e60487e9d6d4e8a570216bd5b328'],6,6,12,856343,4,,,,2469
e4f9731f0fac18938014ed2f3356866700f258c9,0,Daniel Chen,2019-02-01 16:01:50-08:00,['057a90a544a03c3494d22cb43eff7b95a6450acd'],2,3,5,856348,1,0,1,1,2469
93e6192a38304f83bff22c040768a672f4ce22a6,0,GitHub,2019-02-01 16:37:58-08:00,"['057a90a544a03c3494d22cb43eff7b95a6450acd', 'e4f9731f0fac18938014ed2f3356866700f258c9']",2,3,5,856353,1,,,,2469
edef5a2038b1c377f495fe4e4f4b6a1257bb18e5,0,Aditya Toomula,2019-02-04 16:14:37-08:00,['93e6192a38304f83bff22c040768a672f4ce22a6'],22,56,78,856431,7,0.722222222,0.722222222,1,2469
8c1821e5109c4b659c2fea08fa2cb268db3ec690,0,Wei Song,2019-02-05 14:22:03-08:00,"['9f3a1e7f715ceea836cb1311fbbbf2bf21765d76', 'edef5a2038b1c377f495fe4e4f4b6a1257bb18e5']",530,1170,1700,858131,43,,,,2469
4e5ffababfdc18ee41ba8af60f04a4d1755a7ad1,1,Wei Song,2019-02-05 17:19:56-08:00,['edef5a2038b1c377f495fe4e4f4b6a1257bb18e5'],19,184,203,858334,7,0.369863014,0.835616438,0.97260274,2470
88ce78f829d9b763e2a7c93dbe46350693c4d932,0,Aditya Toomula,2019-02-06 11:36:42-08:00,['4e5ffababfdc18ee41ba8af60f04a4d1755a7ad1'],5,7,12,858346,1,,,,2470
8b2f3402b22aa984e800ce128e1df56f24622dfd,0,Shanthoosh Venkataraman,2019-02-06 13:11:29-08:00,['93e6192a38304f83bff22c040768a672f4ce22a6'],24,39,63,858409,5,1,1,1,2470
8e277b0829a131b14348e2947d09e231e2ad3514,0,Shanthoosh Venkataraman,2019-02-06 14:02:52-08:00,['8b2f3402b22aa984e800ce128e1df56f24622dfd'],2,2,4,858413,2,,,,2470
5cea143e7e2bf742de2bf632cd07fdec1c6acb70,1,Srinivasulu Punuru,2019-02-06 16:21:12-08:00,['88ce78f829d9b763e2a7c93dbe46350693c4d932'],64,133,197,858610,6,0.346153846,1,1,2471
02b98dc1c62d4d9e265a9074b2971d97348189aa,0,Shanthoosh Venkataraman,2019-02-06 18:03:11-08:00,['8e277b0829a131b14348e2947d09e231e2ad3514'],46,6,52,858662,1,0,0,0,2471
9f32b52471902387250f244d205c72c711986f36,0,GitHub,2019-02-06 18:36:24-08:00,"['88ce78f829d9b763e2a7c93dbe46350693c4d932', '02b98dc1c62d4d9e265a9074b2971d97348189aa']",68,43,111,858773,5,,,,2471
a9ab7ab3d02f6b6a48fdb61589a1bbe46a4b6f70,0,strkkk,2019-02-07 13:38:35+03:00,['9f32b52471902387250f244d205c72c711986f36'],23,21,44,858817,3,0.5,0.5,0,2471
1bdbfc2b2b6fa710cdd1ca9f4a307a665e1877e4,0,GitHub,2019-02-07 09:00:42-08:00,"['9f32b52471902387250f244d205c72c711986f36', 'a9ab7ab3d02f6b6a48fdb61589a1bbe46a4b6f70']",23,21,44,858861,3,,,,2471
2619f642329a621bf0f8468e470efd48e4eefe0b,0,GitHub,2019-02-07 09:29:46-08:00,"['1bdbfc2b2b6fa710cdd1ca9f4a307a665e1877e4', '5cea143e7e2bf742de2bf632cd07fdec1c6acb70']",64,133,197,859058,6,,,,2471
01ec54dd6ed3c2e7a6558a42732ffd8a0e4e0dc8,1,GitHub,2019-02-11 14:08:47-08:00,['2619f642329a621bf0f8468e470efd48e4eefe0b'],81,234,315,859373,20,0.627118644,1,0.949152542,2472
c0eda3aa610b197bd1553cbe1818f869ac27d920,1,Shanthoosh Venkataraman,2019-02-12 08:20:24-08:00,['01ec54dd6ed3c2e7a6558a42732ffd8a0e4e0dc8'],272,858,1130,860503,18,0.233108108,0.652027027,0.85472973,2475
a4ee9505caaf1cf3d2744d4061461ca7951a7075,1,Shanthoosh Venkataraman,2019-02-12 08:20:24-08:00,['c0eda3aa610b197bd1553cbe1818f869ac27d920'],22,40,62,860565,5,0.083333333,0,1,2475
d8c61f62dbdc73a7cb01c147dbe6e6767d942fc6,1,Shanthoosh Venkataraman,2019-02-12 08:20:24-08:00,['a4ee9505caaf1cf3d2744d4061461ca7951a7075'],16,24,40,860605,2,1,0.5,0.5,2475
9677dce413109ec0f899d06a5603b3e1da637f20,0,Shanthoosh Venkataraman,2019-02-12 08:20:24-08:00,['d8c61f62dbdc73a7cb01c147dbe6e6767d942fc6'],12,16,28,860633,2,,,,2475
14958118220b143006b4ea0ae38422cba1ff8ae4,1,Shanthoosh Venkataraman,2019-02-12 08:23:04-08:00,['9677dce413109ec0f899d06a5603b3e1da637f20'],5,15,20,860653,2,0.285714286,0.428571429,1,2475
fab6356382643ba434ad454d0889c02fcfcc8992,0,GitHub,2019-02-12 10:27:19-08:00,"['01ec54dd6ed3c2e7a6558a42732ffd8a0e4e0dc8', '14958118220b143006b4ea0ae38422cba1ff8ae4']",276,902,1178,861831,18,,,,2475
509bee8668f69fa1cac1da1e1ebb30fad1b175a3,0,Jacob Maes,2019-02-13 07:14:52-08:00,['fab6356382643ba434ad454d0889c02fcfcc8992'],74,55,129,861960,8,1,0.157894737,0.157894737,2475
ad5497a6eb53febb8e45c75b8517e76aebfa7e0b,0,Jacob Maes,2019-02-13 07:39:13-08:00,['509bee8668f69fa1cac1da1e1ebb30fad1b175a3'],87,59,146,862106,11,1,1,0,2475
63abbd21ce500499ebd56bdb00a9e7ed48ded14d,1,GitHub,2019-02-13 11:18:48-08:00,['ad5497a6eb53febb8e45c75b8517e76aebfa7e0b'],42,100,142,862248,6,0.04,0,1,2475
551192f562ea067072bb5a56adc5a1a63189b73b,1,Aditya Toomula,2019-02-13 13:36:12-08:00,['63abbd21ce500499ebd56bdb00a9e7ed48ded14d'],75,127,202,862450,7,1,1,0.52173913,2475
7f6da82607e16ac5cb51db881cff512a0f2a8b9c,0,Jacob Maes,2019-02-14 06:47:05-08:00,['551192f562ea067072bb5a56adc5a1a63189b73b'],2,7,9,862459,1,1,1,1,2475
298c07ceaa8af94cdea3eb87fcfbb823c0897220,0,Jagadish,2019-02-15 18:49:07-08:00,['7f6da82607e16ac5cb51db881cff512a0f2a8b9c'],19,24,43,862502,3,,,,2475
c9083e843bdd4c219c1736aa855f106cd8d0c154,0,Jagadish,2019-02-19 13:48:56-08:00,['298c07ceaa8af94cdea3eb87fcfbb823c0897220'],2,2,4,862506,2,,,,2475
30b43d960aeed9a12dd04b4cd1f5b67c5858ba2d,0,GitHub,2019-02-20 13:23:38-08:00,['c9083e843bdd4c219c1736aa855f106cd8d0c154'],10,11,21,862527,4,1,1,0,2475
d5d0956b5ea861cf59e5733bc2851995495a1879,1,Aditya Toomula,2019-02-21 18:28:09-08:00,['30b43d960aeed9a12dd04b4cd1f5b67c5858ba2d'],20,64,84,862611,2,1,1,1,2476
5fcfc95ee168f1ff82496b11f70db918b1c42332,0,Aditya Toomula,2019-02-23 08:05:11-08:00,['d5d0956b5ea861cf59e5733bc2851995495a1879'],5,5,10,862621,2,0,0,1,2476
2c86eed8943096cab0bf99cdd037f1cfe48227b0,1,Aditya Toomula,2019-02-25 13:39:40-08:00,['5fcfc95ee168f1ff82496b11f70db918b1c42332'],6,10,16,862637,2,0,0,0,2476
725e973905e7936c1ae0ead66f975123496c4b16,1,Prateek Maheshwari,2019-02-25 17:33:03-08:00,['2c86eed8943096cab0bf99cdd037f1cfe48227b0'],128,99,227,862864,11,,,,2476
80524637ae3d9aa8be0e71b42c51d8b25d8e8efa,1,Jagadish,2019-02-25 18:17:07-08:00,['725e973905e7936c1ae0ead66f975123496c4b16'],12,77,89,862953,4,0.285714286,1,1,2476
ad861163baed1b919ce35f9aad74f5f064c6b638,0,Aditya Toomula,2019-02-26 08:28:37-08:00,['80524637ae3d9aa8be0e71b42c51d8b25d8e8efa'],2,3,5,862958,1,1,1,1,2476
f3c6f130018bf7c9f214c48091e69cbacce9c414,1,Prateek Maheshwari,2019-02-26 10:54:19-08:00,['ad861163baed1b919ce35f9aad74f5f064c6b638'],29,29,58,863016,16,1,0,0,2476
c49a218f7126b6cb45d61551bf94c83fa195f56b,0,GitHub,2019-02-28 15:24:37-08:00,['f3c6f130018bf7c9f214c48091e69cbacce9c414'],3,5,8,863024,1,0,0,0,2476
320359fe4aad6210f2eeb91d30e3a5117929ac4a,1,Aditya Toomula,2019-03-01 10:13:13-08:00,['c49a218f7126b6cb45d61551bf94c83fa195f56b'],307,628,935,863959,12,0.258241758,0.796703297,0.89010989,2476
e2b9a76fcba7488a4457907d3915c9a3cbf7cf51,1,Prateek Maheshwari,2019-03-04 12:35:05-08:00,['320359fe4aad6210f2eeb91d30e3a5117929ac4a'],57,943,1000,864959,19,0.509090909,0.756818182,0.527272727,2479
2a32e43947e851409915c73e3bd31d4e0ecf019f,0,Jagadish,2019-03-04 15:32:14-08:00,['e2b9a76fcba7488a4457907d3915c9a3cbf7cf51'],1,2,3,864962,2,,,,2479
3b8dc03b22bf37aeee192190daf26653de5d61ea,1,GitHub,2019-03-04 16:21:51-08:00,['2a32e43947e851409915c73e3bd31d4e0ecf019f'],40,133,173,865135,8,0.4,0.909090909,0.745454545,2479
f3d0dc7a263ed48f6f3ff6fad8bb9b5ea0b9adff,0,GitHub,2019-03-05 12:12:14-08:00,['3b8dc03b22bf37aeee192190daf26653de5d61ea'],8,130,138,865273,3,1,1,0.731707317,2480
d77533dcfb35fe1ef253978d9ccab9c039b13b98,0,xiliu,2019-03-05 18:40:39-08:00,['f3d0dc7a263ed48f6f3ff6fad8bb9b5ea0b9adff'],3,65,68,865341,2,0,1,1,2480
dace47b94e7d2c3ef1d171ab922035eaa7bb3fc9,1,Prateek Maheshwari,2019-03-06 10:39:05-08:00,['f3d0dc7a263ed48f6f3ff6fad8bb9b5ea0b9adff'],83,153,236,865577,9,1,0.857142857,0.285714286,2482
07eb8dff4e8bc69eea869dc4940d2e6321cbc860,0,xiliu,2019-03-06 10:55:29-08:00,['d77533dcfb35fe1ef253978d9ccab9c039b13b98'],0,6,6,865583,1,,,,2482
a96d4811291d9d31eabb417a0aed7e84fdd60ae6,0,GitHub,2019-03-06 12:14:35-08:00,"['dace47b94e7d2c3ef1d171ab922035eaa7bb3fc9', '07eb8dff4e8bc69eea869dc4940d2e6321cbc860']",3,71,74,865657,2,,,,2482
434705750a454d989f00a2f0afd15a2e20b4cf5b,0,xinyuiscool,2019-03-06 17:50:38-08:00,['a96d4811291d9d31eabb417a0aed7e84fdd60ae6'],76,231,307,865964,24,0.5,0.534090909,1,2483
7008e0d4130d429063493ce0bd413fe52d9463f1,0,Aditya Toomula,2019-03-08 12:21:20-08:00,['434705750a454d989f00a2f0afd15a2e20b4cf5b'],24,23,47,866011,8,1,1,0,2483
063f8833868c2ce04d79eb1723429f12622090a9,0,Jagadish,2019-03-08 15:09:14-08:00,['7008e0d4130d429063493ce0bd413fe52d9463f1'],3,2,5,866016,1,,,,2483
a6c4f41881c71a69af254d51dd94f173e5610e2c,0,shanthoosh,2019-03-08 15:16:08-08:00,['063f8833868c2ce04d79eb1723429f12622090a9'],3,6,9,866025,1,,,,2483
02a3d6a62fd77b00316b1b92c76713687320d24e,1,Prateek Maheshwari,2019-03-11 17:35:33-07:00,['a6c4f41881c71a69af254d51dd94f173e5610e2c'],19,98,117,866142,5,1,1,0.411764706,2484
9c38011d5ea9d0871bbeaa8e3351ca8d63abb915,0,GitHub,2019-03-12 08:23:03-07:00,['02a3d6a62fd77b00316b1b92c76713687320d24e'],4,4,8,866150,4,,,,2484
8dea84c944540884d6609be9e1c0a8f93aadb6ab,0,xiliu,2019-03-12 12:20:07-07:00,['9c38011d5ea9d0871bbeaa8e3351ca8d63abb915'],12,39,51,866201,7,0.1,1,1,2484
6711a9f9d6dd121c6740c026dcdc486aff173cea,0,shanthoosh,2019-03-12 13:10:01-07:00,['8dea84c944540884d6609be9e1c0a8f93aadb6ab'],104,434,538,866739,8,,,,2488
c29978b8cdfbaf445bb7e3ef34260c1df5e3256a,0,Boris S,2019-03-13 11:15:53-07:00,"['11d255fd5ecd7d60b1adf9ff4d2674c745a22db9', '6711a9f9d6dd121c6740c026dcdc486aff173cea']",2190,5924,8114,874853,234,,,,2488
3e3713cb749ea6bc294f5064d829233da062eb37,0,GitHub,2019-03-15 18:24:05-07:00,['6711a9f9d6dd121c6740c026dcdc486aff173cea'],0,1,1,874854,1,,,,2488
275d7570bc65aa3a0592ea3a6ec4063b91c4b222,0,GitHub,2019-03-18 15:13:01-07:00,['3e3713cb749ea6bc294f5064d829233da062eb37'],23,75,98,874952,6,0.615384615,0,0.807692308,2488
9d0b9a6f12e5e2d34553cf43b2fa2baf5fb1d223,0,Jagadish,2019-03-18 22:28:10-07:00,['275d7570bc65aa3a0592ea3a6ec4063b91c4b222'],2,5,7,874959,2,,,,2488
0a0d0814a5f324503631ea41fe4987c856f8fab3,0,Jagadish,2019-03-19 10:50:58-07:00,['9d0b9a6f12e5e2d34553cf43b2fa2baf5fb1d223'],27,61,88,875047,7,0,1,1,2488
4e2cabc1e5e46f67f666e09ac3d8146041aaff4c,1,GitHub,2019-03-19 15:06:25-07:00,['0a0d0814a5f324503631ea41fe4987c856f8fab3'],9,31,40,875087,1,0,1,1,2488
0967398dae1825d8d72786910a7471f7b3f40346,0,GitHub,2019-03-19 15:06:53-07:00,['4e2cabc1e5e46f67f666e09ac3d8146041aaff4c'],86,365,451,875538,3,0.852348993,1,0.919463087,2488
98355db1c61e92ceeb64b839f554733ad993f7d0,0,shanthoosh,2019-03-19 15:07:09-07:00,['0967398dae1825d8d72786910a7471f7b3f40346'],2,101,103,875641,3,1,1,0.48,2489
70b07bdbed605547408a153f491beb5309f68e30,0,Dengpan Yin,2019-03-19 15:30:32-07:00,['98355db1c61e92ceeb64b839f554733ad993f7d0'],6,77,83,875724,4,0.536585366,0.390243902,0.585365854,2489
abe35dfd64b34dc64f779c1bc1dce088835e15d2,1,xinyuiscool,2019-03-19 17:20:59-07:00,['98355db1c61e92ceeb64b839f554733ad993f7d0'],26,30,56,875780,13,,,,2489
55ce28850090dbb8fe410b9953eed35be062dcc7,0,Prateek Maheshwari,2019-03-20 10:39:35-07:00,['abe35dfd64b34dc64f779c1bc1dce088835e15d2'],16,46,62,875842,3,0.764705882,1,1,2489
380c9762e683d2c755b7d85f484e338d846132a7,1,Jagadish,2019-03-20 12:52:01-07:00,['55ce28850090dbb8fe410b9953eed35be062dcc7'],175,104,279,876121,19,0.918032787,0.06557377,0.049180328,2489
45bf7c2108fb63d6ad4152fb5cd117187c3c747e,0,GitHub,2019-03-20 15:19:32-07:00,['380c9762e683d2c755b7d85f484e338d846132a7'],25,123,148,876269,7,1,1,1,2491
8387ca48a887a14d27e599dee9b04ed379319bf1,0,Jagadish,2019-03-20 16:04:39-07:00,['45bf7c2108fb63d6ad4152fb5cd117187c3c747e'],2,181,183,876452,3,,,,2493
43f0f012bf6c3a0d56116015a8e4818b65a18bb0,0,shanthoosh,2019-03-21 14:04:55-07:00,['8387ca48a887a14d27e599dee9b04ed379319bf1'],1,1,2,876454,1,,,,2493
a150d31581f2a19d188a56ff90e207ff661cbbdd,0,Jagadish,2019-03-22 10:59:24-07:00,['43f0f012bf6c3a0d56116015a8e4818b65a18bb0'],1,1,2,876456,1,,,,2493
8db83fa92800549c67d94fcff9f7411372bfcd0a,0,shanthoosh,2019-03-22 17:13:05-07:00,['a150d31581f2a19d188a56ff90e207ff661cbbdd'],0,1,1,876457,1,,,,2493
1ce9a7997a86595d4e404a344145b90cd654ec86,1,GitHub,2019-03-22 19:44:00-07:00,['8db83fa92800549c67d94fcff9f7411372bfcd0a'],0,302,302,876759,2,,,,2495
65d09d7b383be907e3f712af4a28f70895a3165f,0,GitHub,2019-03-22 20:20:45-07:00,['1ce9a7997a86595d4e404a344145b90cd654ec86'],17,21,38,876797,1,,,,2495
f0fc4818a8241b3dd6c97a5654c2c1732ae9c380,1,GitHub,2019-03-25 10:54:05-07:00,['65d09d7b383be907e3f712af4a28f70895a3165f'],66,78,144,876941,1,0.75,0.625,0.25,2495
e1ef7a0c8882d7bcf18b57fd6e9f71076d5df247,0,Prateek Maheshwari,2019-03-25 15:49:52-07:00,['f0fc4818a8241b3dd6c97a5654c2c1732ae9c380'],21,1,22,876963,5,0,0,0,2495
0b3089a2be765f2a51fcccc31dcffa6d44bc08f8,0,GitHub,2019-03-25 16:07:19-07:00,['e1ef7a0c8882d7bcf18b57fd6e9f71076d5df247'],5,5,10,876973,1,,,,2495
a74b500d3c1d28a55c596aa813866d8415b8a2b4,0,GitHub,2019-03-25 18:58:45-07:00,['0b3089a2be765f2a51fcccc31dcffa6d44bc08f8'],19,49,68,877041,1,,,,2495
28e19311d7459d0a3cc407e820f3628d95fb1b1b,0,GitHub,2019-03-25 19:57:30-07:00,['a74b500d3c1d28a55c596aa813866d8415b8a2b4'],16,14,30,877071,1,,,,2495
f319db519168cf06de14232de99ef0cf38fdb9f7,0,shanthoosh,2019-03-26 11:23:29-07:00,['28e19311d7459d0a3cc407e820f3628d95fb1b1b'],343,493,836,877907,34,0.630769231,0.984615385,0.938461538,2497
4e94b9d52fd2dd98e355ff06bc661d3d60fe75f3,0,Jacob Maes,2019-03-26 15:11:45-07:00,['f319db519168cf06de14232de99ef0cf38fdb9f7'],12,7,19,877926,2,,,,2497
1ffe917f3e5e9f39ed51d61798cf9bf160b422ea,0,GitHub,2019-03-26 17:52:44-07:00,['4e94b9d52fd2dd98e355ff06bc661d3d60fe75f3'],1,2,3,877929,2,,,,2497
a33cd6ded8ac2b3516b8ab514fac721b1a01bf46,0,dyin,2019-03-26 18:39:00-07:00,['70b07bdbed605547408a153f491beb5309f68e30'],15,15,30,877959,3,,,,2497
87367975c693c4a06f5e56332374c7f95d39eb29,1,Jagadish,2019-03-26 19:11:33-07:00,['1ffe917f3e5e9f39ed51d61798cf9bf160b422ea'],108,133,241,878200,2,0.5,0,0.541666667,2497
0000dfc93457dfb7973947ec0b27be6bee42057e,1,Aditya Toomula,2019-03-27 11:50:34-07:00,['87367975c693c4a06f5e56332374c7f95d39eb29'],4,2,6,878206,1,1,0,1,2497
01c06055057e8c260e73bf3f7db7b9eb53af3745,1,shanthoosh,2019-03-27 23:00:54-07:00,['0000dfc93457dfb7973947ec0b27be6bee42057e'],5589,688,6277,884483,57,0.575436409,0.089775561,0.135286783,2498
cb410d2e14de85064e74cedacc1472f15f7d968c,1,GitHub,2019-03-28 16:43:13-07:00,['01c06055057e8c260e73bf3f7db7b9eb53af3745'],50,81,131,884614,7,0.409090909,0.5,0.909090909,2498
4aaa589cdd22250719c5c30a19f4f95f4c327110,0,shanthoosh,2019-03-28 23:50:56-07:00,['cb410d2e14de85064e74cedacc1472f15f7d968c'],9,24,33,884647,4,0.714285714,0.714285714,1,2498
ccae8f992007cec2f960bd1608b0c61539ec9a42,0,Prateek Maheshwari,2019-04-03 11:56:24-07:00,['4aaa589cdd22250719c5c30a19f4f95f4c327110'],30,50,80,884727,2,0.2,0,1,2498
1b267f70b0db9222e2002c18f831ec23a6f08c42,1,Jagadish,2019-04-03 12:21:00-07:00,['ccae8f992007cec2f960bd1608b0c61539ec9a42'],326,1168,1494,886221,45,0.555944056,0.874125874,0.723776224,2508
4afeb51cd3a3a2f68e1c76fbff14ef24f856eb96,0,GitHub,2019-04-03 14:32:26-07:00,['1b267f70b0db9222e2002c18f831ec23a6f08c42'],4,2,6,886227,1,0,0,0,2508
4d3cd5ca56b232fc8eda631f5c79add26e966952,1,Prateek Maheshwari,2019-04-03 16:24:13-07:00,['4afeb51cd3a3a2f68e1c76fbff14ef24f856eb96'],702,611,1313,887540,33,0,0.1,1,2508
5b9e4a8bcd88c97b50d2229b52950c7c18a2235e,1,GitHub,2019-04-08 14:36:52-07:00,['4d3cd5ca56b232fc8eda631f5c79add26e966952'],370,694,1064,888604,24,0.882352941,1,1,2512
f260be6be5bb184073a2187edc5898b6cba7dea1,1,Prateek Maheshwari,2019-04-09 11:24:16-07:00,['5b9e4a8bcd88c97b50d2229b52950c7c18a2235e'],93,3,96,888700,3,,,,2512
7acb4053aaa6ab05236fd16ac03d38e25a9d219e,0,Prateek Maheshwari,2019-04-09 14:24:37-07:00,['f260be6be5bb184073a2187edc5898b6cba7dea1'],1,6,7,888707,1,0,1,1,2512
b0caee8e2316b0592620d2d6dccdebe78acde2d4,0,GitHub,2019-04-11 16:55:30-07:00,['7acb4053aaa6ab05236fd16ac03d38e25a9d219e'],8,11,19,888726,1,0,0,0,2512
450e1050389a538f5152cbb7ee9a58668e7667d8,1,xinyuiscool,2019-04-12 15:38:12-07:00,['b0caee8e2316b0592620d2d6dccdebe78acde2d4'],288,365,653,889379,19,0.479166667,0.979166667,1,2512
2aced584edb8ae52cf09e7fc0fb66d1ba562d9be,0,GitHub,2019-04-12 17:42:54-07:00,['450e1050389a538f5152cbb7ee9a58668e7667d8'],7,5,12,889391,1,0.333333333,0,0,2512
b0c6283f3ae4acee65efcaecd204aeb804a7f580,0,Prateek Maheshwari,2019-04-15 13:48:19-07:00,['2aced584edb8ae52cf09e7fc0fb66d1ba562d9be'],32,57,89,889480,5,,,,2514
da6c28be82c04a00cafff3360922cd89435e6222,1,Jagadish,2019-04-15 17:30:34-07:00,['b0c6283f3ae4acee65efcaecd204aeb804a7f580'],0,24,24,889504,2,0.666666667,1,1,2514
8277cff803e0d765f41bd5816d689f77ab275ed1,0,GitHub,2019-04-16 17:05:45-07:00,['da6c28be82c04a00cafff3360922cd89435e6222'],0,28,28,889532,1,,,,2515
d78844753c4aeb37883fa37a57351787d50f1fe3,0,xinyuiscool,2019-04-17 13:26:04-07:00,['8277cff803e0d765f41bd5816d689f77ab275ed1'],46,42,88,889620,1,1,1,0,2515
1322cb5d0312be3aa36c568604a7645ba357f3e8,0,Jagadish,2019-04-17 17:52:51-07:00,['d78844753c4aeb37883fa37a57351787d50f1fe3'],1,1,2,889622,1,,,,2515
cc9acb2ee7c64214e21bf46791c74d137594d940,0,shanthoosh,2019-04-18 17:32:29-07:00,['1322cb5d0312be3aa36c568604a7645ba357f3e8'],1,7,8,889630,1,0,1,1,2515
461a090273667322da500829538a2e79dd619e96,0,Prateek Maheshwari,2019-04-18 18:24:31-07:00,['cc9acb2ee7c64214e21bf46791c74d137594d940'],14,27,41,889671,3,,,,2515
36bdc0759d4333bbda36ec349af712a6c766edfc,0,Prateek Maheshwari,2019-04-19 10:16:10-07:00,['461a090273667322da500829538a2e79dd619e96'],7,5,12,889683,1,1,1,1,2515
c6e50a5117b78d2fae570f5286ceec108a59ecc8,1,Prateek Maheshwari,2019-04-19 16:26:35-07:00,['36bdc0759d4333bbda36ec349af712a6c766edfc'],35,109,144,889827,7,0.702702703,0,0,2515
709706a7807536c1561f63de0fe75db92721db3e,0,Prateek Maheshwari,2019-04-22 10:43:48-07:00,['c6e50a5117b78d2fae570f5286ceec108a59ecc8'],31,56,87,889914,7,0.166666667,1,1,2515
130ece536f462e0c0b47b104366e9a52fb967ae0,0,GitHub,2019-04-24 10:57:25-07:00,['709706a7807536c1561f63de0fe75db92721db3e'],1,13,14,889928,2,1,1,1,2515
a0b150cb35c46d089ed3d10987ff805c2e861438,1,Wei Song,2019-04-25 08:22:07-07:00,['130ece536f462e0c0b47b104366e9a52fb967ae0'],27,103,130,890058,8,0.489795918,1,0.959183673,2515
599a58ee5e16d22d9b110c628ec593c0f93307db,0,xinyuiscool,2019-04-25 15:43:15-07:00,['a0b150cb35c46d089ed3d10987ff805c2e861438'],607,68,675,890733,16,0.649350649,0.311688312,0.532467532,2515
23a908b3b1caf9d2ac1db3969d341228bbd4c6aa,0,cameronlee314,2019-04-25 16:05:29-07:00,['599a58ee5e16d22d9b110c628ec593c0f93307db'],2,2,4,890737,1,,,,2515
e874072fb25bcb98d36f475bf996539284679b1f,1,Wei Song,2019-04-25 18:33:45-07:00,['23a908b3b1caf9d2ac1db3969d341228bbd4c6aa'],1,1517,1518,892255,13,0.635114504,0.899236641,0.896183206,2524
2f04b982fa1b61349a1985f9c1194b9a19e41a0f,0,Boris S,2019-04-26 14:22:14-07:00,"['c29978b8cdfbaf445bb7e3ef34260c1df5e3256a', 'e874072fb25bcb98d36f475bf996539284679b1f']",9019,7730,16749,909004,319,,,,2524
997c9f26f72b39e20078b39e29c8f79d345c9e74,1,GitHub,2019-04-27 09:44:57-07:00,['e874072fb25bcb98d36f475bf996539284679b1f'],4,13,17,909021,1,0,1,1,2524
1cbb6c9c9d88e9d3aff59a1e0ad10cc7c1d5f9d5,1,Prateek Maheshwari,2019-04-29 16:23:19-07:00,['997c9f26f72b39e20078b39e29c8f79d345c9e74'],13,15,28,909049,4,,,,2524
ab726187a66ed6ee8c65a58a14c1b9254b1d84fc,1,cameronlee314,2019-04-30 09:35:43-07:00,['1cbb6c9c9d88e9d3aff59a1e0ad10cc7c1d5f9d5'],43,139,182,909231,7,1,1,1,2526
627debe7817a80e2cbebec70d908caea047020e3,0,Boris S,2019-04-30 16:01:44-07:00,"['2f04b982fa1b61349a1985f9c1194b9a19e41a0f', 'ab726187a66ed6ee8c65a58a14c1b9254b1d84fc']",60,167,227,909458,12,,,,2526
5c1fe6872de1b9409b7dd05e0a61320bace6d065,0,Wei Song,2019-05-02 11:31:20-07:00,['ab726187a66ed6ee8c65a58a14c1b9254b1d84fc'],0,4,4,909462,1,,,,2526
12e426345da6d2cc1d4f8d8ae234f0e8514ca093,0,Wei Song,2019-05-02 11:34:48-07:00,['5c1fe6872de1b9409b7dd05e0a61320bace6d065'],1,7,8,909470,1,1,1,0,2526
fca84373f9d45d3409e1996f32d1070c08129813,0,cameronlee314,2019-05-02 15:24:22-07:00,['12e426345da6d2cc1d4f8d8ae234f0e8514ca093'],21,82,103,909573,1,1,1,0.6,2526
b5abcf2652acfa904c86dd80a5a69722d759ded0,0,Wei Song,2019-05-03 08:52:16-07:00,"['8c1821e5109c4b659c2fea08fa2cb268db3ec690', 'fca84373f9d45d3409e1996f32d1070c08129813']",10437,12628,23065,932638,460,,,,2526
1531762074e1c83c1ee72891f210c6ba25579865,0,Wei Song,2019-05-03 14:42:32-07:00,['fca84373f9d45d3409e1996f32d1070c08129813'],0,33,33,932671,1,1,1,1,2526
1fbca051956898cd7dc51fe0cf4e43acd5b51ddc,1,shanthoosh,2019-05-03 16:54:04-07:00,['1531762074e1c83c1ee72891f210c6ba25579865'],3,71,74,932745,4,0.473684211,1,1,2526
22b8b3b97bed32e794e21c1929346753c5363500,1,GitHub,2019-05-08 09:24:29-07:00,['1fbca051956898cd7dc51fe0cf4e43acd5b51ddc'],432,570,1002,933747,28,0.867256637,0.601769912,0.876106195,2528
d931c3433347e37b38c8d033c186fde6add040bd,1,shanthoosh,2019-05-08 09:26:17-07:00,['22b8b3b97bed32e794e21c1929346753c5363500'],33,71,104,933851,4,1,1,0,2529
2d07cfdaf36a33aaeed08d13cdb48c28b4f30bc8,0,GitHub,2019-05-08 09:50:00-07:00,['d931c3433347e37b38c8d033c186fde6add040bd'],590,460,1050,934901,17,0.096774194,0,0.274193548,2529
edaaec29932d8f5885b015032615cb839f73761f,0,GitHub,2019-05-08 15:14:55-07:00,['2d07cfdaf36a33aaeed08d13cdb48c28b4f30bc8'],38,5,43,934944,4,0.230769231,0.230769231,0.230769231,2529
074af509ee6a9e8985dd1b53d9a8f351c350a2da,0,Hai Lu,2019-05-08 15:47:06-07:00,['ab726187a66ed6ee8c65a58a14c1b9254b1d84fc'],4,7,11,934955,1,1,1,1,2529
284ff268bb94c0aef6a03c6353d4849f0f1cb0b4,0,GitHub,2019-05-08 17:15:17-07:00,"['edaaec29932d8f5885b015032615cb839f73761f', '074af509ee6a9e8985dd1b53d9a8f351c350a2da']",4,7,11,934966,1,,,,2529
22bd3acd8ddcc7292599d0f98228b3e8d052db71,0,Wei Song,2019-05-09 10:50:40-07:00,"['b5abcf2652acfa904c86dd80a5a69722d759ded0', '284ff268bb94c0aef6a03c6353d4849f0f1cb0b4']",1076,1193,2269,937235,57,,,,2529
55e9f045f894f32a28e1bbaff85989d2a22cd81f,0,Wei Song,2019-05-09 11:06:30-07:00,['284ff268bb94c0aef6a03c6353d4849f0f1cb0b4'],2,0,2,937237,2,,,,2529
aefd705cbd27cb69dcef5af46928bd03fd864a63,0,cameronlee314,2019-05-09 13:19:47-07:00,['55e9f045f894f32a28e1bbaff85989d2a22cd81f'],1,1,2,937239,1,,,,2529
7aa619564f740ebe5540ad37c13fe8da2550c2ac,0,GitHub,2019-05-10 09:02:10-07:00,['aefd705cbd27cb69dcef5af46928bd03fd864a63'],501,0,501,937740,1,0.821818182,0.654545455,0.509090909,2529
3a3b30058273fde19621bbd13fe24690145fed72,0,Boris S,2019-05-10 10:07:04-07:00,"['627debe7817a80e2cbebec70d908caea047020e3', '7aa619564f740ebe5540ad37c13fe8da2550c2ac']",1602,1287,2889,940629,64,,,,2529
a73414a03ffc9eb713f53500a5520309e562cb36,0,GitHub,2019-05-10 20:17:46-07:00,['7aa619564f740ebe5540ad37c13fe8da2550c2ac'],29,159,188,940817,5,0,0.776859504,1,2529
3373012c63ce389d0d980260650b9f3ecca642f3,0,Wei Song,2019-05-14 10:22:05-07:00,"['22bd3acd8ddcc7292599d0f98228b3e8d052db71', 'a73414a03ffc9eb713f53500a5520309e562cb36']",533,160,693,941510,9,,,,2529
077af8572b401af3c35a4a33870dafeed067c57f,0,GitHub,2019-05-14 10:47:24-07:00,"['a73414a03ffc9eb713f53500a5520309e562cb36', 'a33cd6ded8ac2b3516b8ab514fac721b1a01bf46']",6,77,83,941593,4,,,,2529
60b42d6bd3ce2baa0b7a2bb69ef9bee760d3ae08,0,Wei Song,2019-05-14 10:48:30-07:00,"['3373012c63ce389d0d980260650b9f3ecca642f3', '077af8572b401af3c35a4a33870dafeed067c57f']",6,77,83,941676,4,,,,2529
df36b4288a8f5bb3e254f944187417e764c05cba,0,dyin,2019-05-14 18:05:27-07:00,['077af8572b401af3c35a4a33870dafeed067c57f'],2,5,7,941683,2,0.333333333,1,1,2529
c4afc2e1790ca4210c5f60b2de36a1b9ea471250,0,GitHub,2019-05-14 19:22:15-07:00,"['077af8572b401af3c35a4a33870dafeed067c57f', 'df36b4288a8f5bb3e254f944187417e764c05cba']",2,5,7,941690,2,,,,2529
fc2d5b9926abe459a70a056060f779f6a1933ead,0,Wei Song,2019-05-15 16:49:01-07:00,"['60b42d6bd3ce2baa0b7a2bb69ef9bee760d3ae08', 'c4afc2e1790ca4210c5f60b2de36a1b9ea471250']",2,5,7,941697,2,,,,2529
2a589fcc8b13c0a90f65210185dc86e3dec824e9,0,GitHub,2019-05-15 17:22:40-07:00,['c4afc2e1790ca4210c5f60b2de36a1b9ea471250'],6,181,187,941884,2,0.521276596,1,0.989361702,2529
d7b5034dde2bf28c3ba2d127237b71a3fb98b343,0,shanthoosh,2019-05-15 18:18:39-07:00,['2a589fcc8b13c0a90f65210185dc86e3dec824e9'],0,1,1,941885,1,,,,2529
18540723a231e2d259553f69b409fe0675c6aacf,0,Wei Song,2019-05-16 10:03:48-07:00,['fc2d5b9926abe459a70a056060f779f6a1933ead'],5,6,11,941896,3,,,,2529
57cce597c983723f7f824449b17f592a790fd0ac,0,GitHub,2019-05-16 10:17:06-07:00,"['d7b5034dde2bf28c3ba2d127237b71a3fb98b343', '18540723a231e2d259553f69b409fe0675c6aacf']",5,6,11,941907,3,,,,2529
f753d607ab38fa0691b4d2f6ed380d13903c527e,1,GitHub,2019-05-16 16:27:40-07:00,['57cce597c983723f7f824449b17f592a790fd0ac'],1003,1802,2805,944712,36,0.6375,1,0.6375,2531
063a819e7c7faff8b9677991a8a2e5f285f17a1d,1,shanthoosh,2019-05-17 09:46:09-07:00,['f753d607ab38fa0691b4d2f6ed380d13903c527e'],556,679,1235,945947,14,0.595505618,0.235955056,1,2534
bf97458ad19835b8d80fc7a9a3a21a287b437bff,0,Boris S,2019-05-17 10:22:54-07:00,"['3a3b30058273fde19621bbd13fe24690145fed72', '063a819e7c7faff8b9677991a8a2e5f285f17a1d']",1603,2906,4509,950456,61,,,,2534
4e79a60d3e3ad29f383c12a1df2f66df062814e6,0,Boris S,2019-05-17 10:28:23-07:00,['bf97458ad19835b8d80fc7a9a3a21a287b437bff'],0,37,37,950493,1,,,,2534
17a295c3ff6945be1ab92bea3b0f24419520b2e5,0,GitHub,2019-05-17 10:48:37-07:00,"['063a819e7c7faff8b9677991a8a2e5f285f17a1d', '4e79a60d3e3ad29f383c12a1df2f66df062814e6']",0,37,37,950530,1,,,,2534
1772177bf4e3c93308028fcf3f3f821c9d4a6ea6,0,GitHub,2019-05-20 09:49:32-07:00,['17a295c3ff6945be1ab92bea3b0f24419520b2e5'],196,155,351,950881,12,1,0,0.705882353,2534
f847b8df1b32ff80ac059a310de7c10330cc4d27,1,GitHub,2019-05-21 18:34:36-07:00,['1772177bf4e3c93308028fcf3f3f821c9d4a6ea6'],5,9,14,950895,1,0,0,0,2534
c087f80cfe2ae576f30585894a5d907f7c5b2cee,1,Prateek Maheshwari,2019-05-22 09:36:28-07:00,['f847b8df1b32ff80ac059a310de7c10330cc4d27'],47,166,213,951108,6,0.090909091,0.745454545,0.745454545,2535
6d5f4461d0fa2485ea1274d051f57c5983df5f2e,1,Jagadish,2019-05-22 14:09:08-07:00,['c087f80cfe2ae576f30585894a5d907f7c5b2cee'],158,1323,1481,952589,21,0.545454545,0.835664336,0.917832168,2541
933ce10d8c929a729ac2fec23c4337f99440686f,1,Wei Song,2019-05-22 14:59:12-07:00,['6d5f4461d0fa2485ea1274d051f57c5983df5f2e'],6,2127,2133,954722,29,0.704656863,0.93627451,0.860294118,2561
c78dbf8cc448df72d417d9f8261fa7956c061e41,1,Hai Lu,2019-05-22 15:00:02-07:00,['1772177bf4e3c93308028fcf3f3f821c9d4a6ea6'],10,109,119,954841,4,0.375,1,1,2561
f6e01182245cdcd3c53a0871bb9b41a40065b23d,0,GitHub,2019-05-22 17:11:31-07:00,"['933ce10d8c929a729ac2fec23c4337f99440686f', 'c78dbf8cc448df72d417d9f8261fa7956c061e41']",10,109,119,954960,4,,,,2561
5f8b6d47affbf1c8a101ec0f8c70e8641437c805,1,shanthoosh,2019-05-23 13:35:52-07:00,['f6e01182245cdcd3c53a0871bb9b41a40065b23d'],15,364,379,955339,8,0.17816092,0.879310345,1,2563
66f29e8287ae0f673a75b65db9c10db8e58819dc,1,Prateek Maheshwari,2019-05-23 16:41:30-07:00,['5f8b6d47affbf1c8a101ec0f8c70e8641437c805'],323,675,998,956337,38,0.012121212,0.709090909,0.345454545,2565
e65bcf926dbeebc339630a18fa2c7a53bbd9172b,0,GitHub,2019-05-24 10:24:47-07:00,['66f29e8287ae0f673a75b65db9c10db8e58819dc'],14,29,43,956380,2,0,1,0,2565
3da0d06b4ba0a2a3550929c53729c9a2dd3954cd,1,shanthoosh,2019-05-28 09:44:40-07:00,['e65bcf926dbeebc339630a18fa2c7a53bbd9172b'],8,4,12,956392,2,1,1,1,2565
e7e2077984106fb698afe0e6f267aee02451ae75,0,GitHub,2019-05-28 10:18:02-07:00,['3da0d06b4ba0a2a3550929c53729c9a2dd3954cd'],58,76,134,956526,12,0,0,0,2566
22f16da04b082a05273a354c59a9364632d74826,0,Prateek Maheshwari,2019-05-28 12:41:51-07:00,['e7e2077984106fb698afe0e6f267aee02451ae75'],3,103,106,956632,3,,,,2566
dc882e547793108d975a23905b1e8b2e8b166dbd,0,GitHub,2019-05-28 14:04:09-07:00,['22f16da04b082a05273a354c59a9364632d74826'],79,325,404,957036,8,0.934782609,1,0.673913043,2568
21608cb8c2d115a32fd94adaaea2af7d69d3c689,0,Prateek Maheshwari,2019-05-28 15:16:37-07:00,['dc882e547793108d975a23905b1e8b2e8b166dbd'],52,78,130,957166,17,1,1,1,2568
55f60df0e272e205b2daf443fb2ec38c6e7ffd65,1,GitHub,2019-05-28 17:06:50-07:00,['21608cb8c2d115a32fd94adaaea2af7d69d3c689'],2,3,5,957171,2,1,1,0,2568
fee823bdae90d60094806a0b48668b8abd21bb5f,0,shanthoosh,2019-05-30 10:30:38-07:00,['55f60df0e272e205b2daf443fb2ec38c6e7ffd65'],141,124,265,957436,4,1,0.238938053,0,2568
7aef672c65bcbdc0b330291d680299c325674f14,1,GitHub,2019-05-30 11:19:46-07:00,['fee823bdae90d60094806a0b48668b8abd21bb5f'],0,74,74,957510,2,0.679245283,1,1,2568
bd647bb152f981f3fe32a1ee3914ae8852cdb1ab,0,Prateek Maheshwari,2019-05-30 11:42:31-07:00,['7aef672c65bcbdc0b330291d680299c325674f14'],2,2,4,957514,2,,,,2568
8bb6e5fd2c7f756b790a4dca151ac506e208d52d,0,Prateek Maheshwari,2019-05-31 14:03:15-07:00,['bd647bb152f981f3fe32a1ee3914ae8852cdb1ab'],2,10,12,957526,1,,,,2568
e1a72750abe2735b1bfe128a7531b62d6b7781cc,0,Prateek Maheshwari,2019-05-31 14:04:03-07:00,['8bb6e5fd2c7f756b790a4dca151ac506e208d52d'],2,2,4,957530,2,,,,2568
cc1bb19c175835e823dcce6bc0b0061c2e015af0,0,Cameron Lee,2019-05-31 17:47:06-07:00,['e1a72750abe2735b1bfe128a7531b62d6b7781cc'],8,8,16,957546,8,,,,2568
1947f71388babe31979eee83cd3ec596f66dffaa,0,GitHub,2019-06-03 10:58:37-07:00,['cc1bb19c175835e823dcce6bc0b0061c2e015af0'],0,501,501,958047,1,0.178181818,0.345454545,0.490909091,2569
43819f4746a4cd01b2ece2a65d892fb8a30978e0,0,Jagadish,2019-06-03 11:11:36-07:00,['1947f71388babe31979eee83cd3ec596f66dffaa'],5,5,10,958057,1,,,,2569
07cdbdcdf69833661009e1d5735177667c93607b,1,Prateek Maheshwari,2019-06-03 17:28:14-07:00,['43819f4746a4cd01b2ece2a65d892fb8a30978e0'],49,71,120,958177,9,0,1,0,2569
e1972db4e9d7a79d10037731a0913803c7ceb8b4,0,GitHub,2019-06-05 09:14:01-07:00,['07cdbdcdf69833661009e1d5735177667c93607b'],1,1,2,958179,1,,,,2569
3b87fbd23759b03ed5e2c3bdd570d111e4a3a27e,1,GitHub,2019-06-05 09:48:24-07:00,['e1972db4e9d7a79d10037731a0913803c7ceb8b4'],365,495,860,959039,73,0,1,0,2569
aa57b9ef1b0a89b475ff9334176d00b7ff728667,0,Cameron Lee,2019-06-05 13:33:02-07:00,['3b87fbd23759b03ed5e2c3bdd570d111e4a3a27e'],1,6,7,959046,2,,,,2569
29c0a1cdcc269324bff89bcb8ad2de922dbae019,1,GitHub,2019-06-06 09:12:10-07:00,['aa57b9ef1b0a89b475ff9334176d00b7ff728667'],35,58,93,959139,17,0.75,1,0,2569
38e642d330acc6d08ab1f82580bb712f88ce7b7e,1,GitHub,2019-06-06 13:33:35-07:00,['29c0a1cdcc269324bff89bcb8ad2de922dbae019'],617,850,1467,960606,58,0.752252252,1,1,2571
8621db68b64f3d4f2c1a2aa986e3b1ea0dd80969,0,shanthoosh,2019-06-07 11:43:32-07:00,['38e642d330acc6d08ab1f82580bb712f88ce7b7e'],8,17,25,960631,2,0,1,0,2571
0243f524a547fec404983fa94f632ae74a7d9858,0,Boris S,2019-06-07 14:40:03-07:00,['8621db68b64f3d4f2c1a2aa986e3b1ea0dd80969'],0,266,266,960897,2,,,,2573
c865b0ae42a9035923eb909bee427e001be912f2,0,Boris S,2019-06-07 14:46:56-07:00,['8621db68b64f3d4f2c1a2aa986e3b1ea0dd80969'],14,14,28,960925,3,,,,2573
0fb2a3b244d8506a85fa7a58a0968bed188f27e2,0,Boris S,2019-06-07 14:56:38-07:00,['8621db68b64f3d4f2c1a2aa986e3b1ea0dd80969'],19,29,48,960973,7,,,,2573
5b55d337e72aee55783de7ee6ff5c9821318cf30,0,GitHub,2019-06-07 15:24:06-07:00,"['8621db68b64f3d4f2c1a2aa986e3b1ea0dd80969', 'c865b0ae42a9035923eb909bee427e001be912f2']",14,14,28,961001,3,,,,2573
a5acf547dd05f0146fb59719614eda254a9814c5,0,GitHub,2019-06-07 15:25:40-07:00,"['5b55d337e72aee55783de7ee6ff5c9821318cf30', '0243f524a547fec404983fa94f632ae74a7d9858']",0,266,266,961267,2,,,,2573
9a5aabace46147ddba09fa5e77964f85c35dfac9,0,Boris S,2019-06-07 16:59:34-07:00,['a5acf547dd05f0146fb59719614eda254a9814c5'],0,4,4,961271,1,,,,2573
519b8a568d8ecca8f1b5116b4cf27bd7a7037419,0,Boris S,2019-06-07 17:00:08-07:00,"['0fb2a3b244d8506a85fa7a58a0968bed188f27e2', '9a5aabace46147ddba09fa5e77964f85c35dfac9']",14,284,298,961569,6,,,,2573
b9144ad8f5973fdd825c957361e3d86162ed6cab,0,Hai Lu,2019-06-08 16:21:52-07:00,['a5acf547dd05f0146fb59719614eda254a9814c5'],1,2,3,961572,1,,,,2573
2809915a63b9c2e7950e9aa41b61a69e6a4b0e7e,0,GitHub,2019-06-10 10:18:58-07:00,"['a5acf547dd05f0146fb59719614eda254a9814c5', 'b9144ad8f5973fdd825c957361e3d86162ed6cab']",1,2,3,961575,1,,,,2573
120213cdc6101d003d6ed1837d106fa29c3f5d24,0,GitHub,2019-06-10 13:43:39-07:00,"['2809915a63b9c2e7950e9aa41b61a69e6a4b0e7e', '519b8a568d8ecca8f1b5116b4cf27bd7a7037419']",19,33,52,961627,8,,,,2573
950fdf07318a0c141573dcc7563c198c004d1161,0,GitHub,2019-06-10 13:59:24-07:00,['120213cdc6101d003d6ed1837d106fa29c3f5d24'],224,216,440,962067,17,1,0.8,1,2575
7f41e064ac4b7a848e7c51d1af799606b8c6174b,0,Boris S,2019-06-10 23:25:19-07:00,['950fdf07318a0c141573dcc7563c198c004d1161'],2,122,124,962191,3,,,,2576
02c09a4e7b806e37efd6498ae71d7b351c388bf8,0,Boris S,2019-06-11 13:34:43-07:00,['7f41e064ac4b7a848e7c51d1af799606b8c6174b'],17,21,38,962229,4,,,,2576
0620aa6d9156ae070b20a14c73983928cee32387,0,Boris S,2019-06-11 13:38:21-07:00,['02c09a4e7b806e37efd6498ae71d7b351c388bf8'],1,1,2,962231,1,,,,2576
b26e77813a9f819826d6edddf5a8f02a6c2655d1,0,Boris S,2019-06-11 13:39:45-07:00,['0620aa6d9156ae070b20a14c73983928cee32387'],0,131,131,962362,1,,,,2577
3bdd719b355e50773c5234e000be0e7d1b985e05,0,GitHub,2019-06-11 13:42:15-07:00,"['950fdf07318a0c141573dcc7563c198c004d1161', 'b26e77813a9f819826d6edddf5a8f02a6c2655d1']",3,258,261,962623,6,,,,2577
e82fc46e14a9498cc912e00e9e2ae31571c81ad8,0,GitHub,2019-06-11 16:24:44-07:00,['3bdd719b355e50773c5234e000be0e7d1b985e05'],126,248,374,962997,17,0.904109589,0.97260274,0.931506849,2579
8a215f44140a397989f6554aedb82efd4b366d15,0,Boris S,2019-06-11 17:33:55-07:00,['3bdd719b355e50773c5234e000be0e7d1b985e05'],58,50,108,963105,3,,,,2579
b5c4a5187e3715fcea4d00565e0c8863dadcfb5b,0,GitHub,2019-06-11 19:25:21-07:00,"['e82fc46e14a9498cc912e00e9e2ae31571c81ad8', '8a215f44140a397989f6554aedb82efd4b366d15']",58,50,108,963213,3,,,,2579
a44d8dbd8cb618284f0553e843f8d7e89094c4f3,1,Prateek Maheshwari,2019-06-12 09:35:06-07:00,['b5c4a5187e3715fcea4d00565e0c8863dadcfb5b'],28,23,51,963264,3,1,0,1,2579
1e4b75499ba78e31bcd3dc412a810016b1c547e5,0,Boris S,2019-06-12 11:02:38-07:00,['b5c4a5187e3715fcea4d00565e0c8863dadcfb5b'],6,7,13,963277,5,,,,2579
328bf6362ea9ce76dbe58dafc489052dc231e9d6,0,Boris S,2019-06-12 11:12:24-07:00,['1e4b75499ba78e31bcd3dc412a810016b1c547e5'],5,6,11,963288,1,,,,2579
f01c172d1a56446fe26ba4edf73b245feea24221,0,GitHub,2019-06-12 11:29:58-07:00,"['a44d8dbd8cb618284f0553e843f8d7e89094c4f3', '328bf6362ea9ce76dbe58dafc489052dc231e9d6']",11,13,24,963312,6,,,,2579
e4d0ad11ca360e429f14e291074147dc04dd7fe7,0,Jagadish,2019-06-13 15:39:31-07:00,['f01c172d1a56446fe26ba4edf73b245feea24221'],3,9,12,963324,1,0,1,0,2579
190862207f6f6f6959725884a340762329097d1d,1,GitHub,2019-06-18 15:06:57-07:00,['e4d0ad11ca360e429f14e291074147dc04dd7fe7'],219,88,307,963631,6,0.982300885,0,0,2579
9acb37334499c988a2119e3d921b5bf5a6322868,1,Jagadish,2019-06-19 17:02:05-07:00,['190862207f6f6f6959725884a340762329097d1d'],59,82,141,963772,2,0,0,0.615384615,2579
c12f983f8acdf89befce2806ea31ebc3149c9ab2,1,GitHub,2019-06-21 08:24:21-07:00,['9acb37334499c988a2119e3d921b5bf5a6322868'],2,73,75,963847,3,0,0.941176471,1,2579
6e1301bd0c282500a436011335e5d58a5314802c,0,Prateek Maheshwari,2019-06-24 10:00:30-07:00,['c12f983f8acdf89befce2806ea31ebc3149c9ab2'],11,11,22,963869,5,,,,2579
6b0c20ae63f9f15da89f35dbb15189300cfab371,1,Jagadish,2019-06-24 17:40:28-07:00,['6e1301bd0c282500a436011335e5d58a5314802c'],51,862,913,964782,10,0.647959184,0.882653061,0.87755102,2583
6300ed3ec33e3087ce871c15ba7723325e33d4a5,1,GitHub,2019-06-24 17:47:00-07:00,['6b0c20ae63f9f15da89f35dbb15189300cfab371'],88,231,319,965101,8,0.893333333,0.986666667,0.84,2583
9b42f379d29a92575594519f5b3ff3772c554312,1,GitHub,2019-06-25 11:40:19-07:00,['6300ed3ec33e3087ce871c15ba7723325e33d4a5'],22,107,129,965230,2,0.178571429,0.946428571,0.821428571,2583
2a401b0324dad25084ad40914cecf7f43d7a8c1c,0,Prateek Maheshwari,2019-06-26 18:41:40-07:00,['9b42f379d29a92575594519f5b3ff3772c554312'],1,1,2,965232,1,,,,2583
816313e04c6aea1bc95ed813f0a7ee0b86b9ca02,0,Prateek Maheshwari,2019-06-26 19:03:23-07:00,['2a401b0324dad25084ad40914cecf7f43d7a8c1c'],3,3,6,965238,3,,,,2583
7cf3465a93efceb62a446ec0bf57de37b62575d4,0,Prateek Maheshwari,2019-06-27 09:52:31-07:00,['816313e04c6aea1bc95ed813f0a7ee0b86b9ca02'],2,2,4,965242,1,,,,2583
6615711028721d81c1765392d9e06a43396a3ede,1,GitHub,2019-06-28 14:31:36-07:00,['7cf3465a93efceb62a446ec0bf57de37b62575d4'],0,58,58,965300,4,0.444444444,0.916666667,1,2583
bebad3476430a242c79a96ed29cae344c0e0e561,0,GitHub,2019-06-28 15:20:52-07:00,['6615711028721d81c1765392d9e06a43396a3ede'],5,6,11,965311,1,,,,2583
80210748b24d4e44652af52973902dfcef3cb6cd,1,Prateek Maheshwari,2019-06-28 16:53:49-07:00,['bebad3476430a242c79a96ed29cae344c0e0e561'],4,4,8,965319,1,,,,2583
19ca626fab1a925e134ae7953ac384f2f0a9d09c,0,mynameborat,2019-07-09 10:30:17-07:00,['80210748b24d4e44652af52973902dfcef3cb6cd'],0,28,28,965347,1,,,,2584
d8926ca90c35c3137a332b1edeb7ced1f0961bbb,0,GitHub,2019-07-09 13:46:17-07:00,['19ca626fab1a925e134ae7953ac384f2f0a9d09c'],9,14,23,965370,3,0,1,1,2584
49bb3f5ad044bedb4313bcaa35feba591995034e,0,GitHub,2019-07-09 13:46:57-07:00,['d8926ca90c35c3137a332b1edeb7ced1f0961bbb'],0,28,28,965398,1,,,,2585
e9f7368996213a37b4ac11992e93116fa19c6c9a,0,GitHub,2019-07-10 11:57:17-07:00,['49bb3f5ad044bedb4313bcaa35feba591995034e'],1,0,1,965399,1,1,0,0,2585
71d134643af7e34b8fa41425ab7978425ccf5b57,0,GitHub,2019-07-10 15:51:09-07:00,['e9f7368996213a37b4ac11992e93116fa19c6c9a'],5,56,61,965460,3,0.352941176,1,0.941176471,2585
5071629cdb432143363223259b72c2dde1278271,1,GitHub,2019-07-11 10:26:33-07:00,['71d134643af7e34b8fa41425ab7978425ccf5b57'],12,86,98,965558,7,0,1,0.964285714,2586
6182141be0b7fda994ed2668ac91b99cc1f82f65,0,GitHub,2019-07-11 10:50:46-07:00,['5071629cdb432143363223259b72c2dde1278271'],1,2,3,965561,1,,,,2586
7e33b96fe8c8ea596e729643a0535924de6c4f3d,0,mynameborat,2019-07-11 17:52:24-07:00,['6182141be0b7fda994ed2668ac91b99cc1f82f65'],1,9,10,965571,2,0,0,0,2586
e0ea235155ac5b619f0c5c67d6e86dc45363bda5,1,mynameborat,2019-07-19 15:13:56-07:00,['7e33b96fe8c8ea596e729643a0535924de6c4f3d'],26,34,60,965631,2,0,1,0.375,2586
bab9f9c9911589509bbc712a568770c7a4523967,0,Aditya Toomula,2019-07-21 21:09:47-07:00,['e0ea235155ac5b619f0c5c67d6e86dc45363bda5'],703,986,1689,967320,22,0.916666667,0.952380952,0.892857143,2590
106286fc2161bc093f85bf785d56530467ceff45,1,shanthoosh,2019-07-22 23:07:44-07:00,['bab9f9c9911589509bbc712a568770c7a4523967'],131,341,472,967792,15,0.168141593,1,0.716814159,2590
b1d9a0c0ff76762b3a68664052c7e07e33b9e41f,0,shanthoosh,2019-07-22 23:08:56-07:00,['106286fc2161bc093f85bf785d56530467ceff45'],0,95,95,967887,2,0.2,1,1,2590
b162c32157b72ad857c87be8615f4926d5f07db5,0,Aditya Toomula,2019-07-25 15:04:31-07:00,['b1d9a0c0ff76762b3a68664052c7e07e33b9e41f'],5,188,193,968080,8,0.153846154,1,1,2590
ec536e14a1aa3d0fbd31c76418b605ea82c8b8d9,0,Aditya Toomula,2019-07-26 08:42:25-07:00,['b162c32157b72ad857c87be8615f4926d5f07db5'],94,125,219,968299,19,0.428571429,1,1,2591
97942d9ae1a63c420c64beb84b2a923e6a96b450,0,GitHub,2019-07-29 10:19:39-07:00,['ec536e14a1aa3d0fbd31c76418b605ea82c8b8d9'],125,94,219,968518,19,0.571428571,0,0,2591
cf0ecea298389004d7d6812359bb7019ea4de0dd,1,mynameborat,2019-07-29 10:31:58-07:00,['97942d9ae1a63c420c64beb84b2a923e6a96b450'],43,209,252,968770,2,0.116504854,1,1,2591
bb3721a3a572e74799a08d2391f4fbd61e3377eb,0,mynameborat,2019-07-30 10:02:54-07:00,['cf0ecea298389004d7d6812359bb7019ea4de0dd'],10,90,100,968870,5,0.333333333,1,1,2591
ef077ccc5d06eb59063692f1d30423b67be720a1,0,GitHub,2019-07-30 17:12:13-07:00,['bb3721a3a572e74799a08d2391f4fbd61e3377eb'],18,20,38,968908,4,0,0.75,0.5,2591
f8092ef7af34d978b8b253af5260e937613a50bc,1,GitHub,2019-07-30 17:36:12-07:00,['ef077ccc5d06eb59063692f1d30423b67be720a1'],574,1205,1779,970687,80,0.944086022,1,1,2593
7a8f773de9f5a07a65e591e124e95c1aa47165ef,0,Cameron Lee,2019-07-31 09:40:21-07:00,['f8092ef7af34d978b8b253af5260e937613a50bc'],29,804,833,971520,12,0.566298343,0.790055249,0.91160221,2598
1e6f1fd6ffd1103474afe59413b7816baa061286,0,GitHub,2019-07-31 12:05:17-07:00,['7a8f773de9f5a07a65e591e124e95c1aa47165ef'],3,11,14,971534,1,1,1,0,2598
179d3945918590298bfc4d5d1529a0c8dd316eb4,1,GitHub,2019-07-31 14:52:03-07:00,['1e6f1fd6ffd1103474afe59413b7816baa061286'],13,61,74,971608,3,0.948717949,1,1,2598
54698240f1ec3313736a6368134fc37435f96b16,1,GitHub,2019-08-01 09:50:43-07:00,['179d3945918590298bfc4d5d1529a0c8dd316eb4'],3,9,12,971620,3,1,1,0,2598
9cb275a4424469cc220263b936e1fc514cef594c,0,GitHub,2019-08-01 09:51:22-07:00,['54698240f1ec3313736a6368134fc37435f96b16'],2,2,4,971624,1,,,,2598
da0bf393bc5b6e03985b28ae706c3e05ae5e6992,0,GitHub,2019-08-01 12:44:49-07:00,['9cb275a4424469cc220263b936e1fc514cef594c'],21,100,121,971745,5,0.257142857,0.285714286,0.228571429,2599
d0b91c53780e9766e233a9b4a605f513b14e65e2,0,shanthoosh,2019-08-06 11:12:25-07:00,['da0bf393bc5b6e03985b28ae706c3e05ae5e6992'],2,5,7,971752,2,1,1,1,2599
f3d949453e0b67d6e8f09c5c91dd4d17feb06f7d,0,GitHub,2019-08-06 17:24:23-07:00,['d0b91c53780e9766e233a9b4a605f513b14e65e2'],18,83,101,971853,4,0.106382979,0.957446809,0.382978723,2599
4c06bd3a6b6ee1be2624270d5d1b015e83e0f6bf,1,mynameborat,2019-08-06 19:19:09-07:00,['f3d949453e0b67d6e8f09c5c91dd4d17feb06f7d'],4,2,6,971859,1,1,0,1,2599
affded20e21cdf2694cab1cb40948209c94a4aaa,1,xinyuiscool,2019-08-07 11:05:47-07:00,['4c06bd3a6b6ee1be2624270d5d1b015e83e0f6bf'],8,81,89,971948,2,0.464285714,1,1,2599
043934e9fc2fc1cee0debcc6ff54f146b1605e40,0,GitHub,2019-08-07 11:17:32-07:00,['affded20e21cdf2694cab1cb40948209c94a4aaa'],0,1,1,971949,1,,,,2599
7318e4840f18269b662947c8d7f303ae10fcefa4,0,thunderstumpges,2019-08-07 13:42:01-07:00,['043934e9fc2fc1cee0debcc6ff54f146b1605e40'],1,3,4,971953,1,,,,2599
ab53bb3ac457278963814cc7fd51827091aacd80,0,GitHub,2019-08-07 15:23:28-07:00,"['043934e9fc2fc1cee0debcc6ff54f146b1605e40', '7318e4840f18269b662947c8d7f303ae10fcefa4']",1,3,4,971957,1,,,,2599
77fd1a4721928dabd8b68daeed983a92e64e417c,0,GitHub,2019-08-08 18:25:39-07:00,['ab53bb3ac457278963814cc7fd51827091aacd80'],0,28,28,971985,1,,,,2600
4b012d90d482fc906d4737bb693f806e2ff32a3e,0,shanthoosh,2019-08-09 12:05:15-07:00,['77fd1a4721928dabd8b68daeed983a92e64e417c'],24,57,81,972066,8,1,1,0.733333333,2600
cb06ae13ad5d6f05ab7c0ce0833677fcb01f950a,0,mynameborat,2019-08-12 15:04:40-07:00,['4b012d90d482fc906d4737bb693f806e2ff32a3e'],6,52,58,972124,2,0,1,1,2600
37de270bce27defca691891a93517c8d694057c8,0,GitHub,2019-08-12 17:39:54-07:00,['cb06ae13ad5d6f05ab7c0ce0833677fcb01f950a'],12,312,324,972448,7,0.288,1,0.944,2603
2e17e08ba2469409243bc1749c608ba31782ff5b,1,rmatharu,2019-08-14 10:44:47-07:00,['37de270bce27defca691891a93517c8d694057c8'],368,733,1101,973549,14,0.519417476,0.529126214,0.606796117,2603
dcdf22959565c92fd3cee5e43583c242321cd01f,0,GitHub,2019-08-15 14:48:27-07:00,['2e17e08ba2469409243bc1749c608ba31782ff5b'],0,31,31,973580,1,1,0.45,1,2603
83467a06054b0f63bce1491a6afb5080c5ef30ee,0,GitHub,2019-08-20 09:19:55-07:00,['dcdf22959565c92fd3cee5e43583c242321cd01f'],8,31,39,973619,2,1,1,1,2603
02e15bdd9259e7c555694bc2f609c8c7d9ac7a80,0,Feroz Basheer,2019-08-20 21:59:23-07:00,['83467a06054b0f63bce1491a6afb5080c5ef30ee'],2,2,4,973623,1,,,,2603
ad64622f0b6f3ff65594a42d2936b11a20df4bc8,0,GitHub,2019-08-21 06:23:22-07:00,"['83467a06054b0f63bce1491a6afb5080c5ef30ee', '02e15bdd9259e7c555694bc2f609c8c7d9ac7a80']",2,2,4,973627,1,,,,2603
0c5c3a56104b0872a2cc7692fd87db691621a887,1,GitHub,2019-08-21 10:44:26-07:00,['ad64622f0b6f3ff65594a42d2936b11a20df4bc8'],64,109,173,973800,3,1,,,2604
19c977ce67ea560f669c790e2f855bfc2323cbcb,0,xinyuiscool,2019-08-23 14:29:45-07:00,['0c5c3a56104b0872a2cc7692fd87db691621a887'],12,69,81,973881,6,0,0.909090909,0.931818182,2604
c8f875740b25b8edaf25d17c43cd5d409f278215,0,GitHub,2019-08-26 11:54:46-07:00,['19c977ce67ea560f669c790e2f855bfc2323cbcb'],27,33,60,973941,6,0.75,1,1,2604
767a5d47400948f56158d4c7307a91ef0baff4b4,0,GitHub,2019-08-26 13:35:27-07:00,['c8f875740b25b8edaf25d17c43cd5d409f278215'],16,4,20,973961,2,0,0,0,2604
e0b5a32b1ca542f0409142c667bf0bcec68d5cb3,0,rmatharu,2019-08-30 10:26:06-07:00,['767a5d47400948f56158d4c7307a91ef0baff4b4'],16,140,156,974117,2,0.454545455,1,1,2604
97afd3fa902c5fa9919fb3f930531eca84642269,1,GitHub,2019-09-03 15:23:18-07:00,['e0b5a32b1ca542f0409142c667bf0bcec68d5cb3'],126,853,979,975096,9,0.316489362,0.933510638,0.989361702,2607
ae8e8571ab1cd34f593c4caabc0af62398d1b69f,1,Aditya Toomula,2019-09-04 10:11:47-07:00,['97afd3fa902c5fa9919fb3f930531eca84642269'],119,111,230,975326,17,1,1,1,2607
713a8bf68c2f4f81f7c575f66b1cf091ad81113c,1,GitHub,2019-09-05 21:47:46-07:00,['ae8e8571ab1cd34f593c4caabc0af62398d1b69f'],94,213,307,975633,10,0.876712329,0.356164384,0,2607
5af4b3b1e00fbe78fc45aabac11db19fa6aeaeb7,0,Cameron Lee,2019-09-13 11:51:53-07:00,['713a8bf68c2f4f81f7c575f66b1cf091ad81113c'],3,37,40,975673,2,,,,2607
83e152904ef58118e458d85c2da853c5a34871d4,1,GitHub,2019-09-16 10:05:35-07:00,['5af4b3b1e00fbe78fc45aabac11db19fa6aeaeb7'],17,36,53,975726,7,0,1,1,2607
eace5a2e5c77d5530ccbcd772d2bc31fd3cd9e7e,1,Cameron Lee,2019-09-17 10:32:00-07:00,['83e152904ef58118e458d85c2da853c5a34871d4'],68,229,297,976023,4,1,1,1,2609
e6fe169b9152fa0f6fa8884237d2649e25146ee7,1,GitHub,2019-09-18 15:27:44-07:00,['eace5a2e5c77d5530ccbcd772d2bc31fd3cd9e7e'],34,83,117,976140,5,0,1,1,2609
686be0bdb56535985847a03b1c8b6347df89ed5a,0,mynameborat,2019-09-23 16:06:30-07:00,['e6fe169b9152fa0f6fa8884237d2649e25146ee7'],8,8,16,976156,1,1,0,1,2609
96097a44fe9df38d04e2fc96a50c27f5e17def79,0,GitHub,2019-09-23 17:35:17-07:00,"['e6fe169b9152fa0f6fa8884237d2649e25146ee7', '686be0bdb56535985847a03b1c8b6347df89ed5a']",8,8,16,976172,1,,,,2609
48b3c8e6669521f0d333e72bae8f89c5f576e0c1,0,GitHub,2019-09-24 20:13:23-07:00,['96097a44fe9df38d04e2fc96a50c27f5e17def79'],4,13,17,976189,2,0,1,1,2609
0effeb62e2da48f9f32906106d288816906ffeaa,0,Cameron Lee,2019-09-25 14:34:47-07:00,['48b3c8e6669521f0d333e72bae8f89c5f576e0c1'],12,199,211,976400,7,0.609756098,1,1,2612
6b19cd660c5d7e28a59aea97a934aa58e9eb1a95,0,rmatharu,2019-09-25 17:39:56-07:00,['0effeb62e2da48f9f32906106d288816906ffeaa'],21,61,82,976482,4,0.333333333,0.333333333,0.185185185,2612
6d91400536612aa75af752fa66a31f99236c7b54,0,GitHub,2019-09-26 09:16:15-07:00,['6b19cd660c5d7e28a59aea97a934aa58e9eb1a95'],243,780,1023,977505,3,0.013289037,1,0.707641196,2612
57f8bac308d3a2d8d0ce869eb79599ea5e048ce3,0,Boris S,2019-09-26 11:02:54-07:00,['6d91400536612aa75af752fa66a31f99236c7b54'],415,415,830,978335,36,,,,2612
ad9512295cfb811749c7979d3a2575462a2c97d7,0,Boris S,2019-09-26 13:32:22-07:00,['57f8bac308d3a2d8d0ce869eb79599ea5e048ce3'],835,456,1291,979626,34,0.18125,0,0.04375,2612
c5791ac4ab95e07e21e2b6a6bca7d3e7eb2ea540,0,Boris S,2019-09-26 13:33:36-07:00,['ad9512295cfb811749c7979d3a2575462a2c97d7'],0,347,347,979973,1,0.879699248,1,0.969924812,2613
f8623589786cd0ff25fc3d44025cf33eb775a48d,0,Boris S,2019-09-26 13:37:10-07:00,['c5791ac4ab95e07e21e2b6a6bca7d3e7eb2ea540'],21,19,40,980013,6,1,0,0.5,2613
135b17c71b0dfa29458ab437f629e1df8d6e842f,1,Boris S,2019-09-26 16:24:34-07:00,['f8623589786cd0ff25fc3d44025cf33eb775a48d'],352,357,709,980722,17,0,0.666666667,0,2613
a109588b6f49023bb1aca1e3634379f44ece0345,0,Boris S,2019-09-26 16:32:51-07:00,['135b17c71b0dfa29458ab437f629e1df8d6e842f'],36,84,120,980842,1,,,,2613
f0b2f4c3cc866629f824adc7b1b9e0239eeaced9,1,Boris S,2019-09-26 16:36:06-07:00,['a109588b6f49023bb1aca1e3634379f44ece0345'],399,399,798,981640,36,,,,2613
ba1d4562cd91058f893f7f3d9607f3b70d02c7fd,1,rmatharu,2019-09-27 13:53:49-07:00,['6d91400536612aa75af752fa66a31f99236c7b54'],323,441,764,982404,10,0,1,1,2613
548c9f0c0f553fcfed3898b90de1ad3f7fd7a943,0,Boris S,2019-09-27 17:31:06-07:00,['f0b2f4c3cc866629f824adc7b1b9e0239eeaced9'],94,91,185,982589,8,1,0,0,2613
20f85080fab47206a5cb1b26fd54f9f6065f50d0,0,Boris S,2019-09-30 10:00:01-07:00,['548c9f0c0f553fcfed3898b90de1ad3f7fd7a943'],1,2,3,982592,1,,,,2613
fab7c56eeb4fd88f172dfaaf959dcf1670c9ff1a,0,GitHub,2019-09-30 10:01:31-07:00,"['ba1d4562cd91058f893f7f3d9607f3b70d02c7fd', '20f85080fab47206a5cb1b26fd54f9f6065f50d0']",748,765,1513,984105,34,,,,2613
fb7f1b388d3c50c0dd76ae66a848ba063087cb0e,0,rmatharu,2019-09-30 11:43:53-07:00,['fab7c56eeb4fd88f172dfaaf959dcf1670c9ff1a'],37,37,74,984179,8,,,,2613
4ba15fe223f634612769752baa8189c736efcd46,1,GitHub,2019-10-01 11:43:51-07:00,['fb7f1b388d3c50c0dd76ae66a848ba063087cb0e'],345,210,555,984734,78,0.891566265,0.108433735,1,2613
554f7c513ae41779e3782446367b6c6c90bc9d80,0,Cameron Lee,2019-10-01 12:23:09-07:00,['4ba15fe223f634612769752baa8189c736efcd46'],4,10,14,984748,1,1,1,1,2613
18755a38eef35d9b1b730fef6158efefab80832c,0,GitHub,2019-10-01 18:15:19-07:00,['554f7c513ae41779e3782446367b6c6c90bc9d80'],22,135,157,984905,20,1,1,1,2613
3e5ede6047d7a2a32ac37ff937a08d7b927814c4,1,GitHub,2019-10-01 18:56:14-07:00,['18755a38eef35d9b1b730fef6158efefab80832c'],50,204,254,985159,6,0.386363636,0.625,0.852272727,2614
a4d8014108e53b8e5bc602ddc7dcd90ade801635,1,GitHub,2019-10-01 18:57:55-07:00,['3e5ede6047d7a2a32ac37ff937a08d7b927814c4'],104,125,229,985388,12,0,0.75,0.85,2614
b3f93cbbf6a17987dde1eb6211142629c80abb36,0,GitHub,2019-10-01 23:48:25-07:00,['a4d8014108e53b8e5bc602ddc7dcd90ade801635'],2,2,4,985392,1,,,,2614
a6338f5f40d4a58d8320222c8f601c8a6dbf5d62,0,GitHub,2019-10-02 09:07:58-07:00,"['a4d8014108e53b8e5bc602ddc7dcd90ade801635', 'b3f93cbbf6a17987dde1eb6211142629c80abb36']",2,2,4,985396,1,,,,2614
bc15f5b8cae53e994c7edeb1dd4b24d0cf40246c,0,GitHub,2019-10-02 11:31:10-07:00,['a6338f5f40d4a58d8320222c8f601c8a6dbf5d62'],260,288,548,985944,13,0.663461538,1,1,2618
159683b8c72129dfd5eb0a088091717a85b0fab6,0,mynameborat,2019-10-02 14:09:32-07:00,['bc15f5b8cae53e994c7edeb1dd4b24d0cf40246c'],45,575,620,986564,5,0.09122807,1,0.894736842,2620
c92df1e333e21a64a01bed2c14b22aaa57a077c2,0,Sanil15,2019-10-02 14:51:24-07:00,['bc15f5b8cae53e994c7edeb1dd4b24d0cf40246c'],126,241,367,986931,8,0.959183673,1,0.244897959,2621
6c90ce6ccb03edd91f51b0ee124c357e1a7c377f,1,GitHub,2019-10-03 20:59:02-07:00,['159683b8c72129dfd5eb0a088091717a85b0fab6'],131,247,378,987309,12,0.453125,0.84375,0.6875,2621
7380f19f43c4f8fbaaade1af56f82b3773ab2fc3,1,GitHub,2019-10-07 11:45:47-07:00,['6c90ce6ccb03edd91f51b0ee124c357e1a7c377f'],16,27,43,987352,1,1,1,1,2621
6057a498db72f92f0a4df0849a816ce9851a3472,1,rmatharu,2019-10-08 11:01:05-07:00,['7380f19f43c4f8fbaaade1af56f82b3773ab2fc3'],0,24,24,987376,3,0.5,0,1,2621
2ae34502e3526cbb8e275d87c26c7bc4ce2d8ed4,1,rmatharu,2019-10-08 13:41:06-07:00,['6057a498db72f92f0a4df0849a816ce9851a3472'],20,70,90,987466,5,0,1,1,2621
dc55bd3fe6d9177cc9f57a63d02cee902b2bddab,1,GitHub,2019-10-08 16:17:52-07:00,['2ae34502e3526cbb8e275d87c26c7bc4ce2d8ed4'],502,868,1370,988836,14,0,0.757142857,0.5,2626
a07e386d1fd0a0ff560a4a22918d27cfe28a6249,0,Cameron Lee,2019-10-09 14:12:27-07:00,['dc55bd3fe6d9177cc9f57a63d02cee902b2bddab'],3,17,20,988856,3,0.923076923,0.923076923,0.923076923,2626
f0e77eb88b3332063ae8364ff9ca33bcef69ed6a,1,GitHub,2019-10-09 15:44:50-07:00,['a07e386d1fd0a0ff560a4a22918d27cfe28a6249'],19,109,128,988984,5,0.720588235,1,1,2626
a3dd6fd07166cc0a02c6b1401b3ab0d0386cd429,0,Cameron Lee,2019-10-10 10:43:57-07:00,['f0e77eb88b3332063ae8364ff9ca33bcef69ed6a'],8,8,16,989000,2,,,,2626
a9f06daf9abd7ece0a97d4058c3eda359b866c5a,0,Sanil15,2019-10-10 14:58:14-07:00,"['c92df1e333e21a64a01bed2c14b22aaa57a077c2', 'a3dd6fd07166cc0a02c6b1401b3ab0d0386cd429']",747,1966,2713,991713,48,,,,2626
71e5ae582a0a65cbbdf004bc4e4d5638019ed8d4,1,Aditya Toomula,2019-10-14 07:20:21-07:00,['a3dd6fd07166cc0a02c6b1401b3ab0d0386cd429'],13,58,71,991784,5,0,0,0.6,2626
84d45c2555089400af26b7ba0a950833e21cbf20,0,Aditya Toomula,2019-10-14 07:40:01-07:00,['71e5ae582a0a65cbbdf004bc4e4d5638019ed8d4'],2,3,5,991789,1,,,,2626
ebca8837e09e514f9fbf75ddb11b7e3c376ab066,0,xinyuiscool,2019-10-14 09:19:44-07:00,['a3dd6fd07166cc0a02c6b1401b3ab0d0386cd429'],3,13,16,991805,2,1,1,1,2626
aba8d04e988de416fe5c2fa6a6036091c8548f8a,1,GitHub,2019-10-14 10:59:17-07:00,['ebca8837e09e514f9fbf75ddb11b7e3c376ab066'],89,4029,4118,995923,31,0.126597444,0.908546326,0.819888179,2634
b8708eda61029eefb6a8b1bfd674e59393588414,0,Aditya Toomula,2019-10-14 11:16:17-07:00,['84d45c2555089400af26b7ba0a950833e21cbf20'],14,17,31,995954,3,0,0,1,2634
5660b8682a0c4ff1556f7f91db2363ee5170b7af,1,GitHub,2019-10-14 11:35:56-07:00,['aba8d04e988de416fe5c2fa6a6036091c8548f8a'],209,17,226,996180,9,0.656716418,0,0.194029851,2634
223d37192a880e91ffc0a85ca112f06711e8e1b5,0,Sanil15,2019-10-14 12:18:07-07:00,['a9f06daf9abd7ece0a97d4058c3eda359b866c5a'],3,3,6,996186,2,,,,2634
26df437e28210f4bf52075ff8419dd9f0293575c,0,Aditya Toomula,2019-10-14 14:28:03-07:00,['b8708eda61029eefb6a8b1bfd674e59393588414'],0,1,1,996187,1,,,,2634
6258d2b38d75764d0605dcded1cfdc7ca5e90604,0,GitHub,2019-10-14 14:39:34-07:00,"['5660b8682a0c4ff1556f7f91db2363ee5170b7af', '26df437e28210f4bf52075ff8419dd9f0293575c']",24,74,98,996285,5,,,,2634
cb78a614716bc39281edc973435626c2032f27ca,0,GitHub,2019-10-14 16:13:44-07:00,['6258d2b38d75764d0605dcded1cfdc7ca5e90604'],5,34,39,996324,4,0.6,0.733333333,0.933333333,2634
4f29de6b5713865cc4e0d016ecb8eca6bce48c16,0,GitHub,2019-10-15 16:36:11-07:00,['cb78a614716bc39281edc973435626c2032f27ca'],1,1,2,996326,1,,,,2634
4eb5e52040fb6cc521fecac27f8e8715ecb5705f,0,GitHub,2019-10-15 17:28:04-07:00,['4f29de6b5713865cc4e0d016ecb8eca6bce48c16'],1,1,2,996328,1,,,,2634
493b2756bd15e2776fdf74a715df7a52d83c1af7,0,Prateek Maheshwari,2019-10-17 11:33:03-07:00,['4eb5e52040fb6cc521fecac27f8e8715ecb5705f'],17,3,20,996348,3,0.076923077,0.076923077,0.076923077,2634
e2928e156d81199b00e9ba1fdc218cd0cc32cee0,1,GitHub,2019-10-17 11:37:29-07:00,['493b2756bd15e2776fdf74a715df7a52d83c1af7'],27,216,243,996591,10,0.790697674,0.790697674,1,2637
842f9709cc87e9bd0196da7e34be33ab2590156d,0,Prateek Maheshwari,2019-10-17 14:12:45-07:00,['e2928e156d81199b00e9ba1fdc218cd0cc32cee0'],2,55,57,996648,4,0.5,0.1,1,2637
e7361bbef2163af4266df89f2cb8c137f6c06eed,0,Prateek Maheshwari,2019-10-18 11:58:49-07:00,['842f9709cc87e9bd0196da7e34be33ab2590156d'],1,1,2,996650,1,,,,2637
a50a62fcda6df3f595405be787ffbbda48bce32c,0,GitHub,2019-10-21 13:28:02-07:00,['e7361bbef2163af4266df89f2cb8c137f6c06eed'],3,1,4,996654,2,1,,0,2637
9a9b7d7624bbbd9d0a3fc2baf37fc6ffd7be3c6f,1,GitHub,2019-10-22 17:55:54-07:00,['a50a62fcda6df3f595405be787ffbbda48bce32c'],109,528,637,997291,29,0.28,0.916,0.916,2639
80f06f326744869648a3e206555c2306572a596b,0,GitHub,2019-10-23 11:05:47-07:00,['9a9b7d7624bbbd9d0a3fc2baf37fc6ffd7be3c6f'],25,295,320,997611,8,0.302752294,1,0.80733945,2642
26712317092bed7824492b1866ac57cb782a6379,0,GitHub,2019-10-24 13:44:03-07:00,['80f06f326744869648a3e206555c2306572a596b'],2,7,9,997620,2,0,,,2642
f72577d710fddb0625a47aaf5e508eb02c6d2271,0,shanthoosh,2019-10-24 13:51:43-07:00,['26712317092bed7824492b1866ac57cb782a6379'],499,883,1382,999002,9,0.082304527,0.888888889,0.9218107,2644
c5af0afaa1a7b3c9c0cb07b46f2c2197cb699c31,1,GitHub,2019-10-24 15:00:19-07:00,['f72577d710fddb0625a47aaf5e508eb02c6d2271'],9,125,134,999136,5,0.19047619,0.416666667,0.785714286,2644
d99a87016d905a05acbae15bce11be38906e2c5e,0,mynameborat,2019-10-25 11:43:01-07:00,['c5af0afaa1a7b3c9c0cb07b46f2c2197cb699c31'],67,18,85,999221,5,1,0,0,2644
ede9d4c807c85c871528c96f755d8ae6189be8b7,0,xinyuiscool,2019-10-28 14:09:37-07:00,['d99a87016d905a05acbae15bce11be38906e2c5e'],8,144,152,999373,6,0.489361702,1,1,2646
45decc2c12f4df932efd701384463992a67084a3,0,Sanil15,2019-10-30 12:26:49-07:00,"['223d37192a880e91ffc0a85ca112f06711e8e1b5', 'ede9d4c807c85c871528c96f755d8ae6189be8b7']",1007,6351,7358,1006731,107,,,,2646
bc8b01c26d380c21835c33e38372626135f189f2,0,rmatharu,2019-11-01 16:56:29-07:00,['ede9d4c807c85c871528c96f755d8ae6189be8b7'],1,1,2,1006733,1,,,,2646
de215f12e0904da625a5beba9fc7c126b611162a,1,GitHub,2019-11-05 12:03:07-08:00,['bc8b01c26d380c21835c33e38372626135f189f2'],2,25,27,1006760,3,1,1,1,2646
4f715d37f2b23f73d546221e835000ccbfaf0dca,0,GitHub,2019-11-05 14:05:58-08:00,"['de215f12e0904da625a5beba9fc7c126b611162a', '45decc2c12f4df932efd701384463992a67084a3']",129,262,391,1007151,8,,,,2646
6201be1af32955c84a2a1cb2aabdb4a48f34606f,0,Hai Lu,2019-11-06 09:03:10-08:00,['4f715d37f2b23f73d546221e835000ccbfaf0dca'],1,48,49,1007200,2,0.057142857,1,1,2646
6a9896bd2c1b5c08f3dc707baa81ed73de38c647,0,GitHub,2019-11-06 11:37:14-08:00,['6201be1af32955c84a2a1cb2aabdb4a48f34606f'],262,129,391,1007591,8,0.040816327,0,0.755102041,2646
ab1512f2fef9600856760e83228c38311c3b8319,0,rmatharu,2019-11-06 17:25:07-08:00,['6a9896bd2c1b5c08f3dc707baa81ed73de38c647'],129,262,391,1007982,8,0.959183673,1,0.244897959,2647
dec929f2878a0ac6ae636e09ae177b19301ea9af,0,GitHub,2019-11-06 18:27:11-08:00,['ab1512f2fef9600856760e83228c38311c3b8319'],0,59,59,1008041,1,,,,2647
5defb06702d8a2d216eb07df2ba2a079731233af,0,shanthoosh,2019-11-07 15:14:40-08:00,['dec929f2878a0ac6ae636e09ae177b19301ea9af'],3,3,6,1008047,3,,,,2647
bd9e9d8ca1d64f9545e92bf2b40e998df0fd5751,0,GitHub,2019-11-08 14:38:11-08:00,['5defb06702d8a2d216eb07df2ba2a079731233af'],3,110,113,1008160,5,,,,2647
6aacee21e75a6c4a2eadbf22e2265953b7fbe90f,1,shanthoosh,2019-11-10 19:05:31-08:00,['bd9e9d8ca1d64f9545e92bf2b40e998df0fd5751'],4,19,23,1008183,3,0.8,1,0.8,2647
6e3240092e8390e0e90ec41aaa51557a0c1aca18,0,Boris Shkolnik,2019-11-11 10:57:56-08:00,['6aacee21e75a6c4a2eadbf22e2265953b7fbe90f'],1,1,2,1008185,1,,,,2647
0ee458fde23e6f4c359313f41e259119c33c847c,0,GitHub,2019-11-11 11:18:09-08:00,"['6aacee21e75a6c4a2eadbf22e2265953b7fbe90f', '6e3240092e8390e0e90ec41aaa51557a0c1aca18']",1,1,2,1008187,1,,,,2647
ba02b46e293931b7d44849b2d4126afdf3556b41,0,GitHub,2019-11-12 14:44:41-08:00,['0ee458fde23e6f4c359313f41e259119c33c847c'],8,19,27,1008214,1,0,1,1,2647
86ab945cea711718ba84d2c2b726b78b548b92c7,0,mynameborat,2019-11-12 20:15:59-08:00,['ba02b46e293931b7d44849b2d4126afdf3556b41'],36,41,77,1008291,1,1,1,1,2647
fa873bf324d8d5a434cf7a53bb1a201046ac5a0a,0,shanthoosh,2019-11-13 17:04:50-08:00,['86ab945cea711718ba84d2c2b726b78b548b92c7'],34,32,66,1008357,8,,,,2647
f6295aa1d5552011bbb607fb4dd8789945f7efc6,0,Hai Lu,2019-11-14 14:27:41-08:00,['fa873bf324d8d5a434cf7a53bb1a201046ac5a0a'],79,116,195,1008552,4,0.709677419,1,1,2647
33fc0b8b1307f39486319bc80f5dc55b7c8570a8,0,rmatharu,2019-11-18 13:50:30-08:00,['f6295aa1d5552011bbb607fb4dd8789945f7efc6'],3,18,21,1008573,2,0,1,1,2647
be1b8ac67d5f42c77d473c1c3d5c33a6d5e9d07e,0,Prateek Maheshwari,2019-11-21 10:05:35-08:00,['33fc0b8b1307f39486319bc80f5dc55b7c8570a8'],2,20,22,1008595,2,1,1,1,2647
1feaa50405a7b4a7ec1efada0cda20388a5f47b3,0,GitHub,2019-11-21 19:36:34-08:00,['be1b8ac67d5f42c77d473c1c3d5c33a6d5e9d07e'],6,30,36,1008631,2,0.875,1,1,2647
3832bf86b1a9d6f1c171bab3dff80b3ac91f59a6,1,GitHub,2019-11-26 11:13:28-08:00,['1feaa50405a7b4a7ec1efada0cda20388a5f47b3'],12,589,601,1009232,12,0.605633803,1,0.906103286,2653
a61824501b86f434797a629f4782a84da8122ffe,0,GitHub,2019-11-26 15:01:27-08:00,['3832bf86b1a9d6f1c171bab3dff80b3ac91f59a6'],1,8,9,1009241,1,,,,2653
bad38b8f54d673bfa27dd784b43942c25545764b,0,shanthoosh,2019-11-26 17:15:43-08:00,['a61824501b86f434797a629f4782a84da8122ffe'],3,4,7,1009248,1,0,1,1,2653
19a0581cd8a044ee1c4eb34d1ed9ac8ab189be67,1,GitHub,2019-12-02 10:39:39-08:00,['bad38b8f54d673bfa27dd784b43942c25545764b'],326,547,873,1010121,21,0.251497006,0.832335329,1,2655
fed0359cacee03f80dac101a6f663ce632e2ff8b,0,GitHub,2019-12-05 11:27:57-08:00,['19a0581cd8a044ee1c4eb34d1ed9ac8ab189be67'],1,1,2,1010123,1,,,,2655
6ab1249a1f54f955bda077f65a92ceba46f2b1ce,0,mynameborat,2019-12-06 14:18:34-08:00,['fed0359cacee03f80dac101a6f663ce632e2ff8b'],3,3,6,1010129,1,,,,2655
9b8f841facbf41f6c89ad798867ec80534dd7554,0,GitHub,2019-12-08 21:50:15-08:00,['6ab1249a1f54f955bda077f65a92ceba46f2b1ce'],13,218,231,1010360,9,,,,2657
f44b4f7900f1e777f0845431db69003a221c7dd2,0,Aditya Toomula,2019-12-09 09:50:29-08:00,['4f715d37f2b23f73d546221e835000ccbfaf0dca'],15,5,20,1010380,3,1,0,0.222222222,2657
fb20518a4698ecf1d567d3f1a6007ccc0e3a40fa,0,GitHub,2019-12-10 07:05:49-08:00,"['9b8f841facbf41f6c89ad798867ec80534dd7554', 'f44b4f7900f1e777f0845431db69003a221c7dd2']",14,5,19,1010399,2,,,,2657
0436528e52c12533fd3664b85884f952fb383b55,0,GitHub,2019-12-10 14:04:45-08:00,['fb20518a4698ecf1d567d3f1a6007ccc0e3a40fa'],53,332,385,1010784,15,0.341317365,0.868263473,0.904191617,2657
6ff4863d5c002aa83b4c6b14910dbaa12b6f4d5e,0,GitHub,2019-12-10 14:36:53-08:00,['0436528e52c12533fd3664b85884f952fb383b55'],1,3,4,1010788,1,,,,2657
454bfabcbf702e02ad0678ae51a677a2c2230bd5,0,GitHub,2019-12-16 11:10:02-08:00,['6ff4863d5c002aa83b4c6b14910dbaa12b6f4d5e'],37,36,73,1010861,7,,,,2658
0611d3864d5839d7d53a8ab116686c54b7bd67ed,0,Ke Wu,2019-12-17 17:07:10-08:00,['454bfabcbf702e02ad0678ae51a677a2c2230bd5'],0,188,188,1011049,6,1,1,1,2663
c2b1af2600e3702e4e81af607c8079f3d75b57cc,0,Ke Wu,2019-12-17 17:12:45-08:00,['454bfabcbf702e02ad0678ae51a677a2c2230bd5'],0,188,188,1011237,6,1,1,1,2668
dad5d966e505194de2a1cd6805c8dad88216bb06,0,Ke Wu,2019-12-17 17:15:07-08:00,"['c2b1af2600e3702e4e81af607c8079f3d75b57cc', '0611d3864d5839d7d53a8ab116686c54b7bd67ed']",0,0,0,1011237,0,,,,2668
057d69fb8678f4a77034544565ecc822fed543b4,0,Ke Wu,2019-12-17 17:24:23-08:00,['454bfabcbf702e02ad0678ae51a677a2c2230bd5'],17,68,85,1011322,2,0.291666667,0.5,1,2668
f389dbdc1b1b0523ab54864c9ca0511c140a65f8,0,Ke Wu,2019-12-17 17:30:06-08:00,['dad5d966e505194de2a1cd6805c8dad88216bb06'],0,38,38,1011360,2,,,,2668
36990a3cc51dbf5e03bfdf4b5ee6856d84ba2f7e,0,Ke Wu,2019-12-17 17:32:43-08:00,['454bfabcbf702e02ad0678ae51a677a2c2230bd5'],17,68,85,1011445,2,0.291666667,0.5,1,2668
f9a34c0fa95068076135474be8d2c4bcbabb1709,0,Ke Wu,2019-12-17 17:33:29-08:00,"['36990a3cc51dbf5e03bfdf4b5ee6856d84ba2f7e', '057d69fb8678f4a77034544565ecc822fed543b4']",0,0,0,1011445,0,,,,2668
08ee3a338bbebcf3715b7f48dcfd61ecc5ab69ae,0,mynameborat,2019-12-20 14:35:07-08:00,['454bfabcbf702e02ad0678ae51a677a2c2230bd5'],1,6,7,1011452,1,0,0,0,2668
abeb06f16d2eb3bacd84db94686c4b0fde1cbe3e,1,Aditya Toomula,2020-01-02 09:01:16-08:00,['08ee3a338bbebcf3715b7f48dcfd61ecc5ab69ae'],7,50,57,1011509,2,0,0.290322581,1,2668
beb5e1b40c07c092bc6e14aafc131d96eda5fcd4,0,GitHub,2020-01-02 10:58:52-08:00,"['08ee3a338bbebcf3715b7f48dcfd61ecc5ab69ae', 'abeb06f16d2eb3bacd84db94686c4b0fde1cbe3e']",7,50,57,1011566,2,,,,2668
8ded2b1d989bb0be3ec1155144948dcfa51e2067,0,Ke Wu,2020-01-06 11:26:16-08:00,['f9a34c0fa95068076135474be8d2c4bcbabb1709'],40,4,44,1011610,2,0.708333333,0.5,0,2668
a649f88a76937509a25bcf76c2fc355828d866dd,0,Ke Wu,2020-01-06 14:36:44-08:00,['f389dbdc1b1b0523ab54864c9ca0511c140a65f8'],24,21,45,1011655,5,0,0,0,2668
de6b09409d060cf321b61a7e59b758324a2afc59,0,Ke Wu,2020-01-06 15:18:22-08:00,['a649f88a76937509a25bcf76c2fc355828d866dd'],1,0,1,1011656,1,,,,2668
2f1762c74a74ba8819e68d6d6b068358343fe13e,0,Ke Wu,2020-01-06 15:56:04-08:00,['8ded2b1d989bb0be3ec1155144948dcfa51e2067'],0,7,7,1011663,1,1,1,1,2668
d59aa7e77f774cd906ab92fa982be6186ff3ebdf,0,Ke Wu,2020-01-07 13:27:18-08:00,['de6b09409d060cf321b61a7e59b758324a2afc59'],5,6,11,1011674,3,,,,2668
7651ed377a5c5a78cfbc530bf7cac829ba0cfc45,0,Ke Wu,2020-01-07 15:13:01-08:00,['d59aa7e77f774cd906ab92fa982be6186ff3ebdf'],0,5,5,1011679,1,,,,2668
f0c706b0baedd9ee56750c0413fbf6a463e916b8,0,Ke Wu,2020-01-08 10:11:27-08:00,"['2f1762c74a74ba8819e68d6d6b068358343fe13e', 'beb5e1b40c07c092bc6e14aafc131d96eda5fcd4']",8,56,64,1011743,3,,,,2668
ea38575c090d89e9a33e485343e6c2d830362af1,0,Ke Wu,2020-01-08 10:17:55-08:00,['f0c706b0baedd9ee56750c0413fbf6a463e916b8'],13,13,26,1011769,1,,,,2668
090f49cc18bbcd4b3ef0e2b8dc6ec00a754748d8,0,Ke Wu,2020-01-08 10:45:54-08:00,['ea38575c090d89e9a33e485343e6c2d830362af1'],3,3,6,1011775,2,,,,2668
abdaf1beab2513bf6fd3c2e094724a6e5be13a7c,0,GitHub,2020-01-09 11:42:18-08:00,"['beb5e1b40c07c092bc6e14aafc131d96eda5fcd4', '7651ed377a5c5a78cfbc530bf7cac829ba0cfc45']",0,228,228,1012003,5,,,,2668
b58aeeac9507d6fcab406c12aed536b865f39289,0,Ke Wu,2020-01-09 11:53:28-08:00,"['090f49cc18bbcd4b3ef0e2b8dc6ec00a754748d8', 'abdaf1beab2513bf6fd3c2e094724a6e5be13a7c']",0,228,228,1012231,5,,,,2668
84f5cad30af2382bfe7e61bb8f9ce61c5f230048,0,Ke Wu,2020-01-09 11:54:30-08:00,['b58aeeac9507d6fcab406c12aed536b865f39289'],1,2,3,1012234,1,,,,2668
00c1616ef7159b0a28b9a0b2987805d5ae91cb38,0,Ke Wu,2020-01-09 13:47:09-08:00,['84f5cad30af2382bfe7e61bb8f9ce61c5f230048'],6,6,12,1012246,2,,,,2668
a90563f3bd50e2161b96f85c1059c9554fd4b255,0,GitHub,2020-01-09 13:55:24-08:00,"['abdaf1beab2513bf6fd3c2e094724a6e5be13a7c', '00c1616ef7159b0a28b9a0b2987805d5ae91cb38']",2,25,27,1012273,3,,,,2668
2a34cf29d17f68c31d5d2212939ffe61a1138539,0,rmatharu,2020-01-10 14:06:55-08:00,['a90563f3bd50e2161b96f85c1059c9554fd4b255'],16,23,39,1012312,1,1,1,0,2668
db259fa6ba338588c9c7b12135f6a01e8bd39c99,0,rmatharu,2020-01-13 15:21:58-08:00,['2a34cf29d17f68c31d5d2212939ffe61a1138539'],12,12,24,1012336,7,,,,2668
2659bc019a2c1989c48d81798a84af1eee4dce05,0,shanthoosh,2020-01-13 19:40:06-08:00,['db259fa6ba338588c9c7b12135f6a01e8bd39c99'],62,0,62,1012398,1,0.904761905,0.904761905,0.904761905,2668
eaa0491d7527d9e8c6fbe3ed923cf2aa1034d21c,0,shanthoosh,2020-01-14 12:03:24-08:00,['2659bc019a2c1989c48d81798a84af1eee4dce05'],760,1,761,1013159,8,0.572649573,0.504273504,0,2668
b3e1a4e50883ebd7fb895195519880893baecfb0,0,Shanthoosh Venkataraman,2020-01-14 16:21:17-08:00,['db259fa6ba338588c9c7b12135f6a01e8bd39c99'],5,44,49,1013208,2,1,1,1,2668
2827c96c67c71a7a6ea0dd46b17dece35d774f28,0,GitHub,2020-01-14 17:48:17-08:00,"['eaa0491d7527d9e8c6fbe3ed923cf2aa1034d21c', 'b3e1a4e50883ebd7fb895195519880893baecfb0']",5,44,49,1013257,2,,,,2668
80c799dcbe64fbfeaeb8c51c855dbaf6c92506cf,0,GitHub,2020-01-14 19:02:13-08:00,['2827c96c67c71a7a6ea0dd46b17dece35d774f28'],7,82,89,1013346,5,0.306451613,0.919354839,1,2668
22f47477c3f42b6c0a6434bf05755bab845a3d69,0,Abhishek Shivanna,2020-01-15 14:14:53-08:00,['80c799dcbe64fbfeaeb8c51c855dbaf6c92506cf'],0,3,3,1013349,1,,,,2668
842d259a6694fd425909390f68d42bd0d1bf4b1d,0,GitHub,2020-01-15 15:36:23-08:00,"['80c799dcbe64fbfeaeb8c51c855dbaf6c92506cf', '22f47477c3f42b6c0a6434bf05755bab845a3d69']",0,3,3,1013352,1,,,,2668
14bf312a325b97ad6ef1f3cfad11a17880189ecd,1,Cameron Lee,2020-01-16 10:46:06-08:00,['842d259a6694fd425909390f68d42bd0d1bf4b1d'],1,3695,3696,1017048,23,0.47972973,0.893581081,0.887387387,2689
8a45efefb9770de5e9b1775e4b6134109d03053e,0,GitHub,2020-01-17 10:19:34-08:00,['14bf312a325b97ad6ef1f3cfad11a17880189ecd'],1,20,21,1017069,2,1,1,1,2689
dd7b9b84232e3240cd2241989a8cf3402a2abd15,0,Cameron Lee,2020-01-17 14:02:44-08:00,['8a45efefb9770de5e9b1775e4b6134109d03053e'],3,29,32,1017101,2,0,1,0.782608696,2689
d28a1df62eccc3e3dda11093b69b6220b889c0ba,0,Cameron Lee,2020-01-17 14:03:44-08:00,['dd7b9b84232e3240cd2241989a8cf3402a2abd15'],14,29,43,1017144,2,0,1,1,2689
5bef72595faa8c8cdc9e35b09342e36a5085c10b,0,Cameron Lee,2020-01-17 14:09:24-08:00,['d28a1df62eccc3e3dda11093b69b6220b889c0ba'],54,258,312,1017456,6,0.427184466,1,0.815533981,2689
b379933d62c8cb438f0599e2540bce6b63e8c014,0,mynameborat,2020-01-21 15:37:07-08:00,['5bef72595faa8c8cdc9e35b09342e36a5085c10b'],3,1082,1085,1018541,10,0.612716763,0.874759152,0.832369942,2697
d20b9b32a8285e936511e4be2643610671ac2922,0,GitHub,2020-01-21 15:43:53-08:00,['b379933d62c8cb438f0599e2540bce6b63e8c014'],3,28,31,1018572,2,1,1,1,2697
4e136a9948f5e8762b0f8f182ff2c7e47717bd54,0,GitHub,2020-01-23 11:37:55-08:00,['d20b9b32a8285e936511e4be2643610671ac2922'],2,1,3,1018575,3,,,,2697
5ece27c51a6c2791c02a5ce13d7233168efbacc1,0,GitHub,2020-01-28 15:43:59-08:00,['4e136a9948f5e8762b0f8f182ff2c7e47717bd54'],7,20,27,1018602,2,0,0,1,2697
3ce0aa32b8921fe88c1ac84d532c465b772038fe,0,GitHub,2020-01-28 15:56:44-08:00,['5ece27c51a6c2791c02a5ce13d7233168efbacc1'],5,34,39,1018641,2,0,1,1,2697
72596233935fb0b7cd4e888853d3d3537b30ed09,0,GitHub,2020-01-28 17:23:06-08:00,['3ce0aa32b8921fe88c1ac84d532c465b772038fe'],2,3,5,1018646,1,,,,2697
e6e0f46fae68f3315dcffe293b51863a83737606,0,GitHub,2020-01-30 10:26:03-08:00,['72596233935fb0b7cd4e888853d3d3537b30ed09'],49,66,115,1018761,2,1,1,1,2697
1a03a6a9b8ed19129305842744d6619277bb72f6,0,GitHub,2020-01-30 14:43:21-08:00,['e6e0f46fae68f3315dcffe293b51863a83737606'],159,218,377,1019138,19,1,1,1,2697
92f53c7074c1fd400b11578ca83a23485d4f965e,0,GitHub,2020-01-31 10:41:07-08:00,['1a03a6a9b8ed19129305842744d6619277bb72f6'],3,19,22,1019160,2,,,,2697
841c9a77679c1c0ca203b1070e229b8bb26b8e8e,1,GitHub,2020-01-31 14:49:29-08:00,['92f53c7074c1fd400b11578ca83a23485d4f965e'],62,1013,1075,1020235,9,0.240270728,0.624365482,0.842639594,2699
5a58877897fae4a0e819c70ee48ee2d7edcb01a2,0,GitHub,2020-02-04 15:26:41-08:00,['841c9a77679c1c0ca203b1070e229b8bb26b8e8e'],13,78,91,1020326,3,0.125,1,1,2699
ca641dcf7450682a69e8eda53b9bc40702b4ad7a,0,GitHub,2020-02-05 09:48:24-08:00,['5a58877897fae4a0e819c70ee48ee2d7edcb01a2'],87,109,196,1020522,18,0,0.066666667,1,2699
faf482e8fe914556702d0710241b24e5863a339f,0,GitHub,2020-02-06 17:17:10-08:00,['ca641dcf7450682a69e8eda53b9bc40702b4ad7a'],20,181,201,1020723,9,0.227848101,0.987341772,0.987341772,2699
b88922b40117a9c3639cb8c2a64275920ef43cfb,0,GitHub,2020-02-10 13:48:24-08:00,['faf482e8fe914556702d0710241b24e5863a339f'],0,73,73,1020796,1,,,,2699
ea490102f2851b4669f64d1e0d54eb5ec99e312f,1,GitHub,2020-02-10 18:56:22-08:00,['b88922b40117a9c3639cb8c2a64275920ef43cfb'],42,285,327,1021123,8,0.396946565,0.534351145,0.916030534,2700
f1a8b51713d101d83ab2bb9de1d770b973017f13,0,GitHub,2020-02-12 10:10:07-08:00,['ea490102f2851b4669f64d1e0d54eb5ec99e312f'],220,186,406,1021529,10,0.777777778,1,1,2702
fd5865f9352eb7743cada6317d7eab2d7812a1dd,0,Hai Lu,2020-02-13 09:32:56-08:00,['f1a8b51713d101d83ab2bb9de1d770b973017f13'],59,59,118,1021647,1,,,,2702
252a6e4120f00108f2e9d0256c943eb360444896,0,GitHub,2020-02-13 09:42:46-08:00,"['f1a8b51713d101d83ab2bb9de1d770b973017f13', 'fd5865f9352eb7743cada6317d7eab2d7812a1dd']",59,59,118,1021765,1,,,,2702
b4a9fe67238d6eb81b2c61177cafd276ade67c07,1,GitHub,2020-02-18 12:32:05-08:00,['252a6e4120f00108f2e9d0256c943eb360444896'],121,480,601,1022366,12,0.15625,0.307291667,0.989583333,2703
93c1dd5d460113df66800e61642b7f34da2bae59,1,GitHub,2020-02-18 14:06:00-08:00,['b4a9fe67238d6eb81b2c61177cafd276ade67c07'],24,61,85,1022451,2,0,0,1,2703
031b5e2a682e002fbd6ca8184e53fd99ede5db0b,0,GitHub,2020-02-18 17:34:32-08:00,['93c1dd5d460113df66800e61642b7f34da2bae59'],0,6,6,1022457,3,0,0,0,2703
0189b5dc161501c572220de0a932180b6649a1e1,0,GitHub,2020-02-18 17:58:43-08:00,['031b5e2a682e002fbd6ca8184e53fd99ede5db0b'],1,1,2,1022459,1,,,,2703
9849c37887c8875b8bb270a6194b0d98609fa465,0,GitHub,2020-02-19 13:42:08-08:00,['0189b5dc161501c572220de0a932180b6649a1e1'],1,5,6,1022465,1,1,1,1,2703
66f3b8ec9dfcf88e30577d7724ab8da5976943f1,0,GitHub,2020-02-19 16:54:55-08:00,['9849c37887c8875b8bb270a6194b0d98609fa465'],17,25,42,1022507,2,0,1,1,2703
cd535d00bb4b3e07dbd96bf0bee453419a114e07,0,GitHub,2020-02-20 12:00:51-08:00,['66f3b8ec9dfcf88e30577d7724ab8da5976943f1'],4,6,10,1022517,1,,,,2703
ae9349a12259f5ace91a48bf9004005312094680,0,GitHub,2020-02-20 15:18:26-08:00,['cd535d00bb4b3e07dbd96bf0bee453419a114e07'],8,112,120,1022637,4,,,,2705
999f5e9dfd25a334fbfa15eccd8366c51a3df76a,0,GitHub,2020-02-24 13:00:34-08:00,['ae9349a12259f5ace91a48bf9004005312094680'],1,2,3,1022640,1,,,,2705
eb215c55620819dc00e3dd6b7f944810215f4393,0,GitHub,2020-02-25 15:11:40-08:00,['999f5e9dfd25a334fbfa15eccd8366c51a3df76a'],1,1,2,1022642,1,,,,2705
ded197de57a3c218780a1bf81130822e078a960d,0,GitHub,2020-02-26 11:04:43-08:00,['eb215c55620819dc00e3dd6b7f944810215f4393'],3,48,51,1022693,2,0.228571429,1,1,2705
e52aecd770d9c6e046034420758e17b867f00313,0,GitHub,2020-02-26 13:29:38-08:00,['ded197de57a3c218780a1bf81130822e078a960d'],84,27,111,1022804,6,1,0,0,2705
0aa1e7c1cf6c840e292d245e9bf870c28a17443e,0,GitHub,2020-02-27 14:12:00-08:00,['e52aecd770d9c6e046034420758e17b867f00313'],23,62,85,1022889,3,0,1,0.157894737,2705
d02216726e03695096b680f0f5bff9c0d6ca2e6c,1,GitHub,2020-02-28 14:37:45-08:00,['0aa1e7c1cf6c840e292d245e9bf870c28a17443e'],42,296,338,1023227,7,0.174698795,0.048192771,0.915662651,2705
851fc481d0c12f6bb3330677cc61a7626323423c,0,GitHub,2020-03-02 11:23:35-08:00,['d02216726e03695096b680f0f5bff9c0d6ca2e6c'],16,25,41,1023268,2,0.8,1,1,2705
b9ef56a23a3157b7a13d2fce517ceb63ef6ab265,0,GitHub,2020-03-03 12:02:06-08:00,['851fc481d0c12f6bb3330677cc61a7626323423c'],7,97,104,1023372,7,,,,2706
f8bfe875e9866d350857cf99e5c2b0ddaf7d8ac1,0,GitHub,2020-03-03 14:22:29-08:00,['b9ef56a23a3157b7a13d2fce517ceb63ef6ab265'],5,7,12,1023384,2,1,0,0,2706
7e87d215cc51abbc9ce6984b2e6d399acf6d025f,0,Fan Xie,2020-03-03 17:08:46-08:00,['851fc481d0c12f6bb3330677cc61a7626323423c'],3,33,36,1023420,5,0,1,1,2706
6478824bedcf7608e48fee49b5c5e91c3d5b676d,0,Fan Xie,2020-03-04 11:49:29-08:00,['7e87d215cc51abbc9ce6984b2e6d399acf6d025f'],11,119,130,1023550,5,0.456140351,0.456140351,1,2707
76d216eb1e257b6c2779e26af716f96ff35fdff7,0,Fan Xie,2020-03-04 11:56:37-08:00,['6478824bedcf7608e48fee49b5c5e91c3d5b676d'],5,0,5,1023555,1,0,0,0,2707
3a6e48cc91d3e03e8fe17ab4283182fe4d3f98a5,0,GitHub,2020-03-04 12:27:56-08:00,['f8bfe875e9866d350857cf99e5c2b0ddaf7d8ac1'],0,125,125,1023680,7,0.350649351,1,0.727272727,2707
796d97bc5f354580eafcc4208e5320530862ccc1,0,GitHub,2020-03-04 13:10:22-08:00,['3a6e48cc91d3e03e8fe17ab4283182fe4d3f98a5'],125,0,125,1023805,7,0.649350649,0,0.272727273,2707
9d5c9ef87e0c27d35e136998f4ef9f1df561cb4c,0,GitHub,2020-03-04 14:54:12-08:00,['796d97bc5f354580eafcc4208e5320530862ccc1'],0,125,125,1023930,7,0.350649351,1,0.727272727,2707
8fe7c7f7b1d830f67d86b2242fc975d918e02ace,0,mynameborat,2020-03-04 15:14:38-08:00,['9d5c9ef87e0c27d35e136998f4ef9f1df561cb4c'],28,0,28,1023958,1,,,,2707
f782bc8bb0a52c91434a3ffeecaaeecffca4527d,0,Fan Xie,2020-03-04 17:47:42-08:00,['76d216eb1e257b6c2779e26af716f96ff35fdff7'],27,26,53,1024011,3,0,1,0,2707
a8ccc05b4cf4d31ffb3f9f0cab9e4c41769c5798,0,Fan Xie,2020-03-04 17:56:18-08:00,['f782bc8bb0a52c91434a3ffeecaaeecffca4527d'],26,27,53,1024064,3,1,0,1,2707
aad2ccf1a63eb38e596f4fced605eab031db660c,0,Fan Xie,2020-03-04 17:57:55-08:00,['a8ccc05b4cf4d31ffb3f9f0cab9e4c41769c5798'],5,0,5,1024069,1,0,0,0,2707
36ced5e12e0f7c971ae14216964dfad71e6456b8,0,Fan Xie,2020-03-04 18:07:53-08:00,['aad2ccf1a63eb38e596f4fced605eab031db660c'],3,0,3,1024072,1,,,,2707
eff3df497f8b8b1f127f1498176ff28005c9d0e5,0,Fan Xie,2020-03-05 14:29:04-08:00,['36ced5e12e0f7c971ae14216964dfad71e6456b8'],24,45,69,1024141,3,1,1,0,2707
f112848adf81ae5247a1a0d30d893686075251df,0,Fan Xie,2020-03-05 14:46:17-08:00,['eff3df497f8b8b1f127f1498176ff28005c9d0e5'],0,19,19,1024160,1,,,,2707
9870dd24678df5a4f9360062c7f52046525736c1,0,Fan Xie,2020-03-05 16:48:27-08:00,['f112848adf81ae5247a1a0d30d893686075251df'],37,34,71,1024231,2,,,,2707
ea54f9849814e9e0fca746fb9fd9875ccd66a0ab,0,Fan Xie,2020-03-05 17:17:03-08:00,"['9870dd24678df5a4f9360062c7f52046525736c1', '8fe7c7f7b1d830f67d86b2242fc975d918e02ace']",40,229,269,1024500,17,,,,2707
b7dbe5e27ac8d3e2ecd3a196e61fad34d09d70d1,0,Fan Xie,2020-03-06 11:37:28-08:00,['ea54f9849814e9e0fca746fb9fd9875ccd66a0ab'],9,21,30,1024530,2,0,0,1,2707
fd79504481812ea0d1969f3ae6576b96d7c611b7,0,Fan Xie,2020-03-06 11:45:52-08:00,['b7dbe5e27ac8d3e2ecd3a196e61fad34d09d70d1'],17,17,34,1024564,1,,,,2707
16899e359026208e49f1dab6e48ac6d488eb633c,0,Fan Xie,2020-03-07 16:05:30-08:00,['fd79504481812ea0d1969f3ae6576b96d7c611b7'],5,5,10,1024574,1,0,0,1,2707
6d5f3a144dd5586725a725c0a814d1985d875fff,0,Fan Xie,2020-03-08 15:06:50-07:00,['16899e359026208e49f1dab6e48ac6d488eb633c'],1,1,2,1024576,1,1,1,0,2707
bf8b7d27d8ceae22a7b0ea8505819b464dc769c0,0,Fan Xie,2020-03-08 22:50:36-07:00,['6d5f3a144dd5586725a725c0a814d1985d875fff'],1,14,15,1024591,1,1,1,1,2707
1596e40860fddf6e49468015e56904b80257451b,0,Fan Xie,2020-03-09 09:53:23-07:00,['bf8b7d27d8ceae22a7b0ea8505819b464dc769c0'],1,0,1,1024592,1,,,,2707
d6e4f679c445ad840ac649fbd39fef7d841d2963,0,GitHub,2020-03-09 15:21:23-07:00,['8fe7c7f7b1d830f67d86b2242fc975d918e02ace'],31,180,211,1024803,6,0.075471698,0.226415094,0.981132075,2707
84a9e83d150ebc0d734a024239b35f9a66ea44b3,0,GitHub,2020-03-09 16:19:17-07:00,['d6e4f679c445ad840ac649fbd39fef7d841d2963'],1,8,9,1024812,1,,,,2707
0dafc283bf3b7db0432d7350c8880754951cc8f0,0,GitHub,2020-03-09 17:13:23-07:00,['84a9e83d150ebc0d734a024239b35f9a66ea44b3'],4,51,55,1024867,4,1,1,1,2707
896cfee840dbf111245095946e4504232e97d1fe,0,GitHub,2020-03-09 17:25:47-07:00,['0dafc283bf3b7db0432d7350c8880754951cc8f0'],0,11,11,1024878,1,1,1,1,2707
e4eefe2a9b7d6559ee5ce236e5357d773c199816,0,GitHub,2020-03-10 13:20:39-07:00,['896cfee840dbf111245095946e4504232e97d1fe'],6,79,85,1024963,2,0.675,0,1,2707
b8309aa1950ad393cdf54063c2727d78d4f9d0bc,0,GitHub,2020-03-11 10:32:49-07:00,['e4eefe2a9b7d6559ee5ce236e5357d773c199816'],1,26,27,1024990,2,0,1,1,2707
b84c8b7856baa6c2254910a94f35eb8886799ac0,0,GitHub,2020-03-11 10:35:58-07:00,['b8309aa1950ad393cdf54063c2727d78d4f9d0bc'],2,1,3,1024993,1,,,,2707
d6608714c211835c3b04caaaa49882455135158c,1,GitHub,2020-03-11 13:44:21-07:00,['b84c8b7856baa6c2254910a94f35eb8886799ac0'],120,193,313,1025306,14,0.972222222,1,1,2708
48fc94ae3a0fd7bad36edbe8cfc4d581964395f8,0,GitHub,2020-03-11 17:19:23-07:00,['d6608714c211835c3b04caaaa49882455135158c'],2,2,4,1025310,1,,,,2708
fa50c72dbda5424966b2b4ddfe4a6d012ade649a,0,Fan Xie,2020-03-12 16:43:54-07:00,['1596e40860fddf6e49468015e56904b80257451b'],0,9,9,1025319,1,,,,2708
5c02b920bc20a6c9a3d639c99e9608fc79f066f9,0,Fan Xie,2020-03-12 16:44:40-07:00,['fa50c72dbda5424966b2b4ddfe4a6d012ade649a'],1,1,2,1025321,1,,,,2708
d047b89a1e25b018ed77b25509664c2aa1dc47f4,0,Fan Xie,2020-03-12 17:17:15-07:00,['5c02b920bc20a6c9a3d639c99e9608fc79f066f9'],5,20,25,1025346,3,0.666666667,1,0,2708
c864c4cc1abcc9a5a88f6b0dbf493a096e40bce6,0,GitHub,2020-03-13 10:10:52-07:00,['48fc94ae3a0fd7bad36edbe8cfc4d581964395f8'],15,42,57,1025403,1,0,0,0.695652174,2708
215947f7e296e0ece90a1045a800e2b35ad37529,1,GitHub,2020-03-16 10:43:49-07:00,['c864c4cc1abcc9a5a88f6b0dbf493a096e40bce6'],59,78,137,1025540,2,1,1,0.625,2708
b06cb3ffddb030d22f4c46ccbf7a45b9a54873a7,0,GitHub,2020-03-16 15:09:23-07:00,['215947f7e296e0ece90a1045a800e2b35ad37529'],18,57,75,1025615,2,0,0.952380952,0.952380952,2708
9bd3d616b3699f344e92ccaadb4194f3b4179132,0,GitHub,2020-03-16 16:57:48-07:00,['b06cb3ffddb030d22f4c46ccbf7a45b9a54873a7'],44,38,82,1025697,7,,,,2713
5e52b281c21c1749b981c5e45bc3766ee634a413,0,GitHub,2020-03-17 08:50:29-07:00,['9bd3d616b3699f344e92ccaadb4194f3b4179132'],7,47,54,1025751,4,1,1,1,2713
3364c916e7b583869d00578ff950ee4f8996dbe4,0,Fan Xie,2020-03-17 10:05:11-07:00,['d047b89a1e25b018ed77b25509664c2aa1dc47f4'],2,0,2,1025753,1,,,,2713
b97c1309f288b3c1a7aa178a5d4b1819e9cf7d92,0,Fan Xie,2020-03-17 15:25:18-07:00,['3364c916e7b583869d00578ff950ee4f8996dbe4'],0,6,6,1025759,1,,,,2713
f113a035ee15c20fa2ac709ff5f18db8792359e2,0,Fan Xie,2020-03-17 16:47:30-07:00,['b97c1309f288b3c1a7aa178a5d4b1819e9cf7d92'],2,2,4,1025763,1,,,,2713
170be042563bd59168a89f630569b1de69b50570,0,GitHub,2020-03-17 17:06:41-07:00,"['5e52b281c21c1749b981c5e45bc3766ee634a413', 'f113a035ee15c20fa2ac709ff5f18db8792359e2']",9,223,232,1025995,6,,,,2713
7d09f23bc7c6dc04ee0896f46f5fd151618028d2,0,GitHub,2020-03-17 19:06:04-07:00,['170be042563bd59168a89f630569b1de69b50570'],9,276,285,1026280,6,,,,2715
b7cab952317bd4320f12e18c2cc3e3cee77770da,1,GitHub,2020-03-17 19:20:52-07:00,['7d09f23bc7c6dc04ee0896f46f5fd151618028d2'],84,170,254,1026534,4,0,0,1,2717
05e5fd9f3e21273b02e152330be6610d7b15f127,0,GitHub,2020-03-18 10:42:56-07:00,['b7cab952317bd4320f12e18c2cc3e3cee77770da'],5,5,10,1026544,5,,,,2717
6685b28b5e744ba102675c01fb135059446ab583,0,GitHub,2020-03-19 10:52:43-07:00,['05e5fd9f3e21273b02e152330be6610d7b15f127'],0,76,76,1026620,2,0.407407407,1,1,2718
89954388f1ef0f80e9737607e1b1f63fcf6c0abd,0,GitHub,2020-03-19 11:13:53-07:00,['6685b28b5e744ba102675c01fb135059446ab583'],15,45,60,1026680,2,,,,2718
74261aad6c86150ab3b4be01bbe8b1608a625601,0,GitHub,2020-03-19 14:02:47-07:00,['89954388f1ef0f80e9737607e1b1f63fcf6c0abd'],7,7,14,1026694,4,,,,2718
a8eee8bb718431b32cc4d1a05c3f4827147275a3,0,GitHub,2020-03-23 09:20:30-07:00,['74261aad6c86150ab3b4be01bbe8b1608a625601'],3,7,10,1026704,2,,,,2718
0d63d00dc14985d0bfdec3e19e05c51bade1ca0b,0,GitHub,2020-03-25 09:44:24-07:00,['a8eee8bb718431b32cc4d1a05c3f4827147275a3'],8,0,8,1026712,1,,,,2718
b0fdb826fbff75922ad22392b1521d8f611c7621,0,GitHub,2020-03-25 10:00:54-07:00,['0d63d00dc14985d0bfdec3e19e05c51bade1ca0b'],0,28,28,1026740,1,,,,2718
bbb5bdee7ccbd2b37ff07ef7e832f95b6a4c0ab4,0,GitHub,2020-03-27 15:02:43-07:00,['b0fdb826fbff75922ad22392b1521d8f611c7621'],30,96,126,1026866,2,1,1,0.7,2718
c527ec5a151e0da570dfdc3896c30694ac7c34f6,0,GitHub,2020-03-27 22:36:05-07:00,['bbb5bdee7ccbd2b37ff07ef7e832f95b6a4c0ab4'],0,5,5,1026871,1,1,1,1,2718
26d9eecac76f3b87610312d0066d96a5b36eef35,0,GitHub,2020-04-01 16:43:05-07:00,['c527ec5a151e0da570dfdc3896c30694ac7c34f6'],35,73,108,1026979,8,0.363636364,0.545454545,0.045454545,2718
a086ae0a88b114109b8f3da6d487009505132c82,0,GitHub,2020-04-02 14:13:02-07:00,['26d9eecac76f3b87610312d0066d96a5b36eef35'],2,20,22,1027001,1,1,1,1,2718
291e8540bec120363df07bcd4468d446590e0e0f,0,GitHub,2020-04-02 18:21:39-07:00,['a086ae0a88b114109b8f3da6d487009505132c82'],1,93,94,1027095,2,0.228571429,1,1,2719
b193d45a8cd53996a0272817cc37a59255058092,0,GitHub,2020-04-07 09:44:23-07:00,['291e8540bec120363df07bcd4468d446590e0e0f'],13,100,113,1027208,4,0.2,0.890909091,0.818181818,2719
5e3150312a100011f84bda464ab338bc8301a2fb,0,GitHub,2020-04-07 17:12:42-07:00,['b193d45a8cd53996a0272817cc37a59255058092'],1,34,35,1027243,2,1,1,1,2719
76963c945add609cf558048a5c02f1041b87c410,0,GitHub,2020-04-07 23:11:05-07:00,['5e3150312a100011f84bda464ab338bc8301a2fb'],10,107,117,1027360,2,0.260869565,1,1,2719
fff0bb072f3a118eb8cf71257f54ef3aa8eedbd6,1,GitHub,2020-04-08 21:23:16-07:00,['76963c945add609cf558048a5c02f1041b87c410'],52,81,133,1027493,29,0,1,1,2719
470ae2c375168c3548a49263579db0d2dc51e9d0,0,GitHub,2020-04-15 16:08:20-07:00,['fff0bb072f3a118eb8cf71257f54ef3aa8eedbd6'],7,41,48,1027541,2,0,1,1,2719
9eadad1a4f8f14619bb31c1fda526f656b4f5751,0,GitHub,2020-04-16 10:01:28-07:00,['470ae2c375168c3548a49263579db0d2dc51e9d0'],11,100,111,1027652,7,1,1,0.361702128,2719
d745e7d1cbd051002b30bfe99ae924d48ff96eaa,1,GitHub,2020-04-16 13:48:29-07:00,['9eadad1a4f8f14619bb31c1fda526f656b4f5751'],47,40,87,1027739,6,0.4,0,0.4,2719
ae8bb2c44efdba3a2f7a9f77edc6ebfbe97f5fb8,0,Boris S,2020-04-17 18:19:14-07:00,['d745e7d1cbd051002b30bfe99ae924d48ff96eaa'],3,7,10,1027749,2,1,,0,2719
4af3179edf61f7907e795b20c19bd0081826d097,0,Boris S,2020-04-20 09:24:17-07:00,['ae8bb2c44efdba3a2f7a9f77edc6ebfbe97f5fb8'],1,0,1,1027750,1,,,,2719
9f2d6ddac33d877da163ea5d0177f53824abed63,0,GitHub,2020-04-20 17:12:17-07:00,"['d745e7d1cbd051002b30bfe99ae924d48ff96eaa', '4af3179edf61f7907e795b20c19bd0081826d097']",4,7,11,1027761,2,,,,2719
e86951f102c7a854d343b1f80dc2796be29c9c81,0,GitHub,2020-04-24 09:40:25-07:00,['9f2d6ddac33d877da163ea5d0177f53824abed63'],95,163,258,1028019,4,1,1,0,2721
a97f24985dc6074601b84c9980fc90f5f0ec2728,0,GitHub,2020-04-27 18:06:05-07:00,['e86951f102c7a854d343b1f80dc2796be29c9c81'],1,9,10,1028029,1,0,1,1,2721
9977adf32da1bb17e11bed452196a0be666cb33b,0,GitHub,2020-05-01 11:12:14-07:00,['a97f24985dc6074601b84c9980fc90f5f0ec2728'],10,53,63,1028092,4,0,0.962962963,0.925925926,2721
10915fb3cda40ae3733d82f1290bd854af113af6,0,GitHub,2020-05-04 17:04:21-07:00,['9977adf32da1bb17e11bed452196a0be666cb33b'],17,68,85,1028177,5,0.3125,1,1,2721
0080433d0a97a4de9173732dec12812a23b350c9,0,GitHub,2020-05-06 18:43:31-07:00,['10915fb3cda40ae3733d82f1290bd854af113af6'],4,4,8,1028185,3,,,,2721
70cfd3d0d68189c60d14fa7e4b1240f3953d2a14,0,GitHub,2020-05-07 15:04:45-07:00,['0080433d0a97a4de9173732dec12812a23b350c9'],1,1,2,1028187,1,,,,2721
a29f29a6d56a4dfb1c062a97728bcb11bd824275,0,GitHub,2020-05-08 10:20:34-07:00,['70cfd3d0d68189c60d14fa7e4b1240f3953d2a14'],5,151,156,1028343,2,0,0.785714286,0.918367347,2721
ca57730d53324730540039adbad38157b842c88c,1,GitHub,2020-05-11 21:50:03-07:00,['a29f29a6d56a4dfb1c062a97728bcb11bd824275'],3,7,10,1028353,2,1,1,1,2721
ae82b0ab7882647716640e38a2137a83ec8dc95b,0,GitHub,2020-05-15 11:11:28-07:00,['ca57730d53324730540039adbad38157b842c88c'],4,3,7,1028360,2,0,0,0,2721
9f24f1526d8f1c47e6e8fa4d9f68577cc2995f69,1,GitHub,2020-05-15 14:16:17-07:00,['ae82b0ab7882647716640e38a2137a83ec8dc95b'],28,399,427,1028787,16,0.151515152,0.939393939,0.535353535,2727
5e73b1f6f08a876037b8d97baad9947c4d5a077c,0,GitHub,2020-05-15 14:45:56-07:00,['9f24f1526d8f1c47e6e8fa4d9f68577cc2995f69'],2,2,4,1028791,1,,,,2727
0a7760a55be2b6089088016c55217814b5c9675f,0,GitHub,2020-05-18 18:28:19-07:00,['5e73b1f6f08a876037b8d97baad9947c4d5a077c'],6,40,46,1028837,2,0,0,1,2727
160bbb22a9812a78054723279e87a8b618418775,0,GitHub,2020-05-19 15:28:42-07:00,['0a7760a55be2b6089088016c55217814b5c9675f'],4,4,8,1028845,1,,,,2727
3e18e19c850327afdbbd8994dc4ba8fb58ffa09b,0,GitHub,2020-05-27 15:06:12-07:00,['160bbb22a9812a78054723279e87a8b618418775'],5,5,10,1028855,2,1,1,0,2727
583da7764e2db6541b974ce61db7e1f555d02c4e,0,GitHub,2020-05-27 16:55:29-07:00,['3e18e19c850327afdbbd8994dc4ba8fb58ffa09b'],5,45,50,1028905,6,0,0.954545455,0.772727273,2727
f134f0f467814c09e24d00c6b0fc47be7e47622c,0,GitHub,2020-06-01 10:35:14-07:00,['583da7764e2db6541b974ce61db7e1f555d02c4e'],644,489,1133,1030038,7,0.86,0.16,0.435,2728
bb7d65e2dfff93891c2d79bfeb53c259ec8ccc4f,0,mynameborat,2020-06-02 10:52:36-07:00,['f134f0f467814c09e24d00c6b0fc47be7e47622c'],0,59,59,1030097,1,,,,2728
85afbb7c65f097e098fdd1d4601a73c87e990953,0,mynameborat,2020-06-02 18:09:47-07:00,['bb7d65e2dfff93891c2d79bfeb53c259ec8ccc4f'],9,27,36,1030133,3,1,1,1,2728
b3d5dc3937830898d9213acf9156519fb574492c,0,mynameborat,2020-06-02 18:51:19-07:00,['85afbb7c65f097e098fdd1d4601a73c87e990953'],20,26,46,1030179,7,,,,2728
9e281345441b79994822f1383f06d39b9e74ba67,0,GitHub,2020-06-03 12:22:17-07:00,['b3d5dc3937830898d9213acf9156519fb574492c'],61,173,234,1030413,3,0.545454545,0.736363636,1,2728
8641081f9e9ab6368a3d3617088dfa8dc8b70c93,0,GitHub,2020-06-03 14:17:30-07:00,['9e281345441b79994822f1383f06d39b9e74ba67'],1,1,2,1030415,1,,,,2728
fbe8349714d5ba58b169384d11c8f856613d8919,0,mynameborat,2020-06-03 14:36:00-07:00,['8641081f9e9ab6368a3d3617088dfa8dc8b70c93'],109,47,156,1030571,23,,,,2728
c4f2c5d92ec8762fbc1e058bcc1df314972fb53c,0,GitHub,2020-06-04 13:08:52-07:00,['fbe8349714d5ba58b169384d11c8f856613d8919'],5,36,41,1030612,2,0,1,1,2728
07917f659c7a9c9dbb976ef537a311bac2e98d56,0,mynameborat,2020-06-04 19:30:21-07:00,['c4f2c5d92ec8762fbc1e058bcc1df314972fb53c'],8,16,24,1030636,6,1,0,0.5,2728
8c753eb4ded7a7239f33042da903aa5fcc47dc75,0,mynameborat,2020-06-08 14:32:01-07:00,['07917f659c7a9c9dbb976ef537a311bac2e98d56'],6,30,36,1030672,1,0.866666667,0.866666667,1,2728
89538a915d92e153dd3ff221f2abc9719dd69982,0,mynameborat,2020-06-08 14:36:29-07:00,['8c753eb4ded7a7239f33042da903aa5fcc47dc75'],21,23,44,1030716,1,0,1,1,2728
bcee407801d5966015009e9c1d0337ce7e13fc96,0,mynameborat,2020-06-08 15:35:03-07:00,['89538a915d92e153dd3ff221f2abc9719dd69982'],11,35,46,1030762,2,1,1,0,2728
9346522e4af3259d3e85e317839ff96e278409f9,1,GitHub,2020-06-09 15:46:07-07:00,['bcee407801d5966015009e9c1d0337ce7e13fc96'],407,596,1003,1031765,5,0.722222222,1,0.722222222,2730
47a6890cedb507b721fda369658feafbaa67e17d,0,GitHub,2020-06-09 16:34:29-07:00,['9346522e4af3259d3e85e317839ff96e278409f9'],4,33,37,1031802,3,1,1,1,2731
27e95d5370f44768cddc4fead0028c5f740242e6,0,GitHub,2020-06-10 21:16:43-07:00,['47a6890cedb507b721fda369658feafbaa67e17d'],21,184,205,1032007,4,0.321428571,1,0.928571429,2732
322bfdd7cedcbaa6112d61623111ac2e7726f88f,0,GitHub,2020-06-10 22:50:22-07:00,['27e95d5370f44768cddc4fead0028c5f740242e6'],3,32,35,1032042,2,0,1,1,2732
0b65dbf0e25a030c249791a485f3b46d79cec64f,0,GitHub,2020-06-12 15:31:25-07:00,['322bfdd7cedcbaa6112d61623111ac2e7726f88f'],1,1,2,1032044,1,1,0,0,2732
a5f7a66cfde97ab0aa3bfcf662d827a4aeb324e1,0,GitHub,2020-06-15 15:40:13-07:00,['0b65dbf0e25a030c249791a485f3b46d79cec64f'],200,650,850,1032894,13,1,0.644230769,0.817307692,2735
5f05cdde2eea46a8cbda08dd8c9868c8f46a4e9d,0,GitHub,2020-06-22 15:52:51-07:00,['a5f7a66cfde97ab0aa3bfcf662d827a4aeb324e1'],2399,2371,4770,1037664,98,0.896551724,0,0,2735
ef4fbefa17a3e365870d3488dd434fd30bc78e64,0,GitHub,2020-06-23 12:29:09-07:00,['5f05cdde2eea46a8cbda08dd8c9868c8f46a4e9d'],1,46,47,1037711,2,1,1,1,2736
3a66141158a920a1e8e45ab353140cb906aa1fdb,0,GitHub,2020-06-23 14:07:22-07:00,['ef4fbefa17a3e365870d3488dd434fd30bc78e64'],3,3,6,1037717,2,,,,2736
4e2fa96ef9eb14588aaebe8b4cc4837f39c8e20e,0,GitHub,2020-06-24 13:07:12-07:00,['3a66141158a920a1e8e45ab353140cb906aa1fdb'],0,5,5,1037722,1,0,1,1,2736
188b9bbb7bd87a4d5aebbb6e214935f7434c7495,0,GitHub,2020-06-25 10:40:41-07:00,['4e2fa96ef9eb14588aaebe8b4cc4837f39c8e20e'],588,582,1170,1038892,53,0,0,0,2736
8823fb0512b1166543ecc262d3383496c837311e,0,GitHub,2020-06-25 18:21:43-07:00,['188b9bbb7bd87a4d5aebbb6e214935f7434c7495'],388,395,783,1039675,53,1,1,1,2736
fcf1bbc8fcc41fc38eb870dc16c10cf55e78d706,0,GitHub,2020-06-29 11:41:53-07:00,['8823fb0512b1166543ecc262d3383496c837311e'],234,221,455,1040130,21,0,1,1,2736
3f38b217ce5a3bf11bc79703bc3733b420bd1089,0,GitHub,2020-06-29 16:15:51-07:00,['fcf1bbc8fcc41fc38eb870dc16c10cf55e78d706'],352,348,700,1040830,47,0.4,0.2,0.4,2736
8a9a5e3c1af882cac50130b8e9bf87449a90cb09,0,GitHub,2020-06-29 21:22:30-07:00,['3f38b217ce5a3bf11bc79703bc3733b420bd1089'],61,174,235,1041065,3,0.185185185,0.185185185,0.814814815,2736
c2e7025de0d19c90b30c8c1c1e1ea6666761ba8f,0,GitHub,2020-06-30 10:44:46-07:00,['8a9a5e3c1af882cac50130b8e9bf87449a90cb09'],236,155,391,1041456,28,1,0,0,2736
6a3c6e49eafb661f83a499fc8dac0e2377f38ca8,0,GitHub,2020-07-02 18:37:56-07:00,['c2e7025de0d19c90b30c8c1c1e1ea6666761ba8f'],14,305,319,1041775,11,,,,2738
f665824c1043bc3088bb629cedcabb37e8e91b4d,0,GitHub,2020-07-19 23:03:00-07:00,['6a3c6e49eafb661f83a499fc8dac0e2377f38ca8'],53,851,904,1042679,11,0.151982379,0.733480176,0.715859031,2740
0d8de7ab34de9c851d8bc32c57933d2550e26ecd,0,GitHub,2020-07-20 11:17:38-07:00,['f665824c1043bc3088bb629cedcabb37e8e91b4d'],5,247,252,1042931,5,0.566371681,1,0.982300885,2742
f5faae09fa45844ba55326a7f10a475d9e1ee8e3,0,GitHub,2020-07-22 08:52:05-07:00,['0d8de7ab34de9c851d8bc32c57933d2550e26ecd'],185,864,1049,1043980,24,0.297766749,0.774193548,0.895781638,2744
3b7d0d19d1f65048f2ac2194226a83e6223bbd3b,1,GitHub,2020-07-28 13:53:48-07:00,['f5faae09fa45844ba55326a7f10a475d9e1ee8e3'],245,745,990,1044970,7,0.508650519,0.705882353,1,2746
e7d30676d24f159c1f51c8bbdc7c634330513b4e,0,GitHub,2020-08-03 17:31:34-07:00,"['76963c945add609cf558048a5c02f1041b87c410', '3b7d0d19d1f65048f2ac2194226a83e6223bbd3b']",6194,10581,16775,1061745,434,,,,2746
984978ba9127dee4d5a1ccbbf12e269111253661,0,Cheng,2020-08-03 18:30:14-07:00,['e7d30676d24f159c1f51c8bbdc7c634330513b4e'],19,33,52,1061797,11,0.9,1,0,2746
5c4834e6b6952a8d66329a0671a002fbd2a38aa0,0,GitHub,2020-08-05 10:55:15-07:00,['3b7d0d19d1f65048f2ac2194226a83e6223bbd3b'],28,82,110,1061907,2,0,1,1,2746
7c4b31eaf197eac6c98107710fbba311b9536fe2,1,GitHub,2020-08-05 11:46:18-07:00,['5c4834e6b6952a8d66329a0671a002fbd2a38aa0'],48,101,149,1062056,3,1,0.90625,1,2746
2092530b4a58a31914f0ce28ca9b19506902151b,0,Cheng,2020-08-05 11:53:24-07:00,['984978ba9127dee4d5a1ccbbf12e269111253661'],3,3,6,1062062,1,,,,2746
2b148c924532dd6ee10acc3b169e5ccbf5953618,0,GitHub,2020-08-05 12:08:03-07:00,['7c4b31eaf197eac6c98107710fbba311b9536fe2'],8,50,58,1062120,5,0,0.941176471,0.705882353,2746
a05c6e456b265380b1d0363d3de58177f03f65d5,0,Cheng,2020-08-06 17:24:30-07:00,['2092530b4a58a31914f0ce28ca9b19506902151b'],4,33,37,1062157,2,,,,2746
dcbdf8929cf462c869a49e85f760d5ebb55bb570,0,Cheng,2020-08-06 18:30:08-07:00,['a05c6e456b265380b1d0363d3de58177f03f65d5'],6,11,17,1062174,2,,,,2746
c92b7a56017e4fd9a87209b072e836399f3c8ace,0,Boris S,2020-08-07 08:56:51-07:00,['2b148c924532dd6ee10acc3b169e5ccbf5953618'],1,3,4,1062178,1,1,1,1,2746
7aa658008fc511783109ce6932fa5dd91b8ae545,0,Cheng,2020-08-07 10:10:21-07:00,['dcbdf8929cf462c869a49e85f760d5ebb55bb570'],6,6,12,1062190,1,,,,2746
c8bf03d8804df45310783aa28919c20b54d0ca65,0,GitHub,2020-08-07 11:18:42-07:00,"['2b148c924532dd6ee10acc3b169e5ccbf5953618', 'c92b7a56017e4fd9a87209b072e836399f3c8ace']",1,3,4,1062194,1,,,,2746
10d5d2fa325039260bdefa24cc12aa5334a6ab9c,0,Cheng,2020-08-11 09:59:00-07:00,['7aa658008fc511783109ce6932fa5dd91b8ae545'],6,6,12,1062206,1,,,,2746
5d98e256bc0c38c6a6fc3fc03cf0a882aad13d42,0,GitHub,2020-08-11 15:37:37-07:00,['c8bf03d8804df45310783aa28919c20b54d0ca65'],129,312,441,1062647,10,0.892473118,0.978494624,0.795698925,2747
2b11d9408d9b32aca3a6e3d0aecc36b496608576,0,GitHub,2020-08-12 06:29:10-07:00,['5d98e256bc0c38c6a6fc3fc03cf0a882aad13d42'],92,175,267,1062914,3,1,1,0.836734694,2747
926c758269ce372aa20a02d0d11a25b19db8c405,0,Cheng,2020-08-12 11:05:41-07:00,['10d5d2fa325039260bdefa24cc12aa5334a6ab9c'],3,3,6,1062920,1,,,,2747
b736af9af9bcdbb2bbff3a572beef93863349eac,0,GitHub,2020-08-12 11:41:22-07:00,"['2b11d9408d9b32aca3a6e3d0aecc36b496608576', '926c758269ce372aa20a02d0d11a25b19db8c405']",19,67,86,1063006,11,,,,2747
114bdee6f446f9fff2aa2f14460a5d02c4585aed,0,GitHub,2020-08-12 19:21:03-07:00,['b736af9af9bcdbb2bbff3a572beef93863349eac'],1,3,4,1063010,1,1,1,1,2747
216a87fe4c6fa8e0ed48ad7488e296a88d41376e,0,GitHub,2020-08-17 12:39:11-07:00,['114bdee6f446f9fff2aa2f14460a5d02c4585aed'],1,10,11,1063021,1,1,1,1,2747
0c6b6b66a9b8ae6626d2c500e1afbed0ef06e7a7,0,GitHub,2020-08-18 19:49:21-07:00,['216a87fe4c6fa8e0ed48ad7488e296a88d41376e'],62,234,296,1063317,5,0.306666667,1,0.893333333,2749
44fe7765224fefbac8bc0a78ac0da1e4012a7266,0,GitHub,2020-08-19 09:45:54-07:00,['0c6b6b66a9b8ae6626d2c500e1afbed0ef06e7a7'],0,57,57,1063374,2,1,1,1,2750
29f2ef7cd9169ce8e0b474228c59a3a1da71e5c2,0,GitHub,2020-08-24 11:59:26-07:00,['44fe7765224fefbac8bc0a78ac0da1e4012a7266'],2,37,39,1063413,1,0,0,1,2750
f7f9f3c7905b047f262383bcc64ebb01ab73f421,0,GitHub,2020-08-26 19:39:32-07:00,['29f2ef7cd9169ce8e0b474228c59a3a1da71e5c2'],398,788,1186,1064599,35,0.06557377,0.918032787,0.573770492,2756
6ff6f5588d9516d7f72ed0fc8d7862f7c92d06d9,0,GitHub,2020-08-28 17:43:39-07:00,['f7f9f3c7905b047f262383bcc64ebb01ab73f421'],9,169,178,1064777,6,,,,2758
a66fcd16f5b9ed163798be67afb3f3caba6360f0,0,GitHub,2020-09-01 15:26:21-07:00,['6ff6f5588d9516d7f72ed0fc8d7862f7c92d06d9'],22,97,119,1064896,3,0,1,1,2758
d689fd2568ea9dd457ed1c7c9cb193f4ae6fa631,0,GitHub,2020-09-02 15:10:42-07:00,['a66fcd16f5b9ed163798be67afb3f3caba6360f0'],167,276,443,1065339,6,0,1,1,2760
ccd5789fec2565165a03428056a96c2087611b22,0,GitHub,2020-09-03 20:05:20-07:00,['d689fd2568ea9dd457ed1c7c9cb193f4ae6fa631'],2,2,4,1065343,2,,,,2760
2079a10d7f1e4861a55adf034cb4eb44784e82a8,0,GitHub,2020-09-09 10:54:19-07:00,['ccd5789fec2565165a03428056a96c2087611b22'],81,52,133,1065476,6,0.714285714,1,0.714285714,2760
3fcced3fc2c7b9b344958fe6a1a59ba65aa88d69,0,nickpan,2020-09-10 17:24:14-07:00,['2079a10d7f1e4861a55adf034cb4eb44784e82a8'],33,36,69,1065545,12,,,,2760
764f09c6239cdec961fe4f52ae97b8f374db107d,0,GitHub,2020-09-11 15:33:50-07:00,['3fcced3fc2c7b9b344958fe6a1a59ba65aa88d69'],35,136,171,1065716,5,0.368421053,1,1,2762
3df04d3f1e5e1b98308ddab6000c13814f3e7425,0,Cheng,2020-09-15 18:09:05-07:00,['764f09c6239cdec961fe4f52ae97b8f374db107d'],0,1,1,1065717,1,,,,2762
42e68e88c4dfe4c891dd601ee98f190d598decfd,0,Cheng,2020-09-15 21:50:40-07:00,['3df04d3f1e5e1b98308ddab6000c13814f3e7425'],17,51,68,1065785,14,1,1,1,2762
7eb7079e0016eac39c5a923fef7e306668418ad1,0,GitHub,2020-09-21 12:19:09-07:00,['764f09c6239cdec961fe4f52ae97b8f374db107d'],21,47,68,1065853,2,0.5,0.5,1,2762
71d2d461606830551bea6bd012d89802db533e03,0,Cheng,2020-09-22 14:38:29-07:00,['42e68e88c4dfe4c891dd601ee98f190d598decfd'],1,1,2,1065855,1,,,,2762
42a57b2471e848c1f0a07edd4052d175dab508e1,0,GitHub,2020-09-22 16:39:42-07:00,"['7eb7079e0016eac39c5a923fef7e306668418ad1', '71d2d461606830551bea6bd012d89802db533e03']",16,51,67,1065922,14,,,,2762
9d5c2c44e6b8bcc608c4042cef382a8ceb706cf4,0,GitHub,2020-09-24 12:42:42-07:00,['42a57b2471e848c1f0a07edd4052d175dab508e1'],33,47,80,1066002,3,0.833333333,1,0.666666667,2762
d12af34de53338048e9eb81f8e46019cd9f5ba06,0,GitHub,2020-10-01 15:26:44-07:00,['9d5c2c44e6b8bcc608c4042cef382a8ceb706cf4'],13,43,56,1066058,2,0,0.947368421,1,2762
13b5303ae1ee76a58d2ebe1dfd2c1df476e7e8b5,0,GitHub,2020-10-12 18:55:23-07:00,['d12af34de53338048e9eb81f8e46019cd9f5ba06'],141,70,211,1066269,7,0,0,0,2762
c0e055d917df2981d999a57a63e05b577aeeca02,0,Yixing Zhang,2020-10-22 11:12:23-07:00,['13b5303ae1ee76a58d2ebe1dfd2c1df476e7e8b5'],7,7,14,1066283,1,,,,2762
23945a5b2cd6bd839219276322538c92478c849c,0,Yixing Zhang,2020-10-28 15:54:21-07:00,['c0e055d917df2981d999a57a63e05b577aeeca02'],1,1,2,1066285,1,,,,2762
fb508b76b4c18c05ecf5fd1ca5860d3e8e330aa1,0,GitHub,2020-10-29 16:15:13-07:00,"['13b5303ae1ee76a58d2ebe1dfd2c1df476e7e8b5', '23945a5b2cd6bd839219276322538c92478c849c']",8,8,16,1066301,2,,,,2762
276ed046a57873b038d9256d453df4188ee16b82,0,Cheng,2020-11-04 12:06:55-08:00,['fb508b76b4c18c05ecf5fd1ca5860d3e8e330aa1'],2,22,24,1066325,4,0,0.823529412,1,2762
60fa35906d1b4534fd23d8c32b898ec61f0411d7,0,GitHub,2020-11-04 21:16:28-08:00,['fb508b76b4c18c05ecf5fd1ca5860d3e8e330aa1'],6,6,12,1066337,3,,,,2762
6665098b25bad4061083e549ca57d556eb51788c,0,Hai Lu,2020-11-16 10:21:21-08:00,['60fa35906d1b4534fd23d8c32b898ec61f0411d7'],1,101,102,1066439,3,0.409836066,0.93442623,0.868852459,2762
120f2fb5caf9f0606a7ee233e7445c4db469f413,0,GitHub,2020-11-17 09:56:49-08:00,['60fa35906d1b4534fd23d8c32b898ec61f0411d7'],7,21,28,1066467,5,0.5,1,1,2762
e53083b3ca75c35a9901f27892c39be0d2d44a9f,0,Boris S,2020-11-17 13:35:27-08:00,['120f2fb5caf9f0606a7ee233e7445c4db469f413'],0,2,2,1066469,1,,,,2762
f20be45b54b74f6ed07f02a84e63f1b37d48c757,0,Cheng,2020-11-17 17:16:47-08:00,['276ed046a57873b038d9256d453df4188ee16b82'],8,15,23,1066492,2,0,1,1,2762
48dddc0b74b10a52684adfb1732677351ac08945,0,Cheng,2020-11-17 17:22:21-08:00,['f20be45b54b74f6ed07f02a84e63f1b37d48c757'],7,0,7,1066499,1,0,0,0,2762
56f450eb965e7532df290f01d2373b473aaf288d,0,Boris S,2020-11-18 10:16:33-08:00,['e53083b3ca75c35a9901f27892c39be0d2d44a9f'],1,0,1,1066500,1,,,,2762
64c659fa259072c54798b2d686e46fa89dee9783,0,GitHub,2020-11-18 10:32:24-08:00,"['120f2fb5caf9f0606a7ee233e7445c4db469f413', '56f450eb965e7532df290f01d2373b473aaf288d']",0,1,1,1066501,1,,,,2762
340af402d51594ea27574c67af24036bd60b67dd,0,Cheng,2020-11-18 17:36:11-08:00,['48dddc0b74b10a52684adfb1732677351ac08945'],5,3,8,1066509,2,1,0,0,2762
0e0501bf5977ac1af84fc416d3fc5c33a315469c,0,Boris Shkolnik,2020-11-19 09:51:27-08:00,['120f2fb5caf9f0606a7ee233e7445c4db469f413'],0,37,37,1066546,1,,,,2762
f2b10e069510bac3baba7f70ec8486b77ba0a05f,0,GitHub,2020-11-19 10:04:56-08:00,"['64c659fa259072c54798b2d686e46fa89dee9783', '0e0501bf5977ac1af84fc416d3fc5c33a315469c']",0,37,37,1066583,1,,,,2762
c3636b8aba8dddc6e09e92ff6336630a865fb948,0,Boris S,2020-11-19 16:59:40-08:00,['120f2fb5caf9f0606a7ee233e7445c4db469f413'],2,13,15,1066598,2,,,,2762
42dcc91a14d0729207cf447cf2c6c9c97c099acd,0,Cheng,2020-11-20 15:10:04-08:00,['340af402d51594ea27574c67af24036bd60b67dd'],10,24,34,1066632,5,0,1,1,2762
db47dd3db4a9162975363ca17a120aaa9dfd9ae9,0,Cheng,2020-11-20 15:30:32-08:00,['42dcc91a14d0729207cf447cf2c6c9c97c099acd'],14,0,14,1066646,3,1,0,0,2762
ed0a23092a4f9930a3137c2060ef3817d0b9d53c,0,Cheng,2020-11-20 16:57:16-08:00,['db47dd3db4a9162975363ca17a120aaa9dfd9ae9'],1,2,3,1066649,1,,,,2762
2d477cd2f54274856c13c533b0f0c189898f3c30,0,Boris S,2020-11-20 17:34:33-08:00,['c3636b8aba8dddc6e09e92ff6336630a865fb948'],2,1,3,1066652,1,,,,2762
a58125bb57071996a698370e260419a2a403d0d4,0,Hai Lu,2020-11-21 16:51:33-08:00,['6665098b25bad4061083e549ca57d556eb51788c'],1,2,3,1066655,1,0,0,1,2762
4ad502f67470c74c98be0c8f9a884a05ade28483,0,GitHub,2020-11-21 17:02:50-08:00,"['f2b10e069510bac3baba7f70ec8486b77ba0a05f', 'a58125bb57071996a698370e260419a2a403d0d4']",1,102,103,1066758,3,,,,2762
36e36bc02a8faad3367fcb2fa66cc8efc34a8c2b,0,GitHub,2020-11-23 17:08:32-08:00,"['4ad502f67470c74c98be0c8f9a884a05ade28483', '2d477cd2f54274856c13c533b0f0c189898f3c30']",2,12,14,1066772,2,,,,2762
1dfe009ea33963e66676deeb5c4804e6ef9664ab,1,Cheng,2020-11-24 18:08:36-08:00,['ed0a23092a4f9930a3137c2060ef3817d0b9d53c'],43,63,106,1066878,6,0.52,1,1,2762
126ae084b8399e2975c184006c64ec9fdb166185,0,Cheng,2020-11-24 18:15:18-08:00,['1dfe009ea33963e66676deeb5c4804e6ef9664ab'],3,9,12,1066890,2,,,,2762
3fd456a0554d1c77a70a630b7aa73929f508a045,1,GitHub,2020-11-24 18:53:50-08:00,['36e36bc02a8faad3367fcb2fa66cc8efc34a8c2b'],9,197,206,1067096,5,0.220338983,0.957627119,0.644067797,2762
c212cac420864d09f2663da2e51c23e4718d6812,0,GitHub,2020-11-30 23:37:21-08:00,['3fd456a0554d1c77a70a630b7aa73929f508a045'],7,290,297,1067393,8,0.628865979,0.855670103,0.81443299,2765
3179f86fb8ad9f019d6c6df12f4f10a6a3479e22,0,GitHub,2020-12-02 17:14:06-08:00,"['c212cac420864d09f2663da2e51c23e4718d6812', '126ae084b8399e2975c184006c64ec9fdb166185']",39,84,123,1067516,9,,,,2765
324c381f19bcff41d181c006ec8d39ef8d5c8545,0,Sanil15,2020-12-03 10:50:01-08:00,['c212cac420864d09f2663da2e51c23e4718d6812'],1,1,2,1067518,1,,,,2765
dd2f2b83b0d8270b90e0dc6400527c54bf2cbb9b,0,GitHub,2020-12-03 11:03:25-08:00,"['3179f86fb8ad9f019d6c6df12f4f10a6a3479e22', '324c381f19bcff41d181c006ec8d39ef8d5c8545']",1,1,2,1067520,1,,,,2765
220cbe29911718b5b49509d3f42e8851237f6249,0,GitHub,2020-12-07 07:50:25-08:00,['dd2f2b83b0d8270b90e0dc6400527c54bf2cbb9b'],9,51,60,1067580,3,0.266666667,0.133333333,1,2765
5a099ebae130079e71c9b26797b41fe6e9252898,0,GitHub,2020-12-07 13:47:57-08:00,['220cbe29911718b5b49509d3f42e8851237f6249'],39,256,295,1067875,8,0,0.603773585,0.990566038,2765
1962946d2cf6804fa92c15914daa8d48a14f5e09,0,GitHub,2020-12-08 11:08:08-08:00,['5a099ebae130079e71c9b26797b41fe6e9252898'],0,714,714,1068589,7,0.545098039,0.894117647,0.88627451,2770
108768393960a893f9d202edf50bf47d2b1af590,0,GitHub,2020-12-09 09:33:11-08:00,['1962946d2cf6804fa92c15914daa8d48a14f5e09'],101,443,544,1069133,9,0.720588235,0.960784314,0.901960784,2770
708a6dec8905d7671d3bf70d9124472e52d30cdc,0,GitHub,2020-12-22 13:19:59-08:00,['108768393960a893f9d202edf50bf47d2b1af590'],2,726,728,1069861,14,1,1,0.845771144,2779
5748fa6adec729840beef03495aa6b74f739f017,0,GitHub,2020-12-24 11:20:54-08:00,['708a6dec8905d7671d3bf70d9124472e52d30cdc'],53,239,292,1070153,10,0.307692308,0.509615385,0.634615385,2779
f0afc48902bff36946f5f93f046f9e7e573bc601,0,Cheng,2021-01-04 16:59:52-08:00,['5748fa6adec729840beef03495aa6b74f739f017'],16,9,25,1070178,2,0.25,0,0,2779
f013058a5056453bd51ed0ffe5ad74e91e4071ca,0,Cheng,2021-01-04 17:05:09-08:00,['f0afc48902bff36946f5f93f046f9e7e573bc601'],0,2,2,1070180,1,0,1,1,2779
f7f9b905b40738667a0694d4c490c182d5236d52,0,GitHub,2021-01-04 18:40:58-08:00,"['5748fa6adec729840beef03495aa6b74f739f017', 'f013058a5056453bd51ed0ffe5ad74e91e4071ca']",15,10,25,1070205,2,,,,2779
d0036516509674252edeeb181d994824f0bbec9a,0,GitHub,2021-01-07 12:29:17-08:00,['f7f9b905b40738667a0694d4c490c182d5236d52'],132,373,505,1070710,10,0.91509434,1,1,2779
07e475b201049da2f0ae1966f309984f15aa497b,0,Boris Shkolnik,2021-01-28 10:44:09-08:00,['d0036516509674252edeeb181d994824f0bbec9a'],1,1,2,1070712,1,,,,2779
4bd8af1dbe16e6576004ba8350be46e6a3707057,0,Boris Shkolnik,2021-01-28 17:45:48-08:00,['07e475b201049da2f0ae1966f309984f15aa497b'],15,163,178,1070890,10,,,,2781
f305149d224f46300bf796770ccab798ca8d845d,0,GitHub,2021-02-03 15:55:47-08:00,['07e475b201049da2f0ae1966f309984f15aa497b'],2,9,11,1070901,3,0.75,0.75,0.75,2781
4e7154f11b9c2ad33464b08f46900644944a0682,0,GitHub,2021-02-03 20:39:02-08:00,['f305149d224f46300bf796770ccab798ca8d845d'],12,3,15,1070916,2,0,0,0,2781
479e5108272b2294bbc2e6a03dad16716ddfb9cb,0,GitHub,2021-02-03 21:35:16-08:00,['4e7154f11b9c2ad33464b08f46900644944a0682'],2,2,4,1070920,1,,,,2781
cf8f8143dc50b681d3616c5a3823cf477eb3d30b,0,Boris Shkolnik,2021-02-04 10:00:39-08:00,"['4bd8af1dbe16e6576004ba8350be46e6a3707057', '479e5108272b2294bbc2e6a03dad16716ddfb9cb']",16,14,30,1070950,6,,,,2781
7e2e64191fa39bd087fc671f48c4f629e910bf58,0,Boris Shkolnik,2021-02-04 10:39:46-08:00,['cf8f8143dc50b681d3616c5a3823cf477eb3d30b'],2,2,4,1070954,1,,,,2781
8cf6a4e6f3a0eadd235782ff8aac51fe5de7e0b9,0,Boris Shkolnik,2021-02-04 15:06:20-08:00,['7e2e64191fa39bd087fc671f48c4f629e910bf58'],3,3,6,1070960,1,,,,2781
17a9c2fd0bcc14b6f9ca6c12aa9ab46e46897e16,0,GitHub,2021-02-04 18:10:10-08:00,"['7e2e64191fa39bd087fc671f48c4f629e910bf58', '8cf6a4e6f3a0eadd235782ff8aac51fe5de7e0b9']",3,3,6,1070966,1,,,,2781
eb3de5cc116b489cccde7076f6c672e2535e2a3e,0,GitHub,2021-02-10 17:04:12-08:00,['17a9c2fd0bcc14b6f9ca6c12aa9ab46e46897e16'],1,15,16,1070982,2,1,1,1,2781
83204fc6e72e1a18e3b70420e777bce079c92757,0,GitHub,2021-02-16 18:59:07-08:00,['eb3de5cc116b489cccde7076f6c672e2535e2a3e'],8,8,16,1070998,1,,,,2781
e28daeee574b96487f0245df1a2845686e64cfa1,0,GitHub,2021-02-24 09:28:13-08:00,['83204fc6e72e1a18e3b70420e777bce079c92757'],1,29,30,1071028,2,,,,2782
0f275cfd6f72691464ef82630b489fc8858bddde,0,Ke Wu,2021-02-25 15:35:12-08:00,['e28daeee574b96487f0245df1a2845686e64cfa1'],0,28,28,1071056,1,,,,2783
66b2efd1ee96436dd4f4af798da458bc5928d824,0,GitHub,2021-03-03 12:29:19-08:00,['0f275cfd6f72691464ef82630b489fc8858bddde'],4,32,36,1071092,2,0,1,0.923076923,2783
93c41dfbc776a1b0b24a947234d6d94981709a0e,0,GitHub,2021-03-03 12:52:05-08:00,['66b2efd1ee96436dd4f4af798da458bc5928d824'],1,1,2,1071094,1,,,,2783
89b71ed803ae3049a86d9d877ccec9b69e758a46,0,GitHub,2021-03-03 14:19:41-08:00,['93c41dfbc776a1b0b24a947234d6d94981709a0e'],61,53,114,1071208,10,1,0,0,2783
87779c8b193c6468557cc7e41d250d298dbc5a2c,1,Ke Wu,2021-03-04 11:10:06-08:00,['89b71ed803ae3049a86d9d877ccec9b69e758a46'],209,210,419,1071627,73,1,0,0,2783
5547f8c9bf2cad40857c298fdf62cbfcd8a35fc4,0,GitHub,2021-03-10 18:42:21-08:00,['87779c8b193c6468557cc7e41d250d298dbc5a2c'],864,185,1049,1072676,24,0.702233251,0.225806452,0.104218362,2784
b3128e0bca7877c3c423d5b0d639803e7f837b13,0,GitHub,2021-03-12 04:55:43-08:00,['5547f8c9bf2cad40857c298fdf62cbfcd8a35fc4'],2,11,13,1072689,1,1,1,1,2784
2aea5f71f9742bf995e88608750a071c44ceade5,0,GitHub,2021-03-12 07:07:27-08:00,['b3128e0bca7877c3c423d5b0d639803e7f837b13'],4,64,68,1072757,3,1,1,1,2784
c08f39d9b46584d3a136e9f5782e09c481b7497a,0,GitHub,2021-03-15 06:51:28-07:00,['2aea5f71f9742bf995e88608750a071c44ceade5'],4,33,37,1072794,2,0,1,1,2784
09863bf3ed6a0f892081f462a8a89f34a4a43dc2,0,GitHub,2021-03-17 13:55:54-07:00,['c08f39d9b46584d3a136e9f5782e09c481b7497a'],8,7,15,1072809,1,,,,2784
acd4493a62051b020f928bd288a3623a8c979f92,0,GitHub,2021-03-19 16:19:19-07:00,['09863bf3ed6a0f892081f462a8a89f34a4a43dc2'],6,12,18,1072827,3,1,1,1,2784
4e392013a321a55eaccc03f75780cbea48668f4e,1,GitHub,2021-03-22 14:41:24-07:00,['acd4493a62051b020f928bd288a3623a8c979f92'],2,33,35,1072862,2,1,1,1,2784
ea14805a0588ac3cd7ffbef0e23463962bf9246b,0,GitHub,2021-03-23 15:27:20-07:00,['4e392013a321a55eaccc03f75780cbea48668f4e'],1,3,4,1072866,1,0,0,1,2784
29deb426b3adf1d73e6c5e74330280efbebc974e,0,GitHub,2021-03-25 17:45:21-07:00,['ea14805a0588ac3cd7ffbef0e23463962bf9246b'],13,6,19,1072885,1,,,,2784
a2827db501afc98d420ada50cf7a914436b8dd66,0,GitHub,2021-03-26 04:39:50-07:00,['29deb426b3adf1d73e6c5e74330280efbebc974e'],2,7,9,1072894,1,0,1,1,2784
da8d1582cc4cff22c23d80dc117ea4f076ca3827,1,GitHub,2021-03-26 16:25:48-07:00,['a2827db501afc98d420ada50cf7a914436b8dd66'],113,374,487,1073381,4,1,1,0.72,2784
78e42325410c795482176c7e8d2effabd24de227,0,GitHub,2021-03-30 17:12:13-07:00,['da8d1582cc4cff22c23d80dc117ea4f076ca3827'],2,55,57,1073438,2,0.111111111,0.777777778,0.777777778,2784
78c50e7ae5b4127ff4cc7a53f322f428c4b52323,1,GitHub,2021-03-30 18:24:44-07:00,['78e42325410c795482176c7e8d2effabd24de227'],0,2,2,1073440,1,0,0,0,2784
9e8dcbe787b2d331e731cdeb263f1d159959a925,0,GitHub,2021-03-30 18:34:28-07:00,['78c50e7ae5b4127ff4cc7a53f322f428c4b52323'],17,11,28,1073468,3,1,1,1,2784
86932b9c36a7e69cd0189e522835bb2af6bab634,0,GitHub,2021-04-02 17:17:06-07:00,['9e8dcbe787b2d331e731cdeb263f1d159959a925'],21,281,302,1073770,8,0.542253521,0.781690141,1,2784
9d9ebc70d127c9deca35e09d1056835ad4f73983,0,perkss,2021-04-17 12:11:45+01:00,['86932b9c36a7e69cd0189e522835bb2af6bab634'],49,3,52,1073822,6,0,0,0.458333333,2784
8ecd4458b3353734e36f8ddc31e97c5ec9779e21,0,GitHub,2021-04-27 15:21:07-07:00,['86932b9c36a7e69cd0189e522835bb2af6bab634'],12,50,62,1073884,1,1,1,1,2784
33bc5be6a5c339d2953a9053eaca3dc178a1be40,0,GitHub,2021-04-28 11:22:08-07:00,['8ecd4458b3353734e36f8ddc31e97c5ec9779e21'],115,142,257,1074141,4,0.139534884,1,1,2786
de067c48d8bbac894e0efa41cda37ebf26551e42,0,GitHub,2021-04-28 14:27:47-07:00,['33bc5be6a5c339d2953a9053eaca3dc178a1be40'],804,15,819,1074960,14,0.453924915,0,0.249146758,2786
8250a4380374e71bfcc9fe1ba43fd4cda773e7a0,0,GitHub,2021-04-29 10:48:01-07:00,['de067c48d8bbac894e0efa41cda37ebf26551e42'],25,24,49,1075009,3,,,,2786
2563caafcb53c913c6f40342219480e7ef56aa34,0,GitHub,2021-04-29 11:03:57-07:00,['8250a4380374e71bfcc9fe1ba43fd4cda773e7a0'],0,82,82,1075091,2,1,1,1,2788
65e51ecb748ae9910c3131458fba932f4f15a67d,0,GitHub,2021-05-04 17:08:01-07:00,['2563caafcb53c913c6f40342219480e7ef56aa34'],1,20,21,1075112,2,0.75,1,0.75,2788
aa58950ee3b8487e9892d9638e893764cf3cc345,1,GitHub,2021-05-06 14:44:46-07:00,['86932b9c36a7e69cd0189e522835bb2af6bab634'],270,1675,1945,1077057,40,0.715341959,0.972273567,0.887245841,2801
96b09b5b0ba9172754a5df526cd4d9699b6fde96,0,GitHub,2021-05-07 13:51:12-07:00,['65e51ecb748ae9910c3131458fba932f4f15a67d'],0,475,475,1077532,5,0.597701149,1,0.885057471,2806
c117a685dfa020316c6d9e4ab5b19e8129c4afdb,0,GitHub,2021-05-07 14:03:16-07:00,['aa58950ee3b8487e9892d9638e893764cf3cc345'],1515,4003,5518,1083050,32,0.147000659,0.986816084,0.951878708,2819
c2ef12fa2016b1ee7fd8cc1b34898c233bdcbe3f,0,GitHub,2021-05-10 09:48:38-07:00,['96b09b5b0ba9172754a5df526cd4d9699b6fde96'],5,16,21,1083071,1,,,,2819
c85aade351a3e7dea2a699a5836968a9fc7ec016,1,GitHub,2021-05-12 16:47:09-07:00,['c117a685dfa020316c6d9e4ab5b19e8129c4afdb'],571,717,1288,1084359,35,0.322404372,0.513661202,0.808743169,2820
23627ccd4c35f7c282d20febcfdf95f1df7e7e24,0,GitHub,2021-05-13 09:35:09-07:00,['c2ef12fa2016b1ee7fd8cc1b34898c233bdcbe3f'],1,65,66,1084425,4,0.4,0.6,0.9,2820
d5f5494b7045a3ceb029fe685de8823f8730a652,0,GitHub,2021-05-19 11:33:02-07:00,"['23627ccd4c35f7c282d20febcfdf95f1df7e7e24', '9d9ebc70d127c9deca35e09d1056835ad4f73983']",49,3,52,1084477,6,,,,2820
08931cedea99f35546f4b76923bfe6840bf2144a,0,GitHub,2021-05-19 15:47:11-07:00,['d5f5494b7045a3ceb029fe685de8823f8730a652'],25,95,120,1084597,5,0.382978723,1,1,2820
7cc4eaa96fff244f6dce9c18af804917db7c3b2b,0,GitHub,2021-05-25 16:00:46-07:00,['c85aade351a3e7dea2a699a5836968a9fc7ec016'],193,6652,6845,1091442,59,0.326080387,0.877908734,0.784527047,2855
c2b77f099d062b2c303be932dfe4386818c0a4ac,0,GitHub,2021-05-28 10:16:53-07:00,['7cc4eaa96fff244f6dce9c18af804917db7c3b2b'],19,38,57,1091499,4,1,1,1,2855
1f0f8bdb669894fc7b9c5947d2a8fc9e45d66014,0,GitHub,2021-06-15 11:36:33-07:00,['08931cedea99f35546f4b76923bfe6840bf2144a'],5,2,7,1091506,2,,,,2855
337628effb0d3ac5b8454217b5caee7fa42f06b4,1,GitHub,2021-06-29 15:33:15-07:00,['1f0f8bdb669894fc7b9c5947d2a8fc9e45d66014'],70,255,325,1091831,6,1,1,0.935897436,2856
4c11067b0e2d7c6cb1f9c472c0843eea861a632e,0,GitHub,2021-07-01 15:21:43-07:00,['337628effb0d3ac5b8454217b5caee7fa42f06b4'],205,393,598,1092429,12,0.855421687,1,1,2856
8fa07fe130f175513088d06abe1f5ed5cdd0624e,1,GitHub,2021-07-29 15:40:50-07:00,['4c11067b0e2d7c6cb1f9c472c0843eea861a632e'],6,41,47,1092476,2,0,0.791666667,1,2856
354620f0356c14c02637baab80a76f8c2d59e11d,0,Daniel Chen,2021-08-02 20:34:11-07:00,['c2b77f099d062b2c303be932dfe4386818c0a4ac'],47,3,50,1092526,2,0,0,0,2856
48a878567ec50986cabee9d27386c8ca1d5c0b2f,0,Daniel Chen,2021-08-02 20:43:50-07:00,['354620f0356c14c02637baab80a76f8c2d59e11d'],34,99,133,1092659,7,0,0,1,2856
20631555fc1bb7d663def3e5d42d03e1ae56a318,0,Daniel Chen,2021-08-02 20:44:03-07:00,['48a878567ec50986cabee9d27386c8ca1d5c0b2f'],1,3,4,1092663,1,1,1,0,2856
271ef6469ca4bf264830a885df5d64e64cb9addb,0,Daniel Chen,2021-08-02 20:44:03-07:00,['20631555fc1bb7d663def3e5d42d03e1ae56a318'],4,13,17,1092680,2,0.142857143,1,1,2856
7d61a7d9de9429f64664586144bff66ecc3852ae,0,Daniel Chen,2021-08-02 20:44:03-07:00,['271ef6469ca4bf264830a885df5d64e64cb9addb'],2,5,7,1092687,3,,,,2856
7f5ff3a9e472a0352b2f329423b5f5a58916cf6d,0,Daniel Chen,2021-08-02 20:44:03-07:00,['7d61a7d9de9429f64664586144bff66ecc3852ae'],2,2,4,1092691,1,,,,2856
35c0dbc96d87001ced5e0c0272e28b7d2a8c8602,0,Daniel Chen,2021-08-02 20:44:03-07:00,['7f5ff3a9e472a0352b2f329423b5f5a58916cf6d'],23,141,164,1092855,11,0.329545455,1,1,2856
7676da930a9b504be77d4010747be8ae9a20628b,0,Daniel Chen,2021-08-02 21:04:14-07:00,['35c0dbc96d87001ced5e0c0272e28b7d2a8c8602'],60,222,282,1093137,7,0.116071429,0.491071429,0.598214286,2856
5379f97ae1e93f9af218fc3771d8d85ef4cce3e6,0,Daniel Chen,2021-08-02 21:07:44-07:00,['7676da930a9b504be77d4010747be8ae9a20628b'],87,359,446,1093583,13,0.100456621,0.945205479,0.9543379,2856
06974575051b5db971e23bb5cb323de54a7603d4,0,Daniel Chen,2021-08-02 21:09:20-07:00,['5379f97ae1e93f9af218fc3771d8d85ef4cce3e6'],3,5,8,1093591,2,0,0,0,2856
e74c2415cee42ec6457947698c4827d04e821df5,0,Daniel Chen,2021-08-02 21:18:03-07:00,['06974575051b5db971e23bb5cb323de54a7603d4'],1,90,91,1093682,2,0,1,1,2856
ad408d5e8557255582d84dce522ed3da133eba23,0,Daniel Chen,2021-08-02 21:18:05-07:00,['e74c2415cee42ec6457947698c4827d04e821df5'],12,13,25,1093707,4,0,0,0,2856
785d5060410ba8342509e5dae2303e20fc62ffa3,0,Daniel Chen,2021-08-03 12:18:25-07:00,['ad408d5e8557255582d84dce522ed3da133eba23'],5,4,9,1093716,5,,,,2856
3c8a4623deda61f5ceae8fd54090119d87ad4899,0,Daniel Chen,2021-08-03 13:09:50-07:00,['785d5060410ba8342509e5dae2303e20fc62ffa3'],1,0,1,1093717,1,,,,2856
65b5df6824acaaaad7cb9e504b831b62eae2a57f,0,Daniel Chen,2021-08-03 13:15:43-07:00,['3c8a4623deda61f5ceae8fd54090119d87ad4899'],1,13,14,1093731,2,1,1,1,2856
48699c477255842a33cfcc97e766a51f95bfd2a8,0,GitHub,2021-08-05 13:25:54-07:00,"['c2b77f099d062b2c303be932dfe4386818c0a4ac', '65b5df6824acaaaad7cb9e504b831b62eae2a57f']",227,916,1143,1094874,35,,,,2856
bad9ee81bc065f6dffd55829335434c5d6dfe010,0,GitHub,2021-08-05 14:24:17-07:00,['8fa07fe130f175513088d06abe1f5ed5cdd0624e'],356,269,625,1095499,10,1,0.185185185,0.37037037,2856
e975b86d0fc92ac2dafe2cc7278204e0c9277187,0,Daniel Chen,2021-08-06 16:12:42-07:00,"['48699c477255842a33cfcc97e766a51f95bfd2a8', '8fa07fe130f175513088d06abe1f5ed5cdd0624e']",1309,1676,2985,1098484,66,,,,2856
c95d828a916d43e6eceaf8c7b600bb7ddf407c33,0,GitHub,2021-08-09 12:37:16-07:00,"['48699c477255842a33cfcc97e766a51f95bfd2a8', 'e975b86d0fc92ac2dafe2cc7278204e0c9277187']",1309,1676,2985,1101469,66,,,,2856
f40402948f37d84c000f1b4340180e538ac75c82,0,GitHub,2021-08-10 10:57:32-07:00,"['bad9ee81bc065f6dffd55829335434c5d6dfe010', 'c95d828a916d43e6eceaf8c7b600bb7ddf407c33']",2398,13616,16014,1117483,139,,,,2856
4824bfe32711a9f9e755c3b3aa8bd8877e9023d6,0,GitHub,2021-08-12 12:39:39-07:00,['f40402948f37d84c000f1b4340180e538ac75c82'],11,19,30,1117513,1,0,0,1,2856
39e5806c7b876b60e41d86f6ef51c6a28482c229,0,Ke Wu,2021-08-19 18:06:18-07:00,['4824bfe32711a9f9e755c3b3aa8bd8877e9023d6'],1,1,2,1117515,1,,,,2856
1169b316dd51a6c972c7fc7ab77ac7e34ba5fbde,0,GitHub,2021-08-23 16:57:54-07:00,['39e5806c7b876b60e41d86f6ef51c6a28482c229'],650,1440,2090,1119605,10,0.711359404,1,0.880819367,2860
120098d6c45ca023d2a0fb144b0e333ab4e8ffe8,0,GitHub,2021-08-24 14:08:17-07:00,['1169b316dd51a6c972c7fc7ab77ac7e34ba5fbde'],81,242,323,1119928,7,0.554216867,0.903614458,1,2862
a7313129659bd068ab11176bcf8ea4597be3713b,0,GitHub,2021-08-24 14:38:02-07:00,['120098d6c45ca023d2a0fb144b0e333ab4e8ffe8'],14,20,34,1119962,8,0,0,0,2862
a7cb039d2d53cbcf207a12fce504066da8bc21cb,0,GitHub,2021-08-25 14:06:28-07:00,['a7313129659bd068ab11176bcf8ea4597be3713b'],2,2,4,1119966,1,,,,2862
e3ab00dae2adc4a8c66155bea20e81d4a17adce8,0,GitHub,2021-08-30 10:15:09-07:00,['a7cb039d2d53cbcf207a12fce504066da8bc21cb'],8,8,16,1119982,3,,,,2862
27b1495589e992cf1606ebfc2e34699077d60b73,0,GitHub,2021-08-30 14:26:40-07:00,['e3ab00dae2adc4a8c66155bea20e81d4a17adce8'],80,182,262,1120244,6,1,1,0.888888889,2864
041075cd5d83e20952970c2be17e3e3911d9ccd8,0,GitHub,2021-08-31 11:17:18-07:00,['27b1495589e992cf1606ebfc2e34699077d60b73'],1,1,2,1120246,1,,,,2864
516a40d8c4eb67cad07a379f28e92fbfb4f459d0,0,GitHub,2021-09-11 10:40:24-07:00,['041075cd5d83e20952970c2be17e3e3911d9ccd8'],1,73,74,1120320,2,0,1,1,2864
c4d059a4db6cae86af046b8a28c33c0316a59e69,0,GitHub,2021-09-14 17:09:54-07:00,['516a40d8c4eb67cad07a379f28e92fbfb4f459d0'],3,40,43,1120363,1,1,1,1,2864
b1ed4215f99dbdd322eab36885fec35bb4c2db60,0,GitHub,2021-09-23 14:44:35-07:00,['c4d059a4db6cae86af046b8a28c33c0316a59e69'],0,47,47,1120410,1,,,,2865
b4dc99fa3346e25b08da1525bad7f979e23259da,0,GitHub,2021-09-27 13:08:54-07:00,['b1ed4215f99dbdd322eab36885fec35bb4c2db60'],0,26,26,1120436,2,,,,2866
7da4ac9133963f249f018297b9c3ad9ef755c65f,0,GitHub,2021-09-27 13:10:01-07:00,['b4dc99fa3346e25b08da1525bad7f979e23259da'],0,1,1,1120437,1,,,,2866
a433ce4c167c8c1d8bb491dd173b62025ffefaa5,0,GitHub,2021-09-27 14:06:37-07:00,['7da4ac9133963f249f018297b9c3ad9ef755c65f'],1,1,2,1120439,1,,,,2866
571f39452419f443154ec72ceed3dd7bb77bed1e,0,GitHub,2021-09-27 17:56:55-07:00,['a433ce4c167c8c1d8bb491dd173b62025ffefaa5'],53,21,74,1120513,2,0,0,0,2866
c570a3ddfc91becb6269926231f5737038f02fff,0,GitHub,2021-09-28 13:06:24-07:00,['571f39452419f443154ec72ceed3dd7bb77bed1e'],37,1589,1626,1122139,22,0.632246377,1,0.793478261,2884
477357430e5b099d81434e0363eed4ddc57f420e,0,GitHub,2021-09-29 10:18:34-07:00,['c570a3ddfc91becb6269926231f5737038f02fff'],444,525,969,1123108,15,0,0.8,1,2886
922a5c1fdda93f2e80b669736ba726608c46c8cd,0,Daniel Chen,2021-10-01 12:44:17-04:00,['477357430e5b099d81434e0363eed4ddc57f420e'],20,0,20,1123128,2,0,0,1,2886
960f0dd1652081f0840d1710a9234b75216a3e34,0,Daniel Chen,2021-10-01 12:44:17-04:00,['922a5c1fdda93f2e80b669736ba726608c46c8cd'],0,32,32,1123160,4,1,1,1,2886
daeecf51153c3984da90bfabdba69cd97449c86d,0,GitHub,2021-10-01 15:12:31-04:00,"['477357430e5b099d81434e0363eed4ddc57f420e', '960f0dd1652081f0840d1710a9234b75216a3e34']",14,26,40,1123200,4,,,,2886
bc9e93f1e9043136c9b6e073a7f3468d527394db,0,GitHub,2021-10-05 21:16:11-07:00,['daeecf51153c3984da90bfabdba69cd97449c86d'],0,62,62,1123262,33,1,1,1,2886
dcdd0ec9de223753a9146e8f7bc535575afb738c,0,GitHub,2021-10-08 11:12:19-07:00,['bc9e93f1e9043136c9b6e073a7f3468d527394db'],818,768,1586,1124848,5,1,0,0.695652174,2888
0423e04d7574dab117fb97e31cac35bd968ae814,0,GitHub,2021-10-11 17:18:14-07:00,['dcdd0ec9de223753a9146e8f7bc535575afb738c'],0,16,16,1124864,2,0,1,1,2888
ab1c4c3eb21b3453fa24aac19afe831f3f24d94f,0,GitHub,2021-10-14 10:51:03-07:00,['0423e04d7574dab117fb97e31cac35bd968ae814'],3,3,6,1124870,2,,,,2888
45c0aa998626bb101eb03ea9e4e2f589dd67753d,0,GitHub,2021-10-14 10:53:34-07:00,['ab1c4c3eb21b3453fa24aac19afe831f3f24d94f'],25,11,36,1124906,1,1,1,0,2888
96d4b80caf1fcdfdd1f751a4cd33a3f4b5739c0b,0,GitHub,2021-10-15 10:20:42-07:00,['45c0aa998626bb101eb03ea9e4e2f589dd67753d'],4,6,10,1124916,1,,,,2888
1348d51622f3f46c7e942556a17ba26edf4afe79,0,GitHub,2021-10-27 15:46:04-07:00,['96d4b80caf1fcdfdd1f751a4cd33a3f4b5739c0b'],52,606,658,1125574,15,0.284444444,1,0.915555556,2895
35e9151f185c45497fce0976d2f97919be02bdee,0,GitHub,2021-10-27 16:08:03-07:00,['1348d51622f3f46c7e942556a17ba26edf4afe79'],2,2,4,1125578,1,,,,2895
88e113dc2b1ae4e2027aaee963001e6efec4a364,0,GitHub,2021-11-08 10:30:07-08:00,['35e9151f185c45497fce0976d2f97919be02bdee'],1,1,2,1125580,1,,,,2895
3054a86ecca7fd1909fd230042c698507e4eba05,0,GitHub,2021-11-08 12:54:12-08:00,['88e113dc2b1ae4e2027aaee963001e6efec4a364'],86,26,112,1125692,6,1,0.096774194,0.548387097,2895
1254659cbe9ec730b579e1ba22f7a03164e9794e,0,GitHub,2021-11-09 14:20:33-08:00,['3054a86ecca7fd1909fd230042c698507e4eba05'],3,8,11,1125703,1,1,1,1,2895
8e9ac406de8af0ee06ea4636386f5fa2b96d4125,0,GitHub,2021-11-10 11:08:09-08:00,['1254659cbe9ec730b579e1ba22f7a03164e9794e'],9,14,23,1125726,4,0,1,1,2895
a6ebdddc74fcf89c1654c8f81126e92502a5d059,0,GitHub,2021-11-11 13:42:42-08:00,['8e9ac406de8af0ee06ea4636386f5fa2b96d4125'],9,29,38,1125764,7,1,1,0.875,2895
a8c3b3969b8aff2db69b52b95324db5fe0f03271,0,GitHub,2021-11-12 10:32:38-08:00,['a6ebdddc74fcf89c1654c8f81126e92502a5d059'],49,0,49,1125813,1,,,,2895
39f65300e5dd3c9e3b6498d213383003cbd5b3c7,0,GitHub,2021-11-16 11:49:43-08:00,['a8c3b3969b8aff2db69b52b95324db5fe0f03271'],11,22,33,1125846,1,0,1,1,2895
f9c0e2bb165f3d3cb93820d95a4a3f27920519b0,0,GitHub,2021-11-17 12:45:12-08:00,['39f65300e5dd3c9e3b6498d213383003cbd5b3c7'],22,116,138,1125984,5,0.333333333,1,0.894736842,2895
dc687dbb8e37061917c553e19ce61eab89694a0e,0,GitHub,2021-11-17 16:43:41-08:00,['f9c0e2bb165f3d3cb93820d95a4a3f27920519b0'],1,1,2,1125986,1,,,,2895
d77211dd5dbb4f18ba1e9504810dd6483bd70f8c,0,GitHub,2021-11-23 13:56:21-08:00,['dc687dbb8e37061917c553e19ce61eab89694a0e'],1,1,2,1125988,1,,,,2895
0faf072792056bdd37ab70e1afd386309b571bd3,0,GitHub,2021-11-30 12:34:09-08:00,['d77211dd5dbb4f18ba1e9504810dd6483bd70f8c'],572,1148,1720,1127708,18,0.754385965,0.897660819,0.897660819,2905
b01b05184f6dd28779f537b62991dc920a94b6c8,0,GitHub,2021-12-01 12:18:48-08:00,['0faf072792056bdd37ab70e1afd386309b571bd3'],1,1,2,1127710,1,,,,2905
2e2ed70e1904440ac61689e775b02bd95bfd9053,0,GitHub,2021-12-06 10:05:10-08:00,['b01b05184f6dd28779f537b62991dc920a94b6c8'],4,81,85,1127795,4,0.105263158,1,0.894736842,2905
5714ff98bce0391b323a2e0b5723d7da53deb558,0,GitHub,2021-12-06 14:53:24-08:00,['2e2ed70e1904440ac61689e775b02bd95bfd9053'],3,3,6,1127801,1,,,,2905
1daca8923396492496732175d87c0367b21355df,0,GitHub,2021-12-06 16:30:05-08:00,['5714ff98bce0391b323a2e0b5723d7da53deb558'],223,420,643,1128444,22,0.222222222,0.976190476,0.563492063,2905
6c7fbaaffa5e403b43683aa9600644b1a596e06c,0,GitHub,2021-12-08 10:45:06-08:00,['1daca8923396492496732175d87c0367b21355df'],14,36,50,1128494,3,0.625,1,0.625,2905
810fe6e5e45fc29834084a34dd9bad5bd6a32db8,0,Ke Wu,2021-12-10 17:36:44-08:00,['6c7fbaaffa5e403b43683aa9600644b1a596e06c'],1,1,2,1128496,1,,,,2905
05d5916f6b8e900fba09c2183663cd14ebeaf654,0,GitHub,2021-12-14 13:00:41-08:00,['810fe6e5e45fc29834084a34dd9bad5bd6a32db8'],1,1,2,1128498,1,,,,2905
90a44b3ce68684b5f530a8cc67373f8c4486bd64,0,Prateek Maheshwari,2021-12-21 15:59:18-08:00,['05d5916f6b8e900fba09c2183663cd14ebeaf654'],105,129,234,1128732,7,0,0.15625,1,2905
636b67feed1bc094f447ef061ab240a7e6c935d4,0,Prateek Maheshwari,2021-12-21 16:25:34-08:00,['90a44b3ce68684b5f530a8cc67373f8c4486bd64'],8,0,8,1128740,1,0,0,0,2905
68a4ac70fed48f635975afbeb0ae94be903c9d0a,0,GitHub,2021-12-22 10:22:34-08:00,"['05d5916f6b8e900fba09c2183663cd14ebeaf654', '636b67feed1bc094f447ef061ab240a7e6c935d4']",105,121,226,1128966,7,,,,2905
c125b15142c921c2276508ae0322d3ea508bb136,0,GitHub,2021-12-22 14:39:18-05:00,['68a4ac70fed48f635975afbeb0ae94be903c9d0a'],17,64,81,1129047,3,0.142857143,0.821428571,0.285714286,2905
49e8ae9191da2ab9c7dc582e72b369fe1ce59363,0,shekhars-li,2021-12-22 14:17:39-08:00,['c125b15142c921c2276508ae0322d3ea508bb136'],2,11,13,1129060,2,0,0,0.666666667,2905
93b69788890fe714294897c05e87b4f4b1742f2b,0,shekhars-li,2021-12-22 14:49:04-08:00,['49e8ae9191da2ab9c7dc582e72b369fe1ce59363'],5,5,10,1129070,2,,,,2905
b0541f1b82241ec9d11029a764888f834e5a53e0,0,shekhars-li,2021-12-22 14:57:21-08:00,['93b69788890fe714294897c05e87b4f4b1742f2b'],1,0,1,1129071,1,,,,2905
85151e2c3f44c5e225ddf1fca80276de9fcc5713,0,GitHub,2022-01-03 09:31:37-08:00,"['c125b15142c921c2276508ae0322d3ea508bb136', 'b0541f1b82241ec9d11029a764888f834e5a53e0']",8,16,24,1129095,4,,,,2905
c4115987fdd65a169e61cf254e7752ae9d609667,0,Prateek Maheshwari,2022-01-10 12:51:25-08:00,['85151e2c3f44c5e225ddf1fca80276de9fcc5713'],5,5,10,1129105,1,,,,2905
b76a7af055b7038cb75fd7d6ff0a3e42287a377e,0,GitHub,2022-01-10 13:16:15-08:00,"['85151e2c3f44c5e225ddf1fca80276de9fcc5713', 'c4115987fdd65a169e61cf254e7752ae9d609667']",5,5,10,1129115,1,,,,2905
4584d5d8aadf12d2f2c80d5c73cc97fde7910cc8,0,GitHub,2022-01-11 05:47:24-08:00,['b76a7af055b7038cb75fd7d6ff0a3e42287a377e'],2,3,5,1129120,1,,,,2905
b56044a5c18485816638c4cb40c31da0a21d0ae6,0,GitHub,2022-01-20 15:31:50-08:00,['4584d5d8aadf12d2f2c80d5c73cc97fde7910cc8'],601,2223,2824,1131944,82,0.40567201,0.979038224,0.89025894,2912
aa31bb6ecedc4790b3607ddce0f3ef10737bda90,0,GitHub,2022-01-20 16:29:14-08:00,['b56044a5c18485816638c4cb40c31da0a21d0ae6'],1,122,123,1132067,2,1,1,0.882352941,2913
c5831bfc01b2e70ba57c4bd3505c6a84a73c8a7b,0,GitHub,2022-01-27 10:51:05-08:00,['aa31bb6ecedc4790b3607ddce0f3ef10737bda90'],1,77,78,1132145,3,,,,2914
28b644c7cd8a899df73c24ead506ad3691a3dd39,0,GitHub,2022-02-01 15:22:41-08:00,['c5831bfc01b2e70ba57c4bd3505c6a84a73c8a7b'],47,76,123,1132268,5,,,,2915
43ff95f58f193766b8adb6b85e1d45b078c43721,0,GitHub,2022-02-03 17:02:26-08:00,['28b644c7cd8a899df73c24ead506ad3691a3dd39'],33,53,86,1132354,8,0.909090909,0.818181818,0.909090909,2915
3eaa697d791ac444edde930750b7c38f1f5a69eb,0,GitHub,2022-02-04 11:55:03-08:00,['43ff95f58f193766b8adb6b85e1d45b078c43721'],1,181,182,1132536,6,0.169354839,0.935483871,0.935483871,2915
2e7c2fe6c095d05b1b75fc0c2768ad0e9a81a085,0,GitHub,2022-02-04 14:37:34-08:00,['3eaa697d791ac444edde930750b7c38f1f5a69eb'],42,95,137,1132673,8,0.131578947,0.868421053,0.842105263,2915
8e853336a35acc8de5a7097d1c9d873671df922e,0,Manasa,2022-02-04 17:14:57-08:00,['b56044a5c18485816638c4cb40c31da0a21d0ae6'],19,125,144,1132817,7,0.25,0.09375,0.53125,2915
5b733a4f2f4c14b4d976d96e96f1f7219f076246,0,Manasa,2022-02-04 17:15:58-08:00,['8e853336a35acc8de5a7097d1c9d873671df922e'],22,370,392,1133209,11,0.168141593,1,0.85840708,2915
e0bd1f166e748b9a958ed44191d72da98bb1798a,0,Manasa,2022-02-04 17:18:37-08:00,['3eaa697d791ac444edde930750b7c38f1f5a69eb'],19,125,144,1133353,7,0.25,0.09375,0.53125,2915
69b9beb4a636375c6f7bb17a8bbc712e5d7131a9,0,Manasa,2022-02-04 17:20:02-08:00,['e0bd1f166e748b9a958ed44191d72da98bb1798a'],23,287,310,1133663,11,0.189655172,1,0.816091954,2915
d134bef508a100288a7ca85c8c67ab766e04e529,0,Manasa,2022-02-04 17:21:49-08:00,"['69b9beb4a636375c6f7bb17a8bbc712e5d7131a9', '5b733a4f2f4c14b4d976d96e96f1f7219f076246']",0,0,0,1133663,0,,,,2915
0c2f9a17bf745b67b8b6a05a4bc7857f0c826bdc,0,Manasa,2022-02-04 17:31:47-08:00,['d134bef508a100288a7ca85c8c67ab766e04e529'],5,3,8,1133671,2,1,0.5,0.5,2915
55a8b2694421d9203047274662e91374401f40e3,0,Manasa,2022-02-04 17:38:49-08:00,['0c2f9a17bf745b67b8b6a05a4bc7857f0c826bdc'],25,0,25,1133696,1,1,0,0,2915
ae4453b45305d6eb1a3af2d67751359a39c6cd6d,0,Manasa,2022-02-08 17:25:01-08:00,['55a8b2694421d9203047274662e91374401f40e3'],16,101,117,1133813,4,0.177777778,0.622222222,1,2915
589f5c57c34b2533adfa772862f91951834d4a10,0,Manasa,2022-02-10 17:07:42-08:00,['ae4453b45305d6eb1a3af2d67751359a39c6cd6d'],3,33,36,1133849,2,0.923076923,1,1,2915
664ebb0adddd6c4bb65c1c213e55888a1df67f49,0,GitHub,2022-02-14 15:29:29-08:00,['2e7c2fe6c095d05b1b75fc0c2768ad0e9a81a085'],5,105,110,1133959,2,0.214285714,0.785714286,0.785714286,2916
a7c77c64ff1b6053f2001fd2e43de910ebfeefb2,0,Manasa,2022-02-18 11:51:10-08:00,['589f5c57c34b2533adfa772862f91951834d4a10'],45,56,101,1134060,7,0,1,1,2916
bee7f257f1fa2c25bebd47b1e65dbe6a2bcdc882,0,GitHub,2022-02-18 13:30:25-08:00,"['664ebb0adddd6c4bb65c1c213e55888a1df67f49', 'a7c77c64ff1b6053f2001fd2e43de910ebfeefb2']",40,509,549,1134609,17,,,,2916
06ef532b7d0f6492deaceec573e9f7060d2d9b64,0,GitHub,2022-02-18 17:22:10-08:00,['bee7f257f1fa2c25bebd47b1e65dbe6a2bcdc882'],1,1,2,1134611,1,,,,2916
95f9e0da2878e5689f1a186120e9eae84301b246,0,GitHub,2022-02-28 13:17:37-08:00,['06ef532b7d0f6492deaceec573e9f7060d2d9b64'],5,5,10,1134621,3,,,,2916
858ed3fec4ea96c18c9514f7786514aff0836b72,0,GitHub,2022-03-04 16:37:08-08:00,['95f9e0da2878e5689f1a186120e9eae84301b246'],9,56,65,1134686,2,0.653846154,1,1,2916
735f546c52afd30112bf23a50bc8715863e56cc7,0,GitHub,2022-03-07 18:43:25-08:00,['858ed3fec4ea96c18c9514f7786514aff0836b72'],11,115,126,1134812,7,0,0.535714286,0.928571429,2916
3a902771579917952d1155d5c6ac75cec84f09dc,0,GitHub,2022-03-09 22:37:10-08:00,['735f546c52afd30112bf23a50bc8715863e56cc7'],3,158,161,1134973,6,0.965517241,0.965517241,0.965517241,2919
3a023c185ee165fd6040337b89f7b722ec7ea6a6,0,GitHub,2022-03-14 14:58:22-07:00,['3a902771579917952d1155d5c6ac75cec84f09dc'],0,2,2,1134975,1,0,1,1,2919
f41d29cc10556a150d5b380a15a126eafc290b97,0,GitHub,2022-03-17 14:31:19-07:00,['3a902771579917952d1155d5c6ac75cec84f09dc'],5,62,67,1135042,5,0,0.394736842,1,2919
50500edfbe6aa74eaa445ccc0c26ee6bc54c2e66,0,GitHub,2022-03-25 15:43:48-07:00,['f41d29cc10556a150d5b380a15a126eafc290b97'],0,29,29,1135071,2,0.05,1,0.95,2919
2352ae46980db9e13427f703bfc7f12f1c9860fb,0,Shekhar Sharma,2022-04-04 11:13:06-07:00,['50500edfbe6aa74eaa445ccc0c26ee6bc54c2e66'],5,16,21,1135092,3,0,1,0,2919
c24d631a69d7bf613c27ccff43c3a4de1fec5a2f,0,Shekhar Sharma,2022-04-04 11:26:33-07:00,['2352ae46980db9e13427f703bfc7f12f1c9860fb'],1,0,1,1135093,1,,,,2919
bc5c01ebb654540b92ce8642f779ed7fe4c37e2c,0,Shekhar Sharma,2022-04-04 11:42:24-07:00,['c24d631a69d7bf613c27ccff43c3a4de1fec5a2f'],2,1,3,1135096,1,,,,2919
309e718c4df3dd0f651bb1c73883e5459155e779,0,Shekhar Sharma,2022-04-05 13:24:46-07:00,['bc5c01ebb654540b92ce8642f779ed7fe4c37e2c'],2,2,4,1135100,1,,,,2919
53dbc481aad5b52e689925364f9340e4e4a88e29,0,GitHub,2022-04-05 14:04:29-07:00,"['50500edfbe6aa74eaa445ccc0c26ee6bc54c2e66', '309e718c4df3dd0f651bb1c73883e5459155e779']",7,16,23,1135123,4,,,,2919
303a02e0fdea278f5ad5917ca76c47deefbc13fe,0,GitHub,2022-04-05 16:42:31-07:00,['53dbc481aad5b52e689925364f9340e4e4a88e29'],7,10,17,1135140,2,1,1,1,2919
e37fe259cede587928cc0d543fc8384250c7e113,0,GitHub,2022-04-06 11:02:29-07:00,['303a02e0fdea278f5ad5917ca76c47deefbc13fe'],3,10,13,1135153,2,,,,2919
da75b637a7e3783bca53f5e9aa2be0ed7f77f429,0,Manasa,2022-04-15 14:46:15-07:00,['e37fe259cede587928cc0d543fc8384250c7e113'],16,25,41,1135194,4,0,0.888888889,1,2919
400d1972ca8da08ad0e24d6158048102f1fb3061,0,Manasa,2022-04-15 15:43:26-07:00,['e37fe259cede587928cc0d543fc8384250c7e113'],10,54,64,1135258,3,1,1,1,2919
2cda1742469b5dcb0a3a623544875d59cf6661e1,0,Manasa,2022-04-15 16:59:30-07:00,['400d1972ca8da08ad0e24d6158048102f1fb3061'],9,972,981,1136239,6,0.238993711,0.905660377,0.85115304,2922
cb63b275dfe209f6b2a59509d90d32fa8eb1e826,0,GitHub,2022-04-20 11:49:25-07:00,['e37fe259cede587928cc0d543fc8384250c7e113'],4,23,27,1136266,4,1,1,1,2922
840233ae8e7135e86301fe6234e398e0d6bf6385,0,GitHub,2022-04-27 15:09:33-07:00,"['cb63b275dfe209f6b2a59509d90d32fa8eb1e826', '400d1972ca8da08ad0e24d6158048102f1fb3061']",10,54,64,1136330,3,,,,2922
30cc2c03d6d9657e25f01635a16022231a521f47,0,Manasa,2022-04-27 15:16:23-07:00,['da75b637a7e3783bca53f5e9aa2be0ed7f77f429'],0,0,0,1136330,0,,,,2922
314f5c7b1ed71f4fad8a5262b1f2fecb49a6398f,0,GitHub,2022-04-28 08:58:49-07:00,"['840233ae8e7135e86301fe6234e398e0d6bf6385', '30cc2c03d6d9657e25f01635a16022231a521f47']",16,25,41,1136371,4,,,,2922
c4d42a4d29a71f08e75907c77c8fdc433e0a620a,0,GitHub,2022-04-28 18:25:40-07:00,['314f5c7b1ed71f4fad8a5262b1f2fecb49a6398f'],38,344,382,1136753,5,1,1,1,2923
58af35811f2609268794f7a6482562f9ebae3497,0,Manasa,2022-04-29 17:17:21-07:00,['2cda1742469b5dcb0a3a623544875d59cf6661e1'],13,48,61,1136814,2,0.074074074,1,0.703703704,2923
e52b6502c5ff5ca899b0265e6416b64473cc4a3e,0,Manasa,2022-05-02 12:56:15-07:00,['c4d42a4d29a71f08e75907c77c8fdc433e0a620a'],5,25,30,1136844,2,1,1,1,2923
cea7ab9dbb77cb17d288449e14b7a6b04c336ea6,0,Manasa,2022-05-02 18:38:00-07:00,['58af35811f2609268794f7a6482562f9ebae3497'],2,2,4,1136848,1,,,,2923
8e2f8bc0d0640877111fe1b1ddace9b3c859dc54,0,Manasa,2022-05-04 09:43:00-07:00,['e52b6502c5ff5ca899b0265e6416b64473cc4a3e'],1,41,42,1136890,1,0.142857143,1,1,2923
603cfaacb48780a6b66eba2db8c05198bd0af488,0,Manasa,2022-05-04 15:52:24-07:00,['cea7ab9dbb77cb17d288449e14b7a6b04c336ea6'],110,133,243,1137133,6,0,0.933333333,1,2923
20e6529b8df1a8089cd92bd5463c4dbb893a73ed,0,GitHub,2022-05-05 15:19:37-07:00,"['c4d42a4d29a71f08e75907c77c8fdc433e0a620a', '3a023c185ee165fd6040337b89f7b722ec7ea6a6']",0,2,2,1137135,1,,,,2923
e2b67d18b572145fe06c6d7a1b14bd2588044f3b,0,Prateek Maheshwari,2022-05-12 22:14:03-07:00,['20e6529b8df1a8089cd92bd5463c4dbb893a73ed'],6,145,151,1137286,3,0.708860759,1,0.405063291,2924
fedfd3045c298c8a72520b5213f8f323357577ad,0,Prateek Maheshwari,2022-05-16 08:45:42-07:00,['e2b67d18b572145fe06c6d7a1b14bd2588044f3b'],9,10,19,1137305,2,,,,2924
170f37886bd62b215847c0b8be35c805a14ca389,0,GitHub,2022-05-16 09:13:59-07:00,"['20e6529b8df1a8089cd92bd5463c4dbb893a73ed', 'fedfd3045c298c8a72520b5213f8f323357577ad']",11,151,162,1137467,4,,,,2924
a962e135f46094d06512ec1184b2b845a879418f,0,GitHub,2022-05-17 14:53:21-07:00,"['170f37886bd62b215847c0b8be35c805a14ca389', '8e2f8bc0d0640877111fe1b1ddace9b3c859dc54']",5,65,70,1137537,2,,,,2924
be7e0142ab02f2e91c67910f3cd5df0d9a02bafc,0,Manasa,2022-05-17 14:56:27-07:00,['603cfaacb48780a6b66eba2db8c05198bd0af488'],0,0,0,1137537,0,,,,2924
1ff98f3a5ab3f2c56c742ea1558cea3bf6f0e014,0,GitHub,2022-05-17 15:22:08-07:00,"['a962e135f46094d06512ec1184b2b845a879418f', 'be7e0142ab02f2e91c67910f3cd5df0d9a02bafc']",9,1030,1039,1138576,5,,,,2924
49354c6a99a08916b7c009505f0aec0dfa9283cd,1,Manasa,2022-05-17 15:28:32-07:00,['1ff98f3a5ab3f2c56c742ea1558cea3bf6f0e014'],3,54,57,1138633,3,1,1,0,2924
7dc3de5c649723be5a6d9a67cc6ec260abbe7c5a,0,GitHub,2022-05-17 15:47:28-07:00,"['1ff98f3a5ab3f2c56c742ea1558cea3bf6f0e014', '49354c6a99a08916b7c009505f0aec0dfa9283cd']",3,54,57,1138690,3,,,,2924
01c1c716b6b109dd9cfcaabddee2e2a6cd992077,0,Manasa,2022-05-17 17:51:20-07:00,['a962e135f46094d06512ec1184b2b845a879418f'],20,160,180,1138870,4,0.067567568,1,0.905405405,2924
9363ea6ccfb9f413dba4a5a49bcaa8b9de43b8bc,0,GitHub,2022-05-23 17:29:31-07:00,['7dc3de5c649723be5a6d9a67cc6ec260abbe7c5a'],20,80,100,1138970,4,0,1,0.961538462,2924
3792d71ae5b0dac80dc233893d1ac5e9e83e073d,0,GitHub,2022-05-25 11:45:38-07:00,['9363ea6ccfb9f413dba4a5a49bcaa8b9de43b8bc'],9,15,24,1138994,3,0,1,1,2924
0fc37024bd2b31c70981c61784cb2699cf2d148b,0,Manasa,2022-05-26 10:35:58-07:00,['01c1c716b6b109dd9cfcaabddee2e2a6cd992077'],0,0,0,1138994,0,,,,2924
5135a53d5ec0646a8a6878f91aaff7f0a10f3ac1,0,GitHub,2022-05-27 13:18:23-07:00,"['3792d71ae5b0dac80dc233893d1ac5e9e83e073d', '0fc37024bd2b31c70981c61784cb2699cf2d148b']",20,160,180,1139174,4,,,,2924
eaf8252795aeb6c91ccba107bbef629a1b565775,0,Manasa,2022-05-31 12:26:58-07:00,['5135a53d5ec0646a8a6878f91aaff7f0a10f3ac1'],3,42,45,1139219,2,0,0.466666667,1,2924
9f36e727bd05358d95414d406e1b7f470f8c7a45,0,GitHub,2022-06-01 14:00:20-07:00,"['5135a53d5ec0646a8a6878f91aaff7f0a10f3ac1', 'eaf8252795aeb6c91ccba107bbef629a1b565775']",3,42,45,1139264,2,,,,2924
1072aede568e2e9bd9d69fada1a9cfbd406abdf0,0,GitHub,2022-06-06 11:30:41-07:00,['9f36e727bd05358d95414d406e1b7f470f8c7a45'],2,2,4,1139268,1,,,,2924
22c307178dcb0dd035d962694dfd64e18ff760f8,0,GitHub,2022-06-07 17:27:06-07:00,['1072aede568e2e9bd9d69fada1a9cfbd406abdf0'],31,215,246,1139514,2,0.597826087,1,0.706521739,2924
493de64bb8c0228bbda11822ae3c84c2085263bf,0,GitHub,2022-06-13 15:06:05-07:00,['22c307178dcb0dd035d962694dfd64e18ff760f8'],22,1044,1066,1140580,17,0.497816594,0.912663755,0.945414847,2931
f7afdfff97cd723b76b1ada4dd1f029a1ce44702,0,GitHub,2022-06-29 16:47:49-07:00,['493de64bb8c0228bbda11822ae3c84c2085263bf'],27,212,239,1140819,4,0.1,0.371428571,0.942857143,2931
702fd815fe40bfb23e8d3412e5e8848b585a5d69,0,GitHub,2022-07-21 11:06:28-07:00,['f7afdfff97cd723b76b1ada4dd1f029a1ce44702'],29,58,87,1140906,13,1,1,1,2931
3032c78ea3719bc69096c7dece936333baa43100,0,GitHub,2022-07-26 09:49:54-07:00,['702fd815fe40bfb23e8d3412e5e8848b585a5d69'],1,1,2,1140908,1,,,,2931
a3c3e10c2e054ca832cc3294fe15bd0e87f78023,0,GitHub,2022-07-29 11:16:52-07:00,['3032c78ea3719bc69096c7dece936333baa43100'],234,1461,1695,1142603,39,0.352842809,0.735785953,0.775919732,2936
