sha,is_bug,committer_name,commit_time,parents,all_del,all_add,all_change_lines,all_lines,files_change_nums,dmm_unit_size,dmm_unit_complexity,dmm_unit_interfacing,file_nums
c80b08866d7730d78fb7c0edfc8dc2d758942921,0,Nathan Marz,2011-09-16 12:06:14-07:00,['9edcf177ce7210d7ee7f857dedf0747e5bdb4105'],0,14,14,649,1,,,,12
9d91adbdbde22e91779b91eb40805f598da5b004,1,Nathan Marz,2011-09-17 00:48:10-07:00,[],0,42589,42589,43238,181,0.579859548,0.678220942,0.934185649,193
5fab34e13aabf2bd121e0d0e2db1f80d130887e6,0,Nathan Marz,2011-09-19 02:10:11-05:00,['9d91adbdbde22e91779b91eb40805f598da5b004'],0,1,1,43239,1,,,,193
2c77528ca02c1d6a19a07e9fcddef338a8b69d82,0,Nathan Marz,2011-09-20 10:46:14-05:00,['5fab34e13aabf2bd121e0d0e2db1f80d130887e6'],0,2,2,43241,1,,,,193
e1a6615407915402f43554429b88ab75670bc99b,0,Nathan Marz,2011-09-21 11:51:04-05:00,['c80b08866d7730d78fb7c0edfc8dc2d758942921'],1,2,3,43244,1,,,,193
1469557ec1f4652bcd54f64bad716e1c6e2379b1,0,Nathan Marz,2011-09-21 14:55:41-05:00,['2c77528ca02c1d6a19a07e9fcddef338a8b69d82'],1,1,2,43246,1,,,,193
d5fdf94ba14d13768a14727f6e4afb9cd87c5063,1,Nathan Marz,2011-09-21 16:39:32-05:00,['1469557ec1f4652bcd54f64bad716e1c6e2379b1'],13,81,94,43340,2,1,1,1,193
c2a5bf1ee4524cfb2e6201a6eca481d6cc8f1242,0,Nathan Marz,2011-09-21 16:54:13-05:00,['d5fdf94ba14d13768a14727f6e4afb9cd87c5063'],1,1,2,43342,1,,,,193
2a022ae92cd6bc0d877a244bc2d98f1d8b7cdc05,0,Nathan Marz,2011-09-21 19:16:15-05:00,['c2a5bf1ee4524cfb2e6201a6eca481d6cc8f1242'],1,72,73,43415,1,,,,193
c47e10543daf7938cdb3a1352ef47b349c2a1930,0,Nathan Marz,2011-09-21 19:54:18-07:00,['2a022ae92cd6bc0d877a244bc2d98f1d8b7cdc05'],1,1,2,43417,1,,,,193
433caaafb04835095cfbaed5e565dfa65d32bb3c,1,Nathan Marz,2011-09-21 20:15:48-07:00,['e1a6615407915402f43554429b88ab75670bc99b'],17,13,30,43447,5,1,1,1,193
2ae64459388e605efb7bd00b236936a23d9948b0,0,Nathan Marz,2011-09-21 21:18:01-07:00,['c47e10543daf7938cdb3a1352ef47b349c2a1930'],1,1,2,43449,1,,,,193
f775c09e4397e6d25df05ba7fe967945d7ddf8e2,0,Nathan Marz,2011-09-24 00:16:18-07:00,['2ae64459388e605efb7bd00b236936a23d9948b0'],1,86,87,43536,4,,,,194
3e84ddf38891816409d6748376b7d4d57afc8daa,0,Nathan Marz,2011-09-24 00:25:30-07:00,['2ae64459388e605efb7bd00b236936a23d9948b0'],1,31,32,43568,1,1,1,1,194
2ce3acf2d5d4f48c1beff4b7d32162f84f61aed7,1,Nathan Marz,2011-09-24 00:47:08-07:00,['f775c09e4397e6d25df05ba7fe967945d7ddf8e2'],73,99,172,43740,5,,,,198
25e8d8a5deb70a6b7dab80b35065c3da12fc1d28,0,Nathan Marz,2011-09-24 01:33:53-07:00,['2ce3acf2d5d4f48c1beff4b7d32162f84f61aed7'],53,66,119,43859,7,,,,198
969df632859e9e6f8e4405e2cd48d959cadd672e,0,Nathan Marz,2011-09-24 02:59:41-07:00,['25e8d8a5deb70a6b7dab80b35065c3da12fc1d28'],43,60,103,43962,7,,,,198
a8d85e4d6e6b736cd94235d4eaf37686b7887cb8,0,Nathan Marz,2011-09-24 03:00:09-07:00,"['3e84ddf38891816409d6748376b7d4d57afc8daa', '969df632859e9e6f8e4405e2cd48d959cadd672e']",60,201,261,44223,12,,,,198
1130376bcd38668b80d3aa4e35c617d063fd7095,0,Nathan Marz,2011-09-24 03:33:34-07:00,['a8d85e4d6e6b736cd94235d4eaf37686b7887cb8'],8,6,14,44237,4,,,,198
095ce14e7b289864c64e6a21df2767282ebef416,0,Nathan Marz,2011-09-24 12:07:38-07:00,['1130376bcd38668b80d3aa4e35c617d063fd7095'],1,1,2,44239,1,,,,198
7027ea9cf508c32be56e064182d8d1035d27bfe3,0,Nathan Marz,2011-09-24 12:13:27-07:00,['433caaafb04835095cfbaed5e565dfa65d32bb3c'],1,1,2,44241,1,,,,198
23617033dc978b4256edf9dcb0bed84b7bfe6735,0,Nathan Marz,2011-09-24 12:20:53-07:00,['095ce14e7b289864c64e6a21df2767282ebef416'],1,1,2,44243,1,,,,198
35772e8f136cd9b9b05a651c1a8c14cd90b27793,0,Nathan Marz,2011-09-25 01:01:42-07:00,['23617033dc978b4256edf9dcb0bed84b7bfe6735'],19,22,41,44284,1,,,,198
4e7a187c7f5cdc3fd1a4cb5c8537ae4135660d77,0,Sam Stokes,2011-09-25 19:52:54-07:00,['35772e8f136cd9b9b05a651c1a8c14cd90b27793'],1,1,2,44286,1,,,,198
2fd62d9e00461a4f470717ac80bf06b53770dac3,0,Nathan Marz,2011-09-25 23:13:19-07:00,"['35772e8f136cd9b9b05a651c1a8c14cd90b27793', '4e7a187c7f5cdc3fd1a4cb5c8537ae4135660d77']",1,1,2,44288,1,,,,198
3cee68bdf4b7fc30cf77f3b286edcf3c3451ac3e,0,Nathan Marz,2011-09-27 01:24:08-07:00,['2fd62d9e00461a4f470717ac80bf06b53770dac3'],3,3,6,44294,1,,,,198
f02533bd6b1257891220e6ddcb5210cb7d823a0d,0,Nathan Marz,2011-09-27 01:24:25-07:00,['3cee68bdf4b7fc30cf77f3b286edcf3c3451ac3e'],0,4,4,44298,1,,,,198
2ec6631af32c4b838338b88cad16d0ec3b532c4e,0,Nathan Marz,2011-09-27 01:24:38-07:00,['f02533bd6b1257891220e6ddcb5210cb7d823a0d'],1,1,2,44300,1,,,,198
e1bbcd81c2944f298a6c05a33688ed789d1cfaac,0,Nathan Marz,2011-09-27 01:31:33-07:00,['2ec6631af32c4b838338b88cad16d0ec3b532c4e'],1,1,2,44302,1,,,,198
b3b4b715f88dfb1167024dee23fccb33d1accaa1,0,Nathan Marz,2011-09-27 02:09:43-07:00,['e1bbcd81c2944f298a6c05a33688ed789d1cfaac'],1,3,4,44306,1,,,,198
2937dc083e9513b43fcb489522c0995d8ef4f391,0,Nathan Marz,2011-09-27 20:29:19-07:00,['b3b4b715f88dfb1167024dee23fccb33d1accaa1'],130,104,234,44540,3,0.090909091,0,0.363636364,198
aa3f8292cc012f0acb48ba439bdfa33c97b64fca,0,Nathan Marz,2011-09-27 20:44:20-07:00,['2937dc083e9513b43fcb489522c0995d8ef4f391'],3,26,29,44569,1,,,,198
0c8d942b5d7bcf4a5fa97a2cdda020f9c0799ca1,0,Nathan Marz,2011-09-27 20:54:00-07:00,['aa3f8292cc012f0acb48ba439bdfa33c97b64fca'],10,23,33,44602,2,,,,198
daf093da0f7c4f7e7253cf90f7949e7285946ad4,1,Nathan Marz,2011-09-27 23:29:13-07:00,['0c8d942b5d7bcf4a5fa97a2cdda020f9c0799ca1'],24,231,255,44857,4,0.770491803,1,0.655737705,199
1fea7a49a6d3ab72dac09e398ac988e0831c6832,0,Nathan Marz,2011-09-28 00:02:47-07:00,['daf093da0f7c4f7e7253cf90f7949e7285946ad4'],36,76,112,44969,2,,,,199
ed8729ea578e4e2e2d7fe0026d458b3d5b1e3738,0,Nathan Marz,2011-09-28 00:12:47-07:00,['1fea7a49a6d3ab72dac09e398ac988e0831c6832'],13,20,33,45002,2,,,,199
7fa873d10e147e2363c064f0c3ca64893022e51a,0,Nathan Marz,2011-09-28 00:35:52-07:00,['7027ea9cf508c32be56e064182d8d1035d27bfe3'],1,62,63,45065,2,,,,200
59998cfc18dcc2098f91339674dfe3f47c9f24e4,1,Nathan Marz,2011-09-28 12:24:47-07:00,['ed8729ea578e4e2e2d7fe0026d458b3d5b1e3738'],8,20,28,45093,1,,,,200
2c0b7510ab8ad1e2eca305ad3607814745b142e6,0,Nathan Marz,2011-09-28 12:45:44-07:00,['59998cfc18dcc2098f91339674dfe3f47c9f24e4'],5,17,22,45115,1,,,,200
0e57b733915941034ba5130c40b077635eecaf2f,1,Nathan Marz,2011-09-28 12:45:55-07:00,['2c0b7510ab8ad1e2eca305ad3607814745b142e6'],1,3,4,45119,1,,,,200
8336885d725e5dac598e86f174baa61aa731d1ed,0,Nathan Marz,2011-09-28 12:58:17-07:00,['0e57b733915941034ba5130c40b077635eecaf2f'],0,3,3,45122,1,1,1,1,200
8d236fcf9703cceb6c7f0678a382c5d36648b85a,0,Nathan Marz,2011-09-28 16:15:29-07:00,['8336885d725e5dac598e86f174baa61aa731d1ed'],1,1,2,45124,1,,,,200
028d76c59fed1d830d5c0b3d304c9ff921994539,0,Nathan Marz,2011-09-28 16:16:00-07:00,['8d236fcf9703cceb6c7f0678a382c5d36648b85a'],1,1,2,45126,1,,,,200
3c4f437f59c3a52b2e48a4e38b2072f05fb58262,0,Nathan Marz,2011-09-28 16:30:20-07:00,['7fa873d10e147e2363c064f0c3ca64893022e51a'],1,1,2,45128,1,,,,200
feaafd4b4ea61a88f8627bc962adcfd7433578d9,0,Nathan Marz,2011-09-28 23:47:35-07:00,['028d76c59fed1d830d5c0b3d304c9ff921994539'],4,7,11,45139,1,,,,200
6a3f94e142fae9245093fc27cd5e704e3dc68f61,0,Nathan Marz,2011-09-29 01:55:26-07:00,['feaafd4b4ea61a88f8627bc962adcfd7433578d9'],0,4,4,45143,1,,,,200
14680ff56a8894ef2dd7380c2ed0aee364aadc98,0,Nathan Marz,2011-09-29 17:01:06-07:00,['6a3f94e142fae9245093fc27cd5e704e3dc68f61'],0,7,7,45150,1,,,,200
476e9101d52a1f38531cb71a7565c7db1472b234,0,Nathan Marz,2011-09-29 17:01:37-07:00,['14680ff56a8894ef2dd7380c2ed0aee364aadc98'],1,1,2,45152,1,,,,200
4aa082dbefd01d72aa745a9b6593bad2bc6352d6,0,Nathan Marz,2011-09-29 18:42:35-07:00,['3c4f437f59c3a52b2e48a4e38b2072f05fb58262'],4,18,22,45174,1,,,,200
ef3020a425fcb3e4fb85dcf107b9d4c0ba7a14b2,0,Nathan Marz,2011-09-29 18:43:02-07:00,['4aa082dbefd01d72aa745a9b6593bad2bc6352d6'],0,369,369,45543,4,0.517241379,0.709359606,0.837438424,204
9d267e8da0b9ab81aecc39903517beeaaaf2ea53,1,Nathan Marz,2011-09-30 13:50:45-07:00,['ef3020a425fcb3e4fb85dcf107b9d4c0ba7a14b2'],2,2,4,45547,1,,,,204
a95b418fc34fe6d7e4ca54f81123eb66e2aa1fda,0,Nathan Marz,2011-10-01 21:38:01-07:00,['476e9101d52a1f38531cb71a7565c7db1472b234'],0,2,2,45549,1,,,,204
57ddaae5fd72ff2cef6d179568640b1fac8f4f08,0,Nathan Marz,2011-10-01 21:38:25-07:00,['a95b418fc34fe6d7e4ca54f81123eb66e2aa1fda'],2,2,4,45553,1,,,,204
26125afa8590d883d321ce4911013f4fa5a7d6f3,0,Nathan Marz,2011-10-01 21:38:41-07:00,['57ddaae5fd72ff2cef6d179568640b1fac8f4f08'],6,9,15,45568,1,,,,204
084bbbbe7f2aea90f2dec536d54aa60ee448cd60,0,Nathan Marz,2011-10-01 21:39:03-07:00,['26125afa8590d883d321ce4911013f4fa5a7d6f3'],1,5,6,45574,1,1,1,1,204
5aa6e3d9bfbebfb80676b9cd4db819aac17f8201,1,Nathan Marz,2011-10-02 23:15:44-07:00,['084bbbbe7f2aea90f2dec536d54aa60ee448cd60'],1,16,17,45591,1,,,,204
d353e6be58ac830e7cd20a10c05d84d2651cce2a,0,Nathan Marz,2011-10-04 03:38:02-07:00,['9d267e8da0b9ab81aecc39903517beeaaaf2ea53'],3,4,7,45598,2,,,,204
6fd04ab71949e39d6914cd49c94205e655fbf190,0,Nathan Marz,2011-10-04 12:20:00-07:00,['5aa6e3d9bfbebfb80676b9cd4db819aac17f8201'],0,53,53,45651,2,1,1,1,204
ccbf578c730da0b1e745387a65c3df8b0a2f8f2a,0,Nathan Marz,2011-10-04 16:42:44-07:00,['6fd04ab71949e39d6914cd49c94205e655fbf190'],1,8,9,45660,3,,,,204
0699624e1dc9b736220f135112448e4474c00446,0,Nathan Marz,2011-10-04 22:49:29-07:00,['ccbf578c730da0b1e745387a65c3df8b0a2f8f2a'],2,4,6,45666,1,,,,204
fa9e007c8259f4abe946768395ef534e73a37fac,0,Nathan Marz,2011-10-05 00:00:25-07:00,['0699624e1dc9b736220f135112448e4474c00446'],2,4,6,45672,1,,,,204
31f06a9aa07c8f086d2c3aa70fa8f2a5d56cc333,0,Tom Payne,2011-10-10 17:42:28+02:00,['fa9e007c8259f4abe946768395ef534e73a37fac'],0,5,5,45677,1,1,1,1,204
2e410513e75ec9b584c50a92bec5f24b057b3836,0,Nathan Marz,2011-10-11 00:26:20-07:00,['fa9e007c8259f4abe946768395ef534e73a37fac'],0,1,1,45678,1,,,,204
3226a1ce4641c256134de995d673596e8aa4c603,1,Nathan Marz,2011-10-11 00:26:34-07:00,['2e410513e75ec9b584c50a92bec5f24b057b3836'],4,22,26,45704,1,,,,204
26409830d4c0a59b7236269b041bbed6a81f7960,0,Nathan Marz,2011-10-11 00:32:53-07:00,"['3226a1ce4641c256134de995d673596e8aa4c603', '31f06a9aa07c8f086d2c3aa70fa8f2a5d56cc333']",0,5,5,45709,1,,,,204
98072862b9c04eb27a2c445254d62f4beb5ed380,0,Nathan Marz,2011-10-12 15:30:50-07:00,['3226a1ce4641c256134de995d673596e8aa4c603'],1,6,7,45716,1,1,1,1,204
18dd7423be41313c7476b8981a650dab9b3429a6,0,Nathan Marz,2011-10-12 15:31:17-07:00,"['98072862b9c04eb27a2c445254d62f4beb5ed380', '26409830d4c0a59b7236269b041bbed6a81f7960']",0,5,5,45721,1,,,,204
f597bb120ff8fafc5d5df48e92fb01cb0eea0aa3,0,Nathan Marz,2011-10-18 02:05:29-07:00,['18dd7423be41313c7476b8981a650dab9b3429a6'],39,124,163,45884,22,1,1,1,204
fe268549697a59e6a616bb1434f4abf2bcb826ac,1,Nathan Marz,2011-10-18 15:48:32-07:00,['18dd7423be41313c7476b8981a650dab9b3429a6'],0,1,1,45885,1,,,,204
fbe24e6cc19ccf9bfd3e7345305017826ad3122e,1,Nathan Marz,2011-10-18 15:48:43-07:00,['fe268549697a59e6a616bb1434f4abf2bcb826ac'],2,4,6,45891,1,,,,204
c89270bb7d92c04bb38b987f14933281bb39f706,1,Nathan Marz,2011-10-18 19:35:54-07:00,['fbe24e6cc19ccf9bfd3e7345305017826ad3122e'],4640,4308,8948,54839,38,1,0,1,204
4eb942239e4a2495de6b55e84a28321fc3652908,0,Nathan Marz,2011-10-18 22:06:49-07:00,['c89270bb7d92c04bb38b987f14933281bb39f706'],12,13,25,54864,2,,,,204
8615889b4f5d3e701f731dc860847ae21dffca9b,0,Nathan Marz,2011-10-19 00:23:39-07:00,['4eb942239e4a2495de6b55e84a28321fc3652908'],1805,1805,3610,58474,35,,,,204
44825be9bde250a1b84679ea7bab4727a9ed9e9d,0,Nathan Marz,2011-10-19 19:09:16-07:00,['8615889b4f5d3e701f731dc860847ae21dffca9b'],79,1487,1566,60040,15,0.693461951,0.80278671,0.957127546,205
b419a6b2a3163da87f339b379c084eb26162d83f,0,Nathan Marz,2011-10-19 19:26:35-07:00,['44825be9bde250a1b84679ea7bab4727a9ed9e9d'],8,241,249,60289,6,0,0,0.967741935,205
02cfd6b1e6798c51c5ddd4bf8c925374a61a7dd7,0,Nathan Marz,2011-10-19 20:52:16-07:00,['b419a6b2a3163da87f339b379c084eb26162d83f'],1,1,2,60291,1,,,,205
c50f960974a3d78b137f79c634d544872a8b4ea5,1,Nathan Marz,2011-10-19 21:14:32-07:00,['02cfd6b1e6798c51c5ddd4bf8c925374a61a7dd7'],4,4,8,60299,2,,,,205
bc9a360701e47d2d123b139eaa4c4b50329c0148,0,Nathan Marz,2011-10-19 21:31:39-07:00,['c50f960974a3d78b137f79c634d544872a8b4ea5'],9,19,28,60327,1,0,0,1,205
eb3601f70af7f4e27ba9c97bbd1693777c2468c4,0,Nathan Marz,2011-10-19 22:47:37-07:00,['bc9a360701e47d2d123b139eaa4c4b50329c0148'],7,29,36,60363,4,,,,205
51e784c93228a1b01728c994a5c74f717adb0848,1,Nathan Marz,2011-10-20 00:02:07-07:00,['eb3601f70af7f4e27ba9c97bbd1693777c2468c4'],11,137,148,60511,8,0.913043478,0.913043478,1,209
a17ae044738eb82ec8a93331156fe539dc6ad929,0,Nathan Marz,2011-10-20 01:19:16-07:00,['d353e6be58ac830e7cd20a10c05d84d2651cce2a'],16,29,45,60556,2,0,1,1,209
a1ac4b45a25de4cb3832940df36b268ce5f2ccb1,0,Bertrand Dechoux,2011-10-20 12:40:10+03:00,['a17ae044738eb82ec8a93331156fe539dc6ad929'],2,2,4,60560,1,,,,209
fd70341f62851e1ce5e56e30887c02d835cf2424,0,Nathan Marz,2011-10-20 21:32:00-07:00,['51e784c93228a1b01728c994a5c74f717adb0848'],0,65,65,60625,1,1,1,1,210
0cd570749ce314c3af21c4d90746a9615c82f54c,0,Nathan Marz,2011-10-20 21:32:12-07:00,['fd70341f62851e1ce5e56e30887c02d835cf2424'],11,6,17,60642,1,0,0,0,210
7ffb9cc0642bb673ac6acdf5214ea02e429705d3,0,Nathan Marz,2011-10-20 22:18:33-07:00,['0cd570749ce314c3af21c4d90746a9615c82f54c'],19,71,90,60732,5,0.2,1,0.2,212
92174d8fef1b37e636c45fd0fc3f3b3b137a1637,1,Nathan Marz,2011-10-21 20:49:46-07:00,['7ffb9cc0642bb673ac6acdf5214ea02e429705d3'],131,2958,3089,63821,21,0.698362388,0.795562599,0.970945589,217
acc414cfcbb2dcb53af07bf622813e862083e1aa,0,Nathan Marz,2011-10-21 21:29:14-07:00,['92174d8fef1b37e636c45fd0fc3f3b3b137a1637'],0,37,37,63858,1,,,,218
576577b3daf5c3b5954fb6d5a2f2cb3323b8c489,0,Nathan Marz,2011-10-21 21:29:37-07:00,['acc414cfcbb2dcb53af07bf622813e862083e1aa'],8,12,20,63878,4,1,0,1,218
c3fbb15f25022a29bb4e3e2297c358c398cb1b9e,0,Nathan Marz,2011-10-22 00:28:38-07:00,['576577b3daf5c3b5954fb6d5a2f2cb3323b8c489'],4,5,9,63887,2,,,,218
85663513f5cea9d25b8dcd5672053ad1aa359f40,0,Nathan Marz,2011-10-22 00:38:17-07:00,['c3fbb15f25022a29bb4e3e2297c358c398cb1b9e'],5,5,10,63897,2,,,,218
a2a004abe1af96c056788fef80ec996f7bed457c,0,Nathan Marz,2011-10-22 01:05:25-07:00,['85663513f5cea9d25b8dcd5672053ad1aa359f40'],15,41,56,63953,1,1,1,1,218
f39c0bd185fe70af580f5cab45c7267bf5636ffc,0,Nathan Marz,2011-10-22 01:05:39-07:00,['a2a004abe1af96c056788fef80ec996f7bed457c'],8,19,27,63980,1,0.428571429,1,1,218
4ba4e024a6f51b6b2d642de3b71cf29c78bb38f5,0,Nathan Marz,2011-10-22 01:50:57-07:00,['f39c0bd185fe70af580f5cab45c7267bf5636ffc'],1,9,10,63990,5,,,,218
6b38a1221f926bfab09fe78992f5784081dd1891,0,Nathan Marz,2011-10-22 02:38:30-07:00,['4ba4e024a6f51b6b2d642de3b71cf29c78bb38f5'],10,0,10,64000,5,,,,218
14ae3239d22ec1c1fed122e9f903d46d90129c38,0,Nathan Marz,2011-10-22 14:40:37-07:00,['6b38a1221f926bfab09fe78992f5784081dd1891'],1,4,5,64005,1,,,,218
b4e87a60cb4e6f795faff3eda8da5140f4e8cdad,0,Nathan Marz,2011-10-23 03:06:22-07:00,['14ae3239d22ec1c1fed122e9f903d46d90129c38'],19,617,636,64641,17,0.727272727,0.799242424,0.988636364,224
3b21a8be2c51e5cf4e9616fbedafa278350c5840,0,Nathan Marz,2011-10-23 15:25:53-07:00,['b4e87a60cb4e6f795faff3eda8da5140f4e8cdad'],41,1,42,64683,4,0,0,0,224
a84259de45b123c83ff0e8e0c4b047d3af6e96e5,0,Nathan Marz,2011-10-23 15:26:18-07:00,['3b21a8be2c51e5cf4e9616fbedafa278350c5840'],1,1,2,64685,1,,,,224
50e078cf42b2a437c2fa9e4432f8653e0e75ef5f,0,Nathan Marz,2011-10-23 15:26:40-07:00,['a84259de45b123c83ff0e8e0c4b047d3af6e96e5'],1,1,2,64687,1,,,,224
c2919ad2e485f85f85b57eeebb20b50593a5175f,0,Nathan Marz,2011-10-23 15:29:55-07:00,['a17ae044738eb82ec8a93331156fe539dc6ad929'],3,308,311,64998,6,0.710526316,1,0.960526316,226
b4d90cbc054b4701648555d141ea5f9692f5261a,1,Nathan Marz,2011-10-23 15:32:52-07:00,['c2919ad2e485f85f85b57eeebb20b50593a5175f'],2,4,6,65004,1,0,1,1,226
085dd8fa3f1a0a1df790d7f79a7da1e427e6b927,0,Nathan Marz,2011-10-23 15:36:04-07:00,"['b4d90cbc054b4701648555d141ea5f9692f5261a', 'a1ac4b45a25de4cb3832940df36b268ce5f2ccb1']",2,2,4,65008,1,,,,226
6b57766422be5eae1395e589780748351dd37991,1,Nathan Marz,2011-10-23 15:47:19-07:00,['085dd8fa3f1a0a1df790d7f79a7da1e427e6b927'],7,38,45,65053,3,1,1,1,227
6907554e982baada2dcd5320e7c789327bb80ffb,0,Nathan Marz,2011-10-23 21:05:37-07:00,['50e078cf42b2a437c2fa9e4432f8653e0e75ef5f'],33,0,33,65086,1,,,,227
db63ff1f83e294483ab882d474a76455003a091a,0,Nathan Marz,2011-10-25 01:09:04-07:00,['6907554e982baada2dcd5320e7c789327bb80ffb'],2,2,4,65090,1,,,,227
0d362498b148a455e3a342f75d7fe4df5d5cbea3,0,Nathan Marz,2011-10-25 19:19:47-07:00,['db63ff1f83e294483ab882d474a76455003a091a'],0,1,1,65091,1,,,,227
7dcbe76b626c56f04fc3c9533461b094ce2b318d,0,Nathan Marz,2011-10-29 23:16:04-07:00,['0d362498b148a455e3a342f75d7fe4df5d5cbea3'],1,1,2,65093,1,,,,227
604cf3cb44f3296c14ecd23ab04dee2827f095f5,0,Nathan Marz,2011-10-29 23:18:10-07:00,['7dcbe76b626c56f04fc3c9533461b094ce2b318d'],1,2,3,65096,1,,,,227
1891618e21b01da8de5d43e6b95beab86a3444ac,0,Taylor Goetz,2011-11-02 15:06:41-04:00,['6b57766422be5eae1395e589780748351dd37991'],0,116,116,65212,1,,,,228
91550313b5288e9c059165e6ce8bad180fb764cb,0,ptgoetz,2011-11-02 17:16:04-04:00,['1891618e21b01da8de5d43e6b95beab86a3444ac'],0,31,31,65243,1,,,,228
4edef6a0dcbe136820974aabda649132175a7dd5,0,Nathan Marz,2011-11-03 16:59:32-07:00,['6b57766422be5eae1395e589780748351dd37991'],2,2,4,65247,2,,,,228
95a9a96d89e97cc6e5fec12a80d9ea464d3e086d,0,Nathan Marz,2011-11-06 00:04:29-07:00,['604cf3cb44f3296c14ecd23ab04dee2827f095f5'],2,9,11,65258,1,,,,228
54237454d972a7ac6f2e6244357c4f079fb69978,0,Nathan Marz,2011-11-06 18:23:29-08:00,['95a9a96d89e97cc6e5fec12a80d9ea464d3e086d'],11,16,27,65285,5,,,,228
96a62fd098fd5dbcaf4196e1241015cfae6ed6c5,0,Nathan Marz,2011-11-06 18:23:52-08:00,['54237454d972a7ac6f2e6244357c4f079fb69978'],0,16,16,65301,2,1,1,1,228
65bfaf3d045b3289fd3e08de6b85426f3c369c99,0,Nathan Marz,2011-11-06 21:00:16-08:00,['4edef6a0dcbe136820974aabda649132175a7dd5'],0,149,149,65450,2,0.147727273,0.465909091,0.715909091,230
82b347c3168d2cc0123a43f9690a425f605f966d,0,Nathan Marz,2011-11-06 21:00:23-08:00,['65bfaf3d045b3289fd3e08de6b85426f3c369c99'],0,1,1,65451,1,,,,230
2a3ef25e72514b47e6f7f5321846352f2d2e08a7,0,Nathan Marz,2011-11-06 22:32:33-08:00,"['82b347c3168d2cc0123a43f9690a425f605f966d', '91550313b5288e9c059165e6ce8bad180fb764cb']",0,147,147,65598,1,,,,230
e7adbdb587e04ce71542473062dbcad9d888e8ed,0,Nathan Marz,2011-11-06 22:46:11-08:00,['2a3ef25e72514b47e6f7f5321846352f2d2e08a7'],1,22,23,65621,2,,,,231
1f5cb7fe76ac3a56e9b0f6f6f5b2df0025003303,0,Nathan Marz,2011-11-06 22:46:49-08:00,['e7adbdb587e04ce71542473062dbcad9d888e8ed'],1,2,3,65624,1,,,,231
de9955f5f31ff6a9cd17444075a26f5565b65368,0,Nathan Marz,2011-11-06 22:47:19-08:00,['1f5cb7fe76ac3a56e9b0f6f6f5b2df0025003303'],1,3,4,65628,1,,,,231
3b815c3aa5d8b3500c9c0ff84ee41e9f6b748c56,0,Nathan Marz,2011-11-06 22:47:35-08:00,['de9955f5f31ff6a9cd17444075a26f5565b65368'],1,1,2,65630,1,,,,231
b29176a08398abeb2dbda762c173f708a1abbb5e,0,Nathan Marz,2011-11-07 02:21:18-08:00,['96a62fd098fd5dbcaf4196e1241015cfae6ed6c5'],0,1,1,65631,1,,,,231
b8bb84c5e4c01f73ca7a013f26d7e6ab5ce8f86b,0,Nathan Marz,2011-11-08 18:16:38-08:00,['b29176a08398abeb2dbda762c173f708a1abbb5e'],2,21,23,65654,1,0,1,1,231
bd2b88e4c0926a7afebc8c2e14ef52b09816f742,0,Nathan Marz,2011-11-08 18:32:20-08:00,['b8bb84c5e4c01f73ca7a013f26d7e6ab5ce8f86b'],1,37,38,65692,1,,,,231
40c2fad427fe7985836f072277f01f18e5efe70e,0,P. Taylor Goetz,2011-11-11 00:09:57-05:00,[],0,782,782,66474,11,0.76,0.88,0.77,242
14bbb5a61ae624b9f9bf3c13affb544c7c5b9731,0,P. Taylor Goetz,2011-11-11 00:45:20-05:00,['40c2fad427fe7985836f072277f01f18e5efe70e'],0,70,70,66544,2,0,1,1,243
c723b0db060a4244a0156c2d913410ee21b36ff1,1,P. Taylor Goetz,2011-11-12 22:04:06-05:00,['14bbb5a61ae624b9f9bf3c13affb544c7c5b9731'],128,658,786,67330,13,0.188405797,1,0.782608696,247
daff11de9d31cdcd2134b650b3c0cfcaef0e74f5,0,P. Taylor Goetz,2011-11-12 23:16:20-05:00,['c723b0db060a4244a0156c2d913410ee21b36ff1'],4,51,55,67385,2,,,,248
35acf9b34edd55a4b26b5f3c836402af8b8836f2,0,P. Taylor Goetz,2011-11-14 15:09:23-05:00,['daff11de9d31cdcd2134b650b3c0cfcaef0e74f5'],1,1,2,67387,1,,,,248
faa41dc7daa5a8cade726baa74f0c0d3eebab334,0,Nathan Marz,2011-11-15 00:16:45-08:00,['bd2b88e4c0926a7afebc8c2e14ef52b09816f742'],34,95,129,67516,5,0.095238095,0,0.952380952,248
5c8b9d8d407f9ebc57331dfe5ab40455c2fbfeec,0,Nathan Marz,2011-11-15 00:18:11-08:00,['faa41dc7daa5a8cade726baa74f0c0d3eebab334'],7,45,52,67568,3,,,,248
e9d0fc0411b1becfea6be2946732c3316b4e2852,0,Nathan Marz,2011-11-15 00:25:10-08:00,['5c8b9d8d407f9ebc57331dfe5ab40455c2fbfeec'],0,1,1,67569,1,,,,248
a3a9981103bff9af25394b6d7c06c911f1db13fc,0,Nathan Marz,2011-11-15 14:19:30-08:00,['e9d0fc0411b1becfea6be2946732c3316b4e2852'],3,8,11,67580,2,,,,248
9567ec499f8fb691ae86498df01e182f1dc39b06,0,Nathan Marz,2011-11-15 17:06:42-08:00,['a3a9981103bff9af25394b6d7c06c911f1db13fc'],505,1915,2420,70000,20,0.484756098,0.547764228,0.987804878,251
81aba48216d226057e975849cb13ddc9dbdc2b99,0,Nathan Marz,2011-11-15 18:00:15-08:00,['9567ec499f8fb691ae86498df01e182f1dc39b06'],3,86,89,70089,7,1,1,0.833333333,253
f5e44326a81a3ce3da633020e228301902f533ce,0,Nathan Marz,2011-11-15 18:05:12-08:00,['81aba48216d226057e975849cb13ddc9dbdc2b99'],2,73,75,70164,5,0,0.267857143,0.982142857,253
9516401e8c2c85c51b97d41b1d8fb27b521e6125,0,P. Taylor Goetz,2011-11-15 22:36:36-05:00,['35acf9b34edd55a4b26b5f3c836402af8b8836f2'],14,14,28,70192,5,,,,253
2a31acbc458c04493c20b35f5963e3a7d82eb706,0,Nathan Marz,2011-11-15 23:31:28-08:00,['f5e44326a81a3ce3da633020e228301902f533ce'],3,5,8,70200,1,,,,253
5b9820a34e3de328249e47f9a316bb0f0610b878,0,Nathan Marz,2011-11-17 23:21:51-08:00,['2a31acbc458c04493c20b35f5963e3a7d82eb706'],1,1,2,70202,1,,,,253
52f051daabf616ec22ff808f47fd43bde3e2fcdb,0,Patrick Houk,2011-11-18 22:23:57-05:00,['5b9820a34e3de328249e47f9a316bb0f0610b878'],1,12,13,70215,2,,,,253
3539864fa4fc622e10fdba4e28d99e1cc7d73949,0,Nathan Marz,2011-11-19 01:36:49-08:00,['5b9820a34e3de328249e47f9a316bb0f0610b878'],673,397,1070,71285,25,0.882653061,0.270408163,0.066326531,260
c91da283d12ac3958ea06c491cb22f341ac70956,0,Nathan Marz,2011-11-19 02:00:50-08:00,['3539864fa4fc622e10fdba4e28d99e1cc7d73949'],77,90,167,71452,6,1,1,1,260
8a010865622b04878eced531e03deb92f9e052f0,0,Nathan Marz,2011-11-19 02:01:10-08:00,['c91da283d12ac3958ea06c491cb22f341ac70956'],0,47,47,71499,2,1,1,1,262
461fa22f1b5062f77e89d4cb71e8a08240b5c0b0,0,P. Taylor Goetz,2011-11-19 17:27:53-05:00,['9516401e8c2c85c51b97d41b1d8fb27b521e6125'],1,39,40,71539,2,0,1,1,262
bc104ce6519b57cb903de14fe07f3346bb2d85cd,0,Nathan Marz,2011-11-20 15:35:18-08:00,['8a010865622b04878eced531e03deb92f9e052f0'],4,3,7,71546,3,,,,262
fb38262817ac407da160ce992f1284ac6a5fcf9e,0,Nathan Marz,2011-11-20 17:18:52-08:00,['bc104ce6519b57cb903de14fe07f3346bb2d85cd'],347,357,704,72250,8,0,0,1,262
7ef70ea21567e16dbf454dfd6a9faf30e9eb1dee,0,Nathan Marz,2011-11-21 11:24:26-08:00,['fb38262817ac407da160ce992f1284ac6a5fcf9e'],206,298,504,72754,35,0.983333333,0.983333333,1,262
e1b6c245b28b8b987ec1b92f75b5b448cf3cdb65,0,Nathan Marz,2011-11-21 20:54:58-05:00,['7ef70ea21567e16dbf454dfd6a9faf30e9eb1dee'],6,5,11,72765,1,,,,262
8c63426af2f277ffece05e3fd45cf90131d39a80,0,Nathan Marz,2011-11-21 21:01:29-05:00,"['bc104ce6519b57cb903de14fe07f3346bb2d85cd', '52f051daabf616ec22ff808f47fd43bde3e2fcdb']",1,12,13,72778,2,,,,262
b7ca3f42ace347ccdd56d63c9d2c4243615b964b,0,Nathan Marz,2011-11-21 21:26:12-05:00,['8c63426af2f277ffece05e3fd45cf90131d39a80'],0,1,1,72779,1,,,,262
e9e3ec259d463484fa9aec237ce253b2ac0afa06,0,Nathan Marz,2011-11-22 02:46:40-05:00,['e1b6c245b28b8b987ec1b92f75b5b448cf3cdb65'],153,156,309,73088,8,1,0,1,263
cef7c2b7a00110621cc833f0eccfd6692ec828b4,0,Nathan Marz,2011-11-22 03:37:10-05:00,['e9e3ec259d463484fa9aec237ce253b2ac0afa06'],8,9,17,73105,6,,,,263
8919cdfe6238239a31a81df77f0eb76d14df329a,0,Nathan Marz,2011-11-22 03:45:03-05:00,['cef7c2b7a00110621cc833f0eccfd6692ec828b4'],9,30,39,73144,2,,,,263
fefef8f022910fa480931bf2930b154601de8eee,0,Nathan Marz,2011-11-22 03:56:02-05:00,['8919cdfe6238239a31a81df77f0eb76d14df329a'],9,21,30,73174,3,,,,263
f59256607e8b237cbdd4dc8706aff18ee2811a80,0,Nathan Marz,2011-11-22 13:48:31-05:00,['fefef8f022910fa480931bf2930b154601de8eee'],35,13,48,73222,3,,,,263
c73dc014cf958abd13f48df5fc3425b4d13a99c7,0,Nathan Marz,2011-11-25 02:46:28-05:00,['f59256607e8b237cbdd4dc8706aff18ee2811a80'],48,50,98,73320,5,,,,263
f205124364a345ef673eaa1331573c853b837cd6,0,Nathan Marz,2011-11-25 04:03:33-05:00,['c73dc014cf958abd13f48df5fc3425b4d13a99c7'],11,56,67,73387,4,,,,264
734082d169e1757b47835e1c00fa4e0a9a32c20c,0,Nathan Marz,2011-11-25 15:56:06-05:00,['f205124364a345ef673eaa1331573c853b837cd6'],10,10,20,73407,5,,,,264
3760971bf7b040caf387c3434d15a39c396544a1,0,Nathan Marz,2011-11-25 15:58:15-05:00,['734082d169e1757b47835e1c00fa4e0a9a32c20c'],2,6,8,73415,1,,,,264
862e1c7a37198d554c238fe4ba8ae916d0c6d6ee,0,Nathan Marz,2011-11-30 13:09:01-08:00,['3760971bf7b040caf387c3434d15a39c396544a1'],264,200,464,73879,14,0,0,0.519230769,265
d6ff4555ed22706486cd8c66a54a32a957dab327,0,Nathan Marz,2011-11-30 13:09:14-08:00,"['b7ca3f42ace347ccdd56d63c9d2c4243615b964b', '862e1c7a37198d554c238fe4ba8ae916d0c6d6ee']",1013,1116,2129,76008,59,,,,265
1c027657e256ecefb1430850cd6f9b8ba8cd91dc,0,Nathan Marz,2011-11-30 14:40:59-08:00,['d6ff4555ed22706486cd8c66a54a32a957dab327'],1,13,14,76022,3,0,0,1,265
9fbc42b7cb9244ef9ca2ef95421853fa605c98ad,0,Nathan Marz,2011-11-30 15:10:21-08:00,['1c027657e256ecefb1430850cd6f9b8ba8cd91dc'],1,1,2,76024,1,,,,265
436a8acf450710e4710601eb335f95a9d8f26737,0,Nathan Marz,2011-11-30 19:04:17-08:00,['9fbc42b7cb9244ef9ca2ef95421853fa605c98ad'],2,9,11,76035,2,0,0,1,265
b368e63e3c04e861c2cd6e26b3fc6c001e287cc8,0,Nathan Marz,2011-11-30 21:07:48-08:00,['436a8acf450710e4710601eb335f95a9d8f26737'],2,14,16,76051,1,0.333333333,0,0.333333333,265
e31f0452e1e3b091a69c6c3a88cd7bf04ef4c189,1,Nathan Marz,2011-11-30 21:18:47-08:00,['3b815c3aa5d8b3500c9c0ff84ee41e9f6b748c56'],45,51,96,76147,9,1,1,1,265
b0805c8504f4a1ff31ab5c7a919d1c8ff26cec81,0,Nathan Marz,2011-11-30 21:21:19-08:00,['e31f0452e1e3b091a69c6c3a88cd7bf04ef4c189'],1,0,1,76148,1,1,0,0,265
1056ecd29aa6f0af42d820f56236eb9d4f3831d3,0,Nathan Marz,2011-11-30 21:30:08-08:00,['b368e63e3c04e861c2cd6e26b3fc6c001e287cc8'],0,1,1,76149,1,0,0,1,265
a352eddf1b6d7d14fcb8da6ed3d6339a8a2d87cc,0,Nathan Marz,2011-11-30 22:39:14-08:00,['1056ecd29aa6f0af42d820f56236eb9d4f3831d3'],1,1,2,76151,1,,,,265
fe46b556d1556f0605edecff1278f857fc800ed1,0,Nathan Marz,2011-11-30 22:41:29-08:00,['a352eddf1b6d7d14fcb8da6ed3d6339a8a2d87cc'],1,1,2,76153,1,,,,265
e8d1b21606ebca983c4d5c3be25959504b34412e,0,P. Taylor Goetz,2011-12-01 09:53:53-05:00,['461fa22f1b5062f77e89d4cb71e8a08240b5c0b0'],10,21,31,76184,3,,,,265
6cd9c96b21e380f3fc976b7435746b7c66edd3cd,0,Nathan Marz,2011-12-01 15:13:12-08:00,['fe46b556d1556f0605edecff1278f857fc800ed1'],1,1,2,76186,1,,,,265
98915c3fe9fd71f8009831d65c3e539503b8a978,0,Nathan Marz,2011-12-01 17:09:27-08:00,['b0805c8504f4a1ff31ab5c7a919d1c8ff26cec81'],8,4,12,76198,3,1,1,0,265
b6eac26ff1016fc22721c30f2188d598342ef6b4,1,Nathan Marz,2011-12-01 19:43:05-08:00,['6cd9c96b21e380f3fc976b7435746b7c66edd3cd'],13,1811,1824,78022,10,0.763819095,0.894472362,0.971524288,267
4186391cf91cb4ecc492eea50c8e3cc1cc37c828,0,Nathan Marz,2011-12-01 19:51:55-08:00,['98915c3fe9fd71f8009831d65c3e539503b8a978'],41,2,43,78065,2,,,,267
aef936013a4f4487be710f10880db9dda5dd80e3,0,Nathan Marz,2011-12-01 22:47:08-08:00,['b6eac26ff1016fc22721c30f2188d598342ef6b4'],0,2,2,78067,1,,,,267
b8dae14aab61b1207dbe91d029ce6db68d77489d,1,Nathan Marz,2011-12-02 11:12:13-08:00,['aef936013a4f4487be710f10880db9dda5dd80e3'],174,222,396,78463,1,,,,267
8d7ebbf63dd43d622f2cfc48fab8605e63181dcf,0,Nathan Marz,2011-12-02 11:27:16-08:00,['b8dae14aab61b1207dbe91d029ce6db68d77489d'],11,0,11,78474,2,0,0,0,267
b08d3d067996ba3eafb3cb039213765e3e5b13f6,0,Nathan Marz,2011-12-02 11:33:38-08:00,['8d7ebbf63dd43d622f2cfc48fab8605e63181dcf'],3,5,8,78482,2,0,0,1,267
6ee6d088593b203d679459568ffb96d82c1976a2,0,Nathan Marz,2011-12-02 15:36:40-08:00,['b08d3d067996ba3eafb3cb039213765e3e5b13f6'],1,3,4,78486,1,,,,267
deffe3f7d51cd3e061fb97b2f0f0c67229b4f0cb,0,Nathan Marz,2011-12-03 12:59:59-08:00,['6ee6d088593b203d679459568ffb96d82c1976a2'],3,3,6,78492,1,,,,267
f28af3054536d2a1d421137dacd6172561940157,0,Nathan Marz,2011-12-03 17:33:15-08:00,['deffe3f7d51cd3e061fb97b2f0f0c67229b4f0cb'],0,3,3,78495,1,0,1,1,267
b5c1960662993d7f18b2be076291af0426b5e710,0,Nathan Marz,2011-12-05 23:47:08-05:00,['f28af3054536d2a1d421137dacd6172561940157'],2,4,6,78501,1,0,0,1,267
ff6eac6af086741d2e38e41e82a6e6bcc836bde7,0,Nathan Marz,2011-12-05 23:47:32-05:00,['b5c1960662993d7f18b2be076291af0426b5e710'],2,6,8,78509,1,,,,267
041d9c697a4ce403e72b67806dd759c6404895fa,0,Nathan Marz,2011-12-05 23:47:52-05:00,['ff6eac6af086741d2e38e41e82a6e6bcc836bde7'],0,1,1,78510,1,,,,267
20284190a0e5459e105e3d4a93ef111a607f25fd,0,Nathan Marz,2011-12-06 11:58:24-05:00,['041d9c697a4ce403e72b67806dd759c6404895fa'],0,2,2,78512,1,0,0,1,267
92248231f5e8f31f27c77e6baa1e968686e627e3,0,Nathan Marz,2011-12-06 16:18:33-05:00,['20284190a0e5459e105e3d4a93ef111a607f25fd'],4,4,8,78520,2,,,,267
57d11797395ac2e00731f425af2fa6f19b3f6950,1,Nathan Marz,2011-12-06 16:37:30-05:00,['92248231f5e8f31f27c77e6baa1e968686e627e3'],1,13,14,78534,2,1,1,1,267
b39a7105d02beba61bf4ae7e859e886a08c05043,0,Nathan Marz,2011-12-06 16:44:18-05:00,['57d11797395ac2e00731f425af2fa6f19b3f6950'],2,3,5,78539,2,,,,267
573dd6af4d261b1e673175f96553fbb8143c726f,0,Nathan Marz,2011-12-06 17:46:28-05:00,['b39a7105d02beba61bf4ae7e859e886a08c05043'],3,6,9,78548,2,,,,267
cd9d0a18eb0859c2308f2a7592e684023d0d6314,0,Nathan Marz,2011-12-06 21:42:04-05:00,['573dd6af4d261b1e673175f96553fbb8143c726f'],8,5,13,78561,1,0,0,0,267
bf75498b4cbfbea337a57564e4f20e39a9d4fe15,0,Nathan Marz,2011-12-06 21:48:39-05:00,['cd9d0a18eb0859c2308f2a7592e684023d0d6314'],0,1,1,78562,1,,,,267
1f39064656c93660b97db349a1ba8744eecdaeeb,0,Nathan Marz,2011-12-07 23:42:51-08:00,['bf75498b4cbfbea337a57564e4f20e39a9d4fe15'],1,11,12,78574,3,,,,267
720901fa1ed63e1985aec7fef6e5239b46d7964d,0,Nathan Marz,2011-12-08 01:05:59-08:00,['1f39064656c93660b97db349a1ba8744eecdaeeb'],1,45,46,78620,2,1,1,1,268
5c3bf86014f05cc29825b3261e2fb9c6e774cfc6,0,Nathan Marz,2011-12-08 01:08:12-08:00,['720901fa1ed63e1985aec7fef6e5239b46d7964d'],0,1,1,78621,1,,,,268
bcd4d227fee40d73cf4e9b6986270552436e0f44,0,P. Taylor Goetz,2011-12-08 22:27:07-05:00,['e8d1b21606ebca983c4d5c3be25959504b34412e'],3,3,6,78627,1,0,0,0,268
7371926834a75cb1dacde371cd8f3aa0702dcd0a,1,Nathan Marz,2011-12-12 00:51:25-08:00,['5c3bf86014f05cc29825b3261e2fb9c6e774cfc6'],171,279,450,79077,3,,,,268
44b6edec43275800a0c6eaba278d145c8f70d564,1,Nathan Marz,2011-12-12 16:14:01-08:00,['7371926834a75cb1dacde371cd8f3aa0702dcd0a'],89,97,186,79263,4,,,,269
246845b816954f8744872ebd59e701e5f9f48ed1,0,Nathan Marz,2011-12-12 16:35:03-08:00,['44b6edec43275800a0c6eaba278d145c8f70d564'],2,2,4,79267,1,,,,269
52bea4fd4757001b5fb95e3955c1101f8fc61871,0,Nathan Marz,2011-12-12 16:47:37-08:00,['246845b816954f8744872ebd59e701e5f9f48ed1'],2,2,4,79271,1,,,,269
3cf6a95a3242d8d6bd74a6f78015311fa15e3d64,0,Nathan Marz,2011-12-14 15:07:25-08:00,['52bea4fd4757001b5fb95e3955c1101f8fc61871'],3,3,6,79277,1,,,,269
a8a5536c85f332b548483a45745ada6aba37d0c3,0,Nathan Marz,2011-12-14 16:28:29-08:00,['3cf6a95a3242d8d6bd74a6f78015311fa15e3d64'],8,15,23,79300,1,,,,269
03cb9f377062cb38b15ef40270a830e2db103d92,0,Nathan Marz,2011-12-14 22:40:32-08:00,['5c3bf86014f05cc29825b3261e2fb9c6e774cfc6'],0,20,20,79320,1,,,,270
393357b7852db2dc4f674041e98344f7277f137d,0,Nathan Marz,2011-12-14 22:44:46-08:00,['03cb9f377062cb38b15ef40270a830e2db103d92'],0,1,1,79321,1,,,,270
ab5935cf7d0cb9d9b1dea68ecd68bb24b9ce5bbd,0,Nathan Marz,2011-12-14 22:47:01-08:00,"['a8a5536c85f332b548483a45745ada6aba37d0c3', '393357b7852db2dc4f674041e98344f7277f137d']",0,21,21,79342,1,,,,270
934240a0c10845297c1fdbe297626829f37310d9,1,Nathan Marz,2011-12-17 16:09:34-08:00,['ab5935cf7d0cb9d9b1dea68ecd68bb24b9ce5bbd'],25,69,94,79436,6,,,,270
6bbc2780447de724b7030c86c0fab5cb9e0f0237,0,Nathan Marz,2011-12-17 16:20:32-08:00,['934240a0c10845297c1fdbe297626829f37310d9'],5,6,11,79447,1,,,,270
cf7a37b667ed9b3e379a0c917dd02ff42fea31e3,0,Nathan Marz,2011-12-17 16:25:21-08:00,['6bbc2780447de724b7030c86c0fab5cb9e0f0237'],1,0,1,79448,1,,,,270
277d4e636776c183988953af874016b103168cc3,0,Nathan Marz,2011-12-17 16:35:36-08:00,['cf7a37b667ed9b3e379a0c917dd02ff42fea31e3'],2,1374,1376,80824,8,0.691318328,0.80278671,0.957127546,271
861d9ab112c95bf1ed614e4ef6b88c7c00ffd6ca,1,Nathan Marz,2011-12-17 16:39:14-08:00,['277d4e636776c183988953af874016b103168cc3'],1,23,24,80848,2,,,,272
940e136dbff621d40f6155578e07b963fcc0266f,0,Nathan Marz,2011-12-17 16:47:07-08:00,['861d9ab112c95bf1ed614e4ef6b88c7c00ffd6ca'],12,11,23,80871,1,,,,272
cf7c9d1bd32ba8797eab1fef13c206c0d115c2d4,0,Nathan Marz,2011-12-17 17:08:56-08:00,['940e136dbff621d40f6155578e07b963fcc0266f'],13,19,32,80903,1,,,,272
2d0df523c245dac8e60dfd4e91ec8ff467685dac,0,Nathan Marz,2011-12-17 17:47:42-08:00,['cf7c9d1bd32ba8797eab1fef13c206c0d115c2d4'],4,10,14,80917,1,,,,272
943cfa93a14cdc43f6f8bfecf6523e3c415a2b0f,0,Nathan Marz,2011-12-17 23:32:45-08:00,['2d0df523c245dac8e60dfd4e91ec8ff467685dac'],9,16,25,80942,1,,,,272
a384b05fb5c0e64663d51e00e7ab9eba933ad16a,0,Nathan Marz,2011-12-17 23:59:55-08:00,['943cfa93a14cdc43f6f8bfecf6523e3c415a2b0f'],0,43,43,80985,1,,,,272
ccf53404656e0bcea6e9cb38d8a3ab7624a405ff,0,Nathan Marz,2011-12-18 00:23:24-08:00,['a384b05fb5c0e64663d51e00e7ab9eba933ad16a'],3,0,3,80988,1,,,,272
302cc08410c063783d3b95369debbfcec040aa39,0,Nathan Marz,2011-12-18 00:41:42-08:00,['ccf53404656e0bcea6e9cb38d8a3ab7624a405ff'],1,1,2,80990,1,,,,272
b7048938d88d774d2bae575e59d8f4312d44d366,0,Nathan Marz,2011-12-18 00:44:25-08:00,['302cc08410c063783d3b95369debbfcec040aa39'],5,7,12,81002,1,,,,272
8aed7da5af3a2794f3be7e79524615548a02c767,0,Nathan Marz,2011-12-18 01:13:50-08:00,['b7048938d88d774d2bae575e59d8f4312d44d366'],14,14,28,81030,1,,,,272
c2b9a60e95e9d5b8005bfaec01c3e78d7b5bef52,0,Nathan Marz,2011-12-18 03:31:05-08:00,['8aed7da5af3a2794f3be7e79524615548a02c767'],1,7,8,81038,1,,,,272
95d077118806e6e56f761a569cb2c6a5b97f1195,0,Nathan Marz,2011-12-19 15:28:55-08:00,['c2b9a60e95e9d5b8005bfaec01c3e78d7b5bef52'],1,1,2,81040,1,,,,272
340dedca54f91c6766db74ed3908cdd42fe3f187,0,Nathan Marz,2011-12-19 15:41:49-08:00,['95d077118806e6e56f761a569cb2c6a5b97f1195'],13,11,24,81064,1,,,,272
9178687355514ee90962addcadf55610590a857d,0,Nathan Marz,2011-12-19 16:44:37-08:00,['340dedca54f91c6766db74ed3908cdd42fe3f187'],0,695,695,81759,9,0.465934066,0.562637363,0.96043956,277
b930ee470a432897c348198f2df2b1eb386a8523,0,Nathan Marz,2011-12-22 22:53:15-08:00,['9178687355514ee90962addcadf55610590a857d'],845,2018,2863,84622,33,0.354445798,0.287454324,0.96954933,283
54e94a1f33e9291a55f209016432c5e9198e5917,0,Nathan Marz,2011-12-22 23:06:52-08:00,['b930ee470a432897c348198f2df2b1eb386a8523'],13,27,40,84662,1,,,,283
f4ebac23792e1561c2e5acebb4a86345a6ae0f3f,0,Nathan Marz,2011-12-22 23:42:47-08:00,['54e94a1f33e9291a55f209016432c5e9198e5917'],7,23,30,84692,4,,,,283
72c476c1d4e114f85b29cc794936c3f003369a71,0,Nathan Marz,2011-12-22 23:54:25-08:00,['f4ebac23792e1561c2e5acebb4a86345a6ae0f3f'],5,20,25,84717,1,,,,283
4299517dfeada14ae566ac25125e3b2fb579c378,0,Nathan Marz,2011-12-22 23:55:28-08:00,['72c476c1d4e114f85b29cc794936c3f003369a71'],10,0,10,84727,1,,,,283
aa656d3e66130a91dbb5cb9eced1a86925f6a8f5,0,Nathan Marz,2011-12-23 00:10:53-08:00,['4299517dfeada14ae566ac25125e3b2fb579c378'],27,59,86,84813,10,0.928571429,0.928571429,1,284
c663832deeff338b6481ea54f9ae62e29fdfa4b6,0,Nathan Marz,2011-12-23 02:57:10-08:00,['aa656d3e66130a91dbb5cb9eced1a86925f6a8f5'],2,35,37,84850,2,,,,284
63f11b1a34414a8bd3e70fda31e3573238265a9b,0,Nathan Marz,2011-12-23 02:57:52-08:00,['c663832deeff338b6481ea54f9ae62e29fdfa4b6'],2,0,2,84852,1,,,,284
782d57f40cab0fdbd96d34e2ff417a81e58348e9,0,Nathan Marz,2011-12-23 03:40:30-08:00,['63f11b1a34414a8bd3e70fda31e3573238265a9b'],228,258,486,85338,12,1,1,0.833333333,286
29504af74ce161ea406a666aa5687e6cb5174816,0,Nathan Marz,2011-12-23 03:47:01-08:00,['782d57f40cab0fdbd96d34e2ff417a81e58348e9'],6,4,10,85348,2,0,1,1,286
80adc6a73e981ee671fb35bbba2d8734bb914da0,0,Nathan Marz,2011-12-23 03:52:13-08:00,['29504af74ce161ea406a666aa5687e6cb5174816'],0,4,4,85352,1,,,,286
d756afffdbcb6f2c32797dd4e250867d11b88bd2,0,Nathan Marz,2011-12-23 04:27:19-08:00,['80adc6a73e981ee671fb35bbba2d8734bb914da0'],0,3,3,85355,1,0,1,1,286
aadc136241caec688b0707aeef94b0f299601edb,0,Nathan Marz,2011-12-23 15:41:35-08:00,['d756afffdbcb6f2c32797dd4e250867d11b88bd2'],2132,468,2600,87955,19,0.638980263,0.600328947,0.028782895,286
4838a0601decf70f93be5f1e48a8daf58a7011b2,0,Nathan Marz,2011-12-23 19:13:44-08:00,['aadc136241caec688b0707aeef94b0f299601edb'],301,413,714,88669,23,0.892307692,1,0.861538462,291
34a2a95b81e955b4c0698c71cdb2117bd737a222,0,Nathan Marz,2011-12-23 21:46:35-08:00,['4838a0601decf70f93be5f1e48a8daf58a7011b2'],66,128,194,88863,22,0,1,0.909090909,295
c15d20e65fd4c58b246fc7026c97079fba89cf7d,0,Nathan Marz,2011-12-23 21:59:08-08:00,['34a2a95b81e955b4c0698c71cdb2117bd737a222'],14,16,30,88893,2,,,,295
4bc27848cdd4c1914343eac1419681053f743d42,0,Nathan Marz,2011-12-24 00:49:17-08:00,['c15d20e65fd4c58b246fc7026c97079fba89cf7d'],12,0,12,88905,1,,,,295
cdf5c38efda92c64c129a307e3debc93fa09e124,0,Nathan Marz,2011-12-24 01:12:30-08:00,['4bc27848cdd4c1914343eac1419681053f743d42'],35,31,66,88971,2,0.75,0.75,0.375,295
3fe220072cb523a4675747140438bee384004447,0,Nathan Marz,2011-12-24 01:18:41-08:00,['cdf5c38efda92c64c129a307e3debc93fa09e124'],3,6,9,88980,1,,,,295
8c0ae064b0a10c1cc1d2175b563d364eac78aba9,0,Nathan Marz,2011-12-24 03:14:50-08:00,['3fe220072cb523a4675747140438bee384004447'],7,1,8,88988,2,,,,295
292d31a9664c64ec962f6b8e6be9ef741b77974d,0,Nathan Marz,2011-12-24 03:15:07-08:00,['8c0ae064b0a10c1cc1d2175b563d364eac78aba9'],0,15,15,89003,1,1,1,1,296
ea81b55b89920d55ea0d01fe2559f9527e5c32c6,0,Nathan Marz,2011-12-24 15:18:53-08:00,['292d31a9664c64ec962f6b8e6be9ef741b77974d'],5,353,358,89361,3,0.872586873,0.872586873,0.803088803,296
dd8612120ef0597f8d171767752e908222ae1cf0,0,Nathan Marz,2011-12-24 17:34:54-08:00,['ea81b55b89920d55ea0d01fe2559f9527e5c32c6'],18,82,100,89461,6,0.43902439,0.43902439,0.951219512,296
997fe0c6fbe35a16ec8cf33e8702db5f5c4a43a0,0,Nathan Marz,2011-12-24 21:32:25-08:00,['dd8612120ef0597f8d171767752e908222ae1cf0'],30,34,64,89525,2,0,1,1,296
aea251305ed088b3b267d16a9de03422200c2249,0,Nathan Marz,2011-12-24 21:33:05-08:00,['997fe0c6fbe35a16ec8cf33e8702db5f5c4a43a0'],1,1,2,89527,1,,,,296
48248b5c7b0e85c9fa2b95464c963203ae80b4ac,0,Nathan Marz,2011-12-24 23:20:04-08:00,['aea251305ed088b3b267d16a9de03422200c2249'],2,10,12,89539,2,0,0,1,296
1e8707cffba2de1aa358f41da91c979bb25bdf1c,0,Nathan Marz,2011-12-24 23:37:42-08:00,['48248b5c7b0e85c9fa2b95464c963203ae80b4ac'],0,10,10,89549,2,1,1,1,296
3bc27e3ded3fab45201a156501bfad6cbceecc94,1,Nathan Marz,2011-12-25 00:00:59-08:00,['340dedca54f91c6766db74ed3908cdd42fe3f187'],1,11,12,89561,2,,,,296
e1eb16b3783bbcda9d2b83f7b1224a51c00e5e62,0,Nathan Marz,2011-12-25 01:48:29-08:00,['3bc27e3ded3fab45201a156501bfad6cbceecc94'],1,1,2,89563,1,,,,296
e455ceb45620b431ab6ea1580c6ac270a3f61c2c,1,Nathan Marz,2011-12-25 01:48:55-08:00,['e1eb16b3783bbcda9d2b83f7b1224a51c00e5e62'],0,38,38,89601,3,,,,296
1989897c018bfb64955e304c5df83e2b8aba1925,0,Nathan Marz,2011-12-25 01:49:08-08:00,"['1e8707cffba2de1aa358f41da91c979bb25bdf1c', 'e455ceb45620b431ab6ea1580c6ac270a3f61c2c']",2,50,52,89653,6,,,,296
f410aabd060876bf0100a03f5fdb326e8d26f69c,0,Nathan Marz,2011-12-26 10:47:02-08:00,['1989897c018bfb64955e304c5df83e2b8aba1925'],3,13,16,89669,4,,,,296
abeecafff2726aab78408be635fb50d194c7902f,0,Sam Ritchie,2012-01-03 08:50:27-08:00,['e455ceb45620b431ab6ea1580c6ac270a3f61c2c'],10,10,20,89689,1,,,,296
998b792651509b3298c167acc27c8f5ea2fece4d,0,Nathan Marz,2012-01-04 14:12:11-08:00,['f410aabd060876bf0100a03f5fdb326e8d26f69c'],15,39,54,89743,6,1,1,1,297
d0e6831b016d457c501b9236b24141253da465a0,0,Nathan Marz,2012-01-04 14:35:19-08:00,['e455ceb45620b431ab6ea1580c6ac270a3f61c2c'],2492,2772,5264,95007,16,1,1,0.717948718,301
eadd18742af28ba18bdf663b604028e1e4bb8733,0,Nathan Marz,2012-01-04 14:35:50-08:00,"['d0e6831b016d457c501b9236b24141253da465a0', 'abeecafff2726aab78408be635fb50d194c7902f']",10,10,20,95027,1,,,,301
eb42451418cd71f76ed196f36e52d70a45582491,0,Nathan Marz,2012-01-04 14:36:40-08:00,['eadd18742af28ba18bdf663b604028e1e4bb8733'],1,1,2,95029,1,,,,301
896ec13aa746888216ef660ecbdefc4f0e71c81d,0,Nathan Marz,2012-01-04 14:54:15-08:00,['eb42451418cd71f76ed196f36e52d70a45582491'],1,5,6,95035,1,,,,301
fc5ae41661724a03e06d8352e94b18fe29c149b9,0,Nathan Marz,2012-01-04 16:10:05-08:00,"['998b792651509b3298c167acc27c8f5ea2fece4d', '896ec13aa746888216ef660ecbdefc4f0e71c81d']",2503,2787,5290,100325,18,,,,301
0644b39c8786176b5cdfde62039ca5ee0f7c2f4a,0,Nathan Marz,2012-01-04 16:11:23-08:00,['896ec13aa746888216ef660ecbdefc4f0e71c81d'],4,1,5,100330,3,,,,301
6041cd9d03f4f8acb2a4c91767ab0c9687232383,0,Nathan Marz,2012-01-04 17:57:32-08:00,['0644b39c8786176b5cdfde62039ca5ee0f7c2f4a'],33,48,81,100411,3,,,,301
df33534846d324f2f36066cd87bea2e8ce0f0cfb,0,Nathan Marz,2012-01-04 17:57:43-08:00,['6041cd9d03f4f8acb2a4c91767ab0c9687232383'],1,1,2,100413,1,,,,301
0eb696b1701a54a1a78973399f88003ec56ca353,0,Nathan Marz,2012-01-04 18:31:15-08:00,['df33534846d324f2f36066cd87bea2e8ce0f0cfb'],28,21,49,100462,4,,,,301
7cce193313f89b9afa7f57e288993235e9f8c165,0,Nathan Marz,2012-01-04 22:35:10-08:00,['0eb696b1701a54a1a78973399f88003ec56ca353'],17,28,45,100507,3,,,,301
f7fa84ab322657e44897a495d7299d9f453639a8,1,Nathan Marz,2012-01-04 23:11:42-08:00,['7cce193313f89b9afa7f57e288993235e9f8c165'],9,15,24,100531,3,,,,301
317710d07a1b836478a2bd4aa08c9937554d9d1b,0,Nathan Marz,2012-01-04 23:16:15-08:00,['f7fa84ab322657e44897a495d7299d9f453639a8'],1,9,10,100541,2,,,,301
83e2eecc662e19b20559b8483c41d7db865d401c,0,Nathan Marz,2012-01-04 23:33:26-08:00,['317710d07a1b836478a2bd4aa08c9937554d9d1b'],5,23,28,100569,5,,,,301
8833764ffec48c869c10b504093bbe0b78c1f304,0,Nathan Marz,2012-01-05 01:46:42-08:00,['83e2eecc662e19b20559b8483c41d7db865d401c'],15,4,19,100588,5,,,,301
a6fcc6ed17f7861b0ed8a46bc54903c313c4908b,0,Nathan Marz,2012-01-05 03:43:12-08:00,['8833764ffec48c869c10b504093bbe0b78c1f304'],1,19,20,100608,3,,,,301
130c34e652706acbc9e9c9c49352e8dc9d9cd920,0,Nathan Marz,2012-01-05 04:30:52-08:00,['a6fcc6ed17f7861b0ed8a46bc54903c313c4908b'],1,2,3,100611,1,,,,301
a3094ef9cd940bf5c309d7abd496f4693e31f621,0,Nathan Marz,2012-01-05 04:52:57-08:00,['130c34e652706acbc9e9c9c49352e8dc9d9cd920'],7,11,18,100629,1,,,,301
5046c24eef630ce2f25e47d0ef13b6fc275fa1e0,0,Trevor Summers Smith,2012-01-08 12:42:27-05:00,['a3094ef9cd940bf5c309d7abd496f4693e31f621'],0,82,82,100711,4,,,,301
02dabc54ee827bcf46a2a469bab2215235ebed81,0,Nathan Marz,2012-01-08 19:37:24-08:00,"['fc5ae41661724a03e06d8352e94b18fe29c149b9', 'a3094ef9cd940bf5c309d7abd496f4693e31f621']",77,136,213,100924,15,,,,301
a5e14a22a85fa205fcb4b3127e4014db75fb2c57,0,Nathan Marz,2012-01-08 20:22:20-08:00,['02dabc54ee827bcf46a2a469bab2215235ebed81'],11,9,20,100944,3,,,,301
9a6881b93f1ccdbed1d6d66b575de3c3acf9dd59,0,Nathan Marz,2012-01-08 23:06:05-08:00,['a5e14a22a85fa205fcb4b3127e4014db75fb2c57'],213,391,604,101548,35,0.970588235,0.529411765,1,308
d9df90fd2fae8801b596d020b267774aef520bc5,0,Ben Hughes,2012-01-09 02:06:06-05:00,['a3094ef9cd940bf5c309d7abd496f4693e31f621'],15,124,139,101687,2,0.68852459,1,0.754098361,308
8279bff0c79319e058d1a9fb1429b55d9488ee89,0,Nathan Marz,2012-01-08 23:17:52-08:00,['9a6881b93f1ccdbed1d6d66b575de3c3acf9dd59'],2,5,7,101694,1,1,1,1,308
47a8b19c245dc327c61ce70ed68a4f9341991787,0,Ben Hughes,2012-01-09 02:44:09-05:00,['d9df90fd2fae8801b596d020b267774aef520bc5'],1,60,61,101755,1,1,1,1,308
ff423ae49fa5e06e45108c54727ded93d355c0a5,0,Nathan Marz,2012-01-09 00:00:47-08:00,['8279bff0c79319e058d1a9fb1429b55d9488ee89'],2,8,10,101765,2,,,,308
86b45723532d9b76aa8de9bcea8d29e371aa95de,0,Nathan Marz,2012-01-09 00:01:00-08:00,['ff423ae49fa5e06e45108c54727ded93d355c0a5'],0,10,10,101775,2,1,1,1,308
4cc3ce59a2272674805e8023e71bde4da6273619,0,Nathan Marz,2012-01-09 00:01:21-08:00,['86b45723532d9b76aa8de9bcea8d29e371aa95de'],2,23,25,101800,3,,,,308
bbe4aee5ac77533fa7492f5bef03e2cd2ec2a68b,0,Ben Hughes,2012-01-09 03:13:33-05:00,['47a8b19c245dc327c61ce70ed68a4f9341991787'],2,42,44,101844,1,1,1,1,308
e1ccf0cd44eec68f7bbea4e424da5564017b02a5,0,Nathan Marz,2012-01-09 00:21:03-08:00,['4cc3ce59a2272674805e8023e71bde4da6273619'],53,44,97,101941,10,1,1,1,308
225255ada7717b80f5d0abb452980038de16b26a,0,Nathan Marz,2012-01-09 01:25:18-08:00,['e1ccf0cd44eec68f7bbea4e424da5564017b02a5'],31,63,94,102035,4,1,1,1,309
030304ce4242201ffc0a55f409df18af3237b6ad,0,Nathan Marz,2012-01-09 01:26:01-08:00,['225255ada7717b80f5d0abb452980038de16b26a'],1,2,3,102038,1,,,,309
c67f3579f05a93308303f315aff60a850ed46818,0,Nathan Marz,2012-01-09 01:28:01-08:00,['030304ce4242201ffc0a55f409df18af3237b6ad'],5,7,12,102050,2,1,0,0.666666667,309
1600c312e2b6a51c887afd47b47c7079885f02c8,0,Nathan Marz,2012-01-09 01:41:08-08:00,['c67f3579f05a93308303f315aff60a850ed46818'],7,9,16,102066,3,,,,309
26cf709faa6db019b642f362c85083a9ad7a82ac,0,Nathan Marz,2012-01-09 01:52:07-08:00,['1600c312e2b6a51c887afd47b47c7079885f02c8'],3,4,7,102073,2,1,1,0,309
878293f2fe0ca7120cc16ff5ece4eac676cb800f,0,Nathan Marz,2012-01-09 01:55:17-08:00,['26cf709faa6db019b642f362c85083a9ad7a82ac'],0,9,9,102082,1,,,,309
b37dfdbb13fb0c1c58f47203da6c5097242e92ce,0,Ben Hughes,2012-01-09 06:04:28-05:00,['bbe4aee5ac77533fa7492f5bef03e2cd2ec2a68b'],108,226,334,102416,7,0.975,1,0.975,310
a7da0cc79471fb9a2702409d5a14b88b481a998d,0,Ben Hughes,2012-01-09 13:37:39-05:00,['b37dfdbb13fb0c1c58f47203da6c5097242e92ce'],4,42,46,102462,3,1,1,1,311
102824902199a35331afa517bc4dd2c6666f96f8,0,Nathan Marz,2012-01-09 16:50:19-08:00,['878293f2fe0ca7120cc16ff5ece4eac676cb800f'],1,19,20,102482,2,1,1,1,311
ff82ec375a47ef163b38e806cb95c07c1f86ee4b,0,Ben Hughes,2012-01-10 02:31:58-05:00,['a7da0cc79471fb9a2702409d5a14b88b481a998d'],2,3,5,102487,1,,,,311
7028d12d4b854ed3f00c5492bbf29660d25b2e7d,0,Ben Hughes,2012-01-10 15:16:01-05:00,['ff82ec375a47ef163b38e806cb95c07c1f86ee4b'],7,13,20,102507,1,,,,311
06a8c4a8f93d46ddf224121cf02e61e835a7cc09,0,Nathan Marz,2012-01-10 14:36:24-08:00,['a3094ef9cd940bf5c309d7abd496f4693e31f621'],1,1,2,102509,1,,,,311
95e062453070df1a59648e5e407522bdcd95ae11,0,Nathan Marz,2012-01-10 19:24:04-08:00,['06a8c4a8f93d46ddf224121cf02e61e835a7cc09'],6,9,15,102524,2,,,,311
a6dc3ad29b675b453dd603f16b546a2cd645f109,0,Nathan Marz,2012-01-10 20:03:49-08:00,['102824902199a35331afa517bc4dd2c6666f96f8'],9,94,103,102627,3,1,1,1,312
ca387422892b28bdfcf7595d8a9e58a3f08e1460,0,Nathan Marz,2012-01-10 20:09:59-08:00,['a6dc3ad29b675b453dd603f16b546a2cd645f109'],3,13,16,102643,2,1,1,1,312
3840655f40ebb063a1cccc5465b0c87b91977168,0,Nathan Marz,2012-01-10 21:45:45-08:00,['ca387422892b28bdfcf7595d8a9e58a3f08e1460'],79,143,222,102865,8,1,1,0.921052632,313
ee769e8009a4b06a45b7217f7ae866e50cf0edd8,0,Nathan Marz,2012-01-10 22:04:57-08:00,['3840655f40ebb063a1cccc5465b0c87b91977168'],0,33,33,102898,1,,,,313
36395919fb4aecc38d0f1fb75ea066175df4f7b1,0,Nathan Marz,2012-01-10 23:27:52-08:00,['4186391cf91cb4ecc492eea50c8e3cc1cc37c828'],2,2,4,102902,2,,,,313
38bae1704454ad1c9867cb28b5c6cd7e1b83d219,1,Nathan Marz,2012-01-11 18:40:15-08:00,['ee769e8009a4b06a45b7217f7ae866e50cf0edd8'],65,305,370,103272,14,0.612244898,0.952380952,0.884353741,316
d809dd629b3781d4c8aa14b192ee5d4da915c4ac,0,Nathan Marz,2012-01-12 01:21:31-08:00,['38bae1704454ad1c9867cb28b5c6cd7e1b83d219'],2,6,8,103280,2,0,1,1,316
619f2fdef79df82fea98cfb6d8bfc12ecbc7f31e,0,Nathan Marz,2012-01-12 01:21:54-08:00,['95e062453070df1a59648e5e407522bdcd95ae11'],1,1,2,103282,1,,,,316
d3f28a69c521db40cb52797f4582f1973aecdf02,0,Nathan Marz,2012-01-12 13:57:16-08:00,['d809dd629b3781d4c8aa14b192ee5d4da915c4ac'],7,18,25,103307,2,0.916666667,1,0.833333333,316
20e1ef9bff4092d6438ebda32ec985b616bddd8c,0,Nathan Marz,2012-01-12 14:09:11-08:00,['619f2fdef79df82fea98cfb6d8bfc12ecbc7f31e'],2,6,8,103315,1,,,,316
f2266958346807d8f62f3c790bccf26cb7880def,0,Nathan Marz,2012-01-12 16:32:03-08:00,"['20e1ef9bff4092d6438ebda32ec985b616bddd8c', '5046c24eef630ce2f25e47d0ef13b6fc275fa1e0']",0,82,82,103397,4,,,,316
53ce477c78f9d0a051e6d1d644309079ab6d5e85,0,Nathan Marz,2012-01-12 16:47:48-08:00,['f2266958346807d8f62f3c790bccf26cb7880def'],26,19,45,103442,2,,,,316
9dacabe703968ea4ae0d23e600f734fd7f843ced,1,Nathan Marz,2012-01-12 17:06:00-08:00,['53ce477c78f9d0a051e6d1d644309079ab6d5e85'],10,14,24,103466,2,0,1,1,316
f099259c0128e60276f7931ecd18c39af1b2d94d,0,Nathan Marz,2012-01-12 17:13:03-08:00,['9dacabe703968ea4ae0d23e600f734fd7f843ced'],1,0,1,103467,1,,,,316
0ae5b15f215e5ac4cf8e3f66c07b8489923f78f2,0,Nathan Marz,2012-01-12 17:13:20-08:00,['f099259c0128e60276f7931ecd18c39af1b2d94d'],2,2,4,103471,2,,,,316
de3de421a7d0a6ef5bfd8ce5f606dd1e5c9e82c6,0,dennis zhuang,2012-01-13 11:31:09+08:00,['f2266958346807d8f62f3c790bccf26cb7880def'],4,19,23,103494,4,,,,316
9576260c5c45bdaeb3b5b4481edf78ae4a3672b6,0,Nathan Marz,2012-01-13 01:23:09-08:00,['0ae5b15f215e5ac4cf8e3f66c07b8489923f78f2'],1,1,2,103496,1,,,,316
3038ff09373454946cff602d8a1c6e2ad7c28760,0,Nathan Marz,2012-01-13 01:23:28-08:00,['9576260c5c45bdaeb3b5b4481edf78ae4a3672b6'],15,7,22,103518,1,,,,316
79f792128b6de251e83621f257ec5020f2cfd9fd,0,Nathan Marz,2012-01-13 01:53:01-08:00,['3038ff09373454946cff602d8a1c6e2ad7c28760'],3,7,10,103528,3,,,,316
ff3364a975bc28f68703df65ec2461c92a25dd5d,0,Nathan Marz,2012-01-13 02:03:56-08:00,['79f792128b6de251e83621f257ec5020f2cfd9fd'],0,59,59,103587,1,,,,317
64a686be70b54cd972b80c3d75ef2f10af5ef1d2,0,Nathan Marz,2012-01-13 02:12:02-08:00,['ff3364a975bc28f68703df65ec2461c92a25dd5d'],2,11,13,103600,2,,,,317
0876c314a8e53bcec66e578b4edcf32e2d76cbc9,0,Nathan Marz,2012-01-13 03:22:09-08:00,['64a686be70b54cd972b80c3d75ef2f10af5ef1d2'],1,1,2,103602,1,,,,317
46f860bf5ca1dab7c485e8b193998da6883d085e,0,Nathan Marz,2012-01-13 03:49:06-08:00,"['d3f28a69c521db40cb52797f4582f1973aecdf02', '0876c314a8e53bcec66e578b4edcf32e2d76cbc9']",29,178,207,103809,10,,,,317
51fab9ed23d65045b76ddefaa60eb24a767c5050,0,Nathan Marz,2012-01-13 14:22:57-08:00,['0876c314a8e53bcec66e578b4edcf32e2d76cbc9'],1,1,2,103811,1,,,,317
139026a453e7da8fa9523ca377830b2ca5a4c0ff,0,Ben Hughes,2012-01-14 17:55:34-05:00,['7028d12d4b854ed3f00c5492bbf29660d25b2e7d'],2,4,6,103817,1,,,,317
5771c1c18ee6ed1c77bbe5bbc1bd48b4dc07f91d,0,Ben Hughes,2012-01-14 18:02:44-05:00,['139026a453e7da8fa9523ca377830b2ca5a4c0ff'],12,17,29,103846,1,,,,317
d29cf6a591869989edb42629287420fcadd321c0,1,Nathan Marz,2012-01-15 02:54:31-08:00,['51fab9ed23d65045b76ddefaa60eb24a767c5050'],6,25,31,103877,2,,,,317
58eb7bd911381d337a981914523aa3536ff1bbae,0,Nathan Marz,2012-01-15 03:09:35-08:00,['d29cf6a591869989edb42629287420fcadd321c0'],0,1,1,103878,1,,,,317
25294526e61e8029393667061b921dac54395b96,0,Nathan Marz,2012-01-15 15:29:51-08:00,['58eb7bd911381d337a981914523aa3536ff1bbae'],1,1,2,103880,1,,,,317
a62fcce5e672dcf777673941c864aa93b0cc6d5a,0,Nathan Marz,2012-01-15 18:05:59-08:00,"['46f860bf5ca1dab7c485e8b193998da6883d085e', '25294526e61e8029393667061b921dac54395b96']",7,27,34,103914,3,,,,317
4c5632d0245cfffb6c1b2cca8e8736f151c15a2b,0,Nathan Marz,2012-01-15 18:27:14-08:00,['a62fcce5e672dcf777673941c864aa93b0cc6d5a'],0,3,3,103917,1,0,0,1,317
51240693d9e186db58594984bda264b2ebbfe74b,0,Nathan Marz,2012-01-15 18:27:34-08:00,['4c5632d0245cfffb6c1b2cca8e8736f151c15a2b'],0,10,10,103927,1,,,,317
baae324079cf5a62f1c72e29c2196c336b53f070,0,Nathan Marz,2012-01-15 18:27:58-08:00,['25294526e61e8029393667061b921dac54395b96'],1,1,2,103929,1,,,,317
0b5135f5e2e60ad9297f12021c209344919f1d44,0,Nathan Marz,2012-01-15 18:28:19-08:00,"['51240693d9e186db58594984bda264b2ebbfe74b', 'baae324079cf5a62f1c72e29c2196c336b53f070']",1,1,2,103931,1,,,,317
f16fa2bfc80569dae5a95680bba199abb96db389,0,Nathan Marz,2012-01-16 01:53:23-08:00,['0b5135f5e2e60ad9297f12021c209344919f1d44'],59,141,200,104131,7,0.468085106,0.489361702,0.808510638,318
e7003a75b65f34483a520e04ac71a8ee73bb08bd,0,Nathan Marz,2012-01-16 02:11:25-08:00,['f16fa2bfc80569dae5a95680bba199abb96db389'],40,56,96,104227,5,0.529411765,0.470588235,0.823529412,318
60613149b802e88064383461319ef708aa69e69d,0,Nathan Marz,2012-01-16 02:23:42-08:00,['e7003a75b65f34483a520e04ac71a8ee73bb08bd'],12,0,12,104239,1,0,0,0,318
c5c375221cfc333d76cfa88e2bf576036fb21414,0,Nathan Marz,2012-01-16 02:34:19-08:00,['60613149b802e88064383461319ef708aa69e69d'],3,3,6,104245,2,,,,318
e3af1b19e782858b7f5ba7d95d1d7b1403f0be4d,0,Nathan Marz,2012-01-16 14:02:09-08:00,['c5c375221cfc333d76cfa88e2bf576036fb21414'],13,203,216,104461,9,0.738095238,0.988095238,0.75,321
f03481678ee0079c9dacb65a9df42f638b866e73,0,Nathan Marz,2012-01-16 14:26:25-08:00,['e3af1b19e782858b7f5ba7d95d1d7b1403f0be4d'],11,6,17,104478,4,0,0,0,321
c4eadcf58df045e49d02a6a84743f53e9186c9a1,0,Nathan Marz,2012-01-16 14:32:52-08:00,['f03481678ee0079c9dacb65a9df42f638b866e73'],0,4,4,104482,1,,,,321
7dcc258e12139c987a919da38e5bfeee789610c9,0,Nathan Marz,2012-01-16 16:09:56-08:00,['c4eadcf58df045e49d02a6a84743f53e9186c9a1'],1,5,6,104488,1,1,1,1,321
19cb2974b7ca77d02c406088eb57005b3265230c,0,Nathan Marz,2012-01-16 16:10:14-08:00,['7dcc258e12139c987a919da38e5bfeee789610c9'],0,17,17,104505,1,,,,321
3e53314576071cbb44ada8528d5f2919bea51e5d,0,Nathan Marz,2012-01-16 16:10:33-08:00,['19cb2974b7ca77d02c406088eb57005b3265230c'],2,2,4,104509,1,,,,321
806de3c1720719b0c430da85ea2cffceb1661236,0,Nathan Marz,2012-01-16 21:33:13-08:00,['3e53314576071cbb44ada8528d5f2919bea51e5d'],1,1,2,104511,1,,,,321
c28b350ac979603a5a761ead5c117e047c65b056,0,Ben Hughes,2012-01-17 12:02:17-05:00,['5771c1c18ee6ed1c77bbe5bbc1bd48b4dc07f91d'],23,37,60,104571,4,0,1,0,321
4925294d907f1894d38b65782f4de4d0f92816ef,0,Ben Hughes,2012-01-17 13:13:20-05:00,['c28b350ac979603a5a761ead5c117e047c65b056'],2,14,16,104587,1,,,,321
75f1d1a4af7cbab27241fd2f31c72303f512b1d8,0,Ben Hughes,2012-01-17 13:18:03-05:00,['4925294d907f1894d38b65782f4de4d0f92816ef'],13,0,13,104600,3,0,0,0,321
00366779dfea99d451989970ee426efa682d625d,0,Ben Hughes,2012-01-17 13:29:39-05:00,['75f1d1a4af7cbab27241fd2f31c72303f512b1d8'],2,0,2,104602,2,,,,321
8a64e433605c6bc9c4ad5a341afcf13b71dc1888,0,Ben Hughes,2012-01-17 14:11:18-05:00,['00366779dfea99d451989970ee426efa682d625d'],1,1,2,104604,1,,,,321
d0eac20d71ebcb18801146b03881b58bb5eda5d4,0,Nathan Marz,2012-01-17 18:11:39-08:00,['806de3c1720719b0c430da85ea2cffceb1661236'],102,89,191,104795,13,0,0,0,321
55880e2555704be0f8abc06dd996c9ce32e70838,0,Nathan Marz,2012-01-17 18:14:33-08:00,['d0eac20d71ebcb18801146b03881b58bb5eda5d4'],3,3,6,104801,3,,,,321
1bdfd9dc38f9ff2a598a60ba9c129333bdc0403c,0,Nathan Marz,2012-01-17 18:45:31-08:00,['55880e2555704be0f8abc06dd996c9ce32e70838'],12,47,59,104860,4,0.5,0,0.5,321
aff550f7c74c392feb0ee19a14ec4cc4b47bb337,0,Nathan Marz,2012-01-18 02:05:28-08:00,['1bdfd9dc38f9ff2a598a60ba9c129333bdc0403c'],0,6,6,104866,1,1,1,1,321
315934786b7e2459092d44e59ec8ea6e0168bbb2,0,Nathan Marz,2012-01-18 02:05:42-08:00,['aff550f7c74c392feb0ee19a14ec4cc4b47bb337'],1,1,2,104868,1,,,,321
c6add157958739968b51c96ae0238b8e8114818d,0,Nathan Marz,2012-01-18 02:06:11-08:00,['315934786b7e2459092d44e59ec8ea6e0168bbb2'],36,20,56,104924,5,1,1,1,321
d46e82e92538c0625f117c91f8fb85c7df80bb84,0,Nathan Marz,2012-01-18 02:08:22-08:00,[],0,174,174,105098,3,0.790123457,1,0.481481481,324
1c801a983b301ed72440ec8ca305906997558b0f,0,Nathan Marz,2012-01-18 02:24:30-08:00,['d46e82e92538c0625f117c91f8fb85c7df80bb84'],0,2,2,105100,1,,,,325
5b6c87fb1c31436cf4db1ba399471f66dd97b2d8,0,Nathan Marz,2012-01-18 02:24:50-08:00,['1c801a983b301ed72440ec8ca305906997558b0f'],5,0,5,105105,1,,,,325
a79a8797b95ed7fbe6b3c13b815a9c995cf43599,0,Nathan Marz,2012-01-18 03:22:12-08:00,['c6add157958739968b51c96ae0238b8e8114818d'],28,0,28,105133,1,,,,325
e12b26878d95ab02325baed7902f8c55cfb245ff,0,Nathan Marz,2012-01-18 03:28:37-08:00,['5b6c87fb1c31436cf4db1ba399471f66dd97b2d8'],1,2,3,105136,1,,,,325
331d20229de450bc0930bb5ac081c4f8d638e34d,0,Nathan Marz,2012-01-18 13:55:30-08:00,['e12b26878d95ab02325baed7902f8c55cfb245ff'],0,1,1,105137,1,,,,326
db6b1c5a6b89a1a70e22dfa99e352d4e61c2819d,0,Nathan Marz,2012-01-19 02:38:28-08:00,['a79a8797b95ed7fbe6b3c13b815a9c995cf43599'],7,15,22,105159,6,0,1,0.666666667,326
faa5d74870c14303bdc3b15472e9a555aacf80cc,0,Nathan Marz,2012-01-19 02:38:42-08:00,['db6b1c5a6b89a1a70e22dfa99e352d4e61c2819d'],0,56,56,105215,1,,,,327
74a7947b8890dc8c94dd266929c62a1bf1bb4b7f,0,Nathan Marz,2012-01-19 02:50:43-08:00,['faa5d74870c14303bdc3b15472e9a555aacf80cc'],19,37,56,105271,2,,,,327
502902cb63b5b2d3c216eb840ca464f325bc3f0f,1,Dan Dillinger,2012-01-19 14:35:05-05:00,['baae324079cf5a62f1c72e29c2196c336b53f070'],8,11,19,105290,2,,,,327
09372b158987358472ce0c7489378db4255dac28,0,Dan Dillinger,2012-01-19 14:38:02-05:00,['502902cb63b5b2d3c216eb840ca464f325bc3f0f'],1,1,2,105292,1,,,,327
a4f71940855a5d719e3a3a7d0d3a598117906dd6,0,Nathan Marz,2012-01-19 16:08:45-08:00,['baae324079cf5a62f1c72e29c2196c336b53f070'],1,2,3,105295,1,,,,327
bf034aade09bf0a2b33e7a5860755403c31c52dd,0,Nathan Marz,2012-01-19 16:08:52-08:00,['a4f71940855a5d719e3a3a7d0d3a598117906dd6'],0,2,2,105297,1,,,,327
51359f38d6eec4d95c5c36ce949d3b73b78ccd1b,0,Nathan Marz,2012-01-19 16:12:01-08:00,['bf034aade09bf0a2b33e7a5860755403c31c52dd'],1,1,2,105299,1,,,,327
2d72b94c6fbdbb72ad1e5d39e2ca4481f26d41fa,0,Nathan Marz,2012-01-19 16:15:48-08:00,"['74a7947b8890dc8c94dd266929c62a1bf1bb4b7f', '51359f38d6eec4d95c5c36ce949d3b73b78ccd1b']",1,4,5,105304,2,,,,327
18bd95078ee2cbc742d335d02480a8e954dfe3a0,0,Nathan Marz,2012-01-19 16:21:32-08:00,['2d72b94c6fbdbb72ad1e5d39e2ca4481f26d41fa'],1,1,2,105306,1,,,,327
4e2dd49ee0c7bdfc78863d648e51d7c99b68f48c,0,Nathan Marz,2012-01-20 00:15:30-08:00,['36395919fb4aecc38d0f1fb75ea066175df4f7b1'],2,2,4,105310,2,,,,327
0ee45b138a2453671ec1f98fdc5e74b285421f22,0,Nathan Marz,2012-01-20 01:11:55-08:00,['18bd95078ee2cbc742d335d02480a8e954dfe3a0'],27,81,108,105418,2,,,,327
de4027f967e335e97c34ab69663f3f59d8ad4299,0,Nathan Marz,2012-01-20 01:31:04-08:00,['0ee45b138a2453671ec1f98fdc5e74b285421f22'],1,5,6,105424,1,0,0,1,327
9a375581ddcf3d3c2a82af4f5b4854e331fd9e30,0,Nathan Marz,2012-01-20 01:31:45-08:00,['de4027f967e335e97c34ab69663f3f59d8ad4299'],14,20,34,105458,1,1,0,1,327
21ddd27344e6bf3a03140355713ef8ff663b7b65,0,Nathan Marz,2012-01-20 01:35:54-08:00,['9a375581ddcf3d3c2a82af4f5b4854e331fd9e30'],0,12,12,105470,1,0.75,0.75,1,327
df4692c0a5bc1346ad62918998979a933dc73cf4,0,Sam Ritchie,2012-01-20 09:52:34-08:00,['51359f38d6eec4d95c5c36ce949d3b73b78ccd1b'],3,2,5,105475,1,,,,327
752b4be0cdcd2b5997310b9623d013163bbfe407,0,Nathan Marz,2012-01-20 15:21:58-08:00,['21ddd27344e6bf3a03140355713ef8ff663b7b65'],20,54,74,105549,4,0.764705882,0.764705882,0.764705882,327
a306adbc7b940d9aa99555b5f5cedb786840929f,0,Nathan Marz,2012-01-20 16:27:33-08:00,['752b4be0cdcd2b5997310b9623d013163bbfe407'],4,89,93,105642,5,1,1,0.454545455,328
a0d3dca54a66dfc9650a357687a106c9dd284bea,0,Nathan Marz,2012-01-21 19:14:48-08:00,['a306adbc7b940d9aa99555b5f5cedb786840929f'],54,205,259,105901,7,1,1,1,330
22e48790431c407d89b329fb9ab9f976780d9b0e,0,Nathan Marz,2012-01-23 00:04:07-08:00,['a0d3dca54a66dfc9650a357687a106c9dd284bea'],22,90,112,106013,5,0,0,1,330
b993ec7567ebe7a46bd7dc53b1dee56595d3642e,0,Nathan Marz,2012-01-23 00:09:11-08:00,['22e48790431c407d89b329fb9ab9f976780d9b0e'],6,2,8,106021,1,,,,330
9cab7bd1712d6c60c584643201c8ac2f989d278e,0,Nathan Marz,2012-01-23 01:59:34-08:00,['b993ec7567ebe7a46bd7dc53b1dee56595d3642e'],2,16,18,106039,2,,,,330
670bc7af82eeb07fa83b4ec4af07cefea3a25521,0,Nathan Marz,2012-01-23 02:01:17-08:00,['9cab7bd1712d6c60c584643201c8ac2f989d278e'],0,3,3,106042,1,,,,330
16b6777c0cb00ae48996637d1ae5d0a7d79cd0b4,0,Nathan Marz,2012-01-23 14:07:55-08:00,['670bc7af82eeb07fa83b4ec4af07cefea3a25521'],23,60,83,106125,2,0.269230769,1,1,330
1a3f6d44926d4ceb6f959002c122c9ea3ec2ab62,0,Nathan Marz,2012-01-23 14:23:16-08:00,['16b6777c0cb00ae48996637d1ae5d0a7d79cd0b4'],6,28,34,106159,1,0.545454545,0.545454545,1,330
8890121b424c024f5a11b415a308f13060f3fed7,0,Nathan Marz,2012-01-23 14:26:06-08:00,['1a3f6d44926d4ceb6f959002c122c9ea3ec2ab62'],1,0,1,106160,1,,,,330
b88933b196499f05638439c56348e499edfd04da,0,Nathan Marz,2012-01-23 14:47:05-08:00,['8890121b424c024f5a11b415a308f13060f3fed7'],21,67,88,106248,4,0.548387097,0.548387097,1,331
b13f9fe84c6ae72177e9649433e34506b8edbc08,0,Nathan Marz,2012-01-24 00:25:55-08:00,['b88933b196499f05638439c56348e499edfd04da'],13,205,218,106466,5,0.75,1,0.576086957,333
ed508024e469821929eb295ff6f85e777cf1d0ec,0,Nathan Marz,2012-01-24 00:29:10-08:00,['b13f9fe84c6ae72177e9649433e34506b8edbc08'],2,2,4,106470,1,,,,333
ae28a9b02e4b13e8788ba2e545bf584f21cc8888,0,Nathan Marz,2012-01-24 03:39:11-08:00,['ed508024e469821929eb295ff6f85e777cf1d0ec'],19,64,83,106553,5,0.5,0.5,1,333
f5254d0cbe08fa710cb237a1ecc17fc219937a52,0,Nathan Marz,2012-01-24 14:50:29-08:00,['ae28a9b02e4b13e8788ba2e545bf584f21cc8888'],15,46,61,106614,7,0.846153846,1,0.692307692,333
b17801b5a4769113818a05879aba059216e3fad0,0,P. Taylor Goetz,2012-01-24 21:23:31-05:00,['bcd4d227fee40d73cf4e9b6986270552436e0f44'],4,4,8,106622,3,,,,333
94371832f2faf2ac2018a5a33ddc5608e980e596,0,Nathan Marz,2012-01-25 00:04:38-08:00,['f5254d0cbe08fa710cb237a1ecc17fc219937a52'],218,285,503,107125,16,1,1,0.734693878,337
c9720b698380962933791cfee871149669ece440,0,Nathan Marz,2012-01-25 00:18:04-08:00,['94371832f2faf2ac2018a5a33ddc5608e980e596'],135,75,210,107335,16,0,0,0.058823529,338
17863eb328332af14568862a61b88c17e7c42ee0,0,Nathan Marz,2012-01-25 00:28:36-08:00,['c9720b698380962933791cfee871149669ece440'],15,33,48,107383,18,1,1,1,338
5cdfc047cc5d3fbf4797c56e4befb6f6e282d58d,0,Nathan Marz,2012-01-25 00:39:28-08:00,['17863eb328332af14568862a61b88c17e7c42ee0'],91,32,123,107506,17,1,0,0.071428571,338
fe87c3e6516bfb3cf351666f62600a8a583ba87a,0,Nathan Marz,2012-01-25 00:44:05-08:00,['5cdfc047cc5d3fbf4797c56e4befb6f6e282d58d'],17,7,24,107530,1,0.555555556,0.555555556,0.444444444,338
b8bafcd71293136aceacca3ea9df666db83cef5f,0,Nathan Marz,2012-01-25 00:57:14-08:00,['fe87c3e6516bfb3cf351666f62600a8a583ba87a'],1,6,7,107537,2,1,1,1,338
306a8b9280aafe21e34d40e773e5ba8444e967b6,0,Nathan Marz,2012-01-25 01:08:55-08:00,['b8bafcd71293136aceacca3ea9df666db83cef5f'],7,0,7,107544,1,,,,338
93029ad7e9b3abe55af5f01205a8f377588a85e9,0,Nathan Marz,2012-01-25 01:18:09-08:00,['306a8b9280aafe21e34d40e773e5ba8444e967b6'],1,0,1,107545,1,,,,338
2e1b64047ec0b6a1139a369963f31fba0a94ab36,0,Nathan Marz,2012-01-25 01:21:29-08:00,['93029ad7e9b3abe55af5f01205a8f377588a85e9'],13,0,13,107558,2,,,,338
ff2e570b80671b6006adccfec3390c30bed6b79b,0,Nathan Marz,2012-01-25 12:27:11-08:00,['2e1b64047ec0b6a1139a369963f31fba0a94ab36'],1,9,10,107568,2,0.666666667,0.666666667,1,338
26cc00aa45c37f949582d0551708173035454331,0,Nathan Marz,2012-01-25 15:33:12-08:00,['ff2e570b80671b6006adccfec3390c30bed6b79b'],3,136,139,107707,4,1,1,0.78,341
66810d62c8b02f107a8dc3fafae831e21c752e35,0,Nathan Marz,2012-01-25 15:33:25-08:00,['df4692c0a5bc1346ad62918998979a933dc73cf4'],1,1,2,107709,1,,,,341
33272f32fad813fe062a239fca527f1019e17d25,0,Nathan Marz,2012-01-25 15:35:43-08:00,"['df4692c0a5bc1346ad62918998979a933dc73cf4', '09372b158987358472ce0c7489378db4255dac28']",8,11,19,107728,2,,,,341
66c1dfd15945c87a7e8adf970d890efe65f787f0,0,Nathan Marz,2012-01-25 15:36:07-08:00,"['66810d62c8b02f107a8dc3fafae831e21c752e35', '33272f32fad813fe062a239fca527f1019e17d25']",8,11,19,107747,2,,,,341
e159c3a53d221e59652fc598216b3c33e73ca2f0,0,Nathan Marz,2012-01-25 15:36:54-08:00,['66c1dfd15945c87a7e8adf970d890efe65f787f0'],0,6,6,107753,1,,,,341
a5a7c8c0ba8550ccdc66ef48daf8ca4a39420546,1,Nathan Marz,2012-01-25 15:38:46-08:00,['e159c3a53d221e59652fc598216b3c33e73ca2f0'],1,1,2,107755,1,,,,341
238f1c934e0dcc8e5339376c167fe6326c50b5fb,0,Nathan Marz,2012-01-25 16:00:11-08:00,['a5a7c8c0ba8550ccdc66ef48daf8ca4a39420546'],0,5,5,107760,1,,,,341
fc63b2d286a73944ca9035b2ac3665b5d187d90b,0,Nathan Marz,2012-01-25 16:00:45-08:00,"['26cc00aa45c37f949582d0551708173035454331', '238f1c934e0dcc8e5339376c167fe6326c50b5fb']",12,25,37,107797,5,,,,341
743645ed7439e9896535bcf4e2e9ae2d78d82414,0,Nathan Marz,2012-01-25 18:36:32-08:00,['fc63b2d286a73944ca9035b2ac3665b5d187d90b'],41,44,85,107882,2,,,,341
afe8ee8ff4540830b4da87174dfd2908b0ba39f8,0,Nathan Marz,2012-01-25 20:08:26-08:00,['743645ed7439e9896535bcf4e2e9ae2d78d82414'],28,51,79,107961,3,,,,341
e5789d49094b63e055b4ac164e609b379ee5f0c5,0,Nathan Marz,2012-01-25 22:37:28-08:00,['afe8ee8ff4540830b4da87174dfd2908b0ba39f8'],52,125,177,108138,6,1,1,0.533333333,341
27d1b8a5177099df6f33d5ae228b7658682709d1,0,Nathan Marz,2012-01-25 22:38:02-08:00,['e5789d49094b63e055b4ac164e609b379ee5f0c5'],2,2,4,108142,1,,,,341
20a29802b0566f72fadd56dc8c661b531eb8fd80,0,Nathan Marz,2012-01-25 22:38:24-08:00,['27d1b8a5177099df6f33d5ae228b7658682709d1'],1,1,2,108144,1,,,,341
d56be3fc2a16681f0ce30c617bdac0d8bf3245a0,0,Nathan Marz,2012-01-25 22:59:15-08:00,['20a29802b0566f72fadd56dc8c661b531eb8fd80'],9,1,10,108154,2,0,0,0.5,341
7989c581876f60881c77aba5a611db0948d0121c,0,Nathan Marz,2012-01-25 23:45:51-08:00,['d56be3fc2a16681f0ce30c617bdac0d8bf3245a0'],5,48,53,108207,3,1,1,1,342
51d59ec032cb54ddaa7f3c6b47ad348b67130141,0,Nathan Marz,2012-01-26 01:24:54-08:00,['7989c581876f60881c77aba5a611db0948d0121c'],14,47,61,108268,2,,,,342
ea8b4b9304f2f5166cda919bc3ff257a8dd13f2f,0,Nathan Marz,2012-01-26 02:03:11-08:00,['51d59ec032cb54ddaa7f3c6b47ad348b67130141'],17,45,62,108330,1,,,,342
e1299809a5af84557a94df1f7b8ecb2ace3aa755,0,Nathan Marz,2012-01-26 03:53:28-08:00,['ea8b4b9304f2f5166cda919bc3ff257a8dd13f2f'],38,80,118,108448,1,,,,342
80c797353095cf2420514bdc53daa110c4ea9085,0,Nathan Marz,2012-01-26 13:42:25-08:00,['e1299809a5af84557a94df1f7b8ecb2ace3aa755'],17,94,111,108559,3,1,1,0.75,343
b8b4f22010bd99694f8d60f5cb0ad40e40867cd2,0,Nathan Marz,2012-01-26 13:43:07-08:00,['80c797353095cf2420514bdc53daa110c4ea9085'],7,0,7,108566,1,,,,343
facc876e99d566a89b52e1207fb4742cdc5bb0b7,0,Nathan Marz,2012-01-26 14:49:55-08:00,['b8b4f22010bd99694f8d60f5cb0ad40e40867cd2'],4,7,11,108577,1,1,1,0,343
e223f937a8696c73aba8e2792f7e6b88809e77c4,1,Nathan Marz,2012-01-26 14:50:13-08:00,['facc876e99d566a89b52e1207fb4742cdc5bb0b7'],19,84,103,108680,4,1,1,1,343
ba5477f0a09ac54682668abce097f2221384510c,0,Nathan Marz,2012-01-26 14:52:01-08:00,['e223f937a8696c73aba8e2792f7e6b88809e77c4'],1,0,1,108681,1,,,,343
b904e96c683ef0281949b7dfb543223702575908,0,Nathan Marz,2012-01-26 18:26:48-08:00,['ba5477f0a09ac54682668abce097f2221384510c'],43,43,86,108767,2,0,0,1,343
941ef6362ba7b69856b27b52b10a87fb248ec8b8,0,Nathan Marz,2012-01-26 19:23:29-08:00,['b904e96c683ef0281949b7dfb543223702575908'],3,32,35,108802,1,,,,343
d6e352a2c708b63e5ef65032092ac61713fee7cf,0,Nathan Marz,2012-01-26 20:35:49-08:00,['331d20229de450bc0930bb5ac081c4f8d638e34d'],4,4,8,108810,1,,,,343
fa4792325957dbfc71ec31961b4ec9b75fa44909,0,Nathan Marz,2012-01-26 22:49:03-08:00,['d6e352a2c708b63e5ef65032092ac61713fee7cf'],1,1,2,108812,1,,,,343
634706fa08cbd3302df9d6c22ca6c993675c8531,0,Nathan Marz,2012-01-27 00:27:40-08:00,['941ef6362ba7b69856b27b52b10a87fb248ec8b8'],2,0,2,108814,1,,,,343
297ee5a439c8b082ab5ffc0061d657687e1221ad,0,Nathan Marz,2012-01-27 10:29:35-08:00,['634706fa08cbd3302df9d6c22ca6c993675c8531'],124,37,161,108975,12,0,0,0.162162162,345
b1d1f9e0f15a320993e36538d80c070428d3374f,0,Nathan Marz,2012-01-27 10:35:42-08:00,['297ee5a439c8b082ab5ffc0061d657687e1221ad'],5,5,10,108985,1,,,,345
3f911f6c24457afafc4b1985343bc63bd5cf9e7c,0,Nathan Marz,2012-01-27 10:41:04-08:00,['b1d1f9e0f15a320993e36538d80c070428d3374f'],4,3,7,108992,1,,,,345
8795c6fd923f76d81a54622eaba854886b8df66b,0,Nathan Marz,2012-01-27 10:44:16-08:00,['3f911f6c24457afafc4b1985343bc63bd5cf9e7c'],0,8,8,109000,1,1,1,0,345
40595a3641e44904053e00a3056b379f738a6100,0,Nathan Marz,2012-01-27 10:49:43-08:00,['fa4792325957dbfc71ec31961b4ec9b75fa44909'],1,2,3,109003,1,,,,345
a18a51f6b12ef870143d15a2d127207d8429dff9,0,Nathan Marz,2012-01-27 13:51:27-08:00,['8795c6fd923f76d81a54622eaba854886b8df66b'],1,1,2,109005,1,,,,345
6bcd3bb4cbd0652f01f2c28a25619d7f6477e064,0,Nathan Marz,2012-01-27 13:55:35-08:00,['a18a51f6b12ef870143d15a2d127207d8429dff9'],0,2,2,109007,1,,,,345
9c3a4b7614102c8e120a9736d45902f881f0fd13,0,Nathan Marz,2012-01-27 15:58:44-08:00,['6bcd3bb4cbd0652f01f2c28a25619d7f6477e064'],9,31,40,109047,4,0.625,1,0,345
69bad92f2f7aadff2c704279a9b3198eba813a35,0,Nathan Marz,2012-01-27 20:31:00-08:00,['9c3a4b7614102c8e120a9736d45902f881f0fd13'],4,9,13,109060,1,1,1,1,345
bfb22f946cb86be986b0cc6658e01cdffbb02940,0,Nathan Marz,2012-01-27 20:49:06-08:00,['69bad92f2f7aadff2c704279a9b3198eba813a35'],30,39,69,109129,8,1,1,1,346
2a731bc03f79b1734aceea2b2cd0be5c31afad63,0,Nathan Marz,2012-01-28 01:48:42-08:00,['bfb22f946cb86be986b0cc6658e01cdffbb02940'],2,2,4,109133,1,,,,346
8fc8c7c80c84cefdc428f45ca04bbc50cd309704,0,Nathan Marz,2012-01-28 02:32:18-08:00,['4e2dd49ee0c7bdfc78863d648e51d7c99b68f48c'],0,371,371,109504,2,0.43814433,1,0.896907216,348
06d716c08a00fc5e3fb3ecf12e1dbb703756e9c9,0,Dan Harvey,2012-01-28 12:21:51+00:00,['baae324079cf5a62f1c72e29c2196c336b53f070'],1,1,2,109506,1,,0,,348
8e34af78a08d1b2ac31de4d2e1d006a71d9aff79,0,Dan Harvey,2012-01-28 12:31:51+00:00,['baae324079cf5a62f1c72e29c2196c336b53f070'],0,1,1,109507,1,,,,348
b8d043b00723e077501f5615be096226dcdf8c2c,1,Nathan Marz,2012-01-28 15:20:59-08:00,['8fc8c7c80c84cefdc428f45ca04bbc50cd309704'],227,151,378,109885,14,0,0,0.058823529,348
b9f2cbf4f730e7feabb3af6ad8d3b06a0e57e8c5,1,Alexey S. Kachayev,2012-01-29 01:28:37+02:00,['238f1c934e0dcc8e5339376c167fe6326c50b5fb'],36,182,218,110103,1,,,,348
b9fb42d581cc43170f90711f2e895f6d342ac7fd,0,Nathan Marz,2012-01-28 22:38:59-08:00,['b8d043b00723e077501f5615be096226dcdf8c2c'],33,16,49,110152,1,1,0,0,348
eeb7f55d5852f2b11a78ac7ec8009764dd5ba952,0,Nathan Marz,2012-01-28 22:39:17-08:00,['2a731bc03f79b1734aceea2b2cd0be5c31afad63'],6,60,66,110218,2,,,,348
e70fa8c43c31d0840040cb997b14e4e01f8da148,0,Nathan Marz,2012-01-28 22:46:24-08:00,['238f1c934e0dcc8e5339376c167fe6326c50b5fb'],1,1,2,110220,1,,,,348
2ba30d21159de6592165e7d7d68dc74784a48223,0,Nathan Marz,2012-01-28 22:49:09-08:00,"['eeb7f55d5852f2b11a78ac7ec8009764dd5ba952', 'e70fa8c43c31d0840040cb997b14e4e01f8da148']",1,1,2,110222,1,,,,348
288d24a882bf4f87496eeeba01db5a0d4d569eea,0,Nathan Marz,2012-01-28 23:05:08-08:00,['b9fb42d581cc43170f90711f2e895f6d342ac7fd'],3,16,19,110241,2,,,,348
ec6c752274fe954652ae77a7f9645b3a7c8fc5df,0,Nathan Marz,2012-01-28 23:14:38-08:00,['40595a3641e44904053e00a3056b379f738a6100'],1,4,5,110246,1,,,,348
39728a6c5bd7d3c1d9b88a6ff28604513bd8d7bf,0,Nathan Marz,2012-01-28 23:44:29-08:00,['2ba30d21159de6592165e7d7d68dc74784a48223'],0,3,3,110249,1,,,,348
1cfd17e73d2d804c2ca908a8ff8d10663466d369,0,Nathan Marz,2012-01-29 02:03:09-08:00,['39728a6c5bd7d3c1d9b88a6ff28604513bd8d7bf'],1,7,8,110257,1,,,,348
87fc76453397ad4b6ad059e01c56f322875c3e7a,0,Nathan Marz,2012-01-29 02:14:24-08:00,['1cfd17e73d2d804c2ca908a8ff8d10663466d369'],2,8,10,110267,1,,,,348
c0078a3597ec43555fc846f31eb50fcf4514c1e8,0,Nathan Marz,2012-01-29 02:30:42-08:00,['ec6c752274fe954652ae77a7f9645b3a7c8fc5df'],1,1,2,110269,1,,,,348
c6712a1e7265bb72a72ba0e983e60d195071596f,0,haitao.yao,2012-01-30 13:58:35+08:00,['2ba30d21159de6592165e7d7d68dc74784a48223'],3,3,6,110275,2,,,,348
d4e3d3d5301fe2c8a1a9ff81cbd7ec597c14f2cd,0,Nathan Marz,2012-01-31 20:50:08-08:00,['87fc76453397ad4b6ad059e01c56f322875c3e7a'],2,0,2,110277,1,,,,348
526dcc0ae86968a36a90502a77de9ab2a8db1f14,0,Ben Hughes,2012-02-01 16:21:08-05:00,"['8a64e433605c6bc9c4ad5a341afcf13b71dc1888', 'd4e3d3d5301fe2c8a1a9ff81cbd7ec597c14f2cd']",1324,4876,6200,116477,112,,,,348
fa8a26fc55e74400c7abc2cd88b1c54f8fb0c53e,0,Nathan Marz,2012-02-02 15:29:52-08:00,['526dcc0ae86968a36a90502a77de9ab2a8db1f14'],204,30,234,116711,5,0.040816327,0,0.040816327,348
45a62dd2281e82fe5fbe0cb44b2010c93a462206,0,Nathan Marz,2012-02-02 15:32:37-08:00,['fa8a26fc55e74400c7abc2cd88b1c54f8fb0c53e'],0,160,160,116871,1,1,1,1,349
b3c3239135ee3e016978533bbf064003e749b29d,0,Nathan Marz,2012-02-02 16:26:42-08:00,['45a62dd2281e82fe5fbe0cb44b2010c93a462206'],0,1,1,116872,1,,,,349
bcbc1c831ba4fb32de278570edbcbb2e15e9cfad,0,Nathan Marz,2012-02-02 22:53:39-08:00,"['45a62dd2281e82fe5fbe0cb44b2010c93a462206', 'c6712a1e7265bb72a72ba0e983e60d195071596f']",3,3,6,116878,2,,,,349
7013666812f01580b11b46615e370eaf7e3c6f1a,0,Nathan Marz,2012-02-02 23:18:16-08:00,"['b3c3239135ee3e016978533bbf064003e749b29d', 'bcbc1c831ba4fb32de278570edbcbb2e15e9cfad']",3,3,6,116884,2,,,,349
ac2143ddb9dc9e68cf1ca46a45fbfc8234983adc,0,Nathan Marz,2012-02-03 00:39:19-08:00,['c0078a3597ec43555fc846f31eb50fcf4514c1e8'],12,12,24,116908,2,,,,349
5d245da4a426a7eba8b054ad6fa175789fb178c9,0,Nathan Marz,2012-02-03 01:11:13-08:00,['7013666812f01580b11b46615e370eaf7e3c6f1a'],0,1,1,116909,1,,,,349
2708f8b74ee576e60131f10043dc19f2b65f45f3,0,Nathan Marz,2012-02-03 01:35:06-08:00,['ac2143ddb9dc9e68cf1ca46a45fbfc8234983adc'],1,1,2,116911,1,,,,349
7b1eeb1b1a2b4199797416c52e425e5d893f49c7,0,Nathan Marz,2012-02-03 01:35:58-08:00,['c0078a3597ec43555fc846f31eb50fcf4514c1e8'],1,3,4,116915,1,,,,349
9b98f8a1c80632656b2afedeb62912fe35f61bc9,0,Nathan Marz,2012-02-03 03:14:32-08:00,['7b1eeb1b1a2b4199797416c52e425e5d893f49c7'],1,1,2,116917,1,,,,349
b88a8fd874031efdf7fffa55518aa2e8f859705c,0,Nathan Marz,2012-02-03 16:53:35-08:00,"['5d245da4a426a7eba8b054ad6fa175789fb178c9', 'b9f2cbf4f730e7feabb3af6ad8d3b06a0e57e8c5']",35,181,216,117133,1,,,,349
37d004aeb4fed698cc9b69eb757bb540712895d2,1,Nathan Marz,2012-02-03 16:59:50-08:00,['b88a8fd874031efdf7fffa55518aa2e8f859705c'],10,8,18,117151,1,,,,349
b34a753fd7964bed4a64ac94043ebdf944103a11,0,Nathan Marz,2012-02-03 17:03:59-08:00,['37d004aeb4fed698cc9b69eb757bb540712895d2'],0,2,2,117153,1,,,,349
3244f193b52e274c860f0c9c656c7a43c206df88,0,Nathan Marz,2012-02-03 19:14:38-08:00,"['b34a753fd7964bed4a64ac94043ebdf944103a11', 'de3de421a7d0a6ef5bfd8ce5f606dd1e5c9e82c6']",4,19,23,117176,4,,,,349
369a5cc93689e98fac454262a25d54310427e3c1,1,Nathan Marz,2012-02-03 19:46:18-08:00,['3244f193b52e274c860f0c9c656c7a43c206df88'],76,65,141,117317,7,1,1,0,349
643bfcc8a3f54dfcf12d491e2ae27cf97b330023,0,Nathan Marz,2012-02-04 01:42:52-08:00,['369a5cc93689e98fac454262a25d54310427e3c1'],0,1,1,117318,1,,,,349
df6a4186f43d701572fe7779eb51519a851f088a,0,Nathan Marz,2012-02-05 22:34:08-08:00,['643bfcc8a3f54dfcf12d491e2ae27cf97b330023'],21,23,44,117362,5,,,,349
8d3e385b8dde74506147d710bcb83b3a2e79b6f9,1,haitao.yao,2012-02-06 16:34:40+08:00,['9c3a4b7614102c8e120a9736d45902f881f0fd13'],4,51,55,117417,3,0.428571429,1,0.714285714,349
943561f4adcff1fa156a45d47014b3b6f94ca986,0,Nathan Marz,2012-02-06 12:06:45-08:00,"['df6a4186f43d701572fe7779eb51519a851f088a', '06d716c08a00fc5e3fb3ecf12e1dbb703756e9c9']",1,1,2,117419,1,,,,349
16765f6a284b1850a7b43163745bc60adf67fee1,0,Nathan Marz,2012-02-07 01:24:54-08:00,['943561f4adcff1fa156a45d47014b3b6f94ca986'],3,3,6,117425,1,,,,349
559195b1a5e8fd17c214104d5c2da58d73b0eefa,0,Nathan Marz,2012-02-07 19:07:31-08:00,['16765f6a284b1850a7b43163745bc60adf67fee1'],46,131,177,117602,3,1,1,1,350
4959adf53d73a670de7f4952020262e1d6a39158,0,Nathan Marz,2012-02-08 01:31:31-08:00,['559195b1a5e8fd17c214104d5c2da58d73b0eefa'],265,238,503,118105,15,1,1,1,350
70bc597fbe666c5d8f6aad9e0ba2a3efefc439c9,0,Nathan Marz,2012-02-08 02:04:32-08:00,['4959adf53d73a670de7f4952020262e1d6a39158'],5,17,22,118127,2,,,,350
7582faa26c3a1740e7e7dae06175a5a391b45bd7,0,Nathan Marz,2012-02-08 20:46:30-08:00,['70bc597fbe666c5d8f6aad9e0ba2a3efefc439c9'],156,53,209,118336,6,0,0,0.388888889,350
980d0ca053252a6a341bde2cc0004e54af44dd09,0,Nathan Marz,2012-02-08 21:43:28-08:00,['7582faa26c3a1740e7e7dae06175a5a391b45bd7'],26,18,44,118380,2,,,,350
2510ba9df7240bb1d1d5cfcca2522d897fb01434,0,Nathan Marz,2012-02-08 22:02:02-08:00,['980d0ca053252a6a341bde2cc0004e54af44dd09'],3,13,16,118396,1,,,,350
506c8ad941cc0b9eb122b8339636eb921962198c,0,haitao.yao,2012-02-09 17:59:19+08:00,"['8d3e385b8dde74506147d710bcb83b3a2e79b6f9', '980d0ca053252a6a341bde2cc0004e54af44dd09']",652,1213,1865,120261,57,,,,350
9c72b409abd850c8c60e38354f107a77be2f9710,0,Nathan Marz,2012-02-09 10:54:25-08:00,['2510ba9df7240bb1d1d5cfcca2522d897fb01434'],3,2,5,120266,1,,,,350
2e2f6d341544b0607d198483ced974c032482697,0,Nathan Marz,2012-02-09 13:58:13-08:00,['9c72b409abd850c8c60e38354f107a77be2f9710'],0,1,1,120267,1,,,,350
2e81a43a4d6c01adca419cd1d1a9f116d7bdb418,0,Nathan Marz,2012-02-09 14:01:25-08:00,['2e2f6d341544b0607d198483ced974c032482697'],1,1,2,120269,1,,,,350
cef7bee43de50b5b856de6a1c244dde650adc2ca,0,Nathan Marz,2012-02-10 16:30:26-08:00,['2e81a43a4d6c01adca419cd1d1a9f116d7bdb418'],7,26,33,120302,4,1,1,1,350
353f3a0f953e3c2f5b13224b2bef8edf07604d36,0,Nathan Marz,2012-02-11 01:55:43-08:00,['cef7bee43de50b5b856de6a1c244dde650adc2ca'],12,66,78,120380,5,0.117647059,0.882352941,1,351
ae4f11cc2ea050f85d6a55c42fd9e9207a6bdcda,0,Nathan Marz,2012-02-11 02:17:15-08:00,['353f3a0f953e3c2f5b13224b2bef8edf07604d36'],18,15,33,120413,1,1,0,0,351
693571f01d44db9030de0b9a37dbf86e17c58525,0,Nathan Marz,2012-02-11 03:30:27-08:00,['ae4f11cc2ea050f85d6a55c42fd9e9207a6bdcda'],8,159,167,120580,5,1,1,0.785714286,353
3df25ab6c9629b8b8f332c694529de2b208fce78,0,Nathan Marz,2012-02-11 03:49:30-08:00,['693571f01d44db9030de0b9a37dbf86e17c58525'],4,15,19,120599,2,1,1,0,353
b56a813e8ea4ecda04a5f5500dda21df35e0a35f,0,Nathan Marz,2012-02-11 03:49:55-08:00,['3df25ab6c9629b8b8f332c694529de2b208fce78'],3,2,5,120604,1,,,,353
3a5e40f44a5ed76e44cf5a4e3978f55a6de52772,0,Nathan Marz,2012-02-11 15:46:06-08:00,['b56a813e8ea4ecda04a5f5500dda21df35e0a35f'],12,15,27,120631,2,,,,353
8c9de21901727b00b91d21955704bfa15e7aadfe,0,Nathan Marz,2012-02-11 16:48:18-08:00,['3a5e40f44a5ed76e44cf5a4e3978f55a6de52772'],7,14,21,120652,1,,,,353
81074357185251ee61976b7f05aac4f6e61c2231,0,Nathan Marz,2012-02-11 17:44:04-08:00,['9b98f8a1c80632656b2afedeb62912fe35f61bc9'],61,220,281,120933,8,1,1,0.890625,359
fc580e2fe55abd246518469d0790befb1212b475,0,Nathan Marz,2012-02-11 17:49:45-08:00,"['2708f8b74ee576e60131f10043dc19f2b65f45f3', '81074357185251ee61976b7f05aac4f6e61c2231']",67,225,292,121225,9,,,,359
2775dd55342d4a97c38391581aa87655a74d348c,0,Nathan Marz,2012-02-11 19:17:41-08:00,['8c9de21901727b00b91d21955704bfa15e7aadfe'],18,15,33,121258,6,0,0,0,360
0f96d15add499fde4bad155be7d122ab52094fcc,0,Nathan Marz,2012-02-11 19:48:32-08:00,['81074357185251ee61976b7f05aac4f6e61c2231'],7,56,63,121321,4,0.166666667,1,0.3,361
e5009dba156f45314ba9f266b27fe982d8cab0ba,0,Nathan Marz,2012-02-11 19:48:43-08:00,"['fc580e2fe55abd246518469d0790befb1212b475', '0f96d15add499fde4bad155be7d122ab52094fcc']",7,56,63,121384,4,,,,361
3651b494129790705f6e59674e9c5132aa4f39fe,0,Nathan Marz,2012-02-13 00:27:16-08:00,['2775dd55342d4a97c38391581aa87655a74d348c'],0,4,4,121388,1,0,1,0,361
1f736b2763797cc53a74c5bdfba128b6c193c630,0,Nathan Marz,2012-02-13 00:32:18-08:00,['3651b494129790705f6e59674e9c5132aa4f39fe'],0,1,1,121389,1,,,,361
e2d2adec9b29eafb63dd8f8f44c03ae2e9db2984,0,haitao.yao,2012-02-18 22:37:36+08:00,"['506c8ad941cc0b9eb122b8339636eb921962198c', '3651b494129790705f6e59674e9c5132aa4f39fe']",84,336,420,121809,18,,,,361
3428bd744ef8e76aa2498c05be6f6f8633c302e8,1,Haitao Yao,2012-02-19 23:35:08+08:00,['e2d2adec9b29eafb63dd8f8f44c03ae2e9db2984'],5,7,12,121821,1,,,,361
a3be3ca1975c35b3f0a3b63f2d890e8f3bb9223f,1,haitao.yao,2012-02-21 22:09:37+08:00,['3428bd744ef8e76aa2498c05be6f6f8633c302e8'],13,17,30,121851,2,0,1,1,361
0357d95684f959844a0fcfec2429646eb0ef5835,0,haitao.yao,2012-02-21 22:12:07+08:00,['a3be3ca1975c35b3f0a3b63f2d890e8f3bb9223f'],17,17,34,121885,1,,,,361
bf84f2216ac0306935316180078e1fe184e4a53c,0,Nathan Marz,2012-02-22 14:42:23-08:00,['1f736b2763797cc53a74c5bdfba128b6c193c630'],3,8,11,121896,1,,,,361
205c11ace476e7a028574822b8a2a38489bd5199,0,Nathan Marz,2012-02-22 14:47:30-08:00,['bf84f2216ac0306935316180078e1fe184e4a53c'],0,1,1,121897,1,,,,361
94b9f4e386d25ec721c340fc2637994090a9ee50,1,Nathan Marz,2012-02-22 16:56:21-08:00,['205c11ace476e7a028574822b8a2a38489bd5199'],42,37,79,121976,3,,,,361
d8eca4caac749e0cbdf43e5362db4896ad106b75,0,Nathan Marz,2012-02-22 16:59:04-08:00,['94b9f4e386d25ec721c340fc2637994090a9ee50'],1,1,2,121978,1,,,,361
c851f395600ba4ef9b89ff379dcdd1b753f1fa8f,0,Nathan Marz,2012-02-22 17:11:58-08:00,['d8eca4caac749e0cbdf43e5362db4896ad106b75'],11,7,18,121996,1,,,,361
93791b331a19597bda0cf44e206215836c433f7a,0,Nathan Marz,2012-02-22 17:13:46-08:00,['c851f395600ba4ef9b89ff379dcdd1b753f1fa8f'],0,1,1,121997,1,,,,361
f19334e13c7566e86f3ebf370b1828e203a2461b,0,Nathan Marz,2012-02-22 21:50:36-08:00,['288d24a882bf4f87496eeeba01db5a0d4d569eea'],2,2,4,122001,2,,,,361
b10ebde2a514491df60b746234061fbc04e742b2,0,Nathan Marz,2012-02-22 22:41:24-08:00,['93791b331a19597bda0cf44e206215836c433f7a'],9,9,18,122019,1,,,,361
9d6761efb72f372d44e36088b0ddc51a38a00dfa,0,Nathan Marz,2012-02-23 12:49:26-08:00,['b10ebde2a514491df60b746234061fbc04e742b2'],7,12,19,122038,3,1,1,1,361
ac1d3743ae1d79fc130fe2710835df48b915c348,0,Nathan Marz,2012-02-24 13:03:07-08:00,['9d6761efb72f372d44e36088b0ddc51a38a00dfa'],3,10,13,122051,2,,,,361
cc21a6bd313d4d6b817ee94a2979b7f92eb5724c,0,Nathan Marz,2012-02-24 13:08:17-08:00,['ac1d3743ae1d79fc130fe2710835df48b915c348'],1,4,5,122056,1,,,,361
9359ebb44971179422d176dc89959619cb5fae0f,0,Gabriel Grant,2012-02-25 02:28:07-08:00,['cc21a6bd313d4d6b817ee94a2979b7f92eb5724c'],1,1,2,122058,1,,,,361
8ea793778ee333629f49fa46c50d04d3a44842c5,0,Nathan Marz,2012-02-25 19:02:04-08:00,['cc21a6bd313d4d6b817ee94a2979b7f92eb5724c'],1,1,2,122060,1,,,,361
159f41b5064c38d132146de97c31f5ae1f3df231,0,Nathan Marz,2012-02-27 14:52:11-08:00,['f19334e13c7566e86f3ebf370b1828e203a2461b'],1,1,2,122062,1,,,,361
50a021bddbadbe16e064034b43fbb99d09240176,0,Nathan Marz,2012-02-27 14:56:30-08:00,['0f96d15add499fde4bad155be7d122ab52094fcc'],2,2,4,122066,2,,,,361
3ebbf278b0e85bdb4c8fac4ebb9099853b214c74,0,Nathan Marz,2012-02-27 14:57:33-08:00,['50a021bddbadbe16e064034b43fbb99d09240176'],1,1,2,122068,1,,,,361
d281d285eaec66b73c3ef0d2070807aaedc04861,0,Nathan Marz,2012-02-27 15:21:55-08:00,['3ebbf278b0e85bdb4c8fac4ebb9099853b214c74'],1,2,3,122071,1,,,,361
ea405defdb25256119c9560a6452fca3446edb4e,0,Nathan Marz,2012-02-27 15:22:14-08:00,"['e5009dba156f45314ba9f266b27fe982d8cab0ba', 'd281d285eaec66b73c3ef0d2070807aaedc04861']",3,4,7,122078,3,,,,361
b3ff3ad019d57988c4fc0796d2dc99440d8b143f,0,Nathan Marz,2012-02-27 16:19:05-08:00,['8ea793778ee333629f49fa46c50d04d3a44842c5'],1,1,2,122080,1,,,,361
b487a4765ad6e30e28f5ce5ec0aed19e79df69c3,0,Nathan Marz,2012-02-27 16:19:10-08:00,['b3ff3ad019d57988c4fc0796d2dc99440d8b143f'],1,1,2,122082,1,,,,361
62b5817c8b893fa0ca54e19c55edeb799f02ceb2,0,Nathan Marz,2012-02-28 11:33:19-08:00,['b487a4765ad6e30e28f5ce5ec0aed19e79df69c3'],0,1,1,122083,1,,,,361
e54cd99625bc15876a794c6f23eb7671ec3b288e,0,Nathan Marz,2012-02-29 12:25:56-08:00,['159f41b5064c38d132146de97c31f5ae1f3df231'],2,10,12,122095,1,,,,361
17afe9291929579fae714b7b8bcd52cd0038f3e9,0,Nathan Marz,2012-03-01 18:18:34-08:00,"['62b5817c8b893fa0ca54e19c55edeb799f02ceb2', '0357d95684f959844a0fcfec2429646eb0ef5835']",13,66,79,122174,3,,,,361
39e3079aa88d1e3550a346c0cfe1ef137580bba2,0,Nathan Marz,2012-03-01 18:20:22-08:00,['17afe9291929579fae714b7b8bcd52cd0038f3e9'],30,1,31,122205,1,0,0,0.444444444,361
4d4703ceac8a90f38a4130380a8533811b1a3e14,0,Nathan Marz,2012-03-01 18:35:27-08:00,['39e3079aa88d1e3550a346c0cfe1ef137580bba2'],17,26,43,122248,2,1,1,0.714285714,361
896a4830b703e4f832ff91f07a4f946a6a497537,0,Nathan Marz,2012-03-01 18:36:24-08:00,['4d4703ceac8a90f38a4130380a8533811b1a3e14'],0,4,4,122252,1,,,,361
180975eb90cca943ca28d793709b423f10ca078a,0,Nathan Marz,2012-03-01 19:03:37-08:00,['896a4830b703e4f832ff91f07a4f946a6a497537'],3,3,6,122258,1,,,,361
29beadd5983931b230024018bd1dc24183a6a2b5,0,Nathan Marz,2012-03-01 19:44:15-08:00,['180975eb90cca943ca28d793709b423f10ca078a'],0,43,43,122301,3,0.1,0.2,0.9,362
4e52e3d848a2724c36bb8cf97d6340a9252bd3a0,0,Nathan Marz,2012-03-01 19:58:26-08:00,['29beadd5983931b230024018bd1dc24183a6a2b5'],0,2,2,122303,1,,,,362
b5b3a6203de0a409a08b38e32f81b76f36f6ae82,0,Nathan Marz,2012-03-01 19:58:31-08:00,['4e52e3d848a2724c36bb8cf97d6340a9252bd3a0'],0,1,1,122304,1,,,,362
2a0cb9e5fb0bdad93830327dd58cf7ecfac48e3b,1,Nathan Marz,2012-03-01 20:01:33-08:00,['b5b3a6203de0a409a08b38e32f81b76f36f6ae82'],6,10,16,122320,2,,,,362
d1bc264d67190ce7ac3cfde1d1e95871e291e214,0,Travis Wellman,2012-03-02 14:31:32-08:00,['b5b3a6203de0a409a08b38e32f81b76f36f6ae82'],1,5,6,122326,1,1,1,0.333333333,362
a4ca346b0703a8a8c7fc3eb331eb2e8d1e0fef51,0,Nathan Marz,2012-03-03 14:08:34-08:00,"['b5b3a6203de0a409a08b38e32f81b76f36f6ae82', '9359ebb44971179422d176dc89959619cb5fae0f']",1,1,2,122328,1,,,,362
3557c295079009b342aa25b9f9284c1c32263bb1,0,Nathan Marz,2012-03-03 17:06:05-08:00,['a4ca346b0703a8a8c7fc3eb331eb2e8d1e0fef51'],1,2,3,122331,1,,,,362
8bf19c247e72fc6830bbd6b448ba0e6e62aae27f,0,Nathan Marz,2012-03-03 17:06:29-08:00,['3557c295079009b342aa25b9f9284c1c32263bb1'],2,2,4,122335,1,,,,362
1b4e89bc9cd4e3f16f8cbae038fa0336c642c961,0,Nathan Marz,2012-03-03 17:06:44-08:00,"['2a0cb9e5fb0bdad93830327dd58cf7ecfac48e3b', '8bf19c247e72fc6830bbd6b448ba0e6e62aae27f']",4,5,9,122344,2,,,,362
9b3af144847d44c01d69f8f0ccd81eacd4742d7a,0,Nathan Marz,2012-03-03 17:34:35-08:00,['8bf19c247e72fc6830bbd6b448ba0e6e62aae27f'],10,12,22,122366,2,,,,362
439dd82c01a893702b37c37f2811576ae9fc5bb5,0,Nathan Marz,2012-03-03 18:17:29-08:00,['9b3af144847d44c01d69f8f0ccd81eacd4742d7a'],12,10,22,122388,2,,,,362
39ec53e46b2ce2f62309dedb3ceba2f5f76f231b,0,Nathan Marz,2012-03-03 18:21:57-08:00,['439dd82c01a893702b37c37f2811576ae9fc5bb5'],3,3,6,122394,2,,,,362
d20a7a38f8c2c552f2c4bc327f4df5772ab66f37,0,Nathan Marz,2012-03-03 18:22:10-08:00,"['1b4e89bc9cd4e3f16f8cbae038fa0336c642c961', '39ec53e46b2ce2f62309dedb3ceba2f5f76f231b']",3,3,6,122400,2,,,,362
4762dd3e6f46e248eab6b986f92012e7223c012f,0,Nathan Marz,2012-03-03 19:06:56-08:00,['39ec53e46b2ce2f62309dedb3ceba2f5f76f231b'],2,2,4,122404,2,,,,362
8cf23578728fdee421a838965c285d10ffcee722,0,Nathan Marz,2012-03-03 19:07:05-08:00,"['d20a7a38f8c2c552f2c4bc327f4df5772ab66f37', '4762dd3e6f46e248eab6b986f92012e7223c012f']",2,2,4,122408,2,,,,362
35590279c6e7c590b20f3451341125c47194e7c1,0,Nathan Marz,2012-03-03 19:07:18-08:00,['4762dd3e6f46e248eab6b986f92012e7223c012f'],0,3,3,122411,1,,,,362
7401175c52682d89dcfa5bdc08329df644732c73,0,Nathan Marz,2012-03-03 19:50:51-08:00,"['35590279c6e7c590b20f3451341125c47194e7c1', '8cf23578728fdee421a838965c285d10ffcee722']",6,10,16,122427,2,,,,362
c0a8e69a6394344634b855215f137b5147dd4748,1,Nathan Marz,2012-03-03 20:22:36-08:00,['7401175c52682d89dcfa5bdc08329df644732c73'],3,18,21,122448,1,,,,362
61cc1990d8e2416afb82e9d00662944ea08247e2,0,Nathan Marz,2012-03-03 20:33:06-08:00,['c0a8e69a6394344634b855215f137b5147dd4748'],0,2,2,122450,1,,,,362
02cda16b0a8724d86956072fa08e4a723affcd88,0,Nathan Marz,2012-03-03 20:35:22-08:00,"['61cc1990d8e2416afb82e9d00662944ea08247e2', 'd1bc264d67190ce7ac3cfde1d1e95871e291e214']",1,5,6,122456,1,,,,362
93e731d1bcb08fffbf60b105c4a88af3d0b720b7,0,Nathan Marz,2012-03-03 20:43:31-08:00,['02cda16b0a8724d86956072fa08e4a723affcd88'],1,3,4,122460,2,,,,362
e8dfbf37d10124d57f8af9ea1168877c558e5ecb,0,P. Taylor Goetz,2012-03-06 16:21:01-05:00,['b17801b5a4769113818a05879aba059216e3fad0'],10,36,46,122506,2,,,,362
e04706251aba12055ba90eaa6ee29969b42f4307,0,P. Taylor Goetz,2012-03-06 16:23:53-05:00,['e8dfbf37d10124d57f8af9ea1168877c558e5ecb'],3,2,5,122511,1,,,,362
770a756fb855dde3e22c48dadb6da26eafc9708b,0,P. Taylor Goetz,2012-03-06 16:23:58-05:00,['e04706251aba12055ba90eaa6ee29969b42f4307'],1,1,2,122513,1,,,,362
358608254ea6c1398319455f7e4673684961ee8b,0,Nathan Marz,2012-03-07 15:48:30-08:00,"['93e731d1bcb08fffbf60b105c4a88af3d0b720b7', '8e34af78a08d1b2ac31de4d2e1d006a71d9aff79']",0,1,1,122514,1,,,,362
d4d271e9f54ef04099c8714c33202cd7ac556258,0,Nathan Marz,2012-03-08 16:32:40-08:00,['93e731d1bcb08fffbf60b105c4a88af3d0b720b7'],1,154,155,122669,9,1,1,0.68,370
155ea6d0dae858bf76482d438a656761da6a701c,0,Nathan Marz,2012-03-08 16:45:39-08:00,['d4d271e9f54ef04099c8714c33202cd7ac556258'],19,15,34,122703,1,,,,370
59f1f4f1501e8a09b976e087e3ce70a546d2caec,0,Nathan Marz,2012-03-08 17:06:05-08:00,['155ea6d0dae858bf76482d438a656761da6a701c'],59,43,102,122805,6,0,0,0.846153846,371
a8d3d442bebd3a843b2d26047a27a5e04c48c903,0,Nathan Marz,2012-03-08 18:46:35-08:00,['59f1f4f1501e8a09b976e087e3ce70a546d2caec'],11,52,63,122868,3,,,,371
8283fba12859c819375489b58467c8d232f1e2a2,0,Nathan Marz,2012-03-08 18:47:10-08:00,"['a8d3d442bebd3a843b2d26047a27a5e04c48c903', '358608254ea6c1398319455f7e4673684961ee8b']",0,1,1,122869,1,,,,371
2f148af607b6d7c88725997f10453fd136aa5dae,0,Nathan Marz,2012-03-08 18:49:13-08:00,['8283fba12859c819375489b58467c8d232f1e2a2'],0,1,1,122870,1,,,,371
eccd827b1cadfff380639378e0e7497a2b6197f8,0,Nathan Marz,2012-03-08 19:05:54-08:00,['2f148af607b6d7c88725997f10453fd136aa5dae'],0,10,10,122880,2,,,,371
e273f9984ecd69ea112b9300e5dd0b4f46cfd629,0,Nathan Marz,2012-03-08 19:06:46-08:00,['eccd827b1cadfff380639378e0e7497a2b6197f8'],1,1,2,122882,1,,,,371
3c461b1772b8a31f853653c01a10a935252a11fc,0,Nathan Marz,2012-03-08 19:06:51-08:00,['e273f9984ecd69ea112b9300e5dd0b4f46cfd629'],0,1,1,122883,1,,,,371
9d1f9de1b21db90301bd2dc478211c1c6a909afe,0,Nathan Marz,2012-03-08 23:23:31-08:00,['3c461b1772b8a31f853653c01a10a935252a11fc'],1,2,3,122886,1,,,,371
89d30842c7ec5d439c5cfc6ae2031498011d15e0,0,Nathan Marz,2012-03-08 23:55:41-08:00,['9d1f9de1b21db90301bd2dc478211c1c6a909afe'],9,9,18,122904,5,,,,371
14a6f1a8cc4435fed96e233ae238632e4c11d019,0,Nathan Marz,2012-03-08 23:55:50-08:00,['89d30842c7ec5d439c5cfc6ae2031498011d15e0'],1,0,1,122905,1,,,,371
06a3fa9ea6e5c0f7a7b12b601bb1951269bf5b2b,0,Nathan Marz,2012-03-09 00:35:50-08:00,['14a6f1a8cc4435fed96e233ae238632e4c11d019'],2,8,10,122915,2,,,,371
d0bfbe1332b1b22bfc5bc67bf335f524f957daf6,0,Nathan Marz,2012-03-09 00:36:19-08:00,['06a3fa9ea6e5c0f7a7b12b601bb1951269bf5b2b'],7,13,20,122935,7,0,1,0,371
c54ec0ef8880cfea00f59c04cf6e3286a508f3f2,1,Nathan Marz,2012-03-09 00:52:08-08:00,['d0bfbe1332b1b22bfc5bc67bf335f524f957daf6'],4,18,22,122957,5,1,1,1,371
d8ffcc254db8e53ff06eb309e20b37d4dd41cd6a,0,Nathan Marz,2012-03-09 01:03:51-08:00,['c54ec0ef8880cfea00f59c04cf6e3286a508f3f2'],3,3,6,122963,1,,,,371
766a29940759f1b6b8738d3d63e19b77fc169da2,0,Nathan Marz,2012-03-10 13:21:02-08:00,['d8ffcc254db8e53ff06eb309e20b37d4dd41cd6a'],0,1,1,122964,1,,,,371
da337be74a8b031a3acba524e1a62ed1ae99c3c8,0,Nathan Marz,2012-03-11 19:45:08-07:00,['766a29940759f1b6b8738d3d63e19b77fc169da2'],0,14,14,122978,4,1,1,1,371
d8675c2fdbb15aa6d3422ef540bf76f2311030c4,0,Nathan Marz,2012-03-11 19:51:35-07:00,['da337be74a8b031a3acba524e1a62ed1ae99c3c8'],0,1,1,122979,1,,,,371
1b4939c70759f0a88d125a61e22f189a10eaf039,0,Nathan Marz,2012-03-11 21:34:14-07:00,['d8675c2fdbb15aa6d3422ef540bf76f2311030c4'],2,12,14,122993,1,1,1,0,371
2de2a8edcc6fd458c395a581edfe2956395c3bf6,0,Nathan Marz,2012-03-11 21:34:50-07:00,['1b4939c70759f0a88d125a61e22f189a10eaf039'],0,1,1,122994,1,,,,371
fdbcf7fc78438874fe5e139c6278899c7f1297e6,1,Thomas Jack,2012-03-14 04:20:26-05:00,['2de2a8edcc6fd458c395a581edfe2956395c3bf6'],118,246,364,123358,4,0.763888889,0.763888889,0.430555556,372
8d8194d62100acbc3e9eb6fb907b49d03f13ba6e,0,Thomas Jack,2012-03-14 04:20:28-05:00,['fdbcf7fc78438874fe5e139c6278899c7f1297e6'],5,16,21,123379,3,,,1,372
d5f16d52ce5159ac56258fc8e6ec113839b1d9b0,0,Thomas Jack,2012-03-14 04:20:28-05:00,['8d8194d62100acbc3e9eb6fb907b49d03f13ba6e'],31,224,255,123634,9,0.661654135,0.661654135,0.827067669,375
554c49e19f7f63f65dbe474c7f062f40ac56064f,0,Thomas Jack,2012-03-14 04:20:28-05:00,['d5f16d52ce5159ac56258fc8e6ec113839b1d9b0'],6,6,12,123646,1,,,,375
43a8df18f9d380fc9e7eb1d93aeaefb3850c148e,0,Nathan Marz,2012-03-15 17:41:29-07:00,['2de2a8edcc6fd458c395a581edfe2956395c3bf6'],4,21,25,123671,7,0.833333333,1,0.833333333,375
7a9ff26c235aec83a26f7544cb986f0298a955ee,0,Nathan Marz,2012-03-15 17:42:03-07:00,['43a8df18f9d380fc9e7eb1d93aeaefb3850c148e'],0,1,1,123672,1,,,,375
a94a6cf7d406119322dae22e34ad0b2225e48625,0,millerjam,2012-03-16 23:27:40-04:00,['e54cd99625bc15876a794c6f23eb7671ec3b288e'],1,1,2,123674,1,,,,375
ff4a148e8c8a64683a0e424b6b69bd9372b29067,0,Michael Cetrulo,2012-03-17 21:42:22-03:00,['2de2a8edcc6fd458c395a581edfe2956395c3bf6'],0,40,40,123714,1,,,,376
66275c1fa91dc53c3af9a96128f87bf2415596e3,0,Michael Cetrulo,2012-03-17 21:42:23-03:00,['ff4a148e8c8a64683a0e424b6b69bd9372b29067'],2,9,11,123725,1,1,1,1,376
bf366f1448fc88ce8b195195d2a3996043481e47,0,Nathan Marz,2012-03-18 14:25:19-07:00,"['e54cd99625bc15876a794c6f23eb7671ec3b288e', 'a94a6cf7d406119322dae22e34ad0b2225e48625']",1,1,2,123727,1,,,,376
33c9cfdfd06ef3894f678aa53b5ad9e212d3cf9a,0,Nathan Marz,2012-03-18 14:33:40-07:00,"['7a9ff26c235aec83a26f7544cb986f0298a955ee', '66275c1fa91dc53c3af9a96128f87bf2415596e3']",2,49,51,123778,2,,,,376
c1d93da8f3e6533a6bff6d3ce0ef252c27b31ab1,0,Nathan Marz,2012-03-18 14:41:56-07:00,['33c9cfdfd06ef3894f678aa53b5ad9e212d3cf9a'],0,2,2,123780,2,,,,376
adef0a8b5ff513a57d801378a5b83c11f7b47a24,0,Nathan Marz,2012-03-18 14:42:37-07:00,['c1d93da8f3e6533a6bff6d3ce0ef252c27b31ab1'],1,1,2,123782,1,,,,376
d5cc24fed6695bcafc8c89edcc7cb02a73e8ed29,0,Kasper Madsen,2012-03-19 09:37:27+01:00,['2de2a8edcc6fd458c395a581edfe2956395c3bf6'],0,23,23,123805,2,,,,376
5107e10e6d4b986d5a395846ef78ec3994733a60,0,Nathan Marz,2012-03-21 00:31:43-07:00,['adef0a8b5ff513a57d801378a5b83c11f7b47a24'],20,3,23,123828,1,0,0,0,376
71f7c5b1b80f2dc09505b3a78bba42d9fd03b0af,0,Nathan Marz,2012-03-21 00:32:20-07:00,['5107e10e6d4b986d5a395846ef78ec3994733a60'],0,1,1,123829,1,,,,376
71e7e21594f707128f21bdb9abd64c2f45b43be3,0,Nathan Marz,2012-03-21 04:18:54-07:00,['71f7c5b1b80f2dc09505b3a78bba42d9fd03b0af'],68,28,96,123925,3,,,,376
b26070c39b8b2d10cb0150639d9121218c162f51,0,Nathan Marz,2012-03-21 04:24:42-07:00,['71e7e21594f707128f21bdb9abd64c2f45b43be3'],19,2,21,123946,2,,,,376
3343cc82fd2c269ab1e2924493d3af678056360a,0,Nathan Marz,2012-03-21 04:29:32-07:00,['b26070c39b8b2d10cb0150639d9121218c162f51'],0,1,1,123947,1,,,,376
e7b00ef53b8df27020e94bd5450644ec67456806,0,Nathan Marz,2012-03-21 04:39:54-07:00,"['3343cc82fd2c269ab1e2924493d3af678056360a', '554c49e19f7f63f65dbe474c7f062f40ac56064f']",154,486,640,124587,13,,,,376
fc05f1e097fc0d2d24f5b894b12850d88622eaf4,1,Nathan Marz,2012-03-21 04:59:09-07:00,['e7b00ef53b8df27020e94bd5450644ec67456806'],14,13,27,124614,3,0,0,0,376
1b2ecb1da46ac7ec167509876bd99ebf26741649,0,Nathan Marz,2012-03-21 05:11:16-07:00,['fc05f1e097fc0d2d24f5b894b12850d88622eaf4'],4,5,9,124623,1,,,,376
4a7335d214de759d3d3127411f273081ea8a55eb,0,Nathan Marz,2012-03-21 05:13:05-07:00,['1b2ecb1da46ac7ec167509876bd99ebf26741649'],1,3,4,124627,1,,,,376
55847dafb112ea19c59c4888f1da7ec6c2c49ed5,0,Nathan Marz,2012-03-21 05:14:26-07:00,['4a7335d214de759d3d3127411f273081ea8a55eb'],2,3,5,124632,2,,,,376
0aa8fc5e671e4899f1515ba9d3a06c057ea5c29a,0,Nathan Marz,2012-03-21 05:47:58-07:00,['55847dafb112ea19c59c4888f1da7ec6c2c49ed5'],532,536,1068,125700,5,1,1,1,376
0730a6e834a5531b47f35bf54900a086f4a8af00,0,Nathan Marz,2012-03-21 15:07:00-07:00,['0aa8fc5e671e4899f1515ba9d3a06c057ea5c29a'],3,1,4,125704,2,0,0,0,376
f7e789d01cdbe5d2eaa92986598773ff008e7f17,0,Nathan Marz,2012-03-21 15:10:50-07:00,['0730a6e834a5531b47f35bf54900a086f4a8af00'],513,513,1026,126730,1,,,,376
541c59dabc003511fb2265d6ed51ca9d195a9418,0,Nathan Marz,2012-03-21 15:13:08-07:00,['f7e789d01cdbe5d2eaa92986598773ff008e7f17'],0,2,2,126732,2,,,,376
a3431a97ba3d9f5176d758c75829bc417b53c119,0,Thomas Jack,2012-03-21 17:51:42-05:00,['541c59dabc003511fb2265d6ed51ca9d195a9418'],33,27,60,126792,4,0,0,0,376
b4b4b16e7c53795c3996f31d684325ebcce9206c,1,Nathan Marz,2012-03-22 02:09:23-07:00,['541c59dabc003511fb2265d6ed51ca9d195a9418'],18,78,96,126888,9,1,1,1,376
ba715896254b941f8704334bc62d89581d97163c,0,Nathan Marz,2012-03-22 02:10:05-07:00,['b4b4b16e7c53795c3996f31d684325ebcce9206c'],0,1,1,126889,1,,,,376
6b1384b8c584df639fd6b5ac25627ee9a3b1bfd6,0,Nathan Marz,2012-03-22 21:25:03-07:00,['e54cd99625bc15876a794c6f23eb7671ec3b288e'],2,2,4,126893,1,,,,376
99c2fceb4195db8eb6ab3469c195a18f480b9681,0,Nathan Marz,2012-03-22 21:25:15-07:00,"['6b1384b8c584df639fd6b5ac25627ee9a3b1bfd6', 'bf366f1448fc88ce8b195195d2a3996043481e47']",1,1,2,126895,1,,,,376
1b12455403356937509279fc68f750ae95a4704b,0,Nathan Marz,2012-03-22 21:44:08-07:00,"['ba715896254b941f8704334bc62d89581d97163c', 'd5cc24fed6695bcafc8c89edcc7cb02a73e8ed29']",0,23,23,126918,2,,,,376
635b483f48e2a6ff4cfdb68a10ced817cf8bdda1,0,Nathan Marz,2012-03-22 21:53:04-07:00,['1b12455403356937509279fc68f750ae95a4704b'],16,26,42,126960,2,,,,376
156560db5cbc376709324b32f4d1d7dd022d59bf,0,Nathan Marz,2012-03-22 21:59:18-07:00,['635b483f48e2a6ff4cfdb68a10ced817cf8bdda1'],0,2,2,126962,1,,,,376
5ab6711b71f185e78f2b4677e548754cf3c1d8aa,0,Nathan Marz,2012-03-22 23:47:10-07:00,"['156560db5cbc376709324b32f4d1d7dd022d59bf', 'a3431a97ba3d9f5176d758c75829bc417b53c119']",33,27,60,127022,4,,,,376
195ddafc811833f7dd75ec374989d12db84b381f,0,Nathan Marz,2012-03-22 23:54:43-07:00,['5ab6711b71f185e78f2b4677e548754cf3c1d8aa'],0,1,1,127023,1,,,,376
438a8581e3fa1b32f0595801dc7a3bd94154b840,1,Nathan Marz,2012-03-27 23:49:22-07:00,['195ddafc811833f7dd75ec374989d12db84b381f'],47,162,209,127232,12,0.424242424,0.5,0.787878788,376
4f63ad5ad35bcd9c08846b9c24cc39a061df8471,0,Nathan Marz,2012-03-27 23:53:15-07:00,['438a8581e3fa1b32f0595801dc7a3bd94154b840'],0,68,68,127300,5,1,1,1,376
6cff057ea69f98094d7957777ef22e759db86b13,0,Nathan Marz,2012-03-27 23:55:41-07:00,['4f63ad5ad35bcd9c08846b9c24cc39a061df8471'],1,29,30,127330,2,1,1,1,376
6e73f34968a3c43276018b2f43a9f484e07037e7,0,Nathan Marz,2012-03-27 23:58:23-07:00,['6cff057ea69f98094d7957777ef22e759db86b13'],0,3,3,127333,1,,,,376
b699f0cfdea40891fea74ac83953304d37ea4ba2,0,Nathan Marz,2012-03-28 00:23:38-07:00,['6e73f34968a3c43276018b2f43a9f484e07037e7'],4,53,57,127390,10,1,1,1,376
7ae40de6d8708fb11fe142fa2a3eb12f1be9a309,0,Nathan Marz,2012-03-28 00:36:30-07:00,['b699f0cfdea40891fea74ac83953304d37ea4ba2'],5,15,20,127410,3,0.75,0.75,1,376
1ebe0b2637f1510e18d66085f68c5389d83bfb23,0,Nathan Marz,2012-03-28 03:23:15-07:00,['7ae40de6d8708fb11fe142fa2a3eb12f1be9a309'],2,5,7,127417,1,,,,376
39fd9f04808a1ef915883259e4623ae299e21699,0,Thomas Jack,2012-03-28 23:18:24-05:00,['1ebe0b2637f1510e18d66085f68c5389d83bfb23'],35,29,64,127481,4,0,1,0,376
b76c41b58a1bce5abb59a8814f9ff11699420bb1,1,Thomas Jack,2012-03-28 23:18:54-05:00,['39fd9f04808a1ef915883259e4623ae299e21699'],62,177,239,127720,5,0.771084337,0.771084337,1,378
a71b3024cdf326e6166114d739c9f6413564fc28,0,Thomas Jack,2012-03-29 00:26:20-05:00,['b76c41b58a1bce5abb59a8814f9ff11699420bb1'],11,4,15,127735,3,1,0,0,378
e797049dffaf239177e97f7ee14af66ce24cc7ce,1,Nathan Marz,2012-03-29 15:31:05-07:00,['a71b3024cdf326e6166114d739c9f6413564fc28'],6,20,26,127761,1,1,1,1,378
c1b215a077127704b7f06a6533cbd4443d0c8b25,0,Nathan Marz,2012-03-30 00:28:00-07:00,['99c2fceb4195db8eb6ab3469c195a18f480b9681'],0,2,2,127763,1,,,,378
110d451b480827fd12c92b3264bbfba67f21250b,1,Nathan Marz,2012-03-30 00:59:45-07:00,['e797049dffaf239177e97f7ee14af66ce24cc7ce'],3,2,5,127768,1,,,,378
6fbc06d4e09b876a28122458123c42a492ceab09,0,Nathan Marz,2012-03-30 01:04:13-07:00,['110d451b480827fd12c92b3264bbfba67f21250b'],161,195,356,128124,2,1,1,0,379
718cfa76c2d7156cbf2ddbc590dd8f7681878aac,0,tylerbenson,2012-03-30 15:59:50-07:00,['770a756fb855dde3e22c48dadb6da26eafc9708b'],1,1,2,128126,1,,,,379
04c52855db7db019755436fbccc46d3f186f8c79,0,P. Taylor Goetz,2012-03-31 21:39:44-07:00,"['770a756fb855dde3e22c48dadb6da26eafc9708b', '718cfa76c2d7156cbf2ddbc590dd8f7681878aac']",1,1,2,128128,1,,,,379
40e092dda0e7affe89c00552bc138a251f095dc0,0,Nathan Marz,2012-04-01 22:55:44-07:00,['6fbc06d4e09b876a28122458123c42a492ceab09'],10,3,13,128141,1,,,,379
b2b7f2a7261febd06fcdda1d3977d655c0758553,0,Nathan Marz,2012-04-01 23:37:20-07:00,['40e092dda0e7affe89c00552bc138a251f095dc0'],1,27,28,128169,4,,,,382
e4f477e0ac11959c5a8a1f072368000c33876f4a,0,Nathan Marz,2012-04-02 00:48:09-07:00,['b2b7f2a7261febd06fcdda1d3977d655c0758553'],12,80,92,128261,6,1,1,0.821428571,385
297a750bcee3d1fbebeb36620a32a50d2ba6d591,0,P. Taylor Goetz,2012-04-02 15:47:50-04:00,['04c52855db7db019755436fbccc46d3f186f8c79'],0,9,9,128270,1,,,,385
75775172583ba58266db2f2eadaffc39ba05e2c2,0,Nathan Marz,2012-04-02 12:52:22-07:00,['e4f477e0ac11959c5a8a1f072368000c33876f4a'],0,1,1,128271,1,,,,385
c1b8943e525b08afd7c0e13e61daa649d6b989ee,0,Nathan Marz,2012-04-02 12:52:48-07:00,['40e092dda0e7affe89c00552bc138a251f095dc0'],1,1,2,128273,1,,,,385
96d442dc9ad680c6e34aed4b09a79b6e402c0f62,0,Nathan Marz,2012-04-02 13:05:06-07:00,['d281d285eaec66b73c3ef0d2070807aaedc04861'],0,19,19,128292,2,1,1,1,385
f4c0886a424ce730ef8553f3bd5271bf3637ac91,0,Nathan Marz,2012-04-02 13:05:22-07:00,['96d442dc9ad680c6e34aed4b09a79b6e402c0f62'],2,2,4,128296,1,,,,385
e49662519c3e697845db33c7c535df2095fc13f4,0,Nathan Marz,2012-04-02 13:06:44-07:00,['ea405defdb25256119c9560a6452fca3446edb4e'],0,19,19,128315,2,1,1,1,385
c1e5112d7459b890bc70816e3a26a98b37f4e72a,0,Nathan Marz,2012-04-02 13:08:07-07:00,['e49662519c3e697845db33c7c535df2095fc13f4'],2,2,4,128319,1,,,,385
7bbfa3764b07fa7471e268a4648edb7036d3ddb9,0,Nathan Marz,2012-04-02 13:13:33-07:00,['c1b8943e525b08afd7c0e13e61daa649d6b989ee'],2,2,4,128323,1,,,,385
f4884a719dbacab0a46ee51cdde10a2bd95e006e,0,Nathan Marz,2012-04-02 13:32:09-07:00,['7bbfa3764b07fa7471e268a4648edb7036d3ddb9'],1,3,4,128327,2,,,,385
d3269be3ac4028d2dc92cf1d177f5f87c7d79ca2,0,Soren Macbeth,2012-04-02 15:52:25-07:00,"['f597bb120ff8fafc5d5df48e92fb01cb0eea0aa3', 'c1b8943e525b08afd7c0e13e61daa649d6b989ee']",9583,25755,35338,163665,240,,,,385
cf5fc872e43f4481a2844d9300067a0743554756,0,Soren Macbeth,2012-04-02 17:14:34-07:00,['d3269be3ac4028d2dc92cf1d177f5f87c7d79ca2'],1,1,2,163667,1,,,,385
d22737a0f3ad7c301ae9623f857f95c9a5534891,0,Nathan Marz,2012-04-02 22:12:36-07:00,['75775172583ba58266db2f2eadaffc39ba05e2c2'],0,1,1,163668,1,,,,385
e712c458d98de5d332726da697f89d29d35a233a,0,Nathan Marz,2012-04-02 22:12:42-07:00,['f4884a719dbacab0a46ee51cdde10a2bd95e006e'],1,1,2,163670,1,,,,385
3f3ce816189dba6d8cc51f6a296aec4c5b4fa1aa,0,Nathan Marz,2012-04-03 00:11:27-07:00,['d22737a0f3ad7c301ae9623f857f95c9a5534891'],9,7,16,163686,2,,,,385
b7699f0b28420d7c3b79b07e03d9385ca0ce4f9e,0,Nathan Marz,2012-04-03 00:18:01-07:00,"['3f3ce816189dba6d8cc51f6a296aec4c5b4fa1aa', 'e712c458d98de5d332726da697f89d29d35a233a']",4,6,10,163696,4,,,,385
96f881507f04258ca35d5faf61f517e4b78eca8e,0,Nathan Marz,2012-04-03 00:42:13-07:00,['b7699f0b28420d7c3b79b07e03d9385ca0ce4f9e'],0,6,6,163702,1,1,1,1,385
c6f9629a7e9f4c2752c1ff62f37c8c476242cf35,0,Nathan Marz,2012-04-03 01:37:12-07:00,['96f881507f04258ca35d5faf61f517e4b78eca8e'],4,11,15,163717,2,,,,385
c0118e3e32f2e5e0477cf27a0566b2df37750a71,0,Nathan Marz,2012-04-03 14:20:15-07:00,['c1b215a077127704b7f06a6533cbd4443d0c8b25'],87,219,306,164023,3,0.663551402,0.663551402,1,385
21a6f851400ef3d1607a9b28d6ff961c8c9710df,0,Nathan Marz,2012-04-03 14:47:19-07:00,['e712c458d98de5d332726da697f89d29d35a233a'],4,3,7,164030,1,,,,385
0e0497ce0f4e7427dc84fb154080f9bb8b41b44d,0,Nathan Marz,2012-04-03 15:00:48-07:00,['21a6f851400ef3d1607a9b28d6ff961c8c9710df'],0,5,5,164035,1,,,,385
fa17af879271caa688b728b69c953ed1044794aa,0,Nathan Marz,2012-04-03 15:02:54-07:00,['0e0497ce0f4e7427dc84fb154080f9bb8b41b44d'],0,2,2,164037,1,,,,385
ce554e831b5e0121a6cf5e3d3787b42772a8a931,0,Nathan Marz,2012-04-03 15:20:17-07:00,['c6f9629a7e9f4c2752c1ff62f37c8c476242cf35'],6,6,12,164049,3,,,,385
be97d0959243a35b6dca5c902b27fd99308317a3,0,Nathan Marz,2012-04-03 17:10:47-07:00,['ce554e831b5e0121a6cf5e3d3787b42772a8a931'],1,21,22,164071,2,1,1,0.642857143,385
e988ed4cf269bacb1c6dfdc10eb545f329f7eaf1,0,Nathan Marz,2012-04-03 17:12:29-07:00,['fa17af879271caa688b728b69c953ed1044794aa'],0,5,5,164076,2,1,1,1,385
da21734051e2fb743216d0249e58dc84a4f26e22,0,Nathan Marz,2012-04-03 17:13:43-07:00,['e988ed4cf269bacb1c6dfdc10eb545f329f7eaf1'],1,8,9,164085,2,1,1,1,385
62a6e60cbef5ca93246054872e64803f5d6ba43e,0,Nathan Marz,2012-04-03 17:14:15-07:00,['da21734051e2fb743216d0249e58dc84a4f26e22'],0,2,2,164087,1,,,,385
aad9669643d5ba8552a2d5b62982c8f31d6471cd,1,Nathan Marz,2012-04-04 00:09:09-07:00,['be97d0959243a35b6dca5c902b27fd99308317a3'],12,65,77,164164,6,1,1,1,385
0f474f950a68556183885045acb85ce969f10440,0,Nathan Marz,2012-04-04 00:09:36-07:00,['aad9669643d5ba8552a2d5b62982c8f31d6471cd'],1,1,2,164166,1,,,,385
2a882a9833d6ee794fe4e277c0d72bba008282fe,1,Nathan Marz,2012-04-04 00:57:57-07:00,['0f474f950a68556183885045acb85ce969f10440'],31,69,100,164266,5,0,0,0.625,385
2c7626cab17ca141c1b79d9bdb00704bfd231342,0,Nathan Marz,2012-04-04 02:45:58-07:00,['2a882a9833d6ee794fe4e277c0d72bba008282fe'],7,6,13,164279,2,,,,385
4052d1608c96bc28e1a5603a77d5a25440b4c4b0,0,James Xu,2012-04-04 23:35:03+08:00,['62a6e60cbef5ca93246054872e64803f5d6ba43e'],2,13,15,164294,1,,,,385
77e295157abdc400d64a81f23a69a1c52cd32ed9,1,James Xu,2012-04-05 02:29:22+08:00,['62a6e60cbef5ca93246054872e64803f5d6ba43e'],1,36,37,164331,2,,,,386
a2512e938b4fe006cf1bfc815a60ada1c68e4a47,0,Nathan Marz,2012-04-04 16:14:51-07:00,['77e295157abdc400d64a81f23a69a1c52cd32ed9'],2,2,4,164335,1,,,,386
df45a8dce1cbb78cd78475b608482186e99573cf,0,Nathan Marz,2012-04-04 16:16:19-07:00,"['a2512e938b4fe006cf1bfc815a60ada1c68e4a47', '4052d1608c96bc28e1a5603a77d5a25440b4c4b0']",2,13,15,164350,1,,,,386
daf54a7a62f7b5b162ffa81fc08031d8075103ad,0,Nathan Marz,2012-04-04 16:20:42-07:00,['df45a8dce1cbb78cd78475b608482186e99573cf'],1,1,2,164352,1,,,,386
804aab1e9787267263efebede9c3545d0feda391,0,Nathan Marz,2012-04-04 16:24:53-07:00,['daf54a7a62f7b5b162ffa81fc08031d8075103ad'],0,1,1,164353,1,,,,386
7139e179a39e7dba72d11adb996ea20ca6905db1,0,Nathan Marz,2012-04-04 16:25:53-07:00,['804aab1e9787267263efebede9c3545d0feda391'],0,2,2,164355,1,,,,386
d5376e5e8bf5c4dc9dd2ceb1a73cd8323aaea40c,0,Nathan Marz,2012-04-04 16:45:07-07:00,['2c7626cab17ca141c1b79d9bdb00704bfd231342'],4,9,13,164368,1,,,,386
d74ae4367e7e7204df298d7918b1f2a277b9da67,0,Nathan Marz,2012-04-04 17:17:47-07:00,['d5376e5e8bf5c4dc9dd2ceb1a73cd8323aaea40c'],11,11,22,164390,5,,,,386
ab26d7a9cef04361b24eb2fd8bf7b027986a4e35,0,Nathan Marz,2012-04-04 17:19:28-07:00,['7139e179a39e7dba72d11adb996ea20ca6905db1'],1,1,2,164392,1,,,,386
49c839369926fdd703db38278a59ec8084869716,1,Nathan Marz,2012-04-04 19:01:22-07:00,['d74ae4367e7e7204df298d7918b1f2a277b9da67'],4,4,8,164400,1,,,,386
c6058e6078f4ffe3271bf8119f216f7de54a24e5,0,James Xu,2012-04-06 17:46:30+08:00,['ab26d7a9cef04361b24eb2fd8bf7b027986a4e35'],2,5,7,164407,1,,,,386
d1157e6ac0ae5b2be1ee26713265eae204f4ac23,0,Nathan Marz,2012-04-08 20:29:01-04:00,['f4c0886a424ce730ef8553f3bd5271bf3637ac91'],1,1,2,164409,1,,,,386
f6d464f2a02cf838e1758812239432d562683bed,0,Nathan Marz,2012-04-08 20:30:25-04:00,['c1e5112d7459b890bc70816e3a26a98b37f4e72a'],1,1,2,164411,1,,,,386
9030d84b6d758a98e6189d05086e32124beda8b1,0,Nathan Marz,2012-04-08 22:07:21-04:00,['ab26d7a9cef04361b24eb2fd8bf7b027986a4e35'],0,1,1,164412,1,,,,386
62db0636ced2acc1cf0143859c249dd364bc394a,1,Nathan Marz,2012-04-08 22:07:49-04:00,['49c839369926fdd703db38278a59ec8084869716'],1,25,26,164438,3,,,,386
8581ccef4bf85dcd4bbbb80f509a813b9dc3718c,0,James Xu,2012-04-09 20:56:47+08:00,['ab26d7a9cef04361b24eb2fd8bf7b027986a4e35'],1,12,13,164451,2,,,,386
3ee0a8186d4c215ff2e25098bbf9afc45df61c8b,0,Paul O'Fallon,2012-04-09 17:26:25-03:00,['c0118e3e32f2e5e0477cf27a0566b2df37750a71'],1,1,2,164453,1,,,,386
691cdda0ae45304b603aeb97169a08d52757fa5f,0,Nathan Marz,2012-04-09 13:39:57-07:00,"['c0118e3e32f2e5e0477cf27a0566b2df37750a71', '3ee0a8186d4c215ff2e25098bbf9afc45df61c8b']",1,1,2,164455,1,,,,386
203c48445f33b9bcbdbc377f3e6311babca100fd,0,Andrew Otto,2012-04-11 12:42:20-04:00,['691cdda0ae45304b603aeb97169a08d52757fa5f'],1,1,2,164457,1,,,,386
754ce8b22266079179c9f1275c11fd8364c1b510,0,Nathan Marz,2012-04-11 09:52:45-07:00,"['691cdda0ae45304b603aeb97169a08d52757fa5f', '203c48445f33b9bcbdbc377f3e6311babca100fd']",1,1,2,164459,1,,,,386
9066481830c0bf4171306b03820c10d791f3b05e,0,Nathan Marz,2012-04-11 16:41:37-04:00,['9030d84b6d758a98e6189d05086e32124beda8b1'],5,12,17,164476,3,,,,386
b21fd1447ebe02114cbef5d325b607cb5798d6a1,0,Nathan Marz,2012-04-11 16:41:58-04:00,['9066481830c0bf4171306b03820c10d791f3b05e'],0,1,1,164477,1,,,,386
6584476f7d26dfe11498a56e99d1488641d1d482,0,James Xu,2012-04-12 19:45:48+08:00,['b21fd1447ebe02114cbef5d325b607cb5798d6a1'],6,13,19,164496,1,1,1,1,386
3fee3e4029aaf9981b753512af5db89e80873c6d,0,James Xu,2012-04-12 22:45:14+08:00,['b21fd1447ebe02114cbef5d325b607cb5798d6a1'],41,44,85,164581,5,,,,386
644aaea224424982ed4bc707c6c2b3490bd6e62d,0,Nathan Marz,2012-04-12 13:41:52-04:00,['3fee3e4029aaf9981b753512af5db89e80873c6d'],66,63,129,164710,3,,,,386
4baf72ecf9fc987e5bec070ea44519f038f36128,0,Nathan Marz,2012-04-12 13:48:58-04:00,['644aaea224424982ed4bc707c6c2b3490bd6e62d'],0,1,1,164711,1,,,,386
acf4ef4b51960edb7cbf37dc2b05d04f54c861fd,0,Nathan Marz,2012-04-12 13:49:12-04:00,"['4baf72ecf9fc987e5bec070ea44519f038f36128', '6584476f7d26dfe11498a56e99d1488641d1d482']",6,13,19,164730,1,,,,386
668da62818ad8da5cd6e673062e2765f7d61908c,0,Nathan Marz,2012-04-12 13:53:01-04:00,['acf4ef4b51960edb7cbf37dc2b05d04f54c861fd'],0,1,1,164731,1,,,,386
a6af7ef2b8f7c3107027c1a2af9e2e013bd4b73d,0,Nathan Marz,2012-04-13 11:38:16-07:00,"['668da62818ad8da5cd6e673062e2765f7d61908c', 'c6058e6078f4ffe3271bf8119f216f7de54a24e5']",2,5,7,164738,1,,,,386
26c73c16f7c5786e6b23635af1830ae846ad2ffb,0,Nathan Marz,2012-04-13 11:39:16-07:00,['a6af7ef2b8f7c3107027c1a2af9e2e013bd4b73d'],2,1,3,164741,1,,,,386
6d32c6c82a364faef3773c1b3a1a687df2db5502,0,Nathan Marz,2012-04-13 11:40:32-07:00,['26c73c16f7c5786e6b23635af1830ae846ad2ffb'],0,1,1,164742,1,,,,386
3e99760ecf7d4ca606aa48ccdbe27bae08ed8246,0,Nathan Marz,2012-04-13 22:35:04-07:00,"['6d32c6c82a364faef3773c1b3a1a687df2db5502', '8581ccef4bf85dcd4bbbb80f509a813b9dc3718c']",1,12,13,164755,2,,,,386
e88aa5bf882a501ea156cef61235d60628e86453,0,Nathan Marz,2012-04-13 22:45:56-07:00,['3e99760ecf7d4ca606aa48ccdbe27bae08ed8246'],9,11,20,164775,2,,,,386
183766284e276e826c16c02c5d328b3ff48fef75,0,Soren Macbeth,2012-04-16 09:56:36-07:00,['cf5fc872e43f4481a2844d9300067a0743554756'],4,4,8,164783,3,,,,386
a75d3780832544434c0db09179c4fa2097959137,0,Nathan Marz,2012-04-17 00:15:28-07:00,['e88aa5bf882a501ea156cef61235d60628e86453'],1,1,2,164785,1,,,,386
ec812fa296d4c4835a0cb6159939561264dcd571,0,Nathan Marz,2012-04-17 00:18:50-07:00,['a75d3780832544434c0db09179c4fa2097959137'],0,1,1,164786,1,,,,386
469cd6bfe53a27063e4ded285b1a16b4e4f80902,0,Thomas Jack,2012-04-17 11:19:25-05:00,['7bbfa3764b07fa7471e268a4648edb7036d3ddb9'],2,12,14,164800,1,0,1,1,386
a6cf888896d772ab2a2efb942e7bf6ee992727d4,0,Nathan Marz,2012-04-18 00:36:13-07:00,"['ec812fa296d4c4835a0cb6159939561264dcd571', '469cd6bfe53a27063e4ded285b1a16b4e4f80902']",2,12,14,164814,1,,,,386
9a9861513d4ab4daa222a55d065e5963df1a12d7,0,Nathan Marz,2012-04-18 00:41:14-07:00,['a6cf888896d772ab2a2efb942e7bf6ee992727d4'],1,0,1,164815,1,0,0,0,386
a31de9f59ebf2dbd7c84cfe0afbe62cc57dc2e35,0,Nathan Marz,2012-04-18 00:41:56-07:00,['9a9861513d4ab4daa222a55d065e5963df1a12d7'],0,1,1,164816,1,,,,386
35333e45db9492fe409baaf4d1a6be0b87a6bb0f,1,Nathan Marz,2012-04-18 00:46:57-07:00,['a31de9f59ebf2dbd7c84cfe0afbe62cc57dc2e35'],6,6,12,164828,1,,,,386
a2556b6ff7e1a1401b6c551f0b1b10fbf6fd383f,0,Fabian Neumann,2012-04-18 16:18:19+02:00,['35333e45db9492fe409baaf4d1a6be0b87a6bb0f'],4,4,8,164836,1,,,,386
0ed4a6072512b38d0e29e057b07b22e1da859822,0,Nathan Marz,2012-04-19 22:05:53-07:00,['35333e45db9492fe409baaf4d1a6be0b87a6bb0f'],3,274,277,165113,4,0.5,0.722222222,0.555555556,387
35c70edca27775ec087b9782aeb8eb1f0ebd740d,0,Nathan Marz,2012-04-19 22:27:38-07:00,['0ed4a6072512b38d0e29e057b07b22e1da859822'],0,2,2,165115,1,,,,387
49cd5cda3d2c479cc304305a32c4ef9c32b2cd1b,0,Nathan Marz,2012-04-20 00:41:43-07:00,"['62db0636ced2acc1cf0143859c249dd364bc394a', '35c70edca27775ec087b9782aeb8eb1f0ebd740d']",133,519,652,165767,27,,,,387
badd59b2b7184d4cbb556182b4c55ab30bace17f,1,Nathan Marz,2012-04-20 00:59:36-07:00,['49cd5cda3d2c479cc304305a32c4ef9c32b2cd1b'],18,25,43,165810,3,,,,388
c72758bbd01345136f0c454247f82334b11175cc,0,Nathan Marz,2012-04-20 01:44:29-07:00,['badd59b2b7184d4cbb556182b4c55ab30bace17f'],0,1,1,165811,1,,,,388
b0ddc4db8b18a6bfed2f044681975870c84cd0c0,0,James Xu,2012-04-21 01:45:57+08:00,['35c70edca27775ec087b9782aeb8eb1f0ebd740d'],82,133,215,166026,7,,,,388
9d33777564dcb629071ecc67b4101fcb5d508c92,0,James Xu,2012-04-21 10:29:11+08:00,['b0ddc4db8b18a6bfed2f044681975870c84cd0c0'],15,16,31,166057,2,,,,388
e9efb3993653ed78cdcff2d6f99d3eea3c4ea718,0,Nathan Marz,2012-04-20 19:52:34-07:00,"['35c70edca27775ec087b9782aeb8eb1f0ebd740d', 'a2556b6ff7e1a1401b6c551f0b1b10fbf6fd383f']",4,4,8,166065,1,,,,388
aaaa75913f7ada569c105a185935feb16dc46cf2,0,Nathan Marz,2012-04-20 20:12:03-07:00,['e9efb3993653ed78cdcff2d6f99d3eea3c4ea718'],0,1,1,166066,1,,,,388
df18ab0166be8fb233001a6d464c1bc6587b5a5b,0,Nathan Marz,2012-04-20 20:37:20-07:00,"['c72758bbd01345136f0c454247f82334b11175cc', 'aaaa75913f7ada569c105a185935feb16dc46cf2']",4,5,9,166075,2,,,,388
f84d18128a113cf200206166837dd0f55d7db619,1,Nathan Marz,2012-04-20 20:49:26-07:00,['df18ab0166be8fb233001a6d464c1bc6587b5a5b'],1,3,4,166079,1,,,,388
ce2c9923605061db95eb0e27340e4afc3c3b997e,0,Nathan Marz,2012-04-20 20:53:54-07:00,"['aaaa75913f7ada569c105a185935feb16dc46cf2', '183766284e276e826c16c02c5d328b3ff48fef75']",51,141,192,166271,24,,,,388
c278586887ece7525fa973d08c7dbffaf89bdae4,0,Nathan Marz,2012-04-20 22:36:35-07:00,['ce2c9923605061db95eb0e27340e4afc3c3b997e'],68,57,125,166396,14,1,1,0.6,388
7918fad178f5ad225e4e3c990336d29339300f54,0,Nathan Marz,2012-04-20 23:05:56-07:00,['c278586887ece7525fa973d08c7dbffaf89bdae4'],1,4,5,166401,2,,,,388
4a5b87a771150af09fc827ea5ae579b35fc105eb,0,James Xu,2012-04-21 21:06:01+08:00,['9d33777564dcb629071ecc67b4101fcb5d508c92'],232,125,357,166758,9,,,,388
55ceb6d7f10b5b0c3d49ef48cc6585c5240835bc,0,Nathan Marz,2012-04-22 22:48:49-07:00,"['f84d18128a113cf200206166837dd0f55d7db619', '7918fad178f5ad225e4e3c990336d29339300f54']",114,196,310,167068,35,,,,388
eb257664920a8ece1eb495b63734bcc122037fa8,1,Nathan Marz,2012-04-22 23:25:53-07:00,['7918fad178f5ad225e4e3c990336d29339300f54'],1,12,13,167081,1,,,,388
5d40181b7b99177ab73d54380ae7a2aa770c7817,0,Nathan Marz,2012-04-22 23:58:04-07:00,['eb257664920a8ece1eb495b63734bcc122037fa8'],0,1,1,167082,1,,,,388
3a2e9b1f5adc2a816e3c4e371c9f4f3f47d07996,0,xumingming,2012-04-23 18:46:19+08:00,['4a5b87a771150af09fc827ea5ae579b35fc105eb'],81,100,181,167263,7,,,,388
b7d79621d3615c9492245072495e352b45f1afc1,0,Nathan Marz,2012-04-24 18:37:10-07:00,['55ceb6d7f10b5b0c3d49ef48cc6585c5240835bc'],1,0,1,167264,1,,,,388
efd8ad7da9cfe7779c58c75b1d9e84204bfbd3ed,0,Nathan Marz,2012-04-24 18:39:29-07:00,['5d40181b7b99177ab73d54380ae7a2aa770c7817'],0,2,2,167266,1,,,,388
f5f176ea380e8924b8d0c2d979596e384d855577,0,Brian O'Neill,2012-04-26 15:07:06-04:00,['297a750bcee3d1fbebeb36620a32a50d2ba6d591'],8,236,244,167510,8,0.966292135,1,0.887640449,394
ea95ad3c7e7618a1a3e4c39d16d71cf0c258377b,0,Brian O'Neill,2012-04-26 16:38:09-04:00,['f5f176ea380e8924b8d0c2d979596e384d855577'],15,39,54,167564,3,0,1,0.944444444,394
e5f2254f07399b8d357d99f885913d983a1243f6,0,Brian O'Neill,2012-04-26 16:48:10-04:00,['ea95ad3c7e7618a1a3e4c39d16d71cf0c258377b'],31,2,33,167597,1,0,0,0,394
b5745ad047360715d311af971125a8f7fc60ac84,0,P. Taylor Goetz,2012-04-26 23:12:35-04:00,['e5f2254f07399b8d357d99f885913d983a1243f6'],39,36,75,167672,2,0,0,0,394
429d4d3002ad2a27ab159f539c23e8737810ffb3,0,P. Taylor Goetz,2012-04-27 10:58:45-04:00,['b5745ad047360715d311af971125a8f7fc60ac84'],3,2,5,167677,1,,,,394
4fcddeac4cf7056ff4a95122a965c0fa2fb02cae,0,P. Taylor Goetz,2012-04-27 10:58:48-04:00,['429d4d3002ad2a27ab159f539c23e8737810ffb3'],1,1,2,167679,1,,,,394
6074035921bbbd0ae2edf4f8c17cbd765129064d,0,Nathan Marz,2012-04-27 18:47:02-07:00,"['f6d464f2a02cf838e1758812239432d562683bed', 'd1157e6ac0ae5b2be1ee26713265eae204f4ac23']",1,1,2,167681,1,,,,394
55362f5a918a7fcc4b94bdd13448ded3a4fdc1ef,0,Nathan Marz,2012-04-28 01:36:30-07:00,['6074035921bbbd0ae2edf4f8c17cbd765129064d'],6,255,261,167942,6,0.721428571,1,0.857142857,396
6c8487da1be2d58bd7addbd2c25418fbd687974e,0,Nathan Marz,2012-04-28 01:39:18-07:00,['55362f5a918a7fcc4b94bdd13448ded3a4fdc1ef'],15,13,28,167970,2,1,0,0,396
d1b0e48b7b9845b52e15ae6d3e895b279eaa52ba,0,Nathan Marz,2012-04-28 01:45:05-07:00,['6c8487da1be2d58bd7addbd2c25418fbd687974e'],4,2,6,167976,1,,,,396
ca4c0dbd44b8da77cfb90f482ec123c457068221,0,Nathan Marz,2012-04-28 14:53:11-07:00,"['efd8ad7da9cfe7779c58c75b1d9e84204bfbd3ed', '3a2e9b1f5adc2a816e3c4e371c9f4f3f47d07996']",220,185,405,168381,7,,,,396
d30ad355181e94fff78f1fefe64a45353fe3181a,0,Nathan Marz,2012-04-28 15:43:39-07:00,['ca4c0dbd44b8da77cfb90f482ec123c457068221'],22,20,42,168423,4,,,,396
a52724062c5f0098a0bf87edad9d0ee95f700a07,0,Nathan Marz,2012-04-28 17:47:17-07:00,['d30ad355181e94fff78f1fefe64a45353fe3181a'],20,14,34,168457,4,,,,396
acc5183f29e2c70ac2dd6ed311f87776c4289a54,0,Nathan Marz,2012-04-28 17:49:33-07:00,['a52724062c5f0098a0bf87edad9d0ee95f700a07'],1,4,5,168462,1,,,,396
a942da6072650489230823fc83797ab1e474c0e8,0,Nathan Marz,2012-04-28 23:04:57-07:00,['acc5183f29e2c70ac2dd6ed311f87776c4289a54'],17,35,52,168514,2,,,,396
d99f13d0ac93feeea1cb53c8eebc9a4009e51b75,1,Nathan Marz,2012-04-29 01:50:13-07:00,"['b7d79621d3615c9492245072495e352b45f1afc1', 'a942da6072650489230823fc83797ab1e474c0e8']",243,235,478,168992,13,,,,396
2d9732eb9a22b0dd8032c9b7132cae40edad21f1,1,Nathan Marz,2012-04-29 15:07:16-07:00,['d99f13d0ac93feeea1cb53c8eebc9a4009e51b75'],181,204,385,169377,2,,,,396
37f31ec55482a848320cd686778c23d2237c95c6,0,Nathan Marz,2012-04-30 10:21:44-04:00,['2d9732eb9a22b0dd8032c9b7132cae40edad21f1'],190,227,417,169794,3,,,,396
b72c4699b59b65b9b9ce30fb88d0252e9d44a52e,1,Nathan Marz,2012-04-30 10:41:16-04:00,['37f31ec55482a848320cd686778c23d2237c95c6'],0,6,6,169800,1,,,,396
e0127153f70caf3afa102a289759f990556465bd,0,Nathan Marz,2012-05-01 23:55:53-04:00,['d1b0e48b7b9845b52e15ae6d3e895b279eaa52ba'],14,35,49,169849,2,1,1,1,396
cbafa76bd3d56e5788a18bb6b8e61072b4fb6f81,0,Brian O'Neill,2012-05-02 13:34:39-04:00,['e5f2254f07399b8d357d99f885913d983a1243f6'],1,15,16,169865,2,1,1,1,396
97b5c70d02587fbe603052ba5e598679718385c8,0,Brian O'Neill,2012-05-02 14:31:24-04:00,"['cbafa76bd3d56e5788a18bb6b8e61072b4fb6f81', '4fcddeac4cf7056ff4a95122a965c0fa2fb02cae']",42,38,80,169945,3,,,,396
e8fec25ff5f1b1dcfd38ed17f088a53591530d18,0,P. Taylor Goetz,2012-05-02 11:43:11-07:00,"['4fcddeac4cf7056ff4a95122a965c0fa2fb02cae', '97b5c70d02587fbe603052ba5e598679718385c8']",1,15,16,169961,2,,,,396
3e1cd872ae5af0c424e0920d5235fa35a6972452,0,P. Taylor Goetz,2012-05-02 14:47:16-04:00,['e8fec25ff5f1b1dcfd38ed17f088a53591530d18'],1,1,2,169963,1,,,,396
eda3c10913e7a8631d917bb626cbd443b06eb18e,0,P. Taylor Goetz,2012-05-02 14:47:22-04:00,['3e1cd872ae5af0c424e0920d5235fa35a6972452'],1,1,2,169965,1,,,,396
f04ff40d289ce5ef8b172af39a924c0d8ab1609f,0,Nathan Marz,2012-05-02 15:29:07-04:00,['e0127153f70caf3afa102a289759f990556465bd'],11,49,60,170025,1,0,1,0.888888889,396
2730eb89174b9976feb6ca7401eb07832f7b09d4,0,Nathan Marz,2012-05-02 15:45:09-04:00,['f04ff40d289ce5ef8b172af39a924c0d8ab1609f'],2,0,2,170027,1,1,0,0,396
8b6fb1dbcf574e975af9368a3660c6d8cd5acc15,0,Nathan Marz,2012-05-03 01:04:51-04:00,['2730eb89174b9976feb6ca7401eb07832f7b09d4'],4,0,4,170031,1,,,,396
882e5f072a94c89834ec517345a9ec7e3b34b2be,0,Nathan Marz,2012-05-03 01:07:47-04:00,['b72c4699b59b65b9b9ce30fb88d0252e9d44a52e'],1,1,2,170033,1,,,,396
9db6453509668a08cb1cd3fad760d7d51d917eab,0,Nathan Marz,2012-05-03 01:20:25-04:00,['882e5f072a94c89834ec517345a9ec7e3b34b2be'],1,2,3,170036,1,,,,396
aaa34e410e87efaedbc3fc16ba7b3a1512aa6c37,0,Nathan Marz,2012-05-03 01:21:18-04:00,['9db6453509668a08cb1cd3fad760d7d51d917eab'],2,5,7,170043,1,,,,396
1b519a03ef3230e0ac17c91024e53102bd61bfb1,0,Nathan Marz,2012-05-03 16:34:51-04:00,['8b6fb1dbcf574e975af9368a3660c6d8cd5acc15'],2,9,11,170054,2,1,1,1,396
8dc6928f6fe808b6219c3d847499655848a8d3a4,0,Nathan Marz,2012-05-04 10:21:04-04:00,['1b519a03ef3230e0ac17c91024e53102bd61bfb1'],0,48,48,170102,1,,,,396
e258cef74bd9f828df2307acfb5dc7d99e3e75cb,0,Nathan Marz,2012-05-04 10:23:05-04:00,['8dc6928f6fe808b6219c3d847499655848a8d3a4'],1,1,2,170104,1,,,,396
c8eea0ab98f473d60aef215b964c0d53723c4ffd,0,James Xu,2012-05-06 02:05:12+08:00,['aaa34e410e87efaedbc3fc16ba7b3a1512aa6c37'],5,24,29,170133,1,,,,396
e2d48333239e2615d402fbd455564062117d6a07,0,James Xu,2012-05-06 02:09:22+08:00,['c8eea0ab98f473d60aef215b964c0d53723c4ffd'],0,34,34,170167,1,,,,396
a1710d77377829826c34ff03f3b4ce6a2a739790,0,Jeroen van Dijk,2012-05-05 23:30:26+03:00,['754ce8b22266079179c9f1275c11fd8364c1b510'],2,2,4,170171,1,,,,396
a3ed583c30c9ec55e2c51f3e3124e60f3b61bb1a,0,James Xu,2012-05-06 09:42:59+08:00,['e2d48333239e2615d402fbd455564062117d6a07'],3,2,5,170176,1,,,,396
0f5740feff77283e8ca295486ffac637d7652b09,0,James Xu,2012-05-06 09:43:23+08:00,['a3ed583c30c9ec55e2c51f3e3124e60f3b61bb1a'],2,9,11,170187,1,,,,396
61760715391f8a2eaa3fec99dcfa29a85970bb3c,0,James Xu,2012-05-06 17:11:44+08:00,['aaa34e410e87efaedbc3fc16ba7b3a1512aa6c37'],35,49,84,170271,5,,,,396
a399c94eef3ea762d1d5c0bfbc7a1b54bd7b07fc,0,Nathan Marz,2012-05-06 17:08:22-07:00,['aaa34e410e87efaedbc3fc16ba7b3a1512aa6c37'],0,1,1,170272,1,,,,396
e01055fd3a983cf71767ddf6012378d37249a665,0,Nathan Marz,2012-05-06 17:09:05-07:00,['a399c94eef3ea762d1d5c0bfbc7a1b54bd7b07fc'],1,1,2,170274,1,,,,396
9bfb89efd4ba3a81cc83530e0450548aebc8dee5,0,Nathan Marz,2012-05-06 17:23:02-07:00,['a399c94eef3ea762d1d5c0bfbc7a1b54bd7b07fc'],0,1,1,170275,1,,,,396
3b2917d3478952065ab0dd84fa5b50e11be386f6,0,Nathan Marz,2012-05-06 17:23:08-07:00,"['e01055fd3a983cf71767ddf6012378d37249a665', '9bfb89efd4ba3a81cc83530e0450548aebc8dee5']",0,1,1,170276,1,,,,396
22ca07257b9b7c284048f5f148fad3f25c42b355,0,Nathan Marz,2012-05-06 20:29:58-07:00,['9bfb89efd4ba3a81cc83530e0450548aebc8dee5'],0,1,1,170277,1,,,,396
875d679c25ebfa954164baf1d42295efac76c72b,0,Nathan Marz,2012-05-06 20:30:04-07:00,"['3b2917d3478952065ab0dd84fa5b50e11be386f6', '22ca07257b9b7c284048f5f148fad3f25c42b355']",0,1,1,170278,1,,,,396
4063934ac0027bca38480138f2db56d508c44f7e,0,Nathan Marz,2012-05-06 22:18:46-07:00,['e258cef74bd9f828df2307acfb5dc7d99e3e75cb'],2,2,4,170282,1,,,,396
8f1a4bef881ab4a2d8f67a53795f50c62d53b29e,0,James Xu,2012-05-07 21:39:08+08:00,['61760715391f8a2eaa3fec99dcfa29a85970bb3c'],13,27,40,170322,1,,,,396
099e90c2327b0276781d1b886a5a4d9382c559f6,0,Nathan Marz,2012-05-07 10:29:20-07:00,"['754ce8b22266079179c9f1275c11fd8364c1b510', 'a1710d77377829826c34ff03f3b4ce6a2a739790']",2,2,4,170326,1,,,,396
818287f347b43ac54741f1e54eb384d952a54e78,0,Nathan Marz,2012-05-07 10:30:39-07:00,['099e90c2327b0276781d1b886a5a4d9382c559f6'],2,2,4,170330,1,,,,396
896c0eae2f2083e5f9262adf14c458f82854f348,0,Nathan Marz,2012-05-08 01:14:18-07:00,['22ca07257b9b7c284048f5f148fad3f25c42b355'],118,1082,1200,171530,14,0.69740634,0.778097983,0.971181556,396
45e52f3993a57add63369aafa866d1fd90a388f7,0,Nathan Marz,2012-05-08 01:17:54-07:00,['896c0eae2f2083e5f9262adf14c458f82854f348'],0,4,4,171534,1,,,,396
3d0692aa78330a69fa0111bed58e31a507f53262,0,Nathan Marz,2012-05-08 01:31:31-07:00,['45e52f3993a57add63369aafa866d1fd90a388f7'],1,1,2,171536,1,,,,396
03bd9558bb44da6f4f4ebe1a81f320f8ad6c9538,0,Nathan Marz,2012-05-08 01:39:02-07:00,['875d679c25ebfa954164baf1d42295efac76c72b'],3,4,7,171543,1,,,,396
8d651daa37355b50e11dc2089357ba7c38ed8b5b,0,Nathan Marz,2012-05-08 17:48:17-07:00,['03bd9558bb44da6f4f4ebe1a81f320f8ad6c9538'],1,1,2,171545,1,,,,396
21f82a353bb1b6f44e9d318b3f7969230f8e9de2,0,Nathan Marz,2012-05-08 17:49:00-07:00,['8d651daa37355b50e11dc2089357ba7c38ed8b5b'],1,1,2,171547,1,,,,396
45d0640cc9c8deab02dc09791984f1aa2252711d,0,Nathan Marz,2012-05-08 17:50:07-07:00,['21f82a353bb1b6f44e9d318b3f7969230f8e9de2'],7,7,14,171561,1,0,1,0,396
3e048a140c140e7d87d40b19766919be588af421,0,Nathan Marz,2012-05-08 17:50:15-07:00,"['3d0692aa78330a69fa0111bed58e31a507f53262', '45d0640cc9c8deab02dc09791984f1aa2252711d']",13,14,27,171588,5,,,,396
9282e473d6db0e54b975d564fd07acc641957637,0,Nathan Marz,2012-05-08 17:52:17-07:00,['45d0640cc9c8deab02dc09791984f1aa2252711d'],0,4,4,171592,1,,,,396
e253bc9eab74bd804417997171e07884613efb28,0,Nathan Marz,2012-05-08 17:52:21-07:00,"['3e048a140c140e7d87d40b19766919be588af421', '9282e473d6db0e54b975d564fd07acc641957637']",0,4,4,171596,1,,,,396
f118dbd6d2763ceeae92fd773845a181f67a57cd,0,Nathan Marz,2012-05-08 17:53:23-07:00,['e253bc9eab74bd804417997171e07884613efb28'],1,1,2,171598,1,,,,396
c4a57f3bc12c24ec569098aef1d2db94718e548b,0,Nathan Marz,2012-05-08 21:22:19-07:00,['f118dbd6d2763ceeae92fd773845a181f67a57cd'],1,5,6,171604,1,0,1,0,396
d035c1e4d567cb148341c08efca125eb124522da,0,Nathan Marz,2012-05-08 21:22:38-07:00,['c4a57f3bc12c24ec569098aef1d2db94718e548b'],6,6,12,171616,1,,,,396
d1f42d237f989b480de80334630d6b6dfefa1594,0,Nathan Marz,2012-05-08 21:54:33-07:00,['d035c1e4d567cb148341c08efca125eb124522da'],19,37,56,171672,4,,,,396
796a9fc8b17c0eadde255763c8443b57be21f63d,0,Nathan Marz,2012-05-08 22:34:22-07:00,['d1f42d237f989b480de80334630d6b6dfefa1594'],13,299,312,171984,6,0,0,0.981818182,396
aa124eb95150381a0699386a04a684c6f3a412cd,1,Nathan Marz,2012-05-09 00:45:48-07:00,['796a9fc8b17c0eadde255763c8443b57be21f63d'],2,14,16,172000,2,,,,396
adf6484f99395925e07fc837e468a259cb20a69d,0,Nathan Marz,2012-05-09 01:11:20-07:00,['aa124eb95150381a0699386a04a684c6f3a412cd'],1,1,2,172002,1,,,,396
73866f652650354befe2e1379bd0d5237d0763d5,0,James Xu,2012-05-09 16:15:43+08:00,['aaa34e410e87efaedbc3fc16ba7b3a1512aa6c37'],42,100,142,172144,2,1,0.483870968,0.935483871,397
96ae4a828535a9030b9e93827a47ac0cf33ce7d6,0,Nathan Marz,2012-05-09 10:23:18-07:00,"['adf6484f99395925e07fc837e468a259cb20a69d', '8f1a4bef881ab4a2d8f67a53795f50c62d53b29e']",48,81,129,172273,6,,,,397
68289997edd8431308cc1b95680dab352492e9eb,0,Nathan Marz,2012-05-09 11:08:17-07:00,['96ae4a828535a9030b9e93827a47ac0cf33ce7d6'],1,0,1,172274,1,,,,397
1df18c318cc9a0c1a739407c5559c9954d71b139,0,Nathan Marz,2012-05-09 12:10:26-07:00,['68289997edd8431308cc1b95680dab352492e9eb'],37,40,77,172351,5,,,,397
6b5e5635f31c3caed94c2e9f2640c55e7733a650,0,Nathan Marz,2012-05-09 12:12:55-07:00,"['1df18c318cc9a0c1a739407c5559c9954d71b139', '73866f652650354befe2e1379bd0d5237d0763d5']",42,100,142,172493,2,,,,397
a82d0202d1fb0f7036a258ac2997707ef11e4dd0,0,Nathan Marz,2012-05-09 13:00:14-07:00,['6b5e5635f31c3caed94c2e9f2640c55e7733a650'],8,12,20,172513,1,,,,397
03dae59b429dfba1bf8b3443a0abfb0c215aabc7,0,Nathan Marz,2012-05-09 13:00:52-07:00,['a82d0202d1fb0f7036a258ac2997707ef11e4dd0'],1,2,3,172516,1,,,,397
eee230417152952bbbcfca596e874fe196ec6d1f,0,Nathan Marz,2012-05-09 13:02:34-07:00,['03dae59b429dfba1bf8b3443a0abfb0c215aabc7'],1,1,2,172518,1,,,,397
695f9770bc3a58c3f65f3670f43bfcfe022c8964,0,Nathan Marz,2012-05-09 13:02:40-07:00,['eee230417152952bbbcfca596e874fe196ec6d1f'],0,1,1,172519,1,,,,397
0c7cf730c259d336347c4e1861df543f1b14b3e7,0,Nathan Marz,2012-05-09 13:28:45-07:00,"['695f9770bc3a58c3f65f3670f43bfcfe022c8964', '0f5740feff77283e8ca295486ffac637d7652b09']",4,63,67,172586,2,,,,397
cc8c75d357be671e951b2e4649b390940e910438,0,Nathan Marz,2012-05-09 13:37:32-07:00,['0c7cf730c259d336347c4e1861df543f1b14b3e7'],3,3,6,172592,1,,,,397
31bd4d710a8fa93965128f01788ccc72e4b72a45,0,Nathan Marz,2012-05-09 13:39:53-07:00,['cc8c75d357be671e951b2e4649b390940e910438'],0,1,1,172593,1,,,,397
5bb217d88b4ca136fb3c04344694e39bd3d9dc53,0,Nathan Marz,2012-05-09 13:53:38-07:00,['31bd4d710a8fa93965128f01788ccc72e4b72a45'],1,1,2,172595,1,,,,397
9771cf6c6324c252619e3bc970eac9e4c34ea738,0,Nathan Marz,2012-05-09 15:48:09-07:00,['9282e473d6db0e54b975d564fd07acc641957637'],1,1,2,172597,1,,,,397
3c1065273c1f389afb30688e8972417bf8d53f41,0,Nathan Marz,2012-05-09 15:48:15-07:00,"['5bb217d88b4ca136fb3c04344694e39bd3d9dc53', '9771cf6c6324c252619e3bc970eac9e4c34ea738']",1,1,2,172599,1,,,,397
aca15efc8a94a7cd2dd29b5b82c09704b5849b01,0,Nathan Marz,2012-05-09 16:13:41-07:00,['3c1065273c1f389afb30688e8972417bf8d53f41'],5,5,10,172609,3,,,,397
10cbd8f69290ca0fbfb55034d96b7b0c5c3edbb4,0,Nathan Marz,2012-05-09 17:55:14-07:00,['3c1065273c1f389afb30688e8972417bf8d53f41'],329,350,679,173288,12,0,1,1,397
43426c72097f34a930d9e046af490bee717eacff,0,Nathan Marz,2012-05-09 17:56:30-07:00,['10cbd8f69290ca0fbfb55034d96b7b0c5c3edbb4'],0,1,1,173289,1,,,,397
b18321b5fcb77e0aa3e8820ba6cead9e59e494f4,0,Nathan Marz,2012-05-09 18:11:40-07:00,"['aca15efc8a94a7cd2dd29b5b82c09704b5849b01', '43426c72097f34a930d9e046af490bee717eacff']",329,351,680,173969,13,,,,397
ca937954155dde2de9de08d6251675e91be3235a,0,Nathan Marz,2012-05-09 18:39:49-07:00,['43426c72097f34a930d9e046af490bee717eacff'],2,5,7,173976,1,,,,397
14a842d308ef040ca1192cc6e3e86e769d07043a,0,Nathan Marz,2012-05-09 18:43:00-07:00,"['b18321b5fcb77e0aa3e8820ba6cead9e59e494f4', 'ca937954155dde2de9de08d6251675e91be3235a']",2,5,7,173983,1,,,,397
80201d1346b75d71a0706405da9b6cec7ff3fb5b,0,Nathan Marz,2012-05-09 20:44:06-07:00,['14a842d308ef040ca1192cc6e3e86e769d07043a'],14,24,38,174021,2,,,,397
5b371235853ca243e10a131d3f33f3c9a2099aa5,0,Nathan Marz,2012-05-10 11:59:33-07:00,['80201d1346b75d71a0706405da9b6cec7ff3fb5b'],0,25,25,174046,1,,,,397
066cd0a063fb8a5f03cfcc2f8248ab50b3d144e7,0,Nathan Marz,2012-05-12 00:46:26-07:00,['ca937954155dde2de9de08d6251675e91be3235a'],1,4,5,174051,1,,,,397
4b1ccd9676532429ffdadcac93434a61396da7a2,0,Nathan Marz,2012-05-12 00:48:13-07:00,"['5b371235853ca243e10a131d3f33f3c9a2099aa5', '066cd0a063fb8a5f03cfcc2f8248ab50b3d144e7']",1,4,5,174056,1,,,,397
bba2e7f95f4d67241ab8720bcedb32ea2de8f7c3,0,Nathan Marz,2012-05-12 17:08:35-07:00,['ca937954155dde2de9de08d6251675e91be3235a'],1,4,5,174061,1,,,,397
19c79c14bf52cce43d8d2c5247dbf5da2f5a3bab,0,Nathan Marz,2012-05-12 17:11:16-07:00,['bba2e7f95f4d67241ab8720bcedb32ea2de8f7c3'],2,0,2,174063,1,,,,397
aa91046896db51e62cb66ae7c2cf6a9400d48755,1,Nathan Marz,2012-05-12 17:12:39-07:00,['5b371235853ca243e10a131d3f33f3c9a2099aa5'],31,59,90,174153,5,,,,397
edbddf234bdd4003ef3b1b5fe88b460e42c3cf40,0,Nathan Marz,2012-05-12 17:12:40-07:00,"['aa91046896db51e62cb66ae7c2cf6a9400d48755', '19c79c14bf52cce43d8d2c5247dbf5da2f5a3bab']",0,0,0,174153,0,,,,397
cbf995e57fc59c9d433159d53a057b9698c48159,0,Nathan Marz,2012-05-14 01:01:37-07:00,['9771cf6c6324c252619e3bc970eac9e4c34ea738'],0,3,3,174156,1,0,1,1,397
dc511b6eaf2b6031de664d96e952ba11680a7109,0,Nathan Marz,2012-05-14 01:02:08-07:00,['cbf995e57fc59c9d433159d53a057b9698c48159'],0,1,1,174157,1,,,,397
9aa2d64b8b672eab50b3269dff5fb0867136e709,0,Nathan Marz,2012-05-14 01:02:13-07:00,"['19c79c14bf52cce43d8d2c5247dbf5da2f5a3bab', 'dc511b6eaf2b6031de664d96e952ba11680a7109']",0,4,4,174161,2,,,,397
468ed6ab77e7a223dd8a74201e64e6b3e4faafed,0,Nathan Marz,2012-05-14 01:06:58-07:00,"['edbddf234bdd4003ef3b1b5fe88b460e42c3cf40', '4b1ccd9676532429ffdadcac93434a61396da7a2']",0,0,0,174161,0,,,,397
c36bd0d33ddf340e97f55afdf474a1a73e80b85d,0,Nathan Marz,2012-05-14 22:59:29-07:00,['9aa2d64b8b672eab50b3269dff5fb0867136e709'],1,1,2,174163,1,,,,397
2d196c65a32825024891218a5a5377a2dd5b2187,0,Nathan Marz,2012-05-14 23:28:06-07:00,['dc511b6eaf2b6031de664d96e952ba11680a7109'],1,1,2,174165,1,,,,397
b568f935b7dee8f87a34926899a351c427cad2c7,0,Nathan Marz,2012-05-14 23:28:38-07:00,['2d196c65a32825024891218a5a5377a2dd5b2187'],0,1,1,174166,1,,,,397
2cf102df91b3b454b4a94bd0344c69bb0f5dec73,0,Nathan Marz,2012-05-14 23:28:43-07:00,"['c36bd0d33ddf340e97f55afdf474a1a73e80b85d', 'b568f935b7dee8f87a34926899a351c427cad2c7']",0,1,1,174167,1,,,,397
161bf2a64b041bd1ca502105a71da6aa01a9ed91,0,Nathan Marz,2012-05-16 20:50:57-07:00,['b568f935b7dee8f87a34926899a351c427cad2c7'],0,6,6,174173,2,0.666666667,0.666666667,1,397
2f66e58ae247f737c585510fb1859d8098c62d75,0,Nathan Marz,2012-05-16 20:51:14-07:00,['161bf2a64b041bd1ca502105a71da6aa01a9ed91'],0,1,1,174174,1,,,,397
b74d32322c0b89b2e3870b1b74aee210374f0fe4,0,Nathan Marz,2012-05-16 20:51:22-07:00,"['2cf102df91b3b454b4a94bd0344c69bb0f5dec73', '2f66e58ae247f737c585510fb1859d8098c62d75']",0,7,7,174181,3,,,,397
785ac24971acc4565d987491d239b8e9e6c2f1ca,0,Nathan Marz,2012-05-16 23:49:03-07:00,['4063934ac0027bca38480138f2db56d508c44f7e'],5,8,13,174194,2,1,1,1,397
939c77a6c6a47c4a5caba4c0d453465c19eb8c30,0,Nathan Marz,2012-05-17 13:17:42-07:00,"['468ed6ab77e7a223dd8a74201e64e6b3e4faafed', 'b74d32322c0b89b2e3870b1b74aee210374f0fe4']",1,13,14,174208,5,,,,397
6f99d47576170f8a8804e636acc4e44906b45252,0,Nathan Marz,2012-05-17 13:58:50-07:00,['939c77a6c6a47c4a5caba4c0d453465c19eb8c30'],1,4,5,174213,2,,,,397
58aeabf88d03ac998c02d34e217d23924451fa1a,0,Nathan Marz,2012-05-17 14:38:29-07:00,['b74d32322c0b89b2e3870b1b74aee210374f0fe4'],34,40,74,174287,6,,,,397
dabd1a9c0bb553e59f119ab867dad095d591466e,0,Nathan Marz,2012-05-17 14:41:20-07:00,"['6f99d47576170f8a8804e636acc4e44906b45252', '58aeabf88d03ac998c02d34e217d23924451fa1a']",34,40,74,174361,6,,,,397
633575c799c8e9fa5513aed3ec508b7ab6680ca7,0,Nathan Marz,2012-05-17 18:08:42-07:00,['dabd1a9c0bb553e59f119ab867dad095d591466e'],18,21,39,174400,1,,,,397
8c011bfa6074702ce707899f48d4ad4ae8c24c70,0,Nathan Marz,2012-05-17 18:09:07-07:00,['633575c799c8e9fa5513aed3ec508b7ab6680ca7'],7,0,7,174407,1,,,,397
345cdc2aab9b1c590336f283663c129fd6e7de5c,0,Nathan Marz,2012-05-17 18:36:08-07:00,['58aeabf88d03ac998c02d34e217d23924451fa1a'],7,12,19,174426,3,,,,397
748ecd14324e83223de618b6c6e814bbbb54cb08,0,Nathan Marz,2012-05-17 18:36:16-07:00,"['8c011bfa6074702ce707899f48d4ad4ae8c24c70', '345cdc2aab9b1c590336f283663c129fd6e7de5c']",7,12,19,174445,3,,,,397
7db6aa84076823939a7493218a4c310c226cc983,0,Nathan Marz,2012-05-17 18:43:34-07:00,['345cdc2aab9b1c590336f283663c129fd6e7de5c'],4,0,4,174449,2,,,,397
dba0286b473be702e72bdfc24ae034dd1e48dd83,0,Nathan Marz,2012-05-17 18:43:40-07:00,"['748ecd14324e83223de618b6c6e814bbbb54cb08', '7db6aa84076823939a7493218a4c310c226cc983']",4,0,4,174453,2,,,,397
a2859cbfb49bc316ab33977c527bdb6b3a88dc90,1,Nathan Marz,2012-05-18 01:02:50-07:00,['dba0286b473be702e72bdfc24ae034dd1e48dd83'],443,1039,1482,175935,15,0.50462963,0.488425926,0.986111111,398
1faa92e45021afc0171f843d463625aa83d2d4fd,1,James Xu,2012-05-18 17:34:17+08:00,['19c79c14bf52cce43d8d2c5247dbf5da2f5a3bab'],132,770,902,176837,13,1,1,0.889830508,404
fa0f5dd689be544cabddfc5ddf252db1dc39f972,1,James Xu,2012-05-19 00:03:04+08:00,['1faa92e45021afc0171f843d463625aa83d2d4fd'],42,51,93,176930,2,,,,404
cf036d70474b12b5941512380e420cc804e6a19b,0,Nathan Marz,2012-05-18 10:35:41-07:00,['a2859cbfb49bc316ab33977c527bdb6b3a88dc90'],25,25,50,176980,2,,,,404
8c3918b8fa17fb4711c99653fe0c40616bca936b,0,ashley,2012-05-18 19:51:46+01:00,['7db6aa84076823939a7493218a4c310c226cc983'],3,3,6,176986,2,,,,404
407d6314caebd690da5cd8167900f2b32fef83c6,0,Nathan Marz,2012-05-18 13:46:40-07:00,['cf036d70474b12b5941512380e420cc804e6a19b'],62,87,149,177135,8,,,,404
7520648c8169537fdf00e36bbc47fb659b0a646a,0,James Xu,2012-05-19 18:43:19+08:00,['fa0f5dd689be544cabddfc5ddf252db1dc39f972'],72,143,215,177350,6,1,1,1,404
e3a1401efd81c8a624a8263664b4cbbbadaa3f31,1,Nathan Marz,2012-05-19 14:16:08-07:00,['407d6314caebd690da5cd8167900f2b32fef83c6'],400,506,906,178256,14,1,1,0,406
792bcaab2f7562a2dc0ca4c0a77ca161fcca0c3b,0,Nathan Marz,2012-05-19 14:36:59-07:00,['e3a1401efd81c8a624a8263664b4cbbbadaa3f31'],7,11,18,178274,3,,,,406
4bcb86dd9116b4c41a9bd3934796a27a68bccc34,0,Nathan Marz,2012-05-19 15:48:24-07:00,['792bcaab2f7562a2dc0ca4c0a77ca161fcca0c3b'],36,35,71,178345,2,,,,406
21c9b6977e74e6b82c52ff1acc7e8b3e7cdaafc6,0,Nathan Marz,2012-05-19 17:43:09-07:00,['4bcb86dd9116b4c41a9bd3934796a27a68bccc34'],92,110,202,178547,5,,,,406
b98b6732706a092928271e702a3388b06050833e,0,Nathan Marz,2012-05-19 17:52:30-07:00,['21c9b6977e74e6b82c52ff1acc7e8b3e7cdaafc6'],22,21,43,178590,1,,,,406
520d864efec102d85638ca3578a703e43a28e497,0,Nathan Marz,2012-05-19 17:53:23-07:00,['b98b6732706a092928271e702a3388b06050833e'],3,1,4,178594,1,,,,406
269dbd14214534580308e8fc2a599f14341c3c91,1,Nathan Marz,2012-05-19 18:03:50-07:00,['520d864efec102d85638ca3578a703e43a28e497'],2,5,7,178601,1,1,1,1,406
295816dfceedbfaffe9e50677c08fe65ab9dd729,1,Nathan Marz,2012-05-19 21:27:52-07:00,['269dbd14214534580308e8fc2a599f14341c3c91'],133,169,302,178903,12,0.571428571,1,0.571428571,406
b16c477017ac33df1478d6d752fa9838a9cc2f07,0,Nathan Marz,2012-05-19 23:01:10-07:00,['295816dfceedbfaffe9e50677c08fe65ab9dd729'],39,31,70,178973,8,1,0,1,406
e1db1f194535b2636416b6d53adbf26f6cc158d5,0,Nathan Marz,2012-05-20 00:11:55-07:00,['b16c477017ac33df1478d6d752fa9838a9cc2f07'],1,1,2,178975,1,,,,406
1dd96ec3f528608741e4130cc413b1d154da247f,0,Nathan Marz,2012-05-20 00:12:32-07:00,['e1db1f194535b2636416b6d53adbf26f6cc158d5'],1,6,7,178982,1,,,,406
53524f01c0098b7b4ec5dff25e163b2b435c0d2b,0,Nathan Marz,2012-05-20 00:42:45-07:00,['1dd96ec3f528608741e4130cc413b1d154da247f'],1,1,2,178984,1,,,,406
36494f5b7c5c4b5992d3db96c6c1d8f28e726f85,0,Nathan Marz,2012-05-20 01:08:58-07:00,['53524f01c0098b7b4ec5dff25e163b2b435c0d2b'],4,8,12,178996,2,,,,406
11e70de21db6b3906343839e9edf4b2b18718fd7,0,Nathan Marz,2012-05-20 01:26:55-07:00,['36494f5b7c5c4b5992d3db96c6c1d8f28e726f85'],1,1,2,178998,1,,,,406
b1567c161f578e7a1b2e2bf0f6141f87372ce461,0,Nathan Marz,2012-05-20 01:40:41-07:00,['11e70de21db6b3906343839e9edf4b2b18718fd7'],6,10,16,179014,1,,,,406
eba80e3ca13db39aec7965a692be3cf219d8c856,0,Nathan Marz,2012-05-20 03:20:13-07:00,['b1567c161f578e7a1b2e2bf0f6141f87372ce461'],22,19,41,179055,3,,,,406
688af7c65b6a097891015c4aaf6a175c1300c2f3,0,Nathan Marz,2012-05-20 03:20:36-07:00,['eba80e3ca13db39aec7965a692be3cf219d8c856'],0,21,21,179076,1,1,1,1,407
8475a7415d52d378703278cfd1d75cf4cb00fee8,0,James Xu,2012-05-20 23:24:33+08:00,['7520648c8169537fdf00e36bbc47fb659b0a646a'],116,63,179,179255,4,,,,408
7458f06e8fc2947b826669c6e135826bf35078dc,1,Nathan Marz,2012-05-20 16:05:39-07:00,['688af7c65b6a097891015c4aaf6a175c1300c2f3'],32,176,208,179463,9,0.611940299,0.611940299,0.492537313,409
858df1ef6187a323d1cc10cd4b4e62c8d9d98840,0,Nathan Marz,2012-05-20 17:15:23-07:00,['7458f06e8fc2947b826669c6e135826bf35078dc'],28,37,65,179528,3,,,,409
793ba264f3ca476a1f36980f099b7393d4ffd17a,0,Nathan Marz,2012-05-20 18:34:27-07:00,['858df1ef6187a323d1cc10cd4b4e62c8d9d98840'],2,2,4,179532,1,,,,409
f45921c3dac8dc229cec6e2c1dd3a5b1da9615ac,0,Nathan Marz,2012-05-20 18:34:40-07:00,['793ba264f3ca476a1f36980f099b7393d4ffd17a'],0,1,1,179533,1,,,,409
871a4d30481ecccc82d73971f9e48263041b5f00,0,Nathan Marz,2012-05-20 19:18:34-07:00,['f45921c3dac8dc229cec6e2c1dd3a5b1da9615ac'],17,17,34,179567,2,,,,409
ce726ea2fb41f43524d8c5c5a14e151f45288821,0,Nathan Marz,2012-05-20 20:22:38-07:00,['871a4d30481ecccc82d73971f9e48263041b5f00'],2,8,10,179577,3,,,,409
7bbdb6af40056d284f5c9d91b988a570af31002b,0,Nathan Marz,2012-05-20 20:22:48-07:00,['ce726ea2fb41f43524d8c5c5a14e151f45288821'],2,2,4,179581,1,,,,409
4392e98ed6ace85ada8659dd0f8d95227674e4ea,0,Nathan Marz,2012-05-20 20:50:15-07:00,['7bbdb6af40056d284f5c9d91b988a570af31002b'],136,46,182,179763,5,0,0,0,409
5674f46c7971436063b3281899796d653ffcd645,0,Nathan Marz,2012-05-20 21:38:38-07:00,['4392e98ed6ace85ada8659dd0f8d95227674e4ea'],1,2,3,179766,1,,,,409
3018242a9d5520fdfd6c63c3da366ab0bfed4b49,0,Nathan Marz,2012-05-20 21:55:26-07:00,['5674f46c7971436063b3281899796d653ffcd645'],73,72,145,179911,3,,,,409
f3700ec53dc3e2cf02529843cd84f9fe32e3e834,0,Nathan Marz,2012-05-20 22:49:16-07:00,['3018242a9d5520fdfd6c63c3da366ab0bfed4b49'],12,11,23,179934,1,,,,409
a60a0f279720b323c1aa8f2c29c0745f1d4cb4da,0,Nathan Marz,2012-05-20 22:49:27-07:00,['f3700ec53dc3e2cf02529843cd84f9fe32e3e834'],0,26,26,179960,1,1,1,1,410
a8ae92d9daebc92a200a95e5ff651ab7b946cbab,0,Nathan Marz,2012-05-20 22:49:40-07:00,['a60a0f279720b323c1aa8f2c29c0745f1d4cb4da'],10,11,21,179981,2,,,,410
fd358a8e187730de6d08c1c4070a38a4c0053bc3,0,Nathan Marz,2012-05-21 00:28:06-07:00,['a8ae92d9daebc92a200a95e5ff651ab7b946cbab'],2,3,5,179986,1,,,,410
48242128f96a1865a54237031d8823eccd857aef,0,Nathan Marz,2012-05-21 00:28:21-07:00,['fd358a8e187730de6d08c1c4070a38a4c0053bc3'],3,5,8,179994,1,,,,410
05c49ee91d1215f9d445831566a68e9a227f0068,1,Nathan Marz,2012-05-21 03:23:50-07:00,['48242128f96a1865a54237031d8823eccd857aef'],74,164,238,180232,14,0,0,0,411
e88280045284d42ab17d57707e4f5234fb57e8d1,0,Nathan Marz,2012-05-21 16:30:17-07:00,['05c49ee91d1215f9d445831566a68e9a227f0068'],4,4,8,180240,3,,,,411
11862aa2343962f801f7d2eeb8591bb4262fba3b,0,Nathan Marz,2012-05-21 20:24:49-07:00,['e88280045284d42ab17d57707e4f5234fb57e8d1'],26,34,60,180300,4,,,,411
0411f795ab96c57b569d24533d0cc42293a45fb6,0,Nathan Marz,2012-05-21 21:07:11-07:00,['11862aa2343962f801f7d2eeb8591bb4262fba3b'],15,13,28,180328,2,,,,411
0de685aab8f476648ce189b4e4e62261094f6f7e,0,Nathan Marz,2012-05-21 21:07:27-07:00,['0411f795ab96c57b569d24533d0cc42293a45fb6'],4,19,23,180351,1,0,1,0,411
2b6418c418d70a9d93c71f34c3a3872e54bf9c58,0,Nathan Marz,2012-05-21 21:29:24-07:00,['0de685aab8f476648ce189b4e4e62261094f6f7e'],3,4,7,180358,1,,,,411
969269057f093eaeed5aeceb03a863dfde7e908f,0,Nathan Marz,2012-05-21 22:21:31-07:00,['2b6418c418d70a9d93c71f34c3a3872e54bf9c58'],3,5,8,180366,1,,,,411
32295ddf1e6b19d2d193d8145b5e0c9f73db7cdc,0,Nathan Marz,2012-05-21 23:11:29-07:00,['969269057f093eaeed5aeceb03a863dfde7e908f'],20,23,43,180409,5,,,,411
af4432b2d39f9a0123031274442a33464eb470ca,0,Nathan Marz,2012-05-22 01:32:54-07:00,['32295ddf1e6b19d2d193d8145b5e0c9f73db7cdc'],3,8,11,180420,1,,,,411
925d7dc9afef0946b7aeca87b3c7352ecce9b1b7,0,Nathan Marz,2012-05-22 02:02:45-07:00,['af4432b2d39f9a0123031274442a33464eb470ca'],37,70,107,180527,7,1,1,0.666666667,412
f96e10a0db847752138e87da766fd12ab117d33c,0,Nathan Marz,2012-05-22 12:35:30-07:00,['925d7dc9afef0946b7aeca87b3c7352ecce9b1b7'],34,29,63,180590,7,1,0,1,412
8d10d50e71bff0ab250eaa7756ab0f12bcf6856e,0,Nathan Marz,2012-05-22 15:13:26-07:00,['f96e10a0db847752138e87da766fd12ab117d33c'],7,10,17,180607,4,,,,412
57e557774194a7efc936648c903ff3769c72c037,1,Nathan Marz,2012-05-22 15:37:28-07:00,['8d10d50e71bff0ab250eaa7756ab0f12bcf6856e'],7,27,34,180641,4,,,,412
f1a5e0887b9044c34ef0245ee9b7ec1d09cd43e9,0,Nathan Marz,2012-05-22 15:54:12-07:00,['57e557774194a7efc936648c903ff3769c72c037'],1,4,5,180646,2,,,,412
6568642e8bd9a92ea26af65f54e29dffd84693cb,0,Nathan Marz,2012-05-23 00:35:21-07:00,['f1a5e0887b9044c34ef0245ee9b7ec1d09cd43e9'],35,36,71,180717,6,,,,412
d12a917ba0ce5874917f230d58b09b0d06de5876,0,Nathan Marz,2012-05-23 01:09:10-07:00,['6568642e8bd9a92ea26af65f54e29dffd84693cb'],14,10,24,180741,1,,,,412
f4d59e654d3868e19defbd7e3159ef8e65606aaf,1,Nathan Marz,2012-05-23 03:18:33-07:00,['d12a917ba0ce5874917f230d58b09b0d06de5876'],48,90,138,180879,4,,,,412
f183a0c9487d6ca0055df47c18f4cf8ab4abe6e5,0,Nathan Marz,2012-05-23 03:36:49-07:00,['f4d59e654d3868e19defbd7e3159ef8e65606aaf'],1,1,2,180881,1,,,,412
a9b3daafb698961ba13c4dc5a0f46794ac762a4f,0,Nathan Marz,2012-05-23 03:47:41-07:00,['f183a0c9487d6ca0055df47c18f4cf8ab4abe6e5'],1,1,2,180883,1,,,,412
b72cc81a22c433c7fb518b01123a5a90e1cf5342,0,Nathan Marz,2012-05-23 11:24:09-07:00,['a9b3daafb698961ba13c4dc5a0f46794ac762a4f'],0,1,1,180884,1,,,,412
181854270383cca105a3c398792b9a5d73f8907f,0,Nathan Marz,2012-05-23 14:18:43-07:00,['b72cc81a22c433c7fb518b01123a5a90e1cf5342'],1,1,2,180886,1,,,,412
4011a6d84b64d867cb78bd97b0b6a1e3259fb80b,0,Nathan Marz,2012-05-23 15:59:58-07:00,['181854270383cca105a3c398792b9a5d73f8907f'],1,4,5,180891,2,,,,412
8db16341d2a11243e689077deec11a33e65a4651,1,Nathan Marz,2012-05-24 15:27:46-07:00,['4011a6d84b64d867cb78bd97b0b6a1e3259fb80b'],1,1,2,180893,1,,,,412
3673f6c6736b97f098879594d558bb980c1416c8,0,Nathan Marz,2012-05-24 15:28:03-07:00,['8db16341d2a11243e689077deec11a33e65a4651'],2,6,8,180901,1,1,1,0.666666667,412
2c172850b401eb6982f0cea283f5dc839dce0ee1,0,Nathan Marz,2012-05-24 15:28:51-07:00,['3673f6c6736b97f098879594d558bb980c1416c8'],0,1,1,180902,1,,,,412
094eed833c05a294faf2fa75dad68a7bed95c92c,0,Nathan Marz,2012-05-24 15:30:02-07:00,['2c172850b401eb6982f0cea283f5dc839dce0ee1'],3,0,3,180905,1,,,,412
6695b85b26e39796589bab22913077c5be3af2a8,0,Nathan Marz,2012-05-24 15:51:37-07:00,['094eed833c05a294faf2fa75dad68a7bed95c92c'],1,5,6,180911,1,0,1,0,412
0fef2b17fa0cdbd3f7ad6d6c9bb8e0f160f70091,0,Nathan Marz,2012-05-24 17:03:58-07:00,['6695b85b26e39796589bab22913077c5be3af2a8'],8,31,39,180950,2,,,,412
55c7b57caaa4a4c2ad2d80196c8cdc99b2aec7de,0,Nathan Marz,2012-05-24 18:07:46-07:00,['0fef2b17fa0cdbd3f7ad6d6c9bb8e0f160f70091'],10,10,20,180970,1,,,,412
28a0a2748cd19ec5c8d94edb0a10c8e14786208d,0,Nathan Marz,2012-05-24 18:36:26-07:00,['55c7b57caaa4a4c2ad2d80196c8cdc99b2aec7de'],9,22,31,181001,1,,,,412
cfc87d2b8628eb4576eb26acb3c786c368a419e2,0,James Xu,2012-05-25 21:52:41+08:00,['7db6aa84076823939a7493218a4c310c226cc983'],1,1,2,181003,1,,,,412
ef059451029d0a155451c5fea7cca7dbaf102140,0,Nathan Marz,2012-05-25 11:25:19-07:00,"['7db6aa84076823939a7493218a4c310c226cc983', 'cfc87d2b8628eb4576eb26acb3c786c368a419e2']",1,1,2,181005,1,,,,412
cc46f4cf94e4fa56bbce1dd7f582cc167e2eff9c,0,Nathan Marz,2012-05-25 11:26:51-07:00,['ef059451029d0a155451c5fea7cca7dbaf102140'],0,1,1,181006,1,,,,412
2952e1d5065eab6478829bb7c874c316f0e40faf,0,Nathan Marz,2012-05-25 11:31:18-07:00,['cc46f4cf94e4fa56bbce1dd7f582cc167e2eff9c'],0,4,4,181010,1,,,,412
2508f493f26d0e00fa2acec54c7b6af8b8c7b995,0,Nathan Marz,2012-05-25 11:58:03-07:00,['2952e1d5065eab6478829bb7c874c316f0e40faf'],1,1,2,181012,1,,,,412
78900aa380b04eba3ed8b492411b3bbbe02d1541,0,Nathan Marz,2012-05-25 16:05:47-07:00,['28a0a2748cd19ec5c8d94edb0a10c8e14786208d'],1,1,2,181014,1,,,,412
76a883e8cee1f3526fcc38a4591983cc13da06c9,0,Nathan Marz,2012-05-25 16:13:02-07:00,['78900aa380b04eba3ed8b492411b3bbbe02d1541'],79,80,159,181173,10,0,0,0,412
24fbd922b60213f776c68b2402e88d22ff50d254,0,Nathan Marz,2012-05-25 16:14:26-07:00,['818287f347b43ac54741f1e54eb384d952a54e78'],3,3,6,181179,1,,,,412
1dc034db9f74c08590bf336ac985673c794d15e0,0,Nathan Marz,2012-05-25 16:50:44-07:00,['76a883e8cee1f3526fcc38a4591983cc13da06c9'],1,1,2,181181,2,0,0,,412
b1e41b95297c2813d636c4e071b85d26fcee94da,0,Nathan Marz,2012-05-25 16:51:55-07:00,['1dc034db9f74c08590bf336ac985673c794d15e0'],0,1,1,181182,1,,,,412
51ea80091ffb599694e78fc16b5eac8d3c3b7b65,0,Nathan Marz,2012-05-25 18:16:40-07:00,['b1e41b95297c2813d636c4e071b85d26fcee94da'],3,63,66,181248,4,1,1,0.5,415
653fdc8c2776b44f052beaa9a6a3f2f9f017de17,0,Nathan Marz,2012-05-25 21:47:14-07:00,['51ea80091ffb599694e78fc16b5eac8d3c3b7b65'],1,4,5,181253,1,,,,415
6535caf38b9d5f8e04c7760d95d4c41f880ed703,0,Nathan Marz,2012-05-25 22:21:37-07:00,['653fdc8c2776b44f052beaa9a6a3f2f9f017de17'],10,11,21,181274,1,,,,415
f2d8f2fb03422523f899632fde12041f85b819ec,0,Nathan Marz,2012-05-25 22:41:42-07:00,['6535caf38b9d5f8e04c7760d95d4c41f880ed703'],5,4,9,181283,1,,,,415
dfd73973ee0e63f91175798acd5b4994affc284f,0,Nathan Marz,2012-05-25 22:42:16-07:00,['f2d8f2fb03422523f899632fde12041f85b819ec'],18,20,38,181321,2,,,,415
af1737844d94dfc24772c0e098fe0b80ad7982b7,1,Nathan Marz,2012-05-25 23:11:38-07:00,['dfd73973ee0e63f91175798acd5b4994affc284f'],9,17,26,181347,5,0.5,0.5,0,415
4b43647a29b4ea2fbc2e945e79114513a7542324,0,Nathan Marz,2012-05-26 04:21:55-07:00,['af1737844d94dfc24772c0e098fe0b80ad7982b7'],27,100,127,181474,7,1,1,1,416
3574701d26b8ddde682eaddeaa5e3c940f835e4d,0,Nathan Marz,2012-05-26 12:30:11-07:00,['4b43647a29b4ea2fbc2e945e79114513a7542324'],1,5,6,181480,1,,,,416
5575c668e08f37d7cb78e20a8d51b102d9282fe9,0,Nathan Marz,2012-05-26 14:03:11-07:00,['3574701d26b8ddde682eaddeaa5e3c940f835e4d'],61,48,109,181589,1,1,1,0.666666667,416
071570227bb3c937b9564815343767eb8f5b54b0,1,Nathan Marz,2012-05-26 20:13:03-07:00,['5575c668e08f37d7cb78e20a8d51b102d9282fe9'],257,305,562,182151,7,1,1,1,417
a10b1aa3bf667c38856b9c2d5fdd3f3975fff20e,0,Nathan Marz,2012-05-26 21:26:53-07:00,['071570227bb3c937b9564815343767eb8f5b54b0'],8,20,28,182179,4,0.666666667,0.666666667,1,417
dadb794cdd45d1150242e55202a50c3254e6fcfc,0,Nathan Marz,2012-05-26 22:40:08-07:00,['a10b1aa3bf667c38856b9c2d5fdd3f3975fff20e'],22,81,103,182282,7,1,1,0.888888889,418
55a5f5503a8ef7177dbbe5f448a00d58a7bfbf78,0,Nathan Marz,2012-05-26 23:30:29-07:00,['dadb794cdd45d1150242e55202a50c3254e6fcfc'],92,138,230,182512,5,0,0,0.043478261,418
2fe536bde89e8c01b452a9bd866f8f7ec27d148e,0,Nathan Marz,2012-05-27 00:00:53-07:00,['55a5f5503a8ef7177dbbe5f448a00d58a7bfbf78'],2,3,5,182517,1,,,,418
f77ec596c0abc5bb59a33649b28f02caabbfbb20,0,Nathan Marz,2012-05-27 00:21:29-07:00,['2fe536bde89e8c01b452a9bd866f8f7ec27d148e'],2,5,7,182524,1,,,,418
f320c78d1554806aeb3fb1bb2f020aaa07d520f0,0,Nathan Marz,2012-05-27 17:15:48-07:00,['f77ec596c0abc5bb59a33649b28f02caabbfbb20'],1,1,2,182526,1,,,,418
5d053052563493f51fd2793465cd09505311ff46,0,Nathan Marz,2012-05-27 17:28:46-07:00,['f320c78d1554806aeb3fb1bb2f020aaa07d520f0'],2,2,4,182530,1,,,,418
e116bf51a6e18a75b25378830debf44215f6e68e,0,Nathan Marz,2012-05-27 17:35:57-07:00,['5d053052563493f51fd2793465cd09505311ff46'],29,29,58,182588,2,,,,418
b55d76074d9b0d8be802de28479dd68af98b8006,0,Nathan Marz,2012-05-27 17:41:29-07:00,['e116bf51a6e18a75b25378830debf44215f6e68e'],82,90,172,182760,2,,,,419
33986e427e4c8db7a36445501f49ddedb9939986,0,Nathan Marz,2012-05-27 17:43:57-07:00,['b55d76074d9b0d8be802de28479dd68af98b8006'],48,54,102,182862,2,,,,420
43ac1944d63d62e432567a3e183b10c83fabd7df,0,Nathan Marz,2012-05-27 17:46:59-07:00,['33986e427e4c8db7a36445501f49ddedb9939986'],42,42,84,182946,2,,,,420
3dfa3e74d4b5b1c6b923ecd8d13fb7ab138b3451,0,Nathan Marz,2012-05-27 19:19:22-07:00,['43ac1944d63d62e432567a3e183b10c83fabd7df'],29,99,128,183074,3,1,1,1,421
68672ced95fd44871d9bfa95972d7be77bfaa602,0,Nathan Marz,2012-05-28 20:38:25-07:00,['2508f493f26d0e00fa2acec54c7b6af8b8c7b995'],51,80,131,183205,1,0.565217391,1,1,421
4b3842977c85bc0aa071476c07846bbe212a5286,0,Nathan Marz,2012-05-28 20:38:35-07:00,['68672ced95fd44871d9bfa95972d7be77bfaa602'],0,1,1,183206,1,,,,421
9c14f8f3e0ea28b994f9b77b4f97f81bf4908a78,0,Nathan Marz,2012-05-28 20:41:30-07:00,"['3dfa3e74d4b5b1c6b923ecd8d13fb7ab138b3451', '4b3842977c85bc0aa071476c07846bbe212a5286']",58,93,151,183357,4,,,,421
348d7f3a10e2d6f986eb5886f2556be5a914cbf7,0,Nathan Marz,2012-05-28 22:58:38-07:00,['9c14f8f3e0ea28b994f9b77b4f97f81bf4908a78'],10,13,23,183380,2,,,,421
2892dd89d4b5ed54d24d49b1d69dade5df8b5a6e,0,Nathan Marz,2012-05-28 23:51:21-07:00,['348d7f3a10e2d6f986eb5886f2556be5a914cbf7'],30,48,78,183458,7,1,1,1,421
601d54aee16dc5938fa81b7d19e2a0a3006fa4f8,0,James Xu,2012-05-29 16:25:02+08:00,"['8475a7415d52d378703278cfd1d75cf4cb00fee8', '28a0a2748cd19ec5c8d94edb0a10c8e14786208d']",1718,3039,4757,188215,69,,,,421
debb8da29bb4c6213e6ba010cfc41b996e5c7b4c,1,Nathan Marz,2012-05-29 02:36:53-07:00,['2892dd89d4b5ed54d24d49b1d69dade5df8b5a6e'],36,45,81,188296,5,1,1,1,421
4f374b8662285abf2bc909b4b2ecdb2a3d7a1269,0,James Xu,2012-05-29 18:30:14+08:00,['601d54aee16dc5938fa81b7d19e2a0a3006fa4f8'],5,14,19,188315,2,,,,421
c7cf1387a1de14016bf9f53e466bf743210d0a33,1,James Xu,2012-05-29 20:37:01+08:00,['4f374b8662285abf2bc909b4b2ecdb2a3d7a1269'],9,6,15,188330,5,,,,421
6022d24175752bc9775873a0cd5a363ba07074ac,0,James Xu,2012-05-29 20:59:06+08:00,['c7cf1387a1de14016bf9f53e466bf743210d0a33'],17,2,19,188349,3,,,,421
ad60cb517d3f74df630c1317d7ed444b90c5df34,0,James Xu,2012-05-29 21:53:37+08:00,['6022d24175752bc9775873a0cd5a363ba07074ac'],3,3,6,188355,1,,,,421
b6b117feeeec8513e3c7f79903fad8c74ac99fde,0,James Xu,2012-05-30 08:26:22+08:00,['ad60cb517d3f74df630c1317d7ed444b90c5df34'],3,9,12,188367,1,,,,421
597562e5ddf522d4792ec86524b468bb3d529546,1,Martin Kleppmann,2012-05-30 14:05:13-07:00,['4b3842977c85bc0aa071476c07846bbe212a5286'],15,27,42,188409,1,,,,421
1bc46653e2cd4df41bad5990fcc9fb66913709ef,0,James Xu,2012-05-31 08:06:35+08:00,['b6b117feeeec8513e3c7f79903fad8c74ac99fde'],6,4,10,188419,2,,,,421
acbcb8d9456ced781ea21f4d9b7ed70e3b45efbf,0,Nathan Marz,2012-05-30 17:17:54-07:00,['debb8da29bb4c6213e6ba010cfc41b996e5c7b4c'],2,1,3,188422,1,,,,421
fd232215a58bd16707bc8bb93552e7bfbc97914d,0,Nathan Marz,2012-05-30 17:49:44-07:00,['24fbd922b60213f776c68b2402e88d22ff50d254'],1,1,2,188424,1,,,,421
0f73b6a75def2a5cc2adca61e9a9d3c4adbb5868,0,Nathan Marz,2012-05-30 20:39:21-07:00,['785ac24971acc4565d987491d239b8e9e6c2f1ca'],7,47,54,188478,6,1,1,0.793103448,422
6dd85c9549a51bf85d4954e33b023d7241b45882,0,Nathan Marz,2012-05-30 21:37:44-07:00,['0f73b6a75def2a5cc2adca61e9a9d3c4adbb5868'],2,8,10,188488,3,0,1,1,422
2654edcd075459178f42808feee994aff9ff6a6d,0,Michael Cetrulo,2012-05-31 23:24:19-03:00,['818287f347b43ac54741f1e54eb384d952a54e78'],1,11,12,188500,1,,,,422
babc6fd443fa3476bb893951b241ceb836c409ed,0,Michael Cetrulo,2012-05-31 23:40:21-03:00,['2654edcd075459178f42808feee994aff9ff6a6d'],1,7,8,188508,1,,,,422
182572b57ccb201031d84a40636deb0094e61795,0,Nathan Marz,2012-06-01 16:20:32-07:00,['acbcb8d9456ced781ea21f4d9b7ed70e3b45efbf'],1,1,2,188510,1,,,,422
d64c8e5a0e06a04d36525b87abcf54e7068b7383,0,Nathan Marz,2012-06-01 17:12:39-07:00,['4b3842977c85bc0aa071476c07846bbe212a5286'],1,1,2,188512,1,,,,422
678adb6371245ec471c5f639a691bfa0d6ac3cec,0,Nathan Marz,2012-06-01 22:46:07-07:00,"['182572b57ccb201031d84a40636deb0094e61795', '1bc46653e2cd4df41bad5990fcc9fb66913709ef']",140,874,1014,189526,15,,,,422
488734aba329f7819c6f1fab218fdaea034302b9,0,Nathan Marz,2012-06-01 22:57:45-07:00,['678adb6371245ec471c5f639a691bfa0d6ac3cec'],1,2,3,189529,1,,,,422
c187dc50a9ec85a6e352166c6fef91941188c654,0,Nathan Marz,2012-06-01 23:13:16-07:00,"['818287f347b43ac54741f1e54eb384d952a54e78', 'babc6fd443fa3476bb893951b241ceb836c409ed']",2,18,20,189549,2,,,,422
fce57833e3bb6e311878f160b283008808a607ed,0,Nathan Marz,2012-06-02 00:27:22-07:00,['488734aba329f7819c6f1fab218fdaea034302b9'],8,6,14,189563,1,,,,422
0d8a195f48af016b65c3d42df37ef77ab0a65e2f,0,Nathan Marz,2012-06-02 00:52:29-07:00,"['d64c8e5a0e06a04d36525b87abcf54e7068b7383', '8c3918b8fa17fb4711c99653fe0c40616bca936b']",3,3,6,189569,2,,,,422
2240ad329e2360dc0233c1a1854b1e43cd32177a,0,Nathan Marz,2012-06-02 01:18:42-07:00,['0d8a195f48af016b65c3d42df37ef77ab0a65e2f'],0,1,1,189570,1,,,,422
cc646c35e8b723944b2fa9b3af64cc31f46d7ef6,0,Nathan Marz,2012-06-02 01:37:52-07:00,['182572b57ccb201031d84a40636deb0094e61795'],274,319,593,190163,2,1,0,0.7,422
2e236e4072fde4e87b839232bea93762bf640a3a,0,Nathan Marz,2012-06-02 01:39:12-07:00,['cc646c35e8b723944b2fa9b3af64cc31f46d7ef6'],0,1,1,190164,1,,,,422
1e70817ee9bee9c4c6c2d0a9c8991c8cbba27892,0,Nathan Marz,2012-06-02 02:22:00-07:00,['2e236e4072fde4e87b839232bea93762bf640a3a'],8,86,94,190258,8,0.45,1,0.3,422
2575d71837a23c5fd72b4580af17bab923072597,1,James Xu,2012-06-03 00:49:18+08:00,['1bc46653e2cd4df41bad5990fcc9fb66913709ef'],57,126,183,190441,3,1,1,0.727272727,422
33e3cfc264124d445388d707624e8047a77c11fe,0,James Xu,2012-06-03 03:26:22+08:00,['2575d71837a23c5fd72b4580af17bab923072597'],28,82,110,190551,5,1,1,1,422
7efff3c5b51a38adc86b210f0645c2ab7dcf2d03,0,James Xu,2012-06-03 03:37:00+08:00,['33e3cfc264124d445388d707624e8047a77c11fe'],33,33,66,190617,6,,,,422
109093d357eaa52246b4c5b189ed63acf266875e,0,Nathan Marz,2012-06-02 13:47:48-07:00,['1e70817ee9bee9c4c6c2d0a9c8991c8cbba27892'],7,6,13,190630,1,,,,422
933669968a4322346ac51747934a78ca2810f39e,0,Nathan Marz,2012-06-02 14:00:25-07:00,['109093d357eaa52246b4c5b189ed63acf266875e'],7,23,30,190660,4,1,1,0.857142857,422
2acecc53ed8932e498d57aa96b626b5ca9dcc0c7,0,Nathan Marz,2012-06-02 15:46:10-07:00,['933669968a4322346ac51747934a78ca2810f39e'],10,15,25,190685,2,,,,422
d4c83c3c7750ce865483eb0f065cf028b965be38,0,Nathan Marz,2012-06-02 15:48:11-07:00,['2acecc53ed8932e498d57aa96b626b5ca9dcc0c7'],0,4,4,190689,1,,,,422
64a4b329a1180a7bf060ec86a78d73f6b820804c,0,Nathan Marz,2012-06-02 15:50:56-07:00,['d4c83c3c7750ce865483eb0f065cf028b965be38'],1,1,2,190691,1,,,,422
f92310db314f968df2a67cfbc70565d32e1fb080,0,Nathan Marz,2012-06-02 15:52:01-07:00,['64a4b329a1180a7bf060ec86a78d73f6b820804c'],1,0,1,190692,1,,,,422
dc8d388013b62e1f25ba052c2fcba56a7aa8972f,0,Nathan Marz,2012-06-02 15:57:55-07:00,['f92310db314f968df2a67cfbc70565d32e1fb080'],1,1,2,190694,1,,,,422
2708e40881029b1d8b4e3abbb0105a0476de9680,0,Nathan Marz,2012-06-03 11:47:21-07:00,['dc8d388013b62e1f25ba052c2fcba56a7aa8972f'],1,2,3,190697,1,,,,422
ebe8246460137648e73ceeec35d40decd8171182,0,James Xu,2012-06-04 11:34:19+08:00,['7efff3c5b51a38adc86b210f0645c2ab7dcf2d03'],12,287,299,190996,4,0.105263158,1,0.684210526,423
fbe2047e2412927b6e1137adcc96415402159b9e,0,Nathan Marz,2012-06-04 12:08:13-07:00,"['fce57833e3bb6e311878f160b283008808a607ed', '2708e40881029b1d8b4e3abbb0105a0476de9680']",306,454,760,191756,13,,,,423
ea2e088271e18d702475f92e032c00fa7fa47dfa,0,Nathan Marz,2012-06-04 12:16:48-07:00,"['fbe2047e2412927b6e1137adcc96415402159b9e', 'ebe8246460137648e73ceeec35d40decd8171182']",124,524,648,192404,9,,,,423
86a787d7395179b6ff9813856fe6f8a7bffdc72c,0,Nathan Marz,2012-06-04 13:06:08-07:00,['ea2e088271e18d702475f92e032c00fa7fa47dfa'],18,0,18,192422,2,0,0,0,423
7929a1331ba2b49145e09f5d9c1e79c81e73577c,0,Nathan Marz,2012-06-04 13:09:59-07:00,['86a787d7395179b6ff9813856fe6f8a7bffdc72c'],17,0,17,192439,2,0,0,0,423
0deabfbaf67b51cb27bc21fb01ebb780b77b3f40,0,Nathan Marz,2012-06-04 14:43:01-07:00,['2708e40881029b1d8b4e3abbb0105a0476de9680'],31,9,40,192479,4,0,0,0,423
bf2904b1dcdefdcb6f440eff191aa3a8bfe4ee99,0,Nathan Marz,2012-06-04 16:51:17-07:00,['0deabfbaf67b51cb27bc21fb01ebb780b77b3f40'],23,166,189,192668,6,0.142857143,0.071428571,0.948979592,423
5a615e76c8266dcf9bad44a2a1e02eafa6b77bf7,0,Nathan Marz,2012-06-04 16:55:54-07:00,['bf2904b1dcdefdcb6f440eff191aa3a8bfe4ee99'],0,6,6,192674,1,,,,423
46fb59facff762461f10883714235ab9882ed029,0,Evan Chan,2012-06-04 17:07:25-07:00,['debb8da29bb4c6213e6ba010cfc41b996e5c7b4c'],3,6,9,192683,2,1,1,0,423
2a793d445cd9dfe594138bd5c8b097c58b0a964a,0,Evan Chan,2012-06-04 17:07:50-07:00,['46fb59facff762461f10883714235ab9882ed029'],2,4,6,192689,2,1,1,0,423
436ae8580bfeb528831ede8baec3e5500e6ff34b,0,Nathan Marz,2012-06-04 17:27:47-07:00,['7929a1331ba2b49145e09f5d9c1e79c81e73577c'],9,9,18,192707,1,,,,423
57a78cb7c7a0533d919093486eafcf5a224ec1d8,0,Nathan Marz,2012-06-04 18:02:27-07:00,['5a615e76c8266dcf9bad44a2a1e02eafa6b77bf7'],0,16,16,192723,1,,,,423
6586156c3334f650c8f212bea353c95967d60367,0,Nathan Marz,2012-06-04 18:16:47-07:00,['57a78cb7c7a0533d919093486eafcf5a224ec1d8'],0,24,24,192747,1,,,,423
5ba41627b47506d867eb6766fe91ec0a21d01f48,0,Nathan Marz,2012-06-04 18:24:07-07:00,['6586156c3334f650c8f212bea353c95967d60367'],5,5,10,192757,1,,,,423
6e8a30ba9ab8ffc5f79d6f3542b991dd76d9cc25,0,Nathan Marz,2012-06-04 18:27:17-07:00,['5ba41627b47506d867eb6766fe91ec0a21d01f48'],1,1,2,192759,1,,,,423
365eaeb225588989efe8538e7a4f436065d7c9cf,0,Nathan Marz,2012-06-04 19:28:52-07:00,['6e8a30ba9ab8ffc5f79d6f3542b991dd76d9cc25'],10,50,60,192819,1,,,,423
d84ac473bc61e8cd7535eb63a3acf5fc11e7bf7a,0,James Xu,2012-06-05 11:02:12+08:00,['ebe8246460137648e73ceeec35d40decd8171182'],142,171,313,193132,6,1,1,1,424
3dc29e0dfde9923b54239714f5d7333cd1d11495,0,James Xu,2012-06-05 11:12:41+08:00,"['d84ac473bc61e8cd7535eb63a3acf5fc11e7bf7a', '436ae8580bfeb528831ede8baec3e5500e6ff34b']",1033,1616,2649,195781,55,,,,424
1e35566381b3c5070a0c2f0f45145414e7f200fb,0,James Xu,2012-06-05 12:14:58+08:00,['3dc29e0dfde9923b54239714f5d7333cd1d11495'],13,0,13,195794,1,0,0,0,424
f2a704607267952359c9ccfe96d6dcc18e67bebc,0,Nathan Marz,2012-06-05 11:26:43-07:00,"['436ae8580bfeb528831ede8baec3e5500e6ff34b', '365eaeb225588989efe8538e7a4f436065d7c9cf']",69,276,345,196139,8,,,,424
41d0e3315e7cb04d002b0f8a03ade444a04c472c,0,Nathan Marz,2012-06-05 11:27:10-07:00,"['f2a704607267952359c9ccfe96d6dcc18e67bebc', '1e35566381b3c5070a0c2f0f45145414e7f200fb']",129,158,287,196426,6,,,,424
72db76e9d761ec345071b4d1c0c6c8315ce1410d,0,Nathan Marz,2012-06-05 12:19:36-07:00,['fd232215a58bd16707bc8bb93552e7bfbc97914d'],1,1,2,196428,1,,,,424
f54d0ffc0750c47bac7e1e43ec344817e8ff4736,0,Nathan Marz,2012-06-05 12:19:49-07:00,"['72db76e9d761ec345071b4d1c0c6c8315ce1410d', 'c187dc50a9ec85a6e352166c6fef91941188c654']",2,18,20,196448,2,,,,424
ac3f9ebf2dddf49b810952a13ac670d0a662741d,0,Nathan Marz,2012-06-06 00:47:43-07:00,['365eaeb225588989efe8538e7a4f436065d7c9cf'],0,56,56,196504,1,,,,424
0d863929027453aafdd65f81772604d03986c8fb,0,Nathan Marz,2012-06-06 00:47:56-07:00,"['41d0e3315e7cb04d002b0f8a03ade444a04c472c', 'ac3f9ebf2dddf49b810952a13ac670d0a662741d']",0,56,56,196560,1,,,,424
5df7182d52d00734f665f8e9e14a6d6fac4e2b6f,0,Nathan Marz,2012-06-06 01:00:45-07:00,['0d863929027453aafdd65f81772604d03986c8fb'],15,22,37,196597,6,1,1,1,424
12fde1426aab1cf9cf85590e73a1de10901063b4,0,Nathan Marz,2012-06-06 01:14:32-07:00,"['2240ad329e2360dc0233c1a1854b1e43cd32177a', '5df7182d52d00734f665f8e9e14a6d6fac4e2b6f']",2403,5597,8000,204597,97,,,,424
8a2e06fefe9a5e2875278800053f260bdc7be175,0,Nathan Marz,2012-06-06 01:29:13-07:00,['12fde1426aab1cf9cf85590e73a1de10901063b4'],0,1,1,204598,1,,,,424
479167de35faffb7375ac549af788e75e2dad4f3,0,Nathan Marz,2012-06-06 03:58:58-07:00,['8a2e06fefe9a5e2875278800053f260bdc7be175'],0,1,1,204599,1,,,,424
8c7919ae76084ce862b7b61635e7ebf809ad4818,1,Nathan Marz,2012-06-06 04:00:41-07:00,['479167de35faffb7375ac549af788e75e2dad4f3'],0,4,4,204603,1,,,,424
0749adbe72360e38d82f33392b339977e472b9de,1,Martin Kleppmann,2012-06-06 19:11:14-07:00,['597562e5ddf522d4792ec86524b468bb3d529546'],3,23,26,204629,1,,,,424
08224b2a8a27ea6b5799bbd339da64662eda1b2a,1,Martin Kleppmann,2012-06-06 19:31:02-07:00,['0749adbe72360e38d82f33392b339977e472b9de'],3,7,10,204639,1,,,,424
e633fb93057e6777e1e295ed5063fe6db8564883,0,Evan Chan,2012-06-10 08:09:09-07:00,['2a793d445cd9dfe594138bd5c8b097c58b0a964a'],2,4,6,204645,2,1,1,0,424
7d067a3b5b07071341c4daddbcf641a67c32b3b0,0,Evan Chan,2012-06-10 08:22:27-07:00,['e633fb93057e6777e1e295ed5063fe6db8564883'],2,2,4,204649,1,,,,424
654b40fb6d17f6c4be8068a037cc025e271da308,0,Evan Chan,2012-06-10 08:35:29-07:00,['7d067a3b5b07071341c4daddbcf641a67c32b3b0'],3,6,9,204658,2,1,1,0,424
c201c9deddae018944d34122a6585c8ce8c5e2c7,0,Evan Chan,2012-06-10 08:41:48-07:00,['654b40fb6d17f6c4be8068a037cc025e271da308'],3,6,9,204667,2,1,1,0,424
93c51844c655d5b7accca1c575768dfff9380935,0,Nathan Marz,2012-06-10 17:23:12-07:00,['8c7919ae76084ce862b7b61635e7ebf809ad4818'],2,2,4,204671,1,,,,424
d68498e3d4afb153807140e2f1160a29949fd0b8,0,Nathan Marz,2012-06-11 00:00:04-07:00,['f54d0ffc0750c47bac7e1e43ec344817e8ff4736'],11,1,12,204683,1,,,,424
f7c89ae131c8afd32534da9dc6a9b0efb152fce9,0,Nathan Marz,2012-06-11 16:20:20-07:00,['93c51844c655d5b7accca1c575768dfff9380935'],0,1,1,204684,1,,,,424
2d9db4420dd745ee9a19b2dbc04ee1f97d29ca3f,0,Nathan Marz,2012-06-11 17:33:18-07:00,['6dd85c9549a51bf85d4954e33b023d7241b45882'],15,65,80,204764,2,0,1,1,425
880c2940f0a812d0efdb67e34bdaf66d9376452d,0,Nathan Marz,2012-06-11 17:33:28-07:00,['2d9db4420dd745ee9a19b2dbc04ee1f97d29ca3f'],1,1,2,204766,1,,,,425
654a4365676f61ac25f35297cdd3c2e2411b67bd,0,Nathan Marz,2012-06-11 18:24:38-07:00,['880c2940f0a812d0efdb67e34bdaf66d9376452d'],45,0,45,204811,1,0.761904762,0,0,425
f55992d679c844e2929cbe23401cb4d3de1e21ca,0,Nathan Marz,2012-06-12 17:53:28-07:00,['654a4365676f61ac25f35297cdd3c2e2411b67bd'],1,1,2,204813,1,,,,425
eaab851fecddf2284d9ce3bd5c34f5283e432989,0,Nathan Marz,2012-06-13 17:33:03-07:00,['f7c89ae131c8afd32534da9dc6a9b0efb152fce9'],3,4,7,204820,1,,,,425
5879814b30c2273b778b0f81f07a83d50199c23b,0,Nathan Marz,2012-06-13 18:42:25-07:00,['eaab851fecddf2284d9ce3bd5c34f5283e432989'],2,5,7,204827,2,,,,425
036ce18e3530920b6957604a9f528e43649d61d6,1,Nathan Marz,2012-06-13 18:42:54-07:00,['5879814b30c2273b778b0f81f07a83d50199c23b'],13,30,43,204870,2,,,,425
33a2ea5a8db62e3f7d47ed09d57e1135f211fc74,0,Nathan Marz,2012-06-13 20:47:09-07:00,['036ce18e3530920b6957604a9f528e43649d61d6'],0,5,5,204875,1,,,,425
41b2b77c044f697919084f0e5c07a8746006f069,0,Nathan Marz,2012-06-15 12:11:32-07:00,['d68498e3d4afb153807140e2f1160a29949fd0b8'],1,1,2,204877,1,,,,425
b160035dfb2f7508bf9eb61745d5975c53e1931c,0,Nathan Marz,2012-06-15 12:40:20-07:00,['33a2ea5a8db62e3f7d47ed09d57e1135f211fc74'],1,2,3,204880,1,,,,425
ff9b52877649ab294e19ba10ad67e51ffe28f7ba,1,Martin Kleppmann,2012-06-15 13:27:56-07:00,['08224b2a8a27ea6b5799bbd339da64662eda1b2a'],1,1,2,204882,1,,,,425
3368d34f37975e6c32cb8810a34cfdc7ad173fa0,0,Evan Chan,2012-06-18 16:19:41-07:00,"['c201c9deddae018944d34122a6585c8ce8c5e2c7', '5df7182d52d00734f665f8e9e14a6d6fac4e2b6f']",523,2067,2590,207472,31,,,,425
c4a711aedd952898a53d25240e5fc6480ecde7de,0,Nathan Marz,2012-06-19 15:00:19-04:00,['b160035dfb2f7508bf9eb61745d5975c53e1931c'],1,1,2,207474,1,,,,425
5be1787e3afe89d8657769fbef0c9954d4634961,0,Nathan Marz,2012-06-19 17:50:22-04:00,['5df7182d52d00734f665f8e9e14a6d6fac4e2b6f'],0,624,624,208098,6,0.901369863,0.901369863,0.868493151,431
850572cb95b2cc1177e835e914daa90027f5fa75,0,Nathan Marz,2012-06-19 17:51:23-04:00,['5be1787e3afe89d8657769fbef0c9954d4634961'],11,0,11,208109,1,,,,431
39f41e603a0288941a827f386cb9512c379b966b,0,Nathan Marz,2012-06-20 23:17:08-04:00,['850572cb95b2cc1177e835e914daa90027f5fa75'],2,0,2,208111,1,0,0,0.5,431
bfcfc1a932b3d49d792721a76ee9d131877d06e0,0,Nathan Marz,2012-06-20 23:17:15-04:00,"['c4a711aedd952898a53d25240e5fc6480ecde7de', '39f41e603a0288941a827f386cb9512c379b966b']",0,611,611,208722,6,,,,431
2495a1386811bd27d6bbaed090070e04aff3a5db,0,Nathan Marz,2012-06-21 17:00:56-04:00,['bfcfc1a932b3d49d792721a76ee9d131877d06e0'],1,12,13,208735,2,,,,431
770a03a9d2742fe08b5efc7438a3917ce6e74463,0,Nathan Marz,2012-06-21 17:01:48-04:00,['2495a1386811bd27d6bbaed090070e04aff3a5db'],3,3,6,208741,2,,,,431
8750ea738e5571c0811f0476010bfe1d70306d78,0,Nathan Marz,2012-06-27 00:57:10-07:00,['770a03a9d2742fe08b5efc7438a3917ce6e74463'],4,10,14,208755,1,,,,431
b15ea5ea02b88cbaed8509f692e2d82bb9eec333,0,Nathan Marz,2012-06-27 00:58:48-07:00,['8750ea738e5571c0811f0476010bfe1d70306d78'],0,5,5,208760,1,,,,431
c928c757f9db3a28c3ad6dd9cc40878add6f2c35,0,Nathan Marz,2012-06-27 15:32:24-07:00,['41b2b77c044f697919084f0e5c07a8746006f069'],1,1,2,208762,1,,,,431
04a3476903952b909e0a375e3f21ef05133d9984,0,Nathan Marz,2012-06-27 15:33:03-07:00,['b15ea5ea02b88cbaed8509f692e2d82bb9eec333'],1,1,2,208764,1,,,,431
5869d51f8a77099b309bca07b7a7c4eee46ef79c,0,Argyris Zymnis,2012-06-27 17:02:26-07:00,['f55992d679c844e2929cbe23401cb4d3de1e21ca'],55,160,215,208979,5,0.939393939,1,0.848484848,432
0e1eb41a5988a781abfc1ef397c0708090befd21,0,Argyris Zymnis,2012-06-28 10:41:12-07:00,['5869d51f8a77099b309bca07b7a7c4eee46ef79c'],5,18,23,209002,3,1,1,1,432
d4488c80c1aaacd685484d27bf8f5b91b77f8d33,0,Argyris Zymnis,2012-06-28 10:45:57-07:00,['0e1eb41a5988a781abfc1ef397c0708090befd21'],1,1,2,209004,1,,,,432
4a12919b66ad45ac86789c6c74300cb3e0c31d10,0,Argyris Zymnis,2012-06-28 15:56:44-07:00,['d4488c80c1aaacd685484d27bf8f5b91b77f8d33'],3,7,10,209014,1,1,1,1,432
110cbb3dd71ca9ac3f66ba7f1ffcf3f5af60d286,1,Martin Kleppmann,2012-06-29 16:48:29+01:00,['ff9b52877649ab294e19ba10ad67e51ffe28f7ba'],1,1,2,209016,1,,,,432
f71c58534a047527c5c6164beab8c1f8a07788ed,0,Martin Kleppmann,2012-06-29 17:13:05+01:00,['110cbb3dd71ca9ac3f66ba7f1ffcf3f5af60d286'],1,1,2,209018,1,,,,432
8c834aa07068381082799ff70dfb996d862a2faa,0,Nathan Marz,2012-07-01 01:04:48-07:00,['04a3476903952b909e0a375e3f21ef05133d9984'],22,28,50,209068,6,,,,432
dfb9ad36e7011bf5452fc3f8c9493045ead5509e,0,Jean Vancoppenolle,2012-07-02 14:19:07+02:00,['8c834aa07068381082799ff70dfb996d862a2faa'],3,3,6,209074,1,,,,432
4fb4e0e9dfbce4bda6424e5a8cb1ece9896907e9,0,Nathan Marz,2012-07-02 13:21:29-07:00,['8c834aa07068381082799ff70dfb996d862a2faa'],15,15,30,209104,1,,,,432
eaf27556e9ac32b8f9cfd40d828fed90e43d4264,0,Nathan Marz,2012-07-02 13:21:39-07:00,['4fb4e0e9dfbce4bda6424e5a8cb1ece9896907e9'],2,12,14,209118,3,0,1,0,432
991a46a512f49c61c3b498276f7300284891ff90,0,Nathan Marz,2012-07-02 13:59:54-07:00,['eaf27556e9ac32b8f9cfd40d828fed90e43d4264'],1,2,3,209121,1,,,,432
739167ddf1adf9ad29f811eacde48b39705b201a,0,Nathan Marz,2012-07-02 14:07:38-07:00,['991a46a512f49c61c3b498276f7300284891ff90'],0,5,5,209126,1,,,,432
941f4198abaa736333290c9cbe7a7370b6c52b5a,0,Nathan Marz,2012-07-02 14:39:42-07:00,['739167ddf1adf9ad29f811eacde48b39705b201a'],0,1,1,209127,1,,,,432
d745a9435dd698ba3eaa8cb8db44f864b87ddd90,0,Nathan Marz,2012-07-02 18:38:52-07:00,['4a12919b66ad45ac86789c6c74300cb3e0c31d10'],294,531,825,209952,16,0.585858586,0.595959596,0.707070707,438
b7ba9d9455582b8ef180b96d7f543907b74b674f,0,Nathan Marz,2012-07-02 18:42:24-07:00,['d745a9435dd698ba3eaa8cb8db44f864b87ddd90'],1,1,2,209954,1,,,,438
e4305171091ee31c906f4cac7e476fe7f7681e78,0,Nathan Marz,2012-07-02 18:46:06-07:00,['b7ba9d9455582b8ef180b96d7f543907b74b674f'],0,1,1,209955,1,0,1,0,438
c49b687e37c323e559621b7d058de1a1e5d5eaf5,0,Nathan Marz,2012-07-02 18:55:07-07:00,['e4305171091ee31c906f4cac7e476fe7f7681e78'],0,1,1,209956,1,0,1,0,438
6de5bc5ea664ccca907a34721ddf01672d8f3acf,1,Nathan Marz,2012-07-03 00:27:25-07:00,['941f4198abaa736333290c9cbe7a7370b6c52b5a'],0,5,5,209961,1,1,1,1,438
955a0b0426c3b4ea893580a57f97e852ddc74e20,0,Nathan Marz,2012-07-03 00:28:33-07:00,['6de5bc5ea664ccca907a34721ddf01672d8f3acf'],0,1,1,209962,1,,,,438
0dcfadee6adfb8a956710b453c7d0f7442e868c4,1,Martin Kleppmann,2012-07-03 10:14:35+01:00,['f71c58534a047527c5c6164beab8c1f8a07788ed'],1,2,3,209965,1,,,,438
86904a66dc1e461c42f64e9d393347cb734046e4,0,Nathan Marz,2012-07-04 12:52:31-07:00,['955a0b0426c3b4ea893580a57f97e852ddc74e20'],12,61,73,210038,5,0.875,1,0.75,439
03b3ce4ae5490a2b9d5b19d8c5661aabbf14fed8,0,Nathan Marz,2012-07-04 12:53:10-07:00,['86904a66dc1e461c42f64e9d393347cb734046e4'],0,1,1,210039,1,,,,439
ce6dab3d0421513635d9a49f6160958617473389,0,Nathan Marz,2012-07-05 14:58:53-07:00,['03b3ce4ae5490a2b9d5b19d8c5661aabbf14fed8'],2,1,3,210042,1,,,,439
80b1711949b8d2cd4cbdb4f901005662e5e7c7c8,0,Nathan Marz,2012-07-05 15:30:46-07:00,['ce6dab3d0421513635d9a49f6160958617473389'],7,10,17,210059,2,,,,439
a1630fce76b6fd6465461e78188875dc672926d5,0,Nathan Marz,2012-07-05 15:38:47-07:00,['80b1711949b8d2cd4cbdb4f901005662e5e7c7c8'],4,3,7,210066,2,,,,439
1e4853eea1c893dec82e9886f9cc8403b34bd401,1,Nathan Marz,2012-07-05 17:13:15-07:00,['a1630fce76b6fd6465461e78188875dc672926d5'],19,31,50,210116,2,,,,439
1c4ff0199077494779d06a32325b759471edf6d4,0,Nathan Marz,2012-07-05 17:13:56-07:00,['1e4853eea1c893dec82e9886f9cc8403b34bd401'],0,1,1,210117,1,,,,439
edf6d2a9dae85553865730a14132c8165fc03803,1,Nathan Marz,2012-07-05 22:15:23-07:00,['1c4ff0199077494779d06a32325b759471edf6d4'],3,14,17,210134,2,1,1,0,439
dbf4aa576f4afa6a646a6d795d5a9dd2d142880b,1,Nathan Marz,2012-07-06 18:41:53-07:00,['edf6d2a9dae85553865730a14132c8165fc03803'],1,1,2,210136,1,,,,439
4514be2270facc931c4b9b75bf994dff57f58fd1,0,Nathan Marz,2012-07-06 19:30:09-07:00,['dbf4aa576f4afa6a646a6d795d5a9dd2d142880b'],1,2,3,210139,1,,,,439
fbcbd938da80eae4819ada9a77608cfcd9ef33fd,0,Nathan Marz,2012-07-06 20:22:28-07:00,['4514be2270facc931c4b9b75bf994dff57f58fd1'],1,1,2,210141,1,,,,439
18491a6b3f219fdb1f853dd41f334f204ac036be,0,Nathan Marz,2012-07-07 00:17:05-07:00,['fbcbd938da80eae4819ada9a77608cfcd9ef33fd'],1,1,2,210143,1,,,,439
1f666b5d10651f7e44f1d3005b60eb59fbc250dd,0,Nathan Marz,2012-07-07 00:32:58-07:00,['18491a6b3f219fdb1f853dd41f334f204ac036be'],0,5,5,210148,1,,,,439
24f6f9dfb737b5eceefd81461ec1c8f3891d6427,0,Nathan Marz,2012-07-07 01:24:43-07:00,['1f666b5d10651f7e44f1d3005b60eb59fbc250dd'],41,40,81,210229,3,,,,439
7bb4f2194b9a05f2321670cf8c1010537a75487c,0,Nathan Marz,2012-07-07 14:47:24-07:00,['24f6f9dfb737b5eceefd81461ec1c8f3891d6427'],6,12,18,210247,2,1,1,1,439
c74fbdd3b2ff5342bd0d67a9ea71a97ef1acd693,0,Nathan Marz,2012-07-09 11:37:02-07:00,['7bb4f2194b9a05f2321670cf8c1010537a75487c'],0,5,5,210252,2,,,,439
28fb07b7200a5d50f988df9522aed95e13384050,0,Nathan Marz,2012-07-09 11:56:27-07:00,['c74fbdd3b2ff5342bd0d67a9ea71a97ef1acd693'],0,1,1,210253,1,,,,439
04d8881a1bd040ba434ab6abd9e83d5a660706cf,0,Nathan Marz,2012-07-09 13:19:36-07:00,['28fb07b7200a5d50f988df9522aed95e13384050'],4,7,11,210264,2,1,1,1,439
a2923f3dd96ba283d27d649ec774479d01401d83,0,Nathan Marz,2012-07-09 19:19:48-07:00,['04d8881a1bd040ba434ab6abd9e83d5a660706cf'],2,2,4,210268,1,,,,439
0036e908be4c13ff687b3ca08e6fbbba9b9fa1a2,0,Nathan Marz,2012-07-10 14:17:07-07:00,['a2923f3dd96ba283d27d649ec774479d01401d83'],4,21,25,210293,5,,,,439
31b9e928604be16d8cc648aa8ba4afa614e66256,0,Nathan Marz,2012-07-11 02:28:46-07:00,['c49b687e37c323e559621b7d058de1a1e5d5eaf5'],1,1,2,210295,1,,,,439
887cad498014e584b7a6eca79357962bdc9a040e,0,Nathan Marz,2012-07-12 13:54:37-07:00,['31b9e928604be16d8cc648aa8ba4afa614e66256'],6,29,35,210330,5,0,0.8,1,439
7b5264967c855f353f4ac4f333d05a0e721f91a0,0,Nathan Marz,2012-07-12 13:54:50-07:00,['887cad498014e584b7a6eca79357962bdc9a040e'],1,1,2,210332,1,,,,439
d2c73f85c579f65266ba87c1efd7d07ae6735eef,0,Nathan Marz,2012-07-12 14:10:26-07:00,['7b5264967c855f353f4ac4f333d05a0e721f91a0'],5,12,17,210349,1,0,0,1,439
4debef138e90053e692f72a761e3a3b6692ebe90,0,Nathan Marz,2012-07-12 14:49:55-07:00,['0036e908be4c13ff687b3ca08e6fbbba9b9fa1a2'],4,45,49,210398,3,1,1,0,440
260841bb3053d422db1007d7191a69d922f26234,0,Nathan Marz,2012-07-12 15:56:05-07:00,['4debef138e90053e692f72a761e3a3b6692ebe90'],5,24,29,210427,1,0,1,0,440
a37a9dd73454d707c181d7ab1dced17a3d22f779,0,Nathan Marz,2012-07-12 15:58:59-07:00,['260841bb3053d422db1007d7191a69d922f26234'],0,1,1,210428,1,,,,440
3cc3cd41cb7400d5e1d103bc8410bbf5e8ba005c,0,James Xu,2012-07-13 22:47:34+08:00,['0036e908be4c13ff687b3ca08e6fbbba9b9fa1a2'],0,195,195,210623,5,0.46,1,0.8,444
b8aa3f9691399af4d9b9dc7108eb1f2fc30b1955,0,James Xu,2012-07-14 18:07:17+08:00,['3cc3cd41cb7400d5e1d103bc8410bbf5e8ba005c'],9,184,193,210816,5,0.717948718,1,0.923076923,446
017601be3772feeadff1544d77dba83804292cd2,0,James Xu,2012-07-14 21:33:59+08:00,['b8aa3f9691399af4d9b9dc7108eb1f2fc30b1955'],6,115,121,210937,2,0.141025641,0.487179487,0.961538462,446
ee5968bb993a79af8d46b4a1512005dbb973cc8f,0,James Xu,2012-07-14 22:21:49+08:00,['017601be3772feeadff1544d77dba83804292cd2'],12,75,87,211024,3,0.925925926,1,1,447
cf593f8f87a98cee24e06d52269fbcb2a3d00d17,0,James Xu,2012-07-14 23:18:37+08:00,['ee5968bb993a79af8d46b4a1512005dbb973cc8f'],61,80,141,211165,4,0.68,1,1,448
6a1e025813e45ff07bffc9e291c640b56022a280,0,James Xu,2012-07-14 23:41:45+08:00,['cf593f8f87a98cee24e06d52269fbcb2a3d00d17'],21,42,63,211228,5,0,0,0.3,448
dfd431547ef6e0c20a7e72143d731463fee69fea,0,James Xu,2012-07-14 23:50:45+08:00,['6a1e025813e45ff07bffc9e291c640b56022a280'],0,24,24,211252,3,,,,448
02539af3a5a097244cf15df2519c28552cba88ed,0,James Xu,2012-07-15 00:57:23+08:00,['dfd431547ef6e0c20a7e72143d731463fee69fea'],1,3,4,211256,1,,,,448
a8a92476b77dcec1567aaa04fe5b5f64d4601c0c,0,James Xu,2012-07-15 15:47:06+08:00,['02539af3a5a097244cf15df2519c28552cba88ed'],2,0,2,211258,1,,,,448
4b9ebffa1e5edb04328ac690f5875411497acafb,0,James Xu,2012-07-15 15:49:07+08:00,['a8a92476b77dcec1567aaa04fe5b5f64d4601c0c'],140,212,352,211610,3,0.659574468,1,0.957446809,448
0bac455ef91201ba90c61cdb2ff782c5f9d34c49,0,James Xu,2012-07-15 19:46:16+08:00,['4b9ebffa1e5edb04328ac690f5875411497acafb'],28,14,42,211652,1,,,,448
f552a6ee4705b9e5443dc80f2c7328d3fb006140,0,Nathan Marz,2012-07-17 03:26:06-07:00,['a37a9dd73454d707c181d7ab1dced17a3d22f779'],4,11,15,211667,1,,,,448
68fcc21f05cc867260d2c1b2bc0090541d4e1a73,0,Nathan Marz,2012-07-17 17:13:24-07:00,['f552a6ee4705b9e5443dc80f2c7328d3fb006140'],17,5,22,211689,6,0,0,0,448
d1dd9b95156bb0f264cdaedd8ec1dfd0793b87db,0,Nathan Marz,2012-07-17 17:13:51-07:00,['68fcc21f05cc867260d2c1b2bc0090541d4e1a73'],1,1,2,211691,1,,,,448
f3b9ecffc6bedc8c5351897490bdfe6fba4fba01,0,Nathan Marz,2012-07-19 15:40:37-07:00,['d1dd9b95156bb0f264cdaedd8ec1dfd0793b87db'],2,8,10,211701,1,,,,448
8d2eaba2d0816169eee1e241f92cbdaa397a60e5,0,Nathan Marz,2012-07-19 15:41:24-07:00,['f3b9ecffc6bedc8c5351897490bdfe6fba4fba01'],0,1,1,211702,1,,,,448
f75e9ce3e7ef27aa29572d4a59ee5fd626542b82,0,Nathan Marz,2012-07-20 12:07:59-07:00,['c928c757f9db3a28c3ad6dd9cc40878add6f2c35'],0,53,53,211755,1,1,1,1,449
63e1953d34e96e17d39d5e5a1502669a395b61e6,0,Bart Olsthoorn,2012-07-21 13:25:38+02:00,['f75e9ce3e7ef27aa29572d4a59ee5fd626542b82'],0,11,11,211766,1,1,1,1,450
1dfd56e748190c14914954dc4ff368e7f4f86c3c,0,Vinod Chandru,2012-07-22 05:13:11-07:00,['8d2eaba2d0816169eee1e241f92cbdaa397a60e5'],2,18,20,211786,1,0.083333333,0,1,450
fbdc99369ac3a650a94bd0c7b23341dab08445ca,0,Vinod Chandru,2012-07-22 05:16:16-07:00,['8d2eaba2d0816169eee1e241f92cbdaa397a60e5'],1,1,2,211788,1,,,,450
655d0060a923adc29f2a3926e49d55ac7eac4cfd,0,Nathan Marz,2012-07-23 02:19:54-07:00,"['8d2eaba2d0816169eee1e241f92cbdaa397a60e5', 'fbdc99369ac3a650a94bd0c7b23341dab08445ca']",1,1,2,211790,1,,,,450
f9bcc5b498f4e855981164bdacead84d1522a95f,0,Nathan Marz,2012-07-23 02:22:56-07:00,"['f75e9ce3e7ef27aa29572d4a59ee5fd626542b82', '63e1953d34e96e17d39d5e5a1502669a395b61e6']",0,11,11,211801,1,,,,450
9bb2e2c4d4b341d9489601a3b1ccea1b8885088b,0,Nathan Marz,2012-07-24 17:15:44-07:00,['8d2eaba2d0816169eee1e241f92cbdaa397a60e5'],9,4,13,211814,1,0,0,0,450
3b0fb6fdadaeef9bfc2c45e804f3b24b5ab388bc,0,Nathan Marz,2012-07-24 17:17:16-07:00,"['9bb2e2c4d4b341d9489601a3b1ccea1b8885088b', '655d0060a923adc29f2a3926e49d55ac7eac4cfd']",1,1,2,211816,1,,,,450
835f480f776c97b149bcb71f8abdea5c0dc9c078,0,James Xu,2012-07-25 09:39:05+08:00,['0bac455ef91201ba90c61cdb2ff782c5f9d34c49'],1,33,34,211850,1,,,,450
0c4cb5ea96198956169e3f4662fd9b3ad41683d8,0,James Xu,2012-07-25 12:49:15+08:00,['3b0fb6fdadaeef9bfc2c45e804f3b24b5ab388bc'],26,23,49,211899,3,0,0,0,450
a10f8bbc236dbd45d28336673ca68d8df5074f7b,0,Nathan Marz,2012-07-25 00:53:39-07:00,['0c4cb5ea96198956169e3f4662fd9b3ad41683d8'],5,3,8,211907,1,0,0,0,450
237d716003192d4ceea85e8526b25dcd38f9f49d,0,tombrown52,2012-07-25 10:25:22-06:00,['d2c73f85c579f65266ba87c1efd7d07ae6735eef'],1,1,2,211909,1,,,,450
9f1bf36014caac38a7907f46ab9c0182264075fe,0,Nathan Marz,2012-07-27 01:34:14-07:00,"['a10f8bbc236dbd45d28336673ca68d8df5074f7b', '1dfd56e748190c14914954dc4ff368e7f4f86c3c']",2,18,20,211929,1,,,,450
eaed247622687fed03b321cbe2bf99308dabd216,0,Nathan Marz,2012-07-27 01:49:08-07:00,['9f1bf36014caac38a7907f46ab9c0182264075fe'],3,15,18,211947,3,1,1,1,450
96d46f4fb03e678b30e854f710d01259bac5bffc,0,Nathan Marz,2012-07-27 01:50:33-07:00,['eaed247622687fed03b321cbe2bf99308dabd216'],0,1,1,211948,1,,,,450
360f11f51079c9bc788c0e7e34d71ea0039b99b2,0,Nathan Marz,2012-07-27 01:50:41-07:00,['96d46f4fb03e678b30e854f710d01259bac5bffc'],0,1,1,211949,1,,,,450
d19e8188812bc30a62a8a5e4609b3c78975ef05e,0,Nathan Marz,2012-07-27 02:08:50-07:00,"['360f11f51079c9bc788c0e7e34d71ea0039b99b2', '0dcfadee6adfb8a956710b453c7d0f7442e868c4']",16,53,69,212018,1,,,,450
77fc60c6d8f976bc55b1836e7aea174e7638773e,0,Nathan Marz,2012-07-27 02:17:57-07:00,['d19e8188812bc30a62a8a5e4609b3c78975ef05e'],0,1,1,212019,1,,,,450
a44a08e9d64ee9a068287d44ecb077107578ab8f,0,Nathan Marz,2012-07-27 02:18:41-07:00,['77fc60c6d8f976bc55b1836e7aea174e7638773e'],0,1,1,212020,1,,,,450
57fb6cefea7bd90f419deecf6fcd7682af77f327,0,Nathan Marz,2012-07-29 01:11:05-07:00,['a44a08e9d64ee9a068287d44ecb077107578ab8f'],10,32,42,212062,2,,,,450
84f9bca57c9ea820c6bd871e5f71287e9d1a19c5,1,Nathan Marz,2012-07-29 14:21:29-07:00,['57fb6cefea7bd90f419deecf6fcd7682af77f327'],8,15,23,212085,1,,,,450
d4bdd5c537e03b03121a21a5480fa63114988854,1,Nathan Marz,2012-07-29 14:21:44-07:00,['84f9bca57c9ea820c6bd871e5f71287e9d1a19c5'],4,16,20,212105,1,,,,450
6cbfecd1dd45bf638f9cd1f5d3d70a7a9913643b,0,Nathan Marz,2012-07-29 14:22:48-07:00,['d4bdd5c537e03b03121a21a5480fa63114988854'],3,1,4,212109,1,,,,450
3a907b91737fccd0ef831e6322b938ddd7250492,0,Nathan Marz,2012-07-29 14:45:25-07:00,['6cbfecd1dd45bf638f9cd1f5d3d70a7a9913643b'],4,14,18,212127,2,,,,450
c67ab70e4b8436094a743e1cc782892e8b8615e5,0,Brian O'Neill,2012-07-30 23:25:05-04:00,['f55992d679c844e2929cbe23401cb4d3de1e21ca'],0,76,76,212203,1,,,,451
5f5b97399e1f28542c52382e3d933d2aa1d56da3,0,Nathan Marz,2012-07-30 23:41:08-07:00,['3a907b91737fccd0ef831e6322b938ddd7250492'],11,13,24,212227,1,0,0,1,451
6eea86b44e3eda82cf3ffcc0e72c713b3ff37feb,0,Nathan Marz,2012-07-30 23:45:58-07:00,['5f5b97399e1f28542c52382e3d933d2aa1d56da3'],1,1,2,212229,1,,,,451
0cf4a4ef91a7bad3256347c412a42f43fa71a744,0,Jason Jackson,2012-07-31 14:29:34-07:00,['d2c73f85c579f65266ba87c1efd7d07ae6735eef'],66,63,129,212358,5,1,1,1,452
ad80c0140fbc9b0310e6828f6c4f89a57be2d311,0,Jason Jackson,2012-07-31 14:29:41-07:00,['0cf4a4ef91a7bad3256347c412a42f43fa71a744'],1,1,2,212360,1,,,,452
bc2baeb5c231fe6c56cf2205323452add321028d,0,Nathan Marz,2012-07-31 16:29:59-07:00,['6eea86b44e3eda82cf3ffcc0e72c713b3ff37feb'],1,1,2,212362,1,,,,452
0b2e3d0ddbd6c72ec8769b56c4988a2f6e4ace7f,0,Nathan Marz,2012-07-31 16:54:07-07:00,['bc2baeb5c231fe6c56cf2205323452add321028d'],3,10,13,212375,1,,,,452
ae862e8ffc6f0afa42db5feb05ced96af979e35e,0,Nathan Marz,2012-07-31 16:54:27-07:00,['0b2e3d0ddbd6c72ec8769b56c4988a2f6e4ace7f'],0,1,1,212376,1,,,,452
37313e4893a054e06b9413a5bce28211a3540954,0,Nathan Marz,2012-07-31 17:41:21-07:00,['ae862e8ffc6f0afa42db5feb05ced96af979e35e'],2,4,6,212382,1,,,,452
ef68dd921633b702d9e5d235b5a36d2c50c35070,0,Jason Jackson,2012-07-31 17:51:19-07:00,['ad80c0140fbc9b0310e6828f6c4f89a57be2d311'],40,111,151,212533,7,0.672413793,1,0.896551724,453
bb542b0bf6244304e835a59f3743df9bc28535fe,0,P. Taylor Goetz,2012-07-31 22:08:57-04:00,['c67ab70e4b8436094a743e1cc782892e8b8615e5'],20,2,22,212555,1,,,,453
d47da10b8cdf11726fe963110277f3ddcea42314,0,Nathan Marz,2012-08-01 12:32:15-07:00,['37313e4893a054e06b9413a5bce28211a3540954'],1,2,3,212558,1,,,,453
4a27d30a35b26630fcdd1ea1b0ba84dde3f89fa9,0,Nathan Marz,2012-08-01 14:34:21-07:00,['d2c73f85c579f65266ba87c1efd7d07ae6735eef'],4,3,7,212565,1,,,,453
1b06f21257c2b3ffff491a55e7d87b29063d8b8b,0,Nathan Marz,2012-08-01 14:35:01-07:00,['bb542b0bf6244304e835a59f3743df9bc28535fe'],58,0,58,212623,1,,,,453
866e020a27bae7fc0f88ec54c4593582a52c57a0,0,Nathan Marz,2012-08-01 14:35:54-07:00,"['4a27d30a35b26630fcdd1ea1b0ba84dde3f89fa9', '237d716003192d4ceea85e8526b25dcd38f9f49d']",1,1,2,212625,1,,,,453
58ce22604e97fcb632a517a9a8290343e2d8c4cd,0,Nathan Marz,2012-08-01 14:48:22-07:00,"['d47da10b8cdf11726fe963110277f3ddcea42314', '3368d34f37975e6c32cb8810a34cfdc7ad173fa0']",14,27,41,212666,7,,,,453
277f6e93211d6b604ccd2480b6b387c923c8b9c0,1,Nathan Marz,2012-08-01 15:02:23-07:00,['58ce22604e97fcb632a517a9a8290343e2d8c4cd'],2,8962,8964,221630,151,0.715726239,0.860115855,0.746620897,602
27b615e118af370c9ac62aca802a77f105d04359,0,Nathan Marz,2012-08-01 16:01:31-07:00,['277f6e93211d6b604ccd2480b6b387c923c8b9c0'],1,1,2,221632,1,,,,602
8cfa9fe20622d431b16cd29eeb99864042b5e401,0,Nathan Marz,2012-08-01 16:36:45-07:00,['f75e9ce3e7ef27aa29572d4a59ee5fd626542b82'],2,226,228,221860,3,0.435483871,1,0.975806452,604
6d9c961be18867cfe22b372dc4d976ab61a5baf5,0,Nathan Marz,2012-08-01 19:38:16-07:00,['27b615e118af370c9ac62aca802a77f105d04359'],3,8,11,221871,1,0,0,0,604
d15d5a2bff815317c79a58202bba10602aee06d7,0,Nathan Marz,2012-08-01 21:41:43-07:00,['6d9c961be18867cfe22b372dc4d976ab61a5baf5'],51,100,151,222022,2,0.884615385,0.884615385,0,604
56839f6355585f7adcddce0b40070bb29d9d4c9a,0,Nathan Marz,2012-08-01 21:59:01-07:00,['d15d5a2bff815317c79a58202bba10602aee06d7'],6,19,25,222047,1,0.8,0.8,0.8,604
ae412432e57c60faa92d9dbb215b90f20433092b,0,Nathan Marz,2012-08-01 22:17:35-07:00,['56839f6355585f7adcddce0b40070bb29d9d4c9a'],4,12,16,222063,2,0,0,0.666666667,604
1ff1af8e9f44326cf7207ef194a46113685b69c5,0,Nathan Marz,2012-08-01 22:50:07-07:00,['ae412432e57c60faa92d9dbb215b90f20433092b'],3,3,6,222069,1,,,,604
51fbc79a348dffb56ca21e184ab2d1c1b3f2dbdf,0,Nathan Marz,2012-08-01 22:52:00-07:00,['1ff1af8e9f44326cf7207ef194a46113685b69c5'],0,1,1,222070,1,,,,604
4b6faeb70e79faaf4f15cd533febc2a8dcf4773f,0,Nathan Marz,2012-08-01 23:31:57-07:00,['8cfa9fe20622d431b16cd29eeb99864042b5e401'],2,2,4,222074,2,,,,604
c95063ad6c5bbc9d875e3ab00b8280ce0be5af8d,0,Nathan Marz,2012-08-02 00:30:58-07:00,['51fbc79a348dffb56ca21e184ab2d1c1b3f2dbdf'],0,3,3,222077,2,,,,604
b2755f46a3b5fc7a59e227c30e28ff49adb432b6,0,Nathan Marz,2012-08-02 00:31:13-07:00,['c95063ad6c5bbc9d875e3ab00b8280ce0be5af8d'],1,1,2,222079,1,,,,604
34ae39fb22e5b71982b0e5705c6d345ffd11fd60,0,Nathan Marz,2012-08-02 00:33:13-07:00,['b2755f46a3b5fc7a59e227c30e28ff49adb432b6'],1,0,1,222080,1,,,,604
36b9fea0d8bc023dd07524a64b99b18489262712,0,Nathan Marz,2012-08-02 01:38:51-07:00,['34ae39fb22e5b71982b0e5705c6d345ffd11fd60'],10,15,25,222105,3,0.666666667,1,0.333333333,604
dc6e525315c095a3c14cfd4cfbe2fe4498a732ff,0,Nathan Marz,2012-08-02 01:40:41-07:00,['36b9fea0d8bc023dd07524a64b99b18489262712'],0,1,1,222106,1,,,,604
5693cdb8de5fdb392e13459093c775129b6c2df3,0,Nathan Marz,2012-08-02 09:07:53-07:00,['dc6e525315c095a3c14cfd4cfbe2fe4498a732ff'],1,1,2,222108,1,,,,604
c3083cf83bebc9fb2034e0c6eef275979aafe38d,0,Nathan Marz,2012-08-02 09:10:07-07:00,"['4b6faeb70e79faaf4f15cd533febc2a8dcf4773f', 'f9bcc5b498f4e855981164bdacead84d1522a95f']",0,11,11,222119,1,,,,604
85f668ba47f19e9b3d4c8f8c2ff3ef79b0972e36,0,Nathan Marz,2012-08-02 17:11:17-07:00,['5693cdb8de5fdb392e13459093c775129b6c2df3'],1,1,2,222121,1,,,,604
1b8c94794534e013c8962578c6dccdfd20bea173,0,Nathan Marz,2012-08-05 18:26:49-07:00,['c3083cf83bebc9fb2034e0c6eef275979aafe38d'],1,1,2,222123,1,,,,604
28d4c9e46d6ac54c7ba46a5ed556fdde0183579d,0,Nathan Marz,2012-08-06 01:21:48-07:00,['85f668ba47f19e9b3d4c8f8c2ff3ef79b0972e36'],7,7,14,222137,3,,,,604
a0ca167e17695e39ac907647947737ad258ec7b6,0,Nathan Marz,2012-08-06 13:46:35-07:00,['866e020a27bae7fc0f88ec54c4593582a52c57a0'],3,8,11,222148,1,0,1,1,604
4e7868ef2e7d22b3649953d9ae9dc86ae0799246,0,Nathan Marz,2012-08-06 13:47:25-07:00,['a0ca167e17695e39ac907647947737ad258ec7b6'],2,2,4,222152,1,,,,604
7bfcb121ba2ef957ace4abc4fd552bd3e7ac63b0,0,Argyris Zymnis,2012-08-06 13:49:05-07:00,['d2c73f85c579f65266ba87c1efd7d07ae6735eef'],6,6,12,222164,1,,,,604
e3c257fa0c51bcaa1160a2eb3e4f84fc1058167e,0,Argyris Zymnis,2012-08-06 13:52:05-07:00,"['7bfcb121ba2ef957ace4abc4fd552bd3e7ac63b0', '4e7868ef2e7d22b3649953d9ae9dc86ae0799246']",9,13,22,222186,3,,,,604
e264a255a170d9d4c52b1abfd5e9c55fb20fe25d,0,Nathan Marz,2012-08-06 23:44:57-07:00,['28d4c9e46d6ac54c7ba46a5ed556fdde0183579d'],1,3,4,222190,1,0,0,1,604
59943183c6f4658e036db6fee2367b089a14eeda,0,Debo~ Dutta,2012-08-07 03:49:49-07:00,['e264a255a170d9d4c52b1abfd5e9c55fb20fe25d'],1,1,2,222192,1,,,,604
f94065db5667dc35d31937cd4d415a8f5fa727cd,0,Nathan Marz,2012-08-07 13:02:11-07:00,['e264a255a170d9d4c52b1abfd5e9c55fb20fe25d'],1,1,2,222194,1,,,,604
999eff5e6e7a1346cb6a7c0459302839784585af,0,Nathan Marz,2012-08-07 19:16:31-07:00,['f94065db5667dc35d31937cd4d415a8f5fa727cd'],1,2,3,222197,2,1,1,1,604
2a5daddbed8ed8bba34dc6a88e85398127de3068,0,Sjoerd Mulder,2012-08-09 09:26:34+03:00,['999eff5e6e7a1346cb6a7c0459302839784585af'],3,2,5,222202,1,,,,604
195fb762f3c39bdded4c2216fd2e9e2da487baec,0,Nathan Marz,2012-08-08 23:31:22-07:00,['999eff5e6e7a1346cb6a7c0459302839784585af'],1,1,2,222204,1,,,,604
b647f8f1567afb7ad208016a99755a392143115e,0,Nathan Marz,2012-08-08 23:33:49-07:00,['195fb762f3c39bdded4c2216fd2e9e2da487baec'],0,7,7,222211,1,,,,604
cb6cec9d728b09b416ade5a5b1a000c498c9bd75,0,Sjoerd Mulder,2012-08-09 08:45:19+02:00,['2a5daddbed8ed8bba34dc6a88e85398127de3068'],19,19,38,222249,1,,,,604
59116c60b91cc0bd2d7a52a3a6ff7cf8674527d7,0,Sjoerd Mulder,2012-08-09 09:56:13+02:00,['cb6cec9d728b09b416ade5a5b1a000c498c9bd75'],5,5,10,222259,1,,,,604
7b086e5f18075ff8ebc35f526ce05cb364366873,0,Sjoerd Mulder,2012-08-09 11:11:22+02:00,['59116c60b91cc0bd2d7a52a3a6ff7cf8674527d7'],3,3,6,222265,2,,,,604
88c5c326a258693f71cca13e9b3277b883d7be0c,0,James Xu,2012-08-09 20:46:31+08:00,['835f480f776c97b149bcb71f8abdea5c0dc9c078'],69,42,111,222376,7,0,0,0,604
4d942cd1a1f28b8492072db7131142059a831d12,0,James Xu,2012-08-10 01:34:51+08:00,['88c5c326a258693f71cca13e9b3277b883d7be0c'],3,3,6,222382,1,,,,604
7a5733ceb5442ed8b8a9278f6b681f5461be7458,0,James Xu,2012-08-10 01:35:33+08:00,['4d942cd1a1f28b8492072db7131142059a831d12'],1,1,2,222384,1,,,,604
7507db99cfc2170b2391189e56ffd8e42a940b3f,0,James Xu,2012-08-10 01:37:09+08:00,['7a5733ceb5442ed8b8a9278f6b681f5461be7458'],344,0,344,222728,1,0.672985782,0.18957346,0.037914692,604
9953963e11b3762286dbaf4f0ac141fedca2e18f,0,James Xu,2012-08-10 01:41:28+08:00,['7507db99cfc2170b2391189e56ffd8e42a940b3f'],1,1,2,222730,1,,,,604
0d35d439b3b26b44aac2bf174fc769155609df3b,1,James Xu,2012-08-10 01:44:26+08:00,['9953963e11b3762286dbaf4f0ac141fedca2e18f'],0,144,144,222874,1,,,,605
4aae95b8062a6089e70aa5b4ec13b185425e5a9f,0,Sjoerd Mulder,2012-08-10 09:28:07+02:00,['7b086e5f18075ff8ebc35f526ce05cb364366873'],52,55,107,222981,3,,,,605
f6b56d248fbdc7bcab9fef05ca7980677f400efa,0,Nathan Marz,2012-08-10 00:32:48-07:00,['b647f8f1567afb7ad208016a99755a392143115e'],1,2,3,222984,1,,,,605
d7231a194516f8a03ddfb3926bbbd6df0812d9c0,0,Sjoerd Mulder,2012-08-10 09:45:24+02:00,['4aae95b8062a6089e70aa5b4ec13b185425e5a9f'],0,1,1,222985,1,,,,605
522464ab7609001e405076d3be1c869026bf3217,0,Nathan Marz,2012-08-10 02:15:23-07:00,"['b647f8f1567afb7ad208016a99755a392143115e', '59943183c6f4658e036db6fee2367b089a14eeda']",1,1,2,222987,1,,,,605
9b2fa636e74511ccb5b6231b9d686d7549f1427b,0,Nathan Marz,2012-08-10 02:51:51-07:00,"['b647f8f1567afb7ad208016a99755a392143115e', 'd7231a194516f8a03ddfb3926bbbd6df0812d9c0']",82,85,167,223154,8,,,,605
8f2bbdcb9f74372f170a01784b8cde1be710c49d,0,Nathan Marz,2012-08-10 02:56:07-07:00,['9b2fa636e74511ccb5b6231b9d686d7549f1427b'],0,2,2,223156,2,,,,605
ed619d5a5899dc0cb5042233c6bf9a297009e310,0,Nathan Marz,2012-08-10 02:56:45-07:00,"['8f2bbdcb9f74372f170a01784b8cde1be710c49d', '522464ab7609001e405076d3be1c869026bf3217']",1,1,2,223158,1,,,,605
d3e50e7a8c14feb6ab7cca72fa9d1793285f1b44,0,Sjoerd Mulder,2012-08-11 16:01:15+02:00,['d7231a194516f8a03ddfb3926bbbd6df0812d9c0'],17,17,34,223192,2,,,,605
b23411679ebfb06f820c63c6cee861338444bd59,0,Jason Jackson,2012-08-13 17:22:53-07:00,['ed619d5a5899dc0cb5042233c6bf9a297009e310'],5,23,28,223220,1,0,1,0.842105263,605
8ce3b60f0d653d7d8fa5174081dab9c554548744,0,Nathan Marz,2012-08-13 17:29:24-07:00,"['ed619d5a5899dc0cb5042233c6bf9a297009e310', 'b23411679ebfb06f820c63c6cee861338444bd59']",5,23,28,223248,1,,,,605
6f601e3ce353b2dc18a66767102f345bbc7fa5d6,0,Nathan Marz,2012-08-14 02:50:59-07:00,['ed619d5a5899dc0cb5042233c6bf9a297009e310'],0,1,1,223249,1,,,,605
15ab0e675f778cf359d5e8bdfa841c23d3b7c79c,0,Nathan Marz,2012-08-14 02:51:12-07:00,"['6f601e3ce353b2dc18a66767102f345bbc7fa5d6', '8ce3b60f0d653d7d8fa5174081dab9c554548744']",5,23,28,223277,1,,,,605
b54c162ba64dd045dd46006357cb2a504bab7b87,0,Nathan Marz,2012-08-14 02:52:37-07:00,"['15ab0e675f778cf359d5e8bdfa841c23d3b7c79c', 'd3e50e7a8c14feb6ab7cca72fa9d1793285f1b44']",17,17,34,223311,2,,,,605
ae8435611a7ea51fce9c6ed34365448566316779,0,Nathan Marz,2012-08-14 12:23:13-07:00,['b54c162ba64dd045dd46006357cb2a504bab7b87'],0,1,1,223312,1,,,,605
62f25a73b6621fac8e125c34917d25beb24019a5,0,Argyris Zymnis,2012-08-14 12:29:14-07:00,['e3c257fa0c51bcaa1160a2eb3e4f84fc1058167e'],1,1,2,223314,1,,,,605
505b799182a18e218b0a438a0cc6d777c7cfae1f,1,Jason Jackson,2012-08-14 23:57:28-07:00,['b54c162ba64dd045dd46006357cb2a504bab7b87'],71,109,180,223494,29,,,,607
e37117d7a6814436ca40423f6ec39aff786638e8,0,Jason Jackson,2012-08-15 00:02:15-07:00,['505b799182a18e218b0a438a0cc6d777c7cfae1f'],2,2,4,223498,1,,,,607
2b8f5a55ae3fa0ca4948ff866ab34a8844a6284e,0,Jason Jackson,2012-08-15 00:05:00-07:00,['e37117d7a6814436ca40423f6ec39aff786638e8'],2,2,4,223502,1,,,,607
78ff4a53ce5aca272ed46f5e915a4a59120223ae,0,Jason Jackson,2012-08-15 00:08:54-07:00,['2b8f5a55ae3fa0ca4948ff866ab34a8844a6284e'],1,0,1,223503,1,,,,607
f7505224102a3d9f3119d2685ba2d03cb594dd19,0,Nathan Marz,2012-08-15 00:12:36-07:00,['ae8435611a7ea51fce9c6ed34365448566316779'],1,1,2,223505,1,,,,607
1abc7f79b36f01bd468ad4893d533319b828dba1,0,Nathan Marz,2012-08-15 12:21:01-07:00,['f7505224102a3d9f3119d2685ba2d03cb594dd19'],1,1,2,223507,1,,,,607
1b8bec1ad66e7d09050b084a2a329a6961823ebc,0,Nathan Marz,2012-08-15 15:02:54-07:00,['1abc7f79b36f01bd468ad4893d533319b828dba1'],0,16,16,223523,1,1,1,1,608
54cf35c0b387e21445e0e860b1304f5af178fb50,0,Nathan Marz,2012-08-15 15:03:51-07:00,['1b8bec1ad66e7d09050b084a2a329a6961823ebc'],1,1,2,223525,1,,,,608
b1360fd7cb58c24199439d50ae54bba9b3c393d3,0,Nathan Marz,2012-08-15 15:16:12-07:00,['54cf35c0b387e21445e0e860b1304f5af178fb50'],6,62,68,223593,5,0.733333333,0.733333333,0.8,609
b5bff69664a633d812aac191b5b2e85f08ebc1de,0,Nathan Marz,2012-08-15 15:36:50-07:00,['b1360fd7cb58c24199439d50ae54bba9b3c393d3'],2,38,40,223633,3,1,1,1,610
62ee7639a562910ab76e6b9ff5d5e800bf3dba1f,0,Nathan Marz,2012-08-15 15:37:39-07:00,['b5bff69664a633d812aac191b5b2e85f08ebc1de'],0,1,1,223634,1,,,,610
019aaba934b8294fb071d7e136e31b1bb92d34ce,0,Nathan Marz,2012-08-15 15:39:30-07:00,['62ee7639a562910ab76e6b9ff5d5e800bf3dba1f'],1,1,2,223636,1,,,,610
5b3bec2362ab1df8316a9bdd2b4a6b05b1ed1fe1,1,Jason Jackson,2012-08-15 15:57:28-07:00,['78ff4a53ce5aca272ed46f5e915a4a59120223ae'],27,47,74,223710,5,,,,610
5b10d3cbbf538997f6f34415c44a0bfbae84c3cd,0,Nathan Marz,2012-08-15 16:46:30-07:00,['019aaba934b8294fb071d7e136e31b1bb92d34ce'],1,1,2,223712,1,,,,610
45780e5ce7d6fbd015deaf59b4ca9932d1f1063d,0,Nathan Marz,2012-08-15 17:00:44-07:00,['5b10d3cbbf538997f6f34415c44a0bfbae84c3cd'],2,6,8,223720,2,1,1,1,610
1bdbe34fb48ff74ba7abcf22de5f6be2891c8d00,0,Nathan Marz,2012-08-15 17:00:59-07:00,['45780e5ce7d6fbd015deaf59b4ca9932d1f1063d'],1,1,2,223722,1,,,,610
5f85de2c9cbef4779e304fd3a12c4b0d37babbf0,0,Nathan Marz,2012-08-15 17:01:49-07:00,['1bdbe34fb48ff74ba7abcf22de5f6be2891c8d00'],0,1,1,223723,1,,,,610
09f86bdd2ca6bf749371d01ddffda9284c4ed7ab,0,Nathan Marz,2012-08-15 17:59:30-07:00,['5f85de2c9cbef4779e304fd3a12c4b0d37babbf0'],1,1,2,223725,1,,,,610
5535d107f5600813bf726d1a83de7abff1c4eafe,1,Jason Jackson,2012-08-15 22:07:59-07:00,['5b3bec2362ab1df8316a9bdd2b4a6b05b1ed1fe1'],56,69,125,223850,7,,,,610
e9688a5f84782450d9c9d5ce0a10adf258f92f1f,0,Nathan Marz,2012-08-16 02:32:21-07:00,['1b8c94794534e013c8962578c6dccdfd20bea173'],5,9,14,223864,1,1,1,1,610
febbe25a5f02e7e124a5c02451a8b4d89a6c0dbb,0,Jason Jackson,2012-08-16 12:08:49-07:00,['5535d107f5600813bf726d1a83de7abff1c4eafe'],5,5,10,223874,1,,,,610
d01ed2cf8cfd2344095a8dfdeb06ac6304db7798,0,Jason Jackson,2012-08-16 12:30:30-07:00,['febbe25a5f02e7e124a5c02451a8b4d89a6c0dbb'],2,1,3,223877,1,,,,610
a04991c705b361a962fa23bc25181ea97c475d2e,0,Jason Jackson,2012-08-16 16:44:41-07:00,"['d01ed2cf8cfd2344095a8dfdeb06ac6304db7798', '09f86bdd2ca6bf749371d01ddffda9284c4ed7ab']",10,125,135,224012,11,,,,610
f66ad0982d5a682d1294a64eada08cba33fa2f1f,0,Nathan Marz,2012-08-20 01:41:23-07:00,['09f86bdd2ca6bf749371d01ddffda9284c4ed7ab'],12,201,213,224225,9,0.958333333,0.541666667,0.8125,613
2c17b41cd77ed4638b66a880ca5e3309e1fc67a4,0,Nathan Marz,2012-08-20 01:42:10-07:00,['f66ad0982d5a682d1294a64eada08cba33fa2f1f'],0,1,1,224226,1,,,,613
a4af188ab41ef83ea82badb0105b49e93755ad3f,0,Nathan Marz,2012-08-20 01:43:04-07:00,['2c17b41cd77ed4638b66a880ca5e3309e1fc67a4'],1,1,2,224228,1,,,,613
7f73c148248854181691b0eb81de48760b0a6e69,0,Jason Jackson,2012-08-20 15:48:02-07:00,"['a04991c705b361a962fa23bc25181ea97c475d2e', 'a4af188ab41ef83ea82badb0105b49e93755ad3f']",13,203,216,224444,11,,,,613
5cb7c33819b249fd6bc72e60e02428efbed9b193,1,Jason Jackson,2012-08-20 16:21:11-07:00,['7f73c148248854181691b0eb81de48760b0a6e69'],6,6,12,224456,2,,,,613
7ca5f84fcb77833e52a619df4d0ebad509255cce,0,Jason Jackson,2012-08-21 21:28:57-07:00,['ef68dd921633b702d9e5d235b5a36d2c50c35070'],17,32,49,224505,6,0.416666667,1,0.833333333,613
75655b65284b5371ecfb20abae5e61334a88c6d6,0,Nathan Marz,2012-08-22 12:59:30-07:00,['a4af188ab41ef83ea82badb0105b49e93755ad3f'],3,41,44,224549,4,0.428571429,0.428571429,0.428571429,614
1c085066c98721ebeb36765cb81498b7b62d3d7e,0,Nathan Marz,2012-08-22 13:00:03-07:00,['75655b65284b5371ecfb20abae5e61334a88c6d6'],0,1,1,224550,1,,,,614
dfae7ced8b87f3b3d0a90f1388bbc63f6427094a,0,Jason Jackson,2012-08-22 14:32:44-07:00,['7ca5f84fcb77833e52a619df4d0ebad509255cce'],5,5,10,224560,3,,,,614
8bf8f1cd22dfae841b9ccf837b852b45ee9f3161,0,Jason Jackson,2012-08-22 16:42:15-07:00,['dfae7ced8b87f3b3d0a90f1388bbc63f6427094a'],3,20,23,224583,1,0,0,0,614
a6a0570c09d99b4ff394760963c92395845a77e7,0,Jason Jackson,2012-08-22 16:52:59-07:00,['8bf8f1cd22dfae841b9ccf837b852b45ee9f3161'],4,4,8,224591,1,,,,614
add5809b63c4efa4d5b5d43c6eedc8a4755e6661,0,Nathan Marz,2012-08-22 17:06:06-07:00,['1c085066c98721ebeb36765cb81498b7b62d3d7e'],2,23,25,224616,3,1,1,1,614
fcc39565bd097d70ad2b610dd9ebbd858b7be14e,0,Nathan Marz,2012-08-22 17:06:42-07:00,['add5809b63c4efa4d5b5d43c6eedc8a4755e6661'],0,1,1,224617,1,,,,614
de51ab19ccb7d266c248f38aa52b9b44d9fb71b7,0,Jason Jackson,2012-08-23 14:18:57-07:00,"['a6a0570c09d99b4ff394760963c92395845a77e7', '237d716003192d4ceea85e8526b25dcd38f9f49d']",0,0,0,224617,0,,,,614
99c7bcf801abf38fcc1df629c2700dbad5e04e35,0,Jason Jackson,2012-08-23 14:20:26-07:00,['de51ab19ccb7d266c248f38aa52b9b44d9fb71b7'],1,1,2,224619,1,,,,614
a4bbfcd1100da64a777a834a9a8df0f26f461f99,0,Jason Jackson,2012-08-23 14:24:12-07:00,"['99c7bcf801abf38fcc1df629c2700dbad5e04e35', '4e7868ef2e7d22b3649953d9ae9dc86ae0799246']",7,11,18,224637,2,,,,614
2075e5742acfc4f820813392fbd5e0d71c7e77a3,0,James Xu,2012-08-25 08:55:58+08:00,['0d35d439b3b26b44aac2bf174fc769155609df3b'],26,8,34,224671,5,0,0,0,614
c7b965a0c795fe2b717d0c0afb5a20b95e846ca8,0,Nathan Marz,2012-08-27 16:03:32-07:00,"['f6b56d248fbdc7bcab9fef05ca7980677f400efa', 'fcc39565bd097d70ad2b610dd9ebbd858b7be14e']",100,489,589,225260,33,,,,614
93178dade4d670e168898c2bba1da7a137cda34b,0,Nathan Marz,2012-08-27 16:05:59-07:00,"['c7b965a0c795fe2b717d0c0afb5a20b95e846ca8', '5cb7c33819b249fd6bc72e60e02428efbed9b193']",124,192,316,225576,33,,,,614
fc141fdef769baab6a292d03ca07246e5d4d12fe,0,danehammer,2012-08-27 20:48:03-05:00,['fcc39565bd097d70ad2b610dd9ebbd858b7be14e'],1,1,2,225578,1,,,,614
9ef8b8557fdd40d185449027dcbb5a6d4887e566,0,Nathan Marz,2012-08-27 19:37:41-07:00,"['fcc39565bd097d70ad2b610dd9ebbd858b7be14e', 'fc141fdef769baab6a292d03ca07246e5d4d12fe']",1,1,2,225580,1,,,,614
035bcc89227a23277b86efd4e913aeeeb01abad8,0,Nathan Marz,2012-08-27 21:32:36-07:00,['fcc39565bd097d70ad2b610dd9ebbd858b7be14e'],4,5,9,225589,1,,,,614
cd6cd99dc4296026a458e103599c4526077653df,0,Nathan Marz,2012-08-27 21:37:55-07:00,['035bcc89227a23277b86efd4e913aeeeb01abad8'],0,1,1,225590,1,,,,614
a55a21f2b3e8ac019be4c6eb3ef98926e2fa5493,0,Nathan Marz,2012-08-27 21:48:51-07:00,"['cd6cd99dc4296026a458e103599c4526077653df', '9ef8b8557fdd40d185449027dcbb5a6d4887e566']",1,1,2,225592,1,,,,614
205722d902733fc52827360f618ae552738d7ebc,0,Jason Jackson,2012-08-27 23:44:50-07:00,['fcc39565bd097d70ad2b610dd9ebbd858b7be14e'],2,72,74,225666,6,0.363636364,0.363636364,1,616
d4f6114b77d6ac3c7653d8c048126a24a1475600,0,Jason Jackson,2012-08-28 00:00:12-07:00,['205722d902733fc52827360f618ae552738d7ebc'],12,4,16,225682,1,0,0,0,616
634a35fbc75241ca3f252daa808281ee1fcf9592,0,Jason Jackson,2012-08-28 09:33:52-07:00,['d4f6114b77d6ac3c7653d8c048126a24a1475600'],1,0,1,225683,1,1,1,0,616
b6fa72ec5caba786271d49e806b71d9cf362c54f,0,Nathan Marz,2012-08-28 14:40:35-07:00,['a55a21f2b3e8ac019be4c6eb3ef98926e2fa5493'],1,1,2,225685,1,,,,616
b901169c6e2065a34333de56af059c14e22b590c,0,Nathan Marz,2012-08-28 14:40:51-07:00,['b6fa72ec5caba786271d49e806b71d9cf362c54f'],0,1,1,225686,1,,,,616
0929e11cb001e3914d1606e695cbeb888888776a,0,Nathan Marz,2012-08-28 15:15:12-07:00,['b901169c6e2065a34333de56af059c14e22b590c'],1,1,2,225688,1,,,,616
7b2c09e3b03ac019e652857f02f280bb8b166800,0,Nathan Marz,2012-08-28 16:19:07-07:00,['0929e11cb001e3914d1606e695cbeb888888776a'],0,32,32,225720,2,1,1,1,617
9b0cff8b475f7e45e9aefc1e65e9dab178836bd0,0,Jason Jackson,2012-08-28 16:37:19-07:00,['634a35fbc75241ca3f252daa808281ee1fcf9592'],14,41,55,225775,2,,,,617
7e1438f636b32ad8bc3c43de43c77cdd404f74db,0,Jason Jackson,2012-08-28 16:47:00-07:00,['9b0cff8b475f7e45e9aefc1e65e9dab178836bd0'],23,23,46,225821,2,1,1,0,617
97e807d93d25ca260f1084350df85912fe336bde,0,Jason Jackson,2012-08-28 16:49:06-07:00,['7e1438f636b32ad8bc3c43de43c77cdd404f74db'],1,1,2,225823,1,,,,617
ac77ae14a2d64eb2d3e6ad85e2271f3f738f8c3a,0,Jason Jackson,2012-08-28 16:58:15-07:00,['97e807d93d25ca260f1084350df85912fe336bde'],1,0,1,225824,1,,,,617
3113a404eb24af89133171dd9adca025f6fe231c,0,Nathan Marz,2012-08-28 16:59:33-07:00,"['7b2c09e3b03ac019e652857f02f280bb8b166800', 'ac77ae14a2d64eb2d3e6ad85e2271f3f738f8c3a']",18,105,123,225947,8,,,,617
f3b407a547978d1e9da829521e174341e35c2f32,0,Nathan Marz,2012-08-28 17:14:08-07:00,['3113a404eb24af89133171dd9adca025f6fe231c'],1,2,3,225950,2,,,,617
491e17494bb28a0c0765559c7f344b96c97535c3,0,Nathan Marz,2012-08-28 17:37:12-07:00,['f3b407a547978d1e9da829521e174341e35c2f32'],0,12,12,225962,1,1,1,1,617
db58ba2834037829052578f14368098b4ed5429c,0,Nathan Marz,2012-08-28 17:37:23-07:00,['491e17494bb28a0c0765559c7f344b96c97535c3'],1,1,2,225964,1,,,,617
8642d6acf9f01f3017e942696d312b44239900ae,0,Nathan Marz,2012-08-30 02:59:19-07:00,['db58ba2834037829052578f14368098b4ed5429c'],2,3,5,225969,2,,,,617
8e10be157ad2ae047045eac4dfc0b853b93bdc16,0,minghan,2012-09-02 18:00:28-07:00,['8642d6acf9f01f3017e942696d312b44239900ae'],0,2,2,225971,1,,,,617
92506f6d184a6df552ef1c222124c468a33ba139,0,Nathan Marz,2012-09-03 01:34:56-07:00,"['8642d6acf9f01f3017e942696d312b44239900ae', '8e10be157ad2ae047045eac4dfc0b853b93bdc16']",0,2,2,225973,1,,,,617
93a3f37017127b0f43e9bf00da8489550af8f92f,0,okapies,2012-09-04 22:48:41+09:00,['92506f6d184a6df552ef1c222124c468a33ba139'],0,29,29,226002,4,1,1,1,617
fdee6c9ee3d4ec4db38704f3cb5e4e4a54fb5d10,0,Nathan Marz,2012-09-05 16:00:54-07:00,['93a3f37017127b0f43e9bf00da8489550af8f92f'],0,2,2,226004,2,,,,617
204fbff026e5fdfe1964fbbaca16860f9765e614,0,Nathan Marz,2012-09-05 16:12:54-07:00,"['fdee6c9ee3d4ec4db38704f3cb5e4e4a54fb5d10', '2075e5742acfc4f820813392fbd5e0d71c7e77a3']",5,456,461,226465,9,,,,617
849b76d3468cdb0e77f3c6a1e5ef612201bf98d4,0,Nathan Marz,2012-09-05 16:28:03-07:00,['204fbff026e5fdfe1964fbbaca16860f9765e614'],18,18,36,226501,3,,,,617
a40f85c10caa602092709777b4eac0d9a413ab2b,0,Nathan Marz,2012-09-05 16:32:05-07:00,['849b76d3468cdb0e77f3c6a1e5ef612201bf98d4'],1,1,2,226503,1,,,,617
33897535857d9ead80e9feb22c0b27dc0c3350b0,0,Nathan Marz,2012-09-05 16:37:35-07:00,['a40f85c10caa602092709777b4eac0d9a413ab2b'],0,1,1,226504,1,,,,617
f72de0076775a4cd9f6d202e83e2104e7133b11e,0,Nathan Marz,2012-09-05 18:07:34-07:00,['33897535857d9ead80e9feb22c0b27dc0c3350b0'],1,0,1,226505,1,,,,617
872164c77a333a895415f9995576e2d130def0f2,0,Nathan Marz,2012-09-05 18:07:45-07:00,['f72de0076775a4cd9f6d202e83e2104e7133b11e'],1,0,1,226506,1,,,,617
bab56fd2994ad76dd2c8dc3aad4840ee91946517,0,Nathan Marz,2012-09-05 23:03:23-07:00,['872164c77a333a895415f9995576e2d130def0f2'],1,1,2,226508,1,,,,617
ecd26e52cda2998624c3bbb4f610f5b36019b0e1,1,Nathan Marz,2012-09-05 23:17:14-07:00,['bab56fd2994ad76dd2c8dc3aad4840ee91946517'],22,144,166,226674,11,1,1,1,621
89ac8eda7890a2ec8e440aeff4889405102694c6,0,Nathan Marz,2012-09-05 23:19:19-07:00,['ecd26e52cda2998624c3bbb4f610f5b36019b0e1'],0,2,2,226676,1,,,,621
16f52762a90cda728303fb6ff5d8b1095e10710b,0,Nathan Marz,2012-09-06 11:47:26-07:00,['89ac8eda7890a2ec8e440aeff4889405102694c6'],2,8,10,226686,2,0,0,1,621
4f8ba6cb6fc804b6dd324cf0ce904c437a75adde,0,Nathan Marz,2012-09-06 11:58:55-07:00,['16f52762a90cda728303fb6ff5d8b1095e10710b'],0,2,2,226688,2,,,,621
8926d2e192bc2e6b975f7d62b4dc0369138cbd84,0,Nathan Marz,2012-09-06 12:38:43-07:00,['4f8ba6cb6fc804b6dd324cf0ce904c437a75adde'],0,7,7,226695,1,,,,622
f8909bdc0b89027ac2d4d9a1100a0932b4341987,0,Nathan Marz,2012-09-06 12:39:09-07:00,['8926d2e192bc2e6b975f7d62b4dc0369138cbd84'],0,1,1,226696,1,,,,622
b741f92d81eca74a36f768af01c8916feb489969,0,Nathan Marz,2012-09-06 12:50:10-07:00,['f8909bdc0b89027ac2d4d9a1100a0932b4341987'],1,1,2,226698,1,,,,622
04bf652455d25befd557fe1f6e926e2b7ea06474,0,Nathan Marz,2012-09-06 15:46:31-07:00,['b741f92d81eca74a36f768af01c8916feb489969'],1,1,2,226700,1,,,,622
2840a00be2fb4479e481d097fc4aeffc7cffa817,0,Nathan Marz,2012-09-06 15:50:05-07:00,['e9688a5f84782450d9c9d5ce0a10adf258f92f1f'],2,2,4,226704,2,,,,622
ed2952111a56891fa50ea92a7361aebf7d50bfb9,0,Nathan Marz,2012-09-06 16:11:49-07:00,['04bf652455d25befd557fe1f6e926e2b7ea06474'],1,1,2,226706,1,,,,622
24ae774832795be4f5d396eff421fd3e308eb40e,0,Nathan Marz,2012-09-07 02:22:33-07:00,['ed2952111a56891fa50ea92a7361aebf7d50bfb9'],1,1,2,226708,1,,,,622
fc9bc4196a46ff46a15031801770d16ddbf336e3,0,Jason Jackson,2012-09-09 20:12:17-07:00,['24ae774832795be4f5d396eff421fd3e308eb40e'],395,2331,2726,229434,13,0.532185629,0.562874251,0.937874251,624
7b334c7ca3c76783d183f76a8f1debe7b85d7a6e,0,Jason Jackson,2012-09-09 21:27:19-07:00,['fc9bc4196a46ff46a15031801770d16ddbf336e3'],1,45,46,229480,1,,,,624
f0bf30c5281ce8884ebd85e1acced98ceb9dcfe7,0,Jason Jackson,2012-09-09 21:44:59-07:00,['7b334c7ca3c76783d183f76a8f1debe7b85d7a6e'],6,4,10,229490,1,,,,624
46db7ca9cc58f7a7dca2da7d3a4533ffb7ac4d48,0,Jason Jackson,2012-09-10 02:47:24-07:00,['24ae774832795be4f5d396eff421fd3e308eb40e'],11,92,103,229593,4,0.28,1,0.88,626
eebbc6abda9224dfde658e2d421f4dba8c54878a,0,Jason Jackson,2012-09-10 12:02:28-07:00,['46db7ca9cc58f7a7dca2da7d3a4533ffb7ac4d48'],1,2,3,229596,1,,,,626
12288578be9b0b4ebe5be817312dc5593572216f,0,Jason Jackson,2012-09-10 14:29:47-07:00,['eebbc6abda9224dfde658e2d421f4dba8c54878a'],26,69,95,229691,4,1,1,1,626
1fb58061dc16eefed27badc8245e6d1b78ea2dcc,0,Jason Jackson,2012-09-10 15:03:18-07:00,['12288578be9b0b4ebe5be817312dc5593572216f'],3,4,7,229698,1,,,,626
acb39026f599f5a0e29701d6232de8fd5a3332bf,0,Nathan Marz,2012-09-11 14:43:04-07:00,['2840a00be2fb4479e481d097fc4aeffc7cffa817'],3,11,14,229712,3,0.393939394,0,0.393939394,626
19d3f147028b360e17577ee9f3741c4995cba0df,0,Jason Jackson,2012-09-11 15:02:07-07:00,['1fb58061dc16eefed27badc8245e6d1b78ea2dcc'],62,83,145,229857,2,1,1,1,626
bcd775b37ac5c453f1308b2bdb89bb99f94224ec,0,Nathan Marz,2012-09-12 15:58:59-07:00,['24ae774832795be4f5d396eff421fd3e308eb40e'],4,14,18,229875,5,,,,626
f0488b1a0c6d925636c91e4e13d9a7f7da39b169,0,Sergey Lukjanov,2012-09-13 23:16:42+04:00,['bcd775b37ac5c453f1308b2bdb89bb99f94224ec'],1,1,2,229877,1,,,,626
2b868fe595d3bf00023247ce768dd91cfa24667d,0,Nathan Marz,2012-09-17 14:34:51-04:00,['bcd775b37ac5c453f1308b2bdb89bb99f94224ec'],0,1,1,229878,1,,,,626
288c72e1d811aad0c33318d1e800f3690f97e484,0,Nathan Marz,2012-09-17 14:36:40-04:00,"['2b868fe595d3bf00023247ce768dd91cfa24667d', '93178dade4d670e168898c2bba1da7a137cda34b']",124,193,317,230195,33,,,,626
3690995b096a4641b098e25bd61239f50ba4b866,0,Nathan Marz,2012-09-17 14:46:27-04:00,['288c72e1d811aad0c33318d1e800f3690f97e484'],2,2,4,230199,1,,,,626
7d6bd89d2f54ee594d6e7a85be177b67539c599b,0,Nathan Marz,2012-09-17 12:16:58-07:00,"['bcd775b37ac5c453f1308b2bdb89bb99f94224ec', 'f0488b1a0c6d925636c91e4e13d9a7f7da39b169']",1,1,2,230201,1,,,,626
c053c9462f6c9fbb54370ff601b38c5c738d333b,0,Nathan Marz,2012-09-17 15:22:11-04:00,"['2b868fe595d3bf00023247ce768dd91cfa24667d', '7d6bd89d2f54ee594d6e7a85be177b67539c599b']",1,1,2,230203,1,,,,626
5785ef2e91e1790ebde9a987bc45a4d3bbe510d1,0,Nathan Marz,2012-09-17 15:22:26-04:00,['c053c9462f6c9fbb54370ff601b38c5c738d333b'],0,6,6,230209,2,,,,626
4710bfe78ca704e6bf51c936483fd98d9aa88a82,0,Nathan Marz,2012-09-18 00:10:15-04:00,['5785ef2e91e1790ebde9a987bc45a4d3bbe510d1'],5,87,92,230301,6,,,,626
2d7affe17e5bfb386c35d4a06561e57a51d91c25,0,Nathan Marz,2012-09-18 00:26:22-04:00,"['3690995b096a4641b098e25bd61239f50ba4b866', '4710bfe78ca704e6bf51c936483fd98d9aa88a82']",5,93,98,230399,8,,,,626
1b7308498c727fbeab846a682512da3932ca4f28,0,Nathan Marz,2012-09-18 11:01:07-04:00,['4710bfe78ca704e6bf51c936483fd98d9aa88a82'],1,1,2,230401,1,,,,626
9ef86e0b24b0f4e0121ec05187cccf8eeed15811,0,Nathan Marz,2012-09-18 11:01:55-04:00,['1b7308498c727fbeab846a682512da3932ca4f28'],0,1,1,230402,1,,,,626
dbe98d4a69de252546cda87f4d46c7bf642ed507,0,Nathan Marz,2012-09-18 12:45:12-04:00,['9ef86e0b24b0f4e0121ec05187cccf8eeed15811'],21,102,123,230525,7,0.96,0.96,1,628
9a3e1ecfa8522f71f78f7fe2385af6f85978a6d2,0,Nathan Marz,2012-09-18 12:45:35-04:00,['dbe98d4a69de252546cda87f4d46c7bf642ed507'],1,1,2,230527,1,,,,628
a3650ef458cfe941f2cba26e112060f5bf7f6360,0,Nathan Marz,2012-09-24 11:41:51-05:00,['9a3e1ecfa8522f71f78f7fe2385af6f85978a6d2'],1,37,38,230565,7,1,1,0,630
96b9abc1891aced76cc27263537059d3ed016319,0,Jason Jackson,2012-09-26 16:26:34-07:00,['a3650ef458cfe941f2cba26e112060f5bf7f6360'],32,35,67,230632,1,,,,630
5fccaefdc2b9819c849e11548869856216755ebe,1,Jason Jackson,2012-09-26 16:42:12-07:00,['96b9abc1891aced76cc27263537059d3ed016319'],0,6,6,230638,1,0,0,0,630
daf930d9c646fd07f4d534d18ae0ee21f89e8be1,0,Nathan Marz,2012-09-27 15:56:09-04:00,['a3650ef458cfe941f2cba26e112060f5bf7f6360'],0,50,50,230688,6,0.913043478,0.956521739,0.956521739,631
3d7e68dfd7704c6ddaf2d9e91716f45e7c7f04e4,0,Nathan Marz,2012-09-27 15:56:34-04:00,['daf930d9c646fd07f4d534d18ae0ee21f89e8be1'],1,1,2,230690,1,,,,631
bec91fd7ad81003a8ba67e6a048116b18006f80d,0,Jason Jackson,2012-09-27 13:49:49-07:00,['5fccaefdc2b9819c849e11548869856216755ebe'],1,2,3,230693,1,,,,631
01c6bfde9bdfefce60aa5e2cdcfe9d32e1581e42,0,Nathan Marz,2012-09-27 13:55:23-07:00,"['3d7e68dfd7704c6ddaf2d9e91716f45e7c7f04e4', 'bec91fd7ad81003a8ba67e6a048116b18006f80d']",32,42,74,230767,2,,,,631
bbaa48da0dd24832703eeaa20cdfe174dc2423f2,0,Nathan Marz,2012-09-27 16:56:36-04:00,['01c6bfde9bdfefce60aa5e2cdcfe9d32e1581e42'],0,1,1,230768,1,,,,631
a57a5a08289d2eba6a8cc4bfcac006138c551043,0,Nathan Marz,2012-09-27 19:15:49-04:00,['bbaa48da0dd24832703eeaa20cdfe174dc2423f2'],1,1,2,230770,1,,,,631
4c1efb9a2e611a3ea8d01384089614293cca2598,0,Nathan Marz,2012-09-29 21:28:31-04:00,['a57a5a08289d2eba6a8cc4bfcac006138c551043'],9,43,52,230822,2,0,0,1,631
b9cd44ed22efc2c08b6cd9c4a57c694ee5a6e60f,0,Sergey Lukjanov,2012-09-30 17:14:56+04:00,['a57a5a08289d2eba6a8cc4bfcac006138c551043'],45,104,149,230971,2,1,0.575757576,0.848484848,632
9fa1f0b6653061f6c667abd79e3864e5b17c949c,0,Sergey Lukjanov,2012-09-30 18:22:10+04:00,['a57a5a08289d2eba6a8cc4bfcac006138c551043'],1,3,4,230975,1,,,,632
2576c9c942452f33f0a4ce424f8e9a4deae3889d,1,Nathan Marz,2012-10-01 18:43:27+02:00,['4c1efb9a2e611a3ea8d01384089614293cca2598'],24,85,109,231084,1,1,1,0.893617021,632
8e66e2ede9d0f33a44013bf46ed89e47c5a8ad81,0,Nathan Marz,2012-10-01 18:44:37+02:00,['2576c9c942452f33f0a4ce424f8e9a4deae3889d'],12,105,117,231201,7,0.780487805,0.804878049,0.658536585,635
b650cf24feb56d78d45ed9c4b201a44243b3d658,0,Nathan Marz,2012-10-01 18:45:23+02:00,['8e66e2ede9d0f33a44013bf46ed89e47c5a8ad81'],0,2,2,231203,1,,,,635
415731f287fe4707cc7c8e3f2bee51bbc805297c,0,Nathan Marz,2012-10-01 18:45:38+02:00,['b650cf24feb56d78d45ed9c4b201a44243b3d658'],1,1,2,231205,1,,,,635
54fc737a207cffa8d5013e58ed0a2778cd4ec170,0,Nathan Marz,2012-10-01 23:07:37+02:00,['415731f287fe4707cc7c8e3f2bee51bbc805297c'],7,11,18,231223,1,,,,635
04a1077ec4680a23daae62aaea58ff00e859a0a3,0,Nathan Marz,2012-10-01 23:08:12+02:00,['54fc737a207cffa8d5013e58ed0a2778cd4ec170'],0,1,1,231224,1,,,,635
af3d749f315de2e92f46ac3a2f35fcf3be9fc257,0,Nathan Marz,2012-10-01 23:27:10+02:00,['04a1077ec4680a23daae62aaea58ff00e859a0a3'],3,8,11,231235,1,0,0,1,635
137b908020bb926b838477760fedada54b620f8c,0,Nathan Marz,2012-10-01 23:27:33+02:00,['af3d749f315de2e92f46ac3a2f35fcf3be9fc257'],1,1,2,231237,1,,,,635
d92ab837c0c767be4ba3df78aee494fbf416af2a,0,Nathan Marz,2012-10-01 23:47:47+02:00,['137b908020bb926b838477760fedada54b620f8c'],5,9,14,231251,1,0,0,1,635
890c974394d2d3fea32299aa5b4aa350a01c38f1,0,Nathan Marz,2012-10-01 23:47:59+02:00,['d92ab837c0c767be4ba3df78aee494fbf416af2a'],1,1,2,231253,1,,,,635
5303ca96272528f6aa42605280e205171bfa173d,0,Ross Feinstein,2012-10-05 20:22:25-04:00,['890c974394d2d3fea32299aa5b4aa350a01c38f1'],6,591,597,231850,4,0.839378238,0.966321244,0.992227979,635
821336675d072f229362abf7904f37a1b1747f15,0,Ross Feinstein,2012-10-05 20:22:41-04:00,['5303ca96272528f6aa42605280e205171bfa173d'],0,3,3,231853,1,,,,635
cada14bb1b71685baad6eda4587a06da5066ffc7,0,Sergey Lukjanov,2012-10-08 16:06:11+04:00,['b9cd44ed22efc2c08b6cd9c4a57c694ee5a6e60f'],6,15,21,231874,2,1,1,0.6,635
86544cd3cc6ad94af5533be70d9fb9bfa72f02c2,0,Nathan Marz,2012-10-09 14:19:09-07:00,"['890c974394d2d3fea32299aa5b4aa350a01c38f1', '9fa1f0b6653061f6c667abd79e3864e5b17c949c']",1,3,4,231878,1,,,,635
99fe5d73a02a440b89a623cded8b1ba325de5a4b,0,Jason Jackson,2012-10-09 16:26:28-07:00,['f0bf30c5281ce8884ebd85e1acced98ceb9dcfe7'],19,18,37,231915,1,,,,635
33c9494dbc4d73cda21a2070a766dba8446ba938,0,Jason Jackson,2012-10-09 16:38:20-07:00,['99fe5d73a02a440b89a623cded8b1ba325de5a4b'],219,215,434,232349,1,,,,635
e02d88cbf1ffccef3313348afe2b55de9ad40a16,0,Jason Jackson,2012-10-09 16:55:32-07:00,"['33c9494dbc4d73cda21a2070a766dba8446ba938', '86544cd3cc6ad94af5533be70d9fb9bfa72f02c2']",110,595,705,233054,32,,,,635
8f468e54868873025978f264caa75f6ea3b0330e,0,Jason Jackson,2012-10-09 17:03:01-07:00,['e02d88cbf1ffccef3313348afe2b55de9ad40a16'],2,2,4,233058,1,,,,635
be4542f0d7575b4617431888ec4859d26d03eac2,0,Jason Jackson,2012-10-09 23:04:34-07:00,['19d3f147028b360e17577ee9f3741c4995cba0df'],57,91,148,233206,1,1,1,1,635
c562abca5ce49947f345b9ab45ab10a9c10b8f65,0,Jason Jackson,2012-10-09 23:24:33-07:00,['be4542f0d7575b4617431888ec4859d26d03eac2'],5,25,30,233236,3,1,1,1,635
b870d194193d33568aa58ebec6a36ed30a981bcc,0,Jason Jackson,2012-10-09 23:25:08-07:00,"['c562abca5ce49947f345b9ab45ab10a9c10b8f65', '86544cd3cc6ad94af5533be70d9fb9bfa72f02c2']",109,593,702,233938,32,,,,635
274391a6b4ea5f4ea7ee36a5311aab6c155dbe40,0,Sergey Lukjanov,2012-10-10 10:55:59+04:00,['cada14bb1b71685baad6eda4587a06da5066ffc7'],3,12,15,233953,3,1,1,1,636
95b2f89c74079abfeeea9ff608c018061b536168,0,Sergey Lukjanov,2012-10-10 17:45:33+04:00,['274391a6b4ea5f4ea7ee36a5311aab6c155dbe40'],12,4,16,233969,1,,,,636
60dc00149b1eb663437b8355c006fc4ccf43a6b4,0,Nathan Marz,2012-10-10 09:37:49-07:00,['890c974394d2d3fea32299aa5b4aa350a01c38f1'],22,70,92,234061,8,0.166666667,0.595238095,0.476190476,636
32ce0610d96839174a66bdc68dfdd9d589595df6,0,Nathan Marz,2012-10-10 09:38:14-07:00,['60dc00149b1eb663437b8355c006fc4ccf43a6b4'],1,1,2,234063,1,,,,636
dbcbf72d5c43a14fa317fdc90d552a367a093d2f,0,Nathan Marz,2012-10-10 09:38:33-07:00,"['32ce0610d96839174a66bdc68dfdd9d589595df6', '86544cd3cc6ad94af5533be70d9fb9bfa72f02c2']",1,3,4,234067,1,,,,636
aa47e72cd6d678f7cae15306d4cb664e8ef41a42,0,Nathan Marz,2012-10-10 09:39:02-07:00,['dbcbf72d5c43a14fa317fdc90d552a367a093d2f'],0,1,1,234068,1,,,,636
faf33a7d1abb884f3bef8ba005b1e6c9c41b15c0,0,Nathan Marz,2012-10-10 09:47:30-07:00,"['aa47e72cd6d678f7cae15306d4cb664e8ef41a42', '821336675d072f229362abf7904f37a1b1747f15']",6,594,600,234668,4,,,,636
c6cec6b29ff34bea2457a79a07c9b1359b7c85d5,0,Nathan Marz,2012-10-10 10:35:43-07:00,['faf33a7d1abb884f3bef8ba005b1e6c9c41b15c0'],0,148,148,234816,2,0.820754717,0.70754717,0.905660377,636
d72ad23adab674b1aa9254871498036755cea365,0,Nathan Marz,2012-10-10 10:36:08-07:00,['c6cec6b29ff34bea2457a79a07c9b1359b7c85d5'],1,1,2,234818,1,,,,636
5a5f18103a4b3abff6fdd0ada783c32ffcf5eb1c,0,Nathan Marz,2012-10-10 10:37:20-07:00,['aa47e72cd6d678f7cae15306d4cb664e8ef41a42'],0,2,2,234820,2,,,,636
4f0da194eac8d080394db3a91fc7a7a9e4b43dfe,0,Nathan Marz,2012-10-10 10:37:42-07:00,"['5a5f18103a4b3abff6fdd0ada783c32ffcf5eb1c', 'd72ad23adab674b1aa9254871498036755cea365']",7,743,750,235570,7,,,,636
13b9d4aea5a807331c324b4cd95659a483c0a2db,0,Nathan Marz,2012-10-10 10:38:27-07:00,['4f0da194eac8d080394db3a91fc7a7a9e4b43dfe'],2,2,4,235574,1,,,,636
f129bbc55d3666c415e1bcaf71b3585af5d98dc5,0,Jason Jackson,2012-10-10 12:03:53-07:00,['8f468e54868873025978f264caa75f6ea3b0330e'],8,5,13,235587,1,,,,636
665490fd6fa62b5ea9a431dc36c4cd776731c7bf,0,Jason Jackson,2012-10-10 12:12:17-07:00,['b870d194193d33568aa58ebec6a36ed30a981bcc'],1,1,2,235589,1,,,,636
719f359c7cd4048197ab789a54167eab63fdb48e,0,Nathan Marz,2012-10-10 12:57:41-07:00,"['13b9d4aea5a807331c324b4cd95659a483c0a2db', '665490fd6fa62b5ea9a431dc36c4cd776731c7bf']",90,291,381,235970,7,,,,636
8c1472309fd7d36706d8ca1516f8226fa4bf03b9,0,Nathan Marz,2012-10-10 13:06:42-07:00,['719f359c7cd4048197ab789a54167eab63fdb48e'],9,8,17,235987,4,0,0,1,636
cae96422563dc9be443d1da91f1738b2e6d7ae9e,0,Nathan Marz,2012-10-10 13:07:43-07:00,['13b9d4aea5a807331c324b4cd95659a483c0a2db'],0,1,1,235988,1,,,,636
710f1096dd37b7b8e3a54440d8018017f24b68bd,0,Nathan Marz,2012-10-10 13:08:01-07:00,['cae96422563dc9be443d1da91f1738b2e6d7ae9e'],1,1,2,235990,1,,,,636
b4ad6a80b120cca1a2d5f9c174282d6f18f89313,0,Nathan Marz,2012-10-10 13:08:19-07:00,"['710f1096dd37b7b8e3a54440d8018017f24b68bd', '8c1472309fd7d36706d8ca1516f8226fa4bf03b9']",90,290,380,236370,7,,,,636
ae5d493b649d6f1803b66016bcabaa5c882a093b,0,Nathan Marz,2012-10-10 13:09:00-07:00,"['b4ad6a80b120cca1a2d5f9c174282d6f18f89313', 'f129bbc55d3666c415e1bcaf71b3585af5d98dc5']",213,2184,2397,238767,14,,,,636
54e527e0a560cc8a59a1374e5b70a86e7c3f6796,0,Nathan Marz,2012-10-10 13:34:10-07:00,['ae5d493b649d6f1803b66016bcabaa5c882a093b'],7,23,30,238797,3,1,1,0,636
c1a3a524abd078631251ce35d7ff36141176beb2,0,Sergey Lukjanov,2012-10-11 00:51:11+04:00,"['95b2f89c74079abfeeea9ff608c018061b536168', '54e527e0a560cc8a59a1374e5b70a86e7c3f6796']",1621,4802,6423,245220,45,,,,636
1b38b82bf322a4ffc6149fa6406f2dba1a5cdfdb,0,Sergey Lukjanov,2012-10-11 02:37:39+04:00,['c1a3a524abd078631251ce35d7ff36141176beb2'],28,56,84,245304,2,0,0,0.368421053,636
b27a54f0b9fdf3bbae27dcbb22261eaf2d3bbdfd,0,Sergey Lukjanov,2012-10-11 03:00:34+04:00,['1b38b82bf322a4ffc6149fa6406f2dba1a5cdfdb'],4,5,9,245313,1,,,,636
e7a3beeba4286c1d266f2ed078b1bd020d9e50d7,0,Sergey Lukjanov,2012-10-11 03:01:46+04:00,['b27a54f0b9fdf3bbae27dcbb22261eaf2d3bbdfd'],1,1,2,245315,1,,,,636
b45489144b92f4234377d1226e5255b60848d2b1,0,Sergey Lukjanov,2012-10-11 03:05:38+04:00,['e7a3beeba4286c1d266f2ed078b1bd020d9e50d7'],4,4,8,245323,1,,,,636
9c85b3fadb0248c4769f6d3cce3aaf6c0e6f2bab,0,Nathan Marz,2012-10-10 16:43:24-07:00,"['54e527e0a560cc8a59a1374e5b70a86e7c3f6796', 'b45489144b92f4234377d1226e5255b60848d2b1']",44,142,186,245509,3,,,,636
efe423124f3ad54b5a813789e588f3ee5b63d609,0,Nathan Marz,2012-10-10 16:44:52-07:00,['9c85b3fadb0248c4769f6d3cce3aaf6c0e6f2bab'],0,1,1,245510,1,,,,636
692b573a1a2aedd0d30ac892da7b34b22eaa81b1,0,Nathan Marz,2012-10-10 16:53:41-07:00,['efe423124f3ad54b5a813789e588f3ee5b63d609'],1,1,2,245512,1,,,,636
8ccb15a7641dfc97de0aa90a36a285e5e9efa023,0,Nathan Marz,2012-10-10 19:23:09-07:00,"['2d7affe17e5bfb386c35d4a06561e57a51d91c25', '692b573a1a2aedd0d30ac892da7b34b22eaa81b1']",1706,5165,6871,252383,55,,,,636
3a146c6b9f6cab1bae18078f36f463fdf899b299,1,Nathan Marz,2012-10-12 13:16:14-07:00,['692b573a1a2aedd0d30ac892da7b34b22eaa81b1'],2,7,9,252392,1,0,0,0,636
d6c2736aaa6980cde2f530b544508e7ce5f457af,1,Nathan Marz,2012-10-12 18:47:44-07:00,['3a146c6b9f6cab1bae18078f36f463fdf899b299'],83,165,248,252640,11,0.102564103,0,0,637
92b6a0aa112e10dc7059e40940ef7af6d696f308,0,Nathan Marz,2012-10-13 10:04:58-07:00,['4e7868ef2e7d22b3649953d9ae9dc86ae0799246'],65,111,176,252816,2,1,1,0.814814815,638
f046c2bf8a297d237e076868655e70606860de59,0,Nathan Marz,2012-10-13 10:05:36-07:00,['92b6a0aa112e10dc7059e40940ef7af6d696f308'],294,14,308,253124,6,0.272727273,0,0.428571429,638
58eb982708b778feba1db86aa4fd847567447195,0,Nathan Marz,2012-10-13 10:10:43-07:00,"['f046c2bf8a297d237e076868655e70606860de59', 'a4bbfcd1100da64a777a834a9a8df0f26f461f99']",61,165,226,253350,6,,,,638
32076c24839b1ea3763fc63918aeeb2897cf6b77,0,Nathan Marz,2012-10-13 13:10:39-07:00,['58eb982708b778feba1db86aa4fd847567447195'],1,311,312,253662,8,0.564102564,0.666666667,0.5,645
e6f0daf07a601712e3611628876cb66f36e5f304,0,Nathan Marz,2012-10-13 13:20:49-07:00,"['1b06f21257c2b3ffff491a55e7d87b29063d8b8b', '32076c24839b1ea3763fc63918aeeb2897cf6b77']",501,1076,1577,255239,26,,,,645
14289132abfb8749012faf663d281f336451b703,1,Nathan Marz,2012-10-13 14:46:57-07:00,['d6c2736aaa6980cde2f530b544508e7ce5f457af'],1,20,21,255260,4,0,0,0,645
fbca0982d9d88c2a229bb254ffc38e1c2954df11,0,Nathan Marz,2012-10-13 15:08:18-07:00,['e6f0daf07a601712e3611628876cb66f36e5f304'],64,209,273,255533,9,1,1,0.927536232,648
7e074cfe5c88dd927c2f87bff985e93228ff0b13,0,Nathan Marz,2012-10-13 15:08:56-07:00,['fbca0982d9d88c2a229bb254ffc38e1c2954df11'],1,1,2,255535,1,,,,648
1003690cee89cd6600c9ffc13fa3fdda3d823a3d,0,Nathan Marz,2012-10-13 15:09:46-07:00,"['8ccb15a7641dfc97de0aa90a36a285e5e9efa023', '14289132abfb8749012faf663d281f336451b703']",85,191,276,255811,12,,,,648
201fe37a69b749b5ba47afd33d8b2f4a19ba72ea,0,Nathan Marz,2012-10-13 15:10:07-07:00,['1003690cee89cd6600c9ffc13fa3fdda3d823a3d'],1,1,2,255813,1,,,,648
3641921f21d20a631cf1d24c5642d985b166accf,0,Nathan Marz,2012-10-13 15:10:29-07:00,['7e074cfe5c88dd927c2f87bff985e93228ff0b13'],1,1,2,255815,1,,,,648
0c559cdd7218e882c2cf9fb6933e6a9bf007e290,0,Nathan Marz,2012-10-13 15:14:58-07:00,['201fe37a69b749b5ba47afd33d8b2f4a19ba72ea'],1,9,10,255825,1,,,,648
7fd0575aa305d00a88065a39d470dcfab28e245d,0,Nathan Marz,2012-10-13 15:16:15-07:00,['3641921f21d20a631cf1d24c5642d985b166accf'],1,1,2,255827,1,,,,648
ef2a114393cf047975cfef49aedbee9590cc9545,0,Gabriel Silk,2012-10-15 18:38:57-07:00,['3a146c6b9f6cab1bae18078f36f463fdf899b299'],2,4,6,255833,1,,,,648
1c0e1992a27d68bbb56151b847955a65a5fd0118,0,Gabriel Silk,2012-10-15 23:37:14-07:00,['ef2a114393cf047975cfef49aedbee9590cc9545'],1,5,6,255839,1,,,,648
d8ba460a9e58feef2d661fb7239adc048c474d56,0,Nathan Marz,2012-10-16 14:41:44-07:00,['ef2a114393cf047975cfef49aedbee9590cc9545'],1,1,2,255841,1,,,,648
64c9ae4df8b277dddb4a426d92f609bd307f482c,0,Nathan Marz,2012-10-16 14:42:01-07:00,['d8ba460a9e58feef2d661fb7239adc048c474d56'],1,0,1,255842,1,,,,648
535b5fdfa357a685579529b67d16ec6a9a56b97b,0,Nathan Marz,2012-10-16 14:51:22-07:00,"['64c9ae4df8b277dddb4a426d92f609bd307f482c', '1c0e1992a27d68bbb56151b847955a65a5fd0118']",1,5,6,255848,1,,,,648
bf6dc80568eb1c847179fcc24755c8a89403c398,0,Nathan Marz,2012-10-18 00:26:54-07:00,"['535b5fdfa357a685579529b67d16ec6a9a56b97b', 'dfb9ad36e7011bf5452fc3f8c9493045ead5509e']",3,3,6,255854,1,,,,648
6f1d888f59e579d9fb4bbdc85b9c42da96c9b5bf,0,Sergey Lukjanov,2012-10-18 18:50:39+04:00,['535b5fdfa357a685579529b67d16ec6a9a56b97b'],1,1,2,255856,1,,,,648
9930eeacff96a0005d7a1453d14f31a05bacbc13,0,Nathan Marz,2012-10-18 11:25:26-07:00,['6f1d888f59e579d9fb4bbdc85b9c42da96c9b5bf'],1,1,2,255858,1,,,,648
6fac795843a4e51927ecb7245b2013df86b9b0d1,0,Nathan Marz,2012-10-18 11:43:40-07:00,"['9930eeacff96a0005d7a1453d14f31a05bacbc13', 'bf6dc80568eb1c847179fcc24755c8a89403c398']",3,3,6,255864,1,,,,648
2f2e54d234e42146e7142f54dd9acdd5cffd49d1,1,Nathan Marz,2012-10-18 11:59:47-07:00,['6fac795843a4e51927ecb7245b2013df86b9b0d1'],1,13,14,255878,2,1,1,1,648
6cf173409a4dff054e0af1cb1ce2849763a36d1d,1,Nathan Marz,2012-10-18 12:20:43-07:00,['2f2e54d234e42146e7142f54dd9acdd5cffd49d1'],1,2,3,255881,1,,,,648
c1dba193a21939f282c68ff4a17de919bb3c1500,0,Nathan Marz,2012-10-18 12:22:45-07:00,['6fac795843a4e51927ecb7245b2013df86b9b0d1'],1,3,4,255885,2,,,,648
97091a976e245ba1fc8a934742821df924c56dee,0,Nathan Marz,2012-10-18 12:31:11-07:00,['c1dba193a21939f282c68ff4a17de919bb3c1500'],1,5,6,255891,1,,,,648
a62807cb84986ef9ec60cb7a3db3a28557d34a51,0,Nathan Marz,2012-10-18 12:31:14-07:00,"['97091a976e245ba1fc8a934742821df924c56dee', '6cf173409a4dff054e0af1cb1ce2849763a36d1d']",2,15,17,255908,2,,,,648
0562d43a8a7dc20dfe98e09c24414f79a9ac6f1a,1,Nathan Marz,2012-10-18 12:34:54-07:00,['a62807cb84986ef9ec60cb7a3db3a28557d34a51'],5,1,6,255914,1,,,,648
063c6ac9089ed141d4639ccfa5f14f61eacd18d5,0,Nathan Marz,2012-10-18 12:35:25-07:00,['0562d43a8a7dc20dfe98e09c24414f79a9ac6f1a'],0,1,1,255915,1,,,,648
9b3262037aa78a7e72c480d49a03befb27020373,1,Nathan Marz,2012-10-22 23:37:58-07:00,['063c6ac9089ed141d4639ccfa5f14f61eacd18d5'],59,33,92,256007,2,,,,648
68bf9a60bfd74be27db4170df613e89b15f63533,0,Nathan Marz,2012-10-23 00:10:14-07:00,['9b3262037aa78a7e72c480d49a03befb27020373'],6,22,28,256035,2,1,1,1,648
a0657f718b6ce911cde3c6a904983856d5fcd412,0,Nathan Marz,2012-10-23 09:29:43-07:00,['68bf9a60bfd74be27db4170df613e89b15f63533'],10,31,41,256076,3,1,1,1,648
20d6ad51d1818ff7c4c9aae48abc105b6c376779,1,Nathan Marz,2012-10-23 10:40:28-07:00,['a0657f718b6ce911cde3c6a904983856d5fcd412'],29,41,70,256146,3,,,,648
ea4f101a567115965823f89d17379e71ec301357,1,Bryan Peterson,2012-10-23 18:27:26-03:00,['063c6ac9089ed141d4639ccfa5f14f61eacd18d5'],0,9,9,256155,1,0.75,0.75,0.75,648
c2865d12a94c5ab2224314b1b30f75701e2bd4c4,1,Nathan Marz,2012-10-23 23:13:32-07:00,['20d6ad51d1818ff7c4c9aae48abc105b6c376779'],21,160,181,256336,11,0,0,0.96875,648
513177cea56319a1c3c2d5a38d44e15b3ba2dbd9,0,Nathan Marz,2012-10-23 23:14:50-07:00,['c2865d12a94c5ab2224314b1b30f75701e2bd4c4'],1,1,2,256338,1,,,,648
e78a9a703fe213d6fcf35eb5f956e80573ba9881,0,Nathan Marz,2012-10-23 23:19:06-07:00,['513177cea56319a1c3c2d5a38d44e15b3ba2dbd9'],1,1,2,256340,1,,,,648
bd963bca14d8ecd4c2eded3c6354045ebf73d505,0,Nathan Marz,2012-10-23 23:43:34-07:00,['e78a9a703fe213d6fcf35eb5f956e80573ba9881'],1,1,2,256342,1,,,,648
4870bd9e156e6aa12c50cfef1cdf859c5bceedc7,0,Nathan Marz,2012-10-23 23:43:50-07:00,['bd963bca14d8ecd4c2eded3c6354045ebf73d505'],1,1,2,256344,1,,,,648
810e6769565827d57e5669025cd9ad1e890236f6,0,Nathan Marz,2012-10-24 00:23:30-07:00,"['0c559cdd7218e882c2cf9fb6933e6a9bf007e290', '4870bd9e156e6aa12c50cfef1cdf859c5bceedc7']",115,294,409,256753,23,,,,648
5599fd2b4951103e5f6f25babcb7094f8ddc4898,0,Nathan Marz,2012-10-24 00:24:56-07:00,['4870bd9e156e6aa12c50cfef1cdf859c5bceedc7'],0,2,2,256755,1,,,,648
55289623d4025d51c34a8aefae7cfaaec64bca46,0,Bryan,2012-10-24 10:10:52-04:00,['ea4f101a567115965823f89d17379e71ec301357'],12,25,37,256792,4,1,1,1,648
406b85b144d47c8f09d15025a96e10f0d73c53f5,0,Nathan Marz,2012-10-24 10:29:36-07:00,"['5599fd2b4951103e5f6f25babcb7094f8ddc4898', '55289623d4025d51c34a8aefae7cfaaec64bca46']",9,31,40,256832,4,,,,648
54f662ebc6959dd30bbf1d21f3b79738ed534997,0,Nathan Marz,2012-10-24 12:35:04-07:00,['406b85b144d47c8f09d15025a96e10f0d73c53f5'],180,0,180,257012,2,,,,648
255122cd1f6e3d04c5f1acc5fe7b569a9b7a0f0f,0,Nathan Marz,2012-10-24 12:36:46-07:00,['54f662ebc6959dd30bbf1d21f3b79738ed534997'],0,2,2,257014,2,,,,648
0449d31afae47c00ece64dd11aff8f7a261df5a6,0,Stuart Anderson,2012-10-24 13:58:22-07:00,['255122cd1f6e3d04c5f1acc5fe7b569a9b7a0f0f'],2,10,12,257026,1,1,1,1,648
eab38ea2eff651ae321b66df44f8f22e49d81d27,0,Nathan Marz,2012-10-24 22:47:41-07:00,['255122cd1f6e3d04c5f1acc5fe7b569a9b7a0f0f'],11,0,11,257037,2,,,,648
b06a11630324f656196c1374075138cf1105af10,0,Nathan Marz,2012-10-24 23:21:05-07:00,['eab38ea2eff651ae321b66df44f8f22e49d81d27'],321,830,1151,258188,15,0.118598383,0.045822102,0.970350404,649
c1a4c8972affec99ef4be6333107d35182dd71bf,0,Nathan Marz,2012-10-24 23:21:44-07:00,['b06a11630324f656196c1374075138cf1105af10'],0,2,2,258190,1,,,,649
ae825eb9713913cf2caef742fa4dd3a52ecceec3,0,Nathan Marz,2012-10-25 11:41:42-07:00,['7fd0575aa305d00a88065a39d470dcfab28e245d'],12,33,45,258235,3,0.133333333,0.4,0.133333333,649
6a24cb0e012c65f68513e0db0feeb30a192f70f6,0,Nathan Marz,2012-10-25 11:56:59-07:00,['c1a4c8972affec99ef4be6333107d35182dd71bf'],3,30,33,258268,2,1,1,1,650
bf17856c18941d385d08fd17a9c9fd6f9a60d7a2,0,Nathan Marz,2012-10-25 11:57:26-07:00,['6a24cb0e012c65f68513e0db0feeb30a192f70f6'],0,1,1,258269,1,,,,650
f473629afa6270ede8187ed6da4449844d87cec7,0,Nathan Marz,2012-10-25 11:57:54-07:00,['bf17856c18941d385d08fd17a9c9fd6f9a60d7a2'],1,1,2,258271,1,,,,650
9acacb77cab8eb5399cbe4bef7a25ce7d3b398ff,0,Nathan Marz,2012-10-25 12:20:47-07:00,['f473629afa6270ede8187ed6da4449844d87cec7'],1,1,2,258273,1,,,,650
e8d886485923b0f7a5101e55ded48103751f55a0,0,Nathan Marz,2012-10-25 12:33:42-07:00,['9acacb77cab8eb5399cbe4bef7a25ce7d3b398ff'],1,3,4,258277,1,1,1,1,650
d527be5946fa9ea086d33b41147acc172a644fed,0,Nathan Marz,2012-10-25 12:45:47-07:00,"['810e6769565827d57e5669025cd9ad1e890236f6', 'e8d886485923b0f7a5101e55ded48103751f55a0']",518,891,1409,259686,28,,,,650
fd0d33161bd3c72e8dc650719d4b6b9cdcf3fa78,0,Nathan Marz,2012-10-25 14:26:51-07:00,['acb39026f599f5a0e29701d6232de8fd5a3332bf'],1,1,2,259688,1,,,,650
ecafdcd732865bdfaf379a62a223a90947e30b93,0,Nathan Marz,2012-10-25 14:30:46-07:00,['d527be5946fa9ea086d33b41147acc172a644fed'],1,1,2,259690,1,,,,650
cccbb7f22fecf5e0a22a50dd64cbf061cc9a9d12,0,James Xu,2012-10-27 15:09:03+08:00,['e8d886485923b0f7a5101e55ded48103751f55a0'],1,100,101,259791,2,1,1,0.56,650
7759a54c7a30fb1090bb3d7700c47a5cc87e32ca,0,James Xu,2012-10-28 01:15:57+08:00,['e8d886485923b0f7a5101e55ded48103751f55a0'],8,75,83,259874,3,1,1,1,651
5b0f83224400e7f9cde332fe86991b26417f49b4,0,James Xu,2012-10-28 01:36:09+08:00,['7759a54c7a30fb1090bb3d7700c47a5cc87e32ca'],3,5,8,259882,1,,,,651
0d1b51c0f16e4f8211e23d7993615012477e9c07,0,Nathan Marz,2012-10-29 14:58:30-07:00,['5b0f83224400e7f9cde332fe86991b26417f49b4'],0,1,1,259883,1,,,,651
e69bf555bed5ed27ff73fcbbc2117d604946dc44,0,Nathan Marz,2012-10-29 15:04:08-07:00,['0d1b51c0f16e4f8211e23d7993615012477e9c07'],14,32,46,259929,4,,,,651
d53f3d54b95b9d65f9b6120381a43ade812d4cd6,0,Nathan Marz,2012-10-29 15:04:34-07:00,['e69bf555bed5ed27ff73fcbbc2117d604946dc44'],0,1,1,259930,1,,,,651
6c7c3cca93b21ddb8b678bd12d50bbda6952e143,0,Nathan Marz,2012-10-29 15:10:33-07:00,"['ecafdcd732865bdfaf379a62a223a90947e30b93', 'd53f3d54b95b9d65f9b6120381a43ade812d4cd6']",22,111,133,260063,8,,,,651
3a8bfe7234e16e0c8825108eade9cf978848b417,0,Nathan Marz,2012-10-29 15:13:29-07:00,"['d53f3d54b95b9d65f9b6120381a43ade812d4cd6', 'cccbb7f22fecf5e0a22a50dd64cbf061cc9a9d12']",1,100,101,260164,2,,,,651
5f535c5ce06fa98550513f508a02aadb76571475,0,Nathan Marz,2012-10-29 15:18:41-07:00,['3a8bfe7234e16e0c8825108eade9cf978848b417'],1,1,2,260166,1,,,,651
97b5bfab6fdd6550f77a1952641fd69cbf060938,0,Nathan Marz,2012-10-29 15:19:27-07:00,['5f535c5ce06fa98550513f508a02aadb76571475'],0,1,1,260167,1,,,,651
6b1796fd77299a688dd45a8dcbdabec579092241,0,Nathan Marz,2012-10-29 15:19:33-07:00,"['6c7c3cca93b21ddb8b678bd12d50bbda6952e143', '97b5bfab6fdd6550f77a1952641fd69cbf060938']",1,101,102,260269,3,,,,651
1a9dca46abe4c937e6b5874a9d1b178163a95af4,1,Nathan Marz,2012-10-30 12:07:32-07:00,['97b5bfab6fdd6550f77a1952641fd69cbf060938'],26,98,124,260393,5,0,1,1,651
10e86392804e6dafece1cd796d76246407832bea,0,Nathan Marz,2012-10-30 12:10:21-07:00,['1a9dca46abe4c937e6b5874a9d1b178163a95af4'],0,1,1,260394,1,,,,651
cf67a089d94c8593457cfdf68271dffc17d8d43c,0,Nathan Marz,2012-10-30 12:10:31-07:00,"['6b1796fd77299a688dd45a8dcbdabec579092241', '10e86392804e6dafece1cd796d76246407832bea']",26,99,125,260519,6,,,,651
4a01197115ea84e8be627fa102ae18c40f94c47b,0,Jason Jackson,2012-10-31 15:32:39-07:00,['10e86392804e6dafece1cd796d76246407832bea'],40,342,382,260901,17,1,1,0.781609195,660
a45098d7e32586484a611232cfe1727e008f46cb,0,Jason Jackson,2012-10-31 18:41:47-07:00,['4a01197115ea84e8be627fa102ae18c40f94c47b'],14,39,53,260954,11,1,1,0,660
d4d8e9bd4696f128f454b45da57c23a8283b0fc7,1,Jason Jackson,2012-10-31 18:43:28-07:00,['a45098d7e32586484a611232cfe1727e008f46cb'],47,72,119,261073,9,1,1,0,660
d210aec9c6880f7c388f014b2a76563617f45575,0,Jason Jackson,2012-10-31 19:08:19-07:00,['d4d8e9bd4696f128f454b45da57c23a8283b0fc7'],4,48,52,261125,5,0.19047619,1,0.571428571,662
a3885fddac794c2fb960fb86bf421f6dcd3512ef,0,Jason Jackson,2012-10-31 19:11:56-07:00,['d210aec9c6880f7c388f014b2a76563617f45575'],1,1,2,261127,1,,,,662
b375d5a0c6954cdea52500ee0fdce84955c01399,0,Jason Jackson,2012-11-01 14:27:41-07:00,['a3885fddac794c2fb960fb86bf421f6dcd3512ef'],1,88,89,261216,3,,,,664
d32701f554bee472f9e848194a8d2070ec31f879,1,Jason Jackson,2012-11-02 13:34:39-07:00,['b375d5a0c6954cdea52500ee0fdce84955c01399'],4,6,10,261226,3,,,,664
f1a4cf3ec77680d2e543dbae97dbdbabdd0fbcdc,1,Jason Jackson,2012-11-02 13:36:14-07:00,['d32701f554bee472f9e848194a8d2070ec31f879'],1,1,2,261228,1,,,,664
9e0a7388e89c685d71345328556b04ef992d00ae,0,Nathan Marz,2012-11-02 14:57:43-07:00,['cf67a089d94c8593457cfdf68271dffc17d8d43c'],7,8,15,261243,1,,,,664
69ada7049d110ff4aad5c5acc4471e3bf0383a6c,0,Jason Jackson,2012-11-02 15:11:17-07:00,['f1a4cf3ec77680d2e543dbae97dbdbabdd0fbcdc'],7,12,19,261262,5,,,,665
7207af53c0250c492bb4e00c383dfa8a5fe46f8c,0,Nathan Marz,2012-11-02 15:13:37-07:00,"['9e0a7388e89c685d71345328556b04ef992d00ae', '69ada7049d110ff4aad5c5acc4471e3bf0383a6c']",42,532,574,261836,24,,,,665
d1fc48c1987c3892848ef84f4c60f200068d63a4,0,Nathan Marz,2012-11-02 15:19:53-07:00,['7207af53c0250c492bb4e00c383dfa8a5fe46f8c'],1,1,2,261838,1,,,,665
63aaad01981cd1683a74ce81189ebf4a7a420fb0,0,Nathan Marz,2012-11-02 15:33:30-07:00,['ae825eb9713913cf2caef742fa4dd3a52ecceec3'],12,18,30,261868,6,,,,665
f5938c06a55c523b39ce12aabec3c6f422fe8b3d,0,Nathan Marz,2012-11-02 15:36:11-07:00,['63aaad01981cd1683a74ce81189ebf4a7a420fb0'],1,1,2,261870,1,,,,665
43842a8f35a4e83b89a8b7c71f9a81ab290fb2c0,0,Nathan Marz,2012-11-07 10:54:54-08:00,['10e86392804e6dafece1cd796d76246407832bea'],4,34,38,261908,1,,,,665
06b5c24992de246a1f7ef455558e9c42462a2653,0,Nathan Marz,2012-11-07 10:56:11-08:00,['43842a8f35a4e83b89a8b7c71f9a81ab290fb2c0'],0,1,1,261909,1,,,,665
5e35a647359c422494643611a617443281a8034e,0,Nathan Marz,2012-11-07 15:56:11-08:00,['06b5c24992de246a1f7ef455558e9c42462a2653'],1,1,2,261911,1,,,,665
e5ca8b8e4cf9ef7a3c12c1713be52f671995c638,0,Nathan Marz,2012-11-07 19:10:22-08:00,['5e35a647359c422494643611a617443281a8034e'],3,1,4,261915,1,0,0,0,665
4e6e668ec4f34f5bf3ec6d776c92e6002bb55987,0,Nathan Marz,2012-11-07 19:11:01-08:00,"['d1fc48c1987c3892848ef84f4c60f200068d63a4', 'e5ca8b8e4cf9ef7a3c12c1713be52f671995c638']",8,37,45,261960,4,,,,665
33eb6b05232d9c7a57b6438aceed1dfa50bc5ccf,0,Nathan Marz,2012-11-07 19:11:07-08:00,['4e6e668ec4f34f5bf3ec6d776c92e6002bb55987'],1,3,4,261964,1,1,1,1,665
67b3508856f47ab65cf4b0528bc02cfea955b926,0,Nathan Marz,2012-11-07 19:42:42-08:00,['e5ca8b8e4cf9ef7a3c12c1713be52f671995c638'],1,1,2,261966,1,,,,665
e544f0314c545b09a7a0dae9770704d038239c07,0,Nathan Marz,2012-11-07 19:51:02-08:00,['67b3508856f47ab65cf4b0528bc02cfea955b926'],4,6,10,261976,1,,,,665
7fcd47f12f245384c96d3d0dac371e3930000377,0,Sergey Lukjanov,2012-11-08 21:43:04+04:00,['67b3508856f47ab65cf4b0528bc02cfea955b926'],2,18,20,261996,1,,,,665
c26b95caed7b564f53b553d9a2b58915e78e7c38,0,Nathan Marz,2012-11-08 10:27:31-08:00,"['67b3508856f47ab65cf4b0528bc02cfea955b926', '7fcd47f12f245384c96d3d0dac371e3930000377']",2,18,20,262016,1,,,,665
45911a3256fe99e8c186e47cc7e2105ffbca21d6,0,Nathan Marz,2012-11-08 10:28:10-08:00,"['e544f0314c545b09a7a0dae9770704d038239c07', 'c26b95caed7b564f53b553d9a2b58915e78e7c38']",2,18,20,262036,1,,,,665
a85d809421b451480de98a3710b4d73284b760bb,0,Nathan Marz,2012-11-08 10:29:29-08:00,['45911a3256fe99e8c186e47cc7e2105ffbca21d6'],0,1,1,262037,1,,,,665
2a41f2108e40a2145416e98c052bb13c773a8219,0,Nathan Marz,2012-11-08 10:29:50-08:00,"['33eb6b05232d9c7a57b6438aceed1dfa50bc5ccf', 'a85d809421b451480de98a3710b4d73284b760bb']",6,25,31,262068,2,,,,665
863669e0d6838d78bfbf7d7b2a40292dafb6ae78,0,Jason Jackson,2012-11-08 14:17:51-08:00,['69ada7049d110ff4aad5c5acc4471e3bf0383a6c'],6,5,11,262079,4,0.5,0.5,1,665
eeca80ddf356f3533b195e60ba0373f302d8258c,0,Jason Jackson,2012-11-08 15:09:40-08:00,"['2a41f2108e40a2145416e98c052bb13c773a8219', '863669e0d6838d78bfbf7d7b2a40292dafb6ae78']",6,5,11,262090,4,,,,665
a993a147f4ea2aa3cc386ce2d5a745f2a1e9c9b2,0,Jason Jackson,2012-11-08 16:04:28-08:00,['eeca80ddf356f3533b195e60ba0373f302d8258c'],1,1,2,262092,1,,,,665
ffd8ac443f123331ed5c2642401106f5d25c2519,0,Jason Jackson,2012-11-08 16:05:12-08:00,['863669e0d6838d78bfbf7d7b2a40292dafb6ae78'],1,1,2,262094,1,,,,665
48201179ca6f245333ef3ffbc38c1820f0a35761,0,Stuart Anderson,2012-11-12 14:16:06-05:00,['a85d809421b451480de98a3710b4d73284b760bb'],0,150,150,262244,1,1,1,1,666
6bdd00eb1486c80514a9c1eabf53f77e0b9f4c3a,0,Stuart Anderson,2012-11-12 14:20:09-05:00,['48201179ca6f245333ef3ffbc38c1820f0a35761'],3,2,5,262249,1,,,,666
f2b212e48972d490446a5d2a02272ae8d9116a9c,0,Jason Jackson,2012-11-12 19:12:48-08:00,"['a993a147f4ea2aa3cc386ce2d5a745f2a1e9c9b2', 'ffd8ac443f123331ed5c2642401106f5d25c2519']",0,0,0,262249,0,,,,666
6cc99e37d1c6c4f51394f8bf7119d1ee801f159c,0,Nathan Marz,2012-11-13 16:50:40-08:00,['f5938c06a55c523b39ce12aabec3c6f422fe8b3d'],1,2,3,262252,1,,,,666
d6e9e63512544d1cf5e34c83af1e9cc7d8dfd4b0,0,Nathan Marz,2012-11-13 16:52:48-08:00,['6cc99e37d1c6c4f51394f8bf7119d1ee801f159c'],1,1,2,262254,1,,,,666
8d6bae43b596ebedf9b664cf8f54cd0fa622035e,0,Ofir Hamer,2012-11-16 15:56:54+00:00,['eda3c10913e7a8631d917bb626cbd443b06eb18e'],13,22,35,262289,6,1,1,1,666
079ebf8192a97d8e280790546005b04c5743e4a1,0,Jason Jackson,2012-11-19 19:27:32-08:00,['69ada7049d110ff4aad5c5acc4471e3bf0383a6c'],6,5,11,262300,4,0.5,0.5,1,666
0f59a40950fe3af6c4b00ec9fb2b6c5d84620fca,0,Jason Jackson,2012-11-19 19:27:58-08:00,['079ebf8192a97d8e280790546005b04c5743e4a1'],1,1,2,262302,1,,,,666
c177d096666496a06cf0e6282e2d6849f6641e61,1,Jason Jackson,2012-11-19 19:28:45-08:00,['0f59a40950fe3af6c4b00ec9fb2b6c5d84620fca'],82,402,484,262786,14,0.93220339,1,0.762711864,669
fe3fa6ccd6796263b1f87a3759f62886d8d746c3,0,Jason Jackson,2012-11-19 19:32:08-08:00,['c177d096666496a06cf0e6282e2d6849f6641e61'],1,12,13,262799,2,1,1,0,669
7694401ddf8bc8c988dd70414f1aae8d1540e02b,1,Gabriel Silk,2012-11-21 09:46:24-08:00,['a85d809421b451480de98a3710b4d73284b760bb'],1,5,6,262805,2,,,,669
feed4b8732f9badaa3f50f19726eccc500bba262,0,Ryan,2012-11-22 23:09:37+08:00,['e8d886485923b0f7a5101e55ded48103751f55a0'],2,2,4,262809,1,,,,669
dd781136c4ecc557ac9c1e22126fed36efa35c25,0,Nathan Marz,2012-11-25 13:06:05-08:00,"['2a41f2108e40a2145416e98c052bb13c773a8219', 'fe3fa6ccd6796263b1f87a3759f62886d8d746c3']",87,417,504,263313,17,,,,669
40264637f4188e5a9c2eb72632aeb3b9df275eeb,0,Nathan Marz,2012-11-25 13:31:15-08:00,['dd781136c4ecc557ac9c1e22126fed36efa35c25'],12,8,20,263333,3,,,,669
3105e72bf654666b113399616396f8ebdbb533e1,0,Nathan Marz,2012-11-25 23:37:25-08:00,"['a85d809421b451480de98a3710b4d73284b760bb', 'feed4b8732f9badaa3f50f19726eccc500bba262']",2,2,4,263337,1,,,,669
371400c2055862342849ce3bdc4af5254767873f,1,Sam Ritchie,2012-11-29 14:12:46-08:00,['3105e72bf654666b113399616396f8ebdbb533e1'],0,37,37,263374,3,1,1,1,672
f51396b31d3909de6e1548558b55d7fcbe481204,1,Sam Ritchie,2012-11-29 14:27:01-08:00,['371400c2055862342849ce3bdc4af5254767873f'],0,41,41,263415,1,1,1,1,673
27c01b4683fbe0755bc5479ff4c9e336bea6b81b,0,Sam Ritchie,2012-11-29 14:35:37-08:00,['f51396b31d3909de6e1548558b55d7fcbe481204'],19,0,19,263434,1,,,,673
05f09555c0dafeaffb973722a49ada6e99d6a89c,0,Nathan Marz,2012-11-29 14:37:22-08:00,"['3105e72bf654666b113399616396f8ebdbb533e1', '27c01b4683fbe0755bc5479ff4c9e336bea6b81b']",0,59,59,263493,4,,,,673
1188da38839a59867f89a4bb71b5e42ddad28e99,0,Nathan Marz,2012-11-30 09:45:08+11:00,['05f09555c0dafeaffb973722a49ada6e99d6a89c'],0,2,2,263495,2,,,,673
7d06aaacc2a7b1cabe18e1daeb5e11215602c48f,0,Nathan Marz,2012-11-29 14:47:33-08:00,"['1188da38839a59867f89a4bb71b5e42ddad28e99', '6bdd00eb1486c80514a9c1eabf53f77e0b9f4c3a']",0,149,149,263644,1,,,,673
3332a0d65b71aff74116487eef55a9cad4ac72c6,0,Nathan Marz,2012-11-29 14:48:13-08:00,"['7d06aaacc2a7b1cabe18e1daeb5e11215602c48f', '0449d31afae47c00ece64dd11aff8f7a261df5a6']",2,10,12,263656,1,,,,673
e8dd388e6fb48a0a1300f8798ac03766b930cad4,0,Nathan Marz,2012-11-30 09:49:00+11:00,"['40264637f4188e5a9c2eb72632aeb3b9df275eeb', 'f2b212e48972d490446a5d2a02272ae8d9116a9c']",0,0,0,263656,0,,,,673
ba18283172dc96ef9acf314190f6cddce0038141,0,Nathan Marz,2012-11-30 09:50:42+11:00,['3332a0d65b71aff74116487eef55a9cad4ac72c6'],0,3,3,263659,2,,,,673
f2d5b39551d6980c96b87d0c2f0309a8ff104218,0,Sam Ritchie,2012-11-29 17:02:40-08:00,['d6e9e63512544d1cf5e34c83af1e9cc7d8dfd4b0'],27,34,61,263720,5,0.5,0.5,0.5,673
8e8112357057b30bbe1c51edd878adb2cb2aae4e,0,Tyler Benson,2012-11-30 16:55:24-08:00,['8d6bae43b596ebedf9b664cf8f54cd0fa622035e'],1,5,6,263726,1,0,1,1,673
aad7f4bcc1ff0b4df46d47994adc53eb36ab1009,0,Sam Ritchie,2012-12-03 17:51:39-08:00,"['f2d5b39551d6980c96b87d0c2f0309a8ff104218', '62f25a73b6621fac8e125c34917d25beb24019a5']",7,6,13,263739,1,,,,673
fecf760a4dbcf4f7f5af13b401345a93bb99417d,0,Sam Ritchie,2012-12-03 17:58:09-08:00,['aad7f4bcc1ff0b4df46d47994adc53eb36ab1009'],19,14,33,263772,4,1,1,0,673
a9fd4ab40c744b810ce00fae808f9f7e668a8332,1,Jason Jackson,2012-12-06 14:10:14-08:00,['fe3fa6ccd6796263b1f87a3759f62886d8d746c3'],2,9,11,263783,2,1,1,1,673
d2066e123dc40ae3d803dd9ccd202c5751f17cf9,0,Jason Jackson,2012-12-06 14:11:31-08:00,"['e8dd388e6fb48a0a1300f8798ac03766b930cad4', 'a9fd4ab40c744b810ce00fae808f9f7e668a8332']",2,9,11,263794,2,,,,673
5b62dc5ef623bc178848d9b9beddce5b9e84ec23,0,Jason Jackson,2012-12-06 14:11:52-08:00,['d2066e123dc40ae3d803dd9ccd202c5751f17cf9'],1,1,2,263796,1,,,,673
f5bdc720f50a0c46e90f0085c10217f2a6a3249f,0,Michael G. Noll,2012-12-07 12:41:14+01:00,['fd0d33161bd3c72e8dc650719d4b6b9cdcf3fa78'],318,2098,2416,266212,42,1,1,0.943419434,695
75506dc93bf84730e9c10dbb13015eba42a1152d,0,P. Taylor Goetz,2012-12-07 06:45:59-08:00,"['eda3c10913e7a8631d917bb626cbd443b06eb18e', '8d6bae43b596ebedf9b664cf8f54cd0fa622035e']",13,22,35,266247,6,,,,695
dd4e5e694b814a638d4c510abf5cb50952030cd5,0,P. Taylor Goetz,2012-12-07 06:48:02-08:00,"['75506dc93bf84730e9c10dbb13015eba42a1152d', '8e8112357057b30bbe1c51edd878adb2cb2aae4e']",1,5,6,266253,1,,,,695
47b60937511d848cf023d9fb78267ed69db6f9c4,0,Nathan Marz,2012-12-07 14:43:19-08:00,['ba18283172dc96ef9acf314190f6cddce0038141'],5,14,19,266272,6,,,,696
99153f9374a213b268ac028c04a7ad9f42cb9f14,0,Jason Jackson,2012-12-07 15:00:12-08:00,['5b62dc5ef623bc178848d9b9beddce5b9e84ec23'],1,4,5,266277,1,1,1,1,696
e2f041ebb1bdecef326dabda736a03c40a014f9f,0,Nathan Marz,2012-12-07 15:08:12-08:00,"['5b62dc5ef623bc178848d9b9beddce5b9e84ec23', '47b60937511d848cf023d9fb78267ed69db6f9c4']",9,239,248,266525,15,,,,696
e64ac0c07ab8c09007399cf2c569dc3d82cb0f28,0,Nathan Marz,2012-12-07 15:10:21-08:00,['e2f041ebb1bdecef326dabda736a03c40a014f9f'],1,9,10,266535,1,,,,696
1f6237bb51d5ac1d48bddcb898b9dc348d23b456,0,Nathan Marz,2012-12-07 15:10:52-08:00,['47b60937511d848cf023d9fb78267ed69db6f9c4'],1,2,3,266538,1,,,,696
e2ad4078fa24279ec676001c45d460889091468d,0,Nathan Marz,2012-12-07 15:11:22-08:00,"['e64ac0c07ab8c09007399cf2c569dc3d82cb0f28', '1f6237bb51d5ac1d48bddcb898b9dc348d23b456']",2,7,9,266547,1,,,,696
41c988ff68face9aa9c062ebf02e2fcc3d59c2cb,0,Nathan Marz,2012-12-10 14:17:59-08:00,['e2ad4078fa24279ec676001c45d460889091468d'],1,1,2,266549,1,,,,696
bba726328ea738cd2ad0cf0f1159dda495affdae,0,Nathan Marz,2012-12-10 15:02:46-08:00,['1f6237bb51d5ac1d48bddcb898b9dc348d23b456'],0,5,5,266554,1,0.75,1,1,696
0ed2b6a4bea74ed020f60a89d3c9aa147ccc879c,0,Nathan Marz,2012-12-10 15:03:02-08:00,"['41c988ff68face9aa9c062ebf02e2fcc3d59c2cb', 'bba726328ea738cd2ad0cf0f1159dda495affdae']",0,5,5,266559,1,,,,696
5ac075e2e2744b053dbf282863704d233dca35d2,0,Nathan Marz,2012-12-10 15:05:18-08:00,['0ed2b6a4bea74ed020f60a89d3c9aa147ccc879c'],1,1,2,266561,1,,,,696
f28c17d9080d5f159f0f9d120f0f5f7646b10980,0,Nathan Marz,2012-12-10 15:45:24-08:00,['bba726328ea738cd2ad0cf0f1159dda495affdae'],2,4,6,266567,1,,,,696
698e5f264ff79d5e9315a3bdb76ae3ea4392f773,0,Nathan Marz,2012-12-10 15:45:36-08:00,"['5ac075e2e2744b053dbf282863704d233dca35d2', 'f28c17d9080d5f159f0f9d120f0f5f7646b10980']",2,4,6,266573,1,,,,696
f248d7905d20ee86b603db1d413bd222299ad8bf,0,Nathan Marz,2012-12-10 15:54:59-08:00,['f28c17d9080d5f159f0f9d120f0f5f7646b10980'],0,1,1,266574,1,,,,696
cc0a2e3092a911461da33a067cbc89e17f1193bf,0,Nathan Marz,2012-12-10 15:55:03-08:00,"['698e5f264ff79d5e9315a3bdb76ae3ea4392f773', 'f248d7905d20ee86b603db1d413bd222299ad8bf']",0,1,1,266575,1,,,,696
09081b3d2b1da3dcdd3b97b796b8adf56544583a,0,Michael G. Noll,2012-12-11 10:06:22+01:00,['f5bdc720f50a0c46e90f0085c10217f2a6a3249f'],2,2,4,266579,38,,,,696
9148cd5e124e7de2e9b9a17a5b89b802d60d5500,0,Nathan Marz,2012-12-11 13:50:48-08:00,['cc0a2e3092a911461da33a067cbc89e17f1193bf'],1,1,2,266581,1,,,,696
6f6d0d3d336896896a5a3b01f8176abe4252b517,0,Nathan Marz,2012-12-11 14:11:55-08:00,"['fd0d33161bd3c72e8dc650719d4b6b9cdcf3fa78', '09081b3d2b1da3dcdd3b97b796b8adf56544583a']",304,2084,2388,268969,26,,,,696
6c326ba4ea855898e9211d1fafd0d66d1bbe33c1,0,Nathan Marz,2012-12-11 16:06:51-08:00,['6f6d0d3d336896896a5a3b01f8176abe4252b517'],2,5,7,268976,2,,,,696
bde6ab22f9552515f4e225f9fa9b2a274d518dcd,0,Nathan Marz,2012-12-11 16:07:41-08:00,['6c326ba4ea855898e9211d1fafd0d66d1bbe33c1'],2,0,2,268978,1,,,,696
2f90eff4e7fb7ce0b5738ef7860a1a3c601d4785,0,Michael G. Noll,2012-12-12 17:07:46+01:00,['bde6ab22f9552515f4e225f9fa9b2a274d518dcd'],0,1,1,268979,1,,,,696
9b8ab8dafd1d2d227c5196f2231cd3b678a535a2,0,Nathan Marz,2012-12-12 10:54:27-08:00,"['bde6ab22f9552515f4e225f9fa9b2a274d518dcd', '2f90eff4e7fb7ce0b5738ef7860a1a3c601d4785']",0,1,1,268980,1,,,,696
fd201eb15a1ded90d64808d3b4e32705cd5d85cd,0,Nathan Marz,2012-12-12 14:58:33-08:00,['f248d7905d20ee86b603db1d413bd222299ad8bf'],4,12,16,268996,2,1,1,0.857142857,696
671dc9537088914c4e8b61a8000badadeac527ad,0,Nathan Marz,2012-12-12 14:58:39-08:00,"['9148cd5e124e7de2e9b9a17a5b89b802d60d5500', 'fd201eb15a1ded90d64808d3b4e32705cd5d85cd']",4,12,16,269012,2,,,,696
27d203e7d0ed7ff6c809d15e1a16e7c6b4d5fbc7,0,Nathan Marz,2012-12-12 14:58:50-08:00,['671dc9537088914c4e8b61a8000badadeac527ad'],1,1,2,269014,1,,,,696
7bfe363dd290d1aa43f4724905517a0708b11f6c,0,Nathan Marz,2012-12-12 15:04:47-08:00,['fd201eb15a1ded90d64808d3b4e32705cd5d85cd'],0,1,1,269015,1,,,,696
cb5b413bcf1eae705e7cc5e4370ec147dee391ef,0,Nathan Marz,2012-12-12 15:04:57-08:00,"['27d203e7d0ed7ff6c809d15e1a16e7c6b4d5fbc7', '7bfe363dd290d1aa43f4724905517a0708b11f6c']",0,1,1,269016,1,,,,696
a8df52dcc427acc9c796818abb0d76b792b604bb,0,Nathan Marz,2012-12-16 16:13:53-08:00,['7bfe363dd290d1aa43f4724905517a0708b11f6c'],1,9,10,269026,2,1,1,1,696
55d5b8d52f5575b0f479386025572024091df29f,0,Yu L Li,2012-12-17 13:50:54-08:00,['7bfe363dd290d1aa43f4724905517a0708b11f6c'],2,20,22,269048,2,1,1,0.916666667,696
29997fd6945de742e71bacc519e4cafddf5a62eb,0,Nathan Marz,2012-12-17 16:29:04-08:00,['a8df52dcc427acc9c796818abb0d76b792b604bb'],10,31,41,269089,4,0,1,0,696
33b25c0e42296e295ee253b8179cb35be80f810e,0,Jason Jackson,2012-12-17 16:32:16-08:00,"['99153f9374a213b268ac028c04a7ad9f42cb9f14', 'cb5b413bcf1eae705e7cc5e4370ec147dee391ef']",14,274,288,269377,20,,,,696
52f79adf0a31892ac09c9b89acfc691ce966d315,0,Nathan Marz,2012-12-17 21:39:51-08:00,['29997fd6945de742e71bacc519e4cafddf5a62eb'],8,36,44,269421,1,1,1,1,696
470ec47280a9fc1afc7e5d44ef047c7f6ed58713,0,Jason Jackson,2012-12-17 22:39:44-08:00,['fecf760a4dbcf4f7f5af13b401345a93bb99417d'],5,6,11,269432,2,,,,696
df380fb0186aa59e4d1f2f74e8f609c3bda23dc2,0,Jason Jackson,2012-12-17 22:41:07-08:00,['470ec47280a9fc1afc7e5d44ef047c7f6ed58713'],1,1,2,269434,1,,,,696
d3543951b54db2051961a184e840cfccd8c1c286,0,Nathan Marz,2012-12-18 15:25:53-08:00,['52f79adf0a31892ac09c9b89acfc691ce966d315'],1,1,2,269436,1,,,,696
679f20bc3c226873c970f521c85e873a1bb5e129,0,Nathan Marz,2012-12-18 15:26:29-08:00,['d3543951b54db2051961a184e840cfccd8c1c286'],0,1,1,269437,1,,,,696
d44970afeb3f6166b6c93b6ce39e5cb49b615114,0,Nathan Marz,2012-12-19 13:23:40-08:00,['679f20bc3c226873c970f521c85e873a1bb5e129'],3,305,308,269745,8,1,1,1,697
b4677500e81192f39ce87cb4ac55f0d5a637d747,0,Nathan Marz,2012-12-19 13:33:37-08:00,['d44970afeb3f6166b6c93b6ce39e5cb49b615114'],0,1,1,269746,1,,,,697
1f1511e39f8d415d280653ca7f8ec37ba42cd1a9,0,Nathan Marz,2012-12-19 13:33:51-08:00,"['cb5b413bcf1eae705e7cc5e4370ec147dee391ef', 'b4677500e81192f39ce87cb4ac55f0d5a637d747']",18,379,397,270143,13,,,,697
a39add8639bfd679400ed41275c8566746edfaaa,0,Nathan Marz,2012-12-19 16:10:27-08:00,['b4677500e81192f39ce87cb4ac55f0d5a637d747'],0,7,7,270150,1,,,,697
fd3d4c9e34f5437dce1780fb8a4ce3025f992fdd,0,Nathan Marz,2012-12-19 16:10:33-08:00,"['1f1511e39f8d415d280653ca7f8ec37ba42cd1a9', 'a39add8639bfd679400ed41275c8566746edfaaa']",0,7,7,270157,1,,,,697
81d46181ac200e7a03edbcac852e61a763837e4a,0,Jason Jackson,2012-12-19 16:11:07-08:00,"['33b25c0e42296e295ee253b8179cb35be80f810e', 'fd3d4c9e34f5437dce1780fb8a4ce3025f992fdd']",18,386,404,270561,13,,,,697
f771774b3f87a00f0dfb5346e359427d3fbbee24,0,Jason Jackson,2012-12-19 16:13:20-08:00,['81d46181ac200e7a03edbcac852e61a763837e4a'],1,1,2,270563,1,,,,697
a0e52c7d7fc977c5d5d11673c24830fc17ed5ea2,0,Nathan Marz,2012-12-19 16:58:29-08:00,['a39add8639bfd679400ed41275c8566746edfaaa'],5,15,20,270583,2,1,1,1,697
70242cd178a5619a97a72a2613b3df7bf5836a7b,0,Nathan Marz,2012-12-19 16:58:38-08:00,"['f771774b3f87a00f0dfb5346e359427d3fbbee24', 'a0e52c7d7fc977c5d5d11673c24830fc17ed5ea2']",5,15,20,270603,2,,,,697
7f2b38a5d1791087fe76c4e0428fbf8f9e2ec606,0,Nathan Marz,2012-12-19 16:58:48-08:00,['70242cd178a5619a97a72a2613b3df7bf5836a7b'],1,1,2,270605,1,,,,697
2ec670bc73da3605a49b3f16989649e680b6bfb8,0,Nathan Marz,2012-12-19 17:32:59-08:00,['a0e52c7d7fc977c5d5d11673c24830fc17ed5ea2'],2,25,27,270632,2,,,,697
0182cc30c000400c1613c8fa30a27721c2ecbbd3,0,Nathan Marz,2012-12-19 17:33:04-08:00,"['7f2b38a5d1791087fe76c4e0428fbf8f9e2ec606', '2ec670bc73da3605a49b3f16989649e680b6bfb8']",2,25,27,270659,2,,,,697
5ddc0874626958a86b935a2b994fd758857aff85,0,Nathan Marz,2012-12-19 17:33:21-08:00,['0182cc30c000400c1613c8fa30a27721c2ecbbd3'],1,1,2,270661,1,,,,697
cce1c889f39bf7b0a890b658bcfd05b4ccb1b810,0,Kang Xiao,2012-12-23 14:45:46+08:00,['2ec670bc73da3605a49b3f16989649e680b6bfb8'],1,17,18,270679,3,,,,697
9420e7e57f618a0132d826942e1018900537f67a,0,Nathan Marz,2012-12-24 22:48:40-08:00,['2ec670bc73da3605a49b3f16989649e680b6bfb8'],1,2,3,270682,1,,,,697
78f18123aa1fab432a59d0e9fd9306036a2bb024,0,Nathan Marz,2013-01-04 23:10:22-08:00,"['9420e7e57f618a0132d826942e1018900537f67a', 'cce1c889f39bf7b0a890b658bcfd05b4ccb1b810']",1,17,18,270700,3,,,,697
b965f2f9deb14a45718f9fe72c1eab917dfc9ffc,0,Nathan Marz,2013-01-04 23:13:00-08:00,['78f18123aa1fab432a59d0e9fd9306036a2bb024'],0,2,2,270702,1,,,,697
cc5d7d26503c969c74456e60987ab81d7ccdd7e4,0,Nathan Marz,2013-01-04 23:13:14-08:00,"['5ddc0874626958a86b935a2b994fd758857aff85', 'b965f2f9deb14a45718f9fe72c1eab917dfc9ffc']",2,21,23,270725,5,,,,697
ff77c62b1c86bce70e1a5ea1549efdfb0f9a0669,0,Guanpeng Xu,2013-01-07 15:14:25+08:00,['b965f2f9deb14a45718f9fe72c1eab917dfc9ffc'],1,1,2,270727,1,,,,697
d5bb376d26f465d118b91d264c5cff6642609c3e,0,Nathan Marz,2013-01-06 23:59:45-08:00,"['b965f2f9deb14a45718f9fe72c1eab917dfc9ffc', 'ff77c62b1c86bce70e1a5ea1549efdfb0f9a0669']",1,1,2,270729,1,,,,697
9c3244e80b98d244ea5d16bc2e430d6a09d5a730,0,Nathan Marz,2013-01-07 00:05:58-08:00,['d5bb376d26f465d118b91d264c5cff6642609c3e'],0,1,1,270730,1,,,,697
19a6ffa388029a9118b0ebfa00a4de64623bb886,0,Nathan Marz,2013-01-07 00:06:07-08:00,"['cc5d7d26503c969c74456e60987ab81d7ccdd7e4', '9c3244e80b98d244ea5d16bc2e430d6a09d5a730']",1,2,3,270733,2,,,,697
7c5ae9c265ec35bc0db3907c7392164c65e2af57,0,Nathan Marz,2013-01-07 16:47:17-08:00,['9c3244e80b98d244ea5d16bc2e430d6a09d5a730'],0,228,228,270961,4,1,1,1,697
30126c2ab50c9825c81650a803e05de760e6c45d,0,Nathan Marz,2013-01-07 16:48:26-08:00,['7c5ae9c265ec35bc0db3907c7392164c65e2af57'],0,1,1,270962,1,,,,697
deadcbf924c0cbd0af10389e5da66a937489487e,0,Nathan Marz,2013-01-07 16:48:36-08:00,"['19a6ffa388029a9118b0ebfa00a4de64623bb886', '30126c2ab50c9825c81650a803e05de760e6c45d']",0,229,229,271191,5,,,,697
6f53b95137020405ebf383d6da1d5f647fafa7aa,0,Nathan Marz,2013-01-08 12:53:19-08:00,['deadcbf924c0cbd0af10389e5da66a937489487e'],1,1,2,271193,1,,,,697
6e8c93d27bd18edbd7a0edc6188ad81921c28b57,0,Jason Jackson,2013-01-09 00:55:43-08:00,['df380fb0186aa59e4d1f2f74e8f609c3bda23dc2'],3,1,4,271197,1,,,,697
35275c16e3ea9e9337b1a163a725d2a021e40465,0,Nathan Marz,2013-01-09 15:38:29-08:00,['30126c2ab50c9825c81650a803e05de760e6c45d'],10,11,21,271218,1,,,,697
1b1c1fd68c7cb9e5cc676a43c1e78a57a9dd88ad,0,Nathan Marz,2013-01-09 15:38:44-08:00,"['6f53b95137020405ebf383d6da1d5f647fafa7aa', '35275c16e3ea9e9337b1a163a725d2a021e40465']",10,11,21,271239,1,,,,697
458b9f2ad4c350fa093bd590c12f506f5cbea90b,0,Nathan Marz,2013-01-09 15:41:01-08:00,['35275c16e3ea9e9337b1a163a725d2a021e40465'],3,3,6,271245,1,,,,697
695abab1577eded7b0c58ff451b9483430915d6f,0,Nathan Marz,2013-01-09 15:41:10-08:00,"['1b1c1fd68c7cb9e5cc676a43c1e78a57a9dd88ad', '458b9f2ad4c350fa093bd590c12f506f5cbea90b']",3,3,6,271251,1,,,,697
af77ba5c7ea4934262eb0cc453b1be5b27742890,0,Jason Jackson,2013-01-09 15:58:40-08:00,['695abab1577eded7b0c58ff451b9483430915d6f'],1,1,2,271253,1,,,,697
cf7cb81451b8bf6f50d4f836b30aef8fb68570fb,0,Jason Jackson,2013-01-10 04:18:06-08:00,['af77ba5c7ea4934262eb0cc453b1be5b27742890'],1,3,4,271257,1,1,1,1,697
28251f70c7b2ecfb0ab4a11e686a758c5eb39b85,0,Jason Jackson,2013-01-10 04:18:24-08:00,['cf7cb81451b8bf6f50d4f836b30aef8fb68570fb'],1,1,2,271259,1,,,,697
c40f0ce165a421d2f88f3ce28ee0615dbf19ecad,0,Jason Jackson,2013-01-10 17:01:40-08:00,['6e8c93d27bd18edbd7a0edc6188ad81921c28b57'],2,2,4,271263,1,,,,697
1e00589634d1b1fbb9aafda0c50ba7cc2ccbc624,0,Nathan Marz,2013-01-11 11:53:10-08:00,['d6e9e63512544d1cf5e34c83af1e9cc7d8dfd4b0'],1,1,2,271265,1,,,,697
4d2c4dab1af86887bbe5811a2090e927ecf18305,0,Nathan Marz,2013-01-11 11:53:43-08:00,"['1e00589634d1b1fbb9aafda0c50ba7cc2ccbc624', 'c40f0ce165a421d2f88f3ce28ee0615dbf19ecad']",48,48,96,271361,6,,,,697
7b2139181ed1f5f3961a0ea5f45571a40aa04f60,0,Nathan Marz,2013-01-11 14:43:22-08:00,['458b9f2ad4c350fa093bd590c12f506f5cbea90b'],1,3,4,271365,1,1,1,1,697
6bd21aea924ed8788339f4d1c8a9f451a1335e25,0,Nathan Marz,2013-01-11 15:27:11-08:00,['7b2139181ed1f5f3961a0ea5f45571a40aa04f60'],1,1,2,271367,1,,,,697
1ae5ce4ca77010f84bc80c2ab691b0c68c212e1b,0,Nathan Marz,2013-01-13 02:08:16-08:00,['6bd21aea924ed8788339f4d1c8a9f451a1335e25'],1,1,2,271369,1,,,,697
b33e706503c50390d52c54032a95d955dd71d08a,0,Trevor Wennblom,2013-01-14 18:02:51-06:00,['9b8ab8dafd1d2d227c5196f2231cd3b678a535a2'],33,34,67,271436,3,,,,697
adacdbe0e6965d0235a8aa04b9f6a44f1ba6face,0,Mike Blume,2013-01-16 17:19:09-08:00,['9b8ab8dafd1d2d227c5196f2231cd3b678a535a2'],10,16,26,271462,2,1,1,1,697
c6b0be44c4944763464e69ef50081f967ce7141e,0,Mike Blume,2013-01-16 17:20:27-08:00,['adacdbe0e6965d0235a8aa04b9f6a44f1ba6face'],1,1,2,271464,1,,,,697
3e29f13e405c0d3460781f8f6b310092d332903a,0,Jason Jackson,2013-01-16 17:30:27-08:00,['28251f70c7b2ecfb0ab4a11e686a758c5eb39b85'],2,2,4,271468,2,,,,697
08f779f0de6839f63af1443d7070da730db9a3b4,0,Jason Jackson,2013-01-17 14:31:13-08:00,['4d2c4dab1af86887bbe5811a2090e927ecf18305'],40,167,207,271675,7,0.444444444,0.262626263,0.838383838,697
af2a1fc8e29aadcd12c6521261964ceb5485c0d6,0,Jason Jackson,2013-01-22 14:08:31-08:00,['08f779f0de6839f63af1443d7070da730db9a3b4'],5,7,12,271687,3,0.5,1,0,697
cb5e958745344849a6f4689963c5de08c5bc2386,0,Nathan Marz,2013-01-22 15:29:05-08:00,"['9b8ab8dafd1d2d227c5196f2231cd3b678a535a2', 'c6b0be44c4944763464e69ef50081f967ce7141e']",10,16,26,271713,2,,,,697
446037abe417cc712b600f4eba105ceb677c9ebe,0,Nathan Marz,2013-01-23 14:57:42-08:00,['1ae5ce4ca77010f84bc80c2ab691b0c68c212e1b'],1,0,1,271714,1,,,,697
8935c381188691eb3ed8d9bebf9d3bd8eb1b05cf,0,Nathan Marz,2013-01-23 20:42:09-08:00,"['446037abe417cc712b600f4eba105ceb677c9ebe', '3e29f13e405c0d3460781f8f6b310092d332903a']",272,1284,1556,273270,72,,,,697
78a0a998c29113f6708cabb1f17bb67b0255ac2c,0,Nathan Marz,2013-01-23 23:53:01-08:00,"['cb5e958745344849a6f4689963c5de08c5bc2386', 'b33e706503c50390d52c54032a95d955dd71d08a']",33,34,67,273337,3,,,,697
28193d608a2089241c348d09a522cfbc2bd19379,0,engineerdev,2013-01-25 14:42:53+04:00,['8935c381188691eb3ed8d9bebf9d3bd8eb1b05cf'],1,1,2,273339,1,,,,697
860a43b444f72bd90f3d24090907874330995bb2,0,Jason Jackson,2013-01-29 13:44:43-08:00,['af2a1fc8e29aadcd12c6521261964ceb5485c0d6'],2,3,5,273344,1,1,1,1,697
7ed3d7c5317f78facdad2ca53b695205261ca777,0,Jason Jackson,2013-01-29 13:45:05-08:00,['860a43b444f72bd90f3d24090907874330995bb2'],1,1,2,273346,1,,,,697
b1a1851611f9c0cfdcc31cb90aef531e7b0ac5e9,0,Jason Jackson,2013-02-01 00:23:31-08:00,['3e29f13e405c0d3460781f8f6b310092d332903a'],2,2,4,273350,2,,,,697
2aaada7ff0db344335642eabd0da52751a17717a,0,Mike Blume,2013-02-01 12:49:55-08:00,['78a0a998c29113f6708cabb1f17bb67b0255ac2c'],2,7,9,273359,2,0.333333333,0,0.333333333,697
4859f0d0e994197f259f60b9033e272b28a3cdde,0,Nathan Marz,2013-02-01 14:36:01-08:00,['8935c381188691eb3ed8d9bebf9d3bd8eb1b05cf'],1,11,12,273371,2,1,1,1,697
2fdd7068a7d7db73b2fe5635babbbead3e1f9460,0,Nathan Marz,2013-02-01 14:42:16-08:00,"['b1a1851611f9c0cfdcc31cb90aef531e7b0ac5e9', '4859f0d0e994197f259f60b9033e272b28a3cdde']",3,12,15,273386,4,,,,697
cbd217c6ea20e4d97396bbd7f112081362782573,0,Jason Jackson,2013-02-01 14:54:09-08:00,['2fdd7068a7d7db73b2fe5635babbbead3e1f9460'],1,1,2,273388,1,,,,697
befe50cc496b017576332173a7190c3b3c51588a,1,Andrew Olson,2013-02-01 17:49:05-06:00,['4859f0d0e994197f259f60b9033e272b28a3cdde'],4,35,39,273427,4,,,,698
f5205f413ba68d06bd574a5b2bf7a0352203c717,0,Robert (Bobby) Evans,2013-02-05 10:48:38-06:00,['4859f0d0e994197f259f60b9033e272b28a3cdde'],2,3,5,273432,1,,,,698
1d76894ec8bca162c3e67c4b1bb391004c01b110,0,Robert (Bobby) Evans,2013-02-05 15:48:41-06:00,['f5205f413ba68d06bd574a5b2bf7a0352203c717'],0,4,4,273436,1,,,,698
e96bb2125ca7eb0a7a7cbf28197af6e05f8ddd25,0,Robert (Bobby) Evans,2013-02-08 14:21:38-06:00,['1d76894ec8bca162c3e67c4b1bb391004c01b110'],4,0,4,273440,1,,,,698
06dcc2a75eba930ac27119ac6188962018760ace,1,afeng,2013-02-09 20:40:26-08:00,['4859f0d0e994197f259f60b9033e272b28a3cdde'],0,95,95,273535,2,0.567567568,1,0.756756757,700
5ea2e6fc5d94e24f3de05a27c66238db999d9a2e,0,afeng,2013-02-09 20:45:21-08:00,['06dcc2a75eba930ac27119ac6188962018760ace'],11,63,74,273609,5,0.205882353,0,0.647058824,700
f2a4d3fa1674e39e683c1ad7bbdd893f68a85758,0,Nathan Marz,2013-02-10 10:23:19-08:00,"['4859f0d0e994197f259f60b9033e272b28a3cdde', '28193d608a2089241c348d09a522cfbc2bd19379']",1,1,2,273611,1,,,,700
1c6cd9ca1eddbe4f1f3e55262380255d5cf8df44,0,Nathan Marz,2013-02-10 10:27:51-08:00,"['f2a4d3fa1674e39e683c1ad7bbdd893f68a85758', 'e96bb2125ca7eb0a7a7cbf28197af6e05f8ddd25']",2,3,5,273616,1,,,,700
9837bc41329c267b823268720af925260bc81750,0,afeng,2013-02-10 13:06:56-08:00,['5ea2e6fc5d94e24f3de05a27c66238db999d9a2e'],15,12,27,273643,2,1,1,0,700
ea0e7ff573bb3f61ec8c87bdd3c3d0f01546173f,0,afeng,2013-02-10 13:10:47-08:00,['9837bc41329c267b823268720af925260bc81750'],4,1,5,273648,1,1,1,0,700
76d788cd08265ba22b17632aa0629c34a86baefd,0,Jason Jackson,2013-02-11 10:56:16-08:00,['7ed3d7c5317f78facdad2ca53b695205261ca777'],3,2,5,273653,1,0,0,0,700
ddc3e8eefc881e5809c0f0d9a4b61a60af432024,0,Jason Jackson,2013-02-11 10:59:32-08:00,['76d788cd08265ba22b17632aa0629c34a86baefd'],1,1,2,273655,1,,,,700
01c41476b2d010a0e554bd73550e03e2c23a7ed4,0,afeng,2013-02-11 21:46:15-08:00,['ea0e7ff573bb3f61ec8c87bdd3c3d0f01546173f'],12,0,12,273667,2,,,,700
83af2b8e175be91194e868c83a14cb336a57207b,0,Nathan Marz,2013-02-11 22:38:54-08:00,['1c6cd9ca1eddbe4f1f3e55262380255d5cf8df44'],0,4,4,273671,1,,,,701
de923c4df839f4ad1d94dd75f4f30ed546805208,0,Nathan Marz,2013-02-11 22:51:53-08:00,"['83af2b8e175be91194e868c83a14cb336a57207b', '01c41476b2d010a0e554bd73550e03e2c23a7ed4']",11,140,151,273822,7,,,,701
f94a7bfae7099d6ddd1119db817aff97b69214e5,0,Nathan Marz,2013-02-11 22:57:51-08:00,['de923c4df839f4ad1d94dd75f4f30ed546805208'],0,5,5,273827,2,,,,701
c843ec23d86d6360c018a478723bdee16f9dc427,0,Lorcan Coyle,2013-02-12 10:06:35+00:00,['f94a7bfae7099d6ddd1119db817aff97b69214e5'],2,2,4,273831,1,,,,701
9ab65353e1c1621a12095c4cfec0bbcd0117f697,0,Nathan Marz,2013-02-12 11:24:14-08:00,"['f94a7bfae7099d6ddd1119db817aff97b69214e5', 'c843ec23d86d6360c018a478723bdee16f9dc427']",2,2,4,273835,1,,,,701
f4e7e375e56a4e1b07f35a196f22903805c5310a,0,Nathan Marz,2013-02-12 11:25:36-08:00,['9ab65353e1c1621a12095c4cfec0bbcd0117f697'],0,2,2,273837,2,,,,701
905b8e7745ac78005d82e0ca2b8c9f8f8c90ad9f,0,Nathan Marz,2013-02-12 14:25:49-08:00,['f4e7e375e56a4e1b07f35a196f22903805c5310a'],1,1,2,273839,1,,,,701
f10b69884eb9a04897e59b853c05b96053be6860,0,Nathan Marz,2013-02-12 14:26:11-08:00,['905b8e7745ac78005d82e0ca2b8c9f8f8c90ad9f'],0,1,1,273840,1,,,,701
96c51312a9149a0c86509823f2494dd54f943c9a,1,afeng,2013-02-12 23:43:04-08:00,['01c41476b2d010a0e554bd73550e03e2c23a7ed4'],17,1093,1110,274950,17,0.448529412,0.520220588,0.751838235,714
e34feda46c20160aefff33a3e0d99ff5c08ad887,0,Derek Dagit,2013-02-13 11:49:05-06:00,['f10b69884eb9a04897e59b853c05b96053be6860'],2,2,4,274954,1,,,,714
0806f1f956228804b8daa960010e184edfbe4373,0,afeng,2013-02-13 10:37:59-08:00,['96c51312a9149a0c86509823f2494dd54f943c9a'],8,0,8,274962,3,,,,714
cd81d914076b215e2dccaae3e7759f10a7e46d00,0,Derek Dagit,2013-02-13 12:51:49-06:00,['f10b69884eb9a04897e59b853c05b96053be6860'],0,70,70,275032,1,,,,715
59217cd759aa43280f62077069987080d6c8c2b9,0,Robert (Bobby) Evans,2013-02-14 14:22:41-06:00,['f10b69884eb9a04897e59b853c05b96053be6860'],4,31,35,275067,2,,,,715
76775eab336e604e92b4d25fecfe21bb8e15cf8d,0,Robert (Bobby) Evans,2013-02-14 14:33:18-06:00,['59217cd759aa43280f62077069987080d6c8c2b9'],1,1,2,275069,1,,,,715
0d8f40dac847b1e64b891e191ec8679ee503cdc1,1,Robert (Bobby) Evans,2013-02-14 14:46:15-06:00,['f10b69884eb9a04897e59b853c05b96053be6860'],1,2,3,275072,1,0,0,1,715
8cd0c067a5f176e07d66c90c5c4fa3624c0199f6,1,Robert (Bobby) Evans,2013-02-14 15:20:53-06:00,['f10b69884eb9a04897e59b853c05b96053be6860'],18,22,40,275112,1,,,,715
bcd8688c61bcb834a7935d9d1fce2d35bd09ebcf,0,Nathan Marz,2013-02-14 16:08:39-08:00,"['f10b69884eb9a04897e59b853c05b96053be6860', '8cd0c067a5f176e07d66c90c5c4fa3624c0199f6']",18,22,40,275152,1,,,,715
64c3b96d19e9be28eca010026b90792acfedaa23,0,Nathan Marz,2013-02-14 16:09:31-08:00,"['bcd8688c61bcb834a7935d9d1fce2d35bd09ebcf', '0d8f40dac847b1e64b891e191ec8679ee503cdc1']",1,2,3,275155,1,,,,715
7b45736aea05345d415dd1d2caea1d9a4c775465,0,Nathan Marz,2013-02-14 16:14:51-08:00,"['64c3b96d19e9be28eca010026b90792acfedaa23', '76775eab336e604e92b4d25fecfe21bb8e15cf8d']",4,31,35,275190,2,,,,715
0267c00bfe44b2d5dd6ba5e15012de1f282de24d,0,Nathan Marz,2013-02-14 16:26:26-08:00,['7b45736aea05345d415dd1d2caea1d9a4c775465'],0,3,3,275193,1,,,,715
1e17e828382c37d069a229e7e71529f8e9876f0b,0,afeng,2013-02-14 17:09:43-08:00,['0806f1f956228804b8daa960010e184edfbe4373'],0,310,310,275503,3,,,,718
7def91d33c43df42cbbc69efc6043beff7785ffd,0,afeng,2013-02-15 00:35:12-08:00,['1e17e828382c37d069a229e7e71529f8e9876f0b'],156,195,351,275854,3,0,0,0,719
65848efe8f443de0016b7c04b128434a8c613403,1,afeng,2013-02-15 15:09:55-08:00,['7def91d33c43df42cbbc69efc6043beff7785ffd'],62,158,220,276074,4,,,,720
43bd28b2ae03696d24d1dca1777c4782efa7b7b6,0,afeng,2013-02-15 16:01:12-08:00,['65848efe8f443de0016b7c04b128434a8c613403'],4,5,9,276083,1,,,,720
2d78e680070a5b3181bf08926c32dca105343af4,0,Nathan Marz,2013-02-15 16:14:45-08:00,['ddc3e8eefc881e5809c0f0d9a4b61a60af432024'],3,31,34,276117,3,0.266666667,0.266666667,0.266666667,720
2cc81a171dba6c47c7c347a1bb1fd3898eb500fb,0,Nathan Marz,2013-02-15 16:15:30-08:00,['2d78e680070a5b3181bf08926c32dca105343af4'],1,1,2,276119,1,,,,720
4bf2de58f0972b731600269cd419c1a3d1869458,0,Nathan Marz,2013-02-15 16:16:22-08:00,['2cc81a171dba6c47c7c347a1bb1fd3898eb500fb'],0,18,18,276137,1,1,1,1,721
47ce0ae97830380eb85db7ae97a7f7f3adbff820,0,Jason Jackson,2013-02-16 09:40:03-08:00,['4bf2de58f0972b731600269cd419c1a3d1869458'],1,3,4,276141,2,1,1,1,721
873f52dc6814c3cb27e3a28092a4d400bfde879c,0,Derek Dagit,2013-02-16 14:30:52-06:00,['cd81d914076b215e2dccaae3e7759f10a7e46d00'],16,9,25,276166,1,,,,721
c75b0c95289abfe2844095dd21777faf5fc3a91f,0,afeng,2013-02-16 19:53:25-08:00,['43bd28b2ae03696d24d1dca1777c4782efa7b7b6'],382,379,761,276927,10,1,1,1,721
2847f4173a5d41f9aae964553de49bb8f00718f0,0,afeng,2013-02-16 20:06:51-08:00,['c75b0c95289abfe2844095dd21777faf5fc3a91f'],2,2,4,276931,1,,,,721
330b8bd89b5bb288e14b304ee1cd69c29e6f5c9d,0,Derek Dagit,2013-02-16 23:24:18-06:00,['e34feda46c20160aefff33a3e0d99ff5c08ad887'],4,74,78,277009,5,0,1,0.6,722
1e24e9fdd97d8f05c54278ca23e4f3fbd1656135,1,afeng,2013-02-17 11:55:17-08:00,['2847f4173a5d41f9aae964553de49bb8f00718f0'],546,614,1160,278169,9,1,1,1,725
141aad4ba84e6d52884c3bf2524f915a14929522,0,Nathan Marz,2013-02-17 16:49:48-08:00,['0267c00bfe44b2d5dd6ba5e15012de1f282de24d'],26,26,52,278221,1,,,,725
c876e719c2f8edf77e2c800a49586a1c048805fa,0,Nathan Marz,2013-02-17 18:15:31-08:00,['141aad4ba84e6d52884c3bf2524f915a14929522'],52,101,153,278374,5,0.482758621,0,1,726
aa118f6497e2b4c1766eb064031774a19e634ed2,0,Nathan Marz,2013-02-17 20:47:11-08:00,['c876e719c2f8edf77e2c800a49586a1c048805fa'],0,56,56,278430,1,,,,727
8f8f48c75989ea1af3afeb8c0fe27b51b6080850,0,Nathan Marz,2013-02-17 23:59:37-08:00,['78a0a998c29113f6708cabb1f17bb67b0255ac2c'],8,8,16,278446,1,,,,727
414af600ab08c4cdd7cefc0205ac95036af64c1e,0,Nathan Marz,2013-02-18 18:50:09-08:00,['aa118f6497e2b4c1766eb064031774a19e634ed2'],25,20,45,278491,1,,,,727
c73703d557d5a24e67234da71d93325d12b0f1d2,0,Nathan Marz,2013-02-18 18:50:46-08:00,['414af600ab08c4cdd7cefc0205ac95036af64c1e'],1,1,2,278493,1,,,,727
e6eea02e7e1e83ef248f622ce89df0ab8d42ba8d,0,Nathan Marz,2013-02-18 18:51:50-08:00,['c73703d557d5a24e67234da71d93325d12b0f1d2'],0,1,1,278494,1,,,,727
e57bf89ab11c2ba6fae479133d78cc7471129495,0,Nathan Marz,2013-02-18 20:59:00-08:00,"['8f8f48c75989ea1af3afeb8c0fe27b51b6080850', '2aaada7ff0db344335642eabd0da52751a17717a']",2,7,9,278503,2,,,,727
c729f4580e262f8f4eff851cc8e46f5bae0f0929,1,afeng,2013-02-18 22:44:38-08:00,['1e24e9fdd97d8f05c54278ca23e4f3fbd1656135'],533,977,1510,280013,18,1,1,1,733
1cfd8b5030b6327731e94df8a939f166f4148794,0,afeng,2013-02-18 23:27:11-08:00,['c729f4580e262f8f4eff851cc8e46f5bae0f0929'],5,43,48,280061,6,,,,733
30bd164d76e1d0d9d2d075ac49f8ec076e86523b,0,afeng,2013-02-18 23:41:00-08:00,['1cfd8b5030b6327731e94df8a939f166f4148794'],3,2,5,280066,1,,,,733
2f81fe091c2255583944ba57aa62b1a4fd5d04c6,0,Derek Dagit,2013-02-19 13:21:31-06:00,['873f52dc6814c3cb27e3a28092a4d400bfde879c'],11,4,15,280081,1,,,,733
2420876b665456502af8b3ceff8a8fb50a67838f,0,afeng,2013-02-19 17:38:29-08:00,['30bd164d76e1d0d9d2d075ac49f8ec076e86523b'],485,279,764,280845,14,0,0,0.285714286,733
ce92897f723c5001d59df1ac72ccea8d5175b3c3,0,Nathan Marz,2013-02-19 21:27:10-08:00,"['e6eea02e7e1e83ef248f622ce89df0ab8d42ba8d', '2f81fe091c2255583944ba57aa62b1a4fd5d04c6']",0,56,56,280901,1,,,,733
c9f31839f428df9da4f47c9bd3d259b35136cfcb,0,Derek Dagit,2013-02-20 09:15:16-06:00,"['2f81fe091c2255583944ba57aa62b1a4fd5d04c6', 'e6eea02e7e1e83ef248f622ce89df0ab8d42ba8d']",127,263,390,281291,13,,,,733
974bf24acd61be8df36a13985b785bf56123761f,1,Derek Dagit,2013-02-20 09:36:17-06:00,['c9f31839f428df9da4f47c9bd3d259b35136cfcb'],3,1,4,281295,1,1,0,0,733
98292bec723521c294330df9472b54f1efc136fa,0,Derek Dagit,2013-02-20 09:37:34-06:00,['974bf24acd61be8df36a13985b785bf56123761f'],2,2,4,281299,1,,,,733
7970feeb90c36e0338a7e84aafaace7569129319,0,Derek Dagit,2013-02-20 09:38:15-06:00,['98292bec723521c294330df9472b54f1efc136fa'],2,9,11,281310,1,,,,733
61827e72fe7e715e72fba0b23e7ec86ebe66344d,0,Derek Dagit,2013-02-20 12:52:13-06:00,['330b8bd89b5bb288e14b304ee1cd69c29e6f5c9d'],62,62,124,281434,3,1,0,0.285714286,734
f4f2cdd2d6ab6f2bcd32a4cc32839677fb442999,0,afeng,2013-02-20 11:46:02-08:00,['2420876b665456502af8b3ceff8a8fb50a67838f'],721,99,820,282254,20,0.931972789,0.360544218,0,734
a22cb5d17d85c7da3035fca835d46114e88aed51,0,afeng,2013-02-20 11:55:54-08:00,['f4f2cdd2d6ab6f2bcd32a4cc32839677fb442999'],42,30,72,282326,2,1,1,0,734
a6bd925236c801082e7c261fd39d561a955be923,0,afeng,2013-02-20 12:03:39-08:00,['a22cb5d17d85c7da3035fca835d46114e88aed51'],2,1,3,282329,1,1,1,0,734
010f3b9f6e90fb3c116811e31e8b6d7192e87cac,0,afeng,2013-02-20 12:04:35-08:00,['a6bd925236c801082e7c261fd39d561a955be923'],1,1,2,282331,1,,,,734
169bae4e9707a89ac0a5199891606c47538dd2c0,0,Derek Dagit,2013-02-20 14:16:02-06:00,['61827e72fe7e715e72fba0b23e7ec86ebe66344d'],9,3,12,282343,1,,,,734
7b7617fc1dd956af431ba589521f38649a8f4733,0,Derek Dagit,2013-02-20 14:37:45-06:00,['169bae4e9707a89ac0a5199891606c47538dd2c0'],7,2,9,282352,1,,,,734
50ebab087732bedd28cc097659817c456180bb62,0,afeng,2013-02-20 14:17:01-08:00,['010f3b9f6e90fb3c116811e31e8b6d7192e87cac'],1,1,2,282354,1,,,,734
830886313bd89c262547daabc9d3d371a23b3be0,1,afeng,2013-02-20 23:42:40-08:00,['50ebab087732bedd28cc097659817c456180bb62'],38,33,71,282425,3,0,0,1,734
d104640ff3730576ae4bd342fd1ff0600a7dc317,0,anfeng,2013-02-21 10:40:15-08:00,"['01c41476b2d010a0e554bd73550e03e2c23a7ed4', 'e6eea02e7e1e83ef248f622ce89df0ab8d42ba8d']",133,282,415,282840,18,,,,734
95761f65493b0142c3c1bfc406c599986f1b23ce,0,anfeng,2013-02-21 10:41:57-08:00,['d104640ff3730576ae4bd342fd1ff0600a7dc317'],0,3,3,282843,1,,,,734
b1f08b4a8c1b7448946fbe40eddf93bcfab5dc70,0,Nathan Marz,2013-02-21 12:07:33-08:00,"['e6eea02e7e1e83ef248f622ce89df0ab8d42ba8d', '95761f65493b0142c3c1bfc406c599986f1b23ce']",0,3,3,282846,1,,,,734
24106aa13ded590c0d9ab747d8bf1a149414244a,0,Derek Dagit,2013-02-25 16:38:49-06:00,['e6eea02e7e1e83ef248f622ce89df0ab8d42ba8d'],8,64,72,282918,2,,,,735
2123a17ed5d5ed18ba3f6a0a6d0fe3f1b4a12a9d,1,afeng,2013-02-25 17:12:04-08:00,['830886313bd89c262547daabc9d3d371a23b3be0'],37,61,98,283016,13,1,0.375,0.25,735
aa88f98cbb818c9e6fc929131e9187460aae76a0,0,Derek Dagit,2013-02-26 03:36:18-06:00,['24106aa13ded590c0d9ab747d8bf1a149414244a'],2,2,4,283020,1,,,,735
a8ecc988751175a45c41673377e9ee6516756f30,0,Derek Dagit,2013-02-26 03:37:55-06:00,"['aa88f98cbb818c9e6fc929131e9187460aae76a0', 'b1f08b4a8c1b7448946fbe40eddf93bcfab5dc70']",0,3,3,283023,1,,,,735
aed32985d67a421605df570ad3291084425da030,0,Derek Dagit,2013-02-26 03:40:09-06:00,['a8ecc988751175a45c41673377e9ee6516756f30'],52,0,52,283075,1,,,,735
6cf6c5f2d5c03fcdcc34cbfd2245eb050d6c2eba,0,Derek Dagit,2013-02-27 09:28:13-06:00,['7b7617fc1dd956af431ba589521f38649a8f4733'],1,1,2,283077,1,,,,735
c8905d641367d7dfa94a4e6e9ba58ee3618bfb55,0,Derek Dagit,2013-02-27 09:43:05-06:00,['6cf6c5f2d5c03fcdcc34cbfd2245eb050d6c2eba'],3,3,6,283083,1,,,,735
2a78dc02a54693592dd44c8555325d423c3ba60d,0,afeng,2013-02-27 13:38:42-08:00,['2123a17ed5d5ed18ba3f6a0a6d0fe3f1b4a12a9d'],2,5,7,283090,1,1,1,0,735
010ca82b438f3889220d041375f96831dd9d4892,0,Derek Dagit,2013-02-27 22:47:11-06:00,['2a78dc02a54693592dd44c8555325d423c3ba60d'],2,2,4,283094,1,,,,735
af2c7937ec965b101b5511f453c909500a635ee4,0,anfeng,2013-02-27 21:25:56-08:00,"['2a78dc02a54693592dd44c8555325d423c3ba60d', '010ca82b438f3889220d041375f96831dd9d4892']",2,2,4,283098,1,,,,735
81f888e7d54ea10d5b02df843aae154862c69e26,0,Nathan Marz,2013-03-02 20:35:41-08:00,"['ce92897f723c5001d59df1ac72ccea8d5175b3c3', 'aed32985d67a421605df570ad3291084425da030']",8,15,23,283121,2,,,,735
6398179225c00cab3a1bb16ca726839d3be4136d,0,Nathan Marz,2013-03-02 20:41:22-08:00,['81f888e7d54ea10d5b02df843aae154862c69e26'],0,2,2,283123,2,,,,735
9fbf64adf182f2e889c44a1888e5120e821d9196,0,Nathan Marz,2013-03-02 20:42:38-08:00,"['6398179225c00cab3a1bb16ca726839d3be4136d', '7970feeb90c36e0338a7e84aafaace7569129319']",7,12,19,283142,2,,,,735
8e6934783970fb74f01e1d6909b8bdce9c9b6ec2,1,afeng,2013-03-02 21:08:33-08:00,['2a78dc02a54693592dd44c8555325d423c3ba60d'],9,29,38,283180,4,0,0,0,736
1493285c6d1cc7771800e4588b08d2e3d6bf4e4b,0,afeng,2013-03-02 21:09:06-08:00,"['8e6934783970fb74f01e1d6909b8bdce9c9b6ec2', 'af2c7937ec965b101b5511f453c909500a635ee4']",0,0,0,283180,0,,,,736
9d2356f6259b585e53eb7d33de4f578c03a973ff,0,afeng,2013-03-02 21:14:35-08:00,['1493285c6d1cc7771800e4588b08d2e3d6bf4e4b'],1,1,2,283182,1,,,,736
5185746994ac8d8ae0fc78574564bdd212c89e88,0,Nathan Marz,2013-03-02 23:05:06-08:00,"['9fbf64adf182f2e889c44a1888e5120e821d9196', 'c8905d641367d7dfa94a4e6e9ba58ee3618bfb55']",6,65,71,283253,4,,,,736
3f8264ed0294bd0ec9087599b2aec21ce527b818,0,Nathan Marz,2013-03-02 23:17:50-08:00,['5185746994ac8d8ae0fc78574564bdd212c89e88'],2,2,4,283257,2,,,,736
6ee428da29a13fe9d688332adafde01ef331e417,0,Nathan Marz,2013-03-02 23:23:13-08:00,['3f8264ed0294bd0ec9087599b2aec21ce527b818'],0,1,1,283258,1,,,,736
726be6c791a90d21449bff841b1382bc927465b4,0,Nathan Marz,2013-03-05 11:15:31-08:00,"['6ee428da29a13fe9d688332adafde01ef331e417', 'befe50cc496b017576332173a7190c3b3c51588a']",4,35,39,283297,4,,,,736
28a9b029c1cac5b237dce9bb9f0fa84aeb448dae,0,Nathan Marz,2013-03-05 11:21:43-08:00,['726be6c791a90d21449bff841b1382bc927465b4'],25,1,26,283323,2,,,,736
87d133fcde784e9ecbec67f723b50d852450e3bb,0,Nathan Marz,2013-03-05 11:24:27-08:00,['28a9b029c1cac5b237dce9bb9f0fa84aeb448dae'],0,2,2,283325,2,,,,736
f6804ad2ce30e1ab3abcf1115b1d46256e0575b8,0,Nathan Marz,2013-03-06 21:14:05-08:00,['87d133fcde784e9ecbec67f723b50d852450e3bb'],7,25,32,283357,2,1,1,0.444444444,736
da2480487b53ab49238e2ba31e01a35efd1e8a57,1,Nathan Marz,2013-03-06 21:41:59-08:00,['f6804ad2ce30e1ab3abcf1115b1d46256e0575b8'],3,14,17,283374,1,1,1,1,736
9def4042b3ce0fdca3d2d410384ff8dedc4d00a4,1,afeng,2013-03-08 15:13:36-08:00,['9d2356f6259b585e53eb7d33de4f578c03a973ff'],119,109,228,283602,8,0,0,0,736
6a6dab8c46eb0d018e9b87020cde3d32d2f3d55b,1,afeng,2013-03-10 17:37:58-07:00,['9def4042b3ce0fdca3d2d410384ff8dedc4d00a4'],37,34,71,283673,2,1,1,0,736
7059efc34702c03803e43d322cc98fa1e6ed9403,0,Nathan Marz,2013-03-11 03:06:53-07:00,['da2480487b53ab49238e2ba31e01a35efd1e8a57'],0,7,7,283680,1,,,,736
4b669806530007fc92721fe1a2baa8646f479b5d,1,afeng,2013-03-11 10:50:00-07:00,['6a6dab8c46eb0d018e9b87020cde3d32d2f3d55b'],25,29,54,283734,3,,,,736
d6374fe57e75d35f1b5afa476e57e46e1980aa96,0,Nathan Marz,2013-03-11 12:33:41-07:00,"['7059efc34702c03803e43d322cc98fa1e6ed9403', '4b669806530007fc92721fe1a2baa8646f479b5d']",30,1272,1302,285036,23,,,,736
61f08d681dead891621a1e4f465a33eb659b3297,1,Nathan Marz,2013-03-11 13:04:22-07:00,['d6374fe57e75d35f1b5afa476e57e46e1980aa96'],87,93,180,285216,1,,,,736
99561759320c5b296bdc318088e13fe77ba403b6,0,Nathan Marz,2013-03-11 13:17:00-07:00,['61f08d681dead891621a1e4f465a33eb659b3297'],2,1,3,285219,1,0,0,0,736
9c91db7b2bb155b5b9322870bce863b2d531fd13,0,anfeng,2013-03-11 14:14:38-07:00,"['95761f65493b0142c3c1bfc406c599986f1b23ce', '99561759320c5b296bdc318088e13fe77ba403b6']",63,1482,1545,286764,35,,,,736
158276a9d78d5326cd5f7da571185a4824e73f2c,0,Michael Allman,2013-03-12 17:21:48-07:00,['99561759320c5b296bdc318088e13fe77ba403b6'],1,1,2,286766,1,,,,736
6e1afc29324a327cc50c9c75a6d7435a88afe069,0,James Xu,2013-03-20 13:44:37+08:00,['99561759320c5b296bdc318088e13fe77ba403b6'],1,1,2,286768,1,,,,736
39be0bbb7588d5c0f33bb6eda7c042560a9179d9,0,Nathan Marz,2013-03-20 11:02:55-07:00,"['99561759320c5b296bdc318088e13fe77ba403b6', '6e1afc29324a327cc50c9c75a6d7435a88afe069']",1,1,2,286770,1,,,,736
4ba00f5ca3a53e807cb20cc7ab0dc495a2f6de94,0,anfeng,2013-03-23 10:45:29-07:00,"['9c91db7b2bb155b5b9322870bce863b2d531fd13', '39be0bbb7588d5c0f33bb6eda7c042560a9179d9']",1,1,2,286772,1,,,,736
da29e4b4ddeafe50422f98e9ce9b1d3649f29946,0,afeng,2013-03-24 00:12:39-07:00,['4ba00f5ca3a53e807cb20cc7ab0dc495a2f6de94'],91,171,262,287034,13,1,1,1,741
5053ce6cebd0134df2a82d0e147f81b0db21272b,1,afeng,2013-03-24 10:58:04-07:00,['da29e4b4ddeafe50422f98e9ce9b1d3649f29946'],20,64,84,287118,3,,,,742
98d24466c3ab48f0a2f8fc71440d8f5e114bcd3a,0,Nathan Marz,2013-03-24 23:55:24-07:00,['99561759320c5b296bdc318088e13fe77ba403b6'],17,18,35,287153,1,,,,742
87828f76058d4312b407bba496af2d5ba2a76ff4,0,Nathan Marz,2013-03-24 23:56:10-07:00,"['98d24466c3ab48f0a2f8fc71440d8f5e114bcd3a', '39be0bbb7588d5c0f33bb6eda7c042560a9179d9']",1,1,2,287155,1,,,,742
c6cbcfc53b92fbb15cd402f9411e44901f161008,0,Jason Jackson,2013-03-25 00:35:43-07:00,['cbd217c6ea20e4d97396bbd7f112081362782573'],82,291,373,287528,10,0.265060241,1,0.289156627,743
92586a455de77d9fd90cf2ca83d4a08b7089950e,0,Nathan Marz,2013-03-25 17:02:14-07:00,['87828f76058d4312b407bba496af2d5ba2a76ff4'],1,54,55,287583,2,,,,743
4bc5f5182800e698192cef767d69bf0b8f92b907,0,Jason Jackson,2013-03-25 18:57:14-07:00,['c6cbcfc53b92fbb15cd402f9411e44901f161008'],6,1,7,287590,1,,,,743
4a31a41eaf8b20904a4a75807f7aa11411230eca,0,Jason Jackson,2013-03-25 18:58:55-07:00,['4bc5f5182800e698192cef767d69bf0b8f92b907'],9,0,9,287599,1,1,0,1,743
b12a1b9bb16ff04536b75b07a06f446a90d313ed,0,Jason Jackson,2013-03-25 19:26:01-07:00,['4a31a41eaf8b20904a4a75807f7aa11411230eca'],16,0,16,287615,1,1,0,1,743
4cdfc45e9d8a60bc094ba6cda16dcf2aab2ea94f,0,Nathan Marz,2013-03-25 20:06:31-07:00,"['cbd217c6ea20e4d97396bbd7f112081362782573', 'b12a1b9bb16ff04536b75b07a06f446a90d313ed']",81,260,341,287956,10,,,,743
e61bbf4c8601b9f0db6d2d13e3ccac4833660418,0,Nathan Marz,2013-03-25 20:08:08-07:00,"['92586a455de77d9fd90cf2ca83d4a08b7089950e', 'b12a1b9bb16ff04536b75b07a06f446a90d313ed']",83,262,345,288301,12,,,,743
11503f13f8883e66503bcaa62e6a664e14974e37,0,Nathan Marz,2013-03-25 20:14:34-07:00,['e61bbf4c8601b9f0db6d2d13e3ccac4833660418'],10,0,10,288311,1,,,,743
d6b189fe3300a8317c0d47167573555ded32054a,0,Nathan Marz,2013-03-25 21:00:04-07:00,"['11503f13f8883e66503bcaa62e6a664e14974e37', '7694401ddf8bc8c988dd70414f1aae8d1540e02b']",1,5,6,288317,2,,,,743
1d581105674b10c36e63ee071c98ed51f4311dcb,0,Nathan Marz,2013-03-25 21:09:18-07:00,"['d6b189fe3300a8317c0d47167573555ded32054a', '55d5b8d52f5575b0f479386025572024091df29f']",2,20,22,288339,2,,,,743
930fcbfb6787e364e779bdc332dc0ebcbe076c51,0,Nathan Marz,2013-03-25 21:24:33-07:00,['1d581105674b10c36e63ee071c98ed51f4311dcb'],0,2,2,288341,1,0,0,1,743
c15b28fd71098f77323680db9b1bb0e76cfdbe94,0,Nathan Marz,2013-03-25 21:24:40-07:00,['930fcbfb6787e364e779bdc332dc0ebcbe076c51'],3,1,4,288345,1,,,,743
cfe7662c800c4b69313457053201478f8506d38b,0,Nathan Marz,2013-03-25 21:24:45-07:00,['c15b28fd71098f77323680db9b1bb0e76cfdbe94'],0,6,6,288351,1,,,,743
a6f409e46c0c4a4caa8131fecc89e6d7aa9fd8cf,0,Nathan Marz,2013-03-25 21:26:12-07:00,['cfe7662c800c4b69313457053201478f8506d38b'],0,1,1,288352,1,,,,743
67cb6311277d7b479668e356d0aee1b9a9e6fb0f,1,afeng,2013-03-26 13:27:08-07:00,['5053ce6cebd0134df2a82d0e147f81b0db21272b'],92,145,237,288589,8,,,,743
51ca0f1817a77c2bcc8699d3a3bbfbc53746971d,0,afeng,2013-03-26 15:10:49-07:00,"['67cb6311277d7b479668e356d0aee1b9a9e6fb0f', 'a6f409e46c0c4a4caa8131fecc89e6d7aa9fd8cf']",101,357,458,289047,23,,,,743
c75dbf3fd7e78f0f8c47019942464a2444c6bcd3,0,Derek Dagit,2013-03-27 19:36:40+00:00,['a6f409e46c0c4a4caa8131fecc89e6d7aa9fd8cf'],22,257,279,289326,9,1,1,0,749
2b0cedddd06c8994910ec0faa4cefb04046fed39,0,Nathan Marz,2013-03-27 14:04:41-07:00,"['a6f409e46c0c4a4caa8131fecc89e6d7aa9fd8cf', '158276a9d78d5326cd5f7da571185a4824e73f2c']",1,1,2,289328,1,,,,749
d69ef33ac8acde572d95b0f92195722ffd1b8140,0,afeng,2013-03-28 11:25:36-07:00,['51ca0f1817a77c2bcc8699d3a3bbfbc53746971d'],223,127,350,289678,5,1,1,0.894736842,751
8e57a6c151ac85110b012d8ad7e008f1914d21e0,0,afeng,2013-03-28 11:39:32-07:00,['d69ef33ac8acde572d95b0f92195722ffd1b8140'],11,19,30,289708,4,0,0,0,751
69f1d2a524bea56c5842715d0f6aca8229a6c118,0,Jason Jackson,2013-03-28 21:10:56-07:00,['4cdfc45e9d8a60bc094ba6cda16dcf2aab2ea94f'],0,68,68,289776,1,0.157894737,1,1,752
08ee9c44f084986cca0c9a011b1321f18a4a722d,0,afeng,2013-03-29 18:09:47-07:00,['8e57a6c151ac85110b012d8ad7e008f1914d21e0'],20,23,43,289819,2,,,,752
9238c285a678a76d28a5fc730008393674c146bb,0,afeng,2013-03-30 20:03:14-07:00,['08ee9c44f084986cca0c9a011b1321f18a4a722d'],9,1,10,289829,3,0,0,0,752
a97743bd0249866c63c2eadd910205bea54588e0,0,afeng,2013-03-31 09:56:13-07:00,['9238c285a678a76d28a5fc730008393674c146bb'],10,11,21,289850,2,0,0,0,752
61eee4da6533f3131dd0f875f620c5784baa816f,0,Nathan Marz,2013-04-01 21:38:57-07:00,"['2b0cedddd06c8994910ec0faa4cefb04046fed39', 'c75dbf3fd7e78f0f8c47019942464a2444c6bcd3']",22,257,279,290129,9,,,,752
78b9f99a54eaebe24727357f1318c954775ac3c2,0,Nathan Marz,2013-04-01 23:48:36-07:00,"['4cdfc45e9d8a60bc094ba6cda16dcf2aab2ea94f', '69f1d2a524bea56c5842715d0f6aca8229a6c118']",0,68,68,290197,1,,,,752
5dca35005fd04d220b72cc1d62b172644d5ee711,0,afeng,2013-04-01 23:57:52-07:00,['a97743bd0249866c63c2eadd910205bea54588e0'],1,1,2,290199,1,,,,752
eb63cceea530a6c77d67ddfd74abb66bbe020617,0,afeng,2013-04-04 22:40:15-07:00,['5dca35005fd04d220b72cc1d62b172644d5ee711'],116,17,133,290332,6,0,0,0.145454545,752
3a1ab99a6f655d30d68851736a3df27e1b42a96e,0,afeng,2013-04-04 22:46:04-07:00,['eb63cceea530a6c77d67ddfd74abb66bbe020617'],0,200,200,290532,2,,,,754
2dcbc57c3bba40688e3ee567aa6667914a587a63,0,afeng,2013-04-10 21:53:55-07:00,['3a1ab99a6f655d30d68851736a3df27e1b42a96e'],12,6,18,290550,2,,,,754
da608a1b54164d8bcf74eb951140fa51aa91c216,0,Nathan Marz,2013-04-16 22:43:16-07:00,"['61eee4da6533f3131dd0f875f620c5784baa816f', '2dcbc57c3bba40688e3ee567aa6667914a587a63']",100,284,384,290934,13,,,,754
1b8bd3a9132e3456db1844b1272eb24a89da427e,0,Nathan Marz,2013-04-16 22:51:11-07:00,['da608a1b54164d8bcf74eb951140fa51aa91c216'],3,3,6,290940,1,,,,754
cfbcafddd63249b1f9029b8e8344ef6943856e23,0,anfeng,2013-04-16 22:51:55-07:00,"['2dcbc57c3bba40688e3ee567aa6667914a587a63', '1b8bd3a9132e3456db1844b1272eb24a89da427e']",26,261,287,291227,10,,,,754
220f92470476ca5c0b314d1a6e4d388b70266c44,0,Nathan Marz,2013-04-16 22:53:47-07:00,"['1b8bd3a9132e3456db1844b1272eb24a89da427e', '69f1d2a524bea56c5842715d0f6aca8229a6c118']",0,68,68,291295,1,,,,754
0e74f0086fa9c23eeab3133fd126a1ed0b342a38,0,Nathan Marz,2013-04-17 14:54:19-07:00,['220f92470476ca5c0b314d1a6e4d388b70266c44'],82,185,267,291562,559,,,,762
5d64bb91da551132f54e24543a3bd53dd0e7b293,0,Nathan Marz,2013-04-17 15:26:56-07:00,['0e74f0086fa9c23eeab3133fd126a1ed0b342a38'],11,0,11,291573,1,,,,762
6d04c9ba1bdf5f9018885b47d89a5d6127c95d18,0,Nathan Marz,2013-04-17 15:33:34-07:00,['5d64bb91da551132f54e24543a3bd53dd0e7b293'],2,0,2,291575,1,,,,762
b168177aec5009ddcb1aaf18e34dbd052c30d8b3,0,Nathan Marz,2013-04-17 21:47:16-07:00,['6d04c9ba1bdf5f9018885b47d89a5d6127c95d18'],0,1,1,291576,1,,,,762
b1489d269376acbcdfd012d0ecf3653b817f22aa,0,anfeng,2013-04-19 17:24:27-07:00,['2dcbc57c3bba40688e3ee567aa6667914a587a63'],2,2,4,291580,1,,,,762
b9c82ae391311c1780b50192ec5c5af3a9a7dee2,0,anfeng,2013-04-19 17:25:38-07:00,"['b1489d269376acbcdfd012d0ecf3653b817f22aa', 'cfbcafddd63249b1f9029b8e8344ef6943856e23']",26,261,287,291867,10,,,,762
9bbc7ea9175fa5d7389d2681be98d37a4ace5e18,0,anfeng,2013-04-19 17:29:11-07:00,"['b9c82ae391311c1780b50192ec5c5af3a9a7dee2', 'b168177aec5009ddcb1aaf18e34dbd052c30d8b3']",82,241,323,292190,559,,,,762
5542477f31d8c992aba31e4a28d7c1a8d452bfb4,0,anfeng,2013-04-19 17:35:07-07:00,"['9c91db7b2bb155b5b9322870bce863b2d531fd13', 'b168177aec5009ddcb1aaf18e34dbd052c30d8b3']",397,1227,1624,293814,566,,,,762
f2ff91ad084f038988858896430b810c33dfbec0,0,Nathan Marz,2013-04-19 23:49:18-07:00,"['b168177aec5009ddcb1aaf18e34dbd052c30d8b3', '9bbc7ea9175fa5d7389d2681be98d37a4ace5e18']",2,2,4,293818,1,,,,762
e09cd94fa55098d4718b02630997a118f30c1215,0,Yu L Li,2013-04-23 18:33:41-07:00,['f2ff91ad084f038988858896430b810c33dfbec0'],3,4,7,293825,2,,,,762
205bc6339f7d59ca6533231e0c92a1ad295e05f0,0,Jason Jackson,2013-04-24 10:54:51-07:00,['47ce0ae97830380eb85db7ae97a7f7f3adbff820'],5,50,55,293880,4,0.266666667,0.5,0.5,762
61be2a01feb81146d89071fbe292dcf396a70c47,0,Jason Jackson,2013-04-24 10:55:45-07:00,['205bc6339f7d59ca6533231e0c92a1ad295e05f0'],1,1,2,293882,1,,,,762
a54068c712e73a562c70cd009a216d8674cddef8,1,anfeng,2013-04-30 13:24:56-07:00,['9bbc7ea9175fa5d7389d2681be98d37a4ace5e18'],4,854,858,294740,15,0.658064516,0.890322581,0.803225806,774
7d4d1608f35a9c20c626afefb1e7d8ba7c70e1f4,1,Derek Dagit,2013-04-30 16:24:54-05:00,['f2ff91ad084f038988858896430b810c33dfbec0'],1,1,2,294742,1,,,,774
9df128f09cd213c70c38bfaecc256aa292c1ffff,0,Nathan Marz,2013-05-01 00:30:02-07:00,"['f2ff91ad084f038988858896430b810c33dfbec0', '7d4d1608f35a9c20c626afefb1e7d8ba7c70e1f4']",1,1,2,294744,1,,,,774
9f22f7e566a4135989b4b81cf793ad26a622f49e,0,anfeng,2013-05-01 20:39:00-07:00,['a54068c712e73a562c70cd009a216d8674cddef8'],0,14,14,294758,13,,,,775
b7cf74727da1ad0073b18ea248da45aa157a9cb4,0,anfeng,2013-05-01 20:59:43-07:00,['9f22f7e566a4135989b4b81cf793ad26a622f49e'],6,4,10,294768,1,,,,775
e29609532ff7152bfbd4e9d7e44b95e74272560a,0,anfeng,2013-05-01 21:51:53-07:00,['b7cf74727da1ad0073b18ea248da45aa157a9cb4'],1,0,1,294769,1,,,,775
fd61bb2e1c58f2b704ee7eabe522ea7457fe0606,0,ankitoshniwal,2013-05-02 12:58:21-07:00,['9df128f09cd213c70c38bfaecc256aa292c1ffff'],1,1,2,294771,1,,,,775
ba72e88d6030f66393b3d1037986adfdffce1479,0,anfeng,2013-05-03 15:34:36-07:00,"['5542477f31d8c992aba31e4a28d7c1a8d452bfb4', '9df128f09cd213c70c38bfaecc256aa292c1ffff']",3,3,6,294777,2,,,,775
1c2ba11fdd7a47b04fb5df42ca17b901664f4168,0,afeng,2013-05-03 22:47:06+00:00,['ba72e88d6030f66393b3d1037986adfdffce1479'],4,25,29,294806,1,1,1,1,775
66aadc3037db57b8c1b549e630d8d8cc3fcbccc4,0,anfeng,2013-05-04 15:57:11-07:00,['e29609532ff7152bfbd4e9d7e44b95e74272560a'],87,121,208,295014,10,0.363636364,1,0.954545455,775
3babdb09be2128432511f5d52c1dfac59b1be72a,0,anfeng,2013-05-04 15:59:47-07:00,['66aadc3037db57b8c1b549e630d8d8cc3fcbccc4'],2,0,2,295016,1,,,,775
0d02b6554430976b701cf34edca3026d3aedbefd,0,anfeng,2013-05-05 09:19:06-07:00,['3babdb09be2128432511f5d52c1dfac59b1be72a'],5,10,15,295031,2,,,,775
1ac7b413732892317559dcd9837f998ea8068f15,0,anfeng,2013-05-05 14:43:59-07:00,['0d02b6554430976b701cf34edca3026d3aedbefd'],20,36,56,295087,6,0,0.909090909,1,775
6e96a1f3639ea7a444f0a0fc55427e98aa128604,0,anfeng,2013-05-06 00:17:35-07:00,['1ac7b413732892317559dcd9837f998ea8068f15'],10,22,32,295119,2,1,1,0.833333333,775
e0f3504a77aa294e3b8dd3e850f0ac82b7c2fba2,0,Nathan Marz,2013-05-06 12:43:14-07:00,"['9df128f09cd213c70c38bfaecc256aa292c1ffff', 'fd61bb2e1c58f2b704ee7eabe522ea7457fe0606']",1,1,2,295121,1,,,,775
66af2faf4732b788c0f57ab5582a96d757cfc8ad,0,Jason Jackson,2013-05-08 01:33:58-07:00,['78b9f99a54eaebe24727357f1318c954775ac3c2'],13,12,25,295146,1,0,0,0,775
44f7ddb5d8ce7f9488561d0c576024d04dfc8ec9,0,Jason Jackson,2013-05-08 01:33:35-07:00,"['78b9f99a54eaebe24727357f1318c954775ac3c2', '66af2faf4732b788c0f57ab5582a96d757cfc8ad']",13,12,25,295171,1,,,,775
22c7a8da5bbc00adb400b8d6a17139ae17483635,1,anfeng,2013-05-08 21:32:47-07:00,['6e96a1f3639ea7a444f0a0fc55427e98aa128604'],90,130,220,295391,12,0.344827586,0.103448276,0.310344828,776
43053a7c57db68a4c5bf66d0ab76683f95ad18a0,0,Jason Jackson,2013-05-09 01:01:29-07:00,['44f7ddb5d8ce7f9488561d0c576024d04dfc8ec9'],1,12,13,295404,1,1,1,1,776
b15d695bacd003927fd078432000e796b6a56919,0,wurstmeister,2013-05-09 11:33:02-07:00,[],0,2,2,295406,1,,,,777
5f58bb35e56fac5faf13b4a6ee756cc6db442b83,1,thomas,2013-05-09 19:37:04+01:00,['b15d695bacd003927fd078432000e796b6a56919'],0,1726,1726,297132,27,0.596194503,0.733615222,0.746300211,804
b259294e1eba6deb650affd56725c57034eefe1b,0,Kyle Bolton,2013-05-09 15:45:22-03:00,['e0f3504a77aa294e3b8dd3e850f0ac82b7c2fba2'],1,1,2,297134,1,,,,804
d55df553aa3749107e0bd9938799375ecb2cec02,0,wurstmeister,2013-05-09 21:20:55+01:00,['5f58bb35e56fac5faf13b4a6ee756cc6db442b83'],0,23,23,297157,1,,,,804
38bde87ed3e27ee5d5dfe1fdf5e25a4640472792,1,wurstmeister,2013-05-09 21:22:26+01:00,['d55df553aa3749107e0bd9938799375ecb2cec02'],22,55,77,297234,6,0.869565217,0.913043478,0.347826087,804
89e8c661435698deb318ddf95fd309db1f2f2e8e,1,anfeng,2013-05-09 20:31:37-07:00,['22c7a8da5bbc00adb400b8d6a17139ae17483635'],55,86,141,297375,6,1,1,1,804
cbd9d1e8bfc247df7076460ba604c223b5792fec,0,anfeng,2013-05-09 20:37:09-07:00,['89e8c661435698deb318ddf95fd309db1f2f2e8e'],4,2,6,297381,2,,,,804
86cff767e63b18c81db73a8676e4a4f587ffcbc2,0,anfeng,2013-05-09 21:06:03-07:00,['cbd9d1e8bfc247df7076460ba604c223b5792fec'],29,22,51,297432,2,1,0,1,804
794ba735d68aea59ab5a527b2d769994f3d6ca4d,0,anfeng,2013-05-10 11:55:38-07:00,['86cff767e63b18c81db73a8676e4a4f587ffcbc2'],4,4,8,297440,3,,,,804
176154666faeda8438d306ceb5008365efa6823b,1,Jason Jackson,2013-05-10 14:21:58-07:00,['43053a7c57db68a4c5bf66d0ab76683f95ad18a0'],2,13,15,297455,2,1,1,1,804
d12c33543c9b2e8c8e35908f8672fa06edd18c2e,0,Nathan Marz,2013-05-10 14:26:13-07:00,"['44f7ddb5d8ce7f9488561d0c576024d04dfc8ec9', '176154666faeda8438d306ceb5008365efa6823b']",1,23,24,297479,2,,,,804
dea4c8b6db422a766c922437b4eeed89f3cc8f9f,0,Nathan Marz,2013-05-10 14:27:28-07:00,"['e0f3504a77aa294e3b8dd3e850f0ac82b7c2fba2', '78b9f99a54eaebe24727357f1318c954775ac3c2']",0,0,0,297479,0,,,,804
7c6a77e2322201dfde973b6ecff16a63d09d4eb0,0,Nathan Marz,2013-05-10 14:27:56-07:00,"['dea4c8b6db422a766c922437b4eeed89f3cc8f9f', 'd12c33543c9b2e8c8e35908f8672fa06edd18c2e']",14,35,49,297528,3,,,,804
712d79deba284c9faa24a936c7753d875513d49f,1,anfeng,2013-05-10 15:11:05-07:00,['794ba735d68aea59ab5a527b2d769994f3d6ca4d'],127,95,222,297750,9,0,0,0.055555556,804
2718142cb7d112bc0b91a8bf0dc249c60184c716,0,anfeng,2013-05-10 18:26:37-07:00,['712d79deba284c9faa24a936c7753d875513d49f'],11,3,14,297764,2,0,0,0,804
687cc25abdb33ef36b4031632874a8624610e8db,0,anfeng,2013-05-10 18:45:48-07:00,['2718142cb7d112bc0b91a8bf0dc249c60184c716'],2,1,3,297767,1,,,,804
c4f2b1e08af923318eb8735e0483927abe55ff73,1,anfeng,2013-05-10 20:41:01-07:00,['687cc25abdb33ef36b4031632874a8624610e8db'],83,177,260,298027,8,1,1,1,805
b7f04fe2e7e413f932c703a562e8d358833b01ff,0,anfeng,2013-05-10 20:45:29-07:00,['c4f2b1e08af923318eb8735e0483927abe55ff73'],11,0,11,298038,2,,,,805
005cd8b348a27267e80a3c557c6a6ae25d3f33c2,1,wurstmeister,2013-05-11 15:10:21+01:00,['38bde87ed3e27ee5d5dfe1fdf5e25a4640472792'],178,229,407,298445,25,1,1,1,811
7c50c367937ee98b21b3c203f3afb0e336acf755,0,anfeng,2013-05-11 07:59:19-07:00,['b7f04fe2e7e413f932c703a562e8d358833b01ff'],4,5,9,298454,2,0,0,0,811
e20dcd1d5f3fa6d6e40ac0fe6a4f401930d0a93d,0,wurstmeister,2013-05-11 19:48:12+01:00,['005cd8b348a27267e80a3c557c6a6ae25d3f33c2'],47,50,97,298551,5,0,0,0,812
cb5eccbc458cce5b60f0759491366f8a7b16a696,0,anfeng,2013-05-11 19:36:19-07:00,['7c50c367937ee98b21b3c203f3afb0e336acf755'],0,50,50,298601,2,,,,813
ca1462466a63bd7cdc4038e86e6ee67ec6c37755,0,anfeng,2013-05-11 19:49:37-07:00,['cb5eccbc458cce5b60f0759491366f8a7b16a696'],0,8,8,298609,1,,,,813
6866319e7c22a41ed07b5eddbc498be41428fe85,0,anfeng,2013-05-11 20:18:47-07:00,['ca1462466a63bd7cdc4038e86e6ee67ec6c37755'],23,14,37,298646,1,,,,813
98c98c7d4b24a9d45132c36bcbeaa9c1d8f0ad83,1,anfeng,2013-05-11 23:25:42-07:00,['6866319e7c22a41ed07b5eddbc498be41428fe85'],35,63,98,298744,4,1,1,1,813
966bb5381c0547a940bdeadcaab6bb30ebfd5cd2,1,Derek Dagit,2013-05-16 13:38:47-05:00,['7c6a77e2322201dfde973b6ecff16a63d09d4eb0'],95,95,190,298934,1,,,,813
4024080de5ee9d131b766f870007b13d723ee3cc,1,wurstmeister,2013-05-16 20:23:11+01:00,['e20dcd1d5f3fa6d6e40ac0fe6a4f401930d0a93d'],247,228,475,299409,21,0.857142857,1,0.714285714,814
9abf90b4d924e9b74c4ead612e8819ebd24fca3b,1,wurstmeister,2013-05-16 22:34:08+01:00,['4024080de5ee9d131b766f870007b13d723ee3cc'],24,360,384,299793,4,1,1,0.888888889,816
e4a59d35c7c294316695b5281d61beda1354fe19,0,Nathan Marz,2013-05-16 14:44:14-07:00,"['7c6a77e2322201dfde973b6ecff16a63d09d4eb0', '966bb5381c0547a940bdeadcaab6bb30ebfd5cd2']",95,95,190,299983,1,,,,816
f63b276ea3e99ff7257a31b68e1b7a364bf9f1ac,0,wurstmeister,2013-05-16 22:51:54+01:00,['9abf90b4d924e9b74c4ead612e8819ebd24fca3b'],6,0,6,299989,2,,,,816
f8088920b71b4ab704ffc76f63dab74dc1e834cd,1,wurstmeister,2013-05-22 09:48:16+01:00,['f63b276ea3e99ff7257a31b68e1b7a364bf9f1ac'],253,280,533,300522,9,0,1,0.892857143,817
ddee8961af3d8618610320ee5793547879c91cfa,0,wurstmeister,2013-05-22 11:43:36+01:00,['f8088920b71b4ab704ffc76f63dab74dc1e834cd'],54,41,95,300617,8,1,1,0,817
4d0c93db22b1b63081be95264b2548b793fdd439,0,Nathan Marz,2013-05-28 14:01:56-07:00,"['7c6a77e2322201dfde973b6ecff16a63d09d4eb0', '98c98c7d4b24a9d45132c36bcbeaa9c1d8f0ad83']",0,1108,1108,301725,17,,,,817
12db76f78966da3202c911d00ea777a7173b6f66,0,Nathan Marz,2013-05-28 14:02:33-07:00,['4d0c93db22b1b63081be95264b2548b793fdd439'],62,0,62,301787,1,,,,817
d6e6ebb63acf28ff488370bbcaae180a3c759491,0,Nathan Marz,2013-05-28 14:03:06-07:00,"['12db76f78966da3202c911d00ea777a7173b6f66', 'e4a59d35c7c294316695b5281d61beda1354fe19']",95,95,190,301977,1,,,,817
b87b363cc1d92a9f6ad1dda1db49502cb963bcbd,0,Nathan Marz,2013-05-28 14:09:53-07:00,['d6e6ebb63acf28ff488370bbcaae180a3c759491'],11,4,15,301992,4,,,,817
d96f4313598069c54d26b8627f9bf65dfe2f3fa7,0,Nathan Marz,2013-05-28 14:29:48-07:00,['b87b363cc1d92a9f6ad1dda1db49502cb963bcbd'],2,3,5,301997,3,,,,817
bd2b576f6d23026cda4a500f9e90f06c24291b55,0,Nathan Marz,2013-05-28 15:59:26-07:00,['d96f4313598069c54d26b8627f9bf65dfe2f3fa7'],0,2,2,301999,1,,,,817
09635e8ce6c1493cc86cb50bcd024e6825e2d6df,0,Nathan Marz,2013-05-29 13:43:51-07:00,['bd2b576f6d23026cda4a500f9e90f06c24291b55'],1,1,2,302001,1,,,,817
ef217eb1eb8a2cd72c7ff346e9356da4f2ac49cb,0,Nathan Marz,2013-05-29 13:46:24-07:00,['09635e8ce6c1493cc86cb50bcd024e6825e2d6df'],0,1,1,302002,1,,,,817
1915ca41c15f8790e5080bff2fbfbb93d8eee4a8,0,Derek Dagit,2013-05-29 17:13:07-05:00,['ef217eb1eb8a2cd72c7ff346e9356da4f2ac49cb'],1,1,2,302004,1,,,,817
0a4b9846e154668f83592e8ffe5085e1ad749500,0,Nathan Marz,2013-05-29 15:24:52-07:00,"['ef217eb1eb8a2cd72c7ff346e9356da4f2ac49cb', '1915ca41c15f8790e5080bff2fbfbb93d8eee4a8']",1,1,2,302006,1,,,,817
0f663d2fa1ddd3e26e91937b9fa7ba8b0db55272,0,Derek Dagit,2013-05-29 17:35:45-05:00,['ef217eb1eb8a2cd72c7ff346e9356da4f2ac49cb'],6,6,12,302018,5,,,,817
cbb9cd164eca30daa960e6f32849d6d0ff56c63b,0,Nathan Marz,2013-05-29 16:22:23-07:00,"['0a4b9846e154668f83592e8ffe5085e1ad749500', '0f663d2fa1ddd3e26e91937b9fa7ba8b0db55272']",6,6,12,302030,5,,,,817
9a3e07fb1bca77d2fc7145708b804ddd22556d66,0,anfeng,2013-05-29 21:12:34-07:00,"['1c2ba11fdd7a47b04fb5df42ca17b901664f4168', 'cbb9cd164eca30daa960e6f32849d6d0ff56c63b']",119,1183,1302,303332,29,,,,817
28e4f8e8a270a72e70bc5284339a04481e41227f,0,anfeng,2013-05-29 21:23:15-07:00,['9a3e07fb1bca77d2fc7145708b804ddd22556d66'],4,4,8,303340,1,,,,817
064874b6a5640e8b337e7eeae82bcf87d9890646,0,anfeng,2013-05-29 21:28:53-07:00,['28e4f8e8a270a72e70bc5284339a04481e41227f'],25,4,29,303369,1,0,0,0,817
b20ea50281e122092e2256c1b0853f18521aa4d5,0,Nathan Marz,2013-05-29 21:34:57-07:00,"['cbb9cd164eca30daa960e6f32849d6d0ff56c63b', '064874b6a5640e8b337e7eeae82bcf87d9890646']",4,4,8,303377,1,,,,817
9f761d8f3202a5342fde7d9042aea8a4ce3f68b2,1,Derek Dagit,2013-06-04 01:11:10-05:00,['b20ea50281e122092e2256c1b0853f18521aa4d5'],1,171,172,303549,1,0,1,1,817
6ac59944b98fc2450c2d511dad47c7b8e2e4ee1c,1,Derek Dagit,2013-06-04 01:16:57-05:00,['9f761d8f3202a5342fde7d9042aea8a4ce3f68b2'],4,4,8,303557,1,,,,817
792248276f20f4645f0a2e9a7143e2202cfbff2d,0,Derek Dagit,2013-06-04 01:18:40-05:00,['6ac59944b98fc2450c2d511dad47c7b8e2e4ee1c'],29,29,58,303615,1,,,,817
5b8cb78e966f0443c9afae8aba83f752aee8dff7,0,Derek Dagit,2013-06-04 11:48:14-05:00,['792248276f20f4645f0a2e9a7143e2202cfbff2d'],1,0,1,303616,1,,,,817
b88a81e80d6e731abee655a31a253deed803e48d,1,Derek Dagit,2013-06-04 12:08:30-05:00,['5b8cb78e966f0443c9afae8aba83f752aee8dff7'],3,3,6,303622,1,,,,817
19bb2ea13a08808d1dcf023baa2c619d7efd5b01,0,Derek Dagit,2013-06-04 12:14:02-05:00,['b88a81e80d6e731abee655a31a253deed803e48d'],3,50,53,303675,1,,,,817
840fe5abca000d4b9db025a4495479df0fb726ed,0,Tudor Scurtu,2013-06-06 15:18:24+03:00,['b20ea50281e122092e2256c1b0853f18521aa4d5'],4,15,19,303694,2,,,,817
0fca3034ff90c8d5de2e327d58085580fcc74256,0,smelody@wgen.net,2013-06-06 10:24:22-04:00,['b20ea50281e122092e2256c1b0853f18521aa4d5'],1,4,5,303699,1,,,,817
cf4a4d0b125bf5a5371f747c2992d8725b5c3140,0,smelody@wgen.net,2013-06-06 10:29:00-04:00,['0fca3034ff90c8d5de2e327d58085580fcc74256'],2,0,2,303701,1,,,,817
489e2b506dab730c4dc02387ec90f82d10185451,0,P. Taylor Goetz,2013-06-10 10:32:26-04:00,['dd4e5e694b814a638d4c510abf5cb50952030cd5'],1,1,2,303703,1,,,,817
7fc8e9342fa080f9c5a9055825c0542b6e4f00dc,0,P. Taylor Goetz,2013-06-10 10:32:29-04:00,['489e2b506dab730c4dc02387ec90f82d10185451'],1,1,2,303705,1,,,,817
f0c0bba6b235473b1b65ada94e93808242d9d006,0,Nathan Marz,2013-06-12 15:17:52-04:00,['b20ea50281e122092e2256c1b0853f18521aa4d5'],1,1,2,303707,1,,,,817
0e68cf9e2eb97daa9470d6fbe373a1b7b038d96d,1,Kyle Nusbaum,2013-06-14 20:46:33+00:00,['f0c0bba6b235473b1b65ada94e93808242d9d006'],86,90,176,303883,1,,,,817
9518035cf975863fe114fb95d9fae7b8c1a2f646,0,anfeng,2013-06-17 20:53:59-07:00,"['98c98c7d4b24a9d45132c36bcbeaa9c1d8f0ad83', 'f0c0bba6b235473b1b65ada94e93808242d9d006']",195,151,346,304229,20,,,,817
4b3558169c1dd11d4348440df774777b9130bdf7,0,anfeng,2013-06-17 21:14:04-07:00,['9518035cf975863fe114fb95d9fae7b8c1a2f646'],0,2,2,304231,1,,,,817
2a02f9fdace05317cc3c878a2b2f7a7fe4f060eb,0,andy_lock_farm,2013-06-18 09:27:35+01:00,['dd4e5e694b814a638d4c510abf5cb50952030cd5'],0,9,9,304240,1,,,,817
217acc97fbae6caf3d0b771634070f9af2b691c6,0,andy_lock_farm,2013-06-18 09:27:46+01:00,"['2a02f9fdace05317cc3c878a2b2f7a7fe4f060eb', '7fc8e9342fa080f9c5a9055825c0542b6e4f00dc']",1,1,2,304242,1,,,,817
ab4749798fb445798976330c7c9991aec47796fd,0,andy_lock_farm,2013-06-18 11:02:38+01:00,['217acc97fbae6caf3d0b771634070f9af2b691c6'],0,401,401,304643,2,0.521276596,0.787234043,0.60106383,819
33eea52452be6b53257899573b0c97066876bb92,0,Kang Xiao,2013-06-19 06:24:56+08:00,['f0c0bba6b235473b1b65ada94e93808242d9d006'],2,63,65,304708,5,,,,820
fb11b7668611c555d76d75d706466751750b83bf,1,Kang Xiao,2013-06-21 13:06:03+08:00,['33eea52452be6b53257899573b0c97066876bb92'],12,27,39,304747,2,,,,820
e5dd05167603fe62d9fcb9274b691b5de89881dd,0,Derek Dagit,2013-06-21 11:19:00-05:00,['b20ea50281e122092e2256c1b0853f18521aa4d5'],0,3,3,304750,1,,,,820
bf08c9e6f7f81f46c25927a1d043fe275c1aa647,0,Nathan Marz,2013-06-21 11:03:21-07:00,"['f0c0bba6b235473b1b65ada94e93808242d9d006', '0e68cf9e2eb97daa9470d6fbe373a1b7b038d96d']",86,90,176,304926,1,,,,820
6537459cb816fc3de58f04f2b855cd2fecd9c06c,1,David Lao,2013-06-21 11:08:33-07:00,['d12c33543c9b2e8c8e35908f8672fa06edd18c2e'],38,90,128,305054,7,,,,820
2be4a081fbcfadfed2101129875daef31088698c,0,David Lao,2013-06-21 11:22:11-07:00,['6537459cb816fc3de58f04f2b855cd2fecd9c06c'],23,2,25,305079,2,,,,820
ed7e0f85b25d58bf08bf3c7cb28c1e7b40956f49,1,David Lao,2013-06-21 11:23:48-07:00,['2be4a081fbcfadfed2101129875daef31088698c'],0,281,281,305360,2,,,,822
6ea81d8f6063744d2c6e58cdd805c405b608c77c,0,Nathan Marz,2013-06-21 11:24:16-07:00,"['bf08c9e6f7f81f46c25927a1d043fe275c1aa647', 'e5dd05167603fe62d9fcb9274b691b5de89881dd']",0,3,3,305363,1,,,,822
463f6f75e53bb6e655eaaf0e1aeb9c6369fd9d38,0,Nathan Marz,2013-06-21 14:25:24-04:00,['6ea81d8f6063744d2c6e58cdd805c405b608c77c'],0,1,1,305364,1,,,,822
35c64a35ef60eb1f571dc95bc21bcbeb68059f57,0,Nathan Marz,2013-06-21 14:28:25-04:00,"['463f6f75e53bb6e655eaaf0e1aeb9c6369fd9d38', '840fe5abca000d4b9db025a4495479df0fb726ed']",4,15,19,305383,2,,,,822
b2fc3098524bf841ebcd72282216689339d93df9,1,Nathan Marz,2013-06-21 14:29:07-04:00,['35c64a35ef60eb1f571dc95bc21bcbeb68059f57'],1,1,2,305385,1,,,,822
5d4bb6a42c4d87808a195fc7e1d6b232ad10c1ff,0,anfeng,2013-06-21 11:29:37-07:00,['4b3558169c1dd11d4348440df774777b9130bdf7'],1,6,7,305392,1,,,,822
9ee5587ad452f4aaa346d6f88a8c206201aa59db,0,David Lao,2013-06-21 11:31:06-07:00,['ed7e0f85b25d58bf08bf3c7cb28c1e7b40956f49'],2,0,2,305394,1,,,,822
fd5754b6ba07a17e9a4fff55af3fb662da648750,0,Nathan Marz,2013-06-21 14:40:57-04:00,['b2fc3098524bf841ebcd72282216689339d93df9'],0,2,2,305396,2,,,,822
cda7482ea3cf474d9039afff8a9dafab31979ba0,0,anfeng,2013-06-21 12:02:32-07:00,['5d4bb6a42c4d87808a195fc7e1d6b232ad10c1ff'],1,1,2,305398,1,,,,822
0b2a2c304eb0eba9ce83f0bb53249eeb82dcf069,0,Kang Xiao,2013-06-24 22:52:23+08:00,"['fb11b7668611c555d76d75d706466751750b83bf', 'fd5754b6ba07a17e9a4fff55af3fb662da648750']",90,111,201,305599,6,,,,822
077efd3c3a8079361e06cbbb3a9754c746a60a95,1,Kang Xiao,2013-06-24 23:46:57+08:00,['0b2a2c304eb0eba9ce83f0bb53249eeb82dcf069'],21,43,64,305663,6,,,,822
f5455a01fbfd6870b70b146d722a7079dc84e2e6,1,Homer Strong,2013-06-25 14:54:36-07:00,['fd5754b6ba07a17e9a4fff55af3fb662da648750'],3,11,14,305677,3,,,,822
97f5fae27d4f67b89a282609d00444cc9993305d,0,Homer Strong,2013-06-25 14:59:27-07:00,['f5455a01fbfd6870b70b146d722a7079dc84e2e6'],1,1,2,305679,1,,,,822
b2417d49d67bbbdd6c9ee58f009c58098a527962,0,ankitoshniwal,2013-07-03 12:17:05-07:00,['fd61bb2e1c58f2b704ee7eabe522ea7457fe0606'],1,2,3,305682,1,,,,822
ceb002f155e599c73a86021c5dea0aec43a8c204,0,ankitoshniwal,2013-07-03 12:19:03-07:00,['b2417d49d67bbbdd6c9ee58f009c58098a527962'],1,1,2,305684,1,,,,822
aac85e221722d61ba9a2aa2395ca6a5504028a95,0,ankitoshniwal,2013-07-03 12:19:51-07:00,['ceb002f155e599c73a86021c5dea0aec43a8c204'],1,1,2,305686,1,,,,822
0ba0e3e0c9100af24b17d7fdbcc4f82fcec7d239,0,Nathan Marz,2013-07-09 11:03:30-07:00,"['fd5754b6ba07a17e9a4fff55af3fb662da648750', 'cda7482ea3cf474d9039afff8a9dafab31979ba0']",0,7,7,305693,1,,,,822
b93bda5cb7eea5ca42e3ba108904f54eb834d0df,0,Nathan Marz,2013-07-09 11:07:46-07:00,"['077efd3c3a8079361e06cbbb3a9754c746a60a95', '0ba0e3e0c9100af24b17d7fdbcc4f82fcec7d239']",0,7,7,305700,1,,,,822
c4d4b81f72abdeea9f83d2f5e9f1239370b330e6,0,Nathan Marz,2013-07-09 11:22:58-07:00,['b93bda5cb7eea5ca42e3ba108904f54eb834d0df'],4,19,23,305723,2,,,,822
369c7fea3f40c960511585714410441edd8eba4c,0,Nathan Marz,2013-07-09 11:47:30-07:00,['c4d4b81f72abdeea9f83d2f5e9f1239370b330e6'],0,1,1,305724,1,,,,822
f21bbfbcb2c22b93ce533efe2d7211e38f651a5d,0,Nathan Marz,2013-07-09 13:45:42-07:00,"['369c7fea3f40c960511585714410441edd8eba4c', '97f5fae27d4f67b89a282609d00444cc9993305d']",3,11,14,305738,3,,,,822
9d381800b50d44a8471a551b704293409ce9f8e2,0,Nathan Marz,2013-07-09 13:46:30-07:00,['f21bbfbcb2c22b93ce533efe2d7211e38f651a5d'],0,2,2,305740,2,,,,822
cb45c17043f7797752df18e4637d97b9d2e467dc,0,Nathan Marz,2013-07-09 13:51:23-07:00,"['9d381800b50d44a8471a551b704293409ce9f8e2', 'b259294e1eba6deb650affd56725c57034eefe1b']",1,1,2,305742,1,,,,822
a231edd659b8bc351182f7aeb05703b937fb9d64,0,Nathan Marz,2013-07-09 15:41:27-07:00,"['9d381800b50d44a8471a551b704293409ce9f8e2', 'e09cd94fa55098d4718b02630997a118f30c1215']",3,4,7,305749,2,,,,822
6100478bf16d6d331f227b004c9bf1ec634f3c8a,0,Nathan Marz,2013-07-09 15:48:03-07:00,['a231edd659b8bc351182f7aeb05703b937fb9d64'],0,1,1,305750,1,,,,822
a29958cd219e3fb0c07c5f5ef5982174a661a57b,0,Nathan Marz,2013-07-09 15:48:12-07:00,"['6100478bf16d6d331f227b004c9bf1ec634f3c8a', 'cb45c17043f7797752df18e4637d97b9d2e467dc']",1,1,2,305752,1,,,,822
f9cf61d75e49305e41e06736f1dd75f4c7c2abfa,1,Derek Dagit,2013-07-10 06:31:48-05:00,['19bb2ea13a08808d1dcf023baa2c619d7efd5b01'],160,213,373,306125,5,0,0,1,823
6e5c35a8a4eecc72fe8bc9a76fa6da9edca9e3a6,1,Derek Dagit,2013-07-10 08:11:28-05:00,"['f9cf61d75e49305e41e06736f1dd75f4c7c2abfa', 'a29958cd219e3fb0c07c5f5ef5982174a661a57b']",112,274,386,306511,15,,,,823
1b28ab42d5003b4d27484eac15dd15ff036fc19e,0,Nathan Marz,2013-07-10 23:24:19-07:00,['6e5c35a8a4eecc72fe8bc9a76fa6da9edca9e3a6'],0,1,1,306512,1,,,,823
d80eded266087bd438bea47db58135a06327d76e,0,P. Taylor Goetz,2013-07-11 11:21:40-04:00,['1b28ab42d5003b4d27484eac15dd15ff036fc19e'],7,19,26,306538,1,0,0,1,823
59cdf96958a7237900959b024cf5713ce012ff88,0,Nathan Marz,2013-07-11 12:43:18-07:00,"['1b28ab42d5003b4d27484eac15dd15ff036fc19e', 'd80eded266087bd438bea47db58135a06327d76e']",7,19,26,306564,1,,,,823
46c3ba7160ab5f83fcf28484b98153c578c53687,0,Nathan Marz,2013-07-11 12:44:06-07:00,['59cdf96958a7237900959b024cf5713ce012ff88'],0,1,1,306565,1,,,,823
171b320d83e096f706aefe714e6b39d035b74a32,0,Nathan Marz,2013-07-17 13:51:52-07:00,['46c3ba7160ab5f83fcf28484b98153c578c53687'],1,1,2,306567,1,,,,823
77a39ff3c013585f91fddb6dfeb0ab474157dbbf,0,Nathan Marz,2013-07-17 13:52:18-07:00,['171b320d83e096f706aefe714e6b39d035b74a32'],1,1,2,306569,1,,,,823
ab3157829228ccb937521a2180dd5f0a05190616,0,Nathan Marz,2013-07-17 13:55:52-07:00,['77a39ff3c013585f91fddb6dfeb0ab474157dbbf'],1,1,2,306571,1,,,,823
05fb4697f20b725da6542585bfc6b5be66f10706,0,Nathan Marz,2013-07-17 13:55:59-07:00,['ab3157829228ccb937521a2180dd5f0a05190616'],1,1,2,306573,1,,,,823
ef0221979786e12c7210b2eb55f3c32c259454e8,0,ankitoshniwal,2013-07-17 14:34:44-07:00,['aac85e221722d61ba9a2aa2395ca6a5504028a95'],0,1,1,306574,1,,,,823
89968250e16635fe37e5f45c7484a07c88d83233,1,Derek Dagit,2013-07-18 17:15:28-05:00,['05fb4697f20b725da6542585bfc6b5be66f10706'],17,18,35,306609,3,,,,823
470e7cdc51fd1034190c57abcb11bd567bd79902,0,Nathan Marz,2013-07-18 15:33:29-07:00,"['05fb4697f20b725da6542585bfc6b5be66f10706', '89968250e16635fe37e5f45c7484a07c88d83233']",17,18,35,306644,3,,,,823
af497811f5cb977f6e705c61958678830abcef6d,0,Philip (flip) Kromer,2013-07-20 22:27:30-05:00,['470e7cdc51fd1034190c57abcb11bd567bd79902'],1,7,8,306652,2,,,,823
ef94d01d1bc2a3bbaa6e876b86b8c21e340014b4,1,Philip (flip) Kromer,2013-07-20 22:31:08-05:00,['470e7cdc51fd1034190c57abcb11bd567bd79902'],6,86,92,306744,3,0.111111111,1,0.944444444,824
0e46397defd8e3287b549e6ad7bf085afe1c441b,0,David Lao,2013-07-25 12:12:53-07:00,['9ee5587ad452f4aaa346d6f88a8c206201aa59db'],7,15,22,306766,1,,,,824
be86eea598e715a2153fc877fe5088ba064a078c,0,Nathan Marz,2013-07-25 12:14:47-07:00,"['470e7cdc51fd1034190c57abcb11bd567bd79902', 'cf4a4d0b125bf5a5371f747c2992d8725b5c3140']",1,2,3,306769,1,,,,824
56e1f14320e07c787f36c4da59f0be1dbab5bfba,0,Nathan Marz,2013-07-25 12:16:28-07:00,['be86eea598e715a2153fc877fe5088ba064a078c'],0,2,2,306771,2,,,,824
9ae92648f8398fdd4580974a50e0078bc803490d,0,Philip (flip) Kromer,2013-07-29 01:04:16-05:00,['56e1f14320e07c787f36c4da59f0be1dbab5bfba'],5,34,39,306810,2,1,1,1,824
634055d4898f160e0605db945e2589d7337c1a39,0,Nathan Marz,2013-07-30 18:50:51-07:00,"['56e1f14320e07c787f36c4da59f0be1dbab5bfba', '9ae92648f8398fdd4580974a50e0078bc803490d']",5,34,39,306849,2,,,,824
386b8244f301d84a9f03b6f13da32795c9efa5c0,0,Nathan Marz,2013-07-30 18:52:35-07:00,['634055d4898f160e0605db945e2589d7337c1a39'],0,1,1,306850,1,,,,824
e61d910c5a20ebbb7cc32342a9ffa2debc11a6dd,0,Nathan Marz,2013-07-30 18:53:46-07:00,"['386b8244f301d84a9f03b6f13da32795c9efa5c0', 'ef94d01d1bc2a3bbaa6e876b86b8c21e340014b4']",6,86,92,306942,3,,,,824
a0763eef1f95050c919398a51801ee7e4378d15f,0,Nathan Marz,2013-07-30 18:56:24-07:00,"['e61d910c5a20ebbb7cc32342a9ffa2debc11a6dd', 'af497811f5cb977f6e705c61958678830abcef6d']",1,7,8,306950,2,,,,824
83f183becb4f6bd45822beac48d9b6425be7391b,0,wurstmeister,2013-07-31 22:06:00+01:00,['ddee8961af3d8618610320ee5793547879c91cfa'],11,14,25,306975,2,,,,824
20a1167dcded98fb53bdfceb79165c6e2d296e7f,0,wurstmeister,2013-07-31 22:08:40+01:00,['83f183becb4f6bd45822beac48d9b6425be7391b'],1,0,1,306976,1,,,,824
90a82604f8a40fb33e05f5b4d2003198d4263555,0,wurstmeister,2013-07-31 22:10:22+01:00,['20a1167dcded98fb53bdfceb79165c6e2d296e7f'],12,4,16,306992,1,,,,824
28789106f0b3e6f3b5ef5767df2d6a0ca6ff02cb,0,wurstmeister,2013-07-31 22:34:05+01:00,['90a82604f8a40fb33e05f5b4d2003198d4263555'],1,1,2,306994,1,,,,824
7f10c1ee8fc707dc0dc577c2063a794207db26dd,0,Philip (flip) Kromer,2013-07-31 18:05:35-05:00,['a0763eef1f95050c919398a51801ee7e4378d15f'],4,64,68,307062,5,1,1,1,826
47d5c8d710bd08ce6f9dd4889c73f3137a7ce223,0,Nathan Marz,2013-08-01 02:32:35-07:00,['a0763eef1f95050c919398a51801ee7e4378d15f'],0,1,1,307063,1,,,,826
1a27f8b81f7d9a6e1b18eec2ee45e93cf546a30d,0,Jake Donham,2013-08-06 10:59:14-07:00,['56e1f14320e07c787f36c4da59f0be1dbab5bfba'],2,2,4,307067,1,,,,826
2c6cbcac3cbed97c9b643871f043fa1a5c1ac4f1,0,Nathan Marz,2013-08-06 14:55:54-07:00,"['47d5c8d710bd08ce6f9dd4889c73f3137a7ce223', '1a27f8b81f7d9a6e1b18eec2ee45e93cf546a30d']",2,2,4,307071,1,,,,826
1137c9074d223293caa81455210e097c4a02f55f,0,Nathan Marz,2013-08-06 14:56:42-07:00,['2c6cbcac3cbed97c9b643871f043fa1a5c1ac4f1'],0,1,1,307072,1,,,,826
8b69df9afa99ea558866a6164aa12fd5bcfe4e35,0,Nathan Marz,2013-08-06 14:57:18-07:00,['1137c9074d223293caa81455210e097c4a02f55f'],0,1,1,307073,1,,,,826
08f426070eab980672b2189517e2599f33ea38b3,0,ankitoshniwal,2013-08-09 14:01:30-07:00,['ef0221979786e12c7210b2eb55f3c32c259454e8'],0,1,1,307074,1,,,,826
758616c624fba00c1133ae197989d3f785495039,0,ankitoshniwal,2013-08-09 14:03:13-07:00,['08f426070eab980672b2189517e2599f33ea38b3'],1,1,2,307076,1,,,,826
0997784c0eeea67e4e0fda1b365dce571e121e69,0,ankitoshniwal,2013-08-09 14:04:29-07:00,['758616c624fba00c1133ae197989d3f785495039'],0,3,3,307079,1,1,1,1,826
02b61b69855f9b0475d7d3473ed29730b1c26355,0,ankitoshniwal,2013-08-09 14:05:33-07:00,['0997784c0eeea67e4e0fda1b365dce571e121e69'],1,1,2,307081,1,,,,826
c3b513f8fe25164f1fac13c3bca59d04ee1b88f4,0,ankitoshniwal,2013-08-09 14:20:40-07:00,['02b61b69855f9b0475d7d3473ed29730b1c26355'],2,1,3,307084,1,,,,826
98ce905c419bc1104888a96806db6ee34ac9f9fe,0,Nathan Marz,2013-08-09 15:03:25-07:00,"['8b69df9afa99ea558866a6164aa12fd5bcfe4e35', 'c3b513f8fe25164f1fac13c3bca59d04ee1b88f4']",1,6,7,307091,3,,,,826
81b5aa63c0bc17fedcf91813dd8628615d247012,0,Nathan Marz,2013-08-09 15:04:56-07:00,['98ce905c419bc1104888a96806db6ee34ac9f9fe'],0,2,2,307093,2,,,,826
80244bf796ac6fedcbdc74c9e2ca6b7bd58a461d,0,Nathan Marz,2013-08-15 22:31:58-07:00,['81b5aa63c0bc17fedcf91813dd8628615d247012'],1,1,2,307095,1,,,,826
3d058660c94d97b15e9700b615a82051b599be34,0,wurstmeister,2013-08-17 10:07:48+01:00,['28789106f0b3e6f3b5ef5767df2d6a0ca6ff02cb'],0,191,191,307286,1,,,,827
d3eda036ed839d344415dbaab471fef4472a8d9b,1,wurstmeister,2013-08-17 12:37:43+01:00,['3d058660c94d97b15e9700b615a82051b599be34'],1,1,2,307288,1,,,,827
572a57702dfbe8918b74247a71f5922ebbde7901,1,wurstmeister,2013-08-18 08:38:58+01:00,['d3eda036ed839d344415dbaab471fef4472a8d9b'],118,145,263,307551,13,1,1,1,828
d0d7acb26aee4b1f691ea3c8bdf4cc9e220f693f,0,wurstmeister,2013-08-21 22:11:30+01:00,['572a57702dfbe8918b74247a71f5922ebbde7901'],5,4,9,307560,2,,,,828
049905bb60de3984fe36dc1079649090e3be5dfa,0,Derek Dagit,2013-08-21 17:13:18-05:00,['80244bf796ac6fedcbdc74c9e2ca6b7bd58a461d'],3,18,21,307581,2,,,,828
a909a3cf19dc6cabc756c6bde62cace12c18c9fa,0,Nathan Marz,2013-08-21 16:38:56-07:00,"['80244bf796ac6fedcbdc74c9e2ca6b7bd58a461d', '049905bb60de3984fe36dc1079649090e3be5dfa']",3,18,21,307602,2,,,,828
46cc0fcfcff077ede12cb14168db8fd11df8b227,0,Jake Donham,2013-08-26 14:01:08-07:00,['a909a3cf19dc6cabc756c6bde62cace12c18c9fa'],3,23,26,307628,1,0.916666667,1,1,828
85895c84ed28eb75ec6e5f7997cda74ce1bed61f,1,Jake Donham,2013-08-26 14:07:01-07:00,['a909a3cf19dc6cabc756c6bde62cace12c18c9fa'],2,400,402,308030,2,,,,829
cdbdf8dfc0719de5b6771a17bf4f3849cae3fe5f,0,Jake Donham,2013-08-26 14:08:36-07:00,['85895c84ed28eb75ec6e5f7997cda74ce1bed61f'],397,0,397,308427,1,,,,829
556b2a79213a42106d5dd5e33445f4c292948e63,0,Nathan Marz,2013-08-26 20:37:07-07:00,"['a909a3cf19dc6cabc756c6bde62cace12c18c9fa', 'cdbdf8dfc0719de5b6771a17bf4f3849cae3fe5f']",2,3,5,308432,1,,,,829
206b42ba11f80621a3c88552fb72a4b4dbbc2bba,0,Nathan Marz,2013-08-26 20:38:05-07:00,"['556b2a79213a42106d5dd5e33445f4c292948e63', '46cc0fcfcff077ede12cb14168db8fd11df8b227']",3,23,26,308458,1,,,,829
e7b4c09b6859e6b866d8b45b948c7d69b1cc0ceb,0,Michael G. Noll,2013-08-27 21:12:51+02:00,['e57bf89ab11c2ba6fae479133d78cc7471129495'],1,1,2,308460,1,,,,829
e3450917b100ee46ad5ff334e815fbb015686ccb,0,Michael G. Noll,2013-08-27 21:18:19+02:00,['e7b4c09b6859e6b866d8b45b948c7d69b1cc0ceb'],1,1,2,308462,1,,,,829
8c14994e86d517b145f8d5ef4c12012c4e04b4bc,0,Robert (Bobby) Evans,2013-08-28 09:32:08-05:00,['206b42ba11f80621a3c88552fb72a4b4dbbc2bba'],0,3,3,308465,1,,,,829
21805e309d2dc29e5691e6d88e27add9736e73e0,0,Derek Dagit,2013-08-28 17:46:51-05:00,['206b42ba11f80621a3c88552fb72a4b4dbbc2bba'],2,2,4,308469,2,,,,829
0b7acda1df88301c77f212673789a55d3c445ad2,0,Michael G. Noll,2013-08-29 11:19:13+02:00,['e3450917b100ee46ad5ff334e815fbb015686ccb'],1,3,4,308473,1,,,,829
f26f5974437c32510bde0fdf5dcdc053b42be1f6,0,Michael G. Noll,2013-08-29 11:23:08+02:00,['0b7acda1df88301c77f212673789a55d3c445ad2'],0,8,8,308481,1,,,,829
ab44424d85054e6873d94d2094c2dacfdbbac9b6,0,Michael G. Noll,2013-08-29 11:23:54+02:00,['f26f5974437c32510bde0fdf5dcdc053b42be1f6'],4,8,12,308493,1,,,,829
84b2eba70a0c9c6d5a790c0686d0e835bbad8641,0,Michael G. Noll,2013-08-29 11:25:57+02:00,['ab44424d85054e6873d94d2094c2dacfdbbac9b6'],19,16,35,308528,1,,,,829
84cb0355e6827f967784d02ce85f1ba373932d4c,0,Michael G. Noll,2013-08-29 11:28:25+02:00,['84b2eba70a0c9c6d5a790c0686d0e835bbad8641'],5,6,11,308539,1,,,,829
a9cb8cbfbe751ddda233c67aea26bd7c52dee062,0,Michael G. Noll,2013-08-29 11:37:40+02:00,['84cb0355e6827f967784d02ce85f1ba373932d4c'],11,25,36,308575,1,,,,829
cfaf58a4512cc80dde84f7c15e783ebbe5e584f2,0,Michael G. Noll,2013-08-29 11:38:47+02:00,['a9cb8cbfbe751ddda233c67aea26bd7c52dee062'],1,1,2,308577,1,,,,829
5a92564e0f47cc411117c892e51866b5547f1266,0,Michael G. Noll,2013-08-29 11:41:27+02:00,['cfaf58a4512cc80dde84f7c15e783ebbe5e584f2'],1,22,23,308600,1,,,,829
f64b52acaa9b758acd1c400b142e5c229585d9b5,0,Michael G. Noll,2013-08-29 11:43:52+02:00,['5a92564e0f47cc411117c892e51866b5547f1266'],1,6,7,308607,1,,,,829
b9c57eb9ac20cbb44af0c4fd64c8de3f219bf3c3,0,Michael G. Noll,2013-08-29 11:57:25+02:00,['f64b52acaa9b758acd1c400b142e5c229585d9b5'],0,14,14,308621,1,,,,829
2ace708d42984057f1f29ac3a300ac296b4b7edb,0,Michael G. Noll,2013-08-29 12:19:32+02:00,['b9c57eb9ac20cbb44af0c4fd64c8de3f219bf3c3'],2,2,4,308625,1,,,,829
8e1e3cc1ced2e785c2ce47fd8708dcf2c5a2e8ec,0,Michael G. Noll,2013-08-29 12:20:40+02:00,['2ace708d42984057f1f29ac3a300ac296b4b7edb'],1,1,2,308627,1,,,,829
4c714d03035fd6075392bd0df7577c68d993a366,0,Michael G. Noll,2013-08-29 12:36:48+02:00,['8e1e3cc1ced2e785c2ce47fd8708dcf2c5a2e8ec'],3,53,56,308683,3,0.068965517,1,1,829
3b2db7cfa11d9daf6e326202f3909d9d104f95dd,0,Michael G. Noll,2013-08-29 12:37:36+02:00,['4c714d03035fd6075392bd0df7577c68d993a366'],1,5,6,308689,1,,,,829
a51c8247e3f358788efc8fb3ed7104b7b7cb21c4,1,Michael G. Noll,2013-08-29 12:39:14+02:00,['3b2db7cfa11d9daf6e326202f3909d9d104f95dd'],2673,2574,5247,313936,35,1,0,0,829
6d56eae9f0707462bdb3502b19debaceb4e7f266,0,Michael G. Noll,2013-08-29 12:45:19+02:00,['a51c8247e3f358788efc8fb3ed7104b7b7cb21c4'],2,43,45,313981,2,1,1,1,829
eca746003408107dcfff4846f6bde55e33ffacc8,0,Michael G. Noll,2013-08-29 12:45:50+02:00,['6d56eae9f0707462bdb3502b19debaceb4e7f266'],0,4,4,313985,1,1,1,1,829
fa424aefbed93f5dbddc9ab38b2c5ddc85c592a0,0,Michael G. Noll,2013-08-29 12:52:03+02:00,['eca746003408107dcfff4846f6bde55e33ffacc8'],0,1,1,313986,1,,,,829
d596aaf2c14064a39865c177aea9bbeca20d2493,0,Michael G. Noll,2013-08-29 12:55:09+02:00,['fa424aefbed93f5dbddc9ab38b2c5ddc85c592a0'],0,1,1,313987,1,1,1,1,829
d5ec8f40206cc58dd0c5ecf4355a18f637abde22,0,Michael G. Noll,2013-08-29 12:56:29+02:00,['d596aaf2c14064a39865c177aea9bbeca20d2493'],1,1,2,313989,1,,,,829
8b4012082975fd7b31505ebafbcb9404c55369ae,0,Michael G. Noll,2013-08-29 12:57:10+02:00,['d5ec8f40206cc58dd0c5ecf4355a18f637abde22'],1,1,2,313991,1,,,,829
d85d83d63115c196e10517773d8f138066ca65ed,0,Jason Jackson,2013-08-29 12:11:43-07:00,['206b42ba11f80621a3c88552fb72a4b4dbbc2bba'],0,4,4,313995,4,,,,829
6f7ed1ea950f50a76dae125fab472f4da4621705,0,Nathan Marz,2013-08-29 12:14:47-07:00,"['206b42ba11f80621a3c88552fb72a4b4dbbc2bba', 'd85d83d63115c196e10517773d8f138066ca65ed']",0,4,4,313999,4,,,,829
b8f40558dc050c0da005e745f138d912c7b4d781,0,Robert (Bobby) Evans,2013-08-29 16:41:32-05:00,['8c14994e86d517b145f8d5ef4c12012c4e04b4bc'],5,4,9,314008,2,,,,829
9d0c4e694367bab194560341aaf18850c008f50e,0,Robert (Bobby) Evans,2013-09-03 12:28:25-05:00,['6f7ed1ea950f50a76dae125fab472f4da4621705'],11,20,31,314039,1,,,,829
70e982570bb4359d57f8357ba900941d63281909,0,ankitoshniwal,2013-09-03 11:35:35-07:00,['c3b513f8fe25164f1fac13c3bca59d04ee1b88f4'],1,2,3,314042,1,,,,829
e0acf0a4fad8f2567204062ee99cee3e153ab700,0,ankitoshniwal,2013-09-03 14:52:36-07:00,['70e982570bb4359d57f8357ba900941d63281909'],1,2,3,314045,1,,,,829
98eb38b62bc27317a455d45d988ebddb4b91ff75,0,ankitoshniwal,2013-09-03 14:53:50-07:00,['e0acf0a4fad8f2567204062ee99cee3e153ab700'],1,2,3,314048,1,,,,829
02402617e611bc25363a0adf4178ac040214302e,0,ankitoshniwal,2013-09-03 22:04:55-07:00,['98eb38b62bc27317a455d45d988ebddb4b91ff75'],1,1,2,314050,1,,,,829
043500c8832e1cbfb575d8d4a40cbd85b4511bf3,0,Nathan Marz,2013-09-04 01:02:24-07:00,"['6f7ed1ea950f50a76dae125fab472f4da4621705', '02402617e611bc25363a0adf4178ac040214302e']",1,4,5,314055,1,,,,829
94f664eae05b757ffedfbf9e284be50ae9d9a415,0,Robert (Bobby) Evans,2013-09-05 14:30:57-05:00,"['9d0c4e694367bab194560341aaf18850c008f50e', '043500c8832e1cbfb575d8d4a40cbd85b4511bf3']",1,4,5,314060,1,,,,829
cffa51de11c4293c7becbc7332de79e4990d3384,0,Robert (Bobby) Evans,2013-09-05 14:50:06-05:00,['94f664eae05b757ffedfbf9e284be50ae9d9a415'],6,13,19,314079,2,,,,829
97a454c5f096b21234ab7c594816dcf5776a71d5,0,Nathan Marz,2013-09-18 17:33:44-07:00,"['043500c8832e1cbfb575d8d4a40cbd85b4511bf3', 'cffa51de11c4293c7becbc7332de79e4990d3384']",11,27,38,314117,2,,,,829
fc5fbb8b352cf91050cdde4a9f9e77e673ab7f48,0,Nathan Marz,2013-09-18 17:34:55-07:00,"['97a454c5f096b21234ab7c594816dcf5776a71d5', 'b8f40558dc050c0da005e745f138d912c7b4d781']",2,4,6,314123,1,,,,829
030c11ea1072bfaf170f0d2d6ade0900d3d7f263,0,Nathan Marz,2013-09-18 17:37:57-07:00,"['fc5fbb8b352cf91050cdde4a9f9e77e673ab7f48', '7f10c1ee8fc707dc0dc577c2063a794207db26dd']",4,64,68,314191,5,,,,829
da8e6662eb4c8ba135b373551c56e04e3ea8e6b6,0,Nathan Marz,2013-09-18 18:32:56-07:00,"['030c11ea1072bfaf170f0d2d6ade0900d3d7f263', '21805e309d2dc29e5691e6d88e27add9736e73e0']",2,2,4,314195,2,,,,829
449e4e4560f84e078a7d79f0b3159e22508ac228,0,P. Taylor Goetz,2013-09-23 22:15:20-04:00,['da8e6662eb4c8ba135b373551c56e04e3ea8e6b6'],1,25,26,314221,2,,,,830
d8dc1bd44dcf77ffce71674e77a25538a3f73132,0,P. Taylor Goetz,2013-09-23 23:50:29-04:00,['449e4e4560f84e078a7d79f0b3159e22508ac228'],1,4,5,314226,1,,,,830
8b16230057045e8352f02e08a3584753e1b5b76c,0,roadkill001,2013-09-24 16:29:10-06:00,['d8dc1bd44dcf77ffce71674e77a25538a3f73132'],1,1,2,314228,1,,,,830
0671cb8bb01b6181b786bcef8e767d326b5bd136,0,roadkill001,2013-09-24 16:38:51-06:00,['8b16230057045e8352f02e08a3584753e1b5b76c'],2,2,4,314232,1,,,,830
96a433a289b584ac66be8183ffa86da741a1a012,0,roadkill001,2013-09-26 14:05:29-06:00,['0671cb8bb01b6181b786bcef8e767d326b5bd136'],2,2,4,314236,1,,,,830
ab08cb246050cd940c3f3f4623fb2e8e2361aa41,0,P. Taylor Goetz,2013-09-27 07:32:56-07:00,"['d8dc1bd44dcf77ffce71674e77a25538a3f73132', '96a433a289b584ac66be8183ffa86da741a1a012']",1,1,2,314238,1,,,,830
32098d5b2694434ea43d430a4703fbe51bab268f,0,P. Taylor Goetz,2013-09-27 12:42:06-04:00,['ab08cb246050cd940c3f3f4623fb2e8e2361aa41'],2,5,7,314245,2,,,,830
6b7c62e006fa25c481234722a1148794d1ea0ef6,0,P. Taylor Goetz,2013-09-27 13:10:46-04:00,['32098d5b2694434ea43d430a4703fbe51bab268f'],1,1,2,314247,1,,,,830
0616f5960ab4563d771c9b861755a63cf4aa4180,0,Boris,2013-09-30 11:59:24+04:00,['6b7c62e006fa25c481234722a1148794d1ea0ef6'],1,1,2,314249,1,,,,830
504b552a2b718a55994977684c1e35e88c458884,0,P. Taylor Goetz,2013-09-30 15:41:34-07:00,"['6b7c62e006fa25c481234722a1148794d1ea0ef6', '0616f5960ab4563d771c9b861755a63cf4aa4180']",1,1,2,314251,1,,,,830
1a19f3ddaca0d2ab2c388d70d03d7ebd63590879,1,John Gilmore,2013-10-01 10:59:47+02:00,['504b552a2b718a55994977684c1e35e88c458884'],329,578,907,315158,15,0.898734177,1,1,838
d0203c274cbfc47b6b6a71a31f4bf1584dd6b7e8,1,Derek Dagit,2013-10-01 10:55:41-05:00,['504b552a2b718a55994977684c1e35e88c458884'],4,12,16,315174,1,,,,838
b66d028f90e9376c16c0be1736411300d4bad587,1,Robert (Bobby) Evans,2013-10-01 14:40:17-05:00,['504b552a2b718a55994977684c1e35e88c458884'],2,32,34,315208,4,0,1,0.5,838
96f234254e5a9b7576c21f1f219503df8ef7c727,0,Nathan Marz,2013-10-06 17:33:30-07:00,"['504b552a2b718a55994977684c1e35e88c458884', 'd0203c274cbfc47b6b6a71a31f4bf1584dd6b7e8']",4,12,16,315224,1,,,,838
1e3d2660c751a054731bf95158ed57beb365222f,0,P. Taylor Goetz,2013-10-06 18:30:09-07:00,"['96f234254e5a9b7576c21f1f219503df8ef7c727', 'b66d028f90e9376c16c0be1736411300d4bad587']",2,32,34,315258,4,,,,838
a7918f8ef91b82b5b8fd91c91b36378a6c99caad,0,John Gilmore,2013-10-07 09:33:53+02:00,['1a19f3ddaca0d2ab2c388d70d03d7ebd63590879'],16,23,39,315297,6,,,,838
3701bfcbe3ed90e1ddf73605a0e5cd0bf4f0dbd4,0,John Gilmore,2013-10-07 11:47:48+02:00,['a7918f8ef91b82b5b8fd91c91b36378a6c99caad'],3,45,48,315345,7,,,,838
3219a4f05f938f4ce5bdbb9f006e49cbec5ee89f,0,John Gilmore,2013-10-08 13:52:00+02:00,['3701bfcbe3ed90e1ddf73605a0e5cd0bf4f0dbd4'],381,489,870,316215,13,0.45,0.7,0.75,840
ee0678c7f8bed531a8514166c7254a2190f3c4a9,1,John Gilmore,2013-10-08 13:53:32+02:00,['3701bfcbe3ed90e1ddf73605a0e5cd0bf4f0dbd4'],381,489,870,317085,13,0.45,0.7,0.75,842
06aad3f99d82bcc29c4a827e892d48aaf25e2fd6,0,John Gilmore,2013-10-08 13:53:59+02:00,"['ee0678c7f8bed531a8514166c7254a2190f3c4a9', '3219a4f05f938f4ce5bdbb9f006e49cbec5ee89f']",0,0,0,317085,0,,,,842
18c0ce778bb252e1f8b266d3d3b0a568d283257f,0,John Gilmore,2013-10-09 11:38:49+02:00,"['06aad3f99d82bcc29c4a827e892d48aaf25e2fd6', '1e3d2660c751a054731bf95158ed57beb365222f']",6,44,50,317135,5,,,,842
52948f56511a57cd273431b794819ddc9a343bee,0,John Gilmore,2013-10-09 11:51:20+02:00,['18c0ce778bb252e1f8b266d3d3b0a568d283257f'],1,1,2,317137,1,,,,842
63afb94cd0d8aa769898ba80ed2b020a6379b52f,0,John Gilmore,2013-10-09 15:29:21+02:00,['52948f56511a57cd273431b794819ddc9a343bee'],2,24,26,317163,4,0.333333333,0.444444444,1,842
483ce454a3b2cd31b5d1c34e9365346459b358a8,1,James Xu,2013-10-09 22:08:28+08:00,['1e3d2660c751a054731bf95158ed57beb365222f'],3,39,42,317205,2,,,,843
32b371857ddec5669f65fa779f6a0b098c1cb0a1,0,John Gilmore,2013-10-09 16:40:05+02:00,['63afb94cd0d8aa769898ba80ed2b020a6379b52f'],1,7,8,317213,1,0,0,1,843
5699373be3842310171aa9b51059d94c03dca82a,1,John Gilmore,2013-10-09 17:00:10+02:00,['32b371857ddec5669f65fa779f6a0b098c1cb0a1'],2,2,4,317217,1,,,,843
16ba0c7fbba5b49ed4054f7aba7fc7e15e144c77,0,John Gilmore,2013-10-10 14:28:08+02:00,['5699373be3842310171aa9b51059d94c03dca82a'],2,2,4,317221,2,,,,843
dfbd045966a9a909aaa0e7e31eac59639a86c3c9,0,John Gilmore,2013-10-10 14:58:51+02:00,['16ba0c7fbba5b49ed4054f7aba7fc7e15e144c77'],61,61,122,317343,1,,,,843
30c5d668da3e3bcea931d7e635043689c5c45984,0,Homer Strong,2013-10-10 11:55:37-07:00,['1e3d2660c751a054731bf95158ed57beb365222f'],2,15,17,317360,1,,,,843
b0a4730524bfba8792c9cfab2b7aeac37fd9ffd0,0,Homer Strong,2013-10-10 12:48:13-07:00,['30c5d668da3e3bcea931d7e635043689c5c45984'],5,4,9,317369,1,,,,843
edbb17cb76d3e3790a4c9ca52332fa5638c37bd9,0,Derek Dagit,2013-10-10 16:07:37-05:00,['1e3d2660c751a054731bf95158ed57beb365222f'],9,11,20,317389,1,,,,843
34e6ea79cce5f91b8347ffdadda02da8f7a9e05c,0,Paul Codding,2013-10-14 14:14:24-05:00,['7fc8e9342fa080f9c5a9055825c0542b6e4f00dc'],2,9,11,317400,1,,,,843
66a293976400b5f012e6cf7da233c7153626354e,0,Derek Dagit,2013-10-15 20:41:16-05:00,['1e3d2660c751a054731bf95158ed57beb365222f'],1,1,2,317402,1,,,,843
cab621358bbdc7fe5725ef99767a9a75bb897450,1,Derek Dagit,2013-10-16 13:54:35-05:00,['66a293976400b5f012e6cf7da233c7153626354e'],3,3,6,317408,1,,,,843
242108dbd5fb098421dd73d306e2701b3b7d2dfd,0,Homer Strong,2013-10-16 14:05:19-07:00,['b0a4730524bfba8792c9cfab2b7aeac37fd9ffd0'],0,7,7,317415,2,,,,843
cbb13638165c36f0996eff2deda0bc03b7d48252,0,Homer Strong,2013-10-16 14:07:09-07:00,['242108dbd5fb098421dd73d306e2701b3b7d2dfd'],13,25,38,317453,1,,,,843
7fa44bf1f47579a9dccee0914e5decd1c1beed95,0,Homer Strong,2013-10-17 09:39:08-07:00,['cbb13638165c36f0996eff2deda0bc03b7d48252'],4,2,6,317459,1,,,,843
e57ba47c1c41830680ead2b7168c29085a3dac72,0,Homer Strong,2013-10-17 09:39:20-07:00,['7fa44bf1f47579a9dccee0914e5decd1c1beed95'],2,2,4,317463,1,,,,843
213102b36f89002e1f84615b3c1162aff707073f,0,Brenden Matthews,2013-10-18 15:39:43-07:00,['1e3d2660c751a054731bf95158ed57beb365222f'],1,4,5,317468,1,1,1,1,843
3985de7e9465c3a1dca75d0a17a49c2e075ec83f,0,P. Taylor Goetz,2013-10-22 19:33:22-07:00,"['1e3d2660c751a054731bf95158ed57beb365222f', '213102b36f89002e1f84615b3c1162aff707073f']",1,4,5,317473,1,,,,843
a0bc262fb09b8ed90cc260f7295c4c77077e96e5,0,P. Taylor Goetz,2013-10-24 20:28:09-07:00,"['3985de7e9465c3a1dca75d0a17a49c2e075ec83f', 'edbb17cb76d3e3790a4c9ca52332fa5638c37bd9']",9,11,20,317493,1,,,,843
c3db9162ab26ae001beed0b9d1910a5e94e22056,0,P. Taylor Goetz,2013-10-24 20:34:58-07:00,"['a0bc262fb09b8ed90cc260f7295c4c77077e96e5', '483ce454a3b2cd31b5d1c34e9365346459b358a8']",3,39,42,317535,2,,,,843
6efadbe0b6ab4808acfbae140bc20ff5af50adae,0,P. Taylor Goetz,2013-11-04 00:01:42-05:00,['c3db9162ab26ae001beed0b9d1910a5e94e22056'],1,4,5,317540,1,,,,843
45aebfe78b1643bb950d48b08c33e0fafef09b17,1,Kang Xiao,2013-11-05 14:24:37+08:00,['6efadbe0b6ab4808acfbae140bc20ff5af50adae'],0,11,11,317551,2,0,0,0,843
5b071c0bdf016b7f4d0e62114f7d9362521e4926,0,Kang Xiao,2013-11-05 17:29:41+08:00,['45aebfe78b1643bb950d48b08c33e0fafef09b17'],1,1,2,317553,1,,,,843
8a94795ac157e49ccc2b44b25a54636148d6f22c,0,P. Taylor Goetz,2013-11-05 23:41:03-05:00,['6efadbe0b6ab4808acfbae140bc20ff5af50adae'],1,26,27,317580,1,,,,843
8467022cf1b7138876c66fa743b3ad16da5e7a94,0,P. Taylor Goetz,2013-11-06 13:02:39-05:00,['8a94795ac157e49ccc2b44b25a54636148d6f22c'],1,1,2,317582,1,,,,843
e8f7e31f121b27955724a2c6fbb9594701905b87,0,P. Taylor Goetz,2013-11-06 16:07:58-05:00,['8467022cf1b7138876c66fa743b3ad16da5e7a94'],2,2,4,317586,1,,,,843
84360dd32c77b050e28bf4c8f3483ce393027c5e,0,John Gilmore,2013-11-07 14:46:37+02:00,"['dfbd045966a9a909aaa0e7e31eac59639a86c3c9', 'e8f7e31f121b27955724a2c6fbb9594701905b87']",15,84,99,317685,5,,,,843
9a60d7a3c78d7673ca674898c1e314cfa8a2cd79,0,P. Taylor Goetz,2013-11-08 11:53:32-08:00,"['e8f7e31f121b27955724a2c6fbb9594701905b87', 'e57ba47c1c41830680ead2b7168c29085a3dac72']",10,39,49,317734,3,,,,843
54ccd71a54e4c4f96c65dc0c03a573b878f82fc3,0,Nathan Marz,2013-11-10 12:16:22-08:00,"['9a60d7a3c78d7673ca674898c1e314cfa8a2cd79', '5b071c0bdf016b7f4d0e62114f7d9362521e4926']",0,11,11,317745,2,,,,843
0024a0c603d0b18fdc85075c29dbab999bb4e62b,0,P. Taylor Goetz,2013-11-11 21:10:43-08:00,"['54ccd71a54e4c4f96c65dc0c03a573b878f82fc3', 'cab621358bbdc7fe5725ef99767a9a75bb897450']",3,3,6,317751,1,,,,843
66a397368a98834095b47db2b706420901c52ba3,0,P. Taylor Goetz,2013-11-14 10:39:09-05:00,['0024a0c603d0b18fdc85075c29dbab999bb4e62b'],1,12,13,317764,1,,,,843
80304231ff550f74b99a88684b23031208bec919,0,John Gilmore,2013-11-18 16:30:44+02:00,"['84360dd32c77b050e28bf4c8f3483ce393027c5e', '66a397368a98834095b47db2b706420901c52ba3']",14,65,79,317843,6,,,,843
5ba093862560aa3ca2cff002e2e38e1e37753670,0,John Gilmore,2013-11-18 16:31:44+02:00,['80304231ff550f74b99a88684b23031208bec919'],0,2,2,317845,1,0,0,1,843
2696d84a20f651187aa83b7a6d8070ce46f69dde,0,P. Taylor Goetz,2013-11-21 13:51:24-05:00,['7fc8e9342fa080f9c5a9055825c0542b6e4f00dc'],1,1,2,317847,1,,,,843
f4b39b4e81734da438ff8ad37e0dc537ce22fa61,0,P. Taylor Goetz,2013-11-21 14:18:47-05:00,['2696d84a20f651187aa83b7a6d8070ce46f69dde'],1,1,2,317849,1,,,,843
2520fc24e2d4d13ab33a1cce1cb72e4466516461,0,P. Taylor Goetz,2013-11-21 20:12:05-08:00,"['f4b39b4e81734da438ff8ad37e0dc537ce22fa61', '34e6ea79cce5f91b8347ffdadda02da8f7a9e05c']",2,9,11,317860,1,,,,843
c7258403edf047d72042ec68c2e9a7de3924f0e5,0,P. Taylor Goetz,2013-11-21 20:13:50-08:00,"['2520fc24e2d4d13ab33a1cce1cb72e4466516461', 'ab4749798fb445798976330c7c9991aec47796fd']",0,410,410,318270,3,,,,843
66628504e9e706386a5d53cee3b0afc9d90cc757,0,P. Taylor Goetz,2013-11-26 15:07:32-05:00,['66a397368a98834095b47db2b706420901c52ba3'],5,20,25,318295,2,,,,843
6dfc2377648962410d9bbcbcf13fa3c56ed8b09d,0,P. Taylor Goetz,2013-11-27 12:33:33-05:00,['66a397368a98834095b47db2b706420901c52ba3'],2,6,8,318303,1,,,,843
df73338e7bb4871277ec68779f7bb632d471a229,0,P. Taylor Goetz,2013-11-27 12:39:09-05:00,['6dfc2377648962410d9bbcbcf13fa3c56ed8b09d'],1,1,2,318305,1,,,,843
eb45818f453fbbcef610df757edc21ddbc67f5de,0,P. Taylor Goetz,2013-11-27 13:05:49-05:00,['df73338e7bb4871277ec68779f7bb632d471a229'],0,1,1,318306,1,,,,843
8cde5508b5e4828982aa4f1ff2e70ba6fd10f4b9,1,John Gilmore,2013-11-29 14:47:31+02:00,['5ba093862560aa3ca2cff002e2e38e1e37753670'],28,27,55,318361,3,0,0,1,843
4e195891b25becc9995dce0f4ba64b061c540459,0,P. Taylor Goetz,2013-12-02 10:40:41-08:00,"['66a397368a98834095b47db2b706420901c52ba3', '66628504e9e706386a5d53cee3b0afc9d90cc757']",5,20,25,318386,2,,,,843
c638db0e88e3c56f808c8a76a88f94d7bf1988c4,0,Brenden Matthews,2013-12-04 14:30:52-08:00,['4e195891b25becc9995dce0f4ba64b061c540459'],31,29,60,318446,2,0,0,0,843
9aed0dede671688355d0a866b23167aadab47397,0,P. Taylor Goetz,2013-12-04 15:08:06-08:00,"['4e195891b25becc9995dce0f4ba64b061c540459', 'c638db0e88e3c56f808c8a76a88f94d7bf1988c4']",31,29,60,318506,2,,,,843
5890ee4eb2bdbbc2d29c14e973bc9b5a4acdcefe,0,P. Taylor Goetz,2013-12-04 15:15:51-08:00,"['9aed0dede671688355d0a866b23167aadab47397', 'eb45818f453fbbcef610df757edc21ddbc67f5de']",3,8,11,318517,3,,,,843
6466d0446beec82f2c8b03390eb350251a740abe,0,P. Taylor Goetz,2013-12-04 15:19:30-08:00,['5890ee4eb2bdbbc2d29c14e973bc9b5a4acdcefe'],1,1,2,318519,1,,,,843
061ee2e7ca6ed89dbf0522ba3b2ccee6558c4105,0,P. Taylor Goetz,2013-12-04 15:36:07-08:00,['6466d0446beec82f2c8b03390eb350251a740abe'],1,3,4,318523,1,,,,843
b201033f5a0cf9a680f2b71e395756ce552704a0,0,P. Taylor Goetz,2013-12-05 10:05:57-08:00,['061ee2e7ca6ed89dbf0522ba3b2ccee6558c4105'],2,3,5,318528,3,,,,843
1bcc169f5096e03a4ae117efc65c0f9bcfa2fa22,0,P. Taylor Goetz,2013-12-05 10:33:36-08:00,['b201033f5a0cf9a680f2b71e395756ce552704a0'],1,4,5,318533,2,,,,843
8012cd7a4a8665469ccd4e89c4b7013f52007021,0,P. Taylor Goetz,2013-12-07 00:24:28-05:00,['8b4012082975fd7b31505ebafbcb9404c55369ae'],29,27,56,318589,3,,,,843
7a688ae33a31fd982219259981cd2596e9925bfd,0,Michael G. Noll,2013-12-07 01:20:26-08:00,"['8b4012082975fd7b31505ebafbcb9404c55369ae', '8012cd7a4a8665469ccd4e89c4b7013f52007021']",29,27,56,318645,3,,,,843
4c403845b55c38b2573455efbe519c45a0f0c045,0,Michael G. Noll,2013-12-07 10:25:52+01:00,['7a688ae33a31fd982219259981cd2596e9925bfd'],157,160,317,318962,1,,,,843
1bcefbbfc960353ec6713adb2f3342e4a92a31bb,0,Michael G. Noll,2013-12-07 10:36:58+01:00,['4c403845b55c38b2573455efbe519c45a0f0c045'],0,23,23,318985,1,,,,843
b77057c5d0aa9e47469c86da7c01f4aba3bd5f43,0,wurstmeister,2013-12-07 10:53:18+00:00,['d0d7acb26aee4b1f691ea3c8bdf4cc9e220f693f'],17,2,19,319004,2,,,,843
74f01ec64eef63181e8d6b92a08295a279e76158,0,Michael G. Noll,2013-12-07 11:54:59+01:00,['1bcefbbfc960353ec6713adb2f3342e4a92a31bb'],0,5,5,319009,1,,,,843
651ccfe07b542fd0b2c8c9a518fb6c1cd173bd9d,0,Michael G. Noll,2013-12-07 12:54:08+01:00,['74f01ec64eef63181e8d6b92a08295a279e76158'],6,243,249,319258,7,1,1,0.628205128,844
8364b51c0a053e1b06229144d074f1af80e21927,0,Michael G. Noll,2013-12-07 12:56:05+01:00,['651ccfe07b542fd0b2c8c9a518fb6c1cd173bd9d'],7,8,15,319273,1,,,,844
731a8e517eee130aed7648033e7726ee0025c91e,0,P. Taylor Goetz,2013-12-09 16:45:13-05:00,['1bcc169f5096e03a4ae117efc65c0f9bcfa2fa22'],421,9725,10146,329419,558,,,,844
a0987a5c3ef8c55e6b8c62d2d0eeb58bec512624,0,P. Taylor Goetz,2013-12-09 19:22:47-05:00,['731a8e517eee130aed7648033e7726ee0025c91e'],262,327,589,330008,3,,,,845
009f924b012be061593d10442d93515dcf991a55,0,P. Taylor Goetz,2013-12-09 21:34:50-05:00,['a0987a5c3ef8c55e6b8c62d2d0eeb58bec512624'],1,12,13,330021,6,,,,845
b63ed13946eae3acaab4a51bba705124701207eb,1,P. Taylor Goetz,2013-12-10 11:23:11-05:00,['1bcc169f5096e03a4ae117efc65c0f9bcfa2fa22'],382,36,418,330439,23,,,,845
f2d955bfeb768155b43a52eef10b145dc3a2bb8e,0,P. Taylor Goetz,2013-12-10 17:34:31-05:00,['1bcc169f5096e03a4ae117efc65c0f9bcfa2fa22'],3,3,6,330445,1,,,,845
1babce4f9573cc46fe22fa73b4c7bd590bfe0c4f,0,P. Taylor Goetz,2013-12-10 17:39:25-05:00,['1bcc169f5096e03a4ae117efc65c0f9bcfa2fa22'],1,1,2,330447,1,,,,845
70d432335b82cf799ff8181c12aba155704d656c,0,P. Taylor Goetz,2013-12-10 17:43:12-05:00,"['f2d955bfeb768155b43a52eef10b145dc3a2bb8e', '1babce4f9573cc46fe22fa73b4c7bd590bfe0c4f']",1,1,2,330449,1,,,,845
080cec2dcf98ec4b258d0f1c8447ff7a03a4ce96,0,P. Taylor Goetz,2013-12-11 10:46:27-05:00,['009f924b012be061593d10442d93515dcf991a55'],66,31,97,330546,2,,,,845
639201cf95f3e6b0998714aeda86532391ffebc8,0,P. Taylor Goetz,2013-12-11 10:46:55-05:00,['080cec2dcf98ec4b258d0f1c8447ff7a03a4ce96'],6,17,23,330569,1,,,,845
51f8a549d5363e024f8b6391d67e809424acfbf2,0,P. Taylor Goetz,2013-12-12 17:21:04-08:00,"['1babce4f9573cc46fe22fa73b4c7bd590bfe0c4f', '70d432335b82cf799ff8181c12aba155704d656c']",3,3,6,330575,1,,,,845
7e40f9f619b87537792f06040e354e677662459e,0,P. Taylor Goetz,2013-12-12 17:21:37-08:00,"['51f8a549d5363e024f8b6391d67e809424acfbf2', '639201cf95f3e6b0998714aeda86532391ffebc8']",691,10047,10738,341313,562,,,,845
17de23ca0e0a9ed6e5da94e19e3050ac2a379e2c,1,P. Taylor Goetz,2013-12-13 12:12:29-05:00,['1babce4f9573cc46fe22fa73b4c7bd590bfe0c4f'],3,9,12,341325,3,,,,845
c95b12624ba362d8c76e4e20b1db07aaa231a7bc,0,Lorcan Coyle,2013-12-13 22:24:29+00:00,['7e40f9f619b87537792f06040e354e677662459e'],2,1,3,341328,1,,,,845
697849dcb4ebecd086a42e9fa415d9ed51d9c722,0,P. Taylor Goetz,2013-12-15 15:25:34-05:00,"['7e40f9f619b87537792f06040e354e677662459e', '0e46397defd8e3287b549e6ad7bf085afe1c441b']",38,356,394,341722,7,,,,845
e75451140e534b5489bf7a534d303e2930f7db4a,0,P. Taylor Goetz,2013-12-16 12:42:27-05:00,['7e40f9f619b87537792f06040e354e677662459e'],3,9,12,341734,1,,,,845
962d520777368709cf30d6214719bfa1b81bbd4c,0,P. Taylor Goetz,2013-12-16 13:21:19-05:00,"['b63ed13946eae3acaab4a51bba705124701207eb', '7e40f9f619b87537792f06040e354e677662459e']",695,9974,10669,352403,558,,,,845
a0c2ec732fa772fe7d9649626e6edc37ee1514db,1,P. Taylor Goetz,2013-12-16 16:33:09-05:00,['697849dcb4ebecd086a42e9fa415d9ed51d9c722'],8,35,43,352446,2,,,,845
b7db9fbdd3f3e1894f9c828b16791f77ef69cf83,1,P. Taylor Goetz,2013-12-16 16:38:20-05:00,['a0c2ec732fa772fe7d9649626e6edc37ee1514db'],0,1,1,352447,1,,,,845
4a3a3624f43098aa04826d7bfab8474999ca7952,0,P. Taylor Goetz,2013-12-16 21:19:10-05:00,['7e40f9f619b87537792f06040e354e677662459e'],5,62,67,352514,1,,,,845
5c989cfc3f4c6c1107a040e806012f7fb3f0a625,1,P. Taylor Goetz,2013-12-17 17:13:29-05:00,['b7db9fbdd3f3e1894f9c828b16791f77ef69cf83'],8,2,10,352524,1,,,,845
7127528b44189e37dbf7fa94fa306754d3d74211,1,P. Taylor Goetz,2013-12-18 11:21:58-05:00,['5c989cfc3f4c6c1107a040e806012f7fb3f0a625'],1,1,2,352526,1,,,,845
de291341e3f4258b5900224a540a7af44d268e6e,0,P. Taylor Goetz,2013-12-19 01:20:45-05:00,"['4a3a3624f43098aa04826d7bfab8474999ca7952', '17de23ca0e0a9ed6e5da94e19e3050ac2a379e2c']",3,9,12,352538,3,,,,845
ebd1181ab893e2b1b8b094879869e07e223b95f5,0,P. Taylor Goetz,2013-12-19 01:24:42-05:00,"['de291341e3f4258b5900224a540a7af44d268e6e', '7127528b44189e37dbf7fa94fa306754d3d74211']",38,378,416,352954,7,,,,845
d9268e468532b28a06e7bdcb0c35eca6371e68f8,0,P. Taylor Goetz,2013-12-19 01:28:35-05:00,"['ebd1181ab893e2b1b8b094879869e07e223b95f5', 'c95b12624ba362d8c76e4e20b1db07aaa231a7bc']",2,1,3,352957,1,,,,845
a2b1d5d941f0cb924a4f1464b3a6b18cacf5c44f,0,P. Taylor Goetz,2013-12-19 11:35:54-05:00,['d9268e468532b28a06e7bdcb0c35eca6371e68f8'],15,16,31,352988,5,,,,845
6331d6a937ebfb82bf990b6ce2e17d0479a321b1,0,P. Taylor Goetz,2013-12-19 12:03:30-05:00,['a2b1d5d941f0cb924a4f1464b3a6b18cacf5c44f'],6,7,13,353001,1,,,,845
6bd7848463da7759a41daf6c9eb8491790718617,1,Derek Dagit,2013-12-20 20:42:25+00:00,['6331d6a937ebfb82bf990b6ce2e17d0479a321b1'],6,21,27,353028,4,,,,845
d3414f576181934b28c59ce282c4a32337c8f7c1,0,P. Taylor Goetz,2013-12-20 16:42:42-05:00,"['6331d6a937ebfb82bf990b6ce2e17d0479a321b1', 'e75451140e534b5489bf7a534d303e2930f7db4a']",3,9,12,353040,1,,,,845
d79f6b808cd294b15ec06e41f60b9dbbf1d3986b,0,P. Taylor Goetz,2013-12-20 21:23:47-05:00,"['d3414f576181934b28c59ce282c4a32337c8f7c1', '962d520777368709cf30d6214719bfa1b81bbd4c']",459,36,495,353535,23,,,,845
dc4d33beccb517f096fc59a4df9bdbfc75386012,0,P. Taylor Goetz,2013-12-20 21:49:32-05:00,['d79f6b808cd294b15ec06e41f60b9dbbf1d3986b'],157,0,157,353692,4,,,,845
ed8be1410fc599840f050545c982fd696410760f,0,P. Taylor Goetz,2013-12-20 21:54:15-05:00,['dc4d33beccb517f096fc59a4df9bdbfc75386012'],198,0,198,353890,5,,,,845
42eb3bbf5fd85dec642bf8c0767c5ed6b9d79171,0,P. Taylor Goetz,2013-12-20 23:12:00-05:00,['ed8be1410fc599840f050545c982fd696410760f'],1,0,1,353891,1,,,,845
13d676d01fd3e5032bfce3e1599932cd9ac28fb3,0,P. Taylor Goetz,2013-12-20 23:20:04-05:00,['42eb3bbf5fd85dec642bf8c0767c5ed6b9d79171'],0,1,1,353892,1,,,,845
8b3e85dfbbdee7f60bba3e7b1dfa31551cb4fc6a,0,Derek Dagit,2013-12-21 18:52:46+00:00,['d79f6b808cd294b15ec06e41f60b9dbbf1d3986b'],1923,3102,5025,358917,8,0.5703125,0.69140625,0.875,847
f6b6b00d18b1b98ca93b5cade61904905c988409,0,Derek Dagit,2013-12-21 19:03:45+00:00,['8b3e85dfbbdee7f60bba3e7b1dfa31551cb4fc6a'],1,0,1,358918,1,,,,847
e7f7feac92b4ae7045b5d1c0c8cc75bb842cc20b,0,wurstmeister,2013-12-22 12:50:12+00:00,['b77057c5d0aa9e47469c86da7c01f4aba3bd5f43'],1,1,2,358920,1,,,,847
5da87f3382f75fae4dfe13f8af06896615f80291,0,wurstmeister,2013-12-22 13:06:52+00:00,['e7f7feac92b4ae7045b5d1c0c8cc75bb842cc20b'],1,1,2,358922,1,,,,847
a4c30ebbab9bc662877c8d063e6c89f5f78d7ad9,0,wurstmeister,2013-12-22 13:20:21+00:00,['5da87f3382f75fae4dfe13f8af06896615f80291'],2,9,11,358933,1,,,,847
a440ecc05f7bae6b3cea6b6c9d0450a577b42d58,0,wurstmeister,2013-12-22 13:57:29+00:00,['a4c30ebbab9bc662877c8d063e6c89f5f78d7ad9'],2,11,13,358946,1,,,,847
d35a6eee117ec401e5fea992200167ead9f764d7,0,wurstmeister,2013-12-22 14:18:19+00:00,['a440ecc05f7bae6b3cea6b6c9d0450a577b42d58'],2,8,10,358956,2,,,,847
e8f54d63094806a2a1364adb5e209ab2ca10f0f0,0,wurstmeister,2013-12-22 15:58:01+00:00,['d35a6eee117ec401e5fea992200167ead9f764d7'],798,821,1619,360575,28,0.454545455,0.454545455,0.590909091,847
da18bd858035c495edb41cc018fe706a3f7ef831,0,wurstmeister,2013-12-22 16:10:14+00:00,['e8f54d63094806a2a1364adb5e209ab2ca10f0f0'],2,0,2,360577,1,,,,847
735b87f78459ec686017c538ef50d95a7db9584b,1,wurstmeister,2013-12-25 16:28:16+00:00,['da18bd858035c495edb41cc018fe706a3f7ef831'],45,46,91,360668,7,,,,847
941b14dcfa2f21f0b189b88c50122ef0c5756a3a,1,P. Taylor Goetz,2013-12-30 22:07:16-05:00,['13d676d01fd3e5032bfce3e1599932cd9ac28fb3'],5,1413,1418,362086,12,,,,856
ab5e5096a1acb7f2df46acfcec32caa4fa3e9af2,1,P. Taylor Goetz,2013-12-30 22:08:02-05:00,['941b14dcfa2f21f0b189b88c50122ef0c5756a3a'],96,374,470,362556,105,,,,856
d977020338ad0f034f22f31320a8d3f61e103179,0,P. Taylor Goetz,2013-12-31 12:28:35-05:00,['ab5e5096a1acb7f2df46acfcec32caa4fa3e9af2'],0,2,2,362558,1,,,,856
f6a123f906e91550c352573ae3fb731116e45b9b,0,P. Taylor Goetz,2013-12-31 12:29:15-05:00,['d977020338ad0f034f22f31320a8d3f61e103179'],0,13,13,362571,1,,,,856
03c4e298e968a533a492af6efbbf2ca52b5daef0,1,P. Taylor Goetz,2013-12-31 15:29:02-05:00,['f6a123f906e91550c352573ae3fb731116e45b9b'],115,70,185,362756,2,,,,856
b5de86ed7f966018454fba667a42010f0f73f490,1,wurstmeister,2014-01-05 12:17:55+00:00,['735b87f78459ec686017c538ef50d95a7db9584b'],6,8,14,362770,2,0,0,0,856
4b6e9bcf90f52b3eef4817ff30cb8792b4c3b8e0,0,wurstmeister,2014-01-05 12:25:22+00:00,['b5de86ed7f966018454fba667a42010f0f73f490'],0,2,2,362772,1,,,,857
6b29f8f0bf56b473bf06e2fc7a0f822e5c87d9bc,0,wurstmeister,2014-01-07 08:00:36+00:00,['4b6e9bcf90f52b3eef4817ff30cb8792b4c3b8e0'],0,4,4,362776,1,,,,857
3188c45457477b2f860db76bbf47ecc7d227f02b,0,P. Taylor Goetz,2014-01-07 12:22:18-08:00,['03c4e298e968a533a492af6efbbf2ca52b5daef0'],0,1,1,362777,1,,,,857
3a012c5f5d83810f4fe628f867346ce5a3c8c853,0,P. Taylor Goetz,2014-01-07 12:37:59-08:00,['3188c45457477b2f860db76bbf47ecc7d227f02b'],1,1,2,362779,1,,,,857
9134cd69c34c50c556131eb96098852dbd1505a1,0,P. Taylor Goetz,2014-01-07 13:16:46-08:00,"['f6b6b00d18b1b98ca93b5cade61904905c988409', '6bd7848463da7759a41daf6c9eb8491790718617']",6,21,27,362806,4,,,,857
5bd0facd3006a777c5000827eba58e8b739fb6a1,0,Derek Dagit,2014-01-10 04:52:41+00:00,['9134cd69c34c50c556131eb96098852dbd1505a1'],1,52,53,362859,3,0,0,1,857
394fbd0dcbbadd6177c0e03075e87c66b852e3ff,0,P. Taylor Goetz,2014-01-11 10:40:50-05:00,"['3a012c5f5d83810f4fe628f867346ce5a3c8c853', '5bd0facd3006a777c5000827eba58e8b739fb6a1']",1930,3174,5104,367963,15,,,,857
ea0f54e05a813e5aab01120618db2ddad7131380,0,P. Taylor Goetz,2014-01-11 11:11:34-05:00,['394fbd0dcbbadd6177c0e03075e87c66b852e3ff'],2,2,4,367967,2,,,,857
95c60dbbbc80165969bae6cbbd1926207720e59c,1,wurstmeister,2014-01-11 16:40:02+00:00,['6b29f8f0bf56b473bf06e2fc7a0f822e5c87d9bc'],58,234,292,368259,11,0.587628866,0.711340206,0.742268041,860
80005ba3916e2a05c82649dd67f11b0f813c41b6,0,wurstmeister,2014-01-12 18:24:37+00:00,['95c60dbbbc80165969bae6cbbd1926207720e59c'],2,42,44,368303,2,1,1,1,861
47387185b1c8b61b24c8c3be1675e4e4f2c670c6,0,Derek Dagit,2014-01-15 03:16:51+00:00,['ea0f54e05a813e5aab01120618db2ddad7131380'],18,24,42,368345,2,,,,861
193301f2d4d8188b5cee04f4cf982636ea6c6ba6,0,Derek Dagit,2014-01-15 03:16:52+00:00,['47387185b1c8b61b24c8c3be1675e4e4f2c670c6'],6,8,14,368359,1,,,,861
c7c7087c4be7fff719e846910af1b18c48d01a38,0,Derek Dagit,2014-01-15 03:16:52+00:00,['193301f2d4d8188b5cee04f4cf982636ea6c6ba6'],2,3,5,368364,1,,,,861
6d1ad6a6a3835294a564ab63b1d6399ee7843e18,0,Derek Dagit,2014-01-15 03:16:53+00:00,['c7c7087c4be7fff719e846910af1b18c48d01a38'],2,2,4,368368,2,,,,861
c970225dc43721e1a7827408df7542aed94e11cb,0,Derek Dagit,2014-01-15 03:16:53+00:00,['6d1ad6a6a3835294a564ab63b1d6399ee7843e18'],23,64,87,368455,4,1,1,1,861
2fb66fa3be27f3495fbbe78831565a1edce12af1,1,Derek Dagit,2014-01-15 03:16:54+00:00,['c970225dc43721e1a7827408df7542aed94e11cb'],1,75,76,368531,3,,,,861
375e7a46546f9bd25455e040d12b1a00a5985618,1,P. Taylor Goetz,2014-01-16 13:34:58-05:00,['ea0f54e05a813e5aab01120618db2ddad7131380'],3,11,14,368545,1,,,,861
5b764cd9138dd93e7382e3472b9d3d33d4b286a3,1,wurstmeister,2014-01-18 15:25:36+00:00,['80005ba3916e2a05c82649dd67f11b0f813c41b6'],10,15,25,368570,3,1,1,0,861
f789091534be95c103890be6539bbfc5faf69b37,1,wurstmeister,2014-01-18 15:56:19+00:00,['5b764cd9138dd93e7382e3472b9d3d33d4b286a3'],0,20,20,368590,1,1,1,1,861
dbcd93969ba76c4bfc1283695a3141129ff6eeae,0,P. Taylor Goetz,2014-01-20 17:10:53-05:00,['375e7a46546f9bd25455e040d12b1a00a5985618'],14,15,29,368619,3,,,,862
42297bffcbb0259c92a47aca7ba1e6f243cf41f3,0,P. Taylor Goetz,2014-01-21 14:36:52-05:00,['c7258403edf047d72042ec68c2e9a7de3924f0e5'],6,0,6,368625,1,,,,862
1c74af220989adea6390fff8695a50c1369d73ab,0,P. Taylor Goetz,2014-01-21 15:04:31-05:00,['42297bffcbb0259c92a47aca7ba1e6f243cf41f3'],8,13,21,368646,2,,,0,862
c7794295f9c9bbe3b488629c30998538369ec36e,0,P. Taylor Goetz,2014-01-21 15:23:30-05:00,['1c74af220989adea6390fff8695a50c1369d73ab'],3,13,16,368662,2,,,,862
0a6203acc6a2765049af6913b8deb070fb63a244,0,Edison Xu,2014-01-22 15:07:04+08:00,['f789091534be95c103890be6539bbfc5faf69b37'],0,26,26,368688,1,1,0.318181818,1,862
2e97e3705798e7e4af86d2025336e37fe91f8610,0,dmmata,2014-01-23 18:18:50+01:00,['dbcd93969ba76c4bfc1283695a3141129ff6eeae'],0,1,1,368689,1,,,,862
73136fe617462ccd6e9d03a4f409c28f99a6bf1d,0,P. Taylor Goetz,2014-01-24 14:37:11-05:00,['2e97e3705798e7e4af86d2025336e37fe91f8610'],15,105,120,368809,7,,,,863
a85c387a917f5d85993d21cb9d90456263032bfe,0,P. Taylor Goetz,2014-01-24 15:24:31-05:00,['73136fe617462ccd6e9d03a4f409c28f99a6bf1d'],0,13,13,368822,1,,,,863
e9372e4f952eb7672b30d07ad62b853a9e614ae7,0,P. Taylor Goetz,2014-01-24 15:30:12-05:00,['a85c387a917f5d85993d21cb9d90456263032bfe'],1,2,3,368825,1,,,,863
6599358e492416f759d98bda27a34a3496d6d03e,0,P. Taylor Goetz,2014-01-24 16:08:18-05:00,['e9372e4f952eb7672b30d07ad62b853a9e614ae7'],2,1,3,368828,1,,,,863
0a61db1d25915bfe0f3a53ab55bbb046c99ce9b6,0,P. Taylor Goetz,2014-01-24 16:52:39-05:00,['6599358e492416f759d98bda27a34a3496d6d03e'],0,1,1,368829,1,,,,863
f68dfb1181a85be7a71aecd44acf888f8473b928,0,P. Taylor Goetz,2014-01-25 14:33:33-05:00,['0a61db1d25915bfe0f3a53ab55bbb046c99ce9b6'],1,1,2,368831,1,,,,863
8d2f1eabc211eae0c7a56d1840d273a3b9bc0467,0,P. Taylor Goetz,2014-01-25 15:55:30-05:00,['0a61db1d25915bfe0f3a53ab55bbb046c99ce9b6'],16,237,253,369084,3,,,,864
7fe675d1bf604b9c2b37df5f8918ebda62a9d4b5,0,P. Taylor Goetz,2014-01-25 15:57:25-05:00,['8d2f1eabc211eae0c7a56d1840d273a3b9bc0467'],7,5,12,369096,2,,,,864
d84eb231d511223a8bb91b9b1f2ee3538fea149b,0,P. Taylor Goetz,2014-01-26 00:05:19-05:00,"['7fe675d1bf604b9c2b37df5f8918ebda62a9d4b5', 'f68dfb1181a85be7a71aecd44acf888f8473b928']",1,1,2,369098,1,,,,864
48f6840273e369000421675dfb90141c0e3ac270,0,wurstmeister,2014-01-26 13:17:20-08:00,"['f789091534be95c103890be6539bbfc5faf69b37', '0a6203acc6a2765049af6913b8deb070fb63a244']",0,26,26,369124,1,,,,864
aabcd5846010ff0bc5832520bf8f59e9879728cc,1,wurstmeister,2014-01-26 21:34:54+00:00,['48f6840273e369000421675dfb90141c0e3ac270'],22,21,43,369167,2,0,1,0,864
22ddd6e6d5c78e36610366e71ea879b283575e01,0,P. Taylor Goetz,2014-01-26 20:43:08-05:00,['d84eb231d511223a8bb91b9b1f2ee3538fea149b'],3108,2850,5958,375125,62,,,,864
18f5e6b216f1386a7e1c4e642944343193e9a022,0,P. Taylor Goetz,2014-01-27 07:22:26-08:00,[],0,207,207,375332,3,,,,867
54d15543df9121e8fe6682047cf69d6fd4b11198,1,P. Taylor Goetz,2014-01-27 10:26:47-05:00,[],0,693,693,376025,11,0.746575342,0.876712329,0.876712329,878
34311bceac43b026d8d4a91644de1d7d733b5013,0,P. Taylor Goetz,2014-01-27 10:28:37-05:00,"['54d15543df9121e8fe6682047cf69d6fd4b11198', '18f5e6b216f1386a7e1c4e642944343193e9a022']",0,207,207,376232,3,,,,878
736cd54a6041761eee3428bf6e8e498272b53aad,0,P. Taylor Goetz,2014-01-27 10:30:29-05:00,['34311bceac43b026d8d4a91644de1d7d733b5013'],0,3,3,376235,1,,,,878
8fb04abcd22d757fd7c07106bf99de45b19ef92f,0,P. Taylor Goetz,2014-01-27 10:47:23-05:00,['736cd54a6041761eee3428bf6e8e498272b53aad'],2,28,30,376265,1,,,,878
8c62c8f1aa9489c23d86be29172c65d0c0f1e98d,0,P. Taylor Goetz,2014-01-27 11:50:47-05:00,['8fb04abcd22d757fd7c07106bf99de45b19ef92f'],1,92,93,376358,1,,,,878
07733db07c2a2e549c6114ebc761e772dbbcdeae,0,P. Taylor Goetz,2014-01-27 11:53:39-05:00,['8c62c8f1aa9489c23d86be29172c65d0c0f1e98d'],12,14,26,376384,1,,,,878
42d43f095c285d48effdef82599478df9fa69f60,1,P. Taylor Goetz,2014-01-28 14:48:26-05:00,['07733db07c2a2e549c6114ebc761e772dbbcdeae'],17,306,323,376707,10,0.68907563,0.848739496,0.848739496,881
4ad401ad5bb466a4b6e22e3f1b956149e11d800d,0,P. Taylor Goetz,2014-01-28 14:50:10-05:00,['42d43f095c285d48effdef82599478df9fa69f60'],1,1,2,376709,1,,,,881
568bd56a43ad6565ea86dd0fda39d7dec80c9863,1,P. Taylor Goetz,2014-01-29 23:06:54-05:00,['22ddd6e6d5c78e36610366e71ea879b283575e01'],0,9,9,376718,1,,,,881
292ce2f2d5a2fc36b0b864dd307b8b714755a8d2,0,P. Taylor Goetz,2014-01-29 23:10:47-05:00,['568bd56a43ad6565ea86dd0fda39d7dec80c9863'],9,7,16,376734,2,,,,881
0e5a317ec2ff9d99702cb17a9b74f452bb1862af,0,P. Taylor Goetz,2014-01-29 23:11:12-05:00,['292ce2f2d5a2fc36b0b864dd307b8b714755a8d2'],3,3,6,376740,2,,,,881
4b85ef153e8534f22640c632b6bca78eb719676c,0,P. Taylor Goetz,2014-01-29 23:11:36-05:00,['0e5a317ec2ff9d99702cb17a9b74f452bb1862af'],6,8,14,376754,2,,,,881
ea4c800754bfa3823ef75eea37a9596b457b1146,0,P. Taylor Goetz,2014-01-29 23:15:20-05:00,['4b85ef153e8534f22640c632b6bca78eb719676c'],11,9,20,376774,4,,,,881
30cadb04894448a559daeb38d476e2cb15d14060,0,P. Taylor Goetz,2014-01-29 23:17:38-05:00,['ea4c800754bfa3823ef75eea37a9596b457b1146'],5,5,10,376784,4,,,,881
b6e2590a8417f5efcd94ea6b78c9008dd1edf729,0,P. Taylor Goetz,2014-01-29 23:19:52-05:00,['30cadb04894448a559daeb38d476e2cb15d14060'],6,8,14,376798,2,,,,881
53eba0c2d5d19c9715e429ebc9b97c78c2aee88b,0,P. Taylor Goetz,2014-01-29 23:23:22-05:00,['b6e2590a8417f5efcd94ea6b78c9008dd1edf729'],2,2,4,376802,2,,,,881
7e704a7fd6f5f5cdde39099ca7c8ae1f80f6ad95,0,P. Taylor Goetz,2014-01-29 23:26:42-05:00,['53eba0c2d5d19c9715e429ebc9b97c78c2aee88b'],11,9,20,376822,4,,,,881
9ba48058b209744343b0d465a786c3ba26c04b9a,0,P. Taylor Goetz,2014-01-29 23:28:01-05:00,['7e704a7fd6f5f5cdde39099ca7c8ae1f80f6ad95'],5,5,10,376832,4,,,,881
2cbf5b4d41b21e7575a613baf029aeb6b3f4ffbd,0,P. Taylor Goetz,2014-01-29 23:39:02-05:00,['9ba48058b209744343b0d465a786c3ba26c04b9a'],6,8,14,376846,2,,,,881
fcd4f019ad456f2f1c3d8129be7e6cc127350e73,0,P. Taylor Goetz,2014-01-29 23:40:46-05:00,['2cbf5b4d41b21e7575a613baf029aeb6b3f4ffbd'],2,2,4,376850,2,,,,881
27dd9d60f2c941fef2d9555afba2234bed3c5b99,0,P. Taylor Goetz,2014-01-29 23:42:43-05:00,['fcd4f019ad456f2f1c3d8129be7e6cc127350e73'],0,2,2,376852,2,,,,881
f42a16b5fc6e640feaf5b1b1cf106762e5143de5,0,P. Taylor Goetz,2014-01-29 23:54:53-05:00,['27dd9d60f2c941fef2d9555afba2234bed3c5b99'],11,9,20,376872,4,,,,881
263fade3d4e71ca24fbe84a77a09ae32366536a9,0,P. Taylor Goetz,2014-01-29 23:55:03-05:00,['f42a16b5fc6e640feaf5b1b1cf106762e5143de5'],5,5,10,376882,4,,,,881
5eaf09f44f499c0728ceaafa2c307175c1d391ef,0,P. Taylor Goetz,2014-01-31 16:33:24-05:00,['263fade3d4e71ca24fbe84a77a09ae32366536a9'],2,141,143,377025,4,1,1,0.555555556,883
bb85715dbafc6d12a680614facfb29ffef3c6a8e,0,P. Taylor Goetz,2014-01-31 16:44:39-05:00,['5eaf09f44f499c0728ceaafa2c307175c1d391ef'],7,7,14,377039,1,,,,883
f1c9332cbc8c18cc6ad671deb744f498042d50f8,0,P. Taylor Goetz,2014-02-01 15:33:57-05:00,['bb85715dbafc6d12a680614facfb29ffef3c6a8e'],7,7,14,377053,5,,,,883
e9357eca4881704c398acbe60dda228ad4c7beec,0,wurstmeister,2014-02-02 19:25:13+00:00,['aabcd5846010ff0bc5832520bf8f59e9879728cc'],2,27,29,377082,1,,,,883
1b13ca2281f4aafac92e471167ef0e7c3dccb030,0,supercargo,2014-02-02 16:31:11-05:00,['263fade3d4e71ca24fbe84a77a09ae32366536a9'],2,12,14,377096,1,1,1,1,883
9368ac447aeb473f926302137dbcdf914d06cd32,1,yerenkow,2014-02-03 11:05:52+02:00,['263fade3d4e71ca24fbe84a77a09ae32366536a9'],2,5,7,377103,1,,,,883
fbda8b7000a88b606400c9ed93f9ba68b7b931a8,0,P. Taylor Goetz,2014-02-03 15:00:42-05:00,['4ad401ad5bb466a4b6e22e3f1b956149e11d800d'],2,2,4,377107,1,,,,883
08bd4140c47b02d33d0f3741561f6a44c620a414,1,P. Taylor Goetz,2014-02-03 15:05:49-05:00,['fbda8b7000a88b606400c9ed93f9ba68b7b931a8'],77,101,178,377285,3,1,1,0.714285714,884
7444918651d6a2c7595b03951d11f22671eca3b2,1,P. Taylor Goetz,2014-02-03 15:08:11-05:00,['08bd4140c47b02d33d0f3741561f6a44c620a414'],0,738,738,378023,14,0.827225131,0.916230366,0.853403141,898
ebc630286037ddc7c6764cbcc3609ab9c3307b93,0,P. Taylor Goetz,2014-02-03 15:25:56-05:00,['7444918651d6a2c7595b03951d11f22671eca3b2'],3,29,32,378055,1,,,,898
c5ba15fee214bd9ca0dbe9a1661aec7855fb2db1,0,P. Taylor Goetz,2014-02-04 20:35:45-05:00,['ebc630286037ddc7c6764cbcc3609ab9c3307b93'],0,82,82,378137,1,,,,898
e7adf3f5706602ce481263478b73ba0160fdbd5f,0,P. Taylor Goetz,2014-02-05 01:15:04-05:00,['c5ba15fee214bd9ca0dbe9a1661aec7855fb2db1'],22,94,116,378253,5,0.272727273,0.272727273,1,900
8491178528e92e5e28fc11adaf2bfc9fde073684,0,P. Taylor Goetz,2014-02-05 22:38:34-05:00,['f1c9332cbc8c18cc6ad671deb744f498042d50f8'],32,4,36,378289,3,,,,900
0218472c163be69a7e772691851442a3d5b287e9,0,P. Taylor Goetz,2014-02-05 22:44:36-05:00,['8491178528e92e5e28fc11adaf2bfc9fde073684'],10,8,18,378307,5,,,,900
22b832708295fa2c15c4f3c70ac0d2bc6fded4bd,0,P. Taylor Goetz,2014-02-05 22:44:48-05:00,['0218472c163be69a7e772691851442a3d5b287e9'],6,6,12,378319,5,,,,900
7085e2b19925bc95e7fe921e3979bb16a8c55d1a,0,P. Taylor Goetz,2014-02-07 14:31:09-05:00,['e7adf3f5706602ce481263478b73ba0160fdbd5f'],5,16,21,378340,1,0,1,1,900
e7a0bb86a76a73eadd047f24c4b60e488a4b1886,0,P. Taylor Goetz,2014-02-07 16:05:23-05:00,['7085e2b19925bc95e7fe921e3979bb16a8c55d1a'],77,199,276,378616,2,1,1,0.851351351,900
b19b7869cc7363658dd084b5d08e390cac625542,0,P. Taylor Goetz,2014-02-07 16:08:56-05:00,['e7a0bb86a76a73eadd047f24c4b60e488a4b1886'],2,2,4,378620,1,,,,900
486ecc8cd5b5a1bab3eb626799621985e6d9ab57,0,Robert (Bobby) Evans,2014-02-07 22:23:39+00:00,['22b832708295fa2c15c4f3c70ac0d2bc6fded4bd'],2,9,11,378631,1,,,,900
a63c0d976aabbb4ff9692ab25aa70aa216a0b0d7,0,Robert (Bobby) Evans,2014-02-07 22:43:32+00:00,['22b832708295fa2c15c4f3c70ac0d2bc6fded4bd'],19,46,65,378696,3,1,0,1,900
c5e7c5b92b55e5f9854e411b663944f171384b4d,1,Robert (Bobby) Evans,2014-02-07 22:59:22+00:00,['22b832708295fa2c15c4f3c70ac0d2bc6fded4bd'],1,2,3,378699,1,,,,900
2a0cce2e54eedb4f6f813c4f88b53e852909e1d1,0,P. Taylor Goetz,2014-02-08 02:02:55-05:00,['b19b7869cc7363658dd084b5d08e390cac625542'],48,98,146,378845,5,0,0,0,900
32826f0c3b908e2852b836f46c303a82b62d73bd,0,P. Taylor Goetz,2014-02-08 02:09:06-05:00,['2a0cce2e54eedb4f6f813c4f88b53e852909e1d1'],6,7,13,378858,1,,,,900
37aa116d7aba38c7600b669589bc9458e328bb4a,0,wurstmeister,2014-02-08 08:32:25+00:00,['e9357eca4881704c398acbe60dda228ad4c7beec'],1,1,2,378860,1,,,,900
312408a5c2d22bc2a1578d940c92417e05f94412,0,wurstmeister,2014-02-08 08:47:12+00:00,['37aa116d7aba38c7600b669589bc9458e328bb4a'],1,1,2,378862,1,,,,900
789d615e6c0c2421e4da050a1dff92545b434a6e,0,P. Taylor Goetz,2014-02-09 21:04:23-05:00,['22b832708295fa2c15c4f3c70ac0d2bc6fded4bd'],5,5,10,378872,5,,,,900
dd5e9d7505dd64351c9c2f6665d81b879fbe7cd1,1,P. Taylor Goetz,2014-02-09 21:05:07-05:00,['789d615e6c0c2421e4da050a1dff92545b434a6e'],14,1,15,378887,1,,,,900
b0f33102c2bb206b5a7b3c929f7b5fcb50cb622c,1,P. Taylor Goetz,2014-02-09 21:20:20-05:00,['dd5e9d7505dd64351c9c2f6665d81b879fbe7cd1'],29,4,33,378920,2,,,,900
ffc7a81bfba60c735dd6801af4f5e8db3812658c,0,P. Taylor Goetz,2014-02-09 22:35:48-05:00,['b0f33102c2bb206b5a7b3c929f7b5fcb50cb622c'],7,7,14,378934,5,,,,900
9fe14b405da30638be348fd3fdbc639e6a7376e9,0,P. Taylor Goetz,2014-02-09 22:45:31-05:00,['ffc7a81bfba60c735dd6801af4f5e8db3812658c'],6,6,12,378946,5,,,,900
b214f7231d03ff3c964afd88616e11de16b91a18,0,P. Taylor Goetz,2014-02-10 10:46:15-05:00,['32826f0c3b908e2852b836f46c303a82b62d73bd'],4,62,66,379012,6,,,,900
a826fa33d18d41d6a3c9869c30c4e54f5a848e0a,1,P. Taylor Goetz,2014-02-10 10:46:45-05:00,['b214f7231d03ff3c964afd88616e11de16b91a18'],0,595,595,379607,5,0.40569395,0.932384342,0.918149466,905
b6b1f1d8fb5a56cf14c44ff46aa513e0fa4e99ab,0,Danijel Schiavuzzi,2014-02-11 15:28:59+01:00,['312408a5c2d22bc2a1578d940c92417e05f94412'],5,6,11,379618,3,,,,905
98a70814025bff0a65c01d17c1a2550f17b7b38f,1,P. Taylor Goetz,2014-02-11 16:10:17-05:00,['a826fa33d18d41d6a3c9869c30c4e54f5a848e0a'],37,42,79,379697,12,0,1,,905
bd3d7805be7d8c57d39626b61e1e50240fa98824,0,P. Taylor Goetz,2014-02-11 16:12:55-05:00,['98a70814025bff0a65c01d17c1a2550f17b7b38f'],1,1,2,379699,1,,,,905
891f2f8efe22cad232f10fa6f7a1e327623159dc,0,P. Taylor Goetz,2014-02-11 16:17:26-05:00,['bd3d7805be7d8c57d39626b61e1e50240fa98824'],8,8,16,379715,1,,,,905
ac7f0afa442c0dd64d9d09052f8406beedf3b617,1,P. Taylor Goetz,2014-02-14 02:30:34-05:00,[],0,1063,1063,380778,13,0.66779661,0.755932203,0.888135593,918
c90b67a56c70ab6e8967a0a63f3d0d58ce4c4a22,0,P. Taylor Goetz,2014-02-13 23:49:27-08:00,[],0,205,205,380983,3,,,,921
5d8b4d8a12b1ee6055954a640b6730a09fac292c,0,P. Taylor Goetz,2014-02-14 02:56:09-05:00,"['ac7f0afa442c0dd64d9d09052f8406beedf3b617', 'c90b67a56c70ab6e8967a0a63f3d0d58ce4c4a22']",0,203,203,381186,2,,,,921
fe1a9da07d7d075a9db768d5fa332f1d24bc3a37,0,P. Taylor Goetz,2014-02-15 14:12:36-05:00,['9fe14b405da30638be348fd3fdbc639e6a7376e9'],12,2,14,381200,2,,,,921
254ec135b9a67b1e7bc8e979356274aee2e7d715,0,P. Taylor Goetz,2014-02-15 14:24:51-05:00,['fe1a9da07d7d075a9db768d5fa332f1d24bc3a37'],1,10,11,381211,2,,,,921
db61558bb480dd6f39eaa3e6235d9f0c193f3a6a,0,anfeng,2014-02-15 11:55:42-08:00,['fe1a9da07d7d075a9db768d5fa332f1d24bc3a37'],7,1,8,381219,2,,,,921
021094131c13909bd9195cb3e3b9c9775ee2fcf5,0,supercargo,2014-02-16 08:23:46-05:00,['254ec135b9a67b1e7bc8e979356274aee2e7d715'],1,11,12,381231,3,0,1,1,921
0108765688e64fa7c039e9478b303c118882d972,0,Kang Xiao,2014-02-16 23:12:54+08:00,['254ec135b9a67b1e7bc8e979356274aee2e7d715'],0,8,8,381239,1,,,,921
47dba860094bbe381e0bd231a43e2501a98a855b,0,David Losada,2014-02-16 21:55:45+01:00,['254ec135b9a67b1e7bc8e979356274aee2e7d715'],0,11,11,381250,1,1,1,1,921
2a0757ace47466e4ce13f670e977128c546c0349,0,Danijel Schiavuzzi,2014-02-17 11:43:20+01:00,['b6b1f1d8fb5a56cf14c44ff46aa513e0fa4e99ab'],2,2,4,381254,1,,,,921
d2a0bcd99e806922fb6443d2764f8c3ceb52aca1,0,anfeng,2014-02-17 19:01:23-08:00,['db61558bb480dd6f39eaa3e6235d9f0c193f3a6a'],1,7,8,381262,2,,,,921
a64d9365b4c04cbaf7e865e7eb21b4b9ca1d8939,0,P. Taylor Goetz,2014-02-17 22:08:35-05:00,['c7794295f9c9bbe3b488629c30998538369ec36e'],282,515,797,382059,17,,,,924
6b058e4b2695a05d4cb1df716c1eaccbdb65a3e9,0,P. Taylor Goetz,2014-02-17 22:14:33-05:00,['a64d9365b4c04cbaf7e865e7eb21b4b9ca1d8939'],0,32,32,382091,2,,,,924
6b275d95fbdbc8374a215ecb2551f0fca3438d81,0,Kang Xiao,2014-02-18 23:23:50+08:00,['9fe14b405da30638be348fd3fdbc639e6a7376e9'],1,6,7,382098,1,,,,924
15c489018c0cc7a32cc8e5c157232da4d1e26f2d,1,Kang Xiao,2014-02-19 00:22:01+08:00,['254ec135b9a67b1e7bc8e979356274aee2e7d715'],1,15,16,382114,3,,,,924
0e46a534ba6ce861e3be60b37fcebf906c911337,0,P. Taylor Goetz,2014-02-19 17:31:34-05:00,['6b058e4b2695a05d4cb1df716c1eaccbdb65a3e9'],1,1,2,382116,1,,,,924
f6b3cb99d872daeadc80da31bb5d8ba4495c2e8c,0,P. Taylor Goetz,2014-02-19 17:31:36-05:00,['0e46a534ba6ce861e3be60b37fcebf906c911337'],1,1,2,382118,1,,,,924
71119ce131a1c618759231ed9d4aca0468ff4055,0,wurstmeister,2014-02-19 22:48:37+00:00,"['312408a5c2d22bc2a1578d940c92417e05f94412', '2a0757ace47466e4ce13f670e977128c546c0349']",3,4,7,382125,2,,,,924
f8afa99c3036918291c694163e81fd4f22e0460b,0,wurstmeister,2014-02-19 22:55:45+00:00,['71119ce131a1c618759231ed9d4aca0468ff4055'],2,2,4,382129,1,,,,924
7ed8879a1fdb27df6848bf2921f8cef89408f2ef,0,Kang Xiao,2014-02-20 12:49:45+08:00,['15c489018c0cc7a32cc8e5c157232da4d1e26f2d'],1,1,2,382131,1,,,,924
4de85c8e7f6f4244be9eb688c6a4576a9c88c2a1,1,wurstmeister,2014-02-23 12:48:56+00:00,['f8afa99c3036918291c694163e81fd4f22e0460b'],14,187,201,382332,9,1,1,1,928
bd0cc453a5d7389eb2a92bacef46c13b436a0316,1,wurstmeister,2014-02-23 16:10:38+00:00,['4de85c8e7f6f4244be9eb688c6a4576a9c88c2a1'],13,18,31,382363,1,1,1,1,928
c695c1b06cd1f44fbbe1181a41a6c4ffe2186e01,1,Danijel Schiavuzzi,2014-02-24 17:05:45+01:00,['bd0cc453a5d7389eb2a92bacef46c13b436a0316'],3,8,11,382374,1,0,0,1,928
80ab3625e9802fbd8bff16c706fc788cf7aed17c,0,P. Taylor Goetz,2014-02-26 11:30:15-05:00,['254ec135b9a67b1e7bc8e979356274aee2e7d715'],2,5,7,382381,2,1,1,1,928
f573001db106d6b8d6af2167bb2b88f38a3738e5,0,wurstmeister,2014-02-26 22:16:11+00:00,['bd0cc453a5d7389eb2a92bacef46c13b436a0316'],1,5,6,382387,2,,,,928
118cec43b19eec2ed1d66f6dd0aac7209edfde96,1,wurstmeister,2014-02-27 22:19:24+00:00,['f573001db106d6b8d6af2167bb2b88f38a3738e5'],1,249,250,382637,3,0.876923077,1,0.930769231,930
09ae97303d3faa0b4b837a3bbe18b996854d2733,0,wurstmeister,2014-02-27 22:26:35+00:00,"['118cec43b19eec2ed1d66f6dd0aac7209edfde96', 'c695c1b06cd1f44fbbe1181a41a6c4ffe2186e01']",3,8,11,382648,1,,,,930
6c82685c274c57576d45ab4d4b05ce03a3d2223b,0,Robert (Bobby) Evans,2014-02-28 17:15:37+00:00,['a63c0d976aabbb4ff9692ab25aa70aa216a0b0d7'],0,4,4,382652,2,,,,930
70174deaa758fc1e3f3a881445e8750ae7218b3d,0,supercargo,2014-02-28 12:35:44-05:00,['021094131c13909bd9195cb3e3b9c9775ee2fcf5'],10,3,13,382665,3,1,0,0,930
bb8562f4f19dd04cbc941a4c32ed4cdb392f17a0,0,supercargo,2014-02-28 12:37:06-05:00,['70174deaa758fc1e3f3a881445e8750ae7218b3d'],1,0,1,382666,1,,,,930
d9d637eab5f3761a4768fc960b2574d45962b466,0,Drew,2014-03-03 12:08:43-08:00,['254ec135b9a67b1e7bc8e979356274aee2e7d715'],4,4,8,382674,1,,,,930
d68cd231a8d365a4ec3b7f873cbbf36d59951630,0,Robert (Bobby) Evans,2014-03-04 23:10:43+00:00,['6c82685c274c57576d45ab4d4b05ce03a3d2223b'],12,12,24,382698,7,,,,930
d080e043d15d710d6729963bed9cb078b7dce78e,0,Li Jiahong,2014-03-05 12:36:22+08:00,"['dbcd93969ba76c4bfc1283695a3141129ff6eeae', '254ec135b9a67b1e7bc8e979356274aee2e7d715']",2961,3106,6067,388765,74,,,,930
7a21ae00d18967b9539d5febb9a04dabefb1c8de,0,JuDasheng,2014-03-05 14:22:02+08:00,['254ec135b9a67b1e7bc8e979356274aee2e7d715'],1,278,279,389044,8,0.37007874,0.37007874,0.921259843,934
286cae3815ae6888e463e75442f501d6e25f6dbb,0,P. Taylor Goetz,2014-03-05 14:42:12-05:00,['d9d637eab5f3761a4768fc960b2574d45962b466'],0,3,3,389047,1,,,,934
8ab7806bcf384d0c2a1db54a2f5cd6aa27850201,0,P. Taylor Goetz,2014-03-05 14:49:07-05:00,"['286cae3815ae6888e463e75442f501d6e25f6dbb', '7ed8879a1fdb27df6848bf2921f8cef89408f2ef']",1,15,16,389063,3,,,,934
3aa6d7b95ef3cacccfacc02f0f35d1074780e2f1,0,P. Taylor Goetz,2014-03-05 14:52:11-05:00,['8ab7806bcf384d0c2a1db54a2f5cd6aa27850201'],2,2,4,389067,1,,,,934
f1d7fca7ff1c68c184539e39502f579c9ef6dc39,1,P. Taylor Goetz,2014-03-05 15:57:05-05:00,"['3aa6d7b95ef3cacccfacc02f0f35d1074780e2f1', '8364b51c0a053e1b06229144d074f1af80e21927']",0,4593,4593,393660,48,,,,934
8a2760d71d050093086f4ed5de28857d62ea263e,0,P. Taylor Goetz,2014-03-05 16:48:01-05:00,['f1d7fca7ff1c68c184539e39502f579c9ef6dc39'],1,169,170,393830,2,,,,935
a99d9c11be005ade7c308bebdda71c7fb0111acc,0,P. Taylor Goetz,2014-03-05 17:10:35-05:00,['8a2760d71d050093086f4ed5de28857d62ea263e'],304,704,1008,394838,47,,,,935
651df24374b0b5de45e0a65155fba02af95cf020,1,P. Taylor Goetz,2014-03-05 17:21:11-05:00,['a99d9c11be005ade7c308bebdda71c7fb0111acc'],29,11,40,394878,1,,,,935
ecb39a70f157a5d08a0fb90d0d3319b1c9a71ceb,0,JuDasheng,2014-03-06 17:01:50+08:00,['7a21ae00d18967b9539d5febb9a04dabefb1c8de'],145,113,258,395136,7,0.696969697,0.696969697,0.181818182,935
5448955dba2ffee133b1bd8b4d144611fcdcc751,0,JuDasheng,2014-03-06 17:03:09+08:00,['ecb39a70f157a5d08a0fb90d0d3319b1c9a71ceb'],0,13,13,395149,1,1,1,1,936
98a27203169abf2d7a2bcad163448c488d8d0d40,0,JuDasheng,2014-03-06 17:04:57+08:00,['5448955dba2ffee133b1bd8b4d144611fcdcc751'],0,17,17,395166,1,,,,936
db709fe3eeabd98e5b44d3f5d84c1b5cfe74445a,0,JuDasheng,2014-03-06 17:13:55+08:00,['98a27203169abf2d7a2bcad163448c488d8d0d40'],5,0,5,395171,2,,,,936
e2a7f7c0e1a5a413840948342f4be86d9ba56516,0,dashengju,2014-03-07 09:48:58+08:00,['db709fe3eeabd98e5b44d3f5d84c1b5cfe74445a'],2,0,2,395173,1,,,,936
50408bfc1c193356a66f50f9ce9aeb7786031f4b,0,Kang Xiao,2014-03-08 01:12:22+08:00,['0108765688e64fa7c039e9478b303c118882d972'],1,1,2,395175,1,,,,936
017d73f20d78f61761150950e0e1df6da640499a,0,nathanmarz,2014-03-11 00:02:17+00:00,['3aa6d7b95ef3cacccfacc02f0f35d1074780e2f1'],10,1,11,395186,2,,,,936
0c754dc6d47c6b5b76bb06cace190b164350e53c,1,P. Taylor Goetz,2014-03-11 09:33:45-04:00,['891f2f8efe22cad232f10fa6f7a1e327623159dc'],10,12,22,395208,3,0,1,1,936
c86ef53bba585e1c993058d4ef7a15eff0e43526,0,P. Taylor Goetz,2014-03-11 09:44:49-04:00,['5d8b4d8a12b1ee6055954a640b6730a09fac292c'],2,6,8,395216,2,0,0,1,936
a2d48e1a62c6249c8737fc80ff70587f79e191ef,0,P. Taylor Goetz,2014-03-11 10:30:52-04:00,['c86ef53bba585e1c993058d4ef7a15eff0e43526'],11,19,30,395246,3,0,1,0.166666667,936
b1ccc153d924a971d2f1303023b969f8c975b238,1,Kang Xiao,2014-03-12 00:17:58+08:00,['017d73f20d78f61761150950e0e1df6da640499a'],0,3,3,395249,1,1,1,1,936
2787660e462f1136db8b2317b7f1c0619a59a98c,0,anfeng,2014-03-11 11:11:26-07:00,"['d2a0bcd99e806922fb6443d2764f8c3ceb52aca1', '017d73f20d78f61761150950e0e1df6da640499a']",7,24,31,395280,6,,,,936
b25eeedffb5e9553e8d052a5da47c212fcf53a89,0,P. Taylor Goetz,2014-03-11 14:18:10-04:00,['3aa6d7b95ef3cacccfacc02f0f35d1074780e2f1'],1,1,2,395282,1,,,,936
7a75c959eea518211af766ee0f1146dbc051ae0e,1,P. Taylor Goetz,2014-03-11 17:11:17-04:00,['0c754dc6d47c6b5b76bb06cace190b164350e53c'],13,17,30,395312,3,1,1,1,936
b7b3d8a358389eff376fc50bd791fbb3d1fc413a,0,P. Taylor Goetz,2014-03-12 12:23:44-04:00,"['3aa6d7b95ef3cacccfacc02f0f35d1074780e2f1', '6c82685c274c57576d45ab4d4b05ce03a3d2223b']",19,50,69,395381,4,,,,936
da8489a5cc87c99d132755c08f0486136e908e49,0,P. Taylor Goetz,2014-03-12 12:26:51-04:00,"['b7b3d8a358389eff376fc50bd791fbb3d1fc413a', '017d73f20d78f61761150950e0e1df6da640499a']",10,1,11,395392,2,,,,936
9f613f100daf9517c841a754cd83c107bacf6f30,0,P. Taylor Goetz,2014-03-12 12:28:21-04:00,"['da8489a5cc87c99d132755c08f0486136e908e49', '2787660e462f1136db8b2317b7f1c0619a59a98c']",2,2,4,395396,2,,,,936
bb13ccedc0ca7443b46c3698ed864bbb19f00220,0,P. Taylor Goetz,2014-03-12 13:02:57-04:00,['651df24374b0b5de45e0a65155fba02af95cf020'],1,1,2,395398,1,,,,936
82a754a520f3633903b90af7a03d8ee313ec0c46,1,P. Taylor Goetz,2014-03-12 13:52:18-04:00,['bb13ccedc0ca7443b46c3698ed864bbb19f00220'],0,12,12,395410,1,,,,936
1e6e080118d4d0681eca90ecaad01e7327ade0fe,0,P. Taylor Goetz,2014-03-12 15:18:14-04:00,['82a754a520f3633903b90af7a03d8ee313ec0c46'],0,2,2,395412,1,,,,936
a2be522877a5a86c0c4e0f3407b81e7f8e99c95d,0,P. Taylor Goetz,2014-03-12 15:19:02-04:00,['9f613f100daf9517c841a754cd83c107bacf6f30'],0,2,2,395414,1,,,,936
69594018082333f6dc168a3e5e07ee2eb9a75c8f,0,nathanmarz,2014-03-17 14:07:45-07:00,['a2be522877a5a86c0c4e0f3407b81e7f8e99c95d'],3,71,74,395488,4,0.227272727,1,1,937
9796b5270450cbb914ada62996dd631f92209f4e,0,P. Taylor Goetz,2014-03-18 11:35:33-04:00,"['bd0cc453a5d7389eb2a92bacef46c13b436a0316', '61be2a01feb81146d89071fbe292dcf396a70c47']",0,0,0,395488,0,,,,937
c62d2e115fd2fcbdb2f8030913ac8492ea59c302,0,P. Taylor Goetz,2014-03-18 11:42:48-04:00,['9796b5270450cbb914ada62996dd631f92209f4e'],3,3,6,395494,1,,,,937
e1b6fb4db4554ba4d8cacc1d1fcdea9eabfcaa17,0,P. Taylor Goetz,2014-03-18 12:35:34-04:00,"['c62d2e115fd2fcbdb2f8030913ac8492ea59c302', '09ae97303d3faa0b4b837a3bbe18b996854d2733']",4,261,265,395759,5,,,,937
20d04da351324aa28387ad81aa8b33405bd83f4f,0,supercargo,2014-03-18 14:38:35-04:00,"['bb8562f4f19dd04cbc941a4c32ed4cdb392f17a0', 'a2be522877a5a86c0c4e0f3407b81e7f8e99c95d']",36,77,113,395872,11,,,,937
84f04c3fea11ccb6844bdef7baf8e6f654637981,0,P. Taylor Goetz,2014-03-18 15:36:09-04:00,['e1b6fb4db4554ba4d8cacc1d1fcdea9eabfcaa17'],118,17,135,396007,2,0,0,1,937
77dddca73070c694016c7b682fffb4d113365966,0,P. Taylor Goetz,2014-03-20 17:11:28-04:00,"['20d04da351324aa28387ad81aa8b33405bd83f4f', '1e6e080118d4d0681eca90ecaad01e7327ade0fe']",1,5156,5157,401164,46,,,,937
20b3496c258e356664604912df8df3711914dd95,0,P. Taylor Goetz,2014-03-20 17:23:47-04:00,['77dddca73070c694016c7b682fffb4d113365966'],2,3,5,401169,1,,,,937
d5dee0ef5f8ad403d1eff05f569c8e9b1e44508c,0,P. Taylor Goetz,2014-03-20 17:36:18-04:00,['20b3496c258e356664604912df8df3711914dd95'],0,3,3,401172,1,1,1,1,937
f550621ea814af02014886a78b45584569b468fe,1,P. Taylor Goetz,2014-03-21 15:36:33-04:00,['7a75c959eea518211af766ee0f1146dbc051ae0e'],20,34,54,401226,2,0,1,1,937
28e65a82bfcd60f38c93115974f6a8653756f9b5,1,Adrian Petrescu,2014-03-21 17:17:40-04:00,['d5dee0ef5f8ad403d1eff05f569c8e9b1e44508c'],6,12,18,401244,1,0.666666667,1,1,937
7e175e6a81e64048aae356430875ef9085754a97,0,Derek Dagit,2014-03-24 14:47:25+00:00,['d5dee0ef5f8ad403d1eff05f569c8e9b1e44508c'],41,13,54,401298,6,0,0,0,937
813952a8b1345586e53da62d1d65546c15d9e120,0,Niels Basjes,2014-03-24 20:06:51+01:00,['d5dee0ef5f8ad403d1eff05f569c8e9b1e44508c'],1,1,2,401300,1,,,,937
dbf8fafeceb6c6e77c91389e75424384d4909baa,0,Michael G. Noll,2014-03-24 20:43:44+01:00,['d5dee0ef5f8ad403d1eff05f569c8e9b1e44508c'],2,2,4,401304,1,,,,937
be8a22b0541e0fe7d5dcbc4c83b17d3b92328e99,0,Michael G. Noll,2014-03-24 20:47:37+01:00,['d5dee0ef5f8ad403d1eff05f569c8e9b1e44508c'],10,0,10,401314,1,,,,937
df687cb71ba174e408a6cf68011053ff18b16f71,0,Niels Basjes,2014-03-24 22:06:32+01:00,['813952a8b1345586e53da62d1d65546c15d9e120'],3,3,6,401320,1,,,,937
2c636ba017a8b67eceb11a8b09caf081812752b0,1,Niels Basjes,2014-03-24 22:07:27+01:00,['df687cb71ba174e408a6cf68011053ff18b16f71'],7,14,21,401341,1,,,,937
c621a6c1b8a4f77aac5d48030eabfbb89851fe48,0,nathanmarz,2014-03-24 18:56:46-07:00,"['d5dee0ef5f8ad403d1eff05f569c8e9b1e44508c', '69594018082333f6dc168a3e5e07ee2eb9a75c8f']",3,71,74,401415,4,,,,937
447fdb0b56757cd8d97d7c684f8a0b3b68639673,0,P. Taylor Goetz,2014-03-26 12:32:47-04:00,['c621a6c1b8a4f77aac5d48030eabfbb89851fe48'],1,1,2,401417,1,,,,937
7567d1343583ce13b2e108c430690d29b55a8cfa,0,P. Taylor Goetz,2014-03-26 13:44:32-04:00,['c621a6c1b8a4f77aac5d48030eabfbb89851fe48'],1,1,2,401419,1,,,,937
2f45866c8e011ac4804c940ff9e1d7c147591761,1,wurstmeister,2014-03-31 07:35:22+01:00,['09ae97303d3faa0b4b837a3bbe18b996854d2733'],26,238,264,401683,7,0.919117647,1,0.764705882,939
9129536cd91ea2b54df5ba2a4eb524aa064c56a1,0,wurstmeister,2014-03-31 22:48:08+01:00,['2f45866c8e011ac4804c940ff9e1d7c147591761'],3,4,7,401690,2,,,,939
94c4d4d9e6c4ce736141668c585818214a9d26cf,1,Robert (Bobby) Evans,2014-04-01 15:32:31+00:00,['c621a6c1b8a4f77aac5d48030eabfbb89851fe48'],168,183,351,402041,5,0.6,0,0.266666667,939
33715a2b4613742dfb3294a097874312d4e6c3b6,0,Li Jiahong,2014-04-03 15:46:40+08:00,"['d080e043d15d710d6729963bed9cb078b7dce78e', 'c621a6c1b8a4f77aac5d48030eabfbb89851fe48']",43,5313,5356,407397,62,,,,939
ae71186acdeb5a7efc19393d10cdde997f587773,0,Robert (Bobby) Evans,2014-04-03 17:29:32+00:00,['c621a6c1b8a4f77aac5d48030eabfbb89851fe48'],0,4,4,407401,1,,,,939
93ca65457201948d6be1f994f5a046ea0fe477a1,0,wurstmeister,2014-04-03 21:18:08+01:00,['9129536cd91ea2b54df5ba2a4eb524aa064c56a1'],1,9,10,407411,1,,,,939
0d3b833d86687857ec8cbfb1e01041ffc8120798,0,Suresh Srinivas,2014-04-03 14:17:14-07:00,['c621a6c1b8a4f77aac5d48030eabfbb89851fe48'],1,1,2,407413,1,,,,939
cee992ad57453720f0a28b9ecc0ab3680be6f61f,1,Suresh Srinivas,2014-04-03 14:45:47-07:00,['0d3b833d86687857ec8cbfb1e01041ffc8120798'],2,8,10,407423,1,,,,939
b30de82f88696c1fb6a8cc497ed3a6a65a1b023c,0,Robert (Bobby) Evans,2014-04-04 15:30:12+00:00,['447fdb0b56757cd8d97d7c684f8a0b3b68639673'],0,1,1,407424,1,,,,939
75800059a2d98a948939a81d47997590cb61ae00,1,Prabeesh K,2014-04-05 09:50:36+05:18,['b30de82f88696c1fb6a8cc497ed3a6a65a1b023c'],11,33,44,407468,1,0.462686567,1,0.343283582,939
aa064727d8b13d762c06509c185194b17edc40e7,1,Prabeesh K,2014-04-05 09:52:37+05:18,['75800059a2d98a948939a81d47997590cb61ae00'],6,10,16,407484,1,0,1,1,939
98cfe93010ff069af2f7c607b11e6735060e2405,1,wurstmeister,2014-04-05 13:21:37+01:00,['93ca65457201948d6be1f994f5a046ea0fe477a1'],1,8,9,407493,5,1,1,1,939
9370c5ccaab437f2aa1c0f5fad55802aaa3b2b96,1,wurstmeister,2014-04-05 13:54:39+01:00,['98cfe93010ff069af2f7c607b11e6735060e2405'],21,20,41,407534,3,,,,939
c8c04a6a6d9575f700d4c3db35927ddb5347a265,1,wurstmeister,2014-04-05 14:03:49+01:00,['9370c5ccaab437f2aa1c0f5fad55802aaa3b2b96'],11,6,17,407551,1,1,0,0,939
2c8d3c8927ae611b2c8c7000f8da85df22326b7b,1,Robert (Bobby) Evans,2014-04-07 15:15:13+00:00,['b30de82f88696c1fb6a8cc497ed3a6a65a1b023c'],7,8,15,407566,2,,,,939
c02885673920bb60044714d2af08890df550622a,0,Robert (Bobby) Evans,2014-04-08 16:05:20+00:00,"['2c8d3c8927ae611b2c8c7000f8da85df22326b7b', '0d3b833d86687857ec8cbfb1e01041ffc8120798']",1,1,2,407568,1,,,,939
38ea0ca63651dcf535c4ac0b5bf4e48246e5236f,0,Robert (Bobby) Evans,2014-04-08 16:08:06+00:00,['c02885673920bb60044714d2af08890df550622a'],0,1,1,407569,1,,,,939
1e23111f925d62f4f14e66293780ab3832f5165d,0,aprooks,2014-04-09 13:12:34+03:00,['38ea0ca63651dcf535c4ac0b5bf4e48246e5236f'],0,4,4,407573,1,,,,939
adab172a7d5621eb4497f9ec511f43c04991b2e3,0,P. Taylor Goetz,2014-04-09 09:32:23-04:00,"['e1b6fb4db4554ba4d8cacc1d1fcdea9eabfcaa17', 'c8c04a6a6d9575f700d4c3db35927ddb5347a265']",48,270,318,407891,12,,,,939
8fafbad96bce19a3f11add249d613f9009f9cf17,0,P. Taylor Goetz,2014-04-09 09:33:50-04:00,"['84f04c3fea11ccb6844bdef7baf8e6f654637981', 'adab172a7d5621eb4497f9ec511f43c04991b2e3']",48,270,318,408209,12,,,,939
7d1bf2a923f8416197f81b467d40f959b2f4f997,1,P. Taylor Goetz,2014-04-09 10:26:08-04:00,"['38ea0ca63651dcf535c4ac0b5bf4e48246e5236f', '8fafbad96bce19a3f11add249d613f9009f9cf17']",0,3282,3282,411491,49,,,,939
4fbbf72795951df10f4a82c0f0f019dd51cc1081,0,Robert (Bobby) Evans,2014-04-09 14:28:02+00:00,"['38ea0ca63651dcf535c4ac0b5bf4e48246e5236f', 'ae71186acdeb5a7efc19393d10cdde997f587773']",0,4,4,411495,1,,,,939
bde4f880dc69ad481531a8ed9670e102640f128b,0,Robert (Bobby) Evans,2014-04-09 14:30:32+00:00,['4fbbf72795951df10f4a82c0f0f019dd51cc1081'],0,2,2,411497,1,,,,939
a72aafae503c8314b26330e0d4f440fb4632a483,0,P. Taylor Goetz,2014-04-09 10:33:16-04:00,['7d1bf2a923f8416197f81b467d40f959b2f4f997'],2,7,9,411506,2,1,1,1,939
859a2e81be8f61720fc2965acef5f73f1449a7bb,1,P. Taylor Goetz,2014-04-09 10:57:37-04:00,['a72aafae503c8314b26330e0d4f440fb4632a483'],10,14,24,411530,3,1,1,0,939
3270dd2a83f5b78d51f23ae1b8b6e3951c60b2c0,0,P. Taylor Goetz,2014-04-09 11:26:33-04:00,['859a2e81be8f61720fc2965acef5f73f1449a7bb'],13,16,29,411559,1,,,,939
72dbbee75fe2524ac4ffc2da6f5166483af7ad32,0,P. Taylor Goetz,2014-04-09 11:40:53-04:00,['3270dd2a83f5b78d51f23ae1b8b6e3951c60b2c0'],216,619,835,412394,38,,,,939
fd82382b54c181718f9966f75dd776c8f445cadc,0,P. Taylor Goetz,2014-04-09 12:29:10-04:00,"['38ea0ca63651dcf535c4ac0b5bf4e48246e5236f', 'b25eeedffb5e9553e8d052a5da47c212fcf53a89']",1,1,2,412396,1,,,,939
979fc28d2f35dd701b8a72ee805fbdc9b902262a,0,P. Taylor Goetz,2014-04-09 12:45:52-04:00,"['fd82382b54c181718f9966f75dd776c8f445cadc', 'bde4f880dc69ad481531a8ed9670e102640f128b']",0,6,6,412402,2,,,,939
7832ae00f04c80ec24e90c3911ee12d32fb8e4e5,1,P. Taylor Goetz,2014-04-09 13:15:28-04:00,['979fc28d2f35dd701b8a72ee805fbdc9b902262a'],1,1,2,412404,1,,,,939
eb3ecb37a3a6b5335a01a3a57b5943f6cfa51137,0,P. Taylor Goetz,2014-04-09 13:47:16-04:00,['979fc28d2f35dd701b8a72ee805fbdc9b902262a'],0,1,1,412405,1,,,,939
23f667067c65488a5df4d83ac0b10d9cd3066325,0,P. Taylor Goetz,2014-04-09 14:04:43-04:00,"['eb3ecb37a3a6b5335a01a3a57b5943f6cfa51137', '28e65a82bfcd60f38c93115974f6a8653756f9b5']",6,12,18,412423,1,,,,939
89e2fbbdb187e7f8bdbd75a5710aa3c61ceb4632,0,P. Taylor Goetz,2014-04-09 14:15:17-04:00,['23f667067c65488a5df4d83ac0b10d9cd3066325'],0,1,1,412424,1,,,,939
6f0f30c5f7147c65c534b5161804626d94596b5e,0,P. Taylor Goetz,2014-04-09 14:48:08-04:00,['89e2fbbdb187e7f8bdbd75a5710aa3c61ceb4632'],1,1,2,412426,1,,,,939
1fc5c42237482c003b08faf579e727dd00c255a8,0,P. Taylor Goetz,2014-04-09 15:39:01-04:00,"['6f0f30c5f7147c65c534b5161804626d94596b5e', 'dbf8fafeceb6c6e77c91389e75424384d4909baa']",2,2,4,412430,1,,,,939
253eac7fbbe8ba243ec0d386d52de260587bd2e0,0,P. Taylor Goetz,2014-04-09 15:39:17-04:00,"['1fc5c42237482c003b08faf579e727dd00c255a8', 'be8a22b0541e0fe7d5dcbc4c83b17d3b92328e99']",10,0,10,412440,1,,,,939
3cf3f55e41b65d00ff5b5e3231e519b9cfc2c012,0,P. Taylor Goetz,2014-04-09 15:49:15-04:00,"['253eac7fbbe8ba243ec0d386d52de260587bd2e0', '2c636ba017a8b67eceb11a8b09caf081812752b0']",9,16,25,412465,1,,,,939
c8a511bd0d753bbb48a80a815998e8f7000c77a4,0,P. Taylor Goetz,2014-04-09 16:03:52-04:00,['f550621ea814af02014886a78b45584569b468fe'],2,2,4,412469,2,,,,939
4375bd758ec7a5c461aff34a040b6dc03a745974,1,Sriharsha Chintalapani,2014-04-10 09:16:04-07:00,['3cf3f55e41b65d00ff5b5e3231e519b9cfc2c012'],12,8,20,412489,2,,,,939
fe579beb7c384abcee9ccff98d91451025de7d6f,0,Sriharsha Chintalapani,2014-04-10 09:20:35-07:00,['3cf3f55e41b65d00ff5b5e3231e519b9cfc2c012'],1,4,5,412494,1,,,,939
2cd8f99ead495eda22e37953d140d1d3140c5430,0,Jason Jackson,2014-04-10 12:51:21-07:00,['3cf3f55e41b65d00ff5b5e3231e519b9cfc2c012'],1,1,2,412496,1,,,,939
9da324e12ff12dec97490197063ff35f6935ca93,1,Derek Dagit,2014-04-10 21:38:45+00:00,['2cd8f99ead495eda22e37953d140d1d3140c5430'],1,8,9,412505,1,0,0,1,939
8a9c635f9ffe478f5937ba125201adbf8cb72162,0,yerenkow,2014-04-11 08:49:11+03:00,['9368ac447aeb473f926302137dbcdf914d06cd32'],2,0,2,412507,1,,,,939
de46f7136f07d78946c7c5d16098dd56712ac8d4,0,Robert (Bobby) Evans,2014-04-11 14:32:54+00:00,"['2cd8f99ead495eda22e37953d140d1d3140c5430', '8a9c635f9ffe478f5937ba125201adbf8cb72162']",2,3,5,412512,1,,,,939
6c1af3e5b0f78c8d947a731b4609afaff955950c,0,Robert (Bobby) Evans,2014-04-11 14:33:54+00:00,['de46f7136f07d78946c7c5d16098dd56712ac8d4'],0,1,1,412513,1,,,,939
01389288fecbe13b00cebbfb3e68093f19717766,0,P. Taylor Goetz,2014-04-11 11:19:03-04:00,"['6c1af3e5b0f78c8d947a731b4609afaff955950c', '9da324e12ff12dec97490197063ff35f6935ca93']",1,8,9,412522,1,,,,939
1be3d0f65e4fcb604b14c11a3261aa0cf109ef71,0,P. Taylor Goetz,2014-04-11 11:20:44-04:00,['01389288fecbe13b00cebbfb3e68093f19717766'],0,1,1,412523,1,,,,939
3e7abfc0b0b260c6ac320ac9eca7f5208f0e4973,0,P. Taylor Goetz,2014-04-11 12:06:28-04:00,"['1be3d0f65e4fcb604b14c11a3261aa0cf109ef71', '94c4d4d9e6c4ce736141668c585818214a9d26cf']",168,183,351,412874,5,,,,939
1a0b46e95ab4ac467525314a75819a75dec92c40,0,P. Taylor Goetz,2014-04-11 12:11:46-04:00,['3e7abfc0b0b260c6ac320ac9eca7f5208f0e4973'],0,1,1,412875,1,,,,939
c4ff804c30b331be0af032f01d1b2819d62c7dc2,0,Danijel Schiavuzzi,2014-04-11 18:11:55+02:00,['1be3d0f65e4fcb604b14c11a3261aa0cf109ef71'],0,9,9,412884,1,0,0,0,939
15346a8533442dbd82806824556eb5fd2735e38e,0,P. Taylor Goetz,2014-04-14 13:51:20-04:00,['c8a511bd0d753bbb48a80a815998e8f7000c77a4'],0,35,35,412919,4,0.071428571,0,0.571428571,939
b2a5102917ebb4b32d42b9b722427500f939e8b5,0,Li Jiahong,2014-04-15 16:05:55+08:00,"['33715a2b4613742dfb3294a097874312d4e6c3b6', '1a0b46e95ab4ac467525314a75819a75dec92c40']",209,249,458,413377,14,,,,939
bf557f892702551f33733b95c29c431df5c9816c,0,Derek Dagit,2014-04-15 13:33:20+00:00,"['2fb66fa3be27f3495fbbe78831565a1edce12af1', '1a0b46e95ab4ac467525314a75819a75dec92c40']",3218,8681,11899,425276,135,,,,939
061acf1740d66edd2b90a62635d558a634450c64,0,Derek Dagit,2014-04-15 13:34:13+00:00,['bf557f892702551f33733b95c29c431df5c9816c'],1,3,4,425280,1,,,,939
3a037463569e81a43b399e4de9ae43f0b5749eff,0,Bryan Baugher,2014-04-15 13:10:07-05:00,['1a0b46e95ab4ac467525314a75819a75dec92c40'],1,1,2,425282,1,,,,939
442d8e75103f425d211a022184621072326925f0,0,Danijel Schiavuzzi,2014-04-16 18:01:34+02:00,['c4ff804c30b331be0af032f01d1b2819d62c7dc2'],7,9,16,425298,2,0,1,1,939
bd4ee0e7c606654624c698328b53633489429b37,0,Sriharsha Chintalapani,2014-04-16 14:11:14-07:00,['3cf3f55e41b65d00ff5b5e3231e519b9cfc2c012'],2,7,9,425307,2,,,,939
a0e2aa6e37ddfd1174c3430499de2b18b34052c5,1,Danijel Schiavuzzi,2014-04-17 10:25:54+02:00,['442d8e75103f425d211a022184621072326925f0'],5,5,10,425317,1,,,,939
b81ba5ee75627312719c713b6c3030b237b342d2,0,Danijel Schiavuzzi,2014-04-17 15:42:20+02:00,['a0e2aa6e37ddfd1174c3430499de2b18b34052c5'],21,25,46,425363,2,,,,939
6cc9bfe1c16f668cf8d89ff249136420965e6a51,0,Robert (Bobby) Evans,2014-04-18 18:01:04+00:00,['3a037463569e81a43b399e4de9ae43f0b5749eff'],0,1,1,425364,1,,,,939
a1871e5557e8770d5be73691ebdca75a83cb993d,1,Muneyuki Noguchi,2014-04-18 22:52:18-07:00,['6cc9bfe1c16f668cf8d89ff249136420965e6a51'],5,5,10,425374,4,,,,939
3569e2265cebb4c6f48291c5cb57163aba98e4da,0,Muneyuki Noguchi,2014-04-19 06:08:43-07:00,['6cc9bfe1c16f668cf8d89ff249136420965e6a51'],2,4,6,425380,1,,,,939
0877e1530eedf4f2cbf03142e32ed773b52ed4bd,1,Muneyuki Noguchi,2014-04-21 08:06:44+09:00,['a1871e5557e8770d5be73691ebdca75a83cb993d'],9,12,21,425401,4,,,,939
dbf9543744780a32f40b83fc6ffe5440054f028c,0,P. Taylor Goetz,2014-04-21 11:07:56-04:00,['15346a8533442dbd82806824556eb5fd2735e38e'],3,41,44,425445,2,0,1,1,939
0bd823b797cf63eb145059b0dbc3d5f996d8c824,0,P. Taylor Goetz,2014-04-21 11:10:10-04:00,['dbf9543744780a32f40b83fc6ffe5440054f028c'],1,1,2,425447,1,,,,939
1f92b0b704715c87507cdb7082966f1b2cf294d3,0,P. Taylor Goetz,2014-04-21 11:10:38-04:00,['0bd823b797cf63eb145059b0dbc3d5f996d8c824'],4,2,6,425453,1,,,,939
e1be2c3caddf8654d8441341a4ea868bac9b7a88,0,P. Taylor Goetz,2014-04-21 11:10:40-04:00,['1f92b0b704715c87507cdb7082966f1b2cf294d3'],1,1,2,425455,1,,,,939
b3513083656ca454cd72d8539878cd0716849116,0,P. Taylor Goetz,2014-04-21 11:16:10-04:00,['a2d48e1a62c6249c8737fc80ff70587f79e191ef'],14,77,91,425546,4,0,1,0.736842105,939
c4feab6713dbc0a714185db5586a3b6dfd64406b,0,P. Taylor Goetz,2014-04-21 11:17:14-04:00,['b3513083656ca454cd72d8539878cd0716849116'],4,2,6,425552,1,,,,939
a05d4147a186ddc6bc82a05a0ec354b063c42b75,0,P. Taylor Goetz,2014-04-21 11:17:16-04:00,['c4feab6713dbc0a714185db5586a3b6dfd64406b'],1,1,2,425554,1,,,,939
d324772b36283feaf8a77849506d3b84813d6866,0,P. Taylor Goetz,2014-04-21 12:01:52-04:00,['e1be2c3caddf8654d8441341a4ea868bac9b7a88'],1,1,2,425556,1,,,,939
52f296b00d9d00d4b9837051018094d7586cc51c,0,P. Taylor Goetz,2014-04-21 12:01:54-04:00,['d324772b36283feaf8a77849506d3b84813d6866'],1,1,2,425558,1,,,,939
19ffa64c9231f875cb1a60693a512b8109e73587,1,P. Taylor Goetz,2014-04-21 12:04:34-04:00,['52f296b00d9d00d4b9837051018094d7586cc51c'],0,52,52,425610,3,0.866666667,0.866666667,0.866666667,940
3c02fd72e7675417e43988243206878312f7a1e5,0,P. Taylor Goetz,2014-04-21 12:05:59-04:00,['19ffa64c9231f875cb1a60693a512b8109e73587'],1,1,2,425612,1,,,,940
4051c8a3c5e0a5675a0745168ff4c5ada9044d9b,0,P. Taylor Goetz,2014-04-21 12:06:01-04:00,['3c02fd72e7675417e43988243206878312f7a1e5'],1,1,2,425614,1,,,,940
0c20ab4977031fed868649cd5864545ada33200a,0,P. Taylor Goetz,2014-04-21 12:08:11-04:00,['a05d4147a186ddc6bc82a05a0ec354b063c42b75'],3,64,67,425681,2,0,1,0.727272727,941
d4108c30d635a35327f3d0655ffee0855bb3e971,0,P. Taylor Goetz,2014-04-21 12:09:02-04:00,['0c20ab4977031fed868649cd5864545ada33200a'],1,1,2,425683,1,,,,941
2c87946ec91057bfc4ed1431763659288852b9cd,0,P. Taylor Goetz,2014-04-21 12:09:04-04:00,['d4108c30d635a35327f3d0655ffee0855bb3e971'],1,1,2,425685,1,,,,941
f7e8e615c554bb274f391f70218412726001de9b,0,P. Taylor Goetz,2014-04-21 12:12:41-04:00,['2c87946ec91057bfc4ed1431763659288852b9cd'],1,1,2,425687,1,,,,941
baffe4accee86197b97b72f387f28b9bfd2af9e7,0,P. Taylor Goetz,2014-04-21 12:13:51-04:00,['f7e8e615c554bb274f391f70218412726001de9b'],1,1,2,425689,1,,,,941
ae728f81a3f480cc0f02209f5ed1309204a590f0,0,P. Taylor Goetz,2014-04-21 13:30:41-04:00,['72dbbee75fe2524ac4ffc2da6f5166483af7ad32'],0,19,19,425708,1,,,,941
98265c75aae72f535eb2beb9b97b68db44adb0ab,0,P. Taylor Goetz,2014-04-21 15:38:02-04:00,"['6cc9bfe1c16f668cf8d89ff249136420965e6a51', 'ae728f81a3f480cc0f02209f5ed1309204a590f0']",0,3716,3716,429424,49,,,,941
c4ea0caeef0a0923920c3065de997f04240318b7,0,P. Taylor Goetz,2014-04-21 15:38:38-04:00,['98265c75aae72f535eb2beb9b97b68db44adb0ab'],0,1,1,429425,1,,,,941
5eeb74f78b03d1d1076bb3c5871481056a5edf7f,1,Srinivas Gumdelli,2014-04-21 23:58:20-05:00,['1a0b46e95ab4ac467525314a75819a75dec92c40'],2,2,4,429429,1,,,,941
81704e310eb5e54135fd622281c4c0ebd7df663f,0,Robert (Bobby) Evans,2014-04-22 14:30:41+00:00,"['c4ea0caeef0a0923920c3065de997f04240318b7', '5eeb74f78b03d1d1076bb3c5871481056a5edf7f']",2,2,4,429433,1,,,,941
8f394953426af6eb827efb2c94b8d786c599a2ca,0,Robert (Bobby) Evans,2014-04-22 14:31:30+00:00,['81704e310eb5e54135fd622281c4c0ebd7df663f'],0,1,1,429434,1,,,,941
f6daf072fd644247090f44e6d054a934974e901a,1,P. Taylor Goetz,2014-04-22 12:10:35-04:00,['c4ea0caeef0a0923920c3065de997f04240318b7'],0,10,10,429444,1,,,,941
02b3efd71c453fd50ee4b95bf490753301ece101,0,Robert (Bobby) Evans,2014-04-22 16:22:58+00:00,"['8f394953426af6eb827efb2c94b8d786c599a2ca', '061acf1740d66edd2b90a62635d558a634450c64']",24,149,173,429617,10,,,,941
93612f5659b3f2ef176f9f46f470a081cdbaf239,0,Robert (Bobby) Evans,2014-04-22 16:23:47+00:00,['02b3efd71c453fd50ee4b95bf490753301ece101'],0,1,1,429618,1,,,,941
3b518d11ff2909d11821bd1f78043a19129cf275,0,Robert (Bobby) Evans,2014-04-22 16:40:57+00:00,"['93612f5659b3f2ef176f9f46f470a081cdbaf239', 'b81ba5ee75627312719c713b6c3030b237b342d2']",18,33,51,429669,2,,,,941
6a08855b48be8208cef5862246342b230d0f68cd,0,Robert (Bobby) Evans,2014-04-22 16:41:51+00:00,['3b518d11ff2909d11821bd1f78043a19129cf275'],0,1,1,429670,1,,,,941
bf73a0064c4581f615d46e1246e2178d4819afb8,0,davidlgr,2014-04-23 13:47:51+08:00,['6a08855b48be8208cef5862246342b230d0f68cd'],0,1,1,429671,1,0,1,0,941
46c02be8181d196e48484807e34215d5e5fb61b4,0,John Gilmore,2014-04-23 09:12:01+02:00,"['8cde5508b5e4828982aa4f1ff2e70ba6fd10f4b9', 'b0f33102c2bb206b5a7b3c929f7b5fcb50cb622c']",6130,18198,24328,453999,592,,,,941
f5f41a0b54a852da95a2fa659b1199d727571313,0,John Gilmore,2014-04-23 09:27:39+02:00,"['46c02be8181d196e48484807e34215d5e5fb61b4', '6a08855b48be8208cef5862246342b230d0f68cd']",292,9462,9754,463753,125,,,,941
7429e1d163bc7c52a4e111da22ea5dcfc84ea392,0,P. Taylor Goetz,2014-04-23 14:39:53-04:00,"['6a08855b48be8208cef5862246342b230d0f68cd', 'f6daf072fd644247090f44e6d054a934974e901a']",0,10,10,463763,1,,,,941
a5130af709c2a1979c8d376a4d1194f6450eb0d2,0,P. Taylor Goetz,2014-04-23 14:48:45-04:00,"['7429e1d163bc7c52a4e111da22ea5dcfc84ea392', 'bf73a0064c4581f615d46e1246e2178d4819afb8']",0,1,1,463764,1,,,,941
01d4863d8e4471fd6779085002442c749dd169f5,0,Robert (Bobby) Evans,2014-04-23 19:06:52+00:00,['7429e1d163bc7c52a4e111da22ea5dcfc84ea392'],1,2,3,463767,2,0,1,1,941
d2315e90b17cddcd87a5aac3a3823ba3a1f11868,0,P. Taylor Goetz,2014-04-23 15:11:22-04:00,"['a5130af709c2a1979c8d376a4d1194f6450eb0d2', '3569e2265cebb4c6f48291c5cb57163aba98e4da']",2,4,6,463773,1,,,,941
20c4565dbdbbb916d4143a9262c0869c566221bc,1,P. Taylor Goetz,2014-04-23 17:17:06-04:00,['baffe4accee86197b97b72f387f28b9bfd2af9e7'],4,362,366,464139,6,0.456647399,1,0.705202312,944
d646c4bfe1c551a14b0784220a7c12d9bb7a1b94,0,Robert (Bobby) Evans,2014-04-23 22:03:52+00:00,['01d4863d8e4471fd6779085002442c749dd169f5'],3,4,7,464146,2,1,0,0,944
7ff8dbf412e825165b38a0ec7c784aee54656346,0,Muneyuki Noguchi,2014-04-25 01:46:30+09:00,"['0877e1530eedf4f2cbf03142e32ed773b52ed4bd', 'd2315e90b17cddcd87a5aac3a3823ba3a1f11868']",46,3919,3965,468111,63,,,,944
351895a9b1c02738e64bc04812759b1a6f8c0bd6,0,Muneyuki Noguchi,2014-04-25 01:53:49+09:00,['7ff8dbf412e825165b38a0ec7c784aee54656346'],2,1,3,468114,1,,,,944
8c90f176f921658fe120422628229e01d98d8f68,0,P. Taylor Goetz,2014-04-24 15:06:22-04:00,['351895a9b1c02738e64bc04812759b1a6f8c0bd6'],0,3,3,468117,1,,,,944
2d7f9774160a0520087cdf2cfef968debc5eb168,1,Suresh Srinivas,2014-04-24 16:48:11-07:00,['d2315e90b17cddcd87a5aac3a3823ba3a1f11868'],11,61,72,468189,3,,,,945
c7a7127fcfe6aaefd0dab928334095368cdfadbe,1,Sriharsha Chintalapani,2014-04-24 19:59:20-07:00,['8c90f176f921658fe120422628229e01d98d8f68'],0,2,2,468191,1,0,1,1,945
6589660c12ddea4540c2b7f6fcf8d6873cd36a3c,0,Michael G. Noll,2014-04-25 11:49:40+02:00,['8c90f176f921658fe120422628229e01d98d8f68'],1,1,2,468193,1,,,,945
e64cb1843ff158371b09525bdb963c864be62167,0,Robert (Bobby) Evans,2014-04-25 14:42:39+00:00,"['d68cd231a8d365a4ec3b7f873cbbf36d59951630', '6589660c12ddea4540c2b7f6fcf8d6873cd36a3c']",317,9435,9752,477945,127,,,,945
f60805a49bdf4b394e6d78ab05bb44a226625beb,0,Robert (Bobby) Evans,2014-04-25 15:40:04+00:00,"['6589660c12ddea4540c2b7f6fcf8d6873cd36a3c', 'd646c4bfe1c551a14b0784220a7c12d9bb7a1b94']",2,4,6,477951,2,,,,945
a14adf36d4c6a24d6f666c087e4612562e1eb672,0,Robert (Bobby) Evans,2014-04-25 15:40:39+00:00,['f60805a49bdf4b394e6d78ab05bb44a226625beb'],0,1,1,477952,1,,,,945
be531d1e8662b14b7a5a72695374f88b6263547f,0,Robert (Bobby) Evans,2014-04-25 15:43:37+00:00,"['a14adf36d4c6a24d6f666c087e4612562e1eb672', 'e64cb1843ff158371b09525bdb963c864be62167']",13,12,25,477977,7,,,,945
a9e5d54ab5e2b7519a962674c320a4abace697c8,0,Robert (Bobby) Evans,2014-04-25 15:44:09+00:00,['be531d1e8662b14b7a5a72695374f88b6263547f'],0,1,1,477978,1,,,,945
a276a738c0be29b48ec1b10ba030942fa7956b54,0,P. Taylor Goetz,2014-04-25 12:31:21-04:00,"['a9e5d54ab5e2b7519a962674c320a4abace697c8', '7832ae00f04c80ec24e90c3911ee12d32fb8e4e5']",1,1,2,477980,1,,,,945
33e9bce61fe4955d80bc251bb163ab87b63b6582,0,P. Taylor Goetz,2014-04-25 12:32:21-04:00,['a276a738c0be29b48ec1b10ba030942fa7956b54'],0,1,1,477981,1,,,,945
e652939f0f48e29218394c81658cfcaac7186e35,0,P. Taylor Goetz,2014-04-25 12:33:56-04:00,"['33e9bce61fe4955d80bc251bb163ab87b63b6582', 'c7a7127fcfe6aaefd0dab928334095368cdfadbe']",0,2,2,477983,1,,,,945
920955ba756509aea049be46772d09956354da31,0,P. Taylor Goetz,2014-04-25 12:34:51-04:00,['e652939f0f48e29218394c81658cfcaac7186e35'],0,1,1,477984,1,,,,945
a831984b0d63630daa738d1cae361cb70d7a5804,1,Bryan Baugher,2014-04-25 13:11:58-05:00,['920955ba756509aea049be46772d09956354da31'],1,1,2,477986,1,,,,945
c868aca4813511a5addcdd0e9e043b5c3e4036c6,0,P. Taylor Goetz,2014-04-25 14:12:55-04:00,['920955ba756509aea049be46772d09956354da31'],1,22,23,478009,1,,,,945
a5cd7a52340da5c71dae1d0109c20624926d761b,0,P. Taylor Goetz,2014-04-25 14:22:06-04:00,['920955ba756509aea049be46772d09956354da31'],0,1,1,478010,1,,,,945
24b715ae5e771682608d1fcd3a08bdd33d8d3b11,0,P. Taylor Goetz,2014-04-25 14:48:40-04:00,"['a5cd7a52340da5c71dae1d0109c20624926d761b', '4375bd758ec7a5c461aff34a040b6dc03a745974']",12,8,20,478030,2,,,,945
618337e2e7ac59ce0ea972b013c4a9e1c32d7188,0,P. Taylor Goetz,2014-04-25 14:49:28-04:00,['24b715ae5e771682608d1fcd3a08bdd33d8d3b11'],1,2,3,478033,1,,,,945
7a389d2e64bb4db6bb060149c679367a0fba69a8,0,P. Taylor Goetz,2014-04-25 14:56:21-04:00,"['618337e2e7ac59ce0ea972b013c4a9e1c32d7188', 'c868aca4813511a5addcdd0e9e043b5c3e4036c6']",1,22,23,478056,1,,,,945
aeb1bce0c7971c3378a0858bb60e2834133b38be,0,P. Taylor Goetz,2014-04-25 14:58:29-04:00,['7a389d2e64bb4db6bb060149c679367a0fba69a8'],0,1,1,478057,1,,,,945
39acc27bfb6062aba2d3c748a26b318c30b89cb4,0,P. Taylor Goetz,2014-04-25 16:25:47-04:00,['aeb1bce0c7971c3378a0858bb60e2834133b38be'],3,4,7,478064,1,,,,945
b0f6e00e859d36f6c259345a1da8a205e6475c4f,0,P. Taylor Goetz,2014-04-25 17:16:20-04:00,"['aeb1bce0c7971c3378a0858bb60e2834133b38be', 'c5e7c5b92b55e5f9854e411b663944f171384b4d']",1,2,3,478067,1,,,,945
dc4de425eef5701ccafe0805f08eeb011baae0fb,0,P. Taylor Goetz,2014-04-25 17:18:28-04:00,['b0f6e00e859d36f6c259345a1da8a205e6475c4f'],0,1,1,478068,1,,,,945
45b28482628a37d826a7c6a834d83bcc156a4a87,1,wurstmeister,2014-04-26 20:08:49+01:00,['dc4de425eef5701ccafe0805f08eeb011baae0fb'],16,35,51,478119,3,1,1,1,945
5ee4f3df527290b5949b85c19f74cc1f28832d25,0,Srinivas Prasad Gumdelli,2014-04-27 04:23:42-05:00,['dc4de425eef5701ccafe0805f08eeb011baae0fb'],39,39,78,478197,2,,,,945
6fd68a5fa092a24397bf4492533772d89e1df02e,0,P. Taylor Goetz,2014-04-27 17:26:51-04:00,['39acc27bfb6062aba2d3c748a26b318c30b89cb4'],8,8,16,478213,1,,,,945
0cce4b8254d7fec9565bb94ea48fb7afec540cd2,0,Robert (Bobby) Evans,2014-04-28 14:54:50+00:00,"['486ecc8cd5b5a1bab3eb626799621985e6d9ab57', 'dc4de425eef5701ccafe0805f08eeb011baae0fb']",353,9535,9888,488101,130,,,,945
16c967981f4ebfe6d20ff2b86a8a7bc56227f74d,0,P. Taylor Goetz,2014-04-28 13:35:25-04:00,['6fd68a5fa092a24397bf4492533772d89e1df02e'],2,4,6,488107,1,,,,945
38b288e38768c97090cc86083dd1e6915a65658f,0,P. Taylor Goetz,2014-04-28 16:23:35-04:00,['2d7f9774160a0520087cdf2cfef968debc5eb168'],2,10,12,488119,2,,,,945
6904862f2da5519f34c209f7579060fc5731b2f1,0,P. Taylor Goetz,2014-04-28 16:39:46-04:00,['16c967981f4ebfe6d20ff2b86a8a7bc56227f74d'],10,10,20,488139,1,,,,945
60fac27624611a5a25b3e2102149bff7f015293e,1,ChitturiPadma,2014-04-29 15:31:35+05:18,['dc4de425eef5701ccafe0805f08eeb011baae0fb'],1,1,2,488141,1,,,,945
442752b86647bd7a9ebf149dcbc6862fbb993911,1,ChitturiPadma,2014-04-29 15:34:54+05:18,['60fac27624611a5a25b3e2102149bff7f015293e'],1,9,10,488151,1,,,,945
f6b843d99c874a7139c7339b79cfc6a995f143d2,0,P. Taylor Goetz,2014-04-29 13:08:00-04:00,"['dc4de425eef5701ccafe0805f08eeb011baae0fb', '6904862f2da5519f34c209f7579060fc5731b2f1']",13,16,29,488180,1,,,,945
404bf2592252f00f0a9cb1013938fc066a7f1bd0,0,Robert (Bobby) Evans,2014-04-29 17:28:52+00:00,['dc4de425eef5701ccafe0805f08eeb011baae0fb'],1,5,6,488186,1,0,0,0,945
8e0a97652a9eb68b558accf2a205a1cc8a899fbc,0,Suresh Srinivas,2014-04-29 10:48:35-07:00,"['2d7f9774160a0520087cdf2cfef968debc5eb168', '38b288e38768c97090cc86083dd1e6915a65658f']",2,10,12,488198,2,,,,945
0666c41387fc11c0422b26ab27ebc38c30fe26af,0,Robert (Bobby) Evans,2014-04-29 17:56:53+00:00,['dc4de425eef5701ccafe0805f08eeb011baae0fb'],7,0,7,488205,1,,,,945
3c89fb524f57152353334a60cfc6a2121286c702,0,Robert (Bobby) Evans,2014-04-30 14:49:35+00:00,['404bf2592252f00f0a9cb1013938fc066a7f1bd0'],1,1,2,488207,1,,,,945
660d8c42ee8876847209e57ffa2c200ceefbbbbd,0,John Gilmore,2014-05-01 12:29:48+02:00,['f5f41a0b54a852da95a2fa659b1199d727571313'],10,9,19,488226,3,,,,945
0c669f429b6cf3fa1719dbb35b71b647cd241ab3,0,John Gilmore,2014-05-01 14:26:31+02:00,['660d8c42ee8876847209e57ffa2c200ceefbbbbd'],11,11,22,488248,5,,,,945
bc76878f0ea08e9b853e342ca92211373346bb4e,0,Robert (Bobby) Evans,2014-05-01 13:54:03-05:00,['f6b843d99c874a7139c7339b79cfc6a995f143d2'],0,74,74,488322,1,,,,946
3a9e8fc1ad28942b398fb3864f59989d5720fca7,0,Robert (Bobby) Evans,2014-05-02 14:08:57-05:00,"['f6b843d99c874a7139c7339b79cfc6a995f143d2', '1b13ca2281f4aafac92e471167ef0e7c3dccb030']",2,12,14,488336,1,,,,946
22215b5827d924b35fd5b41d1781af8824c30ce9,0,Robert (Bobby) Evans,2014-05-02 14:09:52-05:00,['3a9e8fc1ad28942b398fb3864f59989d5720fca7'],0,1,1,488337,1,,,,946
262f2dc3cb4212e5e3428f1b2f569114eb3146b3,0,darthbear,2014-05-03 13:06:32-04:00,['22215b5827d924b35fd5b41d1781af8824c30ce9'],27,156,183,488520,7,0,0,0,947
a06fc90e5ddb15a62c5e8214c94f0d59333fecc7,1,Sriharsha Chintalapani,2014-05-03 20:31:31-07:00,['22215b5827d924b35fd5b41d1781af8824c30ce9'],726,2393,3119,491639,13,0.420233463,0.534046693,0.786964981,957
c0ab52447ed895efafa182991cbe1e4a98b83cfa,1,Robert (Bobby) Evans,2014-05-05 15:58:56+00:00,['0cce4b8254d7fec9565bb94ea48fb7afec540cd2'],3,3,6,491645,1,,,,957
2d2e842eeda51bcbb59a4dc1c1d46c746cbeb0a9,1,darthbear,2014-05-05 21:06:39-04:00,['262f2dc3cb4212e5e3428f1b2f569114eb3146b3'],86,67,153,491798,7,,,,957
85f3bddc24774c5f62af71069c522cb32b1bc58f,1,ChitturiPadma,2014-05-06 16:32:18+05:18,['442752b86647bd7a9ebf149dcbc6862fbb993911'],0,31,31,491829,1,,,,957
4e0313236ddf4d5d09a1b01f811f923923d52639,0,darthbear,2014-05-06 11:03:03-04:00,['2d2e842eeda51bcbb59a4dc1c1d46c746cbeb0a9'],13,12,25,491854,1,1,0,1,957
73595921a26445f53fb90037b974a31eea78065f,0,Robert (Bobby) Evans,2014-05-06 15:12:19+00:00,"['22215b5827d924b35fd5b41d1781af8824c30ce9', '3c89fb524f57152353334a60cfc6a2121286c702']",1,5,6,491860,1,,,,957
a0876291a00ba10980b775b5a4b44a066e5f0a0a,0,Robert (Bobby) Evans,2014-05-06 15:12:52+00:00,['73595921a26445f53fb90037b974a31eea78065f'],0,1,1,491861,1,,,,957
57e854a055720e65c660e3385f33aa83f979075e,0,Robert (Bobby) Evans,2014-05-06 15:23:12+00:00,"['a0876291a00ba10980b775b5a4b44a066e5f0a0a', '5ee4f3df527290b5949b85c19f74cc1f28832d25']",39,39,78,491939,2,,,,957
c1eb423c94344ddfaad78fb2db30bb3c33e72d4b,0,Robert (Bobby) Evans,2014-05-06 15:23:49+00:00,['57e854a055720e65c660e3385f33aa83f979075e'],0,1,1,491940,1,,,,957
5b4bb313510b1986afbe3e9522011f6f8376ca2c,0,Robert (Bobby) Evans,2014-05-06 15:52:37+00:00,"['c1eb423c94344ddfaad78fb2db30bb3c33e72d4b', '45b28482628a37d826a7c6a834d83bcc156a4a87']",16,35,51,491991,3,,,,957
7f058e19425ff712d9f8034b3641c06af885535e,1,Sriharsha Chintalapani,2014-05-06 17:38:16-07:00,['a06fc90e5ddb15a62c5e8214c94f0d59333fecc7'],28,29,57,492048,2,,,,957
861a92eab8740cfc0f83ac4d7ade9a2ab04a8b9b,1,Sean Zhong,2014-05-07 11:10:07+08:00,['22215b5827d924b35fd5b41d1781af8824c30ce9'],385,692,1077,493125,18,0.308571429,0.354285714,0.531428571,957
be8f8327b3c2d36e89420d62fb8ca530ba726cf3,1,Sean Zhong,2014-05-07 11:17:53+08:00,['861a92eab8740cfc0f83ac4d7ade9a2ab04a8b9b'],0,148,148,493273,2,0.5,0.5,1,959
a45b53a167cd48a275bbb21279bcaa9e9437b97b,0,Li Jiahong,2014-05-07 20:09:34+08:00,"['b2a5102917ebb4b32d42b9b722427500f939e8b5', '5b4bb313510b1986afbe3e9522011f6f8376ca2c']",141,4088,4229,497502,78,,,,959
248dc8ad7ec6ec23a5ae4efab7bfa6f93ab6a058,0,P. Taylor Goetz,2014-05-07 11:06:25-04:00,"['5b4bb313510b1986afbe3e9522011f6f8376ca2c', 'bc76878f0ea08e9b853e342ca92211373346bb4e']",0,74,74,497576,1,,,,959
7c04873713c763f646539bfc9304b1a9cff94e21,0,P. Taylor Goetz,2014-05-07 11:08:10-04:00,['248dc8ad7ec6ec23a5ae4efab7bfa6f93ab6a058'],0,1,1,497577,1,,,,959
453a4a3516166978d1ca298386613ab88e2cc1a0,0,Sriharsha Chintalapani,2014-05-07 08:12:01-07:00,['7f058e19425ff712d9f8034b3641c06af885535e'],570,0,570,498147,1,0.690909091,0.511688312,0.179220779,959
3497c7716ae475899e1af6192ace7ed2b9745cc4,0,P. Taylor Goetz,2014-05-07 11:17:27-04:00,"['7c04873713c763f646539bfc9304b1a9cff94e21', 'bd4ee0e7c606654624c698328b53633489429b37']",2,7,9,498156,2,,,,959
b612a867532a37b64603ff6178129fc54f84a21c,0,P. Taylor Goetz,2014-05-07 11:19:54-04:00,['3497c7716ae475899e1af6192ace7ed2b9745cc4'],0,1,1,498157,1,,,,959
98809b58af1b6b2a47322ef1994a8585d630c965,0,Robert (Bobby) Evans,2014-05-07 13:48:16-05:00,['b612a867532a37b64603ff6178129fc54f84a21c'],12,0,12,498169,1,,,,959
70a46be1fd24935f92c5d27e509d0800ae950f80,1,Sean Zhong,2014-05-08 09:58:08+08:00,['be8f8327b3c2d36e89420d62fb8ca530ba726cf3'],1,1,2,498171,1,,,,959
2812e511c025f39308ba30be921ed0ab01d15e94,1,Sean Zhong,2014-05-08 10:05:49+08:00,['70a46be1fd24935f92c5d27e509d0800ae950f80'],3,8,11,498182,2,,,,959
c5e7a0d0f137cc5f0ccf6116541c16d4a7727598,1,Sean Zhong,2014-05-08 10:32:46+08:00,['2812e511c025f39308ba30be921ed0ab01d15e94'],21,19,40,498222,5,0,0,0,959
8785f491bab0c3a43d472e1e5250415aee6e287b,1,Prabeesh K,2014-05-08 09:48:40+05:18,['aa064727d8b13d762c06509c185194b17edc40e7'],2,5,7,498229,1,0,1,1,959
426468cc155ab1b80b44028812c7b3fc23bf2776,1,Prabeesh K,2014-05-08 09:49:43+05:18,['8785f491bab0c3a43d472e1e5250415aee6e287b'],110,130,240,498469,1,0.333333333,1,0.333333333,959
aed4e12431b7437da8d181810c75ea78013c31a1,1,Prabeesh K,2014-05-08 09:51:56+05:18,['426468cc155ab1b80b44028812c7b3fc23bf2776'],0,5,5,498474,1,,,,959
1bc4d41e8cf348e9cc1121c145d015f3f7351885,0,darthbear,2014-05-08 11:11:53-04:00,['4e0313236ddf4d5d09a1b01f811f923923d52639'],14,14,28,498502,1,1,1,1,959
877e95fce0ea1859edf2f95c9ae1b4ddf0abb237,0,darthbear,2014-05-08 11:23:08-04:00,['1bc4d41e8cf348e9cc1121c145d015f3f7351885'],1,14,15,498517,2,,,,959
d9f33533f0d55b0e98d8d0290676baced0b70a71,0,darthbear,2014-05-08 11:34:51-04:00,['877e95fce0ea1859edf2f95c9ae1b4ddf0abb237'],2,2,4,498521,1,,,,959
1333d48524eff0f37ecdaef07c8649037eb323e8,0,Sriharsha Chintalapani,2014-05-08 10:42:39-07:00,['453a4a3516166978d1ca298386613ab88e2cc1a0'],5,0,5,498526,1,,,,959
702127d49d7a65844ca2cd74036c360a7d71922c,0,darthbear,2014-05-09 20:47:03-04:00,['b612a867532a37b64603ff6178129fc54f84a21c'],0,5,5,498531,1,0,0,0,959
d42daf5be94e92d506fb83985802fa05d20b62ad,0,ChitturiPadma,2014-05-12 12:43:24+05:18,['85f3bddc24774c5f62af71069c522cb32b1bc58f'],11,10,21,498552,1,,,,959
a89d3968af327f7943d7a24e10e47ac240e6646d,0,Michael G. Noll,2014-05-12 15:19:49+02:00,['b612a867532a37b64603ff6178129fc54f84a21c'],0,6,6,498558,2,,,,959
eb7992aa63a86e4d6b782ff03b90b367b6ac6225,0,Michael G. Noll,2014-05-12 15:24:48+02:00,['b612a867532a37b64603ff6178129fc54f84a21c'],0,317,317,498875,3,,,,960
35b288ec71d26cfd1ef06d86724f83a1ff5146bd,0,Robert (Bobby) Evans,2014-05-12 15:21:10+00:00,"['b612a867532a37b64603ff6178129fc54f84a21c', 'd9f33533f0d55b0e98d8d0290676baced0b70a71']",20,142,162,499037,6,,,,960
9902c9d4e9141203b72e689c3bd73da86be7d1d1,0,Robert (Bobby) Evans,2014-05-12 15:34:57+00:00,['35b288ec71d26cfd1ef06d86724f83a1ff5146bd'],0,1,1,499038,1,,,,960
e9f9e5fdefe44b1862da026f0081de641a9b4fcb,0,darthbear,2014-05-12 20:44:39-04:00,['702127d49d7a65844ca2cd74036c360a7d71922c'],2,2,4,499042,1,,,,960
f0814d4b46af16ba4bb98458ba4f1d5339c7643a,0,Prabeesh K,2014-05-13 08:38:17+05:18,['aed4e12431b7437da8d181810c75ea78013c31a1'],3,0,3,499045,1,,,,960
f55f766d7085a92ea4dfcf645fca10243ec92b89,1,ChitturiPadma,2014-05-13 16:45:40+05:18,['d42daf5be94e92d506fb83985802fa05d20b62ad'],7,11,18,499063,1,,,,960
358d5d0126fc1834861420bc30839f4ab37ecfe4,1,ChitturiPadma,2014-05-13 16:50:17+05:18,['f55f766d7085a92ea4dfcf645fca10243ec92b89'],26,36,62,499125,1,,,,960
0a3b474063cf83fe63feb6b2874b40161539d0b4,0,Robert (Bobby) Evans,2014-05-13 15:09:26+00:00,"['9902c9d4e9141203b72e689c3bd73da86be7d1d1', 'e9f9e5fdefe44b1862da026f0081de641a9b4fcb']",0,5,5,499130,1,,,,960
5df89d54d0573995035b74de50b49072b079fe4b,0,Robert (Bobby) Evans,2014-05-13 15:09:50+00:00,['0a3b474063cf83fe63feb6b2874b40161539d0b4'],0,1,1,499131,1,,,,960
b1bb394c61fd52e40731500ce3311c8a26f718e7,1,thinker0,2014-05-14 21:56:48+09:00,['5df89d54d0573995035b74de50b49072b079fe4b'],24,24,48,499179,6,,,,960
685d38168965472bc6e97124e8fdcb2d28be512c,0,Robert (Bobby) Evans,2014-05-14 15:07:27+00:00,"['5df89d54d0573995035b74de50b49072b079fe4b', 'a831984b0d63630daa738d1cae361cb70d7a5804']",1,1,2,499181,1,,,,960
d0f6b6d9c4e6d404d1048e66846153ad4077831f,0,Robert (Bobby) Evans,2014-05-14 15:08:04+00:00,['685d38168965472bc6e97124e8fdcb2d28be512c'],0,1,1,499182,1,,,,960
f930b0beb6ff66fae00c2067012b366ec8f0eb7e,0,Robert (Bobby) Evans,2014-05-14 15:23:16+00:00,"['d0f6b6d9c4e6d404d1048e66846153ad4077831f', 'fe579beb7c384abcee9ccff98d91451025de7d6f']",1,4,5,499187,1,,,,960
0f2d2ef10b65260cc81c103cd1492dadeec86028,0,Robert (Bobby) Evans,2014-05-14 15:23:54+00:00,['f930b0beb6ff66fae00c2067012b366ec8f0eb7e'],0,1,1,499188,1,,,,960
ac9038407b98e26582ec4abd035e9d731318eef9,0,Robert (Bobby) Evans,2014-05-14 15:32:07+00:00,"['0f2d2ef10b65260cc81c103cd1492dadeec86028', 'eb7992aa63a86e4d6b782ff03b90b367b6ac6225']",0,317,317,499505,3,,,,960
f041e55fc7f8fcaf92d5b7d23c80dee2025c2921,0,Robert (Bobby) Evans,2014-05-14 15:37:06+00:00,"['ac9038407b98e26582ec4abd035e9d731318eef9', 'f0814d4b46af16ba4bb98458ba4f1d5339c7643a']",100,151,251,499756,3,,,,960
79599237f6b25e86f4723bbd86a78bf61e7495ff,0,Robert (Bobby) Evans,2014-05-14 15:37:48+00:00,['f041e55fc7f8fcaf92d5b7d23c80dee2025c2921'],0,1,1,499757,1,,,,960
222c72502d57d37f0b2ee9a63f2765039205bbaf,0,Robert (Bobby) Evans,2014-05-14 15:43:00+00:00,"['79599237f6b25e86f4723bbd86a78bf61e7495ff', 'a89d3968af327f7943d7a24e10e47ac240e6646d']",0,6,6,499763,2,,,,960
c7b223824df12858f3029010d655b72f13d777fb,1,Albert Chu,2014-05-14 10:57:51-07:00,['222c72502d57d37f0b2ee9a63f2765039205bbaf'],1,7,8,499771,1,,,,960
b75e433b07b3459d31a67ce8b446333380078e48,0,Steven Phung,2014-05-14 21:30:26-07:00,['222c72502d57d37f0b2ee9a63f2765039205bbaf'],1,1,2,499773,1,,,,960
bcbd22bf3527fb700b4dda06207b22638db5a16d,0,John Gilmore,2014-05-15 07:04:15+02:00,['0c669f429b6cf3fa1719dbb35b71b647cd241ab3'],16,14,30,499803,2,,,,960
f06d81b97e58d76d8597b4dc4535e60764018a50,0,nathanmarz,2014-05-15 10:07:39-07:00,['222c72502d57d37f0b2ee9a63f2765039205bbaf'],1,0,1,499804,1,,,,960
b50beb7cfa522b8773b0e79aa600c323e8c504d8,0,Robert (Bobby) Evans,2014-05-15 17:36:37+00:00,['222c72502d57d37f0b2ee9a63f2765039205bbaf'],0,320,320,500124,1,0.662100457,0.831050228,0.885844749,961
865756d969dfbda02925bc9d650a526f17c3bbbc,0,Robert (Bobby) Evans,2014-05-15 17:47:56+00:00,"['0666c41387fc11c0422b26ab27ebc38c30fe26af', '222c72502d57d37f0b2ee9a63f2765039205bbaf']",195,824,1019,501143,26,,,,961
a043f669210607c8e33840898ba3c182ad267c15,0,Robert (Bobby) Evans,2014-05-15 17:50:22+00:00,['865756d969dfbda02925bc9d650a526f17c3bbbc'],1,5,6,501149,1,,,,961
edcaf71b304cc5196eec48035b06d15aaa8df433,1,jiahong.ljh,2014-05-16 15:14:05+08:00,['a45b53a167cd48a275bbb21279bcaa9e9437b97b'],1,220,221,501370,4,0.023622047,0.023622047,0.299212598,962
5b0258322fd0b479fb372a69184a24bc27958c21,1,Brenden Matthews,2014-05-16 19:24:21-07:00,['222c72502d57d37f0b2ee9a63f2765039205bbaf'],117,172,289,501659,18,0,0,0.604651163,962
d20ba2e720f66529c1b187d855c857ee6f8d78f2,1,troyding,2014-05-19 14:18:34+08:00,['f06d81b97e58d76d8597b4dc4535e60764018a50'],21,21,42,501701,1,,,,962
db79ab6e66e437388c2b095b6ceaa01fc2e2f28a,0,Robert (Bobby) Evans,2014-05-19 21:25:12+00:00,"['f06d81b97e58d76d8597b4dc4535e60764018a50', '80ab3625e9802fbd8bff16c706fc788cf7aed17c']",2,5,7,501708,2,,,,962
80f4f7d3f88f8d733bfa4a4bf1c06f77b678b372,0,Robert (Bobby) Evans,2014-05-19 21:25:35+00:00,['db79ab6e66e437388c2b095b6ceaa01fc2e2f28a'],0,1,1,501709,1,,,,962
fa3802afd1053b2d0494997387bfb8b579bf9489,0,Robert (Bobby) Evans,2014-05-19 21:29:44+00:00,"['80f4f7d3f88f8d733bfa4a4bf1c06f77b678b372', '7e175e6a81e64048aae356430875ef9085754a97']",41,13,54,501763,6,,,,962
1311a1ddfc097324488f93251062a9ea406f3f77,0,Robert (Bobby) Evans,2014-05-19 21:30:11+00:00,['fa3802afd1053b2d0494997387bfb8b579bf9489'],0,1,1,501764,1,,,,962
d3c6a1b1e8d03297cdca95f9244d7c49a590e3fa,0,Robert (Bobby) Evans,2014-05-19 21:39:19+00:00,"['1311a1ddfc097324488f93251062a9ea406f3f77', 'bcbd22bf3527fb700b4dda06207b22638db5a16d']",195,628,823,502587,11,,,,962
a09adda06fb4f9c2cf291ef9d72eba4cf9972e68,0,Robert (Bobby) Evans,2014-05-19 21:39:47+00:00,['d3c6a1b1e8d03297cdca95f9244d7c49a590e3fa'],0,1,1,502588,1,,,,962
d1159e34c1292f7861bd96cdee508d986a50d276,0,Robert (Bobby) Evans,2014-05-19 17:01:55-05:00,"['a09adda06fb4f9c2cf291ef9d72eba4cf9972e68', '8e0a97652a9eb68b558accf2a205a1cc8a899fbc']",13,71,84,502672,5,,,,962
73dc6245ff0bd53b737df663926d7bd1a93a55c9,0,Robert (Bobby) Evans,2014-05-19 17:02:40-05:00,['d1159e34c1292f7861bd96cdee508d986a50d276'],0,1,1,502673,1,,,,962
deb55ec918126400ed94ee49f88c32b9ffda7b5d,0,Sean Zhong,2014-05-20 10:33:15+08:00,['c5e7a0d0f137cc5f0ccf6116541c16d4a7727598'],2,2,4,502677,1,,,,962
138a7a7f0bc4aceb829915106673b969552cee85,0,Sean Zhong,2014-05-20 10:34:36+08:00,['deb55ec918126400ed94ee49f88c32b9ffda7b5d'],1,1,2,502679,1,,,,962
c5c3571ca15ee2dd675fb3cac44bd0f926ccfc67,0,Sean Zhong,2014-05-20 10:56:26+08:00,['138a7a7f0bc4aceb829915106673b969552cee85'],35,6,41,502720,5,0,0,0,962
7b88cf352e2ab4d9df0c068432140b13821ba057,1,Sean Zhong,2014-05-20 11:15:05+08:00,['c5c3571ca15ee2dd675fb3cac44bd0f926ccfc67'],1,1,2,502722,1,,,,962
19e72e852cb25caa1ee18b6c5ae1ae627e337bf1,1,Sean Zhong,2014-05-20 11:24:42+08:00,['7b88cf352e2ab4d9df0c068432140b13821ba057'],18,5,23,502745,2,1,0.2,1,962
6b9da0804e59935bbe280570bead20954e779c40,0,Sean Zhong,2014-05-20 11:32:20+08:00,['19e72e852cb25caa1ee18b6c5ae1ae627e337bf1'],3,2,5,502750,1,,,,962
fe68fd968bdfab3d902f86956ae04bd3d46b444e,0,Sean Zhong,2014-05-20 11:34:03+08:00,['6b9da0804e59935bbe280570bead20954e779c40'],1,1,2,502752,1,,,,962
0d6b438fff0ddeb254efe3d858ae7a29251ce289,0,troyding,2014-05-20 11:37:52+08:00,['d20ba2e720f66529c1b187d855c857ee6f8d78f2'],0,88,88,502840,1,0.333333333,1,0.9,963
d85c470747c22fa47a1f914388861b018ce9acc8,0,Sean Zhong,2014-05-20 11:59:18+08:00,['fe68fd968bdfab3d902f86956ae04bd3d46b444e'],0,12,12,502852,1,0,0,1,963
1baf9b7f47f1f1592391a9eb18b3ad0b340f7355,1,Sean Zhong,2014-05-20 12:03:16+08:00,['d85c470747c22fa47a1f914388861b018ce9acc8'],7,7,14,502866,2,,,,963
44e47e82d03743cbec3fe6aff17c76711520c061,0,Sean Zhong,2014-05-20 12:06:40+08:00,['1baf9b7f47f1f1592391a9eb18b3ad0b340f7355'],3,0,3,502869,1,,,,963
baa310618ed639c312f2281bc8364d55e5977174,0,Sean Zhong,2014-05-20 12:26:49+08:00,['44e47e82d03743cbec3fe6aff17c76711520c061'],7,4,11,502880,1,0,0,0,963
9eecaf890d06df8d94c73227498a572f4d4cc96d,0,Sean Zhong,2014-05-20 20:46:11+08:00,['baa310618ed639c312f2281bc8364d55e5977174'],18,44,62,502942,2,0,1,0.75,963
deba55833b8752c5275cb37ac3a1043583790963,1,Sean Zhong,2014-05-20 21:19:37+08:00,['baa310618ed639c312f2281bc8364d55e5977174'],18,44,62,503004,2,0,1,0.75,963
f18d98fc45f89d058ebbd2578e2c9e82cfedc722,0,Sean Zhong,2014-05-20 21:22:45+08:00,"['deba55833b8752c5275cb37ac3a1043583790963', '9eecaf890d06df8d94c73227498a572f4d4cc96d']",0,0,0,503004,0,,,,963
04b4907e10c152072dcb1fcdae9d0198d7dc9603,0,Sean Zhong,2014-05-20 22:10:43+08:00,['f18d98fc45f89d058ebbd2578e2c9e82cfedc722'],9,11,20,503024,2,,,,963
9f9a2a556986cc67452081f0bd763e3ed1da8f75,0,Sean Zhong,2014-05-20 22:23:05+08:00,['04b4907e10c152072dcb1fcdae9d0198d7dc9603'],0,2,2,503026,1,,,,963
c0768100738b211a21e1775b78c114f4a20b2b30,0,Robert (Bobby) Evans,2014-05-20 10:20:11-05:00,"['73dc6245ff0bd53b737df663926d7bd1a93a55c9', 'c0ab52447ed895efafa182991cbe1e4a98b83cfa']",2,12,14,503040,2,,,,963
a6bbd877fbcd7b743304a2e95034db826742442c,0,Robert (Bobby) Evans,2014-05-20 10:20:42-05:00,['c0768100738b211a21e1775b78c114f4a20b2b30'],0,1,1,503041,1,,,,963
a3d8d9633cff99456608a6394b9ecbb5389f3683,0,P. Taylor Goetz,2014-05-20 12:46:51-04:00,"['a6bbd877fbcd7b743304a2e95034db826742442c', '7567d1343583ce13b2e108c430690d29b55a8cfa']",1,1,2,503043,1,,,,963
773a33267188fb3c427e2b0fc0113048a27aa528,0,P. Taylor Goetz,2014-05-20 12:51:11-04:00,['a3d8d9633cff99456608a6394b9ecbb5389f3683'],0,1,1,503044,1,,,,963
1099f8ada716a06180620e1c182f6c8488d69c75,0,P. Taylor Goetz,2014-05-20 13:12:47-04:00,"['773a33267188fb3c427e2b0fc0113048a27aa528', 'b75e433b07b3459d31a67ce8b446333380078e48']",1,1,2,503046,1,,,,963
52fe66e9f5c5ce95c3de6121bbb68dcdcd01802f,0,P. Taylor Goetz,2014-05-20 13:14:55-04:00,['1099f8ada716a06180620e1c182f6c8488d69c75'],0,1,1,503047,1,,,,963
20b4f8b2195a1bf214f63e10b1bbca4690c0290f,0,Sean Zhong,2014-05-21 01:15:55+08:00,['9f9a2a556986cc67452081f0bd763e3ed1da8f75'],1,1,2,503049,1,,,,963
9e1dc5918618e9a23e7bc6c1b2e41cb002206230,0,P. Taylor Goetz,2014-05-20 13:45:01-04:00,"['52fe66e9f5c5ce95c3de6121bbb68dcdcd01802f', 'a043f669210607c8e33840898ba3c182ad267c15']",5,2,7,503056,1,,,,963
fe7ac29105e0425d91cb211b724d1db90a64c363,0,P. Taylor Goetz,2014-05-20 13:47:15-04:00,['9e1dc5918618e9a23e7bc6c1b2e41cb002206230'],0,1,1,503057,1,,,,963
512e34eee399a57cffe9c38f68229d604c9f5db9,0,P. Taylor Goetz,2014-05-20 13:58:18-04:00,"['fe7ac29105e0425d91cb211b724d1db90a64c363', '5b0258322fd0b479fb372a69184a24bc27958c21']",117,172,289,503346,18,,,,963
4ee9ea7a8b391380c185a921bcf562b95461f44a,0,P. Taylor Goetz,2014-05-20 14:58:30-04:00,['512e34eee399a57cffe9c38f68229d604c9f5db9'],0,1,1,503347,1,,,,963
115540e8696c8b95bd0a4622e160e343e87dea0d,0,P. Taylor Goetz,2014-05-20 15:29:25-04:00,"['4ee9ea7a8b391380c185a921bcf562b95461f44a', 'b1bb394c61fd52e40731500ce3311c8a26f718e7']",24,24,48,503395,6,,,,963
b5903d22b8608af0ff05ffe5054b775ff62f8c46,0,P. Taylor Goetz,2014-05-20 15:47:17-04:00,['115540e8696c8b95bd0a4622e160e343e87dea0d'],0,1,1,503396,1,,,,963
599dd0660f4b2af446f36bb37887debd45038b07,0,P. Taylor Goetz,2014-05-20 16:33:18-04:00,"['b5903d22b8608af0ff05ffe5054b775ff62f8c46', '1e23111f925d62f4f14e66293780ab3832f5165d']",0,4,4,503400,1,,,,963
cf1ffe735d618eac32d0364c34ca9ddbd446f3db,0,P. Taylor Goetz,2014-05-20 16:34:41-04:00,['599dd0660f4b2af446f36bb37887debd45038b07'],0,1,1,503401,1,,,,963
7346db2f4dc10e59965d3f9dfa9a9611ccefe41a,0,troyding,2014-05-21 16:58:20+08:00,['0d6b438fff0ddeb254efe3d858ae7a29251ce289'],88,24,112,503513,2,0.666666667,0,0.1,963
f6c306b27036ff9905108379846125ee18e772ff,0,Robert (Bobby) Evans,2014-05-21 10:22:48-05:00,"['cf1ffe735d618eac32d0364c34ca9ddbd446f3db', '358d5d0126fc1834861420bc30839f4ab37ecfe4']",9,61,70,503583,2,,,,963
4ac0becbd0d346316ab39c8bf46f27955e8f29cb,0,Robert (Bobby) Evans,2014-05-21 10:23:21-05:00,['f6c306b27036ff9905108379846125ee18e772ff'],0,1,1,503584,1,,,,963
fe5f41aa8332700d3f98422cb7d986fc47289bcd,1,Robert (Bobby) Evans,2014-05-21 11:03:11-05:00,['4ac0becbd0d346316ab39c8bf46f27955e8f29cb'],1212,18509,19721,523305,145,0.297355063,0.42145338,0.88418381,1027
c86dbf956aabcd2623bdbc937dd51acfafe87d4a,0,Aaron Levin,2014-05-21 15:43:40-04:00,['4ac0becbd0d346316ab39c8bf46f27955e8f29cb'],7,10,17,523322,1,,,,1027
2d0b9ad75aaba788d4f60d3b3070e334bba8b922,0,Michael G. Noll,2014-05-22 10:32:06+02:00,['4ac0becbd0d346316ab39c8bf46f27955e8f29cb'],2,2,4,523326,1,,,,1027
4f0d45e4e9b4cb5c926c514e026ab836fb951a62,0,Michael G. Noll,2014-05-22 10:32:22+02:00,['2d0b9ad75aaba788d4f60d3b3070e334bba8b922'],1,1,2,523328,1,,,,1027
60c472f9049e86d565ff6cf6e22ed355c6366f58,0,Michael G. Noll,2014-05-22 10:54:18+02:00,['4f0d45e4e9b4cb5c926c514e026ab836fb951a62'],13,8,21,523349,1,,,,1027
36ce17126159e47e316bb4b1b5e6984faf04f841,0,Michael G. Noll,2014-05-22 10:55:05+02:00,['60c472f9049e86d565ff6cf6e22ed355c6366f58'],0,8,8,523357,1,,,,1027
021f5d5d55eb91137bda2b1f5be316ed60a5140c,0,Michael G. Noll,2014-05-22 11:10:58+02:00,['36ce17126159e47e316bb4b1b5e6984faf04f841'],2,2,4,523361,1,,,,1027
3bf4475ef88cea2fdc70e85051b5f8301ec4a12c,0,Michael G. Noll,2014-05-22 11:12:17+02:00,['36ce17126159e47e316bb4b1b5e6984faf04f841'],1,1,2,523363,1,,,,1027
ce6e5d26384d7f5d831b35e4eff126fe214981d1,0,Derek Dagit,2014-05-22 18:34:23+00:00,['fe5f41aa8332700d3f98422cb7d986fc47289bcd'],1,1,2,523365,1,,,,1027
52d2f2f9160f90a97de2d49a3827bd8c103fb14e,0,Danijel Schiavuzzi,2014-05-23 17:52:56+02:00,['021f5d5d55eb91137bda2b1f5be316ed60a5140c'],4,14,18,523383,2,1,1,1,1027
76c5a6c2911c7b2524bd563d0e63d1a2d8ab228c,0,Michael G. Noll,2014-05-27 10:20:08+02:00,"['021f5d5d55eb91137bda2b1f5be316ed60a5140c', '3bf4475ef88cea2fdc70e85051b5f8301ec4a12c']",1,1,2,523385,1,,,,1027
4091e4b3a758b7718a0f27aa0a61a9d2b8561d21,0,Michael G. Noll,2014-05-27 10:25:09+02:00,['76c5a6c2911c7b2524bd563d0e63d1a2d8ab228c'],0,1,1,523386,1,,,,1027
ddc67051745c383b84fc0ec64b48a44b84ba1668,0,Michael G. Noll,2014-05-27 18:22:52+02:00,['4091e4b3a758b7718a0f27aa0a61a9d2b8561d21'],2,2,4,523390,1,,,,1027
452838f2ab5f2dbe72a77ab6bfc57529da1f4e0c,0,Michael G. Noll,2014-05-27 18:31:03+02:00,['ddc67051745c383b84fc0ec64b48a44b84ba1668'],0,15,15,523405,1,,,,1027
bfdce7aae74c2b467f71228a00c30fb3281eea7a,0,Michael G. Noll,2014-05-28 08:59:11+02:00,['452838f2ab5f2dbe72a77ab6bfc57529da1f4e0c'],1,1,2,523407,1,,,,1027
698bb9c9788b82d4127d861fb3ecf06a06b683c2,0,Robert (Bobby) Evans,2014-05-28 08:45:22-05:00,"['ce6e5d26384d7f5d831b35e4eff126fe214981d1', 'bfdce7aae74c2b467f71228a00c30fb3281eea7a']",18,37,55,523462,5,,,,1027
688444a96a5b2abf28faa0b7220e1436a0e951e3,0,Sriharsha Chintalapani,2014-05-28 20:14:12-07:00,['1333d48524eff0f37ecdaef07c8649037eb323e8'],2,2,4,523466,1,,,,1027
b930e100a9f74e832fd9142d0c825d9f24d0af1d,1,Kyle Nusbaum,2014-05-29 02:02:54-05:00,['bfdce7aae74c2b467f71228a00c30fb3281eea7a'],11,775,786,524252,7,0.850699844,0.894245723,0.718506998,1031
2cd8ee37e60c180fe46f03d2bdbe3042db8bc517,0,P. Taylor Goetz,2014-05-29 15:08:49-04:00,"['bfdce7aae74c2b467f71228a00c30fb3281eea7a', '7346db2f4dc10e59965d3f9dfa9a9611ccefe41a']",21,45,66,524318,2,,,,1031
cd0b118843fb8627810debd78664f0aa53cd6727,0,P. Taylor Goetz,2014-05-29 15:13:19-04:00,['2cd8ee37e60c180fe46f03d2bdbe3042db8bc517'],0,1,1,524319,1,,,,1031
2881ac9c85cb61bec44f8e6e3f1d638e2968abf2,1,P. Taylor Goetz,2014-05-29 15:24:13-04:00,"['cd0b118843fb8627810debd78664f0aa53cd6727', '4051c8a3c5e0a5675a0745168ff4c5ada9044d9b']",0,3238,3238,527557,40,,,,1031
6326baf1e55ee20bf98a404ed07888d03bb42870,0,P. Taylor Goetz,2014-05-29 15:39:51-04:00,['2881ac9c85cb61bec44f8e6e3f1d638e2968abf2'],223,23,246,527803,6,,,,1031
4550bbf59ad4bd68d249433235164bc00520aeb9,0,Robert (Bobby) Evans,2014-05-29 19:41:47+00:00,['b50beb7cfa522b8773b0e79aa600c323e8c504d8'],11,19,30,527833,1,0,1,0,1031
eee8b243c8b4026f5f063c60b02e7d8d8e6fd06b,0,P. Taylor Goetz,2014-05-29 17:01:03-04:00,['cd0b118843fb8627810debd78664f0aa53cd6727'],0,1,1,527834,1,,,,1031
900490b9caf8993ad0beee79fd4139b3bdee6359,1,Sriharsha Chintalapani,2014-05-29 16:33:17-07:00,['688444a96a5b2abf28faa0b7220e1436a0e951e3'],23,23,46,527880,5,,,,1031
2a8f777f8e49a50e5846bae9eafb5f3512192ebd,0,Sriharsha Chintalapani,2014-05-29 17:26:07-07:00,['900490b9caf8993ad0beee79fd4139b3bdee6359'],3,3,6,527886,1,,,,1031
2d64f7e80585281e64514d1be4f5efae83e7a9a4,0,Aaron Zimmerman,2014-05-30 07:40:26-05:00,['eee8b243c8b4026f5f063c60b02e7d8d8e6fd06b'],0,4,4,527890,1,1,1,1,1031
e538ffee70646a17d2d848e287da84c5098b92e7,0,Sriharsha Chintalapani,2014-05-30 07:55:52-07:00,['2a8f777f8e49a50e5846bae9eafb5f3512192ebd'],1,1,2,527892,1,,,,1031
23a63756ac52a0a34309b72918e8b63b2d622e78,0,P. Taylor Goetz,2014-05-30 11:25:53-04:00,['4051c8a3c5e0a5675a0745168ff4c5ada9044d9b'],1,1,2,527894,1,,,,1031
20be88f5dae7af8bd4a749731ee8a6890c249942,0,P. Taylor Goetz,2014-05-30 11:26:40-04:00,['23a63756ac52a0a34309b72918e8b63b2d622e78'],2,7,9,527903,1,,,,1031
3f22fc697c473d6d88a48b631dd0956c96f94f82,0,P. Taylor Goetz,2014-05-30 11:27:17-04:00,['20be88f5dae7af8bd4a749731ee8a6890c249942'],2,3,5,527908,1,,,,1031
c41ad3a2f9173d460a29fc0479ac658d9ad7dfe2,0,P. Taylor Goetz,2014-05-30 11:52:20-04:00,"['6326baf1e55ee20bf98a404ed07888d03bb42870', '3f22fc697c473d6d88a48b631dd0956c96f94f82']",5,11,16,527924,3,,,,1031
33cc25e0413b7360fdd37533fb0352145da840fe,0,P. Taylor Goetz,2014-05-30 12:15:57-04:00,['c41ad3a2f9173d460a29fc0479ac658d9ad7dfe2'],1,1,2,527926,1,,,,1031
1154884438cae5eeb26c4213f8ad80c640bebdff,0,P. Taylor Goetz,2014-05-30 12:25:34-04:00,['3f22fc697c473d6d88a48b631dd0956c96f94f82'],4,0,4,527930,3,0,0,0,1031
d339a56296da3484b54476d2eadb35e6c548129e,0,P. Taylor Goetz,2014-05-30 12:27:03-04:00,"['33cc25e0413b7360fdd37533fb0352145da840fe', '1154884438cae5eeb26c4213f8ad80c640bebdff']",4,0,4,527934,3,,,,1031
2278fc9623d5b71bca9ece3857e645e85ab1562f,1,David James,2014-05-31 13:55:54-04:00,['eee8b243c8b4026f5f063c60b02e7d8d8e6fd06b'],2021,2205,4226,532160,19,,,,1031
3352dc298743eaffc7ade85aa175a1ef53ff3b7e,0,David James,2014-05-31 14:17:23-04:00,['2278fc9623d5b71bca9ece3857e645e85ab1562f'],2,1,3,532163,1,,,,1031
49a9a92f79546f8a44e8664e422e26c187b73ee2,0,Sriharsha Chintalapani,2014-05-31 14:14:13-07:00,['e538ffee70646a17d2d848e287da84c5098b92e7'],1,0,1,532164,1,,,,1031
71817e7e14412a29764271ecbb2e59f6e227400e,1,Sriharsha Chintalapani,2014-06-02 11:09:25-07:00,['49a9a92f79546f8a44e8664e422e26c187b73ee2'],23,21,44,532208,6,,,,1031
4c61cd40023ae31cb9045e04360b376736969d3d,0,Kyle Nusbaum,2014-06-02 21:50:20+00:00,['eee8b243c8b4026f5f063c60b02e7d8d8e6fd06b'],4,17,21,532229,2,,,,1031
4a8fc69c8276bf1de6a293411f889d9b97636d94,0,Kyle Nusbaum,2014-06-02 22:11:54+00:00,['4c61cd40023ae31cb9045e04360b376736969d3d'],7,7,14,532243,1,,,,1031
426d143784ee3610aa3582d43316f1344abd6275,1,Sean Zhong,2014-06-03 14:44:09+08:00,['20b4f8b2195a1bf214f63e10b1bbca4690c0290f'],1,215,216,532459,3,1,1,0.850746269,1033
0bca1733d64a92d8ec411f5fdf41ebc90a1bddef,0,Sean Zhong,2014-06-03 14:53:10+08:00,['426d143784ee3610aa3582d43316f1344abd6275'],1,1,2,532461,1,,,,1033
baee2f4d3543315c040756caa6cf9881c44ee803,0,Robert (Bobby) Evans,2014-06-03 19:27:45-05:00,"['eee8b243c8b4026f5f063c60b02e7d8d8e6fd06b', '71817e7e14412a29764271ecbb2e59f6e227400e']",728,1818,2546,535007,12,,,,1033
6dae731c89b3756eea3257cee949a493d7590f16,0,Robert (Bobby) Evans,2014-06-03 19:28:50-05:00,['baee2f4d3543315c040756caa6cf9881c44ee803'],0,1,1,535008,1,,,,1033
f6915d45a61593f95bf779558a32f807d583932c,0,Sean Zhong,2014-06-04 18:14:55+08:00,['0bca1733d64a92d8ec411f5fdf41ebc90a1bddef'],2,2,4,535012,2,,,,1033
a9180599317e2741559418165ebc7178008147a1,0,Kyle Nusbaum,2014-06-04 18:35:16+00:00,['4a8fc69c8276bf1de6a293411f889d9b97636d94'],3,5,8,535020,2,,,,1033
1e0413e908300ec12fa5615edb7b704a82601757,1,Kyle Nusbaum,2014-06-04 22:14:53+00:00,"['b930e100a9f74e832fd9142d0c825d9f24d0af1d', '6dae731c89b3756eea3257cee949a493d7590f16']",808,1937,2745,537765,17,,,,1033
b15374372e777bf24e7117db41a38bb0c19223a1,1,Kyle Nusbaum,2014-06-04 23:31:06+00:00,['1e0413e908300ec12fa5615edb7b704a82601757'],3,1,4,537769,1,,,,1033
402d1313d9277851267ae0d09481711ec7647689,0,Kyle Nusbaum,2014-06-05 18:43:30+00:00,['a9180599317e2741559418165ebc7178008147a1'],5,4,9,537778,2,,,,1033
0d47c5136744e438f11bbc377adf61f7329c84e5,0,Robert (Bobby) Evans,2014-06-06 10:56:42-05:00,"['6dae731c89b3756eea3257cee949a493d7590f16', '98809b58af1b6b2a47322ef1994a8585d630c965']",12,0,12,537790,1,,,,1033
3dd27a0b95afecca313783ad8e329db8bcca7f1a,0,Robert (Bobby) Evans,2014-06-06 11:00:11-05:00,['0d47c5136744e438f11bbc377adf61f7329c84e5'],0,1,1,537791,1,,,,1033
9bfd77b30f8a04ceebfcf75f2fac9a1673340340,0,Robert (Bobby) Evans,2014-06-06 11:21:19-05:00,"['3dd27a0b95afecca313783ad8e329db8bcca7f1a', '50408bfc1c193356a66f50f9ce9aeb7786031f4b']",0,8,8,537799,1,,,,1033
c7c57d5b0af4d7baa96c2ea52f72c828bafc0f22,0,Robert (Bobby) Evans,2014-06-06 11:22:10-05:00,['9bfd77b30f8a04ceebfcf75f2fac9a1673340340'],0,1,1,537800,1,,,,1033
e4e2879496c71128c8e6dfab5239b1ddaa399329,0,Derek Dagit,2014-06-06 11:35:07-05:00,['c7c57d5b0af4d7baa96c2ea52f72c828bafc0f22'],2,13,15,537815,1,,,,1033
2ab3bc8e656e7420f235e1f45d37b867c256afa4,0,Robert (Bobby) Evans,2014-06-06 11:44:30-05:00,"['c7c57d5b0af4d7baa96c2ea52f72c828bafc0f22', '402d1313d9277851267ae0d09481711ec7647689']",6,20,26,537841,2,,,,1033
dd1d2136034a6b39343795ea6c58c9406c48b597,0,Robert (Bobby) Evans,2014-06-06 11:45:39-05:00,['2ab3bc8e656e7420f235e1f45d37b867c256afa4'],0,1,1,537842,1,,,,1033
e69ead05a6ae098af6c7df65c5a725dea4d44d3f,0,Derek Dagit,2014-06-06 12:47:41-05:00,"['e4e2879496c71128c8e6dfab5239b1ddaa399329', 'dd1d2136034a6b39343795ea6c58c9406c48b597']",5,19,24,537866,3,,,,1033
701ac94d9ad29192368ad63e7d6975794dc3c2f7,0,Robert (Bobby) Evans,2014-06-07 10:30:33-05:00,"['dd1d2136034a6b39343795ea6c58c9406c48b597', 'f6915d45a61593f95bf779558a32f807d583932c']",445,1110,1555,539421,27,,,,1033
e21642d87903869ab7f9239afd20c21ae4cb280e,0,Robert (Bobby) Evans,2014-06-07 10:31:59-05:00,['701ac94d9ad29192368ad63e7d6975794dc3c2f7'],0,1,1,539422,1,,,,1033
b4422f13b6c609b5f68eb0a053f4bc08182f97d5,0,Sean Zhong,2014-06-08 01:03:05+08:00,['f6915d45a61593f95bf779558a32f807d583932c'],1,1,2,539424,1,,,,1033
5f7520af012f9e5ab3bf7e051b0410aaf765bd61,0,Sean Zhong,2014-06-08 01:55:50+08:00,['b4422f13b6c609b5f68eb0a053f4bc08182f97d5'],3,8,11,539435,2,,,,1033
f7a78023abf5119526d0e6e9c8d9e6122545cafb,0,Sean Zhong,2014-06-08 03:37:52+08:00,['5f7520af012f9e5ab3bf7e051b0410aaf765bd61'],8,3,11,539446,2,,,,1033
23f572420b4b1b24e79b53067c9a2cb703599756,0,Sean Zhong,2014-06-08 03:41:46+08:00,['f7a78023abf5119526d0e6e9c8d9e6122545cafb'],13,47,60,539506,1,1,1,1,1033
db16c1dfd0cf41a6d6e7f105ef0b121f5bec0642,0,Boris Aksenov,2014-06-08 02:55:03+04:00,['dd1d2136034a6b39343795ea6c58c9406c48b597'],49,46,95,539601,4,0,0,0,1033
1a57fcf6b015c23f56aea896397bca03fc109ead,0,Robert (Bobby) Evans,2014-06-09 08:35:29-05:00,"['e21642d87903869ab7f9239afd20c21ae4cb280e', '23f572420b4b1b24e79b53067c9a2cb703599756']",14,48,62,539663,2,,,,1033
e3b9d46e31cf72136b7d3e8163ff42c539f3b419,0,Robert (Bobby) Evans,2014-06-09 08:55:22-05:00,['4550bbf59ad4bd68d249433235164bc00520aeb9'],265,349,614,540277,3,0.96969697,0.96969697,1,1035
6592b8209c49a98db15b3d6d228f488aa6c2e623,0,Kishor Patil,2014-06-09 15:44:50+00:00,['698bb9c9788b82d4127d861fb3ecf06a06b683c2'],9,14,23,540300,2,,,,1035
89109b058c19f5f254a0de9dcb1f40fef875f3bf,0,Boris Aksenov,2014-06-09 20:36:55+04:00,"['db16c1dfd0cf41a6d6e7f105ef0b121f5bec0642', '1a57fcf6b015c23f56aea896397bca03fc109ead']",448,1149,1597,541897,28,,,,1035
1ae179e62c6bfa581c9af50285df59ace6bd5eba,0,P. Taylor Goetz,2014-06-09 14:45:39-04:00,"['1a57fcf6b015c23f56aea896397bca03fc109ead', 'b15374372e777bf24e7117db41a38bb0c19223a1']",87,861,948,542845,9,,,,1035
c61b6a78ad1c9574542bcc06ffadad78d716a268,0,P. Taylor Goetz,2014-06-09 15:48:57-04:00,['1ae179e62c6bfa581c9af50285df59ace6bd5eba'],0,1,1,542846,1,,,,1035
8f8cb5eb7179f6d443fb1238329e98fdc862c56c,0,P. Taylor Goetz,2014-06-09 16:32:27-04:00,"['c61b6a78ad1c9574542bcc06ffadad78d716a268', 'e69ead05a6ae098af6c7df65c5a725dea4d44d3f']",0,10,10,542856,1,,,,1035
c89fb820861427b5be0a204bc3ab7a89d67a97de,0,P. Taylor Goetz,2014-06-09 16:36:54-04:00,['8f8cb5eb7179f6d443fb1238329e98fdc862c56c'],0,1,1,542857,1,,,,1035
55e1664d40c87047dc1e9f322726aeb1a77ea344,1,David James,2014-06-09 20:54:24-07:00,['3352dc298743eaffc7ade85aa175a1ef53ff3b7e'],1328,3956,5284,548141,49,0.621988882,0.710315009,0.75416924,1053
2456f0aa8c3834ab562f32d645e2835402075ff2,0,David James,2014-06-09 21:08:02-07:00,['55e1664d40c87047dc1e9f322726aeb1a77ea344'],0,8,8,548149,1,,,,1053
bc391722098c1e66f6ebe0377a3de6b51a7cf38c,0,JuDasheng,2014-06-10 17:43:29+08:00,"['e2a7f7c0e1a5a413840948342f4be86d9ba56516', 'c89fb820861427b5be0a204bc3ab7a89d67a97de']",1693,14785,16478,564627,193,,,,1053
ead423793d392959f41c2782a05ed23413bc84a3,0,JuDasheng,2014-06-10 18:48:06+08:00,['bc391722098c1e66f6ebe0377a3de6b51a7cf38c'],0,31,31,564658,1,,,,1054
0279d725cb6ace2e4f4cb64d48ef236a97f0d785,0,JuDasheng,2014-06-10 18:48:47+08:00,['ead423793d392959f41c2782a05ed23413bc84a3'],4,25,29,564687,4,1,1,1,1054
72b1f592885abc8c02c6902aa0eb6499bacae7f2,1,Sean Zhong,2014-06-10 19:54:11+08:00,['c89fb820861427b5be0a204bc3ab7a89d67a97de'],21,210,231,564918,3,0.442105263,1,0.936842105,1055
6946c34e9f06726b46c5fb1bf12e1f186a1a8a19,0,Sean Zhong,2014-06-10 20:29:28+08:00,['72b1f592885abc8c02c6902aa0eb6499bacae7f2'],6,6,12,564930,1,,,,1055
029ef968a2c03b4c3bfc86072d3f9923a4c463ec,0,P. Taylor Goetz,2014-06-10 13:32:30-04:00,['c89fb820861427b5be0a204bc3ab7a89d67a97de'],3,203,206,565136,3,,,,1055
3bea3c4f55bfe69e1e82626f8f1d3ecc4012b29a,0,P. Taylor Goetz,2014-06-10 13:34:36-04:00,['029ef968a2c03b4c3bfc86072d3f9923a4c463ec'],21,3,24,565160,1,,,,1055
7cafa39565c257f8d6869f8bb3d6f2c634e611d9,0,P. Taylor Goetz,2014-06-10 13:44:25-04:00,['3bea3c4f55bfe69e1e82626f8f1d3ecc4012b29a'],1,1,2,565162,1,,,,1055
c5e1e33db94da602ca5b57d04aa32599e9b90c35,0,P. Taylor Goetz,2014-06-10 14:05:20-04:00,['7cafa39565c257f8d6869f8bb3d6f2c634e611d9'],12,10,22,565184,7,,,,1055
d178bdc56bebb8d498316650c2e9f9e61ff4bede,0,P. Taylor Goetz,2014-06-10 14:26:17-04:00,['c5e1e33db94da602ca5b57d04aa32599e9b90c35'],10,12,22,565206,7,,,,1055
7483d9b8859a932cdd0e9919b9112d53277cd978,1,P. Taylor Goetz,2014-06-10 14:31:34-04:00,['d178bdc56bebb8d498316650c2e9f9e61ff4bede'],1,1,2,565208,1,,,,1055
780c8f23ab164b4f5848e4ea8d48b0306d53ca84,0,P. Taylor Goetz,2014-06-10 14:46:18-04:00,['7483d9b8859a932cdd0e9919b9112d53277cd978'],0,27,27,565235,1,,,,1055
c2477c2c3fd602690ccdaf12c95c9dfa51ab121b,0,P. Taylor Goetz,2014-06-10 14:51:20-04:00,['780c8f23ab164b4f5848e4ea8d48b0306d53ca84'],13,11,24,565259,7,,,,1055
4db451466e08145641ee6173d2ed2d46fe268490,0,P. Taylor Goetz,2014-06-10 14:51:27-04:00,['c2477c2c3fd602690ccdaf12c95c9dfa51ab121b'],8,8,16,565275,7,,,,1055
cf2e8b7ee06b455a90bd4b3bfd53facef1369612,1,Sriharsha Chintalapani,2014-06-10 15:01:33-07:00,['6592b8209c49a98db15b3d6d228f488aa6c2e623'],1,2,3,565278,1,,,,1055
fbaf7278940925f27e24f436d1917aee28b23d3c,1,JuDasheng,2014-06-11 16:35:38+08:00,['0279d725cb6ace2e4f4cb64d48ef236a97f0d785'],32,45,77,565355,6,1,1,1,1055
b3191fc51cbe4f7fa442b27dd8e113159bc7804f,0,JuDasheng,2014-06-11 18:06:27+08:00,['fbaf7278940925f27e24f436d1917aee28b23d3c'],12,27,39,565394,6,,,,1056
7d5b348bd5e498dab1059682d7ef2ceab5f17573,0,Boris Aksenov,2014-06-11 16:05:14+04:00,"['89109b058c19f5f254a0de9dcb1f40fef875f3bf', '4db451466e08145641ee6173d2ed2d46fe268490']",125,1118,1243,566637,21,,,,1056
0427e06e52776b1f4e4ad299d198ee7a1384bae6,0,JuDasheng,2014-06-11 23:00:02+08:00,['b3191fc51cbe4f7fa442b27dd8e113159bc7804f'],40,42,82,566719,3,,,,1056
0a98bee214b46ed20b566a9b49c3eca2895f9fd5,1,Robert (Bobby) Evans,2014-06-11 11:07:59-05:00,"['6592b8209c49a98db15b3d6d228f488aa6c2e623', 'c89fb820861427b5be0a204bc3ab7a89d67a97de']",1337,3976,5313,572032,50,,,,1056
118b9221b492ed8b91e6633c3cfb748bc1b82790,0,Robert (Bobby) Evans,2014-06-11 11:10:04-05:00,"['0a98bee214b46ed20b566a9b49c3eca2895f9fd5', '4db451466e08145641ee6173d2ed2d46fe268490']",38,245,283,572315,11,,,,1056
d951debbf876ae300a5c2c759095d013e827f45a,0,P. Taylor Goetz,2014-06-11 16:05:31-04:00,['4db451466e08145641ee6173d2ed2d46fe268490'],10,12,22,572337,7,,,,1056
ab99b91a06732022045b38ff89b902f4645b726d,1,P. Taylor Goetz,2014-06-11 16:07:57-04:00,['d951debbf876ae300a5c2c759095d013e827f45a'],5,494,499,572836,27,,,,1056
8cc69ec348ea399de9e711fbdc8b9202f422c8c2,0,P. Taylor Goetz,2014-06-11 16:44:15-04:00,['ab99b91a06732022045b38ff89b902f4645b726d'],6,27,33,572869,1,,,,1056
bced187464bc6e7a34e61426e876928603ca83c0,0,P. Taylor Goetz,2014-06-11 17:05:42-04:00,['8cc69ec348ea399de9e711fbdc8b9202f422c8c2'],3,1,4,572873,1,,,,1056
2bb6e4eb9967e04885578a53fb6a6c687c2a2e39,0,P. Taylor Goetz,2014-06-11 17:15:36-04:00,['bced187464bc6e7a34e61426e876928603ca83c0'],13,11,24,572897,7,,,,1056
2a60e991196bcd434116841838b6a4c08ae307e8,0,P. Taylor Goetz,2014-06-11 17:15:45-04:00,['2bb6e4eb9967e04885578a53fb6a6c687c2a2e39'],8,8,16,572913,7,,,,1056
8b57097c6dc39f267bcbafb671ac977872380a8f,0,Sean Zhong,2014-06-12 08:53:17+08:00,['6946c34e9f06726b46c5fb1bf12e1f186a1a8a19'],1,1,2,572915,1,,,,1056
4d6a27f466b942cd011efb0ffd538f0c04daf047,0,JuDasheng,2014-06-12 17:46:08+08:00,['0427e06e52776b1f4e4ad299d198ee7a1384bae6'],16,55,71,572986,2,,,,1056
22a6ca9b94cf68709c16436acc7ad4ac6c7c9d7a,0,JuDasheng,2014-06-12 18:08:02+08:00,"['4d6a27f466b942cd011efb0ffd538f0c04daf047', '2a60e991196bcd434116841838b6a4c08ae307e8']",40,1122,1162,574148,36,,,,1056
2131a0aeb9074b2c83a09d7515ff8e8ae86f6eaf,1,Robert (Bobby) Evans,2014-06-12 10:58:13-05:00,['118b9221b492ed8b91e6633c3cfb748bc1b82790'],9,42,51,574199,5,,,,1057
41615b3c4b174077ac1c729af4aef32e5b79d3c5,0,Robert (Bobby) Evans,2014-06-12 10:59:46-05:00,"['2131a0aeb9074b2c83a09d7515ff8e8ae86f6eaf', '2a60e991196bcd434116841838b6a4c08ae307e8']",10,518,528,574727,28,,,,1057
bc91ed88d77e392f38c406d143e7ac37bc634564,0,Robert (Bobby) Evans,2014-06-12 11:01:35-05:00,['41615b3c4b174077ac1c729af4aef32e5b79d3c5'],0,16,16,574743,1,,,,1057
a762f1c5f99a7a9e77038399f0f14ae03b1414c7,0,Robert (Bobby) Evans,2014-06-12 12:48:51-05:00,"['bc91ed88d77e392f38c406d143e7ac37bc634564', 'cf2e8b7ee06b455a90bd4b3bfd53facef1369612']",1,2,3,574746,1,,,,1057
862f6735f2e4cf9734b395385609bec8f0b6041f,0,Robert (Bobby) Evans,2014-06-12 14:53:13-05:00,"['2a60e991196bcd434116841838b6a4c08ae307e8', '2456f0aa8c3834ab562f32d645e2835402075ff2']",1718,1947,3665,578411,23,,,,1057
0826b93323ccc33b97b45dc82dae2b7c10bfab5c,0,Robert (Bobby) Evans,2014-06-12 14:53:45-05:00,['862f6735f2e4cf9734b395385609bec8f0b6041f'],1,1,2,578413,1,,,,1057
f1bf9cdb5c7fd7445948f7f3097dbe8ced27d3c0,0,P. Taylor Goetz,2014-06-12 16:37:15-04:00,"['0826b93323ccc33b97b45dc82dae2b7c10bfab5c', '8b57097c6dc39f267bcbafb671ac977872380a8f']",21,210,231,578644,3,,,,1057
405dabbc8e67f72a8c04e95c0b562dc2826c01a1,1,P. Taylor Goetz,2014-06-12 16:55:43-04:00,['f1bf9cdb5c7fd7445948f7f3097dbe8ced27d3c0'],3,3,6,578650,1,,,,1057
5299531739b6661a7ce8d3aafb486d6dde09bbf6,0,P. Taylor Goetz,2014-06-12 17:00:30-04:00,['405dabbc8e67f72a8c04e95c0b562dc2826c01a1'],4,2,6,578656,2,,,,1057
2bad66eae90651df7424b389f099e62fe8b9ec5f,0,P. Taylor Goetz,2014-06-12 17:02:36-04:00,['5299531739b6661a7ce8d3aafb486d6dde09bbf6'],7,7,14,578670,7,,,,1057
92e3a5742374a3a7c3aae20cbeda32ce7b033526,1,Robert (Bobby) Evans,2014-06-12 16:09:57-05:00,"['a762f1c5f99a7a9e77038399f0f14ae03b1414c7', '0826b93323ccc33b97b45dc82dae2b7c10bfab5c']",1681,1910,3591,582261,23,,,,1057
00cc9c6af6022af246e4bc409f6ffcc85e88ada4,0,Robert (Bobby) Evans,2014-06-12 16:37:05-05:00,"['0826b93323ccc33b97b45dc82dae2b7c10bfab5c', '47dba860094bbe381e0bd231a43e2501a98a855b']",0,11,11,582272,1,,,,1057
b37b5c82ed6fd6a43c701e75260f5cdf343f5f43,0,Robert (Bobby) Evans,2014-06-12 16:42:50-05:00,['00cc9c6af6022af246e4bc409f6ffcc85e88ada4'],0,1,1,582273,1,,,,1057
61a4eac59e6af57ab9600663b537c120c91c30b6,0,Robert (Bobby) Evans,2014-06-12 16:44:09-05:00,"['b37b5c82ed6fd6a43c701e75260f5cdf343f5f43', '2bad66eae90651df7424b389f099e62fe8b9ec5f']",28,218,246,582519,10,,,,1057
12f79bb1c51f84f29a18d3a80bc5d59cd498df35,0,P. Taylor Goetz,2014-06-12 20:08:48-04:00,['2bad66eae90651df7424b389f099e62fe8b9ec5f'],8,8,16,582535,7,,,,1057
09e50c10aa08fef6f6a1a803d636b8b1e4c690c1,0,P. Taylor Goetz,2014-06-12 20:44:11-04:00,"['12f79bb1c51f84f29a18d3a80bc5d59cd498df35', '61a4eac59e6af57ab9600663b537c120c91c30b6']",0,15,15,582550,2,,,,1057
4a653079ef2a0b4baf644083118404a3506a5e31,0,P. Taylor Goetz,2014-06-12 20:44:57-04:00,['09e50c10aa08fef6f6a1a803d636b8b1e4c690c1'],8,8,16,582566,7,,,,1057
4650914ddd56d45ff3af0445c959d74d69019e5e,0,P. Taylor Goetz,2014-06-12 20:45:36-04:00,['4a653079ef2a0b4baf644083118404a3506a5e31'],7,7,14,582580,7,,,,1057
18b3db976c0f5d9e1b66ef468de83cbff7959c39,0,P. Taylor Goetz,2014-06-12 20:47:16-04:00,['4650914ddd56d45ff3af0445c959d74d69019e5e'],4,1,5,582585,1,,,,1057
f037b41c82e03017b5f894156096f9f96c59f600,0,P. Taylor Goetz,2014-06-12 20:51:37-04:00,['18b3db976c0f5d9e1b66ef468de83cbff7959c39'],8,8,16,582601,7,,,,1057
d448e34812e5cbffe848ce88189a05df1be3226e,0,P. Taylor Goetz,2014-06-12 20:52:30-04:00,['f037b41c82e03017b5f894156096f9f96c59f600'],8,8,16,582617,7,,,,1057
a4b26af6044b3774fec6224a74b8b3f2b994d535,0,JuDasheng,2014-06-13 11:49:42+08:00,['22a6ca9b94cf68709c16436acc7ad4ac6c7c9d7a'],549,72,621,583238,17,0,0,0,1057
7ce0bff2ca63c830e148385b4cce231152843d58,0,JuDasheng,2014-06-13 12:12:54+08:00,['2a60e991196bcd434116841838b6a4c08ae307e8'],3,5,8,583246,1,1,1,1,1057
62f854a81bc643181bc38b1e3dc6d1164a94d874,0,JuDasheng,2014-06-13 15:30:09+08:00,"['a4b26af6044b3774fec6224a74b8b3f2b994d535', 'd448e34812e5cbffe848ce88189a05df1be3226e']",1739,2167,3906,587152,27,,,,1057
57851bb6be4caec950541bcb1f01529224e52af4,0,P. Taylor Goetz,2014-06-13 14:13:50-04:00,['d448e34812e5cbffe848ce88189a05df1be3226e'],1,1,2,587154,1,,,,1057
87a16c1a885c6381a3bc1d532e5105660196a2cb,0,P. Taylor Goetz,2014-06-13 14:37:45-04:00,['d448e34812e5cbffe848ce88189a05df1be3226e'],7,7,14,587168,7,,,,1057
31a1592f743d0efb5d393374d01e3eda9145cfff,0,P. Taylor Goetz,2014-06-13 15:12:24-04:00,"['87a16c1a885c6381a3bc1d532e5105660196a2cb', '57851bb6be4caec950541bcb1f01529224e52af4']",1,1,2,587170,1,,,,1057
24d4a14de310cbbfebdc4a50d8cc9d86f9943087,0,P. Taylor Goetz,2014-06-13 16:21:51-04:00,['31a1592f743d0efb5d393374d01e3eda9145cfff'],8,8,16,587186,7,,,,1057
ecac64ff0dc4278440f0b35e8f55356fa0bc9c42,0,P. Taylor Goetz,2014-06-13 16:22:00-04:00,['24d4a14de310cbbfebdc4a50d8cc9d86f9943087'],8,8,16,587202,7,,,,1057
2c2570fcd707b71d69db81736ba703707cee3ae7,1,Parth Brahmbhatt,2014-06-16 14:06:05-07:00,['ecac64ff0dc4278440f0b35e8f55356fa0bc9c42'],29,63,92,587294,9,,,,1057
de8855d1dd6fbbfe431c33d49013a19881548732,0,Parth Brahmbhatt,2014-06-16 15:21:04-07:00,['2c2570fcd707b71d69db81736ba703707cee3ae7'],3,4,7,587301,1,,,,1057
ab7784e49d251ca4da967c6ec6bc340cc7f940aa,0,Kishor Patil,2014-06-17 15:19:00+00:00,['92e3a5742374a3a7c3aae20cbeda32ce7b033526'],5,51,56,587357,2,0,0,0,1057
d1ba4fc4acdadd5e5e138395bdc5892dfdb88bff,1,Derek Dagit,2014-06-17 10:56:51-05:00,['92e3a5742374a3a7c3aae20cbeda32ce7b033526'],2,13,15,587372,1,,,,1057
cca35276d2b8e38f5a89c6ecc4e0ce7ef04a14c2,1,Parth Brahmbhatt,2014-06-17 09:42:55-07:00,['de8855d1dd6fbbfe431c33d49013a19881548732'],9,4,13,587385,2,,,,1057
87cdbf5fdf5bfb49b983604542283f05123d0d51,0,Robert (Bobby) Evans,2014-06-17 13:32:18-05:00,"['ab7784e49d251ca4da967c6ec6bc340cc7f940aa', 'd1ba4fc4acdadd5e5e138395bdc5892dfdb88bff']",2,13,15,587400,1,,,,1057
d664a40be9fe22a737cf79527644a6eb91678919,0,nathanmarz,2014-06-17 13:55:42-07:00,['ecac64ff0dc4278440f0b35e8f55356fa0bc9c42'],3,3,6,587406,1,,,,1057
718255a9201193ca7bc3e43fa191a09949bc482e,0,Kyle Nusbaum,2014-06-17 21:36:01+00:00,['ecac64ff0dc4278440f0b35e8f55356fa0bc9c42'],2,24,26,587432,4,1,1,1,1057
0c43a37f000298af17a11b6fe6e78dbb35e27ee8,1,Parth Brahmbhatt,2014-06-17 15:13:36-07:00,['ecac64ff0dc4278440f0b35e8f55356fa0bc9c42'],10,52,62,587494,3,0.909090909,0.954545455,1,1057
57b5e1a399373449f2fd50f4e503e2a8f91a700a,0,Kyle Nusbaum,2014-06-17 22:24:22+00:00,"['718255a9201193ca7bc3e43fa191a09949bc482e', 'd664a40be9fe22a737cf79527644a6eb91678919']",3,3,6,587500,1,,,,1057
e1735d2760a7e66d0459968d066cfafb0a9ba1cf,0,Kyle Nusbaum,2014-06-17 23:00:43+00:00,['57b5e1a399373449f2fd50f4e503e2a8f91a700a'],1,20,21,587521,3,1,1,1,1057
f11be28f3ec87cb5824ed0dfe2b25076bbebd640,0,Derek Dagit,2014-06-17 19:40:16-05:00,['d664a40be9fe22a737cf79527644a6eb91678919'],44,163,207,587728,4,1,1,1,1058
ecd0adb812defd0f11f77b3d2e046a0adf787079,0,dashengju,2014-06-18 13:52:27+08:00,['d448e34812e5cbffe848ce88189a05df1be3226e'],4,519,523,588251,16,0.654545455,0.654545455,0.878787879,1067
e33023c7e7f5ec10cbc2d5eade7d68102bfbb317,0,JuDasheng,2014-06-18 14:29:31+08:00,"['62f854a81bc643181bc38b1e3dc6d1164a94d874', 'ecd0adb812defd0f11f77b3d2e046a0adf787079']",4,225,229,588480,5,,,,1067
4ec75dfac6fd9b93f76fe58b40feff7ffe80cf84,1,knowak,2014-06-18 10:40:32+02:00,['24d4a14de310cbbfebdc4a50d8cc9d86f9943087'],1,5,6,588486,1,,,,1067
a821d5cb2376625c28492c2d9461dd6382b752cd,0,Robert (Bobby) Evans,2014-06-18 12:03:02-05:00,['d664a40be9fe22a737cf79527644a6eb91678919'],0,24,24,588510,1,,,,1067
d00f966098eb1e422d9507334c8d1d475112c9ac,0,Kyle Nusbaum,2014-06-18 17:57:00+00:00,['e1735d2760a7e66d0459968d066cfafb0a9ba1cf'],6,39,45,588555,1,,,,1067
550a2596f11aff07b893c24b3737c0521ffcd206,1,Kishor Patil,2014-06-18 21:43:10+00:00,['a821d5cb2376625c28492c2d9461dd6382b752cd'],34,296,330,588885,11,0,0.01734104,0.988439306,1067
ea946d04dcb6df8e65dbf16500a361eaaba13432,0,Kishor Patil,2014-06-18 23:58:33+00:00,['87cdbf5fdf5bfb49b983604542283f05123d0d51'],34,498,532,589417,22,0,0.01734104,0.988439306,1067
d854ecca6a259020aeb2a2acf0bba6f1089531aa,0,JuDasheng,2014-06-19 10:43:18+08:00,['e33023c7e7f5ec10cbc2d5eade7d68102bfbb317'],2,2,4,589421,2,,,,1067
79089ad0da80e38eb36b7ea91be8b43795dc4efb,0,Robert (Bobby) Evans,2014-06-19 16:04:02-05:00,"['87cdbf5fdf5bfb49b983604542283f05123d0d51', '24d4a14de310cbbfebdc4a50d8cc9d86f9943087']",33,237,270,589691,12,,,,1067
1a57aa8fd0e8d53114da9435a61f319014dbb428,0,Derek Dagit,2014-06-19 16:37:01-05:00,"['a821d5cb2376625c28492c2d9461dd6382b752cd', '2d64f7e80585281e64514d1be4f5efae83e7a9a4']",0,4,4,589695,1,,,,1067
093ce720ec4b333c40b1cad3a0a182c6aaae59d3,0,Derek Dagit,2014-06-19 16:41:26-05:00,['1a57aa8fd0e8d53114da9435a61f319014dbb428'],0,4,4,589699,2,,,,1067
51a75fbb5e238e330a5fbc99360520f29b822059,0,Derek Dagit,2014-06-19 16:53:40-05:00,"['093ce720ec4b333c40b1cad3a0a182c6aaae59d3', 'c7b223824df12858f3029010d655b72f13d777fb']",1,7,8,589707,1,,,,1067
5c82b9fed13e889611f5c928fbb73f862bef20a1,0,Derek Dagit,2014-06-19 16:55:12-05:00,['51a75fbb5e238e330a5fbc99360520f29b822059'],0,2,2,589709,2,,,,1067
4bab2b857d0d481d1859336adeb87d7245c6e1c3,1,dashengju,2014-06-20 10:34:38+08:00,['ecd0adb812defd0f11f77b3d2e046a0adf787079'],84,84,168,589877,2,0,0,0,1067
b004e064706dc2ee2c90c54325b9f770c6c116ef,0,dashengju,2014-06-20 10:35:07+08:00,"['4bab2b857d0d481d1859336adeb87d7245c6e1c3', 'd854ecca6a259020aeb2a2acf0bba6f1089531aa']",2,2,4,589881,2,,,,1067
133de77b27f003b9abd533a2bbd3b5c5961b7e77,1,Robert (Bobby) Evans,2014-06-20 07:53:04-05:00,['5c82b9fed13e889611f5c928fbb73f862bef20a1'],0,79,79,589960,1,,,,1068
84d297a23c05fef5164029bd4b697071aa349f9c,1,Robert (Bobby) Evans,2014-06-20 07:59:29-05:00,['133de77b27f003b9abd533a2bbd3b5c5961b7e77'],51,63,114,590074,1,,,,1068
f3646c42ff4bcbcf685357d31326e5a62ad241d4,0,Parth Brahmbhatt,2014-06-20 12:28:51-07:00,['cca35276d2b8e38f5a89c6ecc4e0ce7ef04a14c2'],6,5,11,590085,1,,,,1068
ff2d1a198a0da10c8a0bf21de3410e38f9db8773,0,Kishor Patil,2014-06-20 19:53:12+00:00,['550a2596f11aff07b893c24b3737c0521ffcd206'],31,26,57,590142,4,,,,1068
1ec738edd08551ad55e1369473ceb6f7c750bff0,0,Kishor Patil,2014-06-20 20:10:07+00:00,['ff2d1a198a0da10c8a0bf21de3410e38f9db8773'],1,1,2,590144,1,,,,1068
f20df7d52d52abc9bc03a0cf45388241927cff5a,0,Kishor Patil,2014-06-20 20:35:16+00:00,['ea946d04dcb6df8e65dbf16500a361eaaba13432'],31,25,56,590200,4,,,,1068
7341f70d19a70494ea618c4a613cf12772c25642,0,Kishor Patil,2014-06-20 21:54:04+00:00,['1ec738edd08551ad55e1369473ceb6f7c750bff0'],6,6,12,590212,2,,,,1068
c545b9d638067c0ae4528e16f14e67c56e0dd47e,0,Kishor Patil,2014-06-20 23:01:00+00:00,['f20df7d52d52abc9bc03a0cf45388241927cff5a'],3,3,6,590218,2,,,,1068
fce7b89b5d14ee2103adbb9a98fdcf5723359a56,0,Kishor Patil,2014-06-20 23:10:02+00:00,['7341f70d19a70494ea618c4a613cf12772c25642'],4,4,8,590226,1,,,,1068
5ca09df570a186aaf99a4e33765d75f976a44556,1,Muneyuki Noguchi,2014-06-22 21:30:45+09:00,['5c82b9fed13e889611f5c928fbb73f862bef20a1'],23,36,59,590285,1,,,,1068
ae816ac7b13e1d41a54ca82854553cfabd6f94a5,0,Muneyuki Noguchi,2014-06-22 23:39:44+09:00,['5ca09df570a186aaf99a4e33765d75f976a44556'],2,2,4,590289,1,,,,1068
a90a285f768844eb48c96b2de60a0f570230c001,0,Muneyuki Noguchi,2014-06-22 23:39:47+09:00,['ae816ac7b13e1d41a54ca82854553cfabd6f94a5'],1,1,2,590291,1,,,,1068
e08fb0663fab9d24bd8a4e74cd41aef94e5cb7ac,1,Michael G. Noll,2014-06-23 11:19:36+02:00,['5c82b9fed13e889611f5c928fbb73f862bef20a1'],0,22,22,590313,1,,,,1068
878e651a1d89935e44cf11800005578523b2a97c,0,Robert (Bobby) Evans,2014-06-23 09:15:53-05:00,"['e08fb0663fab9d24bd8a4e74cd41aef94e5cb7ac', 'fce7b89b5d14ee2103adbb9a98fdcf5723359a56']",30,287,317,590630,10,,,,1068
79f258ec6d3e85f190a7e4861ff6cefb1ce905f4,0,Robert (Bobby) Evans,2014-06-23 09:16:43-05:00,['878e651a1d89935e44cf11800005578523b2a97c'],0,1,1,590631,1,,,,1068
d7c1d1d0a909079a370ed35aaac91668eef33a22,0,Robert (Bobby) Evans,2014-06-23 09:31:41-05:00,"['79089ad0da80e38eb36b7ea91be8b43795dc4efb', 'c545b9d638067c0ae4528e16f14e67c56e0dd47e']",31,489,520,591151,21,,,,1068
65aee65af54dd29434af8f5ee403233b597561b6,0,Robert (Bobby) Evans,2014-06-23 10:18:38-05:00,"['d7c1d1d0a909079a370ed35aaac91668eef33a22', '79f258ec6d3e85f190a7e4861ff6cefb1ce905f4']",13,75,88,591239,13,,,,1068
f0e6873fdab6ff3a2f4d7ea7867f54d8c330c819,0,Kishor Patil,2014-06-23 15:46:45+00:00,['79f258ec6d3e85f190a7e4861ff6cefb1ce905f4'],15,41,56,591295,5,,,,1068
357fd09dff8eec1f224d7f00f5344931ec2b64df,0,Kishor Patil,2014-06-23 16:13:34+00:00,['65aee65af54dd29434af8f5ee403233b597561b6'],15,41,56,591351,5,,,,1068
097b3abd3b501c022238c1d8729211d2bd5944da,0,Derek Dagit,2014-06-23 14:07:18-05:00,"['79f258ec6d3e85f190a7e4861ff6cefb1ce905f4', 'd00f966098eb1e422d9507334c8d1d475112c9ac']",9,83,92,591443,5,,,,1068
9b6c0f65643957845c87649b9eeaf118218abc2b,0,Derek Dagit,2014-06-23 14:33:06-05:00,['097b3abd3b501c022238c1d8729211d2bd5944da'],0,1,1,591444,1,,,,1068
d79b423691100c05c0cb2906da458c85d3feaa7b,0,Adrian Petrescu,2014-06-23 18:00:50-04:00,['9b6c0f65643957845c87649b9eeaf118218abc2b'],1,1,2,591446,1,,,,1068
1613a978cecf01c37b5d131eccb4dcc43966d058,1,Sriharsha Chintalapani,2014-06-23 16:05:41-07:00,['9b6c0f65643957845c87649b9eeaf118218abc2b'],0,513,513,591959,1,,,,1069
a80f95e45c202fb14454f4330730970ec75d13fa,0,Michael G. Noll,2014-06-24 16:46:43+02:00,['9b6c0f65643957845c87649b9eeaf118218abc2b'],4,66,70,592029,2,0.166666667,1,0.833333333,1069
4c70e407c33b8cb5f770f22296851c6b1ff6d7c9,1,Michael G. Noll,2014-06-24 17:02:11+02:00,['a80f95e45c202fb14454f4330730970ec75d13fa'],1,26,27,592056,1,,,,1069
31c786c6634052d89ca62c57c428d95124a3a465,0,Kishor Patil,2014-06-24 18:51:01+00:00,['4c70e407c33b8cb5f770f22296851c6b1ff6d7c9'],7,19,26,592082,2,,,,1069
28c168fd7d0272f88d586f6f572eab937b874f22,0,Kishor Patil,2014-06-24 19:12:56+00:00,['65aee65af54dd29434af8f5ee403233b597561b6'],7,19,26,592108,2,,,,1069
85569a6d5cb1262cc495f3f16c7a3af1ed50b41b,0,Robert (Bobby) Evans,2014-06-24 15:19:07-05:00,"['4c70e407c33b8cb5f770f22296851c6b1ff6d7c9', '4ec75dfac6fd9b93f76fe58b40feff7ffe80cf84']",1,5,6,592114,1,,,,1069
97db22a6ed36f19b3ea048d4531d7a802d576a8d,0,Robert (Bobby) Evans,2014-06-24 15:21:41-05:00,['85569a6d5cb1262cc495f3f16c7a3af1ed50b41b'],0,2,2,592116,2,,,,1069
c95c7193e7e24b08016dd68793e19ecad580d118,0,Sriharsha Chintalapani,2014-06-24 18:38:16-07:00,['97db22a6ed36f19b3ea048d4531d7a802d576a8d'],11,20,31,592147,2,,,,1069
c7550881325dab70b56919c56ad6218802c45e47,0,Robert (Bobby) Evans,2014-06-25 08:50:10-05:00,"['97db22a6ed36f19b3ea048d4531d7a802d576a8d', 'f3646c42ff4bcbcf685357d31326e5a62ad241d4']",33,62,95,592242,9,,,,1069
8f2e749333f5a3cd810349ce799c68bc22fd0c43,0,Robert (Bobby) Evans,2014-06-25 08:57:41-05:00,['c7550881325dab70b56919c56ad6218802c45e47'],0,2,2,592244,2,,,,1069
0db27d5b323e8476a989727dbd5cd99444cce56c,0,Kishor Patil,2014-06-25 14:59:17+00:00,['4c70e407c33b8cb5f770f22296851c6b1ff6d7c9'],5,107,112,592356,3,,,,1069
cbb0b8a2970a2094320915934113e4c06a559222,1,Kishor Patil,2014-06-25 15:18:15+00:00,['0db27d5b323e8476a989727dbd5cd99444cce56c'],7,10,17,592373,3,,,,1069
8325186b731259c17d4b06aa2c288ffc4f6dc59b,0,Kishor Patil,2014-06-25 15:32:17+00:00,['357fd09dff8eec1f224d7f00f5344931ec2b64df'],19,7,26,592399,2,,,,1069
20ac58bbbcde6022068dce18ba69c87c59f81476,0,Kishor Patil,2014-06-25 15:34:11+00:00,['f0e6873fdab6ff3a2f4d7ea7867f54d8c330c819'],19,7,26,592425,2,,,,1069
e5efcf506856c472ae7e5e36578862d2c8dd4906,1,Kishor Patil,2014-06-25 23:49:08+00:00,['20ac58bbbcde6022068dce18ba69c87c59f81476'],16,30,46,592471,5,,,,1069
7bb8ec6d8068fe2eeec65085bfa0140aca0fb0a9,1,Kishor Patil,2014-06-26 00:13:03+00:00,['8325186b731259c17d4b06aa2c288ffc4f6dc59b'],16,30,46,592517,5,,,,1069
d38e7968388cb49ec0f393d54a885ce2bbb5e1cd,0,Robert (Bobby) Evans,2014-06-26 10:45:10-05:00,['84d297a23c05fef5164029bd4b697071aa349f9c'],2,3,5,592522,1,,,,1069
99b914ce0a9cc8185dbcf721eb428568c121cfb3,0,Gabriel Ciuloaica,2014-06-26 18:45:29+03:00,['8f2e749333f5a3cd810349ce799c68bc22fd0c43'],4,4,8,592530,1,,,,1069
7cdf8f05689a58656bb16b14c29b5998f042d8e0,0,Robert (Bobby) Evans,2014-06-26 10:47:46-05:00,['d38e7968388cb49ec0f393d54a885ce2bbb5e1cd'],2,1,3,592533,1,,,,1069
afdc918cc17e583a6c4f596c18d2a532aedfacc3,0,Robert (Bobby) Evans,2014-06-26 10:48:36-05:00,['7cdf8f05689a58656bb16b14c29b5998f042d8e0'],1,1,2,592535,1,,,,1069
ed3d42d1afa2759b667dff3e4bd77d2dce79805e,0,P. Taylor Goetz,2014-06-26 15:19:50-04:00,['1154884438cae5eeb26c4213f8ad80c640bebdff'],2,2,4,592539,1,,,,1069
3509e241dfdb9c91de5dae382218b95bb002e814,0,P. Taylor Goetz,2014-06-26 15:20:32-04:00,['ed3d42d1afa2759b667dff3e4bd77d2dce79805e'],8,8,16,592555,4,,,,1069
f227830fdbe14290c6870835b3aab6f701dbdddb,1,P. Taylor Goetz,2014-06-26 16:06:50-04:00,['3509e241dfdb9c91de5dae382218b95bb002e814'],54,73,127,592682,5,0,0.875,0.875,1069
e9ca55cdb4c60597f6560191dfac55203580ccb6,0,Robert (Bobby) Evans,2014-06-26 15:56:06-05:00,"['8f2e749333f5a3cd810349ce799c68bc22fd0c43', 'c95c7193e7e24b08016dd68793e19ecad580d118']",11,20,31,592713,2,,,,1069
6f57464c539f2a667389dffde0d2243796022c76,0,Robert (Bobby) Evans,2014-06-26 15:58:12-05:00,['e9ca55cdb4c60597f6560191dfac55203580ccb6'],0,1,1,592714,1,,,,1069
be5eae3bcc07cfbaf49c19c57da42dac1351a3e3,0,P. Taylor Goetz,2014-06-26 17:04:02-04:00,['f227830fdbe14290c6870835b3aab6f701dbdddb'],7,152,159,592873,5,0.53125,0.53125,0.53125,1071
e3c93445eb112c90ad3d4ca961416a8b26c43a3c,0,Robert (Bobby) Evans,2014-06-26 16:07:42-05:00,"['6f57464c539f2a667389dffde0d2243796022c76', 'a90a285f768844eb48c96b2de60a0f570230c001']",22,35,57,592930,1,,,,1071
b659979a1526c4eb1461981de9f8f512317d3eba,0,Robert (Bobby) Evans,2014-06-26 16:08:59-05:00,['e3c93445eb112c90ad3d4ca961416a8b26c43a3c'],0,1,1,592931,1,,,,1071
b27b8c4fa015f19db6a087c3a565a703b39dc517,1,Kyle Nusbaum,2014-06-26 21:13:56+00:00,['8f2e749333f5a3cd810349ce799c68bc22fd0c43'],10,93,103,593034,4,,,,1071
f3112fa76e98038da83170513a476499dde0bb41,1,Sriharsha Chintalapani,2014-06-26 15:05:21-07:00,['65aee65af54dd29434af8f5ee403233b597561b6'],25,702,727,593761,7,0.548275862,0.603448276,0.879310345,1074
4295b9af8f2d550bd85bcebf72b9d3525a977adc,1,Sriharsha Chintalapani,2014-06-26 17:33:38-07:00,['1613a978cecf01c37b5d131eccb4dcc43966d058'],65,98,163,593924,1,,,,1074
41e5b91a71a609818c8ca8b0291ea292710dd468,0,Kyle Nusbaum,2014-06-27 17:52:52+00:00,['b27b8c4fa015f19db6a087c3a565a703b39dc517'],3,20,23,593947,1,,,,1074
516b33317d49c8687984a77de0764f0b25333e22,0,Kyle Nusbaum,2014-06-27 17:54:05+00:00,"['41e5b91a71a609818c8ca8b0291ea292710dd468', 'b659979a1526c4eb1461981de9f8f512317d3eba']",33,57,90,594037,4,,,,1074
310e09e1a594ef44785e7aeb4b2fd5e4299a303b,1,Kyle Nusbaum,2014-06-27 17:56:57+00:00,['516b33317d49c8687984a77de0764f0b25333e22'],20,8,28,594065,1,,,,1074
6d560cb6b7c1b120f30d026a50042c768ab90692,0,Kyle Nusbaum,2014-06-27 18:29:03+00:00,['310e09e1a594ef44785e7aeb4b2fd5e4299a303b'],9,2,11,594076,2,,,,1074
f4e6c1933ff3f2e8ded52b9ceed389362ad41796,0,Kyle Nusbaum,2014-06-27 18:31:07+00:00,['6d560cb6b7c1b120f30d026a50042c768ab90692'],2,0,2,594078,1,,,,1074
041b11c1966e3bb0b29ba31d366315b8aced19d7,0,Robert (Bobby) Evans,2014-06-27 18:48:30+00:00,['b659979a1526c4eb1461981de9f8f512317d3eba'],2,4,6,594084,1,,,,1074
81cf56edd053ae6e392a81577e0c4cb7a305cc36,1,jiahong.ljh,2014-06-30 18:06:38+08:00,['edcaf71b304cc5196eec48035b06d15aaa8df433'],210,220,430,594514,6,1,1,1,1076
974f0f377a371db6a673c59e13a9640fbdd9d92a,0,Stephen Elliott,2014-06-30 11:25:49+01:00,['b659979a1526c4eb1461981de9f8f512317d3eba'],0,3,3,594517,1,1,1,1,1076
9c186aaa4d6feb2648b9d7f519e46bfd9bb1b070,1,shelld0h,2014-06-30 19:54:19+08:00,['b659979a1526c4eb1461981de9f8f512317d3eba'],7,18,25,594542,5,1,0.884955752,0.920353982,1077
c89712785c5c0e21c0cf47bf263809b64c3f2b3e,0,shelld0h,2014-06-30 20:14:21+08:00,['b659979a1526c4eb1461981de9f8f512317d3eba'],2,2,4,594546,2,,,,1077
b7d808485e331d4d0088ce4ec6bb976aaa5b9b77,0,Robert (Bobby) Evans,2014-06-30 11:51:06-05:00,['afdc918cc17e583a6c4f596c18d2a532aedfacc3'],3,3,6,594552,1,,,,1077
6a75fbb5580592b158086e40bac153402495ceaa,0,Robert (Bobby) Evans,2014-06-30 14:25:22-05:00,"['b659979a1526c4eb1461981de9f8f512317d3eba', '52d2f2f9160f90a97de2d49a3827bd8c103fb14e']",4,14,18,594570,2,,,,1077
66b30112d0be4b91f1e7bcc8289fb8ed5115e60a,0,Robert (Bobby) Evans,2014-06-30 14:26:34-05:00,['6a75fbb5580592b158086e40bac153402495ceaa'],0,1,1,594571,1,,,,1077
4749ac682c18b375011a691dc69763a26712af3b,0,Robert (Bobby) Evans,2014-06-30 14:34:56-05:00,"['66b30112d0be4b91f1e7bcc8289fb8ed5115e60a', '31c786c6634052d89ca62c57c428d95124a3a465']",7,19,26,594597,2,,,,1077
85f87c4c4cfee208dae48f057142eb393a37d8ca,0,Robert (Bobby) Evans,2014-06-30 14:35:24-05:00,['4749ac682c18b375011a691dc69763a26712af3b'],0,1,1,594598,1,,,,1077
49da9ad0d911c26ec6dfaa6444c9a31acf268fbc,0,Robert (Bobby) Evans,2014-06-30 15:19:20-05:00,"['85f87c4c4cfee208dae48f057142eb393a37d8ca', 'f11be28f3ec87cb5824ed0dfe2b25076bbebd640']",44,163,207,594805,4,,,,1077
cc910b4e19e71cc17b3b45eba005a7b764626e22,0,Robert (Bobby) Evans,2014-06-30 15:19:53-05:00,['49da9ad0d911c26ec6dfaa6444c9a31acf268fbc'],0,1,1,594806,1,,,,1077
8fe5c77456fe3ea6a1367ca2d806e1c8b0baed3b,0,Robert (Bobby) Evans,2014-06-30 15:26:50-05:00,"['cc910b4e19e71cc17b3b45eba005a7b764626e22', 'd79b423691100c05c0cb2906da458c85d3feaa7b']",1,1,2,594808,1,,,,1077
5f2d05a4304716af857b157a3278ffaf502b2000,0,Robert (Bobby) Evans,2014-06-30 15:29:42-05:00,['8fe5c77456fe3ea6a1367ca2d806e1c8b0baed3b'],0,2,2,594810,2,,,,1077
afbcfcf82c8ffd305378d0312b4c28ea9c09300a,0,Robert (Bobby) Evans,2014-06-30 15:39:15-05:00,"['5f2d05a4304716af857b157a3278ffaf502b2000', '0c43a37f000298af17a11b6fe6e78dbb35e27ee8']",10,52,62,594872,3,,,,1077
004c05ebf9ec23426e5816eff9840da3172863d3,0,Robert (Bobby) Evans,2014-06-30 15:39:46-05:00,['afbcfcf82c8ffd305378d0312b4c28ea9c09300a'],0,1,1,594873,1,,,,1077
648e54a18f3e41cd93ac1927021f79311ca3186b,0,Robert (Bobby) Evans,2014-06-30 15:49:36-05:00,"['004c05ebf9ec23426e5816eff9840da3172863d3', '4295b9af8f2d550bd85bcebf72b9d3525a977adc']",0,546,546,595419,1,,,,1077
18a0721d8e6702d96d936fa56402aee6009c8240,0,Robert (Bobby) Evans,2014-06-30 15:50:28-05:00,['648e54a18f3e41cd93ac1927021f79311ca3186b'],0,1,1,595420,1,,,,1077
71fed1dc0aa87931e0ebac58d565e92bb47da411,1,Parth Brahmbhatt,2014-06-30 14:23:12-07:00,['20c4565dbdbbb916d4143a9262c0869c566221bc'],41,581,622,596042,13,0.576923077,0.830769231,0.961538462,1088
8f3ed521e17cdd544d89b529130d102eb43fa11f,0,Jungtaek Lim,2014-07-01 21:24:31+09:00,['18a0721d8e6702d96d936fa56402aee6009c8240'],4,5,9,596051,1,1,0.416666667,0.361111111,1088
573c42a64885dac9a6a0d4c69a754500b607a8f1,1,JuDasheng,2014-07-01 22:30:06+08:00,['b004e064706dc2ee2c90c54325b9f770c6c116ef'],1,4,5,596056,1,,,,1088
f6b826b91d2e299e3286dac78c4866cbded165ce,1,Kyle Nusbaum,2014-07-01 16:06:13+00:00,['f4e6c1933ff3f2e8ded52b9ceed389362ad41796'],11,9,20,596076,3,,,,1088
ff345c1fa9dcbe55e96037bec3b59d06c3f64cd4,0,Robert (Bobby) Evans,2014-07-01 15:23:36-05:00,"['18a0721d8e6702d96d936fa56402aee6009c8240', '573c42a64885dac9a6a0d4c69a754500b607a8f1']",70,588,658,596734,17,,,,1088
8da9572ac7d12e843ce8579c9e5629a528a3d0ea,0,Robert (Bobby) Evans,2014-07-01 15:38:41-05:00,['ff345c1fa9dcbe55e96037bec3b59d06c3f64cd4'],0,2,2,596736,2,,,,1088
5c033ca07005698cd165bcc22bad0d729e71b252,1,Parth Brahmbhatt,2014-07-01 20:44:45-07:00,['71fed1dc0aa87931e0ebac58d565e92bb47da411'],128,595,723,597459,13,0.868421053,1,0.673684211,1092
b68c33a31927c45f52b61007ba155d89590bf26c,1,jiahong.ljh,2014-07-02 15:55:21+08:00,['81cf56edd053ae6e392a81577e0c4cb7a305cc36'],47,84,131,597590,3,0,0.65625,0.90625,1092
f8c9995ac7f1d5fcdd19b3d0f67f0abd111f320e,0,dashengju,2014-07-02 23:32:30+08:00,['8da9572ac7d12e843ce8579c9e5629a528a3d0ea'],0,4,4,597594,1,0,0,0,1092
d2be73b06beab538b34d248cb83c494ae7a33e4f,0,Anya Tchernishov,2014-07-03 18:06:44+03:00,['e08fb0663fab9d24bd8a4e74cd41aef94e5cb7ac'],0,603,603,598197,5,0.940063091,1,0.96214511,1097
b47932d899917a8a2d1a5d9a671a448b147a7432,0,Boris Aksenov,2014-07-05 16:02:32+04:00,"['7d5b348bd5e498dab1059682d7ef2ceab5f17573', '8da9572ac7d12e843ce8579c9e5629a528a3d0ea']",1991,4731,6722,604919,95,,,,1097
7d50fbe0a2191b634dc71cd9e7c35d5af24bf063,0,Boris Aksenov,2014-07-05 16:04:09+04:00,['b47932d899917a8a2d1a5d9a671a448b147a7432'],5,2,7,604926,1,,,,1097
8c4684cfca25aa02e815497ad489193bd3d3d495,0,Boris Aksenov,2014-07-05 16:13:45+04:00,['7d50fbe0a2191b634dc71cd9e7c35d5af24bf063'],14,12,26,604952,2,0,0,0,1097
92edcef1902a5376ce0ea5b4fff189ad421cfe38,0,Dave Parfitt,2014-07-07 11:22:52-04:00,['8da9572ac7d12e843ce8579c9e5629a528a3d0ea'],1,1,2,604954,1,,,,1097
4bcda70018fb0977f6f2d96b17a6f948ce1d0344,1,Derek Dagit,2014-07-07 12:04:04-05:00,['b7d808485e331d4d0088ce4ec6bb976aaa5b9b77'],22,28,50,605004,1,,,,1097
3c6930dfe4447b6077916b9f9a07b062141b5305,0,Parth Brahmbhatt,2014-07-07 11:36:49-07:00,['65aee65af54dd29434af8f5ee403233b597561b6'],0,216,216,605220,2,0.27826087,1,1,1098
00e80e9a132764d4b73737d2f7a52282e5247856,0,Parth Brahmbhatt,2014-07-07 11:43:59-07:00,"['3c6930dfe4447b6077916b9f9a07b062141b5305', '28c168fd7d0272f88d586f6f572eab937b874f22']",7,19,26,605246,2,,,,1098
e04c37356c96d9851c00542c739d053e4bf36481,0,Parth Brahmbhatt,2014-07-07 11:49:42-07:00,['00e80e9a132764d4b73737d2f7a52282e5247856'],216,0,216,605462,2,0.72173913,0,0,1098
597b496044c03af0f4b289b62953e52fae7ec510,0,Derek Dagit,2014-07-07 14:26:29-05:00,['4bcda70018fb0977f6f2d96b17a6f948ce1d0344'],3,0,3,605465,1,,,,1098
e3d951d6e67b388d392d00b6793f8ae4ad839787,0,Robert (Bobby) Evans,2014-07-07 14:28:13-05:00,"['b7d808485e331d4d0088ce4ec6bb976aaa5b9b77', '597b496044c03af0f4b289b62953e52fae7ec510']",22,25,47,605512,1,,,,1098
e6b6e3ca049f89222f2aad96e324aa47409383f1,0,jiahong.ljh,2014-07-08 11:56:53+08:00,['b68c33a31927c45f52b61007ba155d89590bf26c'],23,61,84,605596,2,0.965517241,0.965517241,1,1098
1b2ea79e77a54ff1195d75adf52e0c13ec4544d8,0,Jo Liss,2014-07-08 14:18:59+00:00,['8da9572ac7d12e843ce8579c9e5629a528a3d0ea'],0,3,3,605599,1,,,,1098
ae5d0c312d170c883e9758767808e1c8d33f58c8,0,Kishor Patil,2014-07-08 22:08:33+00:00,['28c168fd7d0272f88d586f6f572eab937b874f22'],2,1,3,605602,1,1,0,0,1098
bf8e4565562dcf7a4a9d3087fbe5206269e19a90,1,Itai Frenkel,2014-07-09 11:21:21+03:00,['8da9572ac7d12e843ce8579c9e5629a528a3d0ea'],0,22,22,605624,3,0.7,0.7,0.85,1098
f4bc21d3ec13450a0892b91158d42ec273e15d13,0,Robert (Bobby) Evans,2014-07-09 12:44:25-05:00,"['28c168fd7d0272f88d586f6f572eab937b874f22', 'ae5d0c312d170c883e9758767808e1c8d33f58c8']",2,1,3,605627,1,,,,1098
642ed743140acf7f9eec56cd98c65ac8435dfe9d,0,Robert (Bobby) Evans,2014-07-09 17:49:59+00:00,['f4bc21d3ec13450a0892b91158d42ec273e15d13'],2,2,4,605631,1,,,,1098
2b1d6cfe9b3d567234246b2e01bfb02b64131302,0,Curtis Allen,2014-07-09 15:43:14-06:00,['8da9572ac7d12e843ce8579c9e5629a528a3d0ea'],1,1,2,605633,1,,,,1098
8c697bb1e553977c993fe2a728739fe5485f7313,0,Derek Dagit,2014-07-10 07:59:02-05:00,"['8da9572ac7d12e843ce8579c9e5629a528a3d0ea', '7ce0bff2ca63c830e148385b4cce231152843d58']",3,5,8,605641,1,,,,1098
1471cbd4912cea0dd59fc74553392762ce8c44bc,0,Derek Dagit,2014-07-10 08:01:15-05:00,['8c697bb1e553977c993fe2a728739fe5485f7313'],0,1,1,605642,1,,,,1098
2ea202704a509c0bea14438beb65443f33517ebc,1,Itai Frenkel,2014-07-10 19:10:38+03:00,['bf8e4565562dcf7a4a9d3087fbe5206269e19a90'],2,2,4,605646,2,,,,1098
2572ac3365cb075fce316ce82ca42b015970fbd6,0,Robert (Bobby) Evans,2014-07-10 15:22:38-05:00,['e3d951d6e67b388d392d00b6793f8ae4ad839787'],1,1,2,605648,1,,,,1098
fdbc5ebd081b6b8d6ed4da595ce6f0025343d0ee,0,Robert (Bobby) Evans,2014-07-10 15:24:36-05:00,['2572ac3365cb075fce316ce82ca42b015970fbd6'],1,3,4,605652,1,,,,1098
9e77cd23702e2170590af1d9eae6ae1546431312,0,Robert (Bobby) Evans,2014-07-10 15:50:00-05:00,"['1471cbd4912cea0dd59fc74553392762ce8c44bc', 'fdbc5ebd081b6b8d6ed4da595ce6f0025343d0ee']",0,96,96,605748,1,,,,1098
1ce42cc6cd488d486ba7040c18d03960da07eef0,0,Robert (Bobby) Evans,2014-07-11 08:41:27-05:00,['e3b9d46e31cf72136b7d3e8163ff42c539f3b419'],3,12,15,605763,2,0.25,0.25,1,1098
c2176bafefdc0bcefe2db5586c26d53ff27f0512,1,Milad,2014-07-11 09:01:13-05:00,['9e77cd23702e2170590af1d9eae6ae1546431312'],3,7,10,605773,1,,,,1098
214ee7454548b884c591991b1faea770d1478cec,1,Jungtaek Lim,2014-07-12 00:59:01+09:00,['18a0721d8e6702d96d936fa56402aee6009c8240'],75,175,250,606023,4,0,0,1,1098
1094762bf9c3ae339500a3a4500d742367c33e63,1,Parth Brahmbhatt,2014-07-11 11:50:07-07:00,['e04c37356c96d9851c00542c739d053e4bf36481'],1,312,313,606336,2,0.248366013,1,1,1099
ed1f97d5e40aeff1bf75f72e896b1134cc70f9fc,0,Robert (Bobby) Evans,2014-07-11 16:13:07-05:00,"['9e77cd23702e2170590af1d9eae6ae1546431312', 'f6b826b91d2e299e3286dac78c4866cbded165ce']",11,88,99,606435,4,,,,1099
9e8c769a6fe7559c22ed3bfd229e9bd01c322a2d,0,Robert (Bobby) Evans,2014-07-11 16:13:42-05:00,['ed1f97d5e40aeff1bf75f72e896b1134cc70f9fc'],0,1,1,606436,1,,,,1099
dcd4bf7c33c799fca8ea67ba22f1bee7c6b40f4b,0,Adrian Petrescu,2014-07-11 17:19:21-04:00,['9e77cd23702e2170590af1d9eae6ae1546431312'],4,7,11,606447,1,,,,1099
cc5f1f632a0d4b81ebbf57668ce025a7780b7a0f,0,Jungtaek Lim,2014-07-12 09:23:44+09:00,['214ee7454548b884c591991b1faea770d1478cec'],11,16,27,606474,1,,,,1099
f019eff48b0fbc92b8e147e919dfea910f2b4d19,1,Milad,2014-07-14 07:21:15-05:00,['c2176bafefdc0bcefe2db5586c26d53ff27f0512'],1,1,2,606476,1,,,,1099
6e18ec1fedbc4b7c206fb305ed8b298c30fe5d96,0,P. Taylor Goetz,2014-07-14 13:45:54-04:00,['f6b3cb99d872daeadc80da31bb5d8ba4495c2e8c'],18,104,122,606598,2,0.488888889,0.977777778,0.977777778,1100
183f74fd8a9c66619ea568cbe77ec5a3c43afceb,0,P. Taylor Goetz,2014-07-14 14:30:37-04:00,['6e18ec1fedbc4b7c206fb305ed8b298c30fe5d96'],29,9,38,606636,3,0,0,0,1100
ad6bbee99c5d37d4e6e3dd3a119b14c7031179da,0,Robert (Bobby) Evans,2014-07-15 09:12:43-05:00,"['9e8c769a6fe7559c22ed3bfd229e9bd01c322a2d', 'cc5f1f632a0d4b81ebbf57668ce025a7780b7a0f']",75,180,255,606891,4,,,,1100
e5226dbc535d65ff2c3f8d8bca43b36a0a3c5b77,0,Robert (Bobby) Evans,2014-07-15 09:16:05-05:00,['ad6bbee99c5d37d4e6e3dd3a119b14c7031179da'],0,2,2,606893,2,,,,1100
d606dc93f2536b420bc3af6bfc6116502586f5d8,0,Anya Tchernishov,2014-07-15 18:14:11+03:00,['e08fb0663fab9d24bd8a4e74cd41aef94e5cb7ac'],0,590,590,607483,5,0.936877076,1,0.966777409,1105
bbb3e749ea3a5ccb5d04916656bba670477fa696,0,Robert (Bobby) Evans,2014-07-15 12:52:29-05:00,"['e5226dbc535d65ff2c3f8d8bca43b36a0a3c5b77', 'e6b6e3ca049f89222f2aad96e324aa47409383f1']",1,305,306,607789,3,,,,1105
ae383e37e2a57c4dcc9a11c17192e3ff44429376,0,Robert (Bobby) Evans,2014-07-15 12:55:09-05:00,['bbb3e749ea3a5ccb5d04916656bba670477fa696'],0,2,2,607791,2,,,,1105
c18276f84c09eb575771c2a0d8c6d8e85e785e6a,0,Derek Dagit,2014-07-15 16:41:00-05:00,"['e5226dbc535d65ff2c3f8d8bca43b36a0a3c5b77', '8f3ed521e17cdd544d89b529130d102eb43fa11f']",4,5,9,607800,1,,,,1105
96e81c1fb567006023a37a3f50cc6b8e051f52c7,0,Derek Dagit,2014-07-15 16:45:18-05:00,['c18276f84c09eb575771c2a0d8c6d8e85e785e6a'],1,2,3,607803,2,,,,1105
8081e76d798d6500050e5310fe3a284db04e16c6,0,iwasakims,2014-07-16 06:10:19-07:00,['9e8c769a6fe7559c22ed3bfd229e9bd01c322a2d'],0,6,6,607809,2,,,,1105
e6d138e1935ad77099ea8513a1ea3d6141beec82,0,iwasakims,2014-07-16 06:26:15-07:00,['96e81c1fb567006023a37a3f50cc6b8e051f52c7'],10,10,20,607829,1,,,,1105
c78e08feef7044d262c0ea30d202faee94c28862,0,iwasakims,2014-07-16 06:30:35-07:00,['5b425e41bae2f455cae2c365ed617d5ac833847b'],4,5,9,607838,1,,,,1105
69b4601f71bad51605813fca10a18ccb82859dd2,0,Robert (Bobby) Evans,2014-07-16 09:20:20-05:00,"['96e81c1fb567006023a37a3f50cc6b8e051f52c7', 'ae383e37e2a57c4dcc9a11c17192e3ff44429376']",1,307,308,608146,5,,,,1105
14bcc9b2155ab5be71ccffa43689ef6f51b153f4,0,iwasakims,2014-07-16 08:16:50-07:00,['96e81c1fb567006023a37a3f50cc6b8e051f52c7'],8,74,82,608228,2,,,,1105
a277c887f16e07e5aae3093f77751f23dd6139b6,0,Parth Brahmbhatt,2014-07-16 10:58:44-07:00,['69b4601f71bad51605813fca10a18ccb82859dd2'],0,330,330,608558,6,0.894736842,1,0.776315789,1110
b9017eab4beb4d2997688b0c732e937cedb5af1f,0,Robert (Bobby) Evans,2014-07-17 16:23:21-05:00,['1ce42cc6cd488d486ba7040c18d03960da07eef0'],1,1,2,608560,1,,,,1110
fe95ca4bafa75e120c6b7e8dc828d3f8e8c2461c,0,shelld0h,2014-07-18 18:49:27+08:00,"['9c186aaa4d6feb2648b9d7f519e46bfd9bb1b070', '69b4601f71bad51605813fca10a18ccb82859dd2']",231,2079,2310,610870,44,,,,1110
44aaaa91be7cfa5fef8424f08a25bd1e8b3bf458,0,Robert (Bobby) Evans,2014-07-18 08:25:44-05:00,"['69b4601f71bad51605813fca10a18ccb82859dd2', 'c86dbf956aabcd2623bdbc937dd51acfafe87d4a']",22,26,48,610918,1,,,,1110
85c9cd5aee09ac2bf510fbc7fe877ee16c76ee28,0,Robert (Bobby) Evans,2014-07-18 08:28:52-05:00,['44aaaa91be7cfa5fef8424f08a25bd1e8b3bf458'],0,2,2,610920,2,,,,1110
2940d9d43eab0c27d1ed1331472baa932e966d13,0,Kishor Patil,2014-07-18 15:10:50+00:00,"['e5efcf506856c472ae7e5e36578862d2c8dd4906', '85c9cd5aee09ac2bf510fbc7fe877ee16c76ee28']",334,2411,2745,613665,57,,,,1110
ba3c5c247e1bf72e4382da5981624b10e8650c6c,0,Kishor Patil,2014-07-18 20:43:52+00:00,['2940d9d43eab0c27d1ed1331472baa932e966d13'],2,21,23,613688,1,,,,1110
4a4a298f66270a9edc9a0a5554824d5b616b0cfd,0,Kishor Patil,2014-07-18 20:48:54+00:00,"['7bb8ec6d8068fe2eeec65085bfa0140aca0fb0a9', '642ed743140acf7f9eec56cd98c65ac8435dfe9d']",11,22,33,613721,4,,,,1110
4127249da6f2c5e6f89e91470f9ed3d517a1f3f2,0,Kishor Patil,2014-07-18 21:06:39+00:00,['ba3c5c247e1bf72e4382da5981624b10e8650c6c'],9,9,18,613739,1,,,,1110
3635c88c7377df716b5e3d402ac6412a00dd6dfe,0,Kishor Patil,2014-07-18 21:07:59+00:00,['4a4a298f66270a9edc9a0a5554824d5b616b0cfd'],0,513,513,614252,1,,,,1111
37bfb6f5d8df29aca41715baff295011277f8ac2,0,Kishor Patil,2014-07-18 21:07:59+00:00,['3635c88c7377df716b5e3d402ac6412a00dd6dfe'],65,98,163,614415,1,,,,1111
1ef85903fefbd9e5db497a078c247b2aa2e9a5d2,1,Kishor Patil,2014-07-18 21:09:53+00:00,['37bfb6f5d8df29aca41715baff295011277f8ac2'],2,21,23,614438,1,,,,1111
9a41b50a6e3134a04c3ac1a267b4909facbaf924,1,Kishor Patil,2014-07-18 21:09:53+00:00,['1ef85903fefbd9e5db497a078c247b2aa2e9a5d2'],9,9,18,614456,1,,,,1111
20f4f5eadf832c1d3f5d6cff9e7243c7a844d3d0,0,Kishor Patil,2014-07-18 21:16:53+00:00,"['cbb0b8a2970a2094320915934113e4c06a559222', '85c9cd5aee09ac2bf510fbc7fe877ee16c76ee28']",320,2235,2555,617011,52,,,,1111
f7502f41a7bdfc67a432714efa27b0c952b7bb0e,0,Kang Xiao,2014-07-20 00:19:21+08:00,['6b275d95fbdbc8374a215ecb2551f0fca3438d81'],6,1,7,617018,1,,,,1111
cea872d4e9317601eed60f7fa0a9a831446f41be,0,Kang Xiao,2014-07-20 00:40:15+08:00,['b1ccc153d924a971d2f1303023b969f8c975b238'],2,2,4,617022,1,,,,1111
ea30b703865bf043bea2fc4f7c689f5a13d59c0f,1,dashengju,2014-07-20 17:34:41+08:00,['69b4601f71bad51605813fca10a18ccb82859dd2'],11,129,140,617162,7,0.440860215,0.333333333,1,1111
a5c97d79e0e809a43b962a8a6753f376e8bc020f,0,Homer Strong,2014-07-20 12:39:20-07:00,['85c9cd5aee09ac2bf510fbc7fe877ee16c76ee28'],0,2,2,617164,1,,,,1111
28de7e511340d6c134f2eac039dc054a0107cba4,0,Homer Strong,2014-07-20 12:39:40-07:00,['a5c97d79e0e809a43b962a8a6753f376e8bc020f'],2,2,4,617168,1,,,,1111
6e6aeb9a770df6d119e0db3273981f1d12c3aac7,1,Sriharsha Chintalapani,2014-07-20 13:32:52-07:00,['85c9cd5aee09ac2bf510fbc7fe877ee16c76ee28'],8,14,22,617190,4,,,,1111
8fa0f7881d0c63db70315cd08da75421b1a1d972,0,Robert (Bobby) Evans,2014-07-21 11:17:06-05:00,"['85c9cd5aee09ac2bf510fbc7fe877ee16c76ee28', 'f8c9995ac7f1d5fcdd19b3d0f67f0abd111f320e']",0,4,4,617194,1,,,,1111
48cc069ae6585716c45d5b903a6b428691062b76,0,Robert (Bobby) Evans,2014-07-21 11:18:11-05:00,['8fa0f7881d0c63db70315cd08da75421b1a1d972'],0,1,1,617195,1,,,,1111
3dd0f40e2e87de98195bed792d03adf1cec4848c,0,Robert (Bobby) Evans,2014-07-21 11:28:44-05:00,"['48cc069ae6585716c45d5b903a6b428691062b76', 'e6d138e1935ad77099ea8513a1ea3d6141beec82']",10,10,20,617215,1,,,,1111
c1aed00e0090aba01a422c512bd8a9e447e80031,0,Robert (Bobby) Evans,2014-07-21 11:30:04-05:00,['3dd0f40e2e87de98195bed792d03adf1cec4848c'],0,2,2,617217,2,,,,1111
5b425e41bae2f455cae2c365ed617d5ac833847b,0,Robert (Bobby) Evans,2014-07-21 11:41:43-05:00,"['c1aed00e0090aba01a422c512bd8a9e447e80031', 'f019eff48b0fbc92b8e147e919dfea910f2b4d19']",3,9,12,617229,3,,,,1111
6b50a7f69984ff8d5dc53def4d5bcfeb12c06c5f,0,Kishor Patil,2014-07-21 18:49:34+00:00,['4127249da6f2c5e6f89e91470f9ed3d517a1f3f2'],5,4,9,617238,2,,,,1111
6d0311f82fa2acf8fbc292c381c7e3d507bd651c,0,Kishor Patil,2014-07-21 18:53:03+00:00,['9a41b50a6e3134a04c3ac1a267b4909facbaf924'],6,5,11,617249,2,,,,1111
9e13a356268e1e8bf76ac29c42a441a0f49108be,0,Sriharsha Chintalapani,2014-07-21 15:13:35-07:00,['f3112fa76e98038da83170513a476499dde0bb41'],104,107,211,617460,4,1,1,1,1111
96150dfe6901e0bf89e75c160e01575a711be304,0,fxjwind,2014-07-22 11:58:32+08:00,['85c9cd5aee09ac2bf510fbc7fe877ee16c76ee28'],1,2,3,617463,1,,,,1111
9098f9d765bbae96e1577f000abb416092d1fc34,0,shelld0h,2014-07-22 13:35:16+08:00,['fe95ca4bafa75e120c6b7e8dc828d3f8e8c2461c'],1,22,23,617486,1,,,,1111
aa0139c08db53f4071a82200d8afb2fae397aa35,0,Robert (Bobby) Evans,2014-07-22 08:41:10-05:00,"['5b425e41bae2f455cae2c365ed617d5ac833847b', '9098f9d765bbae96e1577f000abb416092d1fc34']",8,40,48,617534,6,,,,1111
7ac24b893c2162c96efb4dfdee16e6109510283b,0,Robert (Bobby) Evans,2014-07-22 08:53:55-05:00,['aa0139c08db53f4071a82200d8afb2fae397aa35'],0,30,30,617564,3,,,,1111
c9a6f650c23f39dd3303a19a06edc45d9e97a4d4,1,Kishor Patil,2014-07-22 16:27:27+00:00,['20f4f5eadf832c1d3f5d6cff9e7243c7a844d3d0'],67,48,115,617679,3,,,,1111
87fc5541aa617c52cca740bc1564a63f4601c91b,0,Parth Brahmbhatt,2014-07-22 09:41:53-07:00,['1094762bf9c3ae339500a3a4500d742367c33e63'],2,1,3,617682,1,1,0,0,1111
8973e30d70aa615c13ee02f10e20c4690ec1e43e,0,Parth Brahmbhatt,2014-07-22 09:41:53-07:00,['87fc5541aa617c52cca740bc1564a63f4601c91b'],2,2,4,617686,1,,,,1111
2c78f911e495518b65241ee0904d37d0f854b8b7,1,Parth Brahmbhatt,2014-07-22 09:42:52-07:00,['8973e30d70aa615c13ee02f10e20c4690ec1e43e'],127,152,279,617965,7,1,0,0,1112
a26329c238f2bdcd1fd8fe41ac511a394f47c440,0,Parth Brahmbhatt,2014-07-22 11:14:05-07:00,['a277c887f16e07e5aae3093f77751f23dd6139b6'],7,157,164,618129,5,1,1,0.863636364,1116
b5500ec8f7f0171e6ec37de1e85b2041d2f482af,0,Kishor Patil,2014-07-22 18:51:34+00:00,['c9a6f650c23f39dd3303a19a06edc45d9e97a4d4'],20,10,30,618159,1,,,,1116
727dd1d5ea36aadf05ed8ae50435aaa40a46d664,1,Megan Kearl,2014-07-22 15:06:43-05:00,['7ac24b893c2162c96efb4dfdee16e6109510283b'],1,10,11,618170,1,,,,1116
41986445fb89ff77c101fcdd6daccb945160e8a9,1,Raghavendra Nandagopal,2014-07-22 13:20:54-07:00,['642ed743140acf7f9eec56cd98c65ac8435dfe9d'],40,1077,1117,619287,17,0.351598174,0.5,0.9543379,1125
32a49a965c314c4de4ccec0ecb4673177296fdad,0,Kishor Patil,2014-07-22 20:37:28+00:00,['b5500ec8f7f0171e6ec37de1e85b2041d2f482af'],20,19,39,619326,2,,,,1125
a0232c85940529860d5ccaa5db82ee95927116fb,0,Kishor Patil,2014-07-22 20:56:44+00:00,['32a49a965c314c4de4ccec0ecb4673177296fdad'],6,6,12,619338,2,,,,1125
905969ca3a744d86a562d3d85805c25f9f9561cc,0,Parth Brahmbhatt,2014-07-22 14:19:24-07:00,['a26329c238f2bdcd1fd8fe41ac511a394f47c440'],31,287,318,619656,10,0.564102564,1,0.897435897,1129
1c297d70993014a4713f0fa6584a725c480e1cfd,0,Kishor Patil,2014-07-22 21:57:35+00:00,['a0232c85940529860d5ccaa5db82ee95927116fb'],13,13,26,619682,2,,,,1129
6a38b52a51600c7cda561442f92a6195adce527e,0,Parth Brahmbhatt,2014-07-22 15:06:56-07:00,['905969ca3a744d86a562d3d85805c25f9f9561cc'],0,99,99,619781,1,,,,1129
d89faea28405a0aaf82d46164d9cb88c3547d0ca,0,Kyle Nusbaum,2014-07-22 22:59:13+00:00,['7ac24b893c2162c96efb4dfdee16e6109510283b'],0,135,135,619916,1,,,,1129
9f53bdc6a0d3345696a8310a1fc0a0583b095e89,0,Kyle Nusbaum,2014-07-22 23:00:44+00:00,['d89faea28405a0aaf82d46164d9cb88c3547d0ca'],68,0,68,619984,1,,,,1129
cfda011f936d9bc23870e9b0687d3d55941f1ab0,0,iwasakims,2014-07-23 06:53:18-07:00,['14bcc9b2155ab5be71ccffa43689ef6f51b153f4'],1,1,2,619986,1,,,,1129
3414a79c8f1f656c735360fb2bc97057a29e46cd,0,Robert (Bobby) Evans,2014-07-23 10:02:23-05:00,['7ac24b893c2162c96efb4dfdee16e6109510283b'],1,2,3,619989,1,,,,1129
425b75609452f85f90e6945bf4171a2f7cd9e099,0,Parth Brahmbhatt,2014-07-23 14:45:27-07:00,['6a38b52a51600c7cda561442f92a6195adce527e'],41,27,68,620057,10,,,,1129
e1e6a602e330d71410b1876ca9fb6bfc29761f35,0,Kishor Patil,2014-07-24 19:34:38+00:00,['7ac24b893c2162c96efb4dfdee16e6109510283b'],4,7,11,620068,1,0,0,1,1129
9b3a632340b66f1fe493220c0e6c22c2912e8025,0,Kishor Patil,2014-07-24 19:36:41+00:00,['e1e6a602e330d71410b1876ca9fb6bfc29761f35'],1,1,2,620070,1,,,,1129
f1f5ecd92c7ea55d01163c8dbc2360466f34fd3a,0,Kishor Patil,2014-07-24 20:49:22+00:00,['9b3a632340b66f1fe493220c0e6c22c2912e8025'],1,4,5,620075,2,0,0,1,1129
8c89d188a910a57a4e10bc956206c0f16e5d827d,1,Adrian Petrescu,2014-07-24 16:53:59-04:00,"['dcd4bf7c33c799fca8ea67ba22f1bee7c6b40f4b', '7ac24b893c2162c96efb4dfdee16e6109510283b']",141,713,854,620929,24,,,,1129
097a07204af215e813efebdb60fb079130056f98,0,Derek Dagit,2014-07-24 16:07:02-05:00,"['7ac24b893c2162c96efb4dfdee16e6109510283b', '92edcef1902a5376ce0ea5b4fff189ad421cfe38']",1,1,2,620931,1,,,,1129
2e7b1d454db004c51b846d4668ed7826843a4251,0,Derek Dagit,2014-07-24 16:08:27-05:00,['097a07204af215e813efebdb60fb079130056f98'],0,1,1,620932,1,,,,1129
4ac8dc3ed127134d6e8ff7d379bcabf083fef3b7,0,Robert (Bobby) Evans,2014-07-24 16:09:37-05:00,"['7ac24b893c2162c96efb4dfdee16e6109510283b', '1b2ea79e77a54ff1195d75adf52e0c13ec4544d8']",0,3,3,620935,1,,,,1129
9b3cb1830489cc4f629d5fa38cf7ab2181475c4f,0,Robert (Bobby) Evans,2014-07-24 16:11:24-05:00,['4ac8dc3ed127134d6e8ff7d379bcabf083fef3b7'],1,3,4,620939,2,,,,1129
07a561aeec294bd92e15d155c5e1249c1bb0d5d5,0,Robert (Bobby) Evans,2014-07-24 16:12:44-05:00,"['2e7b1d454db004c51b846d4668ed7826843a4251', '9b3cb1830489cc4f629d5fa38cf7ab2181475c4f']",1,6,7,620946,3,,,,1129
b20fcffcbef3d8764a07e25c08a366cc85ad7afa,0,Kishor Patil,2014-07-24 21:33:20+00:00,['1c297d70993014a4713f0fa6584a725c480e1cfd'],2,1,3,620949,1,,,,1129
5b68b9301412ae766fddfc22320f3890240b1779,1,Parth Brahmbhatt,2014-07-24 14:35:11-07:00,['2c78f911e495518b65241ee0904d37d0f854b8b7'],4,97,101,621050,3,,,,1130
498d8b22262a7706ec25097d745f1f6c63c9cb35,0,Derek Dagit,2014-07-24 16:37:54-05:00,['07a561aeec294bd92e15d155c5e1249c1bb0d5d5'],1,1,2,621052,1,,,,1130
3c55b103d3703fbf825a8d03bd426e4a37538b6a,0,Derek Dagit,2014-07-24 16:38:10-05:00,['498d8b22262a7706ec25097d745f1f6c63c9cb35'],0,2,2,621054,2,,,,1130
e9238bcd15fc7b7eb19e2bd34a8b2968eaa7edd0,0,Derek Dagit,2014-07-24 16:56:14-05:00,"['3c55b103d3703fbf825a8d03bd426e4a37538b6a', '2b1d6cfe9b3d567234246b2e01bfb02b64131302']",1,1,2,621056,1,,,,1130
3a19ccc8450638b1028c81d792d97fcbf226fbf5,0,Derek Dagit,2014-07-24 16:58:01-05:00,['e9238bcd15fc7b7eb19e2bd34a8b2968eaa7edd0'],0,2,2,621058,2,,,,1130
133c398ee9f5799fb3d702e27c8f83b969fc0341,1,Raghavendra Nandagopal,2014-07-24 15:47:51-07:00,['41986445fb89ff77c101fcdd6daccb945160e8a9'],54,56,110,621168,5,1,1,1,1130
63e90822056daf0a41c0778c0984b7371459a3f2,0,Raghavendra Nandagopal,2014-07-24 15:57:31-07:00,['133c398ee9f5799fb3d702e27c8f83b969fc0341'],0,3,3,621171,1,,,,1130
5e423647f0f238652b4ad7203f83f527881a8f32,0,fxjwind,2014-07-25 18:16:42+08:00,['96150dfe6901e0bf89e75c160e01575a711be304'],1,0,1,621172,1,,,,1130
e89413368caf86727228cfddf3e252ad8b411ddf,0,Stephen Elliott,2014-07-25 12:04:53+01:00,['974f0f377a371db6a673c59e13a9640fbdd9d92a'],0,2,2,621174,1,0,1,1,1130
cbb6cf3c83eecf8d5b3f10db75b32b23766ae002,0,Itai Frenkel,2014-07-25 16:46:07+03:00,['d606dc93f2536b420bc3af6bfc6116502586f5d8'],3,1,4,621178,1,,,,1130
b0f002d65ea06c5630cab6d9c7abf95b4dfe2065,0,Sriharsha Chintalapani,2014-07-25 09:03:36-07:00,['3a19ccc8450638b1028c81d792d97fcbf226fbf5'],18,27,45,621223,2,,,,1130
6c2f08f02364f3d117db483e39450ee849d7b5ec,0,Robert (Bobby) Evans,2014-07-25 13:45:14-05:00,"['3a19ccc8450638b1028c81d792d97fcbf226fbf5', '28de7e511340d6c134f2eac039dc054a0107cba4']",2,4,6,621229,2,,,,1130
30efc8a53b974dbfb657ec0e13f1d82556ffbe26,0,Robert (Bobby) Evans,2014-07-25 13:53:59-05:00,['6c2f08f02364f3d117db483e39450ee849d7b5ec'],0,1,1,621230,1,,,,1130
5f599173f29679b39df924177c7e04452a728d94,0,Robert (Bobby) Evans,2014-07-25 15:00:13-05:00,"['30efc8a53b974dbfb657ec0e13f1d82556ffbe26', 'ea30b703865bf043bea2fc4f7c689f5a13d59c0f']",11,129,140,621370,7,,,,1130
dc8907b5e4c896772ad0b38bee8d35fa5753e3f9,0,Robert (Bobby) Evans,2014-07-25 15:00:59-05:00,['5f599173f29679b39df924177c7e04452a728d94'],0,1,1,621371,1,,,,1130
2f737761600cd8cbc8d321dd5cfcad4d28e29d05,0,Robert (Bobby) Evans,2014-07-25 15:11:01-05:00,"['dc8907b5e4c896772ad0b38bee8d35fa5753e3f9', 'b9017eab4beb4d2997688b0c732e937cedb5af1f']",0,421,421,621792,3,,,,1130
5219f494e0acc333cd40cb5203458fbd3a34ca7b,0,Robert (Bobby) Evans,2014-07-25 15:11:34-05:00,['2f737761600cd8cbc8d321dd5cfcad4d28e29d05'],0,1,1,621793,1,,,,1130
371286a34a809fbe1f23118e80db105207c824c7,0,Robert (Bobby) Evans,2014-07-25 16:06:10-05:00,['041b11c1966e3bb0b29ba31d366315b8aced19d7'],4,40,44,621837,3,0,1,1,1130
f155e6f445705e56b183e70f1ac64260ff74c0be,0,Robert (Bobby) Evans,2014-07-25 16:18:06-05:00,"['5219f494e0acc333cd40cb5203458fbd3a34ca7b', 'c78e08feef7044d262c0ea30d202faee94c28862']",4,5,9,621846,1,,,,1130
556ac8af1d0a0ee81473b126887e0f1cdc50080f,0,Robert (Bobby) Evans,2014-07-25 16:18:46-05:00,['f155e6f445705e56b183e70f1ac64260ff74c0be'],0,1,1,621847,1,,,,1130
6eea872b52d6a926a0a90925abff783318b85626,0,Robert (Bobby) Evans,2014-07-25 16:27:56-05:00,"['556ac8af1d0a0ee81473b126887e0f1cdc50080f', 'cfda011f936d9bc23870e9b0687d3d55941f1ab0']",8,74,82,621929,2,,,,1130
a6bf4c3ebd5e3211550c3634e7b0f85d9f6fadf0,0,Robert (Bobby) Evans,2014-07-25 16:28:34-05:00,['6eea872b52d6a926a0a90925abff783318b85626'],0,1,1,621930,1,,,,1130
9db723d852f1fb0a053efd3eaf46430bbe40a985,0,Robert (Bobby) Evans,2014-07-25 16:44:07-05:00,"['a6bf4c3ebd5e3211550c3634e7b0f85d9f6fadf0', '3414a79c8f1f656c735360fb2bc97057a29e46cd']",0,0,0,621930,0,,,,1130
c3a9a37a09ffa561505bad1c3adc68726dd7ad12,0,Robert (Bobby) Evans,2014-07-25 16:44:31-05:00,['9db723d852f1fb0a053efd3eaf46430bbe40a985'],0,1,1,621931,1,,,,1130
4ee369ca691436863d9afc83d0a9c21eee234e95,0,Kyle Nusbaum,2014-07-25 21:50:26+00:00,"['9f53bdc6a0d3345696a8310a1fc0a0583b095e89', 'a6bf4c3ebd5e3211550c3634e7b0f85d9f6fadf0']",29,652,681,622612,21,,,,1130
1fedcd5b53649ba1f404429d6fa3c9cc6c296047,0,Parth Brahmbhatt,2014-07-25 16:04:12-07:00,['5b68b9301412ae766fddfc22320f3890240b1779'],47,84,131,622743,7,0,1,1,1130
839120514c4bfc9e2694ed44f32aa42a9f0d94bc,0,wurstmeister,2014-07-26 10:32:53+01:00,['c3a9a37a09ffa561505bad1c3adc68726dd7ad12'],2,2,4,622747,1,,,,1130
827e0ba9e88f5a719532f2cf55a3963ef0bfb6db,1,Parth Brahmbhatt,2014-07-28 09:34:59-07:00,['425b75609452f85f90e6945bf4171a2f7cd9e099'],21,17,38,622785,6,0,1,1,1130
185f1778ed6de45690210a208c3f5d9774d3e56f,0,Parth Brahmbhatt,2014-07-28 09:36:55-07:00,['827e0ba9e88f5a719532f2cf55a3963ef0bfb6db'],1,1,2,622787,1,,,,1130
d4db09f8c0160195bdc296a73ead5d8f1b022ba7,1,Dane Hammer,2014-07-28 12:16:33-05:00,['371286a34a809fbe1f23118e80db105207c824c7'],52,268,320,623107,8,1,1,1,1135
5fbe7855c7b2f6bfee6a88fea086c19f71524b89,0,Dane Hammer,2014-07-28 12:19:44-05:00,['d4db09f8c0160195bdc296a73ead5d8f1b022ba7'],2,10,12,623119,2,,,,1135
fb882ca18f124c7f6b65b7edeb2c0a652e254c3a,1,Sriharsha Chintalapani,2014-07-28 12:51:13-07:00,['9e13a356268e1e8bf76ac29c42a441a0f49108be'],4,13,17,623136,3,,,,1135
ff8336b70d20bccb29f0f5acd8c7f7e4323dca94,0,Robert (Bobby) Evans,2014-07-28 16:59:42-05:00,"['642ed743140acf7f9eec56cd98c65ac8435dfe9d', 'fb882ca18f124c7f6b65b7edeb2c0a652e254c3a']",108,797,905,624041,8,,,,1135
6ba520a82cd80dffa94d9517ac68e4250a598158,0,Robert (Bobby) Evans,2014-07-28 17:43:42-05:00,"['371286a34a809fbe1f23118e80db105207c824c7', '5fbe7855c7b2f6bfee6a88fea086c19f71524b89']",52,276,328,624369,8,,,,1135
3bce04ceab9abfd6e6da211cb5a792d9df6c96c6,0,Raghavendra Nandagopal,2014-07-28 16:28:45-07:00,['63e90822056daf0a41c0778c0984b7371459a3f2'],498,490,988,625357,8,1,0,,1135
19ad13510cb42963f868fd8bd785b4937dd348ab,0,Raghavendra Nandagopal,2014-07-28 17:42:05-07:00,['3bce04ceab9abfd6e6da211cb5a792d9df6c96c6'],4,4,8,625365,1,0,0,0,1135
60799cf0f9420f1e4878a41cff8de20949f6d363,0,Robert (Bobby) Evans,2014-07-28 20:26:31-05:00,['6ba520a82cd80dffa94d9517ac68e4250a598158'],4,95,99,625464,5,0,0,0,1135
6639abb6f9664038a41d9dfdf1f5934dbdbc4384,0,Edison,2014-07-29 15:51:29+08:00,['c3a9a37a09ffa561505bad1c3adc68726dd7ad12'],0,1,1,625465,1,,,,1135
b1a64443943b554365a47f6053c51789da5f87f3,0,Edison,2014-07-29 15:51:48+08:00,['6639abb6f9664038a41d9dfdf1f5934dbdbc4384'],0,1,1,625466,1,,,,1135
98fa84f66c6c41d8e23088bb5bc96ef88e27b67f,0,Edison,2014-07-29 15:52:05+08:00,['b1a64443943b554365a47f6053c51789da5f87f3'],0,1,1,625467,1,,,,1135
848a748c5a00de9fc24174b2f7ccb58e0fa393f7,0,Robert (Bobby) Evans,2014-07-29 07:16:40-05:00,"['c3a9a37a09ffa561505bad1c3adc68726dd7ad12', 'f1f5ecd92c7ea55d01163c8dbc2360466f34fd3a']",5,11,16,625483,2,,,,1135
b2a8a77c3b307137527c706d0cd7635a6afe25bf,0,Robert (Bobby) Evans,2014-07-29 07:17:46-05:00,['848a748c5a00de9fc24174b2f7ccb58e0fa393f7'],0,1,1,625484,1,,,,1135
49c12f255fda2364d1d4d68dcbdd9f14dd718065,0,Sriharsha Chintalapani,2014-07-29 09:47:59-07:00,"['6e6aeb9a770df6d119e0db3273981f1d12c3aac7', 'b2a8a77c3b307137527c706d0cd7635a6afe25bf']",55,762,817,626301,31,,,,1135
39797ac6914d042051d6f4504edb6e01998bccf3,0,P. Taylor Goetz,2014-07-29 14:17:13-04:00,['20c4565dbdbbb916d4143a9262c0869c566221bc'],2,1,3,626304,2,,,,1135
f7fb65676dd80214760e058d366fb2d6dcb302c2,0,P. Taylor Goetz,2014-07-29 14:39:57-04:00,"['d339a56296da3484b54476d2eadb35e6c548129e', 'be5eae3bcc07cfbaf49c19c57da42dac1351a3e3']",69,233,302,626606,8,,,,1135
fcc921596521befb597e07294e02eaeb877c0db2,0,P. Taylor Goetz,2014-07-29 14:57:41-04:00,['f7fb65676dd80214760e058d366fb2d6dcb302c2'],0,1,1,626607,1,,,,1135
179cc3760c629c7fe7ec3e0f09e17101707a010d,0,Parth Brahmbhatt,2014-07-29 12:05:58-07:00,['185f1778ed6de45690210a208c3f5d9774d3e56f'],3,3,6,626613,1,,,,1135
813ed7fc55d70093bd6d9bfb176d28a39b99bd87,0,Parth Brahmbhatt,2014-07-29 12:14:21-07:00,['179cc3760c629c7fe7ec3e0f09e17101707a010d'],6,18,24,626637,2,1,1,1,1135
559c883d5331362808b7e1ada647cbac76a88ab3,1,Robert (Bobby) Evans,2014-07-29 15:57:03-05:00,"['ff8336b70d20bccb29f0f5acd8c7f7e4323dca94', 'b2a8a77c3b307137527c706d0cd7635a6afe25bf']",367,3003,3370,630007,66,,,,1135
ee5bb1792afc28155bd8cdf87e97ebf719c031d1,0,Robert (Bobby) Evans,2014-07-29 16:47:19-05:00,['559c883d5331362808b7e1ada647cbac76a88ab3'],4,18,22,630029,1,0,1,1,1135
02e79499fa381b56f8a5333e00cf0cc0bd7aa252,0,Raghavendra Nandagopal,2014-07-29 16:37:50-07:00,"['19ad13510cb42963f868fd8bd785b4937dd348ab', '559c883d5331362808b7e1ada647cbac76a88ab3']",454,3780,4234,634263,72,,,,1135
90cf0e6c21df978462d29fe906ad0f2a6adcdb1f,1,Raghavendra Nandagopal,2014-07-29 17:32:38-07:00,['02e79499fa381b56f8a5333e00cf0cc0bd7aa252'],0,5,5,634268,2,,,,1135
00f7d632eb48bf967b5a7b72f5460352d0a8dbd9,0,Raghavendra Nandagopal,2014-07-29 17:50:24-07:00,['90cf0e6c21df978462d29fe906ad0f2a6adcdb1f'],5,5,10,634278,2,,,,1135
cf5fc0c3f0a71d8e81d344f247a477694e83a2a7,0,Robert (Bobby) Evans,2014-07-30 11:15:43-05:00,['00f7d632eb48bf967b5a7b72f5460352d0a8dbd9'],0,1,1,634279,1,,,,1135
c6ef84d13e9e767e6ae21f2772b5ad836e27e43e,0,Parth Brahmbhatt,2014-07-30 11:13:03-07:00,['813ed7fc55d70093bd6d9bfb176d28a39b99bd87'],4,5,9,634288,3,0,1,1,1135
188bdb83db816a7eae593f48f6981bedf859311c,0,Parth Brahmbhatt,2014-07-30 13:19:20-07:00,['c6ef84d13e9e767e6ae21f2772b5ad836e27e43e'],2,6,8,634296,2,,,,1135
ec086ab31812fa9ec6f42dcbc61096c6935347f4,0,Parth Brahmbhatt,2014-07-30 13:53:00-07:00,['188bdb83db816a7eae593f48f6981bedf859311c'],1,1,2,634298,1,,,,1135
b2aa030c478875411be009119b0ebc563a4036a9,0,Kishor Patil,2014-07-30 21:40:59+00:00,"['b20fcffcbef3d8764a07e25c08a366cc85ad7afa', 'b2a8a77c3b307137527c706d0cd7635a6afe25bf']",55,761,816,635114,31,,,,1135
af58c3bcfd6f23de34bd895e741831e187734f6e,0,Robert (Bobby) Evans,2014-07-30 18:45:37-05:00,"['b2a8a77c3b307137527c706d0cd7635a6afe25bf', '6b50a7f69984ff8d5dc53def4d5bcfeb12c06c5f']",32,57,89,635203,6,,,,1135
d65c913e4ed5dce07f5c802fb5b9a046ce7d6597,0,Robert (Bobby) Evans,2014-07-30 18:46:17-05:00,['af58c3bcfd6f23de34bd895e741831e187734f6e'],0,1,1,635204,1,,,,1135
9d0b61804a17c3edb6d9b12f64655533ee77b38c,0,Robert (Bobby) Evans,2014-07-30 18:55:51-05:00,"['cf5fc0c3f0a71d8e81d344f247a477694e83a2a7', '6d0311f82fa2acf8fbc292c381c7e3d507bd651c']",32,57,89,635293,6,,,,1135
fa40fbcc8953f95e6a5f0f147f84170fae026c62,0,Robert (Bobby) Evans,2014-07-30 19:03:25-05:00,"['9d0b61804a17c3edb6d9b12f64655533ee77b38c', 'd65c913e4ed5dce07f5c802fb5b9a046ce7d6597']",1,2,3,635296,2,,,,1135
c410404a2af2a01a948a626a0023d14d62159578,0,Robert (Bobby) Evans,2014-07-30 19:08:32-05:00,"['d65c913e4ed5dce07f5c802fb5b9a046ce7d6597', 'c89712785c5c0e21c0cf47bf263809b64c3f2b3e']",2,2,4,635300,2,,,,1135
9ac011129dc90418b9e8210abf0ff8e9f60be656,0,Robert (Bobby) Evans,2014-07-30 19:13:43-05:00,['c410404a2af2a01a948a626a0023d14d62159578'],0,1,1,635301,1,,,,1135
78c5e231f679c84d14258d190c8658f8d0b98ad3,0,Robert (Bobby) Evans,2014-07-30 19:17:05-05:00,"['9ac011129dc90418b9e8210abf0ff8e9f60be656', '8c4684cfca25aa02e815497ad489193bd3d3d495']",50,48,98,635399,5,,,,1135
c8a6e716af4984a0b0515e18029693db2c68be78,0,Robert (Bobby) Evans,2014-07-30 19:18:25-05:00,['78c5e231f679c84d14258d190c8658f8d0b98ad3'],0,2,2,635401,2,,,,1135
ee78097c0408e98df1951282ce72e7cfdc94cce8,0,Robert (Bobby) Evans,2014-07-30 19:30:53-05:00,"['c8a6e716af4984a0b0515e18029693db2c68be78', '8c89d188a910a57a4e10bc956206c0f16e5d827d']",3,4,7,635408,1,,,,1135
b1c5e7eae5b647b13df5b82990eed5f3bbea9d81,0,Robert (Bobby) Evans,2014-07-30 19:31:58-05:00,['ee78097c0408e98df1951282ce72e7cfdc94cce8'],0,1,1,635409,1,,,,1135
c1f102bd35dd845026f3427caaadbd10b3535f98,0,Dane Hammer,2014-07-31 10:24:28-05:00,['60799cf0f9420f1e4878a41cff8de20949f6d363'],14,2,16,635425,1,0,0,0,1135
ded6a53fb3c7e638e1dc6764f9057b110bef83bd,0,Robert (Bobby) Evans,2014-07-31 10:30:57-05:00,"['60799cf0f9420f1e4878a41cff8de20949f6d363', 'c1f102bd35dd845026f3427caaadbd10b3535f98']",14,2,16,635441,1,,,,1135
a484fcd40d02aaca99274886089623d20ee0fb98,0,Robert (Bobby) Evans,2014-07-31 12:59:57-05:00,['ded6a53fb3c7e638e1dc6764f9057b110bef83bd'],9,5,14,635455,1,0,0,0,1135
6c4ff011d74c56265fe699bfc6362a627f3d0d47,0,Midpoint Applications,2014-07-31 16:26:05-04:00,['b2a8a77c3b307137527c706d0cd7635a6afe25bf'],1,1,2,635457,1,,,,1135
342d2e5f1442b26393dff55601d6412bec40ef0c,1,Parth Brahmbhatt,2014-08-03 14:06:01-07:00,['b1c5e7eae5b647b13df5b82990eed5f3bbea9d81'],2,95,97,635554,1,,,,1135
0587bee8bab9fb6d789472217a083f8f5ea7c572,0,Robert (Bobby) Evans,2014-08-04 11:20:16-05:00,['a484fcd40d02aaca99274886089623d20ee0fb98'],3,4,7,635561,1,1,1,1,1135
3208a8e3f39140227fe6be9c686b795a19777e64,1,Sriharsha Chintalapani,2014-08-04 19:18:26-07:00,['fa40fbcc8953f95e6a5f0f147f84170fae026c62'],120,103,223,635784,6,,,,1135
c54539be9e7bd4ea12acdc3d491d0518fdb0a3be,0,Itai Frenkel,2014-08-05 13:43:34+03:00,['b1c5e7eae5b647b13df5b82990eed5f3bbea9d81'],1,6,7,635791,1,1,1,1,1135
5d838b331f76ea225e913a502a332a60154d1fdf,0,Itai Frenkel,2014-08-05 14:29:07+03:00,"['d2be73b06beab538b34d248cb83c494ae7a33e4f', 'cbb6cf3c83eecf8d5b3f10db75b32b23766ae002']",9,1,10,635801,1,,,,1135
f27ac7ca536e335efc72492985d05ab062d492a3,0,Itai Frenkel,2014-08-05 14:45:17+03:00,['5d838b331f76ea225e913a502a332a60154d1fdf'],9,9,18,635819,3,0,0,0,1135
71589213b9d0dade43c1289e308d593567ec66cb,0,Itai Frenkel,2014-08-05 14:46:21+03:00,['f27ac7ca536e335efc72492985d05ab062d492a3'],12,8,20,635839,1,0,0,1,1135
6574592940ec99e5fffffc1adae802f1413a51aa,0,Itai Frenkel,2014-08-05 14:47:37+03:00,['71589213b9d0dade43c1289e308d593567ec66cb'],1,1,2,635841,1,,,,1135
7d8b20140c3db51991166849a29793231052fcdd,0,Itai Frenkel,2014-08-05 14:52:18+03:00,['6574592940ec99e5fffffc1adae802f1413a51aa'],30,39,69,635910,1,0,0,1,1135
a9e7339b7450f036ee60020d61d52f213b8ed00f,0,Parth Brahmbhatt,2014-08-06 09:37:52-07:00,['183f74fd8a9c66619ea568cbe77ec5a3c43afceb'],0,230,230,636140,4,0.5,0.7125,0.85,1139
c361603d2bffea419cb989913099639b65004f22,0,Parth Brahmbhatt,2014-08-06 10:08:02-07:00,['ec086ab31812fa9ec6f42dcbc61096c6935347f4'],3,3,6,636146,1,,,,1139
837b9e50acbfb3b91009ed08259c44e0efebcebf,0,JuDasheng,2014-08-07 16:39:59+08:00,['b1c5e7eae5b647b13df5b82990eed5f3bbea9d81'],2,5,7,636153,1,0,0,1,1139
4c6c77cc8aff2a8895b616fec0e28b9ebde3ea27,0,Itai Frenkel,2014-08-07 14:54:01+03:00,['7d8b20140c3db51991166849a29793231052fcdd'],11,11,22,636175,1,1,1,0,1139
9a9a5eb169f054c209ab51f7a72a955ae12d29c2,0,Itai Frenkel,2014-08-07 14:55:14+03:00,"['7d8b20140c3db51991166849a29793231052fcdd', '4c6c77cc8aff2a8895b616fec0e28b9ebde3ea27']",11,11,22,636197,1,,,,1139
346335c8cbc894c8d7a9168fef85fd145886920c,0,Itai Frenkel,2014-08-07 15:35:48+03:00,['7d8b20140c3db51991166849a29793231052fcdd'],28,23,51,636248,1,,,,1139
c0957d040802003d6b6fcc8ad77e3600ece2e307,1,Itai Frenkel,2014-08-07 15:35:54+03:00,['346335c8cbc894c8d7a9168fef85fd145886920c'],0,448,448,636696,4,0.918803419,0.918803419,0.931623932,1142
45aaed4e862b87f43a89e0e27bbb78a589c90498,0,Itai Frenkel,2014-08-07 15:35:54+03:00,['c0957d040802003d6b6fcc8ad77e3600ece2e307'],11,0,11,636707,2,,,,1142
5ebb6d9d56fbb2c71ad71ac9236739a1551223a7,0,Itai Frenkel,2014-08-07 15:38:48+03:00,"['45aaed4e862b87f43a89e0e27bbb78a589c90498', '9a9a5eb169f054c209ab51f7a72a955ae12d29c2']",11,11,22,636729,1,,,,1142
9c0b0246a0fba746ca2b9c0d1a257e951e3055b6,1,Itai Frenkel,2014-08-07 15:39:14+03:00,['5ebb6d9d56fbb2c71ad71ac9236739a1551223a7'],11,11,22,636751,1,1,1,0,1142
b22e3f85335245a803296be195295f382bd23853,0,Itai Frenkel,2014-08-07 15:43:22+03:00,"['9a9a5eb169f054c209ab51f7a72a955ae12d29c2', '9c0b0246a0fba746ca2b9c0d1a257e951e3055b6']",28,460,488,637239,4,,,,1142
d7e446feb3be1fd1c1ee0b5bd0aea0b1511dfc43,0,Itai Frenkel,2014-08-07 15:44:54+03:00,['b22e3f85335245a803296be195295f382bd23853'],3,1,4,637243,2,,,,1142
1a1df087c1a0f2e15c5e670d8192d66d12d1bae8,0,Robert (Bobby) Evans,2014-08-07 10:09:12-05:00,"['fa40fbcc8953f95e6a5f0f147f84170fae026c62', '1fedcd5b53649ba1f404429d6fa3c9cc6c296047']",23,490,513,637756,10,,,,1142
a41a0ac4e7240338ec4825dc23b10e5e18db1efd,0,Kang Xiao,2014-08-07 23:52:31+08:00,"['f7502f41a7bdfc67a432714efa27b0c952b7bb0e', 'b1c5e7eae5b647b13df5b82990eed5f3bbea9d81']",3549,20900,24449,662205,237,,,,1142
1e3a2b80d4ffe3431bae5912ac3ec39cf12a8ab6,0,Kang Xiao,2014-08-07 23:59:29+08:00,"['cea872d4e9317601eed60f7fa0a9a831446f41be', 'b1c5e7eae5b647b13df5b82990eed5f3bbea9d81']",3536,20880,24416,686621,237,,,,1142
b60feb7407b77b0a70f00340d13c287324c53480,1,Kang Xiao,2014-08-08 00:12:29+08:00,['1e3a2b80d4ffe3431bae5912ac3ec39cf12a8ab6'],1,1,2,686623,1,,,,1142
aff8d651ee32bec8f39baf32f2ff15595e3e0106,0,Robert (Bobby) Evans,2014-08-07 11:26:25-05:00,"['b1c5e7eae5b647b13df5b82990eed5f3bbea9d81', 'b60feb7407b77b0a70f00340d13c287324c53480']",1,4,5,686628,2,,,,1142
2ebdbfa7c746e7c75f3aa34866e1c42d9c0fa340,0,Robert (Bobby) Evans,2014-08-07 11:27:10-05:00,['aff8d651ee32bec8f39baf32f2ff15595e3e0106'],0,1,1,686629,1,,,,1142
fad1f65369925771265d0ba322d41823683a932d,0,Kang Xiao,2014-08-08 02:18:58+08:00,"['a41a0ac4e7240338ec4825dc23b10e5e18db1efd', '2ebdbfa7c746e7c75f3aa34866e1c42d9c0fa340']",1,5,6,686635,3,,,,1142
3a20181b034c18adb0dc9c881059ca884603eba5,0,Kang Xiao,2014-08-08 02:20:53+08:00,['fad1f65369925771265d0ba322d41823683a932d'],1,26,27,686662,2,,,,1142
5fe6ac938c1ff82e80ee3eba5626f458c4dc18e5,0,Robert (Bobby) Evans,2014-08-07 15:11:41-05:00,['24d4a14de310cbbfebdc4a50d8cc9d86f9943087'],1,3,4,686666,1,,,,1142
ba8975671e3449ff335704a5282ccf6bf12ca564,0,Robert (Bobby) Evans,2014-08-07 15:38:07-05:00,"['2ebdbfa7c746e7c75f3aa34866e1c42d9c0fa340', '4ee369ca691436863d9afc83d0a9c21eee234e95']",0,67,67,686733,1,,,,1142
1a49ca631751dabc840a330639ef79234ab01717,0,Robert (Bobby) Evans,2014-08-07 15:38:32-05:00,['ba8975671e3449ff335704a5282ccf6bf12ca564'],0,1,1,686734,1,,,,1142
832600e7bbe31f38cf5d8d58a8f138b7b9df5195,0,Robert (Bobby) Evans,2014-08-07 15:52:41-05:00,"['1a49ca631751dabc840a330639ef79234ab01717', '2ea202704a509c0bea14438beb65443f33517ebc']",0,23,23,686757,3,,,,1142
675edb486eb2f469aa66a4fa390ccf2447359385,0,Robert (Bobby) Evans,2014-08-07 15:56:27-05:00,['832600e7bbe31f38cf5d8d58a8f138b7b9df5195'],0,2,2,686759,2,,,,1142
1800380c2b70bc0697f43db75777b97bf2acb0e5,0,P. Taylor Goetz,2014-08-07 23:55:48-04:00,['b1c5e7eae5b647b13df5b82990eed5f3bbea9d81'],1,40,41,686800,1,,,,1142
de0aa5af21e4ef424e0e9074223ab8a19e832115,0,P. Taylor Goetz,2014-08-08 13:56:29-04:00,['1800380c2b70bc0697f43db75777b97bf2acb0e5'],0,6,6,686806,1,,,,1142
f51bbad17079ca1251992e3a30834c12fdedbf29,0,P. Taylor Goetz,2014-08-08 14:35:33-04:00,['de0aa5af21e4ef424e0e9074223ab8a19e832115'],0,6,6,686812,1,,,,1142
581a528fbeab1c121c0511ece856eafd3dd674de,0,P. Taylor Goetz,2014-08-08 15:13:33-04:00,"['675edb486eb2f469aa66a4fa390ccf2447359385', 'fcc921596521befb597e07294e02eaeb877c0db2']",0,3205,3205,690017,42,,,,1142
50c69fe1bda351b96f204b6705cabf590c4067a7,0,P. Taylor Goetz,2014-08-08 15:15:11-04:00,['581a528fbeab1c121c0511ece856eafd3dd674de'],0,1,1,690018,1,,,,1142
10110763090b0fbeaa797aeec9c3a0f7773daba4,0,P. Taylor Goetz,2014-08-08 15:23:21-04:00,"['50c69fe1bda351b96f204b6705cabf590c4067a7', 'c361603d2bffea419cb989913099639b65004f22']",11,846,857,690875,17,,,,1142
61205557d9c5925a3661177fc2166b8a0413c082,0,P. Taylor Goetz,2014-08-08 15:25:41-04:00,"['10110763090b0fbeaa797aeec9c3a0f7773daba4', '342d2e5f1442b26393dff55601d6412bec40ef0c']",2,95,97,690972,1,,,,1142
c565d562794af33612f3da9c3a670937154f8dc4,0,P. Taylor Goetz,2014-08-08 15:27:05-04:00,['61205557d9c5925a3661177fc2166b8a0413c082'],0,1,1,690973,1,,,,1142
b0bf870af8d2d605d9ad4e95bf51960acb31c939,0,P. Taylor Goetz,2014-08-08 15:34:25-04:00,"['c565d562794af33612f3da9c3a670937154f8dc4', 'e89413368caf86727228cfddf3e252ad8b411ddf']",0,5,5,690978,1,,,,1142
1e3b8c100a61db6e1afc54a003e4eea31e6f18df,0,P. Taylor Goetz,2014-08-08 15:35:32-04:00,['b0bf870af8d2d605d9ad4e95bf51960acb31c939'],0,1,1,690979,1,,,,1142
598acf9710920028ed0c240dc6add02a895f2f48,0,P. Taylor Goetz,2014-08-08 15:41:25-04:00,"['1e3b8c100a61db6e1afc54a003e4eea31e6f18df', '49c12f255fda2364d1d4d68dcbdd9f14dd718065']",7,14,21,691000,4,,,,1142
9968b8b03b9b8eeb9e2f9293d58460cb01647fb1,0,P. Taylor Goetz,2014-08-08 15:42:00-04:00,['598acf9710920028ed0c240dc6add02a895f2f48'],0,1,1,691001,1,,,,1142
7d21ffe9f9f61c9e3115add26a250b95084b131d,1,Kishor Patil,2014-08-08 20:32:20+00:00,['675edb486eb2f469aa66a4fa390ccf2447359385'],44,171,215,691216,4,0.457627119,0.983050847,0.322033898,1144
747765b9042443443a29a2191303c32976d1e640,1,Marc Beitchman,2014-08-10 21:17:48+02:00,['9968b8b03b9b8eeb9e2f9293d58460cb01647fb1'],2,2,4,691220,1,,,,1144
da30c0567ecdb1d1cc1a0af1f62815b47dc48ce8,0,Kishor Patil,2014-08-11 17:10:40+00:00,['7d21ffe9f9f61c9e3115add26a250b95084b131d'],1,2,3,691223,1,,1,0,1144
ee86ad9b6963722a2f2d91c04d5014c11c0a9024,0,Robert (Bobby) Evans,2014-08-11 13:59:08-05:00,['9968b8b03b9b8eeb9e2f9293d58460cb01647fb1'],5,9,14,691237,1,1,1,1,1144
7071fba98caf453db5505b4287f3ebc343a56b54,0,Naresh Kosgi,2014-08-12 13:46:54-04:00,['9968b8b03b9b8eeb9e2f9293d58460cb01647fb1'],1,1,2,691239,1,,,,1144
d6a71142eec6f669f335312f418134960143fdbc,0,Kang Xiao,2014-08-14 00:34:06+08:00,['3a20181b034c18adb0dc9c881059ca884603eba5'],5,5,10,691249,2,,,,1144
2b7c79a2bd66f0502515851935a3d92eb34c3453,1,ashtonwebster,2014-08-13 18:27:59-04:00,['9968b8b03b9b8eeb9e2f9293d58460cb01647fb1'],2,2,4,691253,1,,,,1144
76353a80ff8d0121cdd5ef53e518f07f0be95a0a,0,Daniel Blanchard,2014-08-14 16:23:53-04:00,['9968b8b03b9b8eeb9e2f9293d58460cb01647fb1'],0,2,2,691255,1,0,0,1,1144
b73b051e683f1f27d299b15d79e99ce74bbd6054,1,Sriharsha Chintalapani,2014-08-14 13:42:40-07:00,['3208a8e3f39140227fe6be9c686b795a19777e64'],29,68,97,691352,2,,,,1144
a2484f3e7659841d986439b73c79116f8ba0d70b,0,Kang Xiao,2014-08-16 00:12:53+08:00,['d6a71142eec6f669f335312f418134960143fdbc'],7,3,10,691362,1,,,,1144
91dddb2b653cfcd79ee2b4bef5e784cdf28486cd,0,P. Taylor Goetz,2014-08-15 15:33:40-04:00,['a9e7339b7450f036ee60020d61d52f213b8ed00f'],31,34,65,691427,2,1,1,1,1144
6212947b891896bccd0bc03ed58fbcc48472574f,0,P. Taylor Goetz,2014-08-15 15:36:16-04:00,['91dddb2b653cfcd79ee2b4bef5e784cdf28486cd'],4,6,10,691437,4,,,,1144
a1cf23d81eded0da5183c61912908761226732c9,0,Sean T Allen,2014-08-16 10:45:31-04:00,['9968b8b03b9b8eeb9e2f9293d58460cb01647fb1'],1,0,1,691438,1,,,,1144
7a58c2d23214d818e6d6d974f1f2cc7a25e91d1a,0,Derek Dagit,2014-08-16 15:18:08-05:00,['7071fba98caf453db5505b4287f3ebc343a56b54'],0,3,3,691441,2,,,,1144
576726292a88c67aa9e9ba7563de114540487f54,0,Parth Brahmbhatt,2014-08-17 14:56:27-07:00,['1a1df087c1a0f2e15c5e670d8192d66d12d1bae8'],5,49,54,691495,6,1,1,1,1145
a0ca23ca8862500a59b4f4029f05386e3be2ced8,0,Robert (Bobby) Evans,2014-08-18 10:31:27-05:00,['0587bee8bab9fb6d789472217a083f8f5ea7c572'],6,0,6,691501,4,,,,1145
4ee22b1383fe14bfc852a0bcd8bf7b391ed47f27,0,Parth Brahmbhatt,2014-08-18 08:53:52-07:00,['1a1df087c1a0f2e15c5e670d8192d66d12d1bae8'],5,49,54,691555,6,1,1,1,1146
029b1e171e726e31af12aa0c3ff9c0336bf7f8ae,0,Parth Brahmbhatt,2014-08-18 08:54:09-07:00,"['4ee22b1383fe14bfc852a0bcd8bf7b391ed47f27', '576726292a88c67aa9e9ba7563de114540487f54']",0,0,0,691555,0,,,,1146
a55d7922072a0407aa8ae48129cfb31dca7c7338,0,Robert (Bobby) Evans,2014-08-18 14:04:48-05:00,"['1a1df087c1a0f2e15c5e670d8192d66d12d1bae8', 'b73b051e683f1f27d299b15d79e99ce74bbd6054']",141,163,304,691859,7,,,,1146
d20c101fa73c413b8d9fe1065a0291125e18bc96,0,Robert (Bobby) Evans,2014-08-18 14:25:07-05:00,"['a55d7922072a0407aa8ae48129cfb31dca7c7338', '7a58c2d23214d818e6d6d974f1f2cc7a25e91d1a']",76,4327,4403,696262,76,,,,1146
7a06ef722a7bbf5abae42a6c4b1f6762b2293773,0,Robert (Bobby) Evans,2014-08-18 14:40:45-05:00,['d20c101fa73c413b8d9fe1065a0291125e18bc96'],0,1,1,696263,1,,,,1146
18f283e329920696439c8766155f3291fc339dcc,0,Robert (Bobby) Evans,2014-08-18 14:48:50-05:00,"['7a58c2d23214d818e6d6d974f1f2cc7a25e91d1a', '99b914ce0a9cc8185dbcf721eb428568c121cfb3']",4,4,8,696271,1,,,,1146
ab2cf9a63bc772bb8399320a2141c20c40543a2b,0,Robert (Bobby) Evans,2014-08-18 15:36:45-05:00,"['7a58c2d23214d818e6d6d974f1f2cc7a25e91d1a', 'a1cf23d81eded0da5183c61912908761226732c9']",1,0,1,696272,1,,,,1146
9d8a6f0d17bd15799e32a10844ade455d51d6aef,0,Robert (Bobby) Evans,2014-08-18 15:37:34-05:00,['ab2cf9a63bc772bb8399320a2141c20c40543a2b'],0,1,1,696273,1,,,,1146
4196e5fe1757ea169a35b305f1f51a05c3dec00c,1,Robert (Bobby) Evans,2014-08-18 15:47:16-05:00,['18f283e329920696439c8766155f3291fc339dcc'],2,4,6,696279,3,,,,1146
393a21aba625c1700befe209945abe09105037c2,0,Robert (Bobby) Evans,2014-08-18 15:49:09-05:00,"['9d8a6f0d17bd15799e32a10844ade455d51d6aef', '4196e5fe1757ea169a35b305f1f51a05c3dec00c']",4,6,10,696289,3,,,,1146
e62d3d7fcb34258a65f54bb2f02fa6602b38e75b,0,Robert (Bobby) Evans,2014-08-19 09:52:44-05:00,"['393a21aba625c1700befe209945abe09105037c2', '839120514c4bfc9e2694ed44f32aa42a9f0d94bc']",2,2,4,696293,1,,,,1146
50ab15b73aaeaa5e15c9341755f20152ad3316e6,0,Robert (Bobby) Evans,2014-08-19 09:53:51-05:00,['e62d3d7fcb34258a65f54bb2f02fa6602b38e75b'],1,1,2,696295,1,,,,1146
7c37b05e02c7d6aee3fd46e8fea888220f137084,0,Robert (Bobby) Evans,2014-08-19 10:49:59-05:00,"['50ab15b73aaeaa5e15c9341755f20152ad3316e6', '747765b9042443443a29a2191303c32976d1e640']",2,2,4,696299,1,,,,1146
b607ca9b9b641babab310144560bf253861579b2,0,Robert (Bobby) Evans,2014-08-19 10:51:11-05:00,['7c37b05e02c7d6aee3fd46e8fea888220f137084'],0,2,2,696301,2,,,,1146
96574686e5ec3b83f906fe85793d6937a4729ee2,0,Robert (Bobby) Evans,2014-08-19 11:24:04-05:00,"['b607ca9b9b641babab310144560bf253861579b2', '76353a80ff8d0121cdd5ef53e518f07f0be95a0a']",0,2,2,696303,1,,,,1146
aa33ecd318a423f28fe14fde0269ee4b43dd7240,0,Robert (Bobby) Evans,2014-08-19 11:25:17-05:00,['96574686e5ec3b83f906fe85793d6937a4729ee2'],0,2,2,696305,2,,,,1146
0d82c2fc127343f18c3b41ae7951989a6515f371,0,Robert (Bobby) Evans,2014-08-19 12:32:55-05:00,"['aa33ecd318a423f28fe14fde0269ee4b43dd7240', '837b9e50acbfb3b91009ed08259c44e0efebcebf']",2,5,7,696312,1,,,,1146
d4ebb6de222a1f017c15104b5b8d463f6c232cd7,0,Robert (Bobby) Evans,2014-08-19 12:33:49-05:00,['0d82c2fc127343f18c3b41ae7951989a6515f371'],0,1,1,696313,1,,,,1146
9c9803b98efbea2b651a56051ed1d9b4d7c484b9,0,Robert (Bobby) Evans,2014-08-19 15:35:04-05:00,['d4ebb6de222a1f017c15104b5b8d463f6c232cd7'],1,1,2,696315,1,,,,1146
acc1ae6a757cf426e5917dfdd910c746442b2bc2,0,Michael Pershyn,2014-08-20 15:06:24+02:00,['d4ebb6de222a1f017c15104b5b8d463f6c232cd7'],6,18,24,696339,1,1,1,0.333333333,1146
8f6fbdad58c6d7ff2c9ab6270e33cade61e7d530,0,anya,2014-08-20 16:43:26+03:00,['d7e446feb3be1fd1c1ee0b5bd0aea0b1511dfc43'],1,1,2,696341,1,,,,1146
8abafb34188edcc9e8845c0b24ccd3e13647fb18,0,Robert (Bobby) Evans,2014-08-20 10:56:46-05:00,['ee86ad9b6963722a2f2d91c04d5014c11c0a9024'],6,5,11,696352,1,,,,1146
8604e9044ab08dedcb2851685b70abe54c278c2b,0,Robert (Bobby) Evans,2014-08-20 11:04:16-05:00,['d4ebb6de222a1f017c15104b5b8d463f6c232cd7'],3,4,7,696359,1,,,,1146
32c671ad173b4e33b1be1ef1a0e279808b06e3b8,0,Kishor Patil,2014-08-20 20:00:03+00:00,['b2aa030c478875411be009119b0ebc563a4036a9'],36,36,72,696431,1,,,,1146
1d841941a848bfd17e9a830413415cca21ff76f8,0,Kishor Patil,2014-08-20 21:14:52+00:00,['32c671ad173b4e33b1be1ef1a0e279808b06e3b8'],22,22,44,696475,3,,,,1146
2db902e3883519c3c602c046003b8354d6edfbc3,1,Sriharsha Chintalapani,2014-08-20 15:18:10-07:00,['d4ebb6de222a1f017c15104b5b8d463f6c232cd7'],17,26,43,696518,2,,,,1146
cdaa90b11601f99dc2d7bb2147dd05f48e072941,0,Sriharsha Chintalapani,2014-08-20 15:27:36-07:00,"['2db902e3883519c3c602c046003b8354d6edfbc3', 'b0f002d65ea06c5630cab6d9c7abf95b4dfe2065']",0,0,0,696518,0,,,,1146
6c504613c5cb7dead19c59f17f87d7d8179a0671,0,Kyle Nusbaum,2014-08-20 22:29:51+00:00,['7a58c2d23214d818e6d6d974f1f2cc7a25e91d1a'],97,66,163,696681,9,,,,1146
4da836f251fad76eb9cd3c0ed6a7bb60289ebf42,0,Rick Kilgore,2014-08-20 17:57:47-07:00,['d4ebb6de222a1f017c15104b5b8d463f6c232cd7'],3,2,5,696686,1,0,0,0,1146
2058f40095f5134834821d768a74ffb0905639dd,0,Dave Golombek,2014-08-22 15:56:21-04:00,['d4ebb6de222a1f017c15104b5b8d463f6c232cd7'],1,1,2,696688,1,,,,1146
cac70e77d3417e13082495aaac126f25a6d07eff,0,Rick Kilgore,2014-08-22 21:49:08-07:00,['4da836f251fad76eb9cd3c0ed6a7bb60289ebf42'],4,65,69,696757,2,0.896551724,0.965517241,1,1146
27400ee39d99909abb791eb732714ba4265d40be,0,Robert (Bobby) Evans,2014-08-25 10:13:57-05:00,"['d4ebb6de222a1f017c15104b5b8d463f6c232cd7', '8abafb34188edcc9e8845c0b24ccd3e13647fb18']",2,5,7,696764,1,,,,1146
0ee6631635222af94719551376480de7c4d761d0,0,Robert (Bobby) Evans,2014-08-25 10:14:26-05:00,['27400ee39d99909abb791eb732714ba4265d40be'],0,1,1,696765,1,,,,1146
5171c89a66dde90cac1a652e942801d862be6bbb,0,Robert (Bobby) Evans,2014-08-25 10:23:26-05:00,"['0ee6631635222af94719551376480de7c4d761d0', '8604e9044ab08dedcb2851685b70abe54c278c2b']",3,4,7,696772,1,,,,1146
ee71deeea40159a77175e0668b6fb0b70e5d3237,0,Robert (Bobby) Evans,2014-08-25 10:24:08-05:00,['5171c89a66dde90cac1a652e942801d862be6bbb'],0,1,1,696773,1,,,,1146
05a83c8e542642b4fa403a13ac697c2f91e47997,0,Robert (Bobby) Evans,2014-08-25 10:46:38-05:00,"['ee71deeea40159a77175e0668b6fb0b70e5d3237', 'acc1ae6a757cf426e5917dfdd910c746442b2bc2']",6,18,24,696797,1,,,,1146
2c46e4c6d76462100b746041c132fb30767b47e6,0,Robert (Bobby) Evans,2014-08-25 10:48:15-05:00,['05a83c8e542642b4fa403a13ac697c2f91e47997'],0,2,2,696799,2,,,,1146
5887eb329b1f50666d6736136f875da6a6e62f6e,0,Robert (Bobby) Evans,2014-08-25 10:57:07-05:00,"['2c46e4c6d76462100b746041c132fb30767b47e6', 'a0ca23ca8862500a59b4f4029f05386e3be2ced8']",23,355,378,697177,8,,,,1146
93e712b3781916e23f4f17693d96615e603f9c9e,0,Robert (Bobby) Evans,2014-08-25 10:57:49-05:00,['5887eb329b1f50666d6736136f875da6a6e62f6e'],0,1,1,697178,1,,,,1146
f49aa1c3dc45e0ee2c74b5b86c13fa135a55b8fe,0,Robert (Bobby) Evans,2014-08-25 11:17:07-05:00,"['93e712b3781916e23f4f17693d96615e603f9c9e', 'c54539be9e7bd4ea12acdc3d491d0518fdb0a3be']",1,6,7,697185,1,,,,1146
8dd170d41c8ecf935f4e7a8d263bbe3cee57d3e4,0,Robert (Bobby) Evans,2014-08-25 11:17:55-05:00,['f49aa1c3dc45e0ee2c74b5b86c13fa135a55b8fe'],0,1,1,697186,1,,,,1146
103e2c19ec10375649d536363dde6ad644bd8f44,0,Robert (Bobby) Evans,2014-08-25 11:25:21-05:00,"['8dd170d41c8ecf935f4e7a8d263bbe3cee57d3e4', 'cdaa90b11601f99dc2d7bb2147dd05f48e072941']",17,26,43,697229,2,,,,1146
14d0ee5c5a66e4955112b6186d564a0abf16e13e,0,Robert (Bobby) Evans,2014-08-25 11:25:55-05:00,['103e2c19ec10375649d536363dde6ad644bd8f44'],0,1,1,697230,1,,,,1146
b7fb68c5cb7866c63af437a8a7d63217517393d0,0,Robert (Bobby) Evans,2014-08-25 11:34:20-05:00,"['14d0ee5c5a66e4955112b6186d564a0abf16e13e', '1d841941a848bfd17e9a830413415cca21ff76f8']",9,83,92,697322,3,,,,1146
2b4cbe91cd4f42649c06fb75293397c8eb5de669,0,Robert (Bobby) Evans,2014-08-25 11:34:51-05:00,['b7fb68c5cb7866c63af437a8a7d63217517393d0'],0,1,1,697323,1,,,,1146
4042b9dea8c8bb647c5860ecfc257fb3ad22acf3,0,Robert (Bobby) Evans,2014-08-25 12:50:32-05:00,"['2b4cbe91cd4f42649c06fb75293397c8eb5de669', 'cee992ad57453720f0a28b9ecc0ab3680be6f61f']",2,8,10,697333,1,,,,1146
5ddf308a8df765885410bd116017bd3132fea089,0,Robert (Bobby) Evans,2014-08-25 12:51:57-05:00,['4042b9dea8c8bb647c5860ecfc257fb3ad22acf3'],0,1,1,697334,1,,,,1146
6393d31b0be99f93213405543c8af8d6e8cd6f63,0,Robert (Bobby) Evans,2014-08-25 13:15:57-05:00,"['5ddf308a8df765885410bd116017bd3132fea089', 'a2484f3e7659841d986439b73c79116f8ba0d70b']",1,22,23,697357,2,,,,1146
15757694512319540d385257af3af6d19c8b1aaa,0,Robert (Bobby) Evans,2014-08-25 13:16:47-05:00,['6393d31b0be99f93213405543c8af8d6e8cd6f63'],0,1,1,697358,1,,,,1146
3fcaf69637620173baddc13637bf0ba3289b254d,0,Robert (Bobby) Evans,2014-08-25 15:50:12-05:00,"['15757694512319540d385257af3af6d19c8b1aaa', '2058f40095f5134834821d768a74ffb0905639dd']",1,1,2,697360,1,,,,1146
97608671d59c8d8267822c62481e4a40963834c8,0,Robert (Bobby) Evans,2014-08-25 15:51:25-05:00,['3fcaf69637620173baddc13637bf0ba3289b254d'],0,2,2,697362,2,,,,1146
01f7a02bd0971eb40322d4ab63fd8bc948192544,0,Scott Bessler,2014-08-25 21:22:43-07:00,['97608671d59c8d8267822c62481e4a40963834c8'],0,3,3,697365,1,1,1,1,1146
c0eec64c74a97ff8a1ba28488a5c2775f4f81bfd,1,Parth Brahmbhatt,2014-08-25 23:48:04-07:00,['5ddf308a8df765885410bd116017bd3132fea089'],38,50,88,697453,10,1,0.714285714,0.857142857,1147
d1d2ccbe0259778af2d049ee10535ba0f7e9788d,0,Kyle Nusbaum,2014-08-26 11:40:56-05:00,['97608671d59c8d8267822c62481e4a40963834c8'],197,810,1007,698460,3,,,,1147
cccd4a5336c230ef1fca3a6f23aa55aabc9428fe,0,Parth Brahmbhatt,2014-08-26 10:18:58-07:00,['c0eec64c74a97ff8a1ba28488a5c2775f4f81bfd'],277,1,278,698738,3,0.316831683,0.366336634,0.287128713,1147
bfc7ce193da1313fb656c859ec253cb6d98d0f3e,0,Robert (Bobby) Evans,2014-08-26 16:11:37-05:00,"['97608671d59c8d8267822c62481e4a40963834c8', '8081e76d798d6500050e5310fe3a284db04e16c6']",0,6,6,698744,2,,,,1147
d9b68ab1c7bd3cd3fadfb24d1240a5c1c01890ec,0,Robert (Bobby) Evans,2014-08-26 16:38:28-05:00,['bfc7ce193da1313fb656c859ec253cb6d98d0f3e'],0,1,1,698745,1,,,,1147
dd59ad41caf9463a110d60e4e5b09dba50574428,0,Parth Brahmbhatt,2014-08-26 14:59:38-07:00,['029b1e171e726e31af12aa0c3ff9c0336bf7f8ae'],4,19,23,698768,3,,,,1147
b62d71d6696163134ca19e71e55cbc96fde0524d,0,Parth Brahmbhatt,2014-08-26 15:11:21-07:00,"['dd59ad41caf9463a110d60e4e5b09dba50574428', '7a06ef722a7bbf5abae42a6c4b1f6762b2293773']",215,4490,4705,703473,81,,,,1147
e9ee271e20607ced950da075cbf998d616296dc1,0,Kishor Patil,2014-08-28 00:29:22-05:00,['da30c0567ecdb1d1cc1a0af1f62815b47dc48ce8'],1,13,14,703487,2,0,1,0.6,1147
24749f1b18508de151e892dbb756c721bec29f1b,0,Kishor Patil,2014-08-28 00:30:23-05:00,['e9ee271e20607ced950da075cbf998d616296dc1'],4,3,7,703494,2,,,,1147
6e3c77a69c48c11ce9564b5098953ff7a722e95a,0,Kishor Patil,2014-08-28 09:39:36-05:00,['7a06ef722a7bbf5abae42a6c4b1f6762b2293773'],57,126,183,703677,2,0,0,0.1,1147
84b7deaa5badc07b7ea8a88fef589577c837f8ee,1,Robert (Bobby) Evans,2014-08-28 13:48:29-05:00,"['7a06ef722a7bbf5abae42a6c4b1f6762b2293773', 'd9b68ab1c7bd3cd3fadfb24d1240a5c1c01890ec']",159,555,714,704391,26,,,,1147
b19fdbb7444e9d3ea38ede9d186055319df4751d,0,Robert (Bobby) Evans,2014-08-28 15:02:27-05:00,['84b7deaa5badc07b7ea8a88fef589577c837f8ee'],6,11,17,704408,5,,,,1147
f5db183648ea2cac5fead49efbc6dfc12df823a4,0,Derek Dagit,2014-08-28 16:24:40-05:00,['b19fdbb7444e9d3ea38ede9d186055319df4751d'],1,1,2,704410,1,,,,1147
b89a00c18d3db6f34d861e8b6b35e972645c3a24,0,P. Taylor Goetz,2014-08-29 11:36:19-04:00,"['d9b68ab1c7bd3cd3fadfb24d1240a5c1c01890ec', 'f51bbad17079ca1251992e3a30834c12fdedbf29']",1,52,53,704463,1,,,,1147
db51cace985dd2b97253aadfe2385fcf4a7b1661,0,P. Taylor Goetz,2014-08-29 11:37:41-04:00,['b89a00c18d3db6f34d861e8b6b35e972645c3a24'],0,1,1,704464,1,,,,1147
926583cdd6e78d067e57575c633e23931e848f1e,0,P. Taylor Goetz,2014-08-29 11:55:50-04:00,"['db51cace985dd2b97253aadfe2385fcf4a7b1661', 'd1d2ccbe0259778af2d049ee10535ba0f7e9788d']",197,810,1007,705471,3,,,,1147
c69ced723ae2df2935055ae17dcd425ea41ad629,0,P. Taylor Goetz,2014-08-29 11:58:02-04:00,['926583cdd6e78d067e57575c633e23931e848f1e'],0,1,1,705472,1,,,,1147
53f9de4b001b8949e7ed45759adefb787c350ed2,0,P. Taylor Goetz,2014-08-29 12:02:54-04:00,"['c69ced723ae2df2935055ae17dcd425ea41ad629', '2b7c79a2bd66f0502515851935a3d92eb34c3453']",2,2,4,705476,1,,,,1147
dab6096958983b603e292e80256dfd09ccd3e9b2,0,P. Taylor Goetz,2014-08-29 12:06:47-04:00,['53f9de4b001b8949e7ed45759adefb787c350ed2'],0,1,1,705477,1,,,,1147
529c6db1ac5b648cf636f93c8221d52be685e8ad,0,P. Taylor Goetz,2014-08-29 12:40:07-04:00,"['dab6096958983b603e292e80256dfd09ccd3e9b2', '4da836f251fad76eb9cd3c0ed6a7bb60289ebf42']",3,2,5,705482,1,,,,1147
c7fe9ef97962b7cd0eae11754d2bfbdd473139a9,0,Parth Brahmbhatt,2014-08-29 09:52:23-07:00,"['b62d71d6696163134ca19e71e55cbc96fde0524d', 'b19fdbb7444e9d3ea38ede9d186055319df4751d']",166,567,733,706215,30,,,,1147
5f61c08bb4326995ebdca83d823352fb65f17aa3,0,P. Taylor Goetz,2014-08-29 12:53:11-04:00,"['529c6db1ac5b648cf636f93c8221d52be685e8ad', '5e423647f0f238652b4ad7203f83f527881a8f32']",1,1,2,706217,1,,,,1147
5e6331126b7177c4223133a8c13a47d6ce5668df,0,P. Taylor Goetz,2014-08-29 12:59:04-04:00,"['5f61c08bb4326995ebdca83d823352fb65f17aa3', '01f7a02bd0971eb40322d4ab63fd8bc948192544']",0,3,3,706220,1,,,,1147
002aae294a7070cdc76ea025eb4d8a89e766527b,0,P. Taylor Goetz,2014-08-29 13:10:30-04:00,['5e6331126b7177c4223133a8c13a47d6ce5668df'],0,2,2,706222,1,,,,1147
0c25e8f560ab46c6788c9ffc189ea5760a2a7186,0,Derek Dagit,2014-08-29 12:25:27-05:00,['002aae294a7070cdc76ea025eb4d8a89e766527b'],1,1,2,706224,1,,,,1147
25d286e5a016a5b04b1ab2afc428ca13a4298106,0,Derek Dagit,2014-08-29 12:25:27-05:00,['0c25e8f560ab46c6788c9ffc189ea5760a2a7186'],0,1,1,706225,1,,,,1147
3eab6db969a794a7024fa90d57fc96ca32070650,0,P. Taylor Goetz,2014-08-29 13:38:02-04:00,"['25d286e5a016a5b04b1ab2afc428ca13a4298106', '5fe6ac938c1ff82e80ee3eba5626f458c4dc18e5']",1,3,4,706229,1,,,,1147
cbd0d5cad9efe692a4504e66e59af7782ddf300b,0,P. Taylor Goetz,2014-08-29 13:45:52-04:00,['3eab6db969a794a7024fa90d57fc96ca32070650'],0,1,1,706230,1,,,,1147
b1ec9f1df3bbaabbf8cc1cd925a38ac8a283f95c,0,P. Taylor Goetz,2014-08-29 13:52:23-04:00,['cbd0d5cad9efe692a4504e66e59af7782ddf300b'],0,1,1,706231,1,,,,1147
409df70c52ead29c9ad3d3febf1fddfc2161a095,0,P. Taylor Goetz,2014-08-29 13:56:41-04:00,['b1ec9f1df3bbaabbf8cc1cd925a38ac8a283f95c'],1,0,1,706232,1,,,,1147
1684ecc4d05281c136d6e005b11bde71890f4ab6,0,P. Taylor Goetz,2014-08-29 13:57:24-04:00,['409df70c52ead29c9ad3d3febf1fddfc2161a095'],0,1,1,706233,1,,,,1147
a298079598b36c26b238cd8415d126a00c2f823f,0,P. Taylor Goetz,2014-08-29 13:58:08-04:00,['1684ecc4d05281c136d6e005b11bde71890f4ab6'],1,0,1,706234,1,,,,1147
5fb37727affcfb065f78bf97a2627f6bfe01b02f,0,P. Taylor Goetz,2014-08-29 14:44:42-04:00,"['a298079598b36c26b238cd8415d126a00c2f823f', '9c9803b98efbea2b651a56051ed1d9b4d7c484b9']",0,0,0,706234,0,,,,1147
445cc82a9aeef23cc473d8d4854a3a1da03d5ca9,0,P. Taylor Goetz,2014-08-29 14:46:08-04:00,['5fb37727affcfb065f78bf97a2627f6bfe01b02f'],0,1,1,706235,1,,,,1147
b07eff3fd86eed1fd67c1159e03d52e583b655e8,1,Robert (Bobby) Evans,2014-08-29 19:46:54+00:00,['b19fdbb7444e9d3ea38ede9d186055319df4751d'],9,13,22,706257,2,1,1,1,1147
4e692e0349bc3f62df4453385180f5952c8e4b45,0,P. Taylor Goetz,2014-08-29 15:55:32-04:00,"['445cc82a9aeef23cc473d8d4854a3a1da03d5ca9', '24749f1b18508de151e892dbb756c721bec29f1b']",48,187,235,706492,5,,,,1147
58f658214560ab169a4d2dcc81dbe29eacbcf896,0,P. Taylor Goetz,2014-08-29 15:57:46-04:00,['4e692e0349bc3f62df4453385180f5952c8e4b45'],0,1,1,706493,1,,,,1147
766106a1f19d4b71082efeb1b59331eef6587900,0,danehammer,2014-09-02 16:49:58-05:00,['58f658214560ab169a4d2dcc81dbe29eacbcf896'],0,1,1,706494,1,,,,1147
1201b8481b8606d520641be441339a61245b1ce0,0,Edison,2014-09-03 11:38:16+08:00,['98fa84f66c6c41d8e23088bb5bc96ef88e27b67f'],1,1,2,706496,1,,,,1147
b16fd27083a66042b16a6e0bcbc60110307b2cbc,0,Edison,2014-09-03 11:38:54+08:00,['1201b8481b8606d520641be441339a61245b1ce0'],1,1,2,706498,1,,,,1147
fbbc09e051ce3be70d412cb8b5c6ddad4658f4e8,0,Edison,2014-09-03 11:39:17+08:00,['b16fd27083a66042b16a6e0bcbc60110307b2cbc'],1,1,2,706500,1,,,,1147
7391d32d978c906c80343fa8f59d31a64b8170ab,0,anya,2014-09-03 09:53:06+03:00,['8f6fbdad58c6d7ff2c9ab6270e33cade61e7d530'],1,2,3,706503,1,1,1,1,1147
af61cca75c6215d5a0db2d6fb338deca03e55095,0,Derek Dagit,2014-09-03 10:05:25-05:00,['b19fdbb7444e9d3ea38ede9d186055319df4751d'],3,44,47,706550,3,,,,1148
f9d2948a9e2dadbbb99128fd6570038e2096eabd,0,Rick Kilgore,2014-09-03 15:04:32-07:00,"['cac70e77d3417e13082495aaac126f25a6d07eff', '58f658214560ab169a4d2dcc81dbe29eacbcf896']",316,1615,1931,708481,33,,,,1148
264354305207f04019bf621b5fc06d134632e1b6,0,Derek Dagit,2014-09-04 08:29:15-05:00,"['58f658214560ab169a4d2dcc81dbe29eacbcf896', 'fbbc09e051ce3be70d412cb8b5c6ddad4658f4e8']",0,3,3,708484,3,,,,1148
9ba14a82a1a8dece64f4a6d07cde6ebb4589d116,0,Derek Dagit,2014-09-04 08:32:01-05:00,['264354305207f04019bf621b5fc06d134632e1b6'],0,2,2,708486,2,,,,1148
d07da44a76e1365ed8ea5cb44e7efab30f15aafa,0,Derek Dagit,2014-09-04 12:46:12-05:00,['af61cca75c6215d5a0db2d6fb338deca03e55095'],0,5,5,708491,1,,,,1148
b0cdf65da8542ffffca8b3caffbd7921866a5649,0,Derek Dagit,2014-09-04 12:48:19-05:00,['d07da44a76e1365ed8ea5cb44e7efab30f15aafa'],1,0,1,708492,1,,,,1148
f8cb7b594aaad68e9298914610f200e970f4eb11,0,Derek Dagit,2014-09-04 15:29:31-05:00,['b19fdbb7444e9d3ea38ede9d186055319df4751d'],27,46,73,708565,4,,,,1148
a7b5d68e65d196c5b6330320b412fbaef6335c1e,0,Derek Dagit,2014-09-05 10:37:34-05:00,['c7fe9ef97962b7cd0eae11754d2bfbdd473139a9'],1,1,2,708567,1,,,,1148
3540b0051f7e4fb629d7be302a16e856e960dccc,0,Derek Dagit,2014-09-05 10:51:33-05:00,"['9ba14a82a1a8dece64f4a6d07cde6ebb4589d116', '6c4ff011d74c56265fe699bfc6362a627f3d0d47']",1,1,2,708569,1,,,,1148
547575130ea1d3755c353023ce8f73e2153d2e9c,0,Derek Dagit,2014-09-05 10:55:02-05:00,['3540b0051f7e4fb629d7be302a16e856e960dccc'],0,2,2,708571,2,,,,1148
5f3a3a97959770d7374e78f9e415e91b5091a560,0,Derek Dagit,2014-09-05 11:20:07-05:00,"['a7b5d68e65d196c5b6330320b412fbaef6335c1e', '6e3c77a69c48c11ce9564b5098953ff7a722e95a']",57,126,183,708754,2,,,,1148
5aae7686d8a9bb0abf4a459390e8c3622ad0084b,0,Kishor Patil,2014-09-05 13:22:42-05:00,['547575130ea1d3755c353023ce8f73e2153d2e9c'],1,1,2,708756,1,,,,1148
6138e945894c2e0b95666909af51fd336862ce6d,0,Rick Kilgore,2014-09-05 23:57:17-07:00,"['f9d2948a9e2dadbbb99128fd6570038e2096eabd', '5aae7686d8a9bb0abf4a459390e8c3622ad0084b']",2,9,11,708767,6,,,,1148
1c748a7fde11ebc7d209c16ad2b30bf19a316395,0,Rick Kilgore,2014-09-06 00:08:12-07:00,"['5aae7686d8a9bb0abf4a459390e8c3622ad0084b', '6138e945894c2e0b95666909af51fd336862ce6d']",4,65,69,708836,2,,,,1148
ce0b18a3915f1020042b90ca3e981e586175732b,0,Sriharsha Chintalapani,2014-09-06 20:11:24-07:00,['5f3a3a97959770d7374e78f9e415e91b5091a560'],3,2,5,708841,2,0,1,1,1148
04b64bc66d5c29ba77c455f0125200ed8335376f,0,rick-kilgore,2014-09-08 20:49:18+00:00,['1c748a7fde11ebc7d209c16ad2b30bf19a316395'],3,6,9,708850,1,,,,1148
05336764408921f3ebcc4ac5b3e82da10e713bea,0,rick-kilgore,2014-09-08 20:58:01+00:00,['04b64bc66d5c29ba77c455f0125200ed8335376f'],2,2,4,708854,1,,,,1148
cbbea7c5b2d014e0cb76b120223e6c257a96248b,0,rick-kilgore,2014-09-08 22:44:22+00:00,['05336764408921f3ebcc4ac5b3e82da10e713bea'],4,36,40,708894,2,,,,1148
b95b6d68c54b3e80431c73609870c6935b6d56ce,0,rick-kilgore,2014-09-09 00:17:29+00:00,['cbbea7c5b2d014e0cb76b120223e6c257a96248b'],23,446,469,709363,10,,,,1150
2921336a1889164a15044f9c5b53ee1458cd8d80,0,Itai Frenkel,2014-09-09 20:35:45+03:00,['7391d32d978c906c80343fa8f59d31a64b8170ab'],4,7,11,709374,1,1,1,1,1150
ae65a40473158aaaa546981943e922131aa28b36,0,Rick Kilgore,2014-09-09 11:45:04-07:00,['b95b6d68c54b3e80431c73609870c6935b6d56ce'],0,2,2,709376,1,,,,1150
1e1e57289fe4d1317fcb4cc6e4819c18178b742b,0,Rick Kilgore,2014-09-09 11:51:18-07:00,['ae65a40473158aaaa546981943e922131aa28b36'],0,1,1,709377,1,,,,1150
79e3efe2558d252f2122facdb0ce5e69c9c62104,0,Rick Kilgore,2014-09-09 14:52:37-07:00,['05336764408921f3ebcc4ac5b3e82da10e713bea'],3,3,6,709383,2,,,,1150
ea0989d8fb46ac213d813ec58d9c0ee07b75a6be,0,Rick Kilgore,2014-09-09 14:54:25-07:00,['1e1e57289fe4d1317fcb4cc6e4819c18178b742b'],417,0,417,709800,1,,,,1150
5c1029a921483bc86c0b01fec37bfdaba13a206d,0,Rick Kilgore,2014-09-09 14:56:00-07:00,"['ea0989d8fb46ac213d813ec58d9c0ee07b75a6be', '79e3efe2558d252f2122facdb0ce5e69c9c62104']",3,3,6,709806,2,,,,1150
49f91dc3e644643d774afa159cf521faa9062e42,0,Rick Kilgore,2014-09-09 15:32:39-07:00,['5c1029a921483bc86c0b01fec37bfdaba13a206d'],7,0,7,709813,1,,,,1150
2aa03468db3971a11d07048628908074f2a0d3b3,0,Rick Kilgore,2014-09-09 16:03:34-07:00,['79e3efe2558d252f2122facdb0ce5e69c9c62104'],14,19,33,709846,1,0.5,1,1,1150
6f6ece94743eb5432f079db636f4c76dc880f076,0,Rick Kilgore,2014-09-09 16:04:30-07:00,"['49f91dc3e644643d774afa159cf521faa9062e42', '2aa03468db3971a11d07048628908074f2a0d3b3']",14,19,33,709879,1,,,,1150
f4fa76c63efefa987ba124dd7dc8f895f9fe6dcc,0,Rick Kilgore,2014-09-09 16:06:56-07:00,['2aa03468db3971a11d07048628908074f2a0d3b3'],3,3,6,709885,1,,,,1150
e54fae316d6fc97f0e35a442901adc5ce20166ab,0,Rick Kilgore,2014-09-09 16:07:15-07:00,"['6f6ece94743eb5432f079db636f4c76dc880f076', 'f4fa76c63efefa987ba124dd7dc8f895f9fe6dcc']",3,3,6,709891,1,,,,1150
26af8daa3e16e2199828c7760a68849dbbd27af1,0,Rick Kilgore,2014-09-10 16:05:36-07:00,['f4fa76c63efefa987ba124dd7dc8f895f9fe6dcc'],2,2,4,709895,1,,,,1150
d010cb8f25b4a4e0a7882391fc74566c657dbcd1,0,Rick Kilgore,2014-09-10 17:18:53-07:00,"['e54fae316d6fc97f0e35a442901adc5ce20166ab', '26af8daa3e16e2199828c7760a68849dbbd27af1']",2,2,4,709899,1,,,,1150
c99145c93130e93bff8132516fafbecead815ea8,0,Christophe Carr茅,2014-09-11 18:08:17+02:00,['5aae7686d8a9bb0abf4a459390e8c3622ad0084b'],0,6,6,709905,2,,,,1150
08d21a2cb35a5123dedf0bbe13eeef48ee7896b5,0,P. Taylor Goetz,2014-09-11 13:16:58-04:00,"['39797ac6914d042051d6f4504edb6e01998bccf3', '5c033ca07005698cd165bcc22bad0d729e71b252']",109,1116,1225,711130,16,,,,1150
fafda26918fb7284f8a7ea69e4168f79775f4e42,0,P. Taylor Goetz,2014-09-11 13:46:41-04:00,['08d21a2cb35a5123dedf0bbe13eeef48ee7896b5'],16,16,32,711162,7,,,,1150
9cf06354fcf650694a50719b50f02715a033ecb5,0,P. Taylor Goetz,2014-09-11 13:51:51-04:00,['fafda26918fb7284f8a7ea69e4168f79775f4e42'],162,0,162,711324,1,0.411764706,0,0.070588235,1150
509e41514bb92ef65dba1449bbd935557dc8193c,1,P. Taylor Goetz,2014-09-11 13:52:36-04:00,['9cf06354fcf650694a50719b50f02715a033ecb5'],0,162,162,711486,1,0.588235294,1,0.929411765,1151
36c5dc5169555325e9e7680939b2f87d6de44487,0,Rick Kilgore,2014-09-11 14:03:37-07:00,"['5aae7686d8a9bb0abf4a459390e8c3622ad0084b', 'd010cb8f25b4a4e0a7882391fc74566c657dbcd1']",28,131,159,711645,11,,,,1151
4c515dd71f4b9fb42ca56b738de7758236547046,1,P. Taylor Goetz,2014-09-11 17:04:07-04:00,"['5aae7686d8a9bb0abf4a459390e8c3622ad0084b', '509e41514bb92ef65dba1449bbd935557dc8193c']",0,2792,2792,714437,34,,,,1151
8c78c13de01002fd39536430a32da5a0230184d6,0,Rick Kilgore,2014-09-11 14:05:37-07:00,['26af8daa3e16e2199828c7760a68849dbbd27af1'],0,1,1,714438,1,,,,1151
40ab899fe3d67e77c9f1678dbc70d19dd2faf065,0,Rick Kilgore,2014-09-11 14:16:05-07:00,['36c5dc5169555325e9e7680939b2f87d6de44487'],1,1,2,714440,1,,,,1151
77c2df28517f9b9acd87724116d9b7b3573be4fc,0,Rick Kilgore,2014-09-11 17:29:05-07:00,['8c78c13de01002fd39536430a32da5a0230184d6'],7,24,31,714471,2,,,,1151
2b8dade2fe3fd000008e2ef217b04fba7ab327ef,0,Parth Brahmbhatt,2014-09-12 14:17:08-07:00,['5aae7686d8a9bb0abf4a459390e8c3622ad0084b'],0,15,15,714486,1,,,,1151
4e1f474e5b33fca708c4f8a9c3124cbf1f55611e,1,Parth Brahmbhatt,2014-09-12 14:24:16-07:00,['2b8dade2fe3fd000008e2ef217b04fba7ab327ef'],34,194,228,714714,6,,,,1152
670ad01faf6818f5606b98241811db878ac7ad53,0,Parth Brahmbhatt,2014-09-12 14:25:54-07:00,['4e1f474e5b33fca708c4f8a9c3124cbf1f55611e'],16,0,16,714730,1,,,,1152
9280afb51d6a59088520c0b4b0d46d1cb5824d13,1,Parth Brahmbhatt,2014-09-14 12:01:24-07:00,['670ad01faf6818f5606b98241811db878ac7ad53'],52,148,200,714930,3,,,,1152
e96b4467bedd5db7dfdcce9e5623da79ae2e5468,0,Itai Frenkel,2014-09-16 13:03:49+03:00,['2921336a1889164a15044f9c5b53ee1458cd8d80'],0,2,2,714932,2,1,1,1,1152
f259f1da288171a9393fb500150d034ccca0d146,0,Robert (Bobby) Evans,2014-09-17 13:07:42+00:00,['5aae7686d8a9bb0abf4a459390e8c3622ad0084b'],7,7,14,714946,1,0,1,1,1152
9f823caaba08298c81f77d5d54aa062747b4e542,0,Kishor Patil,2014-09-18 10:44:43-05:00,['5aae7686d8a9bb0abf4a459390e8c3622ad0084b'],0,626,626,715572,5,0.26984127,0.31292517,0.884353741,1154
83ec8b3fa2bb00910a2285d5d0d37c52d690e76f,0,Kishor Patil,2014-09-18 10:45:23-05:00,['9f823caaba08298c81f77d5d54aa062747b4e542'],6,10,16,715588,1,1,1,1,1154
3ab2063c767fab90d201169dc3639283409be32c,0,Kishor Patil,2014-09-18 23:36:24-05:00,['83ec8b3fa2bb00910a2285d5d0d37c52d690e76f'],614,45,659,716247,7,0.779661017,0.716707022,0.113801453,1155
32ff6e1fd62a64e156b58af24924ec7b7d5277a4,0,Robert (Bobby) Evans,2014-09-19 16:24:34+00:00,['5aae7686d8a9bb0abf4a459390e8c3622ad0084b'],0,16,16,716263,1,1,1,0,1155
d0aa8ffae10c5b7795e7db22d22d21f61726ccdc,0,Parth Brahmbhatt,2014-09-22 10:56:24-07:00,['9280afb51d6a59088520c0b4b0d46d1cb5824d13'],1,116,117,716380,3,,,,1157
02f6db5783f75a88ba305430991f6fda0bfc7b1a,0,Sriharsha Chintalapani,2014-09-22 11:16:45-07:00,['5f3a3a97959770d7374e78f9e415e91b5091a560'],1,1,2,716382,1,,,,1157
8cfd40e9788e3b50aa409448db62de4708e59eff,0,Sriharsha Chintalapani,2014-09-22 12:00:26-07:00,['5aae7686d8a9bb0abf4a459390e8c3622ad0084b'],0,1,1,716383,1,,,,1157
bc093ddeed442cefd6f3ac82e742467f90d0422a,0,Robert (Bobby) Evans,2014-09-22 15:22:14-05:00,"['8cfd40e9788e3b50aa409448db62de4708e59eff', 'e96b4467bedd5db7dfdcce9e5623da79ae2e5468']",29,1065,1094,717477,10,,,,1157
206daf69d41fb4ef9050bd5eafd9d0ab86251150,0,Robert (Bobby) Evans,2014-09-22 15:22:57-05:00,['bc093ddeed442cefd6f3ac82e742467f90d0422a'],1,2,3,717480,2,,,,1157
d9309024903f855366caf60ece500f6ccaa16895,0,Robert (Bobby) Evans,2014-09-22 15:53:57-05:00,"['206daf69d41fb4ef9050bd5eafd9d0ab86251150', '3ab2063c767fab90d201169dc3639283409be32c']",6,67,73,717553,8,,,,1157
a9fb9c58c90fcd18386bf2ecfc7e3197b2dd526e,0,Robert (Bobby) Evans,2014-09-22 15:54:44-05:00,['d9309024903f855366caf60ece500f6ccaa16895'],0,1,1,717554,1,,,,1157
0b457f22865e4ab3be5b55f17271528b2c461c70,1,Homer Strong,2014-09-22 15:53:12-07:00,['a9fb9c58c90fcd18386bf2ecfc7e3197b2dd526e'],1,1,2,717556,1,,,,1157
2596e335f27a57784a93a57823bd93dde587909f,0,Michael G. Noll,2014-09-23 09:04:05+02:00,['a9fb9c58c90fcd18386bf2ecfc7e3197b2dd526e'],1,3,4,717560,3,1,1,1,1157
3b609c21fee42951b6260d5344b7fc88fa2d96ab,0,Itai Frenkel,2014-09-23 18:33:31+03:00,['a9fb9c58c90fcd18386bf2ecfc7e3197b2dd526e'],349,350,699,718259,2,,,,1159
4f5f7bf67d9dc94b406679772292fd13accb0041,0,Derek Dagit,2014-09-23 10:39:52-05:00,['5f3a3a97959770d7374e78f9e415e91b5091a560'],4,11,15,718274,1,,,,1159
4cb2eeee4cfec72a638ba149e5aa5cda725d5c9d,1,Parth Brahmbhatt,2014-09-23 08:46:27-07:00,['d0aa8ffae10c5b7795e7db22d22d21f61726ccdc'],99,466,565,718839,14,0.518134715,1,1,1163
5a277f8378460e4d9622dc8cfb09ddf088f5a3f9,0,Robert (Bobby) Evans,2014-09-23 13:30:37-05:00,"['5f3a3a97959770d7374e78f9e415e91b5091a560', 'ee5bb1792afc28155bd8cdf87e97ebf719c031d1']",4,18,22,718861,1,,,,1163
94e731c153488996c60fd764b030ae90a5bb0639,0,Robert (Bobby) Evans,2014-09-23 13:43:27-05:00,"['a9fb9c58c90fcd18386bf2ecfc7e3197b2dd526e', '32ff6e1fd62a64e156b58af24924ec7b7d5277a4']",0,16,16,718877,1,,,,1163
cfcedcf4ad5e5c96fe3f30a0b710cfc604063231,0,Robert (Bobby) Evans,2014-09-23 13:43:57-05:00,['94e731c153488996c60fd764b030ae90a5bb0639'],0,1,1,718878,1,,,,1163
429ead716da22466299e3f3f12933ec62de3f9c9,0,Robert (Bobby) Evans,2014-09-23 13:52:04-05:00,"['5a277f8378460e4d9622dc8cfb09ddf088f5a3f9', 'f5db183648ea2cac5fead49efbc6dfc12df823a4']",1,1,2,718880,1,,,,1163
23271ccee2ad74a055e56021c336d6471c6c26e8,0,Derek Dagit,2014-09-23 14:03:59-05:00,['4f5f7bf67d9dc94b406679772292fd13accb0041'],10,9,19,718899,1,,,,1163
e08bf4b502db76132424d15d1e9540d113bf19ee,0,Robert (Bobby) Evans,2014-09-23 16:11:48-05:00,"['429ead716da22466299e3f3f12933ec62de3f9c9', 'b0cdf65da8542ffffca8b3caffbd7921866a5649']",3,48,51,718950,4,,,,1163
aa6e7ed768797a3cb1674de61bb5a7c23f221bc1,0,Robert (Bobby) Evans,2014-09-23 16:34:01-05:00,"['e08bf4b502db76132424d15d1e9540d113bf19ee', 'f8cb7b594aaad68e9298914610f200e970f4eb11']",27,46,73,719023,4,,,,1163
985fb1f531de086a9b1d75df6fb05945a1517230,0,Derek Dagit,2014-09-24 00:50:30-05:00,['cfcedcf4ad5e5c96fe3f30a0b710cfc604063231'],4,5,9,719032,1,,,,1163
9d605deedcbfcd5e35c697d53e87660ed51a97b2,0,Derek Dagit,2014-09-24 12:14:39-05:00,['23271ccee2ad74a055e56021c336d6471c6c26e8'],9,6,15,719047,1,,,,1163
154ec7b6daec34c6289eaed1846d6bfba809f6ab,0,Robert (Bobby) Evans,2014-09-24 12:55:04-05:00,"['aa6e7ed768797a3cb1674de61bb5a7c23f221bc1', 'cfcedcf4ad5e5c96fe3f30a0b710cfc604063231']",316,2259,2575,721622,38,,,,1163
b0974a37ba4abeb834d1d1729ad11f6b4e43fa28,0,Robert (Bobby) Evans,2014-09-24 14:38:46-05:00,"['cfcedcf4ad5e5c96fe3f30a0b710cfc604063231', '766106a1f19d4b71082efeb1b59331eef6587900']",0,1,1,721623,1,,,,1163
d45c1875c966ef77197910ed4ae41702ea22ec1b,0,Robert (Bobby) Evans,2014-09-24 14:42:06-05:00,"['154ec7b6daec34c6289eaed1846d6bfba809f6ab', 'ce0b18a3915f1020042b90ca3e981e586175732b']",3,2,5,721628,2,,,,1163
4d0c6500b59e4b7cb74cc37b5849ae041092a59b,0,Parth Brahmbhatt,2014-09-24 13:12:38-07:00,['4cb2eeee4cfec72a638ba149e5aa5cda725d5c9d'],1,73,74,721702,1,,,,1163
55231b27922a7cccf7592ebc82de37791a097a07,0,Parth Brahmbhatt,2014-09-24 13:43:09-07:00,"['cccd4a5336c230ef1fca3a6f23aa55aabc9428fe', 'b0974a37ba4abeb834d1d1729ad11f6b4e43fa28']",293,2265,2558,724260,42,,,,1163
7f29b73b477a4f5e12958ccbdf5b6724395c7d5b,0,Robert (Bobby) Evans,2014-09-24 15:53:13-05:00,['b0974a37ba4abeb834d1d1729ad11f6b4e43fa28'],0,6,6,724266,2,,,,1163
46f058854d6ad4e5cad41739c397b703366eaf36,0,Robert (Bobby) Evans,2014-09-24 15:53:13-05:00,['7f29b73b477a4f5e12958ccbdf5b6724395c7d5b'],0,2,2,724268,2,,,,1163
695453619706edb706df8dcb54561e9d17e837a0,0,Michael G. Noll,2014-09-25 12:08:04+02:00,"['46f058854d6ad4e5cad41739c397b703366eaf36', '2596e335f27a57784a93a57823bd93dde587909f']",1,3,4,724272,3,,,,1163
70f98f57fa5f2aa9ab720be4712c2170b4e1c2e9,0,Michael G. Noll,2014-09-25 13:15:31+02:00,['695453619706edb706df8dcb54561e9d17e837a0'],13,13,26,724298,1,,,,1163
3c18fd76971f00a1c691d1c1b74f320115c4bc72,0,Kishor Patil,2014-09-25 13:33:38-05:00,['cfcedcf4ad5e5c96fe3f30a0b710cfc604063231'],1,3,4,724302,1,,,,1163
d2ca0b344fe685c2978c55b9792cde1ef8273eda,0,wurstmeister,2014-09-25 23:26:17+01:00,['695453619706edb706df8dcb54561e9d17e837a0'],333,192,525,724827,7,0,0,0,1164
9553b1486b35b35d5895ded1cc892096aadf3055,0,wurstmeister,2014-09-25 23:26:35+01:00,['d2ca0b344fe685c2978c55b9792cde1ef8273eda'],6,4,10,724837,2,0,0,1,1164
a56ccc7f5f98b34587c307d4cbdb90c91ce947de,0,Michael G. Noll,2014-09-26 16:04:46+02:00,['70f98f57fa5f2aa9ab720be4712c2170b4e1c2e9'],0,1,1,724838,1,,,,1164
ed593480ba543127c9491b5beab68ca49c6bd9a1,0,Rick Kilgore,2014-09-26 16:10:49-07:00,"['36c5dc5169555325e9e7680939b2f87d6de44487', 'a56ccc7f5f98b34587c307d4cbdb90c91ce947de']",50,1179,1229,726067,26,,,,1164
95abbc501c8f29d08dcd1e6200e7ded65c41512e,1,Viktor Taranenko,2014-09-27 15:24:15+01:00,['a56ccc7f5f98b34587c307d4cbdb90c91ce947de'],38,50,88,726155,4,0.25,0.25,1,1165
84002179cf7ae5879c93e900f64a7e576ce4cce1,0,Sriharsha Chintalapani,2014-09-29 10:17:06-07:00,"['02f6db5783f75a88ba305430991f6fda0bfc7b1a', 'd45c1875c966ef77197910ed4ae41702ea22ec1b']",354,2374,2728,728883,47,,,,1165
11e6fc9821d7d7e676d573836c08272ce18385f2,1,Sriharsha Chintalapani,2014-09-29 13:57:07-07:00,['84002179cf7ae5879c93e900f64a7e576ce4cce1'],12,26,38,728921,3,0,0,0,1165
3265508bde30144a18c33b748c37f84d5e31bb9c,0,P. Taylor Goetz,2014-09-30 09:17:49-07:00,['a56ccc7f5f98b34587c307d4cbdb90c91ce947de'],2,2,4,728925,1,,,,1165
c683d45ad1d2e6172764ce411fea34044e81c882,0,P. Taylor Goetz,2014-09-30 10:46:56-07:00,['a56ccc7f5f98b34587c307d4cbdb90c91ce947de'],8,8,16,728941,8,,,,1165
5d1c7c327ac804e99e75a19d8c51e79371b8f2f6,0,P. Taylor Goetz,2014-09-30 11:43:25-07:00,['c683d45ad1d2e6172764ce411fea34044e81c882'],12,12,24,728965,1,,,,1165
0f6719d4303cae6fc8521b802bf86f077278e160,0,Sriharsha Chintalapani,2014-09-30 11:43:37-07:00,['11e6fc9821d7d7e676d573836c08272ce18385f2'],2,0,2,728967,1,1,1,1,1165
24b5eefb1553ae37951807502a433f24d3e95ec1,0,Robert (Bobby) Evans,2014-09-30 13:49:28-05:00,['5d1c7c327ac804e99e75a19d8c51e79371b8f2f6'],0,1,1,728968,1,,,,1165
6c6bec9b1b2b07b5dfb5000297c11911eda5389d,0,Niels Basjes,2014-10-01 11:50:48+02:00,['24b5eefb1553ae37951807502a433f24d3e95ec1'],3,14,17,728985,2,1,1,1,1165
73e54a8f8b0ef9a62955c7c1cee20925d359772b,1,Niels Basjes,2014-10-01 11:51:42+02:00,['6c6bec9b1b2b07b5dfb5000297c11911eda5389d'],0,4,4,728989,1,0,1,1,1165
8888ae631360ad124af9c480d2f8b621b9c51727,0,Niels Basjes,2014-10-01 11:53:17+02:00,['73e54a8f8b0ef9a62955c7c1cee20925d359772b'],1,1,2,728991,1,,,,1165
3cda45d5045eafc35a9aaa4136681fe5628360de,0,Rick Kilgore,2014-10-01 13:29:19-07:00,"['77c2df28517f9b9acd87724116d9b7b3573be4fc', 'ed593480ba543127c9491b5beab68ca49c6bd9a1']",74,1236,1310,730301,34,,,,1165
9faf431ff347549380e5a1cf34273018daa815ac,0,Rick Kilgore,2014-10-01 13:29:41-07:00,"['40ab899fe3d67e77c9f1678dbc70d19dd2faf065', 'ed593480ba543127c9491b5beab68ca49c6bd9a1']",50,1179,1229,731530,26,,,,1165
d49d014c0c540cebd0a985ace52c57fc5ee88ec7,0,Rick Kilgore,2014-10-01 13:41:45-07:00,"['3cda45d5045eafc35a9aaa4136681fe5628360de', '9faf431ff347549380e5a1cf34273018daa815ac']",1,1,2,731532,1,,,,1165
fabd682a2880cc77ff025cb7c09ad19834d47539,0,Rick Kilgore,2014-10-01 14:16:26-07:00,['d49d014c0c540cebd0a985ace52c57fc5ee88ec7'],55,438,493,732025,10,,,,1166
2bf7f6fa1321ca720f2f03d34b638fa502a7e61b,0,Rick Kilgore,2014-10-01 14:18:16-07:00,['fabd682a2880cc77ff025cb7c09ad19834d47539'],0,1,1,732026,1,,,,1166
96dfa412663722f31b493bb8cd8ec7829d148472,0,Rick Kilgore,2014-10-01 14:19:19-07:00,['2bf7f6fa1321ca720f2f03d34b638fa502a7e61b'],417,0,417,732443,1,,,,1166
f3421fbe36a3391b2e621b69f47d9b5d066161cc,0,P. Taylor Goetz,2014-10-01 15:39:25-07:00,"['5d1c7c327ac804e99e75a19d8c51e79371b8f2f6', '0b457f22865e4ab3be5b55f17271528b2c461c70']",1,1,2,732445,1,,,,1166
39ca6f7bd0caf0bec8ba3be5d955860085ba2460,0,P. Taylor Goetz,2014-10-01 15:43:39-07:00,['f3421fbe36a3391b2e621b69f47d9b5d066161cc'],0,1,1,732446,1,,,,1166
f72dad8b2d290c607c7c5a9551ae9f4780268f13,0,P. Taylor Goetz,2014-10-01 15:45:01-07:00,"['39ca6f7bd0caf0bec8ba3be5d955860085ba2460', '24b5eefb1553ae37951807502a433f24d3e95ec1']",0,1,1,732447,1,,,,1166
3f2eec5ff3db9cdb72bd34027c9441e22e599dc2,0,P. Taylor Goetz,2014-10-01 15:48:40-07:00,"['f72dad8b2d290c607c7c5a9551ae9f4780268f13', '9553b1486b35b35d5895ded1cc892096aadf3055']",339,196,535,732982,9,,,,1166
ae710546c4295f0b2a21f8fa993c7f7310855787,0,Rick Kilgore,2014-10-01 15:52:00-07:00,['96dfa412663722f31b493bb8cd8ec7829d148472'],2,2,4,732986,2,,,,1166
a49aebb930847c4e5b76228464758ec4125aea63,0,P. Taylor Goetz,2014-10-01 15:56:43-07:00,"['3f2eec5ff3db9cdb72bd34027c9441e22e599dc2', '3c18fd76971f00a1c691d1c1b74f320115c4bc72']",1,3,4,732990,1,,,,1166
0390891b5178919bc0b92ca27a0a25b314a7e3a6,0,P. Taylor Goetz,2014-10-01 15:58:01-07:00,['a49aebb930847c4e5b76228464758ec4125aea63'],0,1,1,732991,1,,,,1166
9f712703e3c1017f79054a59230ce0a462504251,0,P. Taylor Goetz,2014-10-01 15:59:44-07:00,"['0390891b5178919bc0b92ca27a0a25b314a7e3a6', '4c515dd71f4b9fb42ca56b738de7758236547046']",0,2792,2792,735783,34,,,,1166
43a978fde3fb71f93438d0df939c745c186ae67f,0,P. Taylor Goetz,2014-10-01 16:00:47-07:00,['9f712703e3c1017f79054a59230ce0a462504251'],0,1,1,735784,1,,,,1166
38367b0d43ba9a57ecfba3830f3a11414769ca3c,0,P. Taylor Goetz,2014-10-01 16:07:07-07:00,['43a978fde3fb71f93438d0df939c745c186ae67f'],1,3,4,735788,1,,,,1166
3c699e371a1aba32bdbcd1853edca80f4a00b7e9,0,Rick Kilgore,2014-10-01 17:08:14-07:00,"['ae710546c4295f0b2a21f8fa993c7f7310855787', '38367b0d43ba9a57ecfba3830f3a11414769ca3c']",361,3018,3379,739167,53,,,,1166
9f682eb3c024d3742e905078c4065b0cbfadf163,0,Michael G. Noll,2014-10-02 09:32:01+02:00,['38367b0d43ba9a57ecfba3830f3a11414769ca3c'],5,4,9,739176,1,,,,1166
5aaea8460878d3ad75cf1769381e5ab4052ec319,0,Michael G. Noll,2014-10-02 09:42:35+02:00,['9f682eb3c024d3742e905078c4065b0cbfadf163'],0,1,1,739177,1,,,,1166
b3528c7d9bcb5a04bc5bac5f7ea571f0c8ea0984,1,Michael G. Noll,2014-10-02 10:07:27+02:00,['5aaea8460878d3ad75cf1769381e5ab4052ec319'],0,1,1,739178,1,,,,1166
c6aabd4a8726766eb72d6a2b35b00c680b876ab3,0,Jungtaek Lim,2014-10-03 02:57:30+09:00,['a56ccc7f5f98b34587c307d4cbdb90c91ce947de'],1,4,5,739183,2,,,,1166
00d905103c73e485e4c898163bd9a9a1755ff6be,0,Jungtaek Lim,2014-10-03 09:35:53+09:00,['c6aabd4a8726766eb72d6a2b35b00c680b876ab3'],6,8,14,739197,2,,,,1166
7a93dd6c6c5d2aec27512232c407750c5aa8a150,0,Jungtaek Lim,2014-10-03 09:57:04+09:00,['00d905103c73e485e4c898163bd9a9a1755ff6be'],8,8,16,739213,2,,,,1166
882dfc5fb7b3b26a17e4a1ee5f91220cd80fc4dd,0,Rick Kilgore,2014-10-02 23:12:01-07:00,['3c699e371a1aba32bdbcd1853edca80f4a00b7e9'],15,81,96,739309,1,0.15625,0.15625,1,1166
ed4861d83357dcb13cd32621fa18d1d03497a8a0,1,Jungtaek Lim,2014-10-03 16:18:40+09:00,['5aaea8460878d3ad75cf1769381e5ab4052ec319'],27,32,59,739368,1,,,,1166
be66015dfbfad20451b66db35efb16fef50878c9,0,Sriharsha Chintalapani,2014-10-04 09:33:20-07:00,"['5aaea8460878d3ad75cf1769381e5ab4052ec319', '3265508bde30144a18c33b748c37f84d5e31bb9c']",2,2,4,739372,1,,,,1166
1babd831334d2654b50da7fc73c61d91905f768d,0,Sriharsha Chintalapani,2014-10-04 09:45:26-07:00,['be66015dfbfad20451b66db35efb16fef50878c9'],0,1,1,739373,1,,,,1166
786aacca25227dd97e2e473e3c5a09a66aa0fb8f,0,Jungtaek Lim,2014-10-05 02:04:35+09:00,['7a93dd6c6c5d2aec27512232c407750c5aa8a150'],1,1,2,739375,1,,,,1166
62f4f44566d2332af1715ea23c437bb669b92d12,0,Jungtaek Lim,2014-10-05 02:08:19+09:00,['786aacca25227dd97e2e473e3c5a09a66aa0fb8f'],0,3,3,739378,1,,,,1166
b2ecd44a7ee13d6c98171c63d056bdef481d6e0f,1,Wurstmeister,2014-10-05 21:46:24+01:00,['1babd831334d2654b50da7fc73c61d91905f768d'],9,33,42,739420,2,0,0,1,1166
ccde2332da9ae2c4b43e38651cc0d08ae0ebdb18,0,Wurstmeister,2014-10-06 10:17:26+01:00,['b2ecd44a7ee13d6c98171c63d056bdef481d6e0f'],17,21,38,739458,1,1,1,1,1166
50c4c346afa1eb04d0ebeb57aec40b47ad663dce,0,Parth Brahmbhatt,2014-10-06 10:59:21-07:00,"['4d0c6500b59e4b7cb74cc37b5849ae041092a59b', '1babd831334d2654b50da7fc73c61d91905f768d']",417,4204,4621,744079,77,,,,1166
f87bb3135b4dcfd2b73689a35bf0b73a6cc5bc75,0,Parth Brahmbhatt,2014-10-06 15:21:28-07:00,['1babd831334d2654b50da7fc73c61d91905f768d'],6,11,17,744096,5,0,1,1,1166
e738e27ed8a24b30143c229a3b8405271372ca23,0,joe,2014-10-07 08:26:16+08:00,['1babd831334d2654b50da7fc73c61d91905f768d'],5,1,6,744102,1,,,,1166
c0e51a281f3de5715e8108e9f556e32a0f501f79,0,joe,2014-10-07 08:41:05+08:00,['e738e27ed8a24b30143c229a3b8405271372ca23'],1,5,6,744108,1,,,,1166
6ede0787ea7401ff98f6c4bb2adf5df9153a1b7a,0,joe,2014-10-07 08:49:42+08:00,['c0e51a281f3de5715e8108e9f556e32a0f501f79'],5,1,6,744114,1,,,,1166
dbd431f35e660631afee5f82b15f980e4216c7fd,0,P. Taylor Goetz,2014-10-07 15:20:44-04:00,"['1babd831334d2654b50da7fc73c61d91905f768d', '55231b27922a7cccf7592ebc82de37791a097a07']",313,49,362,744476,11,,,,1166
53245c25ffb7a41de76ebf5c0558286a04a47d35,0,P. Taylor Goetz,2014-10-07 15:24:09-04:00,['dbd431f35e660631afee5f82b15f980e4216c7fd'],10,10,20,744496,1,,,,1166
88b85e63913ff7b5a63533dd9fa7bedbe8df7f2a,0,P. Taylor Goetz,2014-10-07 15:25:44-04:00,['53245c25ffb7a41de76ebf5c0558286a04a47d35'],0,1,1,744497,1,,,,1166
84afd4582bdf538975c40bd5f36c6b4f02c605c4,0,P. Taylor Goetz,2014-10-07 15:26:35-04:00,['88b85e63913ff7b5a63533dd9fa7bedbe8df7f2a'],1,1,2,744499,1,,,,1166
8079245ba9688321da1c090e648caa77430cbff2,0,P. Taylor Goetz,2014-10-07 16:14:32-04:00,['84afd4582bdf538975c40bd5f36c6b4f02c605c4'],9,3,12,744511,3,,,,1166
fc641a2da3079eba7c2980ce7ff5afcee8be407e,1,P. Taylor Goetz,2014-10-07 16:20:17-04:00,['8079245ba9688321da1c090e648caa77430cbff2'],0,474,474,744985,2,0.886792453,0.886792453,0.86163522,1168
588fd378d33bbd4de4a77e602a74706e61e489e9,0,P. Taylor Goetz,2014-10-07 16:32:58-04:00,['fc641a2da3079eba7c2980ce7ff5afcee8be407e'],0,1,1,744986,1,,,,1168
9e63e85eaa538e79882bbe1ae749a533d368ffd3,0,P. Taylor Goetz,2014-10-07 16:33:05-04:00,"['588fd378d33bbd4de4a77e602a74706e61e489e9', '985fb1f531de086a9b1d75df6fb05945a1517230']",4,5,9,744995,1,,,,1168
d50b772fb3240c6908699c65c32895791f8c2630,0,P. Taylor Goetz,2014-10-07 16:34:24-04:00,['9e63e85eaa538e79882bbe1ae749a533d368ffd3'],0,1,1,744996,1,,,,1168
9b754ee4309786fc4c58468679506d57cd8a5072,0,P. Taylor Goetz,2014-10-07 16:42:59-04:00,"['d50b772fb3240c6908699c65c32895791f8c2630', 'b3528c7d9bcb5a04bc5bac5f7ea571f0c8ea0984']",0,1,1,744997,1,,,,1168
42a6dbd0f48e31590485fd46c303b01c4b3279d6,0,P. Taylor Goetz,2014-10-07 16:44:58-04:00,['9b754ee4309786fc4c58468679506d57cd8a5072'],0,1,1,744998,1,,,,1168
533f7baebff24331c983ae9caecfa085968c3d11,0,P. Taylor Goetz,2014-10-07 16:49:33-04:00,"['42a6dbd0f48e31590485fd46c303b01c4b3279d6', '3b609c21fee42951b6260d5344b7fc88fa2d96ab']",349,350,699,745697,2,,,,1168
e9953aff4a8c42ec363cd1d81719c970446dc5b6,0,P. Taylor Goetz,2014-10-07 16:50:51-04:00,['533f7baebff24331c983ae9caecfa085968c3d11'],1,0,1,745698,1,,,,1168
d2707d3c37d9191ca0754243c64099ddd4a07422,0,P. Taylor Goetz,2014-10-07 16:51:55-04:00,['e9953aff4a8c42ec363cd1d81719c970446dc5b6'],0,349,349,746047,1,0.899441341,0.899441341,0.944134078,1169
7ab4f2418b99ebec0c27c4042942a26e4f4972be,0,P. Taylor Goetz,2014-10-07 17:16:17-04:00,['d2707d3c37d9191ca0754243c64099ddd4a07422'],9,7,16,746063,1,,,,1169
fce22a7d48928730873fb9e7eb1724ea72fca356,0,Derek Dagit,2014-10-07 16:24:31-05:00,"['d45c1875c966ef77197910ed4ae41702ea22ec1b', 'b07eff3fd86eed1fd67c1159e03d52e583b655e8']",9,13,22,746085,2,,,,1169
4788c7ecebefb670c1dbe85a32ed26bd85c4e807,0,Derek Dagit,2014-10-07 16:27:56-05:00,"['fce22a7d48928730873fb9e7eb1724ea72fca356', '02f6db5783f75a88ba305430991f6fda0bfc7b1a']",1,1,2,746087,1,,,,1169
f5ac420ba240be888e7c65d4fb5955923b0a2a38,0,Parth Brahmbhatt,2014-10-07 15:09:13-07:00,['50c4c346afa1eb04d0ebeb57aec40b47ad663dce'],22,135,157,746244,3,0.661016949,1,1,1170
b074843ef4dc8e8f987071c42a12ad0c6c7b120d,0,Parth Brahmbhatt,2014-10-07 15:16:45-07:00,"['f5ac420ba240be888e7c65d4fb5955923b0a2a38', '7ab4f2418b99ebec0c27c4042942a26e4f4972be']",415,971,1386,747630,19,,,,1170
ca5874cdf11af8d835335d228b643f28aeb3f9c3,1,Jungtaek Lim,2014-10-08 22:48:01+09:00,['5aaea8460878d3ad75cf1769381e5ab4052ec319'],75,233,308,747938,5,0.625,1,1,1170
1a0d4bdd735ba0ade42f6777a4c47affec931557,0,Jungtaek Lim,2014-10-08 23:06:24+09:00,['ca5874cdf11af8d835335d228b643f28aeb3f9c3'],168,165,333,748271,2,0,0,0,1170
0e24a4363c57a6aa4e994fc3b42fe347b3e58b9e,0,Parth Brahmbhatt,2014-10-08 11:05:06-07:00,['b074843ef4dc8e8f987071c42a12ad0c6c7b120d'],4,4,8,748279,2,,,,1170
050e8fd72c7aef8017a2c2d1ff9b95d5095544a1,0,Parth Brahmbhatt,2014-10-08 15:50:14-07:00,['0e24a4363c57a6aa4e994fc3b42fe347b3e58b9e'],16,38,54,748333,4,0,0,1,1170
932cecfc8b721d63e222e920aba377975c8ae89b,0,Parth Brahmbhatt,2014-10-09 09:22:43-07:00,['050e8fd72c7aef8017a2c2d1ff9b95d5095544a1'],12,14,26,748359,5,,,,1170
effb3eb762f997d3b08650a1c7298ab408897565,0,Derek Dagit,2014-10-09 11:46:40-05:00,['7ab4f2418b99ebec0c27c4042942a26e4f4972be'],1,1,2,748361,1,,,,1170
8c4eebf27cddfe1dca4d7c3618ffba7bf97d999d,0,P. Taylor Goetz,2014-10-09 15:54:19-04:00,"['7ab4f2418b99ebec0c27c4042942a26e4f4972be', 'f87bb3135b4dcfd2b73689a35bf0b73a6cc5bc75']",6,11,17,748378,5,,,,1170
1d9688d710f11e451526fd62109f59e7e63f7b91,0,P. Taylor Goetz,2014-10-09 16:25:11-04:00,['8c4eebf27cddfe1dca4d7c3618ffba7bf97d999d'],0,1,1,748379,1,,,,1170
3a4274c15492707cc944162c2380f33eb18c75ac,0,P. Taylor Goetz,2014-10-09 16:39:11-04:00,['1d9688d710f11e451526fd62109f59e7e63f7b91'],10,10,20,748399,10,,,,1170
cfe7e6313acc35a5c346480b4ac4e0d863d09410,0,P. Taylor Goetz,2014-10-09 17:22:26-04:00,['3a4274c15492707cc944162c2380f33eb18c75ac'],9,9,18,748417,9,,,,1170
f7732e6ab12cfae58b6df2681ab6bdf54de83b29,0,Patrick Lucas,2014-10-09 17:30:25-07:00,['cfe7e6313acc35a5c346480b4ac4e0d863d09410'],1,0,1,748418,1,,,,1170
4095078b44d7b6d2c177be65c0758b3194f5ce43,1,Jungtaek Lim,2014-10-11 21:43:05+09:00,['1a0d4bdd735ba0ade42f6777a4c47affec931557'],4,4,8,748426,2,,,,1170
899eaec53a9b0895924c703b825dc0118e47cc83,1,Itai Frenkel,2014-10-11 15:46:35+03:00,['cfe7e6313acc35a5c346480b4ac4e0d863d09410'],4,12,16,748442,2,0,1,1,1170
8b8a443cbf5896985e0ab38e69baadec57bbe5d0,1,Jungtaek Lim,2014-10-11 22:06:51+09:00,['4095078b44d7b6d2c177be65c0758b3194f5ce43'],0,1,1,748443,1,1,1,1,1170
6c09a9ee4a20cd73bb24b195f049f23d99a04d2f,0,Jungtaek Lim,2014-10-11 22:16:43+09:00,['8b8a443cbf5896985e0ab38e69baadec57bbe5d0'],1,1,2,748445,1,,,,1170
2af791a7f116812a396141bf737f959ea1b51f4c,0,Jungtaek Lim,2014-10-11 23:02:37+09:00,['6c09a9ee4a20cd73bb24b195f049f23d99a04d2f'],82,159,241,748686,5,0.388888889,1,1,1170
31443dcff2d3d1096621ade38c6b61292cea339d,1,Jungtaek Lim,2014-10-11 23:50:17+09:00,['2af791a7f116812a396141bf737f959ea1b51f4c'],12,16,28,748714,2,,,,1170
b6fda45124d163ff51674c5f5b889dc69a712c5b,1,Jungtaek Lim,2014-10-12 11:26:51+09:00,['31443dcff2d3d1096621ade38c6b61292cea339d'],23,19,42,748756,2,,,,1170
573003b45986cce417dccee46f7771b29a6bc337,0,Luke Demi,2014-10-13 22:23:33-04:00,['cfe7e6313acc35a5c346480b4ac4e0d863d09410'],3,3,6,748762,1,,,,1170
d22499734d74609ee2fb2bf4b16f2def932006b3,0,caofangkun,2014-10-15 16:50:57+08:00,['cfe7e6313acc35a5c346480b4ac4e0d863d09410'],9,9,18,748780,9,,,,1170
fa3833516e1855a9053ba13089089c09755b28bb,0,caofangkun,2014-10-15 17:08:39+08:00,['d22499734d74609ee2fb2bf4b16f2def932006b3'],9,9,18,748798,9,,,,1170
ea0b8a2a51332020a569ed7aeb3e0647477af763,1,Robert (Bobby) Evans,2014-10-15 11:05:10-05:00,"['4788c7ecebefb670c1dbe85a32ed26bd85c4e807', 'cfe7e6313acc35a5c346480b4ac4e0d863d09410']",717,3949,4666,753464,73,,,,1170
fd03e16f1a11bafb352dbda74f4b179ddf569bef,1,caofangkun,2014-10-16 09:57:48+08:00,['fa3833516e1855a9053ba13089089c09755b28bb'],20,149,169,753633,7,1,1,1,1173
766e9cfa1b67884b692b5e92f9afe8eb228c0df7,1,caofangkun,2014-10-16 10:29:42+08:00,['fd03e16f1a11bafb352dbda74f4b179ddf569bef'],1,2,3,753636,1,,,,1173
d34037d2d2b1a1e635d708e9367c5a29d2505eff,0,Viktor Taranenko,2014-10-20 22:20:34+01:00,['95abbc501c8f29d08dcd1e6200e7ded65c41512e'],1,1,2,753638,1,,,,1173
dc94bf47886c2c7b80f9eff8feec8054f6b9d43f,0,Damien Raude-Morvan,2014-10-21 01:05:36+02:00,['3a4274c15492707cc944162c2380f33eb18c75ac'],0,4,4,753642,1,,,,1173
aae64a0b71ca5bf524bf38542afd43ae6f785252,0,Damien Raude-Morvan,2014-10-21 01:13:33+02:00,"['dc94bf47886c2c7b80f9eff8feec8054f6b9d43f', 'cfe7e6313acc35a5c346480b4ac4e0d863d09410']",9,9,18,753660,9,,,,1173
d92e974a113bcaba656dd777985c520c8c9a4dd8,0,Jungtaek Lim,2014-10-22 08:31:27+09:00,['62f4f44566d2332af1715ea23c437bb669b92d12'],1,1,2,753662,1,,,,1173
16a3ce4a071f0a40ccb34de48c3e21830cdfacad,1,Parth Brahmbhatt,2014-10-21 17:56:20-07:00,['932cecfc8b721d63e222e920aba377975c8ae89b'],227,176,403,754065,14,0.385714286,0,0,1174
fbb326be7d6a105a7ce40ca06cd3937f9da9d138,0,Parth Brahmbhatt,2014-10-21 17:57:01-07:00,"['16a3ce4a071f0a40ccb34de48c3e21830cdfacad', 'cfe7e6313acc35a5c346480b4ac4e0d863d09410']",15,21,36,754101,14,,,,1174
f0701b333716cc6368daeee9f9c5a11383257293,1,Parth Brahmbhatt,2014-10-21 19:03:09-07:00,['fbb326be7d6a105a7ce40ca06cd3937f9da9d138'],12,2,14,754115,4,,,,1174
1897dee648686282d3bee948ed04c01b8bae729a,0,P. Taylor Goetz,2014-10-22 15:52:59-04:00,"['cfe7e6313acc35a5c346480b4ac4e0d863d09410', 'd34037d2d2b1a1e635d708e9367c5a29d2505eff']",38,50,88,754203,4,,,,1174
046262abd2d796a2056f7ce9c49294beacd0849c,0,Parth Brahmbhatt,2014-10-22 13:07:25-07:00,['f0701b333716cc6368daeee9f9c5a11383257293'],1,3,4,754207,1,,,,1174
376ff8ebe22b92f7bc9b4311077ac669d22764d9,0,Michael Pershyn,2014-10-23 15:29:00+02:00,['cfe7e6313acc35a5c346480b4ac4e0d863d09410'],2,2,4,754211,1,,,,1174
67b5f56c1ff3905c88eb85dbb8985c7bb8342de9,1,P. Taylor Goetz,2014-10-23 16:27:07-04:00,['1897dee648686282d3bee948ed04c01b8bae729a'],9,6,15,754226,3,0,0,0.5,1174
588907ddc1336356ca01ffaa8b07e2812865a642,0,Viktor Taranenko,2014-10-23 22:15:20+01:00,"['d34037d2d2b1a1e635d708e9367c5a29d2505eff', 'cfe7e6313acc35a5c346480b4ac4e0d863d09410']",714,3935,4649,758875,70,,,,1174
e61162c4ccdc65ea3309f289b4640648b6555b12,0,Viktor Taranenko,2014-10-23 22:33:51+01:00,"['588907ddc1336356ca01ffaa8b07e2812865a642', '67b5f56c1ff3905c88eb85dbb8985c7bb8342de9']",9,6,15,758890,3,,,,1174
12d31b4dd7b067fec5ccba794f640a3e77f1b05e,0,Jungtaek Lim,2014-10-24 19:28:37+09:00,['b6fda45124d163ff51674c5f5b889dc69a712c5b'],15,21,36,758926,1,1,0,,1174
3fc7f30ed693354f014f00948c527e0f2273c66c,0,P. Taylor Goetz,2014-10-27 15:51:16-04:00,['6212947b891896bccd0bc03ed58fbcc48472574f'],4,3,7,758933,3,1,0,0,1174
04a7937dd5d031f15ae35b37d5ab031fd39130a5,0,Robert (Bobby) Evans,2014-10-27 14:52:32-05:00,"['ea0b8a2a51332020a569ed7aeb3e0647477af763', '0f6719d4303cae6fc8521b802bf86f077278e160']",12,24,36,758969,3,,,,1174
e757b6cb1e111b61956588fc2819d4466356d6ee,0,P. Taylor Goetz,2014-10-27 16:47:02-04:00,"['aae64a0b71ca5bf524bf38542afd43ae6f785252', 'e61162c4ccdc65ea3309f289b4640648b6555b12']",38,47,85,759054,4,,,,1174
8ccb15dfecb53417e38b509c93bfb7492ea21985,0,P. Taylor Goetz,2014-10-27 16:50:15-04:00,"['e757b6cb1e111b61956588fc2819d4466356d6ee', '376ff8ebe22b92f7bc9b4311077ac669d22764d9']",2,2,4,759058,1,,,,1174
5a460384f4eb90e4e3870f29090e81633aeafe7b,0,P. Taylor Goetz,2014-10-27 16:53:17-04:00,['8ccb15dfecb53417e38b509c93bfb7492ea21985'],0,5,5,759063,1,,,,1174
2e9e36f90a691d517d7472b6f9f4a1b6921c7881,0,joe,2014-10-28 22:25:28+08:00,"['6ede0787ea7401ff98f6c4bb2adf5df9153a1b7a', '5a460384f4eb90e4e3870f29090e81633aeafe7b']",400,981,1381,760444,37,,,,1174
59b2a42af4419e9217849add60e62a0c863c1ece,0,Niels Basjes,2014-10-29 15:50:18+01:00,['8888ae631360ad124af9c480d2f8b621b9c51727'],37,2,39,760483,3,0,0,0,1174
1aacccf286829e9289d86a6ed10b23cb2b21bc47,0,Sergey Tryuber,2014-10-29 18:36:35+03:00,['5a460384f4eb90e4e3870f29090e81633aeafe7b'],15,165,180,760663,2,0,0,1,1174
ac5a18dc30ee6e9257eb5c18c0c87e7c7e944b23,0,JuDasheng,2014-10-30 11:46:21+08:00,['5a460384f4eb90e4e3870f29090e81633aeafe7b'],2,9,11,760674,1,0,1,1,1174
cd47f1d6e4165f8e3393aa5be01d02f4148c3216,0,Niels Basjes,2014-10-30 10:27:05+01:00,['59b2a42af4419e9217849add60e62a0c863c1ece'],0,1,1,760675,1,0,1,1,1174
1d251e99850eb8969ac69021f1f78f8e40434305,0,Sergey Tryuber,2014-10-31 17:55:14+03:00,['1aacccf286829e9289d86a6ed10b23cb2b21bc47'],3,1,4,760679,2,,,,1174
a73a74aab09c42398994fcfbbde55109a0c10001,0,root,2014-11-04 09:26:26+08:00,"['5a460384f4eb90e4e3870f29090e81633aeafe7b', 'f259f1da288171a9393fb500150d034ccca0d146']",7,7,14,760693,1,,,,1174
f2b3f83722fe5cdaa4ea77b3c9909859aa9c7f79,0,root,2014-11-04 10:31:07+08:00,['a73a74aab09c42398994fcfbbde55109a0c10001'],0,1,1,760694,1,,,,1174
b64e7b7a74126f5dbf01ff257090f6396ed38ab2,0,root,2014-11-04 13:59:41+08:00,"['f2b3f83722fe5cdaa4ea77b3c9909859aa9c7f79', '727dd1d5ea36aadf05ed8ae50435aaa40a46d664']",1,10,11,760705,1,,,,1174
cffe7df27cf0df83aacef6ddab4b92df2c7cdc59,0,Sean Zhong,2014-11-04 19:29:55+08:00,"['b64e7b7a74126f5dbf01ff257090f6396ed38ab2', '899eaec53a9b0895924c703b825dc0118e47cc83']",4,12,16,760721,2,,,,1174
93c4d7e5d34f2a781d87bf1956d7cc654db828d2,0,Sean Zhong,2014-11-04 19:43:40+08:00,"['cffe7df27cf0df83aacef6ddab4b92df2c7cdc59', 'ccde2332da9ae2c4b43e38651cc0d08ae0ebdb18']",8,36,44,760765,2,,,,1174
a1e1c1e206bcc22d0721226531fb1328c2d8cd53,0,Sean Zhong,2014-11-04 20:07:08+08:00,"['93c4d7e5d34f2a781d87bf1956d7cc654db828d2', 'c99145c93130e93bff8132516fafbecead815ea8']",2,8,10,760775,2,,,,1174
1b8a32e2c3e8e624fc1ca1863898c3a10834151e,0,Sean Zhong,2014-11-04 20:28:56+08:00,"['a1e1c1e206bcc22d0721226531fb1328c2d8cd53', 'd92e974a113bcaba656dd777985c520c8c9a4dd8']",2,10,12,760787,3,,,,1174
ff23d6462efea5275b4e4c8c1af9189c67b7412a,0,Sean Zhong,2014-11-04 20:47:47+08:00,"['1b8a32e2c3e8e624fc1ca1863898c3a10834151e', 'f7732e6ab12cfae58b6df2681ab6bdf54de83b29']",1,0,1,760788,1,,,,1174
7832412302aed27f7403dfad550c9748b8a012f3,0,Sean Zhong,2014-11-04 20:49:49+08:00,"['ff23d6462efea5275b4e4c8c1af9189c67b7412a', '573003b45986cce417dccee46f7771b29a6bc337']",3,3,6,760794,1,,,,1174
7602f436798e9c5775b4567e8b33bd9146c317d4,0,Sean Zhong,2014-11-04 22:22:57+08:00,['7832412302aed27f7403dfad550c9748b8a012f3'],0,1,1,760795,1,,,,1174
a370c16780d143eb756c428c4c6a26dac05de5ab,0,Homer Strong,2014-11-04 08:30:20-08:00,['7602f436798e9c5775b4567e8b33bd9146c317d4'],2,4,6,760801,1,,,,1174
69ddc67a2b0ca527368ca7a27ac58621c745037b,0,Jungtaek Lim,2014-11-05 06:44:04+09:00,"['12d31b4dd7b067fec5ccba794f640a3e77f1b05e', '7602f436798e9c5775b4567e8b33bd9146c317d4']",420,1075,1495,762296,48,,,,1174
dee91cfa3f73cdd3da6921593a71ec60ae304091,0,Sergey Tryuber,2014-11-05 09:02:10+03:00,['1d251e99850eb8969ac69021f1f78f8e40434305'],146,1,147,762443,2,,,,1174
1a3adec6434de8d4b656d779492e5a22ec655830,0,Sergey Tryuber,2014-11-05 09:10:12+03:00,['dee91cfa3f73cdd3da6921593a71ec60ae304091'],2,1,3,762446,1,,,,1174
f9707b58e7664a0618776bea91402b895541ab00,1,caofangkun,2014-11-05 16:56:40+08:00,['cfe7e6313acc35a5c346480b4ac4e0d863d09410'],2,3,5,762451,1,,,,1174
f880d619972bbbb0a1c3519298efbce260112ea6,0,Jungtaek Lim,2014-11-06 07:07:22+09:00,['7602f436798e9c5775b4567e8b33bd9146c317d4'],10,2,12,762463,3,,,,1174
356f9f8b6e986d5e9113ade5a80a228d15b7bc86,0,Jungtaek Lim,2014-11-06 07:20:24+09:00,['f880d619972bbbb0a1c3519298efbce260112ea6'],2,11,13,762476,3,,,,1174
ec2d33c9f340f0b718c06dcd5dcd2df9490bc535,0,Sriharsha Chintalapani,2014-11-06 09:19:28-08:00,['356f9f8b6e986d5e9113ade5a80a228d15b7bc86'],0,1,1,762477,1,,,,1174
baf7e2c48a7b5340cfd169efa638fa2f1fa03eab,0,P. Taylor Goetz,2014-11-07 12:40:13-05:00,['ec2d33c9f340f0b718c06dcd5dcd2df9490bc535'],3,26,29,762506,2,,,,1174
0505d47471170861ad303dc530a8d8de4e730c10,0,Sean T Allen,2014-11-08 09:41:29-05:00,['baf7e2c48a7b5340cfd169efa638fa2f1fa03eab'],1,1,2,762508,1,,,,1174
04583cfe70db13d6b916ef34467b7ca1205b03f2,0,Homer Strong,2014-11-08 13:05:04-08:00,['a370c16780d143eb756c428c4c6a26dac05de5ab'],0,6,6,762514,1,,,,1174
46ffd19e910fea1979be547ad7894faf0dcc371f,1,Homer Strong,2014-11-08 13:06:23-08:00,['04583cfe70db13d6b916ef34467b7ca1205b03f2'],6,3,9,762523,2,,,,1174
b782852c3c8b5771c3ba12dadfc4e8c5e67d12ec,0,Homer Strong,2014-11-08 14:19:21-08:00,['46ffd19e910fea1979be547ad7894faf0dcc371f'],2,2,4,762527,1,,,,1174
5c9d06bcb280c5059497929d7910a9a8d07349ac,0,Jungtaek Lim,2014-11-09 12:12:13+09:00,['0505d47471170861ad303dc530a8d8de4e730c10'],0,32,32,762559,1,,,,1174
cc633a9420962c3b93a396e4dabb978e4e373492,0,Sean T Allen,2014-11-08 23:23:09-05:00,"['0505d47471170861ad303dc530a8d8de4e730c10', '5c9d06bcb280c5059497929d7910a9a8d07349ac']",0,32,32,762591,1,,,,1174
d23495056f0b870e1ef4bebbae586965e2f21340,0,caofangkun,2014-11-11 16:56:54+08:00,['cfe7e6313acc35a5c346480b4ac4e0d863d09410'],1,10,11,762602,3,0,1,1,1174
94065004b1088bc3d61792bf51e41ad3ff92545b,0,Sean Zhong,2014-11-12 19:47:27+08:00,"['7602f436798e9c5775b4567e8b33bd9146c317d4', '1a3adec6434de8d4b656d779492e5a22ec655830']",14,16,30,762632,2,,,,1174
e15dbe281ae734e9fa46fad75b8efafadb0c2df3,0,Sean Zhong,2014-11-12 19:50:17+08:00,"['94065004b1088bc3d61792bf51e41ad3ff92545b', 'baf7e2c48a7b5340cfd169efa638fa2f1fa03eab']",6,31,37,762669,6,,,,1174
cc9b24ec3634af707147f5205f8e2066e8300cd8,0,Sriharsha Chintalapani,2014-11-12 08:43:34-08:00,"['e15dbe281ae734e9fa46fad75b8efafadb0c2df3', 'b782852c3c8b5771c3ba12dadfc4e8c5e67d12ec']",5,10,15,762684,3,,,,1174
e6b18863e1cc5a5af8c7d1da703d31d9e17b70bf,0,Robert (Bobby) Evans,2014-11-12 10:43:41-06:00,"['04a7937dd5d031f15ae35b37d5ab031fd39130a5', 'e15dbe281ae734e9fa46fad75b8efafadb0c2df3']",82,188,270,762954,24,,,,1174
964188fb7a3314ff3097ddd59684f496449e6045,0,Sriharsha Chintalapani,2014-11-12 08:46:10-08:00,['cc9b24ec3634af707147f5205f8e2066e8300cd8'],0,1,1,762955,1,,,,1174
64f06c70b55bff830b62c5f7c4dfed89ea03692e,0,Sean Zhong,2014-11-13 12:58:05+08:00,['964188fb7a3314ff3097ddd59684f496449e6045'],0,1,1,762956,1,,,,1174
413a6952c2acabdb97a9e4d68eaa774faafc120b,0,Robert (Bobby) Evans,2014-11-13 12:47:07-06:00,"['64f06c70b55bff830b62c5f7c4dfed89ea03692e', 'e6b18863e1cc5a5af8c7d1da703d31d9e17b70bf']",1285,21137,22422,785378,183,,,,1174
a62c6ae21efe5e5557d9c1f78317bec9241e880c,1,Parth Brahmbhatt,2014-11-13 16:02:48-08:00,['413a6952c2acabdb97a9e4d68eaa774faafc120b'],2,2,4,785382,1,,,,1174
e3f9c521222c76d355b2705658b4b5b1b309272b,0,P. Taylor Goetz,2014-11-14 13:22:17-05:00,"['64f06c70b55bff830b62c5f7c4dfed89ea03692e', 'cc633a9420962c3b93a396e4dabb978e4e373492']",1,33,34,785416,2,,,,1174
84b7e7307725713abcb3e7435ef1e1eba838147a,0,P. Taylor Goetz,2014-11-14 13:24:59-05:00,['e3f9c521222c76d355b2705658b4b5b1b309272b'],0,1,1,785417,1,,,,1174
03542ad875cc195057c2aec83184947d91e2b1d8,0,P. Taylor Goetz,2014-11-14 13:26:52-05:00,"['64f06c70b55bff830b62c5f7c4dfed89ea03692e', 'cc633a9420962c3b93a396e4dabb978e4e373492']",1,33,34,785451,2,,,,1174
b606bff8a3ed278db4376f13a0ad23d2dbc7c724,0,P. Taylor Goetz,2014-11-14 13:27:40-05:00,['03542ad875cc195057c2aec83184947d91e2b1d8'],0,1,1,785452,1,,,,1174
c2fefbcc1bcc022303ce690a35206cce92421fb0,0,P. Taylor Goetz,2014-11-14 13:28:06-05:00,"['b606bff8a3ed278db4376f13a0ad23d2dbc7c724', '413a6952c2acabdb97a9e4d68eaa774faafc120b']",1285,21137,22422,807874,183,,,,1174
69b5478fdb987a54c3a78455d23224067e201ba0,0,P. Taylor Goetz,2014-11-14 14:11:51-05:00,['84b7e7307725713abcb3e7435ef1e1eba838147a'],0,1,1,807875,1,1,1,1,1174
b9322a5b072bdf7140a17f51acc2aee091b1faaf,0,P. Taylor Goetz,2014-11-14 16:05:36-05:00,"['69b5478fdb987a54c3a78455d23224067e201ba0', '69ddc67a2b0ca527368ca7a27ac58621c745037b']",170,422,592,808467,9,,,,1174
a9333360678107954209a2f04e0e4836230ad2ad,0,P. Taylor Goetz,2014-11-14 16:46:43-05:00,['b9322a5b072bdf7140a17f51acc2aee091b1faaf'],23,32,55,808522,1,0,1,1,1174
29a8e2e75fe9486151c5aa5dd8602e2817eab20a,1,Robert (Bobby) Evans,2014-11-14 15:47:37-06:00,['c2fefbcc1bcc022303ce690a35206cce92421fb0'],24,233,257,808779,8,0.147058824,0.970588235,0.862745098,1175
dcb4cfe39c2100abf287595458fcfd930dce21d2,0,P. Taylor Goetz,2014-11-14 16:47:43-05:00,"['c2fefbcc1bcc022303ce690a35206cce92421fb0', 'a9333360678107954209a2f04e0e4836230ad2ad']",193,455,648,809427,11,,,,1175
a725b2397eb39fd811cc3afc3cf298b3fe27742e,0,P. Taylor Goetz,2014-11-14 16:51:01-05:00,['a9333360678107954209a2f04e0e4836230ad2ad'],0,1,1,809428,1,,,,1175
2dd7a9426e5634211f14cf5c4e10e021d3420c3c,0,P. Taylor Goetz,2014-11-14 16:51:44-05:00,['dcb4cfe39c2100abf287595458fcfd930dce21d2'],0,1,1,809429,1,,,,1175
32a7c0b161f833f0bae2fe8ee6515af8f899829b,0,Kang Xiao,2014-11-17 15:29:15+08:00,['2dd7a9426e5634211f14cf5c4e10e021d3420c3c'],1,1,2,809431,1,,,,1175
119cd4062041f4072173dd55b4e26f9d74e59005,0,Robert (Bobby) Evans,2014-11-17 11:11:08-06:00,"['2dd7a9426e5634211f14cf5c4e10e021d3420c3c', '29a8e2e75fe9486151c5aa5dd8602e2817eab20a']",24,233,257,809688,8,,,,1175
b8fceb87565454ec01a2c563a28d4221f58d9a75,0,Robert (Bobby) Evans,2014-11-17 11:18:40-06:00,['119cd4062041f4072173dd55b4e26f9d74e59005'],12,15,27,809715,10,,,,1175
4c20cd8cd48aeeb7b33d626f6b0e8583d98f0c0b,0,P. Taylor Goetz,2014-11-17 14:21:39-05:00,['a725b2397eb39fd811cc3afc3cf298b3fe27742e'],48,50,98,809813,5,,,,1175
2ad95f694c9e0211f611a2f19426b6872190de4c,0,P. Taylor Goetz,2014-11-17 14:39:03-05:00,['a725b2397eb39fd811cc3afc3cf298b3fe27742e'],48,50,98,809911,5,,,,1175
b3129de54b172733754f95950e5586bb04232ac5,0,P. Taylor Goetz,2014-11-17 14:57:30-05:00,['2ad95f694c9e0211f611a2f19426b6872190de4c'],1,0,1,809912,1,,,,1175
b79d33a92b9f3ee5167e6e0932f57e408732894b,0,P. Taylor Goetz,2014-11-17 15:07:33-05:00,['b3129de54b172733754f95950e5586bb04232ac5'],2,2,4,809916,1,,,,1175
c81b2cbf35d97216f682f506c03fcd8155dcfcd6,0,P. Taylor Goetz,2014-11-17 15:09:56-05:00,['b79d33a92b9f3ee5167e6e0932f57e408732894b'],0,1,1,809917,1,,,,1175
0f38c89e0e0f731c5528cb985e2a65ac651c20af,0,P. Taylor Goetz,2014-11-17 15:10:55-05:00,"['b8fceb87565454ec01a2c563a28d4221f58d9a75', 'a62c6ae21efe5e5557d9c1f78317bec9241e880c']",2,2,4,809921,1,,,,1175
38182748731613c15bc19080f3f96eb0b6ae0015,0,P. Taylor Goetz,2014-11-17 15:11:21-05:00,['0f38c89e0e0f731c5528cb985e2a65ac651c20af'],0,1,1,809922,1,,,,1175
04e6ebf44de44ff28e96c67fa36f2bbc576051c7,0,P. Taylor Goetz,2014-11-17 15:28:13-05:00,['c81b2cbf35d97216f682f506c03fcd8155dcfcd6'],1,1,2,809924,1,,,,1175
53e00ee873755b9a09f76498282ec29f0b482258,0,P. Taylor Goetz,2014-11-17 15:31:14-05:00,['04e6ebf44de44ff28e96c67fa36f2bbc576051c7'],0,1,1,809925,1,,,,1175
0d6605ef68b061e7b80f9a1ff53f19290f40adba,0,P. Taylor Goetz,2014-11-17 15:32:28-05:00,"['38182748731613c15bc19080f3f96eb0b6ae0015', '32a7c0b161f833f0bae2fe8ee6515af8f899829b']",1,1,2,809927,1,,,,1175
ecd00de620b26b6e9eb8bfbc5723c40edd03bf55,0,P. Taylor Goetz,2014-11-17 15:35:01-05:00,['0d6605ef68b061e7b80f9a1ff53f19290f40adba'],0,1,1,809928,1,,,,1175
1bff8a957bae9c907bf76e49b6f47f6f4e8026b5,0,P. Taylor Goetz,2014-11-18 10:24:38-05:00,['ecd00de620b26b6e9eb8bfbc5723c40edd03bf55'],48,50,98,810026,5,,,,1175
f8bce2225f2cfc550dcc67dff469f87062686506,0,P. Taylor Goetz,2014-11-18 10:31:22-05:00,['1bff8a957bae9c907bf76e49b6f47f6f4e8026b5'],1,0,1,810027,1,,,,1175
9ed8377df034d5834225b12db674c2f9c2b2e542,0,P. Taylor Goetz,2014-11-18 14:43:59-05:00,"['4c20cd8cd48aeeb7b33d626f6b0e8583d98f0c0b', '53e00ee873755b9a09f76498282ec29f0b482258']",4,5,9,810036,3,,,,1175
20f009b71712e2092e58034b8f8e382116db7b45,0,P. Taylor Goetz,2014-11-18 14:53:31-05:00,['9ed8377df034d5834225b12db674c2f9c2b2e542'],9,9,18,810054,9,,,,1175
ca6bf58e3a4e1a997ad40b4dfb41417ef989fd1b,0,P. Taylor Goetz,2014-11-18 14:58:49-05:00,['20f009b71712e2092e58034b8f8e382116db7b45'],10,10,20,810074,9,,,,1175
6a89890fe0969b11ed397138f59a3ffa30eb4475,0,P. Taylor Goetz,2014-11-18 14:58:58-05:00,['ca6bf58e3a4e1a997ad40b4dfb41417ef989fd1b'],10,10,20,810094,9,,,,1175
851767f818823d5a94ad8a5ab2c584b04f7a13f7,0,P. Taylor Goetz,2014-11-18 15:47:30-05:00,['6a89890fe0969b11ed397138f59a3ffa30eb4475'],9,9,18,810112,9,,,,1175
6cfc53a4225998686d21efc87be001d82deb1ebc,0,P. Taylor Goetz,2014-11-18 16:08:48-05:00,['851767f818823d5a94ad8a5ab2c584b04f7a13f7'],1,0,1,810113,1,,,,1175
7165ec264fd5e8ecd5727e557bd6286c0491adc0,0,P. Taylor Goetz,2014-11-18 16:15:39-05:00,['6cfc53a4225998686d21efc87be001d82deb1ebc'],10,10,20,810133,9,,,,1175
20aafcba184734e03bccc70f3a3f6dac521e1742,0,P. Taylor Goetz,2014-11-18 16:17:11-05:00,['7165ec264fd5e8ecd5727e557bd6286c0491adc0'],10,10,20,810153,9,,,,1175
3ef3cc3dd789a59915a25e11b591ccada129909a,0,P. Taylor Goetz,2014-11-18 20:43:12-05:00,['20aafcba184734e03bccc70f3a3f6dac521e1742'],9,9,18,810171,9,,,,1175
8160aa54b236f98cf313c39878a9859d1ed905ad,1,P. Taylor Goetz,2014-11-18 21:53:22-05:00,['3ef3cc3dd789a59915a25e11b591ccada129909a'],3,490,493,810664,29,,,,1175
20ce2bb9088e793b3b019110d07e77896bb642e8,0,P. Taylor Goetz,2014-11-18 22:06:44-05:00,['8160aa54b236f98cf313c39878a9859d1ed905ad'],10,10,20,810684,9,,,,1175
1570fa7a996111bc0a450ac28e58bc3565c4f960,0,P. Taylor Goetz,2014-11-18 22:06:53-05:00,['20ce2bb9088e793b3b019110d07e77896bb642e8'],10,10,20,810704,9,,,,1175
d9dc3b2a173b0124986767ff3f63b72284958467,0,lewuathe,2014-11-20 07:08:26+09:00,['f8bce2225f2cfc550dcc67dff469f87062686506'],2,2,4,810708,1,,,,1175
f3e3aa82e567d4c9c8a70ceb854cfe55c57f4639,0,Robert (Bobby) Evans,2014-11-20 09:41:42-06:00,['f8bce2225f2cfc550dcc67dff469f87062686506'],19,43,62,810770,5,,,,1175
68f4bcc383e23f103d8f62af97df69ad4a4962d0,0,Robert (Bobby) Evans,2014-11-20 09:41:42-06:00,['f3e3aa82e567d4c9c8a70ceb854cfe55c57f4639'],16,33,49,810819,3,,,,1175
618e485110350ca1f6943e717632ab5eb20430e6,0,Robert (Bobby) Evans,2014-11-20 09:49:55-06:00,['68f4bcc383e23f103d8f62af97df69ad4a4962d0'],4,7,11,810830,2,,,,1175
5c0a56105a9a984ae8e693343a6d89b730fd2ff9,0,Sriharsha Chintalapani,2014-11-20 08:36:17-08:00,['f8bce2225f2cfc550dcc67dff469f87062686506'],1,1,2,810832,1,,,,1175
ccef637701f8dfa88ad2aaa6933549267ece1b0a,1,Kishor Patil,2014-11-21 13:34:52+00:00,['f8bce2225f2cfc550dcc67dff469f87062686506'],2,13,15,810847,3,,,,1175
3c4133cdce4c7afe78878635265021ef3a3e3002,0,P. Taylor Goetz,2014-11-21 15:07:35-05:00,['f8bce2225f2cfc550dcc67dff469f87062686506'],0,57,57,810904,1,,,,1176
02bffc601e71d89948a7c5c214d1ae69ccc8ef1d,1,Rick Kilgore,2014-11-21 18:00:51-08:00,['882dfc5fb7b3b26a17e4a1ee5f91220cd80fc4dd'],136,408,544,811448,6,0.773049645,1,0.943262411,1179
e6bed26b0ef6247f31a7220bed32b77adef80eb9,0,Rick Kilgore,2014-11-21 18:24:36-08:00,"['882dfc5fb7b3b26a17e4a1ee5f91220cd80fc4dd', 'f8bce2225f2cfc550dcc67dff469f87062686506']",1952,22991,24943,836391,230,,,,1179
a95a18838b0d17b604ea5e2ba44007d7c3c10318,0,Rick Kilgore,2014-11-21 18:25:26-08:00,"['02bffc601e71d89948a7c5c214d1ae69ccc8ef1d', 'e6bed26b0ef6247f31a7220bed32b77adef80eb9']",1952,22991,24943,861334,230,,,,1179
a8bc05c711b341eeb523da0b2f58aa74959ef106,0,Sriharsha Chintalapani,2014-11-22 11:45:51-08:00,['f8bce2225f2cfc550dcc67dff469f87062686506'],1,1,2,861336,1,,,,1179
96e8a5bdd8b0e47eb27d47930cd681744a4e6f98,0,caofangkun,2014-11-24 10:31:35+08:00,"['cfe7e6313acc35a5c346480b4ac4e0d863d09410', 'f8bce2225f2cfc550dcc67dff469f87062686506']",1644,22119,23763,885099,220,,,,1179
fcd45d82d7ae9b54645c944acc5945bd80fe1f4b,1,caofangkun,2014-11-24 10:49:51+08:00,"['f9707b58e7664a0618776bea91402b895541ab00', '96e8a5bdd8b0e47eb27d47930cd681744a4e6f98']",1643,22207,23850,908949,221,,,,1179
347d2e6b2d5b6be9a77a3ddc63367e5694566dc9,0,thinker0,2014-11-24 21:41:47+09:00,['f8bce2225f2cfc550dcc67dff469f87062686506'],0,0,0,908949,1,,,,1180
e8e05b20ff30b04285240c9a14e39958d77fe4fe,0,Ahmet DAL,2014-11-24 15:42:12+02:00,['f8bce2225f2cfc550dcc67dff469f87062686506'],11,34,45,908994,2,1,1,1,1180
9583feaf87538e4e9aca9aaf405e02834e5ee9bf,0,Rick Kilgore,2014-11-24 22:39:23-08:00,"['e6bed26b0ef6247f31a7220bed32b77adef80eb9', '3c4133cdce4c7afe78878635265021ef3a3e3002']",0,57,57,909051,1,,,,1180
4be9e52b235c390b6746ef290c0422aec104fb00,0,Rick Kilgore,2014-11-24 22:39:40-08:00,"['a95a18838b0d17b604ea5e2ba44007d7c3c10318', '9583feaf87538e4e9aca9aaf405e02834e5ee9bf']",0,57,57,909108,1,,,,1180
13a00ba577d37076c32abed85bf42486f78706e5,0,P. Taylor Goetz,2014-11-25 12:37:06-05:00,['3c4133cdce4c7afe78878635265021ef3a3e3002'],2,2,4,909112,1,,,,1180
ebb48e393485d38fe906e81c0d0162e32d3b5d6a,1,P. Taylor Goetz,2014-11-26 14:16:30-05:00,['13a00ba577d37076c32abed85bf42486f78706e5'],0,16677,16677,925789,185,0.600547945,0.68,0.949589041,1365
1ef421ff59563ab5e3341c5e5bd1c9b1a685ec1e,0,P. Taylor Goetz,2014-11-26 14:18:11-05:00,['ebb48e393485d38fe906e81c0d0162e32d3b5d6a'],0,1,1,925790,1,,,,1365
ce25aa5710d2692cac64a7820d5cf10279e10a09,0,P. Taylor Goetz,2014-11-26 14:20:38-05:00,['1ef421ff59563ab5e3341c5e5bd1c9b1a685ec1e'],0,1,1,925791,1,,,,1365
fd2a7f471b238abc00af7cd71bf8161f16eee370,0,Robert (Bobby) Evans,2014-11-26 13:40:36-06:00,"['13a00ba577d37076c32abed85bf42486f78706e5', '347d2e6b2d5b6be9a77a3ddc63367e5694566dc9']",0,0,0,925791,1,,,,1365
87f7384f676db0cfa42bbe7fde388cc782796691,0,Robert (Bobby) Evans,2014-11-26 13:44:51-06:00,['fd2a7f471b238abc00af7cd71bf8161f16eee370'],0,1,1,925792,1,,,,1365
61e8b8f74a5fa21a3ae285da011a449a6bb127b7,0,Robert (Bobby) Evans,2014-11-26 16:33:07-06:00,"['87f7384f676db0cfa42bbe7fde388cc782796691', '1570fa7a996111bc0a450ac28e58bc3565c4f960']",5,491,496,926288,31,,,,1365
55eb7fec898cfd31581915f952738272e3eda385,0,Robert (Bobby) Evans,2014-11-26 16:58:32-06:00,"['61e8b8f74a5fa21a3ae285da011a449a6bb127b7', 'e8e05b20ff30b04285240c9a14e39958d77fe4fe']",11,34,45,926333,2,,,,1365
e3b85d3184b1f2eb2c3e7708a47f652e5096a375,0,xiajun,2014-11-28 17:52:45+08:00,['61e8b8f74a5fa21a3ae285da011a449a6bb127b7'],6,12,18,926351,1,,,,1365
75a79cf96094025407c8c7023e801a289f8a258e,0,Robert (Bobby) Evans,2014-11-28 16:04:18-06:00,['55eb7fec898cfd31581915f952738272e3eda385'],0,2,2,926353,2,,,,1365
8da47350da49d87ea8a7ee3389927c8ae9441ef2,0,Robert (Bobby) Evans,2014-11-28 16:07:39-06:00,"['75a79cf96094025407c8c7023e801a289f8a258e', 'a8bc05c711b341eeb523da0b2f58aa74959ef106']",1,1,2,926355,1,,,,1365
d110022e3dc781d766d5ac1a60eb34ac533791be,0,Robert (Bobby) Evans,2014-11-28 16:18:42-06:00,['8da47350da49d87ea8a7ee3389927c8ae9441ef2'],0,1,1,926356,1,,,,1365
39fa2e152cad8ca948833f0b24484d82037a684a,0,Robert (Bobby) Evans,2014-11-28 16:21:19-06:00,"['d110022e3dc781d766d5ac1a60eb34ac533791be', 'ccef637701f8dfa88ad2aaa6933549267ece1b0a']",2,13,15,926371,3,,,,1365
bf6e41c8909fee918eed879e7cf2c8f4a28424f7,0,Robert (Bobby) Evans,2014-11-28 16:34:14-06:00,['39fa2e152cad8ca948833f0b24484d82037a684a'],0,1,1,926372,1,,,,1365
e3f6cb96a1da5bb6e570a356e47ca9a6b8bc1e70,0,Robert (Bobby) Evans,2014-11-28 16:38:29-06:00,"['bf6e41c8909fee918eed879e7cf2c8f4a28424f7', '5c0a56105a9a984ae8e693343a6d89b730fd2ff9']",1,1,2,926374,1,,,,1365
544de07c973602f0488751fdee59491a3694896d,0,Robert (Bobby) Evans,2014-11-28 16:46:44-06:00,['e3f6cb96a1da5bb6e570a356e47ca9a6b8bc1e70'],0,1,1,926375,1,,,,1365
cd8dee5159b34d4b338cbf9f6d15da14bd68f8fb,0,Robert (Bobby) Evans,2014-11-29 13:07:17-06:00,"['544de07c973602f0488751fdee59491a3694896d', 'd9dc3b2a173b0124986767ff3f63b72284958467']",2,2,4,926379,1,,,,1365
c064dbaa83897ba81de835256935c5b7cde2784d,0,Robert (Bobby) Evans,2014-11-29 13:09:18-06:00,['cd8dee5159b34d4b338cbf9f6d15da14bd68f8fb'],0,1,1,926380,1,,,,1365
26c4008485928daf7592373d305af8893cbfaf40,0,Mansheng Yang,2014-11-30 12:42:23+08:00,['cfe7e6313acc35a5c346480b4ac4e0d863d09410'],16,16,32,926412,1,,,,1365
0d1f7be79d9336f6902b67fff5f22d7532cb2f4a,0,Mulloy Morrow,2014-12-01 10:38:35-08:00,['c064dbaa83897ba81de835256935c5b7cde2784d'],1,1,2,926414,1,,,,1365
72279c7c339425ebf71d1cf1f5495c28ab67fcec,0,Matt Siegel,2014-12-01 13:52:54-05:00,['f8bce2225f2cfc550dcc67dff469f87062686506'],0,8,8,926422,3,,,,1365
11aadf5201800685ee48147af7b78eec9181df1f,0,Parth Brahmbhatt,2014-12-01 12:03:18-08:00,['046262abd2d796a2056f7ce9c49294beacd0849c'],1,0,1,926423,1,,,,1365
728b35a966df9be45ba60213addce431fbbfe840,0,Parth Brahmbhatt,2014-12-01 13:29:39-08:00,['11aadf5201800685ee48147af7b78eec9181df1f'],7,14,21,926444,1,0,0,1,1365
771f6a9b861afa605e9386fbac9ae0f598b77039,0,Parth Brahmbhatt,2014-12-01 15:22:53-08:00,['728b35a966df9be45ba60213addce431fbbfe840'],8,30,38,926482,2,1,1,0,1365
609f569b1a779ef0db7be5e957c48107bede1560,0,Parth Brahmbhatt,2014-12-02 09:25:06-08:00,['771f6a9b861afa605e9386fbac9ae0f598b77039'],5,0,5,926487,1,,,,1365
50a33ac19ebba3b22c5c07d054c00080781004a4,0,Parth Brahmbhatt,2014-12-02 14:34:11-08:00,['609f569b1a779ef0db7be5e957c48107bede1560'],1,1,2,926489,1,,,,1365
522696cbfa0b5543fb8812e0ecb0acf7bfffef93,0,Parth Brahmbhatt,2014-12-02 14:35:35-08:00,['50a33ac19ebba3b22c5c07d054c00080781004a4'],0,33,33,926522,3,,,,1365
e037d3b665750b7e23ffdf13753eb40dedf74ed8,0,Parth Brahmbhatt,2014-12-02 14:35:59-08:00,['522696cbfa0b5543fb8812e0ecb0acf7bfffef93'],1,0,1,926523,1,,,,1365
e5c14e2a8a27a5342e852201507e79258a3201dd,0,Parth Brahmbhatt,2014-12-02 15:26:19-08:00,['e037d3b665750b7e23ffdf13753eb40dedf74ed8'],9,16,25,926548,2,,,,1365
c684939ee75cfd6b7dd6e9b1cfa19c5925f7d468,1,Parth Brahmbhatt,2014-12-03 11:57:00-08:00,['e5c14e2a8a27a5342e852201507e79258a3201dd'],5,37,42,926590,4,,,,1365
55c2a84db3cb4f2a2fd7edb8c8b48f19cadd90f2,0,Rick Kilgore,2014-12-03 11:59:19-08:00,"['9583feaf87538e4e9aca9aaf405e02834e5ee9bf', 'c064dbaa83897ba81de835256935c5b7cde2784d']",23,550,573,927163,41,,,,1365
f99fe8ee38249951688d11c8dc93d39d24c6b0ac,0,Rick Kilgore,2014-12-03 11:59:37-08:00,"['4be9e52b235c390b6746ef290c0422aec104fb00', '55c2a84db3cb4f2a2fd7edb8c8b48f19cadd90f2']",23,550,573,927736,41,,,,1365
0f7f774357a2a8da2461da40b423aed9e3530155,0,nothinking,2014-12-05 16:14:19+09:00,['c064dbaa83897ba81de835256935c5b7cde2784d'],1,1,2,927738,1,,,,1365
98014a56fe4ee71074b0aebb93e6724451756ee9,0,P. Taylor Goetz,2014-12-05 12:05:46-05:00,"['c064dbaa83897ba81de835256935c5b7cde2784d', 'ce25aa5710d2692cac64a7820d5cf10279e10a09']",0,16679,16679,944417,186,,,,1365
65d828a0488f710737bcfdbed857ab37994279c0,1,P. Taylor Goetz,2014-12-05 12:27:20-05:00,['98014a56fe4ee71074b0aebb93e6724451756ee9'],0,38,38,944455,1,,,,1366
3bbdc166bda7fb1a39b6906eda40da9bc83d5d4c,0,P. Taylor Goetz,2014-12-05 12:29:46-05:00,['65d828a0488f710737bcfdbed857ab37994279c0'],0,1,1,944456,1,,,,1366
32d78388fba9a20b2ba68a3751180c698bac7f65,0,Parth Brahmbhatt,2014-12-05 14:03:09-08:00,['c684939ee75cfd6b7dd6e9b1cfa19c5925f7d468'],22,32,54,944510,2,,,,1366
dda2ee1436c7a444c3f50d00dfabc7214342bd70,1,Parth Brahmbhatt,2014-12-05 14:06:07-08:00,['32d78388fba9a20b2ba68a3751180c698bac7f65'],4,73,77,944587,5,1,1,0,1366
65e9f0c814b2cddc772880042259b66194fd6fb7,0,Parth Brahmbhatt,2014-12-05 14:48:34-08:00,['3bbdc166bda7fb1a39b6906eda40da9bc83d5d4c'],5,17,22,944609,3,0,0.909090909,0.272727273,1366
fbca53dd816c49e4a9622369112bd357c18ebba6,1,Jungtaek Lim,2014-12-06 12:09:41+09:00,['3bbdc166bda7fb1a39b6906eda40da9bc83d5d4c'],14,14,28,944637,9,,,,1366
bba84548af6725037b47a0c3905c3f093ca3f18f,0,Jungtaek Lim,2014-12-06 12:18:47+09:00,['fbca53dd816c49e4a9622369112bd357c18ebba6'],17,0,17,944654,2,,,,1366
c6e7ec8df3024f10fce822547f93cf90a6e4d844,1,Jungtaek Lim,2014-12-06 12:25:15+09:00,['bba84548af6725037b47a0c3905c3f093ca3f18f'],25,4,29,944683,1,,,,1366
a24aea5d9e15fbe4fd42f45ef0020a2c470b905d,1,Jungtaek Lim,2014-12-06 12:26:26+09:00,['c6e7ec8df3024f10fce822547f93cf90a6e4d844'],2,2,4,944687,1,,,,1366
9fff1d7b8674253f1f0853a65b8a9c8c40f6f0d3,0,Jungtaek Lim,2014-12-06 12:30:41+09:00,['a24aea5d9e15fbe4fd42f45ef0020a2c470b905d'],8,8,16,944703,1,,,,1366
39de7bc9d4a073c2c2caed12a21244fa0cc245e9,0,Jungtaek Lim,2014-12-06 12:39:10+09:00,['9fff1d7b8674253f1f0853a65b8a9c8c40f6f0d3'],105,88,193,944896,19,,,,1366
77ff701300d90b5e8b711797cf809dbe94af75a4,1,Jungtaek Lim,2014-12-06 12:56:40+09:00,['39de7bc9d4a073c2c2caed12a21244fa0cc245e9'],1,29,30,944926,1,,,,1366
0bacffb1c7e5f9d350aa518df950e9dcf41c8eda,0,Jungtaek Lim,2014-12-06 13:07:27+09:00,['77ff701300d90b5e8b711797cf809dbe94af75a4'],3,2,5,944931,2,,,,1366
e48f5050399bc2d673ba09c64c5195c93419f5fe,1,Jungtaek Lim,2014-12-06 13:12:12+09:00,['0bacffb1c7e5f9d350aa518df950e9dcf41c8eda'],89,106,195,945126,19,,,,1366
bc7570b7d9ed5bdf675b7893ef66c00362928823,1,Jungtaek Lim,2014-12-06 13:26:14+09:00,['e48f5050399bc2d673ba09c64c5195c93419f5fe'],110,110,220,945346,19,,,,1366
26c7fecd2aaa4f4a027c08d4e623d01720475dc0,1,Jungtaek Lim,2014-12-06 13:41:41+09:00,['bc7570b7d9ed5bdf675b7893ef66c00362928823'],5,5,10,945356,2,,,,1366
b0dd595c56596fda451fbd94dc51139cc34ba46f,1,Jungtaek Lim,2014-12-06 13:51:27+09:00,['26c7fecd2aaa4f4a027c08d4e623d01720475dc0'],1,1,2,945358,1,,,,1366
78f5dae90e26c62d03c5e3be4435d0550c992c88,1,Jungtaek Lim,2014-12-06 13:56:21+09:00,['b0dd595c56596fda451fbd94dc51139cc34ba46f'],2,3,5,945363,1,,,,1366
d14434ac41003507bcfcc1fa1a506172febc0b17,0,joe,2014-12-06 17:24:17+08:00,"['2e9e36f90a691d517d7472b6f9f4a1b6921c7881', '3bbdc166bda7fb1a39b6906eda40da9bc83d5d4c']",1622,39381,41003,986366,432,,,,1366
7dab18f42690cfcc40a54c01760c81850937dabe,0,joe,2014-12-06 17:31:20+08:00,['d14434ac41003507bcfcc1fa1a506172febc0b17'],2,2,4,986370,1,,,,1366
68a7d9f2a8087b642917a2b42c6cb951687c5d69,0,Jungtaek Lim,2014-12-07 10:09:13+09:00,['78f5dae90e26c62d03c5e3be4435d0550c992c88'],1,1,2,986372,1,,,,1366
4e35c1a0820009c005a3b7c30122d04a9197934c,0,Parth Brahmbhatt,2014-12-08 09:50:41-08:00,['dda2ee1436c7a444c3f50d00dfabc7214342bd70'],14,24,38,986410,3,,,,1366
d1982427b4cab805509f993596171346d6759fe5,0,Parth Brahmbhatt,2014-12-08 09:52:11-08:00,['4e35c1a0820009c005a3b7c30122d04a9197934c'],1,2,3,986413,1,,,,1366
62ee10bd7c93b318578c11dbc8b18bf9f7bab076,0,Parth Brahmbhatt,2014-12-08 09:52:47-08:00,['d1982427b4cab805509f993596171346d6759fe5'],6,12,18,986431,1,,,,1366
86839dc6b789045a13cf28cba008e52c4d835fa4,1,Parth Brahmbhatt,2014-12-08 14:49:29-08:00,['65e9f0c814b2cddc772880042259b66194fd6fb7'],20,31,51,986482,2,1,0,0,1366
b2f48b41f19398498c7ae41c2059f3685b87ac22,0,Parth Brahmbhatt,2014-12-08 15:06:26-08:00,['86839dc6b789045a13cf28cba008e52c4d835fa4'],15,10,25,986507,5,,,,1366
fcf31350b62ca0efeeea96c8e1b0134edb81c1eb,0,Parth Brahmbhatt,2014-12-08 15:10:13-08:00,['b2f48b41f19398498c7ae41c2059f3685b87ac22'],1,1,2,986509,1,,,,1366
635c9b2efea767256527c6bbde16c37b8d7fd47d,0,Parth Brahmbhatt,2014-12-08 15:39:36-08:00,['62ee10bd7c93b318578c11dbc8b18bf9f7bab076'],8,6,14,986523,2,1,1,1,1366
646805805bf3ca6f755ec9d33f05ab15aea8cbdb,0,Parth Brahmbhatt,2014-12-08 15:55:47-08:00,['635c9b2efea767256527c6bbde16c37b8d7fd47d'],2,6,8,986531,2,,,,1366
7f9c7dbb8f7c0bc3badfa9972777528e9c504bc6,0,Parth Brahmbhatt,2014-12-08 16:14:45-08:00,['646805805bf3ca6f755ec9d33f05ab15aea8cbdb'],1,1,2,986533,1,,,,1366
71bd4a435b882120f7542fcae678a52e20600539,0,Niels Basjes,2014-12-09 13:53:05+01:00,['cd47f1d6e4165f8e3393aa5be01d02f4148c3216'],1,11,12,986545,1,1,1,1,1366
4e7a7e102723deb0f827946db28a88f7276b113e,0,Niels Basjes,2014-12-09 13:56:11+01:00,['71bd4a435b882120f7542fcae678a52e20600539'],3,1,4,986549,1,0,0,0,1366
401ebebdf8b201b87ff944cc3c2217cc30acd1fc,0,Niels Basjes,2014-12-09 14:00:33+01:00,['4e7a7e102723deb0f827946db28a88f7276b113e'],3,2,5,986554,1,,,,1366
2b6301909e9d821c95658200cf4ca0da88dfc9b1,0,Parth Brahmbhatt,2014-12-09 11:34:05-08:00,['7f9c7dbb8f7c0bc3badfa9972777528e9c504bc6'],3,4,7,986561,2,,,,1366
49680fd615bc4c6b5fcb8f494b244a24b0db5d42,0,Parth Brahmbhatt,2014-12-09 12:15:10-08:00,['2b6301909e9d821c95658200cf4ca0da88dfc9b1'],2,0,2,986563,1,,,,1366
773a40dbe8dd9daf7a8a312ca6ba136cc4f106a6,0,Frantz Mazoyer,2014-12-10 11:09:27+01:00,['3bbdc166bda7fb1a39b6906eda40da9bc83d5d4c'],1,1,2,986565,1,,,,1366
4d2804aacb0a0abb60b5760a2f8bb3eb657ab67b,0,Niels Basjes,2014-12-11 12:35:01+01:00,['401ebebdf8b201b87ff944cc3c2217cc30acd1fc'],2,2,4,986569,1,,,,1366
00300aebcce24fbe5426af4919965466c3aa3965,0,Parth Brahmbhatt,2014-12-11 10:24:50-08:00,['49680fd615bc4c6b5fcb8f494b244a24b0db5d42'],2,2,4,986573,1,,,,1366
678afedc018d5394308c1c321b00c34fce852655,0,Parth Brahmbhatt,2014-12-11 21:26:22-08:00,['00300aebcce24fbe5426af4919965466c3aa3965'],0,1,1,986574,1,,,,1366
5a67957efd3c874cd552e991d27eb9a8021129b3,0,Parth Brahmbhatt,2014-12-12 10:15:38-08:00,['65e9f0c814b2cddc772880042259b66194fd6fb7'],266,297,563,987137,6,0,0,0,1367
fefaf9bb1cab8890c19b538d8ea74c80ab30a853,1,Parth Brahmbhatt,2014-12-12 10:15:38-08:00,['5a67957efd3c874cd552e991d27eb9a8021129b3'],60,71,131,987268,5,0.2,1,1,1367
a37def89645f62a5df88ac6b46de3743703bb051,0,Parth Brahmbhatt,2014-12-12 10:16:44-08:00,['fefaf9bb1cab8890c19b538d8ea74c80ab30a853'],13,294,307,987575,5,0.299212598,0.716535433,0.984251969,1368
0de45c2e5badf211d5e9149801862c8cae8ec36c,0,Parth Brahmbhatt,2014-12-12 10:18:18-08:00,['a37def89645f62a5df88ac6b46de3743703bb051'],14,96,110,987685,3,,,,1368
b7b20fc84836d5a4b11ba343453a7607900cf595,0,Parth Brahmbhatt,2014-12-12 10:18:22-08:00,['0de45c2e5badf211d5e9149801862c8cae8ec36c'],16,0,16,987701,1,,,,1368
e590a7272bbb4838cbc2a9acd524e34094af3d27,1,Parth Brahmbhatt,2014-12-12 10:18:22-08:00,['b7b20fc84836d5a4b11ba343453a7607900cf595'],78,204,282,987983,7,0.3125,0.9375,1,1369
88a8658c619b42ac63b3371199f57969aeb5edb0,0,Parth Brahmbhatt,2014-12-12 10:18:22-08:00,['e590a7272bbb4838cbc2a9acd524e34094af3d27'],133,6,139,988122,6,1,0,0,1369
5c696778c1c70e6cece4e09ee6434e2b6f96e16f,0,Parth Brahmbhatt,2014-12-12 10:41:22-08:00,['88a8658c619b42ac63b3371199f57969aeb5edb0'],4,2,6,988128,3,,,,1369
b272f35bed7688427b2bb88904f632ff7cd01d82,0,Parth Brahmbhatt,2014-12-12 10:43:06-08:00,['5c696778c1c70e6cece4e09ee6434e2b6f96e16f'],17,5,22,988150,3,1,0.090909091,0.727272727,1369
15d9c8e490916f2ac5570ad6cf323c9d7cb3d0c0,0,Norbert Potocki,2014-12-12 16:57:20-08:00,['3bbdc166bda7fb1a39b6906eda40da9bc83d5d4c'],1,1,2,988152,1,,,,1369
59fb8ded9ef892792879efc94b12ea46ff924c41,1,Niels Basjes,2014-12-15 10:56:05+01:00,['4d2804aacb0a0abb60b5760a2f8bb3eb657ab67b'],21,43,64,988216,8,0.333333333,0,0,1370
1ca5f7659ea807f1ae83694788e889ac5cae6669,0,Niels Basjes,2014-12-15 10:58:49+01:00,['59fb8ded9ef892792879efc94b12ea46ff924c41'],6,4,10,988226,4,,,,1370
01ab7b141c408809d6491556494bded0d436ba4d,1,Sriharsha Chintalapani,2014-12-15 14:24:51-08:00,['3bbdc166bda7fb1a39b6906eda40da9bc83d5d4c'],1,3148,3149,991375,21,0.416413374,0.806079027,0.851671733,1388
dfb8e3709d27691a2f97bbc3e49491f13a9769d1,0,Sriharsha Chintalapani,2014-12-15 15:23:30-08:00,['01ab7b141c408809d6491556494bded0d436ba4d'],6,6,12,991387,2,,,,1388
fa69f2aff74b7a2485d2e7d07617f028fadeeb12,0,Parth Brahmbhatt,2014-12-15 16:29:51-08:00,['678afedc018d5394308c1c321b00c34fce852655'],16,17,33,991420,2,,,,1388
02c27a9a84813082fe30e6ffcd52425f85b99176,0,Parth Brahmbhatt,2014-12-15 16:30:21-08:00,['fa69f2aff74b7a2485d2e7d07617f028fadeeb12'],34,45,79,991499,1,1,1,1,1388
d9d5646543ac896e7341afdcececfe157451d711,0,Sriharsha Chintalapani,2014-12-15 18:22:29-08:00,"['3bbdc166bda7fb1a39b6906eda40da9bc83d5d4c', '0d1f7be79d9336f6902b67fff5f22d7532cb2f4a']",1,1,2,991501,1,,,,1388
ca29b5b23313eb46824842a321d55193b99db4eb,0,caofangkun,2014-12-16 11:03:28+08:00,['fcd45d82d7ae9b54645c944acc5945bd80fe1f4b'],89,0,89,991590,1,,,,1388
5bd9c3370ec5df4006b94310c4f56a2acf869ed9,0,Sriharsha Chintalapani,2014-12-15 20:19:24-08:00,"['d9d5646543ac896e7341afdcececfe157451d711', 'ca29b5b23313eb46824842a321d55193b99db4eb']",1,2,3,991593,1,,,,1388
23e630b123fce4626c57c373cd0ab5bdddbb489b,0,Sriharsha Chintalapani,2014-12-15 20:20:42-08:00,['5bd9c3370ec5df4006b94310c4f56a2acf869ed9'],0,1,1,991594,1,,,,1388
88e70a81d6e2715059276431d9dd19ec5763786a,0,Parth Brahmbhatt,2014-12-16 17:25:12-08:00,['02c27a9a84813082fe30e6ffcd52425f85b99176'],0,106,106,991700,1,0.25862069,1,1,1389
6b0da1689525507d2f40823abb50de3a4a1f9607,1,Parth Brahmbhatt,2014-12-16 18:14:32-08:00,"['88e70a81d6e2715059276431d9dd19ec5763786a', '23e630b123fce4626c57c373cd0ab5bdddbb489b']",1664,39442,41106,1032806,435,,,,1389
20672ba0ce16d9a873f048b518af25b246c10c10,0,Sriharsha Chintalapani,2014-12-16 21:49:16-08:00,"['23e630b123fce4626c57c373cd0ab5bdddbb489b', '0f7f774357a2a8da2461da40b423aed9e3530155']",1,1,2,1032808,1,,,,1389
e7bac48edc911996827bb6cfd4948455507c9826,0,Sriharsha Chintalapani,2014-12-16 22:00:04-08:00,"['20672ba0ce16d9a873f048b518af25b246c10c10', 'effb3eb762f997d3b08650a1c7298ab408897565']",1,1,2,1032810,1,,,,1389
38fbb448368966e627d5acbfe700851329a6a081,0,Sriharsha Chintalapani,2014-12-16 22:05:56-08:00,['e7bac48edc911996827bb6cfd4948455507c9826'],0,1,1,1032811,1,,,,1389
341a8a7902c3d796fd8ab3b5e97e6016499a2b5f,0,Sriharsha Chintalapani,2014-12-17 07:15:39-08:00,"['38fbb448368966e627d5acbfe700851329a6a081', '773a40dbe8dd9daf7a8a312ca6ba136cc4f106a6']",1,1,2,1032813,1,,,,1389
f76b3e71284eaadae35be31c7b88c49020ae7414,0,Sriharsha Chintalapani,2014-12-17 08:22:50-08:00,['341a8a7902c3d796fd8ab3b5e97e6016499a2b5f'],0,1,1,1032814,1,,,,1389
1dccc1bde7266bad489c5c9678c9446b13107564,0,Parth Brahmbhatt,2014-12-17 10:31:27-08:00,"['6b0da1689525507d2f40823abb50de3a4a1f9607', 'f76b3e71284eaadae35be31c7b88c49020ae7414']",3,5,8,1032822,4,,,,1389
7a4c9400d5f00e39b06e09cb5a879096ca94d7fe,0,Mike Thomsen,2014-12-17 13:42:48-05:00,['3bbdc166bda7fb1a39b6906eda40da9bc83d5d4c'],3,2,5,1032827,1,,,,1389
8241146d95ea353acc8c5f3e581d938187b09c86,0,Parth Brahmbhatt,2014-12-17 11:13:56-08:00,['1dccc1bde7266bad489c5c9678c9446b13107564'],7,7,14,1032841,5,,,,1389
df4d8c2adb9e7de99573ddd01b6fc81a3ff03072,0,Parth Brahmbhatt,2014-12-17 19:16:42-08:00,['8241146d95ea353acc8c5f3e581d938187b09c86'],22,23,45,1032886,4,,,,1389
63c86367b168c1e1118d498d9e5f7b2c8df033ed,0,Parth Brahmbhatt,2014-12-17 19:19:24-08:00,['fcf31350b62ca0efeeea96c8e1b0134edb81c1eb'],1,2,3,1032889,1,0,0,0,1389
cb548dd13b4b90d64f41ce85e8268f7bab153d56,0,Parth Brahmbhatt,2014-12-17 19:20:00-08:00,"['63c86367b168c1e1118d498d9e5f7b2c8df033ed', 'f76b3e71284eaadae35be31c7b88c49020ae7414']",5,9,14,1032903,6,,,,1389
49bdd0044cf79c025f0f74bd09248a9188a21490,1,Michael G. Noll,2014-12-18 15:18:16+01:00,['f76b3e71284eaadae35be31c7b88c49020ae7414'],60,118,178,1033081,1,,,,1389
10636568dc8bac650d6c38864144ca0808df9642,1,Michael G. Noll,2014-12-18 15:20:07+01:00,['49bdd0044cf79c025f0f74bd09248a9188a21490'],1,1,2,1033083,1,,,,1389
c91e7852a611438ca4fff364a80253e0a3e43265,1,Michael G. Noll,2014-12-18 15:21:24+01:00,['10636568dc8bac650d6c38864144ca0808df9642'],1,1,2,1033085,1,,,,1389
01adbadcf2879de68747112e732fa010e3830192,0,Michael G. Noll,2014-12-18 15:21:49+01:00,['c91e7852a611438ca4fff364a80253e0a3e43265'],1,1,2,1033087,1,,,,1389
527eb2935db1aee4dc972015ab143915b7081d25,1,Michael G. Noll,2014-12-18 15:28:45+01:00,['01adbadcf2879de68747112e732fa010e3830192'],4,4,8,1033095,1,,,,1389
a7c8f25f3032db7658ea12f00acfdea3dfd383fc,0,Parth Brahmbhatt,2014-12-18 10:11:17-08:00,['cb548dd13b4b90d64f41ce85e8268f7bab153d56'],2,2,4,1033099,2,,,,1389
366130e990c441d06d73c832551eeb51d9f7388a,0,Parth Brahmbhatt,2014-12-18 11:04:36-08:00,"['df4d8c2adb9e7de99573ddd01b6fc81a3ff03072', '527eb2935db1aee4dc972015ab143915b7081d25']",64,122,186,1033285,1,,,,1389
256c35af6d4da821675dac3ec0fb9073b0695e92,0,Parth Brahmbhatt,2014-12-18 11:17:48-08:00,['366130e990c441d06d73c832551eeb51d9f7388a'],57,0,57,1033342,1,,,,1389
e5a96f43839a7f5bc6eedb212c1b30c004af914e,0,Parth Brahmbhatt,2014-12-18 11:28:54-08:00,['256c35af6d4da821675dac3ec0fb9073b0695e92'],5,5,10,1033352,1,1,1,1,1389
547ed4916761508040f056c6812e047e04e8db3a,0,Parth Brahmbhatt,2014-12-18 16:39:25-08:00,['e5a96f43839a7f5bc6eedb212c1b30c004af914e'],9,10,19,1033371,7,,,,1389
dc764b10d4862bb2ea123c23289d54600d7b4ffc,0,Parth Brahmbhatt,2014-12-18 16:45:01-08:00,['a7c8f25f3032db7658ea12f00acfdea3dfd383fc'],6,1,7,1033378,1,1,1,1,1389
50fdcee5411be401534559c9822e45a50b477d96,0,Parth Brahmbhatt,2014-12-18 19:44:10-08:00,['547ed4916761508040f056c6812e047e04e8db3a'],17,2,19,1033397,3,,,,1389
b2f8eb651d3e8dbd7939aae126d803da6b948663,0,fmazoyer,2014-12-19 17:12:57+01:00,['f76b3e71284eaadae35be31c7b88c49020ae7414'],14,52,66,1033463,4,,,,1389
d0bb3830a3e6fccbfb4d17ed170ed8f4e6056df0,1,Parth Brahmbhatt,2014-12-19 11:26:26-08:00,['50fdcee5411be401534559c9822e45a50b477d96'],15,29,44,1033507,3,1,1,1,1389
dd991e53a9c0e474360e6cb70b6c1d2217a2aa07,0,Parth Brahmbhatt,2014-12-19 12:09:16-08:00,['d0bb3830a3e6fccbfb4d17ed170ed8f4e6056df0'],7,6,13,1033520,1,,,,1389
07b69b7b86828b4213873405323c0e9be03934f1,0,Parth Brahmbhatt,2014-12-19 12:52:30-08:00,['dd991e53a9c0e474360e6cb70b6c1d2217a2aa07'],0,201,201,1033721,3,,,,1392
e05d6663a3dbc056e9f21194f83fe0e27509f83e,0,Parth Brahmbhatt,2014-12-19 13:01:27-08:00,['07b69b7b86828b4213873405323c0e9be03934f1'],7,6,13,1033734,1,,,,1392
9cd52c88ec67c1dd4a01370a835a0861dcee2c25,0,Parth Brahmbhatt,2014-12-19 13:53:34-08:00,['e05d6663a3dbc056e9f21194f83fe0e27509f83e'],1,16,17,1033751,2,,,,1392
c82482d845de996515047ee001d61b9a50322a9f,0,Parth Brahmbhatt,2014-12-19 13:54:52-08:00,['9cd52c88ec67c1dd4a01370a835a0861dcee2c25'],2,41,43,1033794,3,1,0.625,1,1392
2954eae77c898174bdf6b5970d8095ed442e672d,0,Parth Brahmbhatt,2014-12-19 13:55:32-08:00,['c82482d845de996515047ee001d61b9a50322a9f'],11,0,11,1033805,1,,,,1392
a92a1e9c7887383286295d90d53899dbdbdde000,0,Parth Brahmbhatt,2014-12-19 13:56:25-08:00,['2954eae77c898174bdf6b5970d8095ed442e672d'],7,8,15,1033820,1,,,,1392
a75c72cfc75a150dc3e1a7c1b1b0b6471a4f99ab,0,Parth Brahmbhatt,2014-12-19 13:59:41-08:00,['a92a1e9c7887383286295d90d53899dbdbdde000'],1,0,1,1033821,1,,,,1392
27d6b4ca5ab4d4f9d7753d66b2a28c982b47c7e7,0,Parth Brahmbhatt,2014-12-19 14:31:49-08:00,['a75c72cfc75a150dc3e1a7c1b1b0b6471a4f99ab'],11,33,44,1033865,4,,,,1392
dc24e440fa98f62e232e7929fd075387e2e56e4e,0,Parth Brahmbhatt,2014-12-19 14:37:38-08:00,['27d6b4ca5ab4d4f9d7753d66b2a28c982b47c7e7'],223,0,223,1034088,3,0.459459459,0.27027027,0,1392
d2d2db0285f138c3394d1e68d6a035377acdbc05,0,Sriharsha Chintalapani,2014-12-19 14:52:56-08:00,"['527eb2935db1aee4dc972015ab143915b7081d25', 'ed4861d83357dcb13cd32621fa18d1d03497a8a0']",27,32,59,1034147,1,,,,1392
eb242e0f6e1681825d005dbadb19649684025e01,0,Parth Brahmbhatt,2014-12-19 15:52:17-08:00,['dc24e440fa98f62e232e7929fd075387e2e56e4e'],5,8,13,1034160,2,1,1,1,1392
a17167e4eb6cea78d7da7fa2632c0cbbb3a40c7a,0,Parth Brahmbhatt,2014-12-19 17:09:36-08:00,['eb242e0f6e1681825d005dbadb19649684025e01'],17,19,36,1034196,1,,,,1392
97ae36e42abc961fbcc54dd77c80bafff30dce7e,0,caofangkun,2014-12-22 16:18:08+08:00,"['96e8a5bdd8b0e47eb27d47930cd681744a4e6f98', '527eb2935db1aee4dc972015ab143915b7081d25']",91,17455,17546,1051742,232,,,,1392
901a486c9badfa133a7d72ec1fde23b250280440,0,Sriharsha Chintalapani,2014-12-22 08:42:14-08:00,['d2d2db0285f138c3394d1e68d6a035377acdbc05'],0,1,1,1051743,1,,,,1392
da02d8c915754c44054cf6052a00cfa9d72c9c07,0,Sriharsha Chintalapani,2014-12-22 09:29:25-08:00,"['901a486c9badfa133a7d72ec1fde23b250280440', '15d9c8e490916f2ac5570ad6cf323c9d7cb3d0c0']",1,1,2,1051745,1,,,,1392
743b899b25bc079b5a8008e76286794058151969,0,Robert (Bobby) Evans,2014-12-22 14:52:31-06:00,['da02d8c915754c44054cf6052a00cfa9d72c9c07'],0,0,0,1051745,1,,,,1392
28eb65d2c7987b520f66c59e85f32a2fc209a7b6,1,Robert (Bobby) Evans,2014-12-22 14:54:03-06:00,['743b899b25bc079b5a8008e76286794058151969'],0,8284,8284,1060029,12,,,,1404
cdc699efd13c4ddc45565826ae51bf60ee3e1c53,0,Robert (Bobby) Evans,2014-12-22 14:56:37-06:00,"['618e485110350ca1f6943e717632ab5eb20430e6', 'da02d8c915754c44054cf6052a00cfa9d72c9c07']",119,17489,17608,1077637,234,,,,1404
231ac22b7caa254d96e2647e784747067d52cd38,0,Robert (Bobby) Evans,2014-12-22 14:59:38-06:00,['cdc699efd13c4ddc45565826ae51bf60ee3e1c53'],2,2,4,1077641,1,,,,1404
3907b2d780b796e754bf3566d29567cff6e77679,0,Derek Dagit,2014-12-22 15:02:05-06:00,['da02d8c915754c44054cf6052a00cfa9d72c9c07'],2,3,5,1077646,1,,,,1404
40be5ddb94b674f8fcf2c804c7af96fbfe77776a,0,Derek Dagit,2014-12-22 15:02:05-06:00,['3907b2d780b796e754bf3566d29567cff6e77679'],2,0,2,1077648,1,,,,1404
e5f2370dd2cd832dc46bcf16397f76222bad75b8,0,Robert (Bobby) Evans,2014-12-22 16:33:22-06:00,['da02d8c915754c44054cf6052a00cfa9d72c9c07'],1,1,2,1077650,1,,,,1404
41d1d9c0ef72db56c18fb1cc422f4dd949b32138,0,Robert (Bobby) Evans,2014-12-22 16:52:33-06:00,['e5f2370dd2cd832dc46bcf16397f76222bad75b8'],0,2,2,1077652,1,,,,1404
3ad05ca3565f0d33693e7bff6a5af6fd20afce46,0,Robert (Bobby) Evans,2014-12-23 09:29:36-06:00,['da02d8c915754c44054cf6052a00cfa9d72c9c07'],2,2,4,1077656,1,,,,1404
a0a02b71d0907e68b526ffdf4fd965c6a3ed4770,0,Robert (Bobby) Evans,2014-12-23 09:35:46-06:00,"['da02d8c915754c44054cf6052a00cfa9d72c9c07', '68a7d9f2a8087b642917a2b42c6cb951687c5d69']",184,174,358,1078014,28,,,,1404
e0af1819ba3216ab17f69d5938b12a33e12475b0,0,Robert (Bobby) Evans,2014-12-23 10:04:05-06:00,"['a0a02b71d0907e68b526ffdf4fd965c6a3ed4770', '72279c7c339425ebf71d1cf1f5495c28ab67fcec']",0,8,8,1078022,3,,,,1404
6e0ca69c765c8516938dabab85887e89912ddbf9,0,Robert (Bobby) Evans,2014-12-23 10:13:48-06:00,['e0af1819ba3216ab17f69d5938b12a33e12475b0'],0,2,2,1078024,2,,,,1404
fe4284fe23bd063aa6833002469ea543ae3b6ecd,0,Robert (Bobby) Evans,2014-12-23 10:19:29-06:00,"['6e0ca69c765c8516938dabab85887e89912ddbf9', 'e3b85d3184b1f2eb2c3e7708a47f652e5096a375']",6,12,18,1078042,1,,,,1404
924be6edae69b1d2ccf9f7ca8408c36cc106dd9a,0,Robert (Bobby) Evans,2014-12-23 11:01:21-06:00,['fe4284fe23bd063aa6833002469ea543ae3b6ecd'],0,2,2,1078044,2,,,,1404
6720f9ebe27079c0b750b3d3019f422e6916fc6f,0,Robert (Bobby) Evans,2014-12-23 11:33:55-06:00,"['924be6edae69b1d2ccf9f7ca8408c36cc106dd9a', '9d605deedcbfcd5e35c697d53e87660ed51a97b2']",3,6,9,1078053,1,,,,1404
66be747abdeefb497f8f9955a090c06830f7103d,0,Robert (Bobby) Evans,2014-12-23 12:00:03-06:00,['6720f9ebe27079c0b750b3d3019f422e6916fc6f'],0,1,1,1078054,1,,,,1404
16b7382dc7675d7a8b7aa0108af836913eef0560,1,Parth Brahmbhatt,2014-12-23 12:18:43-08:00,['527eb2935db1aee4dc972015ab143915b7081d25'],16,16,32,1078086,2,,,,1404
d42d8dab3a7e5524f96ed1e9985381ca2936544e,0,Parth Brahmbhatt,2014-12-23 12:19:58-08:00,"['16b7382dc7675d7a8b7aa0108af836913eef0560', '66be747abdeefb497f8f9955a090c06830f7103d']",221,239,460,1078546,36,,,,1404
326cc1c796d073c768de4b5aced1669bd47c6891,1,Curtis Allen,2014-12-23 16:13:31-07:00,['66be747abdeefb497f8f9955a090c06830f7103d'],0,37,37,1078583,2,0.25,0.25,0.785714286,1404
1482915a9c3022d63830dd541b5faabbef2622ca,0,caofangkun,2014-12-24 10:40:12+08:00,"['d23495056f0b870e1ef4bebbae586965e2f21340', '97ae36e42abc961fbcc54dd77c80bafff30dce7e']",1719,39558,41277,1119860,435,,,,1404
93cf2c1d81a475bcb156a3ab8f519e8830c7d1f7,0,caofangkun,2014-12-24 10:46:08+08:00,['1482915a9c3022d63830dd541b5faabbef2622ca'],4,4,8,1119868,3,,,,1404
cad1505deb214facb0fb70e24034e30f79a973da,1,caofangkun,2014-12-24 11:44:25+08:00,['97ae36e42abc961fbcc54dd77c80bafff30dce7e'],17,1642,1659,1121527,6,,,,1406
986ad60bf065c8c3dd965b5c2cfd33d71229385b,0,caofangkun,2014-12-24 11:56:12+08:00,['cad1505deb214facb0fb70e24034e30f79a973da'],1635,0,1635,1123162,2,,,,1406
aa713a2af0130b7d48ae5205459425587eac0280,0,Mike Thomsen,2014-12-25 20:20:35-05:00,"['7a4c9400d5f00e39b06e09cb5a879096ca94d7fe', '66be747abdeefb497f8f9955a090c06830f7103d']",290,370,660,1123822,42,,,,1406
e6f509f82c30eaed5f2b3a6db5340d1438020adc,1,dashengju,2014-12-26 11:53:19+08:00,['66be747abdeefb497f8f9955a090c06830f7103d'],24,111,135,1123957,3,0.6,1,1,1408
741a14c78d64daa4bca4c2119dda8eae589ccd48,0,dashengju,2014-12-26 13:51:42+08:00,['66be747abdeefb497f8f9955a090c06830f7103d'],0,1334,1334,1125291,11,0.737078652,1,0.703370787,1418
5c357ffe7381d0d608e04826ac6b4d915aa2fb72,0,dashengju,2014-12-26 13:58:18+08:00,['741a14c78d64daa4bca4c2119dda8eae589ccd48'],19,2,21,1125312,1,,,,1418
64b0d828b1c2c445ecda45622fbc57f4f7756f1e,0,Muneyuki Noguchi,2014-12-29 05:02:40+00:00,['66be747abdeefb497f8f9955a090c06830f7103d'],0,4,4,1125316,1,0,0,1,1418
10f529efbb1d47f37cc3ccbe06859c3e9fb151bf,0,Muneyuki Noguchi,2014-12-29 05:26:44+00:00,['66be747abdeefb497f8f9955a090c06830f7103d'],2,1,3,1125319,1,1,1,0,1418
895096de35811d0fa5158e550d49d8cdbc497ca0,0,xiajun,2014-12-29 16:52:35+08:00,['66be747abdeefb497f8f9955a090c06830f7103d'],1,1,2,1125321,1,,,,1418
28ebb82d3a1e5364fef8f63775ac2341b991a5aa,0,Jungtaek Lim,2014-12-30 10:22:27+09:00,['5c357ffe7381d0d608e04826ac6b4d915aa2fb72'],10,0,10,1125331,1,,,,1418
ac9719b05220d3a891d60e02f7120ba640230ef4,0,DashengJu,2014-12-30 10:02:59+08:00,"['5c357ffe7381d0d608e04826ac6b4d915aa2fb72', '28ebb82d3a1e5364fef8f63775ac2341b991a5aa']",10,0,10,1125341,1,,,,1418
171a8bf461a2fa97dcfa8439680f4043d1c2dd3a,1,Jungtaek Lim,2014-12-30 17:50:35+09:00,['28ebb82d3a1e5364fef8f63775ac2341b991a5aa'],0,687,687,1126028,11,0.667774086,0.913621262,0.916943522,1429
980dccee35066f676e58684ccdf2db8424aee611,0,DashengJu,2014-12-30 17:54:50+08:00,"['ac9719b05220d3a891d60e02f7120ba640230ef4', '171a8bf461a2fa97dcfa8439680f4043d1c2dd3a']",0,687,687,1126715,11,,,,1429
06b01694125279358c10169d8f54110abe7da836,0,dashengju,2014-12-30 18:02:02+08:00,['980dccee35066f676e58684ccdf2db8424aee611'],0,120,120,1126835,8,,,,1429
ab76e67ccc67349a8483e8ee314621303d6a2fbd,0,Sriharsha Chintalapani,2014-12-30 09:50:21-08:00,['aa713a2af0130b7d48ae5205459425587eac0280'],0,1,1,1126836,1,,,,1429
b2c0731401f99859d454c4a2cd6b54cc9e5a4c96,0,dashengju,2014-12-31 13:47:01+08:00,['06b01694125279358c10169d8f54110abe7da836'],821,656,1477,1128313,10,0,0,0,1432
ff36ac874b03fefefe7d25298238d5c2cc4493d5,0,dashengju,2014-12-31 17:11:22+08:00,['b2c0731401f99859d454c4a2cd6b54cc9e5a4c96'],31,461,492,1128805,15,0.095238095,0.904761905,0.968253968,1437
00e1bad9fa2d517c9a7ee7a544900e39fea31f75,0,Jungtaek Lim,2015-01-01 12:26:03+09:00,['ff36ac874b03fefefe7d25298238d5c2cc4493d5'],1,1,2,1128807,1,,,,1437
37442e5dec821745f99f57e256470e8d1a9c6112,1,Sriharsha Chintalapani,2015-01-03 14:31:11-08:00,['ab76e67ccc67349a8483e8ee314621303d6a2fbd'],0,23,23,1128830,2,,,,1437
8f3530404f3550415146c484d31765028c0d98b9,0,Sriharsha Chintalapani,2015-01-03 14:32:57-08:00,['37442e5dec821745f99f57e256470e8d1a9c6112'],1,1,2,1128832,1,,,,1437
0f9438fc5491fb3764849b31536352e69deae8ea,0,dashengju,2015-01-04 16:31:40+08:00,['ff36ac874b03fefefe7d25298238d5c2cc4493d5'],227,735,962,1129794,12,0.361386139,1,0.678217822,1442
d5267c7f9463df818ee2e6842341617448081741,0,dashengju,2015-01-04 17:06:25+08:00,['0f9438fc5491fb3764849b31536352e69deae8ea'],0,98,98,1129892,1,,,,1442
45b9a2efe0223c470fef9825cbabe038d28b0d2b,0,DashengJu,2015-01-04 17:33:51+08:00,"['d5267c7f9463df818ee2e6842341617448081741', '00e1bad9fa2d517c9a7ee7a544900e39fea31f75']",1,1,2,1129894,1,,,,1442
780d91f29fc1025b3fa6591aa69022001bfd5331,0,dashengju,2015-01-04 17:35:56+08:00,"['d5267c7f9463df818ee2e6842341617448081741', 'ab76e67ccc67349a8483e8ee314621303d6a2fbd']",3,3,6,1129900,2,,,,1442
b1a3396d725239bd801c11019e4968d20cb88e22,0,dashengju,2015-01-04 17:36:24+08:00,"['780d91f29fc1025b3fa6591aa69022001bfd5331', '45b9a2efe0223c470fef9825cbabe038d28b0d2b']",1,1,2,1129902,1,,,,1442
3cee80fc12ca5cdab5a200ac52d67ca55e1a1c69,0,dashengju,2015-01-05 18:47:25+08:00,['b1a3396d725239bd801c11019e4968d20cb88e22'],44,39,83,1129985,6,0,0,0,1442
5b160168c75c0e8c4c402a5e24f606dab697fbef,1,Parth Brahmbhatt,2015-01-05 22:22:46-05:00,['65e9f0c814b2cddc772880042259b66194fd6fb7'],0,1571,1571,1131556,18,0.405825243,0.609708738,0.949514563,1460
ab9f778ae50a1e224ebdcc58e6249009fc1f91cc,0,Parth Brahmbhatt,2015-01-05 22:23:52-05:00,"['5b160168c75c0e8c4c402a5e24f606dab697fbef', 'ab76e67ccc67349a8483e8ee314621303d6a2fbd']",293,373,666,1132222,43,,,,1460
d260759ac203383e27668a7cb7090926029f7406,0,Parth Brahmbhatt,2015-01-05 22:31:05-05:00,['ab9f778ae50a1e224ebdcc58e6249009fc1f91cc'],17,5,22,1132244,3,1,0.090909091,0.727272727,1460
49688fd5856e81d947255aca9cca4252d8243945,1,fmazoyer,2015-01-06 13:16:19+01:00,['ab76e67ccc67349a8483e8ee314621303d6a2fbd'],14,52,66,1132310,4,,,,1460
14a828cae8d883a8a0d1022d75156079a37a88a8,0,fmazoyer,2015-01-06 13:23:37+01:00,"['49688fd5856e81d947255aca9cca4252d8243945', 'b2f8eb651d3e8dbd7939aae126d803da6b948663']",0,0,0,1132310,0,,,,1460
ebc9bc5ae3c74e13f06dcfe137125d1e22ed2d47,0,Sriharsha Chintalapani,2015-01-06 06:40:07-08:00,"['ab76e67ccc67349a8483e8ee314621303d6a2fbd', 'dc764b10d4862bb2ea123c23289d54600d7b4ffc']",26,40,66,1132376,5,,,,1460
fba310af8cc2796af9314bd26217fe08552ad49c,1,fmazoyer,2015-01-06 16:27:19+01:00,['14a828cae8d883a8a0d1022d75156079a37a88a8'],8,9,17,1132393,1,,,,1460
9ad27f19853e08d3bff8bcc5c3d7d1d23c1ea83a,0,Robert (Bobby) Evans,2015-01-06 10:18:34-06:00,"['ab76e67ccc67349a8483e8ee314621303d6a2fbd', '895096de35811d0fa5158e550d49d8cdbc497ca0']",1,1,2,1132395,1,,,,1460
ee4bd3786cb03785d956a3b8992220b309365c8c,0,Sriharsha Chintalapani,2015-01-06 08:25:47-08:00,['ebc9bc5ae3c74e13f06dcfe137125d1e22ed2d47'],0,1,1,1132396,1,,,,1460
01729f1ff375cd68581abebbd7014b7cadfc8c13,0,Robert (Bobby) Evans,2015-01-06 10:26:25-06:00,['9ad27f19853e08d3bff8bcc5c3d7d1d23c1ea83a'],0,1,1,1132397,1,,,,1460
36f75224e6aeb196caac0b43123b12014ac118ff,0,Sriharsha Chintalapani,2015-01-06 08:35:56-08:00,"['01729f1ff375cd68581abebbd7014b7cadfc8c13', 'ee4bd3786cb03785d956a3b8992220b309365c8c']",26,41,67,1132464,6,,,,1460
81ff38d37d4a120f0dd9f0ce0e0f39c9c31cd4d6,0,Robert (Bobby) Evans,2015-01-06 10:54:25-06:00,['36f75224e6aeb196caac0b43123b12014ac118ff'],1,1,2,1132466,1,,,,1460
fce07207fd4023312f507fe977aded09686d05c8,0,Robert (Bobby) Evans,2015-01-06 10:54:25-06:00,['81ff38d37d4a120f0dd9f0ce0e0f39c9c31cd4d6'],0,1,1,1132467,1,,,,1460
079deda496d16bd896611da706402c9df7e2319f,0,Parth Brahmbhatt,2015-01-06 12:47:40-05:00,['d260759ac203383e27668a7cb7090926029f7406'],1,8,9,1132476,3,,,,1460
d256627de95f5cf84743b223b6e65edee502d467,0,Robert (Bobby) Evans,2015-01-06 14:35:24-06:00,"['fce07207fd4023312f507fe977aded09686d05c8', '10f529efbb1d47f37cc3ccbe06859c3e9fb151bf']",2,1,3,1132479,1,,,,1460
cc19d434ca231bfdf72ae1a17beb6e5bb1bf2aad,0,Robert (Bobby) Evans,2015-01-06 14:36:10-06:00,['d256627de95f5cf84743b223b6e65edee502d467'],0,1,1,1132480,1,,,,1460
c3ffc67af523959399554e8dd53a619141f0f798,0,Robert (Bobby) Evans,2015-01-06 14:46:19-06:00,"['cc19d434ca231bfdf72ae1a17beb6e5bb1bf2aad', '64b0d828b1c2c445ecda45622fbc57f4f7756f1e']",0,4,4,1132484,1,,,,1460
b9fb838490ca78c9c3a370ab3a5ff2c6a41a8dab,0,Robert (Bobby) Evans,2015-01-06 14:46:57-06:00,['c3ffc67af523959399554e8dd53a619141f0f798'],0,1,1,1132485,1,,,,1460
2818698c6f687e3c1565a5f29daee1551482ba8d,0,Robert (Bobby) Evans,2015-01-06 15:21:58-06:00,"['b9fb838490ca78c9c3a370ab3a5ff2c6a41a8dab', 'ac5a18dc30ee6e9257eb5c18c0c87e7c7e944b23']",2,9,11,1132496,1,,,,1460
f874464795685860c31fef5307f8ced39ed9480a,0,Robert (Bobby) Evans,2015-01-06 15:22:32-06:00,['2818698c6f687e3c1565a5f29daee1551482ba8d'],0,1,1,1132497,1,,,,1460
ac3bfc1815962cc2458ae9c6bbf04912210dd153,0,Robert (Bobby) Evans,2015-01-06 15:38:25-06:00,"['f874464795685860c31fef5307f8ced39ed9480a', '40be5ddb94b674f8fcf2c804c7af96fbfe77776a']",4,3,7,1132504,1,,,,1460
5314b88a491d1ef972ff35ad0cd675efad7bfcda,0,Robert (Bobby) Evans,2015-01-06 15:39:03-06:00,['ac3bfc1815962cc2458ae9c6bbf04912210dd153'],0,1,1,1132505,1,,,,1460
bab1f566cdc8059d4c8bddc3fe30ba5ed498e7df,0,Robert (Bobby) Evans,2015-01-06 15:54:12-06:00,"['5314b88a491d1ef972ff35ad0cd675efad7bfcda', '231ac22b7caa254d96e2647e784747067d52cd38']",32,76,108,1132613,7,,,,1460
c092cc5cdfc8dfefaa3900719af619122ac255aa,0,Robert (Bobby) Evans,2015-01-06 15:54:50-06:00,['bab1f566cdc8059d4c8bddc3fe30ba5ed498e7df'],0,1,1,1132614,1,,,,1460
5b26e9618942ae10b3f47312c71c4a9c9f916c21,0,Robert (Bobby) Evans,2015-01-06 16:42:11-06:00,"['c092cc5cdfc8dfefaa3900719af619122ac255aa', 'b272f35bed7688427b2bb88904f632ff7cd01d82']",314,700,1014,1133628,12,,,,1460
e71e2a3f745ee770e20dfd9c878b26f5123877f4,0,Robert (Bobby) Evans,2015-01-06 16:43:35-06:00,['5b26e9618942ae10b3f47312c71c4a9c9f916c21'],0,1,1,1133629,1,,,,1460
ca235e6cb18006bbbac56361639309e73c196718,0,Parth Brahmbhatt,2015-01-06 17:43:58-05:00,['079deda496d16bd896611da706402c9df7e2319f'],5,17,22,1133651,3,0,0.909090909,0.272727273,1460
cd96dd0f29cee69747124373c9c58ed135ed0b4a,0,Parth Brahmbhatt,2015-01-06 17:44:28-05:00,"['ca235e6cb18006bbbac56361639309e73c196718', 'e71e2a3f745ee770e20dfd9c878b26f5123877f4']",390,840,1230,1134881,27,,,,1460
51dcc6b81bd787ca0941aab9d8b382537527cc79,1,fmazoyer,2015-01-07 11:14:37+01:00,['fba310af8cc2796af9314bd26217fe08552ad49c'],3,2,5,1134886,1,,,,1460
ffba148cc47a92185fa1a5db11f72982de10f106,0,caofangkun,2015-01-07 19:02:00+08:00,"['766e9cfa1b67884b692b5e92f9afe8eb228c0df7', '97ae36e42abc961fbcc54dd77c80bafff30dce7e']",1718,39558,41276,1176162,435,,,,1460
8bfa602876f84985864f136ee578bd2d9edb9ba7,0,Parth Brahmbhatt,2015-01-07 18:11:49-05:00,['cd96dd0f29cee69747124373c9c58ed135ed0b4a'],160,466,626,1176788,14,1,1,0.923076923,1464
7c665c77b948f129b4b44d677aa7b5a697a02836,0,caofangkun,2015-01-08 10:56:17+08:00,['ffba148cc47a92185fa1a5db11f72982de10f106'],16,757,773,1177561,6,1,1,1,1466
0b9bc2e0df417bf3faa4ff5be9f1c0a565cab9ca,0,caofangkun,2015-01-08 16:20:10+08:00,"['97ae36e42abc961fbcc54dd77c80bafff30dce7e', 'e71e2a3f745ee770e20dfd9c878b26f5123877f4']",606,1086,1692,1179253,60,,,,1466
61870151db95b1a8dd029d903352474374a51180,1,caokun,2015-01-08 16:25:09+08:00,"['7c665c77b948f129b4b44d677aa7b5a697a02836', '0b9bc2e0df417bf3faa4ff5be9f1c0a565cab9ca']",606,1086,1692,1180945,60,,,,1466
63562966db6ef3a07d3e65a417303efc7827d3c3,0,caofangkun,2015-01-08 17:09:03+08:00,['61870151db95b1a8dd029d903352474374a51180'],0,7,7,1180952,1,,,,1466
7681686f324c76a4f8df4887c6abdfe7074be23a,0,Parth Brahmbhatt,2015-01-08 11:51:53-05:00,['a17167e4eb6cea78d7da7fa2632c0cbbb3a40c7a'],32,0,32,1180984,2,,,,1466
5658bbbc84ca1076381ac2398ef423b4af30a1b4,0,Parth Brahmbhatt,2015-01-08 11:52:34-05:00,['7681686f324c76a4f8df4887c6abdfe7074be23a'],1,0,1,1180985,1,,,,1466
58667be951623848406f699f82cafa79a40cb496,0,Parth Brahmbhatt,2015-01-08 11:59:22-05:00,"['5658bbbc84ca1076381ac2398ef423b4af30a1b4', 'e71e2a3f745ee770e20dfd9c878b26f5123877f4']",609,1087,1696,1182681,60,,,,1466
f603a5e0c12fe902ac944a8e17ccc62b2d9f5ed8,0,lewuathe,2015-01-09 22:27:03+09:00,['e71e2a3f745ee770e20dfd9c878b26f5123877f4'],4,0,4,1182685,1,,,,1466
0983da334bd9c9c80214658ed0769b45a6a1351f,0,Robert (Bobby) Evans,2015-01-09 12:32:15-06:00,"['e71e2a3f745ee770e20dfd9c878b26f5123877f4', '93cf2c1d81a475bcb156a3ab8f519e8830c7d1f7']",1,10,11,1182696,3,,,,1466
a1268f110774508d3271c5e584c2a08a55514e18,0,Robert (Bobby) Evans,2015-01-09 12:34:13-06:00,['0983da334bd9c9c80214658ed0769b45a6a1351f'],0,2,2,1182698,2,,,,1466
c1e8782f7cfb3524b6c0d51fe48669fd09b87527,0,Parth Brahmbhatt,2015-01-09 13:52:33-05:00,['58667be951623848406f699f82cafa79a40cb496'],23,22,45,1182743,5,,,,1466
ca5e85ea7532775b1dc3da25fa6b13671b559251,0,Robert (Bobby) Evans,2015-01-09 15:14:01-06:00,"['a1268f110774508d3271c5e584c2a08a55514e18', '26c4008485928daf7592373d305af8893cbfaf40']",15,15,30,1182773,1,,,,1466
8e43c25130b55b0215ff70fa70a6eeb2b8246728,0,Robert (Bobby) Evans,2015-01-09 15:15:47-06:00,['ca5e85ea7532775b1dc3da25fa6b13671b559251'],0,2,2,1182775,2,,,,1466
fd066985a74c3140f61a465cfc49c83a6ddfa713,1,Rick Kilgore,2015-01-09 13:34:29-08:00,['f99fe8ee38249951688d11c8dc93d39d24c6b0ac'],8,21,29,1182804,1,1,1,1,1466
e702656ba5dfda33d9bf2d5a7b8e1622e842785a,0,Parth Brahmbhatt,2015-01-10 13:42:52-05:00,['d42d8dab3a7e5524f96ed1e9985381ca2936544e'],14,15,29,1182833,2,,,,1466
81a92045c2b5ddaabf822211b43c06ea6b60c1d2,0,Parth Brahmbhatt,2015-01-10 13:43:14-05:00,"['e702656ba5dfda33d9bf2d5a7b8e1622e842785a', '8e43c25130b55b0215ff70fa70a6eeb2b8246728']",401,876,1277,1184110,31,,,,1466
15aa671ec652ee00ef6c51bab31bbb4469ff39ec,0,Parth Brahmbhatt,2015-01-10 14:14:56-05:00,['81a92045c2b5ddaabf822211b43c06ea6b60c1d2'],1,1,2,1184112,1,,,,1466
77841313937ffa630e30ae811d671bea24600035,0,caofangkun,2015-01-12 09:51:40+08:00,['63562966db6ef3a07d3e65a417303efc7827d3c3'],743,0,743,1184855,1,,,,1466
a3d5c4e390add10fdf3873d301db5a42ea434578,0,caofangkun,2015-01-12 09:54:21+08:00,['77841313937ffa630e30ae811d671bea24600035'],0,1,1,1184856,1,,,,1466
09bcdd1bc6cca976a9901140a67cacdfc6a36a17,1,caofangkun,2015-01-12 09:59:25+08:00,['a3d5c4e390add10fdf3873d301db5a42ea434578'],8,2,10,1184866,2,,,,1466
80c84bd681e92f03b67d829d75011420830b36a0,1,caofangkun,2015-01-12 10:12:00+08:00,['09bcdd1bc6cca976a9901140a67cacdfc6a36a17'],2,1,3,1184869,1,,,,1466
00e633174914276cfbe724693b11852d8e7efcea,0,caofangkun,2015-01-12 12:31:33+08:00,['80c84bd681e92f03b67d829d75011420830b36a0'],2,2,4,1184873,2,,,,1466
ec2db7517b388f206ec8e269b1a1370ea95747d6,0,caofangkun,2015-01-12 15:00:53+08:00,['00e633174914276cfbe724693b11852d8e7efcea'],2,3,5,1184878,2,,,,1466
77d96f116e62957c1c5b3b33776de5292bcd5e36,0,caofangkun,2015-01-12 15:07:51+08:00,['ec2db7517b388f206ec8e269b1a1370ea95747d6'],1,0,1,1184879,1,,,,1466
8afdbbd43ff95697ae4f8aea366e68dd097ee114,0,caofangkun,2015-01-13 10:00:50+08:00,['77d96f116e62957c1c5b3b33776de5292bcd5e36'],2,1,3,1184882,1,,,,1466
802272ab1455763d649fdba647f167a3c8c87abd,0,caofangkun,2015-01-13 10:03:49+08:00,['8afdbbd43ff95697ae4f8aea366e68dd097ee114'],2,2,4,1184886,1,,,,1466
272749cdbfd4195a2652932998d523a209de6d3d,0,caofangkun,2015-01-13 12:42:39+08:00,['802272ab1455763d649fdba647f167a3c8c87abd'],89,701,790,1185676,11,0.376666667,0.666666667,1,1473
72d621ce81c98a3598f180a1ebdf419e0ad7aa6e,0,caofangkun,2015-01-13 12:43:40+08:00,['272749cdbfd4195a2652932998d523a209de6d3d'],27,0,27,1185703,2,,,,1473
2cef782f0d523ebb6db92f1f4e0c6a4625f69c06,0,caofangkun,2015-01-13 12:44:21+08:00,['72d621ce81c98a3598f180a1ebdf419e0ad7aa6e'],62,0,62,1185765,2,0,0,0,1473
0a96db477e7126bbf5c6a120c23d9176716a5d87,1,lewuathe,2015-01-13 22:21:47+09:00,['8e43c25130b55b0215ff70fa70a6eeb2b8246728'],1,21,22,1185787,3,,,,1473
14e12aa8d4d733510390afe55c779af2a527a9a3,0,caofangkun,2015-01-14 09:43:49+08:00,['2cef782f0d523ebb6db92f1f4e0c6a4625f69c06'],3,3,6,1185793,3,,,,1473
f4483fed4d654192033cdb0edaa6d8356c39ac36,0,caofangkun,2015-01-14 09:48:22+08:00,['14e12aa8d4d733510390afe55c779af2a527a9a3'],20,0,20,1185813,1,,,,1473
07656bd609650f680c3326b997137a7d15d213cd,0,lewuathe,2015-01-14 21:53:58+09:00,['8e43c25130b55b0215ff70fa70a6eeb2b8246728'],7,7,14,1185827,1,,,,1473
a784d8573f2fb835be16aa3543db7b1d4acd9953,0,Derek Dagit,2015-01-14 09:33:53-06:00,"['8e43c25130b55b0215ff70fa70a6eeb2b8246728', '41d1d9c0ef72db56c18fb1cc422f4dd949b32138']",1,3,4,1185831,2,,,,1473
bcb448d2045e6d82e582779c5b8d211e73b80564,0,Derek Dagit,2015-01-14 09:35:27-06:00,['a784d8573f2fb835be16aa3543db7b1d4acd9953'],0,1,1,1185832,1,,,,1473
e7dfcb2d6dc0c80fd8a8f6ba9bbac826a932a244,0,Robert (Bobby) Evans,2015-01-14 09:46:37-06:00,['bcb448d2045e6d82e582779c5b8d211e73b80564'],1,0,1,1185833,1,,,,1473
fca7c7673d6b7e3163531e0267789bfc37229c8b,0,Robert (Bobby) Evans,2015-01-14 09:46:37-06:00,['e7dfcb2d6dc0c80fd8a8f6ba9bbac826a932a244'],3,4,7,1185840,1,,,,1473
273fa637a193f3aa4c50dd901ed50d5a48e25a9e,0,Robert (Bobby) Evans,2015-01-14 09:58:01-06:00,"['fca7c7673d6b7e3163531e0267789bfc37229c8b', 'fd066985a74c3140f61a465cfc49c83a6ddfa713']",21,460,481,1186321,8,,,,1473
94b96087ba78853b97770a0968a5e9bea63811d4,0,Robert (Bobby) Evans,2015-01-14 09:58:49-06:00,['273fa637a193f3aa4c50dd901ed50d5a48e25a9e'],0,1,1,1186322,1,,,,1473
ee37870f4f8ba02ce9081d93164418aba0835aa3,1,Parth Brahmbhatt,2015-01-14 08:29:53-08:00,['8bfa602876f84985864f136ee578bd2d9edb9ba7'],0,80,80,1186402,1,0.4375,0.4375,1,1474
ab8a43de2aab88118213624413defec7281ae968,0,Robert (Bobby) Evans,2015-01-14 11:07:17-06:00,['94b96087ba78853b97770a0968a5e9bea63811d4'],0,42,42,1186444,2,1,1,0.5,1475
1d973c6838118e64024505269b82baffd0f41f8d,0,Derek Dagit,2015-01-14 11:12:30-06:00,['94b96087ba78853b97770a0968a5e9bea63811d4'],2,3,5,1186449,1,,,,1475
fc952d4c64f52e29cd162ffacee984ef36ab9447,0,Derek Dagit,2015-01-14 11:13:05-06:00,['1d973c6838118e64024505269b82baffd0f41f8d'],2,0,2,1186451,1,,,,1475
81fa587d2412d06fdcd2ce33f49dfe033829384d,0,Robert (Bobby) Evans,2015-01-14 11:13:17-06:00,"['94b96087ba78853b97770a0968a5e9bea63811d4', 'f603a5e0c12fe902ac944a8e17ccc62b2d9f5ed8']",4,0,4,1186455,1,,,,1475
1085f5061e28eb9038853278433b8bb52c406d5d,0,Robert (Bobby) Evans,2015-01-14 11:25:47-06:00,['81fa587d2412d06fdcd2ce33f49dfe033829384d'],0,1,1,1186456,1,,,,1475
396bc61992e1c41407b9ed92c02260d467a5ea8e,0,Parth Brahmbhatt,2015-01-14 11:21:26-08:00,['ee37870f4f8ba02ce9081d93164418aba0835aa3'],18,1,19,1186475,2,,,,1475
f217096cd36383639a7f7384e6ce34c78cf5d954,0,Parth Brahmbhatt,2015-01-14 11:42:20-08:00,['396bc61992e1c41407b9ed92c02260d467a5ea8e'],2,2,4,1186479,2,,,,1475
83f3d4bed0e4ac43b60e113e4821fcf23a3f8ab2,0,Parth Brahmbhatt,2015-01-14 12:27:35-08:00,['1085f5061e28eb9038853278433b8bb52c406d5d'],1,1,2,1186481,1,,,,1475
1e0f623f850f219e132ad0807e2d2aca16b64aa4,0,Parth Brahmbhatt,2015-01-14 14:24:45-08:00,['f217096cd36383639a7f7384e6ce34c78cf5d954'],19,32,51,1186532,9,0.5,0.5,1,1475
2d6c5ed338872cd464f3d42c27864f7530d2da9c,0,Parth Brahmbhatt,2015-01-14 14:59:14-08:00,['1e0f623f850f219e132ad0807e2d2aca16b64aa4'],25,56,81,1186613,10,0.833333333,0.944444444,1,1475
d00d18e24ee8287803a9508e46f4028222edff84,0,Parth Brahmbhatt,2015-01-14 15:16:11-08:00,['2d6c5ed338872cd464f3d42c27864f7530d2da9c'],5,15,20,1186633,3,1,1,0.5,1475
dce58c465519bf17d1641c5b807e91545df93f97,0,Sriharsha Chintalapani,2015-01-15 07:22:41-08:00,"['1085f5061e28eb9038853278433b8bb52c406d5d', '51dcc6b81bd787ca0941aab9d8b382537527cc79']",16,54,70,1186703,4,,,,1475
274317e175bdd4ed86618864e0fb237d2f0de4c8,1,Nathan Marz,2015-01-15 17:40:57-05:00,['1085f5061e28eb9038853278433b8bb52c406d5d'],0,11,11,1186714,1,,,,1475
2033825ff89ea9d710f25a4edcc29bef9bcda6d3,0,Paul DelRe,2015-01-16 11:18:06-05:00,['274317e175bdd4ed86618864e0fb237d2f0de4c8'],2,2,4,1186718,1,,,,1475
589463411046c2ed6694c6d4ed85510b064ab8eb,0,Sriharsha Chintalapani,2015-01-16 08:40:37-08:00,['dce58c465519bf17d1641c5b807e91545df93f97'],0,2,2,1186720,1,,,,1475
49553518d9d4a2265776d253c70e4be0d43cbac7,0,Sriharsha Chintalapani,2015-01-16 08:41:36-08:00,"['274317e175bdd4ed86618864e0fb237d2f0de4c8', '589463411046c2ed6694c6d4ed85510b064ab8eb']",16,56,72,1186792,5,,,,1475
d4b49e91e0e6662bf42532814c4b564f124c338a,0,Miracle (Jian) Zhou,2015-01-16 17:39:42-05:00,['49553518d9d4a2265776d253c70e4be0d43cbac7'],1,1,2,1186794,1,,,,1475
6e04647258d8f5147448bdd8fbc7d6be08fc3a16,0,Miracle (Jian) Zhou,2015-01-16 17:40:16-05:00,['d4b49e91e0e6662bf42532814c4b564f124c338a'],1,1,2,1186796,1,,,,1475
c7feb18459ff2d71fccdb5e903524916ea9ef62b,0,Sriharsha Chintalapani,2015-01-16 15:21:46-08:00,['6e04647258d8f5147448bdd8fbc7d6be08fc3a16'],0,1,1,1186797,1,,,,1475
3ff904bda707cda69639180e542ecf6578ddbf37,0,Sriharsha Chintalapani,2015-01-16 15:54:37-08:00,"['c7feb18459ff2d71fccdb5e903524916ea9ef62b', '07656bd609650f680c3326b997137a7d15d213cd']",7,7,14,1186811,1,,,,1475
3401387624e9e165221bc5ee6d05394906975c04,0,Sriharsha Chintalapani,2015-01-16 15:58:03-08:00,"['3ff904bda707cda69639180e542ecf6578ddbf37', '15aa671ec652ee00ef6c51bab31bbb4469ff39ec']",7,8,15,1186826,3,,,,1475
e485e08e0b4c61be7505119551623efa81b7dae0,0,Sriharsha Chintalapani,2015-01-16 16:09:08-08:00,['3401387624e9e165221bc5ee6d05394906975c04'],0,1,1,1186827,1,,,,1475
dd20c3ad91b0a8c3c824f3d3ff28636fdfda9690,1,lewuathe,2015-01-19 20:42:15+09:00,['e485e08e0b4c61be7505119551623efa81b7dae0'],1,4,5,1186832,2,,,,1475
7816f5a4292ccff0ebd18f517490a2e984421327,0,Robert (Bobby) Evans,2015-01-20 12:34:33-06:00,"['e485e08e0b4c61be7505119551623efa81b7dae0', 'fc952d4c64f52e29cd162ffacee984ef36ab9447']",4,3,7,1186839,1,,,,1475
bc54e8ed5a6c53f8069dc411654ad6b040a5e2d3,0,Robert (Bobby) Evans,2015-01-20 12:35:17-06:00,['7816f5a4292ccff0ebd18f517490a2e984421327'],0,1,1,1186840,1,,,,1475
ca255cc7f622b01e1e8869d1089583b7a4170d94,0,Joshi,2015-01-20 13:23:27-08:00,['bc54e8ed5a6c53f8069dc411654ad6b040a5e2d3'],3,3,6,1186846,2,,,,1475
cc784591df8eafea6e6f4ef124e9abc93b31e82c,0,Jungtaek Lim,2015-01-21 08:26:06+09:00,['3cee80fc12ca5cdab5a200ac52d67ca55e1a1c69'],50,0,50,1186896,7,,,,1475
3356c8692d1538f35a49527acd06d98013755673,0,DashengJu,2015-01-21 10:34:22+08:00,"['3cee80fc12ca5cdab5a200ac52d67ca55e1a1c69', 'cc784591df8eafea6e6f4ef124e9abc93b31e82c']",50,0,50,1186946,7,,,,1475
dad3b80f938616f810d29b1a147e24faba765d22,0,dashengju,2015-01-21 10:50:22+08:00,['3356c8692d1538f35a49527acd06d98013755673'],0,1,1,1186947,1,,,,1475
5daeb08226b646d06598e69fda36fcd9bdea21a1,0,dashengju,2015-01-21 10:56:09+08:00,['dad3b80f938616f810d29b1a147e24faba765d22'],3,3,6,1186953,1,,,,1475
dd92c0d87e589b345ae1167e7318e43ba44556bf,0,lewuathe,2015-01-21 22:04:14+09:00,['bc54e8ed5a6c53f8069dc411654ad6b040a5e2d3'],3,3,6,1186959,2,,,,1475
93bb2337cee4ab7c010a7ec46246dc2df219743e,0,Parth Brahmbhatt,2015-01-21 14:20:19-08:00,['d00d18e24ee8287803a9508e46f4028222edff84'],0,0,0,1186959,1,,,,1475
bb927c865b92126caaa874550f478501086ab08d,0,Parth Brahmbhatt,2015-01-21 14:40:56-08:00,['93bb2337cee4ab7c010a7ec46246dc2df219743e'],3,2,5,1186964,1,,,,1475
bf9a311848de6ac2abf5cbbe987953b120fd813c,1,Sriharsha Chintalapani,2015-01-21 17:45:14-08:00,['bc54e8ed5a6c53f8069dc411654ad6b040a5e2d3'],2,1,3,1186967,1,,,,1475
1cfa190f2efb06f8798984b43dec801e5ff20ad5,1,Derek Dagit,2015-01-22 10:46:03-06:00,['bc54e8ed5a6c53f8069dc411654ad6b040a5e2d3'],23,1812,1835,1188802,14,0.574762316,0.668971478,0.949870354,1477
476634bbd09047d932d4d9ecbbce1647e35ca1dd,0,Robert (Bobby) Evans,2015-01-22 11:24:54-06:00,"['bc54e8ed5a6c53f8069dc411654ad6b040a5e2d3', '83f3d4bed0e4ac43b60e113e4821fcf23a3f8ab2']",1,1,2,1188804,1,,,,1477
90561baf443130253edad69a4e4bf8ed71963087,0,Robert (Bobby) Evans,2015-01-22 11:25:17-06:00,['476634bbd09047d932d4d9ecbbce1647e35ca1dd'],1,2,3,1188807,1,,,,1477
45f20be4cd0627e5c3d451d996f68edd4cb38ca3,0,Robert (Bobby) Evans,2015-01-22 11:36:04-06:00,"['90561baf443130253edad69a4e4bf8ed71963087', 'f4483fed4d654192033cdb0edaa6d8356c39ac36']",29,661,690,1189497,12,,,,1477
01e75ec9e4e0429640e9fd9b8aad7aa7091d433b,0,Robert (Bobby) Evans,2015-01-22 11:38:02-06:00,['45f20be4cd0627e5c3d451d996f68edd4cb38ca3'],0,18,18,1189515,2,,,,1477
516097efc72c79f2bad28585f413a78c10c6c9d5,0,Sriharsha Chintalapani,2015-01-22 10:35:41-08:00,['bf9a311848de6ac2abf5cbbe987953b120fd813c'],1,3,4,1189519,1,,,,1477
ef85387299e48051abe2434a58adbd74376190e0,0,Sriharsha Chintalapani,2015-01-22 15:04:35-08:00,['90561baf443130253edad69a4e4bf8ed71963087'],3,5,8,1189527,1,,,,1477
6c04e1bea802d28ae92a234ddbaad2c1ed0a6835,0,caofangkun,2015-01-23 09:28:46+08:00,"['0b9bc2e0df417bf3faa4ff5be9f1c0a565cab9ca', '01e75ec9e4e0429640e9fd9b8aad7aa7091d433b']",106,1264,1370,1190897,35,,,,1477
27a381aef63b0929aedc5e85b6536f8ac29a14fd,0,Parth Brahmbhatt,2015-01-22 23:10:02-08:00,['c1e8782f7cfb3524b6c0d51fe48669fd09b87527'],2,2,4,1190901,2,,,,1477
095f56eed6f9ea682f74bd6fd0d09e529cdc8490,0,Gianmarco De Francisci Morales,2015-01-23 16:04:20+01:00,['01e75ec9e4e0429640e9fd9b8aad7aa7091d433b'],1,70,71,1190972,3,1,1,0.857142857,1479
b0b6c5a7ba04eeb6ffc2496770d169e11de7db92,0,Gianmarco De Francisci Morales,2015-01-23 16:43:13+01:00,['095f56eed6f9ea682f74bd6fd0d09e529cdc8490'],0,34,34,1191006,2,,,,1479
4e5c7ccad90ce11f6072dd24186ddccff98402fa,0,Robert (Bobby) Evans,2015-01-23 14:00:37-06:00,"['01e75ec9e4e0429640e9fd9b8aad7aa7091d433b', 'dd92c0d87e589b345ae1167e7318e43ba44556bf']",3,3,6,1191012,2,,,,1479
f57e3b647c27b39fcb3daacc0427fc01393d9af7,0,Robert (Bobby) Evans,2015-01-23 14:02:13-06:00,"['4e5c7ccad90ce11f6072dd24186ddccff98402fa', '7dab18f42690cfcc40a54c01760c81850937dabe']",7,3,10,1191022,2,,,,1479
cd99ca197aa956ff43528b75774933370c2f0f31,0,Robert (Bobby) Evans,2015-01-23 14:05:23-06:00,['f57e3b647c27b39fcb3daacc0427fc01393d9af7'],0,2,2,1191024,2,,,,1479
91cd49f94a2acf4468f82772483287e00eb98b6a,0,Robert (Bobby) Evans,2015-01-23 15:05:51-06:00,"['cd99ca197aa956ff43528b75774933370c2f0f31', 'dd20c3ad91b0a8c3c824f3d3ff28636fdfda9690']",1,4,5,1191029,2,,,,1479
82caf66806ba60fbe4bbe340512a7f62e5452513,0,Robert (Bobby) Evans,2015-01-23 15:07:06-06:00,['91cd49f94a2acf4468f82772483287e00eb98b6a'],0,1,1,1191030,1,,,,1479
95211d79ca506f0b658011f7c54ff4d312da99bd,0,Hari Sekhon,2015-01-27 22:03:17+00:00,['82caf66806ba60fbe4bbe340512a7f62e5452513'],1,1,2,1191032,1,,,,1479
842b5526469bc6c2fe763498faf4dfb76fcadcd7,0,Zhihui Jiao,2015-01-28 11:17:43+08:00,['82caf66806ba60fbe4bbe340512a7f62e5452513'],0,1,1,1191033,1,1,1,1,1479
40a6cf08cdf6f4269e7e41d3c7d8026e340767da,1,Zhihui Jiao,2015-01-28 20:48:22+08:00,['82caf66806ba60fbe4bbe340512a7f62e5452513'],1,1,2,1191035,1,,,,1479
6136a1586f6316d6e6c85a38e299c761fe59dda3,0,Robert (Bobby) Evans,2015-01-29 08:26:54-06:00,"['82caf66806ba60fbe4bbe340512a7f62e5452513', 'b0b6c5a7ba04eeb6ffc2496770d169e11de7db92']",1,104,105,1191140,3,,,,1479
a115c9df803543f6c2d378c747ae6a58ab4239ea,0,Robert (Bobby) Evans,2015-01-29 08:28:04-06:00,['6136a1586f6316d6e6c85a38e299c761fe59dda3'],0,2,2,1191142,2,,,,1479
6b061aaab5a39e4b95670e3f0590bb48de4375fd,1,Sriharsha Chintalapani,2015-01-29 10:22:20-08:00,['a115c9df803543f6c2d378c747ae6a58ab4239ea'],21,37,58,1191200,1,,,,1479
eaedc83ccfa9cfb150d7ef3e3ba2c4cc5445cb60,1,Sriharsha Chintalapani,2015-01-29 16:14:18-08:00,['6b061aaab5a39e4b95670e3f0590bb48de4375fd'],52,59,111,1191311,1,,,,1479
8d5ac19aceac9cf1bbee0a2cef20ee67d570085b,1,Sriharsha Chintalapani,2015-01-29 22:33:01-08:00,['eaedc83ccfa9cfb150d7ef3e3ba2c4cc5445cb60'],4,5,9,1191320,1,,,,1479
715dfb9a430990835f531c316c93e0b99df626c8,0,lewuathe,2015-01-31 00:08:55+09:00,['a115c9df803543f6c2d378c747ae6a58ab4239ea'],0,10,10,1191330,1,,,,1479
dbefc0da83cc7587766b39b215c7f2a21a5ef573,1,Robert (Bobby) Evans,2015-01-30 15:47:11-06:00,['a115c9df803543f6c2d378c747ae6a58ab4239ea'],17,348,365,1191695,13,0.567164179,1,0.865671642,1481
b610e3c2b9c12006a3c1826878072414d3497ce9,0,Robert (Bobby) Evans,2015-02-02 14:09:33-06:00,['a115c9df803543f6c2d378c747ae6a58ab4239ea'],5,1,6,1191701,1,,,,1481
5e7d812edff8fc24fccdf854bb0f4e28b233515f,0,Robert (Bobby) Evans,2015-02-02 14:11:50-06:00,['b610e3c2b9c12006a3c1826878072414d3497ce9'],0,2,2,1191703,2,,,,1481
0cc6230a300d8ad9bce3d02a460ebaba9acdb3ec,0,Robert (Bobby) Evans,2015-02-02 14:17:01-06:00,"['5e7d812edff8fc24fccdf854bb0f4e28b233515f', '0a96db477e7126bbf5c6a120c23d9176716a5d87']",1,21,22,1191725,3,,,,1481
103de9a79fc26fe93481c2d69a9268889f34a076,0,Robert (Bobby) Evans,2015-02-02 14:22:18-06:00,['0cc6230a300d8ad9bce3d02a460ebaba9acdb3ec'],0,1,1,1191726,1,,,,1481
ef51dbeeb1a5a748deb7ee4f399ef430df443525,1,Kishor Patil,2015-02-02 23:44:30+00:00,['a115c9df803543f6c2d378c747ae6a58ab4239ea'],6436,14557,20993,1212719,54,0.389012621,0.779510022,0.987193764,1481
5eefcfbe331d54216850041a3268d45a20d1933e,0,Sriharsha Chintalapani,2015-02-02 15:45:57-08:00,['103de9a79fc26fe93481c2d69a9268889f34a076'],1,2,3,1212722,1,0,1,1,1481
b61dd3ab143686a8191a47652ca63c6c46992982,0,Sriharsha Chintalapani,2015-02-02 16:09:14-08:00,['103de9a79fc26fe93481c2d69a9268889f34a076'],1,1,2,1212724,1,,,,1481
d8d73a2e095329c5eeda44255ba369e96c4c546f,1,Sriharsha Chintalapani,2015-02-02 16:37:15-08:00,['103de9a79fc26fe93481c2d69a9268889f34a076'],10,13,23,1212747,2,,,,1481
e3ee3a3c3f3f8da03dcecf2c7cd617ec6826b445,0,Sriharsha Chintalapani,2015-02-02 16:49:40-08:00,['103de9a79fc26fe93481c2d69a9268889f34a076'],0,1,1,1212748,1,,,,1481
a9cdaf0c7b21d916b78bda008750d650162b4e27,1,Nathan Marz,2015-02-02 16:58:49-08:00,['103de9a79fc26fe93481c2d69a9268889f34a076'],2,2,4,1212752,1,,,,1481
01eee7aa519c9d63afc38f2f61a53f48913c0a28,0,Parth Brahmbhatt,2015-02-02 23:37:17-08:00,['27a381aef63b0929aedc5e85b6536f8ac29a14fd'],14,14,28,1212780,4,,,,1481
5ff14142995a18a8b6fd81b126f610b1aa0bd0f4,0,lewuathe,2015-02-03 18:23:53+09:00,['a9cdaf0c7b21d916b78bda008750d650162b4e27'],0,1,1,1212781,1,,,,1481
50001f55ef1a1d87bdca2f39618dbe91be09db04,0,lewuathe,2015-02-03 18:42:12+09:00,['715dfb9a430990835f531c316c93e0b99df626c8'],10,2,12,1212793,2,,,,1481
4271360fde9ab4db7b384848bc9b4808a0ccca98,1,Robert (Bobby) Evans,2015-02-03 07:36:57-06:00,['a9cdaf0c7b21d916b78bda008750d650162b4e27'],3139,946,4085,1216878,33,1,1,1,1499
b54b3b41e97b36dfea0d5cb3b887f23bbc29725e,1,Robert (Bobby) Evans,2015-02-03 07:36:57-06:00,['4271360fde9ab4db7b384848bc9b4808a0ccca98'],140,153,293,1217171,8,0,0,0,1499
4abc6b5d343b2cc11403badb81dbed57c4795d7c,0,Robert (Bobby) Evans,2015-02-03 11:00:25-06:00,"['a9cdaf0c7b21d916b78bda008750d650162b4e27', '516097efc72c79f2bad28585f413a78c10c6c9d5']",2,3,5,1217176,1,,,,1499
bbcf749ca3c2557fabfc07db573e6d43eaf63d36,0,Robert (Bobby) Evans,2015-02-03 11:09:24-06:00,['4abc6b5d343b2cc11403badb81dbed57c4795d7c'],0,1,1,1217177,1,,,,1499
01d78c726d15a5ac9a4676e6b85b41b6eff9b857,0,Robert (Bobby) Evans,2015-02-03 12:34:57-06:00,"['bbcf749ca3c2557fabfc07db573e6d43eaf63d36', '1cfa190f2efb06f8798984b43dec801e5ff20ad5']",23,1812,1835,1219012,14,,,,1499
1f35f41a879c8e12a77b1eb8f0695507486a88a6,0,Robert (Bobby) Evans,2015-02-03 12:52:59-06:00,['01d78c726d15a5ac9a4676e6b85b41b6eff9b857'],1,2,3,1219015,1,,,,1499
01e6b12fc9a62e496998cd84f18991b50fc542d9,0,Robert (Bobby) Evans,2015-02-03 12:56:47-06:00,"['1f35f41a879c8e12a77b1eb8f0695507486a88a6', '8f3530404f3550415146c484d31765028c0d98b9']",0,23,23,1219038,2,,,,1499
8491151b67bf07c86032b78e30ce44912fd66def,0,Robert (Bobby) Evans,2015-02-03 13:32:19-06:00,['01e6b12fc9a62e496998cd84f18991b50fc542d9'],0,1,1,1219039,1,,,,1499
639006432c658226bd33dc2ae607f121f3dc02bb,1,Parth Brahmbhatt,2015-02-03 11:52:15-08:00,['a115c9df803543f6c2d378c747ae6a58ab4239ea'],203,5957,6160,1225199,36,0.362263185,0.39656938,0.982846902,1511
8358bdeee00512b7d628c37cd53116556d379ef3,0,Kyle Nusbaum,2015-02-03 15:35:55-06:00,"['6c504613c5cb7dead19c59f17f87d7d8179a0671', '8491151b67bf07c86032b78e30ce44912fd66def']",3530,50619,54149,1279348,517,,,,1511
3f3e0042675d4fa5f1b07bdcc1840508ab2cf3ff,1,Sriharsha Chintalapani,2015-02-03 14:22:04-08:00,['8491151b67bf07c86032b78e30ce44912fd66def'],13,73,86,1279434,3,,,,1511
e157edb2697eeb32cf371d6556e450c343747407,0,Parth Brahmbhatt,2015-02-03 15:21:35-08:00,['bb927c865b92126caaa874550f478501086ab08d'],38,87,125,1279559,7,0.6,0.2,0,1511
017360bdeeccd907d86b36e686f1379d2907ce97,0,Parth Brahmbhatt,2015-02-03 15:22:35-08:00,"['e157edb2697eeb32cf371d6556e450c343747407', '8491151b67bf07c86032b78e30ce44912fd66def']",149,3249,3398,1282957,56,,,,1511
d8c98cb1846bd07aef558bde410607b923aa5c1e,0,caofangkun,2015-02-04 09:09:22+08:00,"['6c04e1bea802d28ae92a234ddbaad2c1ed0a6835', '8491151b67bf07c86032b78e30ce44912fd66def']",43,1985,2028,1284985,30,,,,1511
1b6491f1547ccd796aec387b8622a5c34bda0a81,1,Parth Brahmbhatt,2015-02-03 17:33:19-08:00,['01eee7aa519c9d63afc38f2f61a53f48913c0a28'],29,238,267,1285252,9,0.126506024,0.228915663,0.987951807,1511
ff1168a1d1d3181dc53f61043ce6f226e1823afd,1,P. Taylor Goetz,2015-02-03 20:45:14-05:00,['8491151b67bf07c86032b78e30ce44912fd66def'],0,18,18,1285270,1,,,,1512
be64b2536b7b04db8182b1b39d893dd8c9109e01,0,Robert (Bobby) Evans,2015-02-04 10:51:24-06:00,['8491151b67bf07c86032b78e30ce44912fd66def'],1,1,2,1285272,1,,,,1512
ba6eed054ead6c094a4e33010db32c7186237191,0,Kyle Nusbaum,2015-02-04 16:07:44-06:00,['8358bdeee00512b7d628c37cd53116556d379ef3'],114,77,191,1285463,25,,,,1512
965da06a5997773ea5401d73e48e203f4db46727,0,Kyle Nusbaum,2015-02-05 09:20:02-06:00,['ba6eed054ead6c094a4e33010db32c7186237191'],1,1,2,1285465,1,,,,1512
55924cdc091522aa5653aec138962b233d295f43,0,Kyle Nusbaum,2015-02-05 09:31:35-06:00,['965da06a5997773ea5401d73e48e203f4db46727'],1,0,1,1285466,1,,,,1512
2712ee9b8a4912f74acf33fe1cef7195890ab4fc,0,Sriharsha Chintalapani,2015-02-05 11:02:11-08:00,['8d5ac19aceac9cf1bbee0a2cef20ee67d570085b'],18,25,43,1285509,1,,,,1512
8b534744064b68ccbddb85ac4acf5683bcbd61c6,1,P. Taylor Goetz,2015-02-05 17:07:08-05:00,['8491151b67bf07c86032b78e30ce44912fd66def'],16,15,31,1285540,1,,,,1512
c40c1727799bc34073eaa5d56de4a5e7ffa773ff,0,dashengju,2015-02-06 10:08:46+08:00,['5daeb08226b646d06598e69fda36fcd9bdea21a1'],3,0,3,1285543,1,,,,1512
a99e1276e282a7e3bd2ecd9c9b0a54a30f541228,0,Kishor Patil,2015-02-06 02:40:40+00:00,"['ef51dbeeb1a5a748deb7ee4f399ef430df443525', 'be64b2536b7b04db8182b1b39d893dd8c9109e01']",67,2212,2279,1287822,55,,,,1512
4f468d91494811f22f82154698317e7ed7cabf29,0,Derek Dagit,2015-02-06 17:47:06-06:00,['be64b2536b7b04db8182b1b39d893dd8c9109e01'],2,3,5,1287827,1,,,,1512
b1c993b288385f637fa26b840a11532c7b60a6c7,1,caofangkun,2015-02-09 13:23:23+08:00,['d8c98cb1846bd07aef558bde410607b923aa5c1e'],1,12,13,1287840,3,,,,1512
91fefef439388bb3f6f144f6eecd24213ad1cc62,0,caofangkun,2015-02-09 14:14:06+08:00,['d8c98cb1846bd07aef558bde410607b923aa5c1e'],12,2,14,1287854,2,,,,1512
0b01d0a7217b5eab23c85104021a0d53dc5e8482,0,Derek Dagit,2015-02-09 10:08:28-06:00,"['be64b2536b7b04db8182b1b39d893dd8c9109e01', 'ab8a43de2aab88118213624413defec7281ae968']",0,42,42,1287896,2,,,,1512
2b39a39cb37ca83cd21a3a856ae410c7f1f5a5b9,0,Derek Dagit,2015-02-09 10:09:21-06:00,['0b01d0a7217b5eab23c85104021a0d53dc5e8482'],0,1,1,1287897,1,,,,1512
79d819a10bfea01b31fed70a16cbf3ccbe546f46,0,Derek Dagit,2015-02-09 10:14:53-06:00,"['2b39a39cb37ca83cd21a3a856ae410c7f1f5a5b9', '3ad05ca3565f0d33693e7bff6a5af6fd20afce46']",2,2,4,1287901,1,,,,1512
b920bae3643dd16d348da1150fb5531465f87bc5,0,Derek Dagit,2015-02-09 10:16:00-06:00,['79d819a10bfea01b31fed70a16cbf3ccbe546f46'],0,1,1,1287902,1,,,,1512
74e8ffb4b5dc8afa0a0153506b9f1616d1080bd2,0,Derek Dagit,2015-02-09 10:34:06-06:00,"['b920bae3643dd16d348da1150fb5531465f87bc5', '2033825ff89ea9d710f25a4edcc29bef9bcda6d3']",2,2,4,1287906,1,,,,1512
e57a6bd3f49ccee17185ab35f9a5400ff18dae56,0,Derek Dagit,2015-02-09 10:39:27-06:00,['74e8ffb4b5dc8afa0a0153506b9f1616d1080bd2'],0,2,2,1287908,2,,,,1512
0bc25fbf990202d6838fb944891d425dd2ba4140,0,Robert (Bobby) Evans,2015-02-09 10:54:49-06:00,"['b920bae3643dd16d348da1150fb5531465f87bc5', 'dbefc0da83cc7587766b39b215c7f2a21a5ef573']",17,348,365,1288273,13,,,,1512
bb6f32dffaa3865b8b374c8fb1d7d7af48ebe4d4,0,Robert (Bobby) Evans,2015-02-09 10:55:26-06:00,['0bc25fbf990202d6838fb944891d425dd2ba4140'],0,1,1,1288274,1,,,,1512
15f99fd0d232821289dafbbd9a8b837d4f2313c8,0,Derek Dagit,2015-02-09 11:00:32-06:00,['e57a6bd3f49ccee17185ab35f9a5400ff18dae56'],2,2,4,1288278,1,,,,1512
8036109f68d77802cfd8c4a1e1bb14d4f9e9ff82,0,Robert (Bobby) Evans,2015-02-09 12:32:46-06:00,"['15f99fd0d232821289dafbbd9a8b837d4f2313c8', 'bb6f32dffaa3865b8b374c8fb1d7d7af48ebe4d4']",17,349,366,1288644,14,,,,1512
0571e22c15a1214c3e08510fddad608571f6a6d8,0,Parth Brahmbhatt,2015-02-09 12:47:36-08:00,"['639006432c658226bd33dc2ae607f121f3dc02bb', '8036109f68d77802cfd8c4a1e1bb14d4f9e9ff82']",59,2272,2331,1290975,40,,,,1512
3af6d18ed2d3b5998d0f7a0e87a10ce220eb207d,0,caofangkun,2015-02-10 10:07:16+08:00,"['d8c98cb1846bd07aef558bde410607b923aa5c1e', '8036109f68d77802cfd8c4a1e1bb14d4f9e9ff82']",24,402,426,1291401,19,,,,1512
288cc322774721c2e3ae6c84161ec1bd9d3f24b1,0,lewuathe,2015-02-10 22:06:23+09:00,['8036109f68d77802cfd8c4a1e1bb14d4f9e9ff82'],0,132,132,1291533,2,,,,1512
2be8acd69b6bd89425539231b4b79a10e831e2d7,1,lewuathe,2015-02-10 22:40:21+09:00,['8036109f68d77802cfd8c4a1e1bb14d4f9e9ff82'],72,72,144,1291677,16,,,,1512
d819db1eb3ecb0d7c31b35607e59def1a78da441,0,Parth Brahmbhatt,2015-02-10 13:26:39-08:00,['8036109f68d77802cfd8c4a1e1bb14d4f9e9ff82'],1,17,18,1291695,1,,,,1512
5cf2a549210a31b853af32d94da8eaafacf8787f,0,Parth Brahmbhatt,2015-02-10 13:32:14-08:00,['d819db1eb3ecb0d7c31b35607e59def1a78da441'],10,8,18,1291713,4,0,1,1,1512
db1182d753a6cc911a220d2891c8efd2f093d77c,1,Parth Brahmbhatt,2015-02-10 14:07:31-08:00,['8036109f68d77802cfd8c4a1e1bb14d4f9e9ff82'],18,29,47,1291760,2,,,,1512
205eaf4ebe28ab5550a842ea9aabd23b41678743,1,Michael G. Noll,2015-02-11 19:55:53+01:00,['8036109f68d77802cfd8c4a1e1bb14d4f9e9ff82'],364,736,1100,1292860,10,1,1,1,1514
1d9b28373faeb4a4d7b9017d8ffd130f3397b052,0,caofangkun,2015-02-12 09:25:05+08:00,['b1c993b288385f637fa26b840a11532c7b60a6c7'],3,3,6,1292866,1,,,,1514
81772b22668d51852b65bc8bbe0d83116c07e383,1,Sriharsha Chintalapani,2015-02-12 08:53:43-08:00,['8036109f68d77802cfd8c4a1e1bb14d4f9e9ff82'],2,3148,3150,1296016,21,0.416413374,0.806079027,0.851671733,1532
e85b79a9b1d08d8a9bc534bb96be84b25a1ee831,0,Sriharsha Chintalapani,2015-02-12 08:53:44-08:00,['81772b22668d51852b65bc8bbe0d83116c07e383'],6,6,12,1296028,2,,,,1532
d9568f99841e8449f41353e409eac73aeb3b6dc7,0,P. Taylor Goetz,2015-02-12 12:20:30-05:00,['8036109f68d77802cfd8c4a1e1bb14d4f9e9ff82'],1,1,2,1296030,1,,,,1532
674ceae7bdfba512cad0053dc5fd34026cc5b57f,0,Sriharsha Chintalapani,2015-02-12 09:46:50-08:00,"['e85b79a9b1d08d8a9bc534bb96be84b25a1ee831', 'dfb8e3709d27691a2f97bbc3e49491f13a9769d1']",0,0,0,1296030,0,,,,1532
b0cbb493e541b4b3762b1adfed695abbb39ec863,0,Sriharsha Chintalapani,2015-02-12 09:47:04-08:00,['674ceae7bdfba512cad0053dc5fd34026cc5b57f'],1,1,2,1296032,1,,,,1532
b3597e1892ec30a095edc7a5a75b199faf6bced3,1,Sriharsha Chintalapani,2015-02-12 09:51:27-08:00,['3f3e0042675d4fa5f1b07bdcc1840508ab2cf3ff'],1,1,2,1296034,1,,,,1532
4502bffbe3f9b4cd3674a56afbda1bb115cec239,1,Parth Brahmbhatt,2015-02-12 11:27:50-08:00,['1b6491f1547ccd796aec387b8622a5c34bda0a81'],360,1297,1657,1297691,9,0.317629179,0.223404255,0.96656535,1533
aa24375258626ed6cb3db5257ebc6b7708558bb0,0,Parth Brahmbhatt,2015-02-12 12:01:52-08:00,['4502bffbe3f9b4cd3674a56afbda1bb115cec239'],1,3,4,1297695,1,,,,1533
7cae523e3c8e86688a371da9bae809cb4c244358,1,Parth Brahmbhatt,2015-02-12 14:57:26-08:00,['aa24375258626ed6cb3db5257ebc6b7708558bb0'],22,40,62,1297757,4,0,0,1,1533
0b454e8ebfebdf144f204169f6c75ae4f8fb0a63,0,Parth Brahmbhatt,2015-02-12 15:00:30-08:00,['7cae523e3c8e86688a371da9bae809cb4c244358'],1,0,1,1297758,1,,,,1533
27ad1fb25caa5eb20f477c89cf57c801b6cec3c2,0,Parth Brahmbhatt,2015-02-12 15:47:38-08:00,['0b454e8ebfebdf144f204169f6c75ae4f8fb0a63'],26,16,42,1297800,2,,,,1533
726ce80be94bbfc5e70813221b36b6f4dfce4ccf,1,Parth Brahmbhatt,2015-02-12 15:54:27-08:00,['27ad1fb25caa5eb20f477c89cf57c801b6cec3c2'],1,31,32,1297832,1,,,,1533
63f29f349b469746fd1a4507151ec47942e03e58,0,Parth Brahmbhatt,2015-02-12 16:14:14-08:00,['726ce80be94bbfc5e70813221b36b6f4dfce4ccf'],0,6,6,1297838,1,,,,1533
23ed53754c47a2170e58b178beb1544616f0f08a,0,Parth Brahmbhatt,2015-02-12 16:44:06-08:00,"['63f29f349b469746fd1a4507151ec47942e03e58', '8036109f68d77802cfd8c4a1e1bb14d4f9e9ff82']",159,3647,3806,1301644,71,,,,1533
a8aacca6444a30638162ac27f8c7213a4a96aed1,0,Parth Brahmbhatt,2015-02-12 16:44:52-08:00,['23ed53754c47a2170e58b178beb1544616f0f08a'],12,2,14,1301658,2,,,,1533
18a68a074570db01fc6377a269feb90ecda898ab,1,P. Taylor Goetz,2015-02-12 20:51:27-05:00,['8b534744064b68ccbddb85ac4acf5683bcbd61c6'],1,1,2,1301660,1,,,,1533
54b6a69f044c7a93b7871e6237d33fc612cc90f7,0,Sriharsha Chintalapani,2015-02-12 20:07:33-08:00,['b0cbb493e541b4b3762b1adfed695abbb39ec863'],1,3,4,1301664,1,,,,1533
0ee865750e8d54c00d2abac81c20c429483bc646,0,zhangjinlong,2015-02-16 13:49:06+08:00,['8036109f68d77802cfd8c4a1e1bb14d4f9e9ff82'],1,1,2,1301666,1,,,,1533
b60ab23c467b7bc3d7cd1de34b3ce52126148743,0,Michael G. Noll,2015-02-16 10:01:27+01:00,['205eaf4ebe28ab5550a842ea9aabd23b41678743'],0,1,1,1301667,1,1,1,1,1533
006134383ed448084e358f993e34f12ba5b45dcf,0,Michael G. Noll,2015-02-16 10:03:07+01:00,['b60ab23c467b7bc3d7cd1de34b3ce52126148743'],3,3,6,1301673,1,,,,1533
522d96e5953037728422935d31401a58e943c688,0,Michael G. Noll,2015-02-16 10:07:35+01:00,['006134383ed448084e358f993e34f12ba5b45dcf'],2,2,4,1301677,1,,,,1533
503633cb39449fcfe2f104f22de634399441ebad,0,Derek Dagit,2015-02-17 11:00:00-06:00,"['8036109f68d77802cfd8c4a1e1bb14d4f9e9ff82', '40a6cf08cdf6f4269e7e41d3c7d8026e340767da']",1,1,2,1301679,1,,,,1533
e790828bab00fb03f928682e818f763825eb6985,0,Derek Dagit,2015-02-17 11:01:04-06:00,['503633cb39449fcfe2f104f22de634399441ebad'],0,2,2,1301681,2,,,,1533
c3bdd1146e9565cffbb6fe8670eb4ded922a64ba,0,Kyle Nusbaum,2015-02-17 11:09:30-06:00,"['e790828bab00fb03f928682e818f763825eb6985', 'a99e1276e282a7e3bd2ecd9c9b0a54a30f541228']",6706,15137,21843,1323524,56,,,,1533
fc6d6dd86b0487605b9d154752e3e3e387550ab2,0,Kyle Nusbaum,2015-02-17 11:10:25-06:00,['c3bdd1146e9565cffbb6fe8670eb4ded922a64ba'],0,1,1,1323525,1,,,,1533
888d60fe824f13a35970e0d9ef0f081dc01a6c01,0,Derek Dagit,2015-02-17 11:14:07-06:00,"['fc6d6dd86b0487605b9d154752e3e3e387550ab2', '95211d79ca506f0b658011f7c54ff4d312da99bd']",1,1,2,1323527,1,,,,1533
6e32906c1f15747b02dbd6781779aa387b59f8cb,0,Derek Dagit,2015-02-17 11:14:47-06:00,['888d60fe824f13a35970e0d9ef0f081dc01a6c01'],0,1,1,1323528,1,,,,1533
5ca7e809986b73a31fa4a828af11492cf141522a,0,Derek Dagit,2015-02-17 11:17:23-06:00,['6e32906c1f15747b02dbd6781779aa387b59f8cb'],0,1,1,1323529,1,,,,1533
431976607857d5d29913ba055082a546a22be16e,0,Parth Brahmbhatt,2015-02-17 10:57:25-08:00,['0571e22c15a1214c3e08510fddad608571f6a6d8'],14,23,37,1323566,7,1,1,1,1533
8d4e5618efa8a2e0a0ef9d5f199f0a644f31604c,0,Parth Brahmbhatt,2015-02-17 14:56:44-08:00,['a8aacca6444a30638162ac27f8c7213a4a96aed1'],31,25,56,1323622,2,,,,1533
a4a8f7d22bf79a04d4cddd067f2a63766084ebfe,1,Sriharsha Chintalapani,2015-02-17 17:11:50-08:00,['5ca7e809986b73a31fa4a828af11492cf141522a'],523,632,1155,1324777,3,0.808510638,1,0.861702128,1535
04fccb1b152bdd3454adcfda8c4d71502ad2c6db,0,Parth Brahmbhatt,2015-02-18 12:21:21-08:00,['017360bdeeccd907d86b36e686f1379d2907ce97'],68,64,132,1324909,9,0,0,0,1535
05d3ccf415f366db01249a766b9a8345c266bf70,0,Michael G. Noll,2015-02-19 10:43:14+01:00,['5ca7e809986b73a31fa4a828af11492cf141522a'],1,23,24,1324933,1,,,,1535
0ba5bc1bea44414776efa97f3e66ba08e7384260,0,lewuathe,2015-02-19 22:13:08+09:00,['05d3ccf415f366db01249a766b9a8345c266bf70'],34,100,134,1325067,46,,,,1537
8e8840134eda28e00ba80fe23c175131e3900032,0,Sriharsha Chintalapani,2015-02-19 19:37:01-08:00,"['05d3ccf415f366db01249a766b9a8345c266bf70', 'db1182d753a6cc911a220d2891c8efd2f093d77c']",18,29,47,1325114,2,,,,1537
670936152be08b6d6f5e6d7cb591f8cb932b4661,0,Sriharsha Chintalapani,2015-02-19 19:43:54-08:00,['8e8840134eda28e00ba80fe23c175131e3900032'],0,1,1,1325115,1,,,,1537
5b68f5409d42a3fb8a5ae34c38262b4dd43a38c5,0,Sriharsha Chintalapani,2015-02-19 19:48:37-08:00,"['05d3ccf415f366db01249a766b9a8345c266bf70', 'ef85387299e48051abe2434a58adbd74376190e0']",3,5,8,1325123,1,,,,1537
a16d1404f856934b89349e137be4004ce24104e0,0,Sriharsha Chintalapani,2015-02-19 19:51:33-08:00,"['05d3ccf415f366db01249a766b9a8345c266bf70', '5eefcfbe331d54216850041a3268d45a20d1933e']",1,2,3,1325126,1,,,,1537
3cebc7c9bf7c1d0d0f23b60f2f3d731a88cf95eb,0,Sriharsha Chintalapani,2015-02-19 20:10:31-08:00,"['a16d1404f856934b89349e137be4004ce24104e0', '670936152be08b6d6f5e6d7cb591f8cb932b4661']",18,30,48,1325174,3,,,,1537
9a33c3d31576b3fadc8fce635915e1ccbe6f6dca,0,Sriharsha Chintalapani,2015-02-19 20:16:37-08:00,"['3cebc7c9bf7c1d0d0f23b60f2f3d731a88cf95eb', '5b68f5409d42a3fb8a5ae34c38262b4dd43a38c5']",3,5,8,1325182,1,,,,1537
7d8196ceb167e30e4f48abc8b1b3f085602d5a58,0,Sriharsha Chintalapani,2015-02-19 20:24:33-08:00,"['9a33c3d31576b3fadc8fce635915e1ccbe6f6dca', '5cf2a549210a31b853af32d94da8eaafacf8787f']",11,25,36,1325218,5,,,,1537
f38b4b872fd1766b21984036f21e301bea2e54da,0,Sriharsha Chintalapani,2015-02-19 20:38:15-08:00,"['7d8196ceb167e30e4f48abc8b1b3f085602d5a58', 'e3ee3a3c3f3f8da03dcecf2c7cd617ec6826b445']",0,1,1,1325219,1,,,,1537
a8eab502123244af5fc9b895145f3fd1557762e6,0,Sriharsha Chintalapani,2015-02-19 20:56:17-08:00,['f38b4b872fd1766b21984036f21e301bea2e54da'],0,1,1,1325220,1,,,,1537
e0475e411794a6e60a7cefac34eec24820e15f10,0,Sriharsha Chintalapani,2015-02-21 12:34:12-08:00,"['a8eab502123244af5fc9b895145f3fd1557762e6', 'd8d73a2e095329c5eeda44255ba369e96c4c546f']",10,13,23,1325243,2,,,,1537
23301bdbc1bdb9dcc16f24216fcec19e2da7692b,0,Robert (Bobby) Evans,2015-02-23 10:06:39-06:00,"['a8eab502123244af5fc9b895145f3fd1557762e6', '55924cdc091522aa5653aec138962b233d295f43']",213,147,360,1325603,31,,,,1537
9d0df23b52bf2fffd421a96655ae324905e83c6c,0,Robert (Bobby) Evans,2015-02-23 10:15:30-06:00,['23301bdbc1bdb9dcc16f24216fcec19e2da7692b'],0,1,1,1325604,1,,,,1537
240eb7c6a8155555c622ac5746e83c46dc2c16de,0,Robert (Bobby) Evans,2015-02-23 10:18:52-06:00,"['9d0df23b52bf2fffd421a96655ae324905e83c6c', 'c40c1727799bc34073eaa5d56de4a5e7ffa773ff']",0,2928,2928,1328532,32,,,,1537
4b6e43b815a2f1f48bb04b24b2acfc4cad4d480d,0,Robert (Bobby) Evans,2015-02-23 10:25:38-06:00,['240eb7c6a8155555c622ac5746e83c46dc2c16de'],0,1,1,1328533,1,,,,1537
2de5274268580b56214f70878dfb5afc61227e95,0,Sriharsha Chintalapani,2015-02-23 08:31:17-08:00,['e0475e411794a6e60a7cefac34eec24820e15f10'],0,1,1,1328534,1,,,,1537
51e91f0ac2bbcdc7b7239f53082fbeeb32db721c,0,Robert (Bobby) Evans,2015-02-23 10:31:58-06:00,"['4b6e43b815a2f1f48bb04b24b2acfc4cad4d480d', '2712ee9b8a4912f74acf33fe1cef7195890ab4fc']",72,103,175,1328709,1,,,,1537
ffb1816a9eadbaea95746ec96d5771448ba6fd6d,0,Robert (Bobby) Evans,2015-02-23 10:38:32-06:00,['51e91f0ac2bbcdc7b7239f53082fbeeb32db721c'],0,1,1,1328710,1,,,,1537
76159b017d111b4bd39936fb2e41ce886cd50089,0,Derek Dagit,2015-02-23 10:50:54-06:00,"['ffb1816a9eadbaea95746ec96d5771448ba6fd6d', '842b5526469bc6c2fe763498faf4dfb76fcadcd7']",0,1,1,1328711,1,,,,1537
740609b14ad652e05242334c53b11334fb22c5b9,0,Derek Dagit,2015-02-23 10:51:53-06:00,['76159b017d111b4bd39936fb2e41ce886cd50089'],0,1,1,1328712,1,,,,1537
877e29d0d1811a8b075e1e0a2716e5bd14ea4766,0,Derek Dagit,2015-02-23 10:57:23-06:00,['740609b14ad652e05242334c53b11334fb22c5b9'],0,1,1,1328713,1,,,,1537
b60d0f180d4ebeaae1f1af264f4c126f0f2f6043,0,Robert (Bobby) Evans,2015-02-23 11:02:24-06:00,['877e29d0d1811a8b075e1e0a2716e5bd14ea4766'],3,5,8,1328721,3,,,,1537
348d480bed8d10f6a9ed5902a1b14fe3e8167029,0,Robert (Bobby) Evans,2015-02-23 11:02:55-06:00,['b60d0f180d4ebeaae1f1af264f4c126f0f2f6043'],0,1,1,1328722,1,,,,1537
fa429b2a1669f3f55e8a399bd1c64a51bead09e2,0,Derek Dagit,2015-02-23 11:07:30-06:00,['348d480bed8d10f6a9ed5902a1b14fe3e8167029'],2,3,5,1328727,1,0,0,0,1537
0eb5f30e95f29a02d88935850527ddb3bd23237b,0,Derek Dagit,2015-02-23 11:07:56-06:00,['fa429b2a1669f3f55e8a399bd1c64a51bead09e2'],0,2,2,1328729,2,,,,1537
bde3054479aff1c870e4ebe3241e893706408855,0,Derek Dagit,2015-02-23 11:19:42-06:00,['0eb5f30e95f29a02d88935850527ddb3bd23237b'],1,0,1,1328730,1,,,,1537
e6a29e07c9863db6b885465d6cbf57168f6a1e6c,0,Sriharsha Chintalapani,2015-02-23 09:47:14-08:00,"['bde3054479aff1c870e4ebe3241e893706408855', '2de5274268580b56214f70878dfb5afc61227e95']",10,14,24,1328754,3,,,,1537
4fc835624aaa5a293fe689198a2b4e769739338f,0,Parth Brahmbhatt,2015-02-23 09:57:28-08:00,"['04fccb1b152bdd3454adcfda8c4d71502ad2c6db', 'bde3054479aff1c870e4ebe3241e893706408855']",7056,18827,25883,1354637,150,,,,1537
ca7bd99beff75e592c6abc9ba5186633d00f0fe4,0,Parth Brahmbhatt,2015-02-23 10:08:25-08:00,['a8eab502123244af5fc9b895145f3fd1557762e6'],6,10,16,1354653,2,,,,1537
c291631563e2ab0eaa7f197dc95b340552bd12f7,0,P. Taylor Goetz,2015-02-23 14:41:42-05:00,"['e6a29e07c9863db6b885465d6cbf57168f6a1e6c', '522d96e5953037728422935d31401a58e943c688']",333,737,1070,1355723,11,,,,1537
d7334849b8d1262c7e82dc6f6e5d59d904c9ae4e,0,P. Taylor Goetz,2015-02-23 16:08:29-05:00,['c291631563e2ab0eaa7f197dc95b340552bd12f7'],30,0,30,1355753,1,,,,1537
10ea5e1fc410d8d28510f324b73a8155740b04bb,0,Sriharsha Chintalapani,2015-02-23 13:28:53-08:00,"['d7334849b8d1262c7e82dc6f6e5d59d904c9ae4e', '4fc835624aaa5a293fe689198a2b4e769739338f']",2,2047,2049,1357802,25,,,,1537
64d7ac6b228df1174455040a5a9f4d52cc53db7c,0,Sriharsha Chintalapani,2015-02-23 14:12:04-08:00,['10ea5e1fc410d8d28510f324b73a8155740b04bb'],0,1,1,1357803,1,,,,1537
58a3479032f0e7f2881df8f6fffe06eb984a8c29,0,Sriharsha Chintalapani,2015-02-23 14:32:14-08:00,"['54b6a69f044c7a93b7871e6237d33fc612cc90f7', '64d7ac6b228df1174455040a5a9f4d52cc53db7c']",7411,21213,28624,1386427,167,,,,1537
e62c163335ad6d75d6a6de7d09f3c7d7ff5cbb77,1,Sriharsha Chintalapani,2015-02-23 14:58:34-08:00,['58a3479032f0e7f2881df8f6fffe06eb984a8c29'],0,15,15,1386442,2,,,,1537
c5e5b10f52dd4fb67914434790b52edc93e66aa7,0,Sriharsha Chintalapani,2015-02-23 15:18:11-08:00,['64d7ac6b228df1174455040a5a9f4d52cc53db7c'],1,7,8,1386450,1,,,,1537
bb056459ede50694d488b334e687f336628c4cec,1,Sriharsha Chintalapani,2015-02-23 18:22:47-08:00,['64d7ac6b228df1174455040a5a9f4d52cc53db7c'],0,4,4,1386454,3,,,,1537
fc9927b9e829f27758a1a6131b3abbae7a507668,0,Michael G. Noll,2015-02-24 14:33:17+01:00,['64d7ac6b228df1174455040a5a9f4d52cc53db7c'],1,1,2,1386456,1,,,,1537
99aeb80b074f1dc48a396b21ec5ca30a8ed09ddb,1,Sriharsha Chintalapani,2015-02-24 13:35:12-08:00,['bb056459ede50694d488b334e687f336628c4cec'],5,3,8,1386464,4,,,,1537
2a0bb0dcb3d7fa7aa4e71d89ca1a59a2127b4f38,0,Robert (Bobby) Evans,2015-02-24 15:46:09-06:00,['fc9927b9e829f27758a1a6131b3abbae7a507668'],2,72,74,1386538,2,0.441176471,1,1,1538
0a3a0aabce941329968be31466d9346156a6876e,0,Sriharsha Chintalapani,2015-02-24 16:02:04-08:00,"['fc9927b9e829f27758a1a6131b3abbae7a507668', 'b3597e1892ec30a095edc7a5a75b199faf6bced3']",13,73,86,1386624,3,,,,1538
59eb7f95a243cf23b7cbbbec843f7bdb7fac37f8,0,Sriharsha Chintalapani,2015-02-25 08:16:11-08:00,"['0a3a0aabce941329968be31466d9346156a6876e', 'e62c163335ad6d75d6a6de7d09f3c7d7ff5cbb77']",2,3150,3152,1389776,21,,,,1538
14a302f545ef3ef95aac5177bc9ac441626377b4,0,Sriharsha Chintalapani,2015-02-25 10:35:41-08:00,['59eb7f95a243cf23b7cbbbec843f7bdb7fac37f8'],0,1,1,1389777,1,,,,1538
ec30f4923e80f6f74964ef44d5beeaf274cfa6a2,0,Sriharsha Chintalapani,2015-02-25 10:54:29-08:00,"['14a302f545ef3ef95aac5177bc9ac441626377b4', 'b61dd3ab143686a8191a47652ca63c6c46992982']",1,1,2,1389779,1,,,,1538
a91e9f6980d7d6201d8326f762443dae7fe9c51c,0,Sriharsha Chintalapani,2015-02-25 11:07:57-08:00,"['ec30f4923e80f6f74964ef44d5beeaf274cfa6a2', 'c5e5b10f52dd4fb67914434790b52edc93e66aa7']",1,7,8,1389787,1,,,,1538
0fc2cd57bfc43556095107dd96a23153ad4d587e,0,Robert (Bobby) Evans,2015-02-25 14:53:16-06:00,"['a91e9f6980d7d6201d8326f762443dae7fe9c51c', '2a0bb0dcb3d7fa7aa4e71d89ca1a59a2127b4f38']",2,72,74,1389861,2,,,,1538
d4e9438255c3ea37133f4f8d8a7876c65edb3d39,0,Robert (Bobby) Evans,2015-02-25 15:12:12-06:00,['0fc2cd57bfc43556095107dd96a23153ad4d587e'],0,1,1,1389862,1,,,,1538
5934654d9edcbaf6626ae28cefc147771a4a0bdc,0,Robert (Bobby) Evans,2015-02-25 15:20:07-06:00,"['d4e9438255c3ea37133f4f8d8a7876c65edb3d39', '99aeb80b074f1dc48a396b21ec5ca30a8ed09ddb']",2,4,6,1389868,2,,,,1538
182a734e0b4a1db31cd503838bada69f90f690ed,0,Robert (Bobby) Evans,2015-02-25 15:21:34-06:00,['5934654d9edcbaf6626ae28cefc147771a4a0bdc'],0,1,1,1389869,1,,,,1538
6b6eda7a4b459448bd26e605674a8df973febb97,0,Jungtaek Lim,2015-02-26 09:43:52+09:00,['64d7ac6b228df1174455040a5a9f4d52cc53db7c'],1,1,2,1389871,1,,,,1538
3df6aaa0a16cd641ca8225ffd52c782b016db364,0,Sriharsha Chintalapani,2015-02-25 19:17:35-08:00,['182a734e0b4a1db31cd503838bada69f90f690ed'],4,35,39,1389910,3,0,0.571428571,0.571428571,1538
3193307777b3155dc1524af0316aee139f349b23,0,Sriharsha Chintalapani,2015-02-26 08:02:25-08:00,['182a734e0b4a1db31cd503838bada69f90f690ed'],1,6,7,1389917,1,,,,1538
086e9e588e46922198d56faafbc9d25f4a543f47,1,Parth Brahmbhatt,2015-02-26 17:26:09-08:00,['64d7ac6b228df1174455040a5a9f4d52cc53db7c'],123,463,586,1390503,19,0.525547445,0.532846715,0,1539
32df28743781767059fc0360c2ef9d166a7af6fb,0,Parth Brahmbhatt,2015-02-26 17:27:02-08:00,"['086e9e588e46922198d56faafbc9d25f4a543f47', '182a734e0b4a1db31cd503838bada69f90f690ed']",22,3311,3333,1393836,28,,,,1539
2d6ab7d7fdb0fe8d62acf30357b9c83cd32d2a93,0,Parth Brahmbhatt,2015-02-26 17:32:37-08:00,['32df28743781767059fc0360c2ef9d166a7af6fb'],1,1,2,1393838,1,,,,1539
0ef072ac257b49acc839cbbf9334a2c4b18ba38c,0,caofangkun,2015-02-27 09:52:22+08:00,"['3af6d18ed2d3b5998d0f7a0e87a10ce220eb207d', '182a734e0b4a1db31cd503838bada69f90f690ed']",7425,24531,31956,1425794,188,,,,1539
b7bfdde8714c39e7556ac34915817dd2a8879356,0,Kyle Nusbaum,2015-02-27 12:51:04-06:00,['182a734e0b4a1db31cd503838bada69f90f690ed'],0,17,17,1425811,1,,,,1540
26ce6f1a6dcb40aa4ab77ea5eceebe9f41d940e6,0,P. Taylor Goetz,2015-02-27 16:44:39-05:00,"['182a734e0b4a1db31cd503838bada69f90f690ed', '18a68a074570db01fc6377a269feb90ecda898ab']",16,15,31,1425842,1,,,,1540
023f7a58d299be4401223886201a89acc34fccc2,1,P. Taylor Goetz,2015-02-27 16:46:07-05:00,['26ce6f1a6dcb40aa4ab77ea5eceebe9f41d940e6'],6,6,12,1425854,1,,,,1540
f7c0bf8a7c843c6e555ee982a85e3952d1c28b33,1,Jungtaek Lim,2015-02-28 22:29:32+09:00,['64d7ac6b228df1174455040a5a9f4d52cc53db7c'],123,504,627,1426481,32,0.672839506,0.561728395,0.981481481,1546
b129080f4b578870b03a8d5788b418c2259a4805,0,Jungtaek Lim,2015-02-28 22:45:33+09:00,['f7c0bf8a7c843c6e555ee982a85e3952d1c28b33'],0,34,34,1426515,2,,,,1546
807e5cf08de94c3d4094a69c9e57b1f8b6cdc550,1,Parth Brahmbhatt,2015-02-28 16:05:54-08:00,['2d6ab7d7fdb0fe8d62acf30357b9c83cd32d2a93'],11,34,45,1426560,6,,,1,1546
e353fe006fc07573ddbfa2e0e9d57fea3a3fd1a4,1,Parth Brahmbhatt,2015-02-28 19:56:14-08:00,['807e5cf08de94c3d4094a69c9e57b1f8b6cdc550'],28,68,96,1426656,4,0,1,1,1546
f690fbb58580902461a480d70a3d21d50dbf05ca,0,Kishor Patil,2015-03-02 10:40:58-06:00,"['023f7a58d299be4401223886201a89acc34fccc2', '28eb65d2c7987b520f66c59e85f32a2fc209a7b6']",0,8284,8284,1434940,13,,,,1546
559f0f20016b0a52b2e14f44b906ffd05ddcfdf1,0,Kishor Patil,2015-03-02 10:52:42-06:00,['f690fbb58580902461a480d70a3d21d50dbf05ca'],0,1,1,1434941,1,,,,1546
85e4d5efce66352469cb4c9947922731e834ca5d,0,Parth Brahmbhatt,2015-03-02 15:16:05-08:00,"['8d4e5618efa8a2e0a0ef9d5f199f0a644f31604c', '559f0f20016b0a52b2e14f44b906ffd05ddcfdf1']",7507,32950,40457,1475398,202,,,,1546
f7205d29f7afeb9e4cf03a31be0ac5737652b07c,0,Parth Brahmbhatt,2015-03-02 15:52:00-08:00,['85e4d5efce66352469cb4c9947922731e834ca5d'],158,231,389,1475787,2,0.96969697,0.96969697,1,1546
aadccb4cb2a6602651d31542ecf2c96d72a0edfa,0,Parth Brahmbhatt,2015-03-02 16:06:58-08:00,['559f0f20016b0a52b2e14f44b906ffd05ddcfdf1'],5,4,9,1475796,2,1,0,0,1546
2ae600609466d56e1a50fa05eb7170ae212aae27,0,caofangkun,2015-03-03 09:10:05+08:00,"['0ef072ac257b49acc839cbbf9334a2c4b18ba38c', '559f0f20016b0a52b2e14f44b906ffd05ddcfdf1']",16,8300,8316,1484112,15,,,,1546
f0cef2b0d8618254f02bf73db4263c96241dfbdc,0,zhangjinlong,2015-03-03 23:04:38+08:00,['0ee865750e8d54c00d2abac81c20c429483bc646'],1,1,2,1484114,1,,,,1546
5b4c28a088ffc62ebcc28e8c28a25d096aa1eb78,0,matt.tieman,2015-03-03 11:46:30-05:00,['bc54e8ed5a6c53f8069dc411654ad6b040a5e2d3'],0,1,1,1484115,1,,,,1546
6e4fde20af8d285cdf4829e4c2c4aef4cd45d89d,0,matt.tieman,2015-03-03 11:47:38-05:00,['5b4c28a088ffc62ebcc28e8c28a25d096aa1eb78'],0,15,15,1484130,1,1,1,0,1546
6e768665320d08815c53f27e706ef2ae1ff5af78,0,matt.tieman,2015-03-03 11:48:57-05:00,['6e4fde20af8d285cdf4829e4c2c4aef4cd45d89d'],10,56,66,1484196,1,0,1,1,1546
2f119c6e2edace030afeb9ee0885010f1de7fc28,1,matt.tieman,2015-03-03 11:59:44-05:00,['6e768665320d08815c53f27e706ef2ae1ff5af78'],0,75,75,1484271,3,1,1,0.333333333,1549
f71439de508173022f1958b15a1ab0c532377656,1,Nathan Marz,2015-03-03 14:24:57-05:00,['559f0f20016b0a52b2e14f44b906ffd05ddcfdf1'],0,40,40,1484311,1,,,,1549
2dbeb98adc3a8801d7446fe8b259ff0bc0684172,1,Nathan Marz,2015-03-03 14:30:01-05:00,['f71439de508173022f1958b15a1ab0c532377656'],0,43,43,1484354,1,,,,1549
11194653f43ce0d4f65d0051270cd86f2191cbc5,1,matt.tieman,2015-03-03 16:42:31-05:00,['2f119c6e2edace030afeb9ee0885010f1de7fc28'],9,16,25,1484379,6,0,0,1,1549
5be9e9d9cfe6fb497a7706308cc9c59061215cea,1,Robert (Bobby) Evans,2015-03-03 16:34:53-06:00,['2dbeb98adc3a8801d7446fe8b259ff0bc0684172'],9,18,27,1484406,2,0.833333333,1,0.833333333,1549
25f97369c36e9ad7dffa8dc2699f9454763b234d,0,P. Taylor Goetz,2015-03-03 21:46:33-05:00,[],0,214,214,1484620,2,,,,1551
0f28b93d2d2e92b547d02b7e1208c2d0fd9cbff9,0,P. Taylor Goetz,2015-03-03 21:49:00-05:00,['25f97369c36e9ad7dffa8dc2699f9454763b234d'],0,2,2,1484622,1,,,,1552
7e36ce579f0dcbcf4dfe5942b906a6e94a1815e8,0,lewuathe,2015-03-04 22:14:51+09:00,['2dbeb98adc3a8801d7446fe8b259ff0bc0684172'],1,36,37,1484659,1,,,,1552
03b76d2007299a2c673f42bafd438a8927823832,0,caofangkun,2015-03-05 09:58:19+08:00,"['2ae600609466d56e1a50fa05eb7170ae212aae27', '2dbeb98adc3a8801d7446fe8b259ff0bc0684172']",0,83,83,1484742,1,,,,1552
d589f0316b71f63e85e0360007b66b2df962e02c,0,Derek Dagit,2015-03-05 09:38:05-06:00,"['2dbeb98adc3a8801d7446fe8b259ff0bc0684172', 'f0cef2b0d8618254f02bf73db4263c96241dfbdc']",2,2,4,1484746,1,,,,1552
5eff2e761cc8c981a82e46333b72810d2ed5c5c6,0,Derek Dagit,2015-03-05 09:39:49-06:00,['d589f0316b71f63e85e0360007b66b2df962e02c'],0,1,1,1484747,1,,,,1552
111fd959f52f0211a106a31b4dbeeb346097e6f3,0,Sriharsha Chintalapani,2015-03-05 08:33:55-08:00,['a4a8f7d22bf79a04d4cddd067f2a63766084ebfe'],4,0,4,1484751,2,,,,1552
f23b3c8719b94fa7af04ac2138479842c449deab,0,Parth Brahmbhatt,2015-03-05 16:57:17-08:00,['431976607857d5d29913ba055082a546a22be16e'],9,12,21,1484772,2,,,,1552
5b67b571fe45e14fd52b835bc1de056538de1e70,0,Parth Brahmbhatt,2015-03-05 17:05:33-08:00,"['f23b3c8719b94fa7af04ac2138479842c449deab', '5eff2e761cc8c981a82e46333b72810d2ed5c5c6']",8388,32972,41360,1526132,203,,,,1552
45750543886bc2fa87925a89e6b1894138d9cc52,0,Sriharsha Chintalapani,2015-03-05 18:08:51-08:00,"['5eff2e761cc8c981a82e46333b72810d2ed5c5c6', '111fd959f52f0211a106a31b4dbeeb346097e6f3']",523,628,1151,1527283,3,,,,1552
07098e8ebd1ba69c0a545d22b843112167b64e20,0,Sriharsha Chintalapani,2015-03-05 18:17:31-08:00,['45750543886bc2fa87925a89e6b1894138d9cc52'],0,1,1,1527284,1,,,,1552
ab2ba93d73a667fd0d6424b23b3f593cafef78d0,0,P. Taylor Goetz,2015-03-06 00:27:15-05:00,['0f28b93d2d2e92b547d02b7e1208c2d0fd9cbff9'],0,45,45,1527329,5,1,1,1,1557
539a6a21464acada9d051b3d5ce67990ffa2a239,1,Parth Brahmbhatt,2015-03-05 22:01:14-08:00,['5b67b571fe45e14fd52b835bc1de056538de1e70'],914,2505,3419,1530748,12,0.251060221,0.290076336,0.961832061,1557
b3f4b742ad9e6d6e73da02390c8433829069dc28,0,P. Taylor Goetz,2015-03-06 23:09:46-05:00,['ab2ba93d73a667fd0d6424b23b3f593cafef78d0'],3,111,114,1530862,3,1,1,1,1557
760f3eade7d66faebf4adcfa694e00ea147ff112,0,P. Taylor Goetz,2015-03-06 23:10:59-05:00,['b3f4b742ad9e6d6e73da02390c8433829069dc28'],0,56,56,1530918,2,,,,1559
6344a3df8ddc3912a4ab5ba000346f12018f139c,1,P. Taylor Goetz,2015-03-06 23:12:35-05:00,['760f3eade7d66faebf4adcfa694e00ea147ff112'],0,174,174,1531092,3,0.56626506,0.56626506,1,1562
a99edcf64aaf82b51b9a5e45e2fbf68565d20c51,0,P. Taylor Goetz,2015-03-06 23:13:31-05:00,['6344a3df8ddc3912a4ab5ba000346f12018f139c'],0,34,34,1531126,1,,,,1563
7f8259ab1e136ba3833d744031b5042f97d5fc41,1,P. Taylor Goetz,2015-03-07 01:05:43-05:00,['a99edcf64aaf82b51b9a5e45e2fbf68565d20c51'],0,30,30,1531156,1,,,,1564
3d9804a0409434834dd8bc9c4bf12d7aa9c68a2a,0,P. Taylor Goetz,2015-03-07 01:09:06-05:00,['7f8259ab1e136ba3833d744031b5042f97d5fc41'],25,84,109,1531265,5,1,1,1,1565
c0abd701838897de1143227afe3ecf73675f51a3,0,P. Taylor Goetz,2015-03-08 00:44:04-05:00,['3d9804a0409434834dd8bc9c4bf12d7aa9c68a2a'],1,1,2,1531267,1,,,,1565
63264abd953a2d4df161f24774d10040ccff7eb3,0,P. Taylor Goetz,2015-03-08 01:14:08-05:00,['c0abd701838897de1143227afe3ecf73675f51a3'],1,1,2,1531269,1,1,1,1,1565
b776f6554a4f9b66266cdf64e5d99055d1aca70c,0,P. Taylor Goetz,2015-03-08 01:25:52-05:00,['63264abd953a2d4df161f24774d10040ccff7eb3'],1,12,13,1531282,1,,,,1565
ddc3a47b2f4b5f7c8c7b35efc2c62e48f1fca939,0,P. Taylor Goetz,2015-03-08 01:37:55-05:00,['3fc7f30ed693354f014f00948c527e0f2273c66c'],89,2,91,1531373,4,,,,1565
d152d72f3726f3ff40ba74dee0392f8764b43fd0,0,P. Taylor Goetz,2015-03-08 01:48:49-05:00,['ddc3a47b2f4b5f7c8c7b35efc2c62e48f1fca939'],47,43,90,1531463,21,,,,1565
9cbed269ad4d24dc635cc1ed98a298a850e4c606,0,P. Taylor Goetz,2015-03-08 01:50:47-05:00,['b776f6554a4f9b66266cdf64e5d99055d1aca70c'],0,6,6,1531469,1,,,,1565
9f57ba9bb8da9781d4091403479864886e261c2b,0,Sriharsha Chintalapani,2015-03-08 10:21:53-07:00,"['07098e8ebd1ba69c0a545d22b843112167b64e20', 'aadccb4cb2a6602651d31542ecf2c96d72a0edfa']",5,4,9,1531478,2,,,,1565
9517923b1d3652a3809d25e98994ad43beb1e534,0,Sriharsha Chintalapani,2015-03-08 10:35:28-07:00,"['9f57ba9bb8da9781d4091403479864886e261c2b', '3193307777b3155dc1524af0316aee139f349b23']",1,6,7,1531485,1,,,,1565
d5dcf0dbdc1c815dcb8b8920c4ff7ce78c7d7749,0,Sriharsha Chintalapani,2015-03-08 10:53:51-07:00,"['9517923b1d3652a3809d25e98994ad43beb1e534', '4f468d91494811f22f82154698317e7ed7cabf29']",2,3,5,1531490,1,,,,1565
30a013021931e7e2b7fec56a6d90619e1359873f,0,Sriharsha Chintalapani,2015-03-08 11:02:12-07:00,['d5dcf0dbdc1c815dcb8b8920c4ff7ce78c7d7749'],0,2,2,1531492,1,,,,1565
2666d9907bcf3e517dcafe8a5b3c17d33f05b8ec,0,Sriharsha Chintalapani,2015-03-08 11:07:14-07:00,"['30a013021931e7e2b7fec56a6d90619e1359873f', '5ff14142995a18a8b6fd81b126f610b1aa0bd0f4']",0,1,1,1531493,1,,,,1565
ef163139ced986ee4fd334bc8c53e661dde61692,1,Parth Brahmbhatt,2015-03-08 13:03:24-07:00,['e353fe006fc07573ddbfa2e0e9d57fea3a3fd1a4'],1,8,9,1531502,2,1,1,0,1565
73145629421bafaec46d2fd7c7e648bda67112e5,0,Parth Brahmbhatt,2015-03-08 13:03:35-07:00,"['ef163139ced986ee4fd334bc8c53e661dde61692', '2666d9907bcf3e517dcafe8a5b3c17d33f05b8ec']",549,9031,9580,1541082,24,,,,1565
cee1c0527279487b2b7b991a7d6b42ee173c13f4,0,caofangkun,2015-03-09 10:23:05+08:00,"['03b76d2007299a2c673f42bafd438a8927823832', '2666d9907bcf3e517dcafe8a5b3c17d33f05b8ec']",533,648,1181,1542263,9,,,,1565
22a81920fda6004388a48b5eecd1b103ed6cb3aa,1,Parth Brahmbhatt,2015-03-08 19:34:37-07:00,['73145629421bafaec46d2fd7c7e648bda67112e5'],4,19,23,1542286,2,0,1,1,1565
5bf5ee34decc4cfa5733eb1308bc8552dfe459be,0,P. Taylor Goetz,2015-03-08 23:47:26-04:00,['9cbed269ad4d24dc635cc1ed98a298a850e4c606'],3,1037,1040,1543326,10,0.702752294,0.818348624,0.913761468,1572
8ef2af5597e16ac99f63047f93edf80a5fa7f1f7,0,P. Taylor Goetz,2015-03-09 00:12:08-04:00,['5bf5ee34decc4cfa5733eb1308bc8552dfe459be'],10,19,29,1543355,1,0,1,1,1572
6d446667264b26afdcc528535facc92042b0eb83,0,P. Taylor Goetz,2015-03-09 01:30:20-04:00,['8ef2af5597e16ac99f63047f93edf80a5fa7f1f7'],4,8,12,1543367,1,1,1,1,1572
a7619bbdfab3bd34944b85e1b05814167ff168bd,0,P. Taylor Goetz,2015-03-09 01:31:56-04:00,['6d446667264b26afdcc528535facc92042b0eb83'],0,70,70,1543437,1,1,1,1,1573
78b20f1f7014e7444aa96436d949d8d9c6b59839,0,P. Taylor Goetz,2015-03-09 01:36:25-04:00,['a7619bbdfab3bd34944b85e1b05814167ff168bd'],5,8,13,1543450,1,,,,1573
27a36066bd1ed21a6fed4b8b0fc71a543740e5b3,1,Nathan Marz,2015-03-09 15:51:08-04:00,['2666d9907bcf3e517dcafe8a5b3c17d33f05b8ec'],0,11,11,1543461,1,,,,1573
9ae0921efa6d83a2819da31484798cc03c9b2004,0,P. Taylor Goetz,2015-03-09 22:34:51-04:00,['78b20f1f7014e7444aa96436d949d8d9c6b59839'],0,0,0,1543461,4,,,,1573
75f909cd48ae8e08381cc7e58829b97bee4142be,0,P. Taylor Goetz,2015-03-09 22:36:31-04:00,['9ae0921efa6d83a2819da31484798cc03c9b2004'],3,6,9,1543470,1,1,1,1,1573
5b7d3275807214dcffa8735b3c9fc72ca8efe3ce,0,P. Taylor Goetz,2015-03-09 22:40:36-04:00,['75f909cd48ae8e08381cc7e58829b97bee4142be'],0,3,3,1543473,1,,,,1573
0507f69ec6b0ac6913f3a8d5f394b999e25a413a,0,P. Taylor Goetz,2015-03-09 22:44:19-04:00,['5b7d3275807214dcffa8735b3c9fc72ca8efe3ce'],1,1,2,1543475,1,,,,1573
997eda9104457daa18908259bf37aa2e85d68ddb,0,P. Taylor Goetz,2015-03-09 22:46:13-04:00,['0507f69ec6b0ac6913f3a8d5f394b999e25a413a'],19,25,44,1543519,1,,,,1573
183d454a27b5f4c13ec8e4427b01790049815ce6,0,P. Taylor Goetz,2015-03-09 22:57:54-04:00,['997eda9104457daa18908259bf37aa2e85d68ddb'],1,1,2,1543521,2,,,,1573
1489bcb90c0f789825dbdec2a033653fc9f7bf15,0,P. Taylor Goetz,2015-03-10 00:58:02-04:00,['183d454a27b5f4c13ec8e4427b01790049815ce6'],12,15,27,1543548,2,0,0,0,1573
26e96235d70d01f450bd4e8b5c3c346e40b050d3,0,P. Taylor Goetz,2015-03-10 01:05:53-04:00,['1489bcb90c0f789825dbdec2a033653fc9f7bf15'],1,3,4,1543552,1,,,,1573
14bc9ce73bfe7aa4e46c06eefac102ed693e40c8,0,Kishor Patil,2015-03-10 16:32:21+00:00,"['27a36066bd1ed21a6fed4b8b0fc71a543740e5b3', '5be9e9d9cfe6fb497a7706308cc9c59061215cea']",9,18,27,1543579,2,,,,1573
b02f612498b6310d41c0d5fb15d92300c8179094,1,Kishor Patil,2015-03-10 17:14:09+00:00,['14bc9ce73bfe7aa4e46c06eefac102ed693e40c8'],10,18,28,1543607,2,1,1,0.375,1573
26bab1595c56f6f40ea2392401e829f3ccb0cff0,0,David Katten,2015-03-10 15:52:40-05:00,['27a36066bd1ed21a6fed4b8b0fc71a543740e5b3'],14,5,19,1543626,1,0.1,0,0,1573
eff34c04ddea20167fa93303a2892aa384ae4de8,0,P. Taylor Goetz,2015-03-10 20:28:31-04:00,['26e96235d70d01f450bd4e8b5c3c346e40b050d3'],12,35,47,1543673,5,1,1,1,1573
fe273d415b544e620125937145611e8bf07ea998,0,P. Taylor Goetz,2015-03-10 20:56:29-04:00,['eff34c04ddea20167fa93303a2892aa384ae4de8'],8,74,82,1543755,1,0,0,1,1573
329037081804a80d418bdf608fb1a2e78bbd0a18,0,P. Taylor Goetz,2015-03-10 21:41:27-04:00,['fe273d415b544e620125937145611e8bf07ea998'],1,67,68,1543823,9,,,,1573
3aa41f2712ba101effebf20623e4276296915610,1,P. Taylor Goetz,2015-03-11 00:17:57-04:00,['329037081804a80d418bdf608fb1a2e78bbd0a18'],0,134,134,1543957,1,,,,1573
50aac686de68f783c5767a281922f05ce05e4127,0,Michael G. Noll,2015-03-11 12:13:02+01:00,['27a36066bd1ed21a6fed4b8b0fc71a543740e5b3'],0,2,2,1543959,1,1,1,1,1573
ea2a61d91310835a78354052889e37761a68f5cf,0,Michael G. Noll,2015-03-11 12:14:18+01:00,['50aac686de68f783c5767a281922f05ce05e4127'],0,2,2,1543961,1,0,0,1,1573
148c920500f5c1d748cacfb3739c4a035eddb0e3,1,Parth Brahmbhatt,2015-03-11 10:11:43-07:00,['5eff2e761cc8c981a82e46333b72810d2ed5c5c6'],77,159,236,1544197,8,0.512195122,1,0.975609756,1573
9b56bc8064dda3c9eab8358dddfed5e60d614a03,0,Robert (Bobby) Evans,2015-03-11 12:52:45-05:00,"['27a36066bd1ed21a6fed4b8b0fc71a543740e5b3', 'ca255cc7f622b01e1e8869d1089583b7a4170d94']",3,3,6,1544203,2,,,,1573
1a9e9e92e5e6f3ad54be6655706984d42dc9cf77,0,Robert (Bobby) Evans,2015-03-11 13:07:26-05:00,['9b56bc8064dda3c9eab8358dddfed5e60d614a03'],0,2,2,1544205,2,,,,1573
e2d5dcd1b350d0af80bf6a201d340739515dc053,0,Robert (Bobby) Evans,2015-03-11 14:51:47-05:00,"['1a9e9e92e5e6f3ad54be6655706984d42dc9cf77', 'ff1168a1d1d3181dc53f61043ce6f226e1823afd']",0,18,18,1544223,1,,,,1573
bbc052ebb9fa282e7843c32a8d46b7251def9b7d,0,Robert (Bobby) Evans,2015-03-11 14:52:25-05:00,['e2d5dcd1b350d0af80bf6a201d340739515dc053'],0,1,1,1544224,1,,,,1573
c8ac509b026668f672e185b9f91ca11ce78881a8,0,Robert (Bobby) Evans,2015-03-11 15:01:57-05:00,"['bbc052ebb9fa282e7843c32a8d46b7251def9b7d', '1d9b28373faeb4a4d7b9017d8ffd130f3397b052']",1,12,13,1544237,3,,,,1573
5a66bb6d2ffbae8c1b7ea929dcb256413bee5b50,1,Parth Brahmbhatt,2015-03-11 13:04:31-07:00,['539a6a21464acada9d051b3d5ce67990ffa2a239'],53,37,90,1544327,6,0,0,0,1573
3a3b7cea7b99abea28502fe55c4b50a5ad5f4456,0,Robert (Bobby) Evans,2015-03-11 15:09:04-05:00,['c8ac509b026668f672e185b9f91ca11ce78881a8'],0,1,1,1544328,1,,,,1573
abca012e6fca2a49cff15f69a11cfd4c48e42da6,0,Robert (Bobby) Evans,2015-03-11 15:18:45-05:00,"['3a3b7cea7b99abea28502fe55c4b50a5ad5f4456', '288cc322774721c2e3ae6c84161ec1bd9d3f24b1']",0,132,132,1544460,2,,,,1573
3113ae1ec5a95c9159b203ff016f133e7d2a8e87,0,Robert (Bobby) Evans,2015-03-11 15:27:54-05:00,['abca012e6fca2a49cff15f69a11cfd4c48e42da6'],1,2,3,1544463,1,,,,1573
23c69c3d23b1a7a1e22e6735e43fb09c0eac297d,0,Robert (Bobby) Evans,2015-03-11 15:32:36-05:00,"['3113ae1ec5a95c9159b203ff016f133e7d2a8e87', '6b6eda7a4b459448bd26e605674a8df973febb97']",1,1,2,1544465,1,,,,1573
8c39e4c49ab7b1b6f6cc2a5070acf97e2432ca48,0,Robert (Bobby) Evans,2015-03-11 15:43:56-05:00,['23c69c3d23b1a7a1e22e6735e43fb09c0eac297d'],0,1,1,1544466,1,,,,1573
9e571e0481f41ddbfb8d1dfaba7f3cafe649853c,0,Robert (Bobby) Evans,2015-03-11 15:47:25-05:00,"['8c39e4c49ab7b1b6f6cc2a5070acf97e2432ca48', '2be8acd69b6bd89425539231b4b79a10e831e2d7']",72,72,144,1544610,16,,,,1573
43fe5135a1023813bc8816be07b8dd0c42706fc4,0,Robert (Bobby) Evans,2015-03-11 15:53:34-05:00,['9e571e0481f41ddbfb8d1dfaba7f3cafe649853c'],0,1,1,1544611,1,,,,1573
47bcf3ebe7067e86846057cbca2466d7349b0d98,1,Parth Brahmbhatt,2015-03-11 14:06:49-07:00,['5a66bb6d2ffbae8c1b7ea929dcb256413bee5b50'],80,29,109,1544720,10,0,0,0,1573
69cb7621181405689386c9676936cc763394871c,0,Robert (Bobby) Evans,2015-03-11 16:17:56-05:00,"['43fe5135a1023813bc8816be07b8dd0c42706fc4', 'd9568f99841e8449f41353e409eac73aeb3b6dc7']",1,1,2,1544722,1,,,,1573
a05ba34c8196312818f128d4c207cccdc2bcb784,0,Robert (Bobby) Evans,2015-03-11 16:34:55-05:00,['69cb7621181405689386c9676936cc763394871c'],0,1,1,1544723,1,,,,1573
a4e94eae06080b376f10e9787865d24be74eba2f,0,Robert (Bobby) Evans,2015-03-11 18:18:23-05:00,"['a05ba34c8196312818f128d4c207cccdc2bcb784', 'b7bfdde8714c39e7556ac34915817dd2a8879356']",0,17,17,1544740,1,,,,1573
ec13a14f36aa824d071b302134d1f3f3807fc7e5,0,Robert (Bobby) Evans,2015-03-11 18:21:31-05:00,['a4e94eae06080b376f10e9787865d24be74eba2f'],0,1,1,1544741,1,,,,1573
62b5a7e58ac2441edb0717d24c751697623b239c,0,Jungtaek Lim,2015-03-12 08:36:49+09:00,['b129080f4b578870b03a8d5788b418c2259a4805'],0,6,6,1544747,2,0,0,1,1573
5b9a9356e8a355b4bc0d6aa61d5ac16d2b5732e6,1,P. Taylor Goetz,2015-03-12 10:29:47-04:00,['3aa41f2712ba101effebf20623e4276296915610'],25,422,447,1545194,9,0.678571429,0.778571429,1,1577
6227eecfb51c9b6cefebe4ca8c31c64e9c7c1332,0,P. Taylor Goetz,2015-03-12 11:56:56-04:00,['5b9a9356e8a355b4bc0d6aa61d5ac16d2b5732e6'],74,69,143,1545337,6,0,1,0,1578
89af8f71d9673300d1436c68338db2052355778e,0,Sriharsha Chintalapani,2015-03-12 09:52:54-07:00,['22a81920fda6004388a48b5eecd1b103ed6cb3aa'],0,1,1,1545338,1,,,,1578
117256b60e2e65b5c7650fe66a6388cab172a8fc,0,Sriharsha Chintalapani,2015-03-12 09:53:41-07:00,"['ec13a14f36aa824d071b302134d1f3f3807fc7e5', '89af8f71d9673300d1436c68338db2052355778e']",148,574,722,1546060,26,,,,1578
6f1a4948ca079161273092b6e3e155d65d2ab3fb,0,P. Taylor Goetz,2015-03-12 13:46:06-04:00,['6227eecfb51c9b6cefebe4ca8c31c64e9c7c1332'],4,2,6,1546066,2,1,0,0,1578
334a5bd1c4b422314136e0519d5af699d22aa72a,1,P. Taylor Goetz,2015-03-12 16:14:44-04:00,['6f1a4948ca079161273092b6e3e155d65d2ab3fb'],27,130,157,1546223,4,0.730769231,0.743589744,0.474358974,1579
6f6f48dbb2a11988a96e1cad59ed4c468ef9ac6c,0,Sriharsha Chintalapani,2015-03-12 15:31:53-07:00,['3df6aaa0a16cd641ca8225ffd52c782b016db364'],14,57,71,1546294,3,1,1,1,1579
9b41ddfd599f6b0538095ee43fa8cf72d8f96d03,0,Sriharsha Chintalapani,2015-03-12 15:35:40-07:00,"['6f6f48dbb2a11988a96e1cad59ed4c468ef9ac6c', '117256b60e2e65b5c7650fe66a6388cab172a8fc']",775,9880,10655,1556949,75,,,,1579
012f75a8c0e91371d8794bdf40bb58e439707d2f,0,Sriharsha Chintalapani,2015-03-12 15:39:13-07:00,"['117256b60e2e65b5c7650fe66a6388cab172a8fc', 'ca7bd99beff75e592c6abc9ba5186633d00f0fe4']",6,10,16,1556965,2,,,,1579
73a7f5d7306b0df8921130d23db22a5dca89fdbb,0,Sriharsha Chintalapani,2015-03-12 15:53:28-07:00,['012f75a8c0e91371d8794bdf40bb58e439707d2f'],0,1,1,1556966,1,,,,1579
a7c3c27b142d17cc513e0436f94fa10bfefa63d3,0,caofangkun,2015-03-13 10:21:58+08:00,"['cee1c0527279487b2b7b991a7d6b42ee173c13f4', '73a7f5d7306b0df8921130d23db22a5dca89fdbb']",232,861,1093,1558059,55,,,,1579
5a8bfc77e610465e11d7697a91e12a9a7d2c8e08,0,caofangkun,2015-03-13 10:38:50+08:00,"['91fefef439388bb3f6f144f6eecd24213ad1cc62', 'a7c3c27b142d17cc513e0436f94fa10bfefa63d3']",8222,34822,43044,1601103,266,,,,1579
bd652ef9b80dbdc2d807aebdc727e6b02960dd8f,0,caofangkun,2015-03-13 10:44:19+08:00,['5a8bfc77e610465e11d7697a91e12a9a7d2c8e08'],0,6,6,1601109,1,,,,1579
75349f007af7df82b7df0e575e28e5b365fec3aa,1,P. Taylor Goetz,2015-03-13 01:30:35-04:00,['334a5bd1c4b422314136e0519d5af699d22aa72a'],53,348,401,1601510,6,0,1,1,1580
e77a300c551e614fcdae03b452c55703a10e2217,1,Michael G. Noll,2015-03-13 10:24:57+01:00,['73a7f5d7306b0df8921130d23db22a5dca89fdbb'],1,11,12,1601522,1,,,,1580
145f542700e761572f7359b33e690bae1b446f9a,0,Kyle Nusbaum,2015-03-13 12:19:46-05:00,"['e77a300c551e614fcdae03b452c55703a10e2217', 'b02f612498b6310d41c0d5fb15d92300c8179094']",11,28,39,1601561,2,,,,1580
87a6627302343305beaaade1ab8a64aad3b045ef,0,Kyle Nusbaum,2015-03-13 13:33:42-05:00,['145f542700e761572f7359b33e690bae1b446f9a'],0,1,1,1601562,1,,,,1580
13121812204934cf261dd27f9287cd2df7dc3f68,1,P. Taylor Goetz,2015-03-13 16:02:48-04:00,['75349f007af7df82b7df0e575e28e5b365fec3aa'],32,116,148,1601710,3,1,1,1,1580
fe6dd86a4fa03c908f10ba837c0b1a8fd9d83ff8,0,lewuathe,2015-03-14 11:52:55+09:00,['0ba5bc1bea44414776efa97f3e66ba08e7384260'],51,38,89,1601799,42,,,,1580
96f92b7d3f403572e3d0c7bdf441da392ea367dc,1,P. Taylor Goetz,2015-03-14 00:46:13-04:00,['13121812204934cf261dd27f9287cd2df7dc3f68'],95,91,186,1601985,9,0.133333333,0.4,0.933333333,1580
70a68d151a86d319b74bfdd84cb8915b84f04ad7,0,P. Taylor Goetz,2015-03-14 01:10:48-04:00,['96f92b7d3f403572e3d0c7bdf441da392ea367dc'],19,17,36,1602021,2,,,,1580
57e802bda041122cf2781e2f4a298f9f2f906a8c,0,P. Taylor Goetz,2015-03-15 22:04:07-04:00,['70a68d151a86d319b74bfdd84cb8915b84f04ad7'],38,160,198,1602219,5,0.487804878,0.524390244,1,1580
8ac4318f64af8090f45d8ef37eae6d4cbc4d413d,0,P. Taylor Goetz,2015-03-15 22:23:54-04:00,['57e802bda041122cf2781e2f4a298f9f2f906a8c'],24,21,45,1602264,3,0.875,0.875,1,1580
ce40049b24c521208189380879b99ff975863e9e,0,P. Taylor Goetz,2015-03-15 22:35:30-04:00,['8ac4318f64af8090f45d8ef37eae6d4cbc4d413d'],2,6,8,1602272,1,1,1,1,1580
5898d4b8ffa00e58af980950357bf6b1f5bbb3cc,0,P. Taylor Goetz,2015-03-15 22:39:29-04:00,['ce40049b24c521208189380879b99ff975863e9e'],6,6,12,1602284,2,,,,1580
31a6f9242be0edd75a4f9b7e476d34a1bbf29ac3,1,P. Taylor Goetz,2015-03-15 23:44:27-04:00,['5898d4b8ffa00e58af980950357bf6b1f5bbb3cc'],2,69,71,1602355,4,0.666666667,0.666666667,1,1581
e02cfa52355c4480c93f8c3a494f74107a33a969,0,P. Taylor Goetz,2015-03-16 01:13:52-04:00,['31a6f9242be0edd75a4f9b7e476d34a1bbf29ac3'],0,8,8,1602363,1,,,,1581
f95938b3d973a9d2513d0e326188f77b9bf438c8,0,caofangkun,2015-03-16 14:31:04+08:00,"['a7c3c27b142d17cc513e0436f94fa10bfefa63d3', '87a6627302343305beaaade1ab8a64aad3b045ef']",12,40,52,1602415,4,,,,1581
d37e747bc1edb161efeeeacb0d7c941ba9f032cc,0,Sriharsha Chintalapani,2015-03-16 08:51:58-07:00,"['87a6627302343305beaaade1ab8a64aad3b045ef', '148c920500f5c1d748cacfb3739c4a035eddb0e3']",77,159,236,1602651,8,,,,1581
537b770810351b0f459fc310bb7535b9d4aada3a,0,Derek Dagit,2015-03-16 10:58:02-05:00,['87a6627302343305beaaade1ab8a64aad3b045ef'],0,1,1,1602652,1,,,,1581
b49db05d35f6fd6988cd054fc594d96535fe7295,0,Sriharsha Chintalapani,2015-03-16 09:32:50-07:00,['d37e747bc1edb161efeeeacb0d7c941ba9f032cc'],0,1,1,1602653,1,,,,1581
81ce9a1d6778827591e7e38bb546767b4306bcee,0,Sriharsha Chintalapani,2015-03-16 09:33:19-07:00,"['537b770810351b0f459fc310bb7535b9d4aada3a', 'b49db05d35f6fd6988cd054fc594d96535fe7295']",77,160,237,1602890,9,,,,1581
f86d53d46b7111b6fe10037a5773bc40a7203b89,0,P. Taylor Goetz,2015-03-16 13:33:15-04:00,['e02cfa52355c4480c93f8c3a494f74107a33a969'],5,77,82,1602972,5,1,1,1,1583
63fbbafa661cfff4af8099042824c91f4ee71a1a,0,Kyle Nusbaum,2015-03-16 14:28:49-05:00,"['81ce9a1d6778827591e7e38bb546767b4306bcee', 'ea2a61d91310835a78354052889e37761a68f5cf']",0,4,4,1602976,1,,,,1583
3d48f421359ebecb7607cf38d1ebd2953a1720d2,0,Kyle Nusbaum,2015-03-16 14:30:14-05:00,['63fbbafa661cfff4af8099042824c91f4ee71a1a'],0,1,1,1602977,1,,,,1583
52000598789a4d40862b0e6e0ab61533f2b44162,1,P. Taylor Goetz,2015-03-16 16:43:55-04:00,['f86d53d46b7111b6fe10037a5773bc40a7203b89'],35,37,72,1603049,4,0,0,0,1583
0201a90aec9a73c75ec7bed640ddf70efb1874d8,1,Sriharsha Chintalapani,2015-03-16 15:33:31-07:00,['3d48f421359ebecb7607cf38d1ebd2953a1720d2'],1,10,11,1603060,1,,,,1583
09f49fa7e7995e3a728f3be4b30a0d6a2008b65d,0,P. Taylor Goetz,2015-03-16 21:44:34-04:00,['52000598789a4d40862b0e6e0ab61533f2b44162'],36,122,158,1603218,5,0.546666667,0.546666667,0.626666667,1583
e4f741676faf936c37fa8c812791cfe0301925aa,0,P. Taylor Goetz,2015-03-16 22:58:21-04:00,['09f49fa7e7995e3a728f3be4b30a0d6a2008b65d'],57,76,133,1603351,12,0.535714286,0.535714286,1,1583
0acea55f4b823fde2ef611b91556b88974364049,0,P. Taylor Goetz,2015-03-16 23:13:12-04:00,['e4f741676faf936c37fa8c812791cfe0301925aa'],3,0,3,1603354,1,,,,1583
9b9f525db07a03c374ac0fe589ea8c01d7a69db5,0,P. Taylor Goetz,2015-03-16 23:52:59-04:00,['0acea55f4b823fde2ef611b91556b88974364049'],0,23,23,1603377,1,,,,1583
1e31eb9c574c02a597504232e0027915ff03e7f6,0,P. Taylor Goetz,2015-03-17 00:23:18-04:00,['9b9f525db07a03c374ac0fe589ea8c01d7a69db5'],22,22,44,1603421,1,,,,1583
784be66a58dd3bf3af5ff73310ca03905f418fb4,0,P. Taylor Goetz,2015-03-17 00:48:12-04:00,['1e31eb9c574c02a597504232e0027915ff03e7f6'],56,69,125,1603546,1,,,,1583
ecb8d3fd545ef03723ac0a3948ca278a86b90e19,0,P. Taylor Goetz,2015-03-17 01:06:21-04:00,['784be66a58dd3bf3af5ff73310ca03905f418fb4'],1,389,390,1603936,23,,,,1583
f384fd70764559a3cbb19d4c7f437b41e9d92fc0,0,P. Taylor Goetz,2015-03-17 01:27:08-04:00,['ecb8d3fd545ef03723ac0a3948ca278a86b90e19'],6,13,19,1603955,2,0,0.75,1,1583
899b6bec9028679bf25586d58fd5f24e5deb4d4f,0,P. Taylor Goetz,2015-03-17 01:45:31-04:00,['f384fd70764559a3cbb19d4c7f437b41e9d92fc0'],2,0,2,1603957,1,,,,1583
33a1e23c0a42c469b4d5400ee47b31f558acfef9,0,Robert (Bobby) Evans,2015-03-17 09:40:26-05:00,"['3d48f421359ebecb7607cf38d1ebd2953a1720d2', '9b41ddfd599f6b0538095ee43fa8cf72d8f96d03']",14,87,101,1604058,4,,,,1583
e85d01f7c36ae2f2a0f9c8c00b49b5cef3e69e44,0,Robert (Bobby) Evans,2015-03-17 09:52:37-05:00,['33a1e23c0a42c469b4d5400ee47b31f558acfef9'],0,1,1,1604059,1,,,,1583
1d45f58dc0e0c34bda54e8764229b0d4e5ee6624,0,Robert (Bobby) Evans,2015-03-17 10:28:27-05:00,"['e85d01f7c36ae2f2a0f9c8c00b49b5cef3e69e44', 'bd652ef9b80dbdc2d807aebdc727e6b02960dd8f']",1,2,3,1604062,1,,,,1583
2019209854b6edb923182d480258b26656cb013c,0,Robert (Bobby) Evans,2015-03-17 10:40:54-05:00,['1d45f58dc0e0c34bda54e8764229b0d4e5ee6624'],0,1,1,1604063,1,,,,1583
3f4e666813e7cb693687204479bd547e0473975f,0,Kyle Nusbaum,2015-03-17 12:08:14-05:00,"['2019209854b6edb923182d480258b26656cb013c', 'fe6dd86a4fa03c908f10ba837c0b1a8fd9d83ff8']",1,54,55,1604118,5,,,,1583
1ea378d78daa5176bff5464200aca4d92b102d6e,0,Kyle Nusbaum,2015-03-17 12:58:03-05:00,['3f4e666813e7cb693687204479bd547e0473975f'],0,1,1,1604119,1,,,,1583
4a49eb5697121fac55417dddd91712885d837b89,1,P. Taylor Goetz,2015-03-17 15:43:24-04:00,['899b6bec9028679bf25586d58fd5f24e5deb4d4f'],68,99,167,1604286,8,0,0,,1584
851984e54179347ca2ca8773ecaab17432ef166d,0,P. Taylor Goetz,2015-03-17 15:55:52-04:00,['4a49eb5697121fac55417dddd91712885d837b89'],5,24,29,1604315,1,,,,1584
55d1e165225bd490158cecb69ac67c056a6d0616,0,P. Taylor Goetz,2015-03-17 16:01:42-04:00,['851984e54179347ca2ca8773ecaab17432ef166d'],0,17,17,1604332,1,,,,1584
c45e951932c51d7c11b035ec7df20a4dd1e63446,0,P. Taylor Goetz,2015-03-17 16:05:09-04:00,['55d1e165225bd490158cecb69ac67c056a6d0616'],0,79,79,1604411,1,1,1,1,1585
ed9a563607d8741dcba40d3aaeff4aa70472dff7,1,P. Taylor Goetz,2015-03-17 20:48:50-04:00,['c45e951932c51d7c11b035ec7df20a4dd1e63446'],1,77,78,1604489,1,,,,1585
edb77546724737894bce2e716a50fd6aa01b9f8b,0,P. Taylor Goetz,2015-03-17 20:57:00-04:00,['ed9a563607d8741dcba40d3aaeff4aa70472dff7'],1,1,2,1604491,1,,,,1585
0174fe03cbc614755df3be00601ed80564b42a31,0,P. Taylor Goetz,2015-03-17 20:59:28-04:00,['edb77546724737894bce2e716a50fd6aa01b9f8b'],0,0,0,1604491,1,,,,1585
fb8850f6938088524f633f614e9a99b8bbc7e4c0,0,P. Taylor Goetz,2015-03-17 21:01:26-04:00,['0174fe03cbc614755df3be00601ed80564b42a31'],7,4,11,1604502,1,,,,1585
39caf4df4b2891bf798f373bb6331908c34828bc,0,P. Taylor Goetz,2015-03-17 21:01:28-04:00,['fb8850f6938088524f633f614e9a99b8bbc7e4c0'],1,1,2,1604504,1,,,,1585
146bd6b7b18f03b338df78431654d7c54fa0e8a4,0,caofangkun,2015-03-18 09:17:37+08:00,"['f95938b3d973a9d2513d0e326188f77b9bf438c8', '1ea378d78daa5176bff5464200aca4d92b102d6e']",93,312,405,1604909,21,,,,1585
eabdd4a06b432b39ecf0c4a1b1d0a009fe9d46b3,1,P. Taylor Goetz,2015-03-17 22:11:04-04:00,['39caf4df4b2891bf798f373bb6331908c34828bc'],18,18,36,1604945,1,,,,1585
b30ace0bdf19c0979bd3830a408fc1260c2ffa31,1,P. Taylor Goetz,2015-03-18 00:47:49-04:00,['eabdd4a06b432b39ecf0c4a1b1d0a009fe9d46b3'],23,47,70,1605015,2,,,,1585
58da2016157c1c358f70cf0aceca8b9c56cffb0c,1,Kishor Patil,2015-03-18 12:01:24-05:00,['1ea378d78daa5176bff5464200aca4d92b102d6e'],5,79,84,1605099,5,0.837209302,0.651162791,0.720930233,1586
720a93ee92903d4ad4c4ab299042624fe4202b37,0,Kishor Patil,2015-03-18 12:02:31-05:00,['58da2016157c1c358f70cf0aceca8b9c56cffb0c'],7,23,30,1605129,3,,,,1586
323534097617d44e263c52c27dcb6da1b418816f,0,Kishor Patil,2015-03-18 12:02:33-05:00,['720a93ee92903d4ad4c4ab299042624fe4202b37'],1,1,2,1605131,1,,,,1586
93b1b656013a941b03c51936ea2c95cd7952fbc5,0,Parth Brahmbhatt,2015-03-18 10:34:56-07:00,['47bcf3ebe7067e86846057cbca2466d7349b0d98'],1,1,2,1605133,1,,,,1586
ffb1562cb0eb3fbd916423136fcd3c181fbf6212,1,Parth Brahmbhatt,2015-03-18 10:49:27-07:00,['2666d9907bcf3e517dcafe8a5b3c17d33f05b8ec'],6,6,12,1605145,5,,,,1586
9ee8718029b79b984e57f7624709d44e4703f400,0,Kishor Patil,2015-03-18 17:56:19+00:00,['323534097617d44e263c52c27dcb6da1b418816f'],7,20,27,1605172,6,0,0,0,1586
5d6b62ba49609052426509d04ef8096b2c3dbd46,0,Kishor Patil,2015-03-18 18:50:11+00:00,['9ee8718029b79b984e57f7624709d44e4703f400'],1,0,1,1605173,1,,,,1586
66274f342c8d35e4e952f2d22a6250a1a6760287,0,Robert (Bobby) Evans,2015-03-18 14:20:15-05:00,"['1ea378d78daa5176bff5464200aca4d92b102d6e', '93b1b656013a941b03c51936ea2c95cd7952fbc5']",206,6606,6812,1611985,35,,,,1586
bb8d48da29f0b93fe09f91dc3769517d0fdc045f,0,Robert (Bobby) Evans,2015-03-18 14:37:51-05:00,['66274f342c8d35e4e952f2d22a6250a1a6760287'],0,1,1,1611986,1,,,,1586
30f942ca2c9aae828c04ddaa834ea07bf74201d7,0,jayunit100,2015-03-18 21:31:47-04:00,['87a6627302343305beaaade1ab8a64aad3b045ef'],2,19,21,1612007,2,,,,1586
57a691c865f764cf331abd2e2e6d27bd320813f8,0,caofangkun,2015-03-19 10:01:23+08:00,"['146bd6b7b18f03b338df78431654d7c54fa0e8a4', 'bb8d48da29f0b93fe09f91dc3769517d0fdc045f']",206,6607,6813,1618820,36,,,,1586
f819e7187111c51f00aea1a663721ce00fa66d79,1,P. Taylor Goetz,2015-03-19 00:27:18-04:00,['b30ace0bdf19c0979bd3830a408fc1260c2ffa31'],52,32,84,1618904,3,1,0,0,1586
405509b7aaef9e4db4457d19ac89d422e08f07bb,1,P. Taylor Goetz,2015-03-19 01:06:13-04:00,['f819e7187111c51f00aea1a663721ce00fa66d79'],5,16,21,1618925,2,0,0,1,1586
506c24239e7e3f8f8d6a730232739d7f53da7a23,0,lewuathe,2015-03-19 22:45:01+09:00,['7e36ce579f0dcbcf4dfe5942b906a6e94a1815e8'],27,2,29,1618954,1,,,,1586
26b2f324cbd68aea0839423b4316070d8200f7ae,1,lewuathe,2015-03-19 23:13:29+09:00,"['506c24239e7e3f8f8d6a730232739d7f53da7a23', 'bb8d48da29f0b93fe09f91dc3769517d0fdc045f']",1086,8473,9559,1628513,110,,,,1586
1e3bf8c09cb1be6b60ca57fce2b6d859a57e173a,0,Craig Hawco,2015-03-19 14:02:26-04:00,['bb8d48da29f0b93fe09f91dc3769517d0fdc045f'],8,8,16,1628529,1,,,,1586
43ed102f25dd5df5b7e43205dfc96a157b7a715b,0,Kishor Patil,2015-03-19 15:16:08-05:00,"['bb8d48da29f0b93fe09f91dc3769517d0fdc045f', 'b54b3b41e97b36dfea0d5cb3b887f23bbc29725e']",3259,1079,4338,1632867,34,,,,1586
645504dfa927d6f3e3aaa248c9e6c7a6c462e566,0,Kishor Patil,2015-03-19 15:17:45-05:00,['43ed102f25dd5df5b7e43205dfc96a157b7a715b'],0,1,1,1632868,1,,,,1586
575871822b116608f47a0a7a4cd3b4b17df9a672,1,Parth Brahmbhatt,2015-03-19 15:24:50-07:00,"['f7205d29f7afeb9e4cf03a31be0ac5737652b07c', 'bb8d48da29f0b93fe09f91dc3769517d0fdc045f']",1095,8564,9659,1642527,110,,,,1586
45c1403d4bd6d68f9d2d4e587b3dd152ce8faf7c,1,P. Taylor Goetz,2015-03-19 21:31:24-04:00,['645504dfa927d6f3e3aaa248c9e6c7a6c462e566'],6,17,23,1642550,3,,,,1586
74931dd38dc2295761287f3b815c30923cd609c4,1,P. Taylor Goetz,2015-03-19 23:24:46-04:00,['405509b7aaef9e4db4457d19ac89d422e08f07bb'],1,1,2,1642552,1,,,,1586
d6faef3d6dd5add847638f723d0d3ac505b6b2a0,0,P. Taylor Goetz,2015-03-19 23:36:45-04:00,['74931dd38dc2295761287f3b815c30923cd609c4'],0,7,7,1642559,1,,,,1586
dcee1e29c8c38e148bdc55fa45c8125facd95682,1,P. Taylor Goetz,2015-03-20 00:17:57-04:00,['45c1403d4bd6d68f9d2d4e587b3dd152ce8faf7c'],1,1,2,1642561,1,,,,1586
be79e0e6124794f59fcb6c7e73b85ccce862b8b4,0,P. Taylor Goetz,2015-03-20 01:09:59-04:00,['d6faef3d6dd5add847638f723d0d3ac505b6b2a0'],31,446,477,1643038,36,0.685714286,1,0.7,1590
854fcc4232ad8aaef1ac75824d9f7f08583b7f89,0,P. Taylor Goetz,2015-03-20 01:52:11-04:00,['be79e0e6124794f59fcb6c7e73b85ccce862b8b4'],122,84,206,1643244,4,,,,1592
d3b2d631a91b69eeeb8b92f554f8f1314dff1e2e,0,Derek Dagit,2015-03-20 09:48:05-05:00,['dcee1e29c8c38e148bdc55fa45c8125facd95682'],0,62,62,1643306,1,,,,1592
eb3a8375aed6eea6302383839676634f663acc46,0,Parth Brahmbhatt,2015-03-20 10:38:05-07:00,['575871822b116608f47a0a7a4cd3b4b17df9a672'],0,1,1,1643307,1,,,,1592
a11fcc303aeb728af4c9a7a1c232b2f1213330c4,1,Parth Brahmbhatt,2015-03-20 11:07:07-07:00,"['eb3a8375aed6eea6302383839676634f663acc46', 'dcee1e29c8c38e148bdc55fa45c8125facd95682']",3283,1124,4407,1647714,39,,,,1592
a0311bfeb1fad069e15fa7b855033fadfe020bbe,0,P. Taylor Goetz,2015-03-20 15:04:31-04:00,['854fcc4232ad8aaef1ac75824d9f7f08583b7f89'],12,110,122,1647836,13,,,,1594
d79b162fc7784d0065ec1782277d141b4d0b21a8,0,P. Taylor Goetz,2015-03-20 15:14:49-04:00,['a0311bfeb1fad069e15fa7b855033fadfe020bbe'],9,9,18,1647854,6,,,,1594
1f0aad4ba6171f24863e4d2819513a47dc5e409f,0,jangie,2015-03-20 15:54:29-04:00,['dcee1e29c8c38e148bdc55fa45c8125facd95682'],1,1,2,1647856,1,,,,1594
b968d413f05e39a206352fb5d82bd50003878f36,0,jangie,2015-03-20 16:02:07-04:00,['1f0aad4ba6171f24863e4d2819513a47dc5e409f'],2,2,4,1647860,1,,,,1594
1b4ea1ebf55248cf1d11719839ea126837ec17d1,0,jangie,2015-03-20 16:08:37-04:00,['b968d413f05e39a206352fb5d82bd50003878f36'],1,1,2,1647862,1,,,,1594
2c486b31844a18808364cfb3ff68ec967ec46124,1,Sriharsha Chintalapani,2015-03-22 11:03:42-07:00,['0201a90aec9a73c75ec7bed640ddf70efb1874d8'],3,7,10,1647872,2,,,,1594
05e7fac869c71a4e5211d305b5faf91de4b10383,0,Muneyuki Noguchi,2015-03-23 11:39:53+00:00,['dcee1e29c8c38e148bdc55fa45c8125facd95682'],1,1,2,1647874,1,,,,1594
3bdc56c194cea6a0f69be42c6648853ff6f0a081,0,P. Taylor Goetz,2015-03-23 16:22:29-04:00,['d79b162fc7784d0065ec1782277d141b4d0b21a8'],0,3,3,1647877,1,0,1,1,1594
9cd55045757cf5789a464cd3bb4c1606dd63ce2c,1,P. Taylor Goetz,2015-03-23 17:14:14-04:00,['3bdc56c194cea6a0f69be42c6648853ff6f0a081'],13,42,55,1647932,2,0,0.111111111,1,1594
f910e0db9447ca0bdc1a382c09ee1a242f4fc166,1,Jang-Soo Lee,2015-03-23 22:34:59-04:00,['dcee1e29c8c38e148bdc55fa45c8125facd95682'],4,28,32,1647964,2,0,0,1,1594
2c5b402381dbffd3942c0b67cdb8013462b5552a,0,caofangkun,2015-03-24 10:44:47+08:00,"['57a691c865f764cf331abd2e2e6d27bd320813f8', 'dcee1e29c8c38e148bdc55fa45c8125facd95682']",3266,1098,4364,1652328,39,,,,1594
fc02748f992ca394f64513220424f552263bc6d6,0,P. Taylor Goetz,2015-03-23 23:21:09-04:00,['9cd55045757cf5789a464cd3bb4c1606dd63ce2c'],8,139,147,1652475,7,1,0.80952381,1,1598
cec86948e5566ce43af4fd8eb3b5c481342c08dd,0,P. Taylor Goetz,2015-03-24 01:48:34-04:00,['fc02748f992ca394f64513220424f552263bc6d6'],4,8,12,1652487,1,1,1,1,1598
1f9dc5f861341dd0828dc50ff04cb310061b3249,0,Robert (Bobby) Evans,2015-03-24 09:16:35-05:00,"['dcee1e29c8c38e148bdc55fa45c8125facd95682', '26bab1595c56f6f40ea2392401e829f3ccb0cff0']",14,5,19,1652506,1,,,,1598
549b01a0341437865d47a76f8a1da5d53597513c,0,Robert (Bobby) Evans,2015-03-24 09:39:54-05:00,['1f9dc5f861341dd0828dc50ff04cb310061b3249'],13,17,30,1652536,15,,,,1598
cea3faa84464e543131d330ed3ea1522129eb791,0,Robert (Bobby) Evans,2015-03-24 09:44:29-05:00,"['549b01a0341437865d47a76f8a1da5d53597513c', '62b5a7e58ac2441edb0717d24c751697623b239c']",123,544,667,1653203,32,,,,1598
a8a0dfdbf930886dbaa920698228376b3a0f31a4,0,Robert (Bobby) Evans,2015-03-24 09:53:06-05:00,['cea3faa84464e543131d330ed3ea1522129eb791'],0,1,1,1653204,1,,,,1598
3837f7d4d86e8aeb6cf97519b37817ffe9033401,0,P. Taylor Goetz,2015-03-24 15:51:10-04:00,['cec86948e5566ce43af4fd8eb3b5c481342c08dd'],14,16,30,1653234,1,0,1,1,1598
30add7807da84f83cbbed756635e373606826404,1,P. Taylor Goetz,2015-03-24 15:52:36-04:00,['3837f7d4d86e8aeb6cf97519b37817ffe9033401'],11,57,68,1653302,1,0,0.941176471,1,1598
dc1afbe6cc86d9c7a5f0d274638920de9e69273b,0,P. Taylor Goetz,2015-03-24 15:53:20-04:00,['30add7807da84f83cbbed756635e373606826404'],0,24,24,1653326,1,1,1,1,1599
2421bf78cce867da1358ea283667106b459bb8d2,0,P. Taylor Goetz,2015-03-24 15:53:57-04:00,['dc1afbe6cc86d9c7a5f0d274638920de9e69273b'],4,10,14,1653340,3,1,1,1,1599
6a269c919b0e8bfe2b9cfddd0bcd338f46c0998b,0,P. Taylor Goetz,2015-03-24 15:54:34-04:00,['2421bf78cce867da1358ea283667106b459bb8d2'],11,0,11,1653351,1,,,,1599
5e6a77e4c4e36ebf9d92cbf9055084e5c2f17338,1,P. Taylor Goetz,2015-03-24 17:32:58-04:00,['6a269c919b0e8bfe2b9cfddd0bcd338f46c0998b'],10,166,176,1653527,6,0.512820513,0.653846154,1,1603
e86b924e860bfe7722785b81f9647c5697a9461f,0,Sriharsha Chintalapani,2015-03-24 15:48:03-07:00,['dcee1e29c8c38e148bdc55fa45c8125facd95682'],21,86,107,1653634,4,,,,1603
7bf48fdb4a6d14f65dfdcebeeded3b0d9d364eba,0,P. Taylor Goetz,2015-03-24 21:28:53-04:00,['5e6a77e4c4e36ebf9d92cbf9055084e5c2f17338'],4,13,17,1653651,1,0,1,1,1603
7125e959fd04771668cf19b4f08608aa23cbc1f0,0,P. Taylor Goetz,2015-03-24 22:30:03-04:00,['7bf48fdb4a6d14f65dfdcebeeded3b0d9d364eba'],5,61,66,1653717,6,1,1,1,1605
e22ae7cd60d0f997c57b2c844367ad800fb734ab,0,P. Taylor Goetz,2015-03-25 00:51:20-04:00,['7125e959fd04771668cf19b4f08608aa23cbc1f0'],8,140,148,1653865,4,0.46875,1,1,1607
8dca3a4dbdf6ef01ee0c961f7c46895c3d31c007,0,P. Taylor Goetz,2015-03-25 01:07:48-04:00,['e22ae7cd60d0f997c57b2c844367ad800fb734ab'],1,1,2,1653867,1,,,,1607
fd4f40ec6b1fa3286068d2912c7ee8c4ada60467,0,P. Taylor Goetz,2015-03-25 01:28:55-04:00,['8dca3a4dbdf6ef01ee0c961f7c46895c3d31c007'],3,4,7,1653874,1,,,,1607
85f1be83b6a0fa6a2cced9bae927c03288929c38,0,P. Taylor Goetz,2015-03-25 01:37:07-04:00,['fd4f40ec6b1fa3286068d2912c7ee8c4ada60467'],1,1,2,1653876,1,,,,1607
77c590a35426381e0c6deff1c5085ccd59784aef,0,P. Taylor Goetz,2015-03-25 01:41:44-04:00,['85f1be83b6a0fa6a2cced9bae927c03288929c38'],8,6,14,1653890,4,,,,1607
ae9ebcb275b7c44a21ed9e0acb9d700b89595d93,0,P. Taylor Goetz,2015-03-25 01:41:45-04:00,['77c590a35426381e0c6deff1c5085ccd59784aef'],4,4,8,1653898,4,,,,1607
52e394a9fbbd9aae44f348cfe0023215378653b1,0,P. Taylor Goetz,2015-03-25 02:00:07-04:00,['ae9ebcb275b7c44a21ed9e0acb9d700b89595d93'],0,3,3,1653901,1,,,,1607
286c52bbaea9c83d964ceacac1b44d5815294d3e,0,Jungtaek Lim,2015-03-25 18:30:52+09:00,['a8a0dfdbf930886dbaa920698228376b3a0f31a4'],35,0,35,1653936,1,0.666666667,0,0,1607
4b9b9767c2bcc9b10a541d950a81827d89b4607e,0,Jungtaek Lim,2015-03-25 18:31:03+09:00,['286c52bbaea9c83d964ceacac1b44d5815294d3e'],2,106,108,1654044,1,,,,1607
c75de7e7e63f282f44306d7bd0635a7a9be5e925,0,Jungtaek Lim,2015-03-25 18:51:07+09:00,['a8a0dfdbf930886dbaa920698228376b3a0f31a4'],154,0,154,1654198,2,0.738461538,0.415384615,0.615384615,1607
77960dcc30b79190e17a910ac904dd2d04118e73,0,P. Taylor Goetz,2015-03-25 13:14:50-04:00,['52e394a9fbbd9aae44f348cfe0023215378653b1'],4,14,18,1654216,4,,,,1607
c1ac1d12873dc81092da8e18f8b5f569cd7769c2,0,P. Taylor Goetz,2015-03-25 13:16:11-04:00,['77960dcc30b79190e17a910ac904dd2d04118e73'],4,4,8,1654224,4,,,,1607
e8b3dcf7aebb42ae04d24170a7377823c3fa5e51,0,P. Taylor Goetz,2015-03-25 13:16:13-04:00,['c1ac1d12873dc81092da8e18f8b5f569cd7769c2'],4,4,8,1654232,4,,,,1607
ebc7f0844db076d8f947b3c6bacf0254aa64eb11,0,P. Taylor Goetz,2015-03-25 13:22:47-04:00,['e8b3dcf7aebb42ae04d24170a7377823c3fa5e51'],4,4,8,1654240,4,,,,1607
db0dc44fcbcba59e237a60f3b45de5de0e361f30,0,P. Taylor Goetz,2015-03-25 13:22:49-04:00,['ebc7f0844db076d8f947b3c6bacf0254aa64eb11'],4,4,8,1654248,4,,,,1607
3974958275cdb6f283932f82b5839093e7da68c9,0,P. Taylor Goetz,2015-03-25 13:48:30-04:00,['db0dc44fcbcba59e237a60f3b45de5de0e361f30'],88,0,88,1654336,3,,,,1607
9739d865cb3e2679297aa02263fdc4cb4aa9f0cc,0,P. Taylor Goetz,2015-03-25 13:48:54-04:00,['3974958275cdb6f283932f82b5839093e7da68c9'],4,30,34,1654370,2,,,,1607
d944cc3e1f3150b25439b4d1600ea33c531ab83c,0,P. Taylor Goetz,2015-03-25 14:04:45-04:00,['9739d865cb3e2679297aa02263fdc4cb4aa9f0cc'],3,3,6,1654376,3,,,,1607
3eeb72b57c4fc8cde5ef5def23fe09dd0042f5c9,0,P. Taylor Goetz,2015-03-25 14:04:47-04:00,['d944cc3e1f3150b25439b4d1600ea33c531ab83c'],3,3,6,1654382,3,,,,1607
1fc336e4eec655b48fc0d963ea3071a8fe882eba,1,P. Taylor Goetz,2015-03-25 15:04:21-04:00,['3eeb72b57c4fc8cde5ef5def23fe09dd0042f5c9'],162,61,223,1654605,1,1,0,0,1607
91d0595fd055dff218fe48f7fcbdf2b88696aeae,0,P. Taylor Goetz,2015-03-25 15:51:51-04:00,['1fc336e4eec655b48fc0d963ea3071a8fe882eba'],35,30,65,1654670,1,1,0.6,0,1607
b944cbbc95185211831a760b6a8413a846cbd721,1,P. Taylor Goetz,2015-03-25 16:54:52-04:00,['91d0595fd055dff218fe48f7fcbdf2b88696aeae'],0,245,245,1654915,6,0.58974359,0.598290598,0.598290598,1610
94dc44a653df973008e97dc18f697649bcb94caa,0,P. Taylor Goetz,2015-03-25 20:57:33-04:00,['b944cbbc95185211831a760b6a8413a846cbd721'],2,40,42,1654957,1,,,,1610
b17b1f7925b44a5561ceb04bffeded834359c970,0,P. Taylor Goetz,2015-03-25 21:12:27-04:00,['94dc44a653df973008e97dc18f697649bcb94caa'],40,6,46,1655003,5,,,,1610
3cda91d4312daee2683a66a18dcbe5ba09212598,0,P. Taylor Goetz,2015-03-25 21:14:41-04:00,['b17b1f7925b44a5561ceb04bffeded834359c970'],3,3,6,1655009,3,,,,1610
011fa870dba57294510ad538134f728aca996104,0,P. Taylor Goetz,2015-03-25 21:14:43-04:00,['3cda91d4312daee2683a66a18dcbe5ba09212598'],3,3,6,1655015,3,,,,1610
13f6e9bca350f2626ab962b4927ae6df8324175e,0,Robert (Bobby) Evans,2015-03-26 09:28:06-05:00,"['a8a0dfdbf930886dbaa920698228376b3a0f31a4', 'c75de7e7e63f282f44306d7bd0635a7a9be5e925']",154,0,154,1655169,2,,,,1610
6a0ebadea41b3def331a8ee4ca1fb172281499d8,0,Robert (Bobby) Evans,2015-03-26 09:28:55-05:00,['13f6e9bca350f2626ab962b4927ae6df8324175e'],0,1,1,1655170,1,,,,1610
d96a523cd4e6e4652a4e62883c2eca4706be6c2c,1,P. Taylor Goetz,2015-03-26 16:20:36-04:00,['6a0ebadea41b3def331a8ee4ca1fb172281499d8'],21,67,88,1655258,2,,,,1611
ef25356b1d93fd27d92893779a8ccaf293d90901,0,Derek Dagit,2015-03-26 16:30:03-05:00,['d96a523cd4e6e4652a4e62883c2eca4706be6c2c'],1,1,2,1655260,1,,,,1611
c207f925c3da4ac814c733612e590f3327e2fd2a,0,Kyle Nusbaum,2015-03-26 16:37:39-05:00,"['d96a523cd4e6e4652a4e62883c2eca4706be6c2c', 'd3b2d631a91b69eeeb8b92f554f8f1314dff1e2e']",0,62,62,1655322,1,,,,1611
330e1356d25073f09faa815e422a1ecd95786faf,0,Kyle Nusbaum,2015-03-26 16:42:42-05:00,['c207f925c3da4ac814c733612e590f3327e2fd2a'],0,1,1,1655323,1,,,,1611
db813c7781c4359229ddee58bbe40dc763ec0eab,1,Jungtaek Lim,2015-03-27 07:00:35+09:00,['330e1356d25073f09faa815e422a1ecd95786faf'],0,119,119,1655442,5,1,1,1,1615
6d3ee2478348e8597985374cd110a463de633c04,0,Derek Dagit,2015-03-26 17:02:13-05:00,['d96a523cd4e6e4652a4e62883c2eca4706be6c2c'],1,1,2,1655444,1,,,,1615
cc56d7745e19a46eecf090e643a126d8e07523a2,0,Derek Dagit,2015-03-26 17:12:02-05:00,['d96a523cd4e6e4652a4e62883c2eca4706be6c2c'],1,1,2,1655446,1,,,,1615
86f7c171a7638aa7c3bab5b14ff9c886dfb2909e,0,Jungtaek Lim,2015-03-27 07:52:51+09:00,['330e1356d25073f09faa815e422a1ecd95786faf'],8,18,26,1655472,5,1,1,1,1615
21df8259d95e69adc6e63517e179d5c4f5e0250e,1,P. Taylor Goetz,2015-03-27 17:25:54-04:00,['011fa870dba57294510ad538134f728aca996104'],122,444,566,1656038,12,0.315789474,0.315789474,0.973684211,1619
f62e1209ed47ba9b0e685037fd0a1133810e49fe,0,P. Taylor Goetz,2015-03-28 00:40:41-04:00,['21df8259d95e69adc6e63517e179d5c4f5e0250e'],2,2,4,1656042,1,,,,1619
143b1e5e2ec87860e948b3157982d550cc36311e,0,P. Taylor Goetz,2015-03-28 00:42:36-04:00,['f62e1209ed47ba9b0e685037fd0a1133810e49fe'],4,4,8,1656050,4,,,,1619
96a8b2646c46217617db1f1d605cd241ef2fce1e,0,P. Taylor Goetz,2015-03-28 00:42:38-04:00,['143b1e5e2ec87860e948b3157982d550cc36311e'],4,4,8,1656058,4,,,,1619
d8ac81f73f15fcfd2182bba57f733d92a5c9956b,0,P. Taylor Goetz,2015-03-28 00:50:00-04:00,['96a8b2646c46217617db1f1d605cd241ef2fce1e'],3,3,6,1656064,1,,,,1619
adf91d9b845fc4fda3b205722b804e28c8e6baac,0,P. Taylor Goetz,2015-03-29 00:18:06-04:00,['d8ac81f73f15fcfd2182bba57f733d92a5c9956b'],4,8,12,1656076,1,1,1,0,1619
011debe9bf6fb1b001bdac81cfae01b2f9f823fb,0,Sriharsha Chintalapani,2015-03-29 09:02:21-07:00,['330e1356d25073f09faa815e422a1ecd95786faf'],0,2,2,1656078,1,0,1,1,1619
fda686013f90e6bd575af1673ea92d092e3321a4,1,Parth Brahmbhatt,2015-03-29 10:36:06-07:00,['6a0ebadea41b3def331a8ee4ca1fb172281499d8'],113,118,231,1656309,1,,,,1619
96f3de64ddfe5fa4cc2e2f844efab297d09ed2b6,0,Jungtaek Lim,2015-03-30 09:28:08+09:00,['330e1356d25073f09faa815e422a1ecd95786faf'],1,1,2,1656311,1,,,,1619
2bc9447c78fc6945d71db3772bdb49edad153f07,0,caofangkun,2015-03-30 10:46:28+08:00,"['2c5b402381dbffd3942c0b67cdb8013462b5552a', '330e1356d25073f09faa815e422a1ecd95786faf']",315,688,1003,1657314,50,,,,1619
9c0581e2f0c3ce534017c377e1c0ca206dc90634,0,Sriharsha Chintalapani,2015-03-29 21:32:38-07:00,['2c486b31844a18808364cfb3ff68ec967ec46124'],1,3,4,1657318,2,,,,1619
fe556e9f7a857158e9bad24cea74b7a063a783de,0,Sriharsha Chintalapani,2015-03-29 21:39:29-07:00,"['330e1356d25073f09faa815e422a1ecd95786faf', 'ffb1562cb0eb3fbd916423136fcd3c181fbf6212']",6,6,12,1657330,5,,,,1619
bb38f176de8e5515b6797b3cc86e47ec47fe020c,0,Sriharsha Chintalapani,2015-03-29 21:52:51-07:00,['fe556e9f7a857158e9bad24cea74b7a063a783de'],0,1,1,1657331,1,,,,1619
c8d31271a0c8a96749499e402d3c2cfeae63de9f,0,Sriharsha Chintalapani,2015-03-29 22:01:38-07:00,"['bb38f176de8e5515b6797b3cc86e47ec47fe020c', '4b9b9767c2bcc9b10a541d950a81827d89b4607e']",37,106,143,1657474,2,,,,1619
0d5d4b129e34efa6f52d8c5f5fd92ca23e3fcb6a,0,Sriharsha Chintalapani,2015-03-29 22:10:01-07:00,['c8d31271a0c8a96749499e402d3c2cfeae63de9f'],0,1,1,1657475,1,,,,1619
d063a1ac38a66c8aa5aa9107e45233f9be053020,0,Sriharsha Chintalapani,2015-03-29 22:35:00-07:00,"['0d5d4b129e34efa6f52d8c5f5fd92ca23e3fcb6a', '011debe9bf6fb1b001bdac81cfae01b2f9f823fb']",0,2,2,1657477,1,,,,1619
5b1d10aba4118d854ca06840100b1e8da98bea34,1,P. Taylor Goetz,2015-03-30 01:40:32-04:00,['adf91d9b845fc4fda3b205722b804e28c8e6baac'],27,72,99,1657576,4,0,0.826086957,0,1619
480b63a4b608daf7e5b86c83492af598bb62ff1c,0,Derek Dagit,2015-03-30 09:48:10-05:00,"['d063a1ac38a66c8aa5aa9107e45233f9be053020', 'fda686013f90e6bd575af1673ea92d092e3321a4']",113,118,231,1657807,1,,,,1619
36e99fa2dfdd13cd43d8fa8c558c670cd7750ed0,0,Derek Dagit,2015-03-30 09:51:28-05:00,['480b63a4b608daf7e5b86c83492af598bb62ff1c'],0,1,1,1657808,1,,,,1619
0af1d08c690b1bed68669e4fd291a7c186ea185c,0,Kyle Nusbaum,2015-03-30 12:24:13-05:00,['36e99fa2dfdd13cd43d8fa8c558c670cd7750ed0'],9,8,17,1657825,1,,,,1619
79b405a3225a78a293eda279a8d4dccd2cba6230,1,P. Taylor Goetz,2015-03-30 15:32:14-04:00,['5b1d10aba4118d854ca06840100b1e8da98bea34'],20,143,163,1657988,7,0.769230769,1,0.769230769,1621
d2e10346e58527496bccaeca7b6a1b1d924e7b99,1,Sriharsha Chintalapani,2015-03-30 16:11:22-07:00,['330e1356d25073f09faa815e422a1ecd95786faf'],13,27,40,1658028,6,0,0,1,1621
cdcb73893856710c1fa358c03669c612b83d06ff,1,P. Taylor Goetz,2015-03-30 21:10:21-04:00,['79b405a3225a78a293eda279a8d4dccd2cba6230'],2,37,39,1658067,1,,,,1621
85e53e918437550ff9878a9712eb45055523042e,0,P. Taylor Goetz,2015-03-30 21:31:05-04:00,['cdcb73893856710c1fa358c03669c612b83d06ff'],0,33,33,1658100,1,,,,1621
d8d6cfa073fc5566444675581f3559ea3f3945e4,0,P. Taylor Goetz,2015-03-30 22:26:07-04:00,['85e53e918437550ff9878a9712eb45055523042e'],5,11,16,1658116,1,,,,1621
44d5b5be2dc0e2334fa1e4bd5934eb1f57985084,1,P. Taylor Goetz,2015-03-31 00:16:37-04:00,['d8d6cfa073fc5566444675581f3559ea3f3945e4'],33,97,130,1658246,5,0,0,0.5,1621
b931d1b3da7008c0c278cb6bab9a5ed366333d8d,0,P. Taylor Goetz,2015-03-31 00:19:47-04:00,['44d5b5be2dc0e2334fa1e4bd5934eb1f57985084'],3,3,6,1658252,1,,,,1621
bc530b46bdd7c7995ebd7dd6d9fe41dcb2d8cea7,0,Parth Brahmbhatt,2015-03-31 09:00:53-07:00,['36e99fa2dfdd13cd43d8fa8c558c670cd7750ed0'],0,1,1,1658253,1,,,,1621
9a2c4129b145b901f320238ea36a282ff7f44d0c,1,Sriharsha Chintalapani,2015-03-31 11:37:30-07:00,['330e1356d25073f09faa815e422a1ecd95786faf'],42,77,119,1658372,1,0,0.75,1,1621
b815012509e15a68bdd72cc684ab5cc91dd53b86,0,Jungtaek Lim,2015-04-01 07:02:09+09:00,['bc530b46bdd7c7995ebd7dd6d9fe41dcb2d8cea7'],3,5,8,1658380,1,1,1,0,1621
1945f709174bcd867c8412198c559bbb15e287d9,1,Sriharsha Chintalapani,2015-03-31 17:21:33-07:00,['117256b60e2e65b5c7650fe66a6388cab172a8fc'],2,87,89,1658469,2,,,,1621
002bf003f6b014c1a4f8b83de0a21165691f138b,0,Sriharsha Chintalapani,2015-03-31 17:24:47-07:00,['1945f709174bcd867c8412198c559bbb15e287d9'],1,0,1,1658470,1,,,,1621
bb968c8304e72d90d3d3d11c9fad66122f94dca7,0,Parth Brahmbhatt,2015-03-31 17:26:31-07:00,['36e99fa2dfdd13cd43d8fa8c558c670cd7750ed0'],0,13,13,1658483,2,1,1,1,1621
c5ba437aa9791deb4b5306fa3254fa3c267e7e67,0,Sriharsha Chintalapani,2015-03-31 20:21:29-07:00,['d2e10346e58527496bccaeca7b6a1b1d924e7b99'],3,5,8,1658491,1,,,,1621
003f08d2d0d224c68d620ded35ae2bebc8cfa810,0,Sriharsha Chintalapani,2015-03-31 20:23:37-07:00,"['bc530b46bdd7c7995ebd7dd6d9fe41dcb2d8cea7', 'bb968c8304e72d90d3d3d11c9fad66122f94dca7']",0,13,13,1658504,2,,,,1621
db6df0cafaada08c79679b828721336263341c6c,0,Sriharsha Chintalapani,2015-03-31 20:24:15-07:00,['003f08d2d0d224c68d620ded35ae2bebc8cfa810'],0,1,1,1658505,1,,,,1621
7b1f3f67619d86394e628f984ebb784adec86f2d,0,Sriharsha Chintalapani,2015-03-31 20:36:43-07:00,"['db6df0cafaada08c79679b828721336263341c6c', '002bf003f6b014c1a4f8b83de0a21165691f138b']",2,86,88,1658593,2,,,,1621
cd62063206e4f888f35510a792cdbdf18582e533,0,Sriharsha Chintalapani,2015-03-31 20:37:14-07:00,['7b1f3f67619d86394e628f984ebb784adec86f2d'],0,1,1,1658594,1,,,,1621
33f1a4ef86852b6f033f512512d4f9969668bfda,0,Sriharsha Chintalapani,2015-03-31 20:43:36-07:00,"['cd62063206e4f888f35510a792cdbdf18582e533', '9c0581e2f0c3ce534017c377e1c0ca206dc90634']",2,17,19,1658613,2,,,,1621
20084ba3405ac0ef089fa5b951e9f64f9e0f6f50,0,Sriharsha Chintalapani,2015-03-31 20:44:13-07:00,['33f1a4ef86852b6f033f512512d4f9969668bfda'],1,2,3,1658616,1,,,,1621
55c3f22ddacec13273596dbe9618818a33166b36,0,Sriharsha Chintalapani,2015-03-31 21:05:49-07:00,"['20084ba3405ac0ef089fa5b951e9f64f9e0f6f50', '1e3bf8c09cb1be6b60ca57fce2b6d859a57e173a']",8,8,16,1658632,1,,,,1621
2aaa718094af0d0e931eb3a7a66251268d64896b,0,Sriharsha Chintalapani,2015-03-31 21:06:25-07:00,['55c3f22ddacec13273596dbe9618818a33166b36'],0,1,1,1658633,1,,,,1621
503a04ba1f470ab3f1f6b32109d27a401a8a2510,0,caofangkun,2015-04-01 14:13:00+08:00,"['2bc9447c78fc6945d71db3772bdb49edad153f07', '2aaa718094af0d0e931eb3a7a66251268d64896b']",168,364,532,1659165,17,,,,1621
0c659c26369b376f30951f779882df2645a0bee0,0,Sriharsha Chintalapani,2015-04-01 08:45:33-07:00,['9a2c4129b145b901f320238ea36a282ff7f44d0c'],1,1,2,1659167,1,,,,1621
c3cffa08bbdb3b4748202f94ec802858df45e1fd,1,P. Taylor Goetz,2015-04-01 12:04:55-04:00,['b931d1b3da7008c0c278cb6bab9a5ed366333d8d'],6,14,20,1659187,2,0,0,0.714285714,1621
604026f38b25fdc796b4162b8d6919ecf3eeca68,0,Sriharsha Chintalapani,2015-04-01 10:06:05-07:00,"['e86b924e860bfe7722785b81f9647c5697a9461f', '2aaa718094af0d0e931eb3a7a66251268d64896b']",483,1052,1535,1660722,64,,,,1621
574f876229b9b5e5f7356a770f31fd70e09f73f0,0,Robert (Bobby) Evans,2015-04-01 12:24:57-05:00,['2aaa718094af0d0e931eb3a7a66251268d64896b'],1,2,3,1660725,1,1,1,0,1621
14970de2091485f4ca777606735788657f7bec84,1,P. Taylor Goetz,2015-04-01 13:25:52-04:00,['c3cffa08bbdb3b4748202f94ec802858df45e1fd'],3,4,7,1660732,1,,,,1621
54f5fb7ccf200ba9901dac9753ff292b27037fad,0,P. Taylor Goetz,2015-04-01 13:27:33-04:00,['14970de2091485f4ca777606735788657f7bec84'],4,4,8,1660740,4,,,,1621
df349303e1e2635ac4e6bcab5d872348040a36f4,0,P. Taylor Goetz,2015-04-01 13:27:35-04:00,['54f5fb7ccf200ba9901dac9753ff292b27037fad'],4,4,8,1660748,4,,,,1621
765e4c2fabafbfe31fb0f43e5b670fd3b91d1a2e,1,Parth Brahmbhatt,2015-04-01 10:44:56-07:00,"['a11fcc303aeb728af4c9a7a1c232b2f1213330c4', '2aaa718094af0d0e931eb3a7a66251268d64896b']",486,1057,1543,1662291,64,,,,1621
cc2520a07c2c5005e14dddd21663d14dc3867bc2,1,Sriharsha Chintalapani,2015-04-01 13:54:44-07:00,['604026f38b25fdc796b4162b8d6919ecf3eeca68'],7,118,125,1662416,5,,,,1621
11b01518f0935dedfd71d09b697d7189a29b91b5,1,P. Taylor Goetz,2015-04-02 00:08:12-04:00,['df349303e1e2635ac4e6bcab5d872348040a36f4'],6,6,12,1662428,1,,,,1621
6602c4becb7f22a14faab032872e51f70864530a,0,Derek Dagit,2015-04-02 08:55:03-05:00,['2aaa718094af0d0e931eb3a7a66251268d64896b'],1,2,3,1662431,1,,,,1621
eabc85b67f795bf4ef77218208d39825a9dabc5d,0,Mansheng Yang,2015-04-02 22:00:55+08:00,['2aaa718094af0d0e931eb3a7a66251268d64896b'],1,4,5,1662436,1,,,,1621
2e44c9e6a2fb4382950da463fad9f392f8991468,0,P. Taylor Goetz,2015-04-02 12:18:12-04:00,['11b01518f0935dedfd71d09b697d7189a29b91b5'],0,4,4,1662440,1,0,1,0,1621
8b690e63954b14aa8f079f904d42d2f4beb34cc6,0,P. Taylor Goetz,2015-04-02 12:19:13-04:00,['2e44c9e6a2fb4382950da463fad9f392f8991468'],0,28,28,1662468,1,,,,1622
3411bc7d296c948e3ca6fc1a02ef8a118df39e65,0,P. Taylor Goetz,2015-04-02 12:20:59-04:00,['8b690e63954b14aa8f079f904d42d2f4beb34cc6'],1,45,46,1662514,1,,,,1622
25eb1418b87840b3b07e2045877fef7a0b2f28da,0,Robert (Bobby) Evans,2015-04-02 14:34:04-05:00,"['2aaa718094af0d0e931eb3a7a66251268d64896b', '1ca5f7659ea807f1ae83694788e889ac5cae6669']",11,19,30,1662544,5,,,,1622
fd64c3d2dc61838c1e5c705426b8165068e12c3e,0,Robert (Bobby) Evans,2015-04-02 14:57:27-05:00,['25eb1418b87840b3b07e2045877fef7a0b2f28da'],1,1,2,1662546,2,,,,1622
bebf11a25c23f0aa65a3cf5dc74ef02bb5cafeb6,0,Parth Brahmbhatt,2015-04-02 18:13:18-07:00,['36e99fa2dfdd13cd43d8fa8c558c670cd7750ed0'],67,3,70,1662616,6,0,0,0,1622
d67e16b5deaee27078aab85d5060014191410942,0,Parth Brahmbhatt,2015-04-02 18:15:05-07:00,"['bebf11a25c23f0aa65a3cf5dc74ef02bb5cafeb6', '2aaa718094af0d0e931eb3a7a66251268d64896b']",12,130,142,1662758,8,,,,1622
a37397e5a16c682e70ffe77b272577db7391eb41,0,Jungtaek Lim,2015-04-03 15:45:22+09:00,['96f3de64ddfe5fa4cc2e2f844efab297d09ed2b6'],10,7,17,1662775,2,0,0,0,1622
02b964dc5609e505f91461968b8f46228cd55463,0,Parth Brahmbhatt,2015-04-03 09:58:57-07:00,['d67e16b5deaee27078aab85d5060014191410942'],26,1,27,1662802,3,,,,1622
6c28dce02567fddd8cee8c7461ad4ebb6a3ca6bc,0,Robert (Bobby) Evans,2015-04-03 12:55:30-05:00,"['fd64c3d2dc61838c1e5c705426b8165068e12c3e', '50001f55ef1a1d87bdca2f39618dbe91be09db04']",1,3,4,1662806,1,,,,1622
16c3b4f4c437770bea6f5992153c299024311499,0,Robert (Bobby) Evans,2015-04-03 14:40:11-05:00,"['6c28dce02567fddd8cee8c7461ad4ebb6a3ca6bc', '0c659c26369b376f30951f779882df2645a0bee0']",42,77,119,1662925,1,,,,1622
a5e60b3047244037627f8623a73be4ce466a7f46,0,Robert (Bobby) Evans,2015-04-03 15:42:49-05:00,['16c3b4f4c437770bea6f5992153c299024311499'],0,1,1,1662926,1,,,,1622
5fe57ffd7cfccff78dcd70dc801516bb31b9e2e3,0,Robert (Bobby) Evans,2015-04-03 15:46:45-05:00,"['a5e60b3047244037627f8623a73be4ce466a7f46', '574f876229b9b5e5f7356a770f31fd70e09f73f0']",1,2,3,1662929,1,,,,1622
b367ab4418de5a19b74cad7c5904b9ff12357230,0,Robert (Bobby) Evans,2015-04-03 15:55:29-05:00,['5fe57ffd7cfccff78dcd70dc801516bb31b9e2e3'],0,1,1,1662930,1,,,,1622
45d582c7ea68005d0e37e1cc7d3794fc7589751d,0,Parth Brahmbhatt,2015-04-03 15:34:26-07:00,"['02b964dc5609e505f91461968b8f46228cd55463', 'b367ab4418de5a19b74cad7c5904b9ff12357230']",56,104,160,1663090,10,,,,1622
7fec9a1f4b9887897c9c7d0f3f80433fa34f18c0,0,Jungtaek Lim,2015-04-05 09:38:54+09:00,['b367ab4418de5a19b74cad7c5904b9ff12357230'],97,158,255,1663345,11,1,1,1,1624
8fd1f4b193b5d81b3036726268da39380e2b3b61,0,Jungtaek Lim,2015-04-05 12:21:57+09:00,['7fec9a1f4b9887897c9c7d0f3f80433fa34f18c0'],149,231,380,1663725,8,0.157894737,0,1,1626
b9c0329bd182333f0af237e661e88958d7157520,0,Jungtaek Lim,2015-04-05 18:55:03+09:00,['8fd1f4b193b5d81b3036726268da39380e2b3b61'],242,173,415,1664140,5,1,0,0,1629
2b1f1ae56b3b3eb4ada7563db319066cb78ce0dc,0,Jungtaek Lim,2015-04-05 19:02:19+09:00,['b9c0329bd182333f0af237e661e88958d7157520'],0,51,51,1664191,3,,,,1629
52fec9ab2cc3e9464fab158002fd27887eb6ff85,0,Jungtaek Lim,2015-04-05 19:15:27+09:00,['2b1f1ae56b3b3eb4ada7563db319066cb78ce0dc'],4,16,20,1664211,1,,,,1629
e2e17e1c7899fb918562bbad21a7e68394b5f285,0,Sriharsha Chintalapani,2015-04-05 15:53:25-07:00,['b367ab4418de5a19b74cad7c5904b9ff12357230'],1,1,2,1664213,1,,,,1629
ad0d0d32dbfe06f8b7a40ba7205dddcfe0099a7b,1,Jungtaek Lim,2015-04-06 23:53:31+09:00,['e2e17e1c7899fb918562bbad21a7e68394b5f285'],2,2,4,1664217,1,,,,1629
3a5d3a7892086f4a99f0b35f16a5207eb0522d5d,0,Robert (Bobby) Evans,2015-04-06 12:13:35-05:00,['e2e17e1c7899fb918562bbad21a7e68394b5f285'],0,3,3,1664220,1,,,,1629
0cfb6519d3c09a81ba677d75fabc14c84eb94cdc,0,Robert (Bobby) Evans,2015-04-06 12:15:52-05:00,['3a5d3a7892086f4a99f0b35f16a5207eb0522d5d'],1,1,2,1664222,1,,,,1629
a6935d4befc2c5f751f40a4107ccb9d7f5e17db3,0,Kyle Nusbaum,2015-04-06 12:21:10-05:00,['0cfb6519d3c09a81ba677d75fabc14c84eb94cdc'],0,1,1,1664223,1,,,,1629
f121e9196dfa5b5e8f2a93dfb8138bd6b3cb1df3,1,P. Taylor Goetz,2015-04-06 15:54:24-04:00,['e2e17e1c7899fb918562bbad21a7e68394b5f285'],8,135,143,1664366,8,0,0,0,1632
56284447b89ea70ed4eabdb8c921fde496c71f4c,0,P. Taylor Goetz,2015-04-06 17:02:39-04:00,['f121e9196dfa5b5e8f2a93dfb8138bd6b3cb1df3'],9,16,25,1664391,1,1,1,1,1632
9869fec70bdb06b14cc13ffca69320815950d1f5,0,P. Taylor Goetz,2015-04-06 17:03:15-04:00,['56284447b89ea70ed4eabdb8c921fde496c71f4c'],1,4,5,1664396,1,1,1,1,1632
b77efd3a7cf889cf64e8e5a996f03aadb77b2b6e,0,Robert (Bobby) Evans,2015-04-06 16:06:55-05:00,['a6935d4befc2c5f751f40a4107ccb9d7f5e17db3'],18,13,31,1664427,5,,,,1632
8aa3f4086fd2949e5dbb7befb77e51271eb166d0,0,P. Taylor Goetz,2015-04-06 17:10:27-04:00,['9869fec70bdb06b14cc13ffca69320815950d1f5'],889,25,914,1665341,4,0.176015474,0.104448743,0.104448743,1632
0336c37772305f262df7bfed221ad9378bf4931d,0,P. Taylor Goetz,2015-04-06 17:19:47-04:00,['8aa3f4086fd2949e5dbb7befb77e51271eb166d0'],873,19,892,1666233,5,0.174664107,0.103646833,0.103646833,1632
24fe1f55b4b3b0ebd093b1d4a595def896412873,0,P. Taylor Goetz,2015-04-06 17:25:10-04:00,['0336c37772305f262df7bfed221ad9378bf4931d'],3,3,6,1666239,7,,,,1632
0c1e0aa81f39e473bcf3482448813d78065e1212,0,P. Taylor Goetz,2015-04-06 23:48:38-04:00,['3411bc7d296c948e3ca6fc1a02ef8a118df39e65'],15,66,81,1666320,5,,,,1633
a791604ac5d274cededae8a01362dac4dfd82d84,0,P. Taylor Goetz,2015-04-07 00:07:49-04:00,['0c1e0aa81f39e473bcf3482448813d78065e1212'],4,101,105,1666425,2,,,,1634
dd27ee47346fa417e6acb0cd68b9023d2d6dfe5a,0,Derek Dagit,2015-04-07 11:13:11-05:00,['6602c4becb7f22a14faab032872e51f70864530a'],1,1,2,1666427,1,,,,1634
e2e7c8714a5651beed3b72db6c2186a458940a36,0,Robert (Bobby) Evans,2015-04-07 12:28:39-05:00,['b77efd3a7cf889cf64e8e5a996f03aadb77b2b6e'],4,4,8,1666435,3,,,,1634
98704ec81a7629d11a95a744ee47d3baf7c2de6a,0,Jungtaek Lim,2015-04-08 06:10:44+09:00,['52fec9ab2cc3e9464fab158002fd27887eb6ff85'],28,70,98,1666533,5,0,1,1,1634
c36702e210080b2bc6d59d8f9c0b7307f5926869,0,eric-mulvaney,2015-04-07 17:38:51-04:00,['a6935d4befc2c5f751f40a4107ccb9d7f5e17db3'],1,1,2,1666535,1,,,,1634
410feef51cf7e85267741ca08cdd57a509d1e252,0,eric-mulvaney,2015-04-07 17:38:51-04:00,['c36702e210080b2bc6d59d8f9c0b7307f5926869'],14,17,31,1666566,1,0,0,1,1634
00be569c799a955d7f82a7270fbf37a6178629fd,0,Sriharsha Chintalapani,2015-04-07 15:45:02-07:00,['cc2520a07c2c5005e14dddd21663d14dc3867bc2'],1,24,25,1666591,1,,,,1634
4a1db96fc38fb438c3d4433381e719ca16d63bc8,0,P. Taylor Goetz,2015-04-07 23:23:05-04:00,['a791604ac5d274cededae8a01362dac4dfd82d84'],0,402,402,1666993,8,0.538461538,1,1,1639
edc5744c48b65c3d7298ec5a61affb6164fc4d96,0,P. Taylor Goetz,2015-04-07 23:57:53-04:00,['4a1db96fc38fb438c3d4433381e719ca16d63bc8'],0,12,12,1667005,1,,,,1639
ae305c722c6252cd33530ebb74e56ef991451aba,0,P. Taylor Goetz,2015-04-08 00:00:51-04:00,['edc5744c48b65c3d7298ec5a61affb6164fc4d96'],1,1,2,1667007,1,,,,1639
01702dc503e4f5fbcc499dcae48bb3ffad1229db,1,P. Taylor Goetz,2015-04-08 01:10:30-04:00,['ae305c722c6252cd33530ebb74e56ef991451aba'],3,114,117,1667124,3,0.727272727,1,1,1640
0e9cccddeebacc42995da37bb03232867e704542,0,Robert (Bobby) Evans,2015-04-08 08:46:32-05:00,['a6935d4befc2c5f751f40a4107ccb9d7f5e17db3'],5,131,136,1667260,10,0.208791209,0,0.956043956,1640
05306d5053ff91bd323c4b54cd246c9f928ca339,1,zhuol,2015-04-08 08:57:31-05:00,['330e1356d25073f09faa815e422a1ecd95786faf'],8,56,64,1667324,4,1,1,0,1640
c106f1337f84cf7f46be0a133b3bd17b57412d3f,0,zhuol,2015-04-08 09:03:42-05:00,"['05306d5053ff91bd323c4b54cd246c9f928ca339', 'a6935d4befc2c5f751f40a4107ccb9d7f5e17db3']",225,473,698,1668022,27,,,,1640
9f5f822720544e356682d3c007c3407f5c2e5058,0,P. Taylor Goetz,2015-04-08 12:50:59-04:00,['01702dc503e4f5fbcc499dcae48bb3ffad1229db'],46,24,70,1668092,6,0,1,1,1641
2059f23d8a30df9089f6a928b4a2bf51d608099f,0,eric-mulvaney,2015-04-08 14:35:51-04:00,['410feef51cf7e85267741ca08cdd57a509d1e252'],1,1,2,1668094,1,,,,1641
306c535fb3e7fb5522e9cd2e0f41ba4c9fa8f9ca,0,eric-mulvaney,2015-04-08 14:37:06-04:00,['2059f23d8a30df9089f6a928b4a2bf51d608099f'],1,10,11,1668105,1,0,0,1,1641
c7b364eacd8e3b971775b67f7b2658d88e6c76a3,0,Robert (Bobby) Evans,2015-04-08 14:03:56-05:00,['a6935d4befc2c5f751f40a4107ccb9d7f5e17db3'],0,225,225,1668330,4,0.806818182,1,1,1644
337265749ed1263cc20feaab8950a39af0680008,0,Parth Brahmbhatt,2015-04-08 12:13:37-07:00,"['45d582c7ea68005d0e37e1cc7d3794fc7589751d', 'a6935d4befc2c5f751f40a4107ccb9d7f5e17db3']",1,5,6,1668336,3,,,,1644
1fbaeada6e7eb337bc7d7802c71198d417a8b1d3,0,Sriharsha Chintalapani,2015-04-08 13:44:10-07:00,"['a6935d4befc2c5f751f40a4107ccb9d7f5e17db3', '0af1d08c690b1bed68669e4fd291a7c186ea185c']",9,8,17,1668353,1,,,,1644
e9ac047b0adea339e005aedf13c969474d27edcc,0,Sriharsha Chintalapani,2015-04-08 13:44:55-07:00,['1fbaeada6e7eb337bc7d7802c71198d417a8b1d3'],0,1,1,1668354,1,,,,1644
85b87d92219a10d458b78bdaab64cafae9d22b5a,0,Kishor Patil,2015-04-08 22:37:05+00:00,['5d6b62ba49609052426509d04ef8096b2c3dbd46'],9,21,30,1668384,2,1,1,1,1644
c7bee2b880db2df4c715ea926c0de14e4715026c,0,Robert (Bobby) Evans,2015-04-09 14:34:54-05:00,['c7b364eacd8e3b971775b67f7b2658d88e6c76a3'],3,2,5,1668389,2,,,,1644
641e18a837fe09f16146bd26d7ace95e91635df6,0,Parth Brahmbhatt,2015-04-09 15:37:07-07:00,"['e9ac047b0adea339e005aedf13c969474d27edcc', '337265749ed1263cc20feaab8950a39af0680008']",92,4,96,1668485,7,,,,1644
6b52e0d888651e7ee626a4ddc512c5dee0caa09a,0,Parth Brahmbhatt,2015-04-09 15:39:26-07:00,['641e18a837fe09f16146bd26d7ace95e91635df6'],0,1,1,1668486,1,,,,1644
f4e48e5b046b5853d2294061a31587c629458cee,0,Robert (Bobby) Evans,2015-04-10 09:27:41-05:00,['e2e7c8714a5651beed3b72db6c2186a458940a36'],7,14,21,1668507,4,,,,1644
abf2924e8a89d9b9fc28037a4ce079c607f62939,0,P. Taylor Goetz,2015-04-10 15:47:16-04:00,['9f5f822720544e356682d3c007c3407f5c2e5058'],1,2,3,1668510,1,,,,1644
f432abf523a54806e4b927f676b93575bdf687f2,0,P. Taylor Goetz,2015-04-10 15:47:39-04:00,['abf2924e8a89d9b9fc28037a4ce079c607f62939'],10,13,23,1668533,1,1,0,1,1644
e6d319d79e193bd64b5dba7011200e9876cdafa9,0,Matt Tieman,2015-04-11 17:34:37-04:00,['11194653f43ce0d4f65d0051270cd86f2191cbc5'],4,10,14,1668547,1,1,1,0,1644
9bfd834aaf344a63c1f010a40a7f1bce5a315d4f,0,Matt Tieman,2015-04-11 17:36:17-04:00,['e6d319d79e193bd64b5dba7011200e9876cdafa9'],2,1,3,1668550,1,,,,1644
ad4375e837004a0ec777a35f1cec1cdd89465e74,0,Robert (Bobby) Evans,2015-04-13 13:51:09-05:00,['6b52e0d888651e7ee626a4ddc512c5dee0caa09a'],104,4532,4636,1673186,16,0.578779276,0.690560681,0.983676366,1652
0bef615ad3dfb8ec7ec9f9940eba88964dfe7dec,0,Robert (Bobby) Evans,2015-04-13 16:03:02-05:00,"['6b52e0d888651e7ee626a4ddc512c5dee0caa09a', 'f4e48e5b046b5853d2294061a31587c629458cee']",12,14,26,1673212,3,,,,1652
5d26f715d8a1f731fa3586c10d46a3a24174f97b,0,Robert (Bobby) Evans,2015-04-13 16:10:01-05:00,['0bef615ad3dfb8ec7ec9f9940eba88964dfe7dec'],0,1,1,1673213,1,,,,1652
402f83dd8541e19dca8a375656104b96bf60fa4b,0,Robert (Bobby) Evans,2015-04-13 16:14:10-05:00,"['5d26f715d8a1f731fa3586c10d46a3a24174f97b', '0e9cccddeebacc42995da37bb03232867e704542']",5,131,136,1673349,10,,,,1652
2a45a9a5bdccf5332a9c4954436fbf04af4649d4,0,Robert (Bobby) Evans,2015-04-13 16:14:35-05:00,['402f83dd8541e19dca8a375656104b96bf60fa4b'],0,1,1,1673350,1,,,,1652
a1d7b3eb343f304565fe24fb7e0151bfbcb3824e,0,Jungtaek Lim,2015-04-14 07:16:37+09:00,['6b52e0d888651e7ee626a4ddc512c5dee0caa09a'],20,24,44,1673394,2,1,0,1,1652
84b5b0831d0089bdc85e08cd02f385e07d203c10,0,zhuol,2015-04-15 09:26:13-05:00,"['c106f1337f84cf7f46be0a133b3bd17b57412d3f', '2a45a9a5bdccf5332a9c4954436fbf04af4649d4']",118,161,279,1673673,22,,,,1652
7301d60348e1e3e2e6858d984a6981425482f046,0,zhuol,2015-04-15 09:28:00-05:00,['84b5b0831d0089bdc85e08cd02f385e07d203c10'],2,0,2,1673675,1,,,,1652
9c92d7f2e029053e1b2f459b9c6c2c425ecf008f,0,Robert (Bobby) Evans,2015-04-15 10:40:16-05:00,"['2a45a9a5bdccf5332a9c4954436fbf04af4649d4', 'ad4375e837004a0ec777a35f1cec1cdd89465e74']",104,4530,4634,1678309,16,,,,1652
a7c83108a77a2d04dfc0e43ade235b0db2921a29,0,Robert (Bobby) Evans,2015-04-15 14:09:30-05:00,['9c92d7f2e029053e1b2f459b9c6c2c425ecf008f'],0,1,1,1678310,1,,,,1652
a3602f2552a0c1f88f0323d27076df16a26d09a4,0,caofangkun,2015-04-16 14:52:15+08:00,"['503a04ba1f470ab3f1f6b32109d27a401a8a2510', 'a7c83108a77a2d04dfc0e43ade235b0db2921a29']",279,4801,5080,1683390,45,,,,1652
dfe3fbe144ed6398c2d2cc6210454d4c561e042e,1,Michael G. Noll,2015-04-16 11:44:40+02:00,['a7c83108a77a2d04dfc0e43ade235b0db2921a29'],0,28,28,1683418,2,0.923076923,1,1,1652
5af2e3c784e6dae97fb69521c06898c1be8e5d00,0,Kyle Nusbaum,2015-04-16 11:35:44-05:00,['a7c83108a77a2d04dfc0e43ade235b0db2921a29'],1,18,19,1683437,1,,,,1652
4b78204fe6dcf055d4be43b4a4539746103a0209,0,Derek Dagit,2015-04-16 15:01:22-05:00,['a7c83108a77a2d04dfc0e43ade235b0db2921a29'],1,1,2,1683439,1,,,,1652
174e1a05759ef3722670f7709311d58862bcf483,0,Dan Blanchard,2015-04-16 16:15:32-04:00,['a7c83108a77a2d04dfc0e43ade235b0db2921a29'],22,62,84,1683523,1,0.235294118,1,1,1652
933972abb47aa9b4ad87bc92d3ad7f79d21c9aee,0,Robert (Bobby) Evans,2015-04-16 15:58:37-05:00,['a7c83108a77a2d04dfc0e43ade235b0db2921a29'],2,10,12,1683535,2,,,,1652
14477f4412f4adfaf42367e8a697e1a17b7dfb8e,0,Jungtaek Lim,2015-04-17 14:09:39+09:00,['a7c83108a77a2d04dfc0e43ade235b0db2921a29'],2,4,6,1683541,1,,,,1652
61daca402224af61fe54dede684dd20081ba2f76,0,Dan Blanchard,2015-04-17 11:00:41-04:00,['174e1a05759ef3722670f7709311d58862bcf483'],4,9,13,1683554,1,0,1,1,1652
6bfcb2c888481555e9ae6fd93133b82117baa7b7,0,Robert (Bobby) Evans,2015-04-17 13:33:25-05:00,['a7c83108a77a2d04dfc0e43ade235b0db2921a29'],1,50,51,1683605,7,1,0.333333333,0,1654
f27b90f943e47ca03011de69bce1166d9f57ed3a,0,Sriharsha Chintalapani,2015-04-19 10:09:03-07:00,"['a7c83108a77a2d04dfc0e43ade235b0db2921a29', 'c5ba437aa9791deb4b5306fa3254fa3c267e7e67']",13,29,42,1683647,6,,,,1654
e910819c481ab0a1e9f6452ec87a43fea0e1fbcd,0,Sriharsha Chintalapani,2015-04-19 10:18:10-07:00,['f27b90f943e47ca03011de69bce1166d9f57ed3a'],0,1,1,1683648,1,,,,1654
c7575a2f7d0a2b4b0c985516b9d7cca2f8376e2a,0,Robert (Bobby) Evans,2015-04-20 08:46:14-05:00,"['e910819c481ab0a1e9f6452ec87a43fea0e1fbcd', '933972abb47aa9b4ad87bc92d3ad7f79d21c9aee']",2,10,12,1683660,2,,,,1654
2b41f60e7feb3703eac32d99f7235a3be83a6190,0,Robert (Bobby) Evans,2015-04-20 08:53:48-05:00,['c7575a2f7d0a2b4b0c985516b9d7cca2f8376e2a'],0,2,2,1683662,1,,,,1654
051c415fd44c949c510d61d241de047bc6f833af,0,Robert (Bobby) Evans,2015-04-20 11:13:02-05:00,"['2b41f60e7feb3703eac32d99f7235a3be83a6190', '4b78204fe6dcf055d4be43b4a4539746103a0209']",1,1,2,1683664,1,,,,1654
4bf195cc9b53ee85b0fbce679944f78bb477c15a,0,Robert (Bobby) Evans,2015-04-20 11:21:09-05:00,['051c415fd44c949c510d61d241de047bc6f833af'],0,1,1,1683665,1,,,,1654
77680a0e97a2b79044aad576becf33eab7d6f999,0,Robert (Bobby) Evans,2015-04-20 12:17:45-05:00,"['4bf195cc9b53ee85b0fbce679944f78bb477c15a', '6bfcb2c888481555e9ae6fd93133b82117baa7b7']",1,50,51,1683716,7,,,,1654
496bcf7d52d0de5b98beedc8e957c8f33180bb53,0,Robert (Bobby) Evans,2015-04-20 12:18:16-05:00,['77680a0e97a2b79044aad576becf33eab7d6f999'],0,1,1,1683717,1,,,,1654
7466073c758f27721327055bde39e8a8b6e22d7e,0,Dan Blanchard,2015-04-20 15:52:43-04:00,['61daca402224af61fe54dede684dd20081ba2f76'],28,29,57,1683774,1,1,1,1,1654
ec1a8d3c804bf9edaf905e25ba9d88542a559cc7,0,mjsax,2015-04-20 22:16:30+02:00,['496bcf7d52d0de5b98beedc8e957c8f33180bb53'],1,25,26,1683800,3,,,,1654
0ae3c08a9855fe4b3b9dd4f7278fbc49fb558834,1,Dan Blanchard,2015-04-20 16:33:51-04:00,['7466073c758f27721327055bde39e8a8b6e22d7e'],16,47,63,1683863,1,,,,1654
9220e1b3287480080563d91297c9cc2c6358a1fe,0,Robert (Bobby) Evans,2015-04-20 16:32:14-05:00,"['496bcf7d52d0de5b98beedc8e957c8f33180bb53', 'dfe3fbe144ed6398c2d2cc6210454d4c561e042e']",0,28,28,1683891,2,,,,1654
84e8bc6d28b54056dd75375be7d316ab03125fb6,0,Robert (Bobby) Evans,2015-04-20 16:38:34-05:00,['9220e1b3287480080563d91297c9cc2c6358a1fe'],0,1,1,1683892,1,,,,1654
6ac7d2dc72992ea14df8d789a1e6b41cc621a27a,1,imadityab,2015-04-21 01:48:58-04:00,['84e8bc6d28b54056dd75375be7d316ab03125fb6'],1,1,2,1683894,1,,,,1654
bb8583aca92fc563e0bd750d2783be59ff507173,0,caofangkun,2015-04-21 14:27:13+08:00,"['a3602f2552a0c1f88f0323d27076df16a26d09a4', '84e8bc6d28b54056dd75375be7d316ab03125fb6']",17,124,141,1684035,19,,,,1654
878dbc998f4717023cc84f3df313baa1b9df78a7,0,sanket,2015-04-21 09:48:38-05:00,['84e8bc6d28b54056dd75375be7d316ab03125fb6'],55,313,368,1684403,48,0.165,0.265,0.98,1654
2d5911b8c05fb12079f011d0f5319423393a4751,0,sanket,2015-04-21 09:48:38-05:00,['878dbc998f4717023cc84f3df313baa1b9df78a7'],2,1,3,1684406,2,,,,1654
879cd658747bd5f761ad27aa3337dce2acc15de8,0,sanket,2015-04-21 09:53:36-05:00,['2d5911b8c05fb12079f011d0f5319423393a4751'],37,36,73,1684479,36,,,,1654
6f5d8a406d60fe5ddfedcef1e2e5c0511edc4be7,1,sanket,2015-04-21 09:53:36-05:00,['879cd658747bd5f761ad27aa3337dce2acc15de8'],32,44,76,1684555,5,0,1,1,1654
7bd56ae99c3c156f37ec419a24390bf472358bf8,0,sanket,2015-04-21 09:54:55-05:00,['6f5d8a406d60fe5ddfedcef1e2e5c0511edc4be7'],3,2,5,1684560,1,,,,1654
964bc189d4bb975c4a27147e4803c4fbd66aa410,0,Michael G. Noll,2015-04-22 16:46:16+02:00,['84e8bc6d28b54056dd75375be7d316ab03125fb6'],18,28,46,1684606,1,,,,1654
95e15c12be10b6509a4f106b05600772164959fa,0,Michael G. Noll,2015-04-22 16:50:38+02:00,['964bc189d4bb975c4a27147e4803c4fbd66aa410'],3,6,9,1684615,1,,,,1654
50db5a5e814cee998e23c6eced8e7358cf20beef,0,Michael G. Noll,2015-04-22 16:51:55+02:00,['95e15c12be10b6509a4f106b05600772164959fa'],1,1,2,1684617,1,,,,1654
eb4d0f1174d4e9f60862c2fc8701972e11f2bab7,0,Michael G. Noll,2015-04-22 16:53:52+02:00,['50db5a5e814cee998e23c6eced8e7358cf20beef'],1,1,2,1684619,1,,,,1654
849315b495c3dce44f2fca584bb47db69890cf48,0,Kishor Patil,2015-04-22 18:27:08+00:00,['85b87d92219a10d458b78bdaab64cafae9d22b5a'],3,3,6,1684625,2,0,0,,1654
23ada76aada272165c15af4dd41a54260bd4d648,0,Robert (Bobby) Evans,2015-04-22 13:46:10-05:00,"['eb4d0f1174d4e9f60862c2fc8701972e11f2bab7', '6ac7d2dc72992ea14df8d789a1e6b41cc621a27a']",1,1,2,1684627,1,,,,1654
7c3f7816f9438ce914038327050a202876d413e5,0,Robert (Bobby) Evans,2015-04-22 13:49:25-05:00,"['23ada76aada272165c15af4dd41a54260bd4d648', '7bd56ae99c3c156f37ec419a24390bf472358bf8']",21,288,309,1684936,13,,,,1654
faf9492752e9627cc15d441fa9ace1486400f406,0,Robert (Bobby) Evans,2015-04-22 13:56:47-05:00,['7c3f7816f9438ce914038327050a202876d413e5'],0,1,1,1684937,1,,,,1654
1a9b26cf564e508a8d65eda33b5ec642e23b3082,0,Robert (Bobby) Evans,2015-04-22 15:12:22-05:00,"['faf9492752e9627cc15d441fa9ace1486400f406', 'ec1a8d3c804bf9edaf905e25ba9d88542a559cc7']",1,25,26,1684963,3,,,,1654
b15f462cfacedb681281d6d50d2bda27f9ccf44f,0,Robert (Bobby) Evans,2015-04-22 15:12:58-05:00,['1a9b26cf564e508a8d65eda33b5ec642e23b3082'],0,1,1,1684964,1,,,,1654
b5661e2fd6285785d2419e75c604b50f328d2d0a,0,Robert (Bobby) Evans,2015-04-22 15:20:32-05:00,"['b15f462cfacedb681281d6d50d2bda27f9ccf44f', '0ae3c08a9855fe4b3b9dd4f7278fbc49fb558834']",45,122,167,1685131,2,,,,1654
fea914c86ffd8b21a088bb5a9c477da94f77897d,0,Robert (Bobby) Evans,2015-04-22 15:21:25-05:00,['b5661e2fd6285785d2419e75c604b50f328d2d0a'],0,1,1,1685132,1,,,,1654
665c0610eeac20decfc00db78a29b348b2daff6d,0,Robert (Bobby) Evans,2015-04-22 15:33:02-05:00,"['fea914c86ffd8b21a088bb5a9c477da94f77897d', '5af2e3c784e6dae97fb69521c06898c1be8e5d00']",1,18,19,1685151,1,,,,1654
5a19c6843501f597d5ddb6d77c4abf4188ec86bd,0,Robert (Bobby) Evans,2015-04-22 15:33:33-05:00,['665c0610eeac20decfc00db78a29b348b2daff6d'],0,1,1,1685152,1,,,,1654
c75489dddf484e13570ef25e71c59a346007aaf2,0,Robert (Bobby) Evans,2015-04-22 15:36:39-05:00,"['5a19c6843501f597d5ddb6d77c4abf4188ec86bd', 'c7bee2b880db2df4c715ea926c0de14e4715026c']",1,225,226,1685378,5,,,,1654
db1f470226423bde40cd1d6484b0f73a17161afc,0,Robert (Bobby) Evans,2015-04-22 15:37:05-05:00,['c75489dddf484e13570ef25e71c59a346007aaf2'],0,1,1,1685379,1,,,,1654
654eae94188e3c7942aa6c3a7dea1581c7cda843,0,Robert (Bobby) Evans,2015-04-22 15:46:03-05:00,"['db1f470226423bde40cd1d6484b0f73a17161afc', '7301d60348e1e3e2e6858d984a6981425482f046']",8,54,62,1685441,4,,,,1654
72b80f9302b35bf734a1fb5e219e42bc29274cce,0,Robert (Bobby) Evans,2015-04-22 15:47:08-05:00,['654eae94188e3c7942aa6c3a7dea1581c7cda843'],0,1,1,1685442,1,,,,1654
669d32828e7ccccacc654e3f08bbb63d57a756fc,0,Robert (Bobby) Evans,2015-04-22 16:01:52-05:00,"['72b80f9302b35bf734a1fb5e219e42bc29274cce', '24fe1f55b4b3b0ebd093b1d4a595def896412873']",1764,183,1947,1687389,17,,,,1654
4f4f2c48d068b0f115ed635030eefe15baf897ef,0,Robert (Bobby) Evans,2015-04-22 16:28:19-05:00,"['669d32828e7ccccacc654e3f08bbb63d57a756fc', 'dd27ee47346fa417e6acb0cd68b9023d2d6dfe5a']",1,2,3,1687392,1,,,,1654
01969d8dda09ad4cef248fcf302e97ca507e6fb6,0,Robert (Bobby) Evans,2015-04-22 16:28:47-05:00,['4f4f2c48d068b0f115ed635030eefe15baf897ef'],0,1,1,1687393,1,,,,1654
700c8ed166623d54d5dfa1aa57fc50ae522aaf93,0,Jungtaek Lim,2015-04-23 08:42:35+09:00,['14477f4412f4adfaf42367e8a697e1a17b7dfb8e'],1,1,2,1687395,1,,,,1654
e0aa79f8b26b40caf19cc5a663d8eb9cc9368b5e,0,Robert (Bobby) Evans,2015-04-23 11:17:46-05:00,"['01969d8dda09ad4cef248fcf302e97ca507e6fb6', 'eabc85b67f795bf4ef77218208d39825a9dabc5d']",1,4,5,1687400,1,,,,1654
3eff6fac8a9a0694a890f4610e17ee00dd410175,0,Robert (Bobby) Evans,2015-04-23 11:35:23-05:00,['e0aa79f8b26b40caf19cc5a663d8eb9cc9368b5e'],0,1,1,1687401,1,,,,1654
edb32896800c79e6860e296d8a5dcfe90bdd9f9c,0,Robert (Bobby) Evans,2015-04-23 13:55:54-05:00,"['3eff6fac8a9a0694a890f4610e17ee00dd410175', 'a37397e5a16c682e70ffe77b272577db7391eb41']",11,8,19,1687420,3,,,,1654
1c0200a643891f9387b6bfb39e5fcf7e00d1de7e,0,Robert (Bobby) Evans,2015-04-23 13:56:21-05:00,['edb32896800c79e6860e296d8a5dcfe90bdd9f9c'],0,1,1,1687421,1,,,,1654
fdd26964d73f634d28e6b704677598aa31d62093,0,Robert (Bobby) Evans,2015-04-23 14:13:32-05:00,"['1c0200a643891f9387b6bfb39e5fcf7e00d1de7e', 'cc56d7745e19a46eecf090e643a126d8e07523a2']",1,1,2,1687423,1,,,,1654
37a7e8bb05100b0be0b4c79f09b354b2b91c1b6a,0,Robert (Bobby) Evans,2015-04-23 14:13:57-05:00,['fdd26964d73f634d28e6b704677598aa31d62093'],0,1,1,1687424,1,,,,1654
2c35cb4dec67604185d3b443a3e04a66fd4a6a6d,0,Andrew Montalenti,2015-04-23 16:41:39-04:00,['2a45a9a5bdccf5332a9c4954436fbf04af4649d4'],0,6,6,1687430,1,0.6,0.6,1,1654
0cac820f5dc6ed1ec900f1f452167beeaa031fe2,0,Robert (Bobby) Evans,2015-04-23 15:58:42-05:00,"['37a7e8bb05100b0be0b4c79f09b354b2b91c1b6a', '849315b495c3dce44f2fca584bb47db69890cf48']",7,121,128,1687558,10,,,,1654
b4351ede1a89b83888e9e3ace55227e5ae69c78b,0,Robert (Bobby) Evans,2015-04-23 15:59:11-05:00,['0cac820f5dc6ed1ec900f1f452167beeaa031fe2'],0,1,1,1687559,1,,,,1654
e109e5ad5702a4f12abe4b4158060f4a7f44d6e8,0,Jungtaek Lim,2015-04-24 06:00:09+09:00,['db813c7781c4359229ddee58bbe40dc763ec0eab'],2,0,2,1687561,1,,,,1654
517342b5ad0403e2c291dbb6fb6f70f65a054a3d,0,Jungtaek Lim,2015-04-24 06:02:19+09:00,['e109e5ad5702a4f12abe4b4158060f4a7f44d6e8'],3,4,7,1687568,1,,,,1654
ea6099458d3b79a503178bbc08d2022e00b602a6,0,Jungtaek Lim,2015-04-24 06:58:52+09:00,"['517342b5ad0403e2c291dbb6fb6f70f65a054a3d', '37a7e8bb05100b0be0b4c79f09b354b2b91c1b6a']",2297,6220,8517,1696085,105,,,,1654
c84f20514e81cfdd3c48b5cf89dfe6a9c4d328bb,0,Mark Davis,2015-04-24 07:48:50+01:00,['37a7e8bb05100b0be0b4c79f09b354b2b91c1b6a'],2,2,4,1696089,1,,,,1654
eff6cfa4d9bc6d991fb4e94be72040415f676187,1,P. Taylor Goetz,2015-04-24 15:50:19-04:00,['b4351ede1a89b83888e9e3ace55227e5ae69c78b'],0,4545,4545,1700634,62,0.665513264,0.866782007,0.806228374,1716
38638474ef6b045f9e61942b2fd882a8ed4ed8e9,0,P. Taylor Goetz,2015-04-24 16:29:04-04:00,['eff6cfa4d9bc6d991fb4e94be72040415f676187'],4,31,35,1700669,5,,,,1716
a315e1fe4542b3fa08fbe77bd38ffa79f1b35361,1,Jungtaek Lim,2015-04-25 08:19:00+09:00,['ea6099458d3b79a503178bbc08d2022e00b602a6'],6,32,38,1700707,3,1,1,1,1716
6f62a4e61e1f6d3f2d41d068b78b8e859c751338,0,Jungtaek Lim,2015-04-25 23:50:46+09:00,['700c8ed166623d54d5dfa1aa57fc50ae522aaf93'],1,1,2,1700709,1,,,,1716
0cbc89c19bf0d00850d24ea87d8cd04b30516cbe,0,Sriharsha Chintalapani,2015-04-26 10:32:17-07:00,['38638474ef6b045f9e61942b2fd882a8ed4ed8e9'],0,0,0,1700709,1,,,,1716
20d5476bdb769090230c375098d4fa8772b93d1c,0,Sriharsha Chintalapani,2015-04-26 10:33:27-07:00,"['0cbc89c19bf0d00850d24ea87d8cd04b30516cbe', '00be569c799a955d7f82a7270fbf37a6178629fd']",20,219,239,1700948,5,,,,1716
168fa2f813c4a37784f4cc28c10297eb666d05c9,0,Sriharsha Chintalapani,2015-04-26 10:39:36-07:00,['20d5476bdb769090230c375098d4fa8772b93d1c'],0,1,1,1700949,1,,,,1716
a889f732fa999af97fc74a6d8c469487d4c5f0c8,0,zhuol,2015-04-27 10:00:03-05:00,['168fa2f813c4a37784f4cc28c10297eb666d05c9'],1,4,5,1700954,1,,,,1716
e7d863c09e358c2c75b6d36e8976e6dab5f348f1,0,zhuol,2015-04-27 10:35:06-05:00,['a889f732fa999af97fc74a6d8c469487d4c5f0c8'],1,1,2,1700956,1,,,,1716
31babca137255658934313f2b0117ddccf04e3c8,1,zhuol,2015-04-27 11:05:32-05:00,['e7d863c09e358c2c75b6d36e8976e6dab5f348f1'],1,3,4,1700960,1,,,,1716
85db67e659c3a65cbe0209b4fef282b7f5c2a28e,1,Robert (Bobby) Evans,2015-04-27 17:29:26+00:00,['168fa2f813c4a37784f4cc28c10297eb666d05c9'],16,22,38,1700998,1,0,1,1,1716
fbab1c676011ff7c5c024721c8487264e5ce4465,0,Robert (Bobby) Evans,2015-04-27 12:43:47-05:00,"['168fa2f813c4a37784f4cc28c10297eb666d05c9', 'a315e1fe4542b3fa08fbe77bd38ffa79f1b35361']",0,144,144,1701142,5,,,,1716
7712102381aae329f352e86bcb1cd13bb0598b24,0,Robert (Bobby) Evans,2015-04-27 12:54:55-05:00,['fbab1c676011ff7c5c024721c8487264e5ce4465'],0,1,1,1701143,1,,,,1716
88433d6c7539c71313a68fce678909de7ea4f79c,0,Robert (Bobby) Evans,2015-04-27 18:03:03+00:00,"['85db67e659c3a65cbe0209b4fef282b7f5c2a28e', '7712102381aae329f352e86bcb1cd13bb0598b24']",0,145,145,1701288,6,,,,1716
3a8b0176495ad7b3defcfdda830e288cbbd15c8b,0,Kyle Nusbaum,2015-04-27 13:25:00-05:00,['168fa2f813c4a37784f4cc28c10297eb666d05c9'],0,2,2,1701290,1,,,,1716
03531fd1f248b0213aba924b5e404b12a4c5c2fd,0,Kyle Nusbaum,2015-04-27 13:29:33-05:00,['3a8b0176495ad7b3defcfdda830e288cbbd15c8b'],1,1,2,1701292,1,,,,1716
8696317ba1f3ac19befd53ff6d892282948596e8,0,caofangkun,2015-04-28 15:33:25+08:00,"['bb8583aca92fc563e0bd750d2783be59ff507173', '7712102381aae329f352e86bcb1cd13bb0598b24']",1902,6032,7934,1709226,128,,,,1716
f0130919c7326744ae3297d869dfa38471d9e4e2,0,Robert (Bobby) Evans,2015-04-28 11:16:59-05:00,"['7712102381aae329f352e86bcb1cd13bb0598b24', '88433d6c7539c71313a68fce678909de7ea4f79c']",16,22,38,1709264,1,,,,1716
76d3aec449e0ec52620fe5159e62850bce01d9c6,0,Robert (Bobby) Evans,2015-04-28 11:17:24-05:00,['f0130919c7326744ae3297d869dfa38471d9e4e2'],0,1,1,1709265,1,,,,1716
e65fcc07066b7bc7a64596b30178ee35a7689d30,0,Robert (Bobby) Evans,2015-04-28 14:16:15-05:00,"['76d3aec449e0ec52620fe5159e62850bce01d9c6', '03531fd1f248b0213aba924b5e404b12a4c5c2fd']",0,2,2,1709267,1,,,,1716
7985725ef8961fce60e88414ac59c68f37cf98b0,0,Robert (Bobby) Evans,2015-04-28 14:16:44-05:00,['e65fcc07066b7bc7a64596b30178ee35a7689d30'],0,1,1,1709268,1,,,,1716
600e5b7c9164e60390a24097b71579d659b1cc54,0,Robert (Bobby) Evans,2015-04-28 15:22:43-05:00,"['7985725ef8961fce60e88414ac59c68f37cf98b0', 'c84f20514e81cfdd3c48b5cf89dfe6a9c4d328bb']",2,2,4,1709272,1,,,,1716
fb797d9192a12042a1f6ac96891713e99c9ba10b,0,Robert (Bobby) Evans,2015-04-28 15:26:53-05:00,['600e5b7c9164e60390a24097b71579d659b1cc54'],0,1,1,1709273,1,,,,1716
2a58721050c21906ef03ef84d6b56187197f3f77,0,Robert (Bobby) Evans,2015-04-28 15:29:04-05:00,"['fb797d9192a12042a1f6ac96891713e99c9ba10b', '31babca137255658934313f2b0117ddccf04e3c8']",1,6,7,1709280,1,,,,1716
a171149f7134350cecbbe3a0d2f782a1b4988f39,0,Robert (Bobby) Evans,2015-04-28 15:30:18-05:00,['2a58721050c21906ef03ef84d6b56187197f3f77'],0,2,2,1709282,2,,,,1716
72dede969b301781addb30c9454bbcb005fa6d26,0,Kyle Nusbaum,2015-04-28 15:48:38-05:00,['a171149f7134350cecbbe3a0d2f782a1b4988f39'],1,1,2,1709284,1,,,,1716
bfe9569517be7643aab7d27e106f2ff0bcc78f4b,0,Robert (Bobby) Evans,2015-04-28 15:52:45-05:00,"['72dede969b301781addb30c9454bbcb005fa6d26', 'e6f509f82c30eaed5f2b3a6db5340d1438020adc']",24,111,135,1709419,3,,,,1716
44e9aaf57cec7ca7918d4f9a044cbcd84326d6af,0,Robert (Bobby) Evans,2015-04-28 15:59:57-05:00,['bfe9569517be7643aab7d27e106f2ff0bcc78f4b'],0,1,1,1709420,1,,,,1716
232e4ace33f4424031eef64fa64abd20c9735f9d,0,caofangkun,2015-04-29 08:53:32+08:00,"['8696317ba1f3ac19befd53ff6d892282948596e8', '44e9aaf57cec7ca7918d4f9a044cbcd84326d6af']",43,149,192,1709612,8,,,,1716
f2067b64fa4bb9bda8ec8647aa25d80560c3821a,0,caofangkun,2015-04-29 08:53:11+08:00,"['986ad60bf065c8c3dd965b5c2cfd33d71229385b', '232e4ace33f4424031eef64fa64abd20c9735f9d']",16081,60170,76251,1785863,498,,,,1716
42bcf300e1adfe16ba35a4727a7ae12723a25ca8,1,caofangkun,2015-04-29 09:01:44+08:00,['f2067b64fa4bb9bda8ec8647aa25d80560c3821a'],1,1,2,1785865,1,,,,1716
7ab8b965ff27de917e6338f5b054946240d21c93,1,caofangkun,2015-04-29 09:59:43+08:00,['42bcf300e1adfe16ba35a4727a7ae12723a25ca8'],2,4,6,1785871,2,,,,1716
2b839cb4b29e13029e72c582ff96e7dd873680a6,0,caofangkun,2015-04-29 10:00:18+08:00,['7ab8b965ff27de917e6338f5b054946240d21c93'],2,0,2,1785873,1,,,,1716
9a43ad611bc1c27cf977f18d9953ff9505c6f1e4,0,xiajun,2015-04-29 21:11:08+08:00,['44e9aaf57cec7ca7918d4f9a044cbcd84326d6af'],1,1,2,1785875,1,,,,1716
546abe4308dac2ed29f9e41d9f81ecba461cbb2e,0,xiajun,2015-04-30 10:37:44+08:00,['9a43ad611bc1c27cf977f18d9953ff9505c6f1e4'],0,1,1,1785876,1,1,1,1,1716
95a10557ca9eed5f193841e0a72b5032b627aceb,0,Curtis Allen,2015-04-30 13:13:24-06:00,['326cc1c796d073c768de4b5aced1669bd47c6891'],17,19,36,1785912,2,0,1,0,1716
ca3f7629af93c9d173cc00ab5f3dd5351fb3c669,0,Robert (Bobby) Evans,2015-05-01 09:39:45-05:00,['44e9aaf57cec7ca7918d4f9a044cbcd84326d6af'],1,1,2,1785914,1,,,,1716
93f11c46a219dbaa210a994ded34ed37b0ec8c14,0,Robert (Bobby) Evans,2015-05-04 13:52:28-05:00,"['44e9aaf57cec7ca7918d4f9a044cbcd84326d6af', '95a10557ca9eed5f193841e0a72b5032b627aceb']",0,39,39,1785953,2,,,,1716
ea0fe124c943c6e2bab889c537bd13188df50107,0,Robert (Bobby) Evans,2015-05-04 14:18:33-05:00,['93f11c46a219dbaa210a994ded34ed37b0ec8c14'],0,1,1,1785954,1,,,,1716
f21cd844b7e86258a8560e31fb36dab029b3d4ba,0,Robert (Bobby) Evans,2015-05-04 16:20:30-05:00,['ea0fe124c943c6e2bab889c537bd13188df50107'],3,6,9,1785963,1,0,1,1,1716
998383ffe58834c52ab7ecdda668681177131cd4,0,Robert (Bobby) Evans,2015-05-05 09:02:53-05:00,['ea0fe124c943c6e2bab889c537bd13188df50107'],1,19,20,1785983,2,1,1,1,1716
323fea238bbc6e1250cfe9003d308759a6763f41,0,Robert (Bobby) Evans,2015-05-05 09:34:06-05:00,['998383ffe58834c52ab7ecdda668681177131cd4'],4,4,8,1785991,1,,,,1716
b5ace2227f403aed732374e99d3a93e9f48a5e98,0,Robert (Bobby) Evans,2015-05-05 10:17:46-05:00,['323fea238bbc6e1250cfe9003d308759a6763f41'],0,14,14,1786005,1,,,,1716
601cee72aba6d9130bd02a08617f973e14c61eea,0,P. Taylor Goetz,2015-05-05 15:39:25-04:00,['f432abf523a54806e4b927f676b93575bdf687f2'],1,33,34,1786039,2,,,,1716
c48f63e3f361e9416669d4d791de3b3a67c461d0,0,P. Taylor Goetz,2015-05-05 15:56:47-04:00,['601cee72aba6d9130bd02a08617f973e14c61eea'],2,11,13,1786052,2,,,,1716
01a66bf5b17a9fce94fcdac4fbaa2f28c2df9189,0,P. Taylor Goetz,2015-05-05 16:14:33-04:00,['c48f63e3f361e9416669d4d791de3b3a67c461d0'],138,119,257,1786309,8,0.314285714,0,0.3,1716
8e0f167adf3155f55a7c24875e5e7542615e0c5a,0,P. Taylor Goetz,2015-05-05 16:52:03-04:00,['01a66bf5b17a9fce94fcdac4fbaa2f28c2df9189'],3,3,6,1786315,1,,,,1716
20a30116935eb3bcc4a255c1617bcb8e50331c5e,0,P. Taylor Goetz,2015-05-05 16:54:01-04:00,['8e0f167adf3155f55a7c24875e5e7542615e0c5a'],10,7,17,1786332,4,,,,1716
b372a1198f2227ccc2951b1f5ffccd21a98b589b,0,P. Taylor Goetz,2015-05-05 16:54:05-04:00,['20a30116935eb3bcc4a255c1617bcb8e50331c5e'],4,4,8,1786340,4,,,,1716
0380a42f7ddaf48ce17eabb67ec18a27cd258f69,0,xiajun,2015-05-06 16:19:44+08:00,['ea0fe124c943c6e2bab889c537bd13188df50107'],0,1,1,1786341,1,1,1,1,1716
b21a98dd87f82a06a6295ab2bfd832c2810ca57e,0,P. Taylor Goetz,2015-05-06 13:31:04-04:00,"['ea0fe124c943c6e2bab889c537bd13188df50107', 'b372a1198f2227ccc2951b1f5ffccd21a98b589b']",0,6621,6621,1792962,70,,,,1716
2094a08ea6ccdf81126c103930d9ec3e77fcd5c1,0,P. Taylor Goetz,2015-05-06 14:13:13-04:00,['b21a98dd87f82a06a6295ab2bfd832c2810ca57e'],794,41,835,1793797,10,0.13592233,0.084951456,0.11407767,1716
e1e1609dd3642b820fe6f514b25454dedd446836,0,P. Taylor Goetz,2015-05-06 14:30:38-04:00,['2094a08ea6ccdf81126c103930d9ec3e77fcd5c1'],0,44,44,1793841,1,,,,1716
e40a0fe1b7d52b5f8ad2b9b08d9884dba4829d13,0,Robert (Bobby) Evans,2015-05-06 16:17:08-05:00,['ea0fe124c943c6e2bab889c537bd13188df50107'],0,21,21,1793862,1,,,,1716
f7d2f7fa0c7a0511911e984f13c20fceed743b17,0,P. Taylor Goetz,2015-05-07 10:33:44-04:00,['e1e1609dd3642b820fe6f514b25454dedd446836'],13,11,24,1793886,4,,,,1716
171a8e66ae7332094df7c5ce36197d61f860fd92,0,P. Taylor Goetz,2015-05-07 11:22:37-04:00,"['ea0fe124c943c6e2bab889c537bd13188df50107', 'ad0d0d32dbfe06f8b7a40ba7205dddcfe0099a7b']",2,2,4,1793890,1,,,,1716
ce49e1618151c1846fd2e9b2c0b50c0499fde5f1,0,P. Taylor Goetz,2015-05-07 11:29:19-04:00,['171a8e66ae7332094df7c5ce36197d61f860fd92'],0,1,1,1793891,1,,,,1716
4d26d1c2c78f48d89cdd528952fc097b9ab74b22,0,P. Taylor Goetz,2015-05-07 11:57:36-04:00,"['ce49e1618151c1846fd2e9b2c0b50c0499fde5f1', '2c35cb4dec67604185d3b443a3e04a66fd4a6a6d']",0,6,6,1793897,1,,,,1716
60f8a8003fefaad8fe2961be671298eb688486e9,0,P. Taylor Goetz,2015-05-07 12:05:03-04:00,['4d26d1c2c78f48d89cdd528952fc097b9ab74b22'],0,1,1,1793898,1,,,,1716
f15c3e3751b2751dc8091488c62928558d5cb9cc,0,Robert (Bobby) Evans,2015-05-07 14:45:06-05:00,"['60f8a8003fefaad8fe2961be671298eb688486e9', 'ca3f7629af93c9d173cc00ab5f3dd5351fb3c669']",1,1,2,1793900,1,,,,1716
847958cad438766cb7f39ce649fe7a3506b61b3a,0,Robert (Bobby) Evans,2015-05-07 14:45:37-05:00,['f15c3e3751b2751dc8091488c62928558d5cb9cc'],0,1,1,1793901,1,,,,1716
9fad816fd5840d5ad7d2727db4c7dafe4f1355ba,0,P. Taylor Goetz,2015-05-08 15:23:54-04:00,['f7d2f7fa0c7a0511911e984f13c20fceed743b17'],0,117,117,1794018,2,1,1,1,1718
8c9e6ceeafc1f50eebc519c8f03d5821813ee99b,0,P. Taylor Goetz,2015-05-08 15:35:11-04:00,['9fad816fd5840d5ad7d2727db4c7dafe4f1355ba'],2,20,22,1794040,2,,,,1718
91369ac2f15d4a2dade5d03ee2d0970d99e4d0bd,0,P. Taylor Goetz,2015-05-08 15:43:00-04:00,['8c9e6ceeafc1f50eebc519c8f03d5821813ee99b'],1,1,2,1794042,1,,,,1718
a448be54543783225671eb7578b872c75645fe3e,0,Jungtaek Lim,2015-05-11 23:21:23+09:00,['847958cad438766cb7f39ce649fe7a3506b61b3a'],3,5,8,1794050,1,,,,1718
e823c058742a19e97c7bf71259e94e6f333ec347,1,Kyle Nusbaum,2015-05-12 16:55:08-05:00,['847958cad438766cb7f39ce649fe7a3506b61b3a'],1,1,2,1794052,1,,,,1718
e515492864092c16c2ecc86577a3be73ec79fa56,1,Shanyu Zhao,2015-05-13 12:26:53-07:00,['847958cad438766cb7f39ce649fe7a3506b61b3a'],481,750,1231,1795283,14,0.776119403,0.97761194,0.5,1721
85af195049fd1229acc62a1b8638415c06b6cf9d,0,Jungtaek Lim,2015-05-14 06:21:32+09:00,['a1d7b3eb343f304565fe24fb7e0151bfbcb3824e'],17,36,53,1795336,1,1,1,0.266666667,1721
52bd47b31505db9352e299178c85e990c3f10235,0,Jungtaek Lim,2015-05-14 06:43:28+09:00,"['85af195049fd1229acc62a1b8638415c06b6cf9d', '847958cad438766cb7f39ce649fe7a3506b61b3a']",2073,11022,13095,1808431,172,,,,1721
1f13f15d0c0de233fd4cc4ff6d6de586c4736142,0,Shanyu Zhao,2015-05-13 14:50:02-07:00,['e515492864092c16c2ecc86577a3be73ec79fa56'],647,647,1294,1809725,8,,,,1721
d66444ced195e1546cfcfb188d3146974d42fd78,0,Derek Dagit,2015-05-15 14:30:13-05:00,['847958cad438766cb7f39ce649fe7a3506b61b3a'],2,0,2,1809727,2,,,,1721
512d3def033e2a66ce8f2c8a401c7cef99cbedea,0,Derek Dagit,2015-05-15 14:30:34-05:00,['d66444ced195e1546cfcfb188d3146974d42fd78'],3,3,6,1809733,2,,,,1721
85aeb3d48efcaa28d6fc5dbfe6ce87af9f3e2615,0,Shanyu Zhao,2015-05-17 01:14:01-07:00,['1f13f15d0c0de233fd4cc4ff6d6de586c4736142'],951,56,1007,1810740,23,0.359493671,0.098734177,0.113924051,1721
33d7747e0f0df86f5d1c932f8e3e82279de9a23d,0,Robert (Bobby) Evans,2015-05-19 15:42:34-05:00,['512d3def033e2a66ce8f2c8a401c7cef99cbedea'],1,4,5,1810745,1,0,0,1,1721
85c5096e0806ac872739d8b73574a8f1e5d31679,0,Jungtaek Lim,2015-05-21 06:30:23+09:00,['52bd47b31505db9352e299178c85e990c3f10235'],13,11,24,1810769,2,0,1,0,1721
031b77c4568ad7efc776e84533080c02d7069fdf,0,Kishor Patil,2015-05-21 00:46:28+00:00,['512d3def033e2a66ce8f2c8a401c7cef99cbedea'],10,43,53,1810822,8,,,,1723
07722ffa819692ce7e5dc06905241533bf953379,0,Kishor Patil,2015-05-21 14:45:12+00:00,['031b77c4568ad7efc776e84533080c02d7069fdf'],3,2,5,1810827,2,,,,1723
a16b50c961a1272315dcc3340ae369c516e25235,1,Derek Dagit,2015-05-21 11:24:13-05:00,['512d3def033e2a66ce8f2c8a401c7cef99cbedea'],1429,19589,21018,1831845,36,0.344964896,0.396835377,0.975269831,1733
c52690ab5430910da07b56630d91e7d2bbeed13c,0,Robert (Bobby) Evans,2015-05-22 14:01:45-05:00,"['512d3def033e2a66ce8f2c8a401c7cef99cbedea', 'e40a0fe1b7d52b5f8ad2b9b08d9884dba4829d13']",0,21,21,1831866,1,,,,1733
5ee4bcf16dca46b602f6c743898fa91f43c34fc9,0,Robert (Bobby) Evans,2015-05-22 14:09:21-05:00,['c52690ab5430910da07b56630d91e7d2bbeed13c'],0,1,1,1831867,1,,,,1733
7c95a4f5dc8ad6ad3685e8fc56009bf40d7b8de7,0,Robert (Bobby) Evans,2015-05-22 14:13:54-05:00,"['5ee4bcf16dca46b602f6c743898fa91f43c34fc9', '33d7747e0f0df86f5d1c932f8e3e82279de9a23d']",1,4,5,1831872,1,,,,1733
d2e2d58153a19b35666c39035e445887ce032e6c,0,Robert (Bobby) Evans,2015-05-22 14:20:47-05:00,['7c95a4f5dc8ad6ad3685e8fc56009bf40d7b8de7'],0,1,1,1831873,1,,,,1733
73b6437bff9989d6fdd479b74f07737f2e23b116,0,Robert (Bobby) Evans,2015-05-22 14:25:04-05:00,"['d2e2d58153a19b35666c39035e445887ce032e6c', 'e823c058742a19e97c7bf71259e94e6f333ec347']",1,1,2,1831875,1,,,,1733
f454247dd318708b229ef133672ee06984b5675a,0,Robert (Bobby) Evans,2015-05-22 14:34:11-05:00,['73b6437bff9989d6fdd479b74f07737f2e23b116'],0,1,1,1831876,1,,,,1733
ce3cabf8f8a823ab6da057d8bb6f86c9097a869e,0,Robert (Bobby) Evans,2015-05-22 14:36:35-05:00,"['f454247dd318708b229ef133672ee06984b5675a', 'f21cd844b7e86258a8560e31fb36dab029b3d4ba']",3,6,9,1831885,1,,,,1733
972ab855924730ea4666ebad297baa7f09beb07d,0,Robert (Bobby) Evans,2015-05-22 14:43:29-05:00,['ce3cabf8f8a823ab6da057d8bb6f86c9097a869e'],0,1,1,1831886,1,,,,1733
77bc461da9ae8131026b3cc43c091572f80ffb2e,0,Robert (Bobby) Evans,2015-05-22 14:46:03-05:00,"['972ab855924730ea4666ebad297baa7f09beb07d', '2b839cb4b29e13029e72c582ff96e7dd873680a6']",16,6,22,1831908,4,,,,1733
b3abf05f02305260cdcbf081a8fe7d7db4b03ce7,0,Derek Dagit,2015-05-22 14:49:00-05:00,['a16b50c961a1272315dcc3340ae369c516e25235'],1,1,2,1831910,1,,,,1733
c1cc0bab5c9f0338b18cc431d36f8b5b465a195f,0,Derek Dagit,2015-05-22 14:50:59-05:00,['b3abf05f02305260cdcbf081a8fe7d7db4b03ce7'],3,6,9,1831919,1,,,,1733
40ddae268d7c56156db7ca164788f0625d48c505,0,Derek Dagit,2015-05-22 14:53:17-05:00,['c1cc0bab5c9f0338b18cc431d36f8b5b465a195f'],55,26,81,1832000,1,,,,1733
1392b24fd9ccfe6d263839e5733b3f556039591e,0,Derek Dagit,2015-05-22 14:54:08-05:00,['40ddae268d7c56156db7ca164788f0625d48c505'],3,3,6,1832006,2,,,,1733
2195fd606c101ed949e12e29b0d9e2bf9024978e,0,Robert (Bobby) Evans,2015-05-22 14:54:12-05:00,['77bc461da9ae8131026b3cc43c091572f80ffb2e'],0,1,1,1832007,1,,,,1733
a6b82f8b52533476b645cfbb5a80638f98703103,0,Derek Dagit,2015-05-22 14:55:42-05:00,['1392b24fd9ccfe6d263839e5733b3f556039591e'],5332,1239,6571,1838578,10,,,,1733
2d388fa15a527053572e0be83f9c208a34da5464,0,Robert (Bobby) Evans,2015-05-22 15:02:02-05:00,"['2195fd606c101ed949e12e29b0d9e2bf9024978e', '1b4ea1ebf55248cf1d11719839ea126837ec17d1']",4,4,8,1838586,1,,,,1733
427e954948749d8b08224a891f6ff42d256dc4be,0,Robert (Bobby) Evans,2015-05-22 15:03:15-05:00,['2d388fa15a527053572e0be83f9c208a34da5464'],0,1,1,1838587,1,,,,1733
88af3e3ff393974e89fc47cc5497a910880786d9,0,Robert (Bobby) Evans,2015-05-22 16:25:59-05:00,"['427e954948749d8b08224a891f6ff42d256dc4be', '86f7c171a7638aa7c3bab5b14ff9c886dfb2909e']",8,18,26,1838613,5,,,,1733
455435adffd873d98eedc77f428b7d76f94f8bba,1,Sumit Chawla,2015-05-22 14:38:30-07:00,['512d3def033e2a66ce8f2c8a401c7cef99cbedea'],178,384,562,1839175,20,0,0.647887324,0.725352113,1733
106af613f310353ac0a49a1f37244a916e6770e4,0,Robert (Bobby) Evans,2015-05-22 16:42:19-05:00,['88af3e3ff393974e89fc47cc5497a910880786d9'],0,1,1,1839176,1,,,,1733
4b11f71b7e2fe45a62ad5a26d9d6bc32ebdec6df,0,Derek Dagit,2015-05-22 16:51:10-05:00,['a6b82f8b52533476b645cfbb5a80638f98703103'],5,7,12,1839188,1,,,,1733
f3d5aca8c6eaf3057abe43dccea42b509de70987,0,zhanghailei,2015-05-25 10:00:12+08:00,['106af613f310353ac0a49a1f37244a916e6770e4'],2,2,4,1839192,1,,,,1733
a989a4c30fad07becfac30760f4b858e7b31cd3a,0,Sumit Chawla,2015-05-26 12:35:58-07:00,['455435adffd873d98eedc77f428b7d76f94f8bba'],10,11,21,1839213,1,0,1,0,1733
602cbba506c32d6aa091701893060708cce0bf12,1,Sumit Chawla,2015-05-27 13:27:54-07:00,['a989a4c30fad07becfac30760f4b858e7b31cd3a'],10,88,98,1839311,5,0.470588235,1,0.235294118,1734
fe7de58f09a1a8a886d218c837eb185708264e62,0,Sumit Chawla,2015-05-27 14:42:06-07:00,['602cbba506c32d6aa091701893060708cce0bf12'],15,12,27,1839338,1,0,0,0,1734
dc8dea61be46a45287cfb6aeed5d5675aa3a96ae,0,P. Taylor Goetz,2015-05-28 15:02:49-04:00,"['106af613f310353ac0a49a1f37244a916e6770e4', '6f62a4e61e1f6d3f2d41d068b78b8e859c751338']",2,4,6,1839344,1,,,,1734
59895a71f3401da9f8b52efcb7927a459bb52883,0,P. Taylor Goetz,2015-05-28 15:04:16-04:00,['dc8dea61be46a45287cfb6aeed5d5675aa3a96ae'],0,1,1,1839345,1,,,,1734
dc3f28f2fcb5a1ead6976e373fefc026e82df63d,0,Robert (Bobby) Evans,2015-05-28 15:00:49-05:00,"['59895a71f3401da9f8b52efcb7927a459bb52883', 'f3d5aca8c6eaf3057abe43dccea42b509de70987']",2,2,4,1839349,1,,,,1734
6b606cf68f60858bdc9064c1fe50c873e6dd1971,0,Derek Dagit,2015-05-28 15:08:54-05:00,['4b11f71b7e2fe45a62ad5a26d9d6bc32ebdec6df'],2,2,4,1839353,1,,,,1734
93544b20799d05379d943f47eca8f22c583fe5dc,0,Robert (Bobby) Evans,2015-05-28 15:10:10-05:00,['dc3f28f2fcb5a1ead6976e373fefc026e82df63d'],0,2,2,1839355,2,,,,1734
d686079d19fc79187555bb3764171c4a7bba92de,0,Robert (Bobby) Evans,2015-05-28 15:14:12-05:00,"['93544b20799d05379d943f47eca8f22c583fe5dc', 'ef25356b1d93fd27d92893779a8ccaf293d90901']",1,1,2,1839357,1,,,,1734
34a0c0908d856130d9582c2299e6822eb300ce34,0,Robert (Bobby) Evans,2015-05-28 15:18:56-05:00,['d686079d19fc79187555bb3764171c4a7bba92de'],0,1,1,1839358,1,,,,1734
d189d99a0fbd77592a751867f9558ad64abde1df,0,Robert (Bobby) Evans,2015-05-28 15:24:05-05:00,"['34a0c0908d856130d9582c2299e6822eb300ce34', '6d3ee2478348e8597985374cd110a463de633c04']",1,1,2,1839360,1,,,,1734
431468b0cba8d1c678d94df58c775eded93a6504,0,Robert (Bobby) Evans,2015-05-28 15:24:35-05:00,['d189d99a0fbd77592a751867f9558ad64abde1df'],0,1,1,1839361,1,,,,1734
a257f54ed3135a9df17f95ff50e993f7b4e7df66,0,Robert (Bobby) Evans,2015-05-28 15:29:09-05:00,"['431468b0cba8d1c678d94df58c775eded93a6504', '05e7fac869c71a4e5211d305b5faf91de4b10383']",1,1,2,1839363,1,,,,1734
3f50b72a2e8de0fe8022d227b4d3dd14492dd950,0,Robert (Bobby) Evans,2015-05-28 15:29:28-05:00,['a257f54ed3135a9df17f95ff50e993f7b4e7df66'],0,1,1,1839364,1,,,,1734
4073dbe6cc98c55b9705888ae697778a9974ad30,0,P. Taylor Goetz,2015-05-29 13:53:39-04:00,"['3f50b72a2e8de0fe8022d227b4d3dd14492dd950', '85c5096e0806ac872739d8b73574a8f1e5d31679']",27,48,75,1839439,2,,,,1734
13c33f33573ca4e09f3fd6e723d8c3a08c496ca5,0,P. Taylor Goetz,2015-05-29 13:55:30-04:00,['4073dbe6cc98c55b9705888ae697778a9974ad30'],0,1,1,1839440,1,,,,1734
05d1f8b2451a0f958ff079699862c219ddb26833,0,P. Taylor Goetz,2015-05-29 15:47:08-04:00,['13c33f33573ca4e09f3fd6e723d8c3a08c496ca5'],62,196,258,1839698,14,0.823529412,0,1,1736
0c2b3a4f640d1b2905c093eb85f03190ceb0a711,0,P. Taylor Goetz,2015-05-29 15:49:06-04:00,['05d1f8b2451a0f958ff079699862c219ddb26833'],0,1,1,1839699,1,,,,1736
86f326a3c0b40fc1b0eab65fcb17b438e433cfd6,0,Shanyu Zhao,2015-05-29 14:05:28-07:00,['85aeb3d48efcaa28d6fc5dbfe6ce87af9f3e2615'],1,1,2,1839701,1,,,,1736
037a9754fdee063d2238a9c41e6ffdb79759d33d,0,Jungtaek Lim,2015-05-30 22:34:19+09:00,"['98704ec81a7629d11a95a744ee47d3baf7c2de6a', '0c2b3a4f640d1b2905c093eb85f03190ceb0a711']",2291,11354,13645,1853346,199,,,,1736
a6c46aec300001095fee6396ce8ffd4a0fd5783a,1,Jungtaek Lim,2015-06-01 15:05:50+09:00,['0c2b3a4f640d1b2905c093eb85f03190ceb0a711'],1,38,39,1853385,2,,,,1736
77164e0365c198e9ec090634a138bf46858dbc30,0,chuanlei,2015-06-01 23:38:38+08:00,['0c2b3a4f640d1b2905c093eb85f03190ceb0a711'],1,1,2,1853387,1,,,,1736
ee31b78df55ec1ad929fd2cbe34ff07eac5c2317,0,P. Taylor Goetz,2015-06-01 13:36:47-04:00,['0c2b3a4f640d1b2905c093eb85f03190ceb0a711'],112,127,239,1853626,1,,,,1736
ad98824fc9874c2fd9c0d3e461c7de63866589a6,0,P. Taylor Goetz,2015-06-01 17:11:24-04:00,['ee31b78df55ec1ad929fd2cbe34ff07eac5c2317'],1,0,1,1853627,1,,,,1736
fc73600228c156a68327a342bf2c2da514620bbb,0,P. Taylor Goetz,2015-06-01 17:15:06-04:00,['ad98824fc9874c2fd9c0d3e461c7de63866589a6'],2,2,4,1853631,1,,,,1736
f8906fb4d7750d5f009fccf98943060bb25e2f0c,0,Jungtaek Lim,2015-06-02 06:33:58+09:00,['037a9754fdee063d2238a9c41e6ffdb79759d33d'],8,35,43,1853674,3,,,,1736
84fc764560b50a133c5c902af9f7be9cd0e78a4d,0,Jungtaek Lim,2015-06-02 06:35:02+09:00,['f8906fb4d7750d5f009fccf98943060bb25e2f0c'],1,1,2,1853676,1,,,,1736
1eb85a2285a4d291ce60734bb00e5d0747986885,0,Jungtaek Lim,2015-06-02 06:55:45+09:00,['84fc764560b50a133c5c902af9f7be9cd0e78a4d'],2,2,4,1853680,1,,,,1736
9c2972ac635ef5a7066b1abf19ffd5dc9e42718c,0,Shanyu Zhao,2015-06-01 18:23:11-07:00,['86f326a3c0b40fc1b0eab65fcb17b438e433cfd6'],0,1,1,1853681,1,1,1,1,1736
bed27a744ab7acd061a0ab71bcb8e78bc0e0151e,0,Robert (Bobby) Evans,2015-06-02 09:52:11-05:00,"['ad98824fc9874c2fd9c0d3e461c7de63866589a6', '1eb85a2285a4d291ce60734bb00e5d0747986885']",417,623,1040,1854721,19,,,,1736
a0c032358a63632b958f6f0d1d0bbf9109020e9f,0,Robert (Bobby) Evans,2015-06-02 09:59:16-05:00,['bed27a744ab7acd061a0ab71bcb8e78bc0e0151e'],0,1,1,1854722,1,,,,1736
11768ba2025c89ec6cccc232f682c50a46865dc8,0,P. Taylor Goetz,2015-06-02 16:02:20-04:00,"['a0c032358a63632b958f6f0d1d0bbf9109020e9f', '306c535fb3e7fb5522e9cd2e0f41ba4c9fa8f9ca']",1,20,21,1854743,3,,,,1736
e7818af37ba2b62b222a4ddff948c0f3aff0c7ea,0,P. Taylor Goetz,2015-06-02 16:04:31-04:00,['11768ba2025c89ec6cccc232f682c50a46865dc8'],1,2,3,1854746,1,,,,1736
b90ec781c7a7ba77f6598fe20e7842fa4a228098,0,P. Taylor Goetz,2015-06-02 17:14:34-04:00,['91369ac2f15d4a2dade5d03ee2d0970d99e4d0bd'],6,4,10,1854756,1,,,,1736
d285d94d418bede3376e743f882c157a83f68a7a,0,P. Taylor Goetz,2015-06-02 17:15:30-04:00,"['e7818af37ba2b62b222a4ddff948c0f3aff0c7ea', 'fc73600228c156a68327a342bf2c2da514620bbb']",2,2,4,1854760,1,,,,1736
a55bbbea85fa83c3e9ab664922580d464de565fe,0,P. Taylor Goetz,2015-06-02 17:16:53-04:00,['d285d94d418bede3376e743f882c157a83f68a7a'],0,1,1,1854761,1,,,,1736
28558b34c8be84a1288f290675fb34a71ed6203f,1,Kishor Patil,2015-06-03 14:50:44+00:00,['d66444ced195e1546cfcfb188d3146974d42fd78'],180,380,560,1855321,21,0.244897959,1,1,1739
32e11b962b2ea39ffe1f3c199989a223e9d8ffeb,0,Kishor Patil,2015-06-03 14:52:49+00:00,['28558b34c8be84a1288f290675fb34a71ed6203f'],7,9,16,1855337,1,0,1,0,1739
6978b58574a4de67ef12ded945e5183d96680618,0,P. Taylor Goetz,2015-06-03 13:03:48-04:00,"['a55bbbea85fa83c3e9ab664922580d464de565fe', '9c2972ac635ef5a7066b1abf19ffd5dc9e42718c']",1001,376,1377,1856714,28,,,,1739
23137753250b4d8e8e15cfe661a9ba6cdc037273,0,P. Taylor Goetz,2015-06-03 13:08:46-04:00,['6978b58574a4de67ef12ded945e5183d96680618'],0,1,1,1856715,1,,,,1739
74f243cd6ac154c2557b936f7d95c7f29a88594a,0,Paul Poulosky,2015-06-03 12:21:06-05:00,['a55bbbea85fa83c3e9ab664922580d464de565fe'],0,3,3,1856718,1,,,,1739
cb370a99a12a8466b4acd644bfe4eba00ee26107,0,P. Taylor Goetz,2015-06-03 13:21:16-04:00,"['23137753250b4d8e8e15cfe661a9ba6cdc037273', 'b90ec781c7a7ba77f6598fe20e7842fa4a228098']",0,6043,6043,1862761,70,,,,1739
285d943b87f5037f0eaf3d45af64622f13017dea,0,P. Taylor Goetz,2015-06-03 13:24:03-04:00,['cb370a99a12a8466b4acd644bfe4eba00ee26107'],1,2,3,1862764,1,,,,1739
ff187f6ffbfe58c9bfc6b1b712f6c6ae62652b34,0,Nikhil Singh,2015-06-03 15:26:48-05:00,['285d943b87f5037f0eaf3d45af64622f13017dea'],1,66,67,1862831,2,1,1,1,1740
2154048fd123a0960a4f5854ec4dd436bb775329,1,P. Taylor Goetz,2015-06-03 17:38:14-04:00,['285d943b87f5037f0eaf3d45af64622f13017dea'],817,692,1509,1864340,48,,,,1740
b01a8c98ccad2f1f339cacee91e2ab41a52a244b,0,Jungtaek Lim,2015-06-04 06:44:47+09:00,['285d943b87f5037f0eaf3d45af64622f13017dea'],0,14,14,1864354,1,,,,1740
5f55c51acd06697e339a6d2d5a07e46a21f3e0ab,0,Robert (Bobby) Evans,2015-06-04 08:58:41-05:00,['2154048fd123a0960a4f5854ec4dd436bb775329'],6,32,38,1864392,3,1,1,1,1740
9ecf26cfb1b29ef369a4a99de85e2237645306c3,0,Kishor Patil,2015-06-04 16:52:49+00:00,['2154048fd123a0960a4f5854ec4dd436bb775329'],22,266,288,1864680,7,,,,1740
6aeef56a4684d57e457392c5130db6ab277cbd42,0,Robert (Bobby) Evans,2015-06-04 13:01:54-05:00,"['2154048fd123a0960a4f5854ec4dd436bb775329', '32e11b962b2ea39ffe1f3c199989a223e9d8ffeb']",179,381,560,1865240,19,,,,1740
19e3a28e18dae692c8e3afca41fcb75582e1fa66,0,Robert (Bobby) Evans,2015-06-04 13:08:37-05:00,['6aeef56a4684d57e457392c5130db6ab277cbd42'],0,1,1,1865241,1,,,,1740
07f5e6769ea35f8d680f937b3358176000ae8bdc,0,Robert (Bobby) Evans,2015-06-04 13:51:40-05:00,"['19e3a28e18dae692c8e3afca41fcb75582e1fa66', '5f55c51acd06697e339a6d2d5a07e46a21f3e0ab']",6,32,38,1865279,3,,,,1740
bf2ef232f4b2cd58a3a91801ac6d291a60d2cd38,0,Robert (Bobby) Evans,2015-06-04 13:51:55-05:00,['07f5e6769ea35f8d680f937b3358176000ae8bdc'],0,1,1,1865280,1,,,,1740
70ce03cb58574584babdf5c0cd43100a044e84d2,1,P. Taylor Goetz,2015-06-04 16:03:18-04:00,['19e3a28e18dae692c8e3afca41fcb75582e1fa66'],17,65,82,1865362,2,,,,1741
7e43a2b16f373a25df1e0e86e5a01266ebc69085,0,P. Taylor Goetz,2015-06-04 16:03:43-04:00,"['70ce03cb58574584babdf5c0cd43100a044e84d2', 'bf2ef232f4b2cd58a3a91801ac6d291a60d2cd38']",6,33,39,1865401,4,,,,1741
d69a7faa7d2d30bf04a6f1f6ff584be0d41573c0,1,Ken Dombeck,2015-06-04 16:04:11-05:00,['bf2ef232f4b2cd58a3a91801ac6d291a60d2cd38'],1,1,2,1865403,1,,,,1741
6168ae4e9ccf2301df8ce742ab4455a8713df4f0,0,Kishor Patil,2015-06-04 21:21:30+00:00,['9ecf26cfb1b29ef369a4a99de85e2237645306c3'],0,6,6,1865409,2,,,,1741
4ca39f15eea4ca8c3853f82cf00574babd47c963,1,Jungtaek Lim,2015-06-05 13:08:11+09:00,['bf2ef232f4b2cd58a3a91801ac6d291a60d2cd38'],12,18,30,1865439,1,,,,1741
4b083f314c3e9f905407536fcd090739f25e7e4d,0,Robert (Bobby) Evans,2015-06-05 08:53:29-05:00,"['bf2ef232f4b2cd58a3a91801ac6d291a60d2cd38', 'b01a8c98ccad2f1f339cacee91e2ab41a52a244b']",0,14,14,1865453,1,,,,1741
4a523ad8f1ca50e8ba7b176453e727060bda7e09,0,Robert (Bobby) Evans,2015-06-05 08:53:59-05:00,['4b083f314c3e9f905407536fcd090739f25e7e4d'],0,1,1,1865454,1,,,,1741
f35871cf481d273b9de979a2034aa96458334b32,0,Rick Kellogg,2015-06-05 11:39:26-04:00,['4a523ad8f1ca50e8ba7b176453e727060bda7e09'],6,7,13,1865467,2,,,,1741
992603a651dc4c55f91ebec5cd1aecc2ec09de60,0,Robert (Bobby) Evans,2015-06-05 11:03:22-05:00,"['4a523ad8f1ca50e8ba7b176453e727060bda7e09', '6168ae4e9ccf2301df8ce742ab4455a8713df4f0']",22,272,294,1865761,7,,,,1741
2f9383547b82873c77175cf94a14f8a133f59556,0,Robert (Bobby) Evans,2015-06-05 11:03:52-05:00,['992603a651dc4c55f91ebec5cd1aecc2ec09de60'],0,1,1,1865762,1,,,,1741
b63cfd8d54ad89e1deb61059beee3e1a638dea27,0,Robert (Bobby) Evans,2015-06-05 12:13:29-05:00,"['2f9383547b82873c77175cf94a14f8a133f59556', '4ca39f15eea4ca8c3853f82cf00574babd47c963']",12,18,30,1865792,1,,,,1741
9579c0b04ae3460a19961c81e714c2fa3b541e3c,0,Robert (Bobby) Evans,2015-06-05 12:24:38-05:00,['b63cfd8d54ad89e1deb61059beee3e1a638dea27'],0,1,1,1865793,1,,,,1741
c1ffb2e1e1ec6a8abb5118892ba5aed083222d8b,0,P. Taylor Goetz,2015-06-05 13:37:14-04:00,"['7e43a2b16f373a25df1e0e86e5a01266ebc69085', '9579c0b04ae3460a19961c81e714c2fa3b541e3c']",34,307,341,1866134,9,,,,1741
edd9baba1e9f976c8c3d1a2b591ebf33e418a351,1,Jungtaek Lim,2015-06-06 13:25:11+09:00,['9579c0b04ae3460a19961c81e714c2fa3b541e3c'],6,5,11,1866145,1,,,,1741
fb5fe34f55fdc7e6299d2de406ae9dd28760a10d,0,Jungtaek Lim,2015-06-06 13:55:29+09:00,['edd9baba1e9f976c8c3d1a2b591ebf33e418a351'],2,3,5,1866150,1,,,,1741
165ae10be8a95d51473553e050e49935c6267586,0,nsingh1,2015-06-08 15:32:41-05:00,['ff187f6ffbfe58c9bfc6b1b712f6c6ae62652b34'],4,4,8,1866158,2,,,,1741
128ee14ff6f8571c973161805bceadf8cc2cfce8,0,Derek Dagit,2015-06-08 20:20:42-05:00,['9579c0b04ae3460a19961c81e714c2fa3b541e3c'],6,13,19,1866177,2,,,,1741
97e3fac75925044cf43709b2d2c305c604fde2f5,0,P. Taylor Goetz,2015-06-09 14:19:54-04:00,"['c1ffb2e1e1ec6a8abb5118892ba5aed083222d8b', 'fb5fe34f55fdc7e6299d2de406ae9dd28760a10d']",6,6,12,1866189,1,,,,1741
1baaeb0688e89fa0df9a019ef0aa181a26923d06,0,P. Taylor Goetz,2015-06-09 14:20:50-04:00,['97e3fac75925044cf43709b2d2c305c604fde2f5'],0,1,1,1866190,1,,,,1741
80616df4e6df21c49976bd570780924e5f770da1,0,P. Taylor Goetz,2015-06-09 14:25:46-04:00,"['1baaeb0688e89fa0df9a019ef0aa181a26923d06', 'a448be54543783225671eb7578b872c75645fe3e']",3,5,8,1866198,1,,,,1741
9c1ea176f5bcf2eb53543e9a645e8fb6bb10bbbb,0,P. Taylor Goetz,2015-06-09 14:26:56-04:00,['80616df4e6df21c49976bd570780924e5f770da1'],1,2,3,1866201,1,,,,1741
5a6c7699b329ba0aa797c0c422e682b74e7b0282,0,P. Taylor Goetz,2015-06-09 14:30:04-04:00,"['9c1ea176f5bcf2eb53543e9a645e8fb6bb10bbbb', 'f35871cf481d273b9de979a2034aa96458334b32']",6,7,13,1866214,2,,,,1741
531e9c08e544acdafc5e82ab21c8d524a8af6136,0,P. Taylor Goetz,2015-06-09 14:31:18-04:00,['5a6c7699b329ba0aa797c0c422e682b74e7b0282'],0,1,1,1866215,1,,,,1741
27bc183c0f1e33fefb19b640f8a91f563c60ce61,0,P. Taylor Goetz,2015-06-09 15:06:48-04:00,['531e9c08e544acdafc5e82ab21c8d524a8af6136'],60,172,232,1866447,3,,,,1741
f021d1fd0db14c4d446813783be908596e816be8,0,Derek Dagit,2015-06-09 18:31:38-05:00,['27bc183c0f1e33fefb19b640f8a91f563c60ce61'],3,5,8,1866455,1,,,,1741
f6e2ad063c6a9fef98ed2acd1f824a005daae5d1,0,P. Taylor Goetz,2015-06-09 21:20:10-04:00,"['27bc183c0f1e33fefb19b640f8a91f563c60ce61', '128ee14ff6f8571c973161805bceadf8cc2cfce8']",6,13,19,1866474,2,,,,1741
58372f0a6313b914065faca7c4aa47d41f1d4f4d,0,P. Taylor Goetz,2015-06-09 21:20:57-04:00,['f6e2ad063c6a9fef98ed2acd1f824a005daae5d1'],0,1,1,1866475,1,,,,1741
12cd098826dba7a7b3a20bf90341449c5130eab8,0,Jungtaek Lim,2015-06-10 13:49:13+09:00,['58372f0a6313b914065faca7c4aa47d41f1d4f4d'],0,29,29,1866504,1,,,,1741
cdc9de4343ba4782dfea29495359b231dee73501,0,Robert (Bobby) Evans,2015-06-10 15:24:45-05:00,['58372f0a6313b914065faca7c4aa47d41f1d4f4d'],1,27,28,1866532,2,0.833333333,1,0,1741
55c3f90a6b7bd1df4e1196c9cbf673b267e8df87,0,Jungtaek Lim,2015-06-11 06:04:34+09:00,['58372f0a6313b914065faca7c4aa47d41f1d4f4d'],1,1,2,1866534,1,,,,1741
99cfe28296ad82f4e9d5672b16be7de94f4d7223,0,Jungtaek Lim,2015-06-11 21:56:39+09:00,['58372f0a6313b914065faca7c4aa47d41f1d4f4d'],2,2,4,1866538,1,,,,1741
cebe13641939dc213ac98e40a3ee43b9f3b147a2,0,Jungtaek Lim,2015-06-12 09:10:31+09:00,['99cfe28296ad82f4e9d5672b16be7de94f4d7223'],2,6,8,1866546,2,1,1,1,1741
6a3cca4aabedd12cc86fa006423a682a7b4f5336,0,xiajun,2015-06-12 13:04:29+08:00,['58372f0a6313b914065faca7c4aa47d41f1d4f4d'],12,12,24,1866570,2,,,,1741
6e0b56c100138c0b5881716932178c262b1a3683,0,xiajun,2015-06-12 13:19:59+08:00,['6a3cca4aabedd12cc86fa006423a682a7b4f5336'],12,12,24,1866594,2,,,,1741
d35ff2577c222a4096a4d7333b28fe73de7c7f34,0,Kishor Patil,2015-06-12 09:43:02-05:00,"['58372f0a6313b914065faca7c4aa47d41f1d4f4d', '165ae10be8a95d51473553e050e49935c6267586']",1,66,67,1866661,2,,,,1741
9c8e880d8648f4f2da29b5725258b00f7e05ce8c,0,Kishor Patil,2015-06-12 09:44:18-05:00,['d35ff2577c222a4096a4d7333b28fe73de7c7f34'],0,2,2,1866663,2,,,,1741
8d05605868421f58096def9119bd8e5db7de24e9,0,Jungtaek Lim,2015-06-15 08:14:11+09:00,['58372f0a6313b914065faca7c4aa47d41f1d4f4d'],41,822,863,1867526,27,,,0,1741
d278ee3661c2c64cd825aeb29a69ba9bce1573d5,0,xiajun,2015-06-15 20:20:09+08:00,['9c8e880d8648f4f2da29b5725258b00f7e05ce8c'],3,3,6,1867532,1,,,,1741
ca4cbe8dbc990e46e89f9eec67e53caa042b6164,0,Kishor Patil,2015-06-15 09:22:22-05:00,"['9c8e880d8648f4f2da29b5725258b00f7e05ce8c', 'cebe13641939dc213ac98e40a3ee43b9f3b147a2']",4,8,12,1867544,3,,,,1741
247e149aa83adef18e941a5ba4d383f4248c6637,0,Kishor Patil,2015-06-15 09:23:33-05:00,['ca4cbe8dbc990e46e89f9eec67e53caa042b6164'],0,1,1,1867545,1,,,,1741
df8baad4a137cf9a022744aa66cbabf353bf0db1,0,Kishor Patil,2015-06-15 09:26:25-05:00,"['247e149aa83adef18e941a5ba4d383f4248c6637', '55c3f90a6b7bd1df4e1196c9cbf673b267e8df87']",1,1,2,1867547,1,,,,1741
f75cf7c176bf5cae740c2d29999d57de87ea07fa,0,Kishor Patil,2015-06-15 09:27:12-05:00,['df8baad4a137cf9a022744aa66cbabf353bf0db1'],0,1,1,1867548,1,,,,1741
8e2374fde0d8b7cdd7df7e3919e4b34dd21add09,1,Robert (Bobby) Evans,2015-06-17 10:44:04-05:00,['f75cf7c176bf5cae740c2d29999d57de87ea07fa'],39,215,254,1867802,10,0.25,1,1,1744
fb9b527e40d1b1b71cc1847e5b038a50f1639124,0,Robert (Bobby) Evans,2015-06-17 10:52:24-05:00,['8e2374fde0d8b7cdd7df7e3919e4b34dd21add09'],1,1,2,1867804,1,,,,1744
fcd0d9e7b639f352c6fd6870dcfdec4d830f34d9,0,Robert (Bobby) Evans,2015-06-17 11:06:46-05:00,['fb9b527e40d1b1b71cc1847e5b038a50f1639124'],1,9,10,1867814,1,0,1,1,1744
b554cc900d27a2375bcf71a07ba6e467525cd98a,0,Robert (Bobby) Evans,2015-06-17 13:52:45-05:00,['fcd0d9e7b639f352c6fd6870dcfdec4d830f34d9'],25,107,132,1867946,2,1,1,0.586206897,1745
f95196031144bac23453ccce813667e8ec652a63,0,P. Taylor Goetz,2015-06-17 23:59:58-04:00,['f75cf7c176bf5cae740c2d29999d57de87ea07fa'],12,114,126,1868072,3,0.533333333,0.533333333,1,1746
6e2495378ba7e3e715a4a940736d3c4713bc8c48,0,Robert (Bobby) Evans,2015-06-18 12:30:39-05:00,['b554cc900d27a2375bcf71a07ba6e467525cd98a'],84,25,109,1868181,2,0,0,0.413793103,1746
4a3cb4a90c0d37e2af75b150d7a32c0261e66c91,0,Robert (Bobby) Evans,2015-06-18 12:36:28-05:00,['6e2495378ba7e3e715a4a940736d3c4713bc8c48'],1,1,2,1868183,1,,,,1746
b98530acd3b49a83613048dbfac3b009a21c14f2,0,lyonbrw,2015-06-18 14:51:45-04:00,['f75cf7c176bf5cae740c2d29999d57de87ea07fa'],1,1,2,1868185,1,,,,1746
18056e88a83b8a4dc63b3dd1ac1fd7d875a5a309,1,P. Taylor Goetz,2015-06-19 16:41:48-04:00,['f95196031144bac23453ccce813667e8ec652a63'],0,323,323,1868508,2,,,,1747
3fe57c3dc42e9d61916c239bdad9bf4090330d93,0,P. Taylor Goetz,2015-06-19 16:42:17-04:00,['18056e88a83b8a4dc63b3dd1ac1fd7d875a5a309'],1,1,2,1868510,1,,,,1747
0c9a8a47513fa6e47d25ddc3650531a6619f089d,0,P. Taylor Goetz,2015-06-19 16:48:50-04:00,['3fe57c3dc42e9d61916c239bdad9bf4090330d93'],50,0,50,1868560,2,,,,1747
9d5fd61cd59ac3997527e954b3f10113c4e37237,0,Sriharsha Chintalapani,2015-06-21 19:43:22-07:00,"['0c9a8a47513fa6e47d25ddc3650531a6619f089d', 'd278ee3661c2c64cd825aeb29a69ba9bce1573d5']",3,3,6,1868566,1,,,,1747
7fb7a20ba6e7f397b28f6c79d02c799a7c0f0c90,0,Sriharsha Chintalapani,2015-06-21 19:45:01-07:00,['9d5fd61cd59ac3997527e954b3f10113c4e37237'],0,1,1,1868567,1,,,,1747
82199b42268c3462e0568f3bd134d28a4af01ea8,0,Sriharsha Chintalapani,2015-06-21 21:01:38-07:00,"['7fb7a20ba6e7f397b28f6c79d02c799a7c0f0c90', 'a6c46aec300001095fee6396ce8ffd4a0fd5783a']",1,38,39,1868606,2,,,,1747
e294c3789926d05f9488293add8fd1a3f0fc840f,0,Sriharsha Chintalapani,2015-06-21 21:23:02-07:00,"['82199b42268c3462e0568f3bd134d28a4af01ea8', 'b5ace2227f403aed732374e99d3a93e9f48a5e98']",5,37,42,1868648,3,,,,1747
9e3e48daf01ca0cf2d8182e205275df480c45795,0,Sriharsha Chintalapani,2015-06-21 21:24:12-07:00,['e294c3789926d05f9488293add8fd1a3f0fc840f'],0,1,1,1868649,1,,,,1747
9abca47403991a0e44ba25e1b55db550960b021e,0,Sriharsha Chintalapani,2015-06-21 21:41:38-07:00,"['9e3e48daf01ca0cf2d8182e205275df480c45795', '546abe4308dac2ed29f9e41d9f81ecba461cbb2e']",1,2,3,1868652,2,,,,1747
c682eb76e7c49b26429baf4f43e40ff929163378,0,Sriharsha Chintalapani,2015-06-21 21:47:06-07:00,['9abca47403991a0e44ba25e1b55db550960b021e'],0,1,1,1868653,1,,,,1747
0bc4565166e3d7ed3c219486dfbf51e0851cf105,1,Kyle Nusbaum,2015-06-25 14:03:57-05:00,['c682eb76e7c49b26429baf4f43e40ff929163378'],34,125,159,1868812,4,,,,1747
3f819165f8d553132ce3881e7128a76817d8137b,0,Kyle Nusbaum,2015-06-25 14:14:25-05:00,"['c682eb76e7c49b26429baf4f43e40ff929163378', 'd69a7faa7d2d30bf04a6f1f6ff584be0d41573c0']",1,1,2,1868814,1,,,,1747
9f007c28b6ec5f75770dc0a69fbf09c6e1174036,0,Kyle Nusbaum,2015-06-25 15:00:42-05:00,"['3f819165f8d553132ce3881e7128a76817d8137b', '4a3cb4a90c0d37e2af75b150d7a32c0261e66c91']",40,247,287,1869101,10,,,,1747
28e64c9e52bd7982b97e67c75ef451ddc339d2b1,0,Kyle Nusbaum,2015-06-25 15:02:07-05:00,['9f007c28b6ec5f75770dc0a69fbf09c6e1174036'],0,1,1,1869102,1,,,,1747
9319ab137efa9d606e96d1fc0504502bbaec87e6,1,zhuol,2015-06-26 10:56:57-05:00,['28e64c9e52bd7982b97e67c75ef451ddc339d2b1'],36,157,193,1869295,4,0,0.468085106,1,1747
dad54fc4a719cea47d1116ce57ba14360b38cac2,0,Kishor Patil,2015-06-26 11:39:57-05:00,"['28e64c9e52bd7982b97e67c75ef451ddc339d2b1', '74f243cd6ac154c2557b936f7d95c7f29a88594a']",0,3,3,1869298,1,,,,1747
577e34e7ee39d7010d8e8e0447619896a406eaeb,0,Kishor Patil,2015-06-26 11:43:30-05:00,['dad54fc4a719cea47d1116ce57ba14360b38cac2'],0,2,2,1869300,2,,,,1747
081af1cf18b397af5e77c8c83400c8c7dffda1d0,0,Robert (Bobby) Evans,2015-06-26 12:58:01-05:00,"['577e34e7ee39d7010d8e8e0447619896a406eaeb', '9319ab137efa9d606e96d1fc0504502bbaec87e6']",36,157,193,1869493,4,,,,1747
5383ac375cb2955e3247d485e46f1f58bff62810,0,Robert (Bobby) Evans,2015-06-26 13:05:57-05:00,['081af1cf18b397af5e77c8c83400c8c7dffda1d0'],0,1,1,1869494,1,,,,1747
1da96361b133029444a632bf2624226eb26f566d,0,Kyle Nusbaum,2015-06-29 11:31:22-05:00,['0bc4565166e3d7ed3c219486dfbf51e0851cf105'],2,2,4,1869498,2,,,,1747
276b68d4434c35ee71a23c8d7949d1c9a6bdb037,0,Sumit Chawla,2015-06-29 10:12:48-07:00,"['fe7de58f09a1a8a886d218c837eb185708264e62', '5383ac375cb2955e3247d485e46f1f58bff62810']",2685,9954,12639,1882137,221,,,,1747
e2894f70f45fad8556fda628f93e0f6745e804ff,0,Jungtaek Lim,2015-06-30 05:51:06+09:00,['5383ac375cb2955e3247d485e46f1f58bff62810'],1,1,2,1882139,1,,,,1747
cf923a563018f991447fd708bc694f3b6faff039,0,Jungtaek Lim,2015-06-30 07:06:43+09:00,"['e2894f70f45fad8556fda628f93e0f6745e804ff', '8d05605868421f58096def9119bd8e5db7de24e9']",41,822,863,1883002,27,,,,1747
f7a8a7513503567ecd32ca82d97d69eae0e9d88b,0,Jungtaek Lim,2015-06-30 07:16:59+09:00,['cf923a563018f991447fd708bc694f3b6faff039'],0,2,2,1883004,1,,,,1747
1522670cdde7ab7656301db76bbc9bd11200b86d,0,Robert (Bobby) Evans,2015-06-30 08:16:33-05:00,"['f7a8a7513503567ecd32ca82d97d69eae0e9d88b', '1da96361b133029444a632bf2624226eb26f566d']",34,125,159,1883163,4,,,,1747
27a3a6bb71f78bd20029747981d20c21dd639f55,0,Robert (Bobby) Evans,2015-06-30 08:23:47-05:00,['1522670cdde7ab7656301db76bbc9bd11200b86d'],1,1,2,1883165,1,,,,1747
735fae7899eb8240b7a0d5514c6f68a9f6be3e4f,0,Aaron Dossett,2015-06-30 09:29:32-05:00,['9579c0b04ae3460a19961c81e714c2fa3b541e3c'],5,7,12,1883177,3,,,,1747
b53770068d61950c64cec2a0d9b7f126a3dd648e,0,Sumit Chawla,2015-06-30 09:54:51-07:00,"['276b68d4434c35ee71a23c8d7949d1c9a6bdb037', '27a3a6bb71f78bd20029747981d20c21dd639f55']",76,950,1026,1884203,33,,,,1747
e30bcfdd1071cd1d3392afe0764554cfc86a2f50,0,Aaron Dossett,2015-06-30 14:49:38-05:00,['9579c0b04ae3460a19961c81e714c2fa3b541e3c'],0,24,24,1884227,1,,,,1747
0f7349d168a0e60fd1fd242276d80e1b02200932,0,Jungtaek Lim,2015-07-01 06:21:09+09:00,"['27a3a6bb71f78bd20029747981d20c21dd639f55', '6e0b56c100138c0b5881716932178c262b1a3683']",12,12,24,1884251,2,,,,1747
4a66ab97f72cd26d8a7e4f2527e8d30d14cede00,0,Jungtaek Lim,2015-07-01 06:24:00+09:00,['0f7349d168a0e60fd1fd242276d80e1b02200932'],0,2,2,1884253,1,,,,1747
b1411aa63383801913cb1340a8b51c5bb46db0ba,0,Enno Shioji,2015-07-01 13:54:33+01:00,['4a66ab97f72cd26d8a7e4f2527e8d30d14cede00'],334,298,632,1884885,8,1,0.475409836,0.081967213,1749
24327b1f2f2b88710f50d7f4ab803eacafc5649a,0,Jungtaek Lim,2015-07-01 22:40:25+09:00,"['4a66ab97f72cd26d8a7e4f2527e8d30d14cede00', '0380a42f7ddaf48ce17eabb67ec18a27cd258f69']",0,1,1,1884886,1,,,,1749
30df970e2086fb1d060f643ff01ee1491225605f,0,Jungtaek Lim,2015-07-01 22:41:28+09:00,['24327b1f2f2b88710f50d7f4ab803eacafc5649a'],0,1,1,1884887,1,,,,1749
7e81e54e16feba742ec8501d7b9497ce2c2bf68f,0,Shyam Rajendran,2015-07-01 13:10:54-05:00,['27a3a6bb71f78bd20029747981d20c21dd639f55'],13,50,63,1884950,3,0.766666667,1,0.8,1749
87772f2a1fd84a3a561543659544ac6cdb7c4537,0,Shyam Rajendran,2015-07-01 13:10:54-05:00,['7e81e54e16feba742ec8501d7b9497ce2c2bf68f'],15,15,30,1884980,3,,,,1749
935e87accc85340549f44effa8a675e950747faa,0,Enno Shioji,2015-07-02 18:56:23+01:00,['b1411aa63383801913cb1340a8b51c5bb46db0ba'],1,0,1,1884981,1,,,,1749
7af467723b5c4b0beedc40626a8c56bc7c3e0d21,1,Enno Shioji,2015-07-03 01:09:26+01:00,['935e87accc85340549f44effa8a675e950747faa'],2,6,8,1884989,2,0.5,1,0.5,1749
d955a3a9922d0690142209a31f0a78fc250c7b61,0,caofangkun,2015-07-03 13:55:43+08:00,['30df970e2086fb1d060f643ff01ee1491225605f'],0,5,5,1884994,1,,,,1749
fa370b540cdc91cefea6ccda166525ba4e6aa15c,0,caofangkun,2015-07-03 14:29:57+08:00,['30df970e2086fb1d060f643ff01ee1491225605f'],18,9,27,1885021,2,,,,1749
0d79febc05f02603ac8be0512ff791b53b896905,0,caofangkun,2015-07-03 15:36:45+08:00,['fa370b540cdc91cefea6ccda166525ba4e6aa15c'],1,2,3,1885024,1,,,,1749
de17a9f6c7d19dd7444753eeeea31bf1a5a2d9df,1,Charles Chan,2015-07-05 07:38:04-07:00,['30df970e2086fb1d060f643ff01ee1491225605f'],2,2,4,1885028,1,,,,1749
5069e156a9d87d6e2ebfa14c915330b6f4c42fac,1,Charles Chan,2015-07-05 07:55:09-07:00,['30df970e2086fb1d060f643ff01ee1491225605f'],2,2,4,1885032,1,,,,1749
2d27c64c433fc3178651d318dbc409c086f9fd6d,0,Shyam Rajendran,2015-07-05 10:30:58-05:00,['87772f2a1fd84a3a561543659544ac6cdb7c4537'],0,3,3,1885035,2,,,,1749
c1fe22abfe77a9bdc21de6d85993ae0da96a7fed,1,Charles Chan,2015-07-05 13:39:27-07:00,['30df970e2086fb1d060f643ff01ee1491225605f'],1,9,10,1885045,1,,,,1749
34aa43163fcf5a79713ffb31ce74564cb5666366,0,caofangkun,2015-07-06 09:14:08+08:00,['d955a3a9922d0690142209a31f0a78fc250c7b61'],0,1,1,1885046,1,,,,1749
18ca7966583902e2895949e01c8ea07457c44cb5,0,caofangkun,2015-07-06 13:14:18+08:00,['30df970e2086fb1d060f643ff01ee1491225605f'],6,41,47,1885093,5,,,,1749
3d03b931b66d43fd5dd383c5e0ac23c55b772232,0,Shyam Rajendran,2015-07-06 10:42:21-05:00,['27a3a6bb71f78bd20029747981d20c21dd639f55'],15,52,67,1885160,7,0.9375,0.9375,0.9375,1749
0459bc97f6e7ea80c3212f9bb5cfdc89a1e5450d,0,Shyam Rajendran,2015-07-06 10:42:33-05:00,['3d03b931b66d43fd5dd383c5e0ac23c55b772232'],23,15,38,1885198,3,,,,1749
dfc3cd9d9d96d5a0bf204b0a1389b2ba9da7367a,0,Thilina Rathnayake,2015-07-07 12:01:26+05:18,['30df970e2086fb1d060f643ff01ee1491225605f'],1,1,2,1885200,1,,,,1749
fcf21238db6be31fef6b64845e5a2492e8b295c9,1,Thilina Rathnayake,2015-07-07 16:23:36+05:18,['dfc3cd9d9d96d5a0bf204b0a1389b2ba9da7367a'],1,1,2,1885202,1,,,,1749
a1912eafab7f4313c7f45f27748fff28cb37d8f0,0,Dan Blanchard,2015-07-07 10:16:05-04:00,['30df970e2086fb1d060f643ff01ee1491225605f'],18,20,38,1885240,1,,,,1749
427cef54c74204a257bc97a3e8fb793854603aaf,1,Dan Blanchard,2015-07-07 10:25:58-04:00,['a1912eafab7f4313c7f45f27748fff28cb37d8f0'],2,30,32,1885272,2,0,1,1,1749
9906f85d5267d092c61d2e3d532f80feb0886648,0,Jungtaek Lim,2015-07-08 11:27:28+09:00,['30df970e2086fb1d060f643ff01ee1491225605f'],1,5,6,1885278,1,,,,1749
5141440bbd267ca954b19b990b77781b7795bd7b,0,errordaiwa,2015-07-09 10:40:20+08:00,['9906f85d5267d092c61d2e3d532f80feb0886648'],1,1,2,1885280,1,,,,1749
fb0f00e482d3782682d9ede77f5990bc7d05a895,0,Alexander Kazakov,2015-07-09 12:16:15+03:00,['9906f85d5267d092c61d2e3d532f80feb0886648'],8,9,17,1885297,4,,,,1749
61dceffb622e70dd419096f0fa0ad5979d99d710,0,Hugo Louro,2015-07-09 19:35:33-07:00,['f75cf7c176bf5cae740c2d29999d57de87ea07fa'],344,795,1139,1886436,8,0.884,0.884,0.788,1753
68bd67c02af316e711fba98a37d853063e83884a,0,errordaiwa,2015-07-10 11:00:28+08:00,['5141440bbd267ca954b19b990b77781b7795bd7b'],5,20,25,1886461,7,0,1,0,1753
b69c643936970aa993a21c42dc0c9e498316f24b,0,Sumit Chawla,2015-07-09 21:01:29-07:00,"['b53770068d61950c64cec2a0d9b7f126a3dd648e', '9906f85d5267d092c61d2e3d532f80feb0886648']",13,32,45,1886506,5,,,,1753
3e82028a5a3fae3b9e0616fa85278e4a347b63e2,0,errordaiwa,2015-07-10 14:20:09+08:00,['68bd67c02af316e711fba98a37d853063e83884a'],1,1,2,1886508,1,,,,1753
792a88d1ff636da78199146e57c4fc0c84b3a284,1,Ron DuPlain,2015-07-11 08:17:28-04:00,['9906f85d5267d092c61d2e3d532f80feb0886648'],3,2,5,1886513,1,,,,1753
c27948df35fd6ccbbe6fd19c3c2528c810c24699,1,Jungtaek Lim,2015-07-13 09:51:18+09:00,['9906f85d5267d092c61d2e3d532f80feb0886648'],6,7,13,1886526,3,,,,1753
7bccc6d3d6a123f9192a586293fc5f15c940a9e1,0,Jungtaek Lim,2015-07-13 09:59:42+09:00,['c27948df35fd6ccbbe6fd19c3c2528c810c24699'],0,1,1,1886527,1,,,,1753
f3e973fa4df7af68317e4e239c3c783756de1e75,0,errordaiwa,2015-07-13 17:46:16+08:00,['9906f85d5267d092c61d2e3d532f80feb0886648'],2,2,4,1886531,2,,,,1753
fecba3e144e35ca15765c5868d762e77e5933e4a,0,Jungtaek Lim,2015-07-13 22:09:53+09:00,"['7bccc6d3d6a123f9192a586293fc5f15c940a9e1', 'b98530acd3b49a83613048dbfac3b009a21c14f2']",1,1,2,1886533,1,,,,1753
df12823c97f966717826d6d1595dd014ec1f3afd,0,Jungtaek Lim,2015-07-13 22:12:37+09:00,['fecba3e144e35ca15765c5868d762e77e5933e4a'],0,1,1,1886534,1,,,,1753
0b88a2b8cb61d576a992d8fcf114a378ce452f5f,0,Jungtaek Lim,2015-07-13 22:44:55+09:00,"['df12823c97f966717826d6d1595dd014ec1f3afd', '2d27c64c433fc3178651d318dbc409c086f9fd6d']",0,40,40,1886574,3,,,,1753
f63b1ef535ddf88057f8ba4357bebcb1789c8854,0,Jungtaek Lim,2015-07-13 23:00:08+09:00,['0b88a2b8cb61d576a992d8fcf114a378ce452f5f'],0,2,2,1886576,2,,,,1753
b1388c6dd3a999ccfdb17390fc3033ff4451783e,0,Jungtaek Lim,2015-07-13 23:07:26+09:00,"['f63b1ef535ddf88057f8ba4357bebcb1789c8854', '427cef54c74204a257bc97a3e8fb793854603aaf']",20,50,70,1886646,2,,,,1753
98cbb34f01dd829fcdf3ea931d12c50c7f88cf98,0,Jungtaek Lim,2015-07-13 23:33:25+09:00,['b1388c6dd3a999ccfdb17390fc3033ff4451783e'],0,1,1,1886647,1,,,,1753
78c2adbe04d2d2c7e0224719a24b1412cf13595e,0,errordaiwa,2015-07-14 12:40:45+08:00,"['f3e973fa4df7af68317e4e239c3c783756de1e75', '3e82028a5a3fae3b9e0616fa85278e4a347b63e2']",6,24,30,1886677,7,,,,1753
4a3ddc688a5a0d584a6858168241083db23add15,0,Robert (Bobby) Evans,2015-07-14 09:55:55-05:00,"['98cbb34f01dd829fcdf3ea931d12c50c7f88cf98', '7af467723b5c4b0beedc40626a8c56bc7c3e0d21']",331,298,629,1887306,8,,,,1753
2d030413ab651140a3dd3655673b7bb81c1ce202,0,rfarivar,2015-07-14 11:51:59-05:00,['98cbb34f01dd829fcdf3ea931d12c50c7f88cf98'],1,1,2,1887308,1,,,,1753
b3f0df41dee39999d4e68494fec266c35000d9c5,0,Robert (Bobby) Evans,2015-07-14 13:52:45-05:00,['4a3ddc688a5a0d584a6858168241083db23add15'],1,3,4,1887312,1,,,,1753
4eb2e1e9244c6f427ce000759a44b6bead2bfba3,1,P. Taylor Goetz,2015-07-14 15:18:20-04:00,['0c9a8a47513fa6e47d25ddc3650531a6619f089d'],21,28,49,1887361,1,,,,1753
184fd722785741701768a89c2d7341e22fddb50f,0,P. Taylor Goetz,2015-07-14 15:18:29-04:00,"['4eb2e1e9244c6f427ce000759a44b6bead2bfba3', 'b3f0df41dee39999d4e68494fec266c35000d9c5']",531,1866,2397,1889758,74,,,,1753
1b3e9edfc6597f19cee8b73310c30c0c92739eda,0,rfarivar,2015-07-14 14:38:47-05:00,['2d030413ab651140a3dd3655673b7bb81c1ce202'],2,2,4,1889762,1,,,,1753
6add48717cefd6cd5d259c6784a39b58e9b38680,0,Rahul J,2015-07-15 11:25:31+05:18,['184fd722785741701768a89c2d7341e22fddb50f'],1,1,2,1889764,1,,,,1753
6778b567b56b77a1ac0afe223305865b8684d199,0,Sanket,2015-07-15 09:10:37-05:00,['9906f85d5267d092c61d2e3d532f80feb0886648'],10,16,26,1889790,1,,,,1753
e54f6ea58bfd2b2786afe1d0a552935b0ee32adf,0,Sanket,2015-07-15 09:43:01-05:00,['6778b567b56b77a1ac0afe223305865b8684d199'],1,1,2,1889792,1,,,,1753
e5fbb247311af07a820abb8bce3bff52c06b386b,0,Robert (Bobby) Evans,2015-07-15 12:54:11-05:00,"['6add48717cefd6cd5d259c6784a39b58e9b38680', '1b3e9edfc6597f19cee8b73310c30c0c92739eda']",2,2,4,1889796,1,,,,1753
eb583bb5071ae045c28a65b6af4a0eb56e0c2a9c,0,Robert (Bobby) Evans,2015-07-15 15:01:13-05:00,['e5fbb247311af07a820abb8bce3bff52c06b386b'],0,2,2,1889798,2,,,,1753
cddd2531ca0ef24ab71b9f36787b0c6799c2d5e6,0,Robert (Bobby) Evans,2015-07-15 16:15:25-05:00,"['eb583bb5071ae045c28a65b6af4a0eb56e0c2a9c', '792a88d1ff636da78199146e57c4fc0c84b3a284']",2,1,3,1889801,1,,,,1753
cb92190a9d82317471d825804400a19e40ebd94b,0,Robert (Bobby) Evans,2015-07-15 16:24:00-05:00,"['cddd2531ca0ef24ab71b9f36787b0c6799c2d5e6', '61dceffb622e70dd419096f0fa0ad5979d99d710']",344,795,1139,1890940,8,,,,1753
4133899737dc5af37380bfe0ae57c6ce28c7da34,0,Robert (Bobby) Evans,2015-07-15 16:29:29-05:00,['cb92190a9d82317471d825804400a19e40ebd94b'],0,2,2,1890942,2,,,,1753
7be83684dc7cc2fa8067397cb159439e47122dc3,0,errordaiwa,2015-07-16 09:02:17+08:00,['78c2adbe04d2d2c7e0224719a24b1412cf13595e'],1,1,2,1890944,1,,,,1753
f1703767e1112cd51c48b53b65889d3b7cf14f59,1,Xin Wang,2015-07-16 11:26:39+08:00,['4133899737dc5af37380bfe0ae57c6ce28c7da34'],1,1,2,1890946,1,,,,1753
68d3a5a35ec4f86e360171fb7efdf0c7845d59d2,0,Jungtaek Lim,2015-07-16 19:19:30+09:00,['f1703767e1112cd51c48b53b65889d3b7cf14f59'],0,1,1,1890947,1,,,,1753
e8f872ee8246947f9939f24f0964ce30bd98c91c,0,Robert (Bobby) Evans,2015-07-16 08:33:48-05:00,"['68d3a5a35ec4f86e360171fb7efdf0c7845d59d2', 'fb0f00e482d3782682d9ede77f5990bc7d05a895']",8,9,17,1890964,4,,,,1753
d553005fc28feefaffd504b8adf606af14ed8443,0,Robert (Bobby) Evans,2015-07-16 08:55:16-05:00,"['e8f872ee8246947f9939f24f0964ce30bd98c91c', 'fcf21238db6be31fef6b64845e5a2492e8b295c9']",2,2,4,1890968,2,,,,1753
8bf1fa3e0160087037f8f2af405be38eb63009ce,0,Robert (Bobby) Evans,2015-07-16 09:00:00-05:00,"['d553005fc28feefaffd504b8adf606af14ed8443', '34aa43163fcf5a79713ffb31ce74564cb5666366']",0,6,6,1890974,1,,,,1753
c6d270c6ffbc285e61a2236291b82ad0f268217a,0,Robert (Bobby) Evans,2015-07-16 09:03:05-05:00,['8bf1fa3e0160087037f8f2af405be38eb63009ce'],0,1,1,1890975,1,,,,1753
e6c502b113db1525273e3383822ed26bd561f57c,0,Robert (Bobby) Evans,2015-07-16 09:13:59-05:00,"['c6d270c6ffbc285e61a2236291b82ad0f268217a', 'de17a9f6c7d19dd7444753eeeea31bf1a5a2d9df']",2,2,4,1890979,1,,,,1753
44c033c8b7c93e11b989757e4ec7b51f4e025de2,0,Robert (Bobby) Evans,2015-07-16 11:14:34-05:00,"['e6c502b113db1525273e3383822ed26bd561f57c', '735fae7899eb8240b7a0d5514c6f68a9f6be3e4f']",5,7,12,1890991,3,,,,1753
f079882b941ff4c678a8434667818b5eddac4985,0,Robert (Bobby) Evans,2015-07-16 11:16:31-05:00,['44c033c8b7c93e11b989757e4ec7b51f4e025de2'],0,2,2,1890993,2,,,,1753
dc842c4df51992316853fb1183654b9a663049fe,0,Robert (Bobby) Evans,2015-07-16 11:25:39-05:00,"['f079882b941ff4c678a8434667818b5eddac4985', '5069e156a9d87d6e2ebfa14c915330b6f4c42fac']",2,2,4,1890997,1,,,,1753
aa7cac92f2981a5bb4869ad3ce4db5dd66bf51f5,0,Robert (Bobby) Evans,2015-07-16 11:27:44-05:00,"['dc842c4df51992316853fb1183654b9a663049fe', 'c1fe22abfe77a9bdc21de6d85993ae0da96a7fed']",0,8,8,1891005,1,,,,1753
f62e2e99bec34f6be8c815393ab42a4da3f6a391,0,Robert (Bobby) Evans,2015-07-16 11:28:56-05:00,['aa7cac92f2981a5bb4869ad3ce4db5dd66bf51f5'],0,1,1,1891006,1,,,,1753
76ac09bc027a625bc631f126aaf72e910e747898,0,Robert (Bobby) Evans,2015-07-16 11:31:22-05:00,"['f62e2e99bec34f6be8c815393ab42a4da3f6a391', '18ca7966583902e2895949e01c8ea07457c44cb5']",6,41,47,1891053,5,,,,1753
77f0c8b5bdce493a168cd2fda51087b7648e592a,0,Robert (Bobby) Evans,2015-07-16 11:32:09-05:00,['76ac09bc027a625bc631f126aaf72e910e747898'],0,1,1,1891054,1,,,,1753
83bd369a7c53073a7ba588ac9c0cfc46136a7cf8,0,Robert (Bobby) Evans,2015-07-16 12:32:18-05:00,"['77f0c8b5bdce493a168cd2fda51087b7648e592a', 'e54f6ea58bfd2b2786afe1d0a552935b0ee32adf']",10,16,26,1891080,1,,,,1753
3bc60817dc93064e922e214ac5b22ee59936a268,0,Robert (Bobby) Evans,2015-07-16 12:54:04-05:00,['83bd369a7c53073a7ba588ac9c0cfc46136a7cf8'],0,1,1,1891081,1,,,,1753
24f9c1becd707d4018ae33c4377f4bdf9bc8fd1e,0,Robert (Bobby) Evans,2015-07-16 14:59:57-05:00,"['3bc60817dc93064e922e214ac5b22ee59936a268', '77164e0365c198e9ec090634a138bf46858dbc30']",1,1,2,1891083,1,,,,1753
af781c90e994480e27b2b17d01e1a55fed853c63,0,Robert (Bobby) Evans,2015-07-16 15:07:46-05:00,['24f9c1becd707d4018ae33c4377f4bdf9bc8fd1e'],0,1,1,1891084,1,,,,1753
3c6e04fbf7654e210fb3a4436f891619f1d5bba2,0,Robert (Bobby) Evans,2015-07-16 15:37:31-05:00,"['af781c90e994480e27b2b17d01e1a55fed853c63', 'f021d1fd0db14c4d446813783be908596e816be8']",3,5,8,1891092,1,,,,1753
e2157678f2f5c99455cac4ddc61f21fec66f99cf,0,Robert (Bobby) Evans,2015-07-16 15:37:59-05:00,['3c6e04fbf7654e210fb3a4436f891619f1d5bba2'],0,1,1,1891093,1,,,,1753
11823a722749ba77c4b207ad5d369df69fd2551b,1,Jungtaek Lim,2015-07-17 06:57:28+09:00,['e2157678f2f5c99455cac4ddc61f21fec66f99cf'],25,32,57,1891150,1,0.5,0,1,1753
8ec4c5ba0f84736596f46cda2d0da5ddf94eed1a,0,Jungtaek Lim,2015-07-17 06:57:32+09:00,['11823a722749ba77c4b207ad5d369df69fd2551b'],2,1,3,1891153,1,1,0,1,1753
9c3dfc9863475841f918ddb93cc1db8535cb8aff,0,Jungtaek Lim,2015-07-17 06:57:36+09:00,['8ec4c5ba0f84736596f46cda2d0da5ddf94eed1a'],18,18,36,1891189,1,,,,1753
236a265a59fbdcb93d1f49c882a5b31e794866eb,0,Jungtaek Lim,2015-07-17 07:05:44+09:00,['9c3dfc9863475841f918ddb93cc1db8535cb8aff'],0,1,1,1891190,1,,,,1753
7c46c7d5babe7bb003232df110de6940904bfd96,0,Jungtaek Lim,2015-07-17 07:18:22+09:00,"['236a265a59fbdcb93d1f49c882a5b31e794866eb', '7be83684dc7cc2fa8067397cb159439e47122dc3']",7,25,32,1891222,8,,,,1753
9f75a265c9bee0fb1a46d1f5b5d40925f60b3a04,0,Jungtaek Lim,2015-07-17 07:27:39+09:00,['236a265a59fbdcb93d1f49c882a5b31e794866eb'],0,3,3,1891225,2,,,,1753
df25048cbc0c9884cc558f6c6e4ca118a38f930d,0,Jungtaek Lim,2015-07-17 07:37:54+09:00,"['9f75a265c9bee0fb1a46d1f5b5d40925f60b3a04', '7c46c7d5babe7bb003232df110de6940904bfd96']",7,25,32,1891257,8,,,,1753
3466d35757ef23176e6c47b6edf7ef3654d28bb8,0,Jungtaek Lim,2015-07-17 08:58:24+09:00,['df25048cbc0c9884cc558f6c6e4ca118a38f930d'],1,1,2,1891259,1,,,,1753
740f02ee0025cc0307a1422205f9612ce18d3652,0,caofangkun,2015-07-17 11:35:11+08:00,['3466d35757ef23176e6c47b6edf7ef3654d28bb8'],6,6,12,1891271,2,,,,1753
b132520adb00def6d03ef020b1cb5973eb3b3519,0,Derek Dagit,2015-07-17 18:45:39-05:00,['98cbb34f01dd829fcdf3ea931d12c50c7f88cf98'],32,118,150,1891421,7,0.692307692,0,1,1755
1b581ef1cd2c6a8c9f07f2097816c0312ae003ba,0,Derek Dagit,2015-07-17 18:52:20-05:00,['b132520adb00def6d03ef020b1cb5973eb3b3519'],35,0,35,1891456,1,0,0,0,1755
5ac30623733a4d882e7f2dfd9c903efd91cede5d,0,Jungtaek Lim,2015-07-18 10:14:27+09:00,['3466d35757ef23176e6c47b6edf7ef3654d28bb8'],0,1,1,1891457,1,,,,1755
fd21937526b4b20ac1670c623645ba131ed512ac,0,Jungtaek Lim,2015-07-18 11:51:15+09:00,"['5ac30623733a4d882e7f2dfd9c903efd91cede5d', '0459bc97f6e7ea80c3212f9bb5cfdc89a1e5450d']",1,30,31,1891488,7,,,,1755
54f6b32f6bcf77032db5aa29183426bfbe3c0a90,0,Jungtaek Lim,2015-07-18 11:53:43+09:00,['fd21937526b4b20ac1670c623645ba131ed512ac'],1,2,3,1891491,1,,,,1755
78bd1f45b7276a9c0d414d22a0f58dba0d86f23b,0,Shyam Rajendran,2015-07-17 23:58:58-05:00,['54f6b32f6bcf77032db5aa29183426bfbe3c0a90'],0,21,21,1891512,1,0.75,0,0.75,1755
02ca2e96c97212b860c49b634c93e0c12dcf3e9f,0,Shyam Rajendran,2015-07-17 23:59:06-05:00,['78bd1f45b7276a9c0d414d22a0f58dba0d86f23b'],15,12,27,1891539,1,1,1,1,1755
f091743d9ebc935c9bbbc210095884c3d819632b,1,Jungtaek Lim,2015-07-21 00:17:28+09:00,['54f6b32f6bcf77032db5aa29183426bfbe3c0a90'],3,59,62,1891601,4,0.875,0.875,1,1755
52572e3471d811eb07521cefa464c16289b91800,0,Robert (Bobby) Evans,2015-07-21 04:47:39-05:00,"['f091743d9ebc935c9bbbc210095884c3d819632b', '02ca2e96c97212b860c49b634c93e0c12dcf3e9f']",0,18,18,1891619,1,,,,1755
6a21b6a4e0cd6ad211134bb97bbec0e6d0907e12,0,Robert (Bobby) Evans,2015-07-21 04:50:20-05:00,['52572e3471d811eb07521cefa464c16289b91800'],0,1,1,1891620,1,,,,1755
f72beb086faed40a705cad04e4d87d46fd10fd0e,0,Xin Wang,2015-07-21 18:11:39+08:00,['6a21b6a4e0cd6ad211134bb97bbec0e6d0907e12'],2,2,4,1891624,1,,,,1755
5631b9d4746f34127a1bc89cb4488d2b2d8ec9d7,1,Arun Iyer,2015-07-22 00:29:31+05:18,['6a21b6a4e0cd6ad211134bb97bbec0e6d0907e12'],58,301,359,1891983,5,0.81097561,0.963414634,0.865853659,1755
acb36df704d292b514d5c8e8437dc2d1c84a93d8,1,Sriharsha Chintalapani,2015-07-21 15:42:22-07:00,['3466d35757ef23176e6c47b6edf7ef3654d28bb8'],7,6,13,1891996,2,1,1,0,1755
579dc87f04cf24fc9419945d54519fce09584178,0,Arun Mahadevan,2015-07-22 10:02:43+05:18,['5631b9d4746f34127a1bc89cb4488d2b2d8ec9d7'],4,16,20,1892016,1,,,,1755
e71e2ddfafe8bfb082320c2c3b40f4fb2a3d4995,0,Arun Mahadevan,2015-07-22 12:19:46+05:18,['579dc87f04cf24fc9419945d54519fce09584178'],1,7,8,1892024,1,1,1,1,1755
70cdda253e2f744a4f106400da5e4646b2230b1b,0,Derek Dagit,2015-07-22 12:17:14-05:00,['1b581ef1cd2c6a8c9f07f2097816c0312ae003ba'],2,1,3,1892027,1,,,,1755
639f6a78cb1fc462590d9fe9c0fd7bbbd959505c,0,Derek Dagit,2015-07-22 12:17:39-05:00,['70cdda253e2f744a4f106400da5e4646b2230b1b'],2,22,24,1892051,1,0,0,1,1755
e4cd21a6628c376da411b5cc4076226789e75baa,0,Derek Dagit,2015-07-22 12:17:59-05:00,['639f6a78cb1fc462590d9fe9c0fd7bbbd959505c'],17,17,34,1892085,1,,,,1755
e0f0ce57d443aa7fc295504e3355a7f11e05621e,0,Derek Dagit,2015-07-22 16:41:12-05:00,['6a21b6a4e0cd6ad211134bb97bbec0e6d0907e12'],0,7,7,1892092,2,,,,1755
7a758840d525311435549111d658499a84405090,0,Jungtaek Lim,2015-07-23 07:33:54+09:00,"['6a21b6a4e0cd6ad211134bb97bbec0e6d0907e12', 'e4cd21a6628c376da411b5cc4076226789e75baa']",20,90,110,1892202,6,,,,1755
9b2fd72e90b962175e8610cf072f1aeb8164c527,0,Jungtaek Lim,2015-07-23 08:39:24+09:00,['7a758840d525311435549111d658499a84405090'],0,1,1,1892203,1,,,,1755
0915a32a939c1a1e9a5c8bc9a5f9a2c83b7999fc,0,Jungtaek Lim,2015-07-23 14:11:52+09:00,['9b2fd72e90b962175e8610cf072f1aeb8164c527'],5,2,7,1892210,1,,,,1755
6a446ceae184c0fe13cc993c7966ee73bb63394f,1,SEUNGJIN LEE,2015-07-23 14:32:17+09:00,['9b2fd72e90b962175e8610cf072f1aeb8164c527'],0,1156,1156,1893366,19,0.513513514,0.948648649,0.808108108,1771
b2416e1de16227ba2e280b7d7efb41f65f5ff418,0,SEUNGJIN LEE,2015-07-23 14:32:17+09:00,['6a446ceae184c0fe13cc993c7966ee73bb63394f'],1,1,2,1893368,1,,,,1771
c147a4eb49faa2a7efc05e12d240aa58a9ccee2b,0,SEUNGJIN LEE,2015-07-23 14:32:17+09:00,['b2416e1de16227ba2e280b7d7efb41f65f5ff418'],2,2,4,1893372,1,,,,1771
2002dbd7cf54c9615c7c826496275d35b7471c5b,0,SEUNGJIN LEE,2015-07-23 14:32:17+09:00,['c147a4eb49faa2a7efc05e12d240aa58a9ccee2b'],63,57,120,1893492,9,0,0,0,1771
0c00544ba72339c18d60dffd5e27e5f982ddb649,0,SEUNGJIN LEE,2015-07-23 14:32:17+09:00,['2002dbd7cf54c9615c7c826496275d35b7471c5b'],14,14,28,1893520,4,,,,1771
acaab9c3d6c13952a722480bc64393b5b2dc61bc,0,SEUNGJIN LEE,2015-07-23 14:32:17+09:00,['0c00544ba72339c18d60dffd5e27e5f982ddb649'],26,98,124,1893644,11,0,1,1,1771
85eadd790198a506a020fb4d1fd3247741b7db64,0,Arun Mahadevan,2015-07-24 08:57:51+05:18,"['e71e2ddfafe8bfb082320c2c3b40f4fb2a3d4995', '9b2fd72e90b962175e8610cf072f1aeb8164c527']",20,91,111,1893755,7,,,,1771
eabd1e698d7c1bfa9ff53a9c8db047f632fccc12,0,Jungtaek Lim,2015-07-25 11:47:24+09:00,"['9b2fd72e90b962175e8610cf072f1aeb8164c527', 'f72beb086faed40a705cad04e4d87d46fd10fd0e']",2,2,4,1893759,1,,,,1771
77986c62870d72cf712fc835e1f19c6844a89ed8,0,SEUNGJIN LEE,2015-07-27 14:23:10+09:00,['acaab9c3d6c13952a722480bc64393b5b2dc61bc'],13,11,24,1893783,5,0.5,0,0,1771
2ad6dd61d3d781c3b0d6b8235b2e5a058e8c0acd,0,SEUNGJIN LEE,2015-07-27 17:11:40+09:00,['77986c62870d72cf712fc835e1f19c6844a89ed8'],3,6,9,1893792,1,,,,1771
aab2c17bb5541ae75493b27b77f99b4e14dc2c0a,0,SEUNGJIN LEE,2015-07-27 17:31:41+09:00,['2ad6dd61d3d781c3b0d6b8235b2e5a058e8c0acd'],1,1,2,1893794,1,,,,1771
8842afdd2d556ffe2e5e7c226a310f2a9312306f,0,Jungtaek Lim,2015-07-27 18:23:51+09:00,['eabd1e698d7c1bfa9ff53a9c8db047f632fccc12'],0,1,1,1893795,1,,,,1771
c3a93854fe1e4611ecfb4ebce312c2fb0e06027d,0,Jungtaek Lim,2015-07-27 22:22:29+09:00,"['8842afdd2d556ffe2e5e7c226a310f2a9312306f', '0915a32a939c1a1e9a5c8bc9a5f9a2c83b7999fc']",5,2,7,1893802,1,,,,1771
36366c801dc74be7111bcb2e7f5d78e6fe3570f4,0,Kostya Golikov,2015-07-28 21:44:22+03:00,['c3a93854fe1e4611ecfb4ebce312c2fb0e06027d'],13,0,13,1893815,1,,,,1771
f5ce1f865aaf8fbebd364799dcc9685a96dd7f16,0,zhuol,2015-07-29 10:54:56-05:00,['c3a93854fe1e4611ecfb4ebce312c2fb0e06027d'],0,9,9,1893824,3,,,,1771
d9d2bb7321165c26c256a1d3defdd8507191a6b4,0,zhuol,2015-07-29 17:30:24-05:00,['f5ce1f865aaf8fbebd364799dcc9685a96dd7f16'],5,5,10,1893834,3,,,,1771
eb6d7383861220eaeb685206d3946899c20506ac,0,zhuol,2015-07-29 22:18:39-05:00,['d9d2bb7321165c26c256a1d3defdd8507191a6b4'],1,1,2,1893836,1,,,,1771
db503a4576499f4fd89ea9566b14fdc7ade0b5a4,0,Jerry,2015-07-29 21:00:49-07:00,['c3a93854fe1e4611ecfb4ebce312c2fb0e06027d'],30,1,31,1893867,3,0,0,0,1771
63fe18c6c169aed9d4ee78de242c8c4fe93e20d6,0,Sriharsha Chintalapani,2015-07-30 06:43:06-07:00,"['c3a93854fe1e4611ecfb4ebce312c2fb0e06027d', 'acb36df704d292b514d5c8e8437dc2d1c84a93d8']",7,6,13,1893880,2,,,,1771
8be4c3c3f85adb109685b898fc343660798a02e1,0,Sriharsha Chintalapani,2015-07-30 06:53:34-07:00,['63fe18c6c169aed9d4ee78de242c8c4fe93e20d6'],0,1,1,1893881,1,,,,1771
17356bc345bb9696f11dc861bf9898a9ad32c551,0,Sriharsha Chintalapani,2015-07-30 07:03:47-07:00,['8be4c3c3f85adb109685b898fc343660798a02e1'],0,1,1,1893882,1,,,,1771
61202cce113af316f5c97699bf061af3aa1deecf,0,Jungtaek Lim,2015-07-30 23:44:01+09:00,"['17356bc345bb9696f11dc861bf9898a9ad32c551', '740f02ee0025cc0307a1422205f9612ce18d3652']",6,6,12,1893894,2,,,,1771
14fdab8b188080e5f1095ed422c807493ad6fd01,0,Jungtaek Lim,2015-07-30 23:47:07+09:00,['61202cce113af316f5c97699bf061af3aa1deecf'],0,1,1,1893895,1,,,,1771
937346a3373dfaee2225ae32d53b68391bd09cf5,1,Aaron Dossett,2015-07-30 10:54:17-05:00,['14fdab8b188080e5f1095ed422c807493ad6fd01'],23,115,138,1894033,2,0.015384615,0.476923077,1,1771
2a1a417f922cbce6239b5c85eb75363b92b9a2d0,0,caofangkun,2015-07-31 10:36:42+08:00,['14fdab8b188080e5f1095ed422c807493ad6fd01'],1,1,2,1894035,1,,,,1771
e7d890711fd72b3ff2eceddb5a090d24c6a89c98,0,Jerry,2015-07-30 22:44:57-07:00,['db503a4576499f4fd89ea9566b14fdc7ade0b5a4'],1,20,21,1894056,2,1,1,1,1771
6de597a6d004e56d1889df9b6a913c7391aff126,0,Sriharsha Chintalapani,2015-07-31 07:27:43-07:00,['937346a3373dfaee2225ae32d53b68391bd09cf5'],0,1,1,1894057,1,,,,1771
9fd358eb33b0f3f0d61a8a72890354eb11c5fa1c,1,Aaron Dossett,2015-07-31 10:34:44-05:00,['6de597a6d004e56d1889df9b6a913c7391aff126'],16,49,65,1894122,4,0.64,0.64,1,1771
4555c56f9a05476f0e96fb97aa1da9adbc90037a,0,nsingh1,2015-07-31 11:17:59-05:00,['285d943b87f5037f0eaf3d45af64622f13017dea'],4,15,19,1894141,2,0,1,1,1771
e7ef20ee40beddd028b692ffb4a9c646360f7b24,0,Sumit Chawla,2015-08-01 21:01:11-07:00,"['b69c643936970aa993a21c42dc0c9e498316f24b', '6de597a6d004e56d1889df9b6a913c7391aff126']",870,1743,2613,1896754,82,,,,1771
376fa50d2e8f5d12e9e7b91a6895e6b6face23a3,0,Jungtaek Lim,2015-08-03 07:46:02+09:00,"['6de597a6d004e56d1889df9b6a913c7391aff126', '2a1a417f922cbce6239b5c85eb75363b92b9a2d0']",1,1,2,1896756,1,,,,1771
aae4ba63ef8ab09cbd56d000dbced61e630e3a25,0,Jungtaek Lim,2015-08-03 07:54:23+09:00,['376fa50d2e8f5d12e9e7b91a6895e6b6face23a3'],0,1,1,1896757,1,,,,1771
8505c3ef2d5e32c1716f49f6928851363c25df91,0,Arun Mahadevan,2015-08-03 11:50:52+05:18,['85eadd790198a506a020fb4d1fd3247741b7db64'],4,34,38,1896795,3,0.3,0.3,0.3,1771
df63f75f92fe1cdc9368aedc06be1ea91034fd6c,0,Arun Mahadevan,2015-08-03 11:54:44+05:18,"['8505c3ef2d5e32c1716f49f6928851363c25df91', '6de597a6d004e56d1889df9b6a913c7391aff126']",42,135,177,1896972,10,,,,1771
394d62ae39532dea42474578747a59a41e1e2d38,0,Boyang Jerry Peng,2015-08-03 11:59:56-05:00,['e7d890711fd72b3ff2eceddb5a090d24c6a89c98'],2,15,17,1896989,2,,,,1771
3b2c7fc41603640dd8ae47c225b19b7a7b946441,0,Jungtaek Lim,2015-08-04 15:26:11+09:00,['aae4ba63ef8ab09cbd56d000dbced61e630e3a25'],4,4,8,1896997,1,,,,1771
287718c8bc0f8b51ca89de4f62fcb6710d525992,0,Arun Mahadevan,2015-08-04 13:54:45+05:18,['f72beb086faed40a705cad04e4d87d46fd10fd0e'],0,214,214,1897211,2,0.674698795,0.674698795,0.903614458,1772
62fa05b97cb7e1c0dc3eca8e2ce05fd78a8b88c8,0,Arun Mahadevan,2015-08-04 15:13:49+05:18,['287718c8bc0f8b51ca89de4f62fcb6710d525992'],1,24,25,1897236,2,,,,1772
2360fe1ed6b5407658b3942ba15f1feff029ff09,0,Boyang Jerry Peng,2015-08-04 09:29:15-05:00,['394d62ae39532dea42474578747a59a41e1e2d38'],0,1,1,1897237,1,,,,1772
ccf49d0e195820eb3ee3696a762e35077a18d472,0,Robert (Bobby) Evans,2015-08-05 14:53:39-05:00,"['3b2c7fc41603640dd8ae47c225b19b7a7b946441', '12cd098826dba7a7b3a20bf90341449c5130eab8']",0,29,29,1897266,1,,,,1772
7f181188b68962a7c32679c63ac6370d3640763c,0,Robert (Bobby) Evans,2015-08-05 15:01:19-05:00,['ccf49d0e195820eb3ee3696a762e35077a18d472'],0,1,1,1897267,1,,,,1772
938f03d8357a87b121389222805e843610702c56,0,Robert (Bobby) Evans,2015-08-05 15:39:51-05:00,"['7f181188b68962a7c32679c63ac6370d3640763c', '0d79febc05f02603ac8be0512ff791b53b896905']",18,10,28,1897295,2,,,,1772
2a7bbfa745b7e0c688dea6f87d098dccbf9713e2,0,Robert (Bobby) Evans,2015-08-05 15:52:04-05:00,['938f03d8357a87b121389222805e843610702c56'],0,1,1,1897296,1,,,,1772
524eee6f4d454d40fbc2fcee69499ee07b14208c,0,Robert (Bobby) Evans,2015-08-05 15:53:04-05:00,"['2a7bbfa745b7e0c688dea6f87d098dccbf9713e2', '4555c56f9a05476f0e96fb97aa1da9adbc90037a']",4,15,19,1897315,2,,,,1772
827ddbd8c900d6e8341b487303f72f55b483782f,0,Robert (Bobby) Evans,2015-08-05 16:03:17-05:00,['524eee6f4d454d40fbc2fcee69499ee07b14208c'],0,1,1,1897316,1,,,,1772
a13c0f2122362dd96c2e524a23814cc58e6cadbc,0,Jungtaek Lim,2015-08-06 07:40:15+09:00,"['827ddbd8c900d6e8341b487303f72f55b483782f', 'aab2c17bb5541ae75493b27b77f99b4e14dc2c0a']",0,1223,1223,1898539,19,,,,1772
124e8468a797769eb58e5f49ed2a93d34b19cf90,0,Jungtaek Lim,2015-08-06 07:58:25+09:00,['a13c0f2122362dd96c2e524a23814cc58e6cadbc'],0,1,1,1898540,1,,,,1772
8203ec63997a902ef4d04a503f6681ae2e3dadd5,0,Jungtaek Lim,2015-08-06 10:01:04+09:00,"['124e8468a797769eb58e5f49ed2a93d34b19cf90', '2360fe1ed6b5407658b3942ba15f1feff029ff09']",16,20,36,1898576,3,,,,1772
ac14de3ea7cce09719d3ccdf3c4f6b79c8063e54,0,Jungtaek Lim,2015-08-06 11:13:20+09:00,['124e8468a797769eb58e5f49ed2a93d34b19cf90'],0,1,1,1898577,1,,,,1772
544e55cb8ab8878c4af500aab49bd35d4b69cd3e,0,Jungtaek Lim,2015-08-06 11:14:24+09:00,"['ac14de3ea7cce09719d3ccdf3c4f6b79c8063e54', '8203ec63997a902ef4d04a503f6681ae2e3dadd5']",16,20,36,1898613,3,,,,1772
3ba9aba3983ac14fe6b25e74e05aa24cb1e9e44e,0,rohan_agarwal,2015-08-07 16:51:22+05:18,['544e55cb8ab8878c4af500aab49bd35d4b69cd3e'],1,1,2,1898615,1,,,,1772
80c82e30dbd58b030cb72ed9ab13738eaf6dc106,0,rohan_agarwal,2015-08-10 10:24:13+05:18,['3ba9aba3983ac14fe6b25e74e05aa24cb1e9e44e'],1,1,2,1898617,1,,,,1772
cdabbb3db273895a79939f40894b999167532125,0,Arun Mahadevan,2015-08-10 12:57:53+05:18,['df63f75f92fe1cdc9368aedc06be1ea91034fd6c'],96,299,395,1899012,5,0.565656566,1,1,1773
4d8c51b4503110f03a27b401f096ff2477bbb7cf,0,Arun Mahadevan,2015-08-10 13:49:24+05:18,['cdabbb3db273895a79939f40894b999167532125'],0,3,3,1899015,1,,,,1773
a924e9efb461cd86cee7ff59d867c8cf2118f1e0,1,Arun Mahadevan,2015-08-10 14:08:47+05:18,['f72beb086faed40a705cad04e4d87d46fd10fd0e'],19,361,380,1899395,12,0.8125,1,0.875,1776
26b02706201e3dc92b1dff8398795ae78d6753b6,1,Arun Mahadevan,2015-08-10 14:09:43+05:18,['a924e9efb461cd86cee7ff59d867c8cf2118f1e0'],43,1369,1412,1900807,15,0.511627907,0.690274841,0.976744186,1776
f8c4c5bf428c812ffa51eaabed0c8c1d04793cb4,0,Arun Mahadevan,2015-08-10 14:09:51+05:18,['26b02706201e3dc92b1dff8398795ae78d6753b6'],7,257,264,1901071,3,0.453038674,0.46961326,0.801104972,1776
d1e5ec98732e77409e6303b1ec3708a44e6a7bb9,1,Arun Mahadevan,2015-08-10 14:10:00+05:18,['f8c4c5bf428c812ffa51eaabed0c8c1d04793cb4'],1,60,61,1901132,4,1,1,0.2,1776
5914944f6ac7ad637a8727ab04fed0c1a5e2be1e,0,Arun Mahadevan,2015-08-10 14:10:09+05:18,['d1e5ec98732e77409e6303b1ec3708a44e6a7bb9'],31,47,78,1901210,7,,,,1776
306ec57d9cebaaa8f5b9caa0c6fcfb256702bc77,0,Arun Mahadevan,2015-08-10 14:10:35+05:18,['5914944f6ac7ad637a8727ab04fed0c1a5e2be1e'],730,990,1720,1902930,18,0,0.093617021,0.889361702,1776
bfa3095ef871e0fdd76edef5d9ab1daf098b88b8,0,rohan_agarwal,2015-08-10 14:23:26+05:18,['80c82e30dbd58b030cb72ed9ab13738eaf6dc106'],1,8,9,1902939,2,0,0,1,1776
7940d0c57c07c6b168617a0daaf182895cec8028,0,Arun Mahadevan,2015-08-10 14:56:10+05:18,"['306ec57d9cebaaa8f5b9caa0c6fcfb256702bc77', '544e55cb8ab8878c4af500aab49bd35d4b69cd3e']",102,1532,1634,1904573,43,,,,1776
84a282c48ac54ca2573464e4935cd652dd1f84a3,0,rohan_agarwal,2015-08-10 17:17:47+05:18,['bfa3095ef871e0fdd76edef5d9ab1daf098b88b8'],5,11,16,1904589,2,0.666666667,0.666666667,1,1776
c8e337d13521e6ca5f83639b9a68120618750332,0,Arun Mahadevan,2015-08-11 10:15:48+05:18,"['62fa05b97cb7e1c0dc3eca8e2ce05fd78a8b88c8', '544e55cb8ab8878c4af500aab49bd35d4b69cd3e']",102,1531,1633,1906222,43,,,,1776
35990fa28aa660b389afb00ca3ecfe38fdf519db,0,Arun Mahadevan,2015-08-11 12:14:45+05:18,['7940d0c57c07c6b168617a0daaf182895cec8028'],33,54,87,1906309,9,,,,1776
73a165639ada07b470f0a0cf39d1c27f15f0d98e,0,Jungtaek Lim,2015-08-11 20:17:15+09:00,['544e55cb8ab8878c4af500aab49bd35d4b69cd3e'],1,1,2,1906311,1,,,,1776
6dba1d694ca861a6be90dc650fb2ae6600bcb891,0,Jungtaek Lim,2015-08-12 07:08:58+09:00,"['544e55cb8ab8878c4af500aab49bd35d4b69cd3e', 'e30bcfdd1071cd1d3392afe0764554cfc86a2f50']",0,24,24,1906335,1,,,,1776
c54cea116c33853c265d5f3c4eae2129e995b40d,0,Jungtaek Lim,2015-08-12 07:10:15+09:00,['6dba1d694ca861a6be90dc650fb2ae6600bcb891'],0,1,1,1906336,1,,,,1776
256e12ad9d42dd7b4c815c5918e846f90b74bbe7,0,Jungtaek Lim,2015-08-12 07:20:18+09:00,"['73a165639ada07b470f0a0cf39d1c27f15f0d98e', 'c54cea116c33853c265d5f3c4eae2129e995b40d']",0,25,25,1906361,2,,,,1776
b0baa638c16f2806a850455d80dc8bbf2c9b9e29,0,Randy Gelhausen,2015-08-11 21:46:17-04:00,['c54cea116c33853c265d5f3c4eae2129e995b40d'],7,7,14,1906375,1,,,,1776
d1afefde51e34dc993591ad79d3fe217bef86f87,0,Parth Brahmbhatt,2015-08-11 22:31:02-07:00,"['c54cea116c33853c265d5f3c4eae2129e995b40d', '765e4c2fabafbfe31fb0f43e5b670fd3b91d1a2e']",658,3124,3782,1910157,38,,,,1776
26dc0390dd7d14c1f8cf4f834202ec778e5d82c0,0,Randy Gelhausen,2015-08-12 02:36:24-04:00,['b0baa638c16f2806a850455d80dc8bbf2c9b9e29'],5,5,10,1910167,3,,,,1776
1f93a3f0f8194715c35869766dec5fc623066d3e,0,Jungtaek Lim,2015-08-12 22:47:29+09:00,['b0baa638c16f2806a850455d80dc8bbf2c9b9e29'],47,205,252,1910419,12,0.142857143,1,1,1777
d1a6f4a753661f7e825eeec0c51782462fca4d5f,0,Li Wang,2015-08-12 22:00:15+08:00,['b0baa638c16f2806a850455d80dc8bbf2c9b9e29'],2,5,7,1910426,1,,,,1777
230438988f6b7a42eae3b146549c22db0cfe2add,0,Jungtaek Lim,2015-08-12 23:03:01+09:00,['1f93a3f0f8194715c35869766dec5fc623066d3e'],0,0,0,1910426,1,,,,1777
bfd34a5f46ee36e9237c0d7ea7ae4bed9dc567ee,0,Boyang Jerry Peng,2015-08-12 10:40:49-05:00,['c3a93854fe1e4611ecfb4ebce312c2fb0e06027d'],2,34,36,1910462,2,,,,1777
3e20823c199c9babf3017cf1e8a8ff0753c7f24f,0,Parth Brahmbhatt,2015-08-12 09:25:27-07:00,['d1afefde51e34dc993591ad79d3fe217bef86f87'],1,15,16,1910478,2,0,0,1,1777
3f66ffd73086681c43a7f16342cab5cd944f25f4,0,Parth Brahmbhatt,2015-08-12 09:28:27-07:00,['3e20823c199c9babf3017cf1e8a8ff0753c7f24f'],1,15,16,1910494,2,,,,1777
16293e46f9b32bb495067217a721fe720a488975,1,Parth Brahmbhatt,2015-08-12 09:29:35-07:00,['3f66ffd73086681c43a7f16342cab5cd944f25f4'],23,51,74,1910568,5,0,0,1,1777
95fb6809fad6a5de8af67fec2f6af0556bd18ddb,0,Parth Brahmbhatt,2015-08-12 09:29:53-07:00,['16293e46f9b32bb495067217a721fe720a488975'],1,2,3,1910571,2,,,,1777
0395fd6878f574724686328c1039454ce6acd23d,1,Parth Brahmbhatt,2015-08-12 09:49:44-07:00,['95fb6809fad6a5de8af67fec2f6af0556bd18ddb'],20,21,41,1910612,4,0,0,1,1777
21ba9c1c9f73c7a84ac8d221b6ca6a7ca7639d14,0,Parth Brahmbhatt,2015-08-12 09:55:00-07:00,['0395fd6878f574724686328c1039454ce6acd23d'],5,5,10,1910622,1,,,,1777
ef3cee6d5d9d673246dd1c7d2caa44240546e228,0,Parth Brahmbhatt,2015-08-12 09:58:57-07:00,['21ba9c1c9f73c7a84ac8d221b6ca6a7ca7639d14'],3,34,37,1910659,3,,,,1777
6ea41129b457924de9b6c80efe6bf58413f94e33,0,Derek Dagit,2015-08-12 12:38:08-05:00,"['b0baa638c16f2806a850455d80dc8bbf2c9b9e29', '256e12ad9d42dd7b4c815c5918e846f90b74bbe7']",1,1,2,1910661,1,,,,1777
55ec459e35a3f404cee1c3853aca0a3635d59bdf,0,Derek Dagit,2015-08-12 12:39:19-05:00,['6ea41129b457924de9b6c80efe6bf58413f94e33'],0,1,1,1910662,1,,,,1777
93dbcafaa2e5e9fd4cdc9445d1104fb61ae286f2,0,Parth Brahmbhatt,2015-08-12 13:53:39-07:00,['ef3cee6d5d9d673246dd1c7d2caa44240546e228'],7,17,24,1910686,2,,,,1777
e03bf633ef79ba4ee01436dd260b72263c3b1a7e,0,G谩bor Lipt谩k,2015-08-12 18:10:06-04:00,['544e55cb8ab8878c4af500aab49bd35d4b69cd3e'],1,1,2,1910688,1,,,,1777
26ea627fb39fb84f31de773e650318a81eba8bd4,0,caofangkun,2015-08-13 10:41:23+08:00,['55ec459e35a3f404cee1c3853aca0a3635d59bdf'],5,14,19,1910707,3,0,0,1,1777
a3b29e005f11d184b8cfe6a53f75f667bf2bec68,0,Li Wang,2015-08-13 11:45:40+08:00,['d1a6f4a753661f7e825eeec0c51782462fca4d5f'],1,1,2,1910709,1,,,,1777
98818df9108919df443f5cfd24c01d4cafb3a02d,0,Jungtaek Lim,2015-08-13 17:30:51+09:00,['230438988f6b7a42eae3b146549c22db0cfe2add'],18,0,18,1910727,5,,,,1777
61f4caf5b0d3f1a7f6ee31e28eb32cb836c31ee7,0,Jungtaek Lim,2015-08-13 17:57:44+09:00,"['55ec459e35a3f404cee1c3853aca0a3635d59bdf', '26dc0390dd7d14c1f8cf4f834202ec778e5d82c0']",5,5,10,1910737,3,,,,1777
9e809035cc23f0f51aa40356ad4586ea1e168fd0,0,Jungtaek Lim,2015-08-13 18:37:28+09:00,['61f4caf5b0d3f1a7f6ee31e28eb32cb836c31ee7'],0,1,1,1910738,1,,,,1777
356e7474c9ede3c45232b39e895d554349a55328,0,ddebree,2015-08-13 13:41:36+02:00,['9e809035cc23f0f51aa40356ad4586ea1e168fd0'],65,26,91,1910829,2,0.444444444,0.944444444,0.444444444,1777
9e4c3df17ffbc737210e606d3d8a9cdae8f86634,1,ddebree,2015-08-13 15:43:17+02:00,['9e809035cc23f0f51aa40356ad4586ea1e168fd0'],50,49,99,1910928,8,,,,1777
b84981ec98af8aac0f361fe886f903380171e619,0,Kyle Nusbaum,2015-08-13 11:16:41-05:00,"['9e809035cc23f0f51aa40356ad4586ea1e168fd0', 'eb6d7383861220eaeb685206d3946899c20506ac']",0,9,9,1910937,3,,,,1777
0ce410684c296209a4913ada36a428e009bc4ce4,0,Kyle Nusbaum,2015-08-13 11:18:41-05:00,['b84981ec98af8aac0f361fe886f903380171e619'],0,1,1,1910938,1,,,,1777
237afcfbb1e17015e2271e71111b456a6d014f10,0,Derek Dagit,2015-08-13 11:30:51-05:00,"['0ce410684c296209a4913ada36a428e009bc4ce4', 'e03bf633ef79ba4ee01436dd260b72263c3b1a7e']",1,1,2,1910940,1,,,,1777
d7155d7be58acc4bf77c4f4bee3188e411fc0f99,0,Derek Dagit,2015-08-13 11:34:42-05:00,['237afcfbb1e17015e2271e71111b456a6d014f10'],0,2,2,1910942,2,,,,1777
f5fe47be95fdf5e4d766e5843c3776e97f987e3e,0,Sumit Chawla,2015-08-13 09:44:07-07:00,"['e7ef20ee40beddd028b692ffb4a9c646360f7b24', 'd7155d7be58acc4bf77c4f4bee3188e411fc0f99']",57,1361,1418,1912360,37,,,,1777
b737c2cceb9611ea10c99450c09fb1a4ad28ab02,1,YvonneIronberg,2015-08-13 13:24:26-07:00,['d7155d7be58acc4bf77c4f4bee3188e411fc0f99'],18,18,36,1912396,4,,,,1777
60e6ed73ebf54811f98ea2cd393d784804bf0b96,1,YvonneIronberg,2015-08-13 17:09:15-07:00,['b737c2cceb9611ea10c99450c09fb1a4ad28ab02'],2,8,10,1912406,3,,,,1777
c44e02b3818c572924d96ae1dc26bb6ab6df66c7,1,Arun Mahadevan,2015-08-14 11:46:54+05:18,['4d8c51b4503110f03a27b401f096ff2477bbb7cf'],5,26,31,1912437,5,1,1,1,1777
9973e47016beafed6ea23cc57619a69811c13fd8,0,Robert (Bobby) Evans,2015-08-14 08:24:46-05:00,"['d7155d7be58acc4bf77c4f4bee3188e411fc0f99', 'b815012509e15a68bdd72cc684ab5cc91dd53b86']",3,5,8,1912445,1,,,,1777
5966ff3c5c2709d51cbbf3274a0a9d0be1d8c707,0,Robert (Bobby) Evans,2015-08-14 08:33:05-05:00,['9973e47016beafed6ea23cc57619a69811c13fd8'],0,1,1,1912446,1,,,,1777
497d0af0803c2e20dcb06dc997c0b6b801e15333,0,Jungtaek Lim,2015-08-14 23:49:57+09:00,"['5966ff3c5c2709d51cbbf3274a0a9d0be1d8c707', '26ea627fb39fb84f31de773e650318a81eba8bd4']",5,14,19,1912465,3,,,,1777
80c6119ba0a646adcf791bcf9f248eeb7e482fc4,0,Jungtaek Lim,2015-08-14 23:59:13+09:00,['497d0af0803c2e20dcb06dc997c0b6b801e15333'],0,1,1,1912466,1,,,,1777
b3b3174f36f5421785a5769e2a9744678fdc984f,0,Sriharsha Chintalapani,2015-08-14 08:28:03-07:00,"['80c6119ba0a646adcf791bcf9f248eeb7e482fc4', '9fd358eb33b0f3f0d61a8a72890354eb11c5fa1c']",16,49,65,1912531,4,,,,1777
b8d5635e850ee376426cca65b39f33fa9e8ff392,0,Sriharsha Chintalapani,2015-08-14 08:40:54-07:00,['b3b3174f36f5421785a5769e2a9744678fdc984f'],0,1,1,1912532,1,,,,1777
430375c01ebfbc0342e84c5068872d13292b8edf,0,Derek Dagit,2015-08-14 12:15:14-05:00,"['b8d5635e850ee376426cca65b39f33fa9e8ff392', 'c44e02b3818c572924d96ae1dc26bb6ab6df66c7']",84,602,686,1913218,8,,,,1777
a3fa9b195d1cb3a750fa1506efe017ba393ccff3,0,Derek Dagit,2015-08-14 12:22:17-05:00,['430375c01ebfbc0342e84c5068872d13292b8edf'],0,2,2,1913220,2,,,,1777
aa308e11685b8b7945f2d4963e9f63dfd322087b,0,Derek Dagit,2015-08-14 12:57:53-05:00,"['b8d5635e850ee376426cca65b39f33fa9e8ff392', 'a3fa9b195d1cb3a750fa1506efe017ba393ccff3']",84,604,688,1913908,10,,,,1777
7ca9b1eb04d506770b5f9690301c5c91a5a5a7ae,0,YvonneIronberg,2015-08-14 11:08:20-07:00,['60e6ed73ebf54811f98ea2cd393d784804bf0b96'],2,2,4,1913912,1,,,,1777
e7088c7348e954938ddc3c1187de5e30ba495a5d,0,YvonneIronberg,2015-08-14 11:10:05-07:00,['7ca9b1eb04d506770b5f9690301c5c91a5a5a7ae'],3,3,6,1913918,1,,,,1777
f29de472a21a9f5936cb13d26cc5a36669c48164,1,Priyank,2015-08-14 12:06:16-07:00,['aa308e11685b8b7945f2d4963e9f63dfd322087b'],2,49,51,1913969,3,0.052631579,1,0.736842105,1778
de0e146423811b6d4d8b33353d6252e6c2f10da3,1,Derek Dagit,2015-08-14 15:19:03-05:00,['aa308e11685b8b7945f2d4963e9f63dfd322087b'],0,19,19,1913988,2,,,,1778
0f283f662e98a2163d20c4fd8bf719d1885edfce,0,ddebree,2015-08-14 23:03:33+02:00,['356e7474c9ede3c45232b39e895d554349a55328'],16,23,39,1914027,1,0,1,0,1778
962d57be14d81c0f9b485182f6dd73bcd84dd50d,1,YvonneIronberg,2015-08-14 16:06:28-07:00,['e7088c7348e954938ddc3c1187de5e30ba495a5d'],10,13,23,1914050,3,,,,1778
98f6cd26c5e63af03c411952b2c790564a2e7149,1,YvonneIronberg,2015-08-14 16:08:57-07:00,['962d57be14d81c0f9b485182f6dd73bcd84dd50d'],14,18,32,1914082,1,,,,1778
e9db8e2e60f61548caba4871656c7dbf758bdfaf,0,YvonneIronberg,2015-08-14 16:11:47-07:00,['98f6cd26c5e63af03c411952b2c790564a2e7149'],2,2,4,1914086,1,,,,1778
abdd8a9855ca0a1e970cee7570f630a9901b63ec,0,YvonneIronberg,2015-08-14 16:13:13-07:00,['e9db8e2e60f61548caba4871656c7dbf758bdfaf'],2,2,4,1914090,1,,,,1778
58a4a07eb3148979f787f31ed90cc9e2e91df564,1,YvonneIronberg,2015-08-14 17:20:37-07:00,['abdd8a9855ca0a1e970cee7570f630a9901b63ec'],1,1,2,1914092,1,,,,1778
0fa672f43672a01c842c7f542731b08e1e523feb,0,Arun Mahadevan,2015-08-15 09:30:43+05:18,['c8e337d13521e6ca5f83639b9a68120618750332'],1,23,24,1914116,1,,,,1778
e869d722b38b6f949e32f3cfdcaf295a05267731,0,YvonneIronberg,2015-08-15 16:38:40-07:00,['58a4a07eb3148979f787f31ed90cc9e2e91df564'],1,1,2,1914118,1,,,,1778
87fc2982e50f42e9e8261fb94228cb7ff4113f53,0,Sriharsha Chintalapani,2015-08-16 10:22:13-07:00,['f29de472a21a9f5936cb13d26cc5a36669c48164'],0,1,1,1914119,1,,,,1778
89f480941f0811c4d2f6be2ddafa509386283dd7,0,YvonneIronberg,2015-08-16 15:15:43-07:00,['e869d722b38b6f949e32f3cfdcaf295a05267731'],2,2,4,1914123,1,,,,1778
f5628534fce6b8791d373d012bb533fe32dba3ba,0,Jungtaek Lim,2015-08-17 13:34:11+09:00,['98818df9108919df443f5cfd24c01d4cafb3a02d'],48,32,80,1914203,3,1,0,0,1779
40472e001222900a4c7da395342ca7eaf88aa6df,0,Jungtaek Lim,2015-08-17 13:36:19+09:00,['f5628534fce6b8791d373d012bb533fe32dba3ba'],0,17,17,1914220,1,,,,1779
4262a194a41ab871bac8d9380d9506913601d0fa,0,rohan_agarwal,2015-08-17 10:26:02+05:18,"['84a282c48ac54ca2573464e4935cd652dd1f84a3', '87fc2982e50f42e9e8261fb94228cb7ff4113f53']",124,778,902,1915122,28,,,,1779
f8f162c95ac8deaa26a6fe97e39bfd234c542136,0,rohan_agarwal,2015-08-17 10:35:40+05:18,['4262a194a41ab871bac8d9380d9506913601d0fa'],0,3,3,1915125,1,,,,1779
2295ac2da711eb81e9c4bb34c118926d62a3b2ec,0,Jungtaek Lim,2015-08-17 18:27:08+09:00,"['87fc2982e50f42e9e8261fb94228cb7ff4113f53', '0fa672f43672a01c842c7f542731b08e1e523feb']",1,260,261,1915386,3,,,,1779
285d3288c4bdaf3793621fdac135f84234d979e6,0,Jungtaek Lim,2015-08-17 20:27:53+09:00,['2295ac2da711eb81e9c4bb34c118926d62a3b2ec'],0,1,1,1915387,1,,,,1779
4686a47cabb283037d165438a1f4c886a9e1f47a,0,Kostya Golikov,2015-08-17 16:01:37+03:00,['36366c801dc74be7111bcb2e7f5d78e6fe3570f4'],178,0,178,1915565,1,,,,1779
6f37493e13a2658c81769f1cd30c3eed8bbe3906,0,Robert (Bobby) Evans,2015-08-17 08:52:46-05:00,"['285d3288c4bdaf3793621fdac135f84234d979e6', '4686a47cabb283037d165438a1f4c886a9e1f47a']",191,0,191,1915756,2,,,,1779
e2b08ebc3545e5ca50340cb81a41f90c9fc81511,0,rohan_agarwal,2015-08-18 11:18:26+05:18,"['f8f162c95ac8deaa26a6fe97e39bfd234c542136', '6f37493e13a2658c81769f1cd30c3eed8bbe3906']",192,261,453,1916209,6,,,,1779
f6e2aa5a085341d017eefbc43d4c29bf1413e80f,0,Derek Dagit,2015-08-18 09:51:57-05:00,"['6f37493e13a2658c81769f1cd30c3eed8bbe3906', '89f480941f0811c4d2f6be2ddafa509386283dd7']",43,56,99,1916308,9,,,,1779
1b401e4cd89d8b04edf3bc9bf4ec5af61a2e533d,0,Derek Dagit,2015-08-18 09:55:21-05:00,['f6e2aa5a085341d017eefbc43d4c29bf1413e80f'],0,2,2,1916310,2,,,,1779
3b1b3bfa595851afd468594079caa7c772dafd48,0,Derek Dagit,2015-08-18 09:56:04-05:00,"['6f37493e13a2658c81769f1cd30c3eed8bbe3906', '1b401e4cd89d8b04edf3bc9bf4ec5af61a2e533d']",43,58,101,1916411,11,,,,1779
d76f0b2770c0892eb21cdb0b34bde6d51e2b7e92,0,Derek Dagit,2015-08-18 22:04:53-05:00,['e0f0ce57d443aa7fc295504e3355a7f11e05621e'],1,3,4,1916415,1,,,,1779
e6ba743eea6ca86b04cb4aa1be00818817104f97,0,Jungtaek Lim,2015-08-19 12:36:37+09:00,"['3b1b3bfa595851afd468594079caa7c772dafd48', 'd76f0b2770c0892eb21cdb0b34bde6d51e2b7e92']",0,9,9,1916424,2,,,,1779
9c941884386870b29c916e3ec0d511d2ec01a005,0,Jungtaek Lim,2015-08-19 12:38:22+09:00,['e6ba743eea6ca86b04cb4aa1be00818817104f97'],0,1,1,1916425,1,,,,1779
044ed00c38a26c5a18b806439aeade5fc2e64035,0,rohan_agarwal,2015-08-19 09:58:20+05:18,"['e2b08ebc3545e5ca50340cb81a41f90c9fc81511', '9c941884386870b29c916e3ec0d511d2ec01a005']",43,68,111,1916536,11,,,,1779
51fdc1a367dd9b8657c5245726e4edc66925cf6f,0,Parth Brahmbhatt,2015-08-19 11:03:34-07:00,"['93dbcafaa2e5e9fd4cdc9445d1104fb61ae286f2', '9c941884386870b29c916e3ec0d511d2ec01a005']",359,1082,1441,1917977,38,,,,1779
ef14347f437a6c98f019fc49e8e1a095af0c14b4,0,Boyang Jerry Peng,2015-08-20 00:21:14-05:00,['bfd34a5f46ee36e9237c0d7ea7ae4bed9dc567ee'],26,39,65,1918042,3,,,,1779
642ab9d009f0b195ce0a60ef8363f3692c2e99b5,0,Alex Panov,2015-08-20 12:24:46+02:00,['9c941884386870b29c916e3ec0d511d2ec01a005'],1,7,8,1918050,1,,,,1779
e0bee05a26d3c306a44998b9a409a4d44e5dcde7,0,Alex Panov,2015-08-20 12:26:00+02:00,['642ab9d009f0b195ce0a60ef8363f3692c2e99b5'],4,0,4,1918054,1,,,,1779
3400c7db4b70b6a61750f3d4ad1f948c49e9a34d,1,Alex Panov,2015-08-20 12:28:08+02:00,['e0bee05a26d3c306a44998b9a409a4d44e5dcde7'],27,216,243,1918297,4,1,1,1,1782
3094baf200beb513d98cea3a3ce94605e6760fe2,1,Alex Panov,2015-08-20 12:29:08+02:00,['3400c7db4b70b6a61750f3d4ad1f948c49e9a34d'],87,143,230,1918527,4,1,1,1,1783
599999246f4ce251d44c50a64423ccf8ea464b34,1,Alex Panov,2015-08-20 12:30:17+02:00,['3094baf200beb513d98cea3a3ce94605e6760fe2'],0,327,327,1918854,5,1,1,0.948453608,1788
7996697af5a1e8aa4bc63e80e04829b173d08d2d,0,Alex Panov,2015-08-20 13:07:31+02:00,['599999246f4ce251d44c50a64423ccf8ea464b34'],1,1,2,1918856,1,,,,1788
d3b9a337758329520ccef6cd73e096a4f1d59842,0,Jungtaek Lim,2015-08-20 21:29:32+09:00,"['9c941884386870b29c916e3ec0d511d2ec01a005', 'ef14347f437a6c98f019fc49e8e1a095af0c14b4']",4,49,53,1918909,3,,,,1788
cc276087bb542b92c849f099b5b636e3afddd915,0,Jungtaek Lim,2015-08-20 21:31:29+09:00,['d3b9a337758329520ccef6cd73e096a4f1d59842'],0,2,2,1918911,2,,,,1788
6491c4dd961b284fa6026f3f4df7accc1c374be2,0,rohan_agarwal,2015-08-20 19:19:02+05:18,"['044ed00c38a26c5a18b806439aeade5fc2e64035', 'cc276087bb542b92c849f099b5b636e3afddd915']",4,51,55,1918966,5,,,,1788
7b527548574719f2af7abd835cc30f097d320247,0,Alex Panov,2015-08-20 17:53:16+02:00,['7996697af5a1e8aa4bc63e80e04829b173d08d2d'],0,68,68,1919034,4,,,,1788
a2db49f1b476c5cbd0253a6cba4a29c0e3c5584e,1,Alex Panov,2015-08-20 17:53:52+02:00,['7b527548574719f2af7abd835cc30f097d320247'],3,4,7,1919041,2,,,,1788
4be31c5d1f5d7a782330772c5211f441bbc24922,0,Alex Panov,2015-08-20 18:01:31+02:00,['a2db49f1b476c5cbd0253a6cba4a29c0e3c5584e'],1,4,5,1919046,4,,,,1788
69c78ca18c62fd9142b8052c20952ed72fc42216,0,Alex Panov,2015-08-20 18:01:45+02:00,['4be31c5d1f5d7a782330772c5211f441bbc24922'],1,14,15,1919061,1,,,,1788
f73eed319a63fec6b07ecc5a9ec2d5477007cd1a,0,YvonneIronberg,2015-08-20 10:10:12-07:00,['89f480941f0811c4d2f6be2ddafa509386283dd7'],66,3,69,1919130,3,,,,1788
2169a616f7b117edf7ef654d59ecd3fa3b8dc1cc,0,Drew Robb,2015-08-21 00:31:51-07:00,['cc276087bb542b92c849f099b5b636e3afddd915'],1,1,2,1919132,1,,,,1788
8618eb336e4e84aa3aaf03f3418c9ec40be0ea1f,0,Alex Panov,2015-08-21 12:39:30+02:00,['69c78ca18c62fd9142b8052c20952ed72fc42216'],3,28,31,1919163,3,,,,1788
47a7ba12a8ca39891484d2387cce8f4bf8ecc79c,0,YvonneIronberg,2015-08-21 08:42:53-07:00,['89f480941f0811c4d2f6be2ddafa509386283dd7'],15,15,30,1919193,13,,,,1788
0c409dfc70e5db87e238658788b6a7eebd9cad60,0,Sanket,2015-08-23 12:04:48-05:00,['7bd56ae99c3c156f37ec419a24390bf472358bf8'],3,3,6,1919199,1,,,,1788
1764b867b80b0e228e2f2b867d761c1e91155673,0,Arun Mahadevan,2015-08-24 13:12:46+05:18,['35990fa28aa660b389afb00ca3ecfe38fdf519db'],58,90,148,1919347,8,1,0,1,1788
788db9d9e9dd3913e82732ca631223e0b2d39927,0,Arun Mahadevan,2015-08-24 13:34:47+05:18,['1764b867b80b0e228e2f2b867d761c1e91155673'],1,1,2,1919349,1,,,,1788
6b3cb7595e04e175305380ba665428f5b9c245b3,0,Robert (Bobby) Evans,2015-08-24 08:43:16-05:00,"['cc276087bb542b92c849f099b5b636e3afddd915', '51fdc1a367dd9b8657c5245726e4edc66925cf6f']",659,3224,3883,1923232,39,,,,1788
d4db410548aab93eec6ba745c10c64d1b0850b9a,0,Robert (Bobby) Evans,2015-08-24 08:51:04-05:00,['6b3cb7595e04e175305380ba665428f5b9c245b3'],0,1,1,1923233,1,,,,1788
d0d213b358bb33f59b59920fafafe22cc72b64c0,0,Kyle Nusbaum,2015-08-24 14:20:09-05:00,"['d4db410548aab93eec6ba745c10c64d1b0850b9a', 'f73eed319a63fec6b07ecc5a9ec2d5477007cd1a']",66,3,69,1923302,3,,,,1788
460202eed6657b6cf110b2a1cbc7aa92e0764535,0,Kyle Nusbaum,2015-08-24 14:44:21-05:00,['d0d213b358bb33f59b59920fafafe22cc72b64c0'],0,1,1,1923303,1,,,,1788
8d759b197288f854e6bd4a6a09c607cf66df88c4,0,Kyle Nusbaum,2015-08-24 15:04:32-05:00,"['460202eed6657b6cf110b2a1cbc7aa92e0764535', '0f283f662e98a2163d20c4fd8bf719d1885edfce']",52,20,72,1923375,2,,,,1788
ce6c1c389aef838dcb5f145d4af05815d62ee016,0,Kyle Nusbaum,2015-08-24 15:50:29-05:00,['8d759b197288f854e6bd4a6a09c607cf66df88c4'],0,1,1,1923376,1,,,,1788
7c38ff624833055a940d3189fa89171cd37ed169,0,Jungtaek Lim,2015-08-25 09:03:59+09:00,"['ce6c1c389aef838dcb5f145d4af05815d62ee016', 'a3b29e005f11d184b8cfe6a53f75f667bf2bec68']",2,5,7,1923383,1,,,,1788
199bb3be477ed6a373f70a70b68d5f2a3dff0844,0,Jungtaek Lim,2015-08-25 09:07:06+09:00,['7c38ff624833055a940d3189fa89171cd37ed169'],0,2,2,1923385,2,,,,1788
949da3853cfe3613ebb0fd4c4b4f6864b483f884,0,Jungtaek Lim,2015-08-25 09:23:32+09:00,['199bb3be477ed6a373f70a70b68d5f2a3dff0844'],1,1,2,1923387,1,,,,1788
d66a1b7b10d33de864f942a600f4d42bf0a43452,0,Jungtaek Lim,2015-08-25 12:03:17+09:00,"['949da3853cfe3613ebb0fd4c4b4f6864b483f884', '6491c4dd961b284fa6026f3f4df7accc1c374be2']",3,19,22,1923409,4,,,,1788
528958c27f71da4538f9bca115e3b8eda55445de,0,Jungtaek Lim,2015-08-25 12:04:50+09:00,['d66a1b7b10d33de864f942a600f4d42bf0a43452'],0,2,2,1923411,2,,,,1788
f2e3ea0eb411547802cc87a95a9b4a8f56cd9d10,0,fmazoyer,2015-08-25 14:57:59+02:00,['528958c27f71da4538f9bca115e3b8eda55445de'],8,19,27,1923438,1,1,1,0,1788
4ab6e0c02aaddbd1ad0b1334a5c458f940271827,1,Hugo Louro,2015-08-25 08:18:17-07:00,['528958c27f71da4538f9bca115e3b8eda55445de'],1,1592,1593,1925031,33,0.951219512,0.975609756,0.923959828,1819
8552f43c4704a83488c235a0a8c1cb6da883304d,1,Hugo Louro,2015-08-25 16:23:51-07:00,['4ab6e0c02aaddbd1ad0b1334a5c458f940271827'],257,834,1091,1926122,33,0.842105263,0.842105263,1,1820
4337ebe6e2398073e9a238e88bd51ca7b76b3437,0,wangli1426,2015-08-26 12:48:27+08:00,['528958c27f71da4538f9bca115e3b8eda55445de'],45,82,127,1926249,1,0.941176471,1,0.941176471,1820
f9a4b0100de2e2417296c094caf7c077e5755a0d,0,Arun Mahadevan,2015-08-26 13:38:19+05:18,['788db9d9e9dd3913e82732ca631223e0b2d39927'],137,926,1063,1927312,17,0.396449704,0.463510848,0.938856016,1821
e5265d8519158b41b8ee2490ecdd2eaf41d50c68,0,Arun Mahadevan,2015-08-26 14:50:03+05:18,['f9a4b0100de2e2417296c094caf7c077e5755a0d'],3,3,6,1927318,2,,,,1821
a062a40845a808566c8d727a654654a47e8d3eb3,0,renkai,2015-08-26 17:55:16+08:00,['528958c27f71da4538f9bca115e3b8eda55445de'],2,45,47,1927365,2,1,1,0.942857143,1821
5a1abd3bc6b1b7d6ba7532ad7b0758f143cefde3,0,Parth Brahmbhatt,2015-08-26 16:34:49-07:00,['528958c27f71da4538f9bca115e3b8eda55445de'],6,4,10,1927375,1,0,0,1,1821
612b3df8f3a0213e0b2f28834afc1b5f6ff399b1,0,Parth Brahmbhatt,2015-08-26 16:37:18-07:00,['528958c27f71da4538f9bca115e3b8eda55445de'],0,12,12,1927387,2,,,,1821
c5d77ace8fa0cb2a11a0672941f2e9fa655aef4c,0,renkai,2015-08-27 08:59:14+08:00,['a062a40845a808566c8d727a654654a47e8d3eb3'],6,8,14,1927401,2,0,1,0.5,1821
76748f863877d77b4f10f07323f06d230320a6a3,0,Sriharsha Chintalapani,2015-08-27 09:54:14-07:00,['8552f43c4704a83488c235a0a8c1cb6da883304d'],0,14,14,1927415,1,,,,1821
eb6107b9351498378ce077e9ab4e43e0e6fbef49,0,Sriharsha Chintalapani,2015-08-27 09:55:14-07:00,['76748f863877d77b4f10f07323f06d230320a6a3'],0,1,1,1927416,1,,,,1821
95985c58149369da63718cd05ecf62a5c19f4302,0,Jungtaek Lim,2015-08-28 07:09:05+09:00,"['eb6107b9351498378ce077e9ab4e43e0e6fbef49', '8618eb336e4e84aa3aaf03f3418c9ec40be0ea1f']",119,803,922,1928338,15,,,,1821
59ed4d23c19b0a4be42e56d415c8f0850a2b3ef2,0,Jungtaek Lim,2015-08-28 07:10:50+09:00,['eb6107b9351498378ce077e9ab4e43e0e6fbef49'],0,2,2,1928340,2,,,,1821
4faee0e29d3698b9623209c248c4ab1ddd992518,0,Jungtaek Lim,2015-08-28 07:12:30+09:00,"['59ed4d23c19b0a4be42e56d415c8f0850a2b3ef2', '95985c58149369da63718cd05ecf62a5c19f4302']",119,803,922,1929262,15,,,,1821
2819989001fe0352aa65201192358cdc69fc9356,0,Jungtaek Lim,2015-08-28 07:31:00+09:00,"['40472e001222900a4c7da395342ca7eaf88aa6df', '4faee0e29d3698b9623209c248c4ab1ddd992518']",1251,7395,8646,1937908,127,,,,1821
07e0ff2e206a0e0ca96da9137ebbd3fc7a5e9c8b,0,Jungtaek Lim,2015-08-28 07:32:09+09:00,['2819989001fe0352aa65201192358cdc69fc9356'],0,1,1,1937909,1,,,,1821
f8118e0854e49d70e75707e96ddb6524dff2a930,0,wangjiasheng,2015-08-28 17:28:37+08:00,['07e0ff2e206a0e0ca96da9137ebbd3fc7a5e9c8b'],6,86,92,1938001,2,0.266666667,0.333333333,1,1822
6a54fdb2e617723ca36a82258ba562fd7fadb29f,0,Alex Panov,2015-08-28 17:35:39+02:00,['8618eb336e4e84aa3aaf03f3418c9ec40be0ea1f'],83,188,271,1938272,19,1,1,1,1824
ae0f814d589f718c4f989adffccea9b24bbfd3cf,0,Alex Panov,2015-08-30 11:48:37+02:00,"['6a54fdb2e617723ca36a82258ba562fd7fadb29f', '07e0ff2e206a0e0ca96da9137ebbd3fc7a5e9c8b']",843,5721,6564,1944836,95,,,,1824
677d3c5d601ccd954982d8753fa0a67a21ca3694,0,Alex Panov,2015-08-30 12:11:28+02:00,['ae0f814d589f718c4f989adffccea9b24bbfd3cf'],9,11,20,1944856,7,,,,1824
499f891153c575b46f6b69a233f8e9e99e2183e4,0,Alex Panov,2015-08-30 12:14:10+02:00,['677d3c5d601ccd954982d8753fa0a67a21ca3694'],4,21,25,1944881,2,1,1,1,1825
189ba57eb11854c1cd3db7b54ad8dd341c534b58,0,Alex Panov,2015-08-30 12:22:07+02:00,['499f891153c575b46f6b69a233f8e9e99e2183e4'],18,19,37,1944918,1,,,,1825
539ea98a1d12d516b04b9aabf7af807cede3b632,0,Sriharsha Chintalapani,2015-08-30 07:52:02-07:00,"['07e0ff2e206a0e0ca96da9137ebbd3fc7a5e9c8b', '612b3df8f3a0213e0b2f28834afc1b5f6ff399b1']",0,12,12,1944930,2,,,,1825
bf5c35ba49e5653b661a28a8273e0248d50c7fdf,0,Sriharsha Chintalapani,2015-08-30 07:52:50-07:00,['539ea98a1d12d516b04b9aabf7af807cede3b632'],0,1,1,1944931,1,,,,1825
1469c647799c2d9d644c40e078fc0d533f568699,0,Alex Panov,2015-08-31 10:55:24+02:00,['189ba57eb11854c1cd3db7b54ad8dd341c534b58'],6,18,24,1944955,3,,,,1825
4f53fc4c7171c832b53ce9c6606d0cc7da208037,0,Alex Panov,2015-08-31 12:13:47+02:00,['1469c647799c2d9d644c40e078fc0d533f568699'],0,17,17,1944972,1,,,,1825
fff82fd8d4e72993af61c2ca6725dcd4a9af2d1f,0,Alex Panov,2015-08-31 17:31:44+02:00,['4f53fc4c7171c832b53ce9c6606d0cc7da208037'],5,4,9,1944981,1,,,,1825
25aecf17002b04c43ac258f3ef027f67a3de60df,0,Jungtaek Lim,2015-09-01 22:22:45+09:00,"['bf5c35ba49e5653b661a28a8273e0248d50c7fdf', 'fff82fd8d4e72993af61c2ca6725dcd4a9af2d1f']",105,257,362,1945343,22,,,,1825
436878128310afda4519e625c5db0339b889b811,0,Jungtaek Lim,2015-09-01 22:31:30+09:00,['25aecf17002b04c43ac258f3ef027f67a3de60df'],0,1,1,1945344,1,,,,1825
3b8db7adc64750a33694fad8ae7080dc83623d17,1,wangli1426,2015-09-01 22:42:00+08:00,['154e9ec55deb4eea8fca8554e4d3b224bf337834'],4,135,139,1945483,2,1,1,0.714285714,1826
11886c0c4c3aa2547b1ef571712bed83229dc4e4,0,Kyle Nusbaum,2015-09-01 12:13:05-05:00,['436878128310afda4519e625c5db0339b889b811'],15,22,37,1945520,1,0.333333333,0.333333333,1,1826
3783f4e6669d185d5a0fd42468347238350c2774,0,Kyle Nusbaum,2015-09-01 12:37:01-05:00,['11886c0c4c3aa2547b1ef571712bed83229dc4e4'],3,3,6,1945526,1,,,,1826
e3bfe5a7d2f722825315a52e4542695cecf0f78f,0,Jungtaek Lim,2015-09-02 05:48:00+09:00,"['436878128310afda4519e625c5db0339b889b811', '0c409dfc70e5db87e238658788b6a7eebd9cad60']",3,3,6,1945532,1,,,,1826
e272cfe53febdcae4b63cda9e6f78843e61aa447,0,Jungtaek Lim,2015-09-02 05:49:23+09:00,['e3bfe5a7d2f722825315a52e4542695cecf0f78f'],0,2,2,1945534,2,,,,1826
fbc499af3e807d88525d9334c2bec4c96bdaea56,0,Jungtaek Lim,2015-09-02 06:01:29+09:00,"['e272cfe53febdcae4b63cda9e6f78843e61aa447', '2169a616f7b117edf7ef654d59ecd3fa3b8dc1cc']",1,1,2,1945536,1,,,,1826
33b593aaa35f788889c01f30c69d359f58d0d871,0,Jungtaek Lim,2015-09-02 06:09:42+09:00,['e272cfe53febdcae4b63cda9e6f78843e61aa447'],0,2,2,1945538,2,,,,1826
934a23bfe11927c63c53059fe156ccca5467d443,0,Jungtaek Lim,2015-09-02 06:11:15+09:00,"['33b593aaa35f788889c01f30c69d359f58d0d871', 'fbc499af3e807d88525d9334c2bec4c96bdaea56']",1,1,2,1945540,1,,,,1826
8882acbe956086bac7893e9954f3638220b39083,0,Jungtaek Lim,2015-09-02 06:24:15+09:00,['934a23bfe11927c63c53059fe156ccca5467d443'],1,1,2,1945542,1,,,,1826
203a2d4dceb320300ef43258bc0f9788db6ade46,0,Jungtaek Lim,2015-09-02 06:27:22+09:00,"['8882acbe956086bac7893e9954f3638220b39083', '47a7ba12a8ca39891484d2387cce8f4bf8ecc79c']",15,15,30,1945572,13,,,,1826
1cfbedfba1f9410043346672c0445beb55638493,0,Jungtaek Lim,2015-09-02 06:39:49+09:00,['203a2d4dceb320300ef43258bc0f9788db6ade46'],0,1,1,1945573,1,,,,1826
394cbcf7be5be90f33561ca59c4932d4f4db3bf6,0,Jungtaek Lim,2015-09-02 06:49:12+09:00,"['1cfbedfba1f9410043346672c0445beb55638493', 'f2e3ea0eb411547802cc87a95a9b4a8f56cd9d10']",8,19,27,1945600,1,,,,1826
c559f421a57d4494d6b46e848c84b8b844281b7f,0,Jungtaek Lim,2015-09-02 06:50:41+09:00,['394cbcf7be5be90f33561ca59c4932d4f4db3bf6'],0,2,2,1945602,2,,,,1826
f86b3cd5827ebb7ae27b07a419bd01cd3d6b80e3,0,Jungtaek Lim,2015-09-02 07:10:25+09:00,"['c559f421a57d4494d6b46e848c84b8b844281b7f', '9e4c3df17ffbc737210e606d3d8a9cdae8f86634']",50,49,99,1945701,8,,,,1826
3ff465c5c0720f6c9701b2b7b807a94c92533817,0,Jungtaek Lim,2015-09-02 07:19:29+09:00,['f86b3cd5827ebb7ae27b07a419bd01cd3d6b80e3'],0,2,2,1945703,2,,,,1826
cce0362713102c8620b98e69ad1da9aa6ba6b3c4,0,Jungtaek Lim,2015-09-02 07:22:03+09:00,"['3ff465c5c0720f6c9701b2b7b807a94c92533817', '4337ebe6e2398073e9a238e88bd51ca7b76b3437']",45,82,127,1945830,1,,,,1826
fec4b53fef52dfe47b9db7e626733b8981e0fdd5,0,Jungtaek Lim,2015-09-02 07:38:51+09:00,['cce0362713102c8620b98e69ad1da9aa6ba6b3c4'],0,1,1,1945831,1,,,,1826
1b2bba952a5285738d4793122a9a5b4a7e3ad94e,0,Jungtaek Lim,2015-09-02 07:45:23+09:00,"['fec4b53fef52dfe47b9db7e626733b8981e0fdd5', 'c5d77ace8fa0cb2a11a0672941f2e9fa655aef4c']",2,47,49,1945880,2,,,,1826
154e9ec55deb4eea8fca8554e4d3b224bf337834,0,Jungtaek Lim,2015-09-02 08:03:42+09:00,['1b2bba952a5285738d4793122a9a5b4a7e3ad94e'],0,2,2,1945882,2,,,,1826
38e85b71b8207bf257b0bdf587e89be87bb7ab17,1,Aaron Coburn,2015-09-01 19:06:50-04:00,['fec4b53fef52dfe47b9db7e626733b8981e0fdd5'],1,1,2,1945884,1,,,,1826
2631e88bdf86d265e9ddfce5e413b455ff8303c6,1,Aaron Dossett,2015-09-02 07:55:46-05:00,['bf5c35ba49e5653b661a28a8273e0248d50c7fdf'],34,407,441,1946325,3,0.742268041,0.731958763,0.845360825,1827
d03caab09307af5f8960f33632006b5ff18941ef,0,wangli1426,2015-09-02 22:43:51+08:00,['3b8db7adc64750a33694fad8ae7080dc83623d17'],0,62,62,1946387,1,1,1,1,1828
6c2b754a7a0c69852850c4dd39af31ba98ef847d,0,Arun Mahadevan,2015-09-02 10:31:13-07:00,['154e9ec55deb4eea8fca8554e4d3b224bf337834'],0,1,1,1946388,1,,,,1828
272a9c6ba73e609e9f503638ef7258021681365c,0,wangli1426,2015-09-03 22:45:17+08:00,['d03caab09307af5f8960f33632006b5ff18941ef'],3,31,34,1946422,1,1,1,1,1828
f15ac94d259a96ac891f5243af29b0d953ea863d,0,wangli1426,2015-09-03 23:00:31+08:00,['272a9c6ba73e609e9f503638ef7258021681365c'],3,11,14,1946436,2,1,1,1,1828
0151b441b0a68d490074d415d408caa522e47ffb,0,Arun Mahadevan,2015-09-03 11:39:02-07:00,"['e5265d8519158b41b8ee2490ecdd2eaf41d50c68', '154e9ec55deb4eea8fca8554e4d3b224bf337834']",2431,9012,11443,1957879,178,,,,1828
cec7ff9be618951ed91f3b8183c52e6bc6a6bd28,0,Arun Mahadevan,2015-09-03 13:31:53-07:00,['0151b441b0a68d490074d415d408caa522e47ffb'],3,3,6,1957885,1,,,,1828
3144a533b7ae069cd23483544cc58fa962d88fda,0,Abhishek Agarwal,2015-09-04 17:03:02+05:18,['154e9ec55deb4eea8fca8554e4d3b224bf337834'],33,38,71,1957956,1,,,,1828
7a0c3eeeb5fbcbc5c32d47cca692cec103a68244,0,Derek Dagit,2015-09-04 12:24:43-05:00,['6b606cf68f60858bdc9064c1fe50c873e6dd1971'],1,1,2,1957958,1,,,,1828
ff1962af41f6b3a54e48aee761778ec9ac9c3ef0,0,Rick Kellogg,2015-09-04 17:18:25-04:00,['154e9ec55deb4eea8fca8554e4d3b224bf337834'],1,1,2,1957960,1,,,,1828
ff9142dd09c41a1be3ea628a209e93036f20351d,0,Jungtaek Lim,2015-09-05 09:04:03+09:00,['154e9ec55deb4eea8fca8554e4d3b224bf337834'],1,1,2,1957962,1,,,,1828
7b4e3733bdd47466b4198271e6bf03369531a886,0,Jungtaek Lim,2015-09-05 10:40:39+09:00,"['ff9142dd09c41a1be3ea628a209e93036f20351d', '3783f4e6669d185d5a0fd42468347238350c2774']",15,22,37,1957999,1,,,,1828
260830e33d83b065365fef6fdcc41dacd2a45f41,0,Jungtaek Lim,2015-09-05 10:48:33+09:00,['7b4e3733bdd47466b4198271e6bf03369531a886'],0,1,1,1958000,1,,,,1828
860a2baf97b12ca6f6250f9361c612597c97cc99,0,Jungtaek Lim,2015-09-05 22:13:32+09:00,"['260830e33d83b065365fef6fdcc41dacd2a45f41', '38e85b71b8207bf257b0bdf587e89be87bb7ab17']",1,1,2,1958002,1,,,,1828
371ff01b66089e2189f59e36439d8c4863f7858a,0,Jungtaek Lim,2015-09-05 22:14:46+09:00,['860a2baf97b12ca6f6250f9361c612597c97cc99'],0,2,2,1958004,2,,,,1828
f28af68a5b3552be0f71dddf59a6eeec917729cc,0,Jungtaek Lim,2015-09-05 22:28:51+09:00,"['371ff01b66089e2189f59e36439d8c4863f7858a', '6c2b754a7a0c69852850c4dd39af31ba98ef847d']",0,1,1,1958005,1,,,,1828
a365b66d6589e7d9ceb850252e592e495258799a,0,Jungtaek Lim,2015-09-05 22:30:10+09:00,['f28af68a5b3552be0f71dddf59a6eeec917729cc'],0,1,1,1958006,1,,,,1828
8b7c11363026981090c87c584b2c04b37a64c267,0,Jungtaek Lim,2015-09-05 23:34:23+09:00,['a365b66d6589e7d9ceb850252e592e495258799a'],0,2,2,1958008,1,,,,1828
62aa468749255da409e7365b080e9a22f40ed58a,0,Jungtaek Lim,2015-09-05 23:44:59+09:00,['8b7c11363026981090c87c584b2c04b37a64c267'],26,121,147,1958155,2,,,,1828
895ba4251570ae4c8857ccd00b91af80cf51e957,0,Jungtaek Lim,2015-09-05 23:47:36+09:00,['62aa468749255da409e7365b080e9a22f40ed58a'],0,2,2,1958157,2,,,,1828
f3d60bdfe2457aec0bffe59adef6df72d5fee608,0,Rick Kellogg,2015-09-05 11:27:32-04:00,"['ff1962af41f6b3a54e48aee761778ec9ac9c3ef0', '895ba4251570ae4c8857ccd00b91af80cf51e957']",44,155,199,1958356,8,,,,1828
180c51d0cf1017c872e87845cc356b8803e978cf,1,renkai,2015-09-06 11:47:02+08:00,['895ba4251570ae4c8857ccd00b91af80cf51e957'],6,21,27,1958383,3,,,,1828
0dbe4aed0f74430ec0008974895b1104794ad8d1,1,renkai,2015-09-06 13:07:09+08:00,['180c51d0cf1017c872e87845cc356b8803e978cf'],1,1,2,1958385,1,,,,1828
f55f7a7e57f382b91a700daeeb292580fcf9da7d,1,ddebree,2015-09-06 16:27:29+02:00,['895ba4251570ae4c8857ccd00b91af80cf51e957'],38,37,75,1958460,22,0,0,0,1828
473323e5a94a36c9f14fe84053f66ea64e6f8d8e,0,Stephen Hopper,2015-09-07 13:06:57-05:00,['895ba4251570ae4c8857ccd00b91af80cf51e957'],23,23,46,1958506,1,,,,1828
4db2e368c94a65e59f786f7b70afa3ff97e5316a,0,Jungtaek Lim,2015-09-08 07:02:25+09:00,['895ba4251570ae4c8857ccd00b91af80cf51e957'],0,1,1,1958507,1,,,,1828
8eb4509d94395ce8c5745a24e1b6980b23d81bcd,0,Jungtaek Lim,2015-09-08 07:04:54+09:00,['4db2e368c94a65e59f786f7b70afa3ff97e5316a'],0,1,1,1958508,1,,,,1828
a4dc5fe2379a611f5c66df4e9bf77eaf507b51de,0,renkai,2015-09-08 14:26:41+08:00,['0dbe4aed0f74430ec0008974895b1104794ad8d1'],0,21,21,1958529,1,,,,1828
646bac2be59b8f51ff46307b2bfc3d540a28680d,0,Xinze Chi,2015-09-08 17:58:58+08:00,['8eb4509d94395ce8c5745a24e1b6980b23d81bcd'],1,1,2,1958531,1,,,,1828
96c7702bc3c0060d8a349f33987768f789264ec9,1,Bryan Shell,2015-09-08 09:29:36-05:00,['154e9ec55deb4eea8fca8554e4d3b224bf337834'],3,10,13,1958544,1,1,0,1,1828
088c244cd4cd031ea6226842d6f49e94c1370821,0,Sumit Chawla,2015-09-08 19:41:40-07:00,"['f5fe47be95fdf5e4d766e5843c3776e97f987e3e', '8eb4509d94395ce8c5745a24e1b6980b23d81bcd']",1534,8189,9723,1968267,162,,,,1828
62d30a04371f52ba5cd29279d8dd7e9f19954d8c,0,Abhishek Agarwal,2015-09-09 18:41:04+05:18,['3144a533b7ae069cd23483544cc58fa962d88fda'],11,11,22,1968289,1,,,,1828
ea868a4f0a5af6ad43941ad0ecc09aaa0d0ec498,0,Arun Mahadevan,2015-09-10 00:17:39-07:00,['cec7ff9be618951ed91f3b8183c52e6bc6a6bd28'],12,15,27,1968316,8,1,1,1,1828
4c9506773441ce281fbe83f26ad21da05d19c4d9,0,Sriharsha Chintalapani,2015-09-11 07:09:57-07:00,"['8eb4509d94395ce8c5745a24e1b6980b23d81bcd', '473323e5a94a36c9f14fe84053f66ea64e6f8d8e']",23,23,46,1968362,1,,,,1828
bdb5e3e21f6c64986d2d9e63c0601f13ae2db55c,0,Sumit Chawla,2015-09-11 10:01:18-07:00,"['088c244cd4cd031ea6226842d6f49e94c1370821', '4c9506773441ce281fbe83f26ad21da05d19c4d9']",23,23,46,1968408,1,,,,1828
b6e40dbb7ec3e4e9e8e0d2cff12381d6acdaa8ef,0,Sriharsha Chintalapani,2015-09-12 08:40:42-07:00,"['4c9506773441ce281fbe83f26ad21da05d19c4d9', '5a1abd3bc6b1b7d6ba7532ad7b0758f143cefde3']",6,4,10,1968418,1,,,,1828
0a5426e7c3796535dc9caf2163dc3944868581a9,0,Sriharsha Chintalapani,2015-09-12 08:59:03-07:00,['b6e40dbb7ec3e4e9e8e0d2cff12381d6acdaa8ef'],0,1,1,1968419,1,,,,1828
a019d504dff6492e4b5a18387b7281a918dca0e9,0,lispking,2015-09-14 22:03:30+08:00,['0a5426e7c3796535dc9caf2163dc3944868581a9'],0,2,2,1968421,1,0,1,1,1828
38139303f6777e978516e9d4ad884220d9aad38b,0,Erik Weathers,2015-09-14 13:46:36-07:00,['0a5426e7c3796535dc9caf2163dc3944868581a9'],1,2,3,1968424,1,,,,1828
a89b7ff4b7c96f7998e3a0c673937f9ddefd59c9,0,Priyank,2015-09-14 23:27:01-07:00,['8eb4509d94395ce8c5745a24e1b6980b23d81bcd'],4,7,11,1968435,1,0,0,0,1828
41c896708cd3c9d48005580e5e71e285597d5539,1,Erik Weathers,2015-09-15 00:51:07-07:00,['0a5426e7c3796535dc9caf2163dc3944868581a9'],120,124,244,1968679,1,,,,1828
c30f525e9e5662887888c7a8bfca0592a77ec8cd,1,Karl-Philipp Richter,2015-09-16 00:25:24+02:00,['0a5426e7c3796535dc9caf2163dc3944868581a9'],0,19,19,1968698,1,,,,1828
e78fcd7ff25cf67e840b922388d33c529fcaa73a,0,Karl-Philipp Richter,2015-09-16 01:01:59+02:00,['c30f525e9e5662887888c7a8bfca0592a77ec8cd'],0,2,2,1968700,1,,,,1828
a99fae0fa0aeb8922ce6cb36962b03bc79210730,0,chenyuzhao,2015-09-16 16:05:02+08:00,['0a5426e7c3796535dc9caf2163dc3944868581a9'],0,1,1,1968701,1,,,,1828
8ed57abb5a13cf59a66fb7eb3339b27ec2fe3e60,0,mjsax,2015-09-16 10:20:07+02:00,['0a5426e7c3796535dc9caf2163dc3944868581a9'],20,70,90,1968791,3,1,1,0.6,1829
5f98cd2c1754b3b1b1844d83fd4eb1fb18588fe4,0,Jungtaek Lim,2015-09-17 07:19:02+09:00,"['e78fcd7ff25cf67e840b922388d33c529fcaa73a', '62d30a04371f52ba5cd29279d8dd7e9f19954d8c']",44,49,93,1968884,1,,,,1829
7f445d7d8383eecc6436b37e31f803bb45370df9,0,Jungtaek Lim,2015-09-17 07:22:14+09:00,['5f98cd2c1754b3b1b1844d83fd4eb1fb18588fe4'],0,2,2,1968886,2,,,,1829
ae1b8816b06e99d860784a195dca68055c23b6bb,0,Jungtaek Lim,2015-09-18 07:29:16+09:00,"['7f445d7d8383eecc6436b37e31f803bb45370df9', 'f15ac94d259a96ac891f5243af29b0d953ea863d']",5,234,239,1969125,3,,,,1829
a5a7ba181017413674c4edaf09cf003dfe8c8e62,0,Jungtaek Lim,2015-09-18 07:37:08+09:00,['ae1b8816b06e99d860784a195dca68055c23b6bb'],0,1,1,1969126,1,,,,1829
ed5ba74a9566b252ebabad7a1c1435d401dbc9d2,0,Jungtaek Lim,2015-09-18 10:11:00+09:00,['a5a7ba181017413674c4edaf09cf003dfe8c8e62'],1,1,2,1969128,1,,,,1829
9b647476f3fa83b5be4a149a6d597cd438eea5f9,0,Sriharsha Chintalapani,2015-09-17 19:26:59-07:00,"['ed5ba74a9566b252ebabad7a1c1435d401dbc9d2', '646bac2be59b8f51ff46307b2bfc3d540a28680d']",1,1,2,1969130,1,,,,1829
53516452569e1506b04e4d53bf881b95b0f171da,0,renkai,2015-09-18 10:49:18+08:00,['a4dc5fe2379a611f5c66df4e9bf77eaf507b51de'],19,14,33,1969163,1,,,,1829
4523e54eba2ca7cf4b95aa664daa175fa0ae8185,0,Sriharsha Chintalapani,2015-09-17 21:22:06-07:00,['9b647476f3fa83b5be4a149a6d597cd438eea5f9'],0,1,1,1969164,1,,,,1829
df417e0aa1439c0619e905ee0e624aa0a9717f1e,0,Xin Wang,2015-09-18 13:58:06+08:00,['4523e54eba2ca7cf4b95aa664daa175fa0ae8185'],22,23,45,1969209,1,0,1,1,1829
5c38b91accb9b9f5adfeea412bac0e457508f492,0,Xin Wang,2015-09-18 14:05:21+08:00,['df417e0aa1439c0619e905ee0e624aa0a9717f1e'],4,4,8,1969217,1,,,,1829
be7f2ad1d9b6be1a92fb2a8775822b5752703c89,0,Xin Wang,2015-09-18 15:19:44+08:00,['4523e54eba2ca7cf4b95aa664daa175fa0ae8185'],7,9,16,1969233,1,,,,1829
8b845392e920d753eb24fcffead0263416bc6227,0,Michael Schonfeld,2015-09-18 12:31:32-04:00,['4523e54eba2ca7cf4b95aa664daa175fa0ae8185'],1,1,2,1969235,1,,,,1829
f64121b6e9b91f6433f6804d9a039e96185a8297,1,zhuol,2015-09-18 11:53:02-05:00,['4523e54eba2ca7cf4b95aa664daa175fa0ae8185'],20,515,535,1969770,12,0.53271028,0.757009346,0.897196262,1832
cf5051872682b38137a9b297e80498c78f631685,0,zhuol,2015-09-18 11:53:56-05:00,['f64121b6e9b91f6433f6804d9a039e96185a8297'],0,26,26,1969796,1,,,,1833
5374036ed5764435f5eba6e265c036a97788db6c,1,zhuol,2015-09-18 12:23:43-05:00,['cf5051872682b38137a9b297e80498c78f631685'],59,32,91,1969887,8,,,,1833
1927ccf1fe51c5b387036dfff032cb584663da61,0,Robert (Bobby) Evans,2015-09-18 14:28:02-05:00,"['4523e54eba2ca7cf4b95aa664daa175fa0ae8185', '5374036ed5764435f5eba6e265c036a97788db6c']",20,514,534,1970421,13,,,,1833
e85921035fa9bb59d25f0347dc6d26002aac9fab,0,Robert (Bobby) Evans,2015-09-18 14:29:13-05:00,['1927ccf1fe51c5b387036dfff032cb584663da61'],0,1,1,1970422,1,,,,1833
992bd62b4c80b5fd7e790751513fce3bad243114,0,Jungtaek Lim,2015-09-19 08:34:19+09:00,"['e85921035fa9bb59d25f0347dc6d26002aac9fab', '53516452569e1506b04e4d53bf881b95b0f171da']",12,43,55,1970477,4,,,,1833
87b9b3ab060aad5e788195c05d166deb861b4aa1,0,Jungtaek Lim,2015-09-19 09:00:55+09:00,['992bd62b4c80b5fd7e790751513fce3bad243114'],0,1,1,1970478,1,,,,1833
e48e03c6fe65a0dc9e7a7f169fd3540af7f867fa,0,Jungtaek Lim,2015-09-19 09:05:34+09:00,"['87b9b3ab060aad5e788195c05d166deb861b4aa1', 'f55f7a7e57f382b91a700daeeb292580fcf9da7d']",38,37,75,1970553,22,,,,1833
fc398c6a28f138fb865ff1ba11bcb07bbd5b50fe,0,Jungtaek Lim,2015-09-19 09:52:14+09:00,['e48e03c6fe65a0dc9e7a7f169fd3540af7f867fa'],0,1,1,1970554,1,,,,1833
1a440808fb13df87d7e9f70b00cb567043112096,0,Jungtaek Lim,2015-09-19 10:34:23+09:00,"['fc398c6a28f138fb865ff1ba11bcb07bbd5b50fe', 'a99fae0fa0aeb8922ce6cb36962b03bc79210730']",0,1,1,1970555,1,,,,1833
2bb41a95ec9f20f6cbb11176d0c156bb9ecffa99,0,Jungtaek Lim,2015-09-19 10:44:30+09:00,['1a440808fb13df87d7e9f70b00cb567043112096'],0,2,2,1970557,2,,,,1833
809b6c9f345a3a006c7eeaf58247103ac0efb098,0,Michael Schonfeld,2015-09-19 01:55:09-04:00,['8b845392e920d753eb24fcffead0263416bc6227'],1,1,2,1970559,1,,,,1833
dc6d559b4957898ea96cca3df2910faea0e296a1,0,Arun Mahadevan,2015-09-19 16:23:37+05:18,"['ea868a4f0a5af6ad43941ad0ecc09aaa0d0ec498', '2bb41a95ec9f20f6cbb11176d0c156bb9ecffa99']",190,1091,1281,1971840,53,,,,1833
c567c52399cc3579239a75c4853d0ad17b6640ff,1,Sriharsha Chintalapani,2015-09-19 09:41:33-07:00,['2bb41a95ec9f20f6cbb11176d0c156bb9ecffa99'],1,1,2,1971842,1,,,,1833
0e680b36decffaacf5683e5564b8542cbbfec5d4,0,Arun Mahadevan,2015-09-19 23:20:47+05:18,['dc6d559b4957898ea96cca3df2910faea0e296a1'],2,2,4,1971846,1,,,,1833
2bda1af3656351aa08524ec3e1824f2a8ed62b6e,0,Randy Gelhausen,2015-09-19 17:52:29-04:00,['2bb41a95ec9f20f6cbb11176d0c156bb9ecffa99'],3,5,8,1971854,1,,,,1833
4ccbc6a82ffa3cc0f41b7273f441b051ba00dc47,0,Jungtaek Lim,2015-09-21 06:55:31+09:00,"['2bb41a95ec9f20f6cbb11176d0c156bb9ecffa99', '809b6c9f345a3a006c7eeaf58247103ac0efb098']",1,1,2,1971856,1,,,,1833
acd048a4089167905e7a447b398bbbbedc277462,0,Jungtaek Lim,2015-09-21 06:58:25+09:00,['4ccbc6a82ffa3cc0f41b7273f441b051ba00dc47'],0,2,2,1971858,2,,,,1833
4ad30fc48caa6929179c4be07feebc08c8990dec,0,Randy Gelhausen,2015-09-20 18:02:18-04:00,['2bda1af3656351aa08524ec3e1824f2a8ed62b6e'],2,2,4,1971862,1,,,,1833
46fab37aa32b7ade3f21cd153bf17a4834854af6,0,Jungtaek Lim,2015-09-21 07:09:58+09:00,"['acd048a4089167905e7a447b398bbbbedc277462', '4ad30fc48caa6929179c4be07feebc08c8990dec']",1,3,4,1971866,1,,,,1833
18acb8afa2752d1e8d7fee3ea127e5fa91887ece,0,Jungtaek Lim,2015-09-21 07:11:35+09:00,['46fab37aa32b7ade3f21cd153bf17a4834854af6'],0,1,1,1971867,1,,,,1833
7b35ac65b4a5f2c6b2db39a50e59884a130c529b,0,Randy Gelhausen,2015-09-20 18:19:57-04:00,['4ad30fc48caa6929179c4be07feebc08c8990dec'],1,1,2,1971869,1,,,,1833
cf61b46319469bd4ac223be6859f061ad9c197e4,0,Jungtaek Lim,2015-09-21 07:47:10+09:00,"['18acb8afa2752d1e8d7fee3ea127e5fa91887ece', '8ed57abb5a13cf59a66fb7eb3339b27ec2fe3e60']",20,70,90,1971959,3,,,,1833
2d871005ff8fa0fffc4b7f47a5f564df73c8842c,0,Jungtaek Lim,2015-09-21 08:12:04+09:00,['cf61b46319469bd4ac223be6859f061ad9c197e4'],0,2,2,1971961,2,,,,1833
1e4d22579e32ed3bffcd20b91f66a4e205c848ea,0,Jungtaek Lim,2015-09-21 09:46:50+09:00,"['46fab37aa32b7ade3f21cd153bf17a4834854af6', '7b35ac65b4a5f2c6b2db39a50e59884a130c529b']",1,1,2,1971963,1,,,,1833
8946a4af4beb6c320b7dddad8ead01eb03e978d5,0,Jungtaek Lim,2015-09-21 09:47:03+09:00,"['2d871005ff8fa0fffc4b7f47a5f564df73c8842c', '1e4d22579e32ed3bffcd20b91f66a4e205c848ea']",1,1,2,1971965,1,,,,1833
ca52c26684b4610ddc05306de7a9391c1bba2285,0,Jungtaek Lim,2015-09-21 09:47:41+09:00,['8946a4af4beb6c320b7dddad8ead01eb03e978d5'],1,1,2,1971967,1,,,,1833
d9c9b0b4c09ac053918fc854b08b6470b921e256,0,Jungtaek Lim,2015-09-21 23:06:05+09:00,"['ca52c26684b4610ddc05306de7a9391c1bba2285', '38139303f6777e978516e9d4ad884220d9aad38b']",1,2,3,1971970,1,,,,1833
7e69ff4aa3e2f1fe46c59ed8251bb83d21d42415,0,Jungtaek Lim,2015-09-21 23:07:47+09:00,['d9c9b0b4c09ac053918fc854b08b6470b921e256'],0,2,2,1971972,2,,,,1833
9b02b83c68f117270e2e6d96e41d121f430c162c,0,Jungtaek Lim,2015-09-22 00:13:34+09:00,"['7e69ff4aa3e2f1fe46c59ed8251bb83d21d42415', '96c7702bc3c0060d8a349f33987768f789264ec9']",3,10,13,1971985,1,,,,1833
55b88dfa47e6c772ce42d4026759d38baab3b917,0,Jungtaek Lim,2015-09-22 00:15:59+09:00,['9b02b83c68f117270e2e6d96e41d121f430c162c'],0,2,2,1971987,2,,,,1833
f073af45651f8a258c6632f76c9c461827ffd949,0,Jungtaek Lim,2015-09-22 00:22:26+09:00,"['55b88dfa47e6c772ce42d4026759d38baab3b917', 'cdc9de4343ba4782dfea29495359b231dee73501']",1,27,28,1972015,2,,,,1833
3ec5120558ffe2a34a52bf28fb600c2a67823786,0,Jungtaek Lim,2015-09-22 00:23:07+09:00,['f073af45651f8a258c6632f76c9c461827ffd949'],0,1,1,1972016,1,,,,1833
05de790097452a257a46873b63f8a6a55a1fcba3,0,Sriharsha Chintalapani,2015-09-21 10:13:27-07:00,"['3ec5120558ffe2a34a52bf28fb600c2a67823786', '0e680b36decffaacf5683e5564b8542cbbfec5d4']",1024,4123,5147,1977163,43,,,,1833
206e7283a7752f6a57154e70e369733a7df37fa1,0,Sriharsha Chintalapani,2015-09-21 10:34:06-07:00,['05de790097452a257a46873b63f8a6a55a1fcba3'],0,1,1,1977164,1,,,,1833
38a2628154b4ea7ff2a6f04c94b9be8835bf5b19,0,Sriharsha Chintalapani,2015-09-21 11:53:29-07:00,['c567c52399cc3579239a75c4853d0ad17b6640ff'],1,1,2,1977166,1,,,,1833
24b3bb52a2392e9de0ca46560a99c89b22cf04ee,0,Sriharsha Chintalapani,2015-09-21 11:54:46-07:00,"['206e7283a7752f6a57154e70e369733a7df37fa1', '38a2628154b4ea7ff2a6f04c94b9be8835bf5b19']",1,1,2,1977168,1,,,,1833
ad7488436772cf6658c46b54c9cc5fb8b5092312,0,Sriharsha Chintalapani,2015-09-21 12:02:17-07:00,['24b3bb52a2392e9de0ca46560a99c89b22cf04ee'],0,1,1,1977169,1,,,,1833
0a2843a958dd240ebd6312890e634c9bf5f4883b,0,Erik Weathers,2015-09-21 16:52:50-07:00,['ad7488436772cf6658c46b54c9cc5fb8b5092312'],11,9,20,1977189,1,,,,1833
397d2d8a7bcca79aa3f9c7b33482ced897e074f9,0,Sriharsha Chintalapani,2015-09-22 07:08:56-07:00,"['ad7488436772cf6658c46b54c9cc5fb8b5092312', '41c896708cd3c9d48005580e5e71e285597d5539']",120,124,244,1977433,1,,,,1833
56cfdbf8d9b3b6044d7aa05dfb6b501c24b2f277,0,Priyank,2015-09-22 09:14:26-07:00,['a89b7ff4b7c96f7998e3a0c673937f9ddefd59c9'],4,4,8,1977441,2,1,1,1,1833
898b31389dfef593fd029f60d2610c13f61e53e7,0,Kyle Nusbaum,2015-09-22 12:10:33-05:00,['397d2d8a7bcca79aa3f9c7b33482ced897e074f9'],5,1,6,1977447,2,,,,1833
5d499854bf4b236b2d5fc7078d7fc5343d89dbeb,0,Pete Prokopowicz,2015-09-23 10:09:23-05:00,['4523e54eba2ca7cf4b95aa664daa175fa0ae8185'],9,9,18,1977465,1,,,,1833
8c0dcb1fede52512f2599ae4732372346bb36ba3,0,Pete Prokopowicz,2015-09-23 12:30:06-05:00,['5d499854bf4b236b2d5fc7078d7fc5343d89dbeb'],1,1,2,1977467,1,,,,1833
94b156243eef1cef6e572e94918ac4153a0f82cf,0,zhuol,2015-09-23 14:37:06-05:00,['397d2d8a7bcca79aa3f9c7b33482ced897e074f9'],1,7,8,1977475,2,1,1,1,1833
e4f780a4f226c1255871390d7446e20e8eb1c888,0,zhuol,2015-09-23 14:41:41-05:00,['94b156243eef1cef6e572e94918ac4153a0f82cf'],1,1,2,1977477,1,,,,1833
a30a1801234a864df09b0d0a914e0a34115227cd,0,Jungtaek Lim,2015-09-24 09:56:39+09:00,['397d2d8a7bcca79aa3f9c7b33482ced897e074f9'],1,1,2,1977479,1,,,,1833
508a4ef1f27716f8c6307258303ab4bdb2663330,0,zhuol,2015-09-23 20:26:01-05:00,['e4f780a4f226c1255871390d7446e20e8eb1c888'],1,1,2,1977481,1,,,,1833
d5193649334f967ca50dadde665cc38d7cdcc763,0,zhuol,2015-09-23 20:39:57-05:00,['508a4ef1f27716f8c6307258303ab4bdb2663330'],0,2,2,1977483,1,,,,1833
d13cfe2dc9beda8fc4fda6fa6536d87b9ce514a1,0,Kishor Patil,2015-09-24 14:22:37+00:00,['397d2d8a7bcca79aa3f9c7b33482ced897e074f9'],3,3696,3699,1981182,8,0.600162536,0.700528241,0.97440065,1836
da12450768aff4ca9ad842f302516a322e982215,0,Sriharsha Chintalapani,2015-09-24 09:04:41-07:00,"['a30a1801234a864df09b0d0a914e0a34115227cd', '56cfdbf8d9b3b6044d7aa05dfb6b501c24b2f277']",8,11,19,1981201,3,,,,1836
d75e5fbed635a4c096c98d0abf25236c8616503d,0,zhuol,2015-09-24 11:20:37-05:00,['397d2d8a7bcca79aa3f9c7b33482ced897e074f9'],0,1,1,1981202,1,0,1,1,1836
99285bb719357760f572d6f4f0fb4cd02a8fd389,0,Sriharsha Chintalapani,2015-09-24 09:38:11-07:00,['da12450768aff4ca9ad842f302516a322e982215'],0,1,1,1981203,1,,,,1836
5266a167169cbc7e36a31d55772fdc7ac33ccf94,0,Derek Dagit,2015-09-24 11:42:35-05:00,['7a0c3eeeb5fbcbc5c32d47cca692cec103a68244'],6,13,19,1981222,1,,,,1836
7d5285545a4d4f227f7f8616c2f769f055649560,0,ddragan,2015-09-25 17:58:07+03:00,['99285bb719357760f572d6f4f0fb4cd02a8fd389'],8,8,16,1981238,1,,,,1836
cc082aa93e5da92c4c3f635420fabf8bb6e60bf3,0,dragan,2015-09-25 19:37:50+03:00,['7d5285545a4d4f227f7f8616c2f769f055649560'],0,5,5,1981243,1,,,,1836
a16083c9b064f42f4e4407e6e277ce9660d54aef,0,Derek Dagit,2015-09-25 14:27:26-05:00,"['99285bb719357760f572d6f4f0fb4cd02a8fd389', 'd75e5fbed635a4c096c98d0abf25236c8616503d']",0,1,1,1981244,1,,,,1836
462232126d2a8270c39fb242c2f9411c7586ea8f,0,Derek Dagit,2015-09-25 14:40:09-05:00,['a16083c9b064f42f4e4407e6e277ce9660d54aef'],0,1,1,1981245,1,,,,1836
8dd9e6e213210009968f39483cb69f271b2e8415,0,Derek Dagit,2015-09-25 14:40:52-05:00,"['99285bb719357760f572d6f4f0fb4cd02a8fd389', '462232126d2a8270c39fb242c2f9411c7586ea8f']",0,2,2,1981247,2,,,,1836
fd70d9ca321184fc5b324e166faf0deedc84c11a,0,Sumit Chawla,2015-09-26 12:04:29-07:00,"['bdb5e3e21f6c64986d2d9e63c0601f13ae2db55c', '8dd9e6e213210009968f39483cb69f271b2e8415']",1305,5300,6605,1987852,93,,,,1836
94de2a5932e4a68a53f15428927b72b8c1ee8563,0,Sumit Chawla,2015-09-26 12:17:12-07:00,['fd70d9ca321184fc5b324e166faf0deedc84c11a'],5,5,10,1987862,2,,,,1836
0a2ed63310f9ad9214ef7493134232b5bb6da80c,1,Derek Dagit,2015-09-27 20:27:07-05:00,"['de0e146423811b6d4d8b33353d6252e6c2f10da3', '8dd9e6e213210009968f39483cb69f271b2e8415']",2690,12773,15463,2003325,210,,,,1836
250ab1132e5cb26ac9cf1af5c47cbaf98390923a,1,Kishor Patil,2015-09-28 15:26:22-05:00,['d13cfe2dc9beda8fc4fda6fa6536d87b9ce514a1'],18,941,959,2004284,18,0.46875,1,0.765625,1838
087f08ea314df2055bce61abbb54cc7443da41a9,1,Kishor Patil,2015-09-28 15:57:37-05:00,['250ab1132e5cb26ac9cf1af5c47cbaf98390923a'],0,41,41,2004325,3,,,,1841
8e424d13554b98a6543ee04b2909549429e9a16a,0,Sriharsha Chintalapani,2015-09-28 15:28:21-07:00,['8dd9e6e213210009968f39483cb69f271b2e8415'],0,1,1,2004326,1,,,,1841
ae4b5532e5c4272f0a2a8a940632f30b69f365a0,0,Sriharsha Chintalapani,2015-09-28 15:29:21-07:00,"['8e424d13554b98a6543ee04b2909549429e9a16a', '2631e88bdf86d265e9ddfce5e413b455ff8303c6']",34,407,441,2004767,3,,,,1841
d55c6f4d58b57f9a2071bb3618c91363072fe476,0,Ningyu An,2015-09-29 16:04:10+08:00,['ae4b5532e5c4272f0a2a8a940632f30b69f365a0'],0,2,2,2004769,1,,,,1841
829798eb3f5bbe55f283e786095db395946b0e3e,0,Robert (Bobby) Evans,2015-09-29 09:07:34-05:00,"['ae4b5532e5c4272f0a2a8a940632f30b69f365a0', 'cc082aa93e5da92c4c3f635420fabf8bb6e60bf3']",8,13,21,2004790,1,,,,1841
ced622433eaff81d7039d384c3acf5de595b0a70,0,Robert (Bobby) Evans,2015-09-29 09:08:50-05:00,['829798eb3f5bbe55f283e786095db395946b0e3e'],0,2,2,2004792,2,,,,1841
51c32531ae72adc56d071745677e375326b50fe8,0,Kishor Patil,2015-09-29 09:31:25-05:00,['087f08ea314df2055bce61abbb54cc7443da41a9'],12,12,24,2004816,1,,,,1841
8edf1c28eb82c31969a39041d89b2f0923a3d0f4,0,zhuol,2015-09-29 12:49:01-05:00,['ced622433eaff81d7039d384c3acf5de595b0a70'],10,11,21,2004837,2,,,,1841
5d84794521b2f581d2ccf3b144f8c73cfb277e75,1,Derek Dagit,2015-09-29 13:52:53-05:00,"['5266a167169cbc7e36a31d55772fdc7ac33ccf94', '99285bb719357760f572d6f4f0fb4cd02a8fd389']",6536,28249,34785,2039622,476,,,,1841
bd0fad9ffdb2db9058b447e660ee3a22b6becbca,0,Derek Dagit,2015-09-29 14:18:24-05:00,['5d84794521b2f581d2ccf3b144f8c73cfb277e75'],7,7,14,2039636,7,,,,1841
92705919af8ff26ce051ac5ffb71680d29187665,0,Robert (Bobby) Evans,2015-09-29 14:41:35-05:00,"['ced622433eaff81d7039d384c3acf5de595b0a70', '898b31389dfef593fd029f60d2610c13f61e53e7']",5,1,6,2039642,2,,,,1841
68c0a1647c0dda93fedb9a6183d4b648312a03bd,0,Derek Dagit,2015-09-29 14:42:06-05:00,['bd0fad9ffdb2db9058b447e660ee3a22b6becbca'],1,1,2,2039644,1,,,,1841
3983084b7a66b1ecde43fbf223f059e4e598f2ae,1,Derek Dagit,2015-09-29 14:49:04-05:00,['68c0a1647c0dda93fedb9a6183d4b648312a03bd'],2,2,4,2039648,1,,,,1841
9d911ec1b4f7b5aabe646a5d2cd31591fe4df1b0,0,Robert (Bobby) Evans,2015-09-29 14:49:27-05:00,['92705919af8ff26ce051ac5ffb71680d29187665'],0,1,1,2039649,1,,,,1841
1abe4867160cb07a3eff6c2307d38b049cb51634,0,zhuol,2015-09-29 15:26:57-05:00,['ced622433eaff81d7039d384c3acf5de595b0a70'],2,15,17,2039666,2,1,1,1,1841
c35ec2cfa3e39a8d5cc9b85c40e77b7fa55e61ae,0,zhuol,2015-09-29 15:26:57-05:00,['1abe4867160cb07a3eff6c2307d38b049cb51634'],0,33,33,2039699,1,,,,1842
633d03c409e6d2cd20af3a7792572cbe2071ac47,0,zhuol,2015-09-29 15:26:57-05:00,['c35ec2cfa3e39a8d5cc9b85c40e77b7fa55e61ae'],1,1,2,2039701,1,,,,1842
4386fe62c7f80e0785ba7c3d46a5c986089db51c,0,zhuol,2015-09-29 16:40:32-05:00,['8edf1c28eb82c31969a39041d89b2f0923a3d0f4'],1,3,4,2039705,1,,,,1842
bd3e1d67c735d86dcfbfc6f8d8d899c1977d1621,0,Ningyu An,2015-09-30 16:56:03+08:00,['d55c6f4d58b57f9a2071bb3618c91363072fe476'],0,1,1,2039706,1,,,,1842
754017f1c16bc74797a39c2cbb64e8c5e50f3010,0,Kishor Patil,2015-09-30 07:50:44-05:00,['51c32531ae72adc56d071745677e375326b50fe8'],9,1,10,2039716,2,,,,1842
52df0dff03ec69ad4a5573b60590d5bd2145fe43,0,Robert (Bobby) Evans,2015-09-30 14:31:32-05:00,"['9d911ec1b4f7b5aabe646a5d2cd31591fe4df1b0', 'd5193649334f967ca50dadde665cc38d7cdcc763']",1,9,10,2039726,3,,,,1842
d86cdee8500ba0624f56178880b29d8a1a4dc71b,0,Robert (Bobby) Evans,2015-09-30 14:32:00-05:00,['52df0dff03ec69ad4a5573b60590d5bd2145fe43'],0,1,1,2039727,1,,,,1842
579bc6bf5d868832232f8ac65c7af83ee8291889,0,Robert (Bobby) Evans,2015-09-30 15:00:42-05:00,"['d86cdee8500ba0624f56178880b29d8a1a4dc71b', '633d03c409e6d2cd20af3a7792572cbe2071ac47']",2,48,50,2039777,3,,,,1842
b76d90bb18938a2c6c220ac4eeb7128b56b760ad,0,Robert (Bobby) Evans,2015-09-30 15:01:06-05:00,['579bc6bf5d868832232f8ac65c7af83ee8291889'],0,1,1,2039778,1,,,,1842
a73e5e2c310bd6ea5e5054f9b1f89345b9a4c32d,0,Robert (Bobby) Evans,2015-09-30 16:10:00-05:00,"['b76d90bb18938a2c6c220ac4eeb7128b56b760ad', 'be7f2ad1d9b6be1a92fb2a8775822b5752703c89']",7,9,16,2039794,1,,,,1842
ce93d5f69ba4554681dcba9dd684fe70179e8250,0,Robert (Bobby) Evans,2015-09-30 16:11:08-05:00,['a73e5e2c310bd6ea5e5054f9b1f89345b9a4c32d'],0,1,1,2039795,1,,,,1842
e3b5c2701f1ce912dde052af3e81b9c4ce517f3f,1,Sriharsha Chintalapani,2015-09-30 14:44:28-07:00,['ce93d5f69ba4554681dcba9dd684fe70179e8250'],8,67,75,2039870,2,0.162790698,0,0.860465116,1842
7710eef9249249de2f8bbd5670a50cf6901f7b3e,0,Sriharsha Chintalapani,2015-09-30 16:10:36-07:00,['e3b5c2701f1ce912dde052af3e81b9c4ce517f3f'],7,10,17,2039887,2,1,1,1,1842
768a85926373355c15cc139fd86268916abc6850,0,Haohui Mai,2015-10-01 10:25:46-07:00,['ce93d5f69ba4554681dcba9dd684fe70179e8250'],2,2,4,2039891,2,,,,1842
dbcb138603f55fc9f234d2d3b2404a2bfc92e4d9,1,Robert (Bobby) Evans,2015-10-01 14:04:30-05:00,['ce93d5f69ba4554681dcba9dd684fe70179e8250'],109,149,258,2040149,3,0.183673469,1,0.93877551,1842
f2a35a38929035f5cf352d8e6bf72afe40b69358,0,zhuol,2015-10-01 14:33:10-05:00,['ce93d5f69ba4554681dcba9dd684fe70179e8250'],8,4,12,2040161,2,1,0,0,1842
77b171107ba52daac34ebf3d8c59d7643ecb6408,0,Pete Prokopowicz,2015-10-01 16:48:14-05:00,['8c0dcb1fede52512f2599ae4732372346bb36ba3'],1,1,2,2040163,1,,,,1842
dad2a811f0658f39bf95611fc9657230112bd712,0,Robert (Bobby) Evans,2015-10-02 09:39:51-05:00,['dbcb138603f55fc9f234d2d3b2404a2bfc92e4d9'],2,8,10,2040173,2,,,,1842
12fdaa01b20eb144bf18a231a05c92873c90aa09,1,Robert (Bobby) Evans,2015-10-02 14:18:11-05:00,['768a85926373355c15cc139fd86268916abc6850'],198,289,487,2040660,10,,,,1842
feba08a0488a48cfe030ebb2eb8e915f5501bc8f,0,Robert (Bobby) Evans,2015-10-02 14:18:58-05:00,['12fdaa01b20eb144bf18a231a05c92873c90aa09'],4,8,12,2040672,3,,,,1842
045b77dcae6d40e12fbdfaeeb2b04df38f73154e,0,Robert (Bobby) Evans,2015-10-02 14:18:58-05:00,['feba08a0488a48cfe030ebb2eb8e915f5501bc8f'],4,4,8,2040680,1,,,,1842
f04325b0095f2112c9fc320f03b4806733ce987a,0,Robert (Bobby) Evans,2015-10-02 14:18:58-05:00,['045b77dcae6d40e12fbdfaeeb2b04df38f73154e'],0,29,29,2040709,1,,,,1842
25b6b074c58f9d23081eabb033d7320be58cd3ab,1,Robert (Bobby) Evans,2015-10-02 14:19:59-05:00,['f04325b0095f2112c9fc320f03b4806733ce987a'],91,33,124,2040833,8,,,,1842
f6e10a879c615121468228761a065ce320ee3cd8,0,Robert (Bobby) Evans,2015-10-02 14:19:59-05:00,['25b6b074c58f9d23081eabb033d7320be58cd3ab'],0,2,2,2040835,1,,,,1842
0cdd7e83c893e2e550256e6daeea36c5a7379002,0,Robert (Bobby) Evans,2015-10-02 15:16:53-05:00,"['ce93d5f69ba4554681dcba9dd684fe70179e8250', 'f6e10a879c615121468228761a065ce320ee3cd8']",204,272,476,2041311,14,,,,1842
c90f6fd4d8c9fc823ff22b4355a8f21f155e17fb,0,Robert (Bobby) Evans,2015-10-02 15:18:16-05:00,['0cdd7e83c893e2e550256e6daeea36c5a7379002'],0,4,4,2041315,1,,,,1842
3f378cb42ce876bd8c7ff6ab0edb4773ef671571,0,Jungtaek Lim,2015-10-03 13:45:45+09:00,"['c90f6fd4d8c9fc823ff22b4355a8f21f155e17fb', '0a2ed63310f9ad9214ef7493134232b5bb6da80c']",7,26,33,2041348,3,,,,1842
b0c7049252d8839cc16a7462b6eabcdaa281d4a7,0,Jungtaek Lim,2015-10-03 13:46:31+09:00,['3f378cb42ce876bd8c7ff6ab0edb4773ef671571'],0,1,1,2041349,1,,,,1842
bdb8ff01aae87b75b7a3ab3224ec0205c4b5f49b,0,Jungtaek Lim,2015-10-03 13:51:18+09:00,"['b0c7049252d8839cc16a7462b6eabcdaa281d4a7', '4386fe62c7f80e0785ba7c3d46a5c986089db51c']",11,14,25,2041374,3,,,,1842
7c902976c370a0dbcced77d44a5e6a4de589de96,0,Jungtaek Lim,2015-10-03 13:55:21+09:00,['bdb8ff01aae87b75b7a3ab3224ec0205c4b5f49b'],0,1,1,2041375,1,,,,1842
d828be59ac4daf6c565391b496fe2313d9eb0b7a,0,Jungtaek Lim,2015-10-03 15:42:20+09:00,"['7c902976c370a0dbcced77d44a5e6a4de589de96', 'bd3e1d67c735d86dcfbfc6f8d8d899c1977d1621']",0,3,3,2041378,1,,,,1842
7365771fc1e37fd6690849d5459b1258aa4f0601,0,Jungtaek Lim,2015-10-03 15:43:14+09:00,['d828be59ac4daf6c565391b496fe2313d9eb0b7a'],0,1,1,2041379,1,,,,1842
7df4e9cecc06a10f70ee3d2b9ef518fed38902ff,0,Robert (Bobby) Evans,2015-10-03 08:28:17-05:00,"['7365771fc1e37fd6690849d5459b1258aa4f0601', 'f2a35a38929035f5cf352d8e6bf72afe40b69358']",8,4,12,2041391,2,,,,1842
86ea8b2186934ba18ce140cb5326483f7cfd9082,0,Robert (Bobby) Evans,2015-10-03 08:28:41-05:00,['7df4e9cecc06a10f70ee3d2b9ef518fed38902ff'],0,1,1,2041392,1,,,,1842
831834338266275780b4479b3afce2a162f62974,0,Robert (Bobby) Evans,2015-10-03 08:31:22-05:00,"['86ea8b2186934ba18ce140cb5326483f7cfd9082', 'dad2a811f0658f39bf95611fc9657230112bd712']",109,155,264,2041656,3,,,,1842
7cf4d25968b5185cbe011b7106d06fb15a77d45b,0,Robert (Bobby) Evans,2015-10-03 08:31:48-05:00,['831834338266275780b4479b3afce2a162f62974'],0,1,1,2041657,1,,,,1842
b53b9eb3c12f8caa7180c880ba52c550535ef192,1,Sriharsha Chintalapani,2015-10-03 08:06:57-07:00,['7710eef9249249de2f8bbd5670a50cf6901f7b3e'],5,8,13,2041670,2,0.25,0.25,1,1842
62eeae4b5bc547bc3f36d0a3339b268c684b7ca1,0,Dror Weiss,2015-10-03 21:14:23+03:00,['7cf4d25968b5185cbe011b7106d06fb15a77d45b'],0,2,2,2041672,1,,,,1842
472567ec775b054d454617ca640adbf9c3d24383,0,Matt Tieman,2015-10-03 14:46:56-04:00,"['9bfd834aaf344a63c1f010a40a7f1bce5a315d4f', '7cf4d25968b5185cbe011b7106d06fb15a77d45b']",18263,82970,101233,2142905,726,,,,1842
85a3b3eb63f3285043d57762caf0ec5629c2d3c8,0,Robert (Bobby) Evans,2015-10-05 11:48:11-05:00,['7cf4d25968b5185cbe011b7106d06fb15a77d45b'],16,22,38,2142943,2,0,0,1,1842
63978509decc42d3922fea3b98a20e54b928e571,0,Kishor Patil,2015-10-05 18:53:51+00:00,"['754017f1c16bc74797a39c2cbb64e8c5e50f3010', '7cf4d25968b5185cbe011b7106d06fb15a77d45b']",404,991,1395,2144338,39,,,,1842
dd78e45225865392aee630cbfd390c7872eece8f,0,Robert (Bobby) Evans,2015-10-05 14:13:42-05:00,"['7cf4d25968b5185cbe011b7106d06fb15a77d45b', '63978509decc42d3922fea3b98a20e54b928e571']",21,4670,4691,2149029,29,,,,1842
9ac9eb5a26bf5e834e728c29673d26b65bacfc2f,0,Robert (Bobby) Evans,2015-10-05 14:14:10-05:00,['dd78e45225865392aee630cbfd390c7872eece8f'],0,1,1,2149030,1,,,,1842
f641a804272762eda64a1eafa2bfe9ffdfe28009,0,Derek Dagit,2015-10-05 14:40:37-05:00,"['3983084b7a66b1ecde43fbf223f059e4e598f2ae', '7cf4d25968b5185cbe011b7106d06fb15a77d45b']",401,987,1388,2150418,37,,,,1842
2d59aed83950c280ad1a6a0aacefcd2fa2017d26,0,Derek Dagit,2015-10-05 15:43:38-05:00,"['f641a804272762eda64a1eafa2bfe9ffdfe28009', '9ac9eb5a26bf5e834e728c29673d26b65bacfc2f']",18,4670,4688,2155106,30,,,,1842
262316b310570d30dc589147c00f9eb4a8127cf6,0,Robert (Bobby) Evans,2015-10-05 15:53:54-05:00,"['9ac9eb5a26bf5e834e728c29673d26b65bacfc2f', '2d59aed83950c280ad1a6a0aacefcd2fa2017d26']",1456,16248,17704,2172810,39,,,,1842
4c2b37c7ac24c2e5ff4a9c33e9c39009f27c1df0,0,Robert (Bobby) Evans,2015-10-05 15:54:23-05:00,['262316b310570d30dc589147c00f9eb4a8127cf6'],0,1,1,2172811,1,,,,1842
ed7b4869d3cfd53279d34bf300abdf6fb50958b6,1,Michael Schonfeld,2015-10-06 19:31:03+03:00,['4c2b37c7ac24c2e5ff4a9c33e9c39009f27c1df0'],0,8,8,2172819,1,1,1,1,1842
c85086693519a87436a0c96c361d0f5e640bc3b5,0,Aaron Dossett,2015-10-06 14:55:14-05:00,['4c2b37c7ac24c2e5ff4a9c33e9c39009f27c1df0'],11,120,131,2172950,10,0.545454545,1,1,1842
1822491bc2889765454e456f56125fd7912c1043,0,Jungtaek Lim,2015-10-07 05:35:05+09:00,"['4c2b37c7ac24c2e5ff4a9c33e9c39009f27c1df0', '0a2843a958dd240ebd6312890e634c9bf5f4883b']",11,9,20,2172970,1,,,,1842
0476b92dd82e726adab200d5a77944a5f4f3883c,0,Robert (Bobby) Evans,2015-10-07 21:03:38+00:00,['1822491bc2889765454e456f56125fd7912c1043'],71,104,175,2173145,6,1,1,1,1842
9a25ab79b4457c4ed98b64c96218e0462efe72c4,1,Sriharsha Chintalapani,2015-10-08 09:13:54-07:00,['b53b9eb3c12f8caa7180c880ba52c550535ef192'],3,6,9,2173154,1,1,1,1,1842
103125d428e13aed20acbd7881ab8b1aaa423ed9,0,Paul Poulosky,2015-10-08 18:05:45-05:00,['1822491bc2889765454e456f56125fd7912c1043'],1,12,13,2173167,2,,,,1842
181f84d2cb717e331f254223f1ea9de306842db6,0,Jungtaek Lim,2015-10-09 15:39:59+09:00,"['1822491bc2889765454e456f56125fd7912c1043', '77b171107ba52daac34ebf3d8c59d7643ecb6408']",9,9,18,2173185,1,,,,1842
1af33c7c791ce314993a385f34a36abf874c6872,0,Jungtaek Lim,2015-10-09 15:41:43+09:00,['181f84d2cb717e331f254223f1ea9de306842db6'],0,2,2,2173187,2,,,,1842
9e7d8be68df68cc7dd4f4c560350dcf9a64b2835,0,Jungtaek Lim,2015-10-09 16:06:31+09:00,"['1af33c7c791ce314993a385f34a36abf874c6872', 'ed7b4869d3cfd53279d34bf300abdf6fb50958b6']",0,8,8,2173195,1,,,,1842
8c17b74f4377219174460debdeb9492a2e90f3e4,0,Jungtaek Lim,2015-10-09 16:07:42+09:00,['9e7d8be68df68cc7dd4f4c560350dcf9a64b2835'],0,1,1,2173196,1,,,,1842
368da05b2b18ae62e42058e78a08f937501931eb,0,Jungtaek Lim,2015-10-09 16:18:00+09:00,"['8c17b74f4377219174460debdeb9492a2e90f3e4', 'c85086693519a87436a0c96c361d0f5e640bc3b5']",11,120,131,2173327,10,,,,1842
3aed9165ddcad178f4cf576bfc6903305ea5d45c,0,Jungtaek Lim,2015-10-09 16:27:31+09:00,['368da05b2b18ae62e42058e78a08f937501931eb'],0,1,1,2173328,1,,,,1842
68d81ab092e76e790da4c69fc9215fd1f2633821,0,mjsax,2015-10-09 12:37:35+02:00,['3aed9165ddcad178f4cf576bfc6903305ea5d45c'],4,17,21,2173349,4,1,1,1,1842
2cd27e04455fa429c3ac35b20d10cdfb1092f8de,0,Jungtaek Lim,2015-10-09 21:01:10+09:00,['68d81ab092e76e790da4c69fc9215fd1f2633821'],0,1,1,2173350,1,,,,1842
121d022b9f11146f6dadc2cd402c747472cac0d1,1,Boyang Jerry Peng,2015-10-09 08:44:20-05:00,['1822491bc2889765454e456f56125fd7912c1043'],1821,5161,6982,2180332,61,0.427453341,0.537025888,0.841059603,1854
0aa19370c1569f3efb28aac705303d2f5c489e8b,0,Robert (Bobby) Evans,2015-10-09 08:58:33-05:00,"['2cd27e04455fa429c3ac35b20d10cdfb1092f8de', '0476b92dd82e726adab200d5a77944a5f4f3883c']",71,104,175,2180507,6,,,,1854
3f79c2f40380ce2632db324afec1f251a1746846,0,Robert (Bobby) Evans,2015-10-09 08:59:15-05:00,['0aa19370c1569f3efb28aac705303d2f5c489e8b'],1,4,5,2180512,2,,,,1854
16e5bd135177163912886838de8736f520d9a9b7,0,Paul Poulosky,2015-10-09 09:41:25-05:00,['103125d428e13aed20acbd7881ab8b1aaa423ed9'],6,5,11,2180523,1,,,,1854
7c5f0feffb50eff529b0d7fa8eb82da7c0ace8e3,0,Robert (Bobby) Evans,2015-10-09 09:43:08-05:00,"['3f79c2f40380ce2632db324afec1f251a1746846', '121d022b9f11146f6dadc2cd402c747472cac0d1']",1821,5161,6982,2187505,61,,,,1854
86f2d03c2060f25ccdaf7580cfee5d9f1a9ac2e3,0,Robert (Bobby) Evans,2015-10-09 09:52:44-05:00,['7c5f0feffb50eff529b0d7fa8eb82da7c0ace8e3'],0,1,1,2187506,1,,,,1854
9a25aede1791bba48dbb345fb2523e1484b4db8c,1,Aaron Dossett,2015-10-09 13:29:28-05:00,['86f2d03c2060f25ccdaf7580cfee5d9f1a9ac2e3'],0,9,9,2187515,1,0,0,0,1854
c917679b6d2c8a4c4609878158c2d6f4debb0ead,0,Derek Dagit,2015-10-09 13:42:02-05:00,['1822491bc2889765454e456f56125fd7912c1043'],1,1,2,2187517,1,,,,1854
960743ef26b82cfd6579382abcc765b45f57b8eb,0,Robert (Bobby) Evans,2015-10-09 14:01:35-05:00,"['86f2d03c2060f25ccdaf7580cfee5d9f1a9ac2e3', '85a3b3eb63f3285043d57762caf0ec5629c2d3c8']",16,22,38,2187555,2,,,,1854
ada8097e16bc70af37f04e9472935e4f1b7d5f9b,0,Robert (Bobby) Evans,2015-10-09 14:02:01-05:00,['960743ef26b82cfd6579382abcc765b45f57b8eb'],0,1,1,2187556,1,,,,1854
ba1250993d10ffc523c9f5464371fbeb406d216f,0,Michael Schonfeld,2015-10-09 19:48:41-04:00,['ada8097e16bc70af37f04e9472935e4f1b7d5f9b'],2,1,3,2187559,1,,,,1854
270f9e280cde9ac548fb60cc4634362c9d64259b,0,Jungtaek Lim,2015-10-10 22:45:20+09:00,"['ada8097e16bc70af37f04e9472935e4f1b7d5f9b', '16e5bd135177163912886838de8736f520d9a9b7']",1,11,12,2187571,2,,,,1854
04cf3f6162ce6fdd1ec13b758222d889dafd5749,0,Jungtaek Lim,2015-10-10 23:00:09+09:00,['270f9e280cde9ac548fb60cc4634362c9d64259b'],0,1,1,2187572,1,,,,1854
fc0391038c7d839487a2cafce55519d246974b13,1,Sriharsha Chintalapani,2015-10-12 07:10:07-07:00,['9a25ab79b4457c4ed98b64c96218e0462efe72c4'],3,3,6,2187578,1,,,,1854
31f5286e9a77ea656faa5b480c3ed8882f636100,0,Robert (Bobby) Evans,2015-10-12 11:28:07-05:00,"['04cf3f6162ce6fdd1ec13b758222d889dafd5749', 'ba1250993d10ffc523c9f5464371fbeb406d216f']",2,1,3,2187581,1,,,,1854
7b4f4d7b71e72c5e5be24de8e70e893ebb741ec2,0,Kishor Patil,2015-10-12 16:31:24+00:00,['04cf3f6162ce6fdd1ec13b758222d889dafd5749'],1,1,2,2187583,1,,,,1854
5a29b30212a5f0e15c6e791758f86eb2bb8a6aa4,0,Kishor Patil,2015-10-12 16:49:39+00:00,['7b4f4d7b71e72c5e5be24de8e70e893ebb741ec2'],7,3,10,2187593,2,,,,1854
f0049e6fadb015be2744dde30a6e2fa46e168697,0,Robert (Bobby) Evans,2015-10-12 12:54:01-05:00,['31f5286e9a77ea656faa5b480c3ed8882f636100'],0,1,1,2187594,1,,,,1854
5b86f4712f92d34c32134e933b8f2c7fc3c866f0,1,Robert (Bobby) Evans,2015-10-14 13:33:27-05:00,['f0049e6fadb015be2744dde30a6e2fa46e168697'],1,11,12,2187606,1,0,0,1,1854
8281115371e852eb540246fd127b29d1da5e6f6a,0,Kishor Patil,2015-10-14 18:45:20+00:00,['f0049e6fadb015be2744dde30a6e2fa46e168697'],11,8,19,2187625,4,,,,1854
88bfa5af12ec07c0fb4c2d4a66f1812fee004edf,0,Kishor Patil,2015-10-14 18:46:32+00:00,['8281115371e852eb540246fd127b29d1da5e6f6a'],0,1,1,2187626,1,,,,1854
08464d84f1dabeb6318fa5a3d08a8d64d8e365bb,0,Kyle Nusbaum,2015-10-14 14:57:51-05:00,"['f0049e6fadb015be2744dde30a6e2fa46e168697', 'c917679b6d2c8a4c4609878158c2d6f4debb0ead']",1,1,2,2187628,1,,,,1854
93043e66c22815c3154a329bc1756b254c0c3eb4,0,Kyle Nusbaum,2015-10-14 14:59:01-05:00,['08464d84f1dabeb6318fa5a3d08a8d64d8e365bb'],0,1,1,2187629,1,,,,1854
47f4a3c3d3396b35928578e36b27dbcc49f00752,0,matt.tieman,2015-10-14 17:31:08-04:00,"['472567ec775b054d454617ca640adbf9c3d24383', '93043e66c22815c3154a329bc1756b254c0c3eb4']",4902,27874,32776,2220405,114,,,,1854
ee1bc8a9d4fc0796e897c3b0082d35170bbca05e,0,zhuol,2015-10-14 16:32:44-05:00,['f0049e6fadb015be2744dde30a6e2fa46e168697'],2,2,4,2220409,1,,,,1854
99da29b443c89580be34512b67d780c811d6d38a,0,Sriharsha Chintalapani,2015-10-14 14:38:13-07:00,['fc0391038c7d839487a2cafce55519d246974b13'],13,14,27,2220436,1,0,0,1,1854
4b4c2451915c2741fa2f60c69bc9de942cef807a,0,Kishor Patil,2015-10-14 23:14:17-05:00,"['93043e66c22815c3154a329bc1756b254c0c3eb4', '5a29b30212a5f0e15c6e791758f86eb2bb8a6aa4']",8,4,12,2220448,2,,,,1854
9fe97b6ea8fa84a34f846291735acac8d6399107,0,Kishor Patil,2015-10-14 23:16:38-05:00,['4b4c2451915c2741fa2f60c69bc9de942cef807a'],0,1,1,2220449,1,,,,1854
c7f0882f79fa76cfc94a913bf28eb905471f3fc3,1,Boyang Jerry Peng,2015-10-15 10:26:53-05:00,['9fe97b6ea8fa84a34f846291735acac8d6399107'],497,1756,2253,2222702,8,0.358422939,0.655913978,0.868578256,1858
b5cb2ecdad9d023e9691d5ef5f7dc4aaef7dca75,0,Boyang Jerry Peng,2015-10-15 11:16:50-05:00,['c7f0882f79fa76cfc94a913bf28eb905471f3fc3'],111,152,263,2222965,3,1,1,1,1858
46d7c0e53cd667f397242499d096461229e6510f,0,Robert (Bobby) Evans,2015-10-15 13:08:03-05:00,"['9fe97b6ea8fa84a34f846291735acac8d6399107', 'b5cb2ecdad9d023e9691d5ef5f7dc4aaef7dca75']",497,1797,2294,2225259,8,,,,1858
54772f83ce68160741a76d0383c9f944eda2e058,0,Robert (Bobby) Evans,2015-10-15 13:08:41-05:00,['46d7c0e53cd667f397242499d096461229e6510f'],0,1,1,2225260,1,,,,1858
415654dcc5c6301d05df95ba9ab15d9bb03f95ea,0,Robert (Bobby) Evans,2015-10-15 13:28:05-05:00,['54772f83ce68160741a76d0383c9f944eda2e058'],397,0,397,2225657,1,0.728070175,0.48245614,0.114035088,1858
6408063df31a758a70bf06e67dda7cf7ec744cb0,0,Robert (Bobby) Evans,2015-10-15 13:28:41-05:00,"['415654dcc5c6301d05df95ba9ab15d9bb03f95ea', '5b86f4712f92d34c32134e933b8f2c7fc3c866f0']",1,11,12,2225669,1,,,,1858
794254cb815e2c17850b216577ba16c4e9017435,0,Robert (Bobby) Evans,2015-10-15 13:29:03-05:00,['6408063df31a758a70bf06e67dda7cf7ec744cb0'],0,1,1,2225670,1,,,,1858
a1369bbeed1281e1ea5cc4890364eac3a50236c8,1,Daniel Schonfeld,2015-10-15 17:21:59-04:00,['794254cb815e2c17850b216577ba16c4e9017435'],1,1,2,2225672,1,,,,1858
ebca03a90928969ae5b75a290aa0174c6bdcc75e,0,Jungtaek Lim,2015-10-16 09:17:55+09:00,['794254cb815e2c17850b216577ba16c4e9017435'],1,1,2,2225674,1,,,,1858
a69e3ae268adc226146b91bec5fcd889f70d055c,0,Jungtaek Lim,2015-10-16 09:19:01+09:00,"['ebca03a90928969ae5b75a290aa0174c6bdcc75e', '99da29b443c89580be34512b67d780c811d6d38a']",9,78,87,2225761,3,,,,1858
8f8c3e548596422d768ec4d0b151d2375794172b,0,Jungtaek Lim,2015-10-16 10:04:01+09:00,['a69e3ae268adc226146b91bec5fcd889f70d055c'],0,1,1,2225762,1,,,,1858
26f966ca5b82b54c6a07e218dda9963540ef590d,0,Derek Dagit,2015-10-16 09:54:55-05:00,['8f8c3e548596422d768ec4d0b151d2375794172b'],0,1,1,2225763,1,,,,1858
1a367fbfcec4b1f408545be2231043df51edb78d,0,Derek Dagit,2015-10-16 11:13:38-05:00,['9fe97b6ea8fa84a34f846291735acac8d6399107'],1,5,6,2225769,1,,,,1858
90e811c6e3bd9e9aaee0c95223e648022cdd96ca,0,Jungtaek Lim,2015-10-17 22:30:19+09:00,"['26f966ca5b82b54c6a07e218dda9963540ef590d', 'ee1bc8a9d4fc0796e897c3b0082d35170bbca05e']",2,2,4,2225773,1,,,,1858
e954d0af0c2a431e14dd62b1b0daacc7162344d1,0,Jungtaek Lim,2015-10-17 22:33:15+09:00,['90e811c6e3bd9e9aaee0c95223e648022cdd96ca'],0,1,1,2225774,1,,,,1858
6d0a9df463e58a1b114d4b253b6ba9fe2b3c40d2,0,Jungtaek Lim,2015-10-17 22:33:54+09:00,"['e954d0af0c2a431e14dd62b1b0daacc7162344d1', '9a25aede1791bba48dbb345fb2523e1484b4db8c']",0,9,9,2225783,1,,,,1858
379ab8043e17e4a088a277f98815143154b361ab,0,Jungtaek Lim,2015-10-17 22:35:13+09:00,['6d0a9df463e58a1b114d4b253b6ba9fe2b3c40d2'],0,1,1,2225784,1,,,,1858
1d393eee25032c2649f8368178fc8934f5f79298,0,Jungtaek Lim,2015-10-17 23:25:35+09:00,['379ab8043e17e4a088a277f98815143154b361ab'],1,1,2,2225786,1,,,,1858
c356c35aeab17bc14861bf7efa8ddedd3f257741,1,Robert (Bobby) Evans,2015-10-17 13:59:23-05:00,['1d393eee25032c2649f8368178fc8934f5f79298'],1,799,800,2226586,32,0.530555556,0.577777778,0.902777778,1886
064ff8bb3e9b037017f87ab2576dbbb091de9c8a,0,Sanket,2015-10-18 10:12:18-05:00,['1d393eee25032c2649f8368178fc8934f5f79298'],32,117,149,2226735,11,1,1,1,1888
4c2cb4f165bf0c5e6167e7bd2ad4e157ed5be7eb,0,Robert (Bobby) Evans,2015-10-19 08:10:42-05:00,['c356c35aeab17bc14861bf7efa8ddedd3f257741'],3,46,49,2226784,1,0.53125,0.53125,1,1888
b60bb72c9f572f5cdd99d8deeba1ab214d53e18d,0,Robert (Bobby) Evans,2015-10-19 08:32:56-05:00,['4c2cb4f165bf0c5e6167e7bd2ad4e157ed5be7eb'],2,12,14,2226798,1,0.375,0.375,1,1888
17d70d3b0f163e6ca3500d2c96b3e34850271a28,0,zhuol,2015-10-19 09:38:44-05:00,['1d393eee25032c2649f8368178fc8934f5f79298'],122,8425,8547,2235345,26,0.598601127,0.723916845,0.996502817,1904
a77d0581a061efbe26600d50001c8f8c7ee866e3,0,zhuol,2015-10-19 09:38:44-05:00,['17d70d3b0f163e6ca3500d2c96b3e34850271a28'],8232,78,8310,2243655,24,0.402572097,0.276890101,0.00233827,1904
3a09ef74e28279a81c5baeeade91a081c8fe5cf2,0,zhuol,2015-10-19 09:38:44-05:00,['a77d0581a061efbe26600d50001c8f8c7ee866e3'],1,1,2,2243657,1,,,,1904
584ded8e0f80482cf9e8f30938525fa0374490c2,1,zhuol,2015-10-19 09:38:44-05:00,['3a09ef74e28279a81c5baeeade91a081c8fe5cf2'],417,1447,1864,2245521,60,0.260985353,0.264980027,0.988015979,1905
f9e095dbb938134dd5442fe3a425f687dd17176b,0,zhuol,2015-10-19 09:38:44-05:00,['584ded8e0f80482cf9e8f30938525fa0374490c2'],2,8,10,2245531,1,,,,1905
e50bed80bea67ceef43cdca354c24c5eee4dbef4,0,zhuol,2015-10-19 09:44:12-05:00,['f9e095dbb938134dd5442fe3a425f687dd17176b'],2,30,32,2245563,3,0,0.952380952,0,1905
9bf8b275d258300e498b5ba514cdf1e016ffde4e,0,zhuol,2015-10-19 09:44:12-05:00,['e50bed80bea67ceef43cdca354c24c5eee4dbef4'],4,5,9,2245572,2,,,,1905
b0e52ac89094fe08d725adf6a3d82374fd61c49e,0,zhuol,2015-10-19 09:44:13-05:00,['9bf8b275d258300e498b5ba514cdf1e016ffde4e'],1,2,3,2245575,1,,,,1905
80df44ba5fcfa63dc52bb919c8b0366350e35e58,0,Boyang Jerry Peng,2015-10-19 11:32:48-05:00,['26f966ca5b82b54c6a07e218dda9963540ef590d'],35,213,248,2245823,4,0.2,1,1,1905
c88a4f69d8525cbcefb24863e0b893d8226ce650,0,Kyle Nusbaum,2015-10-19 15:05:26-05:00,"['1d393eee25032c2649f8368178fc8934f5f79298', 'b0e52ac89094fe08d725adf6a3d82374fd61c49e']",578,1793,2371,2248194,73,,,,1905
d23bd3ed244d7cddfe7e0b2adc2ef7871b055dfb,0,Kyle Nusbaum,2015-10-19 15:06:24-05:00,['c88a4f69d8525cbcefb24863e0b893d8226ce650'],0,1,1,2248195,1,,,,1905
77e9f626cb0b8086a7b51417b4deca097d35b32a,0,Jungtaek Lim,2015-10-20 09:32:59+09:00,"['d23bd3ed244d7cddfe7e0b2adc2ef7871b055dfb', '88bfa5af12ec07c0fb4c2d4a66f1812fee004edf']",11,9,20,2248215,4,,,,1905
647d672b5912012d94478a0ed6539aace4be8020,0,Jungtaek Lim,2015-10-20 22:23:21+09:00,['77e9f626cb0b8086a7b51417b4deca097d35b32a'],0,1,1,2248216,1,,,,1905
d6d9b788e88fd440df1f3b4a0ecbacdb42ce4fd1,0,Robert (Bobby) Evans,2015-10-20 09:38:21-05:00,"['647d672b5912012d94478a0ed6539aace4be8020', 'b60bb72c9f572f5cdd99d8deeba1ab214d53e18d']",1,852,853,2249069,32,,,,1905
4b4bbd08bbf881566f9e79d3158ad0e486b00c8f,0,Robert (Bobby) Evans,2015-10-20 09:51:02-05:00,['d6d9b788e88fd440df1f3b4a0ecbacdb42ce4fd1'],0,1,1,2249070,1,,,,1905
f2857eb381961dd57819d741788d47d07412c74d,1,Aaron Dossett,2015-10-20 15:19:22-05:00,['ae4b5532e5c4272f0a2a8a940632f30b69f365a0'],135,142,277,2249347,3,0.888888889,0,0,1905
921f2d53f951af1a88ebdc6820e055ed419abc4b,0,Jungtaek Lim,2015-10-21 05:32:50+09:00,"['4b4bbd08bbf881566f9e79d3158ad0e486b00c8f', '1a367fbfcec4b1f408545be2231043df51edb78d']",1,5,6,2249353,1,,,,1905
0e80f81f4b9655a3e9b610dd74aea65aed86ee24,0,Jungtaek Lim,2015-10-21 05:33:15+09:00,['921f2d53f951af1a88ebdc6820e055ed419abc4b'],0,1,1,2249354,1,,,,1905
b2356b36d39afd04c51221fcb095aeaa4f26751d,0,Jungtaek Lim,2015-10-21 07:40:56+09:00,"['0e80f81f4b9655a3e9b610dd74aea65aed86ee24', '064ff8bb3e9b037017f87ab2576dbbb091de9c8a']",32,117,149,2249503,11,,,,1905
f75fddec908c2f9e09c0913a4234797bbb721217,0,Jungtaek Lim,2015-10-21 07:57:36+09:00,['b2356b36d39afd04c51221fcb095aeaa4f26751d'],0,1,1,2249504,1,,,,1905
8ae6b574a3fe41eae5afbc20ccff23a53bc11aee,1,Edward Samson,2015-10-21 09:54:31+08:00,['f75fddec908c2f9e09c0913a4234797bbb721217'],1,1,2,2249506,1,,,,1905
c1a89d9597dfcbfeca260d4264a4b2e374c419be,0,Zhiqiang He,2015-10-21 10:09:12+08:00,"['0a5426e7c3796535dc9caf2163dc3944868581a9', 'f75fddec908c2f9e09c0913a4234797bbb721217']",5894,36595,42489,2291995,257,,,,1905
90eadfba0aaf62d45b719153eecef14712132546,0,Jungtaek Lim,2015-10-21 23:10:36+09:00,['f75fddec908c2f9e09c0913a4234797bbb721217'],2,2,4,2291999,1,,,,1905
1593a374a4a381238f39fd9b0d078586d1aaa305,1,Kishor Patil,2015-10-21 12:18:30-05:00,['d23bd3ed244d7cddfe7e0b2adc2ef7871b055dfb'],15,41,56,2292055,7,,,,1905
91c0252d223781836b569f2b85f6660ae504cdc1,0,Robert (Bobby) Evans,2015-10-21 14:29:02-05:00,"['f75fddec908c2f9e09c0913a4234797bbb721217', 'a1369bbeed1281e1ea5cc4890364eac3a50236c8']",1,1,2,2292057,1,,,,1905
b0f3be0a507a36ffbbb6bb442b968373407a5462,0,Robert (Bobby) Evans,2015-10-21 14:29:28-05:00,['91c0252d223781836b569f2b85f6660ae504cdc1'],0,1,1,2292058,1,,,,1905
f9c41e31cdd7a04f982bdfb1f25d330fa1340d47,0,Kishor Patil,2015-10-21 23:04:22+00:00,['1593a374a4a381238f39fd9b0d078586d1aaa305'],14,51,65,2292123,5,,,,1905
b57c8305460f4de46d92129c961ed46a53a216db,0,Boyang Jerry Peng,2015-10-22 11:27:56-05:00,['80df44ba5fcfa63dc52bb919c8b0366350e35e58'],10,3,13,2292136,2,0,0,0,1905
8161beab46b5d489aa37db524b980c1676dd08fe,0,zhuol,2015-10-22 12:49:36-05:00,['b0f3be0a507a36ffbbb6bb442b968373407a5462'],130,132,262,2292398,1,,,,1905
d72e277eece0155cbb5e306676f7c025cdaf9e87,0,Kyle Nusbaum,2015-10-22 14:06:51-05:00,"['b0f3be0a507a36ffbbb6bb442b968373407a5462', '8ae6b574a3fe41eae5afbc20ccff23a53bc11aee']",1,1,2,2292400,1,,,,1905
0d8a2fa5caa7a78418001fcf67e442cd136c50f0,0,Kishor Patil,2015-10-22 14:34:38-05:00,['f75fddec908c2f9e09c0913a4234797bbb721217'],23,42,65,2292465,1,,,,1905
aa7dfbfa51c9cfcdc715cd2cd9764522b95f7ffe,0,Kyle Nusbaum,2015-10-23 01:50:58-05:00,"['d72e277eece0155cbb5e306676f7c025cdaf9e87', '90eadfba0aaf62d45b719153eecef14712132546']",2,2,4,2292469,1,,,,1905
9de79225c88f0f43c060753d312c57103b946113,0,Kyle Nusbaum,2015-10-23 01:52:07-05:00,['aa7dfbfa51c9cfcdc715cd2cd9764522b95f7ffe'],0,1,1,2292470,1,,,,1905
6c0ebf706c6e028312e2842c2853a4d39206ed92,0,Kishor Patil,2015-10-23 13:00:02-05:00,['f9c41e31cdd7a04f982bdfb1f25d330fa1340d47'],29,8,37,2292507,4,,,,1905
9ad277490e26145ad5250c010aa42ef0ca2e3e07,0,Kishor Patil,2015-10-23 19:34:58+00:00,['0d8a2fa5caa7a78418001fcf67e442cd136c50f0'],10,6,16,2292523,2,,,,1905
ce5dd660d7607a4298220c905851f07d883f6baf,0,Kishor Patil,2015-10-23 16:48:24-05:00,['6c0ebf706c6e028312e2842c2853a4d39206ed92'],19,9,28,2292551,1,,,,1905
2b3e8617b88779c20524d87fe4d546ba59cc888f,0,Boyang Jerry Peng,2015-10-23 17:10:09-05:00,['b57c8305460f4de46d92129c961ed46a53a216db'],2,2,4,2292555,1,,,,1905
404bb6acab26e3c58644c2ccf75b3abe601f40bf,0,Kishor Patil,2015-10-23 19:45:29-05:00,['ce5dd660d7607a4298220c905851f07d883f6baf'],12,5,17,2292572,5,,,,1905
fd7cadd0282d40b2e20506a4295daf29dcc23e0a,0,Jungtaek Lim,2015-10-24 10:02:28+09:00,"['9de79225c88f0f43c060753d312c57103b946113', '404bb6acab26e3c58644c2ccf75b3abe601f40bf']",35,60,95,2292667,11,,,,1905
8c3fc5590709c21c4f21598d396e16309c917592,0,Jungtaek Lim,2015-10-24 10:02:58+09:00,['fd7cadd0282d40b2e20506a4295daf29dcc23e0a'],0,1,1,2292668,1,,,,1905
9e859238b3b647d834319e43a46684659178a05e,0,Jungtaek Lim,2015-10-24 10:10:50+09:00,"['8c3fc5590709c21c4f21598d396e16309c917592', '9ad277490e26145ad5250c010aa42ef0ca2e3e07']",28,43,71,2292739,2,,,,1905
b3bc585a5615d37dc9b8e7ae5562027df4625ac8,0,Jungtaek Lim,2015-10-24 10:17:12+09:00,['9e859238b3b647d834319e43a46684659178a05e'],0,1,1,2292740,1,,,,1905
aca8bfb7dd76997340dc3d6a54479686a3ee31b0,0,Jungtaek Lim,2015-10-24 10:29:23+09:00,"['b3bc585a5615d37dc9b8e7ae5562027df4625ac8', '2b3e8617b88779c20524d87fe4d546ba59cc888f']",41,212,253,2292993,4,,,,1905
ff3b8affaeed5b94fa5b3e57dee54ca48569d738,0,Jungtaek Lim,2015-10-24 10:30:35+09:00,['aca8bfb7dd76997340dc3d6a54479686a3ee31b0'],0,1,1,2292994,1,,,,1905
6177ae4f8cb3f6b71cf7457ace249f11946bcacb,0,Jungtaek Lim,2015-10-24 10:39:56+09:00,"['ff3b8affaeed5b94fa5b3e57dee54ca48569d738', '8161beab46b5d489aa37db524b980c1676dd08fe']",130,132,262,2293256,1,,,,1905
e93015c642267484cc65fa7c0a3c205f90673f14,0,Jungtaek Lim,2015-10-24 11:55:42+09:00,['6177ae4f8cb3f6b71cf7457ace249f11946bcacb'],0,1,1,2293257,1,,,,1905
4d79d9b3b66bd381d6654e68fb418d2efad8e922,1,Matt Tieman,2015-10-23 23:47:13-04:00,['47f4a3c3d3396b35928578e36b27dbcc49f00752'],39,14,53,2293310,6,0.739130435,0,0.260869565,1905
e75219b5a4856c39c4031c3d6205105e034d10af,0,Robert (Bobby) Evans,2015-10-24 09:11:58-05:00,['e93015c642267484cc65fa7c0a3c205f90673f14'],241,1008,1249,2294559,15,0.48785872,0.869757174,0.841059603,1912
16c33efac39edea7e2d77df319d0ee3fd407383a,0,Robert (Bobby) Evans,2015-10-24 10:27:45-05:00,['e75219b5a4856c39c4031c3d6205105e034d10af'],5,5,10,2294569,3,,,,1912
46b807881379270617ec56c298a2a687a16f45f1,1,Robert (Bobby) Evans,2015-10-24 10:52:49-05:00,['16c33efac39edea7e2d77df319d0ee3fd407383a'],1,1,2,2294571,1,,,,1912
3bc375e73b05b0ff1b390ce5957882a108068c00,0,Sriharsha Chintalapani,2015-10-24 18:17:14-07:00,['46b807881379270617ec56c298a2a687a16f45f1'],0,1,1,2294572,1,,,,1912
e5ad95655e2aac88647c147591d8d11349089da7,0,Sriharsha Chintalapani,2015-10-25 08:58:44-07:00,"['3bc375e73b05b0ff1b390ce5957882a108068c00', 'f2857eb381961dd57819d741788d47d07412c74d']",135,142,277,2294849,3,,,,1912
ce90df5f7cb8ad35fdea2a39bf1c0f39f0b2eff5,0,jmartell7,2015-10-25 10:58:48-05:00,['ff3b8affaeed5b94fa5b3e57dee54ca48569d738'],11,41,52,2294901,1,,,,1912
b9badc29862a4f1744d8994a7d39cd10a938a612,0,Sriharsha Chintalapani,2015-10-25 09:01:35-07:00,['e5ad95655e2aac88647c147591d8d11349089da7'],0,1,1,2294902,1,,,,1912
e82ace2d8e8a3aa53b4f7f8005ee7913b2210889,0,Joshua Martell,2015-10-25 20:35:21-05:00,['ce90df5f7cb8ad35fdea2a39bf1c0f39f0b2eff5'],0,1,1,2294903,1,,,,1912
f582b8fd00d4429f1639ff4b39b3062bee9e9609,0,Sriharsha Chintalapani,2015-10-25 19:30:01-07:00,['b9badc29862a4f1744d8994a7d39cd10a938a612'],0,1,1,2294904,1,,,,1912
8cb379fd995c489f765dac81d334946993ab6bd9,0,Sumit Chawla,2015-10-25 22:54:50-07:00,"['94de2a5932e4a68a53f15428927b72b8c1ee8563', 'f582b8fd00d4429f1639ff4b39b3062bee9e9609']",6985,34686,41671,2336575,236,,,,1912
de579bec841ad86b35d4490a4988c41509f775f5,1,Aaron Dossett,2015-10-26 08:08:44-05:00,['f582b8fd00d4429f1639ff4b39b3062bee9e9609'],1,335,336,2336911,3,0.885542169,1,0.891566265,1914
36665ef4f7b47776787d5c4bd62c87527163e683,0,Robert (Bobby) Evans,2015-10-26 11:23:17-05:00,"['f582b8fd00d4429f1639ff4b39b3062bee9e9609', 'e82ace2d8e8a3aa53b4f7f8005ee7913b2210889']",10,41,51,2336962,1,,,,1914
fa56680369963ff2cb7be27667a548d32a4d9fce,0,Robert (Bobby) Evans,2015-10-26 11:23:53-05:00,['36665ef4f7b47776787d5c4bd62c87527163e683'],0,1,1,2336963,1,,,,1914
d5e8cff557ecd926102ec15df2982976459b90ee,0,Robert (Bobby) Evans,2015-10-26 11:26:57-05:00,['fa56680369963ff2cb7be27667a548d32a4d9fce'],0,1,1,2336964,1,,,,1914
48c55c84cc7a39dc1edf6cc8d6b196dd94b9c8b0,1,Robert (Bobby) Evans,2015-10-26 12:43:51-05:00,['f582b8fd00d4429f1639ff4b39b3062bee9e9609'],84,295,379,2337343,11,0.314285714,0.778571429,0.785714286,1915
41b35ea9f2a2d452a59f5376c416b2beb05de748,0,Robert (Bobby) Evans,2015-10-26 12:43:51-05:00,['48c55c84cc7a39dc1edf6cc8d6b196dd94b9c8b0'],5,7,12,2337355,2,1,1,1,1915
7e0b08ef2201db91cb97fec979cd98faf10dbd31,0,Robert (Bobby) Evans,2015-10-26 12:43:51-05:00,['41b35ea9f2a2d452a59f5376c416b2beb05de748'],2,185,187,2337542,2,0.339805825,0.54368932,0.961165049,1916
acaa3b9c4b5dd28dc63229b8717749f3293b0adb,0,Robert (Bobby) Evans,2015-10-26 12:43:51-05:00,['7e0b08ef2201db91cb97fec979cd98faf10dbd31'],2,2,4,2337546,1,,,,1916
945db1a6e92c0c5d6d3c95be103ab3241a82a74f,0,Robert (Bobby) Evans,2015-10-26 12:43:52-05:00,['acaa3b9c4b5dd28dc63229b8717749f3293b0adb'],17,23,40,2337586,1,1,0,,1916
1be78e79a44319ec32f3d45852a284ca6e9cb895,0,Robert (Bobby) Evans,2015-10-26 13:17:42-05:00,['945db1a6e92c0c5d6d3c95be103ab3241a82a74f'],1,1,2,2337588,1,,,,1916
ee7bf656410a666b6f19bc9cd23088477b152938,0,Boyang Jerry Peng,2015-10-26 13:24:40-05:00,['d5e8cff557ecd926102ec15df2982976459b90ee'],3,3,6,2337594,1,,,,1916
25e7bc496a85c663d50b0c114c620557f35ee034,0,Matt Tieman,2015-10-26 23:07:01-04:00,['4d79d9b3b66bd381d6654e68fb418d2efad8e922'],2,2,4,2337598,1,,,,1916
cc53fe7cad65d420ce2992af4a2686e09532dcb7,0,Sriharsha Chintalapani,2015-10-27 08:45:42-07:00,['d5e8cff557ecd926102ec15df2982976459b90ee'],5,5,10,2337608,1,,,,1916
c415d321cc7cb5e5a7bf91ab9a309e9504896fbb,1,Robert (Bobby) Evans,2015-10-27 12:59:57-05:00,['1be78e79a44319ec32f3d45852a284ca6e9cb895'],339,330,669,2338277,11,0,1,1,1916
17df0526aa78112e3883148a40010a01fa5017fa,0,Boyang Jerry Peng,2015-10-27 14:10:03-05:00,['d5e8cff557ecd926102ec15df2982976459b90ee'],11,18,29,2338306,1,1,1,1,1916
3d49fb96ba6b620dc9a8673053b2453126ea2165,0,Sriharsha Chintalapani,2015-10-27 22:18:38-07:00,"['d5e8cff557ecd926102ec15df2982976459b90ee', 'de579bec841ad86b35d4490a4988c41509f775f5']",1,335,336,2338642,3,,,,1916
437c4b14903f5c094f9445494df9016737b373e5,0,Sriharsha Chintalapani,2015-10-27 22:32:24-07:00,['3d49fb96ba6b620dc9a8673053b2453126ea2165'],0,1,1,2338643,1,,,,1916
c0c830c1e41059a39a61b6563d77ecab5f333186,1,matt.tieman,2015-10-28 09:10:53-04:00,['25e7bc496a85c663d50b0c114c620557f35ee034'],23,65,88,2338731,4,,,,1916
81f6355afed7f258605e8c137ffee332d36b2b71,0,Jungtaek Lim,2015-10-28 23:10:33+09:00,"['437c4b14903f5c094f9445494df9016737b373e5', 'c0c830c1e41059a39a61b6563d77ecab5f333186']",38,203,241,2338972,9,,,,1916
ee9e4fffb684d3ba19c0cce8e97775bea5061bb4,0,Jungtaek Lim,2015-10-28 23:12:48+09:00,['81f6355afed7f258605e8c137ffee332d36b2b71'],2,4,6,2338978,2,,,,1916
1a9e1f969f7733431bc79dcdf2852f2e3a8f7554,0,Kishor Patil,2015-10-28 14:35:14+00:00,"['ee9e4fffb684d3ba19c0cce8e97775bea5061bb4', '1be78e79a44319ec32f3d45852a284ca6e9cb895']",101,503,604,2339582,13,,,,1916
c65b07b66f6c1bce0054e28650ff14a50cf59728,0,Kishor Patil,2015-10-28 14:55:55+00:00,['1a9e1f969f7733431bc79dcdf2852f2e3a8f7554'],0,1,1,2339583,1,,,,1916
88f71b858e2589abbd477f560bfbb706225ea82c,0,Xin Wang,2015-10-29 13:09:20+08:00,['5c38b91accb9b9f5adfeea412bac0e457508f492'],19,17,36,2339619,1,1,0,0,1916
2e1bedcf584b9fa46796567bc6ccaa0068b92cfd,0,Xin Wang,2015-10-29 13:26:10+08:00,['88f71b858e2589abbd477f560bfbb706225ea82c'],1,0,1,2339620,1,,,,1916
acca57205c731a48b5285bfe85c5ea55e6222108,1,Julien Nioche,2015-10-29 12:37:18+00:00,['c65b07b66f6c1bce0054e28650ff14a50cf59728'],34,24,58,2339678,3,,,,1916
698fff6f7426c30694adbefac07cfe390030cf05,1,Julien Nioche,2015-10-29 14:53:08+00:00,['acca57205c731a48b5285bfe85c5ea55e6222108'],10,10,20,2339698,1,,,,1916
59bfd1f9f0c45ed9613eced1e94c3ae16ad7c1a1,0,Derek Dagit,2015-10-29 11:37:51-05:00,"['c65b07b66f6c1bce0054e28650ff14a50cf59728', 'ee7bf656410a666b6f19bc9cd23088477b152938']",2,2,4,2339702,1,,,,1916
8be6c7ceff63bae38ee6af32b54f7c0ccdb76e59,0,Derek Dagit,2015-10-29 11:44:07-05:00,['59bfd1f9f0c45ed9613eced1e94c3ae16ad7c1a1'],0,1,1,2339703,1,,,,1916
b6615d5b15846ce737a283b71773a6c85f6f1cd7,0,Derek Dagit,2015-10-29 11:44:40-05:00,"['c65b07b66f6c1bce0054e28650ff14a50cf59728', '8be6c7ceff63bae38ee6af32b54f7c0ccdb76e59']",2,3,5,2339708,2,,,,1916
2c2858e430d0c9065e98f71ba22113628612e022,1,zhuol,2015-10-29 13:18:15-05:00,['b6615d5b15846ce737a283b71773a6c85f6f1cd7'],286,579,865,2340573,12,0,0.307692308,1,1916
d009d67dd0323db4c2bd472b597a99ff9de9227a,0,zhuol,2015-10-29 13:18:15-05:00,['2c2858e430d0c9065e98f71ba22113628612e022'],141,330,471,2341044,7,0,1,1,1916
ce97de35ec8f3b12f32360e7b678e7ecab5d3f85,0,zhuol,2015-10-29 13:18:15-05:00,['d009d67dd0323db4c2bd472b597a99ff9de9227a'],14,9,23,2341067,1,,,,1916
70f455f133db1c015999d1748fa778dacefc7684,1,zhuol,2015-10-29 13:55:55-05:00,['b6615d5b15846ce737a283b71773a6c85f6f1cd7'],32,246,278,2341345,10,0.666666667,0.685185185,0.981481481,1916
416686ecceef66829c98bf90d112dea5c1870e7b,0,zhuol,2015-10-29 15:36:05-05:00,['70f455f133db1c015999d1748fa778dacefc7684'],218,2749,2967,2344312,7,0.13356974,0.195035461,0.989361702,1916
bed92d6f7624244a834006c5188cbfd5dd7b6424,1,zhuol,2015-10-29 15:36:07-05:00,['416686ecceef66829c98bf90d112dea5c1870e7b'],7,6,13,2344325,2,,,,1916
3688fa80416fd8b8422a52c4754fdca9000c603d,0,zhuol,2015-10-29 15:36:07-05:00,['bed92d6f7624244a834006c5188cbfd5dd7b6424'],5,5,10,2344335,1,,,,1916
c367fdbd88bf7c8a5b20dc37299bc357b33fd437,0,Parth Brahmbhatt,2015-10-29 14:29:17-07:00,['b6615d5b15846ce737a283b71773a6c85f6f1cd7'],0,154,154,2344489,7,0.642857143,1,0.839285714,1918
62c40348ffdac1844067307f6b595633b1addac7,0,Derek Dagit,2015-10-29 21:23:40-05:00,"['b6615d5b15846ce737a283b71773a6c85f6f1cd7', 'ce97de35ec8f3b12f32360e7b678e7ecab5d3f85']",403,880,1283,2345772,13,,,,1918
8cac78238532dde607560487a8bbed786f6152b7,0,Derek Dagit,2015-10-29 21:25:57-05:00,['62c40348ffdac1844067307f6b595633b1addac7'],0,1,1,2345773,1,,,,1918
0bba2baf92bb4042b2c47b2266ff1e4df006a6a3,0,Derek Dagit,2015-10-29 21:26:27-05:00,"['b6615d5b15846ce737a283b71773a6c85f6f1cd7', '8cac78238532dde607560487a8bbed786f6152b7']",403,881,1284,2347057,14,,,,1918
24886eec5c45e7fd30cac804fd080360f17599a0,0,zhuol,2015-10-30 10:10:32-05:00,['0bba2baf92bb4042b2c47b2266ff1e4df006a6a3'],1,1,2,2347059,1,,,,1918
122f8f7b58f85970952880505495adf621b7226c,0,Robert (Bobby) Evans,2015-10-30 12:56:33-05:00,"['0bba2baf92bb4042b2c47b2266ff1e4df006a6a3', 'c415d321cc7cb5e5a7bf91ab9a309e9504896fbb']",339,330,669,2347728,11,,,,1918
a0f3412a8268e75f87a95421a53f6bc4b6af9842,0,Robert (Bobby) Evans,2015-10-30 12:57:10-05:00,['122f8f7b58f85970952880505495adf621b7226c'],0,1,1,2347729,1,,,,1918
2ef1414cc0088dfea3f8e7396fc621de8d19d783,1,zhuol,2015-10-30 14:55:23-05:00,['3688fa80416fd8b8422a52c4754fdca9000c603d'],5,22,27,2347756,4,,,,1918
f6149c87763d431dcfca4a3a0abdccc534c8d180,0,zhuol,2015-10-30 15:25:52-05:00,['2ef1414cc0088dfea3f8e7396fc621de8d19d783'],1,1,2,2347758,1,,,,1918
1d488d9c1638e8ac27b8363f725fc79d7e56342d,1,zhuol,2015-10-30 15:53:19-05:00,['f6149c87763d431dcfca4a3a0abdccc534c8d180'],8,8,16,2347774,1,,,,1918
9b9efc46d5e4fc538f59df88e5614d811f0d1e63,0,zhuol,2015-10-30 16:02:56-05:00,['1d488d9c1638e8ac27b8363f725fc79d7e56342d'],2,2,4,2347778,2,,,,1918
090991ddde328a23554421e4ea89b77f80fb057f,0,Derek Dagit,2015-10-30 16:07:50-05:00,"['a0f3412a8268e75f87a95421a53f6bc4b6af9842', '9b9efc46d5e4fc538f59df88e5614d811f0d1e63']",257,3018,3275,2351053,16,,,,1918
3502907fac5b454a878e29fbdefe73ff9c2327b7,0,Derek Dagit,2015-10-30 16:16:33-05:00,['090991ddde328a23554421e4ea89b77f80fb057f'],0,1,1,2351054,1,,,,1918
ffb5d033864362378200dcd6bfa3dd086a225a47,0,Derek Dagit,2015-10-30 16:17:03-05:00,"['a0f3412a8268e75f87a95421a53f6bc4b6af9842', '3502907fac5b454a878e29fbdefe73ff9c2327b7']",257,3019,3276,2354330,17,,,,1918
bd0e8a01bba16f156c544df107345a7f9703dc57,0,Suresh Srinivas,2015-10-30 14:36:42-07:00,['0bba2baf92bb4042b2c47b2266ff1e4df006a6a3'],96,74,170,2354500,11,0,1,0,1918
444ec05e5a9f38f9a9472c54b39f1371c839683b,1,Kyle Nusbaum,2015-10-30 17:21:27-05:00,['0bba2baf92bb4042b2c47b2266ff1e4df006a6a3'],584,8093,8677,2363177,132,0.49529949,0.600322321,0.946011281,1957
8b6e3f705107e9991325e8db4693732c13a1015f,0,Sriharsha Chintalapani,2015-10-30 15:21:38-07:00,"['ffb5d033864362378200dcd6bfa3dd086a225a47', 'c367fdbd88bf7c8a5b20dc37299bc357b33fd437']",0,154,154,2363331,7,,,,1957
3a724ee3ce0a409f5f4e97b3ab827aae446a5d34,0,Sriharsha Chintalapani,2015-10-30 15:22:21-07:00,['8b6e3f705107e9991325e8db4693732c13a1015f'],0,1,1,2363332,1,,,,1957
7f9d00dba940addb854f7f7f765cb711102857e0,0,Kyle Nusbaum,2015-10-30 17:31:13-05:00,"['444ec05e5a9f38f9a9472c54b39f1371c839683b', 'ffb5d033864362378200dcd6bfa3dd086a225a47']",589,3343,3932,2367264,27,,,,1957
a8ceb1ca39dedd8b8b0ac9a599d0ebf771adca9a,0,Kyle Nusbaum,2015-10-30 17:36:38-05:00,['7f9d00dba940addb854f7f7f765cb711102857e0'],65,65,130,2367394,65,,,,1957
34b1373d4a621ea0b9a18598a800c566e9fc25be,0,Kyle Nusbaum,2015-10-30 17:38:14-05:00,['a8ceb1ca39dedd8b8b0ac9a599d0ebf771adca9a'],2,2,4,2367398,2,,,,1957
33903de82d30021885e73e16a2d479c504e0b163,0,Kyle Nusbaum,2015-10-30 17:48:00-05:00,['34b1373d4a621ea0b9a18598a800c566e9fc25be'],48,48,96,2367494,1,,,,1957
fe08a9f0bc5505e16fcc768c2421b8e54b1db5f3,0,Sriharsha Chintalapani,2015-10-31 10:51:06-07:00,"['3a724ee3ce0a409f5f4e97b3ab827aae446a5d34', 'bd0e8a01bba16f156c544df107345a7f9703dc57']",96,74,170,2367664,11,,,,1957
72fc3beb45000c56af7e1863e95f6c8bc8ec9f75,0,Sriharsha Chintalapani,2015-10-31 10:56:54-07:00,['fe08a9f0bc5505e16fcc768c2421b8e54b1db5f3'],0,1,1,2367665,1,,,,1957
2fed2ae40ccf437d6cb1fcd25298b62a23313e3a,0,Sriharsha Chintalapani,2015-10-31 10:59:12-07:00,"['72fc3beb45000c56af7e1863e95f6c8bc8ec9f75', '24886eec5c45e7fd30cac804fd080360f17599a0']",1,1,2,2367667,1,,,,1957
8ba776bfda2b8070767100d429b29a1a1adb00bd,0,Sriharsha Chintalapani,2015-10-31 11:22:03-07:00,['2fed2ae40ccf437d6cb1fcd25298b62a23313e3a'],0,1,1,2367668,1,,,,1957
5a509c46977c8d1dcc5a3cf2b02e365eec548d3c,0,Rick Kellogg,2015-11-01 08:30:07-05:00,['f3d60bdfe2457aec0bffe59adef6df72d5fee608'],3,3,6,2367674,1,,,,1957
fe882009aa1070b3abb216064f7b54e6a5ac56c1,0,Sumit Chawla,2015-11-01 19:18:24-08:00,"['8cb379fd995c489f765dac81d334946993ab6bd9', '8ba776bfda2b8070767100d429b29a1a1adb00bd']",1180,5487,6667,2374341,72,,,,1957
507f295fc800e61486c55579ff05a13310494424,0,Aaron Dossett,2015-11-02 08:18:58-06:00,['de579bec841ad86b35d4490a4988c41509f775f5'],0,33,33,2374374,1,,,,1957
0c2021e6331cb5324a2803aff9783b539a05f63c,1,Kishor Patil,2015-11-02 18:51:58+00:00,['8ba776bfda2b8070767100d429b29a1a1adb00bd'],28,4149,4177,2378551,30,0.555804572,0.659793814,0.950694756,1964
4c097329187412f75e80a657effa997e2656923f,0,Sriharsha Chintalapani,2015-11-02 14:01:48-08:00,['fe882009aa1070b3abb216064f7b54e6a5ac56c1'],4,4,8,2378559,2,,,,1964
60d9f81ba1b16f7711c487f831f202e49eda258c,0,Sriharsha Chintalapani,2015-11-02 14:03:43-08:00,['4c097329187412f75e80a657effa997e2656923f'],0,1,1,2378560,1,,,,1964
5bd5cf958943007dfe1742f6d4adda8f2a0b75ee,1,Thomas Graves,2015-11-02 22:12:34+00:00,['8ba776bfda2b8070767100d429b29a1a1adb00bd'],2,143,145,2378705,6,1,1,1,1965
6e29d270d95d45cb6e05be8c325475639ae8d9a7,1,Sriharsha Chintalapani,2015-11-02 19:56:29-08:00,['60d9f81ba1b16f7711c487f831f202e49eda258c'],109,93,202,2378907,23,0,0,0,1965
7edf5200d4c9d9348f7af37ee4b17e5c5e1d492a,0,Sriharsha Chintalapani,2015-11-02 19:57:21-08:00,['6e29d270d95d45cb6e05be8c325475639ae8d9a7'],0,1,1,2378908,1,,,,1965
ae5f785ae54c29b341e27bb03bf3748d833da94d,0,Sriharsha Chintalapani,2015-11-02 20:13:01-08:00,"['7edf5200d4c9d9348f7af37ee4b17e5c5e1d492a', '5a509c46977c8d1dcc5a3cf2b02e365eec548d3c']",3,3,6,2378914,1,,,,1965
d2f9305abb16ee3573abaab56de7b1e673168cd5,1,Kishor Patil,2015-11-02 23:51:33-06:00,['0c2021e6331cb5324a2803aff9783b539a05f63c'],32,72,104,2379018,6,,,,1965
f697044a466038ee081fb668be5497c7b5080a8e,1,Kishor Patil,2015-11-03 00:19:10-06:00,['d2f9305abb16ee3573abaab56de7b1e673168cd5'],2,4,6,2379024,2,,,,1965
ac25d6d3bf27efb9367cd537bfc7732b8fea0c0f,1,Aaron Dossett,2015-11-03 07:52:17-06:00,['de579bec841ad86b35d4490a4988c41509f775f5'],0,186,186,2379210,1,1,1,0.835443038,1966
f3568d73c8832cdf2a6a6ec06b929c8b7bb96c10,0,Sriharsha Chintalapani,2015-11-03 06:57:36-08:00,['ae5f785ae54c29b341e27bb03bf3748d833da94d'],0,1,1,2379211,1,,,,1966
af64a3a2ad951a5753c82d7acffc97518b847dcd,1,Robert (Bobby) Evans,2015-11-03 12:17:34-06:00,['7edf5200d4c9d9348f7af37ee4b17e5c5e1d492a'],144,1005,1149,2380360,26,0.766990291,0.86407767,0.718446602,1974
c90c57447e3c9d466eabf06912e63c8fa53928da,1,Thomas Graves,2015-11-03 19:51:04+00:00,['5bd5cf958943007dfe1742f6d4adda8f2a0b75ee'],1,2,3,2380363,1,,,,1974
f6268a08499072e0f091df19605ee64fb3e80ba3,1,Thomas Graves,2015-11-03 19:54:42+00:00,['c90c57447e3c9d466eabf06912e63c8fa53928da'],1,1,2,2380365,1,,,,1974
d59e936af6ed797026ad5b6a86b3b4b28f5660ff,0,Kyle Nusbaum,2015-11-03 14:31:51-06:00,['33903de82d30021885e73e16a2d479c504e0b163'],4,4,8,2380373,1,,,,1974
b1fca5e65f877d1ef73e68bd6f87ad11340a01c1,1,Thomas Graves,2015-11-03 20:49:40+00:00,['f6268a08499072e0f091df19605ee64fb3e80ba3'],0,2,2,2380375,1,,,,1974
664b0ce39a26e92cbc7a08ebb1f099871d30ca9d,0,Robert (Bobby) Evans,2015-11-03 14:56:23-06:00,['af64a3a2ad951a5753c82d7acffc97518b847dcd'],2,4,6,2380381,2,,,,1974
0f0d238deab48178da78cb6f0645d0323b95cafa,0,Boyang Jerry Peng,2015-11-03 15:12:48-06:00,['17df0526aa78112e3883148a40010a01fa5017fa'],42,55,97,2380478,2,0,0.714285714,0.642857143,1974
5c6368c91ceb24448e65a94eae57bad007ac0728,0,Boyang Jerry Peng,2015-11-03 15:12:55-06:00,['0f0d238deab48178da78cb6f0645d0323b95cafa'],2,1,3,2380481,1,,,,1974
25f31a0eee02ceee75f72a8f82f9f33e98cdd192,0,Kishor Patil,2015-11-03 15:16:58-06:00,['f697044a466038ee081fb668be5497c7b5080a8e'],0,2,2,2380483,8,,,,1974
780a472ad2dc4e838b86f65f0c40eb9443046038,0,Boyang Jerry Peng,2015-11-03 17:13:08-06:00,['8ba776bfda2b8070767100d429b29a1a1adb00bd'],16,16,32,2380515,1,,,,1974
8d91ad942374108fce588d3a144cb1831d505521,1,Kishor Patil,2015-11-04 00:24:19-06:00,['25f31a0eee02ceee75f72a8f82f9f33e98cdd192'],0,195,195,2380710,1,,,,1974
77429d07d7c080962b8c414cf02ee93839b25ca2,0,Arun Mahadevan,2015-11-04 16:47:19+05:18,['f3568d73c8832cdf2a6a6ec06b929c8b7bb96c10'],1,1662,1663,2382373,23,0.621993127,0.941580756,0.931271478,1993
8d6ab39ac7d6625254c9dedd217b9d0ce63531fe,0,zhuol,2015-11-04 10:47:19-06:00,['f3568d73c8832cdf2a6a6ec06b929c8b7bb96c10'],1,1,2,2382375,1,,,,1993
a4876b2dc972e4a05f820125da2b933233a217ef,1,Kishor Patil,2015-11-04 11:03:32-06:00,['8d91ad942374108fce588d3a144cb1831d505521'],7,8,15,2382390,2,,,,1993
f35ce6016ad519dced9aff44bb8458cc02740f93,0,Boyang Jerry Peng,2015-11-04 11:05:23-06:00,['780a472ad2dc4e838b86f65f0c40eb9443046038'],2,2,4,2382394,1,,,,1993
2b859fb02db965ea7a68bd69c667526913cf6711,0,Derek Dagit,2015-11-04 11:08:54-06:00,['f3568d73c8832cdf2a6a6ec06b929c8b7bb96c10'],2,0,2,2382396,1,1,1,0,1993
6e0fc9ea4da8d3d2ae919c05000bf6f2a1c709b8,0,Robert (Bobby) Evans,2015-11-04 11:10:20-06:00,"['f3568d73c8832cdf2a6a6ec06b929c8b7bb96c10', 'a4876b2dc972e4a05f820125da2b933233a217ef']",28,4389,4417,2386813,35,,,,1993
f3ed08b9ffb32f0d0c756f176756484366f37f2c,0,Robert (Bobby) Evans,2015-11-04 11:10:53-06:00,['6e0fc9ea4da8d3d2ae919c05000bf6f2a1c709b8'],0,1,1,2386814,1,,,,1993
686e9061fbe921fed23b81b02faeb5965556b6b8,0,zhuol,2015-11-04 11:11:08-06:00,['8d6ab39ac7d6625254c9dedd217b9d0ce63531fe'],1,1,2,2386816,1,,,,1993
b98acd3c41278870e10cc0c1123ae69f24070ad6,0,Boyang Jerry Peng,2015-11-04 13:45:12-06:00,['f3ed08b9ffb32f0d0c756f176756484366f37f2c'],10,220,230,2387046,9,,,,1993
8501184e39b565888995b4262c1758e334428eff,1,Boyang Jerry Peng,2015-11-04 13:45:26-06:00,['b98acd3c41278870e10cc0c1123ae69f24070ad6'],0,70,70,2387116,1,,,,1994
3586bc3eb1d98ead97cee996f201e1b90405cb63,0,Boyang Jerry Peng,2015-11-04 13:45:26-06:00,['8501184e39b565888995b4262c1758e334428eff'],47,46,93,2387209,3,,,,1994
4a57e500b3e0c3f3256e776357d1e1de1c7f5e49,0,Sriharsha Chintalapani,2015-11-04 12:04:59-08:00,"['f3ed08b9ffb32f0d0c756f176756484366f37f2c', '698fff6f7426c30694adbefac07cfe390030cf05']",34,24,58,2387267,3,,,,1994
77aa363ddf9de8a1bd0a11e86ee29c1c283424c2,1,zhuol,2015-11-04 14:24:18-06:00,['f3ed08b9ffb32f0d0c756f176756484366f37f2c'],1,1,2,2387269,1,,,,1994
faa33f922aa7deac0622de2d4d48c86d0cc61875,0,Xin Wang,2015-11-05 10:57:56+08:00,['2e1bedcf584b9fa46796567bc6ccaa0068b92cfd'],2,13,15,2387284,1,0,1,1,1994
58f099421eeed8286d1e7729dad45a60de38f0c8,0,Xin Wang,2015-11-05 11:27:30+08:00,['faa33f922aa7deac0622de2d4d48c86d0cc61875'],3,4,7,2387291,1,1,1,1,1994
0c2fce5bf8fa41430ca09ce6a55afef607b031d7,1,Arun Mahadevan,2015-11-05 18:56:48+05:18,['77429d07d7c080962b8c414cf02ee93839b25ca2'],77,181,258,2387549,14,0.587301587,0.698412698,0.777777778,1994
23f75d973bc242c4c42433cfc518bfd1435cf7d0,1,Boyang Jerry Peng,2015-11-05 11:13:01-06:00,['3586bc3eb1d98ead97cee996f201e1b90405cb63'],6,10,16,2387565,3,,,,1995
e9c2495361b3c72d2a1ca1dac4010aee763ed286,0,Kyle Nusbaum,2015-11-05 11:29:21-06:00,"['4a57e500b3e0c3f3256e776357d1e1de1c7f5e49', '5c6368c91ceb24448e65a94eae57bad007ac0728']",39,58,97,2387662,2,,,,1995
316b23ec4a0afc05abeacaefed3684dce895362c,0,Kyle Nusbaum,2015-11-05 11:30:37-06:00,['e9c2495361b3c72d2a1ca1dac4010aee763ed286'],0,1,1,2387663,1,,,,1995
be9799e4f43d6721e08a3ceab18df9c6ae34cd3b,0,Thomas Graves,2015-11-05 18:53:03+00:00,['b1fca5e65f877d1ef73e68bd6f87ad11340a01c1'],1,8,9,2387672,2,,,,1995
b3521c577bef6654dcf90269c4639064c3ae60eb,0,Thomas Graves,2015-11-05 19:08:45+00:00,"['be9799e4f43d6721e08a3ceab18df9c6ae34cd3b', '316b23ec4a0afc05abeacaefed3684dce895362c']",390,5043,5433,2393105,86,,,,1995
7fe5ac9746dd103bb15f458d649f416b285efd9b,0,Thomas Graves,2015-11-05 19:24:14+00:00,['b3521c577bef6654dcf90269c4639064c3ae60eb'],1,1,2,2393107,1,,,,1995
7a8e6ca18eb16c86bf8413f1b78c7857cf2aa9d0,0,Robert (Bobby) Evans,2015-11-05 14:42:14-06:00,"['316b23ec4a0afc05abeacaefed3684dce895362c', '2b859fb02db965ea7a68bd69c667526913cf6711']",2,0,2,2393109,1,,,,1995
9e2b02dcdcac319b3107f6c0270cc26f2063dfa8,0,Robert (Bobby) Evans,2015-11-05 14:42:40-06:00,['7a8e6ca18eb16c86bf8413f1b78c7857cf2aa9d0'],0,1,1,2393110,1,,,,1995
a213ccefc17f05951524391fcc5999339f70d9f9,0,Robert (Bobby) Evans,2015-11-05 14:47:47-06:00,"['9e2b02dcdcac319b3107f6c0270cc26f2063dfa8', '77aa363ddf9de8a1bd0a11e86ee29c1c283424c2']",1,1,2,2393112,1,,,,1995
2bad9c62e0f7b5a0c101379a929bffac9cccb5ca,0,Robert (Bobby) Evans,2015-11-05 14:48:15-06:00,['a213ccefc17f05951524391fcc5999339f70d9f9'],0,1,1,2393113,1,,,,1995
e49e8c52e5f8814e8ea89c6c58347913ed313fde,0,Parth Brahmbhatt,2015-11-05 12:57:17-08:00,['b6615d5b15846ce737a283b71773a6c85f6f1cd7'],30,76,106,2393219,3,,,,1996
2575b491087d51268e014b28518cbec66aac0239,0,Robert (Bobby) Evans,2015-11-05 15:01:15-06:00,"['2bad9c62e0f7b5a0c101379a929bffac9cccb5ca', '686e9061fbe921fed23b81b02faeb5965556b6b8']",2,2,4,2393223,1,,,,1996
8545ff9a638c8e5be3322243b8e5b6a2f853605e,0,Robert (Bobby) Evans,2015-11-05 15:02:37-06:00,['2575b491087d51268e014b28518cbec66aac0239'],0,1,1,2393224,1,,,,1996
30b3598497d1e2b732c3093abb379f7012b17b01,0,Robert (Bobby) Evans,2015-11-05 15:13:38-06:00,"['8545ff9a638c8e5be3322243b8e5b6a2f853605e', 'f35ce6016ad519dced9aff44bb8458cc02740f93']",16,16,32,2393256,1,,,,1996
90edd94dd2d9cc07945ff06fd084980ef32dd0f0,0,Robert (Bobby) Evans,2015-11-05 15:14:06-06:00,['30b3598497d1e2b732c3093abb379f7012b17b01'],0,1,1,2393257,1,,,,1996
0892f09358e158e9035480a0dfdcb486764e790d,0,Aaron Dossett,2015-11-05 16:03:31-06:00,['90edd94dd2d9cc07945ff06fd084980ef32dd0f0'],60,357,417,2393674,19,,,,1996
34c7eb26e06db3d3fbcf7ded6664944c25a46a9e,0,Boyang Jerry Peng,2015-11-05 16:12:34-06:00,['90edd94dd2d9cc07945ff06fd084980ef32dd0f0'],12,18,30,2393704,1,1,1,1,1996
d59eaac77ed65b85f6aa2d8ab56ca99b1075d468,0,Sriharsha Chintalapani,2015-11-05 16:45:15-08:00,['90edd94dd2d9cc07945ff06fd084980ef32dd0f0'],5,0,5,2393709,1,,,,1996
c804139e86010f7a845af8a0d1713d7efbe7f699,0,Xin Wang,2015-11-06 11:31:32+08:00,['d59eaac77ed65b85f6aa2d8ab56ca99b1075d468'],1,1,2,2393711,1,,,,1996
eb129410dbd12ccdbc213e258312b23cc165557e,0,Arun Mahadevan,2015-11-06 10:22:42+05:18,['0c2fce5bf8fa41430ca09ce6a55afef607b031d7'],23,65,88,2393799,5,1,1,1,1996
024ff263800e4032d7b2395fbbf072e0183ebb5b,0,Robert (Bobby) Evans,2015-11-06 08:16:28-06:00,['664b0ce39a26e92cbc7a08ebb1f099871d30ca9d'],4,8,12,2393811,1,,,,1996
6e76d4b2f4c6eb788b0d04f4ac40e5fc0600c837,0,Robert (Bobby) Evans,2015-11-06 09:41:09-06:00,"['d59eaac77ed65b85f6aa2d8ab56ca99b1075d468', '0892f09358e158e9035480a0dfdcb486764e790d']",60,357,417,2394228,19,,,,1996
b24b0fece6962e1b455ec2fc3499ded2c4c7f7e5,0,Robert (Bobby) Evans,2015-11-06 09:41:45-06:00,['6e76d4b2f4c6eb788b0d04f4ac40e5fc0600c837'],0,1,1,2394229,1,,,,1996
76d73e977f4fddcbf415d51980c9f9bbcd26e0db,0,Chuck Burgess,2015-11-06 10:00:01-06:00,['d59eaac77ed65b85f6aa2d8ab56ca99b1075d468'],0,18,18,2394247,3,0.357142857,0.357142857,0.857142857,1996
fe348412ec95417533a5b6222e4ce1aadd182472,0,Chuck Burgess,2015-11-06 10:00:01-06:00,['76d73e977f4fddcbf415d51980c9f9bbcd26e0db'],0,1,1,2394248,1,,,,1996
b8b2e16374b3f10e81b6bbc6daab5f318b813146,0,Chuck Burgess,2015-11-06 10:24:57-06:00,['d59eaac77ed65b85f6aa2d8ab56ca99b1075d468'],1,2,3,2394251,1,1,1,1,1996
8805443c6ff81eb6718e3cb9a844187b19e66ffe,0,Aaron Dossett,2015-11-06 10:55:42-06:00,['0892f09358e158e9035480a0dfdcb486764e790d'],0,26,26,2394277,1,,,,1997
e9fccb1277edbd62de1c28c8ffbb569ff5f68979,0,Robert (Bobby) Evans,2015-11-06 10:59:24-06:00,"['b24b0fece6962e1b455ec2fc3499ded2c4c7f7e5', '23f75d973bc242c4c42433cfc518bfd1435cf7d0']",10,293,303,2394580,11,,,,1997
1a94d9e283350c1a333a006a657f4bd530eefa34,0,Robert (Bobby) Evans,2015-11-06 11:00:09-06:00,['e9fccb1277edbd62de1c28c8ffbb569ff5f68979'],0,1,1,2394581,1,,,,1997
795edec74961dcd13f9ee87f716bf7270c6cadf8,0,Robert (Bobby) Evans,2015-11-06 11:14:55-06:00,"['1a94d9e283350c1a333a006a657f4bd530eefa34', '8805443c6ff81eb6718e3cb9a844187b19e66ffe']",0,26,26,2394607,1,,,,1997
68d72b32c5fb33923c6169d2100087028a6ec8ce,0,Kishor Patil,2015-11-06 17:43:42+00:00,"['795edec74961dcd13f9ee87f716bf7270c6cadf8', '024ff263800e4032d7b2395fbbf072e0183ebb5b']",146,1013,1159,2395766,26,,,,1997
7f14dfd881571b18caae09b3737e14de59690c46,0,Kishor Patil,2015-11-06 17:44:41+00:00,['68d72b32c5fb33923c6169d2100087028a6ec8ce'],0,1,1,2395767,1,,,,1997
fa9c7a5bf7925fecea01315dc5b74fae55803fb7,0,Robert (Bobby) Evans,2015-11-06 11:57:59-06:00,"['7f14dfd881571b18caae09b3737e14de59690c46', 'ac25d6d3bf27efb9367cd537bfc7732b8fea0c0f']",0,186,186,2395953,1,,,,1997
b57da7b9e9aca4397eb34da3452ac03c31804ff0,0,Robert (Bobby) Evans,2015-11-06 11:58:23-06:00,['fa9c7a5bf7925fecea01315dc5b74fae55803fb7'],0,1,1,2395954,1,,,,1997
e8bf07e85dba1c0ae1b1a045e6eed245b7bc1462,0,Robert (Bobby) Evans,2015-11-06 12:25:55-06:00,"['b57da7b9e9aca4397eb34da3452ac03c31804ff0', '507f295fc800e61486c55579ff05a13310494424']",0,33,33,2395987,1,,,,1997
4fe62b2ca16ad89b99f773ee0b057c72aeec59f3,0,Robert (Bobby) Evans,2015-11-06 12:26:26-06:00,['e8bf07e85dba1c0ae1b1a045e6eed245b7bc1462'],0,1,1,2395988,1,,,,1997
2d8cd8d3d663610114edeabf5622e558ace3675b,0,Robert (Bobby) Evans,2015-11-06 13:10:20-06:00,"['4fe62b2ca16ad89b99f773ee0b057c72aeec59f3', 'b8b2e16374b3f10e81b6bbc6daab5f318b813146']",1,2,3,2395991,1,,,,1997
8fd08b8d7573de819d4bf0167cd33ac4a806d078,0,Robert (Bobby) Evans,2015-11-06 13:10:44-06:00,['2d8cd8d3d663610114edeabf5622e558ace3675b'],0,1,1,2395992,1,,,,1997
fe65176a1a7ee27715640a88fb3a831fbe2533a5,0,Robert (Bobby) Evans,2015-11-06 13:11:59-06:00,['8fd08b8d7573de819d4bf0167cd33ac4a806d078'],1,2,3,2395995,1,,,,1997
f1ec3fe086295990940fddd24174eeeb3e3e652a,0,Robert (Bobby) Evans,2015-11-06 14:43:22-06:00,"['fe65176a1a7ee27715640a88fb3a831fbe2533a5', 'fe348412ec95417533a5b6222e4ce1aadd182472']",0,19,19,2396014,4,,,,1997
ed572d2a9af9fb6ab682fd2ab10007079483a496,0,Robert (Bobby) Evans,2015-11-06 14:43:54-06:00,['f1ec3fe086295990940fddd24174eeeb3e3e652a'],0,1,1,2396015,1,,,,1997
2ed181c79b273ef46e12573bd7009149d6303720,0,Robert (Bobby) Evans,2015-11-06 14:55:17-06:00,"['ed572d2a9af9fb6ab682fd2ab10007079483a496', 'cc53fe7cad65d420ce2992af4a2686e09532dcb7']",5,5,10,2396025,1,,,,1997
2ef095e2b7a1696d105fad86cdfbf0e994d8ff7c,0,Robert (Bobby) Evans,2015-11-06 14:55:59-06:00,['2ed181c79b273ef46e12573bd7009149d6303720'],0,1,1,2396026,1,,,,1997
ea2c2d28b2fadfe6b3c2a6697640df7531804341,0,Parth Brahmbhatt,2015-11-06 13:23:35-08:00,['e49e8c52e5f8814e8ea89c6c58347913ed313fde'],35,154,189,2396215,4,1,1,1,1998
405b853450b339057e83c38094bedb2c30df8a60,0,Parth Brahmbhatt,2015-11-06 13:29:53-08:00,['ea2c2d28b2fadfe6b3c2a6697640df7531804341'],3,5,8,2396223,1,,,,1998
6a0d13bc7c95bf1cd61583057b0d4e3eda6c20f0,0,Robert (Bobby) Evans,2015-11-06 15:40:36-06:00,"['2ef095e2b7a1696d105fad86cdfbf0e994d8ff7c', '34c7eb26e06db3d3fbcf7ded6664944c25a46a9e']",12,18,30,2396253,1,,,,1998
14c7defd57e7be4de69b861a09d9a7c8c5417888,0,Robert (Bobby) Evans,2015-11-06 15:41:05-06:00,['6a0d13bc7c95bf1cd61583057b0d4e3eda6c20f0'],0,1,1,2396254,1,,,,1998
124c62cf912deccaaa2d9d37cc56d815d8654108,0,Parth Brahmbhatt,2015-11-06 15:43:50-08:00,"['405b853450b339057e83c38094bedb2c30df8a60', '14c7defd57e7be4de69b861a09d9a7c8c5417888']",1751,11496,13247,2409501,181,,,,1998
7cfa6e4260536605baf0213da1c37fe2dac41bc6,0,Xin Wang,2015-11-07 09:21:25+08:00,['c804139e86010f7a845af8a0d1713d7efbe7f699'],1,1,2,2409503,1,,,,1998
90ef005c11dc32caaa1549ad73a4b7c9195a917b,0,Sriharsha Chintalapani,2015-11-06 18:10:29-08:00,"['14c7defd57e7be4de69b861a09d9a7c8c5417888', '58f099421eeed8286d1e7729dad45a60de38f0c8']",15,25,40,2409543,3,,,,1998
c12e28c829fcfabc0a3a775fb9714968b7e3e349,0,Sriharsha Chintalapani,2015-11-06 18:20:40-08:00,['90ef005c11dc32caaa1549ad73a4b7c9195a917b'],0,1,1,2409544,1,,,,1998
194aeca7ebe90a40318a1318c09113e31b02f86a,1,Arun Mahadevan,2015-11-09 10:18:54+05:18,['eb129410dbd12ccdbc213e258312b23cc165557e'],0,144,144,2409688,1,,,,1999
5c818b093350f572a38a5c59f9e083625b298ddd,1,Robert (Bobby) Evans,2015-11-09 08:44:36-06:00,['c12e28c829fcfabc0a3a775fb9714968b7e3e349'],8,132,140,2409828,4,0.111111111,0,0.98989899,1999
22cf0acbe8233edfc1fa397e5592e5fb6bf10120,1,zhuol,2015-11-09 11:43:58-06:00,['c12e28c829fcfabc0a3a775fb9714968b7e3e349'],52,5181,5233,2415061,33,0.60472973,0.704814189,0.980152027,2015
9e907dcd2e86ec972ddd9a0e4627e00ac84970f3,0,zhuol,2015-11-09 11:51:09-06:00,['22cf0acbe8233edfc1fa397e5592e5fb6bf10120'],0,12,12,2415073,1,,,,2015
18abd0358fd7b8b7ae482f8502ffe16a8c31e67c,1,zhuol,2015-11-09 11:51:09-06:00,['9e907dcd2e86ec972ddd9a0e4627e00ac84970f3'],0,54,54,2415127,1,,,,2015
a3726a9a4d2d1e194c90c4d3d1837af004b177f7,1,zhuol,2015-11-09 11:51:09-06:00,['18abd0358fd7b8b7ae482f8502ffe16a8c31e67c'],9,16,25,2415152,4,,,,2015
2ed4478e1a8f35e5d0830e8ed2a020ae51023d81,0,zhuol,2015-11-09 11:51:09-06:00,['a3726a9a4d2d1e194c90c4d3d1837af004b177f7'],0,15,15,2415167,4,,,,2018
6764a147560bcfad439ec2572fd1cd8013546bbb,0,zhuol,2015-11-09 13:29:10-06:00,['2ed4478e1a8f35e5d0830e8ed2a020ae51023d81'],0,5,5,2415172,1,,,,2018
9916405d75798b44e28368a679498b311d3e030d,0,zhuol,2015-11-09 13:37:30-06:00,['6764a147560bcfad439ec2572fd1cd8013546bbb'],0,1,1,2415173,1,,,,2018
2923a1ca7ea15170946694f8ce27bc3665c9dd76,0,zhuol,2015-11-09 13:46:15-06:00,['9916405d75798b44e28368a679498b311d3e030d'],0,1,1,2415174,1,,,,2018
f0e4c6f2099196760f0037e7812dda543d332c54,1,Suresh Srinivas,2015-11-09 11:56:11-08:00,['c12e28c829fcfabc0a3a775fb9714968b7e3e349'],579,378,957,2416131,122,0.272727273,0.431818182,0,2018
2a782ce746565561420b60159feebef84761796f,1,Kyle Nusbaum,2015-11-09 16:26:57-06:00,['d59e936af6ed797026ad5b6a86b3b4b28f5660ff'],34,195,229,2416360,6,0,0,1,2018
a2ca314bcccaaa934cdbb3efbdc8b2ad02555a27,0,Robert (Bobby) Evans,2015-11-09 16:49:47-06:00,"['c12e28c829fcfabc0a3a775fb9714968b7e3e349', '2923a1ca7ea15170946694f8ce27bc3665c9dd76']",52,5276,5328,2421688,41,,,,2018
3147955254247b5008427002ca788d8c72c61f13,1,Kyle Nusbaum,2015-11-09 16:50:13-06:00,['2a782ce746565561420b60159feebef84761796f'],59,59,118,2421806,8,1,1,0,2018
5a4e1f85b52e370f265fe21f528a6f473d7c7c50,0,Robert (Bobby) Evans,2015-11-09 16:50:14-06:00,['a2ca314bcccaaa934cdbb3efbdc8b2ad02555a27'],0,1,1,2421807,1,,,,2018
25aae7b9efa7943b924806e3d6b5b2bd97b92f51,0,Kyle Nusbaum,2015-11-09 16:53:42-06:00,['3147955254247b5008427002ca788d8c72c61f13'],8,0,8,2421815,2,0,0,0,2018
80c60d84df16ce35f750f981526e57cfef18e48f,0,Kyle Nusbaum,2015-11-09 16:56:05-06:00,['25aae7b9efa7943b924806e3d6b5b2bd97b92f51'],2,1,3,2421818,1,1,1,0,2018
1acadff444a6660f2fedd3466863736e30eb2f01,0,Sriharsha Chintalapani,2015-11-09 16:57:05-08:00,"['5a4e1f85b52e370f265fe21f528a6f473d7c7c50', 'f0e4c6f2099196760f0037e7812dda543d332c54']",579,378,957,2422775,122,,,,2018
e25f28f7175757e98c14b5d1a502c611a8b9282b,0,Sriharsha Chintalapani,2015-11-09 18:24:54-08:00,['1acadff444a6660f2fedd3466863736e30eb2f01'],1,2,3,2422778,1,,,,2018
8fd011618f1328df669e4a8dd31edb1a2e78928b,0,Parth Brahmbhatt,2015-11-09 22:31:49-08:00,['124c62cf912deccaaa2d9d37cc56d815d8654108'],1,1,2,2422780,1,,,,2018
93815f386e16b8314b8b2e09f2072d8ef3a789c1,0,Jungtaek Lim,2015-11-10 22:09:25+09:00,"['e25f28f7175757e98c14b5d1a502c611a8b9282b', '7cfa6e4260536605baf0213da1c37fe2dac41bc6']",1,1,2,2422782,1,,,,2018
2065dcadac623e8b3bf2037ded34bc15a171734e,0,Jungtaek Lim,2015-11-10 22:10:40+09:00,['93815f386e16b8314b8b2e09f2072d8ef3a789c1'],0,1,1,2422783,1,,,,2018
57a3b89eed2cf62a6d54890e1d094023f1fb3f3b,0,Robert (Bobby) Evans,2015-11-10 08:34:22-06:00,"['2065dcadac623e8b3bf2037ded34bc15a171734e', '5c818b093350f572a38a5c59f9e083625b298ddd']",8,132,140,2422923,4,,,,2018
2b6884b30fbc77203cdc0c9e8e737041125c61b0,0,Robert (Bobby) Evans,2015-11-10 08:34:56-06:00,['57a3b89eed2cf62a6d54890e1d094023f1fb3f3b'],0,1,1,2422924,1,,,,2018
62d725a85e7869290805cdbe55f1f3bce1f905de,0,Kyle Nusbaum,2015-11-10 11:11:47-06:00,"['80c60d84df16ce35f750f981526e57cfef18e48f', '2b6884b30fbc77203cdc0c9e8e737041125c61b0']",4686,16216,20902,2443826,289,,,,2018
73650789729876f016810a8caf59bc9ef85601e1,0,Kyle Nusbaum,2015-11-10 14:02:03-06:00,['2b6884b30fbc77203cdc0c9e8e737041125c61b0'],492,773,1265,2445091,86,0,0.611510791,0.003597122,2018
c29c2b66f8ab469c44a148d44a11b0a523948940,0,Kyle Nusbaum,2015-11-10 14:40:25-06:00,['73650789729876f016810a8caf59bc9ef85601e1'],0,0,0,2445091,1,,,,2018
e9f1e01a6d397912d1401274db773e80b2c53627,0,Robert (Bobby) Evans,2015-11-10 16:22:50-06:00,['2b6884b30fbc77203cdc0c9e8e737041125c61b0'],29,25,54,2445145,1,1,0,0,2018
a99016cf7cae8a5791a4306dbe7efe674722beb8,1,Robert (Bobby) Evans,2015-11-10 16:23:47-06:00,['e9f1e01a6d397912d1401274db773e80b2c53627'],25,185,210,2445355,3,0.330434783,0.791304348,0.973913043,2018
120840d473d1c68c0e90d27b883b53adf2ea0393,1,Robert (Bobby) Evans,2015-11-11 08:11:10-06:00,['a99016cf7cae8a5791a4306dbe7efe674722beb8'],3,3,6,2445361,1,0,0,0,2018
333df58bde783f9bf602b23da6ce8dd982d02f48,0,Robert (Bobby) Evans,2015-11-11 12:18:55-06:00,['120840d473d1c68c0e90d27b883b53adf2ea0393'],10,9,19,2445380,2,0,1,1,2018
03b568fae6596274d725388ec4d4e6ccfd0e2f31,1,Robert (Bobby) Evans,2015-11-11 13:19:51-06:00,['333df58bde783f9bf602b23da6ce8dd982d02f48'],10,7,17,2445397,1,1,0,0,2018
703ba7bebf8e51bcc96ee70e9471551c253344fd,0,Robert (Bobby) Evans,2015-11-11 15:10:36-06:00,"['2b6884b30fbc77203cdc0c9e8e737041125c61b0', '7fe5ac9746dd103bb15f458d649f416b285efd9b']",1,152,153,2445550,7,,,,2018
2c934984bc92c18d9b51a44a6ce384486095a526,0,Robert (Bobby) Evans,2015-11-11 15:11:36-06:00,['703ba7bebf8e51bcc96ee70e9471551c253344fd'],0,2,2,2445552,2,,,,2018
74b0a4f681660d8349e8093900127e07b080da15,0,Robert (Bobby) Evans,2015-11-11 15:15:03-06:00,['2c934984bc92c18d9b51a44a6ce384486095a526'],2,2,4,2445556,1,,,,2018
46a4ede2b5e9e9af63af611ffade0c829babf22b,0,Robert (Bobby) Evans,2015-11-11 15:27:33-06:00,"['74b0a4f681660d8349e8093900127e07b080da15', '62eeae4b5bc547bc3f36d0a3339b268c684b7ca1']",0,2,2,2445558,1,,,,2018
34cda0d5cf26544485a7fc58feefcdf706653a6f,0,Robert (Bobby) Evans,2015-11-11 15:28:54-06:00,['46a4ede2b5e9e9af63af611ffade0c829babf22b'],0,1,1,2445559,1,,,,2018
400dcfad41e505ea16f6dc92e3a7b51aa1075259,0,Chuck Burgess,2015-11-11 16:52:49-06:00,['34cda0d5cf26544485a7fc58feefcdf706653a6f'],2,2,4,2445563,1,,,,2018
3e40c9a695c63cadd526c6e4fb365bda6ff66660,0,Jungtaek Lim,2015-11-12 08:48:39+09:00,['34cda0d5cf26544485a7fc58feefcdf706653a6f'],20,23,43,2445606,1,,,,2018
69abc578d9a1c5305e162210f132f62b026e61a0,0,Robert (Bobby) Evans,2015-11-12 08:15:57-06:00,"['34cda0d5cf26544485a7fc58feefcdf706653a6f', 'c29c2b66f8ab469c44a148d44a11b0a523948940']",492,773,1265,2446871,86,,,,2018
4eccb151b5f7739271e6fde3059767357ab717ff,0,Robert (Bobby) Evans,2015-11-12 08:16:24-06:00,['69abc578d9a1c5305e162210f132f62b026e61a0'],0,1,1,2446872,1,,,,2018
f61f33db3ffac8017b0727f6b9b486613b8164c9,0,Robert (Bobby) Evans,2015-11-12 09:29:39-06:00,"['4eccb151b5f7739271e6fde3059767357ab717ff', '3e40c9a695c63cadd526c6e4fb365bda6ff66660']",20,23,43,2446915,1,,,,2018
2057943636ba8cd9a930ef5289b0e02c1cb1f079,0,Robert (Bobby) Evans,2015-11-12 09:49:13-06:00,['f61f33db3ffac8017b0727f6b9b486613b8164c9'],0,1,1,2446916,1,,,,2018
d0575b94ed352315984dff519a171432d5719c78,0,Kishor Patil,2015-11-12 16:29:12+00:00,"['07722ffa819692ce7e5dc06905241533bf953379', '4eccb151b5f7739271e6fde3059767357ab717ff']",16169,81132,97301,2544217,789,,,,2018
b64998f846ed4d60ea6a9662d88f8a2d6353b110,0,Kishor Patil,2015-11-12 17:03:28+00:00,['d0575b94ed352315984dff519a171432d5719c78'],9,9,18,2544235,6,,,,2019
fea9555e5c86db3775829c1282f8bd31014902d3,0,Robert (Bobby) Evans,2015-11-12 11:14:38-06:00,"['2057943636ba8cd9a930ef5289b0e02c1cb1f079', '400dcfad41e505ea16f6dc92e3a7b51aa1075259']",2,2,4,2544239,1,,,,2019
f4bd90a341475456092830d6043f124ec2dbe81e,0,Robert (Bobby) Evans,2015-11-12 11:14:57-06:00,['fea9555e5c86db3775829c1282f8bd31014902d3'],0,1,1,2544240,1,,,,2019
1bdfd7e1f04194f7aa88ba2537f41a08409ce344,1,Robert (Bobby) Evans,2015-11-12 11:26:33-06:00,['f4bd90a341475456092830d6043f124ec2dbe81e'],398,506,904,2545144,15,1,1,0.804878049,2024
cdb8a850a7fb063208333697e79c73045bdc9d06,0,Robert (Bobby) Evans,2015-11-12 13:11:12-06:00,"['f4bd90a341475456092830d6043f124ec2dbe81e', '1bdfd7e1f04194f7aa88ba2537f41a08409ce344']",398,506,904,2546048,15,,,,2024
1354c4049f39bc08d45a5253b2dea485135b7987,0,Robert (Bobby) Evans,2015-11-12 13:11:42-06:00,['cdb8a850a7fb063208333697e79c73045bdc9d06'],0,1,1,2546049,1,,,,2024
9e6a3d1e5b9a175fe2a97958e050b6160819e977,0,Parth Brahmbhatt,2015-11-12 12:37:07-08:00,['8fd011618f1328df669e4a8dd31edb1a2e78928b'],3,3,6,2546055,1,,,,2024
82c25cab1873eadfbc7cc85bf9a4403158f96ae7,0,Parth Brahmbhatt,2015-11-12 12:39:18-08:00,"['1354c4049f39bc08d45a5253b2dea485135b7987', '9e6a3d1e5b9a175fe2a97958e050b6160819e977']",59,226,285,2546340,5,,,,2024
77015f073e22975e81a9a673a7cd203167c3b3ad,0,Parth Brahmbhatt,2015-11-12 13:06:24-08:00,['82c25cab1873eadfbc7cc85bf9a4403158f96ae7'],0,1,1,2546341,1,,,,2024
4645c190d094d334894acbdea0a51c67cdef7c14,1,Kyle Nusbaum,2015-11-12 16:11:11-06:00,"['62d725a85e7869290805cdbe55f1f3bce1f905de', '77015f073e22975e81a9a673a7cd203167c3b3ad']",1065,1790,2855,2549196,123,,,,2024
5cb4bf56a675480f2d8eeef38b0e02a16fa70048,0,Sriharsha Chintalapani,2015-11-12 20:08:07-08:00,['77015f073e22975e81a9a673a7cd203167c3b3ad'],2,3,5,2549201,1,,,,2024
3dbfa10c26a71d33f35037edc4e57a47f50a11f8,0,wangjiasheng,2015-11-13 16:02:32+08:00,['f8118e0854e49d70e75707e96ddb6524dff2a930'],40,14,54,2549255,2,1,1,0,2024
61ccb735f6c0e6fee70c6302dd8ef27bae056510,0,Robert (Bobby) Evans,2015-11-13 09:29:10-06:00,"['77015f073e22975e81a9a673a7cd203167c3b3ad', '03b568fae6596274d725388ec4d4e6ccfd0e2f31']",39,191,230,2549485,3,,,,2024
5a79ba5f9b509d575e374e7dce58e286c1387430,0,Robert (Bobby) Evans,2015-11-13 09:29:36-06:00,['61ccb735f6c0e6fee70c6302dd8ef27bae056510'],0,1,1,2549486,1,,,,2024
a5f07129ee2771739d661eba6847dc855fcdf55a,0,Kishor Patil,2015-11-13 21:33:16+00:00,['b64998f846ed4d60ea6a9662d88f8a2d6353b110'],0,58,58,2549544,2,,,,2024
c1faba872e49a2249b5fb61fca2e424eb579cb39,0,Kishor Patil,2015-11-13 21:48:30+00:00,['a5f07129ee2771739d661eba6847dc855fcdf55a'],2,2,4,2549548,2,,,,2024
8cf5932958954fc591146f5119da78b8e0ef7307,0,Kishor Patil,2015-11-14 19:28:18+00:00,['5a79ba5f9b509d575e374e7dce58e286c1387430'],20,40,60,2549608,1,,,,2024
b18c6ecefa13570bef097dabb0fbd2c1069aec21,1,Jayapriya Surendran,2015-11-15 17:18:54-06:00,['5a79ba5f9b509d575e374e7dce58e286c1387430'],2,2,4,2549612,1,,,,2024
1496f27a9c6f8678f7f24dc3505693f6b3ff57fa,0,wangjiasheng,2015-11-16 17:27:53+08:00,"['3dbfa10c26a71d33f35037edc4e57a47f50a11f8', '5a79ba5f9b509d575e374e7dce58e286c1387430']",12851,61649,74500,2624112,540,,,,2024
3857644b4c459cbe42b78ca8a13bd55ef704fd30,0,Derek Dagit,2015-11-16 14:15:15-06:00,['5a79ba5f9b509d575e374e7dce58e286c1387430'],48,51,99,2624211,2,0,1,1,2024
83eced3329dc62c685aa6784792506766343fd52,0,P. Taylor Goetz,2015-11-16 17:17:19-05:00,['5a79ba5f9b509d575e374e7dce58e286c1387430'],9,31,40,2624251,24,,,,2024
5261160f84bcb0ef73acf4a632d421f7e2ee901d,0,Zhiqiang He,2015-11-17 10:57:09+08:00,"['c1a89d9597dfcbfeca260d4264a4b2e374c419be', '5a79ba5f9b509d575e374e7dce58e286c1387430']",7350,25065,32415,2656666,414,,,,2024
532a594426c686da38aeab5179c0369cbd2892f1,0,wangjiasheng,2015-11-17 11:35:22+08:00,['1496f27a9c6f8678f7f24dc3505693f6b3ff57fa'],7,19,26,2656692,2,,,,2024
87a4a8b4382de5617d463b23188f18e4f7e7f03c,1,Zhiqiang-He,2015-11-17 17:14:54+08:00,['5261160f84bcb0ef73acf4a632d421f7e2ee901d'],0,11,11,2656703,3,0.333333333,0.333333333,1,2024
696ca47b59194d8dd6537bf6cb11fd9f6abd2583,0,Robert (Bobby) Evans,2015-11-17 09:35:43-06:00,"['5a79ba5f9b509d575e374e7dce58e286c1387430', '532a594426c686da38aeab5179c0369cbd2892f1']",20,86,106,2656809,3,,,,2024
1afa5a27cb7ab5191905d0cfafdb46f542a7c039,0,Robert (Bobby) Evans,2015-11-17 09:36:57-06:00,['696ca47b59194d8dd6537bf6cb11fd9f6abd2583'],0,2,2,2656811,2,,,,2024
601efa5cad6604bf922f7f1ef843e3f8ae9bf1f2,0,Kishor Patil,2015-11-17 16:14:56+00:00,['5a79ba5f9b509d575e374e7dce58e286c1387430'],6,11,17,2656828,2,1,1,1,2024
a305c141bdfc68964b55d2d760d01f48d3385873,0,Derek Dagit,2015-11-17 11:12:20-06:00,['3857644b4c459cbe42b78ca8a13bd55ef704fd30'],11,13,24,2656852,3,1,1,1,2024
1660da0e36b6f5647bc21f9813f3eca1c3c53afa,0,Kishor Patil,2015-11-17 17:23:38+00:00,['601efa5cad6604bf922f7f1ef843e3f8ae9bf1f2'],11,11,22,2656874,3,,,,2024
fa64a657aaff4a3f56d11be152a0964f36f109b8,0,Kishor Patil,2015-11-17 20:47:04+00:00,['1660da0e36b6f5647bc21f9813f3eca1c3c53afa'],11,11,22,2656896,3,,,,2024
0d98bbef6a9c3a38a70b2aa15cebb1d743c4fc9b,1,Kyle Nusbaum,2015-11-17 15:17:37-06:00,['4645c190d094d334894acbdea0a51c67cdef7c14'],0,90,90,2656986,1,,,,2025
c93a0ff66f75c75ba3a36db64099f710e0a9d8f0,1,Kyle Nusbaum,2015-11-17 15:22:29-06:00,['0d98bbef6a9c3a38a70b2aa15cebb1d743c4fc9b'],4,3,7,2656993,1,,,,2025
d7b832a44f03ec5e868bc83275fe9eef27e806ed,1,Kyle Nusbaum,2015-11-17 15:23:08-06:00,['c93a0ff66f75c75ba3a36db64099f710e0a9d8f0'],1,1,2,2656995,1,,,,2025
921db438cc30735f6e0776e2007e5c65935f46e5,0,Kyle Nusbaum,2015-11-17 15:24:08-06:00,['d7b832a44f03ec5e868bc83275fe9eef27e806ed'],3,3,6,2657001,1,,,,2025
099dc72e6fb20369379fd4f5d715f862fa267f71,0,Kyle Nusbaum,2015-11-17 15:24:36-06:00,['921db438cc30735f6e0776e2007e5c65935f46e5'],3,3,6,2657007,1,,,,2025
b8f4056c7a2a706c149dde2038b7cce1fb747942,0,Kyle Nusbaum,2015-11-17 15:39:56-06:00,['099dc72e6fb20369379fd4f5d715f862fa267f71'],1,1,2,2657009,1,,,,2025
37768ef219591a60cf7483b72a58be8552bffac1,1,Kyle Nusbaum,2015-11-17 15:42:59-06:00,['b8f4056c7a2a706c149dde2038b7cce1fb747942'],2,2,4,2657013,1,,,,2025
8c1ad3fb374f1f6311b9853c1c18820834e1f204,1,Kyle Nusbaum,2015-11-17 15:50:38-06:00,['37768ef219591a60cf7483b72a58be8552bffac1'],2,2,4,2657017,2,,,,2025
0f8d1198fb7c24c332ca473eabbae61bd26608b5,0,Kishor Patil,2015-11-17 22:43:09+00:00,['fa64a657aaff4a3f56d11be152a0964f36f109b8'],5,5,10,2657027,1,,,,2025
98159865deada8ff4c7e02264a2ed4f42c5c1c6d,1,Kyle Nusbaum,2015-11-17 17:07:26-06:00,['8c1ad3fb374f1f6311b9853c1c18820834e1f204'],6,6,12,2657039,1,,,,2025
ee5265d807f3cebeb1e1f9e44de077f1b2b3c66f,0,Kyle Nusbaum,2015-11-17 17:09:02-06:00,['98159865deada8ff4c7e02264a2ed4f42c5c1c6d'],7,7,14,2657053,1,,,,2025
ef716467caaada143c951fb88223dd476f72557a,0,Boyang Jerry Peng,2015-11-18 12:59:14-06:00,['1afa5a27cb7ab5191905d0cfafdb46f542a7c039'],2,2,4,2657057,2,,,,2025
1308f89dc7316ea8b1483136cd5ca1209790ef81,0,Kishor Patil,2015-11-18 19:39:06+00:00,"['1afa5a27cb7ab5191905d0cfafdb46f542a7c039', 'a305c141bdfc68964b55d2d760d01f48d3385873']",50,55,105,2657162,3,,,,2025
fa8bf87fcd68384c2fc2aa911eda1f13c2d76181,0,Kishor Patil,2015-11-18 19:41:03+00:00,['1308f89dc7316ea8b1483136cd5ca1209790ef81'],0,1,1,2657163,1,,,,2025
45c42471a6edad77a5154c233c624383b846ad19,0,Kishor Patil,2015-11-18 19:52:04+00:00,"['fa8bf87fcd68384c2fc2aa911eda1f13c2d76181', 'c1faba872e49a2249b5fb61fca2e424eb579cb39']",9,99,108,2657271,9,,,,2025
6d7b6da40bd2f609be4a75d1e97414716545d969,0,Kishor Patil,2015-11-18 19:53:26+00:00,['45c42471a6edad77a5154c233c624383b846ad19'],0,1,1,2657272,1,,,,2025
3612307c365682008546fa4b347c241525841484,0,Kishor Patil,2015-11-18 20:42:51+00:00,"['6d7b6da40bd2f609be4a75d1e97414716545d969', '8cf5932958954fc591146f5119da78b8e0ef7307']",20,40,60,2657332,1,,,,2025
1c07f1d9906628413464ee1ac2d33bcd7251c4c9,0,Kishor Patil,2015-11-18 20:43:40+00:00,['3612307c365682008546fa4b347c241525841484'],0,1,1,2657333,1,,,,2025
e03b28ca6222f61471b4acb1a6086aab9b597b8a,0,P. Taylor Goetz,2015-11-18 20:16:47-05:00,['1afa5a27cb7ab5191905d0cfafdb46f542a7c039'],4,13,17,2657350,1,,,,2025
d6d85518bc7a668dfe7cad9e796c226752ad0aca,0,P. Taylor Goetz,2015-11-18 20:19:09-05:00,['e03b28ca6222f61471b4acb1a6086aab9b597b8a'],119,154,273,2657623,35,,,,2025
bc77f1f59622cff0e0bef01dfbc821ac3dba21c1,0,P. Taylor Goetz,2015-11-18 20:25:27-05:00,['d6d85518bc7a668dfe7cad9e796c226752ad0aca'],0,54,54,2657677,2,,,,2025
a5ca650f7c94b07a46d3cb5a4f84ae893c83bb9c,0,David Wimsey,2015-11-18 21:46:34-05:00,['1c07f1d9906628413464ee1ac2d33bcd7251c4c9'],1,1,2,2657679,1,,,,2025
387232c68ae88c317a1607af20a0ad2a21ee62cf,1,Kyle Nusbaum,2015-11-19 11:00:47-06:00,['ee5265d807f3cebeb1e1f9e44de077f1b2b3c66f'],0,19,19,2657698,1,,,,2025
711e36fafcac33f4fb7238001ea8bc678fab2d56,1,Kyle Nusbaum,2015-11-19 11:08:52-06:00,['387232c68ae88c317a1607af20a0ad2a21ee62cf'],2,2,4,2657702,1,,,,2025
e36bc47acd43ebd567630c253d5f8f422fd21863,0,Arun Mahadevan,2015-11-19 22:31:07+05:18,['1c07f1d9906628413464ee1ac2d33bcd7251c4c9'],18,13,31,2657733,3,1,1,1,2025
fb31f953babd8e01d7ec3a62ee080a8d24de702d,0,Kishor Patil,2015-11-19 17:34:03+00:00,"['1c07f1d9906628413464ee1ac2d33bcd7251c4c9', '0f8d1198fb7c24c332ca473eabbae61bd26608b5']",11,16,27,2657760,3,,,,2025
ad0c4efd90262bb9b481c9d394c9c03dc4c41f63,0,Kishor Patil,2015-11-19 17:35:13+00:00,['fb31f953babd8e01d7ec3a62ee080a8d24de702d'],0,1,1,2657761,1,,,,2025
400f2154e458b2033299b5be5bde165dfbb57cf8,1,zhuol,2015-11-19 12:35:22-06:00,['1c07f1d9906628413464ee1ac2d33bcd7251c4c9'],7,296,303,2658064,8,0.20952381,0.142857143,0.985714286,2025
dda1c32d6b6c39c7e3027fab81f2cfce5f9927e7,1,zhuol,2015-11-19 12:35:22-06:00,['400f2154e458b2033299b5be5bde165dfbb57cf8'],1,9,10,2658074,1,,,,2025
6b12a0b0290b6f3df9c28eb1185d8b294141e60d,0,zhuol,2015-11-19 12:35:22-06:00,['dda1c32d6b6c39c7e3027fab81f2cfce5f9927e7'],1,24,25,2658099,2,,,,2025
2d993c515ecde059ad986bf2c3a77cf463d75b74,0,zhuol,2015-11-19 12:39:25-06:00,['6b12a0b0290b6f3df9c28eb1185d8b294141e60d'],6,17,23,2658122,4,,,,2025
ce7085bafe0f75a3183977414f2321fdd1b55c94,0,zhuol,2015-11-19 12:39:25-06:00,['2d993c515ecde059ad986bf2c3a77cf463d75b74'],14,132,146,2658268,12,0.114942529,0.333333333,1,2025
89fff440819836c78762b1c27fae8b005a752746,0,zhuol,2015-11-19 12:39:27-06:00,['ce7085bafe0f75a3183977414f2321fdd1b55c94'],2,2,4,2658272,2,,,,2025
515722dfdee7f5881b219f81263064b16d2f38a6,1,zhuol,2015-11-19 12:39:27-06:00,['89fff440819836c78762b1c27fae8b005a752746'],24,27,51,2658323,5,,,,2025
c4555600d7441987dfa7d81200f0058aaa38560b,1,P. Taylor Goetz,2015-11-19 15:07:14-05:00,['83eced3329dc62c685aa6784792506766343fd52'],20,38,58,2658381,1,,,,2025
71a5b1a656b099748ddfb87b6c78a26d25146904,0,zhuol,2015-11-19 16:56:17-06:00,['515722dfdee7f5881b219f81263064b16d2f38a6'],2,3,5,2658386,1,1,1,,2025
5cbad190ebcc69faeb492cd45f7e39d584db807a,0,Sriharsha Chintalapani,2015-11-19 22:55:59-08:00,"['ad0c4efd90262bb9b481c9d394c9c03dc4c41f63', '194aeca7ebe90a40318a1318c09113e31b02f86a']",1,1952,1953,2660339,24,,,,2025
ab5b2f92cceee6ffbfeebb4181e06c1835e2edcf,0,Sriharsha Chintalapani,2015-11-19 23:04:20-08:00,['5cbad190ebcc69faeb492cd45f7e39d584db807a'],0,1,1,2660340,1,,,,2025
3c89f923512fef343fdde983f289675dca2bcb0b,0,Boyang Jerry Peng,2015-11-20 12:27:54-06:00,['ef716467caaada143c951fb88223dd476f72557a'],1,1,2,2660342,1,,,,2025
bac4a053687f1ba8c806f6fe20b9d47f3fba2407,0,zhuol,2015-11-20 13:05:35-06:00,['71a5b1a656b099748ddfb87b6c78a26d25146904'],12,12,24,2660366,1,,,,2025
2e56ede5d00af774796344be6581af99076a9590,0,zhuol,2015-11-20 14:45:40-06:00,['bac4a053687f1ba8c806f6fe20b9d47f3fba2407'],10,25,35,2660401,2,0,0,1,2025
20374cef0b48c71cdbab687e2463528dba0055cb,0,Haohui Mai,2015-11-20 13:18:20-08:00,['ad0c4efd90262bb9b481c9d394c9c03dc4c41f63'],5,47,52,2660453,6,1,1,1,2026
ca21dc7d615e1dae1cd4c0f692c3b5f561688347,0,zhuol,2015-11-20 15:20:12-06:00,['2e56ede5d00af774796344be6581af99076a9590'],10,28,38,2660491,2,1,0,1,2026
e58d254102daff659250ee8adc0df68dabac6931,0,zhuol,2015-11-20 15:33:13-06:00,['ca21dc7d615e1dae1cd4c0f692c3b5f561688347'],1,1,2,2660493,1,,,,2026
064628626f5268b1dc8537ac7cce408702672c0f,0,Robert (Bobby) Evans,2015-11-20 16:06:06-06:00,"['ab5b2f92cceee6ffbfeebb4181e06c1835e2edcf', 'e58d254102daff659250ee8adc0df68dabac6931']",16,502,518,2661011,14,,,,2026
cbf64fc3f6ed3d0ba65c5b3c69cb95853631d52a,0,Robert (Bobby) Evans,2015-11-20 16:06:40-06:00,['064628626f5268b1dc8537ac7cce408702672c0f'],0,1,1,2661012,1,,,,2026
7fb80a1d1e96d15ef10610e4235840a1fc446724,1,Robert (Bobby) Evans,2015-11-20 16:25:28-06:00,['cbf64fc3f6ed3d0ba65c5b3c69cb95853631d52a'],1,1,2,2661014,1,,,,2026
ee867bdd9a811e121a7b15d7d72e3d3e35435289,0,Sriharsha Chintalapani,2015-11-20 15:00:41-08:00,"['7fb80a1d1e96d15ef10610e4235840a1fc446724', '20374cef0b48c71cdbab687e2463528dba0055cb']",5,47,52,2661066,6,,,,2026
a8d253a9b725b8fb3181efbfcac78d06e186bea9,0,Sriharsha Chintalapani,2015-11-20 15:01:10-08:00,['ee867bdd9a811e121a7b15d7d72e3d3e35435289'],0,1,1,2661067,1,,,,2026
aee486467788de1a60d8d0194719829c2e313d14,0,Kyle Nusbaum,2015-11-20 17:16:52-06:00,['711e36fafcac33f4fb7238001ea8bc678fab2d56'],177,173,350,2661417,25,0,0,0.818181818,2026
aff24fd1c087dda6ee4055f990d1632097e6c574,0,Chuck Burgess,2015-11-20 19:04:17-06:00,['a8d253a9b725b8fb3181efbfcac78d06e186bea9'],1,15,16,2661433,3,0.272727273,0.272727273,0.272727273,2026
8cb3dc3d2625b35172861a8c8cffc21d53403686,0,Chuck Burgess,2015-11-20 19:04:18-06:00,['aff24fd1c087dda6ee4055f990d1632097e6c574'],0,3,3,2661436,1,,,,2026
61921bbadd24cfa438bd4a744e103ccb50afaa83,0,Kyle Nusbaum,2015-11-20 22:36:58-06:00,['aee486467788de1a60d8d0194719829c2e313d14'],2,1,3,2661439,1,,,,2026
a16eca7e0b35c35be064a742f834add1e4f20879,0,Jungtaek Lim,2015-11-22 23:09:57+09:00,['a8d253a9b725b8fb3181efbfcac78d06e186bea9'],15,19,34,2661473,2,0,0,1,2026
d91c393f092ad2e050f14bc3c6ab9e9658545c26,0,Jungtaek Lim,2015-11-22 23:12:36+09:00,['a16eca7e0b35c35be064a742f834add1e4f20879'],0,2,2,2661475,2,,,,2026
124f664af6d8cdf995ed4061b1f1a90c84e7c18e,0,Jungtaek Lim,2015-11-22 23:15:19+09:00,['d91c393f092ad2e050f14bc3c6ab9e9658545c26'],4,0,4,2661479,1,,,,2026
7a0270382d1a028f410c62467ac1a475f44c5a16,0,Jungtaek Lim,2015-11-23 07:56:22+09:00,['a8d253a9b725b8fb3181efbfcac78d06e186bea9'],0,1,1,2661480,1,,,,2026
69b9cf581fd977f6c28b3a78a116deddadc44014,0,Arun Mahadevan,2015-11-23 14:24:14+05:18,['a8d253a9b725b8fb3181efbfcac78d06e186bea9'],19,134,153,2661633,3,1,1,0.666666667,2028
c2f1da0eee0910b568a7df257d322d2c45179a52,0,Kyle Nusbaum,2015-11-23 12:48:34-06:00,['61921bbadd24cfa438bd4a744e103ccb50afaa83'],1,1,2,2661635,1,,,,2028
9bfb26c840b0b56bb12cd857645625b96e9102e7,0,Kyle Nusbaum,2015-11-23 13:52:10-06:00,['c2f1da0eee0910b568a7df257d322d2c45179a52'],2,38,40,2661675,3,1,0.538461538,1,2028
e7a8c94c94d22337dacc65de8ccd6b18809bec63,0,Kyle Nusbaum,2015-11-23 14:38:32-06:00,['9bfb26c840b0b56bb12cd857645625b96e9102e7'],6,4,10,2661685,2,1,1,0,2028
8d4d72cac5e0e5080d6907a378e54381e0ed5db4,0,Kyle Nusbaum,2015-11-23 15:06:16-06:00,"['a8d253a9b725b8fb3181efbfcac78d06e186bea9', 'e7a8c94c94d22337dacc65de8ccd6b18809bec63']",477,8135,8612,2670297,67,,,,2028
45792ddd3296f4cd9acc25ca67c24a4b5805e0e3,0,Kyle Nusbaum,2015-11-23 15:07:12-06:00,['8d4d72cac5e0e5080d6907a378e54381e0ed5db4'],0,1,1,2670298,1,,,,2028
49353bca93a658968161ed50da228f25da8537f1,0,Robert (Bobby) Evans,2015-11-23 15:52:58-06:00,"['45792ddd3296f4cd9acc25ca67c24a4b5805e0e3', 'c4555600d7441987dfa7d81200f0058aaa38560b']",11,51,62,2670360,24,,,,2028
ccf3fd2b120ff42e5984efd20de1d11004ac8ad1,0,Robert (Bobby) Evans,2015-11-23 15:53:54-06:00,['49353bca93a658968161ed50da228f25da8537f1'],0,1,1,2670361,1,,,,2028
bb266fb5f843a2791d9227df71563a958eafc256,1,Kyle Nusbaum,2015-11-23 16:33:14-06:00,['57a3b89eed2cf62a6d54890e1d094023f1fb3f3b'],2,14,16,2670377,3,,,,2028
ba6ace80f4a88a141239e7028509b16f8595fad1,0,Kyle Nusbaum,2015-11-23 16:34:59-06:00,"['bb266fb5f843a2791d9227df71563a958eafc256', '45792ddd3296f4cd9acc25ca67c24a4b5805e0e3']",1616,12822,14438,2684815,224,,,,2028
037cd00d58418d588bffebf02c7897e29e193a9b,0,Michael Schonfeld,2015-11-23 18:49:11-05:00,['ccf3fd2b120ff42e5984efd20de1d11004ac8ad1'],5,5,10,2684825,1,,,,2028
b03ce6b28e0f16d11b769f75a069de0328637794,0,Michael Schonfeld,2015-11-23 18:50:54-05:00,['037cd00d58418d588bffebf02c7897e29e193a9b'],2041,2330,4371,2689196,37,0.195402299,0,0.982758621,2030
9cb8666963bf3d00e21e3dfaf406650d5b780721,0,Michael Schonfeld,2015-11-23 18:50:54-05:00,['b03ce6b28e0f16d11b769f75a069de0328637794'],0,77,77,2689273,1,1,1,1,2031
fe646428aa044fde60638432b09da007a2acb7b7,0,Michael Schonfeld,2015-11-23 18:50:54-05:00,['9cb8666963bf3d00e21e3dfaf406650d5b780721'],0,17,17,2689290,1,,,,2031
4078d95e6f15fec386ecdfa4625cb3bd89906a61,0,Michael Schonfeld,2015-11-23 18:50:55-05:00,['fe646428aa044fde60638432b09da007a2acb7b7'],1,4,5,2689295,1,,,,2031
b0c37045085d37d9a9309a81ef7f3f7797d454a4,0,Michael Schonfeld,2015-11-23 18:50:55-05:00,['4078d95e6f15fec386ecdfa4625cb3bd89906a61'],0,9,9,2689304,2,1,1,1,2031
07d9733ba0e38aae02d75a47f8813ae378248e42,0,Michael Schonfeld,2015-11-23 18:50:55-05:00,['b0c37045085d37d9a9309a81ef7f3f7797d454a4'],3,0,3,2689307,1,,,,2031
dfc33ec3dee8968b9d337323ca42e178de8dbd53,0,Michael Schonfeld,2015-11-23 18:50:55-05:00,['07d9733ba0e38aae02d75a47f8813ae378248e42'],4,36,40,2689347,3,,,,2031
ccb8031b3cebb06d266a8621b91255945221efc6,0,Michael Schonfeld,2015-11-23 18:50:55-05:00,['dfc33ec3dee8968b9d337323ca42e178de8dbd53'],8,3,11,2689358,3,,,1,2031
9bc9350f613a75de566cf670874c6a037ecc5bfd,0,Michael Schonfeld,2015-11-23 18:50:55-05:00,['ccb8031b3cebb06d266a8621b91255945221efc6'],1,1,2,2689360,1,,,,2031
56dc7b9d25f6b80856c541a71a036b2574d58ae8,0,Jungtaek Lim,2015-11-24 14:56:43+09:00,['124f664af6d8cdf995ed4061b1f1a90c84e7c18e'],16,136,152,2689512,2,0.613636364,1,1,2032
117e81861485ab02d4b97de725309132fce3f2a1,0,Jungtaek Lim,2015-11-24 19:14:05+09:00,['56dc7b9d25f6b80856c541a71a036b2574d58ae8'],0,67,67,2689579,1,0.459459459,1,1,2033
ca02690aa551586389e572d77b6e467abf2d1b10,0,Jungtaek Lim,2015-11-24 19:17:33+09:00,['117e81861485ab02d4b97de725309132fce3f2a1'],0,17,17,2689596,1,,,,2033
8bcb2f29d0fa043631d75f8e7a1a13adf8f5e2bd,0,Robert (Bobby) Evans,2015-11-24 09:15:01-06:00,"['ccf3fd2b120ff42e5984efd20de1d11004ac8ad1', '9bc9350f613a75de566cf670874c6a037ecc5bfd']",2047,2466,4513,2694109,38,,,,2033
74cd042152df6ff0ea982340ac14e16c1d940161,0,Robert (Bobby) Evans,2015-11-24 09:15:37-06:00,['8bcb2f29d0fa043631d75f8e7a1a13adf8f5e2bd'],0,1,1,2694110,1,,,,2033
94823694899b23ef90ba073154a75d42e9c9fa4c,0,P. Taylor Goetz,2015-11-24 13:53:52-05:00,['bc77f1f59622cff0e0bef01dfbc821ac3dba21c1'],27,0,27,2694137,1,,,,2033
fd75ca72016bfb8d20c996bb3d7514f8c2a20740,0,P. Taylor Goetz,2015-11-24 13:56:43-05:00,"['e03b28ca6222f61471b4acb1a6086aab9b597b8a', '74cd042152df6ff0ea982340ac14e16c1d940161']",2622,13348,15970,2710107,172,,,,2033
609b11c54d41795c423d9a33bfa552b4fd89bc05,0,P. Taylor Goetz,2015-11-24 14:24:56-05:00,"['fd75ca72016bfb8d20c996bb3d7514f8c2a20740', 'a019d504dff6492e4b5a18387b7281a918dca0e9']",0,2,2,2710109,1,,,,2033
dc05a00e5c0f956f4511fec789ea7c037f811723,0,P. Taylor Goetz,2015-11-24 14:42:05-05:00,['609b11c54d41795c423d9a33bfa552b4fd89bc05'],1,2,3,2710112,1,,,,2033
c0c146281b51a78d4d543049929ae0af08d43507,0,P. Taylor Goetz,2015-11-24 14:46:11-05:00,"['dc05a00e5c0f956f4511fec789ea7c037f811723', '5cb4bf56a675480f2d8eeef38b0e02a16fa70048']",2,3,5,2710117,1,,,,2033
8eac4aadc4e5de0658649d23d724b04c8e8c2548,0,P. Taylor Goetz,2015-11-24 14:54:10-05:00,['c0c146281b51a78d4d543049929ae0af08d43507'],0,1,1,2710118,1,,,,2033
6ebf24779b963bb52a7653d8d9d8ec04ed3e557b,0,P. Taylor Goetz,2015-11-24 14:56:01-05:00,"['8eac4aadc4e5de0658649d23d724b04c8e8c2548', '8cb3dc3d2625b35172861a8c8cffc21d53403686']",1,18,19,2710137,4,,,,2033
f8a2d65a64f5648abed48d1ba94ea2c572ea8826,0,P. Taylor Goetz,2015-11-24 14:57:34-05:00,['6ebf24779b963bb52a7653d8d9d8ec04ed3e557b'],0,1,1,2710138,1,,,,2033
53a46047d18cb79a2360869ef864bb68a77447bb,0,Kyle Nusbaum,2015-11-24 14:04:39-06:00,"['f8a2d65a64f5648abed48d1ba94ea2c572ea8826', 'ba6ace80f4a88a141239e7028509b16f8595fad1']",2,13,15,2710153,2,,,,2033
e2d267ff9aab1b0a53cdf94e8880d57e64816179,0,Kyle Nusbaum,2015-11-24 14:55:19-06:00,['53a46047d18cb79a2360869ef864bb68a77447bb'],0,1,1,2710154,1,,,,2033
ad96bf9bae0074c76357cd4e5491750cedce8051,0,P. Taylor Goetz,2015-11-24 15:56:06-05:00,"['94823694899b23ef90ba073154a75d42e9c9fa4c', 'f8a2d65a64f5648abed48d1ba94ea2c572ea8826']",2627,13376,16003,2726157,177,,,,2033
35f1da7890b597c9634904c0589f6ac64584e539,0,Haohui Mai,2015-11-24 13:23:16-08:00,['a8d253a9b725b8fb3181efbfcac78d06e186bea9'],50,106,156,2726313,16,1,1,1,2034
fc3b8773e62138abcc41f789072fc5902ab587e3,0,P. Taylor Goetz,2015-11-24 16:55:10-05:00,['e2d267ff9aab1b0a53cdf94e8880d57e64816179'],13,4,17,2726330,1,,,,2034
783a57a9e3e6ba95770232a48d094cac2f4f6f0c,0,P. Taylor Goetz,2015-11-24 17:00:00-05:00,"['ad96bf9bae0074c76357cd4e5491750cedce8051', 'fc3b8773e62138abcc41f789072fc5902ab587e3']",15,18,33,2726363,4,,,,2034
f1fafdfb259dde00b03d227101bc712e2ba988fd,0,P. Taylor Goetz,2015-11-24 17:02:39-05:00,['783a57a9e3e6ba95770232a48d094cac2f4f6f0c'],0,13,13,2726376,1,,,,2034
05c70044f8f98fdf50e8753781525449f77fe6b6,0,Derek Dagit,2015-11-24 16:47:13-06:00,"['fc3b8773e62138abcc41f789072fc5902ab587e3', '3c89f923512fef343fdde983f289675dca2bcb0b']",3,3,6,2726382,3,,,,2034
e182624eb5ba5d7e7561dc8bb2ae23e1217bc5be,0,Derek Dagit,2015-11-24 16:48:38-06:00,['05c70044f8f98fdf50e8753781525449f77fe6b6'],0,1,1,2726383,1,,,,2034
5a71ea07c71dd15854a30f5ecb555b19f0a4e59b,0,Derek Dagit,2015-11-24 16:50:15-06:00,"['fc3b8773e62138abcc41f789072fc5902ab587e3', 'e182624eb5ba5d7e7561dc8bb2ae23e1217bc5be']",3,4,7,2726390,4,,,,2034
20a864d082dc0b302b8f66a654d159ab0f036cc3,0,Jungtaek Lim,2015-11-25 10:24:08+09:00,"['5a71ea07c71dd15854a30f5ecb555b19f0a4e59b', '7a0270382d1a028f410c62467ac1a475f44c5a16']",0,1,1,2726391,1,,,,2034
fc8c296efc41c1efc6060ba09c07d406ceacc844,0,Jungtaek Lim,2015-11-25 13:46:59+09:00,['20a864d082dc0b302b8f66a654d159ab0f036cc3'],2,18,20,2726411,3,0,1,0,2034
641300e2441d732fc2be98f05e70c6e5db4e4cf6,1,Florian Hussonnois,2015-11-25 09:50:15+01:00,['437c4b14903f5c094f9445494df9016737b373e5'],1,4000,4001,2730412,48,0.876782077,1,0.860488798,2080
b039d331aaa2fe99ac038e670c5b8f6f1c126ccf,1,Florian Hussonnois,2015-11-25 09:51:55+01:00,['641300e2441d732fc2be98f05e70c6e5db4e4cf6'],47,178,225,2730637,9,0.961538462,1,0.980769231,2080
cba051100484f2d30635ad204f15f74ec1ed5198,0,P. Taylor Goetz,2015-11-25 11:12:54-05:00,['f1fafdfb259dde00b03d227101bc712e2ba988fd'],8,4,12,2730649,2,,,,2080
352a28498648747b25ea07fad313d63e627c3f44,0,Sriharsha Chintalapani,2015-11-25 11:22:34-08:00,"['20a864d082dc0b302b8f66a654d159ab0f036cc3', '35f1da7890b597c9634904c0589f6ac64584e539']",50,106,156,2730805,16,,,,2080
01bab865400df5dfce3909f8b9f1e6199792d5a3,0,Sriharsha Chintalapani,2015-11-25 11:33:49-08:00,['352a28498648747b25ea07fad313d63e627c3f44'],0,1,1,2730806,1,,,,2080
c1c52735b9bace12a64e9a8c3190b292604b1120,1,Haohui Mai,2015-11-25 13:56:35-08:00,['20a864d082dc0b302b8f66a654d159ab0f036cc3'],87,58,145,2730951,9,0.444444444,0,0.333333333,2080
6d3bee9a69db23ea68ca59259f7139d165dee391,0,Sriharsha Chintalapani,2015-11-25 14:35:16-08:00,"['01bab865400df5dfce3909f8b9f1e6199792d5a3', 'c1c52735b9bace12a64e9a8c3190b292604b1120']",87,58,145,2731096,9,,,,2080
4c59de6f324760cc33c9bbcb5f8d3644d2db4afc,0,Sriharsha Chintalapani,2015-11-25 15:30:22-08:00,['6d3bee9a69db23ea68ca59259f7139d165dee391'],0,1,1,2731097,1,,,,2080
aa1e1ed8df065dea361d86995b31be3674f8eebe,0,Arun Mahadevan,2015-11-26 10:56:43+05:18,['69b9cf581fd977f6c28b3a78a116deddadc44014'],1,49,50,2731147,3,1,1,1,2081
0d8a99d477078a9c9a88cd79c016a387c89f526a,0,Jungtaek Lim,2015-11-27 05:50:37+09:00,"['4c59de6f324760cc33c9bbcb5f8d3644d2db4afc', 'aa1e1ed8df065dea361d86995b31be3674f8eebe']",19,182,201,2731348,5,,,,2081
c7c367ce846cc3d3738168ee497d6de4096ff6f3,0,Jungtaek Lim,2015-11-27 05:51:31+09:00,['0d8a99d477078a9c9a88cd79c016a387c89f526a'],1,2,3,2731351,1,,,,2081
63026eecf46d411ef14ee37d85bfca8af4057b10,0,Jungtaek Lim,2015-11-27 05:58:56+09:00,"['c7c367ce846cc3d3738168ee497d6de4096ff6f3', 'fc8c296efc41c1efc6060ba09c07d406ceacc844']",2,18,20,2731371,3,,,,2081
21814334a857be21440edbdbf415eb42d6180d02,0,Jungtaek Lim,2015-11-27 05:59:26+09:00,['c7c367ce846cc3d3738168ee497d6de4096ff6f3'],0,1,1,2731372,1,,,,2081
cf4407fd31e88112f92c0e85188859e0a396bd98,0,Jungtaek Lim,2015-11-27 05:59:49+09:00,"['21814334a857be21440edbdbf415eb42d6180d02', '63026eecf46d411ef14ee37d85bfca8af4057b10']",2,18,20,2731392,3,,,,2081
b082e85f467e89dbc4b8b7fcb5d2dd7b849420ce,0,Jungtaek Lim,2015-11-27 06:04:50+09:00,"['cf4407fd31e88112f92c0e85188859e0a396bd98', 'a5ca650f7c94b07a46d3cb5a4f84ae893c83bb9c']",1,1,2,2731394,1,,,,2081
0acc1cee6928985357c869a62497a5ebc56d8bf9,0,Jungtaek Lim,2015-11-27 06:05:49+09:00,['b082e85f467e89dbc4b8b7fcb5d2dd7b849420ce'],0,1,1,2731395,1,,,,2081
7029aee576cff6d7159e9e1a991bb02aaf0d4cd8,1,Sanket,2015-11-30 14:56:15-06:00,['0acc1cee6928985357c869a62497a5ebc56d8bf9'],9515,39479,48994,2780389,96,0.557990681,0.76813969,0.912949972,2130
57240b4f1c1aafce51e9465af9b87b7f41e88dec,0,Sanket,2015-11-30 15:29:26-06:00,['7029aee576cff6d7159e9e1a991bb02aaf0d4cd8'],11,9,20,2780409,1,,,,2130
6687bedbe86c1b04cecf18e02e6e2359ce2c3ead,0,Sanket,2015-11-30 18:02:39-06:00,['57240b4f1c1aafce51e9465af9b87b7f41e88dec'],2,166,168,2780577,5,,,,2130
5d22270272bc4e9138e092216ce4e0584096ad75,0,Sriharsha Chintalapani,2015-11-30 22:47:14-08:00,"['0acc1cee6928985357c869a62497a5ebc56d8bf9', 'b039d331aaa2fe99ac038e670c5b8f6f1c126ccf']",1,4131,4132,2784709,48,,,,2130
dae377ce038db0d565ea4f191576f99a78bae623,0,Sriharsha Chintalapani,2015-11-30 22:49:09-08:00,['5d22270272bc4e9138e092216ce4e0584096ad75'],0,5,5,2784714,2,,,,2130
51058027a3d77145adef244c4cf66b5241fd1252,0,Sanket,2015-12-01 15:15:36-06:00,['6687bedbe86c1b04cecf18e02e6e2359ce2c3ead'],3,2,5,2784719,2,,,,2130
5565c43817deb2f3d7b77b5f6975dd3d16c802c4,0,Florian Hussonnois,2015-12-01 22:36:17+01:00,['641300e2441d732fc2be98f05e70c6e5db4e4cf6'],49,182,231,2784950,11,0.961538462,1,0.980769231,2130
224c846ecc4adb3b7f1e147c5b195fbb7c371e32,0,Sriharsha Chintalapani,2015-12-01 14:26:27-08:00,"['dae377ce038db0d565ea4f191576f99a78bae623', '5565c43817deb2f3d7b77b5f6975dd3d16c802c4']",2,4,6,2784956,2,,,,2130
e0f33e783bcccc061fca38e1ae14c9835959d9be,0,Sriharsha Chintalapani,2015-12-01 17:00:37-08:00,"['224c846ecc4adb3b7f1e147c5b195fbb7c371e32', 'cba051100484f2d30635ad204f15f74ec1ed5198']",127,198,325,2785281,39,,,,2130
a55b0503297f7cd7a4ba3f67ef1a6b2e2b33e4c2,0,Sriharsha Chintalapani,2015-12-01 17:02:09-08:00,['e0f33e783bcccc061fca38e1ae14c9835959d9be'],0,1,1,2785282,1,,,,2130
223e072eee0fbdf1998a8fa4c8311cb538056f9d,0,Xin Wang,2015-12-02 09:33:42+08:00,['a55b0503297f7cd7a4ba3f67ef1a6b2e2b33e4c2'],1,1,2,2785284,1,,,,2130
c661e981d1d69d625c2b399882e564bbcc69216e,0,Chuck Burgess,2015-12-02 08:58:19-06:00,['a55b0503297f7cd7a4ba3f67ef1a6b2e2b33e4c2'],0,35,35,2785319,2,,,,2130
cd00dde37d09ca9ff94bb7f3cad08f66cfe74b81,0,Robert (Bobby) Evans,2015-12-02 09:30:16-06:00,"['a55b0503297f7cd7a4ba3f67ef1a6b2e2b33e4c2', 'ca02690aa551586389e572d77b6e467abf2d1b10']",8,214,222,2785541,6,,,,2130
041fbe34978b20cf98e740a4d914a4e839bb33e2,0,Robert (Bobby) Evans,2015-12-02 09:30:43-06:00,['cd00dde37d09ca9ff94bb7f3cad08f66cfe74b81'],0,1,1,2785542,1,,,,2130
9b1e176feddf7cc80460a6bf25fdf9e9c6b5f48f,0,Robert (Bobby) Evans,2015-12-02 09:51:23-06:00,"['041fbe34978b20cf98e740a4d914a4e839bb33e2', 'c661e981d1d69d625c2b399882e564bbcc69216e']",0,35,35,2785577,2,,,,2130
1059735f78bb5e7a15831e1d225ca9f97df06f8d,0,Robert (Bobby) Evans,2015-12-02 09:51:42-06:00,['9b1e176feddf7cc80460a6bf25fdf9e9c6b5f48f'],0,1,1,2785578,1,,,,2130
7041dd7dc266794c5f41e9bacbc48c920710f491,0,Aaron Dossett,2015-12-02 13:05:03-06:00,['1059735f78bb5e7a15831e1d225ca9f97df06f8d'],1,10,11,2785589,2,,,,2130
2c762dd2d7e230c7685b66147d3c92ba807895df,0,Jungtaek Lim,2015-12-03 07:24:51+09:00,['7041dd7dc266794c5f41e9bacbc48c920710f491'],0,1,1,2785590,1,,,,2130
18f68f7a967f7173b9c7c7444bedd53b13ad65fb,0,Jungtaek Lim,2015-12-03 07:33:20+09:00,['2c762dd2d7e230c7685b66147d3c92ba807895df'],0,2,2,2785592,1,,,,2130
ddc6b8e63f8a7393ab3b549d24038b62cfd9e382,0,Zhiqiang-He,2015-12-03 10:43:20+08:00,['87a4a8b4382de5617d463b23188f18e4f7e7f03c'],14,2,16,2785608,4,0.666666667,0.666666667,0,2130
b52988ab1d6c3ef853769ebb272e27caaf55ec38,0,Derek Dagit,2015-12-03 09:55:26-06:00,['7041dd7dc266794c5f41e9bacbc48c920710f491'],10,34,44,2785652,6,,,,2130
d2090d799f8b5bb06a17094545d39c43f12ba6c7,0,Derek Dagit,2015-12-03 13:07:33-06:00,['18f68f7a967f7173b9c7c7444bedd53b13ad65fb'],214,8,222,2785874,6,0.469879518,0,0,2130
f6d84e9fdf1fe21f2229f144a08dceae6259e7e2,0,Derek Dagit,2015-12-03 13:08:59-06:00,['d2090d799f8b5bb06a17094545d39c43f12ba6c7'],1,0,1,2785875,1,,,,2130
ce2d49b924b6690d7704eccbb91ebbbea0a601bb,0,Derek Dagit,2015-12-03 13:20:48-06:00,"['18f68f7a967f7173b9c7c7444bedd53b13ad65fb', 'f6d84e9fdf1fe21f2229f144a08dceae6259e7e2']",215,8,223,2786098,7,,,,2130
87f8fa1c559b8764715fd6f82f8524565d8398aa,0,Jungtaek Lim,2015-12-04 08:03:46+09:00,['ce2d49b924b6690d7704eccbb91ebbbea0a601bb'],8,215,223,2786321,7,0.530120482,1,1,2132
f9890817884fa3c3592ee09e085c0cc58dc52149,0,Jungtaek Lim,2015-12-04 08:16:31+09:00,['87f8fa1c559b8764715fd6f82f8524565d8398aa'],1,2,3,2786324,1,1,1,1,2132
49d46be837a6a0d164c09313db5291fdd995c2e2,0,Chuck Burgess,2015-12-04 08:14:14-06:00,['ce2d49b924b6690d7704eccbb91ebbbea0a601bb'],10,2,12,2786336,1,,,,2132
9e490da70b3f1bd76c02718b6cc1bad45d33244d,0,Chuck Burgess,2015-12-04 08:14:15-06:00,['49d46be837a6a0d164c09313db5291fdd995c2e2'],10,4,14,2786350,1,,,,2132
929458ae55e3aa18ed9cec6ae7ff72fbd75ffcac,0,Chuck Burgess,2015-12-04 08:14:15-06:00,['9e490da70b3f1bd76c02718b6cc1bad45d33244d'],7,0,7,2786357,1,,,,2132
bdbec852a16a758074079eb0bce70ac77c876a5f,0,Robert (Bobby) Evans,2015-12-04 08:54:07-06:00,"['ce2d49b924b6690d7704eccbb91ebbbea0a601bb', '51058027a3d77145adef244c4cf66b5241fd1252']",9515,39640,49155,2835512,96,,,,2132
6babbb08c43a32a7624e81dfc3a3bfe52db02a33,0,Robert (Bobby) Evans,2015-12-04 09:03:09-06:00,['bdbec852a16a758074079eb0bce70ac77c876a5f'],0,1,1,2835513,1,,,,2132
82f9d969446898bc6bdbdb03f2b927a55174f97c,0,Boyang Jerry Peng,2015-12-04 10:23:10-06:00,['ce2d49b924b6690d7704eccbb91ebbbea0a601bb'],37,84,121,2835634,3,0,0,1,2132
0d34abf9ca19f381578053497b103f2bb8a6cff2,0,Boyang Jerry Peng,2015-12-04 13:06:26-06:00,['6babbb08c43a32a7624e81dfc3a3bfe52db02a33'],106,551,657,2836291,8,0.758503401,0.819727891,0.942176871,2133
97b2c9a7e75c0913472311b0be3d9d042b95e21f,0,Boyang Jerry Peng,2015-12-04 13:06:45-06:00,['0d34abf9ca19f381578053497b103f2bb8a6cff2'],0,23,23,2836314,2,1,1,1,2133
3f55feef43602beefebdb6ae20c64bceff2dbecb,0,Boyang Jerry Peng,2015-12-04 13:06:45-06:00,['97b2c9a7e75c0913472311b0be3d9d042b95e21f'],270,1742,2012,2838326,19,0.371052632,0.967105263,0.893421053,2140
9d3c864cdc708d62a088a1b9b23904bd6ea1b276,0,Boyang Jerry Peng,2015-12-04 13:07:00-06:00,['3f55feef43602beefebdb6ae20c64bceff2dbecb'],238,862,1100,2839426,10,0.209459459,0.22972973,0.983108108,2140
4cd5efa3c5114413cf82ced7d3041e258175a5c0,0,Boyang Jerry Peng,2015-12-04 13:07:10-06:00,['9d3c864cdc708d62a088a1b9b23904bd6ea1b276'],134,490,624,2840050,13,0.604938272,0.530864198,0.75308642,2144
3e8322053c3d7fc7877b2985bae1ad657562c931,0,Boyang Jerry Peng,2015-12-04 13:07:11-06:00,['4cd5efa3c5114413cf82ced7d3041e258175a5c0'],533,893,1426,2841476,23,0.049618321,0,1,2145
425280e23cc383366a96031ed459833ae837cbf8,0,Haohui Mai,2015-12-04 11:09:01-08:00,['6babbb08c43a32a7624e81dfc3a3bfe52db02a33'],0,787,787,2842263,14,0.736842105,1,0.745614035,2158
b6fa601c821521fb7ffc6ae37c481105edd7b974,1,Haohui Mai,2015-12-04 11:09:01-08:00,['425280e23cc383366a96031ed459833ae837cbf8'],0,219,219,2842482,2,0.530769231,0.738461538,0.930769231,2160
4e2fe47c3b322552f7dc8f2861ef3e496054006b,0,Haohui Mai,2015-12-04 11:09:01-08:00,['b6fa601c821521fb7ffc6ae37c481105edd7b974'],0,374,374,2842856,4,0.645833333,0.833333333,1,2163
bd4f6dc3c1f8cc5fa772fd267cc416d718f8bcd5,1,Haohui Mai,2015-12-04 11:09:02-08:00,['4e2fe47c3b322552f7dc8f2861ef3e496054006b'],0,177,177,2843033,2,0.611764706,1,1,2165
0a257f12527a4aec6c477147ff8390ac08c92136,1,Haohui Mai,2015-12-04 11:09:02-08:00,['bd4f6dc3c1f8cc5fa772fd267cc416d718f8bcd5'],110,881,991,2844024,16,0.63546798,1,0.689655172,2175
915f135438c08a58bbca6d4ff27386b05254e27f,1,Haohui Mai,2015-12-04 11:09:02-08:00,['0a257f12527a4aec6c477147ff8390ac08c92136'],9,81,90,2844114,3,0.222222222,1,1,2175
0bb8e46cea7fa162c1fd16203e1e415e13636fb1,1,Haohui Mai,2015-12-04 11:09:02-08:00,['915f135438c08a58bbca6d4ff27386b05254e27f'],1,366,367,2844481,8,0.613445378,1,0.882352941,2180
5f9708025e6434b8d4d1457244e45800d10d8c9e,1,Haohui Mai,2015-12-04 11:09:02-08:00,['0bb8e46cea7fa162c1fd16203e1e415e13636fb1'],0,144,144,2844625,2,0.305882353,0.564705882,0.564705882,2181
31daf268b5e536376bfb2a2a77336652d86d5399,1,Haohui Mai,2015-12-04 11:09:02-08:00,['5f9708025e6434b8d4d1457244e45800d10d8c9e'],31,119,150,2844775,2,0.351351351,1,0.891891892,2181
beeaee739a3ba43d0507de3efd4338f9274c4760,1,Haohui Mai,2015-12-04 11:09:02-08:00,['31daf268b5e536376bfb2a2a77336652d86d5399'],21,59,80,2844855,4,0.176470588,1,1,2181
39400075b0e83416f84879b8785be1b1cc0c2826,1,Haohui Mai,2015-12-04 11:09:02-08:00,['beeaee739a3ba43d0507de3efd4338f9274c4760'],285,416,701,2845556,24,0.579545455,1,0.056818182,2187
4d8cc419b109a11e1a1f6489aca8b8b528e77ab5,1,Haohui Mai,2015-12-04 11:09:27-08:00,['39400075b0e83416f84879b8785be1b1cc0c2826'],1,14,15,2845571,1,1,1,1,2187
82f10ebfd00ba71b5c95b95e917d856c5eff9c9f,1,Haohui Mai,2015-12-04 11:09:28-08:00,['4d8cc419b109a11e1a1f6489aca8b8b528e77ab5'],273,382,655,2846226,22,0.9,0.933333333,0.433333333,2193
7e378c65bc18ebcca3e500ea70f6da3f376003c3,1,Haohui Mai,2015-12-04 11:09:28-08:00,['82f10ebfd00ba71b5c95b95e917d856c5eff9c9f'],1,572,573,2846799,7,0.841201717,1,0.91416309,2197
a8894e626ed27867e5f3ed5c4ee997247c8647cb,1,Haohui Mai,2015-12-04 11:09:28-08:00,['7e378c65bc18ebcca3e500ea70f6da3f376003c3'],36,145,181,2846980,15,0.558139535,1,0.88372093,2198
b60712f616be4579049d2ffd7e84f9047d20a8e3,1,Haohui Mai,2015-12-04 11:09:28-08:00,['a8894e626ed27867e5f3ed5c4ee997247c8647cb'],0,616,616,2847596,10,0.797814208,1,0.797814208,2206
b5efe2c4433c0245c2fe0c1119e64baf6ecca776,0,Haohui Mai,2015-12-04 11:09:28-08:00,['b60712f616be4579049d2ffd7e84f9047d20a8e3'],24,140,164,2847760,9,0.675675676,1,0.594594595,2208
ff22fd970f02a39c73f1ee8bfc49f42212f5534e,1,Haohui Mai,2015-12-04 11:09:28-08:00,['b5efe2c4433c0245c2fe0c1119e64baf6ecca776'],66,419,485,2848245,20,0.886597938,1,0.494845361,2209
19b8b7d13ee0afaa0d8082b24304823c64ff425a,0,Aaron Niskode-Dossett,2015-12-04 13:40:12-06:00,['6babbb08c43a32a7624e81dfc3a3bfe52db02a33'],1,1,2,2848247,1,,,,2209
88ad3c316a5a0df7c083470fb66847e5fb29d663,0,Boyang Jerry Peng,2015-12-04 14:02:56-06:00,['3e8322053c3d7fc7877b2985bae1ad657562c931'],33,45,78,2848325,10,1,1,1,2209
79a2a2a58888ca5c7dad379e7316aacfe2c465aa,0,Derek Dagit,2015-12-04 16:33:09-06:00,"['19b8b7d13ee0afaa0d8082b24304823c64ff425a', 'f9890817884fa3c3592ee09e085c0cc58dc52149']",8,216,224,2848549,7,,,,2209
98c90f0fa583e2932c2c8639e9ec483915c47ff1,0,Jungtaek Lim,2015-12-05 08:03:22+09:00,['19b8b7d13ee0afaa0d8082b24304823c64ff425a'],6,16,22,2848571,1,0,1,1,2209
f5bccd05e434c2f0e6007c8c786ef33fa14169e3,1,Boyang Jerry Peng,2015-12-05 16:50:41-06:00,['88ad3c316a5a0df7c083470fb66847e5fb29d663'],0,222,222,2848793,2,,,,2211
10b33a61b727bca43859e53819161f48c1af7226,0,Sriharsha Chintalapani,2015-12-06 08:23:48-08:00,"['79a2a2a58888ca5c7dad379e7316aacfe2c465aa', '929458ae55e3aa18ed9cec6ae7ff72fbd75ffcac']",27,6,33,2848826,2,,,,2211
06d4bb6ef10a11e19e1d718a76d7062ef5f69834,1,Arun Mahadevan,2015-12-07 00:50:56+05:18,['a8d253a9b725b8fb3181efbfcac78d06e186bea9'],173,1664,1837,2850663,27,0.510433387,0.898876404,0.767255217,2222
812cc1ec1e99509523aa27a1d064fd14e28d4391,0,Ilya Ostrovskiy,2015-12-07 08:39:56-05:00,['79a2a2a58888ca5c7dad379e7316aacfe2c465aa'],0,1,1,2850664,1,,,,2222
0e46b02d6b9a814bd715bfdc0340806e05d95591,0,Jungtaek Lim,2015-12-07 22:52:32+09:00,"['10b33a61b727bca43859e53819161f48c1af7226', '812cc1ec1e99509523aa27a1d064fd14e28d4391']",0,1,1,2850665,1,,,,2222
3600953b6e53610ddc606b88e1816b05e2698eca,0,Jungtaek Lim,2015-12-07 22:54:00+09:00,['0e46b02d6b9a814bd715bfdc0340806e05d95591'],0,2,2,2850667,2,,,,2222
4c31c274af14a1b1960245994f03e33d06f192cb,0,Derek Dagit,2015-12-07 12:53:38-06:00,"['3600953b6e53610ddc606b88e1816b05e2698eca', 'b52988ab1d6c3ef853769ebb272e27caaf55ec38']",10,34,44,2850711,6,,,,2222
934f28a8d48cd07f3eecc9d8162771783e6ce841,0,Derek Dagit,2015-12-07 12:54:21-06:00,['4c31c274af14a1b1960245994f03e33d06f192cb'],0,1,1,2850712,1,,,,2222
2b7a758396c3a0529524b293a9c773e974f70b56,0,Derek Dagit,2015-12-07 12:55:43-06:00,"['3600953b6e53610ddc606b88e1816b05e2698eca', '934f28a8d48cd07f3eecc9d8162771783e6ce841']",10,35,45,2850757,7,,,,2222
fa4838381a121a2b83f0a01681296107400a198d,0,Arun Mahadevan,2015-12-08 01:34:21+05:18,['06d4bb6ef10a11e19e1d718a76d7062ef5f69834'],9,14,23,2850780,3,,,,2222
ef9479d06add8f70517d410d7e12a6c21940bd75,1,Satish Duggana,2015-12-08 11:28:23+05:18,['10b33a61b727bca43859e53819161f48c1af7226'],47,679,726,2851506,15,0.591133005,1,0.802955665,2230
5cc697b745fd5f0cfaf940da74d963654efca228,0,Satish Duggana,2015-12-08 11:28:23+05:18,['ef9479d06add8f70517d410d7e12a6c21940bd75'],0,37,37,2851543,2,,,,2230
4c56eb7e47a723ec870c5783d68d8320381e2dff,0,Satish Duggana,2015-12-08 11:28:23+05:18,['5cc697b745fd5f0cfaf940da74d963654efca228'],14,23,37,2851580,2,0.6,1,1,2230
6e65ae250f77035bc9dac9f0f1025c3ab8965140,0,Sriharsha Chintalapani,2015-12-08 09:22:48-08:00,"['2b7a758396c3a0529524b293a9c773e974f70b56', 'ff22fd970f02a39c73f1ee8bfc49f42212f5534e']",5,5058,5063,2856643,61,,,,2230
39163bfcee409c32f6a6b952ed39104cd6b0805d,0,Sriharsha Chintalapani,2015-12-08 09:37:35-08:00,['6e65ae250f77035bc9dac9f0f1025c3ab8965140'],0,1,1,2856644,1,,,,2230
7c972e460fc171dcfeb045957cd7e56af6d198bc,0,Sanket,2015-12-08 12:01:28-06:00,['19b8b7d13ee0afaa0d8082b24304823c64ff425a'],1,248,249,2856893,2,0.669565217,1,0.886956522,2231
f33e9c903fdec29d05403b2be8534652c44e2e51,0,mjsax,2015-12-08 23:46:09+01:00,['39163bfcee409c32f6a6b952ed39104cd6b0805d'],1,1,2,2856895,1,,,,2231
f27e5bce2c7fe2e06cef7746227a01099d7d32d3,0,Sanket,2015-12-08 16:58:28-06:00,['39163bfcee409c32f6a6b952ed39104cd6b0805d'],28,16,44,2856939,3,1,1,0,2231
c511a7e5581c2aff5c4ddd25c5507950fea08005,0,Sanket,2015-12-08 17:12:02-06:00,['f27e5bce2c7fe2e06cef7746227a01099d7d32d3'],1,0,1,2856940,1,0,0,0,2231
96ed62a34907566a67b354bba1f455e7cb96f868,0,Jungtaek Lim,2015-12-09 10:00:49+09:00,"['98c90f0fa583e2932c2c8639e9ec483915c47ff1', 'f33e9c903fdec29d05403b2be8534652c44e2e51']",51,5320,5371,2862311,78,,,,2231
f47ff5fb91da53ef63fe6660516f16751a6823af,0,Jungtaek Lim,2015-12-09 10:14:05+09:00,['96ed62a34907566a67b354bba1f455e7cb96f868'],0,1,1,2862312,1,,,,2231
c5561cfdf520126ad8e5dd8ae39c025eb6041518,1,Parth Brahmbhatt,2015-12-08 18:41:17-08:00,['f47ff5fb91da53ef63fe6660516f16751a6823af'],48,166,214,2862526,9,0.379310345,0.965517241,0,2232
ceb3a0cf764445cb7355f65391e4b6d919307dad,0,Arun Mahadevan,2015-12-09 12:11:50+05:18,['f47ff5fb91da53ef63fe6660516f16751a6823af'],1,1,2,2862528,1,,,,2232
60ff46ea69bb170746f52e300f30ba931136513c,0,Arun Mahadevan,2015-12-09 15:12:42+05:18,"['fa4838381a121a2b83f0a01681296107400a198d', 'ceb3a0cf764445cb7355f65391e4b6d919307dad']",12482,60503,72985,2935513,375,,,,2232
e45ccfe765fdbe5ed48dba9952bbd82aa69061c4,1,Boyang Jerry Peng,2015-12-09 10:27:03-06:00,['f5bccd05e434c2f0e6007c8c786ef33fa14169e3'],29,34,63,2935576,5,,,,2233
4f04d1ab51cd6763c2336e28e9ce49f1b4107b9f,0,Chuck Burgess,2015-12-09 11:00:48-06:00,['ceb3a0cf764445cb7355f65391e4b6d919307dad'],18,18,36,2935612,1,,,,2233
0e0cc9ec292b6697e66ff004550e81b1bfe2309e,0,Chuck Burgess,2015-12-09 11:00:49-06:00,['4f04d1ab51cd6763c2336e28e9ce49f1b4107b9f'],20,23,43,2935655,1,1,1,1,2233
7e270c24f13423a909c413082602f22f6c9aeccf,0,Chuck Burgess,2015-12-09 15:51:17-06:00,['0e0cc9ec292b6697e66ff004550e81b1bfe2309e'],1,3,4,2935659,1,1,1,1,2233
b1ce50d3206543c09c99ec460556991cf9f2e16e,0,Chuck Burgess,2015-12-09 15:51:36-06:00,['7e270c24f13423a909c413082602f22f6c9aeccf'],11,6,17,2935676,1,0,0,0,2233
db226d040d41c4c70b0ac9ad1b90515a78e757f2,0,Chuck Burgess,2015-12-09 15:51:45-06:00,['b1ce50d3206543c09c99ec460556991cf9f2e16e'],1,3,4,2935680,1,1,1,1,2233
cb4ddaa3e0444a49ddf48ebb2cd61c721a60ff7c,0,Sanket,2015-12-09 19:02:00-06:00,['ceb3a0cf764445cb7355f65391e4b6d919307dad'],1,1,2,2935682,1,,,,2233
8f1b4fba81f791b1f0ce4025a0a77b8eb5848ca1,1,Hugo Louro,2015-12-09 18:58:09-08:00,['ceb3a0cf764445cb7355f65391e4b6d919307dad'],8,179,187,2935869,7,,,,2234
d4fcc0fde96c667d1763fe5626ddf1284e4a7f70,0,Hugo Louro,2015-12-09 18:58:22-08:00,['8f1b4fba81f791b1f0ce4025a0a77b8eb5848ca1'],4,4,8,2935877,3,,,,2234
a1c159fe19dc28c90f5d27534add765a6520daf7,0,Hugo Louro,2015-12-09 18:58:22-08:00,['d4fcc0fde96c667d1763fe5626ddf1284e4a7f70'],12,28,40,2935917,5,,,,2234
cc009d4eb44e0d5e644413d542742a7dc273ef45,0,Satish Duggana,2015-12-10 10:05:58+05:18,"['4c56eb7e47a723ec870c5783d68d8320381e2dff', 'ceb3a0cf764445cb7355f65391e4b6d919307dad']",23,5116,5139,2941056,71,,,,2234
ec892623a0b266a1bac003a37d15da9cc9700099,0,Robert (Bobby) Evans,2015-12-10 11:03:17-06:00,"['ceb3a0cf764445cb7355f65391e4b6d919307dad', '82f9d969446898bc6bdbdb03f2b927a55174f97c']",37,84,121,2941177,3,,,,2234
fa6f5258825cb7fb69faa3d4d40719bf3cd3e2b6,0,Robert (Bobby) Evans,2015-12-10 11:03:50-06:00,['ec892623a0b266a1bac003a37d15da9cc9700099'],0,1,1,2941178,1,,,,2234
a3f343a6a14638dfd4a26923b36c4ff6a2361b96,0,Robert (Bobby) Evans,2015-12-10 11:18:04-06:00,"['fa6f5258825cb7fb69faa3d4d40719bf3cd3e2b6', 'db226d040d41c4c70b0ac9ad1b90515a78e757f2']",33,35,68,2941246,2,,,,2234
9a542a6934426eb43f996ac7437e40013643bd43,1,Boyang Jerry Peng,2015-12-10 16:34:51-06:00,['e45ccfe765fdbe5ed48dba9952bbd82aa69061c4'],1,1,2,2941248,1,,,,2234
402b8d215e2cebb7d7f15931aabaee695520f92d,0,Derek Dagit,2015-12-10 23:26:12+00:00,['a3f343a6a14638dfd4a26923b36c4ff6a2361b96'],12,10,22,2941270,4,,,,2234
3c49a734b767c02e81fb924fef0087bec3ea588b,0,zhuol,2015-12-10 19:10:40-06:00,['a3f343a6a14638dfd4a26923b36c4ff6a2361b96'],2,14,16,2941286,4,,,,2234
6343cfaa7ea2114fb71c26252c76e42f253c7486,0,rujia,2015-12-11 09:18:07+08:00,['0acc1cee6928985357c869a62497a5ebc56d8bf9'],1,1,2,2941288,1,,,,2234
9b8c12aa21717ec6ae2ae55d67ccd9433e1af4f6,0,zhuol,2015-12-10 19:18:29-06:00,['3c49a734b767c02e81fb924fef0087bec3ea588b'],5,6,11,2941299,1,,,,2234
e7c5561fe1f0473621370c8feaace3ae755c4780,0,Kyle Nusbaum,2015-12-10 22:27:17-06:00,"['a3f343a6a14638dfd4a26923b36c4ff6a2361b96', 'cb4ddaa3e0444a49ddf48ebb2cd61c721a60ff7c']",1,1,2,2941301,1,,,,2234
bd82914b8a4f7774f9bc8c26f68141634971eace,0,Kyle Nusbaum,2015-12-10 22:29:18-06:00,['e7c5561fe1f0473621370c8feaace3ae755c4780'],0,1,1,2941302,1,,,,2234
f3e7a0225b1512dfd3157c41b13d04eb3ce84e1a,0,Kyle Nusbaum,2015-12-10 22:55:00-06:00,"['bd82914b8a4f7774f9bc8c26f68141634971eace', '223e072eee0fbdf1998a8fa4c8311cb538056f9d']",1,1,2,2941304,1,,,,2234
84820265bf8b1790b19a2a80a0b66ba24e281de8,0,Kyle Nusbaum,2015-12-10 22:57:00-06:00,['f3e7a0225b1512dfd3157c41b13d04eb3ce84e1a'],0,1,1,2941305,1,,,,2234
0be444ea832707f76747534aaa39eb7be214942a,0,Sriharsha Chintalapani,2015-12-10 21:28:14-08:00,"['84820265bf8b1790b19a2a80a0b66ba24e281de8', 'cc009d4eb44e0d5e644413d542742a7dc273ef45']",47,725,772,2942077,17,,,,2234
6d7b96885a5ef3d8e957bba5ce2810f35127a471,0,Sriharsha Chintalapani,2015-12-10 21:29:07-08:00,['0be444ea832707f76747534aaa39eb7be214942a'],0,1,1,2942078,1,,,,2234
9d2361577e1c44043436cb163b02c57fbd3c8d49,0,Xin Wang,2015-12-11 14:28:20+08:00,['84820265bf8b1790b19a2a80a0b66ba24e281de8'],5,5,10,2942088,1,,,,2234
430df4cfaeb2c0a72f0cd21c73b0ea0d974fae39,0,Boyang Jerry Peng,2015-12-11 01:18:13-06:00,['6babbb08c43a32a7624e81dfc3a3bfe52db02a33'],1,1,2,2942090,1,,,,2234
1da0219f51b562752633ea538f86848d28569558,0,Boyang Jerry Peng,2015-12-11 01:21:46-06:00,"['430df4cfaeb2c0a72f0cd21c73b0ea0d974fae39', '6d7b96885a5ef3d8e957bba5ce2810f35127a471']",178,6189,6367,2948457,102,,,,2234
db3d1c7b9ed710afec2514ebe7ebd128bef17cdf,0,Boyang Jerry Peng,2015-12-11 01:27:00-06:00,['1da0219f51b562752633ea538f86848d28569558'],0,9,9,2948466,1,,,,2234
2e0c5e558f30d76dddcf97f1f46fbfa8e400f071,0,Sanket,2015-12-12 10:50:16-06:00,['7c972e460fc171dcfeb045957cd7e56af6d198bc'],9,7,16,2948482,1,0,1,1,2234
a710bb6615c16cb2787ac460b00af33267e888bd,1,Sanket,2015-12-13 17:41:40-06:00,['c511a7e5581c2aff5c4ddd25c5507950fea08005'],9,9,18,2948500,5,,,,2234
c420b2b6b4e5a2003e04a45ac6d0bb2de63df1ea,0,zhuol,2015-12-13 21:40:08-06:00,['9b8c12aa21717ec6ae2ae55d67ccd9433e1af4f6'],0,2,2,2948502,1,,,,2234
f3d1c0888dbebb2b91f144b34443ecc0cd1a6069,0,Satish Duggana,2015-12-14 11:37:42+05:18,['6d7b96885a5ef3d8e957bba5ce2810f35127a471'],2,3,5,2948507,1,,,,2234
c2997cf9f116297812505451269568484196b4c0,1,Florian Hussonnois,2015-12-14 11:57:19+01:00,['6d7b96885a5ef3d8e957bba5ce2810f35127a471'],705,888,1593,2950100,24,0.70212766,0.436170213,0.319148936,2242
054a7f38685d88f491666ae658591ab377179d6e,0,Florian Hussonnois,2015-12-14 11:57:21+01:00,['c2997cf9f116297812505451269568484196b4c0'],32,42,74,2950174,10,,,,2242
0702f54d72e1d18411fc24c9019e3e88b7d35e81,0,Florian Hussonnois,2015-12-14 11:57:22+01:00,['054a7f38685d88f491666ae658591ab377179d6e'],3,3,6,2950180,1,1,1,1,2242
5afb4bafc631593c0a4e8488f5e6cbfd4a34c035,0,Sriharsha Chintalapani,2015-12-14 07:13:04-08:00,"['6d7b96885a5ef3d8e957bba5ce2810f35127a471', 'c420b2b6b4e5a2003e04a45ac6d0bb2de63df1ea']",2,17,19,2950199,5,,,,2242
504bdb5153bfe606633074069647ae6024c63f63,0,Sriharsha Chintalapani,2015-12-14 07:28:41-08:00,['5afb4bafc631593c0a4e8488f5e6cbfd4a34c035'],0,1,1,2950200,1,,,,2242
f9863f47602caca571e2c00423f121010a1fe6bf,0,Boyang Jerry Peng,2015-12-14 13:30:07-06:00,"['504bdb5153bfe606633074069647ae6024c63f63', 'db3d1c7b9ed710afec2514ebe7ebd128bef17cdf']",1,10,11,2950211,2,,,,2242
b1d7a031ab5a7c69d7554d3cf20b8e62d0983b92,0,Boyang Jerry Peng,2015-12-14 13:36:45-06:00,['f9863f47602caca571e2c00423f121010a1fe6bf'],1,1,2,2950213,1,,,,2242
8cf9116ee3e635849bce2623f31ac42fde3918f7,1,Derek Dagit,2015-12-14 15:37:22-06:00,['b1d7a031ab5a7c69d7554d3cf20b8e62d0983b92'],8,65,73,2950286,3,0.8,0.8,1,2243
63b2e3d3d4dfd1f0909957b9bf04af5ea7df8bd2,1,Sanket,2015-12-14 16:35:53-06:00,['79a2a2a58888ca5c7dad379e7316aacfe2c465aa'],0,732,732,2951018,4,,,,2247
a9a84206cd9a86e5253b99d66e5f30ce33ffe3a8,1,Sanket,2015-12-14 16:35:56-06:00,['63b2e3d3d4dfd1f0909957b9bf04af5ea7df8bd2'],29,33,62,2951080,1,,,,2247
efbcd470215a893152f35d595f6fecb71f14592b,0,zhuol,2015-12-14 16:39:43-06:00,['b1d7a031ab5a7c69d7554d3cf20b8e62d0983b92'],1,1,2,2951082,1,,,,2247
fd83da80460c70db1eed127d2a977ff7b7d9110c,0,Sanket,2015-12-14 23:27:26-06:00,['a710bb6615c16cb2787ac460b00af33267e888bd'],1,1,2,2951084,1,,,,2247
e764a2bcc93b0f39f1480b0bfbde7c44a74248f1,1,Arun Mahadevan,2015-12-15 14:04:43+05:18,['60ff46ea69bb170746f52e300f30ba931136513c'],9,36,45,2951129,4,1,1,1,2247
1382b92e25254cc4c58e8b4d03ec646b7b669c8f,0,Sriharsha Chintalapani,2015-12-15 07:00:08-08:00,"['efbcd470215a893152f35d595f6fecb71f14592b', 'a1c159fe19dc28c90f5d27534add765a6520daf7']",24,211,235,2951364,15,,,,2247
8b3c20846a026732a15108e49c5f43fcea37674e,0,Sriharsha Chintalapani,2015-12-15 07:14:44-08:00,['1382b92e25254cc4c58e8b4d03ec646b7b669c8f'],0,1,1,2951365,1,,,,2247
e723112acef519bc1d19e8414bd4925fe803cb8f,0,Derek Dagit,2015-12-15 09:20:20-06:00,['402b8d215e2cebb7d7f15931aabaee695520f92d'],8,22,30,2951395,2,,,,2247
3f0281bdd394b9fbeec2c54e9add86089cbcdf29,0,Derek Dagit,2015-12-15 09:20:49-06:00,['e723112acef519bc1d19e8414bd4925fe803cb8f'],0,2,2,2951397,1,,,,2247
3a627953b0c2221c049d7ab0a8c6bd0b3dc1b430,0,Sanket,2015-12-15 10:59:06-06:00,['2e0c5e558f30d76dddcf97f1f46fbfa8e400f071'],68,126,194,2951591,1,1,1,0.865384615,2247
288d6054baa0c32f682bfe8ff71f89f3a8f8d54a,1,zhuol,2015-12-15 16:01:39-06:00,['8b3c20846a026732a15108e49c5f43fcea37674e'],22,40,62,2951653,6,,,,2248
ea3aa2e3802e19580974899b51368b5eb2850116,1,Sanket,2015-12-15 20:39:25-06:00,['a9a84206cd9a86e5253b99d66e5f30ce33ffe3a8'],222,5,227,2951880,2,,,,2248
b04eb6d834c5337f7bc92790aa0cef54f5ac75c2,0,Sanket,2015-12-15 21:20:27-06:00,['3a627953b0c2221c049d7ab0a8c6bd0b3dc1b430'],38,23,61,2951941,1,1,0,0,2248
f5829c2a0344c310bb3703b565b433cadf7c15ea,0,Sanket,2015-12-15 21:22:24-06:00,['b04eb6d834c5337f7bc92790aa0cef54f5ac75c2'],1,0,1,2951942,1,,,,2248
a7f691350b435068f042ba1e9b83d1c317a4eaf7,1,Boyang Jerry Peng,2015-12-15 23:53:28-06:00,['9a542a6934426eb43f996ac7437e40013643bd43'],206,191,397,2952339,18,0,0.666666667,0.833333333,2248
9a9ab302e7ce055b64c7c85fbc9fbced19b0c8dc,0,Arun Mahadevan,2015-12-16 11:13:01+05:18,"['8b3c20846a026732a15108e49c5f43fcea37674e', 'f3d1c0888dbebb2b91f144b34443ecc0cd1a6069']",2,3,5,2952344,1,,,,2248
aca41df15f295beff8d149705ef5935e80bb211b,0,Arun Mahadevan,2015-12-16 11:29:38+05:18,['9a9ab302e7ce055b64c7c85fbc9fbced19b0c8dc'],0,1,1,2952345,1,,,,2248
b89bbef9017ef766de2721dc691772fe82ceac3b,0,Arun Mahadevan,2015-12-16 12:34:16+05:18,['aca41df15f295beff8d149705ef5935e80bb211b'],0,1,1,2952346,1,,,,2248
a5e4129f460cdc19f7bac17fc8702bf6f856917d,0,zhuol,2015-12-16 09:32:30-06:00,['288d6054baa0c32f682bfe8ff71f89f3a8f8d54a'],3,3,6,2952352,1,,,,2248
7676e0d9cfa9efedc0fcb538bc27b28ea9d8b076,0,Boyang Jerry Peng,2015-12-16 10:39:25-06:00,['a7f691350b435068f042ba1e9b83d1c317a4eaf7'],7,7,14,2952366,2,,,,2248
eb30b81c76ea51793e1a2b4ba19e76b87caa3428,1,Sanket,2015-12-16 11:14:05-06:00,['ea3aa2e3802e19580974899b51368b5eb2850116'],6,5,11,2952377,1,,,,2248
b77dc16247190845ce6bb9c7bc4fc6eeb4c69d57,0,zhuol,2015-12-16 12:14:51-06:00,['a5e4129f460cdc19f7bac17fc8702bf6f856917d'],3,3,6,2952383,2,,,,2248
d6cca84a6b931b69077cf24310e5195d4ddc3a07,0,Kyle Nusbaum,2015-12-16 12:30:31-06:00,"['b89bbef9017ef766de2721dc691772fe82ceac3b', '9d2361577e1c44043436cb163b02c57fbd3c8d49']",5,5,10,2952393,1,,,,2248
56890854997cca6b898073c9258f2df2d33a62bf,0,Kyle Nusbaum,2015-12-16 12:34:28-06:00,['d6cca84a6b931b69077cf24310e5195d4ddc3a07'],0,1,1,2952394,1,,,,2248
51ae9135779b25b1014a80021302758c73432cfb,0,Sanket,2015-12-16 12:49:00-06:00,['f5829c2a0344c310bb3703b565b433cadf7c15ea'],8,24,32,2952426,1,0,0,1,2248
45f637f9ba902f821412982f48f6ac12eff00b40,0,Boyang Jerry Peng,2015-12-16 13:19:57-06:00,['7676e0d9cfa9efedc0fcb538bc27b28ea9d8b076'],114,114,228,2952654,1,,,,2248
c89e4522164bb71c2b8805db02e67492b59dea71,0,P. Taylor Goetz,2015-12-16 15:59:07-05:00,['8b3c20846a026732a15108e49c5f43fcea37674e'],30,10,40,2952694,4,,,,2248
068a8c21e9e4f5e213fca9eab86398685036ac9e,0,Boyang Jerry Peng,2015-12-16 16:06:47-06:00,['45f637f9ba902f821412982f48f6ac12eff00b40'],26,14,40,2952734,4,0.428571429,0,0,2248
96939d49ff83c99b200c47dd5e077e270a36909a,0,Kyle Nusbaum,2015-12-16 16:46:33-06:00,['56890854997cca6b898073c9258f2df2d33a62bf'],5,8,13,2952747,4,,,,2248
6c95887945bd7fe845b9d399b5969d52cf7295da,0,Kyle Nusbaum,2015-12-16 17:00:51-06:00,['96939d49ff83c99b200c47dd5e077e270a36909a'],0,4,4,2952751,4,,,,2248
01710c352c0bb57c4ced4634f9ca33537a6b3492,0,Xin Wang,2015-12-17 09:59:39+08:00,['56890854997cca6b898073c9258f2df2d33a62bf'],1,1,2,2952753,1,,,,2248
2de46793572ee55a32f73c3ecb3002f6a8db936d,0,Arun Mahadevan,2015-12-17 10:54:45+05:18,['e36bc47acd43ebd567630c253d5f8f422fd21863'],6,4,10,2952763,2,,,,2248
04218ae1fcebeaf5ff071358aae6432b82fd169b,0,Robert (Bobby) Evans,2015-12-17 08:50:36-06:00,['56890854997cca6b898073c9258f2df2d33a62bf'],0,4,4,2952767,1,1,1,1,2248
647012319d141564ad08fd1727e67675b0c2efed,1,P. Taylor Goetz,2015-12-17 10:56:05-05:00,['8b3c20846a026732a15108e49c5f43fcea37674e'],3,5,8,2952775,5,1,1,1,2248
4a746c37c50018bb6e4baf6e90d6f4352d6e8b72,0,Derek Dagit,2015-12-17 11:07:39-06:00,"['56890854997cca6b898073c9258f2df2d33a62bf', '3f0281bdd394b9fbeec2c54e9add86089cbcdf29']",13,27,40,2952815,4,,,,2248
390abb9ed94c55e2c646dfb9f88b00059c03baed,0,Derek Dagit,2015-12-17 11:08:10-06:00,['4a746c37c50018bb6e4baf6e90d6f4352d6e8b72'],0,1,1,2952816,1,,,,2248
4e0694b2201e2f3e3952386ed59b7af54e1350d3,0,Derek Dagit,2015-12-17 11:09:50-06:00,"['56890854997cca6b898073c9258f2df2d33a62bf', '390abb9ed94c55e2c646dfb9f88b00059c03baed']",13,28,41,2952857,5,,,,2248
6281ba82c8133bdfeb4ed2f52eb540e5d103e331,0,Derek Dagit,2015-12-17 12:38:52-06:00,['4e0694b2201e2f3e3952386ed59b7af54e1350d3'],1,3,4,2952861,1,1,1,1,2248
8e708cf27d3a6eb8f5df2a9caa48597c57e879e8,0,Kyle Nusbaum,2015-12-17 14:10:25-06:00,"['4e0694b2201e2f3e3952386ed59b7af54e1350d3', '01710c352c0bb57c4ced4634f9ca33537a6b3492']",1,1,2,2952863,1,,,,2248
cbb594406777ef804d1e17a43ac71ea5012d9796,0,Kyle Nusbaum,2015-12-17 14:42:00-06:00,"['8e708cf27d3a6eb8f5df2a9caa48597c57e879e8', 'b77dc16247190845ce6bb9c7bc4fc6eeb4c69d57']",22,40,62,2952925,6,,,,2248
6cf33a86ddd0c605261097100685f5b4893d40e7,0,Kyle Nusbaum,2015-12-17 14:45:07-06:00,['cbb594406777ef804d1e17a43ac71ea5012d9796'],0,1,1,2952926,1,,,,2248
40823ecef65d6774c2d0f22e9fcdad956e8190a6,0,Kyle Nusbaum,2015-12-17 14:45:57-06:00,"['6cf33a86ddd0c605261097100685f5b4893d40e7', 'eb30b81c76ea51793e1a2b4ba19e76b87caa3428']",217,735,952,2953878,5,,,,2248
0e1c969c20bc3039935fb4af6582702b726e5162,0,Kyle Nusbaum,2015-12-17 14:47:10-06:00,['40823ecef65d6774c2d0f22e9fcdad956e8190a6'],0,1,1,2953879,1,,,,2248
d10571afc498727f3c713cd813bf8e713c2d27f7,0,Kyle Nusbaum,2015-12-17 15:00:42-06:00,"['0e1c969c20bc3039935fb4af6582702b726e5162', 'c89e4522164bb71c2b8805db02e67492b59dea71']",30,10,40,2953919,4,,,,2248
f46fec3271d2a2c9bdfc036a2adf5c65ec56a55e,0,Kyle Nusbaum,2015-12-17 15:01:26-06:00,['d10571afc498727f3c713cd813bf8e713c2d27f7'],0,1,1,2953920,1,,,,2248
27809a1794e62038723e08b373a55bc93f4744e6,0,Kyle Nusbaum,2015-12-17 15:08:11-06:00,"['f46fec3271d2a2c9bdfc036a2adf5c65ec56a55e', 'fd83da80460c70db1eed127d2a977ff7b7d9110c']",36,23,59,2953979,6,,,,2248
cefc843099cc6f7cf6bfd89bb9135e0263a4c0d4,0,Kyle Nusbaum,2015-12-17 15:09:06-06:00,['27809a1794e62038723e08b373a55bc93f4744e6'],0,1,1,2953980,1,,,,2248
fd6a7e39c4f02ef8e7e1534a5f61945c0ba2de3a,1,zhuol,2015-12-17 15:16:59-06:00,['cefc843099cc6f7cf6bfd89bb9135e0263a4c0d4'],5,5,10,2953990,1,,,,2248
2502c996aa87af43ea9c3ec3bcaea95c93c2799b,0,Kyle Nusbaum,2015-12-17 15:24:11-06:00,"['cefc843099cc6f7cf6bfd89bb9135e0263a4c0d4', 'c5561cfdf520126ad8e5dd8ae39c025eb6041518']",48,166,214,2954204,9,,,,2248
47d0aabc15054e05870b1504931afa33e70fa0fc,0,Kyle Nusbaum,2015-12-17 15:53:34-06:00,['2502c996aa87af43ea9c3ec3bcaea95c93c2799b'],0,1,1,2954205,1,,,,2248
034a3eb5be6b8b465ead68f4855e7520cc09e0a4,0,Derek Dagit,2015-12-17 19:24:12-06:00,"['47d0aabc15054e05870b1504931afa33e70fa0fc', '8cf9116ee3e635849bce2623f31ac42fde3918f7']",8,65,73,2954278,3,,,,2248
418792f84c95962a5f2e8d8f98aab73e8138c31a,0,Derek Dagit,2015-12-17 19:24:50-06:00,['034a3eb5be6b8b465ead68f4855e7520cc09e0a4'],0,1,1,2954279,1,,,,2248
0f80d0678c243a7bd1b6aa169272741ef7e2950a,0,Boyang Jerry Peng,2015-12-18 01:21:41-06:00,['068a8c21e9e4f5e213fca9eab86398685036ac9e'],184,208,392,2954671,11,0,1,1,2248
a4c377945c864417b548c92f86551cc6e0dd53a9,1,zhuol,2015-12-18 11:34:07-06:00,['fd6a7e39c4f02ef8e7e1534a5f61945c0ba2de3a'],2,2,4,2954675,1,,,,2248
6b133e975eb5411594614a2c6432b782cbc47e0d,0,Derek Dagit,2015-12-18 12:48:02-06:00,"['418792f84c95962a5f2e8d8f98aab73e8138c31a', '6281ba82c8133bdfeb4ed2f52eb540e5d103e331']",1,3,4,2954679,1,,,,2248
ee0b92d1e9ccbc9f09545073171ed6942dcd0d26,0,Derek Dagit,2015-12-18 12:48:40-06:00,['6b133e975eb5411594614a2c6432b782cbc47e0d'],0,1,1,2954680,1,,,,2248
424ef546caa4f564aa5a79a263250062759b75ba,0,zhuol,2015-12-18 12:56:32-06:00,['418792f84c95962a5f2e8d8f98aab73e8138c31a'],1,99,100,2954780,2,,,,2248
eb747b355643ca2112c63f424738c78c0ef36230,0,zhuol,2015-12-18 13:03:17-06:00,['424ef546caa4f564aa5a79a263250062759b75ba'],1,1,2,2954782,1,,,,2248
e859cf4ca0842c8dd18bf11ef90c48cd3f30d708,0,Derek Dagit,2015-12-18 13:03:30-06:00,"['418792f84c95962a5f2e8d8f98aab73e8138c31a', 'ee0b92d1e9ccbc9f09545073171ed6942dcd0d26']",1,4,5,2954787,2,,,,2248
dc6d0f797bd0da8d2da361378ae836cdcf61528e,0,Boyang Jerry Peng,2015-12-18 13:11:04-06:00,['0f80d0678c243a7bd1b6aa169272741ef7e2950a'],17,35,52,2954839,3,0,0,1,2248
27d8b280eb2ee15d78e1f5c397c4fdb84d57dfc9,0,zhuol,2015-12-18 13:13:39-06:00,['418792f84c95962a5f2e8d8f98aab73e8138c31a'],2,25,27,2954866,1,0,0,1,2248
547ad08d34ea5c0dbd9cc339c1a4a9d4803ed763,0,Sanket,2015-12-18 13:24:38-06:00,['56890854997cca6b898073c9258f2df2d33a62bf'],9,10,19,2954885,3,,,,2248
022e382e6fa03fbc0d2d2ee9637dfa0172011948,0,Hugo Louro,2015-12-18 11:58:52-08:00,['e859cf4ca0842c8dd18bf11ef90c48cd3f30d708'],1,1,2,2954887,1,,,,2248
3e76fd5b9166ecc9119007cf6b9ce2eb8958184a,0,zhuol,2015-12-18 15:18:50-06:00,"['e859cf4ca0842c8dd18bf11ef90c48cd3f30d708', 'a4c377945c864417b548c92f86551cc6e0dd53a9']",6,6,12,2954899,1,,,,2248
8129a8bf4f1f28b9f7d3e813f1e3844d9235086f,0,Sriharsha Chintalapani,2015-12-20 19:54:12-08:00,"['3e76fd5b9166ecc9119007cf6b9ce2eb8958184a', 'e764a2bcc93b0f39f1480b0bfbde7c44a74248f1']",178,1691,1869,2956768,27,,,,2248
8f9ed06db57918b16b9e96f444585cc372fe6754,0,Sriharsha Chintalapani,2015-12-20 20:02:57-08:00,['8129a8bf4f1f28b9f7d3e813f1e3844d9235086f'],0,1,1,2956769,1,,,,2248
d790eb5abb1952be57f16f9a49f84eff4b0476b5,0,Derek Dagit,2015-12-21 08:28:05-06:00,"['8f9ed06db57918b16b9e96f444585cc372fe6754', 'dc6d0f797bd0da8d2da361378ae836cdcf61528e']",390,3924,4314,2961083,31,,,,2248
eaf5b37aaa176d61ad3104d6abd76fde0d8890e8,0,Derek Dagit,2015-12-21 08:28:23-06:00,['d790eb5abb1952be57f16f9a49f84eff4b0476b5'],0,1,1,2961084,1,,,,2248
c7164ccd4c8f8f9b3906e1f80d3c0ca7876099dd,0,Derek Dagit,2015-12-21 08:28:38-06:00,"['8f9ed06db57918b16b9e96f444585cc372fe6754', 'eaf5b37aaa176d61ad3104d6abd76fde0d8890e8']",390,3925,4315,2965399,32,,,,2248
7f4aa5dc73ad592ed89afe47e2698574488debb5,0,P. Taylor Goetz,2015-12-21 12:33:59-05:00,"['c7164ccd4c8f8f9b3906e1f80d3c0ca7876099dd', '04218ae1fcebeaf5ff071358aae6432b82fd169b']",0,4,4,2965403,1,,,,2248
e2debccaca82f68602a9cfddddc7c9db6177e49d,0,P. Taylor Goetz,2015-12-21 14:18:37-05:00,"['647012319d141564ad08fd1727e67675b0c2efed', '7f4aa5dc73ad592ed89afe47e2698574488debb5']",951,6710,7661,2973064,95,,,,2248
a998c4e9de89e7fa8f893a29e7c84e96f3c93d56,0,P. Taylor Goetz,2015-12-21 14:31:11-05:00,['e2debccaca82f68602a9cfddddc7c9db6177e49d'],0,2,2,2973066,1,,,,2248
29c910ff701c3b641a01a8a404ed1c4e9d207b31,0,zhuol,2015-12-21 15:36:25-06:00,['a998c4e9de89e7fa8f893a29e7c84e96f3c93d56'],42,36,78,2973144,1,,,,2248
b41f45022e7919093bb431cd2c588dd9245b57c1,0,zhuol,2015-12-21 17:11:26-06:00,"['a998c4e9de89e7fa8f893a29e7c84e96f3c93d56', 'eb747b355643ca2112c63f424738c78c0ef36230']",2,100,102,2973246,2,,,,2248
3f295965dd0ea0e6d20ed7ecd001590d574af06b,0,Xin Wang,2015-12-22 10:44:25+08:00,['b41f45022e7919093bb431cd2c588dd9245b57c1'],1,1,2,2973248,1,,,,2248
3f1de7052513fe59cca020660a5d34d92287a47d,0,Xin Wang,2015-12-22 10:46:32+08:00,['3f295965dd0ea0e6d20ed7ecd001590d574af06b'],1,1,2,2973250,1,,,,2248
37401835f145f6b509b63d3f16c93071473da7ed,0,Derek Dagit,2015-12-22 11:28:52-06:00,['e859cf4ca0842c8dd18bf11ef90c48cd3f30d708'],0,21,21,2973271,1,,,,2248
67be48c9d6da4d2fc13cb28440a130923b7a6d40,0,Derek Dagit,2015-12-22 13:55:21-06:00,['e859cf4ca0842c8dd18bf11ef90c48cd3f30d708'],41,0,41,2973312,1,0,0,0,2248
37099d8ee68cd8c440bae34ed2aa0c7f30a4d3c2,0,Derek Dagit,2015-12-22 14:46:37-06:00,['e859cf4ca0842c8dd18bf11ef90c48cd3f30d708'],66,0,66,2973378,1,,,,2248
7ee350cdb479320885435386e8b77ec93240f57e,0,Xin Wang,2015-12-23 16:56:56+08:00,['b41f45022e7919093bb431cd2c588dd9245b57c1'],1,3,4,2973382,1,,,,2248
0cd69a13183d6d935925d0b49b23ae752e9aeac6,0,Xin Wang,2015-12-23 18:37:18+08:00,['b41f45022e7919093bb431cd2c588dd9245b57c1'],10,12,22,2973404,1,0.5,0.5,0,2248
716a18df015e568de47f3ef1e64fbe6aaccf3c52,0,Xin Wang,2015-12-23 19:05:08+08:00,['b41f45022e7919093bb431cd2c588dd9245b57c1'],10,9,19,2973423,1,1,0,1,2248
48c52db6ed0c67549ce4d0ad7e50ad2d35fe5f5a,0,Xin Wang,2015-12-23 19:07:50+08:00,['716a18df015e568de47f3ef1e64fbe6aaccf3c52'],5,6,11,2973434,1,,,,2248
62b7166470611007d30a2bf285f823fe8377b023,0,Satish Duggana,2015-12-23 19:30:08+05:18,['b41f45022e7919093bb431cd2c588dd9245b57c1'],3,13,16,2973450,1,1,1,1,2248
3f08d7b24a1d99069822e8f4d057730a3205a31b,0,zhuol,2015-12-23 14:30:04-06:00,"['b41f45022e7919093bb431cd2c588dd9245b57c1', '3f1de7052513fe59cca020660a5d34d92287a47d']",2,2,4,2973454,2,,,,2248
040bbd70cbf3a24389107428fcf4676ef7cdf8b5,0,vesense,2015-12-24 21:39:53+08:00,['a998c4e9de89e7fa8f893a29e7c84e96f3c93d56'],3,3,6,2973460,3,,,,2248
452aca81120708c9847d697f08acdc34409fea3b,0,vesense,2015-12-24 22:09:18+08:00,['b41f45022e7919093bb431cd2c588dd9245b57c1'],8,1,9,2973469,2,0,0,0,2248
d5f15aece7ae2cd281534fc504badf6a52a6eda7,0,Arun Mahadevan,2015-12-24 23:01:15+05:18,"['3f08d7b24a1d99069822e8f4d057730a3205a31b', '040bbd70cbf3a24389107428fcf4676ef7cdf8b5']",3,3,6,2973475,3,,,,2248
b7ba063276b0bea82cd74dc1f9d7c7a65454b66d,0,Arun Mahadevan,2015-12-24 23:08:54+05:18,['d5f15aece7ae2cd281534fc504badf6a52a6eda7'],0,1,1,2973476,1,,,,2248
03e803fd322e5740957f92877ba763ba3f900b67,0,Sriharsha Chintalapani,2015-12-24 23:26:57-08:00,"['b7ba063276b0bea82cd74dc1f9d7c7a65454b66d', '022e382e6fa03fbc0d2d2ee9637dfa0172011948']",1,1,2,2973478,1,,,,2248
0cf9ee960d1ee67cf977c7d6b96f86a2b2307c52,0,Seth Ammons,2015-12-26 06:26:09-08:00,['b7ba063276b0bea82cd74dc1f9d7c7a65454b66d'],19,2,21,2973499,1,,,,2248
9090dae3bf75274fed3ee274c7bba740ed800ae1,0,Derek Dagit,2015-12-28 08:26:33-06:00,"['03e803fd322e5740957f92877ba763ba3f900b67', '67be48c9d6da4d2fc13cb28440a130923b7a6d40']",41,0,41,2973540,1,,,,2248
42274b72a9108c00e07e9b1cf09042efeb595877,0,Derek Dagit,2015-12-28 08:27:05-06:00,['9090dae3bf75274fed3ee274c7bba740ed800ae1'],0,1,1,2973541,1,,,,2248
e5de2558adf34e3006532f94b38de9310d380675,0,Derek Dagit,2015-12-28 08:27:21-06:00,"['03e803fd322e5740957f92877ba763ba3f900b67', '42274b72a9108c00e07e9b1cf09042efeb595877']",41,1,42,2973583,2,,,,2248
50c8f836079bb77e2c925e2ea54b05a5ddb85091,0,zhuol,2015-12-28 10:13:56-06:00,"['e5de2558adf34e3006532f94b38de9310d380675', '29c910ff701c3b641a01a8a404ed1c4e9d207b31']",42,36,78,2973661,1,,,,2248
36c10f7ab00ebe12d23a6011bfe68be47ff22e6c,0,zhuol,2015-12-28 10:16:02-06:00,"['50c8f836079bb77e2c925e2ea54b05a5ddb85091', '27d8b280eb2ee15d78e1f5c397c4fdb84d57dfc9']",2,25,27,2973688,1,,,,2248
2199ee89de21899ef7db31d2f4e88aad60a53843,0,Parth Brahmbhatt,2015-12-28 09:46:31-08:00,['36c10f7ab00ebe12d23a6011bfe68be47ff22e6c'],2,17,19,2973707,4,0.846153846,1,1,2248
57d7cf6e50e739fbcf9318f217b57e79a733c78f,0,Derek Dagit,2015-12-28 12:29:42-06:00,['36c10f7ab00ebe12d23a6011bfe68be47ff22e6c'],1,0,1,2973708,1,,,,2248
678e6eaf9b5e84c484e7da594933188fca563bcd,0,ablecao,2015-12-29 09:31:51+08:00,['57d7cf6e50e739fbcf9318f217b57e79a733c78f'],2,1,3,2973711,1,,,,2248
3193d405d3452d2a3ae68bd83f6043c969b4922e,0,vesense,2015-12-29 11:34:10+08:00,['b7ba063276b0bea82cd74dc1f9d7c7a65454b66d'],7,7,14,2973725,4,,,,2248
5edd4eaea7bb6e6be65e9d6bffaeaa897551df71,1,vesense,2015-12-29 12:17:33+08:00,['b7ba063276b0bea82cd74dc1f9d7c7a65454b66d'],0,10,10,2973735,4,0,0.571428571,1,2248
6e621269ff5023c84e4efab30b0ab0c3ebe443f9,1,vesense,2015-12-29 12:17:40+08:00,['5edd4eaea7bb6e6be65e9d6bffaeaa897551df71'],2,2,4,2973739,1,,,,2248
db03e4a768bd9b93395285b97b65d309a0442d5c,0,vesense,2015-12-29 12:35:17+08:00,['b7ba063276b0bea82cd74dc1f9d7c7a65454b66d'],5,15,20,2973759,1,0,1,1,2248
5978612d2d5f9bd0fb44714d7056dfcc70d57596,0,ablecao,2015-12-29 15:08:54+08:00,['57d7cf6e50e739fbcf9318f217b57e79a733c78f'],46,0,46,2973805,1,0,0,0,2248
759e34c675950f813476686e25b29c4ad6dcd5ef,1,ablecao,2015-12-30 17:27:09+08:00,['57d7cf6e50e739fbcf9318f217b57e79a733c78f'],7,17,24,2973829,3,1,1,1,2248
8b6c62362b7977433a4df93ea83205520965e1a4,0,ablecao,2015-12-30 17:31:22+08:00,['759e34c675950f813476686e25b29c4ad6dcd5ef'],24,0,24,2973853,1,,,,2248
ce69a7c750d78996006b2d8e7ab6885c8c2ef2d5,0,ablecao,2015-12-30 18:44:48+08:00,['8b6c62362b7977433a4df93ea83205520965e1a4'],1,1,2,2973855,1,,,,2248
390e11e8bf27b37126c24597c46c1ec6b7dd7943,0,Robert (Bobby) Evans,2016-01-04 18:08:55+00:00,['57d7cf6e50e739fbcf9318f217b57e79a733c78f'],0,4,4,2973859,1,0,1,1,2248
cb6e9234bb22523ef8023303a93190a27cf19786,0,Robert (Bobby) Evans,2016-01-04 13:28:13-06:00,"['57d7cf6e50e739fbcf9318f217b57e79a733c78f', '51ae9135779b25b1014a80021302758c73432cfb']",1,304,305,2974164,2,,,,2248
59a9605520de54930fd9ba008b6594f98f2eb63c,0,Robert (Bobby) Evans,2016-01-04 13:28:44-06:00,['cb6e9234bb22523ef8023303a93190a27cf19786'],0,1,1,2974165,1,,,,2248
a13ebd6e568135c0b0124911da22d311f1b183be,0,Robert (Bobby) Evans,2016-01-04 15:23:52-06:00,"['59a9605520de54930fd9ba008b6594f98f2eb63c', '6c95887945bd7fe845b9d399b5969d52cf7295da']",5,12,17,2974182,4,,,,2248
0390012bdf5f0e79d5bb450cf9f16f7bc6bce7c1,0,Robert (Bobby) Evans,2016-01-04 15:24:15-06:00,['a13ebd6e568135c0b0124911da22d311f1b183be'],0,1,1,2974183,1,,,,2248
274aa9d1b6078f9108639d1fde5d54815a1dc6ad,0,Robert (Bobby) Evans,2016-01-04 15:39:36-06:00,"['0390012bdf5f0e79d5bb450cf9f16f7bc6bce7c1', 'ddc6b8e63f8a7393ab3b549d24038b62cfd9e382']",8,7,15,2974198,4,,,,2248
36b9c055c9fad98fdab2775f50e200467349cf00,0,Robert (Bobby) Evans,2016-01-04 15:40:02-06:00,['274aa9d1b6078f9108639d1fde5d54815a1dc6ad'],0,1,1,2974199,1,,,,2248
7b8c9f028c75b29bae8d5fe866a977636b703cd5,0,Robert (Bobby) Evans,2016-01-04 15:56:33-06:00,"['36b9c055c9fad98fdab2775f50e200467349cf00', '7ee350cdb479320885435386e8b77ec93240f57e']",1,3,4,2974203,1,,,,2248
ba02f1eec4f5f3af5392795161f4a74395f189c7,0,Robert (Bobby) Evans,2016-01-04 15:57:00-06:00,['7b8c9f028c75b29bae8d5fe866a977636b703cd5'],0,1,1,2974204,1,,,,2248
4950381628efbae615cdd5a2b01cacfa3b132c84,1,Arun Mahadevan,2016-01-05 09:00:22+05:18,['57d7cf6e50e739fbcf9318f217b57e79a733c78f'],0,147,147,2974351,1,,,,2249
48216dc11b49a90e20316b4a662e2d2a39206b83,0,vesense,2016-01-05 14:09:52+08:00,['57d7cf6e50e739fbcf9318f217b57e79a733c78f'],4,3,7,2974358,3,,,,2249
2012a8b9bc47f117454b98dffdac88facd7f4631,0,Robert (Bobby) Evans,2016-01-05 08:57:14-06:00,"['ba02f1eec4f5f3af5392795161f4a74395f189c7', '452aca81120708c9847d697f08acdc34409fea3b']",8,1,9,2974367,2,,,,2249
dd8523121708d058f641fdbc4db005c49b42fce1,0,Robert (Bobby) Evans,2016-01-05 08:57:39-06:00,['2012a8b9bc47f117454b98dffdac88facd7f4631'],0,1,1,2974368,1,,,,2249
ee5852c77ec6b0b236ae4eda596cae9101e2a567,0,Robert (Bobby) Evans,2016-01-05 09:12:22-06:00,"['dd8523121708d058f641fdbc4db005c49b42fce1', 'ce69a7c750d78996006b2d8e7ab6885c8c2ef2d5']",32,18,50,2974418,5,,,,2249
be7e7404322294cf664406a89ed1f51b0f284cb1,0,Robert (Bobby) Evans,2016-01-05 09:13:01-06:00,['ee5852c77ec6b0b236ae4eda596cae9101e2a567'],0,1,1,2974419,1,,,,2249
76991c002f5b44ee90bb20b94177e7000ebd17d1,0,Robert (Bobby) Evans,2016-01-05 09:36:52-06:00,"['be7e7404322294cf664406a89ed1f51b0f284cb1', '678e6eaf9b5e84c484e7da594933188fca563bcd']",2,1,3,2974422,1,,,,2249
6d889519cdd4e229ad8cd5efacf9846a7ef870a6,0,Robert (Bobby) Evans,2016-01-05 09:37:18-06:00,['76991c002f5b44ee90bb20b94177e7000ebd17d1'],0,1,1,2974423,1,,,,2249
6803ccb5fcf3c527e4d07e0b19427d2ff569a431,0,Robert (Bobby) Evans,2016-01-05 09:56:28-06:00,"['6d889519cdd4e229ad8cd5efacf9846a7ef870a6', '37099d8ee68cd8c440bae34ed2aa0c7f30a4d3c2']",66,0,66,2974489,1,,,,2249
c242378be261ae31f43a56c09ef5d0c861dc181e,0,Robert (Bobby) Evans,2016-01-05 09:56:57-06:00,['6803ccb5fcf3c527e4d07e0b19427d2ff569a431'],0,1,1,2974490,1,,,,2249
51746991079dee7ac4ad4045eb3cfbadc78fc038,0,johanwitters,2016-01-05 16:16:04+00:00,['6d889519cdd4e229ad8cd5efacf9846a7ef870a6'],1,1,2,2974492,1,,,,2249
a8554305b288ba6f729d40f4670db95ecc1139af,0,Robert (Bobby) Evans,2016-01-05 11:17:23-06:00,"['c242378be261ae31f43a56c09ef5d0c861dc181e', '51746991079dee7ac4ad4045eb3cfbadc78fc038']",1,1,2,2974494,1,,,,2249
0340ffc85825432a025e8c6bd86e96bef7c0b6ca,0,Robert (Bobby) Evans,2016-01-05 11:27:27-06:00,"['a8554305b288ba6f729d40f4670db95ecc1139af', '390e11e8bf27b37126c24597c46c1ec6b7dd7943']",0,4,4,2974498,1,,,,2249
4b672dedc986741debf1d6b27cf6c48273efb023,0,Robert (Bobby) Evans,2016-01-05 11:27:48-06:00,['0340ffc85825432a025e8c6bd86e96bef7c0b6ca'],0,1,1,2974499,1,,,,2249
17b466e978be6e1022dd3e9549f6497416fc2102,0,Derek Dagit,2016-01-05 11:48:54-06:00,"['4b672dedc986741debf1d6b27cf6c48273efb023', '0cf9ee960d1ee67cf977c7d6b96f86a2b2307c52']",19,2,21,2974520,1,,,,2249
e7ac2875c933ba19be1174c4e58300cd237d9654,0,Derek Dagit,2016-01-05 11:51:48-06:00,['17b466e978be6e1022dd3e9549f6497416fc2102'],0,2,2,2974522,2,,,,2249
aff470495f4f971be2e094ec66a8c3c42c15f3e7,0,Derek Dagit,2016-01-05 12:06:44-06:00,"['4b672dedc986741debf1d6b27cf6c48273efb023', 'e7ac2875c933ba19be1174c4e58300cd237d9654']",19,4,23,2974545,3,,,,2249
6712e8d7e4cf48e045eb0d46187291296d99a1f2,0,Kyle Nusbaum,2016-01-05 12:22:23-06:00,['aff470495f4f971be2e094ec66a8c3c42c15f3e7'],2,2,4,2974549,1,,,,2249
516ea28f5488d1523899133fb77a7cba34b2fa66,0,Robert (Bobby) Evans,2016-01-05 12:28:31-06:00,"['aff470495f4f971be2e094ec66a8c3c42c15f3e7', '62b7166470611007d30a2bf285f823fe8377b023']",3,13,16,2974565,1,,,,2249
2d8811dcccb10826ab2063cbcdb2ca0d05973b72,0,Robert (Bobby) Evans,2016-01-05 12:28:54-06:00,['516ea28f5488d1523899133fb77a7cba34b2fa66'],0,1,1,2974566,1,,,,2249
91343205d36eb1f245883d4dd370b9dba91e6a90,0,Kyle Nusbaum,2016-01-05 13:07:27-06:00,['6712e8d7e4cf48e045eb0d46187291296d99a1f2'],2,2,4,2974570,1,,,,2249
9c294509b103f1630b5138e80474ba2bed8d25f0,0,Robert (Bobby) Evans,2016-01-05 13:29:35-06:00,"['2d8811dcccb10826ab2063cbcdb2ca0d05973b72', '5978612d2d5f9bd0fb44714d7056dfcc70d57596']",46,0,46,2974616,1,,,,2249
97613ac77875033f82548fede9d938596686e149,0,Robert (Bobby) Evans,2016-01-05 13:30:22-06:00,['9c294509b103f1630b5138e80474ba2bed8d25f0'],0,1,1,2974617,1,,,,2249
83fba1b4869706c7c30786ed0a4738b763261220,0,Robert (Bobby) Evans,2016-01-05 13:56:22-06:00,"['97613ac77875033f82548fede9d938596686e149', '4950381628efbae615cdd5a2b01cacfa3b132c84']",0,147,147,2974764,1,,,,2249
cc07b945ad8af13dd588522b109b1a54d88b6eb5,0,Robert (Bobby) Evans,2016-01-05 13:56:57-06:00,['83fba1b4869706c7c30786ed0a4738b763261220'],0,1,1,2974765,1,,,,2249
4fff0edf5bbcde0f096b0dd4c72e761c5e65b89d,0,Robert (Bobby) Evans,2016-01-05 14:06:03-06:00,['cc07b945ad8af13dd588522b109b1a54d88b6eb5'],0,0,0,2974765,0,,,,2249
baeba969e0548fa98485c4dc9fd6609937147463,0,Jungtaek Lim,2016-01-06 05:58:06+09:00,['ba02f1eec4f5f3af5392795161f4a74395f189c7'],2,2,4,2974769,1,,,,2249
8b4c65c3fa98c8b270b89b062f6c466792d51aaf,0,Robert (Bobby) Evans,2016-01-05 14:59:04-06:00,"['4fff0edf5bbcde0f096b0dd4c72e761c5e65b89d', '26b2f324cbd68aea0839423b4316070d8200f7ae']",1,6,7,2974776,1,,,,2249
cb1018db0ebf29291ad71d103610620ab06dd82c,0,Robert (Bobby) Evans,2016-01-05 14:59:36-06:00,['8b4c65c3fa98c8b270b89b062f6c466792d51aaf'],0,1,1,2974777,1,,,,2249
2a7709383567b90be9bb347201db19c2a692f4db,0,Sanket,2016-01-05 15:26:51-06:00,['547ad08d34ea5c0dbd9cc339c1a4a9d4803ed763'],0,1,1,2974778,1,,,,2249
f157ab423f6a539d07c512fac4dd97734e3d62e5,1,P. Taylor Goetz,2016-01-05 16:49:15-05:00,['4b672dedc986741debf1d6b27cf6c48273efb023'],0,2235,2235,2977013,26,0.746312684,0.920353982,0.895280236,2274
09e0a9e865f4d5899c91648bdc6d9191375a5a47,0,Haohui Mai,2016-01-05 14:25:40-08:00,['cb1018db0ebf29291ad71d103610620ab06dd82c'],0,1,1,2977014,1,,,,2274
06a47a9a9676aae7f34f6e5d14ef29fd2c59b422,0,Aaron Dixon,2016-01-05 16:36:34-06:00,['cb1018db0ebf29291ad71d103610620ab06dd82c'],5,104,109,2977123,2,0.058823529,1,0.441176471,2274
29bf22a2c2d81d4c3d9db7035d42460d3eddc1a7,0,Aaron Dixon,2016-01-05 16:36:36-06:00,['06a47a9a9676aae7f34f6e5d14ef29fd2c59b422'],1,11,12,2977135,1,,,,2274
7f49cba373756fb710b66c240605b03850e92dd8,0,Kyle Nusbaum,2016-01-05 16:37:23-06:00,"['09e0a9e865f4d5899c91648bdc6d9191375a5a47', 'baeba969e0548fa98485c4dc9fd6609937147463']",2,2,4,2977139,1,,,,2274
c53ae51e4511e940fe37fa778bafe7d122371bd8,0,Aaron Dixon,2016-01-05 16:39:37-06:00,['29bf22a2c2d81d4c3d9db7035d42460d3eddc1a7'],7,30,37,2977176,2,1,1,1,2274
2e88a2fc2b52c43498d5d0df8b177c691c5bfa77,0,Aaron Dixon,2016-01-05 16:40:10-06:00,['c53ae51e4511e940fe37fa778bafe7d122371bd8'],2,29,31,2977207,1,,,,2274
c9cc96a1766ae5ff423a32886c3ce58075816671,0,Aaron Dixon,2016-01-05 16:57:30-06:00,['2e88a2fc2b52c43498d5d0df8b177c691c5bfa77'],106,48,154,2977361,2,,,,2274
ab769cba028b5db4eb00540da6254bb67be216d6,0,Aaron Dixon,2016-01-05 16:59:45-06:00,['c9cc96a1766ae5ff423a32886c3ce58075816671'],1,1,2,2977363,1,,,,2274
f6c3225d9ed5367c2e0f132f9ea1d20c6a0bf4b4,0,Xin Wang,2016-01-06 13:13:36+08:00,['0cd69a13183d6d935925d0b49b23ae752e9aeac6'],3,3,6,2977369,1,,,,2274
46fbd2a5159fccaa7608d0cad5d1fecd4bff7a18,0,vesense,2016-01-06 13:37:01+08:00,['48c52db6ed0c67549ce4d0ad7e50ad2d35fe5f5a'],6,6,12,2977381,2,,,,2274
8910210ee7016512db4344e282f9379c0f81e8d1,1,P. Taylor Goetz,2016-01-06 15:33:18-05:00,['f157ab423f6a539d07c512fac4dd97734e3d62e5'],216,194,410,2977791,12,1,1,0,2274
bd11b59ce3b46d1ccd2ccf5f94851ddf8ebafc21,0,P. Taylor Goetz,2016-01-06 15:44:59-05:00,['8910210ee7016512db4344e282f9379c0f81e8d1'],5,9,14,2977805,1,,,,2274
1e2a583ff805935396f50c79e122b7688cc6e156,0,Robert (Bobby) Evans,2016-01-06 14:57:48-06:00,"['7f49cba373756fb710b66c240605b03850e92dd8', '2a7709383567b90be9bb347201db19c2a692f4db']",8,10,18,2977823,3,,,,2274
c7cb25d997899e815a0d1f68c49a399914c9a173,0,Robert (Bobby) Evans,2016-01-06 14:58:15-06:00,['1e2a583ff805935396f50c79e122b7688cc6e156'],0,1,1,2977824,1,,,,2274
e354b2fdb3d9444c18055a2735ffe89169681b53,0,Robert (Bobby) Evans,2016-01-06 15:23:19-06:00,"['c7cb25d997899e815a0d1f68c49a399914c9a173', '30f942ca2c9aae828c04ddaa834ea07bf74201d7']",2,19,21,2977845,2,,,,2274
ce31f4cfb83dc5d3893be39ffe0a6f6c1d145e96,0,Robert (Bobby) Evans,2016-01-06 15:23:56-06:00,['e354b2fdb3d9444c18055a2735ffe89169681b53'],0,1,1,2977846,1,,,,2274
e8c08927eb7227cc716a54f99d8f90d1b0c3f1f2,0,Jang-Soo Lee,2016-01-06 21:16:41-05:00,"['f910e0db9447ca0bdc1a382c09ee1a242f4fc166', 'ce31f4cfb83dc5d3893be39ffe0a6f6c1d145e96']",21493,154223,175716,3153562,1140,,,,2274
793de733580799f74f0bc59308ec7243e6f0dad6,0,Jang-Soo Lee,2016-01-06 21:24:33-05:00,['e8c08927eb7227cc716a54f99d8f90d1b0c3f1f2'],23,23,46,3153608,1,,,,2274
1eca8a3398679dce7675e72d91527ac05335bd54,0,Arun Mahadevan,2016-01-07 15:14:00+05:18,['ce31f4cfb83dc5d3893be39ffe0a6f6c1d145e96'],1,2,3,3153611,1,,,,2274
32bcfd0602283b743e284d940c768dfec4f4a42a,1,Robert (Bobby) Evans,2016-01-07 14:30:22+00:00,['ce31f4cfb83dc5d3893be39ffe0a6f6c1d145e96'],7,1118,1125,3154736,19,0.367609254,0.596401028,0.4781491,2288
c46692b563b91bd05ef1e005b8ffd70814c34f6f,0,Robert (Bobby) Evans,2016-01-07 14:30:22+00:00,['32bcfd0602283b743e284d940c768dfec4f4a42a'],1,1,2,3154738,1,,,,2288
5b32b89b83e48e73b861c7e29252e967f13114dd,0,Robert (Bobby) Evans,2016-01-07 14:30:22+00:00,['c46692b563b91bd05ef1e005b8ffd70814c34f6f'],2,2,4,3154742,1,,,,2288
8c1653a24165d7941a643ebcb4e0118f911c176f,0,Robert (Bobby) Evans,2016-01-07 14:30:22+00:00,['5b32b89b83e48e73b861c7e29252e967f13114dd'],1,2,3,3154745,1,,,,2288
9c5daccc374fb433376e5861f2cb525f4ed75661,0,Robert (Bobby) Evans,2016-01-07 14:30:22+00:00,['8c1653a24165d7941a643ebcb4e0118f911c176f'],2,3,5,3154750,1,,,,2288
1bd277c2c165b273fecf9bf248dc2635b61ce41a,0,Robert (Bobby) Evans,2016-01-07 14:30:22+00:00,['9c5daccc374fb433376e5861f2cb525f4ed75661'],1,3,4,3154754,1,,,,2288
cea443699522b1dcb3d6953604eb3ca95da6b56d,1,Xin Wang,2016-01-07 23:12:05+08:00,['db03e4a768bd9b93395285b97b65d309a0442d5c'],9,43,52,3154806,1,1,1,0.75,2288
2d915546c4d415022d8bc1b8f8073c4ed9d271af,0,Robert (Bobby) Evans,2016-01-07 15:19:27+00:00,['1bd277c2c165b273fecf9bf248dc2635b61ce41a'],44,44,88,3154894,1,,,,2288
c84a4f527eec105860958dca0a55494773f5dc4f,0,Robert (Bobby) Evans,2016-01-07 15:40:23+00:00,['2d915546c4d415022d8bc1b8f8073c4ed9d271af'],0,19,19,3154913,3,0.461538462,0.461538462,0.461538462,2288
472b83ef94b85cfea8c0302fce052a595e5cf242,0,Robert (Bobby) Evans,2016-01-07 15:44:50+00:00,['c84a4f527eec105860958dca0a55494773f5dc4f'],0,1,1,3154914,1,,,,2288
c5929edae1d644b1093c9c2ded1c98ca62e92ba6,0,Robert (Bobby) Evans,2016-01-07 15:52:03+00:00,['472b83ef94b85cfea8c0302fce052a595e5cf242'],1,9,10,3154924,2,1,1,1,2288
4a3625a061beee6743bfa953dc3c4a17916224aa,0,Robert (Bobby) Evans,2016-01-07 18:46:32+00:00,['c5929edae1d644b1093c9c2ded1c98ca62e92ba6'],1,1,2,3154926,1,,,,2288
f659ef0e8f7f582d685dca3dabebf73c9f97546c,0,vesense,2016-01-08 12:32:38+08:00,['cea443699522b1dcb3d6953604eb3ca95da6b56d'],15,15,30,3154956,2,1,0,0,2288
d88d5518e145f9cb62d03a6528c350fd38014cc3,0,P. Taylor Goetz,2016-01-07 23:55:14-05:00,['bd11b59ce3b46d1ccd2ccf5f94851ddf8ebafc21'],0,178,178,3155134,1,,,,2289
181a46dfa561ba863a170efc5b688e5427ee7089,0,Derek Dagit,2016-01-07 23:06:03-06:00,['ce31f4cfb83dc5d3893be39ffe0a6f6c1d145e96'],31,12,43,3155177,1,,,,2289
a1c3ebbc249e5d35ae59531b424f90b930471378,0,Derek Dagit,2016-01-07 23:22:40-06:00,['181a46dfa561ba863a170efc5b688e5427ee7089'],39,39,78,3155255,1,,,,2289
497aa0991b05b1e8296511bbc3aacf0d9a0830ad,1,Derek Dagit,2016-01-07 23:26:17-06:00,['a1c3ebbc249e5d35ae59531b424f90b930471378'],71,213,284,3155539,2,,,,2289
c34266924a0bcb7c17bddc0a602580e892153651,1,Derek Dagit,2016-01-07 23:27:30-06:00,['497aa0991b05b1e8296511bbc3aacf0d9a0830ad'],1,5,6,3155545,4,,,,2290
4b61308349d8c66d48234de22190fe721aa0e621,0,P. Taylor Goetz,2016-01-08 00:31:16-05:00,['d88d5518e145f9cb62d03a6528c350fd38014cc3'],4,5,9,3155554,1,,,,2290
64ff34966927d4d7c53af3bc4000375655413d81,0,Robert (Bobby) Evans,2016-01-08 10:39:03-06:00,['ce31f4cfb83dc5d3893be39ffe0a6f6c1d145e96'],19,9,28,3155582,3,0,0,0,2290
a927d414456c3837e2d641cfbfcaaa1c159fcd82,0,Robert (Bobby) Evans,2016-01-08 18:48:01+00:00,['4a3625a061beee6743bfa953dc3c4a17916224aa'],0,3,3,3155585,1,,,,2290
2b7a2cdf07ef32bf4a185a1fdfd1c68f17f384b0,0,Robert (Bobby) Evans,2016-01-08 12:57:55-06:00,"['64ff34966927d4d7c53af3bc4000375655413d81', 'b18c6ecefa13570bef097dabb0fbd2c1069aec21']",2,2,4,3155589,1,,,,2290
526a43b88c7fee8501c3c0d29285f24cb6bbe303,0,P. Taylor Goetz,2016-01-08 14:18:59-05:00,['4b61308349d8c66d48234de22190fe721aa0e621'],9,202,211,3155800,3,1,1,1,2290
0f1b14200f8be1f76408d58e71d02226c262e778,0,Kishor Patil,2016-01-08 13:25:23-06:00,['2b7a2cdf07ef32bf4a185a1fdfd1c68f17f384b0'],1,2,3,3155803,1,,,,2290
1f1ba77be849e50cdc09fcfe08dcec8f4984b4f9,0,Haohui Mai,2016-01-08 11:28:51-08:00,['2b7a2cdf07ef32bf4a185a1fdfd1c68f17f384b0'],18,65,83,3155886,1,0.21875,1,0.4375,2290
e1527d9d1b12265c62c6b8a267dc00104fc6827a,0,Haohui Mai,2016-01-08 11:29:28-08:00,['1f1ba77be849e50cdc09fcfe08dcec8f4984b4f9'],0,1,1,3155887,1,,,,2290
d9f09c9da6ff0d331eb82efe2c3525cb4dd92883,0,P. Taylor Goetz,2016-01-08 14:31:43-05:00,['526a43b88c7fee8501c3c0d29285f24cb6bbe303'],5,5,10,3155897,2,,,,2290
e319380e8796d11be834b59788834ca9c2c5ad97,0,P. Taylor Goetz,2016-01-08 14:47:47-05:00,['d9f09c9da6ff0d331eb82efe2c3525cb4dd92883'],1,5,6,3155903,1,,,,2290
a0d05f8397be3e26fcc262553a773109756329a4,0,Kishor Patil,2016-01-08 14:53:20-06:00,['0f1b14200f8be1f76408d58e71d02226c262e778'],1,2,3,3155906,1,,,,2290
d62281629afe02a34aba10633c36be546eb70a74,0,Priyank,2016-01-08 13:27:03-08:00,['ce31f4cfb83dc5d3893be39ffe0a6f6c1d145e96'],1,10,11,3155917,1,,,,2290
7cc1d05a6c4db0610baccbc7870544d9ea8258af,1,zhuol,2016-01-08 17:32:50-06:00,['e1527d9d1b12265c62c6b8a267dc00104fc6827a'],156,377,533,3156450,4,0.160377358,0.160377358,0.160377358,2291
f939fc27fbcc8dd1fc1e3b9d8948f1994fc399af,0,Priyank,2016-01-08 17:15:51-08:00,['e1527d9d1b12265c62c6b8a267dc00104fc6827a'],2,69,71,3156521,3,,,,2291
e9f7bf03e3d40b199c6c1964b2be65fef0d4b213,0,Hugo Louro,2016-01-09 09:42:11-08:00,['aff470495f4f971be2e094ec66a8c3c42c15f3e7'],4,6,10,3156531,1,,,,2291
e6e532e1d9bbcf61c7a17a75ea6e484c8e6f1ef7,0,Robert (Bobby) Evans,2016-01-11 09:02:47-06:00,"['e1527d9d1b12265c62c6b8a267dc00104fc6827a', 'f939fc27fbcc8dd1fc1e3b9d8948f1994fc399af']",2,69,71,3156602,3,,,,2291
405b4beaf094b782dec3f7bb324a90e39198cc84,0,Robert (Bobby) Evans,2016-01-11 09:17:48-06:00,['e6e532e1d9bbcf61c7a17a75ea6e484c8e6f1ef7'],0,1,1,3156603,1,,,,2291
4eee03f9a2e28ffcb7667de9b864f4844e67b5a6,0,Robert (Bobby) Evans,2016-01-11 09:20:09-06:00,"['405b4beaf094b782dec3f7bb324a90e39198cc84', 'ab769cba028b5db4eb00540da6254bb67be216d6']",41,142,183,3156786,3,,,,2291
89c0f84ac4de0061db24f9836638ad9985497774,0,Robert (Bobby) Evans,2016-01-11 09:34:18-06:00,['4eee03f9a2e28ffcb7667de9b864f4844e67b5a6'],0,2,2,3156788,2,,,,2291
3caddbc6932bf87bd7cc1b280533c2386c0c0256,0,Robert (Bobby) Evans,2016-01-11 09:36:25-06:00,"['89c0f84ac4de0061db24f9836638ad9985497774', '2199ee89de21899ef7db31d2f4e88aad60a53843']",2,17,19,3156807,4,,,,2291
fff8917530b1101886d913c8902f9d180319dc89,0,Robert (Bobby) Evans,2016-01-11 09:37:28-06:00,['3caddbc6932bf87bd7cc1b280533c2386c0c0256'],0,1,1,3156808,1,,,,2291
07ed2e79a1e86089d1ceb68542eb8ca17bd0c5ff,0,Robert (Bobby) Evans,2016-01-11 09:41:37-06:00,"['fff8917530b1101886d913c8902f9d180319dc89', 'c34266924a0bcb7c17bddc0a602580e892153651']",142,269,411,3157219,7,,,,2291
09cb84435b5c7d98514f3434ddc9e0e14b1c9c43,0,Robert (Bobby) Evans,2016-01-11 09:42:01-06:00,['07ed2e79a1e86089d1ceb68542eb8ca17bd0c5ff'],0,1,1,3157220,1,,,,2291
af260001905f965c22e7df406a9fd2291b40cb29,0,Robert (Bobby) Evans,2016-01-11 09:48:06-06:00,"['09cb84435b5c7d98514f3434ddc9e0e14b1c9c43', 'a0d05f8397be3e26fcc262553a773109756329a4']",1,3,4,3157224,1,,,,2291
5fefb7728a9f43f9755c134b023d3a2f8e5202a6,0,Robert (Bobby) Evans,2016-01-11 09:48:33-06:00,['af260001905f965c22e7df406a9fd2291b40cb29'],0,1,1,3157225,1,,,,2291
b67de2ffd6b7af30ea6e56a83477e6d7e32ac40b,0,Robert (Bobby) Evans,2016-01-11 09:52:17-06:00,"['5fefb7728a9f43f9755c134b023d3a2f8e5202a6', '48216dc11b49a90e20316b4a662e2d2a39206b83']",4,3,7,3157232,3,,,,2291
d8627d990f2463c499354284b4f81a23c0175e14,0,Robert (Bobby) Evans,2016-01-11 09:52:55-06:00,['b67de2ffd6b7af30ea6e56a83477e6d7e32ac40b'],0,1,1,3157233,1,,,,2291
31959d346aa64b2f69389b470ba127d543da31af,0,Robert (Bobby) Evans,2016-01-11 10:39:34-06:00,"['d8627d990f2463c499354284b4f81a23c0175e14', 'd62281629afe02a34aba10633c36be546eb70a74']",1,10,11,3157244,1,,,,2291
b9094189466c96411c07bc3a9a6b3f4427ce381d,0,Robert (Bobby) Evans,2016-01-11 10:39:53-06:00,['31959d346aa64b2f69389b470ba127d543da31af'],0,1,1,3157245,1,,,,2291
17732a36f68ccd0db5df5cd18194c4201abd563c,0,Robert (Bobby) Evans,2016-01-11 10:49:12-06:00,"['b9094189466c96411c07bc3a9a6b3f4427ce381d', '1eca8a3398679dce7675e72d91527ac05335bd54']",1,2,3,3157248,1,,,,2291
24f03e5702fd46dba6a48796e66112362f0ad425,0,Robert (Bobby) Evans,2016-01-11 10:50:08-06:00,['17732a36f68ccd0db5df5cd18194c4201abd563c'],0,1,1,3157249,1,,,,2291
5f78f25824e31066c7288917659173df89c7c277,0,Robert (Bobby) Evans,2016-01-11 10:52:42-06:00,"['24f03e5702fd46dba6a48796e66112362f0ad425', '91343205d36eb1f245883d4dd370b9dba91e6a90']",4,4,8,3157257,1,,,,2291
58af7660104ba094c9ae7d080ab9d6e3fc32eee0,0,Robert (Bobby) Evans,2016-01-11 10:53:10-06:00,['5f78f25824e31066c7288917659173df89c7c277'],0,1,1,3157258,1,,,,2291
ec8739edbccecf125b012f35dbdd90c3e5439103,0,Robert (Bobby) Evans,2016-01-11 11:03:43-06:00,"['58af7660104ba094c9ae7d080ab9d6e3fc32eee0', '6e621269ff5023c84e4efab30b0ab0c3ebe443f9']",2,12,14,3157272,5,,,,2291
f256eec08575e66a98ef86feef53e88adb637e90,0,Robert (Bobby) Evans,2016-01-11 11:04:24-06:00,['ec8739edbccecf125b012f35dbdd90c3e5439103'],0,1,1,3157273,1,,,,2291
73148594e33743b649e628eec9483ba1495866ff,0,Robert (Bobby) Evans,2016-01-11 11:08:21-06:00,"['f256eec08575e66a98ef86feef53e88adb637e90', '37401835f145f6b509b63d3f16c93071473da7ed']",0,21,21,3157294,1,,,,2291
8bb5f82925bf2ec6e69b5a138c3e310c84a751de,0,Robert (Bobby) Evans,2016-01-11 11:08:46-06:00,['73148594e33743b649e628eec9483ba1495866ff'],0,1,1,3157295,1,,,,2291
b119a3e5d76ec300f88214808a682672c355f21f,0,Robert (Bobby) Evans,2016-01-11 11:19:40-06:00,"['8bb5f82925bf2ec6e69b5a138c3e310c84a751de', 'f6c3225d9ed5367c2e0f132f9ea1d20c6a0bf4b4']",11,13,24,3157319,1,,,,2291
a265c3207b92e7398ec842c6e7e91f0f2ac344e4,0,Robert (Bobby) Evans,2016-01-11 11:20:05-06:00,['b119a3e5d76ec300f88214808a682672c355f21f'],0,1,1,3157320,1,,,,2291
6c31c2b08b8e5600c1560dddcbf97c3f052ccd9f,0,Robert (Bobby) Evans,2016-01-11 11:23:21-06:00,"['a265c3207b92e7398ec842c6e7e91f0f2ac344e4', '46fbd2a5159fccaa7608d0cad5d1fecd4bff7a18']",19,19,38,3157358,2,,,,2291
b6c0c40711f419cb35b11b530fc8627b5ae64a22,0,Robert (Bobby) Evans,2016-01-11 11:23:43-06:00,['6c31c2b08b8e5600c1560dddcbf97c3f052ccd9f'],0,1,1,3157359,1,,,,2291
55f11d46f204a277135f19eda57251ea87c22ccc,0,Robert (Bobby) Evans,2016-01-11 12:53:29-06:00,"['b6c0c40711f419cb35b11b530fc8627b5ae64a22', '3193d405d3452d2a3ae68bd83f6043c969b4922e']",7,7,14,3157373,4,,,,2291
08967889e6a47a33c7b36901b94b8e076278cd5f,0,Robert (Bobby) Evans,2016-01-11 12:54:08-06:00,['55f11d46f204a277135f19eda57251ea87c22ccc'],0,1,1,3157374,1,,,,2291
f75ec948b8c99c1f05f3c55edf36a3df84a1ff8b,0,Robert (Bobby) Evans,2016-01-11 12:57:03-06:00,"['08967889e6a47a33c7b36901b94b8e076278cd5f', '6343cfaa7ea2114fb71c26252c76e42f253c7486']",1,1,2,3157376,1,,,,2291
9a5629d5cf124058385183a20835c68cba14d7bc,0,Robert (Bobby) Evans,2016-01-11 13:02:05-06:00,['f75ec948b8c99c1f05f3c55edf36a3df84a1ff8b'],0,1,1,3157377,1,,,,2291
82a270f6a70f728d112b1bd64311a06a007856c3,0,Robert (Bobby) Evans,2016-01-11 13:06:04-06:00,"['9a5629d5cf124058385183a20835c68cba14d7bc', '2de46793572ee55a32f73c3ecb3002f6a8db936d']",18,11,29,3157406,3,,,,2291
8299aec71990653f8a345c232bf451a901300de7,0,Robert (Bobby) Evans,2016-01-11 13:06:23-06:00,['82a270f6a70f728d112b1bd64311a06a007856c3'],0,1,1,3157407,1,,,,2291
b4c02310f8730bc9026512d6f3800774fa387c49,0,Robert (Bobby) Evans,2016-01-11 13:15:53-06:00,['8299aec71990653f8a345c232bf451a901300de7'],7,8,15,3157422,1,1,1,1,2291
c81284d4feefe8526f5b3f93d7fb0f21d39aa520,0,Robert (Bobby) Evans,2016-01-11 13:46:22-06:00,"['b4c02310f8730bc9026512d6f3800774fa387c49', '7cc1d05a6c4db0610baccbc7870544d9ea8258af']",156,377,533,3157955,4,,,,2291
df32755b1f0944439610a5646c91fef4f39fc2da,0,Robert (Bobby) Evans,2016-01-11 13:46:53-06:00,['c81284d4feefe8526f5b3f93d7fb0f21d39aa520'],0,1,1,3157956,1,,,,2291
fa1ec6f7e2efb1b3dc85b67fd7341d5583f2ad1d,0,Robert (Bobby) Evans,2016-01-11 14:19:45-06:00,"['df32755b1f0944439610a5646c91fef4f39fc2da', '0702f54d72e1d18411fc24c9019e3e88b7d35e81']",724,917,1641,3159597,26,,,,2291
989cae6eccbedef127bf5db56961c040f3fee14d,0,Robert (Bobby) Evans,2016-01-11 14:20:22-06:00,['fa1ec6f7e2efb1b3dc85b67fd7341d5583f2ad1d'],0,1,1,3159598,1,,,,2291
7066e48420041f6db9d127dcbd421585b0e5a6ee,0,Robert (Bobby) Evans,2016-01-11 14:32:47-06:00,"['989cae6eccbedef127bf5db56961c040f3fee14d', '793de733580799f74f0bc59308ec7243e6f0dad6']",2,27,29,3159627,2,,,,2291
f61416254e36029d262b71094e9abab3c3f2a659,0,Robert (Bobby) Evans,2016-01-11 14:33:19-06:00,['7066e48420041f6db9d127dcbd421585b0e5a6ee'],0,1,1,3159628,1,,,,2291
a9a7bab592f55280ac4640a7a6cf37c2cda86bc1,0,Robert (Bobby) Evans,2016-01-11 14:39:54-06:00,"['f61416254e36029d262b71094e9abab3c3f2a659', 'a927d414456c3837e2d641cfbfcaaa1c159fcd82']",22,1157,1179,3160807,20,,,,2291
d839d1bf88b855edda344fc548f0701e2a018655,1,Robert (Bobby) Evans,2016-01-11 14:42:34-06:00,['a9a7bab592f55280ac4640a7a6cf37c2cda86bc1'],5577,5577,11154,3171961,1273,,,,2291
b5fd753f362c8c0737c1a205ba0d5faad08d4765,0,Robert (Bobby) Evans,2016-01-11 14:43:28-06:00,['d839d1bf88b855edda344fc548f0701e2a018655'],96,1,97,3172058,3,,,,2291
a4f9f8bc5b4ca85de487a0a868e519ddcb94e852,0,Robert (Bobby) Evans,2016-01-11 14:55:39-06:00,['b5fd753f362c8c0737c1a205ba0d5faad08d4765'],32,33,65,3172123,31,,,,2291
c55a028a7ff120d36289a2fdab6e266913efd394,0,Robert (Bobby) Evans,2016-01-11 15:01:03-06:00,"['a4f9f8bc5b4ca85de487a0a868e519ddcb94e852', 'e9f7bf03e3d40b199c6c1964b2be65fef0d4b213']",5,7,12,3172135,1,,,,2291
8bfceac224abd2cae5f570e04649b49a2d3e8872,1,Robert (Bobby) Evans,2016-01-11 15:03:42-06:00,['c55a028a7ff120d36289a2fdab6e266913efd394'],31,32,63,3172198,31,,,,2291
3db968092077363bd766db516b9e1135273672bf,0,Robert (Bobby) Evans,2016-01-11 15:08:33-06:00,['8bfceac224abd2cae5f570e04649b49a2d3e8872'],488,0,488,3172686,6,0.18128655,0,0,2291
942bdbd04f8cf01cb97f404aaf1a43054f08f88d,0,Robert (Bobby) Evans,2016-01-11 15:09:41-06:00,['c55a028a7ff120d36289a2fdab6e266913efd394'],488,0,488,3173174,6,0.18128655,0,0,2291
64a57a39fe1d4b0a1f3d15a264eb3335d72e1af6,0,ablecao,2016-01-12 09:38:41+08:00,['3db968092077363bd766db516b9e1135273672bf'],4,4,8,3173182,1,,,,2291
4623d8f87f044a9a8737a55bd32f955485900ce1,1,Arun Mahadevan,2016-01-12 10:08:51+05:18,['3db968092077363bd766db516b9e1135273672bf'],4,2685,2689,3175871,30,0.599329422,0.974853311,0.897736798,2315
3b59ec5d7f0eb505522495f2f67bba506246554e,0,Arun Mahadevan,2016-01-12 10:08:59+05:18,['4623d8f87f044a9a8737a55bd32f955485900ce1'],30,24,54,3175925,2,1,0,0,2315
40a1c7e05962de6e767fb3b37db4eb759fdc9b2d,0,Arun Mahadevan,2016-01-12 10:09:00+05:18,['3b59ec5d7f0eb505522495f2f67bba506246554e'],26,44,70,3175995,7,0.833333333,0.833333333,0,2315
d9a0698f079cd77fc7da40559eeffd7f9fc5b9a5,0,Arun Mahadevan,2016-01-12 10:09:00+05:18,['40a1c7e05962de6e767fb3b37db4eb759fdc9b2d'],135,187,322,3176317,9,0,0,0,2315
16d58e31d5e817e987cf9789139f31c344d6c3e9,0,Arun Mahadevan,2016-01-12 10:09:01+05:18,['d9a0698f079cd77fc7da40559eeffd7f9fc5b9a5'],30,189,219,3176536,6,0.547619048,0.857142857,0.825396825,2315
bfc5ffd57d7373a477744663401a1c66c4f93c7a,1,Arun Mahadevan,2016-01-12 11:13:30+05:18,['16d58e31d5e817e987cf9789139f31c344d6c3e9'],135,138,273,3176809,26,,,,2315
a088de72ed78c2707beacd9eade9803341e12c05,1,Arun Mahadevan,2016-01-12 12:23:03+05:18,['bfc5ffd57d7373a477744663401a1c66c4f93c7a'],28,949,977,3177786,20,0.67983368,0.933471933,0.875259875,2320
96372fa7a3c5a87eef9a97acada44ea17deb9306,1,Satish Duggana,2016-01-12 12:40:05+05:18,['3db968092077363bd766db516b9e1135273672bf'],4,11,15,3177801,2,,,,2320
cff8256490601e9da2150eb8d6952d7407357dc0,0,Arun Mahadevan,2016-01-12 14:01:09+05:18,['a088de72ed78c2707beacd9eade9803341e12c05'],53,52,105,3177906,7,,,,2320
4b2f16b84507fd9c1f38d8b0d449fbb355bb12dc,0,P. Taylor Goetz,2016-01-12 12:03:20-05:00,"['e319380e8796d11be834b59788834ca9c2c5ad97', '942bdbd04f8cf01cb97f404aaf1a43054f08f88d']",7177,8704,15881,3193787,1336,,,,2320
88ece9060ba6ac1a23bd21955523ae7083b1fbf8,0,P. Taylor Goetz,2016-01-12 12:41:32-05:00,['4b2f16b84507fd9c1f38d8b0d449fbb355bb12dc'],41,38,79,3193866,12,0,0,0,2320
b5c565aa190c026d8479f3c3da511b2eb07397ba,0,P. Taylor Goetz,2016-01-12 12:41:46-05:00,"['88ece9060ba6ac1a23bd21955523ae7083b1fbf8', '3db968092077363bd766db516b9e1135273672bf']",31,32,63,3193929,31,,,,2320
8cf627d99f229ab8b48ea7b640d4132653cb366d,0,P. Taylor Goetz,2016-01-12 12:46:28-05:00,['b5c565aa190c026d8479f3c3da511b2eb07397ba'],3,3,6,3193935,3,,,,2320
b24d7d93eea1b1a5700aacb4bc83cce8cef7ce6e,0,P. Taylor Goetz,2016-01-12 14:59:20-05:00,['bfc5ffd57d7373a477744663401a1c66c4f93c7a'],0,1,1,3193936,1,,,,2320
ad3de0b350182b5fcda1578f47618b06f8b729d6,0,P. Taylor Goetz,2016-01-12 15:00:02-05:00,"['942bdbd04f8cf01cb97f404aaf1a43054f08f88d', 'b24d7d93eea1b1a5700aacb4bc83cce8cef7ce6e']",37,2946,2983,3196919,61,,,,2320
3a5c101f3b737daf31614b7b5d92239825ee01c5,0,P. Taylor Goetz,2016-01-12 15:01:10-05:00,['ad3de0b350182b5fcda1578f47618b06f8b729d6'],1,0,1,3196920,1,,,,2320
82b68264d9190c5a84038acc1d0f73a7b74b7981,0,P. Taylor Goetz,2016-01-12 15:35:58-05:00,['b24d7d93eea1b1a5700aacb4bc83cce8cef7ce6e'],0,1,1,3196921,1,,,,2320
2289d36847f113e4b18e105e6623190108bca2ae,0,P. Taylor Goetz,2016-01-12 15:38:28-05:00,['82b68264d9190c5a84038acc1d0f73a7b74b7981'],1,0,1,3196922,1,,,,2320
15f446449193dde9dd06f58ac60362f2bb5610f8,0,Kyle Nusbaum,2016-01-12 14:43:45-06:00,['3db968092077363bd766db516b9e1135273672bf'],7,1,8,3196930,3,,,,2321
3b6a57e694dac0f29e69a9fcc2b2f05aef8ea96d,0,Kyle Nusbaum,2016-01-12 15:01:19-06:00,['15f446449193dde9dd06f58ac60362f2bb5610f8'],0,0,0,3196930,1,,,,2321
2c985b271af109c56670e7d9f9513d9b988cd71b,1,Kyle Nusbaum,2016-01-12 15:45:20-06:00,['3b6a57e694dac0f29e69a9fcc2b2f05aef8ea96d'],68,81,149,3197079,2,,,,2321
699a4092bc1d7ca5a2edbfd06bcd0092c1078fae,0,Kyle Nusbaum,2016-01-12 15:53:21-06:00,['2c985b271af109c56670e7d9f9513d9b988cd71b'],1,1,2,3197081,2,,,,2322
3403196056fdb00a7d79a74d11814cd0e3bc1dc1,0,Kyle Nusbaum,2016-01-12 16:19:47-06:00,['699a4092bc1d7ca5a2edbfd06bcd0092c1078fae'],1,1,2,3197083,1,,,,2322
012cfb009d0ca896e202e94e6e7315a92ec47026,0,Kyle Nusbaum,2016-01-12 16:41:54-06:00,['3403196056fdb00a7d79a74d11814cd0e3bc1dc1'],0,0,0,3197083,1,,,,2322
ab11ce97786c2eef523c04684b86b67b7902dca8,0,Kyle Nusbaum,2016-01-12 16:58:17-06:00,['3db968092077363bd766db516b9e1135273672bf'],2,3,5,3197088,2,1,1,1,2322
2f5c31d24ccc2cb220732f8bc85c9218fbeda221,0,P. Taylor Goetz,2016-01-12 20:40:58-05:00,['2289d36847f113e4b18e105e6623190108bca2ae'],28405,0,28405,3225493,227,0.399452055,0.32,0.050410959,2322
bf45b96e496551e9319eae26cde985965afea5cf,1,vesense,2016-01-13 13:39:00+08:00,['f659ef0e8f7f582d685dca3dabebf73c9f97546c'],58,86,144,3225637,4,1,1,1,2323
023cebd062e002577e7a4ed38ef795060040f812,0,vesense,2016-01-13 13:51:08+08:00,"['bf45b96e496551e9319eae26cde985965afea5cf', '2289d36847f113e4b18e105e6623190108bca2ae']",7380,12006,19386,3245023,1366,,,,2323
d1d6dbea95c263086f0e3820e7acd5aed74a07f8,1,vesense,2016-01-13 14:37:04+08:00,['023cebd062e002577e7a4ed38ef795060040f812'],31,40,71,3245094,2,1,1,1,2323
a99c79e01fca147e7a969b8aa04f4a07048716ef,0,Arun Mahadevan,2016-01-13 13:42:07+05:18,"['cff8256490601e9da2150eb8d6952d7407357dc0', '2289d36847f113e4b18e105e6623190108bca2ae']",0,1,1,3245095,1,,,,2323
2c6313b34509424960e9a54e08d0895518c477f0,0,Arun Mahadevan,2016-01-13 13:52:11+05:18,['a99c79e01fca147e7a969b8aa04f4a07048716ef'],2,5,7,3245102,2,,,,2323
574928b92f3bdd9c96c2a74df19e117b36c4ccc8,0,P. Taylor Goetz,2016-01-13 12:20:45-05:00,['d1d6dbea95c263086f0e3820e7acd5aed74a07f8'],0,1,1,3245103,1,,,,2323
b9bf574a11ecdf9957c8c5d526e0528c4e13ea97,0,P. Taylor Goetz,2016-01-13 12:21:20-05:00,"['3a5c101f3b737daf31614b7b5d92239825ee01c5', 'd1d6dbea95c263086f0e3820e7acd5aed74a07f8']",28,87,115,3245218,3,,,,2323
68ac3af18b171028504f20a8329bfd8793d70445,0,P. Taylor Goetz,2016-01-13 12:21:42-05:00,['b9bf574a11ecdf9957c8c5d526e0528c4e13ea97'],0,1,1,3245219,1,,,,2323
a609f7f58dbe71d41bd8ccb8677b66c2db644dc4,0,P. Taylor Goetz,2016-01-13 12:25:50-05:00,"['574928b92f3bdd9c96c2a74df19e117b36c4ccc8', '64a57a39fe1d4b0a1f3d15a264eb3335d72e1af6']",4,4,8,3245227,1,,,,2323
bd04e212427001d2f02c3cb2a0e7ad320521201b,0,P. Taylor Goetz,2016-01-13 12:27:06-05:00,['a609f7f58dbe71d41bd8ccb8677b66c2db644dc4'],0,1,1,3245228,1,,,,2323
e9707235a1ab29c591a0666deedc64baedd5a077,0,P. Taylor Goetz,2016-01-13 12:27:34-05:00,"['68ac3af18b171028504f20a8329bfd8793d70445', '64a57a39fe1d4b0a1f3d15a264eb3335d72e1af6']",4,4,8,3245236,1,,,,2323
0bf55293908d3a67e92b49b19ec07c64db5f16e8,0,P. Taylor Goetz,2016-01-13 12:27:51-05:00,['e9707235a1ab29c591a0666deedc64baedd5a077'],0,1,1,3245237,1,,,,2323
70197332bba46ffd2b38da183e835bd370a68e70,0,Derek Dagit,2016-01-13 11:29:21-06:00,['574928b92f3bdd9c96c2a74df19e117b36c4ccc8'],42,3,45,3245282,1,,,,2323
6fcebe6e2bb207a0798e98df44dd123a12253cd5,0,P. Taylor Goetz,2016-01-13 12:32:02-05:00,['bd04e212427001d2f02c3cb2a0e7ad320521201b'],0,1,1,3245283,1,,,,2323
b48f02e39dcbec62a29da6989c98e004b6b1c940,0,zhuol,2016-01-13 20:52:59-06:00,['6fcebe6e2bb207a0798e98df44dd123a12253cd5'],3,16,19,3245302,4,,,,2323
c9cdcbc76a7b65b03dce09541f2df40a97a6e1fd,1,zhuol,2016-01-14 11:46:49-06:00,['6fcebe6e2bb207a0798e98df44dd123a12253cd5'],6,9,15,3245317,2,,,,2323
60e7a8126aceb85fe194d1cf90818fcda696d60a,1,Roshan Naik,2016-01-14 11:34:55-08:00,['6fcebe6e2bb207a0798e98df44dd123a12253cd5'],0,2457,2457,3247774,16,0.67550702,0.810452418,0.776911076,2339
1ae943a9b85a8edf1e56ecfa98a87046c4698d48,0,Roshan Naik,2016-01-14 11:34:55-08:00,['60e7a8126aceb85fe194d1cf90818fcda696d60a'],2,54,56,3247830,3,,,,2339
f927787505b6cb5b9d8f7adaaf3944f24a6ab481,1,Roshan Naik,2016-01-14 11:34:55-08:00,['1ae943a9b85a8edf1e56ecfa98a87046c4698d48'],10,20,30,3247860,4,0,0,0.4,2339
5793cdd779eb6a13aa78e57c751f26cd3a44c5b6,0,Roshan Naik,2016-01-14 11:34:55-08:00,['f927787505b6cb5b9d8f7adaaf3944f24a6ab481'],3,6,9,3247869,1,0,1,0,2339
2fb0d7d980c4f8c328905249b3ff5ed5e64c1558,1,Roshan Naik,2016-01-14 11:34:55-08:00,['5793cdd779eb6a13aa78e57c751f26cd3a44c5b6'],24,69,93,3247962,3,0,0.15625,1,2339
dcc930b9ff663f7539dd00e49a68e1bcdcf308d4,1,Roshan Naik,2016-01-14 11:34:55-08:00,['2fb0d7d980c4f8c328905249b3ff5ed5e64c1558'],37,192,229,3248191,5,0.391304348,1,0.811594203,2340
de37de68f3a97c6e0d4d6aa38f972fd8d1ecb032,1,Roshan Naik,2016-01-14 11:34:56-08:00,['dcc930b9ff663f7539dd00e49a68e1bcdcf308d4'],34,314,348,3248539,6,0.14354067,0.775119617,0.832535885,2340
152856d1156065f51430497629ee37412ac098b2,1,Roshan Naik,2016-01-14 11:34:56-08:00,['de37de68f3a97c6e0d4d6aa38f972fd8d1ecb032'],95,473,568,3249107,11,0.653658537,0.980487805,0.897560976,2342
1e52f0837aed03cc47b86b1e02037b6136c8c8b0,1,Roshan Naik,2016-01-14 11:34:56-08:00,['152856d1156065f51430497629ee37412ac098b2'],103,176,279,3249386,7,0.69047619,1,1,2342
721c9b3d1a7a47cda19ca4867a584626c84823f4,1,Roshan Naik,2016-01-14 11:34:56-08:00,['1e52f0837aed03cc47b86b1e02037b6136c8c8b0'],56,144,200,3249586,9,0,0.546875,0.875,2342
e50b639add0cba65dc02b91553af6a9a4e4e5295,1,Roshan Naik,2016-01-14 11:34:56-08:00,['721c9b3d1a7a47cda19ca4867a584626c84823f4'],14,85,99,3249685,4,0,0.980392157,0.882352941,2342
a6fed4c6f8fc973651d1e8e36de78e0a2f8b7c0d,1,Roshan Naik,2016-01-14 11:34:56-08:00,['e50b639add0cba65dc02b91553af6a9a4e4e5295'],138,282,420,3250105,11,0,0.857142857,1,2343
ac1322fbe7bf8bc3dfb614118312cee37c75b44e,1,Roshan Naik,2016-01-14 11:34:56-08:00,['a6fed4c6f8fc973651d1e8e36de78e0a2f8b7c0d'],101,198,299,3250404,8,0,0.764705882,0.529411765,2343
b5240a73bcd56a6883cb46766943e9d76edffc75,1,Roshan Naik,2016-01-14 11:34:56-08:00,['ac1322fbe7bf8bc3dfb614118312cee37c75b44e'],273,330,603,3251007,13,0,0.728813559,0.745762712,2343
0b07f8b3a8a458f39cc9f64be1e5623b0a6815d2,1,Roshan Naik,2016-01-14 11:34:56-08:00,['b5240a73bcd56a6883cb46766943e9d76edffc75'],20,41,61,3251068,3,1,1,1,2343
2c02bc91d8a9b81b55a4e023c927a73068bcc927,1,Roshan Naik,2016-01-14 11:34:57-08:00,['0b07f8b3a8a458f39cc9f64be1e5623b0a6815d2'],15,30,45,3251113,1,0.461538462,0.461538462,0.615384615,2343
d17b3b9c3cbc89d854bfb436d213d11cfd4545ec,1,Roshan Naik,2016-01-14 11:34:57-08:00,['2c02bc91d8a9b81b55a4e023c927a73068bcc927'],39,48,87,3251200,6,0,0,0.125,2343
829ea117c8b382ef72d3c5df841534b89f06dffa,0,Boyang Jerry Peng,2016-01-14 14:24:42-06:00,['2289d36847f113e4b18e105e6623190108bca2ae'],236,390,626,3251826,10,1,0,1,2344
688366902d98a7fdc17d854a33ff975c6a60ccab,0,Boyang Jerry Peng,2016-01-14 14:25:07-06:00,['829ea117c8b382ef72d3c5df841534b89f06dffa'],167,388,555,3252381,10,0.037735849,1,1,2344
91cbb38bfb9a17e4a38fc70aff96f5703b7bd1b7,0,Parth Brahmbhatt,2016-01-14 12:41:23-08:00,"['6fcebe6e2bb207a0798e98df44dd123a12253cd5', 'd17b3b9c3cbc89d854bfb436d213d11cfd4545ec']",10,3965,3975,3256356,23,,,,2344
bc9e7350526beb2d478b7b2f3201dcf86a5ed842,0,Parth Brahmbhatt,2016-01-14 12:45:07-08:00,['91cbb38bfb9a17e4a38fc70aff96f5703b7bd1b7'],0,2,2,3256358,2,,,,2344
4722c6f5d467c147996a027d00baf867cf6bc54d,0,Boyang Jerry Peng,2016-01-14 14:53:02-06:00,['688366902d98a7fdc17d854a33ff975c6a60ccab'],79,0,79,3256437,1,1,0.122807018,0,2344
052941084bc7fcaee3d433d39d2bcc7a9953c69a,0,Boyang Jerry Peng,2016-01-14 23:33:28-06:00,['4722c6f5d467c147996a027d00baf867cf6bc54d'],41,29,70,3256507,5,0.916666667,1,0,2344
10b0d5842a12dbb772fb97fd26271d395396aa31,1,Satish Duggana,2016-01-15 13:10:04+05:18,['bc9e7350526beb2d478b7b2f3201dcf86a5ed842'],9,44,53,3256560,2,,,,2344
a5eddd59c44739fbbc104fd5ebaf4f7d98179ead,0,P. Taylor Goetz,2016-01-15 11:10:05-05:00,"['bc9e7350526beb2d478b7b2f3201dcf86a5ed842', '2f5c31d24ccc2cb220732f8bc85c9218fbeda221']",28405,0,28405,3284965,227,,,,2344
be8f3eea55591e2fe0ac48e78f964f723c68c2ec,0,P. Taylor Goetz,2016-01-15 11:11:56-05:00,['a5eddd59c44739fbbc104fd5ebaf4f7d98179ead'],0,1,1,3284966,1,,,,2344
2ac3f040733d033ad9a9108e885e04027f4eda48,0,P. Taylor Goetz,2016-01-15 11:42:04-05:00,"['0bf55293908d3a67e92b49b19ec07c64db5f16e8', 'd17b3b9c3cbc89d854bfb436d213d11cfd4545ec']",10,3966,3976,3288942,24,,,,2344
8b1b0c827c87c63625883e4c506b375aedf85ee1,0,P. Taylor Goetz,2016-01-15 11:43:47-05:00,['2ac3f040733d033ad9a9108e885e04027f4eda48'],0,2,2,3288944,1,,,,2344
4e7b844f6bb26e5c2d4fd6a00247ac21436c56ac,0,P. Taylor Goetz,2016-01-15 11:46:56-05:00,"['8b1b0c827c87c63625883e4c506b375aedf85ee1', '012cfb009d0ca896e202e94e6e7315a92ec47026']",74,81,155,3289099,2,,,,2344
e8f71c249639272e12a64b43ac5d78225c8227b2,0,P. Taylor Goetz,2016-01-15 11:48:00-05:00,['4e7b844f6bb26e5c2d4fd6a00247ac21436c56ac'],0,1,1,3289100,1,,,,2344
b21b686fd7ebf091ca8f687ac139d8212226eda3,0,P. Taylor Goetz,2016-01-15 11:48:33-05:00,"['be8f3eea55591e2fe0ac48e78f964f723c68c2ec', '012cfb009d0ca896e202e94e6e7315a92ec47026']",74,81,155,3289255,2,,,,2344
45726bbd18271a3a0548dfd36c89a804d350a317,0,P. Taylor Goetz,2016-01-15 11:48:40-05:00,['b21b686fd7ebf091ca8f687ac139d8212226eda3'],0,1,1,3289256,1,,,,2344
ba8a01c6cdde1c8d383cf310399e28d2e5e9c8a3,0,P. Taylor Goetz,2016-01-15 11:57:16-05:00,"['45726bbd18271a3a0548dfd36c89a804d350a317', '70197332bba46ffd2b38da183e835bd370a68e70']",42,3,45,3289301,1,,,,2344
396f6531a2ff8d7db59faf6cbb23182509d3147c,0,P. Taylor Goetz,2016-01-15 11:58:27-05:00,['ba8a01c6cdde1c8d383cf310399e28d2e5e9c8a3'],0,1,1,3289302,1,,,,2344
84339a19c09d9754637b650a87ab9815d6362193,0,P. Taylor Goetz,2016-01-15 11:58:40-05:00,"['e8f71c249639272e12a64b43ac5d78225c8227b2', '70197332bba46ffd2b38da183e835bd370a68e70']",42,3,45,3289347,1,,,,2344
b64b69f76525bde77f177880ba7d3845d9068ff5,0,P. Taylor Goetz,2016-01-15 12:00:04-05:00,['84339a19c09d9754637b650a87ab9815d6362193'],0,1,1,3289348,1,,,,2344
1c45fdf482d4a8eeb1e11502a7641f19f246e2e3,0,P. Taylor Goetz,2016-01-15 12:07:02-05:00,"['396f6531a2ff8d7db59faf6cbb23182509d3147c', 'ab11ce97786c2eef523c04684b86b67b7902dca8']",2,3,5,3289353,2,,,,2344
90e4f3e8a725010c24a3d98af8d4b4a9a1f4e9ea,0,P. Taylor Goetz,2016-01-15 12:08:04-05:00,['1c45fdf482d4a8eeb1e11502a7641f19f246e2e3'],0,1,1,3289354,1,,,,2344
f3ca588e0b76c0006b0d14fffd2d55a48b3ccf24,0,P. Taylor Goetz,2016-01-15 12:08:33-05:00,"['b64b69f76525bde77f177880ba7d3845d9068ff5', 'ab11ce97786c2eef523c04684b86b67b7902dca8']",2,3,5,3289359,2,,,,2344
67a5ceccab08d1b4d4b849f1631b33480e52deb0,0,P. Taylor Goetz,2016-01-15 12:08:39-05:00,['f3ca588e0b76c0006b0d14fffd2d55a48b3ccf24'],0,1,1,3289360,1,,,,2344
40df09547e4e8bf6c80cea4f1250fa27243646b8,1,vesense,2016-01-16 13:50:56+08:00,['90e4f3e8a725010c24a3d98af8d4b4a9a1f4e9ea'],18,3,21,3289381,2,0,0,0,2344
f7d59601ae54128ab9effa1baa8933d81b7e317b,0,Xin Wang,2016-01-16 14:06:45+08:00,['90e4f3e8a725010c24a3d98af8d4b4a9a1f4e9ea'],4,6,10,3289391,1,1,1,1,2344
181b3b09a973acf99719ad60fe03f4d23c869324,0,vesense,2016-01-16 19:50:30+08:00,['90e4f3e8a725010c24a3d98af8d4b4a9a1f4e9ea'],3,18,21,3289412,2,1,1,1,2344
1c87f4aaa5352ec4f68f7dd8dbe0d762c5b2c9d6,0,Xin Wang,2016-01-16 21:03:47+08:00,['90e4f3e8a725010c24a3d98af8d4b4a9a1f4e9ea'],0,1,1,3289413,1,0,0,1,2344
527ad0e16b08e8dfb465abc78da2c65cd79e5c76,0,Xin Wang,2016-01-17 17:41:46+08:00,['90e4f3e8a725010c24a3d98af8d4b4a9a1f4e9ea'],2,2,4,3289417,1,,,,2344
8c591727d3c8eb4384da8c2ea7f26bc7b0c5a02d,0,Jungtaek Lim,2016-01-18 09:54:05+09:00,"['90e4f3e8a725010c24a3d98af8d4b4a9a1f4e9ea', '1c87f4aaa5352ec4f68f7dd8dbe0d762c5b2c9d6']",0,1,1,3289418,1,,,,2344
3a7cfc8e7374bccd98cb963b73ecc3776d1aad49,0,Jungtaek Lim,2016-01-18 09:55:46+09:00,['8c591727d3c8eb4384da8c2ea7f26bc7b0c5a02d'],0,1,1,3289419,1,,,,2344
a6e1bced27b5c02e0b90cd6a91bac9e4e77c4e4f,1,vesense,2016-01-19 10:40:34+08:00,['40df09547e4e8bf6c80cea4f1250fa27243646b8'],4,4,8,3289427,4,,,,2344
a263787d08056afafa0ae777cdab9644bb1e29a4,0,Arun Mahadevan,2016-01-19 16:14:14+05:18,"['3a7cfc8e7374bccd98cb963b73ecc3776d1aad49', 'a6e1bced27b5c02e0b90cd6a91bac9e4e77c4e4f']",20,5,25,3289452,4,,,,2344
c9d687e7f52715d32d51e959293c2480c9a3ab1a,0,Arun Mahadevan,2016-01-19 16:16:20+05:18,['a263787d08056afafa0ae777cdab9644bb1e29a4'],0,1,1,3289453,1,,,,2344
596dc3ecafccd4b9e6ec523ef81832f007d1dee6,0,Arun Mahadevan,2016-01-19 18:25:46+05:18,['2c6313b34509424960e9a54e08d0895518c477f0'],1,15,16,3289469,1,1,1,1,2344
6e15162561805d678c30fd7dc0d80f9545669b33,0,Boyang Jerry Peng,2016-01-19 10:00:27-06:00,"['c9d687e7f52715d32d51e959293c2480c9a3ab1a', '052941084bc7fcaee3d433d39d2bcc7a9953c69a']",374,658,1032,3290501,14,,,,2344
c1e8ec576a391c9431ec50eb8eb60c083417b4c7,1,Abhishek Agarwal,2016-01-19 21:31:22+05:18,['c9d687e7f52715d32d51e959293c2480c9a3ab1a'],32,54,86,3290587,2,0.5,0.5,1,2344
1325b8d85e95dc81a826d53e7da3094747e2586b,1,Kishor Patil,2016-01-19 17:13:38+00:00,['c9d687e7f52715d32d51e959293c2480c9a3ab1a'],0,403,403,3290990,1,0.322834646,0.405511811,1,2345
d3657e27ca82c02c46dd1e89dd6cd80d786711e8,0,Kishor Patil,2016-01-19 17:39:52+00:00,['1325b8d85e95dc81a826d53e7da3094747e2586b'],57,63,120,3291110,4,1,0.5,1,2345
c9916d37357c5bdc2795249a7ad8aee3d05e46d4,0,Kishor Patil,2016-01-19 17:58:43+00:00,['d3657e27ca82c02c46dd1e89dd6cd80d786711e8'],3,13,16,3291126,3,0.857142857,1,0.142857143,2345
49c4ef6d274fc7ca17b623edf1ea53001c8eeaa2,0,Kishor Patil,2016-01-19 18:34:14+00:00,['c9916d37357c5bdc2795249a7ad8aee3d05e46d4'],23,28,51,3291177,1,1,1,1,2345
e7e9eb9492ecd7ff909037561a6e7649f2aa7dc7,0,Boyang Jerry Peng,2016-01-19 15:14:35-06:00,['6e15162561805d678c30fd7dc0d80f9545669b33'],0,1,1,3291178,1,,,,2345
e29856f0e0dc5762b60bf3ad0cf3251606ead54d,1,Kishor Patil,2016-01-19 23:10:53+00:00,['49c4ef6d274fc7ca17b623edf1ea53001c8eeaa2'],11,11,22,3291200,4,,,,2345
93e0d028a588a1c45f8966f7e2fde82f207616eb,0,P. Taylor Goetz,2016-01-19 20:06:26-05:00,['67a5ceccab08d1b4d4b849f1631b33480e52deb0'],28405,0,28405,3319605,227,0.399452055,0.32,0.050410959,2345
b5181c2aba7908bd7b8f994fa238977de812a68b,0,P. Taylor Goetz,2016-01-19 21:52:43-05:00,['e7e9eb9492ecd7ff909037561a6e7649f2aa7dc7'],15,366,381,3319986,11,1,1,1,2345
ad75f190e0383932a5f4d95368cdcbc728190ed9,0,P. Taylor Goetz,2016-01-19 22:31:59-05:00,['b5181c2aba7908bd7b8f994fa238977de812a68b'],22,8,30,3320016,1,0,0,0,2345
6ce984128fd92e42ae7018d6b27be753e7dfa30d,1,zhuol,2016-01-20 09:55:24-06:00,['e7e9eb9492ecd7ff909037561a6e7649f2aa7dc7'],0,487,487,3320503,1,0.798833819,1,0.927113703,2346
0b90a63d5ac7075524e9fabc7a49bda47b41b946,1,zhuol,2016-01-20 09:55:24-06:00,['6ce984128fd92e42ae7018d6b27be753e7dfa30d'],30,54,84,3320587,7,1,1,1,2346
cb4cdf6910b9bc8bc9077d5ad0750707d14e5cb2,0,zhuol,2016-01-20 09:55:24-06:00,['0b90a63d5ac7075524e9fabc7a49bda47b41b946'],12,14,26,3320613,2,,,,2346
f350f1ae9aaa44ea8f931c5e48eef5051d79770d,1,zhuol,2016-01-20 09:55:24-06:00,['cb4cdf6910b9bc8bc9077d5ad0750707d14e5cb2'],71,79,150,3320763,21,,,,2346
3d2796d2fbd7ae182d7414db985cf7de167fcd82,1,zhuol,2016-01-20 09:55:24-06:00,['f350f1ae9aaa44ea8f931c5e48eef5051d79770d'],37,41,78,3320841,4,,,,2346
635488db5e0670f1e4348fab5e3fd7d3970c5e63,0,zhuol,2016-01-20 09:55:24-06:00,['3d2796d2fbd7ae182d7414db985cf7de167fcd82'],55,135,190,3321031,6,0.6,1,1,2346
99189a6016d24aff485b9206323ad68988d32be1,1,zhuol,2016-01-20 09:55:24-06:00,['635488db5e0670f1e4348fab5e3fd7d3970c5e63'],16,14,30,3321061,4,,,,2346
310128d9469f2151851d4e44710593b6ebcbac59,0,zhuol,2016-01-20 09:55:24-06:00,['99189a6016d24aff485b9206323ad68988d32be1'],15,60,75,3321136,6,1,1,1,2346
ba70bf1cfe72aeabec104d8ea664f087b719a08c,0,zhuol,2016-01-20 09:55:24-06:00,['310128d9469f2151851d4e44710593b6ebcbac59'],46,72,118,3321254,4,1,1,1,2346
0dbdcf39bf411a4ee5abac5e740c07e8813ea025,0,zhuol,2016-01-20 09:55:24-06:00,['ba70bf1cfe72aeabec104d8ea664f087b719a08c'],49,89,138,3321392,8,0.764705882,1,0.764705882,2346
7c3fec6502ab23855a0b31dbb93debe7e22e73ff,0,zhuol,2016-01-20 09:55:24-06:00,['0dbdcf39bf411a4ee5abac5e740c07e8813ea025'],20,50,70,3321462,5,1,1,0.8125,2346
13ab1515c503ad3eefe10871b5972d4bce60fde6,0,zhuol,2016-01-20 09:55:24-06:00,['7c3fec6502ab23855a0b31dbb93debe7e22e73ff'],15,21,36,3321498,1,0,0,1,2346
fd37de911ad73cf1a6f0d5500d0c1532a7ece209,0,zhuol,2016-01-20 09:55:25-06:00,['13ab1515c503ad3eefe10871b5972d4bce60fde6'],35,100,135,3321633,7,1,1,1,2346
b4847b76f0222344a51987fce1c8180616a4c279,0,zhuol,2016-01-20 09:55:25-06:00,['fd37de911ad73cf1a6f0d5500d0c1532a7ece209'],9,9,18,3321651,4,,,,2346
b7374d2bb4cf49111936ec1cbd2a4f4f22661100,0,zhuol,2016-01-20 09:55:25-06:00,['b4847b76f0222344a51987fce1c8180616a4c279'],73,11,84,3321735,4,1,0,0.111111111,2346
0d469c057405726c607af07dd9a3daac986fea22,0,zhuol,2016-01-20 10:21:02-06:00,['b48f02e39dcbec62a29da6989c98e004b6b1c940'],3,1,4,3321739,1,,,,2346
2d68387c42634cc5badb770a7369fa7dd96f98d9,0,Robert (Bobby) Evans,2016-01-20 10:48:19-06:00,"['e7e9eb9492ecd7ff909037561a6e7649f2aa7dc7', '0d469c057405726c607af07dd9a3daac986fea22']",2,13,15,3321754,3,,,,2346
56532a014ab6530cc09ac031def87e68ddab6fed,0,Robert (Bobby) Evans,2016-01-20 10:59:01-06:00,['2d68387c42634cc5badb770a7369fa7dd96f98d9'],0,2,2,3321756,1,,,,2346
8ff614f09d0d71c7a64925fde0d8ef771ea8081a,1,Robert (Bobby) Evans,2016-01-20 11:00:22-06:00,['93e0d028a588a1c45f8966f7e2fde82f207616eb'],2,13,15,3321771,3,,,,2346
9a7f362c7d0b76986e4590d5ec1dccb8f148e27f,0,Robert (Bobby) Evans,2016-01-20 11:01:33-06:00,['8ff614f09d0d71c7a64925fde0d8ef771ea8081a'],0,1,1,3321772,1,,,,2346
0411ddd07808ea735358717eb37dd4d74cd5cc1c,0,P. Taylor Goetz,2016-01-20 12:25:35-05:00,['ad75f190e0383932a5f4d95368cdcbc728190ed9'],18,19,37,3321809,8,,,,2346
3d7688ff42677c469e69400ae07bc51c26e39deb,0,Robert (Bobby) Evans,2016-01-20 11:26:48-06:00,"['56532a014ab6530cc09ac031def87e68ddab6fed', '527ad0e16b08e8dfb465abc78da2c65cd79e5c76']",2,2,4,3321813,1,,,,2346
09574884c57966936993f612776341a8d72376dd,0,Robert (Bobby) Evans,2016-01-20 11:28:07-06:00,['3d7688ff42677c469e69400ae07bc51c26e39deb'],0,1,1,3321814,1,,,,2346
7241dc99fb9fe1ed759be305a0772e2d2be7f5f7,0,P. Taylor Goetz,2016-01-20 12:34:38-05:00,['0411ddd07808ea735358717eb37dd4d74cd5cc1c'],3,4,7,3321821,2,,,,2346
464da009f4c5a49853147ffb188f9eea2669b3ba,0,mjsax,2016-01-20 18:37:25+01:00,['09574884c57966936993f612776341a8d72376dd'],1,3,4,3321825,2,,,,2346
2e8dcf34f51aad35e2d28a2c3a0c22cb49fc6927,0,Robert (Bobby) Evans,2016-01-20 13:35:26-06:00,"['09574884c57966936993f612776341a8d72376dd', 'c9cdcbc76a7b65b03dce09541f2df40a97a6e1fd']",6,9,15,3321840,2,,,,2346
e38d1d7829cb290cf0dd22d3193db0f52974506a,0,Robert (Bobby) Evans,2016-01-20 13:36:06-06:00,['2e8dcf34f51aad35e2d28a2c3a0c22cb49fc6927'],0,1,1,3321841,1,,,,2346
468faba2c8184f288c20f212163e3c8d140797bd,0,Robert (Bobby) Evans,2016-01-20 13:46:09-06:00,['9a7f362c7d0b76986e4590d5ec1dccb8f148e27f'],6,9,15,3321856,2,,,,2346
e29b1468264de65ae0b2e06f7d3e500ec742e262,0,Robert (Bobby) Evans,2016-01-20 13:46:21-06:00,['468faba2c8184f288c20f212163e3c8d140797bd'],0,1,1,3321857,1,,,,2346
daff0e394c11d31c175f9f03195a8156e0d18150,0,Robert (Bobby) Evans,2016-01-20 13:57:55-06:00,"['e38d1d7829cb290cf0dd22d3193db0f52974506a', '181b3b09a973acf99719ad60fe03f4d23c869324']",3,18,21,3321878,2,,,,2346
4fb83d926c9cfcdf0abad667cfd7390b1f56f654,0,Robert (Bobby) Evans,2016-01-20 13:59:18-06:00,['e29b1468264de65ae0b2e06f7d3e500ec742e262'],3,18,21,3321899,2,1,1,1,2346
686ffd69763af695b8391a417e87c1de23adf169,0,Robert (Bobby) Evans,2016-01-20 14:01:56-06:00,['daff0e394c11d31c175f9f03195a8156e0d18150'],0,1,1,3321900,1,,,,2346
6912aaba00715c43c87cc094fa7a0c9f64a89e93,0,Robert (Bobby) Evans,2016-01-20 14:02:26-06:00,['4fb83d926c9cfcdf0abad667cfd7390b1f56f654'],0,1,1,3321901,1,,,,2346
9eea60ff567074da4caa29fafb5254d21992d9ea,0,Kishor Patil,2016-01-20 20:49:34+00:00,['e29856f0e0dc5762b60bf3ad0cf3251606ead54d'],2,2,4,3321905,1,,,,2346
97685877dfef008fd4671ee6f4be676c5698585c,0,P. Taylor Goetz,2016-01-20 15:59:11-05:00,['8cf627d99f229ab8b48ea7b640d4132653cb366d'],0,22,22,3321927,1,,,,2346
67d9181d2a9c825f33a2cf7095cda003fd5b84bc,0,Derek Dagit,2016-01-20 15:19:35-06:00,['6912aaba00715c43c87cc094fa7a0c9f64a89e93'],59,76,135,3322062,6,,,,2346
9b5a1bf055a237cfa339c9ab0a7a8af56d6efb32,0,Derek Dagit,2016-01-20 15:19:35-06:00,['67d9181d2a9c825f33a2cf7095cda003fd5b84bc'],2,8,10,3322072,2,,,,2346
4cf77c5876d2ca3103f7fcc9ec092962527b780a,0,P. Taylor Goetz,2016-01-20 17:07:29-05:00,"['686ffd69763af695b8391a417e87c1de23adf169', '97685877dfef008fd4671ee6f4be676c5698585c']",0,2612,2612,3324684,28,,,,2346
c90021f516a38f3b688b37d3291e074bceee0d64,0,P. Taylor Goetz,2016-01-20 17:07:55-05:00,['4cf77c5876d2ca3103f7fcc9ec092962527b780a'],0,1,1,3324685,1,,,,2346
93a66b8f456d64074d46d014b6e65d42dcb6d311,0,P. Taylor Goetz,2016-01-20 17:13:42-05:00,"['c90021f516a38f3b688b37d3291e074bceee0d64', '9b5a1bf055a237cfa339c9ab0a7a8af56d6efb32']",60,83,143,3324828,7,,,,2346
14fbc4859752ae95791d8d5c6d65b9c620d80dab,0,P. Taylor Goetz,2016-01-20 17:14:47-05:00,['93a66b8f456d64074d46d014b6e65d42dcb6d311'],0,1,1,3324829,1,,,,2346
9ea154c3412ab74a0c9159040079310d5c5b4038,0,Jungtaek Lim,2016-01-21 07:26:09+09:00,['14fbc4859752ae95791d8d5c6d65b9c620d80dab'],2,2,4,3324833,1,,,,2346
b9e640afd181e48a3ae2fe726318ce94d8836e59,0,zhuol,2016-01-20 16:37:22-06:00,['b7374d2bb4cf49111936ec1cbd2a4f4f22661100'],344,13,357,3325190,3,0,0,0,2346
b1773a11b7bf8b3589757f959430ed2553a24e2a,0,Jungtaek Lim,2016-01-21 07:44:32+09:00,['9ea154c3412ab74a0c9159040079310d5c5b4038'],3,7,10,3325200,1,,,,2346
24807720244147b626d2b2fa7e5eb2d5bf9c8e21,0,zhuol,2016-01-20 16:52:09-06:00,['b9e640afd181e48a3ae2fe726318ce94d8836e59'],8,14,22,3325222,1,1,1,1,2346
c495266022e47800b74ac8cb0ea73b1d0434669e,0,zhuol,2016-01-20 17:18:11-06:00,['24807720244147b626d2b2fa7e5eb2d5bf9c8e21'],12,12,24,3325246,5,,,,2346
df51368d6d24af12fbde351e77be330736514f24,0,zhuol,2016-01-20 17:38:37-06:00,['c495266022e47800b74ac8cb0ea73b1d0434669e'],7,3,10,3325256,2,,,,2346
1b43c3bdaac84261a80520583af0443bf185eac6,0,Jungtaek Lim,2016-01-21 09:52:53+09:00,['b1773a11b7bf8b3589757f959430ed2553a24e2a'],4,2,6,3325262,1,,,,2346
0e40dbd0b1ce88d879636150f7a7a19effd2ec0a,0,zhuol,2016-01-21 13:21:38-06:00,['df51368d6d24af12fbde351e77be330736514f24'],2,5,7,3325269,5,,,,2346
d052d5a52d4bee707308410216405cdbb93ab158,0,Jungtaek Lim,2016-01-22 10:16:44+09:00,['1b43c3bdaac84261a80520583af0443bf185eac6'],1,1,2,3325271,1,,,,2346
32258ebe1fb98908a985757702ddd41a5d3d0abc,0,Arun Mahadevan,2016-01-22 15:23:18+05:18,['d052d5a52d4bee707308410216405cdbb93ab158'],5,12,17,3325288,1,,,,2346
c467034ffce294abf82258838afcb81a462a92a0,0,Robert (Bobby) Evans,2016-01-22 15:47:49-06:00,"['d052d5a52d4bee707308410216405cdbb93ab158', '7241dc99fb9fe1ed759be305a0772e2d2be7f5f7']",17,356,373,3325661,11,,,,2346
f8168cdecb8f16b888c0bca97d6543944464f8c7,0,Robert (Bobby) Evans,2016-01-22 15:48:17-06:00,['c467034ffce294abf82258838afcb81a462a92a0'],0,1,1,3325662,1,,,,2346
9e092aaa6f387364c9c8a8b114a2b63b63714921,0,zhuol,2016-01-22 15:54:54-06:00,['0e40dbd0b1ce88d879636150f7a7a19effd2ec0a'],238,157,395,3326057,6,0,0,0.063829787,2347
6d850a81f062a4aba8e52e57217bc8045f385f35,0,Robert (Bobby) Evans,2016-01-22 16:06:16-06:00,"['f8168cdecb8f16b888c0bca97d6543944464f8c7', '32258ebe1fb98908a985757702ddd41a5d3d0abc']",5,12,17,3326074,1,,,,2347
34a2898580c803d50b5e681123d342f8c957fc1f,0,Robert (Bobby) Evans,2016-01-22 16:06:47-06:00,['6d850a81f062a4aba8e52e57217bc8045f385f35'],0,1,1,3326075,1,,,,2347
6babd0e41e04e55913ba8aed26755a07e13739bf,0,zhuol,2016-01-22 16:07:08-06:00,['9e092aaa6f387364c9c8a8b114a2b63b63714921'],26,13,39,3326114,1,0.307692308,0,0,2347
49e995865d3ba3e1a9517090f4b07feada48851a,0,Robert (Bobby) Evans,2016-01-22 16:13:13-06:00,"['34a2898580c803d50b5e681123d342f8c957fc1f', '9eea60ff567074da4caa29fafb5254d21992d9ea']",29,453,482,3326596,8,,,,2347
b37e7629e095b9887dbfd8478931a42c980408a1,0,Robert (Bobby) Evans,2016-01-22 16:16:10-06:00,['49e995865d3ba3e1a9517090f4b07feada48851a'],0,1,1,3326597,1,,,,2347
c64e7c85cf5e94d36a1dbc21037de5e465b4ef44,0,Robert (Bobby) Evans,2016-01-22 16:45:35-06:00,"['b37e7629e095b9887dbfd8478931a42c980408a1', '96372fa7a3c5a87eef9a97acada44ea17deb9306']",4,11,15,3326612,2,,,,2347
1a9b7b1da099df3f8d8004c6d26d4fcdc89c0d7c,0,Robert (Bobby) Evans,2016-01-22 16:47:44-06:00,['c64e7c85cf5e94d36a1dbc21037de5e465b4ef44'],0,1,1,3326613,1,,,,2347
ab76a9cfc6882e5823bc260db9fe7f650e948cb4,0,vesense,2016-01-23 19:02:09+08:00,['d052d5a52d4bee707308410216405cdbb93ab158'],76,76,152,3326765,1,,,,2347
19275b88e08928e855b18d17328ec4f9fe3ccfe3,0,Jungtaek Lim,2016-01-25 07:31:38+09:00,"['1a9b7b1da099df3f8d8004c6d26d4fcdc89c0d7c', 'ab76a9cfc6882e5823bc260db9fe7f650e948cb4']",76,76,152,3326917,1,,,,2347
60aa4919e5042311ae62441d89630c0731174177,0,Jungtaek Lim,2016-01-25 07:39:21+09:00,['19275b88e08928e855b18d17328ec4f9fe3ccfe3'],0,1,1,3326918,1,,,,2347
36f03ed7e6031ee3a212ba38f051615ea3c6584d,0,Jungtaek Lim,2016-01-25 08:25:35+09:00,['60aa4919e5042311ae62441d89630c0731174177'],2,2,4,3326922,1,,,,2347
e72f35fe001b82bae6ad94402ce0700002cb7961,0,Xin Wang,2016-01-25 11:35:47+08:00,['36f03ed7e6031ee3a212ba38f051615ea3c6584d'],1,1,2,3326924,1,,,,2347
bddd0db945baf4752c7cae9cf707fcd1616db38d,0,Sanket,2016-01-25 10:37:19-06:00,['36f03ed7e6031ee3a212ba38f051615ea3c6584d'],1,1,2,3326926,1,,,,2347
448e09c7128a5429bc2a51ef016c66c2776afb06,0,Jungtaek Lim,2016-01-26 08:10:45+09:00,"['36f03ed7e6031ee3a212ba38f051615ea3c6584d', 'bddd0db945baf4752c7cae9cf707fcd1616db38d']",1,1,2,3326928,1,,,,2347
ecce1ceb06e40e15d838e583e708bb7e077389de,0,Jungtaek Lim,2016-01-26 08:11:12+09:00,['448e09c7128a5429bc2a51ef016c66c2776afb06'],0,1,1,3326929,1,,,,2347
70f74971561d3a7e152ed558f7b4b1bca0c96185,1,xiaojian.fxj,2016-01-26 17:02:07+08:00,['ecce1ceb06e40e15d838e583e708bb7e077389de'],278,782,1060,3327989,17,0.718662953,0.935933148,0.487465181,2355
39e11c05fde872a5bb7e0ac3ddfe5fd55b0d8fd3,0,xiaojian.fxj,2016-01-26 17:04:36+08:00,['70f74971561d3a7e152ed558f7b4b1bca0c96185'],1,1,2,3327991,1,,,,2355
d66ae23ec4e0aa49a285025acac9406c500e2c62,0,xiaojian.fxj,2016-01-26 17:12:47+08:00,['39e11c05fde872a5bb7e0ac3ddfe5fd55b0d8fd3'],3,4,7,3327998,2,,,,2355
0556bdbef06bde716726b3d98b4ab37c868bfc93,0,abhishekagarwal87,2016-01-26 22:40:27+05:18,"['c1e8ec576a391c9431ec50eb8eb60c083417b4c7', 'ecce1ceb06e40e15d838e583e708bb7e077389de']",585,4326,4911,3332909,76,,,,2355
01116450cfe981fdd37830d7ef2821ea3c0bf99a,0,Kishor Patil,2016-01-26 17:50:10+00:00,['ecce1ceb06e40e15d838e583e708bb7e077389de'],17,32,49,3332958,1,0.357142857,1,1,2355
b0e696062ec690dc7e279349ce4d0015cd96c08d,0,Kishor Patil,2016-01-26 17:50:23+00:00,['01116450cfe981fdd37830d7ef2821ea3c0bf99a'],2,4,6,3332964,1,,,,2355
0bd831687764d1cc818cd97c5d65ef9bdac98101,0,Abhishek Agarwal,2016-01-26 23:17:50+05:18,['0556bdbef06bde716726b3d98b4ab37c868bfc93'],15,18,33,3332997,3,1,1,0,2355
21f56e91efd4af4a8b2c54d6ba6b50b717f2aca7,0,Yegor Tokmakov,2016-01-26 19:58:59+01:00,['36f03ed7e6031ee3a212ba38f051615ea3c6584d'],4,8,12,3333009,2,,,,2355
1832c369735576df61c6533ff772814b537e5d68,0,Arun Mahadevan,2016-01-27 15:52:59+05:18,['ecce1ceb06e40e15d838e583e708bb7e077389de'],1,407,408,3333417,7,0.699186992,1,0.886178862,2361
c75ddca201021533e12f9010ddf6c8be3ed551ee,1,xiaojian.fxj,2016-01-27 22:13:50+08:00,['d66ae23ec4e0aa49a285025acac9406c500e2c62'],173,156,329,3333746,10,0.555555556,0.777777778,0.222222222,2361
c62904e51a79fe038a377b434b39fb3c2bbd0aa3,0,P. Taylor Goetz,2016-01-27 13:48:08-05:00,"['ecce1ceb06e40e15d838e583e708bb7e077389de', '21f56e91efd4af4a8b2c54d6ba6b50b717f2aca7']",4,8,12,3333758,2,,,,2361
195d15174052a678a430bc8889819c7de5b5cbf1,0,P. Taylor Goetz,2016-01-27 13:49:41-05:00,['c62904e51a79fe038a377b434b39fb3c2bbd0aa3'],2,3,5,3333763,3,,,,2361
ca0711d99cdbd413b07ad9d89b7e52ce59c34834,0,P. Taylor Goetz,2016-01-27 14:06:10-05:00,"['195d15174052a678a430bc8889819c7de5b5cbf1', '596dc3ecafccd4b9e6ec523ef81832f007d1dee6']",31,968,999,3334762,21,,,,2361
1386dc7789e818c718e5d1ad06e8408527a7b353,0,P. Taylor Goetz,2016-01-27 14:06:37-05:00,['ca0711d99cdbd413b07ad9d89b7e52ce59c34834'],0,1,1,3334763,1,,,,2361
8ce7b1bb0db73ef6c1b6ae1a7b86764bcaa92ecd,0,P. Taylor Goetz,2016-01-27 15:46:30-05:00,"['1386dc7789e818c718e5d1ad06e8408527a7b353', 'b0e696062ec690dc7e279349ce4d0015cd96c08d']",19,36,55,3334818,2,,,,2361
d94881019fda54ee8ab3d3db471137bde9702e5c,0,P. Taylor Goetz,2016-01-27 15:47:40-05:00,['8ce7b1bb0db73ef6c1b6ae1a7b86764bcaa92ecd'],0,1,1,3334819,1,,,,2361
77325fdbcc506fa9c75a7b2e39f5b24fcca1e58b,0,Arun Mahadevan,2016-01-28 14:04:19+05:18,['1832c369735576df61c6533ff772814b537e5d68'],36,21,57,3334876,6,0,0,0,2361
0997650733589b201df1d3d79057bca435855680,0,zhuol,2016-01-28 11:21:37-06:00,"['d94881019fda54ee8ab3d3db471137bde9702e5c', '6babd0e41e04e55913ba8aed26755a07e13739bf']",593,926,1519,3336395,36,,,,2361
3f1cefc3cfb50463b168feda2f3313bf830aba19,0,Robert (Bobby) Evans,2016-01-28 13:00:29-06:00,"['0997650733589b201df1d3d79057bca435855680', 'c75ddca201021533e12f9010ddf6c8be3ed551ee']",303,791,1094,3337489,19,,,,2361
394fefffd5753f382b3b6c60ebef8617c0d297ef,0,Robert (Bobby) Evans,2016-01-28 13:26:57-06:00,['3f1cefc3cfb50463b168feda2f3313bf830aba19'],11,72,83,3337572,3,1,1,0.8,2362
1c73197824fabbb24fe0953e0c68ea4b997097b8,1,Robert (Bobby) Evans,2016-01-28 13:55:53-06:00,['394fefffd5753f382b3b6c60ebef8617c0d297ef'],6,17,23,3337595,2,1,1,1,2362
795fda80fbfb47d7aef50f8f35b8aab60c58d600,1,Robert (Bobby) Evans,2016-01-28 14:42:21-06:00,['1c73197824fabbb24fe0953e0c68ea4b997097b8'],19,21,40,3337635,4,,,,2362
122fc0901acbbec89b735f430f2770cf711b11e4,0,Robert (Bobby) Evans,2016-01-28 15:41:01-06:00,['795fda80fbfb47d7aef50f8f35b8aab60c58d600'],42,5,47,3337682,3,0,0,0,2362
12a708517d88507c64cd1b934c4a105d757a190b,0,John Fang,2016-01-29 10:37:54+08:00,"['c75ddca201021533e12f9010ddf6c8be3ed551ee', '122fc0901acbbec89b735f430f2770cf711b11e4']",706,2037,2743,3340425,65,,,,2362
12631e056f6b05793a151d70ec7b2ef415423e77,1,xiaojian.fxj,2016-01-29 17:39:34+08:00,['12a708517d88507c64cd1b934c4a105d757a190b'],8,8,16,3340441,2,,,,2362
2e338a1c601f21ab3deba5a63d85d7d28eb73d0b,0,Sanket,2016-01-29 15:05:04-06:00,['0997650733589b201df1d3d79057bca435855680'],1,1,2,3340443,1,,,,2362
9442b4aaedc69131fdc7914d763090ed5bb9a2bb,0,xiaojian.fxj,2016-01-30 22:10:35+08:00,['12631e056f6b05793a151d70ec7b2ef415423e77'],1,1,2,3340445,1,,,,2362
c2f118112cd3b0727e30d2512cbd1d33fe9571cb,0,Robert (Bobby) Evans,2016-01-30 12:36:04-06:00,"['0997650733589b201df1d3d79057bca435855680', '9442b4aaedc69131fdc7914d763090ed5bb9a2bb']",328,853,1181,3341626,19,,,,2362
340ded69cc9a1398e6a6ad0382999a171259456d,0,Robert (Bobby) Evans,2016-01-30 12:37:10-06:00,['c2f118112cd3b0727e30d2512cbd1d33fe9571cb'],1,3,4,3341630,2,,,,2362
fe62b61aea243aa13d507fefa858a6897872d63a,0,Robert (Bobby) Evans,2016-01-30 14:03:07-06:00,['340ded69cc9a1398e6a6ad0382999a171259456d'],29,34,63,3341693,3,1,1,1,2363
982f992f7ed16fac4f881c9091655af0ac94dea0,0,Robert (Bobby) Evans,2016-01-30 14:13:59-06:00,"['340ded69cc9a1398e6a6ad0382999a171259456d', '2e338a1c601f21ab3deba5a63d85d7d28eb73d0b']",1,1,2,3341695,1,,,,2363
66d7a393684a86f178af6b9dd9a389445e4a3431,0,Robert (Bobby) Evans,2016-01-30 14:15:53-06:00,['982f992f7ed16fac4f881c9091655af0ac94dea0'],1,2,3,3341698,1,,,,2363
e9dc271f11e311eea2269a8f6035e2c322d8d520,1,basti.lj,2016-02-01 11:17:05+08:00,['66d7a393684a86f178af6b9dd9a389445e4a3431'],116,203,319,3342017,5,0.380530973,0.539823009,0.96460177,2364
682d31c8a5f53a59f47b4df4bd35ff828e7e0aa5,1,xiaojian.fxj,2016-02-01 15:17:49+08:00,['66d7a393684a86f178af6b9dd9a389445e4a3431'],4,1271,1275,3343292,5,0.647058824,0.753501401,0.675070028,2368
b38041481e3c1d13db40085eb0bed3e8e944bbd1,0,Arun Mahadevan,2016-02-02 20:08:29+05:18,['77325fdbcc506fa9c75a7b2e39f5b24fcca1e58b'],2,33,35,3343327,2,0.923076923,1,1,2368
f2dcee6f3d97be6760c7386cf5fbf355e2ad84aa,0,Sanket,2016-02-02 09:43:13-06:00,['66d7a393684a86f178af6b9dd9a389445e4a3431'],0,1,1,3343328,1,,,,2368
e5ca89b292aa8f7a983b29d610f71313594e32e3,1,Aaron Dossett,2016-02-02 10:27:52-06:00,['66d7a393684a86f178af6b9dd9a389445e4a3431'],5,521,526,3343854,13,1,1,0.782258065,2377
0d3c3477a199e4305566dee5936328e768614cc7,0,Aaron Niskode-Dossett,2016-02-02 12:04:32-06:00,['e5ca89b292aa8f7a983b29d610f71313594e32e3'],2,2,4,3343858,1,,,,2377
0dac59b594912570b21b1e5b917ff7b6d1cbc392,0,Aaron Dossett,2016-02-02 12:45:07-06:00,"['f2dcee6f3d97be6760c7386cf5fbf355e2ad84aa', '0d3c3477a199e4305566dee5936328e768614cc7']",6,522,528,3344386,13,,,,2377
02a44c7fc1b7b3a1571b326fde7bcae13e1b5c8d,0,Aaron Dossett,2016-02-02 12:46:29-06:00,['0dac59b594912570b21b1e5b917ff7b6d1cbc392'],0,1,1,3344387,1,,,,2377
d236036f77b65ee5aa827139a7aab3d430eede9e,0,Robert (Bobby) Evans,2016-02-02 14:18:21-06:00,"['02a44c7fc1b7b3a1571b326fde7bcae13e1b5c8d', '464da009f4c5a49853147ffb188f9eea2669b3ba']",1,3,4,3344391,2,,,,2377
dc198121fb057a2805791cb89888be9bff33ebf1,0,Boyang Jerry Peng,2016-02-02 16:53:03-06:00,['d236036f77b65ee5aa827139a7aab3d430eede9e'],2,2,4,3344395,2,,,,2377
675b0c4f786838a13122b6743ca6c946aa1d63ee,0,basti.lj,2016-02-03 15:46:08+08:00,['e9dc271f11e311eea2269a8f6035e2c322d8d520'],22,70,92,3344487,4,0,0,0,2378
e50a312f1440131e8b9e0cc055d475cbbe711cb9,0,basti.lj,2016-02-03 16:01:43+08:00,['675b0c4f786838a13122b6743ca6c946aa1d63ee'],2,1,3,3344490,1,,,,2378
c4dfa33c58ac8e1d3c6197b86b2976b9669a39f3,0,basti.lj,2016-02-03 18:43:17+08:00,['e50a312f1440131e8b9e0cc055d475cbbe711cb9'],2,1,3,3344493,1,,,,2378
9a79fb7de0e824e73c294738521e892f1d81fbb0,1,xiaojian.fxj,2016-02-03 20:28:05+08:00,['682d31c8a5f53a59f47b4df4bd35ff828e7e0aa5'],1296,488,1784,3346277,32,0.153846154,0.807692308,0.807692308,2380
5916b0b8089f9dd184fdd1ab2f18eb5e5deabc65,0,xiaojian.fxj,2016-02-03 21:15:41+08:00,['9a79fb7de0e824e73c294738521e892f1d81fbb0'],2,4,6,3346283,1,1,1,1,2380
2a17c45591692b61df0be922fdec9d10a108de27,0,xiaojian.fxj,2016-02-03 21:18:13+08:00,"['5916b0b8089f9dd184fdd1ab2f18eb5e5deabc65', 'd236036f77b65ee5aa827139a7aab3d430eede9e']",7,527,534,3346817,17,,,,2380
3d9481f402cf931ab1eb2e8f3b089fb8ded48f00,0,Aaron Dossett,2016-02-03 07:58:01-06:00,['d236036f77b65ee5aa827139a7aab3d430eede9e'],0,1,1,3346818,1,,,,2380
f1f4a5fc813350f31c6f921be9c78d8dc005ed49,0,P. Taylor Goetz,2016-02-03 16:57:18-05:00,"['3d9481f402cf931ab1eb2e8f3b089fb8ded48f00', 'b38041481e3c1d13db40085eb0bed3e8e944bbd1']",2,424,426,3347244,7,,,,2380
695f8c931e85181d7b969397c831ae5c8adc183a,0,P. Taylor Goetz,2016-02-03 16:58:03-05:00,['f1f4a5fc813350f31c6f921be9c78d8dc005ed49'],0,1,1,3347245,1,,,,2380
46ef55890cebf22807e0dc293fb665ba85caeabf,0,Kishor Patil,2016-02-03 16:05:57-06:00,['66d7a393684a86f178af6b9dd9a389445e4a3431'],9,112,121,3347366,10,0.527777778,1,1,2383
d86b99b56902d5c9eae1aaeed369bf3f7e611853,0,Kishor Patil,2016-02-03 16:06:09-06:00,['46ef55890cebf22807e0dc293fb665ba85caeabf'],16,192,208,3347574,7,0.558558559,0.774774775,1,2385
b0467eed7bf3a66b88337ec3dffe861beb6bf8cb,0,Kishor Patil,2016-02-03 16:21:06-06:00,['d86b99b56902d5c9eae1aaeed369bf3f7e611853'],0,85,85,3347659,5,,,,2385
6583b665042784e6cd17399027b0f97a9d2f3112,0,Kishor Patil,2016-02-03 16:35:36-06:00,['b0467eed7bf3a66b88337ec3dffe861beb6bf8cb'],8,7,15,3347674,4,,,,2385
25f8b2af7ac007ca4da304e3e25813a4f0079af4,0,Jungtaek Lim,2016-02-04 18:17:15+09:00,['695f8c931e85181d7b969397c831ae5c8adc183a'],1,28,29,3347703,2,1,1,1,2386
002564739dde8fec43e799e0f81e2b951a2a5a19,0,Jungtaek Lim,2016-02-04 18:49:03+09:00,['25f8b2af7ac007ca4da304e3e25813a4f0079af4'],0,18,18,3347721,1,,,,2386
a7d0289ca52f2a9f2d84ce1bf9ebc84d3c7dcd87,0,basti.lj,2016-02-04 19:47:35+08:00,['c4dfa33c58ac8e1d3c6197b86b2976b9669a39f3'],30,6,36,3347757,2,0.818181818,0,0,2386
c13388baae9c2463f3912c8fe13bea23bcecdff3,0,Kishor Patil,2016-02-04 11:01:40-06:00,['6583b665042784e6cd17399027b0f97a9d2f3112'],13,13,26,3347783,7,,,,2386
3337ce8533f6613ab2b6d4690f53bbc00564b6f7,0,Kishor Patil,2016-02-04 13:16:26-06:00,['c13388baae9c2463f3912c8fe13bea23bcecdff3'],50,95,145,3347928,7,1,1,1,2386
f6ebd0fd368949a0a8f53728bc059a5d503f88a8,0,Kishor Patil,2016-02-04 14:19:02-06:00,['3337ce8533f6613ab2b6d4690f53bbc00564b6f7'],36,52,88,3348016,5,1,1,1,2386
b50677432df9114ea75acf235c2bfa021955d410,0,Kishor Patil,2016-02-04 14:47:32-06:00,['f6ebd0fd368949a0a8f53728bc059a5d503f88a8'],1,2,3,3348019,1,,,,2386
85b24aeb3d2e10ae4670de65d0d042ad5ea5ef2e,0,Kishor Patil,2016-02-04 15:29:17-06:00,['b50677432df9114ea75acf235c2bfa021955d410'],6,1,7,3348026,1,1,0,0,2386
d5a31fc16abe4fb2543e827a30e33a864e9ccfa1,0,roshannaik,2016-02-04 17:55:36-08:00,"['f47ff5fb91da53ef63fe6660516f16751a6823af', '695f8c931e85181d7b969397c831ae5c8adc183a']",37348,30884,68232,3416258,1671,,,,2386
d58ba0099f0900ffe8b45abe9f5a27e4379fb232,0,Roshan Naik,2016-02-04 18:06:07-08:00,['d5a31fc16abe4fb2543e827a30e33a864e9ccfa1'],1,1,2,3416260,1,,,,2386
b0d8f4c59d3dfee75e7e0650ce225ba4ca7dece3,0,Kishor Patil,2016-02-04 22:12:59-06:00,['85b24aeb3d2e10ae4670de65d0d042ad5ea5ef2e'],1,1,2,3416262,1,,,,2386
f3f62ea6ff36ea38b9d82ab2cf4940f6bc13ae90,0,Arun Mahadevan,2016-02-05 10:34:15+05:18,['695f8c931e85181d7b969397c831ae5c8adc183a'],0,101,101,3416363,4,0.739130435,1,1,2388
aeb9dcc19c57efe51bf6db3474ea987d4a7ed46e,0,Jungtaek Lim,2016-02-05 14:36:45+09:00,"['695f8c931e85181d7b969397c831ae5c8adc183a', '0bd831687764d1cc818cd97c5d65ef9bdac98101']",46,71,117,3416480,4,,,,2388
cd2f2028b16f978b7e4eb07956a9cb573a5f2d07,0,Jungtaek Lim,2016-02-05 14:38:11+09:00,['aeb9dcc19c57efe51bf6db3474ea987d4a7ed46e'],0,1,1,3416481,1,,,,2388
55b86ca4f0ea02b25701f25f454e537cbf6239d4,1,xiaojian.fxj,2016-02-05 14:17:58+08:00,['2a17c45591692b61df0be922fdec9d10a108de27'],396,422,818,3417299,25,1,1,0.217391304,2388
58d324e24f7dccb75a803362b0306382e43324f0,0,Jungtaek Lim,2016-02-05 21:43:16+09:00,"['cd2f2028b16f978b7e4eb07956a9cb573a5f2d07', 'f3f62ea6ff36ea38b9d82ab2cf4940f6bc13ae90']",0,101,101,3417400,4,,,,2388
c16b2cf5e8e92ead786676086730c640cb53e905,0,Jungtaek Lim,2016-02-05 21:44:29+09:00,['cd2f2028b16f978b7e4eb07956a9cb573a5f2d07'],0,1,1,3417401,1,,,,2388
5a351830c2e27ca042cdee3061da3fb75833f59c,0,Jungtaek Lim,2016-02-05 21:57:32+09:00,"['c16b2cf5e8e92ead786676086730c640cb53e905', '58d324e24f7dccb75a803362b0306382e43324f0']",0,101,101,3417502,4,,,,2388
212a4f6a672a76ba89e9fc2426a3aad159b6dd72,0,Kishor Patil,2016-02-05 18:41:35+00:00,"['5a351830c2e27ca042cdee3061da3fb75833f59c', 'b0d8f4c59d3dfee75e7e0650ce225ba4ca7dece3']",9,429,438,3417940,13,,,,2388
31b57e8ab6762cf4539353aee9a0a608a4d73dfa,0,Kishor Patil,2016-02-05 18:44:26+00:00,['212a4f6a672a76ba89e9fc2426a3aad159b6dd72'],0,1,1,3417941,1,,,,2388
81a287652365a2b0d8e656e61d6d93f668fac845,0,Kishor Patil,2016-02-05 14:32:32-06:00,['31b57e8ab6762cf4539353aee9a0a608a4d73dfa'],1,1,2,3417943,1,,,,2388
56a7a022de62c122320d619dc153824b57b53be6,0,Kishor Patil,2016-02-06 02:32:20-06:00,['31b57e8ab6762cf4539353aee9a0a608a4d73dfa'],1,21,22,3417965,3,1,1,1,2388
5295a909b1fc8c136a220a0e636c0d70c036e5c5,0,Satish Duggana,2016-02-08 11:02:41+05:18,['31b57e8ab6762cf4539353aee9a0a608a4d73dfa'],13,651,664,3418629,8,0.844155844,1,0.913419913,2395
3f52dda9a078c9aa0d840168ec0c30fa142a5812,0,Sriharsha Chintalapani,2016-02-08 07:16:08-08:00,"['31b57e8ab6762cf4539353aee9a0a608a4d73dfa', 'd58ba0099f0900ffe8b45abe9f5a27e4379fb232']",1,1,2,3418631,1,,,,2395
00c18c988f7b4cf98635e43ce5af6ed13ecc08d0,0,Sriharsha Chintalapani,2016-02-08 07:17:06-08:00,['3f52dda9a078c9aa0d840168ec0c30fa142a5812'],0,1,1,3418632,1,,,,2395
431cbb2db3aa6badfb23c98bcd3255cc603a80d3,0,Shoeb Mohammed,2016-02-08 10:09:35-06:00,['0997650733589b201df1d3d79057bca435855680'],0,2,2,3418634,1,,,,2395
2b1d89e8183cf0a056b42b1a22ee60b918973e97,0,Shoeb Mohammed,2016-02-08 10:10:06-06:00,"['431cbb2db3aa6badfb23c98bcd3255cc603a80d3', '00c18c988f7b4cf98635e43ce5af6ed13ecc08d0']",396,2418,2814,3421448,61,,,,2395
3befae326c24b10cea1b1e6992ef808d481134c2,1,Kyle Nusbaum,2016-02-08 11:46:51-06:00,['00c18c988f7b4cf98635e43ce5af6ed13ecc08d0'],1947,2822,4769,3426217,64,0.613960114,0.743589744,0.736467236,2398
65e8b2fc7ff132a43b2aeda0c26eb996d2a764b0,0,Kyle Nusbaum,2016-02-08 13:42:22-06:00,['3befae326c24b10cea1b1e6992ef808d481134c2'],240,234,474,3426691,3,,,0,2398
7d62bfef862a5dec14cbd94f9a50657927e83015,0,Kyle Nusbaum,2016-02-08 13:50:18-06:00,['65e8b2fc7ff132a43b2aeda0c26eb996d2a764b0'],0,5,5,3426696,1,,,,2398
429ca8d29c9bb2edc822304498fdd1ce928b3a41,1,Kyle Nusbaum,2016-02-08 15:00:40-06:00,['7d62bfef862a5dec14cbd94f9a50657927e83015'],93,63,156,3426852,25,0,0,0,2398
140a1e59b3a4fbb92a361bd66698a0ce4d261a66,0,Aaron Dossett,2016-02-08 15:48:32-06:00,"['00c18c988f7b4cf98635e43ce5af6ed13ecc08d0', '2b1d89e8183cf0a056b42b1a22ee60b918973e97']",0,2,2,3426854,1,,,,2398
b89af960accfd37ed5aa7b1d095de5e3758a5df6,0,Aaron Dossett,2016-02-08 19:59:56-06:00,['140a1e59b3a4fbb92a361bd66698a0ce4d261a66'],1,2,3,3426857,1,,,,2398
7ddbb9f74bf29e887842b0455b0b5f418c66b001,0,Jungtaek Lim,2016-02-09 11:20:42+09:00,"['b89af960accfd37ed5aa7b1d095de5e3758a5df6', '002564739dde8fec43e799e0f81e2b951a2a5a19']",1,46,47,3426904,2,,,,2398
53e44ff3dbc9e3bbc52becf2a756cc5d07dc4825,0,Jungtaek Lim,2016-02-09 11:21:33+09:00,['7ddbb9f74bf29e887842b0455b0b5f418c66b001'],0,1,1,3426905,1,,,,2398
bc263cba67283b0c1ebe95be49e137fad86b3978,0,Satish Duggana,2016-02-09 10:19:18+05:18,['5295a909b1fc8c136a220a0e636c0d70c036e5c5'],103,302,405,3427310,9,0.6,1,0.94,2399
0559b8d7f2bf93a507039092421275541ba11060,1,Dan Bahir,2016-02-09 10:43:36-05:00,['ecce1ceb06e40e15d838e583e708bb7e077389de'],14,22,36,3427346,1,0,0,1,2399
f8ee7b892a8236bb7f2f11ec427549d3bf438169,0,Abhishek Agarwal,2016-02-09 21:11:07+05:18,['53e44ff3dbc9e3bbc52becf2a756cc5d07dc4825'],1,9,10,3427356,2,,,,2399
8fe6cf7dfbdaaae84e1272af0d4cf9292138da9e,0,Abhishek Agarwal,2016-02-09 21:11:51+05:18,['f8ee7b892a8236bb7f2f11ec427549d3bf438169'],1,1,2,3427358,1,,,,2399
a776faf9cc1d52bf291755dac52aefe041ea1d23,0,Robert (Bobby) Evans,2016-02-09 18:13:38+00:00,['53e44ff3dbc9e3bbc52becf2a756cc5d07dc4825'],3,7,10,3427368,3,,,,2399
112ad81b257f274cc69f55d5f898a38bb99d17f1,1,Kyle Nusbaum,2016-02-09 12:27:35-06:00,['429ca8d29c9bb2edc822304498fdd1ce928b3a41'],287,140,427,3427795,20,0.264,0.608,0.232,2399
ce52a250089ed1f9e9f6e9bf8e02f06979228423,0,Kyle Nusbaum,2016-02-09 12:58:12-06:00,['112ad81b257f274cc69f55d5f898a38bb99d17f1'],18,18,36,3427831,1,1,0,1,2399
235d6e785e21888cd258e2d120e997647c2d3320,0,Kyle Nusbaum,2016-02-09 14:45:30-06:00,['ce52a250089ed1f9e9f6e9bf8e02f06979228423'],6,3,9,3427840,2,,,,2399
d1610acc17e89d04c41804dcc93cb19953122e88,0,Arun Mahadevan,2016-02-10 11:13:24+05:18,"['53e44ff3dbc9e3bbc52becf2a756cc5d07dc4825', '10b0d5842a12dbb772fb97fd26271d395396aa31']",9,44,53,3427893,2,,,,2399
5f1cba55a48fc10bc62a19765d5d3f1e007332b9,0,Arun Mahadevan,2016-02-10 11:15:26+05:18,['d1610acc17e89d04c41804dcc93cb19953122e88'],0,1,1,3427894,1,,,,2399
c054d1d2c038e5e886288f7cbe78751cadf266d9,0,Robert (Bobby) Evans,2016-02-10 15:59:38+00:00,['a776faf9cc1d52bf291755dac52aefe041ea1d23'],2,2,4,3427898,2,,,,2399
f3e8348e8ff82b06a14db3513eb9d90a24e5652d,1,Kyle Nusbaum,2016-02-10 13:15:24-06:00,['235d6e785e21888cd258e2d120e997647c2d3320'],53,49,102,3428000,8,0,0,0,2399
777be78ba1f858506b821a5dd2fe8f9d83e63ba1,0,Kyle Nusbaum,2016-02-10 13:18:28-06:00,['f3e8348e8ff82b06a14db3513eb9d90a24e5652d'],0,4,4,3428004,1,,,,2399
0103abc184c068b3e896dfdd49db27e182c671ea,0,Kyle Nusbaum,2016-02-10 13:53:45-06:00,"['5f1cba55a48fc10bc62a19765d5d3f1e007332b9', 'c054d1d2c038e5e886288f7cbe78751cadf266d9']",4,8,12,3428016,4,,,,2399
5536fb3da929a7b2e743fb0909b9e9aa786afba3,0,Kyle Nusbaum,2016-02-10 13:55:10-06:00,['0103abc184c068b3e896dfdd49db27e182c671ea'],0,1,1,3428017,1,,,,2399
b1e61bd25057af37054d10487b7cbe82b54c9fed,0,Parth Brahmbhatt,2016-02-10 11:55:53-08:00,"['5f1cba55a48fc10bc62a19765d5d3f1e007332b9', '0559b8d7f2bf93a507039092421275541ba11060']",14,22,36,3428053,1,,,,2399
0c495eb3fe07799e1e727b876043de9e18423502,0,Parth Brahmbhatt,2016-02-10 12:00:54-08:00,['b1e61bd25057af37054d10487b7cbe82b54c9fed'],1,2,3,3428056,2,,,,2399
3339dae6b5af7aa6112d64dc2ed1063942899e25,0,Parth Brahmbhatt,2016-02-10 12:02:45-08:00,"['0c495eb3fe07799e1e727b876043de9e18423502', '5536fb3da929a7b2e743fb0909b9e9aa786afba3']",4,9,13,3428069,5,,,,2399
88bc6afcac8217533a91cd504bcb9edd6c9d9841,0,Kyle Nusbaum,2016-02-10 14:05:57-06:00,['777be78ba1f858506b821a5dd2fe8f9d83e63ba1'],14,14,28,3428097,1,,,,2399
c7e66894d9401a1a9363d3ce55e31ceedc6ac38f,0,Abhishek Agarwal,2016-02-11 18:23:56+05:18,['5f1cba55a48fc10bc62a19765d5d3f1e007332b9'],109,61,170,3428267,4,1,1,0,2399
65a378492e011c27437c98c1eb947a8fdb80df38,0,Robert (Bobby) Evans,2016-02-11 08:44:22-06:00,"['3339dae6b5af7aa6112d64dc2ed1063942899e25', '8fe6cf7dfbdaaae84e1272af0d4cf9292138da9e']",2,10,12,3428279,3,,,,2399
55b26dd639340ef928951eedc1bc783bf26b5b1e,0,Abhishek Agarwal,2016-02-11 20:20:56+05:18,['c7e66894d9401a1a9363d3ce55e31ceedc6ac38f'],1,1,2,3428281,1,,,,2399
e6a7eefde58a086d1f6ff300ef5c1541593daa6d,0,Robert (Bobby) Evans,2016-02-11 09:32:08-06:00,['65a378492e011c27437c98c1eb947a8fdb80df38'],0,2,2,3428283,1,,,,2399
36aa7b07344fe6b0caf46b3592d1754891ff9597,0,Abhishek Agarwal,2016-02-12 00:21:56+05:18,['3339dae6b5af7aa6112d64dc2ed1063942899e25'],67,11,78,3428361,4,,,,2399
1a445164a96afdc21eac29856f2da569f331e855,0,Kyle Nusbaum,2016-02-11 13:10:26-06:00,"['e6a7eefde58a086d1f6ff300ef5c1541593daa6d', '88bc6afcac8217533a91cd504bcb9edd6c9d9841']",2246,2940,5186,3433547,70,,,,2399
d041183f78a134d844378c0443aba7677e6274f9,0,Kyle Nusbaum,2016-02-11 13:12:25-06:00,['1a445164a96afdc21eac29856f2da569f331e855'],2,1,3,3433550,1,,,,2399
1646805d10dd85739b42d484afd281a0feae5b5b,0,Robert (Bobby) Evans,2016-02-11 13:29:14-06:00,"['d041183f78a134d844378c0443aba7677e6274f9', 'dc198121fb057a2805791cb89888be9bff33ebf1']",2,2,4,3433554,2,,,,2399
55d496871a81c25aea20aab655ee3e6bb90dcfa2,0,Abhishek Agarwal,2016-02-12 00:49:28+05:18,"['36aa7b07344fe6b0caf46b3592d1754891ff9597', 'd041183f78a134d844378c0443aba7677e6274f9']",2249,2953,5202,3438756,73,,,,2399
c6eac2b65fbd0dba3230f7b1318463dc67a484ed,0,Robert (Bobby) Evans,2016-02-11 13:40:40-06:00,['1646805d10dd85739b42d484afd281a0feae5b5b'],0,1,1,3438757,1,,,,2399
add538b983b0e2ecc82a3e0f65d3ab2195402092,0,Robert (Bobby) Evans,2016-02-11 14:12:08-06:00,"['c6eac2b65fbd0dba3230f7b1318463dc67a484ed', 'fe62b61aea243aa13d507fefa858a6897872d63a']",29,34,63,3438820,3,,,,2399
265ff91a77200dd5f55169b3e049ca9567b807f2,0,Robert (Bobby) Evans,2016-02-11 14:12:56-06:00,['add538b983b0e2ecc82a3e0f65d3ab2195402092'],0,2,2,3438822,1,,,,2399
6696e3f1d8309f85d487a3361306f67c5608a0ff,0,Abhishek Agarwal,2016-02-12 02:02:42+05:18,"['55b26dd639340ef928951eedc1bc783bf26b5b1e', 'd041183f78a134d844378c0443aba7677e6274f9']",2311,2996,5307,3444129,77,,,,2399
747080e08af0bd46624e53264111cc3be1a0a74f,0,Kyle Nusbaum,2016-02-11 16:17:20-06:00,['265ff91a77200dd5f55169b3e049ca9567b807f2'],7,7,14,3444143,1,,,,2399
d3d0a868069ff783ba25d9698ff4b9311e58d796,0,Kyle Nusbaum,2016-02-11 16:30:09-06:00,['747080e08af0bd46624e53264111cc3be1a0a74f'],3,3,6,3444149,2,,,,2399
5fe7559aa1ac9bc12accdc2af7ded2f43bea1cf0,0,Jungtaek Lim,2016-02-12 09:43:45+09:00,['53e44ff3dbc9e3bbc52becf2a756cc5d07dc4825'],11,12,23,3444172,1,,,,2399
f4724655740bd67098841789d38ed0c9ee52f0ce,0,Boyang Jerry Peng,2016-02-12 09:13:29-06:00,"['265ff91a77200dd5f55169b3e049ca9567b807f2', 'd3d0a868069ff783ba25d9698ff4b9311e58d796']",10,10,20,3444192,3,,,,2399
9ddd29ff2556c8ba6225d60b953859cd58bd4566,0,Boyang Jerry Peng,2016-02-12 09:15:09-06:00,['f4724655740bd67098841789d38ed0c9ee52f0ce'],0,1,1,3444193,1,,,,2399
fc063ecc3e1fb6a3d50b9cf27c756db0baf2e6c3,0,Boyang Jerry Peng,2016-02-12 10:38:34-06:00,['9ddd29ff2556c8ba6225d60b953859cd58bd4566'],19,3017,3036,3447229,31,0.645053476,0.759358289,0.964572193,2425
c9421cd8b712aae7d0aa3dda986de8920c08fe54,0,Boyang Jerry Peng,2016-02-12 10:44:27-06:00,['fc063ecc3e1fb6a3d50b9cf27c756db0baf2e6c3'],509,530,1039,3448268,32,0,1,0,2425
0bf82362e110ffaa916e496534b5babb23f0e666,0,Kishor Patil,2016-02-12 16:48:24+00:00,['9ddd29ff2556c8ba6225d60b953859cd58bd4566'],0,2,2,3448270,1,0,0,1,2425
0f774026af15798ab4cb482704911a782cb62b9b,0,Boyang Jerry Peng,2016-02-12 10:57:14-06:00,['c9421cd8b712aae7d0aa3dda986de8920c08fe54'],18,18,36,3448306,5,0,0,0,2425
b05aeb0eaadde8c919428bb2dbbffaa414b8470d,1,Robert (Bobby) Evans,2016-02-12 12:38:48-06:00,['265ff91a77200dd5f55169b3e049ca9567b807f2'],38,321,359,3448665,8,0.644578313,0.753012048,0.771084337,2427
42ce11ee1135c13f3efd075bb2d42f9ce995bc23,0,Boyang Jerry Peng,2016-02-12 12:41:37-06:00,['0f774026af15798ab4cb482704911a782cb62b9b'],3,11,14,3448679,3,,,,2427
3db43db5aad666fbb4b5f0849ab10a6cdad68896,0,Robert (Bobby) Evans,2016-02-12 13:56:08-06:00,"['9ddd29ff2556c8ba6225d60b953859cd58bd4566', '55d496871a81c25aea20aab655ee3e6bb90dcfa2']",66,11,77,3448756,4,,,,2427
12ceb09758e57e699436514e3fc69994da1415b8,0,Robert (Bobby) Evans,2016-02-12 14:06:21-06:00,['3db43db5aad666fbb4b5f0849ab10a6cdad68896'],0,1,1,3448757,1,,,,2427
7245be6d174cb55ed60efeb14962483e0d446e48,0,Robert (Bobby) Evans,2016-02-12 14:09:26-06:00,"['12ceb09758e57e699436514e3fc69994da1415b8', '6696e3f1d8309f85d487a3361306f67c5608a0ff']",150,70,220,3448977,4,,,,2427
a759db38d236472122b5263ebfa4249494cd10b2,0,Robert (Bobby) Evans,2016-02-12 14:10:10-06:00,['7245be6d174cb55ed60efeb14962483e0d446e48'],0,1,1,3448978,1,,,,2427
d110b1f95d8f07b8a2c825885fc6bfa94af7a705,0,Roshan Naik,2016-02-12 14:57:54-08:00,['12ceb09758e57e699436514e3fc69994da1415b8'],5,9,14,3448992,2,1,1,1,2427
54f17d81368bc3c58c2a886a63f96c5061c49f13,1,Robert (Bobby) Evans,2016-02-13 13:34:33-06:00,['b05aeb0eaadde8c919428bb2dbbffaa414b8470d'],26,42,68,3449060,4,1,1,1,2428
a64daee0e2d77c4553d2a53a027e9f40194f7370,1,Robert (Bobby) Evans,2016-02-13 13:46:08-06:00,['54f17d81368bc3c58c2a886a63f96c5061c49f13'],26,42,68,3449128,4,1,1,1,2429
7d7f5b6e3519ed66a796087b3cd879261d63880c,0,Robert (Bobby) Evans,2016-02-13 13:56:09-06:00,['a64daee0e2d77c4553d2a53a027e9f40194f7370'],1,4,5,3449133,1,,,,2429
415310a9a13306cd7f110712cee5f19d840d8f6a,0,Robert (Bobby) Evans,2016-02-13 14:33:03-06:00,['7d7f5b6e3519ed66a796087b3cd879261d63880c'],40,52,92,3449225,4,0,1,1,2430
0867b8017678f55fd24fee80408d7c7041e953e8,0,Robert (Bobby) Evans,2016-02-13 15:11:48-06:00,['415310a9a13306cd7f110712cee5f19d840d8f6a'],1,60,61,3449286,2,0,1,1,2431
7ce9a3c9ebf460143ad75275e4108b0b32f0b206,1,basti.lj,2016-02-14 13:03:40+08:00,['a7d0289ca52f2a9f2d84ce1bf9ebc84d3c7dcd87'],39,10,49,3449335,3,0.076923077,0.076923077,0,2431
6c0f4f01aaef6c7a728db45c6d1b3726f2da1ab9,0,basti.lj,2016-02-14 13:47:48+08:00,"['7ce9a3c9ebf460143ad75275e4108b0b32f0b206', '12ceb09758e57e699436514e3fc69994da1415b8']",2426,4677,7103,3456438,120,,,,2431
4e26f06b2d7d343953985ed611b58193c4246bbb,0,basti.lj,2016-02-14 14:33:44+08:00,['6c0f4f01aaef6c7a728db45c6d1b3726f2da1ab9'],16,17,33,3456471,3,,,,2431
e19dafbece89d7d9e440e4a0eacd8b5e544063de,0,Boyang Jerry Peng,2016-02-14 17:01:37-06:00,['42ce11ee1135c13f3efd075bb2d42f9ce995bc23'],1,1,2,3456473,1,,,,2431
2ee8bec8458b02bca6af757ce0f1052a16c660b8,1,xiaojian.fxj,2016-02-15 09:37:32+08:00,['55b86ca4f0ea02b25701f25f454e537cbf6239d4'],60,369,429,3456902,17,0.518292683,1,0.731707317,2434
0e62a2dcd3d7358712cfab8ae18b2251066d0812,1,Arun Mahadevan,2016-02-15 13:12:11+05:18,['5f1cba55a48fc10bc62a19765d5d3f1e007332b9'],2,16,18,3456920,3,,,,2434
4c41ac18be1129d350bc0f6d6d72eea84570c776,0,vesense,2016-02-15 18:17:13+08:00,['12ceb09758e57e699436514e3fc69994da1415b8'],184,312,496,3457416,8,0.197916667,0.21875,0.901041667,2436
9a8962de9c80fc6a5388fd6d63ab225268530adf,0,xiaojian.fxj,2016-02-15 22:15:21+08:00,"['2ee8bec8458b02bca6af757ce0f1052a16c660b8', '12ceb09758e57e699436514e3fc69994da1415b8']",2568,4153,6721,3464137,108,,,,2436
aca76e0db96bd34b9f9d52ccb71fd89a27e97b70,1,Robert (Bobby) Evans,2016-02-15 14:01:25-06:00,['0867b8017678f55fd24fee80408d7c7041e953e8'],25,146,171,3464308,1,0,0,1,2436
924f9a29dc1713921178e61ce2f5b6a14df97ed7,0,xiaojian.fxj,2016-02-16 11:14:18+08:00,"['2ee8bec8458b02bca6af757ce0f1052a16c660b8', '12ceb09758e57e699436514e3fc69994da1415b8']",2602,4235,6837,3471145,113,,,,2436
419be35d5ed0cbbc9abdf89058c1b484ecbf8e6d,0,xiaojian.fxj,2016-02-16 11:17:22+08:00,"['924f9a29dc1713921178e61ce2f5b6a14df97ed7', '9a8962de9c80fc6a5388fd6d63ab225268530adf']",1,4,5,3471150,2,,,,2436
e0f3cb5f322c1dc09d05803e93d1fb3e6a3baff0,0,xiaojian.fxj,2016-02-16 11:40:48+08:00,['419be35d5ed0cbbc9abdf89058c1b484ecbf8e6d'],2,0,2,3471152,1,,,,2436
61c9702a924eb6b1b8bd3f0a829678a50f02bb67,0,Kishor Patil,2016-02-15 23:39:27-06:00,"['56a7a022de62c122320d619dc153824b57b53be6', '12ceb09758e57e699436514e3fc69994da1415b8']",2389,3148,5537,3476689,88,,,,2436
4e6890408047351429447b4a13ae0a5c5ae9d81e,0,xiaojian.fxj,2016-02-16 15:43:50+08:00,['12ceb09758e57e699436514e3fc69994da1415b8'],81,183,264,3476953,5,0.41509434,0.41509434,1,2439
0f4b7522dfeeae33fdadf6ec59ace97769b9ffe4,0,xiaojian.fxj,2016-02-16 17:18:35+08:00,['12ceb09758e57e699436514e3fc69994da1415b8'],92,126,218,3477171,3,0.054794521,0.054794521,1,2440
0f0dea0b4d2b17d6e8dc32e82341b8aec70ef6e9,0,Arun Mahadevan,2016-02-16 15:55:27+05:18,['12ceb09758e57e699436514e3fc69994da1415b8'],2,20,22,3477193,2,0.909090909,0.909090909,1,2440
f343b7d113fbbba2eef0f810f4f20dc955fb8b65,0,xiaojian.fxj,2016-02-16 19:19:28+08:00,['0f4b7522dfeeae33fdadf6ec59ace97769b9ffe4'],1,1,2,3477195,1,,,,2440
930014bf66e841c503f70185aec56ab708af88a2,0,xiaojian.fxj,2016-02-16 19:32:51+08:00,['12ceb09758e57e699436514e3fc69994da1415b8'],31,38,69,3477264,5,1,1,1,2441
99ecc4b42a14c607905441f9284f3716d7b350a7,1,xiaojian.fxj,2016-02-16 20:06:48+08:00,['930014bf66e841c503f70185aec56ab708af88a2'],4,4,8,3477272,4,,,,2441
9f168d267b685a65b69d8f778c96c05c7d5784c6,0,John Fang,2016-02-16 20:43:27+08:00,['99ecc4b42a14c607905441f9284f3716d7b350a7'],0,0,0,3477272,1,,,,2441
45178230c49d397eb89765e68ebc34802b80985c,0,Robert (Bobby) Evans,2016-02-16 09:16:13-06:00,"['a759db38d236472122b5263ebfa4249494cd10b2', 'aca76e0db96bd34b9f9d52ccb71fd89a27e97b70']",130,640,770,3478042,15,,,,2441
4a9278630ec349a92c3970a72520ba237b372bc3,0,Robert (Bobby) Evans,2016-02-16 12:32:48-06:00,['45178230c49d397eb89765e68ebc34802b80985c'],0,4,4,3478046,1,,,,2441
fd42a28edc2d8bfd608d6283106311809e135acc,0,Sriharsha Chintalapani,2016-02-16 17:34:26-08:00,"['4a9278630ec349a92c3970a72520ba237b372bc3', 'd110b1f95d8f07b8a2c825885fc6bfa94af7a705']",5,9,14,3478060,2,,,,2441
9635e391c380ca160cb408e28eb3364b42851a60,0,xiaojian.fxj,2016-02-17 09:42:15+08:00,['f343b7d113fbbba2eef0f810f4f20dc955fb8b65'],5,3,8,3478068,1,1,1,0,2441
40b115f1de09ac04b11bf7ef03c6fa34cadbcc20,0,Sriharsha Chintalapani,2016-02-16 17:48:35-08:00,['fd42a28edc2d8bfd608d6283106311809e135acc'],0,1,1,3478069,1,,,,2441
d946d4d99f3b1b976ac014281bd004e467bcfdb6,0,Sriharsha Chintalapani,2016-02-16 18:26:55-08:00,"['40b115f1de09ac04b11bf7ef03c6fa34cadbcc20', '0e62a2dcd3d7358712cfab8ae18b2251066d0812']",2,16,18,3478087,3,,,,2441
82bea75c92356de2595ffcc118dfecd6b39d1d8b,0,Sriharsha Chintalapani,2016-02-16 18:31:19-08:00,['d946d4d99f3b1b976ac014281bd004e467bcfdb6'],0,1,1,3478088,1,,,,2441
68c87b5eb2d254586fabfc81f5ed7addbb9fdc68,0,Sriharsha Chintalapani,2016-02-16 18:35:03-08:00,"['82bea75c92356de2595ffcc118dfecd6b39d1d8b', 'bc263cba67283b0c1ebe95be49e137fad86b3978']",13,850,863,3478951,9,,,,2441
46999909a7c2f1a8b3e436f314971e9a21467547,0,Sriharsha Chintalapani,2016-02-16 18:39:13-08:00,['68c87b5eb2d254586fabfc81f5ed7addbb9fdc68'],0,1,1,3478952,1,,,,2441
969ebaf76cded1efffe7c02cae675950ccee1c4b,0,Boyang Jerry Peng,2016-02-16 20:42:02-06:00,['e19dafbece89d7d9e440e4a0eacd8b5e544063de'],2,2,4,3478956,2,,,,2441
a261c3ad942dca7edf4422b8d157639584fd1f22,0,xiaojian.fxj,2016-02-17 10:53:00+08:00,"['4e6890408047351429447b4a13ae0a5c5ae9d81e', '46999909a7c2f1a8b3e436f314971e9a21467547']",300,1593,1893,3480849,31,,,,2441
9b74f2efcad3e43c9edc221eca9506aafb78146d,0,vesense,2016-02-17 10:58:46+08:00,['4c41ac18be1129d350bc0f6d6d72eea84570c776'],15,28,43,3480892,1,,,,2441
a9975b62f60751b7d25c5d451dcc0bdb9b758daf,0,xiaojian.fxj,2016-02-17 11:08:04+08:00,['a261c3ad942dca7edf4422b8d157639584fd1f22'],41,14,55,3480947,4,,,,2441
d5463879c0441a5a57eb23653a70bcf95d2efbaf,0,xiaojian.fxj,2016-02-17 11:28:10+08:00,"['e0f3cb5f322c1dc09d05803e93d1fb3e6a3baff0', '46999909a7c2f1a8b3e436f314971e9a21467547']",300,1593,1893,3482840,31,,,,2441
98fb253e522f8c0c3902d48485896a80602f8950,0,xiaojian.fxj,2016-02-17 11:33:23+08:00,['a9975b62f60751b7d25c5d451dcc0bdb9b758daf'],4,5,9,3482849,1,,,,2441
a2a656ed3fdbf76fddb730bced5bfe7f2b18df72,0,Alessandro Bellina,2016-02-16 23:17:42-06:00,['46999909a7c2f1a8b3e436f314971e9a21467547'],118,337,455,3483304,4,0.866666667,0.994871795,1,2443
f9184624f18094beb1bb7e9f60e5665225dfb0ee,0,vesense,2016-02-17 13:22:41+08:00,['9b74f2efcad3e43c9edc221eca9506aafb78146d'],39,20,59,3483363,3,1,0.388888889,0,2443
8749523cf78f9a466aaf68399287f8e48a7e0132,0,Satish Duggana,2016-02-17 11:05:17+05:18,['46999909a7c2f1a8b3e436f314971e9a21467547'],3,3,6,3483369,1,,,,2443
7852bc24f051b7c5dd95835d473b99ed531e353c,0,Satish Duggana,2016-02-17 11:37:35+05:18,['46999909a7c2f1a8b3e436f314971e9a21467547'],2,4,6,3483375,1,,,,2443
de9cb106f3a68f8b13d16a39b242cecd7e5b0513,1,Sanket,2016-02-17 10:20:17-06:00,['46999909a7c2f1a8b3e436f314971e9a21467547'],520,1636,2156,3485531,38,0.682608696,0.77826087,0.752173913,2448
20851f8b2d47bc74fa8ac36c78c43e038d56ed81,0,Alessandro Bellina,2016-02-17 12:26:02-06:00,['a2a656ed3fdbf76fddb730bced5bfe7f2b18df72'],87,75,162,3485693,2,0,1,1,2448
3fe11ecc652790684010b5fdd36c53844e89ce42,0,Alessandro Bellina,2016-02-17 12:31:58-06:00,['20851f8b2d47bc74fa8ac36c78c43e038d56ed81'],6,2,8,3485701,1,0,0,0,2448
a8edd512c903d44bf26a57cace8f848cc4660738,0,Alessandro Bellina,2016-02-17 12:36:32-06:00,['3fe11ecc652790684010b5fdd36c53844e89ce42'],5,5,10,3485711,1,,,,2448
10f9086a459f04579d953dc896706d4ee4d11397,0,Boyang Jerry Peng,2016-02-17 23:01:07-06:00,"['46999909a7c2f1a8b3e436f314971e9a21467547', '969ebaf76cded1efffe7c02cae675950ccee1c4b']",26,3053,3079,3488790,32,,,,2448
12a0936f10dca0886737c7d42ee22eed94e858de,0,Boyang Jerry Peng,2016-02-17 23:05:20-06:00,['10f9086a459f04579d953dc896706d4ee4d11397'],0,1,1,3488791,1,,,,2448
16a0c8d7b32aca74587d1b1f0271249f1d92486f,0,鍗箰,2016-02-18 16:46:26+08:00,['12a0936f10dca0886737c7d42ee22eed94e858de'],2,2,4,3488795,1,,,,2448
72d409c6065de1209ad00289f147b0f65accef16,0,Xin Wang,2016-02-18 17:17:57+08:00,['f9184624f18094beb1bb7e9f60e5665225dfb0ee'],1,1,2,3488797,1,,,,2448
8aff56fb0640a9807acbfa359a43200be46de203,0,zhongyan.feng,2016-02-18 17:36:30+08:00,['12a0936f10dca0886737c7d42ee22eed94e858de'],0,10,10,3488807,2,,,,2448
bb60f11c0cee7698ec77be947b4e707c7ed34c44,0,zhongyan.feng,2016-02-18 19:51:08+08:00,"['8aff56fb0640a9807acbfa359a43200be46de203', '9f168d267b685a65b69d8f778c96c05c7d5784c6']",30,37,67,3488874,4,,,,2448
56004150b229f50c5198233ad436420c1aa981ff,0,wuchong,2016-02-18 21:03:13+08:00,['bb60f11c0cee7698ec77be947b4e707c7ed34c44'],4,4,8,3488882,1,,,,2448
5e4c0a74dbda21d45b2206e929b173fa14833d71,0,Robert (Bobby) Evans,2016-02-18 10:00:19-06:00,"['bb60f11c0cee7698ec77be947b4e707c7ed34c44', 'de9cb106f3a68f8b13d16a39b242cecd7e5b0513']",519,1636,2155,3491037,38,,,,2448
d187a20e22983fc8b4433883e895727ce0467ec0,0,Robert (Bobby) Evans,2016-02-18 10:00:53-06:00,['5e4c0a74dbda21d45b2206e929b173fa14833d71'],0,1,1,3491038,1,,,,2448
bcb40e481f189cc9f77ddcaeddf7d4daa556113b,0,Julien Nioche,2016-02-18 16:25:40+00:00,['bb60f11c0cee7698ec77be947b4e707c7ed34c44'],7,7,14,3491052,4,,,,2448
0a5813abb643ff8c9398f2aa94ac40d01a6379d6,0,Boyang Jerry Peng,2016-02-18 10:32:05-06:00,['d187a20e22983fc8b4433883e895727ce0467ec0'],0,50,50,3491102,1,1,1,1,2449
7f582529a2a896786b809ce7b1619ab52f45431a,0,Boyang Jerry Peng,2016-02-18 10:32:05-06:00,['0a5813abb643ff8c9398f2aa94ac40d01a6379d6'],50,199,249,3491351,2,0.772727273,0.772727273,0.681818182,2450
4243e4e0cf9b9ea4c2aa8efa0a37a78120f2b687,0,Boyang Jerry Peng,2016-02-18 10:35:46-06:00,['7f582529a2a896786b809ce7b1619ab52f45431a'],329,682,1011,3492362,10,0,0.782608696,0.47826087,2451
b09d8ca14798cb1b344038be5bea4fb53428d6a2,0,Boyang Jerry Peng,2016-02-18 10:35:56-06:00,['4243e4e0cf9b9ea4c2aa8efa0a37a78120f2b687'],387,43,430,3492792,10,0.363636364,0.272727273,0.454545455,2451
2d06efe7c62d85a3187c03523bfee7474b963304,1,Boyang Jerry Peng,2016-02-18 10:37:22-06:00,['b09d8ca14798cb1b344038be5bea4fb53428d6a2'],286,225,511,3493303,6,1,0.315789474,0.105263158,2451
0e941dae57916830883d21a1ca7ed38a7ec67874,0,Boyang Jerry Peng,2016-02-18 10:37:29-06:00,['2d06efe7c62d85a3187c03523bfee7474b963304'],8,2,10,3493313,1,1,0,0.5,2451
6e6a00031d0100e6d44db57cb59ecdffe907149d,0,Boyang Jerry Peng,2016-02-18 10:37:29-06:00,['0e941dae57916830883d21a1ca7ed38a7ec67874'],2,3,5,3493318,1,,,,2451
85ae7fabfb03c1971c39340e924fd2137d1f6ba7,0,Robert (Bobby) Evans,2016-02-18 10:58:59-06:00,"['d187a20e22983fc8b4433883e895727ce0467ec0', '6e6a00031d0100e6d44db57cb59ecdffe907149d']",280,422,702,3494020,9,,,,2451
561cecaab24e13233d4465489a12f39acf873d13,0,Robert (Bobby) Evans,2016-02-18 10:59:41-06:00,['85ae7fabfb03c1971c39340e924fd2137d1f6ba7'],0,1,1,3494021,1,,,,2451
dca0e8476f5e55e5b8f8f064e9e47cfd8c3e27c5,1,Maciek Pr贸chniak,2016-02-18 19:22:27+01:00,['561cecaab24e13233d4465489a12f39acf873d13'],11,4,15,3494036,1,1,0,0,2451
02ae42ebe8e42da7a567c2a49309dd6ca4aa5155,0,Maciek Pr贸chniak,2016-02-18 19:32:18+01:00,['dca0e8476f5e55e5b8f8f064e9e47cfd8c3e27c5'],4,4,8,3494044,1,1,0,0,2451
a26f81187c3ea54e05584d31b5eedb66d9600a17,0,Kishor Patil,2016-02-18 13:25:17-06:00,['561cecaab24e13233d4465489a12f39acf873d13'],1,9,10,3494054,1,,,,2451
4bf331d668c279f2f6e462c1bfcaebffa06082f1,0,Abhishek Agarwal,2016-02-19 00:45:40+05:18,['561cecaab24e13233d4465489a12f39acf873d13'],177,209,386,3494440,7,1,1,1,2452
e904053a819bfe53fd280ad7d3b2061a805d83a1,0,Sriharsha Chintalapani,2016-02-18 12:40:16-08:00,"['561cecaab24e13233d4465489a12f39acf873d13', '8749523cf78f9a466aaf68399287f8e48a7e0132']",3,3,6,3494446,1,,,,2452
abb1b85f2bb8aab6bde52a4b5cecd4b22e11c7e6,0,Sriharsha Chintalapani,2016-02-18 12:41:39-08:00,['e904053a819bfe53fd280ad7d3b2061a805d83a1'],0,1,1,3494447,1,,,,2452
bc38f530e4c192055dd4107cb92c9236e8a34b5e,0,Sriharsha Chintalapani,2016-02-18 12:58:25-08:00,"['abb1b85f2bb8aab6bde52a4b5cecd4b22e11c7e6', '4bf331d668c279f2f6e462c1bfcaebffa06082f1']",177,209,386,3494833,7,,,,2452
8052a8c780bc7864861fbdfe70d453ed7a87d7f0,0,Sriharsha Chintalapani,2016-02-18 13:57:51-08:00,['bc38f530e4c192055dd4107cb92c9236e8a34b5e'],0,1,1,3494834,1,,,,2452
2040fee56e9a3c0614cd50e30a93389ea2843a77,1,xiaojian.fxj,2016-02-19 08:59:43+08:00,['46999909a7c2f1a8b3e436f314971e9a21467547'],0,426,426,3495260,3,0.50390625,0.9453125,0.93359375,2454
0803c484ebbf7d572aa3d31ca10794617e4d4bad,0,xiaojian.fxj,2016-02-19 09:08:15+08:00,"['9635e391c380ca160cb408e28eb3364b42851a60', '46999909a7c2f1a8b3e436f314971e9a21467547']",300,1593,1893,3497153,31,,,,2454
4f2d3a96bc4cd19a66529665063b6e8ce406b448,0,xiaojian.fxj,2016-02-19 09:32:28+08:00,"['0803c484ebbf7d572aa3d31ca10794617e4d4bad', '8052a8c780bc7864861fbdfe70d453ed7a87d7f0']",1017,5360,6377,3503530,82,,,,2454
370daf72d9346f13940c104a7de7af0241dc699d,0,xiaojian.fxj,2016-02-19 10:17:34+08:00,['98fb253e522f8c0c3902d48485896a80602f8950'],11,6,17,3503547,2,0,0,0,2454
588423a4df2f38e09091ca4033d6f4176c4d1675,0,xiaojian.fxj,2016-02-19 10:50:35+08:00,"['370daf72d9346f13940c104a7de7af0241dc699d', '8052a8c780bc7864861fbdfe70d453ed7a87d7f0']",1022,5359,6381,3509928,81,,,,2454
f3cd08a36238bd6f8d0b53210364ffca1c86c5e8,0,Longda Feng,2016-02-19 11:14:03+08:00,['4f2d3a96bc4cd19a66529665063b6e8ce406b448'],0,1,1,3509929,1,,,,2454
d0cd52b7bcb3267fa7bc4fb6cb023d968a0dda26,0,Longda Feng,2016-02-19 11:17:22+08:00,['f3cd08a36238bd6f8d0b53210364ffca1c86c5e8'],0,1,1,3509930,1,,,,2454
d912d50a7fcb82883543e004f801490cf41865a2,0,Alessandro Bellina,2016-02-18 22:15:42-06:00,['a8edd512c903d44bf26a57cace8f848cc4660738'],26,41,67,3509997,3,1,1,1,2454
0ca49ab4fdb73ad8b920bb9c8a942fefebd6543c,0,Alessandro Bellina,2016-02-18 22:17:25-06:00,['d912d50a7fcb82883543e004f801490cf41865a2'],8,14,22,3510019,1,1,1,1,2454
8b7536b34d7382f39c3b99319b5ffb703c9658ec,0,xiaojian.fxj,2016-02-19 14:55:18+08:00,"['588423a4df2f38e09091ca4033d6f4176c4d1675', 'd0cd52b7bcb3267fa7bc4fb6cb023d968a0dda26']",93,130,223,3510242,5,,,,2454
afcd0c6c53aca7f99d39f10b91a7b45fda424fe5,1,xiaojian.fxj,2016-02-19 15:22:22+08:00,['d5463879c0441a5a57eb23653a70bcf95d2efbaf'],146,156,302,3510544,16,0,0,0,2455
cc1f6d77962ec96c69cf5af85e4016a9e08ccdcc,0,xiaojian.fxj,2016-02-19 16:47:42+08:00,"['afcd0c6c53aca7f99d39f10b91a7b45fda424fe5', 'd0cd52b7bcb3267fa7bc4fb6cb023d968a0dda26']",1053,5431,6484,3517028,83,,,,2455
1bd2b061d44fef3638ab8b2e1bf3c1311967b208,0,xiaojian.fxj,2016-02-19 17:00:24+08:00,['8b7536b34d7382f39c3b99319b5ffb703c9658ec'],2,2,4,3517032,1,,,,2455
ad95d23971a2b69e1737176f35b09cf04e097154,0,Xin Wang,2016-02-19 18:34:57+08:00,['12ceb09758e57e699436514e3fc69994da1415b8'],1,1,2,3517034,1,,,,2455
90f2eaa184c1257c7a88049722b24cdd424db1c2,0,Robert (Bobby) Evans,2016-02-19 08:21:53-06:00,"['d0cd52b7bcb3267fa7bc4fb6cb023d968a0dda26', '1bd2b061d44fef3638ab8b2e1bf3c1311967b208']",86,154,240,3517274,4,,,,2455
35037d6729563065fbfd4eb8b1b423bf64371c2c,0,Robert (Bobby) Evans,2016-02-19 08:43:15-06:00,['90f2eaa184c1257c7a88049722b24cdd424db1c2'],0,1,1,3517275,1,,,,2455
314d58db60bb4490e71055acd82978e20681c89e,1,zhuol,2016-02-19 13:04:35-06:00,['35037d6729563065fbfd4eb8b1b423bf64371c2c'],58,99,157,3517432,4,1,1,1,2456
02349acca45ea45574d28ac1790193e9bc6ba9f0,0,zhuol,2016-02-19 13:04:35-06:00,['314d58db60bb4490e71055acd82978e20681c89e'],14,5,19,3517451,1,0,0,0,2456
1c974b8f325e5843e1303f423c3d6c0a6e0d4bd9,0,zhuol,2016-02-19 13:04:35-06:00,['02349acca45ea45574d28ac1790193e9bc6ba9f0'],2,4,6,3517457,1,0,0,0,2456
bbdad03967962dfd017b9ecfb3f83f1d53df7595,0,Kishor Patil,2016-02-19 13:52:16-06:00,['a26f81187c3ea54e05584d31b5eedb66d9600a17'],9,12,21,3517478,1,,,,2456
8768c3785cdfc078daab52912bf85b45a3ccee8a,0,Kishor Patil,2016-02-19 13:59:03-06:00,"['bbdad03967962dfd017b9ecfb3f83f1d53df7595', '35037d6729563065fbfd4eb8b1b423bf64371c2c']",359,499,858,3518336,14,,,,2456
4b946805609f703e483435ec992dfb0aa60d7979,0,P. Taylor Goetz,2016-02-19 14:59:32-05:00,"['35037d6729563065fbfd4eb8b1b423bf64371c2c', '5fe7559aa1ac9bc12accdc2af7ded2f43bea1cf0']",11,12,23,3518359,1,,,,2456
e543bbf8157eedd734047c96f4be7cf664349aae,0,P. Taylor Goetz,2016-02-19 15:01:00-05:00,['4b946805609f703e483435ec992dfb0aa60d7979'],0,1,1,3518360,1,,,,2456
eddfea3615a54834425582649a2fb9ba9706dc1c,0,Kishor Patil,2016-02-19 14:21:11-06:00,"['61c9702a924eb6b1b8bd3f0a829678a50f02bb67', 'e543bbf8157eedd734047c96f4be7cf664349aae']",1493,7234,8727,3527087,111,,,,2456
97ff9d29d252b253c60b9cbc2ec3d3836b3bacc3,0,P. Taylor Goetz,2016-02-19 15:22:25-05:00,"['e543bbf8157eedd734047c96f4be7cf664349aae', '7852bc24f051b7c5dd95835d473b99ed531e353c']",2,4,6,3527093,1,,,,2456
f4c6babb5d7bf23fed3daf3ef6e81f5aba22c3fc,0,P. Taylor Goetz,2016-02-19 15:23:42-05:00,['97ff9d29d252b253c60b9cbc2ec3d3836b3bacc3'],0,1,1,3527094,1,,,,2456
4ca7522d1bf24fe030a0913607f54ce8d14cd825,0,P. Taylor Goetz,2016-02-19 15:33:42-05:00,['f4c6babb5d7bf23fed3daf3ef6e81f5aba22c3fc'],0,0,0,3527094,0,,,,2456
85504e2b651363db2b991b00b35e3c866311aa6d,0,Kishor Patil,2016-02-19 15:15:16-06:00,"['81a287652365a2b0d8e656e61d6d93f668fac845', '4ca7522d1bf24fe030a0913607f54ce8d14cd825']",3687,10189,13876,3540970,163,,,,2456
fe547cc629e2933ad66605d549efaa7dcd7247b1,0,Julien Nioche,2016-02-19 22:28:29+00:00,['bcb40e481f189cc9f77ddcaeddf7d4daa556113b'],10,10,20,3540990,4,,,,2456
b7bc9bf9bd0793f2acbf158651e3200b30f97d99,0,xiaojian.fxj,2016-02-21 10:30:05+08:00,['cc1f6d77962ec96c69cf5af85e4016a9e08ccdcc'],1,1,2,3540992,1,,,,2456
3717f3931e51825f16739cbed138e9789b7d1428,0,xiaojian.fxj,2016-02-21 12:59:50+08:00,"['b7bc9bf9bd0793f2acbf158651e3200b30f97d99', '4ca7522d1bf24fe030a0913607f54ce8d14cd825']",99,173,272,3541264,7,,,,2456
fc84e52342bb48c17eb4795face50d35820a8d56,0,鍗箰,2016-02-21 14:06:24+08:00,"['16a0c8d7b32aca74587d1b1f0271249f1d92486f', '4ca7522d1bf24fe030a0913607f54ce8d14cd825']",1173,2596,3769,3545033,58,,,,2456
defcb9601d8f4d287fa4f1d6de7ee43d8183b137,0,Xin Wang,2016-02-21 17:20:09+08:00,['72d409c6065de1209ad00289f147b0f65accef16'],35,28,63,3545096,2,0,0,1,2456
6d43f369a8a16fbf05ca1032e177bb106ad43ca8,0,Maciek Pr贸chniak,2016-02-21 20:31:36+01:00,['02ae42ebe8e42da7a567c2a49309dd6ca4aa5155'],5,2,7,3545103,1,0,0,0,2456
f54f2cf4e72091fd75c2b3f365caf3dcf31735e1,0,basti.lj,2016-02-22 10:22:22+08:00,"['4e26f06b2d7d343953985ed611b58193c4246bbb', '4ca7522d1bf24fe030a0913607f54ce8d14cd825']",1495,7239,8734,3553837,111,,,,2456
ef6dfb9943163d80ff1355e6e1cfcac977d2b8cd,0,Satish Duggana,2016-02-22 11:50:26+05:18,['4ca7522d1bf24fe030a0913607f54ce8d14cd825'],1,2,3,3553840,1,,,,2456
045dd814e6f5beec7b560d5435de71612ef04ade,0,ablecao,2016-02-22 17:36:54+08:00,['4ca7522d1bf24fe030a0913607f54ce8d14cd825'],1,1,2,3553842,1,,,,2456
4d89303081c6563fa2b567059074773d4e80f04b,0,鍗箰,2016-02-22 18:54:41+08:00,['fc84e52342bb48c17eb4795face50d35820a8d56'],1,1,2,3553844,1,,,,2456
3425e7d12f514c976fa793f31dcbeafa1527bab4,1,Abhishek Agarwal,2016-02-22 16:25:57+05:18,['4ca7522d1bf24fe030a0913607f54ce8d14cd825'],122,272,394,3554238,6,0.582524272,1,1,2458
8aaa83880de7a5bc9595a6e3aabc242c3bec5470,0,Abhishek Agarwal,2016-02-22 16:26:43+05:18,['3425e7d12f514c976fa793f31dcbeafa1527bab4'],47,127,174,3554412,3,0.44,1,1,2460
93b314cf6e092e42c6cd6116618bfce94797c5cf,0,Abhishek Agarwal,2016-02-22 16:27:10+05:18,['8aaa83880de7a5bc9595a6e3aabc242c3bec5470'],37,65,102,3554514,2,0,0,1,2461
2d4ad6f4655ff56057d50f359394ecd01fde43eb,1,Abhishek Agarwal,2016-02-22 16:36:28+05:18,['93b314cf6e092e42c6cd6116618bfce94797c5cf'],4,4,8,3554522,2,,,,2461
86e9254b1f7180275c9708dffe13a8c7fa88e16b,0,Abhishek Agarwal,2016-02-22 17:57:25+05:18,['4ca7522d1bf24fe030a0913607f54ce8d14cd825'],3,3,6,3554528,2,,,,2461
9603e30961dbb2391bf309031f64c29f808277f7,0,basti.lj,2016-02-22 22:08:43+08:00,['f54f2cf4e72091fd75c2b3f365caf3dcf31735e1'],76,20,96,3554624,5,,,,2461
14b993a882cf8d416f144a5a3cf4cb8d87a8811d,0,basti.lj,2016-02-22 22:21:20+08:00,['9603e30961dbb2391bf309031f64c29f808277f7'],2,2,4,3554628,1,,,,2461
f0b91a16a4353dc142aac9e81ee033b7c12f5c6a,0,zhuol,2016-02-22 16:57:54-06:00,['1c974b8f325e5843e1303f423c3d6c0a6e0d4bd9'],1,1,2,3554630,1,,,,2461
7562da30b8af433a5531e251fc778c6b9d8f1c88,0,zhuol,2016-02-22 17:02:16-06:00,"['4ca7522d1bf24fe030a0913607f54ce8d14cd825', 'f0b91a16a4353dc142aac9e81ee033b7c12f5c6a']",58,92,150,3554780,4,,,,2461
87cfe888f31edadcf6b4f95b0511f3b6c1c0c49c,1,Jark Wu,2016-02-23 11:35:33+08:00,['d0cd52b7bcb3267fa7bc4fb6cb023d968a0dda26'],350,507,857,3555637,7,0.51627907,0.734883721,0.437209302,2463
480256e9a336c44dd9f605a52d98a13d85e0d2da,0,Jark Wu,2016-02-23 11:37:00+08:00,"['87cfe888f31edadcf6b4f95b0511f3b6c1c0c49c', '7562da30b8af433a5531e251fc778c6b9d8f1c88']",156,264,420,3556057,10,,,,2463
2854d9ee357bf2b03af5801ffe64b3380bd621b6,0,xiaojian.fxj,2016-02-23 12:18:31+08:00,['2040fee56e9a3c0614cd50e30a93389ea2843a77'],13,12,25,3556082,2,,,,2463
84b81fe560c72f36ec130c9374aab0b15e471b03,0,Arun Mahadevan,2016-02-23 13:34:25+05:18,"['7562da30b8af433a5531e251fc778c6b9d8f1c88', '4d89303081c6563fa2b567059074773d4e80f04b']",2,2,4,3556086,1,,,,2463
a3abb6599bb42de24ffa729965d751c21354634f,0,Arun Mahadevan,2016-02-23 13:36:17+05:18,['84b81fe560c72f36ec130c9374aab0b15e471b03'],0,1,1,3556087,1,,,,2463
652ba36c5a75c230638b2f5bbbdfd909c2b23df0,0,Arun Mahadevan,2016-02-23 13:50:58+05:18,"['a3abb6599bb42de24ffa729965d751c21354634f', 'ef6dfb9943163d80ff1355e6e1cfcac977d2b8cd']",1,2,3,3556090,1,,,,2463
58050a5b3e8972717ccf2227e3e8bbdd8034fb43,0,Arun Mahadevan,2016-02-23 13:52:48+05:18,['652ba36c5a75c230638b2f5bbbdfd909c2b23df0'],0,1,1,3556091,1,,,,2463
581cd29876fab988477ac661174cad5ffbeced1e,0,xiaojian.fxj,2016-02-23 19:56:06+08:00,"['3717f3931e51825f16739cbed138e9789b7d1428', '58050a5b3e8972717ccf2227e3e8bbdd8034fb43']",61,98,159,3556250,8,,,,2463
d70952513336532c80957e5398bfbedacff78cb7,0,xiaojian.fxj,2016-02-23 22:05:50+08:00,['581cd29876fab988477ac661174cad5ffbeced1e'],6,5,11,3556261,2,,,,2463
3af457f8cd3dec53af969a70f7f5238b4502dada,0,xiaojian.fxj,2016-02-23 23:11:44+08:00,['58050a5b3e8972717ccf2227e3e8bbdd8034fb43'],4,9,13,3556274,2,0,0.4,1,2463
27373baee746f7baba2a60e06054590afd687976,0,darionyaphet,2016-02-23 23:20:29+08:00,['58050a5b3e8972717ccf2227e3e8bbdd8034fb43'],3,2,5,3556279,1,1,1,0,2463
24a87af2c4a1aa6f03c0ccdabccde8ecb322bd99,0,Parth Brahmbhatt,2016-02-23 10:28:05-08:00,['7562da30b8af433a5531e251fc778c6b9d8f1c88'],2,11,13,3556292,3,,,,2463
bc33bc25b2b3da1ed7b0960119167e8421afee49,0,Robert (Bobby) Evans,2016-02-23 14:08:10-06:00,"['58050a5b3e8972717ccf2227e3e8bbdd8034fb43', '0ca49ab4fdb73ad8b920bb9c8a942fefebd6543c']",118,342,460,3556752,5,,,,2463
53446108bfb286edc527449c5c62820c200cf757,0,Robert (Bobby) Evans,2016-02-23 14:09:17-06:00,['bc33bc25b2b3da1ed7b0960119167e8421afee49'],1,3,4,3556756,2,,,,2463
92fbce935c8481cc88d232d4eaf942304eecf8a1,0,Robert (Bobby) Evans,2016-02-23 14:24:55-06:00,"['53446108bfb286edc527449c5c62820c200cf757', 'f7d59601ae54128ab9effa1baa8933d81b7e317b']",4,6,10,3556766,1,,,,2463
adfd75b000cdfa009d5a37efdb58c6c51697ab04,0,Robert (Bobby) Evans,2016-02-23 14:25:20-06:00,['92fbce935c8481cc88d232d4eaf942304eecf8a1'],0,1,1,3556767,1,,,,2463
11232b5395097feddcd6f998aa573eeb93cc3869,0,Robert (Bobby) Evans,2016-02-23 14:33:06-06:00,"['adfd75b000cdfa009d5a37efdb58c6c51697ab04', 'e72f35fe001b82bae6ad94402ce0700002cb7961']",1,1,2,3556769,1,,,,2463
908b2864dd403c82ab9aaee78eb5898728e8e7e0,0,Hugo Louro,2016-02-23 15:01:32-08:00,['11232b5395097feddcd6f998aa573eeb93cc3869'],1,1,2,3556771,1,,,,2463
b09e2755c2fedcb9048afda63bea897fe1dbd12b,0,xiaojian.fxj,2016-02-24 11:19:06+08:00,['d70952513336532c80957e5398bfbedacff78cb7'],111,74,185,3556956,9,1,1,0.756756757,2463
0af6799411c747a6c900438ded222b7d757c7961,0,xiaojian.fxj,2016-02-24 11:20:00+08:00,"['b09e2755c2fedcb9048afda63bea897fe1dbd12b', '11232b5395097feddcd6f998aa573eeb93cc3869']",124,353,477,3557433,8,,,,2463
d89f7027fcaf5576b5b4a14488f42c71094617ad,0,darionyaphet,2016-02-24 12:34:54+08:00,['27373baee746f7baba2a60e06054590afd687976'],3,2,5,3557438,1,0,0,1,2463
5c81f0c7ff1e344d9996912dd20038fde32dc505,1,Jark Wu,2016-02-24 18:09:01+08:00,['480256e9a336c44dd9f605a52d98a13d85e0d2da'],173,194,367,3557805,7,1,0.166666667,1,2464
afd2d525be396c6f430e6a4a13cd1f237496a473,0,鍗箰,2016-02-24 21:06:25+08:00,['11232b5395097feddcd6f998aa573eeb93cc3869'],1658,84,1742,3559547,8,,,,2464
52d3b587f07db7dcf66b774531e2face7247c7b6,1,鍗箰,2016-02-24 21:12:53+08:00,['afd2d525be396c6f430e6a4a13cd1f237496a473'],0,2354,2354,3561901,4,0.372655777,0.748941319,0.601935874,2468
1b5d9a85021ff4c7bb8e95a55a225277babb2378,0,Robert (Bobby) Evans,2016-02-24 09:45:14-06:00,"['11232b5395097feddcd6f998aa573eeb93cc3869', '0af6799411c747a6c900438ded222b7d757c7961']",1635,2307,3942,3565843,42,,,,2468
71d615b7cc9a96b6667b976a25dc86ef54a66169,0,Robert (Bobby) Evans,2016-02-24 09:46:03-06:00,['1b5d9a85021ff4c7bb8e95a55a225277babb2378'],0,1,1,3565844,1,,,,2468
1a83267f5cacdff7db3934e3b0f00123357e2a4d,0,Robert (Bobby) Evans,2016-02-24 10:30:34-06:00,"['71d615b7cc9a96b6667b976a25dc86ef54a66169', '3af457f8cd3dec53af969a70f7f5238b4502dada']",4,9,13,3565857,2,,,,2468
9e65c1141fcd4141da5e46e36acffea0fc29ace4,0,Robert (Bobby) Evans,2016-02-24 10:41:40-06:00,['1a83267f5cacdff7db3934e3b0f00123357e2a4d'],1,1,2,3565859,1,,,,2468
56bc60374acc61554615d771c09f3c84b8a4ba14,0,Robert (Bobby) Evans,2016-02-24 10:41:57-06:00,['9e65c1141fcd4141da5e46e36acffea0fc29ace4'],0,1,1,3565860,1,,,,2468
b83759074b7b0e7b1727dd4fac1c2b5ab9c4cdad,0,Robert (Bobby) Evans,2016-02-24 11:30:24-06:00,"['56bc60374acc61554615d771c09f3c84b8a4ba14', '2d4ad6f4655ff56057d50f359394ecd01fde43eb']",200,458,658,3566518,13,,,,2468
dece08fbdee7903c76c227e3ec638e57705856cd,0,Robert (Bobby) Evans,2016-02-24 11:32:42-06:00,['b83759074b7b0e7b1727dd4fac1c2b5ab9c4cdad'],0,3,3,3566521,1,,,,2468
6a86e2219c780cb22fb76ac8295f02ab8c4f390e,0,Robert (Bobby) Evans,2016-02-24 11:47:14-06:00,"['dece08fbdee7903c76c227e3ec638e57705856cd', 'ad95d23971a2b69e1737176f35b09cf04e097154']",1,1,2,3566523,1,,,,2468
0e91995556213ec34f8ffbecc6b3bce3d3102c52,0,Robert (Bobby) Evans,2016-02-24 11:47:43-06:00,['6a86e2219c780cb22fb76ac8295f02ab8c4f390e'],0,1,1,3566524,1,,,,2468
bd396b3a4ec0c242f18725ddf43e35f26da51269,0,Kyle Nusbaum,2016-02-24 13:15:32-06:00,"['0e91995556213ec34f8ffbecc6b3bce3d3102c52', '24a87af2c4a1aa6f03c0ccdabccde8ecb322bd99']",2,11,13,3566537,3,,,,2468
455b2baf1d2cab4a478f16a288cc6a60923612c2,0,Kyle Nusbaum,2016-02-24 13:52:41-06:00,"['bd396b3a4ec0c242f18725ddf43e35f26da51269', 'd89f7027fcaf5576b5b4a14488f42c71094617ad']",6,4,10,3566547,2,,,,2468
dd00bc0a2a5d105cabc71b8eeaa132f93746de2a,0,Kyle Nusbaum,2016-02-24 13:56:13-06:00,['455b2baf1d2cab4a478f16a288cc6a60923612c2'],0,2,2,3566549,1,,,,2468
eaa3526f13871915bd3cbe70042cd4866b5a55f5,1,Derek Dagit,2016-02-24 16:17:32-06:00,['dd00bc0a2a5d105cabc71b8eeaa132f93746de2a'],11,6,17,3566566,3,,,,2468
96ca1ffa9460949c0bfe459f302a94128d5d70ce,0,Derek Dagit,2016-02-24 16:20:44-06:00,['eaa3526f13871915bd3cbe70042cd4866b5a55f5'],5,8,13,3566579,2,,,,2468
ee1a51993a4244dd6a3a112f70db0c8d74770557,1,zhuol,2016-02-24 16:56:39-06:00,['dd00bc0a2a5d105cabc71b8eeaa132f93746de2a'],14,113,127,3566706,7,0.333333333,1,0.941176471,2469
03f710c37127a69a9a6bb5377fdafadde1c0fc9a,0,zhuol,2016-02-24 17:01:44-06:00,['ee1a51993a4244dd6a3a112f70db0c8d74770557'],0,1,1,3566707,1,,,,2469
a1ef75f693a78de0c6952aadf4bdf2b2ebbef97e,1,zhuol,2016-02-24 19:45:42-06:00,['03f710c37127a69a9a6bb5377fdafadde1c0fc9a'],1,1,2,3566709,1,,,,2469
f61ea0c0196da4f31126f3f96ffb2bf5551a01d2,1,鍗箰,2016-02-25 10:59:42+08:00,['52d3b587f07db7dcf66b774531e2face7247c7b6'],159,139,298,3567007,7,,,1,2469
67a5878e5f37ccd317c10ef8dcbd56b9de233997,0,鍗箰,2016-02-25 13:10:07+08:00,"['f61ea0c0196da4f31126f3f96ffb2bf5551a01d2', 'dd00bc0a2a5d105cabc71b8eeaa132f93746de2a']",1846,2789,4635,3571642,60,,,,2469
880134881566427e886b01d44890d22db483f6bd,0,鍗箰,2016-02-25 13:11:50+08:00,['67a5878e5f37ccd317c10ef8dcbd56b9de233997'],13,17,30,3571672,6,,,,2469
e5564c0f888e40af2726a645d24cfad0aaeed26a,0,鍗箰,2016-02-25 15:06:59+08:00,['880134881566427e886b01d44890d22db483f6bd'],16,18,34,3571706,2,0.875,1,0.5,2469
a37ddbaa7a4c8b94a68efda94a74910333333820,1,manuzhang,2016-02-25 15:07:12+08:00,['dd00bc0a2a5d105cabc71b8eeaa132f93746de2a'],6,6,12,3571718,1,,,,2469
3fc80c4b0bfc83d2534fab160c72894af044dbc3,0,鍗箰,2016-02-25 15:25:58+08:00,['e5564c0f888e40af2726a645d24cfad0aaeed26a'],0,3,3,3571721,1,0,0,0,2469
4b5b952408d65f2072a5017f0541b49c1379f7dc,0,Abhishek Agarwal,2016-02-25 14:42:58+05:18,"['86e9254b1f7180275c9708dffe13a8c7fa88e16b', 'dd00bc0a2a5d105cabc71b8eeaa132f93746de2a']",2030,3246,5276,3576997,69,,,,2469
26453a36d60798d203721f308f16b87d25143485,0,zhuol,2016-02-25 11:41:25-06:00,['a1ef75f693a78de0c6952aadf4bdf2b2ebbef97e'],9,11,20,3577017,2,0,0,0,2469
f1dbe42b3213a4a040a5b4ca169421020fccc5a7,0,Robert (Bobby) Evans,2016-02-25 13:04:18-06:00,"['dd00bc0a2a5d105cabc71b8eeaa132f93746de2a', 'fe547cc629e2933ad66605d549efaa7dcd7247b1']",17,17,34,3577051,4,,,,2469
46488044b92567bd4ff21ba0299e575d8251f5ba,0,zhuol,2016-02-25 13:23:51-06:00,['26453a36d60798d203721f308f16b87d25143485'],19,0,19,3577070,1,1,0,0,2469
59d6bd832f21e5479cd056565d8203da5089b863,0,Arun Mahadevan,2016-02-26 01:08:35+05:18,['dd00bc0a2a5d105cabc71b8eeaa132f93746de2a'],4,74,78,3577148,2,0.468085106,1,1,2469
aa88360d7b07096a3c55d9f362aaef703bb8a581,0,Robert (Bobby) Evans,2016-02-25 14:43:09-06:00,"['f1dbe42b3213a4a040a5b4ca169421020fccc5a7', '5c81f0c7ff1e344d9996912dd20038fde32dc505']",293,471,764,3577912,7,,,,2469
838ae3390d9ad33ca66ea10b2247940067d38355,0,Robert (Bobby) Evans,2016-02-25 14:43:41-06:00,['aa88360d7b07096a3c55d9f362aaef703bb8a581'],0,1,1,3577913,1,,,,2469
bc35766a2e542a3d3b3c0df52125b67118330578,0,zhuol,2016-02-25 16:00:47-06:00,['46488044b92567bd4ff21ba0299e575d8251f5ba'],5,6,11,3577924,2,0,1,1,2469
cdf139bf0a3a7c18552208407198b39112a26a72,0,Jungtaek Lim,2016-02-25 15:04:53-08:00,"['838ae3390d9ad33ca66ea10b2247940067d38355', '0f0dea0b4d2b17d6e8dc32e82341b8aec70ef6e9']",2,20,22,3577946,2,,,,2469
8fa5aa537a806539a8542af40b8ed68921601afc,0,zhuol,2016-02-25 17:12:44-06:00,"['838ae3390d9ad33ca66ea10b2247940067d38355', 'bc35766a2e542a3d3b3c0df52125b67118330578']",15,99,114,3578060,7,,,,2469
73959526c324da1a72aaac8b48e528a9e2118c8d,0,Jungtaek Lim,2016-02-25 15:12:46-08:00,['cdf139bf0a3a7c18552208407198b39112a26a72'],0,1,1,3578061,1,,,,2469
c193a90c543ec3236391edc0cc133e45efcfa72a,0,Jungtaek Lim,2016-02-25 15:34:09-08:00,"['73959526c324da1a72aaac8b48e528a9e2118c8d', '8fa5aa537a806539a8542af40b8ed68921601afc']",15,99,114,3578175,7,,,,2469
fd5a2dee367288d401ebb3d20649418cb9d3159f,0,Jungtaek Lim,2016-02-25 16:48:05-08:00,"['c193a90c543ec3236391edc0cc133e45efcfa72a', '4b5b952408d65f2072a5017f0541b49c1379f7dc']",3,3,6,3578181,2,,,,2469
2cacef6a5ab7d6b6c196406be821f9c024a66165,0,Jungtaek Lim,2016-02-25 16:58:37-08:00,['fd5a2dee367288d401ebb3d20649418cb9d3159f'],0,1,1,3578182,1,,,,2469
0fc58437badb0f6b464141889d532dea87ff4457,0,Jungtaek Lim,2016-02-25 17:16:43-08:00,"['2cacef6a5ab7d6b6c196406be821f9c024a66165', '6d43f369a8a16fbf05ca1032e177bb106ad43ca8']",14,4,18,3578200,1,,,,2469
ea35ecdcad22ca104d906fbcc0e2eb6a196c34b5,0,jinhong-lu,2016-02-26 09:30:46+08:00,['11232b5395097feddcd6f998aa573eeb93cc3869'],2,2,4,3578204,2,,,,2469
8b622cee0754f0cf6c108af06caf03651760db8f,0,Jungtaek Lim,2016-02-25 17:34:54-08:00,['0fc58437badb0f6b464141889d532dea87ff4457'],0,2,2,3578206,1,,,,2469
f86c2525e4ff119100024bd0ea6373e679648f61,0,Jungtaek Lim,2016-02-25 18:22:03-08:00,"['8b622cee0754f0cf6c108af06caf03651760db8f', '96ca1ffa9460949c0bfe459f302a94128d5d70ce']",13,11,24,3578230,4,,,,2469
73312ad56060567ffde044515d8193ed94f3b07f,0,Jungtaek Lim,2016-02-25 18:22:48-08:00,['f86c2525e4ff119100024bd0ea6373e679648f61'],0,1,1,3578231,1,,,,2469
08934e29982d3936c9e247a8d7bac563053f869f,1,xiaojian.fxj,2016-02-26 12:38:23+08:00,['73312ad56060567ffde044515d8193ed94f3b07f'],0,2892,2892,3581123,17,0.363583138,0.503512881,0.553278689,2486
b281c735f0089d24407af67586a1b41de45ac382,0,xiaojian.fxj,2016-02-26 13:15:56+08:00,['08934e29982d3936c9e247a8d7bac563053f869f'],20,71,91,3581214,5,1,1,1,2487
f819b4999eac052840ff69552198b184afa0c1e0,0,鍗箰,2016-02-26 14:02:45+08:00,"['3fc80c4b0bfc83d2534fab160c72894af044dbc3', '8b622cee0754f0cf6c108af06caf03651760db8f']",343,617,960,3582174,24,,,,2487
e0e9de7d01bb09e6593093cc9324b09f03abb55c,0,鍗箰,2016-02-26 14:03:35+08:00,['f819b4999eac052840ff69552198b184afa0c1e0'],1,2,3,3582177,1,,,,2487
43ca7950609573dc0ba1d7b016083bdf6fcea4ee,0,Jark Wu,2016-02-26 14:05:32+08:00,['dd00bc0a2a5d105cabc71b8eeaa132f93746de2a'],76,154,230,3582407,3,0.795180723,1,1,2488
9178b1c8fb7a77dde0608a285d9adc8d0b767867,0,xiaojian.fxj,2016-02-26 14:13:23+08:00,"['2854d9ee357bf2b03af5801ffe64b3380bd621b6', '73312ad56060567ffde044515d8193ed94f3b07f']",3433,9374,12807,3595214,150,,,,2488
bfbd3753d62ade9675bba3e0676417f673cde3a3,0,鍗箰,2016-02-26 20:34:09+08:00,"['e0e9de7d01bb09e6593093cc9324b09f03abb55c', '73312ad56060567ffde044515d8193ed94f3b07f']",13,12,25,3595239,5,,,,2488
802d28e607ce953664fcea7356eac98fb354683f,1,xiaojian.fxj,2016-02-26 22:02:56+08:00,['9178b1c8fb7a77dde0608a285d9adc8d0b767867'],356,153,509,3595748,9,0.766666667,0,1,2488
8e350d1cf1f16b0101d699de0016bb762061f1e3,0,xiaojian.fxj,2016-02-26 22:59:02+08:00,['802d28e607ce953664fcea7356eac98fb354683f'],2,3,5,3595753,2,,,,2488
69a25ba87d9b47e5b49a134835235f0eff913fb2,0,Sriharsha Chintalapani,2016-02-26 08:59:50-08:00,"['73312ad56060567ffde044515d8193ed94f3b07f', '59d6bd832f21e5479cd056565d8203da5089b863']",4,74,78,3595831,2,,,,2488
b7789365b466085ff148e5673a32859b2eaa395f,0,Sriharsha Chintalapani,2016-02-26 09:01:20-08:00,['69a25ba87d9b47e5b49a134835235f0eff913fb2'],0,1,1,3595832,1,,,,2488
491ff9856eaaa8bc0bab6dbc073016b920500216,0,xiaojian.fxj,2016-02-27 21:10:41+08:00,['8e350d1cf1f16b0101d699de0016bb762061f1e3'],113,105,218,3596050,3,0,1,0,2488
7ad548e353a83a77b6ed489f324f4cd0ac575056,1,Alessandro Bellina,2016-02-27 15:53:10-06:00,['b7789365b466085ff148e5673a32859b2eaa395f'],59,131,190,3596240,3,1,1,1,2489
07629c1f898ebb0cedcc19e15e4813692b6a9345,0,zhuol,2016-02-27 16:00:05-06:00,"['b7789365b466085ff148e5673a32859b2eaa395f', 'ea35ecdcad22ca104d906fbcc0e2eb6a196c34b5']",2,2,4,3596244,2,,,,2489
6e433c83c9ab581d8cbe9f7b42b97ffb8e25a0b4,0,basti.lj,2016-02-28 20:23:29+08:00,"['14b993a882cf8d416f144a5a3cf4cb8d87a8811d', '07629c1f898ebb0cedcc19e15e4813692b6a9345']",2390,3951,6341,3602585,93,,,,2489
c8138dc72d4f39fe1ebb09c42931d6cbd3198c7e,1,basti.lj,2016-02-28 21:50:09+08:00,['6e433c83c9ab581d8cbe9f7b42b97ffb8e25a0b4'],3,4,7,3602592,1,0,0,1,2489
034f0cf107403100650d6eb65e7168f62133864a,0,鍗箰,2016-02-28 22:33:21+08:00,['07629c1f898ebb0cedcc19e15e4813692b6a9345'],5,12,17,3602609,2,0,0,1,2489
504c11b8ead80e186ff0de83dbdece2337cd1162,0,鍗箰,2016-02-28 22:42:56+08:00,['034f0cf107403100650d6eb65e7168f62133864a'],1,1,2,3602611,1,,,,2489
abe9b676c0f15fa47809ae4a094001e345521de6,1,鍗箰,2016-02-29 11:49:26+08:00,['bfbd3753d62ade9675bba3e0676417f673cde3a3'],66,99,165,3602776,10,0,0,0,2489
cbc506c0b4e56ef70e640c268b5b57f845c0e1fe,0,Kishor Patil,2016-02-29 10:54:46-06:00,['07629c1f898ebb0cedcc19e15e4813692b6a9345'],1,1,2,3602778,1,,,,2489
2cabc3b70f0c70c483ee9faa14daa63c9fd21077,1,Abhishek Agarwal,2016-02-29 23:40:13+05:18,['07629c1f898ebb0cedcc19e15e4813692b6a9345'],41,69,110,3602888,5,0,0,1,2490
0f644360042a70d7cbbea3272fdf93903cc4e3ed,1,Arun Mahadevan,2016-02-29 23:57:40+05:18,['4ca7522d1bf24fe030a0913607f54ce8d14cd825'],27,223,250,3603138,10,0.685714286,1,0.935714286,2490
3f5d3b363a5546eb7ac4d8cadbb9136cbc8e553d,0,Dan Simmons,2016-02-29 15:08:22-05:00,['07629c1f898ebb0cedcc19e15e4813692b6a9345'],1,0,1,3603139,1,,,,2490
daec40455b61f6ae84ab1ef9f1514e15e45dc4e4,0,Alessandro Bellina,2016-02-29 17:55:29-06:00,['7ad548e353a83a77b6ed489f324f4cd0ac575056'],14,22,36,3603175,1,1,1,1,2490
c48d20938650359279efe743652c6e0503e7b32c,0,Longda Feng,2016-03-01 08:01:12+08:00,['c8138dc72d4f39fe1ebb09c42931d6cbd3198c7e'],0,1,1,3603176,1,,,,2490
9aa8bf0838ffe77d67af4c7cfaa9b184681f0fba,0,Longda Feng,2016-03-01 08:10:55+08:00,['c48d20938650359279efe743652c6e0503e7b32c'],0,4,4,3603180,1,,,,2490
a4d1ce43bced0db9d81fb1486de0700c193ebf25,0,鍗箰,2016-03-01 09:51:53+08:00,['504c11b8ead80e186ff0de83dbdece2337cd1162'],0,1,1,3603181,1,,,,2490
1c9b9504369594217532a18efb99bf4c5546efe0,0,鍗箰,2016-03-01 09:52:19+08:00,"['a4d1ce43bced0db9d81fb1486de0700c193ebf25', '9aa8bf0838ffe77d67af4c7cfaa9b184681f0fba']",119,150,269,3603450,7,,,,2490
9165b603985c0c158821cd5a20e6c509ee63342a,0,鍗箰,2016-03-01 09:55:50+08:00,['1c9b9504369594217532a18efb99bf4c5546efe0'],0,2,2,3603452,1,,,,2490
faaacaee046bfa4f458c19cade678515a021d836,0,鍗箰,2016-03-01 11:47:51+08:00,['abe9b676c0f15fa47809ae4a094001e345521de6'],6,17,23,3603475,1,0,0,1,2490
69f2906c0748826101511b1dd6005f910ebfd5fc,0,鍗箰,2016-03-01 11:49:59+08:00,"['faaacaee046bfa4f458c19cade678515a021d836', '9aa8bf0838ffe77d67af4c7cfaa9b184681f0fba']",124,226,350,3603825,10,,,,2490
dbe920a2f8b4e6a06f657b24e2df90fb5601333f,0,Sriharsha Chintalapani,2016-02-29 19:57:38-08:00,"['9aa8bf0838ffe77d67af4c7cfaa9b184681f0fba', '0f644360042a70d7cbbea3272fdf93903cc4e3ed']",27,223,250,3604075,10,,,,2490
87e3c246762b56ee8fd638662a9776fdf36c8ef5,0,Sriharsha Chintalapani,2016-02-29 19:58:14-08:00,['dbe920a2f8b4e6a06f657b24e2df90fb5601333f'],0,1,1,3604076,1,,,,2490
521b367aeec0526b762c5a5a9b2bea2b373e5fd5,1,Arun Mahadevan,2016-03-01 12:07:24+05:18,['87e3c246762b56ee8fd638662a9776fdf36c8ef5'],5,52,57,3604133,3,0.825,1,0.9,2490
0047279a71a98a4326c00929ca990e415d0fbce1,1,Arun Mahadevan,2016-03-01 13:46:16+05:18,['521b367aeec0526b762c5a5a9b2bea2b373e5fd5'],7,159,166,3604299,7,0.763157895,1,0.881578947,2491
4855c53a3d5505060fa86ae81650e51f175f16c4,0,Abhishek Agarwal,2016-03-01 20:33:30+05:18,['07629c1f898ebb0cedcc19e15e4813692b6a9345'],15,16,31,3604330,1,,,,2491
a23533cac02c53742e83e1049783c255489521f7,0,鍗箰,2016-03-01 23:34:58+08:00,['87e3c246762b56ee8fd638662a9776fdf36c8ef5'],61,130,191,3604521,2,1,1,1,2492
a6bcfbc45752fde31b27377893e630509b1b193f,0,Robert (Bobby) Evans,2016-03-01 10:58:45-06:00,['87e3c246762b56ee8fd638662a9776fdf36c8ef5'],7,2,9,3604530,1,0,0,0,2492
dab642bd356d106600d6cfdea09736bf3408dc87,0,Robert (Bobby) Evans,2016-03-01 11:24:56-06:00,"['87e3c246762b56ee8fd638662a9776fdf36c8ef5', '2cabc3b70f0c70c483ee9faa14daa63c9fd21077']",41,69,110,3604640,5,,,,2492
8fc0b92b168a95624a7d43eee4225192e65110bb,0,Robert (Bobby) Evans,2016-03-01 11:25:19-06:00,['dab642bd356d106600d6cfdea09736bf3408dc87'],0,1,1,3604641,1,,,,2492
6a0e86d6092ac32a842b7ac676d4e584f615584f,0,Robert (Bobby) Evans,2016-03-01 12:36:31-06:00,"['8fc0b92b168a95624a7d43eee4225192e65110bb', 'cbc506c0b4e56ef70e640c268b5b57f845c0e1fe']",1,1,2,3604643,1,,,,2492
9b92ed1db52ec7cd62c6786ae7a2ba9c4d4f3cd9,0,Robert (Bobby) Evans,2016-03-01 12:53:04-06:00,['6a0e86d6092ac32a842b7ac676d4e584f615584f'],0,1,1,3604644,1,,,,2492
d42c437254d533461c2cf4546a9f166dbbf7ca4b,0,Robert (Bobby) Evans,2016-03-01 13:18:18-06:00,['9b92ed1db52ec7cd62c6786ae7a2ba9c4d4f3cd9'],0,1,1,3604645,1,,,,2492
b1e4c94269dbcf2ba01aee89e468c744887c53de,0,Kishor Patil,2016-03-01 16:18:04-06:00,['d42c437254d533461c2cf4546a9f166dbbf7ca4b'],1,423,424,3605069,5,0.637305699,0.569948187,0.844559585,2496
d36be51a39abb03ac47e01eb2e1fda31f9f9110b,1,Stig D酶ssing,2016-03-01 23:52:36+01:00,['d42c437254d533461c2cf4546a9f166dbbf7ca4b'],10,108,118,3605187,12,0.857142857,0.857142857,1,2496
d1a9b3d0d622ab26a4243d9b77f4201fa88be657,0,xiaojian.fxj,2016-03-02 10:15:32+08:00,['491ff9856eaaa8bc0bab6dbc073016b920500216'],57,26,83,3605270,7,1,1,0,2496
b0c9574cbf2477d9c5a88a55c12f0541137669cf,0,xiaojian.fxj,2016-03-02 10:21:04+08:00,"['d1a9b3d0d622ab26a4243d9b77f4201fa88be657', 'd42c437254d533461c2cf4546a9f166dbbf7ca4b']",194,524,718,3605988,27,,,,2496
3def2364b37a631a3727ca5353949022e341cc0c,1,鍗箰,2016-03-02 11:11:05+08:00,['9165b603985c0c158821cd5a20e6c509ee63342a'],6,24,30,3606018,4,1,1,0,2496
ff11c8a0bfaf2ac4a0daa2d6b0399fb42f301cd5,0,鍗箰,2016-03-02 11:12:55+08:00,"['3def2364b37a631a3727ca5353949022e341cc0c', 'd42c437254d533461c2cf4546a9f166dbbf7ca4b']",69,297,366,3606384,17,,,,2496
122f0f47e049f4ddcc0f6b511654f84403da9742,0,鍗箰,2016-03-02 11:56:13+08:00,"['a23533cac02c53742e83e1049783c255489521f7', 'd42c437254d533461c2cf4546a9f166dbbf7ca4b']",42,73,115,3606499,7,,,,2496
68e5d03634b3d2ecf01be0e23466984977a18437,0,鍗箰,2016-03-02 11:57:06+08:00,['122f0f47e049f4ddcc0f6b511654f84403da9742'],97,99,196,3606695,8,1,1,1,2496
cccb9766eb6b01477b44cd35e836997811464632,0,Kishor Patil,2016-03-02 00:12:57-06:00,['b1e4c94269dbcf2ba01aee89e468c744887c53de'],247,184,431,3607126,8,0.257575758,0.696969697,0,2498
86d78d6c5b5f6ef22ababbeb64e7a140b79bdea2,0,Alessandro Bellina,2016-03-02 00:32:37-06:00,['daec40455b61f6ae84ab1ef9f1514e15e45dc4e4'],12,8,20,3607146,1,0,0,0,2498
035f47a0edbffe445f642bb5c6138d776a472bff,0,Abhishek Agarwal,2016-03-02 17:41:54+05:18,['d42c437254d533461c2cf4546a9f166dbbf7ca4b'],63,80,143,3607289,3,1,1,1,2499
4e04ce8dcdc33d488a3d15f7a47ab8af15136db4,0,Kishor Patil,2016-03-02 10:27:56-06:00,['cccb9766eb6b01477b44cd35e836997811464632'],10,32,42,3607331,4,1,1,1,2499
bc79b4a8d757a3191a85815877345d38710c73e2,1,Stig D酶ssing,2016-03-02 17:59:14+01:00,['d36be51a39abb03ac47e01eb2e1fda31f9f9110b'],1,11,12,3607343,3,0,0,1,2499
f68b4c6362e45af5b6cc7569e6d37982220947cd,0,Stig D酶ssing,2016-03-02 18:03:11+01:00,['bc79b4a8d757a3191a85815877345d38710c73e2'],1,1,2,3607345,1,,,,2499
0953ecaa6ecb01cde7c59973e12d3473795e3d86,0,Robert (Bobby) Evans,2016-03-02 11:15:43-06:00,"['d42c437254d533461c2cf4546a9f166dbbf7ca4b', 'ff11c8a0bfaf2ac4a0daa2d6b0399fb42f301cd5']",6,34,40,3607385,4,,,,2499
906fcea615944626ceec232318290b60fe6bc2b1,0,Robert (Bobby) Evans,2016-03-02 11:26:45-06:00,['0953ecaa6ecb01cde7c59973e12d3473795e3d86'],10,12,22,3607407,2,,,,2499
cfeaba42c0c4c3853efd76b6b5424648e3e535ce,0,Robert (Bobby) Evans,2016-03-02 12:23:29-06:00,"['906fcea615944626ceec232318290b60fe6bc2b1', 'a6bcfbc45752fde31b27377893e630509b1b193f']",7,2,9,3607416,1,,,,2499
df54280e333e5bf29cc4bbab7a29d9f3b245f4fd,0,Robert (Bobby) Evans,2016-03-02 12:23:48-06:00,['cfeaba42c0c4c3853efd76b6b5424648e3e535ce'],0,1,1,3607417,1,,,,2499
5e2d44df8c342d29d723ac4ac90d0e1efb6884bb,0,Kishor Patil,2016-03-02 12:32:00-06:00,['4e04ce8dcdc33d488a3d15f7a47ab8af15136db4'],3,10,13,3607430,2,1,1,1,2499
1dbdfb1769979a8391348b5275bfd4bd2a4edf18,0,Kishor Patil,2016-03-02 12:48:48-06:00,['5e2d44df8c342d29d723ac4ac90d0e1efb6884bb'],2,2,4,3607434,1,,,,2499
2ab6a84eb8715d2e6a4514bf079b8d893f6d15f7,0,Kishor Patil,2016-03-02 23:26:07+00:00,['df54280e333e5bf29cc4bbab7a29d9f3b245f4fd'],38,74,112,3607546,3,1,1,1,2499
e6e96a53e26f7a41f61bd13e2112fe0a7a1f1e7a,0,Kishor Patil,2016-03-02 23:32:18+00:00,['2ab6a84eb8715d2e6a4514bf079b8d893f6d15f7'],2,22,24,3607570,1,,,,2499
6bcdac3f2009bd9bbd19acc866f0db0b838c8f9f,0,鍗箰,2016-03-03 09:58:22+08:00,"['68e5d03634b3d2ecf01be0e23466984977a18437', 'df54280e333e5bf29cc4bbab7a29d9f3b245f4fd']",13,39,52,3607622,6,,,,2499
b1c8188d8252ef613c04aeae9e9560a800f9ead3,0,鍗箰,2016-03-03 10:17:26+08:00,"['69f2906c0748826101511b1dd6005f910ebfd5fc', 'df54280e333e5bf29cc4bbab7a29d9f3b245f4fd']",81,328,409,3608031,21,,,,2499
4e0ff2f6e238a59c13d9af6dc3db84ae5817365f,0,鍗箰,2016-03-03 10:21:55+08:00,['b1c8188d8252ef613c04aeae9e9560a800f9ead3'],0,2,2,3608033,1,,,,2499
177a4c3ad269855532edc7c00312c7a79e1a4da7,0,Kishor Patil,2016-03-03 12:32:19-06:00,['df54280e333e5bf29cc4bbab7a29d9f3b245f4fd'],1,6,7,3608040,1,1,1,1,2499
3f2c771aebf5f722389273e79adf71887c75ab31,0,Robert (Bobby) Evans,2016-03-03 13:41:32-06:00,"['df54280e333e5bf29cc4bbab7a29d9f3b245f4fd', 'e6e96a53e26f7a41f61bd13e2112fe0a7a1f1e7a']",40,96,136,3608176,4,,,,2499
672c8951bbee8348a4c686511e4f3f84c00d8385,0,Robert (Bobby) Evans,2016-03-03 14:19:39-06:00,['3f2c771aebf5f722389273e79adf71887c75ab31'],0,1,1,3608177,1,,,,2499
19fcafbd0fe1cbee49e797824c47ba1f6b727270,1,xiaojian.fxj,2016-03-04 09:21:09+08:00,['b281c735f0089d24407af67586a1b41de45ac382'],1725,605,2330,3610507,20,0.380952381,0.111111111,0,2501
b09b4129d845aff6be285ea1748b842499c40e0b,0,xiaojian.fxj,2016-03-04 13:33:09+08:00,"['19fcafbd0fe1cbee49e797824c47ba1f6b727270', '672c8951bbee8348a4c686511e4f3f84c00d8385']",278,687,965,3611472,37,,,,2501
c7241a67c23899ebb3d6c25cdccde758efb7a0ad,1,basti.lj,2016-03-04 15:16:59+08:00,['87e3c246762b56ee8fd638662a9776fdf36c8ef5'],547,981,1528,3613000,21,0.634615385,0.828846154,1,2505
0726c116ebd2ef27b5225027bdf3008e6156018d,0,basti.lj,2016-03-04 15:18:28+08:00,"['c7241a67c23899ebb3d6c25cdccde758efb7a0ad', '672c8951bbee8348a4c686511e4f3f84c00d8385']",95,209,304,3613304,16,,,,2505
f6b58a52ad30f35e7a635ffbffdb9fc7c7f2de37,0,basti.lj,2016-03-04 17:10:44+08:00,['0726c116ebd2ef27b5225027bdf3008e6156018d'],48,14,62,3613366,2,0,0,0,2505
eca27bc435a7002375a9f8682174afbacf69fc89,0,basti.lj,2016-03-04 17:25:33+08:00,['f6b58a52ad30f35e7a635ffbffdb9fc7c7f2de37'],1,0,1,3613367,1,,,,2505
27a724e2f232d5bcf22ce00ecc0090bbba0bb3ed,0,jinhong-lu,2016-03-04 22:53:06+08:00,['672c8951bbee8348a4c686511e4f3f84c00d8385'],0,4,4,3613371,1,1,1,1,2505
e4eae5f1936a6f61e091653cd14a5a01506290c2,0,Robert (Bobby) Evans,2016-03-04 09:20:21-06:00,"['672c8951bbee8348a4c686511e4f3f84c00d8385', '177a4c3ad269855532edc7c00312c7a79e1a4da7']",1,6,7,3613378,1,,,,2505
cc7ef89c34d696c9e227154a532823472e02614f,0,Robert (Bobby) Evans,2016-03-04 09:20:58-06:00,['e4eae5f1936a6f61e091653cd14a5a01506290c2'],0,1,1,3613379,1,,,,2505
47793e4214ba0ca0cdfbc2ac72bdff083bd21d7c,0,Robert (Bobby) Evans,2016-03-04 09:52:40-06:00,"['cc7ef89c34d696c9e227154a532823472e02614f', '035f47a0edbffe445f642bb5c6138d776a472bff']",63,80,143,3613522,3,,,,2505
e065998334f2cde09506851fb9364e5d1b40803d,0,Robert (Bobby) Evans,2016-03-04 09:53:29-06:00,['47793e4214ba0ca0cdfbc2ac72bdff083bd21d7c'],0,1,1,3613523,2,,,,2505
b8ea44a2ae432e6f8ca44cd1fbd2cdd77042b345,0,Kishor Patil,2016-03-04 16:45:54+00:00,"['e065998334f2cde09506851fb9364e5d1b40803d', '8768c3785cdfc078daab52912bf85b45a3ccee8a']",0,11,11,3613534,1,,,,2505
a51100b5ae1c7378ae560dd6b540a9180000ae81,0,Kishor Patil,2016-03-04 16:48:50+00:00,['b8ea44a2ae432e6f8ca44cd1fbd2cdd77042b345'],0,1,1,3613535,1,,,,2505
45c8a5567d394ecc2af3b4ab2a6a783f20b3d7fd,0,Kishor Patil,2016-03-04 16:49:49+00:00,"['a51100b5ae1c7378ae560dd6b540a9180000ae81', '85504e2b651363db2b991b00b35e3c866311aa6d']",1,1,2,3613537,1,,,,2505
db04ce689669547abe2a9d6ab805d7ba2fe166fd,0,Kishor Patil,2016-03-04 16:50:35+00:00,['45c8a5567d394ecc2af3b4ab2a6a783f20b3d7fd'],0,1,1,3613538,1,,,,2505
761296a1aba34e173c96314a31a9099aa4af3693,0,Kishor Patil,2016-03-04 17:22:29+00:00,"['eddfea3615a54834425582649a2fb9ba9706dc1c', 'db04ce689669547abe2a9d6ab805d7ba2fe166fd']",2695,4637,7332,3620870,118,,,,2505
1d0ca7be2ae2631eced20aca94c8bad95ed7d3f0,0,Kishor Patil,2016-03-04 17:34:41+00:00,"['db04ce689669547abe2a9d6ab805d7ba2fe166fd', '0bf82362e110ffaa916e496534b5babb23f0e666']",0,2,2,3620872,1,,,,2505
595ed28e40d122d803aae778fc6750fa7d357007,0,Kishor Patil,2016-03-04 17:35:27+00:00,['1d0ca7be2ae2631eced20aca94c8bad95ed7d3f0'],0,1,1,3620873,1,,,,2505
9c53f669c97acc3b714d6fa1fd02d96f86e1f450,0,Kishor Patil,2016-03-04 17:51:46+00:00,"['595ed28e40d122d803aae778fc6750fa7d357007', '761296a1aba34e173c96314a31a9099aa4af3693']",0,20,20,3620893,3,,,,2505
96f81d7930316f5faa8c9bfb5db40aa3e270bfec,0,Kishor Patil,2016-03-04 17:53:09+00:00,['9c53f669c97acc3b714d6fa1fd02d96f86e1f450'],0,1,1,3620894,1,,,,2505
39ea23cdbbf64b3844205ce759701ec78d688c4a,1,鍗箰,2016-03-05 20:02:42+08:00,"['4e0ff2f6e238a59c13d9af6dc3db84ae5817365f', '96f81d7930316f5faa8c9bfb5db40aa3e270bfec']",509,623,1132,3622026,18,,,,2505
9002528531693d793299458fd6f01b3e83ca1528,0,鍗箰,2016-03-05 20:03:01+08:00,['39ea23cdbbf64b3844205ce759701ec78d688c4a'],1,1,2,3622028,1,,,,2505
cdc041e0e590059cb81dcb038139b297c6f21e9c,0,Jark Wu,2016-03-06 11:14:40+08:00,['43ca7950609573dc0ba1d7b016083bdf6fcea4ee'],19,9,28,3622056,1,0,0,0,2505
42bacde20ea86867b874395532aa034cfad4f120,1,xiaojian.fxj,2016-03-06 16:17:47+08:00,"['b09b4129d845aff6be285ea1748b842499c40e0b', '96f81d7930316f5faa8c9bfb5db40aa3e270bfec']",68,162,230,3622286,12,,,,2505
812031ff7e3017dfcbff4c3434fbd3c2437dcb33,0,xiaojian.fxj,2016-03-06 16:24:22+08:00,['96f81d7930316f5faa8c9bfb5db40aa3e270bfec'],0,4,4,3622290,1,0,0,1,2505
c0bce3e470ca4d502ee4d2ee953e06e0c0fa96c5,0,Arun Mahadevan,2016-03-07 11:18:35+05:18,['96f81d7930316f5faa8c9bfb5db40aa3e270bfec'],2,14,16,3622306,2,1,1,1,2505
e16da77874ea86fca7f097ade1780cfc2974265e,0,Robert (Bobby) Evans,2016-03-07 12:52:10-06:00,"['96f81d7930316f5faa8c9bfb5db40aa3e270bfec', '6bcdac3f2009bd9bbd19acc866f0db0b838c8f9f']",155,226,381,3622687,8,,,,2505
7a4824b7f63fd2ee314331c4ae40fe333ba4aa74,0,Robert (Bobby) Evans,2016-03-07 12:52:33-06:00,['e16da77874ea86fca7f097ade1780cfc2974265e'],0,1,1,3622688,1,,,,2505
e4963cbc6fdd2304464e42e53c8c995066c56452,0,Robert (Bobby) Evans,2016-03-07 13:05:21-06:00,"['7a4824b7f63fd2ee314331c4ae40fe333ba4aa74', '812031ff7e3017dfcbff4c3434fbd3c2437dcb33']",0,4,4,3622692,1,,,,2505
78d3c48e580b8a3ab9cb5b6f8749f8760355e8bd,0,Robert (Bobby) Evans,2016-03-07 13:07:16-06:00,['e4963cbc6fdd2304464e42e53c8c995066c56452'],0,1,1,3622693,1,,,,2505
fa66e99d21731ebff2674d72d5d507b25925cd01,0,Robert (Bobby) Evans,2016-03-07 13:12:26-06:00,"['78d3c48e580b8a3ab9cb5b6f8749f8760355e8bd', '4855c53a3d5505060fa86ae81650e51f175f16c4']",15,16,31,3622724,1,,,,2505
4117fe545887637f2bab6aec7682e3f4166facbf,0,Robert (Bobby) Evans,2016-03-07 13:12:53-06:00,['fa66e99d21731ebff2674d72d5d507b25925cd01'],0,1,1,3622725,1,,,,2505
2c7e946f72fdd984f1162776486dcc614c420078,0,Robert (Bobby) Evans,2016-03-07 13:58:03-06:00,"['4117fe545887637f2bab6aec7682e3f4166facbf', '1dbdfb1769979a8391348b5275bfd4bd2a4edf18']",109,497,606,3623331,8,,,,2505
974274372129f357fef12fcc82615931cfc8104c,0,Robert (Bobby) Evans,2016-03-07 14:09:52-06:00,['2c7e946f72fdd984f1162776486dcc614c420078'],0,1,1,3623332,1,,,,2505
461b11755c1ea1c2e35dfb51a9070f5a17d8ec77,0,Kyle Nusbaum,2016-03-07 16:08:54-06:00,['974274372129f357fef12fcc82615931cfc8104c'],0,0,0,3623332,0,,,,2505
6db8730b8f82415feac63506371a471174e73512,0,Kyle Nusbaum,2016-03-07 16:19:53-06:00,['461b11755c1ea1c2e35dfb51a9070f5a17d8ec77'],0,0,0,3623332,0,,,,2505
9e42edc03e93e3b78bbdeb9a0bb0246283eea7c7,0,Kyle Nusbaum,2016-03-07 16:24:40-06:00,['6db8730b8f82415feac63506371a471174e73512'],0,0,0,3623332,0,,,,2505
cf2ad5a07427b821edce09bb10bd1efc9c96e101,0,Kyle Nusbaum,2016-03-07 16:28:28-06:00,['9e42edc03e93e3b78bbdeb9a0bb0246283eea7c7'],0,0,0,3623332,0,,,,2505
3478c29637cbd8be0f70998e120c2dc64f5e23b6,0,Kyle Nusbaum,2016-03-07 16:31:41-06:00,['cf2ad5a07427b821edce09bb10bd1efc9c96e101'],0,0,0,3623332,0,,,,2505
6249ee7397f878f5674159296a01fe9534227980,0,Kyle Nusbaum,2016-03-07 16:33:52-06:00,['3478c29637cbd8be0f70998e120c2dc64f5e23b6'],0,0,0,3623332,0,,,,2505
bdedc15cecdae5d6024473dd2a116bf8330fa2b8,0,Kyle Nusbaum,2016-03-07 16:40:21-06:00,['6249ee7397f878f5674159296a01fe9534227980'],0,0,0,3623332,0,,,,2505
ee116f728de8bda70873668ecb5bddac4bd925fd,0,Kyle Nusbaum,2016-03-07 16:42:28-06:00,['bdedc15cecdae5d6024473dd2a116bf8330fa2b8'],0,0,0,3623332,0,,,,2505
b477939945842e11433a964b72bc60acd399eba1,0,Kyle Nusbaum,2016-03-07 16:44:45-06:00,['ee116f728de8bda70873668ecb5bddac4bd925fd'],0,0,0,3623332,0,,,,2505
c1a240cd6f76fa4ac4db2c26c28b4dd8fd1c3d24,1,xiaojian.fxj,2016-03-08 18:52:47+08:00,['b477939945842e11433a964b72bc60acd399eba1'],151,145,296,3623628,2,1,1,1,2506
bc25c51ea079782cf9fe8890520efdec4812a7b5,0,xiaojian.fxj,2016-03-08 19:12:13+08:00,"['b0c9574cbf2477d9c5a88a55c12f0541137669cf', 'b477939945842e11433a964b72bc60acd399eba1']",408,1012,1420,3625048,34,,,,2506
4c246d1c5582396debfad2a3687a243303e9a0e5,1,鍗箰,2016-03-08 20:28:14+08:00,['9002528531693d793299458fd6f01b3e83ca1528'],677,835,1512,3626560,11,0.6875,0.243055556,0.486111111,2506
000fcb86592772c6e51962c565c497c8b052aa47,0,鍗箰,2016-03-08 20:51:34+08:00,"['4c246d1c5582396debfad2a3687a243303e9a0e5', 'b477939945842e11433a964b72bc60acd399eba1']",297,763,1060,3627620,18,,,,2506
5bd5bd7605d8bc74fb72d47bf44b3e5fadf3942e,0,鍗箰,2016-03-08 20:57:13+08:00,['000fcb86592772c6e51962c565c497c8b052aa47'],2,2,4,3627624,1,,,,2506
54b6ac4975582bb6b3ef3511369e52ad81db05b3,0,Sanket,2016-03-08 13:06:39-06:00,['b477939945842e11433a964b72bc60acd399eba1'],0,38,38,3627662,1,0.9375,1,0.9375,2506
17a55d20d3f20bc04ca48ee3a9f63eaed8960b9c,0,Kyle Nusbaum,2016-03-08 15:46:23-06:00,['b477939945842e11433a964b72bc60acd399eba1'],10,213,223,3627885,6,0.242424242,0.787878788,1,2509
645e4a9d2271efcda897def11ffbb45a1ed5780d,0,Sanket,2016-03-08 16:34:49-06:00,['54b6ac4975582bb6b3ef3511369e52ad81db05b3'],5,8,13,3627898,1,0,1,1,2509
7b354287227de358cc357ac45c18ac2b1a679202,1,鍗箰,2016-03-09 13:05:36+08:00,['5bd5bd7605d8bc74fb72d47bf44b3e5fadf3942e'],82,231,313,3628211,1,0,0,1,2509
83c72d5d3f80797be473368c60e2f3deb7b49e90,1,xiaojian.fxj,2016-03-09 13:25:58+08:00,['b477939945842e11433a964b72bc60acd399eba1'],485,491,976,3629187,5,0.423188406,0.826086957,1,2511
f22673af95de6386528b829b09af5ad500d6ac0d,0,xiaojian.fxj,2016-03-09 15:41:37+08:00,['83c72d5d3f80797be473368c60e2f3deb7b49e90'],1,2,3,3629190,1,1,1,0,2511
20f1497c213c97a8a72b2f43039ad59ce9ce5169,0,鍗箰,2016-03-09 16:05:04+08:00,['b477939945842e11433a964b72bc60acd399eba1'],10,2,12,3629202,1,,,,2511
1d7c5e6f3a8e68cb21c4f3721e21dfcb4532a4b5,0,xiaojian.fxj,2016-03-09 16:19:57+08:00,['c1a240cd6f76fa4ac4db2c26c28b4dd8fd1c3d24'],30,21,51,3629253,1,0,0,0,2511
fcaca0735878c9062f898b8437026ce7867b4b6d,0,Satish Duggana,2016-03-09 15:22:57+05:18,['b477939945842e11433a964b72bc60acd399eba1'],1,1,2,3629255,1,,,,2511
e23065333f1fc0db98e1e97af451b3f1ee4d443f,0,xiaojian.fxj,2016-03-09 19:03:49+08:00,['bc25c51ea079782cf9fe8890520efdec4812a7b5'],1,2,3,3629258,1,,,,2511
ee4fa721310cb901df5a9f82d346f9cfbc26ffa2,0,basti.lj,2016-03-09 20:00:03+08:00,"['eca27bc435a7002375a9f8682174afbacf69fc89', 'b477939945842e11433a964b72bc60acd399eba1']",492,953,1445,3630703,28,,,,2511
1ef010d699581d902f34e6e78779d42eb289333f,0,basti.lj,2016-03-09 20:19:32+08:00,['ee4fa721310cb901df5a9f82d346f9cfbc26ffa2'],16,31,47,3630750,2,1,1,0,2511
399476a97b8ce68579dddc303867d91fda9abdb7,0,xiaojian.fxj,2016-03-09 20:45:05+08:00,['f22673af95de6386528b829b09af5ad500d6ac0d'],14,12,26,3630776,1,0.5,0.5,0,2511
729074d6d491b2dabadd49507d41a34fb4079285,0,Robert (Bobby) Evans,2016-03-09 09:37:55-06:00,"['b477939945842e11433a964b72bc60acd399eba1', 'e23065333f1fc0db98e1e97af451b3f1ee4d443f']",306,483,789,3631565,9,,,,2511
ddcd6b037adc06f5dd56b6773666aa0ae67f31ee,0,Robert (Bobby) Evans,2016-03-09 09:39:08-06:00,['729074d6d491b2dabadd49507d41a34fb4079285'],0,2,2,3631567,1,,,,2511
2b2a98f14383f7d50b359964fd89e6ea31a9a673,0,Arun Mahadevan,2016-03-09 22:40:09+05:18,['c0bce3e470ca4d502ee4d2ee953e06e0c0fa96c5'],23,58,81,3631648,6,1,1,1,2511
072fcc8865d5e2ebc606ab5b88dad5ff0ef551d4,0,Sanket,2016-03-09 12:07:52-06:00,['645e4a9d2271efcda897def11ffbb45a1ed5780d'],8,1,9,3631657,1,1,0,0,2511
fbfb1ca0bb97ac2001d139eab56fef6917680340,0,Kyle Nusbaum,2016-03-09 14:57:30-06:00,['17a55d20d3f20bc04ca48ee3a9f63eaed8960b9c'],27,150,177,3631834,5,1,1,1,2511
81fb727d80a27d8d2c8c4441af5608ec472a9e13,0,Sriharsha Chintalapani,2016-03-09 15:29:55-08:00,"['ddcd6b037adc06f5dd56b6773666aa0ae67f31ee', '908b2864dd403c82ab9aaee78eb5898728e8e7e0']",1,1,2,3631836,1,,,,2511
686c63f0f26c89b434e2d9de77c0f8f987292c75,0,鍗箰,2016-03-10 10:33:17+08:00,['20f1497c213c97a8a72b2f43039ad59ce9ce5169'],1,1,2,3631838,1,,,,2511
cdbe744875b6583638166e4ece1563552f272274,0,basti.lj,2016-03-10 11:07:47+08:00,"['1ef010d699581d902f34e6e78779d42eb289333f', '81fb727d80a27d8d2c8c4441af5608ec472a9e13']",348,489,837,3632675,12,,,,2511
465a4b89521a4ac15b81969009133bdfa12d0655,1,xiaojian.fxj,2016-03-10 20:12:18+08:00,['42bacde20ea86867b874395532aa034cfad4f120'],155,168,323,3632998,15,0,0,0,2511
473770d8bcd3f7cfc406643f79279e6ae8117328,0,Abhishek Agarwal,2016-03-10 17:56:08+05:18,['b477939945842e11433a964b72bc60acd399eba1'],77,86,163,3633161,2,0.181818182,1,1,2512
fe5d37a3d9d605c4c10686bf8e9548241bdf4d74,0,Abhishek Agarwal,2016-03-10 17:56:20+05:18,['473770d8bcd3f7cfc406643f79279e6ae8117328'],43,49,92,3633253,2,1,1,1,2513
7d43b39e44735e9863ee376e32899ceae46bed0b,0,Abhishek Agarwal,2016-03-10 17:56:20+05:18,['fe5d37a3d9d605c4c10686bf8e9548241bdf4d74'],73,87,160,3633413,2,1,1,1,2514
184dc4a5c3fa8c9662ab224a82f33cc687b95c4b,0,xiaojian.fxj,2016-03-10 22:17:06+08:00,['465a4b89521a4ac15b81969009133bdfa12d0655'],1,1,2,3633415,1,,,,2514
0daa1f4e721779237a86d9d70e7e14b65a3bc50e,0,Robert (Bobby) Evans,2016-03-10 08:18:10-06:00,"['81fb727d80a27d8d2c8c4441af5608ec472a9e13', 'cdbe744875b6583638166e4ece1563552f272274']",529,837,1366,3634781,18,,,,2514
6390d18dd295ecd85d92a4e9f511a7ad7b47a845,0,Robert (Bobby) Evans,2016-03-10 08:18:37-06:00,['0daa1f4e721779237a86d9d70e7e14b65a3bc50e'],0,1,1,3634782,1,,,,2514
65ce9d2e03be5f5c4defa8342bfbefe9f59adcf9,0,xiaojian.fxj,2016-03-10 22:57:01+08:00,"['184dc4a5c3fa8c9662ab224a82f33cc687b95c4b', '81fb727d80a27d8d2c8c4441af5608ec472a9e13']",769,1237,2006,3636788,38,,,,2514
f78c36d7cc9ca82c6aa4e073f07279650a14fd45,0,xiaojian.fxj,2016-03-10 23:20:33+08:00,['65ce9d2e03be5f5c4defa8342bfbefe9f59adcf9'],5,0,5,3636793,1,0,0,0,2514
69c8b3c31d4ee528aea58f716b092c24ba6b0b1a,0,xiaojian.fxj,2016-03-10 23:26:42+08:00,"['f78c36d7cc9ca82c6aa4e073f07279650a14fd45', '6390d18dd295ecd85d92a4e9f511a7ad7b47a845']",523,833,1356,3638149,18,,,,2514
ee78943a886b5858ff23ed1cd8499b86f0897e8b,0,xiaojian.fxj,2016-03-10 23:28:38+08:00,"['1d7c5e6f3a8e68cb21c4f3721e21dfcb4532a4b5', '6390d18dd295ecd85d92a4e9f511a7ad7b47a845']",834,1322,2156,3640305,28,,,,2514
95bf67347cad7c11aeaf55b7588e627be298d1c2,0,xiaojian.fxj,2016-03-10 23:49:52+08:00,['69c8b3c31d4ee528aea58f716b092c24ba6b0b1a'],1,1,2,3640307,1,,,,2514
e5388d3d0bae6ce43be1db9cc90856a05f7c4930,0,Boyang Jerry Peng,2016-03-10 10:53:39-06:00,['6390d18dd295ecd85d92a4e9f511a7ad7b47a845'],1,2,3,3640310,1,,,,2514
19a7f3640ca2607f970546c02dfad19401994b47,0,Alessandro Bellina,2016-03-10 13:54:36-06:00,['6390d18dd295ecd85d92a4e9f511a7ad7b47a845'],138,398,536,3640846,4,0.725,1,1,2516
cc95d4f708efa123e5fc908bea15545f7139655b,0,xiaojian.fxj,2016-03-11 08:03:00+08:00,['95bf67347cad7c11aeaf55b7588e627be298d1c2'],1,1,2,3640848,1,,,,2516
fb19f0d95cbecfd86cc534677b53302a58046bf6,0,鍗箰,2016-03-11 10:15:53+08:00,"['7b354287227de358cc357ac45c18ac2b1a679202', '6390d18dd295ecd85d92a4e9f511a7ad7b47a845']",834,1322,2156,3643004,28,,,,2516
ede8ec24d9091c68df08fafe8cdcae1aebfe6635,0,Abhishek Agarwal,2016-03-11 16:16:17+05:18,['b477939945842e11433a964b72bc60acd399eba1'],2,5,7,3643011,1,,,,2516
aa424c15f968b3c344418ca3f1bf0c0a397e1d26,1,Stig D酶ssing,2016-03-11 14:13:58+01:00,['6390d18dd295ecd85d92a4e9f511a7ad7b47a845'],1,1,2,3643013,1,,,,2516
5bc15988434bfe4bfb5d4ba317c8fff0283b4ddb,1,Alessandro Bellina,2016-03-11 08:43:29-06:00,['6390d18dd295ecd85d92a4e9f511a7ad7b47a845'],14,287,301,3643314,6,0.892307692,0.892307692,0.738461538,2517
44050a72bd9708ef2c7fbe9059fe6b0964aaa742,0,Alessandro Bellina,2016-03-11 09:19:11-06:00,['5bc15988434bfe4bfb5d4ba317c8fff0283b4ddb'],21,21,42,3643356,2,0,0,1,2517
d3323f305c4835274a219bbe354597856ce6a1ff,0,Kyle Nusbaum,2016-03-11 11:22:06-06:00,['fbfb1ca0bb97ac2001d139eab56fef6917680340'],14,5,19,3643375,3,1,1,0,2517
56ffe77b16f354dac18682e0bf2866347ac5cb6b,0,Boyang Jerry Peng,2016-03-11 14:21:16-06:00,['d187a20e22983fc8b4433883e895727ce0467ec0'],0,1,1,3643376,1,0,1,0,2517
8c761c5d6d01cdc50db27f144ca361067ffb3ba7,0,Abhishek Agarwal,2016-03-13 00:25:14+05:18,['6390d18dd295ecd85d92a4e9f511a7ad7b47a845'],1,11,12,3643388,1,0.166666667,0.166666667,0.833333333,2517
ff9797b284c28ca6c56c699a84234f8d8c15f4c1,0,Sriharsha Chintalapani,2016-03-12 12:13:23-08:00,['6390d18dd295ecd85d92a4e9f511a7ad7b47a845'],0,1,1,3643389,1,,,,2517
4794c25dfe4f5b9c27ece5667eb34a7d4f5f3a01,0,Sriharsha Chintalapani,2016-03-12 12:31:34-08:00,"['ff9797b284c28ca6c56c699a84234f8d8c15f4c1', 'aa424c15f968b3c344418ca3f1bf0c0a397e1d26']",1,1,2,3643391,1,,,,2517
e64d1f15abce6130832e5185f2b14145c8756310,0,Sriharsha Chintalapani,2016-03-12 12:44:15-08:00,['4794c25dfe4f5b9c27ece5667eb34a7d4f5f3a01'],0,1,1,3643392,1,,,,2517
f463a24509f5f69b5939f03cae4cc6a84c749afe,0,Sriharsha Chintalapani,2016-03-12 17:26:26-08:00,"['e64d1f15abce6130832e5185f2b14145c8756310', 'e5388d3d0bae6ce43be1db9cc90856a05f7c4930']",1,2,3,3643395,1,,,,2517
011e48380c19ddbf5ee12f704e1ee14f3b35e21a,0,Sriharsha Chintalapani,2016-03-12 17:29:46-08:00,"['f463a24509f5f69b5939f03cae4cc6a84c749afe', 'ede8ec24d9091c68df08fafe8cdcae1aebfe6635']",2,5,7,3643402,1,,,,2517
9081a7d0f3218e5276fd04ac9f7da88da35e50da,0,Sriharsha Chintalapani,2016-03-12 17:40:14-08:00,['011e48380c19ddbf5ee12f704e1ee14f3b35e21a'],0,1,1,3643403,1,,,,2517
7ca2dd5e17da4ae10a69baadc5deda5264fa49ad,0,Sriharsha Chintalapani,2016-03-12 17:43:36-08:00,"['9081a7d0f3218e5276fd04ac9f7da88da35e50da', '686c63f0f26c89b434e2d9de77c0f8f987292c75']",11,3,14,3643417,2,,,,2517
71733add446d426a8909f576a1ce0f0654bc1e37,0,Sriharsha Chintalapani,2016-03-12 17:44:22-08:00,['7ca2dd5e17da4ae10a69baadc5deda5264fa49ad'],0,1,1,3643418,1,,,,2517
a908e8841ccac74406aeb0f68b68871f74099c1a,0,Sriharsha Chintalapani,2016-03-12 17:47:10-08:00,"['71733add446d426a8909f576a1ce0f0654bc1e37', '072fcc8865d5e2ebc606ab5b88dad5ff0ef551d4']",0,34,34,3643452,1,,,,2517
5f818b9ad5c8f8b302720ecb68a84f15b267d7a2,0,Sriharsha Chintalapani,2016-03-12 17:49:29-08:00,['a908e8841ccac74406aeb0f68b68871f74099c1a'],0,1,1,3643453,1,,,,2517
fd0fb02e8a183f0b184d3895f439e543a5ffd530,0,Sriharsha Chintalapani,2016-03-12 20:53:50-08:00,"['5f818b9ad5c8f8b302720ecb68a84f15b267d7a2', 'cdc041e0e590059cb81dcb038139b297c6f21e9c']",76,144,220,3643673,3,,,,2517
c2cf3befce15ed79e41c1c02752f168194e9a1bf,0,Sriharsha Chintalapani,2016-03-12 21:21:13-08:00,['fd0fb02e8a183f0b184d3895f439e543a5ffd530'],0,1,1,3643674,1,,,,2517
0097a2587311cc874c5c6632856f2405c43be2fd,0,Xin Wang,2016-03-13 14:12:17+08:00,['1a9b7b1da099df3f8d8004c6d26d4fcdc89c0d7c'],0,1349,1349,3645023,21,0.675241158,1,0.881028939,2536
487c05eac0ead1c84ecde7bd08cca119fa372480,0,Abhishek Agarwal,2016-03-13 18:34:18+05:18,['7d43b39e44735e9863ee376e32899ceae46bed0b'],66,120,186,3645209,4,1,1,1,2538
e05a916bd2242f5fb31dee5e6a0230dabe043700,1,Abhishek Agarwal,2016-03-13 18:34:24+05:18,['487c05eac0ead1c84ecde7bd08cca119fa372480'],33,39,72,3645281,3,1,1,1,2539
a1e473526b5d9074ae1f9ff98162ddc78e426a73,0,xiaojian.fxj,2016-03-14 18:55:57+08:00,['cc95d4f708efa123e5fc908bea15545f7139655b'],443,595,1038,3646319,18,0.315789474,1,0,2541
b49c99541ae9c2c3f86d9823c64d30765f7716c6,0,xiaojian.fxj,2016-03-14 20:30:16+08:00,"['a1e473526b5d9074ae1f9ff98162ddc78e426a73', 'c2cf3befce15ed79e41c1c02752f168194e9a1bf']",97,196,293,3646612,11,,,,2541
6d59676acb2789238fddbe8d84830abda8a6038b,0,xiaojian.fxj,2016-03-14 21:23:06+08:00,['c2cf3befce15ed79e41c1c02752f168194e9a1bf'],2,2,4,3646616,1,,,,2541
d80e7ab7a3a6f8427fd46ead30ab4e1dd71077aa,0,Xin Wang,2016-03-14 21:40:38+08:00,['c2cf3befce15ed79e41c1c02752f168194e9a1bf'],1,3,4,3646620,1,,,,2541
e87ab8e267a21c97f7b41a7fec8a3dc5631e1e4a,0,Xin Wang,2016-03-14 21:45:33+08:00,['d80e7ab7a3a6f8427fd46ead30ab4e1dd71077aa'],1,1,2,3646622,1,,,,2541
42928c2182cf2b755c6f98ad039b2e858787dfe4,0,xiaojian.fxj,2016-03-15 00:16:19+08:00,['b49c99541ae9c2c3f86d9823c64d30765f7716c6'],16,21,37,3646659,2,0,0,0,2541
86ad800b71a6ee62638af35ae7b1b11eb7224851,0,xiaojian.fxj,2016-03-15 00:18:10+08:00,"['399476a97b8ce68579dddc303867d91fda9abdb7', '6d59676acb2789238fddbe8d84830abda8a6038b']",925,1517,2442,3649101,37,,,,2541
ae619f31a85e2924172c0e7014e7fa03240a0da3,1,Sanket,2016-03-14 12:26:50-05:00,['c2cf3befce15ed79e41c1c02752f168194e9a1bf'],41,58,99,3649200,7,1,1,1,2541
9b352e95e12b40cfde56d6e8463f82503617782b,0,P. Taylor Goetz,2016-03-14 15:29:42-04:00,"['c2cf3befce15ed79e41c1c02752f168194e9a1bf', '2b2a98f14383f7d50b359964fd89e6ea31a9a673']",25,72,97,3649297,7,,,,2541
1a0ed9a3764d35f4a756e597e330182606d64163,0,P. Taylor Goetz,2016-03-14 15:31:18-04:00,['9b352e95e12b40cfde56d6e8463f82503617782b'],0,1,1,3649298,1,,,,2541
092ea1df87ee7481e43ab18b421a31370dc3986d,0,Alessandro Bellina,2016-03-15 10:01:56-05:00,['44050a72bd9708ef2c7fbe9059fe6b0964aaa742'],7,7,14,3649312,2,,,,2541
02f9308d80da67b6da634b96a08e169268bd9262,0,Jungtaek Lim,2016-03-16 00:06:58+09:00,['1a0ed9a3764d35f4a756e597e330182606d64163'],3,7,10,3649322,1,,,,2541
da2d1c212457bae468fadfcbf350b8059a8ddb9a,0,Sriharsha Chintalapani,2016-03-15 08:49:36-07:00,"['c2cf3befce15ed79e41c1c02752f168194e9a1bf', '0097a2587311cc874c5c6632856f2405c43be2fd']",0,1349,1349,3650671,21,,,,2541
a2a28e5b1e023c0ed1a014a84f4d66a5613eee56,0,Sriharsha Chintalapani,2016-03-15 09:04:40-07:00,['da2d1c212457bae468fadfcbf350b8059a8ddb9a'],0,1,1,3650672,1,,,,2541
afcb2a065fac88e203af93c264bf0a473cac970f,0,Sriharsha Chintalapani,2016-03-15 09:26:47-07:00,"['1a0ed9a3764d35f4a756e597e330182606d64163', 'a2a28e5b1e023c0ed1a014a84f4d66a5613eee56']",0,1350,1350,3652022,22,,,,2541
cf7ef7f771ab263bea976f51187323e54f75aaf9,0,Robert (Bobby) Evans,2016-03-15 12:33:47-05:00,"['afcb2a065fac88e203af93c264bf0a473cac970f', 'fb19f0d95cbecfd86cc534677b53302a58046bf6']",1763,2865,4628,3656650,15,,,,2541
fa25f3d7fae52b7d3e951ab84e6a7fb8c10381f1,0,Robert (Bobby) Evans,2016-03-15 12:34:12-05:00,['cf7ef7f771ab263bea976f51187323e54f75aaf9'],0,1,1,3656651,1,,,,2541
c9a85e362f1c48148ddab4178ede9d9eca8eb302,0,Robert (Bobby) Evans,2016-03-15 12:55:53-05:00,"['fa25f3d7fae52b7d3e951ab84e6a7fb8c10381f1', 'ae619f31a85e2924172c0e7014e7fa03240a0da3']",41,58,99,3656750,7,,,,2541
5b7a7075e82dc77cecbc48d9755931afee8f7b3f,0,Robert (Bobby) Evans,2016-03-15 12:56:17-05:00,['c9a85e362f1c48148ddab4178ede9d9eca8eb302'],0,1,1,3656751,1,,,,2541
3b6813838753f3330cca1b2b8e39c1fee820de40,0,Robert (Bobby) Evans,2016-03-15 13:09:50-05:00,['5b7a7075e82dc77cecbc48d9755931afee8f7b3f'],1,1,2,3656753,1,,,,2541
b048ea20bdfe5b1d72c68b43662279ee89990997,0,P. Taylor Goetz,2016-03-15 15:36:34-04:00,"['3b6813838753f3330cca1b2b8e39c1fee820de40', '8c761c5d6d01cdc50db27f144ca361067ffb3ba7']",1,11,12,3656765,1,,,,2541
500ef20d5a07ad56a22817af70810608046a3b42,0,P. Taylor Goetz,2016-03-15 15:37:40-04:00,['b048ea20bdfe5b1d72c68b43662279ee89990997'],0,1,1,3656766,1,,,,2541
e2d118af9071ab6bcdcbec18df055770b991ee79,0,Stig D酶ssing,2016-03-15 20:49:51+01:00,"['f68b4c6362e45af5b6cc7569e6d37982220947cd', '500ef20d5a07ad56a22817af70810608046a3b42']",3141,6867,10008,3666774,96,,,,2541
e0b874f99314e45ec8f74f9b08fe1d742454d419,0,Stig D酶ssing,2016-03-15 21:15:19+01:00,['e2d118af9071ab6bcdcbec18df055770b991ee79'],2,6,8,3666782,2,0.25,1,1,2541
f679dac1733e5c20fabfda34634d0470466eb539,0,Boyang Jerry Peng,2016-03-15 16:43:58-05:00,['500ef20d5a07ad56a22817af70810608046a3b42'],12,36,48,3666830,3,1,1,1,2541
7f52aecb1114e638eb80264c6eb559f612b3d390,0,Aaron Dossett,2016-03-15 20:04:02-05:00,"['500ef20d5a07ad56a22817af70810608046a3b42', '3f5d3b363a5546eb7ac4d8cadbb9136cbc8e553d']",1,0,1,3666831,1,,,,2541
719de7990cafe7cbd6f1d2127a0e0f65f7672592,0,Xin Wang,2016-03-16 12:30:12+08:00,['defcb9601d8f4d287fa4f1d6de7ee43d8183b137'],5,12,17,3666848,1,,,,2541
3b4a4e3b8ea2fcaf0c1d58fb3abcec2966752369,0,Boyang Jerry Peng,2016-03-15 23:42:27-05:00,['f679dac1733e5c20fabfda34634d0470466eb539'],2,5,7,3666855,1,,,,2541
a199e9ea0b99ed28e8edf8185a3497e9fa6ec5db,0,vesense,2016-03-16 12:46:23+08:00,['719de7990cafe7cbd6f1d2127a0e0f65f7672592'],3,4,7,3666862,3,,,,2541
672c3c002d0fc88de846ec4bdb98898e4104825d,0,vesense,2016-03-16 13:52:30+08:00,"['a199e9ea0b99ed28e8edf8185a3497e9fa6ec5db', '7f52aecb1114e638eb80264c6eb559f612b3d390']",6883,18180,25063,3691925,259,,,,2541
56f27e5d58d7abd1bdd9aff95dfb862540b166ef,0,xiaojian.fxj,2016-03-16 14:02:10+08:00,"['6d59676acb2789238fddbe8d84830abda8a6038b', '7f52aecb1114e638eb80264c6eb559f612b3d390']",1830,4359,6189,3698114,53,,,,2541
4d75ec8494eeda24d6510641259d4c469cff3ee2,1,Julien Nioche,2016-03-16 11:14:24+00:00,['7f52aecb1114e638eb80264c6eb559f612b3d390'],15,15,30,3698144,2,,,,2541
ceeab062ef73ecdfa66c136ba655ce773fb2d9fc,0,Robert (Bobby) Evans,2016-03-16 08:50:38-05:00,"['7f52aecb1114e638eb80264c6eb559f612b3d390', 'e0b874f99314e45ec8f74f9b08fe1d742454d419']",10,114,124,3698268,12,,,,2541
4d15d4c3851acf94fbfe876b3d13842c492bdbc3,0,Robert (Bobby) Evans,2016-03-16 09:35:56-05:00,['ceeab062ef73ecdfa66c136ba655ce773fb2d9fc'],0,1,1,3698269,1,,,,2541
c03a12a98d1486b7268be9d1221b382b3ca2303c,0,Robert (Bobby) Evans,2016-03-16 09:44:58-05:00,"['4d15d4c3851acf94fbfe876b3d13842c492bdbc3', '672c3c002d0fc88de846ec4bdb98898e4104825d']",199,322,521,3698790,9,,,,2541
762ca287a7c77988d3ecdebbd6df331950a41ef2,0,Robert (Bobby) Evans,2016-03-16 09:45:38-05:00,['c03a12a98d1486b7268be9d1221b382b3ca2303c'],0,2,2,3698792,1,,,,2541
178dd5464790cb8a01c09b43f04ce7dfbc61a332,0,Kyle Nusbaum,2016-03-16 15:33:03-05:00,['d3323f305c4835274a219bbe354597856ce6a1ff'],11,23,34,3698826,5,,,,2541
5404023ae5372ac84d7f77a2bcc71015cd50d240,0,Kyle Nusbaum,2016-03-16 15:52:38-05:00,['178dd5464790cb8a01c09b43f04ce7dfbc61a332'],0,12,12,3698838,1,0,1,1,2541
a583bf30ca845850600c773e3c36c76b3a0c282c,0,Sriharsha Chintalapani,2016-03-16 17:54:21-07:00,"['762ca287a7c77988d3ecdebbd6df331950a41ef2', 'e87ab8e267a21c97f7b41a7fec8a3dc5631e1e4a']",1,3,4,3698842,1,,,,2541
413c740135ad528c28bba0499ebdd212b5c886bf,0,Sriharsha Chintalapani,2016-03-16 17:55:29-07:00,['a583bf30ca845850600c773e3c36c76b3a0c282c'],0,1,1,3698843,1,,,,2541
d63167cc4a13289ef46b5fa1650621c57b191d3b,0,xiaojian.fxj,2016-03-17 09:29:54+08:00,"['56f27e5d58d7abd1bdd9aff95dfb862540b166ef', '413c740135ad528c28bba0499ebdd212b5c886bf']",210,443,653,3699496,23,,,,2541
aad675be9e7f8334cc3373b425831746a41ff1d1,0,xiaojian.fxj,2016-03-17 09:30:36+08:00,"['86ad800b71a6ee62638af35ae7b1b11eb7224851', 'd63167cc4a13289ef46b5fa1650621c57b191d3b']",2040,4802,6842,3706338,72,,,,2541
198fa646da1e4161259193ca81039a04e9f68790,0,xiaojian.fxj,2016-03-17 09:45:33+08:00,['aad675be9e7f8334cc3373b425831746a41ff1d1'],10,22,32,3706370,1,0,,,2541
0893c81af1511ff1643f32e68fd7a6aa6ae38934,0,Boyang Jerry Peng,2016-03-16 22:14:58-05:00,"['413c740135ad528c28bba0499ebdd212b5c886bf', '6d59676acb2789238fddbe8d84830abda8a6038b']",2,2,4,3706374,1,,,,2541
50701df4ae3249e43200eaa9803e471cf7513543,0,Boyang Jerry Peng,2016-03-16 22:16:06-05:00,['0893c81af1511ff1643f32e68fd7a6aa6ae38934'],0,1,1,3706375,1,,,,2541
5863d4af59997d9456decd1c0bf02e9bd1202b61,0,Boyang Jerry Peng,2016-03-16 22:31:57-05:00,['50701df4ae3249e43200eaa9803e471cf7513543'],280,202,482,3706857,12,0.744186047,0,0.209302326,2542
580ed9d2c4b012701fb6c1a307afe86eaf32863e,0,Boyang Jerry Peng,2016-03-16 23:45:42-05:00,['50701df4ae3249e43200eaa9803e471cf7513543'],1,1,2,3706859,1,,,,2542
8dd66bfb378b7b103694b7d968ad21483f3a3b80,0,Jungtaek Lim,2016-03-17 17:28:24+09:00,['50701df4ae3249e43200eaa9803e471cf7513543'],91,98,189,3707048,4,1,1,0,2542
251bc5691eb83506ba5934724311883486a1c9d2,0,Kyle Nusbaum,2016-03-17 13:28:19-05:00,['5404023ae5372ac84d7f77a2bcc71015cd50d240'],10,20,30,3707078,4,1,0,0,2542
fb880cae02415889708bb38138795a886164db2f,0,Kyle Nusbaum,2016-03-17 15:03:07-05:00,"['50701df4ae3249e43200eaa9803e471cf7513543', '251bc5691eb83506ba5934724311883486a1c9d2']",39,390,429,3707507,11,,,,2542
367464a3d9aa92fca9d64f4e50e780b775279a3a,0,Kyle Nusbaum,2016-03-17 15:04:13-05:00,['fb880cae02415889708bb38138795a886164db2f'],0,1,1,3707508,1,,,,2542
acd581d952d93c4fadf7dc9b668680d6a817569e,0,xiaojian.fxj,2016-03-18 21:16:08+08:00,['198fa646da1e4161259193ca81039a04e9f68790'],1,115,116,3707624,1,0.614285714,0.714285714,0.957142857,2542
2e2ffb29df039e9339e7b2b44352c744efb5caf0,0,xiaojian.fxj,2016-03-18 21:16:44+08:00,"['d63167cc4a13289ef46b5fa1650621c57b191d3b', '367464a3d9aa92fca9d64f4e50e780b775279a3a']",39,392,431,3708055,12,,,,2542
ca4507fcfa0c54bbb7f2464c388cff24ee524aad,0,xiaojian.fxj,2016-03-18 21:17:32+08:00,"['acd581d952d93c4fadf7dc9b668680d6a817569e', '2e2ffb29df039e9339e7b2b44352c744efb5caf0']",39,392,431,3708486,12,,,,2542
c1b93de1650d113df0e1d0493780d9915bf3dacc,0,zhuol,2016-03-18 16:06:00-05:00,['c2cf3befce15ed79e41c1c02752f168194e9a1bf'],2,754,756,3709242,2,0.036006547,0.399345336,1,2542
7a302e3bc5b6652642ed5fb9ff6f4fed8607680f,0,zhuol,2016-03-18 16:11:50-05:00,['c1b93de1650d113df0e1d0493780d9915bf3dacc'],12,11,23,3709265,3,,,,2542
6340601684ccd1cbe86d27594f8e32e78ec8a0df,0,zhuol,2016-03-18 16:13:28-05:00,['7a302e3bc5b6652642ed5fb9ff6f4fed8607680f'],738,0,738,3710003,1,,,,2542
4e42665452e500e3f0d9d460d6cde83e63dc92c2,0,xiaojian.fxj,2016-03-19 20:36:25+08:00,['ca4507fcfa0c54bbb7f2464c388cff24ee524aad'],18,20,38,3710041,2,1,1,1,2542
abbfb9737e4c99eb27b96aa85335294b025c348e,1,Robert (Bobby) Evans,2016-03-19 12:58:15-05:00,['367464a3d9aa92fca9d64f4e50e780b775279a3a'],0,15049,15049,3725090,130,0.919395466,0.782115869,0.910579345,2671
d909db8fe2aee7633b6f3b95ae71c415efea495f,1,Robert (Bobby) Evans,2016-03-19 12:58:31-05:00,['abbfb9737e4c99eb27b96aa85335294b025c348e'],356,3599,3955,3729045,51,,,,2681
69dfb5322f896057c21cf6bf758938cb14bc3984,1,Robert (Bobby) Evans,2016-03-19 12:58:54-05:00,['d909db8fe2aee7633b6f3b95ae71c415efea495f'],272,14331,14603,3743648,91,0.55412844,0.659938838,0.947400612,2743
96b1cac47aac751f3a6bf8efa3df032e1759abf0,0,Robert (Bobby) Evans,2016-03-19 13:04:58-05:00,['69dfb5322f896057c21cf6bf758938cb14bc3984'],24,16,40,3743688,2,,,,2743
07e1b231e37217705add955d76b57fa530b99955,1,Abhishek Agarwal,2016-03-20 01:05:33+05:18,['367464a3d9aa92fca9d64f4e50e780b775279a3a'],85,103,188,3743876,3,0.613636364,1,0.886363636,2744
36ed8ef1a968ede5e9c60395c13381ef796e7a6a,0,Jungtaek Lim,2016-03-20 10:36:58+09:00,"['367464a3d9aa92fca9d64f4e50e780b775279a3a', '02f9308d80da67b6da634b96a08e169268bd9262']",3,7,10,3743886,1,,,,2744
a726589d8712a3d68eb286c934a25367b3650ee1,0,Jungtaek Lim,2016-03-20 10:54:39+09:00,['36ed8ef1a968ede5e9c60395c13381ef796e7a6a'],0,1,1,3743887,1,,,,2744
575203cf40a6b194f1f24cf9875f0284e42b999d,0,Jungtaek Lim,2016-03-20 11:07:13+09:00,"['a726589d8712a3d68eb286c934a25367b3650ee1', '8dd66bfb378b7b103694b7d968ad21483f3a3b80']",91,98,189,3744076,4,,,,2744
ab66003c18fe4f8c0926b3219408b735b2ce2adf,0,Jungtaek Lim,2016-03-20 11:07:37+09:00,['575203cf40a6b194f1f24cf9875f0284e42b999d'],0,1,1,3744077,1,,,,2744
e461dc999afff00465bcc998bc53e3539074b0fe,1,Abhishek Agarwal,2016-03-20 16:12:20+05:18,['ab66003c18fe4f8c0926b3219408b735b2ce2adf'],13,24,37,3744114,4,1,1,1,2744
8842b73184e6b4b0bfa28778db44949693d65258,1,Arun Mahadevan,2016-03-21 14:22:27+05:18,['0047279a71a98a4326c00929ca990e415d0fbce1'],7,83,90,3744204,5,0.928571429,1,0.976190476,2744
7554fe2042369141d374b149de40949557ee70ea,1,Aaron Dossett,2016-03-21 13:06:44-05:00,['500ef20d5a07ad56a22817af70810608046a3b42'],187,730,917,3745121,19,0.983957219,1,0.983957219,2751
de9f7b1ef57adfeaf03a63e4d7d992a91a1b2050,0,Kun Hu,2016-03-21 11:28:48-07:00,['ab66003c18fe4f8c0926b3219408b735b2ce2adf'],7,5,12,3745133,1,0,0,0,2751
d93b2f272a6eea942702ab26c813c6a6d4d2af3f,1,Stig Rohde D酶ssing,2016-03-22 02:04:53+01:00,['e0b874f99314e45ec8f74f9b08fe1d742454d419'],0,1,1,3745134,1,1,1,1,2751
c90c41987fc59fa6f1ad71297bff62368c5845f4,0,Robert (Bobby) Evans,2016-03-22 09:59:36-05:00,"['ab66003c18fe4f8c0926b3219408b735b2ce2adf', '96b1cac47aac751f3a6bf8efa3df032e1759abf0']",0,32343,32343,3777477,202,,,,2751
b5cdfb955c1c112dc68e23be5ff5e002d05553e2,0,Robert (Bobby) Evans,2016-03-22 13:48:52-05:00,"['c90c41987fc59fa6f1ad71297bff62368c5845f4', '580ed9d2c4b012701fb6c1a307afe86eaf32863e']",1,1,2,3777479,1,,,,2751
b2242bfcee25f4eb6ac2f0834102194e0f43f702,0,Robert (Bobby) Evans,2016-03-22 13:51:52-05:00,['b5cdfb955c1c112dc68e23be5ff5e002d05553e2'],0,1,1,3777480,1,,,,2751
a78bbb45e9087d46b1f091adeda01b7027b71753,0,Robert (Bobby) Evans,2016-03-22 14:14:14-05:00,"['b2242bfcee25f4eb6ac2f0834102194e0f43f702', '4d75ec8494eeda24d6510641259d4c469cff3ee2']",15,15,30,3777510,2,,,,2751
4e6cb58a9acf448c4a6db489439adf40029beeb2,0,Robert (Bobby) Evans,2016-03-22 14:15:24-05:00,['a78bbb45e9087d46b1f091adeda01b7027b71753'],1,1,2,3777512,1,,,,2751
4ad21bd64650cd163efbdc38bc1883219b8ef11f,0,Robert (Bobby) Evans,2016-03-22 14:33:35-05:00,"['4e6cb58a9acf448c4a6db489439adf40029beeb2', '3b4a4e3b8ea2fcaf0c1d58fb3abcec2966752369']",14,41,55,3777567,3,,,,2751
0b3ee9075b1120dfdfaeb77d269420ead7ca2056,0,Robert (Bobby) Evans,2016-03-22 14:34:12-05:00,['4ad21bd64650cd163efbdc38bc1883219b8ef11f'],0,1,1,3777568,1,,,,2751
e675f771c0b601e6ffdde1ecc20a3699c42d754a,0,Robert (Bobby) Evans,2016-03-22 14:47:43-05:00,"['0b3ee9075b1120dfdfaeb77d269420ead7ca2056', '092ea1df87ee7481e43ab18b421a31370dc3986d']",14,287,301,3777869,6,,,,2751
57317ea1c43094cb726bc602b407a94347543661,0,Robert (Bobby) Evans,2016-03-22 15:23:49-05:00,"['e675f771c0b601e6ffdde1ecc20a3699c42d754a', '56004150b229f50c5198233ad436420c1aa981ff']",4,4,8,3777877,1,,,,2751
a91abdb4e6cec53746afe8b3c1ef7b2b9c6fb764,0,Robert (Bobby) Evans,2016-03-22 15:24:21-05:00,['57317ea1c43094cb726bc602b407a94347543661'],0,1,1,3777878,1,,,,2751
a8498888705d975c2e50a4e289d01fcb57d0adc6,0,Alessandro Bellina,2016-03-22 16:57:18-05:00,['4e6cb58a9acf448c4a6db489439adf40029beeb2'],20,100,120,3777998,2,0.4,0,1,2751
28867372a4fc96d744ccd00a27d9e38dab2bd49e,0,xiaojian.fxj,2016-03-23 11:10:08+08:00,"['2e2ffb29df039e9339e7b2b44352c744efb5caf0', 'a91abdb4e6cec53746afe8b3c1ef7b2b9c6fb764']",143,32802,32945,3810943,217,,,,2751
5269ff5859876d8449c3e7f5321f696c7ba05b49,0,xiaojian.fxj,2016-03-23 11:10:49+08:00,"['4e42665452e500e3f0d9d460d6cde83e63dc92c2', '28867372a4fc96d744ccd00a27d9e38dab2bd49e']",143,32802,32945,3843888,217,,,,2751
6a89d3c34f9eb7bd8e44da4619a81d3f424be1fd,0,xiaojian.fxj,2016-03-23 12:54:38+08:00,['5269ff5859876d8449c3e7f5321f696c7ba05b49'],124,78,202,3844090,3,0,1,0.272727273,2751
8647466c6fba838b8b18ff236468c3269feb6f7c,0,xiaojian.fxj,2016-03-23 12:59:46+08:00,['6a89d3c34f9eb7bd8e44da4619a81d3f424be1fd'],3,4,7,3844097,1,,,,2751
21ed0a37916d878632812f4ad7d1d2d663f5bf48,0,Jungtaek Lim,2016-03-23 15:13:42+09:00,['a91abdb4e6cec53746afe8b3c1ef7b2b9c6fb764'],51,23,74,3844171,3,,,,2752
f03b8bec105e88282211bf3e7dd4be4aeed484d8,0,xiaojian.fxj,2016-03-23 14:40:22+08:00,"['42928c2182cf2b755c6f98ad039b2e858787dfe4', '28867372a4fc96d744ccd00a27d9e38dab2bd49e']",2220,37982,40202,3884373,299,,,,2752
87a2d92377413bca47258abb8e4ddab8fad9e8e2,1,Satish Duggana,2016-03-23 12:08:21+05:18,['a91abdb4e6cec53746afe8b3c1ef7b2b9c6fb764'],40,3019,3059,3887432,38,0.617998163,0.923783287,0.84389348,2783
2494df61e2607d7ff8086605234f6f54b796e6af,0,Satish Duggana,2016-03-23 12:08:55+05:18,['87a2d92377413bca47258abb8e4ddab8fad9e8e2'],44,55,99,3887531,10,1,1,1,2783
4ade8f403f680432716f80cde3a100501e50dce1,0,Satish Duggana,2016-03-23 12:08:55+05:18,['2494df61e2607d7ff8086605234f6f54b796e6af'],18,4,22,3887553,1,0,0,1,2783
e48b5ad4406df7313f5010131900aefca3f5367b,0,Satish Duggana,2016-03-23 12:08:55+05:18,['4ade8f403f680432716f80cde3a100501e50dce1'],133,28,161,3887714,8,0,0,0,2783
5da6bffe84d51c1dc04cf6d9d96fdf3c6df30ed7,0,Satish Duggana,2016-03-23 18:51:55+05:18,['e48b5ad4406df7313f5010131900aefca3f5367b'],12,15,27,3887741,4,,,,2783
1bac2a9a080d94286cc3ef2d21fa507ca5140528,0,Satish Duggana,2016-03-23 22:23:08+05:18,['5da6bffe84d51c1dc04cf6d9d96fdf3c6df30ed7'],87,33,120,3887861,8,1,0,0,2783
724f5d2cea8debea8c6fb6a0d42d275880636834,0,xiaojian.fxj,2016-03-24 01:29:20+08:00,['f03b8bec105e88282211bf3e7dd4be4aeed484d8'],1,1,2,3887863,1,,,,2783
df3867fb21383eb74a832c750fadd35a14b7c6fe,0,Kyle Nusbaum,2016-03-23 14:49:49-05:00,"['a91abdb4e6cec53746afe8b3c1ef7b2b9c6fb764', 'fcaca0735878c9062f898b8437026ce7867b4b6d']",1,1,2,3887865,1,,,,2783
c6ed8d0c419dba8bdb479a432d5e7855f78b012b,0,Jungtaek Lim,2016-03-24 11:57:28+09:00,['df3867fb21383eb74a832c750fadd35a14b7c6fe'],16,3,19,3887884,2,0,0,0,2783
4b0268d03acd7ed02d5149d99d1c8ebd26f3e329,1,鍗箰,2016-03-24 12:58:54+08:00,['7f52aecb1114e638eb80264c6eb559f612b3d390'],121,336,457,3888341,9,0.748148148,1,0.740740741,2788
ba2385882e705ebf5c33f5a03b67dc3b14781460,0,Jungtaek Lim,2016-03-24 16:45:24+09:00,['df3867fb21383eb74a832c750fadd35a14b7c6fe'],13,9,22,3888363,1,1,1,0,2788
0c2b555bbac622a7731aacf26cfc6585b886c8c8,0,Abhishek Agarwal,2016-03-24 17:09:13+05:18,['ab66003c18fe4f8c0926b3219408b735b2ce2adf'],16,16,32,3888395,3,,,,2788
6fea5207381a958e2c0a08e5ab79d6ffc4896782,0,Robert (Bobby) Evans,2016-03-24 13:35:25-05:00,"['df3867fb21383eb74a832c750fadd35a14b7c6fe', 'a8498888705d975c2e50a4e289d01fcb57d0adc6']",20,100,120,3888515,2,,,,2788
92d302481e05cdc20215ac4f96ae24c2ba16d70e,0,Robert (Bobby) Evans,2016-03-24 13:46:47-05:00,['6fea5207381a958e2c0a08e5ab79d6ffc4896782'],0,1,1,3888516,1,,,,2788
4e587c28ef03409023df12973ee548b5e15482db,0,Robert (Bobby) Evans,2016-03-24 14:03:01-05:00,"['92d302481e05cdc20215ac4f96ae24c2ba16d70e', '4b0268d03acd7ed02d5149d99d1c8ebd26f3e329']",121,336,457,3888973,9,,,,2788
73f6b5c885bcad51a500dfc5177787f0d957b9db,0,Robert (Bobby) Evans,2016-03-24 14:03:27-05:00,['4e587c28ef03409023df12973ee548b5e15482db'],0,1,1,3888974,1,,,,2788
5cd9c56328fec6c9caeb731d0ccb0420dd5de992,0,Robert (Bobby) Evans,2016-03-24 14:26:53-05:00,"['73f6b5c885bcad51a500dfc5177787f0d957b9db', 'e461dc999afff00465bcc998bc53e3539074b0fe']",13,24,37,3889011,4,,,,2788
3b56c6b1847e5388e94b5c195b0965d55198d81c,0,Kyle Nusbaum,2016-03-24 14:42:17-05:00,['df3867fb21383eb74a832c750fadd35a14b7c6fe'],0,52,52,3889063,3,,,,2789
d3182c46c947378185ff7331a5c43cfa96471285,0,Robert (Bobby) Evans,2016-03-24 15:36:40-05:00,['5cd9c56328fec6c9caeb731d0ccb0420dd5de992'],0,1,1,3889064,1,,,,2789
cb2735c237fa9c38a579f1315b40bf1bfb12895a,0,Kyle Nusbaum,2016-03-24 15:41:07-05:00,"['d3182c46c947378185ff7331a5c43cfa96471285', 'd93b2f272a6eea942702ab26c813c6a6d4d2af3f']",0,1,1,3889065,1,,,,2789
e19e75776fdb1d3f4ed141855dee7e6f4b7091aa,0,Kyle Nusbaum,2016-03-24 16:20:38-05:00,"['cb2735c237fa9c38a579f1315b40bf1bfb12895a', 'de9f7b1ef57adfeaf03a63e4d7d992a91a1b2050']",7,5,12,3889077,1,,,,2789
9f2ca7ef2d7c8137cbf0e988d7d615938075bead,0,Kyle Nusbaum,2016-03-24 16:25:16-05:00,"['e19e75776fdb1d3f4ed141855dee7e6f4b7091aa', '27a724e2f232d5bcf22ce00ecc0090bbba0bb3ed']",0,4,4,3889081,1,,,,2789
58f1161cb077f90fb64e8a68f9da9c9aedf4f7dd,0,zhuol,2016-03-24 17:31:13-05:00,['6340601684ccd1cbe86d27594f8e32e78ec8a0df'],41,13,54,3889135,2,1,1,0,2789
0100898ce9006cedd66c61b082001d1d455e5199,0,xiaojian.fxj,2016-03-25 09:09:53+08:00,"['28867372a4fc96d744ccd00a27d9e38dab2bd49e', '9f2ca7ef2d7c8137cbf0e988d7d615938075bead']",162,474,636,3889771,20,,,,2789
6007e65d0590da40b34a69fe9b9f4dad75bc487d,0,xiaojian.fxj,2016-03-25 10:07:09+08:00,"['8647466c6fba838b8b18ff236468c3269feb6f7c', '0100898ce9006cedd66c61b082001d1d455e5199']",296,500,796,3890567,22,,,,2789
753648927bb2c82443ede9525200bb6197f8d3b6,1,xiaojian.fxj,2016-03-25 10:48:05+08:00,"['724f5d2cea8debea8c6fb6a0d42d275880636834', '0100898ce9006cedd66c61b082001d1d455e5199']",178,484,662,3891229,24,,,,2789
afd2e3f5a53d2a086de1d1d62048377486ab1992,0,xiaojian.fxj,2016-03-25 11:37:48+08:00,"['f03b8bec105e88282211bf3e7dd4be4aeed484d8', '0100898ce9006cedd66c61b082001d1d455e5199']",162,474,636,3891865,20,,,,2789
edf19fe611cc5113a1bd518e01c10ba5fd48a783,0,Sriharsha Chintalapani,2016-03-24 21:45:32-07:00,"['9f2ca7ef2d7c8137cbf0e988d7d615938075bead', '0c2b555bbac622a7731aacf26cfc6585b886c8c8']",16,16,32,3891897,3,,,,2789
26ab643a783e79b9f1293e2b13a4cc4753dd4190,0,Sriharsha Chintalapani,2016-03-24 21:47:09-07:00,['edf19fe611cc5113a1bd518e01c10ba5fd48a783'],0,1,1,3891898,1,,,,2789
de70c375e009b50cdd0e7e4f44bfe5d5d6c77cbc,0,Sriharsha Chintalapani,2016-03-24 21:52:54-07:00,"['26ab643a783e79b9f1293e2b13a4cc4753dd4190', 'c6ed8d0c419dba8bdb479a432d5e7855f78b012b']",16,3,19,3891917,2,,,,2789
a7802e4e8087ef9443fbb63742eeeadd702564ac,0,Sriharsha Chintalapani,2016-03-24 21:53:35-07:00,['de70c375e009b50cdd0e7e4f44bfe5d5d6c77cbc'],0,1,1,3891918,1,,,,2789
4264bfc2a93a49f535fcad5fe8e871161ed13048,0,Sriharsha Chintalapani,2016-03-24 22:00:04-07:00,['a7802e4e8087ef9443fbb63742eeeadd702564ac'],2,2,4,3891922,1,,,,2789
7d0551d0501bf625a9ae8f592df71150bd160540,1,xiaojian.fxj,2016-03-25 13:37:36+08:00,"['afd2e3f5a53d2a086de1d1d62048377486ab1992', '753648927bb2c82443ede9525200bb6197f8d3b6']",19,12,31,3891953,5,,,,2789
2e1056648add8c4535d780afb44e04201eff3e52,0,Jungtaek Lim,2016-03-25 18:08:05+09:00,"['4264bfc2a93a49f535fcad5fe8e871161ed13048', 'ba2385882e705ebf5c33f5a03b67dc3b14781460']",13,9,22,3891975,1,,,,2789
915ce3848d11328005337e16f1c2f47a6773c1d9,0,Jungtaek Lim,2016-03-25 18:08:43+09:00,['2e1056648add8c4535d780afb44e04201eff3e52'],1,2,3,3891978,1,,,,2789
13e8b11a580cea2e67760d14b6efef9a943b3faf,0,zhuol,2016-03-25 15:35:54-05:00,['58f1161cb077f90fb64e8a68f9da9c9aedf4f7dd'],1,2,3,3891981,1,,,,2789
91f8a456d99f92aabb50898f6935a7b44015bf40,0,zhuol,2016-03-25 15:37:41-05:00,['13e8b11a580cea2e67760d14b6efef9a943b3faf'],1,1,2,3891983,1,,,,2789
d22d8450bfd6b0304ec04f68c7710810db3ab5f2,0,Robert (Bobby) Evans,2016-03-25 16:20:33-05:00,['915ce3848d11328005337e16f1c2f47a6773c1d9'],0,50,50,3892033,1,,,,2789
d0aac5fefd743d21738d2140232c10ce58985a1e,0,Hugo Louro,2016-03-25 14:28:05-07:00,['d22d8450bfd6b0304ec04f68c7710810db3ab5f2'],88,1544,1632,3893665,19,0.865740741,0.921296296,0.924382716,2800
3c79096f6295559ee649e88ff3569a6fae0b5723,0,zhuol,2016-03-25 16:38:53-05:00,['91f8a456d99f92aabb50898f6935a7b44015bf40'],7,2,9,3893674,1,1,1,0,2800
8c31e4ddf9012eaf13d76e6c16684037b31fe5ef,0,Bryant,2016-03-25 16:03:13-07:00,['d22d8450bfd6b0304ec04f68c7710810db3ab5f2'],1,1,2,3893676,1,,,,2800
843d6904369ab7db584bcef6e9a62e6be2845b7a,0,Bryant,2016-03-25 16:03:13-07:00,['8c31e4ddf9012eaf13d76e6c16684037b31fe5ef'],7,7,14,3893690,1,,,,2800
3b7c4a81d7c5111eb6d506bef7cedf9254bf91d0,0,Bryant,2016-03-25 17:28:26-07:00,['843d6904369ab7db584bcef6e9a62e6be2845b7a'],0,310,310,3894000,5,,,,2804
8d1991ad7aef9e7ec3d3cb1205ce835e8089ba59,0,Jungtaek Lim,2016-03-26 15:24:54+09:00,"['d22d8450bfd6b0304ec04f68c7710810db3ab5f2', '21ed0a37916d878632812f4ad7d1d2d663f5bf48']",51,23,74,3894074,3,,,,2804
f118060dceee8be014dddb9311ea8ecf0425bf85,0,Jungtaek Lim,2016-03-26 15:25:10+09:00,['8d1991ad7aef9e7ec3d3cb1205ce835e8089ba59'],0,1,1,3894075,1,,,,2804
ac590b43022007a5a0c047c232767bdfd763278b,0,Satish Duggana,2016-03-26 22:49:18+05:18,"['1bac2a9a080d94286cc3ef2d21fa507ca5140528', 'f118060dceee8be014dddb9311ea8ecf0425bf85']",258,579,837,3894912,30,,,,2804
1f1b5504317b9b21dfa2242e7d9650e65bd9cf19,0,Satish Duggana,2016-03-26 23:01:40+05:18,['ac590b43022007a5a0c047c232767bdfd763278b'],6,4,10,3894922,1,,,,2804
0a00c67170db83da3f5c29dcecf6f185fd066b9b,0,Xin Wang,2016-03-27 16:10:53+08:00,['f118060dceee8be014dddb9311ea8ecf0425bf85'],6,948,954,3895876,6,,,,2808
e58c67aef255ee54f392814f1ac998da7d29ba51,0,Xin Wang,2016-03-27 17:37:40+08:00,['f118060dceee8be014dddb9311ea8ecf0425bf85'],10,23,33,3895909,1,,,,2808
a48fae243d7bf4d374a6a3de8e9d3e46d9bd3b64,0,Jungtaek Lim,2016-03-27 20:24:38+09:00,"['f118060dceee8be014dddb9311ea8ecf0425bf85', '0a00c67170db83da3f5c29dcecf6f185fd066b9b']",6,948,954,3896863,6,,,,2808
29d4ba01f145f3089640e42c6dd1a9916fbfe7f8,0,Xin Wang,2016-03-27 23:02:23+08:00,['e58c67aef255ee54f392814f1ac998da7d29ba51'],15,0,15,3896878,1,,,,2808
b102028ce044892b61fb74a4d8e0c19016e05c40,0,Sriharsha Chintalapani,2016-03-27 21:11:05-07:00,"['a48fae243d7bf4d374a6a3de8e9d3e46d9bd3b64', '1f1b5504317b9b21dfa2242e7d9650e65bd9cf19']",38,2856,2894,3899772,37,,,,2808
31db7dc2f78c406e82de7f08ce609d780458b619,0,Sriharsha Chintalapani,2016-03-27 22:10:52-07:00,['b102028ce044892b61fb74a4d8e0c19016e05c40'],0,1,1,3899773,1,,,,2808
a48e9535fd8bcd6de195a70af6102535b60d56d6,0,xiaojian.fxj,2016-03-28 13:37:42+08:00,"['0100898ce9006cedd66c61b082001d1d455e5199', '31db7dc2f78c406e82de7f08ce609d780458b619']",140,3910,4050,3903823,53,,,,2808
60f5dfbc56d293325472459e16cec537d59192a3,0,Satish Duggana,2016-03-28 14:57:25+05:18,['31db7dc2f78c406e82de7f08ce609d780458b619'],0,100,100,3903923,1,,,,2808
00503d99fc6d79dd45ca9dfa8426134ab7e768ed,0,Kyle Nusbaum,2016-03-28 11:27:38-05:00,['3b56c6b1847e5388e94b5c195b0965d55198d81c'],9,10,19,3903942,1,,,,2808
fbcd074c6c1aafc1086fde35d1cbcbdf74d1cdf7,0,Kyle Nusbaum,2016-03-28 11:34:58-05:00,"['31db7dc2f78c406e82de7f08ce609d780458b619', '00503d99fc6d79dd45ca9dfa8426134ab7e768ed']",0,53,53,3903995,3,,,,2808
6d4c6d54fd83030296c60957b5846eb2ccba8867,0,Kyle Nusbaum,2016-03-28 12:13:40-05:00,['fbcd074c6c1aafc1086fde35d1cbcbdf74d1cdf7'],1,1,2,3903997,1,,,,2808
831c2cfbb73b3a008dbebb5b29927299602bb6b9,0,Kyle Nusbaum,2016-03-28 12:25:03-05:00,['6d4c6d54fd83030296c60957b5846eb2ccba8867'],3,5,8,3904005,1,,,,2808
a3cbe474779da27207f2be07d1bbffa991b765a8,0,Robert (Bobby) Evans,2016-03-28 13:08:38-05:00,['831c2cfbb73b3a008dbebb5b29927299602bb6b9'],1,4,5,3904010,1,,,,2808
988581d8b80676363580aee24edeb03a44c13074,0,Robert (Bobby) Evans,2016-03-28 13:20:43-05:00,['a3cbe474779da27207f2be07d1bbffa991b765a8'],3,2,5,3904015,1,,,,2808
89a349eb8a6ab7eac33b1ecc646d5ba984c73679,0,Robert (Bobby) Evans,2016-03-28 13:29:08-05:00,['988581d8b80676363580aee24edeb03a44c13074'],2,2,4,3904019,1,,,,2808
da7969ea946ca9baa633a59454cc9ab0de4542db,0,zhuol,2016-03-28 14:06:31-05:00,"['89a349eb8a6ab7eac33b1ecc646d5ba984c73679', '3c79096f6295559ee649e88ff3569a6fae0b5723']",751,732,1483,3905502,5,,,,2808
e5f0e91fcf7d377817982efd80f6e03d73dc371b,1,Sriharsha Chintalapani,2016-03-28 13:05:52-07:00,['c2cf3befce15ed79e41c1c02752f168194e9a1bf'],140,415,555,3906057,12,0.459627329,0.683229814,0.925465839,2809
09695564b97be6303c50df53071dda0111be2a36,0,Arun Mahadevan,2016-03-29 09:51:07+05:18,['31db7dc2f78c406e82de7f08ce609d780458b619'],0,94,94,3906151,6,,,,2814
775b2af78154baa01db81619ca32903e9f24aea8,0,Satish Duggana,2016-03-29 10:00:50+05:18,['60f5dfbc56d293325472459e16cec537d59192a3'],2,2,4,3906155,1,,,,2814
576499baba14926a564a51e0018f3ead86809ab1,0,Satish Duggana,2016-03-29 10:52:09+05:18,['31db7dc2f78c406e82de7f08ce609d780458b619'],35,122,157,3906312,8,1,1,0.75,2815
2eb80a0fd783a1bec3192802bf8e01d6ff152d74,0,Jungtaek Lim,2016-03-29 16:41:29+09:00,"['da7969ea946ca9baa633a59454cc9ab0de4542db', 'e5f0e91fcf7d377817982efd80f6e03d73dc371b']",140,415,555,3906867,12,,,,2815
4eaaa0bb19261020b67c820bd4aee3802a07e025,0,Jungtaek Lim,2016-03-29 16:42:04+09:00,['da7969ea946ca9baa633a59454cc9ab0de4542db'],0,1,1,3906868,1,,,,2815
e2ca82f8f55ecdaeac31d3da6c1fc634d9bc4b25,0,Jungtaek Lim,2016-03-29 17:01:22+09:00,"['4eaaa0bb19261020b67c820bd4aee3802a07e025', '2eb80a0fd783a1bec3192802bf8e01d6ff152d74']",140,415,555,3907423,12,,,,2815
cd9bcf27f9a6d2716bc27cd28199a89c5997d61b,0,Boyang Jerry Peng,2016-03-29 10:50:57-05:00,['5863d4af59997d9456decd1c0bf02e9bd1202b61'],0,45,45,3907468,1,0,1,1,2815
e5043cdc23e00df21346eae4e3862462f211e823,0,Robert (Bobby) Evans,2016-03-29 11:10:55-05:00,"['e2ca82f8f55ecdaeac31d3da6c1fc634d9bc4b25', 'cd9bcf27f9a6d2716bc27cd28199a89c5997d61b']",280,247,527,3907995,13,,,,2815
65494261af1a9f889af1fd9137c20b9f394026ab,0,Robert (Bobby) Evans,2016-03-29 11:11:28-05:00,['e5043cdc23e00df21346eae4e3862462f211e823'],0,1,1,3907996,1,,,,2815
045b507dc7d97b42fcccbb405f236113e62a2434,0,Stig D酶ssing,2016-03-29 19:39:56+02:00,['e2ca82f8f55ecdaeac31d3da6c1fc634d9bc4b25'],3,17,20,3908016,2,1,1,1,2815
8b16afbf595690ee428350f58bdec0fb2f3e60c7,0,Hugo Louro,2016-03-29 18:01:45-07:00,['d0aac5fefd743d21738d2140232c10ce58985a1e'],191,750,941,3908957,14,0.564516129,0.850806452,0.862903226,2820
f64e39b2b7c840dc79d7e6f395094424e5fd6bc3,0,Longda Feng,2016-03-30 15:03:06+08:00,"['65494261af1a9f889af1fd9137c20b9f394026ab', '6007e65d0590da40b34a69fe9b9f4dad75bc487d']",492,472,964,3909921,7,,,,2820
d2da484edcc55c7b7338ca96086568b612677a8a,0,Longda Feng,2016-03-30 15:20:46+08:00,['f64e39b2b7c840dc79d7e6f395094424e5fd6bc3'],0,1,1,3909922,1,,,,2820
f3078d5186b688fe7e61b829f893df351e3696eb,0,Longda Feng,2016-03-30 15:22:55+08:00,"['d2da484edcc55c7b7338ca96086568b612677a8a', 'ee78943a886b5858ff23ed1cd8499b86f0897e8b']",151,136,287,3910209,2,,,,2820
e14f4299393c79fa59be91150abf11cf13fc6c9f,0,Longda Feng,2016-03-30 15:40:54+08:00,['f3078d5186b688fe7e61b829f893df351e3696eb'],0,1,1,3910210,1,,,,2820
3812b2fa04cc7eb86035d402f3c407af3b4daffe,0,xiaojian.fxj,2016-03-30 16:56:12+08:00,"['a48e9535fd8bcd6de195a70af6102535b60d56d6', 'e14f4299393c79fa59be91150abf11cf13fc6c9f']",1820,2069,3889,3914099,43,,,,2820
d46ed8fbe6bbd8116ceb60769f4b0b569bfd2d0d,0,xiaojian.fxj,2016-03-30 17:06:30+08:00,"['7d0551d0501bf625a9ae8f592df71150bd160540', '3812b2fa04cc7eb86035d402f3c407af3b4daffe']",1965,5981,7946,3922045,95,,,,2820
7d63cb33a99940e11663257b515186e40d4f239e,1,Abhishek Agarwal,2016-03-30 21:31:54+05:18,['4264bfc2a93a49f535fcad5fe8e871161ed13048'],367,675,1042,3923087,14,0.389057751,0.556231003,0.668693009,2822
8c7c197d03af76681111fedbc3a7d812f1d79b5f,0,Sanket,2016-03-30 11:36:27-05:00,['e14f4299393c79fa59be91150abf11cf13fc6c9f'],2,21,23,3923110,3,0.333333333,1,0.333333333,2822
ecf4586bc8f32b2c253c134ed0e7380b0a3f917a,0,Robert (Bobby) Evans,2016-03-30 14:23:31-05:00,['e14f4299393c79fa59be91150abf11cf13fc6c9f'],10,13,23,3923133,1,0,0,0,2822
08eb49e8122f7df607716cc7ed054b368b5b9b50,0,Robert (Bobby) Evans,2016-03-30 14:24:35-05:00,['ecf4586bc8f32b2c253c134ed0e7380b0a3f917a'],6,0,6,3923139,1,,,,2822
f807c80d9be1179e2d23cbc494aaa25fa57ff602,0,Robert (Bobby) Evans,2016-03-30 14:30:19-05:00,['08eb49e8122f7df607716cc7ed054b368b5b9b50'],1,2,3,3923142,1,,,,2822
ba77a1b209aab88b50940e578dc215bbfd175616,0,P. Taylor Goetz,2016-03-30 15:52:41-04:00,"['e14f4299393c79fa59be91150abf11cf13fc6c9f', '29d4ba01f145f3089640e42c6dd1a9916fbfe7f8']",25,23,48,3923190,2,,,,2822
2f1411da32e3f9404b1653c0f28bb6df9a549434,0,P. Taylor Goetz,2016-03-30 15:53:49-04:00,['ba77a1b209aab88b50940e578dc215bbfd175616'],0,1,1,3923191,1,,,,2822
96828b3a8015b29caee0a99d9e5bb6da4be2f0fe,0,Stig Rohde D酶ssing,2016-03-30 22:13:52+02:00,['045b507dc7d97b42fcccbb405f236113e62a2434'],1,1,2,3923193,1,,,,2822
436d7752d9e8deca5b4d83f502eb98491548896f,0,Priyank,2016-03-30 16:23:05-07:00,['2f1411da32e3f9404b1653c0f28bb6df9a549434'],25,20,45,3923238,5,0,0,1,2822
8be5417c8db89ec74dae1f41589a95d95c5c6aac,0,xiaojian.fxj,2016-03-31 09:21:47+08:00,"['3812b2fa04cc7eb86035d402f3c407af3b4daffe', '2f1411da32e3f9404b1653c0f28bb6df9a549434']",25,24,49,3923287,3,,,,2822
01062f109e9f05e93eed3c15a52a623f270cfef1,0,Xin Wang,2016-03-31 12:30:35+08:00,['2f1411da32e3f9404b1653c0f28bb6df9a549434'],14,9,23,3923310,1,0,0,0.166666667,2822
78f17061f7af82e82b011dcadff0829cad202227,0,vesense,2016-03-31 12:45:59+08:00,['50701df4ae3249e43200eaa9803e471cf7513543'],19,80,99,3923409,4,0.195121951,0.195121951,0.975609756,2822
68250d2a22052ecda16864db7fdf982dcafd9048,0,Jungtaek Lim,2016-03-31 14:23:33+09:00,"['2f1411da32e3f9404b1653c0f28bb6df9a549434', '78f17061f7af82e82b011dcadff0829cad202227']",19,80,99,3923508,4,,,,2822
dba69b528860b29fed435c85ee1f76b09f982105,1,xiaojian.fxj,2016-03-31 13:24:15+08:00,"['d46ed8fbe6bbd8116ceb60769f4b0b569bfd2d0d', '8be5417c8db89ec74dae1f41589a95d95c5c6aac']",186,148,334,3923842,13,,,,2822
98dbdcdb5cf63e3d92b7b67137f44911673d8d8f,0,Jungtaek Lim,2016-03-31 14:45:44+09:00,['68250d2a22052ecda16864db7fdf982dcafd9048'],0,1,1,3923843,1,,,,2822
d5b80fccace4e964d2ac7cce338f416c4efe5a5a,0,Jungtaek Lim,2016-03-31 18:30:19+09:00,"['98dbdcdb5cf63e3d92b7b67137f44911673d8d8f', '775b2af78154baa01db81619ca32903e9f24aea8']",0,100,100,3923943,1,,,,2822
3ef91b0c2d9bba94e4bce8da9d55b4357f7697eb,0,Robert (Bobby) Evans,2016-03-31 12:55:25-05:00,"['d5b80fccace4e964d2ac7cce338f416c4efe5a5a', 'f807c80d9be1179e2d23cbc494aaa25fa57ff602']",17,15,32,3923975,3,,,,2822
955b44552e7351ac0171b661b8aa5136a158e05c,0,Robert (Bobby) Evans,2016-03-31 12:56:32-05:00,['3ef91b0c2d9bba94e4bce8da9d55b4357f7697eb'],0,3,3,3923978,1,,,,2822
d26b984d74987c95badbdf8a73c74c4304bd4ec9,1,Robert (Bobby) Evans,2016-03-31 13:59:32-05:00,['955b44552e7351ac0171b661b8aa5136a158e05c'],88,1544,1632,3925610,19,0.865740741,0.921296296,0.924382716,2833
332afc40d8ee7c1f4a4a747280ff83a92c279c5d,1,Robert (Bobby) Evans,2016-03-31 13:59:32-05:00,['d26b984d74987c95badbdf8a73c74c4304bd4ec9'],191,750,941,3926551,14,0.564516129,0.850806452,0.862903226,2838
cd0c0f73322fbaf81405be6cdaddeab080bd59b1,0,Robert (Bobby) Evans,2016-03-31 13:59:32-05:00,['332afc40d8ee7c1f4a4a747280ff83a92c279c5d'],0,1,1,3926552,1,,,,2838
3c03a0f0be95d3bfdf07513e704f4ce2dc444c7a,0,Robert (Bobby) Evans,2016-03-31 14:00:54-05:00,"['cd0c0f73322fbaf81405be6cdaddeab080bd59b1', '8b16afbf595690ee428350f58bdec0fb2f3e60c7']",0,0,0,3926552,0,,,,2838
7862fe4522dbd4b8bc6291bf8a8a3dd9530b6ee0,0,P. Taylor Goetz,2016-03-31 15:24:12-04:00,"['3c03a0f0be95d3bfdf07513e704f4ce2dc444c7a', '576499baba14926a564a51e0018f3ead86809ab1']",35,122,157,3926709,8,,,,2838
223b615d1bea665b66c5c0fe8fd89cdc2e6dd94d,0,P. Taylor Goetz,2016-03-31 15:25:08-04:00,['7862fe4522dbd4b8bc6291bf8a8a3dd9530b6ee0'],0,1,1,3926710,1,,,,2838
31d558cad5c8ee99f0e3540203cfa7e04341d6f8,0,Robert (Bobby) Evans,2016-03-31 14:27:36-05:00,"['223b615d1bea665b66c5c0fe8fd89cdc2e6dd94d', '7d63cb33a99940e11663257b515186e40d4f239e']",367,675,1042,3927752,14,,,,2838
084492782356220404b560aae2567cd4ee7f8052,0,Robert (Bobby) Evans,2016-03-31 14:54:22-05:00,['31d558cad5c8ee99f0e3540203cfa7e04341d6f8'],0,1,1,3927753,1,,,,2838
fd02ac603276b3b38a755eb2c967a51c0b630039,0,P. Taylor Goetz,2016-03-31 16:33:28-04:00,['084492782356220404b560aae2567cd4ee7f8052'],122,35,157,3927910,8,0,0,0.25,2838
33e499479121ba39575d45b126d5f9b3da9c1a94,0,P. Taylor Goetz,2016-03-31 16:34:20-04:00,['fd02ac603276b3b38a755eb2c967a51c0b630039'],1,0,1,3927911,1,,,,2838
6763f71b3e4f1d8e5b8f1f05b61f622db0969642,0,Robert (Bobby) Evans,2016-03-31 15:45:06-05:00,['084492782356220404b560aae2567cd4ee7f8052'],5,36,41,3927952,1,0,0.952380952,0.619047619,2838
1b4edf4225cadae99d0a88d51d1b74dc7a9347ce,0,xiaojian.fxj,2016-04-01 09:03:01+08:00,"['8be5417c8db89ec74dae1f41589a95d95c5c6aac', '33e499479121ba39575d45b126d5f9b3da9c1a94']",491,2979,3470,3931422,46,,,,2838
ac9942cfee18dfb29dae1787c3f36f978cdcfa85,0,xiaojian.fxj,2016-04-01 09:21:47+08:00,"['dba69b528860b29fed435c85ee1f76b09f982105', '1b4edf4225cadae99d0a88d51d1b74dc7a9347ce']",500,2985,3485,3934907,47,,,,2838
7a67fcb14564a8b1547bc66017d04adcc3525c20,0,Kyle Nusbaum,2016-03-31 22:13:50-05:00,"['33e499479121ba39575d45b126d5f9b3da9c1a94', '436d7752d9e8deca5b4d83f502eb98491548896f']",25,20,45,3934952,5,,,,2838
2a435b0289d43494eb2f834e94ed61c175f9eea6,0,Kyle Nusbaum,2016-03-31 22:15:48-05:00,['7a67fcb14564a8b1547bc66017d04adcc3525c20'],0,1,1,3934953,1,,,,2838
96da31ed0068dde3b4309ee417382be5084ce941,0,Jungtaek Lim,2016-04-01 12:22:38+09:00,['2a435b0289d43494eb2f834e94ed61c175f9eea6'],1,1,2,3934955,1,,,,2838
1ed04f14e54efd4b9fbaac4f9e4b73869961ed20,0,Bryant,2016-03-31 20:40:08-07:00,['3b7c4a81d7c5111eb6d506bef7cedf9254bf91d0'],38,41,79,3935034,2,,,,2838
b850847d946ba5ad9809308065352a94bd6287b3,0,Satish Duggana,2016-04-01 09:16:22+05:18,['33e499479121ba39575d45b126d5f9b3da9c1a94'],35,122,157,3935191,8,1,1,0.75,2839
bcf8c8a6e88b6cb57852e3e9af24168e25c0f486,0,Arun Mahadevan,2016-04-01 09:44:10+05:18,['09695564b97be6303c50df53071dda0111be2a36'],5,8,13,3935204,1,,,,2839
ca4015eadfc23bf7bf38c594c9782df22bdf3298,0,P. Taylor Goetz,2016-04-01 00:49:37-04:00,"['33e499479121ba39575d45b126d5f9b3da9c1a94', '01062f109e9f05e93eed3c15a52a623f270cfef1']",14,9,23,3935227,1,,,,2839
a09bf00df2e081db40946571d7877f3c762cf88d,0,P. Taylor Goetz,2016-04-01 00:55:41-04:00,['ca4015eadfc23bf7bf38c594c9782df22bdf3298'],0,1,1,3935228,1,,,,2839
b74320497ba3d3465ddc1c94eda0c4a387046b59,0,P. Taylor Goetz,2016-04-01 00:56:04-04:00,"['a09bf00df2e081db40946571d7877f3c762cf88d', '2a435b0289d43494eb2f834e94ed61c175f9eea6']",25,21,46,3935274,6,,,,2839
3957be5495fbbc79f9c47c4dfa9a3670e7ddb36f,1,Abhishek Agarwal,2016-04-01 16:42:29+05:18,['b74320497ba3d3465ddc1c94eda0c4a387046b59'],9,12,21,3935295,1,0,1,1,2839
20d05e30f956b2905a0816d5dc6aad79dfc2d75f,0,Robert (Bobby) Evans,2016-04-01 08:18:52-05:00,"['b74320497ba3d3465ddc1c94eda0c4a387046b59', 'ac9942cfee18dfb29dae1787c3f36f978cdcfa85']",1587,3359,4946,3940241,32,,,,2839
3de3afc37498ebf007c0f8d07146a2afe286a507,0,Robert (Bobby) Evans,2016-04-01 08:19:19-05:00,['20d05e30f956b2905a0816d5dc6aad79dfc2d75f'],0,1,1,3940242,1,,,,2839
821028374fd09d88d97b3ca3e283da2192f0f2ae,1,zhuol,2016-04-01 11:07:09-05:00,['3de3afc37498ebf007c0f8d07146a2afe286a507'],14,15,29,3940271,3,,,,2839
e9f6a842cfaa13f7a81ceb9b6bc0ce87ca267fd1,0,P. Taylor Goetz,2016-04-01 13:00:47-04:00,"['3de3afc37498ebf007c0f8d07146a2afe286a507', '96da31ed0068dde3b4309ee417382be5084ce941']",1,1,2,3940273,1,,,,2839
175beec7e5b787f51fe4bc772c48bdb4ec41fc20,0,P. Taylor Goetz,2016-04-01 13:01:44-04:00,['e9f6a842cfaa13f7a81ceb9b6bc0ce87ca267fd1'],0,1,1,3940274,1,,,,2839
224d156ec0a301591676d129105bc533b86d00c7,0,P. Taylor Goetz,2016-04-01 14:45:23-04:00,"['175beec7e5b787f51fe4bc772c48bdb4ec41fc20', '821028374fd09d88d97b3ca3e283da2192f0f2ae']",14,15,29,3940303,3,,,,2839
3f11cca9355cebb6054b56ec28ad54cd13e453e8,0,P. Taylor Goetz,2016-04-01 14:46:32-04:00,['224d156ec0a301591676d129105bc533b86d00c7'],0,1,1,3940304,1,,,,2839
68cc70518f10a9e0ec75fe72aeb2e98624a7b330,0,zhuol,2016-04-01 14:04:05-05:00,"['175beec7e5b787f51fe4bc772c48bdb4ec41fc20', '821028374fd09d88d97b3ca3e283da2192f0f2ae']",14,15,29,3940333,3,,,,2839
69ec8ffa1f9bb043291b94d3fd3c1b9b2a74f598,0,P. Taylor Goetz,2016-04-01 15:29:01-04:00,"['3f11cca9355cebb6054b56ec28ad54cd13e453e8', '68cc70518f10a9e0ec75fe72aeb2e98624a7b330']",0,0,0,3940333,0,,,,2839
4c0500206509b205769b8a1a17a17f77d7772fa7,1,Satish Duggana,2016-04-02 07:48:44+05:18,['69ec8ffa1f9bb043291b94d3fd3c1b9b2a74f598'],20,32,52,3940385,1,1,1,1,2839
f6616ccd3de64c55460492f5968ad64a21adcf86,0,Satish Duggana,2016-04-02 07:48:44+05:18,['4c0500206509b205769b8a1a17a17f77d7772fa7'],32,21,53,3940438,1,0,0,0,2839
55c4a6874ddc7e2228a1ea7aa954f378593d3a45,0,Satish Duggana,2016-04-02 08:21:17+05:18,['f6616ccd3de64c55460492f5968ad64a21adcf86'],1,10,11,3940449,1,,,,2839
d5e11126a9c4082b66763bbd493a5b764c3a54ac,0,Jungtaek Lim,2016-04-02 15:15:05+09:00,['2a435b0289d43494eb2f834e94ed61c175f9eea6'],7,7,14,3940463,5,,,,2839
fbef299570ba72d2a29c90f0e7efd91b60cb9b6a,0,Xin Wang,2016-04-03 16:09:31+08:00,['69ec8ffa1f9bb043291b94d3fd3c1b9b2a74f598'],80,146,226,3940689,5,1,1,0.25,2840
d16ee25c7b1db4547e39a4af4d89a3c1b42d9c73,0,Boyang Jerry Peng,2016-04-04 11:17:12-05:00,['69ec8ffa1f9bb043291b94d3fd3c1b9b2a74f598'],4,64,68,3940757,2,0,0.976190476,1,2840
6e7892cad2c8fe651eb7e2b2650b4403e3a8874e,0,Kyle Nusbaum,2016-04-04 11:17:50-05:00,"['69ec8ffa1f9bb043291b94d3fd3c1b9b2a74f598', '1ed04f14e54efd4b9fbaac4f9e4b73869961ed20']",8,321,329,3941086,7,,,,2840
f631516793cd84fc90ad40567479e31f681436a5,0,Kyle Nusbaum,2016-04-04 11:18:23-05:00,['6e7892cad2c8fe651eb7e2b2650b4403e3a8874e'],0,1,1,3941087,1,,,,2840
eb601acccb484942d1fb3c942e0c10ea87c68225,0,P. Taylor Goetz,2016-04-04 16:18:41-04:00,"['f631516793cd84fc90ad40567479e31f681436a5', 'd5e11126a9c4082b66763bbd493a5b764c3a54ac']",7,7,14,3941101,5,,,,2840
674a5e22a0071dd7fb57585315cc54d0797cea5b,0,P. Taylor Goetz,2016-04-04 16:21:08-04:00,['eb601acccb484942d1fb3c942e0c10ea87c68225'],0,3,3,3941104,1,,,,2840
b2bb8dc275f138b51c9e2662951404008d41c048,0,P. Taylor Goetz,2016-04-04 16:58:54-04:00,"['674a5e22a0071dd7fb57585315cc54d0797cea5b', '55c4a6874ddc7e2228a1ea7aa954f378593d3a45']",2,12,14,3941118,2,,,,2840
4ed28c1ab692af508b6d3d5cef1f4d52453f2bba,0,P. Taylor Goetz,2016-04-04 17:00:00-04:00,['b2bb8dc275f138b51c9e2662951404008d41c048'],0,1,1,3941119,1,,,,2840
103e0c6a1387d32e7d141b1a0af9d3a62127b477,1,zhuol,2016-04-04 21:38:38-05:00,['4ed28c1ab692af508b6d3d5cef1f4d52453f2bba'],41,56,97,3941216,3,0,1,1,2841
44343318a116b8d546df3dedadc2bbea427ae3eb,0,zhuol,2016-04-05 20:03:02-05:00,['4ed28c1ab692af508b6d3d5cef1f4d52453f2bba'],1,1,2,3941218,1,,0,,2841
4284b09c7bee2507e46b84b7cff4450902151a97,0,zhuol,2016-04-06 11:34:30-05:00,"['4ed28c1ab692af508b6d3d5cef1f4d52453f2bba', '103e0c6a1387d32e7d141b1a0af9d3a62127b477']",41,56,97,3941315,3,,,,2841
e5ed7ffe5a81e3c6ecf106f21cc84dd2bbe0a927,0,Derek Dagit,2016-04-06 11:20:24-07:00,['f631516793cd84fc90ad40567479e31f681436a5'],9,3,12,3941327,1,,,,2841
7e88f9dc400892e9a6ba7c4509c08a31ff4ac18f,0,Xin Wang,2016-04-07 16:54:01+08:00,['4284b09c7bee2507e46b84b7cff4450902151a97'],2,1,3,3941330,2,,,,2841
b68f49acf4a9b478535d1a85459b74737bad3e85,0,Xin Wang,2016-04-07 20:39:06+08:00,['7e88f9dc400892e9a6ba7c4509c08a31ff4ac18f'],1,1,2,3941332,1,,,,2841
1b6724c2ff4bc61b49c5d0d8956984bf4be68256,0,Aaron Dossett,2016-04-07 11:22:11-05:00,"['4284b09c7bee2507e46b84b7cff4450902151a97', '7554fe2042369141d374b149de40949557ee70ea']",187,730,917,3942249,19,,,,2841
f48d7941b10483e87a30b4849321c4dc0844a5a5,0,Aaron Dossett,2016-04-07 11:49:15-05:00,['1b6724c2ff4bc61b49c5d0d8956984bf4be68256'],0,1,1,3942250,1,,,,2841
7bc317f0a753e650238f8ced2aeba73f79f3dbc0,0,Xin Wang,2016-04-09 22:50:29+08:00,['b68f49acf4a9b478535d1a85459b74737bad3e85'],2,2,4,3942254,1,,,,2841
55692bb6364de87b0bb24db841c40d93047f9439,1,Jungtaek Lim,2016-04-11 16:55:13+09:00,['f48d7941b10483e87a30b4849321c4dc0844a5a5'],37,106,143,3942397,4,,,,2841
3b8bc85bd36fd31ca8d4d8874e8f91c2dd581e9a,0,Robert (Bobby) Evans,2016-04-11 09:52:54-05:00,"['f48d7941b10483e87a30b4849321c4dc0844a5a5', '44343318a116b8d546df3dedadc2bbea427ae3eb']",1,1,2,3942399,1,,,,2841
eadc7c4b565b6fac0a75f586fe7a3250966846e3,0,Robert (Bobby) Evans,2016-04-11 09:53:19-05:00,['3b8bc85bd36fd31ca8d4d8874e8f91c2dd581e9a'],0,1,1,3942400,1,,,,2841
641586321553c67fcf71a77080ddabcfdf00bb54,0,Robert (Bobby) Evans,2016-04-12 09:49:23-05:00,"['eadc7c4b565b6fac0a75f586fe7a3250966846e3', '7bc317f0a753e650238f8ced2aeba73f79f3dbc0']",5,4,9,3942409,3,,,,2841
983c420bfb170fba0b6ae0fd1b1fb3b99d3a1079,0,Abhishek Agarwal,2016-04-12 21:00:09+05:18,['641586321553c67fcf71a77080ddabcfdf00bb54'],34,10,44,3942453,5,0,0,0,2841
a70195d717e1ed179425a0305b2e4279afeb6118,0,zhuoliu,2016-04-13 13:04:57-05:00,['641586321553c67fcf71a77080ddabcfdf00bb54'],8,15,23,3942476,2,1,1,1,2841
63518be11275104314dcebbf83bb1f8a513891ee,0,zhuoliu,2016-04-13 13:08:19-05:00,['a70195d717e1ed179425a0305b2e4279afeb6118'],2,2,4,3942480,1,,,,2841
ac1d008f24a14eeceaa086bee057088b7dd095e3,0,Boyang Jerry Peng,2016-04-14 10:08:28-05:00,"['641586321553c67fcf71a77080ddabcfdf00bb54', 'd16ee25c7b1db4547e39a4af4d89a3c1b42d9c73']",4,64,68,3942548,2,,,,2841
1db08472c17350cfb1744fc28f277bf0ea02b13f,0,Boyang Jerry Peng,2016-04-14 10:19:14-05:00,['ac1d008f24a14eeceaa086bee057088b7dd095e3'],0,1,1,3942549,1,,,,2841
e5a884847833dd179f988b5b7a24525c97542f4f,0,Sriharsha Chintalapani,2016-04-14 08:20:42-07:00,"['1db08472c17350cfb1744fc28f277bf0ea02b13f', '8842b73184e6b4b0bfa28778db44949693d65258']",14,289,303,3942852,10,,,,2841
a41fef386d5ff31fae13d1604abbb509bb5c4728,0,Sriharsha Chintalapani,2016-04-14 09:54:45-07:00,['e5a884847833dd179f988b5b7a24525c97542f4f'],0,1,1,3942853,1,,,,2841
baaba667e1ecea3f644974eda72bbfa922b31586,0,Jungtaek Lim,2016-04-15 11:16:46+09:00,"['a41fef386d5ff31fae13d1604abbb509bb5c4728', '983c420bfb170fba0b6ae0fd1b1fb3b99d3a1079']",34,10,44,3942897,5,,,,2841
6cf8a9c99587b4e3541cd93c09811cf938d1a601,0,Jungtaek Lim,2016-04-15 11:32:56+09:00,['baaba667e1ecea3f644974eda72bbfa922b31586'],0,1,1,3942898,1,,,,2841
34d95156dbec702d1ea5d20b2c9247e88fbb717e,0,Jungtaek Lim,2016-04-15 11:43:23+09:00,"['6cf8a9c99587b4e3541cd93c09811cf938d1a601', '63518be11275104314dcebbf83bb1f8a513891ee']",10,17,27,3942925,2,,,,2841
97e131d5a2d4140fec02aa3a05b5554b6fc289f4,0,Jungtaek Lim,2016-04-15 11:50:40+09:00,['34d95156dbec702d1ea5d20b2c9247e88fbb717e'],0,1,1,3942926,1,,,,2841
5ddec1eddd46568d9917b33681c459fa04fc31f4,0,Stig Rohde D酶ssing,2016-04-15 11:26:19+02:00,['97e131d5a2d4140fec02aa3a05b5554b6fc289f4'],2,1,3,3942929,1,,,,2841
8868a58c27b6baee3d8fa1487434fc58509e514d,0,Arun Mahadevan,2016-04-15 20:41:36+05:18,['97e131d5a2d4140fec02aa3a05b5554b6fc289f4'],4,91,95,3943024,4,1,1,1,2841
e9785d8f1944f6c4bd9ad24dbf7b296830c7e685,0,mjsax,2016-04-16 13:27:44+02:00,['97e131d5a2d4140fec02aa3a05b5554b6fc289f4'],1,1,2,3943026,1,,,,2841
339a95750d1b599c46aac08e2e537db7776ba22f,0,Xin Wang,2016-04-19 10:09:11+08:00,['e9785d8f1944f6c4bd9ad24dbf7b296830c7e685'],1,1,2,3943028,1,,,,2841
f2a02bff16401fd27d91c6efee951ecb528a1b7b,0,Arun Mahadevan,2016-04-19 23:06:56+05:18,['8868a58c27b6baee3d8fa1487434fc58509e514d'],160,218,378,3943406,3,0,0,0,2842
abf16e9c9306054246f3a0dce8276a336e40562f,1,Arun Mahadevan,2016-04-20 10:35:06+05:18,['a41fef386d5ff31fae13d1604abbb509bb5c4728'],5,552,557,3943963,7,0.545454545,0.93315508,0.815508021,2843
3cee864ba23f350cffa53f17542e27b16419b1f0,0,Jungtaek Lim,2016-04-20 16:09:59+09:00,"['e9785d8f1944f6c4bd9ad24dbf7b296830c7e685', 'b850847d946ba5ad9809308065352a94bd6287b3']",35,122,157,3944120,8,,,,2843
d593918a50034a140c42fd20d824bebea8fd6b34,0,Jungtaek Lim,2016-04-20 16:10:42+09:00,['3cee864ba23f350cffa53f17542e27b16419b1f0'],0,1,1,3944121,1,,,,2843
8b0af5004d8472117d709caa8af997c6842d982a,1,Jungtaek Lim,2016-04-20 16:31:02+09:00,['d593918a50034a140c42fd20d824bebea8fd6b34'],2,5,7,3944128,2,,,,2843
c8457812805b658d895445ce58d2583d1cdfaa59,0,Jungtaek Lim,2016-04-20 16:31:10+09:00,"['d593918a50034a140c42fd20d824bebea8fd6b34', '8b0af5004d8472117d709caa8af997c6842d982a']",2,5,7,3944135,2,,,,2843
ce36b6dbf0372c704964e5e854f7863960447a49,0,Jungtaek Lim,2016-04-20 16:31:42+09:00,['c8457812805b658d895445ce58d2583d1cdfaa59'],0,1,1,3944136,1,,,,2843
fbf1e84a2fbcaa45588af51ddcb233e7600d81b9,0,Jungtaek Lim,2016-04-20 16:44:26+09:00,"['ce36b6dbf0372c704964e5e854f7863960447a49', 'e5ed7ffe5a81e3c6ecf106f21cc84dd2bbe0a927']",9,3,12,3944148,1,,,,2843
e6b57ce4bb0acd11631350501461c06a608e4ed9,0,Jungtaek Lim,2016-04-20 16:44:58+09:00,['fbf1e84a2fbcaa45588af51ddcb233e7600d81b9'],0,1,1,3944149,1,,,,2843
3e8edcabf1dc7f39e5f6103a0a461d66ede6bf6c,0,Jungtaek Lim,2016-04-20 17:07:15+09:00,"['e6b57ce4bb0acd11631350501461c06a608e4ed9', 'f2a02bff16401fd27d91c6efee951ecb528a1b7b']",156,301,457,3944606,5,,,,2843
1677de1a1a4177b0f2f3cacdf4152b7e9fa976bd,0,Jungtaek Lim,2016-04-20 17:17:39+09:00,['3e8edcabf1dc7f39e5f6103a0a461d66ede6bf6c'],0,1,1,3944607,1,,,,2843
0ae7a482639bb66dd7020d64dc441e6ee067c726,0,Jungtaek Lim,2016-04-20 17:26:01+09:00,"['1677de1a1a4177b0f2f3cacdf4152b7e9fa976bd', '55692bb6364de87b0bb24db841c40d93047f9439']",37,106,143,3944750,4,,,,2843
1a09da555c3aa7b0daa6d4348c6a35421a6dfeba,0,Jungtaek Lim,2016-04-20 17:26:24+09:00,['0ae7a482639bb66dd7020d64dc441e6ee067c726'],0,1,1,3944751,1,,,,2843
97ee007f14e597fbdceda45bf25c4f0dfe537fc1,0,darionyaphet,2016-04-20 20:57:09+08:00,['1a09da555c3aa7b0daa6d4348c6a35421a6dfeba'],2,1,3,3944754,1,,,,2843
3cf4bcf3cb505aa32507e82320a89d4c25bd4bd8,0,vesense,2016-04-20 23:30:01+08:00,['69ec8ffa1f9bb043291b94d3fd3c1b9b2a74f598'],0,28,28,3944782,2,,,,2844
bc488c23420215db847fd8dde5a1006e319521de,0,Priyank,2016-04-20 18:19:41-07:00,['1a09da555c3aa7b0daa6d4348c6a35421a6dfeba'],10,15,25,3944807,1,0,0,1,2844
87b0f3c895f54b87e0265f7f28984e0e3f310b58,0,Priyank,2016-04-21 10:10:26-07:00,['bc488c23420215db847fd8dde5a1006e319521de'],1,0,1,3944808,1,,,,2844
8e4903152063e8ca35d2dfb235c9bbc2177cf339,0,P. Taylor Goetz,2016-04-21 13:57:39-04:00,"['4ed28c1ab692af508b6d3d5cef1f4d52453f2bba', '3cf4bcf3cb505aa32507e82320a89d4c25bd4bd8']",0,28,28,3944836,2,,,,2844
489a8447e04363f17b445b6fab8d623a54f5dc2f,0,P. Taylor Goetz,2016-04-21 13:58:26-04:00,['8e4903152063e8ca35d2dfb235c9bbc2177cf339'],0,1,1,3944837,1,,,,2844
fdf2cd0050ced1954714f2d128a9443d0a7a46ec,0,P. Taylor Goetz,2016-04-21 14:01:09-04:00,"['489a8447e04363f17b445b6fab8d623a54f5dc2f', '1a09da555c3aa7b0daa6d4348c6a35421a6dfeba']",536,1720,2256,3947093,66,,,,2844
753670689a90ca3c918c975599069eb6a0872978,0,P. Taylor Goetz,2016-04-21 14:42:40-04:00,"['fdf2cd0050ced1954714f2d128a9443d0a7a46ec', 'bcf8c8a6e88b6cb57852e3e9af24168e25c0f486']",0,97,97,3947190,6,,,,2844
4e3c5bd5427cfad76f04d0c6e68dc321d516547e,0,P. Taylor Goetz,2016-04-21 14:44:03-04:00,['753670689a90ca3c918c975599069eb6a0872978'],0,1,1,3947191,1,,,,2844
56e6b614ba9a29ea6c8984492f9227fef3569f76,1,Arun Mahadevan,2016-04-25 12:06:08+05:18,['abf16e9c9306054246f3a0dce8276a336e40562f'],11,62,73,3947264,4,0.945945946,1,1,2844
17fee522dbcbd4f0e00f886cf17094c761f9831c,0,Karthick Duraisamy Soundararaj,2016-04-25 01:54:39-07:00,['4e3c5bd5427cfad76f04d0c6e68dc321d516547e'],0,1,1,3947265,1,0,0,0,2844
a3c0d5d99a4e2882e7647c97cd0919279bf0bf65,0,P. Taylor Goetz,2016-04-25 15:07:03-04:00,"['4e3c5bd5427cfad76f04d0c6e68dc321d516547e', '87b0f3c895f54b87e0265f7f28984e0e3f310b58']",10,14,24,3947289,1,,,,2844
4ea88407199af25282b84dbeed972659d62f161b,0,P. Taylor Goetz,2016-04-25 15:08:25-04:00,['a3c0d5d99a4e2882e7647c97cd0919279bf0bf65'],0,1,1,3947290,1,,,,2844
99fcc34c106eb61c41d2ed721c52cd5b531c59b4,0,Carey Tzou,2016-04-27 13:35:42+08:00,['4ea88407199af25282b84dbeed972659d62f161b'],1,1,2,3947292,1,,,,2844
4fdb5e1c7e83ccb95feabffbbf05b52f584cfce2,0,Stig Rohde D酶ssing,2016-04-27 12:20:38+02:00,['4ea88407199af25282b84dbeed972659d62f161b'],3,3,6,3947298,1,,,,2844
0cade64f3a8a6cc83a6ff3098b71979e685e9dec,0,mjsax,2016-04-28 15:16:18+02:00,['4ea88407199af25282b84dbeed972659d62f161b'],111,126,237,3947535,2,,,,2844
e48b28483fe5874a8245b782581d2d513471a2f3,1,David Luu,2016-04-28 18:33:47-07:00,['0cade64f3a8a6cc83a6ff3098b71979e685e9dec'],5,12,17,3947552,1,1,1,1,2844
ccb66d5fc4893b29869742a1db52e76ae8212823,0,Arun Mahadevan,2016-04-29 09:18:37+05:18,"['0cade64f3a8a6cc83a6ff3098b71979e685e9dec', '17fee522dbcbd4f0e00f886cf17094c761f9831c']",0,1,1,3947553,1,,,,2844
27be83b2923326044dc935d7246ff0cb92555c47,0,Arun Mahadevan,2016-04-29 09:23:40+05:18,['ccb66d5fc4893b29869742a1db52e76ae8212823'],0,2,2,3947555,2,,,,2844
faf2f08ea98d1fcb0b5db46632d6bc42a963d597,0,P. Taylor Goetz,2016-04-29 12:18:06-04:00,"['27be83b2923326044dc935d7246ff0cb92555c47', '99fcc34c106eb61c41d2ed721c52cd5b531c59b4']",1,1,2,3947557,1,,,,2844
a5369374cf2fe7b1146685bb3581098abea56f1d,0,P. Taylor Goetz,2016-04-29 12:18:13-04:00,['faf2f08ea98d1fcb0b5db46632d6bc42a963d597'],0,1,1,3947558,1,,,,2844
3702df4abfcad3537847f5aa957aaf243c1860a0,1,Hugo Louro,2016-04-29 09:22:40-07:00,['27be83b2923326044dc935d7246ff0cb92555c47'],1,1,2,3947560,1,,,,2844
b267c292faffc28be869dfb0424dc729d45808fe,1,Stig Rohde D酶ssing,2016-04-30 23:22:01+02:00,['a5369374cf2fe7b1146685bb3581098abea56f1d'],2,15,17,3947577,2,0,1,0,2844
0f760c20f2a5d1376d20f1dcb259bdb000cc1d35,0,Stig Rohde D酶ssing,2016-05-02 15:07:07+02:00,['a5369374cf2fe7b1146685bb3581098abea56f1d'],1,6,7,3947584,1,0,1,1,2844
39ff8a3cdbecf9b6a20ebf2dd86c53f5a4064478,0,Stig Rohde D酶ssing,2016-05-03 12:23:22+02:00,['27be83b2923326044dc935d7246ff0cb92555c47'],7,11,18,3947602,1,0,1,1,2844
514b932c2f2b643e6865fd82bc6d720acecfa301,0,Hugo Louro,2016-05-03 16:32:45-07:00,['a5369374cf2fe7b1146685bb3581098abea56f1d'],3,3,6,3947608,1,,,,2844
9c2ac7df68753835454a8abb5c6efcabb4c9370c,0,Kyle Nusbaum,2016-05-04 10:47:14-05:00,['a5369374cf2fe7b1146685bb3581098abea56f1d'],15,15,30,3947638,2,1,1,1,2844
2fa4d255bc44cbf31bae577551bfe406626a68ef,0,Kyle Nusbaum,2016-05-04 11:00:51-05:00,['9c2ac7df68753835454a8abb5c6efcabb4c9370c'],2,0,2,3947640,1,,,,2844
848ef21df184d046ac6617ea2bce1efc00e13a13,1,Boyang Jerry Peng,2016-05-04 17:08:57-05:00,['a5369374cf2fe7b1146685bb3581098abea56f1d'],894,542,1436,3949076,6,0.926430518,0.370572207,0.098092643,2845
2bebca52a56f98fa423c518eae6af50c00c9b098,0,Stig Rohde D酶ssing,2016-05-05 10:57:47+02:00,['b267c292faffc28be869dfb0424dc729d45808fe'],2,1,3,3949079,1,,,,2845
7f788d1b7429e99f58e1cbe989d21087d2e0eec1,0,Stig Rohde D酶ssing,2016-05-05 11:13:52+02:00,['2bebca52a56f98fa423c518eae6af50c00c9b098'],3,2,5,3949084,1,,,,2845
3c78314e18e21cd188cd7b8e5ae3f2143ed75cbd,0,Fergus Byrne,2016-05-05 17:32:33+01:00,['a5369374cf2fe7b1146685bb3581098abea56f1d'],2,14,16,3949100,1,1,1,1,2845
0458b0078dcaaeb1d7290e8c77c31cd46ac0f1e2,0,Abhishek Agarwal,2016-05-05 23:29:40+05:18,['a5369374cf2fe7b1146685bb3581098abea56f1d'],18,18,36,3949136,7,,,,2845
48d6fa0eda7ad238a8a0f91a76136be72501dc86,1,Satish Duggana,2016-05-06 15:50:28+05:18,['a5369374cf2fe7b1146685bb3581098abea56f1d'],0,132,132,3949268,1,0.654545455,0.854545455,0.945454545,2846
edb17e52360f4aa51f95ebcbeb9fd5baaa53b1e8,0,Jungtaek Lim,2016-05-09 18:40:58+09:00,['4e3c5bd5427cfad76f04d0c6e68dc321d516547e'],3,94,97,3949365,1,,,,2846
ca4fcecf005e04d61d65160b84ef6299cea92bf0,0,Jungtaek Lim,2016-05-11 12:04:28+09:00,['a5369374cf2fe7b1146685bb3581098abea56f1d'],1,1,2,3949367,1,,,,2846
70aef859d7c4d2e9a595094b04b5d1c30e8f00a4,1,Arun Mahadevan,2016-05-12 14:32:49+05:18,['56e6b614ba9a29ea6c8984492f9227fef3569f76'],28,65,93,3949460,6,1,1,1,2846
a27b2b7a4be58e0227de6ec84cad74a88fb3b90e,0,Sriharsha Chintalapani,2016-05-12 13:10:45-07:00,['ca4fcecf005e04d61d65160b84ef6299cea92bf0'],0,3,3,3949463,1,,,,2846
f4fef40a9be6d8725960618bee396e952f791824,0,hustfxj,2016-05-13 14:01:13+08:00,"['a27b2b7a4be58e0227de6ec84cad74a88fb3b90e', '48d6fa0eda7ad238a8a0f91a76136be72501dc86']",0,133,133,3949596,2,,,,2846
b341e123e1bd5dfb0a5c550443035049ad5a8e4e,0,hustfxj,2016-05-14 10:41:56+08:00,['f4fef40a9be6d8725960618bee396e952f791824'],1,1,2,3949598,1,,,,2846
da23045e66dc1a5304f0c81273c8d51b312b1b18,0,Xin Wang,2016-05-14 19:49:25+08:00,['a5369374cf2fe7b1146685bb3581098abea56f1d'],0,4,4,3949602,1,0,1,1,2846
fe6866df8f54e88fc863d854d535ac647fdccf35,0,ZhxChen,2016-05-15 21:19:21-04:00,['b341e123e1bd5dfb0a5c550443035049ad5a8e4e'],1,1,2,3949604,1,,,,2846
00804b47afbf9ebc4ee2f834c568bb6e5de31762,0,Jungtaek Lim,2016-05-16 14:35:49+09:00,"['b341e123e1bd5dfb0a5c550443035049ad5a8e4e', '8c7c197d03af76681111fedbc3a7d812f1d79b5f']",2,21,23,3949627,3,,,,2846
9a792c1492ae52ae75bcc8730c637dbb874dac2a,0,Jungtaek Lim,2016-05-16 14:38:06+09:00,['00804b47afbf9ebc4ee2f834c568bb6e5de31762'],0,1,1,3949628,1,,,,2846
6da6df233203d52ff945041f91e0ee62f7bf101f,0,Jungtaek Lim,2016-05-16 14:59:40+09:00,['9a792c1492ae52ae75bcc8730c637dbb874dac2a'],7,28,35,3949663,5,0.294117647,0.294117647,1,2846
f0a7c3a58802258090778675b9d0d06896588ec1,0,Jungtaek Lim,2016-05-16 15:00:03+09:00,"['9a792c1492ae52ae75bcc8730c637dbb874dac2a', '6da6df233203d52ff945041f91e0ee62f7bf101f']",7,28,35,3949698,5,,,,2846
0a36a973675754776ec06b6c4c2fc685be9720f5,0,Jungtaek Lim,2016-05-16 15:00:46+09:00,['f0a7c3a58802258090778675b9d0d06896588ec1'],0,3,3,3949701,1,,,,2846
75119c9da107ae1e97b8be3f77e6251d75d0b178,0,Jungtaek Lim,2016-05-16 15:12:00+09:00,"['0a36a973675754776ec06b6c4c2fc685be9720f5', '6763f71b3e4f1d8e5b8f1f05b61f622db0969642']",5,36,41,3949742,1,,,,2846
255911ecbdfb3ba4c9a4778a5356a9cf6349de0a,0,Jungtaek Lim,2016-05-16 15:31:29+09:00,['75119c9da107ae1e97b8be3f77e6251d75d0b178'],0,1,1,3949743,1,,,,2846
0f5d6fd12deb1a11a4654057a296f88f904e874f,0,Jungtaek Lim,2016-05-16 15:36:12+09:00,"['255911ecbdfb3ba4c9a4778a5356a9cf6349de0a', '3957be5495fbbc79f9c47c4dfa9a3670e7ddb36f']",9,12,21,3949764,1,,,,2846
f803fc67ea5f52b9ceebd749fb3a17a079b1e152,0,Jungtaek Lim,2016-05-16 15:50:05+09:00,['0f5d6fd12deb1a11a4654057a296f88f904e874f'],0,1,1,3949765,1,,,,2846
5441702dfe7ab2e0bc45cd11e1534ca9b5335b71,0,Jungtaek Lim,2016-05-16 15:53:25+09:00,"['f803fc67ea5f52b9ceebd749fb3a17a079b1e152', 'fbef299570ba72d2a29c90f0e7efd91b60cb9b6a']",80,146,226,3949991,5,,,,2846
e5b5ec3376a3b912af450a0d844fc03e9283b9f0,0,Jungtaek Lim,2016-05-16 15:54:15+09:00,['5441702dfe7ab2e0bc45cd11e1534ca9b5335b71'],0,1,1,3949992,1,,,,2846
527352f6524a20e3ba3af6608e99aab4359e014c,0,Jungtaek Lim,2016-05-16 16:18:29+09:00,"['e5b5ec3376a3b912af450a0d844fc03e9283b9f0', '5ddec1eddd46568d9917b33681c459fa04fc31f4']",2,1,3,3949995,1,,,,2846
de7cb44a8e33dac1ff4a616211c7cdcc4802e18d,0,Jungtaek Lim,2016-05-16 16:33:36+09:00,['527352f6524a20e3ba3af6608e99aab4359e014c'],0,1,1,3949996,1,,,,2846
18ba20977611cfad8dae463f926fdb1983107010,0,Jungtaek Lim,2016-05-16 16:47:00+09:00,"['de7cb44a8e33dac1ff4a616211c7cdcc4802e18d', '339a95750d1b599c46aac08e2e537db7776ba22f']",1,1,2,3949998,1,,,,2846
23cf5bfda4ee5c12ff7fdd0aba012732cd3ca95c,0,Jungtaek Lim,2016-05-16 16:56:25+09:00,"['18ba20977611cfad8dae463f926fdb1983107010', '97ee007f14e597fbdceda45bf25c4f0dfe537fc1']",2,1,3,3950001,1,,,,2846
171ae269cf3dbc3590475c2ad35f8ec02e035dfb,0,Jungtaek Lim,2016-05-16 16:57:07+09:00,['23cf5bfda4ee5c12ff7fdd0aba012732cd3ca95c'],0,1,1,3950002,1,,,,2846
7b43c2e5fd7852070d9e327e2353b3e65afd94a0,0,Jungtaek Lim,2016-05-16 17:19:15+09:00,"['171ae269cf3dbc3590475c2ad35f8ec02e035dfb', '7f788d1b7429e99f58e1cbe989d21087d2e0eec1']",2,13,15,3950017,2,,,,2846
a46bc068aa2624f5bc337b8ffba3771f2848bd44,0,Jungtaek Lim,2016-05-16 17:20:20+09:00,['7b43c2e5fd7852070d9e327e2353b3e65afd94a0'],0,1,1,3950018,1,,,,2846
e7b128461366ba2597bb083529cb3e0c36ac3bd3,1,Stig Rohde D酶ssing,2016-05-16 10:41:59+02:00,['a5369374cf2fe7b1146685bb3581098abea56f1d'],15,62,77,3950095,3,0.424242424,1,1,2846
cdbf8be01d97912bc4e5c69aae271e41a2f1d6ee,0,Jungtaek Lim,2016-05-16 17:53:05+09:00,"['a46bc068aa2624f5bc337b8ffba3771f2848bd44', '0f760c20f2a5d1376d20f1dcb259bdb000cc1d35']",1,6,7,3950102,1,,,,2846
7f04038681d58222fda0d82ee0a8e91457990274,0,Jungtaek Lim,2016-05-16 17:53:44+09:00,['cdbf8be01d97912bc4e5c69aae271e41a2f1d6ee'],0,1,1,3950103,1,,,,2846
e05de028309386104d62ffdb9b89f30013268c69,0,Jungtaek Lim,2016-05-16 18:06:41+09:00,"['7f04038681d58222fda0d82ee0a8e91457990274', '514b932c2f2b643e6865fd82bc6d720acecfa301']",3,3,6,3950109,1,,,,2846
6ff3fb2527d0a96e9b9e539f01b636e3ead4d714,0,Jungtaek Lim,2016-05-16 18:07:37+09:00,['e05de028309386104d62ffdb9b89f30013268c69'],0,1,1,3950110,1,,,,2846
354fcaf64567f3332b3311681308a841ee83cf34,0,Jungtaek Lim,2016-05-16 18:16:25+09:00,"['6ff3fb2527d0a96e9b9e539f01b636e3ead4d714', '2fa4d255bc44cbf31bae577551bfe406626a68ef']",16,14,30,3950140,2,,,,2846
a558a1f07fdef11595329e7c5e31f862820a56f8,0,Jungtaek Lim,2016-05-16 18:17:27+09:00,['354fcaf64567f3332b3311681308a841ee83cf34'],0,1,1,3950141,1,,,,2846
37aaf006d0e9f34361df6f22b016b0995814db4f,0,Jungtaek Lim,2016-05-16 18:33:15+09:00,"['a558a1f07fdef11595329e7c5e31f862820a56f8', '0458b0078dcaaeb1d7290e8c77c31cd46ac0f1e2']",18,18,36,3950177,7,,,,2846
94604212488fc9cfcb1df18320203b1bf830b28f,0,Jungtaek Lim,2016-05-16 18:35:47+09:00,['37aaf006d0e9f34361df6f22b016b0995814db4f'],0,1,1,3950178,1,,,,2846
efe131d20319f2a1044e3922dadb8c25cb832b3c,0,Jungtaek Lim,2016-05-16 18:43:09+09:00,"['94604212488fc9cfcb1df18320203b1bf830b28f', 'e48b28483fe5874a8245b782581d2d513471a2f3']",5,12,17,3950195,1,,,,2846
28c1459e0c6610c08d06b9e12d83c41e240785e5,0,Jungtaek Lim,2016-05-16 18:47:51+09:00,"['efe131d20319f2a1044e3922dadb8c25cb832b3c', 'da23045e66dc1a5304f0c81273c8d51b312b1b18']",0,4,4,3950199,1,,,,2846
38d92e9b948b5cdc0bc32bcca2f57b00dada483c,0,Jungtaek Lim,2016-05-16 18:48:26+09:00,['28c1459e0c6610c08d06b9e12d83c41e240785e5'],0,1,1,3950200,1,,,,2846
be2a338915ca242108af32542b4695ab7c3705c0,0,Jungtaek Lim,2016-05-16 19:00:33+09:00,"['38d92e9b948b5cdc0bc32bcca2f57b00dada483c', '4fdb5e1c7e83ccb95feabffbbf05b52f584cfce2']",3,3,6,3950206,1,,,,2846
457a95f3068f8b3a6a62989b5a7aaf6ccf403864,0,Jungtaek Lim,2016-05-16 19:01:18+09:00,['be2a338915ca242108af32542b4695ab7c3705c0'],0,1,1,3950207,1,,,,2846
c9ea580b10f625e0588e3bc5b4000730dc6561db,0,Boyang Jerry Peng,2016-05-16 11:08:33-05:00,['848ef21df184d046ac6617ea2bce1efc00e13a13'],1,1,2,3950209,1,,,,2846
cd67d9fe8f35a0c816ba995871aaaf622069188a,1,Arun Mahadevan,2016-05-17 00:00:52+05:18,['457a95f3068f8b3a6a62989b5a7aaf6ccf403864'],8,96,104,3950313,3,1,1,1,2846
63a9c7b6ab4caa316473c5c5de4f13091edd7fb0,0,Sriharsha Chintalapani,2016-05-16 16:26:42-07:00,"['457a95f3068f8b3a6a62989b5a7aaf6ccf403864', '3702df4abfcad3537847f5aa957aaf243c1860a0']",1,1,2,3950315,1,,,,2846
a9de15d4060e8553b6841a6cd515d0b50f21a67c,0,Sriharsha Chintalapani,2016-05-16 16:28:10-07:00,['63a9c7b6ab4caa316473c5c5de4f13091edd7fb0'],0,1,1,3950316,1,,,,2846
d5e6b66a07624f8b1e92aad791d32193715e8ed2,0,Sriharsha Chintalapani,2016-05-16 20:37:07-07:00,"['a9de15d4060e8553b6841a6cd515d0b50f21a67c', 'fe6866df8f54e88fc863d854d535ac647fdccf35']",1,1,2,3950318,1,,,,2846
4609ddb1c551de5fe574d69caefd294bb7498fd6,0,Sriharsha Chintalapani,2016-05-16 22:12:30-07:00,"['d5e6b66a07624f8b1e92aad791d32193715e8ed2', '70aef859d7c4d2e9a595094b04b5d1c30e8f00a4']",5,640,645,3950963,11,,,,2846
dd31d7e5ae6cb37ed84fd43c01bc6f90b022adc7,0,Sriharsha Chintalapani,2016-05-16 22:13:24-07:00,['4609ddb1c551de5fe574d69caefd294bb7498fd6'],0,1,1,3950964,1,,,,2846
cad476a924decf0ca5af02e0f196c72e4644c675,0,Jungtaek Lim,2016-05-17 15:56:53+09:00,"['dd31d7e5ae6cb37ed84fd43c01bc6f90b022adc7', '39ff8a3cdbecf9b6a20ebf2dd86c53f5a4064478']",7,11,18,3950982,1,,,,2846
3fe482e8016f71ac495b31517526b5f3ebaa631b,0,Jungtaek Lim,2016-05-17 15:57:57+09:00,['cad476a924decf0ca5af02e0f196c72e4644c675'],0,1,1,3950983,1,,,,2846
25dd41ed1e03a02aeb82bea7bc7e3f11da3867a6,0,Pavel Grochal,2016-05-17 15:11:29+02:00,['3fe482e8016f71ac495b31517526b5f3ebaa631b'],6,71,77,3951060,1,1,1,1,2846
8a175701fa797d4bb4c90814e49f7dbac287caa3,0,Pavel Grochal,2016-05-17 15:12:13+02:00,['25dd41ed1e03a02aeb82bea7bc7e3f11da3867a6'],0,2,2,3951062,1,,,,2846
d97cab9118268b2af51cec77ae31ca6dc2a62220,0,Pavel Grochal,2016-05-17 15:17:50+02:00,['8a175701fa797d4bb4c90814e49f7dbac287caa3'],5,72,77,3951139,1,1,1,1,2846
f04cfa78788a06f2f980d3e344f90561fd725c78,0,BYRNE Fergus,2016-05-17 23:26:43+02:00,['3c78314e18e21cd188cd7b8e5ae3f2143ed75cbd'],4,1,5,3951144,1,0,0,0,2846
2b93e9b9b7e01d01083142e7b30f56b8c29a0492,0,BYRNE Fergus,2016-05-18 00:32:02+02:00,['f04cfa78788a06f2f980d3e344f90561fd725c78'],5,8,13,3951157,1,1,1,1,2846
2282fb0c68263cbb1396e9f949e35ce910331236,1,Arun Mahadevan,2016-05-18 15:12:58+05:18,['3fe482e8016f71ac495b31517526b5f3ebaa631b'],19,287,306,3951463,9,0.857142857,0.983193277,0.882352941,2846
2795b97fd6113b705232a3cc0bd22632e4857432,0,Stig Rohde D酶ssing,2016-05-18 14:25:31+02:00,['3fe482e8016f71ac495b31517526b5f3ebaa631b'],3,4,7,3951470,2,,,,2846
157f5a13c1ea98b49d176f57e734633615ceb4e0,0,Sriharsha Chintalapani,2016-05-18 08:56:08-07:00,"['3fe482e8016f71ac495b31517526b5f3ebaa631b', 'cd67d9fe8f35a0c816ba995871aaaf622069188a']",8,96,104,3951574,3,,,,2846
97c180002e2c8bb5d3dbcde8df3fd8a86ff4322a,0,Sriharsha Chintalapani,2016-05-18 08:56:47-07:00,['157f5a13c1ea98b49d176f57e734633615ceb4e0'],0,1,1,3951575,1,,,,2846
9f4f00f31ad446b42ce65c83a7a55d526c8aaa2e,0,Sriharsha Chintalapani,2016-05-18 09:35:14-07:00,"['97c180002e2c8bb5d3dbcde8df3fd8a86ff4322a', '2b93e9b9b7e01d01083142e7b30f56b8c29a0492']",2,14,16,3951591,1,,,,2846
decf9a5af24fa6e60fc414a3def3ce31c4042b2c,0,Sriharsha Chintalapani,2016-05-18 09:44:35-07:00,['9f4f00f31ad446b42ce65c83a7a55d526c8aaa2e'],0,1,1,3951592,1,,,,2846
b73c7fcd87fae3a64091bfbcdc2ebf9abfce1f8d,0,Stig Rohde D酶ssing,2016-05-18 21:13:06+02:00,['2795b97fd6113b705232a3cc0bd22632e4857432'],8,12,20,3951612,1,,,,2846
7981ef22f5e1831a198d4cc11ca2b39233f2d4db,1,Jungtaek Lim,2016-05-20 08:33:58+09:00,['decf9a5af24fa6e60fc414a3def3ce31c4042b2c'],5,105,110,3951722,1,,,,2846
7b24dfa6523322b84f496d9533b87cb8bedb2461,0,Balazs Kossovics,2016-05-20 17:36:42+02:00,['7981ef22f5e1831a198d4cc11ca2b39233f2d4db'],0,1,1,3951723,1,1,1,1,2846
fc4aa9dac94df7a763fa6cd3e0954e9557ab5408,0,P. Taylor Goetz,2016-05-20 14:12:43-04:00,['7981ef22f5e1831a198d4cc11ca2b39233f2d4db'],0,1,1,3951724,1,,,,2846
fafbaeb93aaa3c2e290efdcc3bb2953283e151d5,0,Abhishek Agarwal,2016-05-21 00:32:14+05:18,['7981ef22f5e1831a198d4cc11ca2b39233f2d4db'],2,8,10,3951734,1,0,1,1,2846
17ea2b276b0b20bc71695a131324a3e763b7a216,1,P. Taylor Goetz,2016-05-20 15:31:16-04:00,['fc4aa9dac94df7a763fa6cd3e0954e9557ab5408'],1,2,3,3951737,1,,,,2846
6d1cb548f419df966056d0c407572f47d6bdf495,0,P. Taylor Goetz,2016-05-20 15:33:02-04:00,['17ea2b276b0b20bc71695a131324a3e763b7a216'],1,0,1,3951738,1,,,,2846
f63ede69c41e13759a247764142007c7e980df32,0,P. Taylor Goetz,2016-05-20 15:33:49-04:00,['6d1cb548f419df966056d0c407572f47d6bdf495'],0,1,1,3951739,1,,,,2846
29460f11ae75779a62e042ce95486daeb55072c4,0,Jungtaek Lim,2016-05-23 13:15:26+09:00,['f63ede69c41e13759a247764142007c7e980df32'],227,227,454,3952193,3,,,,2846
45e62a75ce667012fa0cf74e1543784b1620d36b,0,Jungtaek Lim,2016-05-23 13:16:34+09:00,"['f63ede69c41e13759a247764142007c7e980df32', '29460f11ae75779a62e042ce95486daeb55072c4']",227,227,454,3952647,3,,,,2846
27fd43d046bfefc24d9be7a42ec599336cacb00d,0,Arun Mahadevan,2016-05-23 11:06:10+05:18,['45e62a75ce667012fa0cf74e1543784b1620d36b'],0,3,3,3952650,1,,,,2846
aa887dabc6817e4444f1626469b5a02fccb6b6b5,0,Arun Mahadevan,2016-05-23 11:12:32+05:18,['27fd43d046bfefc24d9be7a42ec599336cacb00d'],0,2,2,3952652,2,,,,2846
723add3bab1d7a2e7bbfb0046d5a12c03a85b3c7,0,Arun Mahadevan,2016-05-24 10:50:59+05:18,['3fe482e8016f71ac495b31517526b5f3ebaa631b'],2,1,3,3952655,2,,,,2846
7c89502a19de19213126bdd2e800a7aa8b3a9f98,0,Boyang Jerry Peng,2016-05-24 09:43:58-05:00,['c9ea580b10f625e0588e3bc5b4000730dc6561db'],1,0,1,3952656,1,,,,2846
eda2d6aef2bbc7f2ad3e67ea956a6d8c1df51d2e,1,P. Taylor Goetz,2016-05-24 15:46:07-04:00,['aa887dabc6817e4444f1626469b5a02fccb6b6b5'],8,8,16,3952672,1,,,,2846
f818c7d6a74023398b28b5629135cddd9688cc68,0,P. Taylor Goetz,2016-05-24 15:46:30-04:00,['eda2d6aef2bbc7f2ad3e67ea956a6d8c1df51d2e'],0,1,1,3952673,1,,,,2846
abe8d2a65e9906c3dc6cb81f4784865483a8ca54,0,P. Taylor Goetz,2016-05-24 16:14:53-04:00,"['f818c7d6a74023398b28b5629135cddd9688cc68', 'd97cab9118268b2af51cec77ae31ca6dc2a62220']",11,145,156,3952829,2,,,,2846
a702546598dac65401a979b6cb5af11428b44605,0,P. Taylor Goetz,2016-05-24 16:19:04-04:00,['abe8d2a65e9906c3dc6cb81f4784865483a8ca54'],0,1,1,3952830,1,,,,2846
ba09cb5a0fa1d432030e281b329e09fe164d959a,0,P. Taylor Goetz,2016-05-24 16:31:43-04:00,"['a702546598dac65401a979b6cb5af11428b44605', 'b73c7fcd87fae3a64091bfbcdc2ebf9abfce1f8d']",11,16,27,3952857,3,,,,2846
b0940f905617defee0566b4fc17b81f362c73006,0,P. Taylor Goetz,2016-05-24 16:32:47-04:00,['ba09cb5a0fa1d432030e281b329e09fe164d959a'],0,1,1,3952858,1,,,,2846
014f1e4f749b4f5434a390ab3fa2f56f7b2f6268,0,P. Taylor Goetz,2016-05-24 16:45:12-04:00,"['b0940f905617defee0566b4fc17b81f362c73006', '723add3bab1d7a2e7bbfb0046d5a12c03a85b3c7']",2,1,3,3952861,2,,,,2846
26044f36599e452b9a325a2c389974100eaa254d,0,P. Taylor Goetz,2016-05-24 16:46:06-04:00,['014f1e4f749b4f5434a390ab3fa2f56f7b2f6268'],0,1,1,3952862,1,,,,2846
b5fe05a3115b8077e0105f70eee89edc3635eb2a,1,Satish Duggana,2016-05-25 12:04:30+05:18,['3fe482e8016f71ac495b31517526b5f3ebaa631b'],23,90,113,3952975,3,0,0.888888889,0.833333333,2847
fbcd0ab780b9c3047de2f522e4286ec5321cba09,0,Satish Duggana,2016-05-25 14:49:25+05:18,['b5fe05a3115b8077e0105f70eee89edc3635eb2a'],1,6,7,3952982,1,0,1,0,2847
f1f44c21c596edc1e4ef597deb898042c205a19c,0,Arun Mahadevan,2016-05-25 20:42:53+05:18,"['26044f36599e452b9a325a2c389974100eaa254d', '7b24dfa6523322b84f496d9533b87cb8bedb2461']",0,1,1,3952983,1,,,,2847
7cb66132d973b25d4a791a5774f752796e6328e7,0,Arun Mahadevan,2016-05-25 20:45:46+05:18,['f1f44c21c596edc1e4ef597deb898042c205a19c'],0,2,2,3952985,2,,,,2847
eda8e0bb8fe76b9a7e047abd6f28affc3be7e134,0,Boyang Jerry Peng,2016-05-25 13:39:46-05:00,"['7cb66132d973b25d4a791a5774f752796e6328e7', '7c89502a19de19213126bdd2e800a7aa8b3a9f98']",894,541,1435,3954420,6,,,,2847
e1ce13fc7f983bbcb4c48b6143714bf3dcefabc6,0,Boyang Jerry Peng,2016-05-25 13:46:17-05:00,['eda8e0bb8fe76b9a7e047abd6f28affc3be7e134'],0,1,1,3954421,1,,,,2847
0601aa0629f64abc22a556e750c8a0b68ba38311,0,Nathan Marz,2016-05-26 22:57:46-04:00,['e1ce13fc7f983bbcb4c48b6143714bf3dcefabc6'],0,10,10,3954431,1,,,,2847
08850a803797bd371f6fd3befcdfdd1245b42937,0,Arun Mahadevan,2016-05-27 10:33:34+05:18,['7cb66132d973b25d4a791a5774f752796e6328e7'],20,47,67,3954498,1,0,0,1,2847
b92ae8022b2a0d2165337b7c42a4c68854244332,0,Sriharsha Chintalapani,2016-05-27 14:14:16-07:00,"['0601aa0629f64abc22a556e750c8a0b68ba38311', '08850a803797bd371f6fd3befcdfdd1245b42937']",20,47,67,3954565,1,,,,2847
671e21ea2ab28f73e3d23bfaafc6016eb7b8c9a6,0,Sriharsha Chintalapani,2016-05-27 14:15:10-07:00,['b92ae8022b2a0d2165337b7c42a4c68854244332'],0,1,1,3954566,1,,,,2847
fa990039224668a4b9fa3fc9a70f6324515c478d,0,Sivaguru Kannan,2016-05-27 14:23:26-07:00,['decf9a5af24fa6e60fc414a3def3ce31c4042b2c'],10,12,22,3954588,1,0,0.5,0,2847
d0162b726fe63759cb67473185b4ad836bcc6e88,0,darionyaphet,2016-06-01 13:27:54+08:00,['671e21ea2ab28f73e3d23bfaafc6016eb7b8c9a6'],9,9,18,3954606,9,,,,2847
cc723f5c3a824e2ecb952211119729d0592cd113,0,Jungtaek Lim,2016-06-01 15:53:46+09:00,"['671e21ea2ab28f73e3d23bfaafc6016eb7b8c9a6', 'fafbaeb93aaa3c2e290efdcc3bb2953283e151d5']",2,8,10,3954616,1,,,,2847
d053fa7ca319f84131a078d2c5c784481610fe8c,0,Jungtaek Lim,2016-06-01 15:55:01+09:00,['cc723f5c3a824e2ecb952211119729d0592cd113'],0,1,1,3954617,1,,,,2847
cb9248017f4e292db8d31ba86db069027f97634c,0,Jungtaek Lim,2016-06-01 17:10:31+09:00,['d053fa7ca319f84131a078d2c5c784481610fe8c'],0,5,5,3954622,1,,,,2847
2f4c97553c9ed88607887ef5f13dd0cfc10a1fb5,0,Jungtaek Lim,2016-06-01 17:11:12+09:00,"['d053fa7ca319f84131a078d2c5c784481610fe8c', 'cb9248017f4e292db8d31ba86db069027f97634c']",0,5,5,3954627,1,,,,2847
9acd88aeb51587ae54605823cd78e27d1024a71a,0,Jungtaek Lim,2016-06-01 17:11:39+09:00,['2f4c97553c9ed88607887ef5f13dd0cfc10a1fb5'],0,1,1,3954628,1,,,,2847
66eea77177590a39d62bc9e5beea271079d53e2e,0,Jungtaek Lim,2016-06-01 17:20:45+09:00,"['9acd88aeb51587ae54605823cd78e27d1024a71a', 'fa990039224668a4b9fa3fc9a70f6324515c478d']",10,12,22,3954650,1,,,,2847
5a5ec77c0dfdc8e5af2086b7228d19115250892b,0,Jungtaek Lim,2016-06-01 17:25:16+09:00,['66eea77177590a39d62bc9e5beea271079d53e2e'],0,1,1,3954651,1,,,,2847
a9ef86d00c74ae9b2ca22f7fbef523ca154b5458,0,Jungtaek Lim,2016-06-01 17:33:19+09:00,['5a5ec77c0dfdc8e5af2086b7228d19115250892b'],0,1,1,3954652,1,,,,2847
66a0e705e230a0e72a9365c5f7fcdc97cbb0f197,0,Daniel Klessing,2016-06-02 13:19:11+02:00,['a9ef86d00c74ae9b2ca22f7fbef523ca154b5458'],0,8,8,3954660,1,0,0,1,2847
e7e906946ef3cc904148502833cd7cc584e3aac4,0,Daniel Klessing,2016-06-03 13:17:29+02:00,['66a0e705e230a0e72a9365c5f7fcdc97cbb0f197'],0,142,142,3954802,3,1,1,0.823529412,2849
5fff9cc2438233fbd47757ba7d08a238a6e38fa8,0,darionyaphet,2016-06-05 14:40:35+08:00,['671e21ea2ab28f73e3d23bfaafc6016eb7b8c9a6'],1,1,2,3954804,1,,,,2849
d19bcda308414272f705260c5be4bc4d0867c077,0,falmp,2016-06-05 21:56:02-03:00,['a9ef86d00c74ae9b2ca22f7fbef523ca154b5458'],6,6,12,3954816,1,,,,2849
d5dbbe0e3207508f28d4dfae263ce930743a049d,0,Balazs Kossovics,2016-06-06 17:04:27+02:00,['a9ef86d00c74ae9b2ca22f7fbef523ca154b5458'],1,5,6,3954822,1,0,1,1,2849
86ccee493768a3cccfa05e2ca30d962c87dd4e67,0,P. Taylor Goetz,2016-06-06 14:47:38-04:00,"['e1ce13fc7f983bbcb4c48b6143714bf3dcefabc6', 'a9ef86d00c74ae9b2ca22f7fbef523ca154b5458']",32,87,119,3954941,7,,,,2849
87ab6b2287fddfcf3650daf5654e36cdae91ac4b,0,Sriharsha Chintalapani,2016-06-06 19:46:53-07:00,"['a9ef86d00c74ae9b2ca22f7fbef523ca154b5458', 'fbcd0ab780b9c3047de2f522e4286ec5321cba09']",23,95,118,3955059,3,,,,2849
7108c71784f6b369a3bdc3bc5b7ffde336931f92,0,Sriharsha Chintalapani,2016-06-06 19:47:27-07:00,['87ab6b2287fddfcf3650daf5654e36cdae91ac4b'],0,1,1,3955060,1,,,,2849
5c4de20fdcc1b0b96ca9585b467e04d8ba93ed0f,0,Arun Mahadevan,2016-06-07 11:45:25+05:18,"['7108c71784f6b369a3bdc3bc5b7ffde336931f92', 'e7e906946ef3cc904148502833cd7cc584e3aac4']",0,150,150,3955210,4,,,,2849
fa21c11b9a4be499d36d71810f677c1d2aa276fb,0,Arun Mahadevan,2016-06-07 11:47:21+05:18,['5c4de20fdcc1b0b96ca9585b467e04d8ba93ed0f'],0,2,2,3955212,2,,,,2849
974c1685403563d4e7b6c28a49d3128faeab1f84,0,Sriharsha Chintalapani,2016-06-07 20:01:56-07:00,"['fa21c11b9a4be499d36d71810f677c1d2aa276fb', 'd19bcda308414272f705260c5be4bc4d0867c077']",6,6,12,3955224,1,,,,2849
2c77a20016a9eb602e7746a9111b63d427cf504f,0,Sriharsha Chintalapani,2016-06-07 20:02:50-07:00,['974c1685403563d4e7b6c28a49d3128faeab1f84'],0,1,1,3955225,1,,,,2849
9ea9352d2a8eb629c826f56622a395c654536fb7,0,Xin Wang,2016-06-08 12:50:46+08:00,['2c77a20016a9eb602e7746a9111b63d427cf504f'],0,163,163,3955388,1,,,,2849
eccda11615d0a5089d58754c9390371155c4e012,1,Balazs Kossovics,2016-06-08 14:05:01+02:00,['a9ef86d00c74ae9b2ca22f7fbef523ca154b5458'],6,161,167,3955555,7,0,0.891304348,0.891304348,2849
eff8c9382f78aff15cfed11516991f7e503e9373,0,P. Taylor Goetz,2016-06-08 11:21:52-04:00,"['86ccee493768a3cccfa05e2ca30d962c87dd4e67', '2c77a20016a9eb602e7746a9111b63d427cf504f']",29,255,284,3955839,10,,,,2849
1f0411a95726cbb8cf15bf3866023a49922f7dd8,0,Arun Mahadevan,2016-06-09 10:25:18+05:18,"['2c77a20016a9eb602e7746a9111b63d427cf504f', 'eccda11615d0a5089d58754c9390371155c4e012']",6,161,167,3956006,7,,,,2849
04e4fdea01bf0f9981d2cf86ecaa75940760d2f8,0,Arun Mahadevan,2016-06-09 10:26:35+05:18,['1f0411a95726cbb8cf15bf3866023a49922f7dd8'],0,1,1,3956007,1,,,,2849
ec03a1a91e95099992b0cba07c49ddf471a158da,0,Jungtaek Lim,2016-06-09 14:57:30+09:00,"['04e4fdea01bf0f9981d2cf86ecaa75940760d2f8', 'edb17e52360f4aa51f95ebcbeb9fd5baaa53b1e8']",3,94,97,3956104,1,,,,2849
bd4260e4670988402dbe212b736d96bad82de045,0,Abhishek Agarwal,2016-06-09 11:30:19+05:18,['ec03a1a91e95099992b0cba07c49ddf471a158da'],1,10,11,3956115,2,,,,2849
83c620c7001e09969ad72966c61be825552daaa4,0,darionyaphet,2016-06-09 22:23:32+08:00,['2c77a20016a9eb602e7746a9111b63d427cf504f'],5,5,10,3956125,1,,,,2849
a6023dc9c0076e3c875f1eb34ec3eb662f9d8e0b,0,darionyaphet,2016-06-09 23:00:38+08:00,['2c77a20016a9eb602e7746a9111b63d427cf504f'],3,0,3,3956128,1,1,1,1,2849
2835e37a665178d2b736be8fdb56c182e6a129ac,0,P. Taylor Goetz,2016-06-09 15:07:16-04:00,"['eff8c9382f78aff15cfed11516991f7e503e9373', 'bd4260e4670988402dbe212b736d96bad82de045']",10,266,276,3956404,11,,,,2849
3d789fc5c922b4ae6e81a12670211b28690651e4,0,P. Taylor Goetz,2016-06-09 15:27:49-04:00,"['2835e37a665178d2b736be8fdb56c182e6a129ac', '5fff9cc2438233fbd47757ba7d08a238a6e38fa8']",1,1,2,3956406,1,,,,2849
02c4f6b40336d79a268fa790881fcd4ed24f5df9,0,P. Taylor Goetz,2016-06-09 15:38:34-04:00,['3d789fc5c922b4ae6e81a12670211b28690651e4'],0,1,1,3956407,1,,,,2849
f5eb4790e77ec1cda9706c68a9a728808034ffec,0,P. Taylor Goetz,2016-06-09 16:04:22-04:00,['02c4f6b40336d79a268fa790881fcd4ed24f5df9'],2,6,8,3956415,1,0,0,1,2849
0cef213f23a2398771187a75a530b869f3a6eb21,0,P. Taylor Goetz,2016-06-09 16:05:30-04:00,['f5eb4790e77ec1cda9706c68a9a728808034ffec'],0,1,1,3956416,1,,,,2849
fd35ad60787498a398bdff9bd9b125b107098a84,0,P. Taylor Goetz,2016-06-09 16:07:20-04:00,"['0cef213f23a2398771187a75a530b869f3a6eb21', '9ea9352d2a8eb629c826f56622a395c654536fb7']",0,163,163,3956579,1,,,,2849
acbee1d1e4f19758d849259eaf87281a95919ace,0,P. Taylor Goetz,2016-06-09 16:08:22-04:00,['fd35ad60787498a398bdff9bd9b125b107098a84'],0,1,1,3956580,1,,,,2849
1d9c0bedd9c6a5b47264845e2708a245137311a7,0,P. Taylor Goetz,2016-06-09 16:15:27-04:00,"['acbee1d1e4f19758d849259eaf87281a95919ace', 'd0162b726fe63759cb67473185b4ad836bcc6e88']",9,9,18,3956598,9,,,,2849
b7f28206e759d419e5202c53b8732235319a41d2,0,P. Taylor Goetz,2016-06-09 16:25:38-04:00,['1d9c0bedd9c6a5b47264845e2708a245137311a7'],0,1,1,3956599,1,,,,2849
bf4c71cff1c1f36861283945200abde704a8c724,0,P. Taylor Goetz,2016-06-09 16:41:00-04:00,"['b7f28206e759d419e5202c53b8732235319a41d2', 'a37ddbaa7a4c8b94a68efda94a74910333333820']",6,6,12,3956611,1,,,,2849
d974546bee3291ab44d5aec5139e1837dbcbc72a,0,P. Taylor Goetz,2016-06-09 16:42:12-04:00,['bf4c71cff1c1f36861283945200abde704a8c724'],696,2,698,3957309,1,,,,2849
2507b0bbd2a0beda9bc9e3e70e84b6908b13db4d,0,P. Taylor Goetz,2016-06-09 16:49:19-04:00,"['d974546bee3291ab44d5aec5139e1837dbcbc72a', 'd5dbbe0e3207508f28d4dfae263ce930743a049d']",1,5,6,3957315,1,,,,2849
a52e83b833b14f03cb7c742043ba2d0a2933f267,0,P. Taylor Goetz,2016-06-09 16:50:38-04:00,['2507b0bbd2a0beda9bc9e3e70e84b6908b13db4d'],0,1,1,3957316,1,,,,2849
0b54767e246d4619cd9f40931b54947da38d317d,0,P. Taylor Goetz,2016-06-09 21:32:39-04:00,['a52e83b833b14f03cb7c742043ba2d0a2933f267'],1,1,2,3957318,1,,,,2849
fd51eacb58c52d7ed35ecbf52b7e6a9509fe1a7f,0,P. Taylor Goetz,2016-06-10 10:36:15-04:00,['0b54767e246d4619cd9f40931b54947da38d317d'],59,171,230,3957548,5,0.755102041,0.87755102,0.714285714,2849
b23febc39c4ba3f6f0e7eecfa0969cd958dc969a,0,P. Taylor Goetz,2016-06-10 10:36:15-04:00,['fd51eacb58c52d7ed35ecbf52b7e6a9509fe1a7f'],12,64,76,3957624,6,0.5,1,1,2849
582418952d130228789c6e523ffc1190fd5b4d20,0,P. Taylor Goetz,2016-06-10 10:37:40-04:00,['b23febc39c4ba3f6f0e7eecfa0969cd958dc969a'],0,1,1,3957625,1,,,,2849
be877a02466208aa9c469fea4d1826b48c06839f,0,Abhishek Agarwal,2016-06-10 22:45:18+05:18,['bd4260e4670988402dbe212b736d96bad82de045'],5,9,14,3957639,2,,,,2849
ded5a0df1510313ae2dce8869dbabaad6567452d,0,P. Taylor Goetz,2016-06-10 14:02:02-04:00,['582418952d130228789c6e523ffc1190fd5b4d20'],1,0,1,3957640,1,0,0,0,2849
1362c0bc623118e377da57bfd6f42ce52b7b81a1,1,Jungtaek Lim,2016-06-12 21:58:35+09:00,['a9ef86d00c74ae9b2ca22f7fbef523ca154b5458'],65,449,514,3958154,11,1,1,0.871559633,2853
79be212ba81dfbc4f0f8776a4427a986906aefa2,0,Jungtaek Lim,2016-06-13 13:06:26+09:00,['ded5a0df1510313ae2dce8869dbabaad6567452d'],2,54,56,3958210,1,1,1,0.888888889,2853
4dd6de9c494df112d668d66d8c10288becc54495,0,Jungtaek Lim,2016-06-13 13:06:26+09:00,['79be212ba81dfbc4f0f8776a4427a986906aefa2'],4,15,19,3958229,3,0.75,1,0.375,2853
565d53dc655a4ffa5626b81658379cdf96a13fff,0,Jungtaek Lim,2016-06-13 13:06:26+09:00,['4dd6de9c494df112d668d66d8c10288becc54495'],10,275,285,3958514,6,0.796610169,0.830508475,0.872881356,2856
78f728a3d3c33f65c54eefd90f4911a044b030cb,0,Jungtaek Lim,2016-06-13 13:06:34+09:00,"['ded5a0df1510313ae2dce8869dbabaad6567452d', '565d53dc655a4ffa5626b81658379cdf96a13fff']",4,332,336,3958850,6,,,,2856
d42276f6ffa0364d79aa9b48993d85fea06b6d28,0,Jungtaek Lim,2016-06-13 13:15:10+09:00,['78f728a3d3c33f65c54eefd90f4911a044b030cb'],1,3,4,3958854,1,,,,2856
b738dcdbda95328cd8904529c9d3dbf1934a698d,0,Jungtaek Lim,2016-06-13 13:24:07+09:00,"['d42276f6ffa0364d79aa9b48993d85fea06b6d28', '1362c0bc623118e377da57bfd6f42ce52b7b81a1']",65,449,514,3959368,11,,,,2856
f325febd20680a537bed8476458bb24f33f329f8,0,Jungtaek Lim,2016-06-13 13:48:19+09:00,['b738dcdbda95328cd8904529c9d3dbf1934a698d'],0,1,1,3959369,1,,,,2856
82b1ad032f237ede2d4e7c0bcb305f8e36355e3e,0,darionyaphet,2016-06-15 00:21:44+08:00,['0b54767e246d4619cd9f40931b54947da38d317d'],1,17,18,3959387,2,1,1,1,2856
5be13404fce05f313e050ad2b082b36a47c430e4,0,Stig Rohde D酶ssing,2016-06-14 19:40:55+02:00,"['e7b128461366ba2597bb083529cb3e0c36ac3bd3', 'f325febd20680a537bed8476458bb24f33f329f8']",2262,4119,6381,3965768,118,,,,2856
28e2d4894390956ae995ec2fb7da1cafdc80d2ee,1,Satish Duggana,2016-06-15 12:36:03+05:18,['f325febd20680a537bed8476458bb24f33f329f8'],1,1467,1468,3967236,17,0.719917012,0.831950207,0.885892116,2871
66f273557bef67e6e8cc2498d9d1b98d7e776a37,0,Abhishek Agarwal,2016-06-15 19:25:08+05:18,"['be877a02466208aa9c469fea4d1826b48c06839f', 'f325febd20680a537bed8476458bb24f33f329f8']",849,1210,2059,3969295,36,,,,2871
8ea9e5b9dfc8dbe2d2042e58bb499ba029d9776b,0,Sriharsha Chintalapani,2016-06-15 09:55:34-07:00,['28e2d4894390956ae995ec2fb7da1cafdc80d2ee'],0,1,1,3969296,1,,,,2871
11fd47a298aebbfb6972abdafcddc23ea536c254,0,Raghav Kumar Gautam,2016-06-15 12:43:06-07:00,['8ea9e5b9dfc8dbe2d2042e58bb499ba029d9776b'],8,8,16,3969312,1,,,,2871
aae0acbe8206f66129443d78831883226f8144c9,0,Hugo Louro,2016-06-15 21:41:52-07:00,['8ea9e5b9dfc8dbe2d2042e58bb499ba029d9776b'],16,18,34,3969346,2,0,1,1,2871
10c4a98699f3d81d4f13c4fa19a674913d28d937,0,GitHub,2016-06-16 16:04:25+08:00,['8ea9e5b9dfc8dbe2d2042e58bb499ba029d9776b'],1,1,2,3969348,1,,,,2871
384143d99deb81c3a3ecf3bbaef7a5a7eebfa2b6,0,Aaron Niskode-Dossett,2016-06-16 14:44:26+00:00,"['8ea9e5b9dfc8dbe2d2042e58bb499ba029d9776b', '10c4a98699f3d81d4f13c4fa19a674913d28d937']",1,1,2,3969350,1,,,,2871
bfe19eef65e3450e8514715dc1386059a8da9781,0,Sriharsha Chintalapani,2016-06-16 10:49:02-07:00,"['384143d99deb81c3a3ecf3bbaef7a5a7eebfa2b6', '11fd47a298aebbfb6972abdafcddc23ea536c254']",8,8,16,3969366,1,,,,2871
7825a5b579ff4edb23f835d6e6c2190136c53560,0,Sriharsha Chintalapani,2016-06-16 10:59:24-07:00,['bfe19eef65e3450e8514715dc1386059a8da9781'],0,1,1,3969367,1,,,,2871
47f295e70f48cbfe1820d5140998440df8e964f9,0,GitHub,2016-06-16 15:53:41-04:00,['7825a5b579ff4edb23f835d6e6c2190136c53560'],2,2,4,3969371,1,,,,2871
0953c2523bc20d0039e07ad5fe27bd55425de55c,0,Roshan Naik,2016-06-16 16:39:11-07:00,['7825a5b579ff4edb23f835d6e6c2190136c53560'],7,8,15,3969386,1,,,,2871
f05114a0d127d51aae55fd844dc048e1aca2efc4,1,Jungtaek Lim,2016-06-17 09:40:17+09:00,['7825a5b579ff4edb23f835d6e6c2190136c53560'],2,2,4,3969390,1,,,,2871
31e8adea10ee503b546c10d0c612a37ffab11b28,0,GitHub,2016-06-20 10:33:14+08:00,['8ea9e5b9dfc8dbe2d2042e58bb499ba029d9776b'],0,2,2,3969392,1,,,,2871
659dbb340bd5d8ec0d8c43a14e60486ec4d2fee1,0,Jungtaek Lim,2016-06-20 11:34:37+09:00,['f05114a0d127d51aae55fd844dc048e1aca2efc4'],3,3,6,3969398,2,,,,2871
d004cc9518f06e964d1749f8f0980dc2e4f03054,0,vesense,2016-06-20 10:51:01+08:00,['8ea9e5b9dfc8dbe2d2042e58bb499ba029d9776b'],0,0,0,3969398,3,,,,2871
b750d98902e8ba95e2b8b97bb29eaea9cb47375c,0,Sriharsha Chintalapani,2016-06-20 16:59:58-07:00,['7825a5b579ff4edb23f835d6e6c2190136c53560'],2,2,4,3969402,1,,,,2871
d59dadd1098737184c48bba2e188be8c317ea5aa,0,Sriharsha Chintalapani,2016-06-20 17:04:18-07:00,['b750d98902e8ba95e2b8b97bb29eaea9cb47375c'],0,1,1,3969403,1,,,,2871
18a5c79bcf2f19246fbbc89278abdc54c37ff4b2,0,Sriharsha Chintalapani,2016-06-20 17:05:38-07:00,"['d59dadd1098737184c48bba2e188be8c317ea5aa', '659dbb340bd5d8ec0d8c43a14e60486ec4d2fee1']",3,3,6,3969409,2,,,,2871
502107af184afa2c860b496388f917f7fd206d65,0,Sriharsha Chintalapani,2016-06-20 17:06:21-07:00,['18a5c79bcf2f19246fbbc89278abdc54c37ff4b2'],0,1,1,3969410,1,,,,2871
482d96ca9d6a3cb681ea0e393ffade2ebd3d93a2,1,Priyank,2016-06-20 18:03:06-07:00,['502107af184afa2c860b496388f917f7fd206d65'],2,1244,1246,3970656,16,0.335581788,0.340640809,0.907251265,2879
62ba95c92b18defb17474b235027058878a531e7,0,Sriharsha Chintalapani,2016-06-20 18:12:24-07:00,['482d96ca9d6a3cb681ea0e393ffade2ebd3d93a2'],1,2,3,3970659,1,,,,2879
e903fdace7f04895df9427e0e0eb8675802981e2,0,Aaron Niskode-Dossett,2016-06-21 14:15:19+00:00,"['62ba95c92b18defb17474b235027058878a531e7', '47f295e70f48cbfe1820d5140998440df8e964f9']",2,2,4,3970663,1,,,,2879
20c438133bab13566e4163f9ced96c2ddea4d3ee,0,Aaron Niskode-Dossett,2016-06-21 14:25:32+00:00,['e903fdace7f04895df9427e0e0eb8675802981e2'],0,14,14,3970677,1,,,,2879
6630868609bbf53f0cf13af67d3c1e8b9c4d1fc1,0,Aaron Niskode-Dossett,2016-06-21 14:29:15+00:00,"['20c438133bab13566e4163f9ced96c2ddea4d3ee', '0953c2523bc20d0039e07ad5fe27bd55425de55c']",7,8,15,3970692,1,,,,2879
6dd3f6b6d413731128195c9a6f40f41f51e5a9f4,0,Aaron Niskode-Dossett,2016-06-21 14:30:18+00:00,['6630868609bbf53f0cf13af67d3c1e8b9c4d1fc1'],0,1,1,3970693,1,,,,2879
1722e7a30e8346bf4465268041332ac98caf04a6,0,Aaron Niskode-Dossett,2016-06-21 14:46:01+00:00,"['6dd3f6b6d413731128195c9a6f40f41f51e5a9f4', 'a6023dc9c0076e3c875f1eb34ec3eb662f9d8e0b']",3,0,3,3970696,1,,,,2879
6e67ea7a37ee288bf38d69c2e03961cca9e82677,0,Aaron Niskode-Dossett,2016-06-21 14:48:18+00:00,['1722e7a30e8346bf4465268041332ac98caf04a6'],0,1,1,3970697,1,,,,2879
b16a75070706f01adc571d09f7606f1311d1e7e9,0,Sriharsha Chintalapani,2016-06-21 11:41:07-07:00,"['6e67ea7a37ee288bf38d69c2e03961cca9e82677', 'aae0acbe8206f66129443d78831883226f8144c9']",16,18,34,3970731,2,,,,2879
6bf7890b8956ab982a1ff1bbfe94d8b622ac13a1,0,Sriharsha Chintalapani,2016-06-21 12:57:23-07:00,['b16a75070706f01adc571d09f7606f1311d1e7e9'],0,1,1,3970732,1,,,,2879
8f66f8c64fd02fe0417756c25308683fb3f4c7cf,0,Jungtaek Lim,2016-06-22 15:10:16+09:00,['6bf7890b8956ab982a1ff1bbfe94d8b622ac13a1'],2,2,4,3970736,1,,,,2879
3d53861cd0e58b38804803aab837fea62bef899f,0,darionyaphet,2016-06-22 15:25:07+08:00,['8ea9e5b9dfc8dbe2d2042e58bb499ba029d9776b'],0,101,101,3970837,3,1,1,1,2881
60b2f663bbd79997941b340b91eed32945eb2af5,0,Jungtaek Lim,2016-06-22 22:42:53+09:00,"['6bf7890b8956ab982a1ff1bbfe94d8b622ac13a1', '8f66f8c64fd02fe0417756c25308683fb3f4c7cf']",2,2,4,3970841,1,,,,2881
0d3a9f05b434c0eec4318cf9b5108c2744ea5257,0,Jungtaek Lim,2016-06-22 22:43:18+09:00,['60b2f663bbd79997941b340b91eed32945eb2af5'],0,1,1,3970842,1,,,,2881
31c6e07a664037e2eb9e1f5d820761199ec437c8,0,darionyaphet,2016-06-22 22:01:16+08:00,['0d3a9f05b434c0eec4318cf9b5108c2744ea5257'],5,16,21,3970863,4,1,1,1,2881
dbec495fe689bd4ead55f5ebb25ebcbaaff9c1e8,0,Xin Wang,2016-06-22 22:10:48+08:00,['2c77a20016a9eb602e7746a9111b63d427cf504f'],0,5,5,3970868,1,,,,2881
55c1afb777dfdd8795763cf3a943d888a4922386,0,Kyle Nusbaum,2016-06-22 10:21:03-05:00,['7825a5b579ff4edb23f835d6e6c2190136c53560'],1,46,47,3970915,5,0.047619048,1,1,2881
acf0ce193ed84ab51e3eff46fb4af7281ad8239e,0,Boyang Jerry Peng,2016-06-22 14:43:43-05:00,['0d3a9f05b434c0eec4318cf9b5108c2744ea5257'],1,56,57,3970972,3,,,,2883
d40b34e50d17c50acab23c0aa840ab329517d633,0,Jungtaek Lim,2016-06-23 17:49:51+09:00,['0d3a9f05b434c0eec4318cf9b5108c2744ea5257'],75,76,151,3971123,1,,,,2883
754da7f61e2aef46c64a07f4b7e8cedc9161499a,1,Hugo Louro,2016-06-23 18:16:38-07:00,['0d3a9f05b434c0eec4318cf9b5108c2744ea5257'],207,522,729,3971852,11,1,1,0.83,2888
33d15bfb12cac0796d6a0a3662d745ad97812ef7,0,Jungtaek Lim,2016-06-24 17:42:04+09:00,"['0d3a9f05b434c0eec4318cf9b5108c2744ea5257', 'd40b34e50d17c50acab23c0aa840ab329517d633']",75,76,151,3972003,1,,,,2888
83b1f059ac36b7cf20ec60735267b847150e6296,0,Jungtaek Lim,2016-06-24 17:42:50+09:00,['33d15bfb12cac0796d6a0a3662d745ad97812ef7'],0,1,1,3972004,1,,,,2888
a7d69fbe3e759a0a5a7487ebf531e484fd955b84,0,Jungtaek Lim,2016-06-24 18:00:49+09:00,"['83b1f059ac36b7cf20ec60735267b847150e6296', '3d53861cd0e58b38804803aab837fea62bef899f']",0,101,101,3972105,3,,,,2888
9773f05387e5c23f762eeb0aeb0255e9f854167f,0,Jungtaek Lim,2016-06-24 18:01:32+09:00,['a7d69fbe3e759a0a5a7487ebf531e484fd955b84'],0,1,1,3972106,1,,,,2888
7a144357f3d1bbcbd0be674535cfed32dfd6c20e,1,Jungtaek Lim,2016-06-24 18:40:48+09:00,['9773f05387e5c23f762eeb0aeb0255e9f854167f'],0,362,362,3972468,5,0.744966443,1,0.946308725,2892
65aae49dd7528ba2c41076e8a5ec57b94686623e,0,Jungtaek Lim,2016-06-24 18:42:13+09:00,"['9773f05387e5c23f762eeb0aeb0255e9f854167f', '7a144357f3d1bbcbd0be674535cfed32dfd6c20e']",0,362,362,3972830,5,,,,2892
dcae610e4d12db884110b72e8b9db691b26346b4,0,Jungtaek Lim,2016-06-24 18:45:53+09:00,['65aae49dd7528ba2c41076e8a5ec57b94686623e'],0,1,1,3972831,1,,,,2892
4200a79aedf4dc8ce93293b7d11a51d51e5d2f86,0,Jungtaek Lim,2016-06-24 19:00:41+09:00,"['dcae610e4d12db884110b72e8b9db691b26346b4', 'dbec495fe689bd4ead55f5ebb25ebcbaaff9c1e8']",0,5,5,3972836,1,,,,2892
55809d6cc986efcc261c1159dafe3ae459200abc,0,Jungtaek Lim,2016-06-24 19:01:09+09:00,['4200a79aedf4dc8ce93293b7d11a51d51e5d2f86'],0,1,1,3972837,1,,,,2892
f056e5ab51219addf8649eec07b6f09b9be46c67,0,GitHub,2016-06-25 14:16:36+08:00,['55809d6cc986efcc261c1159dafe3ae459200abc'],5,5,10,3972847,1,,,,2892
63fed3becadb418b224c323b970b65de42551c98,1,Jungtaek Lim,2016-06-27 15:01:29+09:00,['55809d6cc986efcc261c1159dafe3ae459200abc'],7,14,21,3972868,3,0.75,0.75,1,2892
0437233415185011cbd9390990f86b8daeca6fa3,0,Jungtaek Lim,2016-06-27 17:36:09+09:00,['55809d6cc986efcc261c1159dafe3ae459200abc'],2,380,382,3973250,2,,,,2892
9ee20a0dcb6f6cbe9d3d89ca0e93913ceb0093a7,0,Jungtaek Lim,2016-06-28 10:43:28+09:00,['55809d6cc986efcc261c1159dafe3ae459200abc'],23,57,80,3973330,4,0,1,1,2892
56d05786af4661807d4923016d142b1dbbb97a73,0,Jungtaek Lim,2016-06-28 10:43:38+09:00,"['55809d6cc986efcc261c1159dafe3ae459200abc', '9ee20a0dcb6f6cbe9d3d89ca0e93913ceb0093a7']",23,57,80,3973410,4,,,,2892
878f5eb36f3988c33e69615c9cf02ea8f34853a1,0,Jungtaek Lim,2016-06-28 10:44:00+09:00,['56d05786af4661807d4923016d142b1dbbb97a73'],0,3,3,3973413,1,,,,2892
816a6cc47e5be505d4857e25a4aa14d2f09cade0,0,Jungtaek Lim,2016-06-29 19:06:43+09:00,['878f5eb36f3988c33e69615c9cf02ea8f34853a1'],110,66,176,3973589,3,1,0.608695652,0.630434783,2892
356c1c8f52b339ed1ac51b5d91fba1e7ecb7f2da,0,Jungtaek Lim,2016-06-30 22:25:54+09:00,"['878f5eb36f3988c33e69615c9cf02ea8f34853a1', '19a7f3640ca2607f970546c02dfad19401994b47']",138,398,536,3974125,4,,,,2892
743bafbafd9ed85ca242d89986f65619afe3c80e,0,Jungtaek Lim,2016-06-30 22:36:28+09:00,['356c1c8f52b339ed1ac51b5d91fba1e7ecb7f2da'],0,1,1,3974126,1,,,,2892
a6d438cbd9484a9e1bcdd8ed8955c0c4aceca5a1,0,Jungtaek Lim,2016-06-30 23:03:43+09:00,"['743bafbafd9ed85ca242d89986f65619afe3c80e', '86d78d6c5b5f6ef22ababbeb64e7a140b79bdea2']",59,135,194,3974320,3,,,,2892
ca45d46ca48245c56fd647d7067f1f08aa77e5d1,0,Jungtaek Lim,2016-06-30 23:04:22+09:00,['a6d438cbd9484a9e1bcdd8ed8955c0c4aceca5a1'],0,1,1,3974321,1,,,,2892
ec6359584c45fe428794fdb3f72342876850965f,0,Jungtaek Lim,2016-06-30 23:27:04+09:00,"['ca45d46ca48245c56fd647d7067f1f08aa77e5d1', '07e1b231e37217705add955d76b57fa530b99955']",85,103,188,3974509,3,,,,2892
7d724e8ca83b3396a5c9a6e218098912d704e9bc,0,Jungtaek Lim,2016-06-30 23:27:34+09:00,['ec6359584c45fe428794fdb3f72342876850965f'],0,1,1,3974510,1,,,,2892
5b19cf0ebdd2aef627aae1ee0edfd09574d55ca6,0,Jungtaek Lim,2016-07-01 23:58:05+09:00,['7d724e8ca83b3396a5c9a6e218098912d704e9bc'],0,2,2,3974512,1,1,1,1,2892
a76eadbdc01b8b484b40b4c8ef74753d2d68ca56,1,Alessandro Bellina,2016-07-01 13:22:10-05:00,['7d724e8ca83b3396a5c9a6e218098912d704e9bc'],43,88,131,3974643,10,1,1,1,2892
42858abe3c2f13b0b6a5f997753d23ee149164ae,0,Alessandro Bellina,2016-07-01 13:41:55-05:00,['a76eadbdc01b8b484b40b4c8ef74753d2d68ca56'],1,2,3,3974646,1,,,,2892
9524679388564aa6c2b7dacf1737c2de8572dc6f,0,Alessandro Bellina,2016-07-01 13:41:55-05:00,['42858abe3c2f13b0b6a5f997753d23ee149164ae'],4,24,28,3974674,1,,,,2892
09c76f510a13a1a8f6454fd867f00579622fb488,0,Alessandro Bellina,2016-07-01 14:18:30-05:00,['9524679388564aa6c2b7dacf1737c2de8572dc6f'],12,15,27,3974701,3,,,,2892
69f40d7654087622d3778326eca1864ad79c438c,0,Alessandro Bellina,2016-07-01 14:41:52-05:00,['7d724e8ca83b3396a5c9a6e218098912d704e9bc'],1,0,1,3974702,1,,,,2892
54effe1492d8890832779a0291deb1928c8300e1,0,Jungtaek Lim,2016-07-03 15:46:33+09:00,['7d724e8ca83b3396a5c9a6e218098912d704e9bc'],3,5,8,3974710,1,0,0,1,2892
e754f63318712fbac0c4541fd637214fc2d35e45,0,Jungtaek Lim,2016-07-03 15:46:44+09:00,"['7d724e8ca83b3396a5c9a6e218098912d704e9bc', '54effe1492d8890832779a0291deb1928c8300e1']",3,5,8,3974718,1,,,,2892
d4bfee16a1623a77b5ae3690106fae264fe799f4,0,Jungtaek Lim,2016-07-03 15:47:02+09:00,['e754f63318712fbac0c4541fd637214fc2d35e45'],0,1,1,3974719,1,,,,2892
0f38aaaebfea4ae95bbb9786acefcc56379c81be,0,Jungtaek Lim,2016-07-03 15:47:57+09:00,['d4bfee16a1623a77b5ae3690106fae264fe799f4'],0,1,1,3974720,1,,,,2892
96bf8e71cff0d4cbad102da14598350e6915eb68,0,Sriharsha Chintalapani,2016-07-04 16:12:03-07:00,"['0f38aaaebfea4ae95bbb9786acefcc56379c81be', '5b19cf0ebdd2aef627aae1ee0edfd09574d55ca6']",0,2,2,3974722,1,,,,2892
14c3a36d8b287e077a8fca06fb649215f42dbc61,0,Sriharsha Chintalapani,2016-07-04 16:12:47-07:00,['96bf8e71cff0d4cbad102da14598350e6915eb68'],0,1,1,3974723,1,,,,2892
20ef57e7bcf95e31aac5f06dd55c5065a6a27b61,0,Sriharsha Chintalapani,2016-07-04 17:03:43-07:00,"['14c3a36d8b287e077a8fca06fb649215f42dbc61', '0437233415185011cbd9390990f86b8daeca6fa3']",2,380,382,3975105,2,,,,2892
be677d27498fc99ee98b2f5d0d19e4ee1869a462,0,Sriharsha Chintalapani,2016-07-04 17:04:33-07:00,['20ef57e7bcf95e31aac5f06dd55c5065a6a27b61'],0,1,1,3975106,1,,,,2892
d1280c2b965f8920647ea26b00bbd8c2262f0464,0,Jungtaek Lim,2016-07-05 17:33:41+09:00,['be677d27498fc99ee98b2f5d0d19e4ee1869a462'],3,1,4,3975110,1,,,,2892
da387c1e3fb8d7a704c479569d7e84ce52d58e7c,1,Jungtaek Lim,2016-07-06 22:56:10+09:00,['d1280c2b965f8920647ea26b00bbd8c2262f0464'],10,44,54,3975164,3,0.705882353,0.764705882,0.823529412,2892
d38c40026ab5dac266986896424e6c25a440e512,0,Slava Andreyev,2016-07-06 13:14:09-04:00,['d1280c2b965f8920647ea26b00bbd8c2262f0464'],3,3,6,3975170,1,,,,2892
c7fd8812dcf9501d1da4661660bf951ac3842cff,0,Kyle Nusbaum,2016-07-06 13:55:36-05:00,['55c1afb777dfdd8795763cf3a943d888a4922386'],7,9,16,3975186,2,0.5,1,1,2892
2c924e532af4583131b4012a5349cadb3bb39626,0,Kyle Nusbaum,2016-07-06 14:38:43-05:00,['c7fd8812dcf9501d1da4661660bf951ac3842cff'],1,1,2,3975188,1,,,,2892
8898258e6ea466f96561a0cceb56b1fb81115513,0,Kyle Nusbaum,2016-07-06 14:40:29-05:00,['2c924e532af4583131b4012a5349cadb3bb39626'],2,2,4,3975192,1,,,,2892
6e551355f0a3a5e89aec37b3045a473f3d7f1516,0,Kyle Nusbaum,2016-07-06 16:59:49-05:00,['8898258e6ea466f96561a0cceb56b1fb81115513'],1,20,21,3975213,1,,,,2892
675e45547c2a27bcab4fcd1ce95ab51bc68cfbbe,0,Jungtaek Lim,2016-07-07 12:58:37+09:00,['d1280c2b965f8920647ea26b00bbd8c2262f0464'],4,10,14,3975227,1,0,0,,2892
364b0ea1e25aac9134208d4f243ba888370aeba1,0,Jungtaek Lim,2016-07-07 23:20:25+09:00,"['d1280c2b965f8920647ea26b00bbd8c2262f0464', 'e05a916bd2242f5fb31dee5e6a0230dabe043700']",291,380,671,3975898,12,,,,2892
0348624ae4f2eaaabd83f5d9553598cbc0d18f10,0,Jungtaek Lim,2016-07-07 23:25:52+09:00,['364b0ea1e25aac9134208d4f243ba888370aeba1'],0,5,5,3975903,1,,,,2892
3773d158c9052757407dcf8a4fa87731923bee21,0,Kyle Nusbaum,2016-07-07 15:01:46-05:00,['6e551355f0a3a5e89aec37b3045a473f3d7f1516'],1,1,2,3975905,1,,,,2892
0933fb07b19a5ca74793b9fcfd1b851e9dc34e0c,0,Jungtaek Lim,2016-07-08 15:55:46+09:00,"['0348624ae4f2eaaabd83f5d9553598cbc0d18f10', 'da387c1e3fb8d7a704c479569d7e84ce52d58e7c']",10,44,54,3975959,3,,,,2892
b96fef6c9dac0f70e41bbfa07911fc7c81d7300b,0,Jungtaek Lim,2016-07-08 15:56:07+09:00,['0933fb07b19a5ca74793b9fcfd1b851e9dc34e0c'],0,1,1,3975960,1,,,,2892
ff595145e30c57271eb8f6ab2f1f31805170f672,1,Jungtaek Lim,2016-07-08 16:00:03+09:00,['b96fef6c9dac0f70e41bbfa07911fc7c81d7300b'],47,150,197,3976157,6,0.8,0.8,0.816666667,2893
46c9ce0c5b317ca60bb08e8a10d1c7b63fbd7040,0,Jungtaek Lim,2016-07-08 16:18:20+09:00,"['b96fef6c9dac0f70e41bbfa07911fc7c81d7300b', 'd38c40026ab5dac266986896424e6c25a440e512']",3,3,6,3976163,1,,,,2893
1134d73ed7c0f98c9c64478444443bb8a61e67d4,0,Jungtaek Lim,2016-07-08 16:19:33+09:00,['46c9ce0c5b317ca60bb08e8a10d1c7b63fbd7040'],0,2,2,3976165,2,,,,2893
772fcc25cd2f145f34d55a43c6979f883b1efc0f,0,Jungtaek Lim,2016-07-08 16:55:56+09:00,"['1134d73ed7c0f98c9c64478444443bb8a61e67d4', '63fed3becadb418b224c323b970b65de42551c98']",7,14,21,3976186,3,,,,2893
3787c9ff81a7b9735045e794758f4bfa7dd46716,0,Jungtaek Lim,2016-07-08 16:56:20+09:00,['772fcc25cd2f145f34d55a43c6979f883b1efc0f'],0,1,1,3976187,1,,,,2893
0ec9a5885eafa99d7d7d569d84915fe81e7a5c5a,0,Jungtaek Lim,2016-07-08 17:03:05+09:00,['3787c9ff81a7b9735045e794758f4bfa7dd46716'],2,0,2,3976189,1,,,,2893
5fefbd10bb6b6dd1ca6f56a07aeeb05fea1072a7,1,Jungtaek Lim,2016-07-08 17:08:08+09:00,['55809d6cc986efcc261c1159dafe3ae459200abc'],8,390,398,3976587,7,0.438461538,0.692307692,0.976923077,2896
f17aa8afaae2aca451c670d7bf8465cd6ad2839b,0,Jungtaek Lim,2016-07-08 17:08:45+09:00,"['0ec9a5885eafa99d7d7d569d84915fe81e7a5c5a', '5fefbd10bb6b6dd1ca6f56a07aeeb05fea1072a7']",8,390,398,3976985,7,,,,2896
69dd773c6ddf1b2bdcc439ee7677d63c5d0c3d76,0,Jungtaek Lim,2016-07-08 17:09:06+09:00,['f17aa8afaae2aca451c670d7bf8465cd6ad2839b'],0,1,1,3976986,1,,,,2896
a61f079d60727e11d3986294b2b90833ab760ffc,0,Jungtaek Lim,2016-07-08 17:31:13+09:00,['69dd773c6ddf1b2bdcc439ee7677d63c5d0c3d76'],1,2,3,3976989,1,,,,2896
3bae6c7d3f875446e91c4ea993e230e3ac4eeacf,0,Jungtaek Lim,2016-07-08 17:32:45+09:00,"['69dd773c6ddf1b2bdcc439ee7677d63c5d0c3d76', 'a61f079d60727e11d3986294b2b90833ab760ffc']",1,2,3,3976992,1,,,,2896
faa84235c416361acb4c21f0de0d18e36dbf056e,0,Jungtaek Lim,2016-07-08 17:33:22+09:00,['3bae6c7d3f875446e91c4ea993e230e3ac4eeacf'],0,1,1,3976993,1,,,,2896
c528933b9d5fd1df9d6c1fd8b5b90ca7f1332906,0,Jungtaek Lim,2016-07-08 17:46:04+09:00,['faa84235c416361acb4c21f0de0d18e36dbf056e'],3,3,6,3976999,3,,,,2896
20fa2403185ba3ab281bd12206a55fc910203b69,0,Jungtaek Lim,2016-07-08 17:46:29+09:00,"['faa84235c416361acb4c21f0de0d18e36dbf056e', 'c528933b9d5fd1df9d6c1fd8b5b90ca7f1332906']",3,3,6,3977005,3,,,,2896
d0a5834565769a363ff2a900f3bcca949b93ef22,0,Jungtaek Lim,2016-07-08 17:46:54+09:00,['20fa2403185ba3ab281bd12206a55fc910203b69'],0,1,1,3977006,1,,,,2896
1260b9556f5906b2cb2ad8bed71018f20ae9fdc4,0,Jungtaek Lim,2016-07-08 18:15:36+09:00,"['d0a5834565769a363ff2a900f3bcca949b93ef22', '82b1ad032f237ede2d4e7c0bcb305f8e36355e3e']",1,17,18,3977024,2,,,,2896
b83a8b9bcc06422275899c8981ab9ea75f9535ec,0,Jungtaek Lim,2016-07-08 18:16:39+09:00,['d0a5834565769a363ff2a900f3bcca949b93ef22'],0,1,1,3977025,1,,,,2896
f57c9aada83c42c8d360652fc98f0e3127e6c438,0,Jungtaek Lim,2016-07-08 18:19:15+09:00,"['b83a8b9bcc06422275899c8981ab9ea75f9535ec', '1260b9556f5906b2cb2ad8bed71018f20ae9fdc4']",1,17,18,3977043,2,,,,2896
b2c33e28654827c61f97f868fd1dccd7fa5d7810,0,Jungtaek Lim,2016-07-08 18:39:09+09:00,['f57c9aada83c42c8d360652fc98f0e3127e6c438'],1,24,25,3977068,1,,,,2896
4cb76d0ffb7ad7207b8731a0d469dd8ce10236c3,0,Jungtaek Lim,2016-07-08 18:39:15+09:00,"['f57c9aada83c42c8d360652fc98f0e3127e6c438', 'b2c33e28654827c61f97f868fd1dccd7fa5d7810']",1,24,25,3977093,1,,,,2896
34bfe923af5ac73aba9c18e35a7a0554aa348ea0,0,Jungtaek Lim,2016-07-08 18:40:50+09:00,['4cb76d0ffb7ad7207b8731a0d469dd8ce10236c3'],0,7,7,3977100,1,,,,2896
7c9e0e13b49bc3a79a861958642978e84cdae6b8,0,Jungtaek Lim,2016-07-08 18:49:46+09:00,"['34bfe923af5ac73aba9c18e35a7a0554aa348ea0', '31e8adea10ee503b546c10d0c612a37ffab11b28']",0,2,2,3977102,1,,,,2896
ce97022ef75e8835ccc8e2828b249e6deeb75c33,0,Jungtaek Lim,2016-07-08 18:50:52+09:00,['7c9e0e13b49bc3a79a861958642978e84cdae6b8'],0,1,1,3977103,1,,,,2896
5bc3ecd12580581ee4a204c2797d3ecf53f48e32,0,Jungtaek Lim,2016-07-08 19:02:36+09:00,"['ce97022ef75e8835ccc8e2828b249e6deeb75c33', 'd004cc9518f06e964d1749f8f0980dc2e4f03054']",0,0,0,3977103,3,,,,2896
3986d669e11dc5d72de76d72030f3edcfd5c2c12,0,Jungtaek Lim,2016-07-08 19:03:08+09:00,['5bc3ecd12580581ee4a204c2797d3ecf53f48e32'],0,1,1,3977104,1,,,,2896
ec7c2cdf949b26cf2450ccbdaca998a332ba5285,0,Jungtaek Lim,2016-07-08 19:06:43+09:00,"['3986d669e11dc5d72de76d72030f3edcfd5c2c12', '83c620c7001e09969ad72966c61be825552daaa4']",5,5,10,3977114,1,,,,2896
cf2c6bd5ce8c97b519c9ec822dfda4f8f400455a,0,Jungtaek Lim,2016-07-08 19:07:12+09:00,['ec7c2cdf949b26cf2450ccbdaca998a332ba5285'],0,1,1,3977115,1,,,,2896
9c1159871831a2ec4dec4b8170b773c641defab3,0,Kyle Nusbaum,2016-07-08 14:53:41-05:00,['3773d158c9052757407dcf8a4fa87731923bee21'],7,7,14,3977129,4,,,,2896
55c9e1fc7d030a0a381af34ba726cf2d4a19e953,0,Kyle Nusbaum,2016-07-08 16:22:12-05:00,['cf2c6bd5ce8c97b519c9ec822dfda4f8f400455a'],1,1,2,3977131,1,,,,2896
65bec185a44417dfe071eb5abde77c52985fc2c6,0,darionyaphet,2016-07-10 22:14:53+08:00,['cf2c6bd5ce8c97b519c9ec822dfda4f8f400455a'],3,3,6,3977137,2,,,,2896
99648fb33d31a5a934062fcace00fe9b492fafcd,0,Sriharsha Chintalapani,2016-07-10 12:57:22-07:00,"['cf2c6bd5ce8c97b519c9ec822dfda4f8f400455a', '816a6cc47e5be505d4857e25a4aa14d2f09cade0']",110,66,176,3977313,3,,,,2896
11e98e9aa2246df1eb590a2686a108e56694426f,0,Sriharsha Chintalapani,2016-07-10 12:58:09-07:00,['99648fb33d31a5a934062fcace00fe9b492fafcd'],0,1,1,3977314,1,,,,2896
98510dd5fd9e9f1e74d8e9fe92f57656a5f6aadf,0,Sriharsha Chintalapani,2016-07-10 13:05:34-07:00,['11e98e9aa2246df1eb590a2686a108e56694426f'],1,1,2,3977316,1,,,,2896
3adba32a101c86c51171d0c9109ffcf5b5048662,0,Sriharsha Chintalapani,2016-07-10 13:06:06-07:00,['98510dd5fd9e9f1e74d8e9fe92f57656a5f6aadf'],0,1,1,3977317,1,,,,2896
2abb3b0c44e9f34773fc8fdccba609a257337260,0,Sriharsha Chintalapani,2016-07-10 13:17:24-07:00,['3adba32a101c86c51171d0c9109ffcf5b5048662'],2,12,14,3977331,1,0,1,1,2896
829c134db783fc1b8e450e00f3de82f2a44ddae4,0,Sriharsha Chintalapani,2016-07-10 13:18:09-07:00,['2abb3b0c44e9f34773fc8fdccba609a257337260'],0,1,1,3977332,1,,,,2896
cbb45da685c76980e1dbf5f6cf79d78e72bab943,0,Sriharsha Chintalapani,2016-07-10 13:23:47-07:00,"['829c134db783fc1b8e450e00f3de82f2a44ddae4', '754da7f61e2aef46c64a07f4b7e8cedc9161499a']",207,522,729,3978061,11,,,,2896
6f20f962b9da0522c0f4e3e87acd43eb30f7655c,0,Sriharsha Chintalapani,2016-07-10 13:32:20-07:00,['cbb45da685c76980e1dbf5f6cf79d78e72bab943'],0,1,1,3978062,1,,,,2896
8599c24ee11099edb93be062764c241aeca688b2,0,Sriharsha Chintalapani,2016-07-10 13:42:20-07:00,"['6f20f962b9da0522c0f4e3e87acd43eb30f7655c', 'f056e5ab51219addf8649eec07b6f09b9be46c67']",5,5,10,3978072,1,,,,2896
3a4dd86223d56a9a2f581be669ec5c3799646501,0,Sriharsha Chintalapani,2016-07-10 13:43:57-07:00,['8599c24ee11099edb93be062764c241aeca688b2'],0,1,1,3978073,1,,,,2896
9e1bf0a38f3ae746f90d9e5b2394bb60537c7ccc,0,Sriharsha Chintalapani,2016-07-10 13:50:26-07:00,"['3a4dd86223d56a9a2f581be669ec5c3799646501', '69f40d7654087622d3778326eca1864ad79c438c']",1,0,1,3978074,1,,,,2896
2b4b10e2cebce6d7899e4cda20315523fb58f0a6,0,Sriharsha Chintalapani,2016-07-10 13:55:12-07:00,"['9e1bf0a38f3ae746f90d9e5b2394bb60537c7ccc', 'acf0ce193ed84ab51e3eff46fb4af7281ad8239e']",1,56,57,3978131,3,,,,2896
629ac13a3fd1f7778249b8e19e200f6d0f2bc1e3,0,Sriharsha Chintalapani,2016-07-10 13:56:38-07:00,['2b4b10e2cebce6d7899e4cda20315523fb58f0a6'],0,1,1,3978132,1,,,,2896
05b4ab1ac7d5b32ce3de3cc415f7470354373460,0,Sriharsha Chintalapani,2016-07-10 14:11:30-07:00,"['629ac13a3fd1f7778249b8e19e200f6d0f2bc1e3', '2282fb0c68263cbb1396e9f949e35ce910331236']",19,287,306,3978438,9,,,,2896
122bbefa2264fa3a28156ad60b2e6e3f4dd0fae1,0,Sriharsha Chintalapani,2016-07-10 14:29:40-07:00,['05b4ab1ac7d5b32ce3de3cc415f7470354373460'],0,1,1,3978439,1,,,,2896
465d58c26438b52161f627eddecf8df5f30ca659,0,Sriharsha Chintalapani,2016-07-10 14:41:05-07:00,"['122bbefa2264fa3a28156ad60b2e6e3f4dd0fae1', 'ff595145e30c57271eb8f6ab2f1f31805170f672']",47,150,197,3978636,6,,,,2896
d7ba59d8ad4e89e21f4e15cea8a457f651fa55a8,0,Sriharsha Chintalapani,2016-07-10 14:41:43-07:00,['465d58c26438b52161f627eddecf8df5f30ca659'],0,1,1,3978637,1,,,,2896
e5224b3bd07226dd68f67cbaa4788cd85df1b06d,0,Jungtaek Lim,2016-07-12 00:21:00+09:00,['d7ba59d8ad4e89e21f4e15cea8a457f651fa55a8'],0,17,17,3978654,1,,,,2896
ba383fa33fe5d962121ba7fe13e21fc8a6613163,0,Robert (Bobby) Evans,2016-07-11 10:49:57-05:00,"['d7ba59d8ad4e89e21f4e15cea8a457f651fa55a8', 'e5224b3bd07226dd68f67cbaa4788cd85df1b06d']",0,17,17,3978671,1,,,,2896
bc406545291f6a92c0b09914644c096b401f9b4e,0,Robert (Bobby) Evans,2016-07-11 10:50:21-05:00,['ba383fa33fe5d962121ba7fe13e21fc8a6613163'],0,1,1,3978672,1,,,,2896
931d4decdbb03e0d73e0c77b19bce9ab1e2f6bde,0,Kyle Nusbaum,2016-07-11 12:33:41-05:00,['7825a5b579ff4edb23f835d6e6c2190136c53560'],57,171,228,3978900,8,0.012345679,0.012345679,1,2896
7c87fe1a698ee82507bbba9e37e1fbbdbc246241,0,Kyle Nusbaum,2016-07-11 13:16:23-05:00,"['bc406545291f6a92c0b09914644c096b401f9b4e', '931d4decdbb03e0d73e0c77b19bce9ab1e2f6bde']",57,171,228,3979128,8,,,,2896
a3edb2c8f7f72b0e52ed3af48e4b5629f84faa51,0,Kyle Nusbaum,2016-07-11 13:19:06-05:00,['7c87fe1a698ee82507bbba9e37e1fbbdbc246241'],1,2,3,3979131,1,,,,2896
01be0d4171189ed0ff26b67e9a43da821f81e3b2,0,Robert (Bobby) Evans,2016-07-11 14:19:35-05:00,['a3edb2c8f7f72b0e52ed3af48e4b5629f84faa51'],6,6,12,3979143,1,,,,2896
2b5e8e7dc6e0b3b1ef35e0d85f1e8bf7589f35ba,0,Slava Andreyev,2016-07-11 17:07:57-04:00,['bc406545291f6a92c0b09914644c096b401f9b4e'],12,42,54,3979197,2,,,,2896
aee470ddd3f04543f5579ec6fd0ebf26c1261cba,0,Kyle Nusbaum,2016-07-11 16:15:39-05:00,"['a3edb2c8f7f72b0e52ed3af48e4b5629f84faa51', '55c9e1fc7d030a0a381af34ba726cf2d4a19e953']",1,1,2,3979199,1,,,,2896
f258097d14e614c32aa54fb7dced8589a4b5b0f9,0,Kyle Nusbaum,2016-07-11 16:16:19-05:00,['aee470ddd3f04543f5579ec6fd0ebf26c1261cba'],0,1,1,3979200,1,,,,2896
01ec4820c3dbb45e9dec0c8aefaf90eeeb6ed9fc,0,Kyle Nusbaum,2016-07-11 16:30:07-05:00,['9c1159871831a2ec4dec4b8170b773c641defab3'],2,2,4,3979204,1,,,,2896
e2313dc480608588fba7978eba4d73ed9fe45b6a,0,Kyle Nusbaum,2016-07-11 16:31:30-05:00,"['f258097d14e614c32aa54fb7dced8589a4b5b0f9', '01ec4820c3dbb45e9dec0c8aefaf90eeeb6ed9fc']",3,69,72,3979276,6,,,,2896
05e32892dc27c02ea634e5a1a94a55fc0b39e6fc,0,Kyle Nusbaum,2016-07-11 16:32:05-05:00,['e2313dc480608588fba7978eba4d73ed9fe45b6a'],0,1,1,3979277,1,,,,2896
a865c3381f2236d93d9d8bbb0bc1eada2ebce46f,0,Jungtaek Lim,2016-07-12 18:34:32+09:00,['05e32892dc27c02ea634e5a1a94a55fc0b39e6fc'],10,46,56,3979333,1,0.88,0.88,1,2896
04f00e56beb9799dc8b8fc732271b786ced5c21e,1,Hugo Louro,2016-07-12 08:14:28-07:00,['05e32892dc27c02ea634e5a1a94a55fc0b39e6fc'],16,27,43,3979376,4,1,1,1,2896
5df06bf523754d2bae35c23c24a6c6ffb99e4d9f,0,Hugo Louro,2016-07-13 09:20:59-07:00,['05e32892dc27c02ea634e5a1a94a55fc0b39e6fc'],1,1,2,3979378,1,,,,2896
ec48183ef5528db7e77ff112a8430cf78c4224e3,0,Abhishek Agarwal,2016-07-13 21:41:37+05:18,"['bc406545291f6a92c0b09914644c096b401f9b4e', 'be877a02466208aa9c469fea4d1826b48c06839f']",5,9,14,3979392,2,,,,2896
05a4d9df227c8b083177505ae131962e17e0e47b,0,Alessandro Bellina,2016-07-13 20:47:14-05:00,['09c76f510a13a1a8f6454fd867f00579622fb488'],2,1,3,3979395,1,,,,2896
322b93d8c6ba9cb064beae520c3c16a263d8631f,0,Jungtaek Lim,2016-07-14 18:03:16+09:00,['05e32892dc27c02ea634e5a1a94a55fc0b39e6fc'],1,0,1,3979396,1,1,0,0,2896
074e3f40e20dc8194c3fa7b91f55848355f8c386,0,Jungtaek Lim,2016-07-14 18:45:45+09:00,"['5df06bf523754d2bae35c23c24a6c6ffb99e4d9f', 'a865c3381f2236d93d9d8bbb0bc1eada2ebce46f']",10,46,56,3979452,1,,,,2896
bc5dbdfa2d428d055f68b17ac62073c63e39cc13,0,Jungtaek Lim,2016-07-14 18:47:25+09:00,['074e3f40e20dc8194c3fa7b91f55848355f8c386'],0,1,1,3979453,1,,,,2896
f9ff225e7831a506baa6a87f93ae4372ec516417,0,vesense,2016-07-14 18:27:20+08:00,['5df06bf523754d2bae35c23c24a6c6ffb99e4d9f'],432,978,1410,3980863,74,1,1,0.676470588,2908
4fc4f419cf44739a4863f9866915934f89c0b56f,0,Jungtaek Lim,2016-07-14 22:10:02+09:00,"['bc5dbdfa2d428d055f68b17ac62073c63e39cc13', '675e45547c2a27bcab4fcd1ce95ab51bc68cfbbe']",4,10,14,3980877,1,,,,2908
4ecae60ad76ee8729c819aa30b048f59a54c1ff3,0,Jungtaek Lim,2016-07-14 22:10:34+09:00,['4fc4f419cf44739a4863f9866915934f89c0b56f'],0,1,1,3980878,1,,,,2908
02c2cbcf836be7b13058a7adb56d161d7f40d5bb,1,Hugo Louro,2016-07-14 10:02:33-07:00,['04f00e56beb9799dc8b8fc732271b786ced5c21e'],34,65,99,3980977,1,,,,2908
fcf888e9e4ed88de2c3df70dca9cb39953cbe8f6,1,P. Taylor Goetz,2016-07-14 17:07:56-04:00,['4ecae60ad76ee8729c819aa30b048f59a54c1ff3'],131,243,374,3981351,4,0.25,0.8125,0.8625,2908
25c2d335eb51d9bbee964f729250faef98dfe0e9,0,P. Taylor Goetz,2016-07-14 17:07:56-04:00,['fcf888e9e4ed88de2c3df70dca9cb39953cbe8f6'],44,44,88,3981439,1,,,,2908
12a4e683deb3bcf30dfc37b052e2c8a371ce6664,0,P. Taylor Goetz,2016-07-14 17:08:48-04:00,['25c2d335eb51d9bbee964f729250faef98dfe0e9'],0,1,1,3981440,1,,,,2908
cda008ab55777e6a841ba9295f92bad398e6d128,0,Jungtaek Lim,2016-07-15 08:17:16+09:00,['05e32892dc27c02ea634e5a1a94a55fc0b39e6fc'],15,249,264,3981704,6,0.752293578,1,0.990825688,2910
3cbd26ec275bb052195a038b49853ed1cfc84806,1,Arun Mahadevan,2016-07-15 11:47:48+05:18,['05e32892dc27c02ea634e5a1a94a55fc0b39e6fc'],29,197,226,3981930,12,0.371794872,1,0.935897436,2912
9f9962e1776a88db4462229a751e9a7e83577837,0,P. Taylor Goetz,2016-07-15 12:44:18-04:00,"['12a4e683deb3bcf30dfc37b052e2c8a371ce6664', '02c2cbcf836be7b13058a7adb56d161d7f40d5bb']",50,92,142,3982072,5,,,,2912
1a93d2d546951084185b9475bc577dfeaf10a9d7,0,P. Taylor Goetz,2016-07-15 12:46:39-04:00,['9f9962e1776a88db4462229a751e9a7e83577837'],0,1,1,3982073,1,,,,2912
454caf2bd657991b7cfdc7b0294376712dcc8493,0,P. Taylor Goetz,2016-07-15 13:12:28-04:00,"['1a93d2d546951084185b9475bc577dfeaf10a9d7', 'cda008ab55777e6a841ba9295f92bad398e6d128']",15,249,264,3982337,6,,,,2912
345148e40d74248d5c417a42a77fe9f132204545,0,P. Taylor Goetz,2016-07-15 13:12:57-04:00,['454caf2bd657991b7cfdc7b0294376712dcc8493'],0,1,1,3982338,1,,,,2912
06178132c0753314394ef83b82db713c604e02fd,1,Abhishek Agarwal,2016-07-16 14:36:45+05:18,['ec48183ef5528db7e77ff112a8430cf78c4224e3'],12,63,75,3982413,7,,,,2912
cff9a71eeee0e59b69ea290ee75dc705544ef6b8,1,Abhishek Agarwal,2016-07-16 15:00:55+05:18,"['06178132c0753314394ef83b82db713c604e02fd', '345148e40d74248d5c417a42a77fe9f132204545']",313,929,1242,3983655,33,,,,2912
adddcf44bde89ad904f8798d0e06697cbd4320e0,0,Abhishek Agarwal,2016-07-16 15:05:08+05:18,"['cff9a71eeee0e59b69ea290ee75dc705544ef6b8', '66f273557bef67e6e8cc2498d9d1b98d7e776a37']",0,0,0,3983655,0,,,,2912
86ba5838bc6205b0ce16086d5ac87b0d4136416a,0,GitHub,2016-07-16 15:06:11+05:18,"['66f273557bef67e6e8cc2498d9d1b98d7e776a37', 'adddcf44bde89ad904f8798d0e06697cbd4320e0']",1397,7353,8750,3992405,156,,,,2912
e386c288dedc93ffc558708aaf36cf0dd28f24e6,0,Abhishek Agarwal,2016-07-16 15:11:35+05:18,['86ba5838bc6205b0ce16086d5ac87b0d4136416a'],12,0,12,3992417,1,,,,2912
068ae32e70c67ab6e182fc31be9ec25272e0e5a5,0,Sriharsha Chintalapani,2016-07-16 16:35:18-07:00,"['345148e40d74248d5c417a42a77fe9f132204545', '322b93d8c6ba9cb064beae520c3c16a263d8631f']",1,0,1,3992418,1,,,,2912
fa73e739405e1f92e8a060c6a0b17304c670b66e,0,Sriharsha Chintalapani,2016-07-16 16:36:03-07:00,['068ae32e70c67ab6e182fc31be9ec25272e0e5a5'],0,1,1,3992419,1,,,,2912
6ddf70f99dedca2fe2b6346d34d35fd80445309b,0,Xin Wang,2016-07-17 18:50:49+08:00,"['f9ff225e7831a506baa6a87f93ae4372ec516417', 'fa73e739405e1f92e8a060c6a0b17304c670b66e']",248,683,931,3993350,19,,,,2912
a61fc0463c4f5cbf694e68f05962144d71f33f60,1,Jungtaek Lim,2016-07-18 14:03:24+09:00,['fa73e739405e1f92e8a060c6a0b17304c670b66e'],25,64,89,3993439,5,0,1,0.04,2912
705b2aab273440fc5f533b52e1854a9d8361362b,0,Aaron Niskode-Dossett,2016-07-18 14:10:51+00:00,"['fa73e739405e1f92e8a060c6a0b17304c670b66e', '65bec185a44417dfe071eb5abde77c52985fc2c6']",3,3,6,3993445,2,,,,2912
41b718363da2f418d9a75e45043a6a1cc4e4d0fc,0,Sriharsha Chintalapani,2016-07-19 09:44:08-07:00,"['705b2aab273440fc5f533b52e1854a9d8361362b', 'a61fc0463c4f5cbf694e68f05962144d71f33f60']",25,64,89,3993534,5,,,,2912
f2cba496c081574921dbff7364df5212e859a698,0,Sriharsha Chintalapani,2016-07-19 10:06:32-07:00,['41b718363da2f418d9a75e45043a6a1cc4e4d0fc'],0,1,1,3993535,1,,,,2912
98206170efa0a8a8d9701abaef05d78b268298b1,0,Jungtaek Lim,2016-07-20 08:20:57+09:00,['f2cba496c081574921dbff7364df5212e859a698'],45,0,45,3993580,2,,,,2912
d6c6f25df6f9aed8fb8040aabb4edc22b57c7308,0,Jungtaek Lim,2016-07-20 08:21:32+09:00,"['f2cba496c081574921dbff7364df5212e859a698', '98206170efa0a8a8d9701abaef05d78b268298b1']",45,0,45,3993625,2,,,,2912
12be4653228d4a2e13132c9090fed828c5a1afee,0,Jungtaek Lim,2016-07-20 08:23:33+09:00,['d6c6f25df6f9aed8fb8040aabb4edc22b57c7308'],1,4,5,3993630,1,,,,2912
092bc36093fa5956b4bfd851d89ce74f6c7aa22e,0,Arun Mahadevan,2016-07-20 10:26:42+05:18,['12be4653228d4a2e13132c9090fed828c5a1afee'],1,1,2,3993632,1,,,,2912
d43342d74234c64902f9fd54af8e47e506df9b94,1,Hugo Louro,2016-07-20 00:51:27-07:00,['f2cba496c081574921dbff7364df5212e859a698'],5,9,14,3993646,2,0,1,1,2912
74dbb2a023fb084f216cc8fe493c6eb0cfa513b3,1,Jungtaek Lim,2016-07-20 19:22:25+09:00,['12be4653228d4a2e13132c9090fed828c5a1afee'],1,1,2,3993648,1,,,,2912
c42a3cbd01c37128416588d8f5591243c1f13973,0,Sriharsha Chintalapani,2016-07-20 09:00:46-07:00,['092bc36093fa5956b4bfd851d89ce74f6c7aa22e'],0,1,1,3993649,1,,,,2912
5dac0c11d55b5db277ead7c660842de58fd15324,0,Sriharsha Chintalapani,2016-07-20 09:40:57-07:00,"['c42a3cbd01c37128416588d8f5591243c1f13973', '74dbb2a023fb084f216cc8fe493c6eb0cfa513b3']",1,1,2,3993651,1,,,,2912
85d87eecd749f1c9b2ccf08723c03801257089f9,0,Sriharsha Chintalapani,2016-07-20 09:41:39-07:00,['5dac0c11d55b5db277ead7c660842de58fd15324'],0,1,1,3993652,1,,,,2912
6e5e8f012d88c3db1c1e4666adbc7970411a44c1,0,lujinhong,2016-07-21 15:45:12+08:00,['85d87eecd749f1c9b2ccf08723c03801257089f9'],6,1,7,3993659,1,0,0,1,2912
f38982c022e38dd7e970babfdfaf941064ebfba2,0,Alessandro Bellina,2016-07-21 09:03:04-05:00,['705b2aab273440fc5f533b52e1854a9d8361362b'],4,4,8,3993667,1,,,,2912
b8b5e9e67b0d40e64b0ba33ad9110c9f6043f800,0,P. Taylor Goetz,2016-07-21 11:11:50-04:00,"['85d87eecd749f1c9b2ccf08723c03801257089f9', '05a4d9df227c8b083177505ae131962e17e0e47b']",51,119,170,3993837,14,,,,2912
63947dda331fa9d8cced9abb4935eedcb18b4d35,0,P. Taylor Goetz,2016-07-21 11:13:28-04:00,['b8b5e9e67b0d40e64b0ba33ad9110c9f6043f800'],0,1,1,3993838,1,,,,2912
90eeeee61c8ffa04a5b564ec6dab71161a153436,0,Jungtaek Lim,2016-07-22 01:07:52+09:00,['85d87eecd749f1c9b2ccf08723c03801257089f9'],3,1,4,3993842,1,,,,2912
e5be9863cd825e9fb1dc21d84c1283a23fddc7cc,0,P. Taylor Goetz,2016-07-21 12:26:45-04:00,"['63947dda331fa9d8cced9abb4935eedcb18b4d35', '90eeeee61c8ffa04a5b564ec6dab71161a153436']",3,1,4,3993846,1,,,,2912
a97b16285afe6a12f63360769985812fe7b5526f,0,P. Taylor Goetz,2016-07-21 13:21:24-04:00,"['e5be9863cd825e9fb1dc21d84c1283a23fddc7cc', '3cbd26ec275bb052195a038b49853ed1cfc84806']",29,197,226,3994072,12,,,,2912
5e5bb8f1ffff56026791563edede427b1ae6d9b1,0,P. Taylor Goetz,2016-07-21 13:23:00-04:00,['a97b16285afe6a12f63360769985812fe7b5526f'],0,1,1,3994073,1,,,,2912
328ca17205df61a96676420c6ba11763d4c23370,0,P. Taylor Goetz,2016-07-21 14:21:11-04:00,"['5e5bb8f1ffff56026791563edede427b1ae6d9b1', '01be0d4171189ed0ff26b67e9a43da821f81e3b2']",6,6,12,3994085,1,,,,2912
2f89ab86ac27f4c4cc2fb2e7cb21961ada4647d1,0,P. Taylor Goetz,2016-07-21 14:21:59-04:00,['328ca17205df61a96676420c6ba11763d4c23370'],0,1,1,3994086,1,,,,2912
8115ef525d311df5fd58dbd70e66d82c11141e35,0,P. Taylor Goetz,2016-07-21 15:05:11-04:00,"['2f89ab86ac27f4c4cc2fb2e7cb21961ada4647d1', 'd43342d74234c64902f9fd54af8e47e506df9b94']",5,9,14,3994100,2,,,,2912
31b2126302209969056e1b4dabac9c27a94b7125,0,Satish Duggana,2016-07-22 12:28:37+05:18,['345148e40d74248d5c417a42a77fe9f132204545'],0,8,8,3994108,1,,,,2912
de68c267fcb7555c7729c9377d3f6d1e504ec25e,1,Priyank,2016-07-23 00:09:45-07:00,['8115ef525d311df5fd58dbd70e66d82c11141e35'],0,1807,1807,3995915,17,0.5950783,0.680089485,0.89261745,2927
591618a73690c8fa727a385d107ad0168d62de00,0,Stig Rohde D酶ssing,2016-07-25 09:26:25+02:00,"['e7b128461366ba2597bb083529cb3e0c36ac3bd3', '8115ef525d311df5fd58dbd70e66d82c11141e35']",3742,11747,15489,4011404,267,,,,2927
db1e91401480abd23657c7c7213565a518d54eef,0,Stig Rohde D酶ssing,2016-07-25 09:39:53+02:00,"['591618a73690c8fa727a385d107ad0168d62de00', '5be13404fce05f313e050ad2b082b36a47c430e4']",0,0,0,4011404,0,,,,2927
f4d95ae42b9f9a9fff8447a9ae3f0b3fcf849be9,0,P. Taylor Goetz,2016-07-25 13:45:18-04:00,"['8115ef525d311df5fd58dbd70e66d82c11141e35', '31b2126302209969056e1b4dabac9c27a94b7125']",0,8,8,4011412,1,,,,2927
5750160f5e7aaaf40a24f060194f4b37d81fb157,0,P. Taylor Goetz,2016-07-25 13:46:04-04:00,['f4d95ae42b9f9a9fff8447a9ae3f0b3fcf849be9'],0,1,1,4011413,1,,,,2927
a1983f554646a72b4e7958264ab934af47927bb5,0,P. Taylor Goetz,2016-07-25 14:19:23-04:00,"['5750160f5e7aaaf40a24f060194f4b37d81fb157', 'e386c288dedc93ffc558708aaf36cf0dd28f24e6']",13,54,67,4011480,7,,,,2927
68e10c3a1e1c6ef879f09a9347c43f24e2f2ca3c,0,P. Taylor Goetz,2016-07-25 14:20:13-04:00,['a1983f554646a72b4e7958264ab934af47927bb5'],0,1,1,4011481,1,,,,2927
726f3eafea7ebd72fc71c493bce390c4bb34fce7,1,P. Taylor Goetz,2016-07-25 17:08:33-04:00,['68e10c3a1e1c6ef879f09a9347c43f24e2f2ca3c'],17,19,36,4011517,8,,,,2927
f5ad92888b6f1470e4d7f179fbe5ae73e37a07f7,1,Alessandro Bellina,2016-07-25 23:21:23-05:00,['726f3eafea7ebd72fc71c493bce390c4bb34fce7'],1655,8352,10007,4021524,26,0.317393459,0.421952428,0.919226957,2933
49c47474dbbf5317a8aee68cd877b9bdef4ec27e,0,Priyank,2016-07-26 11:47:11-07:00,['de68c267fcb7555c7729c9377d3f6d1e504ec25e'],168,73,241,4021765,10,0,0.811594203,0.028985507,2933
ebcf0a4423d9e310271bb04d98da3b492455231a,0,Jungtaek Lim,2016-07-28 21:36:58+09:00,['726f3eafea7ebd72fc71c493bce390c4bb34fce7'],192,366,558,4022323,5,0.410358566,0.593625498,0.964143426,2934
b2aa10f0a7e7f8f2779b0a7893b2533c87e2d7b2,0,Jungtaek Lim,2016-07-29 07:48:49+09:00,['726f3eafea7ebd72fc71c493bce390c4bb34fce7'],55,90,145,4022468,3,0.365853659,1,1,2935
f09bfc027b587233f85e8ec4cd3fae50d67a4b9f,0,Jungtaek Lim,2016-07-31 15:23:27+09:00,['726f3eafea7ebd72fc71c493bce390c4bb34fce7'],56,81,137,4022605,3,0,0,1,2936
eefc7c347afcf10142e06fa14029abc563edf845,0,Jungtaek Lim,2016-07-31 17:49:07+09:00,"['726f3eafea7ebd72fc71c493bce390c4bb34fce7', 'ebcf0a4423d9e310271bb04d98da3b492455231a']",192,366,558,4023163,5,,,,2936
5f28b157a62b3aa79ac9dfbf0f14e41b4b659e4a,0,Jungtaek Lim,2016-07-31 17:49:22+09:00,['eefc7c347afcf10142e06fa14029abc563edf845'],0,1,1,4023164,1,,,,2936
2e9221fc271753ede60bd678fb9e137efe22b0fb,0,Jungtaek Lim,2016-07-31 22:47:18+09:00,"['5f28b157a62b3aa79ac9dfbf0f14e41b4b659e4a', 'f38982c022e38dd7e970babfdfaf941064ebfba2']",4,4,8,4023172,1,,,,2936
883a76b4d3b4d12b1a468597d5e358495cacf632,0,Jungtaek Lim,2016-07-31 23:15:22+09:00,['2e9221fc271753ede60bd678fb9e137efe22b0fb'],0,3,3,4023175,1,,,,2936
08938c222e0f81f40c3d9bd3e5231bb86ae6e815,0,Jungtaek Lim,2016-07-31 23:25:45+09:00,['883a76b4d3b4d12b1a468597d5e358495cacf632'],2,2,4,4023179,1,,,,2936
0fa134edb39208eaa232ae93c3ee858565783ef8,0,Jungtaek Lim,2016-07-31 23:26:48+09:00,"['883a76b4d3b4d12b1a468597d5e358495cacf632', '08938c222e0f81f40c3d9bd3e5231bb86ae6e815']",2,2,4,4023183,1,,,,2936
72459a91f9117c3492e0f2a8d4c93df141714475,0,Jungtaek Lim,2016-07-31 23:27:06+09:00,['0fa134edb39208eaa232ae93c3ee858565783ef8'],0,1,1,4023184,1,,,,2936
369a8951533e5bb69914b6e9e653634e2a0a5ebe,0,Jungtaek Lim,2016-08-01 07:30:13+09:00,"['72459a91f9117c3492e0f2a8d4c93df141714475', 'b2aa10f0a7e7f8f2779b0a7893b2533c87e2d7b2']",55,90,145,4023329,3,,,,2936
fd9b9da5be6678e3293d7b4119f5d0e8bea41ee8,0,Jungtaek Lim,2016-08-01 07:30:30+09:00,['369a8951533e5bb69914b6e9e653634e2a0a5ebe'],0,1,1,4023330,1,,,,2936
36ba6edcf10241bc39a8104fabb48337b8e0ddec,0,Jungtaek Lim,2016-08-01 07:32:26+09:00,"['fd9b9da5be6678e3293d7b4119f5d0e8bea41ee8', 'f09bfc027b587233f85e8ec4cd3fae50d67a4b9f']",56,81,137,4023467,3,,,,2936
8dd7be08e42956ad03ba7a5496cdbf8dfcb0afc0,0,Jungtaek Lim,2016-08-01 07:32:43+09:00,['36ba6edcf10241bc39a8104fabb48337b8e0ddec'],0,1,1,4023468,1,,,,2936
b59c75c052ee73203775d9acc2cecb7c691de940,0,Priyank,2016-08-01 12:19:23-07:00,['49c47474dbbf5317a8aee68cd877b9bdef4ec27e'],152,238,390,4023858,3,0,1,0,2938
cc6deef506c6575cbaa3c2ef0728c8151018d9e8,0,GitHub,2016-08-01 16:50:48-04:00,['8dd7be08e42956ad03ba7a5496cdbf8dfcb0afc0'],1,1,2,4023860,1,,,,2938
3fb327a87c1c3060f96bd8b262e8526d8c1f3848,0,GitHub,2016-08-02 15:42:42+08:00,['8dd7be08e42956ad03ba7a5496cdbf8dfcb0afc0'],1,1,2,4023862,1,,,,2938
0f8aebdb5a3fe2b04810b20aa01feaf5be1fdab0,0,darionyaphet,2016-08-03 00:55:22+08:00,['8115ef525d311df5fd58dbd70e66d82c11141e35'],1,5,6,4023868,1,1,1,0,2938
b23958c4df1f0ce4b7869cafc083da5ed139c65e,0,Sriharsha Chintalapani,2016-08-02 21:35:10-07:00,"['8dd7be08e42956ad03ba7a5496cdbf8dfcb0afc0', 'b59c75c052ee73203775d9acc2cecb7c691de940']",0,1798,1798,4025666,19,,,,2938
4abd6e9261ecc463fb551c059833397dd3d61208,0,Sriharsha Chintalapani,2016-08-02 21:57:28-07:00,['b23958c4df1f0ce4b7869cafc083da5ed139c65e'],0,1,1,4025667,1,,,,2938
23ec2f13bfbfd3b725104b58291221b115ada6df,0,Satish Duggana,2016-08-04 00:10:32+05:18,['4abd6e9261ecc463fb551c059833397dd3d61208'],0,10,10,4025677,2,,,,2938
4263644bbe3155780e68fb5edff5945b2773df32,0,Robert (Bobby) Evans,2016-08-04 10:43:02-05:00,['23ec2f13bfbfd3b725104b58291221b115ada6df'],17,10,27,4025704,3,0,0,0.333333333,2938
ff5a4dd2895d707b509be4aafdf14c2c2eba74d6,0,Robert (Bobby) Evans,2016-08-04 11:09:59-05:00,['4263644bbe3155780e68fb5edff5945b2773df32'],1,56,57,4025761,4,,,,2938
ebddc47dba9448f7888fdc4e04c17a02fe4567e2,1,Robert (Bobby) Evans,2016-08-04 11:24:08-05:00,['ff5a4dd2895d707b509be4aafdf14c2c2eba74d6'],2,2,4,4025765,1,,,,2938
ed46c8988b25dc4d832cdc8ac476508cc12e9732,0,Robert (Bobby) Evans,2016-08-04 11:29:24-05:00,['ebddc47dba9448f7888fdc4e04c17a02fe4567e2'],1,1,2,4025767,1,,,,2938
3c9e27b94bcc69a95ee921b9b0837c178dfaed5b,0,Alessandro Bellina,2016-08-05 13:36:05-05:00,['726f3eafea7ebd72fc71c493bce390c4bb34fce7'],14,11,25,4025792,3,,,,2938
b49c60bfb0723fd08f7defd88ec06b8daba8c827,0,Robert (Bobby) Evans,2016-08-05 13:45:06-05:00,"['23ec2f13bfbfd3b725104b58291221b115ada6df', 'ed46c8988b25dc4d832cdc8ac476508cc12e9732']",19,67,86,4025878,8,,,,2938
44068c4191bf0890e81a5612fc989ba984d0a971,0,Robert (Bobby) Evans,2016-08-05 13:45:45-05:00,['b49c60bfb0723fd08f7defd88ec06b8daba8c827'],0,3,3,4025881,1,,,,2938
5414768a1f03f03efb3b18cf1f13c28a1d661331,0,GitHub,2016-08-06 10:53:31+05:18,"['a5369374cf2fe7b1146685bb3581098abea56f1d', '44068c4191bf0890e81a5612fc989ba984d0a971']",4080,14239,18319,4044200,297,,,,2938
422e0534f1a22b65f2ffcbf5e9a3884a619434f1,1,Manikumar Reddy O,2016-08-08 09:26:34+05:18,['44068c4191bf0890e81a5612fc989ba984d0a971'],1,1223,1224,4045424,17,0.467084639,1,0.921630094,2953
a5e19d9b8064f83adf00190ed74518e2156faae2,1,Jungtaek Lim,2016-08-08 17:13:48+09:00,['44068c4191bf0890e81a5612fc989ba984d0a971'],1026,2077,3103,4048527,28,0.340996169,0.695402299,0.619731801,2966
c7d450f3fa871ff35452ac72b011e86c34446264,0,Jungtaek Lim,2016-08-08 17:14:48+09:00,"['44068c4191bf0890e81a5612fc989ba984d0a971', 'a5e19d9b8064f83adf00190ed74518e2156faae2']",1026,2077,3103,4051630,28,,,,2966
28563ece16274bcd61827f38e960ce2d27a57dea,0,Jungtaek Lim,2016-08-08 17:15:20+09:00,['c7d450f3fa871ff35452ac72b011e86c34446264'],0,1,1,4051631,1,,,,2966
aa8e94c43dab44d1ef8f85adb0f7662894efb2f0,1,Jungtaek Lim,2016-08-08 18:02:07+09:00,['28563ece16274bcd61827f38e960ce2d27a57dea'],12,12,24,4051655,3,0,0,1,2966
e602ba614a1f364701ae251859e26d8401821c9f,0,Jungtaek Lim,2016-08-09 10:09:56+09:00,['23ec2f13bfbfd3b725104b58291221b115ada6df'],18,68,86,4051741,3,,,,2966
52b67b4ae677b17e0d255fd103d2d24cd58ff2c0,0,Satish Duggana,2016-08-09 10:15:30+05:18,"['28563ece16274bcd61827f38e960ce2d27a57dea', '422e0534f1a22b65f2ffcbf5e9a3884a619434f1']",1,1223,1224,4052965,17,,,,2966
f5c55ac608fbd05e08530cc744c0d1db7fe6374b,0,Satish Duggana,2016-08-09 10:25:05+05:18,['52b67b4ae677b17e0d255fd103d2d24cd58ff2c0'],0,1,1,4052966,1,,,,2966
d43a91c70f2d8244aa6a9e792c596a5654a7405d,0,Satish Duggana,2016-08-09 10:59:14+05:18,['f5c55ac608fbd05e08530cc744c0d1db7fe6374b'],1,1,2,4052968,1,,,,2966
d7fe6cacfbb0d16b28a6eb56583aa38aba981e76,0,Satish Duggana,2016-08-10 15:43:39+05:18,"['d43a91c70f2d8244aa6a9e792c596a5654a7405d', 'aa8e94c43dab44d1ef8f85adb0f7662894efb2f0']",12,12,24,4052992,3,,,,2966
3b1ab3d8a7da7ed35adc448d24f1f1ccb6c5ff27,0,Satish Duggana,2016-08-10 15:44:50+05:18,['d7fe6cacfbb0d16b28a6eb56583aa38aba981e76'],1,1,2,4052994,1,,,,2966
251a6819ef9ec8b47ac401b5613520f2e2f191de,0,Boyang Jerry Peng,2016-08-11 11:23:56-05:00,"['3b1ab3d8a7da7ed35adc448d24f1f1ccb6c5ff27', '56ffe77b16f354dac18682e0bf2866347ac5cb6b']",0,0,0,4052994,0,,,,2966
019d1e0c6fb8615df4e1ab86def62e8dcb4094e1,0,Boyang Jerry Peng,2016-08-11 11:32:17-05:00,['251a6819ef9ec8b47ac401b5613520f2e2f191de'],0,1,1,4052995,1,,,,2966
3e4d9444c4a637538bf66d36f99c8f36cd50edf5,0,Jungtaek Lim,2016-08-12 08:27:39+09:00,['3b1ab3d8a7da7ed35adc448d24f1f1ccb6c5ff27'],68,0,68,4053063,1,,,,2966
af557ffe27777cb5b9ff0a805ded5b9f1e1b738e,0,Jungtaek Lim,2016-08-12 10:26:49+09:00,['019d1e0c6fb8615df4e1ab86def62e8dcb4094e1'],1,1,2,4053065,1,,,,2966
610eb6e970ade9114c301e321d2375cda772bf11,0,Jungtaek Lim,2016-08-12 10:29:41+09:00,"['019d1e0c6fb8615df4e1ab86def62e8dcb4094e1', 'af557ffe27777cb5b9ff0a805ded5b9f1e1b738e']",1,1,2,4053067,1,,,,2966
cb620d3cdfe3241f6eb201038fbc433d6f145d64,0,Jungtaek Lim,2016-08-12 10:30:04+09:00,['610eb6e970ade9114c301e321d2375cda772bf11'],0,1,1,4053068,1,,,,2966
e8cb020731cf8464181c03223c47854a4341a441,0,Jungtaek Lim,2016-08-12 10:44:20+09:00,"['cb620d3cdfe3241f6eb201038fbc433d6f145d64', '3e4d9444c4a637538bf66d36f99c8f36cd50edf5']",68,0,68,4053136,1,,,,2966
89a6985aef30dd3de75f2ca8de3d638ff22a88cc,0,Arun Mahadevan,2016-08-12 08:55:08+05:18,['019d1e0c6fb8615df4e1ab86def62e8dcb4094e1'],0,1,1,4053137,1,,,,2966
36451ad148ae06e08e608ebfe90bff0a5d713767,0,Jungtaek Lim,2016-08-12 12:54:29+09:00,"['e8cb020731cf8464181c03223c47854a4341a441', 'e602ba614a1f364701ae251859e26d8401821c9f']",18,68,86,4053223,3,,,,2966
24443930a1a1eca136c61aa52fa0f9bd025cb7de,0,Jungtaek Lim,2016-08-12 13:02:30+09:00,['36451ad148ae06e08e608ebfe90bff0a5d713767'],0,1,1,4053224,1,,,,2966
45bf3ef9f461770eaf342cdfb2d7b9c9a8963f1f,0,Abhishek Agarwal,2016-08-12 15:51:10+05:18,['24443930a1a1eca136c61aa52fa0f9bd025cb7de'],405,353,758,4053982,8,0.720779221,1,0.967532468,2970
ecf085a99d30522bacf46ff8204348e344000a11,0,Sriharsha Chintalapani,2016-08-13 20:43:41-07:00,"['24443930a1a1eca136c61aa52fa0f9bd025cb7de', '89a6985aef30dd3de75f2ca8de3d638ff22a88cc']",0,1,1,4053983,1,,,,2970
a1a952a4af3654dfaeb737d798df201335a5da45,0,Sriharsha Chintalapani,2016-08-13 20:44:39-07:00,['ecf085a99d30522bacf46ff8204348e344000a11'],3,4,7,4053990,1,,,,2970
820c2684809a837f8a58d902d4408de7e1cd79ed,0,Alessandro Bellina,2016-08-15 14:56:42-05:00,['a1a952a4af3654dfaeb737d798df201335a5da45'],27,12,39,4054029,3,1,0,0.142857143,2970
52ff5c9fdef41d7d440c0893e0228c859ffcd36f,0,Jungtaek Lim,2016-08-16 22:44:26+09:00,"['a1a952a4af3654dfaeb737d798df201335a5da45', '45bf3ef9f461770eaf342cdfb2d7b9c9a8963f1f']",405,353,758,4054787,8,,,,2970
da5c3acd7e5123876566db6ddf2d8de2b4a3506e,0,Jungtaek Lim,2016-08-16 23:07:27+09:00,['52ff5c9fdef41d7d440c0893e0228c859ffcd36f'],0,4,4,4054791,1,,,,2970
95555e114e868b34e00ddd6b052718038405a97d,0,Sriharsha Chintalapani,2016-08-16 16:13:07-07:00,['d7ba59d8ad4e89e21f4e15cea8a457f651fa55a8'],5,4,9,4054800,3,,,,2970
96b3325ccdf7ac7649a1425d176c59308811954c,0,Alessandro Bellina,2016-08-16 22:59:56-05:00,['820c2684809a837f8a58d902d4408de7e1cd79ed'],1,1,2,4054802,1,,,,2970
6c3cd2a3c3c39dc79e2cae576546876bf2efab0c,0,Arun Mahadevan,2016-08-17 14:03:12+05:18,['da5c3acd7e5123876566db6ddf2d8de2b4a3506e'],12,9,21,4054823,4,1,1,1,2970
d090d877f002ecd8be831639d2c29e95f820e7dc,0,Alessandro Bellina,2016-08-17 08:03:58-05:00,['96b3325ccdf7ac7649a1425d176c59308811954c'],3,15,18,4054841,3,,,,2970
7cf7647e546201d3f175860526888cd92b3927b3,0,鍗箰,2016-08-18 20:30:11+08:00,['da5c3acd7e5123876566db6ddf2d8de2b4a3506e'],1,1,2,4054843,1,,,,2970
588af4b876fd3addd1f3d78cdf476250800c3cdc,0,Jungtaek Lim,2016-08-19 10:47:46+09:00,"['da5c3acd7e5123876566db6ddf2d8de2b4a3506e', '95555e114e868b34e00ddd6b052718038405a97d']",5,4,9,4054852,3,,,,2970
b1dca4ea389761f6429791f408bf5c17da5fe26f,0,Jungtaek Lim,2016-08-19 10:48:17+09:00,['588af4b876fd3addd1f3d78cdf476250800c3cdc'],0,1,1,4054853,1,,,,2970
3ec0e3aed5d132c5b33786bfd6f6d2ea66eacebf,0,Jungtaek Lim,2016-08-19 14:29:33+09:00,"['b1dca4ea389761f6429791f408bf5c17da5fe26f', '6c3cd2a3c3c39dc79e2cae576546876bf2efab0c']",12,9,21,4054874,4,,,,2970
318c9e26b32d6c3f3533c956a213df78a2c12793,0,Jungtaek Lim,2016-08-19 14:47:38+09:00,['3ec0e3aed5d132c5b33786bfd6f6d2ea66eacebf'],0,1,1,4054875,1,,,,2970
f155d95142079e7f545b05d8a844b109ef542841,0,Juan Paulo Gutierrez,2016-08-19 15:51:08+09:00,['8dd7be08e42956ad03ba7a5496cdbf8dfcb0afc0'],1,1,2,4054877,1,,,,2970
dd7859056c180a148e6177e73729b4553bc06316,0,GitHub,2016-08-19 15:56:37+08:00,['318c9e26b32d6c3f3533c956a213df78a2c12793'],1,1,2,4054879,1,,,,2970
b53753d30d225d15aafae5e9627e82840adb5a7f,0,Juan Paulo Gutierrez,2016-08-19 17:06:16+09:00,"['f155d95142079e7f545b05d8a844b109ef542841', '318c9e26b32d6c3f3533c956a213df78a2c12793']",1557,5629,7186,4062065,87,,,,2970
736df0c602eb4a350db41c13aec69b2e412513e8,0,Arun Mahadevan,2016-08-20 15:20:15+05:18,['b1dca4ea389761f6429791f408bf5c17da5fe26f'],1,3,4,4062069,1,,,,2970
5de39b39bbe06d661b489c09dfb544e01902c2a8,1,GitHub,2016-08-21 17:17:49+08:00,['318c9e26b32d6c3f3533c956a213df78a2c12793'],2,2,4,4062073,1,,,,2970
00cbacf0771de5b528d1991265b72090a14cfaeb,0,Jungtaek Lim,2016-08-22 17:33:27+09:00,"['318c9e26b32d6c3f3533c956a213df78a2c12793', 'f5ad92888b6f1470e4d7f179fbe5ae73e37a07f7']",1655,8352,10007,4072080,26,,,,2970
09bfca3379d35598a46bae7e495a3ad1a597349a,0,Jungtaek Lim,2016-08-22 17:34:00+09:00,['00cbacf0771de5b528d1991265b72090a14cfaeb'],0,1,1,4072081,1,,,,2970
a507899d5b2706ecca16420e082aa351864603ca,0,Jungtaek Lim,2016-08-22 20:16:32+09:00,"['09bfca3379d35598a46bae7e495a3ad1a597349a', '7cf7647e546201d3f175860526888cd92b3927b3']",1,1,2,4072083,1,,,,2970
dad9db9729c76365f04159b7656fc4e0011de831,0,Jungtaek Lim,2016-08-22 20:17:04+09:00,['a507899d5b2706ecca16420e082aa351864603ca'],0,1,1,4072084,1,,,,2970
fd29b2af553d0601a8a954c4f0f0f81966962a38,1,Jungtaek Lim,2016-08-23 09:10:56+09:00,['dad9db9729c76365f04159b7656fc4e0011de831'],7,3,10,4072094,3,0,0,0,2970
038664188bbe3f056a24a0ab3f2ab11080c61c5b,0,Jungtaek Lim,2016-08-23 09:13:05+09:00,['fd29b2af553d0601a8a954c4f0f0f81966962a38'],0,1,1,4072095,1,,,,2970
4d6ebe1041d907961ea4338b75924bf022ce99e5,0,Jungtaek Lim,2016-08-23 09:20:27+09:00,"['038664188bbe3f056a24a0ab3f2ab11080c61c5b', 'cc6deef506c6575cbaa3c2ef0728c8151018d9e8']",1,1,2,4072097,1,,,,2970
5fc33f0d9e41a85c74e77c8d19ae80c3fe0783ac,0,Jungtaek Lim,2016-08-23 09:21:41+09:00,['4d6ebe1041d907961ea4338b75924bf022ce99e5'],0,1,1,4072098,1,,,,2970
cfe84e915f2f8ef3c7103b40ad764addc9d08eeb,0,Jungtaek Lim,2016-08-23 09:28:44+09:00,"['5fc33f0d9e41a85c74e77c8d19ae80c3fe0783ac', '2b5e8e7dc6e0b3b1ef35e0d85f1e8bf7589f35ba']",12,42,54,4072152,2,,,,2970
73a9e960fc58d53cddf25ca411403a31328c9178,0,Jungtaek Lim,2016-08-23 09:34:41+09:00,"['cfe84e915f2f8ef3c7103b40ad764addc9d08eeb', 'b53753d30d225d15aafae5e9627e82840adb5a7f']",1,1,2,4072154,1,,,,2970
f350f0291d69413543d0fbd0d38d867a97978ff0,0,Jungtaek Lim,2016-08-23 09:35:45+09:00,['cfe84e915f2f8ef3c7103b40ad764addc9d08eeb'],0,1,1,4072155,1,,,,2970
1726a46b4d967a68b0a41fe61469a8ae3017b4fd,0,Jungtaek Lim,2016-08-23 09:38:02+09:00,['f350f0291d69413543d0fbd0d38d867a97978ff0'],1,1,2,4072157,1,,,,2970
aba71a58c88ac8a1403d1cd68474c820380e5a42,0,Jungtaek Lim,2016-08-23 09:40:32+09:00,"['1726a46b4d967a68b0a41fe61469a8ae3017b4fd', '73a9e960fc58d53cddf25ca411403a31328c9178']",1,1,2,4072159,1,,,,2970
1c35bc6656c623a2ccca6a0fe442c60ebebe46fe,0,Jungtaek Lim,2016-08-23 09:43:09+09:00,"['aba71a58c88ac8a1403d1cd68474c820380e5a42', '736df0c602eb4a350db41c13aec69b2e412513e8']",1,3,4,4072163,1,,,,2970
abad44526cc5344eaf110bc1d81dfa2fb8ce2f65,0,Jungtaek Lim,2016-08-23 09:43:32+09:00,['1c35bc6656c623a2ccca6a0fe442c60ebebe46fe'],0,1,1,4072164,1,,,,2970
3fee2bddada979b5da3919e6fe06ac9146311734,1,Jungtaek Lim,2016-08-23 17:00:54+09:00,['abad44526cc5344eaf110bc1d81dfa2fb8ce2f65'],2284,4403,6687,4078851,65,0.372511848,0.626540284,0.878672986,2983
51f52fe8d67d7aed6adcaf1ce5bf47e6261b5204,0,Jungtaek Lim,2016-08-23 17:01:08+09:00,"['abad44526cc5344eaf110bc1d81dfa2fb8ce2f65', '3fee2bddada979b5da3919e6fe06ac9146311734']",2284,4403,6687,4085538,65,,,,2983
5b7300ea0e57fd7adaea25cd65856eec66bcf6ee,0,Jungtaek Lim,2016-08-23 17:01:32+09:00,['51f52fe8d67d7aed6adcaf1ce5bf47e6261b5204'],0,1,1,4085539,1,,,,2983
f78c262e65cde4dc27fdf48685d331a3f12f9620,0,Kyle Nusbaum,2016-08-23 15:34:09-05:00,['5b7300ea0e57fd7adaea25cd65856eec66bcf6ee'],0,0,0,4085539,0,,,,2983
225d468ec14d9a7c8d7a414f2c316203a7a25efd,0,Kyle Nusbaum,2016-08-23 15:37:07-05:00,['f78c262e65cde4dc27fdf48685d331a3f12f9620'],0,0,0,4085539,0,,,,2983
fdac5bb6931e09f23cba188228afa733e9e1a0fb,0,Kyle Nusbaum,2016-08-23 15:39:49-05:00,['225d468ec14d9a7c8d7a414f2c316203a7a25efd'],0,0,0,4085539,0,,,,2983
1e72a5bc6994b969958599d36f6584e7f080f028,0,Kyle Nusbaum,2016-08-23 15:45:52-05:00,['fdac5bb6931e09f23cba188228afa733e9e1a0fb'],0,0,0,4085539,0,,,,2983
e55c6e3c3d612efbc5d90453fd71eedb93424e2e,0,Kyle Nusbaum,2016-08-23 16:23:58-05:00,['1e72a5bc6994b969958599d36f6584e7f080f028'],0,0,0,4085539,0,,,,2983
b2c6b96505ac3af51e00bee4e6ea3b4428f5e8b1,0,Kyle Nusbaum,2016-08-23 16:27:14-05:00,['e55c6e3c3d612efbc5d90453fd71eedb93424e2e'],0,0,0,4085539,0,,,,2983
0b080fcf63ad6dad52c654e059f2493599df1d67,0,Jungtaek Lim,2016-08-24 11:11:34+09:00,['b2c6b96505ac3af51e00bee4e6ea3b4428f5e8b1'],23,7,30,4085569,2,,,,2983
f17f71ebd72c49892fbcd87106741f7e327ebae7,1,Jungtaek Lim,2016-08-24 12:09:57+09:00,['0b080fcf63ad6dad52c654e059f2493599df1d67'],4,251,255,4085824,5,1,1,1,2984
e554e3c7135b2c7aed7529103ecfe6bd47d0fe1c,0,Jungtaek Lim,2016-08-24 12:47:14+09:00,['0b080fcf63ad6dad52c654e059f2493599df1d67'],41,0,41,4085865,3,,,,2984
28eefbef90900f715e19a55da9d48fcec1f32947,1,Jungtaek Lim,2016-08-25 06:58:38+09:00,['da5c3acd7e5123876566db6ddf2d8de2b4a3506e'],371,1211,1582,4087447,26,0.506329114,0.772151899,0.762025316,2995
64fb1b1a1c09f79dbb1ed919b786e20c0d4a358d,0,Jungtaek Lim,2016-08-25 07:00:56+09:00,"['0b080fcf63ad6dad52c654e059f2493599df1d67', '28eefbef90900f715e19a55da9d48fcec1f32947']",371,1211,1582,4089029,26,,,,2995
989b00811f631a7bfedb0f8ee6888efd4637e562,0,Jungtaek Lim,2016-08-25 07:01:21+09:00,['64fb1b1a1c09f79dbb1ed919b786e20c0d4a358d'],0,1,1,4089030,1,,,,2995
1f5f4a2bda0134c27b6d95f87599ecee850f953a,1,Jungtaek Lim,2016-08-25 07:42:38+09:00,['989b00811f631a7bfedb0f8ee6888efd4637e562'],30,363,393,4089423,7,0.705128205,0.967948718,0.807692308,2996
22c5c7d5e395e03f38e1000000f3a46864cc544c,0,Jungtaek Lim,2016-08-25 21:52:04+09:00,"['989b00811f631a7bfedb0f8ee6888efd4637e562', '1f5f4a2bda0134c27b6d95f87599ecee850f953a']",30,363,393,4089816,7,,,,2996
7e15fbe3428664d34e2d2b76a30878315bb3ccaa,0,Jungtaek Lim,2016-08-25 21:52:32+09:00,['22c5c7d5e395e03f38e1000000f3a46864cc544c'],0,1,1,4089817,1,,,,2996
9dd62dacf9aab8e5db3bb2647007956eb1425b03,1,Hugo Louro,2016-08-25 11:35:38-07:00,['0b080fcf63ad6dad52c654e059f2493599df1d67'],18,66,84,4089901,3,0,1,1,2996
a12f6436734b5fa4a90854b1462d78efef71d70a,0,P. Taylor Goetz,2016-08-25 15:54:44-04:00,['d152d72f3726f3ff40ba74dee0392f8764b43fd0'],72,60,132,4090033,14,1,1,1,2996
0d2319ca892ff90c3cb6a3248e4ef3b482a53100,0,P. Taylor Goetz,2016-08-25 16:13:10-04:00,['a12f6436734b5fa4a90854b1462d78efef71d70a'],32,8,40,4090073,4,,,,2996
1ad1b5168592c884403d9fcbfe6e041ab15e08db,0,P. Taylor Goetz,2016-08-25 16:14:33-04:00,['0d2319ca892ff90c3cb6a3248e4ef3b482a53100'],1,1,2,4090075,1,,,,2996
89100c416b3eb47e062d6ce94de761a6799d898f,0,P. Taylor Goetz,2016-08-25 16:24:21-04:00,['1ad1b5168592c884403d9fcbfe6e041ab15e08db'],1,9,10,4090085,1,,,,2996
bfbd6ed18d6836c7e114f0ca7837fb1ce6f83629,0,P. Taylor Goetz,2016-08-25 16:27:22-04:00,['89100c416b3eb47e062d6ce94de761a6799d898f'],1,1,2,4090087,1,,,,2996
6112d6474524237cbc44f3430d20f6d1d419eae8,0,P. Taylor Goetz,2016-08-25 16:29:27-04:00,['bfbd6ed18d6836c7e114f0ca7837fb1ce6f83629'],1,1,2,4090089,1,,,,2996
aab6acdf316c48bf566e37776790116f2794199b,0,P. Taylor Goetz,2016-08-25 16:29:30-04:00,['6112d6474524237cbc44f3430d20f6d1d419eae8'],1,1,2,4090091,1,,,,2996
e740c32a0e19b71fda5e0a72ef6c55d1685a213b,1,Stig Rohde D酶ssing,2016-08-29 09:48:18+02:00,['db1e91401480abd23657c7c7213565a518d54eef'],4,9,13,4090104,1,0,1,1,2996
3457a03884bba7976074b0a36c3c10c91a6ee074,0,Stig Rohde D酶ssing,2016-08-29 09:48:37+02:00,"['e740c32a0e19b71fda5e0a72ef6c55d1685a213b', '7e15fbe3428664d34e2d2b76a30878315bb3ccaa']",5844,20220,26064,4116168,213,,,,2996
c400a2e092207c6e08b3f6cd36343202c1314d71,0,Alessandro Bellina,2016-08-29 11:12:07-05:00,['7e15fbe3428664d34e2d2b76a30878315bb3ccaa'],16,42,58,4116226,3,1,1,0,2996
1e4db17f0539132a9026e18ef0479971927818ff,0,Alessandro Bellina,2016-08-29 12:07:28-05:00,['7e15fbe3428664d34e2d2b76a30878315bb3ccaa'],1,1,2,4116228,1,,,,2996
5e36f9342d2322ea987a2d386e11724de4b514dd,0,Sriharsha Chintalapani,2016-08-29 11:52:12-07:00,"['7e15fbe3428664d34e2d2b76a30878315bb3ccaa', '9dd62dacf9aab8e5db3bb2647007956eb1425b03']",18,66,84,4116312,3,,,,2996
3e56bd10df812d9c27a39ed94f3d22a3ecfffd52,0,Sriharsha Chintalapani,2016-08-29 11:55:35-07:00,['5e36f9342d2322ea987a2d386e11724de4b514dd'],0,1,1,4116313,1,,,,2996
788d0b6bfb12ed985fe84686ccab039d0a497def,0,Alessandro Bellina,2016-08-29 17:41:30-05:00,['7e15fbe3428664d34e2d2b76a30878315bb3ccaa'],1,9,10,4116323,1,0,1,0,2996
743b8e0f88a018c7851be6db2d081d31627d10c8,1,Jungtaek Lim,2016-08-30 10:22:48+09:00,['3e56bd10df812d9c27a39ed94f3d22a3ecfffd52'],2,2,4,4116327,1,,,,2996
4c796731e25627893a66cbdc5099000f5177b4b2,0,Paul Poulosky,2016-08-30 10:31:47-05:00,['3e56bd10df812d9c27a39ed94f3d22a3ecfffd52'],12,26,38,4116365,2,1,1,1,2996
71fb390a0b31d3b48a238b6777c3a9c7cb481245,0,Boyang Jerry Peng,2016-08-30 15:38:05-05:00,['3e56bd10df812d9c27a39ed94f3d22a3ecfffd52'],13,16,29,4116394,1,,,,2996
ef3c4de133528d04f76a43a0e87e72cea19e173e,0,Jungtaek Lim,2016-08-31 08:26:17+09:00,['3e56bd10df812d9c27a39ed94f3d22a3ecfffd52'],1,1,2,4116396,1,,,,2996
313282c607d965a2c25ffd1b946153753ecdb1d0,0,Jungtaek Lim,2016-08-31 16:22:42+09:00,"['3e56bd10df812d9c27a39ed94f3d22a3ecfffd52', '1e4db17f0539132a9026e18ef0479971927818ff']",1,1,2,4116398,1,,,,2996
eb998c565ae0648f3fa8eaebfd95141613ac0d70,0,Jungtaek Lim,2016-08-31 16:24:02+09:00,['313282c607d965a2c25ffd1b946153753ecdb1d0'],0,1,1,4116399,1,,,,2996
c9e6595967801cb9bd26790098b480fd0e2232c8,0,Jungtaek Lim,2016-08-31 16:54:28+09:00,"['eb998c565ae0648f3fa8eaebfd95141613ac0d70', 'c400a2e092207c6e08b3f6cd36343202c1314d71']",16,42,58,4116457,3,,,,2996
a7b4a42961e6fa536e38f825e2213b37f88b52a4,0,Jungtaek Lim,2016-08-31 16:55:51+09:00,['eb998c565ae0648f3fa8eaebfd95141613ac0d70'],0,1,1,4116458,1,,,,2996
b3d6359b1400ef484198df0b47fb6b34e570b4d6,0,Jungtaek Lim,2016-08-31 17:05:39+09:00,"['a7b4a42961e6fa536e38f825e2213b37f88b52a4', 'c9e6595967801cb9bd26790098b480fd0e2232c8']",16,42,58,4116516,3,,,,2996
f547f3faffd93b1fcaac8858ec61c8861fc4fd1d,0,Jungtaek Lim,2016-08-31 17:22:14+09:00,"['b3d6359b1400ef484198df0b47fb6b34e570b4d6', '3c9e27b94bcc69a95ee921b9b0837c178dfaed5b']",14,11,25,4116541,3,,,,2996
a149adf02b6278851b7be591377341bbb4bd56be,0,Jungtaek Lim,2016-08-31 18:15:21+09:00,"['f547f3faffd93b1fcaac8858ec61c8861fc4fd1d', 'd090d877f002ecd8be831639d2c29e95f820e7dc']",30,27,57,4116598,5,,,,2996
bcadf0461f1819d54cd3e8bde321c8f8a7775789,0,Jungtaek Lim,2016-08-31 18:16:20+09:00,['a149adf02b6278851b7be591377341bbb4bd56be'],0,1,1,4116599,1,,,,2996
c8191d75e630b762b3b06adc288b416eb97424e2,0,Xin Wang,2016-08-31 21:21:42+08:00,"['dd7859056c180a148e6177e73729b4553bc06316', 'bcadf0461f1819d54cd3e8bde321c8f8a7775789']",4040,14122,18162,4134761,131,,,,2996
a4bf2af9626a789d397a23059240ea8b06f9880e,0,Jungtaek Lim,2016-08-31 22:29:50+09:00,"['bcadf0461f1819d54cd3e8bde321c8f8a7775789', 'c8191d75e630b762b3b06adc288b416eb97424e2']",1,1,2,4134763,1,,,,2996
e61e7738328913ec429742cd2b3cb22a39eb263f,0,GitHub,2016-08-31 23:11:28+08:00,['bcadf0461f1819d54cd3e8bde321c8f8a7775789'],3,11,14,4134777,1,0,0,1,2996
0264698419b7da82eb494c4c23a6f8b185583229,1,Stig Rohde D酶ssing,2016-08-31 17:45:29+02:00,['3457a03884bba7976074b0a36c3c10c91a6ee074'],1,6,7,4134784,1,0.833333333,1,1,2996
69a85ec27e081ef61ea65bda0b54804a1cb1504c,0,Jungtaek Lim,2016-09-01 07:33:46+09:00,"['a4bf2af9626a789d397a23059240ea8b06f9880e', '4c796731e25627893a66cbdc5099000f5177b4b2']",12,26,38,4134822,2,,,,2996
b96b06938007ecb036441998d2e5592d7786b398,0,Jungtaek Lim,2016-09-01 07:39:31+09:00,['69a85ec27e081ef61ea65bda0b54804a1cb1504c'],0,1,1,4134823,1,,,,2996
0a3c168e83c2e9219361044520ad6cf74b9487f4,0,Jungtaek Lim,2016-09-01 07:44:09+09:00,"['b96b06938007ecb036441998d2e5592d7786b398', '71fb390a0b31d3b48a238b6777c3a9c7cb481245']",13,16,29,4134852,1,,,,2996
4c692c16ec91147ac17d25f4ec19307887e218b6,0,Jungtaek Lim,2016-09-01 07:44:39+09:00,['b96b06938007ecb036441998d2e5592d7786b398'],0,1,1,4134853,1,,,,2996
b9071ae156f898796385f5c5ab54ee1f7df94fc9,0,Jungtaek Lim,2016-09-01 07:47:34+09:00,"['4c692c16ec91147ac17d25f4ec19307887e218b6', '0a3c168e83c2e9219361044520ad6cf74b9487f4']",13,16,29,4134882,1,,,,2996
7b267ecdff585eb01ede602435d58dcb4a31e2ed,0,manuzhang,2016-09-01 12:01:36+08:00,['bcadf0461f1819d54cd3e8bde321c8f8a7775789'],22,27,49,4134931,2,0,1,1,2996
eceb8ed797e7a528e074f3e45f63040428e0719b,0,vesense,2016-09-01 12:56:02+08:00,"['6ddf70f99dedca2fe2b6346d34d35fd80445309b', 'b9071ae156f898796385f5c5ab54ee1f7df94fc9']",6076,20784,26860,4161791,251,,,,2996
4a0f37b1511eac3960ef6a16c7da0890dc40b798,0,Jungtaek Lim,2016-09-01 15:36:53+09:00,"['b9071ae156f898796385f5c5ab54ee1f7df94fc9', 'ef3c4de133528d04f76a43a0e87e72cea19e173e']",1,1,2,4161793,1,,,,2996
97f0cba13eebab0cac991fc8e92cbf9e727b4fcc,0,Jungtaek Lim,2016-09-01 15:37:11+09:00,['4a0f37b1511eac3960ef6a16c7da0890dc40b798'],0,1,1,4161794,1,,,,2996
d7de92ced449737034d4451891c17721b408411e,0,Jungtaek Lim,2016-09-01 17:08:25+09:00,['97f0cba13eebab0cac991fc8e92cbf9e727b4fcc'],3,5,8,4161802,2,,,,2996
3cfa00eb2cf1b3c56c9904cf7fc76cb3c5384086,0,Alessandro Bellina,2016-09-01 09:13:52-05:00,['97f0cba13eebab0cac991fc8e92cbf9e727b4fcc'],14,23,37,4161839,1,0.375,0,0.375,2996
06f4e11374227154d42f04788b64ea1905004d85,0,Paul Poulosky,2016-09-01 10:51:27-05:00,['3e56bd10df812d9c27a39ed94f3d22a3ecfffd52'],49,0,49,4161888,2,,,,2996
7d706c542b5d5863eea98c1430634a0ac962d792,0,Boyang Jerry Peng,2016-09-01 15:11:35-05:00,['97f0cba13eebab0cac991fc8e92cbf9e727b4fcc'],1,0,1,4161889,1,,,,2996
454649c5c4b77d50f1205e5352e5859c35a31f4e,0,Jungtaek Lim,2016-09-02 09:30:27+09:00,"['97f0cba13eebab0cac991fc8e92cbf9e727b4fcc', '7b267ecdff585eb01ede602435d58dcb4a31e2ed']",22,27,49,4161938,2,,,,2996
2b4609f15c019aa69d85e395115c57f90ed7b9cd,0,Jungtaek Lim,2016-09-02 09:31:23+09:00,['454649c5c4b77d50f1205e5352e5859c35a31f4e'],0,1,1,4161939,1,,,,2996
e9125e0fdaf7c97227edf0466846f05302d47d8e,0,Jungtaek Lim,2016-09-02 09:44:39+09:00,"['2b4609f15c019aa69d85e395115c57f90ed7b9cd', '06f4e11374227154d42f04788b64ea1905004d85']",49,0,49,4161988,2,,,,2996
0164728b0737bf5a901d04cce425cd7e0b3bd96a,0,Jungtaek Lim,2016-09-02 09:45:41+09:00,['e9125e0fdaf7c97227edf0466846f05302d47d8e'],0,1,1,4161989,1,,,,2996
d409aab3ab48893c6b352abd8f015bab3657ec22,0,Jungtaek Lim,2016-09-02 10:16:27+09:00,['0b080fcf63ad6dad52c654e059f2493599df1d67'],38,55,93,4162082,5,1,1,1,2996
0b861c19152cb3d400bc9f216d9aaa84b8fa60ee,0,Alessandro Bellina,2016-09-03 15:01:47-05:00,['3cfa00eb2cf1b3c56c9904cf7fc76cb3c5384086'],5,2,7,4162089,1,0,0,0,2996
641494f572d3e0c2ad4e1cdedd63cd8f7d42c42e,0,Xin Wang,2016-09-04 16:47:59+08:00,['e61e7738328913ec429742cd2b3cb22a39eb263f'],7,2,9,4162098,1,1,1,0,2996
bcd6d8b905dd659c9e1870caafa34a2903fd6d96,0,Xin Wang,2016-09-04 22:17:33+08:00,['eceb8ed797e7a528e074f3e45f63040428e0719b'],27,457,484,4162582,11,,,,2996
f14fb62d3ea3e5704577ddbfa52e0a149e443dd6,0,vesense,2016-09-05 11:31:03+08:00,['0164728b0737bf5a901d04cce425cd7e0b3bd96a'],4,4,8,4162590,9,,,,2996
5086dfaf04a1e3d147212123da9c8a1ad591149a,0,Robert (Bobby) Evans,2016-09-05 15:11:35-05:00,"['0164728b0737bf5a901d04cce425cd7e0b3bd96a', 'd409aab3ab48893c6b352abd8f015bab3657ec22']",38,55,93,4162683,5,,,,2996
fbbc6344271848ab4b6c91e88ecc498839ba0ce4,0,Robert (Bobby) Evans,2016-09-05 15:12:08-05:00,['5086dfaf04a1e3d147212123da9c8a1ad591149a'],0,1,1,4162684,1,,,,2996
6f40de8015c94851f2296a766de9cfb98db0df52,0,Jungtaek Lim,2016-09-06 13:07:59+09:00,"['fbbc6344271848ab4b6c91e88ecc498839ba0ce4', 'f14fb62d3ea3e5704577ddbfa52e0a149e443dd6']",4,4,8,4162692,9,,,,2996
ce5f21f02a53d240aaad4890dfcdf9c6fee5907e,0,Jungtaek Lim,2016-09-06 13:08:50+09:00,['6f40de8015c94851f2296a766de9cfb98db0df52'],0,1,1,4162693,1,,,,2996
72a76d7182a965c0b005430b69c4d6586962031c,0,Jungtaek Lim,2016-09-06 14:00:34+09:00,"['ce5f21f02a53d240aaad4890dfcdf9c6fee5907e', '641494f572d3e0c2ad4e1cdedd63cd8f7d42c42e']",3,6,9,4162702,1,,,,2996
111d76524f1c94ec7a7544091bdc4b024a6479ca,0,Jungtaek Lim,2016-09-06 14:03:25+09:00,['72a76d7182a965c0b005430b69c4d6586962031c'],0,1,1,4162703,1,,,,2996
ddc72b17db025cd771ac4e2cdf26615233f1c60a,0,Jungtaek Lim,2016-09-06 14:07:06+09:00,"['111d76524f1c94ec7a7544091bdc4b024a6479ca', '7d706c542b5d5863eea98c1430634a0ac962d792']",1,0,1,4162704,1,,,,2996
ef94566bcc66fcb5ff0db21c32f3a2f3999d7aa6,0,Jungtaek Lim,2016-09-06 14:08:15+09:00,['ddc72b17db025cd771ac4e2cdf26615233f1c60a'],0,1,1,4162705,1,,,,2996
a6f807d259382093ed474d89148fa82a90117693,0,GitHub,2016-09-06 21:39:09+05:18,"['5414768a1f03f03efb3b18cf1f13c28a1d661331', 'ef94566bcc66fcb5ff0db21c32f3a2f3999d7aa6']",5644,17939,23583,4186288,197,,,,2996
c71314fbd2101ff081bee7aef3ecc434c3541044,0,Kyle Nusbaum,2016-09-06 16:04:07-05:00,['ef94566bcc66fcb5ff0db21c32f3a2f3999d7aa6'],0,2,2,4186290,1,,,,2996
8ebb8ca96784b565be4659fe0c9e7b19cdc6978e,0,kamleshbhatt,2016-09-07 08:15:35+05:18,['44068c4191bf0890e81a5612fc989ba984d0a971'],0,114,114,4186404,1,0.701754386,1,1,2997
1ab0a0fa49acec384da46b7c3f557b5ed453e289,0,kamleshbhatt,2016-09-07 08:17:55+05:18,"['8ebb8ca96784b565be4659fe0c9e7b19cdc6978e', 'a6f807d259382093ed474d89148fa82a90117693']",5644,17939,23583,4209987,197,,,,2997
c752c3c4d4b5547c49490443036e9043939a3071,0,Xin Wang,2016-09-07 16:27:28+08:00,['ef94566bcc66fcb5ff0db21c32f3a2f3999d7aa6'],13,2,15,4210002,1,0,0,0,2997
efa546862f7717ee1db222895ea14e6432666ab3,0,Kyle Nusbaum,2016-09-08 15:07:49-05:00,['c71314fbd2101ff081bee7aef3ecc434c3541044'],99,241,340,4210342,10,0.753246753,0.207792208,0.090909091,2999
4a4da58105ab1ac8eb9e02ff647cd4150c806ef2,0,Bruno P. Kinoshita,2016-09-12 13:44:52+12:00,['ef94566bcc66fcb5ff0db21c32f3a2f3999d7aa6'],2,2,4,4210346,1,,,,2999
32723e0670f4d9610fec232032d85f2d5fcf2240,0,Jungtaek Lim,2016-09-12 12:12:26+09:00,"['ef94566bcc66fcb5ff0db21c32f3a2f3999d7aa6', 'c752c3c4d4b5547c49490443036e9043939a3071']",13,2,15,4210361,1,,,,2999
8b489948784b8b5bd9c0846ae6ff322196a02525,0,Jungtaek Lim,2016-09-12 12:13:05+09:00,['32723e0670f4d9610fec232032d85f2d5fcf2240'],0,1,1,4210362,1,,,,2999
9f436320903ca4a0644a98c3b161f93233759c29,0,Jungtaek Lim,2016-09-12 12:44:15+09:00,"['8b489948784b8b5bd9c0846ae6ff322196a02525', 'bcd6d8b905dd659c9e1870caafa34a2903fd6d96']",428,1404,1832,4212194,74,,,,2999
a1e962666804a07d2b6184b6152417cab478aa10,0,Jungtaek Lim,2016-09-12 12:44:42+09:00,['9f436320903ca4a0644a98c3b161f93233759c29'],0,1,1,4212195,1,,,,2999
0bfd1afc5455e72a8f63143c4fcb40d9fa54da01,1,Jungtaek Lim,2016-09-13 13:29:19+09:00,['743b8e0f88a018c7851be6db2d081d31627d10c8'],46,637,683,4212878,11,0.565714286,0.851428571,0.671428571,3002
f7f5aa4fda1eaac6a4ae85dd268a09883d6d6123,0,Jungtaek Lim,2016-09-13 13:31:51+09:00,"['a1e962666804a07d2b6184b6152417cab478aa10', '0bfd1afc5455e72a8f63143c4fcb40d9fa54da01']",48,639,687,4213565,12,,,,3002
0d302cd3b7ed32f063a35f80b7b169c276239a50,0,Jungtaek Lim,2016-09-13 13:34:50+09:00,['f7f5aa4fda1eaac6a4ae85dd268a09883d6d6123'],0,2,2,4213567,1,,,,3002
cb05b85908626394361863026e187b108beca5ce,0,Jungtaek Lim,2016-09-13 16:23:48+09:00,['0d302cd3b7ed32f063a35f80b7b169c276239a50'],3,3,6,4213573,1,,,,3002
cd5c9e8f904205a6ca6eee9222ca954ca8b37ec3,0,Jungtaek Lim,2016-09-13 17:49:22+09:00,['cb05b85908626394361863026e187b108beca5ce'],2,3,5,4213578,1,,,,3002
9888bf6b994a29a2f18ac8126c249dd314ed764b,0,vesense,2016-09-13 17:33:26+08:00,['cd5c9e8f904205a6ca6eee9222ca954ca8b37ec3'],15,21,36,4213614,1,0,0,1,3002
093671bf7f100bd2304db7dbd66240c50704295e,0,kamleshbhatt,2016-09-15 23:11:53+05:18,['1ab0a0fa49acec384da46b7c3f557b5ed453e289'],0,16,16,4213630,1,1,1,1,3002
0a8f3e20b287dec5d0e1c5e4fe7c66f2e39cc8ae,1,kamleshbhatt,2016-09-15 23:14:12+05:18,['093671bf7f100bd2304db7dbd66240c50704295e'],16,35,51,4213681,1,1,1,1,3002
788256d641ae8220feb02451509c385d27079082,1,Hugo Louro,2016-09-16 08:10:57+01:00,['cd5c9e8f904205a6ca6eee9222ca954ca8b37ec3'],94,399,493,4214174,15,0.765714286,1,0.885714286,3003
8d57f611bd66f8fec6b0f864e484e205400d3aaa,1,Manikumar Reddy O,2016-09-16 15:10:54+05:18,['cd5c9e8f904205a6ca6eee9222ca954ca8b37ec3'],5,5,10,4214184,2,,,,3003
c69a4864dfcb0e82d63e278a92bb662842e52d4b,0,kamleshbhatt,2016-09-16 20:26:35+05:18,['0a8f3e20b287dec5d0e1c5e4fe7c66f2e39cc8ae'],1,1,2,4214186,1,,,,3003
ae3b90fdfd22dabfe2f72155f48802e1f1cb2d19,0,vesense,2016-09-18 11:19:14+08:00,['9888bf6b994a29a2f18ac8126c249dd314ed764b'],6,13,19,4214205,1,0,0,1,3003
3dd4b43b130081afa796dde335674665ea09884d,0,Jungtaek Lim,2016-09-19 08:43:56+09:00,"['cd5c9e8f904205a6ca6eee9222ca954ca8b37ec3', 'ae3b90fdfd22dabfe2f72155f48802e1f1cb2d19']",15,28,43,4214248,1,,,,3003
dbe1878453f63a01cc143134975a90e0da1fb378,0,Jungtaek Lim,2016-09-19 08:45:23+09:00,['3dd4b43b130081afa796dde335674665ea09884d'],0,1,1,4214249,1,,,,3003
520270d8783b1bb99d1508af445be5956d7f4818,0,Satish Duggana,2016-09-19 08:35:03+05:18,"['dbe1878453f63a01cc143134975a90e0da1fb378', '8d57f611bd66f8fec6b0f864e484e205400d3aaa']",5,5,10,4214259,2,,,,3003
2b08b95aaf49f1a78e3b76bf97fdaa6484fd5961,0,Satish Duggana,2016-09-19 09:12:03+05:18,['520270d8783b1bb99d1508af445be5956d7f4818'],0,1,1,4214260,1,,,,3003
8e6552ce439d4caf872bc92d8c0c03a32c340022,0,Jungtaek Lim,2016-09-19 21:31:19+09:00,['2b08b95aaf49f1a78e3b76bf97fdaa6484fd5961'],0,17,17,4214277,1,,,,3003
7c15b55a3403b45d83b83bbfe5a75756bfbc579f,1,Jungtaek Lim,2016-09-19 22:40:33+09:00,['a1e962666804a07d2b6184b6152417cab478aa10'],9,193,202,4214479,7,0,1,1,3003
70ecffc8b83ccdf8f99bd35dfb53e14ef3578fa6,0,Stig Rohde D酶ssing,2016-09-19 18:28:55+02:00,['0264698419b7da82eb494c4c23a6f8b185583229'],1,1,2,4214481,1,,,,3003
ee37e57a4bcdf93d85019314909c04143ef0a96a,1,Stig Rohde D酶ssing,2016-09-19 19:44:57+02:00,['70ecffc8b83ccdf8f99bd35dfb53e14ef3578fa6'],6,9,15,4214496,1,1,1,1,3003
f46cfc15fa2069cabaa742ccfd2b5689fe5a3777,0,Kyle Nusbaum,2016-09-19 14:22:46-05:00,['efa546862f7717ee1db222895ea14e6432666ab3'],9,9,18,4214514,1,0,0,0,3003
0c002928e49f63070915e7a41f97f70b40336f23,0,Kyle Nusbaum,2016-09-19 14:47:04-05:00,"['f46cfc15fa2069cabaa742ccfd2b5689fe5a3777', '8e6552ce439d4caf872bc92d8c0c03a32c340022']",514,2107,2621,4217135,91,,,,3003
f8cbfd5bff20d4a6c87f00f401ff13f83e09a4ae,0,Robert (Bobby) Evans,2016-09-19 15:12:25-05:00,"['8e6552ce439d4caf872bc92d8c0c03a32c340022', 'ee37e57a4bcdf93d85019314909c04143ef0a96a']",19,79,98,4217233,3,,,,3003
4ce6f04e8352b142b746471a5b96da7ac11c2bf2,0,Robert (Bobby) Evans,2016-09-19 15:41:38-05:00,['f8cbfd5bff20d4a6c87f00f401ff13f83e09a4ae'],0,1,1,4217234,1,,,,3003
5a3204610734871f18ba38a29b271cfb814ff1bc,1,Robert (Bobby) Evans,2016-09-19 15:57:57-05:00,['4ce6f04e8352b142b746471a5b96da7ac11c2bf2'],3825,6100,9925,4227159,71,0.441573034,1,1,3023
e0056c7d6cb5d71a327814a7a97a885093ae43dc,0,Robert (Bobby) Evans,2016-09-19 15:58:08-05:00,['5a3204610734871f18ba38a29b271cfb814ff1bc'],0,1,1,4227160,1,,,,3023
5228916f453f67e418f373c4de3129ea8656d6ea,1,Jungtaek Lim,2016-09-20 12:03:49+09:00,['8e6552ce439d4caf872bc92d8c0c03a32c340022'],16,27,43,4227203,2,1,1,1,3023
b0944100e339f6d28c6c7bb936bef8ebb1948d89,0,Alessandro Bellina,2016-09-20 08:21:15-05:00,['cd5c9e8f904205a6ca6eee9222ca954ca8b37ec3'],10,11,21,4227224,1,,,,3023
d312e750a4cf7051cf1df54af090e540b4920d9a,0,Satish Duggana,2016-09-21 08:36:53+05:18,"['e0056c7d6cb5d71a327814a7a97a885093ae43dc', '5228916f453f67e418f373c4de3129ea8656d6ea']",16,27,43,4227267,2,,,,3023
84641f636f5932cbdcadd4409fe2d717059d2996,0,Satish Duggana,2016-09-21 08:59:43+05:18,['d312e750a4cf7051cf1df54af090e540b4920d9a'],0,1,1,4227268,1,,,,3023
ef8bc581872b38b31d69bbb441c9e638f0b197b4,1,Alessandro Bellina,2016-09-21 09:50:09-05:00,['e0056c7d6cb5d71a327814a7a97a885093ae43dc'],86,214,300,4227568,5,,,,3023
4acd9ebfa8d555d3d20e18d61192412c181e61cc,0,Alessandro Bellina,2016-09-21 10:20:10-05:00,['ef8bc581872b38b31d69bbb441c9e638f0b197b4'],10,10,20,4227588,1,,,,3023
874e730668c10efde55c907318920a7b095e091f,0,Robert (Bobby) Evans,2016-09-21 11:16:23-05:00,['84641f636f5932cbdcadd4409fe2d717059d2996'],2,7,9,4227597,2,0,0.333333333,1,3023
09d9ea101b4dbaf49335907aaaf3167d29140c59,0,GitHub,2016-09-21 14:51:50-05:00,['84641f636f5932cbdcadd4409fe2d717059d2996'],1,1,2,4227599,1,,,,3023
26dc3a6ad333a79224eaac71d5876d0ea1db5853,0,Jungtaek Lim,2016-09-22 20:46:11+09:00,['84641f636f5932cbdcadd4409fe2d717059d2996'],2,2,4,4227603,1,,,,3023
2da36e660dbf3e80db54a209a91d093f520ff7cd,1,Arun Mahadevan,2016-09-22 17:49:07+05:18,['7e15fbe3428664d34e2d2b76a30878315bb3ccaa'],24,43,67,4227670,3,1,1,0.846153846,3023
967132b80245cdfd8de70cbe4112524c85b75392,0,Boyang Jerry Peng,2016-09-22 13:39:24-05:00,['84641f636f5932cbdcadd4409fe2d717059d2996'],1,1,2,4227672,1,,,,3023
7777a90beecebd731521902eb418ac5c9b987e65,0,Jungtaek Lim,2016-09-23 10:00:09+09:00,"['84641f636f5932cbdcadd4409fe2d717059d2996', '045dd814e6f5beec7b560d5435de71612ef04ade']",1,1,2,4227674,1,,,,3023
b5b2dfc6d4407e51f9ce5dbdb88cb83fa5378569,0,Jungtaek Lim,2016-09-23 10:00:37+09:00,['7777a90beecebd731521902eb418ac5c9b987e65'],0,1,1,4227675,1,,,,3023
bf31bc6e82772ea7906f7237bf3f03f995d18dba,0,Jungtaek Lim,2016-09-23 10:05:03+09:00,"['b5b2dfc6d4407e51f9ce5dbdb88cb83fa5378569', '31c6e07a664037e2eb9e1f5d820761199ec437c8']",5,16,21,4227696,4,,,,3023
bc2293a3d680910472006e8a22df214287f2af85,0,Jungtaek Lim,2016-09-23 10:12:33+09:00,['bf31bc6e82772ea7906f7237bf3f03f995d18dba'],0,1,1,4227697,1,,,,3023
dd3dacbbeefa06e4bd06d629747f1cfb4bb35b42,0,Jungtaek Lim,2016-09-23 10:16:56+09:00,"['bc2293a3d680910472006e8a22df214287f2af85', '6e5e8f012d88c3db1c1e4666adbc7970411a44c1']",6,1,7,4227704,1,,,,3023
b21d9364e84d7f335a2591724bedefc9ccad8d55,0,Jungtaek Lim,2016-09-23 10:19:06+09:00,"['dd3dacbbeefa06e4bd06d629747f1cfb4bb35b42', '0f8aebdb5a3fe2b04810b20aa01feaf5be1fdab0']",1,5,6,4227710,1,,,,3023
39a24bd00cf04f23ba1afb47cabec23f675649bd,0,Jungtaek Lim,2016-09-23 10:19:30+09:00,['b21d9364e84d7f335a2591724bedefc9ccad8d55'],0,1,1,4227711,1,,,,3023
aa0da6c6116a4ae2c41a5884b58f9574e942d6e9,0,Jungtaek Lim,2016-09-23 10:22:43+09:00,"['39a24bd00cf04f23ba1afb47cabec23f675649bd', '5de39b39bbe06d661b489c09dfb544e01902c2a8']",2,2,4,4227715,1,,,,3023
fe413ab5ccc1d910617f48c53d8f33239f59bf43,0,Jungtaek Lim,2016-09-23 10:26:28+09:00,"['aa0da6c6116a4ae2c41a5884b58f9574e942d6e9', '4a4da58105ab1ac8eb9e02ff647cd4150c806ef2']",2,2,4,4227719,1,,,,3023
b779ca4e270f6f2a86d4d30336004e4a642ec690,1,Jungtaek Lim,2016-09-23 10:32:28+09:00,['fe413ab5ccc1d910617f48c53d8f33239f59bf43'],2,3099,3101,4230820,35,0.712177122,0.919741697,0.861623616,3055
83e1e5b9e99ad44770a59c929fd7105b440333b8,0,Jungtaek Lim,2016-09-23 10:32:44+09:00,"['fe413ab5ccc1d910617f48c53d8f33239f59bf43', 'b779ca4e270f6f2a86d4d30336004e4a642ec690']",2,3099,3101,4233921,35,,,,3055
73640f0c7185385199fefaad233d2c3fe572f266,0,Jungtaek Lim,2016-09-23 10:33:08+09:00,['83e1e5b9e99ad44770a59c929fd7105b440333b8'],0,1,1,4233922,1,,,,3055
0352361d2649f1d0536f7acebb4175d6b9285e8d,0,Jungtaek Lim,2016-09-23 10:38:37+09:00,"['73640f0c7185385199fefaad233d2c3fe572f266', 'b0944100e339f6d28c6c7bb936bef8ebb1948d89']",10,11,21,4233943,1,,,,3055
3a16070385e699af37d996fb2401260ec671a391,0,Jungtaek Lim,2016-09-23 10:39:04+09:00,['0352361d2649f1d0536f7acebb4175d6b9285e8d'],0,1,1,4233944,1,,,,3055
edd0c73d71dceeeb0e2d645a8d96da8fc1c13aa3,0,Jungtaek Lim,2016-09-23 10:43:33+09:00,"['3a16070385e699af37d996fb2401260ec671a391', '874e730668c10efde55c907318920a7b095e091f']",2,7,9,4233953,2,,,,3055
1bdc922e288dac031cdb9bc628e3dd660385dd03,0,Jungtaek Lim,2016-09-23 10:44:02+09:00,['edd0c73d71dceeeb0e2d645a8d96da8fc1c13aa3'],0,1,1,4233954,1,,,,3055
bd75c9352c45d7e7c16b46052c0a3c4e9b2513d2,0,Jungtaek Lim,2016-09-23 10:48:23+09:00,"['1bdc922e288dac031cdb9bc628e3dd660385dd03', '09d9ea101b4dbaf49335907aaaf3167d29140c59']",1,1,2,4233956,1,,,,3055
5e5e83cabe3b66161d4774f5f5698fcad8012d0e,0,Jungtaek Lim,2016-09-23 10:48:43+09:00,['bd75c9352c45d7e7c16b46052c0a3c4e9b2513d2'],0,1,1,4233957,1,,,,3055
1fed08f3ee56de4bc98adc8991c7b2c76f9bf4ec,0,Jungtaek Lim,2016-09-23 10:56:21+09:00,"['5e5e83cabe3b66161d4774f5f5698fcad8012d0e', '96828b3a8015b29caee0a99d9e5bb6da4be2f0fe']",3,17,20,4233977,2,,,,3055
eb02edeaa8e7e6daf0012c68650d35b5fd00baa6,0,Jungtaek Lim,2016-09-23 10:56:49+09:00,['1fed08f3ee56de4bc98adc8991c7b2c76f9bf4ec'],0,1,1,4233978,1,,,,3055
7140a1534c32b1ead35c4c35a251a543f2e0b488,0,Jungtaek Lim,2016-09-23 11:02:58+09:00,"['eb02edeaa8e7e6daf0012c68650d35b5fd00baa6', '0b861c19152cb3d400bc9f216d9aaa84b8fa60ee']",14,20,34,4234012,1,,,,3055
d2ca97f3e96e382f33978893e2fad9a887933b76,0,Jungtaek Lim,2016-09-23 11:13:29+09:00,['7140a1534c32b1ead35c4c35a251a543f2e0b488'],0,1,1,4234013,1,,,,3055
a7445d3f714e4eee913997689f87ad53b5483ac5,0,Arun Mahadevan,2016-09-23 11:15:45+05:18,['2da36e660dbf3e80db54a209a91d093f520ff7cd'],2,9,11,4234024,1,1,1,0,3055
6cd9661bde2ce4c93c5628aae2565e167b89aeb3,0,Kyle Nusbaum,2016-09-23 01:48:33-05:00,['0c002928e49f63070915e7a41f97f70b40336f23'],5,16,21,4234045,4,0,0.7,1,3055
6a8be9f8c19bacb646c119c162c6cdba69cc66ff,0,Kyle Nusbaum,2016-09-23 02:03:46-05:00,['6cd9661bde2ce4c93c5628aae2565e167b89aeb3'],12,0,12,4234057,1,,,,3055
523317b06abe87d7e745885c32c8a9c5dfbbeb0d,0,Kyle Nusbaum,2016-09-23 02:29:59-05:00,['6a8be9f8c19bacb646c119c162c6cdba69cc66ff'],39,0,39,4234096,2,,,,3055
410ef3a816fc6a961771abfbcac2d83512192040,0,Kyle Nusbaum,2016-09-23 02:31:54-05:00,['523317b06abe87d7e745885c32c8a9c5dfbbeb0d'],2,2,4,4234100,1,,,,3055
158228b7ad434287e7d1ec92aca9c5c08f144869,0,Kyle Nusbaum,2016-09-23 11:03:32-05:00,['410ef3a816fc6a961771abfbcac2d83512192040'],0,0,0,4234100,0,,,,3055
e55d9b7d47a8ea62174be106af0f9ab1cea402eb,0,Robert (Bobby) Evans,2016-09-23 11:26:34-05:00,['d2ca97f3e96e382f33978893e2fad9a887933b76'],14,79,93,4234193,1,1,0.536585366,0.585365854,3055
6a657f16301306b5b0d8d4ab91f916c6e7757ffe,0,Kyle Nusbaum,2016-09-23 11:28:39-05:00,['158228b7ad434287e7d1ec92aca9c5c08f144869'],3,35,38,4234231,3,0,1,1,3055
e5a8841d3138eb5b7ce7863b0b2a1c8452bb8b5c,0,Robert (Bobby) Evans,2016-09-23 11:51:30-05:00,['d2ca97f3e96e382f33978893e2fad9a887933b76'],4,4,8,4234239,1,,,,3055
bf91e6d27912d02912d7220d2abeeaf05b8d5f0a,0,Robert (Bobby) Evans,2016-09-23 12:07:25-05:00,['e5a8841d3138eb5b7ce7863b0b2a1c8452bb8b5c'],4,4,8,4234247,1,,,,3055
7bb3b25473b7271512715f0599f27c334ef61332,0,Robert (Bobby) Evans,2016-09-23 12:28:03-05:00,"['d2ca97f3e96e382f33978893e2fad9a887933b76', '26dc3a6ad333a79224eaac71d5876d0ea1db5853']",2,2,4,4234251,1,,,,3055
d8115e7bdfeb08a9629a6e8525b90de72c35cbf7,0,Robert (Bobby) Evans,2016-09-23 12:28:44-05:00,['7bb3b25473b7271512715f0599f27c334ef61332'],0,1,1,4234252,1,,,,3055
42722c5f1707d8179adf2903480744327b326954,0,kamleshbhatt,2016-09-23 23:06:51+05:18,['c69a4864dfcb0e82d63e278a92bb662842e52d4b'],4,6,10,4234262,1,,,,3055
dcd4de631cc3b4d5752da8e0246c658c9b0dca24,0,kamleshbhatt,2016-09-23 23:10:08+05:18,['42722c5f1707d8179adf2903480744327b326954'],4,5,9,4234271,1,0,1,1,3055
506b77ed2428d7554000d2bcdbb036c55c068825,0,Jungtaek Lim,2016-09-25 20:17:34+09:00,"['d8115e7bdfeb08a9629a6e8525b90de72c35cbf7', '4acd9ebfa8d555d3d20e18d61192412c181e61cc']",86,214,300,4234571,5,,,,3055
5fea60211987043926fe404e1fbf86b69dfd1723,0,Jungtaek Lim,2016-09-25 20:44:48+09:00,['506b77ed2428d7554000d2bcdbb036c55c068825'],0,1,1,4234572,1,,,,3055
1056efb227409c136e715da0f93a06633b53af8c,0,Jungtaek Lim,2016-09-25 20:57:04+09:00,"['5fea60211987043926fe404e1fbf86b69dfd1723', 'e55d9b7d47a8ea62174be106af0f9ab1cea402eb']",14,79,93,4234665,1,,,,3055
22e9609e933587436aee018009684d5599c0f47b,0,Jungtaek Lim,2016-09-25 21:08:56+09:00,['1056efb227409c136e715da0f93a06633b53af8c'],0,1,1,4234666,1,,,,3055
6220f71edf9906d2ec1197cb8f7316c85e4fa20d,0,Jungtaek Lim,2016-09-25 21:12:21+09:00,"['22e9609e933587436aee018009684d5599c0f47b', '967132b80245cdfd8de70cbe4112524c85b75392']",1,1,2,4234668,1,,,,3055
95832a2cdcfe01f4cf3fa66177230d44d2c24da2,0,Jungtaek Lim,2016-09-25 21:13:26+09:00,['6220f71edf9906d2ec1197cb8f7316c85e4fa20d'],0,1,1,4234669,1,,,,3055
d5540871117eb680f52002cc3e65318e0efb1067,0,Jungtaek Lim,2016-09-25 21:18:47+09:00,"['95832a2cdcfe01f4cf3fa66177230d44d2c24da2', 'a7445d3f714e4eee913997689f87ad53b5483ac5']",24,50,74,4234743,3,,,,3055
00f4c146b25e19eb2c18fd405ae0c1efc33f7472,0,Jungtaek Lim,2016-09-25 21:19:15+09:00,['d5540871117eb680f52002cc3e65318e0efb1067'],0,1,1,4234744,1,,,,3055
15e4d5eb039667ff470f62cc65cad03921287fdf,0,Jungtaek Lim,2016-09-25 21:22:59+09:00,['00f4c146b25e19eb2c18fd405ae0c1efc33f7472'],1,1,2,4234746,1,,,,3055
c91aada18da634ab0cf78577913c5e1d1e427066,0,Jungtaek Lim,2016-09-25 21:26:18+09:00,"['15e4d5eb039667ff470f62cc65cad03921287fdf', 'bf91e6d27912d02912d7220d2abeeaf05b8d5f0a']",2,2,4,4234750,1,,,,3055
8e26bc1429b820559474f034e15f80a95b3c6346,0,Jungtaek Lim,2016-09-25 21:26:45+09:00,['c91aada18da634ab0cf78577913c5e1d1e427066'],0,1,1,4234751,1,,,,3055
92df7044846e6f296ecab6282503dd0fac6875e2,0,Jungtaek Lim,2016-09-26 12:41:46+09:00,['8e26bc1429b820559474f034e15f80a95b3c6346'],16,23,39,4234790,2,,,,3055
837591df3fc9047055b16f64527cbbec59684849,0,Kyle Nusbaum,2016-09-26 16:31:50-05:00,['6a657f16301306b5b0d8d4ab91f916c6e7757ffe'],10,3,13,4234803,5,1,1,0,3055
1cd5b749a77fd83bc6e5c501c103f706ff1fe51c,0,Jungtaek Lim,2016-09-27 06:43:32+09:00,['8e26bc1429b820559474f034e15f80a95b3c6346'],147,210,357,4235160,12,0,1,1,3056
227721a6d185929eb0a81d86ef3e5a5c7df47a1b,0,Jungtaek Lim,2016-09-27 06:49:04+09:00,"['8e26bc1429b820559474f034e15f80a95b3c6346', '1cd5b749a77fd83bc6e5c501c103f706ff1fe51c']",147,210,357,4235517,12,,,,3056
07fcbf64a4cef832292b79e602f22ac54a055a4e,0,Jungtaek Lim,2016-09-27 06:49:34+09:00,['227721a6d185929eb0a81d86ef3e5a5c7df47a1b'],0,1,1,4235518,1,,,,3056
300569caa24db5495168635864d0a30e0b5cba67,0,Jungtaek Lim,2016-09-27 06:57:50+09:00,['07fcbf64a4cef832292b79e602f22ac54a055a4e'],1,1,2,4235520,1,,,,3056
e02af6e544d4ddab1af7047cb705bbe68f4d4cfb,1,Jungtaek Lim,2016-09-27 07:14:40+09:00,['300569caa24db5495168635864d0a30e0b5cba67'],0,512,512,4236032,6,0.570588235,1,0.729411765,3060
1cc4a2412e6d153bf2f940b94e81f3986edce9bc,0,Robert (Bobby) Evans,2016-09-27 09:58:54-05:00,"['300569caa24db5495168635864d0a30e0b5cba67', '92df7044846e6f296ecab6282503dd0fac6875e2']",16,23,39,4236071,2,,,,3060
230e64ec5df0d489ea24091f7f53ee7d677150b1,0,Kyle Nusbaum,2016-09-27 12:38:21-05:00,['837591df3fc9047055b16f64527cbbec59684849'],8,13,21,4236092,2,1,1,1,3060
d9d2e118691c40e3ef22c3240bec62dca907a6ad,0,Alessandro Bellina,2016-09-27 15:35:44-05:00,['1cc4a2412e6d153bf2f940b94e81f3986edce9bc'],1332,1795,3127,4239219,35,0.184375,0.19375,0.99375,3060
fedfbc4ede6d9e60b8d8e113fe498a1cfe36643f,0,Alessandro Bellina,2016-09-27 15:35:44-05:00,['d9d2e118691c40e3ef22c3240bec62dca907a6ad'],47,37,84,4239303,2,,,,3060
7252848608d8a90fc6041fc155ec52655b2c5f29,0,Kyle Nusbaum,2016-09-27 15:43:04-05:00,['230e64ec5df0d489ea24091f7f53ee7d677150b1'],8,7,15,4239318,3,1,1,0,3060
12c8a8af48842d99076c6af6a7893299638dad0d,0,Alessandro Bellina,2016-09-27 16:00:41-05:00,['fedfbc4ede6d9e60b8d8e113fe498a1cfe36643f'],12,82,94,4239412,1,,,,3060
362858c49919d2264606be06469f1da79fadc511,0,Ravi Peri,2016-09-27 14:06:16-07:00,['cd5c9e8f904205a6ca6eee9222ca954ca8b37ec3'],346,588,934,4240346,10,0.582417582,1,0.835164835,3062
c5a9ad8d2cb2dcb71a7dd96d65cfd01a854ab60e,0,Robert (Bobby) Evans,2016-09-27 16:41:13-05:00,"['1cc4a2412e6d153bf2f940b94e81f3986edce9bc', '12c8a8af48842d99076c6af6a7893299638dad0d']",1377,1900,3277,4243623,36,,,,3062
35a73151a3abf868e58002a1685c7fa2f98030d3,0,Robert (Bobby) Evans,2016-09-27 16:57:42-05:00,['c5a9ad8d2cb2dcb71a7dd96d65cfd01a854ab60e'],0,1,1,4243624,1,,,,3062
3b8472b615072a1c4f183816ef13dbff9b304e43,1,Kyle Nusbaum,2016-09-27 17:02:18-05:00,['7252848608d8a90fc6041fc155ec52655b2c5f29'],3,6,9,4243633,1,0,0,1,3062
3b0c69d9cf619d836d4f4f667a3b373bff354a9a,0,Robert (Bobby) Evans,2016-09-28 08:16:25-05:00,['35a73151a3abf868e58002a1685c7fa2f98030d3'],1,1,2,4243635,1,,,,3062
f3e4dd3ffa818d575f531edde6045cdf9c21decb,0,Robert (Bobby) Evans,2016-09-28 08:17:23-05:00,['3b0c69d9cf619d836d4f4f667a3b373bff354a9a'],0,1,1,4243636,1,,,,3062
c0c72eab7004e1e8e46e6c24f2abb7e4b24c863a,0,Alessandro Bellina,2016-09-28 09:18:51-05:00,['35a73151a3abf868e58002a1685c7fa2f98030d3'],42,30,72,4243708,1,,,,3062
093c7923a6174a5919307ea33e6f34df42e82e1a,0,Alessandro Bellina,2016-09-28 09:48:37-05:00,['c0c72eab7004e1e8e46e6c24f2abb7e4b24c863a'],1,2,3,4243711,1,,,,3062
71acf9b78f766faff251d5586a4aa35bb601e5d2,0,Alessandro Bellina,2016-09-28 09:48:47-05:00,['093c7923a6174a5919307ea33e6f34df42e82e1a'],174,167,341,4244052,11,,,,3062
164fd9c6e1f6dd0925858ba3fce40859e547938d,0,Robert (Bobby) Evans,2016-09-29 09:25:40-05:00,"['f3e4dd3ffa818d575f531edde6045cdf9c21decb', '71acf9b78f766faff251d5586a4aa35bb601e5d2']",217,199,416,4244468,13,,,,3062
337e83518fc182d280e738ca4ab38610eb23d475,0,Robert (Bobby) Evans,2016-09-29 10:25:31-05:00,['164fd9c6e1f6dd0925858ba3fce40859e547938d'],0,1,1,4244469,1,,,,3062
d88558237f37de87d81fad0be7d51042328c615e,0,Robert (Bobby) Evans,2016-09-29 10:41:16-05:00,"['337e83518fc182d280e738ca4ab38610eb23d475', 'e554e3c7135b2c7aed7529103ecfe6bd47d0fe1c']",41,0,41,4244510,3,,,,3062
5345496ce48f621adcec58acc1130e00c823801a,0,Abhishek Raj,2016-09-30 14:18:37+05:18,['f3e4dd3ffa818d575f531edde6045cdf9c21decb'],140,223,363,4244873,1,,,,3062
36e4d9c9578297d24d314ebcdcb09065bdf65614,0,Jungtaek Lim,2016-10-01 12:49:40+09:00,"['d88558237f37de87d81fad0be7d51042328c615e', 'f17f71ebd72c49892fbcd87106741f7e327ebae7']",4,251,255,4245128,5,,,,3062
47a2e70a89e08ba3bc92a55d81df5b85f1a01d42,0,Jungtaek Lim,2016-10-01 12:50:11+09:00,['36e4d9c9578297d24d314ebcdcb09065bdf65614'],0,1,1,4245129,1,,,,3062
665f11ebeb18d80788461b3ffe9d4931b713c1d6,0,Jungtaek Lim,2016-10-01 13:13:57+09:00,"['47a2e70a89e08ba3bc92a55d81df5b85f1a01d42', 'd7de92ced449737034d4451891c17721b408411e']",3,5,8,4245137,2,,,,3062
8f526554bbdad4bc040aebc7251b8b3eeff3c4ba,0,Jungtaek Lim,2016-10-01 13:14:37+09:00,['665f11ebeb18d80788461b3ffe9d4931b713c1d6'],0,1,1,4245138,1,,,,3062
efc1d4f90fad7adf2ca5ab42f14b025a8a16407e,0,Jungtaek Lim,2016-10-01 13:25:45+09:00,"['8f526554bbdad4bc040aebc7251b8b3eeff3c4ba', '788d0b6bfb12ed985fe84686ccab039d0a497def']",1,9,10,4245148,1,,,,3062
08d3a5b160f1a5853faa246c04a15553f458e68b,0,Jungtaek Lim,2016-10-01 13:32:09+09:00,['efc1d4f90fad7adf2ca5ab42f14b025a8a16407e'],0,1,1,4245149,1,,,,3062
1b73dc74ad7b1129a7e242be152ad25399ba0252,1,kamleshbhatt,2016-10-02 23:10:13+05:18,['dcd4de631cc3b4d5752da8e0246c658c9b0dca24'],3,9,12,4245161,2,,,,3062
d5762c8a5baac269fcb8134f9947b1dc91c3e5ac,0,kamleshbhatt,2016-10-02 23:13:23+05:18,['1b73dc74ad7b1129a7e242be152ad25399ba0252'],4,3,7,4245168,1,,,,3062
56222e883e215df7aa147a412a4d80d7591aaa16,0,Ravi Peri,2016-10-03 11:53:12-07:00,['362858c49919d2264606be06469f1da79fadc511'],115,119,234,4245402,1,,,,3062
49514b6e9265d0510ce61ba998a53000e0b2e57e,0,Kyle Nusbaum,2016-10-03 14:26:24-05:00,['08d3a5b160f1a5853faa246c04a15553f458e68b'],16,24,40,4245442,3,0,0,0,3062
5825e14a11c3d91c10036971e7757c8e4f82283d,0,Kyle Nusbaum,2016-10-03 14:30:08-05:00,['49514b6e9265d0510ce61ba998a53000e0b2e57e'],12,9,21,4245463,3,,,,3062
f930b9a7e5c6d86c5782a44f5154c81bff82d9d8,0,Kyle Nusbaum,2016-10-03 15:08:33-05:00,['5825e14a11c3d91c10036971e7757c8e4f82283d'],1,34,35,4245498,4,0.636363636,0.636363636,0.590909091,3062
4501052312f6f2d0ca174fa63e4596cf6acecb2f,0,Kyle Nusbaum,2016-10-04 14:22:49-05:00,['3b8472b615072a1c4f183816ef13dbff9b304e43'],9,8,17,4245515,1,,,,3062
8afe7b42f2e19f2b2eda991d2c343c2eeb4579b0,0,Kyle Nusbaum,2016-10-04 15:37:43-05:00,['08d3a5b160f1a5853faa246c04a15553f458e68b'],0,0,0,4245515,0,,,,3062
ad0f9ae81e27e3b27b7afc9b9e610804d1f06caa,0,Kyle Nusbaum,2016-10-04 15:56:31-05:00,['8afe7b42f2e19f2b2eda991d2c343c2eeb4579b0'],0,0,0,4245515,0,,,,3062
8969f0701fcaba550ca832e96c9742aa150ad17e,0,Kyle Nusbaum,2016-10-04 16:21:42-05:00,['ad0f9ae81e27e3b27b7afc9b9e610804d1f06caa'],0,0,0,4245515,0,,,,3062
d0a77306e5a2d2794182ef9885be5ff131f1836c,0,Kyle Nusbaum,2016-10-04 16:23:22-05:00,['8969f0701fcaba550ca832e96c9742aa150ad17e'],0,0,0,4245515,0,,,,3062
3ff10c9676797d1c71a3a31526eedc13fe03b9f0,0,Kyle Nusbaum,2016-10-04 16:25:37-05:00,['d0a77306e5a2d2794182ef9885be5ff131f1836c'],0,0,0,4245515,0,,,,3062
2676d4ffa77351c988edbf78397b9c649b8ed79d,0,Kyle Nusbaum,2016-10-04 16:52:59-05:00,['3ff10c9676797d1c71a3a31526eedc13fe03b9f0'],0,0,0,4245515,0,,,,3062
2f0c3dd47fd930118f31861d34fb49eb9a232bd9,0,Jungtaek Lim,2016-10-05 23:58:25+09:00,['3e56bd10df812d9c27a39ed94f3d22a3ecfffd52'],5,153,158,4245673,7,0.979591837,1,1,3064
a82f910a49cafb1a6b16ea3e6ae9ff9fc93ab4b0,0,P. Taylor Goetz,2016-10-05 12:59:38-04:00,"['2676d4ffa77351c988edbf78397b9c649b8ed79d', 'aab6acdf316c48bf566e37776790116f2794199b']",0,2630,2630,4248303,28,,,,3064
c116945a37d03c3cb85bd6bd85f6315f9353543e,0,P. Taylor Goetz,2016-10-05 13:14:17-04:00,['a82f910a49cafb1a6b16ea3e6ae9ff9fc93ab4b0'],82,57,139,4248442,2,,,,3064
4a2f50cfe2dc770eb1ff9b31276c6eceac12f8cd,1,P. Taylor Goetz,2016-10-05 14:05:08-04:00,['c116945a37d03c3cb85bd6bd85f6315f9353543e'],369,1813,2182,4250624,21,0.556836903,0.840197694,0.746293245,3081
5ede1ee7c00293e25372fddace43dce724a6657c,0,P. Taylor Goetz,2016-10-05 14:06:12-04:00,['4a2f50cfe2dc770eb1ff9b31276c6eceac12f8cd'],130,109,239,4250863,4,,,,3081
13f4b07f707d50c50abeac910bc0fd144e542070,0,P. Taylor Goetz,2016-10-05 14:06:56-04:00,['5ede1ee7c00293e25372fddace43dce724a6657c'],1622,1,1623,4252486,17,0.443163097,0.159802306,0.253706755,3081
6a57e1640bf7e1001e8ca2f7c1182a2f2a711e31,0,P. Taylor Goetz,2016-10-05 14:12:21-04:00,['13f4b07f707d50c50abeac910bc0fd144e542070'],500,495,995,4253481,6,,,,3081
96431b31c4b06dfb2e69b0828cd0e35bd5903eb4,0,P. Taylor Goetz,2016-10-05 14:26:28-04:00,['6a57e1640bf7e1001e8ca2f7c1182a2f2a711e31'],77,212,289,4253770,10,,,,3081
fd22d74317ab55426af2760478b2794a481db29b,0,P. Taylor Goetz,2016-10-05 16:34:46-04:00,['96431b31c4b06dfb2e69b0828cd0e35bd5903eb4'],0,170,170,4253940,5,,,,3085
668d4ab6a8d2c3a98674fefce44147be315e73d4,0,P. Taylor Goetz,2016-10-05 16:48:27-04:00,['fd22d74317ab55426af2760478b2794a481db29b'],0,21,21,4253961,1,,,,3085
74c4c3bd4aca60c8271903db870791c547c9cc8c,0,Kyle Nusbaum,2016-10-05 17:00:55-05:00,"['2676d4ffa77351c988edbf78397b9c649b8ed79d', '4501052312f6f2d0ca174fa63e4596cf6acecb2f']",151,286,437,4254398,14,,,,3085
06a7f54cbad746ebb71a22e38b53e33ad99f4906,0,Kyle Nusbaum,2016-10-05 17:13:33-05:00,['74c4c3bd4aca60c8271903db870791c547c9cc8c'],0,1,1,4254399,1,,,,3085
1ce0f639c53a8fd1d22a74ea78cfbdb15a81b90b,0,Kyle Nusbaum,2016-10-05 17:19:19-05:00,['f930b9a7e5c6d86c5782a44f5154c81bff82d9d8'],1,1,2,4254401,1,,,,3085
ce7ba756903e129157b232787b5eb42195b2ce98,0,P. Taylor Goetz,2016-10-06 11:07:24-04:00,"['668d4ab6a8d2c3a98674fefce44147be315e73d4', '06a7f54cbad746ebb71a22e38b53e33ad99f4906']",151,287,438,4254839,15,,,,3085
d4e943794458f8177a518b68eb2efe09d48d0c6d,1,Boyang Jerry Peng,2016-10-06 13:45:55-05:00,['ce7ba756903e129157b232787b5eb42195b2ce98'],254,472,726,4255565,6,0,0,0.85106383,3085
caf525e63cbb441267b0f7ad4ba51b48675e4fb2,0,Boyang Jerry Peng,2016-10-06 14:25:51-05:00,['d4e943794458f8177a518b68eb2efe09d48d0c6d'],713,1491,2204,4257769,3,0.036006547,0.399345336,1,3086
43478edbd7369047ccc417d6b81ab6a314910437,0,Jungtaek Lim,2016-10-07 13:44:39+09:00,['06a7f54cbad746ebb71a22e38b53e33ad99f4906'],5,1220,1225,4258994,3,,,,3087
459f5cea40d8004d4a4598f572d8e28ee7aed720,0,Robert (Bobby) Evans,2016-10-07 14:12:42-05:00,['d2ca97f3e96e382f33978893e2fad9a887933b76'],4,44,48,4259042,3,0.882352941,1,0,3087
df67ade7ef58707c3142853eb1010283e730d78f,0,Jungtaek Lim,2016-10-10 14:18:14+09:00,['ce7ba756903e129157b232787b5eb42195b2ce98'],0,1,1,4259043,1,1,1,1,3087
d4601692d0f230234a1d28992d53dffcb963407f,0,Jungtaek Lim,2016-10-10 20:48:54+09:00,['ce7ba756903e129157b232787b5eb42195b2ce98'],1,5,6,4259049,2,0.666666667,0.666666667,1,3087
0d616ba539a3e72b7c26fe74a7e8690f7b60a6e8,0,Boyang Jerry Peng,2016-10-10 14:19:38-05:00,['caf525e63cbb441267b0f7ad4ba51b48675e4fb2'],52,201,253,4259302,8,,,,3094
2d570b844f978fa82a28f8f4b507b2e5042b1deb,0,Kyle Nusbaum,2016-10-10 15:01:44-05:00,['1ce0f639c53a8fd1d22a74ea78cfbdb15a81b90b'],3,18,21,4259323,3,,,,3094
5884d55fd3f966a93b4c6b254b6bc698c9d8cef6,0,Jungtaek Lim,2016-10-11 11:38:57+09:00,['43478edbd7369047ccc417d6b81ab6a314910437'],0,372,372,4259695,1,,,,3095
320ac9d3a138f2dfd227d141fb2e16f355687c09,1,Satish Duggana,2016-10-11 15:29:16+05:18,['ce7ba756903e129157b232787b5eb42195b2ce98'],15,15,30,4259725,2,1,0,0,3095
5908b33b4f7104ccf6662936215204993005a4d5,0,Satish Duggana,2016-10-11 15:32:35+05:18,['320ac9d3a138f2dfd227d141fb2e16f355687c09'],0,1,1,4259726,1,,,,3095
f621cf2b05be59b7327f598450336e58250b8823,0,Boyang Jerry Peng,2016-10-11 10:16:00-05:00,['0d616ba539a3e72b7c26fe74a7e8690f7b60a6e8'],3,30,33,4259759,2,1,1,1,3095
4174c3f13c6477a1eef1084214cea680d7811423,0,Sriharsha Chintalapani,2016-10-11 08:45:35-07:00,"['5908b33b4f7104ccf6662936215204993005a4d5', '788256d641ae8220feb02451509c385d27079082']",94,399,493,4260252,15,,,,3095
f807a2115a558e2433274477faecdfb2313c3722,0,Sriharsha Chintalapani,2016-10-11 09:00:58-07:00,['4174c3f13c6477a1eef1084214cea680d7811423'],0,1,1,4260253,1,,,,3095
6ad10a36dd4148bfae2a638d8651f76994be4bc5,0,Kyle Nusbaum,2016-10-11 11:01:31-05:00,"['5908b33b4f7104ccf6662936215204993005a4d5', '2d570b844f978fa82a28f8f4b507b2e5042b1deb']",22,75,97,4260350,6,,,,3095
420e3f377f220bf218f67c90c503b0fa0536a06f,0,Kyle Nusbaum,2016-10-11 11:02:26-05:00,['6ad10a36dd4148bfae2a638d8651f76994be4bc5'],0,1,1,4260351,1,,,,3095
0a5a069c6223bdb1e7b9318f208c1b29cb302560,0,Sriharsha Chintalapani,2016-10-11 09:05:19-07:00,"['420e3f377f220bf218f67c90c503b0fa0536a06f', 'f807a2115a558e2433274477faecdfb2313c3722']",94,400,494,4260845,16,,,,3095
55402dba99cfe16d643d6465604033c827791af8,0,Jungtaek Lim,2016-10-12 06:12:36+09:00,"['0a5a069c6223bdb1e7b9318f208c1b29cb302560', 'e02af6e544d4ddab1af7047cb705bbe68f4d4cfb']",0,512,512,4261357,6,,,,3095
f9dd06669d32757d221431879a27fd66d51c955a,0,Jungtaek Lim,2016-10-12 06:13:03+09:00,['55402dba99cfe16d643d6465604033c827791af8'],0,1,1,4261358,1,,,,3095
d6eb0f9f5b53a4a4122b1101fad5a8e62a06a0d6,0,Jungtaek Lim,2016-10-12 06:20:12+09:00,"['f9dd06669d32757d221431879a27fd66d51c955a', '7c15b55a3403b45d83b83bbfe5a75756bfbc579f']",9,193,202,4261560,7,,,,3095
502dca194767b8c161c4e0d203856c540f85df89,0,Jungtaek Lim,2016-10-12 06:20:28+09:00,['d6eb0f9f5b53a4a4122b1101fad5a8e62a06a0d6'],0,1,1,4261561,1,,,,3095
996e6afb5202991f010a5ababcc1f63782dc5537,1,Jungtaek Lim,2016-10-12 06:57:21+09:00,['502dca194767b8c161c4e0d203856c540f85df89'],797,923,1720,4263281,23,1,1,1,3098
4633983d537f31b60f3b9f68cbdabc573c5d6746,0,Jungtaek Lim,2016-10-12 18:25:47+09:00,"['502dca194767b8c161c4e0d203856c540f85df89', '996e6afb5202991f010a5ababcc1f63782dc5537']",797,923,1720,4265001,23,,,,3098
6162ccdbaf549b168f7e77db82d960aae7bc3cb4,0,Jungtaek Lim,2016-10-12 18:26:07+09:00,['4633983d537f31b60f3b9f68cbdabc573c5d6746'],0,1,1,4265002,1,,,,3098
3a5ecf50f43d15ea07649de2d915dd25bed7fcf6,0,Jungtaek Lim,2016-10-12 21:49:11+09:00,"['6162ccdbaf549b168f7e77db82d960aae7bc3cb4', '5884d55fd3f966a93b4c6b254b6bc698c9d8cef6']",5,1592,1597,4266599,4,,,,3098
cbf7eda91df17a6e98c26d6c2ad191e69a54b238,0,Boyang Jerry Peng,2016-10-13 15:04:27-05:00,"['3a5ecf50f43d15ea07649de2d915dd25bed7fcf6', 'f621cf2b05be59b7327f598450336e58250b8823']",1018,2190,3208,4269807,17,,,,3098
b8c52026f4e947d371501bbac9ab78ea368adf97,0,Boyang Jerry Peng,2016-10-13 15:06:14-05:00,['cbf7eda91df17a6e98c26d6c2ad191e69a54b238'],0,1,1,4269808,1,,,,3098
aee1ebb5fdacc9635b5a7c7d02e089442b53f9ca,1,Hugo Picado,2016-10-13 21:51:58+01:00,['3a5ecf50f43d15ea07649de2d915dd25bed7fcf6'],1,1,2,4269810,1,,,,3098
5f45252c27a4bbf25d71c892574a5552786134d2,0,Hugo Picado,2016-10-14 09:32:04+01:00,"['aee1ebb5fdacc9635b5a7c7d02e089442b53f9ca', 'b8c52026f4e947d371501bbac9ab78ea368adf97']",1018,2191,3209,4273019,18,,,,3098
c8f7a531bb43e82146758a80ec1f1174d1f8ff3b,0,Ravi Peri,2016-10-17 10:49:08-07:00,['cd5c9e8f904205a6ca6eee9222ca954ca8b37ec3'],261,507,768,4273787,10,0.582417582,1,0.835164835,3100
a3ca828029502b80fa333ec86912688a591f7f3d,0,Ravi Peri,2016-10-17 10:50:09-07:00,"['c8f7a531bb43e82146758a80ec1f1174d1f8ff3b', '56222e883e215df7aa147a412a4d80d7591aaa16']",0,0,0,4273787,0,,,,3100
a3799d45e7e8dc0f22f20709dfed08d03f5d4cc9,0,Hugo Picado,2016-10-18 00:24:02+01:00,['5f45252c27a4bbf25d71c892574a5552786134d2'],1,1,2,4273789,1,,,,3100
e649e0e441bf1bccc8cd99db8331c94e7081d971,0,Jungtaek Lim,2016-10-18 13:24:09+09:00,"['b8c52026f4e947d371501bbac9ab78ea368adf97', 'df67ade7ef58707c3142853eb1010283e730d78f']",0,1,1,4273790,1,,,,3100
74c31164d5ad9beb51459523e663d054f06b7048,0,Jungtaek Lim,2016-10-18 13:24:32+09:00,['e649e0e441bf1bccc8cd99db8331c94e7081d971'],0,1,1,4273791,1,,,,3100
8635dcfe246cd4fcdd1dfceed8111ed5640f4406,0,Kyle Nusbaum,2016-10-18 10:37:57-05:00,"['74c31164d5ad9beb51459523e663d054f06b7048', '3fb327a87c1c3060f96bd8b262e8526d8c1f3848']",1,1,2,4273793,1,,,,3100
b2e7388d622bac6042c7617f2232b9802e83daa5,0,Kyle Nusbaum,2016-10-18 10:38:38-05:00,['8635dcfe246cd4fcdd1dfceed8111ed5640f4406'],0,1,1,4273794,1,,,,3100
e3f001e05463fd78a7ef02b9ae351c73cf925408,0,Sriharsha Chintalapani,2016-10-18 13:12:30-07:00,"['b2e7388d622bac6042c7617f2232b9802e83daa5', 'a3ca828029502b80fa333ec86912688a591f7f3d']",261,507,768,4274562,10,,,,3100
f05e37ea4684d49297fc08ef6d27ee681e8b3eb2,0,Sriharsha Chintalapani,2016-10-18 13:13:07-07:00,['e3f001e05463fd78a7ef02b9ae351c73cf925408'],0,1,1,4274563,1,,,,3100
7cd3f22313713abdda09e01618393b7759a05ed0,0,Tibor Kiss,2016-10-21 07:19:49+02:00,['f05e37ea4684d49297fc08ef6d27ee681e8b3eb2'],0,2,2,4274565,1,0,1,1,3100
a3d1389edaa1c92948a629922cafdecf1410b3ad,1,kamleshbhatt,2016-10-21 22:37:01+05:18,['d5762c8a5baac269fcb8134f9947b1dc91c3e5ac'],1,1,2,4274567,1,,,,3100
b8b890e2446ae2f8cde6f50e4546aab7a77e9943,0,kamleshbhatt,2016-10-21 22:57:43+05:18,"['a3d1389edaa1c92948a629922cafdecf1410b3ad', 'f05e37ea4684d49297fc08ef6d27ee681e8b3eb2']",8621,23788,32409,4306976,392,,,,3100
da42ba103f66dba0759886251371d013ae2d386b,0,Jungtaek Lim,2016-10-26 00:23:09+09:00,"['f05e37ea4684d49297fc08ef6d27ee681e8b3eb2', '2f0c3dd47fd930118f31861d34fb49eb9a232bd9']",5,153,158,4307134,7,,,,3100
1daeb977ca552b33a96ee93cdf8b399a67ec4ebd,0,Jungtaek Lim,2016-10-26 00:23:33+09:00,['da42ba103f66dba0759886251371d013ae2d386b'],0,1,1,4307135,1,,,,3100
0a18ef21fe6fc4c6da37c7048e1c2f68bcb31bf5,0,Jungtaek Lim,2016-10-26 00:33:14+09:00,"['1daeb977ca552b33a96ee93cdf8b399a67ec4ebd', 'd4601692d0f230234a1d28992d53dffcb963407f']",1,5,6,4307141,2,,,,3100
0c600196fa622b427d3994580ce95cffc7995866,0,Jungtaek Lim,2016-10-26 00:37:11+09:00,['0a18ef21fe6fc4c6da37c7048e1c2f68bcb31bf5'],0,1,1,4307142,1,,,,3100
c1ed4db92ef3181630ec49197320e5c1300f9281,0,Robert (Bobby) Evans,2016-10-25 13:26:44-05:00,"['0c600196fa622b427d3994580ce95cffc7995866', 'b8b890e2446ae2f8cde6f50e4546aab7a77e9943']",4,161,165,4307307,4,,,,3100
4da5f7b0b1f208aa274cdd4f97d7e8b889f0d225,0,Robert (Bobby) Evans,2016-10-25 13:27:47-05:00,['c1ed4db92ef3181630ec49197320e5c1300f9281'],0,1,1,4307308,1,,,,3100
8c1e8af9253202c4218f2ca49418e5d5fde43be7,0,Robert (Bobby) Evans,2016-10-25 14:46:44-05:00,['459f5cea40d8004d4a4598f572d8e28ee7aed720'],0,28,28,4307336,1,,,,3100
e0d861f2054e25a9b49178d5f57bd37ae648766f,0,Robert (Bobby) Evans,2016-10-25 15:52:07-05:00,"['4da5f7b0b1f208aa274cdd4f97d7e8b889f0d225', '7cd3f22313713abdda09e01618393b7759a05ed0']",0,2,2,4307338,1,,,,3100
4ae17b8a4846b0c19a0f231e53ee399f55e32634,0,Robert (Bobby) Evans,2016-10-25 16:20:32-05:00,['e0d861f2054e25a9b49178d5f57bd37ae648766f'],0,3,3,4307341,1,,,,3100
c75fc8521546ebe22d9a0832165976a7b069aefc,0,Jungtaek Lim,2016-10-27 09:08:10+09:00,"['4ae17b8a4846b0c19a0f231e53ee399f55e32634', '8c1e8af9253202c4218f2ca49418e5d5fde43be7']",4,72,76,4307417,4,,,,3100
793d3adb0ed61d4b45aaeac132cb50af25210659,0,Jungtaek Lim,2016-10-27 09:08:38+09:00,['c75fc8521546ebe22d9a0832165976a7b069aefc'],0,1,1,4307418,1,,,,3100
891134926d4e223fa1140c0ebef1613deb2e3c18,0,Jungtaek Lim,2016-10-28 01:10:42+09:00,['793d3adb0ed61d4b45aaeac132cb50af25210659'],0,5,5,4307423,1,,,,3100
2c9ce5c6e6a6c16daec93d1b3ef526b4dc6ed560,1,vesense,2016-10-28 17:51:24+08:00,['793d3adb0ed61d4b45aaeac132cb50af25210659'],95,452,547,4307970,17,1,1,0.947368421,3105
94d61c7f3dbc4e1b6dd61cfcbb569027f35bf570,0,Robert (Bobby) Evans,2016-10-28 15:47:38-05:00,['891134926d4e223fa1140c0ebef1613deb2e3c18'],9,24,33,4308003,3,0,1,1,3105
76d6e7e5249fe564dee1a3b92b9d9799cb50ef4c,1,Hugo Louro,2016-10-29 13:13:55-07:00,['891134926d4e223fa1140c0ebef1613deb2e3c18'],5,915,920,4308923,17,0.865951743,0.927613941,0.887399464,3115
67178e00b1ef9b07367728bef2632009762d9b0c,1,vesense,2016-10-31 09:15:23+08:00,['891134926d4e223fa1140c0ebef1613deb2e3c18'],22,371,393,4309316,9,0.243902439,0.756097561,0.593495935,3120
f9fb20696b4e6e9dd7419b291087123c65cbd35c,1,Abhishek Agarwal,2016-10-31 13:38:06+05:18,['891134926d4e223fa1140c0ebef1613deb2e3c18'],939,1524,2463,4311779,24,0.465171192,0.584415584,0.85596222,3125
9747e5f2f8072ba82b27c9fb96993270c114e034,1,Robert (Bobby) Evans,2016-10-31 11:13:25-05:00,['94d61c7f3dbc4e1b6dd61cfcbb569027f35bf570'],10,22,32,4311811,1,0,0,1,3125
2d1785b3bb47c103906a24a40cc1a3b4ffcd70fc,0,vesense,2016-11-01 10:37:58+08:00,['67178e00b1ef9b07367728bef2632009762d9b0c'],5,216,221,4312032,7,0.597014925,1,0.910447761,3129
b635b0c8ad6437e1a2c265f3d0d3960ef9771747,0,Erik Weathers,2016-10-31 23:20:41-07:00,['891134926d4e223fa1140c0ebef1613deb2e3c18'],2,2,4,4312036,1,,,,3129
d165464b1b3e6c58f37a6632689cf3a3eb80c196,0,vesense,2016-11-01 19:26:22+08:00,['2d1785b3bb47c103906a24a40cc1a3b4ffcd70fc'],1,196,197,4312233,5,0.888888889,0.037037037,0.888888889,3132
3e071954d0b2c129354b1e64efde6bdef2167da9,1,Robert (Bobby) Evans,2016-11-01 10:27:11-05:00,['9747e5f2f8072ba82b27c9fb96993270c114e034'],7,7,14,4312247,5,,,,3132
3a389e93aeeadd28e0409584e8a14bd56a7b8f52,1,Robert (Bobby) Evans,2016-11-01 10:59:07-05:00,['3e071954d0b2c129354b1e64efde6bdef2167da9'],14,54,68,4312315,6,0,0,1,3133
4d22a68abb94a0f2a4bcd5cdc4d512ae0a9a0590,1,Hugo Louro,2016-11-01 10:10:04-07:00,['76d6e7e5249fe564dee1a3b92b9d9799cb50ef4c'],460,727,1187,4313502,14,0.375,0.375,0.696428571,3139
ad599b48b71db3125e9bd61d75b7b6dec5f499d3,0,vesense,2016-11-02 10:28:19+08:00,['67178e00b1ef9b07367728bef2632009762d9b0c'],15,27,42,4313544,3,1,0,1,3139
f14e0b21666e009f3138c228d9ea0727488a895f,0,vesense,2016-11-02 16:06:19+08:00,['d165464b1b3e6c58f37a6632689cf3a3eb80c196'],17,25,42,4313586,7,0.714285714,0.714285714,0.714285714,3139
0d5c8bff13a4339e410af8eab09d27833d5a709c,0,Jungtaek Lim,2016-11-03 08:48:58+09:00,['891134926d4e223fa1140c0ebef1613deb2e3c18'],0,1,1,4313587,1,,,,3139
af264600b6055844eb4b8aa9f9acd929d3a72fde,0,Jungtaek Lim,2016-11-03 09:03:41+09:00,"['0d5c8bff13a4339e410af8eab09d27833d5a709c', '3a389e93aeeadd28e0409584e8a14bd56a7b8f52']",28,95,123,4313710,9,,,,3139
99a11cb2890b273520cd29cffb5806f5111abeb6,0,Jungtaek Lim,2016-11-03 09:07:16+09:00,['af264600b6055844eb4b8aa9f9acd929d3a72fde'],0,1,1,4313711,1,,,,3139
02d290be8ac212d63450248d9d6cb9e656befd2b,0,Abhishek Agarwal,2016-11-03 12:20:01+05:18,['f9fb20696b4e6e9dd7419b291087123c65cbd35c'],384,355,739,4314450,13,0.146551724,0.810344828,0.853448276,3140
f7b8cda6f678b894f924ab6a8ad3b37815d63083,0,Abhishek Agarwal,2016-11-03 12:45:06+05:18,"['02d290be8ac212d63450248d9d6cb9e656befd2b', '99a11cb2890b273520cd29cffb5806f5111abeb6']",112,151,263,4314713,16,,,,3140
71bcd88d617a0f5ff74fd854d259ac73a3d6a5ea,0,Robert (Bobby) Evans,2016-11-03 10:34:26-05:00,"['99a11cb2890b273520cd29cffb5806f5111abeb6', 'b635b0c8ad6437e1a2c265f3d0d3960ef9771747']",2,2,4,4314717,1,,,,3140
b0b7ea95bb127dbfd07bb77b746d45374eef4768,0,Robert (Bobby) Evans,2016-11-03 11:33:16-05:00,"['71bcd88d617a0f5ff74fd854d259ac73a3d6a5ea', 'a3799d45e7e8dc0f22f20709dfed08d03f5d4cc9']",1,1,2,4314719,1,,,,3140
e5e06408de03bf21e6cf8bc2441198dce504b250,0,Robert (Bobby) Evans,2016-11-03 11:34:35-05:00,['b0b7ea95bb127dbfd07bb77b746d45374eef4768'],0,1,1,4314720,1,,,,3140
10b9df27c51e6c1bef8f519758d7a9f8d69659c5,0,Stig Rohde D酶ssing,2016-11-03 19:08:50+01:00,['891134926d4e223fa1140c0ebef1613deb2e3c18'],1,0,1,4314721,1,0,0,0,3140
43bdc03066c850202970ce48d16f354be14c1a50,0,Robert (Bobby) Evans,2016-11-03 13:48:37-05:00,"['e5e06408de03bf21e6cf8bc2441198dce504b250', '5345496ce48f621adcec58acc1130e00c823801a']",140,223,363,4315084,1,,,,3140
11fcaff0e3f807419db2609bab07e0efb47f8df2,1,Stig Rohde D酶ssing,2016-11-04 16:22:22+01:00,['43bdc03066c850202970ce48d16f354be14c1a50'],17,427,444,4315528,9,0.755244755,0.979020979,0.699300699,3146
be91989b00c1ab4e93719d84b2e90d18ac8b7bed,0,Jungtaek Lim,2016-11-05 10:49:26+09:00,"['43bdc03066c850202970ce48d16f354be14c1a50', '2c9ce5c6e6a6c16daec93d1b3ef526b4dc6ed560']",95,452,547,4316075,17,,,,3146
32c83d8c614b6f1589d628825e69d037cd441321,0,Jungtaek Lim,2016-11-05 10:50:22+09:00,['be91989b00c1ab4e93719d84b2e90d18ac8b7bed'],0,1,1,4316076,1,,,,3146
dbc95a09ad59f0d9ad7a2c8290e743e46bcbbe0f,1,Xin Wang,2016-11-05 16:32:47+08:00,"['ad599b48b71db3125e9bd61d75b7b6dec5f499d3', '32c83d8c614b6f1589d628825e69d037cd441321']",274,786,1060,4317136,30,,,,3146
6ce3a60cacc9f09391d0f654534d1039d48cf2f9,0,Stig Rohde D酶ssing,2016-11-05 16:40:49+01:00,['32c83d8c614b6f1589d628825e69d037cd441321'],1,4,5,4317141,2,0,0,1,3146
3fe3de7d5a256dcb93435fbae8552558f667e346,0,Xin Wang,2016-11-06 09:32:46+08:00,['dbc95a09ad59f0d9ad7a2c8290e743e46bcbbe0f'],25,61,86,4317227,4,1,1,1,3146
7f0479fba3c7c97288a8cadc856cfd1dfda3ca4a,0,GitHub,2016-11-07 11:03:05+08:00,['32c83d8c614b6f1589d628825e69d037cd441321'],1,1,2,4317229,1,,,,3146
6749a5c1e64f04f3d48fc0ff676b72fada216fa8,0,vesense,2016-11-07 17:10:53+08:00,['3fe3de7d5a256dcb93435fbae8552558f667e346'],49,5,54,4317283,3,1,0,0,3146
bf4f7be2127b1e774ef227ebac72e9743a87d363,0,Jungtaek Lim,2016-11-07 22:45:36+09:00,"['32c83d8c614b6f1589d628825e69d037cd441321', '6ce3a60cacc9f09391d0f654534d1039d48cf2f9']",1,4,5,4317288,2,,,,3146
e8d681b515bca175ab9388cf83ad80e0bc9dd42b,0,Jungtaek Lim,2016-11-07 22:46:54+09:00,['bf4f7be2127b1e774ef227ebac72e9743a87d363'],0,1,1,4317289,1,,,,3146
5f5a482b4be316719be2334cf2ca30b2a0fc6049,0,Jungtaek Lim,2016-11-07 22:49:30+09:00,['e8d681b515bca175ab9388cf83ad80e0bc9dd42b'],1,8,9,4317298,1,0,1,0,3146
2c95f34ac717f51fa30a1703f79a6c5d95f878ed,0,Jungtaek Lim,2016-11-07 22:50:27+09:00,"['e8d681b515bca175ab9388cf83ad80e0bc9dd42b', '5f5a482b4be316719be2334cf2ca30b2a0fc6049']",1,8,9,4317307,1,,,,3146
5e0ece3531e269de0106887ed56e6c6f6d17e731,0,Jungtaek Lim,2016-11-07 22:51:16+09:00,['2c95f34ac717f51fa30a1703f79a6c5d95f878ed'],0,1,1,4317308,1,,,,3146
acd6f8c7f9b9d7363146893042a9911f37922c51,0,Jungtaek Lim,2016-11-07 23:12:26+09:00,"['5e0ece3531e269de0106887ed56e6c6f6d17e731', '10b9df27c51e6c1bef8f519758d7a9f8d69659c5']",1,0,1,4317309,1,,,,3146
6dc6407a01d032483edebb1c1b4d8b69a304d81c,0,Jungtaek Lim,2016-11-07 23:15:50+09:00,['acd6f8c7f9b9d7363146893042a9911f37922c51'],0,1,1,4317310,1,,,,3146
4efb0e66ef3088d0122a3511b55aa533f2e89cbd,0,Thomas Graves,2016-11-08 19:28:56+00:00,['6dc6407a01d032483edebb1c1b4d8b69a304d81c'],0,280,280,4317590,2,0.329268293,0.87195122,0.87195122,3148
a0b46a9240d4604925904cbaccb6dcf7b34e0ec4,0,Jungtaek Lim,2016-11-09 09:33:17+09:00,"['6dc6407a01d032483edebb1c1b4d8b69a304d81c', '7f0479fba3c7c97288a8cadc856cfd1dfda3ca4a']",1,1,2,4317592,1,,,,3148
6bdad214ecba344548e63d1f34fa7b8f0b88640f,0,Jungtaek Lim,2016-11-09 09:34:00+09:00,['a0b46a9240d4604925904cbaccb6dcf7b34e0ec4'],0,1,1,4317593,1,,,,3148
c09081bfc5b4ee7affff452bdf5d17ea778ed9a9,0,vesense,2016-11-09 11:30:00+08:00,['6749a5c1e64f04f3d48fc0ff676b72fada216fa8'],22,16,38,4317631,1,1,0,1,3148
afb029194d94d3a0628d5c87236a75751d6e9398,0,Thomas Graves,2016-11-09 15:41:00+00:00,['4efb0e66ef3088d0122a3511b55aa533f2e89cbd'],0,17,17,4317648,1,,,,3148
eaa415a10a2d51aa87651c1adf7f68f2f0ac75de,1,Kyle Nusbaum,2016-11-09 14:17:35-06:00,['6bdad214ecba344548e63d1f34fa7b8f0b88640f'],198,91,289,4317937,3,0.987654321,0.62962963,0.641975309,3148
3a5052f4368ea66533c449ad5f1fddddfd0a0f52,0,Kyle Nusbaum,2016-11-09 14:30:16-06:00,['eaa415a10a2d51aa87651c1adf7f68f2f0ac75de'],10,0,10,4317947,1,,,,3148
9d7c3cd5fa6815649e7318cc400cc4640441872e,0,Satish Duggana,2016-11-10 09:34:03+05:18,['6bdad214ecba344548e63d1f34fa7b8f0b88640f'],3,10,13,4317960,1,0,0,1,3148
2bae6789a47b2cb848c844a8a3e552df8e65f97d,0,GitHub,2016-11-10 12:48:26+08:00,['6bdad214ecba344548e63d1f34fa7b8f0b88640f'],1,1,2,4317962,1,,,,3148
c7129611f8e6504ad3835fa5656d40225c9b4ba5,1,GitHub,2016-11-11 14:43:14+08:00,['6dc6407a01d032483edebb1c1b4d8b69a304d81c'],8,17,25,4317987,1,1,1,1,3148
c42fcc1124892f603bbe58fccb151146e0dc3cb3,0,Satish Duggana,2016-11-11 15:28:11+05:18,['9d7c3cd5fa6815649e7318cc400cc4640441872e'],0,1,1,4317988,1,,,,3148
4e5b2eac995e15791182f8db0a36e6b8e05eadfb,0,Xin Wang,2016-11-11 21:29:48+08:00,['c09081bfc5b4ee7affff452bdf5d17ea778ed9a9'],4,51,55,4318043,3,0,1,1,3149
3eca861aceddf01e71d2fbecf53a9cd446b72cd6,0,Jungtaek Lim,2016-11-11 22:32:30+09:00,"['c42fcc1124892f603bbe58fccb151146e0dc3cb3', '4e5b2eac995e15791182f8db0a36e6b8e05eadfb']",34,429,463,4318506,11,,,,3149
f357d84faf635005849692550e55ffa717839c3b,0,Jungtaek Lim,2016-11-11 23:14:37+09:00,['3eca861aceddf01e71d2fbecf53a9cd446b72cd6'],0,1,1,4318507,1,,,,3149
7c1aff5c17b0154a44eb165dafd9e5d1191a823f,0,Xin Wang,2016-11-12 11:02:49+08:00,"['f14e0b21666e009f3138c228d9ea0727488a895f', 'f357d84faf635005849692550e55ffa717839c3b']",356,936,1292,4319799,45,,,,3149
068e06959cf2992598a8db9c55b9ccfd4e84f818,0,Jungtaek Lim,2016-11-14 11:18:57+09:00,"['f357d84faf635005849692550e55ffa717839c3b', '2bae6789a47b2cb848c844a8a3e552df8e65f97d']",1,1,2,4319801,1,,,,3149
bf086cfcf2b2a5a77075c1a7eb7c99f34d3bae45,0,Jungtaek Lim,2016-11-14 11:20:25+09:00,['f357d84faf635005849692550e55ffa717839c3b'],0,1,1,4319802,1,,,,3149
b3356de9bc2c74e52a28cc648a94941f4c004bcb,0,Jungtaek Lim,2016-11-14 11:26:11+09:00,"['bf086cfcf2b2a5a77075c1a7eb7c99f34d3bae45', '068e06959cf2992598a8db9c55b9ccfd4e84f818']",1,1,2,4319804,1,,,,3149
424f65b484ff0de8c9ff79859f0d7997e8310248,0,GitHub,2016-11-14 13:04:22+08:00,['7c1aff5c17b0154a44eb165dafd9e5d1191a823f'],2,2,4,4319808,1,,,,3149
ace68fd9e80db85ce8335f936143cc969cb93ee5,0,Jungtaek Lim,2016-11-14 19:02:57+09:00,"['b3356de9bc2c74e52a28cc648a94941f4c004bcb', '424f65b484ff0de8c9ff79859f0d7997e8310248']",0,415,415,4320223,9,,,,3149
a5220283c968bdce1ec669f808ed5442ca7e851a,0,Jungtaek Lim,2016-11-14 21:25:48+09:00,['ace68fd9e80db85ce8335f936143cc969cb93ee5'],0,2,2,4320225,1,,,,3149
d636ae151d6ce556bb604d431362970b2c1a559e,0,Jungtaek Lim,2016-11-14 21:51:51+09:00,['a5220283c968bdce1ec669f808ed5442ca7e851a'],1,1,2,4320227,1,,,,3149
6d6bdb9b66efcb1cee80c2ed1ad70ef0918c166f,0,Robert (Bobby) Evans,2016-11-14 15:25:19-06:00,"['d636ae151d6ce556bb604d431362970b2c1a559e', 'f7b8cda6f678b894f924ab6a8ad3b37815d63083']",1176,1702,2878,4323105,25,,,,3149
71f8e864fcbfb5d1073ca42f4d5a6acb94928eed,1,Jeff Fenchel,2016-11-14 14:12:17-08:00,['ef94566bcc66fcb5ff0db21c32f3a2f3999d7aa6'],10,411,421,4323526,5,0.478947368,1,1,3152
1c1029fb9298288e2c346651a806d2eb614b57eb,0,Robert (Bobby) Evans,2016-11-14 16:17:48-06:00,['6d6bdb9b66efcb1cee80c2ed1ad70ef0918c166f'],99,117,216,4323742,8,0.2,0.2,1,3152
f98dd1889467433226721bbab09037041c5c8f1a,0,Sriharsha Chintalapani,2016-11-14 22:09:59-08:00,"['d636ae151d6ce556bb604d431362970b2c1a559e', '4d22a68abb94a0f2a4bcd5cdc4d512ae0a9a0590']",318,1495,1813,4325555,26,,,,3152
397a131dd8ac835931d7599b272bb669f6443252,0,Sriharsha Chintalapani,2016-11-14 22:22:32-08:00,['f98dd1889467433226721bbab09037041c5c8f1a'],0,2,2,4325557,1,,,,3152
957fcabb6467f502e93524098391380fbf5cba77,0,Jungtaek Lim,2016-11-15 17:56:11+09:00,['d636ae151d6ce556bb604d431362970b2c1a559e'],1,110,111,4325668,1,,,,3152
aa49508b052661a7bdc32b96a961fbc70726a7cc,0,Kyle Nusbaum,2016-11-15 12:30:46-06:00,"['397a131dd8ac835931d7599b272bb669f6443252', 'afb029194d94d3a0628d5c87236a75751d6e9398']",0,297,297,4325965,2,,,,3152
69eee312903f74d8dad287f97fc7227399c58f76,0,Kyle Nusbaum,2016-11-15 12:32:04-06:00,['aa49508b052661a7bdc32b96a961fbc70726a7cc'],0,1,1,4325966,1,,,,3152
0606977d2a7ffe8ea85da12ed9ac80fe1157f799,0,Jungtaek Lim,2016-11-16 15:56:14+09:00,"['69eee312903f74d8dad287f97fc7227399c58f76', '1c1029fb9298288e2c346651a806d2eb614b57eb']",1246,1790,3036,4329002,27,,,,3152
9fb0e205d6ba2ce158188c21f78f32fdb4aa1ec2,0,Jungtaek Lim,2016-11-16 15:56:31+09:00,['0606977d2a7ffe8ea85da12ed9ac80fe1157f799'],0,1,1,4329003,1,,,,3152
9a50567328c5ac9d1ba781c72205eb83b3ea7674,0,Jungtaek Lim,2016-11-16 20:29:43+09:00,"['9fb0e205d6ba2ce158188c21f78f32fdb4aa1ec2', 'c7129611f8e6504ad3835fa5656d40225c9b4ba5']",8,17,25,4329028,1,,,,3152
8c449dc7154464b73ae92adb06185e4eb68f8f54,0,Jungtaek Lim,2016-11-16 20:33:38+09:00,['9a50567328c5ac9d1ba781c72205eb83b3ea7674'],0,1,1,4329029,1,,,,3152
5bcbb8d6d700d0d238d23f8f6d3976667aaedab9,0,Sriharsha Chintalapani,2016-11-18 18:24:59-08:00,"['8c449dc7154464b73ae92adb06185e4eb68f8f54', '71f8e864fcbfb5d1073ca42f4d5a6acb94928eed']",10,411,421,4329450,5,,,,3152
a912cf3fa90338d8a6f7d5ac386272c5de93c448,0,Sriharsha Chintalapani,2016-11-18 18:26:46-08:00,['5bcbb8d6d700d0d238d23f8f6d3976667aaedab9'],0,1,1,4329451,1,,,,3152
71af6701d933c444d0de9cee1e614b46f4fb5f8d,0,Satish Duggana,2016-11-20 09:34:56+05:18,['a912cf3fa90338d8a6f7d5ac386272c5de93c448'],2,6,8,4329459,1,1,1,1,3152
8705605c46da22bae0af6fff3a6f9caf84339bb3,1,Xin Wang,2016-11-20 13:49:29+08:00,['a912cf3fa90338d8a6f7d5ac386272c5de93c448'],71,505,576,4330035,8,,,,3156
bd1f5c54752f67b484a83c26667331234234d3a3,0,Stig Rohde D酶ssing,2016-11-20 13:01:22+01:00,"['11fcaff0e3f807419db2609bab07e0efb47f8df2', 'a912cf3fa90338d8a6f7d5ac386272c5de93c448']",1725,5227,6952,4336987,98,,,,3156
d53615369b03a03362c629d9b3dc5fabfccf50ac,0,Satish Duggana,2016-11-20 17:25:56+05:18,['71af6701d933c444d0de9cee1e614b46f4fb5f8d'],0,1,1,4336988,1,,,,3156
6fda4a48f9eb89f843b57a6d132f70a77d37fb14,0,Robert (Bobby) Evans,2016-11-21 12:54:20-06:00,"['d53615369b03a03362c629d9b3dc5fabfccf50ac', '3a5052f4368ea66533c449ad5f1fddddfd0a0f52']",198,81,279,4337267,3,,,,3156
ea676940c67f5b5176e74e86d83a0055ce52a498,0,Robert (Bobby) Evans,2016-11-21 12:54:57-06:00,['6fda4a48f9eb89f843b57a6d132f70a77d37fb14'],0,1,1,4337268,1,,,,3156
b7c9d926690486fba2ce1a8ba6248d8d0aa76b1c,0,Hugo Louro,2016-11-21 13:24:10-08:00,['a912cf3fa90338d8a6f7d5ac386272c5de93c448'],19,12,31,4337299,1,1,0,0,3156
a23a6ad5dc2b673aceb8344b81ea9d3a0403eb74,0,Jungtaek Lim,2016-11-22 18:04:24+09:00,['ea676940c67f5b5176e74e86d83a0055ce52a498'],0,1,1,4337300,1,1,1,1,3156
81b601dd5589a313f26e9b5b4961eb1578cd821e,0,Robert (Bobby) Evans,2016-11-22 10:27:35-06:00,['ea676940c67f5b5176e74e86d83a0055ce52a498'],11,63,74,4337374,1,0.236842105,0.710526316,0.710526316,3156
ccd5107649bb289e18a51b0ce1ceab4b70b82dd0,0,Hugo Louro,2016-11-22 08:37:16-08:00,['ea676940c67f5b5176e74e86d83a0055ce52a498'],79,9,88,4337462,22,,,,3156
1e30adc5ff63f184226e8dfaf6002cbb87208377,0,Robert (Bobby) Evans,2016-11-22 12:22:56-06:00,['ea676940c67f5b5176e74e86d83a0055ce52a498'],2,2,4,4337466,2,,,,3156
d41704eb5b9fb2dd2eb2d34488ca00a2e25182c5,1,Robert (Bobby) Evans,2016-11-22 15:04:14-06:00,['ea676940c67f5b5176e74e86d83a0055ce52a498'],50,94,144,4337610,18,0,0.513513514,0.756756757,3156
cdbaba2defa7ff5882ed52df8e96cdd94867524c,0,GitHub,2016-11-23 16:29:44+08:00,['8705605c46da22bae0af6fff3a6f9caf84339bb3'],0,1,1,4337611,1,,,,3156
69de52aa06ebdcb47a994f945c15f6a8aa429adc,0,Kevin Peek,2016-11-23 08:18:26-05:00,['d53615369b03a03362c629d9b3dc5fabfccf50ac'],7,152,159,4337770,2,0,0.31884058,1,3157
0cc0e4e83c8f5ab742edfb30d8d83e7cf5e73a17,0,Robert (Bobby) Evans,2016-11-23 13:34:16-06:00,"['ea676940c67f5b5176e74e86d83a0055ce52a498', '69de52aa06ebdcb47a994f945c15f6a8aa429adc']",7,152,159,4337929,2,,,,3157
10c85726a299cd3927334b7b7dc4ef7d0261874f,0,Robert (Bobby) Evans,2016-11-23 13:37:56-06:00,['0cc0e4e83c8f5ab742edfb30d8d83e7cf5e73a17'],0,1,1,4337930,1,,,,3157
aeb9d2f81c819b06cc8581d4ddf90a469315502b,0,Robert (Bobby) Evans,2016-11-23 13:44:39-06:00,"['10c85726a299cd3927334b7b7dc4ef7d0261874f', 'ccd5107649bb289e18a51b0ce1ceab4b70b82dd0']",79,9,88,4338018,22,,,,3157
ecb3fd8961c280327f522422037a56ac9f49c400,0,Robert (Bobby) Evans,2016-11-23 14:09:05-06:00,['aeb9d2f81c819b06cc8581d4ddf90a469315502b'],0,1,1,4338019,1,,,,3157
f7b62c363f5a323c76c9996a0d5728d97b868837,0,Robert (Bobby) Evans,2016-11-23 14:11:47-06:00,"['ecb3fd8961c280327f522422037a56ac9f49c400', 'cdbaba2defa7ff5882ed52df8e96cdd94867524c']",71,506,577,4338596,8,,,,3157
33c155f7f385154e95a0fb17ec06940653b98e8e,0,Robert (Bobby) Evans,2016-11-23 14:12:32-06:00,['f7b62c363f5a323c76c9996a0d5728d97b868837'],0,1,1,4338597,1,,,,3157
49c61fde7068a146c08c53b9ab7053ac3ac1ecb5,0,Jungtaek Lim,2016-11-25 00:12:53+09:00,"['33c155f7f385154e95a0fb17ec06940653b98e8e', 'a23a6ad5dc2b673aceb8344b81ea9d3a0403eb74']",0,1,1,4338598,1,,,,3157
286a9ceb26d527579a6e59bf79e6a9da3db6624a,0,Jungtaek Lim,2016-11-25 00:13:25+09:00,['49c61fde7068a146c08c53b9ab7053ac3ac1ecb5'],0,1,1,4338599,1,,,,3157
6de1f0d138d7dc5988920517132a23213f278642,0,Jungtaek Lim,2016-11-25 00:30:30+09:00,"['286a9ceb26d527579a6e59bf79e6a9da3db6624a', 'b7c9d926690486fba2ce1a8ba6248d8d0aa76b1c']",19,12,31,4338630,1,,,,3157
89311db733dc2539657e8398cd3421233179f28e,0,Jungtaek Lim,2016-11-25 00:31:14+09:00,['6de1f0d138d7dc5988920517132a23213f278642'],0,1,1,4338631,1,,,,3157
983227f9a44051b8ad14ec4b58d852841c6b5a31,0,Jungtaek Lim,2016-11-25 00:40:41+09:00,"['89311db733dc2539657e8398cd3421233179f28e', 'd41704eb5b9fb2dd2eb2d34488ca00a2e25182c5']",50,94,144,4338775,18,,,,3157
73bdbca0f100924d4fee16a25039a2f74c85f9c5,0,Jungtaek Lim,2016-11-25 10:20:27+09:00,['983227f9a44051b8ad14ec4b58d852841c6b5a31'],0,1,1,4338776,1,,,,3157
5f71a2de219b671f442528fe96a27408e10c2fc5,0,Jungtaek Lim,2016-11-25 10:58:08+09:00,"['73bdbca0f100924d4fee16a25039a2f74c85f9c5', '1e30adc5ff63f184226e8dfaf6002cbb87208377']",2,2,4,4338780,2,,,,3157
e6d667cc7dc25fff9ab4e52b9fb4f565d7890c49,0,Jungtaek Lim,2016-11-25 10:58:28+09:00,['5f71a2de219b671f442528fe96a27408e10c2fc5'],0,1,1,4338781,1,,,,3157
57998b4d7f71efd751476deb19bacac8f29f4645,0,Jungtaek Lim,2016-11-25 11:45:06+09:00,"['e6d667cc7dc25fff9ab4e52b9fb4f565d7890c49', '957fcabb6467f502e93524098391380fbf5cba77']",1,110,111,4338892,1,,,,3157
8bbb31bf015f1e8e043e46d4c5dfa266f7027f70,1,Jungtaek Lim,2016-11-25 12:11:07+09:00,['57998b4d7f71efd751476deb19bacac8f29f4645'],0,550,550,4339442,8,0.739583333,1,0.739583333,3163
29b52e9c266b130642d99e665ff73c55dfabba13,0,Stig Rohde D酶ssing,2016-11-29 20:54:47+01:00,"['bd1f5c54752f67b484a83c26667331234234d3a3', '57998b4d7f71efd751476deb19bacac8f29f4645']",428,982,1410,4340852,60,,,,3163
152c51ab840a175332342e0453a8320eaeeb9169,0,Xin Wang,2016-11-30 23:15:31+08:00,['57998b4d7f71efd751476deb19bacac8f29f4645'],1,10,11,4340863,2,,,,3163
0d65e3193ec112cfded5433ee1c459ab5d0203e9,0,Arun Mahadevan,2016-11-30 21:46:18+05:18,['152c51ab840a175332342e0453a8320eaeeb9169'],19,121,140,4341003,4,0.142857143,0.261904762,0.845238095,3163
0d01d974bac1a3fd291c852339be7bc218cbc645,0,Arun Mahadevan,2016-11-30 21:46:18+05:18,['0d65e3193ec112cfded5433ee1c459ab5d0203e9'],59,80,139,4341142,6,1,1,1,3163
14098db42365b17faafe457faec1d9a0e14c7a13,0,Arun Mahadevan,2016-11-30 21:46:18+05:18,['0d01d974bac1a3fd291c852339be7bc218cbc645'],19,26,45,4341187,2,0,1,1,3163
285668742742da6316d38c1ef492c7c873b5a649,0,Arun Mahadevan,2016-11-30 21:46:18+05:18,['14098db42365b17faafe457faec1d9a0e14c7a13'],0,1,1,4341188,1,,,,3163
adee4aa3a0966bf05c037c01903b83706b4970ac,0,Satish Duggana,2016-12-01 08:24:02+05:18,['285668742742da6316d38c1ef492c7c873b5a649'],18,53,71,4341259,2,1,1,0.909090909,3163
8048cfa11d3692de8e242ceadc8cc0695bcefee1,0,Satish Duggana,2016-12-01 08:25:18+05:18,['adee4aa3a0966bf05c037c01903b83706b4970ac'],0,1,1,4341260,1,,,,3163
3c309fcfaf5b37282c82e2fb3649df1c47f169d3,0,Satish Duggana,2016-12-01 08:31:30+05:18,['8048cfa11d3692de8e242ceadc8cc0695bcefee1'],4,10,14,4341274,1,1,1,1,3163
872d0a13c836391a89b3354ed1304e7b7bc80633,0,Satish Duggana,2016-12-01 08:32:43+05:18,['3c309fcfaf5b37282c82e2fb3649df1c47f169d3'],0,1,1,4341275,1,,,,3163
725003cc5f488191dda011dda738e41d57eca474,1,Robert (Bobby) Evans,2016-12-01 13:58:59-06:00,['57998b4d7f71efd751476deb19bacac8f29f4645'],3206,4669,7875,4349150,33,0.282051282,0.543522267,0.709851552,3167
b91046684d0d1fc40e37471e0b8b00750bf1fe69,0,Robert (Bobby) Evans,2016-12-01 14:02:39-06:00,"['872d0a13c836391a89b3354ed1304e7b7bc80633', '725003cc5f488191dda011dda738e41d57eca474']",3206,4669,7875,4357025,33,,,,3167
2832aeb369d431a2e2f0709175db68f079855387,0,Robert (Bobby) Evans,2016-12-01 14:03:15-06:00,['b91046684d0d1fc40e37471e0b8b00750bf1fe69'],0,1,1,4357026,1,,,,3167
4efcc996aad0e30469b310d74efd58f0c0249d91,1,Robert (Bobby) Evans,2016-12-01 14:15:22-06:00,['2832aeb369d431a2e2f0709175db68f079855387'],3661,4274,7935,4364961,138,0.661521499,0.686879824,0.769570011,3174
4f0339a972916b5116bd2e02a192279c5c89d798,0,Robert (Bobby) Evans,2016-12-01 14:44:44-06:00,['2832aeb369d431a2e2f0709175db68f079855387'],3,59,62,4365023,5,0.56097561,0.975609756,0.975609756,3174
4cec3bdd073572fc41f9724c582baa3f769edddb,1,Satish Duggana,2016-12-02 11:33:41+05:18,['2832aeb369d431a2e2f0709175db68f079855387'],7,34,41,4365064,5,0,0.733333333,0.933333333,3174
80846773d9104fa565cf118d32b94796fc7507cf,0,Satish Duggana,2016-12-02 11:34:48+05:18,['4cec3bdd073572fc41f9724c582baa3f769edddb'],0,1,1,4365065,1,,,,3174
02872e40ecac1882e94dccabe44043126d8e8286,0,Jungtaek Lim,2016-12-02 22:58:27+09:00,"['80846773d9104fa565cf118d32b94796fc7507cf', '8bbb31bf015f1e8e043e46d4c5dfa266f7027f70']",0,550,550,4365615,8,,,,3174
fd87bdb7492301e3cc1389befe3502af654f19ea,0,Jungtaek Lim,2016-12-02 23:02:04+09:00,['02872e40ecac1882e94dccabe44043126d8e8286'],0,1,1,4365616,1,,,,3174
32b42758b4dd8ba54e4201f2918405cc520ff7da,0,Kyle Nusbaum,2016-12-02 13:46:21-06:00,['80846773d9104fa565cf118d32b94796fc7507cf'],3,7,10,4365626,1,,,,3174
7ef33e15d801b9d336846fb97ea9da48cce225ad,0,Jungtaek Lim,2016-12-03 10:22:23+09:00,"['fd87bdb7492301e3cc1389befe3502af654f19ea', '4f0339a972916b5116bd2e02a192279c5c89d798']",3,59,62,4365688,5,,,,3174
612aea66e94588db35625e89ab1080ed440d4fbe,0,Jungtaek Lim,2016-12-03 11:09:15+09:00,['7ef33e15d801b9d336846fb97ea9da48cce225ad'],0,1,1,4365689,1,,,,3174
557c49d561b7278495db47a759625b45c95f6a7b,0,Robert (Bobby) Evans,2016-12-03 09:28:12-06:00,"['612aea66e94588db35625e89ab1080ed440d4fbe', '4efcc996aad0e30469b310d74efd58f0c0249d91']",3661,4274,7935,4373624,138,,,,3174
607ba8a9e5c9ca939b4317cbf839cbc52d991799,0,Robert (Bobby) Evans,2016-12-03 09:49:28-06:00,['557c49d561b7278495db47a759625b45c95f6a7b'],0,1,1,4373625,1,,,,3174
0cc1d6aaeb784c938fab1ebee2abf789459d2622,0,itiel,2016-12-03 18:45:04+02:00,['607ba8a9e5c9ca939b4317cbf839cbc52d991799'],0,4,4,4373629,1,1,1,1,3174
ea44062fdaa60cbc8faff54a26862848a527b25c,1,Robert (Bobby) Evans,2016-12-05 08:09:28-06:00,['607ba8a9e5c9ca939b4317cbf839cbc52d991799'],839,2887,3726,4377355,35,0.579577465,0.845070423,0.923239437,3188
a104de1a76a2b094b538a0760f54f7cbbc8cfab0,1,Jungtaek Lim,2016-12-06 15:36:23+09:00,['607ba8a9e5c9ca939b4317cbf839cbc52d991799'],23,83,106,4377461,5,0.684210526,0.921052632,1,3188
d556552afdefb2b2757304248803086d40269fec,0,Jungtaek Lim,2016-12-07 08:12:14+09:00,"['607ba8a9e5c9ca939b4317cbf839cbc52d991799', '0cc1d6aaeb784c938fab1ebee2abf789459d2622']",0,4,4,4377465,1,,,,3188
f0b18d9493a58ae6179b8011e64330377948c8c4,1,Robert (Bobby) Evans,2016-12-06 17:12:48-06:00,['ea44062fdaa60cbc8faff54a26862848a527b25c'],27,183,210,4377675,11,,,,3189
a3957bd9b3605703f57f63883cb8f53b433b8531,0,Jungtaek Lim,2016-12-07 08:15:32+09:00,['d556552afdefb2b2757304248803086d40269fec'],0,1,1,4377676,1,,,,3189
9508b6666d97d478a9e7a06f2ee20e3fcf98b3ae,0,Jungtaek Lim,2016-12-07 08:20:59+09:00,['a3957bd9b3605703f57f63883cb8f53b433b8531'],0,0,0,4377676,0,,,,3189
9b8de73af64866e40d4775dc4b9024c6eed0e9ad,0,Jungtaek Lim,2016-12-07 08:29:54+09:00,['9508b6666d97d478a9e7a06f2ee20e3fcf98b3ae'],0,0,0,4377676,0,,,,3189
2fb82999414d9f6d956c79d54ae907da87a6355a,0,Jungtaek Lim,2016-12-07 08:36:27+09:00,"['9b8de73af64866e40d4775dc4b9024c6eed0e9ad', '32b42758b4dd8ba54e4201f2918405cc520ff7da']",3,7,10,4377686,1,,,,3189
9a69922175f24cd8b489aca94f5da957ffd87111,1,Robert (Bobby) Evans,2016-12-07 13:44:23-06:00,['f0b18d9493a58ae6179b8011e64330377948c8c4'],583,107,690,4378376,5,1,1,1,3191
7c246273d47879cd7009c4890a48746b244bddaa,0,Robert (Bobby) Evans,2016-12-07 17:02:19-06:00,['9a69922175f24cd8b489aca94f5da957ffd87111'],0,619,619,4378995,2,,,,3193
dafeda587f21d9fa41cf517a4824d98ba8950845,1,Robert (Bobby) Evans,2016-12-07 17:16:47-06:00,['2fb82999414d9f6d956c79d54ae907da87a6355a'],47,57,104,4379099,3,0,0.5,1,3193
984a322ac59afe11aa12e55080fa35d06603895a,0,Robert (Bobby) Evans,2016-12-07 17:16:48-06:00,['dafeda587f21d9fa41cf517a4824d98ba8950845'],83,83,166,4379265,1,1,1,0,3193
9400ac5dd113255a052b42896e14e38780f1cbd9,1,Robert (Bobby) Evans,2016-12-07 17:16:48-06:00,['984a322ac59afe11aa12e55080fa35d06603895a'],874,3145,4019,4383284,11,0.628571429,0.81552795,0.963354037,3193
802103857dfc212a79f495ad9ec18cd8fc538dc7,0,Robert (Bobby) Evans,2016-12-07 17:16:48-06:00,['9400ac5dd113255a052b42896e14e38780f1cbd9'],3,1,4,4383288,1,1,0,0,3193
3d21559004d4bdd2277151b676cf5d64a14fee9d,0,Jungtaek Lim,2016-12-08 19:59:32+09:00,"['2fb82999414d9f6d956c79d54ae907da87a6355a', 'a104de1a76a2b094b538a0760f54f7cbbc8cfab0']",23,83,106,4383394,5,,,,3193
e9cc74869ceb24e8a76f6cee1fd817d79b8e6313,0,Jungtaek Lim,2016-12-08 20:14:28+09:00,['3d21559004d4bdd2277151b676cf5d64a14fee9d'],0,1,1,4383395,1,,,,3193
23899bd8484b0d3f035436ad626a08a4581a00ee,0,Robert (Bobby) Evans,2016-12-08 12:02:18-06:00,"['e9cc74869ceb24e8a76f6cee1fd817d79b8e6313', '29b52e9c266b130642d99e665ff73c55dfabba13']",20,306,326,4383721,8,,,,3193
806e3635c301bf02d4525f1acb837110a87c4e26,0,Robert (Bobby) Evans,2016-12-08 12:14:07-06:00,['23899bd8484b0d3f035436ad626a08a4581a00ee'],0,1,1,4383722,1,,,,3193
c08d61c74e99aa9a5db6cce0e5299cb7e59c75f1,0,vesense,2016-12-13 11:32:37+08:00,['806e3635c301bf02d4525f1acb837110a87c4e26'],2,2,4,4383726,1,,,,3193
aeb3b8c71d42359474f8cc7d678d8df5b7b678ee,0,Alessandro Bellina,2016-12-14 13:43:42-06:00,['c08d61c74e99aa9a5db6cce0e5299cb7e59c75f1'],2,10,12,4383738,1,1,1,1,3193
610d58d829032854515939c912da142cbe8e2ccb,0,vesense,2016-12-15 16:11:29+08:00,['c08d61c74e99aa9a5db6cce0e5299cb7e59c75f1'],42,92,134,4383872,4,0,1,0.208333333,3193
a174300fcb71e90f57159a908cd525959bd55024,0,vesense,2016-12-15 16:54:44+08:00,['610d58d829032854515939c912da142cbe8e2ccb'],0,1,1,4383873,1,,,,3193
f05266955aa8fc7ad168db9d1b8130d8bbcf288f,0,vesense,2016-12-15 17:08:59+08:00,['a174300fcb71e90f57159a908cd525959bd55024'],0,1,1,4383874,1,,,,3193
10daf025d8d4d7ee29cee3aaeefc0213ae1e22cf,0,vesense,2016-12-16 11:53:08+08:00,['607ba8a9e5c9ca939b4317cbf839cbc52d991799'],7,2,9,4383883,1,0,0,0,3193
021c9336ee1bdaefa658fd0b5e9255fde2aef2c9,0,vesense,2016-12-16 13:19:55+08:00,['f05266955aa8fc7ad168db9d1b8130d8bbcf288f'],16,607,623,4384506,15,0.817757009,1,0.827102804,3200
2dfd4401fc8c6a805abb38a674a5bcea14188b0a,0,vesense,2016-12-16 13:23:29+08:00,['021c9336ee1bdaefa658fd0b5e9255fde2aef2c9'],38,461,499,4385005,8,0.240740741,1,1,3204
f63078c90d0671205ecef873d00efd35dd90d98d,0,vesense,2016-12-16 13:24:21+08:00,['2dfd4401fc8c6a805abb38a674a5bcea14188b0a'],0,1,1,4385006,1,,,,3204
74bf25e2f24b36b9aaaede629b5bfc9ef1402334,0,Arun Mahadevan,2016-12-16 11:07:45+05:18,['f63078c90d0671205ecef873d00efd35dd90d98d'],4,5,9,4385015,2,,,,3204
02214b6197fa4b7a818f59af5eb7ed86c4ed11b0,0,Hugo Louro,2016-12-17 00:57:13-08:00,['f63078c90d0671205ecef873d00efd35dd90d98d'],1,1,2,4385017,1,,,,3204
fd4913ff71cb0014b0d7ec63b7188079f6d4bdab,0,Jungtaek Lim,2016-12-18 19:56:08+09:00,"['f63078c90d0671205ecef873d00efd35dd90d98d', '10daf025d8d4d7ee29cee3aaeefc0213ae1e22cf']",7,2,9,4385026,1,,,,3204
6b1394f38b6c5be16450c4dba8e66cd232be13ea,0,Jungtaek Lim,2016-12-18 19:59:24+09:00,['fd4913ff71cb0014b0d7ec63b7188079f6d4bdab'],0,1,1,4385027,1,,,,3204
3c879e8785d1ee21cfb4710930080b5170b9ec60,1,Jungtaek Lim,2016-12-18 20:25:19+09:00,['6b1394f38b6c5be16450c4dba8e66cd232be13ea'],54,102,156,4385183,2,0.37254902,1,1,3205
9f50c9d9f24a9d866adec3fa8917a3922bd22460,0,Jungtaek Lim,2016-12-18 20:25:47+09:00,"['6b1394f38b6c5be16450c4dba8e66cd232be13ea', '3c879e8785d1ee21cfb4710930080b5170b9ec60']",54,102,156,4385339,2,,,,3205
7988af1271f0b60a74160515fc569e40f43902be,0,Jungtaek Lim,2016-12-18 20:26:02+09:00,['9f50c9d9f24a9d866adec3fa8917a3922bd22460'],0,1,1,4385340,1,,,,3205
aa04639856ecef38a84102af3936f4d77708448f,0,Jungtaek Lim,2016-12-18 20:31:23+09:00,"['7988af1271f0b60a74160515fc569e40f43902be', '02214b6197fa4b7a818f59af5eb7ed86c4ed11b0']",1,1,2,4385342,1,,,,3205
f659dc621e6ec94f2440af44f4cfb1c4f026497c,0,Jungtaek Lim,2016-12-18 20:36:38+09:00,"['aa04639856ecef38a84102af3936f4d77708448f', '74bf25e2f24b36b9aaaede629b5bfc9ef1402334']",4,5,9,4385351,2,,,,3205
2aa7791d2a02cd746e75763f3779a8956796bf94,0,Jungtaek Lim,2016-12-18 20:42:43+09:00,['f659dc621e6ec94f2440af44f4cfb1c4f026497c'],0,1,1,4385352,1,,,,3205
023c2f5d28287ae738e01ce26afed89dcf6ecd8b,1,Jungtaek Lim,2016-12-18 20:59:39+09:00,['6b1394f38b6c5be16450c4dba8e66cd232be13ea'],34,11,45,4385397,1,,,,3205
491c40ec63180e593f68c0589d1bf382edd7293f,0,Arun Mahadevan,2016-12-18 23:00:26+05:18,['3a5ecf50f43d15ea07649de2d915dd25bed7fcf6'],24,156,180,4385577,10,1,1,1,3207
e320eac4673dcf90336bf088a8b1e19ff75be9c1,0,Jungtaek Lim,2016-12-19 07:24:08+09:00,['2aa7791d2a02cd746e75763f3779a8956796bf94'],0,342,342,4385919,20,,,,3207
38289537a54efa9e7a1bfadec0007e0595f50ae4,0,Jungtaek Lim,2016-12-19 07:26:38+09:00,"['2aa7791d2a02cd746e75763f3779a8956796bf94', '491c40ec63180e593f68c0589d1bf382edd7293f']",24,156,180,4386099,10,,,,3207
4e20f88309348848ed85bafe25f0a12dd0f9f1cc,0,Jungtaek Lim,2016-12-19 07:27:37+09:00,['38289537a54efa9e7a1bfadec0007e0595f50ae4'],0,1,1,4386100,1,,,,3207
5eedddf741a6d50f847ea17ceb6d595d6d840b65,0,Jungtaek Lim,2016-12-19 09:35:48+09:00,"['4e20f88309348848ed85bafe25f0a12dd0f9f1cc', '7c246273d47879cd7009c4890a48746b244bddaa']",959,3306,4265,4390365,40,,,,3207
47dd09c1f258e33f752b84db7ad5ae0e74cdb1f5,0,Jungtaek Lim,2016-12-19 09:53:44+09:00,['5eedddf741a6d50f847ea17ceb6d595d6d840b65'],0,1,1,4390366,1,,,,3207
258b0e199a86215759a2184f47baad5542ab0405,1,Jungtaek Lim,2016-12-20 16:52:56+09:00,['47dd09c1f258e33f752b84db7ad5ae0e74cdb1f5'],14,38,52,4390418,1,0,0,1,3207
320eebbdcc288f82e5cd7af27c57646632fb39c5,0,Jungtaek Lim,2016-12-20 16:53:36+09:00,"['47dd09c1f258e33f752b84db7ad5ae0e74cdb1f5', '258b0e199a86215759a2184f47baad5542ab0405']",14,38,52,4390470,1,,,,3207
a925ca466b14c92a31eca3d6043cee60a342d845,0,Jungtaek Lim,2016-12-20 16:54:55+09:00,['320eebbdcc288f82e5cd7af27c57646632fb39c5'],0,1,1,4390471,1,,,,3207
371af68f675e6a95c3740e44606f4ee079466b06,0,Jungtaek Lim,2016-12-20 17:24:09+09:00,"['a925ca466b14c92a31eca3d6043cee60a342d845', '802103857dfc212a79f495ad9ec18cd8fc538dc7']",999,3278,4277,4394748,12,,,,3207
29547e66b7105f757bfbff71f65b830a38d03b7b,0,Jungtaek Lim,2016-12-20 17:56:48+09:00,['371af68f675e6a95c3740e44606f4ee079466b06'],0,1,1,4394749,1,,,,3207
3da11a2723213f0b1788c9b5766226124c1f4297,1,Sanket,2016-12-21 15:08:12-06:00,['29547e66b7105f757bfbff71f65b830a38d03b7b'],17,40,57,4394806,4,0.538461538,1,0.923076923,3207
c85cc1935d66cde6587674cce71734fd9a745f7d,1,Hugo Louro,2016-12-21 14:10:34-08:00,['29547e66b7105f757bfbff71f65b830a38d03b7b'],8,1550,1558,4396364,22,0.845938375,1,0.977591036,3223
42f709bb575e27d83c20409b11f51ecf9dd41cad,0,Sanket,2016-12-21 16:29:02-06:00,['3da11a2723213f0b1788c9b5766226124c1f4297'],1,1,2,4396366,1,,,,3223
5a0835d415039175e042ad70d585e669ca7bc2ca,0,Sanket,2016-12-21 16:42:13-06:00,['29547e66b7105f757bfbff71f65b830a38d03b7b'],1,0,1,4396367,1,1,1,0,3223
fbf334da839cb4acf999b48cd58c457044f142d3,0,Jungtaek Lim,2016-12-22 23:58:55+09:00,"['29547e66b7105f757bfbff71f65b830a38d03b7b', '023c2f5d28287ae738e01ce26afed89dcf6ecd8b']",34,11,45,4396412,1,,,,3223
15887ee3db6d6757fb00ce107d6d6b24af02589c,0,Jungtaek Lim,2016-12-23 00:01:13+09:00,['fbf334da839cb4acf999b48cd58c457044f142d3'],0,1,1,4396413,1,,,,3223
46c7abd90c07f925989e6330baf907215429eb9c,0,Sanket,2016-12-22 09:45:42-06:00,['42f709bb575e27d83c20409b11f51ecf9dd41cad'],1,1,2,4396415,1,,,,3223
540e4ce93813bfb4a73774356d00b626ef21b300,0,Sriharsha Chintalapani,2016-12-22 20:42:18-08:00,"['15887ee3db6d6757fb00ce107d6d6b24af02589c', 'c85cc1935d66cde6587674cce71734fd9a745f7d']",8,1550,1558,4397973,22,,,,3223
d5acec9e3b9473a0e8cf39c7e12393626a3ca426,0,Sriharsha Chintalapani,2016-12-22 20:45:43-08:00,['540e4ce93813bfb4a73774356d00b626ef21b300'],0,1,1,4397974,1,,,,3223
fca8ebb404127c6b07d01832563a21ccb3814238,0,Xin Wang,2016-12-24 19:15:17+08:00,['f118060dceee8be014dddb9311ea8ecf0425bf85'],268,431,699,4398673,4,0.474576271,0.759322034,0.983050847,3224
33e7089d75be896f4bb4ee11f6aa2e8be00d7da6,0,Jungtaek Lim,2016-12-25 19:25:58+09:00,"['d5acec9e3b9473a0e8cf39c7e12393626a3ca426', 'fca8ebb404127c6b07d01832563a21ccb3814238']",268,431,699,4399372,4,,,,3224
273fc4b747bb6ab9a10a147ecccb8b3da9fa0b2e,0,Jungtaek Lim,2016-12-25 19:32:36+09:00,['33e7089d75be896f4bb4ee11f6aa2e8be00d7da6'],0,1,1,4399373,1,,,,3224
c97ce0ef9cec7fa7247f8ae0824b9fd0f328566f,0,Jungtaek Lim,2016-12-26 12:13:54+09:00,['273fc4b747bb6ab9a10a147ecccb8b3da9fa0b2e'],0,2,2,4399375,1,,,,3224
e83cadc220863d78b2c256717abee88b18d33793,1,Xin Wang,2016-12-26 22:08:54+08:00,['c97ce0ef9cec7fa7247f8ae0824b9fd0f328566f'],1,413,414,4399789,7,0.546391753,1,0.845360825,3228
97c8a64ddc76bf62877fdb1cf826a08c2d601108,0,Jungtaek Lim,2016-12-27 22:20:46+09:00,"['c97ce0ef9cec7fa7247f8ae0824b9fd0f328566f', 'e83cadc220863d78b2c256717abee88b18d33793']",1,413,414,4400203,7,,,,3228
11db3eac3d29bb186d560265706a0bad8093773c,0,Jungtaek Lim,2016-12-28 00:20:36+09:00,['97c8a64ddc76bf62877fdb1cf826a08c2d601108'],0,1,1,4400204,1,,,,3228
62aedd9c41247db356838a0e40a8514ff373204b,1,Jungtaek Lim,2016-12-29 07:54:55+09:00,['11db3eac3d29bb186d560265706a0bad8093773c'],0,60,60,4400264,1,1,1,1,3228
3e313f125de1659bd2042a4c75ca5a22f5a582b7,0,Jungtaek Lim,2016-12-29 07:55:22+09:00,"['11db3eac3d29bb186d560265706a0bad8093773c', '62aedd9c41247db356838a0e40a8514ff373204b']",0,60,60,4400324,1,,,,3228
02ddf88c042ee969837259891f18e30a1d8869ad,0,Jungtaek Lim,2016-12-29 07:55:37+09:00,['3e313f125de1659bd2042a4c75ca5a22f5a582b7'],0,1,1,4400325,1,,,,3228
5ab547e82b724550e577f795845d9fa16475ab05,1,Satish Duggana,2016-12-29 13:20:47+05:18,['02ddf88c042ee969837259891f18e30a1d8869ad'],19,10,29,4400354,4,1,1,0.777777778,3228
96c6605d6e2be60d0a1267d5bf0d440fe8d70f2d,1,Arun Mahadevan,2016-12-30 11:49:39+05:18,['02ddf88c042ee969837259891f18e30a1d8869ad'],31,220,251,4400605,5,0.717948718,1,0.897435897,3230
80dd6e44dd12864de2c82091462fd66815383c45,0,Arun Mahadevan,2016-12-30 11:53:02+05:18,['96c6605d6e2be60d0a1267d5bf0d440fe8d70f2d'],0,2,2,4400607,2,,,,3230
fe013c45d869107834b6d0e188e5019fdbc09351,0,Satish Duggana,2017-01-03 06:51:05+05:18,['5ab547e82b724550e577f795845d9fa16475ab05'],5,12,17,4400624,1,0,0,1,3230
1e09c59f823edffaa2aa30514deed9f3e8518772,0,Jungtaek Lim,2017-01-03 13:27:08+09:00,['80dd6e44dd12864de2c82091462fd66815383c45'],7,26,33,4400657,3,0.923076923,1,1,3230
39f9a06aa783d83e2432eef0abaedfb6bcc8b7ee,1,Jungtaek Lim,2017-01-03 23:14:58+09:00,['80dd6e44dd12864de2c82091462fd66815383c45'],23,56,79,4400736,2,0.238095238,1,1,3230
7f34ff6ace2a5887dca528c8e53c71b8f51d95f1,0,Jungtaek Lim,2017-01-03 23:15:05+09:00,"['80dd6e44dd12864de2c82091462fd66815383c45', '39f9a06aa783d83e2432eef0abaedfb6bcc8b7ee']",23,56,79,4400815,2,,,,3230
46121cbd4010e70daefb5d5b1e66dbde0b5d2069,0,Jungtaek Lim,2017-01-03 23:15:55+09:00,['7f34ff6ace2a5887dca528c8e53c71b8f51d95f1'],0,1,1,4400816,1,,,,3230
add21b67763ea3f295028a68a5536d28c493ec42,0,Jungtaek Lim,2017-01-03 23:23:43+09:00,"['46121cbd4010e70daefb5d5b1e66dbde0b5d2069', 'fe013c45d869107834b6d0e188e5019fdbc09351']",15,13,28,4400844,4,,,,3230
f14517493d6452d41c94ddf3d6c0bb2f630e3b03,0,Jungtaek Lim,2017-01-03 23:31:15+09:00,['add21b67763ea3f295028a68a5536d28c493ec42'],0,1,1,4400845,1,,,,3230
0e0e091f04c7e26b45b6fe87659cb2ad60eb6a92,0,Sanket,2017-01-03 11:03:54-06:00,['5a0835d415039175e042ad70d585e669ca7bc2ca'],6,18,24,4400869,7,0,0,1,3230
307f92b176e9d4a8af35d795bc588175e1d724da,0,Sriharsha Chintalapani,2017-01-03 11:52:31-08:00,"['f14517493d6452d41c94ddf3d6c0bb2f630e3b03', 'e320eac4673dcf90336bf088a8b1e19ff75be9c1']",0,342,342,4401211,20,,,,3230
f5c291b871195cca9593d76ca2e3a4abc70ea57b,0,Sriharsha Chintalapani,2017-01-03 11:53:12-08:00,['307f92b176e9d4a8af35d795bc588175e1d724da'],0,1,1,4401212,1,,,,3230
95972ad60c71f4e62b32d723e0399794bfe04744,0,Jungtaek Lim,2017-01-04 07:29:27+09:00,['f5c291b871195cca9593d76ca2e3a4abc70ea57b'],1144,15,1159,4402371,13,0.519927536,0.239130435,0.240942029,3230
8f2f6892bd24832465de63860dcb8ce252dbf3e1,0,Jungtaek Lim,2017-01-04 07:30:31+09:00,"['f5c291b871195cca9593d76ca2e3a4abc70ea57b', '95972ad60c71f4e62b32d723e0399794bfe04744']",1144,15,1159,4403530,13,,,,3230
ff8fc2ceb98354699aa56d1cdc34859357e27f63,0,Jungtaek Lim,2017-01-04 07:30:59+09:00,['8f2f6892bd24832465de63860dcb8ce252dbf3e1'],0,1,1,4403531,1,,,,3230
00f54089caeceb6bf7293c751606163da5130a75,0,liurenjie1024,2017-01-04 11:58:43+08:00,['ff8fc2ceb98354699aa56d1cdc34859357e27f63'],77,568,645,4404176,12,0.827586207,0.972413793,0.710344828,3240
2ec4c30a4dbd27a5170a4fc73e60ce4d9835c38d,0,Jungtaek Lim,2017-01-04 17:33:23+09:00,"['ff8fc2ceb98354699aa56d1cdc34859357e27f63', '46c7abd90c07f925989e6330baf907215429eb9c']",17,40,57,4404233,4,,,,3240
6a4112a4c7e2e771a6f64c5f18eaf296fb68d7bb,0,Jungtaek Lim,2017-01-04 17:58:15+09:00,['2ec4c30a4dbd27a5170a4fc73e60ce4d9835c38d'],0,1,1,4404234,1,,,,3240
9e96613dd76600445f0174054985346c398539b6,0,Jungtaek Lim,2017-01-04 18:02:03+09:00,"['6a4112a4c7e2e771a6f64c5f18eaf296fb68d7bb', '1e09c59f823edffaa2aa30514deed9f3e8518772']",7,26,33,4404267,3,,,,3240
abee4d712ce6968cc3e0d326e4d094d55a798e4a,0,Jungtaek Lim,2017-01-04 18:29:14+09:00,['9e96613dd76600445f0174054985346c398539b6'],0,1,1,4404268,1,,,,3240
1581291d9f8cd3db911a6a0ecb5f2bd5c14173a6,0,Sanket,2017-01-04 05:55:42-06:00,['0e0e091f04c7e26b45b6fe87659cb2ad60eb6a92'],1,0,1,4404269,1,,,,3240
71269e411bec714f4844790831200dda25d0241b,1,Jungtaek Lim,2017-01-05 01:24:25+09:00,['abee4d712ce6968cc3e0d326e4d094d55a798e4a'],1,3,4,4404273,1,,,,3240
9971b5833fc7b9738fdeb4516f3fa9a770bed17f,0,Robert (Bobby) Evans,2017-01-04 13:06:59-06:00,"['abee4d712ce6968cc3e0d326e4d094d55a798e4a', '81b601dd5589a313f26e9b5b4961eb1578cd821e']",11,63,74,4404347,1,,,,3240
6b92d236fc88ea95b28012fea75902e265d3e9ec,0,Robert (Bobby) Evans,2017-01-04 13:07:41-06:00,['9971b5833fc7b9738fdeb4516f3fa9a770bed17f'],0,1,1,4404348,1,,,,3240
4e0da8f8d4cc0e9b593fdefe6003e24366ac60d0,1,Robert (Bobby) Evans,2017-01-04 14:40:09-06:00,['6b92d236fc88ea95b28012fea75902e265d3e9ec'],73,87,160,4404508,2,0.285714286,0.285714286,1,3240
daf63f6ffd7ffcc88cf0d46c38b91e2988f70ce3,0,Hugo Louro,2017-01-04 14:13:14-08:00,['6b92d236fc88ea95b28012fea75902e265d3e9ec'],2,4,6,4404514,1,,,,3240
2b82fc8b5328fd4fbd680998c6051d9496c102d7,0,Raghav Kumar Gautam,2017-01-04 16:17:39-08:00,['f14517493d6452d41c94ddf3d6c0bb2f630e3b03'],2,2,4,4404518,1,,,,3240
ff07f0ddd6be1e4f597c4a8e44b46cc2b148c7b2,0,Jungtaek Lim,2017-01-05 11:31:57+09:00,['6b92d236fc88ea95b28012fea75902e265d3e9ec'],1,1,2,4404520,1,,,,3240
0ff9d5e46ef99073fc602219b3400601e7568f15,0,Jungtaek Lim,2017-01-05 12:55:45+09:00,['ff07f0ddd6be1e4f597c4a8e44b46cc2b148c7b2'],224,0,224,4404744,3,0.637362637,0,0.527472527,3240
1e5de79c608684fecfd29cd3d5003a53c866270d,0,Robert (Bobby) Evans,2017-01-05 09:16:10-06:00,"['ff07f0ddd6be1e4f597c4a8e44b46cc2b148c7b2', 'aeb3b8c71d42359474f8cc7d678d8df5b7b678ee']",2,10,12,4404756,1,,,,3240
42db5f1b4ed80dfecf00fbe895209b3439968028,0,Robert (Bobby) Evans,2017-01-05 09:16:55-06:00,['1e5de79c608684fecfd29cd3d5003a53c866270d'],0,1,1,4404757,1,,,,3240
40f075605424ba50970f19931ed39acc2df8b83b,0,Jungtaek Lim,2017-01-06 17:28:33+09:00,['42db5f1b4ed80dfecf00fbe895209b3439968028'],1,1,2,4404759,1,,,,3240
296828704431e9e481a470e1f2ee6ac8aa15c865,0,Jungtaek Lim,2017-01-06 17:30:20+09:00,['40f075605424ba50970f19931ed39acc2df8b83b'],3,3,6,4404765,3,,,,3240
b2dde4ce099e315ee45f0e1d14c3142b811cafb6,0,Jungtaek Lim,2017-01-06 17:53:36+09:00,"['40f075605424ba50970f19931ed39acc2df8b83b', '0ff9d5e46ef99073fc602219b3400601e7568f15']",224,0,224,4404989,3,,,,3240
c402b9e86380e1aa1b1fe86d39310500354a2c42,0,Jungtaek Lim,2017-01-06 17:54:19+09:00,['b2dde4ce099e315ee45f0e1d14c3142b811cafb6'],0,1,1,4404990,1,,,,3240
e978b672cb0072b51bda0b267378c7bcc3d8cad2,0,Jungtaek Lim,2017-01-06 18:12:33+09:00,"['c402b9e86380e1aa1b1fe86d39310500354a2c42', '2b82fc8b5328fd4fbd680998c6051d9496c102d7']",2,2,4,4404994,1,,,,3240
e95fd94083e6663d9030415f5c8b24be49371119,0,Jungtaek Lim,2017-01-06 18:13:03+09:00,['e978b672cb0072b51bda0b267378c7bcc3d8cad2'],0,1,1,4404995,1,,,,3240
7d697c5da16d6c805fafcced2021eb4248b44e72,0,Robert (Bobby) Evans,2017-01-06 10:41:38-06:00,"['e95fd94083e6663d9030415f5c8b24be49371119', '4e0da8f8d4cc0e9b593fdefe6003e24366ac60d0']",73,87,160,4405155,2,,,,3240
b41e9a161b994c336e094b875b83b0825fdccf6b,0,Robert (Bobby) Evans,2017-01-06 10:58:20-06:00,['7d697c5da16d6c805fafcced2021eb4248b44e72'],0,1,1,4405156,1,,,,3240
51c8474143b0081ff0522b0367f3efdba2689089,1,Raghav Kumar Gautam,2017-01-06 22:15:12-08:00,['b41e9a161b994c336e094b875b83b0825fdccf6b'],1,1,2,4405158,1,,,,3240
98d808ea87f0c9e8b88f8fcdda2aee45f619bc8c,0,Jungtaek Lim,2017-01-09 08:29:20+09:00,"['e95fd94083e6663d9030415f5c8b24be49371119', '71269e411bec714f4844790831200dda25d0241b']",1,3,4,4405162,1,,,,3240
4ce9f303ba105f87bf2a733ac710898ebf540489,0,Jungtaek Lim,2017-01-09 08:29:43+09:00,['98d808ea87f0c9e8b88f8fcdda2aee45f619bc8c'],0,1,1,4405163,1,,,,3240
e23a4e36996995582223d4461bbd60e479fba0ac,0,Jungtaek Lim,2017-01-09 09:46:05+09:00,"['4ce9f303ba105f87bf2a733ac710898ebf540489', 'b41e9a161b994c336e094b875b83b0825fdccf6b']",73,88,161,4405324,3,,,,3240
d2c21fe3ae5517e9e07143eac2d5e2799a7df107,0,Jungtaek Lim,2017-01-09 10:13:50+09:00,"['e23a4e36996995582223d4461bbd60e479fba0ac', '1581291d9f8cd3db911a6a0ecb5f2bd5c14173a6']",7,17,24,4405348,7,,,,3240
70102643e74d577728adf5f8719920d1bf60e98a,0,Jungtaek Lim,2017-01-09 10:36:34+09:00,['d2c21fe3ae5517e9e07143eac2d5e2799a7df107'],0,1,1,4405349,1,,,,3240
e34c3ffc783c61326bfb81ec94d09cc432e38c95,0,Jungtaek Lim,2017-01-09 11:46:05+09:00,"['70102643e74d577728adf5f8719920d1bf60e98a', 'daf63f6ffd7ffcc88cf0d46c38b91e2988f70ce3']",2,4,6,4405355,1,,,,3240
fb4e78acf0d9082422a3cc581a9604b281b832c5,1,Jungtaek Lim,2017-01-09 11:49:23+09:00,['e34c3ffc783c61326bfb81ec94d09cc432e38c95'],3,24,27,4405382,2,1,1,1,3240
243170bce0d19ad53efe4d449650c10961c34cd3,0,Jungtaek Lim,2017-01-09 11:49:36+09:00,"['e34c3ffc783c61326bfb81ec94d09cc432e38c95', 'fb4e78acf0d9082422a3cc581a9604b281b832c5']",3,24,27,4405409,2,,,,3240
54b9e3f864e6c05a7a977b3b75b32f0d89508c5c,0,Jungtaek Lim,2017-01-09 11:49:53+09:00,['243170bce0d19ad53efe4d449650c10961c34cd3'],0,1,1,4405410,1,,,,3240
d27a8be00a2656a8e54b9c0af7547a1b874c4011,0,Jungtaek Lim,2017-01-09 14:49:19+09:00,['54b9e3f864e6c05a7a977b3b75b32f0d89508c5c'],2,11,13,4405423,3,,,,3240
36046191aba31e6cff22eabbac71164877ffeb17,0,Robert (Bobby) Evans,2017-01-09 15:07:02-06:00,['54b9e3f864e6c05a7a977b3b75b32f0d89508c5c'],1,13,14,4405437,1,1,1,1,3240
107795c01e5af6880d71bd044adfb5b0be04dc2e,0,Robert (Bobby) Evans,2017-01-09 15:53:18-06:00,['36046191aba31e6cff22eabbac71164877ffeb17'],3,20,23,4405460,2,0,1,1,3240
835f1b164edae309e2e9f22972897735f586b330,1,Jungtaek Lim,2017-01-10 09:48:34+09:00,['54b9e3f864e6c05a7a977b3b75b32f0d89508c5c'],8,68,76,4405536,3,0,1,1,3240
7503a680c4a737e7f7dc5dd885aac1b44580bdfd,0,Jungtaek Lim,2017-01-10 09:48:39+09:00,"['54b9e3f864e6c05a7a977b3b75b32f0d89508c5c', '835f1b164edae309e2e9f22972897735f586b330']",8,68,76,4405612,3,,,,3240
40bb834b83b424c05e61daf63c30b7542e5831c5,0,Jungtaek Lim,2017-01-10 09:49:07+09:00,['7503a680c4a737e7f7dc5dd885aac1b44580bdfd'],0,1,1,4405613,1,,,,3240
fd1f4951f8b3a1aab39464057adc433eea5141bd,0,Jungtaek Lim,2017-01-10 09:52:29+09:00,"['40bb834b83b424c05e61daf63c30b7542e5831c5', '51c8474143b0081ff0522b0367f3efdba2689089']",1,1,2,4405615,1,,,,3240
29bf68073d2aec874bb85851cafa8a1a4fc8f835,0,Jungtaek Lim,2017-01-10 09:55:27+09:00,['fd1f4951f8b3a1aab39464057adc433eea5141bd'],0,1,1,4405616,1,,,,3240
8c9515a7ffaf6155d3f535f4338f9a010e90b422,0,Jungtaek Lim,2017-01-10 10:14:09+09:00,"['29bf68073d2aec874bb85851cafa8a1a4fc8f835', '107795c01e5af6880d71bd044adfb5b0be04dc2e']",2,31,33,4405649,2,,,,3240
e98cb19010e480d4f578b2c14101ebead72ee161,0,Jungtaek Lim,2017-01-10 10:39:25+09:00,['8c9515a7ffaf6155d3f535f4338f9a010e90b422'],0,1,1,4405650,1,,,,3240
0f8ec795647b3bb775d5c261a01bc6b308ec0519,1,Raghav Kumar Gautam,2017-01-10 12:49:08-08:00,['51c8474143b0081ff0522b0367f3efdba2689089'],22,24,46,4405696,5,,,,3240
67b5b22d8d1932597991129480c810c3b36e6610,0,Jungtaek Lim,2017-01-11 07:54:37+09:00,"['e98cb19010e480d4f578b2c14101ebead72ee161', 'd27a8be00a2656a8e54b9c0af7547a1b874c4011']",2,11,13,4405709,3,,,,3240
a3ba10c708b1f3ee4f1eccb5c656fda6671fb31f,0,Jungtaek Lim,2017-01-11 08:03:24+09:00,['67b5b22d8d1932597991129480c810c3b36e6610'],0,1,1,4405710,1,,,,3240
ec34d2277f236517440eac5e0784a294507d8a55,0,Arun Mahadevan,2017-01-12 17:03:32+05:18,['a3ba10c708b1f3ee4f1eccb5c656fda6671fb31f'],10,20,30,4405740,1,1,1,1,3240
0e55fc51e32d85bf9ac6488e9fce1398a37ebf73,0,Jungtaek Lim,2017-01-12 22:06:20+09:00,"['a3ba10c708b1f3ee4f1eccb5c656fda6671fb31f', 'ec34d2277f236517440eac5e0784a294507d8a55']",10,20,30,4405770,1,,,,3240
358a392c7f533b19209c6c2b892faf59a021ea99,0,Jungtaek Lim,2017-01-12 23:16:30+09:00,['0e55fc51e32d85bf9ac6488e9fce1398a37ebf73'],0,1,1,4405771,1,,,,3240
36639d12202e9da53c8259e73356725f2de88f13,0,Jungtaek Lim,2017-01-12 23:37:51+09:00,"['358a392c7f533b19209c6c2b892faf59a021ea99', '0f8ec795647b3bb775d5c261a01bc6b308ec0519']",22,24,46,4405817,5,,,,3240
e3b2f96931317d98bff0e2be567a0bf80e835f43,0,Jungtaek Lim,2017-01-12 23:40:03+09:00,['36639d12202e9da53c8259e73356725f2de88f13'],0,1,1,4405818,1,,,,3240
e251573d524f6a6a11c7821ba93fd155d9beb770,1,Arun Mahadevan,2017-01-13 01:08:43+05:18,['e3b2f96931317d98bff0e2be567a0bf80e835f43'],29,6505,6534,4412352,94,0.778297872,0.882553191,0.895744681,3320
3a10865c628fa0606456826e28ce8838baf60134,0,Arun Mahadevan,2017-01-13 01:08:44+05:18,['e251573d524f6a6a11c7821ba93fd155d9beb770'],300,2398,2698,4415050,46,0.644685039,0.692913386,0.703740157,3335
dc19597c290ca0177cf9a06c81f13a60a3afedd2,0,Arun Mahadevan,2017-01-13 01:08:44+05:18,['3a10865c628fa0606456826e28ce8838baf60134'],78,63,141,4415191,5,1,1,0,3335
0aa0e8579723a76f53fe7e0ae71dfd1722465c0e,1,Stig Rohde D酶ssing,2017-01-12 21:27:05+01:00,['e3b2f96931317d98bff0e2be567a0bf80e835f43'],44,34,78,4415269,4,0,0,0.1,3335
00fed518d14b485e2a9e9cdd91ade3cc9d68dc8d,0,Jungtaek Lim,2017-01-13 10:45:03+09:00,['e3b2f96931317d98bff0e2be567a0bf80e835f43'],3,3,6,4415275,1,,,,3335
e2f87c304297ce95f01708e0934c44ee385fa0bb,0,Sriharsha Chintalapani,2017-01-13 20:45:57-08:00,"['00fed518d14b485e2a9e9cdd91ade3cc9d68dc8d', '00f54089caeceb6bf7293c751606163da5130a75']",77,568,645,4415920,12,,,,3335
0c12cc4d74fe4e52a64840e30eb07794cd555e47,0,Sriharsha Chintalapani,2017-01-13 20:46:44-08:00,['e2f87c304297ce95f01708e0934c44ee385fa0bb'],0,1,1,4415921,1,,,,3335
c5e266b01b697969fd6514c5bbab9ca5459e90b6,1,Jungtaek Lim,2017-01-16 12:58:13+09:00,['00fed518d14b485e2a9e9cdd91ade3cc9d68dc8d'],9,9,18,4415939,4,,,,3335
33cb8ec33300cb447e06d34deebeff70bf824de4,0,Jungtaek Lim,2017-01-16 23:32:08+09:00,['0c12cc4d74fe4e52a64840e30eb07794cd555e47'],22,21,43,4415982,2,0,0,0,3335
7ba179c16e85382a5f11c0457e8dc98a6ed03427,0,Jungtaek Lim,2017-01-16 23:33:55+09:00,"['0c12cc4d74fe4e52a64840e30eb07794cd555e47', '33cb8ec33300cb447e06d34deebeff70bf824de4']",22,21,43,4416025,2,,,,3335
bb533a9eb074ea572053392e3601d3c158404161,0,Jungtaek Lim,2017-01-16 23:35:35+09:00,['7ba179c16e85382a5f11c0457e8dc98a6ed03427'],0,1,1,4416026,1,,,,3335
85a31e2fdec1ffef83e1ff438cd765a821fb06e4,1,Jungtaek Lim,2017-01-17 19:42:41+09:00,['bb533a9eb074ea572053392e3601d3c158404161'],4,10,14,4416040,2,1,1,1,3335
a1b7b568ad02bbd599f908c3ab500c85aa498197,0,Jungtaek Lim,2017-01-18 17:50:40+09:00,['bb533a9eb074ea572053392e3601d3c158404161'],68,9,77,4416117,3,1,1,1,3335
b2a7be33fb6aa580c93005721eca4aa60c9b871c,0,Jungtaek Lim,2017-01-18 18:28:42+09:00,['bb533a9eb074ea572053392e3601d3c158404161'],6,145,151,4416268,8,0.08,0.14,0.96,3336
7bc4a6aa4718b9ea363f42694e4b01b663e78c35,0,Jungtaek Lim,2017-01-18 18:36:09+09:00,"['bb533a9eb074ea572053392e3601d3c158404161', 'c5e266b01b697969fd6514c5bbab9ca5459e90b6']",9,9,18,4416286,4,,,,3336
28f4df1db603de6c3a67eeb9462e856847e63b44,0,Jungtaek Lim,2017-01-18 18:37:11+09:00,['7bc4a6aa4718b9ea363f42694e4b01b663e78c35'],0,1,1,4416287,1,,,,3336
249aa8459c262ebcb5b6fe20840c28fa0b04bf23,0,Jungtaek Lim,2017-01-18 18:43:03+09:00,"['28f4df1db603de6c3a67eeb9462e856847e63b44', '85a31e2fdec1ffef83e1ff438cd765a821fb06e4']",4,10,14,4416301,2,,,,3336
b1b7d00cbd049b1b07f8210ccd9e046617cf6ae4,0,Jungtaek Lim,2017-01-18 18:44:50+09:00,['249aa8459c262ebcb5b6fe20840c28fa0b04bf23'],0,1,1,4416302,1,,,,3336
5b0c8115474924a24d4755b4d596a2e6feff60ce,0,Sriharsha Chintalapani,2017-01-18 16:35:51-08:00,['b1b7d00cbd049b1b07f8210ccd9e046617cf6ae4'],0,18,18,4416320,1,,,,3336
2e9e9d63f8bd5a712f73b28a083b50c1df11c9d1,0,Jungtaek Lim,2017-01-19 10:33:32+09:00,['bb533a9eb074ea572053392e3601d3c158404161'],6,158,164,4416484,2,1,1,1,3337
84975803b59cc9c026a742e4f3d8241fa549d369,0,Jungtaek Lim,2017-01-19 14:06:35+09:00,['5b0c8115474924a24d4755b4d596a2e6feff60ce'],8,9,17,4416501,3,,,,3337
17312ea6167a16fbc66784f2176f186cdd604556,0,Jungtaek Lim,2017-01-19 15:53:05+09:00,"['5b0c8115474924a24d4755b4d596a2e6feff60ce', 'b2a7be33fb6aa580c93005721eca4aa60c9b871c']",6,145,151,4416652,8,,,,3337
f79d41e8fcc238bf0d8e5a0be61a7c670a3e55a7,0,Jungtaek Lim,2017-01-19 15:57:48+09:00,['17312ea6167a16fbc66784f2176f186cdd604556'],0,1,1,4416653,1,,,,3337
ba406c16a27221dc4c1ca7ac3d3c3164cb669bfd,1,Jungtaek Lim,2017-01-19 16:04:15+09:00,['f79d41e8fcc238bf0d8e5a0be61a7c670a3e55a7'],8,46,54,4416707,2,1,1,1,3338
109b8fc756380f42bccd5f28faa2f32c81757461,0,Jungtaek Lim,2017-01-19 16:06:49+09:00,"['f79d41e8fcc238bf0d8e5a0be61a7c670a3e55a7', 'ba406c16a27221dc4c1ca7ac3d3c3164cb669bfd']",8,46,54,4416761,2,,,,3338
4ab42d08cbf02a80c1576f070c60b70f0cc4bb19,0,Jungtaek Lim,2017-01-19 16:12:52+09:00,['109b8fc756380f42bccd5f28faa2f32c81757461'],0,1,1,4416762,1,,,,3338
5e29c068042c2e8d2dad2934649b7b2ec1a39618,0,Jungtaek Lim,2017-01-20 10:20:21+09:00,"['4ab42d08cbf02a80c1576f070c60b70f0cc4bb19', '296828704431e9e481a470e1f2ee6ac8aa15c865']",3,3,6,4416768,3,,,,3338
15ce11a2e9f21c75f61fc4c129c9e88fc654afbf,0,Jungtaek Lim,2017-01-20 10:20:59+09:00,['5e29c068042c2e8d2dad2934649b7b2ec1a39618'],0,1,1,4416769,1,,,,3338
3bee1f7976ad54a965b4352fbf975758e8260a0e,0,Jungtaek Lim,2017-01-20 11:00:00+09:00,['15ce11a2e9f21c75f61fc4c129c9e88fc654afbf'],1,1,2,4416771,1,,,,3338
04b065fd0be6db2be9577c7f98f7dbf0865c5e84,0,Jungtaek Lim,2017-01-20 13:07:02+09:00,['3bee1f7976ad54a965b4352fbf975758e8260a0e'],61,68,129,4416900,2,0,1,1,3339
a5d410d3ac22d453fc0cae6e8d390537a2334b5a,0,Jungtaek Lim,2017-01-20 13:07:37+09:00,"['3bee1f7976ad54a965b4352fbf975758e8260a0e', '04b065fd0be6db2be9577c7f98f7dbf0865c5e84']",61,68,129,4417029,2,,,,3339
43b89502fe462988de591a1104cb4ea230015865,0,Jungtaek Lim,2017-01-20 13:08:20+09:00,['a5d410d3ac22d453fc0cae6e8d390537a2334b5a'],0,1,1,4417030,1,,,,3339
bf5373d879616e44dbde38d2720e80e52c76318a,0,Raghav Kumar Gautam,2017-01-20 06:33:19-08:00,['00fed518d14b485e2a9e9cdd91ade3cc9d68dc8d'],5,8,13,4417043,3,1,1,1,3339
0fb48e867fd7a4360bc372a53dda6f203ebf0911,0,Jungtaek Lim,2017-01-23 15:15:44+09:00,"['43b89502fe462988de591a1104cb4ea230015865', '84975803b59cc9c026a742e4f3d8241fa549d369']",8,9,17,4417060,3,,,,3339
8597808d433cd0c2e5caba4faafb094b4ad6e127,0,Jungtaek Lim,2017-01-23 15:18:49+09:00,['0fb48e867fd7a4360bc372a53dda6f203ebf0911'],0,1,1,4417061,1,,,,3339
9ae8f4e3d9742994f0051e50ad65cd965ef5feb1,1,Jungtaek Lim,2017-01-23 18:51:12+09:00,['8597808d433cd0c2e5caba4faafb094b4ad6e127'],385,1877,2262,4419323,45,0.744360902,0.919799499,0.922305764,3368
7011d9311eeb8ed24baf364e4851a6c993bdbb07,0,Jungtaek Lim,2017-01-24 07:40:32+09:00,"['8597808d433cd0c2e5caba4faafb094b4ad6e127', '9ae8f4e3d9742994f0051e50ad65cd965ef5feb1']",385,1877,2262,4421585,45,,,,3368
670be8732b0f8dc1549ebc7779cdfbbdd29484cd,0,Jungtaek Lim,2017-01-24 07:50:33+09:00,['7011d9311eeb8ed24baf364e4851a6c993bdbb07'],0,1,1,4421586,1,,,,3368
fe473655a5f09bd061e12ca673aac7ad064d656b,0,Jungtaek Lim,2017-01-24 07:57:28+09:00,"['670be8732b0f8dc1549ebc7779cdfbbdd29484cd', 'bf5373d879616e44dbde38d2720e80e52c76318a']",5,8,13,4421599,3,,,,3368
caeb892426622011eef63dccc06d81b32526208a,0,Jungtaek Lim,2017-01-24 07:57:59+09:00,['fe473655a5f09bd061e12ca673aac7ad064d656b'],0,1,1,4421600,1,,,,3368
20cbd3a1f522cbd0f04e605d8fa4c41b0e66d5ae,1,Jungtaek Lim,2017-01-24 09:42:36+09:00,['caeb892426622011eef63dccc06d81b32526208a'],15,105,120,4421720,10,0,0,0.933333333,3369
c23d93c5ebda38b66dad1177f49a6e97fb2f1957,1,Hugo Louro,2017-01-23 18:29:12-08:00,['11db3eac3d29bb186d560265706a0bad8093773c'],6,109,115,4421835,4,0.904761905,0.952380952,0.380952381,3370
38672e6a19452387e2ae1f3093ec5abd18aaf400,0,Jungtaek Lim,2017-01-24 11:59:47+09:00,"['caeb892426622011eef63dccc06d81b32526208a', 'a1b7b568ad02bbd599f908c3ab500c85aa498197']",68,9,77,4421912,3,,,,3370
7e02b71ea46f009918b9526e6054b60a064b031a,0,Jungtaek Lim,2017-01-24 12:02:52+09:00,['38672e6a19452387e2ae1f3093ec5abd18aaf400'],0,1,1,4421913,1,,,,3370
e760b66853fb01035d2c1372710d2a19712f2f0c,0,Jungtaek Lim,2017-01-24 12:05:32+09:00,"['7e02b71ea46f009918b9526e6054b60a064b031a', '2e9e9d63f8bd5a712f73b28a083b50c1df11c9d1']",6,158,164,4422077,2,,,,3370
1811273f18e79430167af709c23dbb9c9e2f7f7d,0,Jungtaek Lim,2017-01-24 12:42:35+09:00,['e760b66853fb01035d2c1372710d2a19712f2f0c'],0,1,1,4422078,1,,,,3370
a07039fc07f6f2aa5d3baeaf5107359218d84b5c,0,Arun Mahadevan,2017-01-24 17:21:40+05:18,['dc19597c290ca0177cf9a06c81f13a60a3afedd2'],0,66,66,4422144,6,,,,3371
8ab4fd05ed5ed95c7a5bb7356fe228c14a8d86d7,0,zhangbiao3,2017-01-24 21:01:02+08:00,['5b0c8115474924a24d4755b4d596a2e6feff60ce'],3,0,3,4422147,2,,,,3371
37ee12ccd9a0465dc6cd6d2f9fb59929a798b6b5,0,Arun Mahadevan,2017-01-24 22:13:21+05:18,['a07039fc07f6f2aa5d3baeaf5107359218d84b5c'],88,105,193,4422340,23,1,0,0,3371
ab539770ae4a7ac96335ff90e12a35b735af2cf0,0,Jungtaek Lim,2017-01-25 18:20:19+09:00,['1811273f18e79430167af709c23dbb9c9e2f7f7d'],5,10,15,4422355,3,1,1,1,3371
f7373f43511d1410f0f026034a4c8194e5f1a7f1,1,Jungtaek Lim,2017-01-26 08:58:20+09:00,['1811273f18e79430167af709c23dbb9c9e2f7f7d'],19,100,119,4422474,1,0,0,0,3371
1d09d786fdbf61f634441e76e2c2a53c35178540,1,Arun Mahadevan,2017-01-27 12:07:18+05:18,['1811273f18e79430167af709c23dbb9c9e2f7f7d'],13,82,95,4422569,4,1,1,1,3372
03b8b793616d8b75130746fd496c622a50ba9ad9,0,Antti J盲rvinen,2017-01-28 13:22:26+02:00,['1811273f18e79430167af709c23dbb9c9e2f7f7d'],6,14,20,4422589,1,0,1,1,3372
346ade35193c86266c238ec11f8e248da2bff553,0,Jungtaek Lim,2017-01-30 22:21:16+09:00,"['1811273f18e79430167af709c23dbb9c9e2f7f7d', 'ab539770ae4a7ac96335ff90e12a35b735af2cf0']",5,10,15,4422604,3,,,,3372
69568ecf0d85d034b7e04807911f61e1a7c2c3f4,0,Jungtaek Lim,2017-01-30 22:41:19+09:00,['346ade35193c86266c238ec11f8e248da2bff553'],0,1,1,4422605,1,,,,3372
fcecf42e6db6f332ded1d76854a95867f98528d1,0,Jungtaek Lim,2017-01-30 22:51:26+09:00,"['69568ecf0d85d034b7e04807911f61e1a7c2c3f4', '1d09d786fdbf61f634441e76e2c2a53c35178540']",13,82,95,4422700,4,,,,3372
4c5e34ee6399d8b19718bd7b75dc7c241a37a515,0,Jungtaek Lim,2017-01-30 22:58:26+09:00,['fcecf42e6db6f332ded1d76854a95867f98528d1'],0,1,1,4422701,1,,,,3372
74a77aa6494957b941df55d66ff64b6561eee4a8,1,Robert (Bobby) Evans,2017-01-30 14:17:40-06:00,['4c5e34ee6399d8b19718bd7b75dc7c241a37a515'],586,77,663,4423364,12,0.172413793,0.027586207,0.289655172,3372
c9f9348e3de0917020a8c903f4c9d026b7dc6204,1,Robert (Bobby) Evans,2017-01-30 14:42:10-06:00,['74a77aa6494957b941df55d66ff64b6561eee4a8'],1428,2662,4090,4427454,65,0.39516129,0.741935484,0.822580645,3399
d76c5d590319afc1aad81ea9fa3acbc8416fdd93,1,Jungtaek Lim,2017-01-31 13:20:29+09:00,['4c5e34ee6399d8b19718bd7b75dc7c241a37a515'],250,473,723,4428177,17,0.291666667,0.989583333,0.03125,3402
ff7204385976e2de8099b5fffa858ae29db8c5a8,1,Jungtaek Lim,2017-01-31 17:00:31+09:00,['4c5e34ee6399d8b19718bd7b75dc7c241a37a515'],15,38,53,4428230,5,0,0,1,3402
8685807b9a9c77dad3ecb8507e985906bce974b5,1,Julien Nioche,2017-01-31 16:20:30+00:00,['1811273f18e79430167af709c23dbb9c9e2f7f7d'],247,318,565,4428795,7,0,0,0.625,3403
85fd22131fd8232a6744bea2fb917f382557a60c,0,Sriharsha Chintalapani,2017-01-31 17:51:24-08:00,"['4c5e34ee6399d8b19718bd7b75dc7c241a37a515', 'f7373f43511d1410f0f026034a4c8194e5f1a7f1']",19,100,119,4428914,1,,,,3403
22cecb08770ffa325a2e0fc92c2077873262c434,0,Sriharsha Chintalapani,2017-01-31 17:52:21-08:00,['85fd22131fd8232a6744bea2fb917f382557a60c'],0,1,1,4428915,1,,,,3403
c3872b5fef930d981b5da34682e14b24bcd3117e,0,Jungtaek Lim,2017-02-01 13:54:05+09:00,['4c5e34ee6399d8b19718bd7b75dc7c241a37a515'],0,69,69,4428984,2,,,,3405
4ddd1880dacc9a9c5ab9d760517f6552d993eac8,0,Jungtaek Lim,2017-02-01 17:17:46+09:00,['4c5e34ee6399d8b19718bd7b75dc7c241a37a515'],7,9,16,4429000,1,1,0,1,3405
44cfe3d0b2ada74a1513826817b04fc904be783e,0,Jungtaek Lim,2017-02-01 17:45:54+09:00,['4c5e34ee6399d8b19718bd7b75dc7c241a37a515'],1,3,4,4429004,1,0,1,1,3405
0d037042b95486c631f8e407f19f4a2c9c9ab095,0,Robert (Bobby) Evans,2017-02-01 09:15:04-06:00,"['22cecb08770ffa325a2e0fc92c2077873262c434', 'c9f9348e3de0917020a8c903f4c9d026b7dc6204']",1820,2545,4365,4433369,73,,,,3405
251cb8876b0dbab1211a69e35c460aeeb07a20e2,0,Robert (Bobby) Evans,2017-02-01 09:15:34-06:00,['0d037042b95486c631f8e407f19f4a2c9c9ab095'],0,1,1,4433370,1,,,,3405
ad2be678831b3b060229fd936e3908110162b7ac,0,Stig Rohde D酶ssing,2017-02-01 22:28:00+01:00,"['0aa0e8579723a76f53fe7e0ae71dfd1722465c0e', '251cb8876b0dbab1211a69e35c460aeeb07a20e2']",2000,5183,7183,4440553,146,,,,3405
5ccef1393de96ac3e87aaca8abc0b31a5c38457f,0,Sriharsha Chintalapani,2017-02-01 15:24:30-08:00,"['251cb8876b0dbab1211a69e35c460aeeb07a20e2', 'c23d93c5ebda38b66dad1177f49a6e97fb2f1957']",6,109,115,4440668,4,,,,3405
1064ed10740091fb38b884b2ded29dcceed3318f,0,Sriharsha Chintalapani,2017-02-01 15:25:29-08:00,['5ccef1393de96ac3e87aaca8abc0b31a5c38457f'],0,1,1,4440669,1,,,,3405
dfbf6fef81fbd8cf29e99b167299177e9907a706,0,Sriharsha Chintalapani,2017-02-01 15:46:36-08:00,"['1064ed10740091fb38b884b2ded29dcceed3318f', '03b8b793616d8b75130746fd496c622a50ba9ad9']",6,14,20,4440689,1,,,,3405
9c8d7b916f09e4d7cc97db1b089496e8ab356a9a,0,Sriharsha Chintalapani,2017-02-01 15:47:16-08:00,['dfbf6fef81fbd8cf29e99b167299177e9907a706'],0,1,1,4440690,1,,,,3405
245134aced0f520a133398975740609ee4cd83de,0,Jungtaek Lim,2017-02-02 15:52:14+09:00,"['9c8d7b916f09e4d7cc97db1b089496e8ab356a9a', '8685807b9a9c77dad3ecb8507e985906bce974b5']",247,318,565,4441255,7,,,,3405
81aea91f1ba7479cc76d9ce8066f4a297dfaac38,0,Jungtaek Lim,2017-02-02 16:05:25+09:00,['245134aced0f520a133398975740609ee4cd83de'],0,1,1,4441256,1,,,,3405
9d4480940846ac876ffcfaf8204c659f9dd16954,0,Jungtaek Lim,2017-02-02 23:41:40+09:00,"['81aea91f1ba7479cc76d9ce8066f4a297dfaac38', '4ddd1880dacc9a9c5ab9d760517f6552d993eac8']",7,9,16,4441272,1,,,,3405
a49483da0accf7e8eee09d52169fb35452ec5aa8,0,Jungtaek Lim,2017-02-02 23:43:27+09:00,['9d4480940846ac876ffcfaf8204c659f9dd16954'],0,1,1,4441273,1,,,,3405
a459361331361191c7fee438573c3f2b36abeaec,0,Jungtaek Lim,2017-02-03 00:28:55+09:00,"['a49483da0accf7e8eee09d52169fb35452ec5aa8', '44cfe3d0b2ada74a1513826817b04fc904be783e']",1,3,4,4441277,1,,,,3405
1445a955a79d1d831715f309400c7368ca337d6a,0,Jungtaek Lim,2017-02-03 00:33:30+09:00,['a459361331361191c7fee438573c3f2b36abeaec'],0,1,1,4441278,1,,,,3405
5b31d5f8a61851fab26a28e249089ada6ff26231,0,Sriharsha Chintalapani,2017-02-02 09:19:05-08:00,"['1445a955a79d1d831715f309400c7368ca337d6a', 'ff7204385976e2de8099b5fffa858ae29db8c5a8']",15,38,53,4441331,5,,,,3405
4e1572e29fbc3fd983ad6163852d84f8a3c80782,0,Sriharsha Chintalapani,2017-02-02 09:19:36-08:00,['5b31d5f8a61851fab26a28e249089ada6ff26231'],0,1,1,4441332,1,,,,3405
9947dd1154989f11d78aca709acfe81f41cc586a,0,Jungtaek Lim,2017-02-03 09:16:05+09:00,['4e1572e29fbc3fd983ad6163852d84f8a3c80782'],1,1,2,4441334,1,,,,3405
ab430f5efa1b3df26319fef6e85b0944106d7823,0,Roshan Naik,2017-02-02 16:21:11-08:00,['9947dd1154989f11d78aca709acfe81f41cc586a'],4,11,15,4441349,2,0,0,1,3405
a1857165df99414f3622e157d01ab3529019cfaf,0,Jungtaek Lim,2017-02-03 09:35:28+09:00,"['9947dd1154989f11d78aca709acfe81f41cc586a', 'c3872b5fef930d981b5da34682e14b24bcd3117e']",0,69,69,4441418,2,,,,3405
ee6c6b59a6d28dba11782ba76dab94bc853550bf,0,Jungtaek Lim,2017-02-03 09:49:45+09:00,"['a1857165df99414f3622e157d01ab3529019cfaf', 'd76c5d590319afc1aad81ea9fa3acbc8416fdd93']",250,473,723,4442141,17,,,,3405
f57f3bba9c641e2eb7eef5fada4f04ae4481be03,0,Jungtaek Lim,2017-02-03 10:02:25+09:00,['ee6c6b59a6d28dba11782ba76dab94bc853550bf'],0,1,1,4442142,1,,,,3405
33b782265ca81bf1d8358b302d73b67366fa40aa,0,Jungtaek Lim,2017-02-03 10:22:56+09:00,"['f57f3bba9c641e2eb7eef5fada4f04ae4481be03', '20cbd3a1f522cbd0f04e605d8fa4c41b0e66d5ae']",15,105,120,4442262,10,,,,3405
2d9543c1837a8c352a0129d3551ab06db3408191,0,Jungtaek Lim,2017-02-03 10:27:09+09:00,['33b782265ca81bf1d8358b302d73b67366fa40aa'],0,1,1,4442263,1,,,,3405
29a68089ab30a242655a7cc89ad1d83f48176609,0,Jungtaek Lim,2017-02-03 10:54:10+09:00,"['2d9543c1837a8c352a0129d3551ab06db3408191', 'ab430f5efa1b3df26319fef6e85b0944106d7823']",4,11,15,4442278,2,,,,3405
e8c390059df5a3199763f33601b00c4a0b7d4ed0,0,Jungtaek Lim,2017-02-03 11:23:30+09:00,['29a68089ab30a242655a7cc89ad1d83f48176609'],0,1,1,4442279,1,,,,3405
99be17282e73314f30de3d80abcefc2de8f226a8,0,Jungtaek Lim,2017-02-03 11:41:54+09:00,"['e8c390059df5a3199763f33601b00c4a0b7d4ed0', 'ad2be678831b3b060229fd936e3908110162b7ac']",45,34,79,4442358,4,,,,3405
38ee403bf4a537ef276221033901690f099479c0,0,Jungtaek Lim,2017-02-03 11:52:02+09:00,['99be17282e73314f30de3d80abcefc2de8f226a8'],0,1,1,4442359,1,,,,3405
bd6e0c5fbcebd1f3ac99e4095c3c492c39873455,0,Jungtaek Lim,2017-02-04 08:07:37+09:00,['38ee403bf4a537ef276221033901690f099479c0'],52,131,183,4442542,3,0.260869565,0.217391304,0.594202899,3405
9e92e685b7a5390631e3ceb4347adffe4cfbd381,0,Jungtaek Lim,2017-02-04 08:20:35+09:00,"['38ee403bf4a537ef276221033901690f099479c0', 'bd6e0c5fbcebd1f3ac99e4095c3c492c39873455']",52,131,183,4442725,3,,,,3405
5d8f23026e1e19c37603252b12721b4d9f158c9c,0,Jungtaek Lim,2017-02-04 08:24:31+09:00,['9e92e685b7a5390631e3ceb4347adffe4cfbd381'],0,1,1,4442726,1,,,,3405
a7cdfefd7dc60df6c257c78f5dc908e815fd0812,0,vesense,2017-02-04 10:39:24+08:00,['5d8f23026e1e19c37603252b12721b4d9f158c9c'],1,2,3,4442729,1,,,,3405
fccdbf31d010a45d41b4ec8f83d7bbd511d082da,0,GitHub,2017-02-04 11:01:32+08:00,['a7cdfefd7dc60df6c257c78f5dc908e815fd0812'],1,1,2,4442731,1,,,,3405
01d7b6d081db98c284ed16036d0159faee2d0946,0,vesense,2017-02-06 10:29:36+08:00,['5d8f23026e1e19c37603252b12721b4d9f158c9c'],0,22,22,4442753,2,,,,3405
00b0fd75025b87c96fd535387964f16be42cb776,0,Jungtaek Lim,2017-02-07 10:23:16+09:00,"['a7cdfefd7dc60df6c257c78f5dc908e815fd0812', '37ee12ccd9a0465dc6cd6d2f9fb59929a798b6b5']",29,8671,8700,4451453,110,,,,3405
b5f02d4e4cac577454c379ca4e150c7ae47307be,0,Jungtaek Lim,2017-02-07 10:27:56+09:00,['00b0fd75025b87c96fd535387964f16be42cb776'],1,2,3,4451456,1,,,,3405
5be2ce8afb33bff926547da6034f16cdc909f4a0,0,Jungtaek Lim,2017-02-07 11:13:07+09:00,['b5f02d4e4cac577454c379ca4e150c7ae47307be'],1,1,2,4451458,1,,,,3405
7f1af22860e10f013b1bc2a7a11adb9a1fceb4f6,0,Jungtaek Lim,2017-02-07 11:13:13+09:00,"['b5f02d4e4cac577454c379ca4e150c7ae47307be', '5be2ce8afb33bff926547da6034f16cdc909f4a0']",1,1,2,4451460,1,,,,3405
b705d861b925e0a8e486449f01c594150021aae7,0,Jungtaek Lim,2017-02-07 11:14:41+09:00,['7f1af22860e10f013b1bc2a7a11adb9a1fceb4f6'],5,6,11,4451471,1,,,,3405
e59c28e6c22f162e3e0bb80c571f4235adb07969,0,vesense,2017-02-07 14:40:58+08:00,"['b705d861b925e0a8e486449f01c594150021aae7', '01d7b6d081db98c284ed16036d0159faee2d0946']",0,22,22,4451493,2,,,,3405
d3250b22f17bf98ffe97b00c9bdd2cdf0dc9eb8c,0,vesense,2017-02-07 14:44:16+08:00,['e59c28e6c22f162e3e0bb80c571f4235adb07969'],1,2,3,4451496,1,,,,3405
9daddac7389df3414325c0a80eac490c16bbf99a,0,GitHub,2017-02-07 16:46:08+08:00,['d3250b22f17bf98ffe97b00c9bdd2cdf0dc9eb8c'],1,1,2,4451498,1,,,,3405
07cf86e95a66e47cac41f67f5b269ab24758d8cb,1,Hugo Louro,2017-02-07 15:43:45-08:00,['d3250b22f17bf98ffe97b00c9bdd2cdf0dc9eb8c'],160,237,397,4451895,10,0,0,0.512195122,3405
469162639ece6e774f1e526c91b799b6cc85daec,0,Jungtaek Lim,2017-02-08 10:25:00+09:00,"['d3250b22f17bf98ffe97b00c9bdd2cdf0dc9eb8c', '07cf86e95a66e47cac41f67f5b269ab24758d8cb']",160,237,397,4452292,10,,,,3405
3e232e2fc70c8dcc1fa1f79e0e2b50dce37072b0,0,Jungtaek Lim,2017-02-08 11:11:24+09:00,['469162639ece6e774f1e526c91b799b6cc85daec'],0,1,1,4452293,1,,,,3405
677971d876f9ff35801cdaaf81a025f592c72059,1,Jungtaek Lim,2017-02-08 13:59:39+09:00,['3e232e2fc70c8dcc1fa1f79e0e2b50dce37072b0'],1,10,11,4452304,1,0,1,1,3405
ec5c9627c41babd1b404952608fabc99ed36b9cd,0,Jungtaek Lim,2017-02-08 14:31:54+09:00,['3e232e2fc70c8dcc1fa1f79e0e2b50dce37072b0'],0,17,17,4452321,1,,,,3405
18a8286fac462c4616f1550048231f315adc45ef,0,Paul Poulosky,2017-02-08 20:31:14+00:00,['ec5c9627c41babd1b404952608fabc99ed36b9cd'],1,2,3,4452324,1,1,1,1,3405
6c805c6562c3c98deb584cb1c9fb3435abd0692b,0,P. Taylor Goetz,2017-02-08 16:28:25-05:00,['2fb82999414d9f6d956c79d54ae907da87a6355a'],1,1,2,4452326,1,,,,3405
3985bb84037accee772844aa299caf35440293ec,0,P. Taylor Goetz,2017-02-08 16:29:02-05:00,['6c805c6562c3c98deb584cb1c9fb3435abd0692b'],0,1,1,4452327,1,,,,3405
560ff86ee0a42246d82d6d33c284a3711a0ea60f,0,P. Taylor Goetz,2017-02-08 16:30:48-05:00,"['3985bb84037accee772844aa299caf35440293ec', 'ec5c9627c41babd1b404952608fabc99ed36b9cd']",6678,27203,33881,4486208,480,,,,3405
1fd503daf589a221bb4e66bbf1f2982ed6d312ff,0,Hugo Louro,2017-02-08 21:04:54-08:00,['d3250b22f17bf98ffe97b00c9bdd2cdf0dc9eb8c'],37,230,267,4486475,3,0.85046729,0.644859813,0.859813084,3405
9bcd56677b0812642e5a0b7b14841cb66d1c5ca4,0,Jungtaek Lim,2017-02-09 14:33:42+09:00,"['560ff86ee0a42246d82d6d33c284a3711a0ea60f', '677971d876f9ff35801cdaaf81a025f592c72059']",1,10,11,4486486,1,,,,3405
ecbd21c00030f66783834fc00781bd13b49d7196,0,Robert (Bobby) Evans,2017-02-09 14:06:55-06:00,['4c5e34ee6399d8b19718bd7b75dc7c241a37a515'],30,341,371,4486857,9,0.429824561,0.51754386,1,3410
d6c3145b6c64c23c58fecce24dd15d02670cebf2,0,ambud,2017-02-09 15:04:34-06:00,['a7cdfefd7dc60df6c257c78f5dc908e815fd0812'],2,537,539,4487396,12,0.986961451,0.841269841,0.83106576,3419
4bbf0f394b58daa83b15130905735a81f87e4ac9,0,Jungtaek Lim,2017-02-10 12:02:38+09:00,"['9bcd56677b0812642e5a0b7b14841cb66d1c5ca4', 'd6c3145b6c64c23c58fecce24dd15d02670cebf2']",2,537,539,4487935,12,,,,3419
3fd66b5e842f68f99bab3bf6ad0fea045c8d0d17,0,Jungtaek Lim,2017-02-10 12:41:37+09:00,['4bbf0f394b58daa83b15130905735a81f87e4ac9'],0,1,1,4487936,1,,,,3419
914a4768c9a8aa0320b49ff4bfb1ec338bf1d042,1,Jungtaek Lim,2017-02-14 11:25:49+09:00,['3fd66b5e842f68f99bab3bf6ad0fea045c8d0d17'],15,50,65,4488001,2,0.111111111,0,1,3419
714ace234711e44ca18f960d42a05ad2b39beee5,0,Jungtaek Lim,2017-02-14 11:27:22+09:00,"['3fd66b5e842f68f99bab3bf6ad0fea045c8d0d17', '914a4768c9a8aa0320b49ff4bfb1ec338bf1d042']",15,50,65,4488066,2,,,,3419
db4695d2dd11c564f530177a1090a6dc23db3db4,0,Jungtaek Lim,2017-02-14 11:54:45+09:00,['714ace234711e44ca18f960d42a05ad2b39beee5'],0,1,1,4488067,1,,,,3419
6e75016c45c602c874086dea26324ca413f0c141,1,Stig Rohde D酶ssing,2017-02-14 21:31:45+01:00,['db4695d2dd11c564f530177a1090a6dc23db3db4'],387,524,911,4488978,13,0.641025641,1,1,3420
b89984c225f3a44d9231fa3dc43e451f3c6a2746,0,Robert (Bobby) Evans,2017-02-15 14:11:17-06:00,['ecbd21c00030f66783834fc00781bd13b49d7196'],0,31,31,4489009,1,,,,3420
b8e458f4a0eb5c79e6099b52a7acf9268b7b655e,0,P. Taylor Goetz,2017-02-15 16:33:21-05:00,"['560ff86ee0a42246d82d6d33c284a3711a0ea60f', '6e75016c45c602c874086dea26324ca413f0c141']",404,1122,1526,4490535,28,,,,3420
d235a0c1b49a4ead966d2288e81058495d2ada44,0,P. Taylor Goetz,2017-02-15 16:34:13-05:00,['b8e458f4a0eb5c79e6099b52a7acf9268b7b655e'],1,2,3,4490538,1,,,,3420
83fe7805f36f2dd9c85619f7e7d5af9e90b6dd6e,0,Arun Mahadevan,2017-02-16 14:14:04+05:18,['d235a0c1b49a4ead966d2288e81058495d2ada44'],1,16,17,4490555,2,1,1,1,3420
622b9507e2ac6740852d5c57c918a5b79fb6549b,0,Satish Duggana,2017-02-17 15:33:33+05:18,['83fe7805f36f2dd9c85619f7e7d5af9e90b6dd6e'],0,1,1,4490556,1,,,,3420
b5053a622008b47812a1d06c5602a48b8d391cfe,0,Jungtaek Lim,2017-02-20 09:52:04+09:00,['622b9507e2ac6740852d5c57c918a5b79fb6549b'],0,4,4,4490560,1,,,,3420
7903f9d5e00341930e88e254e6355df03df3a16e,0,Arun Mahadevan,2017-02-21 21:31:07+05:18,['9bcd56677b0812642e5a0b7b14841cb66d1c5ca4'],0,475,475,4491035,1,,,,3421
86e0f5268e892a8c897576e9c63254414757a9cf,1,Robert (Bobby) Evans,2017-02-21 15:25:18-06:00,['b89984c225f3a44d9231fa3dc43e451f3c6a2746'],106,133,239,4491274,8,1,1,0,3421
0d9737547d38400c37b534fd54cce141fa51ead2,0,Robert (Bobby) Evans,2017-02-21 16:26:33-06:00,['86e0f5268e892a8c897576e9c63254414757a9cf'],0,5,5,4491279,1,0,0,1,3421
a64f135d2859d178e4645787e99638a84e1b192f,1,Kyle Nusbaum,2017-02-21 17:14:09-06:00,['15887ee3db6d6757fb00ce107d6d6b24af02589c'],7,28,35,4491314,2,0.047619048,0,1,3421
a76bbd703c2e29a76ec41f904ea8b02cedc293a7,0,Satish Duggana,2017-02-22 05:19:47+05:18,"['b5053a622008b47812a1d06c5602a48b8d391cfe', '7903f9d5e00341930e88e254e6355df03df3a16e']",0,475,475,4491789,1,,,,3421
4986373c5ca8d8e3d6903dd479c4442451c49655,0,Satish Duggana,2017-02-22 05:31:55+05:18,['a76bbd703c2e29a76ec41f904ea8b02cedc293a7'],0,1,1,4491790,1,,,,3421
913d0c15d364195760239a93e4efeb1c2550f975,0,Jungtaek Lim,2017-02-22 16:36:10+09:00,['4986373c5ca8d8e3d6903dd479c4442451c49655'],18,32,50,4491840,1,0,0,1,3421
313e960bedde3b2c47520a74c391425d79271727,0,Jungtaek Lim,2017-02-22 16:37:24+09:00,"['4986373c5ca8d8e3d6903dd479c4442451c49655', '913d0c15d364195760239a93e4efeb1c2550f975']",18,32,50,4491890,1,,,,3421
2833e30616c2fc8da4f5f8f8b278a80c0d2832dc,0,Jungtaek Lim,2017-02-22 16:38:50+09:00,['313e960bedde3b2c47520a74c391425d79271727'],0,3,3,4491893,1,,,,3421
debb3b81e88104fa63c21be473f883352ae13c03,0,Robert (Bobby) Evans,2017-02-22 10:26:53-06:00,['0d9737547d38400c37b534fd54cce141fa51ead2'],20,60,80,4491973,2,0,0,0,3421
6839fec10b94a56f6d9614547f4cabafcd9b355a,0,Kyle Nusbaum,2017-02-22 12:26:31-06:00,['a64f135d2859d178e4645787e99638a84e1b192f'],2,2,4,4491977,1,,,,3421
a1148955f1b84bbfecb939dfa656ef5e1fc15acd,0,Hugo Louro,2017-02-22 15:03:16-08:00,['2833e30616c2fc8da4f5f8f8b278a80c0d2832dc'],1,3,4,4491981,1,,,,3421
16bf6c0ff0a2fb444130690ac1f5d9c9b6de89db,0,Jungtaek Lim,2017-02-23 18:27:31+09:00,['4986373c5ca8d8e3d6903dd479c4442451c49655'],4,26,30,4492011,1,,,,3421
408bdb90019e3f5e4f4e14edfd49686d823b733f,0,Jungtaek Lim,2017-02-23 18:45:03+09:00,"['2833e30616c2fc8da4f5f8f8b278a80c0d2832dc', '16bf6c0ff0a2fb444130690ac1f5d9c9b6de89db']",4,26,30,4492041,1,,,,3421
c01b04d4d772b1bdb779cb5d2649620ad82d4b18,0,Robert (Bobby) Evans,2017-02-23 09:54:46-06:00,['debb3b81e88104fa63c21be473f883352ae13c03'],0,11,11,4492052,1,0.428571429,0.428571429,1,3421
469f0256dc639c26b92cc8c1fc97789ca176ece0,0,Kyle Nusbaum,2017-02-23 10:48:34-06:00,['6839fec10b94a56f6d9614547f4cabafcd9b355a'],0,0,0,4492052,0,,,,3421
9e898247845f99392fe0b714a6df39fe2cfc5fe7,1,Arun Mahadevan,2017-02-24 13:47:02+05:18,['408bdb90019e3f5e4f4e14edfd49686d823b733f'],23,1177,1200,4493252,9,0.715771231,0.878682842,0.783362218,3425
03e6b841960d7061de6a7dbd01e24dc535594819,0,Arun Mahadevan,2017-02-24 13:50:22+05:18,['9e898247845f99392fe0b714a6df39fe2cfc5fe7'],1,2,3,4493255,2,,,,3425
2c6ab5aa68b8ac008ed3a1a379a997e881f1a4bc,0,P. Taylor Goetz,2017-02-24 13:15:17-05:00,"['03e6b841960d7061de6a7dbd01e24dc535594819', '469f0256dc639c26b92cc8c1fc97789ca176ece0']",8,29,37,4493292,2,,,,3425
c73c17a3e13ed61c2add1f5701bd28566f72c6f0,0,P. Taylor Goetz,2017-02-24 13:15:54-05:00,['2c6ab5aa68b8ac008ed3a1a379a997e881f1a4bc'],0,1,1,4493293,1,,,,3425
bbffd8b0e7d53b5400d4741973315b117f43d5bd,0,P. Taylor Goetz,2017-02-24 13:24:22-05:00,"['c73c17a3e13ed61c2add1f5701bd28566f72c6f0', 'a1148955f1b84bbfecb939dfa656ef5e1fc15acd']",1,3,4,4493297,1,,,,3425
8295e5df56c832d941e82f271e7e5d6c85485234,0,P. Taylor Goetz,2017-02-24 13:24:49-05:00,['bbffd8b0e7d53b5400d4741973315b117f43d5bd'],0,1,1,4493298,1,,,,3425
71c35ddc3642b91699f52243b1a0a6c6c04751e8,0,P. Taylor Goetz,2017-02-24 13:38:49-05:00,['8295e5df56c832d941e82f271e7e5d6c85485234'],0,0,0,4493298,0,,,,3425
0201af3648ff8bed897ad79e4fbf61e9f942c110,0,Hiro Kuwabara,2017-02-24 11:53:05-08:00,['71c35ddc3642b91699f52243b1a0a6c6c04751e8'],0,10,10,4493308,1,1,1,1,3425
290a4271bcaa73ebc8d570da63a23dcad6074df3,0,Sriharsha Chintalapani,2017-02-24 19:27:47-08:00,"['71c35ddc3642b91699f52243b1a0a6c6c04751e8', '9daddac7389df3414325c0a80eac490c16bbf99a']",1,1,2,4493310,1,,,,3425
b73a772e23ec8fe1101e9d8e960c282a4139352e,0,Sriharsha Chintalapani,2017-02-24 19:33:39-08:00,"['290a4271bcaa73ebc8d570da63a23dcad6074df3', '8ab4fd05ed5ed95c7a5bb7356fe228c14a8d86d7']",3,0,3,4493313,2,,,,3425
8224c6b60957f9e0ddd208c98d4819e30e78fe51,0,Sriharsha Chintalapani,2017-02-26 11:27:50-08:00,"['b73a772e23ec8fe1101e9d8e960c282a4139352e', '0201af3648ff8bed897ad79e4fbf61e9f942c110']",0,10,10,4493323,1,,,,3425
34406ec81d0257847bf8b7984edd5406d51b7f29,0,Sriharsha Chintalapani,2017-02-26 11:29:10-08:00,['8224c6b60957f9e0ddd208c98d4819e30e78fe51'],0,1,1,4493324,1,,,,3425
71195780e872b45f592c5d30b87626852bd71d3e,0,Julien Nioche,2017-02-27 11:31:47+00:00,['34406ec81d0257847bf8b7984edd5406d51b7f29'],2,2,4,4493328,1,,,,3425
3a0e953a27e21fed2ddee219e8bc08e92d51d586,0,Robert (Bobby) Evans,2017-02-27 09:51:56-06:00,"['34406ec81d0257847bf8b7984edd5406d51b7f29', 'c01b04d4d772b1bdb779cb5d2649620ad82d4b18']",62,487,549,4493877,12,,,,3425
f0bfe0d3d1e7446a9de289e0b07d84885eaf01ff,0,Robert (Bobby) Evans,2017-02-27 10:03:31-06:00,['3a0e953a27e21fed2ddee219e8bc08e92d51d586'],0,1,1,4493878,1,,,,3425
ca58d5437105cbd79504f06ce4aa65755d05d32b,0,Robert (Bobby) Evans,2017-02-27 12:11:29-06:00,['f0bfe0d3d1e7446a9de289e0b07d84885eaf01ff'],1,11,12,4493890,1,1,1,1,3425
92da0c5635c8cee378aac46383847e4530e51bc4,0,Jungtaek Lim,2017-02-28 12:29:39+09:00,['f0bfe0d3d1e7446a9de289e0b07d84885eaf01ff'],3,1,4,4493894,1,1,1,0,3425
26cc63813f35f4378934a5e5142f44858228c7fc,1,Jungtaek Lim,2017-03-02 17:06:27+09:00,['f0bfe0d3d1e7446a9de289e0b07d84885eaf01ff'],103,168,271,4494165,27,0,1,1,3426
1901434e7b79901b747c025654f17f6d322572fd,0,Jungtaek Lim,2017-03-02 19:07:33+09:00,['f0bfe0d3d1e7446a9de289e0b07d84885eaf01ff'],1,3,4,4494169,1,1,1,1,3426
0bd70fd3b7bc0dfa7dadec870c8811263d00bac3,0,Sriharsha Chintalapani,2017-03-03 14:12:14-08:00,['92da0c5635c8cee378aac46383847e4530e51bc4'],0,1,1,4494170,1,,,,3426
42152f4930068b6cd91dc36ddd4f13938109c8e2,0,Jungtaek Lim,2017-03-04 11:24:52+09:00,"['0bd70fd3b7bc0dfa7dadec870c8811263d00bac3', '1901434e7b79901b747c025654f17f6d322572fd']",1,3,4,4494174,1,,,,3426
eb0e0edfedab2def9f05f867c3a98c1d24e18d7b,0,Jungtaek Lim,2017-03-04 11:26:55+09:00,['42152f4930068b6cd91dc36ddd4f13938109c8e2'],5,4,9,4494183,1,,,,3426
62f14b89630bf498cc77808524b52daa101a14bb,0,Jungtaek Lim,2017-03-04 11:45:13+09:00,['eb0e0edfedab2def9f05f867c3a98c1d24e18d7b'],10,59,69,4494252,1,0.113636364,0.113636364,1,3426
6d15fcd7ec5c5f5e684d24f8cf5a588836bfb3db,0,Jungtaek Lim,2017-03-04 11:45:17+09:00,"['eb0e0edfedab2def9f05f867c3a98c1d24e18d7b', '62f14b89630bf498cc77808524b52daa101a14bb']",10,59,69,4494321,1,,,,3426
b7fe860779f513125d8372b906d95e35faacb3a5,0,Jungtaek Lim,2017-03-04 11:57:17+09:00,['6d15fcd7ec5c5f5e684d24f8cf5a588836bfb3db'],0,1,1,4494322,1,,,,3426
eb6c308925b2a4cd89031a2a6b951976deb6262f,0,Magnus Koch,2017-03-06 11:39:34+01:00,['b7fe860779f513125d8372b906d95e35faacb3a5'],37,2261,2298,4496620,20,0.629145729,0.787939698,0.84321608,3442
f2eb6af918d6f4346985644e9744c2b1ebce0a51,0,Jungtaek Lim,2017-03-07 12:10:10+09:00,"['b7fe860779f513125d8372b906d95e35faacb3a5', '71195780e872b45f592c5d30b87626852bd71d3e']",2,2,4,4496624,1,,,,3442
129b2979c0b0cf58ebe538510f6775473a282d15,0,ikashperskyi,2017-03-07 20:10:53+01:00,['b7fe860779f513125d8372b906d95e35faacb3a5'],0,1,1,4496625,1,1,1,1,3442
ae8ef6f131e4e81fb134a839d2c02406c26d752e,0,Jungtaek Lim,2017-03-08 08:45:37+09:00,['f2eb6af918d6f4346985644e9744c2b1ebce0a51'],1,7,8,4496633,1,,,,3442
fc69a1cb490171811797056eebd7428966c431b8,0,Jungtaek Lim,2017-03-08 08:45:43+09:00,"['f2eb6af918d6f4346985644e9744c2b1ebce0a51', 'ae8ef6f131e4e81fb134a839d2c02406c26d752e']",1,7,8,4496641,1,,,,3442
5c59e0632108847a0ba7dacf43eff9ac477b00d7,0,Sriharsha Chintalapani,2017-03-07 19:56:08-08:00,['fc69a1cb490171811797056eebd7428966c431b8'],0,16591,16591,4513232,31,0.578454333,0.915690867,0.911007026,3471
4fcd37829a63feda5a8e42b96239cf05c49bf08d,0,Sriharsha Chintalapani,2017-03-07 19:56:37-08:00,['5c59e0632108847a0ba7dacf43eff9ac477b00d7'],2,3,5,4513237,2,,,,3471
abe3ff7f30100087016b0b9418bb5756770609df,0,Satish Duggana,2017-03-08 12:01:40+05:18,['4fcd37829a63feda5a8e42b96239cf05c49bf08d'],12,10,22,4513259,2,1,1,1,3471
40a2780c58e7e59cacdb04e848342f42bd778226,1,Satish Duggana,2017-03-08 12:30:19+05:18,['abe3ff7f30100087016b0b9418bb5756770609df'],9,9,18,4513277,4,,,,3471
bde9ba4584ebc742e51c378deaab296a3c7d5677,0,Kyle Nusbaum,2017-03-08 15:53:37-06:00,"['abe3ff7f30100087016b0b9418bb5756770609df', '18a8286fac462c4616f1550048231f315adc45ef']",1,2,3,4513280,1,,,,3471
655995962493031e0758f841bdeb4fb43c6c9950,0,Kyle Nusbaum,2017-03-08 15:54:16-06:00,['bde9ba4584ebc742e51c378deaab296a3c7d5677'],0,1,1,4513281,1,,,,3471
9075ab2d80ed283459b3942e36bf67aa21e14bde,0,Jungtaek Lim,2017-03-09 13:51:20+09:00,"['655995962493031e0758f841bdeb4fb43c6c9950', '129b2979c0b0cf58ebe538510f6775473a282d15']",0,1,1,4513282,1,,,,3471
c70c5890bc04c8fe94ccd7673fb49d53af3307ed,0,Jungtaek Lim,2017-03-09 13:51:51+09:00,['9075ab2d80ed283459b3942e36bf67aa21e14bde'],0,1,1,4513283,1,,,,3471
f94254b534554407c4067192e1b18fe24f6a5a5d,0,Jungtaek Lim,2017-03-09 14:04:16+09:00,"['c70c5890bc04c8fe94ccd7673fb49d53af3307ed', '40a2780c58e7e59cacdb04e848342f42bd778226']",9,9,18,4513301,4,,,,3471
74d836f41555aeb5006e8c27105bd06334696c52,0,Jungtaek Lim,2017-03-09 14:04:43+09:00,['f94254b534554407c4067192e1b18fe24f6a5a5d'],0,1,1,4513302,1,,,,3471
d90effbb45255ea7e1c161c8ef3f1a2be620ac4d,0,Jungtaek Lim,2017-03-09 14:22:02+09:00,['74d836f41555aeb5006e8c27105bd06334696c52'],1,1,2,4513304,1,,,,3471
902ee81364a0652c4985437bfdf517d3ec6d85ea,0,Jungtaek Lim,2017-03-09 14:22:07+09:00,"['74d836f41555aeb5006e8c27105bd06334696c52', 'd90effbb45255ea7e1c161c8ef3f1a2be620ac4d']",1,1,2,4513306,1,,,,3471
4d595fd1b9b738d31c2a0a7bba7f17f4ab818d7d,0,Jungtaek Lim,2017-03-09 14:22:27+09:00,['902ee81364a0652c4985437bfdf517d3ec6d85ea'],0,1,1,4513307,1,,,,3471
e444985599250e39f5aea95a00d38870876a71a0,0,Jungtaek Lim,2017-03-09 14:28:31+09:00,"['4d595fd1b9b738d31c2a0a7bba7f17f4ab818d7d', 'fccdbf31d010a45d41b4ec8f83d7bbd511d082da']",1,1,2,4513309,1,,,,3471
4baff3a55963a542caf917719ff90739fde38f3a,0,Jungtaek Lim,2017-03-09 14:32:25+09:00,"['e444985599250e39f5aea95a00d38870876a71a0', '26cc63813f35f4378934a5e5142f44858228c7fc']",103,168,271,4513580,27,,,,3471
e4f05c21960e8330a751b5cf4976796e8c5652b4,0,Jungtaek Lim,2017-03-09 14:34:19+09:00,['4baff3a55963a542caf917719ff90739fde38f3a'],0,1,1,4513581,1,,,,3471
94738460ca3f498bdac2b610af350692cfb5a525,1,lukess,2017-03-08 23:29:08-08:00,['e4f05c21960e8330a751b5cf4976796e8c5652b4'],17,202,219,4513800,4,1,1,1,3473
15eefbeadcc4729afa11675a5a0791e86ad9dcbf,0,Jungtaek Lim,2017-03-09 19:28:18+09:00,"['e4f05c21960e8330a751b5cf4976796e8c5652b4', '94738460ca3f498bdac2b610af350692cfb5a525']",17,202,219,4514019,4,,,,3473
d6b69a7cad3ccda634e06dbabdc52338a03b5a8b,0,Jungtaek Lim,2017-03-09 19:35:35+09:00,['15eefbeadcc4729afa11675a5a0791e86ad9dcbf'],0,1,1,4514020,1,,,,3473
cc590a263a42e0c624efcc8bcb8d0729f14b7e27,0,Jungtaek Lim,2017-03-10 01:15:15+09:00,['d6b69a7cad3ccda634e06dbabdc52338a03b5a8b'],2,2,4,4514024,1,,,,3473
83a342f6f812d41052fa56c82b349a53316792bf,0,Jungtaek Lim,2017-03-10 01:26:20+09:00,['d6b69a7cad3ccda634e06dbabdc52338a03b5a8b'],0,21,21,4514045,1,1,1,1,3473
e7fe74d95d25eb9f98cc3fb3d871aaed27ff38a6,0,Jungtaek Lim,2017-03-10 01:26:27+09:00,"['d6b69a7cad3ccda634e06dbabdc52338a03b5a8b', '83a342f6f812d41052fa56c82b349a53316792bf']",0,21,21,4514066,1,,,,3473
9daa6a1e34558baee7fbaa3163a2002eaf644b00,0,Jungtaek Lim,2017-03-10 01:28:35+09:00,['e7fe74d95d25eb9f98cc3fb3d871aaed27ff38a6'],0,1,1,4514067,1,,,,3473
53355ded0639f3471d44ad4cb47f04b67b86db30,0,Satish Duggana,2017-03-11 06:18:56+05:18,"['9daa6a1e34558baee7fbaa3163a2002eaf644b00', '1fd503daf589a221bb4e66bbf1f2982ed6d312ff']",37,230,267,4514334,3,,,,3473
f66a04e550146b6c97cb492396d7662b87ca1af4,0,Satish Duggana,2017-03-11 06:20:21+05:18,['53355ded0639f3471d44ad4cb47f04b67b86db30'],0,1,1,4514335,1,,,,3473
45cec010289fd23231e339209ff55b3f8d7e512c,0,lukess,2017-03-10 17:54:57-08:00,['f66a04e550146b6c97cb492396d7662b87ca1af4'],2,5,7,4514342,1,,,,3473
a859d3ee943d20a4d66a969cf4af2b4c2be5199c,0,Jungtaek Lim,2017-03-13 16:47:56+09:00,"['f66a04e550146b6c97cb492396d7662b87ca1af4', 'cc590a263a42e0c624efcc8bcb8d0729f14b7e27']",2,2,4,4514346,1,,,,3473
62d02eff4b6a457d091bd95b26ec4f328182f8e8,0,Jungtaek Lim,2017-03-13 16:48:41+09:00,['a859d3ee943d20a4d66a969cf4af2b4c2be5199c'],0,1,1,4514347,1,,,,3473
aa27a372836e79acd0c814714c0ad06254e9bb86,0,Jungtaek Lim,2017-03-13 17:18:00+09:00,"['62d02eff4b6a457d091bd95b26ec4f328182f8e8', '45cec010289fd23231e339209ff55b3f8d7e512c']",2,5,7,4514354,1,,,,3473
cf581cba7a23029ff7ba33e218a9ec1e6f92246d,0,Jungtaek Lim,2017-03-13 17:39:13+09:00,['aa27a372836e79acd0c814714c0ad06254e9bb86'],0,1,1,4514355,1,,,,3473
d3976e5242c122fb42049fdd612a23fed620ea54,0,Roshan Naik,2017-03-13 22:41:09-07:00,['cf581cba7a23029ff7ba33e218a9ec1e6f92246d'],1,1,2,4514357,1,,,,3473
fd7c62ac0b40b4e5be97c76f94e4c1598c55ee53,0,Arun Mahadevan,2017-03-15 11:32:22+05:18,['cf581cba7a23029ff7ba33e218a9ec1e6f92246d'],1,5,6,4514363,3,0,0,0.75,3473
943bef622239d31fb1a2b7a8c27e478c8969602d,0,Satish Duggana,2017-03-15 16:31:51+05:18,['fd7c62ac0b40b4e5be97c76f94e4c1598c55ee53'],0,1,1,4514364,1,,,,3473
dd6a7d1613d2084b5005fe7009eaa43220dcd468,1,Hugo Louro,2017-03-15 17:30:34-07:00,['943bef622239d31fb1a2b7a8c27e478c8969602d'],70,150,220,4514584,5,0,0.857142857,0.897959184,3473
cd3b93093b3a3ef85e9acffc4cd350ec1e3640de,1,Hugo Louro,2017-03-15 20:52:16-07:00,['943bef622239d31fb1a2b7a8c27e478c8969602d'],90,74,164,4514748,7,1,1,0,3473
927f7e62e142f8cd9755bb39e40c91e128477138,1,Hugo Louro,2017-03-15 23:09:15-07:00,['943bef622239d31fb1a2b7a8c27e478c8969602d'],8,13,21,4514769,2,,,,3473
1b82c5767b7ea0ea0a57fe48fbada1a1d8707944,0,Robert Evans,2017-03-16 10:43:03-05:00,"['943bef622239d31fb1a2b7a8c27e478c8969602d', 'ca58d5437105cbd79504f06ce4aa65755d05d32b']",1,11,12,4514781,1,,,,3473
0946048eb578b2f3e8dc16d653ce58c14c736f26,0,Robert Evans,2017-03-16 12:00:19-05:00,['1b82c5767b7ea0ea0a57fe48fbada1a1d8707944'],0,3,3,4514784,1,,,,3473
1c9063756fe9e268676234757d54994aacfc0b7b,1,Robert (Bobby) Evans,2017-03-16 12:07:05-05:00,['0946048eb578b2f3e8dc16d653ce58c14c736f26'],35,83,118,4514902,8,0.3,0.333333333,0.566666667,3473
b000a988b3f333f0f54f72b1dc1315a5222240fd,0,Robert (Bobby) Evans,2017-03-16 12:08:01-05:00,['1c9063756fe9e268676234757d54994aacfc0b7b'],1,1,2,4514904,1,,,,3473
525f14f64b112cb6e73788a0e97dad56048c876d,0,Robert (Bobby) Evans,2017-03-17 13:31:58-05:00,['0946048eb578b2f3e8dc16d653ce58c14c736f26'],31,60,91,4514995,1,0.19047619,1,0.428571429,3473
de47cebd42b3d76c5bc3012f96becde439e84fbb,0,Jungtaek Lim,2017-03-20 16:35:34+09:00,"['cf581cba7a23029ff7ba33e218a9ec1e6f92246d', 'b000a988b3f333f0f54f72b1dc1315a5222240fd']",37,103,140,4515135,12,,,,3473
c2cb25b959cc6d3c275916538bba2951d053966f,0,Jungtaek Lim,2017-03-20 16:53:12+09:00,['de47cebd42b3d76c5bc3012f96becde439e84fbb'],0,1,1,4515136,1,,,,3473
0c689b1c6d0df7ddf1c4cf4bb47fb29b08e0a14f,0,Jungtaek Lim,2017-03-20 17:39:25+09:00,['c2cb25b959cc6d3c275916538bba2951d053966f'],7,38,45,4515181,1,0.086956522,1,0.782608696,3473
79284b8e97e0a939216dd5f1f2c9500fb2762268,0,Jungtaek Lim,2017-03-20 17:39:35+09:00,"['c2cb25b959cc6d3c275916538bba2951d053966f', '0c689b1c6d0df7ddf1c4cf4bb47fb29b08e0a14f']",7,38,45,4515226,1,,,,3473
809c4b2a95a13a02164b526ce83b9d8f9ca75655,0,Jungtaek Lim,2017-03-20 17:39:59+09:00,['79284b8e97e0a939216dd5f1f2c9500fb2762268'],0,1,1,4515227,1,,,,3473
3ce63b8551bd710451308f5d6e140a1a622564e4,0,Arun Mahadevan,2017-03-20 14:26:20+05:18,['809c4b2a95a13a02164b526ce83b9d8f9ca75655'],14,19,33,4515260,1,1,1,1,3473
25249cade060ac8d463d1d397b8f172e5b021a18,0,Jungtaek Lim,2017-03-20 18:31:41+09:00,"['809c4b2a95a13a02164b526ce83b9d8f9ca75655', '525f14f64b112cb6e73788a0e97dad56048c876d']",31,60,91,4515351,1,,,,3473
c4bb1246387b34f847f546896bfb22ebebfc3492,0,Jungtaek Lim,2017-03-20 18:32:34+09:00,['25249cade060ac8d463d1d397b8f172e5b021a18'],0,1,1,4515352,1,,,,3473
58c841159fa6c94a04a95d2509cbb6612d90d7d8,0,Jungtaek Lim,2017-03-20 18:40:35+09:00,"['c4bb1246387b34f847f546896bfb22ebebfc3492', '927f7e62e142f8cd9755bb39e40c91e128477138']",8,13,21,4515373,2,,,,3473
e0f1f869b2f7337b44275f14e581dc4f4c13dc2e,0,Jungtaek Lim,2017-03-20 19:24:13+09:00,"['58c841159fa6c94a04a95d2509cbb6612d90d7d8', 'd3976e5242c122fb42049fdd612a23fed620ea54']",1,1,2,4515375,1,,,,3473
f5a362a6e0410935ffce4160e34ecee7baed25f0,0,Jungtaek Lim,2017-03-20 19:24:36+09:00,['e0f1f869b2f7337b44275f14e581dc4f4c13dc2e'],0,1,1,4515376,1,,,,3473
c2c9559f0cac2049a83b026209610bd99dcf6a8e,0,Sriharsha Chintalapani,2017-03-20 10:27:13-07:00,"['f5a362a6e0410935ffce4160e34ecee7baed25f0', 'cd3b93093b3a3ef85e9acffc4cd350ec1e3640de']",90,74,164,4515540,7,,,,3473
17783d5e061b887b87a03c18a0485e6d0f6f2baa,0,Sriharsha Chintalapani,2017-03-20 10:57:29-07:00,['c2c9559f0cac2049a83b026209610bd99dcf6a8e'],0,1,1,4515541,1,,,,3473
034019e6bcb4fa4f633a00656896bc4b0716684a,0,Satish Duggana,2017-03-21 09:35:10+05:18,['17783d5e061b887b87a03c18a0485e6d0f6f2baa'],5,21,26,4515567,4,1,0,0,3473
9c5f5129448dcd6a3c94514c56df4cf77462dc79,0,Satish Duggana,2017-03-21 10:13:28+05:18,['034019e6bcb4fa4f633a00656896bc4b0716684a'],0,1,1,4515568,1,,,,3473
f0a52862e340dde5849d06fd7984e0d308f14291,0,Arun Mahadevan,2017-03-21 10:33:00+05:18,['17783d5e061b887b87a03c18a0485e6d0f6f2baa'],4,4,8,4515576,3,,,,3473
3186330e6a6e2565972751cc28a87f307797b8ba,0,Arun Mahadevan,2017-03-21 10:33:09+05:18,['f0a52862e340dde5849d06fd7984e0d308f14291'],5,35,40,4515616,4,0,0,0,3473
b1ee165c68ecb6e8f50993c4181a70ff011da145,0,Arun Mahadevan,2017-03-21 10:36:11+05:18,['3186330e6a6e2565972751cc28a87f307797b8ba'],2,2,4,4515620,1,,,,3473
80a64640aa66543cc9ddcbe9d119bc22bfd9b1ba,0,Satish Duggana,2017-03-21 10:57:47+05:18,"['9c5f5129448dcd6a3c94514c56df4cf77462dc79', 'dd6a7d1613d2084b5005fe7009eaa43220dcd468']",70,150,220,4515840,5,,,,3473
f4298176015404bbc08bef2593cbbcb729180b5d,0,Satish Duggana,2017-03-21 12:07:50+05:18,['80a64640aa66543cc9ddcbe9d119bc22bfd9b1ba'],0,1,1,4515841,1,,,,3473
0d40fa9e9587b6ee9003bcea72a668614df432c9,0,Satish Duggana,2017-03-21 14:38:00+05:18,"['f4298176015404bbc08bef2593cbbcb729180b5d', '3ce63b8551bd710451308f5d6e140a1a622564e4']",14,19,33,4515874,1,,,,3473
c722940b68b34ef8ea8f07017c1fb7af6df2e6d4,0,Satish Duggana,2017-03-21 14:38:51+05:18,['0d40fa9e9587b6ee9003bcea72a668614df432c9'],0,1,1,4515875,1,,,,3473
0ad48919a91d3c7a6a856e81ed7f3a289151506a,0,David Judd,2017-03-21 16:02:01-07:00,['c722940b68b34ef8ea8f07017c1fb7af6df2e6d4'],3,23,26,4515901,2,1,1,1,3473
34aea04150747df459fff02975bde2e39d93a2c5,0,Satish Duggana,2017-03-22 09:54:17+05:18,"['c722940b68b34ef8ea8f07017c1fb7af6df2e6d4', 'b1ee165c68ecb6e8f50993c4181a70ff011da145']",8,38,46,4515947,5,,,,3473
e3204bc16ce87a2cf7e0e6370f616c02fcd78e96,0,Satish Duggana,2017-03-22 09:56:02+05:18,['34aea04150747df459fff02975bde2e39d93a2c5'],0,1,1,4515948,1,,,,3473
389865a394a05fe45fd9071c9806625bf24b1280,0,Hugo Louro,2017-03-23 19:02:17-07:00,['e3204bc16ce87a2cf7e0e6370f616c02fcd78e96'],0,10,10,4515958,2,,,,3473
37665b5c51cae70ae021ff8ab2f1d43b1e1d607b,0,GitHub,2017-03-24 12:56:08+03:00,['e3204bc16ce87a2cf7e0e6370f616c02fcd78e96'],12,12,24,4515982,1,,,,3473
4950cafaedaefed519f8324fbc21fe6e3213ec35,0,Heather McCartney,2017-03-25 20:16:07+00:00,['389865a394a05fe45fd9071c9806625bf24b1280'],0,2,2,4515984,1,,,,3473
38f866c64c9bb1c55109a122c8ea3dc1a3b4b09b,1,Satish Duggana,2017-03-26 22:10:19+05:18,['389865a394a05fe45fd9071c9806625bf24b1280'],4,10,14,4515998,1,0.75,0.75,1,3473
21f365ea333d3a75eebce7bbb1e3a1ae68be8f86,0,Satish Duggana,2017-03-26 22:12:14+05:18,['38f866c64c9bb1c55109a122c8ea3dc1a3b4b09b'],0,1,1,4515999,1,,,,3473
457f422fe48744771722e4bd3ba781d6d915f2e2,0,Aki M盲kinen,2017-03-27 22:55:09+03:00,['21f365ea333d3a75eebce7bbb1e3a1ae68be8f86'],46,76,122,4516121,1,1,1,1,3473
5913d160fa38efc3e8888e761e075582ba8c8a5f,0,Aki M盲kinen,2017-03-28 18:19:06+03:00,['457f422fe48744771722e4bd3ba781d6d915f2e2'],9,8,17,4516138,1,0,0,0,3473
488c38b61f4bb29209cbf3eb5e64b9d104446ab5,0,鍒樺厗鍧?0206665,2017-03-29 12:04:36+08:00,['21f365ea333d3a75eebce7bbb1e3a1ae68be8f86'],2,2,4,4516142,1,,,,3473
547cb108254e144bdf5a7dc0ccad95cbb7f4c4d6,1,Robert (Bobby) Evans,2017-04-01 10:35:39-05:00,['21f365ea333d3a75eebce7bbb1e3a1ae68be8f86'],3,3,6,4516148,1,,,,3473
5459995f99e5acbcf273e3b5dd1a02b92439e3e7,0,alexlehm,2017-04-02 12:49:01+02:00,['21f365ea333d3a75eebce7bbb1e3a1ae68be8f86'],6,7,13,4516161,1,,,,3473
4ffed19b04401d0aaeefeb3bb8f73b6f7ede101f,1,alexlehm,2017-04-02 15:04:10+02:00,['21f365ea333d3a75eebce7bbb1e3a1ae68be8f86'],0,10,10,4516171,1,,,,3473
098265b42fe7d5759ce00ef55184129dfdf9049e,0,Robert Evans,2017-04-03 10:49:25-05:00,"['21f365ea333d3a75eebce7bbb1e3a1ae68be8f86', '547cb108254e144bdf5a7dc0ccad95cbb7f4c4d6']",3,3,6,4516177,1,,,,3473
28c8711e792b03c8363bb58c34d3c7768d263cc6,0,Robert Evans,2017-04-03 12:56:45-05:00,['098265b42fe7d5759ce00ef55184129dfdf9049e'],0,1,1,4516178,1,,,,3473
2a369e408c18adf1045f57382d30fe18dacdbb19,1,Jungtaek Lim,2017-04-04 18:37:10+09:00,['28c8711e792b03c8363bb58c34d3c7768d263cc6'],941,332,1273,4517451,130,,,,3473
22d2d9163772e494f9565946bba056000648fdd8,0,Jungtaek Lim,2017-04-04 22:04:23+09:00,"['28c8711e792b03c8363bb58c34d3c7768d263cc6', '4ffed19b04401d0aaeefeb3bb8f73b6f7ede101f']",0,10,10,4517461,1,,,,3473
2fe4a9eede0af104dfc29abec604e786d5159d34,0,Jungtaek Lim,2017-04-04 22:04:57+09:00,['22d2d9163772e494f9565946bba056000648fdd8'],0,3,3,4517464,1,,,,3473
e9d783386e6d964df925546beb4db55106e61312,1,Jungtaek Lim,2017-04-04 23:04:18+09:00,['28c8711e792b03c8363bb58c34d3c7768d263cc6'],109,44,153,4517617,209,,,,3473
cddb4c1d8f557016d3777baad0ba985fe97cf9ca,0,Jungtaek Lim,2017-04-05 09:16:43+09:00,"['2fe4a9eede0af104dfc29abec604e786d5159d34', '0ad48919a91d3c7a6a856e81ed7f3a289151506a']",3,23,26,4517643,2,,,,3473
b346c1c01e1d1982d9b9f1a62998b537e4a3e751,0,Jungtaek Lim,2017-04-05 09:17:17+09:00,['cddb4c1d8f557016d3777baad0ba985fe97cf9ca'],0,1,1,4517644,1,,,,3473
80d22b84827c67fb4596b9b0eaf0b88c6693258a,0,Jungtaek Lim,2017-04-05 09:45:03+09:00,"['b346c1c01e1d1982d9b9f1a62998b537e4a3e751', 'eb6c308925b2a4cd89031a2a6b951976deb6262f']",37,2261,2298,4519942,20,,,,3473
08e7b640d6f2e4d7cffad9f5ef64248e65e52739,0,Jungtaek Lim,2017-04-05 09:45:43+09:00,['80d22b84827c67fb4596b9b0eaf0b88c6693258a'],0,1,1,4519943,1,,,,3473
cd7aa739cdfc03254c5483839104c01be13ed5f0,0,Jungtaek Lim,2017-04-05 09:51:07+09:00,"['08e7b640d6f2e4d7cffad9f5ef64248e65e52739', '4950cafaedaefed519f8324fbc21fe6e3213ec35']",0,2,2,4519945,1,,,,3473
a542041c7b745554f8e32f4e4667cf67200647dc,0,Jungtaek Lim,2017-04-05 09:51:34+09:00,['cd7aa739cdfc03254c5483839104c01be13ed5f0'],0,1,1,4519946,1,,,,3473
8a426218537ad8d6638350998e23c5676f710849,0,Jungtaek Lim,2017-04-05 10:15:59+09:00,"['a542041c7b745554f8e32f4e4667cf67200647dc', '5459995f99e5acbcf273e3b5dd1a02b92439e3e7']",6,7,13,4519959,1,,,,3473
b2b9ecf276cb2fecba7490e91c8a6a2c4a16c392,0,Jungtaek Lim,2017-04-05 10:57:58+09:00,"['8a426218537ad8d6638350998e23c5676f710849', '488c38b61f4bb29209cbf3eb5e64b9d104446ab5']",2,2,4,4519963,1,,,,3473
de47d1bb79ce1a14786725c38b85dc9694299ee9,0,Jungtaek Lim,2017-04-05 11:04:00+09:00,['b2b9ecf276cb2fecba7490e91c8a6a2c4a16c392'],21,29,50,4520013,6,,,,3473
dba325aa72eab65f45078ef79a2a4a619e189ef8,0,Jungtaek Lim,2017-04-05 11:04:47+09:00,"['b2b9ecf276cb2fecba7490e91c8a6a2c4a16c392', 'de47d1bb79ce1a14786725c38b85dc9694299ee9']",21,29,50,4520063,6,,,,3473
c4170ab16094c16f213704ecf48b0feeb424d19a,0,Jungtaek Lim,2017-04-05 11:05:01+09:00,['dba325aa72eab65f45078ef79a2a4a619e189ef8'],0,1,1,4520064,1,,,,3473
c2f2c227a34e6ef958875b090a289015652f6ed4,0,鍒樺厗鍧?0206665,2017-04-05 17:03:28+08:00,['c4170ab16094c16f213704ecf48b0feeb424d19a'],1,1,2,4520066,1,,,,3473
7dfd1100d63212a2e46902f818bbe6a0ef7c7a8e,0,Jungtaek Lim,2017-04-06 07:27:28+09:00,"['c4170ab16094c16f213704ecf48b0feeb424d19a', '2a369e408c18adf1045f57382d30fe18dacdbb19']",941,332,1273,4521339,130,,,,3473
e84b39d1e6efa044bbe1762c7e971f9aff35eca6,0,Jungtaek Lim,2017-04-06 07:33:41+09:00,['7dfd1100d63212a2e46902f818bbe6a0ef7c7a8e'],0,1,1,4521340,1,,,,3473
1dd4bbc4874f38eee0e96eb19a342cc1217baab1,0,Jungtaek Lim,2017-04-06 08:11:02+09:00,"['e84b39d1e6efa044bbe1762c7e971f9aff35eca6', 'e9d783386e6d964df925546beb4db55106e61312']",118,46,164,4521504,209,,,,3473
c652d3ffc2e9a701f0fd67f787f9e257499d6cbb,0,Jungtaek Lim,2017-04-06 08:18:49+09:00,['1dd4bbc4874f38eee0e96eb19a342cc1217baab1'],0,1,1,4521505,1,,,,3473
4de339a8cd74ac06211d5a8e4f56c2ea7f6ee951,1,Jungtaek Lim,2017-04-06 09:24:43+09:00,['c652d3ffc2e9a701f0fd67f787f9e257499d6cbb'],6274,7437,13711,4535216,1299,0,0,0,3497
dcf6d88a4587b709840fb088bb3f46909cbedcfa,0,鍒樺厗鍧?0206665,2017-04-06 13:20:09+08:00,['c652d3ffc2e9a701f0fd67f787f9e257499d6cbb'],24,70,94,4535310,2,,,,3497
8c5dba2065cc0fbefbbf022ecf178339c4021ce9,0,Sourav Mitra,2017-04-06 17:11:35+05:18,['c652d3ffc2e9a701f0fd67f787f9e257499d6cbb'],0,27,27,4535337,5,0.666666667,1,1,3497
4eb65075ad066da9f8bb25c47503a10546a30458,0,Robert Evans,2017-04-06 08:33:21-05:00,"['c652d3ffc2e9a701f0fd67f787f9e257499d6cbb', '4de339a8cd74ac06211d5a8e4f56c2ea7f6ee951']",6274,7437,13711,4549048,1299,,,,3497
b254ede46a25466749cd48ebd4bcb56dd791ec4a,1,Robert (Bobby) Evans,2017-04-06 13:58:41-05:00,['4eb65075ad066da9f8bb25c47503a10546a30458'],2880,2684,5564,4554612,138,1,0.31372549,0,3501
9eced5310464f87ca52eb92b6224ef5abe531514,0,Robert (Bobby) Evans,2017-04-06 14:50:14-05:00,['b254ede46a25466749cd48ebd4bcb56dd791ec4a'],12,8,20,4554632,2,0,0,0,3501
24dff29979f87caa81fc7251f7d8655ca6a4c64e,0,vesense,2017-04-07 13:38:19+08:00,"['4eb65075ad066da9f8bb25c47503a10546a30458', 'dcf6d88a4587b709840fb088bb3f46909cbedcfa']",24,70,94,4554726,2,,,,3501
50be3e84c39958e12a556ce918b155dbbb3728ac,0,vesense,2017-04-07 13:39:09+08:00,"['24dff29979f87caa81fc7251f7d8655ca6a4c64e', 'c2f2c227a34e6ef958875b090a289015652f6ed4']",1,1,2,4554728,1,,,,3501
1850dd53bd286307a2422e1fcdb07fada9635fdb,0,vesense,2017-04-07 13:46:08+08:00,['50be3e84c39958e12a556ce918b155dbbb3728ac'],0,2,2,4554730,1,,,,3501
71dc2e019d84580fbcdd5eabf267016393324872,0,Robert (Bobby) Evans,2017-04-07 08:31:56-05:00,"['9eced5310464f87ca52eb92b6224ef5abe531514', '1850dd53bd286307a2422e1fcdb07fada9635fdb']",19,69,88,4554818,4,,,,3501
d98a5b8baaac3595df6d1f43a0f84a33b57de546,1,Stig Rohde D酶ssing,2017-04-08 08:23:43+02:00,['1850dd53bd286307a2422e1fcdb07fada9635fdb'],79,616,695,4555513,9,0.215909091,0.662878788,1,3503
f49bbf9bfb860e652b50b55518bf673b518be44e,0,鍒樺厗鍧?0206665,2017-04-08 15:47:01+08:00,['1850dd53bd286307a2422e1fcdb07fada9635fdb'],8,201,209,4555722,2,,,,3503
fdb9136bc69f28175f4dc3bee9297352440f2f13,1,Ranjan Banerjee,2017-04-09 13:06:00-07:00,['1850dd53bd286307a2422e1fcdb07fada9635fdb'],404,531,935,4556657,29,0,0,1,3506
4a4a8d2e1ec89d572116865e28df7241178bc624,0,vesense,2017-04-11 10:41:32+08:00,['1850dd53bd286307a2422e1fcdb07fada9635fdb'],1,1915,1916,4558573,28,0.479381443,1,0.718213058,3531
bf0f9bbf1d854643193c82b6a68f75b41cb6726c,0,Arun Mahadevan,2017-04-11 14:18:05+05:18,['1850dd53bd286307a2422e1fcdb07fada9635fdb'],13,37,50,4558623,5,0,1,0.909090909,3531
de753cba7d64aa89e2906cf1825e8ce40266b7c1,0,vesense,2017-04-11 18:19:05+08:00,"['f49bbf9bfb860e652b50b55518bf673b518be44e', '8c5dba2065cc0fbefbbf022ecf178339c4021ce9']",0,27,27,4558650,5,,,,3531
65c8b7bd7d7fc23e4b1d64500baada13ff6c6fc0,0,vesense,2017-04-11 18:25:02+08:00,['de753cba7d64aa89e2906cf1825e8ce40266b7c1'],0,2,2,4558652,1,,,,3531
5de29f5057b75d72d770cd794ebc79097087c21a,0,鍒樺厗鍧?0206665,2017-04-11 19:30:01+08:00,['65c8b7bd7d7fc23e4b1d64500baada13ff6c6fc0'],27,154,181,4558833,1,,,,3531
219ffb84bc15914a3e140f0928df2c184b175ea3,0,鍒樺厗鍧?0206665,2017-04-11 19:46:01+08:00,['65c8b7bd7d7fc23e4b1d64500baada13ff6c6fc0'],6,53,59,4558892,2,,,,3531
b44f473bf72b0fb2178def0532a75cc1d1f60b4d,1,GitHub,2017-04-11 21:31:29+08:00,['1850dd53bd286307a2422e1fcdb07fada9635fdb'],2,1,3,4558895,1,,,,3531
10dc53bf97dceeb9ab10c80273a070eb507a778a,0,Marcus Thiesen,2017-04-11 17:02:01+02:00,['1850dd53bd286307a2422e1fcdb07fada9635fdb'],1,1,2,4558897,1,,,,3531
0aa6040fbdc2fa781c8fbbd1bedae9b499b3d4de,0,GitHub,2017-04-12 09:47:19+08:00,['b44f473bf72b0fb2178def0532a75cc1d1f60b4d'],1,1,2,4558899,1,,,,3531
a9dbe7ca48d123c8d60394da89e8bae7524bf7e8,1,GitHub,2017-04-12 14:12:12+08:00,['1850dd53bd286307a2422e1fcdb07fada9635fdb'],28,9,37,4558936,1,,,,3531
a011de4e8b489f5ee09b9079a1271bd22d78b8f2,0,Jungtaek Lim,2017-04-12 16:33:26+09:00,"['65c8b7bd7d7fc23e4b1d64500baada13ff6c6fc0', '71dc2e019d84580fbcdd5eabf267016393324872']",2895,2697,5592,4564528,140,,,,3531
78b074caac2410389d41db9d51fd441efc563c7b,0,Jungtaek Lim,2017-04-12 17:28:52+09:00,['a011de4e8b489f5ee09b9079a1271bd22d78b8f2'],0,1,1,4564529,1,,,,3531
6898fb2eb344a69c1d8e4c9609e52d4d658600e3,0,Robert Evans,2017-04-12 09:38:19-05:00,"['78b074caac2410389d41db9d51fd441efc563c7b', '0aa6040fbdc2fa781c8fbbd1bedae9b499b3d4de']",2,1,3,4564532,1,,,,3531
d8368b0e5dc23b0ad0b5972bac31b50334341bbb,0,Robert Evans,2017-04-12 09:38:43-05:00,['6898fb2eb344a69c1d8e4c9609e52d4d658600e3'],0,1,1,4564533,1,,,,3531
122d64534772c8467620b615d68eeff4dd24534e,0,Jacob Tolar,2017-04-12 12:05:07-05:00,['d8368b0e5dc23b0ad0b5972bac31b50334341bbb'],13,6,19,4564552,2,1,0,1,3531
41fdd98fffff52c346e5358ac8e704fc5b49ea66,0,P. Taylor Goetz,2017-04-12 14:28:35-04:00,['d8368b0e5dc23b0ad0b5972bac31b50334341bbb'],8,25,33,4564585,2,0,1,0.538461538,3531
abcd9720991115a9bde9b72b41180d3022641d0d,0,vesense,2017-04-13 09:02:15+08:00,"['d8368b0e5dc23b0ad0b5972bac31b50334341bbb', '5de29f5057b75d72d770cd794ebc79097087c21a']",27,154,181,4564766,1,,,,3531
91fb8f567feb629f230df6d0694a9d990ea28cb0,0,vesense,2017-04-13 09:03:28+08:00,"['abcd9720991115a9bde9b72b41180d3022641d0d', '219ffb84bc15914a3e140f0928df2c184b175ea3']",6,53,59,4564825,2,,,,3531
4f99514e4f25935619212fb18cddf97680098572,0,vesense,2017-04-13 09:11:34+08:00,['91fb8f567feb629f230df6d0694a9d990ea28cb0'],0,2,2,4564827,1,,,,3531
aec187f4302ac81f0bc308278beed6e9c56b7d3e,1,Robert (Bobby) Evans,2017-04-12 20:36:48-05:00,['d8368b0e5dc23b0ad0b5972bac31b50334341bbb'],277,618,895,4565722,34,0,0,0.958333333,3536
8b1041744e1d236eb4f1b37b0ca2c6b7a2685f1b,0,Robert Evans,2017-04-12 20:59:06-05:00,"['4f99514e4f25935619212fb18cddf97680098572', '5913d160fa38efc3e8888e761e075582ba8c8a5f']",46,75,121,4565843,1,,,,3536
4c27ef9d36b0fa1239cfef2ba5e8e1f2f99b43e7,0,Robert Evans,2017-04-12 20:59:26-05:00,['8b1041744e1d236eb4f1b37b0ca2c6b7a2685f1b'],0,1,1,4565844,1,,,,3536
51e601852d9c3de3c9af722f5d2c5ea79b5e8b9f,0,Satish Duggana,2017-04-13 09:23:56+05:18,"['4c27ef9d36b0fa1239cfef2ba5e8e1f2f99b43e7', 'bf0f9bbf1d854643193c82b6a68f75b41cb6726c']",13,37,50,4565894,5,,,,3536
4df35c571a1c8d549a57f6102d413b60b9c86458,0,Satish Duggana,2017-04-13 09:41:06+05:18,['51e601852d9c3de3c9af722f5d2c5ea79b5e8b9f'],0,1,1,4565895,1,,,,3536
6a09512cc481dd68a989a46ed959d69d8721b58b,0,vesense,2017-04-13 13:52:30+08:00,"['4df35c571a1c8d549a57f6102d413b60b9c86458', 'a9dbe7ca48d123c8d60394da89e8bae7524bf7e8']",28,9,37,4565932,1,,,,3536
1f5caca010cb08ab4fb9b0c171a675d595b0f784,0,vesense,2017-04-13 13:54:43+08:00,['6a09512cc481dd68a989a46ed959d69d8721b58b'],0,1,1,4565933,1,,,,3536
ab4204e757ae373426fc675035405c9e88c90efb,0,GitHub,2017-04-13 17:53:06+08:00,['1f5caca010cb08ab4fb9b0c171a675d595b0f784'],3,5,8,4565941,1,,,,3536
9bacd977f27aa3f9358c7c9adaf7b04191a15cb8,0,vesense,2017-04-13 21:39:44+08:00,['4a4a8d2e1ec89d572116865e28df7241178bc624'],64,78,142,4566083,4,1,0,1,3536
ef1229df844b1eda9934b32bf2f73937e358610a,0,R茅gis Behmo,2017-04-13 16:33:42+02:00,['1f5caca010cb08ab4fb9b0c171a675d595b0f784'],241,266,507,4566590,10,,,,3536
66a9e77294ef36bf1210d828cf9da1318d06677a,0,P. Taylor Goetz,2017-04-13 14:48:35-04:00,"['1f5caca010cb08ab4fb9b0c171a675d595b0f784', '41fdd98fffff52c346e5358ac8e704fc5b49ea66']",8,25,33,4566623,2,,,,3536
1a17f741657b723a8299b67c8cc1ae80fd5f0690,0,P. Taylor Goetz,2017-04-13 14:49:59-04:00,['66a9e77294ef36bf1210d828cf9da1318d06677a'],0,1,1,4566624,1,,,,3536
7327924a4171aab3d9e30cfea307ba62f063d44e,0,GitHub,2017-04-13 15:03:49-05:00,['122d64534772c8467620b615d68eeff4dd24534e'],1,0,1,4566625,1,,,,3536
2b4565c668c16c366e086214d11f3ec2e1d4769c,0,Heather McCartney,2017-04-13 21:30:18+01:00,['1a17f741657b723a8299b67c8cc1ae80fd5f0690'],544,1403,1947,4568572,39,0.923547401,0.853211009,0.944954128,3547
45cd82a06b0035d67398262a036c9c7c4ba1997d,0,Robert Evans,2017-04-13 16:33:08-05:00,"['1a17f741657b723a8299b67c8cc1ae80fd5f0690', '7327924a4171aab3d9e30cfea307ba62f063d44e']",13,5,18,4568590,1,,,,3547
4a3a238dcc29f19720bc3c05f51b7f4df9bfaf8e,0,Robert Evans,2017-04-13 16:33:33-05:00,['45cd82a06b0035d67398262a036c9c7c4ba1997d'],0,1,1,4568591,1,,,,3547
2823682d1de37676b76011535fdbe3dd311208cd,1,Robert (Bobby) Evans,2017-04-13 19:34:11-05:00,['4a3a238dcc29f19720bc3c05f51b7f4df9bfaf8e'],11,14,25,4568616,1,1,1,0,3547
644d817bc7608bd65a9752a20ff6073592ec8c34,0,Jungtaek Lim,2017-04-14 14:49:05+09:00,"['4a3a238dcc29f19720bc3c05f51b7f4df9bfaf8e', '10dc53bf97dceeb9ab10c80273a070eb507a778a']",1,1,2,4568618,1,,,,3547
0e653a2c222ec5566b7fd2511a15ed04236e436b,0,Jungtaek Lim,2017-04-14 14:49:51+09:00,['644d817bc7608bd65a9752a20ff6073592ec8c34'],0,1,1,4568619,1,,,,3547
f37fb022405d093481a1b3d14ebd116e05b766f9,0,Jungtaek Lim,2017-04-14 15:04:17+09:00,"['0e653a2c222ec5566b7fd2511a15ed04236e436b', 'ab4204e757ae373426fc675035405c9e88c90efb']",3,5,8,4568627,1,,,,3547
3679df1af382a0e7202766fddd6571025797d25d,0,Jungtaek Lim,2017-04-14 15:10:08+09:00,"['f37fb022405d093481a1b3d14ebd116e05b766f9', 'ef1229df844b1eda9934b32bf2f73937e358610a']",241,266,507,4569134,10,,,,3547
0e72a74ab4c0570f3d739dbbee984104bb2b5ee6,0,Jungtaek Lim,2017-04-14 15:21:24+09:00,"['3679df1af382a0e7202766fddd6571025797d25d', '37665b5c51cae70ae021ff8ab2f1d43b1e1d607b']",12,12,24,4569158,1,,,,3547
67c99bf7fcda65181b60c5f5e145b233ca4fe6eb,0,Jungtaek Lim,2017-04-14 15:27:42+09:00,"['0e72a74ab4c0570f3d739dbbee984104bb2b5ee6', 'aec187f4302ac81f0bc308278beed6e9c56b7d3e']",277,618,895,4570053,34,,,,3547
877dc8c95d3a46db647a68aa607bf0700e41a713,0,Jungtaek Lim,2017-04-14 15:28:19+09:00,['67c99bf7fcda65181b60c5f5e145b233ca4fe6eb'],0,1,1,4570054,1,,,,3547
d76ec81e30a758a18dec93fcc4b628480f02616c,0,Jungtaek Lim,2017-04-14 15:51:51+09:00,['877dc8c95d3a46db647a68aa607bf0700e41a713'],7,6,13,4570067,1,,,,3547
249260ddeb9cde23a154535a8df2ce8f8090a661,0,Jungtaek Lim,2017-04-14 16:08:31+09:00,"['877dc8c95d3a46db647a68aa607bf0700e41a713', 'd76ec81e30a758a18dec93fcc4b628480f02616c']",7,6,13,4570080,1,,,,3547
aca117db7020f48a6abe27d5ab33a675c9a645f3,0,Jungtaek Lim,2017-04-14 16:12:37+09:00,['249260ddeb9cde23a154535a8df2ce8f8090a661'],0,1,1,4570081,1,,,,3547
e43e86fe11a916d937867c5265d56d597d93923e,0,鍒樺厗鍧?0206665,2017-04-14 16:12:32+08:00,['4df35c571a1c8d549a57f6102d413b60b9c86458'],1,1,2,4570083,1,,,,3547
487a246cb290cdba6f7549a52a6c88ca7ae147f8,0,Jungtaek Lim,2017-04-14 18:03:09+09:00,"['aca117db7020f48a6abe27d5ab33a675c9a645f3', 'e43e86fe11a916d937867c5265d56d597d93923e']",1,1,2,4570085,1,,,,3547
a4cf917d35352211a80502e04b08d3318cfeb6d1,1,Robert (Bobby) Evans,2017-04-14 20:51:43-05:00,['487a246cb290cdba6f7549a52a6c88ca7ae147f8'],895,854,1749,4571834,50,0.985074627,0.985074627,0.611940299,3553
8e1128ac9fc7cc7b9df20096e2b639615e29650d,0,Robert (Bobby) Evans,2017-04-14 20:53:08-05:00,['a4cf917d35352211a80502e04b08d3318cfeb6d1'],0,16,16,4571850,1,,,,3553
edf4db0130c02b60c419a028051051202bea28ed,0,Robert Evans,2017-04-15 15:21:38-05:00,"['487a246cb290cdba6f7549a52a6c88ca7ae147f8', '2823682d1de37676b76011535fdbe3dd311208cd']",11,14,25,4571875,1,,,,3553
c38d7950a347e906a8ebe7b2889c65c6e8e8c936,0,Robert Evans,2017-04-15 15:22:11-05:00,['edf4db0130c02b60c419a028051051202bea28ed'],0,1,1,4571876,1,,,,3553
3d619678ca3a91012dc9dc9e9678826a1ed8cff7,0,鍒樺厗鍧?0206665,2017-04-17 15:41:47+08:00,['c38d7950a347e906a8ebe7b2889c65c6e8e8c936'],4,4,8,4571884,4,,,,3553
1044473bb191c15dabfa434b8126f2fa523f59c9,0,Stig Rohde D酶ssing,2017-04-17 10:31:45+02:00,['c38d7950a347e906a8ebe7b2889c65c6e8e8c936'],225,229,454,4572338,9,1,1,0,3553
e55f67a58210461abbbdb1318c3b2a73b448a645,0,Jungtaek Lim,2017-04-18 11:53:22+09:00,['c38d7950a347e906a8ebe7b2889c65c6e8e8c936'],161,128,289,4572627,9,0,,,3553
ded7a1e4bda4cf8f16faaa507246636d49bcdc92,0,vesense,2017-04-18 12:01:43+08:00,['9bacd977f27aa3f9358c7c9adaf7b04191a15cb8'],146,307,453,4573080,11,0.912280702,1,1,3556
55297b01d67981572f4705b210a904e560e5ac6d,0,Sriharsha Chintalapani,2017-04-18 10:50:15-07:00,"['c38d7950a347e906a8ebe7b2889c65c6e8e8c936', '2b4565c668c16c366e086214d11f3ec2e1d4769c']",544,1403,1947,4575027,39,,,,3556
f794d72306d040249427000ba2ea7eae5b647cf7,0,Sriharsha Chintalapani,2017-04-18 12:25:50-07:00,['55297b01d67981572f4705b210a904e560e5ac6d'],0,1,1,4575028,1,,,,3556
940096a275562a25eccf5da7a6b048702b1be788,0,Sriharsha Chintalapani,2017-04-18 14:02:58-07:00,"['f794d72306d040249427000ba2ea7eae5b647cf7', 'fdb9136bc69f28175f4dc3bee9297352440f2f13']",404,531,935,4575963,29,,,,3556
2307b8023c947a408aac6d522d18e13434c0f57e,0,Sriharsha Chintalapani,2017-04-18 14:08:22-07:00,['940096a275562a25eccf5da7a6b048702b1be788'],0,1,1,4575964,1,,,,3556
7f1566cfc37c5ea26022b4c66af73ddf5d1b0719,0,vesense,2017-04-19 09:38:57+08:00,"['2307b8023c947a408aac6d522d18e13434c0f57e', '3d619678ca3a91012dc9dc9e9678826a1ed8cff7']",4,4,8,4575972,4,,,,3556
30388d49662da1b035a32483a519db745ec5da10,0,vesense,2017-04-19 09:43:23+08:00,['7f1566cfc37c5ea26022b4c66af73ddf5d1b0719'],0,1,1,4575973,1,,,,3556
3876098970e0a8fff51be2a3e5e05d52fc4a34bf,0,vesense,2017-04-19 09:48:59+08:00,['30388d49662da1b035a32483a519db745ec5da10'],0,1,1,4575974,1,,,,3556
ef7afd87dd4fc82bf626eadaa99b7f7077f39526,0,Satish Duggana,2017-04-19 09:06:11+05:18,"['3876098970e0a8fff51be2a3e5e05d52fc4a34bf', 'e55f67a58210461abbbdb1318c3b2a73b448a645']",161,128,289,4576263,9,,,,3556
bfd10066cc86b66fe7e71c7c09b33d628bd3d20e,0,Satish Duggana,2017-04-19 09:07:00+05:18,['ef7afd87dd4fc82bf626eadaa99b7f7077f39526'],0,1,1,4576264,1,,,,3556
f6f4ac7dfbf351ea1c91b0a1a9404213706ed950,0,David Luu,2017-04-21 14:31:55-07:00,['e48b28483fe5874a8245b782581d2d513471a2f3'],0,1,1,4576265,1,,,,3556
8c3b9797101b313c31f8af5d585eb43c88d54dd0,0,GitHub,2017-04-24 09:50:39+08:00,['bfd10066cc86b66fe7e71c7c09b33d628bd3d20e'],0,1,1,4576266,1,,,,3556
3411c45e9a6ef77f1e84051964ca60ac2961f951,0,vesense,2017-04-24 11:56:36+08:00,"['bfd10066cc86b66fe7e71c7c09b33d628bd3d20e', 'ded7a1e4bda4cf8f16faaa507246636d49bcdc92']",1,2090,2091,4578357,31,,,,3556
7e183c010ee1ab342c923596d0474e4093571a43,0,vesense,2017-04-24 13:09:22+08:00,['3411c45e9a6ef77f1e84051964ca60ac2961f951'],0,1,1,4578358,1,,,,3556
f995ead1a08e82973c5ec23c399a33cafedcf2eb,0,GitHub,2017-04-24 14:28:05+01:00,['7e183c010ee1ab342c923596d0474e4093571a43'],1,1,2,4578360,1,,,,3556
7f88b03fabd9264b8cbd8331f8adfe35f222e913,0,Erik Weathers,2017-04-24 15:49:56-07:00,['7e183c010ee1ab342c923596d0474e4093571a43'],0,3,3,4578363,1,,,,3556
7b19d6b8a32726fb45c6095111a27e13411efd66,0,vesense,2017-04-25 12:55:24+08:00,['7e183c010ee1ab342c923596d0474e4093571a43'],1,372,373,4578736,11,1,1,0.8125,3564
0d690c4105654da266eb726c2d23459fac3bb219,0,Sriharsha Chintalapani,2017-04-25 20:40:08-07:00,"['7e183c010ee1ab342c923596d0474e4093571a43', '8c3b9797101b313c31f8af5d585eb43c88d54dd0']",0,1,1,4578737,1,,,,3564
41ab01726664c4a67552c2327466ab1290f2dad6,0,Sriharsha Chintalapani,2017-04-25 20:40:57-07:00,['0d690c4105654da266eb726c2d23459fac3bb219'],0,1,1,4578738,1,,,,3564
4d8efaee4577ebc369ccd2153c4e2bafe2de3c6b,0,vesense,2017-04-26 13:16:50+08:00,['7b19d6b8a32726fb45c6095111a27e13411efd66'],7,29,36,4578774,2,1,1,1,3564
dc19b6dd2299b54295888acca997c63d962600b1,0,Erik Weathers,2017-04-25 23:18:51-07:00,['7e183c010ee1ab342c923596d0474e4093571a43'],2,2,4,4578778,1,,,,3564
60da333d217b457811a932b4c44c176736be92fc,0,vesense,2017-04-26 16:06:19+08:00,"['41ab01726664c4a67552c2327466ab1290f2dad6', '4d8efaee4577ebc369ccd2153c4e2bafe2de3c6b']",1,394,395,4579173,11,,,,3564
ce58ae5388e5d8c60a511e239ecb57bdbfc17437,0,vesense,2017-04-26 17:59:45+08:00,['4d8efaee4577ebc369ccd2153c4e2bafe2de3c6b'],43,32,75,4579248,6,0,1,0.25,3564
27ff5851fd2b6281e3a6be07c239bec632e70113,0,vesense,2017-04-27 09:12:13+08:00,"['60da333d217b457811a932b4c44c176736be92fc', 'ce58ae5388e5d8c60a511e239ecb57bdbfc17437']",43,32,75,4579323,6,,,,3564
500691df77d5b869afc0e2cf80331400ab4036c2,0,vesense,2017-04-27 09:32:15+08:00,['27ff5851fd2b6281e3a6be07c239bec632e70113'],0,1,1,4579324,1,,,,3564
e80f9e20db208555753b93f48c4af175dbe47c6a,0,vesense,2017-04-27 12:40:57+08:00,['500691df77d5b869afc0e2cf80331400ab4036c2'],7,145,152,4579476,6,,,,3566
de2907f859e144ed754cf88a1814d151671de6e6,0,Robert Evans,2017-04-27 08:37:10-05:00,"['500691df77d5b869afc0e2cf80331400ab4036c2', 'dc19b6dd2299b54295888acca997c63d962600b1']",2,2,4,4579480,1,,,,3566
71e05fed8e0af46ab88af4ecd5b36a79daa6c484,0,Mads Tandrup,2017-04-27 23:00:20+02:00,['7e183c010ee1ab342c923596d0474e4093571a43'],9,143,152,4579632,4,0.310810811,1,0.986486486,3566
e6a7e269d55fa9aea4e3994caaeb847824ef6c0d,0,Robert Evans,2017-04-27 19:11:51-05:00,"['de2907f859e144ed754cf88a1814d151671de6e6', '8e1128ac9fc7cc7b9df20096e2b639615e29650d']",894,869,1763,4581395,50,,,,3566
2ec5581bb904971cee671cd1cd9b89495fca6636,0,Robert Evans,2017-04-27 20:43:44-05:00,['e6a7e269d55fa9aea4e3994caaeb847824ef6c0d'],0,1,1,4581396,1,,,,3566
6a13c141ba537e4e06c62f0089dd0b132bcabb6e,0,Robert Evans,2017-04-27 21:17:44-05:00,"['2ec5581bb904971cee671cd1cd9b89495fca6636', '7f88b03fabd9264b8cbd8331f8adfe35f222e913']",0,3,3,4581399,1,,,,3566
14d06fbfbc758fa21fef696b8b87514a49a0308f,0,Robert Evans,2017-04-27 21:18:19-05:00,['6a13c141ba537e4e06c62f0089dd0b132bcabb6e'],0,1,1,4581400,1,,,,3566
2f8952d70e99e83f956f833adfae7020146a29a5,0,vesense,2017-04-28 15:00:44+08:00,"['14d06fbfbc758fa21fef696b8b87514a49a0308f', 'f995ead1a08e82973c5ec23c399a33cafedcf2eb']",1,1,2,4581402,1,,,,3566
a4afacd9617d620f50cf026fc599821f7ac25c79,0,vesense,2017-04-28 15:02:47+08:00,"['2f8952d70e99e83f956f833adfae7020146a29a5', 'f6f4ac7dfbf351ea1c91b0a1a9404213706ed950']",0,1,1,4581403,1,,,,3566
2ceef0dce21895c4ef0f0b8eb5bc8248fad25e13,1,Erik Weathers,2017-04-28 00:57:23-07:00,['7e183c010ee1ab342c923596d0474e4093571a43'],38,57,95,4581498,4,0,0,0,3567
98f679db33f143346bf4bd52f078ba83012bfa0e,0,vesense,2017-04-28 16:33:31+08:00,['e80f9e20db208555753b93f48c4af175dbe47c6a'],6,6,12,4581510,2,,,,3567
d39e3a778873b36af9c120a71c81b883cefc674b,0,Sriharsha Chintalapani,2017-05-01 12:55:31-07:00,"['a4afacd9617d620f50cf026fc599821f7ac25c79', 'd98a5b8baaac3595df6d1f43a0f84a33b57de546']",79,616,695,4582205,9,,,,3567
2c597e56255ad86a1920b64b6153d6972d37179c,0,Sriharsha Chintalapani,2017-05-01 12:57:08-07:00,['d39e3a778873b36af9c120a71c81b883cefc674b'],0,1,1,4582206,1,,,,3567
8ca135c7f893f8d8975e8ed914e19501f3e0c353,0,vinodkc,2017-05-02 21:52:25+05:18,['2c597e56255ad86a1920b64b6153d6972d37179c'],1,31,32,4582238,1,,,,3567
dcd5f6f5e5705161696216b54900bd4acd9d04ca,0,vinodkc,2017-05-02 21:52:25+05:18,['8ca135c7f893f8d8975e8ed914e19501f3e0c353'],2,2,4,4582242,1,,,,3567
d4ac25005869366e2c72789c8bd140212cb6bbd2,1,vinodkc,2017-05-02 21:52:25+05:18,['dcd5f6f5e5705161696216b54900bd4acd9d04ca'],40,548,588,4582830,58,,,,3567
682fa9e97f12901695114a1ba7f585a4837288cb,0,vinodkc,2017-05-02 21:52:25+05:18,['d4ac25005869366e2c72789c8bd140212cb6bbd2'],48,49,97,4582927,49,,,,3567
0db616045007a02d55f0eec54296587c8b6ed256,0,vinodkc,2017-05-02 22:15:20+05:18,['682fa9e97f12901695114a1ba7f585a4837288cb'],1,1,2,4582929,1,,,,3567
a0122aed59ea0e151a6017593afec550f88e5081,0,Arun Mahadevan,2017-05-03 14:01:31+05:18,['2c597e56255ad86a1920b64b6153d6972d37179c'],259,548,807,4583736,16,0.15,0.625,0.5,3569
289d6ff743c42ef3cf7bd1e9e8fe52652aeac457,0,Arun Mahadevan,2017-05-03 14:01:38+05:18,['a0122aed59ea0e151a6017593afec550f88e5081'],8,6,14,4583750,2,0,0,0,3569
56310f90cc49539c18b3701bc2256dbed816ab2c,0,Arun Mahadevan,2017-05-03 17:57:50+05:18,['289d6ff743c42ef3cf7bd1e9e8fe52652aeac457'],10,5,15,4583765,6,,,,3569
933335e2d59bc813855ac3f103fbd5b6fa3f4df9,0,Robert Evans,2017-05-04 09:28:24-05:00,"['2c597e56255ad86a1920b64b6153d6972d37179c', '0db616045007a02d55f0eec54296587c8b6ed256']",11,550,561,4584326,58,,,,3569
42c917d1963c12b13e5ecaf8386886836ad370a8,0,Robert Evans,2017-05-04 09:28:59-05:00,['933335e2d59bc813855ac3f103fbd5b6fa3f4df9'],0,1,1,4584327,1,,,,3569
d57a895fe67e1afbf5f2efc9b2e9f59cce5707f7,0,Erik Weathers,2017-05-04 14:57:56-07:00,['2ceef0dce21895c4ef0f0b8eb5bc8248fad25e13'],3,3,6,4584333,3,,,,3569
f3d86e6915d5d10018664dafbb85fb746a3f63c7,0,Erik Weathers,2017-05-04 15:01:12-07:00,['d57a895fe67e1afbf5f2efc9b2e9f59cce5707f7'],0,1,1,4584334,1,,,,3569
a60215baaf3ad9ab05b68cdd17cf7a52c0aa9c69,0,Robert Evans,2017-05-05 09:17:53-05:00,"['42c917d1963c12b13e5ecaf8386886836ad370a8', 'f3d86e6915d5d10018664dafbb85fb746a3f63c7']",40,60,100,4584434,7,,,,3569
5b270d3d74587c5df4d45a31838e21d8cfd60ca2,0,Robert Evans,2017-05-05 09:24:43-05:00,['a60215baaf3ad9ab05b68cdd17cf7a52c0aa9c69'],0,1,1,4584435,1,,,,3569
f56ab4477e28c500575934c987780478bc1319b7,1,Jungtaek Lim,2017-05-08 12:25:30+09:00,['5b270d3d74587c5df4d45a31838e21d8cfd60ca2'],3,24,27,4584462,2,0,1,1,3569
f342d5c3de859e49f7244f68186a15445495898f,0,Jungtaek Lim,2017-05-08 13:53:28+09:00,"['5b270d3d74587c5df4d45a31838e21d8cfd60ca2', '56310f90cc49539c18b3701bc2256dbed816ab2c']",263,545,808,4585270,16,,,,3569
0639244f7127e57afae46136daf296155704ced9,0,Jungtaek Lim,2017-05-08 14:05:06+09:00,['f342d5c3de859e49f7244f68186a15445495898f'],0,1,1,4585271,1,,,,3569
09b475af32b7b5176261de18ffcd2d4facd1b30d,0,Jungtaek Lim,2017-05-08 17:04:00+09:00,"['0639244f7127e57afae46136daf296155704ced9', '1044473bb191c15dabfa434b8126f2fa523f59c9']",225,229,454,4585725,9,,,,3569
9755ff547de3247fe4aa1b60a778983145f43f76,0,Jungtaek Lim,2017-05-08 17:04:20+09:00,['09b475af32b7b5176261de18ffcd2d4facd1b30d'],0,1,1,4585726,1,,,,3569
ca17c4ff10231a5d93deb3d4ac934140ccec674d,0,Ranjan Banerjee,2017-05-09 16:12:14-07:00,['9755ff547de3247fe4aa1b60a778983145f43f76'],11,17,28,4585754,4,1,1,0,3569
440f1b5d3dd6194feed81a7da21b63b51cde6544,1,Vivek Mittal,2017-05-10 08:33:41+05:18,['9755ff547de3247fe4aa1b60a778983145f43f76'],15,53,68,4585822,2,0.153846154,0,1,3569
a50056691e02109a52c665aadf06f0c1135ee0ad,0,Arun Mahadevan,2017-05-12 14:32:12+05:18,['9755ff547de3247fe4aa1b60a778983145f43f76'],27,69,96,4585918,4,,,,3569
88cf6f7b418a6edb9ea32b66382261dd9e2570dd,1,Erik Weathers,2017-05-12 02:26:12-07:00,['9755ff547de3247fe4aa1b60a778983145f43f76'],0,223,223,4586141,1,,,,3570
29c761908ec8305d36535c1d2e3d1c0c3d6c95d1,1,Erik Weathers,2017-05-12 02:27:12-07:00,['88cf6f7b418a6edb9ea32b66382261dd9e2570dd'],63,86,149,4586290,59,,,,3570
772c334caee061eb7b90803045a2cea5d3ff1021,1,Erik Weathers,2017-05-12 10:12:08-07:00,['29c761908ec8305d36535c1d2e3d1c0c3d6c95d1'],3,21,24,4586314,1,,,,3570
b8d04023a6dbf4b690b0517d5f62dfd32f2a3773,1,Erik Weathers,2017-05-12 10:14:07-07:00,['772c334caee061eb7b90803045a2cea5d3ff1021'],43,43,86,4586400,43,,,,3570
2aa415498df01b450562368d7c38643a3456189f,0,Satish Duggana,2017-05-13 10:33:12+05:18,['bfd10066cc86b66fe7e71c7c09b33d628bd3d20e'],1,7,8,4586408,2,1,1,1,3570
fac6e0b4fa3509afdba3f921a9e4b762909c7e5f,0,Sriharsha Chintalapani,2017-05-12 22:19:17-07:00,['440f1b5d3dd6194feed81a7da21b63b51cde6544'],0,3,3,4586411,1,,,,3570
9c616fd5ee887e2cf17582b4e80adc3b82158c37,0,Priyank,2017-05-12 23:45:17-07:00,['fac6e0b4fa3509afdba3f921a9e4b762909c7e5f'],2,6,8,4586419,1,1,1,1,3570
fd9b25ba1fb6fff3c61da2a0af6f6551677a2426,0,Sriharsha Chintalapani,2017-05-14 08:58:33-07:00,['9c616fd5ee887e2cf17582b4e80adc3b82158c37'],0,1,1,4586420,1,,,,3570
a67a3d2b4d8b9b3db955c489f8e7cf096926569d,0,鍒樺厗鍧?0206665,2017-05-15 13:36:02+08:00,['9755ff547de3247fe4aa1b60a778983145f43f76'],10,58,68,4586488,2,,,,3571
d07a7f62ecd79adcc4e6d398c239d05ce5fcadac,0,Robert Evans,2017-05-15 09:25:33-05:00,"['fd9b25ba1fb6fff3c61da2a0af6f6551677a2426', 'b8d04023a6dbf4b690b0517d5f62dfd32f2a3773']",58,322,380,4586868,59,,,,3571
77456b08bfc35231a44fc1a166d233adf94ed66d,0,Robert Evans,2017-05-15 09:25:55-05:00,['d07a7f62ecd79adcc4e6d398c239d05ce5fcadac'],0,1,1,4586869,1,,,,3571
7043dea8e487d55510c120ada39d18b5bd08451a,0,Robert Evans,2017-05-15 10:09:16-05:00,['77456b08bfc35231a44fc1a166d233adf94ed66d'],1,1,2,4586871,1,,,,3571
dd6b4870844a6854644968000198871c7b82a3f8,0,Sriharsha Chintalapani,2017-05-15 08:12:02-07:00,"['7043dea8e487d55510c120ada39d18b5bd08451a', 'f56ab4477e28c500575934c987780478bc1319b7']",3,24,27,4586898,2,,,,3571
013edc967ff7b290bf5e384b343715c522fb2c1b,0,Sriharsha Chintalapani,2017-05-15 08:13:33-07:00,['dd6b4870844a6854644968000198871c7b82a3f8'],0,1,1,4586899,1,,,,3571
4e00e48d5c45a7698e6dc727287089f5b6fd314d,1,Robert (Bobby) Evans,2017-05-15 11:59:23-05:00,['7043dea8e487d55510c120ada39d18b5bd08451a'],80,131,211,4587110,28,1,1,1,3572
0afa19989f4e0436f651ee954aeb0af7de49d56f,0,Robert Evans,2017-05-15 12:27:52-05:00,"['013edc967ff7b290bf5e384b343715c522fb2c1b', '2aa415498df01b450562368d7c38643a3456189f']",1,7,8,4587118,2,,,,3572
e3c7ff1ddbf5c3277cc51802caa4ad2c01a56ff9,0,Robert Evans,2017-05-15 12:41:45-05:00,['0afa19989f4e0436f651ee954aeb0af7de49d56f'],0,1,1,4587119,1,,,,3572
7742398d0c6cec5eedc03bffe0a4e7350ad4ea30,0,Robert Evans,2017-05-15 13:21:59-05:00,"['e3c7ff1ddbf5c3277cc51802caa4ad2c01a56ff9', 'a50056691e02109a52c665aadf06f0c1135ee0ad']",27,69,96,4587215,4,,,,3572
9c1ab5b8c97dfacda3daa199d8a2383495b69374,1,Aditya Sharad,2017-05-15 22:11:25+01:00,['7742398d0c6cec5eedc03bffe0a4e7350ad4ea30'],11,29,40,4587255,7,1,1,1,3572
0a88924bdaccb6471ed34b35de4d34e217d54d39,0,Aditya Sharad,2017-05-15 22:11:26+01:00,['9c1ab5b8c97dfacda3daa199d8a2383495b69374'],48,17,65,4587320,1,0.466666667,0,0,3572
0eb365abff0ac3c3564266c14172dc9a21b5fea8,0,Robert Evans,2017-05-15 16:46:14-05:00,"['7742398d0c6cec5eedc03bffe0a4e7350ad4ea30', '98f679db33f143346bf4bd52f078ba83012bfa0e']",10,148,158,4587478,7,,,,3572
d4ee957a9d677f7ea2ec684915ea88f7717f5d6e,0,Robert Evans,2017-05-15 16:46:41-05:00,['0eb365abff0ac3c3564266c14172dc9a21b5fea8'],0,1,1,4587479,1,,,,3572
3a1d2d64aef43b49d5f249785d92567eb712d4e8,0,Jungtaek Lim,2017-05-17 18:03:50+09:00,['d4ee957a9d677f7ea2ec684915ea88f7717f5d6e'],7,45,52,4587531,1,0,0,0,3572
05d218ccc5f639614b24c9c6d7ba29a690d83298,0,Arun Mahadevan,2017-05-18 13:05:15+05:18,['d4ee957a9d677f7ea2ec684915ea88f7717f5d6e'],11,17,28,4587559,1,0.8,1,1,3572
fa846f187f483b195ba558b609d46e05694fdc56,0,Arun Mahadevan,2017-05-18 13:06:14+05:18,['05d218ccc5f639614b24c9c6d7ba29a690d83298'],0,1,1,4587560,1,,,,3572
d6b7f32f892d2ecd75fa1c71f40eeb9204c344c9,0,Arun Mahadevan,2017-05-18 13:20:47+05:18,['fa846f187f483b195ba558b609d46e05694fdc56'],1,5,6,4587566,1,0,0,1,3572
902520344af6baf7b67f7f408d66b6b82d310a8f,0,Arun Mahadevan,2017-05-18 13:21:20+05:18,['d6b7f32f892d2ecd75fa1c71f40eeb9204c344c9'],0,1,1,4587567,1,,,,3572
aca0e9e9c4b662c340bb94b63d120be121f8543d,1,Jungtaek Lim,2017-05-18 20:29:36+09:00,['902520344af6baf7b67f7f408d66b6b82d310a8f'],96,536,632,4588199,11,0.45320197,1,0.709359606,3573
c4988c998e47c87d5c4b27e072a8fd1450e0a245,0,Jungtaek Lim,2017-05-18 20:30:28+09:00,"['902520344af6baf7b67f7f408d66b6b82d310a8f', 'aca0e9e9c4b662c340bb94b63d120be121f8543d']",96,536,632,4588831,11,,,,3573
a1c1ecfb27d5c187457952bdb485332d52bc47d2,0,Jungtaek Lim,2017-05-18 20:30:41+09:00,['c4988c998e47c87d5c4b27e072a8fd1450e0a245'],0,1,1,4588832,1,,,,3573
b7cb2d563eab9349bbbfaa9a6ce823bc2e291748,0,Robert Evans,2017-05-18 08:49:18-05:00,"['a1c1ecfb27d5c187457952bdb485332d52bc47d2', '4e00e48d5c45a7698e6dc727287089f5b6fd314d']",80,131,211,4589043,28,,,,3573
64e29f365c9b5d3e15b33f33ab64e200345333e4,1,Robert Evans,2017-05-18 08:51:20-05:00,['b7cb2d563eab9349bbbfaa9a6ce823bc2e291748'],1525,1490,3015,4592058,597,,,,3573
fd5367e6d2fbc8ff293bf530a3aba6c05eff5e1d,0,GitHub,2017-05-19 15:37:55+08:00,['64e29f365c9b5d3e15b33f33ab64e200345333e4'],2,2,4,4592062,1,,,,3573
a8cf3653bafb6b0f8b7c0e82e39ea619257671b3,0,Sriharsha Chintalapani,2017-05-19 13:51:40-07:00,"['64e29f365c9b5d3e15b33f33ab64e200345333e4', 'ca17c4ff10231a5d93deb3d4ac934140ccec674d']",11,17,28,4592090,4,,,,3573
e33c415e9cba89b6282b70af5c7f285071f62dfb,0,Sriharsha Chintalapani,2017-05-19 13:52:45-07:00,['a8cf3653bafb6b0f8b7c0e82e39ea619257671b3'],0,1,1,4592091,1,,,,3573
18170db7ee6ff08c74ab91e72e3eb5812ae78595,0,Jungtaek Lim,2017-05-20 16:57:59+09:00,"['e33c415e9cba89b6282b70af5c7f285071f62dfb', '3a1d2d64aef43b49d5f249785d92567eb712d4e8']",7,45,52,4592143,1,,,,3573
2a0c168dba1edc72b2dae6a40a693fdd264225b9,0,Jungtaek Lim,2017-05-20 17:01:24+09:00,['18170db7ee6ff08c74ab91e72e3eb5812ae78595'],0,1,1,4592144,1,,,,3573
1db867449c2e2dd8b17cbe464f5ac9ac972f8ff7,1,Stig Rohde D酶ssing,2017-05-21 00:14:50+02:00,['2a0c168dba1edc72b2dae6a40a693fdd264225b9'],195,185,380,4592524,25,1,1,1,3573
4d8f5d6edfd9c9a405cb4c6ea84312752e21fd6e,1,Jungtaek Lim,2017-05-21 19:30:44+09:00,['2a0c168dba1edc72b2dae6a40a693fdd264225b9'],382,470,852,4593376,59,0.72,0.72,0.56,3573
9d5a57004518b0f0aae3809b2fac13d51c75f928,1,Jungtaek Lim,2017-05-21 19:30:50+09:00,['4d8f5d6edfd9c9a405cb4c6ea84312752e21fd6e'],6,3,9,4593385,2,1,1,0,3573
c02fc09713d6a19122cd74ae6efa4761511bc6a9,0,Jungtaek Lim,2017-05-21 19:30:55+09:00,"['2a0c168dba1edc72b2dae6a40a693fdd264225b9', '9d5a57004518b0f0aae3809b2fac13d51c75f928']",386,471,857,4594242,59,,,,3573
ca12db92c361bb2e3d802f6bf1534f13301cb559,0,Jungtaek Lim,2017-05-21 19:41:06+09:00,['c02fc09713d6a19122cd74ae6efa4761511bc6a9'],1,1,2,4594244,1,,,,3573
20a82602ffda6795ced9d34e413464d7720f660c,1,Stig Rohde D酶ssing,2017-05-21 13:15:47+02:00,['ca12db92c361bb2e3d802f6bf1534f13301cb559'],11,100,111,4594355,8,0.441176471,1,1,3574
07ca978c78846c9159d4e132d46c62465e82ec84,0,Jungtaek Lim,2017-05-21 20:18:45+09:00,"['ca12db92c361bb2e3d802f6bf1534f13301cb559', '20a82602ffda6795ced9d34e413464d7720f660c']",11,100,111,4594466,8,,,,3574
779e5665696f5f10cf9674283420278f38c7a05c,0,Jungtaek Lim,2017-05-21 20:42:49+09:00,['07ca978c78846c9159d4e132d46c62465e82ec84'],0,1,1,4594467,1,,,,3574
185101dd8cd4955e37279670d8ae3f61e43f37a6,0,Robert (Bobby) Evans,2017-05-22 10:02:48-05:00,['779e5665696f5f10cf9674283420278f38c7a05c'],49,49,98,4594565,2,,,,3574
8a4fe363b9ef11f1dfdefc7eefd3aec3bf9f89b0,0,Robert Evans,2017-05-22 10:31:38-05:00,"['779e5665696f5f10cf9674283420278f38c7a05c', 'fd5367e6d2fbc8ff293bf530a3aba6c05eff5e1d']",2,2,4,4594569,1,,,,3574
83f11bd9e34948ae72ff50a55628298e36e62ec6,0,Robert Evans,2017-05-22 10:34:57-05:00,"['8a4fe363b9ef11f1dfdefc7eefd3aec3bf9f89b0', '0a88924bdaccb6471ed34b35de4d34e217d54d39']",59,46,105,4594674,8,,,,3574
d7fb0fbc4916afe734e69be9705d1b839af4f617,0,Robert Evans,2017-05-22 12:08:25-05:00,['83f11bd9e34948ae72ff50a55628298e36e62ec6'],0,1,1,4594675,1,,,,3574
22d1fe3881f0d62feddcf1cc7b8fcd3e9fed0360,1,Robert (Bobby) Evans,2017-05-22 16:00:03-05:00,['d7fb0fbc4916afe734e69be9705d1b839af4f617'],208,1203,1411,4596086,22,0.245967742,0.350806452,0.922043011,3575
e50c907e3ce17d9a8c71d43104ae36245d715ba4,0,Robert Evans,2017-05-22 16:20:02-05:00,"['d7fb0fbc4916afe734e69be9705d1b839af4f617', '22d1fe3881f0d62feddcf1cc7b8fcd3e9fed0360']",208,1203,1411,4597497,22,,,,3575
9e31509d47c4e91c1009f55c7ccf321d7d7e63aa,0,Robert Evans,2017-05-22 16:40:16-05:00,['e50c907e3ce17d9a8c71d43104ae36245d715ba4'],0,1,1,4597498,1,,,,3575
26bcfdbef95c4aecbff8aee0a587281f59b55bcf,0,Carl Haferd,2017-05-22 16:09:19-07:00,['9e31509d47c4e91c1009f55c7ccf321d7d7e63aa'],3,18,21,4597519,2,1,1,0,3575
d370c5e7a0da58eb5d2d9cd383a63a6977baf63b,0,Jungtaek Lim,2017-05-23 20:14:36+09:00,['779e5665696f5f10cf9674283420278f38c7a05c'],1,1,2,4597521,1,,,,3575
8bb5f5b8fdf5177129b44d7cda7de455913bfa40,0,Robert Evans,2017-05-23 08:50:55-05:00,"['9e31509d47c4e91c1009f55c7ccf321d7d7e63aa', '26bcfdbef95c4aecbff8aee0a587281f59b55bcf']",3,18,21,4597542,2,,,,3575
385fdd71fae99fc6ca55c157ab44d6313bdb840f,0,Robert Evans,2017-05-23 08:51:21-05:00,['8bb5f5b8fdf5177129b44d7cda7de455913bfa40'],0,1,1,4597543,1,,,,3575
ece2a1c8a7acef86152f81a8f031d6be0e6f98e3,0,Robert Evans,2017-05-23 10:15:19-05:00,"['385fdd71fae99fc6ca55c157ab44d6313bdb840f', '185101dd8cd4955e37279670d8ae3f61e43f37a6']",49,49,98,4597641,2,,,,3575
d67aaf344dd56c722562358eb7c9967f4942fe77,0,Robert Evans,2017-05-23 10:15:39-05:00,['ece2a1c8a7acef86152f81a8f031d6be0e6f98e3'],0,1,1,4597642,1,,,,3575
c2bd9f09aadb42c56960aae032de2ea289e83f32,0,Robert Evans,2017-05-23 12:57:10-05:00,"['d67aaf344dd56c722562358eb7c9967f4942fe77', '1db867449c2e2dd8b17cbe464f5ac9ac972f8ff7']",195,185,380,4598022,25,,,,3575
1a380ede3fb3e23db95790703c0a5a09c9052222,0,Robert Evans,2017-05-23 12:57:32-05:00,['c2bd9f09aadb42c56960aae032de2ea289e83f32'],0,1,1,4598023,1,,,,3575
2e24ab1041959f67fb3415275f09a0502b1d4640,1,Stig Rohde D酶ssing,2017-05-23 20:21:29+02:00,['1a380ede3fb3e23db95790703c0a5a09c9052222'],6,21,27,4598050,3,1,1,1,3575
00d064c1441bace7e96f1ea9cb89ffbae1bd2c38,0,Jungtaek Lim,2017-05-24 09:54:22+09:00,['779e5665696f5f10cf9674283420278f38c7a05c'],16,52,68,4598118,1,1,1,0,3575
65def93a8c8fc2b98be8cd9b466033cb4cbf875a,0,Satish Duggana,2017-05-24 09:30:02+05:18,"['1a380ede3fb3e23db95790703c0a5a09c9052222', '00d064c1441bace7e96f1ea9cb89ffbae1bd2c38']",16,52,68,4598186,1,,,,3575
d520353258806d9fb8ca28e9c39b5db1feaebb72,0,Satish Duggana,2017-05-24 10:18:04+05:18,['65def93a8c8fc2b98be8cd9b466033cb4cbf875a'],0,1,1,4598187,1,,,,3575
0b7f9a1b09a65b7b19ca54f8cf43cc9f6813565b,0,Balint Molnar,2017-05-24 13:32:06+02:00,['d520353258806d9fb8ca28e9c39b5db1feaebb72'],1,1,2,4598189,1,,,,3575
30cbae5795176351085f66a8eda55d90a75cc91d,0,Jungtaek Lim,2017-05-25 13:49:38+09:00,"['d520353258806d9fb8ca28e9c39b5db1feaebb72', 'd370c5e7a0da58eb5d2d9cd383a63a6977baf63b']",1,1,2,4598191,1,,,,3575
01b856479ab147fc148c928a500dbea4251fbf12,1,Stig Rohde D酶ssing,2017-05-25 17:54:48+02:00,['30cbae5795176351085f66a8eda55d90a75cc91d'],63,102,165,4598356,10,0.947368421,1,1,3575
e4e48f8255446f952278eb4f8937e54bcc14b6c0,1,stephen powis,2017-05-25 13:24:58-04:00,['9e31509d47c4e91c1009f55c7ccf321d7d7e63aa'],701,648,1349,4599705,15,0.992150022,0.829044919,0.890536415,3580
6111ab73343a7edaf1b971b2d63c8776d270fd71,0,Stig Rohde D酶ssing,2017-05-25 22:32:42+02:00,['30cbae5795176351085f66a8eda55d90a75cc91d'],16,37,53,4599758,1,,,,3580
6311abfc05afa4db9309fe1e3699c95d200c9e31,0,Robert Evans,2017-05-26 08:34:21-05:00,"['30cbae5795176351085f66a8eda55d90a75cc91d', 'e4e48f8255446f952278eb4f8937e54bcc14b6c0']",701,648,1349,4601107,15,,,,3580
465c9c61c7256203df22687da978619eb33fb290,0,Robert Evans,2017-05-26 08:52:04-05:00,['6311abfc05afa4db9309fe1e3699c95d200c9e31'],0,1,1,4601108,1,,,,3580
918849fb44d9d9133801f561a608ed42f774b421,0,Arun Mahadevan,2017-05-28 23:28:02+05:18,['465c9c61c7256203df22687da978619eb33fb290'],4,48,52,4601160,5,0.291666667,1,0.833333333,3580
7b7a8b31d3eb32d0feae16055590409db37bd9d4,0,Stig Rohde D酶ssing,2017-05-28 20:24:43+02:00,['1a380ede3fb3e23db95790703c0a5a09c9052222'],23,31,54,4601214,2,1,0,0,3580
3ceaba8873ff172285231f1234713df053d7e96d,0,Aditya Sharad,2017-05-29 15:04:48+01:00,['465c9c61c7256203df22687da978619eb33fb290'],5,5,10,4601224,1,,,,3580
699fc5a6c59945b6375670c8a7e47da0232f1ba2,0,Jungtaek Lim,2017-05-29 23:12:25+09:00,['465c9c61c7256203df22687da978619eb33fb290'],0,8,8,4601232,1,,,,3580
c46b49a973fae5c0624801d7ecc51c5775f90248,0,Sumedh Shekhar,2017-05-30 00:57:39+05:18,['465c9c61c7256203df22687da978619eb33fb290'],88,128,216,4601448,8,1,1,0,3580
2570f4e18f27d601a784f8d722078b74eadfe5d5,0,Sumedh Shekhar,2017-05-30 01:51:49+05:18,['c46b49a973fae5c0624801d7ecc51c5775f90248'],22,22,44,4601492,6,,,,3580
64fe32df8f5098d027a6c94b3c9ce5f0e7a96e4b,0,Jungtaek Lim,2017-05-30 07:45:12+09:00,"['465c9c61c7256203df22687da978619eb33fb290', '0b7f9a1b09a65b7b19ca54f8cf43cc9f6813565b']",1,1,2,4601494,1,,,,3580
adc3dd63b0b1ff65695f138ae683a53224f92e9a,0,Jungtaek Lim,2017-05-30 07:47:17+09:00,['64fe32df8f5098d027a6c94b3c9ce5f0e7a96e4b'],0,1,1,4601495,1,,,,3580
2de2999184aab4d1396b2c33228260a62606d5b4,0,Sumedh Shekhar,2017-05-30 04:59:31+05:18,['2570f4e18f27d601a784f8d722078b74eadfe5d5'],1,1,2,4601497,1,,,,3580
8ac9ef574599bf4cb2453bf04ff152df2ca40c61,0,Sumedh Shekhar,2017-05-30 05:04:47+05:18,['2de2999184aab4d1396b2c33228260a62606d5b4'],1,1,2,4601499,1,,,,3580
d4584c197932798817c8b14c8f63dc99df8917d9,0,Arun Mahadevan,2017-05-30 10:05:34+05:18,"['adc3dd63b0b1ff65695f138ae683a53224f92e9a', '918849fb44d9d9133801f561a608ed42f774b421']",4,48,52,4601551,5,,,,3580
349eb02831ce89ac18f6294624218c0db25f8230,0,Arun Mahadevan,2017-05-30 10:06:11+05:18,['d4584c197932798817c8b14c8f63dc99df8917d9'],0,1,1,4601552,1,,,,3580
9abebd5dc73301866d97c137f22696af412afd28,0,Arun Mahadevan,2017-05-30 15:41:13+05:18,"['349eb02831ce89ac18f6294624218c0db25f8230', '7b7a8b31d3eb32d0feae16055590409db37bd9d4']",23,31,54,4601606,2,,,,3580
416f3f7b35e6edb185eabd0d588b38a93534b9c8,0,Arun Mahadevan,2017-05-30 15:41:42+05:18,['9abebd5dc73301866d97c137f22696af412afd28'],0,1,1,4601607,1,,,,3580
ca2e124ca19f6ec6c1b384b159babadd06173956,0,Jungtaek Lim,2017-05-31 09:00:59+09:00,"['416f3f7b35e6edb185eabd0d588b38a93534b9c8', '699fc5a6c59945b6375670c8a7e47da0232f1ba2']",0,8,8,4601615,1,,,,3580
820195b4fa4f6316438b33ec3e464996cc164935,0,Jungtaek Lim,2017-05-31 09:03:53+09:00,['ca2e124ca19f6ec6c1b384b159babadd06173956'],0,1,1,4601616,1,,,,3580
6ce2cc7216344a8b5f8191e753fd0ec507937b73,0,Robert Evans,2017-06-02 10:23:55-05:00,"['820195b4fa4f6316438b33ec3e464996cc164935', '3ceaba8873ff172285231f1234713df053d7e96d']",5,5,10,4601626,1,,,,3580
3f5bac032e049f6e99d55b7945b3e26c2489bab2,0,Robert Evans,2017-06-02 10:24:15-05:00,['6ce2cc7216344a8b5f8191e753fd0ec507937b73'],0,1,1,4601627,1,,,,3580
64bf4daa9b92072bb91a694b34cb2d3fdc896cc6,0,Robert Evans,2017-06-02 10:40:14-05:00,"['3f5bac032e049f6e99d55b7945b3e26c2489bab2', '8ac9ef574599bf4cb2453bf04ff152df2ca40c61']",67,107,174,4601801,8,,,,3580
716ca5e5c0c9aa6a92ff27c9e84375e4478c1a08,0,Robert Evans,2017-06-02 10:40:41-05:00,['64bf4daa9b92072bb91a694b34cb2d3fdc896cc6'],0,1,1,4601802,1,,,,3580
281df26dcd4f887de2dcd100047cb48872dee9ea,0,Robert Evans,2017-06-02 11:05:37-05:00,"['716ca5e5c0c9aa6a92ff27c9e84375e4478c1a08', '6111ab73343a7edaf1b971b2d63c8776d270fd71']",16,37,53,4601855,1,,,,3580
138770d47c240c1817080b3b17748a5e74474b00,0,Robert Evans,2017-06-02 11:32:56-05:00,['281df26dcd4f887de2dcd100047cb48872dee9ea'],0,1,1,4601856,1,,,,3580
554cc8a006a6510e37744aec6ad9a091e0bafe4d,0,Robert Evans,2017-06-02 11:40:18-05:00,"['138770d47c240c1817080b3b17748a5e74474b00', '01b856479ab147fc148c928a500dbea4251fbf12']",63,102,165,4602021,10,,,,3580
5befe2746f98a2e37b20233cfd9bc63f491e5a49,0,Robert Evans,2017-06-02 12:15:58-05:00,['554cc8a006a6510e37744aec6ad9a091e0bafe4d'],0,1,1,4602022,1,,,,3580
5cba2319d9b312f5698fac8eb96ad132b426028e,1,Govind Menon,2017-06-05 13:30:45-05:00,['5befe2746f98a2e37b20233cfd9bc63f491e5a49'],71,153,224,4602246,16,0.2,0,0.933333333,3580
e65f23b7df2be87cc57a0b42ff47445c3baa755a,1,Stig Rohde D酶ssing,2017-06-06 17:50:30+02:00,['5befe2746f98a2e37b20233cfd9bc63f491e5a49'],7,11,18,4602264,4,1,1,1,3580
b57f1365da65243eb7729cd766dcb55b6cd70c1b,0,Robert Evans,2017-06-06 10:58:27-05:00,"['5befe2746f98a2e37b20233cfd9bc63f491e5a49', '5cba2319d9b312f5698fac8eb96ad132b426028e']",71,153,224,4602488,16,,,,3580
7f33447477dfbf581e9b46feb27c362cc170dc56,0,Robert Evans,2017-06-06 10:58:46-05:00,['b57f1365da65243eb7729cd766dcb55b6cd70c1b'],0,1,1,4602489,1,,,,3580
3ac89a44c665c85ed94fa82b6cff7761a0e4bbc7,0,Jungtaek Lim,2017-06-07 08:07:34+09:00,"['7f33447477dfbf581e9b46feb27c362cc170dc56', 'e65f23b7df2be87cc57a0b42ff47445c3baa755a']",7,11,18,4602507,4,,,,3580
f4787519501b8417aead5e9720697c0cc104cc31,0,Jungtaek Lim,2017-06-07 08:09:53+09:00,['3ac89a44c665c85ed94fa82b6cff7761a0e4bbc7'],0,1,1,4602508,1,,,,3580
4f9d5c013da12284353a2411ef386c07ef210214,1,Govind Menon,2017-06-09 12:42:17-05:00,['f4787519501b8417aead5e9720697c0cc104cc31'],17,42,59,4602567,3,1,1,1,3580
b20a6dfa973de028db614bece9a429d22c84aee0,0,Robert Evans,2017-06-09 15:11:37-05:00,"['f4787519501b8417aead5e9720697c0cc104cc31', '4f9d5c013da12284353a2411ef386c07ef210214']",17,42,59,4602626,3,,,,3580
ca10da2fd96023601b406a15c520bfb72e7078d6,0,Robert Evans,2017-06-09 15:12:00-05:00,['b20a6dfa973de028db614bece9a429d22c84aee0'],0,1,1,4602627,1,,,,3580
38e997ed96ce6627cabb4054224d7044fd2b40f9,0,Jungtaek Lim,2017-06-12 09:56:53+09:00,"['ca10da2fd96023601b406a15c520bfb72e7078d6', 'a67a3d2b4d8b9b3db955c489f8e7cf096926569d']",10,58,68,4602695,2,,,,3580
fdf63ce9a619ee24b52435e8f5945304912ad3ea,0,Jungtaek Lim,2017-06-16 15:39:45+09:00,['38e997ed96ce6627cabb4054224d7044fd2b40f9'],35,360,395,4603090,2,0.295180723,0.843373494,0.909638554,3581
b3389abbfdc37fb89d838547769703fedcd82d27,1,Jungtaek Lim,2017-06-17 20:37:25+09:00,['38e997ed96ce6627cabb4054224d7044fd2b40f9'],59,79,138,4603228,2,0.314285714,1,1,3582
0acbc19ceff975200722109abf031f027c2ac2f0,0,Jungtaek Lim,2017-06-17 20:37:33+09:00,"['38e997ed96ce6627cabb4054224d7044fd2b40f9', 'b3389abbfdc37fb89d838547769703fedcd82d27']",59,79,138,4603366,2,,,,3582
ed130ac7ae8b561909b7608b7900a6e8fed3380b,0,Jungtaek Lim,2017-06-17 20:37:51+09:00,['0acbc19ceff975200722109abf031f027c2ac2f0'],0,1,1,4603367,1,,,,3582
b59e49b2dd7bd75c738751208b64eabe18f9c894,0,Jungtaek Lim,2017-06-17 20:41:48+09:00,['ed130ac7ae8b561909b7608b7900a6e8fed3380b'],1,1,2,4603369,1,,,,3582
bfcf398c96c277801699da5a32cf03bb04070e10,0,鍒樺厗鍧?0206665,2017-06-19 10:42:47+08:00,['b59e49b2dd7bd75c738751208b64eabe18f9c894'],3,0,3,4603372,1,,,,3582
6fe323d27b3a7a8a8f47f7b9062ee1b793804d8a,0,Jungtaek Lim,2017-06-20 20:34:06+09:00,"['b59e49b2dd7bd75c738751208b64eabe18f9c894', 'fdf63ce9a619ee24b52435e8f5945304912ad3ea']",35,360,395,4603767,2,,,,3582
8a71ec5bea5f323304b3737e3a650b9345bf6f5c,0,Jungtaek Lim,2017-06-20 20:56:56+09:00,['6fe323d27b3a7a8a8f47f7b9062ee1b793804d8a'],0,1,1,4603768,1,,,,3582
8299b0c9e0ca0213055e2199d3a6947cf33e08ba,0,Jungtaek Lim,2017-06-20 21:11:41+09:00,['8a71ec5bea5f323304b3737e3a650b9345bf6f5c'],2,22,24,4603792,1,0.888888889,1,1,3582
52744f77d3cd07ac0e959fabee2f8e8cd2de790c,0,Jungtaek Lim,2017-06-20 21:12:12+09:00,"['8a71ec5bea5f323304b3737e3a650b9345bf6f5c', '8299b0c9e0ca0213055e2199d3a6947cf33e08ba']",2,22,24,4603816,1,,,,3582
4461a1d54b94f59042d3a68f4aeec1b883503702,0,Jungtaek Lim,2017-06-20 21:20:28+09:00,['52744f77d3cd07ac0e959fabee2f8e8cd2de790c'],0,1,1,4603817,1,,,,3582
3ab11ea2945175713bf759024376b5072d94f0c8,0,Srishty Agrawal,2017-06-20 11:06:09-07:00,['4461a1d54b94f59042d3a68f4aeec1b883503702'],29,35,64,4603881,8,0.8,1,0,3582
3baf61bad84001cd3ed21d30dc56b3df60e75e20,0,Priyank,2017-06-20 12:01:13-07:00,['4461a1d54b94f59042d3a68f4aeec1b883503702'],1,1,2,4603883,1,,,,3582
2fac9787c711ee30145c4275547629394df1c67b,0,Arun Mahadevan,2017-06-21 09:59:36+05:18,['820195b4fa4f6316438b33ec3e464996cc164935'],38,2,40,4603923,1,1,1,0,3582
9ca6d95bda80c5685d1ac7262ae6f8520eb8c483,1,Jungtaek Lim,2017-06-21 20:33:19+09:00,['38e997ed96ce6627cabb4054224d7044fd2b40f9'],828,1229,2057,4605980,19,0.081081081,1,0.081081081,3593
b0258d5e38b5bafd43f19bc109d7ae3488379460,0,Prasanna Ranganathan,2017-06-21 18:07:16+05:18,['38e997ed96ce6627cabb4054224d7044fd2b40f9'],4,5,9,4605989,1,,,,3593
acad0fed7c448a0fba5ab6c8be01b067a1081f01,0,Jungtaek Lim,2017-06-22 07:36:18+09:00,"['4461a1d54b94f59042d3a68f4aeec1b883503702', '9ca6d95bda80c5685d1ac7262ae6f8520eb8c483']",828,1229,2057,4608046,19,,,,3593
ef283a17bed7963da164335fe3631f913dac5645,0,Jungtaek Lim,2017-06-22 07:36:39+09:00,['acad0fed7c448a0fba5ab6c8be01b067a1081f01'],0,1,1,4608047,1,,,,3593
9e7b6819f1ae651eab95bcfd24f276ac81dff2ac,0,Jungtaek Lim,2017-06-22 07:56:45+09:00,"['ef283a17bed7963da164335fe3631f913dac5645', 'b0258d5e38b5bafd43f19bc109d7ae3488379460']",4,5,9,4608056,1,,,,3593
648f0d6e3c1cc97c1135aa567a0c630c8db59593,0,Jungtaek Lim,2017-06-22 07:57:35+09:00,['9e7b6819f1ae651eab95bcfd24f276ac81dff2ac'],0,1,1,4608057,1,,,,3593
9fb21e7f6e02cf3cb86a4171953c20287c045e45,0,Jungtaek Lim,2017-06-22 08:16:09+09:00,['648f0d6e3c1cc97c1135aa567a0c630c8db59593'],3,77,80,4608137,3,0.31372549,0.31372549,1,3593
adec42aee2723c4fbcded32b61835c1f6a6d963f,0,Jungtaek Lim,2017-06-22 08:37:15+09:00,"['648f0d6e3c1cc97c1135aa567a0c630c8db59593', '9fb21e7f6e02cf3cb86a4171953c20287c045e45']",3,77,80,4608217,3,,,,3593
34a7f6fee80868c3c4ee5fb03a46147061f38915,0,Jungtaek Lim,2017-06-22 08:38:21+09:00,['adec42aee2723c4fbcded32b61835c1f6a6d963f'],0,1,1,4608218,1,,,,3593
9a20c67e63cef8cbfe024aa38b336c8a21dc0103,0,Jungtaek Lim,2017-06-22 08:49:47+09:00,"['34a7f6fee80868c3c4ee5fb03a46147061f38915', '3ab11ea2945175713bf759024376b5072d94f0c8']",29,35,64,4608282,8,,,,3593
659b59d0339d304140abab25ff6a92a7054a35e0,0,Jungtaek Lim,2017-06-22 08:51:21+09:00,['9a20c67e63cef8cbfe024aa38b336c8a21dc0103'],1,2,3,4608285,1,,,,3593
11cb85f210de143c60822b96fd894c130c930fe8,0,Arun Mahadevan,2017-06-22 06:51:25+05:18,"['659b59d0339d304140abab25ff6a92a7054a35e0', '3baf61bad84001cd3ed21d30dc56b3df60e75e20']",1,1,2,4608287,1,,,,3593
841445756ad8942da5041eb01b63ca9e94001b10,0,Arun Mahadevan,2017-06-22 06:53:29+05:18,['11cb85f210de143c60822b96fd894c130c930fe8'],0,1,1,4608288,1,,,,3593
1d945892b04f271eb26702b57be8aa2af38ac21f,0,yan guotao,2017-06-22 10:21:11+08:00,['38e997ed96ce6627cabb4054224d7044fd2b40f9'],3,45,48,4608336,5,0.866666667,1,0.466666667,3593
966d44501fca9c332ef4c078e4b7bc191092c83b,0,Jungtaek Lim,2017-06-22 12:30:30+09:00,"['841445756ad8942da5041eb01b63ca9e94001b10', '1d945892b04f271eb26702b57be8aa2af38ac21f']",3,45,48,4608384,5,,,,3593
63e20784aaafdbf78a5b2e3ce9a9847ab4b76b0e,0,Jungtaek Lim,2017-06-22 12:30:47+09:00,['966d44501fca9c332ef4c078e4b7bc191092c83b'],0,1,1,4608385,1,,,,3593
b03118aecbb44545574ec649b554d2033d2efa20,1,Jungtaek Lim,2017-06-22 15:26:50+09:00,['63e20784aaafdbf78a5b2e3ce9a9847ab4b76b0e'],39,112,151,4608536,6,0,0.863636364,0.454545455,3593
cc35446c8cee800f87edb328b115492f7d3a120d,0,Jungtaek Lim,2017-06-22 15:43:27+09:00,"['63e20784aaafdbf78a5b2e3ce9a9847ab4b76b0e', '2fac9787c711ee30145c4275547629394df1c67b']",38,2,40,4608576,1,,,,3593
980c65573de0b83ad0a60f9bf8e9f9682425bcaf,0,Jungtaek Lim,2017-06-22 15:44:44+09:00,['cc35446c8cee800f87edb328b115492f7d3a120d'],0,1,1,4608577,1,,,,3593
3811e5c7a97d3d502d5b79f905017e1ad78acfe4,0,Jordi Esteban,2017-06-22 15:38:29+02:00,['38e997ed96ce6627cabb4054224d7044fd2b40f9'],0,4,4,4608581,1,0,0,0,3593
e9c09789f7953b251c7104336eaf16cf88346f0a,0,Jungtaek Lim,2017-06-23 00:08:07+09:00,"['980c65573de0b83ad0a60f9bf8e9f9682425bcaf', '3811e5c7a97d3d502d5b79f905017e1ad78acfe4']",0,4,4,4608585,1,,,,3593
27e3f6a8dc11c27acb421eefa34024ea3662fe92,0,Jungtaek Lim,2017-06-23 01:02:14+09:00,['e9c09789f7953b251c7104336eaf16cf88346f0a'],0,1,1,4608586,1,,,,3593
ddf11b156e8386e425da533ab96d584254ab3858,0,Robert (Bobby) Evans,2017-06-23 14:57:55-05:00,['27e3f6a8dc11c27acb421eefa34024ea3662fe92'],4,2,6,4608592,1,1,1,1,3593
342d466911e71943b0269719c7f7ab1126fad8c6,0,Jungtaek Lim,2017-06-24 13:31:21+09:00,"['27e3f6a8dc11c27acb421eefa34024ea3662fe92', 'b03118aecbb44545574ec649b554d2033d2efa20']",39,112,151,4608743,6,,,,3593
c2253fbdbf63ab618eb56c08c24c18e28bf2c8f3,0,Jungtaek Lim,2017-06-24 13:31:45+09:00,['342d466911e71943b0269719c7f7ab1126fad8c6'],0,1,1,4608744,1,,,,3593
c2477520c18ee56401d2517b09e372b6d58df559,0,Jungtaek Lim,2017-06-24 14:03:35+09:00,['27e3f6a8dc11c27acb421eefa34024ea3662fe92'],48,230,278,4609022,5,0.383561644,0,0.452054795,3593
9858a605ec7671285cc701940c8e68d0bb59345b,0,Heather McCartney,2017-06-24 15:31:09+01:00,['c2253fbdbf63ab618eb56c08c24c18e28bf2c8f3'],112,485,597,4609619,11,0.894444444,1,0.933333333,3596
914d768f8ebdbeef9223f36c59bfd0ad9aaddbd3,0,Stig Rohde D酶ssing,2017-06-24 17:22:29+02:00,['c2253fbdbf63ab618eb56c08c24c18e28bf2c8f3'],2,1,3,4609622,1,,,,3596
62498dc4c5db0458e714d27c1ec3172f15fba083,0,Satish Duggana,2017-06-26 09:30:28+05:18,"['c2253fbdbf63ab618eb56c08c24c18e28bf2c8f3', 'c2477520c18ee56401d2517b09e372b6d58df559']",48,230,278,4609900,5,,,,3596
062457a73a47b6a658b7c0c4fc908a72770c6faa,0,Jungtaek Lim,2017-06-26 13:40:53+09:00,"['c2253fbdbf63ab618eb56c08c24c18e28bf2c8f3', 'c2477520c18ee56401d2517b09e372b6d58df559']",48,230,278,4610178,5,,,,3596
100c35c8b69622bcc3fa4be7580f067df9fdfc80,0,Jungtaek Lim,2017-06-26 13:42:17+09:00,['062457a73a47b6a658b7c0c4fc908a72770c6faa'],0,1,1,4610179,1,,,,3596
d767313e7aa1fd0e07fd285d6cd1224d6921a4a0,0,Satish Duggana,2017-06-26 10:02:24+05:18,['62498dc4c5db0458e714d27c1ec3172f15fba083'],0,1,1,4610180,1,,,,3596
daacde53de91a2bd66d8105bc8c0bc6efcb5178e,0,Satish Duggana,2017-06-26 10:03:53+05:18,"['d767313e7aa1fd0e07fd285d6cd1224d6921a4a0', '100c35c8b69622bcc3fa4be7580f067df9fdfc80']",0,1,1,4610181,1,,,,3596
bf8198d6fe71ebfb46c5a2975632595bd699300e,0,鍒樺厗鍧?0206665,2017-06-27 09:19:02+08:00,['4461a1d54b94f59042d3a68f4aeec1b883503702'],0,18,18,4610199,1,,,,3597
e424a6cf1d4f0199ee97a16ca79afc2c64dc1e59,0,Jungtaek Lim,2017-06-28 21:51:34+09:00,['daacde53de91a2bd66d8105bc8c0bc6efcb5178e'],629,1906,2535,4612734,36,0.903896104,0.994805195,0.903896104,3609
69b6bfb8d0db7e0fa25a58e63eb9f6a6c7387f35,0,Jungtaek Lim,2017-06-29 13:43:10+09:00,"['daacde53de91a2bd66d8105bc8c0bc6efcb5178e', 'bfcf398c96c277801699da5a32cf03bb04070e10']",3,0,3,4612737,1,,,,3609
f70f9f9764ddfaa4d882cc56e7e8dfa8f7924c8b,0,Jungtaek Lim,2017-06-29 13:43:37+09:00,['69b6bfb8d0db7e0fa25a58e63eb9f6a6c7387f35'],0,1,1,4612738,1,,,,3609
88f9ea6c72317c83a9f1a91ce8c4b08b5bc1f646,0,Jungtaek Lim,2017-06-29 14:16:10+09:00,"['f70f9f9764ddfaa4d882cc56e7e8dfa8f7924c8b', '914d768f8ebdbeef9223f36c59bfd0ad9aaddbd3']",2,1,3,4612741,1,,,,3609
ad3c4650b73e77331f9ea520ac750192590c98f2,0,Jungtaek Lim,2017-06-29 14:27:51+09:00,['88f9ea6c72317c83a9f1a91ce8c4b08b5bc1f646'],0,1,1,4612742,1,,,,3609
c9ef5c6852694e883db3c42c5584e0df121f9abe,0,Jungtaek Lim,2017-06-29 15:59:37+09:00,"['ad3c4650b73e77331f9ea520ac750192590c98f2', 'bf8198d6fe71ebfb46c5a2975632595bd699300e']",0,18,18,4612760,1,,,,3609
2e2adc725ecf3c41206e93e473eb5380c023316d,0,Jungtaek Lim,2017-06-29 16:00:56+09:00,['c9ef5c6852694e883db3c42c5584e0df121f9abe'],0,1,1,4612761,1,,,,3609
a99a029ad918a57326f41a6055ca170d28a2f02b,0,Jungtaek Lim,2017-06-29 22:29:52+09:00,"['2e2adc725ecf3c41206e93e473eb5380c023316d', 'e424a6cf1d4f0199ee97a16ca79afc2c64dc1e59']",629,1906,2535,4615296,36,,,,3609
2a2befaa63192921508c73f79f26a6bac8058ee4,0,Jungtaek Lim,2017-06-29 22:30:12+09:00,['a99a029ad918a57326f41a6055ca170d28a2f02b'],0,1,1,4615297,1,,,,3609
5fa7154120b48e9aff9656f6c0f831f7612b678a,0,Robert Evans,2017-06-29 13:19:58-05:00,"['2a2befaa63192921508c73f79f26a6bac8058ee4', 'ddf11b156e8386e425da533ab96d584254ab3858']",4,2,6,4615303,1,,,,3609
7db08a8127b58f3e5acc01e5b24b749d0794ddf1,0,Robert Evans,2017-06-29 13:24:19-05:00,['5fa7154120b48e9aff9656f6c0f831f7612b678a'],0,1,1,4615304,1,,,,3609
4eb4cd1b3f049b0fbd5042eded547fb750cd81cc,0,shichenglong,2017-06-30 08:59:30+08:00,['c2253fbdbf63ab618eb56c08c24c18e28bf2c8f3'],3,11,14,4615318,1,1,1,0,3609
a1b6a443c130b40ba001105c1541015c087a554c,0,鍒樺厗鍧?0206665,2017-06-30 11:01:30+08:00,['daacde53de91a2bd66d8105bc8c0bc6efcb5178e'],8,5,13,4615331,2,1,1,1,3609
963db6f39cf439a0d2b01e3a98f5d07c9a8ff2ec,1,Stig Rohde D酶ssing,2017-06-30 08:01:49+02:00,['daacde53de91a2bd66d8105bc8c0bc6efcb5178e'],471,102,573,4615904,6,1,1,1,3611
96f6b063579f5b213f2c89dea4ac5700458a6f88,0,Jungtaek Lim,2017-06-30 16:40:17+09:00,"['7db08a8127b58f3e5acc01e5b24b749d0794ddf1', '963db6f39cf439a0d2b01e3a98f5d07c9a8ff2ec']",471,102,573,4616477,6,,,,3611
4ec7963b4031c83e0e7709ed76b768b9e8cd8ea0,0,Jungtaek Lim,2017-06-30 17:03:16+09:00,['96f6b063579f5b213f2c89dea4ac5700458a6f88'],0,1,1,4616478,1,,,,3611
13d22df5ffc6dfe0fa037d8aa966f991bbcf1193,0,Jungtaek Lim,2017-06-30 17:10:30+09:00,"['4ec7963b4031c83e0e7709ed76b768b9e8cd8ea0', '4eb4cd1b3f049b0fbd5042eded547fb750cd81cc']",3,11,14,4616492,1,,,,3611
48bcf85f186effea0dfb518de619bd97fb531b04,0,Jungtaek Lim,2017-06-30 17:30:50+09:00,['13d22df5ffc6dfe0fa037d8aa966f991bbcf1193'],0,1,1,4616493,1,,,,3611
9ce3585b11a14be97e5236ebbfba043da87c3d34,0,Jungtaek Lim,2017-06-30 18:24:55+09:00,"['48bcf85f186effea0dfb518de619bd97fb531b04', '9858a605ec7671285cc701940c8e68d0bb59345b']",112,485,597,4617090,11,,,,3611
86e389c883b03080304a6f65659cf311682b56bf,0,Jungtaek Lim,2017-06-30 18:25:28+09:00,['9ce3585b11a14be97e5236ebbfba043da87c3d34'],0,1,1,4617091,1,,,,3611
5a23997720a0fec60f137222182fa43d848a1e78,0,Robert (Bobby) Evans,2017-06-30 16:34:01-05:00,['86e389c883b03080304a6f65659cf311682b56bf'],28,24,52,4617143,4,0,0,0,3611
73c59dcd1a4668c1f1e1fd317cc8f8eb3fe4523e,0,vinodkc,2017-07-03 17:31:03+05:18,['86e389c883b03080304a6f65659cf311682b56bf'],1,1,2,4617145,1,,,,3611
5fcb6728ba043117725dc7c8ae0754bcd7dc61d0,0,Satish Duggana,2017-07-04 15:46:25+05:18,['73c59dcd1a4668c1f1e1fd317cc8f8eb3fe4523e'],0,1,1,4617146,1,,,,3611
91add2832b6f0b22afdf162c65f7a833a62b9b66,0,Jungtaek Lim,2017-07-04 21:13:30+09:00,['86e389c883b03080304a6f65659cf311682b56bf'],12,30,42,4617188,1,,,,3611
80bf4e270716ae7264b7615b18d078daa8297933,0,Satish Duggana,2017-07-04 18:25:10+05:18,"['5fcb6728ba043117725dc7c8ae0754bcd7dc61d0', '91add2832b6f0b22afdf162c65f7a833a62b9b66']",12,30,42,4617230,1,,,,3611
9f082ae9af3fc64df3fcadbec720e05270c1ff75,0,Jungtaek Lim,2017-07-05 21:49:10+09:00,['80bf4e270716ae7264b7615b18d078daa8297933'],21,1786,1807,4619037,13,0.686645636,0.915878023,0.8170347,3618
3e251adaa74f319b41a81eafba1f5a1b2ec12311,1,Robert (Bobby) Evans,2017-07-05 10:47:49-05:00,['80bf4e270716ae7264b7615b18d078daa8297933'],12,157,169,4619206,5,0.317073171,0.43902439,0.841463415,3619
85396df9b321ccd19d42a28e441aa51c1f8d87d9,0,Robert (Bobby) Evans,2017-07-05 12:27:58-05:00,['3e251adaa74f319b41a81eafba1f5a1b2ec12311'],10,105,115,4619321,4,,,,3619
538edf3a20106b1358371bebbe1bbfcc17d4efb7,0,Jungtaek Lim,2017-07-06 12:16:22+09:00,"['80bf4e270716ae7264b7615b18d078daa8297933', 'a1b6a443c130b40ba001105c1541015c087a554c']",8,5,13,4619334,2,,,,3619
23d0c41ade1b392d282ad4cf4b63d510c9d7f5bb,0,Jungtaek Lim,2017-07-06 12:25:21+09:00,['538edf3a20106b1358371bebbe1bbfcc17d4efb7'],0,1,1,4619335,1,,,,3619
a164ceda95d52f8f4a2537ea4f98ba4dbc84b5b7,0,Robert (Bobby) Evans,2017-07-06 08:07:50-05:00,['5a23997720a0fec60f137222182fa43d848a1e78'],10,9,19,4619354,1,,,,3619
8f829ddb40bae579d6416b0128ac72861fd98ac7,0,Robert Evans,2017-07-06 08:15:10-05:00,"['23d0c41ade1b392d282ad4cf4b63d510c9d7f5bb', '85396df9b321ccd19d42a28e441aa51c1f8d87d9']",22,262,284,4619638,9,,,,3619
43fde85e350c7feaa8e289fab0eedcfafedab44d,0,Robert Evans,2017-07-06 09:13:27-05:00,['8f829ddb40bae579d6416b0128ac72861fd98ac7'],0,1,1,4619639,1,,,,3619
2c39f691ea6ccb2599a4a8658b86ed04b5d00fb6,0,Jungtaek Lim,2017-07-07 13:37:47+09:00,"['43fde85e350c7feaa8e289fab0eedcfafedab44d', '2e24ab1041959f67fb3415275f09a0502b1d4640']",6,21,27,4619666,3,,,,3619
85486dde9dc5cff8e9a7cbb7c913c5cb68ed3be5,0,Jungtaek Lim,2017-07-07 13:50:51+09:00,['2c39f691ea6ccb2599a4a8658b86ed04b5d00fb6'],0,1,1,4619667,1,,,,3619
b1c04ef59a9f258e8618358529e53e7d47f9cb5a,0,Jungtaek Lim,2017-07-07 14:13:21+09:00,"['85486dde9dc5cff8e9a7cbb7c913c5cb68ed3be5', '9f082ae9af3fc64df3fcadbec720e05270c1ff75']",21,1786,1807,4621474,13,,,,3619
02598af367c1ea356109c591f97dc7db38674690,0,Jungtaek Lim,2017-07-07 14:13:45+09:00,['b1c04ef59a9f258e8618358529e53e7d47f9cb5a'],0,1,1,4621475,1,,,,3619
0201ae79a5f4fc7ba7ee1c524818a29a92f140f1,0,Ethan Li,2017-07-07 06:17:01-05:00,['43fde85e350c7feaa8e289fab0eedcfafedab44d'],0,16,16,4621491,1,,,,3619
e138df8e46566d1b9b061265399e5e44986d4d1a,0,Robert Evans,2017-07-07 08:50:07-05:00,"['02598af367c1ea356109c591f97dc7db38674690', 'a164ceda95d52f8f4a2537ea4f98ba4dbc84b5b7']",32,27,59,4621550,4,,,,3619
d7c781891fd0cf409335ed1b70397e3c6747475e,0,Robert Evans,2017-07-07 08:50:43-05:00,['e138df8e46566d1b9b061265399e5e44986d4d1a'],0,1,1,4621551,1,,,,3619
24dc055226d377f04e1b3116ceb5e5261133bd16,0,Xin Wang,2017-07-09 13:40:57+08:00,['d7c781891fd0cf409335ed1b70397e3c6747475e'],12,45,57,4621608,4,1,1,0,3620
3d4c59e5d3f20cae205a82336b2cd59ff51fac84,0,Xin Wang,2017-07-09 18:06:22+08:00,['d7c781891fd0cf409335ed1b70397e3c6747475e'],95,156,251,4621859,22,,,,3620
1d7be760198189711165abac48acfd3bc332083a,0,Xin Wang,2017-07-09 21:02:30+08:00,['d7c781891fd0cf409335ed1b70397e3c6747475e'],164,237,401,4622260,27,,,,3620
49e461f36eb530e6a006d5403ec076f7ba9047bc,0,Ethan Li,2017-07-09 22:57:33+00:00,['d7c781891fd0cf409335ed1b70397e3c6747475e'],3,3,6,4622266,1,,,,3620
8172b63a46cb660dfbbae2b37a4b79f1481fb065,0,Jungtaek Lim,2017-07-10 09:37:58+09:00,"['d7c781891fd0cf409335ed1b70397e3c6747475e', '0201ae79a5f4fc7ba7ee1c524818a29a92f140f1']",0,16,16,4622282,1,,,,3620
03578ca9961fd1ad1ffc5432839fc4ad04455d96,0,Jungtaek Lim,2017-07-10 10:04:47+09:00,['8172b63a46cb660dfbbae2b37a4b79f1481fb065'],0,1,1,4622283,1,,,,3620
f967a2b55bad9d4cc8d62ea426c570de67f27e22,0,Kevin Conaway,2017-07-10 08:33:14-04:00,['03578ca9961fd1ad1ffc5432839fc4ad04455d96'],9,339,348,4622631,3,0.276243094,0.845303867,0.801104972,3621
908da58db4c1ce5a62ad0c1a7cb9838ef214501a,0,Robert (Bobby) Evans,2017-07-10 08:59:28-05:00,['03578ca9961fd1ad1ffc5432839fc4ad04455d96'],2,2,4,4622635,1,,,,3621
34b9fb2c15ec32d763416ede3e3c3c0d0e185ee0,0,Jungtaek Lim,2017-07-11 07:52:29+09:00,"['03578ca9961fd1ad1ffc5432839fc4ad04455d96', '71e05fed8e0af46ab88af4ecd5b36a79daa6c484']",9,143,152,4622787,4,,,,3621
97cc20b941f9f2cfe677465d1996ce71ebbf9d1e,0,Jungtaek Lim,2017-07-11 07:54:29+09:00,['34b9fb2c15ec32d763416ede3e3c3c0d0e185ee0'],0,1,1,4622788,1,,,,3621
2f2e9e11d0bb7c8d246517320a47337ff8b5bd19,0,Jungtaek Lim,2017-07-11 07:59:23+09:00,['97cc20b941f9f2cfe677465d1996ce71ebbf9d1e'],22,442,464,4623252,3,0.135036496,0.96350365,0.96350365,3622
1b4e4e7f02036a6e0989f9709ec65c229ee0eabf,0,Jungtaek Lim,2017-07-11 07:59:44+09:00,"['97cc20b941f9f2cfe677465d1996ce71ebbf9d1e', '2f2e9e11d0bb7c8d246517320a47337ff8b5bd19']",22,442,464,4623716,3,,,,3622
458595fb6bf787c96329ea85466ef4e5e22cd4aa,0,Jungtaek Lim,2017-07-11 08:00:08+09:00,['1b4e4e7f02036a6e0989f9709ec65c229ee0eabf'],0,1,1,4623717,1,,,,3622
26b24b9e4f22327b4e79b0d1deff3b0c8e7d8d33,0,Jungtaek Lim,2017-07-11 08:03:45+09:00,"['458595fb6bf787c96329ea85466ef4e5e22cd4aa', 'f967a2b55bad9d4cc8d62ea426c570de67f27e22']",9,339,348,4624065,3,,,,3622
29a8a42c85cb9e3c6e2ebc6dcd8148b6976badd7,0,Jungtaek Lim,2017-07-11 08:04:21+09:00,['26b24b9e4f22327b4e79b0d1deff3b0c8e7d8d33'],0,1,1,4624066,1,,,,3622
88e691aa3009cf14f433333775d37b964fcd6c90,0,Jungtaek Lim,2017-07-11 08:22:26+09:00,"['29a8a42c85cb9e3c6e2ebc6dcd8148b6976badd7', '1d7be760198189711165abac48acfd3bc332083a']",164,237,401,4624467,27,,,,3622
64fab1e58349f5057d9bfd95be018ed8224a88c4,0,Jungtaek Lim,2017-07-11 08:22:46+09:00,['88e691aa3009cf14f433333775d37b964fcd6c90'],0,1,1,4624468,1,,,,3622
53616605396461fb08b490655eedc063252e918e,0,Jungtaek Lim,2017-07-11 08:24:45+09:00,"['64fab1e58349f5057d9bfd95be018ed8224a88c4', '3d4c59e5d3f20cae205a82336b2cd59ff51fac84']",95,156,251,4624719,22,,,,3622
d537a53411fc1899949e460600ccf6ce1d106988,0,Jungtaek Lim,2017-07-11 08:25:06+09:00,['53616605396461fb08b490655eedc063252e918e'],0,1,1,4624720,1,,,,3622
f4ee179a21943f73e4b2049a5d2d23ef3d5e2673,0,Jungtaek Lim,2017-07-11 08:30:12+09:00,"['d537a53411fc1899949e460600ccf6ce1d106988', '24dc055226d377f04e1b3116ceb5e5261133bd16']",12,45,57,4624777,4,,,,3622
caeaf255b7c20009d36c39bc2999c205082c63aa,0,Jungtaek Lim,2017-07-11 08:36:43+09:00,['f4ee179a21943f73e4b2049a5d2d23ef3d5e2673'],0,1,1,4624778,1,,,,3622
ec297dda7076b44f5cf37a88e7eb3bed4e2c14b2,0,Jungtaek Lim,2017-07-11 08:38:40+09:00,"['caeaf255b7c20009d36c39bc2999c205082c63aa', '49e461f36eb530e6a006d5403ec076f7ba9047bc']",3,3,6,4624784,1,,,,3622
8ba90e9fa5aeb0169480dd8622fed93e1fd1a657,0,Jungtaek Lim,2017-07-11 08:42:22+09:00,"['ec297dda7076b44f5cf37a88e7eb3bed4e2c14b2', '908da58db4c1ce5a62ad0c1a7cb9838ef214501a']",2,2,4,4624788,1,,,,3622
2dd79db30a360d1f899c54c18873a41a74dfd5a4,0,Jungtaek Lim,2017-07-13 00:53:53+09:00,['8ba90e9fa5aeb0169480dd8622fed93e1fd1a657'],0,6,6,4624794,6,,,,3622
559053dec9cd3e6b46cb71323a64c9e0c2e86838,0,Jungtaek Lim,2017-07-14 12:11:16+09:00,"['8ba90e9fa5aeb0169480dd8622fed93e1fd1a657', '2dd79db30a360d1f899c54c18873a41a74dfd5a4']",0,6,6,4624800,6,,,,3622
11a79053f7a9250b7347013cafff0e8eec79ec70,1,Jungtaek Lim,2017-07-14 12:11:41+09:00,['559053dec9cd3e6b46cb71323a64c9e0c2e86838'],55,2734,2789,4627589,32,0.500681199,0.628065395,0.476158038,3639
44b268badb7ee1a92b1cc8abf81dbb640fa9af19,1,Jungtaek Lim,2017-07-14 12:11:41+09:00,['11a79053f7a9250b7347013cafff0e8eec79ec70'],2188,1859,4047,4631636,30,0.286427146,0.977045908,0.976047904,3647
bb5c247f9ba595ec0e9dc88284da568011520aff,1,Jungtaek Lim,2017-07-14 12:11:41+09:00,['44b268badb7ee1a92b1cc8abf81dbb640fa9af19'],138,274,412,4632048,9,0.456521739,0.652173913,0.847826087,3648
7f84691516dbbea28a780acb05bc5bae449f67cd,1,Jungtaek Lim,2017-07-14 14:24:20+09:00,['bb5c247f9ba595ec0e9dc88284da568011520aff'],15,6,21,4632069,2,1,1,1,3648
7148d119234bb733f5a568830bf8cb8fc8d99640,0,Stig Rohde D酶ssing,2017-07-14 20:55:11+02:00,['559053dec9cd3e6b46cb71323a64c9e0c2e86838'],0,1,1,4632070,1,,,,3648
9a7cb048556db04eab4d75629c0bded04e62d8e8,0,Xin Wang,2017-07-15 11:37:15+08:00,['d7c781891fd0cf409335ed1b70397e3c6747475e'],78,77,155,4632225,2,,,,3648
38c91267278ecf40e14c5f2da9ddc53624c08c69,0,Xin Wang,2017-07-15 11:43:22+08:00,['d7c781891fd0cf409335ed1b70397e3c6747475e'],71,70,141,4632366,2,,,,3648
c2d2bd2fc997bc80b03c61ab8ced7cac8110990f,0,Xin Wang,2017-07-15 11:52:10+08:00,['d7c781891fd0cf409335ed1b70397e3c6747475e'],113,113,226,4632592,2,,,,3648
2dbe80a508c9b17ecf60fdc9256412841f4c0819,0,Xin Wang,2017-07-15 11:59:55+08:00,['d7c781891fd0cf409335ed1b70397e3c6747475e'],146,149,295,4632887,2,0.666666667,1,0.333333333,3648
2a36ec7bbe88d61685886b9de291b7fcc027b899,1,Xin Wang,2017-07-15 16:10:39+08:00,['d7c781891fd0cf409335ed1b70397e3c6747475e'],535,677,1212,4634099,37,1,1,0,3648
c22f9972b7840006f177c377aeec69910cbcc321,0,Xin Wang,2017-07-16 19:02:54+08:00,"['7148d119234bb733f5a568830bf8cb8fc8d99640', '9a7cb048556db04eab4d75629c0bded04e62d8e8']",78,77,155,4634254,2,,,,3648
15cedbe7f899aaa49fbf3f4294c252ff74e1f519,0,Xin Wang,2017-07-16 19:10:18+08:00,"['c22f9972b7840006f177c377aeec69910cbcc321', '38c91267278ecf40e14c5f2da9ddc53624c08c69']",71,70,141,4634395,2,,,,3648
73c33bf9a14c1975f19ebbc851e93dba7fbfa4d1,0,Xin Wang,2017-07-16 19:11:08+08:00,"['15cedbe7f899aaa49fbf3f4294c252ff74e1f519', 'c2d2bd2fc997bc80b03c61ab8ced7cac8110990f']",113,113,226,4634621,2,,,,3648
2fc414d00317d5d50ba5e648ccfdb4a4b36495f9,0,Xin Wang,2017-07-16 19:12:24+08:00,"['73c33bf9a14c1975f19ebbc851e93dba7fbfa4d1', '2dbe80a508c9b17ecf60fdc9256412841f4c0819']",146,149,295,4634916,2,,,,3648
72e219c1551aa999a51e6f6ce91f3dbaa279494c,0,Xin Wang,2017-07-16 19:13:05+08:00,"['2fc414d00317d5d50ba5e648ccfdb4a4b36495f9', '2a36ec7bbe88d61685886b9de291b7fcc027b899']",535,677,1212,4636128,37,,,,3648
9a4ea813456a6a22fd157cfdddde4cc4996e38da,0,Xin Wang,2017-07-16 19:28:21+08:00,['72e219c1551aa999a51e6f6ce91f3dbaa279494c'],0,5,5,4636133,1,,,,3648
6a041a98fc7fe04db3f520fa283192d96ffb0a56,1,Jungtaek Lim,2017-07-17 13:35:51+09:00,['7f84691516dbbea28a780acb05bc5bae449f67cd'],456,873,1329,4637462,32,0,0,0,3648
d250ae0b1b71af24f57950828111b39b4679e14e,1,Prasanna Ranganathan,2017-07-17 17:43:45+05:18,['7f33447477dfbf581e9b46feb27c362cc170dc56'],1,130,131,4637593,2,0.347826087,1,1,3649
8a5077a23b821c8601981ae2f7eb73ed54f59f81,1,Prasanna Ranganathan,2017-07-17 17:58:56+05:18,['980c65573de0b83ad0a60f9bf8e9f9682425bcaf'],3,150,153,4637746,2,0.245901639,1,1,3650
e5d6d32b5a90066ddeeb3789be0cee198a787361,1,Ethan Li,2017-07-17 09:28:54-05:00,['9a4ea813456a6a22fd157cfdddde4cc4996e38da'],599,5166,5765,4643511,25,0.313046402,0.426361802,0.964694015,3653
e6465b5dc5c7e31e0b92a18de578a13d05a5abf2,0,Kyle Nusbaum,2017-07-17 14:40:15-05:00,['559053dec9cd3e6b46cb71323a64c9e0c2e86838'],8,33,41,4643552,7,0.363636364,0,0.454545455,3653
d4847797f6ad1d4bd18ab1b79ceccd36c906f1e7,0,Kyle Nusbaum,2017-07-17 14:59:45-05:00,['e6465b5dc5c7e31e0b92a18de578a13d05a5abf2'],0,2,2,4643554,1,1,1,0,3653
02f2b7705dd584e806730225856cafad8c70125d,0,Ethan Li,2017-07-17 17:41:17-05:00,['e5d6d32b5a90066ddeeb3789be0cee198a787361'],3,18,21,4643575,1,,,,3653
8ea90b9d39c068c177613f08523780c7e1866c85,0,Ethan Li,2017-07-17 20:12:05-05:00,['02f2b7705dd584e806730225856cafad8c70125d'],0,57,57,4643632,1,,,,3653
110c405157e44149046fb84e97faf135bb7bd277,0,Xin Wang,2017-07-18 15:53:41+08:00,['8ea90b9d39c068c177613f08523780c7e1866c85'],0,1,1,4643633,1,,,,3653
89ad42153b93e0eccebd25cd462157975ea53f2a,0,Stig Rohde D酶ssing,2017-07-18 10:46:05+02:00,"['110c405157e44149046fb84e97faf135bb7bd277', 'd250ae0b1b71af24f57950828111b39b4679e14e']",1,130,131,4643764,2,,,,3653
4fce9380c237a0b320313328cbae550c524949b3,0,Stig Rohde D酶ssing,2017-07-18 11:06:11+02:00,['89ad42153b93e0eccebd25cd462157975ea53f2a'],0,1,1,4643765,1,,,,3653
a0bb63efbf648b17dca101ebbd8180d3e2fdec60,0,Stig Rohde D酶ssing,2017-07-18 11:23:53+02:00,"['4fce9380c237a0b320313328cbae550c524949b3', '8a5077a23b821c8601981ae2f7eb73ed54f59f81']",3,150,153,4643918,2,,,,3653
899477782f22986f99fc6355165ae4437cd604de,0,Stig Rohde D酶ssing,2017-07-18 11:26:17+02:00,['a0bb63efbf648b17dca101ebbd8180d3e2fdec60'],0,1,1,4643919,1,,,,3653
01a56ec992e9343f25b5613219dbf8a5ca76e95f,1,Stig Rohde D酶ssing,2017-07-18 11:53:13+02:00,['899477782f22986f99fc6355165ae4437cd604de'],384,186,570,4644489,13,0.150943396,0,0.613207547,3653
a8946adde9edbf1546f0872657ea3a11c8c41c0b,0,Stig Rohde D酶ssing,2017-07-18 16:25:44+02:00,['899477782f22986f99fc6355165ae4437cd604de'],1,1,2,4644491,1,,,,3653
782c4bf7debb2475e41e6771ef6088ebb1a2d9a9,0,Stig Rohde D酶ssing,2017-07-18 18:37:34+02:00,"['a8946adde9edbf1546f0872657ea3a11c8c41c0b', '01a56ec992e9343f25b5613219dbf8a5ca76e95f']",384,186,570,4645061,13,,,,3653
399e35f10918f07b645682cffcb869ca8aa2278a,0,Stig Rohde D酶ssing,2017-07-18 18:41:52+02:00,['782c4bf7debb2475e41e6771ef6088ebb1a2d9a9'],0,1,1,4645062,1,,,,3653
8ac87838d584eebe5d8c6ef434c0e560c177d4a2,0,Ethan Li,2017-07-18 12:23:53-05:00,['899477782f22986f99fc6355165ae4437cd604de'],0,49,49,4645111,9,1,1,1,3653
c7b7b896bb0101a1b1b56677b647550b615d515a,1,Stig Rohde D酶ssing,2017-07-18 22:36:46+02:00,['399e35f10918f07b645682cffcb869ca8aa2278a'],96,329,425,4645536,8,1,1,1,3658
b9aefbe3bff2ca7d2bf6fd4ee217e046e3f5071f,0,Stig Rohde D酶ssing,2017-07-18 22:38:48+02:00,"['399e35f10918f07b645682cffcb869ca8aa2278a', 'c7b7b896bb0101a1b1b56677b647550b615d515a']",96,329,425,4645961,8,,,,3658
cd6ca3ef040bb812670be13d3b08420e81f05797,0,Stig Rohde D酶ssing,2017-07-18 22:39:12+02:00,['b9aefbe3bff2ca7d2bf6fd4ee217e046e3f5071f'],0,1,1,4645962,1,,,,3658
fdb649e352e05fd849cafa312bbd62fc75694579,1,Stig Rohde D酶ssing,2017-07-19 00:18:03+02:00,['cd6ca3ef040bb812670be13d3b08420e81f05797'],339,307,646,4646608,21,0,0,0,3659
6a647cb6f48a91d9df7015491b556f117ab3ee38,0,Jungtaek Lim,2017-07-19 14:17:53+09:00,['cd6ca3ef040bb812670be13d3b08420e81f05797'],1,1,2,4646610,1,,,,3659
32b46ff887f0c92c0712f81b600ac1df73ae8eef,0,Stig Rohde D酶ssing,2017-07-19 15:06:52+02:00,['6a647cb6f48a91d9df7015491b556f117ab3ee38'],1,4,5,4646615,2,0,0,0,3659
9f621e5faeb7ed6129e6032c28a91bead7a11169,0,Kyle Nusbaum,2017-07-19 11:16:12-05:00,['d4847797f6ad1d4bd18ab1b79ceccd36c906f1e7'],14,17,31,4646646,4,0,0,1,3659
a9611ef74a905cfe0f60cade12c55fb3fe6269d8,0,Kyle Nusbaum,2017-07-19 12:04:09-05:00,['9f621e5faeb7ed6129e6032c28a91bead7a11169'],16,25,41,4646687,5,1,1,0,3659
c298b9ead9449dc7dfa13af1c27cdd0f164f90cd,0,Robert Evans,2017-07-19 13:11:22-05:00,"['6a647cb6f48a91d9df7015491b556f117ab3ee38', '8ac87838d584eebe5d8c6ef434c0e560c177d4a2']",0,49,49,4646736,9,,,,3659
10d381b303c9176ede0d1260428ad61c7757e396,0,Robert Evans,2017-07-19 13:11:48-05:00,['c298b9ead9449dc7dfa13af1c27cdd0f164f90cd'],0,1,1,4646737,1,,,,3659
f67699cce3d71c416ee4db3e8692c289cae0f4db,0,Stig Rohde D酶ssing,2017-07-19 20:15:20+02:00,"['10d381b303c9176ede0d1260428ad61c7757e396', 'fdb649e352e05fd849cafa312bbd62fc75694579']",339,307,646,4647383,21,,,,3659
3580dbc806307fc1bda805f04d910657a6fa61d5,0,Stig Rohde D酶ssing,2017-07-19 20:18:11+02:00,['f67699cce3d71c416ee4db3e8692c289cae0f4db'],0,1,1,4647384,1,,,,3659
8814bfaa14f1bcca050505f9e2b7168fe61b1a5b,0,Stig Rohde D酶ssing,2017-07-19 20:36:10+02:00,['3580dbc806307fc1bda805f04d910657a6fa61d5'],1,1,2,4647386,1,,,,3659
713cbbba843bbe051de0f734f86d44e274a26a08,0,GitHub,2017-07-19 23:49:55+03:00,['8814bfaa14f1bcca050505f9e2b7168fe61b1a5b'],1,1,2,4647388,1,,,,3659
c2d8e77495f1970d716a2e91e2afa20abd438a8c,0,Ethan Li,2017-07-19 19:07:01-05:00,['8814bfaa14f1bcca050505f9e2b7168fe61b1a5b'],1,13,14,4647402,1,,,,3659
67d41fc89ea7c056b1c1233ecd235d789d6df482,0,鍒樺厗鍧?0206665,2017-07-20 09:14:11+08:00,['8ba90e9fa5aeb0169480dd8622fed93e1fd1a657'],1,1,2,4647404,1,,,,3659
f9ed5d432ce433de7d2f7b475bf77e02ef563341,0,Jungtaek Lim,2017-07-20 12:16:59+09:00,['6a041a98fc7fe04db3f520fa283192d96ffb0a56'],11,1,12,4647416,2,0,0,0,3659
37f9c59949a1d8873668934b317e5c1ba20d3599,0,Jungtaek Lim,2017-07-20 19:51:17+09:00,['f9ed5d432ce433de7d2f7b475bf77e02ef563341'],2,2,4,4647420,1,,,,3659
5d93a864459b2407fda95de4995ac316ddd49fe7,0,Xin Wang,2017-07-20 22:09:25+08:00,"['8814bfaa14f1bcca050505f9e2b7168fe61b1a5b', 'a9611ef74a905cfe0f60cade12c55fb3fe6269d8']",13,52,65,4647485,7,,,,3659
ce19f81d5bd107849380d5a8b0b5b57b74772122,0,Xin Wang,2017-07-20 22:12:09+08:00,['5d93a864459b2407fda95de4995ac316ddd49fe7'],0,1,1,4647486,1,,,,3659
c4760f2476cfcf1c9a681585094b00aa838fac9f,0,GitHub,2017-07-20 15:48:18+01:00,['ce19f81d5bd107849380d5a8b0b5b57b74772122'],0,3,3,4647489,1,,,,3659
b5a1a177c1cf0f1c2e488f9ff07ce83fcdc68dcb,1,Ethan Li,2017-07-20 15:27:19+00:00,['8814bfaa14f1bcca050505f9e2b7168fe61b1a5b'],2,23,25,4647514,2,,,,3659
752b90c51b5b3081ab990a0e4476ee8e2175455c,0,Stig Rohde D酶ssing,2017-07-20 17:43:56+02:00,['ce19f81d5bd107849380d5a8b0b5b57b74772122'],1,12,13,4647527,3,0,1,1,3659
de0d270b977d6d5560ee1e9e2a602c9cf93762e4,1,Stig Rohde D酶ssing,2017-07-20 19:27:45+02:00,['ce19f81d5bd107849380d5a8b0b5b57b74772122'],5,6,11,4647538,2,,,,3659
4528a61872d3a9709d1d9f6c66a9f15fc0810f2e,0,Robert (Bobby) Evans,2017-07-20 13:33:18-05:00,['ce19f81d5bd107849380d5a8b0b5b57b74772122'],2,12,14,4647552,1,0,0.857142857,1,3659
32d0b473e9eb048fca5822de7970324431e1bf11,0,Stig Rohde D酶ssing,2017-07-20 23:22:13+02:00,"['ce19f81d5bd107849380d5a8b0b5b57b74772122', 'de0d270b977d6d5560ee1e9e2a602c9cf93762e4']",5,6,11,4647563,2,,,,3659
38fb8cce096fd0b37f7999eeb7bfbfa21c17c61d,0,Stig Rohde D酶ssing,2017-07-20 23:22:49+02:00,['32d0b473e9eb048fca5822de7970324431e1bf11'],0,1,1,4647564,1,,,,3659
20b01c012dc65309054db81f700bdea32a312148,0,Stig Rohde D酶ssing,2017-07-20 23:28:18+02:00,"['38fb8cce096fd0b37f7999eeb7bfbfa21c17c61d', '32b46ff887f0c92c0712f81b600ac1df73ae8eef']",1,4,5,4647569,2,,,,3659
e38f936077ea9b3ba5cd568b69335e0aac8369dd,0,Stig Rohde D酶ssing,2017-07-20 23:29:17+02:00,['20b01c012dc65309054db81f700bdea32a312148'],0,1,1,4647570,1,,,,3659
1deab8d2ee48733e22e690b8e07d9c3a06f0a39f,0,鍒樺厗鍧?0206665,2017-07-21 11:32:05+08:00,['8ba90e9fa5aeb0169480dd8622fed93e1fd1a657'],0,28,28,4647598,1,,,,3660
12b06df7236952b7af3f0e7c9155e95043117fcc,0,Xin Wang,2017-07-21 18:43:20+08:00,"['e38f936077ea9b3ba5cd568b69335e0aac8369dd', 'c2d8e77495f1970d716a2e91e2afa20abd438a8c']",1,13,14,4647612,1,,,,3660
47a4416733b6fdb0eb5689d71cb11fbeaa73c82f,0,Xin Wang,2017-07-21 18:45:29+08:00,"['12b06df7236952b7af3f0e7c9155e95043117fcc', 'b5a1a177c1cf0f1c2e488f9ff07ce83fcdc68dcb']",2,23,25,4647637,2,,,,3660
36e2e99e32effcb4b4df9fdbb841eb400e242fcb,0,Xin Wang,2017-07-21 18:48:12+08:00,['47a4416733b6fdb0eb5689d71cb11fbeaa73c82f'],0,2,2,4647639,1,,,,3660
72eae02fa5079d8a9f0b1e927bc9ca3c919b7858,0,Robert Evans,2017-07-21 10:23:41-05:00,"['36e2e99e32effcb4b4df9fdbb841eb400e242fcb', '67d41fc89ea7c056b1c1233ecd235d789d6df482']",1,1,2,4647641,1,,,,3660
3512ae97fdb6b846afe67f4bd097b488c658e51d,0,Robert Evans,2017-07-21 10:25:23-05:00,['72eae02fa5079d8a9f0b1e927bc9ca3c919b7858'],0,1,1,4647642,1,,,,3660
4ac1154e93bf5c99251b1aeffae679459af47325,0,Robert Evans,2017-07-21 10:40:39-05:00,"['3512ae97fdb6b846afe67f4bd097b488c658e51d', '4528a61872d3a9709d1d9f6c66a9f15fc0810f2e']",2,12,14,4647656,1,,,,3660
2aba1c42a2d5c7fb89eec209ed619c6c7040a724,0,Robert Evans,2017-07-21 12:13:10-05:00,['4ac1154e93bf5c99251b1aeffae679459af47325'],0,1,1,4647657,1,,,,3660
dbf7b998c04efb622f4d6ddc1ad4ae9d382e07a5,1,Robert Evans,2017-07-21 12:31:23-05:00,['2aba1c42a2d5c7fb89eec209ed619c6c7040a724'],379,819,1198,4648855,44,0.075376884,0.050251256,0.442211055,3660
1ff72288c8eccc5a74c58d8426824a4f4bccba43,0,Stig Rohde D酶ssing,2017-07-21 21:22:15+02:00,"['dbf7b998c04efb622f4d6ddc1ad4ae9d382e07a5', '752b90c51b5b3081ab990a0e4476ee8e2175455c']",1,12,13,4648868,3,,,,3660
64168037fbf383a350c5be7e220ae137d4317411,0,Stig Rohde D酶ssing,2017-07-21 21:36:22+02:00,['1ff72288c8eccc5a74c58d8426824a4f4bccba43'],0,1,1,4648869,1,,,,3660
a9ab18dac1b68e8f5e09d9aecc7ada5dd70626a9,0,Robert Evans,2017-07-21 15:34:30-05:00,"['64168037fbf383a350c5be7e220ae137d4317411', '713cbbba843bbe051de0f734f86d44e274a26a08']",1,1,2,4648871,1,,,,3660
e86ac7541f9c83a4a1f3aa2318db6959938049fe,0,Robert Evans,2017-07-21 15:37:25-05:00,['a9ab18dac1b68e8f5e09d9aecc7ada5dd70626a9'],0,1,1,4648872,1,,,,3660
fc84597ab2ce22a63eb6b8c43f709d2e163d531d,0,GitHub,2017-07-21 15:47:54-05:00,['1811273f18e79430167af709c23dbb9c9e2f7f7d'],20,29,49,4648921,1,,,,3660
d16c82126cecbbe95ff2f8bd377ba8842828fc9c,0,Mads Tandrup,2017-07-22 07:54:20+02:00,['36e2e99e32effcb4b4df9fdbb841eb400e242fcb'],0,334,334,4649255,6,0.442307692,0.605769231,0.5,3664
d6e5e6d4e0a20c4c9f0ce0e3000e730dcb4700da,1,Omer Hadari,2017-07-22 13:34:25+03:00,['e38f936077ea9b3ba5cd568b69335e0aac8369dd'],104,269,373,4649628,3,0.857142857,1,1,3664
7cf48f6535fb5b473865c208255b7d9004c09ff4,0,Stig Rohde D酶ssing,2017-07-22 22:55:37+02:00,"['e86ac7541f9c83a4a1f3aa2318db6959938049fe', 'd6e5e6d4e0a20c4c9f0ce0e3000e730dcb4700da']",104,269,373,4650001,3,,,,3664
caf39096be1c32fd1643fbb881eeed01a0208f10,0,Stig Rohde D酶ssing,2017-07-22 22:56:38+02:00,['7cf48f6535fb5b473865c208255b7d9004c09ff4'],0,1,1,4650002,1,,,,3664
1622f19c072001656e8870b9bd825c63ceddcd57,0,Stig Rohde D酶ssing,2017-07-23 21:37:15+02:00,['caf39096be1c32fd1643fbb881eeed01a0208f10'],1,1,2,4650004,1,,,,3664
35ca265af963dc21b356e1a305fea897c58a59fa,0,Jungtaek Lim,2017-07-24 11:44:28+09:00,['37f9c59949a1d8873668934b317e5c1ba20d3599'],13,18,31,4650035,6,0.666666667,1,0,3664
1a6ab72cb61493a3fac5be5efe3fb2eec4b0f9eb,0,Ethan Li,2017-07-23 22:32:19-05:00,['1622f19c072001656e8870b9bd825c63ceddcd57'],7,16,23,4650058,1,0.375,0,1,3664
8b4a1ce3a13bc1c51297cc80625c51e55c7790a0,0,Jungtaek Lim,2017-07-24 13:38:07+09:00,['35ca265af963dc21b356e1a305fea897c58a59fa'],4,4,8,4650066,4,,,,3664
ad5ea39facc10dc2b9d07c4d12c0be0208dca00e,0,Robert Evans,2017-07-24 10:47:41-05:00,"['1622f19c072001656e8870b9bd825c63ceddcd57', '8b4a1ce3a13bc1c51297cc80625c51e55c7790a0']",2161,5050,7211,4657277,51,,,,3664
3c53dd516810824593855060a69c5e82d08323e7,0,Robert Evans,2017-07-24 10:48:02-05:00,['ad5ea39facc10dc2b9d07c4d12c0be0208dca00e'],0,1,1,4657278,1,,,,3664
3efaeb2c1fd262fa974c27689e3d05f01e564735,0,Robert Evans,2017-07-24 12:37:56-05:00,"['3c53dd516810824593855060a69c5e82d08323e7', '1deab8d2ee48733e22e690b8e07d9c3a06f0a39f']",0,28,28,4657306,1,,,,3664
450ed637f92c3f387681a47b4b667f17eeecac1f,0,Robert Evans,2017-07-24 12:38:25-05:00,['3efaeb2c1fd262fa974c27689e3d05f01e564735'],0,1,1,4657307,1,,,,3664
db47bf51ad52cfbdb59d503d7fee28e1a38deb1e,1,Ethan Li,2017-07-24 19:21:48+00:00,['450ed637f92c3f387681a47b4b667f17eeecac1f'],0,2,2,4657309,2,,,,3664
7cf019b874ca937e134ae7a77de0f361965783dc,0,Ethan Li,2017-07-24 15:16:22-05:00,['450ed637f92c3f387681a47b4b667f17eeecac1f'],8,18,26,4657335,5,0.8,1,1,3664
b4d33955b15c74ecf2c779d321e941a6345924bc,1,Robert (Bobby) Evans,2017-07-25 15:26:47-05:00,['450ed637f92c3f387681a47b4b667f17eeecac1f'],8102,11460,19562,4676897,132,0.350885827,0.405019685,0.769192913,3680
08e0239d865acdc70793ec6f6175df009ad820b6,0,Robert (Bobby) Evans,2017-07-25 15:33:03-05:00,['450ed637f92c3f387681a47b4b667f17eeecac1f'],4,195,199,4677096,1,,,,3680
900bb96fcef9a96d3e79deedbb8aff2a2a57384b,0,Robert (Bobby) Evans,2017-07-25 16:23:22-05:00,['08e0239d865acdc70793ec6f6175df009ad820b6'],44,46,90,4677186,1,,,,3680
c08cfba0b65513b7b11d5ddbd399f7f15438f9cf,0,Stig Rohde D酶ssing,2017-07-27 00:35:36+02:00,['450ed637f92c3f387681a47b4b667f17eeecac1f'],0,2,2,4677188,1,,,,3680
3292ca46cc9bf2923410d099491a64ae2b2c4681,0,Stig Rohde D酶ssing,2017-07-29 18:08:30+02:00,['c08cfba0b65513b7b11d5ddbd399f7f15438f9cf'],8,6,14,4677202,1,,,,3680
dde00b7d04e441f94f910a41461d690009b20df3,0,Jungtaek Lim,2017-07-31 07:02:45+09:00,"['3292ca46cc9bf2923410d099491a64ae2b2c4681', '900bb96fcef9a96d3e79deedbb8aff2a2a57384b']",4,197,201,4677403,1,,,,3680
4dfd4ae42d9c7c32ff1732b4b3741f163ba4b9a7,0,Jungtaek Lim,2017-07-31 07:10:53+09:00,['dde00b7d04e441f94f910a41461d690009b20df3'],0,3,3,4677406,1,,,,3680
3ab7ffbc31b54b0d747bda4c9b5051912357445e,0,Jungtaek Lim,2017-07-31 11:05:32+09:00,"['4dfd4ae42d9c7c32ff1732b4b3741f163ba4b9a7', 'b4d33955b15c74ecf2c779d321e941a6345924bc']",8102,11460,19562,4696968,132,,,,3680
4c8a986f519cdf3e63bed47e9c4f723e4867267a,0,Jungtaek Lim,2017-07-31 11:06:46+09:00,['3ab7ffbc31b54b0d747bda4c9b5051912357445e'],0,1,1,4696969,1,,,,3680
29764bd2bbb26d8c7d59c89d03e384e0410b0435,0,Jungtaek Lim,2017-07-31 11:11:03+09:00,"['4c8a986f519cdf3e63bed47e9c4f723e4867267a', 'fc84597ab2ce22a63eb6b8c43f709d2e163d531d']",20,29,49,4697018,1,,,,3680
f36cfb0dd29a7bb6687232cfa4931e1c285c1cc0,0,Jungtaek Lim,2017-07-31 11:15:35+09:00,"['29764bd2bbb26d8c7d59c89d03e384e0410b0435', '1a6ab72cb61493a3fac5be5efe3fb2eec4b0f9eb']",7,16,23,4697041,1,,,,3680
393e5c4363468b2dba9e7421d2e6dde5afd9b094,0,Jungtaek Lim,2017-07-31 11:16:24+09:00,['f36cfb0dd29a7bb6687232cfa4931e1c285c1cc0'],0,1,1,4697042,1,,,,3680
172c04af43655f1eb9a9d09ebb19766e44eae4d8,0,Jungtaek Lim,2017-07-31 11:23:48+09:00,"['393e5c4363468b2dba9e7421d2e6dde5afd9b094', 'db47bf51ad52cfbdb59d503d7fee28e1a38deb1e']",0,2,2,4697044,2,,,,3680
05b75e40fb2c392a14879d6b41f18ae4221be2fd,0,Jungtaek Lim,2017-07-31 11:24:09+09:00,['172c04af43655f1eb9a9d09ebb19766e44eae4d8'],0,1,1,4697045,1,,,,3680
b8132c2da9d477c4332f313271da131212e25c90,0,Jungtaek Lim,2017-07-31 11:39:23+09:00,"['05b75e40fb2c392a14879d6b41f18ae4221be2fd', '7cf019b874ca937e134ae7a77de0f361965783dc']",8,18,26,4697071,5,,,,3680
a17b97a4d2aad690c0d37c57b8e3c6600d6ae7bb,0,Jungtaek Lim,2017-07-31 11:40:29+09:00,['b8132c2da9d477c4332f313271da131212e25c90'],0,1,1,4697072,1,,,,3680
f7dda2e9586e9cca330b5690dee85ef0d3d89844,0,Ethan Li,2017-07-31 15:01:06+00:00,['a17b97a4d2aad690c0d37c57b8e3c6600d6ae7bb'],84,495,579,4697651,14,0.185185185,0.212962963,0.972222222,3680
3f386c9174e98bc97f4786baa77539d9fbf17642,0,Jungtaek Lim,2017-08-01 16:32:37+09:00,['a17b97a4d2aad690c0d37c57b8e3c6600d6ae7bb'],0,8,8,4697659,1,,,,3680
9b84248d4c496340f60253bbcabae1b097d4dd23,1,Stig Rohde D酶ssing,2017-08-01 15:37:54+02:00,['3f386c9174e98bc97f4786baa77539d9fbf17642'],189,232,421,4698080,19,1,1,1,3683
59f0f1872c691446c6474ea92105880796b3d4e2,0,Jungtaek Lim,2017-08-02 07:09:46+09:00,['3f386c9174e98bc97f4786baa77539d9fbf17642'],1003,3,1006,4699086,2,,,,3683
b00dc70e2fb7fc88d9a5d58a60fb8e03ef0debd6,0,root,2017-08-02 10:03:03+08:00,['450ed637f92c3f387681a47b4b667f17eeecac1f'],1,39,40,4699126,1,,,,3683
8b5f57600bc4e7377d68a77b701fa4c5e0d0e9d2,0,Robert Evans,2017-08-02 08:44:27-05:00,"['3f386c9174e98bc97f4786baa77539d9fbf17642', 'b00dc70e2fb7fc88d9a5d58a60fb8e03ef0debd6']",1,39,40,4699166,1,,,,3683
6ae02e403e59507bf2a01f07ece503f9daafdb0e,0,Robert Evans,2017-08-02 08:44:52-05:00,['8b5f57600bc4e7377d68a77b701fa4c5e0d0e9d2'],0,1,1,4699167,1,,,,3683
fe961e6bf6c810b8cb4f18bd274e49ab889cce6a,0,Robert (Bobby) Evans,2017-08-02 10:37:13-05:00,['6ae02e403e59507bf2a01f07ece503f9daafdb0e'],1083,12,1095,4700262,15,0.610169492,0.397094431,0.525423729,3683
51df6accfb58d7be94eed4e47226e04d4bba0db1,0,Ethan Li,2017-08-02 13:52:41-05:00,['6ae02e403e59507bf2a01f07ece503f9daafdb0e'],1,11,12,4700274,1,0,1,0,3683
9b4c30dab0bc2828c4675d94a1e834a092ae8635,1,Robert (Bobby) Evans,2017-08-02 14:21:11-05:00,['6ae02e403e59507bf2a01f07ece503f9daafdb0e'],46,226,272,4700546,4,0,0,0.723880597,3683
aa17c880d37e123c9484678e972ad5379ce3448b,0,Jungtaek Lim,2017-08-03 07:36:43+09:00,"['6ae02e403e59507bf2a01f07ece503f9daafdb0e', 'f7dda2e9586e9cca330b5690dee85ef0d3d89844']",84,495,579,4701125,14,,,,3683
4966d7a69318d2ca690c47dd43466b03574e5e9e,0,Jungtaek Lim,2017-08-03 07:45:30+09:00,['aa17c880d37e123c9484678e972ad5379ce3448b'],0,1,1,4701126,1,,,,3683
7340590ceb9549eb3fe8bc443ba9576260d337cc,0,鍒樺厗鍧?0206665,2017-08-03 09:16:02+08:00,['4966d7a69318d2ca690c47dd43466b03574e5e9e'],1,1,2,4701128,1,,,,3683
921635ad1e3b04d5ee1555178e064797ade5d3d6,0,Rahul Jain,2017-08-03 12:01:34+05:18,['3c53dd516810824593855060a69c5e82d08323e7'],10,75,85,4701213,2,0.307692308,0.820512821,1,3683
f3cef0c1e1198d8c962a07c7247d403d3a49705c,0,Stig Rohde D酶ssing,2017-08-03 13:17:31+02:00,"['4966d7a69318d2ca690c47dd43466b03574e5e9e', '9b84248d4c496340f60253bbcabae1b097d4dd23']",189,232,421,4701634,19,,,,3683
3f84dcca0848ac1d0481f184d63cfaaa4f73da4e,0,Stig Rohde D酶ssing,2017-08-03 13:18:47+02:00,['f3cef0c1e1198d8c962a07c7247d403d3a49705c'],0,1,1,4701635,1,,,,3683
e6ef82bfa8cf26dfe3820961715a3ece900ca143,0,Stig Rohde D酶ssing,2017-08-03 18:37:28+02:00,['3f84dcca0848ac1d0481f184d63cfaaa4f73da4e'],2,120,122,4701757,4,1,1,0.470588235,3684
cfa2f15f7e94f4037b70f644cfb0268057308884,0,Stig Rohde D酶ssing,2017-08-03 18:47:06+02:00,"['3f84dcca0848ac1d0481f184d63cfaaa4f73da4e', 'e6ef82bfa8cf26dfe3820961715a3ece900ca143']",2,120,122,4701879,4,,,,3684
05ad40325aefca1eab552e8a9417c1034f35c34c,0,tigrant,2017-08-03 13:02:54-04:00,['4966d7a69318d2ca690c47dd43466b03574e5e9e'],15,13,28,4701907,2,1,1,0,3684
96ad079354eba2c68a4e9854e14c584043e49e36,0,Ethan Li,2017-08-03 13:24:10-05:00,['3f84dcca0848ac1d0481f184d63cfaaa4f73da4e'],0,60,60,4701967,7,0.823529412,0.941176471,0.941176471,3685
37205df2b795c0ad00eaa01c4a368763d90724e9,0,Robert Evans,2017-08-03 13:57:18-05:00,"['cfa2f15f7e94f4037b70f644cfb0268057308884', '59f0f1872c691446c6474ea92105880796b3d4e2']",1006,3,1009,4702976,2,,,,3685
fc03b85ed721746360a0043ee2c3fa2cf8fe2f99,0,Robert Evans,2017-08-03 14:00:02-05:00,"['37205df2b795c0ad00eaa01c4a368763d90724e9', '51df6accfb58d7be94eed4e47226e04d4bba0db1']",1,11,12,4702988,1,,,,3685
90ca7fa0c8e73a1884c70e2d3da3388b24d13db0,0,Robert Evans,2017-08-03 15:14:41-05:00,"['fc03b85ed721746360a0043ee2c3fa2cf8fe2f99', '96ad079354eba2c68a4e9854e14c584043e49e36']",0,60,60,4703048,7,,,,3685
bfa26e4e5cc1fc50117328d2e184d4c946a72708,0,Robert Evans,2017-08-03 15:42:16-05:00,"['90ca7fa0c8e73a1884c70e2d3da3388b24d13db0', 'fe961e6bf6c810b8cb4f18bd274e49ab889cce6a']",1083,12,1095,4704143,15,,,,3685
3f43fc4a94cc2f66890deee8fb425e73da7499a9,0,cluo,2017-08-04 10:34:56+08:00,['393e5c4363468b2dba9e7421d2e6dde5afd9b094'],0,2,2,4704145,1,,,,3685
77354fee0b517d680c4eca11ffec69b79d6b0c00,0,Jungtaek Lim,2017-08-04 14:58:03+09:00,['bfa26e4e5cc1fc50117328d2e184d4c946a72708'],4,0,4,4704149,1,,,,3685
48427880a483e1d86f9dbe99ef46e395e3a40308,1,Jungtaek Lim,2017-08-04 15:17:24+09:00,['77354fee0b517d680c4eca11ffec69b79d6b0c00'],54,485,539,4704688,3,0.239583333,0.652777778,0.756944444,3686
9f67be1036ce0955cf45b188022dd687619b3ed8,0,GitHub,2017-08-04 14:43:38+08:00,"['3f43fc4a94cc2f66890deee8fb425e73da7499a9', '77354fee0b517d680c4eca11ffec69b79d6b0c00']",2352,979,3331,4708019,70,,,,3686
cab86d08f6f49afaca5b49d6ed08079f700b3737,1,Jungtaek Lim,2017-08-04 16:20:55+09:00,['48427880a483e1d86f9dbe99ef46e395e3a40308'],56,144,200,4708219,1,0.253968254,0.253968254,0.253968254,3686
8f63d5a85609ca71019ab298859af0b9858262b8,1,Jungtaek Lim,2017-08-04 18:26:21+09:00,['cab86d08f6f49afaca5b49d6ed08079f700b3737'],28,52,80,4708299,2,0,0.157894737,0.684210526,3686
bba4df4514240d9fb88a25cbe4d4e6448f1f1a82,0,Robert Evans,2017-08-04 08:51:51-05:00,"['77354fee0b517d680c4eca11ffec69b79d6b0c00', '05ad40325aefca1eab552e8a9417c1034f35c34c']",15,13,28,4708327,2,,,,3686
1274b076e0f5efb4d4114ecf61d985b2000b2d46,0,Robert Evans,2017-08-04 10:12:59-05:00,"['bba4df4514240d9fb88a25cbe4d4e6448f1f1a82', '7340590ceb9549eb3fe8bc443ba9576260d337cc']",1,1,2,4708329,1,,,,3686
1c2ac2eb4cc09b349dea034fd4854547ffcde9a9,0,Jungtaek Lim,2017-08-05 12:15:37+09:00,"['1274b076e0f5efb4d4114ecf61d985b2000b2d46', '9f67be1036ce0955cf45b188022dd687619b3ed8']",0,2,2,4708331,1,,,,3686
a1fd83a987995430269cd25ef360f703e7eb8f99,1,Jungtaek Lim,2017-08-07 23:51:39+09:00,['8f63d5a85609ca71019ab298859af0b9858262b8'],30,81,111,4708442,8,0.833333333,0,0.958333333,3686
0d59f7cd326a3913a43aed45af5f73fd4f1994a4,1,Robert (Bobby) Evans,2017-08-07 16:44:39-05:00,['1c2ac2eb4cc09b349dea034fd4854547ffcde9a9'],3,19,22,4708464,2,0,0,1,3686
3599a2e3c53c5bd40c763f77ec033298d1f64995,0,cluo,2017-08-08 09:30:24+08:00,['1c2ac2eb4cc09b349dea034fd4854547ffcde9a9'],1,1,2,4708466,1,,,,3686
3ba3cabb01743f6a7181378b89957fff8d14e850,0,Arun Mahadevan,2017-08-08 07:43:46+05:18,['1c2ac2eb4cc09b349dea034fd4854547ffcde9a9'],197,2966,3163,4711629,50,0.506980162,0.879500367,0.847905952,3696
aaebc3b237916340156ac3b8dc956d6c62c34983,0,Arun Mahadevan,2017-08-08 07:45:57+05:18,"['1c2ac2eb4cc09b349dea034fd4854547ffcde9a9', '3ba3cabb01743f6a7181378b89957fff8d14e850']",197,2966,3163,4714792,50,,,,3696
73ff6cebbca65fce6047e301ae758d9e8d7063d4,0,Stig Rohde D酶ssing,2017-08-09 01:35:37+02:00,['aaebc3b237916340156ac3b8dc956d6c62c34983'],1,4,5,4714797,2,,,,3696
08038b6d65462788796348e40adbacfa6d2f9467,1,Jungtaek Lim,2017-08-09 13:23:50+09:00,['a1fd83a987995430269cd25ef360f703e7eb8f99'],53,77,130,4714927,2,0,0.923076923,0.692307692,3696
d364270b933cf59e9eaa845cc37af26a4ea7f63f,1,Jungtaek Lim,2017-08-09 13:37:40+09:00,['aaebc3b237916340156ac3b8dc956d6c62c34983'],77,82,159,4715086,10,0.2,0,0.6,3696
4c9a864f337281a655c46e7f227b1ae043f8cc56,0,Jungtaek Lim,2017-08-09 13:38:11+09:00,"['aaebc3b237916340156ac3b8dc956d6c62c34983', 'd364270b933cf59e9eaa845cc37af26a4ea7f63f']",77,82,159,4715245,10,,,,3696
b48a8a1a64404e98d4c408dd68caaa5f27e450f3,0,Jungtaek Lim,2017-08-09 13:43:57+09:00,"['4c9a864f337281a655c46e7f227b1ae043f8cc56', '921635ad1e3b04d5ee1555178e064797ade5d3d6']",10,75,85,4715330,2,,,,3696
2afb25830d49cb1dfa395a272ef23721c8b4f73f,0,Jungtaek Lim,2017-08-09 20:54:43+09:00,"['b48a8a1a64404e98d4c408dd68caaa5f27e450f3', '73ff6cebbca65fce6047e301ae758d9e8d7063d4']",1,4,5,4715335,2,,,,3696
5d601e8d583fcdcffa700f305ba90a3f6ffc75da,0,Jungtaek Lim,2017-08-09 21:03:01+09:00,"['2afb25830d49cb1dfa395a272ef23721c8b4f73f', '3599a2e3c53c5bd40c763f77ec033298d1f64995']",1,1,2,4715337,1,,,,3696
f9d75d8a38d77ec725b7f3b58d6666196bac62e0,0,Kyle Nusbaum,2017-08-09 16:53:35-05:00,['03578ca9961fd1ad1ffc5432839fc4ad04455d96'],6,111,117,4715454,5,0.93877551,0.93877551,0.87755102,3697
832395a1a88d31e6d40db9326fd86c012473c013,0,Kyle Nusbaum,2017-08-09 16:58:59-05:00,"['f9d75d8a38d77ec725b7f3b58d6666196bac62e0', '5d601e8d583fcdcffa700f305ba90a3f6ffc75da']",16120,30977,47097,4762551,477,,,,3697
f3a400117f70dfd437a39f025cfd1d7fe39eb96a,0,Kyle Nusbaum,2017-08-09 17:06:33-05:00,['832395a1a88d31e6d40db9326fd86c012473c013'],35,40,75,4762626,2,,,,3697
8e04115e962b78d9f7a2a3c343eeb532cc79452b,0,Jungtaek Lim,2017-08-10 07:48:57+09:00,"['5d601e8d583fcdcffa700f305ba90a3f6ffc75da', 'f3a400117f70dfd437a39f025cfd1d7fe39eb96a']",2,109,111,4762737,6,,,,3697
f18ac4289cc5a6488c725d3c295111b90bc07734,0,Jungtaek Lim,2017-08-11 06:16:54+09:00,['8e04115e962b78d9f7a2a3c343eeb532cc79452b'],1,61,62,4762799,3,,,,3698
f5a3942b4561e7ca6d52dcfac043fe23b5ddb511,0,Jungtaek Lim,2017-08-11 15:05:04+09:00,"['8e04115e962b78d9f7a2a3c343eeb532cc79452b', 'f18ac4289cc5a6488c725d3c295111b90bc07734']",1,61,62,4762861,3,,,,3698
730605827ed7f7d9f40c0716103541d059fed473,0,Rui Li,2017-08-12 21:52:43-04:00,['f5a3942b4561e7ca6d52dcfac043fe23b5ddb511'],3,3,6,4762867,1,,,,3698
f18330f3836dc481e13a21df2781eaf44856be30,1,Ethan Li,2017-08-15 10:45:50-05:00,['f5a3942b4561e7ca6d52dcfac043fe23b5ddb511'],3,1,4,4762871,1,1,1,0,3698
8f7d25c159d450b0549cb1cbbfcca71b2889e758,0,Vitaliy Fuks,2017-08-16 15:20:25+00:00,['f5a3942b4561e7ca6d52dcfac043fe23b5ddb511'],1,1,2,4762873,1,,,,3698
8ed69fdeafc4cce8c1b11a42be0de6de309a1f8e,0,Ethan Li,2017-08-18 09:04:56-05:00,['f5a3942b4561e7ca6d52dcfac043fe23b5ddb511'],3,3,6,4762879,1,,,,3698
aede02eb34c5c8078a3d3bdbab38b4dac65f2411,0,Ethan Li,2017-08-18 09:21:45-05:00,['f5a3942b4561e7ca6d52dcfac043fe23b5ddb511'],4,4,8,4762887,1,,,,3698
3cb416a31d54eb29d6acb74c506ae7fb47a87965,0,Jungtaek Lim,2017-08-19 10:57:07+09:00,"['f5a3942b4561e7ca6d52dcfac043fe23b5ddb511', '0d59f7cd326a3913a43aed45af5f73fd4f1994a4']",3,19,22,4762909,2,,,,3698
2f688228b2f238f6fb2dc7fc67bd7e9414b25d5b,0,Jungtaek Lim,2017-08-19 11:30:41+09:00,"['3cb416a31d54eb29d6acb74c506ae7fb47a87965', '730605827ed7f7d9f40c0716103541d059fed473']",3,3,6,4762915,1,,,,3698
9c20d1039f01386444ddb5e53f3fbf197e42433e,0,Jungtaek Lim,2017-08-19 11:32:14+09:00,"['2f688228b2f238f6fb2dc7fc67bd7e9414b25d5b', 'f18330f3836dc481e13a21df2781eaf44856be30']",3,1,4,4762919,1,,,,3698
1852b7c908eafc5a84772cfa0a95e0ffd66bd288,0,Jungtaek Lim,2017-08-19 12:07:14+09:00,"['9c20d1039f01386444ddb5e53f3fbf197e42433e', '8f7d25c159d450b0549cb1cbbfcca71b2889e758']",1,1,2,4762921,1,,,,3698
9a52ce9ba43fa2ab7ab3a8390accb5594234f0eb,0,Stig Rohde D酶ssing,2017-08-19 22:01:28+02:00,"['1852b7c908eafc5a84772cfa0a95e0ffd66bd288', '8ed69fdeafc4cce8c1b11a42be0de6de309a1f8e']",3,3,6,4762927,1,,,,3698
b04c2458c92cbb57ea57ba8ad7095ddfd6f2a7c6,0,Jungtaek Lim,2017-08-20 15:41:31+09:00,"['9a52ce9ba43fa2ab7ab3a8390accb5594234f0eb', 'aede02eb34c5c8078a3d3bdbab38b4dac65f2411']",4,4,8,4762935,1,,,,3698
cd347b2fbad69455e6a3cf971efee5d4f5a0d2c7,1,Stig Rohde D酶ssing,2017-08-20 09:33:37+02:00,['9a52ce9ba43fa2ab7ab3a8390accb5594234f0eb'],254,194,448,4763383,18,0.772727273,0,0.863636364,3700
0ffbe88e5a6d363b4696b6d176ba48a5dddb7500,0,Jungtaek Lim,2017-08-20 22:25:26+09:00,"['b04c2458c92cbb57ea57ba8ad7095ddfd6f2a7c6', 'cd347b2fbad69455e6a3cf971efee5d4f5a0d2c7']",254,194,448,4763831,18,,,,3700
b87dcc0f7c28e6bc5de77dfffb95e506f8eeba45,0,Jungtaek Lim,2017-08-21 07:41:12+09:00,"['0ffbe88e5a6d363b4696b6d176ba48a5dddb7500', 'd16c82126cecbbe95ff2f8bd377ba8842828fc9c']",0,334,334,4764165,6,,,,3700
20ec78c771670cab7072e496cf1756af59821a28,1,10213270,2017-08-21 16:15:03+08:00,['b87dcc0f7c28e6bc5de77dfffb95e506f8eeba45'],26,12,38,4764203,10,,,,3700
0d10b8afe7e282d04b67f1a0c1c90db801842b14,1,Robert (Bobby) Evans,2017-08-21 13:29:59-05:00,['b87dcc0f7c28e6bc5de77dfffb95e506f8eeba45'],69,286,355,4764558,8,,,,3702
6c2dcbedabb88970697f42b6f66bf64177e2ac9c,1,Robert (Bobby) Evans,2017-08-21 14:36:10-05:00,['0d10b8afe7e282d04b67f1a0c1c90db801842b14'],338,3724,4062,4768620,24,0.44481982,0.544481982,0.913288288,3722
2be883c1eb899568fb7e285da4b46dcbf1a1581b,0,Ethan Li,2017-08-22 08:22:29-05:00,['b87dcc0f7c28e6bc5de77dfffb95e506f8eeba45'],2,9,11,4768631,3,0.75,0.25,0,3722
ee109142d6b4faa18b68edc03a6f2171a7628694,0,Robert Evans,2017-08-22 12:05:25-05:00,"['b87dcc0f7c28e6bc5de77dfffb95e506f8eeba45', '9b4c30dab0bc2828c4675d94a1e834a092ae8635']",46,226,272,4768903,4,,,,3722
3213ba40b9479337e8f9dc1c412f57e6bb57aace,1,Ethan Li,2017-08-22 13:15:30-05:00,['ee109142d6b4faa18b68edc03a6f2171a7628694'],0,16,16,4768919,1,0,0,1,3722
12e3f910e2ce986826ad7da763a2a0eef8c80f4e,0,Robert Evans,2017-08-22 13:27:32-05:00,"['ee109142d6b4faa18b68edc03a6f2171a7628694', '20ec78c771670cab7072e496cf1756af59821a28']",26,12,38,4768957,10,,,,3722
58baf802d1bf723beea61e66cde844990e1c2d51,0,Arun Mahadevan,2017-08-23 12:14:07+05:18,['12e3f910e2ce986826ad7da763a2a0eef8c80f4e'],0,239,239,4769196,4,0.6,1,1,3724
5308634f762434018938566db35b20a84f47d5f5,0,Arun Mahadevan,2017-08-23 12:14:07+05:18,['58baf802d1bf723beea61e66cde844990e1c2d51'],21,19,40,4769236,4,,,,3724
ab38a7a0c87a857f9a9021d9805d8d63c794ef74,1,Jungtaek Lim,2017-08-23 23:42:23+09:00,['08038b6d65462788796348e40adbacfa6d2f9467'],2,2,4,4769240,1,,,,3724
211f8a944c096b04083c211306687daeb16c7adc,1,Robert (Bobby) Evans,2017-08-23 14:30:38-05:00,['6c2dcbedabb88970697f42b6f66bf64177e2ac9c'],65,182,247,4769487,4,0.073529412,0.632352941,0,3724
986e4e160695660a91810587f32f78db6032c79c,0,Robert Evans,2017-08-23 14:52:46-05:00,"['5308634f762434018938566db35b20a84f47d5f5', '3213ba40b9479337e8f9dc1c412f57e6bb57aace']",0,16,16,4769503,1,,,,3724
ec05019da42d492724ab3e2c3be3e1b1c6bbf299,0,Robert Evans,2017-08-23 15:19:52-05:00,"['986e4e160695660a91810587f32f78db6032c79c', '2be883c1eb899568fb7e285da4b46dcbf1a1581b']",2,9,11,4769514,3,,,,3724
0bf7e703fa61c0c0e44f56fa3387f88a528f6ea7,0,Robert Evans,2017-08-23 16:29:45-05:00,"['ec05019da42d492724ab3e2c3be3e1b1c6bbf299', 'c4760f2476cfcf1c9a681585094b00aa838fac9f']",0,3,3,4769517,1,,,,3724
4dade36c6200a1fea06aa207f3f6d8470b725d0f,1,Jungtaek Lim,2017-08-24 09:15:27+09:00,['ab38a7a0c87a857f9a9021d9805d8d63c794ef74'],34,15,49,4769566,6,1,0.090909091,1,3724
954d158bff04c8bdc638429fc1ca2a78a773d696,0,sakanaou,2017-08-24 09:58:42+02:00,['0bf7e703fa61c0c0e44f56fa3387f88a528f6ea7'],6,0,6,4769572,1,1,1,0,3724
2b15fc4fc7189f2f42a0fea13f2ca00a6675d6c7,0,Jungtaek Lim,2017-08-24 20:23:43+09:00,['0bf7e703fa61c0c0e44f56fa3387f88a528f6ea7'],1,1,2,4769574,1,,,,3724
b4cd98fa9f2f263aee3eaf7df53b385e62a34386,0,Robert (Bobby) Evans,2017-08-24 09:09:34-05:00,['211f8a944c096b04083c211306687daeb16c7adc'],29,131,160,4769734,4,0.441860465,0.453488372,0.744186047,3724
5238df2ebfea91926b9a85e57aad2b73ce01e43c,0,Robert (Bobby) Evans,2017-08-24 09:22:47-05:00,['b4cd98fa9f2f263aee3eaf7df53b385e62a34386'],3,5,8,4769742,1,,,,3724
6bc3213806c67818c8e7c0c8d72c0b8a234468b7,1,Robert (Bobby) Evans,2017-08-24 10:07:21-05:00,['5238df2ebfea91926b9a85e57aad2b73ce01e43c'],119,173,292,4770034,6,0.210084034,0.378151261,0.731092437,3724
6fef40b4fbdad74b61fd54ad48085699a74c569c,1,Bijan Fahimi,2017-08-24 17:37:57+02:00,['0bf7e703fa61c0c0e44f56fa3387f88a528f6ea7'],3,174,177,4770211,4,0.25,0.964285714,0.928571429,3726
0e3fc5a097d156bad4cf17c74c147255575aa646,1,Robert (Bobby) Evans,2017-08-24 11:13:08-05:00,['6bc3213806c67818c8e7c0c8d72c0b8a234468b7'],21,116,137,4770348,2,0.8,0.814285714,0.614285714,3726
d3ece270fbcace79195a4217731c3f82bcf2b360,1,Angus Helm,2017-08-24 15:34:19-05:00,['c38d7950a347e906a8ebe7b2889c65c6e8e8c936'],20,55,75,4770423,3,,,,3727
a4c372c95e5ad97beedc534e55d35cc09a962520,0,Robert (Bobby) Evans,2017-08-24 17:13:50-05:00,['0e3fc5a097d156bad4cf17c74c147255575aa646'],11,34,45,4770468,4,0,0.368421053,0,3727
0ef492e7e7189fe13bef067b3892bbd1be7457a0,0,Robert (Bobby) Evans,2017-08-24 17:36:22-05:00,['a4c372c95e5ad97beedc534e55d35cc09a962520'],0,9,9,4770477,1,0,0,0,3727
d16ed4cb5dd1a75aae85507c5229317914faa787,0,Jungtaek Lim,2017-08-25 14:36:13+09:00,"['0bf7e703fa61c0c0e44f56fa3387f88a528f6ea7', '954d158bff04c8bdc638429fc1ca2a78a773d696']",6,0,6,4770483,1,,,,3727
5bc04478dd4ac3613980abe3d5f5aa8f104efe55,1,Jungtaek Lim,2017-08-25 14:59:23+09:00,['d16ed4cb5dd1a75aae85507c5229317914faa787'],31,92,123,4770606,4,1,1,1,3727
d8384f43b444381dc674a2db1a30a2bfe0563602,0,Jungtaek Lim,2017-08-25 14:59:56+09:00,"['d16ed4cb5dd1a75aae85507c5229317914faa787', '5bc04478dd4ac3613980abe3d5f5aa8f104efe55']",31,92,123,4770729,4,,,,3727
381387b2c89f11cc6206219634af53df0769850e,0,Robert (Bobby) Evans,2017-08-25 12:10:41-05:00,['0ef492e7e7189fe13bef067b3892bbd1be7457a0'],19,15,34,4770763,4,1,1,0.2,3727
29a44e57a3481874b0a84cfd6ec00130c661f620,0,Jungtaek Lim,2017-08-26 21:01:30+09:00,"['d8384f43b444381dc674a2db1a30a2bfe0563602', '2b15fc4fc7189f2f42a0fea13f2ca00a6675d6c7']",1,1,2,4770765,1,,,,3727
58bd51ec88c8eff02d35904e106edd68ea45e6a4,0,morokosi,2017-08-28 23:29:02+09:00,['29a44e57a3481874b0a84cfd6ec00130c661f620'],3,3,6,4770771,1,,,,3727
6ea3d0d46c6e9b94a639fed9bf1c6fb5f765b37c,0,Robert Evans,2017-08-28 16:22:45-05:00,"['29a44e57a3481874b0a84cfd6ec00130c661f620', 'd3ece270fbcace79195a4217731c3f82bcf2b360']",20,55,75,4770846,3,,,,3727
d06bb3856f13389c1b2cadaad3f8580548001bba,0,Robert Evans,2017-08-28 17:06:56-05:00,['6ea3d0d46c6e9b94a639fed9bf1c6fb5f765b37c'],5,5,10,4770856,2,,,,3727
f1f954493408e5c62d4a0e061ae6180c8ad7972a,1,Ethan Li,2017-08-29 12:54:00-05:00,['d06bb3856f13389c1b2cadaad3f8580548001bba'],86,1275,1361,4772217,15,0.309664694,0.8382643,0.83234714,3737
08d9d5a875ede000097a6a857db80541f76c0c58,0,Stig Rohde D酶ssing,2017-08-29 21:29:38+02:00,"['d06bb3856f13389c1b2cadaad3f8580548001bba', '6fef40b4fbdad74b61fd54ad48085699a74c569c']",3,174,177,4772394,4,,,,3737
e1dd247ce97ad560c72554ed612e1ec8e69e9777,0,Jungtaek Lim,2017-08-30 10:41:07+09:00,"['08d9d5a875ede000097a6a857db80541f76c0c58', 'f1f954493408e5c62d4a0e061ae6180c8ad7972a']",86,1275,1361,4773755,15,,,,3737
54a829ceba6c1575d0665721509889e4b60dd066,1,Stig Rohde D酶ssing,2017-08-30 18:54:08+02:00,['e1dd247ce97ad560c72554ed612e1ec8e69e9777'],110,334,444,4774199,16,0.642857143,0.375,0.625,3739
d818b86b4042a4c6d39a1f29a3ecc0a6686b7253,0,Ethan Li,2017-08-30 13:02:56-05:00,['e1dd247ce97ad560c72554ed612e1ec8e69e9777'],5,0,5,4774204,1,,,,3739
9d62c13aad92daffa6af483306af35fc5609d89d,0,Jungtaek Lim,2017-08-31 12:11:57+09:00,['e1dd247ce97ad560c72554ed612e1ec8e69e9777'],10,58,68,4774272,3,0,0.939393939,1,3739
9833f5449e598b7f257a229e64ed2f479c4d07ac,0,Jungtaek Lim,2017-08-31 14:33:43+09:00,['e1dd247ce97ad560c72554ed612e1ec8e69e9777'],2,10,12,4774284,2,0,0,1,3739
862b969bf7715609587bfa1745a8a7745049ed64,0,Jungtaek Lim,2017-08-31 20:26:04+09:00,['9d62c13aad92daffa6af483306af35fc5609d89d'],2,2,4,4774288,1,,,,3739
fee498d003385fe48c2e38e8707ba35f8bece77a,0,Jungtaek Lim,2017-09-01 18:29:13+09:00,['9d62c13aad92daffa6af483306af35fc5609d89d'],8,11,19,4774307,5,,,,3739
758a1d2d602099e64177cad0ecadb2c000d408f3,0,Robert Evans,2017-09-01 08:56:05-05:00,"['9d62c13aad92daffa6af483306af35fc5609d89d', 'd818b86b4042a4c6d39a1f29a3ecc0a6686b7253']",5,0,5,4774312,1,,,,3739
2f5cde873a4fc3733b72cafb9761e844340c88ff,0,Robert (Bobby) Evans,2017-09-01 09:29:06-05:00,['381387b2c89f11cc6206219634af53df0769850e'],3,19,22,4774334,1,0.545454545,0,1,3739
96e68c02453eb1884785db1b32e387782f576a29,0,Robert (Bobby) Evans,2017-09-01 09:47:40-05:00,['2f5cde873a4fc3733b72cafb9761e844340c88ff'],3,16,19,4774353,2,0.375,0.75,0.75,3739
19508b94253a813aca4adca8ef373cef87a69e6d,0,Robert (Bobby) Evans,2017-09-01 10:28:22-05:00,['96e68c02453eb1884785db1b32e387782f576a29'],2,25,27,4774380,2,0.166666667,0.388888889,0.888888889,3739
113413cddefce23f920ec12733321284d31ce9d7,0,Robert (Bobby) Evans,2017-09-01 10:44:34-05:00,['19508b94253a813aca4adca8ef373cef87a69e6d'],7,28,35,4774415,2,0.555555556,0.555555556,0.388888889,3739
59213c16865023bad72036ecf4719fdc6ecb6c67,0,Robert (Bobby) Evans,2017-09-01 11:15:41-05:00,['113413cddefce23f920ec12733321284d31ce9d7'],11,36,47,4774462,2,0,1,0.357142857,3739
9565b003f206d7a10927f315158bf3633c4eef29,0,Ethan Li,2017-09-01 21:56:44+00:00,['758a1d2d602099e64177cad0ecadb2c000d408f3'],4,4,8,4774470,1,,,,3739
96a08665ca5cceda541514872e904079e59b486a,0,Jungtaek Lim,2017-09-04 08:08:37+09:00,['758a1d2d602099e64177cad0ecadb2c000d408f3'],17,26,43,4774513,5,1,1,1,3739
aefc725201a037745fba7c95e1ac34ffb266207f,0,Jungtaek Lim,2017-09-04 08:09:13+09:00,"['758a1d2d602099e64177cad0ecadb2c000d408f3', '96a08665ca5cceda541514872e904079e59b486a']",17,26,43,4774556,5,,,,3739
a9f92dba040d41974d144e1340a161b38752d382,0,Jungtaek Lim,2017-09-04 14:22:31+09:00,"['aefc725201a037745fba7c95e1ac34ffb266207f', '9565b003f206d7a10927f315158bf3633c4eef29']",4,4,8,4774564,1,,,,3739
9bf202277bf02cee8fbe8c627aa1834d00f556ef,1,Robert Evans,2017-09-06 08:21:36-05:00,['a9f92dba040d41974d144e1340a161b38752d382'],7,6,13,4774577,1,0,1,1,3739
e7e1177992ba3a151d3162b8c6de041bf6708005,0,Ethan Li,2017-09-07 12:15:50-05:00,['9bf202277bf02cee8fbe8c627aa1834d00f556ef'],10,12,22,4774599,1,1,1,1,3739
dad14e414619b1f336d18bc570ea165e072008ea,0,Robert Evans,2017-09-07 12:32:26-05:00,"['9bf202277bf02cee8fbe8c627aa1834d00f556ef', '4dade36c6200a1fea06aa207f3f6d8470b725d0f']",65,664,729,4775328,10,,,,3739
3ee9a899c3f4cfb4c5ad1dca5dd8a62740fa2ce8,0,Robert Evans,2017-09-07 13:12:00-05:00,"['dad14e414619b1f336d18bc570ea165e072008ea', '9833f5449e598b7f257a229e64ed2f479c4d07ac']",2,10,12,4775340,2,,,,3739
32389d75f5e2e4aab0c2699a2d5b842d20358340,0,Robert Evans,2017-09-07 13:43:40-05:00,"['3ee9a899c3f4cfb4c5ad1dca5dd8a62740fa2ce8', '59213c16865023bad72036ecf4719fdc6ecb6c67']",512,4611,5123,4780463,27,,,,3739
06f8bc7ab94fc9557397e57b7d73ee7501505b75,0,Robert Evans,2017-09-07 16:45:18-05:00,"['32389d75f5e2e4aab0c2699a2d5b842d20358340', '862b969bf7715609587bfa1745a8a7745049ed64']",2,2,4,4780467,1,,,,3739
6fbd3d4e8df0c68472308d81c4c824635355dfcd,0,Jungtaek Lim,2017-09-08 07:46:56+09:00,['a9f92dba040d41974d144e1340a161b38752d382'],1,7,8,4780475,2,1,1,1,3739
9d311b2a427431ed1d3e874a8295ef3756d7fcd6,0,Stig Rohde D酶ssing,2017-09-08 08:53:55+02:00,['06f8bc7ab94fc9557397e57b7d73ee7501505b75'],4,7,11,4780486,2,,,,3739
306f399e9a5a9348c25b64ae33f0a7b6a7d2ea9d,0,Robert Evans,2017-09-08 08:36:59-05:00,"['06f8bc7ab94fc9557397e57b7d73ee7501505b75', 'fee498d003385fe48c2e38e8707ba35f8bece77a']",8,11,19,4780505,5,,,,3739
ea0e465ab863668f0b04aba7d01050aeb4b13d22,0,Robert Evans,2017-09-08 08:56:38-05:00,"['306f399e9a5a9348c25b64ae33f0a7b6a7d2ea9d', '54a829ceba6c1575d0665721509889e4b60dd066']",110,334,444,4780949,16,,,,3739
e0494c343b3288b2df6319d6eafeb2f1b59caa6b,1,Jungtaek Lim,2017-09-09 08:05:09+09:00,['a9f92dba040d41974d144e1340a161b38752d382'],2,38,40,4780989,4,1,1,0.666666667,3739
cb25186f5624293f71114913e4a8424fc22f75c2,0,Jungtaek Lim,2017-09-09 08:06:07+09:00,"['ea0e465ab863668f0b04aba7d01050aeb4b13d22', 'e0494c343b3288b2df6319d6eafeb2f1b59caa6b']",2,38,40,4781029,4,,,,3739
de1d468592b402fb862f98ce357cbd1268d13f8c,0,Stig Rohde D酶ssing,2017-09-09 15:38:24+02:00,"['cb25186f5624293f71114913e4a8424fc22f75c2', '9d311b2a427431ed1d3e874a8295ef3756d7fcd6']",4,7,11,4781040,2,,,,3739
84a4314d96b9e4e377a3d5d81d0a042d96a0625e,1,Stig Rohde D酶ssing,2017-09-09 22:02:42+02:00,['de1d468592b402fb862f98ce357cbd1268d13f8c'],138,53,191,4781231,23,,,,3739
cb262769ae06c016bc071ef5915c1e83cd690a91,0,Stig Rohde D酶ssing,2017-09-10 13:09:34+02:00,['de1d468592b402fb862f98ce357cbd1268d13f8c'],1,1,2,4781233,1,,,,3739
bf0f3a2fb0806d44ba79867ad911a2df19d8c360,0,Robert Evans,2017-09-11 09:12:44-05:00,"['cb262769ae06c016bc071ef5915c1e83cd690a91', '84a4314d96b9e4e377a3d5d81d0a042d96a0625e']",138,53,191,4781424,23,,,,3739
ed6dca0246e053c443e6ecdbea1e08073ebbaff2,0,Robert Evans,2017-09-11 09:44:20-05:00,"['bf0f3a2fb0806d44ba79867ad911a2df19d8c360', 'e7e1177992ba3a151d3162b8c6de041bf6708005']",10,12,22,4781446,1,,,,3739
a42b10a91dad99ef740aa58b2be08a9d157d115b,0,Robert Evans,2017-09-11 10:03:39-05:00,"['ed6dca0246e053c443e6ecdbea1e08073ebbaff2', '6fbd3d4e8df0c68472308d81c4c824635355dfcd']",1,7,8,4781454,2,,,,3739
1275f80fc844e73ef4de9e028bf0fcf0f06bcded,1,Ethan Li,2017-09-11 10:14:41-05:00,['ea0e465ab863668f0b04aba7d01050aeb4b13d22'],9,62,71,4781525,2,1,1,1,3739
6d23b8b7e1ff3ef15f60449d7089af452009c220,0,Robert Evans,2017-09-11 10:25:43-05:00,"['a42b10a91dad99ef740aa58b2be08a9d157d115b', '1275f80fc844e73ef4de9e028bf0fcf0f06bcded']",9,62,71,4781596,2,,,,3739
b9f1d7efd96cf2fb1393f7a2e4277e3fb68b21bc,1,Robert (Bobby) Evans,2017-09-11 15:38:03-05:00,['6d23b8b7e1ff3ef15f60449d7089af452009c220'],267,512,779,4782375,22,1,0.535714286,1,3741
32be4e3674b3fdd4db427a53f24d9cac3b98412e,1,Ethan Li,2017-09-12 14:28:51-05:00,['32389d75f5e2e4aab0c2699a2d5b842d20358340'],9,50,59,4782434,2,0,1,1,3741
1dba0b4d8f324ae561bc7d407f079d32e2730939,1,Heather McCartney,2017-09-13 11:47:02+01:00,['6d23b8b7e1ff3ef15f60449d7089af452009c220'],10,282,292,4782726,4,0.97029703,0.97029703,0.891089109,3744
c365bcae0b3f951a2a4f749495226945354e98cc,0,Robert Evans,2017-09-13 08:08:04-05:00,"['6d23b8b7e1ff3ef15f60449d7089af452009c220', '1dba0b4d8f324ae561bc7d407f079d32e2730939']",10,282,292,4783018,4,,,,3744
79010512da01e156bb74478fce7062ac422e6475,0,Robert Evans,2017-09-13 10:30:31-05:00,"['c365bcae0b3f951a2a4f749495226945354e98cc', '32be4e3674b3fdd4db427a53f24d9cac3b98412e']",9,50,59,4783077,2,,,,3744
124acb92dff04a57b530ab4d95a698abc8ff46d9,0,Robert Evans,2017-09-14 10:15:16-05:00,"['79010512da01e156bb74478fce7062ac422e6475', 'b9f1d7efd96cf2fb1393f7a2e4277e3fb68b21bc']",267,512,779,4783856,22,,,,3744
4a29b57a1c58cc6fda54356ae5568843d1abbb3c,1,Ethan Li,2017-09-15 09:55:34-05:00,['124acb92dff04a57b530ab4d95a698abc8ff46d9'],1,38,39,4783895,4,0,0,1,3744
ac8d37b9fdb43197b143901bd6d3212601265bca,1,Robert (Bobby) Evans,2017-09-15 11:15:06-05:00,['124acb92dff04a57b530ab4d95a698abc8ff46d9'],152,446,598,4784493,11,0.858333333,1,0.275,3745
3c1364cfc5d8846cbac78dd6721b81a0725b916f,0,morokosi,2017-09-18 14:03:44+09:00,['124acb92dff04a57b530ab4d95a698abc8ff46d9'],1,1,2,4784495,1,,,,3745
05a74c73db9b9017d3672d3cc055e8f1ada1d69e,0,Robert Evans,2017-09-18 08:41:13-05:00,"['124acb92dff04a57b530ab4d95a698abc8ff46d9', '4a29b57a1c58cc6fda54356ae5568843d1abbb3c']",1,38,39,4784534,4,,,,3745
da2f035865c0176e2fdf047730b0c1f55d016c50,0,Robert Evans,2017-09-18 09:07:07-05:00,"['05a74c73db9b9017d3672d3cc055e8f1ada1d69e', 'ac8d37b9fdb43197b143901bd6d3212601265bca']",152,446,598,4785132,11,,,,3745
3c88b0ce87ac72492e3720d3d89ccbe91b3d89e0,0,Robert (Bobby) Evans,2017-09-18 14:50:07-05:00,['da2f035865c0176e2fdf047730b0c1f55d016c50'],31,41,72,4785204,1,0,1,1,3745
1e81a907fd3722601e3d1e765baf4a9360b95e99,1,Kyle Nusbaum,2017-09-18 15:06:07-05:00,['da2f035865c0176e2fdf047730b0c1f55d016c50'],67,73,140,4785344,1,0,0,0,3745
bb86dcc8cb57351b34077a506336f6b5c90f7bbc,0,Ethan Li,2017-09-19 08:40:32-05:00,['da2f035865c0176e2fdf047730b0c1f55d016c50'],60,118,178,4785522,3,0.959183673,0.959183673,0.959183673,3745
42a4dc2f62b652b6003229dc95b04dab7bf103c3,0,Robert Evans,2017-09-19 14:23:21-05:00,"['da2f035865c0176e2fdf047730b0c1f55d016c50', '3c88b0ce87ac72492e3720d3d89ccbe91b3d89e0']",31,41,72,4785594,1,,,,3745
95c9524ac4fb5e11efcc997c2ff22107f8d49978,0,Robert Evans,2017-09-19 14:40:50-05:00,"['42a4dc2f62b652b6003229dc95b04dab7bf103c3', '3c1364cfc5d8846cbac78dd6721b81a0725b916f']",1,1,2,4785596,1,,,,3745
f7443a8224b23e648117eb56e03b4b03f80398cb,0,Robert Evans,2017-09-19 14:43:00-05:00,"['95c9524ac4fb5e11efcc997c2ff22107f8d49978', '1e81a907fd3722601e3d1e765baf4a9360b95e99']",67,73,140,4785736,1,,,,3745
2da6b81978407bf4765a194e1fd6c0502fa7c4ed,0,Robert Evans,2017-09-19 15:20:20-05:00,"['f7443a8224b23e648117eb56e03b4b03f80398cb', 'bb86dcc8cb57351b34077a506336f6b5c90f7bbc']",60,118,178,4785914,3,,,,3745
91ac5c801a0f000a4ae2313437d4de79ea5bd2bc,0,Jerry Peng,2017-09-19 13:58:40-07:00,['32389d75f5e2e4aab0c2699a2d5b842d20358340'],2,30,32,4785946,1,1,1,1,3745
62dec63b58cef39c9f7504b6c73c46572f574e19,0,Jungtaek Lim,2017-09-20 07:52:28+09:00,"['2da6b81978407bf4765a194e1fd6c0502fa7c4ed', '58bd51ec88c8eff02d35904e106edd68ea45e6a4']",3,3,6,4785952,1,,,,3745
50d55a951bcf36afadf281f56099fe31d4387025,0,Stig Rohde D酶ssing,2017-09-20 07:59:33+02:00,"['62dec63b58cef39c9f7504b6c73c46572f574e19', '91ac5c801a0f000a4ae2313437d4de79ea5bd2bc']",2,30,32,4785984,1,,,,3745
54f0bf22fdcc7e68118ed5184aa8c1f65678e218,1,Robert (Bobby) Evans,2017-09-20 12:06:44-05:00,['50d55a951bcf36afadf281f56099fe31d4387025'],49,75,124,4786108,2,1,1,0.625,3745
b182dc6a76abf1a1208bf7df861bf5316468ed7c,1,Robert (Bobby) Evans,2017-09-20 16:06:09-05:00,['54f0bf22fdcc7e68118ed5184aa8c1f65678e218'],18,8,26,4786134,1,1,0,0,3745
b7ed06f82650dd762ec2f422b024268c561076a2,0,Kishor Patil,2017-09-21 11:09:05-04:00,['50d55a951bcf36afadf281f56099fe31d4387025'],1,0,1,4786135,1,0,0,0,3745
66ff5fd9400aa1195c2e00409b96f991e869a824,0,Robert Evans,2017-09-21 12:49:35-05:00,"['50d55a951bcf36afadf281f56099fe31d4387025', 'b182dc6a76abf1a1208bf7df861bf5316468ed7c']",49,65,114,4786249,2,,,,3745
bebc09cfb744f760bf14395513145165cd214e77,0,Ethan Li,2017-09-21 18:36:03+00:00,['50d55a951bcf36afadf281f56099fe31d4387025'],34,60,94,4786343,5,0.466666667,0.466666667,0.866666667,3745
78cb243c4bc9aaeaffd6f1c76915ac20016b32e7,1,Robert (Bobby) Evans,2017-09-21 15:59:24-05:00,['66ff5fd9400aa1195c2e00409b96f991e869a824'],1908,1627,3535,4789878,17,0,0.602941176,0,3745
c78eb0d522e97cc00136b46e1188ba08a5ca9d9c,0,xiaoyong03,2017-09-22 11:55:37+08:00,['559053dec9cd3e6b46cb71323a64c9e0c2e86838'],1,1,2,4789880,1,,,,3745
884eb61ddab0c3da7ef587793b8543ba0f906451,0,Ethan Li,2017-09-22 09:38:46-05:00,['bebc09cfb744f760bf14395513145165cd214e77'],25,60,85,4789965,6,0,0.7,0,3745
8e90ffc2bff714aaa945d24620fb3154d264127a,0,Stig Rohde D酶ssing,2017-09-22 16:44:12+02:00,"['66ff5fd9400aa1195c2e00409b96f991e869a824', 'c78eb0d522e97cc00136b46e1188ba08a5ca9d9c']",1,1,2,4789967,1,,,,3745
de0118d3c80d5bcf67aa20fb4b15743bc7fc2a5b,0,Ethan Li,2017-09-22 10:14:49-05:00,['884eb61ddab0c3da7ef587793b8543ba0f906451'],5,5,10,4789977,1,,,,3745
d2e221ae8087bcea8a17ab2ef6437f3df2baadc6,0,Robert Evans,2017-09-22 10:17:39-05:00,"['8e90ffc2bff714aaa945d24620fb3154d264127a', 'b7ed06f82650dd762ec2f422b024268c561076a2']",1,0,1,4789978,1,,,,3745
7d07c72a2f434f30b5d10047be65740a1b2e4f9f,0,Ethan Li,2017-09-22 10:55:04-05:00,['d2e221ae8087bcea8a17ab2ef6437f3df2baadc6'],0,8,8,4789986,1,0,0,0,3745
db510ae588f6cf2547c8c4c4b220b53f9db912d0,0,Robert Evans,2017-09-22 12:10:07-05:00,"['d2e221ae8087bcea8a17ab2ef6437f3df2baadc6', 'de0118d3c80d5bcf67aa20fb4b15743bc7fc2a5b']",50,111,161,4790147,7,,,,3745
ec77f66c124e1bdb499b9b80a9778aaa2fa9f9af,1,Ethan Li,2017-09-26 13:42:57-05:00,['db510ae588f6cf2547c8c4c4b220b53f9db912d0'],1,2,3,4790150,1,,,,3745
b1f98c5442cb402cc701514fa80c213135117273,0,GitHub,2017-09-26 14:30:55-05:00,['db510ae588f6cf2547c8c4c4b220b53f9db912d0'],1,1,2,4790152,1,,,,3745
4af7da0ff48bd347aa49509744c0e6a8e749341f,1,Kyle Nusbaum,2017-09-26 15:17:32-05:00,['da2f035865c0176e2fdf047730b0c1f55d016c50'],0,575,575,4790727,13,0.25,0.660714286,0.93452381,3757
ab6abf9512403d809fe3babccb95686d462c614f,1,Ethan Li,2017-09-26 16:08:58-05:00,['db510ae588f6cf2547c8c4c4b220b53f9db912d0'],49,91,140,4790867,6,,,,3757
9d5515a8a81f93467318e7c49279921a03e5cabc,0,Robert Evans,2017-09-26 16:51:54-05:00,"['db510ae588f6cf2547c8c4c4b220b53f9db912d0', '7d07c72a2f434f30b5d10047be65740a1b2e4f9f']",0,8,8,4790875,1,,,,3757
25c27c6d3a3680c6c3cf4d4e0a0dc0a1c18b82e8,1,Jungtaek Lim,2017-09-27 14:09:27+09:00,['9d5515a8a81f93467318e7c49279921a03e5cabc'],14,1333,1347,4792222,15,0.260989011,0.633241758,0.806318681,3766
a7b86c328ad56adf7e7259aeb2a9bcc1ece88b4f,1,Jungtaek Lim,2017-09-27 14:09:31+09:00,['25c27c6d3a3680c6c3cf4d4e0a0dc0a1c18b82e8'],150,123,273,4792495,7,1,1,0.302325581,3766
74cc7e2d8283dffbb2cd6f97e4b3d410f87c40bb,1,Jungtaek Lim,2017-09-27 14:09:31+09:00,['a7b86c328ad56adf7e7259aeb2a9bcc1ece88b4f'],119,208,327,4792822,10,0,0.866666667,1,3766
b5be1d6b0b42e42b527dc18665e529699b8c587c,0,Jungtaek Lim,2017-09-28 16:17:03+09:00,"['9d5515a8a81f93467318e7c49279921a03e5cabc', 'ab6abf9512403d809fe3babccb95686d462c614f']",49,91,140,4792962,6,,,,3766
ddea2ac7e31955a6bff0e77bb08550f870af3ce0,0,Jungtaek Lim,2017-09-28 16:17:48+09:00,"['b5be1d6b0b42e42b527dc18665e529699b8c587c', 'b1f98c5442cb402cc701514fa80c213135117273']",1,1,2,4792964,1,,,,3766
99969a5bf259c3fd0dc3ee12cc5380ed87896d18,0,Jungtaek Lim,2017-09-28 16:19:48+09:00,"['ddea2ac7e31955a6bff0e77bb08550f870af3ce0', 'ec77f66c124e1bdb499b9b80a9778aaa2fa9f9af']",1,2,3,4792967,1,,,,3766
5c05bb74cbef88dfd63ab212183c0494b9fcc985,0,Jungtaek Lim,2017-09-28 16:20:32+09:00,"['99969a5bf259c3fd0dc3ee12cc5380ed87896d18', '78cb243c4bc9aaeaffd6f1c76915ac20016b32e7']",1908,1627,3535,4796502,17,,,,3766
07418ae23c74b0baffc731920274c823c1edcbc3,0,Ethan Li,2017-09-28 08:29:58-05:00,['5c05bb74cbef88dfd63ab212183c0494b9fcc985'],0,28,28,4796530,2,0,1,1,3767
87ad03585276f4c02b54da70a0fe62ebcdcabe8c,0,Robert (Bobby) Evans,2017-09-28 14:42:36-05:00,['5c05bb74cbef88dfd63ab212183c0494b9fcc985'],47,58,105,4796635,1,0,0,0,3767
48f6969027e7b02a5b9220577189d3911aa2226d,1,Jungtaek Lim,2017-09-29 14:25:59+09:00,['5c05bb74cbef88dfd63ab212183c0494b9fcc985'],170,468,638,4797273,8,0.824561404,0.807017544,0.868421053,3769
293643f0956abbd2ccdf2b85c70fee0e1dce6be0,0,Jungtaek Lim,2017-09-29 14:26:30+09:00,"['5c05bb74cbef88dfd63ab212183c0494b9fcc985', '48f6969027e7b02a5b9220577189d3911aa2226d']",170,468,638,4797911,8,,,,3769
177cb95f4fbcb3011f73b88d8755b577671ed527,0,Robert Evans,2017-09-29 08:43:52-05:00,"['293643f0956abbd2ccdf2b85c70fee0e1dce6be0', '74cc7e2d8283dffbb2cd6f97e4b3d410f87c40bb']",57,1438,1495,4799406,15,,,,3769
07d79c198f174f41d68b08ad1b28f5ad84db99b6,0,Kyle Nusbaum,2017-09-29 11:28:17-05:00,['4af7da0ff48bd347aa49509744c0e6a8e749341f'],90,200,290,4799696,12,0.454545455,0.181818182,0,3769
a4fc110f72f982acde7d01c68850c374a7d9f1a3,0,Robert Evans,2017-09-29 12:43:23-05:00,"['177cb95f4fbcb3011f73b88d8755b577671ed527', '07d79c198f174f41d68b08ad1b28f5ad84db99b6']",0,685,685,4800381,12,,,,3769
cef7c9265699e1d74c71ab9839eee515e0074df7,1,Stig Rohde D酶ssing,2017-09-30 16:04:36+02:00,['a4fc110f72f982acde7d01c68850c374a7d9f1a3'],75,561,636,4801017,9,0.355311355,0.974358974,0.978021978,3771
3e3a04122740808799cafe460788f475cec05e89,0,Stig Rohde D酶ssing,2017-09-30 16:34:47+02:00,['a4fc110f72f982acde7d01c68850c374a7d9f1a3'],0,1,1,4801018,1,,,,3771
c548522c8882c499a4234cbc4cd8975b07a2f815,0,Jungtaek Lim,2017-10-02 14:44:52+09:00,"['a4fc110f72f982acde7d01c68850c374a7d9f1a3', '87ad03585276f4c02b54da70a0fe62ebcdcabe8c']",47,58,105,4801123,1,,,,3771
1b8b648d3a7e989bd321b510c07638a9771b9cab,0,Jungtaek Lim,2017-10-02 15:03:29+09:00,"['c548522c8882c499a4234cbc4cd8975b07a2f815', '07418ae23c74b0baffc731920274c823c1edcbc3']",0,28,28,4801151,2,,,,3771
3970122a07308346701de50e0de616a007999e77,0,Ethan Li,2017-10-02 08:42:23-05:00,['a4fc110f72f982acde7d01c68850c374a7d9f1a3'],32,11,43,4801194,5,0,0,0,3771
2151a2d2106caf015164bba224613c57545bd283,0,Robert Evans,2017-10-02 09:04:04-05:00,"['1b8b648d3a7e989bd321b510c07638a9771b9cab', '3e3a04122740808799cafe460788f475cec05e89']",0,1,1,4801195,1,,,,3771
c607d04828e73f8cc4bf32b4b872318b6b6e189d,0,Robert Evans,2017-10-02 09:20:52-05:00,"['2151a2d2106caf015164bba224613c57545bd283', '3970122a07308346701de50e0de616a007999e77']",32,11,43,4801238,5,,,,3771
e20394f91246b9d936f8ef3bf130343d7c4f1a03,0,Ethan Li,2017-10-03 15:03:16-05:00,['c607d04828e73f8cc4bf32b4b872318b6b6e189d'],0,3,3,4801241,1,1,1,0,3771
22427d0e793dd67c16498e59f4da70ed174e6cc9,0,Kishor Patil,2017-10-04 11:25:51-04:00,['c607d04828e73f8cc4bf32b4b872318b6b6e189d'],3,39,42,4801283,2,0.655172414,0.655172414,1,3771
e0e9bcb30c5d6dff8f2fe08322312374fb7d63f2,0,Kishor Patil,2017-10-04 17:21:27+00:00,['22427d0e793dd67c16498e59f4da70ed174e6cc9'],5,231,236,4801519,3,0.191489362,0.223404255,0.989361702,3771
4b2d6dc320f03317937e4908c404829944d84760,0,Stig Rohde D酶ssing,2017-10-04 21:22:11+02:00,"['c607d04828e73f8cc4bf32b4b872318b6b6e189d', 'cef7c9265699e1d74c71ab9839eee515e0074df7']",75,561,636,4802155,9,,,,3771
cbe1e372a462e6c8a6a19edf53774302940894a9,0,Stig Rohde D酶ssing,2017-10-04 21:24:57+02:00,"['4b2d6dc320f03317937e4908c404829944d84760', 'e20394f91246b9d936f8ef3bf130343d7c4f1a03']",0,3,3,4802158,1,,,,3771
2269e2028db6999c19c887116d0fcc95448a9a6d,0,Kishor Patil,2017-10-04 16:05:06-04:00,['e0e9bcb30c5d6dff8f2fe08322312374fb7d63f2'],12,36,48,4802206,3,0.333333333,0,1,3771
44f51f7e72f97fbd744e663be9ae68c676797a04,0,GitHub,2017-10-06 14:53:35-05:00,['cbe1e372a462e6c8a6a19edf53774302940894a9'],1,1,2,4802208,1,,,,3771
370a631857a2b510a1d4de2870ded09598394aa9,1,Stig Rohde D酶ssing,2017-10-07 22:25:57+02:00,['cbe1e372a462e6c8a6a19edf53774302940894a9'],114,203,317,4802525,16,0,1,1,3774
d304dd585239f74b75540cc5f7129f852f822fd8,0,Stig Rohde D酶ssing,2017-10-07 22:29:22+02:00,"['cbe1e372a462e6c8a6a19edf53774302940894a9', '44f51f7e72f97fbd744e663be9ae68c676797a04']",1,1,2,4802527,1,,,,3774
70d8ba9d5832c1893351dcfd0e285d287f221794,0,Jungtaek Lim,2017-10-09 10:15:17+09:00,"['d304dd585239f74b75540cc5f7129f852f822fd8', '370a631857a2b510a1d4de2870ded09598394aa9']",114,203,317,4802844,16,,,,3774
3503dcea62c9bb9d004388773705ad362e7cc5dd,1,Stig Rohde D酶ssing,2017-10-09 07:21:21+02:00,['70d8ba9d5832c1893351dcfd0e285d287f221794'],468,510,978,4803822,42,0,1,0,3774
38a32f83126fe894a78946504e4eb1cd2c953e8f,0,Felix Dreissig,2017-10-09 09:46:20+02:00,['cbe1e372a462e6c8a6a19edf53774302940894a9'],1,1,2,4803824,1,,,,3774
0b3930dc4506b0613e30d9d736becfac77b9a41b,0,Kishor Patil,2017-10-09 10:15:29-04:00,['2269e2028db6999c19c887116d0fcc95448a9a6d'],1,0,1,4803825,1,,,,3774
1a857637e6ab04241501ace192ffbf06487c750a,0,Stig Rohde D酶ssing,2017-10-09 20:35:36+02:00,"['70d8ba9d5832c1893351dcfd0e285d287f221794', '38a32f83126fe894a78946504e4eb1cd2c953e8f']",1,1,2,4803827,1,,,,3774
352cd4665287712813d5f6f2af2537769a2cbb82,0,Stig Rohde D酶ssing,2017-10-09 20:39:49+02:00,"['1a857637e6ab04241501ace192ffbf06487c750a', '3503dcea62c9bb9d004388773705ad362e7cc5dd']",468,510,978,4804805,42,,,,3774
e94b735a1381193fbf406657430284f381f9d8a7,1,Robert (Bobby) Evans,2017-10-09 14:56:58-05:00,['352cd4665287712813d5f6f2af2537769a2cbb82'],1541,3985,5526,4810331,52,0.374916164,0.502347418,0.898725687,3781
d1e6bbb50ee5dbfb595d27e3630205d29ff975c2,1,Robert (Bobby) Evans,2017-10-09 16:27:36-05:00,['e94b735a1381193fbf406657430284f381f9d8a7'],60,57,117,4810448,4,,,,3781
cf91236b385065209cf50d86d2d3071a402e5cd8,0,httfighter,2017-10-10 10:51:06+08:00,['352cd4665287712813d5f6f2af2537769a2cbb82'],3,3,6,4810454,1,,,,3781
f867e3ae577b4ac61d6941af0373253accd38ff5,0,Robert Evans,2017-10-10 13:10:21-05:00,"['352cd4665287712813d5f6f2af2537769a2cbb82', '0b3930dc4506b0613e30d9d736becfac77b9a41b']",12,297,309,4810763,7,,,,3781
a66c4a5effba66bf97e67dc55bfb79299ea02afe,0,Robert Evans,2017-10-10 13:30:50-05:00,"['f867e3ae577b4ac61d6941af0373253accd38ff5', 'd1e6bbb50ee5dbfb595d27e3630205d29ff975c2']",1541,3982,5523,4816286,52,,,,3781
01bd4f821c940e979c360a4667c27c0477fde9a7,1,Ethan Li,2017-10-10 17:06:31-05:00,['352cd4665287712813d5f6f2af2537769a2cbb82'],14,267,281,4816567,7,0.401234568,0.666666667,0.703703704,3781
14e98e73f42700b0c35519f89d8ef3bc41e9d9db,1,Stig Rohde D酶ssing,2017-10-11 19:05:37+02:00,['352cd4665287712813d5f6f2af2537769a2cbb82'],9,12,21,4816588,2,0,0,1,3781
d7bdc2d34b1a09a14c76381284edaf6236096457,1,Stig Rohde D酶ssing,2017-10-11 19:27:22+02:00,['14e98e73f42700b0c35519f89d8ef3bc41e9d9db'],118,226,344,4816932,12,1,0.983870968,1,3781
278cf205672ebc74a8f6e3973c0080f74e3012c7,0,Robert (Bobby) Evans,2017-10-12 08:38:59-05:00,['a66c4a5effba66bf97e67dc55bfb79299ea02afe'],3,3,6,4816938,1,,,,3781
f9747ef0d74db9567a5f2d73560c09f344c94d7e,0,Kevin Conaway,2017-10-12 16:26:43-04:00,['a66c4a5effba66bf97e67dc55bfb79299ea02afe'],6,8,14,4816952,1,1,1,1,3781
414f2b4a80546074465c5035360d4c78d2001d63,0,Robert Evans,2017-10-13 10:45:20-05:00,"['a66c4a5effba66bf97e67dc55bfb79299ea02afe', '278cf205672ebc74a8f6e3973c0080f74e3012c7']",3,3,6,4816958,1,,,,3781
15845336fd878f45298cfb49069bdfda326fa5fb,0,Stig Rohde D酶ssing,2017-10-14 08:49:59+02:00,"['414f2b4a80546074465c5035360d4c78d2001d63', 'd7bdc2d34b1a09a14c76381284edaf6236096457']",115,226,341,4817299,12,,,,3781
94dab8d9f59ce4416fcb24076c8ae518690a229e,0,Stig Rohde D酶ssing,2017-10-14 08:53:33+02:00,"['15845336fd878f45298cfb49069bdfda326fa5fb', 'f9747ef0d74db9567a5f2d73560c09f344c94d7e']",6,8,14,4817313,1,,,,3781
ca022899b3c433318f4e427e873d1ae583bee13b,0,Stig Rohde D酶ssing,2017-10-14 09:08:20+02:00,['94dab8d9f59ce4416fcb24076c8ae518690a229e'],1,1,2,4817315,1,,,,3781
37403d17ddf4f762fa61aac9feb93143ae854645,0,Robert Evans,2017-10-16 08:48:56-05:00,"['ca022899b3c433318f4e427e873d1ae583bee13b', 'cf91236b385065209cf50d86d2d3071a402e5cd8']",3,3,6,4817321,1,,,,3781
767c7f3be8699099ad9b2ffbdfc8baab36dd14f0,0,Ethan Li,2017-10-16 10:11:42-05:00,['ca022899b3c433318f4e427e873d1ae583bee13b'],1,1,2,4817323,1,,,,3781
c8947c2fede62036c20472c9e0335ef90a06b536,0,Robert Evans,2017-10-16 10:24:39-05:00,"['37403d17ddf4f762fa61aac9feb93143ae854645', '01bd4f821c940e979c360a4667c27c0477fde9a7']",14,267,281,4817604,7,,,,3781
e69fbc51ada2fd542d717bbd7623c39f4f6a1cb8,0,Jungtaek Lim,2017-10-17 12:40:48+09:00,['c8947c2fede62036c20472c9e0335ef90a06b536'],1,3,4,4817608,1,1,1,1,3781
914abe59b4c6e7e156e81a8e37a483cab6097f5a,0,Robert Evans,2017-10-17 10:11:04-05:00,"['c8947c2fede62036c20472c9e0335ef90a06b536', '767c7f3be8699099ad9b2ffbdfc8baab36dd14f0']",1,1,2,4817610,1,,,,3781
7b940aed63d05b17ce6fc18341af02748c548c7e,0,Jungtaek Lim,2017-10-18 13:59:01+09:00,"['914abe59b4c6e7e156e81a8e37a483cab6097f5a', 'e69fbc51ada2fd542d717bbd7623c39f4f6a1cb8']",1,3,4,4817614,1,,,,3781
7f6d7063df1690f267399a6d581fd2b782712e04,1,Stig Rohde D酶ssing,2017-10-18 22:18:34+02:00,['914abe59b4c6e7e156e81a8e37a483cab6097f5a'],129,20,149,4817763,10,0,0,0,3781
ae827dac08fa67997c5eb8e6c23828f190de2851,0,Hugo Louro,2017-10-22 21:49:00-07:00,['7b940aed63d05b17ce6fc18341af02748c548c7e'],1,1,2,4817765,1,,,,3781
b09e98698e298ad0edaf1f4916c663875d387c2e,1,Robert (Bobby) Evans,2017-10-23 13:15:39-05:00,['7b940aed63d05b17ce6fc18341af02748c548c7e'],34,30,64,4817829,2,1,0,0,3781
d0c5457c0efa4cf5838fdd9626804ff05e541ed0,0,Stig Rohde D酶ssing,2017-10-23 20:29:17+02:00,"['7b940aed63d05b17ce6fc18341af02748c548c7e', '7f6d7063df1690f267399a6d581fd2b782712e04']",129,20,149,4817978,10,,,,3781
6207d320c3f79185f5e8e19458d73fbf1aa10f72,0,Robert Evans,2017-10-25 16:39:18-05:00,"['d0c5457c0efa4cf5838fdd9626804ff05e541ed0', 'b09e98698e298ad0edaf1f4916c663875d387c2e']",34,30,64,4818042,2,,,,3781
7afd6fbe4603e35114a84e836b02484fe8cda660,1,Jungtaek Lim,2017-10-27 13:48:52+09:00,['6207d320c3f79185f5e8e19458d73fbf1aa10f72'],1936,1573,3509,4821551,24,0.358267717,0.543307087,0.692913386,3782
cef450064fa20e2194ef3f51a21c8e6693a285e3,0,Jungtaek Lim,2017-10-27 13:49:14+09:00,"['6207d320c3f79185f5e8e19458d73fbf1aa10f72', '7afd6fbe4603e35114a84e836b02484fe8cda660']",1936,1573,3509,4825060,24,,,,3782
5077228df5f2f047f991d2a026a3217fd904eec5,0,Jungtaek Lim,2017-10-27 15:11:30+09:00,"['cef450064fa20e2194ef3f51a21c8e6693a285e3', 'ae827dac08fa67997c5eb8e6c23828f190de2851']",1,1,2,4825062,1,,,,3782
e7d9881c1876494b179e06c7c3ee64c606590343,1,Kishor Patil,2017-10-27 11:58:50-04:00,['6207d320c3f79185f5e8e19458d73fbf1aa10f72'],9,182,191,4825253,9,0.013513514,0,1,3783
44855ba60e616ebd35bef9f4b7a5ca9013bd5c7e,0,Ethan Li,2017-10-27 14:13:41-05:00,['d0c5457c0efa4cf5838fdd9626804ff05e541ed0'],66,90,156,4825409,9,0,0.416666667,0,3783
875761189ca387f0575aeaea33a769d70d36ae47,1,Hugo Louro,2017-10-27 15:42:18-07:00,['7b940aed63d05b17ce6fc18341af02748c548c7e'],64,100,164,4825573,4,1,1,0,3783
0b547d373abeaac721c409034e3ae4b7ff485dd6,1,Hugo Louro,2017-10-27 15:58:44-07:00,['875761189ca387f0575aeaea33a769d70d36ae47'],3,5,8,4825581,1,,,,3783
2060664018a90cc341025800cc644474ed586cb1,0,Daniel Dara,2017-10-27 22:38:37-04:00,['5077228df5f2f047f991d2a026a3217fd904eec5'],5,13,18,4825599,1,1,1,1,3783
29f845b4a5db3f8807f6a07ea3f80a4ebcf5bbc0,0,Stig Rohde D酶ssing,2017-10-28 08:52:56+02:00,"['5077228df5f2f047f991d2a026a3217fd904eec5', '875761189ca387f0575aeaea33a769d70d36ae47']",64,100,164,4825763,4,,,,3783
a1ab78b2b0087096e2d019238c72c6e527c44082,0,Jungtaek Lim,2017-10-28 19:16:56+09:00,"['29f845b4a5db3f8807f6a07ea3f80a4ebcf5bbc0', '44855ba60e616ebd35bef9f4b7a5ca9013bd5c7e']",66,90,156,4825919,9,,,,3783
16a4cb8c4ed88124bd7476256b02ca41d9399ed0,0,Jungtaek Lim,2017-10-29 12:44:29+09:00,"['a1ab78b2b0087096e2d019238c72c6e527c44082', '0b547d373abeaac721c409034e3ae4b7ff485dd6']",3,5,8,4825927,1,,,,3783
24ab227edf2309aaad1bb41145cc11861b8b46eb,0,Jungtaek Lim,2017-10-29 14:06:57+09:00,"['16a4cb8c4ed88124bd7476256b02ca41d9399ed0', '2060664018a90cc341025800cc644474ed586cb1']",5,13,18,4825945,1,,,,3783
cca93d2a1ad503e5d2630fb4d1a88778df359c35,1,Stig Rohde D酶ssing,2017-10-29 20:30:11+01:00,['24ab227edf2309aaad1bb41145cc11861b8b46eb'],196,252,448,4826393,12,1,1,0.961538462,3783
d884f8a3dda9f9d81064280e61eb9e56d4542e87,0,Kevin Peek,2017-10-30 11:22:20-04:00,['7b940aed63d05b17ce6fc18341af02748c548c7e'],59,311,370,4826763,4,1,1,0.952380952,3785
82f7450cc24f0953730d48dc0264a4df11283c57,0,Robert Evans,2017-10-30 10:25:06-05:00,"['24ab227edf2309aaad1bb41145cc11861b8b46eb', 'd884f8a3dda9f9d81064280e61eb9e56d4542e87']",59,311,370,4827133,4,,,,3785
171a14464075705b04494ea594f14e41d92bee4c,0,Kishor Patil,2017-10-30 13:05:18-04:00,['e7d9881c1876494b179e06c7c3ee64c606590343'],47,48,95,4827228,2,,,,3785
4128c7318044e007828d22cf277953ffd144a1ec,0,Kishor Patil,2017-10-30 13:22:31-04:00,['171a14464075705b04494ea594f14e41d92bee4c'],34,34,68,4827296,1,,,,3785
1b8f67c14970323667cd5a6ecb15bf0ee73f9c98,0,Robert Evans,2017-10-30 12:29:32-05:00,"['82f7450cc24f0953730d48dc0264a4df11283c57', '4128c7318044e007828d22cf277953ffd144a1ec']",47,221,268,4827564,9,,,,3785
6e15670a90466e6439beb612092c12a1142438f8,0,Lawrence Craft,2017-10-31 16:39:20+00:00,['1b8f67c14970323667cd5a6ecb15bf0ee73f9c98'],11,11,22,4827586,1,,,,3785
5d95e7139493270643e35ffb1ba59628c8402e57,0,Robert (Bobby) Evans,2017-11-01 09:23:33-05:00,['1b8f67c14970323667cd5a6ecb15bf0ee73f9c98'],1,7,8,4827594,1,0,0,1,3785
5f0abb21c83c129af5b4acce2d0bb3bbb0f41887,1,Robert (Bobby) Evans,2017-11-03 08:16:49-05:00,['5d95e7139493270643e35ffb1ba59628c8402e57'],694,876,1570,4829164,26,1,1,1,3788
3b5fa38588d85a65592d93a1c738bce0855022de,0,Robert (Bobby) Evans,2017-11-03 15:24:56-05:00,['5f0abb21c83c129af5b4acce2d0bb3bbb0f41887'],49,52,101,4829265,3,0.285714286,0.571428571,0.571428571,3788
89b48d2a89874ab6656494fc7a9c27f861e50ba6,0,Robert Evans,2017-11-03 15:30:49-05:00,"['1b8f67c14970323667cd5a6ecb15bf0ee73f9c98', '5d95e7139493270643e35ffb1ba59628c8402e57']",1,7,8,4829273,1,,,,3788
b37d31a0240b4f3b64d5b74025a1649224eeb794,0,Stig Rohde D酶ssing,2017-11-05 12:57:04+01:00,['89b48d2a89874ab6656494fc7a9c27f861e50ba6'],1,18,19,4829292,3,,,,3788
c3b56624356224743f5e22a186807a3875ddd83e,0,Stig Rohde D酶ssing,2017-11-05 13:43:51+01:00,['89b48d2a89874ab6656494fc7a9c27f861e50ba6'],0,21,21,4829313,4,,,,3788
82e00aa12631da4137ba9503cc8660c769e3d4f0,0,Jungtaek Lim,2017-11-06 12:40:32+09:00,['89b48d2a89874ab6656494fc7a9c27f861e50ba6'],18,175,193,4829506,5,0.901639344,1,0.983606557,3789
b5eb86b0147879c7536c9ad43feaf2f8046dfe4c,0,Jungtaek Lim,2017-11-06 12:41:04+09:00,"['89b48d2a89874ab6656494fc7a9c27f861e50ba6', '82e00aa12631da4137ba9503cc8660c769e3d4f0']",18,175,193,4829699,5,,,,3789
efd1f05940b41ab1f1e5c5d22fa9f1d2322d2d78,0,Robert (Bobby) Evans,2017-11-06 11:01:59-06:00,['3b5fa38588d85a65592d93a1c738bce0855022de'],13,34,47,4829746,1,,,,3789
06341d8de6ad5a71ec00eb1336ba86b4f02ea720,0,Robert Evans,2017-11-07 10:18:50-06:00,"['b5eb86b0147879c7536c9ad43feaf2f8046dfe4c', 'efd1f05940b41ab1f1e5c5d22fa9f1d2322d2d78']",705,911,1616,4831362,25,,,,3789
29d37124d4f55fecc3d29fb5304553e0b539f4b2,0,Robert Evans,2017-11-07 11:09:58-06:00,"['06341d8de6ad5a71ec00eb1336ba86b4f02ea720', 'b37d31a0240b4f3b64d5b74025a1649224eeb794']",1,18,19,4831381,3,,,,3789
75e4a027d874266b302b84c5507ca148c5be7e52,1,Stig Rohde D酶ssing,2017-11-07 23:06:53+01:00,['06341d8de6ad5a71ec00eb1336ba86b4f02ea720'],156,353,509,4831890,13,1,1,1,3792
52f2e9f34c275e12c062302b8a5e3c0ed2cbe0bc,0,Ethan Li,2017-11-07 16:32:16-06:00,['29d37124d4f55fecc3d29fb5304553e0b539f4b2'],1,8,9,4831899,1,0,0,0,3792
b16a0deb0ceb7a730c7a5835b39881a5785ac388,0,Jungtaek Lim,2017-11-08 09:08:43+09:00,"['29d37124d4f55fecc3d29fb5304553e0b539f4b2', '52f2e9f34c275e12c062302b8a5e3c0ed2cbe0bc']",1,8,9,4831908,1,,,,3792
8bf8a2f95df266fc6ca4024f6ce7cd0743e7ecc5,0,Robert Evans,2017-11-08 08:34:01-06:00,"['b16a0deb0ceb7a730c7a5835b39881a5785ac388', 'c3b56624356224743f5e22a186807a3875ddd83e']",0,21,21,4831929,4,,,,3792
566db743de29d8463c9a8c68a359cb34ce01d900,0,Robert Evans,2017-11-08 08:55:24-06:00,"['8bf8a2f95df266fc6ca4024f6ce7cd0743e7ecc5', '6e15670a90466e6439beb612092c12a1142438f8']",11,11,22,4831951,1,,,,3792
9371685d8a7f6685822ab367078d7ab5e86a4c96,0,Robert Evans,2017-11-08 13:55:59-06:00,"['566db743de29d8463c9a8c68a359cb34ce01d900', '75e4a027d874266b302b84c5507ca148c5be7e52']",156,353,509,4832460,13,,,,3792
3578cf8d4f4f541c1ba3e0e0d9410426908114f4,0,Ethan Li,2017-11-08 14:17:14-06:00,['566db743de29d8463c9a8c68a359cb34ce01d900'],4,6,10,4832470,1,1,1,0,3792
8a9141c24d2732865061765a43cd8e1871709095,1,Govind Menon,2017-11-09 13:56:08-06:00,['566db743de29d8463c9a8c68a359cb34ce01d900'],946,2282,3228,4835698,34,0.292475728,0.497572816,0.811893204,3795
e85e50fb86c03f0fe036d13d55209d80291b96d6,0,Jungtaek Lim,2017-11-10 06:01:34+09:00,"['9371685d8a7f6685822ab367078d7ab5e86a4c96', '3578cf8d4f4f541c1ba3e0e0d9410426908114f4']",4,6,10,4835708,1,,,,3795
445f439391f211ca064df818f752f3ee49e06f47,0,Jungtaek Lim,2017-11-10 06:06:11+09:00,"['e85e50fb86c03f0fe036d13d55209d80291b96d6', '8a9141c24d2732865061765a43cd8e1871709095']",946,2282,3228,4838936,34,,,,3795
864188f1cfb18aedccf9e235e18de3b059ebdc80,0,Ethan Li,2017-11-09 17:02:19-06:00,['566db743de29d8463c9a8c68a359cb34ce01d900'],31,59,90,4839026,1,0.631578947,0.578947368,0.578947368,3795
3cb52398a3242ce6d1e01113aefee1402bd034a8,0,Stig Rohde D酶ssing,2017-11-10 09:08:29+01:00,['9371685d8a7f6685822ab367078d7ab5e86a4c96'],23,32,55,4839081,8,0,1,1,3795
0ae5068a205becfafc75bd8e11c2c672c76e0f61,0,Stig Rohde D酶ssing,2017-11-10 17:03:14+01:00,"['445f439391f211ca064df818f752f3ee49e06f47', 'cca93d2a1ad503e5d2630fb4d1a88778df359c35']",196,252,448,4839529,12,,,,3795
37f9c548f75fe4e43fc496e8b59472edaa123cda,0,GitHub,2017-11-10 12:46:37-06:00,['0ae5068a205becfafc75bd8e11c2c672c76e0f61'],6,6,12,4839541,1,,,,3795
ee1be2b73fffff05e32cfd15857561c24655d90c,0,Robert Evans,2017-11-10 14:53:54-06:00,"['0ae5068a205becfafc75bd8e11c2c672c76e0f61', '37f9c548f75fe4e43fc496e8b59472edaa123cda']",6,6,12,4839553,1,,,,3795
b25d580780d31598f568bbe8dde800fe4b0d6f61,0,Govind Menon,2017-11-10 17:24:10-06:00,['ee1be2b73fffff05e32cfd15857561c24655d90c'],7,7,14,4839567,2,,,,3795
2657c25f232f9cf6f7d6580cd27c2d76a7b6c4c9,0,Stig Rohde D酶ssing,2017-11-11 10:47:41+01:00,"['ee1be2b73fffff05e32cfd15857561c24655d90c', '3cb52398a3242ce6d1e01113aefee1402bd034a8']",23,32,55,4839622,8,,,,3795
caca8292772650c8ce041d569b624b4813a13b46,1,Stig Rohde D酶ssing,2017-11-12 08:26:14+01:00,['2657c25f232f9cf6f7d6580cd27c2d76a7b6c4c9'],2866,2914,5780,4845402,17,0,0,1,3796
d568408e4d284199cf53baed7dd1471ab9628ca4,0,Stig Rohde D酶ssing,2017-11-12 10:14:31+01:00,['2657c25f232f9cf6f7d6580cd27c2d76a7b6c4c9'],5,7,12,4845414,6,1,1,1,3796
9063524f31bb6822ee1b94dc13a2c1393f7d0732,0,Jungtaek Lim,2017-11-13 06:37:21+09:00,"['2657c25f232f9cf6f7d6580cd27c2d76a7b6c4c9', 'caca8292772650c8ce041d569b624b4813a13b46']",2866,2914,5780,4851194,17,,,,3796
32fefef835984663af2e799885351e7f3d9a067a,0,Jungtaek Lim,2017-11-13 06:57:54+09:00,"['9063524f31bb6822ee1b94dc13a2c1393f7d0732', 'b25d580780d31598f568bbe8dde800fe4b0d6f61']",7,7,14,4851208,2,,,,3796
2709a1cda9bd1bcc5982bd73243bbe2a5fd0112c,0,Stig Rohde D酶ssing,2017-11-13 19:26:09+01:00,"['32fefef835984663af2e799885351e7f3d9a067a', 'd568408e4d284199cf53baed7dd1471ab9628ca4']",5,7,12,4851220,6,,,,3796
6bc873cd23ecc4d20758afca322f44f6a3713e8c,0,Robert (Bobby) Evans,2017-11-13 15:18:42-06:00,['2709a1cda9bd1bcc5982bd73243bbe2a5fd0112c'],0,4,4,4851224,1,0,1,0,3796
6a26bef8f0373c26317b1aa5dc26a74f92b87016,0,Jungtaek Lim,2017-11-14 15:23:05+09:00,"['2709a1cda9bd1bcc5982bd73243bbe2a5fd0112c', '864188f1cfb18aedccf9e235e18de3b059ebdc80']",31,59,90,4851314,1,,,,3796
a1ef0f6169761721a1c6f9247fdaf8544c2f3d8d,0,Stig Rohde D酶ssing,2017-11-14 22:52:41+01:00,"['6a26bef8f0373c26317b1aa5dc26a74f92b87016', '6bc873cd23ecc4d20758afca322f44f6a3713e8c']",0,4,4,4851318,1,,,,3796
88583feabf6e39c6bc7c4e657c989ca5ba2671d2,1,Stig Rohde D酶ssing,2017-11-15 08:20:20+01:00,['a1ef0f6169761721a1c6f9247fdaf8544c2f3d8d'],144,382,526,4851844,10,0.081632653,0.666666667,0.829931973,3797
3ee5543f06978765ee1d66bce0fc6530f68076d9,0,Stig Rohde D酶ssing,2017-11-15 08:21:18+01:00,"['a1ef0f6169761721a1c6f9247fdaf8544c2f3d8d', '88583feabf6e39c6bc7c4e657c989ca5ba2671d2']",144,382,526,4852370,10,,,,3797
1e957a64af1a3ea2855bbb29e28f94b87ae91932,0,Ethan Li,2017-11-15 14:15:30-06:00,['6a26bef8f0373c26317b1aa5dc26a74f92b87016'],4,5,9,4852379,2,0,0,0,3797
f9637c6e680eca1577df795afc1e3e5add6cb44f,0,Jungtaek Lim,2017-11-16 08:21:53+09:00,['3ee5543f06978765ee1d66bce0fc6530f68076d9'],7,11,18,4852397,4,0.5,1,1,3797
0b4741c5a9d0b1e87ed9becf1c8fffdbe084ec32,0,Jungtaek Lim,2017-11-16 08:22:22+09:00,"['3ee5543f06978765ee1d66bce0fc6530f68076d9', 'f9637c6e680eca1577df795afc1e3e5add6cb44f']",7,11,18,4852415,4,,,,3797
0ecc5bf9595259c94ea52cddbed336890d281b46,0,Jungtaek Lim,2017-11-16 13:43:04+09:00,['0b4741c5a9d0b1e87ed9becf1c8fffdbe084ec32'],7,8,15,4852430,4,,,,3797
8abdec8b53fe454d068cd592f1568021de960dff,0,Jungtaek Lim,2017-11-16 13:43:28+09:00,"['0b4741c5a9d0b1e87ed9becf1c8fffdbe084ec32', '0ecc5bf9595259c94ea52cddbed336890d281b46']",7,8,15,4852445,4,,,,3797
8e4a146542a5a3176d2e22bccc851558d57f219a,0,Robert Evans,2017-11-16 16:49:35-06:00,"['8abdec8b53fe454d068cd592f1568021de960dff', '1e957a64af1a3ea2855bbb29e28f94b87ae91932']",4,5,9,4852454,2,,,,3797
96c461d06274fbeaaccbe713967bdfd0585e3a61,0,Robert (Bobby) Evans,2017-11-17 07:32:23-06:00,['8e4a146542a5a3176d2e22bccc851558d57f219a'],129,108,237,4852691,6,0,0,0,3797
dcfbf274b0b6d75051423eb81440c85b4b27beb3,0,Robert (Bobby) Evans,2017-11-17 07:32:23-06:00,['96c461d06274fbeaaccbe713967bdfd0585e3a61'],180,182,362,4853053,12,1,1,1,3797
14cf5e61a96775d1997ec5e79d22fb3a36f13b6b,0,Robert (Bobby) Evans,2017-11-17 09:34:15-06:00,['dcfbf274b0b6d75051423eb81440c85b4b27beb3'],31,29,60,4853113,4,,,,3797
774928028f2d06af5d68e13f0fb745561c2aa4a0,0,Stig Rohde D酶ssing,2017-11-19 11:00:37+01:00,['8e4a146542a5a3176d2e22bccc851558d57f219a'],3,3,6,4853119,2,,,,3797
9d52435c5b5378bc4a618731ef5ecf573f07294a,0,Robert Evans,2017-11-20 08:12:35-06:00,"['8e4a146542a5a3176d2e22bccc851558d57f219a', '14cf5e61a96775d1997ec5e79d22fb3a36f13b6b']",313,292,605,4853724,12,,,,3797
6a4aeb9101bb1e6b196fa348ece03e55807391d1,1,Robert (Bobby) Evans,2017-11-20 13:47:47-06:00,['9d52435c5b5378bc4a618731ef5ecf573f07294a'],615,864,1479,4855203,24,1,1,1,3800
61a944fd15e564482a5c55655daad9736948d961,0,Stig Rohde D酶ssing,2017-11-20 20:59:45+01:00,"['9d52435c5b5378bc4a618731ef5ecf573f07294a', '774928028f2d06af5d68e13f0fb745561c2aa4a0']",3,3,6,4855209,2,,,,3800
860fe46b96a078767f667560217a582962a3f3cd,0,Ethan Li,2017-11-21 15:42:55-06:00,['61a944fd15e564482a5c55655daad9736948d961'],1,1,2,4855211,1,,,,3800
6568fd066df04c18c42f39249cea9673f546c59a,1,Stig Rohde D酶ssing,2017-11-24 16:34:05+01:00,['61a944fd15e564482a5c55655daad9736948d961'],21,10,31,4855242,6,,,,3800
3cf71d2c6fde34fb708b9f834135702b0adeb4b6,0,Stig Rohde D酶ssing,2017-11-24 16:39:54+01:00,"['61a944fd15e564482a5c55655daad9736948d961', '860fe46b96a078767f667560217a582962a3f3cd']",1,1,2,4855244,1,,,,3800
becab7cc2de23bb7754a7bf438be2270101eecf0,0,Jungtaek Lim,2017-11-25 09:09:11+09:00,"['3cf71d2c6fde34fb708b9f834135702b0adeb4b6', '6a4aeb9101bb1e6b196fa348ece03e55807391d1']",615,864,1479,4856723,24,,,,3800
ea233a908fd3124f2460353c5a6622a8aed98519,0,Ethan Li,2017-11-27 10:36:07-06:00,['becab7cc2de23bb7754a7bf438be2270101eecf0'],5,12,17,4856740,2,1,1,0,3800
792ac9761dcc0ce2462eb4b2c02467e87e0103fc,0,Ethan Li,2017-11-28 13:14:56-06:00,['becab7cc2de23bb7754a7bf438be2270101eecf0'],6,12,18,4856758,1,1,0.75,0.75,3800
107a9c9ab34aebfabad646e8d30b51e94e3ae060,0,Jungtaek Lim,2017-11-29 07:49:41+09:00,['becab7cc2de23bb7754a7bf438be2270101eecf0'],1,6,7,4856765,1,0,1,0,3800
e99b53902d40fbcaff47bd876eba432de1d086d5,0,Jungtaek Lim,2017-11-29 07:49:56+09:00,"['becab7cc2de23bb7754a7bf438be2270101eecf0', '107a9c9ab34aebfabad646e8d30b51e94e3ae060']",1,6,7,4856772,1,,,,3800
7e718862aeb32fad5695ca57f16b32f18a58c177,0,Jungtaek Lim,2017-11-29 07:51:09+09:00,['e99b53902d40fbcaff47bd876eba432de1d086d5'],1,1,2,4856774,1,,,,3800
44e0e0a491d1db23884eb018852e97e7ca9d0a6b,0,GitHub,2017-11-29 15:22:50+08:00,['bfd10066cc86b66fe7e71c7c09b33d628bd3d20e'],1,1,2,4856776,1,,,,3800
2552c078427bbae54100093b0976dfff9d8c6d08,0,GitHub,2017-11-29 15:24:31+08:00,"['bfd10066cc86b66fe7e71c7c09b33d628bd3d20e', '44e0e0a491d1db23884eb018852e97e7ca9d0a6b']",1,1,2,4856778,1,,,,3800
7e622d178bd98860f6722977f9d803c371bbe0f2,0,Robert Evans,2017-11-29 08:28:20-06:00,"['7e718862aeb32fad5695ca57f16b32f18a58c177', '2552c078427bbae54100093b0976dfff9d8c6d08']",1,1,2,4856780,1,,,,3800
d42e186e3ea1241ed2f79548002bbf53e306f71e,0,Stig Rohde D酶ssing,2017-11-29 18:42:08+01:00,"['7e622d178bd98860f6722977f9d803c371bbe0f2', '6568fd066df04c18c42f39249cea9673f546c59a']",21,10,31,4856811,6,,,,3800
c3ae8b97d2d11e008402f5e8d30692df830be8d4,0,Stig Rohde D酶ssing,2017-11-29 18:43:12+01:00,"['d42e186e3ea1241ed2f79548002bbf53e306f71e', 'ea233a908fd3124f2460353c5a6622a8aed98519']",5,12,17,4856828,2,,,,3800
4495f661ce80fb98aefee0aa843f58a72ecada89,0,Jungtaek Lim,2017-12-05 16:12:13+09:00,"['c3ae8b97d2d11e008402f5e8d30692df830be8d4', '792ac9761dcc0ce2462eb4b2c02467e87e0103fc']",6,12,18,4856846,1,,,,3800
6e2b2dc0f29a1db41d81820395c7382631d29494,0,GitHub,2017-12-05 16:01:15+08:00,['d7c781891fd0cf409335ed1b70397e3c6747475e'],2,2,4,4856850,1,,,,3800
5c7a5e186686c8501453db2daf0fc0cd88ee5c68,0,GitHub,2017-12-06 12:30:55-06:00,['4495f661ce80fb98aefee0aa843f58a72ecada89'],12,12,24,4856874,1,,,,3800
1dcd12de27b813a8c3e42d600028fa97df0a5f15,1,Jungtaek Lim,2017-12-07 09:59:28+09:00,['4495f661ce80fb98aefee0aa843f58a72ecada89'],2981,1048,4029,4860903,31,0.275362319,0.005797101,0.09468599,3804
3489dbce822c502046c204318b14412dee033653,0,Xin Wang,2017-12-07 17:34:05+08:00,"['4495f661ce80fb98aefee0aa843f58a72ecada89', '6e2b2dc0f29a1db41d81820395c7382631d29494']",2,2,4,4860907,1,,,,3804
00c247742781d4c6407d8cd87ae70820739714f9,0,Xin Wang,2017-12-07 17:39:53+08:00,"['3489dbce822c502046c204318b14412dee033653', '5c7a5e186686c8501453db2daf0fc0cd88ee5c68']",12,12,24,4860931,1,,,,3804
c8b306dc33e606c209046374952b6c9f7cc69ca0,1,Hugo Louro,2017-12-07 13:42:40-08:00,['00c247742781d4c6407d8cd87ae70820739714f9'],9,11,20,4860951,1,1,1,1,3804
cfb7d263d2c5f4b48f106f930ed654b0b539674d,1,Jungtaek Lim,2017-12-08 15:31:29+09:00,['c8b306dc33e606c209046374952b6c9f7cc69ca0'],303,611,914,4861865,33,0.173913043,0.043478261,1,3804
67f13b530577e2da4993709a62ec3b2aa86b376c,0,Jungtaek Lim,2017-12-08 15:33:12+09:00,"['c8b306dc33e606c209046374952b6c9f7cc69ca0', 'cfb7d263d2c5f4b48f106f930ed654b0b539674d']",303,611,914,4862779,33,,,,3804
c71f4c351511b8683b7b28528259774a7f11c3de,1,Stig Rohde D酶ssing,2017-12-08 12:44:44+01:00,['67f13b530577e2da4993709a62ec3b2aa86b376c'],1,78,79,4862858,2,0,1,1,3805
b246d37419f89a33cc9895129d42952a82f667f3,0,Stig Rohde D酶ssing,2017-12-10 15:28:37+01:00,"['67f13b530577e2da4993709a62ec3b2aa86b376c', 'c71f4c351511b8683b7b28528259774a7f11c3de']",1,78,79,4862937,2,,,,3805
44c1e0031a270a367150bc76d0a1077fa5d3e1d1,1,Stig Rohde D酶ssing,2017-12-14 17:32:20+01:00,['b246d37419f89a33cc9895129d42952a82f667f3'],0,1,1,4862938,1,,,,3805
5bdf3dd674d0fdf4c5d6b2549da34e21e6c70d77,0,Jungtaek Lim,2017-12-15 18:43:56+09:00,"['b246d37419f89a33cc9895129d42952a82f667f3', '44c1e0031a270a367150bc76d0a1077fa5d3e1d1']",0,1,1,4862939,1,,,,3805
e7fdd67a6ad7b2fb9b30610a4613f0a132311cdb,0,Jungtaek Lim,2017-12-15 18:55:23+09:00,"['5bdf3dd674d0fdf4c5d6b2549da34e21e6c70d77', '1dcd12de27b813a8c3e42d600028fa97df0a5f15']",2981,1048,4029,4866968,31,,,,3805
6d3ef144360daafc16ad4cd9c9a8b264bb95cee3,0,Stig Rohde D酶ssing,2017-12-16 00:28:54+01:00,['e7fdd67a6ad7b2fb9b30610a4613f0a132311cdb'],42,82,124,4867092,3,0.5,0.5,1,3806
8e42652ef40aede81c05c6e8a83da11889f9f54b,1,Stig Rohde D酶ssing,2017-12-16 01:04:51+01:00,['e7fdd67a6ad7b2fb9b30610a4613f0a132311cdb'],49,118,167,4867259,3,0.052631579,1,1,3806
06b48fe0454d756c81dbedf906b5ff084a00c233,0,Stig Rohde D酶ssing,2017-12-16 09:10:01+01:00,"['e7fdd67a6ad7b2fb9b30610a4613f0a132311cdb', '8e42652ef40aede81c05c6e8a83da11889f9f54b']",49,118,167,4867426,3,,,,3806
969c232618725ad254c4d28bcf91d6b0805f189f,1,Stig Rohde D酶ssing,2017-12-16 09:22:26+01:00,['06b48fe0454d756c81dbedf906b5ff084a00c233'],105,254,359,4867785,11,0,1,0.92,3807
c893c8dd82dc3fcc5f1c9fce469d62c429e6e84c,0,Stig Rohde D酶ssing,2017-12-16 10:41:32+01:00,"['06b48fe0454d756c81dbedf906b5ff084a00c233', '969c232618725ad254c4d28bcf91d6b0805f189f']",105,254,359,4868144,11,,,,3807
37d96e7adb4450357958211a5ef568ff84a99cfc,0,Ethan Li,2017-12-18 09:22:52-06:00,['c893c8dd82dc3fcc5f1c9fce469d62c429e6e84c'],2,12,14,4868158,1,0,1,1,3807
6bf3094c60f0af665f0129bb9f68c0ec7836b05f,0,Jungtaek Lim,2017-12-19 08:02:38+09:00,['b246d37419f89a33cc9895129d42952a82f667f3'],33,199,232,4868390,8,1,0.8375,0.4625,3807
3af8dda88aaff2e62be0d6aafd8bb1cbaaa07f8d,0,Jungtaek Lim,2017-12-19 08:02:55+09:00,"['c893c8dd82dc3fcc5f1c9fce469d62c429e6e84c', '6bf3094c60f0af665f0129bb9f68c0ec7836b05f']",33,199,232,4868622,8,,,,3807
5e3c966b23bc3b6d924a52ea62a32b194978af24,0,Erik Weathers,2017-12-18 21:42:31-07:00,['3af8dda88aaff2e62be0d6aafd8bb1cbaaa07f8d'],1,2,3,4868625,2,0,0,1,3807
1c2286bc2c776fe14869111070131f1407d698fe,0,Jungtaek Lim,2017-12-19 14:00:13+09:00,"['3af8dda88aaff2e62be0d6aafd8bb1cbaaa07f8d', '37d96e7adb4450357958211a5ef568ff84a99cfc']",2,12,14,4868639,1,,,,3807
a5406a61b8d65d54662078f5b2dfe96afe3ed319,0,Robert (Bobby) Evans,2017-12-19 10:45:09-06:00,['1c2286bc2c776fe14869111070131f1407d698fe'],23,954,977,4869616,6,0.290378007,0.701030928,0.847079038,3809
6d96c401108127d020a5fe98a0ab98bd2077cd9a,0,Robert Evans,2017-12-19 14:02:41-06:00,"['1c2286bc2c776fe14869111070131f1407d698fe', 'a5406a61b8d65d54662078f5b2dfe96afe3ed319']",23,954,977,4870593,6,,,,3809
5fad1ad30785e3f25ce094ad06e39d29a4a914e7,1,Robert (Bobby) Evans,2017-12-21 09:05:16-06:00,['6d96c401108127d020a5fe98a0ab98bd2077cd9a'],58,56,114,4870707,2,1,1,0,3809
6aaf8ee7cb042960831547a3ef07ce68a1105970,0,Robert (Bobby) Evans,2017-12-21 12:08:51-06:00,['5fad1ad30785e3f25ce094ad06e39d29a4a914e7'],6,54,60,4870767,2,1,1,1,3810
74a718cdf9ba5d8f159ea80ea706012c78aab070,0,ouyangliang,2017-12-22 11:02:32+08:00,['1c2286bc2c776fe14869111070131f1407d698fe'],26,28,54,4870821,3,0,0,1,3810
65be2709c5fbd686211d5ec25e46835c56c9733d,0,Stig Rohde D酶ssing,2017-12-22 18:30:20+01:00,"['6d96c401108127d020a5fe98a0ab98bd2077cd9a', '74a718cdf9ba5d8f159ea80ea706012c78aab070']",26,28,54,4870875,3,,,,3810
6482b2a140e8cc19ea2357822543324a1c570d38,0,Xin Wang,2017-12-24 23:06:15+08:00,['65be2709c5fbd686211d5ec25e46835c56c9733d'],35,56,91,4870966,3,1,1,1,3810
a3899b75a79781602fa58b90de6c8aa784af5332,1,Hugo Louro,2017-12-25 16:07:36-08:00,['65be2709c5fbd686211d5ec25e46835c56c9733d'],125,896,1021,4871987,14,0.527065527,0.982905983,0.977207977,3814
8b9330ab055fc517209eb583b3b6fe7e78584e09,0,Jungtaek Lim,2017-12-26 09:41:30+09:00,"['65be2709c5fbd686211d5ec25e46835c56c9733d', '5e3c966b23bc3b6d924a52ea62a32b194978af24']",1,2,3,4871990,2,,,,3814
34faca7162d335ab0dcb88a23e991a3bdeacda45,0,Jungtaek Lim,2017-12-26 09:51:42+09:00,"['8b9330ab055fc517209eb583b3b6fe7e78584e09', '6482b2a140e8cc19ea2357822543324a1c570d38']",35,56,91,4872081,3,,,,3814
d6f666785a1e78894b1e4e25080cf3f90a953121,0,Jungtaek Lim,2017-12-26 13:21:42+09:00,"['34faca7162d335ab0dcb88a23e991a3bdeacda45', '6aaf8ee7cb042960831547a3ef07ce68a1105970']",58,104,162,4872243,3,,,,3814
5e696ffe464d3bcd15dbf29adda2d10902727b33,0,Jungtaek Lim,2017-12-26 13:44:04+09:00,"['d6f666785a1e78894b1e4e25080cf3f90a953121', '6d3ef144360daafc16ad4cd9c9a8b264bb95cee3']",42,82,124,4872367,3,,,,3814
f998e267c9aa78609088b7d58e072f49e8befb3f,0,Stig Rohde D酶ssing,2017-12-26 11:33:25+01:00,"['5e696ffe464d3bcd15dbf29adda2d10902727b33', 'a3899b75a79781602fa58b90de6c8aa784af5332']",125,896,1021,4873388,14,,,,3814
adabfdd0789570aabc62a76f50f32e107118b4a1,0,Jan Schmidle,2017-12-26 14:05:39+01:00,['1c2286bc2c776fe14869111070131f1407d698fe'],0,62,62,4873450,6,0.325,0.325,1,3814
a6c4965900f54edf3b45cea67e19da125f90c547,0,Jungtaek Lim,2017-12-27 05:56:40+09:00,"['f998e267c9aa78609088b7d58e072f49e8befb3f', 'adabfdd0789570aabc62a76f50f32e107118b4a1']",0,62,62,4873512,6,,,,3814
df5187e803d38f2cbb35ac9f1853ed7f2410ad0e,1,Stig Rohde D酶ssing,2017-12-26 23:17:13+01:00,['f998e267c9aa78609088b7d58e072f49e8befb3f'],453,86,539,4874051,6,0.795918367,0,0,3814
a894fe63a0814719634fab78783079bbcd121735,0,Jungtaek Lim,2017-12-27 16:21:27+09:00,['a6c4965900f54edf3b45cea67e19da125f90c547'],3,30,33,4874084,1,0.777777778,1,1,3814
41d6cdcc99133168d1ecf400381e3dd1cf48f28e,0,Jungtaek Lim,2017-12-29 11:13:08+09:00,"['a894fe63a0814719634fab78783079bbcd121735', 'df5187e803d38f2cbb35ac9f1853ed7f2410ad0e']",453,86,539,4874623,6,,,,3814
af6b7f30241db17584184c359ac24dbd555f8c59,0,Stig Rohde D酶ssing,2017-12-29 19:19:54+01:00,['a894fe63a0814719634fab78783079bbcd121735'],10,10,20,4874643,2,,,,3814
05c810af4042c8e5d36824f029f56251f4c0d4d6,0,Govind Menon,2018-01-02 13:44:49-06:00,['41d6cdcc99133168d1ecf400381e3dd1cf48f28e'],4,4,8,4874651,1,,,,3814
4fd02caabe2415481c4a0c52d51638a022730f73,1,Govind Menon,2018-01-02 14:58:32-06:00,['41d6cdcc99133168d1ecf400381e3dd1cf48f28e'],45,78,123,4874774,5,0.863636364,1,1,3814
2846417c8a2b2d990146063bc30aef5acbb6933c,0,Robert Evans,2018-01-02 15:19:07-06:00,"['41d6cdcc99133168d1ecf400381e3dd1cf48f28e', '4fd02caabe2415481c4a0c52d51638a022730f73']",45,78,123,4874897,5,,,,3814
d644e29a8808dd6cc619230f884d9be43a1e7509,0,Robert Evans,2018-01-02 15:43:35-06:00,"['2846417c8a2b2d990146063bc30aef5acbb6933c', 'af6b7f30241db17584184c359ac24dbd555f8c59']",10,10,20,4874917,2,,,,3814
c09013a1afde86d61350a854d2ab2684b9c6517e,0,Govind Menon,2018-01-02 16:24:54-06:00,['4fd02caabe2415481c4a0c52d51638a022730f73'],5,18,23,4874940,1,0,1,1,3814
9655d0dc8c4f01e17edc3ff823cf7446dbc9930e,0,chenyuzhao,2018-01-03 15:31:38+08:00,['d644e29a8808dd6cc619230f884d9be43a1e7509'],1,12,13,4874953,1,0,0,0,3814
9b2b2dbd087aea6f5081442338c90e24f9799e4f,1,Manikumar Reddy,2018-01-03 18:19:59+05:18,['d644e29a8808dd6cc619230f884d9be43a1e7509'],3,245,248,4875201,7,0.365853659,0.569105691,0.975609756,3815
8e256a532bc76435c3a292db814df57579200cd0,0,Manikumar Reddy O,2018-01-03 22:41:29+05:18,['d644e29a8808dd6cc619230f884d9be43a1e7509'],63,300,363,4875564,17,0.762376238,1,0.920792079,3816
69e596ac60ac152c854c238e98783c57e432d86c,0,Stig Rohde D酶ssing,2018-01-03 19:02:11+01:00,"['d644e29a8808dd6cc619230f884d9be43a1e7509', '9b2b2dbd087aea6f5081442338c90e24f9799e4f']",3,245,248,4875812,7,,,,3816
19878bdb05e5eca4bf47012039243bbf9d14ec81,1,Robert (Bobby) Evans,2018-01-03 16:16:43-06:00,['d644e29a8808dd6cc619230f884d9be43a1e7509'],2,28,30,4875842,6,,,,3816
73e5f6746cab33b5dcb616b8bad3c0bb00d796f4,0,Robert Evans,2018-01-03 16:24:54-06:00,"['69e596ac60ac152c854c238e98783c57e432d86c', 'c09013a1afde86d61350a854d2ab2684b9c6517e']",5,18,23,4875865,1,,,,3816
873028b583e2f8c25d1e9e67f49994d26b457556,0,Jungtaek Lim,2018-01-04 12:42:10+09:00,"['73e5f6746cab33b5dcb616b8bad3c0bb00d796f4', '05c810af4042c8e5d36824f029f56251f4c0d4d6']",4,4,8,4875873,1,,,,3816
8aae491b6b1e2be2a085f61d45d5d915203eb0ee,0,Stig Rohde D酶ssing,2018-01-04 16:36:21+01:00,['873028b583e2f8c25d1e9e67f49994d26b457556'],88,180,268,4876141,7,0.095890411,0.082191781,0.931506849,3816
a18657d0cd01601dfd193dccade1f601fbef94b4,0,Robert Evans,2018-01-04 12:52:33-06:00,"['873028b583e2f8c25d1e9e67f49994d26b457556', '9655d0dc8c4f01e17edc3ff823cf7446dbc9930e']",1,12,13,4876154,1,,,,3816
c72fa8960adb01065eb2ac01a8c5d5e6187d2ee5,0,GitHub,2018-01-04 16:22:20-08:00,['a18657d0cd01601dfd193dccade1f601fbef94b4'],2,2,4,4876158,1,,,,3816
64615c9ac45a3906e48b1c44f2393f8bedbb2c72,0,Robert Evans,2018-01-05 09:06:09-06:00,"['a18657d0cd01601dfd193dccade1f601fbef94b4', '19878bdb05e5eca4bf47012039243bbf9d14ec81']",2,28,30,4876188,6,,,,3816
7ecb3d73e8e909c01d39e03a7a7ed45a2fb81859,0,Robert Evans,2018-01-05 12:23:49-06:00,"['64615c9ac45a3906e48b1c44f2393f8bedbb2c72', 'c72fa8960adb01065eb2ac01a8c5d5e6187d2ee5']",2,2,4,4876192,1,,,,3816
41db23fe86299f71b6ecc7deaa70ab731899c83f,1,Stig Rohde D酶ssing,2018-01-07 18:27:04+01:00,['8aae491b6b1e2be2a085f61d45d5d915203eb0ee'],297,892,1189,4877381,25,0.961165049,0.96763754,0.640776699,3821
88533346dbfb318d8bf623703f6a16a1eab19534,0,Stig Rohde D酶ssing,2018-01-07 18:43:11+01:00,['41db23fe86299f71b6ecc7deaa70ab731899c83f'],25,32,57,4877438,22,,,,3821
8f70777bee43d8add02d659d689076c15540976c,1,Robert (Bobby) Evans,2018-01-08 13:21:44-06:00,['7ecb3d73e8e909c01d39e03a7a7ed45a2fb81859'],30,28,58,4877496,2,0,1,1,3821
e8dd1f7e2df5e034a20573b89cb89e9f3529e373,0,Robert Evans,2018-01-08 15:02:55-06:00,"['7ecb3d73e8e909c01d39e03a7a7ed45a2fb81859', '88533346dbfb318d8bf623703f6a16a1eab19534']",521,1215,1736,4879232,31,,,,3821
9c9aee763c51d999fae50e09620180a51357cae7,0,GitHub,2018-01-09 23:42:35+05:18,['e8dd1f7e2df5e034a20573b89cb89e9f3529e373'],2,2,4,4879236,1,,,,3821
466a7ad74da27c1250eedf412a487db409e42c19,0,Robert Evans,2018-01-09 12:51:23-06:00,"['e8dd1f7e2df5e034a20573b89cb89e9f3529e373', '9c9aee763c51d999fae50e09620180a51357cae7']",2,2,4,4879240,1,,,,3821
9924c1478da2ef71f7624ae1e271ef067758372e,0,Stig Rohde D酶ssing,2018-01-09 21:58:57+01:00,['7ecb3d73e8e909c01d39e03a7a7ed45a2fb81859'],1,1,2,4879242,1,,,,3821
b070bd1077398910ee3f818980d1d1705969485c,0,Erik Weathers,2018-01-09 22:10:44-08:00,['466a7ad74da27c1250eedf412a487db409e42c19'],3,3,6,4879248,1,,,,3821
08d7d8db51df3b2620461f7167cae787c9cf96dc,0,Erik Weathers,2018-01-09 23:20:02-08:00,['466a7ad74da27c1250eedf412a487db409e42c19'],0,1,1,4879249,1,,,,3821
7b849e20704fe6d51c01fd543fdf78f1989e04b4,0,Erik Weathers,2018-01-10 00:08:24-08:00,['466a7ad74da27c1250eedf412a487db409e42c19'],0,0,0,4879249,1,,,,3821
515b6492d2bc185f4454975d12edf6fe7fe14d22,0,Erik Weathers,2018-01-10 00:09:00-08:00,['7b849e20704fe6d51c01fd543fdf78f1989e04b4'],3,3,6,4879255,2,,,,3821
b25d297ade58a996d54e1d0f0e9f12e1a3943f24,0,Robert Evans,2018-01-10 11:55:06-06:00,"['466a7ad74da27c1250eedf412a487db409e42c19', '9924c1478da2ef71f7624ae1e271ef067758372e']",1,1,2,4879257,1,,,,3821
6d43128de81b440262ce701f6e7ba14e95f39ab9,0,Robert Evans,2018-01-10 12:03:16-06:00,"['b25d297ade58a996d54e1d0f0e9f12e1a3943f24', '8f70777bee43d8add02d659d689076c15540976c']",30,28,58,4879315,2,,,,3821
c36f9efad43677c8e82fbac306bbd6575ba46443,0,鍒樿搐濞?0221805,2018-01-12 10:04:53+08:00,['6d43128de81b440262ce701f6e7ba14e95f39ab9'],5,2,7,4879322,1,,,,3821
bdcfb5fe23efed0bb594748b1ff91ea3b35fbcda,0,Stig Rohde D酶ssing,2018-01-12 20:39:16+01:00,"['6d43128de81b440262ce701f6e7ba14e95f39ab9', '08d7d8db51df3b2620461f7167cae787c9cf96dc']",0,1,1,4879323,1,,,,3821
b612c09d0deba7a6c0f68ab4fcd2e8af22b192a2,0,Stig Rohde D酶ssing,2018-01-12 20:44:39+01:00,"['bdcfb5fe23efed0bb594748b1ff91ea3b35fbcda', 'b070bd1077398910ee3f818980d1d1705969485c']",3,3,6,4879329,1,,,,3821
a49c6d7b12e853ea41c881b4618b7919ff4a1051,0,Stig Rohde D酶ssing,2018-01-12 22:01:07+01:00,['b612c09d0deba7a6c0f68ab4fcd2e8af22b192a2'],177,0,177,4879506,1,,,,3821
01ea3d644c2bc6eabdfc7eca74fbd9c1b96d6443,1,Srishty Agrawal,2018-01-12 14:29:16-08:00,['b612c09d0deba7a6c0f68ab4fcd2e8af22b192a2'],97,109,206,4879712,5,,,,3821
975174bee0c757f5c1a465ffea4abf0c3b0b1dca,0,Jungtaek Lim,2018-01-13 14:17:55+09:00,"['b612c09d0deba7a6c0f68ab4fcd2e8af22b192a2', '01ea3d644c2bc6eabdfc7eca74fbd9c1b96d6443']",97,109,206,4879918,5,,,,3821
577b8c924106d6eae0641114a4ad11eb51700ffd,0,Jungtaek Lim,2018-01-13 14:20:26+09:00,"['975174bee0c757f5c1a465ffea4abf0c3b0b1dca', 'a49c6d7b12e853ea41c881b4618b7919ff4a1051']",177,0,177,4880095,1,,,,3821
4b28a60a3748b3346ff18f0fca28a20ec8f40463,0,Jungtaek Lim,2018-01-13 14:22:28+09:00,"['577b8c924106d6eae0641114a4ad11eb51700ffd', '8e256a532bc76435c3a292db814df57579200cd0']",63,300,363,4880458,17,,,,3821
ee0c36dd3ed5b00e8dbe725d62945bf9702728ad,0,Stig Rohde D酶ssing,2018-01-15 20:30:13+01:00,"['4b28a60a3748b3346ff18f0fca28a20ec8f40463', '515b6492d2bc185f4454975d12edf6fe7fe14d22']",3,3,6,4880464,2,,,,3821
cce4a5b4d9dc9715ceb632adfa93540e81d22134,0,Satish Duggana,2018-01-18 09:01:38+05:18,['ee0c36dd3ed5b00e8dbe725d62945bf9702728ad'],1,3,4,4880468,1,1,1,1,3821
3ce7ada65fe38beb6ecc6c5cffd773a2aaeaa3c8,0,Arun Mahadevan,2018-01-18 13:08:12-08:00,"['ee0c36dd3ed5b00e8dbe725d62945bf9702728ad', 'cce4a5b4d9dc9715ceb632adfa93540e81d22134']",1,3,4,4880472,1,,,,3821
a0437f73edd4df320f60e11929cb40aef5ea35ad,0,Manikumar Reddy,2018-01-20 00:31:06+05:18,['3ce7ada65fe38beb6ecc6c5cffd773a2aaeaa3c8'],5,9,14,4880486,2,0,0,1,3821
163ea7186498c426260fcf1851e12d367ed74d37,0,Jungtaek Lim,2018-01-22 07:49:53+09:00,"['3ce7ada65fe38beb6ecc6c5cffd773a2aaeaa3c8', 'a0437f73edd4df320f60e11929cb40aef5ea35ad']",5,9,14,4880500,2,,,,3821
507e7ed8208f1bc8fd8be4210ce3e9adacb82931,0,Jungtaek Lim,2018-01-22 08:44:39+09:00,"['163ea7186498c426260fcf1851e12d367ed74d37', 'c36f9efad43677c8e82fbac306bbd6575ba46443']",5,2,7,4880507,1,,,,3821
20044b0e004f9ea9f309228c747aa7aa10647396,0,Heather McCartney,2018-01-22 08:47:59+00:00,['507e7ed8208f1bc8fd8be4210ce3e9adacb82931'],59,412,471,4880978,8,1,1,0.870967742,3825
05771bafaf6a11631867c457b8af53c8b9955734,0,Jungtaek Lim,2018-01-22 18:26:58+09:00,"['507e7ed8208f1bc8fd8be4210ce3e9adacb82931', '20044b0e004f9ea9f309228c747aa7aa10647396']",59,412,471,4881449,8,,,,3825
841586151e241beb87a42d55f5a7a500428b0c99,0,Manikumar Reddy,2018-01-22 15:47:46+05:18,['05771bafaf6a11631867c457b8af53c8b9955734'],0,6,6,4881455,1,0,0,1,3825
348faf946864b86b1833ff1115d1c5706f638269,1,chenyuzhao,2018-01-22 19:14:31+08:00,['ee0c36dd3ed5b00e8dbe725d62945bf9702728ad'],61,85,146,4881601,10,1,1,1,3825
879cb5b8f2d9f869d2f90b0968fba1e08b04cd07,0,Jungtaek Lim,2018-01-22 20:28:43+09:00,"['05771bafaf6a11631867c457b8af53c8b9955734', '348faf946864b86b1833ff1115d1c5706f638269']",61,85,146,4881747,10,,,,3825
326afbe6288046a89254a089e9384930ca76713c,1,chenyuzhao,2018-01-22 22:29:57+08:00,['879cb5b8f2d9f869d2f90b0968fba1e08b04cd07'],0,1,1,4881748,1,0,1,1,3825
48e23a99bf90c50f5d4864dbd449b0079ab2d5e2,1,Aaron Gresch,2018-01-22 09:25:57-06:00,['879cb5b8f2d9f869d2f90b0968fba1e08b04cd07'],750,7571,8321,4890069,58,0.453017571,0.666412019,0.903488668,3850
e6a423dd8cada12997e2a9448a9944050cf23a1f,0,Jungtaek Lim,2018-01-23 06:23:11+09:00,"['879cb5b8f2d9f869d2f90b0968fba1e08b04cd07', '48e23a99bf90c50f5d4864dbd449b0079ab2d5e2']",750,7571,8321,4898390,58,,,,3850
d291f39c9aa6e29184a2712797e956b42cae3293,1,Jungtaek Lim,2018-01-23 13:34:22+09:00,['e6a423dd8cada12997e2a9448a9944050cf23a1f'],3,18,21,4898411,1,0,1,0,3850
fc4ac8e2a950a7f5e3447a29e395d325486a4698,0,Jungtaek Lim,2018-01-24 14:30:31+09:00,"['e6a423dd8cada12997e2a9448a9944050cf23a1f', '326afbe6288046a89254a089e9384930ca76713c']",0,1,1,4898412,1,,,,3850
609a4a78f2a762f784648a6a57af060abd089d7c,0,Jungtaek Lim,2018-01-24 14:40:15+09:00,['d291f39c9aa6e29184a2712797e956b42cae3293'],4,9,13,4898425,1,0,0,0,3850
ed0548e8b61a8ea67007d906953406a264b15c99,0,Robert (Bobby) Evans,2018-01-24 14:48:12-06:00,['fc4ac8e2a950a7f5e3447a29e395d325486a4698'],1,12,13,4898438,1,0,0,1,3850
1b918e5764c67dfc6587c2fc64aae5d792f79a73,0,Jungtaek Lim,2018-01-25 16:39:24+09:00,['fc4ac8e2a950a7f5e3447a29e395d325486a4698'],5,9,14,4898452,1,0,0,1,3850
48c2fda867aa1d1123f6ba9c9f623ae80c9df280,0,Robert (Bobby) Evans,2018-01-25 09:49:20-06:00,['ed0548e8b61a8ea67007d906953406a264b15c99'],31,112,143,4898595,6,0.620689655,0.862068966,0.793103448,3851
278f01bf09ee6d0bbe71315a69118961405b19fe,0,P. Taylor Goetz,2018-01-26 13:24:27-05:00,"['fc4ac8e2a950a7f5e3447a29e395d325486a4698', '1b918e5764c67dfc6587c2fc64aae5d792f79a73']",5,9,14,4898609,1,,,,3851
f37a6bd99d10f65a43becadcd7f7615715e5dc0b,0,Jungtaek Lim,2018-01-28 06:12:44+09:00,"['fc4ac8e2a950a7f5e3447a29e395d325486a4698', '1b918e5764c67dfc6587c2fc64aae5d792f79a73']",5,9,14,4898623,1,,,,3851
f58d472994297d240af8a478d660c3be8a69bd97,1,Ethan Li,2018-01-30 15:05:38-06:00,['f37a6bd99d10f65a43becadcd7f7615715e5dc0b'],42,287,329,4898952,9,,,,3852
77be31bc4533cb9437242261ff89d1a750eef5c4,0,Robert (Bobby) Evans,2018-01-31 10:17:43-06:00,['48c2fda867aa1d1123f6ba9c9f623ae80c9df280'],2,7,9,4898961,1,1,1,1,3852
956ba1c16b46a92e00db0be4b026dc731ec6621f,0,Artem Ervits,2018-01-31 15:13:06-05:00,['f37a6bd99d10f65a43becadcd7f7615715e5dc0b'],1,1,2,4898963,1,,,,3852
a5540d79fa8b3b6f625308972fe922786680b833,0,Jungtaek Lim,2018-02-01 09:46:52+09:00,['f37a6bd99d10f65a43becadcd7f7615715e5dc0b'],1,2,3,4898966,3,0,0,1,3852
d3a74eec58a918fbc9414f59edc1189e40d38650,0,Jungtaek Lim,2018-02-01 23:04:32+09:00,"['f37a6bd99d10f65a43becadcd7f7615715e5dc0b', '841586151e241beb87a42d55f5a7a500428b0c99']",0,6,6,4898972,1,,,,3852
1c7361982873fc8a84ed2b217b39ff634b35375b,0,Jungtaek Lim,2018-02-01 23:15:55+09:00,"['d3a74eec58a918fbc9414f59edc1189e40d38650', '609a4a78f2a762f784648a6a57af060abd089d7c']",3,23,26,4898998,1,,,,3852
18045a3fca0c2cc2f5f7cc0241233c25b17432fe,0,Jungtaek Lim,2018-02-02 00:09:02+09:00,['1c7361982873fc8a84ed2b217b39ff634b35375b'],1,3,4,4899002,1,,,,3852
d68416b2447756e2fdf31ef63cbd3428eb299899,0,Jungtaek Lim,2018-02-02 00:24:05+09:00,"['18045a3fca0c2cc2f5f7cc0241233c25b17432fe', 'f58d472994297d240af8a478d660c3be8a69bd97']",42,287,329,4899331,9,,,,3852
abf0f8a22b665117c88e2b2dccdc588d72f12403,0,Robert Evans,2018-02-01 12:44:06-06:00,"['d68416b2447756e2fdf31ef63cbd3428eb299899', '77be31bc4533cb9437242261ff89d1a750eef5c4']",32,129,161,4899492,7,,,,3852
5d2cf6f9d45188caf676eb4dc178d0161d369f91,0,Jungtaek Lim,2018-02-02 13:17:03+09:00,"['abf0f8a22b665117c88e2b2dccdc588d72f12403', 'a5540d79fa8b3b6f625308972fe922786680b833']",1,2,3,4899495,3,,,,3852
7fbe7a278f99e30ac856a21cfe9e6e5a2c16c8b1,0,Jungtaek Lim,2018-02-02 13:27:03+09:00,"['5d2cf6f9d45188caf676eb4dc178d0161d369f91', '956ba1c16b46a92e00db0be4b026dc731ec6621f']",1,1,2,4899497,1,,,,3852
2bd8a1a1dc1aff169ab61ce98f1893d4911d2795,0,Ethan Li,2018-02-02 11:34:32-06:00,['7fbe7a278f99e30ac856a21cfe9e6e5a2c16c8b1'],8,8,16,4899513,4,,,,3852
71496cb67ee354d1ee7303094891dd503dca97c6,0,Stig Rohde D酶ssing,2018-02-03 18:18:27+01:00,['7fbe7a278f99e30ac856a21cfe9e6e5a2c16c8b1'],15,161,176,4899689,5,0.375,0.95,1,3854
eff32a32bb724c37f4eaca6a363665c55b17813c,1,Stig Rohde D酶ssing,2018-02-04 19:41:46+01:00,['7fbe7a278f99e30ac856a21cfe9e6e5a2c16c8b1'],125,160,285,4899974,5,0.133333333,0.866666667,1,3854
e756889aa712aee22c216bc99ee17b972abf886d,1,Stig Rohde D酶ssing,2018-02-04 23:18:54+01:00,['eff32a32bb724c37f4eaca6a363665c55b17813c'],74,146,220,4900194,4,0,0.75,0.208333333,3855
ffa5f05df151e01c662fa8d74f797138650099d7,0,Jungtaek Lim,2018-02-05 10:56:56+09:00,"['7fbe7a278f99e30ac856a21cfe9e6e5a2c16c8b1', 'eff32a32bb724c37f4eaca6a363665c55b17813c']",125,160,285,4900479,5,,,,3855
b5d70e17d798f91417b74863772f0826b4a84625,0,Jungtaek Lim,2018-02-05 10:57:33+09:00,"['ffa5f05df151e01c662fa8d74f797138650099d7', 'e756889aa712aee22c216bc99ee17b972abf886d']",74,146,220,4900699,4,,,,3855
49ab628a952a58c236ad31d93a939ab75794e131,1,Aaron Gresch,2018-02-05 14:56:13-06:00,['abf0f8a22b665117c88e2b2dccdc588d72f12403'],63,127,190,4900889,6,0.595238095,0,0.904761905,3855
12cc49fcb99c81cda59281b8f607882f6a4ab537,0,Jungtaek Lim,2018-02-06 16:27:07+09:00,"['b5d70e17d798f91417b74863772f0826b4a84625', '71496cb67ee354d1ee7303094891dd503dca97c6']",15,161,176,4901065,5,,,,3855
ab609514c5f0581f39d6a5d78213ef38981436d4,0,Aaron Gresch,2018-02-06 16:08:48-06:00,['49ab628a952a58c236ad31d93a939ab75794e131'],21,51,72,4901137,5,0.333333333,0.333333333,0,3856
30d81a5d508a521ce6f850163d57d13228689f7c,0,Aaron Gresch,2018-02-07 08:15:23-06:00,['12cc49fcb99c81cda59281b8f607882f6a4ab537'],1,3,4,4901141,1,,,,3856
b5aca6ce0ef64df81868cbb60ac436f18e347a37,0,Aaron Gresch,2018-02-07 08:39:49-06:00,['ab609514c5f0581f39d6a5d78213ef38981436d4'],8,2,10,4901151,1,0,0,0,3856
f991dae41641eeb9101ec832dd2fd29b5ed3e059,0,P. Taylor Goetz,2018-02-07 14:02:54-05:00,"['278f01bf09ee6d0bbe71315a69118961405b19fe', '12cc49fcb99c81cda59281b8f607882f6a4ab537']",284,908,1192,4902343,33,,,,3856
c02f4a0db35aaec47b0f049e3b5195857a915f1e,0,Robert Evans,2018-02-07 14:08:21-06:00,"['12cc49fcb99c81cda59281b8f607882f6a4ab537', '30d81a5d508a521ce6f850163d57d13228689f7c']",1,3,4,4902347,1,,,,3856
d6d1d48a2f36ceb65be9a598b141baad18760489,1,Robert (Bobby) Evans,2018-02-07 14:37:42-06:00,['c02f4a0db35aaec47b0f049e3b5195857a915f1e'],2,6,8,4902355,1,0,0,1,3856
5f0573983a118743e5c2eb4bb82861dd708f9014,0,Robert Evans,2018-02-07 14:39:45-06:00,"['c02f4a0db35aaec47b0f049e3b5195857a915f1e', 'b5aca6ce0ef64df81868cbb60ac436f18e347a37']",63,151,214,4902569,7,,,,3856
9566a8823a61b753cb176f7394b7a37b825281c3,1,Robert (Bobby) Evans,2018-02-08 10:22:39-06:00,['5f0573983a118743e5c2eb4bb82861dd708f9014'],1184,5020,6204,4908773,69,0.428350715,0.633449208,0.906527617,3871
318b49e6c4b59dfaf962ae9817c7bd41cf6b5d92,0,Aaron Gresch,2018-02-08 14:25:40-06:00,['b5aca6ce0ef64df81868cbb60ac436f18e347a37'],2,4,6,4908779,1,,,,3871
ec537fdf54c4139fc4779edbf77eb55067a09b43,0,Robert Evans,2018-02-08 14:58:22-06:00,"['5f0573983a118743e5c2eb4bb82861dd708f9014', 'd6d1d48a2f36ceb65be9a598b141baad18760489']",2,6,8,4908787,1,,,,3871
1eb355ef7825740686e2294238c51f3495cbeb88,1,Aaron Gresch,2018-02-08 16:09:19-06:00,['5f0573983a118743e5c2eb4bb82861dd708f9014'],17,144,161,4908948,10,0.666666667,0.740740741,0.888888889,3873
a715e9a5c20299a54a985baa7916031a80c3a09a,0,Robert Evans,2018-02-08 20:20:08-06:00,"['ec537fdf54c4139fc4779edbf77eb55067a09b43', '9566a8823a61b753cb176f7394b7a37b825281c3']",1184,5020,6204,4915152,69,,,,3873
b332503b113fa6cde6afa320c9c190e3aad5b4c3,0,Jungtaek Lim,2018-02-10 09:11:37+09:00,['a715e9a5c20299a54a985baa7916031a80c3a09a'],22,46,68,4915220,2,0.882352941,0.882352941,0.941176471,3873
0b320323936018e34c7469af98c76bea50d7dc54,0,Jungtaek Lim,2018-02-10 09:12:18+09:00,"['a715e9a5c20299a54a985baa7916031a80c3a09a', 'b332503b113fa6cde6afa320c9c190e3aad5b4c3']",22,46,68,4915288,2,,,,3873
2977d98b5cc43dd46fce33c537ea7ac4db36a3b2,0,Jungtaek Lim,2018-02-12 17:55:48+09:00,['0b320323936018e34c7469af98c76bea50d7dc54'],10,23,33,4915321,1,1,1,1,3873
09d95f7ebf6b8d8927225031152aa850593189ed,0,Robert Evans,2018-02-12 10:32:20-06:00,"['0b320323936018e34c7469af98c76bea50d7dc54', '318b49e6c4b59dfaf962ae9817c7bd41cf6b5d92']",2,4,6,4915327,1,,,,3873
23d704a6d9d2af0e2fa35624463b90aa055347e3,0,Aaron Gresch,2018-02-12 16:27:37-06:00,['1eb355ef7825740686e2294238c51f3495cbeb88'],11,11,22,4915349,3,,,,3873
c8fab2065222daf7297a8e65fc1b486dd23d7022,0,Jungtaek Lim,2018-02-13 17:48:25+09:00,"['09d95f7ebf6b8d8927225031152aa850593189ed', '2977d98b5cc43dd46fce33c537ea7ac4db36a3b2']",10,23,33,4915382,1,,,,3873
5c3a911c0aed922421f4fab387dfad550ec90b31,0,P. Taylor Goetz,2018-02-13 12:13:02-05:00,"['f991dae41641eeb9101ec832dd2fd29b5ed3e059', 'c8fab2065222daf7297a8e65fc1b486dd23d7022']",1284,5253,6537,4921919,80,,,,3873
a323987bb7325eb9756ea6371b72dbe1ce409cc0,0,Robert Evans,2018-02-13 14:10:58-06:00,"['c8fab2065222daf7297a8e65fc1b486dd23d7022', '23d704a6d9d2af0e2fa35624463b90aa055347e3']",21,148,169,4922088,10,,,,3873
ab7b4ca7731fcab279d67a7837e195f40ebb378a,0,Jungtaek Lim,2018-02-14 12:24:47+09:00,"['a323987bb7325eb9756ea6371b72dbe1ce409cc0', '2bd8a1a1dc1aff169ab61ce98f1893d4911d2795']",8,8,16,4922104,4,,,,3873
bc4c480705fa543913b66befccabe8fa3bbe35f0,1,Roshan Naik,2018-02-14 03:43:10-08:00,['ab7b4ca7731fcab279d67a7837e195f40ebb378a'],2882,5207,8089,4930193,162,0.651829871,0.963402572,0.829871414,3889
09e01231cc427004bab475c9c70f21fa79cfedef,0,Robert Evans,2018-02-14 07:48:31-06:00,"['ab7b4ca7731fcab279d67a7837e195f40ebb378a', 'bc4c480705fa543913b66befccabe8fa3bbe35f0']",2882,5207,8089,4938282,162,,,,3889
5cc95a267a474cfbad526e00a160d59846cb93dc,0,Ethan Li,2018-02-14 08:48:29-06:00,['09e01231cc427004bab475c9c70f21fa79cfedef'],1,1,2,4938284,1,,,,3889
5e68cd91133d193be8dc10f6bf492765a9a99633,0,Ethan Li,2018-02-14 17:32:45-06:00,['09e01231cc427004bab475c9c70f21fa79cfedef'],1,1,2,4938286,1,,,,3889
0267d549a96c1e7aefa3cb5d23e1cca559dd8e74,0,Kishor Patil,2018-02-16 19:23:17-05:00,['09e01231cc427004bab475c9c70f21fa79cfedef'],105,84,189,4938475,7,0,0,0,3889
a20b2659c20b1a12dd455023010f4454d62ee313,1,Stig Rohde D酶ssing,2018-02-17 23:18:45+01:00,['09e01231cc427004bab475c9c70f21fa79cfedef'],630,807,1437,4939912,38,0,1,0.672897196,3893
d5581bbd6b45bee1ad2229cd914ca871c0266ec0,0,Jungtaek Lim,2018-02-18 08:54:45+09:00,"['09e01231cc427004bab475c9c70f21fa79cfedef', '5cc95a267a474cfbad526e00a160d59846cb93dc']",1,1,2,4939914,1,,,,3893
4721c361789214225ac0616a045b9d38ab7efe29,0,Jungtaek Lim,2018-02-18 09:02:33+09:00,"['d5581bbd6b45bee1ad2229cd914ca871c0266ec0', '5e68cd91133d193be8dc10f6bf492765a9a99633']",1,1,2,4939916,1,,,,3893
726e92c723dd92c92eea753de44f880a07288a97,0,Jungtaek Lim,2018-02-20 07:03:29+09:00,['4721c361789214225ac0616a045b9d38ab7efe29'],0,3,3,4939919,1,,,,3893
aab39da1d53339a06a33b6e3d42ac66ecab8d2e6,0,Kishor Patil,2018-02-19 17:42:14-05:00,['0267d549a96c1e7aefa3cb5d23e1cca559dd8e74'],1,1,2,4939921,1,,,,3893
51997889492ab9ebe68f495a232c239c33b31d9f,0,Roshan Naik,2018-02-19 16:18:31-08:00,['4721c361789214225ac0616a045b9d38ab7efe29'],157,92,249,4940170,11,0,0,0,3893
dc4011cd69436d1fa43033c085f79bc91af7ee22,0,Jungtaek Lim,2018-02-20 14:23:36+09:00,"['4721c361789214225ac0616a045b9d38ab7efe29', '51997889492ab9ebe68f495a232c239c33b31d9f']",157,92,249,4940419,11,,,,3893
c917c8a660fd5053c9431ebbc984eb996bf920cf,0,Arun Mahadevan,2018-02-20 11:36:03-08:00,['dc4011cd69436d1fa43033c085f79bc91af7ee22'],1,1,2,4940421,1,,,,3893
de1103530618eea54240a7c244b5855e1c7025eb,0,Arun Mahadevan,2018-02-20 12:23:20-08:00,['dc4011cd69436d1fa43033c085f79bc91af7ee22'],0,16,16,4940437,1,,,,3893
461ac628fdacc09e50325a9f5786000d67e89c5e,0,Jungtaek Lim,2018-02-21 13:41:08+09:00,"['dc4011cd69436d1fa43033c085f79bc91af7ee22', 'aab39da1d53339a06a33b6e3d42ac66ecab8d2e6']",104,83,187,4940624,7,,,,3893
4ace62f2def44e4a3afc918df90296b72df62820,0,Jungtaek Lim,2018-02-21 13:43:20+09:00,"['461ac628fdacc09e50325a9f5786000d67e89c5e', '726e92c723dd92c92eea753de44f880a07288a97']",0,3,3,4940627,1,,,,3893
6f40bd7cbc0419240bcec7b8525ef7b7bf57cf3a,0,Ethan Li,2018-02-21 15:31:32-06:00,['4ace62f2def44e4a3afc918df90296b72df62820'],3,5,8,4940635,1,,,,3893
d6d4ff1b2381289440c864347eac6cd9a36714a7,0,Jungtaek Lim,2018-02-24 20:10:13+09:00,"['4ace62f2def44e4a3afc918df90296b72df62820', '6f40bd7cbc0419240bcec7b8525ef7b7bf57cf3a']",3,5,8,4940643,1,,,,3893
1236115652e78fada1fc498259f954178fb8f5e7,0,Stig Rohde D酶ssing,2018-02-24 12:45:29+01:00,['d6d4ff1b2381289440c864347eac6cd9a36714a7'],0,646,646,4941289,8,0.181818182,1,0.632231405,3900
a38f0c5c5df970a09cc5b12c9da28d7a6b7e5463,0,Stig Rohde D酶ssing,2018-02-24 13:01:55+01:00,"['d6d4ff1b2381289440c864347eac6cd9a36714a7', '1236115652e78fada1fc498259f954178fb8f5e7']",0,646,646,4941935,8,,,,3900
f03e936fdfec92bdc3995635afaadec899b1700d,0,Stig Rohde D酶ssing,2018-02-25 00:15:50+01:00,['a38f0c5c5df970a09cc5b12c9da28d7a6b7e5463'],179,39,218,4942153,6,0.461538462,0,0.076923077,3900
408e53174d3fc0f82a542f38ab0d49ca7c8992e4,0,Gergely Hajos,2018-02-25 15:32:21+01:00,['a38f0c5c5df970a09cc5b12c9da28d7a6b7e5463'],0,1,1,4942154,1,,,,3900
afc0ae52312aee670c396885514f76a606cc3dfb,0,Jungtaek Lim,2018-02-26 11:35:28+09:00,['dc4011cd69436d1fa43033c085f79bc91af7ee22'],26,173,199,4942353,3,0.692307692,0.692307692,0.923076923,3901
51613c78ae6060c398cefdf20fd7967084f9a55f,0,Jungtaek Lim,2018-02-26 11:37:57+09:00,"['a38f0c5c5df970a09cc5b12c9da28d7a6b7e5463', 'afc0ae52312aee670c396885514f76a606cc3dfb']",26,173,199,4942552,3,,,,3901
6da0c6cfe4639ff42419d854ef6e52ed9594b4ab,0,Arun Mahadevan,2018-02-26 09:28:09-08:00,"['51613c78ae6060c398cefdf20fd7967084f9a55f', 'c917c8a660fd5053c9431ebbc984eb996bf920cf']",1,1,2,4942554,1,,,,3901
a15f78f9c7755a009338c348bf14b1f6b6892ef9,1,Kishor Patil,2018-02-26 14:14:49-05:00,['6da0c6cfe4639ff42419d854ef6e52ed9594b4ab'],3,15,18,4942572,3,0.375,0.375,1,3901
51fb1263ff953b785c48447499f166558475f6f1,0,Stig Rohde D酶ssing,2018-02-26 20:24:09+01:00,"['6da0c6cfe4639ff42419d854ef6e52ed9594b4ab', '408e53174d3fc0f82a542f38ab0d49ca7c8992e4']",0,1,1,4942573,1,,,,3901
21f4173f25b44eea8b985987afb20c476751a50a,0,Stig Rohde D酶ssing,2018-02-26 20:37:26+01:00,"['51fb1263ff953b785c48447499f166558475f6f1', 'f03e936fdfec92bdc3995635afaadec899b1700d']",179,39,218,4942791,6,,,,3901
bc346375cf3ece9fad4375b3240f1c5525f36c68,0,Ethan Li,2018-02-26 16:06:39-06:00,['21f4173f25b44eea8b985987afb20c476751a50a'],23,52,75,4942866,2,0,1,1,3901
d5ff2d46f5fd327a270896a9c56275f0bfc28555,0,Stig Rohde D酶ssing,2018-02-27 11:43:59+01:00,['21f4173f25b44eea8b985987afb20c476751a50a'],80,116,196,4943062,8,,,,3901
f18821c4b9fe59bcc552c51521a5bdba40c8a290,0,Stig Rohde D酶ssing,2018-02-27 15:13:11+01:00,['21f4173f25b44eea8b985987afb20c476751a50a'],12,2,14,4943076,1,,,,3901
2dd43d781d1ff569261347ca03e3b466072a3bf0,0,Stig Rohde D酶ssing,2018-02-27 15:32:10+01:00,['21f4173f25b44eea8b985987afb20c476751a50a'],1,1,2,4943078,1,,,,3901
8baf6411f87c4550ccc521ffad3a52267ff99055,0,Jungtaek Lim,2018-03-01 13:30:09+09:00,"['21f4173f25b44eea8b985987afb20c476751a50a', 'de1103530618eea54240a7c244b5855e1c7025eb']",0,16,16,4943094,1,,,,3901
5b1339ac3634449ecbb87a36de8c1bb2b9e0d695,0,Jungtaek Lim,2018-03-01 13:43:19+09:00,"['8baf6411f87c4550ccc521ffad3a52267ff99055', '2dd43d781d1ff569261347ca03e3b466072a3bf0']",1,1,2,4943096,1,,,,3901
3d9d1d1b2e5ad4709ff40b3299428f11068f37a7,0,Jungtaek Lim,2018-03-01 13:47:26+09:00,"['5b1339ac3634449ecbb87a36de8c1bb2b9e0d695', 'f18821c4b9fe59bcc552c51521a5bdba40c8a290']",12,2,14,4943110,1,,,,3901
665f2c4e6eab7c4223db50e522baff335d9235ef,0,Jungtaek Lim,2018-03-01 13:51:31+09:00,"['3d9d1d1b2e5ad4709ff40b3299428f11068f37a7', 'd5ff2d46f5fd327a270896a9c56275f0bfc28555']",80,116,196,4943306,8,,,,3901
93f9a1733c89329949f4164e581c173cc422f1d1,0,Jungtaek Lim,2018-03-01 14:50:26+09:00,"['665f2c4e6eab7c4223db50e522baff335d9235ef', 'a15f78f9c7755a009338c348bf14b1f6b6892ef9']",3,15,18,4943324,3,,,,3901
288d97cb5497f27b69b2fb126c2b0097cd02605a,0,Stig Rohde D酶ssing,2018-03-01 08:16:21+01:00,['a38f0c5c5df970a09cc5b12c9da28d7a6b7e5463'],181,200,381,4943705,10,0,0.944444444,0.666666667,3903
e8e1a4e8f5cf77dce00970a1cdcf6dfd03222194,0,Jungtaek Lim,2018-03-01 19:35:51+09:00,"['93f9a1733c89329949f4164e581c173cc422f1d1', 'a20b2659c20b1a12dd455023010f4454d62ee313']",630,807,1437,4945142,38,,,,3903
21832ad4098e9795d94403d25ceb5649099c5f9a,0,Stig Rohde D酶ssing,2018-03-02 12:45:37+01:00,"['e8e1a4e8f5cf77dce00970a1cdcf6dfd03222194', '288d97cb5497f27b69b2fb126c2b0097cd02605a']",181,200,381,4945523,10,,,,3903
840c6c969f0fda0292c4fe3c07a3126ab1072d18,0,Gergely Hajos,2018-03-02 15:42:50+01:00,['a38f0c5c5df970a09cc5b12c9da28d7a6b7e5463'],3,55,58,4945581,2,0.075,1,1,3903
8d8bed80ad2d3edc561214271aa26f1cd87292a5,0,Gergely Hajos,2018-03-03 12:50:55+01:00,['840c6c969f0fda0292c4fe3c07a3126ab1072d18'],21,48,69,4945650,2,1,1,1,3903
2189abfa1e15ce859969d93ad4656c5b84a345fd,1,Gergely Hajos,2018-03-04 17:47:30+01:00,['21832ad4098e9795d94403d25ceb5649099c5f9a'],117,9,126,4945776,4,0,0,0,3903
6aa941bdb01e1cf710916c2d53c6839165c82a26,0,Ethan Li,2018-03-05 17:51:16-06:00,['e8e1a4e8f5cf77dce00970a1cdcf6dfd03222194'],3,4,7,4945783,1,0,1,1,3903
6a5f4b256cfe956b9eeda5f3c45e2cfbd83cb723,0,Gergely Hajos,2018-03-06 18:29:49+01:00,['2189abfa1e15ce859969d93ad4656c5b84a345fd'],2,2,4,4945787,1,,,,3903
b99d80ce60132b5a731ff54cdd5601fbd8295b24,0,Gergely Hajos,2018-03-06 18:34:36+01:00,['8d8bed80ad2d3edc561214271aa26f1cd87292a5'],2,2,4,4945791,1,,,,3903
f9986fc091e0d95c3499bffb92496684378d80d9,0,Robert Evans,2018-03-06 14:58:56-06:00,"['21832ad4098e9795d94403d25ceb5649099c5f9a', '6a5f4b256cfe956b9eeda5f3c45e2cfbd83cb723']",115,7,122,4945913,4,,,,3903
ffa607e2464a361a8f2fa548cc8043f5a8818d04,0,Robert Evans,2018-03-07 08:27:17-06:00,"['f9986fc091e0d95c3499bffb92496684378d80d9', '6aa941bdb01e1cf710916c2d53c6839165c82a26']",3,4,7,4945920,1,,,,3903
3a6f2043b840bfe647a48c04c93f460ebcb2688a,0,Ethan Li,2018-03-07 09:03:44-06:00,['f9986fc091e0d95c3499bffb92496684378d80d9'],1,1,2,4945922,1,,,,3903
32f6b622259266afad6c7bb63cf0f5ca53a07fce,0,鍒樺厗鍧?0206665,2018-03-19 16:18:12+08:00,['ffa607e2464a361a8f2fa548cc8043f5a8818d04'],2,22,24,4945946,1,,,,3903
e4c1b6117e77365741231825f806c419dc45d3a4,0,鍒樺厗鍧?0206665,2018-03-19 16:46:56+08:00,['ffa607e2464a361a8f2fa548cc8043f5a8818d04'],2,2,4,4945950,2,,,,3903
c7394d12ba9c705d8004396ab67cb3ae47d4aeee,0,Karl-Philipp Richter,2018-03-19 18:13:53+01:00,['ffa607e2464a361a8f2fa548cc8043f5a8818d04'],344,388,732,4946682,146,1,0.578947368,0.263157895,3903
1582024efc88a2d0b7da189774c380c01ac59683,0,Karl-Philipp Richter,2018-03-19 21:25:35+01:00,['c7394d12ba9c705d8004396ab67cb3ae47d4aeee'],32,9,41,4946723,27,,,,3903
11ed99cf37adf9ae59aa11338656991d14ea8355,0,Stig Rohde D酶ssing,2018-03-20 20:06:38+01:00,"['ffa607e2464a361a8f2fa548cc8043f5a8818d04', 'e4c1b6117e77365741231825f806c419dc45d3a4']",2,2,4,4946727,2,,,,3903
de6624569affd53f44ff3891d8678b00b074a4fe,0,Ethan Li,2018-03-20 14:21:59-05:00,['21832ad4098e9795d94403d25ceb5649099c5f9a'],72,58,130,4946857,3,1,0.2,0,3903
80f59a9fd6f4c00469d58f9410a01d77339e286d,0,Stig Rohde D酶ssing,2018-03-20 20:38:59+01:00,"['11ed99cf37adf9ae59aa11338656991d14ea8355', 'de6624569affd53f44ff3891d8678b00b074a4fe']",72,58,130,4946987,3,,,,3903
8c8c0c31c70f3e73b85083d84f5ab9475c6f1e2b,0,Stig Rohde D酶ssing,2018-03-20 20:55:14+01:00,"['80f59a9fd6f4c00469d58f9410a01d77339e286d', '3a6f2043b840bfe647a48c04c93f460ebcb2688a']",1,1,2,4946989,1,,,,3903
0fdad2c0ff357c431454128dd937edf2876a5fb5,0,Derek Dagit,2018-03-21 11:05:32-05:00,"['8c8c0c31c70f3e73b85083d84f5ab9475c6f1e2b', '1582024efc88a2d0b7da189774c380c01ac59683']",376,397,773,4947762,170,,,,3903
e9c427cbe4b32f6103e704c48bc1dbcb936b98cb,0,Karl-Philipp Richter,2018-03-23 06:00:07+01:00,['0fdad2c0ff357c431454128dd937edf2876a5fb5'],3127,3136,6263,4954025,48,,,,3903
adf4efb715b33abe7107175dc893a9036232a166,0,Stig Rohde D酶ssing,2018-03-23 18:08:23+01:00,"['0fdad2c0ff357c431454128dd937edf2876a5fb5', 'e9c427cbe4b32f6103e704c48bc1dbcb936b98cb']",3127,3136,6263,4960288,48,,,,3903
97c1d10caf8461982fcbe73e236a6a37e7941d84,0,Lukasz Gebel,2018-03-25 12:25:22+02:00,['adf4efb715b33abe7107175dc893a9036232a166'],3,1,4,4960292,1,,,,3903
dd780d1b94ba4a3ae5cc4588905047fa76883330,0,Stig Rohde D酶ssing,2018-03-25 20:10:29+02:00,['adf4efb715b33abe7107175dc893a9036232a166'],13,13,26,4960318,2,,,,3903
7814f01f0697743c8168205aa2c800705844b4d4,0,Ethan Li,2018-03-27 10:41:45-05:00,['adf4efb715b33abe7107175dc893a9036232a166'],2,4,6,4960324,1,0,1,1,3903
15a5757a6109f0840861a5004763b8611864b26c,0,Julien Nioche,2018-03-28 08:54:42+01:00,['1811273f18e79430167af709c23dbb9c9e2f7f7d'],1,5,6,4960330,1,,,,3903
0dac58b0aa82133df242b3b2ebeb65bfea7d63cc,1,chenyuzhao,2018-03-28 23:22:03+08:00,['adf4efb715b33abe7107175dc893a9036232a166'],1949,14135,16084,4976414,76,0.620440829,0.828391498,0.943190764,3923
85d7b73fc2c45dbf187c1f57256d796b64cf32ca,0,Arun Mahadevan,2018-03-28 08:53:59-07:00,['adf4efb715b33abe7107175dc893a9036232a166'],8,10,18,4976432,1,1,1,1,3923
eb7260385366ae0a130381d367f2ad0145d39b29,0,Karl-Philipp Richter,2018-03-28 21:55:35+02:00,['adf4efb715b33abe7107175dc893a9036232a166'],63,350,413,4976845,8,0,0.971428571,0.6,3926
a344a29b9ce4bd71259452e7a9cb5b3284335ae2,0,Karl-Philipp Richter,2018-03-28 21:56:33+02:00,['ffa607e2464a361a8f2fa548cc8043f5a8818d04'],26,111,137,4976982,4,0,1,1,3927
283f315f02b0903f2589905250844a1aa47cec55,0,Stig Rohde D酶ssing,2018-03-28 22:04:45+02:00,"['adf4efb715b33abe7107175dc893a9036232a166', 'eb7260385366ae0a130381d367f2ad0145d39b29']",63,350,413,4977395,8,,,,3927
e6a3ac655db254d2e40a85eaeb932ea65cb6756d,0,Robert Evans,2018-03-28 16:01:10-05:00,"['283f315f02b0903f2589905250844a1aa47cec55', '0dac58b0aa82133df242b3b2ebeb65bfea7d63cc']",1949,14135,16084,4993479,76,,,,3927
6bd5760adb2b7e95dc2c8039d7b835b4b7592290,1,Jungtaek Lim,2018-03-29 23:05:04+09:00,['e6a3ac655db254d2e40a85eaeb932ea65cb6756d'],1,2,3,4993482,1,0,1,1,3927
df9a619b0812616830b10a4e01bb87100fa7133e,0,Stig Rohde D酶ssing,2018-03-29 22:26:12+02:00,['283f315f02b0903f2589905250844a1aa47cec55'],6,0,6,4993488,1,,,,3927
6a5b32ea8cd06b3b5a6c863fcd04cb115aa53bc7,0,Robert Evans,2018-03-30 08:59:44-05:00,"['e6a3ac655db254d2e40a85eaeb932ea65cb6756d', '6bd5760adb2b7e95dc2c8039d7b835b4b7592290']",1,2,3,4993491,1,,,,3927
d72d5ae12271afc8540756cbb725a7d27754c811,0,Robert Evans,2018-03-30 09:21:10-05:00,"['6a5b32ea8cd06b3b5a6c863fcd04cb115aa53bc7', '15a5757a6109f0840861a5004763b8611864b26c']",1,5,6,4993497,1,,,,3927
d42bd2b315e23bf79a2429bef67d7d7dedc275bb,0,Robert Evans,2018-03-30 09:26:16-05:00,"['d72d5ae12271afc8540756cbb725a7d27754c811', '85d7b73fc2c45dbf187c1f57256d796b64cf32ca']",8,10,18,4993515,1,,,,3927
4bca4ad8d02ab05aab729d56b6393261a59c0601,0,Robert Evans,2018-03-30 10:11:05-05:00,"['d42bd2b315e23bf79a2429bef67d7d7dedc275bb', '7814f01f0697743c8168205aa2c800705844b4d4']",2,4,6,4993521,1,,,,3927
f8dc5a6ee4e781e207160dfca12efcbcc6734d57,0,Robert Evans,2018-03-30 10:43:12-05:00,"['4bca4ad8d02ab05aab729d56b6393261a59c0601', 'dd780d1b94ba4a3ae5cc4588905047fa76883330']",13,13,26,4993547,2,,,,3927
2155b43fd0e6b8f0fe441c34a0bac6518e3ab159,0,Robert Evans,2018-03-30 11:09:33-05:00,"['f8dc5a6ee4e781e207160dfca12efcbcc6734d57', '97c1d10caf8461982fcbe73e236a6a37e7941d84']",3,1,4,4993551,1,,,,3927
dd0348e18101f482c7f82d0db04b4307fee509d8,0,Robert Evans,2018-03-30 14:15:40-05:00,['2155b43fd0e6b8f0fe441c34a0bac6518e3ab159'],8,14,22,4993573,1,,,,3927
6e59035c8005d07335bc1bce5dcb6b1f172733db,0,Robert Evans,2018-03-30 14:18:27-05:00,"['dd0348e18101f482c7f82d0db04b4307fee509d8', 'bc346375cf3ece9fad4375b3240f1c5525f36c68']",23,52,75,4993648,2,,,,3927
f0064e1c312ee4b5b3e015d5f14aa87d0932097e,0,Robert Evans,2018-03-30 14:40:42-05:00,"['6e59035c8005d07335bc1bce5dcb6b1f172733db', '32f6b622259266afad6c7bb63cf0f5ca53a07fce']",2,22,24,4993672,1,,,,3927
a851badfba8f3195ece72fad27c8fb6be3bec7fe,0,Robert Evans,2018-03-30 14:45:13-05:00,"['f0064e1c312ee4b5b3e015d5f14aa87d0932097e', 'a344a29b9ce4bd71259452e7a9cb5b3284335ae2']",26,111,137,4993809,4,,,,3927
34c1857229a5eb31b53c2801e6b9c6f6a6216583,0,chenyuzhao,2018-04-01 20:47:21+08:00,['a851badfba8f3195ece72fad27c8fb6be3bec7fe'],0,8,8,4993817,3,,,,3927
0a48fd9ded9a9afbc08ef17d59292891d4aff2fc,0,Haj贸s Gergely,2018-04-02 12:47:24+02:00,['b99d80ce60132b5a731ff54cdd5601fbd8295b24'],21,47,68,4993885,3,0.045454545,1,1,3927
cb0bfceddf400bbbff9d8e90942137212f2bd15b,0,Stig Rohde D酶ssing,2018-04-02 15:22:44+02:00,"['a851badfba8f3195ece72fad27c8fb6be3bec7fe', '34c1857229a5eb31b53c2801e6b9c6f6a6216583']",0,8,8,4993893,3,,,,3927
76af86b5828903dadf8f1ebe6756d39d23dfaf66,0,Stig Rohde D酶ssing,2018-04-02 15:31:48+02:00,"['cb0bfceddf400bbbff9d8e90942137212f2bd15b', 'df9a619b0812616830b10a4e01bb87100fa7133e']",6,0,6,4993899,1,,,,3927
402a371ccdb39ccd7146fe9743e91ca36fee6d15,0,Robert Evans,2018-04-02 09:07:28-05:00,"['76af86b5828903dadf8f1ebe6756d39d23dfaf66', '0a48fd9ded9a9afbc08ef17d59292891d4aff2fc']",4,109,113,4994012,3,,,,3927
33961ac7b76589a1fc8ecb1d4559517f755bc7d5,1,Rui Abreu,2018-04-03 10:27:30+01:00,['ffa607e2464a361a8f2fa548cc8043f5a8818d04'],28,131,159,4994171,4,0.916666667,0.972222222,1,3928
a9ea7d5f414de2b8c0d6bcdebea825ebf9f5c15c,0,Stig Rohde D酶ssing,2018-04-03 18:19:22+02:00,"['76af86b5828903dadf8f1ebe6756d39d23dfaf66', '33961ac7b76589a1fc8ecb1d4559517f755bc7d5']",28,131,159,4994330,4,,,,3928
19cdedfc837c39bc382424d56998341492722fe9,0,Stig Rohde D酶ssing,2018-04-03 18:27:15+02:00,"['402a371ccdb39ccd7146fe9743e91ca36fee6d15', 'a9ea7d5f414de2b8c0d6bcdebea825ebf9f5c15c']",28,131,159,4994489,4,,,,3928
5e69300f6366ad81d2c7b887ed6331f0a7bddd6c,0,Derek Dagit,2018-04-03 12:24:50-05:00,['19cdedfc837c39bc382424d56998341492722fe9'],0,0,0,4994489,0,,,,3928
8b9173081045b31aff4064af3a44ce502c658c18,1,Ethan Li,2018-04-03 16:40:53-05:00,['402a371ccdb39ccd7146fe9743e91ca36fee6d15'],22,46,68,4994557,3,0.043478261,0,1,3928
5516f291a635243d7ab2d34a4d967bb6b218fc4f,0,Ethan Li,2018-04-04 10:37:40-05:00,['e6a3ac655db254d2e40a85eaeb932ea65cb6756d'],2,11,13,4994570,2,0.6,0.6,0.6,3928
337aef8f1291aba0ab228f6e9e0800c19b8c5ceb,1,Robert (Bobby) Evans,2018-04-04 15:14:00-05:00,['5e69300f6366ad81d2c7b887ed6331f0a7bddd6c'],68,66,134,4994704,3,1,0,1,3928
282a68af094f49a3f297b6a19eb80ab765f6fa0a,0,Jungtaek Lim,2018-04-05 22:06:55+09:00,"['5e69300f6366ad81d2c7b887ed6331f0a7bddd6c', '5516f291a635243d7ab2d34a4d967bb6b218fc4f']",2,11,13,4994717,2,,,,3928
a8d84d6716321d3daef3fea84f62add7e28d02c3,0,Roshan Naik,2018-04-06 02:04:42-07:00,['282a68af094f49a3f297b6a19eb80ab765f6fa0a'],1,12,13,4994730,2,,,,3928
ce7c716fc55c9af792998c2b3d512018cdbd8bec,0,michelo,2018-04-07 18:13:12+02:00,['ffa607e2464a361a8f2fa548cc8043f5a8818d04'],9,19,28,4994758,1,0,0,0,3928
21da5dff6c6b12f8350096969a7082f68e2f802c,1,Aaron Gresch,2018-04-09 10:24:26-05:00,['a8d84d6716321d3daef3fea84f62add7e28d02c3'],348,1830,2178,4996936,43,0.480620155,0.710077519,0.530232558,3944
d9a369329b741f3f78c9f62e28768faee7063cbd,0,michelo,2018-04-09 21:38:56+02:00,['ce7c716fc55c9af792998c2b3d512018cdbd8bec'],17,17,34,4996970,1,1,1,1,3944
3fa24d1dad5b5b4504c217f511c98d43aebf6a14,1,Robert (Bobby) Evans,2018-04-09 16:52:25-05:00,['337aef8f1291aba0ab228f6e9e0800c19b8c5ceb'],8,12,20,4996990,2,,,,3944
89bfbf58f091716b07f551397ac238dc25d91443,0,Jungtaek Lim,2018-04-10 13:17:08+09:00,['a8d84d6716321d3daef3fea84f62add7e28d02c3'],265,367,632,4997622,5,0,1,1,3944
b4e610c5f440d309bd2442eb80708e278e952819,0,Jungtaek Lim,2018-04-10 18:08:11+09:00,"['a8d84d6716321d3daef3fea84f62add7e28d02c3', '3fa24d1dad5b5b4504c217f511c98d43aebf6a14']",76,78,154,4997776,4,,,,3944
26818f2b45e8e83760380f1f4bb32907a10e594c,0,Jungtaek Lim,2018-04-10 18:10:59+09:00,"['b4e610c5f440d309bd2442eb80708e278e952819', '21da5dff6c6b12f8350096969a7082f68e2f802c']",348,1830,2178,4999954,43,,,,3944
8120e15eff36a1415a6590297f682458c783dd1e,0,Jungtaek Lim,2018-04-10 19:05:08+09:00,"['26818f2b45e8e83760380f1f4bb32907a10e594c', 'd9a369329b741f3f78c9f62e28768faee7063cbd']",11,21,32,4999986,1,,,,3944
a50c2b145e6403447aa6d7e4b74b80e80171b5d9,0,Ethan Li,2018-04-10 14:45:45-05:00,['a8d84d6716321d3daef3fea84f62add7e28d02c3'],22,10,32,5000018,2,1,1,1,3944
46486d87fc8a26262d75abc05c1398afceee687c,0,Kishor Patil,2018-04-10 17:42:03-04:00,['8120e15eff36a1415a6590297f682458c783dd1e'],46,88,134,5000152,3,1,1,0.235294118,3944
caf7f885d6c10eaed440b02ec345e863af700762,0,Kishor Patil,2018-04-10 18:30:03-04:00,['46486d87fc8a26262d75abc05c1398afceee687c'],25,0,25,5000177,1,0.105263158,0.105263158,0.315789474,3944
b57654c8a90705029ba3555ccd75d7056051c31c,0,Kishor Patil,2018-04-10 18:55:03-04:00,['caf7f885d6c10eaed440b02ec345e863af700762'],23,10,33,5000210,1,0,0,0,3944
8e61ef9cbc6158066ee9d434e30f55e89d780823,0,Kishor Patil,2018-04-11 09:48:34-04:00,['b57654c8a90705029ba3555ccd75d7056051c31c'],12,2,14,5000224,1,0,0,0,3944
3983a28aacf5f5a966e2009e7639ed4c0d0b1335,1,Robert (Bobby) Evans,2018-04-11 09:57:42-05:00,['8120e15eff36a1415a6590297f682458c783dd1e'],26,71,97,5000321,9,0.5,0.5,0.961538462,3944
4f5fdd928517df719db3b8d54351d0c5421193b7,0,Robert Evans,2018-04-11 10:00:43-05:00,"['8120e15eff36a1415a6590297f682458c783dd1e', '3983a28aacf5f5a966e2009e7639ed4c0d0b1335']",26,71,97,5000418,9,,,,3944
7069d90182e171859ff409047f10b432a79b327d,0,Kishor Patil,2018-04-11 12:08:45-04:00,['8e61ef9cbc6158066ee9d434e30f55e89d780823'],57,18,75,5000493,3,0,0,0,3944
9f72f8b47869a312941ffe6331ac2b6f2ee5aeff,0,P. Taylor Goetz,2018-04-11 13:57:54-04:00,"['5c3a911c0aed922421f4fab387dfad550ec90b31', '4f5fdd928517df719db3b8d54351d0c5421193b7']",10341,27914,38255,5038748,552,,,,3944
285e287c063c6a12c79553c7a96c9878b0ba3884,1,Gergely Hajos,2018-04-12 14:43:43+02:00,['4f5fdd928517df719db3b8d54351d0c5421193b7'],1,35,36,5038784,2,0,0.869565217,1,3944
2c61eba95caa2600e978972fc1749379cc57c5e1,0,Jungtaek Lim,2018-04-14 02:15:36+09:00,['4f5fdd928517df719db3b8d54351d0c5421193b7'],2,176,178,5038962,3,,,,3945
2ed793d9ba78afd7311dcdc3b098dea82623e0fa,0,Jungtaek Lim,2018-04-14 02:16:12+09:00,"['4f5fdd928517df719db3b8d54351d0c5421193b7', '2c61eba95caa2600e978972fc1749379cc57c5e1']",2,176,178,5039140,3,,,,3945
c5988e83df3f20722733d2b201907a300277bc5f,0,Jungtaek Lim,2018-04-14 02:31:33+09:00,"['2ed793d9ba78afd7311dcdc3b098dea82623e0fa', 'a50c2b145e6403447aa6d7e4b74b80e80171b5d9']",22,10,32,5039172,2,,,,3945
8ffa920d3894634aa078f0fdf6b02d270262caf4,1,Robert Evans,2018-04-13 16:31:57-05:00,['c5988e83df3f20722733d2b201907a300277bc5f'],129,519,648,5039820,21,0.278431373,0.431372549,0.549019608,3946
6a47ab5658d8587562dea3620ccdc287ba21b04c,0,Xin Wang,2018-04-16 10:36:30+08:00,['1c2286bc2c776fe14869111070131f1407d698fe'],461,740,1201,5041021,26,1,0,0.662337662,3953
f748bbcdcf317992368db922b77f9da580acbd88,0,Robert Evans,2018-04-19 08:52:15-05:00,"['8ffa920d3894634aa078f0fdf6b02d270262caf4', '7069d90182e171859ff409047f10b432a79b327d']",81,36,117,5041138,1,,,,3953
2b4276f22e47d5daea742938926f4cf7ee954f65,0,Robert Evans,2018-04-19 09:21:55-05:00,"['f748bbcdcf317992368db922b77f9da580acbd88', '89bfbf58f091716b07f551397ac238dc25d91443']",265,367,632,5041770,5,,,,3953
b26a62fde8e903819e89d0addbd3ce53d59bf2d0,0,Xin Wang,2018-04-20 14:19:17+08:00,"['2b4276f22e47d5daea742938926f4cf7ee954f65', '6a47ab5658d8587562dea3620ccdc287ba21b04c']",461,740,1201,5042971,26,,,,3953
8b34c6e7d15e7f79bb9e939ae2cb4a6d5f893eb7,1,Kishor Patil,2018-04-22 20:16:58-04:00,['b26a62fde8e903819e89d0addbd3ce53d59bf2d0'],28369,23600,51969,5094940,938,0.104100946,0.575709779,0.783911672,3953
1d8a9b6243494b11f140343819e67fc84e701200,0,Kishor Patil,2018-04-22 20:46:33-04:00,['8b34c6e7d15e7f79bb9e939ae2cb4a6d5f893eb7'],2000,1779,3779,5098719,52,0.8,0.933333333,0.533333333,3953
f1c0bcbed16085699f5fa809afb7c58f9925ce68,1,Kishor Patil,2018-04-23 00:03:38-04:00,['1d8a9b6243494b11f140343819e67fc84e701200'],10315,9484,19799,5118518,202,0.061538462,0.707692308,0.738461538,3953
fc1cf09b05c86dc5d1802049e7b650ceb52e54d4,1,Kishor Patil,2018-04-23 00:04:03-04:00,['f1c0bcbed16085699f5fa809afb7c58f9925ce68'],969,807,1776,5120294,47,0,0.666666667,0.416666667,3953
18723171612bdfe818929297378433a3c069e4e7,0,Kishor Patil,2018-04-23 00:22:17-04:00,['fc1cf09b05c86dc5d1802049e7b650ceb52e54d4'],2406,2386,4792,5125086,53,1,0.923076923,0,3953
7da98cf0c5d3e23fac42871974ff8017924673c5,1,Kishor Patil,2018-04-23 00:22:35-04:00,['18723171612bdfe818929297378433a3c069e4e7'],2522,2128,4650,5129736,78,0,0.666666667,0.619047619,3953
81ec15d1096cd526b94313661e7b5de7ed1791d0,0,Kishor Patil,2018-04-23 00:22:36-04:00,['7da98cf0c5d3e23fac42871974ff8017924673c5'],3869,3613,7482,5137218,67,0.5,0.967391304,0.989130435,3953
e3f5b138eb33e0b67c98a3ba3d8b26d70c988537,0,Kishor Patil,2018-04-23 00:22:36-04:00,['81ec15d1096cd526b94313661e7b5de7ed1791d0'],1015,797,1812,5139030,43,1,1,0.909090909,3953
1a2d131f99e62823bf15fa958cc676a51efda10c,0,Kishor Patil,2018-04-23 00:22:36-04:00,['e3f5b138eb33e0b67c98a3ba3d8b26d70c988537'],1449,1011,2460,5141490,67,0.818181818,1,0.545454545,3953
4fe4f04bb9750301b96f5c20142acb9a9a6a6000,0,Kishor Patil,2018-04-23 00:22:37-04:00,['1a2d131f99e62823bf15fa958cc676a51efda10c'],1551,1246,2797,5144287,71,0.45,0.775,0.725,3953
84084ab0ac16390f24e7f24a1d9d1693062cb023,0,Kishor Patil,2018-04-23 00:22:37-04:00,['4fe4f04bb9750301b96f5c20142acb9a9a6a6000'],295,282,577,5144864,3,,,,3953
6ccf6a0a0954590e3db4c95a3f22b504a5a72757,0,Kishor Patil,2018-04-23 00:22:37-04:00,['84084ab0ac16390f24e7f24a1d9d1693062cb023'],8,8,16,5144880,2,,,,3953
880d14f1e7c6d450375b195f3aa5bc4045151fab,0,Kishor Patil,2018-04-23 00:37:54-04:00,['6ccf6a0a0954590e3db4c95a3f22b504a5a72757'],827,684,1511,5146391,30,0.4,0.8,0.6,3953
f4ba7c952825ef7b0ee10bd1861dd0f288fe7761,0,Kishor Patil,2018-04-23 02:32:25-04:00,['880d14f1e7c6d450375b195f3aa5bc4045151fab'],175,124,299,5146690,10,,,,3953
0e409ecd8b2d6956ed38f78bb068ce8fef67e83b,0,Kishor Patil,2018-04-23 02:32:40-04:00,['f4ba7c952825ef7b0ee10bd1861dd0f288fe7761'],156,139,295,5146985,25,0,1,1,3953
5fc4e9f0bdf7a58852f7c27a1f8049e2bb3776a5,0,Kishor Patil,2018-04-23 02:32:40-04:00,['0e409ecd8b2d6956ed38f78bb068ce8fef67e83b'],776,683,1459,5148444,14,0,0.833333333,0.583333333,3953
224633d3ccbaa843c7f94c709d5cc573b1c59845,1,Kishor Patil,2018-04-23 02:32:40-04:00,['5fc4e9f0bdf7a58852f7c27a1f8049e2bb3776a5'],149,188,337,5148781,6,0.078947368,0.289473684,0.973684211,3953
95602b1be7493c33b7dc8c3a8cb6e406b59e907d,1,Kishor Patil,2018-04-23 02:32:41-04:00,['224633d3ccbaa843c7f94c709d5cc573b1c59845'],438,382,820,5149601,16,0,0.5,0,3953
53adebcfec5dec5e7a59f0a9108da734d3a3f01a,0,Kishor Patil,2018-04-23 02:32:41-04:00,['95602b1be7493c33b7dc8c3a8cb6e406b59e907d'],469,350,819,5150420,20,0.75,1,0.75,3953
6d20c4af585611c6d317ad817b0a0b4b172a40ce,0,Kishor Patil,2018-04-23 02:32:42-04:00,['53adebcfec5dec5e7a59f0a9108da734d3a3f01a'],435,323,758,5151178,21,0,1,1,3953
f7f3524d1401d76e1779c823391dce46e58acf48,0,Kishor Patil,2018-04-23 02:32:42-04:00,['6d20c4af585611c6d317ad817b0a0b4b172a40ce'],354,254,608,5151786,18,0,1,1,3953
e8ffac458baf6cc7a90dd0ced78cc01f0ffb4229,0,Kishor Patil,2018-04-23 02:32:42-04:00,['f7f3524d1401d76e1779c823391dce46e58acf48'],262,248,510,5152296,7,0,0.8,1,3953
a8978ab3543e00cf4e94ae361d4d1935b44b69f2,0,Gergely Hajos,2018-04-23 14:31:14+02:00,['b26a62fde8e903819e89d0addbd3ce53d59bf2d0'],0,1,1,5152297,1,0,1,1,3953
767325340295bee6f5b70b31c5f7cc781a3b311c,0,Robert Evans,2018-04-23 13:15:20-05:00,"['b26a62fde8e903819e89d0addbd3ce53d59bf2d0', '8b9173081045b31aff4064af3a44ce502c658c18']",22,46,68,5152365,3,,,,3953
99c62d4943904233197f9d820ce63cacf16ec0f0,0,Kishor Patil,2018-04-25 17:04:24-04:00,"['e8ffac458baf6cc7a90dd0ced78cc01f0ffb4229', '767325340295bee6f5b70b31c5f7cc781a3b311c']",25,50,75,5152440,3,,,,3953
d9ca88ac53cf512ee19241f9f0d4eec5d37ab514,0,Kishor Patil,2018-04-25 17:06:35-04:00,['99c62d4943904233197f9d820ce63cacf16ec0f0'],13,10,23,5152463,3,0.666666667,0.666666667,0,3953
4137328b75c06771f84414c3c2113e2d1c757c08,0,Robert Evans,2018-04-26 15:27:49-05:00,"['767325340295bee6f5b70b31c5f7cc781a3b311c', 'd9ca88ac53cf512ee19241f9f0d4eec5d37ab514']",58810,50515,109325,5261788,1790,,,,3953
abaaf9ba7ca00eca6583ba77dd1acc91bfe95106,0,Ethan Li,2018-04-27 08:47:05-05:00,['767325340295bee6f5b70b31c5f7cc781a3b311c'],2,6,8,5261796,1,0,0,1,3953
8bcf866df364bce03ef0514b03ceab10b6b7e86c,0,Ethan Li,2018-04-27 09:21:57-05:00,['4137328b75c06771f84414c3c2113e2d1c757c08'],0,10,10,5261806,2,,,,3953
19f086714deefe1835b8af4464b50f7d2e49d07e,0,Ethan Li,2018-04-27 09:28:22-05:00,['4137328b75c06771f84414c3c2113e2d1c757c08'],37,45,82,5261888,2,0,0,0.428571429,3953
f97347277ba2ad237c0d72ee80334fbf45bbe62f,1,Ethan Li,2018-04-27 09:55:12-05:00,['4137328b75c06771f84414c3c2113e2d1c757c08'],42,61,103,5261991,6,0,0,0,3953
38028cfc53d36d00775d030dd311b0afa1ae4a29,0,cleroux,2018-04-27 17:21:14+00:00,['b26a62fde8e903819e89d0addbd3ce53d59bf2d0'],1,57,58,5262049,3,1,1,1,3954
fdab9f9ae68aa45df6e3b2228cea4f51e29c97a5,0,Stig Rohde D酶ssing,2018-04-27 22:02:46+02:00,"['8bcf866df364bce03ef0514b03ceab10b6b7e86c', '38028cfc53d36d00775d030dd311b0afa1ae4a29']",1,57,58,5262107,3,,,,3954
0154216c9cb489b92ab86393fa1dd2fa5de56073,0,Stig Rohde D酶ssing,2018-04-28 13:01:44+02:00,['fdab9f9ae68aa45df6e3b2228cea4f51e29c97a5'],16,75,91,5262198,2,0,0.888888889,1,3954
e294761772e9e180d6499bcb080471ff2626b59d,0,Ethan Li,2018-04-29 21:27:04-05:00,"['fdab9f9ae68aa45df6e3b2228cea4f51e29c97a5', 'abaaf9ba7ca00eca6583ba77dd1acc91bfe95106']",2,6,8,5262206,1,,,,3954
e62ee285265248009c984218ac01aae0473a04c6,0,Ethan Li,2018-04-29 22:22:06-05:00,"['e294761772e9e180d6499bcb080471ff2626b59d', 'f97347277ba2ad237c0d72ee80334fbf45bbe62f']",42,61,103,5262309,6,,,,3954
1bd53a58e198efd2e43cc3bd5edfc6514816ebef,0,Ethan Li,2018-04-29 22:39:55-05:00,"['e62ee285265248009c984218ac01aae0473a04c6', '19f086714deefe1835b8af4464b50f7d2e49d07e']",37,45,82,5262391,2,,,,3954
1117a37b01a1058897a34e11ff5156e465efb692,0,Robert Evans,2018-04-30 10:13:25-05:00,['1bd53a58e198efd2e43cc3bd5edfc6514816ebef'],133,134,267,5262658,2,1,0,0,3954
75830c0bfe90e99cd2cb16a46ce26dc46bff8ec7,0,Aaron Gresch,2018-05-02 08:20:52-05:00,['767325340295bee6f5b70b31c5f7cc781a3b311c'],17,24,41,5262699,2,0,0,1,3954
57658f7fb83149cd16acbad5b089b8c268b729db,0,Stig Rohde D酶ssing,2018-05-02 16:35:57+02:00,"['1117a37b01a1058897a34e11ff5156e465efb692', '75830c0bfe90e99cd2cb16a46ce26dc46bff8ec7']",17,24,41,5262740,2,,,,3954
844b2d25d32649ba65d8bf7c4bc9803d027acca6,0,Jungtaek Lim,2018-05-03 18:38:04+09:00,"['57658f7fb83149cd16acbad5b089b8c268b729db', 'a8978ab3543e00cf4e94ae361d4d1935b44b69f2']",0,1,1,5262741,1,,,,3954
d5865711a7c7ad567295ba53109133702c954033,1,Govind Menon,2018-05-03 08:56:00-05:00,['844b2d25d32649ba65d8bf7c4bc9803d027acca6'],249,298,547,5263288,10,0.111111111,0,0.777777778,3954
82e7cf8cc4f5fead22824a0d3d38108bbdcdf87c,1,Govind Menon,2018-05-03 09:10:29-05:00,['d5865711a7c7ad567295ba53109133702c954033'],23,28,51,5263339,8,,0,0,3954
692cc4e28ae3e13094e425bdf99d088ee0fa37f2,0,Govind Menon,2018-05-03 09:28:01-05:00,['82e7cf8cc4f5fead22824a0d3d38108bbdcdf87c'],15,32,47,5263386,4,0.666666667,0.666666667,0.666666667,3954
de129584f3c34e95b219d2089cec750463e6c761,1,Govind Menon,2018-05-03 13:11:11-05:00,['692cc4e28ae3e13094e425bdf99d088ee0fa37f2'],38,49,87,5263473,11,,,,3954
33824825850aeeabcd2e14202fe096867481b02e,1,Gergely Hajos,2018-05-04 13:05:18+02:00,['285e287c063c6a12c79553c7a96c9878b0ba3884'],3,2,5,5263478,2,,0,,3954
02639f4f07140fdc3248a9ef869d62654d378d24,0,Robert Evans,2018-05-04 11:11:24-05:00,"['844b2d25d32649ba65d8bf7c4bc9803d027acca6', 'de129584f3c34e95b219d2089cec750463e6c761']",305,387,692,5264170,19,,,,3954
32392bc8e19a21a7d8c22248fedf42673472acbc,1,Robert (Bobby) Evans,2018-05-04 13:59:04-05:00,['02639f4f07140fdc3248a9ef869d62654d378d24'],341,783,1124,5265294,18,0.619607843,1,0.803921569,3955
3370b2d6495be770989c048a35cd3998e899bd60,0,Stig Rohde D酶ssing,2018-05-07 08:33:48+02:00,['02639f4f07140fdc3248a9ef869d62654d378d24'],42,89,131,5265425,4,0.882352941,0.882352941,1,3956
15a6fa5753d14ce5c12f054bf9255607e4943081,0,Jungtaek Lim,2018-05-07 21:53:05+09:00,"['02639f4f07140fdc3248a9ef869d62654d378d24', '3370b2d6495be770989c048a35cd3998e899bd60']",42,89,131,5265556,4,,,,3956
d0be8aed6ccba2abf7b32084fe8255f15514563c,0,Robert (Bobby) Evans,2018-05-07 09:56:27-05:00,['32392bc8e19a21a7d8c22248fedf42673472acbc'],29,46,75,5265631,7,0,0,0,3956
a02ca0149bd035ae4d49a040acb78e49f9b2fa68,0,Srishty Agrawal,2018-05-07 16:54:55-07:00,['15a6fa5753d14ce5c12f054bf9255607e4943081'],1,35,36,5265667,1,,,,3956
34650ba6c5049f86901de8cecc82abbf2df6ff95,0,Artem Ervits,2018-05-07 20:42:23-04:00,['15a6fa5753d14ce5c12f054bf9255607e4943081'],1,1,2,5265669,1,,,,3956
558e9b671a7904aec5798cbac6cbdd2aca65b488,0,Robert (Bobby) Evans,2018-05-08 09:56:22-05:00,['d0be8aed6ccba2abf7b32084fe8255f15514563c'],0,4,4,5265673,2,,,,3956
290458c121181b6213e3efe71cfcd7b5025738c1,0,Stig Rohde D酶ssing,2018-05-08 18:33:36+02:00,"['15a6fa5753d14ce5c12f054bf9255607e4943081', 'a02ca0149bd035ae4d49a040acb78e49f9b2fa68']",1,35,36,5265709,1,,,,3956
9749c60d387e124f022cf023f12d7884d31b6afd,0,Stig Rohde D酶ssing,2018-05-09 18:37:30+02:00,['02639f4f07140fdc3248a9ef869d62654d378d24'],9,19,28,5265737,2,,,,3956
d541e60bc41f9cbe3ba1469966bd9031ebaec207,0,Stig Rohde D酶ssing,2018-05-10 01:29:59+02:00,['290458c121181b6213e3efe71cfcd7b5025738c1'],16,19,35,5265772,5,0,0,0,3956
5deba40fca0f88f61d2086cb902318ad9bb044f1,0,Stig Rohde D酶ssing,2018-05-10 13:37:17+02:00,"['290458c121181b6213e3efe71cfcd7b5025738c1', '9749c60d387e124f022cf023f12d7884d31b6afd']",9,19,28,5265800,2,,,,3956
d976f4890ab3f2f81bf2a86b23584b341aacc798,0,Rajkumar singh,2018-05-10 12:58:01-07:00,['5deba40fca0f88f61d2086cb902318ad9bb044f1'],1,1,2,5265802,1,,,,3956
b5ab9e897908036caa6e73d80b6369fb5d192f7a,0,Jungtaek Lim,2018-05-11 10:50:36+09:00,['15a6fa5753d14ce5c12f054bf9255607e4943081'],12,39,51,5265853,2,0,0,0.777777778,3956
eae4dc216fc1cc858be929049d27254ad6ec0b8f,0,Stig Rohde D酶ssing,2018-05-11 19:50:48+02:00,['5deba40fca0f88f61d2086cb902318ad9bb044f1'],0,2,2,5265855,1,0,0,0,3956
3dbc67f4c5cd1b8a77b365dd3b8dcf723af82e3c,0,Stig Rohde D酶ssing,2018-05-13 21:34:41+02:00,"['5deba40fca0f88f61d2086cb902318ad9bb044f1', 'd541e60bc41f9cbe3ba1469966bd9031ebaec207']",16,19,35,5265890,5,,,,3956
c9a9cc1fcdbc9efc9635124f620c146e118fff92,0,Jungtaek Lim,2018-05-14 11:03:08+09:00,['3dbc67f4c5cd1b8a77b365dd3b8dcf723af82e3c'],279,313,592,5266482,3,1,1,1,3956
85877154f68e4cd6e59c6c5c0bff9b4c2eacf535,0,Jungtaek Lim,2018-05-14 11:03:40+09:00,"['3dbc67f4c5cd1b8a77b365dd3b8dcf723af82e3c', 'c9a9cc1fcdbc9efc9635124f620c146e118fff92']",279,313,592,5267074,3,,,,3956
ecbf7352cac53826b273f56ee72bd3e18c8a84e7,0,Jungtaek Lim,2018-05-14 11:54:25+09:00,"['85877154f68e4cd6e59c6c5c0bff9b4c2eacf535', 'b5ab9e897908036caa6e73d80b6369fb5d192f7a']",12,39,51,5267125,2,,,,3956
5cb4582ffb9f4703377e8963133640d1d50e065a,0,Jungtaek Lim,2018-05-14 12:59:59+09:00,"['ecbf7352cac53826b273f56ee72bd3e18c8a84e7', '34650ba6c5049f86901de8cecc82abbf2df6ff95']",1,1,2,5267127,1,,,,3956
ecef8ce3a88e3a6fba47c3c7a10794da2e1679cb,0,Stig Rohde D酶ssing,2018-05-14 16:40:01+02:00,['3dbc67f4c5cd1b8a77b365dd3b8dcf723af82e3c'],0,7,7,5267134,1,,,,3956
53f38bc31f2fd315a520ba6b86c0a60be08381cc,0,Robert Evans,2018-05-14 12:15:13-05:00,"['5cb4582ffb9f4703377e8963133640d1d50e065a', '558e9b671a7904aec5798cbac6cbdd2aca65b488']",363,826,1189,5268323,19,,,,3956
14b0b4fc5e0945456769fd58a3595188e3dea234,0,Stig Rohde D酶ssing,2018-05-15 17:24:15+02:00,"['53f38bc31f2fd315a520ba6b86c0a60be08381cc', 'ecef8ce3a88e3a6fba47c3c7a10794da2e1679cb']",0,7,7,5268330,1,,,,3956
473bf84a0caef26544b8c01aecd6fb139aa51110,0,Gergely Hajos,2018-05-16 14:18:56+02:00,['33824825850aeeabcd2e14202fe096867481b02e'],2,0,2,5268332,1,1,1,0,3956
7a4f1d0ff8f49243f8ca7440ed29d6c10c136269,1,pczb,2018-05-17 23:02:02+08:00,['290458c121181b6213e3efe71cfcd7b5025738c1'],36,14,50,5268382,3,0.117647059,0,0.470588235,3956
917be55a5bd6be8baa4811c6684897da949c3bb1,1,Aaron Gresch,2018-05-17 10:24:59-05:00,['14b0b4fc5e0945456769fd58a3595188e3dea234'],4,6,10,5268392,1,,,,3956
fbeafdcbb1e4be1263b91be7ba75a15aa6e885a8,0,Ethan Li,2018-05-17 10:37:14-05:00,"['14b0b4fc5e0945456769fd58a3595188e3dea234', '917be55a5bd6be8baa4811c6684897da949c3bb1']",4,6,10,5268402,1,,,,3956
e8ee6deedda17c6bc8855985a91079fd64d57f0d,1,Aaron Gresch,2018-05-17 14:46:44-05:00,['fbeafdcbb1e4be1263b91be7ba75a15aa6e885a8'],132,440,572,5268974,25,1,1,1,3964
3551a8b2b64d166b8aa5de566a5c229d70faa1de,1,Stig Rohde D酶ssing,2018-05-21 10:19:50+02:00,['14b0b4fc5e0945456769fd58a3595188e3dea234'],357,387,744,5269718,4,0.241758242,1,1,3965
7ce2a3b615a8d6833800b3e9286c88547ed39201,0,Stig Rohde D酶ssing,2018-05-21 16:00:08+02:00,['3dbc67f4c5cd1b8a77b365dd3b8dcf723af82e3c'],4,12,16,5269734,3,0,1,1,3965
afba24e79840026bf04582732ff0bfdd11659302,0,Stig Rohde D酶ssing,2018-05-21 16:03:09+02:00,"['fbeafdcbb1e4be1263b91be7ba75a15aa6e885a8', 'eae4dc216fc1cc858be929049d27254ad6ec0b8f']",0,2,2,5269736,1,,,,3965
66559c6f1b5a5c5c0540558a84dfca50daf0cee9,0,Stig Rohde D酶ssing,2018-05-21 16:27:25+02:00,"['afba24e79840026bf04582732ff0bfdd11659302', '7ce2a3b615a8d6833800b3e9286c88547ed39201']",4,12,16,5269752,3,,,,3965
4f110e3a0934f427573f81f1922562a6a1910e77,0,Aaron Gresch,2018-05-21 10:34:22-05:00,['66559c6f1b5a5c5c0540558a84dfca50daf0cee9'],91,203,294,5270046,10,0.416666667,0.833333333,1,3967
99f47570750266c12d31eaa11ef912e92575b095,1,Aaron Gresch,2018-05-21 15:05:41-05:00,['66559c6f1b5a5c5c0540558a84dfca50daf0cee9'],9,92,101,5270147,4,1,1,0.761904762,3967
109c2153c70a8f6f7e68a8710566c0bfd38142ee,0,Jungtaek Lim,2018-05-22 17:57:55+09:00,"['66559c6f1b5a5c5c0540558a84dfca50daf0cee9', 'e8ee6deedda17c6bc8855985a91079fd64d57f0d']",132,440,572,5270719,25,,,,3967
e6ad8938e075612b07e7d0e054f8771e2c9359fb,0,Jungtaek Lim,2018-05-22 19:03:40+09:00,"['109c2153c70a8f6f7e68a8710566c0bfd38142ee', '4f110e3a0934f427573f81f1922562a6a1910e77']",91,203,294,5271013,10,,,,3967
93ed601425a79759c0189a945c6b46266e5c9ced,0,Jungtaek Lim,2018-05-22 19:42:18+09:00,"['e6ad8938e075612b07e7d0e054f8771e2c9359fb', 'd976f4890ab3f2f81bf2a86b23584b341aacc798']",1,1,2,5271015,1,,,,3967
1fd1e17fb2ede7bbb872bfca9ac6dd50fa58efd5,1,Robert (Bobby) Evans,2018-05-22 16:26:21-05:00,['93ed601425a79759c0189a945c6b46266e5c9ced'],44785,41924,86709,5357724,119,1,0,0,3967
9e97a0758c013556b925f090ec39d9d1f383e6c9,0,Robert Evans,2018-05-23 14:08:12-05:00,"['93ed601425a79759c0189a945c6b46266e5c9ced', '1fd1e17fb2ede7bbb872bfca9ac6dd50fa58efd5']",44785,41924,86709,5444433,119,,,,3967
5cdb9c0acf2dbfff2c1bebd4b5a6931ed98558bc,0,Robert (Bobby) Evans,2018-05-23 15:05:54-05:00,['9e97a0758c013556b925f090ec39d9d1f383e6c9'],20,0,20,5444453,3,0,0,0,3967
cbe9ed5a500638401513b475685f74221e8ebe20,0,Jungtaek Lim,2018-05-24 07:40:52+09:00,['9e97a0758c013556b925f090ec39d9d1f383e6c9'],1,1,2,5444455,1,,,,3967
26c4bec99efec800b3824db67ef88f5d856354a7,1,chenyuzhao,2018-05-25 00:34:14+08:00,['9e97a0758c013556b925f090ec39d9d1f383e6c9'],9,1269,1278,5445733,13,0.627959414,0.78692221,0.96054115,3967
4cd851bd457a8544cf9987c4b0f8741ef7c8dc93,0,Robert Evans,2018-05-24 12:32:54-05:00,"['9e97a0758c013556b925f090ec39d9d1f383e6c9', '5cdb9c0acf2dbfff2c1bebd4b5a6931ed98558bc']",20,0,20,5445753,3,,,,3967
fe388df9b3e9649fbdf9f2e57206ee655212bcc6,0,Aaron Gresch,2018-05-24 16:39:07-05:00,['4cd851bd457a8544cf9987c4b0f8741ef7c8dc93'],6,9,15,5445768,1,1,1,1,3967
9861f9a718caba4dc04b82327210830e25118a07,0,Jungtaek Lim,2018-05-25 12:08:25+09:00,"['4cd851bd457a8544cf9987c4b0f8741ef7c8dc93', 'cbe9ed5a500638401513b475685f74221e8ebe20']",1,1,2,5445770,1,,,,3967
64af629a19a82591dbf3428f7fd6b02f39e0723f,0,Robert Evans,2018-05-25 07:34:16-05:00,"['9861f9a718caba4dc04b82327210830e25118a07', '26c4bec99efec800b3824db67ef88f5d856354a7']",9,1269,1278,5447048,13,,,,3967
1ebdf301edbd3bac1ff9416d971ee6e7738891ce,0,Stig Rohde D酶ssing,2018-05-28 22:48:33+02:00,['64af629a19a82591dbf3428f7fd6b02f39e0723f'],9,96,105,5447153,4,0.733333333,0.733333333,1,3968
d016cbec758f93cd1e6e7aa0f228a1f8bdea5e5d,0,Stig Rohde D酶ssing,2018-05-28 23:03:27+02:00,['64af629a19a82591dbf3428f7fd6b02f39e0723f'],0,35,35,5447188,1,,,,3968
befc2db7f2f96930dabdd40d062790a4f11761a5,0,Stig Rohde D酶ssing,2018-05-29 17:56:02+02:00,['64af629a19a82591dbf3428f7fd6b02f39e0723f'],0,4,4,5447192,1,,,,3968
787a4340a8d2d3291e5e4ecef47c8b85ff9a3b74,1,Aaron Gresch,2018-05-30 10:40:23-05:00,['99f47570750266c12d31eaa11ef912e92575b095'],15,20,35,5447227,5,0,1,1,3968
4964112d962ea935b8ff1194efc5c338c27b03ab,0,Ethan Li,2018-05-31 08:38:55-05:00,"['64af629a19a82591dbf3428f7fd6b02f39e0723f', 'fe388df9b3e9649fbdf9f2e57206ee655212bcc6']",6,9,15,5447242,1,,,,3968
3356f1f764135570b948f6614c4816f49fd68dbd,0,Robert Evans,2018-05-31 12:56:10-05:00,"['4964112d962ea935b8ff1194efc5c338c27b03ab', '7a4f1d0ff8f49243f8ca7440ed29d6c10c136269']",36,14,50,5447292,3,,,,3968
0bc4e26d1897fdc58d6b5ae77142384a1ecc8495,0,Robert Evans,2018-06-01 08:06:31-05:00,"['3356f1f764135570b948f6614c4816f49fd68dbd', '1ebdf301edbd3bac1ff9416d971ee6e7738891ce']",9,96,105,5447397,4,,,,3968
b0bdbf08260d55d36a5893cf3dcafba90d695211,0,Stig Rohde D酶ssing,2018-06-01 17:16:40+02:00,"['0bc4e26d1897fdc58d6b5ae77142384a1ecc8495', '787a4340a8d2d3291e5e4ecef47c8b85ff9a3b74']",9,97,106,5447503,5,,,,3968
f7ab952b2243add7c79984dcb64475583749515c,0,Stig Rohde D酶ssing,2018-06-01 17:56:07+02:00,"['b0bdbf08260d55d36a5893cf3dcafba90d695211', 'befc2db7f2f96930dabdd40d062790a4f11761a5']",0,4,4,5447507,1,,,,3968
41f977a9e1e10a53633fabd77b30852c052dba3f,0,Stig Rohde D酶ssing,2018-06-01 18:03:24+02:00,"['f7ab952b2243add7c79984dcb64475583749515c', 'd016cbec758f93cd1e6e7aa0f228a1f8bdea5e5d']",0,35,35,5447542,1,,,,3968
85fc30f4f5970ccc6aa67a4e27090b2fd29cd76b,0,chenyuzhao,2018-06-02 17:47:10+08:00,['41f977a9e1e10a53633fabd77b30852c052dba3f'],12,39,51,5447593,1,0,1,0.428571429,3968
3ad1937ab019eff9cb5c74fa6b51785dffd46529,0,Jungtaek Lim,2018-06-03 15:47:40+09:00,['41f977a9e1e10a53633fabd77b30852c052dba3f'],0,3,3,5447596,1,0,0.333333333,1,3968
98d724f84218b95c0aae7ba4c36910febf85ec25,0,Jungtaek Lim,2018-06-03 15:48:29+09:00,"['41f977a9e1e10a53633fabd77b30852c052dba3f', '3ad1937ab019eff9cb5c74fa6b51785dffd46529']",0,3,3,5447599,1,,,,3968
73a343aff14a789b39a6ceb165e72354fa8999af,0,Stig Rohde D酶ssing,2018-06-03 11:53:43+02:00,['3551a8b2b64d166b8aa5de566a5c229d70faa1de'],5,11,16,5447615,1,1,1,1,3968
44e272735688113ff0b49de6aa1cab2fa9e9fdfc,0,Zhengdai,2018-06-04 10:44:48-05:00,['98d724f84218b95c0aae7ba4c36910febf85ec25'],2,4,6,5447621,1,,,,3968
c9b73a5e3ffcfc458772100dc6bd62ad1cf468de,0,Robert Evans,2018-06-04 11:01:13-05:00,"['98d724f84218b95c0aae7ba4c36910febf85ec25', '85fc30f4f5970ccc6aa67a4e27090b2fd29cd76b']",12,39,51,5447672,1,,,,3968
fe32d95c61d0a4c9350eb4515f6e74b2aec761a3,0,Robert Evans,2018-06-04 12:14:10-05:00,"['c9b73a5e3ffcfc458772100dc6bd62ad1cf468de', '73a343aff14a789b39a6ceb165e72354fa8999af']",357,393,750,5448422,4,,,,3968
4c4b2b4b6d579a118379607a268ef060136d9aac,1,Aaron Gresch,2018-06-05 08:28:30-05:00,['41f977a9e1e10a53633fabd77b30852c052dba3f'],17,25,42,5448464,7,1,1,1,3968
07a437302c544b2635a835c9eeb1f3210e7519db,0,Robert Evans,2018-06-05 10:58:26-05:00,"['fe32d95c61d0a4c9350eb4515f6e74b2aec761a3', '4c4b2b4b6d579a118379607a268ef060136d9aac']",17,25,42,5448506,7,,,,3968
3e098f12e2b09d4954eeeaaf807e4ff6006a6929,0,Robert Evans,2018-06-05 11:21:48-05:00,"['07a437302c544b2635a835c9eeb1f3210e7519db', '44e272735688113ff0b49de6aa1cab2fa9e9fdfc']",2,4,6,5448512,1,,,,3968
8f60cefe4bd57f4d143f47e1b8862765abaad445,0,Aaron Gresch,2018-06-05 15:58:29-05:00,['3e098f12e2b09d4954eeeaaf807e4ff6006a6929'],18,15,33,5448545,3,1,0,0,3968
39320181ff122a0eaf34cde24937c92c5043a5e7,1,Robert (Bobby) Evans,2018-06-06 15:43:12-05:00,['3e098f12e2b09d4954eeeaaf807e4ff6006a6929'],255,353,608,5449153,107,0.15,0,0.15,3969
a010586c283e44c5710d8cfb472cc53ac41579c4,1,Robert (Bobby) Evans,2018-06-06 15:43:12-05:00,['39320181ff122a0eaf34cde24937c92c5043a5e7'],941,270,1211,5450364,46,0.496453901,0.052009456,0.115839243,3971
8191e46ff4bbf780531d0684dffaa72f00a93132,1,Robert (Bobby) Evans,2018-06-06 15:43:12-05:00,['a010586c283e44c5710d8cfb472cc53ac41579c4'],34,34,68,5450432,21,,,,3971
a8eb4c40af8229f4737f7e5eef1534d5d0d12dfd,1,Robert (Bobby) Evans,2018-06-06 15:43:12-05:00,['8191e46ff4bbf780531d0684dffaa72f00a93132'],0,753,753,5451185,2,0.558962264,0.948113208,0.884433962,3973
8a95784267743ee616d3d9d4ec091d7f8e2c9248,0,Robert (Bobby) Evans,2018-06-06 15:43:12-05:00,['a8eb4c40af8229f4737f7e5eef1534d5d0d12dfd'],1,1,2,5451187,1,,,,3973
9b83b46d55acdf20f62cfec15800d1898f0efe19,1,Robert (Bobby) Evans,2018-06-06 15:43:12-05:00,['8a95784267743ee616d3d9d4ec091d7f8e2c9248'],99,92,191,5451378,41,,,,3973
2837eeadf0cf9d165ce6fe97e41f3b393c05bdb0,0,Robert (Bobby) Evans,2018-06-06 15:43:12-05:00,['9b83b46d55acdf20f62cfec15800d1898f0efe19'],3,27,30,5451408,3,,,,3973
719221c9f17204074859506d98d2711e18d120af,0,Robert (Bobby) Evans,2018-06-06 15:43:12-05:00,['2837eeadf0cf9d165ce6fe97e41f3b393c05bdb0'],29,28,57,5451465,20,,,,3973
62f9568e150fff3f306ab3b204ef7660afdd34d3,1,Robert (Bobby) Evans,2018-06-06 15:43:12-05:00,['719221c9f17204074859506d98d2711e18d120af'],66,98,164,5451629,40,,,,3973
2a13177163ea1d0aef9bc9d3ba03007f1ab7c569,0,Robert (Bobby) Evans,2018-06-06 15:43:12-05:00,['62f9568e150fff3f306ab3b204ef7660afdd34d3'],11,23,34,5451663,5,,,,3973
5fd330da2e6577915cb046bb190ea57ceb1ac71b,0,Robert (Bobby) Evans,2018-06-06 15:43:12-05:00,['2a13177163ea1d0aef9bc9d3ba03007f1ab7c569'],6,0,6,5451669,1,,,,3973
6c34c286659158acb6c4c1ad0f47eb05e92626c9,0,Robert (Bobby) Evans,2018-06-06 15:43:12-05:00,['5fd330da2e6577915cb046bb190ea57ceb1ac71b'],40,50,90,5451759,23,,,,3973
9734cd63a364c2e93b34a398feaf710c6f326703,0,Robert (Bobby) Evans,2018-06-06 15:43:12-05:00,['6c34c286659158acb6c4c1ad0f47eb05e92626c9'],10,22,32,5451791,6,,,,3973
5eb2be75d1b089caaaa41f7a1f1b15dc16741895,0,Robert (Bobby) Evans,2018-06-06 15:43:12-05:00,['9734cd63a364c2e93b34a398feaf710c6f326703'],131,136,267,5452058,36,,,,3973
142ad60809e2a2ff1576378d645eb15fcb48d25b,0,Robert (Bobby) Evans,2018-06-06 15:43:12-05:00,['5eb2be75d1b089caaaa41f7a1f1b15dc16741895'],43,43,86,5452144,18,,,,3973
91251c54abdb5bc267851dcf38a1cfcea247eaad,1,Robert (Bobby) Evans,2018-06-06 15:43:13-05:00,['142ad60809e2a2ff1576378d645eb15fcb48d25b'],13149,13137,26286,5478430,157,,,,3973
1b9e81f0452a584706e9c608ba8b010068724e48,0,Robert (Bobby) Evans,2018-06-06 15:43:13-05:00,['91251c54abdb5bc267851dcf38a1cfcea247eaad'],6,0,6,5478436,1,,,,3973
8fa274388e5b5644543f409e7cddcadca4a3ff33,0,Robert (Bobby) Evans,2018-06-06 15:43:13-05:00,['1b9e81f0452a584706e9c608ba8b010068724e48'],7,24,31,5478467,6,,,,3973
60da0ef39a202eebd7fa68aeb4f1f9f9257b2ac1,0,Robert (Bobby) Evans,2018-06-06 15:43:13-05:00,['8fa274388e5b5644543f409e7cddcadca4a3ff33'],0,4,4,5478471,1,,,,3973
e584c610fc0507a4059f681ae6983c8a5a2fff95,0,Robert (Bobby) Evans,2018-06-06 15:43:13-05:00,['60da0ef39a202eebd7fa68aeb4f1f9f9257b2ac1'],7,11,18,5478489,4,,,,3973
71b61d9b2728026c848e9aa45e23a3dfae041f9a,0,Robert (Bobby) Evans,2018-06-06 15:43:13-05:00,['e584c610fc0507a4059f681ae6983c8a5a2fff95'],14,14,28,5478517,2,,,,3973
492eff4e7203d8a060cfa6c9c20d8bea28235be3,0,Robert (Bobby) Evans,2018-06-06 15:43:13-05:00,['71b61d9b2728026c848e9aa45e23a3dfae041f9a'],93,9,102,5478619,4,,,,3973
b588b2556b39e6249bcd25654115ecbf21e19e94,0,Robert (Bobby) Evans,2018-06-06 15:43:13-05:00,['492eff4e7203d8a060cfa6c9c20d8bea28235be3'],0,7,7,5478626,1,,,,3973
35a1b8f4822eed54f95f0d1ea7e71dfe1b97a796,0,Robert (Bobby) Evans,2018-06-06 17:01:52-05:00,['b588b2556b39e6249bcd25654115ecbf21e19e94'],11,32,43,5478669,5,,,,3973
498da9e77cec4d5cb9dfbb1044cb9634f1ff0422,0,Zhengdai Hu,2018-06-07 09:19:44-05:00,['3e098f12e2b09d4954eeeaaf807e4ff6006a6929'],1,1,2,5478671,1,,,,3973
ab97687997c6b24a1c47cb2d84c07757501779eb,0,Robert Evans,2018-06-07 09:58:52-05:00,"['3e098f12e2b09d4954eeeaaf807e4ff6006a6929', '35a1b8f4822eed54f95f0d1ea7e71dfe1b97a796']",14181,14393,28574,5507245,390,,,,3973
5e5ff7807662ceb34f028d4fb5c54fffe3d24793,0,Zhengdai Hu,2018-06-07 14:37:08-05:00,['498da9e77cec4d5cb9dfbb1044cb9634f1ff0422'],11,15,26,5507271,1,0,1,1,3973
93fc34100ba8110e39fc9908d33c5ff8df8e5545,0,Robert Evans,2018-06-08 08:39:16-05:00,"['ab97687997c6b24a1c47cb2d84c07757501779eb', '5e5ff7807662ceb34f028d4fb5c54fffe3d24793']",12,16,28,5507299,2,,,,3973
c24cf9764583263bf73eb631ac25759818e2dd73,0,Robert Evans,2018-06-08 09:03:05-05:00,"['93fc34100ba8110e39fc9908d33c5ff8df8e5545', '8f60cefe4bd57f4d143f47e1b8862765abaad445']",18,15,33,5507332,3,,,,3973
d293dd32ed64669164620ce984af53441508eae5,1,Stig Rohde D酶ssing,2018-06-08 19:05:02+02:00,['c24cf9764583263bf73eb631ac25759818e2dd73'],10,13,23,5507355,2,,,,3973
e2308285d28a2df4a1435a1f4fb304630749c29a,1,Jungtaek Lim,2018-06-09 20:34:51+09:00,['d293dd32ed64669164620ce984af53441508eae5'],1047,905,1952,5509307,50,0.715151515,0.703030303,0,3975
4aa6b5e18cf2dcefb509f965cd8a61e31389d6aa,0,Jungtaek Lim,2018-06-09 20:37:23+09:00,"['c24cf9764583263bf73eb631ac25759818e2dd73', 'e2308285d28a2df4a1435a1f4fb304630749c29a']",1040,901,1941,5511248,50,,,,3975
b6cab8dca97e2238aef8e45118f6946fc2d35049,0,Jungtaek Lim,2018-06-09 20:43:33+09:00,['4aa6b5e18cf2dcefb509f965cd8a61e31389d6aa'],1365,0,1365,5512613,18,0.53869969,0,0.077399381,3975
0eb6b5116f251e17b6f14a61cebfadfc286faa59,0,Jungtaek Lim,2018-06-09 20:44:03+09:00,"['4aa6b5e18cf2dcefb509f965cd8a61e31389d6aa', 'b6cab8dca97e2238aef8e45118f6946fc2d35049']",1365,0,1365,5513978,18,,,,3975
aa537af7e37c4469b4ca85a5e9771a3ba4bd77d7,0,Jungtaek Lim,2018-06-09 20:45:37+09:00,['0eb6b5116f251e17b6f14a61cebfadfc286faa59'],1,1,2,5513980,1,,,,3975
cd6c47aac61bd2a730d03f0a90908b42bd6aec9d,0,ManoharVanam,2018-06-12 09:10:37+05:18,['aa537af7e37c4469b4ca85a5e9771a3ba4bd77d7'],5,21,26,5514006,3,0.666666667,0.666666667,0.666666667,3975
ce7630229f352d3c283a066a026cec3a2cbe1343,0,GitHub,2018-06-12 15:21:55-07:00,['aa537af7e37c4469b4ca85a5e9771a3ba4bd77d7'],0,12,12,5514018,1,,,,3975
0cb659040e1ace1b236237350dd7325ec2aae842,0,Jungtaek Lim,2018-06-13 21:56:22+09:00,"['aa537af7e37c4469b4ca85a5e9771a3ba4bd77d7', 'cd6c47aac61bd2a730d03f0a90908b42bd6aec9d']",5,21,26,5514044,3,,,,3975
e73338c661e88b00b64be489de33c849d30b2f19,0,GitHub,2018-06-13 08:54:17-07:00,['ce7630229f352d3c283a066a026cec3a2cbe1343'],3,3,6,5514050,1,,,,3975
0eb6cd72c07a12499eb12f5830a80c1da1bdfaa0,0,Andy Seidel,2018-06-13 11:29:07-07:00,['0cb659040e1ace1b236237350dd7325ec2aae842'],13,0,13,5514063,1,1,1,0,3975
5c5d071305785fb322413b0a39d3fb6d19a83a9d,0,Aaron Gresch,2018-06-13 15:31:15-05:00,['0cb659040e1ace1b236237350dd7325ec2aae842'],3,3,6,5514069,1,,,,3975
b03ee18dd13196265c3d68e59e76380ccc6b4bd8,0,Zhengdai Hu,2018-06-15 16:56:01-05:00,['0cb659040e1ace1b236237350dd7325ec2aae842'],1,0,1,5514070,1,0,0,0,3975
1e3ab3ac386cec0a67a0c3374afe385090d3814e,0,Stig Rohde D酶ssing,2018-06-16 20:01:38+02:00,"['0cb659040e1ace1b236237350dd7325ec2aae842', '0eb6cd72c07a12499eb12f5830a80c1da1bdfaa0']",13,0,13,5514083,1,,,,3975
9c3831a8028f7ea3787e814b13fc4c03b96b830d,0,Stig Rohde D酶ssing,2018-06-16 22:54:48+02:00,['1e3ab3ac386cec0a67a0c3374afe385090d3814e'],57,40,97,5514180,1,1,0.666666667,1,3975
15a9a3bac57ea92e0df56390289ad4de1f43bc80,0,Stig Rohde D酶ssing,2018-06-17 17:56:45+02:00,"['1e3ab3ac386cec0a67a0c3374afe385090d3814e', '5c5d071305785fb322413b0a39d3fb6d19a83a9d']",3,3,6,5514186,1,,,,3975
d3625b0980faab699e6e3b5ca7ac6d07d5c7c275,0,Stig Rohde D酶ssing,2018-06-17 18:15:23+02:00,"['15a9a3bac57ea92e0df56390289ad4de1f43bc80', 'b03ee18dd13196265c3d68e59e76380ccc6b4bd8']",1,0,1,5514187,1,,,,3975
5200cffeee608848f9f7f41005a4fbd44d7cc273,0,Robert Evans,2018-06-18 11:06:54-05:00,"['d3625b0980faab699e6e3b5ca7ac6d07d5c7c275', 'e73338c661e88b00b64be489de33c849d30b2f19']",0,12,12,5514199,1,,,,3975
f5474a5ef7f4d9e158902809cc03fcb7b06317b7,0,Robert (Bobby) Evans,2018-06-18 11:15:09-05:00,['d3625b0980faab699e6e3b5ca7ac6d07d5c7c275'],1,1,2,5514201,1,,,,3975
cade93e4e3241b43700383571b6494a1f020eae5,0,Stig Rohde D酶ssing,2018-06-18 21:14:50+02:00,['5200cffeee608848f9f7f41005a4fbd44d7cc273'],1,1,2,5514203,1,,,,3975
e73e03aea61150fd35ca1f8bae7196272e27a909,0,Stig Rohde D酶ssing,2018-06-18 21:48:41+02:00,['5200cffeee608848f9f7f41005a4fbd44d7cc273'],0,11,11,5514214,2,,,,3975
2eae159fde55ecb0ddf16f6e2355b641940e6e25,0,Robert (Bobby) Evans,2018-06-19 10:30:22-05:00,['5200cffeee608848f9f7f41005a4fbd44d7cc273'],53,99,152,5514366,1,0,1,0,3975
fce4c6b3a0d37d02ce01458041b07b99f8827f2e,0,Robert (Bobby) Evans,2018-06-19 12:56:51-05:00,['2eae159fde55ecb0ddf16f6e2355b641940e6e25'],80,243,323,5514689,3,0.179104478,0.179104478,0,3976
36b050766dfa772ee6a4d97dcee2f3c6e3979d17,0,Stig Rohde D酶ssing,2018-06-19 20:16:50+02:00,['5200cffeee608848f9f7f41005a4fbd44d7cc273'],15,35,50,5514739,11,0,0,1,3976
593c453b47097208bf1218df527f50f0a7e7027b,0,Jungtaek Lim,2018-06-20 04:33:44+09:00,['5200cffeee608848f9f7f41005a4fbd44d7cc273'],44,91,135,5514874,9,0.75,1,0.875,3977
8fd3bf561ad5c92e97b4f2f86a8751de606e3b0b,0,Jungtaek Lim,2018-06-20 04:34:15+09:00,"['5200cffeee608848f9f7f41005a4fbd44d7cc273', '593c453b47097208bf1218df527f50f0a7e7027b']",44,91,135,5515009,9,,,,3977
99e0357f79f271b57d0c04e76f596dccd1f21878,0,Jungtaek Lim,2018-06-20 04:38:42+09:00,"['8fd3bf561ad5c92e97b4f2f86a8751de606e3b0b', 'f5474a5ef7f4d9e158902809cc03fcb7b06317b7']",1,1,2,5515011,1,,,,3977
49504b4e036f7688a37a19d609afb8ac9a02c01a,0,Jungtaek Lim,2018-06-20 04:54:34+09:00,"['99e0357f79f271b57d0c04e76f596dccd1f21878', '9c3831a8028f7ea3787e814b13fc4c03b96b830d']",57,40,97,5515108,1,,,,3977
e9630a5754b9b47155eb74298576077f62226492,0,Jungtaek Lim,2018-06-20 04:57:24+09:00,"['49504b4e036f7688a37a19d609afb8ac9a02c01a', 'cade93e4e3241b43700383571b6494a1f020eae5']",1,1,2,5515110,1,,,,3977
11586d0fb9dc78829c1f51d822f596b26fcde7e8,0,Jungtaek Lim,2018-06-20 05:00:58+09:00,"['e9630a5754b9b47155eb74298576077f62226492', 'e73e03aea61150fd35ca1f8bae7196272e27a909']",0,11,11,5515121,2,,,,3977
fafe4f46cb69dcb67639021a2c0ca74e3dd77852,0,Robert Evans,2018-06-20 12:34:48-05:00,"['11586d0fb9dc78829c1f51d822f596b26fcde7e8', 'fce4c6b3a0d37d02ce01458041b07b99f8827f2e']",125,334,459,5515580,3,,,,3977
7122a4e2c047e45ed026c4bafc181885dd146737,0,Jungtaek Lim,2018-06-21 12:59:08+09:00,"['fafe4f46cb69dcb67639021a2c0ca74e3dd77852', '36b050766dfa772ee6a4d97dcee2f3c6e3979d17']",15,35,50,5515630,11,,,,3977
79ce734e4d74393d1811149158782702eaab957e,0,Aaron Gresch,2018-06-21 13:45:16-05:00,['7122a4e2c047e45ed026c4bafc181885dd146737'],0,1,1,5515631,1,0,1,0,3977
b80cd70d9f1875fa199df16a4da52c5d58b245b4,0,Jing Chen,2018-06-21 11:58:13-07:00,['7122a4e2c047e45ed026c4bafc181885dd146737'],8,33,41,5515672,2,1,1,0,3977
41cf4f3224063796e49529b09bf05fe12b162a2e,0,Stig Rohde D酶ssing,2018-06-22 16:02:52+02:00,"['7122a4e2c047e45ed026c4bafc181885dd146737', 'b80cd70d9f1875fa199df16a4da52c5d58b245b4']",8,33,41,5515713,2,,,,3977
d6f8afbbced0c92eb59ba40d43b225b9139c982a,0,Robert Evans,2018-06-22 12:37:48-05:00,"['41cf4f3224063796e49529b09bf05fe12b162a2e', '79ce734e4d74393d1811149158782702eaab957e']",0,1,1,5515714,1,,,,3977
3a66a47b45de82260ed6731f5af469da11165690,0,Stig Rohde D酶ssing,2018-06-24 22:57:38+02:00,['d6f8afbbced0c92eb59ba40d43b225b9139c982a'],1,4,5,5515719,1,0,0,1,3977
e5ca0c97f31f4d2e92427c9ed2b00519985fc43c,0,Stig Rohde D酶ssing,2018-06-24 23:02:41+02:00,['d6f8afbbced0c92eb59ba40d43b225b9139c982a'],44,39,83,5515802,3,0,1,0,3977
82deb62dd3a6f58e5569244517bc93647fcab2a2,0,Jungtaek Lim,2018-06-25 09:48:38+09:00,['d6f8afbbced0c92eb59ba40d43b225b9139c982a'],3,27,30,5515832,2,1,1,1,3977
950e527d578d01f4db2c27f87b22b5ac16138d7a,0,Jungtaek Lim,2018-06-25 09:48:48+09:00,"['d6f8afbbced0c92eb59ba40d43b225b9139c982a', '82deb62dd3a6f58e5569244517bc93647fcab2a2']",3,27,30,5515862,2,,,,3977
733d58cd687517678ebb6e78890327796fd0aef6,0,Aaron Gresch,2018-06-25 13:04:25-05:00,['7122a4e2c047e45ed026c4bafc181885dd146737'],12,649,661,5516523,7,0.540865385,0.552884615,0.966346154,3979
21bb1388414d373572779289edc785c7e5aa52aa,0,Robert Evans,2018-06-25 13:33:30-05:00,"['950e527d578d01f4db2c27f87b22b5ac16138d7a', '733d58cd687517678ebb6e78890327796fd0aef6']",12,649,661,5517184,7,,,,3979
f876b31f4b91960b9012a679d37f04a112424a9b,0,Stig Rohde D酶ssing,2018-06-26 08:06:21+02:00,['d6f8afbbced0c92eb59ba40d43b225b9139c982a'],70,97,167,5517351,4,,,,3979
a050ee8b1987c3fc37a7ee7be4231b108c779aa4,0,Jungtaek Lim,2018-06-26 16:48:16+09:00,"['21bb1388414d373572779289edc785c7e5aa52aa', '3a66a47b45de82260ed6731f5af469da11165690']",1,4,5,5517356,1,,,,3979
69801887c324a7c6366b2dbefbada4c4e6a48c8e,0,Jungtaek Lim,2018-06-26 16:52:33+09:00,"['a050ee8b1987c3fc37a7ee7be4231b108c779aa4', 'f876b31f4b91960b9012a679d37f04a112424a9b']",70,97,167,5517523,4,,,,3979
d8807671627ee4add1bbe67e6ae19adbf8515938,0,Robert Evans,2018-06-27 12:03:27-05:00,"['69801887c324a7c6366b2dbefbada4c4e6a48c8e', 'e5ca0c97f31f4d2e92427c9ed2b00519985fc43c']",44,39,83,5517606,3,,,,3979
95db8fc039d810e1a609145dc6c5c7aa52b4fbab,0,Robert (Bobby) Evans,2018-06-27 13:15:46-05:00,['d8807671627ee4add1bbe67e6ae19adbf8515938'],35,25,60,5517666,3,1,0,0,3979
ffb60e0f9f756b25581df73c1061db5e9b2ad823,0,Robert (Bobby) Evans,2018-06-27 13:15:46-05:00,['95db8fc039d810e1a609145dc6c5c7aa52b4fbab'],40,51,91,5517757,5,,,,3979
86dfce168d8312361606bf51be432e046d9c3d18,0,Robert (Bobby) Evans,2018-06-27 13:15:46-05:00,['ffb60e0f9f756b25581df73c1061db5e9b2ad823'],2,2,4,5517761,1,,,,3979
f0d0b3e88297051a2b35b39f909a31fa48a05299,0,Stig Rohde D酶ssing,2018-06-27 20:21:39+02:00,['d8807671627ee4add1bbe67e6ae19adbf8515938'],11,79,90,5517851,9,,,,3980
307f01bf7c83512ca0762935d34c70ba6073b7b2,0,Zhengdai Hu,2018-06-27 15:09:54-05:00,['d8807671627ee4add1bbe67e6ae19adbf8515938'],1,1,2,5517853,1,,,,3980
dad6f1f51fdfb782510b3e95236a1a7e1f7dff6b,1,Aaron Gresch,2018-06-27 16:18:09-05:00,['d8807671627ee4add1bbe67e6ae19adbf8515938'],34,53,87,5517940,3,1,0.923076923,1,3980
a69cb004d0d1688ff1599d757d745cabb1bb4d87,0,Robert (Bobby) Evans,2018-06-28 12:39:42-05:00,['d8807671627ee4add1bbe67e6ae19adbf8515938'],7,7,14,5517954,1,,,,3980
7893f432a812fc7562de735852dfc80d0be9025f,0,Robert Evans,2018-06-28 15:09:52-05:00,"['d8807671627ee4add1bbe67e6ae19adbf8515938', 'dad6f1f51fdfb782510b3e95236a1a7e1f7dff6b']",34,53,87,5518041,3,,,,3980
10f01f49c2166c803bf6ba46f3d6bb9203a9c440,0,Robert Evans,2018-06-28 15:32:56-05:00,"['7893f432a812fc7562de735852dfc80d0be9025f', '307f01bf7c83512ca0762935d34c70ba6073b7b2']",1,1,2,5518043,1,,,,3980
5204647e0513b9c3d1180c3a5fa79d413cd86cef,0,Stig Rohde D酶ssing,2018-06-28 22:41:15+02:00,['f0d0b3e88297051a2b35b39f909a31fa48a05299'],29,41,70,5518113,2,,,,3980
aa4d93c9c3d75b12c00cbd8966f976e5ea107fbe,0,Robert (Bobby) Evans,2018-06-29 18:06:34-05:00,['10f01f49c2166c803bf6ba46f3d6bb9203a9c440'],11,206,217,5518330,4,0.525252525,0.727272727,0.777777778,3980
f05226009066263057838606da776af1fa2933c9,0,Robert (Bobby) Evans,2018-06-29 18:21:06-05:00,['10f01f49c2166c803bf6ba46f3d6bb9203a9c440'],0,8,8,5518338,2,1,1,1,3980
f964f3fb555b34c5328046ee3044b443d0f191ec,1,Stig Rohde D酶ssing,2018-06-30 11:06:29+02:00,['10f01f49c2166c803bf6ba46f3d6bb9203a9c440'],29,15,44,5518382,1,,,,3980
24a6f43670f4e2489b9d826ca518482ed17d4475,0,Robert Evans,2018-07-02 08:09:04-05:00,"['10f01f49c2166c803bf6ba46f3d6bb9203a9c440', 'f05226009066263057838606da776af1fa2933c9']",0,8,8,5518390,2,,,,3980
f57a3e415b9a28798a9c7e85f70f3a1a5212c6a4,0,Robert Evans,2018-07-02 08:15:02-05:00,"['24a6f43670f4e2489b9d826ca518482ed17d4475', '86dfce168d8312361606bf51be432e046d9c3d18']",77,78,155,5518545,9,,,,3980
1ffa9167d7520822e4776d24889c0145c0b46af8,0,Robert Evans,2018-07-02 08:41:49-05:00,"['f57a3e415b9a28798a9c7e85f70f3a1a5212c6a4', 'a69cb004d0d1688ff1599d757d745cabb1bb4d87']",7,7,14,5518559,1,,,,3980
ba7c6a85fa49b2b1dfb66351fa0ff733811c068e,0,Robert Evans,2018-07-02 09:04:33-05:00,"['1ffa9167d7520822e4776d24889c0145c0b46af8', 'f964f3fb555b34c5328046ee3044b443d0f191ec']",29,15,44,5518603,1,,,,3980
26d2f955251c0fa56520f6fe08cb35ef5171f321,0,Robert Evans,2018-07-02 09:27:50-05:00,"['ba7c6a85fa49b2b1dfb66351fa0ff733811c068e', '5204647e0513b9c3d1180c3a5fa79d413cd86cef']",34,114,148,5518751,9,,,,3980
1613206802ffa00f1b6b9ab56a741e86aeff6a5e,1,Stig Rohde D酶ssing,2018-07-02 21:56:27+02:00,['26d2f955251c0fa56520f6fe08cb35ef5171f321'],44,84,128,5518879,3,0.111111111,1,1,3980
c14a9b53f2aa68c161063a5a5e141c4eab0356bb,1,Stig Rohde D酶ssing,2018-07-04 19:41:53+02:00,['26d2f955251c0fa56520f6fe08cb35ef5171f321'],246,144,390,5519269,34,0,0,0,3980
f237f3207afa6761c1948e0b0af33175337a3924,0,Robert (Bobby) Evans,2018-07-05 11:30:12-05:00,['aa4d93c9c3d75b12c00cbd8966f976e5ea107fbe'],0,10,10,5519279,1,0,0,1,3980
f60e943a388f3e828d10237782c205781c3050bc,1,Stig Rohde D酶ssing,2018-07-05 20:20:15+02:00,['1613206802ffa00f1b6b9ab56a741e86aeff6a5e'],1,120,121,5519400,2,1,1,1,3981
db86bade005494aa26e782a3be5a64cb67ed522b,0,Stig Rohde D酶ssing,2018-07-05 20:22:38+02:00,"['26d2f955251c0fa56520f6fe08cb35ef5171f321', 'c14a9b53f2aa68c161063a5a5e141c4eab0356bb']",246,144,390,5519790,34,,,,3981
76a8e62a019a412f038bae93d74104a9fceefcc2,0,Zhengdai Hu,2018-07-05 16:37:16-05:00,['db86bade005494aa26e782a3be5a64cb67ed522b'],1,2,3,5519793,1,,,,3981
528ab30b5c49dbeae37df4cb9a97c12ee8989c01,0,Stig Rohde D酶ssing,2018-07-06 13:13:46+02:00,['db86bade005494aa26e782a3be5a64cb67ed522b'],48,73,121,5519914,6,1,1,0.9375,3981
81307a50528f71c39786cab577edafe7151d18a0,1,Zhengdai Hu,2018-07-06 16:52:17-05:00,['d8807671627ee4add1bbe67e6ae19adbf8515938'],246,392,638,5520552,11,0,0.058823529,0,3983
216ed738e5243d552ca20d2c9b13fb99c56e33e6,0,Zhengdai Hu,2018-07-06 16:52:20-05:00,['81307a50528f71c39786cab577edafe7151d18a0'],2,1,3,5520555,1,1,1,0,3983
11383c2ae08bbadb10857bf0a9dd1eb69b7d2ccc,0,Zhengdai Hu,2018-07-06 16:52:20-05:00,['216ed738e5243d552ca20d2c9b13fb99c56e33e6'],1,1,2,5520557,1,,,,3983
1ee9558d9ae356e4d332dd57c79debd89b147634,1,Raghav Kumar Gautam,2018-07-06 15:37:04-07:00,['db86bade005494aa26e782a3be5a64cb67ed522b'],0,39,39,5520596,1,0.322580645,1,1,3983
6872adfc260a9417e4dadc0e1c867476ed45bce6,0,Jungtaek Lim,2018-07-09 12:33:37+09:00,"['db86bade005494aa26e782a3be5a64cb67ed522b', '528ab30b5c49dbeae37df4cb9a97c12ee8989c01']",48,73,121,5520717,6,,,,3983
afe35f318489c86eca26064e3133e89b5591bf1f,0,Jungtaek Lim,2018-07-09 17:57:48+09:00,"['6872adfc260a9417e4dadc0e1c867476ed45bce6', '0154216c9cb489b92ab86393fa1dd2fa5de56073']",16,75,91,5520808,2,,,,3983
daec24841501c911b06fc10a5c98956e40fc1cd4,0,Jungtaek Lim,2018-07-10 06:12:23+09:00,"['afe35f318489c86eca26064e3133e89b5591bf1f', '11383c2ae08bbadb10857bf0a9dd1eb69b7d2ccc']",249,394,643,5521451,12,,,,3983
bdcf1683732e9c5cf7fae3f5297295b12b37e26d,0,Stig Rohde D酶ssing,2018-07-09 23:13:56+02:00,['10f01f49c2166c803bf6ba46f3d6bb9203a9c440'],658,582,1240,5522691,17,0.516853933,0.202247191,0.151685393,3988
da9cb54904bc196dd689c265ce8373f8b3256e8d,0,Jungtaek Lim,2018-07-10 06:24:13+09:00,"['daec24841501c911b06fc10a5c98956e40fc1cd4', '473bf84a0caef26544b8c01aecd6fb139aa51110']",1,32,33,5522724,2,,,,3988
b82ffcffa386277892c275bc31b267ef3dd6fa60,1,Stig Rohde D酶ssing,2018-07-09 23:35:40+02:00,['daec24841501c911b06fc10a5c98956e40fc1cd4'],2,25,27,5522751,2,1,1,1,3988
f6208b84c5a4eda09e18bf9ee31e12f43802f304,0,Stig Rohde D酶ssing,2018-07-09 23:35:46+02:00,['b82ffcffa386277892c275bc31b267ef3dd6fa60'],2,2,4,5522755,2,,,,3988
2e3f767353be09bf08b2c74738523acfac4a9491,0,Stig Rohde D酶ssing,2018-07-09 23:47:05+02:00,"['da9cb54904bc196dd689c265ce8373f8b3256e8d', 'f6208b84c5a4eda09e18bf9ee31e12f43802f304']",2,25,27,5522782,2,,,,3988
35d2ed49d5b367157b3f1351d23c10fcd57cd017,0,Jungtaek Lim,2018-07-10 12:47:15+09:00,"['2e3f767353be09bf08b2c74738523acfac4a9491', '76a8e62a019a412f038bae93d74104a9fceefcc2']",1,2,3,5522785,1,,,,3988
9109b617ba317dc61ce6157ecdf83e14d93488d1,0,Jungtaek Lim,2018-07-10 12:53:25+09:00,"['35d2ed49d5b367157b3f1351d23c10fcd57cd017', 'bdcf1683732e9c5cf7fae3f5297295b12b37e26d']",658,582,1240,5524025,17,,,,3988
2d7c7d31679b16a8797f39ff3f1c8df2b63952d7,0,Jungtaek Lim,2018-07-10 13:00:34+09:00,"['9109b617ba317dc61ce6157ecdf83e14d93488d1', '1ee9558d9ae356e4d332dd57c79debd89b147634']",0,39,39,5524064,1,,,,3988
ba5260774bbd436e81da14a97c072e399a70a896,0,Stig Rohde D酶ssing,2018-07-10 11:27:47+02:00,['2d7c7d31679b16a8797f39ff3f1c8df2b63952d7'],304,695,999,5525063,38,0.786163522,0.748427673,0.616352201,3992
c705eea6628504ee6c74cecf0f0e82c3356ef247,0,Robert (Bobby) Evans,2018-07-10 11:27:53-05:00,['f237f3207afa6761c1948e0b0af33175337a3924'],12,66,78,5525141,2,,,,3992
07c795af5dd398832049262d25858ecc846f4ac5,0,Robert Evans,2018-07-10 14:03:36-05:00,"['2d7c7d31679b16a8797f39ff3f1c8df2b63952d7', 'f60e943a388f3e828d10237782c205781c3050bc']",44,203,247,5525388,4,,,,3992
8cb4baf251d742e2d06bdb0f7853ea8b6783a567,1,Stig Rohde D酶ssing,2018-07-10 23:41:01+02:00,['10f01f49c2166c803bf6ba46f3d6bb9203a9c440'],31,28,59,5525447,8,0,1,0,3992
6b043d794aa38acbb51b2903651d2a66100d5215,0,Robert Evans,2018-07-10 17:26:10-05:00,"['07c795af5dd398832049262d25858ecc846f4ac5', '8cb4baf251d742e2d06bdb0f7853ea8b6783a567']",31,28,59,5525506,8,,,,3992
1768062f7b5f069a5a1b6a55218e6195f5e8f66a,0,Stig Rohde D酶ssing,2018-07-12 15:07:58+02:00,['2d7c7d31679b16a8797f39ff3f1c8df2b63952d7'],2126,785,2911,5528417,8,0.465428277,0.319917441,0.037151703,3992
e0795f12113e722726f6d05ace7db8d1c496d86d,0,Stig Rohde D酶ssing,2018-07-12 15:17:29+02:00,['1768062f7b5f069a5a1b6a55218e6195f5e8f66a'],2,0,2,5528419,1,,,,3992
96b702dfc8115918c01c68e79471460bc5b2b41a,0,Jungtaek Lim,2018-07-12 22:35:17+09:00,"['6b043d794aa38acbb51b2903651d2a66100d5215', 'c705eea6628504ee6c74cecf0f0e82c3356ef247']",23,282,305,5528724,6,,,,3992
c4ed52e79732d0026f615f00ae6be4683dbf9c74,1,Stig Rohde D酶ssing,2018-07-12 16:14:23+02:00,['2d7c7d31679b16a8797f39ff3f1c8df2b63952d7'],303,36,339,5529063,18,0.090909091,0.070707071,0.111111111,3992
efb2e9a337f9320efd7e5873e493532aa58f341c,0,Robert Evans,2018-07-12 10:41:09-05:00,"['96b702dfc8115918c01c68e79471460bc5b2b41a', 'c4ed52e79732d0026f615f00ae6be4683dbf9c74']",303,36,339,5529402,18,,,,3992
950bd1819cbef92ea12d93d2fae9324895e667a1,0,Stig Rohde D酶ssing,2018-07-12 19:30:20+02:00,['e0795f12113e722726f6d05ace7db8d1c496d86d'],17,22,39,5529441,3,,,,3992
911a0d7006ca79ec41d9a5692fbd417f1931cbb4,1,Robert (Bobby) Evans,2018-07-12 15:58:20-05:00,['efb2e9a337f9320efd7e5873e493532aa58f341c'],17,44,61,5529502,5,1,1,1,3993
63017568eb543571804d0475c975a9c5382465f9,0,Robert (Bobby) Evans,2018-07-12 16:49:04-05:00,['911a0d7006ca79ec41d9a5692fbd417f1931cbb4'],7,18,25,5529527,2,0.2,0.2,1,3993
e21110d338fe8ca71b904682be35642a00de9e78,0,Jungtaek Lim,2018-07-13 21:25:41+09:00,"['efb2e9a337f9320efd7e5873e493532aa58f341c', 'ba5260774bbd436e81da14a97c072e399a70a896']",304,695,999,5530526,38,,,,3993
bfb267e8025092e72ad0d586e50e1182b54f3242,0,Robert (Bobby) Evans,2018-07-13 08:09:02-05:00,['63017568eb543571804d0475c975a9c5382465f9'],35,4,39,5530565,2,0,0,0,3993
c9e9a7c294458c8bb1166e0646a5fa580661e21e,0,Robert Evans,2018-07-13 15:42:53-05:00,"['e21110d338fe8ca71b904682be35642a00de9e78', 'bfb267e8025092e72ad0d586e50e1182b54f3242']",24,31,55,5530620,6,,,,3993
c69a23cfe661afd7862201d94b45282e4450b9ee,1,Jungtaek Lim,2018-07-17 06:51:39+09:00,['c9e9a7c294458c8bb1166e0646a5fa580661e21e'],2963,2174,5137,5535757,87,0.572277228,0.005940594,0,4013
af42f434f4a4c3d9087c6058b359033736d3b5e8,0,Jungtaek Lim,2018-07-17 07:00:29+09:00,"['c9e9a7c294458c8bb1166e0646a5fa580661e21e', 'c69a23cfe661afd7862201d94b45282e4450b9ee']",2963,2174,5137,5540894,87,,,,4013
7f992a6b7474267691e48fd2e5a64230cda41390,0,Stig Rohde D酶ssing,2018-07-17 17:59:36+02:00,['af42f434f4a4c3d9087c6058b359033736d3b5e8'],101,158,259,5541153,8,0,1,0.777777778,4014
e58ac3e033670aeb83e8543ab7b8779227ca10d8,1,Stig Rohde D酶ssing,2018-07-18 11:01:13+02:00,['7f992a6b7474267691e48fd2e5a64230cda41390'],8111,30,8141,5549294,89,0.465798948,0.269731376,0.202436998,4014
da0bc6a75b2b395dfb8204a2f0f85ae0fe1566ec,0,Stig Rohde D酶ssing,2018-07-18 13:40:41+02:00,['af42f434f4a4c3d9087c6058b359033736d3b5e8'],3760,26,3786,5553080,37,0.2904795,0.102849201,0.234885337,4014
3883bf74c7e706d83f3d721257a285f8fdf4b969,0,Jungtaek Lim,2018-07-19 12:24:41+09:00,"['af42f434f4a4c3d9087c6058b359033736d3b5e8', '7f992a6b7474267691e48fd2e5a64230cda41390']",101,158,259,5553339,8,,,,4014
a7e817bcd1424d300ab5bad06c5d9f4729d9f347,0,Jungtaek Lim,2018-07-19 12:29:34+09:00,"['3883bf74c7e706d83f3d721257a285f8fdf4b969', 'e58ac3e033670aeb83e8543ab7b8779227ca10d8']",8111,30,8141,5561480,89,,,,4014
de59923e37911885975fc097d4313fae14ef5f37,0,Aaron Gresch,2018-07-20 16:02:43-05:00,['a7e817bcd1424d300ab5bad06c5d9f4729d9f347'],1,1,2,5561482,1,,,,4014
ab0b1a80b4d8eb85e307bfaf344ea33b7a44ec7f,0,Zhengdai Hu,2018-07-24 14:13:42-05:00,['a7e817bcd1424d300ab5bad06c5d9f4729d9f347'],9,8,17,5561499,1,0,0,0,4014
7a0fa47f76e5cdfc6a5a0b89352e191b17e74b13,0,Stig Rohde D酶ssing,2018-07-24 21:51:39+02:00,"['a7e817bcd1424d300ab5bad06c5d9f4729d9f347', 'ab0b1a80b4d8eb85e307bfaf344ea33b7a44ec7f']",9,8,17,5561516,1,,,,4014
5084c9756a4d792c4ac3a2a64e0d0ec2da8530e5,0,Hugo Louro,2018-07-24 18:42:23-07:00,['7a0fa47f76e5cdfc6a5a0b89352e191b17e74b13'],1,1,2,5561518,1,,,,4014
882cfff9f8249248ff09b5898389523512ede40b,0,Jungtaek Lim,2018-07-27 17:03:57+09:00,['a7e817bcd1424d300ab5bad06c5d9f4729d9f347'],0,1,1,5561519,1,0,0,1,4014
82961751f9c09bccd776e6ad4c67006a5a93ce65,0,Jungtaek Lim,2018-07-29 16:14:50+09:00,"['7a0fa47f76e5cdfc6a5a0b89352e191b17e74b13', '882cfff9f8249248ff09b5898389523512ede40b']",0,1,1,5561520,1,,,,4014
b9dbf8c9700c847e7d4fe0fd1e8b51b1fac9ef6c,0,Jungtaek Lim,2018-07-29 22:15:29+09:00,"['82961751f9c09bccd776e6ad4c67006a5a93ce65', '5084c9756a4d792c4ac3a2a64e0d0ec2da8530e5']",1,1,2,5561522,1,,,,4014
5f386b1da383f6b4039d81074e5ce58c191483bf,0,Jungtaek Lim,2018-07-29 22:17:42+09:00,"['b9dbf8c9700c847e7d4fe0fd1e8b51b1fac9ef6c', 'de59923e37911885975fc097d4313fae14ef5f37']",1,1,2,5561524,1,,,,4014
9cc5b72c1fae78c60061b9f3c3f3d41277ca93cf,0,Jungtaek Lim,2018-07-29 22:52:17+09:00,['5f386b1da383f6b4039d81074e5ce58c191483bf'],0,79,79,5561603,1,,,,4014
5ed30b564f37deba00318f330c2b6e2dcf731cdf,0,Mal Graty,2018-07-29 17:35:15+01:00,['9cc5b72c1fae78c60061b9f3c3f3d41277ca93cf'],8,8,16,5561619,1,,,,4014
c8896efcca5b6101942f51434d2100f45df456c6,0,Robert Evans,2018-07-30 13:01:54-05:00,"['9cc5b72c1fae78c60061b9f3c3f3d41277ca93cf', '950bd1819cbef92ea12d93d2fae9324895e667a1']",2114,776,2890,5564509,9,,,,4014
31624a2d2f9ed2df0fd37ee871e45e321735d27c,0,Robert Evans,2018-07-30 13:24:31-05:00,"['c8896efcca5b6101942f51434d2100f45df456c6', 'da0bc6a75b2b395dfb8204a2f0f85ae0fe1566ec']",3760,26,3786,5568295,37,,,,4014
146beff6a5e7f0b39147bcf8e9f798c8738c2379,0,Robert Evans,2018-07-30 13:48:16-05:00,"['31624a2d2f9ed2df0fd37ee871e45e321735d27c', '5ed30b564f37deba00318f330c2b6e2dcf731cdf']",8,8,16,5568311,1,,,,4014
eb7924a5c754e04566d6f64d57a2bc1910cac282,0,Stig Rohde D酶ssing,2018-08-01 15:11:28+02:00,['146beff6a5e7f0b39147bcf8e9f798c8738c2379'],0,4,4,5568315,1,0,1,1,4014
8fb87ed7211cfde104ca1f5a2a3689190414ae2c,0,Stig Rohde D酶ssing,2018-08-01 16:33:04+02:00,['146beff6a5e7f0b39147bcf8e9f798c8738c2379'],11,11,22,5568337,1,,,,4014
4d43947dc87d490efbcdd446a6c45f79f7d9e6ea,0,Zhengdai Hu,2018-08-02 09:56:59-05:00,['146beff6a5e7f0b39147bcf8e9f798c8738c2379'],87,39,126,5568463,6,0.024390244,0,0.146341463,4014
5ef7c1d3580f7a6ede03ecab7ca1fa6e86e03ed7,0,Stig Rohde D酶ssing,2018-08-02 19:38:44+02:00,"['146beff6a5e7f0b39147bcf8e9f798c8738c2379', '4d43947dc87d490efbcdd446a6c45f79f7d9e6ea']",87,39,126,5568589,6,,,,4014
5c6e102aa4e4d5c8f9515fa919f38130872eb18a,0,Aaron Gresch,2018-08-02 13:45:35-05:00,['146beff6a5e7f0b39147bcf8e9f798c8738c2379'],46,53,99,5568688,1,0,0,1,4014
aff667643e220d4f5353a63b9a759d1646366224,0,Robert Evans,2018-08-03 09:58:05-05:00,"['5ef7c1d3580f7a6ede03ecab7ca1fa6e86e03ed7', '5c6e102aa4e4d5c8f9515fa919f38130872eb18a']",46,53,99,5568787,1,,,,4014
05d907b8b1390e39443487fe0d6a2a185344d256,0,Zhengdai Hu,2018-08-03 10:35:11-05:00,['146beff6a5e7f0b39147bcf8e9f798c8738c2379'],4,7,11,5568798,1,0.5,1,1,4014
ec418b755e1b9828bd415fb885e8b83290459d88,0,Stig Rohde D酶ssing,2018-08-03 17:38:32+02:00,"['aff667643e220d4f5353a63b9a759d1646366224', 'eb7924a5c754e04566d6f64d57a2bc1910cac282']",0,4,4,5568802,1,,,,4014
e8dc31d34c901d50d7de6a88d845f0ca22074c22,0,Stig Rohde D酶ssing,2018-08-03 17:38:53+02:00,"['ec418b755e1b9828bd415fb885e8b83290459d88', '8fb87ed7211cfde104ca1f5a2a3689190414ae2c']",11,11,22,5568824,1,,,,4014
674a7cb4a1bae26b30a87b0d3d5204c48cd13ebe,0,Stig Rohde D酶ssing,2018-08-03 17:39:39+02:00,"['e8dc31d34c901d50d7de6a88d845f0ca22074c22', '05d907b8b1390e39443487fe0d6a2a185344d256']",4,7,11,5568835,1,,,,4014
fe94434a48f4f5e4f3812f6787117fa2b57e6d5d,1,Zhengdai Hu,2018-08-03 10:43:07-05:00,['146beff6a5e7f0b39147bcf8e9f798c8738c2379'],68,92,160,5568995,3,1,1,1,4015
d644636096c37fb7cace1b6823453d398f0a7024,0,Robert Evans,2018-08-03 10:49:17-05:00,"['674a7cb4a1bae26b30a87b0d3d5204c48cd13ebe', 'fe94434a48f4f5e4f3812f6787117fa2b57e6d5d']",68,92,160,5569155,3,,,,4015
034ac677eb486a5bd07da28246d7682730cb5072,1,Govind Menon,2018-08-03 15:13:10-05:00,['d644636096c37fb7cace1b6823453d398f0a7024'],2084,3613,5697,5574852,107,0.512970169,0.815823606,0.509079118,4026
1828a17e553927419d380203055803647aab2aa1,0,Robert Evans,2018-08-03 15:14:30-05:00,"['d644636096c37fb7cace1b6823453d398f0a7024', '034ac677eb486a5bd07da28246d7682730cb5072']",2084,3613,5697,5580549,107,,,,4026
d86ef7d2d5f21d5e4f29fce97a681f33c4ffa0ad,0,David DeMar,2018-08-05 22:47:50-04:00,['146beff6a5e7f0b39147bcf8e9f798c8738c2379'],53,187,240,5580789,3,0.557377049,1,0.950819672,4027
fdfeb14166301fed82b045f41934b693e95577c4,0,Jungtaek Lim,2018-08-06 22:07:53+09:00,['1828a17e553927419d380203055803647aab2aa1'],1,1,2,5580791,1,,,,4027
4bc28e7e8ecd13ed7c0a7276927014be1b0dbaff,0,Stig Rohde D酶ssing,2018-08-06 15:54:19+02:00,"['1828a17e553927419d380203055803647aab2aa1', 'd86ef7d2d5f21d5e4f29fce97a681f33c4ffa0ad']",53,187,240,5581031,3,,,,4027
88ba5f6cb042bd6bb7f499ea7f95749b2a3f96e7,0,Zhengdai Hu,2018-08-06 10:50:53-05:00,['4bc28e7e8ecd13ed7c0a7276927014be1b0dbaff'],21,40,61,5581092,2,1,1,1,4027
73382d9ecee7dc193070ec136b34ea9ac568b20d,0,Stig Rohde D酶ssing,2018-08-06 18:06:40+02:00,"['4bc28e7e8ecd13ed7c0a7276927014be1b0dbaff', '88ba5f6cb042bd6bb7f499ea7f95749b2a3f96e7']",21,40,61,5581153,2,,,,4027
ecec9cf52e61ffd889e51309b1bc2c1df99d7366,0,Govind Menon,2018-08-06 15:44:57-05:00,['73382d9ecee7dc193070ec136b34ea9ac568b20d'],2,2,4,5581157,2,,,,4027
66a1aa34141aa6f5b8b04c73935fd140cf47987e,0,Govind Menon,2018-08-07 15:37:56-05:00,['73382d9ecee7dc193070ec136b34ea9ac568b20d'],1,1,2,5581159,1,,,,4027
bc1078d9114da5840c133a56ffda5e1d917b023d,0,Govind Menon,2018-08-07 17:38:23-05:00,['73382d9ecee7dc193070ec136b34ea9ac568b20d'],14,12,26,5581185,1,1,1,0,4027
422f2255732c7c01e905327cbc81fc3827b045fe,1,Zhengdai Hu,2018-08-08 10:03:19-05:00,['73382d9ecee7dc193070ec136b34ea9ac568b20d'],125,541,666,5581851,20,0.558823529,0.897058824,0.889705882,4034
c9efe3be960b3144f0b64954b94f249cfbe50b2a,0,Ethan Li,2018-08-08 10:10:25-05:00,"['73382d9ecee7dc193070ec136b34ea9ac568b20d', '422f2255732c7c01e905327cbc81fc3827b045fe']",125,541,666,5582517,20,,,,4034
e270a1eeab20d794dcc60a697c440b65b03aecc2,0,Jungtaek Lim,2018-08-10 19:26:33+09:00,"['c9efe3be960b3144f0b64954b94f249cfbe50b2a', 'fdfeb14166301fed82b045f41934b693e95577c4']",1,1,2,5582519,1,,,,4034
44cf25fa9987b8f91f0147580ab245d73de51928,0,Jungtaek Lim,2018-08-10 19:27:01+09:00,"['e270a1eeab20d794dcc60a697c440b65b03aecc2', 'ecec9cf52e61ffd889e51309b1bc2c1df99d7366']",2,2,4,5582523,2,,,,4034
70e379f7beef92ec6292119161ade8f4b3d20bdd,0,Jungtaek Lim,2018-08-10 19:27:24+09:00,"['44cf25fa9987b8f91f0147580ab245d73de51928', '66a1aa34141aa6f5b8b04c73935fd140cf47987e']",1,1,2,5582525,1,,,,4034
16e500844481aaf8179ea786d00030b1f18729b0,0,Jungtaek Lim,2018-08-10 19:27:46+09:00,"['70e379f7beef92ec6292119161ade8f4b3d20bdd', 'bc1078d9114da5840c133a56ffda5e1d917b023d']",14,12,26,5582551,1,,,,4034
bf81b6840dba16b506187c53448db8e09a6a9f14,1,Zhengdai Hu,2018-08-10 12:01:36-05:00,['c9efe3be960b3144f0b64954b94f249cfbe50b2a'],259,722,981,5583532,22,0.146551724,0.836206897,0.887931034,4037
154173a70fb0e1b11c08be9b4499c811c30163f1,0,Ethan Li,2018-08-10 12:11:56-05:00,"['16e500844481aaf8179ea786d00030b1f18729b0', 'bf81b6840dba16b506187c53448db8e09a6a9f14']",259,722,981,5584513,22,,,,4037
078e8cc239788bbec14a0e38492ed683341af7dc,0,Govind Menon,2018-08-10 17:25:05-05:00,['16e500844481aaf8179ea786d00030b1f18729b0'],25,24,49,5584562,1,,,,4037
9d36724e88f54ae48fd892b001eeb76313adc9da,1,Arun Mahadevan,2018-08-10 17:41:19-07:00,['154173a70fb0e1b11c08be9b4499c811c30163f1'],7,81,88,5584650,10,0.939393939,0.96969697,0.939393939,4037
c2931dab720a2f6dcafa80a2a771c970302dca86,0,Jungtaek Lim,2018-08-11 20:55:44+09:00,"['154173a70fb0e1b11c08be9b4499c811c30163f1', '078e8cc239788bbec14a0e38492ed683341af7dc']",25,24,49,5584699,1,,,,4037
0fe39c8844f1d7e508b4f314942e26ee66bb503b,0,Arun Mahadevan,2018-08-11 10:28:55-07:00,['9d36724e88f54ae48fd892b001eeb76313adc9da'],19,33,52,5584751,5,1,1,1,4037
3358effa636d7e405971f3dc0ab19ed9ec8ae76d,1,Arun Mahadevan,2018-08-11 20:58:49-07:00,['0fe39c8844f1d7e508b4f314942e26ee66bb503b'],33,19,52,5584803,5,0,0,0,4037
c12ddb3f7d6c28a35bd4c90b0df48f48715c3f6e,0,Arun Mahadevan,2018-08-11 21:15:10-07:00,['3358effa636d7e405971f3dc0ab19ed9ec8ae76d'],11,5,16,5584819,5,1,1,1,4037
4c42ee3d259d5d90a4e7d3445d1c119601eec6c7,0,Jungtaek Lim,2018-08-14 23:24:04+09:00,"['c2931dab720a2f6dcafa80a2a771c970302dca86', 'c12ddb3f7d6c28a35bd4c90b0df48f48715c3f6e']",8,76,84,5584903,10,,,,4037
cac56053b40c888cc7e448f2b525c7baea419205,0,Aaron Gresch,2018-08-14 13:06:47-05:00,['4c42ee3d259d5d90a4e7d3445d1c119601eec6c7'],1,1,2,5584905,1,,,,4037
5aff46584b8ee22fa8e80ef47f9cc385e5f11e14,0,Jacob Tolar,2018-08-15 16:46:10-05:00,['4c42ee3d259d5d90a4e7d3445d1c119601eec6c7'],3,4,7,5584912,1,0,1,1,4037
88d19b09846838715218cfcb30fe72b6b906b546,0,Stig Rohde D酶ssing,2018-08-16 18:54:01+02:00,"['4c42ee3d259d5d90a4e7d3445d1c119601eec6c7', 'cac56053b40c888cc7e448f2b525c7baea419205']",1,1,2,5584914,1,,,,4037
806bb11ca26b5caa41c6d0ef7c4658855219cec3,0,Stig Rohde D酶ssing,2018-08-16 20:04:11+02:00,['88d19b09846838715218cfcb30fe72b6b906b546'],135,0,135,5585049,4,0.666666667,0.666666667,0.666666667,4037
8bbee40c3c2426aea9028290296cd758c3a3b567,0,Jing Chen,2018-08-17 18:41:57-07:00,['88d19b09846838715218cfcb30fe72b6b906b546'],44,97,141,5585190,23,0.8,1,1,4037
2875c838a9577ca81e119de6601a0f5d0184b663,0,Jungtaek Lim,2018-08-20 14:12:26+09:00,"['88d19b09846838715218cfcb30fe72b6b906b546', '5aff46584b8ee22fa8e80ef47f9cc385e5f11e14']",3,4,7,5585197,1,,,,4037
518f9470312170525fb50cc614a157547514b9b5,0,Jungtaek Lim,2018-08-20 14:16:03+09:00,"['2875c838a9577ca81e119de6601a0f5d0184b663', '8bbee40c3c2426aea9028290296cd758c3a3b567']",44,97,141,5585338,23,,,,4037
04f75bfad131ac2be4450433231814f3eba25717,0,Aaron Gresch,2018-08-21 14:32:16-05:00,['518f9470312170525fb50cc614a157547514b9b5'],1,1,2,5585340,1,,,,4037
dd90dcadd63c579838e32090c491c9192a9105c5,1,Robert (Bobby) Evans,2018-08-22 11:09:09-05:00,['518f9470312170525fb50cc614a157547514b9b5'],48,64,112,5585452,5,1,0,0,4037
2f399579d2ab990946b0b7a5b36c9b0340019c82,0,Jungtaek Lim,2018-08-23 22:40:32+09:00,"['518f9470312170525fb50cc614a157547514b9b5', '04f75bfad131ac2be4450433231814f3eba25717']",1,1,2,5585454,1,,,,4037
47575ec6f0a5f3d1bf7dfb6153e9827bc8791e84,0,Robert Evans,2018-08-23 08:47:26-05:00,"['2f399579d2ab990946b0b7a5b36c9b0340019c82', 'dd90dcadd63c579838e32090c491c9192a9105c5']",48,64,112,5585566,5,,,,4037
aa6bc4d2cc49a36f65dcf9c4792c426f17fff069,0,Robert Evans,2018-08-24 14:37:45-05:00,"['47575ec6f0a5f3d1bf7dfb6153e9827bc8791e84', '806bb11ca26b5caa41c6d0ef7c4658855219cec3']",135,0,135,5585701,4,,,,4037
9f815caafe82164e1b22ddfacdc227f28cb4afad,0,Kishor Patil,2018-08-28 12:34:52-04:00,['aa6bc4d2cc49a36f65dcf9c4792c426f17fff069'],2,2,4,5585705,1,,,,4037
2d2e80bfd531e86fb0a1c7c7bdd4ce238f31108d,0,Govind Menon,2018-08-28 17:03:46-05:00,['aa6bc4d2cc49a36f65dcf9c4792c426f17fff069'],4,33,37,5585742,1,0,1,1,4037
91458a32cded87fb64dbb1b22db8059edd6af99d,0,Aaron Gresch,2018-08-29 12:42:55-05:00,['aa6bc4d2cc49a36f65dcf9c4792c426f17fff069'],4,6,10,5585752,1,1,1,1,4037
066c967990002d553d1f2239b43051412171c359,0,Robert Evans,2018-08-30 10:31:16-05:00,"['aa6bc4d2cc49a36f65dcf9c4792c426f17fff069', '2d2e80bfd531e86fb0a1c7c7bdd4ce238f31108d']",4,33,37,5585789,1,,,,4037
3274324a237403aebca2e2b2d6d4d2b3a7dac4c4,1,Robert (Bobby) Evans,2018-08-30 10:42:46-05:00,['aa6bc4d2cc49a36f65dcf9c4792c426f17fff069'],18,41,59,5585848,3,0.076923077,0.538461538,0.923076923,4037
288eb7fad97adea12c69bc610c30fb9bf7807fd2,0,Robert Evans,2018-08-30 10:56:19-05:00,"['066c967990002d553d1f2239b43051412171c359', '9f815caafe82164e1b22ddfacdc227f28cb4afad']",2,2,4,5585852,1,,,,4037
26bfefb258282ab90b1577dd332c0d4e5cef87a8,0,Aaron Gresch,2018-08-30 11:36:12-05:00,['91458a32cded87fb64dbb1b22db8059edd6af99d'],0,2,2,5585854,1,1,1,1,4037
cd3e471407495702d87e9f3f0f416cfa451a7f09,1,Robert (Bobby) Evans,2018-08-30 12:20:32-05:00,['3274324a237403aebca2e2b2d6d4d2b3a7dac4c4'],18,18,36,5585890,3,,,,4037
8df4ce27c1c689bd1e0d1e771b2506f2e05dbefc,0,GitHub,2018-08-31 14:34:28-05:00,['288eb7fad97adea12c69bc610c30fb9bf7807fd2'],1,1,2,5585892,1,,,,4037
c179ea7ea1d7619d2a377f9961a9d45d47c3fbfe,0,Aaron Gresch,2018-09-04 09:12:49-05:00,['288eb7fad97adea12c69bc610c30fb9bf7807fd2'],1,1,2,5585894,1,,,,4037
8ea2679d47dd14443f44944fed98b9e7b6c6c516,0,Robert Evans,2018-09-04 15:01:40-05:00,"['288eb7fad97adea12c69bc610c30fb9bf7807fd2', '8df4ce27c1c689bd1e0d1e771b2506f2e05dbefc']",1,1,2,5585896,1,,,,4037
88fc18b2f2d031e9915b852e16cd406fbc21a91e,0,Robert Evans,2018-09-04 15:25:11-05:00,"['8ea2679d47dd14443f44944fed98b9e7b6c6c516', '26bfefb258282ab90b1577dd332c0d4e5cef87a8']",4,8,12,5585908,1,,,,4037
17a69e001dac77108b32a71b13296167ae607130,0,Robert Evans,2018-09-04 15:48:03-05:00,"['88fc18b2f2d031e9915b852e16cd406fbc21a91e', 'cd3e471407495702d87e9f3f0f416cfa451a7f09']",18,41,59,5585967,3,,,,4037
ffb7351f9c3a38b33e9b0eefa150c74a0933da89,0,Ethan Li,2018-09-05 08:50:14-05:00,['17a69e001dac77108b32a71b13296167ae607130'],1,49,50,5586017,3,0.3125,1,1,4037
26a6c878ce368ddba026a2977f484523a70f3d56,0,Ethan Li,2018-09-05 14:31:07-05:00,['17a69e001dac77108b32a71b13296167ae607130'],2,3,5,5586022,1,0,1,1,4037
4300e944a0d453191c23ef4d818956a8f84eb5f0,0,Robert (Bobby) Evans,2018-09-06 10:57:05-05:00,['17a69e001dac77108b32a71b13296167ae607130'],25,194,219,5586241,3,0.294117647,0.294117647,0.382352941,4038
b99982ef3518ffbd502e0e43d57030dfc090ec32,0,Robert Evans,2018-09-06 11:57:31-05:00,"['17a69e001dac77108b32a71b13296167ae607130', 'c179ea7ea1d7619d2a377f9961a9d45d47c3fbfe']",1,1,2,5586243,1,,,,4038
7da6d6ab5cdc6cc9de137a9623acbb6edc4da73d,0,Robert Evans,2018-09-06 12:22:49-05:00,"['b99982ef3518ffbd502e0e43d57030dfc090ec32', 'ffb7351f9c3a38b33e9b0eefa150c74a0933da89']",1,49,50,5586293,3,,,,4038
bc06df529721e0684abc335b7868092c9ab0773c,0,Robert Evans,2018-09-07 09:18:33-05:00,"['7da6d6ab5cdc6cc9de137a9623acbb6edc4da73d', '26a6c878ce368ddba026a2977f484523a70f3d56']",2,3,5,5586298,1,,,,4038
e39988646d9ed3e96d129c85b65a0ddeb4233910,1,Robert (Bobby) Evans,2018-09-07 16:06:08-05:00,['7da6d6ab5cdc6cc9de137a9623acbb6edc4da73d'],37,295,332,5586630,11,0.595419847,0.595419847,0.954198473,4039
c7d9d68ade30ffa241a2688ce6552d6a2e18745d,0,Robert Evans,2018-09-07 16:09:44-05:00,"['bc06df529721e0684abc335b7868092c9ab0773c', '4300e944a0d453191c23ef4d818956a8f84eb5f0']",25,194,219,5586849,3,,,,4039
f2ced23fa4e3f699558663baef4ee582ee148fa2,0,Robert Evans,2018-09-07 16:10:43-05:00,['c7d9d68ade30ffa241a2688ce6552d6a2e18745d'],2,2,4,5586853,1,,,,4039
0ab866c911b906071865410c03446673a4f07862,0,Jing Chen,2018-09-08 01:34:52-07:00,['f2ced23fa4e3f699558663baef4ee582ee148fa2'],16,16,32,5586885,10,,,,4039
e6ff07180a9fb209c56bf38dc2eaf68f09a572a6,0,Robert Evans,2018-09-10 11:07:48-05:00,"['f2ced23fa4e3f699558663baef4ee582ee148fa2', 'e39988646d9ed3e96d129c85b65a0ddeb4233910']",37,295,332,5587217,11,,,,4039
60634d32acb89482c9524f7ab5a029dc5b8b1163,0,Robert Evans,2018-09-10 12:08:44-05:00,"['e6ff07180a9fb209c56bf38dc2eaf68f09a572a6', '0ab866c911b906071865410c03446673a4f07862']",16,16,32,5587249,10,,,,4039
620ccf9c1d8d2205182bcd6b595529f5c6a5df8d,0,Jacob Tolar,2018-09-10 12:28:36-05:00,['e6ff07180a9fb209c56bf38dc2eaf68f09a572a6'],10,26,36,5587285,4,0,0,0,4039
8f9061a1b7c56499a42bcb406a11287955cfce73,0,Robert Evans,2018-09-10 12:36:05-05:00,"['60634d32acb89482c9524f7ab5a029dc5b8b1163', '620ccf9c1d8d2205182bcd6b595529f5c6a5df8d']",10,26,36,5587321,4,,,,4039
45fc760dc0211253add9ed5d6219104ac8342715,0,Ethan Li,2018-09-11 10:44:03-05:00,['8f9061a1b7c56499a42bcb406a11287955cfce73'],4,12,16,5587337,3,1,1,1,4039
38d59713486e1d74edae92e1577bf2d0b3942b22,0,Robert (Bobby) Evans,2018-09-11 10:49:54-05:00,['8f9061a1b7c56499a42bcb406a11287955cfce73'],43,47,90,5587427,2,0,0,0,4039
da554572000b802681876fd6ec5e9d12359675c8,0,Kishor Patil,2018-09-11 15:34:25-04:00,['8f9061a1b7c56499a42bcb406a11287955cfce73'],10,32,42,5587469,6,0,0,1,4039
0d7b97570b2da2a5b9145e0cacf24a6fa8108c99,0,Robert (Bobby) Evans,2018-09-11 15:23:29-05:00,['8f9061a1b7c56499a42bcb406a11287955cfce73'],281,428,709,5588178,8,1,1,1,4039
14965c706c04686b8bc9f376c17f63c1cc82e208,0,Govind Menon,2018-09-12 11:07:33-05:00,['8f9061a1b7c56499a42bcb406a11287955cfce73'],4,2,6,5588184,1,1,0,1,4039
f3c14378e4ef48e1516242acd2fd24d287702e98,0,Robert Evans,2018-09-12 16:13:46-05:00,"['8f9061a1b7c56499a42bcb406a11287955cfce73', '45fc760dc0211253add9ed5d6219104ac8342715']",4,12,16,5588200,3,,,,4039
a805c70b210f47cb4a5192a6692888637a81f654,1,Govind Menon,2018-09-12 16:57:08-05:00,['8f9061a1b7c56499a42bcb406a11287955cfce73'],19,361,380,5588580,1,0.239669421,1,0.376033058,4039
a5384aa845496a7e584bd947cace968a18b7ffdf,1,Arun Mahadevan,2018-09-12 15:37:52-07:00,['f3c14378e4ef48e1516242acd2fd24d287702e98'],2,3,5,5588585,1,,,,4039
5a1539fdad4ae4300d64e8afbd7008be36f4e9b7,0,Robert Evans,2018-09-13 12:51:07-05:00,"['f3c14378e4ef48e1516242acd2fd24d287702e98', '38d59713486e1d74edae92e1577bf2d0b3942b22']",43,47,90,5588675,2,,,,4039
a35459d98c2c7e24d7acb5f9b90e925b1bb22be7,0,Govind Menon,2018-09-13 13:04:53-05:00,['a805c70b210f47cb4a5192a6692888637a81f654'],9,68,77,5588752,4,,,,4039
6d58e63eb085ef21adf9170fbc3e9eb93db0c621,0,Robert (Bobby) Evans,2018-09-13 13:35:47-05:00,['f3c14378e4ef48e1516242acd2fd24d287702e98'],1,1,2,5588754,1,,,,4039
834eb107e1024626daf90e34dc041ab544770380,0,Robert Evans,2018-09-13 13:37:49-05:00,"['5a1539fdad4ae4300d64e8afbd7008be36f4e9b7', 'da554572000b802681876fd6ec5e9d12359675c8']",10,32,42,5588796,6,,,,4039
5b0afe2fc8c12a5815da4c2dc2b85b91a96f15d9,0,Robert Evans,2018-09-13 14:06:56-05:00,"['834eb107e1024626daf90e34dc041ab544770380', '0d7b97570b2da2a5b9145e0cacf24a6fa8108c99']",281,428,709,5589505,8,,,,4039
66ce42a5620bda5a26b510cf8bde131ecb4c811e,0,Kishor Patil,2018-09-13 15:19:54-04:00,['8f9061a1b7c56499a42bcb406a11287955cfce73'],6,8,14,5589519,2,,,,4039
a1e6e98c6b7dab0005d56af8d17525bd6a90c314,0,Robert Evans,2018-09-13 14:31:04-05:00,"['5b0afe2fc8c12a5815da4c2dc2b85b91a96f15d9', '14965c706c04686b8bc9f376c17f63c1cc82e208']",4,2,6,5589525,1,,,,4039
f5a410ba34374023b89876b310a95c3be9dd1c3c,0,Robert Evans,2018-09-13 14:53:30-05:00,"['a1e6e98c6b7dab0005d56af8d17525bd6a90c314', 'a35459d98c2c7e24d7acb5f9b90e925b1bb22be7']",21,422,443,5589968,4,,,,4039
9f77b88e6151da367f34e6825fe82b063e1eaa95,0,roshannaik,2018-09-14 02:24:32-07:00,['f5a410ba34374023b89876b310a95c3be9dd1c3c'],1,1,2,5589970,1,,,,4039
ceabe3613cd1ccdc5419b5da5fcab4ff988f305b,0,Robert (Bobby) Evans,2018-09-14 11:58:46-05:00,['f5a410ba34374023b89876b310a95c3be9dd1c3c'],1,2,3,5589973,1,,,,4039
fdab9f5163ad5b56049fe4d51c7a0542048c3873,0,Robert (Bobby) Evans,2018-09-14 12:32:19-05:00,['f5a410ba34374023b89876b310a95c3be9dd1c3c'],1,1,2,5589975,1,,,,4039
0f89cd8ab29f7db4ceed9afee4a329ff756ce3d4,0,Robert Evans,2018-09-14 12:43:02-05:00,"['f5a410ba34374023b89876b310a95c3be9dd1c3c', 'a5384aa845496a7e584bd947cace968a18b7ffdf']",2,3,5,5589980,1,,,,4039
4605ae0a34858309171e726e1924b9a37695c977,0,Robert Evans,2018-09-14 13:11:20-05:00,"['0f89cd8ab29f7db4ceed9afee4a329ff756ce3d4', '6d58e63eb085ef21adf9170fbc3e9eb93db0c621']",1,1,2,5589982,1,,,,4039
0e765f89e674f7e0a05746f5cce8ace193180837,0,Stig Rohde D酶ssing,2018-09-16 13:23:30+02:00,['4605ae0a34858309171e726e1924b9a37695c977'],1038,0,1038,5591020,1,,,,4039
26cb516f7e0ae233a0c8a0e7daebf372c240de1d,0,Robert Evans,2018-09-17 10:29:55-05:00,"['4605ae0a34858309171e726e1924b9a37695c977', 'fdab9f5163ad5b56049fe4d51c7a0542048c3873']",1,1,2,5591022,1,,,,4039
4ae59104e6995779577c8479b12f1fcc96bbda3d,0,Robert Evans,2018-09-17 10:30:29-05:00,['26cb516f7e0ae233a0c8a0e7daebf372c240de1d'],1,1,2,5591024,1,,,,4039
80104fa457ec9e93eaeefb483da5e06a2ebdfd11,0,Robert Evans,2018-09-17 11:09:26-05:00,"['4ae59104e6995779577c8479b12f1fcc96bbda3d', '0e765f89e674f7e0a05746f5cce8ace193180837']",1038,0,1038,5592062,1,,,,4039
dc70ffdba026180f434997a87ed3434c409eb237,0,Robert Evans,2018-09-17 11:10:38-05:00,"['80104fa457ec9e93eaeefb483da5e06a2ebdfd11', 'ceabe3613cd1ccdc5419b5da5fcab4ff988f305b']",1,2,3,5592065,1,,,,4039
7607778bb5387a98f2e0bf5cb0c70e69c967d137,0,Robert (Bobby) Evans,2018-09-17 11:29:29-05:00,['4605ae0a34858309171e726e1924b9a37695c977'],7,172,179,5592244,7,0,0.457364341,0.914728682,4039
37d22b8df999c5293bd1f4eea6f10b809c3c2f87,0,Robert Evans,2018-09-17 12:11:56-05:00,"['dc70ffdba026180f434997a87ed3434c409eb237', '9f77b88e6151da367f34e6825fe82b063e1eaa95']",1,1,2,5592246,1,,,,4039
5c47b2d7c1f3628c892e16b4d0f2dc78beddbb28,1,Aaron Gresch,2018-09-17 12:58:31-05:00,['dc70ffdba026180f434997a87ed3434c409eb237'],5,50,55,5592301,4,1,1,1,4039
8c90f12dda92eb7b7f93d3d9286ba6035e07127f,1,Stig Rohde D酶ssing,2018-09-17 20:14:16+02:00,['dc70ffdba026180f434997a87ed3434c409eb237'],1033,1434,2467,5594768,101,0.003731343,0.78358209,0.156716418,4043
13e4f84e0c6ff1c8c3058db646666e6e615942ee,0,Kishor Patil,2018-09-17 14:45:16-04:00,"['66ce42a5620bda5a26b510cf8bde131ecb4c811e', '37d22b8df999c5293bd1f4eea6f10b809c3c2f87']",1407,951,2358,5597126,27,,,,4043
02428594b53801572f657f4d0bff85b2213b3723,0,Stig Rohde D酶ssing,2018-09-17 21:27:33+02:00,['8c90f12dda92eb7b7f93d3d9286ba6035e07127f'],31,260,291,5597417,1,0.169934641,0.862745098,0.993464052,4043
eaed3cbf3610bbefb9466f2c40db1e0e2a20ca9c,0,Robert Evans,2018-09-17 14:31:28-05:00,"['37d22b8df999c5293bd1f4eea6f10b809c3c2f87', '8c90f12dda92eb7b7f93d3d9286ba6035e07127f']",1033,1434,2467,5599884,101,,,,4043
8b0b7fe3ab75bef87cb1723205c54df58c8279d4,0,Kishor Patil,2018-09-17 15:44:31-04:00,['13e4f84e0c6ff1c8c3058db646666e6e615942ee'],5,1,6,5599890,2,,,,4043
9d3feb0e18a96a90cdce9c2ff1727c9c9ecca4a1,0,Robert (Bobby) Evans,2018-09-17 14:56:56-05:00,['eaed3cbf3610bbefb9466f2c40db1e0e2a20ca9c'],527,681,1208,5601098,12,1,1,1,4045
15a62dde69d1a39993268ba23383dcc87a328d6b,0,Robert (Bobby) Evans,2018-09-17 14:56:56-05:00,['9d3feb0e18a96a90cdce9c2ff1727c9c9ecca4a1'],392,378,770,5601868,6,0.533333333,0,0.066666667,4045
4c1ba85a6d1547ce2424902dca9aed8856ddbf69,0,Robert (Bobby) Evans,2018-09-17 15:01:41-05:00,['15a62dde69d1a39993268ba23383dcc87a328d6b'],1,1,2,5601870,1,,,,4045
83fea15d7bf240453d35a18958bece29df5489c9,0,Robert Evans,2018-09-17 15:02:58-05:00,"['eaed3cbf3610bbefb9466f2c40db1e0e2a20ca9c', '4c1ba85a6d1547ce2424902dca9aed8856ddbf69']",821,961,1782,5603652,12,,,,4045
392803c9bb2fe81a5df57f695a0e6d7c37bd1f2e,0,Stig Rohde D酶ssing,2018-09-17 22:47:33+02:00,['02428594b53801572f657f4d0bff85b2213b3723'],35,50,85,5603737,2,0.8,1,1,4045
b9e841d11bcaa7d2cc9673396a95948a508e0853,0,Robert Evans,2018-09-17 15:53:33-05:00,"['83fea15d7bf240453d35a18958bece29df5489c9', '8b0b7fe3ab75bef87cb1723205c54df58c8279d4']",5,3,8,5603745,2,,,,4045
0cc1ec486fe851790469490a6283a944aadcdd4d,0,Robert (Bobby) Evans,2018-09-18 11:28:29-05:00,['b9e841d11bcaa7d2cc9673396a95948a508e0853'],1,1,2,5603747,1,,,,4045
5bd07de48b7ae5be2ce0f59f2d96eaec22b2e001,0,Robert (Bobby) Evans,2018-09-18 11:28:29-05:00,['0cc1ec486fe851790469490a6283a944aadcdd4d'],0,34,34,5603781,3,,,,4045
8c817e81f942bd9f01752b776de25aba65b640aa,0,Robert Evans,2018-09-18 12:05:25-05:00,"['b9e841d11bcaa7d2cc9673396a95948a508e0853', '7607778bb5387a98f2e0bf5cb0c70e69c967d137']",7,172,179,5603960,7,,,,4045
028589cabe85f2fcb76909ea891c52df092600b1,0,Robert Evans,2018-09-18 14:32:32-05:00,"['8c817e81f942bd9f01752b776de25aba65b640aa', '5c47b2d7c1f3628c892e16b4d0f2dc78beddbb28']",5,50,55,5604015,4,,,,4045
6d0f2ebd2ffb728a1e9292455ac642665796a2ea,0,Robert Evans,2018-09-18 14:35:35-05:00,['028589cabe85f2fcb76909ea891c52df092600b1'],4,4,8,5604023,2,,,,4045
b1a535de35b8813a84d1cf6d95bc811fa0a58381,0,Robert (Bobby) Evans,2018-09-18 17:03:39-05:00,['6d0f2ebd2ffb728a1e9292455ac642665796a2ea'],3,11,14,5604037,1,0,1,1,4045
e3cdca429a67da09a028fe39981a4c5f868e420d,0,Robert (Bobby) Evans,2018-09-19 08:47:49-05:00,['b1a535de35b8813a84d1cf6d95bc811fa0a58381'],1,1,2,5604039,1,,,,4045
839071367754338b83096e9d1f908f859e9d5493,1,Robert (Bobby) Evans,2018-09-19 10:05:23-05:00,['6d0f2ebd2ffb728a1e9292455ac642665796a2ea'],4,16,20,5604059,2,0,0.7,0.4,4045
7ec618c10b95392fa9a033e360f1b2ac035b05ad,0,Robert Evans,2018-09-19 12:52:53-05:00,"['6d0f2ebd2ffb728a1e9292455ac642665796a2ea', '392803c9bb2fe81a5df57f695a0e6d7c37bd1f2e']",31,275,306,5604365,2,,,,4045
8896502d775531f2a313787a82ea78ee707ef1d9,0,Robert Evans,2018-09-19 13:25:18-05:00,"['7ec618c10b95392fa9a033e360f1b2ac035b05ad', '5bd07de48b7ae5be2ce0f59f2d96eaec22b2e001']",1,35,36,5604401,4,,,,4045
f89349ca83662d088f02a3ea1382109982d8cf06,0,Robert (Bobby) Evans,2018-09-19 13:54:12-05:00,['839071367754338b83096e9d1f908f859e9d5493'],4,5,9,5604410,2,,,,4045
f72ef8331ad59d5e47b01a01e3cf62e3ae6ad5c7,0,Robert Evans,2018-09-20 10:14:52-05:00,"['8896502d775531f2a313787a82ea78ee707ef1d9', 'e3cdca429a67da09a028fe39981a4c5f868e420d']",3,11,14,5604424,1,,,,4045
b2a1a5872bf78d516417b326f06f85774b0c4d48,0,Robert Evans,2018-09-20 12:27:41-05:00,"['f72ef8331ad59d5e47b01a01e3cf62e3ae6ad5c7', 'f89349ca83662d088f02a3ea1382109982d8cf06']",5,18,23,5604447,2,,,,4045
70dd313e2be5c6ea6ca7d30fbdb05960cc3c6b33,1,Robert (Bobby) Evans,2018-09-20 15:56:25-05:00,['b2a1a5872bf78d516417b326f06f85774b0c4d48'],132,397,529,5604976,8,0.631578947,0,0.881578947,4047
e736c4b44e94723be4c1efc06e4e9d2e9bd0314a,0,P. Taylor Goetz,2018-09-20 18:17:31-04:00,"['9f72f8b47869a312941ffe6331ac2b6f2ee5aeff', 'b2a1a5872bf78d516417b326f06f85774b0c4d48']",138841,121728,260569,5865545,2323,,,,4047
1f1fb0a129a2bbf3a5065af08fc28e309612dea6,1,Robert (Bobby) Evans,2018-09-21 08:59:38-05:00,['70dd313e2be5c6ea6ca7d30fbdb05960cc3c6b33'],26,108,134,5865679,7,0,0.936170213,0.936170213,4047
442372eb5b72ffda8171200db7d2c94ea87f28f5,0,P. Taylor Goetz,2018-09-21 11:41:08-04:00,['e736c4b44e94723be4c1efc06e4e9d2e9bd0314a'],1,1,2,5865681,1,,,,4047
062bb2f158a66b802a3ad7bdda14fb8f70cf9b88,0,P. Taylor Goetz,2018-09-21 12:10:16-04:00,['442372eb5b72ffda8171200db7d2c94ea87f28f5'],215,144,359,5866040,72,,,,4047
94c6a644aeb27b6c689d7b9f68bd2e7adb5c8734,0,P. Taylor Goetz,2018-09-21 12:30:34-04:00,['062bb2f158a66b802a3ad7bdda14fb8f70cf9b88'],74,74,148,5866188,72,,,,4047
0db99bcbf4e9edc8f7f1eb16143075bb4ee80806,0,Robert (Bobby) Evans,2018-09-22 11:56:26-05:00,['b2a1a5872bf78d516417b326f06f85774b0c4d48'],81,259,340,5866528,5,1,1,1,4048
b187971e0da0238c6beba200b01fb738a6f848d8,0,Michal Koziorowski,2018-09-24 16:12:47+02:00,['94c6a644aeb27b6c689d7b9f68bd2e7adb5c8734'],1,1,2,5866530,1,,,,4048
490fe49afac3b86057f713daf473d03dcf165569,0,Govind Menon,2018-09-24 14:55:22-05:00,['94c6a644aeb27b6c689d7b9f68bd2e7adb5c8734'],4,12,16,5866546,1,0,0,0,4048
d4a5fa1499b60b68b8d5c5843a1ec5cbd2f644d9,0,Robert Evans,2018-09-25 10:29:09-05:00,"['94c6a644aeb27b6c689d7b9f68bd2e7adb5c8734', 'b187971e0da0238c6beba200b01fb738a6f848d8']",1,1,2,5866548,1,,,,4048
5334e0c2f13e282ff6c4a8e536268816b97f81c6,0,Robert Evans,2018-09-25 11:50:53-05:00,"['d4a5fa1499b60b68b8d5c5843a1ec5cbd2f644d9', '0db99bcbf4e9edc8f7f1eb16143075bb4ee80806']",81,259,340,5866888,5,,,,4048
9d083fa919e0000d9b74938b80459c8833b116b3,0,Robert Evans,2018-09-25 11:53:50-05:00,['5334e0c2f13e282ff6c4a8e536268816b97f81c6'],2,2,4,5866892,1,,,,4048
bca4761d7b36296f12b64c7575b57085d1f3ec1e,0,Robert Evans,2018-09-25 12:24:46-05:00,"['9d083fa919e0000d9b74938b80459c8833b116b3', '1f1fb0a129a2bbf3a5065af08fc28e309612dea6']",131,478,609,5867501,9,,,,4048
4c3a9bdc0cf217fab94cd2fc8bc8df0959e579cc,0,Robert Evans,2018-09-25 12:59:45-05:00,"['bca4761d7b36296f12b64c7575b57085d1f3ec1e', '490fe49afac3b86057f713daf473d03dcf165569']",4,12,16,5867517,1,,,,4048
24a28eaadd17d2594eb88e098455d68aa74380a7,0,Kishor Patil,2018-09-26 04:26:54-07:00,['4c3a9bdc0cf217fab94cd2fc8bc8df0959e579cc'],38,41,79,5867596,3,1,1,1,4048
2b9f404cc29f1b46008cdf7ae0d2337dc905a47b,0,Aaron Gresch,2018-09-26 16:37:03-05:00,['4c3a9bdc0cf217fab94cd2fc8bc8df0959e579cc'],6,2,8,5867604,2,0,,,4048
53434b7eb8388455f43826519ba1a40bff1493d2,0,Robert Evans,2018-09-28 12:09:18-05:00,"['4c3a9bdc0cf217fab94cd2fc8bc8df0959e579cc', '24a28eaadd17d2594eb88e098455d68aa74380a7']",38,41,79,5867683,3,,,,4048
c367f9af74669ae5a1f314b826fa9057cdfd546f,0,Robert Evans,2018-09-28 12:45:55-05:00,"['53434b7eb8388455f43826519ba1a40bff1493d2', '2b9f404cc29f1b46008cdf7ae0d2337dc905a47b']",6,2,8,5867691,2,,,,4048
d7d2c62312d2e3ed73273a88359d1e2f35a0ecbc,0,Aaron Gresch,2018-09-28 15:23:58-05:00,['4c3a9bdc0cf217fab94cd2fc8bc8df0959e579cc'],46,63,109,5867800,2,0,0,0,4048
50bcb3c20a2c7ef77fbeac47ed8354b586b43d99,0,roshannaik,2018-09-30 03:22:09-07:00,['c367f9af74669ae5a1f314b826fa9057cdfd546f'],0,14,14,5867814,1,,,,4048
954c810e150971e94219ec192f16fdd7d772d8df,0,Govind Menon,2018-09-30 19:30:23-05:00,['c367f9af74669ae5a1f314b826fa9057cdfd546f'],36,64,100,5867914,2,1,1,0,4048
c47c23cf8140db59c2ad76bd3ac5ef17ceb8fad4,0,Robert Evans,2018-10-01 09:27:44-05:00,"['c367f9af74669ae5a1f314b826fa9057cdfd546f', 'd7d2c62312d2e3ed73273a88359d1e2f35a0ecbc']",46,63,109,5868023,2,,,,4048
39d28387296a57835947da45f4c5c1f92eb676e6,0,Aaron Gresch,2018-10-01 11:12:28-05:00,['c367f9af74669ae5a1f314b826fa9057cdfd546f'],2,2,4,5868027,1,,,,4048
1f5ce4131ecbf27255f6c1dd7beba5c1b0794104,0,Derek Dagit,2018-10-01 15:26:55-05:00,['c47c23cf8140db59c2ad76bd3ac5ef17ceb8fad4'],3,10,13,5868040,2,0,0,0,4048
e1815c1e8aa5280838eae32d9a0cb914b8fef57c,0,GitHub,2018-10-01 17:21:02-05:00,['c47c23cf8140db59c2ad76bd3ac5ef17ceb8fad4'],1,1,2,5868042,1,,,,4048
ad63cc20ff0df278eaf55b3df28de62d6584790a,0,Robert Evans,2018-10-02 11:25:29-05:00,"['c47c23cf8140db59c2ad76bd3ac5ef17ceb8fad4', '50bcb3c20a2c7ef77fbeac47ed8354b586b43d99']",0,14,14,5868056,1,,,,4048
7811fd02c5880067593a809024893268ea629db4,1,Aaron Gresch,2018-10-02 14:00:52-05:00,['39d28387296a57835947da45f4c5c1f92eb676e6'],1,1,2,5868058,1,,,,4048
9e84142c84ea4975d6b446c1aaea19e04daa120c,1,Aaron Gresch,2018-10-02 15:16:40-05:00,['7811fd02c5880067593a809024893268ea629db4'],2,2,4,5868062,1,,,,4048
0b32a2950c61814ec6f9a9d73a82242559bb003f,0,Aaron Gresch,2018-10-02 15:35:59-05:00,['9e84142c84ea4975d6b446c1aaea19e04daa120c'],3,3,6,5868068,2,,,,4048
a930e078db453bc933e775cb16cd9733a1e49e73,0,Edward Samson,2018-10-03 14:18:41+08:00,['ad63cc20ff0df278eaf55b3df28de62d6584790a'],2,2,4,5868072,2,,,,4048
d1b6f76381ec8d8aca4d28fdec5e82711ed06176,0,Derek Dagit,2018-10-03 11:06:31-05:00,['ad63cc20ff0df278eaf55b3df28de62d6584790a'],34,47,81,5868153,3,0,1,1,4049
fe3cfdf0afb111ac16479a059e8aae54fd0a0321,0,Robert Evans,2018-10-03 12:49:39-05:00,"['ad63cc20ff0df278eaf55b3df28de62d6584790a', '0b32a2950c61814ec6f9a9d73a82242559bb003f']",5,5,10,5868163,2,,,,4049
353399a1f67cb0d3c227b60c1e29995ac31744b4,0,Derek Dagit,2018-10-03 13:23:55-05:00,"['fe3cfdf0afb111ac16479a059e8aae54fd0a0321', '1f5ce4131ecbf27255f6c1dd7beba5c1b0794104']",3,10,13,5868176,2,,,,4049
a6f76df3f2a15bc1f8b88e7f432efaa0cdf8eed9,0,Robert Evans,2018-10-03 13:48:47-05:00,"['353399a1f67cb0d3c227b60c1e29995ac31744b4', 'e1815c1e8aa5280838eae32d9a0cb914b8fef57c']",1,1,2,5868178,1,,,,4049
9cad3415e597bd25534d64271109653676d9be46,1,Aaron Gresch,2018-10-03 15:25:02-05:00,['a6f76df3f2a15bc1f8b88e7f432efaa0cdf8eed9'],8,23,31,5868209,5,1,0,0,4049
2bc519f083832bd1b5a458c6b6529c6c16fd69ce,0,Robert Evans,2018-10-03 16:27:29-05:00,"['a6f76df3f2a15bc1f8b88e7f432efaa0cdf8eed9', '954c810e150971e94219ec192f16fdd7d772d8df']",36,64,100,5868309,2,,,,4049
ee516cebb6fe2ad516df6444087dc02d44e93c98,0,Derek Dagit,2018-10-03 16:28:19-05:00,['ad63cc20ff0df278eaf55b3df28de62d6584790a'],7,7,14,5868323,1,,,,4049
a9ff4403b74fb5df3b751916b00b7ac05f431a2e,0,Derek Dagit,2018-10-04 09:27:01-05:00,['c47c23cf8140db59c2ad76bd3ac5ef17ceb8fad4'],51,65,116,5868439,4,,,,4049
dad7410e2db0e1bfa801ae2d33525bc9619c8abd,0,Stig Rohde D酶ssing,2018-10-04 17:01:06+02:00,"['2bc519f083832bd1b5a458c6b6529c6c16fd69ce', 'a9ff4403b74fb5df3b751916b00b7ac05f431a2e']",51,65,116,5868555,4,,,,4049
d012f6c323d29a48ded29ff2ef86d77970a5d080,0,Robert (Bobby) Evans,2018-10-04 15:12:18-05:00,['dad7410e2db0e1bfa801ae2d33525bc9619c8abd'],40,53,93,5868648,5,0,0,1,4049
c8ce783f2fe5e444a97ea385a33ad300f99f67ff,0,Kishor Patil,2018-10-04 16:18:40-04:00,['c367f9af74669ae5a1f314b826fa9057cdfd546f'],2,2,4,5868652,2,,,,4049
7b3cf31d009971ba66644462cad55a10c0af17ba,0,Derek Dagit,2018-10-04 16:51:53-05:00,"['dad7410e2db0e1bfa801ae2d33525bc9619c8abd', 'ee516cebb6fe2ad516df6444087dc02d44e93c98']",7,7,14,5868666,1,,,,4049
b6b2b7d143642b5cbcbfce86b9da8e77292368a9,0,Robert Evans,2018-10-05 09:25:54-05:00,"['7b3cf31d009971ba66644462cad55a10c0af17ba', 'a930e078db453bc933e775cb16cd9733a1e49e73']",2,2,4,5868670,2,,,,4049
e82052339bd0567d132017ace4e303be3056c82f,0,Robert Evans,2018-10-05 09:30:14-05:00,"['b6b2b7d143642b5cbcbfce86b9da8e77292368a9', 'd1b6f76381ec8d8aca4d28fdec5e82711ed06176']",34,47,81,5868751,3,,,,4049
e63dee617bdbdb8294978ab8442b2dd1e007b2b9,0,Aaron Gresch,2018-10-05 13:52:53-05:00,['9cad3415e597bd25534d64271109653676d9be46'],3,7,10,5868761,1,0,1,1,4049
e5e0ddec875534af34d8499523530f34ede086c8,0,Aaron Gresch,2018-10-05 14:23:44-05:00,['e82052339bd0567d132017ace4e303be3056c82f'],6,1,7,5868768,2,1,1,0,4049
bfcbf2c8e35518de02f6326cd10aad6c7cf7ad92,0,Robert Evans,2018-10-05 15:18:10-05:00,"['e82052339bd0567d132017ace4e303be3056c82f', 'd012f6c323d29a48ded29ff2ef86d77970a5d080']",40,53,93,5868861,5,,,,4049
06a64949c8c5b764a33a10beb6088cdd8f182aa0,0,Robert Evans,2018-10-05 15:43:29-05:00,"['bfcbf2c8e35518de02f6326cd10aad6c7cf7ad92', 'e63dee617bdbdb8294978ab8442b2dd1e007b2b9']",10,29,39,5868900,5,,,,4049
53d13997b3a8d0bc3a52e0ef45418e4308de8bb3,0,Robert Evans,2018-10-05 16:08:18-05:00,"['06a64949c8c5b764a33a10beb6088cdd8f182aa0', 'c8ce783f2fe5e444a97ea385a33ad300f99f67ff']",2,2,4,5868904,2,,,,4049
20d5581270c9643f2764f7f5a4cab0e5ea84a673,0,Robert Evans,2018-10-08 08:16:34-05:00,"['53d13997b3a8d0bc3a52e0ef45418e4308de8bb3', 'e5e0ddec875534af34d8499523530f34ede086c8']",6,1,7,5868911,2,,,,4049
fe6116a7119b1ee8ca55dca247b689ca173aeb53,0,Govind Menon,2018-10-08 09:46:53-05:00,['20d5581270c9643f2764f7f5a4cab0e5ea84a673'],2,2,4,5868915,1,,,,4049
bbfd7cd4050ae80d406daaed9cec882b00be1f98,0,Robert (Bobby) Evans,2018-10-08 13:25:17-05:00,['20d5581270c9643f2764f7f5a4cab0e5ea84a673'],24,40,64,5868979,6,0.214285714,0.714285714,1,4049
d0a169978942736556fd0af1b8e4306c0291e107,0,Robert Evans,2018-10-09 12:24:17-05:00,"['20d5581270c9643f2764f7f5a4cab0e5ea84a673', 'fe6116a7119b1ee8ca55dca247b689ca173aeb53']",2,2,4,5868983,1,,,,4049
fb2a101b8535e158d8f7ac01c376615cd6ce4275,0,P. Taylor Goetz,2018-10-09 13:34:18-04:00,['20d5581270c9643f2764f7f5a4cab0e5ea84a673'],74,74,148,5869131,72,,,,4049
9d4ccf5d743c2f1a08ac81023c8b300ab0f8b997,0,P. Taylor Goetz,2018-10-09 13:39:50-04:00,['fb2a101b8535e158d8f7ac01c376615cd6ce4275'],73,73,146,5869277,72,,,,4049
6b24ecd0dcb82901e3b7dd1667b29ee15a74c2be,0,P. Taylor Goetz,2018-10-09 14:00:29-04:00,['9d4ccf5d743c2f1a08ac81023c8b300ab0f8b997'],73,73,146,5869423,72,,,,4049
f8d04910dc3fd14534c186232ecf7882d8916f67,0,P. Taylor Goetz,2018-10-09 14:26:19-04:00,"['6b24ecd0dcb82901e3b7dd1667b29ee15a74c2be', 'd0a169978942736556fd0af1b8e4306c0291e107']",2,2,4,5869427,1,,,,4049
a0f3b1ace6eb6d2f1838364c7971dd8c91e07768,0,P. Taylor Goetz,2018-10-09 14:27:08-04:00,['f8d04910dc3fd14534c186232ecf7882d8916f67'],73,73,146,5869573,72,,,,4049
22440747aa0f2ed3f3d26baec9140f79bb82f644,0,Robert Evans,2018-10-09 14:35:30-05:00,"['a0f3b1ace6eb6d2f1838364c7971dd8c91e07768', 'bbfd7cd4050ae80d406daaed9cec882b00be1f98']",24,40,64,5869637,6,,,,4049
94e6bbcc873c04034c55977653910b9921bc014c,1,Arun Mahadevan,2018-10-11 10:33:21-07:00,['22440747aa0f2ed3f3d26baec9140f79bb82f644'],2,6,8,5869645,2,0,0,0,4049
1fa76994608198dd50d0abcd0793ec4cf42e7bbf,0,Aaron Gresch,2018-10-11 13:20:59-05:00,['22440747aa0f2ed3f3d26baec9140f79bb82f644'],6,21,27,5869672,2,1,1,1,4049
a6fc2f933184c28f293fdd1d6aad562e983f21f8,0,Arun Mahadevan,2018-10-11 11:36:35-07:00,['94e6bbcc873c04034c55977653910b9921bc014c'],1,1,2,5869674,1,,,,4049
1086857a24e824fde649be449135e8c5a89740f1,0,Derek Dagit,2018-10-11 15:54:17-05:00,['22440747aa0f2ed3f3d26baec9140f79bb82f644'],307,7,314,5869988,8,0,0,0,4049
b89c56ec3ff599262588cf05fa50a27101912ee3,0,Derek Dagit,2018-10-11 16:08:29-05:00,['22440747aa0f2ed3f3d26baec9140f79bb82f644'],5,5,10,5869998,1,,,,4049
8533116d955506e5f295ac8e31bc83f408c26854,0,Derek Dagit,2018-10-11 16:28:38-05:00,['22440747aa0f2ed3f3d26baec9140f79bb82f644'],9,4,13,5870011,3,,,,4049
23dab727ed23ed739e066d414c546652cb8ac4d1,0,Kishor Patil,2018-10-11 18:04:23-04:00,['20d5581270c9643f2764f7f5a4cab0e5ea84a673'],3,3,6,5870017,1,,,,4049
cafe61ffaa98c9656b489b4bc38d1f1689e28535,0,Derek Dagit,2018-10-12 13:02:52-05:00,['22440747aa0f2ed3f3d26baec9140f79bb82f644'],1,5,6,5870023,1,,,,4049
39205027d9fc066310617931a741b51905d27fcd,0,Derek Dagit,2018-10-12 14:54:32-05:00,['cafe61ffaa98c9656b489b4bc38d1f1689e28535'],28,1,29,5870052,2,,,,4049
63aabcb9d6fdca2e48b16464863acea48676631b,0,Robert Evans,2018-10-12 15:56:17-05:00,"['22440747aa0f2ed3f3d26baec9140f79bb82f644', 'a6fc2f933184c28f293fdd1d6aad562e983f21f8']",2,6,8,5870060,2,,,,4049
5a8378a340467654f50d4ee827cdb5196e4e250d,0,Robert Evans,2018-10-12 16:19:16-05:00,"['63aabcb9d6fdca2e48b16464863acea48676631b', '1fa76994608198dd50d0abcd0793ec4cf42e7bbf']",6,21,27,5870087,2,,,,4049
5ea90ce0f26653770125358be0d036e411a1248d,0,Robert Evans,2018-10-15 07:30:00-05:00,"['5a8378a340467654f50d4ee827cdb5196e4e250d', '1086857a24e824fde649be449135e8c5a89740f1']",307,7,314,5870401,8,,,,4049
8e1627dde8d3fd4624a5ceecfccfd250cef1e407,0,Robert Evans,2018-10-15 08:50:29-05:00,"['5ea90ce0f26653770125358be0d036e411a1248d', 'b89c56ec3ff599262588cf05fa50a27101912ee3']",5,5,10,5870411,1,,,,4049
c52cedf9bd7430ef7fb47279b232ca4d769e64f0,0,Robert Evans,2018-10-15 08:51:22-05:00,"['8e1627dde8d3fd4624a5ceecfccfd250cef1e407', '8533116d955506e5f295ac8e31bc83f408c26854']",9,4,13,5870424,3,,,,4049
f671f89301058419dfa059318770e5a646eabb7a,0,Robert Evans,2018-10-15 08:52:47-05:00,"['c52cedf9bd7430ef7fb47279b232ca4d769e64f0', '39205027d9fc066310617931a741b51905d27fcd']",24,1,25,5870449,2,,,,4049
438e02e4fd57ac8c7a7933f71500336cc07012d8,0,Robert Evans,2018-10-15 08:56:06-05:00,"['f671f89301058419dfa059318770e5a646eabb7a', '23dab727ed23ed739e066d414c546652cb8ac4d1']",3,3,6,5870455,1,,,,4049
238f1c18f3ef5fa5240439a7ffd9f0a89a200473,0,Robert (Bobby) Evans,2018-10-15 10:28:57-05:00,['438e02e4fd57ac8c7a7933f71500336cc07012d8'],1,1,2,5870457,1,,,,4049
a0b8a6a8d6746700fb356ed0687f88844a146b9a,0,Robert Evans,2018-10-15 10:36:10-05:00,"['438e02e4fd57ac8c7a7933f71500336cc07012d8', '238f1c18f3ef5fa5240439a7ffd9f0a89a200473']",1,1,2,5870459,1,,,,4049
56d3752c001f021ebb723c904d134fd01024cad8,0,Aaron Gresch,2018-10-16 08:40:00-05:00,['a0b8a6a8d6746700fb356ed0687f88844a146b9a'],11,12,23,5870482,1,,,,4049
fdb95d0fa70da5ad79aa1ffaf0d2806698d10641,0,Derek Dagit,2018-10-16 12:32:34-05:00,['a0b8a6a8d6746700fb356ed0687f88844a146b9a'],0,0,0,5870482,0,,,,4049
fe0da1c274e5282d017c06d0f034d94b48d8a34d,0,P. Taylor Goetz,2018-10-16 14:09:18-04:00,['a0f3b1ace6eb6d2f1838364c7971dd8c91e07768'],73,73,146,5870628,72,,,,4049
f4e3ac18571ca6b0ea5ec97e72e60d7f808cb625,0,P. Taylor Goetz,2018-10-16 14:11:08-04:00,"['fe0da1c274e5282d017c06d0f034d94b48d8a34d', 'a0b8a6a8d6746700fb356ed0687f88844a146b9a']",381,88,469,5871097,23,,,,4049
606da75a0df8d54509191d9cb9427c1215459700,0,P. Taylor Goetz,2018-10-16 14:12:14-04:00,['f4e3ac18571ca6b0ea5ec97e72e60d7f808cb625'],73,73,146,5871243,72,,,,4049
8710b1966fc68e65f5375084f0b70eff53ceddbc,0,P. Taylor Goetz,2018-10-16 14:34:44-04:00,['606da75a0df8d54509191d9cb9427c1215459700'],73,73,146,5871389,72,,,,4049
66b8f507572f351e7349fdb721cd1f15e5e1a7f4,0,P. Taylor Goetz,2018-10-16 14:35:05-04:00,['8710b1966fc68e65f5375084f0b70eff53ceddbc'],73,73,146,5871535,72,,,,4049
6828ecae38c79522c3b7c9ab590d54ececf6d4c3,0,Robert (Bobby) Evans,2018-10-17 17:02:40-05:00,['66b8f507572f351e7349fdb721cd1f15e5e1a7f4'],13,187,200,5871735,3,0.62992126,0.763779528,0.181102362,4049
e33cf7c089748d21c2857c19005a1bb60e39bd55,0,Edward Samson,2018-10-18 19:33:16+08:00,['66b8f507572f351e7349fdb721cd1f15e5e1a7f4'],2,2,4,5871739,2,,,,4049
379d9a4171409c88634a5aae9f1fb409eee73a39,0,Manuel Dossinger,2018-10-18 14:55:58+02:00,['66b8f507572f351e7349fdb721cd1f15e5e1a7f4'],29,33,62,5871801,4,,,,4049
ebb41d7faf1ebefaece3cb746608a1855b794593,0,Robert (Bobby) Evans,2018-10-18 10:44:33-05:00,['66b8f507572f351e7349fdb721cd1f15e5e1a7f4'],4,31,35,5871836,1,,,,4049
05f8adcdaa457e1b5880b803cc304f199688b945,0,Robert (Bobby) Evans,2018-10-18 11:03:58-05:00,['ebb41d7faf1ebefaece3cb746608a1855b794593'],10,10,20,5871856,1,,,,4049
02404865f241d2e737eb5dabe9d745d2393f3d9c,0,Aaron Gresch,2018-10-18 11:23:28-05:00,['66b8f507572f351e7349fdb721cd1f15e5e1a7f4'],2,8,10,5871866,1,0,0.25,1,4049
a100c1241d689595bf1ec8ae21aaa97fd1aed951,0,Robert Evans,2018-10-19 09:49:31-05:00,"['66b8f507572f351e7349fdb721cd1f15e5e1a7f4', '56d3752c001f021ebb723c904d134fd01024cad8']",11,12,23,5871889,1,,,,4049
14a483e0e90cdd04cc852a2a64a703f29bcf60a2,0,Robert Evans,2018-10-19 10:23:13-05:00,"['a100c1241d689595bf1ec8ae21aaa97fd1aed951', '05f8adcdaa457e1b5880b803cc304f199688b945']",10,37,47,5871936,1,,,,4049
0a01432fb5de1f8fbbea47cf679a707f629fb71b,0,Robert Evans,2018-10-19 10:26:31-05:00,"['14a483e0e90cdd04cc852a2a64a703f29bcf60a2', 'e33cf7c089748d21c2857c19005a1bb60e39bd55']",2,2,4,5871940,2,,,,4049
ce984cd31a16e7fe4b983659005f1f7648455404,0,Robert Evans,2018-10-19 10:31:55-05:00,"['0a01432fb5de1f8fbbea47cf679a707f629fb71b', '379d9a4171409c88634a5aae9f1fb409eee73a39']",29,33,62,5872002,4,,,,4049
6b0373703ab89648943f52ec87c43531e2defc84,0,Jacob Tolar,2018-10-19 14:14:32-05:00,['ce984cd31a16e7fe4b983659005f1f7648455404'],3,22,25,5872027,1,0.636363636,1,0.636363636,4049
ef9d907d457d9d5ce9af42b88c8a11d16b7facfe,0,Stig Rohde D酶ssing,2018-10-21 12:55:49+02:00,['ce984cd31a16e7fe4b983659005f1f7648455404'],1,0,1,5872028,1,,,,4049
5b066609b0dbeec2bb842ddd5a81ae8c32ac9719,0,Stig Rohde D酶ssing,2018-10-21 14:39:43+02:00,['ef9d907d457d9d5ce9af42b88c8a11d16b7facfe'],102,187,289,5872317,15,1,1,0.829268293,4049
4bba9c4e8ba962dd6f35c7fd25cfa466050f5607,0,Robert (Bobby) Evans,2018-10-22 10:44:18-05:00,['ce984cd31a16e7fe4b983659005f1f7648455404'],12,16,28,5872345,5,1,1,1,4049
9f643ac9d3532a0adcdb648fd6af3897e5eed746,0,Stig Rohde D酶ssing,2018-10-22 17:47:53+02:00,"['ce984cd31a16e7fe4b983659005f1f7648455404', 'fdb95d0fa70da5ad79aa1ffaf0d2806698d10641']",0,0,0,5872345,0,,,,4049
0ef21a85fb798f17b0e5017e1d500f2f7b35b657,0,Stig Rohde D酶ssing,2018-10-22 17:48:35+02:00,"['9f643ac9d3532a0adcdb648fd6af3897e5eed746', 'ef9d907d457d9d5ce9af42b88c8a11d16b7facfe']",1,0,1,5872346,1,,,,4049
46fe41e418ce06f507488c2debb3b04033273006,0,Robert (Bobby) Evans,2018-10-22 10:57:49-05:00,['ce984cd31a16e7fe4b983659005f1f7648455404'],1,3,4,5872350,1,,,,4049
80999f40536b06694465080d3f6c3f6bab6efc4a,0,Robert Evans,2018-10-22 11:08:11-05:00,"['0ef21a85fb798f17b0e5017e1d500f2f7b35b657', '02404865f241d2e737eb5dabe9d745d2393f3d9c']",2,8,10,5872360,1,,,,4049
3d315b85491751507e8bfdc41cf64cf4cf3bd89f,0,Stig Rohde D酶ssing,2018-10-22 19:17:41+02:00,"['80999f40536b06694465080d3f6c3f6bab6efc4a', '5b066609b0dbeec2bb842ddd5a81ae8c32ac9719']",102,187,289,5872649,15,,,,4049
e2563a195fffa18b3299fd5903ec8bdbae8467c8,0,Robert Evans,2018-10-22 12:50:53-05:00,"['3d315b85491751507e8bfdc41cf64cf4cf3bd89f', '6b0373703ab89648943f52ec87c43531e2defc84']",3,22,25,5872674,1,,,,4049
131344777ae4cbc4ca47952b3a95f35b11713f23,1,Aaron Gresch,2018-10-23 09:00:38-05:00,['e2563a195fffa18b3299fd5903ec8bdbae8467c8'],5,8,13,5872687,1,0,0,1,4049
72be7085f8d9357295cd0991d7b4d0124d614cd7,0,Robert (Bobby) Evans,2018-10-23 09:11:28-05:00,['e2563a195fffa18b3299fd5903ec8bdbae8467c8'],0,6,6,5872693,1,0,0,0.5,4049
3fe0021379c1b491bc45bd5cc8efbc91cedd8536,0,Aaron Gresch,2018-10-23 09:59:35-05:00,['131344777ae4cbc4ca47952b3a95f35b11713f23'],1,5,6,5872699,1,0,0,1,4049
71aa68f09c00dcd70c01bc918ee018accde7eb43,0,Robert Evans,2018-10-23 11:09:35-05:00,"['e2563a195fffa18b3299fd5903ec8bdbae8467c8', '6828ecae38c79522c3b7c9ab590d54ececf6d4c3']",13,187,200,5872899,3,,,,4049
617b03a6af580c00aaa8d31f4cdde1a8bd7bc5c9,0,Robert (Bobby) Evans,2018-10-23 11:11:55-05:00,['46fe41e418ce06f507488c2debb3b04033273006'],2,2,4,5872903,1,,,,4049
6bca7a94945e9f24fc9259db6efca939180f272f,0,Robert Evans,2018-10-23 12:06:30-05:00,"['71aa68f09c00dcd70c01bc918ee018accde7eb43', '4bba9c4e8ba962dd6f35c7fd25cfa466050f5607']",12,16,28,5872931,5,,,,4049
4d7099f3c21ce3dae981414882f327d1b5ab29a1,0,Robert Evans,2018-10-23 12:31:46-05:00,"['6bca7a94945e9f24fc9259db6efca939180f272f', '617b03a6af580c00aaa8d31f4cdde1a8bd7bc5c9']",2,4,6,5872937,1,,,,4049
441f2103905979605d5586c3bc8fa04fee4fd31e,0,Robert Evans,2018-10-24 09:26:40-05:00,"['4d7099f3c21ce3dae981414882f327d1b5ab29a1', '3fe0021379c1b491bc45bd5cc8efbc91cedd8536']",5,12,17,5872954,1,,,,4049
730c1a302d857121542ce27b6a40b05b90f7f3ed,0,Robert Evans,2018-10-24 09:51:51-05:00,"['441f2103905979605d5586c3bc8fa04fee4fd31e', '72be7085f8d9357295cd0991d7b4d0124d614cd7']",0,6,6,5872960,1,,,,4049
6b42587dfb1f99c8dfb6066a2bbc83e29552cff8,0,Kishor Patil,2018-10-24 17:50:59-04:00,['730c1a302d857121542ce27b6a40b05b90f7f3ed'],10,10,20,5872980,1,,,,4049
e996abce19ce535599dab1bb90977d0056a9ad97,0,Manuel Dossinger,2018-10-26 11:18:03+02:00,['730c1a302d857121542ce27b6a40b05b90f7f3ed'],4,23,27,5873007,4,,,,4049
64ce3e0853531e550f31280fe4285f16aaebda1f,0,Manuel Dossinger,2018-10-26 11:18:27+02:00,['e996abce19ce535599dab1bb90977d0056a9ad97'],7,7,14,5873021,6,,,,4049
a88e4491c39e7dded5a16974ed2fcacc33892ae7,0,Julien Nioche,2018-10-26 16:41:03+01:00,['730c1a302d857121542ce27b6a40b05b90f7f3ed'],1,1,2,5873023,1,,,,4049
83f15670fe79e4f0fd5845bc8ffc6b34c8a295fa,0,GitHub,2018-10-26 16:30:47-05:00,['730c1a302d857121542ce27b6a40b05b90f7f3ed'],0,1,1,5873024,1,,,,4049
9e44d48995d023c53dd2aec6f92bba50f8818103,0,Ethan Li,2018-10-27 20:27:51-04:00,"['730c1a302d857121542ce27b6a40b05b90f7f3ed', '83f15670fe79e4f0fd5845bc8ffc6b34c8a295fa']",0,1,1,5873025,1,,,,4049
dcf637ff666e3c08ef81911034576019d35ca215,0,Robert Evans,2018-10-31 12:58:13-05:00,"['9e44d48995d023c53dd2aec6f92bba50f8818103', '64ce3e0853531e550f31280fe4285f16aaebda1f']",11,30,41,5873066,10,,,,4049
d0dc3b4bd86657f2be13c1c0cdae2e5933da9eb1,0,GitHub,2018-11-01 09:08:15-05:00,['dcf637ff666e3c08ef81911034576019d35ca215'],0,1,1,5873067,1,1,1,1,4049
c1801ecf36afbe9abd193fd1ea9d6ab9d95d30ed,0,Ethan Li,2018-11-02 10:50:21-05:00,['dcf637ff666e3c08ef81911034576019d35ca215'],11,20,31,5873098,1,,,,4049
00cd3d32365180da47184fe1c29b927fecf56871,0,Ethan Li,2018-11-02 10:54:28-05:00,"['dcf637ff666e3c08ef81911034576019d35ca215', 'c1801ecf36afbe9abd193fd1ea9d6ab9d95d30ed']",11,20,31,5873129,1,,,,4049
fb630899207f23ad0d3fbe91d532aca7ff604447,0,Robert Evans,2018-11-02 12:32:13-05:00,"['00cd3d32365180da47184fe1c29b927fecf56871', 'a88e4491c39e7dded5a16974ed2fcacc33892ae7']",1,1,2,5873131,1,,,,4049
02662ea6641a6763b8e285ad292dbb789be6fc61,0,Robert Evans,2018-11-02 14:11:24-05:00,"['fb630899207f23ad0d3fbe91d532aca7ff604447', '6b42587dfb1f99c8dfb6066a2bbc83e29552cff8']",10,10,20,5873151,1,,,,4049
19fbfb9ac8f82719cf70fedf6a024acaeec4e804,0,Ethan Li,2018-11-06 10:47:30-06:00,"['02662ea6641a6763b8e285ad292dbb789be6fc61', 'd0dc3b4bd86657f2be13c1c0cdae2e5933da9eb1']",0,1,1,5873152,1,,,,4049
8288d41b313126ce7a9da7b548801a58da98b7ae,0,Kishor Patil,2018-11-06 16:58:31-05:00,['19fbfb9ac8f82719cf70fedf6a024acaeec4e804'],2,4,6,5873158,1,1,1,1,4049
2ba69e2e4e56bc8207c629d64b1abbe22dccc457,0,Kishor Patil,2018-11-07 11:35:35-05:00,['8288d41b313126ce7a9da7b548801a58da98b7ae'],4,3,7,5873165,1,0,0,0,4049
9178c10211874f8928ebc5ce4fdbf04ae698bcb5,0,Kishor Patil,2018-11-08 13:05:53-05:00,['19fbfb9ac8f82719cf70fedf6a024acaeec4e804'],0,27,27,5873192,3,0,0,0,4049
98ed0a8157837e909203371fa2f4f75fac367a0f,0,Kishor Patil,2018-11-08 17:20:39-05:00,"['19fbfb9ac8f82719cf70fedf6a024acaeec4e804', '2ba69e2e4e56bc8207c629d64b1abbe22dccc457']",2,3,5,5873197,1,,,,4049
00cd667a4cce14f716cc9480dfad71ec0e029a3f,0,jenkins,2018-11-11 01:49:18+09:00,['98ed0a8157837e909203371fa2f4f75fac367a0f'],139,139,278,5873475,2,,,,4049
2e73e4086cfdc37c919120b0b3bc9fb74494dd17,0,Stig Rohde D酶ssing,2018-11-11 17:26:27+01:00,['98ed0a8157837e909203371fa2f4f75fac367a0f'],1,1,2,5873477,1,,,,4049
40e24ce45a7744e2d24d4e8d3f6f146372c57824,1,Arun Mahadevan,2018-11-12 18:12:18-08:00,['98ed0a8157837e909203371fa2f4f75fac367a0f'],3,20,23,5873500,2,0.636363636,0.727272727,0.818181818,4049
fa0b8624492630d0f5c3c89e6bf7a5d20ac59d8b,1,Arun Mahadevan,2018-11-13 00:38:50-08:00,['40e24ce45a7744e2d24d4e8d3f6f146372c57824'],16,77,93,5873593,3,0.29787234,0.191489362,1,4049
4ebb6406ea850cdd5b710fd9185fe211bbdf746d,0,Robert Evans,2018-11-13 10:45:14-06:00,"['98ed0a8157837e909203371fa2f4f75fac367a0f', '9178c10211874f8928ebc5ce4fdbf04ae698bcb5']",0,27,27,5873620,3,,,,4049
f17b3dad8572f96217a8bf058022b26fe147a0b5,0,Robert Evans,2018-11-13 11:14:44-06:00,"['4ebb6406ea850cdd5b710fd9185fe211bbdf746d', '2e73e4086cfdc37c919120b0b3bc9fb74494dd17']",1,1,2,5873622,1,,,,4049
d8d88374d992a7f3b6455e26fececa2bf50d5165,0,Arun Mahadevan,2018-11-15 10:38:58-08:00,['fa0b8624492630d0f5c3c89e6bf7a5d20ac59d8b'],9,11,20,5873642,4,0,1,1,4049
29eb449ee2518d4d2f750fa32b667b671912cbad,0,Jungtaek Lim (HeartSaVioR),2018-11-16 08:14:47+09:00,"['f17b3dad8572f96217a8bf058022b26fe147a0b5', 'd8d88374d992a7f3b6455e26fececa2bf50d5165']",13,93,106,5873748,4,,,,4049
5784eb1afc1ea911aeb639020f6c9afd7e414280,0,Robert (Bobby) Evans,2018-11-16 10:16:35-06:00,['29eb449ee2518d4d2f750fa32b667b671912cbad'],1,3,4,5873752,1,0,1,0,4049
40f1b6104bbd77bf278dbdf9ecf7e24fa305dae4,0,Stig Rohde D酶ssing,2018-11-19 19:55:24+01:00,"['29eb449ee2518d4d2f750fa32b667b671912cbad', '00cd667a4cce14f716cc9480dfad71ec0e029a3f']",139,139,278,5874030,2,,,,4049
63de17eda9220163867ea051d03adc44eaa7d113,0,Stig Rohde D酶ssing,2018-11-20 19:57:25+01:00,['40f1b6104bbd77bf278dbdf9ecf7e24fa305dae4'],360,591,951,5874981,29,1,0.963636364,0.836363636,4053
c92918949c3b8830c153807b761ac1c10022f1c6,0,GitHub,2018-11-20 17:11:06-06:00,['40f1b6104bbd77bf278dbdf9ecf7e24fa305dae4'],4,0,4,5874985,1,0,0,1,4053
043b4eecbb30e5d244dee52335db4321ec6ca455,0,Stig Rohde D酶ssing,2018-11-24 14:59:14+01:00,"['40f1b6104bbd77bf278dbdf9ecf7e24fa305dae4', '5784eb1afc1ea911aeb639020f6c9afd7e414280']",1,3,4,5874989,1,,,,4053
52cb6b20a3e9d718d297a38bf879c107e6357754,0,Stig Rohde D酶ssing,2018-11-24 14:59:32+01:00,"['043b4eecbb30e5d244dee52335db4321ec6ca455', 'c92918949c3b8830c153807b761ac1c10022f1c6']",4,0,4,5874993,1,,,,4053
07634fcb881a53d548827f27b1a9388ff8982f5e,0,Arun Mahadevan,2018-11-26 18:17:55-08:00,['29eb449ee2518d4d2f750fa32b667b671912cbad'],0,7,7,5875000,1,1,1,1,4053
c23e7d203f40b343af9b3fdea2a04478d0f3277f,0,Stig Rohde D酶ssing,2018-11-27 09:28:18+01:00,['52cb6b20a3e9d718d297a38bf879c107e6357754'],1,1,2,5875002,1,,,,4053
b7a8d7492c9036fbf5e5c269f121265e68c65cd0,0,Arun Mahadevan,2018-11-27 11:00:36-08:00,['07634fcb881a53d548827f27b1a9388ff8982f5e'],1,8,9,5875011,2,1,1,1,4053
6d871a73e7341c956a56d09f7b3f7a367a5752e3,0,Stig Rohde D酶ssing,2018-11-29 19:18:00+01:00,"['52cb6b20a3e9d718d297a38bf879c107e6357754', '63de17eda9220163867ea051d03adc44eaa7d113']",360,591,951,5875962,29,,,,4053
642ae3698ce4cc6186b7a694a0f523f5a773fa2e,0,Stig Rohde D酶ssing,2018-11-29 19:36:08+01:00,['6d871a73e7341c956a56d09f7b3f7a367a5752e3'],395,508,903,5876865,11,0.4,0.8,0.977777778,4055
94cd157c0f12ceb6538169ce4b4f6193f7f77eed,0,Jungtaek Lim (HeartSaVioR),2018-12-02 15:52:56+09:00,"['6d871a73e7341c956a56d09f7b3f7a367a5752e3', 'b7a8d7492c9036fbf5e5c269f121265e68c65cd0']",1,15,16,5876881,3,,,,4055
b4d3df2167b2962bdf7039ba064ad7a646f32644,1,Aaron Gresch,2018-12-04 16:23:35-06:00,['94cd157c0f12ceb6538169ce4b4f6193f7f77eed'],14,37,51,5876932,1,0.833333333,0.833333333,1,4055
3c4646a14dff42fc23809192d56efcb29a14525e,0,Stig Rohde D酶ssing,2018-12-05 14:56:41+01:00,['94cd157c0f12ceb6538169ce4b4f6193f7f77eed'],1,1,2,5876934,1,,,,4055
b53f6a155f80f422831d4e8d6bb39e22c1591cdb,0,Kishor Patil,2018-12-05 11:24:30-05:00,['94cd157c0f12ceb6538169ce4b4f6193f7f77eed'],1,1,2,5876936,1,,,,4055
f594c20dc5f3547578835e32c2a48cc37f2d6cfd,0,Aaron Gresch,2018-12-06 11:02:10-06:00,['b4d3df2167b2962bdf7039ba064ad7a646f32644'],30,31,61,5876997,2,0,0,1,4055
df84dec0a55c7dba4c5f400329481eee8d20492a,0,Stig Rohde D酶ssing,2018-12-08 16:37:57+01:00,['94cd157c0f12ceb6538169ce4b4f6193f7f77eed'],3,4,7,5877004,1,0,0,1,4055
8bb0185651dfd0e085d9dda4bc0298a1bd8742fb,0,Stig Rohde D酶ssing,2018-12-09 11:54:41+01:00,['94cd157c0f12ceb6538169ce4b4f6193f7f77eed'],16,113,129,5877133,4,0,0.984848485,1,4055
7340e849b7dd4bda70fd31f261ed421ea71e9bb3,0,Stig Rohde D酶ssing,2018-12-11 19:32:24+01:00,"['94cd157c0f12ceb6538169ce4b4f6193f7f77eed', '8bb0185651dfd0e085d9dda4bc0298a1bd8742fb']",16,113,129,5877262,4,,,,4055
ce2e2b368780d8c00c03a7b0eaa03baa62f31dc1,0,Stig Rohde D酶ssing,2018-12-11 19:33:55+01:00,"['7340e849b7dd4bda70fd31f261ed421ea71e9bb3', '3c4646a14dff42fc23809192d56efcb29a14525e']",1,1,2,5877264,1,,,,4055
5c7c0dfca6f60af6a48ada6e36469c0cc920f12c,0,Stig Rohde D酶ssing,2018-12-11 19:34:15+01:00,"['ce2e2b368780d8c00c03a7b0eaa03baa62f31dc1', 'b53f6a155f80f422831d4e8d6bb39e22c1591cdb']",1,1,2,5877266,1,,,,4055
f5b3f93fcba2a368fb85e3e7bb0fce852f5ce077,0,Stig Rohde D酶ssing,2018-12-11 19:35:34+01:00,"['5c7c0dfca6f60af6a48ada6e36469c0cc920f12c', 'c23e7d203f40b343af9b3fdea2a04478d0f3277f']",1,1,2,5877268,1,,,,4055
afa173f694b648694f1dd8b2d0c4ac0dc6f8529d,0,Aaron Gresch,2018-12-11 13:25:06-06:00,['94cd157c0f12ceb6538169ce4b4f6193f7f77eed'],1,2,3,5877271,1,,,,4055
43859e9e82ad419d09756702395b2747c7326eaa,0,Stig Rohde D酶ssing,2018-12-11 20:28:30+01:00,"['f5b3f93fcba2a368fb85e3e7bb0fce852f5ce077', 'afa173f694b648694f1dd8b2d0c4ac0dc6f8529d']",1,2,3,5877274,1,,,,4055
abca1540be9e6875f93dc0b9a276710717bc0ff6,0,Aaron Gresch,2018-12-11 14:18:23-06:00,['f5b3f93fcba2a368fb85e3e7bb0fce852f5ce077'],11,11,22,5877296,5,,,,4055
845787d671dcdf4475493ea5888f2021b1422ba9,0,Derek Dagit,2018-12-12 10:43:28-06:00,['730c1a302d857121542ce27b6a40b05b90f7f3ed'],24,46,70,5877366,4,0,0.684210526,0.526315789,4055
e46a87a862f4d9fc76358f76f9fb4aad5264b080,0,Stig Rohde D酶ssing,2018-12-14 16:55:35+01:00,"['43859e9e82ad419d09756702395b2747c7326eaa', '642ae3698ce4cc6186b7a694a0f523f5a773fa2e']",395,508,903,5878269,11,,,,4055
ec634bd65087d1b67a53c99ef3d5d3efeaea0afe,0,Stig Rohde D酶ssing,2018-12-14 19:35:27+01:00,['e46a87a862f4d9fc76358f76f9fb4aad5264b080'],62,45,107,5878376,25,,,,4055
cecff46b1d3f776d30a90af944906eea380acf65,0,Stig Rohde D酶ssing,2018-12-18 10:31:46+01:00,"['e46a87a862f4d9fc76358f76f9fb4aad5264b080', 'df84dec0a55c7dba4c5f400329481eee8d20492a']",3,4,7,5878383,1,,,,4055
a9c2f3adb9dbd6f283cce11c0d0953bfc8976ed2,0,Stig Rohde D酶ssing,2018-12-18 10:31:55+01:00,"['cecff46b1d3f776d30a90af944906eea380acf65', 'ec634bd65087d1b67a53c99ef3d5d3efeaea0afe']",62,45,107,5878490,25,,,,4055
339b1e6f34d8209ff8c1afcdea815781bfbe22eb,0,Robert Evans,2018-12-18 09:04:29-06:00,"['a9c2f3adb9dbd6f283cce11c0d0953bfc8976ed2', '845787d671dcdf4475493ea5888f2021b1422ba9']",24,46,70,5878560,4,,,,4055
41dd0a7b333c3f1fbe9538394541ff8bc03451b0,0,Robert Evans,2018-12-18 09:33:47-06:00,"['339b1e6f34d8209ff8c1afcdea815781bfbe22eb', 'abca1540be9e6875f93dc0b9a276710717bc0ff6']",11,11,22,5878582,5,,,,4055
cf00a537b4ce34fdd3a2823642e7d4a3158684c6,0,Robert Evans,2018-12-18 10:06:40-06:00,"['41dd0a7b333c3f1fbe9538394541ff8bc03451b0', 'f594c20dc5f3547578835e32c2a48cc37f2d6cfd']",27,51,78,5878660,2,,,,4055
095bdbc267fe4354c28baa84186807dcd3be2a31,0,Robert (Bobby) Evans,2018-12-18 11:21:16-06:00,['cf00a537b4ce34fdd3a2823642e7d4a3158684c6'],80,106,186,5878846,4,0,0,0.307692308,4055
d6a1e730ea200b36c42475f9ce45d11ee940c949,1,Stig Rohde D酶ssing,2018-12-19 16:48:03+01:00,['a9c2f3adb9dbd6f283cce11c0d0953bfc8976ed2'],794,1319,2113,5880959,27,0.366032211,1,0.925329429,4057
02e0e75c6bbbb580b6a62dbe394ade7298a9a1dd,1,Stig Rohde D酶ssing,2018-12-19 16:48:38+01:00,['d6a1e730ea200b36c42475f9ce45d11ee940c949'],393,521,914,5881873,8,0.407142857,1,1,4063
7d14d02ed309fd724b3ecccf2a75a65b0359eee6,0,Stig Rohde D酶ssing,2018-12-21 18:51:17+01:00,['cf00a537b4ce34fdd3a2823642e7d4a3158684c6'],1,1,2,5881875,1,,,,4063
074fb35a0a5ab746d5508d2a60b48a7948a2cdda,0,Robert Evans,2018-12-21 12:20:57-06:00,"['cf00a537b4ce34fdd3a2823642e7d4a3158684c6', '095bdbc267fe4354c28baa84186807dcd3be2a31']",80,106,186,5882061,4,,,,4063
ff5b645134cfab98b2421b187e5afe0132b85e76,0,Govind Menon,2019-01-03 10:50:28-06:00,['074fb35a0a5ab746d5508d2a60b48a7948a2cdda'],2,4,6,5882067,1,1,1,0,4063
7575a00275df5d0e4f8d4979a716383ad49f23a2,0,Kishor Patil,2019-01-04 16:46:15-05:00,"['074fb35a0a5ab746d5508d2a60b48a7948a2cdda', 'ff5b645134cfab98b2421b187e5afe0132b85e76']",2,4,6,5882073,1,,,,4063
2930f2f98ed00a8861d1ee77b5f1bdb317cb9989,0,Stig Rohde D酶ssing,2019-01-05 16:01:17+01:00,"['7575a00275df5d0e4f8d4979a716383ad49f23a2', '7d14d02ed309fd724b3ecccf2a75a65b0359eee6']",1,1,2,5882075,1,,,,4063
7908fac03c127d32716e860ecd247d15a92205a5,0,Stig Rohde D酶ssing,2019-01-05 16:01:53+01:00,"['2930f2f98ed00a8861d1ee77b5f1bdb317cb9989', '02e0e75c6bbbb580b6a62dbe394ade7298a9a1dd']",966,1619,2585,5884660,33,,,,4063
0c82b8fc926651dcd8006e4e602738d8a2431b7a,0,Stig Rohde D酶ssing,2019-01-05 17:58:22+01:00,['7908fac03c127d32716e860ecd247d15a92205a5'],80,139,219,5884879,14,0.032258065,0.258064516,1,4063
8c19705041b459aef95e9479489afd1eb6453ebd,0,P. Taylor Goetz,2019-01-07 10:39:46-05:00,['7908fac03c127d32716e860ecd247d15a92205a5'],73,73,146,5885025,72,,,,4063
ddee8decac57d1a4a0aa23cc76066609a2abc8d2,0,P. Taylor Goetz,2019-01-07 11:02:20-05:00,['8c19705041b459aef95e9479489afd1eb6453ebd'],73,73,146,5885171,72,,,,4063
8a475696e908c53f1c06bf1a8f373d8ac0483427,0,P. Taylor Goetz,2019-01-07 11:02:38-05:00,['ddee8decac57d1a4a0aa23cc76066609a2abc8d2'],73,73,146,5885317,72,,,,4063
9069e30d6939ff1ebadc7a798aff131d237de1f8,1,Stig Rohde D酶ssing,2019-01-07 17:21:03+01:00,['7908fac03c127d32716e860ecd247d15a92205a5'],78,89,167,5885484,1,0.142857143,1,0.285714286,4063
b1a8a062332b301ca05be740699862f23d9b540a,0,Edward Samson,2019-01-09 10:23:02+08:00,['8a475696e908c53f1c06bf1a8f373d8ac0483427'],1,2,3,5885487,1,,,,4063
111aa8d599d9216423f8ce5a79362460a5f6aa36,0,Stig Rohde D酶ssing,2019-01-11 11:58:05+01:00,['8a475696e908c53f1c06bf1a8f373d8ac0483427'],2,2,4,5885491,1,,,,4063
75f9f5c25dfece734c4e9bed1df2a4fbe4842c79,0,Aaron Gresch,2019-01-17 14:22:23-06:00,['8a475696e908c53f1c06bf1a8f373d8ac0483427'],0,4,4,5885495,1,0,0,1,4063
444e0518e0ace34a6bc490ffa61fe722a322a465,0,shichenglong,2019-01-18 21:06:29+08:00,['8a475696e908c53f1c06bf1a8f373d8ac0483427'],6,27,33,5885528,1,0,0,1,4063
da12d89f555f33bf5c15ab49e0ce4859228b42a5,0,Stig Rohde D酶ssing,2019-01-21 20:53:12+01:00,['8a475696e908c53f1c06bf1a8f373d8ac0483427'],14,53,67,5885595,10,0.466666667,0.466666667,0.8,4063
c466f5f563cf675c3b3c08701e86e4a317741641,0,Stig Rohde D酶ssing,2019-01-24 12:07:26+01:00,['8a475696e908c53f1c06bf1a8f373d8ac0483427'],2,6,8,5885603,1,,,,4063
c05db638d98ef6f1efdbe713c2ac04447aec2e8e,0,Govind Menon,2019-01-29 14:05:53-06:00,['75f9f5c25dfece734c4e9bed1df2a4fbe4842c79'],0,10,10,5885613,2,,,,4063
604ecf7fc87ec25b3a2ac1269bc0bd0b4eea0a82,0,Govind Menon,2019-01-29 15:46:34-06:00,"['75f9f5c25dfece734c4e9bed1df2a4fbe4842c79', 'c05db638d98ef6f1efdbe713c2ac04447aec2e8e']",0,10,10,5885623,2,,,,4063
df9fde4ae4fcea348c3823a1aa0a974ad18304be,0,Stig Rohde D酶ssing,2019-01-30 12:37:48+01:00,"['604ecf7fc87ec25b3a2ac1269bc0bd0b4eea0a82', '0c82b8fc926651dcd8006e4e602738d8a2431b7a']",80,139,219,5885842,14,,,,4063
f7883f82945113f4999dc2f23b299234b58142a4,0,Stig Rohde D酶ssing,2019-01-30 12:38:03+01:00,"['df9fde4ae4fcea348c3823a1aa0a974ad18304be', '9069e30d6939ff1ebadc7a798aff131d237de1f8']",78,89,167,5886009,1,,,,4063
31c7e22f809e4d5de27c06fbfd4ddf380e1059e1,0,Stig Rohde D酶ssing,2019-01-30 12:38:36+01:00,"['f7883f82945113f4999dc2f23b299234b58142a4', 'b1a8a062332b301ca05be740699862f23d9b540a']",1,2,3,5886012,1,,,,4063
564bf83ecbe59d8b951867247edd2bf276b8495a,0,Stig Rohde D酶ssing,2019-01-30 12:38:54+01:00,"['31c7e22f809e4d5de27c06fbfd4ddf380e1059e1', '111aa8d599d9216423f8ce5a79362460a5f6aa36']",2,2,4,5886016,1,,,,4063
6175a04b1345c49e0f065f5bc6af85ecf8a0f16d,0,Stig Rohde D酶ssing,2019-01-30 12:39:30+01:00,"['564bf83ecbe59d8b951867247edd2bf276b8495a', '444e0518e0ace34a6bc490ffa61fe722a322a465']",6,27,33,5886049,1,,,,4063
8f49e06998abb4dfc50f51d78b6784ebd04844fb,0,Stig Rohde D酶ssing,2019-01-30 12:40:13+01:00,"['6175a04b1345c49e0f065f5bc6af85ecf8a0f16d', 'c466f5f563cf675c3b3c08701e86e4a317741641']",2,6,8,5886057,1,,,,4063
87f125a678d3ce996386840a0b71cf17102d4373,0,Stig Rohde D酶ssing,2019-01-30 12:44:39+01:00,['8f49e06998abb4dfc50f51d78b6784ebd04844fb'],9,21,30,5886087,4,0.5,0.666666667,0.833333333,4063
0abf0f6e9ec9331bc67fa6fb567320a04194c9ac,0,Stig Rohde D酶ssing,2019-01-30 15:56:07+01:00,['8f49e06998abb4dfc50f51d78b6784ebd04844fb'],3,3,6,5886093,1,,,,4063
4f00d6ae434115f35a22ef0f50490eba407f4b84,0,Stig Rohde D酶ssing,2019-01-31 11:19:22+01:00,['8f49e06998abb4dfc50f51d78b6784ebd04844fb'],1,7,8,5886101,1,1,1,1,4063
487e58578d2708171cf81745335f5dd07e223c88,0,Aaron Gresch,2019-02-01 10:17:51-06:00,['8f49e06998abb4dfc50f51d78b6784ebd04844fb'],9,14,23,5886124,1,0,0,1,4063
9df5de6993b347e3b0ca3b18da35271022ad8d46,0,Stig Rohde D酶ssing,2019-02-04 23:36:06+01:00,['8f49e06998abb4dfc50f51d78b6784ebd04844fb'],430,401,831,5886955,13,1,0.28125,0,4063
557784abbf46a6120c46a1b76d38e522080e7959,1,Govind Menon,2019-02-05 14:32:37-06:00,['8a475696e908c53f1c06bf1a8f373d8ac0483427'],705,1548,2253,5889208,7,0.345331834,0.989876265,1,4065
ecb142b225e4a45194402861917deaec9102aebb,0,Aaron Gresch,2019-02-05 15:49:45-06:00,['8f49e06998abb4dfc50f51d78b6784ebd04844fb'],0,1,1,5889209,1,,,,4065
8000bd30e710e8ad6a24d01680ee59e70d735391,0,Stig Rohde D酶ssing,2019-02-06 19:29:35+01:00,"['8f49e06998abb4dfc50f51d78b6784ebd04844fb', '0abf0f6e9ec9331bc67fa6fb567320a04194c9ac']",3,3,6,5889215,1,,,,4065
4b665dbbb8c3e45dbe5c8cdf8363efd1e88b369b,0,Stig Rohde D酶ssing,2019-02-06 19:30:00+01:00,"['8000bd30e710e8ad6a24d01680ee59e70d735391', '4f00d6ae434115f35a22ef0f50490eba407f4b84']",1,7,8,5889223,1,,,,4065
258f67db64c204bc08cacd79f6d1816ab89d089a,0,Govind Menon,2019-02-06 15:13:22-06:00,['557784abbf46a6120c46a1b76d38e522080e7959'],80,139,219,5889442,14,0.032258065,0.258064516,1,4065
ceb867c8c048528cfc71e7d580a3372775a23508,0,Govind Menon,2019-02-06 15:13:22-06:00,['258f67db64c204bc08cacd79f6d1816ab89d089a'],78,89,167,5889609,1,0.142857143,1,0.285714286,4065
29c04c7eb9f830baf2d76ca80ed4b5f120adaae0,0,Govind Menon,2019-02-06 15:13:22-06:00,['ceb867c8c048528cfc71e7d580a3372775a23508'],1,2,3,5889612,1,,,,4065
e93e00c57b108dd6ee57ac2f133ba93b29b24c79,0,Govind Menon,2019-02-06 15:13:22-06:00,['29c04c7eb9f830baf2d76ca80ed4b5f120adaae0'],2,2,4,5889616,1,,,,4065
0e7d372701e2e649f910e8d56a0516bd5d40eab6,0,Govind Menon,2019-02-06 15:13:22-06:00,['e93e00c57b108dd6ee57ac2f133ba93b29b24c79'],0,4,4,5889620,1,0,0,1,4065
5a434bb29eadf484daa0e8675a99d02baeb5fdd3,0,Govind Menon,2019-02-06 15:13:22-06:00,['0e7d372701e2e649f910e8d56a0516bd5d40eab6'],6,27,33,5889653,1,0,0,1,4065
33850c65830bc7456c3b612052be65730321c920,0,Govind Menon,2019-02-06 15:13:22-06:00,['5a434bb29eadf484daa0e8675a99d02baeb5fdd3'],2,6,8,5889661,1,,,,4065
5d73e28625aa881bf776990192363ac293774014,0,Govind Menon,2019-02-06 15:13:22-06:00,['33850c65830bc7456c3b612052be65730321c920'],0,10,10,5889671,2,,,,4065
9b03a05f482524c65f826dc22f49a07e7efa65f8,0,Govind Menon,2019-02-06 15:13:22-06:00,['5d73e28625aa881bf776990192363ac293774014'],3,3,6,5889677,1,,,,4065
f38476d3b163908b6c2d972790d8f87604dcbbca,0,Govind Menon,2019-02-06 15:13:22-06:00,['9b03a05f482524c65f826dc22f49a07e7efa65f8'],1,7,8,5889685,1,1,1,1,4065
e8b5435783e47424d5ca1367ca8fca2ee6ae2aeb,0,Govind Menon,2019-02-06 15:39:42-06:00,"['4b665dbbb8c3e45dbe5c8cdf8363efd1e88b369b', 'f38476d3b163908b6c2d972790d8f87604dcbbca']",705,1548,2253,5891938,7,,,,4065
6bbe435429abff24c88a85e85b316da879d9c734,0,GitHub,2019-02-08 16:10:35-05:00,"['10a5e3ee219b93ef77b0c642f9f3536e62459766', '487e58578d2708171cf81745335f5dd07e223c88']",9,14,23,5892115,1,,,,4065
d93bce040627e606214288fc16ade2fb488e6cf4,0,Stig Rohde D酶ssing,2019-02-16 12:51:08+01:00,"['6bbe435429abff24c88a85e85b316da879d9c734', '9df5de6993b347e3b0ca3b18da35271022ad8d46']",430,401,831,5892946,13,,,,4065
9fea42fe11f808550e604ec349b4b3366d20929b,0,Stig Rohde D酶ssing,2019-02-16 12:51:29+01:00,"['d93bce040627e606214288fc16ade2fb488e6cf4', 'd3c784c642e5e7483816f9a318f4d7436926c2a7']",69,85,154,5893100,8,,,,4065
435e57b09ec8d00d2e630f710f0f6db9f0746842,0,Aaron Gresch,2019-02-20 14:21:10-06:00,['9fea42fe11f808550e604ec349b4b3366d20929b'],200,435,635,5893735,19,0.381578947,0.710526316,0.881578947,4065
e3029000620f9dd07463c58cc5b5ada3fa39f43f,0,Stig Rohde D酶ssing,2019-02-21 10:39:56+01:00,"['9fea42fe11f808550e604ec349b4b3366d20929b', '435e57b09ec8d00d2e630f710f0f6db9f0746842']",200,435,635,5894370,19,,,,4065
e909b3d604367e7c47c3bbf3ec8e7f6b672ff778,0,Stig Rohde D酶ssing,2019-02-21 11:29:57+01:00,['e3029000620f9dd07463c58cc5b5ada3fa39f43f'],330,834,1164,5895534,19,0.426229508,0.81557377,0.963114754,4070
35b294b6cc1de035fcbc957f4782a93f0ccf27f4,0,Stig Rohde D酶ssing,2019-02-21 12:13:40+01:00,['e909b3d604367e7c47c3bbf3ec8e7f6b672ff778'],12,6,18,5895552,1,0.857142857,0,0,4070
499ba076a9e1b2f93eda03895d761d1ff0bc6332,0,Stig Rohde D酶ssing,2019-02-21 17:31:57+01:00,['9fea42fe11f808550e604ec349b4b3366d20929b'],1,134,135,5895687,3,,,,4071
8014f8434ae3a7ec354402df0a13cd516bf5fead,0,Aaron Gresch,2019-02-22 11:36:17-06:00,['e909b3d604367e7c47c3bbf3ec8e7f6b672ff778'],2,4,6,5895693,1,1,1,1,4071
4b1caa02dbb0a6e92312845cde67ced8861e07d9,0,Jungtaek Lim (HeartSaVioR),2019-02-25 22:43:52+09:00,['e909b3d604367e7c47c3bbf3ec8e7f6b672ff778'],6,6,12,5895705,4,,,,4071
7b0bc3b36e7d89e332d47956b747c3f77a6a21ad,0,Jungtaek Lim (HeartSaVioR),2019-02-25 22:54:34+09:00,['e909b3d604367e7c47c3bbf3ec8e7f6b672ff778'],3,3,6,5895711,1,,,,4071
fe9c734f990be507efdf011d4bb1938f8b8e21b5,0,Jungtaek Lim (HeartSaVioR),2019-02-26 22:58:51+09:00,"['e909b3d604367e7c47c3bbf3ec8e7f6b672ff778', '4b1caa02dbb0a6e92312845cde67ced8861e07d9']",6,6,12,5895723,4,,,,4071
b3c0c8b6f0bc02ae2100335ea35ab4b0a3888499,0,Jungtaek Lim (HeartSaVioR),2019-02-26 22:59:57+09:00,"['fe9c734f990be507efdf011d4bb1938f8b8e21b5', '7b0bc3b36e7d89e332d47956b747c3f77a6a21ad']",3,3,6,5895729,1,,,,4071
0eb14a5f6ed882324319c33b45345b076897288c,0,GitHub,2019-02-26 23:18:10+09:00,"['b3c0c8b6f0bc02ae2100335ea35ab4b0a3888499', '499ba076a9e1b2f93eda03895d761d1ff0bc6332']",1,134,135,5895864,3,,,,4071
c4898b9c2d4ec89b1da702e5c4c2b5969065436e,0,Jungtaek Lim (HeartSaVioR),2019-02-27 04:52:50+09:00,"['0eb14a5f6ed882324319c33b45345b076897288c', '87f125a678d3ce996386840a0b71cf17102d4373']",9,21,30,5895894,4,,,,4071
78463c3403ba76d3a67ea622aa875f8d64710ca9,0,Jungtaek Lim (HeartSaVioR),2019-02-27 04:53:20+09:00,"['c4898b9c2d4ec89b1da702e5c4c2b5969065436e', '35b294b6cc1de035fcbc957f4782a93f0ccf27f4']",12,6,18,5895912,1,,,,4071
ab8de9ac252032f62e68b9eb8d269c5ed42b5d07,0,Stig Rohde D酶ssing,2019-02-26 22:59:44+01:00,['78463c3403ba76d3a67ea622aa875f8d64710ca9'],4,10,14,5895926,1,1,1,0,4071
cd1062969bace192f1ea6985cb0aea92bd5aae3f,0,Aaron Gresch,2019-02-27 08:32:26-06:00,['8014f8434ae3a7ec354402df0a13cd516bf5fead'],15,61,76,5896002,6,0,1,0.878787879,4071
da8c4539e7c697b2ca706a26a0a6092930dc7ae0,0,Stig Rohde D酶ssing,2019-02-27 20:38:52+01:00,['ab8de9ac252032f62e68b9eb8d269c5ed42b5d07'],26,7,33,5896035,1,,,,4071
901f4aa81ccb9596ea46dac23bd7d82aba2cfaa2,1,Arun Mahadevan,2019-02-28 12:33:14-08:00,['ab8de9ac252032f62e68b9eb8d269c5ed42b5d07'],1578,3184,4762,5900797,119,,,,4071
d1bd66843b9c2089dcd8189c2bfbeab9c2990417,0,Vivek Ojha,2019-03-01 18:50:00+05:18,['e909b3d604367e7c47c3bbf3ec8e7f6b672ff778'],4,13,17,5900814,1,0,0,1,4071
41fe57a9a65f8b0007d327f01442ecb8d0982521,0,Stig Rohde D酶ssing,2019-03-04 13:38:33+01:00,['901f4aa81ccb9596ea46dac23bd7d82aba2cfaa2'],53,133,186,5901000,11,1,0,0,4071
b07413670fa62fec077c92cb78fc711c3bda820c,0,Stig Rohde D酶ssing,2019-03-05 10:40:31+01:00,"['901f4aa81ccb9596ea46dac23bd7d82aba2cfaa2', 'd1bd66843b9c2089dcd8189c2bfbeab9c2990417']",4,13,17,5901017,1,,,,4071
232933175b2a1d04eb7262881d2872daec75f5d8,0,Stig Rohde D酶ssing,2019-03-05 14:05:45+01:00,['b07413670fa62fec077c92cb78fc711c3bda820c'],9,8,17,5901034,6,,,,4071
57befa1a3dbfbbca93299223007559f00c1c6f55,0,Stig Rohde D酶ssing,2019-03-07 07:10:12+01:00,"['b07413670fa62fec077c92cb78fc711c3bda820c', 'da12d89f555f33bf5c15ab49e0ce4859228b42a5']",14,53,67,5901101,10,,,,4071
002bc97d4acd497f9bfb0e64edd131f6b34e7ea8,0,Stig Rohde D酶ssing,2019-03-07 07:11:40+01:00,"['57befa1a3dbfbbca93299223007559f00c1c6f55', 'da8c4539e7c697b2ca706a26a0a6092930dc7ae0']",26,7,33,5901134,1,,,,4071
0a4b4330e585e5a40845b1752b14f9beacb92268,0,Stig Rohde D酶ssing,2019-03-07 07:11:57+01:00,"['002bc97d4acd497f9bfb0e64edd131f6b34e7ea8', '41fe57a9a65f8b0007d327f01442ecb8d0982521']",53,133,186,5901320,11,,,,4071
e0feb6cf04107029d4b24420f265495cdfbdb098,0,Stig Rohde D酶ssing,2019-03-07 07:12:04+01:00,"['0a4b4330e585e5a40845b1752b14f9beacb92268', '232933175b2a1d04eb7262881d2872daec75f5d8']",9,8,17,5901337,6,,,,4071
947c7b22acf4cdf4f95001b26e700a590d675220,1,Stig Rohde D酶ssing,2019-03-07 18:27:14+01:00,['e0feb6cf04107029d4b24420f265495cdfbdb098'],61,198,259,5901596,7,0,0.920454545,1,4071
e069c06657e60023094ee9c0540d7e10762409c4,0,Jungtaek Lim (HeartSaVioR),2019-03-11 23:00:02+09:00,['b07413670fa62fec077c92cb78fc711c3bda820c'],1,1,2,5901598,1,,,,4071
8a332e382e404d1341b09f7b77c74c5bbec43610,0,Aaron Gresch,2019-03-15 10:33:30-05:00,['cd1062969bace192f1ea6985cb0aea92bd5aae3f'],17,33,50,5901648,4,1,1,0.266666667,4071
0da9f18dd479a77a9d0e3ea575c001232f91fefe,0,Aaron Gresch,2019-03-15 10:36:26-05:00,['8a332e382e404d1341b09f7b77c74c5bbec43610'],1,1,2,5901650,1,,,,4071
18ead35b38a1cb4f63ea69c60629da9725ded839,0,Jungtaek Lim (HeartSaVioR),2019-03-16 03:41:51+09:00,"['e0feb6cf04107029d4b24420f265495cdfbdb098', '947c7b22acf4cdf4f95001b26e700a590d675220']",61,198,259,5901909,7,,,,4071
77c4e2857175cb980f984bc1dbe19751d71f9f41,0,Jungtaek Lim (HeartSaVioR),2019-03-16 03:45:31+09:00,"['18ead35b38a1cb4f63ea69c60629da9725ded839', '0da9f18dd479a77a9d0e3ea575c001232f91fefe']",15,79,94,5902003,5,,,,4071
ca3a17a39ec488f772324a97b4d0c63421df492b,0,Jungtaek Lim (HeartSaVioR),2019-03-16 03:50:59+09:00,"['77c4e2857175cb980f984bc1dbe19751d71f9f41', 'e069c06657e60023094ee9c0540d7e10762409c4']",1,1,2,5902005,1,,,,4071
b25c242813da80dd1c5ee1ef6aa33499a0c1c10b,0,Stig Rohde D酶ssing,2019-03-15 19:55:53+01:00,['ca3a17a39ec488f772324a97b4d0c63421df492b'],17,160,177,5902182,23,,,,4071
719124682e6a736fac5c4e089bed55f9d45e7b20,0,Stig Rohde D酶ssing,2019-03-15 19:57:42+01:00,['ca3a17a39ec488f772324a97b4d0c63421df492b'],1,1,2,5902184,1,,,,4071
2cfbe073848ef7074a26f0929c934a4f283793fc,0,Stig Rohde D酶ssing,2019-03-15 19:58:32+01:00,['ca3a17a39ec488f772324a97b4d0c63421df492b'],0,20,20,5902204,2,,,,4071
49cf9ccd087fd81e563172a9c695b0a409dcdf64,0,Stig Rohde D酶ssing,2019-03-15 19:58:48+01:00,['ca3a17a39ec488f772324a97b4d0c63421df492b'],1,1,2,5902206,1,,,,4071
60199bd7600a7d8b32cea59d5691c279e4032c0f,0,Stig Rohde D酶ssing,2019-03-15 20:17:27+01:00,['ca3a17a39ec488f772324a97b4d0c63421df492b'],13,17,30,5902236,7,0,1,1,4071
18e24a31745d9f6116e4c0dfca6e2d9d78a1625f,0,Stig Rohde D酶ssing,2019-03-15 21:58:40+01:00,"['ca3a17a39ec488f772324a97b4d0c63421df492b', '719124682e6a736fac5c4e089bed55f9d45e7b20']",1,1,2,5902238,1,,,,4071
65ce33cc6dfdad5261dd1609dc95965262d6c299,0,Stig Rohde D酶ssing,2019-03-15 22:00:14+01:00,"['18e24a31745d9f6116e4c0dfca6e2d9d78a1625f', 'b25c242813da80dd1c5ee1ef6aa33499a0c1c10b']",17,160,177,5902415,23,,,,4071
68d2f49e2bfd984b9d015bc7f40ae600a0031ca1,0,Stig Rohde D酶ssing,2019-03-15 22:00:58+01:00,"['65ce33cc6dfdad5261dd1609dc95965262d6c299', '60199bd7600a7d8b32cea59d5691c279e4032c0f']",13,17,30,5902445,7,,,,4071
d4b53b7d41a4b55975c48b5412581de74b9bd80c,0,Stig Rohde D酶ssing,2019-03-15 22:04:59+01:00,['68d2f49e2bfd984b9d015bc7f40ae600a0031ca1'],1,3,4,5902449,1,,,,4071
f335cce2bcd7ff55505c9f0c238b2fefa58b9ebd,0,Jungtaek Lim (HeartSaVioR),2019-03-16 11:54:57+09:00,"['68d2f49e2bfd984b9d015bc7f40ae600a0031ca1', 'd4b53b7d41a4b55975c48b5412581de74b9bd80c']",1,3,4,5902453,1,,,,4071
8848bb858df41b63c430c604301ddea164a8a904,0,Jungtaek Lim (HeartSaVioR),2019-03-16 12:35:28+09:00,"['f335cce2bcd7ff55505c9f0c238b2fefa58b9ebd', '2cfbe073848ef7074a26f0929c934a4f283793fc']",0,20,20,5902473,2,,,,4071
0ea3c89f5f7605bc919a73fc10a0e5ffc2d8acfd,0,Jungtaek Lim (HeartSaVioR),2019-03-18 06:17:30+09:00,"['8848bb858df41b63c430c604301ddea164a8a904', '49cf9ccd087fd81e563172a9c695b0a409dcdf64']",1,1,2,5902475,1,,,,4071
8e78d34797bd3c7e58af1b03d99268fb8cef40b6,0,P. Taylor Goetz,2019-03-22 12:39:20-04:00,['0ea3c89f5f7605bc919a73fc10a0e5ffc2d8acfd'],73,73,146,5902621,72,,,,4071
b5823809bd4b438e789a36f163f318d4b161ad13,0,P. Taylor Goetz,2019-03-22 13:35:40-04:00,['8e78d34797bd3c7e58af1b03d99268fb8cef40b6'],73,73,146,5902767,72,,,,4071
dc56e32f3dcdd9396a827a85029d60ed97474786,0,P. Taylor Goetz,2019-03-22 13:36:02-04:00,['b5823809bd4b438e789a36f163f318d4b161ad13'],73,73,146,5902913,72,,,,4071
9b36f634521f8659f8d859c004fb7b1c16c4eb58,0,Jungtaek Lim (HeartSaVioR),2019-03-28 17:52:15+09:00,['dc56e32f3dcdd9396a827a85029d60ed97474786'],68,31,99,5903012,4,,,,4071
52989cb57660c0d68c137c0a4ddaff46687bc336,0,Stig Rohde D酶ssing,2019-03-28 10:46:37+01:00,['dc56e32f3dcdd9396a827a85029d60ed97474786'],4,1,5,5903017,2,,,,4071
27921e208a1373f4f3d8b1639693510e23cb593b,0,Stig Rohde D酶ssing,2019-03-28 14:25:18+01:00,['ca3a17a39ec488f772324a97b4d0c63421df492b'],123,162,285,5903302,10,1,1,1,4072
ec0a99a2fd747c0fe53f8dc7acb6c229e0e44d44,0,York Yang,2019-03-28 11:37:33-04:00,['dc56e32f3dcdd9396a827a85029d60ed97474786'],0,15,15,5903317,2,0.7,0.7,1,4072
7e98f2916a2d6e6087fa09ad8bb7dca45ba3f436,0,Jungtaek Lim (HeartSaVioR),2019-03-29 12:41:42+09:00,"['dc56e32f3dcdd9396a827a85029d60ed97474786', '27921e208a1373f4f3d8b1639693510e23cb593b']",123,162,285,5903602,10,,,,4072
c4aa01aaeb3c40a4614073f62e82b0c28df94e04,0,Jungtaek Lim (HeartSaVioR),2019-03-29 12:52:46+09:00,"['7e98f2916a2d6e6087fa09ad8bb7dca45ba3f436', 'ec0a99a2fd747c0fe53f8dc7acb6c229e0e44d44']",0,15,15,5903617,2,,,,4072
ffa85aaa376c6f12da6dbefc708e772e9e6764a5,0,Stig Rohde D酶ssing,2019-03-29 10:36:47+01:00,"['c4aa01aaeb3c40a4614073f62e82b0c28df94e04', '9b36f634521f8659f8d859c004fb7b1c16c4eb58']",68,31,99,5903716,4,,,,4072
37369fdf6f3e89d3a008b637b9539330e994b5f3,0,Stig Rohde D酶ssing,2019-03-29 10:38:40+01:00,"['ffa85aaa376c6f12da6dbefc708e772e9e6764a5', '52989cb57660c0d68c137c0a4ddaff46687bc336']",4,1,5,5903721,2,,,,4072
1374166af737b9d502a8edc298538698c92a1134,0,Kishor Patil,2019-03-29 15:53:46-04:00,['37369fdf6f3e89d3a008b637b9539330e994b5f3'],1,9,10,5903731,2,1,1,1,4072
5af22bf9e683e866262fd8b529593356e33e223a,0,Kishor Patil,2019-03-31 22:47:26-04:00,['1374166af737b9d502a8edc298538698c92a1134'],2,3,5,5903736,3,,,,4072
ecca56d770ff8ec0ba514758ae5b908e1b5d65df,1,Aaron Gresch,2019-04-01 12:36:15-05:00,['37369fdf6f3e89d3a008b637b9539330e994b5f3'],4,134,138,5903874,4,0.3,0.766666667,0.766666667,4072
2947fdbd3c1c9ef6c5afc909735c88003bee5a59,0,GitHub,2019-04-03 11:55:16-04:00,"['37369fdf6f3e89d3a008b637b9539330e994b5f3', 'ecca56d770ff8ec0ba514758ae5b908e1b5d65df']",4,134,138,5904012,4,,,,4072
9680928a0c6e26a8a2d3e5ceb9a632579546353d,0,GitHub,2019-04-03 12:12:05-04:00,"['2947fdbd3c1c9ef6c5afc909735c88003bee5a59', '5af22bf9e683e866262fd8b529593356e33e223a']",1,10,11,5904023,3,,,,4072
74d4bc275d412fa6f371c8f944aa7494e8474575,1,Stig Rohde D酶ssing,2019-04-04 12:44:11+02:00,['9680928a0c6e26a8a2d3e5ceb9a632579546353d'],127,142,269,5904292,14,0.5,0.857142857,0.785714286,4072
3482d41a33fb6bd308c3dad676abd747379632ab,0,Peter Chamberlain,2019-04-04 13:14:27+01:00,['9680928a0c6e26a8a2d3e5ceb9a632579546353d'],1,1,2,5904294,1,,,,4072
c884fe0f01b951b16ff57084b95d02f8cc5acaed,0,Stig Rohde D酶ssing,2019-04-04 19:24:48+02:00,['9680928a0c6e26a8a2d3e5ceb9a632579546353d'],16,7,23,5904317,1,,,,4072
52d2b3bf47dc9a42fb2880361f6323b41a9b2d7a,0,Stig Rohde D酶ssing,2019-04-04 20:11:09+02:00,['74d4bc275d412fa6f371c8f944aa7494e8474575'],1,63,64,5904381,3,1,1,1,4072
d1391dd6b72185f9e14feae27818c665e814be75,0,Stig Rohde D酶ssing,2019-04-05 18:10:42+02:00,"['9680928a0c6e26a8a2d3e5ceb9a632579546353d', '3482d41a33fb6bd308c3dad676abd747379632ab']",1,1,2,5904383,1,,,,4072
e22ae6ea72be92a24db9d6d45a56822d9d674246,1,Stig Rohde D酶ssing,2019-04-09 17:42:10+02:00,['d1391dd6b72185f9e14feae27818c665e814be75'],983,12274,13257,5917640,61,,,,4109
79a20ffb7986ff78c2089b48193e41bd328ed979,0,Stig Rohde D酶ssing,2019-04-09 18:45:53+02:00,"['d1391dd6b72185f9e14feae27818c665e814be75', 'e22ae6ea72be92a24db9d6d45a56822d9d674246']",983,12274,13257,5930897,61,,,,4109
c569f0dcbebb51b3f976a2efe930c51490784333,0,P. Taylor Goetz,2019-04-11 12:49:12-04:00,['79a20ffb7986ff78c2089b48193e41bd328ed979'],78,78,156,5931053,77,,,,4109
ac046ee6170d982f98b66f3ed21a82f979707d68,0,P. Taylor Goetz,2019-04-11 18:30:58-04:00,['c569f0dcbebb51b3f976a2efe930c51490784333'],78,78,156,5931209,77,,,,4109
1976cb332bc6e8dceaec278fb1c3927627981081,0,P. Taylor Goetz,2019-04-11 18:31:18-04:00,['ac046ee6170d982f98b66f3ed21a82f979707d68'],78,78,156,5931365,77,,,,4109
7eec29fc80b7c2e48137486bbeb65a18e35f648e,0,Aaron Gresch,2019-04-15 09:21:21-05:00,['1976cb332bc6e8dceaec278fb1c3927627981081'],2,83,85,5931450,5,0.436363636,1,0.945454545,4109
0dafa836071578c9c0db125066f151665cc474ad,0,Aaron Gresch,2019-04-15 15:30:46-05:00,['1976cb332bc6e8dceaec278fb1c3927627981081'],1,6,7,5931457,1,1,1,1,4109
d20e44c01429070027fd8a1fdde0af270574e232,0,Stig Rohde D酶ssing,2019-04-16 00:07:00+02:00,"['1976cb332bc6e8dceaec278fb1c3927627981081', '0dafa836071578c9c0db125066f151665cc474ad']",1,6,7,5931464,1,,,,4109
362b3b6a41c784eccc2f9362b403c45623a3ea51,0,bd2019us,2019-04-15 17:45:26-05:00,['1976cb332bc6e8dceaec278fb1c3927627981081'],4,2,6,5931470,2,0,0,0,4109
b48e10559b65e834884d59887b30fc86d2988c20,0,Stig Rohde D酶ssing,2019-04-16 09:04:33+02:00,"['d20e44c01429070027fd8a1fdde0af270574e232', '362b3b6a41c784eccc2f9362b403c45623a3ea51']",4,2,6,5931476,2,,,,4109
263c8d3562558f6ffdd6bbd208f7bed7b3f1370f,0,Stig Rohde D酶ssing,2019-04-17 14:20:33+02:00,['b48e10559b65e834884d59887b30fc86d2988c20'],23,18,41,5931517,3,,,,4109
ef240c3816a158e708f3e7372a421fa5230ec508,0,Stig Rohde D酶ssing,2019-04-18 14:48:43+02:00,"['b48e10559b65e834884d59887b30fc86d2988c20', '263c8d3562558f6ffdd6bbd208f7bed7b3f1370f']",23,18,41,5931558,3,,,,4109
844631ab5e52f9d4e35b0c9701a3c7df9476faa0,0,GitHub,2019-04-19 10:32:22-04:00,"['ef240c3816a158e708f3e7372a421fa5230ec508', '7eec29fc80b7c2e48137486bbeb65a18e35f648e']",2,83,85,5931643,5,,,,4109
2e260aa8dfcc4aa2fc30831b77c0c025cf4fa42e,0,P. Taylor Goetz,2019-04-29 12:57:44-04:00,['844631ab5e52f9d4e35b0c9701a3c7df9476faa0'],78,78,156,5931799,77,,,,4109
2ba95bbd1c911d4fc6363b1c4b9c4c6d86ac9aae,0,P. Taylor Goetz,2019-04-29 13:21:00-04:00,['2e260aa8dfcc4aa2fc30831b77c0c025cf4fa42e'],78,78,156,5931955,77,,,,4109
d21579509f9cb44fd4f91ac87f4395e03722c6cd,0,P. Taylor Goetz,2019-04-29 13:21:23-04:00,['2ba95bbd1c911d4fc6363b1c4b9c4c6d86ac9aae'],78,78,156,5932111,77,,,,4109
eacd235639da54810060fe61c5cd4904c2ebd3a9,0,Ethan Li,2019-05-01 09:29:44-05:00,['d21579509f9cb44fd4f91ac87f4395e03722c6cd'],1,1,2,5932113,1,,,,4109
0fcbb4e747ab25ae5435827a6aff054c1efe6be1,0,Stig Rohde D酶ssing,2019-05-01 22:36:18+02:00,['d21579509f9cb44fd4f91ac87f4395e03722c6cd'],1,1,2,5932115,1,,,,4109
1c940489df4f15ef974171ce2ebab069119aa401,0,Stig Rohde D酶ssing,2019-05-03 13:56:06+02:00,"['d21579509f9cb44fd4f91ac87f4395e03722c6cd', '0fcbb4e747ab25ae5435827a6aff054c1efe6be1']",1,1,2,5932117,1,,,,4109
48fb1e4af7a21fc15c5381f4c367435e7f181df8,0,Jungtaek Lim (HeartSaVioR),2019-05-05 18:04:30+09:00,"['1c940489df4f15ef974171ce2ebab069119aa401', '74d4bc275d412fa6f371c8f944aa7494e8474575']",127,142,269,5932386,14,,,,4109
fabfcd63792cddcf171cee15484b033c4c301bfe,0,Jungtaek Lim (HeartSaVioR),2019-05-05 18:05:47+09:00,"['48fb1e4af7a21fc15c5381f4c367435e7f181df8', '52d2b3bf47dc9a42fb2880361f6323b41a9b2d7a']",1,63,64,5932450,3,,,,4109
8951e7a89344100be6a6845b3cf500967f1bb930,0,Jungtaek Lim (HeartSaVioR),2019-05-05 18:06:48+09:00,"['fabfcd63792cddcf171cee15484b033c4c301bfe', 'c884fe0f01b951b16ff57084b95d02f8cc5acaed']",16,7,23,5932473,1,,,,4109
d3b8da09bad45975d85c035ae9e9d26836e0a7ea,0,Stig Rohde D酶ssing,2019-05-05 14:43:37+02:00,['8951e7a89344100be6a6845b3cf500967f1bb930'],1,1,2,5932475,1,,,,4109
aaf1113360ce151d86948860c2f290befa79abb8,1,Stig Rohde D酶ssing,2019-05-05 16:08:36+02:00,['8951e7a89344100be6a6845b3cf500967f1bb930'],265,247,512,5932987,25,0,0,0,4109
c985695e0728eb3af171ca6d346c51cc4e0b083a,1,Stig Rohde D酶ssing,2019-05-05 16:10:02+02:00,['aaf1113360ce151d86948860c2f290befa79abb8'],85,164,249,5933236,12,0.794117647,0.764705882,1,4110
2bf972e050af2356940f2b9ce59af6d660f49766,0,Stig Rohde D酶ssing,2019-05-05 16:12:55+02:00,"['8951e7a89344100be6a6845b3cf500967f1bb930', 'aaf1113360ce151d86948860c2f290befa79abb8']",265,247,512,5933748,25,,,,4110
26e6c06c4b94aa121457889b1bd22c74fa41b3f7,0,Stig Rohde D酶ssing,2019-05-05 16:13:19+02:00,"['2bf972e050af2356940f2b9ce59af6d660f49766', 'c985695e0728eb3af171ca6d346c51cc4e0b083a']",85,164,249,5933997,12,,,,4110
ecf97fc80370e81fe684894f994c3cd5b0e42d0b,0,Stig Rohde D酶ssing,2019-05-08 18:00:35+02:00,"['26e6c06c4b94aa121457889b1bd22c74fa41b3f7', 'd3b8da09bad45975d85c035ae9e9d26836e0a7ea']",1,1,2,5933999,1,,,,4110
9711d9afd7249c5fd44534e2edb8de8219860ad0,0,dandsager,2019-05-15 11:32:39-05:00,['d21579509f9cb44fd4f91ac87f4395e03722c6cd'],0,84,84,5934083,1,0,0.961538462,0.961538462,4110
50ae20d7392f602397d3946ef0b36d211777c3f0,0,Jungtaek Lim (HeartSaVioR),2019-05-17 19:08:50+09:00,"['ecf97fc80370e81fe684894f994c3cd5b0e42d0b', 'eacd235639da54810060fe61c5cd4904c2ebd3a9']",1,1,2,5934085,1,,,,4110
14530099b2accd462f3af815eee82d3d1b407c0a,0,Jungtaek Lim,2019-05-17 21:42:01+09:00,['50ae20d7392f602397d3946ef0b36d211777c3f0'],15,116,131,5934216,4,0.381818182,0.872727273,0.981818182,4110
4fcce90f77b17554ec3d3940b4af98ad1b52f006,0,Manuel Dossinger,2019-05-17 14:44:13+02:00,['50ae20d7392f602397d3946ef0b36d211777c3f0'],1,1,2,5934218,1,,,,4110
ab0b75084dc70232efd5d67a4ec8465902e34228,0,Jungtaek Lim (HeartSaVioR),2019-05-17 23:14:47+09:00,"['14530099b2accd462f3af815eee82d3d1b407c0a', '9711d9afd7249c5fd44534e2edb8de8219860ad0']",0,84,84,5934302,1,,,,4110
19b1aa6c83634faaf96049cce7c88ba8de8b37d8,0,dandsager,2019-05-17 14:33:10-05:00,['ab0b75084dc70232efd5d67a4ec8465902e34228'],7,8,15,5934317,1,,0,0,4110
7d385a55e89f25faeb6155b1934194e4cbd9d887,0,dandsager,2019-05-20 10:36:38-05:00,['19b1aa6c83634faaf96049cce7c88ba8de8b37d8'],1,1,2,5934319,1,,,,4110
969fea6562e137957001a718864e65ece15f272b,0,dandsager,2019-05-20 11:55:30-05:00,['7d385a55e89f25faeb6155b1934194e4cbd9d887'],1,1,2,5934321,1,,,,4110
2bbc8262ccd4119f4c98886d3aaab9431b5d585c,0,dandsager,2019-05-22 11:53:52-05:00,['ab0b75084dc70232efd5d67a4ec8465902e34228'],7,8,15,5934336,1,,0,0,4110
c5356f01846c6899b4fe752c5acac9f149ce3d77,0,dandsager,2019-05-22 11:54:11-05:00,"['2bbc8262ccd4119f4c98886d3aaab9431b5d585c', '969fea6562e137957001a718864e65ece15f272b']",0,0,0,5934336,0,,,,4110
9e50006020e9cb033a589704a55c0215e75ed5ad,1,lihonglin05,2019-05-28 06:35:58+08:00,['c5356f01846c6899b4fe752c5acac9f149ce3d77'],1,16,17,5934353,3,0.333333333,1,1,4110
cc5f3c4360693e9b546f9c8b69fef35a12e88f72,0,GitHub,2019-05-28 19:16:19+02:00,"['c5356f01846c6899b4fe752c5acac9f149ce3d77', '9e50006020e9cb033a589704a55c0215e75ed5ad']",1,16,17,5934370,3,,,,4110
92008a2419ad9e4521c3c30cbd117dd4f60c4dbc,0,GitHub,2019-05-30 22:11:37+02:00,"['cc5f3c4360693e9b546f9c8b69fef35a12e88f72', '4fcce90f77b17554ec3d3940b4af98ad1b52f006']",1,1,2,5934372,1,,,,4110
b3103407ccd84596422733dba72cdb191844623d,0,Stig Rohde D酶ssing,2019-06-01 13:11:29+02:00,['92008a2419ad9e4521c3c30cbd117dd4f60c4dbc'],4,4,8,5934380,3,,,,4110
4815bdc5ca5a2f9e8f94a4e62e439b9dd8003197,0,Karl-Philipp Richter,2019-06-03 19:49:00+02:00,['92008a2419ad9e4521c3c30cbd117dd4f60c4dbc'],17,350,367,5934747,66,,,,4110
90d7c0288d5dfbdeb02e9742d3f9215ce3178e5b,0,dandsager,2019-06-04 10:18:43-05:00,['969fea6562e137957001a718864e65ece15f272b'],17,31,48,5934795,1,0,1,1,4110
08468c5f9f5b45e8e96f3260fc60128ec567e771,0,GitHub,2019-06-04 13:35:33-05:00,"['92008a2419ad9e4521c3c30cbd117dd4f60c4dbc', '90d7c0288d5dfbdeb02e9742d3f9215ce3178e5b']",17,31,48,5934843,1,,,,4110
f4e18abfb8bc3864083e3c9fcf732e6486024e30,0,GitHub,2019-06-04 22:39:31+02:00,"['08468c5f9f5b45e8e96f3260fc60128ec567e771', '4815bdc5ca5a2f9e8f94a4e62e439b9dd8003197']",17,350,367,5935210,66,,,,4110
b9ab5e56a9ad1776022ed6d8520c0268a666fea0,0,GitHub,2019-06-06 16:21:47+02:00,"['f4e18abfb8bc3864083e3c9fcf732e6486024e30', 'b3103407ccd84596422733dba72cdb191844623d']",4,4,8,5935218,3,,,,4110
f7598f5e9069c6b7e0d0825f7e82861c8011ec12,0,Karl-Philipp Richter,2019-06-14 10:23:19+02:00,['b9ab5e56a9ad1776022ed6d8520c0268a666fea0'],2,585,587,5935805,181,0,0.730769231,0.730769231,4111
5d8731efb7d99adfbad403f6eed47cfb81e45341,0,GitHub,2019-06-15 19:50:52+02:00,"['b9ab5e56a9ad1776022ed6d8520c0268a666fea0', 'f7598f5e9069c6b7e0d0825f7e82861c8011ec12']",2,585,587,5936392,181,,,,4111
3c2cbaa0d99e5861d5bafed733d8f2220c7b3f3b,0,GitHub,2019-06-18 06:48:57+01:00,['5d8731efb7d99adfbad403f6eed47cfb81e45341'],1,1,2,5936394,1,,,,4111
43dee13cd3ab3af2a3e89290c3dc0a740fe19192,0,Stig Rohde D酶ssing,2019-06-20 07:57:01+02:00,['5d8731efb7d99adfbad403f6eed47cfb81e45341'],139,11,150,5936544,5,,,,4111
1757d9b3fc93f727726b4a185c939e61e88e1455,0,ruili8080,2019-06-20 11:24:18-05:00,['5d8731efb7d99adfbad403f6eed47cfb81e45341'],0,2,2,5936546,1,0,1,0,4111
6af03d385dcc2e18132cc156ee0de059ca02aa44,0,GitHub,2019-06-20 20:29:53+02:00,"['5d8731efb7d99adfbad403f6eed47cfb81e45341', '3c2cbaa0d99e5861d5bafed733d8f2220c7b3f3b']",1,1,2,5936548,1,,,,4111
dfae3c7e5a4128f821c9c8594156caf17f375d1a,0,GitHub,2019-06-20 21:22:44+02:00,"['6af03d385dcc2e18132cc156ee0de059ca02aa44', '43dee13cd3ab3af2a3e89290c3dc0a740fe19192']",139,11,150,5936698,5,,,,4111
fd34fd69200d207f6e8cbd8c4404003335e0c2c2,0,Karl-Philipp Richter,2019-06-23 22:24:02+02:00,['dfae3c7e5a4128f821c9c8594156caf17f375d1a'],42,69,111,5936809,7,0,1,1,4111
7411b1d45d5f343bf2a1cd43e552a02319a3a711,0,Karl-Philipp Richter,2019-06-23 22:45:09+02:00,['dfae3c7e5a4128f821c9c8594156caf17f375d1a'],59,66,125,5936934,5,,,,4111
7a07b5e8477d3078e616b7c41bc2f25c7a0d82b1,0,GitHub,2019-06-24 07:45:05+02:00,"['dfae3c7e5a4128f821c9c8594156caf17f375d1a', '7411b1d45d5f343bf2a1cd43e552a02319a3a711']",59,66,125,5937059,5,,,,4111
b19f28b2cf2ff200a30f79b99e38d304d111e56a,0,GitHub,2019-06-24 07:45:58+02:00,"['7a07b5e8477d3078e616b7c41bc2f25c7a0d82b1', 'fd34fd69200d207f6e8cbd8c4404003335e0c2c2']",42,69,111,5937170,7,,,,4111
ad3c64211ff56456056b23fae95db25bdece194e,0,Karl-Philipp Richter,2019-06-24 10:51:16+02:00,['b19f28b2cf2ff200a30f79b99e38d304d111e56a'],9,0,9,5937179,1,,,,4111
70353fcc247d63c51168d31558659c1fa4f54698,0,GitHub,2019-06-24 16:18:07+02:00,"['b19f28b2cf2ff200a30f79b99e38d304d111e56a', 'ad3c64211ff56456056b23fae95db25bdece194e']",9,0,9,5937188,1,,,,4111
7fd37ccd380395dddf3632c7a1b64487612695f7,0,GitHub,2019-06-24 09:44:35-05:00,"['70353fcc247d63c51168d31558659c1fa4f54698', '1757d9b3fc93f727726b4a185c939e61e88e1455']",0,2,2,5937190,1,,,,4111
fb76dd1c7dc39c4979f9cc921cf4a5930dfaa760,0,Stig D酶ssing,2019-06-25 19:39:43+02:00,['7fd37ccd380395dddf3632c7a1b64487612695f7'],106,135,241,5937431,3,0,0,0.357142857,4111
eb6a963d05da12e5b604a15a5633adde95a27748,0,Karl-Philipp Richter,2019-06-25 19:40:00+02:00,['7fd37ccd380395dddf3632c7a1b64487612695f7'],73,76,149,5937580,12,1,1,1,4111
de44647c76e3133ce4343b81eeda43db6fd2f7e9,0,Karl-Philipp Richter,2019-06-25 22:06:51+02:00,['7fd37ccd380395dddf3632c7a1b64487612695f7'],139,163,302,5937882,13,0,0,1,4111
443d99a8da9e346763887d73914b42ceeabab3d9,0,Karl-Philipp Richter,2019-06-26 17:58:17+02:00,['fb76dd1c7dc39c4979f9cc921cf4a5930dfaa760'],11,29,40,5937922,4,0,1,1,4111
bf0a2e51ccf36fec193f221ab40cd81218603ef2,0,Karl-Philipp Richter,2019-06-27 16:17:55+02:00,['fb76dd1c7dc39c4979f9cc921cf4a5930dfaa760'],97,158,255,5938177,10,0,0.565217391,0.956521739,4111
34750d557b82cbdfdef379ab9b7162142a06b169,0,Karl-Philipp Richter,2019-06-27 16:19:44+02:00,['fb76dd1c7dc39c4979f9cc921cf4a5930dfaa760'],188,279,467,5938644,13,0,0.451612903,0.596774194,4111
4822ecd7dd06e0ccc05c0dbcb850d2be4adb4fe7,0,GitHub,2019-06-27 19:38:01+02:00,"['fb76dd1c7dc39c4979f9cc921cf4a5930dfaa760', 'eb6a963d05da12e5b604a15a5633adde95a27748']",73,76,149,5938793,12,,,,4111
f617c6e25b7b6e4f74b601efab50005ace37870b,0,GitHub,2019-06-27 19:41:56+02:00,"['4822ecd7dd06e0ccc05c0dbcb850d2be4adb4fe7', '34750d557b82cbdfdef379ab9b7162142a06b169']",188,279,467,5939260,13,,,,4111
08d2b9e93e429c6e746f5f9e58082f52c75451a3,0,GitHub,2019-06-27 19:46:06+02:00,"['f617c6e25b7b6e4f74b601efab50005ace37870b', '443d99a8da9e346763887d73914b42ceeabab3d9']",11,29,40,5939300,4,,,,4111
9b23e8ac35970b4ceb8c21008954d00897c1e31a,0,GitHub,2019-06-27 19:47:44+02:00,"['08d2b9e93e429c6e746f5f9e58082f52c75451a3', 'de44647c76e3133ce4343b81eeda43db6fd2f7e9']",139,163,302,5939602,13,,,,4111
b4f9eb1dc7284fa7f3a28368c1538dd901c5dd6f,0,GitHub,2019-06-27 19:50:09+02:00,"['9b23e8ac35970b4ceb8c21008954d00897c1e31a', 'bf0a2e51ccf36fec193f221ab40cd81218603ef2']",97,158,255,5939857,10,,,,4111
8f9fedf37ba09f0d0d75e6d0232da10a8767833f,0,Karl-Philipp Richter,2019-06-27 21:39:41+02:00,['b4f9eb1dc7284fa7f3a28368c1538dd901c5dd6f'],43,15,58,5939915,7,0,1,1,4111
b32d1d80e9b18527c189403035844c5b3449bb6a,0,Karl-Philipp Richter,2019-06-27 21:54:59+02:00,['b4f9eb1dc7284fa7f3a28368c1538dd901c5dd6f'],47,81,128,5940043,5,0,0.636363636,1,4111
b203ae379b61117b0f795c3c408b81751cf8d3bc,0,Karl-Philipp Richter,2019-06-27 23:06:03+02:00,['b4f9eb1dc7284fa7f3a28368c1538dd901c5dd6f'],172,207,379,5940422,9,0.866666667,1,0.866666667,4111
d597e1d076260491ee14a2a7975f32ceaf77ab5d,0,Karl-Philipp Richter,2019-06-27 23:18:03+02:00,['b4f9eb1dc7284fa7f3a28368c1538dd901c5dd6f'],1,1,2,5940424,1,,,,4111
052e082376a4640987993148d000e6b12922550d,0,Karl-Philipp Richter,2019-06-27 23:22:20+02:00,['b4f9eb1dc7284fa7f3a28368c1538dd901c5dd6f'],5,4,9,5940433,3,,,,4111
871c20f524930cf9d3e9c03b08266d33aea04d65,0,Karl-Philipp Richter,2019-06-27 23:41:31+02:00,['b4f9eb1dc7284fa7f3a28368c1538dd901c5dd6f'],37,40,77,5940510,7,,,,4111
d5434f5e20effcea7be05c28416528470d90bc30,0,Karl-Philipp Richter,2019-06-28 16:11:55+02:00,['b4f9eb1dc7284fa7f3a28368c1538dd901c5dd6f'],71,89,160,5940670,8,1,1,1,4111
2c5c9b79e0550e7b8d2f8d8315edc2dc3d445ce2,0,Stig Rohde D酶ssing,2019-06-29 12:08:46+02:00,['b4f9eb1dc7284fa7f3a28368c1538dd901c5dd6f'],17,3,20,5940690,1,,,,4111
3819e696a424d792e1a39eb955b5c4fb46d3b81a,0,Stig Rohde D酶ssing,2019-06-30 10:12:28+02:00,['b4f9eb1dc7284fa7f3a28368c1538dd901c5dd6f'],9,10,19,5940709,3,0,0,0,4111
4b1d2aa21db2cf61d82c1e76a9de5c5cc935ab48,0,Karl-Philipp Richter,2019-06-30 12:19:22+02:00,['b4f9eb1dc7284fa7f3a28368c1538dd901c5dd6f'],44,53,97,5940806,10,1,1,0,4111
9e7109ac0c8e6de86ccb62ce4fabe9b9214d9d78,0,GitHub,2019-07-01 09:22:14-05:00,"['b4f9eb1dc7284fa7f3a28368c1538dd901c5dd6f', '3819e696a424d792e1a39eb955b5c4fb46d3b81a']",9,10,19,5940825,3,,,,4111
cb1bdc629774760533fc285e2703813250707c4a,0,ruili8080,2019-07-01 09:53:40-05:00,['fb76dd1c7dc39c4979f9cc921cf4a5930dfaa760'],1,4,5,5940830,2,0,0,0,4111
91c8cde21bd3b89c42102f932ebcb287057b962f,0,GitHub,2019-07-01 17:42:11+02:00,"['9e7109ac0c8e6de86ccb62ce4fabe9b9214d9d78', '8f9fedf37ba09f0d0d75e6d0232da10a8767833f']",43,15,58,5940888,7,,,,4111
b43793ccd905aca54e1bf32be89e36ac319b64da,0,GitHub,2019-07-01 17:43:59+02:00,"['91c8cde21bd3b89c42102f932ebcb287057b962f', 'b32d1d80e9b18527c189403035844c5b3449bb6a']",47,81,128,5941016,5,,,,4111
e80da42c4ff65713acaab20b4af075fcc0e72106,0,GitHub,2019-07-01 17:47:51+02:00,"['b43793ccd905aca54e1bf32be89e36ac319b64da', 'b203ae379b61117b0f795c3c408b81751cf8d3bc']",172,207,379,5941395,9,,,,4111
1070293513934e6ff5dfb3cc9cb29ce3c6a5fa56,0,GitHub,2019-07-01 17:48:50+02:00,"['e80da42c4ff65713acaab20b4af075fcc0e72106', 'd597e1d076260491ee14a2a7975f32ceaf77ab5d']",1,1,2,5941397,1,,,,4111
ead0bdd138f8b4b41d9483caedaf956394a13dc2,0,GitHub,2019-07-01 17:49:33+02:00,"['1070293513934e6ff5dfb3cc9cb29ce3c6a5fa56', '052e082376a4640987993148d000e6b12922550d']",5,4,9,5941406,3,,,,4111
220338f21b42e68bd9fb2a13ddbea6af04fbd068,0,GitHub,2019-07-01 17:50:27+02:00,"['ead0bdd138f8b4b41d9483caedaf956394a13dc2', '871c20f524930cf9d3e9c03b08266d33aea04d65']",37,40,77,5941483,7,,,,4111
a4a1070a34f8d4893daa4fcfc15dceafd35feec6,0,GitHub,2019-07-01 17:52:56+02:00,"['220338f21b42e68bd9fb2a13ddbea6af04fbd068', 'd5434f5e20effcea7be05c28416528470d90bc30']",71,89,160,5941643,8,,,,4111
994a48404b16fa4386b57ad82ab523f662bbd006,0,GitHub,2019-07-01 17:54:42+02:00,"['a4a1070a34f8d4893daa4fcfc15dceafd35feec6', '4b1d2aa21db2cf61d82c1e76a9de5c5cc935ab48']",44,53,97,5941740,10,,,,4111
26c471a802c6757c3ff623e877a0bb83c1bdfb93,0,david,2019-07-01 11:15:25-05:00,['994a48404b16fa4386b57ad82ab523f662bbd006'],10,39,49,5941789,5,0,0,1,4111
5d582b4972ef27718e79be267a4f46209500f86a,0,GitHub,2019-07-01 12:15:53-05:00,"['994a48404b16fa4386b57ad82ab523f662bbd006', 'cb1bdc629774760533fc285e2703813250707c4a']",1,4,5,5941794,2,,,,4111
4ec0180d779612a1e7dfdb18e3a99a3969287e10,0,Govind Menon,2019-07-01 12:40:18-05:00,['26c471a802c6757c3ff623e877a0bb83c1bdfb93'],1,4,5,5941799,2,0,0,0,4111
4568fb47d7bbce9d4c1194bd0a925bfa0b16d9ad,0,Govind Menon,2019-07-01 12:40:51-05:00,"['5d582b4972ef27718e79be267a4f46209500f86a', '4ec0180d779612a1e7dfdb18e3a99a3969287e10']",10,39,49,5941848,5,,,,4111
3c2e03ecfd1657ab99ceea9226f31667f8fd32e8,0,Karl-Philipp Richter,2019-07-01 20:19:38+02:00,['5d582b4972ef27718e79be267a4f46209500f86a'],114,116,230,5942078,28,1,1,1,4111
e3825f338347a027a0cab190c79bbb3c4f3a0892,0,Karl-Philipp Richter,2019-07-01 20:57:32+02:00,['5d582b4972ef27718e79be267a4f46209500f86a'],84,88,172,5942250,11,0.083333333,0.666666667,0.583333333,4111
7bf7268e25a627882ddccc68fdf58df9889011a5,0,Karl-Philipp Richter,2019-07-01 22:18:27+02:00,['5d582b4972ef27718e79be267a4f46209500f86a'],392,627,1019,5943269,27,0,1,1,4122
4bae551127c4e34eab49a352924bbc9fbbe6b83b,0,Karl-Philipp Richter,2019-07-01 22:22:21+02:00,['5d582b4972ef27718e79be267a4f46209500f86a'],87,67,154,5943423,9,0,1,1,4122
905007fb1db4f18158c85b3f92211be7ab73138b,0,Karl-Philipp Richter,2019-07-01 22:23:13+02:00,['5d582b4972ef27718e79be267a4f46209500f86a'],115,50,165,5943588,19,,,,4122
6549a5107137a79585f5b81ab61e2b7b5df92aee,1,Karl-Philipp Richter,2019-07-01 22:24:29+02:00,['5d582b4972ef27718e79be267a4f46209500f86a'],160,164,324,5943912,7,0,0,0.5,4122
fceb59af05b672540b223ef9ed1308eafe9e5ae9,0,Karl-Philipp Richter,2019-07-02 19:41:18+02:00,['5d582b4972ef27718e79be267a4f46209500f86a'],35,42,77,5943989,3,0.8,1,0.2,4122
fa0e64a4733cd305e3e86fa090f287ae2dc76ead,0,Hugo Da Cruz Louro,2019-07-02 14:51:37-07:00,['4568fb47d7bbce9d4c1194bd0a925bfa0b16d9ad'],1,1,2,5943991,1,,,,4122
8950d9b73d545cc28fa258532545873421519479,0,GitHub,2019-07-03 21:08:48+02:00,"['4568fb47d7bbce9d4c1194bd0a925bfa0b16d9ad', '3c2e03ecfd1657ab99ceea9226f31667f8fd32e8']",114,116,230,5944221,28,,,,4122
3ec02e0b1a4c9c35f67da803ac9e3c9d89ab7eb7,0,GitHub,2019-07-03 14:34:42-05:00,"['8950d9b73d545cc28fa258532545873421519479', 'fa0e64a4733cd305e3e86fa090f287ae2dc76ead']",1,1,2,5944223,1,,,,4122
b1ed06452d809cc2402f77fc3d29c9dd462195d9,0,Karl-Philipp Richter,2019-07-04 19:44:29+02:00,['5d582b4972ef27718e79be267a4f46209500f86a'],11,24,35,5944258,2,0,0,1,4122
82b8bdf8908de117fef0f5178d11325e70b42221,0,Karl-Philipp Richter,2019-07-04 19:48:18+02:00,['5d582b4972ef27718e79be267a4f46209500f86a'],104,69,173,5944431,10,,,,4122
138949285cd9514897c8abb836c8d9629199db9d,0,GitHub,2019-07-04 19:53:40+02:00,"['3ec02e0b1a4c9c35f67da803ac9e3c9d89ab7eb7', '905007fb1db4f18158c85b3f92211be7ab73138b']",115,50,165,5944596,19,,,,4122
f5aecc1b5d5e15c0c128f600c5a399eb0b0e8fc4,0,Karl-Philipp Richter,2019-07-04 19:54:19+02:00,['5d582b4972ef27718e79be267a4f46209500f86a'],287,312,599,5945195,17,0.181818182,0.727272727,0.181818182,4122
04af94793de3e4f20e247dba477db130c6d3e706,0,GitHub,2019-07-04 19:58:32+02:00,"['138949285cd9514897c8abb836c8d9629199db9d', '4bae551127c4e34eab49a352924bbc9fbbe6b83b']",87,67,154,5945349,9,,,,4122
2e9d2a3f349d932fff12f2fa65b06cd0169ff0dc,0,GitHub,2019-07-04 19:59:32+02:00,"['04af94793de3e4f20e247dba477db130c6d3e706', 'fceb59af05b672540b223ef9ed1308eafe9e5ae9']",35,42,77,5945426,3,,,,4122
3ecaf62d9f24f15a32d9b76b5b8d0ac957532ff6,0,GitHub,2019-07-04 20:02:34+02:00,"['2e9d2a3f349d932fff12f2fa65b06cd0169ff0dc', 'e3825f338347a027a0cab190c79bbb3c4f3a0892']",84,88,172,5945598,11,,,,4122
67ae024eb8f87a6f42423dee9bca6ce7ee8eebf0,0,GitHub,2019-07-04 20:10:49+02:00,"['3ecaf62d9f24f15a32d9b76b5b8d0ac957532ff6', '7bf7268e25a627882ddccc68fdf58df9889011a5']",392,627,1019,5946617,27,,,,4122
0b3ca352f3cb7c35141d6f07b5e831043ff26230,0,GitHub,2019-07-04 20:28:38+02:00,"['67ae024eb8f87a6f42423dee9bca6ce7ee8eebf0', '82b8bdf8908de117fef0f5178d11325e70b42221']",104,69,173,5946790,10,,,,4122
ace62896c5183943270fac15c6f5cbe3f133cda2,0,GitHub,2019-07-04 20:29:26+02:00,"['0b3ca352f3cb7c35141d6f07b5e831043ff26230', 'b1ed06452d809cc2402f77fc3d29c9dd462195d9']",11,24,35,5946825,2,,,,4122
bba702e6b6a077ab7e9c2d64c187b9ec6b8d25e5,0,GitHub,2019-07-04 20:33:52+02:00,"['ace62896c5183943270fac15c6f5cbe3f133cda2', '6549a5107137a79585f5b81ab61e2b7b5df92aee']",160,164,324,5947149,7,,,,4122
7ca1ffb81522a97c4a98fbf0da388cd1b0887051,0,GitHub,2019-07-04 20:35:49+02:00,"['bba702e6b6a077ab7e9c2d64c187b9ec6b8d25e5', 'f5aecc1b5d5e15c0c128f600c5a399eb0b0e8fc4']",287,312,599,5947748,17,,,,4122
83be1b9c015255162df41085b138c36921350ded,0,Karl-Philipp Richter,2019-07-04 22:57:42+02:00,['7ca1ffb81522a97c4a98fbf0da388cd1b0887051'],39,50,89,5947837,5,0.666666667,0.666666667,0.166666667,4122
2ac9e2e62a6fbb82bcff94c7015241f8135b6a4b,0,Karl-Philipp Richter,2019-07-05 12:00:14+02:00,['7ca1ffb81522a97c4a98fbf0da388cd1b0887051'],267,300,567,5948404,36,0,0.777777778,1,4123
926d7d143dd283d450b044617cb37be7525f5e3d,0,dandsager,2019-07-05 10:42:53-05:00,['4568fb47d7bbce9d4c1194bd0a925bfa0b16d9ad'],37,152,189,5948593,11,0.102803738,0.130841121,0.934579439,4123
8d4f0c6d7f3d8e58cab10822e42c2db4e74f8f84,0,GitHub,2019-07-05 13:37:52-05:00,"['7ca1ffb81522a97c4a98fbf0da388cd1b0887051', '926d7d143dd283d450b044617cb37be7525f5e3d']",37,152,189,5948782,11,,,,4123
4990c86285095f058a066b285ba74a4b2ffcc8cd,0,ruili8080,2019-07-05 14:44:10-05:00,['5d8731efb7d99adfbad403f6eed47cfb81e45341'],29,44,73,5948855,7,0,1,0,4123
4764432f1692a3a6f5e89a1bbf5e430481adb0f4,0,Karl-Philipp Richter,2019-07-05 22:33:37+02:00,['8d4f0c6d7f3d8e58cab10822e42c2db4e74f8f84'],39,27,66,5948921,18,0.666666667,0,0,4123
247d7f0038de23c50c7f5b1dca851ac30e0adfab,0,Karl-Philipp Richter,2019-07-05 23:26:32+02:00,['8d4f0c6d7f3d8e58cab10822e42c2db4e74f8f84'],18,18,36,5948957,7,0,1,1,4123
65ab12c3e7605904160ba62816067bb23a0f3944,0,Bruce Szudera Wienand,2019-07-05 15:01:26-07:00,['8d4f0c6d7f3d8e58cab10822e42c2db4e74f8f84'],1,1,2,5948959,1,,,,4123
c1431fb0f34de2b16bcb03fcc74f592d6099c571,0,Karl-Philipp Richter,2019-07-06 00:03:16+02:00,['8d4f0c6d7f3d8e58cab10822e42c2db4e74f8f84'],50,53,103,5949062,15,,,,4123
3cb335e950fa55e20aca325bff0c5e88d7f484b9,0,GitHub,2019-07-06 12:58:28+02:00,"['8d4f0c6d7f3d8e58cab10822e42c2db4e74f8f84', '83be1b9c015255162df41085b138c36921350ded']",39,50,89,5949151,5,,,,4123
1bb13c604918baedbe811e0c1b11d1954e43ad03,0,GitHub,2019-07-06 13:00:03+02:00,"['3cb335e950fa55e20aca325bff0c5e88d7f484b9', '4764432f1692a3a6f5e89a1bbf5e430481adb0f4']",39,27,66,5949217,18,,,,4123
f2a4d066d6cf68f90c28391c8aaf6376af489792,0,GitHub,2019-07-06 13:01:29+02:00,"['1bb13c604918baedbe811e0c1b11d1954e43ad03', '247d7f0038de23c50c7f5b1dca851ac30e0adfab']",18,18,36,5949253,7,,,,4123
351d21915b33f3f5e5db3824c5e4b2b396a528c0,0,GitHub,2019-07-06 13:02:41+02:00,"['f2a4d066d6cf68f90c28391c8aaf6376af489792', 'c1431fb0f34de2b16bcb03fcc74f592d6099c571']",50,53,103,5949356,15,,,,4123
addc1df5b555e1c9b4347dd0704e1b1b3e7b1ea0,0,GitHub,2019-07-06 13:17:26+02:00,"['351d21915b33f3f5e5db3824c5e4b2b396a528c0', '2ac9e2e62a6fbb82bcff94c7015241f8135b6a4b']",267,300,567,5949923,36,,,,4123
32ccd43e37e5fab42b8dc8d07b44180f6bda0a02,0,Karl-Philipp Richter,2019-07-06 14:55:09+02:00,['8d4f0c6d7f3d8e58cab10822e42c2db4e74f8f84'],30,34,64,5949987,9,0,0.111111111,1,4123
4f532273f9d63ac560561d13be31d5242d4d82b4,0,Karl-Philipp Richter,2019-07-06 14:59:49+02:00,['addc1df5b555e1c9b4347dd0704e1b1b3e7b1ea0'],168,154,322,5950309,48,0.511111111,0.733333333,0.888888889,4123
01b299bbd4c0a749f122befc7ec5d275832fdfe6,0,Karl-Philipp Richter,2019-07-06 15:04:36+02:00,['addc1df5b555e1c9b4347dd0704e1b1b3e7b1ea0'],252,187,439,5950748,40,0.571428571,0.642857143,0.142857143,4123
8cd3a5328dfa7c1de7e18cd0dc31d0e9f0fc61a4,0,GitHub,2019-07-06 17:53:37+02:00,"['addc1df5b555e1c9b4347dd0704e1b1b3e7b1ea0', '4f532273f9d63ac560561d13be31d5242d4d82b4']",168,154,322,5951070,48,,,,4123
224f75a30599f9abcd7161c4ff1993a96f3e9f5e,0,GitHub,2019-07-06 17:54:07+02:00,"['8cd3a5328dfa7c1de7e18cd0dc31d0e9f0fc61a4', '32ccd43e37e5fab42b8dc8d07b44180f6bda0a02']",30,34,64,5951134,9,,,,4123
98ac65fec88c15639f9f9a0fefba0f92d9a783cd,0,GitHub,2019-07-06 17:54:48+02:00,"['224f75a30599f9abcd7161c4ff1993a96f3e9f5e', '01b299bbd4c0a749f122befc7ec5d275832fdfe6']",252,187,439,5951573,40,,,,4123
f44624685ca5c12963c2939ca58eb0db10fbeb24,0,Karl-Philipp Richter,2019-07-06 18:01:32+02:00,['addc1df5b555e1c9b4347dd0704e1b1b3e7b1ea0'],13,19,32,5951605,5,,,,4123
918e894da7ac528cf2f350babe3878c36107b0ba,0,Karl-Philipp Richter,2019-07-06 18:09:45+02:00,['98ac65fec88c15639f9f9a0fefba0f92d9a783cd'],28,29,57,5951662,6,0,0,1,4123
5c610a1f110245a70e29c0e4c85d253c37b7e2be,0,Karl-Philipp Richter,2019-07-06 18:20:04+02:00,['98ac65fec88c15639f9f9a0fefba0f92d9a783cd'],56,61,117,5951779,5,0,0,1,4123
1672d4553b928a02b4d397c19b16ca672c07c723,0,Karl-Philipp Richter,2019-07-06 18:24:52+02:00,['98ac65fec88c15639f9f9a0fefba0f92d9a783cd'],14,16,30,5951809,3,,,,4123
fe41f8d02f80971a06e89d1095397a201888dbfb,0,Karl-Philipp Richter,2019-07-06 18:30:38+02:00,['98ac65fec88c15639f9f9a0fefba0f92d9a783cd'],30,37,67,5951876,10,,,,4123
5438a0157eb0cfeb87ffa66633b23286fcc806fe,0,Karl-Philipp Richter,2019-07-06 18:39:42+02:00,['98ac65fec88c15639f9f9a0fefba0f92d9a783cd'],38,53,91,5951967,14,,,,4123
925422a5b5ad1c3329a2c2b44db460ae94f70806,1,Stig D酶ssing,2019-07-07 18:51:36+02:00,['98ac65fec88c15639f9f9a0fefba0f92d9a783cd'],6078,6037,12115,5964082,459,0,0.654761905,0.666666667,4124
f5ddeb2682054320b816fe65269218a31456aa7d,0,GitHub,2019-07-07 18:54:12+02:00,"['925422a5b5ad1c3329a2c2b44db460ae94f70806', 'f44624685ca5c12963c2939ca58eb0db10fbeb24']",13,19,32,5964114,5,,,,4124
5b1f70d50be4e670bbe0090ca888c6f406f8d4e7,0,GitHub,2019-07-07 18:55:37+02:00,"['f5ddeb2682054320b816fe65269218a31456aa7d', '918e894da7ac528cf2f350babe3878c36107b0ba']",28,29,57,5964171,6,,,,4124
efb40479f502468c228311775da27ee525c1bdc0,0,GitHub,2019-07-07 18:56:46+02:00,"['5b1f70d50be4e670bbe0090ca888c6f406f8d4e7', '5c610a1f110245a70e29c0e4c85d253c37b7e2be']",56,61,117,5964288,5,,,,4124
237b0da7038440f853f06cd4c827372457acfc50,0,GitHub,2019-07-07 18:57:21+02:00,"['efb40479f502468c228311775da27ee525c1bdc0', '1672d4553b928a02b4d397c19b16ca672c07c723']",14,16,30,5964318,3,,,,4124
bc42472d07e2539725baa2f0ae6486c6698720d1,0,GitHub,2019-07-07 18:58:18+02:00,"['237b0da7038440f853f06cd4c827372457acfc50', 'fe41f8d02f80971a06e89d1095397a201888dbfb']",30,37,67,5964385,10,,,,4124
65d545e769ac94c09490d2e2363bd70ac4b2133a,0,GitHub,2019-07-07 18:59:26+02:00,"['bc42472d07e2539725baa2f0ae6486c6698720d1', '5438a0157eb0cfeb87ffa66633b23286fcc806fe']",38,53,91,5964476,14,,,,4124
c6bf261a23a26e40a0a97075306a5e979bbbefee,0,GitHub,2019-07-07 19:00:16+02:00,"['65d545e769ac94c09490d2e2363bd70ac4b2133a', '65ab12c3e7605904160ba62816067bb23a0f3944']",1,1,2,5964478,1,,,,4124
2ac0a0d09fb778dfd74f92fabffe73af4bd24115,0,Karl-Philipp Richter,2019-07-07 22:32:02+02:00,['c6bf261a23a26e40a0a97075306a5e979bbbefee'],30,0,30,5964508,1,,,,4124
60a93add93bc4e1d63ad6d3356a81626ace00920,0,Petr Jane膷ek,2019-07-08 19:06:32+02:00,['c6bf261a23a26e40a0a97075306a5e979bbbefee'],11,22,33,5964541,1,1,1,1,4124
727caf6a06ccf5427ec30ed0055d927e1551cae3,0,GitHub,2019-07-08 20:00:57+02:00,"['c6bf261a23a26e40a0a97075306a5e979bbbefee', '60a93add93bc4e1d63ad6d3356a81626ace00920']",11,22,33,5964574,1,,,,4124
80b2384c9a2a3b7dcc815231dfb1951120ed7ae5,0,GitHub,2019-07-08 14:45:57-05:00,"['727caf6a06ccf5427ec30ed0055d927e1551cae3', '4990c86285095f058a066b285ba74a4b2ffcc8cd']",29,44,73,5964647,7,,,,4124
e73b5cf0615899be682c5a7480f2e3f0d222f99b,0,jongho123,2019-07-10 17:00:56+09:00,['80b2384c9a2a3b7dcc815231dfb1951120ed7ae5'],1,1,2,5964649,1,,,,4124
545a464f18315942b8dffcbb70186a3665a5a796,0,GitHub,2019-07-11 16:35:03-05:00,"['80b2384c9a2a3b7dcc815231dfb1951120ed7ae5', 'e73b5cf0615899be682c5a7480f2e3f0d222f99b']",1,1,2,5964651,1,,,,4124
bb680dd2f8d7f14e40b9628850954869428d96a0,0,GitHub,2019-07-14 12:01:22+02:00,"['545a464f18315942b8dffcbb70186a3665a5a796', '2ac0a0d09fb778dfd74f92fabffe73af4bd24115']",30,0,30,5964681,1,,,,4124
e1dcb03e22f78ac6eb853e817b1067c09235c6f7,0,Stig D酶ssing,2019-07-14 12:02:34+02:00,['bb680dd2f8d7f14e40b9628850954869428d96a0'],0,1,1,5964682,1,,,,4124
0ade48d96257c75e99c5bccb1fd1788e46b3c190,0,Stig Rohde D酶ssing,2019-07-19 18:49:45+02:00,['e1dcb03e22f78ac6eb853e817b1067c09235c6f7'],0,59,59,5964741,2,,,,4125
d16b99f302bb106cfd8464ce3747e38ccd9cb205,0,Stig Rohde D酶ssing,2019-07-19 18:59:06+02:00,['e1dcb03e22f78ac6eb853e817b1067c09235c6f7'],2,3,5,5964746,1,,,,4125
e240079e75532648b13fd84123f4e79d97fdcc87,0,GitHub,2019-07-19 16:26:33-05:00,"['e1dcb03e22f78ac6eb853e817b1067c09235c6f7', 'd16b99f302bb106cfd8464ce3747e38ccd9cb205']",2,3,5,5964751,1,,,,4125
0114323fc7f434d65b474798f5cfd35b85d8c3df,0,GitHub,2019-07-19 16:29:21-05:00,"['e240079e75532648b13fd84123f4e79d97fdcc87', '0ade48d96257c75e99c5bccb1fd1788e46b3c190']",0,59,59,5964810,2,,,,4125
f4bda6d6a41049d1e2dc6fdb617efb620cdf8b2e,0,Nes Cohen,2019-07-19 14:29:52-07:00,['e1dcb03e22f78ac6eb853e817b1067c09235c6f7'],2,3,5,5964815,1,,,,4125
2576e38dfd89149ba47f1af4e74f2ee5f512d66f,0,GitHub,2019-07-19 16:39:19-05:00,"['0114323fc7f434d65b474798f5cfd35b85d8c3df', 'f4bda6d6a41049d1e2dc6fdb617efb620cdf8b2e']",2,3,5,5964820,1,,,,4125
27883442e59973658f62a281382800e7a3289c38,0,Stig Rohde D酶ssing,2019-07-20 17:52:24+02:00,['2576e38dfd89149ba47f1af4e74f2ee5f512d66f'],11704,1,11705,5976525,36,0.326471799,0.300123508,0.064635653,4125
1008feba371dd33232070603a54f8b3f4ed49ae7,0,Aaron Gresch,2019-07-25 16:29:04-05:00,['2576e38dfd89149ba47f1af4e74f2ee5f512d66f'],0,4,4,5976529,1,0,0,1,4125
2b669f8f101617fc227b0bbb00456eff60f2a6bf,0,GitHub,2019-07-26 07:53:23+02:00,"['2576e38dfd89149ba47f1af4e74f2ee5f512d66f', '2c5c9b79e0550e7b8d2f8d8315edc2dc3d445ce2']",17,3,20,5976549,1,,,,4125
a09020ac48af5f219626c9059e53cffd354c1bdb,0,GitHub,2019-07-26 07:54:14+02:00,"['2b669f8f101617fc227b0bbb00456eff60f2a6bf', '27883442e59973658f62a281382800e7a3289c38']",11704,1,11705,5988254,36,,,,4125
a694d873f93616474430a337d7819e174f9e9b5b,0,GitHub,2019-07-26 18:40:29+02:00,['a09020ac48af5f219626c9059e53cffd354c1bdb'],27,42,69,5988323,6,0,0.333333333,0.666666667,4125
9f10f8a14482e4eb1c1323ac86d3c373634539c2,0,Stig D酶ssing,2019-07-26 18:49:05+02:00,['a694d873f93616474430a337d7819e174f9e9b5b'],3,3,6,5988329,1,,,,4125
94e5ad1fba57f991257e461b512114f5555f011b,0,GitHub,2019-07-29 17:42:29+02:00,"['9f10f8a14482e4eb1c1323ac86d3c373634539c2', '1008feba371dd33232070603a54f8b3f4ed49ae7']",0,4,4,5988333,1,,,,4125
d1912ae98afe9f470a05e57835c41f056cebb311,0,Stig Rohde D酶ssing,2019-07-29 22:48:10+02:00,['9f10f8a14482e4eb1c1323ac86d3c373634539c2'],161,268,429,5988762,13,1,1,1,4127
788b93445c28ddd74a637e2109d3a647233774d4,0,Stig Rohde D酶ssing,2019-07-29 23:55:58+02:00,['d1912ae98afe9f470a05e57835c41f056cebb311'],7,2,9,5988771,2,0.333333333,0,0,4127
f015130b0e4b33191f9fa84302f46f9a5e10c014,0,GitHub,2019-07-29 23:56:57+02:00,"['94e5ad1fba57f991257e461b512114f5555f011b', 'd1912ae98afe9f470a05e57835c41f056cebb311']",161,268,429,5989200,13,,,,4127
7a98768a20fc716bc2330a159781ef49a8b6f631,0,GitHub,2019-07-31 11:06:13-05:00,"['f015130b0e4b33191f9fa84302f46f9a5e10c014', '788b93445c28ddd74a637e2109d3a647233774d4']",7,2,9,5989209,2,,,,4127
89893556a936fa3482b2387cbfe1797ab7614566,0,Meng Li (Ethan),2019-07-31 11:11:48-05:00,['7a98768a20fc716bc2330a159781ef49a8b6f631'],6,20,26,5989235,2,1,1,1,4127
45f9d0b12f01fcc628c4016a72e232d786d868c5,0,dandsager,2019-08-02 08:00:42-05:00,['2576e38dfd89149ba47f1af4e74f2ee5f512d66f'],0,218,218,5989453,2,0.298245614,1,0.850877193,4127
f8394c58db457649002880554de771cc345df909,0,GitHub,2019-08-02 16:55:07-05:00,"['89893556a936fa3482b2387cbfe1797ab7614566', '45f9d0b12f01fcc628c4016a72e232d786d868c5']",0,218,218,5989671,2,,,,4127
ab1c8b0838e7006d2443f67dbde907244faf8e96,0,Ethan Li,2019-08-06 15:16:20-05:00,['f8394c58db457649002880554de771cc345df909'],35,20,55,5989726,3,1,1,0,4127
e3ffa9925d46990f4070502077f253bc1e56c39c,0,GitHub,2019-08-07 11:30:49-05:00,"['f8394c58db457649002880554de771cc345df909', 'ab1c8b0838e7006d2443f67dbde907244faf8e96']",35,20,55,5989781,3,,,,4127
6bc2a858ead4d5bf9cdf3edaa881ad7d682d139a,1,GitHub,2019-08-14 16:21:11+02:00,['e3ffa9925d46990f4070502077f253bc1e56c39c'],382,417,799,5990580,9,1,0.844444444,1,4128
36356ff16e851ab43aac7c927e5a9dfe84b71309,0,Stig Rohde D酶ssing,2019-08-15 17:58:30+02:00,['6bc2a858ead4d5bf9cdf3edaa881ad7d682d139a'],1,28,29,5990609,3,0,0,1,4128
0d3135894572e92c13c5424f0aa13f299ef43e19,0,GitHub,2019-08-16 10:43:31-05:00,"['6bc2a858ead4d5bf9cdf3edaa881ad7d682d139a', '36356ff16e851ab43aac7c927e5a9dfe84b71309']",1,28,29,5990638,3,,,,4128
247f9905ba59e7fb92536a146ce04846bc952f25,0,Stig Rohde D酶ssing,2019-08-19 19:35:08+02:00,['0d3135894572e92c13c5424f0aa13f299ef43e19'],7,13,20,5990658,2,,,,4128
26c5bfdf36b737a7ba5a4ac1cf700101b6293de3,0,Ethan Li,2019-08-19 12:41:00-05:00,['0d3135894572e92c13c5424f0aa13f299ef43e19'],2,1,3,5990661,1,1,1,0,4128
e13207443c5e1b441dab6c760ce5de4c7b38a1ba,0,GitHub,2019-08-19 14:56:54-05:00,"['0d3135894572e92c13c5424f0aa13f299ef43e19', '247f9905ba59e7fb92536a146ce04846bc952f25']",7,13,20,5990681,2,,,,4128
b92c732df571b0949a9c913ec51d1b55ec9682c0,0,Ethan Li,2019-08-19 14:58:24-05:00,['e13207443c5e1b441dab6c760ce5de4c7b38a1ba'],1,0,1,5990682,1,,,,4128
4a1159dab9076c39fea45113d2b842a8c48721aa,0,GitHub,2019-08-20 10:48:10-05:00,"['e13207443c5e1b441dab6c760ce5de4c7b38a1ba', '26c5bfdf36b737a7ba5a4ac1cf700101b6293de3']",2,1,3,5990685,1,,,,4128
1478fc429c41a3489c2daed636029dbcc6b0f2d8,0,GitHub,2019-08-20 13:13:22-05:00,"['4a1159dab9076c39fea45113d2b842a8c48721aa', 'b92c732df571b0949a9c913ec51d1b55ec9682c0']",1,0,1,5990686,1,,,,4128
3f7e2d7e1eb6af734ccdf8c14746a536e12185bb,0,ruili8080,2019-08-20 15:29:43-05:00,['6bc2a858ead4d5bf9cdf3edaa881ad7d682d139a'],19,165,184,5990870,8,0.218181818,0.254545455,0.990909091,4128
651c2ec7cea2d66ebb1060a38e51f89cf0c26d71,0,GitHub,2019-08-21 10:38:44-05:00,['1478fc429c41a3489c2daed636029dbcc6b0f2d8'],78,78,156,5991026,77,,,,4128
fa09024aee6390b2602ba691fc74195dcda3ddbf,1,dandsager,2019-08-21 11:10:32-05:00,['e3ffa9925d46990f4070502077f253bc1e56c39c'],91,305,396,5991422,13,0.055555556,0.261904762,0.96031746,4129
6ed753e722b1b01b0c71e80d9c8802e7206dbf9b,0,GitHub,2019-08-21 12:43:49-05:00,"['651c2ec7cea2d66ebb1060a38e51f89cf0c26d71', 'fa09024aee6390b2602ba691fc74195dcda3ddbf']",91,305,396,5991818,13,,,,4129
8d2316ffda6b1d0d76c3bbfda09bf0a91a556c26,0,dandsager,2019-08-21 13:43:50-05:00,['e3ffa9925d46990f4070502077f253bc1e56c39c'],1,52,53,5991871,2,0,1,1,4129
884ed9c09d5fd92f8053f1d83a5b1a4227c7018e,0,Meng Li (Ethan),2019-08-22 08:57:52-05:00,['6ed753e722b1b01b0c71e80d9c8802e7206dbf9b'],1,3,4,5991875,1,,,,4129
51ac40303daf87811170cce3f76ae0e8610fa598,0,GitHub,2019-08-22 09:06:36-05:00,"['884ed9c09d5fd92f8053f1d83a5b1a4227c7018e', '3f7e2d7e1eb6af734ccdf8c14746a536e12185bb']",19,165,184,5992059,8,,,,4129
e005c1c04a1e98ae1035439b3c27c3fee6573531,0,GitHub,2019-08-22 09:18:26-05:00,"['51ac40303daf87811170cce3f76ae0e8610fa598', '8d2316ffda6b1d0d76c3bbfda09bf0a91a556c26']",1,47,48,5992107,1,,,,4129
46d11daebba8bb52edfd8628037a0f4ec7bb86ca,0,ruili8080,2019-08-22 10:21:33-05:00,['e005c1c04a1e98ae1035439b3c27c3fee6573531'],6,21,27,5992134,3,0,0,1,4129
307c95c15dbf05ef35f5b05cacb80b3a190acf5d,0,Meng Li (Ethan),2019-08-22 11:25:18-05:00,['e005c1c04a1e98ae1035439b3c27c3fee6573531'],2,28,30,5992164,1,0,0,1,4129
7ea9235b1ceb331d0c10bba813cf3f56bf7bf38a,0,GitHub,2019-08-22 11:28:52-05:00,"['307c95c15dbf05ef35f5b05cacb80b3a190acf5d', '46d11daebba8bb52edfd8628037a0f4ec7bb86ca']",6,21,27,5992191,3,,,,4129
b9fcb19f0f5d920d3f278e7f00593f8ad0661d8d,1,Meng Li (Ethan),2019-08-22 14:19:23-05:00,['7ea9235b1ceb331d0c10bba813cf3f56bf7bf38a'],1678,1756,3434,5995625,99,0.405405405,0.635135135,0.459459459,4129
f310952d822ed698515926c0a76c05b0a7879b44,0,Karl-Philipp Richter,2019-08-22 21:25:02+02:00,['b9fcb19f0f5d920d3f278e7f00593f8ad0661d8d'],153,2,155,5995780,52,,,,4129
e3ab87b4498cbd46430027373ad270ca22eda657,0,GitHub,2019-08-22 15:29:14-05:00,"['b9fcb19f0f5d920d3f278e7f00593f8ad0661d8d', 'f310952d822ed698515926c0a76c05b0a7879b44']",153,2,155,5995935,52,,,,4129
51ed4f89895213fb2521c0644b763c5db88fe9a5,0,dandsager,2019-08-23 10:44:01-05:00,['e3ab87b4498cbd46430027373ad270ca22eda657'],2,2,4,5995939,1,,,,4129
eb27556f7669c7c966716e1aca4867da04ce6e08,0,Stig D酶ssing,2019-08-24 17:58:58+02:00,['e3ab87b4498cbd46430027373ad270ca22eda657'],4,2,6,5995945,2,,,,4129
dee4347a35cfb5e8807fcd79244fcaa85d80e7ec,0,GitHub,2019-08-25 17:09:12-05:00,"['eb27556f7669c7c966716e1aca4867da04ce6e08', '51ed4f89895213fb2521c0644b763c5db88fe9a5']",2,2,4,5995949,1,,,,4129
405c90ba16bb886ae9727b65682ad902c8f2fb0b,0,Stig Rohde D酶ssing,2019-08-27 22:28:50+02:00,['dee4347a35cfb5e8807fcd79244fcaa85d80e7ec'],7,7,14,5995963,3,,,,4129
3b993a98ea42bec22d8ad7eb9699f30c6afba9b7,0,Stig Rohde D酶ssing,2019-08-27 22:29:35+02:00,['dee4347a35cfb5e8807fcd79244fcaa85d80e7ec'],4,0,4,5995967,1,1,1,0,4129
7bc48361531027d078842e3cec00eae6945d22fa,0,Meng Li (Ethan),2019-08-28 08:50:42-05:00,['dee4347a35cfb5e8807fcd79244fcaa85d80e7ec'],379,379,758,5996725,175,,,,4129
3b93ae96e2b574b8abd0e6e0ffc2ae03d20379cc,0,dandsager,2019-08-28 09:23:50-05:00,['7bc48361531027d078842e3cec00eae6945d22fa'],45,111,156,5996881,2,0.023255814,0.697674419,1,4129
b27da9f3f90d78fefc676555c792ccba87e5361e,0,GitHub,2019-08-30 18:48:16+02:00,"['7bc48361531027d078842e3cec00eae6945d22fa', '3b993a98ea42bec22d8ad7eb9699f30c6afba9b7']",4,0,4,5996885,1,,,,4129
2c095ee5d2bb14700f1d23d8c4d4c5621c30d838,0,GitHub,2019-08-30 18:50:55+02:00,"['b27da9f3f90d78fefc676555c792ccba87e5361e', '405c90ba16bb886ae9727b65682ad902c8f2fb0b']",7,7,14,5996899,3,,,,4129
7bc3a81a62fb147882da59fa147ea31a7f383837,0,GitHub,2019-08-30 13:12:37-05:00,"['2c095ee5d2bb14700f1d23d8c4d4c5621c30d838', '3b93ae96e2b574b8abd0e6e0ffc2ae03d20379cc']",45,111,156,5997055,2,,,,4129
9c47a02e52173b55c0184f3d9ecfa4b7d2a79984,1,Stig D酶ssing,2019-08-31 19:19:14+02:00,['7bc3a81a62fb147882da59fa147ea31a7f383837'],3,141,144,5997199,5,0.107142857,0.988095238,1,4129
f33b7d80b3a30b5f08cbcd36aa92b5e86b90263f,0,GitHub,2019-09-01 13:04:24+02:00,['9c47a02e52173b55c0184f3d9ecfa4b7d2a79984'],231,158,389,5997588,6,,,,4129
d212b59cd05d2c67a9b09d0c6a98d241f77824fb,0,Tim Frison,2019-09-04 10:30:49-06:00,['e3ffa9925d46990f4070502077f253bc1e56c39c'],9,36,45,5997633,2,0.105263158,1,1,4129
23cd491da1ddc3cb684eb0a196101af5af64f6a9,0,GitHub,2019-09-04 19:21:46+02:00,"['f33b7d80b3a30b5f08cbcd36aa92b5e86b90263f', 'd212b59cd05d2c67a9b09d0c6a98d241f77824fb']",9,36,45,5997678,2,,,,4129
c427119f24bc0b14f81706ab4ad03404aa85aede,0,Meng Li (Ethan),2019-09-05 16:14:31-05:00,['23cd491da1ddc3cb684eb0a196101af5af64f6a9'],43,113,156,5997834,8,0.043478261,0,0.47826087,4129
93b7d7c02b115a598545c6797cd5a9b0f5f791ad,0,Meng Li (Ethan),2019-09-05 16:53:53-05:00,['c427119f24bc0b14f81706ab4ad03404aa85aede'],3,12,15,5997849,1,0,1,1,4129
74958a6e333b9f4bbf8ccb26aeab8fc47b2d2959,0,Stig D酶ssing,2019-09-12 17:22:51+02:00,['93b7d7c02b115a598545c6797cd5a9b0f5f791ad'],514,496,1010,5998859,1,1,0,0,4129
961124392ec9e96c459b3b73514578fc8b6b55c6,0,boshu Zheng,2019-09-16 08:52:11+08:00,['93b7d7c02b115a598545c6797cd5a9b0f5f791ad'],1,1,2,5998861,1,,,,4129
73fdf0988b48d6e78c8b6eaffd89035fa618262e,0,GitHub,2019-09-16 21:00:24-05:00,"['74958a6e333b9f4bbf8ccb26aeab8fc47b2d2959', '961124392ec9e96c459b3b73514578fc8b6b55c6']",1,1,2,5998863,1,,,,4129
e28401fe1838a7e4d2edcd2b636b0ee6710b9435,0,david,2019-09-20 10:34:10-05:00,['f33b7d80b3a30b5f08cbcd36aa92b5e86b90263f'],26,152,178,5999041,8,0.75,0.881578947,0.842105263,4129
38b09fd229d2034a0fb6d5359eaa0b8ecdc0b61a,0,GitHub,2019-09-21 09:01:48+02:00,['73fdf0988b48d6e78c8b6eaffd89035fa618262e'],1,1,2,5999043,1,,,,4129
822a4685c0278aba9d4e0f43104bc4f86a462222,0,GitHub,2019-09-24 23:32:24-05:00,"['38b09fd229d2034a0fb6d5359eaa0b8ecdc0b61a', 'e28401fe1838a7e4d2edcd2b636b0ee6710b9435']",26,152,178,5999221,8,,,,4129
a2a202805eadf1bf5c6761e4304f0afc961da163,0,Meng Li (Ethan),2019-09-26 16:10:23-05:00,['822a4685c0278aba9d4e0f43104bc4f86a462222'],0,22,22,5999243,1,0,1,0,4129
c78f1aaa8fcd17eb5c8f45f5dbb90e30f99e19bb,0,Stig D酶ssing,2019-10-01 16:38:28+02:00,['a2a202805eadf1bf5c6761e4304f0afc961da163'],18,60,78,5999321,3,0.384615385,1,1,4129
073987bc681c2169adb182465081dd3494599bbc,0,Meng Li (Ethan),2019-10-03 19:46:08-05:00,['c78f1aaa8fcd17eb5c8f45f5dbb90e30f99e19bb'],54,300,354,5999675,5,0.660130719,0.777777778,1,4129
a0b2e6260bb6bdbeeb1dbaaced418c972f627187,0,Meng Li (Ethan),2019-10-03 19:51:49-05:00,['073987bc681c2169adb182465081dd3494599bbc'],13,26,39,5999714,2,0,0,1,4129
bdd0a3b99e39302afdbb3354634e7be269e22a78,1,Govind Menon,2019-10-07 10:52:25-05:00,['a0b2e6260bb6bdbeeb1dbaaced418c972f627187'],35,31,66,5999780,2,1,0,0,4129
661dff5c789918ee58c887e089ad0b8eef2c5e84,1,Govind Menon,2019-10-09 15:50:29-05:00,['bdd0a3b99e39302afdbb3354634e7be269e22a78'],90,135,225,6000005,2,0.681818182,0.931818182,0.886363636,4129
0bc86218bc641c68ef17eac796bc9b6e5eb37037,0,GitHub,2019-10-10 08:51:55-05:00,"['a0b2e6260bb6bdbeeb1dbaaced418c972f627187', '661dff5c789918ee58c887e089ad0b8eef2c5e84']",109,150,259,6000264,2,,,,4129
51baa7dfa32b0dd2a537985c357b323fd0a1b76e,1,Govind Menon,2019-10-10 09:48:56-05:00,['0bc86218bc641c68ef17eac796bc9b6e5eb37037'],1,15,16,6000280,2,0,1,1,4129
09213e0d00e1ce0193d8d310a4540346c6260ab0,1,Govind Menon,2019-10-10 14:01:16-05:00,['0bc86218bc641c68ef17eac796bc9b6e5eb37037'],2,28,30,6000310,2,0,1,1,4129
bed06ca685f6ebde431ad30495650ebfdc589a71,0,Daisy Chen,2019-10-10 16:07:45-05:00,['a0b2e6260bb6bdbeeb1dbaaced418c972f627187'],2,1,3,6000313,1,,,,4129
c5a8ac41f10ad0a475f64df52b1ef4e74a256c30,0,GitHub,2019-10-11 10:10:20-05:00,"['0bc86218bc641c68ef17eac796bc9b6e5eb37037', '51baa7dfa32b0dd2a537985c357b323fd0a1b76e']",1,15,16,6000329,2,,,,4129
8bbd15b19dc4d2f1d2c9878abc05b7b0dcd2c808,0,GitHub,2019-10-11 13:49:45-05:00,"['c5a8ac41f10ad0a475f64df52b1ef4e74a256c30', '09213e0d00e1ce0193d8d310a4540346c6260ab0']",2,28,30,6000359,2,,,,4129
5eacd97ca4fe2934f752d32f7803e6608b7b2c44,0,GitHub,2019-10-14 09:10:09-05:00,"['8bbd15b19dc4d2f1d2c9878abc05b7b0dcd2c808', 'bed06ca685f6ebde431ad30495650ebfdc589a71']",2,1,3,6000362,1,,,,4129
6ff56893479266f3a5656bdf26c07d40a4e1ae98,1,Aaron Gresch,2019-10-14 09:57:48-05:00,['5eacd97ca4fe2934f752d32f7803e6608b7b2c44'],1,10,11,6000373,1,0,0,1,4129
7d45bc381c9e2b31cedd7aa113aa2829b88e8a97,0,daisyxchen,2019-10-14 14:10:12-05:00,['5eacd97ca4fe2934f752d32f7803e6608b7b2c44'],15,0,15,6000388,2,0,0,0.5,4129
dd502708c71ac62f10a50616fa2d217d464efcca,0,Meng Li (Ethan),2019-10-15 17:57:03-05:00,['5eacd97ca4fe2934f752d32f7803e6608b7b2c44'],41,77,118,6000506,2,0.090909091,0,1,4129
a5a03f3c9d2fa3bb79eb1a52216da66a2061ef38,0,Kishor Patil,2019-10-17 14:47:46-04:00,['dd502708c71ac62f10a50616fa2d217d464efcca'],3,9,12,6000518,1,0.4,0.4,1,4129
885ca981fc52bda6552be854c7e4af9c7a451cd2,0,Meng Li (Ethan),2019-10-18 10:35:24-05:00,['a5a03f3c9d2fa3bb79eb1a52216da66a2061ef38'],0,2,2,6000520,1,0,1,1,4129
9a1f5a3ddda6139dfedbd5ee3d141965717ae81e,0,GitHub,2019-10-18 13:59:19-05:00,"['885ca981fc52bda6552be854c7e4af9c7a451cd2', '6ff56893479266f3a5656bdf26c07d40a4e1ae98']",1,10,11,6000531,1,,,,4129
3c14c1f3bfd873e28665e3562df66d98931d4128,0,Govind Menon,2019-10-21 10:31:14-05:00,['dd502708c71ac62f10a50616fa2d217d464efcca'],71,94,165,6000696,2,0.090909091,1,1,4129
b2393ee21c56b1de5ffbc0cda91406414b6de02c,0,GitHub,2019-10-21 13:08:34-05:00,"['9a1f5a3ddda6139dfedbd5ee3d141965717ae81e', '3c14c1f3bfd873e28665e3562df66d98931d4128']",71,94,165,6000861,2,,,,4129
1bfb2e03e51a950ffedda1f2d1a6620ab4437d0b,0,Ethan Li,2019-10-22 15:50:10-05:00,['b2393ee21c56b1de5ffbc0cda91406414b6de02c'],6,24,30,6000891,1,0,0,1,4129
4fffbd9f54b96a17d6d9338b136b1501d2f75dff,0,GitHub,2019-10-24 16:48:23+02:00,"['b2393ee21c56b1de5ffbc0cda91406414b6de02c', '7d45bc381c9e2b31cedd7aa113aa2829b88e8a97']",15,0,15,6000906,2,,,,4129
7b1a98fc10fad516ef9ed0b3afc53a1d7be8a169,0,GitHub,2019-10-25 08:38:51-05:00,"['4fffbd9f54b96a17d6d9338b136b1501d2f75dff', '1bfb2e03e51a950ffedda1f2d1a6620ab4437d0b']",6,24,30,6000936,1,,,,4129
24805b44d5fd9579152a6ee876d8e663be55c20f,0,Ethan Li,2019-10-25 14:55:06-05:00,['7b1a98fc10fad516ef9ed0b3afc53a1d7be8a169'],4,33,37,6000973,1,,,,4129
55f346cb093d4f219ecb43b1e6b1a7c2ea5d9a5f,0,Eduardo Pinto,2019-10-27 22:32:30+00:00,['7b1a98fc10fad516ef9ed0b3afc53a1d7be8a169'],1,11,12,6000985,2,1,1,1,4129
637f69ae2800a0a0cfdd6e65f53699330cfa4165,0,GitHub,2019-10-29 12:52:39-05:00,"['7b1a98fc10fad516ef9ed0b3afc53a1d7be8a169', '24805b44d5fd9579152a6ee876d8e663be55c20f']",4,33,37,6001022,1,,,,4129
418b2d0a6539cc5dfa34432ddc2c63992fb0bbc1,0,david,2019-10-30 08:24:38-05:00,['7b1a98fc10fad516ef9ed0b3afc53a1d7be8a169'],20,44,64,6001086,3,0.4,1,0.8,4129
8843f4debf4f1acf630758dc665ac763fb549670,0,david,2019-10-30 12:20:49-05:00,['418b2d0a6539cc5dfa34432ddc2c63992fb0bbc1'],23,4,27,6001113,3,0.4,0.1,0.3,4129
4c69b96307bf5f0464cab6c5333171dadf939c97,0,GitHub,2019-10-31 11:03:22-05:00,['637f69ae2800a0a0cfdd6e65f53699330cfa4165'],18,23,41,6001154,2,,,,4129
ebd52b37c7448d381d31451e46e8f19c6e51352d,0,Meng Li (Ethan),2019-10-31 13:04:32-05:00,['4c69b96307bf5f0464cab6c5333171dadf939c97'],20,14,34,6001188,1,1,1,0,4129
b6ed6ade4f75863b2607d4478898449c469bb662,0,Eduardo Pinto,2019-11-02 02:40:41+00:00,['7b1a98fc10fad516ef9ed0b3afc53a1d7be8a169'],42,68,110,6001298,3,1,1,0.9,4129
dfb9b55e10b60e8755c8552eee4563ec3c86aa77,0,GitHub,2019-11-02 10:23:28+01:00,"['ebd52b37c7448d381d31451e46e8f19c6e51352d', 'b6ed6ade4f75863b2607d4478898449c469bb662']",42,68,110,6001408,3,,,,4129
9165a783590a65e935e5ee229abbad2942b12333,0,GitHub,2019-11-02 10:25:32+01:00,"['dfb9b55e10b60e8755c8552eee4563ec3c86aa77', '55f346cb093d4f219ecb43b1e6b1a7c2ea5d9a5f']",1,11,12,6001420,2,,,,4129
34ff63719d6ff67e98f38a23a2e8fa7ec33024a7,0,GitHub,2019-11-05 08:22:44-06:00,"['9165a783590a65e935e5ee229abbad2942b12333', '8843f4debf4f1acf630758dc665ac763fb549670']",17,22,39,6001459,2,,,,4129
b5822b04f1dda3e1bfa97cc08d6dd9dd98481d90,0,david,2019-11-07 17:19:41-06:00,['4c69b96307bf5f0464cab6c5333171dadf939c97'],2483,3388,5871,6007330,42,0.165822785,0.146835443,0.993670886,4129
12075272b6dc9ac96ff25922f31da673f527e9e2,0,david,2019-11-08 08:52:04-06:00,['b5822b04f1dda3e1bfa97cc08d6dd9dd98481d90'],15,264,279,6007609,12,0.632478632,0.786324786,0.777777778,4129
b17e5483cdecf19b3c6b6f5aa8bc7bedb1a23340,0,Oliver Downard,2019-11-10 14:33:04+00:00,['34ff63719d6ff67e98f38a23a2e8fa7ec33024a7'],7,28,35,6007644,2,0.5,0.5,1,4129
7a3b97affcdee05e367395b9ff19616ffb820b7c,0,david,2019-11-11 10:28:50-06:00,['12075272b6dc9ac96ff25922f31da673f527e9e2'],8,7,15,6007659,6,,,,4129
dd8ce7b66b60bfc7b2b2dab0d9c7384b2ca28a69,0,GitHub,2019-11-13 16:58:47+01:00,"['34ff63719d6ff67e98f38a23a2e8fa7ec33024a7', 'b17e5483cdecf19b3c6b6f5aa8bc7bedb1a23340']",7,28,35,6007694,2,,,,4129
8eec7fd3d721b78c1e8a522c78433a8898dfd4c2,0,david,2019-11-15 09:00:40-06:00,['34ff63719d6ff67e98f38a23a2e8fa7ec33024a7'],13,36,49,6007743,4,0,0.9375,0.625,4129
bd42fe98a6e56ac17467f3903d41f93539d234f5,0,david,2019-11-15 11:25:35-06:00,['34ff63719d6ff67e98f38a23a2e8fa7ec33024a7'],0,4,4,6007747,3,0.5,0.5,1,4129
49c0948b3696f5b9a7b04f33656fc0e1032e2c61,0,Aaron Gresch,2019-11-15 14:15:06-06:00,['dd8ce7b66b60bfc7b2b2dab0d9c7384b2ca28a69'],2,3,5,6007752,2,1,,,4129
5786bb0026b7554e55a3687f8fe08307bea7b667,0,GitHub,2019-11-19 09:01:12-06:00,"['dd8ce7b66b60bfc7b2b2dab0d9c7384b2ca28a69', '8eec7fd3d721b78c1e8a522c78433a8898dfd4c2']",13,36,49,6007801,4,,,,4129
cc3435c817632fa422d4ea57aa6523505b6cf6a2,1,Aaron Gresch,2019-11-19 13:18:22-06:00,['dd8ce7b66b60bfc7b2b2dab0d9c7384b2ca28a69'],10,99,109,6007910,2,0.309859155,0.338028169,0.774647887,4129
02a0965e41a0394da7811868e9096ecad340aea0,0,Aaron Gresch,2019-11-19 13:18:50-06:00,['cc3435c817632fa422d4ea57aa6523505b6cf6a2'],0,14,14,6007924,3,0,0,1,4129
27cf22f1ddc0ef4768a2389e66fadec37bbe6569,0,Christopher Johnson,2019-11-20 18:24:33+00:00,['5786bb0026b7554e55a3687f8fe08307bea7b667'],13,28,41,6007965,6,1,1,1,4129
0c6648a63d79aa7ee8cc49bf71c164a4ecaad4ad,0,GitHub,2019-11-20 12:57:30-06:00,"['5786bb0026b7554e55a3687f8fe08307bea7b667', 'bd42fe98a6e56ac17467f3903d41f93539d234f5']",0,4,4,6007969,3,,,,4129
0f924bd07b4ccea9e81a071f9a5438c53901d16e,0,Aaron Gresch,2019-11-21 08:05:40-06:00,['0c6648a63d79aa7ee8cc49bf71c164a4ecaad4ad'],0,9,9,6007978,1,,,,4129
406f222833113a798e0a022b1be8e6174dcefc7e,0,Stig D酶ssing,2019-11-21 17:15:26+01:00,['0c6648a63d79aa7ee8cc49bf71c164a4ecaad4ad'],0,40,40,6008018,3,,,,4131
1d946d3640a175dd7b606ee753203d041484e68e,0,Stig D酶ssing,2019-11-21 17:21:00+01:00,['406f222833113a798e0a022b1be8e6174dcefc7e'],0,2,2,6008020,2,,,,4131
91f88db6dc5240aa94d796077fa3c03cc1d7d282,0,GitHub,2019-11-21 10:21:13-06:00,"['1d946d3640a175dd7b606ee753203d041484e68e', '0f924bd07b4ccea9e81a071f9a5438c53901d16e']",0,9,9,6008029,1,,,,4131
1bbc0458a55694d653c2f7799cfb7818ad95c69b,0,GitHub,2019-11-27 09:47:06-06:00,"['91f88db6dc5240aa94d796077fa3c03cc1d7d282', '7a3b97affcdee05e367395b9ff19616ffb820b7c']",2499,3652,6151,6014180,54,,,,4131
0f9f3fb511b1792a011e6fea94f80dca5dbf7e67,0,GitHub,2019-12-02 10:41:54-06:00,"['1bbc0458a55694d653c2f7799cfb7818ad95c69b', '49c0948b3696f5b9a7b04f33656fc0e1032e2c61']",2,3,5,6014185,2,,,,4131
6338cc9394523ea490128484deda72b51a09ddcb,0,Aaron Gresch,2019-12-02 11:39:10-06:00,['0f9f3fb511b1792a011e6fea94f80dca5dbf7e67'],138,96,234,6014419,17,1,1,0,4131
f6ebace63e4faa6d7320dedb7cee13f190a9a1da,0,Aaron Gresch,2019-12-02 11:40:17-06:00,['6338cc9394523ea490128484deda72b51a09ddcb'],3,2,5,6014424,2,1,1,0,4131
68a74d04e809c4fff106d2e733c9a8c45322f8cb,1,Kishor Patil,2019-12-06 16:53:36-05:00,['0f9f3fb511b1792a011e6fea94f80dca5dbf7e67'],8,144,152,6014576,2,0,0.463917526,0.927835052,4131
b77dffbf8abaf939939994e766257651adf47ffc,0,MARJORAM Luke,2019-12-10 12:01:15+00:00,['0f9f3fb511b1792a011e6fea94f80dca5dbf7e67'],3,31,34,6014610,3,1,1,1,4131
f26ad0c8c65fd66933378f7b0719f51a2d056aff,0,MARJORAM Luke,2019-12-10 12:23:10+00:00,['0f9f3fb511b1792a011e6fea94f80dca5dbf7e67'],234,258,492,6015102,123,0,1,0.6,4131
357df98180fe368efa9e5195c4fa38670ae64a9f,0,GitHub,2019-12-17 13:55:07-06:00,"['0f9f3fb511b1792a011e6fea94f80dca5dbf7e67', '68a74d04e809c4fff106d2e733c9a8c45322f8cb']",8,144,152,6015254,2,,,,4131
3bedb340fd3546ab267d940594c2dfbdc253b345,0,Aaron Gresch,2019-12-18 14:04:55-06:00,['357df98180fe368efa9e5195c4fa38670ae64a9f'],6,34,40,6015294,7,0,0.071428571,1,4131
f5877a36beaf83f0cd408f9a1567a381bf791f15,0,Stig Rohde D酶ssing,2019-12-27 11:32:49+01:00,['357df98180fe368efa9e5195c4fa38670ae64a9f'],2,2,4,6015298,2,,,,4131
6e6ff5811ff5d004d647d75ac2c9bee70b51ab7a,0,GitHub,2019-12-30 09:03:58-06:00,"['357df98180fe368efa9e5195c4fa38670ae64a9f', 'f5877a36beaf83f0cd408f9a1567a381bf791f15']",2,2,4,6015302,2,,,,4131
993a59782b54716ac731790758521c74d8e60226,0,GitHub,2019-12-30 09:20:17-06:00,"['6e6ff5811ff5d004d647d75ac2c9bee70b51ab7a', 'f6ebace63e4faa6d7320dedb7cee13f190a9a1da']",141,98,239,6015541,19,,,,4131
141b5cccd3463266e80d6d64033b0117116cc895,0,Kishor Patil,2020-01-02 15:42:42-05:00,['993a59782b54716ac731790758521c74d8e60226'],15,22,37,6015578,2,0,0.428571429,1,4131
99b516040ddd6ce776ae6d88e8e02462c3aa9707,0,GitHub,2020-01-03 00:19:13-06:00,"['141b5cccd3463266e80d6d64033b0117116cc895', 'b77dffbf8abaf939939994e766257651adf47ffc']",3,31,34,6015612,3,,,,4131
1a3025fac804f44f53878ec2656f019a084fc6ad,0,Ethan Li,2020-01-03 01:02:49-06:00,['99b516040ddd6ce776ae6d88e8e02462c3aa9707'],3,4,7,6015619,1,,,,4131
7e671f03732e22d06ab1463b99daab0c3ff8acb5,0,GitHub,2020-01-03 09:35:27-06:00,"['99b516040ddd6ce776ae6d88e8e02462c3aa9707', '1a3025fac804f44f53878ec2656f019a084fc6ad']",3,4,7,6015626,1,,,,4131
50458f77f8335fb0d7bba09b914bfd809a8cacee,0,GitHub,2020-01-03 09:57:46-06:00,"['7e671f03732e22d06ab1463b99daab0c3ff8acb5', 'f26ad0c8c65fd66933378f7b0719f51a2d056aff']",234,258,492,6016118,123,,,,4131
f1313c1c606cb765c9b683f552013a93332ca206,0,GitHub,2020-01-03 11:34:38-06:00,"['50458f77f8335fb0d7bba09b914bfd809a8cacee', '27cf22f1ddc0ef4768a2389e66fadec37bbe6569']",13,28,41,6016159,6,,,,4131
8277bb6ecd27499b9cff39116c2c964594bc173c,0,Rui Li,2020-01-06 10:20:04-06:00,['93b7d7c02b115a598545c6797cd5a9b0f5f791ad'],4,85,89,6016248,5,0.183333333,0.916666667,0.85,4131
49321368a3ce14a922ba057712c40aac6fdf4a4c,1,Aaron Gresch,2020-01-06 10:50:36-06:00,['02a0965e41a0394da7811868e9096ecad340aea0'],15,4,19,6016267,3,0.571428571,0.285714286,0,4131
07af9709ad2ec6854c478b5561137852baf8ae11,0,Meng Li (Ethan),2020-01-06 16:44:36-06:00,['f1313c1c606cb765c9b683f552013a93332ca206'],2,2,4,6016271,1,,,,4131
1aec14dffd3b1bc85802c89966ac8f3fed853b0a,0,GitHub,2020-01-06 16:48:48-06:00,"['07af9709ad2ec6854c478b5561137852baf8ae11', '8277bb6ecd27499b9cff39116c2c964594bc173c']",3,85,88,6016359,5,,,,4131
ce6de3aa170771cff390000a094d9d4b0f936040,0,GitHub,2020-01-07 11:09:07-06:00,"['1aec14dffd3b1bc85802c89966ac8f3fed853b0a', '49321368a3ce14a922ba057712c40aac6fdf4a4c']",10,102,112,6016471,3,,,,4131
cd5f7f80fc146d8935d03421559d49a0aa8fb69a,0,Aaron Gresch,2020-01-07 13:57:09-06:00,['ce6de3aa170771cff390000a094d9d4b0f936040'],0,7,7,6016478,1,0,0.25,1,4131
709001d07c08a019f321a465595f260c13560546,0,Aaron Gresch,2020-01-07 15:01:13-06:00,['3bedb340fd3546ab267d940594c2dfbdc253b345'],6,5,11,6016489,3,,,,4131
17a5cbd5bdff1cebc9dc98d6fecadfccd2bc9beb,0,GitHub,2020-01-08 14:19:05-06:00,"['ce6de3aa170771cff390000a094d9d4b0f936040', 'cd5f7f80fc146d8935d03421559d49a0aa8fb69a']",0,7,7,6016496,1,,,,4131
ae0de8552aa69298bd4c9be067868c8b63abf234,0,GitHub,2020-01-08 14:23:45-06:00,"['709001d07c08a019f321a465595f260c13560546', '17a5cbd5bdff1cebc9dc98d6fecadfccd2bc9beb']",426,639,1065,6017561,164,,,,4131
6dc8075de5d878365cac972e5bf12527255c9646,0,GitHub,2020-01-09 11:26:11-06:00,"['17a5cbd5bdff1cebc9dc98d6fecadfccd2bc9beb', 'ae0de8552aa69298bd4c9be067868c8b63abf234']",6,33,39,6017600,6,,,,4131
6ba5879faa72c4ae3918daf3206f2d1f466d9c78,0,Christoph Deil,2020-01-09 23:42:37+01:00,['0f9f3fb511b1792a011e6fea94f80dca5dbf7e67'],1,1,2,6017602,1,,,,4131
d81b06e854554ebeefe42ce6fb44e77c07c729c2,0,GitHub,2020-01-09 19:59:36-06:00,"['6dc8075de5d878365cac972e5bf12527255c9646', '6ba5879faa72c4ae3918daf3206f2d1f466d9c78']",1,1,2,6017604,1,,,,4131
3eb88ae5773267d23ea732990270ff669c74d41b,0,Stig Rohde D酶ssing,2020-01-14 09:35:20+01:00,['d81b06e854554ebeefe42ce6fb44e77c07c729c2'],3,3,6,6017610,1,,,,4131
bb93200bf6de2becb2e390750fa0c2ffcce5dd5b,0,GitHub,2020-01-14 14:06:44-06:00,"['d81b06e854554ebeefe42ce6fb44e77c07c729c2', '3eb88ae5773267d23ea732990270ff669c74d41b']",3,3,6,6017616,1,,,,4131
bd4ba786ebd5964f4624abfde894e10297fb711a,0,Rui Li,2020-01-17 15:34:10-06:00,['bb93200bf6de2becb2e390750fa0c2ffcce5dd5b'],0,4,4,6017620,1,,,,4131
bc47a748948e0588cfbce2e9d5f20a3b682a27eb,0,Rui Li,2020-01-17 15:59:25-06:00,['ce6de3aa170771cff390000a094d9d4b0f936040'],34,55,89,6017709,3,0,1,0,4131
c43754f8e0b7851e994f1777a5af1478f2124aa0,0,Rui Li,2020-01-21 13:14:36-06:00,['bc47a748948e0588cfbce2e9d5f20a3b682a27eb'],12,12,24,6017733,2,,,,4131
d415da5f6b6506030207f06c77f72833d6e53f0c,0,GitHub,2020-01-23 10:07:51-06:00,"['bb93200bf6de2becb2e390750fa0c2ffcce5dd5b', 'c43754f8e0b7851e994f1777a5af1478f2124aa0']",22,43,65,6017798,1,,,,4131
bec8b19ea345d685c65f5f6f1b3a5634e603b7c4,0,GitHub,2020-01-23 10:21:39-06:00,"['d415da5f6b6506030207f06c77f72833d6e53f0c', 'bd4ba786ebd5964f4624abfde894e10297fb711a']",0,4,4,6017802,1,,,,4131
86e5b2c514b0f03fe566d95c1c0f695242d1027f,0,Stig D酶ssing,2020-01-24 12:38:13+01:00,['bec8b19ea345d685c65f5f6f1b3a5634e603b7c4'],0,40,40,6017842,1,1,1,1,4132
4e0ebd4cbc23927c846ee31530b2d29dd4f338da,0,Aaron Gresch,2020-01-29 14:40:29-06:00,['86e5b2c514b0f03fe566d95c1c0f695242d1027f'],1,1,2,6017844,1,,,,4132
dc086fec06928cfc6da3efcdf2201c618b9683c6,0,GitHub,2020-01-30 08:33:26-06:00,['86e5b2c514b0f03fe566d95c1c0f695242d1027f'],1,10,11,6017855,1,,,,4132
2f9c3d57d33cf9c57a03db343da307abe3e48d28,0,Rui Li,2020-01-30 15:39:50-06:00,['dc086fec06928cfc6da3efcdf2201c618b9683c6'],4,8,12,6017867,1,0,0,1,4132
73737748f3800d948e53b882c4880ae06ff62720,0,GitHub,2020-01-31 08:22:52-06:00,"['dc086fec06928cfc6da3efcdf2201c618b9683c6', '4e0ebd4cbc23927c846ee31530b2d29dd4f338da']",1,1,2,6017869,1,,,,4132
36204eda00bca7e03ac3979d9c0d3527d1f08330,0,GitHub,2020-02-03 09:57:12-06:00,"['73737748f3800d948e53b882c4880ae06ff62720', '2f9c3d57d33cf9c57a03db343da307abe3e48d28']",4,8,12,6017881,1,,,,4132
5b89af3d4430483ef40f9fec7cdf960e3647059e,0,Aaron Gresch,2020-02-03 10:56:19-06:00,['73737748f3800d948e53b882c4880ae06ff62720'],1,10,11,6017892,2,0,1,0.666666667,4132
3fb289b87c7d72bfe01ee1c7028adbc69f012439,0,GitHub,2020-02-03 14:48:35-06:00,"['36204eda00bca7e03ac3979d9c0d3527d1f08330', '5b89af3d4430483ef40f9fec7cdf960e3647059e']",1,10,11,6017903,2,,,,4132
50303a52ca75da8b3a2c9c5999bf32297f17403a,0,Howard Liu,2020-02-07 14:51:39+08:00,['d81b06e854554ebeefe42ce6fb44e77c07c729c2'],1,1,2,6017905,1,,,,4132
4d40ae0bea4c372af2e795a1091c4dc3c02c28b3,0,Rui Li,2020-02-07 09:49:03-06:00,['3fb289b87c7d72bfe01ee1c7028adbc69f012439'],3,7,10,6017915,1,0,0,0,4132
078332a6670c852164fea166d84304627173feba,0,Ethan Li,2020-02-07 13:39:08-06:00,['bb93200bf6de2becb2e390750fa0c2ffcce5dd5b'],3,12,15,6017930,2,0.125,0,1,4132
db93e7ba01d553a9d6856964456674a5118113dd,0,GitHub,2020-02-10 09:04:32-06:00,"['3fb289b87c7d72bfe01ee1c7028adbc69f012439', '50303a52ca75da8b3a2c9c5999bf32297f17403a']",1,1,2,6017932,1,,,,4132
1b2ff398b5b45d63ed85f1aaba5e8e5d00cabcc3,0,GitHub,2020-02-10 21:28:44-06:00,"['db93e7ba01d553a9d6856964456674a5118113dd', '078332a6670c852164fea166d84304627173feba']",3,12,15,6017947,2,,,,4132
65f374c5e9a258d1d485e8c99c334c0ba6122f74,0,Ethan Li,2020-02-10 21:50:54-06:00,['bb93200bf6de2becb2e390750fa0c2ffcce5dd5b'],23,36,59,6018006,2,0,1,0,4132
cdd316964d45cea6e436f26f8e66a0ba0984b182,0,GitHub,2020-02-12 08:52:01-06:00,"['1b2ff398b5b45d63ed85f1aaba5e8e5d00cabcc3', '65f374c5e9a258d1d485e8c99c334c0ba6122f74']",23,36,59,6018065,2,,,,4132
f3e7662cd31443b5231e9f88408ef9c4c5305144,0,GitHub,2020-02-12 16:38:44-06:00,['cdd316964d45cea6e436f26f8e66a0ba0984b182'],0,10,10,6018075,1,0,0,1,4132
d5d248c6714fde35a96a416415f4defd9bdebd77,0,Ethan Li,2020-02-13 11:13:33-06:00,['f3e7662cd31443b5231e9f88408ef9c4c5305144'],1,1,2,6018077,1,,,,4132
7e9c3fc3fbb596a0f7503c51c3d54c1747e31dcd,0,GitHub,2020-02-14 15:28:05-06:00,"['f3e7662cd31443b5231e9f88408ef9c4c5305144', 'd5d248c6714fde35a96a416415f4defd9bdebd77']",1,1,2,6018079,1,,,,4132
3a7e1b9873c08150025707478b2c53834daf89cd,0,GitHub,2020-02-24 09:42:47-06:00,['7e9c3fc3fbb596a0f7503c51c3d54c1747e31dcd'],3,21,24,6018103,1,0,0,1,4132
044e01542fe07326de26365e022dcd8193891c04,0,Rui Li,2020-02-24 10:01:08-06:00,['3fb289b87c7d72bfe01ee1c7028adbc69f012439'],17,14,31,6018134,4,1,0,1,4132
cc058eb805217448df33b6173d6cbf011496415b,0,Rui Li,2020-02-26 10:19:13-06:00,['3a7e1b9873c08150025707478b2c53834daf89cd'],2,4,6,6018140,2,0,0,1,4132
e67eb721e777a6d2427f783e48c1efbbe2337d93,0,GitHub,2020-02-26 13:23:53-06:00,"['3a7e1b9873c08150025707478b2c53834daf89cd', '044e01542fe07326de26365e022dcd8193891c04']",17,14,31,6018171,4,,,,4132
2b6b5cd80e58fad75b436f790e0fef0ff6877bcf,0,Rui Li,2020-02-26 15:21:35-06:00,['7e9c3fc3fbb596a0f7503c51c3d54c1747e31dcd'],3,11,14,6018185,1,0.428571429,0.428571429,1,4132
a595c6765d1499066d81963bb38dea79a319cb6c,0,GitHub,2020-02-27 08:57:25-06:00,"['e67eb721e777a6d2427f783e48c1efbbe2337d93', '2b6b5cd80e58fad75b436f790e0fef0ff6877bcf']",2,10,12,6018197,1,,,,4132
79b181d493837ce317fdded3c776725781a7e34f,0,GitHub,2020-02-27 12:35:44-06:00,"['a595c6765d1499066d81963bb38dea79a319cb6c', 'cc058eb805217448df33b6173d6cbf011496415b']",2,4,6,6018203,2,,,,4132
1c5e0967ed6565b1fdbdbe1248c5634118d03ba7,0,GitHub,2020-02-27 13:18:41-06:00,"['79b181d493837ce317fdded3c776725781a7e34f', '4d40ae0bea4c372af2e795a1091c4dc3c02c28b3']",3,7,10,6018213,1,,,,4132
d74a712560a4a61f01261e6d14f80d3a4b720af6,0,Ethan Li,2020-03-04 09:39:48-06:00,['1c5e0967ed6565b1fdbdbe1248c5634118d03ba7'],69,286,355,6018568,8,0,1,1,4133
81933b8978d9c62bcd71fb41c7c10918b9f9ded4,0,Ethan Li,2020-03-04 22:06:21-06:00,['1c5e0967ed6565b1fdbdbe1248c5634118d03ba7'],198,201,399,6018967,73,1,1,1,4133
6b02a65f75da59292b382729d35bf625bb4c1d6a,0,GitHub,2020-03-05 22:53:13-06:00,"['1c5e0967ed6565b1fdbdbe1248c5634118d03ba7', '81933b8978d9c62bcd71fb41c7c10918b9f9ded4']",198,201,399,6019366,73,,,,4133
99a1b96368c080f1dc06c6d1b996f6bfa5aabc2b,0,Ethan Li,2020-03-11 11:38:14-05:00,['6b02a65f75da59292b382729d35bf625bb4c1d6a'],8,16,24,6019390,1,0,0,1,4133
1137f61aad3e277f102fb8baf6ee24a5d183da32,0,GitHub,2020-03-11 18:10:30-05:00,['6b02a65f75da59292b382729d35bf625bb4c1d6a'],196,829,1025,6020415,7,0.081818182,0.486363636,0.670454545,4133
85d9df4a80cffccc0e59cd3be847ddfb2e89619c,0,Yikun Jiang,2020-03-12 19:02:16+08:00,['1137f61aad3e277f102fb8baf6ee24a5d183da32'],3,3,6,6020421,3,,,,4133
06e323f58c4f72f1f6fc83c3449c3d21cab0e26a,0,GitHub,2020-03-13 09:16:11-05:00,"['1137f61aad3e277f102fb8baf6ee24a5d183da32', '85d9df4a80cffccc0e59cd3be847ddfb2e89619c']",3,3,6,6020427,3,,,,4133
4bc08c7fd88c26c2b2831d4cd585bcfcb18b815f,0,GitHub,2020-03-13 09:24:57-05:00,"['06e323f58c4f72f1f6fc83c3449c3d21cab0e26a', '99a1b96368c080f1dc06c6d1b996f6bfa5aabc2b']",8,16,24,6020451,1,,,,4133
46257706b41dbe085be6b884283edd9d72af2f37,0,GitHub,2020-03-13 10:26:51-05:00,['4bc08c7fd88c26c2b2831d4cd585bcfcb18b815f'],6,11,17,6020468,3,0.6,1,0,4133
636ca4c83eafe077bd4c7e3edbc275b5a9a420e6,0,GitHub,2020-03-13 10:31:34-05:00,"['46257706b41dbe085be6b884283edd9d72af2f37', 'd74a712560a4a61f01261e6d14f80d3a4b720af6']",69,286,355,6020823,8,,,,4133
0994303194bc9f6a8b997ae4e3d776a04b04f1fd,0,nathanday123,2020-03-14 15:41:15+00:00,['636ca4c83eafe077bd4c7e3edbc275b5a9a420e6'],149,75,224,6021047,1,0.737704918,0,0,4133
097940d0f915fdf2893d02558b3c860f32e7369a,0,GitHub,2020-03-16 13:02:04-05:00,"['636ca4c83eafe077bd4c7e3edbc275b5a9a420e6', '0994303194bc9f6a8b997ae4e3d776a04b04f1fd']",149,75,224,6021271,1,,,,4133
b37a67ad75f27428e334900c8001169bda70f274,0,nathanday123,2020-03-16 18:59:05+00:00,['097940d0f915fdf2893d02558b3c860f32e7369a'],4,4,8,6021279,1,,,,4133
fb78f00849474392269137b190390a210826259f,0,GitHub,2020-03-19 08:57:27-05:00,['097940d0f915fdf2893d02558b3c860f32e7369a'],29,111,140,6021419,2,0.519230769,0.961538462,0.826923077,4133
4d5e9b85a459894d6cc3caa983c919039b82ddf8,0,GitHub,2020-03-19 09:04:28-05:00,"['fb78f00849474392269137b190390a210826259f', 'b37a67ad75f27428e334900c8001169bda70f274']",4,4,8,6021427,1,,,,4133
ec217df0efa11de58fffb01a907fc9c42f255958,0,GitHub,2020-03-23 11:29:35-05:00,['4d5e9b85a459894d6cc3caa983c919039b82ddf8'],7,29,36,6021463,2,0,0.090909091,0.909090909,4133
171c0b3b82c826feb959cc1f06b027a7d7649160,1,Ethan Li,2020-03-25 13:34:34-05:00,['ec217df0efa11de58fffb01a907fc9c42f255958'],0,10,10,6021473,1,0,1,1,4133
5b8f448fe97751487ed23aecf6933a41d30df5c0,0,Ethan Li,2020-03-26 10:56:26-05:00,['ec217df0efa11de58fffb01a907fc9c42f255958'],3,3,6,6021479,3,,,,4133
25c9070601fc5d58b71b7acdb9d58d7d3af6ebeb,0,Aaron Gresch,2020-03-26 13:30:41-05:00,['ec217df0efa11de58fffb01a907fc9c42f255958'],76,87,163,6021642,17,0,0.5,0.5,4133
04b753ef512f1d5915926a09ed12d8ed006fbd1f,0,Ethan Li,2020-03-26 17:27:34-05:00,['ec217df0efa11de58fffb01a907fc9c42f255958'],2,6,8,6021650,2,0,0,1,4133
5dac9de2ec04c75ccb821f63734e4efcc9ad2d2a,0,GitHub,2020-03-26 17:40:54-05:00,"['ec217df0efa11de58fffb01a907fc9c42f255958', '171c0b3b82c826feb959cc1f06b027a7d7649160']",0,10,10,6021660,1,,,,4133
41732c6f045fe1d159db5f74c5ada34c904306d1,0,GitHub,2020-03-27 11:17:29-05:00,"['5dac9de2ec04c75ccb821f63734e4efcc9ad2d2a', '5b8f448fe97751487ed23aecf6933a41d30df5c0']",3,3,6,6021666,3,,,,4133
1960807dc89a2bfbf02d3ee07f61dcf50f062166,0,GitHub,2020-03-30 10:04:20-05:00,"['41732c6f045fe1d159db5f74c5ada34c904306d1', '04b753ef512f1d5915926a09ed12d8ed006fbd1f']",2,6,8,6021674,2,,,,4133
f3a09838b6b117841f13f1d6efd106f3ece2cfde,0,Ethan Li,2020-03-30 13:22:45-05:00,['1960807dc89a2bfbf02d3ee07f61dcf50f062166'],3,4,7,6021681,2,0,1,0,4133
b71aa0443ac83a9e497b1363a1afd6a509438830,0,GitHub,2020-04-01 15:20:56-05:00,"['1960807dc89a2bfbf02d3ee07f61dcf50f062166', 'f3a09838b6b117841f13f1d6efd106f3ece2cfde']",3,4,7,6021688,2,,,,4133
4a9fc42f2dd2de828a2ead488cbf7519a350fac0,0,GitHub,2020-04-03 11:28:22-05:00,"['b71aa0443ac83a9e497b1363a1afd6a509438830', '25c9070601fc5d58b71b7acdb9d58d7d3af6ebeb']",76,87,163,6021851,17,,,,4133
b38e159d31fab3805980e1bcd35d83611487930b,0,GitHub,2020-04-07 08:39:06-05:00,['4a9fc42f2dd2de828a2ead488cbf7519a350fac0'],8,30,38,6021889,5,0,0.461538462,0.923076923,4133
257ae2fc52a1b097e62cacdae9a0347d1c7db139,0,Aaron Gresch,2020-04-07 13:30:36-05:00,['b38e159d31fab3805980e1bcd35d83611487930b'],10,30,40,6021929,1,0,0,1,4133
a34e0cb54f4712a8f10fd2c082ee105c38f24ca7,1,Aaron Gresch,2020-04-07 16:04:40-05:00,['b38e159d31fab3805980e1bcd35d83611487930b'],107,67,174,6022103,10,0,0,0,4133
4e126034356968a89e976e7011b9dec9917dd6ed,0,GitHub,2020-04-08 09:28:26-05:00,"['b38e159d31fab3805980e1bcd35d83611487930b', 'a34e0cb54f4712a8f10fd2c082ee105c38f24ca7']",107,67,174,6022277,10,,,,4133
15d58729ef14c45c85d19faa5d409bb8ceae5006,0,Aaron Gresch,2020-04-08 15:18:56-05:00,['4e126034356968a89e976e7011b9dec9917dd6ed'],1,5,6,6022283,2,0.5,0.5,0.5,4133
be63269cc338078c4bfb3d88f2732dcae672aab8,0,Ethan Li,2020-04-08 15:58:17-05:00,['4e126034356968a89e976e7011b9dec9917dd6ed'],15,30,45,6022328,3,1,1,1,4133
ef9ab9cc379af1f45fd2d0994a51ad759bdbeffc,0,GitHub,2020-04-08 16:09:17-05:00,['4e126034356968a89e976e7011b9dec9917dd6ed'],8,21,29,6022357,1,1,1,1,4133
00f48d60e75b28e11a887baba02dc77876b2bb3d,0,GitHub,2020-04-08 16:11:15-05:00,"['ef9ab9cc379af1f45fd2d0994a51ad759bdbeffc', '257ae2fc52a1b097e62cacdae9a0347d1c7db139']",10,30,40,6022397,1,,,,4133
3eca57d4349162c9bc7dca65bf1e98e8d85aacb1,0,GitHub,2020-04-09 15:31:53-05:00,"['00f48d60e75b28e11a887baba02dc77876b2bb3d', '15d58729ef14c45c85d19faa5d409bb8ceae5006']",1,5,6,6022403,2,,,,4133
ae5b70ff9d512431bb9e85aaa0883564c61fa917,0,GitHub,2020-04-09 15:32:45-05:00,"['3eca57d4349162c9bc7dca65bf1e98e8d85aacb1', 'be63269cc338078c4bfb3d88f2732dcae672aab8']",15,30,45,6022448,3,,,,4133
1a382d477b550723984e46acf24dd957fd043aa3,0,GitHub,2020-04-13 09:54:13-05:00,['ae5b70ff9d512431bb9e85aaa0883564c61fa917'],66,98,164,6022612,2,0,1,1,4134
c122876f1518f5e737ca0ea831e8c853af8d6a79,0,GitHub,2020-04-13 09:56:54-05:00,['1a382d477b550723984e46acf24dd957fd043aa3'],75,107,182,6022794,2,1,1,1,4135
632d32039031c7e6bbe29ecce2d9833c1a677b76,0,Govind Menon,2020-04-13 16:36:35-05:00,['097940d0f915fdf2893d02558b3c860f32e7369a'],43,317,360,6023154,10,0.425531915,0.29787234,0.496453901,4137
1b325e6110414d9b425b4c74fd72e1e40bb98c9c,0,Ethan Li,2020-04-15 09:08:18-05:00,['c122876f1518f5e737ca0ea831e8c853af8d6a79'],5,3,8,6023162,1,,,,4137
7ffc44d083707bc60749fe6821f662fc730c6466,0,GitHub,2020-04-15 17:10:34-04:00,['c122876f1518f5e737ca0ea831e8c853af8d6a79'],11,873,884,6024046,83,0.176125245,0.504892368,0.876712329,4219
3890a0345f1c73dad04a8cda87c279a2ffdb0cbf,0,GitHub,2020-04-16 08:39:17-05:00,"['7ffc44d083707bc60749fe6821f662fc730c6466', '1b325e6110414d9b425b4c74fd72e1e40bb98c9c']",5,3,8,6024054,1,,,,4219
973fda807a407b4fd764fcca14e30f5891ec30f2,0,GitHub,2020-04-16 08:57:11-05:00,['3890a0345f1c73dad04a8cda87c279a2ffdb0cbf'],32,551,583,6024637,9,0.290441176,0.830882353,0.761029412,4221
ec4065a4150bb6c2b924e3019885d4cc474c8a4e,0,GitHub,2020-04-16 10:15:28-05:00,"['973fda807a407b4fd764fcca14e30f5891ec30f2', '632d32039031c7e6bbe29ecce2d9833c1a677b76']",43,317,360,6024997,10,,,,4221
53a277ec79d0b289e4f2bef5e94e289132342f9d,0,Rui Li,2020-04-16 14:31:17-05:00,['ec4065a4150bb6c2b924e3019885d4cc474c8a4e'],1,1,2,6024999,1,,,,4221
3cd0d23bd441a731b59c58b5812b393d26b81b8d,0,GitHub,2020-04-17 11:01:18-05:00,"['ec4065a4150bb6c2b924e3019885d4cc474c8a4e', '53a277ec79d0b289e4f2bef5e94e289132342f9d']",1,1,2,6025001,1,,,,4221
bba0f38e0b90ef5e1220f303abf9b14031b8bdbf,0,Ethan Li,2020-04-17 11:04:50-05:00,['3cd0d23bd441a731b59c58b5812b393d26b81b8d'],0,1,1,6025002,1,,,,4221
ad4093ac68d52cc42d04624064a5a901c20292df,0,Ethan Li,2020-04-21 13:32:18-05:00,['3cd0d23bd441a731b59c58b5812b393d26b81b8d'],3,3,6,6025008,1,,,,4221
ffab30362320e0b5cd8f6356c01d9dc3cfa28fd6,0,GitHub,2020-04-21 13:41:55-05:00,"['3cd0d23bd441a731b59c58b5812b393d26b81b8d', 'bba0f38e0b90ef5e1220f303abf9b14031b8bdbf']",0,1,1,6025009,1,,,,4221
c33ae620e1b81281acd657253673482432a38cb5,0,GitHub,2020-04-22 15:16:51-05:00,"['ffab30362320e0b5cd8f6356c01d9dc3cfa28fd6', 'ad4093ac68d52cc42d04624064a5a901c20292df']",3,3,6,6025015,1,,,,4221
5daf0cce0ddbbb7c6ceee38c5cfec9ba3a858517,0,Govind Menon,2020-04-23 13:07:20-05:00,['632d32039031c7e6bbe29ecce2d9833c1a677b76'],13,48,61,6025076,2,0,0.36,0.88,4221
a2905c8844291ca35bc7d50905b7adc605765c29,0,GitHub,2020-04-24 10:21:01-05:00,"['c33ae620e1b81281acd657253673482432a38cb5', '5daf0cce0ddbbb7c6ceee38c5cfec9ba3a858517']",13,48,61,6025137,2,,,,4221
6976624228386c25e9ac6dd2b8ef87a9deeb1ad9,1,Aaron Gresch,2020-04-27 16:43:41-05:00,['3cd0d23bd441a731b59c58b5812b393d26b81b8d'],55,174,229,6025366,5,1,1,0.563218391,4221
38d714bf37ecd69dc2d2a16e8f6f6317dfe4f846,0,GitHub,2020-04-28 13:47:05-05:00,"['a2905c8844291ca35bc7d50905b7adc605765c29', '6976624228386c25e9ac6dd2b8ef87a9deeb1ad9']",55,174,229,6025595,5,,,,4221
669d886bef942498ec83d5c6839cfd03f25a0307,0,Aaron Gresch,2020-04-28 13:49:38-05:00,['3cd0d23bd441a731b59c58b5812b393d26b81b8d'],12,96,108,6025703,8,0.6,0.777777778,0.777777778,4222
5873eaded557a6fd639c1b70acff684b9c4bd466,0,GitHub,2020-04-28 14:49:21-05:00,['38d714bf37ecd69dc2d2a16e8f6f6317dfe4f846'],4,31,35,6025738,4,0,0.047619048,1,4222
626ebd7b283a9c76745d2a0a20540128e31ed352,0,GitHub,2020-04-29 15:24:33-05:00,"['5873eaded557a6fd639c1b70acff684b9c4bd466', '669d886bef942498ec83d5c6839cfd03f25a0307']",12,96,108,6025846,8,,,,4222
c78611630233dfef5a14835be93e525b672a50da,0,Ethan Li,2020-04-29 17:48:18-05:00,['626ebd7b283a9c76745d2a0a20540128e31ed352'],15,17,32,6025878,2,,0,,4222
06e1ecb2f6de7c3f28ece287a2bd5ae73ea91de7,0,GitHub,2020-05-01 09:04:28-05:00,['626ebd7b283a9c76745d2a0a20540128e31ed352'],2,2,4,6025882,1,,,,4222
5d84e5e98f55c87afd425dc2169118f7821f6a71,0,GitHub,2020-05-01 09:07:24-05:00,"['06e1ecb2f6de7c3f28ece287a2bd5ae73ea91de7', 'c78611630233dfef5a14835be93e525b672a50da']",15,17,32,6025914,2,,,,4222
0553e9a605d46addc8e01f021ad651296d2e4e8d,0,Ethan Li,2020-05-01 14:46:16-05:00,['5d84e5e98f55c87afd425dc2169118f7821f6a71'],69,45,114,6026028,9,1,1,0.032258065,4222
55ce4a09e54497ab96bcd42aa39460fc0344d13f,0,GitHub,2020-05-01 17:40:34-05:00,['5d84e5e98f55c87afd425dc2169118f7821f6a71'],0,8,8,6026036,2,,,,4223
06db0e954997e579c175ffae5f7f25a06cf9e4c5,0,GitHub,2020-05-04 14:58:35-05:00,"['55ce4a09e54497ab96bcd42aa39460fc0344d13f', '0553e9a605d46addc8e01f021ad651296d2e4e8d']",69,45,114,6026150,9,,,,4223
f1c435424d1b5ad36aea8d7a056dcacf043311f4,0,Aaron Gresch,2020-05-06 15:54:38-05:00,['06db0e954997e579c175ffae5f7f25a06cf9e4c5'],1,1,2,6026152,1,,,,4223
250fe114023fa120df7f94d7d954930aba6de7a4,0,GitHub,2020-05-08 09:21:35-05:00,"['06db0e954997e579c175ffae5f7f25a06cf9e4c5', 'f1c435424d1b5ad36aea8d7a056dcacf043311f4']",1,1,2,6026154,1,,,,4223
71023d2919ff67affe5d908fa2e8ecd0b526ca00,0,Aaron Gresch,2020-05-12 09:50:28-05:00,['250fe114023fa120df7f94d7d954930aba6de7a4'],0,1,1,6026155,1,0,0,1,4223
3f96b79d57b56b25cd93ee49d85c09e78bb674b3,0,GitHub,2020-05-13 09:44:45-05:00,"['250fe114023fa120df7f94d7d954930aba6de7a4', '71023d2919ff67affe5d908fa2e8ecd0b526ca00']",0,1,1,6026156,1,,,,4223
a3378c09fb0bf35ee20ddc1dd5a33ace8b576eda,0,Aaron Gresch,2020-05-13 10:20:23-05:00,['250fe114023fa120df7f94d7d954930aba6de7a4'],48,81,129,6026285,1,0,1,0.75,4223
69e69d40d5c700465b49f4c23312f974fb2ca1f6,0,GitHub,2020-05-13 11:53:26-05:00,"['3f96b79d57b56b25cd93ee49d85c09e78bb674b3', 'a3378c09fb0bf35ee20ddc1dd5a33ace8b576eda']",48,81,129,6026414,1,,,,4223
2b36eae9385616a26dd0f84c3071b8c4908d57d4,1,Aaron Gresch,2020-05-14 11:46:14-05:00,['69e69d40d5c700465b49f4c23312f974fb2ca1f6'],6,35,41,6026455,3,1,1,1,4223
d5256cecad2ab18489d0e20150a9adff286fc616,0,GitHub,2020-05-14 13:08:02-05:00,"['69e69d40d5c700465b49f4c23312f974fb2ca1f6', '2b36eae9385616a26dd0f84c3071b8c4908d57d4']",6,35,41,6026496,3,,,,4223
4aa4797787675e604571a5f6a9f596d9f6b13d83,0,GitHub,2020-05-14 16:54:45-05:00,['d5256cecad2ab18489d0e20150a9adff286fc616'],9,214,223,6026719,7,0.404494382,0.741573034,0.887640449,4225
8e037721dfee166bcfc113da662caaa6b11d9b2d,0,GitHub,2020-05-18 13:19:30-05:00,['4aa4797787675e604571a5f6a9f596d9f6b13d83'],5,5,10,6026729,1,,,,4225
515faafa231f07e806d5837036cf2f31deca2e79,0,Govind Menon,2020-05-20 18:26:00-05:00,['8e037721dfee166bcfc113da662caaa6b11d9b2d'],0,97,97,6026826,1,,,,4226
59891a5c8f63070b60d678a975657fb5c5de9aba,0,GitHub,2020-05-22 14:35:53-05:00,"['8e037721dfee166bcfc113da662caaa6b11d9b2d', '515faafa231f07e806d5837036cf2f31deca2e79']",0,97,97,6026923,1,,,,4226
e89a0596ece96edb9371eeaf8a948f5c60f30d69,0,Aaron Gresch,2020-05-28 16:26:30-05:00,['59891a5c8f63070b60d678a975657fb5c5de9aba'],1,5,6,6026929,1,0,0,1,4226
3f0e3d58025f03a9742d6bb9e02989383c089d91,0,T-Bone,2020-05-29 14:53:58-05:00,['59891a5c8f63070b60d678a975657fb5c5de9aba'],78,78,156,6027085,77,,,,4226
de50e5a848b3838ffe8a76b92ae6d5913444d0a8,0,GitHub,2020-05-29 14:58:28-05:00,"['59891a5c8f63070b60d678a975657fb5c5de9aba', '3f0e3d58025f03a9742d6bb9e02989383c089d91']",78,78,156,6027241,77,,,,4226
8362fbcb764eccc5eff1fad3c86152f05ea4398f,0,GitHub,2020-06-01 11:44:19-05:00,"['de50e5a848b3838ffe8a76b92ae6d5913444d0a8', 'e89a0596ece96edb9371eeaf8a948f5c60f30d69']",1,5,6,6027247,1,,,,4226
2e3e2b5c674a1262d1ae9f4162c17c409fccbb32,0,Aaron Gresch,2020-06-01 16:11:11-05:00,['8362fbcb764eccc5eff1fad3c86152f05ea4398f'],3,8,11,6027258,1,1,1,1,4226
013654d9cb415c4119d2bdf753351f5af5394fad,0,GitHub,2020-06-02 10:25:50-05:00,['8362fbcb764eccc5eff1fad3c86152f05ea4398f'],13,320,333,6027591,6,0.113636364,0.618181818,0.868181818,4226
e3852a24eb994e3acc63551c99766e2fdd91bcdf,0,Aaron Gresch,2020-06-02 14:46:41-05:00,['8362fbcb764eccc5eff1fad3c86152f05ea4398f'],200,189,389,6027980,12,0,0,0,4227
488af7a49c978a4598b3f5a7e13ae87440d6a328,0,Aaron Gresch,2020-06-03 09:22:39-05:00,['013654d9cb415c4119d2bdf753351f5af5394fad'],1,1,2,6027982,1,,,,4227
cfc28e348d07d00e52259b8f7f611b2241caf62b,0,GitHub,2020-06-03 09:24:54-05:00,"['013654d9cb415c4119d2bdf753351f5af5394fad', '2e3e2b5c674a1262d1ae9f4162c17c409fccbb32']",3,8,11,6027993,1,,,,4227
df2e8d6e774eb3f9aadd440384208a918304dfe0,0,GitHub,2020-06-03 09:26:48-05:00,"['cfc28e348d07d00e52259b8f7f611b2241caf62b', 'e3852a24eb994e3acc63551c99766e2fdd91bcdf']",200,189,389,6028382,12,,,,4227
6c805acefdc69d21edd27c307c76d50733f2683b,0,GitHub,2020-06-04 09:32:25-05:00,"['df2e8d6e774eb3f9aadd440384208a918304dfe0', '488af7a49c978a4598b3f5a7e13ae87440d6a328']",1,1,2,6028384,1,,,,4227
712af2f60cf8cc52156cf42a6b13ea1b53482133,0,Govind Menon,2020-06-04 15:37:02-05:00,['6c805acefdc69d21edd27c307c76d50733f2683b'],27,48,75,6028459,2,0.45,1,0,4227
fcfc32dfd537d9d99586c97459b4d465a0355b46,0,GitHub,2020-06-05 13:26:17-05:00,['6c805acefdc69d21edd27c307c76d50733f2683b'],29,372,401,6028860,7,0.629310345,1,0.956896552,4231
5c8d2fb85d7a1e86b0f1f31246d6376f835f9e86,0,GitHub,2020-06-08 09:16:52-05:00,['fcfc32dfd537d9d99586c97459b4d465a0355b46'],41,462,503,6029363,2,0.112244898,0.258503401,1,4231
0ceecaf3d08bee8e166ef47d2471688e17217e6a,0,Ethan Li,2020-06-08 15:48:14-05:00,['5c8d2fb85d7a1e86b0f1f31246d6376f835f9e86'],1,1,2,6029365,1,,,,4231
16e92e7b0a4c30308a00bcfe4d52bdbb4be563ac,0,GitHub,2020-06-09 15:26:53-05:00,"['5c8d2fb85d7a1e86b0f1f31246d6376f835f9e86', '0ceecaf3d08bee8e166ef47d2471688e17217e6a']",1,1,2,6029367,1,,,,4231
15028d091382806ff270c5095ada1c6b1695acf4,0,GitHub,2020-06-09 16:35:39-05:00,"['16e92e7b0a4c30308a00bcfe4d52bdbb4be563ac', '712af2f60cf8cc52156cf42a6b13ea1b53482133']",27,48,75,6029442,2,,,,4231
14b762ac5190939af038612c1160936b45cefcdf,0,Ethan Li,2020-06-09 16:47:15-05:00,['15028d091382806ff270c5095ada1c6b1695acf4'],974,1053,2027,6031469,16,0.870967742,0,0.161290323,4232
879087e19f048f222cd01972bf538daa80ec7dba,0,GitHub,2020-06-10 15:35:47-05:00,"['15028d091382806ff270c5095ada1c6b1695acf4', '14b762ac5190939af038612c1160936b45cefcdf']",974,1053,2027,6033496,16,,,,4232
b56a1aafa4bf26f45f6633dacf1a0e7171c06b14,0,Ethan Li,2020-06-10 16:19:01-05:00,['15028d091382806ff270c5095ada1c6b1695acf4'],1,2,3,6033499,1,0,1,1,4232
af5021aa1911a89c8cee65b91f50fa8d00263d08,0,GitHub,2020-06-15 10:07:51-05:00,['879087e19f048f222cd01972bf538daa80ec7dba'],12,119,131,6033630,8,0.379310345,0.965517241,1,4233
a9a747ec45cb94ed113437e5b1b8ce23d6508623,0,GitHub,2020-06-15 12:24:55-05:00,"['af5021aa1911a89c8cee65b91f50fa8d00263d08', 'b56a1aafa4bf26f45f6633dacf1a0e7171c06b14']",1,2,3,6033633,1,,,,4233
04ee172f9580cbae2f7974fb98323432b887af3c,0,Bipin Prasad,2020-06-17 16:16:09-05:00,['a9a747ec45cb94ed113437e5b1b8ce23d6508623'],0,10,10,6033643,1,,,,4233
17db8a9799805d77e8a7cbaf6cfe6d4ec1ce2822,0,Kishor Patil,2020-06-23 00:57:35-04:00,['a9a747ec45cb94ed113437e5b1b8ce23d6508623'],3,3,6,6033649,1,,,,4233
a8b514b042bc5ee82c76ed8b3f8afda8118873b5,0,Aaron Gresch,2020-06-24 09:45:28-05:00,['a9a747ec45cb94ed113437e5b1b8ce23d6508623'],38,61,99,6033748,4,1,1,0,4233
a59d82f8342ff00af041fb6f283c172f0b2f07b3,0,GitHub,2020-06-24 10:31:23-05:00,"['a9a747ec45cb94ed113437e5b1b8ce23d6508623', '04ee172f9580cbae2f7974fb98323432b887af3c']",0,10,10,6033758,1,,,,4233
e832204321b07f9a13c48ec75f54627b153d97f1,0,GitHub,2020-06-25 09:16:45-05:00,"['a59d82f8342ff00af041fb6f283c172f0b2f07b3', '17db8a9799805d77e8a7cbaf6cfe6d4ec1ce2822']",3,3,6,6033764,1,,,,4233
ba487540591b24d67e258470f6a4b5420f6c28ed,0,GitHub,2020-06-25 13:14:39-05:00,"['e832204321b07f9a13c48ec75f54627b153d97f1', 'a8b514b042bc5ee82c76ed8b3f8afda8118873b5']",38,61,99,6033863,4,,,,4233
2643f6952c6258dcd45581aa8a9eadc7eb11ad8f,0,Aaron Gresch,2020-06-26 09:37:57-05:00,['a9a747ec45cb94ed113437e5b1b8ce23d6508623'],0,17,17,6033880,3,0.777777778,0.777777778,0.111111111,4233
dd65dd7f6b931bf5eb8338da35e234d9eabfda65,0,Rui Li,2020-06-26 17:52:45-05:00,['ba487540591b24d67e258470f6a4b5420f6c28ed'],0,0,0,6033880,1,,,,4233
450d5956bf8345d2b1dff9c60d8d50cb2431edb3,0,GitHub,2020-06-29 09:27:52-05:00,['ba487540591b24d67e258470f6a4b5420f6c28ed'],34,35,69,6033949,9,0.25,0.75,0.5,4233
9d4eb6bc15cdef03e2da466bfe469b46720ab5ce,0,GitHub,2020-06-29 09:38:29-05:00,"['450d5956bf8345d2b1dff9c60d8d50cb2431edb3', 'dd65dd7f6b931bf5eb8338da35e234d9eabfda65']",0,0,0,6033949,1,,,,4233
f10cfd48ec2d30127acb101eff14ba8f9fa616de,0,GitHub,2020-06-29 09:53:03-05:00,['9d4eb6bc15cdef03e2da466bfe469b46720ab5ce'],2,15,17,6033966,1,0,0,0,4233
2924dcad3d1fb9326e01ea0d5a3a68cace7ba822,0,GitHub,2020-06-29 09:58:39-05:00,"['f10cfd48ec2d30127acb101eff14ba8f9fa616de', '2643f6952c6258dcd45581aa8a9eadc7eb11ad8f']",0,17,17,6033983,3,,,,4233
07362f566132ff9392f2d320ed6aa4e78509258d,1,Kishor Patil,2020-06-29 14:00:22-04:00,['a9a747ec45cb94ed113437e5b1b8ce23d6508623'],6,22,28,6034011,1,0.866666667,0.866666667,1,4233
04210b4a3f0b6e61f2669306faa8998d7eb2ced6,0,Bipin Prasad,2020-06-30 13:52:30-05:00,['2924dcad3d1fb9326e01ea0d5a3a68cace7ba822'],0,6,6,6034017,1,,,,4233
4fdfc0e919c70352c85ebe652dc50a929077d853,0,GitHub,2020-07-01 08:53:19-05:00,"['2924dcad3d1fb9326e01ea0d5a3a68cace7ba822', '07362f566132ff9392f2d320ed6aa4e78509258d']",6,22,28,6034045,1,,,,4233
e0ffb8d16097c1bb7545b1d1618a37a739793528,0,GitHub,2020-07-02 09:03:13-05:00,['4fdfc0e919c70352c85ebe652dc50a929077d853'],4,34,38,6034083,6,0,0,0.842105263,4233
259567551048c4e131d990e9983dc86d0aa03388,0,GitHub,2020-07-02 09:07:02-05:00,['e0ffb8d16097c1bb7545b1d1618a37a739793528'],48,64,112,6034195,3,0,0,1,4233
c98b2d120c8af19148c61192beb4f56226078edb,0,GitHub,2020-07-02 09:09:35-05:00,"['259567551048c4e131d990e9983dc86d0aa03388', '04210b4a3f0b6e61f2669306faa8998d7eb2ced6']",0,6,6,6034201,1,,,,4233
332cbe5f1bfd8753a1a4f6ba1fcad5d3476de4e2,0,GitHub,2020-07-02 13:07:36-05:00,['c98b2d120c8af19148c61192beb4f56226078edb'],1,10,11,6034212,1,1,1,0,4233
1c500ef9cc0e468f94dc7988e9b31e0402ec26da,0,GitHub,2020-07-07 12:52:31-05:00,['332cbe5f1bfd8753a1a4f6ba1fcad5d3476de4e2'],2,0,2,6034214,1,1,1,1,4233
dd04f8962e61ae65e6a0183451b26d735d6c33a7,0,GitHub,2020-07-08 13:40:37-05:00,['1c500ef9cc0e468f94dc7988e9b31e0402ec26da'],1,1,2,6034216,1,,,,4233
07bb178de9ed6ab2f642d7e3ae464e736ba18975,0,GitHub,2020-07-09 11:10:35-05:00,['dd04f8962e61ae65e6a0183451b26d735d6c33a7'],4,4,8,6034224,1,,,,4233
e7731a547ae113d2fbc0fda6a9f02fc3d78de5fb,0,GitHub,2020-07-10 16:15:23-05:00,['07bb178de9ed6ab2f642d7e3ae464e736ba18975'],32,24,56,6034280,15,0,0.21299639,0.173285199,4234
93a7f770d508668bc7af183e08535813fff6f805,0,GitHub,2020-07-14 10:10:49-05:00,['e7731a547ae113d2fbc0fda6a9f02fc3d78de5fb'],32,41,73,6034353,8,1,1,0,4234
9076d32ac1b0a6f95f25a4f4c7266e83c4cea80d,0,GitHub,2020-07-15 09:17:07-05:00,['93a7f770d508668bc7af183e08535813fff6f805'],3,4,7,6034360,2,,,,4234
b0d253cf815c7104feca079d1473d353e789c056,0,Aaron Gresch,2020-07-16 14:06:37-05:00,['9076d32ac1b0a6f95f25a4f4c7266e83c4cea80d'],1,0,1,6034361,1,1,1,0,4234
b190b9c41492f1595bec7edff3a1c030e78e7165,0,GitHub,2020-07-20 10:11:00-05:00,"['9076d32ac1b0a6f95f25a4f4c7266e83c4cea80d', 'b0d253cf815c7104feca079d1473d353e789c056']",1,0,1,6034362,1,,,,4234
884faf740745d9d04eda215bc43dc90a76ec165a,0,GitHub,2020-07-21 11:36:46-05:00,['b190b9c41492f1595bec7edff3a1c030e78e7165'],2,2,4,6034366,1,,,,4234
8f0c26266d13094343c8a790a9ea7de8b1e7933f,0,GitHub,2020-07-21 11:38:05-05:00,['884faf740745d9d04eda215bc43dc90a76ec165a'],8,14,22,6034388,1,0,1,1,4234
02c349dd6d6cbfec6bad7eb54c9c25c6d6956cd1,0,GitHub,2020-07-28 09:02:38-05:00,['8f0c26266d13094343c8a790a9ea7de8b1e7933f'],29,78,107,6034495,4,0,0.6875,0.75,4234
9986a335584d322f6cf632bcc8326f974583ece1,0,GitHub,2020-08-05 09:30:45-05:00,['02c349dd6d6cbfec6bad7eb54c9c25c6d6956cd1'],1,4,5,6034500,1,,,,4234
c9276d228426ba076e9a4690998ab9c4570e16f2,0,GitHub,2020-08-05 23:35:12-05:00,['9986a335584d322f6cf632bcc8326f974583ece1'],0,14,14,6034514,1,,,,4234
bb3e7a195a1a97f4184a48bb4ad07a398194ed1a,0,GitHub,2020-08-06 09:47:50-05:00,['c9276d228426ba076e9a4690998ab9c4570e16f2'],149,356,505,6035019,24,1,1,0.957142857,4236
e82b9a707db38a814dbd2d8f85eeaac0fda0b75b,0,GitHub,2020-08-07 12:59:04-05:00,['bb3e7a195a1a97f4184a48bb4ad07a398194ed1a'],5,14,19,6035038,1,0,1,0,4236
bb199d574eae337d0512670dcc4957f3c7ef4922,0,GitHub,2020-08-19 20:07:07-05:00,['e82b9a707db38a814dbd2d8f85eeaac0fda0b75b'],19,903,922,6035960,5,0.175588865,1,0.905781585,4237
1ab888a2aed84537f6300c20a43387a56fa92f4a,0,GitHub,2020-08-26 09:54:46-05:00,['bb199d574eae337d0512670dcc4957f3c7ef4922'],3,5,8,6035968,1,1,1,1,4237
fd4ba1579863ba5fdbd2e8951da8a6e429a7ea08,0,GitHub,2020-08-27 10:51:59-05:00,['1ab888a2aed84537f6300c20a43387a56fa92f4a'],490,274,764,6036732,22,1,0,0,4239
c84bfc1c563662b4712785f88870dd31a056671a,0,GitHub,2020-08-31 14:31:37-05:00,['fd4ba1579863ba5fdbd2e8951da8a6e429a7ea08'],28,227,255,6036987,2,0,0,1,4239
b1e2d669035875de74e51ee65febdc067c504828,0,GitHub,2020-09-02 09:16:48-05:00,['c84bfc1c563662b4712785f88870dd31a056671a'],25,25,50,6037037,4,,,,4239
55a6eec9b73b0cf2bfc8b6383fbea8d2b7281b58,0,GitHub,2020-09-02 09:25:10-05:00,['b1e2d669035875de74e51ee65febdc067c504828'],41,114,155,6037192,2,0.073170732,0,0,4239
8399edcfbb06b484f7b06a08d4d75e0a2c8d4e86,0,GitHub,2020-09-04 09:23:06-05:00,['55a6eec9b73b0cf2bfc8b6383fbea8d2b7281b58'],24,407,431,6037623,4,0.055363322,0.14532872,0.85467128,4239
e83fafcb884f4c630dbbe4a8656a4f93a41abe5b,0,GitHub,2020-09-08 08:59:43-05:00,['8399edcfbb06b484f7b06a08d4d75e0a2c8d4e86'],8,12,20,6037643,1,1,1,0,4239
feb103e267f591920918473e0360d578e2c34c9e,0,Aaron Gresch,2020-09-09 13:33:33-05:00,['e83fafcb884f4c630dbbe4a8656a4f93a41abe5b'],1,4,5,6037648,1,0,1,0,4239
eeeaef35f234d11f4fb8271fae3bcf76aea3864b,0,GitHub,2020-09-09 14:58:15-05:00,"['e83fafcb884f4c630dbbe4a8656a4f93a41abe5b', 'feb103e267f591920918473e0360d578e2c34c9e']",1,4,5,6037653,1,,,,4239
369451ed0e92cd7d475cae15749000eb4b295656,0,GitHub,2020-09-16 09:41:10-05:00,['eeeaef35f234d11f4fb8271fae3bcf76aea3864b'],0,84,84,6037737,1,,,,4240
e794990f278fa01284daca94f0c1c577f056d513,0,GitHub,2020-09-17 08:54:10-05:00,['369451ed0e92cd7d475cae15749000eb4b295656'],10,27,37,6037774,2,0.083333333,0.083333333,1,4240
110736af19def6e0331316c52b6b3cff76fc3af0,0,GitHub,2020-09-18 09:58:38-05:00,['e794990f278fa01284daca94f0c1c577f056d513'],24,37,61,6037835,1,,,,4240
6e2e46bcf21584cb111bd5254912b2a6410eccb7,0,GitHub,2020-09-18 10:04:53-05:00,['110736af19def6e0331316c52b6b3cff76fc3af0'],1834,3115,4949,6042784,33,0.898765432,1,1,4253
39a6fba632a70f1d4684489b5b4dc6cb98a34662,1,GitHub,2020-09-21 13:28:49-05:00,['6e2e46bcf21584cb111bd5254912b2a6410eccb7'],40,459,499,6043283,10,0.546296296,0.550925926,0.490740741,4257
19e23ae4a44fcf8e74473a48d408a712cde45d64,0,GitHub,2020-09-21 13:38:54-05:00,['39a6fba632a70f1d4684489b5b4dc6cb98a34662'],4,12,16,6043299,1,0,0,1,4257
7bef73a6faa14558ef254efe74cbe4bfef81c2e2,0,GitHub,2020-09-30 16:24:22-05:00,['19e23ae4a44fcf8e74473a48d408a712cde45d64'],7,68,75,6043374,5,0.43902439,0.951219512,0.926829268,4257
f1c161949db066c35839116070892b86b8bd7e67,0,GitHub,2020-10-01 10:57:31-05:00,['7bef73a6faa14558ef254efe74cbe4bfef81c2e2'],856,7577,8433,6051807,25,0.547154134,0.6497715,0.949937682,4257
935f74c6abd705c1ce9833ee88e092df097c17a5,0,GitHub,2020-10-01 14:23:46-05:00,['f1c161949db066c35839116070892b86b8bd7e67'],62,3310,3372,6055179,39,0.451879699,0.630827068,0.743609023,4279
d3a06a2fc0c577b9db7f14e24b99f7bf70d2d55d,0,Aaron Gresch,2020-10-27 16:45:17-05:00,['935f74c6abd705c1ce9833ee88e092df097c17a5'],0,4,4,6055183,2,0,0.5,0.5,4279
1d653a228e89749a1ce67c1b0ff5b2d1fef05818,0,GitHub,2020-10-29 11:15:52-05:00,"['935f74c6abd705c1ce9833ee88e092df097c17a5', 'd3a06a2fc0c577b9db7f14e24b99f7bf70d2d55d']",0,4,4,6055187,2,,,,4279
aee7523f53c4c7a72da7f293cca0cbdc227a5940,0,Bipin Prasad,2020-10-30 06:57:59-05:00,['1d653a228e89749a1ce67c1b0ff5b2d1fef05818'],0,65,65,6055252,2,0,0.884615385,0.884615385,4280
f33012084a05bcab86510cd6e593d91f0c3974f4,0,GitHub,2020-11-02 09:52:44-06:00,['1d653a228e89749a1ce67c1b0ff5b2d1fef05818'],2,2,4,6055256,2,,,,4280
fe2f7102e244336e288d26f2dde8089198ee4c33,0,GitHub,2020-11-05 16:03:27-06:00,['f33012084a05bcab86510cd6e593d91f0c3974f4'],2,4,6,6055262,1,,,,4280
abd27a67aafed707f2804ecdec549483e39bcdd9,0,Kishor Patil,2020-11-11 17:42:41-05:00,['fe2f7102e244336e288d26f2dde8089198ee4c33'],11,43,54,6055316,1,0.153846154,0.923076923,0.884615385,4280
873bb8820605eb7e3be7c9c9033536edebf7ea11,0,GitHub,2020-11-15 23:05:37-06:00,"['fe2f7102e244336e288d26f2dde8089198ee4c33', 'abd27a67aafed707f2804ecdec549483e39bcdd9']",11,43,54,6055370,1,,,,4280
19eb699061a1e2ffb7e05576985905d1da1ca1e5,0,GitHub,2020-11-15 23:08:11-06:00,['873bb8820605eb7e3be7c9c9033536edebf7ea11'],0,36,36,6055406,1,0.0625,0.75,1,4280
51f5464fcdda3b416053ff67bba4a40cb257b3a5,0,GitHub,2020-11-15 23:23:03-06:00,"['19eb699061a1e2ffb7e05576985905d1da1ca1e5', 'aee7523f53c4c7a72da7f293cca0cbdc227a5940']",0,65,65,6055471,2,,,,4280
e0cc3b1932733be03b786c9fd537e836d96fd270,0,Aaron Gresch,2020-11-17 11:26:03-06:00,['51f5464fcdda3b416053ff67bba4a40cb257b3a5'],1,1,2,6055473,1,,,,4280
6e5609acfd4750ba17b2c0d0e6f819e28e64c96c,0,GitHub,2020-12-02 12:49:54-06:00,"['51f5464fcdda3b416053ff67bba4a40cb257b3a5', 'e0cc3b1932733be03b786c9fd537e836d96fd270']",1,1,2,6055475,1,,,,4280
76f356cb65ced103b44d58e0274d2ac29472040c,0,GitHub,2020-12-08 10:19:01-06:00,['6e5609acfd4750ba17b2c0d0e6f819e28e64c96c'],52,51,103,6055578,3,,,,4280
6e3707242e0e6835085d358bec0abee4f62b1426,0,GitHub,2020-12-08 10:22:33-06:00,['76f356cb65ced103b44d58e0274d2ac29472040c'],2,18,20,6055598,4,0.333333333,1,0.333333333,4280
10a1e1ec434742ccb1d28d22411a915c75ed74d2,0,GitHub,2020-12-09 11:32:44-06:00,['6e3707242e0e6835085d358bec0abee4f62b1426'],8,8,16,6055614,7,,,,4280
58c7ad671e97bc5f8de6f6d85eb8129489ca6939,0,GitHub,2020-12-09 11:36:15-06:00,['10a1e1ec434742ccb1d28d22411a915c75ed74d2'],24,27,51,6055665,2,0.333333333,0.333333333,0,4280
eba778189cac5be896fe8fb724b1852882bb851f,0,GitHub,2020-12-10 09:15:53-06:00,['58c7ad671e97bc5f8de6f6d85eb8129489ca6939'],11,10,21,6055686,3,0,0,0,4280
e4ce51736dd9dd3cbf86657aa8b2ca67b9bd40a7,0,GitHub,2020-12-14 09:54:57-06:00,['eba778189cac5be896fe8fb724b1852882bb851f'],0,21,21,6055707,2,,,,4280
6b3922f8a2ee41d24538213626555d460a3d5415,1,GitHub,2020-12-16 20:39:16-06:00,['e4ce51736dd9dd3cbf86657aa8b2ca67b9bd40a7'],7,17,24,6055731,2,,,,4280
9a9596685348e310078fb6b0970a629703465454,0,GitHub,2020-12-16 20:42:36-06:00,['6b3922f8a2ee41d24538213626555d460a3d5415'],20,71,91,6055822,2,0,0.774193548,1,4280
d0027d97323375120f8c17540f698a3f66489aa7,0,GitHub,2020-12-22 09:25:25-06:00,['9a9596685348e310078fb6b0970a629703465454'],54,79,133,6055955,1,0,1,0.916666667,4280
ab6b6f69a10bf57c1b46a6519d57ca423d99558c,0,GitHub,2020-12-23 09:08:51-06:00,['d0027d97323375120f8c17540f698a3f66489aa7'],0,6,6,6055961,1,0,1,0,4280
254a98db0966914bc07094e168667e1a851affcf,0,GitHub,2020-12-23 15:18:28-06:00,['ab6b6f69a10bf57c1b46a6519d57ca423d99558c'],141,899,1040,6057001,18,0.082589286,0.352678571,0.796875,4280
f451be2ef81c0821f65a1a4d671b90c221ef99db,0,GitHub,2021-01-05 09:28:19-06:00,['254a98db0966914bc07094e168667e1a851affcf'],2,4,6,6057007,2,1,1,1,4280
5360a15861db8edf5728b9f3eaca92c5470811b0,0,GitHub,2021-01-05 09:32:52-06:00,['f451be2ef81c0821f65a1a4d671b90c221ef99db'],2,0,2,6057009,1,,,,4280
ba7f969a3a046c5a312a394026d5d9dd755e04a0,0,GitHub,2021-01-05 11:32:40-06:00,['5360a15861db8edf5728b9f3eaca92c5470811b0'],1,6,7,6057016,1,1,1,1,4280
7207cc883c71061a522ccaba33bf29fb5003282f,0,GitHub,2021-01-05 16:04:14-06:00,['ba7f969a3a046c5a312a394026d5d9dd755e04a0'],24,124,148,6057164,3,0.872340426,1,0.638297872,4281
c9d33bc82cfbb741542d00131ebf8a4790f4df15,0,GitHub,2021-01-12 10:00:44-06:00,['7207cc883c71061a522ccaba33bf29fb5003282f'],211,390,601,6057765,8,0.408602151,0.967741935,0.731182796,4283
af0b1fd873a4c28253811d9bc27e32c4279daddf,0,GitHub,2021-01-14 09:15:12-06:00,['c9d33bc82cfbb741542d00131ebf8a4790f4df15'],45,377,422,6058187,14,0.653846154,1,0.987179487,4284
b23e69170f94f8f1265172bd0609c4f3471cf490,0,GitHub,2021-01-19 09:47:47-06:00,['af0b1fd873a4c28253811d9bc27e32c4279daddf'],0,2,2,6058189,1,0,0,1,4284
3cc4797e56cf30dc04c8c8dcf133534522cc87eb,0,GitHub,2021-01-19 11:06:56-06:00,['b23e69170f94f8f1265172bd0609c4f3471cf490'],106,188,294,6058483,12,0.62,1,0.44,4284
bc87b1183fed3c2933f2ed518dee0bbcccdd826d,0,Bipin Prasad,2021-02-04 01:28:42-06:00,['3cc4797e56cf30dc04c8c8dcf133534522cc87eb'],1,1,2,6058485,1,,,,4284
dcaf4fbded8c22a5e6a5ba2cf1f04b08945f9e7c,0,GitHub,2021-02-05 10:12:03-06:00,['3cc4797e56cf30dc04c8c8dcf133534522cc87eb'],8,25,33,6058518,2,0.714285714,0.714285714,0.928571429,4284
1b870a829b84c31a1dba17139ff389762d523dbb,0,Bipin Prasad,2021-02-17 08:35:35-06:00,['dcaf4fbded8c22a5e6a5ba2cf1f04b08945f9e7c'],47,154,201,6058719,93,0.423076923,1,0.91025641,4376
2fe9644a52bb8256a74003e1ca6cb4e88aa5be27,0,GitHub,2021-02-17 12:29:00-06:00,"['dcaf4fbded8c22a5e6a5ba2cf1f04b08945f9e7c', 'bc87b1183fed3c2933f2ed518dee0bbcccdd826d']",1,1,2,6058721,1,,,,4376
e1d15cc766df523eb2e042397430ec6a9590a26a,0,Bipin Prasad,2021-02-18 13:34:26-06:00,"['1b870a829b84c31a1dba17139ff389762d523dbb', '2fe9644a52bb8256a74003e1ca6cb4e88aa5be27']",1,1,2,6058723,1,,,,4376
fa33d4b271df7cda61980361ec28093b4749768e,0,Bipin Prasad,2021-02-18 15:06:37-06:00,['e1d15cc766df523eb2e042397430ec6a9590a26a'],6,23,29,6058752,102,1,1,1,4476
fc20b4b528b9e5041c3bc189f2dc358215ba7993,0,Bipin Prasad,2021-02-22 20:47:17-06:00,['fa33d4b271df7cda61980361ec28093b4749768e'],132,152,284,6059036,2,0.461538462,1,1,4476
f7601194349cfd78b4f5c870bb7b6b21d29d2fb5,0,Bipin Prasad,2021-02-25 22:29:08-06:00,['fc20b4b528b9e5041c3bc189f2dc358215ba7993'],1,1,2,6059038,1,,,,4476
e3df2c17e758bf4fc02558f5976f7151ab2fe33a,0,GitHub,2021-02-26 10:36:29-06:00,"['2fe9644a52bb8256a74003e1ca6cb4e88aa5be27', 'f7601194349cfd78b4f5c870bb7b6b21d29d2fb5']",118,262,380,6059418,194,,,,4476
5f9fabc22e0741e62aa0c96c150709ccae74b9e8,0,GitHub,2021-03-05 10:14:51-06:00,['e3df2c17e758bf4fc02558f5976f7151ab2fe33a'],1,1,2,6059420,1,,,,4476
0859cd191715a09f5c84e781e3d0e3ca89e60654,0,GitHub,2021-03-08 09:31:39-06:00,['5f9fabc22e0741e62aa0c96c150709ccae74b9e8'],5,1,6,6059426,1,0,0,0,4476
f1716be3d630c44c93787500af9cee427652f548,0,GitHub,2021-03-15 12:18:35-05:00,['0859cd191715a09f5c84e781e3d0e3ca89e60654'],151,2045,2196,6061622,12,0.149957155,0.792630677,0.797772065,4478
ab7e003ca0e811f95b092561870d69b0591d6d46,0,GitHub,2021-03-17 13:39:02-05:00,['f1716be3d630c44c93787500af9cee427652f548'],1,1,2,6061624,1,,,,4478
874b87cd7b71107558f734cdb5cdb7f36f5f3d42,0,GitHub,2021-03-17 13:57:20-05:00,['ab7e003ca0e811f95b092561870d69b0591d6d46'],30,31,61,6061685,3,,,,4478
4de0622c6e25e891419f8ccd002e243470dfe969,0,GitHub,2021-03-18 11:06:34-05:00,['874b87cd7b71107558f734cdb5cdb7f36f5f3d42'],37,24,61,6061746,1,1,1,0,4478
3f96c249cbc17ce062491bfbb39d484e241ab168,0,GitHub,2021-03-23 11:30:31-05:00,['4de0622c6e25e891419f8ccd002e243470dfe969'],1,17,18,6061764,1,0,0,0,4478
3b48efc15aff240c2dc883d503362d3f20db2692,0,GitHub,2021-03-26 11:57:12-05:00,['3f96c249cbc17ce062491bfbb39d484e241ab168'],0,37,37,6061801,1,,,,4478
4a1eea700766da2f175ac7eaba6064f0d7f0ff03,0,GitHub,2021-04-01 11:19:52-05:00,['3b48efc15aff240c2dc883d503362d3f20db2692'],4,17,21,6061822,2,0.888888889,1,0.888888889,4478
72a56dafa767309856dc1549e2a0aec4f60c81e7,0,GitHub,2021-04-27 10:56:07-05:00,['4a1eea700766da2f175ac7eaba6064f0d7f0ff03'],4,4,8,6061830,1,,,,4478
d5244b8cb06a0f840ad1bf5d3faf74948702fdb9,0,GitHub,2021-05-03 13:17:07-05:00,['72a56dafa767309856dc1549e2a0aec4f60c81e7'],16,68,84,6061914,2,0.958333333,0.958333333,1,4478
8165f427729eccc0b018ed5b62610b7bf714cb3c,0,GitHub,2021-05-03 13:26:20-05:00,['d5244b8cb06a0f840ad1bf5d3faf74948702fdb9'],2,24,26,6061940,3,0,0,1,4478
b6e7d0355e0397b8acc566961ed31279338998e1,0,GitHub,2021-06-14 11:34:17-05:00,['8165f427729eccc0b018ed5b62610b7bf714cb3c'],25,571,596,6062536,18,0.153526971,0.531120332,0.970954357,4486
6c8b6cbeb387817d72432637acd19a71440e0173,0,GitHub,2021-06-21 09:41:58-05:00,['b6e7d0355e0397b8acc566961ed31279338998e1'],5,47,52,6062588,3,0.393939394,1,1,4486
8e4b235555d576a2a424fa2ac0086bd4bb96fe82,0,GitHub,2021-07-01 10:18:01-05:00,['6c8b6cbeb387817d72432637acd19a71440e0173'],51,42,93,6062681,4,0,1,0,4486
0df2ba288a57b2afff11a47c978fa99c905c71da,0,GitHub,2021-07-14 10:04:15-05:00,['8e4b235555d576a2a424fa2ac0086bd4bb96fe82'],73,10,83,6062764,7,0.176470588,0.235294118,0,4486
6a410493e27da96b893625df13e7c75e217f6fc7,0,GitHub,2021-07-29 14:02:41-05:00,['0df2ba288a57b2afff11a47c978fa99c905c71da'],1,8,9,6062773,2,0,0.5,1,4486
b869958557675c1da29e21db494d9daf62df30e4,0,GitHub,2021-07-30 15:21:57-05:00,['6a410493e27da96b893625df13e7c75e217f6fc7'],19,49,68,6062841,2,1,1,0,4486
ce078fcb78dd881f70df0be34e04940a53c38394,0,GitHub,2021-08-06 12:33:19-05:00,['b869958557675c1da29e21db494d9daf62df30e4'],491,14301,14792,6077633,53,0.331602769,0.481895634,0.766640043,4518
a87172a2abf5208e10f85c73dcd13081d79418e6,0,GitHub,2021-08-13 12:07:05-05:00,['ce078fcb78dd881f70df0be34e04940a53c38394'],2,12,14,6077647,3,0.5,1,1,4518
16ca56eae2c88db42293e926f764abfc2139f26b,0,GitHub,2021-08-16 14:17:53-05:00,['a87172a2abf5208e10f85c73dcd13081d79418e6'],1,1,2,6077649,1,,,,4518
0787d86010d83269b616e6f09c70ee45784b06d8,0,GitHub,2021-08-18 09:49:38-05:00,['16ca56eae2c88db42293e926f764abfc2139f26b'],15,14,29,6077678,4,,,,4518
aa67da56da0e21506624ea9ad12b35b630d28dc8,0,Meng (Ethan) Li,2021-09-20 14:51:47-05:00,['0787d86010d83269b616e6f09c70ee45784b06d8'],28,25,53,6077731,7,0,0,0,4518
aeccc45a126ebf45ecf68a2bc78e852c1c34074f,0,Meng (Ethan) Li,2021-09-21 09:50:05-05:00,['aa67da56da0e21506624ea9ad12b35b630d28dc8'],0,5,5,6077736,1,0,1,1,4518
185107f478c75ec9a78b90d036c9bcd639152494,0,GitHub,2021-09-22 10:24:23-05:00,['aeccc45a126ebf45ecf68a2bc78e852c1c34074f'],15,49,64,6077800,4,0.185185185,1,0,4518
0c7bbca67db593b82030a7b406a44d54122ce792,0,GitHub,2021-09-22 13:25:35-05:00,['185107f478c75ec9a78b90d036c9bcd639152494'],18,19,37,6077837,1,1,1,0,4518
775d6098a9a7bc8d2242e925457a960ff89faaeb,0,GitHub,2021-09-22 14:26:05-05:00,['0c7bbca67db593b82030a7b406a44d54122ce792'],1,2,3,6077840,1,1,1,0,4518
7321ed4ae11cf9bde7d266b1a0fcba7a63067f1f,0,Ethan Li,2021-09-23 09:57:14-05:00,['775d6098a9a7bc8d2242e925457a960ff89faaeb'],78,78,156,6077996,78,,,,4518
77786a0dee3a9a51a2bd0d1cf8caacc34fb38b8e,0,GitHub,2021-09-28 09:26:35-05:00,['7321ed4ae11cf9bde7d266b1a0fcba7a63067f1f'],2,2,4,6078000,1,,,,4518
d9b12720d149c78b15a7eb0e114c6b5b5824421d,0,GitHub,2021-10-14 11:10:28-05:00,['77786a0dee3a9a51a2bd0d1cf8caacc34fb38b8e'],1,1,2,6078002,1,,,,4518
2092e61a80d236b9ebb58b1ca36a0bb297a2f3db,0,GitHub,2021-10-20 15:09:27-05:00,['d9b12720d149c78b15a7eb0e114c6b5b5824421d'],21,63,84,6078086,3,1,1,1,4519
159a66199d086cf09fb1d1cb527287a3cd554be9,0,GitHub,2021-10-21 16:03:30-05:00,['2092e61a80d236b9ebb58b1ca36a0bb297a2f3db'],9,9,18,6078104,1,,,,4519
30857b7d54ac7a91c42e0816cb0fbcdcd111e89f,0,GitHub,2021-10-25 10:12:36-05:00,['159a66199d086cf09fb1d1cb527287a3cd554be9'],0,15,15,6078119,2,0,0,0,4519
6c3a6be54514ebba6f7e0fbd0c9b89a9192e9eff,0,GitHub,2021-11-03 15:54:44-05:00,['30857b7d54ac7a91c42e0816cb0fbcdcd111e89f'],0,33,33,6078152,1,0,0,0.24,4519
f481eaf043dba3b6c62ac27bb2306ef652f2ace9,0,GitHub,2021-11-08 14:50:37-05:00,['6c3a6be54514ebba6f7e0fbd0c9b89a9192e9eff'],36,105,141,6078293,5,,,,4519
e21b71b56353cc4c7ce6d628d44223e3ca32fe80,0,GitHub,2021-11-18 12:17:12-05:00,['f481eaf043dba3b6c62ac27bb2306ef652f2ace9'],3,2,5,6078298,1,,,,4519
216e930826d0211f55868b7c5f47280a383c3e1e,0,GitHub,2021-12-16 10:16:26-06:00,['e21b71b56353cc4c7ce6d628d44223e3ca32fe80'],1,1,2,6078300,1,,,,4519
07be3ed337b184e055463d84fe8aa6c636cbe8b2,0,GitHub,2021-12-20 09:21:45-06:00,['216e930826d0211f55868b7c5f47280a383c3e1e'],1,1,2,6078302,1,,,,4519
4a9f17c1beac759df5f7a880ded2365323c73a17,0,GitHub,2022-01-04 16:05:24-06:00,['07be3ed337b184e055463d84fe8aa6c636cbe8b2'],2,11,13,6078315,3,0,1,0,4519
1ec1022f823f3d9c15819579fe48ac4384f0c119,0,GitHub,2022-01-16 12:29:21-08:00,['4a9f17c1beac759df5f7a880ded2365323c73a17'],1,1,2,6078317,1,,,,4519
99974575963a3b54ffdc0745aa93d96ab7e1003d,0,GitHub,2022-01-16 21:55:28-08:00,['1ec1022f823f3d9c15819579fe48ac4384f0c119'],10,10,20,6078337,2,,,,4519
a0cbf5a3d7f043ffe529b7dae1a2759de7ba49d5,0,GitHub,2022-02-07 16:32:53-06:00,['99974575963a3b54ffdc0745aa93d96ab7e1003d'],44,43,87,6078424,5,1,1,0,4519
6e5f6331f09e8aebd1d4f3394c5af1f000601786,0,GitHub,2022-02-22 11:14:04-08:00,['a0cbf5a3d7f043ffe529b7dae1a2759de7ba49d5'],24,24,48,6078472,1,,,,4519
14c99ef05adafd11053394c7402f6a1a8b38345a,0,Bipin Prasad,2022-02-23 10:07:57-08:00,['6e5f6331f09e8aebd1d4f3394c5af1f000601786'],82,81,163,6078635,78,,,,4519
2744d18d4df4f06eebd54211a58b326f0783a5ee,0,Bipin Prasad,2022-02-23 10:09:00-08:00,['14c99ef05adafd11053394c7402f6a1a8b38345a'],79,79,158,6078793,78,,,,4519
d48b1f03a8f6703c19e30b86d36b29bcefca1e47,0,GitHub,2022-02-24 12:16:41-05:00,['2744d18d4df4f06eebd54211a58b326f0783a5ee'],4,1,5,6078798,1,,,,4519
6da175a8a2a99f05234e1e895dcbadad5caeeade,0,Bipin Prasad,2022-02-24 13:48:16-08:00,['d48b1f03a8f6703c19e30b86d36b29bcefca1e47'],79,79,158,6078956,78,,,,4519
4d36dedf2c67b0d57652c56d11cb609512dd0bcb,0,Bipin Prasad,2022-02-24 13:48:45-08:00,['6da175a8a2a99f05234e1e895dcbadad5caeeade'],81,82,163,6079119,78,,,,4519
05fb58624e6cf005879a47f81f2988fe4afbb1e5,0,Bipin Prasad,2022-02-24 15:05:55-08:00,['4d36dedf2c67b0d57652c56d11cb609512dd0bcb'],24,24,48,6079167,1,,,,4519
25b0fd7753280698187245df00bb201cbb099aa5,0,Bipin Prasad,2022-02-24 15:23:14-08:00,['05fb58624e6cf005879a47f81f2988fe4afbb1e5'],78,78,156,6079323,78,,,,4519
ba4225e47157956b4fd1049709ab41d335e15258,0,GitHub,2022-02-28 10:39:39-06:00,['25b0fd7753280698187245df00bb201cbb099aa5'],10,10,20,6079343,6,,,,4519
b1e671a52bf906344f94dde483e08c02590e0b12,0,GitHub,2022-02-28 10:44:09-06:00,['ba4225e47157956b4fd1049709ab41d335e15258'],3,3,6,6079349,3,,,,4519
d664716944de8bd0930bd876d7c316a9cf3280b4,0,GitHub,2022-03-04 09:55:54-08:00,['b1e671a52bf906344f94dde483e08c02590e0b12'],11,0,11,6079360,1,,,,4519
b7e31cafbf1f15e285aa40e9bb63b0b8ded223a6,0,GitHub,2022-03-04 14:29:41-06:00,['d664716944de8bd0930bd876d7c316a9cf3280b4'],3,0,3,6079363,1,,,,4519
d2db1952f0f3759066e95a90b0a5faad9e973538,0,GitHub,2022-03-07 10:31:40-06:00,['b7e31cafbf1f15e285aa40e9bb63b0b8ded223a6'],0,10,10,6079373,1,,,,4519
326f9e9fb28aa8d5b44b835d12a3be7b387ee317,0,GitHub,2022-03-09 09:13:12-06:00,['d2db1952f0f3759066e95a90b0a5faad9e973538'],10,86,96,6079469,11,,,,4519
01fb443730f319a7269889e3785c862b651633ea,0,GitHub,2022-03-28 15:15:36-05:00,['326f9e9fb28aa8d5b44b835d12a3be7b387ee317'],19,0,19,6079488,1,,,,4519
b83df866e5ae63481348b67d3613fc444c60d8c7,0,GitHub,2022-03-28 15:22:09-05:00,['01fb443730f319a7269889e3785c862b651633ea'],12,6,18,6079506,6,1,1,0,4519
617926a33eeca2ae7e4f5b05e48aad9a689e2cf2,0,GitHub,2022-03-28 15:39:34-05:00,['b83df866e5ae63481348b67d3613fc444c60d8c7'],23,23,46,6079552,3,,,,4519
9a226b5c2c856d36c409bb05917f5c7538476bac,0,GitHub,2022-03-28 15:40:28-05:00,['617926a33eeca2ae7e4f5b05e48aad9a689e2cf2'],1,1,2,6079554,1,,,,4519
61e47a96f3184b5985245ff3fd6be9e1f0e33a92,0,GitHub,2022-03-29 15:22:44-05:00,['9a226b5c2c856d36c409bb05917f5c7538476bac'],0,1,1,6079555,1,1,1,1,4519
2bd7075654737c7d0376d525de98198dee6195ad,0,GitHub,2022-03-30 07:40:04-07:00,['61e47a96f3184b5985245ff3fd6be9e1f0e33a92'],86,84,170,6079725,78,,,,4519
87efcea9d74e26e7e8879eed4d200871cf13db3e,0,GitHub,2022-03-30 15:20:59-05:00,['2bd7075654737c7d0376d525de98198dee6195ad'],1,22,23,6079748,2,0.928571429,0.928571429,0.928571429,4519
1713a9c37b985188349bcf8d3cc6aad41c5bd8b7,0,GitHub,2022-04-01 09:18:57-07:00,['87efcea9d74e26e7e8879eed4d200871cf13db3e'],7,7,14,6079762,2,,,,4519
c0750018d08dae822537e80ab3c894da8ba29532,0,GitHub,2022-04-03 00:18:13-07:00,['1713a9c37b985188349bcf8d3cc6aad41c5bd8b7'],10,25,35,6079797,2,1,1,1,4519
bb9979b47a25a5215660c8f3df0b1a910da9d5e4,0,GitHub,2022-04-03 22:52:57-07:00,['c0750018d08dae822537e80ab3c894da8ba29532'],10,12,22,6079819,2,0,0,0,4519
c71e7ac498067de4ee2c5b9c9b6759cece5b0184,0,GitHub,2022-04-04 10:52:50-05:00,['bb9979b47a25a5215660c8f3df0b1a910da9d5e4'],31,41,72,6079891,13,,,,4519
629a1965c6212dc18114cac908ac6c519f9bc524,0,GitHub,2022-04-05 07:13:54-07:00,['c71e7ac498067de4ee2c5b9c9b6759cece5b0184'],0,1,1,6079892,1,,,,4519
495c8b08c25f63cf0ae928e49346f73c856545a4,0,GitHub,2022-04-05 07:14:44-07:00,['629a1965c6212dc18114cac908ac6c519f9bc524'],2,2,4,6079896,1,,,,4519
ddc78e9c0c322aff41991a87e60d71770e343a85,0,GitHub,2022-04-05 07:16:51-07:00,['495c8b08c25f63cf0ae928e49346f73c856545a4'],5,34,39,6079935,1,1,0.923076923,0.230769231,4519
0fc6e05c819ae13e924380724054e3daccc092e4,0,GitHub,2022-04-06 06:39:36-07:00,['ddc78e9c0c322aff41991a87e60d71770e343a85'],10,10,20,6079955,2,,,,4519
48e3e4e6188e5c2923eb175c4a3ab18ec94ebaa0,0,GitHub,2022-04-06 08:47:05-07:00,['0fc6e05c819ae13e924380724054e3daccc092e4'],0,5,5,6079960,1,,,,4519
ef965be9770912357232cb0f512cc632891ab0c8,0,GitHub,2022-04-06 18:18:23-07:00,['48e3e4e6188e5c2923eb175c4a3ab18ec94ebaa0'],22,23,45,6080005,1,,,,4519
67cb564e6afb836a08a7d91c1ae0455e16f1952f,0,GitHub,2022-04-26 08:21:57-07:00,['ef965be9770912357232cb0f512cc632891ab0c8'],3,6,9,6080014,5,,,,4519
40459a0246a600acb61435d2b44e00bd1a945025,0,GitHub,2022-04-26 08:23:04-07:00,['67cb564e6afb836a08a7d91c1ae0455e16f1952f'],0,36,36,6080050,17,0.142857143,0.571428571,0.428571429,4519
c17f6854eb80bf2e37a870539bc45fc4dc2781ce,0,GitHub,2022-05-04 15:37:16-05:00,['40459a0246a600acb61435d2b44e00bd1a945025'],1,1,2,6080052,1,,,,4519
145fe09507e75208f5104053093eb678df4e360b,0,GitHub,2022-05-16 11:08:57-05:00,['c17f6854eb80bf2e37a870539bc45fc4dc2781ce'],0,10,10,6080062,2,0,0,0.5,4519
a4b026ec50df94786bd7e9a2450e0018beed7dba,0,GitHub,2022-05-23 17:23:57-07:00,['145fe09507e75208f5104053093eb678df4e360b'],2,5,7,6080069,2,,,,4519
9cebcbc28e2a6cea0538fb80a2c27db7ae77e470,0,GitHub,2022-05-24 23:03:35-07:00,['a4b026ec50df94786bd7e9a2450e0018beed7dba'],10,10,20,6080089,2,,,,4519
0f22217365ba186ef8624612082c5adf4a87cee2,0,GitHub,2022-05-25 00:17:51-07:00,['9cebcbc28e2a6cea0538fb80a2c27db7ae77e470'],3,3,6,6080095,3,,,,4519
cc75516e0cfe9d75d67a0ab93196ece09a24c0b3,0,GitHub,2022-05-26 07:32:53-07:00,['0f22217365ba186ef8624612082c5adf4a87cee2'],16,8,24,6080119,6,,,,4519
a79b6bbdbfa5f0d2c80d07420fe9415c7cbc99e1,0,GitHub,2022-05-26 07:36:43-07:00,['cc75516e0cfe9d75d67a0ab93196ece09a24c0b3'],10,10,20,6080139,2,,,,4519
54f411c491d31cccb4ebb18d7cef39a4b96a4a5b,0,GitHub,2022-05-26 07:37:24-07:00,['a79b6bbdbfa5f0d2c80d07420fe9415c7cbc99e1'],60,74,134,6080273,3,,,,4519
b93f0d65cadbc585f2108591452f8bb7f8a9c446,0,GitHub,2022-05-31 17:57:49-07:00,['54f411c491d31cccb4ebb18d7cef39a4b96a4a5b'],57,73,130,6080403,3,,,,4519
9be54dce25a58d61c26926cbdcf8a224424a6297,0,GitHub,2022-06-09 07:48:33-07:00,['b93f0d65cadbc585f2108591452f8bb7f8a9c446'],654,1371,2025,6082428,21,0.877142857,0.902857143,0.9,4521
33918ad0d38ea74286a8236b065505e7b940ea6c,0,GitHub,2022-06-09 08:01:12-07:00,['9be54dce25a58d61c26926cbdcf8a224424a6297'],7,1,8,6082436,1,1,1,0,4521
a8fb509f7d5992a8f4aecff1af889aa890a99979,0,GitHub,2022-06-16 08:20:46-07:00,['33918ad0d38ea74286a8236b065505e7b940ea6c'],4797,4551,9348,6091784,287,1,0.279635258,0.094224924,4522
6807f1d41f6562810251384ff562713eabb49f92,0,GitHub,2022-07-05 14:33:09-05:00,['a8fb509f7d5992a8f4aecff1af889aa890a99979'],2,3,5,6091789,1,,,,4522
8de7676f7eb28f65fd3a58050b8a2df41d803ae8,0,GitHub,2022-07-14 09:21:24-05:00,['6807f1d41f6562810251384ff562713eabb49f92'],3,25,28,6091817,6,,,,4522
aa477298075f590da0a38428d8c3d4a431ecf089,0,GitHub,2022-07-18 11:37:19-05:00,['8de7676f7eb28f65fd3a58050b8a2df41d803ae8'],3,0,3,6091820,1,1,1,0,4522
e694f59595669565e9963133a6c290fd5a9cfce9,0,GitHub,2022-07-20 11:16:27-07:00,['aa477298075f590da0a38428d8c3d4a431ecf089'],22,40,62,6091882,6,1,1,1,4522
